;aberration;accessory;amount;analysis;apparatus;aspheric;axis;base;calculate;capture;center;characteristic;circular;coefficient;color;combination;compensate;compensation;component;computer;condition;control;coordinate;correct;correction;correlation;curve;data;degree;detect;detection;determine;device;difference;digital;dimensional;direct;direction;displacement;display;distance;distortion;drive;element;error;evaluation;fitting;focal;focus;frequency;function;generate;generation;group;height;image;include;interpolation;length;lens;linear;magnification;method;minimum;model;motor;moving;objective;occur;operation;optical;order;path;peripheral;periphery;photographic;piezoelectric;point;position;power;prevent;processing;processor;produce;property;reflection;region;relation;represent;select;sensor;shift;shoot;signal;size;space;spot;storage;store;substrate;surface;system;trace;transfer;transitory;trigger;type;unit;wave;absorb;adapt;arrange;array;assembly;attach;balance;barrier;blue;board;body;bond;carriage;changing;circuit;coat;collect;configure;contact;contrast;couple;cover;create;crystal;cylinder;describe;detector;dispose;door;electrode;emit;energy;environment;external;face;filter;force;form;frame;gamma;glass;green;groove;guide;heat;hold;holder;hole;house;illumination;imaging;incident;increase;inner;inside;instrument;layer;level;light;load;material;member;mirror;module;mount;movement;open;outer;output;package;pane;panel;partially;pass;pick;pivot;plane;plate;plurality;polarization;portion;protective;protrusion;radiation;receive;rectangular;reflect;refractive;resilient;rotation;secure;semiconductor;shape;shield;side;sleeve;specific;stage;stationary;structure;support;test;thereon;thermal;thin;tilt;time;transmit;transparent;travel;tube;upper;vehicle;vibration;visible;wall;wavelength;window;windshield;work;abut;accommodate;actuation;actuator;adjacent;adjust;angle;annular;apply;area;autofocus;barrel;bearing;block;bottom;cable;case;channel;chip;circumferential;coil;column;compression;conductive;connect;constitute;construct;cylindrical;define;desire;diameter;divide;driving;edge;elastic;engage;engagement;extend;fasten;flange;flat;flexible;front;ground;held;insert;interface;item;lever;limit;locate;lock;magnet;mechanical;mechanism;mold;motion;move;object;operate;opposite;optics;orthogonal;overlap;pattern;permanent;perpendicular;photoelectric;photograph;planar;pole;portable;post;predetermine;project;projection;protrude;rail;range;rear;recess;reference;respective;retract;retractable;ring;roller;rotatable;rotor;screw;seal;seat;sense;shaft;slide;slope;source;spacer;spring;supply;translation;user;vary;wheel;acceleration;accelerometer;accumulate;achieve;acquisition;addition;angular;apart;associate;association;basis;blur;buffer;calculation;carry;chamber;change;close;command;compute;constant;criterion;decrease;derive;deviation;dome;equip;estimate;evaluate;exit;flow;identify;indicate;indication;indicative;integrate;interest;judge;lateral;magnitude;measure;medium;memory;multiple;noise;omega;parallel;period;pickup;product;program;pulse;quantity;rate;ratio;readable;record;release;response;rotational;security;shutter;speed;start;target;threshold;total;track;traffic;utilize;variation;vector;velocity;virtual;zoom;action;activate;align;allow;carrier;combine;communications;event;feature;inertial;input;laser;location;logic;message;mobile;mode;phone;quality;read;resolution;scene;sequence;spatial;speaker;stabilization;accept;adapter;analog;aspect;audio;battery;button;candidate;card;circuitry;configuration;controller;conversion;convert;designate;driver;engine;execute;field;flash;fold;format;identification;instruct;instruction;internet;judgment;list;live;maximum;microphone;monitor;movable;operator;parameter;participant;partition;perform;platform;player;port;positional;print;radio;recognition;recognize;register;representation;request;responsive;road;rotate;screen;selection;selector;setting;sound;switch;temperature;turn;video;view;viewfinder;voltage;volume;write;access;address;algorithm;analyze;aperture;attachment;attribute;axial;capsule;casing;cavity;cleaning;client;code;communication;connection;connector;content;database;decide;detachably;distal;distribution;document;edit;emission;enable;endoscope;enhance;enter;equipment;estimation;expose;feed;file;gain;grip;hand;handheld;identifier;illuminator;individual;initiate;install;interior;lamp;link;machine;management;manipulate;match;media;metal;modify;network;opening;operable;operative;permit;picture;pixel;potential;printer;priority;proximal;registration;relative;reproduction;restrict;retrieve;roll;send;server;service;sidewall;site;slot;software;solder;station;stitch;stream;subject;subsequent;synchronize;terminal;thread;thumbnail;tone;update;wireless;adhesive;articulate;auxiliary;cell;charge;compact;compartment;consist;cross;electronics;emitter;exposure;eyepiece;handle;host;interchangeable;intermediate;linkage;loop;mate;piece;proximate;rearview;reception;recorder;remote;removable;removably;require;reset;rigid;sensitivity;separate;share;shoulder;stand;strap;transmission;tripod;vehicular;wire;adjustable;adjustment;alignment;ball;beam;blade;bracket;chassis;clip;complete;concave;container;curvature;decode;defect;design;dimension;enclose;extract;film;hardware;hinge;hollow;insertion;join;latch;offset;orient;orientation;passage;protocol;radius;reflective;remove;shake;shell;socket;straight;strobe;telephoto;television;thickness;vertical;vision;wafer;weight;accumulation;activity;amplifier;amplify;average;brightness;calibration;capacitor;conductivity;continuously;count;diffusion;discharge;electric;exceed;expression;factor;float;gate;horizontal;imager;integration;interval;modulate;node;observe;partial;perimeter;photodiode;presence;preset;process;readout;remain;repeat;scan;successive;synthesize;transistor;actuate;decision;enclosure;liquid;marker;middle;photo;photosensor;reach;realtime;sequential;water;amplitude;automatic;clock;compare;continuous;differential;dynamic;enlarge;equation;implement;installation;intensity;iris;master;phase;physical;reduction;relationship;sample;satisfy;similarity;split;stabilize;stereoscopic;table;template;transform;transformation;variable;width;arrangement;auto;band;calibrate;characterize;comparison;compose;contour;converter;correspondence;cycle;determination;diode;forward;fundus;geometric;head;luminance;maintain;manual;navigation;notification;panoramic;parallax;person;predict;projector;search;shot;sign;smart;synchronization;trajectory;alert;character;communicate;crop;execution;exterior;extraction;finger;game;gesture;initialization;joint;perspective;preview;reflector;render;segment;selectable;separation;transition;viewpoint;visual;yoke;activation;ambient;assist;become;brake;counter;delay;depth;detachable;duration;finder;fixture;fluid;illuminate;indicator;left;manner;measurement;moveable;opaque;pressure;profile;ramp;receiver;reverse;sensitive;superimpose;surround;transmitter;voice;zone;drain;feedback;foreground;gear;press;slave;assign;correlate;histogram;rule;surveillance;train;bias;circle;clamp;generator;half;lead;prism;subsystem;touch;conductor;encoder;hook;manufacturing;modular;plural;suspension;elongate;embed;mask;modulation;neighboring;pitch;polarize;receptacle;rolling;rotary;rotatably;silicon;slid;stack;tool;transceiver;aerial;antenna;classify;comparator;composite;composition;compress;context;destination;diaphragm;encode;extension;fastener;foot;friction;gaming;gimbal;graphic;human;interpolate;mark;observation;overlay;photography;pose;primary;pupil;radar;rearward;refract;representative;scale;scanner;score;serial;series;sight;spectral;spectrum;stabilizer;status;subset;timer;warp;discrete;executable;stereo;adaptor;bobbin;patient;wearable;denote;technique;matrix;packet;sharpness;text;boundary;cure;entry;insulate;photosensitive;resin;sheet;chain;corner;grid;impurity;incline;intersect;intersection;lane;patch;principal;aircraft;cement;compound;dark;freedom;peak;probe;standard;steer;symbol;tooth;plug;robot;gradient;shade;signature;cluster;facial;posture;square;photodetector;splitter;core;icon;gaze;disparity;metadata;microlens;version;conditional;landmark;convex;dental;park;trailer;terahertz
accessory;4,0;;;;6,0;;;10,0;;2,0;1,0;;;;5,0;5,0;;;5,0;;;60,0;;;;;;20,0;;;6,0;;78,0;;5,0;;;3,0;1,0;3,0;;;;1,0;;;;3,0;;;2,0;;;5,0;;6,0;39,0;;4,0;36,0;;;8,0;;;;1,0;;;17,0;;;;3,0;;8,0;;;7,0;6,0;;2,0;;;;;;;1,0;4,0;14,0;4,0;;3,0;;;;2,0;9,0;;7,0;96,0;;2,0;;1,0;3,0;122,0;;3,0;3,0;3,0;;41,0;53,0;;;;2,0;43,0;;;;1,0;;;12,0;2,0;;4,0;3,0;;;;;;2,0;2,0;4,0;1,0;;;16,0;5,0;;4,0;2,0;3,0;;;;1,0;;;;;;15,0;6,0;;;;2,0;;;7,0;;22,0;;;8,0;15,0;;141,0;;3,0;2,0;3,0;;;10,0;;;;;;17,0;14,0;;27,0;;;;25,0;;;;;;7,0;;4,0;;2,0;;13,0;;2,0;3,0;15,0;;6,0;;;;5,0;14,0;;;;;20,0;;;;;;10,0;;;;1,0;;;;;;4,0;;;5,0;;;;;4,0;;;;;;;;8,0;1,0;;;9,0;;;;;3,0;1,0;14,0;2,0;7,0;;2,0;;;1,0;;;;3,0;2,0;;;14,0;;;;4,0;;;;;4,0;3,0;;;;2,0;;;;15,0;;;;1,0;1,0;;;;4,0;;;;;;;;;;;;;;;;;;;3,0;;;4,0;;;;;;;;;;;;;;2,0;;;;;;;;;;;;;;;;;;;;;;;;;;;;1,0;;;;;2,0;;;;;2,0;;;;;;;;;5,0;2,0;;2,0;;;;1,0;;;;;;;;;;;;;;;;1,0;;;;3,0;;;;;;;;2,0;;;;;;;;;;;1,0;;;;3,0;1,0;;;1,0;;1,0;4,0;;;;;2,0;;19,0;;;1,0;;1,0;;1,0;;;;;;;;;;;19,0;;;;;;;;;9,0;;;;;;;;;;;5,0;;;2,0;;16,0;;;;2,0;;;;4,0;17,0;;;;;3,0;2,0;;;8,0;7,0;2,0;;;;3,0;;;;;;;;;1,0;;;;;;;1,0;1,0;1,0;;;;;1,0;15,0;;;;;2,0;;;;;;;;;;;1,0;;;1,0;;;;;;;;;;;3,0;7,0;;;;;1,0;;;;;8,0;5,0;;;;;6,0;2,0;1,0;1,0;1,0;1,0;24,0;2,0;2,0;8,0;1,0;2,0;12,0;1,0;1,0;4,0;28,0;1,0;1,0;3,0;1,0;2,0;1,0;6,0;1,0;3,0;7,0;11,0;3,0;6,0;3,0;1,0;3,0;4,0;1,0;3,0;4,0;6,0;1,0;1,0;1,0;;;;;;;;;;;;;;;;;;;;;;;;;;;;;;;;;;;;;;;;;;;;;;;;;;;;;;;;;;;;;;;;;;;;;;;;;;;;;;;;;;;;;;;;;;;;;;;;;;;;;;;;;;;;;;;;;;;;;;;;;;;;;;;;;;;;;;;;;;;;;;;;;;;;;;;;;;;;;;;;;;;;;;;;;;;;;;;;;;;;;;;;;;;;;;;;;;;;;;;;;;;;;;;;;;;;;;;;;;;;;;;;;;;;;;;;;;;;;;;;;;;;;;;;;;;;;;;;;;;;;;;;;;;;;;;;;;;;;;;;;;;;;;;;;;;;;;;;;;;;;;;;;;;;;;;;;;;;;;;;;;;;;;;;;;;;;;;;;;;;;;;;;;;;;;;;;;;;;;;;;;;;;;;;
amount;5,0;;;;55,0;;44,0;235,0;265,0;49,0;31,0;79,0;;5,0;158,0;3,0;3,0;1,0;37,0;9,0;55,0;209,0;8,0;42,0;188,0;5,0;4,0;107,0;20,0;198,0;95,0;167,0;162,0;52,0;48,0;5,0;15,0;93,0;62,0;54,0;20,0;2,0;29,0;38,0;5,0;2,0;2,0;12,0;61,0;5,0;4,0;31,0;;38,0;3,0;398,0;28,0;;20,0;199,0;4,0;26,0;104,0;6,0;2,0;14,0;50,0;1,0;5,0;34,0;72,0;15,0;;;;17,0;2,0;18,0;51,0;8,0;2,0;57,0;4,0;2,0;7,0;8,0;51,0;9,0;23,0;42,0;47,0;108,0;19,0;112,0;13,0;6,0;;9,0;42,0;5,0;26,0;72,0;;20,0;3,0;2,0;2,0;263,0;2,0;1,0;20,0;3,0;11,0;4,0;3,0;3,0;;1,0;;18,0;;;12,0;18,0;14,0;1,0;75,0;;2,0;2,0;5,0;;6,0;;1,0;4,0;1,0;3,0;;115,0;14,0;;6,0;90,0;26,0;2,0;10,0;88,0;7,0;;2,0;3,0;6,0;2,0;4,0;1,0;2,0;16,0;45,0;39,0;36,0;30,0;2,0;;;8,0;15,0;684,0;;;26,0;12,0;9,0;1,0;247,0;13,0;;33,0;1,0;;1,0;;17,0;;;2,0;6,0;64,0;;55,0;;;1,0;47,0;3,0;42,0;;2,0;54,0;1,0;;3,0;;7,0;;3,0;9,0;1,0;;3,0;5,0;;1,0;2,0;11,0;165,0;23,0;;4,0;;11,0;;29,0;1,0;;10,0;1,0;5,0;1,0;;;1,0;;2,0;98,0;24,0;;26,0;49,0;5,0;4,0;;7,0;;1,0;8,0;2,0;2,0;;9,0;;61,0;5,0;5,0;;;;12,0;40,0;1,0;4,0;28,0;39,0;1,0;;;5,0;;;3,0;;;;;2,0;;1,0;;42,0;2,0;;;4,0;21,0;;161,0;19,0;41,0;10,0;3,0;6,0;;3,0;;;6,0;4,0;41,0;;;;;224,0;5,0;2,0;;;44,0;4,0;;36,0;33,0;;1,0;;;;1,0;;;;22,0;3,0;6,0;;5,0;;;9,0;6,0;17,0;38,0;;3,0;;11,0;1,0;9,0;5,0;8,0;;23,0;;42,0;104,0;3,0;41,0;4,0;;110,0;14,0;15,0;55,0;1,0;2,0;28,0;4,0;29,0;;;10,0;;;;;23,0;;12,0;12,0;4,0;9,0;1,0;2,0;24,0;3,0;14,0;3,0;8,0;1,0;4,0;20,0;10,0;9,0;6,0;21,0;1,0;12,0;91,0;2,0;16,0;;24,0;10,0;;8,0;9,0;2,0;74,0;46,0;26,0;1,0;;;60,0;18,0;6,0;3,0;32,0;;1,0;2,0;3,0;;;;1,0;54,0;;38,0;1,0;;1,0;;2,0;60,0;1,0;3,0;8,0;;16,0;1,0;5,0;;;2,0;;2,0;;2,0;25,0;3,0;3,0;;;;20,0;17,0;5,0;1,0;;;;8,0;58,0;2,0;2,0;2,0;4,0;2,0;;2,0;;;65,0;2,0;13,0;18,0;;30,0;1,0;1,0;74,0;;;;;2,0;;;8,0;9,0;;;7,0;6,0;13,0;2,0;5,0;2,0;23,0;;9,0;19,0;3,0;24,0;9,0;10,0;5,0;;;;;;;27,0;;;2,0;3,0;1,0;;;2,0;85,0;6,0;;3,0;1,0;;24,0;1,0;;7,0;;;293,0;1,0;;;9,0;;;1,0;;;6,0;;8,0;;1,0;;1,0;1,0;;;;;;2,0;;1,0;3,0;;;1,0;3,0;5,0;;1,0;21,0;98,0;1,0;;;;5,0;22,0;;1,0;;1,0;1,0;2,0;;;;;2,0;;;;5,0;86,0;12,0;;2,0;;;;11,0;;4,0;;10,0;2,0;31,0;;;3,0;;;;133,0;1,0;;;11,0;1,0;;;;;;;;;1,0;;;22,0;1,0;;2,0;1,0;;;;;;;1,0;;;50,0;21,0;;14,0;2,0;;;;;;;1,0;;;;9,0;;38,0;4,0;;;;2,0;;;43,0;;4,0;2,0;;;;8,0;122,0;;;2,0;6,0;15,0;;2,0;22,0;;;6,0;5,0;16,0;;1,0;15,0;40,0;;5,0;1,0;6,0;4,0;;1,0;23,0;23,0;4,0;9,0;;;30,0;3,0;;8,0;;1,0;1,0;14,0;;1,0;1,0;1,0;7,0;;26,0;1,0;8,0;2,0;1,0;;;5,0;;14,0;;;2,0;;22,0;1,0;3,0;;2,0;3,0;22,0;29,0;5,0;;5,0;3,0;6,0;1,0;;;15,0;;32,0;3,0;36,0;3,0;3,0;22,0;9,0;;2,0;;7,0;14,0;1,0;4,0;2,0;4,0;1,0;;2,0;1,0;;12,0;2,0;;;;9,0;35,0;18,0;;5,0;;3,0;45,0;7,0;1,0;;;;2,0;3,0;2,0;;2,0;;10,0;;4,0;;;;2,0;;;;6,0;;;;;;;;;;4,0;;5,0;;;4,0;;1,0;;;19,0;;1,0;10,0;1,0;;15,0;4,0;;;4,0;3,0;2,0;6,0;9,0;;;;;;1,0;4,0;;;;;;;;26,0;;6,0;;;15,0;8,0;;;1,0;;5,0;;;;;;;;2,0;;2,0;1,0;;;3,0;;;;;1,0;10,0;1,0;1,0;;3,0;;;;;;;;;;;;1,0;1,0;3,0;;1,0;18,0;10,0;;;3,0;;;;;;10,0;;;;8,0;;7,0;2,0;;1,0;;5,0;;;9,0;;;;1,0;;;;1,0;1,0;;;3,0;;;;;;;1,0;;1,0;;;;;;;;2,0;;;5,0;;;;7,0;;;;;;2,0;;8,0;3,0;;2,0;5,0;;;;;;;1,0;;;3,0;;;;1,0;;;;1,0;4,0;8,0;;;;;;;;
analysis;1,0;;;;14,0;;;40,0;4,0;23,0;;;;;12,0;4,0;1,0;;5,0;8,0;;22,0;;1,0;;;;15,0;;7,0;7,0;24,0;14,0;;14,0;;1,0;1,0;;5,0;1,0;;;1,0;;;;;10,0;5,0;16,0;5,0;;;;155,0;27,0;;1,0;1,0;;1,0;33,0;;;1,0;1,0;;;6,0;1,0;2,0;;;;7,0;;7,0;5,0;;;30,0;10,0;1,0;;;12,0;;;5,0;5,0;;;22,0;;4,0;;1,0;2,0;;2,0;37,0;;;;;;53,0;1,0;;;2,0;3,0;1,0;1,0;;;;;;;;1,0;1,0;;2,0;5,0;;;6,0;;;;;;3,0;;;;;;;;3,0;2,0;;;3,0;;;1,0;;;;;;;1,0;;7,0;;;;;;;2,0;2,0;2,0;;;;46,0;;2,0;;;8,0;;;;;;1,0;;;;4,0;;;;;;4,0;;;;;;;;;;;;;1,0;;2,0;;;;;;;10,0;3,0;;;;1,0;1,0;;;;;;;;;;;;;3,0;;;4,0;9,0;;;;;;;;;;;;;1,0;;5,0;;;;3,0;;;;;;;;;1,0;;;;;1,0;;;4,0;;;;;1,0;;;;;;15,0;1,0;12,0;;;1,0;;;17,0;;;;2,0;;;10,0;;2,0;;1,0;;;5,0;;;2,0;;;;;;;;;;;;;;;;;;;;2,0;;;;;;;;;;;1,0;;5,0;;;3,0;;;3,0;;8,0;1,0;;1,0;;2,0;;;;;3,0;;2,0;11,0;1,0;;5,0;;3,0;;;;;;1,0;;3,0;;;2,0;;;1,0;;;1,0;6,0;;;;5,0;;;;;1,0;11,0;;;1,0;;1,0;;3,0;;;;;1,0;1,0;1,0;;4,0;1,0;3,0;4,0;;3,0;;3,0;4,0;4,0;;28,0;;2,0;;1,0;43,0;4,0;;2,0;3,0;;;;1,0;3,0;;;;;;;7,0;1,0;4,0;1,0;;;3,0;8,0;2,0;;;;;3,0;;;;;;;4,0;;1,0;4,0;1,0;;30,0;;;;;;;3,0;7,0;;1,0;;2,0;;;2,0;;;8,0;4,0;1,0;;;14,0;3,0;;;;;4,0;;25,0;19,0;;;;;;;;;;1,0;2,0;;;;;;;;2,0;;;;3,0;;;;;;;;;;;;;;;1,0;;;;;;;;;1,0;;;2,0;;;;;;;16,0;;;;;;2,0;;;;;;1,0;;;;;1,0;;;;;3,0;1,0;;4,0;;;;;;;;;;;;;;;;;3,0;;;;;;;;;;;;;;1,0;;;;;;;;;;;;;;;;;2,0;;;;;;;;;;;;3,0;2,0;;;;10,0;;2,0;;;3,0;;;;;;;;;;;;;;;;;;;;;;;;3,0;;;;3,0;1,0;;;;;;;;;;;;;;5,0;;;;;;;;;;;5,0;;;1,0;;;;;;;;;2,0;;;;;;;;1,0;6,0;;;;;;;2,0;;;;;;;;;;;;;;1,0;;;;4,0;;1,0;;;;;;1,0;;;;;;1,0;;;;;;;1,0;;;;;;;1,0;;;;1,0;;;;;1,0;;;;;;;;;;;1,0;1,0;;;;;2,0;;;;;;;;2,0;;;;;;;;;;;;;;;3,0;;;;;;1,0;;;1,0;;;;;;;;;;;;;6,0;3,0;;;;;;;;;;;3,0;;;;;;;;;;;;3,0;;;;;;;;;;1,0;;;;3,0;;2,0;;;;;;2,0;;;;;;;;;;;;;;;;2,0;;;;;;;;;;;1,0;;;3,0;;;;;;;;;;;;1,0;;;;2,0;;;;;;;;;;4,0;;;;;2,0;;;;;;;;;;;;2,0;;;;;;;;;;1,0;;;;;;;;;;;;;;;;
apparatus;2,0;6,0;55,0;14,0;;;93,0;136,0;57,0;298,0;21,0;14,0;9,0;9,0;85,0;40,0;11,0;10,0;61,0;100,0;52,0;969,0;29,0;84,0;224,0;1,0;20,0;371,0;42,0;222,0;113,0;131,0;483,0;37,0;206,0;2,0;17,0;279,0;14,0;614,0;45,0;8,0;101,0;113,0;19,0;4,0;;31,0;142,0;31,0;125,0;164,0;22,0;48,0;10,0;2220,0;610,0;8,0;66,0;804,0;12,0;29,0;547,0;14,0;15,0;112,0;78,0;5,0;3,0;152,0;283,0;19,0;62,0;12,0;2,0;18,0;4,0;91,0;229,0;89,0;6,0;626,0;160,0;14,0;9,0;9,0;78,0;6,0;20,0;103,0;184,0;16,0;43,0;375,0;59,0;25,0;4,0;83,0;90,0;32,0;129,0;343,0;1,0;28,0;5,0;7,0;57,0;736,0;5,0;;99,0;49,0;58,0;66,0;59,0;7,0;18,0;5,0;25,0;118,0;1,0;6,0;31,0;136,0;5,0;1,0;312,0;14,0;7,0;70,0;112,0;12,0;13,0;8,0;46,0;91,0;34,0;51,0;19,0;33,0;3,0;13,0;45,0;60,0;74,0;30,0;124,0;131,0;4,0;2,0;5,0;14,0;83,0;8,0;47,0;27,0;67,0;177,0;67,0;639,0;9,0;16,0;9,0;15,0;3,0;11,0;88,0;256,0;2,0;16,0;259,0;55,0;169,0;228,0;91,0;32,0;9,0;211,0;;;53,0;8,0;21,0;25,0;6,0;23,0;100,0;342,0;7,0;180,0;;4,0;12,0;191,0;6,0;13,0;5,0;7,0;62,0;31,0;22,0;45,0;8,0;52,0;2,0;8,0;365,0;50,0;59,0;146,0;45,0;15,0;8,0;60,0;59,0;84,0;84,0;13,0;5,0;30,0;12,0;40,0;71,0;18,0;9,0;12,0;24,0;;4,0;7,0;2,0;38,0;60,0;14,0;91,0;55,0;2,0;46,0;146,0;37,0;56,0;3,0;42,0;17,0;57,0;17,0;2,0;18,0;1,0;17,0;12,0;22,0;2,0;157,0;3,0;9,0;6,0;78,0;4,0;6,0;15,0;234,0;33,0;9,0;20,0;8,0;42,0;10,0;2,0;6,0;19,0;21,0;10,0;3,0;8,0;29,0;40,0;9,0;22,0;16,0;12,0;28,0;10,0;110,0;5,0;103,0;60,0;132,0;62,0;17,0;3,0;3,0;4,0;25,0;5,0;13,0;27,0;84,0;5,0;7,0;88,0;4,0;145,0;19,0;46,0;8,0;1,0;63,0;21,0;6,0;57,0;18,0;2,0;;24,0;10,0;15,0;2,0;28,0;26,0;5,0;66,0;28,0;21,0;;138,0;;32,0;36,0;7,0;104,0;16,0;13,0;20,0;5,0;5,0;1,0;21,0;5,0;12,0;;22,0;;9,0;48,0;14,0;14,0;10,0;14,0;70,0;22,0;30,0;23,0;7,0;;19,0;1,0;4,0;7,0;16,0;17,0;9,0;;5,0;31,0;33,0;2,0;;32,0;11,0;1,0;;1,0;54,0;54,0;113,0;14,0;37,0;;19,0;38,0;176,0;8,0;78,0;7,0;3,0;12,0;21,0;4,0;210,0;5,0;42,0;25,0;8,0;35,0;44,0;17,0;56,0;78,0;4,0;72,0;1,0;8,0;1,0;25,0;19,0;25,0;64,0;2,0;15,0;20,0;18,0;9,0;31,0;9,0;59,0;22,0;3,0;123,0;40,0;56,0;9,0;6,0;67,0;98,0;9,0;53,0;48,0;8,0;26,0;14,0;4,0;9,0;4,0;5,0;24,0;3,0;7,0;12,0;13,0;29,0;2,0;25,0;27,0;10,0;87,0;46,0;22,0;37,0;38,0;4,0;64,0;42,0;90,0;4,0;12,0;29,0;4,0;24,0;5,0;4,0;10,0;1,0;20,0;31,0;157,0;54,0;5,0;85,0;8,0;24,0;130,0;2,0;7,0;26,0;13,0;112,0;8,0;14,0;12,0;18,0;1,0;42,0;5,0;3,0;102,0;55,0;26,0;2,0;61,0;45,0;87,0;20,0;18,0;294,0;67,0;6,0;27,0;10,0;13,0;16,0;6,0;4,0;15,0;87,0;38,0;8,0;9,0;49,0;10,0;4,0;12,0;29,0;52,0;114,0;20,0;22,0;9,0;6,0;3,0;7,0;6,0;18,0;20,0;1,0;20,0;27,0;19,0;4,0;3,0;8,0;7,0;5,0;2,0;15,0;17,0;32,0;14,0;14,0;11,0;6,0;1,0;3,0;5,0;13,0;1,0;42,0;10,0;45,0;3,0;10,0;7,0;9,0;8,0;50,0;5,0;20,0;11,0;3,0;88,0;138,0;1,0;13,0;5,0;;9,0;44,0;27,0;;1,0;6,0;20,0;36,0;2,0;9,0;9,0;26,0;15,0;;8,0;2,0;15,0;34,0;4,0;3,0;180,0;7,0;5,0;26,0;7,0;31,0;5,0;47,0;10,0;11,0;5,0;4,0;5,0;9,0;7,0;7,0;19,0;83,0;1,0;3,0;;13,0;14,0;4,0;10,0;6,0;23,0;7,0;;17,0;4,0;48,0;4,0;8,0;5,0;7,0;10,0;3,0;18,0;8,0;8,0;1,0;14,0;47,0;2,0;;33,0;17,0;35,0;7,0;15,0;23,0;1,0;13,0;;9,0;12,0;4,0;3,0;;30,0;32,0;8,0;24,0;3,0;31,0;11,0;9,0;10,0;5,0;8,0;2,0;5,0;7,0;;41,0;2,0;8,0;3,0;5,0;15,0;106,0;7,0;14,0;5,0;11,0;;26,0;13,0;8,0;25,0;32,0;11,0;1,0;;3,0;;6,0;24,0;36,0;2,0;1,0;7,0;5,0;7,0;8,0;9,0;9,0;6,0;8,0;4,0;3,0;18,0;14,0;;14,0;5,0;1,0;12,0;10,0;6,0;7,0;1,0;8,0;46,0;6,0;7,0;3,0;14,0;1,0;3,0;13,0;1,0;2,0;65,0;17,0;2,0;;5,0;1,0;7,0;;1,0;16,0;1,0;8,0;12,0;15,0;4,0;;5,0;7,0;;6,0;2,0;6,0;3,0;1,0;14,0;1,0;67,0;6,0;28,0;10,0;3,0;3,0;33,0;8,0;8,0;1,0;10,0;30,0;19,0;8,0;17,0;45,0;35,0;17,0;2,0;24,0;1,0;2,0;6,0;8,0;8,0;31,0;9,0;5,0;4,0;3,0;61,0;30,0;8,0;14,0;6,0;5,0;4,0;2,0;15,0;11,0;5,0;10,0;10,0;1,0;3,0;;6,0;2,0;55,0;24,0;1,0;10,0;11,0;9,0;3,0;76,0;5,0;1,0;11,0;1,0;1,0;13,0;2,0;18,0;6,0;2,0;1,0;18,0;21,0;5,0;1,0;1,0;10,0;7,0;;6,0;1,0;19,0;14,0;;4,0;;;5,0;1,0;4,0;14,0;21,0;7,0;8,0;4,0;3,0;;29,0;10,0;5,0;6,0;6,0;25,0;10,0;15,0;;16,0;;10,0;5,0;;12,0;2,0;4,0;1,0;58,0;;18,0;2,0;33,0;29,0;2,0;21,0;5,0;3,0;22,0;3,0;52,0;4,0;9,0;2,0;23,0;7,0;19,0;4,0;20,0;1,0;;4,0;3,0;;1,0;5,0;6,0;3,0;;;1,0;;;1,0;7,0;5,0;3,0;9,0;12,0;1,0;3,0;11,0;99,0;7,0;2,0;4,0;2,0;1,0;2,0;9,0;2,0;6,0;14,0;11,0;;1,0;13,0;4,0;;;;;6,0;20,0;6,0;2,0;8,0;5,0;10,0;19,0;5,0;;6,0;9,0;;;3,0;8,0;19,0;;3,0;1,0;;1,0;11,0;7,0;8,0;3,0;2,0;8,0;;6,0;5,0;1,0;2,0;14,0;2,0;5,0;1,0;;;3,0;1,0;1,0;1,0;1,0;3,0;;3,0;10,0;1,0;6,0;4,0;10,0;2,0;1,0;9,0;4,0;6,0;1,0;19,0;5,0;3,0;7,0;2,0;3,0;3,0;3,0;4,0;3,0;1,0;1,0;9,0;1,0;;3,0;3,0;3,0;;;;
aspheric;3,0;;;;;;;;;;;;;;;;;2,0;9,0;;29,0;2,0;;;;;;;3,0;;;;1,0;;2,0;;1,0;;;;1,0;;;39,0;;;;1,0;;;;;;25,0;3,0;5,0;25,0;;;195,0;;;2,0;;;;;;;;8,0;6,0;;;;;;;;11,0;;;;;;;;;;;;;;;;;;;1,0;;142,0;10,0;;;;;;33,0;;;;1,0;;4,0;;;;;1,0;;;;;;;;;;;;;;;;1,0;;;;;;;;;10,0;1,0;;5,0;;;8,0;;;;;;;;;;4,0;;;;;;;;4,0;;1,0;;;3,0;;;;;;1,0;;;;;;;3,0;;1,0;;;;;;;;;14,0;;;;;11,0;;21,0;;;;;;;;;;;;;;;;;;1,0;;;;;;;;;;;;;;;;;;;;;;;;;;;;;;;;;15,0;;;;;;;;;;;;;;;;;9,0;;;;;;;;;;;;;;;;6,0;;14,0;;;;;;;;;;;;;;;;;;;;;;;;;;;;;;;;;;;;1,0;;;;;;;;;;;;;;;;;;;;;;;;;3,0;;;;;;;;;;;;3,0;;;;;;;;;;;;;;;;2,0;;;;;;;;;1,0;;;;;;;;;;;;;;;;;;;;14,0;;;;;;;;;;;;;;;;;;;;;;;;;;;;;;;;;;;;;;;;;;;;;;;;;;;;;;;;2,0;;;;;4,0;;;;;;;;;;;;;;;;;;;;;;;;;;;;;;;;;;;;2,0;;;;;;;;;;;;;;;;;;;;;;;;;;;;;;;;;;;;;;;;;;;;;;;;;;;;;;;;;;;;;;;;;;;;;;;;;;;;;;2,0;;;;;;;;;;;;;;2,0;;;;;;;;;;;;;;;;;;;;;;;;;;;;;;;;;;;;;;;;;;;;;;;;;;;;;;;1,0;;;;;;;;;;;;;;;;;;;;;;;;;;;;;;;;;;;;;;;;;;;;;;;;;;;;;;;;;;;;;;;;;;;;;;;;;;;;;;;;;;;;;;;;;;;;;;;;;20,0;;;;;;;;;;;;;;;;;4,0;;;;;;;;;;;;;;;;;;;;;;;;;;;;;;;;;;;;;;;;;;;;;;;;;;;;;;;;;;;;;;4,0;;;;;;;;;;;;;;;;;;;;;;;;;;;;;;;;;;;;;3,0;;;;;;;;;;;;;;;;;;;;;;;;;;;;;;;;;;;;;;;;;;;;;;;;;;;;;;;2,0;;;;;;;;;;;;;;;;;;;;;;;;;;;;;;;;;1,0;;;;;;;;;;;;;;;;;;;;;;;;;;;;;;;;;;;;;;;;;;;;;;;
axis;2,0;;44,0;;93,0;;;95,0;19,0;64,0;213,0;1,0;2,0;;3,0;1,0;20,0;5,0;39,0;5,0;63,0;127,0;33,0;27,0;60,0;;9,0;20,0;60,0;53,0;25,0;46,0;217,0;2,0;41,0;;18,0;1660,0;31,0;40,0;137,0;26,0;150,0;245,0;7,0;1,0;1,0;74,0;69,0;5,0;11,0;30,0;;244,0;26,0;433,0;130,0;;69,0;1801,0;25,0;23,0;76,0;2,0;2,0;63,0;149,0;6,0;2,0;26,0;3733,0;22,0;15,0;11,0;18,0;38,0;9,0;186,0;446,0;80,0;8,0;27,0;5,0;8,0;;36,0;19,0;12,0;26,0;23,0;175,0;26,0;19,0;22,0;19,0;52,0;3,0;5,0;20,0;16,0;248,0;415,0;;9,0;1,0;3,0;6,0;493,0;;;23,0;129,0;19,0;103,0;34,0;3,0;25,0;;16,0;135,0;1,0;12,0;24,0;16,0;2,0;2,0;118,0;21,0;;33,0;26,0;5,0;2,0;73,0;8,0;42,0;157,0;7,0;3,0;22,0;8,0;2,0;2,0;29,0;31,0;97,0;98,0;188,0;2,0;2,0;;21,0;95,0;10,0;50,0;57,0;50,0;63,0;31,0;196,0;54,0;18,0;27,0;11,0;19,0;4,0;3,0;236,0;;2,0;355,0;69,0;96,0;64,0;88,0;54,0;53,0;18,0;5,0;4,0;5,0;2,0;82,0;1,0;95,0;284,0;97,0;102,0;2,0;187,0;2,0;16,0;6,0;55,0;6,0;41,0;64,0;5,0;386,0;18,0;;45,0;5,0;133,0;11,0;9,0;41,0;38,0;39,0;145,0;4,0;3,0;1,0;5,0;152,0;47,0;25,0;2,0;4,0;13,0;7,0;21,0;35,0;4,0;22,0;4,0;18,0;;12,0;10,0;9,0;14,0;36,0;14,0;49,0;191,0;7,0;23,0;17,0;6,0;248,0;15,0;24,0;5,0;6,0;15,0;7,0;6,0;18,0;50,0;3,0;;;56,0;5,0;3,0;31,0;52,0;2,0;7,0;11,0;78,0;13,0;15,0;30,0;3,0;189,0;6,0;11,0;49,0;6,0;42,0;1,0;5,0;11,0;;;12,0;21,0;42,0;15,0;20,0;2,0;96,0;;33,0;339,0;73,0;13,0;17,0;9,0;197,0;11,0;5,0;5,0;579,0;;128,0;5,0;7,0;3,0;13,0;70,0;11,0;12,0;30,0;11,0;52,0;19,0;2,0;65,0;39,0;47,0;71,0;50,0;3,0;126,0;7,0;25,0;4,0;9,0;14,0;104,0;29,0;1,0;41,0;10,0;19,0;12,0;3,0;3,0;14,0;8,0;10,0;6,0;;4,0;11,0;6,0;11,0;26,0;25,0;;18,0;32,0;2,0;2,0;7,0;3,0;43,0;16,0;;5,0;14,0;;4,0;2,0;3,0;3,0;1,0;1,0;;14,0;;1,0;7,0;1,0;8,0;5,0;10,0;4,0;6,0;3,0;12,0;;4,0;7,0;;8,0;338,0;;36,0;;3,0;;7,0;8,0;8,0;1,0;5,0;1,0;18,0;227,0;10,0;20,0;5,0;3,0;15,0;;2,0;4,0;;;4,0;33,0;5,0;24,0;195,0;1,0;;106,0;21,0;11,0;;;;1,0;3,0;10,0;5,0;30,0;1,0;;33,0;8,0;2,0;4,0;;2,0;1,0;2,0;7,0;;;;1,0;;;;2,0;;;2,0;1,0;5,0;25,0;5,0;13,0;;47,0;;1,0;59,0;41,0;5,0;;;;5,0;;2,0;;;17,0;;26,0;236,0;;6,0;;2,0;26,0;3,0;;1,0;6,0;7,0;;;;;;;1,0;;286,0;5,0;1,0;1,0;21,0;;4,0;3,0;12,0;36,0;136,0;4,0;2,0;;;;1,0;;;85,0;7,0;;8,0;2,0;3,0;4,0;1,0;;3,0;7,0;3,0;10,0;;;;2,0;13,0;1,0;;;;3,0;4,0;;16,0;;;3,0;;;;26,0;2,0;;;;6,0;3,0;;1,0;;52,0;2,0;;11,0;8,0;2,0;1,0;4,0;5,0;4,0;2,0;;3,0;;6,0;;;;8,0;;162,0;;3,0;;28,0;;;;3,0;;1,0;;;2,0;;1,0;53,0;2,0;1,0;12,0;9,0;;;5,0;2,0;1,0;;5,0;5,0;6,0;2,0;;1,0;40,0;;1,0;5,0;7,0;11,0;;3,0;27,0;4,0;1,0;;5,0;10,0;;;1,0;13,0;9,0;;;;2,0;;16,0;8,0;;1,0;;9,0;;;14,0;20,0;16,0;70,0;2,0;80,0;1,0;18,0;5,0;1,0;1,0;9,0;2,0;39,0;;;1,0;10,0;;;;1,0;34,0;2,0;48,0;2,0;;40,0;28,0;19,0;1,0;;19,0;11,0;1,0;24,0;7,0;;8,0;;3,0;;24,0;89,0;2,0;;;;;;;2,0;2,0;9,0;;;2,0;;;;12,0;3,0;7,0;;2,0;;83,0;20,0;;37,0;;;4,0;1,0;1,0;1,0;;;6,0;;1,0;1,0;1,0;;;;4,0;;5,0;5,0;4,0;7,0;;;;;;;;7,0;;2,0;4,0;3,0;;;7,0;;;2,0;4,0;;2,0;2,0;14,0;11,0;2,0;62,0;2,0;4,0;15,0;;15,0;;1,0;2,0;5,0;5,0;5,0;2,0;;2,0;9,0;;20,0;;;;1,0;4,0;;25,0;12,0;9,0;21,0;1,0;21,0;6,0;1,0;;2,0;3,0;;;;1,0;;1,0;;;5,0;;2,0;;1,0;;;;;;;;13,0;;;6,0;1,0;9,0;;1,0;;;58,0;5,0;;;;22,0;1,0;1,0;;3,0;3,0;;3,0;;;13,0;4,0;3,0;33,0;7,0;15,0;;;;;1,0;4,0;;2,0;9,0;;1,0;;2,0;;;27,0;3,0;;;;;;1,0;1,0;10,0;10,0;7,0;2,0;14,0;28,0;14,0;;4,0;1,0;2,0;;1,0;;5,0;;4,0;;;;;27,0;3,0;;2,0;41,0;8,0;;2,0;7,0;3,0;;;1,0;;;2,0;;1,0;;;9,0;;38,0;2,0;2,0;3,0;;19,0;;;;2,0;;;;;8,0;11,0;;12,0;2,0;;3,0;5,0;;;3,0;2,0;10,0;;2,0;;1,0;;;;;1,0;5,0;;5,0;;2,0;;7,0;;;;7,0;1,0;4,0;;;;1,0;;3,0;;;17,0;88,0;24,0;;;9,0;;;2,0;;2,0;;7,0;4,0;5,0;;9,0;;4,0;;;;;;1,0;;;4,0;8,0;;;;;;;;;12,0;;;;
base;4,0;10,0;235,0;40,0;136,0;;95,0;;321,0;258,0;52,0;131,0;2,0;40,0;192,0;33,0;13,0;11,0;121,0;39,0;191,0;545,0;111,0;99,0;157,0;24,0;18,0;979,0;68,0;338,0;357,0;633,0;444,0;142,0;190,0;35,0;17,0;215,0;61,0;320,0;233,0;15,0;37,0;153,0;36,0;66,0;6,0;82,0;400,0;49,0;59,0;443,0;7,0;62,0;24,0;2938,0;367,0;15,0;95,0;606,0;24,0;26,0;371,0;13,0;38,0;55,0;178,0;17,0;13,0;203,0;148,0;18,0;42,0;29,0;15,0;44,0;31,0;303,0;828,0;48,0;17,0;179,0;63,0;21,0;46,0;;131,0;21,0;29,0;172,0;248,0;23,0;148,0;899,0;127,0;82,0;14,0;34,0;173,0;53,0;288,0;330,0;;34,0;13,0;17,0;52,0;710,0;7,0;;25,0;62,0;54,0;115,0;216,0;35,0;6,0;2,0;56,0;91,0;4,0;10,0;39,0;69,0;12,0;5,0;125,0;55,0;65,0;165,0;149,0;29,0;8,0;15,0;17,0;32,0;105,0;;16,0;33,0;30,0;21,0;56,0;178,0;105,0;17,0;190,0;291,0;14,0;3,0;9,0;52,0;50,0;;34,0;46,0;57,0;162,0;43,0;257,0;4,0;12,0;70,0;11,0;13,0;61,0;134,0;344,0;9,0;22,0;402,0;11,0;284,0;427,0;165,0;89,0;59,0;410,0;4,0;2,0;21,0;6,0;24,0;9,0;31,0;91,0;356,0;430,0;8,0;409,0;4,0;29,0;23,0;275,0;20,0;16,0;5,0;2,0;76,0;77,0;7,0;80,0;5,0;211,0;8,0;15,0;9,0;5,0;72,0;289,0;26,0;26,0;16,0;3,0;34,0;211,0;69,0;52,0;7,0;5,0;77,0;65,0;27,0;22,0;94,0;11,0;44,0;1,0;;2,0;11,0;14,0;30,0;39,0;110,0;131,0;15,0;49,0;241,0;26,0;78,0;;33,0;65,0;14,0;46,0;25,0;52,0;3,0;74,0;11,0;77,0;11,0;242,0;5,0;5,0;31,0;114,0;16,0;6,0;15,0;109,0;79,0;17,0;85,0;33,0;165,0;26,0;19,0;21,0;3,0;57,0;3,0;14,0;33,0;26,0;18,0;11,0;42,0;63,0;40,0;29,0;16,0;90,0;11,0;217,0;74,0;542,0;14,0;23,0;7,0;5,0;28,0;36,0;4,0;31,0;32,0;187,0;11,0;7,0;36,0;25,0;145,0;55,0;22,0;13,0;10,0;122,0;55,0;27,0;172,0;67,0;8,0;1,0;38,0;10,0;23,0;3,0;18,0;4,0;37,0;55,0;82,0;32,0;2,0;42,0;5,0;13,0;20,0;5,0;172,0;9,0;15,0;26,0;5,0;12,0;1,0;3,0;6,0;62,0;3,0;83,0;8,0;6,0;88,0;13,0;61,0;17,0;21,0;156,0;28,0;69,0;106,0;9,0;25,0;8,0;20,0;9,0;22,0;2,0;70,0;14,0;3,0;5,0;89,0;28,0;22,0;13,0;17,0;33,0;18,0;5,0;16,0;127,0;37,0;58,0;30,0;26,0;;46,0;31,0;74,0;11,0;21,0;32,0;55,0;29,0;34,0;5,0;82,0;5,0;25,0;17,0;13,0;85,0;96,0;20,0;200,0;45,0;13,0;88,0;5,0;6,0;26,0;116,0;37,0;42,0;69,0;26,0;11,0;38,0;17,0;47,0;32,0;8,0;59,0;132,0;1,0;195,0;16,0;172,0;7,0;13,0;35,0;101,0;17,0;16,0;73,0;30,0;86,0;24,0;19,0;14,0;4,0;3,0;11,0;25,0;9,0;19,0;15,0;3,0;28,0;15,0;4,0;16,0;33,0;75,0;20,0;20,0;13,0;7,0;31,0;132,0;61,0;5,0;12,0;32,0;15,0;64,0;6,0;13,0;8,0;9,0;27,0;16,0;52,0;40,0;2,0;303,0;1,0;4,0;144,0;;9,0;5,0;47,0;44,0;9,0;41,0;75,0;16,0;22,0;15,0;;5,0;104,0;57,0;19,0;3,0;107,0;17,0;41,0;48,0;26,0;247,0;168,0;7,0;29,0;8,0;3,0;19,0;48,0;7,0;15,0;55,0;48,0;16,0;;4,0;15,0;49,0;;2,0;46,0;52,0;69,0;22,0;33,0;7,0;15,0;10,0;29,0;49,0;30,0;1,0;63,0;26,0;;;4,0;5,0;56,0;21,0;10,0;24,0;23,0;7,0;21,0;2,0;10,0;4,0;24,0;;33,0;14,0;;41,0;7,0;5,0;2,0;20,0;17,0;9,0;18,0;83,0;4,0;11,0;3,0;6,0;55,0;383,0;13,0;3,0;8,0;19,0;19,0;191,0;5,0;4,0;1,0;7,0;7,0;34,0;3,0;108,0;;43,0;4,0;5,0;81,0;;6,0;194,0;13,0;9,0;32,0;19,0;5,0;18,0;45,0;28,0;10,0;5,0;15,0;11,0;46,0;3,0;1,0;5,0;5,0;4,0;;174,0;6,0;23,0;7,0;5,0;40,0;;1,0;32,0;37,0;2,0;1,0;5,0;4,0;32,0;2,0;3,0;18,0;4,0;8,0;23,0;13,0;3,0;5,0;3,0;3,0;21,0;18,0;1,0;27,0;29,0;159,0;38,0;2,0;22,0;19,0;39,0;;13,0;20,0;5,0;;3,0;17,0;9,0;14,0;22,0;9,0;65,0;22,0;7,0;23,0;9,0;6,0;17,0;10,0;44,0;19,0;59,0;2,0;6,0;7,0;3,0;2,0;22,0;;10,0;11,0;6,0;;14,0;7,0;59,0;11,0;1,0;40,0;3,0;22,0;1,0;20,0;92,0;96,0;65,0;5,0;;4,0;15,0;2,0;;28,0;1,0;5,0;74,0;5,0;;53,0;16,0;15,0;22,0;10,0;3,0;13,0;24,0;13,0;;14,0;5,0;93,0;5,0;9,0;4,0;27,0;7,0;15,0;12,0;7,0;21,0;2,0;7,0;2,0;3,0;5,0;;3,0;10,0;8,0;2,0;5,0;10,0;30,0;29,0;10,0;11,0;12,0;7,0;2,0;;27,0;36,0;10,0;4,0;42,0;22,0;8,0;76,0;9,0;13,0;26,0;;31,0;;23,0;5,0;23,0;79,0;22,0;21,0;15,0;10,0;8,0;16,0;21,0;116,0;7,0;6,0;5,0;19,0;;71,0;5,0;7,0;4,0;15,0;113,0;53,0;4,0;8,0;12,0;17,0;9,0;61,0;33,0;26,0;6,0;20,0;35,0;1,0;2,0;11,0;1,0;23,0;28,0;22,0;11,0;3,0;17,0;8,0;28,0;14,0;21,0;;7,0;19,0;10,0;;3,0;42,0;4,0;17,0;4,0;;31,0;27,0;;29,0;1,0;6,0;;16,0;8,0;32,0;2,0;13,0;6,0;12,0;;18,0;9,0;14,0;9,0;83,0;;3,0;1,0;16,0;3,0;24,0;2,0;;11,0;22,0;14,0;3,0;13,0;;4,0;;7,0;1,0;27,0;12,0;2,0;28,0;25,0;42,0;;10,0;4,0;58,0;4,0;12,0;18,0;;3,0;9,0;1,0;10,0;15,0;3,0;;14,0;;11,0;10,0;60,0;1,0;10,0;6,0;;4,0;;61,0;28,0;;1,0;;7,0;2,0;;6,0;10,0;7,0;28,0;5,0;8,0;8,0;6,0;7,0;9,0;22,0;6,0;17,0;2,0;;46,0;2,0;5,0;2,0;4,0;10,0;;26,0;30,0;11,0;2,0;;1,0;3,0;14,0;13,0;1,0;15,0;11,0;15,0;11,0;16,0;1,0;24,0;18,0;1,0;2,0;6,0;1,0;;19,0;;1,0;11,0;;;12,0;27,0;;12,0;17,0;3,0;;3,0;9,0;3,0;10,0;8,0;;24,0;4,0;;2,0;5,0;4,0;2,0;;4,0;4,0;;;2,0;8,0;12,0;6,0;4,0;13,0;3,0;3,0;1,0;8,0;3,0;16,0;12,0;12,0;17,0;5,0;8,0;3,0;;2,0;2,0;1,0;5,0;10,0;;1,0;;7,0;10,0;;1,0;;
calculate;2,0;;265,0;4,0;57,0;;19,0;321,0;;44,0;28,0;59,0;;52,0;72,0;32,0;16,0;17,0;58,0;25,0;7,0;149,0;67,0;58,0;99,0;17,0;16,0;157,0;13,0;51,0;56,0;80,0;223,0;196,0;66,0;3,0;13,0;104,0;44,0;29,0;189,0;7,0;22,0;11,0;20,0;117,0;3,0;39,0;159,0;26,0;46,0;44,0;5,0;16,0;36,0;666,0;99,0;6,0;62,0;82,0;6,0;12,0;183,0;11,0;2,0;32,0;30,0;7,0;2,0;27,0;35,0;6,0;;;;6,0;;163,0;300,0;2,0;1,0;62,0;39,0;2,0;29,0;;83,0;1,0;22,0;32,0;36,0;15,0;11,0;141,0;12,0;9,0;1,0;18,0;48,0;2,0;8,0;95,0;;2,0;1,0;2,0;1,0;478,0;;;6,0;7,0;9,0;1,0;3,0;34,0;;2,0;1,0;11,0;;;3,0;59,0;9,0;;113,0;;22,0;2,0;;4,0;;;;23,0;;;;19,0;4,0;1,0;2,0;18,0;17,0;3,0;;102,0;;;3,0;;4,0;;3,0;;;2,0;5,0;78,0;6,0;7,0;3,0;2,0;7,0;;118,0;47,0;3,0;;5,0;;51,0;;96,0;;;121,0;;;;;2,0;8,0;;26,0;;77,0;2,0;31,0;;;;13,0;;3,0;;;19,0;;;12,0;2,0;4,0;;5,0;1,0;1,0;2,0;;14,0;;6,0;;36,0;207,0;3,0;;2,0;;2,0;21,0;18,0;;1,0;;12,0;;4,0;;;;2,0;7,0;40,0;177,0;;23,0;41,0;4,0;;2,0;55,0;;;5,0;3,0;;;;5,0;2,0;;9,0;;4,0;;13,0;5,0;;2,0;18,0;29,0;;;;;;;;;3,0;2,0;1,0;;7,0;3,0;;8,0;5,0;;;;3,0;;125,0;23,0;162,0;4,0;;;;1,0;17,0;;9,0;;50,0;3,0;;1,0;;94,0;13,0;13,0;;;68,0;;;118,0;41,0;;;;;;;;;;18,0;;;;8,0;;;2,0;9,0;12,0;7,0;2,0;4,0;1,0;6,0;2,0;8,0;6,0;7,0;;10,0;2,0;27,0;27,0;;309,0;1,0;;21,0;1,0;24,0;12,0;;1,0;6,0;3,0;28,0;;;20,0;8,0;;2,0;14,0;19,0;5,0;1,0;98,0;57,0;5,0;;9,0;27,0;17,0;21,0;6,0;17,0;;5,0;15,0;9,0;5,0;7,0;12,0;52,0;23,0;83,0;1,0;10,0;;11,0;4,0;;10,0;18,0;17,0;73,0;28,0;21,0;27,0;;1,0;93,0;175,0;28,0;4,0;30,0;;;1,0;;;5,0;;10,0;27,0;1,0;50,0;4,0;73,0;2,0;;38,0;15,0;;2,0;7,0;4,0;15,0;5,0;6,0;;;;;1,0;3,0;2,0;1,0;;5,0;;5,0;;23,0;32,0;5,0;3,0;;1,0;11,0;124,0;28,0;;;6,0;3,0;16,0;;2,0;;;39,0;;5,0;8,0;;139,0;;4,0;27,0;;;;8,0;;;5,0;8,0;10,0;3,0;1,0;2,0;1,0;2,0;3,0;2,0;1,0;16,0;;2,0;23,0;3,0;19,0;54,0;;41,0;1,0;;3,0;2,0;20,0;2,0;15,0;;1,0;1,0;;;;;;15,0;;;2,0;;;1,0;;3,0;24,0;;1,0;20,0;1,0;;8,0;;3,0;3,0;;;;66,0;;;;2,0;;8,0;2,0;;;1,0;;1,0;1,0;;17,0;2,0;;1,0;;;8,0;;;15,0;232,0;;;2,0;;8,0;65,0;;;;;;4,0;;;;;2,0;;;;2,0;45,0;7,0;4,0;3,0;;;11,0;1,0;;;;;2,0;4,0;3,0;;3,0;2,0;;;187,0;;;1,0;;6,0;;;;9,0;;;;;;;;10,0;;;10,0;;;;;;1,0;;5,0;;3,0;33,0;;2,0;2,0;;;;2,0;5,0;;;;;10,0;;9,0;;38,0;;;;;;;;17,0;;35,0;;;4,0;;4,0;5,0;;;5,0;8,0;;;;32,0;;;29,0;;;;;183,0;71,0;44,0;;;5,0;;;;1,0;6,0;7,0;28,0;;;33,0;1,0;3,0;10,0;11,0;13,0;4,0;14,0;;;;;16,0;;41,0;2,0;3,0;;;;;1,0;;;5,0;;1,0;;;;11,0;;3,0;6,0;;17,0;1,0;10,0;;;36,0;1,0;9,0;14,0;8,0;1,0;25,0;5,0;2,0;23,0;9,0;7,0;28,0;;;;4,0;15,0;18,0;40,0;3,0;12,0;;;1,0;2,0;;10,0;1,0;4,0;;6,0;4,0;8,0;1,0;5,0;;3,0;3,0;157,0;;;1,0;;;24,0;3,0;;2,0;5,0;2,0;;;1,0;2,0;;;;;;1,0;6,0;5,0;4,0;;;3,0;;;;;16,0;;;;28,0;4,0;;;3,0;;11,0;;;2,0;9,0;;;4,0;;;8,0;;3,0;1,0;22,0;;;;;;4,0;2,0;;3,0;1,0;1,0;;4,0;;8,0;2,0;1,0;;;2,0;;37,0;;;1,0;4,0;3,0;7,0;5,0;4,0;;;;;;;;;;10,0;;;2,0;4,0;;4,0;1,0;;;;;;;;;;;;;2,0;4,0;4,0;;;;;1,0;;;;;;1,0;;;5,0;;;1,0;;2,0;;;;;;;3,0;12,0;1,0;3,0;;;3,0;;1,0;;1,0;;;2,0;;;5,0;;;;;3,0;1,0;38,0;;17,0;;;;;;;;;;2,0;1,0;;1,0;;7,0;;;4,0;;;;9,0;;7,0;1,0;9,0;4,0;;;;34,0;6,0;5,0;;3,0;11,0;5,0;4,0;;;;;;16,0;;;7,0;1,0;20,0;2,0;;;;
capture;1,0;2,0;49,0;23,0;298,0;;64,0;258,0;44,0;;43,0;90,0;;7,0;151,0;37,0;14,0;16,0;90,0;68,0;98,0;320,0;23,0;112,0;63,0;1,0;3,0;939,0;19,0;124,0;24,0;291,0;1664,0;51,0;555,0;14,0;19,0;90,0;7,0;463,0;59,0;23,0;39,0;327,0;9,0;43,0;;23,0;97,0;4,0;66,0;209,0;10,0;19,0;2,0;9219,0;521,0;9,0;19,0;380,0;16,0;7,0;608,0;2,0;10,0;6,0;126,0;4,0;23,0;113,0;209,0;55,0;39,0;3,0;;67,0;;115,0;274,0;13,0;12,0;158,0;134,0;62,0;6,0;10,0;136,0;11,0;31,0;132,0;456,0;35,0;12,0;308,0;10,0;14,0;10,0;81,0;259,0;42,0;226,0;526,0;;65,0;11,0;31,0;15,0;866,0;1,0;1,0;71,0;40,0;105,0;63,0;29,0;14,0;;10,0;59,0;61,0;1,0;;20,0;134,0;4,0;9,0;343,0;14,0;32,0;66,0;18,0;21,0;1,0;;3,0;19,0;38,0;;3,0;15,0;2,0;29,0;41,0;64,0;27,0;;128,0;452,0;11,0;1,0;19,0;;9,0;1,0;20,0;23,0;1,0;96,0;55,0;416,0;;41,0;8,0;13,0;26,0;4,0;53,0;185,0;5,0;5,0;15,0;17,0;315,0;67,0;79,0;67,0;4,0;191,0;1,0;2,0;2,0;13,0;21,0;4,0;;57,0;3,0;529,0;2,0;241,0;1,0;;5,0;246,0;1,0;44,0;;;35,0;2,0;2,0;8,0;5,0;29,0;2,0;16,0;58,0;11,0;19,0;38,0;26,0;17,0;33,0;1,0;16,0;314,0;101,0;13,0;;1,0;4,0;57,0;6,0;45,0;10,0;20,0;16,0;;;1,0;;5,0;2,0;14,0;111,0;81,0;;44,0;383,0;15,0;10,0;;11,0;10,0;4,0;11,0;27,0;26,0;;1,0;11,0;9,0;;46,0;10,0;2,0;6,0;65,0;10,0;;18,0;29,0;17,0;;15,0;;33,0;;;20,0;8,0;12,0;;15,0;1,0;53,0;16,0;;9,0;30,0;12,0;3,0;7,0;46,0;1,0;126,0;7,0;561,0;25,0;;16,0;;38,0;66,0;;12,0;1,0;60,0;4,0;;40,0;3,0;121,0;25,0;32,0;;;97,0;6,0;;109,0;52,0;3,0;;;;3,0;;;;;23,0;1,0;;2,0;59,0;1,0;;3,0;;159,0;2,0;5,0;1,0;;2,0;3,0;15,0;2,0;11,0;12,0;93,0;6,0;23,0;65,0;14,0;7,0;16,0;1,0;70,0;20,0;28,0;48,0;;5,0;9,0;5,0;4,0;;1,0;24,0;16,0;2,0;;92,0;43,0;12,0;14,0;49,0;23,0;69,0;1,0;;36,0;40,0;128,0;36,0;8,0;;21,0;95,0;97,0;4,0;16,0;3,0;5,0;12,0;19,0;8,0;170,0;15,0;71,0;5,0;3,0;64,0;5,0;136,0;126,0;37,0;1,0;31,0;;22,0;4,0;5,0;1,0;30,0;61,0;6,0;13,0;19,0;31,0;1,0;46,0;14,0;94,0;56,0;1,0;104,0;5,0;78,0;14,0;8,0;60,0;214,0;30,0;20,0;28,0;44,0;287,0;74,0;19,0;10,0;10,0;12,0;15,0;8,0;19,0;50,0;7,0;28,0;3,0;8,0;5,0;44,0;77,0;10,0;32,0;17,0;11,0;;17,0;158,0;140,0;;19,0;30,0;12,0;124,0;9,0;5,0;3,0;45,0;6,0;33,0;105,0;11,0;10,0;140,0;7,0;1,0;120,0;15,0;;1,0;7,0;61,0;3,0;6,0;31,0;13,0;15,0;10,0;30,0;5,0;31,0;69,0;33,0;1,0;148,0;13,0;33,0;44,0;7,0;793,0;235,0;23,0;4,0;10,0;7,0;3,0;;15,0;52,0;31,0;2,0;8,0;;17,0;;3,0;;6,0;35,0;47,0;14,0;1,0;23,0;;5,0;;38,0;7,0;19,0;5,0;13,0;45,0;6,0;19,0;8,0;3,0;11,0;15,0;3,0;24,0;14,0;;21,0;35,0;12,0;1,0;27,0;52,0;3,0;2,0;2,0;6,0;2,0;5,0;45,0;15,0;38,0;;43,0;36,0;;91,0;24,0;19,0;98,0;209,0;8,0;26,0;;;8,0;72,0;;1,0;25,0;3,0;9,0;24,0;4,0;;2,0;6,0;5,0;;30,0;4,0;40,0;453,0;39,0;24,0;15,0;;5,0;23,0;41,0;35,0;;;35,0;5,0;14,0;;;3,0;5,0;6,0;;216,0;;1,0;1,0;6,0;4,0;;9,0;;4,0;2,0;16,0;3,0;5,0;28,0;2,0;;13,0;;;32,0;27,0;7,0;;1,0;;27,0;;;;3,0;57,0;1,0;2,0;8,0;4,0;7,0;1,0;13,0;7,0;;1,0;;6,0;5,0;2,0;4,0;6,0;18,0;11,0;2,0;;;;;;11,0;21,0;30,0;1,0;;2,0;9,0;6,0;19,0;;;2,0;24,0;;2,0;;8,0;14,0;10,0;7,0;4,0;10,0;;;13,0;24,0;33,0;;;77,0;;;1,0;8,0;3,0;2,0;5,0;;;12,0;55,0;11,0;45,0;4,0;;5,0;17,0;11,0;;11,0;6,0;76,0;7,0;8,0;7,0;16,0;18,0;18,0;;26,0;3,0;;1,0;8,0;;24,0;15,0;6,0;20,0;48,0;1,0;;30,0;6,0;41,0;32,0;;5,0;2,0;3,0;10,0;;23,0;14,0;8,0;2,0;14,0;7,0;3,0;11,0;11,0;1,0;1,0;4,0;5,0;5,0;1,0;10,0;11,0;14,0;8,0;9,0;2,0;6,0;12,0;1,0;16,0;2,0;;9,0;3,0;6,0;30,0;1,0;2,0;2,0;10,0;18,0;38,0;10,0;1,0;1,0;5,0;28,0;;37,0;4,0;9,0;21,0;12,0;;;3,0;;1,0;10,0;4,0;38,0;1,0;1,0;;4,0;16,0;6,0;;4,0;54,0;12,0;13,0;11,0;18,0;1,0;2,0;7,0;5,0;70,0;;2,0;7,0;;6,0;;;14,0;23,0;29,0;13,0;9,0;;;50,0;12,0;29,0;14,0;5,0;8,0;1,0;;17,0;1,0;18,0;3,0;;1,0;33,0;7,0;8,0;4,0;5,0;7,0;;;2,0;;17,0;7,0;23,0;;21,0;1,0;17,0;1,0;1,0;;;;4,0;16,0;4,0;;13,0;;2,0;3,0;15,0;;;10,0;11,0;;;2,0;;;22,0;1,0;1,0;8,0;2,0;5,0;2,0;8,0;;;4,0;6,0;12,0;11,0;13,0;2,0;1,0;2,0;9,0;;;;;;;2,0;5,0;2,0;14,0;;1,0;12,0;14,0;38,0;;;2,0;;21,0;8,0;3,0;;1,0;47,0;1,0;5,0;;;8,0;10,0;9,0;7,0;21,0;4,0;17,0;;;3,0;;;8,0;6,0;;10,0;17,0;13,0;;16,0;;5,0;;14,0;1,0;4,0;8,0;;;1,0;4,0;1,0;2,0;;2,0;;;4,0;4,0;;3,0;6,0;;3,0;;;35,0;2,0;;;3,0;5,0;;1,0;;;2,0;3,0;1,0;;10,0;;4,0;;2,0;;;;;
center;2,0;1,0;31,0;;21,0;;213,0;52,0;28,0;43,0;;;8,0;6,0;38,0;1,0;5,0;;13,0;11,0;17,0;32,0;50,0;45,0;29,0;;4,0;28,0;10,0;22,0;75,0;83,0;99,0;9,0;13,0;6,0;1,0;87,0;10,0;78,0;160,0;7,0;15,0;76,0;;;4,0;8,0;7,0;1,0;19,0;4,0;;26,0;1,0;384,0;40,0;;15,0;211,0;10,0;3,0;55,0;;12,0;17,0;47,0;3,0;2,0;3,0;177,0;2,0;4,0;3,0;32,0;6,0;;172,0;245,0;6,0;2,0;26,0;;1,0;;1,0;105,0;9,0;4,0;13,0;41,0;20,0;2,0;23,0;6,0;7,0;1,0;10,0;15,0;1,0;67,0;77,0;;4,0;;;;163,0;;;9,0;23,0;13,0;13,0;12,0;1,0;;;1,0;9,0;1,0;5,0;1,0;7,0;;;15,0;1,0;;26,0;10,0;1,0;;7,0;;10,0;25,0;1,0;9,0;8,0;;1,0;;47,0;10,0;7,0;53,0;105,0;;4,0;;12,0;12,0;;6,0;7,0;74,0;24,0;4,0;29,0;5,0;19,0;14,0;10,0;20,0;14,0;7,0;46,0;2,0;9,0;36,0;13,0;26,0;57,0;22,0;19,0;29,0;7,0;;;2,0;2,0;75,0;1,0;12,0;29,0;33,0;51,0;;100,0;;8,0;2,0;40,0;11,0;3,0;1,0;;147,0;1,0;;17,0;;16,0;;2,0;4,0;18,0;11,0;26,0;2,0;4,0;1,0;2,0;62,0;17,0;16,0;;2,0;17,0;11,0;9,0;19,0;1,0;1,0;7,0;26,0;;3,0;1,0;2,0;;4,0;10,0;11,0;35,0;2,0;2,0;132,0;2,0;10,0;4,0;15,0;5,0;4,0;7,0;15,0;;17,0;18,0;;;;17,0;;1,0;6,0;23,0;1,0;12,0;1,0;31,0;40,0;3,0;7,0;1,0;20,0;;1,0;3,0;;18,0;1,0;3,0;2,0;3,0;;6,0;3,0;52,0;3,0;8,0;1,0;5,0;2,0;30,0;16,0;53,0;6,0;8,0;;;1,0;9,0;;5,0;2,0;17,0;;3,0;2,0;8,0;47,0;19,0;5,0;;;31,0;;1,0;42,0;19,0;3,0;;96,0;;8,0;3,0;3,0;;3,0;4,0;40,0;2,0;;7,0;;3,0;;;21,0;;4,0;;;;;7,0;1,0;2,0;3,0;1,0;;4,0;8,0;;9,0;4,0;2,0;26,0;14,0;2,0;13,0;;;;4,0;;9,0;;7,0;;1,0;1,0;30,0;1,0;;1,0;1,0;6,0;1,0;4,0;;20,0;;1,0;3,0;;4,0;28,0;;14,0;3,0;1,0;;;;11,0;;7,0;1,0;6,0;29,0;1,0;20,0;;2,0;19,0;;;2,0;1,0;1,0;2,0;35,0;;12,0;6,0;;;40,0;2,0;;8,0;;;8,0;;26,0;;27,0;1,0;;3,0;2,0;;1,0;;;;1,0;14,0;;;;3,0;;11,0;;;;;;1,0;2,0;1,0;1,0;;6,0;4,0;;1,0;45,0;2,0;1,0;2,0;;1,0;1,0;;;;1,0;3,0;2,0;17,0;12,0;2,0;16,0;;;11,0;18,0;;1,0;20,0;1,0;;;1,0;1,0;;;;;36,0;31,0;3,0;;18,0;1,0;2,0;8,0;2,0;11,0;88,0;;1,0;;;6,0;;;;93,0;1,0;;12,0;;4,0;;;;3,0;1,0;;1,0;;1,0;9,0;;1,0;5,0;7,0;;;1,0;;;;;1,0;;;2,0;;3,0;5,0;;;;;;14,0;2,0;4,0;22,0;2,0;3,0;1,0;3,0;;;;12,0;3,0;4,0;3,0;;10,0;73,0;;;;;1,0;19,0;3,0;;;5,0;3,0;26,0;2,0;;10,0;;;;5,0;;;11,0;;;3,0;1,0;;;4,0;;;;2,0;2,0;2,0;;;;3,0;2,0;;5,0;;1,0;;1,0;2,0;12,0;;;3,0;1,0;12,0;1,0;;41,0;;;4,0;;;;4,0;;;1,0;;5,0;;;6,0;22,0;5,0;5,0;1,0;7,0;30,0;7,0;1,0;5,0;;;1,0;;;;;16,0;1,0;11,0;9,0;;6,0;7,0;;7,0;1,0;14,0;1,0;4,0;;;11,0;5,0;;1,0;;1,0;6,0;;;1,0;68,0;21,0;;;9,0;;;;;12,0;5,0;6,0;;;2,0;;;;7,0;;;3,0;;;22,0;8,0;;3,0;;;;1,0;3,0;3,0;;;3,0;1,0;4,0;3,0;6,0;2,0;;;1,0;;5,0;;1,0;11,0;;1,0;2,0;;;;;;;3,0;;;;29,0;4,0;;;;;2,0;11,0;2,0;;;6,0;16,0;;;2,0;4,0;16,0;;;;1,0;6,0;1,0;;8,0;3,0;;2,0;;3,0;;;;10,0;;;3,0;5,0;38,0;2,0;5,0;;;;;;2,0;3,0;;3,0;2,0;;;;;;1,0;;7,0;;1,0;;2,0;1,0;;;3,0;;;;;17,0;;;;2,0;7,0;3,0;;;;29,0;;4,0;5,0;2,0;;;1,0;1,0;;3,0;1,0;5,0;11,0;5,0;;;;;;;;;;4,0;;;1,0;;;1,0;6,0;2,0;;3,0;;3,0;;1,0;2,0;5,0;31,0;;;;4,0;2,0;1,0;23,0;;1,0;;1,0;;;;2,0;;18,0;;1,0;;2,0;;;10,0;4,0;;;;6,0;;;1,0;;;10,0;;;;;;;7,0;;;;3,0;2,0;;;4,0;;1,0;;4,0;;11,0;5,0;;2,0;;;1,0;;;;;;1,0;;;;4,0;;;;;;2,0;;;;16,0;;2,0;;;;8,0;;;2,0;;1,0;;;12,0;4,0;;;3,0;17,0;2,0;;;;;1,0;;;5,0;5,0;3,0;;;2,0;;33,0;4,0;;;4,0;;1,0;10,0;;3,0;;;;;;9,0;;2,0;;3,0;;;;
characteristic;8,0;;79,0;;14,0;;1,0;131,0;59,0;90,0;;;;;145,0;;;6,0;11,0;14,0;14,0;25,0;47,0;27,0;55,0;4,0;13,0;98,0;1,0;39,0;39,0;95,0;75,0;47,0;36,0;3,0;3,0;8,0;1,0;17,0;4,0;;2,0;7,0;;;;17,0;14,0;64,0;18,0;20,0;11,0;33,0;6,0;512,0;67,0;;13,0;108,0;;;96,0;;10,0;6,0;14,0;1,0;1,0;6,0;59,0;10,0;7,0;;;19,0;;11,0;44,0;12,0;2,0;18,0;22,0;1,0;31,0;;2,0;6,0;19,0;50,0;32,0;2,0;;42,0;15,0;;;7,0;45,0;1,0;14,0;56,0;4,0;7,0;4,0;;4,0;167,0;2,0;;5,0;3,0;18,0;;;1,0;;5,0;;11,0;;;7,0;3,0;;;25,0;;;1,0;;13,0;;;1,0;;8,0;;;9,0;1,0;23,0;3,0;4,0;64,0;;9,0;7,0;2,0;1,0;6,0;;;1,0;;1,0;;1,0;14,0;47,0;2,0;2,0;;;;;12,0;107,0;9,0;6,0;3,0;16,0;6,0;6,0;1,0;;;52,0;2,0;;;;4,0;16,0;;;6,0;42,0;;22,0;;;1,0;36,0;;1,0;1,0;4,0;;;;9,0;3,0;2,0;;8,0;;;2,0;1,0;2,0;2,0;26,0;;;25,0;18,0;1,0;;2,0;;17,0;23,0;6,0;;5,0;8,0;;;;;;10,0;;68,0;;;3,0;20,0;1,0;;;;;;;4,0;1,0;;;;1,0;;2,0;6,0;;;13,0;1,0;;;2,0;10,0;;;;;;;;;;;1,0;1,0;3,0;;;;;;;2,0;1,0;;1,0;1,0;99,0;10,0;;2,0;;4,0;24,0;;;;21,0;;;;;23,0;;4,0;2,0;;24,0;;;90,0;7,0;1,0;3,0;;;;;;;;18,0;;;6,0;22,0;;5,0;1,0;;41,0;16,0;;1,0;;2,0;4,0;;;;;38,0;;16,0;;;7,0;;;28,0;16,0;1,0;6,0;3,0;;2,0;4,0;;;;3,0;14,0;;20,0;12,0;41,0;;27,0;6,0;4,0;3,0;;;16,0;5,0;14,0;;3,0;;8,0;4,0;4,0;4,0;4,0;9,0;;;3,0;4,0;1,0;;24,0;;;;75,0;1,0;29,0;12,0;;;;1,0;4,0;1,0;2,0;;3,0;;6,0;2,0;6,0;;5,0;2,0;10,0;4,0;;8,0;4,0;6,0;;;3,0;13,0;;4,0;9,0;2,0;12,0;2,0;8,0;;4,0;;;;;;7,0;;9,0;;;3,0;2,0;89,0;7,0;;;;22,0;1,0;46,0;1,0;;3,0;;1,0;;2,0;;;;;;;;39,0;;;26,0;;;;;;;;2,0;9,0;5,0;;4,0;9,0;;1,0;4,0;3,0;26,0;;2,0;8,0;1,0;27,0;6,0;;17,0;;;2,0;;3,0;11,0;2,0;1,0;2,0;;;;;;;2,0;13,0;;2,0;;;;1,0;;28,0;2,0;1,0;7,0;1,0;;4,0;;1,0;;;;2,0;;;4,0;;;;;;;;5,0;;2,0;2,0;;22,0;2,0;;;;;3,0;;1,0;21,0;47,0;9,0;2,0;;;;2,0;2,0;;;;;2,0;;;;;4,0;1,0;;;6,0;2,0;;;;;;;4,0;;;;10,0;2,0;;;;31,0;;;;16,0;;;;14,0;;;;;1,0;;;;;1,0;1,0;;1,0;1,0;;44,0;1,0;;;;;3,0;;;;1,0;5,0;4,0;;6,0;;;;;;;;;;;2,0;;4,0;24,0;;;;;;1,0;;;;4,0;;;;;;;;;;2,0;;;;;2,0;;8,0;;12,0;;;;12,0;8,0;;;;;1,0;11,0;1,0;1,0;2,0;2,0;;;;;1,0;;3,0;;;14,0;;;1,0;2,0;9,0;;;;;;1,0;;;;;;1,0;;;;9,0;;;;;;;44,0;;1,0;1,0;;1,0;;;6,0;;;2,0;15,0;3,0;13,0;3,0;3,0;1,0;;;;;11,0;4,0;;5,0;3,0;4,0;;5,0;;2,0;5,0;1,0;;3,0;;;;5,0;;;;;43,0;;;;;;;;;;41,0;;5,0;;;;;;1,0;2,0;3,0;;10,0;;;2,0;;;;;;;17,0;;;;;9,0;;;4,0;;;;;;;;2,0;;;;2,0;3,0;;1,0;1,0;;1,0;;;;;;;2,0;;1,0;;1,0;;;;;;;;2,0;;1,0;3,0;;;3,0;;3,0;;;;;;;;;1,0;;;;;3,0;2,0;1,0;3,0;;;;;;;;;;;;;;;;1,0;;2,0;1,0;;;;;;;;;;;9,0;;4,0;;;;;;;;;;3,0;;1,0;;;;;99,0;34,0;;;;;;;;;;;;;;;26,0;;;;;;;;;;;;1,0;;;;;;;;;;;;;;2,0;;;;;;;;;28,0;;;;;;;;;;;;1,0;1,0;;1,0;;;;;;
circular;4,0;;;;9,0;;2,0;2,0;;;8,0;;;;1,0;2,0;;1,0;1,0;;;2,0;;;;;8,0;3,0;;;;1,0;14,0;;1,0;;3,0;21,0;;1,0;;14,0;2,0;3,0;;;1,0;;;;;2,0;;1,0;;31,0;26,0;4,0;2,0;18,0;;;8,0;;;2,0;;;;;2,0;5,0;13,0;1,0;6,0;;;13,0;13,0;;;;;;;;6,0;;;5,0;18,0;;;1,0;2,0;;;;;2,0;30,0;18,0;;;;;;20,0;;;;7,0;;;4,0;;;;;4,0;1,0;;;;;;4,0;2,0;;;;;;2,0;7,0;;5,0;;;;;1,0;;7,0;2,0;;25,0;1,0;;1,0;;3,0;8,0;;2,0;4,0;3,0;7,0;;;;;13,0;4,0;;;;7,0;;;9,0;3,0;7,0;5,0;12,0;10,0;11,0;;;;;;;;3,0;3,0;8,0;2,0;;38,0;;7,0;;4,0;1,0;;;;2,0;3,0;;42,0;;1,0;;;;;4,0;2,0;;;;;2,0;3,0;;4,0;;;;;;;;;1,0;;;;;;;1,0;5,0;;2,0;;3,0;;3,0;2,0;16,0;4,0;;;;;;2,0;;;;1,0;;;6,0;7,0;;6,0;;2,0;;;2,0;;8,0;;1,0;;2,0;;;;3,0;1,0;;;1,0;;;2,0;;;;1,0;9,0;;;;;;;4,0;;1,0;;1,0;;;;;2,0;7,0;3,0;3,0;7,0;;;6,0;;2,0;;;1,0;;5,0;2,0;;10,0;;;7,0;1,0;;;;;;;3,0;;;;;;;;;;;;;6,0;;;;;;;;;;;;;;;;;;;;;49,0;;;;;;;;;;;;1,0;;;;;1,0;;;;;;;;;;;;;;;;;;;;;1,0;;;;;;;;2,0;;;;;;;;;;12,0;;;;;;;;;1,0;;;;;;;;;;;;;;;;3,0;;2,0;;;;1,0;1,0;;;;;;;;;;;;;;1,0;;4,0;;;4,0;;;;14,0;;;;;1,0;1,0;;;3,0;5,0;1,0;;;;;1,0;;2,0;1,0;6,0;;;;;;;;;8,0;;;;;;;;;1,0;;;12,0;;1,0;;;;;;;;;;;;;;;;;;;1,0;;;;;;;;;1,0;;;;;;;1,0;;2,0;;;;;;;;;;;;1,0;;;;;;;2,0;;;;;;;;;;;;2,0;;;;;;;;;;;;;9,0;;;;;;;;;;;;;;;;;;;;;;;;1,0;;;;;;1,0;;;2,0;;;;;;9,0;;;;1,0;;15,0;;;;;;;;;;3,0;;;;;3,0;1,0;6,0;;16,0;;;;;;22,0;;;;;2,0;;;;;;;;;;;;;;;;;;;;;;;;;;6,0;;;;;;;;;;;;;;;;;;;;;;;;;;;;;;;;2,0;;;;;;;;;;;;;;2,0;;;;;;1,0;;;1,0;;;1,0;3,0;;;;;;;2,0;;;;;3,0;;;;;;1,0;;;;3,0;;;;;;;;;1,0;1,0;;7,0;;;;;;5,0;4,0;;;2,0;;;;;;;4,0;;1,0;3,0;2,0;;;;;;;;;;;;;;;;;1,0;;;;;;;1,0;1,0;;;2,0;;;1,0;;;;;;;;;;;;2,0;;;1,0;;2,0;;;;1,0;;;;;;1,0;;2,0;;10,0;;;;3,0;;;3,0;6,0;;;;;;;;;1,0;;;;;;;;;;;;;;;;;;;;;;;;;;;;;;;;;1,0;;;;;;;2,0;;;1,0;;;;;;;;;;;;;;;;;;;;;;;;;;;;;;;;;;;;;7,0;2,0;;;;;;;;;4,0;;;1,0;;;;;;;;;;;;;
coefficient;1,0;;5,0;;9,0;;;40,0;52,0;7,0;6,0;;;;10,0;;;;13,0;2,0;2,0;11,0;19,0;11,0;74,0;5,0;1,0;93,0;1,0;10,0;12,0;75,0;26,0;1,0;14,0;;;23,0;;;3,0;31,0;;14,0;10,0;;;7,0;12,0;15,0;15,0;31,0;;14,0;;54,0;13,0;15,0;5,0;38,0;27,0;4,0;37,0;;5,0;3,0;1,0;;;;19,0;6,0;;;;2,0;;10,0;8,0;5,0;;12,0;3,0;6,0;;;5,0;3,0;58,0;26,0;7,0;;;26,0;1,0;;;15,0;72,0;1,0;76,0;23,0;;1,0;1,0;;;81,0;;;;;24,0;1,0;;4,0;;;;1,0;;;2,0;31,0;;;7,0;3,0;;1,0;;;;;;7,0;;;;;;;;;40,0;;4,0;17,0;1,0;;;;;;;;;;;22,0;;3,0;;;;2,0;8,0;6,0;;23,0;11,0;4,0;6,0;;5,0;;;67,0;;;;;;;;3,0;;64,0;;13,0;;;;1,0;6,0;;12,0;;;;;2,0;;;;;;;;6,0;1,0;;24,0;2,0;1,0;3,0;;;;;;;;;;;;;;;;;;;3,0;;;1,0;2,0;;;1,0;24,0;;;4,0;1,0;2,0;;;;5,0;;;;7,0;;2,0;;;;;3,0;;;;1,0;;;;;;;;;;;;;;;;;;;;;1,0;;;;;;1,0;;;;;1,0;;;;8,0;;1,0;;;10,0;;;2,0;11,0;;;;;;;;;;16,0;1,0;;1,0;7,0;;;;;;3,0;;;;3,0;;2,0;2,0;2,0;;;4,0;;3,0;;2,0;;;11,0;;;13,0;3,0;;;;;;;6,0;;;;;1,0;;;4,0;;;;;;;3,0;15,0;5,0;;;;;;4,0;;;;27,0;1,0;4,0;;2,0;;;3,0;3,0;;1,0;10,0;;;;2,0;;3,0;2,0;4,0;2,0;;;;;;7,0;;;3,0;;7,0;;;;;2,0;4,0;;;;;;;1,0;;;;;;;1,0;;;;;;;1,0;52,0;13,0;;;;;;;;;;;3,0;;;;;;;;;;9,0;;1,0;3,0;;;;6,0;;;1,0;;1,0;11,0;;1,0;;;;;7,0;48,0;;;1,0;1,0;2,0;;;;;;;5,0;1,0;;6,0;;;;;;;;;8,0;;;;;;;;;;;;2,0;;;;;;;;;;;;;;;;;;;;;;;;;14,0;;;23,0;;;;;;4,0;103,0;;;;;;;;;2,0;;;;;;;;;;;;1,0;6,0;;;1,0;;;2,0;3,0;;;;;;3,0;;;2,0;2,0;;;4,0;;;;1,0;;;;;4,0;;;;;;;;;;;;;;;;;2,0;;;;;22,0;;;;;;3,0;;5,0;;;;;;;;;4,0;;;;;;;;;;;;;;;1,0;;;;;;;;;1,0;;;19,0;;;;;8,0;;3,0;;;;;;;2,0;;;1,0;;;1,0;;;1,0;;;;4,0;;;;;5,0;;;;;;;;;;;;;;;;;;;;1,0;;4,0;8,0;;;;;6,0;1,0;;;;;4,0;;2,0;6,0;;10,0;2,0;;;;2,0;;15,0;5,0;;1,0;;;;2,0;1,0;9,0;7,0;;;3,0;1,0;;;;;;;4,0;;;;;;;;;;;;5,0;;;;;1,0;;;;;;;;;;;;;;;;;1,0;4,0;;;;;;;1,0;;;6,0;1,0;;;;;;;;;;3,0;;;;1,0;;;;;;;;;;;;;;;;;3,0;;;;;;;;;;;1,0;;;;7,0;;;;;;;;4,0;;;;;;;;;1,0;;;;;;;;;;;;;;;3,0;1,0;;;1,0;;;;;19,0;;;;2,0;;;;;;;7,0;;2,0;;;1,0;;;;;;4,0;;1,0;2,0;;;;;;;;;11,0;;;;;;;;;;;;;;;;;;;;;;;;;;;;1,0;;;;;;;;;;;;;;;;;;;;;4,0;;;;;;;
color;8,0;5,0;158,0;12,0;85,0;;3,0;192,0;72,0;151,0;38,0;145,0;1,0;10,0;;9,0;21,0;5,0;583,0;23,0;24,0;79,0;33,0;99,0;288,0;12,0;;392,0;13,0;165,0;88,0;197,0;347,0;166,0;197,0;4,0;6,0;4,0;;80,0;21,0;1,0;;67,0;2,0;3,0;19,0;15,0;9,0;18,0;13,0;87,0;2,0;77,0;4,0;1264,0;265,0;72,0;2,0;40,0;2,0;14,0;314,0;1,0;23,0;4,0;5,0;;2,0;24,0;35,0;21,0;5,0;3,0;1,0;9,0;;35,0;97,0;14,0;4,0;226,0;43,0;60,0;22,0;2,0;157,0;4,0;67,0;128,0;188,0;140,0;43,0;408,0;38,0;189,0;;18,0;60,0;13,0;21,0;128,0;;21,0;7,0;;18,0;312,0;;6,0;32,0;54,0;84,0;4,0;;109,0;3,0;85,0;;5,0;;;18,0;47,0;;3,0;109,0;;30,0;14,0;8,0;2,0;17,0;;8,0;27,0;16,0;;;86,0;;40,0;14,0;27,0;414,0;;45,0;66,0;4,0;2,0;97,0;;;1,0;10,0;1,0;;;51,0;113,0;23,0;4,0;;;;83,0;112,0;605,0;1,0;11,0;7,0;2,0;45,0;8,0;9,0;3,0;3,0;212,0;1,0;;5,0;;8,0;10,0;;52,0;1,0;370,0;;121,0;;;;95,0;2,0;13,0;1,0;;16,0;1,0;12,0;19,0;;20,0;;31,0;3,0;1,0;16,0;3,0;17,0;7,0;14,0;1,0;5,0;30,0;37,0;15,0;;;7,0;8,0;;92,0;3,0;85,0;6,0;;;;1,0;;;38,0;141,0;;;48,0;129,0;;;;24,0;3,0;1,0;16,0;72,0;10,0;;;20,0;2,0;;8,0;12,0;1,0;;27,0;67,0;1,0;12,0;2,0;14,0;4,0;;;6,0;;;3,0;;1,0;;2,0;6,0;9,0;17,0;;;7,0;;;;;;17,0;3,0;206,0;19,0;7,0;2,0;;6,0;73,0;;1,0;5,0;9,0;;;8,0;;160,0;4,0;10,0;;;130,0;;;168,0;56,0;;;;;1,0;;;;;48,0;;;;176,0;1,0;;13,0;1,0;21,0;16,0;33,0;;;3,0;2,0;12,0;13,0;;;81,0;;46,0;;17,0;26,0;6,0;8,0;60,0;23,0;3,0;31,0;5,0;;6,0;18,0;;;1,0;4,0;;;2,0;27,0;48,0;4,0;36,0;2,0;;6,0;2,0;;70,0;6,0;21,0;15,0;40,0;;1,0;;29,0;8,0;10,0;22,0;3,0;10,0;64,0;5,0;37,0;;17,0;3,0;2,0;;12,0;2,0;30,0;11,0;11,0;8,0;;5,0;13,0;21,0;2,0;;12,0;;;12,0;6,0;1,0;35,0;;8,0;10,0;;89,0;;16,0;9,0;;5,0;66,0;;5,0;38,0;36,0;97,0;16,0;8,0;1,0;4,0;1,0;2,0;4,0;;;6,0;;20,0;;3,0;;17,0;71,0;78,0;8,0;;1,0;49,0;90,0;98,0;;12,0;3,0;;5,0;;7,0;;;2,0;;9,0;;;56,0;;5,0;103,0;;;1,0;36,0;55,0;;1,0;1,0;4,0;22,0;;;;15,0;9,0;12,0;10,0;65,0;4,0;13,0;600,0;8,0;70,0;34,0;;;;;2,0;2,0;7,0;4,0;5,0;2,0;5,0;;;;;;;25,0;3,0;;;18,0;;12,0;;;38,0;;;90,0;;2,0;6,0;8,0;5,0;;2,0;;8,0;32,0;;3,0;2,0;15,0;;25,0;;;8,0;18,0;;3,0;;6,0;44,0;11,0;;35,0;;;1,0;;;16,0;692,0;;44,0;2,0;;;14,0;5,0;;;;1,0;;;;;;4,0;;;3,0;5,0;90,0;;15,0;4,0;;;20,0;30,0;;;;1,0;12,0;7,0;;;8,0;;;;;;1,0;;3,0;48,0;;;;11,0;;;;;;;;;;;8,0;20,0;4,0;;;;8,0;1,0;;;11,0;132,0;;;1,0;;;;;2,0;3,0;;4,0;6,0;;13,0;16,0;;22,0;21,0;1,0;;;1,0;;;20,0;4,0;3,0;;;5,0;;11,0;;;;9,0;41,0;;1,0;8,0;23,0;;;10,0;1,0;1,0;1,0;2,0;82,0;55,0;13,0;2,0;;1,0;4,0;1,0;;;3,0;4,0;28,0;;;9,0;;;16,0;;;;25,0;;7,0;7,0;2,0;47,0;1,0;4,0;7,0;18,0;;4,0;4,0;3,0;10,0;;17,0;3,0;;7,0;;2,0;1,0;39,0;;;4,0;1,0;22,0;10,0;;4,0;6,0;2,0;2,0;;30,0;3,0;;9,0;;17,0;2,0;40,0;1,0;4,0;;;;12,0;16,0;25,0;35,0;16,0;2,0;4,0;3,0;50,0;19,0;3,0;3,0;9,0;5,0;1,0;7,0;1,0;14,0;19,0;1,0;9,0;8,0;1,0;66,0;7,0;6,0;;2,0;;;3,0;;19,0;13,0;;;;;;;;;6,0;;;13,0;;1,0;;;;4,0;8,0;2,0;26,0;44,0;;28,0;1,0;;4,0;;;8,0;1,0;18,0;;1,0;;4,0;1,0;1,0;1,0;;;17,0;1,0;33,0;14,0;41,0;;2,0;;2,0;;1,0;1,0;19,0;1,0;;;1,0;;;;2,0;;;;45,0;20,0;96,0;;1,0;;1,0;1,0;;5,0;;1,0;2,0;;;;;;3,0;2,0;9,0;;;;73,0;;1,0;;;;;;;;;;9,0;;;;3,0;;7,0;4,0;15,0;;1,0;;2,0;2,0;;;;2,0;;;9,0;40,0;6,0;;12,0;1,0;1,0;145,0;;;;;29,0;6,0;;;;5,0;;20,0;63,0;;2,0;5,0;;2,0;8,0;;1,0;;;2,0;;;2,0;28,0;17,0;2,0;4,0;3,0;1,0;2,0;3,0;;;;;;;;1,0;;;;18,0;;;;2,0;2,0;;8,0;;4,0;;;2,0;;;;5,0;;;2,0;;2,0;1,0;1,0;;2,0;;;;8,0;7,0;;;2,0;;;;
combination;4,0;5,0;3,0;4,0;40,0;;1,0;33,0;32,0;37,0;1,0;;2,0;;9,0;;;7,0;22,0;2,0;4,0;32,0;4,0;1,0;5,0;;2,0;68,0;;8,0;;7,0;36,0;;27,0;1,0;;7,0;;26,0;3,0;2,0;5,0;2,0;;2,0;;;;5,0;2,0;14,0;2,0;17,0;;182,0;46,0;;;47,0;1,0;;49,0;;3,0;3,0;;2,0;;10,0;21,0;2,0;;2,0;;;;6,0;7,0;4,0;;18,0;4,0;5,0;;;7,0;;1,0;17,0;9,0;;4,0;18,0;;1,0;;4,0;1,0;1,0;5,0;44,0;;;2,0;;18,0;32,0;;;2,0;2,0;1,0;7,0;4,0;6,0;;13,0;4,0;11,0;;;3,0;9,0;;;17,0;;;4,0;2,0;;;;;6,0;2,0;;3,0;5,0;;2,0;;8,0;14,0;1,0;14,0;23,0;;;5,0;;;1,0;5,0;4,0;2,0;3,0;11,0;13,0;;;;1,0;;1,0;6,0;47,0;;3,0;17,0;;16,0;6,0;4,0;6,0;;5,0;6,0;;3,0;;;;1,0;2,0;26,0;38,0;;4,0;;;;9,0;2,0;1,0;2,0;2,0;4,0;1,0;;7,0;;1,0;;1,0;2,0;2,0;1,0;4,0;4,0;;;;6,0;5,0;3,0;1,0;;2,0;;6,0;;4,0;;;;;;1,0;;;2,0;1,0;3,0;5,0;;3,0;13,0;;1,0;;;1,0;5,0;5,0;17,0;;;;1,0;6,0;;3,0;3,0;;1,0;15,0;1,0;1,0;5,0;2,0;;2,0;;;2,0;1,0;2,0;;2,0;1,0;;;5,0;1,0;2,0;;1,0;1,0;3,0;1,0;3,0;2,0;;11,0;;3,0;8,0;;2,0;;;3,0;1,0;;;1,0;;;1,0;;4,0;2,0;;1,0;;1,0;;;6,0;20,0;;;4,0;;2,0;;1,0;1,0;;2,0;1,0;;;20,0;;4,0;1,0;;4,0;;;;;;;3,0;;;;6,0;;1,0;5,0;1,0;4,0;;4,0;7,0;;1,0;4,0;;;;;;2,0;;4,0;;;;1,0;7,0;;;1,0;;;;;3,0;3,0;4,0;5,0;2,0;;1,0;;1,0;2,0;;;2,0;3,0;;1,0;;;;3,0;;2,0;4,0;;4,0;;;1,0;;14,0;;59,0;;;7,0;;9,0;;1,0;;26,0;1,0;;6,0;3,0;4,0;6,0;4,0;3,0;;1,0;17,0;;19,0;3,0;2,0;10,0;1,0;3,0;1,0;;1,0;2,0;1,0;2,0;3,0;1,0;2,0;8,0;;;;;2,0;;;1,0;;2,0;9,0;6,0;;1,0;;;3,0;;;7,0;;;;2,0;;;5,0;;;5,0;;;2,0;;2,0;2,0;1,0;;3,0;1,0;;;3,0;;9,0;;4,0;40,0;;10,0;1,0;2,0;15,0;21,0;1,0;1,0;;;;1,0;;4,0;1,0;1,0;4,0;;;1,0;;;;;;6,0;;;;4,0;;1,0;1,0;;1,0;;1,0;1,0;1,0;;;1,0;;1,0;;2,0;;2,0;3,0;;;;;;;3,0;1,0;;;;;3,0;2,0;2,0;1,0;;;;;3,0;6,0;;1,0;;;;1,0;;1,0;2,0;;;;;1,0;;;1,0;;;;3,0;3,0;3,0;;;;;27,0;;1,0;1,0;;;;;4,0;;14,0;2,0;;;2,0;;2,0;;;3,0;;;;;;;4,0;;;;;;;;;;3,0;;;;2,0;;;1,0;2,0;5,0;;;2,0;;;;;;;;;;;2,0;;;6,0;;;1,0;;;;1,0;;;;;;2,0;;1,0;13,0;;;6,0;;;;;;;;;;;;;10,0;;9,0;;;;;;;2,0;1,0;;6,0;;;;1,0;3,0;;;;2,0;;;;;2,0;6,0;;;;4,0;;1,0;;1,0;;3,0;;;;;;;;;;;1,0;;3,0;2,0;2,0;;;;;;1,0;1,0;;2,0;8,0;2,0;2,0;2,0;;;;;1,0;1,0;;;;;;8,0;;;2,0;;1,0;3,0;;;;1,0;;3,0;;1,0;;4,0;;4,0;4,0;;;;;1,0;;;;3,0;;;;;;6,0;3,0;;;;;1,0;;;;;;9,0;;;3,0;10,0;;2,0;;;;;2,0;;;;;1,0;1,0;;;;;;1,0;;2,0;1,0;3,0;;;;;;;;;1,0;;;;;;3,0;;;;;;5,0;;2,0;;;;;;;;;3,0;;;;;;;;1,0;;1,0;;;;;;3,0;;;;;1,0;;;1,0;;1,0;;;;1,0;;;2,0;;;;;1,0;3,0;2,0;;;;;;2,0;;4,0;;;1,0;;;;;;;;;3,0;;;;1,0;;1,0;;;;;;3,0;;;1,0;;;1,0;;;3,0;;;;;;;;;2,0;3,0;;;;;4,0;1,0;;;;;1,0;;;;;;;6,0;;;1,0;;;;;;;;;;;;;1,0;;;3,0;;;;;;;
compensate;5,0;;3,0;1,0;11,0;;20,0;13,0;16,0;14,0;5,0;;;;21,0;;;36,0;5,0;;9,0;11,0;12,0;1,0;23,0;;;31,0;;5,0;2,0;28,0;20,0;16,0;15,0;;;8,0;5,0;3,0;6,0;8,0;3,0;3,0;;;;1,0;10,0;;11,0;6,0;;1,0;;129,0;16,0;;2,0;42,0;;;52,0;;1,0;1,0;11,0;;3,0;1,0;32,0;22,0;1,0;;;1,0;;1,0;31,0;;;3,0;9,0;;;;3,0;;;5,0;10,0;9,0;2,0;36,0;3,0;3,0;;;2,0;;;22,0;;;2,0;1,0;2,0;21,0;;;1,0;2,0;;;;6,0;;;;1,0;;;;7,0;;;33,0;;;;;;;;;4,0;1,0;;;;;2,0;1,0;;11,0;;3,0;24,0;;;;1,0;;;;;;1,0;6,0;3,0;;;;;1,0;;13,0;16,0;;;1,0;;5,0;;36,0;;;9,0;;;;1,0;;;;5,0;;13,0;;9,0;;;4,0;8,0;;;2,0;;;;;;;;;;2,0;;5,0;3,0;;;1,0;;15,0;10,0;5,0;;;;;7,0;10,0;;;;;;;;;;;;5,0;19,0;;10,0;13,0;;;;4,0;;1,0;;;;;;;;;;2,0;1,0;;;;;;;;;;;1,0;;1,0;;;;2,0;;;2,0;;;;1,0;;;1,0;8,0;;32,0;17,0;3,0;1,0;;;;7,0;1,0;;1,0;;4,0;;;;;;;2,0;;;1,0;;;5,0;1,0;;;;;;;;;;2,0;;;;;;;1,0;;4,0;;;1,0;;2,0;1,0;;1,0;2,0;;;;;5,0;;;;;3,0;;;;;;1,0;;4,0;;;2,0;;;;;1,0;;;6,0;;;;;1,0;1,0;6,0;2,0;1,0;;;;2,0;;;;1,0;;2,0;;;;4,0;;1,0;3,0;;;4,0;;;;;;24,0;1,0;1,0;;7,0;;;1,0;3,0;;6,0;1,0;;;;;;;;;2,0;1,0;;;1,0;1,0;5,0;;;;;;;;;;;;;;;;5,0;;3,0;;;;;2,0;4,0;;;;;1,0;;;;;;;3,0;5,0;;33,0;;;6,0;;;;;7,0;;;;3,0;;;;;3,0;;;2,0;;;;12,0;;2,0;1,0;;4,0;;;;;3,0;;;;;;;;;;;2,0;1,0;;;;;;;;4,0;;;;;;;;;;;;;3,0;;2,0;;;;;;;;;;;;;;;;;;;;;;;22,0;;;;;;3,0;;;1,0;;;1,0;;;;;;;;2,0;;1,0;2,0;;2,0;1,0;;;;;;;;;;;;;;;;6,0;;2,0;;;3,0;;;2,0;;;;;;;;;1,0;;;;1,0;;;2,0;;2,0;;;;1,0;;;;;;;;;;;;3,0;;12,0;2,0;;;5,0;;3,0;;;;;;5,0;;1,0;;;;;;12,0;;;;;;;2,0;;;;1,0;;;;2,0;;2,0;4,0;;;3,0;1,0;;;;;;5,0;;;;;4,0;;;;;;;;;;9,0;;;;;;1,0;;;;;;;;3,0;;;2,0;;;;4,0;;;;;;;1,0;;;5,0;;;;;7,0;;;3,0;;;;;;;;3,0;1,0;1,0;;12,0;1,0;1,0;3,0;;;;;;;;;;;;;9,0;2,0;1,0;;;;1,0;1,0;;;;;;;;;;;;;;;;;;;;;;;;;2,0;;;;;;;;5,0;;;;;;;;;;;;1,0;;1,0;3,0;;;;;;;;;;;;1,0;;;;;;;;;;;;;3,0;;;;;;;;2,0;;;;;;2,0;;;;;;1,0;;5,0;1,0;;;;;;;;;;;;;;;;;1,0;;;;;;;;;;;;;;;;;1,0;;;;;;;;;;;;;;3,0;1,0;1,0;;2,0;;1,0;;;;;;;;;3,0;;;;;;;;;;;;;;;;;;;;;;;;;;;;;;4,0;;;;;;3,0;;;;;;;;;;;;;;;;;;;;;
compensation;25,0;;1,0;;10,0;2,0;5,0;11,0;17,0;16,0;;6,0;1,0;;5,0;7,0;36,0;;20,0;1,0;5,0;16,0;4,0;4,0;1,0;;5,0;18,0;4,0;8,0;;13,0;29,0;6,0;34,0;;;4,0;4,0;2,0;7,0;4,0;16,0;4,0;1,0;2,0;;18,0;4,0;;6,0;12,0;;1,0;;53,0;9,0;4,0;13,0;59,0;;1,0;44,0;;;4,0;1,0;;;26,0;27,0;1,0;5,0;;1,0;;1,0;3,0;8,0;1,0;;19,0;21,0;;;;5,0;;3,0;10,0;10,0;;1,0;21,0;2,0;;;2,0;2,0;;3,0;48,0;;;;4,0;1,0;32,0;;;1,0;;1,0;3,0;1,0;1,0;;;;;;;;11,0;;;23,0;;;1,0;;;;;;;1,0;;;;3,0;3,0;5,0;2,0;2,0;;5,0;1,0;;;;;;;;;;;;8,0;;;;;;1,0;;6,0;;;11,0;;20,0;;28,0;;;;;;;3,0;;;;;;8,0;;25,0;;;2,0;3,0;;;1,0;;1,0;;;3,0;;;;2,0;;;8,0;9,0;;;;;;41,0;5,0;;;;;;11,0;;;;;;;1,0;;;;;2,0;1,0;;7,0;1,0;;;;1,0;;1,0;1,0;1,0;;;;;;;;;;1,0;;1,0;1,0;;5,0;;;;;;;;;;;;;6,0;;;;;1,0;;;;26,0;;4,0;10,0;;1,0;;;;;5,0;;2,0;;6,0;;;;;11,0;;;;;28,0;;;3,0;;;;;;;;;;;2,0;1,0;;;3,0;;;;;1,0;;;;;3,0;;;;1,0;;3,0;;;34,0;;;1,0;;4,0;;13,0;;;;;1,0;;;;;;;;;1,0;;;;;;;;;;1,0;;;;;3,0;;;1,0;1,0;;2,0;;;1,0;1,0;;;;6,0;;;;2,0;;;;;5,0;;;;3,0;;;;5,0;;;;;;;;;;1,0;;;17,0;;;;1,0;3,0;;1,0;;1,0;;;;;;;;;;;;4,0;;;;;;1,0;;21,0;;;1,0;;1,0;;;;;33,0;;;1,0;;188,0;;;16,0;;;;;5,0;;1,0;;6,0;;;1,0;;1,0;3,0;;;24,0;;9,0;7,0;2,0;2,0;1,0;;3,0;;;;;1,0;1,0;;;;;;;;;;;;;;;;;;;;;;;5,0;;;;;;;;;2,0;;;;;;;;1,0;;;;;;;1,0;2,0;;1,0;;;;;;;23,0;5,0;5,0;;;;;;;;;;6,0;;;;;;;;;;4,0;1,0;;;;;1,0;;1,0;;;;;;;;;;;;48,0;;;1,0;;;;;;;;;;;;;;;;;10,0;;;;1,0;;1,0;;;;;1,0;;;;;;;;;;;;;19,0;;;;4,0;;;;;1,0;;;1,0;;;;;;;2,0;7,0;;;;;;;;9,0;;;1,0;;;;;2,0;4,0;1,0;;;;;;;;;;3,0;;;5,0;;;;;;;;;;;;4,0;;;4,0;;;;1,0;;;;;;;8,0;;;;;;;1,0;;;;;;2,0;2,0;;;;;;5,0;;;;;;;;;;1,0;;;;10,0;1,0;;;;1,0;;;;;;1,0;;;;;3,0;;1,0;15,0;1,0;1,0;;;;;;;;1,0;;;;;;;1,0;2,0;1,0;;;;;;;;;;1,0;1,0;1,0;;;;;;;;;;;;;;;;;;;;;;1,0;;;;;;;;;;;;;;2,0;;;;;;;;;;;;;;;;1,0;;;;;;;;;;;2,0;;;;;3,0;;;;;;;;;;;;;;;;;;;;;;;;2,0;;;;;;;;;;1,0;;;;;;;;;;;;2,0;;;1,0;;;;;;;31,0;;;;;2,0;;;;;;;4,0;;;;;;;;;;;;;;;;;;;;;;;;;1,0;;;;;;;;;;;;;;;;;;;;;;;;;;;;;;;
component;1,0;5,0;37,0;5,0;61,0;9,0;39,0;121,0;58,0;90,0;13,0;11,0;1,0;13,0;583,0;22,0;5,0;20,0;;9,0;42,0;143,0;28,0;10,0;101,0;6,0;3,0;143,0;7,0;103,0;7,0;98,0;119,0;102,0;71,0;2,0;12,0;98,0;;174,0;7,0;1,0;20,0;16,0;16,0;;;35,0;13,0;145,0;22,0;81,0;;47,0;5,0;671,0;225,0;32,0;14,0;273,0;1,0;10,0;144,0;;19,0;10,0;26,0;9,0;;11,0;169,0;14,0;8,0;16,0;4,0;1,0;;42,0;178,0;31,0;;104,0;27,0;70,0;;;69,0;14,0;39,0;85,0;77,0;37,0;;216,0;11,0;28,0;;12,0;35,0;23,0;91,0;207,0;;61,0;3,0;;1,0;125,0;1,0;;22,0;41,0;13,0;52,0;26,0;3,0;;37,0;43,0;68,0;1,0;;2,0;38,0;2,0;1,0;140,0;12,0;6,0;50,0;12,0;19,0;4,0;17,0;2,0;51,0;45,0;;3,0;20,0;5,0;1,0;6,0;70,0;59,0;11,0;25,0;66,0;7,0;8,0;42,0;;15,0;5,0;23,0;21,0;;42,0;25,0;85,0;5,0;4,0;21,0;8,0;;6,0;35,0;318,0;2,0;15,0;75,0;24,0;100,0;51,0;8,0;4,0;4,0;52,0;8,0;;20,0;1,0;17,0;1,0;7,0;55,0;9,0;169,0;2,0;76,0;6,0;;4,0;109,0;;12,0;8,0;;18,0;9,0;1,0;2,0;10,0;63,0;;6,0;4,0;14,0;24,0;37,0;2,0;16,0;6,0;;11,0;31,0;18,0;13,0;1,0;;21,0;38,0;8,0;105,0;23,0;81,0;1,0;;3,0;;;2,0;2,0;14,0;43,0;4,0;;24,0;33,0;;5,0;;11,0;16,0;4,0;5,0;2,0;5,0;2,0;6,0;7,0;11,0;1,0;36,0;3,0;;5,0;11,0;3,0;;9,0;11,0;65,0;34,0;12,0;2,0;37,0;;;2,0;3,0;62,0;2,0;10,0;18,0;3,0;1,0;1,0;5,0;40,0;14,0;2,0;7,0;13,0;9,0;48,0;6,0;102,0;17,0;7,0;28,0;10,0;2,0;25,0;;10,0;1,0;24,0;2,0;;2,0;;62,0;37,0;14,0;4,0;8,0;56,0;33,0;7,0;92,0;13,0;;1,0;2,0;;18,0;;1,0;4,0;2,0;33,0;5,0;11,0;1,0;13,0;;10,0;10,0;4,0;20,0;;;;3,0;4,0;;;19,0;5,0;;19,0;2,0;36,0;23,0;7,0;11,0;3,0;4,0;11,0;12,0;8,0;24,0;;;2,0;;2,0;;4,0;2,0;1,0;;7,0;3,0;35,0;;1,0;20,0;;3,0;;9,0;14,0;10,0;17,0;7,0;53,0;;6,0;20,0;1,0;2,0;4,0;;4,0;1,0;17,0;3,0;5,0;2,0;14,0;23,0;;6,0;;;14,0;1,0;1,0;7,0;;28,0;22,0;51,0;2,0;46,0;8,0;1,0;21,0;15,0;9,0;2,0;27,0;1,0;7,0;25,0;;38,0;6,0;25,0;;1,0;2,0;18,0;;4,0;10,0;1,0;61,0;1,0;13,0;;;;2,0;;3,0;14,0;3,0;1,0;;1,0;1,0;8,0;25,0;18,0;9,0;;1,0;2,0;7,0;23,0;90,0;1,0;4,0;4,0;;2,0;;;;;17,0;9,0;8,0;13,0;1,0;7,0;;;56,0;1,0;;;41,0;5,0;2,0;5,0;5,0;2,0;;;;;14,0;;;5,0;18,0;8,0;8,0;10,0;5,0;66,0;23,0;1,0;30,0;;;4,0;2,0;2,0;15,0;60,0;;;;3,0;1,0;5,0;;3,0;1,0;4,0;15,0;2,0;;3,0;;1,0;;;;;1,0;5,0;2,0;27,0;1,0;4,0;;;12,0;;15,0;2,0;4,0;2,0;2,0;;1,0;;26,0;2,0;1,0;4,0;22,0;1,0;3,0;12,0;;1,0;11,0;3,0;2,0;8,0;1,0;4,0;7,0;219,0;;;2,0;2,0;4,0;22,0;;;5,0;;2,0;;6,0;;;;33,0;2,0;1,0;6,0;13,0;40,0;1,0;;1,0;2,0;;7,0;;5,0;;;8,0;8,0;16,0;2,0;;19,0;;5,0;1,0;;;6,0;;2,0;1,0;;;6,0;8,0;;;;;3,0;;4,0;;9,0;3,0;2,0;32,0;6,0;;;1,0;;2,0;;12,0;22,0;3,0;3,0;2,0;29,0;;3,0;;;;2,0;4,0;9,0;2,0;;;1,0;1,0;66,0;1,0;1,0;3,0;5,0;8,0;4,0;;2,0;1,0;1,0;;;10,0;2,0;22,0;12,0;;14,0;;;;;;36,0;1,0;3,0;4,0;;1,0;7,0;;21,0;48,0;14,0;4,0;;;3,0;;;11,0;1,0;;1,0;;;41,0;3,0;2,0;5,0;4,0;;1,0;16,0;2,0;;;1,0;36,0;;3,0;1,0;;;3,0;;3,0;;8,0;5,0;;2,0;;;1,0;;2,0;;1,0;3,0;;3,0;9,0;;1,0;7,0;17,0;3,0;;4,0;;;20,0;;8,0;2,0;19,0;3,0;;17,0;1,0;8,0;3,0;14,0;15,0;7,0;2,0;;1,0;;3,0;11,0;3,0;5,0;12,0;2,0;2,0;;;3,0;9,0;6,0;2,0;3,0;37,0;83,0;18,0;;;;3,0;;4,0;2,0;9,0;;;;;;;2,0;;10,0;;;25,0;9,0;;;2,0;;5,0;;;7,0;6,0;2,0;2,0;1,0;4,0;;13,0;;;4,0;1,0;2,0;;1,0;1,0;25,0;;6,0;;9,0;;2,0;;30,0;2,0;;2,0;;4,0;;1,0;3,0;;7,0;4,0;7,0;2,0;3,0;6,0;;;9,0;1,0;3,0;2,0;3,0;;1,0;;23,0;;26,0;;14,0;2,0;2,0;2,0;2,0;;;7,0;;;6,0;5,0;15,0;;;4,0;;;3,0;;7,0;4,0;;2,0;;1,0;;10,0;1,0;;;;;;2,0;;11,0;;;;;3,0;;2,0;1,0;;;;;60,0;;1,0;;21,0;2,0;14,0;2,0;;8,0;;1,0;2,0;1,0;;1,0;7,0;8,0;57,0;13,0;6,0;;;;;4,0;;;;;1,0;;1,0;;20,0;8,0;;;6,0;;;;;1,0;1,0;;3,0;;;;;;;;;1,0;29,0;2,0;;;3,0;;18,0;;;;;9,0;4,0;;3,0;;;;7,0;6,0;;;;;6,0;;;10,0;;;7,0;;;;
computer;1,0;;9,0;8,0;100,0;;5,0;39,0;25,0;68,0;11,0;14,0;;2,0;23,0;2,0;;1,0;9,0;;5,0;137,0;15,0;13,0;33,0;;1,0;108,0;6,0;26,0;9,0;95,0;197,0;10,0;82,0;19,0;12,0;12,0;8,0;88,0;7,0;3,0;1,0;19,0;;;9,0;1,0;4,0;3,0;40,0;88,0;1,0;27,0;1,0;437,0;108,0;;4,0;4,0;1,0;2,0;253,0;;64,0;;15,0;;3,0;32,0;9,0;9,0;12,0;3,0;;2,0;;28,0;55,0;14,0;;111,0;120,0;11,0;1,0;;20,0;;6,0;39,0;32,0;;2,0;25,0;3,0;16,0;1,0;150,0;158,0;6,0;12,0;299,0;;16,0;159,0;3,0;3,0;21,0;;;20,0;7,0;7,0;9,0;5,0;;;;2,0;24,0;;;1,0;4,0;;;103,0;6,0;4,0;36,0;3,0;12,0;;1,0;1,0;5,0;7,0;2,0;5,0;2,0;1,0;20,0;28,0;7,0;4,0;;10,0;23,0;2,0;;;;;;6,0;;2,0;12,0;10,0;21,0;1,0;2,0;;;10,0;4,0;16,0;18,0;6,0;12,0;3,0;;46,0;15,0;21,0;2,0;;9,0;;;1,0;;2,0;;1,0;6,0;;61,0;;25,0;;;;80,0;;;;;7,0;2,0;;5,0;;2,0;;1,0;2,0;;1,0;10,0;;28,0;6,0;;7,0;20,0;32,0;2,0;;;1,0;2,0;;2,0;;;;;6,0;;1,0;;;6,0;5,0;3,0;;11,0;22,0;1,0;;;3,0;;;1,0;2,0;;;;1,0;9,0;3,0;36,0;4,0;3,0;;13,0;1,0;;2,0;1,0;4,0;;;;1,0;;;2,0;3,0;1,0;4,0;;;55,0;2,0;;2,0;5,0;2,0;;;3,0;;27,0;1,0;73,0;22,0;;;;3,0;8,0;;1,0;;4,0;;;70,0;1,0;20,0;3,0;;;;10,0;;;21,0;6,0;;;;;3,0;;1,0;;;9,0;;1,0;;12,0;;4,0;3,0;;68,0;2,0;1,0;3,0;;2,0;;;1,0;1,0;;20,0;;3,0;5,0;;3,0;11,0;;11,0;1,0;28,0;21,0;;;1,0;4,0;3,0;;;3,0;6,0;6,0;1,0;17,0;1,0;1,0;1,0;3,0;7,0;1,0;2,0;;19,0;465,0;66,0;2,0;1,0;;;8,0;2,0;303,0;672,0;;1,0;4,0;1,0;413,0;62,0;4,0;16,0;2,0;18,0;1,0;3,0;3,0;19,0;14,0;;28,0;;3,0;3,0;;5,0;27,0;6,0;10,0;1,0;3,0;7,0;2,0;4,0;2,0;18,0;16,0;;33,0;5,0;27,0;11,0;;20,0;34,0;10,0;3,0;18,0;2,0;28,0;5,0;2,0;2,0;;5,0;;;;2,0;3,0;5,0;2,0;;;5,0;12,0;1,0;2,0;1,0;;4,0;191,0;14,0;9,0;;5,0;;8,0;156,0;8,0;;1,0;;;2,0;23,0;3,0;;28,0;;;111,0;6,0;2,0;5,0;2,0;19,0;;19,0;5,0;1,0;1,0;7,0;1,0;;7,0;28,0;8,0;1,0;16,0;3,0;9,0;3,0;3,0;87,0;50,0;;1,0;4,0;;28,0;7,0;2,0;2,0;;1,0;3,0;;2,0;;;;7,0;184,0;35,0;6,0;18,0;8,0;1,0;;;4,0;2,0;2,0;4,0;1,0;21,0;;1,0;1,0;7,0;3,0;;6,0;25,0;1,0;;7,0;10,0;3,0;;1,0;2,0;1,0;3,0;;2,0;8,0;3,0;4,0;8,0;29,0;;1,0;50,0;;4,0;5,0;1,0;16,0;31,0;;8,0;1,0;;;19,0;1,0;;2,0;1,0;16,0;28,0;5,0;;;;20,0;;1,0;;6,0;21,0;1,0;1,0;14,0;;3,0;3,0;8,0;6,0;;;8,0;1,0;1,0;;1,0;3,0;;1,0;;4,0;;;18,0;;1,0;;;;4,0;13,0;;;1,0;12,0;;;2,0;;;;4,0;;;;;3,0;;;4,0;;3,0;1,0;2,0;;;;1,0;1,0;1,0;;7,0;1,0;8,0;1,0;3,0;;;1,0;8,0;1,0;;;;;;2,0;5,0;14,0;;5,0;3,0;3,0;2,0;2,0;2,0;;;;;1,0;;1,0;26,0;;;2,0;3,0;;;3,0;2,0;10,0;;;2,0;2,0;;;;3,0;;2,0;;;1,0;2,0;;1,0;;18,0;;;6,0;;2,0;4,0;25,0;;3,0;4,0;1,0;1,0;;;;3,0;;;5,0;;;;1,0;3,0;2,0;;;;6,0;6,0;5,0;;1,0;;2,0;67,0;1,0;1,0;;;2,0;8,0;1,0;;5,0;3,0;;;;1,0;3,0;8,0;1,0;4,0;;;1,0;;10,0;16,0;2,0;1,0;;;;1,0;;4,0;;;;4,0;3,0;2,0;2,0;2,0;1,0;;2,0;;1,0;;3,0;3,0;1,0;;1,0;;;2,0;25,0;22,0;;17,0;5,0;1,0;;44,0;2,0;;;8,0;;;12,0;13,0;;;4,0;1,0;6,0;;;1,0;;;;;;7,0;2,0;1,0;2,0;5,0;;;3,0;2,0;1,0;3,0;1,0;;;1,0;;2,0;;;1,0;2,0;3,0;;1,0;;1,0;;;;;11,0;2,0;2,0;2,0;5,0;;;1,0;1,0;;;;;2,0;;;1,0;;;;;;;7,0;2,0;1,0;2,0;2,0;;;;1,0;4,0;;;;6,0;1,0;;;1,0;;4,0;;2,0;3,0;11,0;;44,0;;;;;2,0;;33,0;4,0;;2,0;;1,0;1,0;2,0;;;;;;1,0;4,0;2,0;;9,0;;2,0;1,0;1,0;;1,0;3,0;;;;86,0;1,0;;;2,0;;;13,0;2,0;;;4,0;4,0;;;;;2,0;;;6,0;;;;2,0;2,0;5,0;;7,0;;;;1,0;2,0;1,0;1,0;2,0;;4,0;;;1,0;1,0;5,0;;1,0;1,0;;2,0;1,0;;;;;;1,0;;;;2,0;;;;;
condition;1,0;;55,0;;52,0;29,0;63,0;191,0;7,0;98,0;17,0;14,0;;2,0;24,0;4,0;9,0;5,0;42,0;5,0;;91,0;;13,0;9,0;4,0;;104,0;1,0;136,0;7,0;237,0;120,0;10,0;53,0;4,0;7,0;79,0;;106,0;21,0;2,0;5,0;33,0;1,0;;;175,0;22,0;4,0;18,0;23,0;16,0;18,0;13,0;607,0;99,0;;130,0;419,0;;31,0;93,0;1,0;1,0;2,0;8,0;;1,0;86,0;215,0;4,0;1,0;;1,0;32,0;;13,0;38,0;34,0;13,0;84,0;18,0;16,0;3,0;;10,0;3,0;21,0;33,0;112,0;14,0;163,0;46,0;5,0;5,0;;53,0;49,0;;51,0;368,0;;4,0;8,0;19,0;83,0;292,0;;;8,0;3,0;7,0;6,0;7,0;5,0;8,0;4,0;2,0;3,0;;;8,0;38,0;;;42,0;3,0;1,0;;10,0;7,0;;;2,0;11,0;7,0;;;3,0;;5,0;5,0;12,0;;6,0;29,0;30,0;;2,0;4,0;;;;2,0;2,0;2,0;10,0;70,0;161,0;;8,0;;2,0;;;14,0;130,0;6,0;17,0;12,0;3,0;11,0;5,0;33,0;;;43,0;;;5,0;;2,0;3,0;;1,0;1,0;59,0;;9,0;;;;27,0;;3,0;75,0;;7,0;1,0;;21,0;;34,0;;23,0;;;;;26,0;;46,0;;7,0;90,0;5,0;;;;2,0;6,0;5,0;;2,0;;;;;;;;2,0;;56,0;7,0;;20,0;17,0;5,0;8,0;;3,0;;;17,0;;;;;;191,0;;4,0;;;;17,0;2,0;1,0;;6,0;;;2,0;;;;;2,0;;;2,0;;2,0;2,0;5,0;;15,0;1,0;1,0;;;;;8,0;44,0;100,0;59,0;;4,0;;8,0;4,0;;12,0;;92,0;1,0;;2,0;;184,0;;;;;15,0;;;43,0;5,0;3,0;;;;;;;;;4,0;3,0;1,0;;24,0;;1,0;8,0;;38,0;5,0;;;;;5,0;3,0;2,0;7,0;;9,0;1,0;27,0;2,0;;9,0;1,0;;121,0;8,0;2,0;2,0;;2,0;;6,0;;;;;5,0;;;12,0;25,0;2,0;7,0;;1,0;7,0;1,0;3,0;14,0;4,0;1,0;7,0;3,0;132,0;3,0;9,0;18,0;;7,0;;5,0;7,0;19,0;1,0;43,0;9,0;11,0;;;1,0;1,0;9,0;2,0;49,0;7,0;3,0;2,0;1,0;8,0;2,0;6,0;;86,0;9,0;2,0;;6,0;;5,0;;4,0;5,0;;54,0;;5,0;;;4,0;37,0;;3,0;2,0;;48,0;;;;;3,0;;2,0;2,0;;;6,0;23,0;;3,0;2,0;23,0;3,0;;26,0;1,0;2,0;6,0;9,0;49,0;;;2,0;11,0;23,0;;1,0;;;3,0;1,0;14,0;3,0;7,0;39,0;;;16,0;;;;3,0;12,0;;1,0;7,0;1,0;;2,0;;;3,0;12,0;30,0;3,0;89,0;;8,0;39,0;1,0;15,0;83,0;;1,0;;3,0;;;1,0;5,0;16,0;1,0;14,0;32,0;9,0;2,0;;;1,0;;7,0;3,0;;;;32,0;;;2,0;;;5,0;2,0;;;3,0;;;3,0;;1,0;15,0;;;;;;5,0;2,0;;;;1,0;;;;21,0;1,0;;3,0;8,0;;5,0;3,0;;4,0;30,0;;1,0;2,0;;1,0;1,0;3,0;1,0;2,0;;;3,0;;;;;4,0;;;;;88,0;8,0;;13,0;;;;57,0;;;;;;7,0;;;3,0;1,0;8,0;;221,0;14,0;;;2,0;1,0;;5,0;;1,0;4,0;;;;3,0;;;;6,0;;15,0;;;;;;4,0;;;;;69,0;7,0;;14,0;;;;;;;;22,0;14,0;;;1,0;;9,0;;5,0;;;;;;2,0;;;;;32,0;2,0;2,0;8,0;;;;;15,0;1,0;34,0;;;;;;;;;6,0;29,0;;;;6,0;1,0;;;9,0;9,0;4,0;16,0;;;2,0;5,0;;5,0;;;29,0;;;;6,0;63,0;12,0;;1,0;;;3,0;1,0;;4,0;14,0;;;;8,0;;;2,0;;;2,0;;19,0;;9,0;3,0;3,0;1,0;;1,0;2,0;;14,0;3,0;;1,0;3,0;3,0;11,0;3,0;709,0;;;;10,0;1,0;16,0;3,0;18,0;17,0;2,0;;;;;;5,0;1,0;;;5,0;;21,0;;;2,0;;;18,0;4,0;2,0;;;;;5,0;34,0;;37,0;16,0;;;3,0;;5,0;;3,0;;;;2,0;;1,0;;1,0;;;2,0;;;2,0;4,0;13,0;8,0;5,0;3,0;;;28,0;3,0;5,0;1,0;;;2,0;;1,0;5,0;;;11,0;3,0;3,0;5,0;6,0;;;;;;;;;4,0;1,0;;7,0;;;1,0;;;1,0;;;;6,0;;1,0;;;;;;;;;;2,0;;1,0;1,0;;;;;;1,0;2,0;;;;;;;;;;;;;;;;4,0;;44,0;;;;;;;1,0;;;;;;;;;2,0;;;69,0;;;1,0;;;;;;;;;4,0;;;;;2,0;3,0;;;;;;;;;;12,0;1,0;;;;1,0;;;;;;1,0;;;;6,0;;;;;;;;;1,0;;5,0;;;;;;;;;;;1,0;;;2,0;;4,0;;;;8,0;;;18,0;;;;;1,0;;;;
control;12,0;60,0;209,0;22,0;969,0;2,0;127,0;545,0;149,0;320,0;32,0;25,0;2,0;11,0;79,0;32,0;11,0;16,0;143,0;137,0;91,0;;35,0;115,0;211,0;;10,0;654,0;30,0;268,0;194,0;333,0;2071,0;25,0;448,0;2,0;38,0;269,0;13,0;1361,0;77,0;2,0;468,0;369,0;7,0;42,0;6,0;75,0;659,0;32,0;193,0;420,0;50,0;69,0;11,0;1967,0;565,0;3,0;72,0;819,0;15,0;67,0;1004,0;4,0;9,0;272,0;207,0;13,0;8,0;748,0;323,0;49,0;68,0;5,0;;40,0;6,0;158,0;692,0;219,0;18,0;367,0;238,0;15,0;17,0;4,0;53,0;8,0;16,0;305,0;338,0;57,0;170,0;1789,0;79,0;3,0;6,0;261,0;310,0;20,0;128,0;926,0;;187,0;15,0;20,0;35,0;3761,0;23,0;1,0;184,0;89,0;45,0;116,0;24,0;93,0;112,0;2,0;61,0;169,0;;7,0;77,0;978,0;;5,0;911,0;37,0;22,0;114,0;23,0;11,0;27,0;11,0;13,0;60,0;31,0;2,0;16,0;82,0;15,0;11,0;96,0;131,0;41,0;18,0;124,0;142,0;13,0;;2,0;2,0;20,0;4,0;40,0;8,0;8,0;43,0;151,0;418,0;16,0;23,0;;11,0;7,0;8,0;118,0;719,0;29,0;7,0;364,0;52,0;332,0;69,0;214,0;14,0;2,0;498,0;2,0;;40,0;3,0;22,0;29,0;8,0;12,0;29,0;502,0;4,0;334,0;1,0;;2,0;374,0;;22,0;2,0;1,0;81,0;2,0;8,0;26,0;9,0;58,0;1,0;35,0;59,0;15,0;12,0;38,0;12,0;16,0;;12,0;138,0;509,0;193,0;1,0;64,0;5,0;2,0;81,0;47,0;6,0;5,0;9,0;29,0;;25,0;;;6,0;136,0;8,0;155,0;79,0;2,0;119,0;227,0;80,0;65,0;;123,0;8,0;27,0;34,0;162,0;24,0;;46,0;28,0;61,0;2,0;174,0;;6,0;11,0;52,0;27,0;;12,0;497,0;13,0;3,0;24,0;3,0;6,0;;1,0;1,0;6,0;9,0;11,0;;10,0;160,0;24,0;2,0;31,0;9,0;48,0;2,0;23,0;209,0;;201,0;120,0;168,0;189,0;5,0;31,0;4,0;9,0;38,0;;8,0;31,0;307,0;7,0;;29,0;1,0;217,0;21,0;45,0;6,0;2,0;130,0;2,0;;118,0;85,0;28,0;4,0;16,0;6,0;4,0;;;2,0;;98,0;5,0;16,0;;101,0;;5,0;176,0;4,0;307,0;45,0;6,0;15,0;1,0;11,0;19,0;21,0;46,0;16,0;;65,0;7,0;69,0;67,0;10,0;58,0;83,0;1,0;256,0;31,0;298,0;35,0;16,0;3,0;25,0;13,0;7,0;;2,0;14,0;14,0;2,0;18,0;49,0;82,0;33,0;8,0;53,0;7,0;30,0;;29,0;22,0;87,0;162,0;24,0;23,0;;15,0;105,0;93,0;16,0;151,0;117,0;62,0;40,0;52,0;14,0;461,0;16,0;101,0;13,0;5,0;216,0;194,0;177,0;91,0;79,0;2,0;92,0;;13,0;7,0;5,0;17,0;193,0;250,0;41,0;37,0;6,0;139,0;8,0;24,0;11,0;10,0;26,0;2,0;286,0;14,0;76,0;46,0;40,0;97,0;494,0;12,0;62,0;95,0;18,0;41,0;27,0;1,0;10,0;17,0;30,0;20,0;23,0;17,0;24,0;25,0;54,0;5,0;12,0;103,0;12,0;541,0;59,0;42,0;29,0;151,0;4,0;158,0;68,0;247,0;;31,0;33,0;36,0;171,0;10,0;11,0;6,0;70,0;18,0;16,0;102,0;60,0;28,0;142,0;25,0;2,0;655,0;3,0;10,0;23,0;5,0;41,0;11,0;12,0;16,0;88,0;6,0;64,0;47,0;3,0;37,0;66,0;97,0;35,0;223,0;13,0;365,0;41,0;60,0;366,0;168,0;40,0;183,0;24,0;10,0;18,0;51,0;14,0;9,0;143,0;9,0;5,0;1,0;7,0;8,0;;24,0;61,0;51,0;230,0;59,0;8,0;24,0;7,0;20,0;2,0;6,0;8,0;4,0;2,0;359,0;54,0;1,0;7,0;19,0;15,0;2,0;12,0;7,0;26,0;71,0;6,0;17,0;9,0;3,0;12,0;14,0;29,0;5,0;7,0;4,0;12,0;15,0;26,0;32,0;4,0;16,0;;11,0;111,0;;96,0;20,0;69,0;70,0;202,0;18,0;15,0;22,0;3,0;42,0;71,0;30,0;8,0;1,0;5,0;76,0;37,0;10,0;;9,0;7,0;13,0;;60,0;2,0;14,0;138,0;16,0;36,0;99,0;;3,0;5,0;17,0;68,0;;;25,0;6,0;80,0;3,0;3,0;7,0;3,0;14,0;4,0;612,0;12,0;7,0;13,0;39,0;18,0;1,0;79,0;;68,0;2,0;;9,0;4,0;196,0;11,0;2,0;15,0;50,0;1,0;34,0;19,0;5,0;;;2,0;73,0;15,0;1,0;33,0;23,0;175,0;9,0;3,0;42,0;11,0;4,0;1,0;;12,0;;;;25,0;1,0;10,0;3,0;1,0;32,0;2,0;1,0;2,0;4,0;8,0;5,0;;10,0;9,0;45,0;;9,0;;1,0;7,0;71,0;1,0;3,0;1,0;47,0;;22,0;6,0;47,0;6,0;2,0;8,0;22,0;2,0;22,0;12,0;10,0;58,0;7,0;16,0;;23,0;10,0;1,0;12,0;49,0;5,0;12,0;18,0;17,0;34,0;64,0;16,0;30,0;34,0;28,0;11,0;4,0;;16,0;4,0;2,0;42,0;189,0;20,0;17,0;2,0;103,0;3,0;9,0;13,0;20,0;9,0;7,0;35,0;1,0;;5,0;4,0;30,0;8,0;76,0;;4,0;84,0;61,0;27,0;30,0;9,0;11,0;22,0;4,0;30,0;;54,0;44,0;6,0;66,0;4,0;42,0;2,0;19,0;11,0;;;26,0;2,0;35,0;;9,0;6,0;66,0;32,0;34,0;66,0;11,0;2,0;59,0;21,0;1,0;;8,0;1,0;16,0;65,0;18,0;1,0;21,0;;66,0;39,0;21,0;48,0;8,0;3,0;10,0;1,0;20,0;4,0;23,0;11,0;11,0;;4,0;23,0;1,0;;107,0;50,0;25,0;10,0;4,0;13,0;27,0;52,0;18,0;16,0;;4,0;8,0;2,0;10,0;29,0;4,0;1,0;6,0;7,0;54,0;;11,0;7,0;9,0;7,0;3,0;36,0;23,0;9,0;7,0;19,0;8,0;1,0;6,0;68,0;8,0;6,0;75,0;17,0;11,0;;1,0;;2,0;32,0;20,0;3,0;17,0;5,0;12,0;33,0;12,0;10,0;71,0;3,0;9,0;6,0;10,0;4,0;12,0;;;25,0;;36,0;2,0;12,0;26,0;2,0;1,0;12,0;1,0;13,0;2,0;29,0;1,0;;2,0;7,0;;;;38,0;3,0;;1,0;7,0;6,0;4,0;79,0;2,0;2,0;;;2,0;2,0;1,0;7,0;2,0;53,0;1,0;4,0;8,0;;1,0;66,0;39,0;1,0;;;6,0;;4,0;1,0;4,0;;2,0;1,0;;42,0;7,0;5,0;5,0;;1,0;;11,0;11,0;1,0;;15,0;11,0;5,0;;1,0;2,0;43,0;2,0;;;;20,0;18,0;4,0;;1,0;;;1,0;7,0;5,0;;2,0;3,0;;4,0;1,0;1,0;;;;;5,0;;;7,0;2,0;1,0;;;9,0;;;6,0;1,0;5,0;;7,0;30,0;;;;52,0;1,0;1,0;;3,0;1,0;32,0;;5,0;;;16,0;;;24,0;;1,0;;5,0;;;;;
coordinate;4,0;;8,0;;29,0;;33,0;111,0;67,0;23,0;50,0;47,0;;19,0;33,0;4,0;12,0;4,0;28,0;15,0;;35,0;;28,0;2,0;;4,0;121,0;3,0;76,0;44,0;139,0;67,0;11,0;11,0;52,0;2,0;57,0;11,0;46,0;42,0;1,0;1,0;6,0;14,0;;;10,0;7,0;3,0;17,0;36,0;;5,0;3,0;453,0;77,0;3,0;3,0;7,0;;2,0;98,0;4,0;29,0;27,0;25,0;;;10,0;10,0;3,0;3,0;;;;;277,0;354,0;;;8,0;18,0;4,0;;;89,0;9,0;30,0;49,0;31,0;2,0;1,0;24,0;10,0;51,0;5,0;15,0;24,0;;38,0;769,0;;3,0;4,0;;;93,0;;;2,0;9,0;10,0;;1,0;2,0;;;;2,0;;;2,0;2,0;;;20,0;2,0;;;;;;;23,0;2,0;1,0;;;;;;;20,0;;2,0;5,0;51,0;3,0;;;;2,0;;1,0;2,0;2,0;2,0;1,0;19,0;;2,0;;;55,0;;3,0;14,0;1,0;;6,0;9,0;14,0;7,0;31,0;;;37,0;;;2,0;1,0;;3,0;;23,0;1,0;38,0;;47,0;;;;43,0;11,0;2,0;;;30,0;;;1,0;;6,0;;2,0;2,0;6,0;5,0;4,0;2,0;3,0;;;82,0;9,0;9,0;1,0;;;3,0;12,0;;;;;9,0;;2,0;;;;;;9,0;13,0;;8,0;15,0;;1,0;;13,0;;;1,0;;;;;;;;3,0;3,0;2,0;12,0;82,0;4,0;;4,0;3,0;;;1,0;;3,0;;;;;4,0;5,0;;1,0;11,0;;;;21,0;;;57,0;2,0;;2,0;33,0;160,0;10,0;;;12,0;1,0;25,0;;;;;1,0;;;;82,0;20,0;3,0;;;25,0;;;188,0;20,0;;;1,0;;4,0;;;;;2,0;;;;27,0;2,0;;;14,0;37,0;1,0;;;;;1,0;;5,0;;;32,0;;13,0;4,0;;8,0;1,0;;21,0;2,0;2,0;16,0;3,0;;;1,0;1,0;;;41,0;;;;32,0;15,0;2,0;2,0;1,0;58,0;;;;40,0;13,0;9,0;1,0;;;18,0;;4,0;3,0;5,0;;7,0;;5,0;;3,0;;8,0;7,0;;4,0;3,0;1,0;111,0;5,0;1,0;18,0;;;3,0;51,0;2,0;38,0;3,0;3,0;;12,0;2,0;;2,0;;7,0;24,0;;121,0;6,0;61,0;8,0;;24,0;1,0;;;15,0;3,0;8,0;;8,0;;;1,0;;;;4,0;;;1,0;;1,0;1,0;29,0;14,0;6,0;67,0;;;4,0;10,0;16,0;;;4,0;;17,0;;;;2,0;8,0;4,0;18,0;3,0;;129,0;;;34,0;;3,0;;8,0;;;7,0;;;;;;;3,0;25,0;5,0;3,0;6,0;;15,0;1,0;;14,0;68,0;;;;;;;2,0;3,0;1,0;;4,0;;;;;;;27,0;;;;;1,0;;;;12,0;2,0;;;1,0;;;;;;;;1,0;;;22,0;5,0;;;;;;;;2,0;4,0;;3,0;2,0;;;;2,0;;17,0;1,0;;4,0;120,0;;;;;;40,0;1,0;;;;2,0;6,0;;;;;;;;3,0;4,0;5,0;;;1,0;;;;2,0;;;;52,0;4,0;;;;2,0;3,0;;;8,0;;3,0;;;3,0;;;;2,0;;;;;;;;;;;;;;;;;;;;;;;10,0;1,0;;;;;;;;;;1,0;;;;;2,0;;1,0;;;;;;6,0;;34,0;;;1,0;;;2,0;;;11,0;;;;;5,0;3,0;;1,0;;;;;1,0;;73,0;;;;;;;;3,0;;3,0;;;6,0;22,0;;;;17,0;2,0;;3,0;;;;106,0;;1,0;;1,0;1,0;;;;;;;26,0;;;;5,0;;4,0;;;1,0;;21,0;;;3,0;1,0;14,0;;;15,0;;;2,0;13,0;;30,0;2,0;3,0;2,0;;;;5,0;2,0;47,0;148,0;9,0;2,0;;;;14,0;9,0;;6,0;6,0;;1,0;;13,0;;;;1,0;3,0;;;;2,0;;4,0;;;;8,0;8,0;;;;;;;3,0;;1,0;;;;;35,0;;;;;;;;;;;5,0;2,0;28,0;;;;;1,0;;;;;;1,0;;1,0;;8,0;1,0;3,0;;3,0;;;;;;5,0;;;1,0;9,0;1,0;;;;;3,0;;;;9,0;4,0;4,0;;15,0;2,0;5,0;7,0;;;1,0;2,0;;;;;;;;;3,0;;;;3,0;;;2,0;;;;;;;;;3,0;;;;;;2,0;;;;;;;;;1,0;;;;1,0;;1,0;2,0;;1,0;;;;4,0;4,0;;;1,0;;;;;;4,0;;;;;;;2,0;;;;;;1,0;;5,0;;19,0;;;;11,0;;;;;;;;1,0;;;2,0;3,0;12,0;;;4,0;;;;;;;;;4,0;;;;12,0;;;;;;;5,0;;;;5,0;1,0;1,0;;;;;29,0;;;;;
correct;3,0;;42,0;1,0;84,0;;27,0;99,0;58,0;112,0;45,0;27,0;;11,0;99,0;1,0;1,0;4,0;10,0;13,0;13,0;115,0;28,0;;246,0;;;159,0;3,0;41,0;43,0;97,0;153,0;15,0;66,0;1,0;;58,0;17,0;28,0;21,0;300,0;7,0;28,0;41,0;;5,0;12,0;41,0;10,0;15,0;113,0;4,0;11,0;3,0;1072,0;55,0;2,0;14,0;102,0;3,0;3,0;123,0;6,0;10,0;5,0;69,0;;9,0;50,0;94,0;17,0;4,0;8,0;;1,0;;14,0;99,0;12,0;2,0;98,0;27,0;23,0;;;128,0;6,0;;19,0;31,0;60,0;9,0;204,0;23,0;1,0;;2,0;69,0;2,0;9,0;69,0;;2,0;;;2,0;460,0;;;1,0;7,0;5,0;;5,0;49,0;;1,0;;37,0;;;13,0;22,0;;;88,0;;6,0;1,0;4,0;9,0;;;;5,0;;;;1,0;3,0;;1,0;4,0;16,0;3,0;19,0;105,0;5,0;;1,0;;3,0;;1,0;1,0;1,0;5,0;2,0;63,0;4,0;6,0;;;;;46,0;34,0;;1,0;11,0;12,0;8,0;4,0;33,0;;1,0;97,0;;;;1,0;1,0;4,0;;6,0;2,0;55,0;;47,0;;3,0;;10,0;;5,0;;;19,0;1,0;;7,0;;7,0;;1,0;5,0;;;4,0;4,0;1,0;1,0;;8,0;35,0;1,0;1,0;3,0;2,0;;5,0;16,0;;;;;;2,0;;;;10,0;4,0;19,0;36,0;;12,0;21,0;2,0;;;7,0;;;12,0;2,0;;;5,0;8,0;;;;3,0;;;15,0;4,0;;3,0;12,0;2,0;;1,0;;;;;;;3,0;1,0;;1,0;1,0;;;3,0;29,0;;4,0;1,0;12,0;;48,0;4,0;28,0;5,0;1,0;3,0;;5,0;4,0;;3,0;;23,0;;;;;17,0;7,0;1,0;;;11,0;5,0;;38,0;2,0;;;;;;;;;;;;;;4,0;;;2,0;1,0;4,0;1,0;2,0;11,0;;4,0;4,0;3,0;9,0;23,0;;3,0;2,0;36,0;248,0;5,0;5,0;3,0;;6,0;3,0;;22,0;;1,0;1,0;;13,0;;;19,0;4,0;;;1,0;3,0;;;23,0;1,0;1,0;2,0;1,0;39,0;;10,0;4,0;55,0;;1,0;6,0;18,0;1,0;11,0;;38,0;;10,0;;30,0;;8,0;1,0;;16,0;14,0;8,0;30,0;11,0;2,0;23,0;;;11,0;193,0;20,0;5,0;4,0;;;4,0;4,0;;7,0;;;3,0;6,0;44,0;;5,0;4,0;;9,0;11,0;;1,0;4,0;5,0;31,0;1,0;4,0;;1,0;;2,0;;;;;2,0;1,0;;2,0;;6,0;5,0;1,0;1,0;;;20,0;12,0;12,0;;4,0;;;13,0;;1,0;;;3,0;;7,0;6,0;;40,0;;;45,0;;;;29,0;;;;3,0;5,0;;;1,0;;6,0;2,0;6,0;;10,0;;3,0;3,0;1,0;16,0;39,0;;8,0;1,0;;;;2,0;4,0;5,0;;;2,0;3,0;;;;;19,0;1,0;;;1,0;;;;;;1,0;2,0;;6,0;;1,0;;;2,0;;1,0;1,0;18,0;;3,0;;;;22,0;;;;;;;;1,0;2,0;;;;;;2,0;;;7,0;122,0;;;;;;5,0;;;;;;;;;;1,0;1,0;;;;;49,0;2,0;;1,0;;;;;;;;1,0;;5,0;;;;;;;127,0;;;1,0;4,0;3,0;;9,0;;4,0;;;;;;;;;;;1,0;;;;1,0;;;;;;2,0;7,0;3,0;;5,0;;;;;2,0;;;;22,0;27,0;2,0;2,0;12,0;12,0;1,0;;;;;;;16,0;;2,0;;;3,0;7,0;2,0;139,0;;;;2,0;;;;1,0;1,0;;;;;;;17,0;7,0;20,0;;;;;1,0;;8,0;;;20,0;;;1,0;1,0;4,0;;1,0;;;7,0;;;;4,0;19,0;;3,0;1,0;;;;;2,0;;1,0;;1,0;;;1,0;;;;;1,0;1,0;1,0;9,0;;;;2,0;4,0;1,0;;6,0;2,0;;1,0;;3,0;3,0;1,0;;;;2,0;;12,0;;3,0;4,0;;1,0;;;;2,0;6,0;1,0;;;;2,0;1,0;8,0;;;;;;20,0;2,0;3,0;4,0;;1,0;21,0;2,0;1,0;;;1,0;;;;;;2,0;3,0;;;;1,0;;1,0;;;;3,0;;;;2,0;;;5,0;;4,0;;;;1,0;5,0;;;;1,0;;;;;;1,0;;2,0;2,0;6,0;;;;;;;;1,0;;3,0;;;;;3,0;;;;;;4,0;1,0;1,0;;;1,0;3,0;5,0;;18,0;;;;;;4,0;;3,0;;6,0;;;;1,0;;1,0;1,0;;;;1,0;2,0;;;;;;;;1,0;;2,0;;1,0;;;2,0;;;;;;;;;1,0;4,0;2,0;;;;;1,0;;;;;;4,0;;;;2,0;;;1,0;;;;;1,0;;;1,0;;;1,0;;;;4,0;;;;;;;;;;2,0;;10,0;;;;;;;1,0;1,0;3,0;;;4,0;;1,0;;25,0;;;;;9,0;;2,0;;;16,0;1,0;2,0;;1,0;;;;;;;;3,0;9,0;;;;;
correction;4,0;;188,0;;224,0;;60,0;157,0;99,0;63,0;29,0;55,0;;74,0;288,0;5,0;23,0;1,0;101,0;33,0;9,0;211,0;2,0;246,0;;3,0;13,0;227,0;3,0;46,0;73,0;94,0;298,0;27,0;53,0;;;91,0;18,0;12,0;9,0;69,0;52,0;19,0;13,0;;6,0;2,0;46,0;26,0;69,0;84,0;1,0;8,0;1,0;932,0;138,0;20,0;14,0;272,0;6,0;6,0;136,0;;9,0;40,0;95,0;;6,0;105,0;192,0;15,0;2,0;;;31,0;1,0;62,0;102,0;21,0;1,0;139,0;21,0;12,0;1,0;;35,0;2,0;21,0;44,0;47,0;64,0;22,0;119,0;11,0;5,0;;37,0;90,0;6,0;13,0;135,0;;1,0;5,0;;3,0;504,0;;;3,0;5,0;8,0;;11,0;35,0;;6,0;18,0;40,0;;;20,0;46,0;1,0;;75,0;;6,0;4,0;4,0;1,0;;;;7,0;8,0;;;6,0;;1,0;;5,0;38,0;6,0;10,0;52,0;39,0;;9,0;;11,0;10,0;65,0;;4,0;5,0;57,0;77,0;7,0;6,0;;;;;22,0;48,0;2,0;2,0;112,0;;35,0;2,0;37,0;4,0;;63,0;;;;;5,0;7,0;;15,0;10,0;48,0;;114,0;;;;7,0;;1,0;;;18,0;5,0;;9,0;;19,0;;11,0;41,0;2,0;10,0;31,0;2,0;;;;3,0;129,0;8,0;3,0;3,0;;;5,0;20,0;;;;2,0;;;;2,0;21,0;25,0;2,0;50,0;27,0;;52,0;26,0;;1,0;;1,0;;;9,0;3,0;1,0;;21,0;4,0;;;9,0;2,0;;;3,0;1,0;;2,0;36,0;3,0;;;;7,0;;;;1,0;4,0;;;;;;;8,0;10,0;;10,0;1,0;71,0;;89,0;29,0;84,0;35,0;;;7,0;;;3,0;29,0;;45,0;;;6,0;;52,0;1,0;7,0;;;23,0;3,0;;44,0;14,0;;;;;;;;;1,0;11,0;7,0;1,0;6,0;16,0;;1,0;1,0;;3,0;10,0;;7,0;;2,0;;11,0;6,0;12,0;;10,0;1,0;19,0;762,0;1,0;14,0;80,0;;51,0;;;23,0;;2,0;5,0;12,0;3,0;;;6,0;;;;2,0;23,0;;;1,0;;50,0;8,0;2,0;6,0;5,0;20,0;1,0;23,0;;;;6,0;5,0;10,0;2,0;21,0;4,0;22,0;1,0;20,0;;1,0;9,0;2,0;1,0;23,0;19,0;8,0;6,0;;;;;3,0;28,0;13,0;;6,0;14,0;;;5,0;;15,0;;1,0;1,0;4,0;50,0;;3,0;;;4,0;195,0;;3,0;19,0;9,0;9,0;6,0;;;30,0;;8,0;2,0;;;1,0;1,0;3,0;;;2,0;36,0;20,0;3,0;;;;70,0;15,0;5,0;;1,0;1,0;2,0;5,0;;3,0;;;4,0;;10,0;13,0;4,0;41,0;;;288,0;1,0;;;41,0;;;;;;;;1,0;;;;11,0;13,0;9,0;;44,0;30,0;3,0;14,0;9,0;21,0;13,0;18,0;;;5,0;5,0;4,0;15,0;1,0;;3,0;;2,0;;;;;;;;;;;1,0;;9,0;;;2,0;25,0;;;9,0;;3,0;;1,0;2,0;24,0;;14,0;;;;39,0;;;;1,0;;;;;3,0;;2,0;17,0;;;14,0;3,0;;9,0;106,0;;;;;1,0;6,0;2,0;3,0;16,0;3,0;;;;;;;3,0;;;;;45,0;1,0;;7,0;;;25,0;3,0;;;;;;13,0;;;4,0;;;;117,0;;;;11,0;10,0;;7,0;;6,0;;;;;;;;28,0;;;8,0;8,0;;;;;5,0;;;;;21,0;5,0;;;;;1,0;;10,0;;;;;7,0;;;;4,0;;1,0;;;;;;5,0;;1,0;;;;;1,0;290,0;;;2,0;;;;;3,0;;;;1,0;;;2,0;10,0;11,0;17,0;;1,0;;3,0;;;10,0;;;71,0;;1,0;3,0;3,0;8,0;2,0;;;;4,0;;;;1,0;54,0;1,0;2,0;;3,0;;;1,0;33,0;3,0;;;;;2,0;;;;;;;3,0;3,0;8,0;2,0;;2,0;;1,0;1,0;;5,0;1,0;;1,0;1,0;20,0;4,0;10,0;1,0;1,0;;8,0;;20,0;;2,0;5,0;;2,0;1,0;2,0;1,0;1,0;;7,0;;3,0;3,0;9,0;1,0;14,0;3,0;1,0;;6,0;;15,0;2,0;2,0;6,0;;;11,0;2,0;4,0;;4,0;1,0;;;;;;;;3,0;5,0;;6,0;;;;;;6,0;;;;;;;5,0;4,0;;1,0;2,0;3,0;;9,0;;;;1,0;;;;;;6,0;;;6,0;9,0;;;;;;;;1,0;;1,0;;;;;2,0;;;1,0;;;2,0;11,0;8,0;;;6,0;;9,0;;2,0;2,0;;;;;1,0;;2,0;;1,0;;;1,0;3,0;;1,0;3,0;3,0;;;4,0;;;;;1,0;;;;;;;6,0;;;2,0;3,0;;;;;1,0;;;;;7,0;;;;1,0;;;1,0;;;;5,0;7,0;;;;1,0;;;;;;;;;3,0;2,0;7,0;;;;;;;4,0;;;;;;;;;;;;;;;;;;;;;;;;6,0;;;;7,0;;;;;;;9,0;;;1,0;;;;;3,0;;;;;;;;;;;;;
correlation;1,0;;5,0;;1,0;;;24,0;17,0;1,0;;4,0;;5,0;12,0;;;;6,0;;4,0;;;;3,0;;1,0;13,0;;10,0;1,0;14,0;1,0;4,0;;;;;5,0;;;;;1,0;;;;2,0;;7,0;1,0;10,0;2,0;;;81,0;8,0;;2,0;1,0;;;16,0;;1,0;;;;;;;;;;;2,0;;7,0;18,0;;;1,0;;2,0;1,0;;7,0;3,0;;11,0;2,0;13,0;;2,0;1,0;1,0;;;2,0;;9,0;8,0;;;;;2,0;15,0;;;2,0;4,0;3,0;;;8,0;;;;;;;;1,0;;;7,0;;;;;2,0;;;;;;;;;;;;;;;4,0;16,0;;;1,0;;;;;;;;2,0;;;1,0;;;;;3,0;8,0;;;;;1,0;;2,0;;;1,0;;;;;;;;;;9,0;;3,0;;;;;;;;;;;;;;;;;;;;;1,0;;;1,0;;8,0;;;;;;2,0;;;;;1,0;;;;;;;;1,0;;;10,0;10,0;;;;;;;;;;;;1,0;4,0;;;;;;;;;;;5,0;;;;;;;;;;;;;;;;;;;;;3,0;;;;21,0;;;;;;3,0;;;;1,0;;;;;8,0;;;;;1,0;;;14,0;1,0;;;;;;;;;;12,0;;;1,0;1,0;;;;;13,0;;;;;3,0;;;;;;1,0;;10,0;;1,0;2,0;;;;2,0;;6,0;;;;;;;;;;;;;4,0;;;;;22,0;;1,0;5,0;;;;;;;4,0;;;;;;;;;4,0;;;;;;;;4,0;2,0;3,0;5,0;;;;5,0;;;;;;1,0;;;;;;3,0;;;;;;;;3,0;;;;1,0;2,0;;3,0;;;;;;;;;;;;;;;;;;;;;;1,0;;;1,0;;;;8,0;1,0;;3,0;1,0;;;;4,0;;;12,0;;;;;;;;;3,0;;;;;;;;;;;;2,0;;3,0;;;;;;;;6,0;;;;;;;;;;;;;;;;;1,0;;;7,0;1,0;;;;;;;;;1,0;;4,0;;;;;1,0;;;;;;2,0;3,0;;;;3,0;;;;;;;;;3,0;9,0;;1,0;;;4,0;3,0;;;;;;1,0;;;;;;;;;;;;;;;5,0;;;;;;;;;;;;2,0;;;1,0;;;;;;;;;;;;;;;;;;;;;;;;;;;;;;;5,0;;;;;;;;;;;;;;;;;3,0;;;;;;;;1,0;;;;;;;3,0;;;;;;;;;;;;4,0;;;;;;;;;;;1,0;;;;1,0;;;;;;;;;;;;;;;;;9,0;;;;;;;;;;;;;;;;;;;;;;;3,0;;;;;;1,0;;1,0;;;13,0;;;4,0;4,0;;3,0;;;;1,0;;5,0;;;;;;1,0;;;1,0;;;;;;;;;;;;;;;2,0;;;1,0;;;;1,0;;;;;;;;;;;;;;;;;;;;;1,0;;;;;;;;;;;1,0;;1,0;;;;;;;;;;;;;;;;;;;;;;;;;;;;;;;;;7,0;28,0;;;;;;;;;;;;;;;;;;;;;;;;;;;;;;;;;;;;;;;1,0;;;;;;;;;;;;;;;;1,0;;;;;;;;;;;;;;12,0;;;;1,0;;;5,0;;;;;;;;;10,0;;;;8,0;;;;;;1,0;;;;;;;;;;;;;;;;;;;;1,0;;;;;;;;;;;;;;;;;;;;;;;;;;;;;;
curve;3,0;;4,0;;20,0;;9,0;18,0;16,0;3,0;4,0;13,0;8,0;1,0;;2,0;;5,0;3,0;1,0;;10,0;4,0;;13,0;1,0;;13,0;1,0;3,0;2,0;13,0;13,0;23,0;11,0;;6,0;9,0;;1,0;5,0;;;3,0;;;1,0;1,0;70,0;1,0;14,0;20,0;;33,0;;25,0;10,0;1,0;1,0;20,0;3,0;;27,0;2,0;8,0;;6,0;9,0;;;10,0;1,0;4,0;1,0;2,0;;;11,0;55,0;;;;;;2,0;;9,0;;4,0;4,0;9,0;4,0;;2,0;;;;;19,0;;65,0;5,0;1,0;8,0;2,0;;1,0;16,0;;;1,0;3,0;;;;;;2,0;6,0;1,0;;;2,0;3,0;;;1,0;7,0;;1,0;11,0;3,0;;;5,0;;8,0;1,0;;;5,0;;;6,0;3,0;;27,0;11,0;8,0;;1,0;4,0;22,0;;;5,0;6,0;4,0;5,0;4,0;8,0;1,0;4,0;1,0;;3,0;9,0;6,0;;2,0;19,0;41,0;6,0;7,0;2,0;13,0;;6,0;;;;1,0;1,0;;1,0;3,0;3,0;20,0;;61,0;;2,0;;6,0;;2,0;3,0;;3,0;1,0;;23,0;2,0;8,0;;1,0;;;4,0;7,0;;;;;5,0;6,0;;1,0;;;23,0;3,0;;;5,0;;;;;;;;;2,0;9,0;12,0;4,0;;10,0;;;1,0;3,0;8,0;11,0;4,0;11,0;;;;;;;11,0;1,0;;;10,0;;;2,0;;38,0;;4,0;;10,0;;2,0;19,0;1,0;1,0;;;1,0;3,0;;;;1,0;;2,0;;;;1,0;;4,0;;5,0;;;;1,0;;7,0;;;;2,0;;;9,0;8,0;;3,0;10,0;5,0;;;28,0;1,0;;;3,0;2,0;2,0;;1,0;;;;;1,0;2,0;;1,0;;;;;6,0;;;;1,0;;;;3,0;;16,0;;1,0;28,0;;6,0;;2,0;5,0;1,0;;10,0;;;10,0;3,0;;;;2,0;;1,0;;;1,0;;;;;;;;1,0;;1,0;5,0;;;4,0;;4,0;;;;;10,0;1,0;;1,0;;6,0;;;1,0;1,0;1,0;5,0;1,0;;2,0;;;6,0;1,0;1,0;;12,0;;;1,0;;3,0;;;;1,0;;2,0;;;;;;1,0;;;;;4,0;;;;;;;;;;;;;1,0;;;1,0;10,0;3,0;2,0;;;1,0;6,0;1,0;2,0;;;;;;;;;3,0;;;5,0;;;;;11,0;;;;;;;;;;;;;2,0;1,0;;;;;;;5,0;7,0;2,0;4,0;;4,0;;;;;;;2,0;;4,0;;;;;;;;;;;;;;;6,0;13,0;;;;1,0;;;;;;;;;7,0;;;;;;;;;1,0;1,0;;2,0;;;3,0;;3,0;;;;;;;17,0;7,0;;;;;;;;;4,0;;;;;;;5,0;;;;;;25,0;;;1,0;;;4,0;;;;;;1,0;;;;7,0;;;;1,0;;;;;2,0;;;;;;;;;;;;2,0;;;;2,0;;;;;;;;3,0;;1,0;;;;;1,0;;;;;;12,0;;;1,0;;;;12,0;;;;;;;;;2,0;4,0;;2,0;1,0;3,0;;;;;;;;;3,0;;;;;;;;6,0;12,0;;;;;;;4,0;;;;;;;2,0;;;;;3,0;;;1,0;;;;6,0;;;;;;;;;;1,0;;;15,0;;;2,0;;;;2,0;;;2,0;3,0;;6,0;;8,0;;;3,0;;;;;;1,0;2,0;;;;;;;;1,0;3,0;;;2,0;28,0;;;;1,0;;;;;;1,0;;;1,0;;3,0;6,0;;2,0;;;;;;6,0;;;;;;;;;;1,0;;;;;;;;;;;;;;3,0;;;;;1,0;;;;;;;;;5,0;;;1,0;;;;;4,0;;;;;;;;;;;;;;;;;;;;1,0;;1,0;4,0;2,0;;;;;1,0;1,0;2,0;;;;;;2,0;;;;;;;2,0;;4,0;10,0;;;;;;1,0;;;;;;;;;;;2,0;;;;;;;;;;;;;;;;;;;;;;;;;;;;;;;;;;;;;;;;;;;;;;;;;;;;;;;;6,0;;;2,0;;4,0;;;;;;;;;;;;;;;;2,0;3,0;;;;;;;;;;;;;;;;;;;;;;;1,0;;;;
data;28,0;20,0;107,0;15,0;371,0;;20,0;979,0;157,0;939,0;28,0;98,0;3,0;93,0;392,0;68,0;31,0;18,0;143,0;108,0;104,0;654,0;121,0;159,0;227,0;13,0;13,0;;21,0;311,0;134,0;367,0;1366,0;146,0;922,0;50,0;27,0;85,0;13,0;832,0;65,0;92,0;49,0;204,0;9,0;73,0;2,0;34,0;57,0;46,0;94,0;1308,0;70,0;107,0;1,0;11128,0;913,0;51,0;23,0;366,0;10,0;29,0;844,0;21,0;63,0;15,0;194,0;;15,0;207,0;190,0;55,0;53,0;3,0;;23,0;;298,0;580,0;37,0;14,0;1005,0;317,0;179,0;36,0;;135,0;22,0;351,0;527,0;577,0;62,0;186,0;667,0;174,0;37,0;11,0;555,0;1249,0;7,0;47,0;545,0;2,0;656,0;18,0;5,0;23,0;1599,0;15,0;;91,0;66,0;191,0;19,0;63,0;29,0;;16,0;37,0;141,0;1,0;;23,0;210,0;;99,0;426,0;14,0;79,0;47,0;20,0;110,0;3,0;;36,0;102,0;6,0;1,0;;20,0;2,0;5,0;130,0;405,0;117,0;1,0;191,0;458,0;14,0;4,0;14,0;;2,0;;55,0;1,0;1,0;50,0;150,0;500,0;20,0;14,0;;1,0;35,0;1,0;73,0;257,0;34,0;13,0;12,0;15,0;280,0;19,0;83,0;4,0;;1230,0;3,0;9,0;3,0;18,0;37,0;37,0;;67,0;3,0;747,0;3,0;267,0;;;9,0;893,0;12,0;8,0;;;21,0;45,0;2,0;2,0;2,0;79,0;;17,0;28,0;4,0;42,0;10,0;28,0;18,0;91,0;27,0;39,0;409,0;597,0;;2,0;;24,0;123,0;1,0;54,0;;88,0;56,0;;;;;;2,0;8,0;64,0;48,0;;81,0;291,0;15,0;7,0;;104,0;2,0;44,0;35,0;36,0;30,0;;;11,0;160,0;;123,0;23,0;7,0;;98,0;54,0;1,0;64,0;9,0;34,0;;3,0;;55,0;1,0;;3,0;;11,0;4,0;17,0;19,0;125,0;243,0;;14,0;37,0;21,0;;15,0;19,0;;130,0;6,0;490,0;38,0;2,0;12,0;4,0;11,0;33,0;1,0;5,0;13,0;210,0;1,0;;32,0;;279,0;39,0;26,0;;;227,0;3,0;;174,0;112,0;9,0;5,0;3,0;;;;;;;138,0;;4,0;4,0;86,0;;1,0;112,0;9,0;172,0;9,0;1,0;4,0;18,0;14,0;5,0;52,0;20,0;5,0;;324,0;29,0;73,0;36,0;115,0;43,0;46,0;2,0;69,0;11,0;80,0;66,0;6,0;5,0;4,0;58,0;10,0;2,0;3,0;32,0;28,0;;6,0;158,0;187,0;6,0;80,0;18,0;18,0;23,0;;7,0;46,0;488,0;609,0;84,0;74,0;;60,0;94,0;134,0;17,0;59,0;13,0;23,0;102,0;40,0;20,0;1368,0;8,0;108,0;1,0;8,0;21,0;91,0;47,0;98,0;57,0;14,0;72,0;16,0;33,0;14,0;58,0;4,0;65,0;58,0;7,0;5,0;40,0;39,0;1,0;108,0;53,0;81,0;131,0;8,0;404,0;5,0;173,0;40,0;11,0;53,0;213,0;11,0;66,0;418,0;107,0;150,0;75,0;23,0;8,0;11,0;21,0;12,0;54,0;15,0;257,0;8,0;9,0;60,0;49,0;40,0;42,0;156,0;125,0;345,0;79,0;4,0;1,0;87,0;233,0;98,0;;296,0;160,0;16,0;83,0;8,0;20,0;40,0;24,0;32,0;38,0;67,0;4,0;11,0;156,0;;3,0;270,0;2,0;5,0;30,0;55,0;287,0;27,0;22,0;179,0;61,0;27,0;66,0;21,0;19,0;15,0;68,0;39,0;53,0;116,0;51,0;64,0;20,0;5,0;692,0;143,0;12,0;6,0;30,0;127,0;24,0;67,0;23,0;51,0;41,0;49,0;106,0;;8,0;1,0;;;30,0;284,0;373,0;129,0;47,0;65,0;34,0;10,0;;2,0;35,0;52,0;24,0;28,0;43,0;1,0;13,0;5,0;11,0;3,0;7,0;44,0;248,0;58,0;;6,0;10,0;18,0;;81,0;18,0;;;2,0;39,0;21,0;80,0;34,0;84,0;67,0;;14,0;289,0;;30,0;14,0;20,0;191,0;849,0;2,0;83,0;25,0;7,0;118,0;60,0;27,0;5,0;86,0;21,0;114,0;144,0;13,0;;34,0;1,0;24,0;;13,0;16,0;294,0;491,0;44,0;73,0;66,0;;124,0;37,0;196,0;111,0;;;12,0;;11,0;1,0;;34,0;8,0;9,0;1,0;95,0;;25,0;14,0;5,0;22,0;2,0;;;132,0;2,0;;17,0;7,0;78,0;14,0;3,0;25,0;2,0;;13,0;44,0;27,0;;;;152,0;4,0;4,0;2,0;3,0;46,0;10,0;;2,0;;7,0;;5,0;22,0;;1,0;;157,0;21,0;15,0;7,0;2,0;160,0;2,0;4,0;;;6,0;;14,0;37,0;9,0;60,0;;8,0;2,0;1,0;20,0;24,0;;1,0;1,0;3,0;;;;12,0;;6,0;17,0;5,0;1,0;12,0;13,0;45,0;85,0;168,0;15,0;;10,0;14,0;;;15,0;13,0;1,0;17,0;;;62,0;19,0;30,0;14,0;22,0;;2,0;35,0;;;8,0;1,0;376,0;2,0;34,0;10,0;22,0;11,0;36,0;1,0;5,0;12,0;2,0;4,0;14,0;;31,0;3,0;5,0;25,0;70,0;;;11,0;106,0;104,0;16,0;24,0;25,0;49,0;2,0;12,0;3,0;39,0;4,0;29,0;18,0;16,0;50,0;14,0;128,0;10,0;4,0;4,0;2,0;40,0;52,0;9,0;74,0;47,0;21,0;3,0;18,0;5,0;5,0;29,0;40,0;36,0;11,0;;38,0;39,0;31,0;31,0;3,0;4,0;5,0;5,0;90,0;73,0;18,0;12,0;18,0;13,0;11,0;5,0;55,0;;42,0;85,0;51,0;5,0;2,0;43,0;6,0;4,0;34,0;85,0;4,0;12,0;1,0;7,0;;3,0;3,0;;1,0;;80,0;2,0;16,0;78,0;7,0;7,0;35,0;7,0;64,0;;1,0;11,0;3,0;6,0;;11,0;17,0;32,0;49,0;17,0;4,0;;;24,0;11,0;32,0;38,0;36,0;1,0;;;4,0;;33,0;4,0;2,0;17,0;4,0;63,0;5,0;14,0;;13,0;;;2,0;11,0;15,0;52,0;15,0;;9,0;3,0;1,0;2,0;;21,0;3,0;1,0;1,0;14,0;;1,0;21,0;1,0;6,0;6,0;55,0;;2,0;9,0;15,0;1,0;;2,0;;3,0;;3,0;;;;1,0;3,0;9,0;;8,0;4,0;16,0;21,0;1,0;288,0;2,0;56,0;3,0;132,0;;;2,0;;;;25,0;44,0;69,0;19,0;13,0;14,0;8,0;6,0;29,0;6,0;9,0;;;111,0;37,0;4,0;4,0;85,0;33,0;14,0;16,0;9,0;;20,0;46,0;4,0;1,0;18,0;6,0;88,0;;;18,0;;1,0;7,0;39,0;56,0;2,0;12,0;4,0;;27,0;;15,0;;3,0;10,0;;1,0;;;;3,0;2,0;;1,0;8,0;;5,0;25,0;1,0;6,0;2,0;11,0;15,0;2,0;;;;;38,0;;26,0;8,0;;3,0;6,0;;14,0;2,0;;;58,0;;10,0;6,0;54,0;;4,0;;;
degree;1,0;;20,0;;42,0;3,0;60,0;68,0;13,0;19,0;10,0;1,0;;1,0;13,0;;;4,0;7,0;6,0;1,0;30,0;3,0;3,0;3,0;;1,0;21,0;;14,0;14,0;50,0;59,0;17,0;28,0;;3,0;38,0;71,0;18,0;12,0;4,0;;14,0;;5,0;2,0;137,0;24,0;;;18,0;;26,0;;221,0;22,0;1,0;9,0;76,0;2,0;6,0;88,0;1,0;6,0;3,0;5,0;;4,0;3,0;30,0;24,0;4,0;;;;;11,0;86,0;2,0;1,0;11,0;6,0;7,0;;1,0;14,0;;31,0;18,0;10,0;8,0;7,0;13,0;3,0;2,0;;4,0;2,0;1,0;43,0;66,0;;1,0;;;;57,0;;4,0;2,0;2,0;3,0;19,0;5,0;;;;;19,0;;;15,0;2,0;;1,0;9,0;;;3,0;5,0;1,0;4,0;;;4,0;16,0;;5,0;;1,0;2,0;;21,0;7,0;;20,0;21,0;4,0;8,0;1,0;2,0;11,0;;;15,0;10,0;10,0;19,0;13,0;1,0;3,0;1,0;;2,0;1,0;2,0;23,0;;6,0;16,0;9,0;23,0;7,0;59,0;11,0;;4,0;;;6,0;;1,0;1,0;5,0;39,0;15,0;17,0;8,0;21,0;;1,0;3,0;20,0;;19,0;;2,0;49,0;3,0;;5,0;;13,0;1,0;;18,0;6,0;2,0;4,0;2,0;1,0;;3,0;35,0;4,0;5,0;1,0;14,0;1,0;10,0;8,0;4,0;;;;1,0;;1,0;;;;5,0;1,0;1,0;390,0;6,0;3,0;25,0;1,0;3,0;;11,0;;1,0;;;;6,0;5,0;1,0;;;2,0;;;2,0;20,0;2,0;;9,0;3,0;3,0;;;;7,0;;;;;;;;;;;;142,0;5,0;;6,0;4,0;1,0;;25,0;5,0;23,0;5,0;1,0;;5,0;4,0;1,0;4,0;1,0;;6,0;;;4,0;;17,0;2,0;4,0;;;62,0;1,0;1,0;5,0;1,0;;;1,0;;5,0;3,0;1,0;1,0;;4,0;5,0;4,0;;12,0;;;;;6,0;1,0;;;;;12,0;12,0;;68,0;3,0;1,0;;5,0;6,0;;;1,0;9,0;10,0;8,0;;33,0;;;;;;;;3,0;3,0;;;;15,0;;9,0;1,0;;4,0;;4,0;3,0;1,0;3,0;1,0;21,0;;5,0;;5,0;;;;;4,0;3,0;;3,0;;5,0;26,0;;1,0;1,0;;15,0;6,0;;1,0;;;;;;2,0;11,0;;;9,0;;4,0;2,0;;;1,0;;18,0;1,0;2,0;;;8,0;10,0;;1,0;1,0;9,0;5,0;1,0;;;;;;;;;;;;;1,0;;7,0;;4,0;3,0;3,0;;;40,0;2,0;2,0;1,0;;;1,0;;;;;2,0;;5,0;2,0;;17,0;;;14,0;;;;9,0;;;;;5,0;6,0;;;;106,0;1,0;4,0;;;;;24,0;2,0;12,0;232,0;7,0;2,0;;;;;;2,0;6,0;8,0;;9,0;3,0;;;;;;;;;;;1,0;;1,0;3,0;5,0;;;8,0;1,0;;;;;;;;;;1,0;;;;;;;;;6,0;3,0;;4,0;13,0;;;;;;5,0;;2,0;;10,0;7,0;;;;2,0;77,0;;2,0;;;;;;;;10,0;;2,0;;4,0;;12,0;1,0;;3,0;;;1,0;;;;;1,0;;1,0;;;27,0;1,0;2,0;;;;;;1,0;3,0;;1,0;;;;;;;1,0;;;4,0;;;;1,0;;;;;1,0;;;4,0;1,0;2,0;3,0;;9,0;12,0;1,0;;;1,0;2,0;3,0;3,0;1,0;;;2,0;1,0;2,0;;1,0;5,0;;;;;6,0;10,0;5,0;;;2,0;1,0;4,0;;;;10,0;3,0;;;3,0;18,0;3,0;;4,0;;;;1,0;;;1,0;;;1,0;;;;;10,0;3,0;8,0;;1,0;21,0;9,0;4,0;6,0;;;;1,0;4,0;;;3,0;6,0;;17,0;;;;;;7,0;;2,0;;;;;;2,0;4,0;;;;;;5,0;3,0;;2,0;;;1,0;3,0;;;;27,0;;21,0;4,0;2,0;7,0;99,0;;;;;5,0;;4,0;;3,0;1,0;;;2,0;1,0;9,0;;;;14,0;1,0;;;1,0;1,0;3,0;7,0;;2,0;2,0;2,0;;10,0;9,0;;;;1,0;1,0;;;;;;1,0;;;1,0;;1,0;;1,0;;;12,0;;;;;5,0;;1,0;;;7,0;;;;;;;;;;1,0;;;;;;;;1,0;4,0;3,0;;;;;;;;;6,0;;;2,0;;;;1,0;;;;;;;;;1,0;3,0;4,0;;138,0;10,0;1,0;;4,0;;;;;;2,0;;;;;1,0;;1,0;5,0;;;;;;;;;;;;;;;;1,0;;;;;;;;;;1,0;;5,0;;;1,0;;;10,0;;2,0;;;;;2,0;2,0;;;1,0;;;;;;1,0;;;;;2,0;;3,0;2,0;;;;2,0;;;;4,0;;;;;;;3,0;3,0;4,0;;5,0;4,0;1,0;;;10,0;;;;;134,0;;3,0;;2,0;;4,0;1,0;3,0;;;;;;;;;;5,0;;;;;;;3,0;;;;;;
detect;4,0;;198,0;7,0;222,0;;53,0;338,0;51,0;124,0;22,0;39,0;;10,0;165,0;8,0;5,0;8,0;103,0;26,0;136,0;268,0;76,0;41,0;46,0;10,0;3,0;311,0;14,0;;1006,0;197,0;569,0;109,0;146,0;1,0;10,0;224,0;39,0;106,0;157,0;4,0;24,0;131,0;53,0;53,0;11,0;66,0;435,0;48,0;68,0;100,0;12,0;30,0;6,0;1426,0;214,0;6,0;37,0;316,0;3,0;18,0;517,0;10,0;13,0;14,0;192,0;3,0;24,0;119,0;153,0;19,0;12,0;6,0;4,0;32,0;2,0;137,0;906,0;58,0;9,0;139,0;73,0;20,0;1,0;10,0;205,0;1,0;13,0;68,0;501,0;50,0;79,0;374,0;47,0;13,0;2,0;57,0;46,0;7,0;119,0;215,0;;20,0;4,0;14,0;23,0;1055,0;11,0;3,0;38,0;23,0;56,0;10,0;27,0;3,0;2,0;1,0;2,0;115,0;;;51,0;94,0;4,0;3,0;324,0;12,0;101,0;4,0;18,0;14,0;7,0;3,0;1,0;512,0;15,0;;1,0;19,0;41,0;30,0;11,0;776,0;29,0;;38,0;159,0;50,0;;2,0;;2,0;4,0;30,0;13,0;5,0;39,0;47,0;180,0;18,0;24,0;4,0;8,0;28,0;7,0;181,0;269,0;25,0;3,0;69,0;20,0;115,0;41,0;320,0;20,0;2,0;140,0;;1,0;6,0;1,0;12,0;7,0;6,0;19,0;10,0;205,0;;153,0;;;68,0;69,0;8,0;26,0;;;64,0;1,0;;10,0;2,0;28,0;;42,0;38,0;15,0;13,0;10,0;6,0;3,0;2,0;1,0;35,0;151,0;36,0;;;;2,0;25,0;258,0;9,0;;13,0;11,0;1,0;;3,0;;2,0;16,0;10,0;39,0;49,0;;27,0;497,0;7,0;18,0;;28,0;10,0;1,0;19,0;4,0;8,0;;17,0;4,0;11,0;9,0;26,0;5,0;;;26,0;8,0;3,0;14,0;33,0;93,0;;;3,0;3,0;;;8,0;;8,0;6,0;3,0;3,0;14,0;3,0;;1,0;24,0;2,0;10,0;4,0;26,0;;345,0;49,0;715,0;26,0;3,0;2,0;4,0;6,0;65,0;2,0;2,0;7,0;121,0;4,0;;4,0;1,0;155,0;14,0;2,0;1,0;;55,0;9,0;;77,0;25,0;2,0;6,0;;;;;6,0;3,0;2,0;43,0;;;4,0;91,0;3,0;2,0;28,0;7,0;79,0;15,0;;101,0;16,0;8,0;3,0;13,0;7,0;175,0;;46,0;3,0;85,0;86,0;1,0;17,0;15,0;2,0;314,0;23,0;27,0;15,0;;6,0;10,0;;9,0;;1,0;37,0;6,0;1,0;14,0;40,0;69,0;5,0;13,0;17,0;33,0;18,0;;24,0;37,0;71,0;27,0;9,0;7,0;;9,0;49,0;45,0;4,0;15,0;51,0;58,0;11,0;20,0;5,0;86,0;28,0;82,0;13,0;3,0;40,0;74,0;17,0;207,0;64,0;2,0;47,0;1,0;13,0;21,0;30,0;145,0;11,0;38,0;6,0;13,0;1,0;1,0;;2,0;3,0;105,0;100,0;;97,0;7,0;69,0;8,0;1,0;27,0;166,0;11,0;9,0;13,0;6,0;88,0;54,0;5,0;3,0;7,0;;3,0;17,0;1,0;10,0;54,0;32,0;26,0;58,0;4,0;15,0;58,0;13,0;16,0;6,0;14,0;5,0;30,0;71,0;20,0;;4,0;6,0;4,0;20,0;;10,0;1,0;2,0;21,0;20,0;79,0;31,0;2,0;88,0;;1,0;94,0;;7,0;1,0;29,0;15,0;6,0;15,0;41,0;7,0;23,0;4,0;9,0;13,0;11,0;47,0;20,0;6,0;38,0;62,0;50,0;146,0;20,0;165,0;81,0;;74,0;1,0;2,0;4,0;3,0;16,0;22,0;7,0;33,0;2,0;3,0;22,0;;;;;31,0;42,0;37,0;6,0;2,0;1,0;5,0;;2,0;80,0;5,0;;12,0;8,0;;3,0;10,0;8,0;2,0;;10,0;3,0;2,0;2,0;31,0;2,0;1,0;;6,0;3,0;6,0;;;;5,0;;2,0;11,0;14,0;;9,0;4,0;;25,0;3,0;;62,0;136,0;17,0;12,0;;1,0;7,0;63,0;3,0;1,0;1,0;3,0;10,0;1,0;;;;;5,0;;3,0;;3,0;290,0;3,0;3,0;25,0;;3,0;7,0;1,0;14,0;;1,0;8,0;7,0;21,0;1,0;;3,0;;3,0;3,0;54,0;;;;20,0;;;;;25,0;2,0;;17,0;2,0;8,0;;;1,0;2,0;;2,0;1,0;1,0;;;;8,0;5,0;;;6,0;33,0;21,0;;18,0;;;;;3,0;;;;3,0;96,0;8,0;4,0;5,0;21,0;6,0;4,0;;;17,0;;;7,0;4,0;74,0;;1,0;;3,0;18,0;330,0;;;;3,0;;;4,0;14,0;4,0;61,0;5,0;8,0;12,0;11,0;4,0;8,0;89,0;4,0;;;;8,0;;;35,0;4,0;;;6,0;;21,0;3,0;5,0;14,0;3,0;1,0;9,0;9,0;1,0;;39,0;6,0;60,0;;69,0;3,0;20,0;7,0;4,0;16,0;6,0;10,0;;1,0;16,0;;5,0;;9,0;3,0;5,0;2,0;;10,0;11,0;31,0;2,0;10,0;6,0;9,0;1,0;11,0;4,0;50,0;2,0;1,0;39,0;29,0;13,0;3,0;58,0;9,0;1,0;1,0;8,0;;8,0;3,0;8,0;1,0;14,0;5,0;4,0;12,0;13,0;11,0;46,0;15,0;2,0;11,0;2,0;18,0;8,0;23,0;2,0;1,0;;24,0;13,0;170,0;2,0;3,0;1,0;11,0;1,0;1,0;74,0;6,0;1,0;52,0;13,0;4,0;;14,0;1,0;12,0;4,0;3,0;5,0;;;12,0;53,0;3,0;12,0;;;;11,0;4,0;2,0;25,0;;;21,0;;16,0;;1,0;12,0;2,0;8,0;;3,0;3,0;19,0;9,0;4,0;1,0;1,0;;9,0;4,0;3,0;6,0;12,0;;3,0;;2,0;;4,0;15,0;1,0;1,0;4,0;7,0;32,0;10,0;;;1,0;;1,0;;6,0;10,0;5,0;4,0;16,0;1,0;2,0;7,0;4,0;1,0;5,0;1,0;1,0;;19,0;3,0;20,0;;1,0;;23,0;;;5,0;18,0;;1,0;1,0;;;;24,0;;1,0;;;3,0;2,0;;;3,0;5,0;1,0;1,0;9,0;6,0;3,0;11,0;14,0;2,0;;2,0;;;;;21,0;3,0;5,0;37,0;1,0;10,0;21,0;18,0;;;;;4,0;4,0;;12,0;;7,0;28,0;68,0;5,0;1,0;10,0;4,0;1,0;;;1,0;;1,0;;3,0;;;1,0;3,0;;7,0;;9,0;;;;;;;;11,0;4,0;;7,0;3,0;2,0;7,0;;1,0;;;1,0;4,0;;62,0;6,0;3,0;1,0;;;;14,0;1,0;37,0;;18,0;9,0;;1,0;9,0;;;;;;1,0;;;;20,0;;;5,0;;
detection;5,0;6,0;95,0;7,0;113,0;;25,0;357,0;56,0;24,0;75,0;39,0;;12,0;88,0;;2,0;;7,0;9,0;7,0;194,0;44,0;43,0;73,0;1,0;2,0;134,0;14,0;1006,0;;84,0;428,0;123,0;64,0;19,0;;127,0;12,0;61,0;21,0;2,0;42,0;91,0;29,0;19,0;13,0;281,0;1268,0;20,0;17,0;143,0;4,0;70,0;3,0;551,0;207,0;13,0;24,0;185,0;26,0;19,0;278,0;3,0;11,0;8,0;261,0;;3,0;99,0;89,0;3,0;2,0;;;23,0;;236,0;383,0;13,0;1,0;150,0;21,0;13,0;;;319,0;2,0;8,0;181,0;234,0;31,0;10,0;378,0;23,0;6,0;50,0;28,0;17,0;23,0;70,0;277,0;;4,0;3,0;10,0;27,0;834,0;3,0;;29,0;20,0;61,0;7,0;11,0;1,0;;3,0;4,0;34,0;;;3,0;238,0;;1,0;136,0;5,0;83,0;9,0;10,0;2,0;1,0;;4,0;97,0;91,0;;7,0;11,0;6,0;1,0;2,0;350,0;22,0;;18,0;63,0;5,0;;10,0;;;7,0;9,0;;;8,0;10,0;212,0;2,0;2,0;;;16,0;9,0;56,0;116,0;11,0;;15,0;7,0;101,0;11,0;139,0;8,0;;413,0;;14,0;8,0;;13,0;1,0;;32,0;7,0;275,0;;110,0;;;32,0;61,0;2,0;13,0;;;21,0;;4,0;9,0;;24,0;;9,0;35,0;4,0;29,0;22,0;5,0;;1,0;;10,0;62,0;16,0;1,0;1,0;;6,0;11,0;99,0;1,0;;3,0;1,0;;;;1,0;;;31,0;31,0;23,0;;20,0;225,0;12,0;13,0;;30,0;4,0;;29,0;3,0;;;4,0;13,0;3,0;;35,0;1,0;1,0;1,0;35,0;1,0;;10,0;37,0;35,0;;;;1,0;;;1,0;;18,0;;1,0;;2,0;3,0;;4,0;14,0;;1,0;1,0;19,0;;198,0;18,0;358,0;5,0;2,0;11,0;2,0;14,0;20,0;;8,0;6,0;41,0;8,0;;7,0;;103,0;6,0;13,0;;;40,0;4,0;;57,0;17,0;;1,0;;;;;;;;5,0;3,0;1,0;;45,0;;;22,0;;60,0;;;25,0;;11,0;3,0;8,0;8,0;46,0;;16,0;1,0;78,0;44,0;;19,0;68,0;;124,0;12,0;13,0;1,0;1,0;8,0;1,0;5,0;6,0;;;18,0;3,0;2,0;6,0;27,0;96,0;;3,0;6,0;4,0;15,0;1,0;8,0;13,0;16,0;12,0;11,0;5,0;;16,0;16,0;9,0;2,0;3,0;9,0;21,0;2,0;6,0;3,0;25,0;2,0;45,0;27,0;;7,0;11,0;7,0;28,0;17,0;10,0;58,0;5,0;4,0;2,0;15,0;25,0;;6,0;5,0;2,0;3,0;5,0;;8,0;1,0;24,0;16,0;;39,0;5,0;29,0;12,0;;15,0;72,0;11,0;1,0;43,0;1,0;13,0;2,0;;4,0;7,0;;5,0;6,0;;1,0;37,0;4,0;12,0;4,0;2,0;4,0;42,0;20,0;22,0;9,0;4,0;;34,0;30,0;33,0;;2,0;28,0;5,0;4,0;;11,0;;1,0;9,0;1,0;39,0;6,0;4,0;43,0;3,0;;180,0;;2,0;;6,0;2,0;;13,0;5,0;5,0;1,0;;20,0;6,0;9,0;10,0;45,0;1,0;30,0;19,0;49,0;51,0;6,0;37,0;47,0;2,0;96,0;1,0;;2,0;;9,0;3,0;22,0;18,0;;1,0;4,0;2,0;1,0;;;6,0;18,0;11,0;;;;1,0;;;7,0;;;34,0;15,0;;7,0;2,0;15,0;;1,0;1,0;4,0;2,0;6,0;4,0;;;;1,0;4,0;2,0;;;;;;;6,0;5,0;2,0;;12,0;1,0;9,0;;;27,0;664,0;31,0;5,0;1,0;;4,0;21,0;4,0;3,0;;;1,0;1,0;;;3,0;1,0;5,0;;3,0;;1,0;40,0;2,0;1,0;28,0;;;5,0;3,0;7,0;;;;24,0;11,0;1,0;;2,0;1,0;1,0;;50,0;;;;21,0;9,0;;;;2,0;;1,0;;1,0;;;;;12,0;;23,0;;;;;;1,0;;;5,0;;31,0;19,0;;3,0;;;;;2,0;;;;1,0;22,0;;;;18,0;1,0;;;;4,0;2,0;;1,0;6,0;6,0;;;;2,0;4,0;139,0;;;2,0;;;2,0;4,0;14,0;4,0;7,0;1,0;3,0;2,0;;4,0;;32,0;8,0;8,0;;3,0;1,0;2,0;;18,0;7,0;3,0;5,0;4,0;2,0;15,0;1,0;4,0;12,0;1,0;;15,0;2,0;;;8,0;3,0;40,0;;13,0;2,0;11,0;5,0;;34,0;2,0;5,0;;;7,0;;3,0;;5,0;;6,0;;5,0;38,0;;18,0;1,0;1,0;2,0;2,0;;3,0;;15,0;1,0;;88,0;3,0;6,0;1,0;5,0;2,0;;;18,0;;3,0;1,0;;1,0;2,0;2,0;9,0;10,0;3,0;;11,0;17,0;;8,0;12,0;20,0;;15,0;1,0;1,0;3,0;;28,0;96,0;1,0;4,0;3,0;10,0;1,0;1,0;8,0;1,0;2,0;7,0;4,0;2,0;;2,0;;2,0;1,0;4,0;1,0;;;1,0;12,0;4,0;;;;;2,0;;;12,0;;3,0;10,0;;5,0;;2,0;;1,0;7,0;;1,0;7,0;5,0;4,0;;;;;8,0;2,0;;2,0;22,0;;;1,0;;;1,0;2,0;2,0;;8,0;2,0;9,0;88,0;1,0;;3,0;;;;31,0;;1,0;2,0;3,0;3,0;1,0;3,0;;5,0;;;2,0;;27,0;1,0;4,0;;1,0;;3,0;;1,0;;20,0;;1,0;5,0;;;1,0;3,0;;2,0;;;;;;1,0;3,0;6,0;2,0;1,0;1,0;1,0;16,0;9,0;2,0;;;;;;;;14,0;1,0;7,0;3,0;2,0;;;17,0;1,0;;;;3,0;1,0;;;1,0;2,0;1,0;16,0;1,0;;60,0;;;;;;1,0;3,0;;;;;15,0;9,0;;;;3,0;;;3,0;2,0;;1,0;;;;;;34,0;2,0;5,0;;;;;;8,0;;11,0;2,0;4,0;;;;;5,0;;3,0;;5,0;2,0;;;1,0;;;;3,0;;3,0;8,0;;;13,0;;;1,0;;
determine;9,0;;167,0;24,0;131,0;;46,0;633,0;80,0;291,0;83,0;95,0;1,0;75,0;197,0;7,0;28,0;13,0;98,0;95,0;237,0;333,0;139,0;97,0;94,0;14,0;13,0;367,0;50,0;197,0;84,0;;671,0;121,0;150,0;15,0;27,0;208,0;51,0;157,0;298,0;18,0;11,0;65,0;43,0;30,0;10,0;49,0;259,0;79,0;82,0;51,0;15,0;37,0;13,0;2056,0;262,0;13,0;55,0;254,0;7,0;64,0;820,0;24,0;53,0;48,0;84,0;2,0;50,0;180,0;122,0;34,0;20,0;3,0;1,0;10,0;5,0;333,0;922,0;40,0;5,0;179,0;189,0;31,0;29,0;2,0;165,0;14,0;37,0;107,0;192,0;45,0;89,0;231,0;97,0;28,0;11,0;35,0;72,0;14,0;65,0;290,0;;19,0;10,0;18,0;25,0;699,0;6,0;;44,0;30,0;20,0;22,0;7,0;25,0;;6,0;1,0;37,0;;1,0;20,0;75,0;;5,0;302,0;4,0;34,0;18,0;12,0;9,0;2,0;;7,0;45,0;8,0;;;31,0;36,0;21,0;15,0;197,0;55,0;;13,0;336,0;36,0;;4,0;;6,0;1,0;7,0;3,0;4,0;10,0;73,0;125,0;3,0;10,0;;1,0;15,0;1,0;119,0;282,0;2,0;7,0;18,0;20,0;87,0;21,0;199,0;11,0;;235,0;;;;1,0;7,0;12,0;1,0;24,0;15,0;305,0;2,0;129,0;;1,0;13,0;86,0;3,0;35,0;;;65,0;2,0;5,0;18,0;4,0;7,0;;9,0;9,0;13,0;26,0;16,0;23,0;13,0;3,0;2,0;44,0;345,0;33,0;;4,0;;8,0;64,0;5,0;4,0;3,0;5,0;34,0;;2,0;;;6,0;2,0;14,0;87,0;92,0;;39,0;284,0;43,0;1,0;;51,0;3,0;;54,0;23,0;3,0;2,0;;8,0;2,0;;16,0;;4,0;;40,0;29,0;1,0;6,0;23,0;39,0;;;;2,0;;;8,0;;;15,0;;30,0;13,0;3,0;;23,0;39,0;;;18,0;30,0;;195,0;52,0;639,0;39,0;;9,0;2,0;5,0;51,0;;;;103,0;8,0;;20,0;;162,0;5,0;4,0;;;296,0;;;220,0;79,0;1,0;;1,0;;;2,0;;5,0;5,0;11,0;4,0;1,0;;93,0;;;3,0;40,0;75,0;3,0;1,0;9,0;3,0;7,0;7,0;6,0;2,0;2,0;1,0;113,0;8,0;63,0;48,0;14,0;35,0;18,0;;154,0;23,0;35,0;30,0;12,0;16,0;17,0;10,0;10,0;1,0;;42,0;22,0;3,0;7,0;64,0;33,0;4,0;15,0;5,0;45,0;7,0;2,0;14,0;55,0;81,0;44,0;22,0;32,0;;6,0;37,0;17,0;17,0;62,0;13,0;41,0;47,0;108,0;11,0;60,0;12,0;65,0;18,0;2,0;42,0;183,0;71,0;219,0;134,0;2,0;78,0;10,0;13,0;29,0;88,0;37,0;97,0;121,0;36,0;56,0;20,0;3,0;;5,0;1,0;89,0;111,0;2,0;120,0;24,0;278,0;24,0;9,0;17,0;200,0;1,0;14,0;24,0;36,0;117,0;39,0;34,0;5,0;1,0;8,0;3,0;11,0;22,0;15,0;63,0;14,0;43,0;11,0;3,0;3,0;98,0;24,0;4,0;30,0;7,0;12,0;36,0;58,0;129,0;;4,0;15,0;1,0;53,0;;21,0;5,0;12,0;23,0;3,0;36,0;9,0;6,0;269,0;21,0;;115,0;2,0;2,0;;43,0;49,0;6,0;10,0;78,0;14,0;22,0;48,0;37,0;4,0;3,0;40,0;9,0;2,0;87,0;6,0;53,0;81,0;12,0;192,0;106,0;27,0;83,0;19,0;31,0;4,0;17,0;20,0;35,0;246,0;4,0;5,0;3,0;21,0;;1,0;1,0;3,0;127,0;36,0;3,0;;11,0;13,0;16,0;;10,0;35,0;1,0;2,0;78,0;13,0;8,0;;20,0;5,0;2,0;4,0;1,0;7,0;39,0;;26,0;11,0;11,0;;12,0;9,0;6,0;;2,0;4,0;6,0;2,0;2,0;49,0;11,0;;14,0;17,0;;55,0;8,0;;34,0;466,0;30,0;13,0;4,0;;7,0;114,0;6,0;1,0;8,0;11,0;8,0;8,0;;;1,0;;12,0;;5,0;2,0;10,0;203,0;17,0;5,0;39,0;;;2,0;46,0;16,0;;;5,0;;5,0;;;2,0;3,0;2,0;3,0;337,0;;;6,0;19,0;5,0;;;;5,0;5,0;5,0;1,0;;6,0;;;22,0;4,0;2,0;27,0;4,0;;;;;15,0;1,0;;;1,0;77,0;22,0;5,0;12,0;1,0;3,0;;3,0;6,0;;12,0;2,0;28,0;9,0;5,0;11,0;11,0;35,0;5,0;3,0;;;;;;40,0;1,0;149,0;;3,0;28,0;1,0;11,0;16,0;;;22,0;26,0;;2,0;8,0;25,0;3,0;3,0;77,0;2,0;32,0;1,0;1,0;77,0;74,0;38,0;;;4,0;19,0;;;23,0;13,0;;81,0;7,0;1,0;29,0;21,0;28,0;48,0;5,0;;5,0;10,0;7,0;1,0;55,0;7,0;90,0;4,0;34,0;13,0;26,0;12,0;1,0;4,0;3,0;29,0;2,0;2,0;42,0;;1,0;2,0;9,0;6,0;18,0;;13,0;10,0;35,0;57,0;14,0;7,0;;1,0;14,0;8,0;1,0;56,0;9,0;9,0;27,0;14,0;13,0;55,0;52,0;33,0;12,0;;18,0;11,0;23,0;13,0;19,0;57,0;16,0;20,0;9,0;6,0;4,0;10,0;16,0;38,0;9,0;8,0;6,0;60,0;8,0;343,0;5,0;;;14,0;23,0;55,0;11,0;1,0;3,0;3,0;2,0;9,0;32,0;5,0;2,0;47,0;15,0;4,0;;;2,0;7,0;22,0;8,0;2,0;2,0;1,0;4,0;9,0;10,0;13,0;11,0;15,0;7,0;20,0;2,0;8,0;57,0;1,0;7,0;12,0;4,0;35,0;;;23,0;4,0;15,0;1,0;5,0;30,0;40,0;;41,0;3,0;;;19,0;7,0;5,0;3,0;61,0;5,0;;;31,0;;15,0;;8,0;2,0;8,0;5,0;6,0;4,0;;1,0;6,0;1,0;3,0;5,0;10,0;16,0;33,0;9,0;2,0;10,0;4,0;10,0;2,0;7,0;2,0;;;;8,0;;15,0;;;;4,0;;1,0;;9,0;;41,0;39,0;2,0;;6,0;;;;;;3,0;;3,0;;4,0;10,0;4,0;12,0;8,0;19,0;18,0;5,0;4,0;2,0;;1,0;;4,0;;;6,0;;7,0;7,0;1,0;18,0;61,0;2,0;8,0;1,0;5,0;;20,0;32,0;1,0;22,0;;7,0;6,0;8,0;13,0;;19,0;10,0;;6,0;2,0;4,0;9,0;1,0;;13,0;;2,0;14,0;40,0;2,0;36,0;19,0;6,0;;5,0;1,0;;;6,0;1,0;32,0;1,0;2,0;;21,0;27,0;14,0;2,0;2,0;5,0;;;23,0;4,0;2,0;1,0;8,0;1,0;1,0;;;12,0;1,0;7,0;;6,0;5,0;7,0;12,0;;;;1,0;;15,0;7,0;;;;10,0;2,0;;;;
device;7,0;78,0;162,0;14,0;483,0;1,0;217,0;444,0;223,0;1664,0;99,0;75,0;14,0;26,0;347,0;36,0;20,0;29,0;119,0;197,0;120,0;2071,0;67,0;153,0;298,0;1,0;13,0;1366,0;59,0;569,0;428,0;671,0;;56,0;921,0;36,0;66,0;366,0;19,0;2366,0;185,0;25,0;248,0;334,0;21,0;39,0;16,0;73,0;295,0;69,0;170,0;420,0;38,0;168,0;12,0;7001,0;1572,0;33,0;69,0;1497,0;34,0;55,0;1111,0;6,0;33,0;86,0;278,0;9,0;12,0;429,0;975,0;64,0;66,0;89,0;11,0;132,0;10,0;220,0;976,0;209,0;36,0;1019,0;342,0;76,0;10,0;16,0;368,0;21,0;46,0;414,0;586,0;43,0;197,0;1072,0;99,0;80,0;1,0;666,0;532,0;175,0;493,0;1335,0;;267,0;21,0;18,0;70,0;1261,0;15,0;13,0;156,0;184,0;221,0;118,0;210,0;44,0;14,0;11,0;85,0;473,0;4,0;26,0;55,0;325,0;12,0;20,0;755,0;99,0;17,0;338,0;120,0;27,0;55,0;16,0;89,0;114,0;224,0;10,0;70,0;277,0;23,0;29,0;774,0;318,0;193,0;58,0;349,0;435,0;7,0;20,0;8,0;39,0;132,0;63,0;105,0;120,0;41,0;290,0;183,0;3869,0;35,0;30,0;23,0;13,0;21,0;178,0;82,0;1187,0;66,0;86,0;453,0;104,0;530,0;333,0;287,0;97,0;44,0;681,0;32,0;10,0;37,0;13,0;35,0;144,0;10,0;78,0;119,0;865,0;8,0;514,0;26,0;14,0;15,0;653,0;55,0;43,0;20,0;6,0;135,0;132,0;261,0;122,0;26,0;201,0;45,0;45,0;23,0;47,0;88,0;283,0;93,0;27,0;29,0;15,0;33,0;341,0;269,0;72,0;8,0;28,0;34,0;168,0;78,0;24,0;39,0;39,0;86,0;;;;24,0;25,0;56,0;35,0;273,0;130,0;8,0;95,0;304,0;42,0;178,0;6,0;47,0;37,0;35,0;47,0;45,0;33,0;6,0;65,0;44,0;62,0;26,0;569,0;15,0;15,0;29,0;216,0;21,0;6,0;58,0;555,0;22,0;23,0;34,0;14,0;68,0;19,0;5,0;27,0;31,0;84,0;9,0;51,0;76,0;167,0;20,0;16,0;62,0;155,0;75,0;17,0;30,0;213,0;4,0;179,0;143,0;456,0;215,0;35,0;35,0;10,0;29,0;70,0;2,0;29,0;147,0;287,0;24,0;5,0;670,0;2,0;181,0;77,0;143,0;9,0;4,0;186,0;54,0;30,0;94,0;69,0;30,0;24,0;24,0;3,0;18,0;9,0;18,0;40,0;18,0;258,0;55,0;39,0;8,0;170,0;10,0;40,0;136,0;14,0;429,0;23,0;3,0;5,0;10,0;30,0;11,0;64,0;10,0;35,0;9,0;201,0;7,0;33,0;156,0;31,0;61,0;57,0;11,0;127,0;51,0;171,0;349,0;67,0;1,0;13,0;27,0;10,0;3,0;45,0;13,0;10,0;4,0;12,0;192,0;90,0;25,0;17,0;98,0;13,0;91,0;4,0;2,0;138,0;145,0;351,0;29,0;63,0;;60,0;92,0;1364,0;43,0;320,0;77,0;12,0;36,0;66,0;63,0;583,0;25,0;150,0;34,0;55,0;292,0;86,0;50,0;160,0;42,0;3,0;163,0;;31,0;11,0;25,0;9,0;48,0;270,0;32,0;67,0;25,0;52,0;24,0;69,0;79,0;39,0;84,0;7,0;641,0;60,0;197,0;56,0;41,0;779,0;430,0;86,0;14,0;161,0;43,0;83,0;25,0;19,0;12,0;13,0;7,0;99,0;22,0;17,0;108,0;84,0;48,0;58,0;33,0;43,0;46,0;231,0;232,0;219,0;96,0;59,0;1,0;130,0;154,0;428,0;18,0;43,0;58,0;39,0;143,0;22,0;30,0;59,0;26,0;20,0;33,0;194,0;149,0;44,0;108,0;1,0;;390,0;3,0;7,0;32,0;4,0;144,0;79,0;101,0;67,0;37,0;12,0;38,0;40,0;7,0;111,0;192,0;115,0;9,0;202,0;35,0;286,0;172,0;50,0;937,0;251,0;118,0;81,0;17,0;52,0;19,0;28,0;8,0;21,0;200,0;79,0;1,0;10,0;13,0;46,0;19,0;41,0;103,0;83,0;671,0;139,0;112,0;19,0;20,0;64,0;13,0;50,0;41,0;72,0;2,0;244,0;132,0;16,0;20,0;32,0;18,0;16,0;27,0;151,0;146,0;13,0;15,0;71,0;293,0;18,0;1,0;44,0;36,0;43,0;15,0;11,0;70,0;22,0;18,0;50,0;24,0;54,0;36,0;32,0;221,0;5,0;94,0;33,0;27,0;141,0;552,0;35,0;47,0;7,0;1,0;9,0;141,0;122,0;17,0;27,0;20,0;57,0;94,0;21,0;7,0;1,0;25,0;36,0;3,0;21,0;;30,0;349,0;10,0;43,0;251,0;9,0;5,0;4,0;17,0;248,0;9,0;6,0;86,0;38,0;166,0;53,0;11,0;38,0;11,0;135,0;3,0;231,0;11,0;20,0;38,0;26,0;10,0;5,0;4,0;14,0;5,0;13,0;1,0;35,0;11,0;177,0;26,0;13,0;12,0;43,0;4,0;77,0;65,0;9,0;1,0;27,0;12,0;87,0;22,0;;102,0;22,0;200,0;16,0;7,0;100,0;20,0;11,0;6,0;7,0;9,0;11,0;9,0;6,0;15,0;6,0;11,0;10,0;10,0;51,0;120,0;14,0;23,0;9,0;9,0;1,0;21,0;31,0;16,0;98,0;3,0;20,0;4,0;19,0;37,0;107,0;1,0;9,0;9,0;60,0;4,0;31,0;22,0;31,0;69,0;11,0;11,0;2,0;;53,0;24,0;10,0;62,0;111,0;25,0;21,0;26,0;7,0;31,0;3,0;72,0;5,0;2,0;24,0;45,0;41,0;41,0;26,0;9,0;30,0;12,0;9,0;23,0;14,0;94,0;37,0;16,0;4,0;91,0;9,0;33,0;3,0;64,0;11,0;47,0;89,0;53,0;66,0;23,0;69,0;16,0;6,0;17,0;10,0;11,0;9,0;12,0;3,0;;58,0;32,0;47,0;10,0;6,0;60,0;76,0;1,0;27,0;11,0;28,0;17,0;19,0;119,0;27,0;93,0;20,0;46,0;7,0;5,0;15,0;64,0;10,0;20,0;4,0;10,0;15,0;30,0;39,0;91,0;10,0;16,0;42,0;62,0;12,0;13,0;4,0;31,0;6,0;14,0;162,0;49,0;14,0;26,0;6,0;57,0;76,0;29,0;21,0;76,0;10,0;11,0;1,0;36,0;6,0;61,0;42,0;52,0;8,0;4,0;25,0;11,0;17,0;19,0;105,0;7,0;22,0;9,0;15,0;31,0;23,0;9,0;;22,0;10,0;25,0;23,0;28,0;20,0;4,0;4,0;4,0;8,0;50,0;6,0;3,0;19,0;4,0;17,0;5,0;18,0;7,0;21,0;71,0;9,0;120,0;2,0;;249,0;17,0;5,0;58,0;70,0;12,0;11,0;;7,0;1,0;34,0;19,0;16,0;27,0;30,0;28,0;15,0;21,0;11,0;17,0;1,0;17,0;9,0;4,0;28,0;6,0;8,0;4,0;36,0;18,0;101,0;11,0;44,0;7,0;;12,0;45,0;5,0;23,0;15,0;6,0;13,0;55,0;9,0;32,0;;17,0;37,0;32,0;2,0;2,0;7,0;11,0;23,0;8,0;27,0;22,0;19,0;12,0;3,0;7,0;20,0;;8,0;1,0;20,0;13,0;10,0;27,0;;39,0;51,0;19,0;6,0;1,0;14,0;3,0;7,0;2,0;9,0;23,0;5,0;17,0;39,0;9,0;109,0;8,0;7,0;2,0;3,0;51,0;1,0;14,0;28,0;6,0;1,0;47,0;30,0;6,0;22,0;2,0;8,0;17,0;7,0;;1,0;17,0;22,0;32,0;4,0;10,0;9,0;;;14,0;13,0;16,0;4,0;29,0;11,0;;20,0;28,0;9,0;51,0;12,0;2,0;13,0;55,0;17,0;5,0;3,0;4,0;6,0;2,0;;2,0;1,0;3,0;15,0;9,0;6,0;3,0;15,0;43,0;1,0;2,0;2,0;4,0;;24,0;;;22,0;1,0;5,0;2,0;16,0;2,0;20,0;2,0;1,0;12,0;8,0;3,0;;14,0;4,0;1,0;;;1,0
difference;2,0;;52,0;;37,0;;2,0;142,0;196,0;51,0;9,0;47,0;;1,0;166,0;;16,0;6,0;102,0;10,0;10,0;25,0;11,0;15,0;27,0;4,0;23,0;146,0;17,0;109,0;123,0;121,0;56,0;;39,0;;1,0;29,0;;7,0;55,0;1,0;10,0;8,0;18,0;26,0;;12,0;29,0;24,0;59,0;81,0;3,0;6,0;10,0;667,0;35,0;9,0;24,0;24,0;1,0;1,0;127,0;14,0;16,0;4,0;19,0;2,0;2,0;19,0;17,0;8,0;3,0;;;2,0;;35,0;143,0;6,0;;22,0;21,0;23,0;1,0;1,0;84,0;1,0;15,0;20,0;38,0;16,0;6,0;129,0;6,0;8,0;;6,0;36,0;;18,0;44,0;;7,0;3,0;;14,0;93,0;4,0;;;2,0;20,0;;;2,0;;2,0;3,0;1,0;;;2,0;42,0;;;35,0;;23,0;;;7,0;1,0;;;10,0;;;3,0;;27,0;;2,0;1,0;30,0;5,0;15,0;222,0;;;4,0;1,0;;;;;;2,0;4,0;29,0;;17,0;2,0;;;4,0;107,0;12,0;2,0;4,0;1,0;3,0;8,0;1,0;15,0;;3,0;85,0;;;;5,0;;;;4,0;2,0;87,0;1,0;48,0;;;6,0;6,0;;7,0;5,0;;10,0;;2,0;6,0;;6,0;;26,0;1,0;;4,0;;14,0;;;1,0;5,0;95,0;4,0;;;;6,0;3,0;9,0;;;;6,0;;;;;;1,0;25,0;18,0;39,0;;9,0;73,0;7,0;;;10,0;;;7,0;;;;6,0;2,0;;2,0;4,0;;16,0;;23,0;2,0;;11,0;23,0;19,0;5,0;;;9,0;;1,0;;;2,0;2,0;6,0;;2,0;3,0;;1,0;;;;5,0;2,0;;46,0;4,0;101,0;3,0;1,0;;1,0;8,0;3,0;;;;4,0;;;;;91,0;1,0;;;;31,0;;;47,0;19,0;1,0;2,0;3,0;;;;;2,0;;1,0;;;;8,0;;;2,0;;1,0;12,0;;7,0;;;;6,0;3,0;11,0;3,0;25,0;1,0;28,0;51,0;;28,0;2,0;;19,0;;1,0;49,0;9,0;3,0;16,0;3,0;5,0;;;6,0;6,0;;2,0;22,0;85,0;;11,0;21,0;8,0;10,0;;8,0;20,0;9,0;6,0;18,0;2,0;;;10,0;;6,0;4,0;2,0;7,0;4,0;14,0;6,0;;;5,0;3,0;;;24,0;16,0;13,0;132,0;11,0;15,0;;1,0;20,0;30,0;8,0;1,0;2,0;;1,0;7,0;;;;;44,0;12,0;;16,0;1,0;7,0;1,0;;;2,0;;;3,0;11,0;15,0;1,0;10,0;;1,0;;5,0;5,0;;1,0;8,0;;1,0;;;1,0;2,0;7,0;;;1,0;;4,0;17,0;20,0;;;;;3,0;;1,0;;1,0;8,0;4,0;2,0;;;11,0;;;15,0;;;;85,0;2,0;;;;2,0;2,0;;;;;1,0;;1,0;24,0;1,0;2,0;14,0;;27,0;11,0;;31,0;1,0;;;6,0;7,0;3,0;3,0;;;3,0;4,0;;;;;13,0;;;;;;2,0;;;7,0;;;7,0;1,0;;11,0;;;;1,0;2,0;;15,0;;;;;;2,0;;;;2,0;;2,0;;1,0;6,0;5,0;;1,0;3,0;1,0;19,0;;;31,0;199,0;60,0;;;;;20,0;;;12,0;;;;;;;;;;;;;13,0;4,0;;4,0;;;6,0;7,0;1,0;;;1,0;2,0;2,0;;;1,0;;;;37,0;;6,0;;1,0;2,0;2,0;;;;;;;;;;;;1,0;;;3,0;;;;;;;;;;2,0;26,0;;;1,0;;;;2,0;;;;;;;2,0;1,0;14,0;4,0;;;;;;;10,0;3,0;3,0;;;8,0;2,0;5,0;6,0;;;;5,0;;;;18,0;1,0;;17,0;;;;;57,0;144,0;5,0;;;;9,0;;;4,0;15,0;6,0;12,0;;;17,0;;;4,0;5,0;1,0;;7,0;;;6,0;3,0;13,0;6,0;;;3,0;;1,0;2,0;;;;;;1,0;;;8,0;;7,0;;3,0;;1,0;28,0;;8,0;;;12,0;2,0;;12,0;1,0;;155,0;1,0;;;30,0;1,0;1,0;;;;;;2,0;3,0;2,0;3,0;2,0;3,0;7,0;1,0;2,0;8,0;5,0;;6,0;1,0;4,0;6,0;;;;;;50,0;;;1,0;1,0;;;;6,0;;11,0;;;;1,0;1,0;;;;;;;7,0;;1,0;;;;;;;8,0;9,0;;1,0;;;1,0;;;;;6,0;;;2,0;1,0;;;3,0;;;;1,0;;4,0;7,0;;;1,0;;;1,0;;;;;;;13,0;;2,0;;;;;;1,0;7,0;;;;3,0;;;3,0;;1,0;;;;;;;;;1,0;;;;3,0;;1,0;;5,0;;;;;;;;;;;;;5,0;;1,0;1,0;;;;17,0;1,0;;;;;;;;4,0;38,0;5,0;;;;;;;;;5,0;17,0;;;;;;1,0;;;1,0;2,0;;;;;;;;;;;;4,0;;16,0;;1,0;;1,0;;;;;;;;1,0;;;;;;;;;;;;;;45,0;;;;;;3,0;3,0;;1,0;3,0;;8,0;;;;;;19,0;;;;;;;;;;
digital;3,0;5,0;48,0;14,0;206,0;2,0;41,0;190,0;66,0;555,0;13,0;36,0;1,0;14,0;197,0;27,0;15,0;34,0;71,0;82,0;53,0;448,0;11,0;66,0;53,0;;11,0;922,0;28,0;146,0;64,0;150,0;921,0;39,0;;21,0;12,0;58,0;3,0;392,0;62,0;20,0;26,0;135,0;1,0;17,0;4,0;23,0;94,0;24,0;130,0;183,0;1,0;73,0;3,0;3908,0;551,0;3,0;18,0;566,0;12,0;31,0;757,0;5,0;15,0;27,0;60,0;2,0;11,0;171,0;198,0;33,0;36,0;12,0;9,0;33,0;21,0;51,0;155,0;54,0;3,0;283,0;321,0;73,0;1,0;5,0;111,0;7,0;64,0;163,0;362,0;53,0;91,0;1043,0;61,0;21,0;3,0;161,0;369,0;61,0;90,0;687,0;;101,0;11,0;10,0;47,0;556,0;1,0;7,0;36,0;47,0;146,0;58,0;50,0;18,0;1,0;11,0;37,0;124,0;10,0;4,0;5,0;134,0;19,0;2,0;186,0;22,0;3,0;78,0;51,0;37,0;4,0;5,0;31,0;89,0;60,0;;1,0;17,0;3,0;15,0;115,0;47,0;84,0;6,0;123,0;164,0;4,0;4,0;20,0;10,0;3,0;;13,0;41,0;18,0;85,0;30,0;514,0;9,0;28,0;10,0;13,0;25,0;15,0;44,0;212,0;8,0;20,0;68,0;71,0;581,0;106,0;52,0;23,0;7,0;349,0;19,0;;20,0;10,0;28,0;16,0;4,0;19,0;16,0;333,0;;264,0;7,0;2,0;12,0;216,0;12,0;4,0;;;24,0;22,0;26,0;30,0;2,0;43,0;10,0;19,0;8,0;1,0;23,0;54,0;29,0;18,0;3,0;3,0;5,0;207,0;148,0;26,0;1,0;8,0;17,0;20,0;17,0;10,0;10,0;61,0;17,0;;1,0;;2,0;;22,0;11,0;38,0;34,0;4,0;37,0;82,0;21,0;60,0;;20,0;24,0;20,0;33,0;79,0;44,0;6,0;11,0;18,0;48,0;4,0;92,0;28,0;1,0;2,0;105,0;16,0;3,0;17,0;32,0;26,0;7,0;10,0;;24,0;2,0;9,0;12,0;23,0;23,0;;32,0;24,0;84,0;12,0;;22,0;53,0;3,0;10,0;15,0;35,0;3,0;150,0;7,0;118,0;72,0;11,0;28,0;3,0;20,0;24,0;5,0;4,0;13,0;176,0;2,0;;82,0;1,0;132,0;9,0;10,0;5,0;2,0;62,0;3,0;26,0;62,0;49,0;13,0;7,0;6,0;;7,0;;2,0;3,0;7,0;20,0;8,0;13,0;;41,0;2,0;2,0;28,0;2,0;231,0;7,0;;;4,0;3,0;10,0;28,0;9,0;4,0;;89,0;1,0;18,0;38,0;37,0;11,0;27,0;4,0;60,0;11,0;26,0;47,0;3,0;2,0;7,0;39,0;;;26,0;13,0;8,0;6,0;2,0;52,0;37,0;3,0;6,0;45,0;7,0;17,0;1,0;3,0;42,0;96,0;254,0;18,0;10,0;;17,0;44,0;40,0;22,0;33,0;16,0;27,0;28,0;14,0;6,0;181,0;39,0;59,0;7,0;26,0;84,0;41,0;20,0;22,0;31,0;5,0;39,0;;19,0;5,0;11,0;3,0;7,0;150,0;17,0;4,0;7,0;38,0;3,0;34,0;20,0;29,0;20,0;2,0;98,0;11,0;74,0;17,0;5,0;60,0;196,0;22,0;12,0;33,0;41,0;145,0;44,0;1,0;1,0;25,0;15,0;3,0;138,0;25,0;28,0;41,0;58,0;14,0;23,0;13,0;39,0;81,0;56,0;165,0;50,0;12,0;3,0;36,0;53,0;84,0;2,0;78,0;12,0;3,0;44,0;18,0;9,0;;41,0;11,0;7,0;64,0;44,0;12,0;82,0;;;114,0;10,0;6,0;5,0;;128,0;5,0;7,0;2,0;20,0;86,0;19,0;10,0;;27,0;50,0;26,0;11,0;88,0;3,0;88,0;13,0;36,0;584,0;131,0;43,0;51,0;25,0;10,0;43,0;17,0;14,0;41,0;28,0;23,0;1,0;5,0;5,0;2,0;12,0;13,0;8,0;60,0;94,0;30,0;15,0;16,0;2,0;1,0;6,0;5,0;9,0;13,0;4,0;29,0;56,0;6,0;25,0;15,0;14,0;7,0;20,0;2,0;265,0;56,0;21,0;39,0;20,0;16,0;;23,0;16,0;16,0;;2,0;25,0;;5,0;9,0;7,0;38,0;1,0;16,0;90,0;1,0;34,0;10,0;10,0;180,0;261,0;22,0;88,0;;2,0;2,0;51,0;4,0;3,0;19,0;5,0;29,0;31,0;37,0;10,0;4,0;27,0;11,0;4,0;;;63,0;93,0;2,0;14,0;67,0;19,0;17,0;5,0;10,0;48,0;18,0;;2,0;20,0;23,0;21,0;;15,0;5,0;6,0;;106,0;5,0;5,0;9,0;43,0;4,0;1,0;;4,0;3,0;3,0;;26,0;13,0;54,0;11,0;10,0;7,0;4,0;;13,0;15,0;13,0;;5,0;1,0;35,0;25,0;;20,0;3,0;34,0;5,0;5,0;20,0;1,0;17,0;1,0;11,0;7,0;;2,0;1,0;6,0;7,0;5,0;13,0;4,0;19,0;30,0;8,0;2,0;8,0;14,0;1,0;3,0;4,0;;37,0;1,0;14,0;2,0;1,0;30,0;28,0;2,0;2,0;10,0;4,0;1,0;11,0;1,0;20,0;3,0;2,0;11,0;2,0;;4,0;4,0;16,0;28,0;22,0;2,0;;9,0;17,0;;2,0;9,0;6,0;;17,0;1,0;5,0;28,0;40,0;25,0;12,0;1,0;;1,0;19,0;2,0;7,0;1,0;;68,0;4,0;21,0;;40,0;20,0;10,0;7,0;13,0;4,0;6,0;4,0;10,0;2,0;44,0;7,0;8,0;4,0;6,0;18,0;;28,0;13,0;16,0;3,0;7,0;5,0;6,0;3,0;18,0;;17,0;7,0;1,0;30,0;8,0;11,0;8,0;62,0;16,0;;;4,0;;15,0;1,0;5,0;4,0;13,0;11,0;3,0;32,0;31,0;19,0;6,0;10,0;37,0;6,0;78,0;2,0;9,0;31,0;;2,0;1,0;1,0;13,0;23,0;6,0;16,0;3,0;3,0;10,0;;5,0;8,0;14,0;34,0;32,0;;1,0;9,0;;;15,0;23,0;9,0;10,0;3,0;3,0;9,0;;6,0;3,0;1,0;1,0;63,0;;28,0;1,0;13,0;2,0;;;21,0;;;5,0;141,0;8,0;;5,0;10,0;4,0;4,0;1,0;10,0;12,0;;16,0;12,0;18,0;11,0;22,0;2,0;4,0;;33,0;;9,0;2,0;5,0;1,0;12,0;17,0;7,0;2,0;;5,0;3,0;4,0;9,0;;3,0;8,0;7,0;;6,0;;17,0;2,0;17,0;10,0;1,0;1,0;8,0;4,0;13,0;1,0;28,0;;1,0;23,0;15,0;;5,0;28,0;8,0;;2,0;2,0;2,0;;9,0;5,0;;5,0;3,0;2,0;4,0;2,0;;2,0;14,0;5,0;24,0;8,0;85,0;;31,0;9,0;19,0;;2,0;;;1,0;;4,0;15,0;;4,0;;3,0;42,0;;7,0;3,0;;1,0;;22,0;10,0;13,0;;34,0;18,0;1,0;8,0;15,0;;6,0;46,0;2,0;21,0;;19,0;54,0;;;1,0;;1,0;11,0;2,0;3,0;2,0;4,0;1,0;;;1,0;11,0;6,0;6,0;2,0;12,0;1,0;;3,0;;3,0;;;2,0;;;;7,0;;3,0;;10,0;2,0;2,0;;;;6,0;4,0;;10,0;;;4,0;45,0;2,0;5,0;;;;31,0;;;;1,0;;1,0;;;
dimensional;1,0;;5,0;;2,0;;;35,0;3,0;14,0;6,0;3,0;;;4,0;1,0;;;2,0;19,0;4,0;2,0;52,0;1,0;;;;50,0;;1,0;19,0;15,0;36,0;;21,0;;2,0;15,0;5,0;51,0;2,0;;;19,0;;1,0;;2,0;14,0;4,0;8,0;45,0;;1,0;4,0;276,0;52,0;;2,0;14,0;4,0;;39,0;1,0;18,0;;8,0;;;7,0;7,0;6,0;2,0;;;4,0;;39,0;20,0;;;27,0;7,0;11,0;;1,0;;6,0;2,0;3,0;64,0;2,0;;7,0;3,0;34,0;;;3,0;4,0;15,0;35,0;;;2,0;2,0;7,0;30,0;;;3,0;34,0;115,0;6,0;;;;;2,0;2,0;;;4,0;10,0;2,0;;11,0;;;;;5,0;3,0;;1,0;11,0;29,0;;1,0;8,0;2,0;;9,0;;12,0;;24,0;13,0;2,0;;;;;;;;2,0;;2,0;52,0;;;;;;;1,0;17,0;1,0;;;1,0;6,0;1,0;2,0;;;6,0;1,0;;;;1,0;;4,0;25,0;;60,0;;2,0;;;3,0;12,0;;2,0;;;;;10,0;12,0;;;;1,0;;;1,0;;;;;;2,0;4,0;1,0;;;;2,0;6,0;;1,0;;;;;;;;;;4,0;;4,0;;2,0;7,0;;;;19,0;;;;;1,0;;;8,0;4,0;;;3,0;;;4,0;;;5,0;;22,0;;;;;;;;;;;;;;;;4,0;12,0;;;;7,0;;6,0;;72,0;2,0;;;1,0;;21,0;;6,0;5,0;;4,0;;;;6,0;7,0;1,0;;;7,0;;;;9,0;;;;;2,0;;;;;;;;;14,0;;;;;2,0;;;;;;;;;;;8,0;;3,0;;;;;;3,0;;;5,0;;;;4,0;;;12,0;8,0;;;;8,0;7,0;;1,0;2,0;4,0;;;;2,0;2,0;3,0;9,0;;;3,0;;13,0;;2,0;;;4,0;;1,0;1,0;;1,0;;;;;1,0;14,0;;;6,0;;1,0;3,0;8,0;;41,0;5,0;;;1,0;3,0;;;;2,0;1,0;;12,0;;42,0;;;;;;1,0;5,0;3,0;28,0;1,0;5,0;;;;;;;;;;;2,0;;6,0;9,0;3,0;4,0;;;;2,0;7,0;;;;;;1,0;;;;;;1,0;;;;6,0;;;15,0;3,0;1,0;;;3,0;;2,0;2,0;2,0;6,0;;;1,0;;9,0;;;4,0;;1,0;1,0;;5,0;30,0;;;6,0;;;;;6,0;5,0;;;;;;;;;11,0;;;;;;;;;;;2,0;;;;2,0;;;1,0;;;;;;1,0;1,0;;;2,0;;;;;;2,0;;;3,0;;;;;;;;;10,0;117,0;8,0;1,0;;;;6,0;;;;;;;;;;;;;;;3,0;6,0;;;;;;;;;;2,0;;3,0;;;;2,0;;;;;;;;;;;;;3,0;;;;;2,0;;;;;;2,0;;;;4,0;;;;;;;1,0;;;18,0;;;;;2,0;;;;6,0;;;1,0;;2,0;;;;;;;;;1,0;;;;;;;;;;1,0;;;;;8,0;;;;;;;;1,0;;12,0;;;;;;;1,0;;;;;;;6,0;;3,0;;;;;;2,0;;;9,0;1,0;;;10,0;;15,0;;;;;3,0;;;3,0;10,0;;;;;;;;;;;4,0;;2,0;5,0;;;;;;;;2,0;5,0;;;;;1,0;;;12,0;6,0;;;7,0;4,0;1,0;5,0;;;;;;1,0;;;;;;2,0;3,0;;;;;;;3,0;;4,0;8,0;6,0;;;;;;;1,0;;;;;;;2,0;;;;20,0;;;2,0;1,0;;3,0;;;;;;;;;;;;3,0;;1,0;;;;1,0;2,0;7,0;;6,0;;;;;;3,0;;;;;;;;;;;;;;2,0;2,0;1,0;;;;;;;1,0;1,0;;;;;1,0;;;;;;;;;;;;;;;;;;;;;2,0;;;;1,0;;1,0;;;;;;;;;3,0;;1,0;;10,0;;;;;;2,0;1,0;2,0;;20,0;;;;;1,0;;;1,0;;1,0;;;;4,0;;;;;2,0;;;2,0;;;1,0;9,0;;;;;;;;25,0;;;;;1,0;;;1,0;;;;;;;;;;;;;;;;;;4,0;;;;;;;2,0;;;;;;;;;;;;;;;
direct;1,0;;15,0;1,0;17,0;1,0;18,0;17,0;13,0;19,0;1,0;3,0;3,0;;6,0;;;;12,0;12,0;7,0;38,0;2,0;;;;6,0;27,0;3,0;10,0;;27,0;66,0;1,0;12,0;2,0;;101,0;;32,0;5,0;1,0;3,0;33,0;;;;6,0;7,0;14,0;;7,0;;23,0;2,0;214,0;33,0;;4,0;111,0;;2,0;39,0;;;12,0;1,0;11,0;;18,0;66,0;1,0;36,0;;;17,0;1,0;11,0;36,0;14,0;2,0;15,0;15,0;9,0;;2,0;10,0;;1,0;10,0;64,0;;7,0;34,0;;1,0;;2,0;1,0;10,0;69,0;36,0;;1,0;;;1,0;153,0;;;27,0;12,0;3,0;10,0;2,0;;1,0;;4,0;14,0;;5,0;;6,0;;;31,0;23,0;1,0;3,0;;;;;3,0;7,0;10,0;;9,0;19,0;13,0;3,0;5,0;9,0;16,0;;18,0;11,0;;;;;1,0;1,0;;1,0;;16,0;49,0;29,0;19,0;;;4,0;4,0;1,0;2,0;253,0;2,0;2,0;9,0;40,0;35,0;32,0;5,0;17,0;;11,0;6,0;;;4,0;2,0;;3,0;22,0;2,0;31,0;;26,0;;;52,0;29,0;;25,0;;;;;1,0;10,0;2,0;33,0;;;;;5,0;7,0;3,0;7,0;1,0;;2,0;5,0;14,0;;;3,0;;7,0;;10,0;5,0;14,0;10,0;;;;;;1,0;;2,0;19,0;2,0;;20,0;;2,0;;3,0;2,0;;;17,0;3,0;;1,0;2,0;;;16,0;;;;5,0;6,0;;1,0;5,0;1,0;;4,0;;1,0;;1,0;;7,0;6,0;;4,0;;4,0;;;12,0;4,0;;3,0;2,0;10,0;;;6,0;47,0;4,0;5,0;8,0;;4,0;5,0;;1,0;;3,0;;;1,0;;2,0;13,0;1,0;2,0;;15,0;8,0;;;1,0;;;10,0;4,0;;;;;;2,0;2,0;;;34,0;4,0;;4,0;;14,0;;1,0;;;2,0;;;;1,0;;4,0;;;;;;1,0;5,0;4,0;2,0;4,0;7,0;;;;;;;;1,0;;1,0;15,0;1,0;7,0;;;4,0;1,0;;;2,0;1,0;;9,0;;;;3,0;;8,0;1,0;12,0;8,0;;;;;8,0;1,0;5,0;;;2,0;;6,0;23,0;1,0;3,0;6,0;;;;13,0;1,0;33,0;1,0;1,0;;;1,0;;4,0;4,0;4,0;3,0;;8,0;24,0;18,0;2,0;2,0;6,0;13,0;5,0;;1,0;;12,0;;10,0;1,0;;;2,0;;1,0;2,0;;1,0;;;;;8,0;3,0;2,0;;;;9,0;51,0;26,0;6,0;;;7,0;14,0;3,0;;;;1,0;2,0;;4,0;4,0;3,0;;;15,0;;1,0;;;1,0;;;1,0;;;;1,0;;7,0;6,0;2,0;1,0;1,0;2,0;;;2,0;22,0;52,0;12,0;9,0;;4,0;4,0;7,0;;;11,0;;;;;;;;;1,0;11,0;10,0;;;;;;;2,0;1,0;;;2,0;2,0;3,0;2,0;;2,0;15,0;;;;1,0;;;;;;1,0;1,0;3,0;1,0;1,0;5,0;;2,0;1,0;;;3,0;;;4,0;3,0;1,0;7,0;3,0;2,0;;;1,0;1,0;8,0;;;2,0;;;;1,0;1,0;;1,0;;;;;3,0;10,0;;;4,0;4,0;;;;;;;3,0;1,0;1,0;1,0;;;;;6,0;4,0;;;;1,0;;;;1,0;;;;1,0;;5,0;;;;;;;3,0;;;;;;;;1,0;3,0;;7,0;;115,0;;;4,0;;2,0;4,0;;;2,0;;;1,0;;;;;;;;;;;1,0;1,0;;;;19,0;2,0;;;;;;;;;;6,0;;;;;;;;;;;;1,0;;1,0;;1,0;;;;;3,0;7,0;5,0;;;1,0;;;;1,0;;;1,0;1,0;;;;1,0;;;9,0;2,0;;;;;;;1,0;2,0;1,0;;3,0;;;;1,0;;;8,0;;2,0;;1,0;7,0;8,0;2,0;;;2,0;1,0;8,0;;;;;;3,0;;;1,0;;;2,0;;16,0;;1,0;;;;;1,0;1,0;4,0;;2,0;3,0;;2,0;;;;;;;;;;2,0;1,0;;;;;;;1,0;1,0;;3,0;;;;2,0;;;;;;3,0;;1,0;3,0;;;;6,0;;;1,0;;;2,0;;;1,0;;;4,0;;;2,0;;;2,0;7,0;1,0;;;;;6,0;;;;;6,0;1,0;1,0;;;;2,0;;1,0;;;1,0;;;;;4,0;;;2,0;;2,0;;;1,0;2,0;;;3,0;;;;;2,0;;;;;2,0;;;;;;;1,0;;;;;;3,0;2,0;3,0;;2,0;;;;2,0;;;;;;;2,0;;2,0;;6,0;;;7,0;;;;;1,0;;;;;19,0;10,0;;1,0;;;;;1,0;1,0;;;;;;;1,0;;;;;;;1,0;;;;3,0;;;;;;14,0;;;;3,0;;;;;;;;2,0;2,0;;;1,0;;;;;;1,0;;;;11,0;;;;1,0;;2,0;;;;17,0;;;;
direction;2,0;3,0;93,0;1,0;279,0;;1660,0;215,0;104,0;90,0;87,0;8,0;21,0;23,0;4,0;7,0;8,0;4,0;98,0;12,0;79,0;269,0;57,0;58,0;91,0;;9,0;85,0;38,0;224,0;127,0;208,0;366,0;29,0;58,0;15,0;101,0;;122,0;199,0;99,0;;223,0;158,0;21,0;;6,0;34,0;100,0;15,0;24,0;120,0;8,0;119,0;46,0;560,0;150,0;5,0;143,0;1038,0;40,0;30,0;170,0;1,0;;76,0;486,0;2,0;6,0;116,0;1481,0;54,0;53,0;19,0;3,0;17,0;8,0;203,0;457,0;20,0;23,0;46,0;26,0;11,0;;43,0;164,0;21,0;26,0;44,0;165,0;57,0;59,0;112,0;32,0;84,0;2,0;40,0;39,0;123,0;239,0;149,0;1,0;140,0;5,0;2,0;65,0;529,0;6,0;1,0;22,0;181,0;46,0;53,0;22,0;6,0;14,0;;36,0;203,0;3,0;7,0;52,0;37,0;1,0;;133,0;37,0;4,0;26,0;40,0;3,0;36,0;38,0;15,0;47,0;110,0;2,0;84,0;18,0;18,0;11,0;13,0;224,0;22,0;159,0;188,0;291,0;32,0;1,0;;95,0;215,0;10,0;95,0;62,0;149,0;42,0;13,0;300,0;27,0;28,0;25,0;21,0;1,0;45,0;5,0;185,0;4,0;1,0;964,0;73,0;117,0;93,0;241,0;47,0;47,0;110,0;1,0;5,0;8,0;12,0;32,0;17,0;25,0;171,0;139,0;240,0;4,0;608,0;1,0;31,0;14,0;97,0;7,0;64,0;;9,0;269,0;27,0;10,0;59,0;9,0;176,0;2,0;45,0;202,0;91,0;39,0;327,0;;17,0;9,0;10,0;133,0;53,0;28,0;16,0;51,0;12,0;19,0;52,0;51,0;1,0;28,0;;27,0;;6,0;13,0;13,0;;173,0;92,0;30,0;162,0;10,0;67,0;98,0;13,0;147,0;7,0;23,0;12,0;1,0;45,0;28,0;;150,0;182,0;112,0;1,0;10,0;103,0;22,0;;27,0;34,0;9,0;12,0;4,0;194,0;49,0;32,0;102,0;44,0;422,0;3,0;9,0;8,0;4,0;81,0;12,0;11,0;22,0;7,0;5,0;18,0;19,0;65,0;27,0;59,0;6,0;75,0;8,0;95,0;542,0;140,0;51,0;321,0;6,0;222,0;34,0;24,0;7,0;666,0;6,0;134,0;36,0;8,0;21,0;4,0;235,0;48,0;93,0;45,0;8,0;62,0;30,0;20,0;100,0;20,0;14,0;21,0;40,0;2,0;37,0;17,0;8,0;5,0;7,0;12,0;79,0;114,0;3,0;94,0;2,0;77,0;26,0;14,0;14,0;5,0;3,0;16,0;;9,0;6,0;2,0;4,0;31,0;29,0;15,0;;31,0;21,0;1,0;20,0;4,0;4,0;249,0;30,0;13,0;38,0;12,0;2,0;14,0;5,0;;6,0;;13,0;1,0;9,0;7,0;31,0;154,0;4,0;20,0;3,0;4,0;6,0;32,0;18,0;38,0;8,0;11,0;5,0;;1,0;247,0;13,0;70,0;3,0;8,0;16,0;55,0;5,0;9,0;2,0;16,0;9,0;36,0;137,0;2,0;59,0;43,0;12,0;45,0;1,0;8,0;4,0;;2,0;5,0;46,0;40,0;116,0;98,0;5,0;2,0;83,0;18,0;1,0;15,0;;2,0;3,0;;40,0;5,0;61,0;;4,0;27,0;6,0;;8,0;30,0;6,0;12,0;9,0;8,0;;;;1,0;2,0;2,0;4,0;4,0;17,0;9,0;85,0;2,0;4,0;83,0;18,0;29,0;18,0;42,0;;7,0;97,0;18,0;4,0;;;22,0;5,0;;3,0;1,0;7,0;7,0;13,0;18,0;446,0;3,0;39,0;1,0;2,0;62,0;4,0;10,0;1,0;5,0;11,0;;12,0;11,0;31,0;1,0;4,0;1,0;1,0;241,0;40,0;8,0;;22,0;42,0;47,0;5,0;20,0;45,0;196,0;47,0;21,0;;;;;1,0;4,0;10,0;7,0;;295,0;2,0;9,0;8,0;1,0;;8,0;7,0;11,0;10,0;1,0;3,0;2,0;1,0;4,0;6,0;13,0;;;;;;8,0;1,0;;6,0;17,0;;;32,0;3,0;4,0;2,0;;;;21,0;5,0;;40,0;1,0;;4,0;2,0;3,0;9,0;4,0;2,0;9,0;19,0;;5,0;17,0;235,0;3,0;1,0;1,0;5,0;12,0;196,0;1,0;2,0;;6,0;1,0;;;19,0;1,0;27,0;3,0;;11,0;2,0;;82,0;;1,0;35,0;5,0;;;10,0;1,0;3,0;;3,0;16,0;59,0;2,0;;1,0;20,0;4,0;4,0;9,0;8,0;;;4,0;5,0;3,0;1,0;;6,0;;4,0;1,0;;5,0;5,0;2,0;;2,0;;5,0;38,0;;;3,0;;12,0;;1,0;21,0;2,0;30,0;2,0;22,0;94,0;11,0;1,0;3,0;;9,0;7,0;11,0;;1,0;5,0;2,0;49,0;;8,0;2,0;;14,0;3,0;9,0;14,0;9,0;34,0;37,0;28,0;;;7,0;5,0;;69,0;4,0;4,0;37,0;6,0;4,0;;73,0;236,0;;6,0;;;;1,0;1,0;13,0;5,0;5,0;;;9,0;12,0;3,0;1,0;57,0;5,0;;12,0;3,0;25,0;261,0;7,0;2,0;8,0;1,0;;13,0;2,0;11,0;5,0;4,0;9,0;8,0;4,0;4,0;5,0;102,0;1,0;;10,0;15,0;;;42,0;;20,0;3,0;4,0;5,0;;1,0;;;18,0;1,0;8,0;5,0;3,0;4,0;4,0;11,0;;3,0;2,0;2,0;1,0;13,0;12,0;40,0;25,0;13,0;4,0;;16,0;27,0;;;;;4,0;7,0;65,0;28,0;3,0;;2,0;6,0;3,0;3,0;;3,0;3,0;5,0;25,0;1,0;61,0;2,0;;32,0;7,0;22,0;18,0;37,0;;1,0;;38,0;1,0;4,0;7,0;6,0;2,0;;;4,0;;99,0;1,0;1,0;;6,0;4,0;6,0;15,0;2,0;;18,0;2,0;;4,0;1,0;45,0;2,0;5,0;;1,0;116,0;4,0;;;;40,0;1,0;6,0;2,0;20,0;;;3,0;;;15,0;22,0;28,0;19,0;21,0;15,0;3,0;;;;2,0;64,0;;5,0;4,0;;66,0;6,0;7,0;;8,0;30,0;14,0;1,0;5,0;;;;6,0;10,0;65,0;6,0;14,0;38,0;7,0;13,0;7,0;;9,0;;1,0;2,0;1,0;;18,0;;96,0;;7,0;;19,0;35,0;23,0;2,0;11,0;79,0;10,0;;9,0;15,0;;;;;3,0;1,0;2,0;1,0;;;;11,0;1,0;36,0;;;;;;;2,0;22,0;;4,0;;8,0;;1,0;4,0;;14,0;1,0;;;5,0;;;10,0;38,0;;9,0;12,0;6,0;;2,0;;2,0;;1,0;;5,0;;;;;8,0;1,0;;39,0;6,0;1,0;;1,0;4,0;2,0;3,0;;2,0;;;23,0;37,0;5,0;;;2,0;;;3,0;6,0;1,0;;2,0;3,0;1,0;5,0;4,0;;3,0;6,0;;;4,0;;8,0;2,0;6,0;9,0;1,0;16,0;1,0;3,0;;;2,0;;2,0;;1,0;;;
displacement;1,0;1,0;62,0;;14,0;;31,0;61,0;44,0;7,0;10,0;1,0;;;;;5,0;4,0;;8,0;;13,0;11,0;17,0;18,0;5,0;;13,0;71,0;39,0;12,0;51,0;19,0;;3,0;5,0;;122,0;;13,0;17,0;13,0;13,0;18,0;17,0;1,0;4,0;;11,0;;3,0;7,0;;5,0;;192,0;12,0;;4,0;54,0;5,0;2,0;32,0;;;2,0;17,0;;1,0;;52,0;;1,0;;;;8,0;8,0;132,0;1,0;;1,0;12,0;;;;24,0;7,0;20,0;7,0;11,0;16,0;15,0;8,0;3,0;3,0;1,0;3,0;5,0;8,0;5,0;21,0;;2,0;;;1,0;48,0;;;2,0;5,0;3,0;1,0;;;;;4,0;7,0;;5,0;3,0;3,0;;;26,0;;;2,0;1,0;;;;;2,0;2,0;;;;;1,0;3,0;7,0;;8,0;4,0;61,0;;;;;14,0;;;4,0;;14,0;;13,0;2,0;;;;;1,0;;6,0;;;33,0;;13,0;1,0;18,0;1,0;;2,0;;;;;;6,0;1,0;6,0;1,0;40,0;1,0;17,0;;1,0;;2,0;2,0;;;;23,0;;;;;2,0;2,0;;3,0;;;2,0;4,0;1,0;;;5,0;1,0;;;;;;6,0;;4,0;;;6,0;;;;;;3,0;;2,0;14,0;;;18,0;;2,0;3,0;3,0;;;;;;;2,0;1,0;;;9,0;;2,0;1,0;;;;;12,0;;;;;3,0;2,0;;;;;;;;7,0;;7,0;5,0;1,0;2,0;;4,0;28,0;;15,0;17,0;26,0;3,0;19,0;;1,0;3,0;16,0;;2,0;;1,0;;;2,0;1,0;;4,0;;;;3,0;;;20,0;3,0;;3,0;;;2,0;2,0;;;;2,0;;9,0;;30,0;;4,0;1,0;9,0;3,0;;;1,0;;;;30,0;;107,0;;;;3,0;5,0;;;1,0;1,0;6,0;6,0;4,0;25,0;;;;;;;1,0;5,0;;;;;5,0;;6,0;;;;;;13,0;1,0;;;;;4,0;;2,0;;1,0;;42,0;;;;;1,0;3,0;6,0;;3,0;;2,0;7,0;;;3,0;;;;57,0;;;5,0;;;9,0;;;;;;3,0;;2,0;1,0;;;;;;;;;8,0;;34,0;1,0;;;;;;;;;;;;;;1,0;;;;2,0;;3,0;4,0;;;;;;;;;;;5,0;;2,0;;;29,0;;;4,0;;;;;;;1,0;3,0;;;;;;15,0;1,0;;;;;2,0;;;7,0;4,0;;;;;;;;;;2,0;;14,0;;;;;;;;;;2,0;;;;;;;;;2,0;;1,0;;1,0;;;;;;;;;;;2,0;;;;;6,0;3,0;;2,0;;;;;;;11,0;;;1,0;20,0;;;;;1,0;35,0;;1,0;;;;;;;;;;;;;;2,0;;;;;;;;;;;;;;;;;;;;1,0;;;;1,0;1,0;;;;4,0;;;;;1,0;;;;1,0;;;;;;;;;;;;;2,0;;;;;1,0;;;;;;;;;;;;;;;;;;;2,0;2,0;;7,0;;;;;;;;;;;;;;5,0;;;;;;;;15,0;;;;;;;;;;;;5,0;;;4,0;3,0;;;;;;4,0;;;;;;;;;;;;;7,0;;;;;;;;;;;;;;;7,0;;;;27,0;6,0;;;;;;;;1,0;;1,0;1,0;;;;;;;;5,0;;2,0;;1,0;;;;;;;;5,0;;;1,0;;;;;;;;4,0;;;6,0;;;;8,0;;1,0;;;;;;4,0;;;;;;;;;;;;;;;;;;;8,0;;;;;4,0;;;;;;;1,0;;;;2,0;4,0;;;;;;;;;;;;4,0;;2,0;;;;;;;;;;;;;;;;1,0;;;;;;;;3,0;;;;4,0;;1,0;;1,0;;;;;;;;;;;;;;;;;;;;;;;;;;;;;;;1,0;;;;;;;;;;;;;;8,0;;;;;4,0;;;;;1,0;;;;;;;;;;;;6,0;;;;1,0;;;;2,0;;;;;;;;;2,0;;;;;;;;;;;;;;;;;;;;;;;;;;;;;;;;;;;;;;;
display;3,0;3,0;54,0;5,0;614,0;;40,0;320,0;29,0;463,0;78,0;17,0;1,0;;80,0;26,0;3,0;2,0;174,0;88,0;106,0;1361,0;46,0;28,0;12,0;;1,0;832,0;18,0;106,0;61,0;157,0;2366,0;7,0;392,0;51,0;32,0;199,0;13,0;;86,0;1,0;30,0;223,0;23,0;10,0;9,0;33,0;136,0;29,0;68,0;246,0;9,0;34,0;2,0;7028,0;553,0;2,0;50,0;173,0;5,0;212,0;765,0;18,0;5,0;34,0;295,0;1,0;1,0;287,0;137,0;72,0;33,0;9,0;34,0;62,0;;132,0;475,0;49,0;2,0;247,0;145,0;31,0;18,0;1,0;549,0;8,0;66,0;435,0;100,0;28,0;65,0;384,0;115,0;20,0;18,0;108,0;242,0;59,0;293,0;458,0;4,0;26,0;9,0;1,0;31,0;2513,0;1,0;;135,0;132,0;38,0;87,0;24,0;3,0;;1,0;10,0;430,0;3,0;1,0;92,0;68,0;12,0;7,0;524,0;15,0;13,0;117,0;38,0;22,0;197,0;;5,0;23,0;82,0;1,0;12,0;24,0;3,0;27,0;83,0;171,0;15,0;3,0;133,0;319,0;19,0;6,0;6,0;;38,0;2,0;18,0;1,0;6,0;135,0;117,0;219,0;;27,0;5,0;13,0;19,0;62,0;121,0;196,0;18,0;40,0;87,0;45,0;169,0;112,0;41,0;56,0;61,0;421,0;;12,0;313,0;6,0;5,0;38,0;7,0;32,0;11,0;359,0;;697,0;;4,0;3,0;154,0;11,0;7,0;5,0;2,0;31,0;13,0;1,0;28,0;11,0;125,0;;21,0;8,0;1,0;21,0;84,0;3,0;51,0;30,0;;4,0;253,0;91,0;42,0;19,0;3,0;13,0;186,0;6,0;37,0;5,0;7,0;109,0;;1,0;2,0;14,0;;13,0;58,0;64,0;90,0;4,0;31,0;596,0;1,0;8,0;5,0;8,0;14,0;2,0;61,0;8,0;2,0;;4,0;5,0;16,0;3,0;111,0;8,0;6,0;4,0;55,0;44,0;;39,0;29,0;33,0;1,0;5,0;;26,0;1,0;;16,0;95,0;77,0;3,0;10,0;26,0;145,0;82,0;;19,0;38,0;3,0;;;50,0;1,0;87,0;48,0;397,0;86,0;41,0;6,0;3,0;28,0;60,0;;15,0;3,0;214,0;5,0;;98,0;;148,0;30,0;62,0;12,0;;83,0;54,0;11,0;123,0;49,0;4,0;;;;12,0;;;2,0;1,0;60,0;11,0;9,0;4,0;68,0;;;29,0;6,0;347,0;30,0;5,0;;1,0;;4,0;3,0;9,0;1,0;;121,0;6,0;40,0;14,0;18,0;13,0;25,0;8,0;211,0;38,0;46,0;29,0;4,0;13,0;7,0;3,0;2,0;;14,0;4,0;4,0;;;41,0;149,0;35,0;9,0;23,0;16,0;8,0;16,0;;31,0;157,0;117,0;16,0;;;43,0;78,0;62,0;8,0;51,0;;11,0;29,0;40,0;13,0;320,0;18,0;130,0;13,0;;15,0;36,0;50,0;105,0;12,0;20,0;28,0;3,0;3,0;;2,0;6,0;125,0;51,0;8,0;21,0;18,0;51,0;3,0;62,0;12,0;25,0;1,0;2,0;164,0;5,0;108,0;13,0;24,0;120,0;464,0;34,0;74,0;77,0;27,0;110,0;81,0;6,0;26,0;4,0;23,0;5,0;3,0;34,0;14,0;38,0;68,0;21,0;28,0;4,0;18,0;265,0;27,0;45,0;76,0;29,0;2,0;50,0;140,0;47,0;23,0;38,0;36,0;44,0;102,0;1,0;9,0;65,0;156,0;20,0;17,0;388,0;35,0;23,0;42,0;12,0;3,0;135,0;1,0;8,0;13,0;2,0;105,0;3,0;16,0;19,0;29,0;48,0;43,0;16,0;;46,0;1091,0;84,0;23,0;215,0;76,0;262,0;33,0;42,0;754,0;441,0;110,0;4,0;2,0;10,0;20,0;49,0;;3,0;63,0;8,0;1,0;1,0;;10,0;;33,0;22,0;46,0;114,0;14,0;10,0;50,0;3,0;23,0;;3,0;8,0;16,0;15,0;16,0;43,0;1,0;9,0;14,0;2,0;11,0;39,0;41,0;59,0;3,0;10,0;19,0;26,0;77,0;;25,0;9,0;3,0;8,0;29,0;29,0;14,0;22,0;2,0;26,0;19,0;;9,0;30,0;;41,0;12,0;34,0;151,0;107,0;2,0;16,0;5,0;;28,0;56,0;91,0;;15,0;;8,0;20,0;5,0;3,0;3,0;10,0;11,0;;25,0;3,0;23,0;297,0;5,0;14,0;252,0;;82,0;1,0;43,0;22,0;;;65,0;;4,0;1,0;7,0;4,0;13,0;16,0;2,0;25,0;26,0;5,0;2,0;11,0;;;;1,0;17,0;8,0;14,0;4,0;6,0;86,0;4,0;1,0;;3,0;;6,0;34,0;;1,0;2,0;;29,0;2,0;1,0;52,0;31,0;23,0;17,0;;11,0;;5,0;6,0;57,0;10,0;1,0;;1,0;14,0;;11,0;14,0;7,0;10,0;7,0;2,0;36,0;2,0;;;1,0;4,0;4,0;47,0;;2,0;;5,0;14,0;;1,0;;8,0;1,0;;39,0;26,0;17,0;42,0;;7,0;;14,0;3,0;;1,0;32,0;7,0;1,0;;40,0;6,0;;;9,0;5,0;5,0;63,0;;1,0;39,0;3,0;;18,0;;;58,0;8,0;6,0;;1,0;22,0;103,0;;30,0;19,0;8,0;13,0;63,0;;1,0;29,0;;194,0;14,0;;19,0;1,0;1,0;31,0;10,0;;;4,0;3,0;14,0;13,0;;7,0;111,0;1,0;6,0;;8,0;6,0;9,0;1,0;4,0;10,0;18,0;21,0;;5,0;4,0;33,0;68,0;5,0;1,0;6,0;8,0;;59,0;8,0;12,0;;5,0;11,0;24,0;3,0;4,0;;15,0;22,0;37,0;4,0;3,0;42,0;;28,0;5,0;11,0;8,0;27,0;14,0;7,0;42,0;56,0;2,0;9,0;20,0;42,0;1,0;;1,0;6,0;2,0;103,0;18,0;13,0;3,0;5,0;2,0;2,0;80,0;;;;45,0;62,0;;46,0;23,0;44,0;16,0;13,0;8,0;128,0;;3,0;33,0;4,0;12,0;;1,0;;3,0;1,0;5,0;72,0;;;31,0;81,0;67,0;120,0;18,0;2,0;4,0;3,0;;;20,0;6,0;;83,0;7,0;12,0;;5,0;;2,0;3,0;1,0;5,0;1,0;10,0;3,0;3,0;1,0;15,0;1,0;;3,0;;5,0;;;3,0;2,0;63,0;;;1,0;12,0;4,0;152,0;;3,0;1,0;27,0;;;;7,0;;;;18,0;;8,0;;6,0;2,0;;2,0;;;44,0;10,0;8,0;1,0;9,0;9,0;12,0;;2,0;;;6,0;;32,0;2,0;;98,0;51,0;13,0;51,0;4,0;12,0;7,0;5,0;8,0;;6,0;67,0;;;2,0;17,0;6,0;;4,0;5,0;47,0;7,0;;4,0;1,0;1,0;7,0;;;2,0;;13,0;3,0;4,0;;2,0;56,0;9,0;;;18,0;;10,0;19,0;;6,0;7,0;;;;2,0;;;;;;;2,0;1,0;2,0;2,0;3,0;9,0;13,0;;;33,0;;6,0;;;;1,0;1,0;6,0;;11,0;107,0;1,0;;17,0;;4,0;;3,0;;;1,0;;
distance;9,0;;20,0;1,0;45,0;1,0;137,0;233,0;189,0;59,0;160,0;4,0;;3,0;21,0;3,0;6,0;7,0;7,0;7,0;21,0;77,0;42,0;21,0;9,0;;5,0;65,0;12,0;157,0;21,0;298,0;185,0;55,0;62,0;2,0;5,0;99,0;17,0;86,0;;1,0;22,0;109,0;10,0;2,0;1,0;264,0;275,0;;47,0;30,0;;143,0;21,0;601,0;58,0;3,0;102,0;719,0;3,0;56,0;166,0;34,0;11,0;5,0;74,0;18,0;4,0;23,0;291,0;12,0;12,0;;2,0;29,0;3,0;277,0;334,0;9,0;2,0;19,0;21,0;27,0;2,0;3,0;86,0;23,0;60,0;47,0;109,0;15,0;122,0;31,0;30,0;64,0;5,0;16,0;49,0;7,0;210,0;210,0;;4,0;3,0;;;238,0;3,0;;8,0;25,0;20,0;7,0;7,0;6,0;;1,0;4,0;36,0;;;27,0;14,0;;;96,0;6,0;4,0;9,0;3,0;2,0;1,0;;8,0;18,0;15,0;8,0;6,0;17,0;4,0;1,0;6,0;43,0;10,0;4,0;11,0;60,0;7,0;;;;8,0;2,0;3,0;8,0;5,0;23,0;8,0;114,0;20,0;106,0;2,0;6,0;47,0;5,0;15,0;94,0;;1,0;31,0;20,0;79,0;30,0;86,0;14,0;6,0;45,0;;;;;4,0;3,0;2,0;67,0;3,0;76,0;;83,0;2,0;3,0;5,0;28,0;;17,0;4,0;5,0;25,0;3,0;7,0;3,0;3,0;166,0;2,0;12,0;2,0;1,0;3,0;24,0;9,0;1,0;1,0;;29,0;42,0;17,0;;11,0;3,0;6,0;31,0;1,0;9,0;9,0;2,0;19,0;7,0;29,0;;10,0;;4,0;26,0;81,0;55,0;;1,0;119,0;14,0;9,0;;2,0;9,0;1,0;27,0;;1,0;2,0;7,0;1,0;1,0;2,0;13,0;;5,0;1,0;40,0;14,0;4,0;22,0;23,0;7,0;3,0;2,0;3,0;32,0;1,0;;1,0;;18,0;4,0;3,0;;2,0;;;73,0;60,0;;6,0;12,0;7,0;;27,0;81,0;493,0;14,0;8,0;6,0;1,0;10,0;13,0;3,0;10,0;;79,0;2,0;;4,0;2,0;196,0;21,0;13,0;;;152,0;3,0;2,0;60,0;50,0;3,0;;28,0;3,0;2,0;;;;5,0;8,0;8,0;4,0;2,0;28,0;2,0;1,0;1,0;7,0;19,0;54,0;10,0;3,0;;;2,0;;;4,0;23,0;15,0;2,0;22,0;14,0;10,0;19,0;2,0;;61,0;79,0;8,0;47,0;13,0;;28,0;35,0;6,0;2,0;;56,0;9,0;1,0;6,0;23,0;26,0;1,0;3,0;3,0;13,0;9,0;6,0;1,0;294,0;9,0;11,0;3,0;1,0;2,0;17,0;17,0;22,0;4,0;8,0;2,0;1,0;;31,0;1,0;16,0;1,0;6,0;8,0;;10,0;10,0;7,0;127,0;4,0;20,0;15,0;;3,0;5,0;6,0;3,0;45,0;60,0;3,0;1,0;7,0;4,0;4,0;6,0;;2,0;13,0;;41,0;31,0;69,0;;;33,0;20,0;2,0;;4,0;3,0;75,0;1,0;;;;;1,0;;;;;;6,0;;;;15,0;;18,0;12,0;3,0;;9,0;40,0;7,0;;2,0;22,0;1,0;6,0;;12,0;2,0;;45,0;;12,0;8,0;;41,0;;1,0;24,0;;4,0;;15,0;;;14,0;7,0;4,0;;;5,0;;6,0;24,0;5,0;1,0;29,0;;1,0;6,0;;50,0;38,0;2,0;6,0;16,0;;;;3,0;11,0;25,0;2,0;;72,0;;;;;;15,0;10,0;4,0;;;;5,0;;11,0;29,0;3,0;;2,0;5,0;;1,0;1,0;;18,0;;1,0;;;;;;;;7,0;;5,0;;2,0;13,0;;;;9,0;1,0;;5,0;;;9,0;;1,0;11,0;128,0;;;4,0;8,0;;64,0;;6,0;5,0;;;;;6,0;;6,0;;1,0;;1,0;;243,0;3,0;4,0;10,0;1,0;;2,0;;;;;3,0;19,0;3,0;;;1,0;;1,0;1,0;6,0;;;1,0;;14,0;;;;2,0;7,0;1,0;;;6,0;;;1,0;;1,0;1,0;31,0;7,0;;;;6,0;;;13,0;19,0;40,0;18,0;3,0;7,0;;3,0;;1,0;;;7,0;7,0;2,0;1,0;;12,0;;8,0;3,0;;;;2,0;;1,0;32,0;;9,0;;;12,0;4,0;;;;;18,0;7,0;31,0;3,0;7,0;43,0;;;8,0;;3,0;;1,0;16,0;2,0;4,0;;;;3,0;5,0;;3,0;;14,0;8,0;6,0;1,0;28,0;11,0;3,0;7,0;1,0;2,0;3,0;2,0;4,0;10,0;;1,0;10,0;;9,0;2,0;17,0;2,0;7,0;;2,0;4,0;3,0;;6,0;3,0;2,0;;13,0;3,0;;;2,0;1,0;;12,0;;;;;15,0;3,0;;18,0;4,0;1,0;5,0;2,0;1,0;30,0;1,0;40,0;4,0;;2,0;10,0;12,0;2,0;5,0;2,0;11,0;11,0;8,0;6,0;10,0;;11,0;2,0;1,0;2,0;;3,0;;7,0;;;9,0;;6,0;4,0;22,0;;1,0;;;7,0;;;;5,0;3,0;3,0;;1,0;4,0;;27,0;;5,0;;;;;1,0;;;;8,0;;2,0;;20,0;;23,0;;7,0;37,0;;;1,0;;13,0;;;3,0;15,0;;;31,0;1,0;;40,0;3,0;16,0;6,0;99,0;;;;;;2,0;3,0;;;;4,0;;3,0;;2,0;2,0;3,0;2,0;;3,0;;;;16,0;;;9,0;;2,0;14,0;;1,0;;;;3,0;;;;4,0;;4,0;;2,0;1,0;9,0;5,0;1,0;;;7,0;;;;;4,0;;;;1,0;1,0;6,0;;;;;;;;1,0;12,0;;;;1,0;28,0;2,0;39,0;1,0;2,0;;;5,0;14,0;;2,0;2,0;;34,0;;;;;1,0;;;;;13,0;;2,0;2,0;;9,0;;1,0;;;14,0;;8,0;;;4,0;10,0;;;;;2,0;;;8,0;1,0;2,0;;5,0;6,0;2,0;;16,0;;4,0;;3,0;;3,0;;;;;2,0;;3,0;1,0;;;;1,0;;5,0;1,0;1,0;;;6,0;12,0;;1,0;1,0;15,0;5,0;11,0;;1,0;;
distortion;31,0;;2,0;;8,0;;26,0;15,0;7,0;23,0;7,0;;14,0;31,0;1,0;2,0;8,0;4,0;1,0;3,0;2,0;2,0;1,0;300,0;69,0;;;92,0;4,0;4,0;2,0;18,0;25,0;1,0;20,0;;1,0;;13,0;1,0;1,0;;;2,0;3,0;;;4,0;1,0;2,0;10,0;50,0;;;;235,0;32,0;11,0;4,0;75,0;2,0;;46,0;1,0;1,0;;1,0;;2,0;1,0;55,0;1,0;;3,0;;11,0;;6,0;9,0;7,0;1,0;26,0;33,0;1,0;;;9,0;1,0;8,0;7,0;12,0;;2,0;6,0;;;;14,0;57,0;;5,0;39,0;;;;;;13,0;;;;;2,0;;;;;;;1,0;;;;3,0;;;22,0;;;3,0;3,0;;;;;1,0;;;;;;;;;4,0;1,0;5,0;;1,0;;;;;;1,0;;;;;7,0;;1,0;;;;;;4,0;;;5,0;15,0;4,0;2,0;;;;3,0;;;;1,0;;6,0;;;;15,0;;;;;;3,0;;2,0;;;;;;;;;;;;;1,0;;4,0;1,0;;;10,0;;1,0;1,0;;;;1,0;;;;;;;;;;;;;1,0;37,0;;3,0;1,0;;;;4,0;;;1,0;;;;;;;;1,0;;1,0;;1,0;;;;;;;;;;1,0;;;;;;;;2,0;;;;1,0;;;;;;4,0;1,0;2,0;;;1,0;;;11,0;;;;3,0;1,0;;;;3,0;10,0;4,0;;;8,0;;;;1,0;;;;;;;1,0;;;4,0;;;;;;;;;2,0;;;;;;3,0;;1,0;1,0;;8,0;;1,0;;;2,0;9,0;;;;;;;1,0;;;;;;3,0;;;;2,0;13,0;;;;6,0;;;;;1,0;1,0;;;;1,0;;;1,0;4,0;;;1,0;;;;;1,0;;1,0;;2,0;;4,0;2,0;;;;;;196,0;1,0;;4,0;;;1,0;;;7,0;;;4,0;;;;4,0;;;;2,0;;;1,0;1,0;2,0;;5,0;;;;;;;3,0;;;;11,0;2,0;;;;;;;3,0;9,0;4,0;;;;;;11,0;;;;;;;11,0;;;82,0;;;19,0;;;;;9,0;;;;;;;;;;;;;1,0;;;;;9,0;13,0;;;;;;1,0;1,0;;;;;;;;;;;3,0;2,0;;;;;;;;;;;;;;;;;;;;;;;;;1,0;;;;;;;;;;;6,0;;;4,0;;;;;;4,0;;;9,0;;;;;;;;;;;;;;;;;;;;12,0;;;;;;;;;;;;;;;;1,0;;;;;;;;1,0;;;;;;;;;;1,0;2,0;;;;;;;;;;;;;;;;;;;2,0;;;;;;;;2,0;;;2,0;;;3,0;1,0;1,0;;;;;;;;4,0;;;;;18,0;;;;;;;1,0;;;;;;;;;;;;6,0;;;;;;;;;;;;;;;;;;;;;;;1,0;;3,0;;;;;;;;;;1,0;;1,0;;;;;;;;;;;;;;;;1,0;1,0;;;2,0;;;2,0;;;;;;;;;3,0;;5,0;6,0;;;1,0;;1,0;2,0;;;;;;;;;;;;;;;;;;;;;;;;;;;;;;;;;;;;;;;;;;4,0;;;;;;;;;1,0;;;;;;;;;;;;;;;;;;;6,0;;;;;;;;;;3,0;;;;;;;;;;;;1,0;1,0;1,0;;;;;;;;;;;;;;;;;;;;;;;;;;;;;;;;;;;;;;;;;;;;1,0;;;;;;;;3,0;;;;;;;;;;;;;1,0;;;;;;;;;;7,0;;3,0;;;;;;;;;;;;;;;;;;;;;;;;;;;;;;;;;;;;;;;2,0;;;;;;;;;;;;2,0;;;;;;;;;;;;;;;
drive;2,0;;29,0;;101,0;;150,0;37,0;22,0;39,0;15,0;2,0;2,0;;;5,0;3,0;16,0;20,0;1,0;5,0;468,0;1,0;7,0;52,0;;;49,0;;24,0;42,0;11,0;248,0;10,0;26,0;;3,0;223,0;13,0;30,0;22,0;;;161,0;12,0;9,0;;9,0;205,0;14,0;5,0;87,0;;38,0;;158,0;176,0;;6,0;716,0;16,0;;64,0;1,0;;376,0;69,0;1,0;;131,0;233,0;15,0;5,0;7,0;12,0;26,0;24,0;12,0;158,0;69,0;7,0;20,0;6,0;7,0;;4,0;16,0;;1,0;18,0;41,0;3,0;9,0;187,0;;6,0;1,0;8,0;8,0;12,0;30,0;235,0;;64,0;;4,0;11,0;495,0;9,0;;29,0;37,0;8,0;26,0;6,0;1,0;32,0;;18,0;41,0;;7,0;8,0;99,0;;;182,0;11,0;1,0;61,0;12,0;;;31,0;3,0;9,0;39,0;;38,0;3,0;;;14,0;12,0;30,0;168,0;55,0;171,0;;;;14,0;24,0;1,0;78,0;12,0;15,0;29,0;;78,0;2,0;1,0;3,0;5,0;1,0;1,0;3,0;40,0;2,0;5,0;431,0;239,0;28,0;40,0;73,0;32,0;11,0;88,0;;;11,0;4,0;12,0;;14,0;13,0;33,0;95,0;;140,0;;1,0;;49,0;;30,0;;;140,0;1,0;1,0;14,0;9,0;45,0;;;32,0;17,0;29,0;93,0;;8,0;;;128,0;83,0;73,0;1,0;4,0;22,0;4,0;25,0;57,0;;1,0;;;;;7,0;2,0;8,0;121,0;8,0;24,0;11,0;6,0;84,0;12,0;4,0;72,0;18,0;4,0;;11,0;7,0;;;1,0;113,0;1,0;;;86,0;2,0;1,0;5,0;6,0;1,0;1,0;;446,0;3,0;7,0;49,0;4,0;30,0;;3,0;1,0;2,0;3,0;9,0;2,0;5,0;19,0;1,0;40,0;8,0;6,0;5,0;27,0;13,0;489,0;8,0;13,0;119,0;49,0;23,0;7,0;14,0;7,0;3,0;6,0;11,0;5,0;;56,0;30,0;3,0;;;46,0;3,0;7,0;2,0;22,0;95,0;3,0;2,0;11,0;18,0;20,0;9,0;124,0;51,0;17,0;7,0;15,0;1,0;;13,0;146,0;5,0;;108,0;;15,0;22,0;3,0;1,0;4,0;32,0;2,0;;;2,0;2,0;1,0;3,0;2,0;32,0;6,0;28,0;35,0;1,0;4,0;6,0;;25,0;18,0;9,0;6,0;7,0;;1,0;;3,0;;1,0;4,0;;;4,0;3,0;1,0;;;1,0;;;3,0;5,0;4,0;1,0;12,0;;4,0;;31,0;28,0;19,0;;;50,0;6,0;6,0;4,0;;13,0;5,0;32,0;64,0;;175,0;13,0;28,0;46,0;;;13,0;;;;;18,0;;44,0;;1,0;;3,0;2,0;;;;;;19,0;12,0;;;;3,0;44,0;2,0;;15,0;;;3,0;;;9,0;;6,0;1,0;;;5,0;1,0;;3,0;2,0;;105,0;7,0;4,0;2,0;52,0;1,0;7,0;9,0;10,0;;2,0;3,0;4,0;8,0;;1,0;;2,0;6,0;3,0;2,0;94,0;;3,0;;;43,0;28,0;1,0;;;13,0;1,0;;1,0;;;;;;152,0;12,0;2,0;2,0;12,0;1,0;19,0;5,0;29,0;11,0;1,0;2,0;42,0;1,0;1,0;;5,0;2,0;2,0;42,0;;;20,0;;;;;;;;1,0;;;;2,0;;3,0;;22,0;;1,0;50,0;;;2,0;;;1,0;1,0;1,0;;;5,0;;;;;;13,0;;;15,0;1,0;3,0;;;3,0;4,0;;2,0;;21,0;6,0;;14,0;59,0;7,0;3,0;;;;23,0;;9,0;;2,0;;;;;;3,0;;;;;;11,0;;;1,0;9,0;;1,0;;;;;;3,0;48,0;;;1,0;1,0;12,0;;5,0;;;;4,0;;10,0;;;1,0;2,0;;3,0;4,0;3,0;1,0;;1,0;;5,0;;3,0;;;1,0;;39,0;;;11,0;;32,0;2,0;;7,0;33,0;1,0;2,0;;7,0;4,0;;;;1,0;;1,0;;1,0;1,0;;3,0;24,0;4,0;4,0;;2,0;2,0;;;;1,0;3,0;1,0;8,0;;;2,0;1,0;;;;14,0;;2,0;1,0;;;9,0;6,0;;;;;;5,0;1,0;;;58,0;1,0;;;;;9,0;1,0;2,0;24,0;;;;;;;;;5,0;;4,0;;7,0;1,0;;7,0;26,0;;;;;1,0;1,0;;9,0;;;;2,0;12,0;3,0;2,0;;10,0;;;;;;1,0;14,0;;11,0;;18,0;;;;;;5,0;;;;;;2,0;10,0;1,0;2,0;;;5,0;;1,0;;1,0;;;;4,0;21,0;2,0;;28,0;;13,0;35,0;1,0;;;4,0;;3,0;;;;;;2,0;;;;2,0;;;;2,0;;;;3,0;1,0;;3,0;;4,0;;1,0;4,0;;;;;1,0;;;;4,0;;;2,0;;;7,0;;;2,0;2,0;2,0;7,0;;4,0;;11,0;;;1,0;19,0;;4,0;;;12,0;;;2,0;;132,0;2,0;1,0;;;;;6,0;58,0;21,0;1,0;;8,0;3,0;16,0;2,0;;2,0;;3,0;;;;;;;3,0;1,0;;;2,0;;;1,0;13,0;11,0;;3,0;4,0;2,0;;;;;;;;;;;36,0;;;;;1,0;;10,0;2,0;;;;;;;;;;;;;;5,0;;;2,0;3,0;;;;2,0;2,0;;;;;;;3,0;;;;;;4,0;4,0;;;;;;;2,0;;;10,0;;;;;1,0;;;;;;;;;;;;;3,0;;10,0;;;3,0;;;;;;1,0;;;;;;;;;;;;1,0;;;;
element;5,0;1,0;38,0;1,0;113,0;39,0;245,0;153,0;11,0;327,0;76,0;7,0;3,0;14,0;67,0;2,0;3,0;4,0;16,0;19,0;33,0;369,0;6,0;28,0;19,0;1,0;3,0;204,0;14,0;131,0;91,0;65,0;334,0;8,0;135,0;19,0;33,0;158,0;18,0;223,0;109,0;2,0;161,0;;6,0;11,0;;171,0;47,0;42,0;43,0;115,0;11,0;370,0;13,0;1487,0;539,0;5,0;172,0;4201,0;25,0;8,0;173,0;2,0;;57,0;102,0;5,0;5,0;43,0;1426,0;46,0;65,0;31,0;11,0;16,0;115,0;52,0;399,0;206,0;11,0;94,0;14,0;18,0;17,0;10,0;174,0;9,0;4,0;138,0;328,0;18,0;6,0;306,0;19,0;47,0;;42,0;72,0;189,0;856,0;380,0;;47,0;;3,0;40,0;775,0;8,0;2,0;45,0;232,0;159,0;71,0;85,0;1,0;8,0;14,0;67,0;95,0;57,0;10,0;25,0;72,0;11,0;25,0;193,0;53,0;;125,0;72,0;1,0;43,0;9,0;12,0;208,0;232,0;;92,0;227,0;17,0;6,0;20,0;164,0;143,0;39,0;248,0;110,0;16,0;31,0;18,0;8,0;77,0;43,0;102,0;53,0;14,0;130,0;35,0;547,0;38,0;14,0;43,0;38,0;9,0;53,0;12,0;841,0;1,0;66,0;185,0;43,0;180,0;154,0;101,0;35,0;102,0;160,0;7,0;52,0;9,0;17,0;51,0;53,0;48,0;88,0;56,0;794,0;16,0;299,0;21,0;9,0;35,0;276,0;2,0;179,0;285,0;61,0;79,0;33,0;168,0;118,0;25,0;822,0;13,0;5,0;32,0;;79,0;267,0;19,0;15,0;7,0;5,0;17,0;97,0;69,0;120,0;1,0;13,0;20,0;130,0;64,0;10,0;12,0;13,0;24,0;13,0;;17,0;42,0;6,0;43,0;113,0;30,0;39,0;20,0;54,0;117,0;27,0;122,0;10,0;12,0;33,0;1,0;9,0;13,0;25,0;9,0;33,0;28,0;3,0;29,0;274,0;103,0;8,0;7,0;38,0;4,0;12,0;7,0;210,0;8,0;149,0;67,0;10,0;51,0;12,0;;8,0;8,0;48,0;18,0;4,0;30,0;24,0;9,0;4,0;25,0;80,0;46,0;28,0;4,0;33,0;21,0;64,0;116,0;364,0;42,0;47,0;3,0;2,0;21,0;19,0;2,0;56,0;193,0;37,0;9,0;7,0;17,0;3,0;88,0;16,0;6,0;24,0;7,0;24,0;134,0;51,0;117,0;118,0;13,0;22,0;61,0;2,0;21,0;7,0;25,0;13,0;14,0;112,0;50,0;13,0;1,0;38,0;16,0;37,0;25,0;7,0;25,0;9,0;1,0;;;20,0;10,0;9,0;8,0;1,0;12,0;26,0;3,0;1,0;15,0;2,0;5,0;8,0;4,0;43,0;41,0;6,0;5,0;6,0;2,0;;10,0;1,0;;1,0;2,0;1,0;;7,0;22,0;15,0;1,0;4,0;19,0;;3,0;1,0;1,0;22,0;8,0;93,0;38,0;;128,0;20,0;22,0;358,0;;7,0;25,0;7,0;;13,0;2,0;60,0;6,0;35,0;35,0;1,0;66,0;11,0;20,0;39,0;4,0;1,0;7,0;;3,0;6,0;5,0;8,0;11,0;136,0;;21,0;9,0;21,0;20,0;14,0;15,0;9,0;9,0;;23,0;10,0;59,0;3,0;;17,0;74,0;;6,0;36,0;5,0;7,0;31,0;4,0;;2,0;;4,0;16,0;2,0;1,0;3,0;4,0;2,0;;6,0;6,0;30,0;263,0;44,0;9,0;18,0;2,0;4,0;82,0;11,0;2,0;10,0;;;9,0;;3,0;19,0;3,0;4,0;1,0;13,0;169,0;;11,0;1,0;;33,0;4,0;3,0;;;11,0;4,0;2,0;;;1,0;;15,0;3,0;42,0;11,0;38,0;1,0;28,0;;90,0;57,0;15,0;37,0;172,0;10,0;37,0;20,0;24,0;3,0;;;7,0;65,0;32,0;;54,0;9,0;12,0;35,0;;;6,0;10,0;27,0;10,0;2,0;;;7,0;4,0;10,0;;;94,0;15,0;1,0;;14,0;5,0;;15,0;2,0;13,0;8,0;6,0;4,0;5,0;;;4,0;4,0;5,0;12,0;8,0;16,0;3,0;2,0;8,0;17,0;1,0;8,0;;12,0;7,0;25,0;2,0;2,0;117,0;200,0;1,0;5,0;;9,0;18,0;113,0;1,0;4,0;2,0;6,0;1,0;3,0;18,0;5,0;2,0;3,0;;2,0;2,0;1,0;1,0;77,0;17,0;;19,0;5,0;;;2,0;21,0;6,0;5,0;12,0;79,0;53,0;2,0;;83,0;1,0;6,0;;85,0;;4,0;;3,0;7,0;1,0;;7,0;7,0;2,0;;;1,0;3,0;104,0;2,0;1,0;6,0;1,0;7,0;41,0;2,0;4,0;16,0;2,0;24,0;66,0;;51,0;18,0;34,0;14,0;8,0;34,0;15,0;12,0;;3,0;1,0;81,0;;78,0;;;13,0;12,0;9,0;4,0;30,0;;3,0;11,0;2,0;14,0;18,0;15,0;11,0;54,0;2,0;;85,0;102,0;10,0;8,0;2,0;2,0;2,0;13,0;;;39,0;25,0;35,0;8,0;2,0;7,0;;19,0;40,0;11,0;46,0;1,0;16,0;18,0;;1,0;15,0;3,0;26,0;5,0;37,0;3,0;10,0;7,0;45,0;5,0;6,0;53,0;1,0;5,0;3,0;8,0;9,0;9,0;11,0;5,0;18,0;3,0;26,0;;27,0;7,0;8,0;29,0;19,0;;;48,0;;6,0;18,0;3,0;2,0;;1,0;3,0;3,0;5,0;;5,0;8,0;;;2,0;6,0;18,0;1,0;25,0;4,0;;23,0;1,0;1,0;3,0;15,0;43,0;;4,0;4,0;;1,0;;;;15,0;7,0;59,0;;9,0;;37,0;2,0;74,0;;2,0;8,0;4,0;5,0;7,0;10,0;26,0;;72,0;22,0;12,0;3,0;;;;4,0;;;2,0;2,0;2,0;33,0;;;1,0;;5,0;3,0;3,0;1,0;10,0;1,0;;4,0;;;2,0;5,0;3,0;;5,0;10,0;26,0;10,0;5,0;4,0;66,0;;;3,0;;3,0;;1,0;3,0;4,0;4,0;2,0;5,0;;8,0;28,0;;5,0;26,0;31,0;19,0;3,0;4,0;2,0;;6,0;5,0;81,0;11,0;23,0;4,0;1,0;11,0;4,0;;;11,0;8,0;;2,0;1,0;;;6,0;1,0;34,0;1,0;59,0;1,0;97,0;8,0;23,0;4,0;4,0;29,0;1,0;4,0;2,0;;3,0;1,0;7,0;1,0;7,0;1,0;2,0;16,0;3,0;;7,0;17,0;6,0;4,0;;14,0;14,0;7,0;;;1,0;2,0;35,0;15,0;5,0;;;2,0;5,0;17,0;;2,0;5,0;15,0;;11,0;;;5,0;19,0;;1,0;;12,0;3,0;;12,0;24,0;3,0;2,0;;;;9,0;2,0;12,0;;;;9,0;;;9,0;1,0;23,0;;;1,0;;2,0;;52,0;10,0;;16,0;5,0;;;24,0;34,0;25,0;7,0;;;2,0;5,0;1,0;2,0;;1,0;;8,0;;207,0;2,0;20,0;1,0;2,0;4,0;;;;;;;1,0;2,0;;36,0;1,0;;9,0;;7,0;;;;;10,0;27,0;;33,0;;125,0;;;4,0;
error;1,0;;5,0;;19,0;;7,0;36,0;20,0;9,0;;;;10,0;2,0;;;1,0;16,0;;1,0;7,0;14,0;41,0;13,0;;;9,0;;53,0;29,0;43,0;21,0;18,0;1,0;;;21,0;17,0;23,0;10,0;3,0;12,0;6,0;;;13,0;1,0;3,0;8,0;8,0;9,0;;3,0;;109,0;15,0;;1,0;11,0;;;63,0;15,0;8,0;;12,0;3,0;9,0;6,0;25,0;4,0;;;;2,0;;24,0;24,0;5,0;;11,0;3,0;1,0;;;2,0;;10,0;1,0;9,0;2,0;1,0;48,0;4,0;1,0;1,0;2,0;6,0;;;20,0;;2,0;;6,0;;14,0;;;;;;;;;;;;;;;;3,0;;2,0;8,0;1,0;;1,0;;3,0;;;;4,0;;;;;;;;;5,0;1,0;4,0;18,0;1,0;;;;;;;;;3,0;1,0;19,0;;1,0;;;;;;;;;12,0;2,0;6,0;;14,0;;;19,0;;;;;;;;;;16,0;;1,0;;;;1,0;;;;;3,0;;;5,0;;;;4,0;;;;;;;;;3,0;44,0;4,0;;2,0;;;;;1,0;;;;;;;;;;;2,0;10,0;;1,0;3,0;;;;6,0;;;;;;;;2,0;2,0;;;;;;6,0;;;2,0;;2,0;;;;3,0;;;;;;;;;1,0;1,0;;;;;;;2,0;;66,0;;49,0;;;3,0;1,0;1,0;;;;;5,0;1,0;;;;13,0;;;;;40,0;;;6,0;;;;;;;;;;;2,0;;;;;;1,0;;8,0;4,0;5,0;;;;;;2,0;;6,0;;1,0;;4,0;;;2,0;;;4,0;;3,0;7,0;1,0;;;3,0;;;;19,0;;;;1,0;7,0;;4,0;;12,0;;;;13,0;2,0;8,0;1,0;8,0;;;2,0;;;1,0;;1,0;;1,0;;3,0;;;3,0;;;2,0;2,0;5,0;33,0;;;;2,0;;2,0;9,0;;1,0;;;;;;6,0;;2,0;3,0;2,0;;1,0;3,0;;14,0;;;;;1,0;;5,0;;;;;;;;;;3,0;4,0;;;;;7,0;;;;;2,0;;2,0;;;;;;;;;;;;;;;1,0;29,0;;;33,0;;;;2,0;;;;2,0;5,0;;;;;;;;;4,0;8,0;2,0;;;2,0;3,0;;;;;;5,0;3,0;;;;;;;;;;2,0;19,0;1,0;;;;;;;;;2,0;2,0;1,0;;;;;;2,0;;;;1,0;;;;;;12,0;2,0;;;;;;;;5,0;;;;;;2,0;;;5,0;2,0;;;;;;2,0;;;;1,0;3,0;;;;;;;;;2,0;;8,0;;2,0;4,0;;;6,0;14,0;1,0;;;;;1,0;;;;2,0;;;9,0;;;;;1,0;;;;4,0;;;;;;;;;;;1,0;4,0;;;;;;;;;;2,0;;;;;;;;;;;1,0;2,0;;;;;;;;;;;;;5,0;;9,0;;;;;3,0;;;;;1,0;;;;;;;7,0;;;;;5,0;;6,0;;;;;1,0;;;2,0;;;;;;;;1,0;;;;2,0;;;;;4,0;;;;1,0;;;;;;3,0;;;;1,0;;2,0;;;;;;2,0;2,0;;4,0;4,0;;;;;;;;2,0;1,0;;1,0;;;;;;;;;7,0;15,0;;1,0;;;;5,0;;;;;;4,0;;7,0;;;;;;6,0;2,0;1,0;4,0;4,0;1,0;31,0;;4,0;;1,0;2,0;;2,0;7,0;;;;;;;;;;;;;;;;;;;;;;;2,0;;;;;7,0;;;;;;;;;;1,0;;;;1,0;;;;2,0;;23,0;;;;4,0;;;;;;;;;;;;;;;;;;;;;;;;;;;;3,0;;;;;;;;;;;;;;;;;;;;;;;;;;;;1,0;;;;;;;;;;;;1,0;;;;;;;;;;;;;;;1,0;;;;;;;;;;;;;;;;;2,0;;;;;12,0;;1,0;;;;;;;;;;;;;;;;;;;;;;;;4,0;;;;;8,0;;;;;12,0;;;;;;;;;;;;;;;;
evaluation;1,0;;2,0;;4,0;;1,0;66,0;117,0;43,0;;;;;3,0;2,0;;2,0;;;;42,0;;;;;;73,0;5,0;53,0;19,0;30,0;39,0;26,0;17,0;1,0;;;1,0;10,0;2,0;;9,0;11,0;;;1,0;10,0;145,0;;9,0;6,0;2,0;;;176,0;22,0;;4,0;19,0;;;33,0;1,0;4,0;;1,0;;;3,0;2,0;3,0;1,0;;;;;10,0;30,0;;;17,0;;;;;5,0;6,0;9,0;14,0;6,0;2,0;2,0;20,0;9,0;;;11,0;9,0;;1,0;24,0;;;1,0;;1,0;76,0;;;1,0;;1,0;;;6,0;;;;;;;;2,0;;;5,0;;7,0;2,0;;1,0;;;;1,0;;;;;;;1,0;6,0;;;7,0;6,0;;;;;1,0;;1,0;;;3,0;7,0;20,0;;;;;2,0;;1,0;4,0;;;1,0;;6,0;;16,0;2,0;;8,0;;;;1,0;1,0;3,0;;;;18,0;;10,0;;;;4,0;;2,0;;;;;;1,0;;;;8,0;3,0;;;;;;;;;15,0;;;;;1,0;;;;;;5,0;;;;;;;;4,0;;;;79,0;2,0;;;4,0;;;7,0;;;;;;;;11,0;;;;2,0;;;1,0;6,0;1,0;;1,0;;;;;;;;;;;1,0;1,0;;1,0;1,0;;;;;;;7,0;29,0;1,0;;;;9,0;1,0;;;;11,0;;;;;27,0;;;;;9,0;;;3,0;11,0;;;;;;;;;;;;;;;;;1,0;;4,0;7,0;;;;1,0;;;15,0;;;5,0;;2,0;;;9,0;;;40,0;2,0;;13,0;;11,0;6,0;3,0;;;;;36,0;;;2,0;6,0;2,0;2,0;;;2,0;;1,0;2,0;;2,0;1,0;3,0;;1,0;;2,0;1,0;4,0;;;15,0;1,0;;8,0;;8,0;;;;2,0;;13,0;5,0;;;;;6,0;;;;1,0;;7,0;;;;2,0;;;4,0;;6,0;;1,0;;;2,0;5,0;;1,0;3,0;;10,0;2,0;;;;;;;;;;;3,0;;;2,0;22,0;1,0;27,0;3,0;;;;3,0;3,0;;2,0;;;;;2,0;;1,0;9,0;;12,0;;;6,0;;;8,0;;;;1,0;;;;5,0;;;2,0;1,0;;;;1,0;2,0;2,0;;1,0;;;1,0;;1,0;;;;;;;1,0;;;;;;;;;;;;;;;;;;;;;;;;;;;;3,0;;;;3,0;;;;;;4,0;;;;;;;;;;;;;;;17,0;;;1,0;4,0;2,0;;6,0;;;1,0;;;;;1,0;;;;;;4,0;;;;1,0;5,0;2,0;1,0;1,0;;;;1,0;;;;2,0;;;;;;;16,0;;5,0;;;;;5,0;;;;2,0;;;;;;;;1,0;;;;;;;;;;;;;;9,0;;;;;;;;;;;;;1,0;;;;1,0;;;;;;;;;;;;;;;;3,0;;;;;;;;3,0;;;2,0;4,0;;;;5,0;9,0;;;;;;;;;4,0;;;;;3,0;1,0;;2,0;;;;;;;;;3,0;;1,0;3,0;2,0;1,0;;;2,0;;;;3,0;;;;1,0;;;;;;;2,0;;;;;;;;2,0;;;;;1,0;4,0;;1,0;;1,0;;;;;;;;;6,0;;;;5,0;2,0;;;2,0;2,0;;;;;2,0;;;25,0;;4,0;;;;17,0;1,0;;;2,0;27,0;;;;;;;;;;;;;;;;;;;;;;;;;;;;;;;2,0;;;;5,0;;;;;;;4,0;;2,0;;;;;1,0;;;;;;;;;;;;;;;;19,0;;;;1,0;;;;2,0;1,0;;;;;;;;;;;;;;;;;;7,0;;;;;;;;;;;;;;;;;;;;;;;;;;;;;1,0;1,0;;;;;;;;;;;;;;1,0;;;;;;;8,0;;;;;;4,0;;;;;;;;;4,0;;;;;;1,0;;;;;;;;;;;;;;;;;;11,0;;21,0;;;;;;;;;;2,0;;;;;;;;;;;;;;;;;;
fitting;15,0;;2,0;;;;1,0;6,0;3,0;;4,0;;1,0;;19,0;;;;;9,0;;6,0;;5,0;6,0;;1,0;2,0;2,0;11,0;13,0;10,0;16,0;;4,0;;;6,0;4,0;9,0;1,0;;;;13,0;1,0;;;3,0;;5,0;1,0;;1,0;2,0;12,0;7,0;;3,0;7,0;;9,0;28,0;;13,0;;;;;2,0;1,0;;4,0;1,0;;2,0;;4,0;19,0;;1,0;3,0;;2,0;;;3,0;1,0;;4,0;4,0;12,0;;;;1,0;;1,0;1,0;1,0;25,0;25,0;;1,0;;;;20,0;;;7,0;2,0;;4,0;5,0;1,0;;;8,0;5,0;;;1,0;7,0;;;8,0;2,0;;6,0;10,0;2,0;;2,0;;;5,0;;;;;;;1,0;;1,0;18,0;2,0;;;;15,0;5,0;2,0;;1,0;10,0;3,0;;1,0;;;5,0;;;;;1,0;;4,0;22,0;;4,0;6,0;;5,0;4,0;13,0;;;;1,0;;;;5,0;3,0;4,0;;19,0;;6,0;1,0;7,0;2,0;;;;3,0;3,0;;3,0;;3,0;;;;;6,0;12,0;;;;;1,0;;;;;1,0;3,0;1,0;;;5,0;;;;;2,0;;;;;1,0;3,0;;1,0;;;8,0;;;;;11,0;1,0;2,0;3,0;;;1,0;10,0;;;;3,0;;;;1,0;;6,0;;2,0;6,0;9,0;3,0;;2,0;1,0;;;1,0;1,0;;;;;1,0;6,0;;;2,0;;;;4,0;1,0;;;;3,0;;;;;;;;;;3,0;6,0;8,0;1,0;2,0;1,0;;10,0;2,0;1,0;;;1,0;;;14,0;1,0;2,0;;2,0;4,0;;;;;;;;2,0;;2,0;;;;1,0;;;;;8,0;;;;;;1,0;;;2,0;;2,0;;;;6,0;;4,0;;;1,0;;;;;;;;;;;;4,0;;;;2,0;;3,0;;;;;;1,0;;;;;1,0;;;;;;;;;;;;5,0;;;;;;;;;;;;;;;;3,0;;5,0;;;;;;;;;3,0;;;;;;;;;;;;2,0;;;;;;3,0;;;;;;;;;;;;;;;;;;;2,0;;4,0;;;4,0;;;;;;;;;;;;;;1,0;;;;;;1,0;;;;;;;;;;;4,0;;;3,0;;;;;;;;;4,0;10,0;1,0;;;;;;2,0;;;;;;;;;1,0;1,0;;;;;;;;;1,0;;1,0;;;;;;;1,0;;;;;;;;;;;;;;;;2,0;;;;;;;;;2,0;1,0;7,0;1,0;;;;;;;;;;;;;;;2,0;;;;;;;;;;;;;;4,0;;;;;;;;;6,0;;;;;;;2,0;;;1,0;4,0;;;;10,0;5,0;;;;;;;;;7,0;;;;;;;;;;;;;;;2,0;;;;4,0;;;;;3,0;;;;;;;;;;;;;;;;;;;;;;;;;;;;;;;;;;;;;;;;;;;;1,0;;;6,0;;;;;;;;;;1,0;;;;;;2,0;;;;;;;;;2,0;;2,0;;;;;;;;;1,0;;;;;8,0;;1,0;;3,0;;;;;;;;;;;;;;;;;;;;;;;;;;;;;;;;;;;;;;;;;;;;;;2,0;;;;;;1,0;;;;;;;;;;;;;;;;;;;;;;2,0;;2,0;;;;;;;;;5,0;;;;;;;3,0;;;;;2,0;;;;;;1,0;;;;;;;;;;;;;;6,0;;;;;;;;;;;;;;;;;;;;;;;;;;;;;;;;;2,0;;;;;;;;;;;;;;;;;;;;;;;;2,0;;;;;;;;;;;;4,0;;;;;;;;;1,0;1,0;;;;;;;;;;;;;;;;;;2,0;;;1,0;1,0;;;;;;;;1,0;;;3,0;;;;;;;;;;;;;
focal;5,0;3,0;12,0;;31,0;1,0;74,0;82,0;39,0;23,0;8,0;17,0;;7,0;15,0;;1,0;18,0;35,0;1,0;175,0;75,0;10,0;12,0;2,0;2,0;1,0;34,0;137,0;66,0;281,0;49,0;73,0;12,0;23,0;2,0;6,0;34,0;;33,0;264,0;4,0;9,0;171,0;1,0;10,0;;;95,0;;33,0;16,0;;332,0;2,0;259,0;77,0;;2316,0;1467,0;8,0;22,0;81,0;63,0;2,0;1,0;20,0;20,0;;29,0;244,0;12,0;16,0;;;24,0;;535,0;212,0;17,0;;14,0;6,0;3,0;3,0;;137,0;23,0;38,0;81,0;70,0;2,0;25,0;41,0;21,0;8,0;;4,0;10,0;;43,0;828,0;;;2,0;;3,0;337,0;3,0;1,0;2,0;22,0;103,0;15,0;4,0;1,0;;;;14,0;;;8,0;10,0;;;50,0;3,0;6,0;10,0;2,0;;;;1,0;34,0;12,0;;;2,0;;1,0;2,0;6,0;12,0;9,0;20,0;7,0;4,0;;2,0;;;;4,0;;;13,0;;139,0;2,0;8,0;;1,0;1,0;3,0;3,0;32,0;;4,0;6,0;19,0;49,0;9,0;13,0;1,0;;32,0;;;;;28,0;1,0;1,0;240,0;11,0;41,0;;29,0;;;12,0;24,0;;16,0;1,0;;2,0;;;2,0;;35,0;;6,0;2,0;2,0;;5,0;;;;4,0;12,0;19,0;6,0;;;;;8,0;;;;7,0;1,0;;;;1,0;;1,0;4,0;44,0;92,0;;1,0;58,0;1,0;10,0;;1,0;3,0;;5,0;;1,0;;2,0;;;;;;;1,0;26,0;;5,0;8,0;6,0;2,0;;;;;;13,0;;;14,0;;;;;;;434,0;5,0;;2,0;2,0;5,0;;;28,0;77,0;3,0;6,0;;;4,0;;1,0;16,0;15,0;46,0;;;3,0;1,0;44,0;4,0;1,0;;;47,0;7,0;;12,0;16,0;1,0;;18,0;;;;;1,0;1,0;2,0;;;;;;;1,0;2,0;8,0;13,0;;;;;7,0;;1,0;4,0;;13,0;;15,0;14,0;;5,0;12,0;;33,0;8,0;;3,0;1,0;;9,0;;1,0;;;15,0;;;;1,0;18,0;3,0;3,0;;;13,0;;2,0;4,0;2,0;;10,0;;75,0;6,0;3,0;13,0;2,0;;;4,0;;13,0;;3,0;;7,0;7,0;;12,0;3,0;7,0;7,0;18,0;43,0;3,0;;2,0;6,0;3,0;2,0;5,0;325,0;;;4,0;8,0;;24,0;2,0;2,0;2,0;;23,0;;8,0;;;6,0;16,0;2,0;;2,0;3,0;11,0;;2,0;;;;2,0;;4,0;8,0;;;;;;1,0;6,0;20,0;3,0;10,0;;2,0;12,0;16,0;5,0;;1,0;;;3,0;;7,0;;;65,0;5,0;;1,0;;25,0;;;23,0;;;;;;;;;;1,0;;1,0;;;4,0;23,0;;42,0;1,0;2,0;2,0;;15,0;20,0;;6,0;;;;;1,0;2,0;50,0;;;1,0;;;;;;;1,0;;;;;;;8,0;2,0;;;;15,0;;;;;;2,0;;;;;1,0;;;;;;8,0;1,0;;;;;;4,0;;;9,0;;;;1,0;1,0;;11,0;;;;8,0;;9,0;1,0;;;;1,0;;;;;;;;;;2,0;13,0;3,0;;2,0;;;;;;;;1,0;;1,0;1,0;;1,0;;1,0;;7,0;55,0;;;8,0;4,0;;;;;;;;;1,0;;;2,0;;;;;1,0;;;;;;;;24,0;94,0;;;1,0;;;;1,0;;16,0;;3,0;;;6,0;5,0;5,0;3,0;1,0;;;;;;;1,0;;2,0;;;;;;;;;;4,0;209,0;1,0;7,0;3,0;;;;;;;;;1,0;4,0;;;;;;;2,0;1,0;44,0;;;;4,0;6,0;;;;;3,0;3,0;;;;1,0;4,0;1,0;;1,0;3,0;;2,0;;;;3,0;2,0;;10,0;;;8,0;;;;;21,0;;2,0;5,0;;;;2,0;;;1,0;;;6,0;;;12,0;5,0;182,0;;;;;;;4,0;;28,0;3,0;8,0;6,0;43,0;1,0;6,0;;;;;6,0;;7,0;;;;;;;6,0;2,0;;;3,0;;;;;29,0;3,0;;;;;;;;;1,0;;;;;;;;;;;1,0;1,0;;6,0;1,0;;7,0;2,0;;;;1,0;;;;13,0;;;4,0;;;1,0;3,0;2,0;;3,0;3,0;;;2,0;;;;4,0;3,0;;4,0;;;;;;;;;;;;;10,0;;;;;;1,0;;;;;;1,0;;;;;;;;;;;4,0;;;;;1,0;;;;;;;;;;111,0;;;;;9,0;;4,0;;;;;;;;;;1,0;;;;;1,0;;;;3,0;4,0;;;;;;4,0;;;;;;;11,0;;;1,0;;;;28,0;;;;;;;;;;14,0;;;;;;;;11,0;8,0;;;28,0;;;;;;;;1,0;;;;;;;;;;;;3,0;2,0;;;;;;;1,0;;46,0;;6,0;;;;
focus;9,0;;61,0;10,0;142,0;;69,0;400,0;159,0;97,0;7,0;14,0;;12,0;9,0;;10,0;4,0;13,0;4,0;22,0;659,0;7,0;41,0;46,0;;70,0;57,0;24,0;435,0;1268,0;259,0;295,0;29,0;94,0;14,0;7,0;100,0;11,0;136,0;275,0;1,0;205,0;47,0;3,0;145,0;3,0;95,0;;4,0;34,0;136,0;2,0;155,0;7,0;869,0;207,0;12,0;52,0;1716,0;8,0;34,0;307,0;12,0;;74,0;85,0;5,0;;168,0;286,0;24,0;6,0;;2,0;7,0;;166,0;746,0;4,0;2,0;43,0;13,0;4,0;;;134,0;2,0;25,0;124,0;227,0;25,0;21,0;229,0;36,0;19,0;75,0;26,0;85,0;1,0;31,0;387,0;1,0;9,0;7,0;;37,0;521,0;11,0;;17,0;15,0;33,0;56,0;12,0;20,0;;4,0;2,0;43,0;;;20,0;78,0;;2,0;158,0;4,0;64,0;24,0;16,0;9,0;;1,0;1,0;83,0;107,0;;4,0;7,0;2,0;2,0;;50,0;13,0;1,0;31,0;95,0;4,0;1,0;6,0;5,0;9,0;1,0;12,0;7,0;1,0;24,0;13,0;261,0;2,0;8,0;2,0;;;;43,0;131,0;;1,0;58,0;11,0;127,0;13,0;80,0;14,0;12,0;371,0;;;5,0;1,0;6,0;14,0;;40,0;3,0;274,0;;144,0;;;6,0;36,0;;7,0;1,0;;40,0;7,0;1,0;8,0;;22,0;10,0;13,0;40,0;;25,0;52,0;3,0;5,0;;;10,0;97,0;12,0;1,0;;1,0;;;;11,0;11,0;10,0;3,0;;;;2,0;;7,0;14,0;462,0;10,0;3,0;21,0;390,0;63,0;40,0;;11,0;;;18,0;4,0;7,0;1,0;5,0;9,0;1,0;;1,0;2,0;;1,0;36,0;32,0;;12,0;196,0;23,0;1,0;8,0;;22,0;;;;;9,0;;;1,0;7,0;15,0;1,0;16,0;12,0;13,0;3,0;2,0;163,0;;9,0;258,0;248,0;22,0;8,0;34,0;1,0;8,0;;3,0;11,0;9,0;55,0;;;;;101,0;5,0;5,0;;;248,0;22,0;;50,0;12,0;;;28,0;;;;5,0;2,0;1,0;12,0;1,0;4,0;;6,0;;2,0;;;35,0;13,0;;;;3,0;38,0;6,0;2,0;3,0;;25,0;;55,0;10,0;4,0;14,0;13,0;;139,0;36,0;23,0;36,0;6,0;2,0;12,0;;1,0;4,0;;23,0;18,0;;;2,0;47,0;4,0;1,0;6,0;9,0;9,0;1,0;2,0;28,0;13,0;36,0;13,0;;;4,0;24,0;43,0;1,0;6,0;;10,0;27,0;23,0;2,0;14,0;6,0;25,0;;;15,0;21,0;58,0;75,0;17,0;5,0;31,0;;4,0;21,0;2,0;;40,0;155,0;;23,0;20,0;14,0;;8,0;;;35,0;;17,0;3,0;27,0;13,0;;4,0;158,0;1,0;5,0;29,0;5,0;45,0;2,0;5,0;;3,0;4,0;2,0;;;;;21,0;25,0;2,0;4,0;6,0;153,0;17,0;10,0;5,0;71,0;;44,0;35,0;20,0;;2,0;27,0;;19,0;;24,0;3,0;4,0;45,0;5,0;17,0;20,0;2,0;60,0;;;254,0;;;;7,0;;;12,0;7,0;1,0;1,0;;27,0;;20,0;7,0;16,0;;154,0;;47,0;29,0;8,0;26,0;29,0;4,0;1,0;4,0;;;1,0;3,0;1,0;39,0;;;1,0;1,0;1,0;1,0;1,0;;1,0;;;;3,0;;4,0;1,0;;;;;;50,0;;5,0;12,0;1,0;6,0;2,0;;7,0;2,0;;4,0;;2,0;2,0;1,0;1,0;1,0;;;;4,0;;;13,0;11,0;1,0;11,0;;;9,0;17,0;3,0;27,0;611,0;;;3,0;;;85,0;;3,0;;;2,0;1,0;;;;1,0;1,0;;;;;135,0;2,0;4,0;;10,0;;;2,0;;;;4,0;;;3,0;;1,0;;;;89,0;1,0;;;17,0;11,0;;;;4,0;;;;;1,0;1,0;;32,0;4,0;;26,0;1,0;2,0;;;;2,0;;;;25,0;379,0;3,0;;32,0;;;;3,0;6,0;;;1,0;13,0;;;;;4,0;;;;;;;;43,0;;3,0;;;1,0;;3,0;2,0;;;;2,0;6,0;10,0;;;1,0;1,0;;;;1,0;;13,0;15,0;;;;2,0;1,0;;;3,0;8,0;1,0;16,0;;;5,0;2,0;1,0;20,0;;;;1,0;;;;5,0;148,0;;3,0;4,0;24,0;4,0;;;4,0;;;7,0;5,0;;;;5,0;;;;;55,0;;17,0;3,0;;;2,0;;2,0;;11,0;25,0;;26,0;;1,0;17,0;;5,0;2,0;2,0;3,0;12,0;2,0;;;;14,0;2,0;5,0;299,0;10,0;1,0;8,0;5,0;2,0;;6,0;24,0;7,0;36,0;;7,0;20,0;;1,0;17,0;17,0;53,0;;;;1,0;10,0;1,0;1,0;84,0;3,0;;;5,0;1,0;;;2,0;;;2,0;2,0;;;2,0;;;1,0;1,0;;16,0;5,0;;2,0;;;9,0;;2,0;7,0;2,0;11,0;;1,0;;63,0;2,0;1,0;8,0;;;4,0;18,0;1,0;10,0;22,0;4,0;;;10,0;31,0;2,0;4,0;4,0;12,0;;1,0;;;;;;6,0;;;2,0;4,0;;2,0;;;2,0;5,0;;;3,0;5,0;3,0;;2,0;;8,0;1,0;2,0;;1,0;2,0;;;1,0;2,0;;11,0;;;;;;;1,0;;12,0;;1,0;;;2,0;3,0;1,0;4,0;;;1,0;2,0;2,0;;14,0;;;;;3,0;;139,0;;2,0;;;;2,0;;;2,0;;144,0;;;;5,0;;6,0;;2,0;8,0;1,0;1,0;;2,0;2,0;3,0;;;;;;4,0;;;15,0;;14,0;;;;4,0;;1,0;;;1,0;;3,0;;;;;19,0;;;3,0;;;23,0;;4,0;;;1,0;2,0;;;1,0;;;1,0;;2,0;2,0;2,0;;;;;1,0;4,0;;1,0;;1,0;;;;
frequency;1,0;;5,0;5,0;31,0;;5,0;49,0;26,0;4,0;1,0;64,0;;15,0;18,0;5,0;;;145,0;3,0;4,0;32,0;3,0;10,0;26,0;7,0;1,0;46,0;;48,0;20,0;79,0;69,0;24,0;24,0;4,0;14,0;15,0;;29,0;;2,0;14,0;42,0;8,0;;;;4,0;;30,0;18,0;1,0;2,0;2,0;248,0;55,0;;;14,0;1,0;;57,0;;1,0;30,0;14,0;;1,0;14,0;30,0;3,0;1,0;;;;5,0;1,0;3,0;29,0;1,0;38,0;15,0;12,0;;1,0;57,0;;23,0;84,0;46,0;3,0;4,0;192,0;16,0;;1,0;9,0;14,0;;19,0;22,0;;5,0;2,0;;2,0;92,0;26,0;;;2,0;7,0;4,0;3,0;1,0;;8,0;1,0;14,0;;;13,0;17,0;;1,0;26,0;;1,0;2,0;1,0;6,0;;;4,0;25,0;;;;5,0;4,0;8,0;4,0;2,0;73,0;;24,0;17,0;;;4,0;;;;;1,0;;;12,0;33,0;;6,0;;;;;28,0;35,0;19,0;6,0;8,0;7,0;7,0;;11,0;1,0;2,0;36,0;;;;6,0;26,0;;;;2,0;25,0;;17,0;;;19,0;56,0;1,0;5,0;;2,0;1,0;;;6,0;1,0;14,0;;11,0;;;2,0;;;;;1,0;;51,0;69,0;;;;2,0;1,0;54,0;5,0;;;;;;;;;15,0;2,0;15,0;2,0;;38,0;2,0;1,0;;;13,0;;2,0;2,0;;;;;;2,0;;5,0;;;;17,0;1,0;2,0;2,0;76,0;5,0;;;;2,0;;;1,0;;1,0;;;;3,0;;;1,0;;1,0;;2,0;;;22,0;;25,0;28,0;3,0;;;4,0;16,0;;4,0;;7,0;;;1,0;;56,0;3,0;;;;110,0;;;31,0;24,0;;;1,0;;;;;;;5,0;;;;12,0;;;32,0;;5,0;7,0;1,0;4,0;;2,0;1,0;1,0;1,0;;;10,0;;22,0;1,0;;;8,0;;37,0;3,0;6,0;;14,0;;;;;;;2,0;9,0;;1,0;4,0;20,0;;;;;3,0;;4,0;28,0;2,0;4,0;25,0;4,0;;2,0;9,0;1,0;4,0;;31,0;;8,0;44,0;3,0;84,0;;12,0;6,0;;;15,0;3,0;10,0;5,0;;5,0;;3,0;8,0;;;;;;;1,0;;1,0;6,0;14,0;;1,0;;20,0;3,0;3,0;;1,0;9,0;47,0;7,0;5,0;5,0;6,0;2,0;2,0;42,0;;2,0;2,0;;;;21,0;2,0;;;;;8,0;11,0;7,0;4,0;;6,0;;15,0;1,0;66,0;;1,0;21,0;;3,0;2,0;;4,0;;2,0;6,0;1,0;6,0;;12,0;;;8,0;;;;;1,0;83,0;;;10,0;;7,0;2,0;;2,0;3,0;5,0;;11,0;11,0;27,0;3,0;;39,0;5,0;;36,0;;;;1,0;;1,0;;;;;;;;;;55,0;4,0;1,0;1,0;;;1,0;1,0;;16,0;3,0;;12,0;1,0;;5,0;;;;;1,0;3,0;;;6,0;;;;3,0;;1,0;;;3,0;;;;32,0;;;;3,0;;7,0;;;39,0;26,0;;;;;;2,0;2,0;;7,0;;;;;;;;;;;;;7,0;;;;;;;9,0;14,0;;;;;3,0;;;1,0;2,0;;4,0;18,0;;;;;;;;;;;;15,0;1,0;2,0;;;;;;;5,0;;;;;73,0;;;;;1,0;18,0;;4,0;;;;;9,0;;;;3,0;;;;;27,0;3,0;;;;;2,0;11,0;;;;;5,0;;;1,0;;;;;;;;;1,0;;;;;;;2,0;7,0;9,0;7,0;;;1,0;15,0;;;2,0;3,0;;1,0;;;4,0;2,0;;5,0;7,0;;;4,0;;;2,0;3,0;24,0;1,0;;3,0;9,0;;;;3,0;8,0;;;;23,0;;2,0;3,0;;;;19,0;1,0;84,0;1,0;5,0;;;;;3,0;;10,0;;;12,0;;4,0;27,0;47,0;2,0;;;1,0;;;;1,0;;21,0;;;2,0;87,0;;;;3,0;1,0;;;4,0;;3,0;;;;;;2,0;;2,0;;;;;;;2,0;;;;4,0;;;;;;;;6,0;;;;;;;;1,0;;;;;;;;;;7,0;26,0;;;14,0;;1,0;;;3,0;;;2,0;;;4,0;2,0;;;;;3,0;24,0;;3,0;1,0;;14,0;1,0;7,0;;;;;;;;1,0;13,0;;;;;;;2,0;;;;;;;;1,0;;1,0;14,0;;;;7,0;7,0;5,0;;;;;;;;;;;25,0;;2,0;2,0;1,0;;2,0;2,0;;;;1,0;;;;;;;1,0;;;;;;;;;;;;;;;;;2,0;;;;2,0;;;;;;;;;;;;;;1,0;;1,0;1,0;;;;;;2,0;;;;;;;;;;;;;;;;;;3,0;;;1,0;;;;;;8,0;;1,0;;;;;4,0;4,0;1,0;;;;;;;;;;;;
function;11,0;2,0;4,0;16,0;125,0;;11,0;59,0;46,0;66,0;19,0;18,0;;15,0;13,0;2,0;11,0;6,0;22,0;40,0;18,0;193,0;17,0;15,0;69,0;1,0;14,0;94,0;;68,0;17,0;82,0;170,0;59,0;130,0;8,0;;24,0;3,0;68,0;47,0;10,0;5,0;43,0;8,0;9,0;5,0;33,0;34,0;30,0;;27,0;7,0;21,0;5,0;465,0;131,0;6,0;22,0;137,0;31,0;19,0;153,0;6,0;10,0;5,0;26,0;2,0;1,0;75,0;104,0;9,0;8,0;1,0;1,0;12,0;4,0;26,0;68,0;41,0;7,0;78,0;15,0;6,0;;4,0;36,0;9,0;12,0;54,0;26,0;14,0;32,0;69,0;7,0;8,0;;3,0;20,0;6,0;21,0;117,0;;58,0;;5,0;12,0;158,0;1,0;;14,0;7,0;3,0;10,0;1,0;1,0;3,0;;;34,0;;;8,0;18,0;1,0;;44,0;1,0;2,0;41,0;7,0;;4,0;;4,0;18,0;4,0;;2,0;10,0;29,0;5,0;7,0;22,0;28,0;2,0;28,0;18,0;;2,0;;;3,0;;2,0;1,0;4,0;7,0;12,0;41,0;5,0;3,0;3,0;1,0;2,0;12,0;79,0;67,0;;4,0;28,0;11,0;89,0;15,0;12,0;6,0;7,0;55,0;2,0;;3,0;3,0;4,0;2,0;2,0;21,0;12,0;76,0;3,0;29,0;;;2,0;43,0;;6,0;1,0;;26,0;1,0;6,0;3,0;;8,0;1,0;45,0;;2,0;10,0;23,0;7,0;4,0;;2,0;23,0;44,0;6,0;3,0;;;3,0;15,0;1,0;1,0;;3,0;10,0;;1,0;;1,0;1,0;4,0;;61,0;31,0;;22,0;22,0;30,0;12,0;;;;;3,0;6,0;;;;;4,0;6,0;6,0;;1,0;1,0;54,0;13,0;;2,0;18,0;8,0;;2,0;1,0;8,0;;;2,0;;4,0;5,0;6,0;4,0;4,0;;;3,0;3,0;10,0;1,0;;3,0;;21,0;7,0;28,0;29,0;1,0;;;2,0;6,0;;1,0;8,0;45,0;;;23,0;;45,0;13,0;3,0;;;7,0;;;13,0;25,0;;;;;1,0;;;;;7,0;6,0;1,0;1,0;22,0;;2,0;4,0;;34,0;18,0;;;;;4,0;1,0;;5,0;;58,0;;2,0;48,0;3,0;15,0;24,0;;17,0;9,0;12,0;8,0;3,0;;16,0;2,0;;2,0;16,0;9,0;4,0;1,0;;7,0;10,0;5,0;;6,0;2,0;;;;25,0;4,0;14,0;4,0;10,0;;4,0;4,0;13,0;21,0;52,0;1,0;;5,0;8,0;4,0;40,0;1,0;58,0;3,0;8,0;56,0;8,0;6,0;11,0;23,0;2,0;;1,0;10,0;7,0;19,0;;5,0;130,0;5,0;29,0;;11,0;;5,0;2,0;10,0;7,0;;46,0;;13,0;4,0;;29,0;76,0;33,0;27,0;3,0;3,0;8,0;4,0;7,0;3,0;1,0;1,0;5,0;;1,0;;4,0;21,0;2,0;1,0;;3,0;49,0;14,0;5,0;6,0;7,0;1,0;32,0;22,0;37,0;;;4,0;7,0;4,0;1,0;;4,0;2,0;6,0;1,0;16,0;2,0;8,0;21,0;;;164,0;;;2,0;;9,0;1,0;23,0;1,0;;1,0;1,0;;;6,0;11,0;22,0;6,0;38,0;1,0;123,0;3,0;25,0;14,0;18,0;20,0;8,0;9,0;;1,0;;11,0;11,0;9,0;2,0;;;;4,0;1,0;1,0;;5,0;27,0;13,0;;6,0;;;;;7,0;2,0;;2,0;15,0;;4,0;1,0;4,0;3,0;1,0;;1,0;16,0;3,0;3,0;;;;1,0;3,0;2,0;;1,0;;5,0;3,0;;10,0;;3,0;3,0;4,0;;2,0;;;9,0;39,0;;3,0;2,0;;;6,0;3,0;8,0;;1,0;;;3,0;;;4,0;4,0;;21,0;;;10,0;;2,0;68,0;;;4,0;3,0;9,0;;;25,0;4,0;29,0;;;11,0;1,0;8,0;;19,0;;;;8,0;7,0;;;;;;;3,0;;2,0;1,0;;;6,0;;10,0;12,0;1,0;;;;7,0;;;5,0;;22,0;4,0;;2,0;9,0;;;;6,0;;;2,0;1,0;;4,0;2,0;;1,0;15,0;4,0;;;;;4,0;1,0;;7,0;1,0;1,0;3,0;1,0;3,0;56,0;;;;;2,0;14,0;2,0;1,0;5,0;1,0;16,0;13,0;;;1,0;19,0;7,0;7,0;;;;18,0;;4,0;3,0;;2,0;9,0;;;2,0;5,0;2,0;;4,0;1,0;2,0;2,0;;8,0;4,0;11,0;1,0;2,0;;1,0;3,0;1,0;7,0;22,0;6,0;;1,0;2,0;4,0;;1,0;;;;1,0;1,0;2,0;35,0;15,0;;34,0;2,0;2,0;1,0;23,0;9,0;;13,0;30,0;;28,0;1,0;7,0;2,0;5,0;2,0;1,0;;1,0;;12,0;;4,0;31,0;;;2,0;6,0;2,0;1,0;;2,0;4,0;;;1,0;;6,0;6,0;1,0;5,0;17,0;8,0;12,0;1,0;21,0;;;;;;1,0;1,0;11,0;2,0;1,0;8,0;2,0;;;1,0;5,0;;16,0;;;;2,0;;;4,0;;1,0;;;2,0;;;1,0;;5,0;;6,0;7,0;7,0;1,0;;7,0;2,0;3,0;;;6,0;;;9,0;6,0;1,0;1,0;16,0;8,0;;;4,0;;;2,0;3,0;2,0;1,0;2,0;;4,0;3,0;;2,0;1,0;;;40,0;1,0;6,0;;;3,0;8,0;2,0;;;1,0;;10,0;2,0;2,0;;;;1,0;2,0;32,0;;;;;28,0;1,0;;;;;5,0;;;;1,0;;;;2,0;4,0;4,0;2,0;;3,0;7,0;;2,0;;1,0;;;;;;;1,0;;1,0;1,0;1,0;9,0;;1,0;2,0;;;3,0;3,0;12,0;3,0;3,0;;1,0;4,0;23,0;2,0;;1,0;;1,0;2,0;;3,0;2,0;;;;;;5,0;20,0;;;;2,0;;;3,0;;;;;;1,0;;;;;1,0;6,0;1,0;;;1,0;;;;;10,0;;;;;;2,0;;;;;1,0;2,0;;;1,0;2,0;;;;;;;5,0;1,0;;;;
generate;1,0;;31,0;5,0;164,0;;30,0;443,0;44,0;209,0;4,0;20,0;2,0;31,0;87,0;14,0;6,0;12,0;81,0;88,0;23,0;420,0;36,0;113,0;84,0;10,0;20,0;1308,0;18,0;100,0;143,0;51,0;420,0;81,0;183,0;45,0;7,0;120,0;7,0;246,0;30,0;50,0;87,0;115,0;9,0;6,0;1,0;16,0;136,0;18,0;27,0;;140,0;29,0;;3228,0;221,0;4,0;12,0;154,0;3,0;6,0;367,0;2,0;61,0;11,0;59,0;;22,0;85,0;98,0;21,0;2,0;;;12,0;14,0;119,0;202,0;45,0;12,0;190,0;178,0;10,0;9,0;4,0;58,0;20,0;83,0;65,0;302,0;12,0;55,0;1591,0;21,0;34,0;10,0;42,0;108,0;16,0;64,0;243,0;;57,0;10,0;49,0;2,0;662,0;75,0;5,0;37,0;14,0;58,0;10,0;14,0;3,0;9,0;24,0;;22,0;;;5,0;195,0;;6,0;330,0;3,0;6,0;23,0;8,0;4,0;5,0;2,0;4,0;90,0;6,0;2,0;23,0;18,0;15,0;1,0;18,0;87,0;94,0;190,0;35,0;426,0;13,0;;32,0;;4,0;29,0;3,0;2,0;6,0;22,0;55,0;227,0;23,0;1,0;;12,0;1,0;9,0;41,0;351,0;2,0;1,0;106,0;16,0;110,0;17,0;74,0;3,0;5,0;421,0;1,0;;2,0;5,0;4,0;7,0;;22,0;2,0;317,0;;123,0;;;18,0;122,0;3,0;13,0;;4,0;22,0;9,0;4,0;15,0;1,0;15,0;;36,0;29,0;1,0;4,0;2,0;27,0;1,0;14,0;;31,0;167,0;67,0;1,0;22,0;1,0;2,0;26,0;83,0;26,0;;38,0;6,0;;;1,0;;8,0;21,0;16,0;39,0;16,0;1,0;55,0;142,0;5,0;4,0;2,0;33,0;3,0;1,0;5,0;18,0;8,0;2,0;51,0;21,0;19,0;6,0;20,0;7,0;4,0;4,0;8,0;10,0;;12,0;132,0;19,0;12,0;2,0;;4,0;;;1,0;;1,0;2,0;1,0;1,0;19,0;3,0;;;19,0;;48,0;10,0;22,0;;202,0;13,0;267,0;16,0;2,0;6,0;;14,0;38,0;9,0;5,0;75,0;79,0;;5,0;6,0;1,0;86,0;27,0;6,0;;;64,0;2,0;1,0;104,0;36,0;;2,0;8,0;;;7,0;1,0;1,0;4,0;46,0;3,0;1,0;;110,0;;;36,0;2,0;62,0;13,0;;3,0;4,0;25,0;;6,0;8,0;1,0;;67,0;3,0;20,0;39,0;30,0;14,0;13,0;1,0;66,0;1,0;76,0;39,0;;;;5,0;3,0;;3,0;45,0;;;14,0;44,0;50,0;8,0;19,0;20,0;20,0;;5,0;4,0;15,0;37,0;23,0;12,0;39,0;;26,0;46,0;93,0;8,0;27,0;66,0;3,0;16,0;8,0;12,0;96,0;8,0;91,0;5,0;1,0;20,0;19,0;13,0;58,0;31,0;;70,0;3,0;5,0;8,0;145,0;13,0;95,0;43,0;8,0;6,0;4,0;5,0;29,0;98,0;1,0;35,0;32,0;1,0;133,0;52,0;38,0;2,0;12,0;14,0;61,0;3,0;2,0;26,0;35,0;122,0;61,0;3,0;1,0;16,0;5,0;;28,0;2,0;60,0;4,0;8,0;17,0;2,0;1,0;18,0;68,0;93,0;39,0;12,0;2,0;5,0;22,0;191,0;14,0;1,0;27,0;14,0;4,0;34,0;;1,0;29,0;12,0;9,0;10,0;44,0;10,0;7,0;80,0;1,0;30,0;103,0;;6,0;;15,0;19,0;4,0;5,0;49,0;15,0;24,0;8,0;14,0;3,0;11,0;34,0;18,0;1,0;49,0;29,0;26,0;10,0;5,0;565,0;74,0;7,0;130,0;29,0;4,0;;11,0;7,0;24,0;3,0;18,0;2,0;1,0;1,0;;;1,0;2,0;56,0;26,0;2,0;;13,0;1,0;3,0;;;31,0;5,0;5,0;11,0;23,0;5,0;15,0;4,0;2,0;3,0;4,0;1,0;52,0;26,0;;4,0;1,0;5,0;;10,0;1,0;4,0;1,0;2,0;16,0;11,0;3,0;3,0;20,0;4,0;;5,0;19,0;;37,0;10,0;2,0;120,0;318,0;19,0;;1,0;;12,0;11,0;2,0;;;8,0;9,0;3,0;2,0;;1,0;;6,0;;3,0;;57,0;209,0;4,0;26,0;38,0;;14,0;12,0;12,0;8,0;3,0;;8,0;6,0;157,0;;;2,0;;2,0;6,0;64,0;;4,0;12,0;1,0;61,0;;;;18,0;;;1,0;4,0;10,0;;;1,0;7,0;6,0;7,0;17,0;;;;;22,0;;;1,0;1,0;12,0;7,0;;25,0;;;;2,0;12,0;;;;26,0;6,0;18,0;6,0;12,0;41,0;3,0;;;;;;1,0;7,0;5,0;13,0;2,0;;;;11,0;1,0;;;5,0;1,0;;3,0;1,0;35,0;2,0;8,0;26,0;3,0;6,0;2,0;26,0;24,0;40,0;46,0;5,0;;10,0;43,0;1,0;7,0;55,0;4,0;;9,0;;2,0;39,0;28,0;6,0;14,0;15,0;22,0;8,0;13,0;;50,0;6,0;5,0;103,0;2,0;1,0;2,0;58,0;8,0;40,0;11,0;1,0;2,0;;6,0;10,0;1,0;16,0;2,0;2,0;5,0;5,0;;2,0;3,0;43,0;23,0;8,0;;7,0;2,0;8,0;6,0;;27,0;;5,0;17,0;3,0;36,0;4,0;48,0;3,0;17,0;;14,0;7,0;11,0;3,0;21,0;12,0;20,0;6,0;2,0;9,0;9,0;17,0;1,0;15,0;4,0;;18,0;5,0;5,0;26,0;10,0;1,0;1,0;3,0;9,0;48,0;2,0;1,0;20,0;40,0;19,0;1,0;15,0;7,0;12,0;10,0;4,0;;1,0;12,0;1,0;25,0;5,0;17,0;2,0;7,0;;;;2,0;3,0;;8,0;13,0;3,0;;11,0;20,0;2,0;3,0;2,0;10,0;43,0;5,0;1,0;;4,0;2,0;1,0;16,0;9,0;17,0;;1,0;5,0;4,0;;14,0;;14,0;13,0;22,0;3,0;;21,0;7,0;6,0;6,0;;1,0;24,0;17,0;4,0;25,0;3,0;1,0;7,0;2,0;1,0;7,0;15,0;2,0;5,0;57,0;1,0;16,0;;28,0;2,0;2,0;99,0;2,0;4,0;;;2,0;;3,0;;;1,0;16,0;;1,0;;55,0;3,0;4,0;3,0;1,0;;1,0;1,0;;1,0;;1,0;2,0;;;;5,0;1,0;89,0;13,0;32,0;;3,0;;69,0;2,0;;;1,0;;;2,0;7,0;10,0;17,0;12,0;;3,0;22,0;5,0;;4,0;;2,0;26,0;27,0;9,0;6,0;13,0;27,0;1,0;2,0;3,0;;5,0;3,0;1,0;;11,0;4,0;32,0;;;3,0;;;21,0;19,0;20,0;2,0;7,0;13,0;;;1,0;5,0;;3,0;;3,0;1,0;;;5,0;1,0;4,0;2,0;10,0;2,0;;2,0;13,0;1,0;1,0;;7,0;6,0;4,0;4,0;;2,0;;1,0;7,0;11,0;6,0;;;3,0;;;3,0;1,0;2,0;18,0;3,0;;;1,0;;;;;
generation;2,0;;;;22,0;;;7,0;5,0;10,0;;11,0;;;2,0;2,0;;;;1,0;16,0;50,0;;4,0;1,0;2,0;;70,0;;12,0;4,0;15,0;38,0;3,0;1,0;;;8,0;;9,0;;;;11,0;;2,0;;;2,0;1,0;7,0;140,0;;7,0;;97,0;12,0;;;;;;16,0;5,0;;;6,0;;3,0;10,0;3,0;6,0;;;;;;1,0;6,0;52,0;;11,0;1,0;;;;1,0;7,0;2,0;9,0;7,0;3,0;;137,0;;2,0;;;7,0;1,0;;9,0;;3,0;1,0;5,0;;179,0;2,0;;18,0;;1,0;;5,0;;;;;2,0;;;;39,0;;;16,0;;;2,0;1,0;;;;1,0;1,0;4,0;;;;1,0;;2,0;1,0;;;;15,0;;;;;;1,0;1,0;;;;1,0;14,0;;2,0;;;;;4,0;6,0;5,0;;2,0;;5,0;2,0;;;;20,0;;;;;;;;;;19,0;;4,0;;;;13,0;;;;;;;;;;6,0;;1,0;;;;;;;;;;35,0;1,0;;;;;;2,0;;;;;;;;;;;;9,0;;;1,0;5,0;;;;1,0;;;;;;;;2,0;;;;;2,0;;;;;;2,0;;;;;;;;;;;;;;2,0;2,0;;;6,0;;;1,0;1,0;1,0;9,0;;4,0;5,0;2,0;;;2,0;1,0;;;;7,0;;;;;;;;;;2,0;;;68,0;7,0;;;;;;;;;;1,0;;;;2,0;;;;;6,0;;;;;;;1,0;;;;;1,0;3,0;;1,0;;;;4,0;6,0;;;2,0;;;;;1,0;;2,0;;;;1,0;;;;2,0;1,0;1,0;;;;2,0;2,0;;2,0;;10,0;5,0;1,0;;1,0;2,0;;2,0;2,0;;7,0;;2,0;;;;1,0;12,0;;;;1,0;;;;;;;1,0;;;;1,0;;;;;;;2,0;;6,0;1,0;;;1,0;;;4,0;1,0;2,0;;;;;;;5,0;;1,0;;;;;;;;2,0;11,0;1,0;;;9,0;;1,0;;3,0;2,0;;6,0;;;2,0;;;;4,0;;;;;;3,0;;;;;2,0;;;;3,0;;1,0;;;;1,0;;;6,0;1,0;4,0;1,0;;61,0;;;23,0;;;2,0;;;;;;8,0;;;;;;;;;;;;;1,0;;;3,0;;;;1,0;;;;3,0;;;;;;;;;;;8,0;;;;;11,0;;;;6,0;;;;4,0;;19,0;2,0;;25,0;14,0;2,0;1,0;;;2,0;;1,0;;;;1,0;;;;;;;;;;7,0;3,0;1,0;;;;;;;;;;;7,0;22,0;;;1,0;;;;8,0;;;;;3,0;;2,0;;;;;;1,0;;;;4,0;2,0;;;1,0;;;;;7,0;;;;;;;;;;;;;2,0;;;;;;2,0;;;3,0;;;;;;;;;;;;;;;;;;;;;;;;3,0;;;5,0;2,0;;;;2,0;;;;;;;;;21,0;1,0;;;;1,0;1,0;7,0;;1,0;;;;1,0;;;1,0;;;;;;;3,0;;;;;;;;;;;;;;2,0;;;3,0;;;;;;;1,0;;1,0;;;;;3,0;;5,0;;;;;;;;;;1,0;;;;;;1,0;;;;;;1,0;13,0;;;;;;;;;;;8,0;;;;;;4,0;;;;;;;;;;;;;;;;;;;;;;;1,0;;;;;;;;;;;3,0;1,0;;;;;;;;;;;;;;;4,0;;;;;;1,0;;;;1,0;;;;;;;1,0;;3,0;;;;2,0;;;;;;;;;;;;;;;;;;;;;;;;;;;;;;;;2,0;;2,0;;;;;;;;;;;;;;;;;;;;;;;;;;;;;;8,0;1,0;;;;;;2,0;;;;;;;;;;;;;;;;;;;;;;;;;;;;;;;;;;;;1,0;;1,0;;;;;;;;;;1,0;;;;;;;;;;;20,0;;;;;;;;;
group;3,0;5,0;38,0;;48,0;25,0;244,0;62,0;16,0;19,0;26,0;33,0;1,0;14,0;77,0;17,0;1,0;1,0;47,0;27,0;18,0;69,0;5,0;11,0;8,0;;33,0;107,0;26,0;30,0;70,0;37,0;168,0;6,0;73,0;1,0;23,0;119,0;5,0;34,0;143,0;;38,0;370,0;3,0;;1,0;332,0;155,0;2,0;21,0;29,0;7,0;;5,0;690,0;336,0;1,0;317,0;3761,0;;34,0;61,0;6,0;13,0;15,0;95,0;5,0;;42,0;878,0;58,0;23,0;;2,0;12,0;;102,0;252,0;421,0;3,0;43,0;10,0;1,0;3,0;;47,0;11,0;16,0;509,0;82,0;28,0;;54,0;10,0;33,0;18,0;21,0;29,0;13,0;142,0;554,0;1,0;25,0;1,0;4,0;13,0;170,0;16,0;;15,0;107,0;12,0;18,0;7,0;3,0;4,0;3,0;;27,0;;;28,0;24,0;7,0;3,0;113,0;11,0;8,0;20,0;1,0;2,0;4,0;33,0;8,0;15,0;130,0;;21,0;10,0;;2,0;4,0;37,0;14,0;11,0;78,0;148,0;1,0;2,0;3,0;4,0;42,0;1,0;67,0;3,0;1,0;26,0;19,0;62,0;10,0;83,0;3,0;12,0;;18,0;6,0;116,0;;31,0;75,0;7,0;33,0;19,0;63,0;14,0;3,0;10,0;;;;;24,0;;;71,0;7,0;337,0;;81,0;;4,0;1,0;65,0;1,0;16,0;156,0;3,0;4,0;8,0;2,0;17,0;7,0;400,0;;2,0;;17,0;12,0;52,0;15,0;23,0;;7,0;1,0;40,0;36,0;2,0;6,0;2,0;16,0;5,0;1,0;;7,0;;41,0;;;2,0;2,0;;9,0;12,0;10,0;20,0;;13,0;49,0;10,0;73,0;;12,0;3,0;3,0;2,0;;2,0;;1,0;54,0;3,0;4,0;13,0;17,0;;;15,0;;3,0;13,0;47,0;5,0;1,0;11,0;;4,0;2,0;2,0;3,0;6,0;54,0;;6,0;6,0;16,0;26,0;2,0;7,0;33,0;;4,0;3,0;24,0;2,0;9,0;216,0;236,0;10,0;5,0;5,0;;1,0;21,0;;3,0;11,0;36,0;3,0;;4,0;3,0;50,0;8,0;;;4,0;22,0;44,0;;16,0;9,0;29,0;27,0;2,0;;1,0;3,0;8,0;2,0;;;15,0;24,0;;8,0;8,0;5,0;4,0;;49,0;6,0;10,0;;;;6,0;1,0;2,0;;;19,0;2,0;4,0;3,0;3,0;;10,0;;41,0;49,0;1,0;6,0;1,0;8,0;63,0;1,0;;;1,0;2,0;5,0;;;21,0;43,0;1,0;16,0;;4,0;3,0;6,0;1,0;3,0;4,0;8,0;12,0;6,0;;6,0;2,0;4,0;3,0;3,0;10,0;;1,0;7,0;;29,0;3,0;;2,0;;14,0;;7,0;26,0;19,0;3,0;8,0;;2,0;4,0;8,0;;3,0;336,0;11,0;;7,0;11,0;1,0;1,0;1,0;7,0;12,0;;2,0;4,0;6,0;;2,0;19,0;7,0;5,0;1,0;14,0;2,0;5,0;;;1,0;1,0;8,0;;6,0;;2,0;;6,0;2,0;3,0;;17,0;3,0;28,0;4,0;10,0;4,0;;14,0;6,0;2,0;1,0;12,0;4,0;;3,0;;4,0;11,0;;11,0;;10,0;110,0;;15,0;1,0;4,0;17,0;;4,0;5,0;;8,0;3,0;2,0;16,0;12,0;;1,0;;1,0;12,0;5,0;13,0;;10,0;;11,0;;3,0;22,0;9,0;;;;9,0;12,0;;4,0;1,0;67,0;4,0;4,0;8,0;;;2,0;;;3,0;5,0;3,0;8,0;2,0;;;;;3,0;;;;14,0;;;1,0;4,0;;4,0;;18,0;;;;1,0;6,0;;20,0;1,0;7,0;;2,0;;;6,0;1,0;;3,0;18,0;7,0;5,0;;14,0;;3,0;30,0;242,0;5,0;;2,0;;8,0;32,0;2,0;;;;;16,0;1,0;3,0;3,0;9,0;1,0;2,0;2,0;;2,0;60,0;1,0;;91,0;2,0;3,0;10,0;1,0;3,0;;10,0;;47,0;5,0;7,0;;448,0;;18,0;10,0;5,0;;;;3,0;10,0;;1,0;;15,0;;;;1,0;2,0;5,0;;;;3,0;2,0;14,0;13,0;;2,0;1,0;5,0;;;9,0;;2,0;11,0;3,0;8,0;;6,0;8,0;1,0;1,0;56,0;;20,0;5,0;;2,0;3,0;2,0;5,0;6,0;2,0;;;;;;3,0;1,0;;;;30,0;17,0;1,0;;1,0;;1,0;1,0;31,0;1,0;8,0;9,0;2,0;1,0;3,0;;12,0;1,0;;46,0;15,0;10,0;2,0;;;;;;2,0;;34,0;5,0;2,0;4,0;8,0;;;84,0;3,0;;;;;;3,0;;22,0;;25,0;1,0;1,0;;3,0;11,0;;;;7,0;2,0;16,0;;;6,0;;8,0;;2,0;7,0;;6,0;;;;;3,0;3,0;;4,0;12,0;;;2,0;;5,0;7,0;61,0;;;1,0;;;;;;13,0;2,0;4,0;2,0;;;1,0;;60,0;;;2,0;1,0;3,0;8,0;10,0;;;;1,0;13,0;1,0;;2,0;;;8,0;;;24,0;;;;;1,0;2,0;19,0;;;2,0;;;;4,0;;;6,0;;;1,0;;31,0;3,0;7,0;1,0;;6,0;;2,0;1,0;;13,0;;;;;;1,0;5,0;;;;5,0;;19,0;3,0;9,0;;;11,0;;;;1,0;;;;1,0;2,0;1,0;;1,0;6,0;3,0;;2,0;2,0;;;3,0;;;1,0;;;3,0;3,0;16,0;;;;;1,0;;;7,0;;1,0;5,0;3,0;2,0;3,0;2,0;;;;1,0;;1,0;9,0;6,0;;3,0;;;4,0;;10,0;2,0;;;;12,0;;2,0;3,0;3,0;;;;1,0;;;1,0;;;4,0;;2,0;;;7,0;256,0;1,0;;;11,0;1,0;;;2,0;1,0;;;;;;2,0;;;;;1,0;;7,0;1,0;;;;;7,0;1,0;;4,0;;4,0;;;6,0;5,0;;;6,0;;2,0;1,0;16,0;;12,0;7,0;;2,0;6,0;;2,0;2,0;7,0;;;;;2,0;;1,0;;;13,0;2,0;5,0;;;;;;;;32,0;;21,0;;;;
height;25,0;;3,0;;10,0;3,0;26,0;24,0;36,0;2,0;1,0;6,0;;;4,0;;;;5,0;1,0;13,0;11,0;3,0;3,0;1,0;;;1,0;;6,0;3,0;13,0;12,0;10,0;3,0;4,0;2,0;46,0;;2,0;21,0;;;13,0;;;2,0;2,0;7,0;2,0;5,0;;;5,0;;191,0;17,0;;37,0;56,0;1,0;11,0;31,0;;6,0;1,0;;;;1,0;23,0;;1,0;2,0;2,0;;;42,0;21,0;1,0;1,0;2,0;2,0;1,0;;;19,0;;4,0;5,0;41,0;3,0;2,0;;9,0;1,0;;;;6,0;78,0;20,0;;4,0;1,0;;;40,0;;;;;;2,0;9,0;;7,0;;2,0;4,0;3,0;;;;;;3,0;2,0;;3,0;3,0;;;;;2,0;4,0;1,0;11,0;;;;;2,0;;;5,0;;;;;3,0;3,0;;1,0;3,0;;11,0;1,0;12,0;7,0;4,0;3,0;1,0;;;2,0;58,0;;1,0;17,0;;35,0;4,0;;1,0;7,0;;1,0;;1,0;;3,0;;3,0;35,0;3,0;12,0;;6,0;;8,0;;2,0;;;33,0;;2,0;3,0;4,0;6,0;;24,0;;;;;1,0;11,0;1,0;2,0;;1,0;7,0;2,0;;8,0;;;14,0;7,0;;;1,0;;5,0;;1,0;;;;;5,0;3,0;36,0;;;6,0;;3,0;3,0;2,0;22,0;1,0;1,0;;;5,0;5,0;;;;10,0;;;;28,0;2,0;;;2,0;8,0;;;;4,0;;4,0;1,0;;6,0;12,0;;1,0;9,0;1,0;;43,0;9,0;1,0;4,0;;1,0;;;;40,0;;;;2,0;;4,0;;12,0;;;;;5,0;;17,0;;2,0;;;17,0;;1,0;6,0;1,0;;;6,0;;;;;;2,0;6,0;;1,0;;;;1,0;;1,0;8,0;;;;;;1,0;;;;;;;;4,0;;;;;2,0;3,0;;3,0;;;;;;;;;;;;;;;;;2,0;;;;21,0;;;;;;2,0;;1,0;1,0;;;;;7,0;;;;;;;;;;9,0;2,0;1,0;;;;;;;7,0;17,0;;;;2,0;;;;;2,0;;;1,0;4,0;;;1,0;;;;;;;;;;;;1,0;;1,0;;;;;;;1,0;;;3,0;;;;;7,0;5,0;;;;;;;;;;96,0;;5,0;;;4,0;;;;;6,0;;;1,0;;;;;;;;6,0;3,0;6,0;;;9,0;;;;;3,0;21,0;;1,0;;;;;1,0;;;1,0;;13,0;;;;;;;;;;;;;;;1,0;1,0;;;2,0;;1,0;;1,0;;;3,0;;;;;;;;;;;;;;;;;4,0;;;;;;;;;;8,0;6,0;;;;;5,0;;;;4,0;;;;2,0;;3,0;;6,0;;;;6,0;4,0;;;;;;;;2,0;;;4,0;;;;;;;;;;;;;1,0;;;;;;;;;;;1,0;2,0;;;;1,0;;;;;;1,0;;;8,0;2,0;;4,0;2,0;1,0;2,0;;;;;;3,0;;;;7,0;2,0;;2,0;;;;3,0;;1,0;;1,0;3,0;;;2,0;;;;;;;;;;5,0;23,0;;;;;;;;3,0;;6,0;;;;;2,0;;;2,0;3,0;;1,0;2,0;6,0;;;;;;5,0;;;;;;2,0;;;2,0;;;;;;;1,0;;;;;;2,0;;;;;;;1,0;;;;;1,0;;22,0;;;4,0;;;;2,0;;18,0;;;1,0;;;;;;1,0;39,0;;;12,0;;;;;2,0;;;;;;;;;1,0;;1,0;;;;;;4,0;;;;;;;;;;6,0;;2,0;;;;;;;;;;;;;5,0;;;;;3,0;;;;;2,0;;;;2,0;;;;;;;;2,0;;;;;;;;2,0;;;;;;;;1,0;;;;;4,0;;;;;;;;2,0;;;10,0;;3,0;;1,0;;1,0;;3,0;;;;2,0;;;;;2,0;;;;;;;;;;;;;;;;;;;;;;;;2,0;;;;1,0;;;3,0;;;;;2,0;;;;;;;;;;;;;;;;;;2,0;;;;1,0;;;;6,0;;;;;;;;;;;;;;;;1,0;3,0;;24,0;;;6,0;;4,0;;;;;;;;;;;5,0;;;;;;;1,0;;;;;;;;;;3,0;7,0;;;;;
image;52,0;6,0;398,0;155,0;2220,0;5,0;433,0;2938,0;666,0;9219,0;384,0;512,0;31,0;54,0;1264,0;182,0;129,0;53,0;671,0;437,0;607,0;1967,0;453,0;1072,0;932,0;81,0;25,0;11128,0;221,0;1426,0;551,0;2056,0;7001,0;667,0;3908,0;276,0;214,0;560,0;192,0;7028,0;601,0;235,0;158,0;1487,0;109,0;176,0;12,0;259,0;869,0;248,0;465,0;3228,0;97,0;690,0;191,0;;2969,0;75,0;193,0;3879,0;63,0;383,0;4065,0;73,0;191,0;59,0;1545,0;45,0;111,0;815,0;2929,0;612,0;369,0;60,0;15,0;677,0;2,0;1291,0;2090,0;133,0;70,0;5081,0;1438,0;881,0;53,0;34,0;1455,0;63,0;680,0;1985,0;6603,0;283,0;770,0;5128,0;827,0;282,0;76,0;787,0;2356,0;278,0;1374,0;3035,0;32,0;455,0;87,0;86,0;160,0;5219,0;41,0;8,0;352,0;430,0;507,0;246,0;196,0;173,0;11,0;100,0;209,0;397,0;55,0;;195,0;850,0;10,0;93,0;1896,0;81,0;206,0;325,0;143,0;402,0;35,0;10,0;30,0;376,0;336,0;2,0;56,0;59,0;73,0;68,0;269,0;1355,0;686,0;21,0;2303,0;2734,0;55,0;43,0;129,0;16,0;110,0;36,0;93,0;146,0;10,0;359,0;209,0;2288,0;172,0;135,0;24,0;45,0;129,0;77,0;492,0;1510,0;81,0;50,0;270,0;252,0;1445,0;407,0;343,0;154,0;35,0;3279,0;167,0;22,0;73,0;45,0;263,0;755,0;2,0;759,0;74,0;3817,0;23,0;2015,0;5,0;44,0;61,0;2181,0;69,0;193,0;67,0;3,0;159,0;22,0;188,0;132,0;36,0;1842,0;6,0;147,0;149,0;50,0;130,0;139,0;285,0;122,0;272,0;29,0;91,0;1492,0;855,0;80,0;27,0;17,0;85,0;249,0;111,0;227,0;15,0;129,0;258,0;;21,0;11,0;20,0;12,0;45,0;136,0;558,0;442,0;8,0;321,0;2452,0;120,0;134,0;25,0;212,0;78,0;20,0;119,0;91,0;552,0;;37,0;71,0;631,0;25,0;394,0;82,0;93,0;19,0;302,0;236,0;15,0;234,0;228,0;296,0;8,0;40,0;4,0;89,0;1,0;8,0;35,0;23,0;97,0;21,0;33,0;72,0;336,0;96,0;2,0;153,0;335,0;8,0;21,0;24,0;134,0;13,0;625,0;239,0;4060,0;205,0;65,0;39,0;7,0;174,0;378,0;24,0;78,0;89,0;1323,0;46,0;;96,0;9,0;1098,0;433,0;261,0;14,0;1,0;489,0;39,0;22,0;1165,0;551,0;40,0;8,0;8,0;2,0;9,0;1,0;;46,0;3,0;979,0;24,0;37,0;3,0;371,0;21,0;7,0;103,0;17,0;765,0;71,0;15,0;23,0;15,0;57,0;50,0;272,0;50,0;64,0;25,0;672,0;58,0;337,0;904,0;225,0;129,0;176,0;38,0;595,0;179,0;112,0;178,0;13,0;56,0;33,0;127,0;33,0;;20,0;221,0;82,0;6,0;11,0;652,0;408,0;69,0;110,0;143,0;229,0;87,0;14,0;31,0;266,0;704,0;1116,0;216,0;183,0;9,0;183,0;296,0;3341,0;70,0;375,0;24,0;123,0;206,0;249,0;49,0;2880,0;66,0;382,0;22,0;13,0;315,0;154,0;304,0;813,0;263,0;74,0;496,0;17,0;107,0;84,0;203,0;25,0;250,0;646,0;62,0;51,0;180,0;186,0;35,0;561,0;41,0;183,0;428,0;1,0;1442,0;70,0;546,0;86,0;35,0;171,0;1031,0;45,0;423,0;613,0;520,0;1177,0;516,0;99,0;6,0;168,0;81,0;51,0;102,0;130,0;102,0;23,0;93,0;174,0;62,0;109,0;37,0;393,0;368,0;1112,0;248,0;54,0;22,0;333,0;790,0;313,0;10,0;269,0;248,0;84,0;426,0;21,0;24,0;139,0;153,0;259,0;12,0;547,0;133,0;43,0;706,0;10,0;63,0;1334,0;22,0;10,0;33,0;84,0;746,0;25,0;158,0;307,0;171,0;206,0;152,0;56,0;24,0;261,0;637,0;245,0;105,0;553,0;102,0;416,0;118,0;65,0;1536,0;1128,0;201,0;33,0;52,0;180,0;64,0;131,0;126,0;364,0;334,0;46,0;80,0;38,0;48,0;29,0;17,0;64,0;46,0;303,0;459,0;130,0;29,0;242,0;65,0;95,0;17,0;45,0;151,0;162,0;51,0;32,0;155,0;7,0;132,0;72,0;31,0;63,0;197,0;39,0;822,0;140,0;38,0;100,0;68,0;72,0;7,0;180,0;55,0;9,0;25,0;9,0;67,0;33,0;91,0;134,0;258,0;132,0;6,0;178,0;320,0;10,0;267,0;92,0;26,0;268,0;2650,0;62,0;193,0;46,0;;94,0;388,0;132,0;10,0;148,0;15,0;135,0;446,0;58,0;8,0;9,0;12,0;33,0;12,0;23,0;55,0;162,0;3151,0;191,0;54,0;169,0;4,0;308,0;106,0;414,0;95,0;42,0;1,0;49,0;38,0;106,0;10,0;;75,0;28,0;31,0;4,0;732,0;81,0;37,0;31,0;40,0;122,0;8,0;11,0;;159,0;30,0;32,0;43,0;30,0;100,0;19,0;8,0;66,0;36,0;1,0;73,0;183,0;44,0;1,0;7,0;1,0;205,0;3,0;6,0;54,0;36,0;206,0;117,0;16,0;245,0;10,0;44,0;12,0;19,0;83,0;105,0;16,0;103,0;181,0;62,0;18,0;102,0;71,0;507,0;77,0;14,0;4,0;6,0;3,0;17,0;;78,0;64,0;211,0;2,0;29,0;116,0;54,0;136,0;213,0;1,0;1,0;36,0;13,0;24,0;14,0;24,0;133,0;75,0;67,0;69,0;7,0;4,0;16,0;39,0;317,0;343,0;264,0;9,0;3,0;216,0;50,0;11,0;8,0;359,0;83,0;24,0;208,0;9,0;9,0;151,0;205,0;51,0;152,0;29,0;8,0;189,0;415,0;24,0;19,0;46,0;61,0;1151,0;24,0;128,0;51,0;226,0;117,0;344,0;37,0;52,0;61,0;5,0;71,0;63,0;28,0;54,0;20,0;48,0;106,0;108,0;9,0;9,0;97,0;62,0;528,0;117,0;16,0;165,0;280,0;42,0;61,0;5,0;155,0;71,0;15,0;86,0;60,0;139,0;75,0;281,0;117,0;49,0;17,0;291,0;122,0;58,0;482,0;290,0;108,0;128,0;103,0;43,0;18,0;90,0;49,0;103,0;115,0;81,0;22,0;94,0;99,0;63,0;169,0;2,0;22,0;121,0;53,0;140,0;236,0;78,0;27,0;26,0;25,0;208,0;84,0;236,0;45,0;58,0;293,0;442,0;13,0;4,0;21,0;3,0;7,0;82,0;79,0;142,0;17,0;15,0;49,0;48,0;67,0;28,0;1,0;7,0;54,0;234,0;19,0;115,0;209,0;77,0;35,0;50,0;60,0;292,0;6,0;7,0;31,0;122,0;56,0;;38,0;30,0;188,0;14,0;31,0;97,0;;2,0;193,0;62,0;211,0;259,0;57,0;17,0;7,0;1,0;40,0;7,0;65,0;20,0;27,0;201,0;151,0;73,0;28,0;55,0;5,0;15,0;46,0;6,0;11,0;7,0;139,0;144,0;81,0;9,0;84,0;7,0;12,0;45,0;23,0;52,0;70,0;13,0;53,0;15,0;43,0;2,0;150,0;17,0;47,0;19,0;328,0;1,0;4,0;17,0;266,0;7,0;32,0;26,0;9,0;2,0;44,0;6,0;6,0;14,0;5,0;21,0;6,0;2,0;11,0;8,0;107,0;17,0;274,0;78,0;289,0;5,0;76,0;37,0;264,0;10,0;3,0;3,0;;1,0;;55,0;84,0;142,0;83,0;124,0;51,0;70,0;46,0;164,0;38,0;11,0;21,0;33,0;174,0;224,0;44,0;6,0;35,0;203,0;29,0;39,0;14,0;98,0;48,0;157,0;14,0;30,0;32,0;20,0;225,0;18,0;;60,0;;44,0;43,0;68,0;25,0;231,0;88,0;74,0;;7,0;4,0;40,0;13,0;51,0;13,0;63,0;18,0;;6,0;27,0;13,0;8,0;15,0;66,0;6,0;50,0;13,0;137,0;6,0;20,0;37,0;150,0;32,0;14,0;4,0;10,0;53,0;17,0;47,0;;33,0;169,0;;24,0;19,0;22,0;13,0;30,0;3,0;29,0;62,0;21,0;61,0;12,0;59,0;86,0;3,0;;;1,0
include;1,0;39,0;28,0;27,0;610,0;25,0;130,0;367,0;99,0;521,0;40,0;67,0;26,0;13,0;265,0;46,0;16,0;9,0;225,0;108,0;99,0;565,0;77,0;55,0;138,0;8,0;10,0;913,0;22,0;214,0;207,0;262,0;1572,0;35,0;551,0;52,0;33,0;150,0;12,0;553,0;58,0;32,0;176,0;539,0;15,0;22,0;7,0;77,0;207,0;55,0;131,0;221,0;12,0;336,0;17,0;2969,0;;18,0;77,0;2380,0;19,0;18,0;1075,0;9,0;45,0;107,0;164,0;19,0;10,0;163,0;693,0;45,0;87,0;21,0;6,0;48,0;22,0;189,0;347,0;147,0;5,0;420,0;229,0;43,0;11,0;16,0;324,0;7,0;42,0;166,0;725,0;37,0;79,0;537,0;127,0;70,0;9,0;135,0;197,0;212,0;556,0;1434,0;3,0;156,0;7,0;11,0;99,0;1685,0;7,0;13,0;44,0;136,0;287,0;404,0;73,0;23,0;31,0;21,0;93,0;513,0;11,0;10,0;31,0;386,0;66,0;16,0;372,0;60,0;11,0;138,0;153,0;39,0;48,0;39,0;18,0;188,0;149,0;5,0;104,0;55,0;5,0;23,0;46,0;219,0;222,0;16,0;285,0;331,0;27,0;28,0;23,0;64,0;54,0;30,0;100,0;155,0;91,0;430,0;86,0;701,0;19,0;24,0;67,0;21,0;21,0;185,0;45,0;457,0;22,0;108,0;537,0;106,0;966,0;342,0;81,0;116,0;91,0;206,0;49,0;9,0;86,0;20,0;32,0;35,0;29,0;113,0;150,0;1307,0;3,0;699,0;10,0;29,0;72,0;335,0;27,0;104,0;33,0;15,0;51,0;53,0;68,0;73,0;26,0;179,0;43,0;26,0;71,0;34,0;142,0;295,0;47,0;28,0;30,0;6,0;104,0;209,0;97,0;106,0;2,0;30,0;72,0;133,0;14,0;50,0;107,0;94,0;77,0;2,0;4,0;3,0;17,0;9,0;83,0;45,0;96,0;105,0;35,0;76,0;407,0;16,0;342,0;28,0;66,0;51,0;42,0;66,0;46,0;69,0;16,0;72,0;70,0;29,0;40,0;175,0;16,0;8,0;78,0;155,0;18,0;11,0;11,0;135,0;52,0;22,0;68,0;27,0;89,0;7,0;35,0;47,0;37,0;111,0;25,0;6,0;35,0;147,0;55,0;12,0;26,0;48,0;50,0;53,0;20,0;320,0;31,0;188,0;25,0;389,0;54,0;31,0;42,0;4,0;17,0;88,0;5,0;9,0;138,0;246,0;44,0;7,0;81,0;24,0;177,0;46,0;50,0;35,0;4,0;172,0;31,0;33,0;72,0;58,0;13,0;33,0;55,0;19,0;17,0;14,0;41,0;25,0;35,0;80,0;75,0;34,0;2,0;166,0;28,0;59,0;67,0;20,0;188,0;18,0;33,0;11,0;7,0;12,0;;23,0;20,0;14,0;5,0;97,0;3,0;17,0;40,0;17,0;33,0;27,0;22,0;58,0;19,0;43,0;38,0;6,0;11,0;;5,0;3,0;15,0;8,0;46,0;9,0;7,0;3,0;110,0;56,0;13,0;12,0;71,0;43,0;54,0;12,0;10,0;42,0;119,0;129,0;44,0;57,0;;62,0;52,0;157,0;67,0;112,0;39,0;22,0;15,0;26,0;31,0;147,0;23,0;38,0;25,0;21,0;100,0;29,0;12,0;217,0;49,0;8,0;110,0;1,0;20,0;14,0;45,0;18,0;40,0;174,0;19,0;11,0;15,0;32,0;27,0;27,0;24,0;91,0;82,0;;156,0;30,0;99,0;17,0;60,0;69,0;278,0;31,0;23,0;86,0;17,0;109,0;38,0;9,0;16,0;13,0;9,0;30,0;23,0;27,0;31,0;39,0;89,0;15,0;32,0;24,0;46,0;142,0;176,0;80,0;26,0;41,0;1,0;105,0;134,0;110,0;10,0;108,0;41,0;3,0;110,0;6,0;13,0;58,0;17,0;11,0;40,0;131,0;91,0;9,0;192,0;35,0;6,0;102,0;27,0;2,0;19,0;25,0;228,0;13,0;18,0;18,0;23,0;17,0;14,0;1,0;1,0;50,0;144,0;58,0;23,0;145,0;22,0;159,0;33,0;17,0;455,0;282,0;34,0;25,0;5,0;13,0;11,0;32,0;48,0;15,0;240,0;39,0;15,0;21,0;8,0;37,0;24,0;6,0;20,0;181,0;109,0;70,0;80,0;27,0;19,0;17,0;6,0;14,0;20,0;54,0;5,0;27,0;23,0;4,0;8,0;3,0;17,0;16,0;14,0;16,0;171,0;26,0;33,0;13,0;20,0;25,0;3,0;80,0;12,0;15,0;11,0;16,0;44,0;37,0;29,0;21,0;15,0;55,0;27,0;9,0;72,0;4,0;43,0;8,0;7,0;53,0;822,0;6,0;47,0;7,0;16,0;6,0;38,0;7,0;6,0;7,0;63,0;18,0;51,0;30,0;20,0;5,0;53,0;20,0;3,0;34,0;1,0;29,0;150,0;25,0;22,0;215,0;34,0;12,0;10,0;31,0;51,0;15,0;9,0;9,0;63,0;50,0;6,0;10,0;9,0;9,0;31,0;17,0;87,0;23,0;29,0;6,0;73,0;17,0;19,0;4,0;17,0;42,0;1,0;5,0;12,0;5,0;52,0;15,0;1,0;;23,0;16,0;18,0;35,0;7,0;3,0;1,0;7,0;57,0;9,0;2,0;55,0;38,0;54,0;34,0;29,0;49,0;18,0;62,0;4,0;8,0;5,0;28,0;22,0;4,0;18,0;7,0;7,0;12,0;14,0;58,0;95,0;7,0;13,0;31,0;15,0;2,0;27,0;8,0;21,0;38,0;3,0;27,0;4,0;38,0;28,0;19,0;17,0;27,0;6,0;14,0;3,0;15,0;16,0;56,0;26,0;25,0;17,0;5,0;11,0;50,0;33,0;31,0;59,0;95,0;12,0;28,0;4,0;10,0;13,0;6,0;19,0;2,0;4,0;16,0;10,0;31,0;40,0;58,0;19,0;53,0;8,0;10,0;12,0;22,0;33,0;57,0;3,0;6,0;96,0;18,0;7,0;9,0;43,0;6,0;4,0;138,0;17,0;13,0;27,0;47,0;20,0;9,0;38,0;13,0;4,0;2,0;3,0;2,0;12,0;32,0;19,0;55,0;32,0;7,0;22,0;7,0;4,0;7,0;10,0;24,0;13,0;6,0;47,0;15,0;14,0;35,0;35,0;9,0;1,0;7,0;27,0;9,0;35,0;39,0;15,0;13,0;39,0;26,0;72,0;9,0;36,0;16,0;36,0;13,0;8,0;6,0;39,0;6,0;23,0;48,0;21,0;6,0;17,0;4,0;131,0;41,0;11,0;9,0;10,0;17,0;15,0;7,0;44,0;1,0;26,0;47,0;28,0;4,0;1,0;8,0;3,0;11,0;20,0;29,0;8,0;7,0;12,0;9,0;10,0;15,0;6,0;1,0;18,0;9,0;9,0;3,0;8,0;48,0;19,0;15,0;9,0;2,0;28,0;10,0;4,0;8,0;3,0;;4,0;23,0;3,0;25,0;20,0;6,0;50,0;4,0;5,0;17,0;43,0;14,0;10,0;31,0;9,0;17,0;2,0;18,0;87,0;62,0;3,0;10,0;8,0;36,0;38,0;6,0;24,0;10,0;12,0;7,0;38,0;10,0;20,0;17,0;21,0;10,0;21,0;39,0;32,0;28,0;11,0;40,0;15,0;11,0;25,0;24,0;3,0;15,0;10,0;24,0;7,0;13,0;19,0;45,0;1,0;25,0;10,0;37,0;2,0;6,0;10,0;24,0;5,0;6,0;12,0;13,0;22,0;1,0;16,0;15,0;10,0;;9,0;10,0;49,0;16,0;8,0;21,0;;11,0;37,0;36,0;21,0;13,0;11,0;6,0;3,0;5,0;2,0;10,0;3,0;21,0;10,0;11,0;12,0;3,0;6,0;1,0;9,0;2,0;3,0;31,0;22,0;15,0;4,0;31,0;29,0;15,0;10,0;6,0;12,0;15,0;25,0;2,0;2,0;6,0;30,0;12,0;9,0;2,0;10,0;;1,0;17,0;33,0;61,0;6,0;7,0;13,0;4,0;17,0;18,0;6,0;31,0;18,0;3,0;5,0;19,0;2,0;10,0;2,0;2,0;;4,0;;6,0;17,0;8,0;11,0;8,0;4,0;4,0;2,0;18,0;19,0;10,0;7,0;19,0;4,0;9,0;4,0;8,0;9,0;2,0;5,0;9,0;9,0;30,0;8,0;1,0;3,0;98,0;28,0;3,0;;11,0;33,0;3,0;2,0;;
interpolation;6,0;;;;8,0;;;15,0;6,0;9,0;;;4,0;15,0;72,0;;;4,0;32,0;;;3,0;3,0;2,0;20,0;;1,0;51,0;1,0;6,0;13,0;13,0;33,0;9,0;3,0;;;5,0;;2,0;3,0;11,0;;5,0;;;;;12,0;;6,0;4,0;;1,0;;75,0;18,0;;;14,0;12,0;;30,0;;;;;;;10,0;1,0;1,0;;;;;;2,0;28,0;;;63,0;2,0;6,0;;;3,0;;;7,0;4,0;5,0;;11,0;;8,0;;10,0;2,0;;;8,0;;;;;;58,0;;;2,0;2,0;7,0;;;1,0;;;;;;;2,0;19,0;;;11,0;;;;;2,0;;;;;;;;;;;;;23,0;;5,0;12,0;2,0;;3,0;;;;;;;;;5,0;;1,0;;;;;;3,0;1,0;;;;10,0;1,0;;;;22,0;;;;;;;;;;11,0;;;;;;;;;;;;;;;;;;1,0;;;5,0;;2,0;5,0;;;;6,0;;;;;;;;;;;3,0;;;;;;;2,0;;1,0;;1,0;5,0;;;;4,0;;;4,0;1,0;;;;;4,0;;;;;;;;;;;1,0;;;;;;;;;;;;;;13,0;;;2,0;;;;;;1,0;;6,0;;2,0;;;;2,0;;;;;;;;;4,0;;;;;2,0;;;7,0;5,0;;;;;;;;;;;;;;;;;;;;;;;;;;;;;;1,0;;1,0;;2,0;5,0;1,0;;;2,0;;;;;;1,0;;;;;;;1,0;;1,0;;;;1,0;;;;;;3,0;4,0;2,0;;;;1,0;;;;;;;;;;;;;;;;;3,0;;;;;;;;2,0;;;;;;;;;;;;2,0;;;;;;;;;;3,0;9,0;1,0;12,0;;;;;;;;;;;;;;1,0;4,0;7,0;;;;;1,0;;;2,0;;;;;;;;;;2,0;;;14,0;;;56,0;;;;5,0;;;1,0;;5,0;3,0;;;;;;;2,0;;;2,0;;;;4,0;;;;;;;;;6,0;;;;;;;;;;;;;1,0;;;;;2,0;;;;;;;;;;;;;;;;;;;;;;;;;;;;3,0;;;6,0;;;;;;;73,0;;;;;;;;;;;;;;;;;;;;;;1,0;;1,0;;;;;;;;;;;;;;2,0;;;;;;;;;;;;;;;;;;;;;;;;;;;;;;;;;;;;3,0;;;;;;;4,0;;;;3,0;;;;;2,0;;1,0;;;;;;8,0;;;;;;;;;;;;;;;;2,0;;;1,0;;;;;;1,0;1,0;;;4,0;1,0;;;;;;;;;4,0;;;3,0;;3,0;;;;;;;20,0;;;;;;;;;;;;;;;;;;;;;;;;5,0;;;;1,0;1,0;;4,0;1,0;;;;;;5,0;;;;;;2,0;;1,0;7,0;;;;;;1,0;;;;;;1,0;;;;;;;;7,0;;;;;;;;;;;;;;;1,0;;;;;;;2,0;;;;;;;;;;;;4,0;5,0;3,0;;;;;;4,0;;;;;;;;;;;;;;1,0;;;;;;;;;;;;;;;;;;;;;;;;;;;;;;;;;;;;;;;;;;;;;;;1,0;;;;;;;;;;;;;;;;;;;3,0;;;;;;;;;;;23,0;;;;;;;;;;;;;;;;;;9,0;;;;;;;1,0;;;;;;;;3,0;8,0;;;;;;;;;;;;;;;;;;;;1,0;;;;;;;;;;;;;;;;;;;;;;;;;;;;;;;;;;;;
length;2,0;4,0;20,0;1,0;66,0;;69,0;95,0;62,0;19,0;15,0;13,0;2,0;5,0;2,0;;2,0;13,0;14,0;4,0;130,0;72,0;3,0;14,0;14,0;2,0;1,0;23,0;9,0;37,0;24,0;55,0;69,0;24,0;18,0;2,0;4,0;143,0;4,0;50,0;102,0;4,0;6,0;172,0;1,0;4,0;3,0;2316,0;52,0;;22,0;12,0;;317,0;37,0;193,0;77,0;;;1345,0;7,0;20,0;70,0;77,0;1,0;1,0;4,0;7,0;2,0;21,0;289,0;9,0;69,0;;;22,0;;66,0;81,0;10,0;;13,0;5,0;7,0;4,0;;37,0;12,0;49,0;26,0;57,0;1,0;16,0;22,0;30,0;26,0;;3,0;4,0;14,0;52,0;651,0;;32,0;4,0;;1,0;316,0;7,0;;4,0;12,0;7,0;27,0;10,0;;;4,0;13,0;26,0;5,0;;57,0;11,0;;;53,0;5,0;1,0;10,0;45,0;;;5,0;2,0;3,0;9,0;1,0;2,0;1,0;;1,0;6,0;3,0;3,0;3,0;24,0;17,0;3,0;1,0;2,0;12,0;7,0;14,0;4,0;7,0;11,0;21,0;;76,0;5,0;14,0;1,0;;;4,0;3,0;23,0;;8,0;34,0;1,0;54,0;24,0;10,0;3,0;5,0;32,0;1,0;;;1,0;7,0;;1,0;11,0;12,0;45,0;;94,0;;2,0;;12,0;4,0;8,0;4,0;;5,0;5,0;;8,0;1,0;75,0;7,0;20,0;4,0;3,0;17,0;57,0;;2,0;;1,0;21,0;134,0;;1,0;2,0;4,0;5,0;16,0;;;2,0;3,0;1,0;;;;6,0;11,0;5,0;6,0;60,0;88,0;;9,0;17,0;2,0;15,0;;2,0;23,0;9,0;11,0;;1,0;3,0;11,0;1,0;7,0;;15,0;8,0;4,0;;34,0;13,0;19,0;2,0;8,0;10,0;1,0;7,0;1,0;32,0;;13,0;;4,0;6,0;1,0;11,0;3,0;3,0;;;465,0;11,0;1,0;;;9,0;1,0;5,0;4,0;94,0;12,0;7,0;;;16,0;9,0;;7,0;;22,0;2,0;;2,0;;111,0;2,0;1,0;1,0;2,0;57,0;;3,0;17,0;32,0;;2,0;23,0;;;;;7,0;4,0;2,0;3,0;8,0;;;4,0;4,0;;2,0;21,0;21,0;2,0;;;1,0;4,0;;1,0;4,0;1,0;13,0;;12,0;12,0;;1,0;10,0;4,0;48,0;2,0;;2,0;3,0;;14,0;;;8,0;;28,0;;;1,0;6,0;16,0;2,0;2,0;6,0;8,0;;;3,0;27,0;5,0;1,0;4,0;3,0;147,0;11,0;16,0;6,0;5,0;;2,0;;2,0;22,0;1,0;3,0;2,0;4,0;14,0;;5,0;1,0;5,0;10,0;21,0;56,0;7,0;;;10,0;10,0;7,0;14,0;298,0;1,0;2,0;5,0;6,0;;24,0;1,0;2,0;13,0;;31,0;1,0;7,0;1,0;;2,0;5,0;4,0;;6,0;3,0;2,0;;;;1,0;;;1,0;1,0;2,0;3,0;3,0;2,0;;;2,0;8,0;4,0;2,0;6,0;2,0;1,0;8,0;22,0;6,0;;;;;4,0;;;;;60,0;1,0;7,0;8,0;;36,0;;;14,0;2,0;9,0;;;22,0;;;;1,0;;;7,0;;1,0;;;2,0;23,0;1,0;19,0;6,0;2,0;16,0;19,0;;6,0;;;;12,0;1,0;2,0;20,0;5,0;;32,0;1,0;;;;;;;;;;;;;5,0;2,0;;;;3,0;;;4,0;2,0;3,0;6,0;;;;1,0;1,0;1,0;;;;;6,0;1,0;;26,0;2,0;;;4,0;9,0;1,0;8,0;;3,0;2,0;;2,0;;19,0;4,0;;;5,0;;8,0;;;;2,0;;;;2,0;;7,0;;;4,0;;4,0;7,0;1,0;1,0;2,0;;;;;;1,0;;1,0;;2,0;4,0;1,0;;2,0;;;15,0;50,0;4,0;;7,0;2,0;3,0;1,0;;3,0;;;;;;;;2,0;;9,0;2,0;;;3,0;1,0;1,0;3,0;3,0;;61,0;37,0;27,0;;6,0;8,0;;4,0;1,0;1,0;;16,0;1,0;2,0;16,0;;6,0;30,0;;7,0;5,0;;;;;;;;11,0;6,0;;;7,0;;2,0;;2,0;;13,0;;383,0;;14,0;16,0;;;4,0;;6,0;;;25,0;;6,0;;;1,0;1,0;;;4,0;14,0;37,0;4,0;;14,0;19,0;2,0;6,0;26,0;;;2,0;1,0;;;;1,0;4,0;;5,0;7,0;1,0;;4,0;7,0;;;;2,0;3,0;10,0;;;12,0;;;;;;2,0;8,0;1,0;;1,0;;1,0;;;2,0;1,0;;;6,0;1,0;11,0;5,0;110,0;;3,0;2,0;;4,0;;3,0;1,0;33,0;35,0;3,0;3,0;23,0;;6,0;;;;;5,0;10,0;3,0;1,0;2,0;;29,0;;6,0;1,0;;1,0;;;;;;;9,0;3,0;1,0;;;1,0;;3,0;;;;;;;;;;;;;;;61,0;;;1,0;;;4,0;;;;3,0;;1,0;3,0;3,0;;6,0;2,0;;;2,0;4,0;2,0;;23,0;2,0;;;2,0;2,0;;;;;;;;;;;;;3,0;;;1,0;;;14,0;;;1,0;;2,0;10,0;;1,0;;;;2,0;3,0;;;4,0;;15,0;;;;;3,0;;;;;;;;;;;;;;;139,0;;4,0;;;1,0;3,0;7,0;;1,0;;;;;;;;;;;;;;;;;;10,0;2,0;3,0;1,0;1,0;;3,0;;1,0;;;;1,0;1,0;;;;;;;36,0;;;;;;2,0;;;;;;;;;;;8,0;1,0;;5,0;;24,0;;4,0;;;;;;;;2,0;;;;;;;;;;4,0;2,0;;5,0;;;;;;;39,0;;;;;;
lens;31,0;36,0;199,0;1,0;804,0;195,0;1801,0;606,0;82,0;380,0;211,0;108,0;18,0;38,0;40,0;47,0;42,0;59,0;273,0;4,0;419,0;819,0;7,0;102,0;272,0;1,0;20,0;366,0;76,0;316,0;185,0;254,0;1497,0;24,0;566,0;14,0;111,0;1038,0;54,0;173,0;719,0;75,0;716,0;4201,0;11,0;19,0;7,0;1467,0;1716,0;14,0;137,0;154,0;;3761,0;56,0;3879,0;2380,0;14,0;1345,0;;44,0;223,0;484,0;43,0;10,0;299,0;636,0;306,0;6,0;290,0;4476,0;461,0;209,0;80,0;96,0;249,0;15,0;299,0;2472,0;1166,0;86,0;66,0;47,0;42,0;47,0;46,0;86,0;34,0;62,0;111,0;864,0;87,0;133,0;446,0;81,0;301,0;8,0;99,0;223,0;227,0;2209,0;3429,0;14,0;91,0;3,0;2,0;121,0;7320,0;24,0;;129,0;516,0;281,0;1038,0;468,0;5,0;241,0;6,0;136,0;949,0;53,0;19,0;90,0;159,0;34,0;27,0;846,0;249,0;44,0;299,0;513,0;21,0;17,0;408,0;124,0;187,0;772,0;15,0;45,0;41,0;3,0;5,0;103,0;362,0;226,0;120,0;1097,0;1064,0;5,0;108,0;6,0;159,0;301,0;25,0;724,0;1055,0;195,0;870,0;95,0;1371,0;161,0;69,0;236,0;132,0;6,0;134,0;19,0;1177,0;11,0;261,0;1261,0;112,0;2211,0;1315,0;441,0;399,0;293,0;164,0;74,0;25,0;26,0;21,0;331,0;47,0;32,0;302,0;150,0;1397,0;7,0;1122,0;13,0;92,0;15,0;913,0;15,0;285,0;563,0;29,0;171,0;107,0;16,0;211,0;74,0;2302,0;35,0;45,0;47,0;57,0;230,0;661,0;13,0;99,0;17,0;4,0;92,0;284,0;175,0;106,0;32,0;170,0;129,0;123,0;111,0;25,0;145,0;32,0;98,0;1,0;14,0;56,0;112,0;65,0;178,0;197,0;276,0;256,0;58,0;88,0;189,0;111,0;3675,0;32,0;66,0;86,0;21,0;91,0;16,0;121,0;66,0;139,0;4,0;8,0;19,0;303,0;201,0;17,0;139,0;261,0;29,0;153,0;41,0;757,0;44,0;121,0;232,0;29,0;269,0;45,0;55,0;37,0;20,0;296,0;19,0;54,0;103,0;40,0;5,0;16,0;740,0;297,0;36,0;146,0;13,0;339,0;65,0;39,0;1429,0;1624,0;76,0;131,0;30,0;25,0;19,0;16,0;48,0;94,0;19,0;759,0;26,0;4,0;92,0;3,0;302,0;75,0;84,0;60,0;21,0;299,0;175,0;52,0;67,0;118,0;295,0;619,0;295,0;;37,0;40,0;92,0;53,0;58,0;104,0;80,0;81,0;36,0;121,0;207,0;41,0;47,0;;52,0;46,0;4,0;1,0;5,0;1,0;40,0;23,0;13,0;3,0;29,0;55,0;7,0;70,0;168,0;4,0;9,0;45,0;38,0;226,0;381,0;42,0;15,0;13,0;1,0;78,0;1,0;9,0;18,0;23,0;12,0;4,0;13,0;12,0;19,0;78,0;3,0;9,0;59,0;11,0;34,0;18,0;6,0;73,0;19,0;130,0;42,0;;226,0;124,0;38,0;217,0;;10,0;10,0;29,0;13,0;34,0;2,0;51,0;18,0;51,0;52,0;1,0;176,0;43,0;67,0;50,0;5,0;78,0;11,0;;18,0;43,0;2,0;13,0;27,0;3167,0;13,0;4,0;194,0;103,0;61,0;66,0;;10,0;13,0;;91,0;39,0;27,0;8,0;1,0;111,0;118,0;59,0;4,0;74,0;33,0;125,0;16,0;4,0;2,0;10,0;6,0;45,0;1,0;7,0;;5,0;12,0;2,0;21,0;12,0;14,0;186,0;29,0;65,0;15,0;98,0;;27,0;191,0;45,0;16,0;10,0;26,0;2,0;12,0;;18,0;;6,0;105,0;5,0;51,0;651,0;14,0;53,0;;;136,0;6,0;;13,0;9,0;41,0;4,0;7,0;4,0;14,0;;4,0;17,0;;368,0;33,0;14,0;16,0;86,0;1,0;149,0;57,0;51,0;117,0;190,0;29,0;33,0;38,0;;1,0;1,0;1,0;4,0;448,0;107,0;7,0;179,0;4,0;48,0;38,0;2,0;;5,0;97,0;98,0;62,0;1,0;;27,0;94,0;8,0;3,0;7,0;;3,0;88,0;;17,0;47,0;9,0;;97,0;;6,0;;9,0;5,0;1,0;;;45,0;3,0;142,0;27,0;4,0;9,0;3,0;;9,0;10,0;3,0;13,0;16,0;8,0;15,0;18,0;37,0;4,0;63,0;47,0;;5,0;2,0;3,0;1,0;333,0;1,0;19,0;6,0;;39,0;;;43,0;5,0;34,0;5,0;1,0;2,0;2,0;3,0;297,0;65,0;11,0;153,0;154,0;2,0;;1,0;5,0;63,0;11,0;24,0;204,0;12,0;29,0;2,0;194,0;17,0;31,0;6,0;30,0;85,0;3,0;9,0;653,0;57,0;15,0;3,0;16,0;77,0;38,0;;11,0;;8,0;24,0;41,0;20,0;24,0;6,0;5,0;71,0;9,0;2,0;1,0;11,0;18,0;19,0;;47,0;88,0;95,0;68,0;5,0;196,0;20,0;24,0;19,0;2,0;13,0;305,0;3,0;184,0;;;38,0;15,0;21,0;10,0;52,0;7,0;5,0;67,0;92,0;22,0;11,0;19,0;24,0;21,0;14,0;;201,0;132,0;45,0;122,0;21,0;;19,0;5,0;401,0;23,0;208,0;47,0;9,0;52,0;10,0;;;2,0;6,0;14,0;10,0;14,0;;7,0;25,0;6,0;3,0;;173,0;4,0;221,0;26,0;2,0;;25,0;35,0;;343,0;2,0;1,0;8,0;1,0;36,0;3,0;6,0;9,0;41,0;;40,0;4,0;53,0;4,0;6,0;1,0;33,0;8,0;39,0;185,0;;29,0;45,0;9,0;60,0;1,0;9,0;8,0;1,0;11,0;;32,0;12,0;;;5,0;16,0;;1,0;10,0;52,0;;23,0;;46,0;33,0;6,0;624,0;;17,0;30,0;18,0;13,0;;1,0;1,0;140,0;22,0;45,0;30,0;90,0;4,0;5,0;6,0;260,0;2,0;3,0;6,0;;25,0;6,0;43,0;32,0;8,0;14,0;3,0;39,0;49,0;4,0;2,0;17,0;10,0;3,0;1,0;1,0;43,0;2,0;31,0;2,0;16,0;4,0;;;40,0;2,0;7,0;17,0;1,0;11,0;;5,0;5,0;18,0;2,0;;21,0;1,0;;4,0;12,0;3,0;1,0;20,0;11,0;8,0;7,0;1,0;11,0;;;;33,0;36,0;;52,0;22,0;42,0;45,0;12,0;33,0;81,0;19,0;37,0;7,0;3,0;4,0;89,0;11,0;13,0;12,0;2,0;62,0;2,0;5,0;6,0;;7,0;1,0;72,0;12,0;;11,0;5,0;;;16,0;;66,0;11,0;10,0;44,0;174,0;19,0;57,0;2,0;7,0;13,0;15,0;3,0;22,0;3,0;9,0;6,0;7,0;10,0;9,0;4,0;26,0;53,0;1,0;2,0;;24,0;34,0;9,0;16,0;112,0;7,0;;;2,0;;;174,0;5,0;6,0;;;128,0;;49,0;16,0;8,0;8,0;;7,0;1,0;1,0;;48,0;14,0;;11,0;;13,0;58,0;;16,0;291,0;1,0;59,0;1,0;;13,0;26,0;5,0;1,0;5,0;14,0;;4,0;;1,0;21,0;2,0;4,0;12,0;3,0;9,0;8,0;52,0;;2,0;;5,0;2,0;12,0;15,0;2,0;3,0;4,0;53,0;15,0;;7,0;1,0;;6,0;14,0;6,0;;2,0;55,0;;465,0;74,0;4,0;1,0;12,0;3,0;16,0;7,0;;6,0;8,0;;5,0;67,0;;;;3,0;13,0;9,0;27,0;8,0;;;;;26,0;;191,0;1,0;451,0;;;;
linear;10,0;;4,0;;12,0;;25,0;24,0;6,0;16,0;10,0;;;27,0;2,0;1,0;;;1,0;1,0;;15,0;;3,0;6,0;;3,0;10,0;2,0;3,0;26,0;7,0;34,0;1,0;12,0;4,0;;40,0;5,0;5,0;3,0;2,0;16,0;25,0;;;;8,0;8,0;1,0;31,0;3,0;;;1,0;63,0;19,0;12,0;7,0;44,0;;7,0;25,0;;5,0;16,0;4,0;1,0;1,0;4,0;11,0;1,0;5,0;1,0;;;4,0;4,0;41,0;4,0;1,0;1,0;;;7,0;;27,0;;2,0;8,0;218,0;2,0;;10,0;1,0;1,0;;;8,0;2,0;2,0;28,0;;3,0;;;6,0;30,0;;4,0;11,0;33,0;31,0;;1,0;;;1,0;1,0;2,0;;2,0;1,0;;;;7,0;;;8,0;8,0;;;64,0;;;3,0;;7,0;1,0;;;;1,0;14,0;18,0;23,0;3,0;;1,0;1,0;16,0;35,0;;;1,0;7,0;5,0;19,0;5,0;7,0;;4,0;;;;7,0;23,0;1,0;2,0;38,0;5,0;15,0;6,0;71,0;;1,0;2,0;;;;;4,0;;4,0;6,0;12,0;35,0;24,0;66,0;;;2,0;3,0;;1,0;;1,0;12,0;1,0;;4,0;1,0;5,0;;1,0;;;5,0;18,0;1,0;;;1,0;6,0;12,0;5,0;6,0;1,0;4,0;;1,0;;1,0;4,0;;;;;;1,0;;10,0;6,0;1,0;5,0;;8,0;9,0;2,0;8,0;3,0;1,0;;;;;;4,0;11,0;;;;9,0;;;1,0;1,0;;;4,0;7,0;1,0;;5,0;;1,0;;;;3,0;4,0;;;4,0;;;2,0;1,0;1,0;5,0;1,0;;13,0;;12,0;14,0;9,0;3,0;;;8,0;;;;;3,0;;;;1,0;;;1,0;13,0;;4,0;2,0;;;22,0;7,0;;;;;9,0;4,0;;;;;11,0;6,0;1,0;5,0;;2,0;1,0;11,0;1,0;;1,0;;1,0;;3,0;;;;;2,0;;;4,0;2,0;;1,0;;6,0;6,0;1,0;5,0;;;1,0;;1,0;;;1,0;;;;;;;1,0;1,0;;;;;2,0;;2,0;;;;5,0;;2,0;;1,0;;5,0;;3,0;;;;2,0;5,0;;;2,0;;;2,0;;1,0;;;;1,0;2,0;;2,0;;;3,0;3,0;9,0;;;;1,0;;6,0;;;;;1,0;6,0;;1,0;1,0;2,0;;;;;;;1,0;;;;;;;2,0;;;;6,0;5,0;;;;3,0;3,0;1,0;;2,0;;;;;;;;1,0;;;12,0;;;;;7,0;;;;;;;;;;1,0;;;;30,0;2,0;1,0;1,0;4,0;;;;;2,0;11,0;;2,0;;;;1,0;2,0;;1,0;;;;;;;;;;;2,0;;;;;;4,0;;;;;4,0;;1,0;;1,0;4,0;1,0;1,0;;;;;;;;1,0;;4,0;;1,0;4,0;;;;1,0;1,0;;1,0;;;;;;;25,0;;;;;;7,0;;;;;;;;;1,0;;;;;;;8,0;;;1,0;;;;;;;;6,0;3,0;;;;;2,0;;;;;;;;2,0;1,0;;;;;;;;;;;;;;;;;;;;1,0;;;;1,0;1,0;2,0;;;;;;;;1,0;;;;;2,0;;;;;;;;4,0;;;1,0;;4,0;;;1,0;;;;;;3,0;;;;1,0;;;;;7,0;;;;6,0;;2,0;;;;;;;1,0;;2,0;2,0;;;;;;2,0;;;;1,0;;;;;;;;;9,0;;;;;;;;;1,0;;;;;;;;5,0;;;;;;;8,0;;;3,0;;;8,0;;;7,0;3,0;1,0;;;;1,0;13,0;;9,0;5,0;3,0;;2,0;1,0;3,0;;;;;;1,0;1,0;;;;;;;4,0;8,0;1,0;;;;;;1,0;;;;;;;;;;;;;;;;;;;;;1,0;;;;;;;;4,0;1,0;;;3,0;;7,0;;;;;;2,0;1,0;;;;;1,0;4,0;2,0;;;;1,0;;;;;;;;10,0;;;;;1,0;;;;;1,0;;;;8,0;;;;1,0;;;;;;2,0;;;;4,0;;;;;;2,0;5,0;4,0;;;;5,0;;1,0;;;;;;;;;;;;;;;1,0;;;;;1,0;;;1,0;;;;;;;;;;;;2,0;;1,0;;;;2,0;;;3,0;;;;;;;1,0;;;;;1,0;;;;;;;;;13,0;;;;;;;;;1,0;;;;;;;;3,0;;;28,0;1,0;;;;;;;;;;;;;;;;;;;;;;;;;;;
magnification;80,0;;26,0;1,0;29,0;;23,0;26,0;12,0;7,0;3,0;;;4,0;14,0;;;1,0;10,0;2,0;31,0;67,0;2,0;3,0;6,0;;;29,0;6,0;18,0;19,0;64,0;55,0;1,0;31,0;;2,0;30,0;2,0;212,0;56,0;;;8,0;;;9,0;22,0;34,0;;19,0;6,0;;34,0;11,0;383,0;18,0;;20,0;223,0;7,0;;35,0;22,0;42,0;;12,0;1,0;1,0;20,0;72,0;12,0;2,0;;;33,0;;6,0;41,0;11,0;;20,0;3,0;;;;;;8,0;35,0;38,0;17,0;35,0;16,0;15,0;7,0;;13,0;36,0;;;61,0;;;2,0;;;195,0;;;1,0;9,0;;1,0;1,0;;;;;1,0;;;97,0;4,0;;;25,0;;;;;3,0;;;;;8,0;;;;;1,0;;2,0;;;46,0;11,0;;;;;;;;;;1,0;2,0;37,0;;19,0;;;;;14,0;;;;2,0;;10,0;;2,0;2,0;;10,0;;;;;;;;8,0;1,0;51,0;;7,0;;;;7,0;2,0;2,0;;;10,0;;;;;17,0;;;;;1,0;;;;;8,0;22,0;25,0;1,0;;;1,0;;;3,0;;;;;;;;;1,0;;;20,0;31,0;;4,0;31,0;3,0;5,0;;4,0;;;4,0;;;;;;;;;;;;4,0;6,0;;5,0;3,0;;;;;;;;;;;;;;1,0;;;15,0;3,0;;;;2,0;;5,0;19,0;72,0;1,0;;;;;;;1,0;;19,0;;;;;39,0;;;;;15,0;;;32,0;1,0;8,0;;;;;;;;;2,0;;1,0;;;;;;;5,0;88,0;;1,0;;;23,0;2,0;;;;10,0;;6,0;1,0;1,0;;12,0;;132,0;;7,0;;;;11,0;;;;;2,0;;;;;8,0;;;;6,0;;9,0;;;1,0;8,0;;;;1,0;2,0;5,0;1,0;;;1,0;8,0;62,0;2,0;1,0;;11,0;;;;4,0;1,0;10,0;20,0;;3,0;;;28,0;;;;316,0;2,0;4,0;;2,0;;;;4,0;2,0;;86,0;;;;;;3,0;;;8,0;1,0;;;;;;;;;3,0;;;;;;;;53,0;;33,0;5,0;;2,0;1,0;6,0;2,0;;;;8,0;4,0;;;18,0;1,0;9,0;;10,0;;2,0;1,0;;;24,0;;;;2,0;;;;;;;1,0;2,0;;;2,0;2,0;7,0;12,0;;22,0;1,0;;1,0;6,0;;;;1,0;;;;1,0;2,0;2,0;;1,0;;;;;;;;3,0;;;;3,0;;;;2,0;;;;;;;;;;;;2,0;;2,0;;;;9,0;;;;;;;;;2,0;;;;;;;;1,0;10,0;11,0;;;;;1,0;19,0;3,0;;;;;;;;;;;;;;;11,0;4,0;;;;;;;;;;;;;;;;;;;8,0;2,0;;;;;;;;3,0;;;;;;;;;;;;;2,0;;;;;;;;3,0;3,0;2,0;;;;;;;;;;;;;;1,0;;1,0;;;;;;;;3,0;;;;;;;;1,0;;;;3,0;43,0;;1,0;3,0;;;;;;;;;;1,0;;;33,0;;;;;1,0;;153,0;2,0;;3,0;;;9,0;;;11,0;;1,0;;;;;;;;5,0;;;;;2,0;;;;1,0;;;;;;;;1,0;;1,0;;;;12,0;;;;;;;;;9,0;3,0;2,0;27,0;;;;;;27,0;;;110,0;2,0;;4,0;8,0;;;;1,0;;;2,0;;3,0;;;;;;;;2,0;;4,0;;;;;;;8,0;;;;;;;;4,0;;;;;;;;;;;;;1,0;;;;;;;;;;3,0;;;;;;;4,0;;;;;;5,0;;;;;5,0;;;;;;;;;;;;;;;;;2,0;;;9,0;;;;;;;;;;;;;;;;16,0;;;;2,0;;;;;;;;;;;;;;;;;;1,0;;;;;;;;;;;;;;;;;;;;;;;;;2,0;;4,0;;;;;;;;;;;;;;;;1,0;;;;;;;;;;;;;;;;;;1,0;;;;;;;;;;;;;;;;1,0;;;;;;;;;;;;;;;;1,0;;;;;;;2,0;;;;;
method;25,0;8,0;104,0;33,0;547,0;2,0;76,0;371,0;183,0;608,0;55,0;96,0;8,0;37,0;314,0;49,0;52,0;44,0;144,0;253,0;93,0;1004,0;98,0;123,0;136,0;16,0;27,0;844,0;88,0;517,0;278,0;820,0;1111,0;127,0;757,0;39,0;39,0;170,0;32,0;765,0;166,0;46,0;64,0;173,0;63,0;33,0;28,0;81,0;307,0;57,0;153,0;367,0;16,0;61,0;31,0;4065,0;1075,0;30,0;70,0;484,0;25,0;35,0;;21,0;106,0;85,0;202,0;21,0;34,0;192,0;248,0;41,0;67,0;14,0;5,0;41,0;2,0;374,0;514,0;72,0;17,0;705,0;136,0;95,0;41,0;10,0;262,0;17,0;52,0;445,0;398,0;24,0;32,0;460,0;110,0;66,0;23,0;95,0;247,0;105,0;218,0;898,0;12,0;171,0;23,0;44,0;32,0;374,0;18,0;;19,0;56,0;143,0;94,0;73,0;41,0;9,0;20,0;32,0;85,0;25,0;6,0;64,0;70,0;64,0;21,0;65,0;20,0;57,0;74,0;49,0;60,0;8,0;1,0;52,0;125,0;44,0;2,0;15,0;33,0;21,0;45,0;78,0;138,0;166,0;7,0;271,0;361,0;35,0;14,0;37,0;3,0;22,0;13,0;11,0;25,0;15,0;71,0;129,0;543,0;15,0;36,0;10,0;15,0;36,0;67,0;128,0;413,0;27,0;73,0;43,0;40,0;347,0;170,0;149,0;35,0;5,0;386,0;35,0;2,0;8,0;18,0;55,0;10,0;8,0;99,0;63,0;548,0;9,0;312,0;12,0;6,0;39,0;371,0;10,0;30,0;5,0;1,0;56,0;43,0;41,0;52,0;13,0;59,0;3,0;33,0;29,0;18,0;26,0;60,0;103,0;14,0;42,0;13,0;53,0;351,0;181,0;51,0;21,0;22,0;19,0;153,0;44,0;34,0;6,0;31,0;83,0;;5,0;1,0;2,0;12,0;48,0;37,0;203,0;134,0;;164,0;283,0;31,0;32,0;;49,0;19,0;13,0;25,0;28,0;33,0;;1,0;34,0;79,0;15,0;90,0;2,0;40,0;8,0;161,0;32,0;5,0;29,0;280,0;100,0;2,0;11,0;4,0;36,0;1,0;2,0;11,0;11,0;14,0;27,0;4,0;32,0;97,0;26,0;1,0;27,0;53,0;9,0;1,0;23,0;22,0;25,0;263,0;51,0;631,0;164,0;19,0;16,0;2,0;31,0;120,0;3,0;12,0;17,0;154,0;24,0;2,0;80,0;8,0;294,0;36,0;63,0;2,0;1,0;196,0;8,0;10,0;169,0;81,0;9,0;3,0;7,0;1,0;4,0;5,0;10,0;30,0;6,0;91,0;9,0;3,0;2,0;154,0;18,0;10,0;20,0;21,0;296,0;42,0;14,0;20,0;5,0;16,0;19,0;37,0;9,0;21,0;7,0;155,0;6,0;22,0;47,0;22,0;28,0;59,0;14,0;72,0;38,0;93,0;95,0;20,0;20,0;21,0;23,0;2,0;18,0;12,0;104,0;30,0;6,0;12,0;200,0;54,0;27,0;7,0;45,0;69,0;16,0;6,0;19,0;187,0;138,0;124,0;59,0;73,0;;37,0;71,0;35,0;31,0;139,0;30,0;34,0;47,0;36,0;27,0;271,0;4,0;92,0;9,0;28,0;59,0;59,0;29,0;223,0;218,0;3,0;203,0;9,0;45,0;14,0;81,0;38,0;115,0;126,0;28,0;31,0;63,0;31,0;25,0;63,0;36,0;131,0;141,0;6,0;167,0;60,0;291,0;1,0;37,0;140,0;223,0;28,0;54,0;96,0;60,0;197,0;86,0;47,0;4,0;26,0;12,0;8,0;8,0;20,0;37,0;25,0;22,0;35,0;17,0;8,0;46,0;50,0;34,0;65,0;30,0;15,0;8,0;157,0;178,0;178,0;3,0;44,0;32,0;2,0;54,0;15,0;2,0;17,0;19,0;40,0;11,0;186,0;24,0;17,0;239,0;29,0;5,0;503,0;18,0;7,0;18,0;21,0;167,0;14,0;43,0;39,0;37,0;45,0;44,0;7,0;12,0;74,0;249,0;51,0;3,0;172,0;28,0;117,0;92,0;21,0;562,0;303,0;22,0;62,0;22,0;17,0;20,0;28,0;64,0;84,0;89,0;12,0;12,0;6,0;43,0;2,0;22,0;7,0;16,0;135,0;115,0;51,0;21,0;38,0;4,0;6,0;1,0;7,0;47,0;48,0;13,0;20,0;37,0;5,0;26,0;4,0;13,0;40,0;20,0;12,0;78,0;35,0;5,0;21,0;57,0;22,0;1,0;21,0;22,0;15,0;12,0;6,0;35,0;20,0;25,0;21,0;62,0;32,0;23,0;52,0;137,0;4,0;15,0;3,0;3,0;119,0;482,0;11,0;26,0;6,0;;66,0;119,0;20,0;6,0;18,0;15,0;23,0;19,0;34,0;4,0;5,0;11,0;22,0;25,0;15,0;17,0;37,0;115,0;39,0;24,0;92,0;8,0;12,0;18,0;58,0;84,0;19,0;16,0;10,0;36,0;32,0;6,0;1,0;15,0;6,0;5,0;2,0;166,0;5,0;14,0;9,0;22,0;16,0;4,0;2,0;3,0;10,0;4,0;;6,0;6,0;83,0;8,0;2,0;17,0;11,0;5,0;13,0;40,0;10,0;4,0;1,0;2,0;53,0;2,0;2,0;18,0;10,0;88,0;30,0;11,0;76,0;16,0;4,0;1,0;8,0;31,0;3,0;41,0;1,0;83,0;41,0;20,0;42,0;5,0;88,0;52,0;14,0;1,0;11,0;8,0;4,0;1,0;35,0;15,0;96,0;3,0;23,0;3,0;17,0;60,0;28,0;1,0;8,0;15,0;4,0;1,0;19,0;2,0;37,0;24,0;37,0;51,0;2,0;14,0;10,0;4,0;70,0;57,0;206,0;8,0;1,0;49,0;28,0;4,0;1,0;9,0;23,0;5,0;68,0;2,0;7,0;55,0;41,0;33,0;51,0;16,0;13,0;29,0;20,0;17,0;6,0;16,0;20,0;143,0;9,0;16,0;33,0;94,0;17,0;21,0;4,0;19,0;7,0;36,0;17,0;26,0;7,0;27,0;10,0;24,0;18,0;17,0;8,0;10,0;67,0;32,0;87,0;17,0;2,0;21,0;2,0;19,0;106,0;4,0;54,0;20,0;7,0;103,0;26,0;49,0;28,0;66,0;25,0;4,0;8,0;42,0;27,0;43,0;20,0;52,0;34,0;25,0;29,0;37,0;46,0;34,0;178,0;90,0;30,0;2,0;7,0;14,0;22,0;31,0;45,0;10,0;2,0;14,0;23,0;59,0;47,0;35,0;10,0;42,0;13,0;27,0;6,0;43,0;18,0;34,0;39,0;13,0;5,0;2,0;19,0;13,0;19,0;29,0;36,0;11,0;16,0;19,0;8,0;25,0;24,0;25,0;1,0;7,0;36,0;25,0;13,0;29,0;71,0;9,0;9,0;9,0;6,0;84,0;1,0;5,0;24,0;21,0;4,0;2,0;14,0;12,0;43,0;5,0;18,0;2,0;6,0;4,0;57,0;16,0;9,0;18,0;84,0;4,0;8,0;;20,0;7,0;29,0;12,0;7,0;8,0;11,0;13,0;13,0;16,0;;15,0;18,0;2,0;3,0;17,0;56,0;21,0;33,0;28,0;66,0;9,0;19,0;14,0;8,0;3,0;13,0;9,0;8,0;5,0;10,0;6,0;34,0;1,0;226,0;2,0;18,0;;5,0;10,0;34,0;8,0;11,0;9,0;7,0;1,0;6,0;;3,0;3,0;1,0;3,0;36,0;14,0;1,0;3,0;37,0;2,0;27,0;9,0;44,0;3,0;17,0;9,0;123,0;6,0;;5,0;1,0;8,0;;17,0;11,0;35,0;35,0;21,0;8,0;32,0;43,0;19,0;1,0;3,0;1,0;1,0;16,0;44,0;11,0;29,0;11,0;10,0;29,0;40,0;15,0;3,0;12,0;33,0;4,0;15,0;24,0;13,0;38,0;1,0;;15,0;2,0;3,0;43,0;88,0;12,0;7,0;32,0;14,0;3,0;15,0;10,0;5,0;6,0;10,0;5,0;16,0;13,0;;;6,0;5,0;14,0;4,0;13,0;10,0;;9,0;13,0;10,0;12,0;8,0;21,0;11,0;6,0;2,0;10,0;15,0;10,0;29,0;1,0;11,0;19,0;1,0;18,0;9,0;;5,0;4,0;;16,0;16,0;1,0;8,0;;13,0;5,0;6,0;;3,0;
minimum;2,0;;6,0;;14,0;;2,0;13,0;11,0;2,0;;;;;1,0;;;;;;1,0;4,0;4,0;6,0;;;2,0;21,0;1,0;10,0;3,0;24,0;6,0;14,0;5,0;1,0;;1,0;;18,0;34,0;1,0;1,0;2,0;15,0;1,0;;63,0;12,0;;6,0;2,0;5,0;6,0;;73,0;9,0;;77,0;43,0;;22,0;21,0;;;1,0;2,0;;;18,0;15,0;;;;;;;20,0;20,0;12,0;;9,0;2,0;1,0;;;;;6,0;9,0;1,0;4,0;;18,0;83,0;2,0;;2,0;1,0;;;17,0;;;2,0;;;22,0;;;;2,0;1,0;1,0;;;;;1,0;2,0;;;1,0;1,0;;;2,0;;8,0;3,0;;2,0;2,0;;;;;;;;;;;9,0;8,0;;3,0;3,0;;;2,0;;;;;;;;28,0;5,0;;;;1,0;1,0;1,0;24,0;4,0;;1,0;;;3,0;;3,0;;;11,0;;;2,0;;;1,0;;;11,0;9,0;;;;;;1,0;;;;;4,0;;;;;12,0;;;;;;;1,0;;;;;20,0;;;;;;1,0;;;;;;;;;;;;;7,0;15,0;;;4,0;;;;8,0;;;1,0;;3,0;;;2,0;;;2,0;;;;;;;;9,0;;;;;;;;;1,0;;;;;2,0;;;14,0;;;;2,0;2,0;;11,0;2,0;6,0;3,0;;;;3,0;;;;;2,0;;;;;16,0;;;;;15,0;;;4,0;;;;;;;4,0;;;;1,0;;;;;;;;6,0;1,0;;;;;;;;6,0;;;;;;;;4,0;8,0;;16,0;1,0;2,0;3,0;;;;;;;;1,0;;;;5,0;;;;;;;;;;1,0;;;;;2,0;;2,0;;;1,0;2,0;;13,0;;;;;1,0;;;9,0;9,0;4,0;6,0;3,0;;;;2,0;5,0;;3,0;51,0;;;;3,0;;1,0;;;12,0;;;;;;2,0;2,0;12,0;;;;;10,0;;;;;3,0;;1,0;;;15,0;;;;;;6,0;;;1,0;;2,0;;2,0;5,0;;1,0;;;1,0;;;;;98,0;;;;;4,0;;;6,0;;;;;;;;;;;;;;;1,0;;;6,0;;2,0;17,0;;13,0;2,0;;10,0;;1,0;1,0;;1,0;;38,0;;;;;;;;;;;;;;;2,0;;;;;;4,0;2,0;;;;;;;;;16,0;;;;;;6,0;;;;;8,0;;;;;1,0;;;;;4,0;;;;26,0;;;;;;1,0;1,0;;;;;;;;;;;;;3,0;;5,0;;;;;;;3,0;;;;;;;;;3,0;;;;;;;;;1,0;;1,0;;;;;;;;1,0;;;;;2,0;;;;;;;;;;12,0;;;;1,0;;;;;1,0;;;;;;2,0;4,0;;;;;;;;;;1,0;;;;;;;;;;;;;3,0;;;3,0;;;6,0;;11,0;;;;2,0;2,0;;;;;;;;6,0;4,0;24,0;;;;;;22,0;2,0;;;1,0;;;;;;;3,0;;;;;;;;;2,0;;;;;12,0;;;;3,0;;2,0;3,0;;9,0;3,0;1,0;;;;2,0;;;5,0;;;1,0;13,0;4,0;;;;;2,0;;;5,0;1,0;;;;;;;1,0;;;;;;;;;;;;9,0;5,0;;;;;;;;;1,0;;;;;;;;;9,0;;;;;;;;;;;;;18,0;;;;;;;;;;16,0;;;1,0;;;;;;;1,0;;;;1,0;;;;;;;;;;1,0;;;;;;;;;;;;;;;;;;;1,0;;;;;;;;;;;;;;;;;;1,0;;;;;;;;;;;;;;;;;;;;9,0;;;;;;;;;;;;;;;;3,0;;;;;;;;;;;;;;;;;;;2,0;;;;;;;;;;;;;;;;;1,0;;;;;;;;;;;;;;;;2,0;;;;;;;;;;1,0;;;;;;3,0;;;;;;;;;;4,0;;;;;;
model;32,0;;2,0;;15,0;;2,0;38,0;2,0;10,0;12,0;10,0;;5,0;23,0;3,0;1,0;;19,0;64,0;1,0;9,0;29,0;10,0;9,0;1,0;8,0;63,0;6,0;13,0;11,0;53,0;33,0;16,0;15,0;18,0;;;;5,0;11,0;1,0;;;8,0;4,0;13,0;2,0;;1,0;10,0;61,0;;13,0;6,0;191,0;45,0;;1,0;10,0;5,0;42,0;106,0;;;;2,0;;1,0;3,0;2,0;;1,0;;;;;85,0;24,0;;;6,0;10,0;1,0;;;15,0;3,0;11,0;20,0;9,0;6,0;;;7,0;7,0;;;12,0;;33,0;38,0;;;1,0;;;26,0;;;4,0;;1,0;2,0;3,0;;;;;5,0;;;;;;;6,0;;;4,0;1,0;15,0;;;3,0;3,0;;1,0;;;;13,0;;;11,0;;23,0;11,0;3,0;;;;;;;;;1,0;7,0;10,0;;1,0;;;;;1,0;;;2,0;;;1,0;6,0;10,0;;;4,0;;;;;;;;3,0;;21,0;;17,0;;;1,0;10,0;1,0;;;;7,0;;;21,0;;;;2,0;;;6,0;;1,0;;3,0;;10,0;8,0;1,0;;;;1,0;2,0;;;;;;;;;;;1,0;;3,0;2,0;;16,0;15,0;;;;2,0;;;1,0;;;;;;;;2,0;;22,0;;7,0;3,0;;;;13,0;;;;6,0;;;;;;;;;;;1,0;;3,0;;;;;;36,0;;76,0;;;;;;3,0;;;;;;;;;4,0;2,0;5,0;;;3,0;1,0;;21,0;2,0;;;;;;;;;;;;;2,0;15,0;;;1,0;3,0;11,0;;3,0;3,0;;11,0;;6,0;1,0;;;32,0;1,0;6,0;5,0;1,0;1,0;3,0;;5,0;1,0;;6,0;;;;15,0;4,0;;;15,0;;;23,0;17,0;;;;3,0;2,0;;2,0;;1,0;4,0;4,0;1,0;4,0;;;1,0;;1,0;4,0;;;;;4,0;;;9,0;;3,0;1,0;;1,0;16,0;8,0;1,0;15,0;;9,0;;4,0;;38,0;1,0;;;13,0;;;;;;24,0;;8,0;;5,0;3,0;;2,0;8,0;;;;16,0;16,0;6,0;12,0;;;;;;;;;;21,0;;;1,0;1,0;1,0;3,0;;;;2,0;11,0;1,0;;1,0;;;2,0;;;;;;;3,0;;;33,0;;;18,0;;;;;1,0;;;;;9,0;1,0;;;;2,0;1,0;;5,0;;1,0;1,0;;11,0;24,0;;;8,0;;;;6,0;;9,0;;;;;;;;;;;;;;5,0;;;4,0;14,0;;;;;;;;;4,0;;1,0;;;1,0;2,0;;;;;;;;;1,0;;;;17,0;;;6,0;;;4,0;;;;20,0;;;;;1,0;4,0;;;;;4,0;;;;;;1,0;;;;;7,0;;;;;;;13,0;;;;;;;1,0;;16,0;;;;2,0;;;;1,0;;;;;;;;;;;;;1,0;;;;;;;;;8,0;;;1,0;;8,0;1,0;;4,0;;;;;2,0;;;;;;4,0;1,0;;5,0;;;;;;;;;3,0;25,0;;;;;2,0;;1,0;;3,0;;;;;4,0;;;3,0;;2,0;;;2,0;2,0;16,0;;;;;;;1,0;1,0;1,0;5,0;;;4,0;;;;;;4,0;2,0;;;;;5,0;;;;1,0;;;;;;;1,0;1,0;;;;;6,0;;;;1,0;;6,0;;;;;1,0;;;6,0;;;8,0;11,0;;11,0;3,0;;;;4,0;;21,0;6,0;18,0;5,0;;5,0;;;;17,0;2,0;;;;;;;2,0;1,0;;;6,0;;10,0;;;1,0;;5,0;;2,0;7,0;;;;;;;;;;;;;;3,0;19,0;;;;1,0;10,0;;;6,0;2,0;;;1,0;1,0;;;;;;;;;;;;;;4,0;;;;;;1,0;;;;;;;;;9,0;;;;2,0;;;;;;;;;9,0;;6,0;2,0;;;;3,0;;;;;4,0;;;;8,0;;;;1,0;;9,0;;2,0;;;;;;;;;;4,0;;;;2,0;;4,0;;;;;;;;;;;;;28,0;1,0;;;;;1,0;5,0;;;;;;;12,0;;;;;3,0;;;;;2,0;;3,0;;;;1,0;;;;;;;;2,0;;;;;;;;;;;;;;1,0;4,0;;6,0;1,0;;;;;2,0;1,0;2,0;;;;1,0;;;5,0;13,0;;4,0;;;;;;;;;;;;;;;;3,0;;;
motor;4,0;;14,0;1,0;112,0;;63,0;55,0;32,0;6,0;17,0;6,0;2,0;3,0;4,0;3,0;1,0;4,0;10,0;;2,0;272,0;27,0;5,0;40,0;;;15,0;3,0;14,0;8,0;48,0;86,0;4,0;27,0;;12,0;76,0;2,0;34,0;5,0;;376,0;57,0;;;;1,0;74,0;30,0;5,0;11,0;;15,0;1,0;59,0;107,0;;1,0;299,0;16,0;;85,0;1,0;;;23,0;9,0;;42,0;40,0;2,0;4,0;;;4,0;20,0;17,0;124,0;78,0;15,0;4,0;4,0;6,0;;;2,0;;8,0;4,0;46,0;6,0;;126,0;5,0;3,0;;6,0;6,0;5,0;17,0;139,0;;44,0;;4,0;55,0;105,0;14,0;;6,0;46,0;;36,0;33,0;12,0;3,0;;8,0;57,0;;2,0;4,0;51,0;1,0;;72,0;32,0;;103,0;12,0;;;3,0;5,0;7,0;28,0;;;;;8,0;10,0;1,0;5,0;44,0;30,0;10,0;;;;2,0;6,0;2,0;15,0;8,0;3,0;40,0;1,0;15,0;4,0;11,0;7,0;18,0;;1,0;2,0;45,0;12,0;1,0;66,0;36,0;40,0;149,0;30,0;4,0;5,0;80,0;;6,0;9,0;4,0;1,0;;5,0;2,0;46,0;30,0;;38,0;2,0;2,0;5,0;37,0;;4,0;;;143,0;1,0;;2,0;;31,0;12,0;;6,0;14,0;9,0;54,0;1,0;3,0;;;212,0;37,0;35,0;3,0;3,0;;4,0;205,0;17,0;2,0;3,0;;1,0;7,0;2,0;1,0;;1,0;34,0;2,0;10,0;67,0;3,0;59,0;3,0;6,0;26,0;5,0;4,0;4,0;10,0;6,0;1,0;2,0;1,0;45,0;;;;48,0;;1,0;4,0;11,0;;;;403,0;;4,0;58,0;1,0;20,0;3,0;;2,0;2,0;2,0;11,0;1,0;2,0;;;;4,0;13,0;;14,0;12,0;98,0;;13,0;77,0;6,0;13,0;5,0;3,0;2,0;2,0;;2,0;1,0;;9,0;3,0;3,0;;2,0;19,0;3,0;4,0;;3,0;6,0;4,0;;4,0;7,0;1,0;;56,0;;16,0;14,0;18,0;;3,0;;97,0;4,0;;11,0;;4,0;12,0;2,0;;10,0;15,0;4,0;3,0;;;;;;2,0;7,0;;4,0;;;9,0;2,0;;2,0;;9,0;;4,0;;8,0;;;3,0;1,0;;;;;5,0;;1,0;1,0;8,0;;;2,0;4,0;4,0;;1,0;1,0;1,0;;12,0;1,0;9,0;;2,0;19,0;;;5,0;;12,0;4,0;22,0;32,0;13,0;24,0;72,0;15,0;3,0;4,0;4,0;1,0;;2,0;;;;1,0;52,0;1,0;21,0;1,0;9,0;1,0;;;2,0;2,0;;6,0;;5,0;;;3,0;17,0;2,0;;;1,0;;2,0;;;;;;1,0;;;5,0;1,0;;;3,0;;36,0;1,0;1,0;;34,0;1,0;2,0;2,0;2,0;;;;;2,0;;;;2,0;1,0;7,0;6,0;13,0;;;;2,0;18,0;27,0;;2,0;1,0;6,0;;;;2,0;;;;;136,0;4,0;;;3,0;1,0;8,0;3,0;11,0;1,0;10,0;;52,0;;;1,0;;;1,0;16,0;;;;;;3,0;;;;3,0;6,0;4,0;;;;;;;;;;4,0;;;;2,0;;5,0;;;;;1,0;;;;;2,0;10,0;6,0;;39,0;4,0;;;;;;;;1,0;9,0;;;3,0;;5,0;;;;;3,0;;;;10,0;2,0;;;;;8,0;;;;;;14,0;;8,0;20,0;2,0;;;;;;2,0;;2,0;10,0;1,0;;;2,0;4,0;;;;;;9,0;4,0;16,0;1,0;;;4,0;3,0;;;2,0;;;5,0;;;;10,0;1,0;;;;8,0;;;3,0;5,0;1,0;;1,0;2,0;4,0;52,0;4,0;;;;;;;;1,0;;;1,0;20,0;7,0;;1,0;3,0;1,0;;5,0;1,0;2,0;;;;;;1,0;;;;;;;2,0;2,0;;;6,0;;;3,0;1,0;;;2,0;4,0;;3,0;1,0;;;106,0;1,0;;6,0;;;2,0;2,0;1,0;8,0;1,0;;2,0;;;;;;5,0;;;;7,0;;;;14,0;;12,0;;;;;;7,0;;;;3,0;3,0;;3,0;1,0;3,0;;;2,0;3,0;1,0;3,0;13,0;;16,0;;1,0;5,0;;;;;;;1,0;;;;;;18,0;1,0;;;5,0;2,0;1,0;;2,0;;;3,0;;10,0;;;15,0;;6,0;7,0;2,0;;2,0;;;;2,0;;;3,0;;;;;;;;1,0;11,0;;;;;;;;;5,0;;;;;;;;6,0;17,0;;;3,0;;8,0;;;3,0;;;;;;;1,0;3,0;;4,0;;;;;;21,0;;;;2,0;20,0;;;4,0;;153,0;;;;;;;4,0;23,0;3,0;;;;;17,0;4,0;1,0;;3,0;12,0;;;3,0;;;1,0;;;;2,0;2,0;;;;9,0;11,0;;2,0;;;;;;;;;;;;;25,0;;1,0;9,0;;;;;;;;;;;;2,0;;;;;;;;1,0;;1,0;;1,0;;;;;;;;;2,0;1,0;;;1,0;;;1,0;;;;;2,0;;;;1,0;36,0;;1,0;2,0;;;;1,0;;;;;;;;;;;;;14,0;1,0;3,0;2,0;;;;;;;;1,0;;;1,0;;;;;;;;;;;;;
moving;1,0;1,0;50,0;1,0;78,0;;149,0;178,0;30,0;126,0;47,0;14,0;;1,0;5,0;;11,0;1,0;26,0;15,0;8,0;207,0;25,0;69,0;95,0;;6,0;194,0;5,0;192,0;261,0;84,0;278,0;19,0;60,0;8,0;1,0;486,0;17,0;295,0;74,0;1,0;69,0;102,0;12,0;1,0;;20,0;85,0;14,0;26,0;59,0;6,0;95,0;;1545,0;164,0;;4,0;636,0;4,0;12,0;202,0;2,0;2,0;23,0;;3,0;14,0;58,0;238,0;8,0;55,0;1,0;3,0;13,0;2,0;53,0;338,0;64,0;33,0;80,0;24,0;6,0;;2,0;119,0;5,0;21,0;35,0;52,0;16,0;95,0;126,0;12,0;24,0;2,0;14,0;24,0;14,0;37,0;146,0;1,0;7,0;5,0;5,0;3,0;454,0;;;7,0;9,0;7,0;27,0;8,0;3,0;10,0;;3,0;49,0;;26,0;25,0;3,0;;;82,0;15,0;1,0;17,0;32,0;6,0;6,0;9,0;1,0;15,0;17,0;;10,0;3,0;;10,0;;4,0;22,0;20,0;28,0;360,0;1,0;;;22,0;86,0;1,0;43,0;12,0;;25,0;9,0;82,0;;6,0;3,0;4,0;;6,0;6,0;19,0;1,0;9,0;437,0;20,0;39,0;44,0;84,0;31,0;1,0;27,0;9,0;;6,0;8,0;2,0;6,0;9,0;38,0;48,0;102,0;;136,0;;2,0;;48,0;2,0;1,0;;4,0;35,0;18,0;1,0;13,0;5,0;29,0;2,0;9,0;39,0;43,0;9,0;100,0;;5,0;9,0;7,0;29,0;81,0;7,0;;4,0;1,0;6,0;73,0;19,0;13,0;10,0;;;;;4,0;;2,0;80,0;6,0;38,0;12,0;2,0;19,0;167,0;4,0;38,0;;7,0;1,0;3,0;1,0;1,0;;3,0;45,0;;9,0;;27,0;9,0;1,0;2,0;21,0;6,0;;7,0;71,0;8,0;15,0;14,0;14,0;3,0;3,0;;1,0;1,0;23,0;10,0;3,0;10,0;4,0;17,0;2,0;8,0;16,0;3,0;9,0;8,0;85,0;7,0;99,0;141,0;987,0;5,0;9,0;;8,0;7,0;14,0;1,0;21,0;;78,0;3,0;;4,0;2,0;57,0;1,0;15,0;2,0;9,0;56,0;2,0;8,0;33,0;5,0;9,0;4,0;8,0;;;1,0;10,0;;8,0;12,0;33,0;28,0;;6,0;;4,0;5,0;1,0;24,0;7,0;;7,0;;;11,0;4,0;2,0;2,0;;3,0;1,0;8,0;35,0;6,0;14,0;62,0;7,0;40,0;48,0;34,0;27,0;;;1,0;2,0;;;5,0;19,0;1,0;4,0;2,0;26,0;40,0;;5,0;3,0;34,0;10,0;;1,0;10,0;21,0;25,0;3,0;;;27,0;25,0;39,0;4,0;10,0;2,0;1,0;3,0;5,0;5,0;206,0;5,0;22,0;21,0;3,0;35,0;85,0;16,0;34,0;5,0;;66,0;1,0;6,0;;39,0;8,0;30,0;92,0;55,0;3,0;2,0;4,0;2,0;3,0;;50,0;8,0;1,0;62,0;1,0;36,0;1,0;1,0;36,0;155,0;1,0;2,0;3,0;10,0;24,0;17,0;5,0;;;1,0;1,0;;1,0;;2,0;8,0;;3,0;;;26,0;10,0;21,0;1,0;13,0;1,0;8,0;42,0;7,0;;5,0;;11,0;39,0;;7,0;;5,0;12,0;3,0;34,0;67,0;2,0;6,0;;;76,0;13,0;37,0;;7,0;42,0;7,0;;3,0;;1,0;1,0;3,0;;21,0;24,0;2,0;1,0;12,0;34,0;7,0;1,0;1,0;36,0;67,0;3,0;4,0;;2,0;1,0;;2,0;2,0;37,0;2,0;;47,0;;3,0;5,0;;;26,0;2,0;3,0;;6,0;;3,0;;3,0;6,0;6,0;4,0;;14,0;;;;8,0;6,0;;3,0;30,0;;15,0;3,0;;;;2,0;2,0;4,0;;1,0;2,0;;;1,0;7,0;;;2,0;12,0;;35,0;;2,0;186,0;36,0;;;1,0;1,0;2,0;87,0;4,0;3,0;5,0;12,0;3,0;;;2,0;;6,0;;;2,0;;3,0;72,0;4,0;2,0;4,0;5,0;10,0;;2,0;2,0;;;3,0;1,0;1,0;4,0;1,0;1,0;3,0;;;16,0;;;;;4,0;3,0;;;;3,0;;;;1,0;5,0;4,0;10,0;;;;4,0;7,0;;;;6,0;;;5,0;13,0;7,0;11,0;;14,0;14,0;4,0;;1,0;10,0;6,0;;1,0;;;1,0;8,0;1,0;20,0;2,0;1,0;;;1,0;10,0;2,0;15,0;;4,0;1,0;;;;1,0;20,0;;;12,0;4,0;3,0;;2,0;7,0;;;2,0;;;;;17,0;2,0;2,0;;;6,0;;;;10,0;3,0;;4,0;;;3,0;45,0;;2,0;;2,0;6,0;1,0;1,0;;14,0;6,0;20,0;1,0;11,0;2,0;8,0;2,0;2,0;;11,0;;;6,0;4,0;;6,0;;;34,0;;1,0;1,0;21,0;2,0;9,0;8,0;3,0;;6,0;;;;;;2,0;;4,0;10,0;3,0;;6,0;;;2,0;1,0;2,0;;6,0;3,0;5,0;;1,0;3,0;2,0;5,0;1,0;;;;1,0;;;12,0;;16,0;8,0;2,0;19,0;2,0;11,0;3,0;1,0;;;;20,0;5,0;;15,0;18,0;1,0;;;13,0;1,0;88,0;;19,0;1,0;;1,0;1,0;1,0;2,0;;;1,0;3,0;1,0;3,0;1,0;;;;2,0;38,0;;;;15,0;8,0;3,0;3,0;1,0;1,0;;6,0;3,0;;1,0;1,0;1,0;3,0;12,0;2,0;11,0;;;4,0;;;5,0;;;6,0;1,0;7,0;2,0;;;2,0;7,0;;6,0;2,0;2,0;;;24,0;;8,0;;6,0;7,0;10,0;3,0;4,0;;17,0;;39,0;3,0;;;9,0;;6,0;;10,0;;;7,0;2,0;;;7,0;2,0;;;;1,0;7,0;;;1,0;;;;8,0;;2,0;4,0;37,0;;;;;11,0;1,0;3,0;1,0;;2,0;5,0;;12,0;3,0;;;;15,0;2,0;;;;;;10,0;2,0;;1,0;;108,0;12,0;;;;1,0;;4,0;;1,0;;;2,0;;;;;26,0;;5,0;4,0;3,0;;3,0;;;;;2,0;;1,0;1,0;;;4,0;;1,0;;;1,0;;2,0;;4,0;;;10,0;;;;;;1,0;;2,0;;1,0;;;;8,0;;;;4,0;2,0;;;;
objective;1,0;;1,0;;5,0;;6,0;17,0;7,0;4,0;3,0;1,0;;;;2,0;;;9,0;;;13,0;;;;;9,0;;;3,0;;2,0;9,0;2,0;2,0;;11,0;2,0;;1,0;18,0;;1,0;5,0;3,0;;;20,0;5,0;;2,0;;;5,0;;45,0;19,0;;7,0;306,0;1,0;1,0;21,0;;;9,0;3,0;;;2,0;53,0;3,0;3,0;;;;;4,0;26,0;;;;;3,0;;;3,0;2,0;;;10,0;;;3,0;;;;;;7,0;7,0;29,0;;;;;;3,0;;;7,0;13,0;23,0;;2,0;;;;1,0;7,0;;;;;1,0;2,0;7,0;;;2,0;3,0;;;1,0;;3,0;14,0;;;;;;1,0;;;;19,0;1,0;;3,0;;1,0;;1,0;2,0;26,0;2,0;17,0;3,0;4,0;4,0;;;4,0;;;;37,0;;1,0;6,0;12,0;21,0;30,0;3,0;8,0;;;;;;;10,0;;;9,0;5,0;10,0;;8,0;;;;10,0;;10,0;;;;1,0;;3,0;;2,0;1,0;;;;1,0;4,0;;2,0;;;;;;2,0;;14,0;3,0;4,0;;2,0;3,0;;;;11,0;6,0;2,0;;6,0;1,0;9,0;;1,0;3,0;3,0;;6,0;;12,0;1,0;;;;2,0;;;;;;5,0;;1,0;;9,0;;;;3,0;1,0;;6,0;;3,0;;3,0;;;11,0;;;1,0;;;;;14,0;;;;6,0;;;13,0;18,0;4,0;;;2,0;;;;;;7,0;;;;;;4,0;3,0;;;15,0;;2,0;;;;;3,0;;;;2,0;1,0;;;;;;;;;2,0;;2,0;4,0;;;;;2,0;;;;;3,0;;1,0;;;2,0;2,0;11,0;;4,0;;;;;;;;;;;;;;;2,0;;;3,0;1,0;;;;2,0;;;2,0;;;1,0;;9,0;;;;;;;;;;2,0;;;;;6,0;;;;;;;;;7,0;;;;;3,0;1,0;;;;;;;;;4,0;;;;;1,0;;;1,0;3,0;;;;;2,0;;;;;;;;;;;;;1,0;;;;;10,0;;;;;;;;;;;;;;5,0;;;;;3,0;;;;;2,0;;;;;;;;;8,0;;;;1,0;;5,0;;1,0;3,0;9,0;1,0;;;;;;;3,0;6,0;7,0;;;;2,0;;;;;;2,0;;;;;2,0;4,0;;;;;1,0;1,0;;;;;3,0;;;;;;;;;4,0;;;3,0;;;3,0;;;;;;;;;;;;;;;;;3,0;;1,0;;;;;;;;;;;;;;;;3,0;;;;3,0;;;;;3,0;;;;;;;;;;;;9,0;;;;;;;4,0;1,0;;;;;;;;;;;;6,0;;;3,0;;;;;;1,0;1,0;;;2,0;;;;;;;;;;;;4,0;;;;;;;;;;1,0;;;;;;;;;4,0;;;;;;;;;;;;;;;;;;;;;;;;;;;;;;;;;;;;5,0;;;;;;8,0;;;;;;;;;;;;;;;5,0;6,0;;;;;1,0;;;;;;;;;;;4,0;;;;;;2,0;;;;;;;;;;;;;;;;;;;;;;;;1,0;;4,0;2,0;;2,0;3,0;;;;;;;;;;;;;;;;;2,0;;;1,0;;;;;;;;;;;;;;;;;;;2,0;;;;;;;;;1,0;;;1,0;;;;2,0;;;;1,0;;;;;;2,0;;;;;;;;;;;;;;;;;;;;;;1,0;;;;;;;;1,0;;;;1,0;;;;;;;;;;;1,0;;;;;;;;;;;;6,0;;;;;;;;;;;;9,0;;2,0;;2,0;7,0;;;6,0;;;;;;;;;;;;;;;3,0;;;2,0;;;;;;;;;;;;;;1,0;;;;1,0;;;;;;;;;;;;;;;;;;;;;;;;;;;;;;;;;;;;;;;;;;;;
occur;1,0;;5,0;;3,0;;2,0;13,0;2,0;23,0;2,0;1,0;;;2,0;;3,0;;;3,0;1,0;8,0;;9,0;6,0;;;15,0;4,0;24,0;3,0;50,0;12,0;2,0;11,0;;;6,0;1,0;1,0;4,0;2,0;;5,0;9,0;;;;;1,0;1,0;22,0;3,0;;;111,0;10,0;;2,0;6,0;1,0;1,0;34,0;;1,0;;14,0;;;10,0;6,0;;2,0;;;;;6,0;16,0;1,0;2,0;;4,0;;;;12,0;;2,0;1,0;4,0;8,0;;13,0;;2,0;;;5,0;;4,0;14,0;;3,0;;25,0;2,0;20,0;2,0;2,0;;;1,0;;;;;;1,0;5,0;;;12,0;9,0;;;1,0;;;4,0;;;;3,0;;;3,0;;;2,0;;8,0;7,0;2,0;;4,0;2,0;12,0;;;;;5,0;;;2,0;;1,0;;6,0;;1,0;;;;;2,0;6,0;5,0;;2,0;2,0;4,0;1,0;18,0;2,0;;3,0;;;;;;15,0;;3,0;;7,0;;3,0;;;1,0;5,0;;3,0;;;2,0;;;1,0;;;;11,0;1,0;1,0;;;;;;;;45,0;6,0;;;;;3,0;8,0;;;;;;;;;;;;2,0;4,0;;4,0;10,0;;;;1,0;;;3,0;;;;;;3,0;;1,0;;1,0;;4,0;;;;;;;;;;;;;;;;;;;2,0;;1,0;;;;;2,0;;11,0;1,0;5,0;6,0;;;;;1,0;;;;17,0;;;;;11,0;1,0;;;;4,0;;;;3,0;;;;;;;;1,0;;2,0;;;;5,0;;;;;1,0;;;;;;1,0;1,0;;11,0;;4,0;1,0;1,0;10,0;;;;;74,0;;2,0;1,0;;;1,0;;;;;3,0;;;;8,0;5,0;1,0;;;;18,0;;1,0;6,0;3,0;1,0;;7,0;;4,0;18,0;1,0;1,0;1,0;1,0;;1,0;;;5,0;;8,0;;;5,0;;4,0;8,0;3,0;;2,0;2,0;;2,0;1,0;10,0;;1,0;;;;;;1,0;;61,0;2,0;1,0;6,0;;19,0;;;;6,0;;;;7,0;13,0;5,0;;;;;;;;;4,0;3,0;;;;;4,0;3,0;1,0;;;3,0;3,0;11,0;10,0;;1,0;;;2,0;;1,0;;3,0;2,0;;9,0;;6,0;3,0;;;6,0;6,0;;;4,0;;;;1,0;;;3,0;2,0;;1,0;;8,0;1,0;3,0;2,0;3,0;;1,0;18,0;12,0;;5,0;2,0;;;;2,0;;;;;;4,0;;;;;1,0;3,0;4,0;;1,0;;5,0;;2,0;;;2,0;2,0;;;;;1,0;;;;;;;;;;;6,0;;;;;;;;;;;;;2,0;;1,0;3,0;;17,0;28,0;7,0;2,0;;2,0;;;;;;;1,0;;;;;;;;1,0;;6,0;15,0;2,0;;1,0;3,0;;;;3,0;;;;;;;;;;;;10,0;;;;;;;;;;;;2,0;;3,0;;;;;;1,0;;;;;;;;;;;2,0;;;5,0;2,0;;;;;;;;2,0;;;;;;1,0;;;;;;;7,0;;;;;;;1,0;7,0;;1,0;;2,0;;;;;;;;;10,0;;;;2,0;3,0;;;;;;;;;;;;;;1,0;1,0;;;;1,0;3,0;;;;;4,0;2,0;;;;;;;2,0;;1,0;;;;;;;2,0;;;;;9,0;2,0;;;;;;;;;;;3,0;2,0;;;1,0;2,0;;;7,0;;;;;;;;;1,0;;;;;1,0;;;;10,0;3,0;;;;;2,0;;;;1,0;1,0;;;;3,0;;;;;;3,0;;5,0;1,0;;;1,0;;;;;;;;;;;;2,0;;;3,0;1,0;1,0;;;;;;;;3,0;;;6,0;;;;3,0;;;;4,0;;;;;;;1,0;;;;;;;6,0;;;;;;;;;;;;2,0;;2,0;;2,0;;;;;;;;1,0;;;;;;;;4,0;;;;1,0;;;;;;2,0;;;;;;5,0;;2,0;;;;;;;;;;;;;;2,0;;;4,0;;;;;;;;;;;3,0;3,0;;;;;1,0;;;1,0;2,0;;;;;;;;2,0;;;;;;;;;;;;;;;;;;;;;;;;;4,0;;;;;;;;;2,0;;2,0;;;;;;;;;;;;;;;;1,0;;;;;
operation;3,0;17,0;34,0;6,0;152,0;;26,0;203,0;27,0;113,0;3,0;6,0;;;24,0;10,0;1,0;26,0;11,0;32,0;86,0;748,0;10,0;50,0;105,0;;;207,0;3,0;119,0;99,0;180,0;429,0;19,0;171,0;7,0;18,0;116,0;;287,0;23,0;1,0;131,0;43,0;6,0;3,0;2,0;29,0;168,0;14,0;75,0;85,0;10,0;42,0;1,0;815,0;163,0;10,0;21,0;290,0;4,0;20,0;192,0;18,0;3,0;42,0;58,0;2,0;10,0;;66,0;12,0;11,0;4,0;1,0;24,0;;46,0;194,0;74,0;15,0;124,0;124,0;6,0;9,0;1,0;21,0;10,0;15,0;196,0;67,0;29,0;110,0;384,0;6,0;34,0;15,0;77,0;94,0;2,0;51,0;158,0;7,0;51,0;9,0;5,0;4,0;536,0;1,0;;15,0;28,0;6,0;24,0;14,0;18,0;12,0;;4,0;68,0;10,0;;57,0;132,0;;;138,0;12,0;12,0;6,0;14,0;16,0;1,0;;3,0;20,0;24,0;;2,0;5,0;2,0;3,0;71,0;22,0;30,0;21,0;7,0;78,0;5,0;;;2,0;8,0;1,0;16,0;9,0;3,0;30,0;27,0;199,0;1,0;7,0;4,0;4,0;;3,0;19,0;67,0;13,0;;301,0;24,0;62,0;10,0;25,0;59,0;2,0;153,0;1,0;4,0;13,0;;15,0;7,0;3,0;3,0;3,0;143,0;;147,0;3,0;;;137,0;1,0;3,0;;;102,0;3,0;;1,0;3,0;100,0;;27,0;10,0;;17,0;4,0;1,0;2,0;;;27,0;167,0;33,0;;;;11,0;12,0;18,0;;1,0;;7,0;;11,0;;2,0;2,0;1,0;2,0;52,0;10,0;;34,0;56,0;55,0;24,0;3,0;17,0;4,0;1,0;34,0;3,0;5,0;;5,0;24,0;3,0;;46,0;1,0;3,0;;19,0;10,0;1,0;6,0;25,0;12,0;5,0;30,0;2,0;13,0;1,0;1,0;;2,0;2,0;;4,0;11,0;20,0;12,0;12,0;16,0;7,0;24,0;1,0;17,0;39,0;;26,0;26,0;41,0;136,0;1,0;;1,0;7,0;14,0;;1,0;19,0;263,0;;;23,0;;119,0;8,0;41,0;5,0;4,0;96,0;3,0;5,0;26,0;26,0;12,0;6,0;94,0;;2,0;2,0;3,0;1,0;2,0;20,0;11,0;6,0;;24,0;;;34,0;;176,0;8,0;;4,0;;;1,0;50,0;23,0;4,0;;26,0;5,0;30,0;56,0;5,0;5,0;148,0;;118,0;47,0;28,0;13,0;6,0;;6,0;2,0;2,0;2,0;9,0;6,0;2,0;8,0;;13,0;62,0;;1,0;5,0;4,0;13,0;4,0;5,0;6,0;39,0;37,0;8,0;7,0;;14,0;89,0;32,0;12,0;13,0;7,0;13,0;11,0;6,0;7,0;191,0;97,0;152,0;18,0;;199,0;58,0;123,0;9,0;16,0;;16,0;;3,0;;8,0;2,0;56,0;129,0;1,0;15,0;;20,0;;1,0;6,0;5,0;5,0;;103,0;;3,0;5,0;4,0;57,0;454,0;18,0;31,0;51,0;3,0;31,0;2,0;3,0;;2,0;41,0;1,0;6,0;5,0;7,0;24,0;125,0;2,0;4,0;18,0;3,0;149,0;37,0;16,0;13,0;15,0;4,0;106,0;34,0;52,0;8,0;5,0;1,0;56,0;73,0;;6,0;5,0;20,0;4,0;;21,0;13,0;29,0;25,0;;;576,0;;43,0;2,0;;44,0;5,0;5,0;6,0;11,0;;31,0;6,0;;47,0;25,0;10,0;2,0;113,0;4,0;424,0;5,0;24,0;93,0;55,0;8,0;33,0;11,0;4,0;8,0;5,0;4,0;6,0;57,0;7,0;;1,0;5,0;1,0;;4,0;4,0;8,0;63,0;8,0;3,0;3,0;1,0;7,0;;;3,0;8,0;11,0;27,0;42,0;;3,0;15,0;20,0;1,0;30,0;28,0;11,0;3,0;4,0;11,0;5,0;4,0;;;17,0;2,0;;6,0;3,0;10,0;13,0;2,0;;3,0;;5,0;10,0;;15,0;1,0;6,0;28,0;108,0;6,0;11,0;;;2,0;30,0;38,0;4,0;1,0;;5,0;13,0;12,0;;1,0;2,0;6,0;1,0;2,0;;5,0;28,0;24,0;5,0;67,0;1,0;;1,0;9,0;24,0;;;3,0;1,0;56,0;;;2,0;;7,0;1,0;129,0;4,0;5,0;1,0;16,0;1,0;1,0;3,0;;3,0;1,0;;;2,0;64,0;;;7,0;47,0;;19,0;;;;1,0;;5,0;1,0;;1,0;3,0;57,0;;;;36,0;1,0;;1,0;45,0;;;;39,0;;6,0;2,0;4,0;7,0;;2,0;3,0;;;1,0;2,0;5,0;;11,0;;12,0;;;16,0;31,0;;;;6,0;;9,0;1,0;4,0;3,0;;4,0;;;23,0;33,0;;8,0;7,0;8,0;;36,0;31,0;;39,0;62,0;9,0;1,0;3,0;1,0;3,0;20,0;5,0;7,0;24,0;;15,0;4,0;;;;2,0;5,0;54,0;2,0;1,0;25,0;20,0;3,0;2,0;27,0;20,0;30,0;1,0;;1,0;;1,0;3,0;;;6,0;3,0;;54,0;24,0;8,0;24,0;4,0;;;;4,0;1,0;1,0;4,0;1,0;7,0;2,0;8,0;1,0;13,0;5,0;;1,0;4,0;;3,0;;3,0;2,0;7,0;;4,0;28,0;;4,0;3,0;16,0;1,0;;7,0;11,0;16,0;64,0;;5,0;2,0;;33,0;16,0;10,0;153,0;3,0;12,0;;1,0;8,0;;15,0;98,0;33,0;;2,0;3,0;3,0;;10,0;2,0;8,0;13,0;;;4,0;3,0;8,0;7,0;;;17,0;;5,0;7,0;;;1,0;;3,0;1,0;3,0;;;4,0;;25,0;2,0;5,0;;;7,0;;;9,0;10,0;9,0;13,0;10,0;;;;;;8,0;6,0;1,0;3,0;;9,0;3,0;1,0;2,0;;;3,0;22,0;;4,0;4,0;3,0;1,0;10,0;4,0;4,0;1,0;22,0;7,0;6,0;1,0;2,0;;8,0;;6,0;5,0;;2,0;7,0;9,0;;;8,0;;;;;;;52,0;4,0;1,0;;;1,0;1,0;;;3,0;22,0;;;9,0;;1,0;21,0;42,0;;;1,0;;;;1,0;5,0;;6,0;2,0;1,0;43,0;1,0;7,0;;;1,0;;2,0;13,0;1,0;;6,0;11,0;;;;1,0;20,0;2,0;;;1,0;6,0;1,0;2,0;;;;;1,0;;;;;;;;;;1,0;3,0;;;2,0;;;;;;;1,0;;;;;;4,0;;2,0;;;;;2,0;;;;2,0;;35,0;;;;2,0;2,0;;;;;;;2,0;1,0;;;;
optical;35,0;;72,0;1,0;283,0;8,0;3733,0;148,0;35,0;209,0;177,0;59,0;2,0;19,0;35,0;21,0;32,0;27,0;169,0;9,0;215,0;323,0;10,0;94,0;192,0;;10,0;190,0;30,0;153,0;89,0;122,0;975,0;17,0;198,0;7,0;66,0;1481,0;52,0;137,0;291,0;55,0;233,0;1426,0;25,0;2,0;1,0;244,0;286,0;30,0;104,0;98,0;3,0;878,0;23,0;2929,0;693,0;1,0;289,0;4476,0;11,0;72,0;248,0;15,0;2,0;40,0;238,0;53,0;6,0;66,0;;60,0;932,0;49,0;21,0;270,0;18,0;93,0;714,0;845,0;10,0;70,0;29,0;21,0;119,0;145,0;149,0;10,0;44,0;38,0;584,0;45,0;145,0;392,0;22,0;61,0;1,0;21,0;41,0;121,0;645,0;3858,0;1,0;3,0;;7,0;51,0;1895,0;25,0;7,0;48,0;282,0;118,0;178,0;69,0;2,0;41,0;3,0;53,0;131,0;11,0;;32,0;76,0;17,0;6,0;335,0;60,0;16,0;54,0;91,0;15,0;23,0;45,0;7,0;58,0;311,0;;17,0;61,0;2,0;3,0;39,0;73,0;545,0;76,0;817,0;215,0;2,0;65,0;2,0;35,0;185,0;29,0;163,0;83,0;32,0;187,0;84,0;1110,0;162,0;40,0;42,0;17,0;6,0;142,0;13,0;773,0;4,0;97,0;591,0;261,0;350,0;118,0;109,0;98,0;59,0;126,0;4,0;9,0;9,0;10,0;209,0;38,0;7,0;325,0;124,0;467,0;5,0;373,0;2,0;13,0;55,0;242,0;19,0;160,0;105,0;3,0;54,0;37,0;8,0;64,0;28,0;347,0;4,0;4,0;19,0;13,0;29,0;183,0;9,0;9,0;2,0;30,0;62,0;63,0;107,0;54,0;3,0;2,0;16,0;12,0;65,0;31,0;38,0;59,0;36,0;2,0;4,0;10,0;20,0;5,0;35,0;33,0;111,0;165,0;6,0;43,0;149,0;16,0;311,0;17,0;97,0;15,0;3,0;21,0;36,0;114,0;8,0;28,0;3,0;;2,0;67,0;44,0;3,0;18,0;57,0;13,0;12,0;12,0;126,0;11,0;20,0;23,0;4,0;133,0;9,0;13,0;41,0;12,0;92,0;6,0;9,0;53,0;14,0;;8,0;88,0;117,0;1,0;21,0;7,0;120,0;2,0;38,0;534,0;615,0;20,0;26,0;23,0;129,0;26,0;16,0;12,0;436,0;10,0;558,0;5,0;;15,0;;144,0;101,0;78,0;27,0;;85,0;49,0;5,0;12,0;64,0;109,0;75,0;35,0;;30,0;4,0;17,0;19,0;8,0;51,0;73,0;24,0;2,0;57,0;11,0;7,0;11,0;1,0;30,0;33,0;;1,0;;3,0;8,0;8,0;7,0;14,0;7,0;31,0;5,0;28,0;114,0;3,0;12,0;22,0;15,0;129,0;34,0;;26,0;25,0;;23,0;1,0;16,0;10,0;14,0;12,0;14,0;42,0;22,0;17,0;11,0;17,0;2,0;27,0;5,0;3,0;5,0;12,0;12,0;40,0;18,0;11,0;1,0;19,0;215,0;8,0;346,0;6,0;13,0;9,0;18,0;13,0;14,0;;149,0;4,0;33,0;45,0;;52,0;11,0;4,0;62,0;6,0;31,0;12,0;;14,0;11,0;22,0;19,0;12,0;552,0;11,0;1,0;72,0;39,0;2,0;26,0;;1,0;18,0;15,0;65,0;33,0;35,0;1,0;;51,0;56,0;3,0;4,0;21,0;24,0;61,0;4,0;1,0;;4,0;;16,0;5,0;6,0;;3,0;;2,0;;1,0;7,0;17,0;21,0;287,0;11,0;35,0;3,0;10,0;106,0;20,0;10,0;15,0;2,0;7,0;18,0;1,0;;;4,0;29,0;8,0;28,0;370,0;;40,0;;3,0;78,0;;;1,0;7,0;14,0;1,0;18,0;12,0;1,0;5,0;;15,0;1,0;82,0;53,0;13,0;4,0;18,0;;62,0;8,0;8,0;28,0;244,0;170,0;6,0;12,0;7,0;2,0;5,0;;3,0;172,0;10,0;;230,0;;8,0;;3,0;;7,0;48,0;11,0;;11,0;;;26,0;1,0;2,0;3,0;;20,0;2,0;5,0;1,0;84,0;2,0;;7,0;;9,0;2,0;11,0;;6,0;;;64,0;2,0;10,0;2,0;2,0;;;4,0;2,0;6,0;;3,0;12,0;4,0;13,0;22,0;1,0;7,0;16,0;142,0;;;;2,0;1,0;154,0;7,0;10,0;;3,0;;2,0;;8,0;1,0;;2,0;2,0;;1,0;6,0;343,0;16,0;4,0;12,0;7,0;2,0;3,0;5,0;2,0;7,0;;8,0;6,0;6,0;4,0;;15,0;37,0;1,0;;42,0;84,0;;;38,0;15,0;3,0;1,0;4,0;16,0;;;4,0;;8,0;94,0;;7,0;3,0;;6,0;53,0;19,0;;;;15,0;;;28,0;27,0;82,0;65,0;8,0;253,0;4,0;;8,0;4,0;4,0;13,0;;23,0;;11,0;19,0;9,0;3,0;4,0;63,0;;3,0;5,0;;5,0;;19,0;22,0;15,0;;;28,0;51,0;31,0;48,0;;;7,0;4,0;26,0;1,0;161,0;41,0;28,0;22,0;4,0;;;;2,0;1,0;3,0;21,0;;;9,0;;2,0;;94,0;4,0;7,0;3,0;6,0;;27,0;53,0;1,0;51,0;2,0;;65,0;12,0;2,0;2,0;2,0;;25,0;4,0;17,0;5,0;27,0;1,0;;4,0;8,0;2,0;12,0;28,0;11,0;4,0;17,0;4,0;10,0;1,0;;4,0;1,0;19,0;4,0;4,0;9,0;;2,0;;4,0;2,0;15,0;9,0;36,0;;16,0;7,0;30,0;20,0;9,0;170,0;;26,0;35,0;3,0;5,0;;10,0;5,0;28,0;10,0;35,0;12,0;30,0;8,0;16,0;;28,0;;11,0;11,0;1,0;2,0;5,0;44,0;79,0;1,0;33,0;10,0;9,0;4,0;;;;2,0;2,0;;7,0;3,0;;40,0;;;6,0;;15,0;13,0;;;4,0;5,0;;1,0;;7,0;3,0;;6,0;4,0;1,0;9,0;1,0;33,0;3,0;2,0;33,0;;;3,0;9,0;15,0;;;;14,0;2,0;;213,0;;;39,0;15,0;13,0;48,0;9,0;32,0;1,0;3,0;2,0;;15,0;4,0;;10,0;15,0;5,0;1,0;2,0;;;1,0;6,0;3,0;;8,0;4,0;;1,0;14,0;6,0;9,0;12,0;8,0;1,0;34,0;25,0;55,0;27,0;28,0;1,0;2,0;;20,0;2,0;8,0;;4,0;1,0;10,0;2,0;;6,0;8,0;4,0;1,0;15,0;12,0;6,0;2,0;4,0;;27,0;;;1,0;;4,0;5,0;3,0;4,0;3,0;24,0;4,0;21,0;;;3,0;1,0;6,0;1,0;2,0;;2,0;89,0;;24,0;;41,0;26,0;;20,0;155,0;5,0;13,0;7,0;;1,0;2,0;5,0;13,0;7,0;90,0;4,0;;;;1,0;1,0;66,0;;;3,0;;10,0;;1,0;1,0;;2,0;4,0;4,0;1,0;5,0;;61,0;1,0;;10,0;1,0;;15,0;55,0;3,0;;;16,0;;2,0;4,0;8,0;2,0;3,0;;15,0;1,0;6,0;;;;1,0;1,0;;3,0;;;2,0;18,0;26,0;;;;;4,0;8,0;;27,0;;35,0;;;;
order;2,0;;15,0;2,0;19,0;6,0;22,0;18,0;6,0;55,0;2,0;10,0;5,0;6,0;21,0;2,0;22,0;1,0;14,0;9,0;4,0;49,0;3,0;17,0;15,0;;1,0;55,0;24,0;19,0;3,0;34,0;64,0;8,0;33,0;6,0;1,0;54,0;;72,0;12,0;1,0;15,0;46,0;4,0;3,0;;12,0;24,0;3,0;9,0;21,0;6,0;58,0;;612,0;45,0;1,0;9,0;461,0;1,0;12,0;41,0;;;2,0;8,0;3,0;;12,0;60,0;;7,0;;;6,0;;7,0;53,0;73,0;5,0;30,0;3,0;5,0;8,0;1,0;10,0;;3,0;21,0;7,0;7,0;5,0;37,0;10,0;15,0;;13,0;29,0;2,0;12,0;204,0;;2,0;3,0;;1,0;195,0;;;1,0;66,0;8,0;2,0;1,0;4,0;;5,0;3,0;8,0;;;2,0;;;1,0;13,0;;;2,0;3,0;16,0;;;1,0;2,0;29,0;;5,0;6,0;;;4,0;46,0;3,0;8,0;29,0;51,0;2,0;;3,0;;2,0;5,0;7,0;;2,0;7,0;1,0;64,0;3,0;3,0;2,0;;;5,0;1,0;34,0;1,0;4,0;27,0;8,0;4,0;11,0;19,0;8,0;;22,0;;;1,0;;1,0;;1,0;7,0;6,0;45,0;;18,0;;;8,0;16,0;1,0;15,0;4,0;;12,0;7,0;;3,0;1,0;418,0;;2,0;13,0;4,0;5,0;14,0;;;;;8,0;33,0;12,0;2,0;4,0;;10,0;13,0;9,0;;1,0;;3,0;1,0;;1,0;8,0;;6,0;;17,0;9,0;;7,0;14,0;2,0;3,0;;3,0;;;;;;;;11,0;6,0;1,0;2,0;;2,0;;12,0;19,0;;4,0;5,0;10,0;;;;3,0;;;2,0;;4,0;;;2,0;3,0;17,0;;2,0;;;2,0;1,0;4,0;;15,0;20,0;444,0;6,0;7,0;4,0;;;1,0;;2,0;;50,0;;;1,0;;24,0;1,0;;1,0;;10,0;5,0;;3,0;6,0;;;1,0;;;;;;;2,0;;;1,0;7,0;;;3,0;8,0;12,0;10,0;;;;;3,0;;;;;1,0;;5,0;1,0;3,0;2,0;11,0;3,0;26,0;3,0;1,0;8,0;2,0;;;1,0;1,0;;;1,0;7,0;;;12,0;8,0;;;2,0;1,0;1,0;;2,0;3,0;7,0;61,0;;1,0;6,0;;5,0;2,0;1,0;8,0;;2,0;1,0;12,0;1,0;11,0;3,0;6,0;;;8,0;1,0;10,0;2,0;24,0;3,0;17,0;;;2,0;;1,0;2,0;148,0;;1,0;8,0;3,0;;3,0;;;;;22,0;;29,0;;;2,0;11,0;;4,0;12,0;3,0;3,0;8,0;4,0;;1,0;;2,0;;;12,0;1,0;5,0;;;;1,0;4,0;1,0;6,0;4,0;11,0;;7,0;7,0;3,0;;;9,0;2,0;10,0;;;6,0;;2,0;2,0;3,0;4,0;4,0;13,0;;2,0;21,0;;;;2,0;;2,0;;4,0;15,0;;;;5,0;23,0;7,0;;;13,0;14,0;15,0;3,0;1,0;28,0;1,0;;8,0;;6,0;;;2,0;6,0;4,0;;;;;2,0;;;;1,0;5,0;13,0;;9,0;2,0;23,0;;;1,0;4,0;;9,0;6,0;;4,0;1,0;;;;2,0;3,0;;1,0;;;2,0;;;1,0;;1,0;;;1,0;1,0;3,0;11,0;;;;9,0;;1,0;;2,0;4,0;29,0;;2,0;59,0;;5,0;8,0;;;;;2,0;;3,0;1,0;;;1,0;;;1,0;4,0;20,0;7,0;;;;;;4,0;1,0;;1,0;;8,0;3,0;1,0;;3,0;;;;11,0;4,0;;4,0;;2,0;;;;3,0;;;;;;;;2,0;;;2,0;;;;1,0;;3,0;;;;;4,0;8,0;;4,0;2,0;10,0;;;1,0;5,0;;;16,0;3,0;;;;1,0;4,0;;;;;2,0;;4,0;;2,0;;;;;1,0;;;;;;;;2,0;3,0;1,0;;;1,0;3,0;;4,0;;;;;;8,0;2,0;;;5,0;;3,0;;;;5,0;;;;;;3,0;1,0;;;2,0;31,0;16,0;2,0;;3,0;3,0;;;1,0;;2,0;;;;;;1,0;2,0;1,0;15,0;;1,0;5,0;;7,0;8,0;;;1,0;;1,0;;3,0;2,0;;;3,0;3,0;2,0;;;;;1,0;3,0;1,0;;;3,0;13,0;;3,0;;;3,0;;2,0;9,0;;;;;5,0;;2,0;3,0;;;;2,0;1,0;;2,0;;1,0;2,0;;1,0;10,0;6,0;;;;;;2,0;1,0;;3,0;;1,0;;;;;;;1,0;;1,0;18,0;;;1,0;;5,0;;;;;2,0;4,0;1,0;1,0;5,0;;;;;;3,0;;3,0;7,0;1,0;;;3,0;2,0;;;23,0;;2,0;;;;;;;2,0;;;;2,0;;;3,0;;;;2,0;;;;;;;;;;;1,0;;;;;;;;;;;;;1,0;;;;3,0;2,0;;;1,0;;;2,0;;1,0;;;6,0;3,0;;;;;;;1,0;1,0;1,0;2,0;;;2,0;1,0;3,0;2,0;;;12,0;;2,0;;2,0;;;1,0;;5,0;;1,0;3,0;;;;;3,0;;;;;;1,0;1,0;;;;;;;;1,0;;;;;;1,0;;;1,0;2,0;;;;4,0;;;;;4,0;;;;;;3,0;;;;;3,0;;;;;;;;;;;2,0;;;;;;;
path;3,0;;;;62,0;;15,0;42,0;;39,0;4,0;7,0;13,0;;5,0;;1,0;5,0;8,0;12,0;1,0;68,0;3,0;4,0;2,0;;4,0;53,0;4,0;12,0;2,0;20,0;66,0;3,0;36,0;2,0;36,0;53,0;1,0;33,0;12,0;;5,0;65,0;;1,0;4,0;16,0;6,0;1,0;8,0;2,0;;23,0;1,0;369,0;87,0;;69,0;209,0;5,0;2,0;67,0;;1,0;4,0;55,0;3,0;2,0;11,0;932,0;7,0;;1,0;;26,0;;22,0;181,0;5,0;2,0;22,0;19,0;4,0;20,0;17,0;15,0;;1,0;6,0;76,0;4,0;14,0;89,0;6,0;2,0;3,0;8,0;3,0;3,0;25,0;138,0;6,0;32,0;2,0;;17,0;66,0;6,0;1,0;4,0;125,0;25,0;9,0;6,0;2,0;22,0;;;17,0;;4,0;11,0;10,0;3,0;2,0;30,0;1,0;;3,0;39,0;7,0;;;3,0;33,0;69,0;;1,0;8,0;2,0;2,0;5,0;8,0;91,0;2,0;59,0;10,0;4,0;3,0;;;29,0;1,0;3,0;6,0;1,0;22,0;68,0;194,0;14,0;4,0;1,0;4,0;3,0;2,0;33,0;319,0;11,0;2,0;47,0;109,0;39,0;12,0;38,0;19,0;6,0;94,0;2,0;;;1,0;25,0;;5,0;22,0;12,0;46,0;;68,0;;;23,0;73,0;2,0;48,0;6,0;;4,0;2,0;4,0;3,0;3,0;21,0;;;;2,0;1,0;14,0;;;;;4,0;15,0;17,0;1,0;24,0;2,0;2,0;2,0;1,0;45,0;;8,0;1,0;;;;1,0;;2,0;2,0;15,0;6,0;12,0;10,0;11,0;7,0;8,0;;13,0;;;3,0;2,0;8,0;;;2,0;6,0;5,0;24,0;4,0;3,0;;32,0;;1,0;3,0;11,0;5,0;;3,0;1,0;26,0;;2,0;;1,0;4,0;1,0;;49,0;8,0;1,0;;1,0;36,0;;;4,0;9,0;;25,0;35,0;92,0;1,0;13,0;28,0;5,0;1,0;2,0;;12,0;5,0;76,0;2,0;;3,0;;19,0;12,0;16,0;2,0;15,0;11,0;;;5,0;31,0;52,0;;;9,0;1,0;;;3,0;;12,0;3,0;4,0;;43,0;;;1,0;1,0;5,0;;4,0;;;4,0;;;1,0;;;7,0;1,0;1,0;;;1,0;3,0;;16,0;8,0;4,0;5,0;24,0;;5,0;1,0;;5,0;;2,0;;4,0;9,0;6,0;2,0;;2,0;4,0;10,0;1,0;1,0;1,0;28,0;12,0;1,0;4,0;;;22,0;;74,0;;5,0;1,0;;2,0;4,0;1,0;84,0;1,0;12,0;3,0;;10,0;2,0;13,0;10,0;;;8,0;;3,0;5,0;4,0;6,0;14,0;7,0;;1,0;3,0;22,0;4,0;2,0;;2,0;;;28,0;10,0;16,0;;2,0;5,0;5,0;5,0;;1,0;;22,0;10,0;3,0;;9,0;4,0;5,0;;;;2,0;;;4,0;;;5,0;23,0;15,0;1,0;5,0;;1,0;5,0;2,0;;;;;4,0;;;;3,0;3,0;;13,0;15,0;;32,0;;;21,0;9,0;;;;21,0;;;;;2,0;;;;9,0;2,0;6,0;;2,0;;15,0;4,0;7,0;107,0;29,0;136,0;4,0;;;;;;10,0;31,0;;;;;;;;;1,0;20,0;1,0;;;1,0;;;;;22,0;;8,0;1,0;;;29,0;;;;6,0;4,0;;;;;;;;;2,0;1,0;;;;;16,0;1,0;10,0;;1,0;1,0;2,0;7,0;;;14,0;16,0;4,0;4,0;;;;5,0;3,0;1,0;;1,0;1,0;;;;;1,0;1,0;;4,0;;;48,0;;2,0;2,0;;;;;12,0;;;4,0;;10,0;;;;4,0;;1,0;23,0;11,0;;;;3,0;1,0;;;;;;1,0;;4,0;1,0;;1,0;;;;8,0;10,0;;;;54,0;;;;;26,0;1,0;;578,0;9,0;;1,0;;3,0;;1,0;1,0;2,0;1,0;;;;23,0;43,0;;;;;;;12,0;4,0;3,0;;;7,0;9,0;20,0;2,0;;;4,0;1,0;;;2,0;20,0;9,0;;;1,0;;11,0;;;4,0;1,0;3,0;5,0;;;1,0;;3,0;;;2,0;1,0;5,0;8,0;2,0;;;;2,0;9,0;5,0;;8,0;;;4,0;;1,0;2,0;4,0;;;9,0;;;;;;4,0;13,0;;;;2,0;;;;;2,0;;;1,0;;;;;;1,0;;4,0;;3,0;;1,0;4,0;;39,0;;;;;;8,0;11,0;7,0;1,0;;6,0;1,0;;;;;;;;;3,0;;16,0;1,0;3,0;;;1,0;13,0;1,0;;2,0;8,0;10,0;1,0;;9,0;1,0;;;2,0;;1,0;;;2,0;;5,0;;;;;;2,0;;;1,0;1,0;;;2,0;3,0;8,0;;;;32,0;;;;;;;;42,0;;;2,0;;;;1,0;;;;;;1,0;3,0;;;7,0;1,0;;;;7,0;;;;;2,0;2,0;;;1,0;;;;6,0;;1,0;;13,0;2,0;;;1,0;;;;4,0;;1,0;;7,0;;;;3,0;;;2,0;1,0;;4,0;;;;;;2,0;2,0;;;2,0;;;3,0;2,0;;;;;1,0;;;;;;21,0;;3,0;5,0;12,0;1,0;;;17,0;;;;;;;1,0;1,0;;2,0;;1,0;;;;1,0;;;;6,0;;;;;;;;;;1,0;;;;;;;;;1,0;;;;;;;;;;;;4,0;;;1,0;;;;;;;;;;;10,0;24,0;1,0;;;;;;;;;14,0;;;;
peripheral;1,0;3,0;;;12,0;;11,0;29,0;;3,0;3,0;;1,0;;3,0;2,0;;;16,0;3,0;;5,0;;8,0;;;1,0;3,0;;6,0;;3,0;89,0;;12,0;;;19,0;;9,0;;3,0;7,0;31,0;;;1,0;;;;1,0;;;;2,0;60,0;21,0;;;80,0;1,0;;14,0;;;;1,0;;;4,0;49,0;;1,0;;6,0;;1,0;14,0;44,0;2,0;;;;;;;71,0;2,0;;;11,0;;1,0;12,0;;6,0;;;;1,0;201,0;3,0;;;2,0;;;10,0;;;;22,0;;1,0;15,0;;2,0;;1,0;9,0;2,0;;1,0;26,0;;;12,0;67,0;;19,0;12,0;;;28,0;2,0;;8,0;;9,0;;;;6,0;20,0;4,0;;49,0;20,0;;;;22,0;7,0;;7,0;13,0;8,0;11,0;;18,0;;;80,0;11,0;1,0;12,0;;28,0;;7,0;68,0;;13,0;10,0;;22,0;159,0;;1,0;;;;;8,0;;;4,0;20,0;;305,0;;8,0;;3,0;;;20,0;1,0;11,0;4,0;;3,0;2,0;41,0;4,0;;;3,0;9,0;29,0;;;;2,0;;;;2,0;;7,0;15,0;2,0;7,0;;45,0;;;;;2,0;6,0;;;38,0;;2,0;21,0;4,0;48,0;;24,0;;1,0;1,0;;;;1,0;3,0;12,0;;;1,0;14,0;;;21,0;17,0;;1,0;4,0;1,0;19,0;1,0;2,0;1,0;19,0;;5,0;2,0;;5,0;;;9,0;18,0;1,0;;6,0;9,0;;2,0;;5,0;9,0;13,0;8,0;7,0;;;;;2,0;7,0;1,0;;;20,0;2,0;20,0;2,0;;4,0;6,0;4,0;3,0;;1,0;4,0;8,0;4,0;3,0;;2,0;7,0;;;20,0;2,0;15,0;;;40,0;1,0;1,0;;;4,0;;;4,0;;3,0;;;;;;3,0;;;;;;;;;;2,0;4,0;3,0;;;;;;;;;;;;;2,0;;;;;1,0;3,0;;2,0;;4,0;3,0;2,0;;;;;;4,0;;;;;;;;;1,0;;2,0;;;;1,0;4,0;;;;;;;;4,0;4,0;;;;;1,0;2,0;;;;4,0;;5,0;;;;;;;;;;5,0;4,0;;;;;;;;;;;1,0;;;;;1,0;6,0;5,0;;;;8,0;6,0;2,0;;;;;;;;;;;1,0;1,0;3,0;;;;2,0;;;;;;;;;;;;;;;4,0;7,0;;;;;;;;14,0;11,0;;;;;;;;;;2,0;;;;;2,0;;4,0;;;4,0;;;;;;;;;;;;;;;;;;;;;2,0;;;;;;;12,0;8,0;;;;;1,0;;;2,0;;;;1,0;;;9,0;8,0;;1,0;;;;4,0;;;;;;;;13,0;;2,0;12,0;;;;;1,0;;;3,0;12,0;1,0;;;11,0;8,0;;;;;;;1,0;2,0;;;;;;2,0;;6,0;;;7,0;1,0;;;;;;;;;;;;1,0;;;;;1,0;;;2,0;;;;;;;;;4,0;;6,0;;4,0;;;4,0;;;;7,0;;;2,0;1,0;;;;4,0;;;;4,0;;1,0;1,0;;2,0;1,0;;;;2,0;;8,0;;3,0;;;;4,0;;;;;;;;;;;;;;;;3,0;;;1,0;;;;;;;;;;;;;;;;2,0;;;;;;4,0;;;2,0;;;;;;;;;;;1,0;;1,0;1,0;;;;;;;;;4,0;;;;;;;;;;;1,0;;;;;;;;;;;;;;12,0;;1,0;;;;;;;;3,0;;;;1,0;;;;;;;5,0;;;8,0;;1,0;;;;;;;;;;;;;;;;;;;;;;;1,0;;;;;;;;;;11,0;;;;;;;;;;11,0;;;;;;;;10,0;;;;;;;;;;;2,0;5,0;;;;1,0;;;1,0;;;;;2,0;1,0;11,0;;;;;;;2,0;;1,0;;1,0;;;;;;;;;;;;;;;;;;;;;1,0;;;;;;;;;;;;;;1,0;;4,0;;;;;13,0;1,0;;;;;;3,0;;;;;;;;;;;;;;8,0;;;3,0;;1,0;;;;;;;;;;;;;;;;7,0;2,0;;;1,0;;;3,0;;;;;;;;;;;;;;;4,0;;4,0;;;;
periphery;1,0;;;;2,0;;18,0;15,0;;;32,0;;6,0;;1,0;;;1,0;4,0;;1,0;;;;;;2,0;;;4,0;;1,0;11,0;;9,0;;;3,0;;34,0;2,0;;12,0;11,0;;;;;2,0;;1,0;;;2,0;2,0;15,0;6,0;;;96,0;;;5,0;;;;3,0;;;1,0;21,0;;;6,0;;;;8,0;25,0;7,0;1,0;2,0;;;;2,0;20,0;;;;13,0;;;2,0;1,0;10,0;1,0;;;20,0;79,0;;;;;;;8,0;;1,0;;18,0;6,0;1,0;13,0;;;;5,0;5,0;7,0;;;3,0;;;2,0;7,0;;7,0;34,0;;;1,0;;4,0;16,0;7,0;25,0;1,0;;;5,0;7,0;2,0;;42,0;22,0;;;;6,0;5,0;;5,0;9,0;4,0;11,0;;8,0;2,0;13,0;78,0;3,0;;4,0;;29,0;;5,0;34,0;;23,0;8,0;;10,0;135,0;;1,0;;;;;;;;11,0;31,0;;81,0;1,0;2,0;;6,0;6,0;1,0;7,0;4,0;3,0;;2,0;13,0;4,0;21,0;2,0;;1,0;;2,0;2,0;;;;;;;9,0;16,0;6,0;2,0;6,0;2,0;;;19,0;;;;;3,0;;1,0;2,0;4,0;1,0;1,0;10,0;3,0;74,0;;26,0;5,0;;5,0;;;;15,0;1,0;6,0;;;3,0;15,0;1,0;;;31,0;;;;2,0;3,0;3,0;7,0;;34,0;;11,0;3,0;9,0;2,0;;1,0;2,0;1,0;;;;8,0;2,0;3,0;;;2,0;;1,0;6,0;2,0;3,0;;;;;1,0;1,0;;14,0;13,0;;;;2,0;14,0;2,0;6,0;3,0;;4,0;7,0;;;;;8,0;;;2,0;2,0;20,0;2,0;;3,0;;;3,0;2,0;4,0;;;;;5,0;;;;;;;;1,0;;;;;;;;;4,0;14,0;;;;;;;;;;;;;;;;;;1,0;;;;;2,0;;;;;;3,0;;3,0;;;;2,0;;;;1,0;;;2,0;;;;;1,0;;;;;;;;;;2,0;;;2,0;;2,0;;;;;;3,0;1,0;1,0;;;1,0;;;;;;;;;;;;;;;;;;;;;;1,0;;2,0;;1,0;;;;;1,0;;;;;;;;;;;2,0;2,0;;;;;;;;;;1,0;;;;;;;;;1,0;4,0;3,0;;;;2,0;4,0;;;;;2,0;;;;;;;2,0;;;4,0;;;5,0;;;;;;;;;;;1,0;;;;;;;;;;;;;;;1,0;;;;;;;1,0;2,0;2,0;1,0;;;;;;5,0;;;;;;;;8,0;;;;;;;;;;;;;;13,0;;5,0;;;;;;;;;3,0;23,0;;;;;11,0;;;3,0;;;;;;;;;;;;;;;1,0;;2,0;;;;;;;;;;;;1,0;;;;;;;;7,0;;2,0;;;7,0;;;;;;3,0;;;;;;18,0;1,0;;1,0;;;5,0;;1,0;;;;;5,0;;;;1,0;;;;;;;;6,0;;;1,0;;;;;;;;;;;;;;;2,0;;;;;;;;;;;;;;;;;;;3,0;;;;;;;;;;7,0;1,0;2,0;;;;;;;;;;;;;;;;;;;;;9,0;;;;;3,0;;;;;;;;;;2,0;;;;;;;;;;;;;;;7,0;;;;;;;;;;;;;;;;;;;;;4,0;;;2,0;;;;;;;;;;;;;;;;;2,0;;;;6,0;;;5,0;;;;;2,0;;;;;2,0;;2,0;;;;;;;;1,0;19,0;;;;;;;3,0;3,0;;;;;;;;;;;;1,0;;;;;;;;;;;;;;;;;;;;1,0;1,0;3,0;;;;;;;;;;;;;;;;;;;;;;5,0;;;;6,0;;;;;;;;;;;;;;;;;;;;;;;;;;;;;;;;;;;;;4,0;;;3,0;;1,0;4,0;;;;;2,0;;;;;;;;;;;;;;;;;;;;;;;;;2,0;;;3,0;;;;;;;;;7,0;;;;
photographic;2,0;8,0;17,0;7,0;18,0;;38,0;44,0;6,0;67,0;6,0;19,0;;2,0;9,0;;1,0;;1,0;2,0;32,0;40,0;;1,0;31,0;2,0;;23,0;;32,0;23,0;10,0;132,0;2,0;33,0;4,0;17,0;17,0;;62,0;29,0;11,0;26,0;16,0;2,0;;2,0;24,0;7,0;;12,0;12,0;;12,0;;677,0;48,0;;22,0;249,0;;33,0;41,0;;;4,0;13,0;;;24,0;270,0;6,0;26,0;;;;;11,0;167,0;3,0;;26,0;1,0;;;;44,0;3,0;;23,0;20,0;1,0;16,0;8,0;1,0;;;5,0;13,0;;10,0;146,0;;48,0;5,0;;;255,0;;;7,0;2,0;;9,0;11,0;2,0;;;;20,0;;;2,0;9,0;;;19,0;1,0;;;2,0;8,0;;;;;15,0;;;6,0;;2,0;10,0;8,0;2,0;1,0;84,0;40,0;;;2,0;;24,0;;3,0;;2,0;7,0;10,0;24,0;6,0;2,0;;2,0;;;20,0;86,0;;;22,0;27,0;1,0;38,0;10,0;12,0;;37,0;;;3,0;;5,0;1,0;1,0;25,0;;54,0;;15,0;3,0;;;22,0;25,0;11,0;;;3,0;;;23,0;2,0;63,0;;7,0;;;;9,0;;;;;;31,0;14,0;;;4,0;2,0;11,0;8,0;8,0;;;4,0;;;;;;;1,0;3,0;9,0;;;33,0;2,0;10,0;;1,0;;;7,0;;;;;6,0;;;6,0;4,0;;1,0;2,0;;;35,0;7,0;2,0;;10,0;;2,0;;;2,0;;3,0;;2,0;1,0;;;;;;;1,0;;6,0;;3,0;8,0;178,0;5,0;;;8,0;2,0;11,0;;;1,0;83,0;;;5,0;;12,0;4,0;31,0;;;83,0;1,0;;6,0;5,0;12,0;;12,0;;;;;;1,0;4,0;2,0;;;1,0;;;1,0;;6,0;3,0;;;;;2,0;3,0;;;3,0;;4,0;8,0;2,0;;10,0;2,0;;24,0;7,0;1,0;;;;1,0;;1,0;;4,0;1,0;;2,0;;16,0;20,0;1,0;;1,0;;2,0;;;12,0;3,0;3,0;;3,0;;1,0;;6,0;1,0;1,0;;2,0;;;;34,0;;3,0;;;1,0;;2,0;2,0;;3,0;18,0;;;;1,0;;7,0;38,0;;;;13,0;;;;;;;15,0;3,0;;3,0;;1,0;54,0;;;4,0;1,0;2,0;7,0;;;;;;;;;2,0;1,0;;;;;6,0;17,0;49,0;;1,0;;36,0;69,0;10,0;;1,0;11,0;;10,0;;2,0;26,0;;1,0;;12,0;5,0;;;;;21,0;;;;;25,0;;1,0;3,0;23,0;;1,0;;;1,0;10,0;5,0;;41,0;;7,0;;1,0;6,0;11,0;10,0;4,0;;;;;;3,0;6,0;;;;;10,0;;;;;11,0;;;;;2,0;8,0;;;1,0;;12,0;1,0;;;8,0;4,0;;15,0;;20,0;;;;;;;;;4,0;;6,0;;;27,0;;7,0;;;;;;;;;;9,0;;;6,0;;11,0;10,0;3,0;24,0;;;;;;3,0;1,0;;;;;;;249,0;6,0;;2,0;2,0;5,0;;1,0;1,0;;;5,0;;4,0;;;4,0;;;;39,0;;;;6,0;2,0;;;;;;;;;1,0;;1,0;2,0;;;13,0;7,0;;;;1,0;4,0;1,0;;;1,0;23,0;;;;;;;;;;;;;;;;;8,0;5,0;;;;;;1,0;;;20,0;;;;1,0;;;;;;;;6,0;;;;;;;;;;4,0;24,0;;;;1,0;2,0;;;34,0;;;1,0;;;;1,0;;;;;1,0;;;;4,0;;;;2,0;;;;;;;4,0;;;;;;;;;;;;3,0;;4,0;;;;;;;;;;;;;7,0;;;7,0;;1,0;;;;;;;31,0;1,0;;2,0;;;;;;;;2,0;;4,0;;1,0;8,0;;3,0;5,0;;1,0;;;;1,0;1,0;1,0;5,0;;1,0;;;;;;2,0;1,0;;;;;;;;;;;;3,0;;;4,0;2,0;;;8,0;;;;;1,0;;;6,0;;;1,0;;1,0;;35,0;;;;1,0;;;;;;;1,0;1,0;4,0;;;;;;;;;;;;5,0;;;1,0;;1,0;;;;2,0;;;;;;;;;;;;;;;;;;;;;2,0;;;;;;;;;3,0;;;11,0;3,0;;;14,0;;;;;;;;2,0;1,0;;2,0;1,0;;28,0;;;;;;;4,0;;;;1,0;5,0;;;1,0;;;;3,0;;;;1,0;;;1,0;;1,0;1,0;;;;2,0;;;;;;;;;1,0;;;;;;;;;;;;;;;;;;;4,0;;;;;;;53,0;;;;;;;;;;;;;;;4,0;;;
piezoelectric;1,0;;2,0;;4,0;;9,0;31,0;;;;;;;;;;1,0;;;;6,0;;;1,0;;;;;2,0;;5,0;10,0;;21,0;;1,0;8,0;8,0;;3,0;;24,0;115,0;;;;;;5,0;4,0;14,0;;;;2,0;22,0;;;15,0;4,0;;2,0;;;20,0;2,0;;;;18,0;;;1,0;;;;;14,0;;;;;;;;;;;;7,0;;;4,0;1,0;;;;;27,0;4,0;2,0;;;;2,0;1,0;6,0;7,0;1,0;3,0;10,0;;;5,0;;;;2,0;25,0;;;;7,0;;;11,0;3,0;;3,0;3,0;;;;2,0;;7,0;;18,0;;;;;9,0;2,0;7,0;13,0;;;;;;;;;2,0;;1,0;;1,0;;;;3,0;;43,0;;;1,0;5,0;8,0;;12,0;14,0;3,0;;4,0;;;;;;;;;2,0;5,0;16,0;1,0;35,0;;1,0;;1,0;2,0;;;3,0;7,0;;;4,0;;8,0;;;;;13,0;7,0;;;;;;;;;;;;;7,0;;;;;;;;;3,0;77,0;1,0;5,0;;2,0;23,0;;;15,0;;;;;;;;;;;;;8,0;;;2,0;1,0;;;;26,0;;1,0;4,0;1,0;4,0;;;;1,0;;2,0;;;;;4,0;;;;;;6,0;;;3,0;;;2,0;;;;;;1,0;;;;;;;;;;;7,0;;2,0;;;8,0;;;;;;;;;;1,0;3,0;;;;;3,0;2,0;;;1,0;;;;;;;;;;;9,0;;;;;;;;;;;;;;;;;;;;;1,0;;;;;;;;;;;;;;;;2,0;;1,0;;;1,0;;;;;;;4,0;;;3,0;;;;;2,0;;;;;;;;2,0;;;;1,0;;;;;;;;;;;;;1,0;;;;;;;;;;;;;;;;1,0;;;;;;2,0;;;;;;11,0;;;;;;;;;;;1,0;;;4,0;;;;;1,0;;;;;;;;;;;;;;4,0;;;;;;;;;;;;11,0;7,0;;;;;;;;;2,0;;;;;;;;;;;;;;;;;;;;;;;;;;;;;;;;;;6,0;;;;;;;;;;;;;;;;3,0;;;;;;;;;;;;;;;;;;;1,0;;;;;;;;;5,0;;;;;;;;;;3,0;;;;;;;;;;;;;;;;;;;;;;;;;;;;2,0;;;;;3,0;;;;;;;;;1,0;;;;;;;;;;;;;;;;;4,0;;;;;;;;;;;;4,0;;;;;;;1,0;;;;;;;;;;;;2,0;;;;;;7,0;;;;;;;;;;;;;;;;;;;;;;;;;7,0;10,0;;;;;;;;;;;;;1,0;;;1,0;;;5,0;;;;;2,0;;;;;;;;;;;;;;;;;1,0;;;;;;;;;;;;;;;;;;;;;;;;;;;;;;;;;;;;;;;;;;;;;;;;;;;1,0;;;;;;;;;;;;;;;;;;;;;;;;;;;;;;;;;;;1,0;;4,0;;;4,0;;;;;;;;;;;;;;;;;;;;;;;;;1,0;;;;1,0;;1,0;;;;;;;;;;;;;;;;;;;;;2,0;;;;;;;;;;;;;;;;;;;;;;;;;;;;;;;;;;;;;;;;;;;;;;;;;4,0;;;;;;;;;;;;;;;;;;;;;;;;;;;;;;;;;1,0;;;;;;;;;;;;;;;;
point;1,0;;18,0;7,0;91,0;;186,0;303,0;163,0;115,0;172,0;11,0;13,0;10,0;35,0;6,0;1,0;3,0;42,0;28,0;13,0;158,0;277,0;14,0;62,0;7,0;11,0;298,0;11,0;137,0;236,0;333,0;220,0;35,0;51,0;39,0;11,0;203,0;8,0;132,0;277,0;6,0;12,0;52,0;24,0;10,0;4,0;535,0;166,0;1,0;26,0;119,0;1,0;102,0;42,0;1291,0;189,0;2,0;66,0;299,0;4,0;6,0;374,0;20,0;85,0;17,0;53,0;4,0;6,0;46,0;93,0;7,0;22,0;14,0;8,0;11,0;;;785,0;3,0;;35,0;39,0;8,0;;;197,0;12,0;47,0;238,0;84,0;27,0;14,0;58,0;32,0;74,0;3,0;23,0;34,0;3,0;122,0;180,0;2,0;10,0;9,0;;7,0;107,0;4,0;1,0;20,0;28,0;11,0;14,0;12,0;4,0;4,0;;3,0;21,0;2,0;1,0;38,0;8,0;;4,0;75,0;77,0;4,0;22,0;12,0;8,0;2,0;2,0;12,0;25,0;14,0;1,0;;8,0;8,0;40,0;14,0;100,0;5,0;20,0;71,0;141,0;;;;9,0;3,0;1,0;5,0;1,0;2,0;24,0;14,0;74,0;;3,0;3,0;6,0;56,0;3,0;19,0;220,0;3,0;2,0;54,0;15,0;64,0;52,0;65,0;4,0;6,0;42,0;1,0;13,0;2,0;6,0;16,0;2,0;36,0;119,0;16,0;293,0;;95,0;;;6,0;55,0;10,0;7,0;18,0;;17,0;;1,0;25,0;4,0;72,0;;38,0;1,0;25,0;19,0;51,0;1,0;9,0;23,0;9,0;46,0;252,0;16,0;9,0;4,0;4,0;13,0;35,0;4,0;10,0;6,0;;87,0;;20,0;6,0;;;1,0;23,0;55,0;65,0;;25,0;111,0;10,0;7,0;;8,0;9,0;;4,0;;6,0;;5,0;13,0;4,0;7,0;79,0;3,0;10,0;;47,0;7,0;7,0;12,0;8,0;55,0;2,0;18,0;17,0;39,0;;2,0;2,0;;16,0;20,0;;3,0;3,0;;8,0;38,0;105,0;5,0;2,0;;18,0;;82,0;89,0;408,0;39,0;14,0;2,0;2,0;8,0;47,0;1,0;12,0;5,0;35,0;4,0;;3,0;;120,0;72,0;23,0;8,0;;61,0;17,0;6,0;333,0;66,0;23,0;8,0;4,0;;14,0;;;1,0;7,0;2,0;8,0;5,0;;72,0;;24,0;5,0;9,0;81,0;10,0;1,0;;;1,0;5,0;;6,0;5,0;11,0;85,0;4,0;23,0;7,0;;39,0;11,0;;99,0;49,0;22,0;36,0;1,0;;2,0;29,0;;;1,0;56,0;18,0;2,0;2,0;141,0;46,0;3,0;3,0;3,0;208,0;4,0;2,0;1,0;72,0;23,0;14,0;34,0;5,0;;39,0;32,0;1,0;7,0;3,0;11,0;4,0;3,0;19,0;5,0;35,0;2,0;19,0;6,0;1,0;5,0;19,0;179,0;144,0;23,0;2,0;56,0;;6,0;9,0;51,0;5,0;174,0;33,0;6,0;1,0;49,0;11,0;4,0;6,0;;13,0;317,0;;95,0;19,0;154,0;1,0;;15,0;22,0;1,0;6,0;3,0;2,0;58,0;22,0;5,0;;4,0;1,0;1,0;1,0;5,0;8,0;;11,0;59,0;10,0;1,0;1,0;19,0;19,0;9,0;45,0;;1,0;6,0;31,0;2,0;;10,0;8,0;3,0;10,0;;8,0;;9,0;8,0;5,0;18,0;26,0;6,0;54,0;;;48,0;2,0;53,0;;23,0;6,0;1,0;;27,0;2,0;4,0;;9,0;8,0;21,0;53,0;54,0;;32,0;8,0;19,0;18,0;2,0;130,0;220,0;9,0;19,0;9,0;1,0;4,0;;20,0;24,0;46,0;48,0;1,0;1,0;;1,0;2,0;;;14,0;3,0;44,0;;;4,0;;;7,0;5,0;1,0;;59,0;28,0;2,0;2,0;6,0;;7,0;;2,0;;5,0;1,0;28,0;6,0;;;8,0;;3,0;2,0;4,0;14,0;2,0;;4,0;35,0;;4,0;;2,0;;24,0;;3,0;10,0;116,0;14,0;;;;17,0;57,0;1,0;;;;1,0;;;;;;2,0;6,0;;10,0;7,0;51,0;1,0;4,0;13,0;;;;9,0;2,0;1,0;;7,0;12,0;2,0;2,0;;10,0;16,0;1,0;;83,0;;4,0;1,0;13,0;19,0;4,0;7,0;;2,0;2,0;;2,0;;1,0;;;19,0;1,0;4,0;;11,0;5,0;;;;2,0;;;22,0;8,0;31,0;23,0;1,0;17,0;;2,0;;;2,0;;;2,0;2,0;;;;1,0;69,0;1,0;;;3,0;16,0;2,0;;1,0;12,0;58,0;;;10,0;4,0;2,0;6,0;1,0;;66,0;43,0;3,0;;3,0;15,0;1,0;;9,0;;8,0;3,0;;16,0;11,0;77,0;;2,0;3,0;7,0;;;3,0;4,0;1,0;48,0;;2,0;17,0;10,0;;1,0;;6,0;8,0;3,0;4,0;;3,0;;17,0;;15,0;14,0;16,0;15,0;;2,0;10,0;;;2,0;7,0;9,0;;;6,0;1,0;4,0;;;23,0;;28,0;17,0;;8,0;1,0;13,0;4,0;1,0;28,0;;2,0;4,0;15,0;4,0;29,0;21,0;8,0;4,0;;;10,0;7,0;3,0;11,0;29,0;9,0;11,0;51,0;6,0;15,0;22,0;68,0;8,0;;5,0;;39,0;;24,0;2,0;8,0;5,0;10,0;10,0;6,0;18,0;2,0;3,0;3,0;4,0;57,0;19,0;25,0;10,0;38,0;6,0;2,0;;;5,0;;127,0;3,0;;2,0;4,0;9,0;3,0;14,0;1,0;;2,0;8,0;;2,0;5,0;42,0;1,0;5,0;18,0;4,0;293,0;2,0;4,0;2,0;;16,0;;2,0;3,0;14,0;;;6,0;;;9,0;27,0;13,0;13,0;85,0;2,0;;;;1,0;;10,0;3,0;9,0;4,0;;;27,0;;2,0;3,0;;;5,0;17,0;1,0;1,0;3,0;3,0;;4,0;20,0;1,0;;;1,0;;;16,0;3,0;1,0;;1,0;;17,0;5,0;2,0;;6,0;;8,0;11,0;;;;5,0;2,0;;;;5,0;;;1,0;2,0;2,0;1,0;;;;5,0;12,0;13,0;;;;;19,0;1,0;4,0;;26,0;7,0;17,0;;2,0;25,0;1,0;;8,0;1,0;;38,0;13,0;6,0;;;12,0;1,0;1,0;3,0;;;59,0;;3,0;5,0;;3,0;1,0;;1,0;;26,0;5,0;21,0;;;4,0;8,0;;;;;;1,0;2,0;8,0;2,0;;2,0;32,0;105,0;;;74,0;;;;1,0;7,0;1,0;1,0;12,0;4,0;;;1,0;1,0;2,0;14,0;;2,0;4,0;;4,0;;;;;27,0;11,0;;;;8,0;;3,0;;2,0;;
position;6,0;7,0;51,0;5,0;229,0;;446,0;828,0;300,0;274,0;245,0;44,0;13,0;8,0;97,0;7,0;31,0;8,0;178,0;55,0;38,0;692,0;354,0;99,0;102,0;18,0;55,0;580,0;86,0;906,0;383,0;922,0;976,0;143,0;155,0;20,0;36,0;457,0;132,0;475,0;334,0;9,0;158,0;399,0;24,0;30,0;19,0;212,0;746,0;3,0;68,0;202,0;6,0;252,0;21,0;2090,0;347,0;28,0;81,0;2472,0;41,0;41,0;514,0;20,0;24,0;124,0;338,0;26,0;16,0;194,0;714,0;53,0;181,0;44,0;25,0;167,0;14,0;785,0;;78,0;17,0;76,0;89,0;43,0;2,0;21,0;232,0;47,0;60,0;128,0;510,0;79,0;119,0;273,0;140,0;88,0;24,0;103,0;217,0;91,0;373,0;656,0;2,0;49,0;23,0;36,0;21,0;1149,0;2,0;1,0;57,0;136,0;88,0;206,0;61,0;19,0;114,0;2,0;52,0;275,0;31,0;30,0;136,0;72,0;;11,0;412,0;156,0;75,0;49,0;215,0;16,0;3,0;87,0;26,0;188,0;194,0;12,0;69,0;30,0;9,0;25,0;39,0;279,0;134,0;51,0;197,0;382,0;24,0;14,0;1,0;40,0;89,0;24,0;103,0;107,0;110,0;283,0;66,0;427,0;31,0;27,0;69,0;49,0;49,0;13,0;24,0;327,0;4,0;18,0;723,0;339,0;255,0;238,0;168,0;405,0;71,0;173,0;3,0;;63,0;16,0;25,0;13,0;45,0;158,0;178,0;465,0;2,0;480,0;24,0;32,0;22,0;236,0;15,0;90,0;3,0;8,0;169,0;65,0;10,0;53,0;22,0;263,0;17,0;75,0;53,0;51,0;70,0;225,0;22,0;15,0;5,0;1,0;192,0;152,0;48,0;43,0;4,0;59,0;102,0;119,0;29,0;12,0;58,0;20,0;139,0;;25,0;23,0;20,0;1,0;110,0;130,0;262,0;241,0;6,0;41,0;255,0;28,0;269,0;7,0;98,0;25,0;9,0;100,0;17,0;21,0;25,0;95,0;6,0;2,0;16,0;98,0;8,0;3,0;23,0;163,0;83,0;9,0;14,0;152,0;35,0;36,0;69,0;25,0;140,0;13,0;11,0;15,0;19,0;156,0;7,0;34,0;90,0;38,0;18,0;13,0;32,0;262,0;122,0;50,0;44,0;279,0;17,0;63,0;527,0;848,0;79,0;44,0;23,0;14,0;32,0;66,0;11,0;36,0;4,0;308,0;10,0;13,0;34,0;17,0;423,0;82,0;93,0;35,0;9,0;165,0;62,0;33,0;453,0;81,0;367,0;56,0;46,0;5,0;38,0;16,0;23,0;6,0;16,0;73,0;37,0;64,0;7,0;105,0;9,0;41,0;18,0;12,0;129,0;39,0;11,0;4,0;;7,0;10,0;48,0;6,0;67,0;22,0;94,0;9,0;83,0;14,0;2,0;81,0;15,0;15,0;348,0;546,0;66,0;44,0;9,0;3,0;14,0;51,0;42,0;7,0;3,0;111,0;13,0;12,0;10,0;126,0;165,0;12,0;43,0;27,0;145,0;13,0;6,0;13,0;210,0;41,0;50,0;17,0;9,0;;49,0;17,0;97,0;18,0;17,0;24,0;2,0;12,0;14,0;13,0;77,0;48,0;87,0;94,0;2,0;133,0;59,0;181,0;312,0;23,0;1,0;129,0;1,0;32,0;18,0;37,0;23,0;139,0;334,0;11,0;14,0;51,0;54,0;18,0;33,0;1,0;43,0;163,0;17,0;115,0;69,0;108,0;3,0;;128,0;178,0;50,0;;21,0;34,0;49,0;15,0;47,0;15,0;5,0;2,0;12,0;1,0;2,0;16,0;9,0;61,0;5,0;68,0;6,0;18,0;158,0;8,0;50,0;37,0;38,0;5,0;24,0;146,0;146,0;30,0;3,0;47,0;21,0;57,0;;5,0;3,0;14,0;51,0;28,0;94,0;339,0;11,0;110,0;4,0;19,0;123,0;24,0;44,0;4,0;33,0;61,0;;23,0;34,0;5,0;32,0;10,0;12,0;3,0;195,0;102,0;29,0;3,0;110,0;17,0;188,0;50,0;29,0;201,0;285,0;23,0;;9,0;17,0;6,0;6,0;12,0;32,0;208,0;43,0;;46,0;;20,0;25,0;88,0;;20,0;26,0;12,0;20,0;5,0;8,0;48,0;1,0;45,0;20,0;17,0;;2,0;38,0;5,0;10,0;11,0;7,0;7,0;70,0;23,0;3,0;;27,0;34,0;24,0;16,0;1,0;5,0;9,0;26,0;26,0;8,0;27,0;17,0;1,0;14,0;37,0;8,0;7,0;7,0;18,0;8,0;72,0;7,0;11,0;43,0;318,0;1,0;3,0;2,0;14,0;11,0;616,0;12,0;11,0;15,0;31,0;11,0;6,0;3,0;6,0;1,0;25,0;4,0;2,0;2,0;1,0;1,0;300,0;9,0;1,0;62,0;11,0;;;16,0;8,0;6,0;3,0;10,0;5,0;10,0;8,0;;19,0;6,0;4,0;2,0;45,0;5,0;3,0;1,0;20,0;68,0;14,0;5,0;10,0;25,0;14,0;4,0;21,0;6,0;27,0;18,0;3,0;11,0;7,0;;2,0;25,0;2,0;3,0;19,0;2,0;16,0;;1,0;27,0;32,0;101,0;33,0;17,0;110,0;92,0;58,0;4,0;5,0;18,0;22,0;3,0;1,0;2,0;36,0;2,0;11,0;2,0;60,0;8,0;;14,0;2,0;7,0;3,0;36,0;46,0;36,0;261,0;3,0;;6,0;19,0;32,0;8,0;9,0;5,0;28,0;18,0;57,0;;7,0;71,0;17,0;17,0;42,0;;;1,0;2,0;21,0;10,0;144,0;1,0;1,0;13,0;10,0;1,0;;27,0;3,0;;25,0;1,0;10,0;85,0;56,0;;71,0;5,0;1,0;6,0;12,0;15,0;24,0;;9,0;141,0;4,0;25,0;4,0;11,0;1,0;2,0;1,0;36,0;10,0;29,0;1,0;38,0;16,0;17,0;2,0;79,0;;1,0;2,0;;24,0;1,0;80,0;6,0;11,0;2,0;7,0;11,0;2,0;18,0;12,0;10,0;6,0;26,0;16,0;19,0;29,0;26,0;12,0;10,0;2,0;31,0;;18,0;9,0;18,0;34,0;11,0;23,0;29,0;13,0;1,0;21,0;28,0;23,0;11,0;13,0;;27,0;6,0;95,0;10,0;17,0;32,0;25,0;132,0;32,0;43,0;31,0;54,0;;7,0;6,0;30,0;55,0;5,0;100,0;43,0;8,0;;6,0;8,0;;177,0;23,0;22,0;7,0;8,0;5,0;19,0;18,0;2,0;8,0;47,0;9,0;9,0;43,0;7,0;12,0;5,0;4,0;3,0;12,0;244,0;3,0;;2,0;3,0;38,0;2,0;11,0;6,0;19,0;3,0;10,0;17,0;12,0;;17,0;26,0;31,0;29,0;55,0;20,0;;2,0;6,0;6,0;27,0;7,0;6,0;15,0;38,0;20,0;2,0;29,0;2,0;25,0;;9,0;16,0;18,0;15,0;12,0;8,0;4,0;45,0;;37,0;5,0;15,0;7,0;23,0;3,0;30,0;10,0;22,0;1,0;63,0;8,0;2,0;2,0;35,0;;10,0;1,0;33,0;;13,0;12,0;1,0;2,0;7,0;42,0;7,0;4,0;11,0;5,0;21,0;2,0;;8,0;5,0;2,0;5,0;14,0;4,0;;8,0;48,0;;27,0;11,0;6,0;1,0;8,0;;2,0;12,0;15,0;72,0;9,0;5,0;16,0;7,0;20,0;18,0;;2,0;2,0;28,0;41,0;4,0;;1,0;12,0;1,0;1,0;3,0;2,0;;4,0;;;37,0;;7,0;4,0;;5,0;;8,0;5,0;41,0;;6,0;19,0;16,0;;3,0;2,0;9,0;2,0;8,0;6,0;27,0;2,0;;9,0;11,0;6,0;;2,0;2,0;25,0;;;2,0;11,0;32,0;11,0;27,0;9,0;14,0;6,0;;63,0;3,0;;;;15,0;5,0;7,0;;12,0;7,0;1,0;;;;5,0;3,0;5,0;72,0;25,0;;6,0;;
power;4,0;6,0;8,0;;89,0;11,0;80,0;48,0;2,0;13,0;6,0;12,0;;5,0;14,0;4,0;;1,0;31,0;14,0;34,0;219,0;;12,0;21,0;;;37,0;2,0;58,0;13,0;40,0;209,0;6,0;54,0;;14,0;20,0;1,0;49,0;9,0;7,0;69,0;206,0;5,0;;;17,0;4,0;29,0;41,0;45,0;52,0;421,0;1,0;133,0;147,0;;10,0;1166,0;4,0;11,0;72,0;12,0;;78,0;64,0;;1,0;74,0;845,0;73,0;5,0;2,0;7,0;3,0;;3,0;78,0;;4,0;56,0;46,0;6,0;;;10,0;20,0;6,0;77,0;46,0;25,0;6,0;188,0;;13,0;1,0;24,0;23,0;4,0;89,0;374,0;;28,0;1,0;15,0;1,0;1415,0;1,0;;12,0;26,0;7,0;20,0;2,0;;;;9,0;33,0;1,0;;5,0;118,0;;1,0;179,0;13,0;;41,0;10,0;1,0;7,0;;7,0;15,0;39,0;;12,0;23,0;14,0;1,0;70,0;7,0;10,0;16,0;16,0;37,0;2,0;2,0;;;14,0;11,0;5,0;;7,0;38,0;43,0;28,0;;5,0;1,0;2,0;;2,0;127,0;109,0;3,0;5,0;63,0;1,0;112,0;36,0;13,0;10,0;;33,0;;;7,0;2,0;8,0;;2,0;20,0;8,0;70,0;;17,0;;;11,0;142,0;;9,0;189,0;7,0;11,0;5,0;2,0;14,0;4,0;107,0;;3,0;2,0;5,0;3,0;13,0;6,0;6,0;;1,0;9,0;44,0;72,0;3,0;;6,0;1,0;22,0;;;;2,0;;;;;4,0;2,0;7,0;5,0;9,0;5,0;;52,0;1,0;2,0;12,0;;4,0;3,0;18,0;10,0;;4,0;;20,0;8,0;;4,0;122,0;1,0;2,0;4,0;9,0;2,0;1,0;2,0;67,0;;;;1,0;28,0;;;3,0;1,0;8,0;31,0;;4,0;17,0;;2,0;31,0;20,0;;2,0;;11,0;;12,0;53,0;49,0;41,0;1,0;;;;;;;;2,0;;2,0;16,0;;18,0;1,0;3,0;8,0;11,0;26,0;2,0;;5,0;8,0;6,0;;5,0;;3,0;6,0;12,0;;1,0;9,0;19,0;3,0;;413,0;;2,0;944,0;;14,0;32,0;;1,0;;;2,0;;32,0;;1,0;7,0;;;4,0;1,0;;2,0;1,0;22,0;7,0;2,0;9,0;8,0;;8,0;4,0;;;1,0;;;1,0;4,0;3,0;7,0;2,0;2,0;38,0;;14,0;;;1,0;21,0;12,0;2,0;2,0;;4,0;18,0;5,0;;1,0;50,0;;10,0;9,0;;94,0;2,0;35,0;5,0;1,0;6,0;5,0;29,0;3,0;;11,0;2,0;;3,0;1,0;;;;116,0;3,0;10,0;;5,0;2,0;2,0;1,0;2,0;5,0;;33,0;5,0;1,0;2,0;2,0;24,0;187,0;2,0;1,0;1,0;1,0;24,0;3,0;;;;4,0;35,0;1,0;;11,0;184,0;47,0;;1,0;16,0;2,0;27,0;18,0;36,0;;9,0;;2,0;2,0;28,0;;;1,0;;2,0;7,0;14,0;3,0;;;9,0;14,0;16,0;2,0;2,0;;1,0;42,0;1,0;;1,0;;5,0;1,0;;;3,0;;;3,0;;7,0;4,0;22,0;;21,0;14,0;238,0;8,0;91,0;43,0;1,0;;73,0;1,0;1,0;3,0;;1,0;1,0;13,0;3,0;4,0;;11,0;;;;;9,0;137,0;30,0;40,0;1,0;;2,0;;;22,0;;;;9,0;1,0;1,0;13,0;1,0;;3,0;2,0;1,0;;1,0;2,0;;;;;1,0;;;8,0;1,0;1,0;4,0;1,0;;;2,0;3,0;18,0;;11,0;;7,0;5,0;38,0;3,0;6,0;;1,0;;5,0;;5,0;2,0;1,0;4,0;4,0;1,0;;;;;1,0;4,0;;1,0;7,0;16,0;;52,0;2,0;;;;65,0;;1,0;10,0;12,0;23,0;5,0;4,0;3,0;;73,0;6,0;3,0;1,0;2,0;1,0;11,0;6,0;;;;;;;;;7,0;;6,0;8,0;12,0;;1,0;31,0;3,0;;3,0;;58,0;1,0;;79,0;17,0;;;;2,0;;1,0;;;1,0;14,0;;;;;;2,0;1,0;;1,0;;;;;;;;;;;1,0;1,0;1,0;10,0;;1,0;1,0;;2,0;4,0;3,0;1,0;2,0;2,0;;;2,0;;14,0;3,0;8,0;;;6,0;;1,0;;1,0;3,0;139,0;1,0;13,0;2,0;1,0;2,0;1,0;3,0;2,0;1,0;8,0;;;;;;3,0;2,0;1,0;;7,0;;;;;5,0;;4,0;9,0;16,0;;;1,0;;1,0;;;;;;3,0;1,0;5,0;;;1,0;;2,0;;6,0;2,0;;10,0;3,0;6,0;1,0;;28,0;;;16,0;1,0;;;;;26,0;;2,0;;;;1,0;;12,0;;5,0;4,0;;19,0;12,0;3,0;7,0;;3,0;1,0;5,0;;;;1,0;2,0;;;6,0;;;40,0;;;;1,0;;7,0;;;2,0;;;;;;;;;1,0;;;;;1,0;;3,0;2,0;2,0;2,0;;3,0;;;;;3,0;3,0;;;;3,0;1,0;;4,0;;;;2,0;;;12,0;;;11,0;;6,0;;4,0;;1,0;;17,0;1,0;;;;;;41,0;2,0;;;1,0;2,0;;9,0;5,0;;;9,0;14,0;;;23,0;3,0;;1,0;;;;3,0;;;;;3,0;;;;;;2,0;;1,0;;;7,0;;;;;4,0;;;;;;;;;1,0;;;;;1,0;;7,0;;;;223,0;1,0;;;;10,0;1,0;1,0;26,0;;;5,0;4,0;1,0;;2,0;;;;;1,0;;;4,0;;;;;;;;2,0;;;1,0;;;;;;1,0;;;;;2,0;17,0;;;;;;17,0;;;1,0;;1,0;;;;;;;2,0;;;1,0;;;;;;;16,0;;54,0;;;;
prevent;2,0;;2,0;;6,0;;8,0;17,0;1,0;12,0;2,0;2,0;;;4,0;;;;;;13,0;18,0;;2,0;1,0;;;14,0;1,0;9,0;1,0;5,0;36,0;;3,0;;2,0;23,0;;2,0;2,0;1,0;7,0;11,0;;;1,0;;2,0;1,0;7,0;12,0;;3,0;1,0;70,0;5,0;;;86,0;1,0;;17,0;;;15,0;33,0;;2,0;15,0;10,0;5,0;2,0;;1,0;;;;17,0;4,0;;1,0;1,0;2,0;;9,0;7,0;;;4,0;17,0;3,0;;4,0;;6,0;;;1,0;7,0;31,0;5,0;;13,0;;;;25,0;10,0;;1,0;7,0;2,0;13,0;5,0;4,0;12,0;;6,0;24,0;;1,0;;4,0;1,0;;42,0;14,0;;3,0;22,0;;;10,0;1,0;;2,0;;;3,0;1,0;;9,0;5,0;5,0;5,0;10,0;17,0;;6,0;;3,0;13,0;3,0;2,0;15,0;1,0;9,0;1,0;8,0;4,0;2,0;5,0;8,0;;2,0;;62,0;;1,0;78,0;2,0;12,0;12,0;20,0;5,0;4,0;3,0;2,0;;4,0;;15,0;;4,0;;28,0;7,0;;29,0;2,0;8,0;;3,0;;18,0;;;41,0;3,0;;2,0;6,0;3,0;;;;2,0;11,0;11,0;;;;;17,0;4,0;;1,0;;;7,0;1,0;;5,0;6,0;2,0;2,0;;;7,0;1,0;;5,0;3,0;;2,0;;;3,0;;14,0;4,0;;;5,0;6,0;;2,0;;;;1,0;4,0;7,0;1,0;;4,0;;;;;4,0;;3,0;4,0;;5,0;;2,0;3,0;5,0;6,0;3,0;;5,0;;;;10,0;;9,0;1,0;;18,0;;9,0;8,0;7,0;8,0;;;1,0;;7,0;;2,0;;3,0;;;;;5,0;;2,0;;1,0;5,0;1,0;8,0;2,0;;7,0;;9,0;;5,0;;3,0;4,0;;;4,0;7,0;;2,0;;7,0;;;14,0;;;;;;1,0;;;;;1,0;;;13,0;1,0;;;;;5,0;;;1,0;;1,0;;1,0;;;;;1,0;4,0;;;;;;;;1,0;;2,0;1,0;;;2,0;;;1,0;3,0;;;1,0;;1,0;1,0;;3,0;2,0;;17,0;3,0;2,0;4,0;;2,0;;;;;1,0;1,0;;;;4,0;;2,0;;3,0;;;;;;;;;1,0;;;;11,0;;;;;;;;;;;;;;;3,0;;;;1,0;;3,0;;;;;;1,0;5,0;2,0;;1,0;;;;;;;;;1,0;1,0;3,0;2,0;;;;3,0;;;;;;;1,0;1,0;;;;;;14,0;;2,0;;1,0;1,0;7,0;;;4,0;3,0;;;;;;;;;7,0;;;3,0;;1,0;5,0;;;;2,0;3,0;;1,0;;;1,0;;;1,0;;1,0;1,0;1,0;;13,0;;;3,0;;2,0;;1,0;1,0;1,0;;;;;1,0;4,0;;1,0;;;;;;;1,0;;;1,0;6,0;;1,0;1,0;;;;;;18,0;;;;;;;;3,0;;;;;;;;4,0;1,0;;3,0;;;;;;2,0;;;;2,0;;4,0;;;;2,0;4,0;;;;;;;;1,0;;;;;;3,0;;;1,0;;;;5,0;;1,0;;;;7,0;;7,0;;1,0;;1,0;16,0;1,0;6,0;;2,0;1,0;1,0;;1,0;14,0;;1,0;;;;12,0;;4,0;;1,0;;7,0;;;;1,0;;;5,0;;4,0;;;;;;1,0;1,0;;1,0;;6,0;4,0;;;;;1,0;;;;;2,0;;1,0;6,0;2,0;;;;;2,0;;;;;1,0;;;;1,0;;;1,0;;;;;;;;;;10,0;1,0;;;;;3,0;;;13,0;;3,0;;;;;;;;2,0;;;;;3,0;;;;;;;1,0;1,0;;1,0;;;;;;;;;;1,0;;;;;;;;;;;;2,0;1,0;;6,0;;;2,0;;;;;;;;;;;;2,0;;;;1,0;;3,0;;;;;;;;;2,0;;;;;3,0;;;;;2,0;2,0;;;;;;;;;;;;3,0;;2,0;6,0;;;;;;;;3,0;;;1,0;;;;1,0;1,0;;;;;;3,0;1,0;5,0;;1,0;;;3,0;;;2,0;;;;;;1,0;;;;;;;;;;1,0;;;;;;;;;;;;;;;;;;;;1,0;;1,0;;;;;;;;;1,0;;;;;5,0;;;;;;;;;;;;;2,0;;;;;;;;2,0;;;;;;;;;;4,0;;;4,0;;;;;;;;;;;;;;;1,0;;;;;;;;;;;12,0;;;;;;;;;;;1,0;;;;;;;;;;
processing;3,0;2,0;57,0;30,0;626,0;;27,0;179,0;62,0;158,0;26,0;18,0;;12,0;226,0;18,0;3,0;19,0;104,0;111,0;84,0;367,0;8,0;98,0;139,0;1,0;;1005,0;11,0;139,0;150,0;179,0;1019,0;22,0;283,0;27,0;15,0;46,0;1,0;247,0;19,0;26,0;20,0;94,0;11,0;17,0;3,0;14,0;43,0;38,0;78,0;190,0;11,0;43,0;2,0;5081,0;420,0;63,0;13,0;66,0;1,0;20,0;705,0;9,0;6,0;4,0;80,0;;;124,0;70,0;30,0;22,0;;2,0;26,0;;35,0;76,0;56,0;1,0;;171,0;57,0;5,0;2,0;95,0;3,0;20,0;148,0;174,0;15,0;30,0;1599,0;26,0;22,0;2,0;76,0;118,0;45,0;39,0;522,0;;34,0;13,0;4,0;10,0;1387,0;2,0;;51,0;22,0;52,0;31,0;23,0;20,0;;2,0;4,0;35,0;;;20,0;441,0;;9,0;319,0;6,0;6,0;92,0;10,0;12,0;5,0;1,0;2,0;12,0;11,0;;6,0;4,0;6,0;;10,0;164,0;132,0;;53,0;204,0;19,0;1,0;4,0;;3,0;10,0;5,0;3,0;;33,0;28,0;220,0;6,0;23,0;;1,0;;9,0;29,0;44,0;7,0;2,0;4,0;21,0;221,0;15,0;25,0;7,0;2,0;337,0;3,0;;;6,0;22,0;6,0;;22,0;5,0;238,0;;85,0;;3,0;12,0;206,0;;3,0;;;25,0;7,0;18,0;14,0;18,0;21,0;;3,0;43,0;3,0;39,0;5,0;4,0;19,0;18,0;14,0;5,0;118,0;48,0;1,0;;1,0;10,0;30,0;18,0;5,0;;6,0;9,0;;;2,0;;1,0;;9,0;27,0;26,0;;102,0;172,0;11,0;;;67,0;1,0;5,0;18,0;5,0;91,0;;1,0;28,0;411,0;6,0;129,0;3,0;5,0;;21,0;18,0;1,0;25,0;19,0;28,0;;10,0;;3,0;;;4,0;3,0;10,0;2,0;1,0;5,0;39,0;4,0;;7,0;20,0;;;;19,0;1,0;40,0;8,0;114,0;47,0;3,0;7,0;;14,0;32,0;;4,0;1,0;56,0;1,0;;8,0;3,0;198,0;7,0;4,0;;;27,0;1,0;3,0;54,0;13,0;1,0;;1,0;;;;;;;60,0;3,0;2,0;2,0;57,0;;;23,0;;64,0;2,0;6,0;;;;2,0;19,0;8,0;14,0;2,0;42,0;2,0;18,0;20,0;18,0;56,0;90,0;9,0;52,0;5,0;10,0;11,0;11,0;6,0;7,0;13,0;;;4,0;19,0;15,0;;16,0;45,0;43,0;5,0;8,0;43,0;12,0;9,0;1,0;3,0;19,0;77,0;71,0;13,0;72,0;;30,0;61,0;120,0;13,0;154,0;2,0;3,0;18,0;7,0;14,0;122,0;3,0;33,0;;;11,0;31,0;25,0;54,0;27,0;7,0;39,0;;15,0;2,0;21,0;10,0;6,0;51,0;;4,0;4,0;6,0;1,0;43,0;3,0;56,0;36,0;1,0;171,0;;65,0;49,0;5,0;20,0;152,0;4,0;20,0;69,0;20,0;53,0;41,0;23,0;6,0;7,0;13,0;;21,0;5,0;46,0;;8,0;16,0;8,0;151,0;6,0;30,0;137,0;43,0;10,0;5,0;8,0;317,0;43,0;33,0;;23,0;10,0;8,0;62,0;;6,0;8,0;11,0;6,0;10,0;41,0;;5,0;62,0;;;806,0;1,0;;13,0;2,0;31,0;1,0;22,0;34,0;9,0;7,0;10,0;8,0;;7,0;20,0;37,0;1,0;58,0;14,0;49,0;11,0;12,0;245,0;76,0;3,0;3,0;4,0;10,0;15,0;3,0;59,0;18,0;5,0;4,0;9,0;;1,0;;2,0;;1,0;84,0;84,0;8,0;3,0;6,0;4,0;1,0;6,0;1,0;12,0;66,0;10,0;3,0;17,0;1,0;8,0;5,0;9,0;12,0;;2,0;35,0;13,0;;3,0;15,0;;1,0;13,0;5,0;;;3,0;1,0;8,0;10,0;14,0;4,0;5,0;;28,0;34,0;;62,0;17,0;2,0;73,0;278,0;2,0;9,0;5,0;;6,0;9,0;2,0;2,0;3,0;;20,0;15,0;5,0;;;1,0;14,0;2,0;12,0;;15,0;124,0;12,0;5,0;51,0;;3,0;19,0;13,0;27,0;;;5,0;6,0;7,0;;;5,0;;12,0;;43,0;3,0;2,0;3,0;4,0;17,0;;1,0;;8,0;1,0;;1,0;1,0;16,0;;3,0;15,0;;3,0;1,0;12,0;;;2,0;;11,0;2,0;2,0;8,0;4,0;17,0;1,0;;1,0;;21,0;;;24,0;;;;5,0;5,0;3,0;6,0;7,0;46,0;9,0;7,0;;;2,0;;1,0;2,0;2,0;9,0;;;1,0;;11,0;24,0;;;4,0;;;4,0;;15,0;4,0;;6,0;;2,0;1,0;;12,0;19,0;7,0;;;14,0;4,0;;;9,0;;3,0;25,0;;4,0;15,0;35,0;8,0;10,0;6,0;;11,0;6,0;5,0;5,0;4,0;3,0;293,0;9,0;3,0;3,0;7,0;2,0;14,0;4,0;6,0;5,0;;6,0;2,0;;9,0;;1,0;9,0;3,0;;1,0;1,0;10,0;22,0;19,0;4,0;6,0;7,0;;33,0;;5,0;;10,0;1,0;3,0;42,0;;14,0;1,0;;2,0;4,0;1,0;11,0;1,0;16,0;14,0;5,0;2,0;28,0;4,0;32,0;5,0;7,0;14,0;;1,0;10,0;10,0;8,0;6,0;3,0;2,0;;1,0;31,0;30,0;3,0;6,0;1,0;1,0;2,0;1,0;10,0;1,0;;22,0;19,0;;6,0;1,0;;1,0;5,0;16,0;1,0;10,0;;1,0;2,0;1,0;5,0;6,0;4,0;9,0;6,0;2,0;10,0;13,0;36,0;;2,0;3,0;37,0;;1,0;;33,0;6,0;;1,0;4,0;19,0;3,0;3,0;;;;8,0;;3,0;13,0;16,0;2,0;;;;;4,0;4,0;;17,0;;2,0;7,0;;;1,0;;;;1,0;3,0;;5,0;;8,0;;;;3,0;4,0;;2,0;;15,0;32,0;;2,0;;1,0;21,0;17,0;;2,0;3,0;58,0;;1,0;;;;1,0;;2,0;1,0;;;5,0;;;1,0;5,0;8,0;9,0;17,0;21,0;;4,0;4,0;51,0;;;;;;;29,0;6,0;18,0;2,0;;;8,0;;11,0;;8,0;;;9,0;9,0;;;;3,0;35,0;7,0;1,0;;15,0;;3,0;;5,0;7,0;12,0;;;2,0;;;10,0;10,0;4,0;2,0;2,0;5,0;;;;1,0;1,0;;2,0;3,0;;;;;;4,0;;;;;;1,0;1,0;;;1,0;2,0;2,0;;;3,0;2,0;16,0;;2,0;7,0;;3,0;5,0;;11,0;;1,0;;15,0;;;1,0;;;;;;
processor;2,0;;4,0;10,0;160,0;;5,0;63,0;39,0;134,0;;22,0;;3,0;43,0;4,0;9,0;21,0;27,0;120,0;18,0;238,0;18,0;27,0;21,0;;;317,0;6,0;73,0;21,0;189,0;342,0;21,0;321,0;7,0;15,0;26,0;12,0;145,0;21,0;33,0;6,0;14,0;3,0;;;6,0;13,0;15,0;15,0;178,0;1,0;10,0;2,0;1438,0;229,0;2,0;5,0;47,0;;3,0;136,0;2,0;10,0;4,0;24,0;;4,0;124,0;29,0;3,0;19,0;;;1,0;;39,0;89,0;46,0;1,0;171,0;;18,0;1,0;;34,0;1,0;3,0;59,0;145,0;4,0;4,0;479,0;19,0;22,0;3,0;41,0;115,0;7,0;14,0;332,0;;21,0;21,0;4,0;17,0;133,0;;;62,0;62,0;65,0;15,0;4,0;4,0;;;6,0;15,0;;;3,0;23,0;1,0;3,0;516,0;;1,0;178,0;8,0;33,0;;;2,0;43,0;7,0;;12,0;3,0;6,0;8,0;7,0;15,0;21,0;;31,0;63,0;5,0;;2,0;;;6,0;1,0;12,0;;35,0;10,0;74,0;1,0;13,0;2,0;;2,0;2,0;6,0;48,0;6,0;2,0;9,0;9,0;80,0;21,0;17,0;3,0;;84,0;;;2,0;;2,0;;1,0;11,0;2,0;155,0;3,0;41,0;;;20,0;189,0;1,0;3,0;;;7,0;5,0;11,0;12,0;;7,0;;8,0;5,0;1,0;15,0;5,0;24,0;15,0;11,0;3,0;7,0;42,0;33,0;1,0;1,0;;5,0;35,0;;10,0;1,0;6,0;18,0;2,0;1,0;;;;19,0;4,0;18,0;16,0;;19,0;22,0;4,0;4,0;1,0;2,0;4,0;7,0;4,0;154,0;5,0;;2,0;23,0;9,0;7,0;95,0;3,0;7,0;1,0;12,0;;;8,0;6,0;17,0;;;;12,0;;;;1,0;2,0;2,0;1,0;2,0;76,0;5,0;;1,0;10,0;;;2,0;24,0;;21,0;9,0;75,0;29,0;2,0;2,0;;;15,0;;1,0;;56,0;3,0;;18,0;;30,0;2,0;2,0;2,0;;28,0;;1,0;22,0;18,0;;;1,0;;;;;5,0;;20,0;4,0;2,0;;21,0;;;20,0;1,0;47,0;2,0;3,0;1,0;2,0;5,0;;16,0;;4,0;;44,0;8,0;7,0;24,0;20,0;;38,0;1,0;31,0;3,0;10,0;36,0;;3,0;;4,0;;;;19,0;8,0;4,0;1,0;59,0;11,0;1,0;4,0;16,0;13,0;8,0;6,0;5,0;7,0;47,0;192,0;9,0;8,0;;26,0;18,0;1,0;6,0;169,0;7,0;8,0;5,0;2,0;51,0;48,0;2,0;15,0;;7,0;12,0;11,0;6,0;30,0;11,0;;32,0;4,0;7,0;;27,0;7,0;30,0;19,0;8,0;8,0;3,0;2,0;;12,0;10,0;6,0;12,0;1,0;98,0;6,0;22,0;9,0;4,0;31,0;65,0;13,0;;11,0;4,0;20,0;35,0;1,0;2,0;2,0;3,0;7,0;16,0;1,0;7,0;8,0;6,0;;6,0;18,0;10,0;33,0;4,0;37,0;8,0;5,0;2,0;242,0;27,0;26,0;;16,0;6,0;9,0;237,0;3,0;2,0;4,0;;5,0;9,0;13,0;;4,0;67,0;;;219,0;;5,0;7,0;10,0;22,0;3,0;6,0;9,0;4,0;4,0;2,0;21,0;3,0;6,0;7,0;7,0;3,0;47,0;5,0;42,0;12,0;7,0;143,0;44,0;;2,0;1,0;2,0;8,0;1,0;5,0;19,0;15,0;;;;2,0;2,0;;10,0;1,0;77,0;91,0;9,0;;2,0;2,0;;1,0;4,0;3,0;2,0;;;38,0;4,0;8,0;;7,0;11,0;2,0;2,0;8,0;2,0;;2,0;7,0;;;11,0;10,0;1,0;;1,0;4,0;2,0;;15,0;10,0;16,0;1,0;2,0;25,0;;53,0;3,0;;14,0;76,0;1,0;15,0;1,0;;1,0;9,0;;;12,0;;14,0;;;;1,0;;21,0;;4,0;14,0;7,0;18,0;4,0;3,0;14,0;;;5,0;8,0;6,0;;;4,0;8,0;5,0;1,0;;2,0;;;2,0;39,0;;2,0;4,0;;18,0;;1,0;;;2,0;;16,0;;7,0;;4,0;3,0;1,0;;;11,0;;1,0;;;8,0;4,0;4,0;4,0;;9,0;4,0;2,0;2,0;;58,0;4,0;;4,0;5,0;;;4,0;2,0;2,0;4,0;1,0;18,0;5,0;10,0;;;;;;5,0;1,0;13,0;;1,0;;;9,0;1,0;;;7,0;;;1,0;;4,0;8,0;;3,0;;;1,0;;6,0;4,0;41,0;;;4,0;7,0;4,0;;9,0;5,0;;5,0;;1,0;3,0;16,0;12,0;2,0;1,0;2,0;;1,0;;;4,0;1,0;138,0;;1,0;;18,0;;5,0;;14,0;;;1,0;2,0;;14,0;1,0;1,0;9,0;;;5,0;;;15,0;3,0;;4,0;1,0;1,0;12,0;;10,0;1,0;8,0;;10,0;3,0;2,0;33,0;1,0;2,0;2,0;2,0;;10,0;2,0;9,0;14,0;5,0;5,0;7,0;5,0;1,0;6,0;2,0;1,0;;;2,0;4,0;1,0;8,0;;1,0;;4,0;7,0;21,0;1,0;;16,0;1,0;;;2,0;8,0;2,0;3,0;1,0;;;2,0;1,0;2,0;13,0;18,0;8,0;19,0;1,0;4,0;3,0;6,0;;;3,0;4,0;8,0;;5,0;9,0;;2,0;10,0;;15,0;;6,0;;;2,0;;1,0;1,0;4,0;1,0;;5,0;;;6,0;3,0;1,0;9,0;5,0;;;;7,0;;11,0;;;1,0;1,0;10,0;4,0;1,0;;1,0;5,0;;2,0;8,0;4,0;2,0;3,0;1,0;8,0;1,0;1,0;1,0;;1,0;1,0;1,0;;3,0;2,0;;6,0;;3,0;4,0;3,0;;;14,0;17,0;4,0;;;2,0;;2,0;;;;;1,0;4,0;6,0;;;2,0;;6,0;;11,0;1,0;;;1,0;;;;;;;32,0;;2,0;5,0;2,0;;2,0;;7,0;;1,0;;;13,0;12,0;;4,0;2,0;12,0;1,0;;6,0;;;3,0;1,0;4,0;1,0;52,0;;;;;;;2,0;4,0;;1,0;;1,0;;;;;;;;6,0;2,0;;;5,0;2,0;;;6,0;;;5,0;3,0;1,0;;2,0;;;2,0;;;;2,0;3,0;;;1,0;4,0;;4,0;;33,0;1,0;;;9,0;;1,0;;1,0;;;;;
produce;1,0;;2,0;1,0;14,0;;8,0;21,0;2,0;62,0;1,0;1,0;;6,0;60,0;5,0;;;70,0;11,0;16,0;15,0;4,0;23,0;12,0;2,0;;179,0;7,0;20,0;13,0;31,0;76,0;23,0;73,0;11,0;9,0;11,0;;31,0;27,0;1,0;7,0;18,0;1,0;;2,0;3,0;4,0;12,0;6,0;10,0;;1,0;1,0;881,0;43,0;6,0;7,0;42,0;;;95,0;1,0;1,0;6,0;6,0;3,0;;6,0;21,0;5,0;4,0;;;;;8,0;43,0;6,0;2,0;57,0;18,0;;;;16,0;;3,0;21,0;89,0;4,0;3,0;157,0;6,0;12,0;;9,0;15,0;7,0;16,0;45,0;;4,0;;3,0;;66,0;3,0;;14,0;3,0;25,0;11,0;3,0;15,0;;7,0;3,0;4,0;;;;11,0;;;34,0;;;2,0;3,0;;1,0;;1,0;10,0;2,0;;2,0;4,0;22,0;;1,0;3,0;12,0;30,0;10,0;41,0;3,0;;3,0;1,0;1,0;2,0;;;;9,0;7,0;93,0;4,0;4,0;;;2,0;4,0;18,0;110,0;;;9,0;6,0;18,0;4,0;8,0;2,0;;129,0;;;;2,0;5,0;;;12,0;4,0;49,0;;43,0;;;13,0;33,0;10,0;15,0;;;2,0;;1,0;;;4,0;;5,0;8,0;1,0;2,0;4,0;3,0;4,0;7,0;2,0;3,0;19,0;2,0;1,0;;;2,0;4,0;11,0;8,0;1,0;12,0;2,0;;1,0;;;;5,0;;;5,0;;4,0;25,0;;3,0;1,0;;;;1,0;2,0;3,0;;17,0;;14,0;;4,0;;;;3,0;14,0;;4,0;47,0;;;;;1,0;;;;;2,0;1,0;;2,0;5,0;;;1,0;1,0;;2,0;9,0;1,0;;10,0;;39,0;3,0;1,0;7,0;;;12,0;;;5,0;4,0;;;1,0;;5,0;2,0;1,0;;;11,0;;;10,0;23,0;;;;;1,0;2,0;;;;5,0;;;;33,0;;2,0;;;10,0;1,0;;;;1,0;;2,0;2,0;1,0;;4,0;;22,0;21,0;;;8,0;5,0;4,0;3,0;9,0;7,0;1,0;2,0;1,0;;;1,0;;1,0;1,0;;1,0;6,0;4,0;;15,0;2,0;15,0;;;;1,0;4,0;13,0;7,0;;;4,0;2,0;7,0;;7,0;2,0;1,0;1,0;;;26,0;;7,0;;1,0;4,0;4,0;7,0;27,0;;;9,0;;2,0;5,0;;;1,0;15,0;1,0;3,0;3,0;;1,0;9,0;;7,0;;;21,0;26,0;23,0;2,0;;4,0;4,0;;1,0;;8,0;37,0;1,0;4,0;1,0;;;1,0;1,0;;;1,0;2,0;1,0;;1,0;2,0;10,0;12,0;11,0;;;2,0;3,0;19,0;58,0;;3,0;;;16,0;;;;9,0;;1,0;2,0;9,0;2,0;7,0;3,0;;8,0;1,0;;;4,0;35,0;;1,0;4,0;2,0;1,0;;2,0;;1,0;4,0;;;2,0;5,0;2,0;2,0;2,0;55,0;31,0;2,0;2,0;;3,0;;2,0;1,0;9,0;16,0;;;;1,0;;;1,0;;6,0;1,0;4,0;1,0;;;;;;;13,0;;1,0;8,0;;5,0;;;2,0;;5,0;20,0;6,0;;;1,0;3,0;;;;;;;;1,0;;3,0;;;1,0;31,0;2,0;;9,0;1,0;;17,0;53,0;;6,0;;;;2,0;;;;;;;;;;;2,0;2,0;;;5,0;21,0;4,0;1,0;3,0;;3,0;1,0;1,0;;;;2,0;;;;;;;1,0;1,0;5,0;1,0;;;1,0;;;;;;;;3,0;1,0;2,0;;1,0;8,0;1,0;;;2,0;;;;;3,0;;;;;7,0;;;50,0;;;;;1,0;;;;3,0;;;16,0;;;2,0;;;;1,0;;;2,0;1,0;2,0;;;1,0;;4,0;20,0;1,0;;;;;;;1,0;2,0;;2,0;;;;3,0;11,0;15,0;2,0;;;;;;;8,0;;;6,0;;;4,0;13,0;3,0;3,0;2,0;;1,0;4,0;2,0;;;3,0;58,0;;1,0;;12,0;2,0;5,0;1,0;1,0;2,0;;1,0;2,0;1,0;1,0;;;3,0;20,0;5,0;;;1,0;2,0;;;4,0;1,0;;;;;;;;;;;;5,0;;;;1,0;1,0;;2,0;;;;4,0;;7,0;2,0;;10,0;;;2,0;7,0;13,0;4,0;5,0;;2,0;;1,0;4,0;;;;;5,0;;1,0;;;;5,0;;;;;;2,0;;;;;;;;;;;;2,0;;9,0;11,0;;;;;8,0;;;3,0;;;2,0;;1,0;;;6,0;;;4,0;;7,0;1,0;;14,0;1,0;;;;;;;;;;;2,0;;;;;;;;1,0;1,0;;;;1,0;;;5,0;7,0;;;1,0;;;;;;;;;;;;6,0;;2,0;;;2,0;;;;;;;;;;;;4,0;2,0;;6,0;;;;4,0;;;;;;;;1,0;;2,0;;;4,0;;5,0;;16,0;;;7,0;2,0;;1,0;;8,0;;6,0;9,0;;;1,0;;;;;4,0;1,0;;2,0;;;;4,0;1,0;1,0;8,0;5,0;;;;;;1,0;;;;;;9,0;3,0;;;2,0;;;;1,0;;;5,0;3,0;1,0;;2,0;;;2,0;;;;2,0;;;6,0;;;;;;1,0;;4,0;;2,0;;;;;
property;4,0;;7,0;;9,0;;;46,0;29,0;6,0;;31,0;;;22,0;;;;;1,0;3,0;17,0;;;1,0;1,0;2,0;36,0;;1,0;;29,0;10,0;1,0;1,0;;;;;18,0;2,0;;;17,0;;;;3,0;;;;9,0;;3,0;;53,0;11,0;;4,0;47,0;7,0;;41,0;;;;;;;9,0;119,0;8,0;20,0;;;;;;2,0;;;5,0;1,0;;;;;2,0;;5,0;4,0;;7,0;7,0;;;6,0;2,0;3,0;2,0;7,0;11,0;;;1,0;;1,0;71,0;;;3,0;3,0;;3,0;;;;;;;;;8,0;;1,0;;6,0;;;;2,0;;;;;6,0;1,0;;;3,0;;;;11,0;;;2,0;;;1,0;;;1,0;2,0;;;6,0;;1,0;3,0;;;;;1,0;12,0;;31,0;;7,0;;;2,0;;;1,0;;1,0;;;;;;;;;3,0;20,0;21,0;6,0;;;1,0;1,0;;;;;;;;4,0;1,0;;;4,0;;;;;;;3,0;;;10,0;3,0;6,0;;;;;;2,0;;;;;;;;;;;2,0;;;12,0;;;;;;;;;;;;;;;;;;;;4,0;9,0;;1,0;;1,0;2,0;;;;;;;;2,0;;;;;;;;;;;;;;;;82,0;;;;;;;;;;8,0;;;;;9,0;;;;;3,0;;;;7,0;;;;;;;;;;;;;;1,0;;;;;5,0;;;;;;;;;;2,0;;;1,0;;;7,0;;;8,0;;;;;;;;;;;6,0;1,0;;;32,0;5,0;;1,0;;;;;;3,0;1,0;2,0;;1,0;;;;;;8,0;;;;4,0;;5,0;;;;;;;;14,0;3,0;;5,0;;1,0;;6,0;;;2,0;1,0;;;;;;;;;;;;1,0;;;;2,0;;;;1,0;;2,0;;1,0;;;;;;;;;8,0;;;;1,0;18,0;2,0;7,0;;;1,0;;2,0;;;4,0;4,0;8,0;;;;;;;3,0;;;12,0;;;3,0;;;;1,0;;;1,0;14,0;;;;;;;3,0;2,0;;8,0;;;3,0;;6,0;;;;;1,0;;;;9,0;1,0;;;;;;;1,0;;;;;;;;;;;8,0;;;;;;1,0;;;;;;;;;;;;;;;;;;;;;;3,0;;;;;;;;;2,0;45,0;;;;;;;;3,0;;;;;;;;;;;;;;4,0;;;;;;;;;;;5,0;;2,0;;;;;;;2,0;;;;;;;;;11,0;;;;;;;;6,0;;;1,0;2,0;;;;;7,0;;;;1,0;;1,0;;;;;;;;;;;;;2,0;;;;6,0;;;;;;;;;;;;;;;;;;;;;;;;;;2,0;;;;;1,0;2,0;;;;;;;;;1,0;6,0;;;;1,0;1,0;;;;;;;;;;;1,0;;;1,0;;;1,0;;;;;;3,0;;1,0;;;1,0;;;;;;;;;;;;;;1,0;;;;6,0;;;;3,0;;;;;;;2,0;10,0;;;;;;;;;1,0;;;;;2,0;2,0;1,0;;1,0;;;;;;;;;3,0;;;18,0;1,0;;;;;;;;;;;;;;;;;;;;;;;;;;1,0;;;1,0;;;;;;;3,0;;;;;;;;;;;;;1,0;;;;;;;;;2,0;;;;;;;4,0;;9,0;;4,0;;;;;;;;;;;;;;1,0;;;;;;;;;;;;;;;2,0;;;;;;;;;;;2,0;;;;;;;;;;;;;;;;;;;;;;;;;1,0;;;;;;7,0;;;;;;;;;;;;;;;;;;;;;;;;;1,0;;;;;;;;;;;;;;;;;;;;;;;;;;;;;;;;;;;;;;;;;2,0;;;;;;
reflection;2,0;;8,0;;9,0;;36,0;;;10,0;1,0;;;;2,0;;;;;;;4,0;;;;;;;1,0;10,0;;2,0;16,0;1,0;5,0;1,0;2,0;43,0;;1,0;3,0;;4,0;10,0;;;;;;1,0;4,0;4,0;;;;34,0;16,0;;;46,0;;;10,0;;;;2,0;;;1,0;145,0;1,0;17,0;;2,0;;;;21,0;;9,0;2,0;;;;;10,0;4,0;;;8,0;;1,0;11,0;;;;;;2,0;159,0;17,0;;;;;1,0;4,0;25,0;7,0;;48,0;;3,0;;;;;;3,0;;;;;9,0;;4,0;;;;3,0;;;;1,0;4,0;7,0;2,0;5,0;6,0;;;2,0;5,0;3,0;;18,0;8,0;;3,0;;;2,0;;11,0;3,0;;4,0;;8,0;16,0;;;2,0;;4,0;;88,0;;2,0;63,0;75,0;5,0;4,0;1,0;3,0;3,0;;;;4,0;2,0;8,0;;1,0;8,0;6,0;8,0;1,0;8,0;;1,0;3,0;7,0;;100,0;3,0;;;;;3,0;;18,0;;;;;3,0;;5,0;1,0;;8,0;1,0;4,0;9,0;6,0;;2,0;2,0;;;9,0;;7,0;6,0;;2,0;;;;;;;4,0;;2,0;;;14,0;;1,0;1,0;;7,0;;;3,0;;;;;;;;;2,0;;;;4,0;;;;;1,0;;;2,0;;1,0;;;;1,0;1,0;;;2,0;;;;15,0;;;;3,0;;6,0;;;;3,0;;18,0;1,0;2,0;;;;;3,0;;;;;1,0;;;2,0;7,0;11,0;;;;3,0;;;;;;;;;3,0;;;;;5,0;;;;;;;;;;;;;1,0;;;;;1,0;1,0;;;;;;1,0;;;;;;;;;;2,0;;;1,0;;;;;2,0;;;;;;2,0;;2,0;;;1,0;;;;;2,0;;;;;;;3,0;2,0;;11,0;;;;;;;;;4,0;;;2,0;;;;;1,0;;;1,0;1,0;;;;;;;;1,0;2,0;;;;;;;;;;;;;;;;1,0;;;;;;;2,0;;;;;;;;;;;;;;15,0;;;;;;;;;;;1,0;;;;;;;;;6,0;;;;;3,0;;7,0;4,0;;;;;;;;;;2,0;;;;2,0;;;;;;1,0;;;;;;;;;;;;;;;2,0;;;1,0;;;;1,0;;;;;;;;1,0;;;;;;;;;;1,0;;;;;;;;;;;;3,0;;;;;;;;;;;;;;;;6,0;;;2,0;;;;;;;;;;5,0;;;1,0;;;;;3,0;;;;;;;;;;;;;;;;;;;;;;;;;;;;;;;;;16,0;;;;;;;;;;;1,0;;;;78,0;;;;;;;;;2,0;;;;3,0;4,0;;;;;;;;7,0;2,0;;;;2,0;;;2,0;;;;;2,0;;;;;2,0;;;;;7,0;2,0;;;;;;6,0;;;;;;;;;;;;;3,0;;;2,0;;;;;;;;;;;;;;;;;;;;;1,0;;;14,0;;;;4,0;;;2,0;;;;;;;;;;;;;1,0;;;;;;;;;;4,0;;;;;;;;;;;;;;;;;;;;;;;;;;;;;;;;;8,0;;;;;;;2,0;;;1,0;;;;;;;;;5,0;;;11,0;;1,0;;;;;;1,0;;1,0;;;;;;;;;;;;;;;;;;;;;;;;;;11,0;;;;;;;;;;1,0;;;;;;;;;1,0;2,0;;;;;;;;;;;;;;;8,0;;;;;;;;;;;1,0;1,0;;;;;;;;10,0;;;1,0;;;;;;;;;;;;;;;;;1,0;;;;;;;;;;;;;;3,0;;;;;;5,0;;;;;;;;;;;;;;;;;;;;;;;;;;;;;;;;2,0;;;;10,0;;;;
region;2,0;;51,0;12,0;78,0;;19,0;131,0;83,0;136,0;105,0;2,0;6,0;5,0;157,0;7,0;3,0;5,0;69,0;20,0;10,0;53,0;89,0;128,0;35,0;7,0;9,0;135,0;14,0;205,0;319,0;165,0;368,0;84,0;111,0;;10,0;164,0;24,0;549,0;86,0;9,0;16,0;174,0;2,0;5,0;3,0;137,0;134,0;57,0;36,0;58,0;1,0;47,0;19,0;1455,0;324,0;3,0;37,0;86,0;27,0;;262,0;;15,0;2,0;119,0;3,0;12,0;21,0;149,0;10,0;15,0;71,0;20,0;44,0;;197,0;232,0;10,0;7,0;95,0;34,0;16,0;;10,0;;11,0;18,0;181,0;101,0;47,0;2,0;153,0;72,0;64,0;1,0;33,0;67,0;97,0;237,0;119,0;1,0;137,0;6,0;2,0;272,0;298,0;;;9,0;132,0;21,0;19,0;5,0;1,0;23,0;7,0;7,0;22,0;5,0;;9,0;35,0;2,0;6,0;92,0;44,0;10,0;7,0;35,0;15,0;6,0;2,0;;24,0;113,0;;102,0;13,0;4,0;3,0;30,0;136,0;91,0;;286,0;249,0;9,0;2,0;13,0;11,0;8,0;8,0;35,0;;6,0;25,0;26,0;420,0;35,0;24,0;3,0;62,0;7,0;131,0;43,0;266,0;;27,0;35,0;19,0;63,0;13,0;95,0;25,0;26,0;35,0;1,0;28,0;7,0;20,0;11,0;6,0;;39,0;21,0;393,0;5,0;277,0;1,0;1,0;27,0;131,0;51,0;54,0;12,0;;16,0;11,0;419,0;44,0;5,0;141,0;;52,0;17,0;15,0;35,0;35,0;71,0;1,0;3,0;;11,0;48,0;17,0;29,0;2,0;4,0;51,0;46,0;2,0;8,0;19,0;36,0;96,0;;2,0;2,0;2,0;;;87,0;40,0;44,0;16,0;42,0;72,0;7,0;20,0;2,0;20,0;18,0;2,0;3,0;18,0;46,0;39,0;;15,0;32,0;21,0;35,0;24,0;2,0;16,0;136,0;6,0;6,0;92,0;21,0;37,0;;8,0;6,0;36,0;;1,0;6,0;19,0;7,0;2,0;2,0;5,0;51,0;17,0;;32,0;141,0;2,0;;;4,0;26,0;66,0;34,0;251,0;17,0;24,0;;1,0;51,0;28,0;;5,0;127,0;38,0;19,0;;;1,0;197,0;23,0;4,0;5,0;1,0;48,0;16,0;2,0;206,0;68,0;8,0;;10,0;;;;;43,0;;40,0;2,0;;1,0;156,0;;;8,0;;69,0;1,0;;;;56,0;;4,0;2,0;2,0;2,0;81,0;;20,0;2,0;6,0;14,0;9,0;1,0;43,0;40,0;6,0;15,0;;;3,0;6,0;1,0;;2,0;11,0;9,0;3,0;19,0;55,0;25,0;1,0;5,0;10,0;298,0;3,0;4,0;;23,0;7,0;36,0;24,0;2,0;;15,0;8,0;58,0;5,0;5,0;46,0;;;28,0;3,0;11,0;1,0;7,0;6,0;;4,0;11,0;6,0;107,0;45,0;7,0;48,0;;7,0;4,0;20,0;2,0;6,0;31,0;18,0;7,0;17,0;11,0;78,0;9,0;;3,0;33,0;;87,0;1,0;66,0;1,0;;2,0;13,0;;1,0;31,0;21,0;47,0;4,0;4,0;;;1,0;;10,0;4,0;;20,0;1,0;20,0;;12,0;18,0;19,0;128,0;8,0;28,0;1,0;;4,0;112,0;16,0;;1,0;2,0;;23,0;;5,0;5,0;;8,0;;108,0;;8,0;37,0;;9,0;67,0;;;;;2,0;;3,0;11,0;6,0;6,0;;2,0;12,0;8,0;44,0;52,0;2,0;37,0;;29,0;5,0;6,0;129,0;200,0;7,0;12,0;24,0;;;8,0;1,0;17,0;42,0;4,0;5,0;8,0;6,0;3,0;;;23,0;30,0;2,0;21,0;;17,0;;19,0;;11,0;43,0;;;13,0;2,0;;;1,0;;2,0;4,0;11,0;;1,0;;2,0;;;;7,0;2,0;;25,0;;5,0;3,0;14,0;3,0;21,0;6,0;1,0;4,0;;7,0;7,0;10,0;;57,0;411,0;36,0;;;6,0;1,0;30,0;1,0;1,0;18,0;;5,0;1,0;;7,0;8,0;;1,0;2,0;1,0;;;133,0;4,0;1,0;63,0;2,0;1,0;5,0;12,0;1,0;6,0;;7,0;3,0;72,0;;;2,0;8,0;;;37,0;;2,0;;1,0;1,0;;;;2,0;6,0;;;;1,0;;;1,0;17,0;;35,0;39,0;8,0;;;;41,0;;;7,0;;25,0;4,0;;36,0;;;;;51,0;3,0;;3,0;3,0;54,0;2,0;13,0;;121,0;58,0;1,0;1,0;3,0;1,0;;;8,0;6,0;8,0;10,0;;4,0;;14,0;4,0;;;2,0;;2,0;;27,0;63,0;5,0;22,0;9,0;34,0;1,0;6,0;37,0;51,0;80,0;4,0;21,0;197,0;17,0;;142,0;;4,0;5,0;;2,0;124,0;92,0;66,0;8,0;5,0;3,0;2,0;;9,0;105,0;5,0;65,0;4,0;6,0;22,0;6,0;16,0;4,0;30,0;1,0;17,0;94,0;;12,0;;12,0;2,0;1,0;7,0;6,0;1,0;1,0;6,0;4,0;;11,0;;14,0;1,0;27,0;1,0;;;1,0;;10,0;6,0;1,0;59,0;;;6,0;24,0;;8,0;12,0;15,0;2,0;6,0;14,0;;2,0;12,0;26,0;13,0;1,0;34,0;4,0;3,0;7,0;8,0;;1,0;7,0;1,0;10,0;;9,0;;;9,0;55,0;2,0;;3,0;;1,0;;8,0;4,0;6,0;78,0;;;;;;;8,0;4,0;54,0;;22,0;37,0;2,0;1,0;;;;5,0;23,0;2,0;15,0;11,0;1,0;4,0;9,0;9,0;18,0;;1,0;1,0;1,0;13,0;;;1,0;26,0;;1,0;2,0;;;60,0;1,0;24,0;5,0;40,0;1,0;;3,0;4,0;;2,0;2,0;;;70,0;;;2,0;144,0;3,0;22,0;;2,0;6,0;17,0;3,0;28,0;1,0;6,0;;7,0;3,0;6,0;;12,0;24,0;3,0;;11,0;14,0;;;1,0;;24,0;;;1,0;25,0;;;3,0;27,0;;2,0;2,0;;18,0;1,0;6,0;12,0;;;;25,0;3,0;9,0;;8,0;1,0;2,0;;6,0;1,0;;1,0;;;;3,0;12,0;;10,0;;;3,0;;1,0;;4,0;;4,0;10,0;29,0;;;;2,0;;20,0;23,0;;;7,0;;3,0;4,0;;6,0;4,0;;3,0;;;;7,0;;24,0;;56,0;;2,0;40,0;;;;;26,0;3,0;81,0;29,0;1,0;16,0;1,0;;15,0;;;;26,0;;1,0;1,0;6,0;2,0;;;4,0;;1,0;5,0;;;20,0;;2,0;;2,0;;8,0;;;;;2,0;7,0;;2,0;;;;
relation;1,0;;9,0;;6,0;;12,0;21,0;1,0;11,0;9,0;6,0;;3,0;4,0;;;;14,0;;3,0;8,0;9,0;6,0;2,0;3,0;;22,0;;1,0;2,0;14,0;21,0;1,0;7,0;6,0;;21,0;7,0;8,0;23,0;1,0;;9,0;;6,0;1,0;23,0;2,0;;9,0;20,0;7,0;11,0;;63,0;7,0;;12,0;34,0;;;17,0;;3,0;;5,0;2,0;;10,0;10,0;;;2,0;;3,0;;12,0;47,0;20,0;;3,0;1,0;;2,0;4,0;11,0;;2,0;;10,0;3,0;3,0;3,0;9,0;5,0;;2,0;2,0;;18,0;10,0;;;;;;17,0;;;1,0;1,0;3,0;2,0;3,0;;1,0;;2,0;9,0;;;4,0;;;;5,0;1,0;;2,0;2,0;1,0;;;;4,0;15,0;;;;;1,0;;5,0;;3,0;7,0;4,0;2,0;;;;2,0;;;1,0;;14,0;;;;4,0;5,0;;5,0;;4,0;16,0;;;16,0;2,0;1,0;9,0;12,0;;2,0;5,0;;;1,0;;;;7,0;12,0;6,0;9,0;;8,0;;;1,0;4,0;;5,0;27,0;;7,0;3,0;;1,0;;27,0;;;;;4,0;5,0;;;1,0;;1,0;5,0;2,0;;1,0;;1,0;4,0;4,0;;;;4,0;;;2,0;;;4,0;2,0;6,0;12,0;;1,0;29,0;;1,0;;1,0;;;6,0;;;;2,0;;;;2,0;;;;6,0;;;2,0;2,0;;;2,0;;;;;;;2,0;;;;;;;6,0;7,0;1,0;;6,0;1,0;;1,0;5,0;27,0;1,0;3,0;;1,0;4,0;;;1,0;;;;;;;17,0;1,0;4,0;;;2,0;6,0;1,0;13,0;4,0;;;1,0;;10,0;;;6,0;;;4,0;4,0;1,0;;;;;;2,0;3,0;12,0;;;;;2,0;;5,0;;;;;;;;2,0;;7,0;3,0;;;5,0;;2,0;2,0;;;;6,0;3,0;;;9,0;4,0;;9,0;;;3,0;;3,0;1,0;;7,0;;;;4,0;;;;;;2,0;;2,0;;9,0;;2,0;;;;2,0;;20,0;;20,0;2,0;;;;;;;12,0;;;2,0;3,0;;;;;4,0;;5,0;;1,0;;;;;;;;;;;;;;;1,0;2,0;;;2,0;;4,0;;;1,0;;;;;;;;1,0;;;;2,0;;1,0;;;;;1,0;;3,0;3,0;;;;;8,0;;;;6,0;1,0;;2,0;;;;;;;5,0;11,0;;;5,0;;;3,0;;12,0;5,0;;2,0;;3,0;;;;;10,0;;;;;;;;;;;1,0;2,0;;;;;4,0;;;;;;;;;;4,0;;;;2,0;;;1,0;;;3,0;;;2,0;;36,0;2,0;;;4,0;;;;;;1,0;4,0;;6,0;21,0;5,0;;;2,0;8,0;9,0;;;;3,0;2,0;;;;;;;;;;;5,0;;;2,0;1,0;;;;;;10,0;;;;;;1,0;;;1,0;10,0;;;;;;;;1,0;2,0;;;;;;;;;;12,0;;;;;;;;;;1,0;;4,0;1,0;;;;;;;;4,0;;5,0;;;;1,0;;1,0;;;;;;1,0;2,0;1,0;1,0;3,0;;;4,0;;;;;;2,0;;3,0;;;1,0;;;1,0;;;;;;1,0;6,0;;;;;;;;;;;;;8,0;;;;;;;;;;5,0;;;;;;;;;;;;;;;;;;4,0;;;1,0;6,0;;;;;;;;;;;2,0;;;;1,0;;;;10,0;1,0;;;;;;3,0;1,0;;;2,0;;;;;;;;;10,0;;1,0;;6,0;;;2,0;4,0;3,0;;;;;;1,0;;;;;;;;;;;;3,0;;2,0;;;;;;;;;;;;;;;;1,0;;;;;;;;;;;;;;;;;;;1,0;;;;;;;;;;;;;;;;;;;;1,0;;4,0;1,0;;;1,0;;1,0;2,0;;;;;;;;;;;1,0;;2,0;;;;;;;;;;;;;;;;;;;;;;;;;4,0;;;;;;1,0;;;;;;;;;6,0;2,0;2,0;;4,0;;;3,0;;;;;1,0;;;1,0;;;;;;;;;;;;;;2,0;;;1,0;;;;;2,0;;;;;;;;;;;;;;;;7,0;;1,0;;1,0;;;;;2,0;;;;;;;;;;;;;;;;;;6,0;;;;;
represent;5,0;1,0;23,0;;20,0;;26,0;29,0;22,0;31,0;4,0;19,0;;58,0;67,0;1,0;;3,0;39,0;6,0;21,0;16,0;30,0;;21,0;;4,0;351,0;31,0;13,0;8,0;37,0;46,0;15,0;64,0;2,0;1,0;26,0;20,0;66,0;60,0;8,0;1,0;4,0;10,0;9,0;;38,0;25,0;23,0;12,0;83,0;2,0;16,0;4,0;680,0;42,0;;49,0;62,0;2,0;8,0;52,0;6,0;11,0;8,0;21,0;;2,0;15,0;44,0;3,0;1,0;;;;;47,0;60,0;6,0;;20,0;3,0;3,0;;;18,0;2,0;;16,0;24,0;5,0;28,0;153,0;18,0;6,0;;13,0;39,0;;39,0;57,0;;;3,0;2,0;;53,0;;;1,0;1,0;11,0;;;;;7,0;;5,0;;;4,0;10,0;;7,0;19,0;4,0;3,0;1,0;11,0;;;;1,0;;;;;5,0;8,0;5,0;3,0;30,0;12,0;;13,0;62,0;;2,0;11,0;;6,0;;1,0;2,0;4,0;;4,0;12,0;14,0;4,0;;1,0;1,0;8,0;21,0;52,0;;1,0;2,0;3,0;4,0;;28,0;;;54,0;;;2,0;;;;;19,0;;79,0;;43,0;;;3,0;36,0;4,0;9,0;11,0;;15,0;;;4,0;;10,0;;4,0;2,0;;6,0;4,0;;;2,0;;9,0;42,0;15,0;;1,0;;2,0;5,0;;5,0;4,0;;5,0;;;;;;;4,0;5,0;29,0;;7,0;54,0;2,0;;;13,0;;;2,0;18,0;;;;2,0;;;;;;2,0;19,0;5,0;13,0;2,0;;;;;;2,0;;;;;1,0;1,0;1,0;;4,0;6,0;;1,0;1,0;;;3,0;;;62,0;3,0;125,0;1,0;1,0;;2,0;;3,0;;3,0;;9,0;;3,0;;1,0;21,0;3,0;1,0;;;17,0;;;10,0;8,0;;;;;;;;;;8,0;;;4,0;25,0;4,0;;4,0;1,0;27,0;;;1,0;;3,0;;;3,0;6,0;;10,0;;4,0;4,0;1,0;;10,0;1,0;6,0;1,0;3,0;14,0;;1,0;1,0;3,0;;4,0;;2,0;;;;18,0;3,0;;5,0;;8,0;;3,0;17,0;2,0;20,0;12,0;1,0;;1,0;3,0;14,0;;;4,0;2,0;16,0;2,0;2,0;;54,0;5,0;4,0;;;1,0;1,0;;18,0;16,0;2,0;5,0;;;1,0;67,0;;12,0;21,0;1,0;;;;;11,0;;7,0;25,0;;15,0;5,0;38,0;;4,0;2,0;6,0;;1,0;7,0;2,0;49,0;15,0;;;;2,0;;6,0;;5,0;;5,0;3,0;1,0;;;;1,0;6,0;;;;;29,0;23,0;;;3,0;;4,0;;;20,0;1,0;6,0;;6,0;4,0;8,0;43,0;;;8,0;;;;5,0;10,0;1,0;;;;2,0;;;4,0;;5,0;5,0;;18,0;;;4,0;;52,0;43,0;9,0;17,0;4,0;2,0;3,0;1,0;;;6,0;10,0;2,0;;;;4,0;;;8,0;9,0;;;18,0;2,0;;;;8,0;;;5,0;;;;;1,0;;;4,0;5,0;6,0;;;;3,0;;14,0;;;;;1,0;;;;7,0;1,0;;;2,0;;2,0;;;25,0;125,0;9,0;1,0;2,0;;17,0;5,0;;;;;1,0;;;;;;;;;;7,0;127,0;1,0;;2,0;;18,0;3,0;26,0;;;;6,0;1,0;;;;2,0;1,0;;;5,0;;;;;;;2,0;;;;;1,0;;1,0;;;5,0;1,0;;3,0;2,0;;;;;;;;;;14,0;6,0;;;;;;4,0;5,0;;;4,0;;;6,0;4,0;4,0;11,0;3,0;;;;;;;2,0;1,0;13,0;;1,0;3,0;;;1,0;;;1,0;;;;;1,0;;;2,0;;2,0;4,0;12,0;6,0;13,0;5,0;5,0;;;2,0;1,0;4,0;1,0;;10,0;14,0;;1,0;12,0;;4,0;6,0;;3,0;;;1,0;;5,0;;20,0;1,0;1,0;;2,0;1,0;1,0;;;;;;;;;1,0;1,0;;;;5,0;;8,0;16,0;;;;2,0;25,0;;;8,0;;;2,0;12,0;;1,0;5,0;15,0;;1,0;2,0;1,0;3,0;1,0;;5,0;6,0;7,0;1,0;;;;18,0;4,0;1,0;;;4,0;9,0;;;;;2,0;;19,0;;;;;;13,0;12,0;2,0;;;4,0;;;;;;7,0;1,0;;;;4,0;1,0;2,0;;;;2,0;2,0;;;6,0;;6,0;;4,0;5,0;;;1,0;1,0;;;;;13,0;;1,0;;;;;6,0;5,0;2,0;;;;;11,0;;2,0;;;;1,0;3,0;;;;1,0;;;1,0;;3,0;4,0;5,0;;;;;7,0;6,0;1,0;4,0;;;;4,0;;;;;;;;;;3,0;;5,0;;;;2,0;;;;;6,0;3,0;;;;;;4,0;;1,0;;;1,0;1,0;2,0;;;;;;;2,0;;9,0;;1,0;3,0;1,0;;2,0;;;;5,0;9,0;;2,0;;6,0;;13,0;;;8,0;3,0;2,0;;1,0;1,0;;;;;;21,0;;3,0;2,0;4,0;1,0;1,0;;;;;;;;6,0;;;;;4,0;1,0;;;3,0;;;2,0;4,0;3,0;2,0;;;8,0;;;;;;;1,0;;;;;;;2,0;;;2,0;;1,0;1,0;;;;;;
select;12,0;4,0;42,0;5,0;103,0;;23,0;172,0;32,0;132,0;13,0;50,0;5,0;26,0;128,0;17,0;5,0;10,0;85,0;39,0;33,0;305,0;49,0;19,0;44,0;11,0;4,0;527,0;18,0;68,0;181,0;107,0;414,0;20,0;163,0;3,0;10,0;44,0;7,0;435,0;47,0;7,0;18,0;138,0;1,0;14,0;4,0;81,0;124,0;84,0;54,0;65,0;9,0;509,0;5,0;1985,0;166,0;7,0;26,0;111,0;8,0;35,0;445,0;9,0;20,0;4,0;35,0;;1,0;196,0;38,0;21,0;6,0;;;23,0;;238,0;128,0;77,0;4,0;148,0;59,0;21,0;5,0;;181,0;;16,0;;144,0;16,0;90,0;233,0;77,0;2,0;7,0;46,0;133,0;10,0;10,0;143,0;;79,0;5,0;12,0;31,0;574,0;;;16,0;5,0;31,0;12,0;6,0;4,0;3,0;7,0;10,0;56,0;;;11,0;150,0;4,0;12,0;159,0;9,0;9,0;12,0;2,0;7,0;13,0;;6,0;45,0;16,0;;8,0;6,0;13,0;16,0;17,0;25,0;138,0;1,0;56,0;164,0;2,0;8,0;10,0;;3,0;2,0;32,0;;11,0;4,0;65,0;192,0;2,0;4,0;;;2,0;13,0;32,0;100,0;;36,0;79,0;12,0;72,0;22,0;21,0;6,0;;388,0;4,0;2,0;5,0;;5,0;19,0;;32,0;32,0;509,0;;168,0;;2,0;8,0;94,0;2,0;4,0;5,0;3,0;14,0;2,0;;10,0;;8,0;;40,0;31,0;4,0;1,0;15,0;29,0;3,0;3,0;3,0;12,0;106,0;57,0;5,0;1,0;;3,0;8,0;2,0;17,0;3,0;18,0;24,0;;;;2,0;;11,0;18,0;18,0;35,0;;46,0;158,0;6,0;;2,0;16,0;1,0;2,0;7,0;7,0;2,0;;;49,0;57,0;1,0;30,0;;3,0;;15,0;121,0;1,0;5,0;20,0;27,0;2,0;8,0;1,0;4,0;2,0;;2,0;;5,0;;7,0;17,0;39,0;60,0;1,0;6,0;4,0;8,0;;1,0;16,0;;43,0;8,0;155,0;58,0;3,0;;;8,0;58,0;;3,0;11,0;66,0;;;6,0;;122,0;4,0;35,0;;3,0;50,0;2,0;;75,0;19,0;;;2,0;;1,0;;6,0;4,0;2,0;5,0;2,0;3,0;;34,0;;6,0;25,0;4,0;395,0;4,0;18,0;4,0;3,0;;4,0;12,0;4,0;;1,0;58,0;10,0;11,0;45,0;3,0;8,0;6,0;1,0;55,0;4,0;44,0;9,0;4,0;11,0;;10,0;;;2,0;17,0;7,0;;1,0;38,0;64,0;9,0;3,0;7,0;23,0;2,0;;3,0;13,0;76,0;43,0;27,0;6,0;;21,0;28,0;8,0;4,0;53,0;2,0;17,0;18,0;6,0;7,0;138,0;1,0;54,0;1,0;1,0;25,0;6,0;20,0;70,0;38,0;2,0;30,0;;6,0;9,0;5,0;8,0;44,0;39,0;15,0;11,0;5,0;63,0;1,0;20,0;28,0;31,0;47,0;;106,0;2,0;53,0;14,0;3,0;33,0;714,0;8,0;11,0;36,0;20,0;55,0;22,0;7,0;1,0;2,0;3,0;7,0;8,0;2,0;23,0;1,0;30,0;55,0;5,0;4,0;20,0;53,0;13,0;6,0;25,0;22,0;;20,0;59,0;14,0;1,0;27,0;12,0;6,0;76,0;;1,0;31,0;5,0;14,0;4,0;26,0;4,0;6,0;84,0;43,0;;87,0;2,0;5,0;11,0;14,0;99,0;;8,0;18,0;19,0;19,0;41,0;17,0;2,0;12,0;61,0;289,0;122,0;139,0;24,0;75,0;9,0;15,0;180,0;126,0;9,0;31,0;10,0;18,0;5,0;37,0;3,0;18,0;16,0;2,0;13,0;1,0;;;2,0;;2,0;25,0;16,0;10,0;5,0;46,0;3,0;5,0;;;22,0;11,0;2,0;25,0;44,0;;3,0;5,0;;1,0;2,0;94,0;88,0;3,0;;13,0;4,0;55,0;;14,0;8,0;12,0;;;5,0;3,0;4,0;2,0;14,0;19,0;19,0;19,0;30,0;;23,0;5,0;4,0;35,0;445,0;2,0;20,0;3,0;1,0;36,0;48,0;29,0;2,0;21,0;;7,0;17,0;17,0;;;12,0;4,0;6,0;4,0;1,0;29,0;37,0;15,0;3,0;23,0;6,0;42,0;;36,0;5,0;;;7,0;4,0;11,0;;;373,0;13,0;3,0;;69,0;;;10,0;5,0;1,0;;;;31,0;2,0;;8,0;1,0;6,0;;;5,0;7,0;;23,0;13,0;;4,0;2,0;;15,0;2,0;1,0;15,0;3,0;2,0;8,0;3,0;3,0;;7,0;;1,0;2,0;;7,0;1,0;33,0;4,0;6,0;13,0;1,0;29,0;6,0;3,0;;;;;;9,0;2,0;12,0;;9,0;1,0;5,0;5,0;20,0;1,0;;3,0;3,0;;4,0;;30,0;1,0;;24,0;7,0;20,0;13,0;5,0;18,0;9,0;20,0;;;8,0;10,0;1,0;;6,0;6,0;;20,0;;17,0;26,0;6,0;2,0;3,0;2,0;1,0;3,0;14,0;17,0;;7,0;12,0;35,0;1,0;9,0;12,0;54,0;2,0;;18,0;6,0;12,0;1,0;5,0;2,0;;1,0;;2,0;;7,0;;;20,0;10,0;18,0;2,0;;1,0;3,0;;10,0;5,0;12,0;;;4,0;14,0;8,0;17,0;6,0;2,0;4,0;;12,0;;12,0;107,0;2,0;34,0;8,0;8,0;;7,0;20,0;7,0;3,0;4,0;2,0;3,0;5,0;8,0;2,0;31,0;5,0;4,0;;13,0;6,0;30,0;24,0;24,0;6,0;4,0;5,0;;7,0;;3,0;14,0;7,0;;;2,0;1,0;2,0;34,0;3,0;4,0;4,0;;5,0;5,0;7,0;4,0;;;19,0;18,0;;20,0;30,0;27,0;1,0;2,0;5,0;16,0;;;6,0;1,0;;1,0;1,0;;20,0;5,0;1,0;4,0;;;15,0;;9,0;15,0;18,0;;;;7,0;;5,0;3,0;3,0;4,0;13,0;5,0;2,0;18,0;4,0;;11,0;;;1,0;13,0;16,0;2,0;5,0;13,0;;2,0;;;2,0;1,0;;3,0;;12,0;2,0;10,0;;;;32,0;;2,0;;8,0;;2,0;;;;;;1,0;1,0;;1,0;2,0;3,0;;;1,0;1,0;21,0;7,0;23,0;;8,0;5,0;14,0;;3,0;;;2,0;;2,0;1,0;2,0;3,0;12,0;8,0;1,0;14,0;13,0;;;;;28,0;12,0;;13,0;1,0;5,0;1,0;15,0;3,0;;3,0;45,0;;1,0;3,0;2,0;;;;5,0;;;8,0;12,0;;3,0;1,0;9,0;;5,0;;;;;2,0;;1,0;;;5,0;8,0;3,0;5,0;1,0;;;;2,0;2,0;6,0;1,0;4,0;2,0;;;;;3,0;1,0;;;;3,0;5,0;;1,0;;10,0;2,0;2,0;1,0;;1,0;;;;;;;
sensor;3,0;14,0;47,0;5,0;184,0;;175,0;248,0;36,0;456,0;41,0;32,0;18,0;7,0;188,0;9,0;10,0;10,0;77,0;32,0;112,0;338,0;31,0;31,0;47,0;2,0;9,0;577,0;10,0;501,0;234,0;192,0;586,0;38,0;362,0;64,0;64,0;165,0;11,0;100,0;109,0;12,0;41,0;328,0;9,0;6,0;4,0;70,0;227,0;46,0;26,0;302,0;7,0;82,0;41,0;6603,0;725,0;4,0;57,0;864,0;218,0;38,0;398,0;1,0;9,0;46,0;52,0;10,0;4,0;67,0;584,0;7,0;76,0;11,0;13,0;20,0;7,0;84,0;510,0;46,0;17,0;174,0;145,0;89,0;4,0;8,0;101,0;10,0;24,0;144,0;;28,0;16,0;546,0;38,0;35,0;12,0;44,0;63,0;213,0;313,0;546,0;13,0;40,0;3,0;29,0;65,0;290,0;11,0;4,0;82,0;141,0;520,0;168,0;81,0;2,0;4,0;10,0;167,0;87,0;47,0;;7,0;238,0;3,0;15,0;314,0;30,0;16,0;221,0;63,0;20,0;5,0;1,0;35,0;32,0;171,0;2,0;27,0;18,0;19,0;7,0;40,0;49,0;146,0;18,0;305,0;101,0;7,0;15,0;23,0;11,0;3,0;42,0;11,0;109,0;37,0;212,0;56,0;468,0;36,0;19,0;23,0;17,0;9,0;54,0;17,0;609,0;1,0;31,0;205,0;38,0;613,0;361,0;75,0;42,0;19,0;686,0;154,0;3,0;25,0;17,0;65,0;22,0;;103,0;34,0;610,0;4,0;407,0;2,0;20,0;35,0;394,0;6,0;54,0;5,0;1,0;13,0;4,0;139,0;41,0;6,0;91,0;4,0;4,0;112,0;34,0;53,0;106,0;22,0;27,0;15,0;4,0;26,0;169,0;75,0;47,0;4,0;11,0;35,0;96,0;37,0;35,0;12,0;35,0;28,0;6,0;11,0;4,0;17,0;2,0;15,0;52,0;85,0;123,0;;34,0;234,0;17,0;80,0;1,0;9,0;20,0;8,0;10,0;20,0;499,0;1,0;19,0;38,0;9,0;28,0;213,0;3,0;1,0;2,0;36,0;3,0;15,0;9,0;70,0;12,0;3,0;30,0;5,0;22,0;2,0;6,0;7,0;19,0;47,0;12,0;8,0;14,0;73,0;;;29,0;74,0;5,0;32,0;10,0;33,0;19,0;177,0;41,0;259,0;35,0;41,0;37,0;3,0;23,0;22,0;15,0;15,0;40,0;64,0;1,0;;28,0;3,0;75,0;31,0;10,0;4,0;1,0;115,0;16,0;11,0;78,0;97,0;;2,0;2,0;;11,0;;3,0;15,0;8,0;209,0;3,0;12,0;;63,0;18,0;4,0;28,0;1,0;48,0;7,0;6,0;54,0;11,0;13,0;5,0;6,0;6,0;74,0;5,0;90,0;3,0;20,0;7,0;1,0;5,0;22,0;15,0;46,0;12,0;8,0;21,0;10,0;;4,0;12,0;2,0;1,0;5,0;9,0;4,0;2,0;13,0;24,0;17,0;2,0;9,0;55,0;4,0;22,0;13,0;4,0;95,0;32,0;56,0;38,0;15,0;;30,0;34,0;29,0;5,0;21,0;8,0;6,0;22,0;34,0;15,0;61,0;6,0;35,0;16,0;4,0;54,0;19,0;22,0;36,0;27,0;11,0;42,0;53,0;16,0;21,0;24,0;78,0;2,0;52,0;1,0;13,0;40,0;18,0;33,0;32,0;4,0;44,0;11,0;20,0;59,0;21,0;87,0;8,0;;36,0;59,0;14,0;2,0;91,0;56,0;128,0;6,0;9,0;3,0;4,0;1,0;2,0;22,0;18,0;27,0;2,0;2,0;;29,0;16,0;6,0;91,0;26,0;177,0;8,0;25,0;1,0;13,0;105,0;63,0;;10,0;9,0;6,0;23,0;;17,0;4,0;28,0;45,0;35,0;44,0;60,0;;27,0;;;69,0;2,0;1,0;14,0;4,0;50,0;15,0;4,0;3,0;27,0;23,0;;10,0;5,0;16,0;26,0;7,0;9,0;19,0;4,0;30,0;127,0;8,0;115,0;121,0;63,0;16,0;13,0;;1,0;1,0;4,0;12,0;46,0;9,0;;1,0;4,0;8,0;12,0;3,0;;16,0;68,0;26,0;2,0;;;3,0;1,0;8,0;3,0;2,0;;2,0;24,0;1,0;3,0;24,0;2,0;2,0;43,0;5,0;8,0;18,0;1,0;3,0;16,0;8,0;2,0;29,0;5,0;22,0;3,0;1,0;6,0;5,0;4,0;2,0;10,0;23,0;9,0;2,0;26,0;1,0;34,0;8,0;5,0;39,0;491,0;1,0;9,0;;3,0;15,0;59,0;2,0;1,0;7,0;6,0;8,0;;;13,0;3,0;19,0;4,0;11,0;3,0;8,0;1,0;126,0;11,0;11,0;47,0;2,0;;2,0;9,0;15,0;34,0;2,0;3,0;71,0;80,0;4,0;;24,0;7,0;8,0;2,0;92,0;2,0;2,0;8,0;1,0;7,0;;;;4,0;25,0;;3,0;1,0;8,0;2,0;4,0;8,0;7,0;;41,0;20,0;4,0;;;;10,0;;4,0;26,0;18,0;15,0;50,0;8,0;163,0;5,0;12,0;9,0;;4,0;12,0;6,0;1,0;9,0;10,0;5,0;3,0;11,0;14,0;24,0;4,0;1,0;4,0;8,0;2,0;1,0;32,0;4,0;21,0;;1,0;;20,0;12,0;109,0;2,0;1,0;5,0;1,0;;5,0;8,0;26,0;2,0;36,0;2,0;8,0;3,0;9,0;8,0;12,0;19,0;62,0;1,0;7,0;9,0;10,0;;4,0;18,0;3,0;2,0;6,0;1,0;4,0;43,0;28,0;46,0;27,0;3,0;9,0;;10,0;4,0;12,0;6,0;3,0;48,0;18,0;1,0;;57,0;12,0;;13,0;5,0;1,0;36,0;6,0;1,0;;39,0;7,0;18,0;7,0;;;6,0;22,0;31,0;21,0;3,0;;21,0;4,0;2,0;10,0;39,0;31,0;12,0;;14,0;12,0;1,0;10,0;20,0;14,0;;23,0;17,0;15,0;2,0;5,0;7,0;6,0;42,0;29,0;67,0;2,0;20,0;11,0;28,0;8,0;5,0;;2,0;5,0;18,0;17,0;6,0;7,0;7,0;5,0;18,0;9,0;11,0;;12,0;15,0;9,0;16,0;1,0;3,0;1,0;;6,0;;;2,0;;;1,0;20,0;3,0;;5,0;4,0;2,0;3,0;1,0;;5,0;;8,0;6,0;11,0;48,0;3,0;12,0;2,0;4,0;18,0;3,0;14,0;22,0;14,0;9,0;;21,0;;23,0;1,0;1,0;4,0;1,0;1,0;8,0;6,0;17,0;14,0;20,0;1,0;4,0;5,0;1,0;5,0;8,0;5,0;19,0;2,0;23,0;26,0;23,0;13,0;;3,0;4,0;;2,0;;;4,0;2,0;;17,0;1,0;5,0;2,0;3,0;5,0;6,0;1,0;4,0;1,0;10,0;7,0;45,0;;41,0;6,0;20,0;;2,0;4,0;5,0;7,0;5,0;26,0;5,0;;11,0;1,0;3,0;7,0;;7,0;7,0;1,0;7,0;13,0;;5,0;1,0;;19,0;;;6,0;2,0;2,0;2,0;;1,0;1,0;;;2,0;1,0;2,0;;;9,0;;4,0;;7,0;;1,0;6,0;5,0;4,0;;12,0;12,0;3,0;16,0;1,0;8,0;;62,0;1,0;1,0;2,0;3,0;4,0;;;4,0;;31,0;8,0;6,0;6,0;;1,0;;1,0;6,0;2,0;75,0;;1,0;1,0;1,0;4,0;;3,0;30,0;10,0;;;38,0;;;3,0;;1,0;;3,0;61,0;8,0;;2,0;11,0;2,0;;6,0;4,0;;;;;7,0;16,0;;16,0;;;8,0;26,0;1,0;;;;;;;
shift;11,0;4,0;108,0;;16,0;;26,0;23,0;15,0;35,0;20,0;2,0;;;140,0;;9,0;;37,0;;14,0;57,0;2,0;60,0;64,0;13,0;4,0;62,0;8,0;50,0;31,0;45,0;43,0;16,0;53,0;2,0;;57,0;16,0;28,0;15,0;;3,0;18,0;2,0;2,0;12,0;2,0;25,0;3,0;14,0;12,0;3,0;28,0;3,0;283,0;37,0;5,0;1,0;87,0;2,0;17,0;24,0;4,0;6,0;6,0;16,0;;8,0;29,0;45,0;7,0;4,0;;;1,0;;27,0;79,0;25,0;3,0;15,0;4,0;4,0;;;47,0;3,0;5,0;16,0;28,0;;6,0;69,0;;4,0;;6,0;12,0;4,0;7,0;10,0;;14,0;1,0;;1,0;110,0;;;1,0;11,0;9,0;;;;;2,0;;6,0;;;4,0;23,0;;;21,0;;;;;1,0;2,0;3,0;;6,0;3,0;;2,0;;;;;2,0;2,0;5,0;13,0;55,0;;;4,0;;;4,0;;2,0;;;5,0;18,0;3,0;;;;;12,0;8,0;34,0;;;7,0;;4,0;3,0;44,0;10,0;1,0;24,0;;;2,0;;;4,0;;5,0;;27,0;;46,0;;;4,0;4,0;;2,0;;;25,0;;;1,0;7,0;9,0;;;32,0;5,0;4,0;2,0;;;;;2,0;102,0;5,0;;3,0;;3,0;5,0;12,0;;;1,0;3,0;;;;;;1,0;9,0;13,0;6,0;;4,0;33,0;1,0;6,0;;;;;;;;1,0;2,0;5,0;;;14,0;;;;7,0;2,0;;5,0;20,0;13,0;;;;16,0;;;;;1,0;;;1,0;;;;;9,0;;7,0;;37,0;;14,0;12,0;26,0;5,0;9,0;;1,0;7,0;6,0;;5,0;2,0;10,0;;2,0;;;18,0;;25,0;;;10,0;;;41,0;4,0;4,0;;1,0;;;;;;;6,0;6,0;;;11,0;;;4,0;;6,0;;;;;16,0;;;7,0;4,0;3,0;1,0;;17,0;;2,0;1,0;12,0;1,0;13,0;;;13,0;1,0;;;2,0;;;;9,0;;;;11,0;6,0;;;4,0;;2,0;;2,0;14,0;6,0;1,0;1,0;2,0;;;4,0;13,0;;;33,0;;;1,0;;15,0;;14,0;;;;7,0;7,0;4,0;1,0;2,0;;;1,0;3,0;3,0;;;21,0;1,0;;;1,0;2,0;9,0;;;4,0;;9,0;2,0;6,0;;;;59,0;1,0;;4,0;2,0;4,0;15,0;2,0;;;2,0;;3,0;;;;11,0;;;;;1,0;2,0;;17,0;4,0;;7,0;26,0;2,0;;;;2,0;7,0;;3,0;1,0;20,0;;;;2,0;;;;;17,0;;;;75,0;26,0;;;;91,0;;;;;15,0;1,0;14,0;;15,0;;14,0;;;9,0;15,0;;1,0;;;;1,0;;;6,0;4,0;;;;1,0;;;1,0;3,0;;3,0;;3,0;;;;;;1,0;;;;;;;;;1,0;;;;;4,0;;;;;;;;;;;;3,0;8,0;;;;;1,0;1,0;;;12,0;105,0;3,0;1,0;;;;13,0;14,0;1,0;1,0;;;;;;;;;;;;;8,0;;2,0;;;;;6,0;;;;;4,0;37,0;;;;4,0;;;13,0;;;;3,0;5,0;;;;1,0;;;;;;;;;16,0;;2,0;;;;;;;;;1,0;;8,0;;;13,0;;;1,0;;1,0;;;2,0;;;3,0;;;5,0;;;;;;;;2,0;1,0;1,0;1,0;;;;4,0;10,0;;;;;;;;18,0;;;;1,0;;2,0;;;;;;;4,0;;;;2,0;2,0;2,0;24,0;;;17,0;2,0;7,0;9,0;2,0;;;1,0;;9,0;;5,0;7,0;3,0;2,0;1,0;7,0;;;14,0;;;;1,0;;1,0;;2,0;;;;;;1,0;33,0;;6,0;1,0;;;4,0;1,0;;;1,0;;54,0;;1,0;2,0;17,0;;;6,0;;;;;;;6,0;;6,0;4,0;;;;4,0;;;;;2,0;7,0;2,0;10,0;;;3,0;1,0;3,0;;1,0;;;3,0;1,0;1,0;;12,0;;;;6,0;2,0;;;;3,0;;2,0;3,0;;;14,0;;;1,0;;;;12,0;4,0;5,0;;;;;;;;;;;2,0;3,0;;;;;;;;3,0;6,0;;;;;;;;5,0;;;2,0;;1,0;;;;;4,0;;;;2,0;;;;;;;2,0;;9,0;;;1,0;;;;;;;2,0;;;;;;5,0;3,0;;;;6,0;;;1,0;;;;;;1,0;3,0;;;;;3,0;;1,0;16,0;;;;;;;;7,0;3,0;;2,0;8,0;;;1,0;;1,0;;;;;6,0;;6,0;;;;1,0;;;;;;;;;;;;;;;;;;;;;;;;;;;;;;;;;;;;;;;;4,0;1,0;10,0;;;;;;;;;;2,0;;;;;;;;;;3,0;;;;;;;;
shoot;1,0;;19,0;;43,0;;19,0;148,0;11,0;12,0;2,0;;;;43,0;4,0;2,0;1,0;;2,0;163,0;170,0;1,0;9,0;22,0;;;186,0;7,0;79,0;10,0;89,0;197,0;6,0;91,0;;7,0;59,0;15,0;65,0;122,0;2,0;9,0;6,0;1,0;2,0;;25,0;21,0;4,0;32,0;55,0;;;2,0;770,0;79,0;;16,0;133,0;;35,0;32,0;;;;95,0;;;110,0;145,0;5,0;14,0;1,0;;16,0;;14,0;119,0;6,0;;30,0;4,0;3,0;7,0;1,0;2,0;3,0;28,0;90,0;16,0;6,0;;35,0;6,0;5,0;;32,0;42,0;14,0;5,0;131,0;;3,0;1,0;1,0;3,0;273,0;;;2,0;11,0;2,0;;1,0;9,0;1,0;;1,0;11,0;1,0;4,0;7,0;15,0;;;24,0;1,0;5,0;;2,0;6,0;;3,0;1,0;2,0;2,0;;;3,0;;1,0;1,0;85,0;;5,0;10,0;12,0;1,0;1,0;;;4,0;4,0;19,0;;;8,0;4,0;86,0;3,0;2,0;;5,0;5,0;6,0;3,0;39,0;;;19,0;6,0;26,0;8,0;2,0;10,0;2,0;56,0;;;2,0;;6,0;;;65,0;;86,0;;35,0;;;;14,0;;3,0;1,0;;7,0;14,0;;3,0;2,0;22,0;;;3,0;1,0;2,0;5,0;;2,0;;;11,0;115,0;4,0;;;;5,0;;1,0;;2,0;;38,0;;;;1,0;;;9,0;37,0;23,0;;3,0;260,0;;18,0;;;1,0;;29,0;;;;;;9,0;;3,0;5,0;1,0;;3,0;23,0;2,0;2,0;6,0;;;3,0;;1,0;2,0;;;;8,0;1,0;;1,0;3,0;16,0;;61,0;17,0;;;;4,0;;21,0;5,0;125,0;6,0;1,0;;;3,0;1,0;;3,0;;29,0;;;;;51,0;2,0;;;;92,0;3,0;;3,0;12,0;7,0;;1,0;;;;;;;4,0;;;;12,0;;;1,0;;14,0;20,0;;;;;;14,0;;1,0;;1,0;1,0;7,0;6,0;5,0;3,0;9,0;;14,0;9,0;;2,0;;;1,0;;;2,0;;3,0;;;;10,0;30,0;;4,0;;;11,0;;;2,0;4,0;3,0;5,0;;;5,0;1,0;12,0;;21,0;;2,0;;5,0;;78,0;18,0;8,0;4,0;;14,0;7,0;8,0;20,0;6,0;;1,0;;9,0;;15,0;;;29,0;;2,0;;18,0;;1,0;2,0;1,0;1,0;;5,0;;20,0;;1,0;;486,0;3,0;4,0;20,0;71,0;63,0;;1,0;4,0;;2,0;;5,0;;;;13,0;;;;;7,0;9,0;19,0;13,0;;;20,0;8,0;32,0;;23,0;4,0;21,0;32,0;;5,0;16,0;2,0;1,0;1,0;8,0;6,0;2,0;31,0;;9,0;80,0;1,0;;;;12,0;;1,0;10,0;12,0;;1,0;3,0;;2,0;25,0;29,0;4,0;94,0;7,0;34,0;24,0;2,0;15,0;10,0;2,0;;;;;1,0;;;126,0;20,0;;;;;;;;;12,0;1,0;;6,0;;36,0;;;1,0;;;11,0;10,0;;;4,0;1,0;2,0;;;31,0;2,0;;4,0;;;;4,0;1,0;3,0;;;1,0;;1,0;;;;;2,0;1,0;;16,0;;10,0;35,0;4,0;;;3,0;;2,0;3,0;;;2,0;;3,0;;;1,0;;;;;;;;92,0;1,0;2,0;99,0;;;;;;;;;;7,0;;4,0;;;;;27,0;;;;1,0;;;;;8,0;;;;;2,0;;;3,0;;;16,0;;;;;;4,0;;;;;14,0;;;5,0;;;;;7,0;;;1,0;;;;;;11,0;;;;;;;;;;2,0;;;1,0;;;13,0;;;;24,0;39,0;;3,0;3,0;1,0;;20,0;;;;;;;;;;10,0;;;;1,0;;13,0;6,0;;;2,0;;;5,0;;;5,0;;;;;1,0;17,0;1,0;;2,0;2,0;17,0;4,0;;;14,0;;;;2,0;;;12,0;;13,0;;;1,0;;2,0;137,0;;1,0;;;;1,0;;9,0;;;;1,0;;2,0;8,0;;1,0;;1,0;;;;;1,0;;;2,0;;;9,0;1,0;2,0;;4,0;1,0;;10,0;;2,0;;;3,0;1,0;5,0;;;6,0;3,0;;21,0;;;;45,0;;;12,0;;;3,0;6,0;;;;;;1,0;;;;;;;;;7,0;;;1,0;;;;;1,0;12,0;;;1,0;2,0;;;1,0;;;3,0;3,0;;;11,0;;;;;;;;;1,0;2,0;;;;;;;;5,0;;;7,0;;;31,0;;;;;;;;;;;;2,0;;;;12,0;;;;;;;;;;;;1,0;;;;;;;;;;;4,0;;;;1,0;2,0;;;;;;;2,0;1,0;;1,0;2,0;;;;;;;;;;;;;;4,0;;;;;;;3,0;;1,0;;3,0;;;;;;;;;;;;;;;;;;;;;;;;;;1,0;20,0;;;;;;;;3,0;;;;;;;;;;;4,0;;;;;;;;5,0;;;11,0;;;;;;
signal;2,0;3,0;112,0;22,0;375,0;;22,0;899,0;141,0;308,0;23,0;42,0;1,0;26,0;408,0;18,0;36,0;21,0;216,0;25,0;46,0;1789,0;24,0;204,0;119,0;2,0;2,0;667,0;13,0;374,0;378,0;231,0;1072,0;129,0;1043,0;7,0;34,0;112,0;8,0;384,0;31,0;6,0;187,0;306,0;48,0;20,0;;41,0;229,0;192,0;69,0;1591,0;137,0;54,0;;5128,0;537,0;11,0;22,0;446,0;10,0;16,0;460,0;18,0;;126,0;126,0;3,0;13,0;384,0;392,0;37,0;89,0;12,0;2,0;8,0;4,0;58,0;273,0;188,0;4,0;1599,0;479,0;157,0;7,0;11,0;153,0;3,0;153,0;233,0;546,0;69,0;35,0;;16,0;22,0;23,0;134,0;399,0;45,0;44,0;619,0;;440,0;5,0;146,0;61,0;1624,0;29,0;;89,0;60,0;126,0;15,0;17,0;37,0;8,0;44,0;34,0;68,0;;;51,0;690,0;;15,0;485,0;35,0;29,0;58,0;17,0;28,0;9,0;2,0;6,0;167,0;58,0;;77,0;61,0;4,0;4,0;106,0;28,0;117,0;4,0;168,0;260,0;7,0;6,0;57,0;;5,0;14,0;128,0;;13,0;25,0;13,0;903,0;75,0;28,0;2,0;5,0;5,0;41,0;512,0;470,0;34,0;6,0;111,0;35,0;197,0;23,0;72,0;20,0;1,0;2350,0;;;11,0;5,0;35,0;24,0;;24,0;3,0;603,0;;198,0;2,0;1,0;56,0;1106,0;3,0;43,0;1,0;;50,0;11,0;50,0;23,0;41,0;67,0;;12,0;67,0;3,0;17,0;11,0;80,0;9,0;2,0;7,0;12,0;608,0;555,0;5,0;;4,0;29,0;57,0;102,0;15,0;10,0;54,0;24,0;;10,0;;1,0;3,0;81,0;28,0;212,0;20,0;;131,0;152,0;18,0;12,0;1,0;42,0;6,0;23,0;37,0;12,0;79,0;;31,0;296,0;18,0;9,0;292,0;20,0;3,0;;43,0;20,0;;53,0;237,0;4,0;4,0;10,0;;24,0;4,0;2,0;1,0;4,0;21,0;10,0;57,0;3,0;99,0;3,0;2,0;23,0;19,0;8,0;11,0;5,0;60,0;1,0;208,0;41,0;284,0;64,0;4,0;2,0;;11,0;34,0;;;100,0;158,0;;2,0;26,0;;284,0;14,0;16,0;;;139,0;5,0;1,0;341,0;97,0;3,0;2,0;3,0;;1,0;;;1,0;;135,0;1,0;1,0;6,0;166,0;3,0;;319,0;;61,0;35,0;2,0;5,0;1,0;70,0;6,0;28,0;113,0;114,0;1,0;68,0;7,0;94,0;54,0;61,0;26,0;50,0;2,0;254,0;24,0;133,0;21,0;26,0;6,0;13,0;58,0;3,0;;;80,0;17,0;;8,0;63,0;232,0;8,0;65,0;62,0;16,0;7,0;9,0;88,0;59,0;55,0;272,0;16,0;112,0;;26,0;198,0;228,0;6,0;27,0;178,0;36,0;29,0;39,0;2,0;242,0;51,0;257,0;13,0;7,0;137,0;29,0;86,0;115,0;76,0;22,0;26,0;3,0;38,0;37,0;14,0;122,0;2,0;165,0;3,0;52,0;13,0;7,0;29,0;121,0;13,0;27,0;7,0;1,0;659,0;11,0;58,0;22,0;20,0;56,0;205,0;21,0;8,0;504,0;19,0;103,0;37,0;6,0;3,0;18,0;19,0;13,0;673,0;4,0;166,0;10,0;34,0;8,0;26,0;29,0;15,0;229,0;273,0;560,0;25,0;56,0;;26,0;220,0;67,0;1,0;117,0;31,0;13,0;97,0;1,0;14,0;5,0;15,0;30,0;28,0;127,0;20,0;36,0;56,0;;9,0;392,0;1,0;2,0;13,0;1,0;14,0;78,0;16,0;14,0;48,0;20,0;47,0;42,0;;20,0;30,0;41,0;60,0;121,0;71,0;260,0;61,0;39,0;1511,0;52,0;17,0;247,0;23,0;56,0;3,0;43,0;9,0;45,0;8,0;2,0;;;3,0;5,0;7,0;;;70,0;217,0;35,0;61,0;2,0;;31,0;3,0;1,0;29,0;2,0;4,0;35,0;30,0;1,0;10,0;14,0;16,0;20,0;35,0;16,0;17,0;103,0;;3,0;2,0;5,0;;18,0;6,0;5,0;;2,0;4,0;7,0;1,0;9,0;9,0;3,0;3,0;10,0;63,0;;67,0;12,0;3,0;148,0;1486,0;62,0;;2,0;;24,0;32,0;41,0;12,0;6,0;;116,0;15,0;4,0;;;5,0;4,0;;12,0;;13,0;225,0;10,0;116,0;113,0;;6,0;22,0;39,0;189,0;;;;28,0;534,0;2,0;;15,0;1,0;11,0;22,0;156,0;;7,0;8,0;8,0;26,0;2,0;2,0;;;1,0;;15,0;3,0;161,0;1,0;1,0;4,0;160,0;1,0;24,0;52,0;4,0;;;;103,0;3,0;;84,0;9,0;115,0;4,0;;39,0;5,0;;3,0;6,0;10,0;2,0;;;14,0;17,0;3,0;2,0;;106,0;21,0;;;3,0;3,0;;26,0;12,0;;12,0;1,0;6,0;2,0;4,0;26,0;11,0;;1,0;4,0;5,0;;14,0;10,0;376,0;8,0;6,0;8,0;26,0;1,0;121,0;141,0;79,0;61,0;41,0;36,0;15,0;17,0;97,0;30,0;4,0;598,0;25,0;;7,0;49,0;35,0;227,0;32,0;18,0;44,0;66,0;20,0;2,0;22,0;4,0;86,0;9,0;25,0;383,0;93,0;3,0;4,0;148,0;7,0;41,0;141,0;32,0;8,0;9,0;4,0;3,0;10,0;14,0;31,0;13,0;8,0;12,0;;19,0;26,0;426,0;124,0;5,0;71,0;5,0;2,0;20,0;2,0;;23,0;15,0;62,0;198,0;16,0;23,0;10,0;183,0;8,0;;3,0;1,0;;13,0;1,0;15,0;56,0;40,0;21,0;8,0;7,0;31,0;2,0;18,0;80,0;29,0;4,0;115,0;25,0;36,0;39,0;14,0;1,0;5,0;3,0;108,0;298,0;15,0;21,0;45,0;42,0;2,0;16,0;11,0;;5,0;16,0;11,0;4,0;5,0;158,0;1,0;12,0;7,0;67,0;3,0;7,0;4,0;18,0;5,0;;;9,0;1,0;;12,0;2,0;5,0;1,0;1,0;12,0;4,0;;43,0;;15,0;2,0;79,0;6,0;8,0;60,0;55,0;8,0;1,0;4,0;10,0;;;15,0;7,0;4,0;16,0;40,0;2,0;1,0;;;46,0;128,0;23,0;15,0;39,0;4,0;91,0;43,0;12,0;5,0;72,0;;;9,0;21,0;5,0;43,0;;;25,0;1,0;15,0;;59,0;112,0;4,0;;;2,0;8,0;2,0;54,0;17,0;3,0;1,0;18,0;2,0;;8,0;40,0;20,0;2,0;3,0;6,0;3,0;;30,0;1,0;2,0;;;2,0;16,0;2,0;11,0;2,0;61,0;66,0;17,0;106,0;;11,0;12,0;91,0;;;;;;;3,0;1,0;32,0;6,0;13,0;;8,0;3,0;11,0;;;;1,0;86,0;18,0;;;61,0;23,0;5,0;13,0;3,0;;43,0;8,0;3,0;;2,0;2,0;7,0;3,0;;;;1,0;2,0;13,0;142,0;4,0;1,0;4,0;;1,0;8,0;7,0;1,0;3,0;;1,0;;;;9,0;;3,0;;;9,0;;;5,0;;11,0;;22,0;10,0;3,0;;;;2,0;2,0;;1,0;2,0;;2,0;14,0;;6,0;;;;18,0;8,0;1,0;3,0;;1,0;;;;
size;2,0;;13,0;;59,0;;19,0;127,0;12,0;10,0;6,0;15,0;2,0;1,0;38,0;;3,0;2,0;11,0;3,0;5,0;79,0;10,0;23,0;11,0;1,0;;174,0;3,0;47,0;23,0;97,0;99,0;6,0;61,0;3,0;;32,0;3,0;115,0;30,0;;;19,0;4,0;9,0;;21,0;36,0;16,0;7,0;21,0;;10,0;9,0;827,0;127,0;;30,0;81,0;1,0;15,0;110,0;83,0;7,0;5,0;12,0;;;6,0;22,0;10,0;6,0;;1,0;1,0;1,0;32,0;140,0;;;26,0;19,0;6,0;;;72,0;9,0;18,0;77,0;38,0;;6,0;16,0;;9,0;3,0;27,0;12,0;6,0;29,0;51,0;;4,0;3,0;;3,0;94,0;;1,0;9,0;11,0;7,0;4,0;2,0;1,0;;;3,0;16,0;1,0;;14,0;4,0;1,0;;38,0;;;12,0;10,0;1,0;;;1,0;1,0;2,0;;1,0;;1,0;;2,0;137,0;16,0;;25,0;129,0;;;;;1,0;;2,0;2,0;10,0;16,0;4,0;40,0;4,0;17,0;7,0;;;2,0;23,0;11,0;;1,0;15,0;6,0;58,0;14,0;24,0;22,0;4,0;97,0;5,0;;3,0;1,0;4,0;2,0;;14,0;14,0;44,0;;49,0;2,0;;;35,0;9,0;6,0;;;9,0;11,0;1,0;73,0;;22,0;;10,0;1,0;;2,0;20,0;6,0;;;3,0;1,0;26,0;6,0;2,0;;;3,0;6,0;4,0;1,0;1,0;2,0;36,0;;;;17,0;;1,0;4,0;48,0;10,0;1,0;6,0;180,0;1,0;6,0;1,0;54,0;2,0;1,0;9,0;;8,0;;;1,0;8,0;;5,0;;;1,0;21,0;59,0;11,0;2,0;2,0;3,0;;6,0;4,0;3,0;;;2,0;1,0;1,0;;;3,0;12,0;1,0;;96,0;1,0;;;;6,0;;22,0;7,0;106,0;5,0;;;7,0;2,0;2,0;;;4,0;21,0;;;1,0;2,0;112,0;1,0;4,0;;1,0;77,0;2,0;5,0;31,0;24,0;1,0;;3,0;;;;;3,0;1,0;4,0;2,0;;;2,0;;7,0;;;15,0;29,0;;1,0;;;5,0;;14,0;;2,0;11,0;;13,0;;8,0;10,0;11,0;1,0;69,0;1,0;;;4,0;;9,0;;;;;12,0;1,0;;1,0;30,0;28,0;4,0;3,0;1,0;11,0;;;1,0;8,0;36,0;17,0;1,0;;;1,0;2,0;7,0;1,0;9,0;;1,0;13,0;20,0;;20,0;;7,0;1,0;;5,0;6,0;2,0;90,0;11,0;1,0;18,0;;1,0;1,0;7,0;;;19,0;;1,0;;6,0;;1,0;;;10,0;;27,0;3,0;31,0;;;2,0;52,0;;10,0;7,0;11,0;4,0;;3,0;;;;;;1,0;;;2,0;2,0;1,0;;4,0;11,0;31,0;7,0;7,0;;;7,0;29,0;9,0;1,0;11,0;;1,0;9,0;;;3,0;1,0;78,0;;20,0;;;14,0;4,0;;20,0;;;;1,0;91,0;;2,0;6,0;1,0;5,0;;1,0;1,0;2,0;37,0;6,0;;34,0;;4,0;3,0;;41,0;49,0;5,0;3,0;2,0;2,0;;;;;177,0;6,0;;;;1,0;6,0;;;7,0;;;31,0;;5,0;6,0;;;;9,0;;1,0;4,0;;5,0;;1,0;;2,0;;17,0;3,0;;4,0;;;;3,0;;;2,0;;;;;;6,0;5,0;;1,0;2,0;;14,0;;2,0;29,0;64,0;3,0;12,0;;;1,0;11,0;;;1,0;1,0;;2,0;;4,0;;3,0;;;;;2,0;37,0;;;6,0;20,0;3,0;4,0;;;2,0;;1,0;15,0;;6,0;2,0;7,0;;;;6,0;;3,0;;;2,0;;;3,0;4,0;;;;;;;;1,0;;1,0;;;;;;2,0;3,0;1,0;;;3,0;4,0;;;1,0;;;;2,0;;1,0;1,0;;1,0;6,0;1,0;;;13,0;6,0;;1,0;1,0;;;2,0;2,0;;15,0;3,0;;;5,0;1,0;;;2,0;;;3,0;;4,0;15,0;;;7,0;;;;;;13,0;7,0;;;;;;;;12,0;3,0;7,0;;;14,0;5,0;;;;;2,0;2,0;;;;4,0;3,0;;;;2,0;;;;;2,0;;2,0;;;;2,0;6,0;;;;;5,0;14,0;11,0;;;10,0;11,0;;5,0;;;4,0;;;14,0;5,0;2,0;2,0;;;;3,0;4,0;3,0;7,0;1,0;1,0;1,0;15,0;3,0;;4,0;;2,0;3,0;;;;6,0;;23,0;;;2,0;;11,0;;5,0;1,0;;;;2,0;7,0;3,0;;18,0;12,0;;;;;;1,0;;44,0;;;5,0;1,0;;;;;;12,0;;1,0;3,0;3,0;;1,0;;;;;;;6,0;;;;4,0;;;3,0;;;;2,0;1,0;12,0;2,0;;;;;;;;;;2,0;3,0;;3,0;;;;;;4,0;1,0;6,0;;;;;;2,0;;;5,0;;;;6,0;;;2,0;1,0;;3,0;;;;44,0;;;;;;;2,0;;;;;1,0;;;;8,0;1,0;6,0;2,0;28,0;;4,0;13,0;;;9,0;;;;;;4,0;1,0;4,0;2,0;;;;28,0;15,0;;;1,0;;11,0;;2,0;;;;;;;;1,0;1,0;1,0;2,0;;3,0;3,0;;;;;;;;;;;;;;4,0;2,0;11,0;;;2,0;;1,0;;;;;;;;;;;;;21,0;;;;;2,0;;;;;;;2,0;;;;9,0;;;;4,0;1,0;4,0;;2,0;;;;
space;1,0;;6,0;4,0;25,0;;52,0;82,0;9,0;14,0;7,0;;;;189,0;1,0;3,0;;28,0;16,0;5,0;3,0;51,0;1,0;5,0;1,0;;37,0;2,0;13,0;6,0;28,0;80,0;8,0;21,0;34,0;1,0;84,0;3,0;20,0;64,0;;6,0;47,0;1,0;;1,0;8,0;19,0;;8,0;34,0;2,0;33,0;1,0;282,0;70,0;8,0;26,0;301,0;1,0;7,0;66,0;2,0;7,0;3,0;24,0;;2,0;34,0;61,0;15,0;2,0;6,0;10,0;;;74,0;88,0;13,0;6,0;22,0;22,0;12,0;;;64,0;5,0;6,0;2,0;35,0;4,0;5,0;22,0;9,0;;1,0;27,0;9,0;25,0;87,0;53,0;;18,0;4,0;4,0;;83,0;;4,0;4,0;45,0;4,0;18,0;7,0;;36,0;7,0;24,0;24,0;1,0;;4,0;21,0;;;21,0;9,0;8,0;8,0;19,0;5,0;;17,0;6,0;18,0;61,0;8,0;10,0;;;3,0;9,0;21,0;15,0;;135,0;56,0;1,0;3,0;11,0;19,0;21,0;2,0;9,0;23,0;23,0;88,0;7,0;15,0;2,0;20,0;60,0;25,0;1,0;11,0;4,0;37,0;3,0;10,0;117,0;4,0;64,0;38,0;5,0;43,0;20,0;39,0;2,0;24,0;7,0;4,0;6,0;5,0;9,0;24,0;32,0;80,0;;126,0;2,0;10,0;;106,0;3,0;5,0;4,0;5,0;17,0;2,0;5,0;21,0;7,0;67,0;6,0;;;4,0;9,0;27,0;4,0;3,0;1,0;1,0;3,0;10,0;2,0;8,0;1,0;8,0;25,0;19,0;2,0;;28,0;;15,0;1,0;6,0;4,0;18,0;;2,0;18,0;9,0;4,0;85,0;;19,0;;64,0;1,0;18,0;18,0;3,0;5,0;11,0;4,0;9,0;10,0;1,0;2,0;2,0;32,0;;8,0;7,0;103,0;1,0;;14,0;8,0;28,0;7,0;9,0;2,0;44,0;4,0;13,0;1,0;1,0;10,0;5,0;1,0;15,0;7,0;;;2,0;36,0;9,0;10,0;1,0;10,0;9,0;10,0;5,0;53,0;1,0;12,0;3,0;1,0;3,0;2,0;;;7,0;1,0;12,0;4,0;1,0;3,0;33,0;11,0;3,0;1,0;6,0;4,0;15,0;13,0;8,0;13,0;4,0;10,0;47,0;;2,0;9,0;;84,0;4,0;21,0;10,0;4,0;7,0;19,0;15,0;17,0;2,0;1,0;8,0;;;;;;1,0;3,0;;1,0;162,0;17,0;;1,0;;11,0;1,0;7,0;10,0;12,0;26,0;5,0;8,0;1,0;;12,0;;;;3,0;;;;7,0;17,0;13,0;1,0;1,0;1,0;2,0;;2,0;;1,0;2,0;70,0;2,0;5,0;;32,0;;9,0;2,0;5,0;;;12,0;;4,0;1,0;;5,0;5,0;;8,0;1,0;9,0;26,0;5,0;9,0;7,0;2,0;1,0;;2,0;;137,0;5,0;;2,0;8,0;5,0;5,0;1,0;;;7,0;1,0;58,0;4,0;26,0;;;;3,0;;1,0;;27,0;4,0;;2,0;;;2,0;5,0;2,0;;3,0;4,0;;;;1,0;1,0;6,0;14,0;30,0;14,0;;;;26,0;6,0;4,0;;1,0;;6,0;;;;1,0;1,0;7,0;18,0;8,0;;3,0;;;6,0;;5,0;;3,0;5,0;;;;;4,0;;1,0;;4,0;12,0;;1,0;2,0;;;1,0;1,0;51,0;35,0;1,0;;35,0;3,0;;39,0;;1,0;20,0;1,0;8,0;13,0;;7,0;3,0;;;;2,0;4,0;2,0;;5,0;;;4,0;5,0;;;;3,0;;8,0;4,0;;;2,0;;;;1,0;1,0;;;;1,0;2,0;12,0;35,0;;10,0;4,0;;;;4,0;3,0;1,0;;2,0;;;1,0;18,0;48,0;1,0;5,0;;;1,0;13,0;;6,0;;1,0;;2,0;;12,0;;9,0;;1,0;;4,0;6,0;18,0;;;14,0;1,0;;;2,0;;1,0;;1,0;17,0;;;3,0;3,0;1,0;2,0;;4,0;1,0;1,0;4,0;;45,0;4,0;1,0;;15,0;1,0;;;;12,0;;1,0;3,0;;1,0;;17,0;;1,0;;1,0;4,0;;;8,0;;4,0;2,0;;9,0;5,0;6,0;6,0;;1,0;3,0;11,0;;;;2,0;7,0;51,0;;28,0;;1,0;21,0;4,0;;3,0;12,0;3,0;1,0;26,0;;;1,0;;1,0;2,0;2,0;3,0;;1,0;;2,0;6,0;;;;;7,0;;;2,0;2,0;9,0;;;;;;;8,0;;1,0;2,0;;;12,0;;;9,0;1,0;2,0;2,0;;4,0;;1,0;;7,0;;8,0;;7,0;;;;;;1,0;1,0;2,0;;;;1,0;;1,0;;;1,0;;;;;;;2,0;1,0;3,0;5,0;;9,0;;1,0;4,0;6,0;19,0;5,0;;;1,0;;4,0;;16,0;1,0;4,0;5,0;5,0;;1,0;;;;;;;;;;4,0;1,0;;1,0;1,0;17,0;10,0;;5,0;;;1,0;1,0;;1,0;25,0;;;;2,0;;;26,0;28,0;;;3,0;2,0;1,0;25,0;;;11,0;9,0;8,0;9,0;22,0;3,0;;1,0;3,0;14,0;20,0;2,0;;;;1,0;;;;6,0;;2,0;;4,0;4,0;4,0;1,0;13,0;7,0;;4,0;;1,0;;;;;;;10,0;;;1,0;;;;;1,0;;4,0;2,0;4,0;;2,0;;;;13,0;;10,0;6,0;5,0;;;1,0;;;;2,0;3,0;;2,0;4,0;9,0;;15,0;;;;;4,0;4,0;;;;9,0;;3,0;;;;;;2,0;;;;;2,0;2,0;4,0;;;;;7,0;14,0;1,0;;;;;;;;;1,0;;;2,0;;;4,0;;;;;;;;;4,0;;1,0;;;;;;;14,0;;;4,0;;;;1,0;3,0;4,0;8,0;;4,0;;;;8,0;1,0;;;1,0;;16,0;1,0;;;;;;;1,0;;1,0;1,0;;;;1,0;;;;;;1,0;;1,0;;;;;1,0;1,0;5,0;;9,0;;
spot;2,0;;;;4,0;;3,0;14,0;1,0;10,0;1,0;;;;;;;;;1,0;;6,0;5,0;;;;;11,0;;2,0;50,0;11,0;1,0;;3,0;;;2,0;1,0;18,0;5,0;;1,0;;1,0;;;;75,0;1,0;;10,0;;18,0;;76,0;9,0;;;8,0;;;23,0;;;;2,0;;;15,0;1,0;;3,0;;1,0;;;3,0;24,0;1,0;;2,0;3,0;;6,0;;1,0;;;7,0;12,0;;;23,0;3,0;1,0;;;2,0;;1,0;10,0;;;;;;1,0;1,0;;4,0;5,0;2,0;2,0;;;;;;2,0;1,0;;;1,0;;;3,0;;;1,0;4,0;2,0;;;;3,0;;;;;;;;1,0;;;3,0;;1,0;;;;;2,0;;;;;;10,0;;;;;;;;39,0;;3,0;2,0;;1,0;;1,0;;1,0;5,0;;;;;;;;;;10,0;;23,0;;;1,0;4,0;;1,0;;;;;;4,0;;;;5,0;;;;;;;;;;1,0;4,0;;;;;2,0;;6,0;;1,0;;;;;;;;1,0;5,0;;5,0;;19,0;;1,0;;;;;;;;;;;;;;;;;;1,0;;2,0;;;;;;1,0;;;;;;;;;2,0;;;;3,0;;;;;;3,0;2,0;18,0;;;1,0;;4,0;1,0;;;;1,0;1,0;;;;8,0;11,0;;;;;;;11,0;;;;5,0;;;;;;;;;;;10,0;;;;;3,0;;;;;;;;;;;1,0;;;;;;1,0;;;;;;;;;;;;;;;;;20,0;4,0;1,0;1,0;;;;;;8,0;;1,0;;;;2,0;1,0;;;1,0;;;;;;2,0;;2,0;;;;;;4,0;4,0;;11,0;;;;;;;;;3,0;1,0;;;;;;1,0;;2,0;43,0;12,0;1,0;;;;;;;;;;;;;;;;;;1,0;1,0;;;;;1,0;;;;3,0;;;12,0;;;;;;3,0;;;;;3,0;;4,0;;;8,0;;;1,0;;;1,0;;;;;;;;;;;1,0;;;;9,0;;;6,0;;1,0;16,0;;;;;;;;1,0;;;;;1,0;;;;;1,0;;;;;;;;;3,0;;;;;;;;;;1,0;;;;;;;;;;;;;;;;;;;;;;;;2,0;;;;;;;;;;4,0;;;;4,0;;;;;;;;;;;;3,0;;;;;;18,0;;;;;;;;;;;;;;3,0;;;;;;;;;;;;;;3,0;;;;;;;;;;;;1,0;;;;;;2,0;;11,0;;;;;3,0;;1,0;;;;;;;;;;;;;;;1,0;2,0;;;;;;;;;;2,0;;;;;;;;3,0;;;;;;;;;;;;;;;;;;;;;;;;;;;;;;;;;;;;;1,0;;;2,0;;;;2,0;;;;;;;;;;;1,0;;;;;;;;4,0;;;;;;;;;;;2,0;;;;;;;;;;;1,0;;;;;;;;;;;;;;1,0;2,0;;;;;;;;;;;;;;5,0;;;;;;;;;;;;3,0;;;1,0;;3,0;;;;;7,0;;1,0;;;;;;1,0;;;;;;;1,0;2,0;;;;;;;;;;;;;;;;;;1,0;;;;;;;;;;;;;;;;;;2,0;;;;;;;;;;;;;;;;;;;;;;;;;5,0;;;;;;;;;;;;;;;;;;;;35,0;;;;;;;;;;;;;;;4,0;;;3,0;;;;;;;;;;;;;;1,0;;;;;;;;;;1,0;;;;;;;;;;;;;;;;;;;;;;;;;;;;;;;;;;;;;;;;;;;;;;;
storage;4,0;2,0;9,0;1,0;83,0;;5,0;34,0;18,0;81,0;10,0;7,0;;15,0;18,0;4,0;;2,0;12,0;150,0;53,0;261,0;15,0;2,0;37,0;;;555,0;4,0;57,0;28,0;35,0;666,0;6,0;161,0;;2,0;40,0;3,0;108,0;16,0;14,0;8,0;42,0;2,0;11,0;1,0;4,0;26,0;9,0;3,0;42,0;;21,0;;787,0;135,0;10,0;3,0;99,0;;13,0;95,0;2,0;;6,0;14,0;;;77,0;21,0;13,0;8,0;;;5,0;;23,0;103,0;24,0;;76,0;41,0;9,0;2,0;;33,0;2,0;13,0;46,0;44,0;6,0;32,0;134,0;27,0;27,0;;;1022,0;;6,0;97,0;;18,0;102,0;1,0;2,0;740,0;;;10,0;12,0;6,0;2,0;49,0;5,0;;;4,0;18,0;;;6,0;144,0;;;75,0;;2,0;22,0;1,0;14,0;;1,0;1,0;12,0;17,0;;2,0;11,0;;1,0;61,0;43,0;;;10,0;44,0;;3,0;;;4,0;;16,0;11,0;6,0;25,0;1,0;40,0;;2,0;;4,0;2,0;;10,0;25,0;14,0;2,0;9,0;6,0;42,0;1,0;5,0;9,0;1,0;52,0;;;5,0;;2,0;4,0;;;;97,0;;32,0;;;;38,0;;;;;1,0;24,0;4,0;5,0;1,0;20,0;;9,0;;;6,0;12,0;;27,0;4,0;1,0;7,0;53,0;23,0;2,0;1,0;1,0;3,0;9,0;1,0;;4,0;3,0;1,0;;4,0;;;;1,0;;9,0;6,0;;4,0;93,0;;9,0;1,0;3,0;2,0;2,0;26,0;7,0;4,0;;;6,0;51,0;;55,0;;1,0;;15,0;1,0;;3,0;11,0;4,0;;3,0;3,0;4,0;;;1,0;1,0;;;3,0;38,0;43,0;12,0;;14,0;2,0;;;2,0;7,0;;15,0;5,0;33,0;11,0;;;;;7,0;;1,0;33,0;28,0;;;16,0;;39,0;1,0;8,0;2,0;;10,0;2,0;;20,0;5,0;4,0;;;;;;;;;7,0;;1,0;;17,0;;;10,0;;77,0;2,0;;1,0;1,0;3,0;;13,0;8,0;3,0;2,0;13,0;4,0;8,0;4,0;28,0;2,0;3,0;8,0;13,0;3,0;7,0;10,0;;1,0;;;;;;4,0;;;1,0;11,0;26,0;1,0;2,0;3,0;2,0;31,0;;;13,0;774,0;118,0;11,0;1,0;;2,0;24,0;2,0;2,0;115,0;;4,0;4,0;16,0;124,0;97,0;;8,0;;2,0;3,0;4,0;9,0;13,0;9,0;2,0;2,0;1,0;3,0;2,0;1,0;2,0;10,0;5,0;2,0;1,0;1,0;7,0;1,0;6,0;;2,0;6,0;;27,0;;12,0;7,0;6,0;11,0;29,0;1,0;7,0;55,0;14,0;6,0;2,0;;;;3,0;5,0;1,0;;31,0;11,0;4,0;18,0;5,0;;1,0;16,0;38,0;5,0;9,0;1,0;;24,0;7,0;7,0;3,0;6,0;16,0;5,0;57,0;;8,0;21,0;2,0;3,0;2,0;12,0;1,0;1,0;59,0;1,0;;22,0;;4,0;17,0;;10,0;1,0;;3,0;48,0;2,0;8,0;5,0;;4,0;8,0;10,0;5,0;18,0;;35,0;3,0;1,0;94,0;6,0;2,0;4,0;;26,0;19,0;46,0;;2,0;4,0;19,0;12,0;;12,0;1,0;1,0;;1,0;10,0;25,0;33,0;3,0;2,0;3,0;1,0;11,0;;16,0;3,0;4,0;11,0;7,0;;;;3,0;;;6,0;92,0;4,0;;;4,0;12,0;;2,0;9,0;;4,0;6,0;2,0;22,0;5,0;1,0;1,0;42,0;;9,0;39,0;;27,0;1,0;1,0;32,0;91,0;;5,0;3,0;;5,0;2,0;10,0;2,0;17,0;2,0;6,0;21,0;1,0;;1,0;3,0;4,0;;4,0;;3,0;8,0;3,0;;27,0;;1,0;;14,0;6,0;;;4,0;49,0;49,0;1,0;4,0;4,0;;9,0;;20,0;;;;16,0;3,0;;2,0;;29,0;;;2,0;1,0;12,0;11,0;8,0;;5,0;;14,0;7,0;;;;2,0;6,0;;;2,0;1,0;8,0;;;;;;;;1,0;;4,0;;18,0;1,0;;1,0;1,0;4,0;;;;;1,0;;1,0;7,0;;5,0;;4,0;1,0;;2,0;2,0;;;;5,0;;;1,0;3,0;;2,0;5,0;1,0;1,0;2,0;1,0;;8,0;2,0;45,0;;;4,0;;15,0;2,0;;;3,0;;1,0;;1,0;;;;21,0;3,0;;;;12,0;4,0;30,0;1,0;15,0;;6,0;;;4,0;2,0;5,0;13,0;;;;;;;;1,0;4,0;;1,0;1,0;3,0;;;;;;3,0;;2,0;;;10,0;;;;1,0;5,0;2,0;;1,0;1,0;8,0;8,0;1,0;1,0;3,0;1,0;1,0;;7,0;3,0;2,0;3,0;;;;3,0;6,0;1,0;5,0;;;;1,0;4,0;3,0;3,0;1,0;6,0;;4,0;10,0;;1,0;6,0;14,0;3,0;;4,0;3,0;3,0;3,0;7,0;;1,0;;1,0;;11,0;;8,0;;;3,0;;1,0;7,0;5,0;3,0;;;1,0;;;1,0;;1,0;;4,0;2,0;;86,0;;;;4,0;4,0;1,0;1,0;2,0;6,0;;;;17,0;;6,0;1,0;1,0;4,0;;;;;;;1,0;;;;4,0;9,0;;1,0;3,0;;5,0;;3,0;;1,0;;;3,0;;;10,0;2,0;;;4,0;;;2,0;36,0;;10,0;;;;;2,0;;;;;;;;2,0;;;1,0;;15,0;;14,0;;11,0;;;;;;;;4,0;;;1,0;;2,0;4,0;3,0;;;;;2,0;;;;3,0;4,0;6,0;;;;2,0;;;2,0;2,0;6,0;2,0;;;;;;;;;;1,0;;;;;;;;;;;;1,0;;;;;;2,0;;;;;3,0;2,0;7,0;;;;;1,0;;;;;2,0;3,0;;;;1,0;6,0;;;1,0;;;;;;;;;
store;2,0;9,0;42,0;2,0;90,0;1,0;20,0;173,0;48,0;259,0;15,0;45,0;;72,0;60,0;1,0;2,0;2,0;35,0;158,0;49,0;310,0;24,0;69,0;90,0;2,0;19,0;1249,0;2,0;46,0;17,0;72,0;532,0;36,0;369,0;3,0;1,0;39,0;5,0;242,0;49,0;57,0;8,0;72,0;6,0;9,0;1,0;10,0;85,0;14,0;20,0;108,0;7,0;29,0;;2356,0;197,0;2,0;4,0;223,0;8,0;36,0;247,0;1,0;12,0;6,0;24,0;;5,0;94,0;41,0;29,0;3,0;;;13,0;;34,0;217,0;23,0;1,0;118,0;115,0;15,0;3,0;;67,0;2,0;39,0;133,0;63,0;12,0;42,0;399,0;12,0;9,0;2,0;1022,0;;8,0;29,0;100,0;2,0;37,0;55,0;13,0;16,0;695,0;3,0;;40,0;15,0;13,0;4,0;23,0;11,0;9,0;;4,0;30,0;;;14,0;87,0;;7,0;229,0;4,0;;19,0;7,0;15,0;;15,0;3,0;16,0;7,0;;3,0;5,0;40,0;;20,0;61,0;20,0;1,0;29,0;161,0;4,0;1,0;;4,0;6,0;10,0;11,0;;1,0;19,0;26,0;77,0;3,0;;4,0;2,0;3,0;7,0;20,0;48,0;10,0;4,0;22,0;3,0;46,0;5,0;6,0;9,0;;128,0;3,0;;2,0;1,0;2,0;11,0;;5,0;;390,0;;81,0;;;;103,0;11,0;1,0;;;6,0;3,0;10,0;6,0;1,0;15,0;1,0;13,0;1,0;3,0;6,0;;15,0;83,0;3,0;7,0;13,0;94,0;46,0;1,0;2,0;2,0;1,0;1,0;2,0;;1,0;3,0;19,0;;3,0;1,0;;;3,0;;18,0;37,0;;17,0;95,0;21,0;38,0;;17,0;;;15,0;15,0;3,0;4,0;;4,0;50,0;1,0;25,0;;2,0;1,0;10,0;6,0;;2,0;13,0;2,0;;;;6,0;;;;;1,0;;2,0;2,0;22,0;21,0;;2,0;6,0;3,0;;;11,0;;49,0;18,0;94,0;30,0;3,0;3,0;2,0;1,0;24,0;2,0;2,0;14,0;63,0;;;20,0;;70,0;2,0;3,0;6,0;;24,0;4,0;;89,0;53,0;;4,0;2,0;;;;;;;17,0;;7,0;;12,0;;3,0;9,0;;83,0;3,0;;5,0;;1,0;4,0;15,0;9,0;5,0;;55,0;25,0;12,0;12,0;169,0;3,0;9,0;;35,0;4,0;39,0;26,0;1,0;15,0;;6,0;6,0;;;18,0;1,0;1,0;3,0;51,0;53,0;3,0;11,0;23,0;20,0;8,0;;1,0;13,0;339,0;1096,0;22,0;5,0;;9,0;12,0;12,0;13,0;254,0;15,0;3,0;2,0;25,0;89,0;181,0;12,0;28,0;;14,0;22,0;7,0;5,0;13,0;21,0;8,0;15,0;1,0;5,0;4,0;51,0;2,0;12,0;40,0;2,0;2,0;1,0;11,0;1,0;12,0;3,0;13,0;44,0;;97,0;4,0;43,0;21,0;;18,0;53,0;12,0;12,0;80,0;15,0;42,0;38,0;2,0;1,0;5,0;2,0;1,0;7,0;1,0;14,0;3,0;11,0;29,0;6,0;1,0;35,0;58,0;23,0;54,0;11,0;11,0;;99,0;122,0;36,0;1,0;14,0;40,0;6,0;132,0;6,0;2,0;37,0;3,0;;;23,0;;5,0;154,0;;;83,0;;;8,0;1,0;41,0;11,0;15,0;10,0;61,0;19,0;20,0;3,0;;19,0;20,0;7,0;4,0;68,0;5,0;10,0;16,0;3,0;201,0;30,0;3,0;23,0;3,0;9,0;22,0;108,0;7,0;7,0;3,0;3,0;42,0;;8,0;;7,0;1,0;21,0;45,0;40,0;43,0;4,0;7,0;46,0;4,0;;1,0;9,0;3,0;5,0;23,0;5,0;;2,0;5,0;1,0;;4,0;1,0;185,0;11,0;;11,0;11,0;33,0;;42,0;;3,0;1,0;;5,0;18,0;27,0;;21,0;33,0;;14,0;75,0;;35,0;16,0;4,0;48,0;158,0;2,0;20,0;2,0;;10,0;2,0;11,0;1,0;22,0;10,0;5,0;45,0;4,0;;1,0;3,0;20,0;;5,0;;18,0;71,0;19,0;5,0;21,0;;16,0;2,0;51,0;21,0;;2,0;4,0;11,0;99,0;;;3,0;;;;29,0;;;4,0;5,0;7,0;;3,0;;43,0;;;2,0;2,0;4,0;7,0;2,0;4,0;8,0;;17,0;3,0;2,0;;1,0;;7,0;;;;;9,0;6,0;;4,0;1,0;;;15,0;1,0;1,0;8,0;;28,0;14,0;1,0;;;8,0;1,0;;;;;;2,0;15,0;1,0;13,0;;1,0;;;1,0;3,0;3,0;;;;;;;8,0;1,0;4,0;11,0;;1,0;2,0;4,0;12,0;18,0;39,0;40,0;3,0;2,0;28,0;2,0;24,0;10,0;6,0;;8,0;2,0;;35,0;2,0;7,0;8,0;4,0;2,0;9,0;4,0;1,0;12,0;;11,0;74,0;4,0;;3,0;28,0;1,0;4,0;1,0;4,0;4,0;1,0;;4,0;;5,0;7,0;11,0;;7,0;3,0;;;6,0;23,0;1,0;1,0;7,0;;2,0;2,0;3,0;7,0;2,0;;19,0;3,0;2,0;15,0;13,0;1,0;1,0;;4,0;4,0;84,0;20,0;3,0;5,0;16,0;;3,0;;6,0;5,0;10,0;26,0;;;1,0;6,0;3,0;7,0;1,0;2,0;;3,0;5,0;7,0;3,0;;2,0;2,0;2,0;1,0;10,0;;;8,0;28,0;3,0;1,0;3,0;4,0;;4,0;22,0;;25,0;;;;1,0;9,0;;;;14,0;;3,0;;8,0;2,0;;;3,0;;;4,0;2,0;;;16,0;9,0;;16,0;;;;7,0;11,0;4,0;8,0;6,0;11,0;1,0;;;18,0;;1,0;7,0;3,0;1,0;1,0;1,0;;;;;;;;;11,0;14,0;2,0;1,0;11,0;2,0;11,0;;4,0;3,0;2,0;;;2,0;;;1,0;;3,0;6,0;25,0;;;4,0;16,0;;14,0;;;;2,0;4,0;;;;;;;;4,0;7,0;17,0;;2,0;32,0;;6,0;;14,0;;;;;;;1,0;2,0;2,0;3,0;;5,0;17,0;11,0;1,0;;;;;10,0;2,0;3,0;5,0;1,0;10,0;2,0;10,0;;;12,0;1,0;;3,0;2,0;41,0;;;;;;;1,0;7,0;8,0;14,0;6,0;1,0;;7,0;;;;1,0;;;2,0;3,0;;;;;;;1,0;;;2,0;;3,0;;13,0;2,0;5,0;;;;1,0;2,0;1,0;2,0;12,0;2,0;1,0;;;9,0;6,0;;;1,0;;4,0;;2,0;1,0;;;;
substrate;1,0;;5,0;;32,0;;16,0;53,0;2,0;42,0;1,0;1,0;2,0;1,0;13,0;1,0;;;23,0;6,0;;20,0;;2,0;6,0;;;7,0;1,0;7,0;23,0;14,0;175,0;;61,0;4,0;10,0;123,0;8,0;59,0;7,0;;12,0;189,0;;;1,0;;1,0;;6,0;16,0;1,0;13,0;6,0;278,0;212,0;;14,0;227,0;2,0;;105,0;;;5,0;14,0;7,0;;2,0;121,0;2,0;3,0;1,0;20,0;;27,0;3,0;91,0;4,0;7,0;45,0;7,0;7,0;2,0;2,0;97,0;;;10,0;213,0;4,0;14,0;45,0;6,0;25,0;;;8,0;;703,0;49,0;51,0;16,0;;;41,0;87,0;;;4,0;79,0;96,0;25,0;51,0;;;;43,0;16,0;34,0;2,0;;122,0;32,0;;53,0;62,0;;126,0;77,0;5,0;28,0;;;31,0;146,0;;177,0;44,0;1,0;;20,0;88,0;26,0;4,0;315,0;33,0;;18,0;;10,0;4,0;22,0;5,0;89,0;35,0;45,0;;95,0;32,0;1,0;18,0;5,0;2,0;176,0;5,0;200,0;;78,0;57,0;;213,0;175,0;3,0;21,0;25,0;21,0;48,0;;7,0;7,0;14,0;1,0;;25,0;55,0;166,0;;224,0;5,0;;7,0;81,0;2,0;6,0;20,0;;10,0;29,0;274,0;9,0;9,0;129,0;;2,0;1,0;;40,0;82,0;;15,0;3,0;5,0;;10,0;8,0;169,0;;1,0;74,0;3,0;3,0;8,0;11,0;8,0;3,0;2,0;;3,0;2,0;;20,0;62,0;8,0;4,0;;26,0;60,0;1,0;25,0;2,0;7,0;77,0;24,0;7,0;7,0;92,0;;15,0;3,0;;64,0;186,0;5,0;1,0;6,0;30,0;;8,0;4,0;;11,0;6,0;6,0;1,0;14,0;;;5,0;93,0;65,0;24,0;3,0;15,0;4,0;;;1,0;34,0;27,0;2,0;;6,0;36,0;;15,0;2,0;1,0;39,0;2,0;;1,0;36,0;;17,0;34,0;;42,0;;3,0;;25,0;29,0;16,0;3,0;3,0;2,0;34,0;20,0;6,0;6,0;;;;;;;;28,0;1,0;1,0;1,0;;;34,0;78,0;2,0;21,0;;1,0;;;;;;1,0;;2,0;2,0;;1,0;;3,0;;;;;12,0;1,0;25,0;;;;;;1,0;;;2,0;;;;;2,0;;;;47,0;;;11,0;;2,0;2,0;14,0;7,0;;;30,0;7,0;39,0;;1,0;8,0;;;1,0;;2,0;1,0;1,0;3,0;;2,0;9,0;;10,0;;2,0;;;;;;;;;;;10,0;6,0;23,0;4,0;;;;;10,0;;5,0;3,0;;3,0;3,0;2,0;;5,0;1,0;;;;;;;;3,0;;;;;;62,0;5,0;2,0;13,0;29,0;20,0;;9,0;;;7,0;3,0;8,0;19,0;;;4,0;;;;;;;2,0;54,0;;;;4,0;8,0;;;;1,0;54,0;;;;;;;;;4,0;5,0;;;;;8,0;10,0;2,0;12,0;8,0;;14,0;1,0;;;;;;14,0;;;2,0;;2,0;14,0;;;4,0;5,0;49,0;10,0;;;;;;;;;;10,0;;;13,0;;;21,0;;;;;;2,0;;;4,0;;7,0;14,0;5,0;;;;;;3,0;10,0;;;10,0;1,0;15,0;4,0;;38,0;1,0;;;;;21,0;;;;;1,0;;;8,0;1,0;10,0;;23,0;;;;;;;46,0;;;;;;31,0;;55,0;18,0;18,0;16,0;;3,0;2,0;;;1,0;;;;1,0;6,0;;;;6,0;;;;;4,0;;;2,0;8,0;3,0;;6,0;3,0;;;;2,0;;;153,0;;;2,0;4,0;;;3,0;;;;13,0;;;;;;9,0;;;41,0;;;2,0;1,0;;;1,0;2,0;2,0;;;;2,0;10,0;1,0;1,0;1,0;2,0;;;;52,0;7,0;;16,0;;9,0;;;;4,0;;3,0;;28,0;2,0;;;2,0;8,0;;;;;17,0;3,0;3,0;2,0;;;;3,0;;;37,0;;;18,0;3,0;1,0;;;;;42,0;;;3,0;37,0;;35,0;10,0;7,0;;;;;;1,0;;2,0;;;;1,0;;;;;4,0;;;;;1,0;2,0;3,0;;2,0;;;;;;;;44,0;1,0;;1,0;;;;4,0;;;;;;3,0;;;2,0;;1,0;;;;;;1,0;;;;;;;;;;;;2,0;;;;;;;;;4,0;;;1,0;;5,0;;16,0;;;3,0;;;;;;;;;1,0;;;1,0;;;28,0;;6,0;4,0;;;;;6,0;;2,0;;;1,0;15,0;;;;8,0;;;;2,0;;;;;;2,0;;26,0;;8,0;;;7,0;;;;5,0;3,0;;7,0;;3,0;1,0;;4,0;;;;;;;7,0;;1,0;21,0;;24,0;;;;;;;;2,0;8,0;;;;;1,0;1,0;;;;;;;;8,0;;;;;1,0;;;;1,0;;1,0;;;1,0;1,0;;;;10,0;;;;;1,0;;;;;;;;3,0;9,0;;;;2,0;3,0;;36,0;4,0;15,0;3,0;;3,0;;7,0;;3,0;;;;19,0;;;;1,0;;;;;;;;2,0;;;;;;;;;19,0;;;;;;;1,0;;;;10,0;;;;
surface;2,0;7,0;26,0;2,0;129,0;142,0;248,0;288,0;8,0;226,0;67,0;14,0;30,0;76,0;21,0;5,0;;3,0;91,0;12,0;51,0;128,0;38,0;9,0;13,0;9,0;65,0;47,0;43,0;119,0;70,0;65,0;493,0;18,0;90,0;15,0;69,0;239,0;5,0;293,0;210,0;5,0;30,0;856,0;;1,0;25,0;43,0;31,0;19,0;21,0;64,0;;142,0;78,0;1374,0;556,0;;52,0;2209,0;2,0;;218,0;;33,0;17,0;37,0;7,0;4,0;51,0;645,0;12,0;25,0;201,0;79,0;10,0;4,0;122,0;373,0;89,0;31,0;39,0;14,0;16,0;7,0;159,0;237,0;18,0;39,0;10,0;313,0;7,0;5,0;44,0;29,0;87,0;1,0;6,0;29,0;703,0;;266,0;31,0;16,0;1,0;;19,0;618,0;10,0;14,0;42,0;206,0;71,0;108,0;178,0;7,0;21,0;;132,0;411,0;44,0;9,0;4,0;101,0;44,0;33,0;150,0;448,0;4,0;108,0;294,0;6,0;7,0;77,0;7,0;67,0;431,0;25,0;116,0;42,0;21,0;;116,0;458,0;113,0;16,0;945,0;106,0;2,0;37,0;;164,0;157,0;24,0;35,0;137,0;84,0;415,0;25,0;569,0;227,0;10,0;681,0;96,0;3,0;205,0;11,0;779,0;;72,0;528,0;203,0;469,0;489,0;44,0;369,0;660,0;38,0;16,0;;81,0;15,0;82,0;23,0;17,0;162,0;198,0;319,0;2,0;797,0;16,0;85,0;28,0;239,0;14,0;491,0;169,0;10,0;97,0;35,0;111,0;107,0;35,0;1605,0;34,0;23,0;21,0;17,0;59,0;289,0;15,0;20,0;6,0;12,0;69,0;9,0;56,0;136,0;3,0;53,0;319,0;108,0;3,0;17,0;162,0;10,0;107,0;23,0;20,0;79,0;22,0;;17,0;133,0;40,0;168,0;60,0;41,0;235,0;4,0;190,0;38,0;50,0;460,0;15,0;54,0;24,0;106,0;115,0;38,0;7,0;1,0;43,0;139,0;30,0;5,0;115,0;242,0;4,0;104,0;28,0;50,0;93,0;16,0;83,0;50,0;195,0;13,0;22,0;236,0;33,0;487,0;20,0;12,0;27,0;47,0;2,0;3,0;12,0;139,0;28,0;73,0;5,0;80,0;35,0;20,0;52,0;671,0;58,0;285,0;8,0;29,0;5,0;52,0;4,0;177,0;29,0;43,0;176,0;27,0;42,0;19,0;91,0;98,0;99,0;64,0;1,0;57,0;298,0;125,0;71,0;24,0;1,0;5,0;76,0;18,0;17,0;48,0;13,0;11,0;6,0;32,0;60,0;69,0;12,0;60,0;23,0;31,0;18,0;1,0;27,0;16,0;16,0;;4,0;5,0;;;3,0;12,0;30,0;35,0;2,0;6,0;;4,0;;6,0;6,0;17,0;103,0;1,0;9,0;10,0;3,0;7,0;6,0;1,0;17,0;7,0;;12,0;53,0;7,0;14,0;11,0;23,0;1,0;16,0;5,0;11,0;33,0;;34,0;23,0;12,0;16,0;;30,0;223,0;;101,0;5,0;17,0;4,0;;1,0;5,0;2,0;43,0;9,0;13,0;9,0;4,0;47,0;10,0;2,0;90,0;7,0;7,0;11,0;;15,0;2,0;8,0;1,0;4,0;73,0;3,0;4,0;17,0;23,0;6,0;27,0;1,0;3,0;23,0;1,0;16,0;47,0;74,0;1,0;;24,0;9,0;8,0;2,0;3,0;;27,0;;1,0;9,0;;2,0;15,0;;;;15,0;13,0;46,0;8,0;4,0;24,0;22,0;34,0;50,0;18,0;3,0;;2,0;68,0;36,0;21,0;2,0;;;5,0;;;;;22,0;13,0;17,0;64,0;1,0;1,0;;11,0;14,0;28,0;2,0;5,0;7,0;57,0;1,0;3,0;1,0;;6,0;;2,0;43,0;39,0;77,0;;1,0;9,0;4,0;49,0;16,0;23,0;41,0;83,0;4,0;30,0;4,0;;;;;5,0;63,0;23,0;;33,0;8,0;36,0;43,0;1,0;;12,0;10,0;41,0;20,0;1,0;1,0;;4,0;18,0;13,0;1,0;;13,0;5,0;;2,0;40,0;;;108,0;1,0;10,0;1,0;42,0;;4,0;3,0;2,0;6,0;;28,0;101,0;4,0;6,0;8,0;;;14,0;8,0;15,0;1,0;3,0;15,0;4,0;4,0;7,0;19,0;47,0;1,0;2,0;;1,0;1,0;97,0;;2,0;;4,0;;;;61,0;7,0;49,0;;10,0;5,0;2,0;3,0;58,0;10,0;2,0;65,0;57,0;;;;;34,0;;;36,0;30,0;12,0;2,0;2,0;24,0;8,0;2,0;22,0;6,0;11,0;;6,0;15,0;1,0;2,0;26,0;40,0;17,0;;3,0;3,0;6,0;5,0;;1,0;4,0;2,0;;31,0;10,0;2,0;1,0;1,0;2,0;19,0;;36,0;3,0;35,0;10,0;53,0;99,0;12,0;7,0;7,0;6,0;8,0;218,0;8,0;392,0;6,0;4,0;;24,0;29,0;8,0;93,0;2,0;21,0;17,0;16,0;68,0;14,0;10,0;16,0;48,0;5,0;;268,0;266,0;6,0;3,0;7,0;26,0;3,0;;7,0;3,0;21,0;25,0;7,0;46,0;8,0;14,0;;;;4,0;10,0;17,0;;10,0;5,0;;1,0;2,0;20,0;9,0;15,0;;;5,0;21,0;35,0;1,0;28,0;1,0;;6,0;12,0;105,0;34,0;;;9,0;3,0;20,0;;4,0;;;37,0;;;29,0;8,0;;19,0;2,0;5,0;2,0;;;5,0;;14,0;;10,0;25,0;2,0;;3,0;6,0;1,0;31,0;;6,0;1,0;7,0;10,0;1,0;7,0;6,0;54,0;2,0;5,0;2,0;;7,0;;5,0;4,0;1,0;5,0;13,0;2,0;8,0;4,0;20,0;2,0;19,0;31,0;3,0;1,0;3,0;11,0;2,0;12,0;;10,0;28,0;1,0;9,0;9,0;3,0;;5,0;;1,0;;12,0;23,0;;17,0;;;1,0;;1,0;9,0;4,0;;71,0;;6,0;4,0;;;44,0;2,0;;37,0;4,0;17,0;1,0;2,0;6,0;1,0;7,0;23,0;1,0;1,0;1,0;5,0;;;;21,0;;2,0;22,0;21,0;3,0;81,0;24,0;20,0;27,0;25,0;10,0;32,0;2,0;6,0;56,0;3,0;2,0;7,0;;65,0;;1,0;2,0;5,0;;3,0;10,0;21,0;;6,0;;;12,0;16,0;;25,0;15,0;62,0;2,0;18,0;18,0;79,0;;49,0;9,0;;8,0;12,0;;5,0;;13,0;4,0;7,0;;2,0;1,0;10,0;48,0;10,0;10,0;13,0;10,0;1,0;4,0;4,0;;;3,0;1,0;;;4,0;;;;7,0;2,0;24,0;1,0;9,0;6,0;;;3,0;3,0;;8,0;1,0;;;;40,0;5,0;;3,0;12,0;;3,0;2,0;;;8,0;1,0;13,0;1,0;1,0;10,0;1,0;;;;;3,0;3,0;;1,0;;;;5,0;;;;5,0;4,0;11,0;13,0;3,0;47,0;27,0;;15,0;11,0;8,0;91,0;21,0;34,0;;5,0;32,0;1,0;35,0;2,0;8,0;1,0;;9,0;26,0;2,0;6,0;3,0;;12,0;19,0;11,0;;;;2,0;4,0;;3,0;2,0;;;;;3,0;2,0;6,0;;255,0;1,0;;;
system;20,0;96,0;72,0;37,0;343,0;10,0;415,0;330,0;95,0;526,0;77,0;56,0;18,0;23,0;128,0;44,0;22,0;48,0;207,0;299,0;368,0;926,0;769,0;69,0;135,0;8,0;5,0;545,0;66,0;215,0;277,0;290,0;1335,0;44,0;687,0;35,0;36,0;149,0;21,0;458,0;210,0;39,0;235,0;380,0;20,0;24,0;25,0;828,0;387,0;22,0;117,0;243,0;9,0;554,0;20,0;3035,0;1434,0;8,0;651,0;3429,0;28,0;61,0;898,0;17,0;38,0;139,0;146,0;29,0;14,0;158,0;3858,0;204,0;138,0;3,0;;146,0;2,0;180,0;656,0;374,0;5,0;522,0;332,0;45,0;11,0;17,0;119,0;10,0;57,0;143,0;546,0;10,0;131,0;619,0;51,0;53,0;10,0;97,0;100,0;49,0;266,0;;;66,0;10,0;48,0;85,0;975,0;4,0;1,0;138,0;102,0;154,0;175,0;101,0;21,0;13,0;2,0;34,0;280,0;4,0;8,0;34,0;124,0;19,0;8,0;559,0;27,0;28,0;163,0;36,0;29,0;11,0;3,0;57,0;174,0;91,0;1,0;5,0;46,0;19,0;30,0;109,0;62,0;95,0;18,0;605,0;245,0;100,0;8,0;3,0;3,0;106,0;7,0;59,0;32,0;11,0;164,0;176,0;1398,0;58,0;29,0;14,0;23,0;83,0;29,0;61,0;708,0;28,0;32,0;139,0;171,0;370,0;318,0;191,0;43,0;28,0;182,0;9,0;7,0;13,0;11,0;61,0;31,0;40,0;119,0;47,0;606,0;5,0;218,0;2,0;2,0;54,0;274,0;4,0;69,0;42,0;3,0;57,0;31,0;13,0;35,0;10,0;314,0;;26,0;30,0;28,0;129,0;220,0;69,0;25,0;20,0;10,0;48,0;160,0;98,0;16,0;7,0;11,0;10,0;377,0;62,0;50,0;4,0;41,0;27,0;8,0;11,0;1,0;4,0;37,0;49,0;34,0;183,0;213,0;9,0;25,0;196,0;85,0;133,0;12,0;31,0;4,0;24,0;29,0;29,0;49,0;;5,0;6,0;14,0;;94,0;44,0;16,0;10,0;158,0;18,0;13,0;21,0;102,0;25,0;6,0;15,0;7,0;41,0;4,0;11,0;8,0;11,0;47,0;7,0;9,0;8,0;195,0;14,0;2,0;787,0;72,0;18,0;8,0;29,0;130,0;3,0;156,0;145,0;766,0;152,0;1,0;37,0;13,0;35,0;72,0;;11,0;17,0;545,0;22,0;;106,0;;144,0;73,0;70,0;6,0;22,0;109,0;39,0;3,0;224,0;73,0;67,0;157,0;37,0;3,0;12,0;2,0;1,0;10,0;8,0;58,0;34,0;4,0;2,0;188,0;1,0;9,0;60,0;9,0;178,0;15,0;15,0;14,0;6,0;1,0;5,0;41,0;9,0;25,0;8,0;101,0;16,0;30,0;117,0;19,0;20,0;40,0;8,0;121,0;32,0;35,0;81,0;10,0;3,0;24,0;5,0;5,0;6,0;22,0;32,0;8,0;11,0;4,0;68,0;19,0;17,0;11,0;82,0;76,0;32,0;13,0;6,0;81,0;51,0;111,0;54,0;12,0;122,0;40,0;29,0;228,0;16,0;81,0;47,0;14,0;37,0;7,0;15,0;198,0;21,0;60,0;17,0;57,0;120,0;49,0;25,0;230,0;38,0;15,0;219,0;4,0;42,0;4,0;32,0;21,0;123,0;1558,0;9,0;48,0;23,0;51,0;16,0;36,0;14,0;199,0;34,0;22,0;188,0;77,0;118,0;44,0;11,0;146,0;165,0;17,0;31,0;26,0;43,0;96,0;39,0;15,0;5,0;61,0;1,0;22,0;23,0;13,0;50,0;53,0;28,0;4,0;55,0;13,0;29,0;312,0;43,0;49,0;10,0;48,0;4,0;57,0;169,0;64,0;16,0;39,0;62,0;5,0;86,0;20,0;9,0;9,0;16,0;11,0;26,0;329,0;92,0;27,0;111,0;13,0;;214,0;43,0;17,0;20,0;11,0;224,0;25,0;74,0;8,0;18,0;20,0;18,0;4,0;4,0;53,0;101,0;25,0;16,0;67,0;11,0;122,0;29,0;34,0;970,0;310,0;143,0;12,0;16,0;1,0;8,0;11,0;6,0;20,0;125,0;24,0;4,0;10,0;22,0;7,0;8,0;1,0;17,0;102,0;211,0;33,0;20,0;8,0;18,0;2,0;13,0;5,0;32,0;35,0;6,0;21,0;82,0;41,0;13,0;21,0;10,0;19,0;8,0;12,0;46,0;15,0;14,0;20,0;23,0;2,0;9,0;18,0;5,0;10,0;15,0;11,0;64,0;25,0;16,0;9,0;15,0;30,0;10,0;29,0;217,0;4,0;93,0;21,0;14,0;62,0;164,0;10,0;45,0;1,0;11,0;9,0;86,0;1,0;2,0;6,0;12,0;22,0;45,0;21,0;;15,0;6,0;27,0;;31,0;6,0;56,0;216,0;30,0;14,0;74,0;4,0;1,0;;33,0;171,0;9,0;4,0;87,0;20,0;10,0;8,0;3,0;34,0;4,0;65,0;6,0;67,0;57,0;91,0;15,0;92,0;15,0;15,0;7,0;8,0;7,0;11,0;6,0;11,0;9,0;175,0;11,0;4,0;14,0;8,0;2,0;20,0;39,0;21,0;6,0;5,0;32,0;81,0;7,0;14,0;26,0;29,0;107,0;109,0;6,0;153,0;;34,0;16,0;9,0;13,0;17,0;11,0;18,0;5,0;21,0;7,0;12,0;6,0;20,0;25,0;11,0;1,0;8,0;8,0;5,0;8,0;14,0;16,0;50,0;2,0;11,0;22,0;21,0;28,0;62,0;4,0;2,0;9,0;1,0;285,0;36,0;11,0;16,0;156,0;1,0;11,0;1,0;7,0;2,0;1,0;10,0;18,0;194,0;6,0;;11,0;2,0;6,0;2,0;102,0;15,0;14,0;14,0;5,0;11,0;14,0;94,0;5,0;44,0;4,0;15,0;41,0;8,0;4,0;5,0;7,0;5,0;129,0;9,0;10,0;10,0;54,0;3,0;10,0;11,0;15,0;15,0;30,0;10,0;36,0;3,0;10,0;;19,0;23,0;15,0;3,0;3,0;62,0;53,0;24,0;12,0;14,0;18,0;1,0;7,0;37,0;7,0;36,0;27,0;13,0;30,0;23,0;23,0;35,0;19,0;365,0;4,0;18,0;45,0;54,0;23,0;9,0;15,0;59,0;44,0;7,0;29,0;15,0;41,0;95,0;32,0;8,0;21,0;1,0;17,0;10,0;29,0;25,0;18,0;7,0;57,0;28,0;89,0;8,0;19,0;13,0;96,0;10,0;30,0;9,0;25,0;3,0;78,0;77,0;6,0;;;5,0;7,0;24,0;54,0;33,0;8,0;7,0;18,0;8,0;1,0;30,0;3,0;16,0;15,0;13,0;9,0;15,0;21,0;21,0;9,0;17,0;7,0;6,0;127,0;;9,0;9,0;8,0;26,0;24,0;4,0;15,0;36,0;13,0;2,0;139,0;1,0;3,0;64,0;26,0;24,0;26,0;55,0;5,0;3,0;2,0;20,0;;40,0;6,0;10,0;6,0;15,0;44,0;10,0;10,0;;12,0;2,0;30,0;1,0;20,0;18,0;14,0;8,0;9,0;307,0;7,0;44,0;21,0;7,0;7,0;8,0;4,0;36,0;17,0;87,0;;10,0;13,0;7,0;85,0;18,0;11,0;13,0;;26,0;2,0;10,0;3,0;28,0;3,0;14,0;6,0;11,0;3,0;;4,0;10,0;15,0;;19,0;1,0;15,0;36,0;;11,0;6,0;15,0;29,0;22,0;5,0;11,0;2,0;;37,0;;20,0;6,0;3,0;11,0;59,0;9,0;57,0;8,0;31,0;26,0;8,0;14,0;67,0;8,0;13,0;4,0;3,0;6,0;19,0;17,0;24,0;20,0;2,0;12,0;12,0;8,0;5,0;13,0;8,0;73,0;1,0;;22,0;;11,0;27,0;37,0;3,0;3,0;6,0;12,0;;7,0;;7,0;5,0;23,0;3,0;2,0;15,0;;1,0;15,0;10,0;5,0;;1,0;12,0;9,0;21,0;2,0;10,0;;16,0;13,0;62,0;3,0;3,0;3,0;35,0;3,0;3,0;1,0;1,0;7,0;;5,0;10,0;15,0;4,0;6,0;3,0;2,0;4,0;;1,0;23,0;27,0;10,0;4,0;4,0;;
trace;1,0;;;;1,0;;;;;;;4,0;;;;;;;;;;;;;;;1,0;2,0;;;;;;;;;;1,0;;4,0;;;;;;;;;1,0;;;;;1,0;;32,0;3,0;;;14,0;;;12,0;;;;1,0;;;7,0;1,0;;6,0;;;;;2,0;2,0;;;;;;;;1,0;;;;13,0;;;;;;;;2,0;51,0;31,0;;;;;;2,0;10,0;;;;;;;;;;;;;11,0;;;;;;;3,0;;8,0;;2,0;;;;;;;;;;;;1,0;;;5,0;6,0;;;;1,0;;;;;;;;;;;;;;;;1,0;;1,0;1,0;;6,0;1,0;11,0;;;;;;9,0;;1,0;;;;;;;3,0;;;;1,0;;;;;;;;2,0;;;;;;;;;;1,0;;;;2,0;;;;;;;;;;;;;;;;;;;1,0;;1,0;;2,0;;2,0;;;;1,0;;;;;;;;;9,0;;;;;;;;;;;1,0;;;;1,0;1,0;;;;;;;;;;;;;;;1,0;2,0;5,0;2,0;;;;;;6,0;;;;;;;;;2,0;;1,0;;;;;;;;;;;;;;;;;;;;;3,0;;2,0;;;2,0;;;;;;;;;;;2,0;;;;;;;;1,0;;1,0;;;;;;;;;2,0;;;;;;;;;;;;;;;4,0;;;;;2,0;;;;;;;;;2,0;;;;;1,0;;;1,0;;;;;;;;4,0;2,0;3,0;;2,0;;;;;;;;;;;1,0;;;;3,0;;;2,0;;;;;;;;;;;;;;;;;;2,0;;;2,0;;;;;;;;;;;;;;;;;;;;;;;5,0;;;;;;;;;;;;;;;;;;;;;;;;;;;;;;;;;;;;;;;;;;;;;;;;;;;;;;;;;;;;;;;;;;;;;;;;;;;;;;1,0;1,0;;1,0;;;;;;;2,0;;;;;;;;;;;;;;;;;;;;;;;2,0;;;1,0;;;;;;;;;;;;;;;;;;;;;;;;;;;;;;;;;;;;;;;;;;;;;;;;1,0;;;;;;;;;;;;;;2,0;;6,0;;;;;;;;;;;1,0;;;;;;;;;;;;;;;;;;;;;;;;;;;;;;;;;;;;;;;;;;;;;;;;;;;;;;;;;;;;;;4,0;;;;;;;;;;;;;;;;;;;;;;;;;1,0;;;;;;1,0;;;;;;;;;;;;;5,0;;;;;;;1,0;;;;;;;;;;;;;2,0;;;;;;;4,0;;4,0;;;;1,0;;;;;;;;;;;;;;;;;;;;;;;;;;;;;;;;;;;;;;;;;;;1,0;;;;;;;;;;;;;;;;;1,0;;;;;;;8,0;;;;;;;;;1,0;1,0;;;;;;;;;;;;;;;;;;;;;;;;;;;;;;;;;;;;;;;;;;;;;;;;;;;;;;;;;;;;;;;;;;;;;;;;;;1,0;;;3,0;;;;;;;;;;;;;;;;;;;;;;;;;;;;;;;;;;;;;;;;;;4,0;;;;
transfer;2,0;2,0;20,0;;28,0;;9,0;34,0;2,0;65,0;4,0;7,0;;1,0;21,0;;;;61,0;16,0;4,0;187,0;3,0;2,0;1,0;;8,0;656,0;1,0;20,0;4,0;19,0;267,0;7,0;101,0;;1,0;140,0;2,0;26,0;4,0;;64,0;47,0;2,0;;1,0;;9,0;5,0;58,0;57,0;3,0;25,0;4,0;455,0;156,0;;32,0;91,0;3,0;;171,0;;;44,0;7,0;;3,0;51,0;3,0;2,0;32,0;;;48,0;;10,0;49,0;28,0;13,0;34,0;21,0;4,0;;;137,0;;;79,0;40,0;14,0;3,0;440,0;4,0;18,0;;18,0;37,0;16,0;16,0;66,0;;;;5,0;23,0;629,0;4,0;;24,0;67,0;47,0;4,0;8,0;;21,0;1,0;4,0;19,0;;;2,0;58,0;1,0;8,0;58,0;19,0;;9,0;12,0;;;;;3,0;15,0;;641,0;;6,0;;51,0;4,0;2,0;11,0;93,0;35,0;;;1,0;;6,0;24,0;74,0;6,0;;10,0;;68,0;3,0;2,0;;4,0;1,0;136,0;13,0;19,0;6,0;3,0;12,0;1,0;65,0;6,0;7,0;;;62,0;;;;3,0;;;;8,0;10,0;196,0;;69,0;;;;73,0;2,0;;;;60,0;5,0;28,0;12,0;;27,0;;3,0;59,0;2,0;10,0;3,0;18,0;2,0;16,0;2,0;;83,0;24,0;;;;8,0;;;;8,0;;;;;;;;5,0;19,0;12,0;6,0;;38,0;4,0;8,0;22,0;;3,0;;1,0;;181,0;14,0;2,0;5,0;156,0;3,0;4,0;134,0;3,0;;4,0;7,0;2,0;;;59,0;1,0;;;;36,0;;;;;;;14,0;;25,0;7,0;;;8,0;;;;74,0;1,0;;1,0;12,0;3,0;3,0;;3,0;1,0;4,0;;8,0;97,0;12,0;;;2,0;;20,0;;;;;6,0;;;15,0;35,0;;;37,0;;;;2,0;;;;4,0;;;9,0;1,0;;33,0;;24,0;4,0;;;;55,0;;1,0;7,0;;;7,0;1,0;6,0;;17,0;;5,0;19,0;4,0;11,0;7,0;4,0;;;;;;1,0;;;;;2,0;2,0;8,0;1,0;;5,0;4,0;3,0;;;13,0;17,0;26,0;6,0;;;11,0;32,0;24,0;;4,0;88,0;;5,0;;;49,0;;18,0;46,0;;;11,0;16,0;1,0;1,0;1,0;;;2,0;1,0;;;;2,0;2,0;;2,0;3,0;89,0;;7,0;9,0;;;14,0;;7,0;1,0;12,0;7,0;49,0;;;103,0;14,0;;11,0;;;;;3,0;2,0;;5,0;2,0;;;;;17,0;18,0;81,0;25,0;5,0;1,0;;8,0;14,0;4,0;;15,0;7,0;;2,0;9,0;3,0;;;2,0;;2,0;1,0;3,0;1,0;;1,0;21,0;;;7,0;5,0;5,0;;;;40,0;;45,0;;;24,0;4,0;20,0;3,0;3,0;;55,0;1,0;15,0;43,0;7,0;2,0;27,0;;;5,0;44,0;;;2,0;;;;1,0;;;;20,0;2,0;27,0;14,0;3,0;;;2,0;1,0;;9,0;;;1,0;8,0;;1,0;;6,0;;;9,0;96,0;;;;1,0;;;;12,0;1,0;;;1,0;8,0;23,0;;;1,0;1,0;4,0;30,0;1,0;31,0;1,0;5,0;15,0;135,0;42,0;3,0;;;21,0;3,0;;;;;4,0;32,0;20,0;;;;;;6,0;;5,0;4,0;6,0;;13,0;;2,0;;1,0;10,0;;;;20,0;381,0;;;3,0;;1,0;;8,0;;;2,0;;;;8,0;;12,0;;;;;3,0;;;;19,0;;;7,0;6,0;;;1,0;2,0;;;14,0;;11,0;;;;;;;;6,0;;;;2,0;1,0;;;;;13,0;;;;;1,0;;9,0;;;;12,0;;;6,0;;;1,0;;;;;2,0;255,0;;;;5,0;;6,0;17,0;;2,0;;20,0;11,0;;1,0;29,0;5,0;61,0;;;;31,0;125,0;261,0;1,0;;2,0;1,0;;;2,0;;49,0;;6,0;17,0;5,0;3,0;11,0;8,0;;1,0;242,0;;8,0;1,0;;;;6,0;20,0;;;8,0;1,0;;1,0;49,0;;4,0;;6,0;;;2,0;;;;;30,0;;;;1,0;2,0;;;;;2,0;;;;;22,0;5,0;;;;;;1,0;;;3,0;3,0;6,0;;14,0;;1,0;49,0;;;15,0;;;;;;;;;;;2,0;7,0;;;;11,0;1,0;4,0;;;;;;;;;;;;;4,0;;3,0;;1,0;;;;3,0;;;;1,0;3,0;;;;;;;;;10,0;;;;;;;;2,0;;;2,0;1,0;;;21,0;;;;;;;1,0;;;2,0;;;;;3,0;;2,0;;;;2,0;1,0;;;2,0;1,0;;;;2,0;19,0;13,0;;;;;5,0;;2,0;;;;;;;;;;;8,0;;22,0;;10,0;;;;;;2,0;;;;;;1,0;;12,0;3,0;;;;;3,0;1,0;;4,0;5,0;1,0;;;;;7,0;;;;;;;;;;;;2,0;2,0;107,0;;1,0;;;;4,0;;;;1,0;;;2,0;;;;;;;;;;;;;;1,0;;;7,0;;6,0;2,0;3,0;;;;;;;;;2,0;;;;;;;;;;;;
transitory;1,0;;3,0;;5,0;;1,0;13,0;1,0;11,0;;4,0;;1,0;7,0;2,0;2,0;;3,0;159,0;8,0;15,0;4,0;;5,0;;2,0;18,0;;4,0;3,0;10,0;21,0;3,0;11,0;2,0;;5,0;;9,0;3,0;;;;;1,0;;2,0;7,0;2,0;;10,0;1,0;1,0;1,0;87,0;7,0;;4,0;3,0;;2,0;23,0;2,0;1,0;;5,0;;;9,0;;3,0;2,0;2,0;;5,0;;9,0;23,0;1,0;;13,0;21,0;;1,0;;6,0;;3,0;5,0;3,0;1,0;1,0;5,0;3,0;4,0;;102,0;55,0;;1,0;10,0;;;;;1,0;7,0;;;;2,0;;;;;;;;;;;;;;;3,0;1,0;1,0;1,0;;1,0;;;;;;;;;;2,0;1,0;4,0;1,0;1,0;1,0;8,0;;;;;;;;;;;;4,0;;;;;3,0;;2,0;1,0;1,0;;;;;;9,0;;;4,0;;;;1,0;;1,0;;3,0;;14,0;;4,0;;;;2,0;;;;;1,0;;;1,0;;;;1,0;;;1,0;;;;;1,0;2,0;9,0;;;;;;1,0;1,0;;;;1,0;;;;;;;1,0;;3,0;;2,0;8,0;;;;;;;;;;;;;1,0;;;;;;;;;1,0;1,0;;;;;1,0;;;;;2,0;;;2,0;1,0;;;1,0;;;1,0;2,0;;;;1,0;20,0;;;;;;2,0;;;;3,0;;;;;14,0;;;;;2,0;;;2,0;2,0;;;;;;;;;;;;;;1,0;;;;2,0;5,0;1,0;;1,0;;;;;;;;5,0;;;1,0;;2,0;4,0;;2,0;1,0;1,0;2,0;;;;;;;;1,0;;;;2,0;1,0;;;;5,0;;;;1,0;354,0;10,0;;2,0;;;1,0;;24,0;53,0;;2,0;;;156,0;33,0;;1,0;;;;2,0;;6,0;7,0;;5,0;;;;4,0;;9,0;4,0;;;;;;;;3,0;10,0;;8,0;;;1,0;2,0;2,0;8,0;2,0;;;2,0;2,0;3,0;;;;;;;;;;;;;;;;;;;;;13,0;6,0;;;1,0;2,0;;30,0;;;;;;;1,0;;1,0;11,0;;;10,0;;3,0;;1,0;;;1,0;;;;1,0;;;;2,0;;;7,0;;2,0;4,0;;12,0;10,0;;1,0;1,0;;;;;;;;;;;;;;;8,0;;;;;;;;;;1,0;;;;;;;1,0;;;;3,0;;;1,0;1,0;;;;;;;;1,0;22,0;;;1,0;34,0;;;2,0;;;;1,0;5,0;11,0;;;;;;2,0;;;;;;;2,0;;;;2,0;;;;1,0;9,0;;;3,0;;;1,0;6,0;1,0;;;;2,0;;;;;;;;1,0;;;;;;;;;;;;;;;;;;;;1,0;;;;;;;;;;;2,0;;;;;1,0;;;;;;;;;;;;2,0;;;;;;;;;;;;;;;;;;;2,0;;;;;2,0;1,0;;2,0;;;;1,0;4,0;2,0;2,0;;;;;;;;4,0;;2,0;;;2,0;;;;;;;1,0;;;;1,0;8,0;;1,0;;;;;;;3,0;;;;;;;1,0;;;;;;1,0;2,0;;;;;2,0;1,0;;;;;;1,0;;1,0;2,0;3,0;4,0;;1,0;2,0;2,0;6,0;3,0;;;;;;1,0;;;;;;;4,0;;2,0;;;;1,0;;;;;;;;;3,0;;1,0;;;;;;;;4,0;;2,0;;;;;3,0;;;1,0;;;;1,0;;1,0;1,0;;;;;;;;1,0;;;;;;1,0;;;;;;;;4,0;;;;2,0;;;;;1,0;;3,0;2,0;1,0;;;2,0;;;;1,0;;;;2,0;;;;;;;;;;;;;;;;;;;;;;;;;;;;;;;;;;;;;;;;1,0;;;;4,0;;;;;;;;1,0;;;1,0;;;1,0;2,0;;;;;;;;;;;;;;;;;1,0;;;5,0;;;;;;;;1,0;;3,0;3,0;;;;;;;;;;;;;;;;;;;;;;;;1,0;;;;;;;;;;1,0;;;;;;;;;;;;;;;;;;;
trigger;2,0;1,0;2,0;;7,0;;3,0;17,0;2,0;31,0;;;;;;;1,0;4,0;;3,0;19,0;20,0;;;;;;5,0;;14,0;10,0;18,0;18,0;;10,0;2,0;;2,0;;1,0;;;4,0;3,0;6,0;;;;;;5,0;49,0;5,0;4,0;;86,0;11,0;;;2,0;;;44,0;;;4,0;5,0;;25,0;5,0;7,0;;;;;;2,0;;36,0;15,0;;4,0;4,0;3,0;;;2,0;;2,0;12,0;29,0;;1,0;146,0;;4,0;;1,0;13,0;;;48,0;;5,0;;;;22,0;;;2,0;;2,0;5,0;;;;;2,0;2,0;;;2,0;16,0;;;20,0;3,0;;2,0;;;;;;14,0;2,0;;6,0;3,0;;;30,0;;1,0;;15,0;6,0;;;;;;;;;;4,0;1,0;2,0;;3,0;;;;;3,0;8,0;;;;;13,0;1,0;2,0;2,0;;12,0;;;;5,0;;;;;;38,0;;9,0;1,0;;;26,0;;;;;1,0;;;;;;;2,0;3,0;;1,0;;;1,0;;;;53,0;3,0;;;2,0;;1,0;;;;;;;1,0;;1,0;;;;;2,0;;6,0;1,0;1,0;;;;;;;;;;;;;;17,0;;4,0;;6,0;1,0;;;;1,0;;5,0;;;;;;;;;2,0;;;;;;;;;;19,0;;24,0;3,0;1,0;4,0;;;;;;;;;;;;;;10,0;;;;;;;;;1,0;;;;;;;;;;1,0;;;;4,0;;;;;6,0;;1,0;;;;;2,0;;;2,0;3,0;;7,0;;;;;;5,0;;2,0;;;4,0;1,0;;;;;;1,0;;;2,0;6,0;;1,0;;1,0;;;;;;11,0;9,0;;;;4,0;;;1,0;23,0;;1,0;;;7,0;3,0;29,0;;;31,0;;;;11,0;1,0;;8,0;2,0;;;;;;;7,0;3,0;;;;;25,0;;;20,0;;7,0;4,0;;;1,0;;1,0;;;7,0;5,0;;;3,0;1,0;1,0;;;;;7,0;;;;;14,0;;;1,0;;;7,0;1,0;15,0;;;;;11,0;;;;;;;4,0;;;;;;8,0;;;3,0;;;1,0;;;;;;1,0;1,0;;;1,0;;5,0;6,0;21,0;;;11,0;1,0;;2,0;;;;1,0;;;;;;;;;;;1,0;1,0;1,0;;;;;;;;;;;;4,0;;;2,0;;;19,0;;;;1,0;1,0;;;;1,0;4,0;;;1,0;;;;;6,0;;;;2,0;;5,0;;;4,0;3,0;;;;;;5,0;;;1,0;;4,0;;;6,0;;;;;1,0;;2,0;;5,0;1,0;2,0;;;30,0;9,0;4,0;;;;;;;;2,0;;;1,0;9,0;1,0;;;;;;;;;;;1,0;;6,0;;;;;;;;;;;;3,0;;;;;;;;2,0;;;;;;;1,0;;;1,0;;;;;;;3,0;;;;;;;1,0;;1,0;;1,0;3,0;;;;;;;;;;;;;;4,0;;;;1,0;;;;3,0;3,0;;2,0;1,0;;;;;;;2,0;;3,0;;;;1,0;;;;1,0;5,0;;;1,0;2,0;8,0;;;2,0;;;;;;;;4,0;;;;;19,0;1,0;6,0;;;;;;;;4,0;;;;4,0;;;;2,0;;;;;1,0;;;;;4,0;;;;;;;;;;;2,0;;;;;;;;;1,0;;;1,0;;1,0;;;;;;4,0;2,0;;2,0;;1,0;1,0;;;;;;;;;;;;;;;;;2,0;;;2,0;;;;;1,0;8,0;1,0;;;;;;1,0;;1,0;2,0;;;;;;;1,0;;;;;2,0;;;;;;;1,0;;;;;;;;;;4,0;;;;;;;;;;;;;;;;;;;2,0;;;1,0;;;;;;;;;;;1,0;;;;;1,0;;;;;;;;;;;;;;;1,0;;2,0;;;;;;;;;;;;;;;;;2,0;;1,0;;;;;;;;1,0;;;;;;;;;2,0;;;;;;;;1,0;;;;;;;;;;;;;;;;;;;;;;;;;;;;;;;;;;;;;;;;
type;1,0;3,0;2,0;;57,0;;6,0;52,0;1,0;15,0;;4,0;;;18,0;18,0;2,0;1,0;1,0;3,0;83,0;35,0;;2,0;3,0;2,0;1,0;23,0;;23,0;27,0;25,0;70,0;14,0;47,0;7,0;1,0;65,0;1,0;31,0;;;11,0;40,0;;1,0;;3,0;37,0;2,0;12,0;2,0;;13,0;;160,0;99,0;;1,0;121,0;6,0;;32,0;;;55,0;3,0;;2,0;4,0;51,0;1,0;17,0;;;;1,0;7,0;21,0;1,0;;10,0;17,0;;1,0;1,0;272,0;;;31,0;65,0;1,0;3,0;61,0;3,0;;;2,0;16,0;41,0;19,0;85,0;2,0;23,0;1,0;;;32,0;9,0;;3,0;20,0;7,0;7,0;4,0;4,0;6,0;3,0;2,0;46,0;;;2,0;15,0;;;10,0;6,0;3,0;13,0;6,0;;1,0;;;2,0;22,0;;4,0;15,0;3,0;8,0;3,0;4,0;10,0;;83,0;10,0;;7,0;21,0;;;;;3,0;2,0;11,0;;25,0;;;10,0;;;103,0;7,0;93,0;1,0;41,0;14,0;4,0;64,0;24,0;3,0;3,0;;2,0;8,0;;;;;;;3,0;21,0;103,0;;21,0;;;1,0;23,0;1,0;1,0;;1,0;17,0;;178,0;11,0;;12,0;;;3,0;;1,0;;4,0;;;;;5,0;6,0;;;2,0;6,0;4,0;;;2,0;2,0;2,0;;1,0;;3,0;;10,0;33,0;2,0;6,0;1,0;3,0;11,0;2,0;16,0;;4,0;1,0;1,0;10,0;10,0;9,0;;;6,0;6,0;38,0;30,0;2,0;2,0;1,0;5,0;1,0;;1,0;4,0;8,0;1,0;1,0;;;;;;;;3,0;1,0;1,0;64,0;;;1,0;4,0;6,0;;2,0;2,0;;11,0;;15,0;;40,0;;;;6,0;;2,0;9,0;2,0;;;3,0;;13,0;;3,0;;;5,0;3,0;2,0;;24,0;;1,0;8,0;;1,0;;3,0;;;9,0;;3,0;;36,0;1,0;;3,0;3,0;19,0;;;;;5,0;1,0;;;;;8,0;;;;1,0;1,0;;;77,0;4,0;5,0;2,0;;;;;;20,0;;;2,0;;;34,0;1,0;3,0;;2,0;;1,0;;;7,0;3,0;20,0;2,0;5,0;;;;24,0;4,0;;;;4,0;;1,0;5,0;2,0;11,0;;;18,0;;1,0;16,0;1,0;;;;2,0;2,0;3,0;;;46,0;;4,0;;13,0;6,0;1,0;49,0;20,0;3,0;;23,0;;11,0;;1,0;8,0;18,0;3,0;;13,0;;49,0;1,0;;;;2,0;2,0;1,0;1,0;;6,0;4,0;;1,0;;24,0;1,0;23,0;3,0;;;;2,0;3,0;3,0;;1,0;1,0;;1,0;4,0;1,0;6,0;;;;14,0;;1,0;8,0;;;6,0;;;;;;;;25,0;1,0;1,0;3,0;5,0;;5,0;;8,0;;5,0;;23,0;1,0;1,0;9,0;4,0;;3,0;;1,0;1,0;4,0;;;;12,0;;;1,0;;1,0;;;4,0;2,0;14,0;;6,0;;;1,0;;;;;;2,0;;2,0;1,0;1,0;;;;;1,0;;1,0;6,0;4,0;;;;1,0;;;6,0;;;;;10,0;;;18,0;;;;;2,0;34,0;9,0;1,0;;;;2,0;;;5,0;;;1,0;;;;4,0;;;4,0;;;5,0;1,0;;23,0;2,0;;4,0;1,0;8,0;2,0;;;44,0;17,0;;;8,0;2,0;;;24,0;;;1,0;48,0;5,0;;;2,0;;;;;;2,0;;;;7,0;;1,0;14,0;1,0;;;;2,0;;;;;2,0;1,0;1,0;;;;;;;;5,0;;1,0;;;;;1,0;10,0;;1,0;;;1,0;;2,0;;;1,0;8,0;;;2,0;;5,0;;1,0;;2,0;2,0;;;;3,0;4,0;12,0;;13,0;16,0;20,0;;;6,0;324,0;;;17,0;;;;;1,0;11,0;30,0;1,0;4,0;;;;4,0;;;;17,0;;;4,0;;;;1,0;;;78,0;;;;;;1,0;1,0;;;;1,0;;2,0;1,0;;6,0;1,0;;;1,0;;2,0;2,0;;;;15,0;;2,0;1,0;;1,0;;;;14,0;1,0;;;;;;3,0;1,0;;;;;8,0;;2,0;2,0;1,0;7,0;;;4,0;;28,0;;;;;10,0;;;;;;1,0;;;;;;;2,0;2,0;;;1,0;;1,0;2,0;;3,0;;;;2,0;;1,0;11,0;8,0;;;;;;;;;;;;;1,0;;1,0;;;8,0;;;;;;;;6,0;;;2,0;3,0;;3,0;;;;8,0;;;3,0;;;;;2,0;;;;;;;1,0;2,0;2,0;;;;;;;1,0;1,0;;;1,0;;;;;;;;18,0;;;30,0;;2,0;;;;1,0;23,0;;;;;;1,0;;;;1,0;;3,0;;;;;;;;1,0;7,0;;6,0;;;;;1,0;7,0;;;1,0;6,0;;;18,0;;;2,0;;;;;;;;10,0;;;;2,0;14,0;;;3,0;;;;;6,0;1,0;;;1,0;65,0;;;;;;;;;;1,0;;1,0;;5,0;;;;;;;1,0;;;;;;1,0;;;20,0;;;1,0;;3,0;;;2,0;;;;
unit;3,0;122,0;263,0;53,0;736,0;33,0;493,0;710,0;478,0;866,0;163,0;167,0;20,0;81,0;312,0;32,0;21,0;32,0;125,0;21,0;292,0;3761,0;93,0;460,0;504,0;15,0;16,0;1599,0;57,0;1055,0;834,0;699,0;1261,0;93,0;556,0;30,0;153,0;529,0;48,0;2513,0;238,0;13,0;495,0;775,0;14,0;76,0;20,0;337,0;521,0;92,0;158,0;662,0;179,0;170,0;40,0;5219,0;1685,0;58,0;316,0;7320,0;30,0;195,0;374,0;22,0;26,0;105,0;454,0;3,0;20,0;536,0;1895,0;195,0;66,0;10,0;8,0;255,0;6,0;107,0;1149,0;1415,0;25,0;1387,0;133,0;66,0;71,0;4,0;298,0;17,0;53,0;574,0;290,0;110,0;273,0;1624,0;94,0;83,0;1,0;740,0;695,0;87,0;618,0;975,0;10,0;629,0;7,0;22,0;32,0;;28,0;1,0;147,0;323,0;86,0;80,0;229,0;30,0;56,0;3,0;69,0;716,0;22,0;1,0;128,0;238,0;2,0;28,0;1254,0;109,0;26,0;250,0;109,0;110,0;4,0;4,0;9,0;62,0;293,0;17,0;27,0;110,0;15,0;;142,0;203,0;163,0;60,0;322,0;360,0;4,0;;1,0;49,0;74,0;12,0;494,0;74,0;25,0;302,0;221,0;1264,0;51,0;47,0;65,0;27,0;35,0;27,0;127,0;787,0;81,0;29,0;338,0;51,0;343,0;436,0;257,0;126,0;86,0;832,0;8,0;;105,0;21,0;63,0;131,0;22,0;25,0;54,0;881,0;2,0;333,0;5,0;36,0;16,0;819,0;7,0;50,0;19,0;;127,0;12,0;30,0;56,0;31,0;737,0;9,0;64,0;37,0;47,0;75,0;246,0;19,0;47,0;10,0;3,0;53,0;652,0;286,0;24,0;16,0;41,0;95,0;100,0;162,0;9,0;32,0;14,0;15,0;4,0;3,0;21,0;47,0;33,0;66,0;84,0;358,0;152,0;5,0;108,0;412,0;46,0;255,0;11,0;121,0;26,0;9,0;165,0;28,0;24,0;8,0;89,0;272,0;207,0;7,0;604,0;89,0;12,0;52,0;141,0;34,0;6,0;65,0;670,0;20,0;37,0;96,0;39,0;52,0;2,0;11,0;21,0;91,0;65,0;24,0;76,0;64,0;130,0;20,0;8,0;214,0;79,0;40,0;75,0;3,0;88,0;12,0;134,0;635,0;834,0;183,0;34,0;30,0;6,0;24,0;52,0;18,0;112,0;329,0;442,0;;1,0;38,0;3,0;299,0;50,0;96,0;7,0;19,0;149,0;42,0;33,0;206,0;90,0;64,0;10,0;28,0;9,0;11,0;19,0;9,0;20,0;30,0;400,0;81,0;22,0;3,0;176,0;1,0;21,0;233,0;7,0;185,0;47,0;29,0;17,0;;105,0;24,0;156,0;10,0;25,0;14,0;43,0;12,0;45,0;275,0;57,0;293,0;65,0;6,0;458,0;80,0;95,0;81,0;12,0;16,0;68,0;14,0;25,0;6,0;24,0;55,0;63,0;1,0;21,0;150,0;97,0;2,0;3,0;33,0;11,0;152,0;11,0;2,0;88,0;138,0;411,0;19,0;92,0;72,0;39,0;147,0;389,0;5,0;98,0;59,0;44,0;21,0;50,0;3,0;653,0;22,0;79,0;36,0;4,0;201,0;179,0;146,0;127,0;88,0;29,0;106,0;;16,0;27,0;25,0;18,0;19,0;413,0;22,0;9,0;20,0;42,0;91,0;64,0;35,0;24,0;7,0;12,0;372,0;12,0;69,0;29,0;8,0;53,0;503,0;32,0;26,0;235,0;90,0;75,0;31,0;14,0;9,0;21,0;62,0;13,0;83,0;5,0;30,0;114,0;41,0;38,0;14,0;3,0;6,0;119,0;580,0;297,0;71,0;29,0;;256,0;75,0;534,0;18,0;59,0;123,0;72,0;261,0;3,0;112,0;40,0;19,0;39,0;18,0;140,0;222,0;20,0;206,0;;2,0;513,0;3,0;;21,0;45,0;171,0;22,0;42,0;53,0;90,0;3,0;38,0;33,0;2,0;152,0;152,0;182,0;25,0;473,0;45,0;407,0;36,0;48,0;411,0;156,0;17,0;117,0;12,0;130,0;46,0;60,0;4,0;60,0;186,0;48,0;41,0;119,0;3,0;35,0;;1,0;14,0;95,0;561,0;165,0;30,0;29,0;10,0;74,0;56,0;8,0;50,0;4,0;10,0;218,0;57,0;5,0;1,0;6,0;20,0;20,0;47,0;10,0;55,0;45,0;2,0;2,0;1,0;42,0;;38,0;8,0;38,0;12,0;9,0;25,0;15,0;69,0;33,0;27,0;42,0;3,0;10,0;87,0;1,0;352,0;36,0;24,0;168,0;948,0;31,0;42,0;11,0;7,0;111,0;94,0;56,0;63,0;5,0;22,0;108,0;29,0;50,0;6,0;24,0;23,0;1,0;7,0;17,0;;10,0;452,0;41,0;22,0;168,0;32,0;7,0;13,0;62,0;147,0;17,0;;46,0;121,0;180,0;8,0;14,0;54,0;4,0;24,0;5,0;279,0;25,0;24,0;20,0;82,0;14,0;10,0;6,0;;70,0;;1,0;69,0;1,0;75,0;12,0;26,0;26,0;98,0;10,0;49,0;81,0;10,0;;2,0;;189,0;2,0;;47,0;21,0;252,0;49,0;9,0;42,0;1,0;9,0;19,0;;28,0;9,0;14,0;14,0;81,0;5,0;20,0;6,0;35,0;180,0;39,0;5,0;16,0;15,0;31,0;14,0;30,0;22,0;2,0;11,0;1,0;2,0;12,0;55,0;41,0;160,0;3,0;2,0;;33,0;143,0;31,0;118,0;133,0;10,0;7,0;80,0;19,0;;28,0;101,0;17,0;77,0;26,0;40,0;3,0;26,0;48,0;31,0;13,0;106,0;12,0;12,0;34,0;34,0;14,0;159,0;9,0;;159,0;19,0;5,0;46,0;27,0;26,0;7,0;9,0;38,0;173,0;59,0;40,0;10,0;157,0;3,0;46,0;26,0;24,0;74,0;5,0;18,0;2,0;49,0;;;6,0;13,0;11,0;;10,0;90,0;141,0;90,0;51,0;5,0;12,0;21,0;4,0;14,0;13,0;30,0;7,0;23,0;54,0;12,0;111,0;23,0;19,0;41,0;54,0;7,0;44,0;4,0;41,0;19,0;21,0;73,0;64,0;10,0;67,0;52,0;16,0;7,0;17,0;62,0;69,0;5,0;52,0;25,0;14,0;224,0;16,0;12,0;18,0;3,0;64,0;85,0;10,0;15,0;12,0;54,0;11,0;16,0;13,0;25,0;32,0;129,0;22,0;5,0;4,0;6,0;4,0;;7,0;74,0;11,0;25,0;42,0;53,0;3,0;;5,0;33,0;8,0;3,0;37,0;8,0;5,0;6,0;27,0;53,0;18,0;7,0;65,0;11,0;7,0;3,0;22,0;6,0;;23,0;17,0;;14,0;2,0;47,0;13,0;;92,0;25,0;23,0;84,0;40,0;10,0;2,0;5,0;1,0;49,0;57,0;3,0;3,0;26,0;27,0;43,0;24,0;27,0;13,0;40,0;1,0;28,0;8,0;22,0;17,0;32,0;11,0;4,0;116,0;1,0;31,0;4,0;3,0;18,0;71,0;9,0;12,0;1,0;23,0;2,0;41,0;7,0;9,0;12,0;54,0;;7,0;10,0;79,0;;10,0;4,0;1,0;4,0;4,0;36,0;31,0;1,0;3,0;5,0;;1,0;;13,0;19,0;37,0;21,0;14,0;56,0;;6,0;51,0;58,0;8,0;;;4,0;;;15,0;28,0;11,0;5,0;10,0;3,0;31,0;4,0;25,0;1,0;;;1,0;5,0;55,0;10,0;;15,0;28,0;38,0;19,0;1,0;4,0;50,0;2,0;16,0;1,0;1,0;4,0;18,0;1,0;;;;15,0;2,0;42,0;70,0;8,0;10,0;;;3,0;2,0;9,0;11,0;18,0;;3,0;4,0;5,0;;7,0;3,0;1,0;;10,0;3,0;31,0;2,0;5,0;;33,0;7,0;47,0;8,0;3,0;2,0;7,0;3,0;1,0;12,0;;2,0;3,0;19,0;6,0;2,0;;7,0;27,0;1,0;9,0;34,0;7,0;2,0;;1,0;32,0;;;;
wave;3,0;;2,0;1,0;5,0;;;7,0;;1,0;;2,0;;;;;;;1,0;;;23,0;;;;;;15,0;;11,0;3,0;6,0;15,0;4,0;1,0;;;6,0;;1,0;3,0;;9,0;8,0;;;;3,0;11,0;26,0;1,0;75,0;2,0;16,0;;41,0;7,0;;7,0;24,0;;;18,0;;;14,0;;;2,0;1,0;25,0;;6,0;;;;7,0;4,0;2,0;1,0;10,0;2,0;;3,0;;25,0;;;;;11,0;;;29,0;;;1,0;;3,0;;10,0;4,0;;4,0;;;9,0;28,0;;5,0;;;2,0;;1,0;;;4,0;;9,0;1,0;;;22,0;2,0;;3,0;2,0;;1,0;;7,0;;1,0;;10,0;;;;1,0;12,0;;7,0;4,0;12,0;6,0;1,0;5,0;;3,0;2,0;;;1,0;;;;3,0;;7,0;35,0;;;1,0;;2,0;9,0;6,0;;;12,0;;2,0;;;;;19,0;;;;;3,0;;;;;30,0;;10,0;;1,0;;17,0;;20,0;;;;;1,0;4,0;3,0;;;;;;;;;;;7,0;;8,0;14,0;;22,0;5,0;;;49,0;1,0;;6,0;3,0;;;;;;;3,0;1,0;10,0;;2,0;;;1,0;;1,0;;;;;;;3,0;;;2,0;;;;;3,0;;;;2,0;;;;;;;;;;11,0;;;;;;;;;;2,0;;;;3,0;2,0;;3,0;4,0;;;;;;;2,0;;;;;;5,0;;;;;6,0;1,0;;;6,0;;;;;;;;;;;;;;;;;2,0;;;;;;;;;;;;;;;;;;;;;;;1,0;;1,0;;;;;;;;;;1,0;3,0;1,0;;;;;;;;1,0;;;;2,0;;;3,0;;2,0;;;;2,0;2,0;;;;;;;;;;;5,0;;;;;;;;;;;;;;1,0;;;3,0;;;6,0;;4,0;;;;1,0;;;;;;;;;;;;;;2,0;;;;;;;;1,0;;;;;;1,0;;;;1,0;;;;;;1,0;;;;;;;;;4,0;;;;;;31,0;3,0;;;;;;;;;;;2,0;;;1,0;;20,0;;;7,0;1,0;;;;;;;;;;;;;;;;5,0;;;;;;;;2,0;;;;1,0;;;;;;;;;;;;;;;3,0;;;;;;;;;;;;;;;;;;;;;;;;;2,0;;;;;2,0;;;;;;;;;;;1,0;;4,0;;;;;;2,0;;;;;2,0;;;;;;;;;;;;;;;;;;;6,0;;;;;;;;;;;;;;3,0;;;;;;;;;;;;;;;;;;;;;;1,0;11,0;;;;;2,0;;;;;;;;;;;;;;;;9,0;7,0;;;;;;;;;1,0;;;;;2,0;;;;7,0;;;;;;;;;;3,0;1,0;;;;;;;1,0;;;;;;;;;;;2,0;;;;;;;;;;;;1,0;2,0;;;;2,0;;;7,0;;;14,0;;;;;;;;;;;;;;2,0;;;10,0;;;;;;;1,0;;17,0;;;;;;;;;;;;;;;;;;;;;;;;;7,0;;;;;;;;;;;;;;;;;;;;;;;;;;1,0;;;;;;;;2,0;;;;;;;;;15,0;2,0;;;;;2,0;;4,0;;;;;;;;;;;;;;;;;;;;;;;;;;;;;;;;;;;;;;;;;;;;;2,0;1,0;;1,0;3,0;;;;;;;;;;;;;;;;;;;;;7,0;;;;;;;;;;2,0;;3,0;1,0;;2,0;;;;;;;;;;;;;2,0;;;;;;;;;1,0;;;;;;;;;;;;;;1,0;;;1,0;;;;;;;;;;;;;;30,0;;;;;;;;2,0;;;;;;;;
aberration;;4,0;5,0;1,0;2,0;3,0;2,0;4,0;2,0;1,0;2,0;8,0;4,0;1,0;8,0;4,0;5,0;25,0;1,0;1,0;1,0;12,0;4,0;3,0;4,0;1,0;3,0;28,0;1,0;4,0;5,0;9,0;7,0;2,0;3,0;1,0;1,0;2,0;1,0;3,0;9,0;31,0;2,0;5,0;1,0;1,0;15,0;5,0;9,0;1,0;11,0;1,0;2,0;3,0;25,0;52,0;1,0;6,0;2,0;31,0;10,0;80,0;25,0;2,0;32,0;4,0;1,0;1,0;1,0;3,0;35,0;2,0;3,0;1,0;1,0;2,0;1,0;1,0;6,0;4,0;2,0;3,0;2,0;1,0;4,0;2,0;2,0;1,0;5,0;12,0;3,0;11,0;1,0;2,0;2,0;1,0;2,0;4,0;2,0;1,0;2,0;20,0;1,0;2,0;1,0;2,0;1,0;3,0;3,0;;;;;;;;;;;;;;;;;;;;;;;;;;;;;;;;;;;;;;;;;;;;;;;;;;;;;;;;;;;;;;;;;;;;;;;;;;;;;;;;;;;;;;;;;;;;;;;;;;;;;;;;;;;;;;;;;;;;;;;;;;;;;;;;;;;;;;;;;;;;;;;;;;;;;;;;;;;;;;;;;;;;;;;;;;;;;;;;;;;;;;;;;;;;;;;;;;;;;;;;;;;;;;;;;;;;;;;;;;;;;;;;;;;;;;;;;;;;;;;;;;;;;;;;;;;;;;;;;;;;;;;;;;;;;;;;;;;;;;;;;;;;;;;;;;;;;;;;;;;;;;;;;;;;;;;;;;;;;;;;;;;;;;;;;;;;;;;;;;;;;;;;;;;;;;;;;;;;;;;;;;;;;;;;;;;;;;;;;;;;;;;;;;;;;;;;;;;;;;;;;;;;;;;;;;;;;;;;;;;;;;;;;;;;;;;;;;;;;;;;;;;;;;;;;;;;;;;;;;;;;;;;;;;;;;;;;;;;;;;;;;;;;;;;;;;;;;;;;;;;;;;;;;;;;;;;;;;;;;;;;;;;;;;;;;;;;;;;;;;;;;;;;;;;;;;;;;;;;;;;;;;;;;;;;;;;;;;;;;;;;;;;;;;;;;;;;;;;;;;;;;;;;;;;;;;;;;;;;;;;;;;;;;;;;;;;;;;;;;;;;;;;;;;;;;;;;;;;;;;;;;;;;;;;;;;;;;;;;;;;;;;;;;;;;;;;;;;;;;;;;;;;;;;;;;;;;;;;;;;;;;;;;;;;;;;;;;;;;;;;;;;;;;;;;;;;;;;;;;;;;;;;;;;;;;;;;;;;;;;;;;;;;;;;;;;;;;;;;;;;;;;;;;;;;;;;;;;;;;;;;;;;;;;;;;;;;;;;;;;;;;;;;;;;;;;;;;;;;;;;;;;;;;;;;;;;;;;;;;;;;;;;;;;;;;;
absorb;;3,0;1,0;;;;;;;1,0;;;;;6,0;;;;;;;1,0;;;;;;;4,0;3,0;;;13,0;;7,0;;;1,0;;;;;;2,0;;;;1,0;;;;5,0;;;;8,0;13,0;;;;4,0;;;;;;;;2,0;;7,0;;1,0;;1,0;;1,0;1,0;1,0;;;;;;;7,0;;;;;4,0;;;;1,0;4,0;;;;;14,0;1,0;;;;;;1,0;5,0;;3,0;1,0;5,0;6,0;4,0;1,0;1,0;5,0;2,0;3,0;1,0;3,0;1,0;2,0;2,0;2,0;5,0;1,0;1,0;2,0;3,0;1,0;13,0;1,0;1,0;1,0;1,0;1,0;1,0;2,0;4,0;2,0;1,0;3,0;9,0;2,0;12,0;4,0;2,0;19,0;3,0;2,0;1,0;6,0;1,0;1,0;1,0;6,0;1,0;7,0;1,0;3,0;2,0;3,0;2,0;56,0;1,0;80,0;3,0;23,0;45,0;6,0;4,0;12,0;1,0;3,0;4,0;1,0;3,0;1,0;1,0;3,0;1,0;2,0;1,0;1,0;8,0;1,0;4,0;24,0;4,0;1,0;3,0;7,0;1,0;2,0;4,0;16,0;4,0;1,0;3,0;8,0;1,0;2,0;1,0;3,0;3,0;3,0;8,0;6,0;1,0;1,0;1,0;7,0;1,0;3,0;17,0;4,0;1,0;2,0;4,0;6,0;5,0;6,0;2,0;6,0;2,0;16,0;1,0;;;;;;;;;;;;;;;;;;;;;;;;;;;;;;;;;;;;;;;;;;;;;;;;;;;;;;;;;;;;;;;;;;;;;;;;;;;;;;;;;;;;;;;;;;;;;;;;;;;;;;;;;;;;;;;;;;;;;;;;;;;;;;;;;;;;;;;;;;;;;;;;;;;;;;;;;;;;;;;;;;;;;;;;;;;;;;;;;;;;;;;;;;;;;;;;;;;;;;;;;;;;;;;;;;;;;;;;;;;;;;;;;;;;;;;;;;;;;;;;;;;;;;;;;;;;;;;;;;;;;;;;;;;;;;;;;;;;;;;;;;;;;;;;;;;;;;;;;;;;;;;;;;;;;;;;;;;;;;;;;;;;;;;;;;;;;;;;;;;;;;;;;;;;;;;;;;;;;;;;;;;;;;;;;;;;;;;;;;;;;;;;;;;;;;;;;;;;;;;;;;;;;;;;;;;;;;;;;;;;;;;;;;;;;;;;;;;;;;;;;;;;;;;;;;;;;;;;;;;;;;;;;;;;;;;;;;;;;;;;;;;;;;;;;;;;;;;;;;;;;;;;;;;;;;;;;;;;;;;;;;;;;;;;;;;;;;;;;;;;;;;;;;;;;;;;;;;;;;;;;;;;;;;;;;;;;;;;;;;;;;;;;;;;;;;;;;;;;;;;;;;;;;;;;;;;;;;;;;;;;;;;;;;;;;;;;;;;;;;;;;;;;;;;;;;;;;;;;;;;;;;;;;;;;;;;;;;;;;;;;;;;;;;;;;;;;;;;;;;;;;;;;;;;;;;;;;;;;;;;;;;;;;;;;;;;;;;;;;;;;;;;;;;;;;;;;;;;;;;;;;;;;;;;;;;
access;;2,0;;4,0;16,0;;;19,0;3,0;3,0;6,0;2,0;;;2,0;;;;4,0;28,0;;18,0;;;;;;24,0;;4,0;2,0;4,0;19,0;;43,0;;4,0;;;20,0;;;;3,0;;;;;;;1,0;;2,0;12,0;;64,0;11,0;;;1,0;;;20,0;1,0;;1,0;1,0;;;8,0;2,0;;;;;;;4,0;6,0;3,0;;15,0;8,0;;;;;;3,0;5,0;1,0;;;3,0;;;;19,0;22,0;;;8,0;;5,0;;;1,0;46,0;;;;;;1,0;6,0;;;;;3,0;;;2,0;6,0;;;10,0;;;2,0;;;;;;;;1,0;;;;;1,0;2,0;2,0;;1,0;1,0;;;;;;;;;;7,0;;2,0;;;;;2,0;1,0;13,0;3,0;;;;;2,0;;;5,0;;11,0;;;5,0;;;;1,0;;3,0;11,0;;2,0;;;;22,0;;;;;;8,0;;;;1,0;;;;;1,0;1,0;;;;;;2,0;12,0;;;;4,0;;;;2,0;8,0;7,0;;;;1,0;;;;;;;;2,0;;;;;;;2,0;3,0;1,0;4,0;;;;;8,0;;1,0;;4,0;;;;;1,0;2,0;1,0;;4,0;;;;;;;;1,0;7,0;;;;;;;;1,0;;6,0;;1,0;1,0;;;;;1,0;;;;;;;5,0;;;;;;;;14,0;1,0;;3,0;3,0;2,0;;2,0;;;;2,0;;1,0;4,0;;;;;;;;53,0;;;;;;;;;;;2,0;;;;1,0;;3,0;;;2,0;;;;;;;;;;1,0;;;2,0;;8,0;;;;1,0;;;;;13,0;22,0;;;;1,0;;;1,0;1,0;;;;;;10,0;;1,0;;;1,0;22,0;;;;;10,0;;1,0;;;;;1,0;;;2,0;8,0;;;1,0;;1,0;;;;;1,0;2,0;2,0;2,0;;1,0;;;;1,0;;;;;;;;;1,0;;;;;2,0;7,0;1,0;;6,0;3,0;;2,0;2,0;2,0;;;1,0;;1,0;14,0;;1,0;;;;2,0;;;2,0;;;3,0;;;34,0;;3,0;;1,0;;1,0;;1,0;2,0;;;;;;11,0;;;;;7,0;;;;1,0;2,0;;3,0;2,0;2,0;2,0;3,0;6,0;3,0;4,0;2,0;6,0;2,0;2,0;3,0;1,0;1,0;4,0;4,0;1,0;3,0;2,0;4,0;3,0;3,0;2,0;3,0;5,0;4,0;1,0;1,0;1,0;1,0;1,0;5,0;4,0;2,0;1,0;1,0;2,0;1,0;5,0;2,0;1,0;2,0;4,0;6,0;1,0;4,0;1,0;1,0;2,0;6,0;1,0;1,0;41,0;2,0;2,0;1,0;3,0;2,0;1,0;1,0;1,0;2,0;1,0;2,0;2,0;1,0;1,0;1,0;1,0;3,0;14,0;2,0;1,0;14,0;2,0;3,0;2,0;1,0;2,0;2,0;1,0;1,0;4,0;10,0;1,0;2,0;2,0;2,0;2,0;;;;;;;;;;;;;;;;;;;;;;;;;;;;;;;;;;;;;;;;;;;;;;;;;;;;;;;;;;;;;;;;;;;;;;;;;;;;;;;;;;;;;;;;;;;;;;;;;;;;;;;;;;;;;;;;;;;;;;;;;;;;;;;;;;;;;;;;;;;;;;;;;;;;;;;;;;;;;;;;;;;;;;;;;;;;;;;;;;;;;;;;;;;;;;;;;;;;;;;;;;;;;;;;;;;;;;;;;;;;;;;;;;;;;;;;;;;;;;;;;;;;;;;;;;;;;;;;;;;;;;;;;;;;;;;;;;;;;;;;;;;;;;;;;;;;;;;;;;;;;;;;;;;;;;;;;;;;;;;;;;;;;;;;;;;;;;;;;;;;;;;;;;;;;;;;;;;;;;;;;;;;;;;;;;;;;;;;;;;;;;;;;;;;;;;;;;;;;;;;;;;;;;;;;
actuation;;1,0;1,0;;38,0;;14,0;14,0;;5,0;;;;;;;;;2,0;;;6,0;;;21,0;;;;;2,0;;6,0;25,0;;;;;;;;;;8,0;6,0;;;;;;;1,0;8,0;;;;12,0;9,0;;11,0;65,0;;1,0;12,0;;;1,0;2,0;;;2,0;5,0;;;;1,0;;3,0;;1,0;2,0;;1,0;;;;;;;;;2,0;;;3,0;;;;;;;;37,0;;;;;;33,0;;;;5,0;;4,0;;;;;3,0;1,0;;1,0;;;;;8,0;5,0;;10,0;;;;;;;5,0;;;;;;9,0;;;1,0;;1,0;;;;;4,0;;;;;1,0;;;;;;;;;;4,0;;;11,0;;;1,0;3,0;;;;;;;;4,0;;;;;9,0;;5,0;;;;;;;;2,0;;;;;;;;;;;2,0;5,0;;;;;2,0;6,0;;;;;;;;;;;;;;5,0;;;1,0;;;;;;;;;;;;;;1,0;;;;;;;1,0;;;;1,0;;3,0;;3,0;;;;;;;;;;;;;;;;;;2,0;;;;8,0;;2,0;6,0;;;;;;;;;;;2,0;;;9,0;;1,0;;;;;;;1,0;;;;;;;;;;;;3,0;;;;;1,0;6,0;2,0;;;;;;;;;;;;;;;;5,0;;;;;;;;;;;;;;;;;;;;;;;;;;;;;;;1,0;;;;;;;;;;;;;;;8,0;6,0;;;17,0;;;;;;;;;;;;;;;;3,0;;7,0;;;;;;1,0;;1,0;;;;3,0;;;;;;;;;4,0;;;;;;1,0;15,0;;;;;1,0;;;;;2,0;;;;;;;;;;;;;;;;;;;;;3,0;;;;;1,0;;;;;;;;;;1,0;;;;;3,0;;;;3,0;;;;;;;;;;;;;;;;;;;;;;;;;;;;;;;8,0;;;;;;;;;;;;2,0;;;;;;;;;;;;;;;;;;;;;;;;;;;;1,0;;;;;;;;;;;;;;;;;1,0;;;;;;;;;;;;;;;;;;;;;;;;;;1,0;;2,0;;;;;;;;;;;;;;;;;;;;18,0;;;1,0;;;11,0;;;;;;;;;;;;;;;;;;;;;;;;;;;;;17,0;;;;;;;;;;;;;;;;;;;;;;;;;;;;;;;;2,0;;;;;;;;;;;;;;;;;;;20,0;;;;;;;;;;;;;2,0;;;1,0;;;;;;;;;;;;;;1,0;;;;;;;;;;;;2,0;;;;;;;;;;;;;;;;;;;1,0;;;;;;;;;;;;;;;;;;;;;;;;;3,0;;;;;;;;;;;2,0;;;;;;;9,0;;;;;;;;;;;;;;;3,0;;;;;;;;;;;;;;4,0;;;;;;;;3,0;;;;2,0;;;;;1,0;1,0;1,0;4,0;2,0;1,0;6,0;;;;;;;;;;;;;;;;;;;;;;;;;;;;;;;;;;;;;;;;;;;;;;;;;;;;;;;;;;;;;;;;;;;;;;;;;;;;;;;;;;;;;;;;;;;;;;;;;;;;;;;;;;;;;;;;;;;;;;;;;;;;;;
adapt;;3,0;20,0;;99,0;;23,0;25,0;6,0;71,0;9,0;5,0;;;32,0;2,0;1,0;1,0;22,0;20,0;8,0;184,0;2,0;1,0;3,0;2,0;1,0;91,0;2,0;38,0;29,0;44,0;156,0;;36,0;3,0;27,0;22,0;2,0;135,0;8,0;;29,0;45,0;;1,0;7,0;2,0;17,0;;14,0;37,0;18,0;15,0;;352,0;44,0;2,0;4,0;129,0;11,0;1,0;19,0;;4,0;6,0;7,0;7,0;;15,0;48,0;1,0;4,0;;;7,0;3,0;20,0;57,0;12,0;1,0;51,0;62,0;14,0;3,0;;9,0;1,0;1,0;16,0;82,0;1,0;2,0;89,0;9,0;4,0;4,0;10,0;40,0;4,0;42,0;138,0;;24,0;;2,0;3,0;147,0;;3,0;;6,0;17,0;17,0;29,0;;1,0;3,0;5,0;45,0;;3,0;1,0;82,0;;2,0;7,0;13,0;2,0;45,0;35,0;3,0;;;;30,0;12,0;7,0;4,0;17,0;37,0;2,0;16,0;11,0;40,0;10,0;38,0;26,0;;1,0;3,0;8,0;18,0;8,0;4,0;7,0;6,0;76,0;11,0;19,0;;2,0;;3,0;1,0;5,0;7,0;108,0;3,0;3,0;52,0;14,0;56,0;91,0;11,0;16,0;3,0;58,0;;;4,0;1,0;4,0;2,0;4,0;4,0;34,0;70,0;4,0;48,0;;10,0;3,0;145,0;;2,0;;4,0;7,0;33,0;;9,0;1,0;8,0;1,0;3,0;;;11,0;38,0;4,0;11,0;28,0;;3,0;16,0;33,0;7,0;3,0;8,0;1,0;25,0;;7,0;4,0;3,0;9,0;1,0;;4,0;;;24,0;;15,0;13,0;3,0;2,0;12,0;1,0;13,0;;3,0;10,0;9,0;15,0;2,0;1,0;1,0;4,0;;2,0;5,0;50,0;;2,0;1,0;16,0;8,0;1,0;;10,0;3,0;;7,0;4,0;7,0;;10,0;3,0;3,0;4,0;2,0;2,0;5,0;27,0;;1,0;9,0;5,0;9,0;;1,0;13,0;;8,0;24,0;43,0;22,0;4,0;4,0;3,0;;3,0;;1,0;13,0;7,0;2,0;;10,0;;4,0;10,0;3,0;;3,0;7,0;5,0;1,0;15,0;3,0;1,0;;20,0;;;;8,0;2,0;5,0;23,0;3,0;16,0;;16,0;7,0;2,0;7,0;;20,0;3,0;8,0;2,0;;10,0;;4,0;;1,0;;10,0;;1,0;;3,0;2,0;7,0;1,0;15,0;3,0;8,0;1,0;3,0;1,0;;1,0;1,0;;;4,0;3,0;2,0;12,0;7,0;3,0;1,0;;3,0;1,0;;2,0;;3,0;10,0;21,0;;4,0;;9,0;;9,0;1,0;19,0;3,0;2,0;;;1,0;43,0;1,0;4,0;1,0;;15,0;6,0;1,0;25,0;2,0;;4,0;;;;;;;32,0;5,0;6,0;7,0;17,0;4,0;7,0;;6,0;5,0;;25,0;2,0;13,0;16,0;;3,0;8,0;1,0;1,0;3,0;2,0;2,0;1,0;2,0;;1,0;5,0;6,0;4,0;2,0;4,0;1,0;7,0;3,0;;5,0;3,0;25,0;;7,0;1,0;5,0;;9,0;29,0;13,0;;2,0;;;6,0;1,0;;;3,0;3,0;;2,0;9,0;5,0;3,0;1,0;;30,0;9,0;;9,0;;20,0;7,0;7,0;;1,0;10,0;6,0;;;17,0;11,0;5,0;8,0;13,0;;27,0;7,0;2,0;30,0;36,0;4,0;17,0;;;;;;1,0;23,0;15,0;2,0;2,0;;3,0;8,0;;;10,0;16,0;16,0;14,0;4,0;2,0;1,0;2,0;1,0;;1,0;;15,0;1,0;4,0;;7,0;;1,0;3,0;1,0;2,0;;;2,0;;2,0;1,0;3,0;1,0;4,0;3,0;;6,0;1,0;;8,0;2,0;7,0;;1,0;11,0;3,0;1,0;1,0;3,0;6,0;6,0;;1,0;;;1,0;5,0;;;;12,0;6,0;3,0;1,0;;1,0;4,0;7,0;;5,0;;3,0;9,0;;;22,0;2,0;;;1,0;8,0;;1,0;3,0;9,0;32,0;;1,0;;;3,0;2,0;3,0;2,0;5,0;;1,0;3,0;2,0;2,0;6,0;;1,0;;2,0;1,0;3,0;2,0;2,0;;4,0;1,0;;11,0;;;;;;4,0;;2,0;4,0;9,0;;1,0;26,0;;8,0;5,0;1,0;;5,0;;;;;6,0;8,0;5,0;1,0;2,0;;;;2,0;;1,0;1,0;2,0;6,0;;5,0;2,0;;1,0;;3,0;1,0;;;;;;;1,0;2,0;;;;2,0;;;4,0;1,0;8,0;1,0;2,0;1,0;4,0;16,0;11,0;;7,0;;2,0;3,0;2,0;;;2,0;;;;1,0;2,0;9,0;;1,0;33,0;;10,0;4,0;11,0;;;1,0;2,0;;2,0;;1,0;;1,0;1,0;1,0;;;;;;;2,0;1,0;;;;;5,0;;1,0;11,0;;;3,0;3,0;;11,0;1,0;;1,0;3,0;1,0;;;2,0;4,0;;;32,0;1,0;;;14,0;2,0;;1,0;5,0;;5,0;12,0;;;;;4,0;3,0;4,0;;1,0;;1,0;;;1,0;1,0;;;;;;;3,0;;23,0;;;4,0;;2,0;;;4,0;4,0;;;;1,0;;2,0;4,0;;;8,0;;2,0;1,0;;;;;9,0;1,0;3,0;;1,0;;;3,0;2,0;;1,0;7,0;1,0;;1,0;;;8,0;;2,0;;2,0;18,0;3,0;;;1,0;;14,0;1,0;3,0;;;;;4,0;;14,0;;;1,0;1,0;;2,0;;;;;6,0;;;;;5,0;2,0;1,0;;;1,0;4,0;2,0;3,0;;1,0;;3,0;;3,0;3,0;2,0;3,0;2,0;5,0;2,0;1,0;3,0;2,0;1,0;3,0;12,0;1,0;3,0;2,0;1,0;1,0;1,0;1,0;4,0;1,0;5,0;2,0;1,0;4,0;9,0;5,0;1,0;1,0;1,0;2,0;3,0;1,0;1,0;1,0;8,0;2,0;2,0;5,0;3,0;2,0;1,0;1,0;2,0;1,0;;;;;;;;;;;;;;;;;;;;;;;;;;;;;;;;;;;;;;;;;;;;;;;;;;;;;;;;;;;;;;;;;;
adapter;;1,0;;;24,0;;1,0;11,0;;15,0;3,0;;;;2,0;2,0;;;2,0;;;20,0;;2,0;8,0;;;12,0;;3,0;5,0;3,0;99,0;5,0;3,0;;2,0;1,0;;5,0;1,0;;6,0;4,0;;;;2,0;2,0;;5,0;;;;1,0;51,0;30,0;;;45,0;1,0;;8,0;;;;1,0;;;1,0;16,0;2,0;5,0;;;;;1,0;12,0;35,0;;;7,0;1,0;;;;1,0;;7,0;2,0;;;13,0;;5,0;;5,0;1,0;;15,0;22,0;;3,0;;1,0;2,0;13,0;;;6,0;;;3,0;35,0;1,0;;;;40,0;;;;3,0;;;10,0;8,0;2,0;1,0;9,0;;1,0;;;3,0;4,0;;;;;;3,0;1,0;2,0;;8,0;46,0;;;;4,0;1,0;;2,0;3,0;;2,0;;8,0;4,0;;6,0;;;;;6,0;;;37,0;2,0;;49,0;;6,0;1,0;4,0;;;;;;;3,0;1,0;39,0;14,0;;13,0;;;;10,0;;1,0;;;1,0;;;1,0;;4,0;;;;;;34,0;;1,0;;;2,0;;6,0;;;6,0;1,0;;;;;;;;;;2,0;;;;;1,0;3,0;;1,0;;;;3,0;2,0;6,0;8,0;;;;;;;;44,0;5,0;;;4,0;;3,0;;8,0;;;3,0;2,0;3,0;;1,0;1,0;;4,0;;1,0;5,0;13,0;;;;3,0;3,0;;4,0;17,0;;2,0;;;4,0;;1,0;;;;2,0;;;1,0;;;1,0;;2,0;;1,0;;;1,0;6,0;;;1,0;;;33,0;;1,0;;;;;;;;;8,0;;;1,0;;3,0;;;;;;;;;;;1,0;;1,0;1,0;;;1,0;;1,0;;;;;;3,0;;;;;;;;;;;;;2,0;;15,0;;;;1,0;3,0;;;;2,0;;;;1,0;;;;;;2,0;2,0;;;;1,0;4,0;;;;;;;;;;;;;;;;2,0;6,0;6,0;;2,0;;;4,0;;;;;;4,0;;1,0;;;;;;;;2,0;;;;1,0;6,0;;;;;;8,0;;;;;;2,0;2,0;;;;;;;8,0;15,0;;;;;;;;;;;3,0;;;;;;6,0;;;;;;;;19,0;;;;3,0;;2,0;;2,0;27,0;;3,0;;;;;13,0;6,0;;2,0;5,0;;;;;;;;;12,0;30,0;6,0;;;;13,0;;;;;;3,0;;;;;;;;2,0;;;1,0;4,0;;;;;3,0;1,0;;;;;;1,0;;;;48,0;;;2,0;;1,0;;;;;;;1,0;;;;;;;;;;1,0;;;;;;4,0;;;13,0;1,0;2,0;;1,0;7,0;;;5,0;;;;;;;;;;1,0;;;13,0;70,0;;;;;;;1,0;;4,0;;;;;;;2,0;;6,0;2,0;;6,0;1,0;;;;7,0;;;5,0;;1,0;;1,0;;;;;;;8,0;1,0;;;;;;;3,0;;2,0;;;;;3,0;;5,0;;;;;;;;;;;;;;;;;;;;;;;;;1,0;;;;;;;;;;;;;;;;;;;;;;;;;;;;;;;;;;;;;;;;;;;;;;;;;;;;;;7,0;5,0;;;;;;;;;;;;;;1,0;;;;;;;;;;;;;;;;;85,0;;;;;;;;;;;;;;;;;;;1,0;;;;;;;;;;;;;;;;;;;;;;;;;;;;;12,0;;;;;;;;2,0;;;;;;;;1,0;;2,0;;;;;;;;;4,0;;;;;;;;;;;;;;7,0;;;;;;;;;;;;;;;;;10,0;;;;;;;;;;;;;;;;;;;;4,0;;;;;;;;;;;;;;;2,0;;;;;;;;4,0;;7,0;;;;;;;;1,0;1,0;1,0;;;;;;;;;;;;;;;;;;;;;;;;;;;;;;;;;;;;;;;;;;;;;;;;;;;;;;;;;;;;;;;
adhesive;;6,0;4,0;;5,0;;1,0;10,0;;;;;;;;1,0;;;;;;;;;;;;;;;;;9,0;;18,0;;;3,0;;;;;;6,0;;;;;;;;3,0;;;2,0;42,0;15,0;;1,0;63,0;;;19,0;;;;;3,0;;;7,0;;;8,0;11,0;;;1,0;6,0;;2,0;;;;;;6,0;;;;34,0;;;;2,0;1,0;;;;31,0;34,0;9,0;;;;;2,0;17,0;;;;1,0;;15,0;22,0;;;;12,0;5,0;28,0;;;9,0;4,0;;3,0;4,0;;20,0;49,0;;;;3,0;;14,0;;3,0;;;;;5,0;14,0;;18,0;9,0;;1,0;;10,0;;4,0;7,0;12,0;9,0;16,0;;1,0;;;2,0;3,0;;46,0;;8,0;;13,0;22,0;;85,0;10,0;;1,0;3,0;;14,0;;;;;;;;9,0;8,0;;59,0;1,0;5,0;;13,0;;;;1,0;;8,0;2,0;;;9,0;;;5,0;;6,0;6,0;;;;;;1,0;;26,0;;4,0;6,0;;;;2,0;;4,0;3,0;;;;;;2,0;;;5,0;47,0;36,0;1,0;13,0;;1,0;4,0;;;4,0;46,0;1,0;3,0;;;25,0;13,0;;;1,0;8,0;;;;;3,0;;1,0;;3,0;;1,0;;1,0;;;2,0;5,0;;;;;5,0;;4,0;;;10,0;;;;1,0;;;;1,0;3,0;;;;;2,0;;;;;1,0;1,0;;;1,0;1,0;10,0;;5,0;;;;;;;3,0;10,0;1,0;1,0;;;;;16,0;;3,0;;;;;;;;;;;;;;;;;;;;2,0;;;;;;;;;;;;;;;5,0;;;;;;;;;;;;;;;;;;5,0;;;;;;;;;;;;;1,0;;;;;;;;;;;;;;;;;5,0;10,0;;;;;;;;;;;4,0;;;;;;;;;;;;;;;;;;;;;;;;;2,0;;;;;;2,0;;;;;;;;;;;;;;;;;;;;;;6,0;;;;;;;;;;2,0;;;;;;;;;2,0;;;;;;;;;3,0;1,0;;;;;2,0;;;;;6,0;3,0;;;;;;;;;;;;;;;;;;;;;;;;;;;;;;;;;;;;;;;1,0;;;;;2,0;;;;;;;;;;;;;;3,0;;2,0;;3,0;;;;;1,0;;7,0;6,0;;;;;;;;;;;;2,0;1,0;;;;;;;;;;2,0;;2,0;;;;;;;;;;;;2,0;;;;3,0;;;;19,0;;;1,0;2,0;1,0;;;;3,0;;4,0;;;;;;;3,0;;;;;3,0;;2,0;;;;;;;;;1,0;;;;;;;;3,0;2,0;;;;;;;;;;;;;;;;;;;;;;;2,0;;;;;;;;1,0;;;;3,0;;;;;;;;;;;5,0;;4,0;;;;;;;;;;;;;;3,0;;;;;;;;;;;;;;;;;;;;;;;3,0;;;;;;1,0;;;;;;;;;;;;;;;;;;;;;;;;;;;;;1,0;;;;;;;;;1,0;;;;;;;;;;;;;;;;;;;;;;3,0;;;;;3,0;;;;3,0;;;;;;;;6,0;;;;;;;1,0;;;;;;;;;;;;;;;;;;;;1,0;;;;;;;;;;;;;;;;;;;;;;;;;;;;;;;;;1,0;;;;;;;;;;;;;;;;;;;;;;;;;;;;;;;;;;;;;;;;;;;;;1,0;17,0;2,0;1,0;9,0;9,0;12,0;;;;;;;;;;;;;;;;;;;;;;;;;;;;;;;;;;;;;;;;;;;;;;
aperture;;4,0;27,0;;87,0;2,0;85,0;55,0;15,0;31,0;93,0;2,0;8,0;6,0;5,0;1,0;;;60,0;;16,0;143,0;1,0;5,0;15,0;;2,0;41,0;6,0;7,0;22,0;246,0;200,0;3,0;28,0;5,0;11,0;10,0;;63,0;25,0;;42,0;65,0;;;;50,0;39,0;;9,0;3,0;;67,0;;334,0;240,0;6,0;20,0;448,0;1,0;2,0;89,0;38,0;9,0;16,0;37,0;6,0;;57,0;172,0;4,0;31,0;;2,0;6,0;;46,0;208,0;13,0;7,0;5,0;15,0;16,0;1,0;2,0;42,0;10,0;6,0;16,0;46,0;6,0;126,0;8,0;177,0;20,0;;4,0;3,0;14,0;63,0;125,0;;2,0;;;;186,0;;;23,0;57,0;30,0;29,0;19,0;8,0;3,0;;3,0;29,0;1,0;;9,0;15,0;1,0;5,0;66,0;3,0;1,0;20,0;47,0;2,0;12,0;;;19,0;64,0;;5,0;1,0;2,0;1,0;9,0;7,0;40,0;5,0;72,0;4,0;;2,0;;2,0;15,0;;2,0;3,0;19,0;83,0;35,0;178,0;17,0;12,0;13,0;3,0;;2,0;4,0;140,0;;5,0;41,0;74,0;47,0;41,0;3,0;108,0;10,0;8,0;;;13,0;8,0;65,0;2,0;4,0;11,0;68,0;55,0;5,0;94,0;3,0;1,0;10,0;66,0;6,0;4,0;11,0;;16,0;30,0;;37,0;2,0;45,0;12,0;2,0;;29,0;11,0;33,0;;;;9,0;35,0;42,0;28,0;18,0;2,0;4,0;18,0;1,0;2,0;;8,0;3,0;28,0;;3,0;;;;15,0;15,0;59,0;21,0;5,0;9,0;32,0;;24,0;;10,0;8,0;2,0;25,0;9,0;8,0;2,0;3,0;1,0;1,0;;14,0;6,0;;8,0;127,0;;32,0;16,0;17,0;17,0;6,0;30,0;1,0;59,0;;21,0;12,0;;25,0;;;20,0;1,0;;;6,0;40,0;1,0;1,0;10,0;118,0;2,0;5,0;18,0;57,0;7,0;6,0;2,0;1,0;3,0;19,0;1,0;2,0;3,0;30,0;5,0;;;13,0;31,0;18,0;5,0;4,0;;328,0;9,0;11,0;10,0;9,0;4,0;;61,0;;20,0;1,0;;7,0;;2,0;15,0;6,0;;14,0;3,0;2,0;;;3,0;8,0;;;;;3,0;2,0;;2,0;16,0;18,0;;3,0;8,0;;3,0;12,0;;16,0;29,0;;;2,0;;4,0;;1,0;;2,0;;;2,0;;1,0;18,0;;;3,0;;;;;1,0;;1,0;1,0;1,0;1,0;1,0;7,0;3,0;1,0;24,0;;6,0;7,0;50,0;;17,0;;9,0;6,0;;168,0;19,0;11,0;14,0;2,0;;1,0;;2,0;1,0;;;4,0;24,0;;;11,0;25,0;1,0;;;;1,0;;6,0;2,0;4,0;;;3,0;26,0;1,0;5,0;1,0;6,0;7,0;2,0;3,0;;;;2,0;;2,0;;;1,0;;;;11,0;12,0;6,0;;1,0;2,0;;9,0;25,0;28,0;1,0;;;;5,0;;;;1,0;36,0;;8,0;10,0;;8,0;;;22,0;;;;;2,0;;;1,0;;;;2,0;;35,0;9,0;1,0;;72,0;;5,0;10,0;;5,0;33,0;6,0;3,0;10,0;;2,0;;;2,0;;14,0;;2,0;1,0;8,0;5,0;;;6,0;1,0;4,0;;;;19,0;3,0;9,0;4,0;2,0;;3,0;4,0;;2,0;17,0;1,0;;21,0;;;14,0;;;;;;8,0;;6,0;20,0;;;1,0;;;1,0;;;1,0;;;6,0;;6,0;;23,0;;2,0;1,0;;3,0;11,0;;1,0;;;;;;4,0;;9,0;;;2,0;1,0;;48,0;;;1,0;28,0;;;;;3,0;;3,0;2,0;;2,0;;;5,0;1,0;;43,0;;;1,0;4,0;;1,0;;;4,0;3,0;;1,0;;;;;;;2,0;3,0;6,0;11,0;7,0;;16,0;9,0;1,0;;;25,0;27,0;1,0;1,0;45,0;46,0;15,0;2,0;;2,0;2,0;;3,0;;;;2,0;;;4,0;;1,0;3,0;3,0;;;6,0;;2,0;;;1,0;3,0;2,0;;;12,0;;;2,0;;2,0;5,0;;2,0;;5,0;;;;;9,0;3,0;;2,0;;;;;2,0;2,0;2,0;4,0;;1,0;3,0;22,0;;2,0;;;;;2,0;;1,0;2,0;2,0;;2,0;;9,0;1,0;;;2,0;2,0;7,0;15,0;;5,0;;;4,0;;2,0;;;2,0;;;1,0;1,0;1,0;4,0;;;;2,0;38,0;;;2,0;;1,0;3,0;4,0;;2,0;;;2,0;;;;1,0;18,0;15,0;;1,0;;;3,0;;;;12,0;;;2,0;2,0;3,0;15,0;;2,0;8,0;3,0;;;;;;;;;4,0;;;;;;;2,0;;;4,0;;;;;;;;6,0;;;1,0;;;;;12,0;;;;6,0;2,0;;;;2,0;;;;;1,0;6,0;;1,0;6,0;8,0;1,0;;;;;27,0;;;;8,0;37,0;;;;;;15,0;3,0;;1,0;;;;2,0;;1,0;4,0;3,0;;6,0;;;;;;;;;;8,0;;2,0;;24,0;;1,0;2,0;11,0;5,0;;;8,0;;4,0;1,0;;;;;;;;;;;;142,0;;3,0;9,0;;;;;;;;;2,0;1,0;;;9,0;5,0;;;9,0;;;3,0;1,0;1,0;2,0;;;;2,0;;;;;8,0;;;;;3,0;;;;1,0;;;;;;;;;;2,0;;;4,0;;;8,0;1,0;;;;;;;;;;;;;;;;;;4,0;;;;;3,0;8,0;3,0;;;;;;;;2,0;;;;;;
apply;;4,0;26,0;4,0;46,0;;23,0;49,0;23,0;44,0;2,0;3,0;;1,0;48,0;3,0;10,0;7,0;24,0;11,0;20,0;119,0;8,0;12,0;52,0;10,0;;81,0;3,0;27,0;20,0;39,0;95,0;9,0;37,0;2,0;;67,0;;31,0;1,0;3,0;84,0;54,0;1,0;;1,0;1,0;21,0;38,0;22,0;55,0;1,0;13,0;;321,0;76,0;1,0;9,0;88,0;8,0;4,0;164,0;;16,0;59,0;19,0;3,0;4,0;34,0;43,0;7,0;10,0;4,0;3,0;;23,0;25,0;41,0;52,0;;102,0;19,0;4,0;12,0;2,0;42,0;1,0;7,0;46,0;34,0;4,0;3,0;131,0;6,0;;;4,0;17,0;26,0;41,0;25,0;;38,0;2,0;6,0;3,0;108,0;2,0;;2,0;6,0;6,0;11,0;4,0;3,0;1,0;4,0;2,0;2,0;;;17,0;46,0;76,0;4,0;54,0;16,0;10,0;4,0;18,0;2,0;4,0;2,0;5,0;;9,0;;75,0;1,0;1,0;;12,0;33,0;75,0;161,0;7,0;16,0;3,0;;4,0;;7,0;3,0;4,0;6,0;3,0;8,0;9,0;35,0;1,0;3,0;4,0;1,0;;31,0;21,0;21,0;17,0;19,0;85,0;6,0;42,0;9,0;31,0;7,0;3,0;35,0;1,0;;;;10,0;;;6,0;8,0;39,0;;46,0;;2,0;;19,0;2,0;2,0;2,0;3,0;15,0;3,0;3,0;13,0;;15,0;;1,0;1,0;;16,0;12,0;;7,0;4,0;;4,0;70,0;3,0;5,0;;4,0;4,0;7,0;25,0;;;1,0;3,0;;;1,0;;;28,0;4,0;11,0;5,0;1,0;;54,0;6,0;25,0;;12,0;3,0;2,0;11,0;7,0;22,0;1,0;35,0;5,0;18,0;4,0;2,0;3,0;;;2,0;7,0;;4,0;161,0;11,0;16,0;3,0;;1,0;4,0;;1,0;5,0;18,0;;;;10,0;;3,0;5,0;;2,0;6,0;;14,0;;6,0;16,0;15,0;6,0;13,0;;;;8,0;1,0;3,0;2,0;4,0;9,0;;2,0;2,0;52,0;3,0;3,0;;2,0;12,0;16,0;4,0;11,0;9,0;5,0;;3,0;;2,0;;;6,0;2,0;6,0;3,0;2,0;2,0;13,0;1,0;10,0;11,0;;34,0;1,0;;5,0;;1,0;1,0;;3,0;8,0;;8,0;1,0;8,0;6,0;2,0;1,0;3,0;;25,0;8,0;29,0;3,0;2,0;;;4,0;4,0;;;5,0;;;3,0;4,0;2,0;;;2,0;4,0;;;8,0;10,0;12,0;14,0;11,0;7,0;;14,0;22,0;14,0;1,0;9,0;98,0;;;18,0;2,0;13,0;;14,0;2,0;3,0;12,0;8,0;2,0;16,0;18,0;;4,0;;;3,0;8,0;10,0;3,0;11,0;1,0;5,0;1,0;8,0;4,0;3,0;3,0;65,0;6,0;;29,0;8,0;2,0;1,0;;1,0;9,0;1,0;4,0;18,0;4,0;12,0;15,0;6,0;;8,0;;;11,0;3,0;;6,0;4,0;5,0;1,0;6,0;;21,0;2,0;7,0;1,0;8,0;2,0;2,0;65,0;6,0;;1,0;1,0;1,0;8,0;;;1,0;;;;5,0;3,0;1,0;14,0;;;14,0;2,0;;;2,0;36,0;2,0;2,0;2,0;2,0;;;;3,0;14,0;3,0;2,0;;4,0;;19,0;4,0;11,0;21,0;12,0;1,0;316,0;3,0;;;1,0;21,0;1,0;9,0;3,0;;;;;3,0;;4,0;15,0;1,0;1,0;;;;1,0;;2,0;3,0;17,0;;;11,0;;1,0;;;1,0;1,0;;4,0;5,0;2,0;1,0;;;;1,0;;3,0;2,0;;1,0;;;2,0;6,0;1,0;5,0;3,0;1,0;;5,0;3,0;;3,0;76,0;25,0;8,0;;2,0;;10,0;;;3,0;;;;;;2,0;2,0;;3,0;;;1,0;22,0;1,0;1,0;11,0;2,0;;2,0;2,0;;47,0;4,0;3,0;2,0;12,0;;;;1,0;;;15,0;1,0;;;7,0;;;;;6,0;1,0;;;;;;;3,0;6,0;3,0;;4,0;1,0;;1,0;;2,0;;;43,0;4,0;5,0;;;22,0;;;;2,0;3,0;;6,0;2,0;;9,0;;11,0;;6,0;2,0;2,0;;;;;;4,0;4,0;5,0;;;;;10,0;14,0;;;3,0;;;;2,0;6,0;4,0;2,0;12,0;;;6,0;5,0;11,0;7,0;5,0;1,0;2,0;1,0;;;1,0;67,0;1,0;;9,0;;15,0;6,0;7,0;5,0;24,0;;;1,0;3,0;2,0;;;;29,0;;;1,0;3,0;1,0;4,0;24,0;6,0;1,0;2,0;19,0;3,0;4,0;;2,0;;2,0;9,0;;4,0;1,0;2,0;4,0;1,0;;5,0;2,0;;;;7,0;1,0;;20,0;;3,0;20,0;4,0;;2,0;;;;;;38,0;61,0;18,0;3,0;1,0;;1,0;2,0;1,0;;;1,0;;1,0;;;6,0;10,0;1,0;2,0;2,0;23,0;5,0;2,0;;;;;3,0;1,0;;5,0;;;;;;;2,0;;;2,0;;;;;3,0;11,0;2,0;;;;;3,0;;;;;9,0;2,0;;;;;6,0;3,0;;3,0;;;;2,0;2,0;;;1,0;3,0;16,0;2,0;;9,0;1,0;;;15,0;;;10,0;;;2,0;5,0;8,0;;3,0;1,0;1,0;;;4,0;2,0;2,0;;25,0;2,0;3,0;2,0;;1,0;;;;;;;;1,0;4,0;;2,0;;6,0;;3,0;;7,0;;;3,0;3,0;;;;;;;;2,0;;;6,0;3,0;;;4,0;4,0;1,0;;;;;;2,0;;3,0;1,0;2,0;;1,0;;;;;;;;;;1,0;;1,0;4,0;;;5,0;5,0;;;1,0;;;;;;;;;11,0;8,0;;;2,0;7,0;3,0;1,0;2,0;5,0;2,0;4,0;;;;;;1,0;;3,0;3,0;1,0;;;;;;4,0;;;;;;;;5,0;1,0;;3,0;;;2,0;;;5,0;;;;9,0;;;;4,0;;;;;
arrange;;3,0;3,0;2,0;49,0;1,0;129,0;62,0;7,0;40,0;23,0;3,0;7,0;;54,0;2,0;2,0;;41,0;7,0;3,0;89,0;9,0;7,0;5,0;4,0;3,0;66,0;2,0;23,0;20,0;30,0;184,0;2,0;47,0;34,0;12,0;181,0;5,0;132,0;25,0;;37,0;232,0;;;2,0;22,0;15,0;2,0;7,0;14,0;;107,0;;430,0;136,0;2,0;12,0;516,0;33,0;9,0;56,0;2,0;;46,0;9,0;13,0;;28,0;282,0;66,0;125,0;22,0;18,0;2,0;10,0;28,0;136,0;26,0;7,0;22,0;62,0;3,0;3,0;48,0;132,0;1,0;1,0;5,0;141,0;11,0;11,0;60,0;11,0;45,0;5,0;12,0;15,0;79,0;206,0;102,0;;67,0;2,0;;20,0;323,0;;1,0;6,0;;132,0;58,0;11,0;1,0;5,0;2,0;70,0;64,0;;1,0;3,0;90,0;3,0;;51,0;34,0;;13,0;32,0;;7,0;5,0;1,0;32,0;13,0;4,0;120,0;15,0;;1,0;14,0;57,0;71,0;6,0;106,0;88,0;2,0;14,0;4,0;11,0;18,0;;41,0;20,0;59,0;40,0;16,0;96,0;16,0;;23,0;15,0;9,0;48,0;3,0;232,0;;23,0;173,0;53,0;53,0;59,0;30,0;26,0;33,0;38,0;;4,0;10,0;9,0;7,0;11,0;8,0;62,0;50,0;424,0;2,0;280,0;4,0;13,0;15,0;119,0;3,0;28,0;9,0;7,0;11,0;8,0;33,0;58,0;4,0;316,0;1,0;4,0;12,0;2,0;26,0;60,0;7,0;32,0;5,0;1,0;7,0;7,0;18,0;52,0;3,0;3,0;20,0;18,0;10,0;3,0;14,0;16,0;14,0;;;1,0;;5,0;7,0;52,0;16,0;13,0;8,0;6,0;74,0;3,0;52,0;3,0;16,0;8,0;7,0;14,0;16,0;26,0;2,0;40,0;95,0;1,0;7,0;47,0;2,0;19,0;6,0;21,0;1,0;3,0;6,0;44,0;14,0;16,0;6,0;7,0;38,0;1,0;5,0;5,0;10,0;69,0;1,0;;4,0;10,0;;17,0;4,0;6,0;8,0;49,0;;35,0;4,0;3,0;10,0;150,0;9,0;44,0;17,0;19,0;11,0;64,0;12,0;22,0;54,0;28,0;2,0;15,0;3,0;;29,0;13,0;20,0;;18,0;8,0;16,0;5,0;23,0;17,0;;;3,0;5,0;4,0;6,0;9,0;8,0;17,0;3,0;18,0;11,0;15,0;29,0;8,0;4,0;14,0;2,0;9,0;3,0;1,0;;;1,0;1,0;3,0;1,0;5,0;2,0;5,0;;3,0;2,0;1,0;1,0;2,0;4,0;2,0;27,0;;;3,0;;2,0;3,0;;2,0;2,0;8,0;;4,0;1,0;6,0;6,0;6,0;;;2,0;;;;11,0;2,0;21,0;10,0;;;68,0;4,0;39,0;6,0;20,0;;;4,0;;;4,0;1,0;1,0;19,0;10,0;37,0;11,0;2,0;5,0;;;4,0;;;;;;3,0;7,0;3,0;3,0;8,0;9,0;16,0;7,0;4,0;;;;31,0;;16,0;;4,0;;20,0;;;7,0;2,0;7,0;5,0;9,0;1,0;;;;;;;2,0;12,0;;;2,0;19,0;39,0;47,0;22,0;;1,0;;3,0;21,0;4,0;;6,0;;;14,0;;;5,0;;3,0;9,0;11,0;51,0;4,0;5,0;;;20,0;;;2,0;3,0;36,0;;6,0;1,0;4,0;;;2,0;;17,0;28,0;1,0;1,0;10,0;3,0;15,0;3,0;3,0;13,0;16,0;43,0;9,0;1,0;;;3,0;;4,0;57,0;3,0;;5,0;;7,0;4,0;;1,0;7,0;14,0;25,0;4,0;;;;;;13,0;7,0;;9,0;5,0;;;4,0;;;11,0;10,0;3,0;7,0;2,0;1,0;;2,0;;2,0;1,0;;;5,0;5,0;;;;;5,0;2,0;1,0;7,0;8,0;2,0;;;10,0;392,0;5,0;12,0;2,0;;;15,0;4,0;;;;6,0;5,0;;3,0;8,0;4,0;;1,0;6,0;1,0;;12,0;;;27,0;4,0;;;2,0;4,0;1,0;;3,0;24,0;4,0;;;2,0;1,0;1,0;9,0;4,0;9,0;;;3,0;4,0;8,0;9,0;2,0;3,0;6,0;;;;;1,0;3,0;;5,0;;3,0;19,0;3,0;1,0;;;12,0;1,0;;50,0;1,0;7,0;11,0;2,0;69,0;7,0;2,0;;;;8,0;1,0;;2,0;;1,0;3,0;3,0;2,0;57,0;3,0;1,0;6,0;;;3,0;4,0;1,0;3,0;2,0;;;8,0;1,0;3,0;1,0;;6,0;;;;6,0;29,0;13,0;1,0;;4,0;;2,0;8,0;;;11,0;8,0;5,0;;3,0;2,0;5,0;7,0;1,0;1,0;;8,0;17,0;22,0;10,0;;22,0;1,0;2,0;2,0;2,0;;28,0;;;9,0;3,0;8,0;5,0;17,0;;;12,0;3,0;1,0;;7,0;2,0;4,0;18,0;2,0;;;6,0;;;;3,0;4,0;4,0;;;6,0;;;1,0;4,0;6,0;;;1,0;;10,0;3,0;;1,0;2,0;;;1,0;;2,0;5,0;2,0;4,0;36,0;;6,0;5,0;2,0;;5,0;;6,0;3,0;4,0;;8,0;;11,0;12,0;3,0;7,0;;;8,0;1,0;;1,0;1,0;;2,0;24,0;2,0;;;;;;1,0;6,0;3,0;;10,0;;3,0;;;;;;3,0;1,0;1,0;7,0;5,0;1,0;;2,0;1,0;8,0;;1,0;20,0;1,0;;8,0;;1,0;;;21,0;;7,0;20,0;4,0;5,0;26,0;14,0;;2,0;;2,0;;19,0;7,0;3,0;4,0;10,0;2,0;;3,0;2,0;;1,0;3,0;;;1,0;;2,0;;2,0;;9,0;10,0;1,0;8,0;2,0;18,0;4,0;;3,0;1,0;;2,0;;;14,0;3,0;2,0;1,0;4,0;;14,0;13,0;3,0;;;;2,0;11,0;;3,0;3,0;4,0;;;3,0;7,0;3,0;3,0;;;;22,0;;3,0;2,0;;;;;;;;14,0;1,0;;3,0;1,0;4,0;2,0;1,0;6,0;16,0;2,0;10,0;3,0;;;3,0;;4,0;1,0;;1,0;;1,0;;;5,0;5,0;;3,0;;;;;76,0;;;;;;2,0;6,0;8,0;;9,0;;7,0;10,0;;;;4,0;;;5,0;1,0;;;;;;;5,0;2,0;3,0;8,0;;;;4,0;;;;;2,0;13,0;10,0;8,0;;;1,0;;3,0;;;;5,0;;;;
articulate;;2,0;;;47,0;;;5,0;;;;;;;;;;;;;;;;;;;;;;1,0;;;6,0;;;2,0;;;;;;;;5,0;;;;;;;;;;10,0;;1,0;9,0;;;11,0;;;16,0;;;2,0;;;;;;1,0;;;;;;;3,0;1,0;;;;;;;;10,0;;;2,0;;;;;;;;2,0;;;4,0;;;;;;;;;1,0;;;5,0;6,0;;;;;7,0;;7,0;;;;;;;;3,0;;;;;;;3,0;;;;;;;;;2,0;2,0;;;;;;;;;;;;;;;;;;;;;1,0;;;2,0;;;17,0;;;;;;;;1,0;;;5,0;5,0;1,0;99,0;;;;;;;;;;;;;;;;;;;;;5,0;11,0;;;;;4,0;;;;;;;1,0;;;;;;;;;36,0;;;;1,0;;;4,0;;;;1,0;;;;2,0;;;;;;;;14,0;;;;;;;;2,0;;;;;10,0;;;;;1,0;;;;;;2,0;;;2,0;;;1,0;;;;3,0;2,0;1,0;;;;;;;;;;;;;;;;;;;;;;4,0;;;;;7,0;;;;;;;;;1,0;;;;;;;324,0;;;;;;;;;;;;;;;5,0;;;;;;;;;;;;;;;;;;;;;;1,0;;;;;;;;;;;;;;;;;;;;;;;;;;;;;;;7,0;;;;;;;1,0;;;;;1,0;;;;;;;;;;;;;;;;;;;;;;;;;;;1,0;;;;;8,0;1,0;;;;2,0;;;;2,0;;;;;;;;;;;;1,0;;;;;;2,0;;;;;;;5,0;;1,0;;;;;3,0;;;;;;;;;5,0;;;;;;;;;;;;;;;;;;;;;;;;;;;5,0;;;;;;;;;;;;;;;2,0;1,0;;;;;;;;;;;;;;;;;2,0;;;;;;;;;;2,0;;;;;;;;;;;;;;;;;;;;;;;;;;;;;;;;;;10,0;;;;;;;;;;;;;;;;;;;;;;;8,0;;;;;;;;;;;2,0;;;;;;;;;;;;18,0;;;;;;;;;3,0;;;;;;;;1,0;;;;;;;;;;;;;;;;;;;;;;;;;;;;;;;;;;;;9,0;;;;;;;;;;;;;;;;;;;;;;;;;;;;;;;;;;;;;;;;;;;;;;;;;;;;;;;;;;;;;;;;;;;;;;;;;;;;;;1,0;;;;;;;;;;;;;;;;;;;;;;;;;;;;10,0;;;;;;;;;;;;;;;;;;;;;;;;;;;;2,0;;;;;;;;;;;1,0;;;;;;;;;;;;;;1,0;;;;;;;;;;;;;;;;;;;;;;;;;;;3,0;3,0;;;;;;;;;;;;;;;;;6,0;;;;;2,0;;;;;;;;;;;;;;;;;;;;;;;;;;;;;;;;;;;;;;;;;;;;;;;;;;;;;;;;;;;;;;;;;;;;;;;;;;;;;;;;;;;;;;;;;;;;;
assembly;;41,0;4,0;1,0;66,0;4,0;103,0;115,0;1,0;63,0;13,0;;;1,0;4,0;7,0;;3,0;52,0;9,0;6,0;116,0;;;;;;19,0;19,0;10,0;7,0;22,0;118,0;;58,0;6,0;10,0;53,0;1,0;87,0;7,0;;26,0;71,0;;;4,0;15,0;56,0;4,0;10,0;10,0;;18,0;2,0;246,0;404,0;;27,0;1038,0;;1,0;94,0;1,0;2,0;36,0;27,0;;;24,0;178,0;2,0;9,0;1,0;1,0;9,0;;14,0;206,0;20,0;13,0;31,0;15,0;11,0;3,0;3,0;19,0;2,0;;12,0;168,0;;;15,0;4,0;18,0;2,0;2,0;4,0;25,0;108,0;175,0;;4,0;;5,0;7,0;80,0;;6,0;17,0;58,0;41,0;;62,0;;;1,0;28,0;137,0;12,0;3,0;4,0;35,0;3,0;3,0;131,0;25,0;2,0;107,0;82,0;;1,0;8,0;4,0;89,0;67,0;2,0;23,0;10,0;8,0;6,0;29,0;19,0;15,0;5,0;89,0;60,0;;3,0;;33,0;24,0;3,0;28,0;25,0;34,0;225,0;20,0;79,0;2,0;4,0;17,0;7,0;3,0;26,0;5,0;76,0;7,0;11,0;82,0;36,0;173,0;274,0;22,0;33,0;36,0;7,0;9,0;;22,0;8,0;24,0;;22,0;27,0;67,0;160,0;1,0;234,0;20,0;9,0;20,0;62,0;2,0;19,0;8,0;;43,0;49,0;3,0;17,0;8,0;48,0;21,0;;118,0;11,0;50,0;132,0;1,0;8,0;1,0;;12,0;12,0;6,0;9,0;2,0;29,0;15,0;55,0;2,0;10,0;21,0;4,0;37,0;17,0;;11,0;9,0;4,0;40,0;7,0;44,0;21,0;14,0;11,0;13,0;;114,0;3,0;13,0;13,0;22,0;21,0;5,0;8,0;1,0;8,0;;;2,0;51,0;1,0;1,0;41,0;34,0;6,0;4,0;3,0;35,0;15,0;7,0;29,0;3,0;45,0;25,0;3,0;4,0;12,0;23,0;3,0;5,0;17,0;8,0;2,0;;5,0;23,0;40,0;26,0;2,0;36,0;1,0;61,0;43,0;29,0;20,0;11,0;17,0;6,0;;;;2,0;;15,0;22,0;;58,0;3,0;25,0;5,0;11,0;10,0;5,0;14,0;19,0;7,0;;10,0;19,0;5,0;50,0;27,0;33,0;13,0;12,0;25,0;2,0;6,0;19,0;32,0;;17,0;14,0;26,0;7,0;2,0;31,0;;9,0;2,0;;;;11,0;;;1,0;18,0;4,0;;;3,0;;2,0;15,0;7,0;31,0;10,0;3,0;;;;;3,0;5,0;8,0;;1,0;2,0;1,0;2,0;5,0;;;11,0;3,0;;;;3,0;;14,0;6,0;4,0;2,0;6,0;;2,0;8,0;4,0;;;23,0;;;3,0;5,0;10,0;13,0;2,0;94,0;3,0;1,0;9,0;3,0;;4,0;;6,0;;;;;9,0;;4,0;25,0;15,0;6,0;7,0;3,0;;10,0;;11,0;6,0;9,0;1,0;4,0;8,0;13,0;5,0;1,0;8,0;14,0;11,0;2,0;;4,0;3,0;2,0;3,0;;;;32,0;24,0;;8,0;1,0;7,0;37,0;;2,0;;11,0;;1,0;79,0;11,0;2,0;2,0;;;4,0;;;;;1,0;1,0;14,0;57,0;;8,0;;;7,0;8,0;;3,0;;54,0;;;1,0;;3,0;;4,0;;83,0;10,0;4,0;;3,0;;6,0;12,0;17,0;41,0;115,0;8,0;3,0;1,0;;1,0;;3,0;7,0;29,0;34,0;;;;7,0;16,0;;;14,0;13,0;14,0;35,0;;;;10,0;14,0;2,0;14,0;;;5,0;10,0;14,0;2,0;1,0;;18,0;5,0;;;6,0;6,0;21,0;6,0;;9,0;;14,0;11,0;8,0;31,0;1,0;;29,0;1,0;19,0;3,0;;13,0;;3,0;2,0;11,0;3,0;5,0;;30,0;;2,0;;50,0;;2,0;;19,0;1,0;;2,0;6,0;;17,0;1,0;2,0;4,0;4,0;;6,0;1,0;2,0;64,0;5,0;;;;2,0;15,0;5,0;;21,0;1,0;5,0;;8,0;2,0;;;17,0;8,0;21,0;;3,0;7,0;1,0;25,0;17,0;3,0;6,0;;;;22,0;6,0;9,0;1,0;;9,0;;7,0;3,0;1,0;6,0;3,0;;2,0;1,0;14,0;36,0;8,0;29,0;23,0;48,0;24,0;20,0;2,0;25,0;2,0;7,0;4,0;;;;2,0;5,0;6,0;;26,0;16,0;34,0;5,0;7,0;7,0;1,0;;8,0;5,0;5,0;;5,0;5,0;12,0;;6,0;4,0;8,0;44,0;;;10,0;5,0;2,0;5,0;4,0;;;;;;1,0;1,0;;1,0;2,0;;;;1,0;;;;;;6,0;8,0;2,0;4,0;;;2,0;;;;;;27,0;;2,0;;16,0;1,0;;;20,0;;5,0;5,0;;;7,0;1,0;5,0;;;5,0;;2,0;;1,0;1,0;;3,0;;;1,0;;3,0;1,0;;;2,0;3,0;;;;;;;1,0;1,0;;;;;10,0;3,0;;12,0;6,0;1,0;;4,0;;;2,0;;4,0;8,0;8,0;;;68,0;;11,0;3,0;;;5,0;;;;;;;12,0;;;;1,0;;;;;5,0;;2,0;;;;21,0;;;;1,0;1,0;;;;;1,0;9,0;;;;;3,0;1,0;;11,0;3,0;;;20,0;1,0;2,0;3,0;3,0;7,0;2,0;8,0;;3,0;;5,0;8,0;3,0;1,0;;10,0;3,0;3,0;;;;;12,0;1,0;;;;;;20,0;;5,0;;3,0;3,0;;2,0;23,0;1,0;9,0;;4,0;51,0;12,0;74,0;;;7,0;1,0;;3,0;;1,0;;;;7,0;14,0;2,0;;11,0;2,0;;;;;;;3,0;4,0;;;12,0;2,0;;11,0;9,0;4,0;;;;;;11,0;;;9,0;;3,0;7,0;2,0;1,0;;;10,0;;;2,0;8,0;;;1,0;28,0;;;;;4,0;;3,0;;;1,0;;;1,0;;;;;;1,0;;;;1,0;11,0;1,0;2,0;;;3,0;2,0;;;;6,0;;;;4,0;4,0;;;;5,0;;4,0;1,0;;1,0;;;;3,0;;2,0;;2,0;10,0;;;;;;;;;1,0;1,0;;;
association;;2,0;;;;;;8,0;2,0;6,0;;;;4,0;;;;;2,0;;1,0;7,0;;2,0;1,0;;;29,0;;3,0;1,0;8,0;7,0;1,0;1,0;;;;;6,0;2,0;;6,0;3,0;;;;;;;;3,0;1,0;2,0;;58,0;3,0;;;7,0;;;6,0;;1,0;;1,0;;1,0;5,0;5,0;;1,0;;;4,0;9,0;4,0;9,0;;;2,0;8,0;;;;;;;10,0;3,0;;1,0;7,0;;;;4,0;25,0;;2,0;16,0;;1,0;;;;12,0;;;;;;4,0;;;;;;1,0;;;;2,0;;;3,0;;;;;2,0;;1,0;;;1,0;;;;;2,0;1,0;2,0;7,0;;1,0;1,0;;;;;;;;;1,0;;;2,0;;;;;;;;;;;1,0;;1,0;3,0;8,0;2,0;;;;;4,0;;;;4,0;;;2,0;;1,0;;;;2,0;;;;;2,0;;;;;;;;;;;6,0;;;;;;3,0;;;;9,0;;;;;;;;;;;;;3,0;;;1,0;;1,0;3,0;;;;;;;;;;1,0;;;;;;;;;4,0;;;1,0;5,0;2,0;;1,0;;;5,0;;;;;;;;4,0;1,0;1,0;;;2,0;;;1,0;;2,0;1,0;22,0;;;;;;1,0;;;;;;;1,0;;;;;;6,0;8,0;;;;1,0;;;3,0;;;;;;;;7,0;;;2,0;;;2,0;;;;;2,0;;;;1,0;;1,0;;6,0;;;;;;;;10,0;;;;;;;;1,0;;;;;;;;2,0;1,0;;;;;1,0;;;8,0;7,0;;;;;;;;1,0;2,0;;;;;7,0;;;;15,0;;;2,0;;;;3,0;;;;;;2,0;;;;;1,0;;;1,0;;1,0;;2,0;;;;;;;;;;;4,0;;;;;;;;;2,0;;;;;;;1,0;1,0;;4,0;21,0;;;2,0;;;;;;1,0;;;;;;;4,0;2,0;;2,0;;;13,0;;;;;1,0;;5,0;;1,0;;1,0;1,0;;;;;;1,0;;3,0;8,0;3,0;1,0;4,0;;;;;;2,0;1,0;;;4,0;;;;;;;8,0;1,0;2,0;;;;14,0;;4,0;;;;;;2,0;;;;;;;;4,0;;1,0;;;11,0;;2,0;;1,0;;;;;;;4,0;1,0;;2,0;;;;36,0;4,0;3,0;;;;;;1,0;;;;;;;;;;;;1,0;;;;4,0;;;;2,0;;;;;;;;;;;;;;;;;;;;;;4,0;;;4,0;;;;;;;;;;2,0;;;;3,0;;;;;;;;;;;;;;;;;;;2,0;;;;;;;;;;;;;;;;;;;;;;;;;;;;;;;;;;;;;1,0;;;;1,0;;;;;;;;;;;;;;;;;;;;;;;;;8,0;;;;;;;;;;;;;;;;;1,0;;;;;;2,0;;;2,0;;;;;;;;;;;;;;;;;;3,0;;;;;;;;;;;3,0;;;;;;;1,0;;;;;1,0;;3,0;;;;;;;;2,0;;;;;;;;;;;;2,0;;;;;;;;;;1,0;;;;;4,0;;;3,0;;;;;;;;1,0;;;;;2,0;;;;;;;;;;;;;;;;;;;;;;;;;;;2,0;;;;2,0;;;;;;;;;;;;;;;;;;;;;;;2,0;;;;;;;;;;;;;;;;;;;;;;2,0;;;;;;;;4,0;;;;;;;;;;;;;;;;2,0;;;;;;;;;;;;;;;;;2,0;;;10,0;;;;;;;;;;;;;;;4,0;;;;;;;;;;;;;;;;;;;;;;;5,0;;;2,0;;;;2,0;;;;;
attach;;53,0;3,0;1,0;59,0;;34,0;216,0;3,0;29,0;12,0;;4,0;;;4,0;;1,0;26,0;5,0;7,0;24,0;1,0;5,0;11,0;;;63,0;5,0;27,0;11,0;7,0;210,0;;50,0;;2,0;22,0;;24,0;7,0;;6,0;85,0;;;5,0;4,0;12,0;3,0;1,0;14,0;5,0;7,0;9,0;196,0;73,0;;10,0;468,0;1,0;1,0;73,0;;3,0;33,0;8,0;2,0;;14,0;69,0;1,0;6,0;15,0;13,0;11,0;5,0;12,0;61,0;2,0;5,0;23,0;4,0;3,0;;;5,0;3,0;;6,0;81,0;;1,0;17,0;2,0;7,0;;49,0;23,0;51,0;178,0;101,0;;8,0;;;4,0;229,0;1,0;4,0;29,0;11,0;1,0;62,0;;5,0;6,0;;35,0;259,0;5,0;7,0;2,0;24,0;1,0;;43,0;7,0;;7,0;84,0;13,0;;43,0;;7,0;3,0;2,0;12,0;6,0;2,0;3,0;5,0;25,0;35,0;8,0;46,0;104,0;5,0;7,0;;5,0;10,0;5,0;16,0;60,0;24,0;91,0;4,0;54,0;;;61,0;24,0;5,0;10,0;7,0;36,0;3,0;8,0;376,0;14,0;77,0;185,0;8,0;32,0;93,0;13,0;16,0;;14,0;3,0;;2,0;46,0;31,0;73,0;77,0;1,0;215,0;1,0;6,0;;23,0;1,0;1,0;;2,0;20,0;16,0;6,0;17,0;7,0;80,0;7,0;31,0;20,0;18,0;57,0;168,0;;5,0;3,0;;12,0;12,0;7,0;11,0;1,0;53,0;65,0;61,0;1,0;;23,0;;10,0;18,0;6,0;1,0;;;6,0;5,0;7,0;13,0;22,0;4,0;14,0;2,0;50,0;1,0;10,0;25,0;20,0;34,0;7,0;24,0;1,0;21,0;;1,0;9,0;30,0;1,0;1,0;16,0;24,0;;1,0;;18,0;15,0;7,0;15,0;4,0;25,0;12,0;6,0;8,0;16,0;48,0;1,0;7,0;21,0;6,0;;1,0;4,0;1,0;15,0;12,0;4,0;32,0;10,0;6,0;11,0;17,0;13,0;38,0;6,0;3,0;;3,0;;5,0;;66,0;10,0;1,0;4,0;10,0;8,0;2,0;7,0;4,0;4,0;4,0;37,0;7,0;6,0;11,0;;3,0;45,0;6,0;6,0;2,0;25,0;3,0;;10,0;13,0;26,0;;10,0;4,0;37,0;;;21,0;;10,0;1,0;;;;1,0;;1,0;1,0;3,0;;3,0;3,0;;;1,0;8,0;;12,0;1,0;;1,0;;;;;7,0;;;;;;3,0;7,0;;1,0;3,0;;22,0;12,0;;;42,0;17,0;2,0;;;3,0;;25,0;;4,0;;;;;;12,0;5,0;;5,0;1,0;7,0;1,0;;4,0;;;3,0;;;1,0;;1,0;1,0;1,0;;3,0;1,0;6,0;12,0;;;1,0;5,0;;16,0;;14,0;4,0;3,0;2,0;4,0;;;5,0;;;;;;;1,0;35,0;;1,0;;11,0;4,0;;;1,0;1,0;12,0;6,0;;2,0;2,0;;1,0;4,0;15,0;;1,0;9,0;;;1,0;5,0;;;;1,0;15,0;39,0;10,0;1,0;;;4,0;13,0;;1,0;2,0;7,0;;;;15,0;;;;;14,0;3,0;;;8,0;;7,0;;6,0;64,0;9,0;1,0;;;9,0;6,0;;;1,0;19,0;88,0;19,0;1,0;;10,0;7,0;;;4,0;10,0;9,0;17,0;;;;88,0;10,0;1,0;1,0;;3,0;19,0;6,0;;;4,0;;1,0;2,0;8,0;;6,0;13,0;2,0;;2,0;1,0;;7,0;12,0;2,0;4,0;4,0;2,0;1,0;5,0;3,0;8,0;;12,0;7,0;8,0;2,0;3,0;;4,0;;3,0;;19,0;;9,0;;;;19,0;13,0;3,0;;6,0;;5,0;;3,0;5,0;;;1,0;;;15,0;5,0;;;;5,0;22,0;6,0;;;;1,0;;1,0;9,0;16,0;;1,0;1,0;12,0;;43,0;37,0;10,0;5,0;;6,0;2,0;3,0;;;4,0;7,0;38,0;1,0;1,0;1,0;;8,0;;17,0;2,0;45,0;2,0;15,0;;15,0;22,0;2,0;3,0;5,0;12,0;1,0;84,0;7,0;8,0;;;4,0;;;;2,0;;1,0;;13,0;7,0;9,0;8,0;9,0;;1,0;1,0;;5,0;1,0;9,0;1,0;;6,0;2,0;8,0;5,0;;;;2,0;1,0;;1,0;3,0;7,0;;;;;;;;4,0;;;;;;8,0;;;;;;3,0;2,0;;;;2,0;;;2,0;;;;3,0;1,0;4,0;;;;;;10,0;;12,0;3,0;12,0;1,0;;;;;;3,0;;;;1,0;;;;1,0;;;;1,0;;;;;;;;;;;6,0;32,0;2,0;;;;;1,0;;;2,0;;2,0;;1,0;;;;;4,0;;;;;22,0;;2,0;;;;;;1,0;;3,0;3,0;2,0;;;;;;;;;;10,0;;6,0;;;;5,0;;;8,0;;10,0;;;;;;7,0;4,0;;1,0;2,0;4,0;;;1,0;29,0;;10,0;9,0;;;;8,0;3,0;;2,0;;;;;1,0;;;;3,0;;;4,0;;;;13,0;3,0;;;;;;3,0;;3,0;;7,0;4,0;;;1,0;;;2,0;;3,0;2,0;;5,0;;6,0;1,0;3,0;;;;3,0;11,0;;2,0;32,0;;1,0;;;;;1,0;;;;;;;1,0;6,0;;10,0;7,0;;3,0;;11,0;2,0;;;1,0;;4,0;2,0;;;;;;;;2,0;;;1,0;1,0;;;;2,0;;;;;;;1,0;6,0;;;1,0;;;;;;;1,0;3,0;;;;1,0;13,0;3,0;;;;3,0;4,0;1,0;;;;1,0;;;;;;;2,0;;;1,0;;7,0;;;;;;;;;;;;;;2,0;;;;18,0;14,0;;;;
attachment;;17,0;;;38,0;;7,0;48,0;;2,0;1,0;1,0;;;2,0;1,0;;;;1,0;1,0;9,0;;;1,0;;;49,0;8,0;33,0;18,0;4,0;79,0;;23,0;;;7,0;2,0;8,0;2,0;;;32,0;;;3,0;;;;2,0;18,0;;4,0;1,0;46,0;39,0;;5,0;107,0;;2,0;12,0;;;;2,0;7,0;;7,0;10,0;;;2,0;;;;48,0;43,0;3,0;;4,0;;;;;4,0;;10,0;2,0;9,0;4,0;20,0;2,0;6,0;1,0;;19,0;3,0;;23,0;24,0;;;;;12,0;48,0;;;15,0;3,0;3,0;34,0;88,0;;;;11,0;41,0;;;;1,0;;;35,0;2,0;;20,0;4,0;1,0;;;;18,0;8,0;;;;;;4,0;7,0;;2,0;27,0;4,0;;1,0;;3,0;2,0;;;15,0;25,0;10,0;;14,0;;;8,0;;;;1,0;11,0;2,0;;72,0;15,0;12,0;52,0;1,0;3,0;5,0;;7,0;;2,0;;;;5,0;2,0;37,0;8,0;;60,0;;2,0;;12,0;2,0;;;;4,0;12,0;;6,0;;13,0;;1,0;4,0;;12,0;43,0;;;1,0;;1,0;4,0;2,0;3,0;;1,0;16,0;2,0;2,0;;15,0;;9,0;;2,0;;;;1,0;4,0;2,0;9,0;4,0;3,0;8,0;;3,0;1,0;1,0;7,0;4,0;19,0;;;;;;11,0;1,0;23,0;1,0;1,0;3,0;13,0;;1,0;;;3,0;;12,0;5,0;3,0;18,0;;;2,0;4,0;;;15,0;1,0;;;3,0;3,0;7,0;4,0;9,0;13,0;2,0;;1,0;10,0;;7,0;1,0;;;;;;;1,0;1,0;;4,0;19,0;4,0;2,0;;1,0;;;4,0;;;3,0;;;11,0;;7,0;;2,0;;8,0;;10,0;;;1,0;;33,0;;;11,0;2,0;;;;;;;;;1,0;7,0;4,0;2,0;1,0;;;4,0;;;1,0;;;;;;1,0;;2,0;;;;;;;;2,0;;2,0;;18,0;;;;17,0;3,0;6,0;;;3,0;;10,0;;1,0;;;;;;4,0;1,0;;;;;;2,0;4,0;;;;;;;;;;;;1,0;1,0;10,0;;;;3,0;2,0;;;;9,0;;3,0;1,0;3,0;1,0;;;;;;;;;;5,0;;;;3,0;4,0;;;;2,0;2,0;1,0;1,0;;;;;6,0;;;;1,0;;;1,0;2,0;1,0;;;;;1,0;5,0;1,0;;;2,0;3,0;;;2,0;1,0;3,0;;;4,0;;;1,0;;10,0;2,0;;;3,0;;2,0;;;11,0;3,0;;;;;3,0;;;;14,0;;;2,0;;1,0;2,0;;;;6,0;11,0;3,0;;;;4,0;7,0;;;;;8,0;;;;;;;;10,0;;2,0;;;;;;;;1,0;;2,0;;1,0;2,0;;;;;;;;3,0;3,0;1,0;;;;;1,0;;;;;;1,0;2,0;;;;;8,0;;;;;;;;;9,0;12,0;1,0;;;;1,0;;;2,0;;1,0;;3,0;2,0;5,0;;;;;1,0;8,0;9,0;;;11,0;6,0;;;;;2,0;8,0;4,0;1,0;4,0;;;2,0;;;7,0;4,0;2,0;10,0;;2,0;10,0;2,0;2,0;1,0;;;14,0;1,0;2,0;;;;;;;1,0;4,0;1,0;;;;1,0;;3,0;;2,0;;3,0;5,0;;;;;;;5,0;42,0;;;;;1,0;;;;;;;;;;;;;;;;;;;;;;;;;;;;;;;;;;;;;;2,0;;;;;;;;1,0;;;;;;;;;;;;;1,0;;;;;;1,0;;;;;;;;;;;;;1,0;;;;;;1,0;1,0;7,0;;;;;;2,0;;;;;;;;;;4,0;;10,0;;;;;;1,0;;;;;;;;;;;2,0;;;;;;;;;;;;;;;;;;;;;1,0;;;;;;;;3,0;;;1,0;;1,0;;1,0;3,0;;;;;;;;;;;;;;;;;;;;;;2,0;;;;;;;7,0;;;3,0;;;;;;;;;2,0;;4,0;;;;;;;;;;5,0;;;;;;;;;;;;2,0;;;;;3,0;1,0;;;;;;;;;;;1,0;;;;;;;;1,0;;;;;;;;12,0;;;;;1,0;;;;;;;;;;;;;;;;;;;3,0;;1,0;;;1,0;;;;;;;;;;;;;3,0;;;1,0;;;;;;;;;;;;;;;;;;;;;;;;;
auxiliary;;1,0;10,0;;10,0;;5,0;15,0;;35,0;2,0;10,0;;;1,0;;;;8,0;8,0;;25,0;52,0;1,0;;;;12,0;1,0;8,0;;5,0;86,0;1,0;2,0;;3,0;3,0;;65,0;3,0;;;12,0;;2,0;2,0;1,0;4,0;;25,0;8,0;;;;49,0;9,0;;1,0;24,0;6,0;;10,0;;;;3,0;;;3,0;8,0;;4,0;;;5,0;;7,0;10,0;10,0;;5,0;4,0;2,0;5,0;;7,0;;6,0;7,0;3,0;;;;1,0;1,0;;4,0;4,0;55,0;;87,0;;;;;;46,0;;;3,0;3,0;;;;;;;;;;;4,0;;;;;;;3,0;;;;;9,0;9,0;;;4,0;27,0;;;;;;4,0;2,0;1,0;;;;;3,0;;1,0;;1,0;1,0;90,0;6,0;2,0;1,0;1,0;2,0;2,0;4,0;;124,0;;;10,0;18,0;;1,0;2,0;1,0;;2,0;;;;;2,0;;4,0;;2,0;11,0;10,0;8,0;;;2,0;4,0;;28,0;;;5,0;;;;;4,0;;2,0;;;1,0;7,0;;;;1,0;;;;2,0;;2,0;;;;;;3,0;;;;;;;;24,0;;5,0;1,0;3,0;1,0;10,0;1,0;;;2,0;1,0;;1,0;;;;;2,0;;36,0;;;;18,0;;;;;;5,0;4,0;;1,0;;;2,0;;;;;;;;;;23,0;7,0;10,0;;1,0;;14,0;1,0;29,0;1,0;1,0;1,0;;;4,0;;;;;;;2,0;;4,0;4,0;2,0;4,0;3,0;1,0;;;19,0;3,0;;;8,0;;;;;6,0;;;1,0;;;12,0;;;12,0;;12,0;;;;;;;;;;;3,0;;2,0;;;;;;2,0;;;2,0;2,0;;8,0;6,0;;;2,0;;2,0;;;;2,0;;;;;;;;3,0;2,0;2,0;;;;;;;;;;;;;;4,0;2,0;;;1,0;;;;;;;;;;;;;;;;;2,0;3,0;;;;;;;22,0;6,0;;2,0;;2,0;9,0;3,0;2,0;1,0;;3,0;;;;;;5,0;;3,0;;;;;;;;15,0;;;;;;;9,0;2,0;;;;;4,0;;;;;;;13,0;;2,0;1,0;;;2,0;;;;;;;4,0;;;;;;;;;6,0;5,0;2,0;1,0;25,0;;1,0;2,0;34,0;;;1,0;;;;;;3,0;;;;;;;;;;6,0;4,0;;;;;;;;;;20,0;2,0;;;;;;;;;;;;;;;;;;;3,0;6,0;;;;;;12,0;;;;;;;17,0;5,0;;;;;;;;;;;;;;;;;;1,0;1,0;;16,0;22,0;;;;1,0;;;;;;;;;1,0;;;;;;2,0;2,0;;;;1,0;;;;3,0;;;;;;;;1,0;;;;;18,0;1,0;;;;;;;93,0;;;8,0;;20,0;;;;;;1,0;;;;;;;;;1,0;;;;;;;;;1,0;1,0;;;;;;;;;;;3,0;1,0;;;;;;;;;;;;;;;;;;;;;3,0;;;;;;;;16,0;;;;;;4,0;1,0;;;1,0;;;12,0;;;;;;;;2,0;;;;;;;;;;;;;;;;;;;;;1,0;;;;;;;;;;;;;;;;;;3,0;1,0;2,0;;;;;;;;;;4,0;;;1,0;;;;;;;;2,0;;;;;;;;;2,0;;7,0;;;;;;;;;;2,0;;;;;;;2,0;2,0;;;2,0;;;;;;3,0;;2,0;;;;;;2,0;;;;;;;;;2,0;2,0;;3,0;;;;;;17,0;;;11,0;;;;1,0;;2,0;;;;;;;;;;;;;;8,0;;;;;;;;;;;1,0;;;;;;;;;;;;1,0;4,0;;;;;1,0;;;;;;;;;2,0;;;1,0;;;;;;;;3,0;;;;;11,0;10,0;;;;;;;;;;;;;;;;;;;;;;;;;;;;;;;;1,0;;;;15,0;;;;;;1,0;;;;;5,0;;3,0;;;;;;1,0;;;;;;;;;;;;1,0;;;;;
barrel;;5,0;4,0;;56,0;;248,0;78,0;;10,0;10,0;;3,0;;;1,0;;;5,0;;8,0;65,0;1,0;;1,0;;;7,0;3,0;18,0;13,0;1,0;178,0;;60,0;;2,0;147,0;2,0;8,0;9,0;;72,0;122,0;;;8,0;10,0;40,0;;12,0;4,0;;73,0;3,0;134,0;342,0;;15,0;3675,0;8,0;5,0;32,0;;;26,0;38,0;6,0;;24,0;311,0;3,0;8,0;24,0;26,0;10,0;15,0;7,0;269,0;12,0;14,0;;4,0;3,0;;14,0;20,0;1,0;;;80,0;6,0;18,0;12,0;6,0;64,0;1,0;9,0;38,0;25,0;190,0;133,0;2,0;22,0;;;16,0;255,0;1,0;;13,0;52,0;14,0;114,0;50,0;;52,0;;14,0;79,0;4,0;;2,0;6,0;;;102,0;52,0;;78,0;48,0;;;101,0;35,0;13,0;116,0;;14,0;1,0;;;33,0;37,0;29,0;16,0;143,0;104,0;;6,0;;57,0;57,0;8,0;161,0;224,0;71,0;116,0;3,0;119,0;12,0;4,0;227,0;46,0;;5,0;;61,0;1,0;19,0;245,0;;339,0;234,0;38,0;66,0;202,0;5,0;7,0;;;11,0;6,0;6,0;;13,0;31,0;142,0;;236,0;4,0;32,0;;323,0;15,0;2,0;;12,0;30,0;25,0;1,0;33,0;11,0;77,0;33,0;;;20,0;34,0;103,0;1,0;15,0;;1,0;1,0;29,0;5,0;12,0;5,0;;47,0;;23,0;;111,0;;2,0;;;24,0;18,0;;81,0;30,0;13,0;6,0;32,0;25,0;13,0;5,0;;;26,0;35,0;;11,0;2,0;13,0;45,0;44,0;;2,0;6,0;58,0;3,0;1,0;45,0;113,0;;30,0;2,0;72,0;11,0;30,0;107,0;12,0;86,0;9,0;18,0;7,0;3,0;48,0;3,0;12,0;23,0;11,0;1,0;4,0;12,0;26,0;6,0;40,0;4,0;32,0;15,0;5,0;128,0;29,0;11,0;19,0;6,0;2,0;7,0;;11,0;7,0;;57,0;1,0;5,0;25,0;;14,0;27,0;29,0;24,0;;9,0;34,0;18,0;9,0;6,0;59,0;59,0;23,0;;7,0;23,0;30,0;8,0;25,0;11,0;10,0;21,0;12,0;10,0;19,0;19,0;10,0;;2,0;4,0;;;;1,0;;;;;5,0;5,0;;1,0;2,0;;;7,0;10,0;10,0;7,0;1,0;;;;;;1,0;;3,0;;;3,0;;1,0;;;;;;1,0;;;;;6,0;1,0;;;7,0;2,0;14,0;;;;22,0;;2,0;;;;15,0;6,0;;14,0;4,0;;;;2,0;;;;;;2,0;;48,0;1,0;;9,0;7,0;;7,0;;;1,0;;22,0;6,0;;1,0;;22,0;20,0;;;;1,0;;1,0;;;;;;2,0;;;;3,0;;;;5,0;10,0;3,0;8,0;;9,0;;2,0;26,0;;1,0;;1,0;;;;;;;;;1,0;108,0;;;;;7,0;3,0;;3,0;1,0;2,0;;;;6,0;;;;;84,0;1,0;;;1,0;;22,0;9,0;1,0;;4,0;;;2,0;;;;;;24,0;3,0;;14,0;;1,0;19,0;;;;2,0;8,0;4,0;;;;;4,0;;;;;;1,0;;6,0;2,0;;8,0;;;;5,0;;1,0;;;;1,0;25,0;2,0;;;;;;;;3,0;;;1,0;1,0;;1,0;3,0;;;;;;;92,0;;5,0;;;;;;7,0;;5,0;;;2,0;;13,0;11,0;2,0;;59,0;108,0;;;;3,0;13,0;;1,0;;2,0;5,0;;3,0;12,0;;;;2,0;;;12,0;8,0;6,0;3,0;6,0;2,0;2,0;;4,0;;;;2,0;;9,0;2,0;;1,0;;;;;1,0;;;3,0;3,0;3,0;3,0;1,0;3,0;4,0;;3,0;;2,0;;;1,0;5,0;;1,0;2,0;6,0;;;;;28,0;6,0;8,0;;1,0;1,0;;9,0;;;4,0;1,0;;1,0;;5,0;;16,0;;10,0;6,0;;1,0;1,0;;;2,0;2,0;;;1,0;;2,0;1,0;;;;1,0;;;;;;5,0;1,0;;8,0;;;;;;;;;;;;1,0;;;;;3,0;;;13,0;;6,0;;;16,0;;;1,0;;2,0;;;2,0;;;1,0;5,0;;;;1,0;;;;7,0;;;11,0;;;2,0;;;;;;8,0;7,0;;2,0;;;5,0;;;5,0;;;;;;1,0;;3,0;2,0;;6,0;;;;;;;;;;;;;;1,0;;;6,0;;;1,0;;3,0;;;;13,0;;;;;;;;;;;2,0;;;;;;;;;;;2,0;;;;;;9,0;;;;3,0;;26,0;;;;;5,0;1,0;2,0;2,0;2,0;1,0;1,0;8,0;4,0;;;;;;;;9,0;1,0;3,0;19,0;;3,0;;;;;;;;;3,0;;2,0;;;;2,0;;;;1,0;15,0;9,0;1,0;;;;;;1,0;;;5,0;;1,0;;;4,0;;16,0;;4,0;3,0;;;;;;;;;;;;;;;2,0;;;;;;10,0;;;;;;;;;;;;;2,0;;;;;;;;;3,0;2,0;8,0;;;;2,0;;;1,0;;1,0;7,0;;;;3,0;;;;;;;;;;;;;;1,0;;;;;;;;;;;;;;;;;;1,0;;;;
battery;;3,0;25,0;;13,0;;2,0;15,0;1,0;7,0;;7,0;;;6,0;1,0;;;3,0;3,0;;25,0;;;1,0;;;8,0;;54,0;37,0;63,0;84,0;8,0;41,0;;;4,0;;38,0;;;5,0;3,0;3,0;;;;;2,0;4,0;4,0;;;;23,0;39,0;;3,0;5,0;;;25,0;15,0;;5,0;2,0;;4,0;24,0;3,0;1,0;2,0;;;2,0;;;9,0;184,0;3,0;;8,0;1,0;;;20,0;2,0;;1,0;2,0;;;10,0;;4,0;1,0;11,0;3,0;;15,0;53,0;;2,0;;;6,0;114,0;;;1,0;2,0;;32,0;11,0;1,0;;;3,0;17,0;;;1,0;12,0;;;33,0;1,0;;5,0;11,0;;;;;10,0;7,0;7,0;;;14,0;;10,0;1,0;1,0;;4,0;8,0;1,0;;;;;;1,0;;;53,0;7,0;3,0;;3,0;1,0;2,0;;;62,0;15,0;11,0;;9,0;5,0;54,0;24,0;2,0;7,0;1,0;13,0;;;7,0;;2,0;;;;9,0;38,0;;8,0;;;;25,0;;;;;3,0;3,0;;;;11,0;;;;;2,0;7,0;;1,0;;2,0;;14,0;3,0;;;;3,0;2,0;;;6,0;;2,0;;;;8,0;1,0;;2,0;14,0;;;6,0;5,0;;;;;3,0;;4,0;;;;1,0;;;;14,0;2,0;;;1,0;;;;1,0;;;7,0;;3,0;;;;;;;;7,0;4,0;;;3,0;3,0;8,0;;2,0;3,0;;;;;11,0;;;;;;;;;;2,0;;18,0;;13,0;;;1,0;;6,0;;2,0;4,0;;;;;;;;1,0;;;5,0;1,0;6,0;;34,0;;2,0;57,0;;1,0;4,0;;;;;;;;;;6,0;;2,0;1,0;;;1,0;6,0;2,0;2,0;;2,0;;;8,0;;;;;;;;;;4,0;;;4,0;;2,0;;;31,0;3,0;12,0;;;;3,0;4,0;;1,0;;12,0;;;;;14,0;;1,0;1,0;;;4,0;;;8,0;8,0;;;;;;;;;;3,0;;3,0;2,0;;1,0;;;;3,0;;;;5,0;36,0;9,0;3,0;1,0;;;;;;;;2,0;6,0;;;7,0;;;;1,0;;;6,0;;;;;;;;16,0;;2,0;2,0;;;;;;1,0;7,0;;;4,0;;12,0;;;26,0;;;2,0;;;2,0;;;;;;3,0;;5,0;3,0;1,0;;1,0;;5,0;22,0;6,0;30,0;;;98,0;;;1,0;;;;;3,0;;;;5,0;1,0;;;6,0;18,0;2,0;7,0;;;;2,0;;;;;;2,0;3,0;;;10,0;;;;;;3,0;3,0;3,0;;;;;4,0;3,0;2,0;2,0;;1,0;;1,0;;;;2,0;;3,0;2,0;;;;3,0;1,0;;;;2,0;;;;;;;;;;3,0;;;4,0;;;;;1,0;4,0;6,0;;;;30,0;;1,0;;8,0;11,0;1,0;18,0;1,0;;1,0;;13,0;1,0;2,0;;;;;;;1,0;;;;;1,0;;3,0;;;;;4,0;1,0;;2,0;1,0;7,0;1,0;1,0;;;;;;;;;;;;;;;;;4,0;;6,0;;2,0;;;;7,0;1,0;1,0;;;;;;;;4,0;;2,0;;;3,0;;1,0;5,0;2,0;;;;;;;;;1,0;;1,0;;;;;6,0;17,0;;;;;;;;;;;;;;;;;2,0;14,0;;64,0;;;;;;;;;;;;;;;;;;2,0;;;;1,0;;;;;;;;;;;1,0;;;;;;;2,0;;14,0;;;;;3,0;;;;;;;;;1,0;;;23,0;;;;;1,0;;;;;;;;;;4,0;;;;;;;1,0;;;;;3,0;;;;;;;;;;;;;;;;1,0;;1,0;1,0;;2,0;;;;;5,0;;;;;;;;1,0;10,0;;;;;;3,0;;;;;4,0;;;8,0;;;;;;;;;;;;;;1,0;1,0;;;;;;;;;;1,0;;;;;;;;;;;;2,0;;;;;;9,0;;;;;;;;;;;;;;;;;;;;3,0;;;;;;;;;;;;;;;3,0;6,0;;;;;3,0;;;;;;;7,0;;;;;1,0;;;;;;;;;;;5,0;;;;;;;;;;;;;;;;;;1,0;;;;1,0;;;;;;;;;;;;;;;;;;;;;;;;
board;;2,0;;;25,0;1,0;16,0;56,0;1,0;59,0;1,0;;;;;4,0;;;43,0;2,0;2,0;61,0;;;18,0;;6,0;37,0;;2,0;4,0;1,0;85,0;3,0;37,0;2,0;4,0;36,0;4,0;10,0;4,0;;18,0;67,0;;;8,0;;2,0;1,0;;;;;2,0;209,0;93,0;;13,0;136,0;1,0;;32,0;1,0;;8,0;3,0;1,0;1,0;4,0;53,0;3,0;;1,0;5,0;;2,0;3,0;52,0;9,0;6,0;4,0;6,0;3,0;;;7,0;2,0;;10,0;167,0;;1,0;34,0;3,0;24,0;;4,0;4,0;43,0;132,0;34,0;;4,0;;2,0;2,0;69,0;;2,0;5,0;70,0;22,0;28,0;35,0;;;;;49,0;32,0;;7,0;1120,0;10,0;1,0;17,0;26,0;;58,0;47,0;;;;6,0;6,0;65,0;1,0;4,0;1,0;;;9,0;33,0;23,0;9,0;87,0;37,0;;12,0;;10,0;8,0;8,0;17,0;59,0;34,0;87,0;6,0;31,0;;2,0;13,0;3,0;1,0;36,0;4,0;33,0;1,0;7,0;26,0;5,0;183,0;195,0;4,0;26,0;9,0;13,0;14,0;;8,0;8,0;5,0;9,0;1,0;10,0;27,0;93,0;;93,0;1,0;25,0;;53,0;5,0;1,0;;;2,0;7,0;3,0;21,0;13,0;45,0;2,0;5,0;18,0;105,0;5,0;218,0;;13,0;1,0;;1,0;7,0;14,0;5,0;;3,0;15,0;7,0;;;12,0;;12,0;2,0;;;1,0;3,0;5,0;10,0;7,0;3,0;4,0;2,0;22,0;2,0;14,0;3,0;3,0;22,0;;17,0;1,0;61,0;;24,0;8,0;;20,0;209,0;2,0;;3,0;70,0;;1,0;4,0;9,0;1,0;3,0;12,0;;48,0;2,0;2,0;1,0;133,0;23,0;18,0;4,0;14,0;10,0;;;1,0;10,0;1,0;2,0;;16,0;5,0;;8,0;6,0;2,0;11,0;;4,0;;24,0;;1,0;7,0;;3,0;1,0;11,0;1,0;6,0;2,0;;6,0;1,0;;32,0;18,0;1,0;10,0;;;11,0;;3,0;8,0;5,0;2,0;7,0;8,0;2,0;4,0;;5,0;1,0;4,0;8,0;;;;;;;;;;;;2,0;6,0;;;;;;7,0;7,0;2,0;2,0;;;;;;;;;;;;;;;;;;3,0;;;4,0;;;;2,0;5,0;;;28,0;;29,0;3,0;1,0;;;;;;3,0;1,0;;;;8,0;;;;;;;;1,0;;4,0;;;3,0;;2,0;6,0;5,0;17,0;3,0;;;;;1,0;;1,0;;;2,0;;1,0;;;;;;;3,0;;;;;;;3,0;;;2,0;4,0;2,0;4,0;;1,0;2,0;13,0;;;;7,0;1,0;;;;;;;;;;4,0;7,0;46,0;;;;;2,0;;;1,0;2,0;458,0;3,0;6,0;;;2,0;;;;19,0;;;;;12,0;1,0;3,0;8,0;4,0;;5,0;1,0;;;;;;;3,0;11,0;;6,0;;3,0;28,0;;;;5,0;27,0;18,0;;;;;;;1,0;;;;;;1,0;5,0;;7,0;3,0;;;2,0;;1,0;;2,0;;;30,0;5,0;1,0;3,0;1,0;;;;;15,0;;;4,0;;1,0;;;10,0;2,0;1,0;;;;22,0;;;;;;;;13,0;9,0;2,0;;7,0;;;4,0;;;;32,0;9,0;;;;2,0;12,0;;;;;;2,0;;1,0;;3,0;4,0;1,0;;;;1,0;;;1,0;;;;1,0;;;;1,0;;;31,0;;2,0;7,0;;1,0;;1,0;;;67,0;;2,0;3,0;7,0;1,0;;12,0;3,0;2,0;;5,0;5,0;;;;;1,0;2,0;1,0;1,0;1,0;3,0;4,0;;9,0;9,0;;;2,0;1,0;;;;3,0;14,0;1,0;7,0;1,0;;;;2,0;6,0;1,0;;;;;;;;;6,0;;;;;;1,0;10,0;;;;;;3,0;;;4,0;;;;;3,0;;1,0;1,0;5,0;;;;1,0;;;;;;7,0;;;2,0;;;1,0;1,0;;;;;;2,0;;;;;;;;;;12,0;1,0;;1,0;;;;;;;2,0;;1,0;;;;;4,0;;;;8,0;;;;1,0;;;;1,0;1,0;;;11,0;;;;;;;;;;;;;;;;;;;5,0;;;6,0;;1,0;;;;4,0;;;4,0;;;;;;;;;;2,0;;;;;;;;;;5,0;1,0;;1,0;1,0;;;;;;;;;1,0;;2,0;8,0;;;;;;;3,0;4,0;;;;;;3,0;2,0;17,0;;3,0;4,0;;8,0;;1,0;;1,0;;1,0;4,0;1,0;;;;5,0;3,0;;3,0;;;;;1,0;2,0;;;;;;;;;;10,0;;;;;;;1,0;6,0;;;;;1,0;1,0;;2,0;;;;;;;;4,0;;;;;;;;;;;3,0;;;;1,0;;;;;;;;;;;;;;;;;3,0;3,0;;1,0;;3,0;;;;5,0;;;;;;;;;;;;;5,0;;;;;1,0;;;;;;1,0;;;;;;;1,0;;;;;;;;;
body;;43,0;18,0;;118,0;;135,0;91,0;11,0;61,0;9,0;11,0;4,0;1,0;5,0;11,0;1,0;;68,0;24,0;3,0;169,0;2,0;37,0;40,0;;1,0;141,0;19,0;115,0;34,0;37,0;473,0;1,0;124,0;2,0;14,0;203,0;7,0;430,0;36,0;1,0;41,0;95,0;;;5,0;14,0;43,0;14,0;34,0;22,0;2,0;27,0;4,0;397,0;513,0;;26,0;949,0;2,0;1,0;85,0;2,0;5,0;57,0;49,0;7,0;5,0;68,0;131,0;8,0;17,0;9,0;5,0;20,0;25,0;21,0;275,0;33,0;24,0;35,0;15,0;4,0;;3,0;22,0;9,0;5,0;56,0;87,0;6,0;11,0;68,0;16,0;24,0;2,0;18,0;30,0;16,0;411,0;280,0;;19,0;;2,0;46,0;716,0;9,0;3,0;45,0;64,0;3,0;137,0;259,0;3,0;10,0;;49,0;;;8,0;8,0;57,0;6,0;;201,0;56,0;7,0;147,0;201,0;1,0;2,0;27,0;5,0;65,0;138,0;37,0;12,0;15,0;2,0;;13,0;149,0;12,0;17,0;178,0;101,0;2,0;2,0;;35,0;52,0;33,0;79,0;113,0;79,0;123,0;16,0;180,0;3,0;2,0;43,0;48,0;;9,0;2,0;98,0;4,0;20,0;338,0;25,0;259,0;343,0;70,0;92,0;75,0;17,0;4,0;13,0;48,0;3,0;13,0;6,0;51,0;25,0;59,0;83,0;2,0;428,0;;17,0;;126,0;16,0;4,0;6,0;10,0;84,0;46,0;6,0;108,0;8,0;236,0;3,0;5,0;7,0;14,0;34,0;216,0;13,0;11,0;1,0;3,0;6,0;47,0;60,0;21,0;3,0;8,0;82,0;64,0;55,0;12,0;36,0;;24,0;;3,0;4,0;13,0;1,0;10,0;29,0;15,0;36,0;17,0;2,0;28,0;4,0;79,0;21,0;2,0;32,0;9,0;61,0;2,0;;3,0;10,0;;2,0;8,0;306,0;11,0;3,0;77,0;116,0;3,0;12,0;8,0;53,0;12,0;132,0;45,0;8,0;131,0;5,0;41,0;29,0;39,0;126,0;12,0;15,0;43,0;49,0;1,0;16,0;3,0;36,0;59,0;23,0;1,0;94,0;15,0;29,0;46,0;23,0;34,0;31,0;4,0;7,0;;16,0;7,0;19,0;;48,0;3,0;14,0;98,0;2,0;31,0;41,0;20,0;46,0;;6,0;97,0;31,0;7,0;16,0;29,0;3,0;30,0;6,0;82,0;;10,0;7,0;21,0;13,0;76,0;64,0;;19,0;5,0;37,0;16,0;;45,0;;3,0;13,0;;;3,0;9,0;2,0;21,0;1,0;9,0;1,0;11,0;104,0;;;10,0;10,0;15,0;56,0;9,0;2,0;;;;2,0;6,0;3,0;5,0;;;17,0;;14,0;20,0;6,0;;9,0;;11,0;9,0;;3,0;5,0;21,0;2,0;;;13,0;;35,0;1,0;5,0;;;;1,0;;10,0;14,0;10,0;70,0;1,0;26,0;7,0;14,0;1,0;2,0;10,0;8,0;;1,0;;3,0;9,0;2,0;2,0;7,0;5,0;21,0;41,0;3,0;3,0;9,0;1,0;5,0;;21,0;;12,0;2,0;1,0;65,0;59,0;24,0;1,0;10,0;;8,0;1,0;;6,0;3,0;;40,0;;1,0;;17,0;21,0;;1,0;4,0;18,0;116,0;16,0;8,0;;8,0;;;12,0;80,0;17,0;11,0;2,0;2,0;1,0;;2,0;;;;10,0;25,0;79,0;8,0;2,0;;;30,0;;6,0;1,0;;17,0;26,0;;4,0;;2,0;17,0;1,0;;139,0;20,0;2,0;15,0;18,0;3,0;39,0;2,0;32,0;26,0;32,0;9,0;;4,0;1,0;3,0;;;;29,0;41,0;3,0;3,0;;11,0;27,0;;;2,0;158,0;57,0;95,0;;;1,0;76,0;18,0;;;;1,0;12,0;6,0;3,0;5,0;12,0;;44,0;5,0;3,0;;59,0;3,0;12,0;;;1,0;;46,0;20,0;1,0;8,0;10,0;;9,0;2,0;6,0;6,0;;9,0;2,0;6,0;6,0;7,0;8,0;3,0;;25,0;;3,0;;148,0;1,0;2,0;;2,0;22,0;;;8,0;6,0;21,0;;;;;;39,0;2,0;1,0;209,0;13,0;1,0;;10,0;44,0;5,0;7,0;;5,0;;5,0;5,0;8,0;11,0;2,0;5,0;33,0;9,0;5,0;;126,0;22,0;2,0;2,0;4,0;20,0;4,0;;2,0;;10,0;13,0;48,0;4,0;6,0;;;7,0;2,0;2,0;;6,0;15,0;4,0;;10,0;1,0;5,0;1,0;1,0;7,0;2,0;48,0;30,0;;;3,0;13,0;;;;6,0;1,0;10,0;2,0;25,0;;51,0;51,0;24,0;17,0;13,0;4,0;11,0;2,0;1,0;;1,0;5,0;12,0;65,0;16,0;;2,0;11,0;;5,0;37,0;6,0;;;3,0;;;;;4,0;8,0;2,0;;;1,0;;;;8,0;;;;;1,0;8,0;6,0;1,0;4,0;;;1,0;1,0;11,0;;1,0;;24,0;;8,0;;1,0;;;;3,0;2,0;6,0;3,0;;4,0;;;4,0;;;4,0;;12,0;;7,0;3,0;;1,0;;;;;;1,0;;1,0;1,0;1,0;2,0;;2,0;;41,0;1,0;2,0;1,0;;;;1,0;20,0;10,0;6,0;2,0;4,0;1,0;3,0;3,0;8,0;;;;2,0;7,0;7,0;5,0;;89,0;;1,0;15,0;;;1,0;;7,0;2,0;1,0;;;;;14,0;2,0;;2,0;33,0;1,0;;21,0;;4,0;2,0;1,0;;5,0;;;5,0;;;;;;;3,0;2,0;1,0;;1,0;4,0;;;;7,0;17,0;;15,0;6,0;;;7,0;13,0;17,0;;6,0;;;;;5,0;3,0;;;14,0;;;;;;;10,0;12,0;;;;;;;1,0;12,0;5,0;4,0;14,0;;9,0;6,0;;3,0;5,0;2,0;12,0;2,0;5,0;5,0;;11,0;14,0;2,0;;;4,0;1,0;5,0;4,0;17,0;80,0;;1,0;4,0;;10,0;;15,0;;;1,0;;2,0;;;12,0;;4,0;1,0;2,0;3,0;;4,0;;53,0;;8,0;3,0;;8,0;;3,0;;;;;1,0;2,0;1,0;;16,0;;2,0;1,0;;;1,0;;6,0;;4,0;;1,0;3,0;3,0;17,0;;;;6,0;;;1,0;;1,0;2,0;4,0;;3,0;4,0;;1,0;;;9,0;;;;;;;;;;3,0;1,0;2,0;;3,0;;3,0;;18,0;;;;;5,0;;5,0;;2,0;;;;;;;2,0;;;;;;;
button;;1,0;3,0;;29,0;;;3,0;;28,0;;;;;;2,0;;;1,0;5,0;6,0;54,0;;2,0;1,0;;;9,0;;32,0;4,0;14,0;48,0;;58,0;;1,0;17,0;;68,0;;;1,0;4,0;4,0;;;;21,0;;21,0;8,0;;6,0;;93,0;89,0;;3,0;12,0;;;22,0;;;1,0;8,0;;3,0;125,0;;5,0;;1,0;;1,0;1,0;11,0;61,0;47,0;;8,0;6,0;2,0;;;1,0;;5,0;30,0;2,0;11,0;13,0;34,0;2,0;;1,0;4,0;11,0;;13,0;28,0;;;;7,0;4,0;41,0;;;7,0;12,0;;24,0;4,0;;;;;21,0;;;8,0;3,0;;;25,0;15,0;;2,0;7,0;;;1,0;;6,0;15,0;;;2,0;;;38,0;16,0;;10,0;;2,0;;;;2,0;;;2,0;1,0;2,0;6,0;4,0;5,0;;4,0;;1,0;;;;9,0;;;29,0;1,0;6,0;8,0;7,0;1,0;4,0;12,0;;;6,0;6,0;;;2,0;;5,0;61,0;;52,0;;1,0;;23,0;1,0;1,0;;;3,0;;;;;8,0;;7,0;8,0;;4,0;23,0;;1,0;;;;29,0;6,0;;;;;;;;;;2,0;;2,0;;;15,0;;;1,0;;;4,0;21,0;3,0;3,0;;2,0;3,0;;2,0;;;;5,0;;;;12,0;;;;6,0;;2,0;;6,0;;;6,0;;;;;2,0;3,0;3,0;;8,0;4,0;5,0;;;;1,0;6,0;;;4,0;;3,0;3,0;6,0;51,0;2,0;;;;;;6,0;;45,0;;1,0;2,0;1,0;13,0;3,0;;;;;;;1,0;5,0;4,0;;2,0;;6,0;;;;;2,0;1,0;4,0;;1,0;;8,0;38,0;;37,0;;1,0;;;;;1,0;2,0;;;10,0;;;;1,0;;5,0;;12,0;3,0;5,0;;1,0;;4,0;;;;2,0;;;;;1,0;5,0;4,0;;;;12,0;;;;;8,0;;;;;4,0;;1,0;1,0;;2,0;;;;40,0;223,0;37,0;1,0;;229,0;;30,0;1,0;;;;;;;;;13,0;8,0;;13,0;;15,0;;;;;;;18,0;;1,0;;;;76,0;4,0;;1,0;;2,0;;;;;4,0;;;;;;;;;;;12,0;;;10,0;;;1,0;;8,0;3,0;2,0;;2,0;25,0;;8,0;2,0;4,0;;1,0;4,0;2,0;3,0;;;;12,0;;;;;58,0;;;;;;;9,0;;4,0;11,0;12,0;1,0;21,0;;73,0;;23,0;7,0;7,0;1,0;;;;;;;;1,0;4,0;;;;1,0;;;;;9,0;1,0;3,0;;;;;;;;;1,0;19,0;;;3,0;;;2,0;;8,0;;;12,0;;;;;10,0;3,0;;;;;;2,0;;;;;;;12,0;1,0;4,0;2,0;;;7,0;;2,0;;2,0;3,0;;;;4,0;;;;;;;;;;;6,0;1,0;;11,0;;;4,0;6,0;9,0;;;;;;;;10,0;;;5,0;12,0;;;1,0;;;;2,0;;;;;;;1,0;;;1,0;;;;2,0;;;;;1,0;;;;1,0;1,0;;;;;;;;4,0;;;;;;;;;;;;;;;;;;;;1,0;;;;1,0;;;;1,0;;;2,0;;;;;;;;;;;1,0;;;;11,0;;;;;;;;;;;;;;;;;;;;;;10,0;;;5,0;;1,0;;;24,0;4,0;;;;;1,0;;;;1,0;;;1,0;;1,0;2,0;;;;;;;;;;;2,0;;;;;;;;1,0;1,0;;;;;1,0;1,0;;;;2,0;;1,0;;;;7,0;;;;;;4,0;;2,0;5,0;;;;;1,0;;;3,0;2,0;;;;;;;2,0;;;;;3,0;;;;;;2,0;;;;;;;;;;9,0;;;;;;;;;;;;;1,0;;41,0;;2,0;3,0;;2,0;;;;6,0;;;;;1,0;;;;;3,0;45,0;;1,0;;;;;1,0;1,0;2,0;;;18,0;;;;9,0;;;10,0;;;;;2,0;;;;;;;;;4,0;;;1,0;;;;;;;;;;;;;;;;;;;;;;;;;;;4,0;;;;;;;;;;;;;;;;;2,0;;;;3,0;;;;;;;;;;;;2,0;;;;;;1,0;1,0;;;;;;;;;;;;;;1,0;;;;;;;3,0;;;;;;;;;;;;;16,0;;;;;;;;;;;;
carrier;;1,0;;;9,0;;11,0;47,0;;1,0;;;;;1,0;;;;2,0;2,0;;8,0;;;;;3,0;1,0;4,0;;;;24,0;;3,0;;;1,0;;3,0;4,0;;2,0;20,0;;;;;;1,0;;29,0;;1,0;;35,0;27,0;;;61,0;9,0;;25,0;;;1,0;2,0;;;;2,0;;4,0;2,0;2,0;;;4,0;18,0;2,0;;1,0;;1,0;;;78,0;;;1,0;33,0;2,0;;29,0;;5,0;;1,0;1,0;23,0;6,0;16,0;;89,0;;;6,0;91,0;1,0;;4,0;16,0;3,0;6,0;12,0;;2,0;;17,0;3,0;;;;14,0;;;1,0;2,0;;3,0;13,0;;;;4,0;1,0;10,0;;4,0;3,0;;;1,0;;;;28,0;8,0;1,0;2,0;;;3,0;;48,0;26,0;1,0;21,0;;1,0;3,0;2,0;1,0;;;3,0;1,0;9,0;5,0;2,0;14,0;1,0;25,0;80,0;7,0;16,0;;5,0;16,0;;;2,0;;;7,0;;40,0;28,0;;30,0;;;;6,0;2,0;;;;7,0;2,0;5,0;6,0;1,0;8,0;2,0;2,0;;3,0;2,0;7,0;;1,0;2,0;;;;1,0;4,0;;;1,0;;;;;;;;;;10,0;7,0;1,0;3,0;4,0;4,0;;4,0;1,0;;;;;;2,0;;1,0;35,0;;1,0;;;6,0;22,0;;;6,0;6,0;;3,0;2,0;4,0;16,0;;2,0;;2,0;8,0;;4,0;1,0;4,0;;4,0;8,0;;;;;;;2,0;2,0;;;;;;;5,0;;;;;;;89,0;;;;;;1,0;;1,0;;6,0;2,0;2,0;2,0;4,0;3,0;;;;;;;11,0;;2,0;;;;;8,0;;5,0;2,0;;;10,0;;;1,0;132,0;2,0;;;;;;;;;;;2,0;;;4,0;;;;;;;;;;;;;11,0;;;;;1,0;;;2,0;;;2,0;;;;;2,0;2,0;4,0;1,0;1,0;;;;1,0;;;;;;;;;;;;;4,0;;;;;;;;;;3,0;2,0;;1,0;;;5,0;;;;;;;;;;2,0;4,0;;;;;;;;6,0;;;;2,0;;;;;;;102,0;;;;;;;4,0;;;;;;;;;;;;;1,0;;1,0;;;2,0;;;;;1,0;;;;2,0;;;;;9,0;;4,0;;;;3,0;;4,0;4,0;;;3,0;;;;;;;1,0;;;;;;8,0;;;;2,0;1,0;;;;;;2,0;;;;;1,0;;;;;;6,0;;;;;;;;;2,0;;1,0;;;2,0;;;;;;1,0;;;1,0;;;;;11,0;5,0;;;;;1,0;;;;;;;;4,0;;2,0;;;;;;;;;9,0;6,0;;;;;10,0;1,0;;;1,0;;;;1,0;;;;;3,0;;;;;;;12,0;;;;;1,0;;;;3,0;;;13,0;;1,0;4,0;;4,0;;;6,0;7,0;;;;7,0;;;;;;;;22,0;;;;;3,0;;1,0;;;1,0;;1,0;;;1,0;13,0;2,0;;;;;;;;;;;;;2,0;;;7,0;7,0;;6,0;30,0;;;;24,0;7,0;;;29,0;1,0;1,0;;;;23,0;2,0;1,0;;;;2,0;;;;;8,0;;;;;3,0;;;;;30,0;;;7,0;;;1,0;;;;;;;;;;;;;1,0;;;;;;;;14,0;1,0;;1,0;;;;;;1,0;;;;;;;;;;;;;;;;;;;8,0;;;1,0;6,0;;;;;;;;;;;;;;;;;;;;;;;;;;;;3,0;;;;;;;;;;;1,0;;;;;;8,0;;;;;;;;;1,0;;2,0;;3,0;;;1,0;;;;;;;;;;6,0;;;;;;;;;;;;2,0;;3,0;;;6,0;;;;2,0;;;;;;;;;;;;;;;;;9,0;;;;;;;;;;;;;;;;;10,0;5,0;;;;;;;;;;;;;;;;;;;6,0;;;;;;;;;;;;;;;;;;;;;;;;;;;;;;2,0;;;;;;1,0;;;;;;;;;;;;;;;;;3,0;;;;;;;;;;;;;;;;;;;;;;;;;
case;;4,0;8,0;;17,0;;15,0;46,0;5,0;11,0;7,0;;;4,0;16,0;5,0;;1,0;5,0;1,0;17,0;34,0;1,0;12,0;9,0;;4,0;35,0;;19,0;29,0;54,0;47,0;7,0;33,0;;;45,0;;61,0;27,0;1,0;7,0;9,0;;7,0;11,0;5,0;18,0;2,0;3,0;5,0;;2,0;1,0;119,0;66,0;4,0;11,0;91,0;;4,0;25,0;1,0;1,0;6,0;1,0;;3,0;34,0;21,0;;3,0;;;7,0;;4,0;100,0;10,0;6,0;18,0;4,0;1,0;;7,0;3,0;6,0;2,0;7,0;10,0;;29,0;37,0;9,0;5,0;;26,0;15,0;7,0;54,0;29,0;;;;;10,0;165,0;;;15,0;14,0;1,0;21,0;34,0;;8,0;;17,0;61,0;;;5,0;18,0;;;16,0;9,0;;6,0;53,0;1,0;;;1,0;;7,0;;;7,0;;;10,0;46,0;1,0;6,0;27,0;21,0;;;3,0;7,0;4,0;;19,0;10,0;4,0;26,0;1,0;13,0;;1,0;20,0;35,0;1,0;1,0;5,0;17,0;8,0;9,0;56,0;1,0;25,0;34,0;22,0;59,0;63,0;13,0;;;15,0;1,0;4,0;1,0;5,0;2,0;22,0;27,0;1,0;51,0;3,0;15,0;;23,0;7,0;;;;4,0;9,0;;14,0;40,0;39,0;;8,0;;;7,0;21,0;;1,0;2,0;;4,0;30,0;1,0;2,0;;5,0;55,0;14,0;3,0;2,0;8,0;;7,0;;;4,0;22,0;;1,0;6,0;8,0;13,0;;11,0;22,0;;11,0;1,0;2,0;3,0;1,0;;1,0;2,0;;;2,0;;1,0;39,0;;1,0;4,0;6,0;;;2,0;6,0;3,0;3,0;22,0;2,0;18,0;;4,0;2,0;2,0;48,0;;3,0;15,0;;3,0;;20,0;6,0;42,0;11,0;;4,0;;6,0;1,0;9,0;15,0;11,0;;1,0;1,0;3,0;;8,0;;27,0;;;2,0;;40,0;1,0;2,0;;;9,0;20,0;;3,0;;1,0;;;;5,0;;1,0;3,0;2,0;5,0;8,0;4,0;;4,0;;8,0;2,0;;3,0;1,0;5,0;;;;4,0;2,0;2,0;8,0;;5,0;;4,0;1,0;;2,0;18,0;;9,0;13,0;;8,0;;;;;;5,0;2,0;7,0;;;3,0;;6,0;2,0;;4,0;;9,0;2,0;2,0;1,0;12,0;15,0;2,0;3,0;;3,0;11,0;7,0;;;;6,0;1,0;;;25,0;3,0;3,0;1,0;1,0;9,0;13,0;2,0;2,0;6,0;;2,0;;2,0;3,0;;8,0;;3,0;1,0;9,0;;4,0;;;;2,0;;;1,0;;10,0;;;3,0;19,0;2,0;7,0;2,0;2,0;5,0;;;;;2,0;8,0;;1,0;;4,0;2,0;;2,0;;;3,0;;1,0;1,0;4,0;;3,0;6,0;3,0;;;4,0;2,0;5,0;;7,0;;2,0;2,0;1,0;6,0;7,0;1,0;2,0;;;11,0;;;10,0;;9,0;;5,0;2,0;;;17,0;;;14,0;5,0;;;17,0;;15,0;3,0;;25,0;19,0;3,0;;;;2,0;6,0;;5,0;25,0;19,0;2,0;1,0;;2,0;5,0;5,0;;;3,0;2,0;6,0;3,0;;;2,0;1,0;2,0;;;;3,0;;1,0;2,0;1,0;;17,0;;6,0;2,0;;;;;;1,0;;9,0;7,0;2,0;;;;;;;1,0;;3,0;2,0;3,0;;;3,0;21,0;;;;1,0;;11,0;;;;;;;;10,0;1,0;14,0;;;;;;8,0;;1,0;6,0;4,0;2,0;;7,0;2,0;;2,0;;1,0;6,0;;1,0;1,0;2,0;;;12,0;1,0;2,0;;;8,0;;4,0;;10,0;;;;;;;;3,0;;1,0;;;;;;5,0;4,0;;;1,0;1,0;8,0;;2,0;;4,0;;;;;;;9,0;;;;1,0;5,0;1,0;9,0;;12,0;2,0;18,0;;;;;2,0;;;;;;;;;;17,0;18,0;1,0;;;;;;;;;;4,0;1,0;;;;2,0;;;;;1,0;;4,0;;;1,0;;;6,0;;;;;;;;2,0;6,0;;2,0;;5,0;;;;1,0;;;;;;;;1,0;;;25,0;;;;4,0;;;1,0;;;;;;;;;;;1,0;;;;5,0;;;1,0;4,0;;;;;;;2,0;;1,0;3,0;1,0;;1,0;;;12,0;;;;;6,0;3,0;1,0;1,0;;1,0;;;;2,0;;7,0;1,0;;;;;;;2,0;5,0;;;;;;;4,0;;;3,0;;;6,0;;6,0;;;;;;;;;;;;;;;1,0;3,0;;;2,0;1,0;4,0;;;;;;;;;;;;;5,0;1,0;;;;2,0;2,0;;;;;;1,0;;1,0;;;1,0;;;;;1,0;;;4,0;;;;;;1,0;1,0;;;13,0;;2,0;;13,0;3,0;;;4,0;;;;;;;;;;;;1,0;14,0;;1,0;;2,0;;;3,0;3,0;2,0;;2,0;;;;2,0;;;;;;;;;;;2,0;;;;;;;;;;1,0;;;;;;2,0;1,0;;;;;;;;;1,0;1,0;;;;;;2,0;;;;;;;;6,0;;;;1,0;8,0;;;2,0;;;;;;;;;;;;6,0;;;;;;;;;;;;
cavity;;3,0;;;4,0;;4,0;49,0;;3,0;;;;;;;;;5,0;;;;;;;;;;;;1,0;1,0;19,0;;12,0;;;8,0;;;;;;35,0;;;;;1,0;;1,0;;;2,0;;17,0;24,0;;;38,0;;;22,0;;;3,0;5,0;;;;;;;2,0;5,0;;;2,0;25,0;;5,0;2,0;;;;;;;4,0;2,0;12,0;;;7,0;6,0;3,0;;1,0;7,0;14,0;43,0;8,0;;;;;1,0;;;;8,0;4,0;3,0;16,0;7,0;;1,0;;28,0;27,0;1,0;3,0;;9,0;;;12,0;10,0;;6,0;35,0;3,0;;4,0;3,0;1,0;30,0;;;;;;;4,0;7,0;;43,0;1,0;;5,0;;2,0;12,0;1,0;7,0;22,0;4,0;72,0;;4,0;;;15,0;9,0;;2,0;;13,0;2,0;8,0;17,0;;48,0;42,0;1,0;19,0;10,0;;3,0;;;;7,0;1,0;3,0;;15,0;10,0;;36,0;1,0;8,0;2,0;108,0;12,0;1,0;;;;1,0;1,0;12,0;1,0;5,0;3,0;;;;4,0;13,0;;4,0;;;;;3,0;7,0;;;10,0;;1,0;2,0;27,0;;15,0;;2,0;;3,0;;;2,0;;1,0;2,0;3,0;3,0;;19,0;;2,0;25,0;4,0;5,0;2,0;10,0;1,0;3,0;;;3,0;25,0;;1,0;4,0;92,0;;14,0;;;2,0;4,0;21,0;;28,0;2,0;4,0;;;3,0;;2,0;7,0;5,0;;;1,0;4,0;2,0;3,0;;4,0;41,0;;3,0;;10,0;9,0;;;;;4,0;;;1,0;1,0;1,0;3,0;;2,0;2,0;3,0;1,0;;;;9,0;;7,0;;;2,0;1,0;4,0;;15,0;24,0;;10,0;7,0;7,0;;3,0;;;;;3,0;;;;;;;;;;;;;;;;;;3,0;;3,0;;;;;;;;3,0;;;;6,0;3,0;;;;;8,0;;;;;1,0;1,0;;1,0;;;;;1,0;;;;;;;;1,0;;;;;;;;;;;;;;1,0;;;;;;;3,0;1,0;8,0;;;1,0;4,0;;;;5,0;;;;;;;;;;;;;;;;;;;1,0;;;;;;;;;;;;;;1,0;;;;;;;;;;;;;1,0;;;;;;;;2,0;;6,0;;;;;;;;;2,0;;;;1,0;;4,0;2,0;;6,0;;;;;;6,0;;;;5,0;2,0;;11,0;;2,0;;;;;1,0;1,0;7,0;20,0;;;;;;;;;1,0;2,0;;3,0;;;3,0;;;;;;;;;;;4,0;51,0;;;;;1,0;;3,0;2,0;;;;;;;;;;;;1,0;;1,0;;;;1,0;;;;27,0;;;;;;;;3,0;;;12,0;2,0;;;;;2,0;;;;;;6,0;2,0;1,0;;;;;4,0;;;;;;;;;;;;;;6,0;;;;;9,0;;6,0;;;;16,0;;2,0;;14,0;1,0;;;;;;1,0;;;5,0;;;;;6,0;1,0;;1,0;;1,0;1,0;2,0;;;;2,0;;;;;;3,0;;3,0;3,0;2,0;;;;;;;4,0;;;;;;;;;;;;;;;;;;;;10,0;;;;;;;;;;;;;1,0;;;;;;;;;;6,0;2,0;;;;;1,0;;;4,0;;;;;4,0;;;;;;2,0;;;;;;;;;;;;;;;;;;;;;;;;;;;1,0;;;;;1,0;;;;2,0;;;;;;2,0;;;;;;;;;;;;;23,0;;;9,0;;;;;;;;;1,0;;;;;;;;;4,0;;;1,0;;;;;;;;;;;;;5,0;;;;5,0;1,0;;;;;;5,0;;;1,0;;;;;1,0;;;;;;4,0;;;;;;6,0;;;;;;2,0;;;;;;2,0;;;;;;;;;;3,0;;;;;;;;;;;4,0;;;;;;3,0;;;;;;;;;;4,0;;;;;;;;;;;;;;;;;;;;;;;;;;;;;;;;;;;;1,0;2,0;;1,0;2,0;4,0;;;;;;1,0;;;;;;;;;;;;;1,0;;;;;4,0;;;;;;;;;;7,0;;;;;;;;;;;;;
cell;;1,0;2,0;;11,0;;5,0;11,0;2,0;5,0;2,0;2,0;;;12,0;;;;8,0;1,0;;6,0;4,0;;;;1,0;;;7,0;24,0;;38,0;2,0;20,0;3,0;1,0;16,0;;;19,0;;3,0;79,0;;;;;;;4,0;6,0;7,0;47,0;4,0;38,0;63,0;;;204,0;3,0;;36,0;;;2,0;1,0;;;1,0;6,0;8,0;;;3,0;;;12,0;5,0;12,0;;6,0;8,0;;;;3,0;;1,0;4,0;71,0;4,0;;28,0;15,0;17,0;;49,0;11,0;18,0;36,0;20,0;;20,0;2,0;;44,0;121,0;;;9,0;24,0;84,0;21,0;;2,0;;8,0;;5,0;;;1,0;5,0;;1,0;19,0;3,0;1,0;14,0;6,0;;;;;15,0;15,0;;1,0;1,0;7,0;;10,0;5,0;7,0;;37,0;2,0;1,0;;56,0;;;;15,0;28,0;;12,0;2,0;6,0;3,0;1,0;;9,0;;18,0;2,0;41,0;;;;;1,0;;;9,0;1,0;19,0;2,0;;;1,0;;1,0;;;7,0;165,0;;12,0;;1,0;4,0;6,0;4,0;;1,0;;;2,0;10,0;24,0;;8,0;;;;;2,0;22,0;;8,0;;;;18,0;5,0;6,0;;;;;;5,0;;;3,0;;;;9,0;;;83,0;;2,0;;2,0;6,0;;;;;1,0;1,0;1,0;;3,0;;;20,0;;3,0;9,0;;1,0;;10,0;;;2,0;1,0;;;;1,0;1,0;;;;1,0;1,0;;3,0;3,0;;;;1,0;4,0;;;;;;;5,0;;;6,0;;5,0;;11,0;;;18,0;;;;6,0;;8,0;;;1,0;;1,0;2,0;;;8,0;;;;;;;;3,0;;1,0;;;;7,0;;;2,0;;;;;;;9,0;;;2,0;;;10,0;;;;;;;;;8,0;;16,0;;;;1,0;;;;;;;;2,0;;;;1,0;;;;;16,0;;44,0;1,0;1,0;;2,0;1,0;6,0;;;;;;;1,0;1,0;;;1,0;;;;;7,0;;;;;;;;;;;;1,0;;;;6,0;1,0;;;;1,0;1,0;6,0;;;2,0;;24,0;;9,0;7,0;5,0;;;;;;;26,0;;;8,0;;;;;;2,0;11,0;2,0;;;;;1,0;;;;1,0;;;;;;;1,0;;;;;;;;1,0;;;1,0;;;;;;2,0;9,0;;;;;;;;;;4,0;2,0;;5,0;9,0;;;;1,0;;;;1,0;2,0;2,0;;3,0;;10,0;;;;;5,0;;;4,0;;;;;;;;;;;1,0;;2,0;;;;;;5,0;1,0;8,0;;;3,0;;1,0;;;3,0;;;;;1,0;3,0;;3,0;;1,0;1,0;;;97,0;;;;;;8,0;;;;;;;;;;;;;;;;;;;;6,0;;;;1,0;;;;;9,0;;21,0;13,0;2,0;;;5,0;;;;;;;;;;;;;;1,0;;;;3,0;;;9,0;2,0;;;;;;;6,0;;;2,0;;;;;;;;;;29,0;;;;;;;;;;;;1,0;;1,0;4,0;1,0;;;29,0;;;;;;;;;;1,0;8,0;;;15,0;;4,0;2,0;10,0;17,0;;;5,0;;3,0;;;;2,0;;;6,0;;1,0;4,0;;6,0;;;;;;;;;;;5,0;;4,0;3,0;;;7,0;;;3,0;4,0;;;;;;;6,0;;13,0;;;;;;;;1,0;;;;;;;;;;;;;;;;1,0;;;;;;1,0;;;;;;8,0;;;;;1,0;;;;;;;;;;;;;;;;;;;2,0;;;;;;;;;;;1,0;;;;;;;;;;6,0;1,0;;;;;;;;;1,0;;2,0;;;;11,0;;13,0;;;;;;;;;;;;22,0;;2,0;;;;2,0;;;11,0;;;1,0;;;;;;;;;;;;;;;3,0;;;;;6,0;;;;;1,0;1,0;;2,0;;;;;;;;;;;;7,0;;;;;;;;;;;;1,0;;;;1,0;;;;;;;;;;;;;;1,0;;;;;;;;;3,0;;;;;;;;;;;;4,0;;;;;;;4,0;2,0;1,0;;;;;;;4,0;;;;1,0;;;;;;;;;;;4,0;;;;;;;;;5,0;4,0;;;;;;;;;;;2,0;;;;
charge;;1,0;31,0;;5,0;;6,0;46,0;4,0;14,0;2,0;;;3,0;7,0;;;;16,0;1,0;7,0;80,0;;5,0;13,0;;;11,0;1,0;21,0;11,0;5,0;166,0;2,0;23,0;;1,0;59,0;;4,0;3,0;;48,0;53,0;1,0;;;1,0;;3,0;29,0;157,0;22,0;5,0;;106,0;50,0;;2,0;12,0;;;32,0;;;10,0;1,0;;;56,0;6,0;3,0;10,0;;;4,0;3,0;2,0;10,0;23,0;2,0;7,0;5,0;;2,0;5,0;72,0;;;11,0;80,0;37,0;7,0;534,0;;;;49,0;99,0;18,0;30,0;10,0;;381,0;;;17,0;180,0;2,0;;32,0;4,0;5,0;1,0;;1,0;16,0;16,0;;;;;;80,0;;18,0;39,0;9,0;;71,0;;;;;;13,0;8,0;;53,0;4,0;21,0;;10,0;9,0;;6,0;28,0;3,0;;;14,0;;;;60,0;8,0;1,0;;;30,0;25,0;3,0;1,0;;1,0;23,0;9,0;134,0;;1,0;15,0;38,0;2,0;4,0;1,0;1,0;;78,0;;;;;;;3,0;1,0;6,0;51,0;;111,0;;;;64,0;;10,0;;;11,0;;19,0;1,0;2,0;19,0;;;;;5,0;1,0;;;;1,0;;62,0;2,0;;3,0;;2,0;;;1,0;;10,0;;;;;;;;4,0;;;;12,0;5,0;;2,0;;11,0;1,0;;6,0;13,0;;;;48,0;;5,0;19,0;;;;2,0;1,0;;1,0;34,0;;;3,0;2,0;1,0;;;;;4,0;3,0;15,0;;10,0;;37,0;5,0;4,0;1,0;;;58,0;;3,0;5,0;5,0;3,0;7,0;;1,0;3,0;;;;144,0;2,0;;;;;19,0;1,0;3,0;;;6,0;;;3,0;22,0;;;;;1,0;;;;;2,0;1,0;;;15,0;;5,0;14,0;;;;;;;184,0;2,0;;3,0;;;;;3,0;;;;6,0;;2,0;;1,0;;1,0;;;18,0;;;;2,0;;;5,0;1,0;1,0;;;33,0;;;2,0;;;3,0;;3,0;5,0;;;40,0;18,0;;;5,0;10,0;;4,0;;9,0;4,0;11,0;;;144,0;1,0;8,0;;10,0;3,0;;;2,0;;;;;;;1,0;;4,0;1,0;1,0;;;;;1,0;1,0;;;;3,0;25,0;2,0;;135,0;;;;;;;;;11,0;;;11,0;;;1,0;1,0;9,0;28,0;118,0;74,0;4,0;;;7,0;20,0;42,0;;;;1,0;1,0;;;;;;;;5,0;;;;;15,0;;;2,0;;;;;;24,0;1,0;;;;5,0;3,0;;;2,0;;14,0;;3,0;;2,0;;42,0;;;;;;;;;;;;;;;;;;;8,0;;;;;;2,0;;;10,0;5,0;;;;2,0;;1,0;;;2,0;;;;;;;1,0;;;;;;;;;;1,0;;;;17,0;;;1,0;137,0;51,0;;;;;2,0;;;;;;1,0;;;;;;;1,0;;;4,0;;;2,0;;;;;;;;1,0;9,0;;1,0;;2,0;;;;19,0;;;;;;;1,0;;;;;;;;;;;35,0;;;;;;;;4,0;;;1,0;;;;;1,0;3,0;;;1,0;11,0;1,0;;;;1,0;4,0;;;;12,0;;;;;;;;;;;;;;6,0;;;;;9,0;;;3,0;70,0;1,0;;;69,0;;7,0;25,0;;;;63,0;14,0;3,0;;15,0;65,0;161,0;;;;11,0;54,0;39,0;3,0;11,0;15,0;8,0;5,0;;2,0;;117,0;;;5,0;45,0;9,0;2,0;2,0;;2,0;41,0;3,0;;6,0;;;11,0;1,0;15,0;;;;;;1,0;3,0;;;;1,0;;;;;1,0;;;;;3,0;;2,0;;;;;;;;;;;2,0;;;;;2,0;;;;2,0;;;;2,0;1,0;2,0;;;;1,0;;;;;;2,0;;;;;;;;;;;1,0;;;;;;;;;;;;;;;;;2,0;;;;;;;1,0;;;;;;;;;;1,0;;;4,0;3,0;;3,0;;1,0;;;6,0;;;;;;;13,0;2,0;;23,0;;;;;;;3,0;13,0;10,0;;;;;;;;;;;;;;1,0;;;;;9,0;;;;;;;;;;;;2,0;;;;2,0;;;;;;;;;;;;;;;;;;;;2,0;;1,0;;;;;;;;;;;;;;;3,0;;1,0;;;;;;;;;;;2,0;45,0;;;;;;4,0;;;;;1,0;;4,0;;;;;;1,0;;;;2,0;;;;;;;;1,0;;;;;;;;;;;;;;;;;;;;1,0;;;;
circuit;;1,0;18,0;1,0;136,0;;16,0;69,0;59,0;134,0;7,0;3,0;;31,0;47,0;9,0;7,0;11,0;38,0;4,0;38,0;978,0;2,0;22,0;46,0;1,0;3,0;210,0;2,0;94,0;238,0;75,0;325,0;42,0;134,0;10,0;6,0;37,0;3,0;68,0;14,0;3,0;99,0;72,0;3,0;2,0;7,0;10,0;78,0;17,0;18,0;195,0;39,0;24,0;;850,0;386,0;19,0;11,0;159,0;;4,0;70,0;1,0;;51,0;3,0;;9,0;132,0;76,0;;10,0;26,0;3,0;9,0;7,0;8,0;72,0;118,0;4,0;441,0;23,0;11,0;;;35,0;;10,0;150,0;238,0;23,0;15,0;690,0;4,0;21,0;1,0;144,0;87,0;122,0;101,0;124,0;;58,0;;16,0;15,0;238,0;22,0;2,0;82,0;90,0;92,0;35,0;24,0;11,0;;1,0;1120,0;57,0;14,0;;12,0;;4,0;4,0;292,0;37,0;2,0;134,0;40,0;;5,0;2,0;4,0;40,0;71,0;;32,0;10,0;3,0;;33,0;11,0;94,0;1,0;122,0;102,0;7,0;1,0;1,0;1,0;6,0;9,0;54,0;36,0;20,0;93,0;26,0;130,0;;7,0;6,0;2,0;1,0;77,0;22,0;116,0;39,0;5,0;17,0;43,0;206,0;147,0;14,0;14,0;16,0;384,0;3,0;;27,0;4,0;33,0;14,0;1,0;3,0;18,0;275,0;;81,0;1,0;10,0;6,0;143,0;4,0;5,0;;;;9,0;33,0;22,0;3,0;54,0;;20,0;30,0;1,0;15,0;30,0;18,0;14,0;5,0;5,0;;78,0;54,0;9,0;10,0;4,0;15,0;4,0;32,0;;5,0;;11,0;1,0;;;;;15,0;8,0;54,0;4,0;;46,0;62,0;7,0;6,0;1,0;21,0;20,0;4,0;18,0;5,0;105,0;1,0;35,0;82,0;44,0;16,0;314,0;3,0;;3,0;52,0;;3,0;6,0;116,0;3,0;2,0;6,0;7,0;44,0;1,0;3,0;3,0;126,0;21,0;23,0;2,0;6,0;88,0;8,0;;2,0;12,0;;11,0;;17,0;8,0;58,0;6,0;40,0;64,0;6,0;5,0;2,0;6,0;51,0;;1,0;15,0;7,0;1,0;;7,0;4,0;47,0;3,0;1,0;2,0;7,0;17,0;17,0;11,0;58,0;18,0;;;15,0;;2,0;8,0;2,0;2,0;7,0;24,0;5,0;;;79,0;4,0;4,0;96,0;;8,0;17,0;;15,0;1,0;10,0;3,0;10,0;3,0;;3,0;27,0;2,0;1,0;1,0;19,0;28,0;13,0;3,0;21,0;32,0;3,0;1,0;23,0;;5,0;1,0;;;2,0;12,0;1,0;;27,0;3,0;4,0;;7,0;276,0;1,0;9,0;;3,0;16,0;5,0;64,0;5,0;13,0;;23,0;23,0;43,0;1,0;4,0;25,0;7,0;1,0;1,0;;37,0;7,0;8,0;2,0;;20,0;18,0;24,0;4,0;30,0;4,0;2,0;1,0;2,0;;3,0;;;23,0;;9,0;6,0;42,0;14,0;35,0;4,0;9,0;;;58,0;4,0;54,0;14,0;3,0;2,0;92,0;;7,0;117,0;6,0;11,0;4,0;;2,0;3,0;;3,0;21,0;;;12,0;3,0;;1,0;13,0;4,0;50,0;71,0;62,0;10,0;47,0;;63,0;23,0;64,0;2,0;10,0;1,0;1,0;23,0;;1,0;;1,0;7,0;6,0;19,0;22,0;1,0;21,0;;;99,0;;;3,0;;461,0;16,0;;19,0;33,0;3,0;4,0;8,0;;2,0;3,0;24,0;12,0;58,0;15,0;178,0;15,0;40,0;71,0;4,0;4,0;285,0;1,0;22,0;6,0;47,0;;;15,0;1,0;;2,0;2,0;2,0;9,0;;8,0;37,0;49,0;59,0;24,0;1,0;;8,0;;;9,0;;2,0;11,0;4,0;;1,0;4,0;3,0;26,0;4,0;;12,0;56,0;2,0;1,0;;;;10,0;6,0;19,0;1,0;;;3,0;;;2,0;;14,0;24,0;69,0;4,0;17,0;8,0;1,0;41,0;338,0;36,0;3,0;4,0;;1,0;2,0;3,0;1,0;6,0;16,0;9,0;;2,0;;10,0;3,0;2,0;12,0;1,0;;8,0;6,0;33,0;4,0;53,0;;;;8,0;24,0;9,0;;;5,0;80,0;;2,0;1,0;2,0;;3,0;65,0;;;;1,0;8,0;;;1,0;;;;1,0;;4,0;;;1,0;21,0;29,0;41,0;5,0;7,0;;1,0;;18,0;;;41,0;2,0;62,0;;2,0;;2,0;10,0;;3,0;8,0;1,0;6,0;;21,0;;3,0;;2,0;5,0;3,0;;1,0;1,0;;7,0;14,0;7,0;;;1,0;9,0;;;19,0;4,0;1,0;3,0;1,0;5,0;1,0;14,0;2,0;22,0;;;;19,0;;59,0;19,0;9,0;4,0;2,0;50,0;5,0;;4,0;;42,0;55,0;6,0;2,0;3,0;;14,0;33,0;4,0;12,0;8,0;5,0;13,0;;1,0;;;;1,0;52,0;65,0;1,0;;95,0;;3,0;70,0;2,0;10,0;7,0;4,0;;1,0;1,0;1,0;;;5,0;;;6,0;15,0;23,0;11,0;2,0;5,0;1,0;;4,0;1,0;7,0;9,0;12,0;8,0;3,0;4,0;;94,0;10,0;2,0;;9,0;3,0;7,0;;5,0;;18,0;10,0;13,0;11,0;1,0;1,0;6,0;23,0;;;32,0;3,0;1,0;14,0;6,0;1,0;;;2,0;10,0;11,0;2,0;;;;;1,0;;;1,0;1,0;;1,0;;;4,0;;14,0;;;10,0;;2,0;;;3,0;2,0;;1,0;6,0;;2,0;;;1,0;;3,0;10,0;;7,0;;4,0;;33,0;24,0;;;2,0;1,0;;1,0;4,0;;;5,0;5,0;;;;;15,0;2,0;1,0;3,0;9,0;8,0;3,0;;;1,0;24,0;;3,0;2,0;;;1,0;;;5,0;;24,0;;68,0;3,0;;8,0;;;;7,0;12,0;;10,0;;;;1,0;2,0;2,0;;1,0;;;;;5,0;2,0;2,0;;;;;;1,0;;30,0;18,0;12,0;5,0;;5,0;1,0;38,0;;2,0;;;;;2,0;;2,0;;;;6,0;;3,0;;;;;2,0;8,0;;;14,0;6,0;;;;3,0;1,0;;2,0;1,0;6,0;;1,0;2,0;;;;;8,0;12,0;;11,0;;;;3,0;5,0;5,0;;9,0;;2,0;3,0;;;5,0;;;;;;;;;;4,0;5,0;;;;;;;;6,0;;;;;;3,0;;;;;;;;;;;;;;;
circuitry;;1,0;;;27,0;;1,0;4,0;5,0;5,0;1,0;;;;3,0;;;;1,0;;3,0;103,0;1,0;2,0;;;;40,0;1,0;4,0;2,0;3,0;43,0;;13,0;;;2,0;;4,0;;2,0;2,0;6,0;;;;;4,0;;;1,0;;;;109,0;24,0;;;12,0;;;8,0;;;3,0;;;;18,0;1,0;;;;;;;1,0;6,0;16,0;1,0;151,0;18,0;1,0;;;12,0;;;4,0;16,0;;;29,0;;1,0;;;1,0;5,0;4,0;13,0;;;;;;3,0;;;5,0;2,0;14,0;1,0;1,0;;;;4,0;4,0;;;;13,0;;1,0;81,0;;;48,0;;3,0;;;;7,0;1,0;;;1,0;1,0;;4,0;;1,0;;8,0;;;;;;;;;;;10,0;3,0;3,0;;3,0;1,0;;;5,0;1,0;6,0;;;;;18,0;5,0;;;;22,0;1,0;;1,0;;;;1,0;;;13,0;;5,0;;;;24,0;;;;;;;10,0;2,0;;;;;;;;3,0;;1,0;;3,0;;8,0;2,0;;;;;2,0;;;;;1,0;;;;;;1,0;;4,0;1,0;;6,0;2,0;8,0;;;1,0;;;;;5,0;;7,0;;10,0;;27,0;;;;;1,0;;;;1,0;;;;;;;;2,0;1,0;;;;22,0;;;;1,0;;;;;;2,0;;4,0;4,0;;;;;;;;;;;;;;5,0;2,0;;;;;;;;4,0;;;;;;;;;;1,0;;;;;;;6,0;;11,0;;;;;;;5,0;1,0;;;9,0;;;;1,0;5,0;5,0;2,0;1,0;;2,0;5,0;;;;4,0;;;;1,0;5,0;1,0;;2,0;;;;5,0;;1,0;;;2,0;;13,0;3,0;;;2,0;;;;2,0;1,0;;;;;;;1,0;;;2,0;;;2,0;;;;;1,0;1,0;;;1,0;;1,0;2,0;;2,0;;8,0;5,0;;;;5,0;;2,0;7,0;;1,0;;;;2,0;;2,0;1,0;;2,0;;1,0;;3,0;;2,0;;;;2,0;;3,0;2,0;6,0;16,0;;2,0;;2,0;8,0;1,0;;6,0;;;;;;;;;;;;5,0;1,0;;;6,0;;;;;1,0;1,0;;;;;;1,0;;;;2,0;;1,0;;;;;15,0;17,0;;2,0;;;;1,0;2,0;;;;;;;;;;;;6,0;7,0;;;;;;;2,0;;;;2,0;;;;1,0;;;;1,0;;;;;;;;;;1,0;;1,0;;;;;;;6,0;5,0;;;;4,0;9,0;8,0;;1,0;;;;1,0;;;;;2,0;;;;20,0;;;2,0;1,0;;4,0;;;2,0;;;;;;11,0;;;;;1,0;1,0;;;;;1,0;9,0;;;3,0;;2,0;;;;;1,0;;;;1,0;;;2,0;2,0;;;;1,0;;;;5,0;;;2,0;;;;;;;;;;;;;;;;;;;7,0;2,0;;;;;;;;;;;;;;;;;;;;;;1,0;1,0;;;;;;;;5,0;6,0;1,0;2,0;;;;;;1,0;;;;;2,0;;4,0;3,0;;;;;;;;;;6,0;4,0;;;;;;1,0;;;;;;;7,0;;;;;1,0;1,0;;;;2,0;;;;;1,0;;1,0;;1,0;;;;;;;;;;;;;2,0;3,0;;;;;;;;;;;1,0;;;1,0;;;;;1,0;6,0;1,0;;;;;;;;;;;;;2,0;;;1,0;1,0;;;;7,0;;;;;1,0;5,0;;;1,0;;;;;;;;;1,0;;;;;;;;4,0;;;;1,0;;;;17,0;1,0;;;;;;1,0;;;;2,0;;;1,0;;;;;1,0;;;;;;;;;;3,0;;;;;4,0;;;;;;;;;;;;;;2,0;;;;;;;;;3,0;;1,0;;;;;2,0;;;;;;;;;;;;1,0;;1,0;;;;;;;;;;;;;;2,0;;;5,0;;;;;;;;;;;;;;;;;;;1,0;;;;;;;;;;;;;;;;;;;;;;;;;;;;;;;2,0;;;;;;;2,0;;8,0;;;;;;;;;;;;;
cleaning;;2,0;;;12,0;;1,0;;;;;;;;;;;;;;;24,0;;;;;;;;;;1,0;41,0;;13,0;;;1,0;;33,0;;;;;;;;;1,0;;1,0;1,0;;;;64,0;6,0;;;2,0;;;7,0;;;;;;;4,0;3,0;;;;;;;;88,0;;;;10,0;1,0;1,0;;;;;;3,0;;;;;;;;1,0;;1,0;1,0;;;;;;1,0;;;;;;;;;;;;;;;2,0;;;;1,0;19,0;;;;12,0;;;;;;;;;;;1,0;11,0;5,0;1,0;;;;;;;;;;;;4,0;;42,0;;;;;14,0;;;4,0;;;88,0;;;1,0;17,0;;;;;;;;;;;;;;;1,0;;;;1,0;;;;;;;;;3,0;1,0;;;;;;;;;;;;3,0;1,0;;;;;;;;;;11,0;;;;;;;;;;;;;;;;;10,0;;5,0;;;;;;;;3,0;;;;;;;;;;;;;;;;;;9,0;;;4,0;;;;;6,0;;;;4,0;;;30,0;;;;;;;;;;;4,0;;;;;;;;;;;;;;;28,0;;;;;;;;;;;;;1,0;;;;;;;;;;;;;;;;;;;;;;3,0;2,0;;;;;;;;;;;;;;;;;3,0;;;;;;;;;;1,0;;;;;;;;1,0;;5,0;;;;;1,0;;;;;;14,0;;1,0;;;;;;;;;;;2,0;;;;10,0;;;;;;;;;;;;;;;;;;;;;;;;;;;;;;;;22,0;;;;1,0;;;;;;;;;;;;;;;;;8,0;;;;;14,0;;;1,0;;1,0;;;;;;;;;;;;;;;;;;;1,0;;;;;2,0;;;;;;;;;;;;;;;;;;;;;;;;;;1,0;;;;;;;;4,0;;;;;;;;;;;;;;;;1,0;;;;;;;;;;;;;;;;3,0;;;;;;;;;;3,0;;;;;;11,0;;;;;;;;;;;;;;;;;;;;;;;;;;;;;;;;;;;;;1,0;;;;;;;;;;;;;;1,0;;;;;;;;;;;;;;;;;;;;;;;;;;;1,0;;;;;1,0;;;;;;;;;;;;;;;;;;;;;;;;;;;;;;;;;;;;;;;;;;;;1,0;;;;;;;;;;;;;;;;;;;14,0;;;;;;;;;;;;;;;;;1,0;;;;;;;;;;;;;;;;;;;;;;;;;;;;;;;;;;;;;;;;;;;;;;;;;;;;;;;;;;;;;;;;;;;;;;1,0;;;;;;;;;;;;2,0;;;6,0;;;;;1,0;;;1,0;;;;;;;;;;;;;;1,0;;;;;;;;;;;;;;;;;;;;;;;;;;;;;;;;;1,0;;;;;;;;;;;;;;;;;;;;;;;;;;;;;;;;;;;;;;;;;;;;;2,0;;;;;;;;;;;;;;;;;;;;;;;;;;;;;;;;;;;;;;;;;;;;;;;;;;;;;;;;;;;;;;;;;;;;;
communication;;8,0;6,0;2,0;114,0;;7,0;52,0;;47,0;1,0;13,0;;;3,0;;1,0;;4,0;35,0;7,0;230,0;;1,0;;;;373,0;;42,0;18,0;36,0;671,0;;94,0;;11,0;7,0;;114,0;10,0;2,0;;10,0;1,0;;4,0;1,0;;4,0;27,0;26,0;;5,0;;459,0;109,0;;;97,0;;;115,0;;;3,0;2,0;;3,0;63,0;48,0;5,0;20,0;;;11,0;;3,0;26,0;137,0;2,0;84,0;91,0;1,0;;1,0;2,0;;9,0;16,0;68,0;;12,0;217,0;;2,0;;25,0;40,0;5,0;10,0;211,0;;27,0;;1,0;2,0;561,0;5,0;;16,0;14,0;2,0;13,0;10,0;2,0;;1,0;5,0;158,0;;;4,0;49,0;;;108,0;5,0;;23,0;4,0;4,0;1,0;2,0;1,0;12,0;10,0;;;5,0;2,0;;79,0;5,0;;4,0;15,0;18,0;1,0;1,0;1,0;7,0;8,0;7,0;;2,0;19,0;29,0;14,0;24,0;;;5,0;;62,0;;;26,0;1,0;;49,0;;326,0;29,0;5,0;9,0;1,0;35,0;1,0;;3,0;;2,0;;1,0;1,0;3,0;54,0;;17,0;;4,0;1,0;221,0;1,0;;;13,0;9,0;4,0;2,0;4,0;;40,0;;5,0;;3,0;12,0;9,0;;1,0;;;;17,0;158,0;;;2,0;1,0;4,0;;1,0;7,0;;4,0;;;;1,0;;6,0;2,0;4,0;8,0;;1,0;58,0;1,0;2,0;;11,0;;8,0;3,0;16,0;20,0;;;1,0;;;103,0;2,0;;;12,0;1,0;;;1,0;;3,0;10,0;;7,0;;;;;3,0;1,0;;;169,0;1,0;;3,0;6,0;;1,0;26,0;6,0;1,0;4,0;1,0;17,0;23,0;;1,0;;1,0;2,0;;3,0;;37,0;2,0;;67,0;;29,0;2,0;1,0;1,0;;30,0;2,0;11,0;1,0;21,0;;;;;2,0;;;1,0;;10,0;2,0;;;12,0;;;33,0;1,0;76,0;1,0;4,0;;;7,0;;5,0;1,0;;;10,0;2,0;5,0;;12,0;2,0;12,0;2,0;31,0;;19,0;9,0;1,0;;;1,0;;;1,0;;;;;37,0;15,0;1,0;1,0;3,0;4,0;5,0;;;1,0;33,0;29,0;2,0;;;24,0;2,0;3,0;1,0;18,0;2,0;;1,0;4,0;3,0;27,0;2,0;32,0;1,0;7,0;6,0;40,0;16,0;40,0;3,0;;7,0;2,0;7,0;;;;1,0;10,0;;3,0;;16,0;2,0;4,0;6,0;17,0;17,0;;31,0;;26,0;5,0;11,0;319,0;86,0;11,0;1,0;13,0;5,0;4,0;;;6,0;;;12,0;4,0;1,0;52,0;18,0;9,0;;3,0;6,0;4,0;51,0;2,0;5,0;8,0;5,0;1,0;10,0;4,0;23,0;;67,0;36,0;3,0;5,0;11,0;9,0;3,0;;;6,0;31,0;1,0;1,0;2,0;10,0;;133,0;2,0;1,0;38,0;;6,0;139,0;3,0;;7,0;1,0;8,0;2,0;1,0;7,0;2,0;5,0;2,0;23,0;8,0;43,0;;8,0;77,0;11,0;1,0;3,0;4,0;;1,0;105,0;;;1,0;6,0;;;2,0;;1,0;;8,0;5,0;;24,0;62,0;1,0;3,0;2,0;;;7,0;3,0;;;45,0;;;;2,0;;3,0;3,0;1,0;;;1,0;26,0;4,0;;;18,0;3,0;3,0;3,0;31,0;;2,0;1,0;2,0;5,0;5,0;1,0;226,0;1,0;14,0;12,0;13,0;8,0;7,0;;25,0;1,0;;2,0;1,0;1,0;;1,0;;45,0;112,0;27,0;;3,0;4,0;4,0;;5,0;;1,0;32,0;2,0;2,0;301,0;;1,0;;1,0;334,0;;;6,0;5,0;;1,0;;;;14,0;1,0;3,0;;1,0;3,0;16,0;1,0;1,0;;;2,0;;;8,0;2,0;27,0;;5,0;2,0;;;1,0;4,0;8,0;;;;65,0;1,0;;12,0;;1,0;;;;;4,0;10,0;;;;;;1,0;3,0;;;;;;1,0;2,0;;;;4,0;;2,0;3,0;;10,0;;;4,0;;9,0;1,0;;;;1,0;5,0;2,0;1,0;;1,0;;1,0;;;;;;;;3,0;;;;3,0;;;;;;;4,0;;2,0;5,0;2,0;;1,0;;;;;19,0;;2,0;;;;;;;;2,0;1,0;;;1,0;;1,0;;1,0;;;2,0;8,0;5,0;2,0;1,0;;;;1,0;;;;2,0;;;;;;;;;;;2,0;;;;;;4,0;;1,0;;;5,0;;;;2,0;4,0;5,0;;;;;34,0;;4,0;2,0;;3,0;;;11,0;;1,0;5,0;8,0;;;2,0;2,0;7,0;7,0;93,0;;;;;;1,0;6,0;;;;;;;;;;;;11,0;;1,0;1,0;;1,0;18,0;;1,0;;1,0;;1,0;;24,0;6,0;2,0;;1,0;;;;;;;9,0;;;9,0;;10,0;21,0;8,0;;;;;1,0;;;;;;2,0;;;;1,0;8,0;;;;;1,0;;5,0;;1,0;6,0;8,0;;;;8,0;1,0;2,0;;;;;2,0;;1,0;;;;5,0;;13,0;;4,0;;;6,0;3,0;16,0;1,0;17,0;;2,0;;;;;1,0;36,0;;;1,0;;2,0;;6,0;;;;;;;;;47,0;6,0;2,0;2,0;;;;;;2,0;;;23,0;;;;;;1,0;1,0;5,0;;4,0;;;2,0;;;1,0;;;;;;;;;;;;;;;1,0;;;;3,0;;6,0;;;6,0;;;;;;;;;;8,0;;;;;;;;2,0;;;;;
compact;;1,0;;;4,0;2,0;2,0;3,0;3,0;;;;;;;4,0;;;2,0;;;3,0;;;;;;1,0;;1,0;1,0;;53,0;;21,0;;1,0;2,0;;1,0;;;;2,0;;;;1,0;3,0;;;;;7,0;;10,0;6,0;;4,0;29,0;;;6,0;;1,0;1,0;4,0;;;;4,0;1,0;;;;;;2,0;8,0;5,0;;;1,0;;;;;;;;4,0;;;2,0;6,0;;;1,0;;16,0;12,0;8,0;;;;;;8,0;;;;;;5,0;1,0;;;;;5,0;;;;;;;;1,0;;2,0;2,0;;1,0;4,0;1,0;;2,0;;;;1,0;2,0;;;;;5,0;;4,0;1,0;;;;;;;;7,0;2,0;6,0;;;;2,0;;2,0;;2,0;;1,0;1,0;1,0;55,0;1,0;;;2,0;;3,0;;2,0;;;;;6,0;1,0;;;5,0;1,0;;;2,0;;;;;5,0;2,0;;1,0;;1,0;;;;3,0;2,0;2,0;;;;1,0;;;;;;;;;1,0;;1,0;;;;;;;;;;;;;;9,0;;5,0;;;3,0;2,0;;;2,0;;1,0;;;;3,0;;;;1,0;;;;1,0;;;;;2,0;;;;;;;;;;;;3,0;;;;;1,0;;;1,0;;;;1,0;;;;;;;;2,0;;;;;;;;;10,0;;;;;2,0;;;;;8,0;;;;;2,0;;;1,0;;1,0;3,0;;1,0;;;;;;;;1,0;;;;;;;;;;;;;;1,0;;;;;;;;;;;;;;;;1,0;;;1,0;;;;1,0;;;;9,0;;;4,0;;;;;1,0;;;;1,0;;;1,0;;;;;;;;;;;;;7,0;;;;1,0;;;;;3,0;;1,0;;;;;;;;;;1,0;;;;;1,0;;;;;;1,0;;;3,0;1,0;1,0;;;;;;;;;3,0;;;;;;;;;;;;;3,0;;;;;;;;;;;;;;;3,0;;;;2,0;;;;;;;;;3,0;;;1,0;;;;;6,0;;2,0;1,0;;;;;;;;;1,0;1,0;;;;;;;;2,0;;;4,0;;;;2,0;;1,0;;1,0;;5,0;1,0;;;;;;;;;;;;;;;;;;;;;;;;;1,0;;;;;;;;;;;;3,0;;2,0;1,0;;;;;;;;;;;;;;;;;;1,0;;;;;;;;;;;;;8,0;;;1,0;;;;;1,0;;1,0;;;;;;;;2,0;;;;;1,0;2,0;1,0;;;1,0;;;;;;;;;;;;;;;;;;1,0;;;;;;;;;;;;;;;;;;;;;;;3,0;;;;;;;;;;;;;;;;;;;;;;;;;;;;;;;;1,0;;;;;;;;;;2,0;;;;;;;;;;;;;;;;;;;;;;;;1,0;;1,0;;;;;;1,0;1,0;;;;;;4,0;;3,0;;;;;;;;;;;1,0;;10,0;;4,0;;2,0;;;;1,0;;;;;;;;;;;;;;;;;;1,0;;;;;;;;;;;;;;;1,0;;;;;;;;;;;;1,0;;;;;;;;;;;;;;1,0;;;;;;;;;;;;;;;;;;;;;;;;2,0;;;;;;;2,0;;;;;;;;;;;;;;1,0;;;;;;;;;;;;;;;;;;;;;;;;;;;;;10,0;;;;;;;;;;;;;;;;;;;;;;;;;2,0;;;;;;;;;;;;;;;;1,0;;;;;;;;;;;;;;;1,0;2,0;;;;;;;;;;;;;;1,0;;;;;;;;;;;;;;
compartment;;24,0;;;5,0;;;1,0;;;;;;;;;;;;1,0;;3,0;;;;;;;;;;;11,0;;;;;;;7,0;;;;;;;;;;;;;;;;;10,0;;1,0;2,0;;;1,0;;;;1,0;;;;;;;;;;;;;4,0;4,0;;;;;;;;;;;;4,0;;2,0;3,0;;4,0;;;2,0;3,0;;;;;;14,0;;;1,0;;;;;;;;2,0;5,0;;;;2,0;;;3,0;;;;2,0;1,0;;;;;9,0;4,0;;;;;5,0;;;;4,0;4,0;;;;;;;;1,0;6,0;2,0;;;;;;7,0;;;;5,0;1,0;;6,0;;9,0;17,0;;9,0;;;;;3,0;;1,0;;;;6,0;1,0;;17,0;;;6,0;8,0;;;;;;;;1,0;;6,0;;;;;;4,0;;1,0;;;;;;;;;1,0;4,0;;6,0;4,0;;;;;;5,0;;;;;;;;;;;;;;;1,0;;;;;;;;2,0;;;;2,0;;;;;;;;;2,0;;;;;;;;1,0;;;;1,0;3,0;;;1,0;;;;;;;;;;;;;;;;;;2,0;;;;;;;;2,0;;;;;;2,0;;;;;2,0;;;;5,0;;7,0;;1,0;8,0;;2,0;3,0;;;;;;;;;;7,0;;;;;;1,0;;;4,0;;;;;;;;;;;;;;;;;;;;;;;;;;;;;;;;;;;;;;;1,0;;;;;;;;;;;;;;;;;;;;;;;;;;;;;;;;;;;;;;;;;;;;;;;;;;18,0;;;;;;;;;;;3,0;;;;;;;;;;;;;;;1,0;;2,0;;;2,0;;4,0;;2,0;;;;;;;;;;;4,0;;;;;;;;;;1,0;;;;;;;;;;;;;;16,0;6,0;;;;;;;;;;1,0;;;;;;;;;4,0;4,0;;;;;;;;;;;;;;6,0;;1,0;2,0;;;;;;;;1,0;;;;;;;;;;;1,0;;;;;;;;;;;;;;;;;;;;;;;;;;;;21,0;;;;;1,0;;;;;;;;;;;;;;;;;;;;;;;;12,0;;;;2,0;;1,0;;;;;;;;;;;;;;;;;;;1,0;;;;;;;;;;;;;;;;;;;;;;;;;;;2,0;;;;;;;;;;;;1,0;;;;;;;;;;;;;;;;;;;;;;;;;;;;;;;;1,0;;;;;;;;;;;;;;;;;;;;;;;;;;;;;;;;;;;;;;;;;;;;;;;;;;;;;;;;;;;;;;;;;;;;;;;;;;;4,0;;;1,0;;;;;;;;;;;;;;;;;;;;;;;;;1,0;;;;;;;;;;;;;;;;;;;;;;;;;;;;;;;;;;4,0;;;;;;;;;;;;;;;;;;;;;;;;;;;;;;;;;;;;;;;;;;;;;;;;;;;;;;;;;;;;;;;;;;;;;;;;;;;;;;;;;;;;;;;;;;;;;;;;;;;;;;;;;;;;;;;;;;;;;;;;;;;;;;;;;;;;;;;;;;;;;;8,0;
configure;;12,0;75,0;5,0;312,0;;118,0;125,0;113,0;343,0;15,0;25,0;4,0;7,0;109,0;17,0;33,0;23,0;140,0;103,0;42,0;911,0;20,0;88,0;75,0;7,0;1,0;426,0;9,0;324,0;136,0;302,0;755,0;35,0;186,0;11,0;31,0;133,0;26,0;524,0;96,0;22,0;182,0;193,0;8,0;5,0;8,0;50,0;158,0;26,0;44,0;330,0;16,0;113,0;3,0;1896,0;372,0;11,0;53,0;846,0;7,0;25,0;65,0;2,0;6,0;72,0;82,0;7,0;1,0;138,0;335,0;13,0;30,0;12,0;2,0;19,0;11,0;75,0;412,0;179,0;42,0;319,0;516,0;34,0;6,0;4,0;92,0;5,0;19,0;159,0;314,0;21,0;24,0;485,0;38,0;21,0;3,0;75,0;229,0;53,0;150,0;559,0;;58,0;3,0;20,0;10,0;1254,0;3,0;5,0;7,0;51,0;94,0;131,0;43,0;12,0;57,0;4,0;17,0;201,0;;2,0;26,0;292,0;;13,0;;71,0;28,0;119,0;104,0;23,0;7,0;56,0;5,0;168,0;55,0;12,0;15,0;39,0;12,0;8,0;68,0;49,0;140,0;19,0;95,0;208,0;7,0;10,0;4,0;20,0;97,0;23,0;76,0;44,0;24,0;142,0;39,0;246,0;19,0;20,0;14,0;8,0;6,0;10,0;53,0;475,0;17,0;11,0;249,0;37,0;327,0;163,0;89,0;55,0;22,0;196,0;4,0;1,0;21,0;12,0;61,0;37,0;24,0;36,0;70,0;352,0;;407,0;5,0;13,0;37,0;578,0;4,0;44,0;;9,0;56,0;41,0;8,0;25,0;13,0;101,0;10,0;10,0;14,0;9,0;33,0;103,0;20,0;18,0;12,0;2,0;23,0;110,0;143,0;19,0;2,0;3,0;8,0;40,0;35,0;51,0;29,0;28,0;32,0;;1,0;6,0;15,0;8,0;78,0;14,0;118,0;52,0;8,0;54,0;105,0;13,0;102,0;3,0;35,0;24,0;9,0;16,0;121,0;23,0;5,0;13,0;34,0;6,0;4,0;111,0;6,0;9,0;7,0;52,0;11,0;4,0;8,0;180,0;32,0;18,0;83,0;15,0;39,0;1,0;7,0;13,0;7,0;46,0;;9,0;22,0;110,0;13,0;5,0;19,0;17,0;29,0;13,0;6,0;112,0;6,0;109,0;222,0;240,0;75,0;10,0;20,0;5,0;13,0;23,0;5,0;18,0;24,0;73,0;6,0;2,0;19,0;3,0;36,0;47,0;26,0;4,0;2,0;55,0;20,0;13,0;42,0;41,0;43,0;77,0;15,0;8,0;2,0;16,0;6,0;8,0;1,0;66,0;51,0;39,0;2,0;74,0;1,0;25,0;81,0;1,0;151,0;29,0;4,0;6,0;;7,0;1,0;37,0;7,0;15,0;3,0;34,0;3,0;18,0;66,0;31,0;12,0;26,0;6,0;113,0;42,0;39,0;50,0;4,0;1,0;1,0;7,0;6,0;;;10,0;13,0;5,0;1,0;59,0;11,0;9,0;5,0;32,0;6,0;13,0;;4,0;42,0;31,0;123,0;8,0;16,0;;23,0;30,0;55,0;28,0;76,0;27,0;4,0;7,0;2,0;10,0;59,0;27,0;11,0;18,0;8,0;97,0;19,0;24,0;29,0;17,0;11,0;45,0;1,0;9,0;7,0;23,0;13,0;27,0;83,0;11,0;25,0;25,0;70,0;1,0;29,0;32,0;14,0;30,0;3,0;139,0;14,0;48,0;53,0;4,0;16,0;153,0;25,0;7,0;49,0;6,0;31,0;31,0;7,0;2,0;11,0;10,0;10,0;34,0;6,0;21,0;33,0;25,0;11,0;58,0;81,0;13,0;311,0;35,0;142,0;12,0;26,0;7,0;58,0;88,0;91,0;8,0;24,0;16,0;8,0;55,0;3,0;;19,0;5,0;3,0;18,0;46,0;56,0;7,0;108,0;1,0;2,0;177,0;16,0;3,0;20,0;3,0;115,0;4,0;3,0;10,0;25,0;2,0;15,0;5,0;2,0;85,0;23,0;34,0;34,0;82,0;21,0;98,0;41,0;10,0;263,0;118,0;10,0;37,0;2,0;16,0;10,0;8,0;5,0;19,0;66,0;35,0;1,0;;13,0;13,0;12,0;1,0;31,0;149,0;108,0;29,0;53,0;10,0;3,0;4,0;3,0;9,0;10,0;5,0;4,0;9,0;49,0;1,0;8,0;8,0;3,0;2,0;6,0;8,0;17,0;6,0;6,0;18,0;10,0;10,0;6,0;6,0;7,0;6,0;2,0;3,0;16,0;12,0;4,0;13,0;17,0;23,0;2,0;22,0;61,0;2,0;8,0;3,0;9,0;55,0;159,0;4,0;36,0;;6,0;6,0;47,0;2,0;3,0;4,0;12,0;21,0;22,0;20,0;5,0;;16,0;23,0;4,0;14,0;3,0;11,0;126,0;;8,0;40,0;9,0;2,0;7,0;32,0;54,0;3,0;;;19,0;39,0;;3,0;;2,0;11,0;9,0;88,0;4,0;6,0;7,0;27,0;18,0;6,0;8,0;9,0;11,0;1,0;3,0;2,0;6,0;19,0;10,0;1,0;2,0;14,0;1,0;6,0;26,0;2,0;2,0;4,0;11,0;19,0;;;5,0;22,0;29,0;19,0;5,0;44,0;15,0;21,0;8,0;3,0;7,0;;13,0;7,0;26,0;3,0;1,0;6,0;6,0;28,0;3,0;;11,0;6,0;8,0;2,0;11,0;25,0;11,0;44,0;5,0;9,0;;9,0;8,0;49,0;3,0;7,0;6,0;5,0;;3,0;4,0;16,0;11,0;3,0;10,0;3,0;2,0;14,0;15,0;12,0;33,0;33,0;8,0;;3,0;19,0;1,0;2,0;29,0;2,0;6,0;11,0;17,0;3,0;16,0;19,0;9,0;7,0;;7,0;2,0;7,0;3,0;19,0;5,0;;120,0;17,0;6,0;1,0;18,0;;18,0;7,0;22,0;4,0;22,0;5,0;1,0;;29,0;5,0;;5,0;;1,0;1,0;3,0;8,0;45,0;6,0;5,0;36,0;7,0;3,0;8,0;1,0;15,0;5,0;5,0;4,0;6,0;7,0;10,0;34,0;5,0;;12,0;13,0;17,0;15,0;6,0;16,0;1,0;9,0;3,0;10,0;12,0;20,0;10,0;1,0;14,0;2,0;18,0;21,0;;5,0;54,0;1,0;10,0;1,0;6,0;32,0;46,0;13,0;11,0;23,0;11,0;10,0;6,0;7,0;15,0;27,0;14,0;6,0;2,0;6,0;11,0;1,0;2,0;11,0;46,0;8,0;2,0;1,0;15,0;3,0;4,0;7,0;7,0;5,0;8,0;5,0;16,0;7,0;4,0;5,0;16,0;4,0;1,0;19,0;10,0;5,0;17,0;;5,0;;18,0;3,0;7,0;3,0;1,0;3,0;3,0;7,0;28,0;17,0;33,0;17,0;28,0;11,0;;11,0;8,0;7,0;7,0;;7,0;13,0;8,0;14,0;14,0;7,0;;17,0;4,0;11,0;8,0;;8,0;9,0;5,0;1,0;20,0;;34,0;2,0;8,0;45,0;;8,0;9,0;15,0;4,0;;18,0;1,0;;2,0;15,0;;3,0;;31,0;;2,0;1,0;1,0;7,0;2,0;5,0;8,0;;1,0;2,0;5,0;16,0;;6,0;;40,0;10,0;5,0;10,0;;1,0;15,0;54,0;7,0;3,0;6,0;;2,0;;1,0;2,0;12,0;5,0;;5,0;16,0;2,0;16,0;1,0;;4,0;6,0;7,0;21,0;;5,0;6,0;13,0;;23,0;6,0;10,0;7,0;2,0;;;;16,0;13,0;9,0;;8,0;;;4,0;11,0;1,0;;;5,0;;5,0;;8,0;2,0;7,0;1,0;4,0;8,0;;;1,0;1,0;;;;;1,0;1,0;3,0;;3,0;2,0;7,0;6,0;1,0;;4,0;;1,0;;;;2,0;1,0;2,0;;16,0;6,0;6,0;;;2,0;3,0;2,0;;1,0;1,0;;;;3,0
connect;;8,0;5,0;5,0;157,0;;56,0;242,0;9,0;46,0;17,0;2,0;1,0;;8,0;3,0;;;36,0;36,0;4,0;174,0;3,0;;9,0;;11,0;123,0;2,0;26,0;35,0;16,0;569,0;4,0;92,0;;16,0;103,0;9,0;111,0;13,0;1,0;86,0;274,0;;11,0;;;1,0;5,0;6,0;20,0;;13,0;10,0;394,0;175,0;;15,0;303,0;9,0;;90,0;2,0;2,0;48,0;27,0;5,0;1,0;46,0;67,0;2,0;24,0;14,0;15,0;6,0;8,0;79,0;98,0;122,0;7,0;129,0;95,0;4,0;;;35,0;2,0;;30,0;213,0;14,0;3,0;292,0;5,0;32,0;;55,0;25,0;186,0;139,0;94,0;9,0;134,0;;17,0;30,0;604,0;;;50,0;47,0;16,0;51,0;30,0;;7,0;;209,0;306,0;15,0;;5,0;314,0;;;111,0;102,0;;75,0;104,0;2,0;6,0;14,0;9,0;25,0;56,0;11,0;250,0;3,0;2,0;;117,0;24,0;19,0;5,0;188,0;118,0;1,0;5,0;;15,0;53,0;23,0;45,0;57,0;105,0;174,0;13,0;83,0;;2,0;76,0;6,0;4,0;34,0;7,0;68,0;36,0;27,0;333,0;19,0;301,0;175,0;13,0;41,0;63,0;184,0;18,0;25,0;27,0;6,0;11,0;11,0;29,0;18,0;113,0;370,0;;485,0;5,0;73,0;4,0;96,0;5,0;8,0;1,0;18,0;26,0;7,0;31,0;38,0;19,0;203,0;8,0;4,0;24,0;6,0;51,0;163,0;9,0;22,0;4,0;3,0;31,0;17,0;32,0;14,0;;27,0;52,0;14,0;;1,0;54,0;;5,0;;;1,0;3,0;1,0;48,0;25,0;19,0;20,0;20,0;2,0;104,0;21,0;58,0;10,0;29,0;67,0;92,0;39,0;24,0;123,0;1,0;98,0;69,0;14,0;62,0;;;4,0;9,0;48,0;;5,0;;43,0;14,0;39,0;21,0;3,0;93,0;5,0;22,0;28,0;81,0;52,0;75,0;6,0;23,0;104,0;;14,0;;31,0;13,0;37,0;16,0;138,0;4,0;7,0;13,0;12,0;19,0;42,0;1,0;7,0;;26,0;2,0;16,0;9,0;5,0;3,0;23,0;25,0;18,0;30,0;5,0;5,0;15,0;6,0;4,0;28,0;10,0;22,0;50,0;7,0;4,0;105,0;2,0;23,0;16,0;25,0;11,0;27,0;27,0;47,0;20,0;6,0;107,0;;18,0;104,0;;24,0;5,0;11,0;;;1,0;1,0;10,0;1,0;;1,0;1,0;;4,0;;17,0;5,0;3,0;3,0;5,0;13,0;5,0;10,0;17,0;;1,0;1,0;;;3,0;1,0;1,0;;;20,0;5,0;;;7,0;;;9,0;;7,0;24,0;82,0;6,0;1,0;;63,0;2,0;22,0;3,0;14,0;11,0;;;;;46,0;3,0;1,0;9,0;3,0;57,0;;3,0;9,0;;;2,0;;10,0;;5,0;;4,0;5,0;;;2,0;12,0;22,0;7,0;11,0;;3,0;;88,0;1,0;14,0;5,0;;20,0;6,0;6,0;;50,0;;11,0;8,0;;7,0;;;44,0;8,0;;6,0;14,0;12,0;;19,0;27,0;5,0;78,0;10,0;12,0;2,0;27,0;1,0;7,0;45,0;84,0;3,0;;2,0;1,0;2,0;21,0;;;;2,0;8,0;56,0;66,0;;13,0;;;11,0;26,0;;30,0;;66,0;4,0;4,0;;31,0;1,0;9,0;;;46,0;6,0;20,0;15,0;15,0;;168,0;3,0;3,0;113,0;13,0;5,0;67,0;;;8,0;3,0;2,0;;14,0;23,0;5,0;9,0;2,0;18,0;25,0;3,0;7,0;6,0;103,0;186,0;172,0;10,0;5,0;3,0;28,0;29,0;2,0;8,0;;8,0;12,0;7,0;;;18,0;2,0;6,0;3,0;3,0;5,0;7,0;6,0;7,0;3,0;6,0;8,0;8,0;5,0;10,0;1,0;60,0;;1,0;;;2,0;20,0;1,0;144,0;2,0;4,0;;8,0;6,0;118,0;15,0;13,0;;12,0;;16,0;2,0;;1,0;3,0;;36,0;7,0;39,0;32,0;50,0;1,0;14,0;5,0;2,0;11,0;1,0;;;335,0;16,0;;;;32,0;13,0;14,0;36,0;9,0;19,0;3,0;2,0;4,0;12,0;11,0;6,0;9,0;6,0;5,0;7,0;12,0;14,0;8,0;6,0;;23,0;2,0;;3,0;;13,0;4,0;8,0;;34,0;2,0;1,0;8,0;;2,0;1,0;17,0;28,0;75,0;;263,0;10,0;23,0;;12,0;10,0;30,0;59,0;8,0;8,0;4,0;;16,0;;5,0;;1,0;1,0;;5,0;7,0;;59,0;9,0;;3,0;1,0;;;2,0;10,0;7,0;1,0;8,0;14,0;2,0;6,0;16,0;8,0;44,0;;2,0;2,0;62,0;3,0;1,0;2,0;;;99,0;32,0;;;4,0;102,0;14,0;1,0;;23,0;5,0;25,0;;;2,0;25,0;105,0;16,0;5,0;;1,0;1,0;93,0;;4,0;;19,0;1,0;;14,0;2,0;4,0;4,0;3,0;;;299,0;6,0;;2,0;6,0;1,0;2,0;;1,0;1,0;3,0;;1,0;1,0;2,0;1,0;;4,0;5,0;;;1,0;1,0;1,0;;5,0;5,0;9,0;;1,0;4,0;25,0;5,0;;4,0;2,0;;10,0;;2,0;1,0;24,0;9,0;13,0;1,0;2,0;4,0;1,0;5,0;;;26,0;;;1,0;8,0;3,0;;;40,0;;1,0;16,0;6,0;;5,0;;2,0;1,0;;;4,0;;2,0;11,0;;;11,0;7,0;1,0;;6,0;3,0;6,0;;;3,0;37,0;;;12,0;;33,0;;1,0;1,0;;9,0;2,0;3,0;;3,0;;1,0;4,0;2,0;;3,0;;1,0;8,0;;1,0;;3,0;4,0;3,0;12,0;;;2,0;;18,0;;;1,0;7,0;14,0;3,0;;52,0;5,0;;28,0;4,0;;1,0;;;;25,0;10,0;12,0;2,0;44,0;8,0;;21,0;;;1,0;38,0;8,0;9,0;;8,0;24,0;2,0;11,0;2,0;;;1,0;;;25,0;3,0;15,0;85,0;3,0;3,0;6,0;2,0;5,0;;2,0;4,0;20,0;;3,0;;;11,0;3,0;;9,0;3,0;7,0;1,0;;1,0;6,0;1,0;;3,0;2,0;;3,0;;4,0;;;1,0;;;4,0;;;27,0;23,0;;;2,0;2,0;1,0;;5,0;;;;;5,0;;;;;;2,0;;;9,0;6,0;;;19,0;;1,0;7,0;12,0;5,0;11,0;;;;5,0;;;3,0;;;;;;;3,0;9,0;6,0;;1,0;12,0;3,0;;;;12,0;;;5,0;2,0;;19,0;;;;1,0;;;;;;;;;
connection;;7,0;;;20,0;;3,0;69,0;;14,0;;;;;;6,0;;;15,0;6,0;3,0;59,0;;;;;;129,0;;37,0;11,0;3,0;139,0;;30,0;;10,0;11,0;;14,0;4,0;;1,0;27,0;;;10,0;;;1,0;13,0;2,0;;3,0;;130,0;70,0;;;98,0;2,0;3,0;51,0;;;6,0;3,0;2,0;4,0;8,0;11,0;13,0;1,0;4,0;;;;44,0;12,0;30,0;3,0;8,0;9,0;4,0;;;21,0;1,0;;10,0;26,0;3,0;1,0;35,0;;4,0;;33,0;43,0;49,0;41,0;33,0;;14,0;;;14,0;165,0;;;16,0;25,0;1,0;14,0;9,0;;8,0;;27,0;57,0;2,0;;;59,0;;;29,0;37,0;;28,0;5,0;1,0;;;;6,0;27,0;;8,0;1,0;;;47,0;10,0;1,0;;66,0;19,0;1,0;2,0;;3,0;;5,0;;6,0;13,0;9,0;;14,0;;;8,0;1,0;;9,0;;12,0;;15,0;56,0;;74,0;40,0;;11,0;8,0;33,0;4,0;;2,0;4,0;;;7,0;3,0;7,0;65,0;;137,0;;4,0;4,0;28,0;;;;;1,0;12,0;5,0;10,0;;27,0;2,0;6,0;;;22,0;40,0;;6,0;1,0;2,0;2,0;9,0;31,0;6,0;;2,0;33,0;4,0;;;5,0;;;;2,0;;2,0;;5,0;1,0;3,0;;;1,0;8,0;1,0;8,0;4,0;7,0;8,0;16,0;2,0;2,0;27,0;6,0;3,0;;;6,0;186,0;4,0;;4,0;21,0;;;;6,0;2,0;7,0;17,0;10,0;17,0;;;;9,0;2,0;1,0;;9,0;21,0;;;2,0;6,0;;5,0;11,0;11,0;;;1,0;1,0;8,0;3,0;4,0;1,0;5,0;21,0;;;;2,0;;;14,0;10,0;10,0;14,0;;5,0;;2,0;1,0;7,0;;9,0;1,0;;1,0;;13,0;;3,0;8,0;;;23,0;1,0;;5,0;;4,0;7,0;;11,0;;;;;;2,0;17,0;;;1,0;5,0;;1,0;1,0;;1,0;2,0;1,0;5,0;4,0;5,0;1,0;4,0;;;;;;;;;;;3,0;5,0;;;6,0;;;2,0;;;8,0;14,0;;;;1,0;;4,0;4,0;1,0;;;;;;6,0;2,0;5,0;6,0;2,0;4,0;1,0;;;;;;;;;;;;6,0;;2,0;;2,0;1,0;3,0;2,0;2,0;1,0;;18,0;;6,0;1,0;;9,0;11,0;5,0;3,0;9,0;;;;;;;;30,0;;;2,0;2,0;1,0;;1,0;7,0;10,0;16,0;;12,0;5,0;;;;;15,0;;;;;;20,0;;8,0;;;1,0;1,0;11,0;;3,0;;;6,0;;;20,0;;14,0;7,0;;;;;7,0;;;3,0;;;;8,0;;45,0;3,0;1,0;23,0;;9,0;;;;1,0;2,0;;;4,0;11,0;8,0;1,0;;2,0;1,0;;1,0;1,0;24,0;;21,0;;;;6,0;;2,0;;;3,0;11,0;2,0;;;2,0;;6,0;;9,0;;2,0;;8,0;;;;18,0;3,0;;;;;;;;6,0;3,0;;142,0;;5,0;21,0;1,0;2,0;18,0;;11,0;6,0;1,0;;1,0;;;;6,0;7,0;20,0;10,0;1,0;20,0;2,0;1,0;5,0;;;;;2,0;;71,0;2,0;;;1,0;52,0;6,0;;4,0;;;1,0;;7,0;1,0;3,0;;;4,0;1,0;4,0;10,0;4,0;2,0;;3,0;7,0;;;;;6,0;;;2,0;;1,0;;6,0;;;1,0;;13,0;;;57,0;2,0;;;4,0;1,0;;12,0;;;8,0;;;2,0;;;;;;;2,0;1,0;;1,0;3,0;4,0;;;;;;5,0;;;;;1,0;1,0;;;;4,0;;;1,0;7,0;;;;2,0;;;;2,0;;2,0;;;;;16,0;;;;;12,0;1,0;1,0;;5,0;;2,0;;;;;;;2,0;;1,0;;1,0;;;4,0;;;2,0;;;2,0;;;;;;;;;1,0;;;;;;;1,0;;;;1,0;;2,0;;;;1,0;;;;1,0;;;;;;2,0;3,0;;;1,0;;;2,0;;;;;5,0;;1,0;;;8,0;;2,0;1,0;3,0;;;;;;;;;;;3,0;;;;3,0;3,0;;3,0;;;;;1,0;2,0;;;1,0;2,0;;1,0;;1,0;2,0;3,0;;;;;4,0;;;;1,0;5,0;;;3,0;;;1,0;;3,0;;;1,0;;;;1,0;;1,0;;5,0;;1,0;;;;;12,0;;;;;;;4,0;;4,0;;;;;1,0;;;2,0;5,0;1,0;;;1,0;2,0;;;;;;;;;;;1,0;2,0;;;;2,0;1,0;;3,0;;;;;;;9,0;;;2,0;1,0;;;;;;;;;;;;;3,0;;;;;;;;;9,0;8,0;;;;4,0;4,0;;4,0;;;;;4,0;;;;;;;;;;;;;4,0;;1,0;;;1,0;;;;3,0;;;;;;;;;;;1,0;;;;;5,0;;;;;;;;;;;;2,0;;;;;;;;;;;;
connector;;2,0;3,0;;22,0;;10,0;22,0;2,0;1,0;1,0;2,0;12,0;;;;;;2,0;18,0;;8,0;;;;;;47,0;;6,0;;;112,0;;15,0;;;10,0;;10,0;;;;10,0;;;1,0;;;1,0;;;;8,0;;29,0;80,0;;;62,0;;;21,0;;;4,0;;;;3,0;;;;;;;;;20,0;40,0;;3,0;;1,0;;;;2,0;;5,0;2,0;;;61,0;31,0;2,0;;3,0;4,0;10,0;20,0;20,0;;3,0;;;;30,0;;;14,0;4,0;;35,0;17,0;;;;18,0;95,0;3,0;2,0;;24,0;;;53,0;5,0;;104,0;13,0;;;;7,0;4,0;13,0;;;;;;22,0;6,0;2,0;2,0;28,0;;;6,0;;;4,0;;5,0;;3,0;43,0;6,0;18,0;;;4,0;;;5,0;;5,0;;2,0;15,0;;114,0;85,0;2,0;38,0;4,0;19,0;;;;1,0;;1,0;2,0;12,0;25,0;9,0;;31,0;;1,0;;40,0;;;;2,0;;24,0;;10,0;15,0;54,0;;11,0;;;6,0;9,0;3,0;;;;1,0;6,0;12,0;;;2,0;2,0;3,0;;;6,0;;;;;;;;;;;1,0;;;3,0;3,0;4,0;2,0;14,0;9,0;55,0;6,0;3,0;;3,0;10,0;;;4,0;172,0;;;2,0;7,0;;1,0;;4,0;1,0;1,0;5,0;3,0;15,0;1,0;2,0;9,0;23,0;2,0;1,0;;10,0;23,0;;;3,0;7,0;11,0;4,0;1,0;18,0;;;;;1,0;14,0;;;;1,0;;1,0;;1,0;1,0;1,0;;;3,0;7,0;;2,0;1,0;;2,0;;;3,0;3,0;5,0;1,0;;5,0;;9,0;2,0;2,0;;;3,0;;7,0;;13,0;15,0;;5,0;;;;;;;;;;;7,0;;;;;;4,0;3,0;1,0;2,0;2,0;;;;;;;;;;;;;;;2,0;;2,0;;;1,0;;;;14,0;;;;27,0;;;1,0;;;;;;;;;5,0;;;;;;;;;;;;;;;;;;;;7,0;;3,0;;;3,0;;19,0;;;;;4,0;2,0;1,0;;;;5,0;;;2,0;;;6,0;6,0;;;7,0;3,0;;11,0;;2,0;;;1,0;;4,0;;2,0;;26,0;;;;;;;;;;;2,0;10,0;3,0;;;;;2,0;1,0;;10,0;;34,0;3,0;;;;;6,0;;;;;;;;;5,0;;;35,0;;;;;;4,0;;;;;3,0;;;2,0;2,0;7,0;;;;62,0;21,0;;;;;1,0;2,0;1,0;3,0;;5,0;5,0;;;2,0;10,0;;8,0;4,0;;;;;;;;;;1,0;2,0;1,0;4,0;;;;;;4,0;;6,0;;2,0;5,0;9,0;;;;5,0;;2,0;;;;;;;2,0;2,0;4,0;18,0;;18,0;5,0;4,0;;;;;;;60,0;4,0;;;;12,0;3,0;;;;8,0;;;;;1,0;;;;;2,0;;;;;11,0;1,0;;;;;14,0;6,0;;;;1,0;;4,0;;;;5,0;6,0;2,0;;33,0;;;;;;;;;;;;11,0;;;;4,0;1,0;2,0;;;;;2,0;16,0;4,0;3,0;3,0;;;1,0;;;;;;11,0;14,0;;;;3,0;;;;;;;;;;;;;;;;;;;7,0;;;;;;;;;1,0;;;;;6,0;;;;2,0;;;;;;;;;;7,0;;;;;;;;;;;;;;;;;;;;1,0;;;;;;;;;;;;;;;;;;;3,0;1,0;1,0;;;;;;;;;;;;1,0;;;;7,0;;;;;;;2,0;;;;;;;26,0;;;;9,0;;;4,0;;;;;;1,0;;;;;;;;;;;;;;;;;;1,0;;2,0;;;;;;;;1,0;4,0;;;;2,0;;1,0;;;1,0;;;;;;;;3,0;4,0;;;;;;;;;;1,0;;;;;;;;;9,0;3,0;8,0;2,0;;2,0;3,0;;;;;;4,0;;1,0;1,0;;;;2,0;5,0;;;;;;;;;;;;5,0;;3,0;;;;;;;;;;;;;;;;;;;;;29,0;1,0;;;;;;;;;;;;2,0;;;;;;;;;;;;;1,0;;;;;;;;;;;;;;;;;;;;;27,0;;;;9,0;;;;;;;;;;;;;;;;;;;;;;;;
consist;;2,0;3,0;;9,0;;1,0;5,0;3,0;3,0;;31,0;;2,0;8,0;14,0;;;19,0;3,0;3,0;7,0;2,0;;4,0;;7,0;34,0;27,0;3,0;2,0;2,0;38,0;1,0;15,0;2,0;;1,0;;4,0;1,0;1,0;1,0;83,0;;;;1,0;1,0;1,0;11,0;2,0;1,0;448,0;;75,0;9,0;2,0;;194,0;;;15,0;3,0;16,0;;1,0;;;2,0;15,0;3,0;;1,0;;4,0;;10,0;19,0;3,0;;5,0;2,0;;;1,0;2,0;1,0;2,0;373,0;24,0;;;15,0;7,0;3,0;;4,0;3,0;3,0;2,0;34,0;;3,0;;2,0;8,0;54,0;;;;2,0;5,0;8,0;1,0;1,0;;4,0;;8,0;;;;1,0;3,0;;;;;1,0;;1,0;1,0;;;3,0;2,0;;;6,0;;4,0;;;2,0;;4,0;25,0;;2,0;4,0;;2,0;2,0;;;;4,0;2,0;2,0;;1,0;1,0;;;13,0;2,0;30,0;;30,0;16,0;5,0;12,0;7,0;4,0;;1,0;;;;;1,0;;;;1,0;2,0;30,0;;9,0;1,0;;;;3,0;;3,0;;;;;2,0;;61,0;2,0;1,0;;;8,0;5,0;3,0;3,0;;;;5,0;;1,0;;1,0;2,0;4,0;;2,0;3,0;2,0;;;;;;;2,0;11,0;;7,0;;;8,0;;3,0;;2,0;2,0;1,0;1,0;6,0;2,0;;;1,0;1,0;3,0;4,0;;;;;;;;;16,0;1,0;;;3,0;;;5,0;4,0;5,0;;;2,0;4,0;6,0;;2,0;5,0;4,0;3,0;;5,0;3,0;8,0;;18,0;;;;;;19,0;;;;;;;1,0;;2,0;;;;;2,0;10,0;;2,0;;;;2,0;;;;5,0;;;1,0;;;;4,0;6,0;7,0;1,0;;6,0;;10,0;;;;2,0;;;;;;;;;6,0;;2,0;;10,0;1,0;1,0;;;7,0;;;;;;;2,0;;;1,0;;1,0;;;3,0;;;;4,0;4,0;1,0;1,0;3,0;;;;;;;2,0;3,0;1,0;;;1,0;1,0;;;;5,0;1,0;;21,0;9,0;;3,0;;;;3,0;1,0;3,0;24,0;5,0;;;;;;;1,0;6,0;;1,0;6,0;1,0;;1,0;5,0;;3,0;;2,0;1,0;1,0;1,0;;1,0;;;;6,0;;2,0;1,0;10,0;2,0;3,0;;10,0;2,0;;1,0;;2,0;;1,0;20,0;1,0;;8,0;;;;;;9,0;;;;1,0;;;6,0;;;;6,0;;7,0;;1,0;5,0;;4,0;;;;;1,0;;3,0;;;3,0;;;;;14,0;2,0;;;;;;;4,0;;;3,0;4,0;;;;2,0;;;;;7,0;;1,0;;;;;2,0;1,0;;;;;;;3,0;;;;2,0;1,0;;;;1,0;;;;1,0;;;1,0;;;;;1,0;14,0;;;;;;;1,0;9,0;;;;;;5,0;;;3,0;;1,0;;3,0;3,0;;1,0;;;1,0;;1,0;12,0;;;;2,0;;;;4,0;2,0;10,0;;13,0;2,0;;;;;;;1,0;;;;;;;;;;;;;3,0;;;1,0;;;4,0;;;;1,0;;1,0;;;;2,0;;;;3,0;;;;;1,0;;18,0;;;;1,0;;1,0;;;3,0;1,0;;;;;;1,0;;2,0;;;1,0;;1,0;;1,0;;;;;;3,0;;;;;;8,0;;1,0;;;9,0;2,0;;;;;;1,0;;;6,0;;2,0;;2,0;;;;;;;;;;;1,0;;;;;;;;;;;3,0;;5,0;;;;;12,0;1,0;;2,0;;;;;;;;;;1,0;3,0;;1,0;;;1,0;1,0;;;;;;;;2,0;;2,0;;;;2,0;2,0;;;;;;;;;4,0;;;;1,0;4,0;;1,0;;2,0;;;3,0;;;;;;;;1,0;1,0;9,0;;;;;;;3,0;;;;;;;;5,0;;1,0;1,0;;2,0;;;1,0;;;;;;;;1,0;1,0;;;;;;1,0;1,0;;;;;;;1,0;;;;;1,0;;;;1,0;;;;;2,0;;;;;;3,0;;;;4,0;13,0;;;;1,0;2,0;;;1,0;;1,0;;;;;;;;;;;1,0;;2,0;;6,0;;1,0;;;6,0;1,0;;;;2,0;1,0;;3,0;3,0;;;;;;1,0;1,0;;;;;1,0;;1,0;;;;;;;1,0;;;;;;;;;;2,0;;1,0;;;1,0;;;1,0;;;;;4,0;;;;;;1,0;;1,0;6,0;;;4,0;;3,0;1,0;;;7,0;;1,0;;;;;;;;;;1,0;;;;;;;;1,0;;;;;;;;;3,0;;;;;
constitute;;1,0;;;3,0;15,0;5,0;5,0;;10,0;;6,0;;;12,0;3,0;2,0;;3,0;4,0;;;3,0;3,0;2,0;;1,0;23,0;;5,0;1,0;;15,0;;28,0;3,0;;22,0;;8,0;;;2,0;103,0;;;;;2,0;;;7,0;;17,0;;82,0;16,0;;8,0;201,0;;;2,0;;;;9,0;;;1,0;44,0;;4,0;;1,0;4,0;;3,0;8,0;1,0;1,0;3,0;3,0;;;;24,0;;;;3,0;;5,0;20,0;;;;;;5,0;30,0;44,0;;3,0;;;2,0;89,0;;;;2,0;1,0;1,0;1,0;;;;2,0;11,0;;;1,0;3,0;3,0;;6,0;4,0;1,0;;7,0;;1,0;4,0;1,0;;6,0;;2,0;;;;2,0;5,0;6,0;;5,0;23,0;;2,0;;2,0;2,0;;1,0;;2,0;5,0;;12,0;1,0;;;1,0;;14,0;2,0;25,0;;5,0;27,0;2,0;12,0;;;2,0;;8,0;;;2,0;1,0;1,0;;;1,0;5,0;36,0;;26,0;;;;2,0;;6,0;3,0;;2,0;;8,0;4,0;;20,0;;;;;4,0;9,0;;;2,0;3,0;;;;6,0;;;8,0;;;;12,0;2,0;;;;1,0;;;2,0;28,0;5,0;3,0;;3,0;5,0;;3,0;;7,0;2,0;;;;1,0;;4,0;;;;;;;;1,0;;;1,0;5,0;;;;1,0;;;;;4,0;3,0;;;;;;;;2,0;;3,0;;3,0;;;31,0;9,0;;;;3,0;;7,0;1,0;;;;;;;1,0;3,0;;;1,0;;7,0;;1,0;2,0;11,0;;;;1,0;;;;2,0;;;5,0;;;15,0;;;1,0;;5,0;;1,0;;;;;;;;;;;3,0;;;3,0;;;;;;;;;;;2,0;;;;;;;;3,0;;;2,0;2,0;;;;;2,0;;;;;1,0;2,0;2,0;;;7,0;;;;;5,0;;;2,0;;;;;4,0;1,0;2,0;;;;;3,0;;;10,0;;;2,0;;;7,0;;3,0;;;;;;;;;2,0;;;3,0;;1,0;2,0;;;;;5,0;;;;2,0;;;;;;;;;;2,0;;;5,0;;;;;;2,0;;;;;;;;14,0;;;;;3,0;;;;;1,0;1,0;;;;;;;2,0;;;1,0;;;;1,0;;;;1,0;;3,0;;2,0;;;;;6,0;1,0;;3,0;;;;;;;2,0;4,0;;;;;;1,0;;;;;;;;;;;;;8,0;;1,0;;;;;;;;1,0;;2,0;;;;1,0;1,0;1,0;;2,0;;;;;13,0;35,0;;3,0;;;;1,0;1,0;;;;;;;;;;;;;;;8,0;2,0;;7,0;;1,0;;;;;;;;;;;;;;;;;;;6,0;5,0;;;;2,0;;;;;1,0;;1,0;;2,0;;3,0;1,0;2,0;;;;3,0;;;2,0;;;;2,0;;;;;;4,0;2,0;1,0;;;;;;;;13,0;;;;4,0;;;;;;;;1,0;;;;;;;;;;2,0;12,0;;;;;;2,0;3,0;;10,0;;;;2,0;1,0;;;;2,0;;;;;4,0;;;;;;;;;8,0;1,0;;4,0;;;;;;;12,0;;;;6,0;;;;;;;;;;1,0;3,0;2,0;;;;;;;;;;;1,0;;;;;;;;;;;1,0;;;2,0;;;;;;;;;;;;1,0;;;;;;;;;1,0;;;;;;1,0;1,0;;;;;8,0;;;;;;;3,0;;;;;;;;;;;;;4,0;2,0;;;1,0;;;;;;;;;;;1,0;;;7,0;;3,0;1,0;7,0;;;;;;;;;;;;;5,0;;;;3,0;2,0;;;;;;;;;;;;;1,0;;;;;;;1,0;;1,0;;1,0;;;;;;;;;;;;;;;;;;;;;;;;;;;;;;;;;;;;;;;;;;;;;;1,0;5,0;;;;;;;;;;;;;;;5,0;;;;;3,0;;;;;16,0;;;;;2,0;;;;2,0;;;;2,0;;;;;;;;;;;;;;;;2,0;;;;;;;;;;;;;;;1,0;2,0;;;;4,0;2,0;;;
contact;;2,0;;;14,0;;21,0;55,0;;14,0;1,0;;2,0;3,0;;;;;12,0;6,0;3,0;37,0;2,0;;;;7,0;14,0;;12,0;5,0;4,0;99,0;;22,0;;23,0;37,0;;15,0;6,0;;11,0;53,0;1,0;;2,0;3,0;4,0;;1,0;3,0;;11,0;2,0;81,0;60,0;;5,0;249,0;;;20,0;;;32,0;15,0;;;12,0;60,0;;1,0;67,0;7,0;1,0;3,0;77,0;156,0;13,0;14,0;6,0;;;;;44,0;1,0;4,0;9,0;30,0;;1,0;35,0;;9,0;;;4,0;62,0;448,0;27,0;3,0;19,0;1,0;3,0;6,0;109,0;2,0;1,0;13,0;34,0;6,0;25,0;7,0;;16,0;1,0;26,0;56,0;3,0;2,0;;37,0;1,0;;71,0;;;16,0;24,0;1,0;;4,0;5,0;26,0;64,0;2,0;47,0;11,0;;;36,0;51,0;9,0;6,0;116,0;36,0;1,0;5,0;;26,0;25,0;8,0;11,0;21,0;12,0;70,0;14,0;28,0;2,0;3,0;58,0;16,0;;28,0;;24,0;1,0;9,0;357,0;25,0;118,0;63,0;16,0;36,0;45,0;3,0;7,0;;16,0;5,0;;8,0;5,0;5,0;68,0;116,0;;360,0;1,0;23,0;;29,0;2,0;4,0;1,0;4,0;22,0;3,0;28,0;7,0;2,0;58,0;1,0;1,0;8,0;16,0;20,0;85,0;;10,0;15,0;1,0;13,0;4,0;17,0;19,0;;2,0;13,0;1,0;;;37,0;;5,0;3,0;;14,0;;5,0;15,0;38,0;1,0;5,0;17,0;16,0;55,0;10,0;52,0;7,0;8,0;34,0;5,0;9,0;6,0;15,0;;7,0;1,0;;35,0;102,0;4,0;;15,0;16,0;;4,0;2,0;19,0;10,0;21,0;27,0;20,0;51,0;4,0;8,0;18,0;13,0;17,0;43,0;;3,0;18,0;2,0;3,0;6,0;14,0;8,0;11,0;1,0;7,0;2,0;;18,0;15,0;14,0;35,0;;;2,0;15,0;;4,0;3,0;1,0;7,0;16,0;10,0;4,0;14,0;10,0;15,0;24,0;4,0;3,0;19,0;3,0;4,0;15,0;;7,0;14,0;18,0;8,0;5,0;12,0;6,0;2,0;10,0;8,0;33,0;2,0;3,0;18,0;37,0;4,0;;38,0;;;;;;;1,0;1,0;;;3,0;;;;1,0;;;;8,0;7,0;;;;;;;;2,0;2,0;;;1,0;1,0;2,0;4,0;;;;;;12,0;;;;2,0;;;;18,0;;6,0;1,0;;;;;;;20,0;9,0;4,0;3,0;;15,0;;;3,0;;;;;;1,0;;;;;;;7,0;12,0;2,0;;23,0;1,0;3,0;;2,0;;6,0;2,0;2,0;6,0;1,0;1,0;;2,0;;4,0;;;;;;8,0;;;;1,0;15,0;;;;;4,0;8,0;3,0;;2,0;;;1,0;15,0;;;4,0;;;;;28,0;;;;1,0;53,0;;;;12,0;3,0;;;;;12,0;;;;;;;1,0;;17,0;7,0;10,0;;4,0;;21,0;;7,0;7,0;1,0;3,0;4,0;;;;3,0;;;3,0;2,0;;;;6,0;10,0;19,0;2,0;;5,0;37,0;5,0;2,0;;;2,0;12,0;;;;;8,0;3,0;;1,0;;;14,0;;;;1,0;2,0;;;;3,0;;6,0;8,0;;;;;;;;6,0;;3,0;2,0;4,0;;1,0;;5,0;4,0;;;9,0;1,0;15,0;;1,0;4,0;2,0;;;;9,0;2,0;2,0;;3,0;;;;3,0;;;158,0;4,0;;;;5,0;4,0;;;3,0;9,0;1,0;;;;;;;3,0;;;7,0;10,0;;;14,0;19,0;;;;;;1,0;1,0;;;;2,0;1,0;;3,0;;2,0;10,0;4,0;;23,0;2,0;;2,0;14,0;1,0;;;;2,0;;14,0;;3,0;2,0;;4,0;;;;16,0;;1,0;5,0;4,0;4,0;;5,0;;1,0;5,0;1,0;1,0;1,0;;;6,0;25,0;1,0;;;;;4,0;;;;;;4,0;;;;;;5,0;2,0;;7,0;;16,0;1,0;;;5,0;3,0;5,0;;;;;;4,0;;3,0;;;;;;11,0;;;;;1,0;;;6,0;16,0;;1,0;;;;;;;;;;;1,0;;1,0;;;;1,0;;;;;10,0;;;;;;4,0;;;2,0;;;;;1,0;2,0;;;5,0;;;1,0;1,0;;;;;;5,0;3,0;;14,0;;8,0;1,0;;;;;6,0;;;;;;;;;;;4,0;2,0;;11,0;;17,0;;;;;;;;;4,0;;;4,0;;;2,0;;;;;;;;1,0;;;;;;3,0;;1,0;6,0;;;;1,0;1,0;9,0;;;;;11,0;;;2,0;4,0;;;2,0;3,0;;;;;;;;7,0;;;;6,0;24,0;;;21,0;5,0;;2,0;2,0;1,0;6,0;;18,0;;;;;;;1,0;4,0;8,0;1,0;8,0;8,0;2,0;;1,0;;;;;;;;;6,0;;;5,0;3,0;3,0;1,0;;1,0;;;;;;;;;;;;5,0;;;;;;1,0;1,0;;;;;;;;;;1,0;;;;2,0;;;;;;;;;;;5,0;;14,0;5,0;;4,0;;;8,0;;;;;;;4,0;;;;;6,0;1,0;2,0;;12,0;5,0;;;;1,0;;;2,0;;1,0;1,0;10,0;;;;;;;;;14,0;;;;
controller;;1,0;20,0;7,0;87,0;;25,0;33,0;23,0;77,0;1,0;2,0;3,0;1,0;17,0;;5,0;4,0;25,0;12,0;23,0;541,0;29,0;6,0;36,0;;1,0;156,0;7,0;58,0;42,0;98,0;231,0;2,0;81,0;9,0;8,0;83,0;1,0;265,0;15,0;;105,0;30,0;7,0;22,0;;6,0;153,0;11,0;49,0;68,0;;3,0;;393,0;142,0;1,0;8,0;186,0;;53,0;50,0;6,0;1,0;36,0;26,0;;4,0;149,0;17,0;4,0;5,0;1,0;1,0;6,0;;19,0;158,0;27,0;3,0;30,0;33,0;10,0;1,0;1,0;19,0;;;53,0;91,0;1,0;7,0;229,0;11,0;6,0;1,0;16,0;58,0;13,0;22,0;312,0;2,0;18,0;;14,0;1,0;119,0;;;25,0;39,0;43,0;37,0;12,0;5,0;;;4,0;116,0;;;17,0;50,0;;1,0;311,0;4,0;10,0;77,0;3,0;2,0;5,0;;4,0;62,0;4,0;;;22,0;1,0;3,0;42,0;26,0;7,0;;18,0;33,0;9,0;;;;;;31,0;1,0;2,0;33,0;18,0;110,0;2,0;4,0;;2,0;3,0;;8,0;99,0;;;12,0;19,0;45,0;25,0;48,0;4,0;2,0;95,0;;;16,0;;2,0;1,0;2,0;4,0;1,0;92,0;;37,0;;;3,0;107,0;1,0;6,0;;;20,0;;;;2,0;15,0;;5,0;4,0;;2,0;21,0;14,0;2,0;6,0;1,0;9,0;74,0;51,0;;2,0;;;4,0;1,0;;;1,0;;;;;;1,0;32,0;2,0;82,0;14,0;;21,0;29,0;14,0;10,0;;32,0;;2,0;3,0;11,0;;;6,0;5,0;1,0;;78,0;;;;40,0;6,0;;5,0;69,0;1,0;;1,0;;;;;;1,0;3,0;;2,0;;62,0;;;15,0;7,0;;;1,0;65,0;;42,0;52,0;59,0;50,0;1,0;5,0;;1,0;4,0;;;;30,0;1,0;;10,0;;46,0;1,0;7,0;;;17,0;;;26,0;18,0;;;3,0;;;;;;;11,0;;;;28,0;;;43,0;;54,0;14,0;1,0;;;4,0;;6,0;4,0;2,0;;11,0;1,0;9,0;27,0;11,0;1,0;11,0;;52,0;1,0;48,0;6,0;1,0;;1,0;;;2,0;;5,0;2,0;;;12,0;13,0;4,0;5,0;19,0;;4,0;;5,0;14,0;12,0;86,0;4,0;1,0;;6,0;3,0;20,0;;25,0;10,0;8,0;6,0;9,0;5,0;55,0;;19,0;6,0;;34,0;37,0;19,0;18,0;8,0;;14,0;1,0;2,0;;5,0;3,0;41,0;27,0;4,0;34,0;;25,0;;6,0;6,0;15,0;2,0;;94,0;;11,0;12,0;8,0;10,0;90,0;;;29,0;1,0;8,0;6,0;1,0;;;1,0;8,0;6,0;;6,0;6,0;12,0;1,0;7,0;2,0;5,0;;11,0;7,0;5,0;12,0;;30,0;27,0;49,0;;8,0;6,0;6,0;13,0;;;4,0;2,0;4,0;7,0;41,0;13,0;2,0;14,0;;;61,0;2,0;7,0;19,0;;8,0;4,0;11,0;;5,0;3,0;5,0;17,0;;16,0;15,0;7,0;16,0;13,0;2,0;70,0;22,0;27,0;111,0;30,0;3,0;19,0;;4,0;7,0;11,0;2,0;9,0;12,0;2,0;2,0;;2,0;3,0;;22,0;1,0;34,0;51,0;16,0;;1,0;;3,0;1,0;;2,0;;1,0;16,0;52,0;;1,0;1,0;2,0;;8,0;;4,0;10,0;;13,0;6,0;1,0;;3,0;;;;19,0;14,0;7,0;2,0;7,0;1,0;5,0;;4,0;23,0;;22,0;31,0;;9,0;48,0;;3,0;3,0;;;7,0;;;8,0;7,0;27,0;4,0;7,0;2,0;2,0;3,0;1,0;;;1,0;;13,0;;4,0;7,0;;12,0;3,0;5,0;34,0;;1,0;15,0;2,0;28,0;;;2,0;;2,0;3,0;54,0;;1,0;1,0;11,0;1,0;1,0;;;1,0;;1,0;;;68,0;;;2,0;5,0;;2,0;5,0;2,0;;;;4,0;;;5,0;6,0;26,0;4,0;1,0;6,0;1,0;1,0;;;2,0;;;;7,0;1,0;3,0;;;2,0;;;;;1,0;;;2,0;4,0;13,0;;2,0;;;6,0;44,0;;;6,0;;;4,0;;6,0;;;3,0;;2,0;;;;7,0;;5,0;;1,0;7,0;;;27,0;3,0;;8,0;;6,0;4,0;6,0;2,0;2,0;1,0;5,0;1,0;3,0;1,0;;1,0;12,0;16,0;14,0;11,0;3,0;12,0;1,0;1,0;;11,0;2,0;;4,0;3,0;;;;;;1,0;;5,0;11,0;17,0;20,0;4,0;;;8,0;3,0;4,0;;2,0;11,0;20,0;4,0;;1,0;3,0;5,0;5,0;4,0;;;;3,0;;2,0;3,0;9,0;;5,0;25,0;4,0;;5,0;1,0;;;2,0;;1,0;11,0;1,0;2,0;;;4,0;2,0;1,0;24,0;6,0;2,0;;;;;1,0;53,0;;;12,0;8,0;;;17,0;17,0;;3,0;3,0;1,0;2,0;15,0;;;2,0;;1,0;;3,0;3,0;2,0;;;;22,0;;7,0;;;;;9,0;3,0;10,0;;;;;;6,0;4,0;;;5,0;;;;;;9,0;5,0;3,0;1,0;;2,0;8,0;3,0;;2,0;;;1,0;8,0;7,0;1,0;1,0;;6,0;1,0;;;3,0;10,0;;;;1,0;6,0;;8,0;;;;1,0;4,0;1,0;;17,0;;;1,0;;;1,0;10,0;;;;;;6,0;;1,0;1,0;2,0;;1,0;;;4,0;15,0;;;;;;2,0;;12,0;10,0;;1,0;1,0;1,0;;;;;;;;3,0;;1,0;;6,0;;;;1,0;;6,0;;1,0;;3,0;11,0;;;;;;;;;;;;1,0;;;;;;;;;1,0;;;5,0;;;;;;;;2,0;1,0;3,0;;1,0;1,0;;;;10,0;;;;;1,0;;;;;;;;1,0;;;;;2,0;;;;;
conversion;;4,0;17,0;1,0;46,0;;5,0;75,0;32,0;10,0;1,0;89,0;;52,0;71,0;2,0;;;18,0;1,0;3,0;59,0;14,0;5,0;20,0;;10,0;125,0;;13,0;20,0;24,0;232,0;7,0;56,0;3,0;3,0;18,0;;27,0;;;7,0;263,0;;1,0;;20,0;17,0;7,0;14,0;93,0;2,0;28,0;;368,0;176,0;4,0;4,0;29,0;6,0;;34,0;;1,0;1,0;10,0;;3,0;37,0;21,0;1,0;23,0;6,0;;17,0;2,0;19,0;8,0;18,0;;137,0;4,0;12,0;18,0;;128,0;;1,0;13,0;26,0;2,0;9,0;273,0;31,0;14,0;;38,0;23,0;29,0;34,0;43,0;;81,0;;;23,0;580,0;1,0;;;47,0;23,0;;6,0;2,0;21,0;;;16,0;;;;71,0;;;35,0;8,0;;7,0;1,0;;;;1,0;;28,0;;31,0;;15,0;;1,0;6,0;3,0;8,0;60,0;3,0;21,0;;1,0;;2,0;;15,0;;;;3,0;89,0;23,0;6,0;2,0;;;39,0;;126,0;;3,0;34,0;1,0;19,0;4,0;2,0;4,0;1,0;134,0;;;;3,0;5,0;;;14,0;;123,0;2,0;54,0;1,0;;;22,0;;;;6,0;6,0;;27,0;4,0;1,0;15,0;;;;;6,0;;;;;1,0;;8,0;9,0;1,0;;1,0;2,0;;13,0;;1,0;3,0;;;;;;;7,0;14,0;7,0;;1,0;2,0;28,0;;3,0;;3,0;;;;5,0;5,0;;;8,0;18,0;3,0;10,0;;;7,0;3,0;4,0;;2,0;15,0;1,0;8,0;;;1,0;;;;;;;1,0;;;1,0;;1,0;12,0;;;;8,0;;2,0;1,0;9,0;1,0;3,0;;2,0;3,0;5,0;;1,0;841,0;2,0;;;1,0;;17,0;;;;;6,0;;;73,0;5,0;;;;;;3,0;;;;;;;5,0;3,0;;;10,0;;1,0;;;;;74,0;1,0;;2,0;;;6,0;1,0;1,0;;3,0;19,0;6,0;;4,0;5,0;;;1,0;;;4,0;;;5,0;2,0;;;9,0;1,0;;;;;;1,0;;;2,0;14,0;9,0;6,0;1,0;;6,0;11,0;86,0;;1,0;2,0;;;14,0;;67,0;;3,0;2,0;;2,0;2,0;2,0;9,0;3,0;;;;2,0;1,0;;;;3,0;;2,0;;;102,0;2,0;;;;;26,0;;3,0;;;;20,0;;;25,0;56,0;;2,0;6,0;;;1,0;;38,0;;;;;;1,0;6,0;;11,0;;136,0;;2,0;;118,0;6,0;1,0;;6,0;;;2,0;;1,0;;;;;2,0;2,0;;1,0;;;177,0;;;;;;;;;4,0;;;;;1,0;1,0;;5,0;54,0;;19,0;6,0;;21,0;7,0;;18,0;;1,0;1,0;;;;6,0;1,0;;;;;;;;3,0;2,0;;;;;;;;;;;;;;1,0;2,0;;;1,0;;;13,0;;;;;;3,0;;;;;;;;;1,0;;;;;4,0;12,0;;;;228,0;13,0;;;;;3,0;;;;;;1,0;;;;;1,0;;;;;20,0;1,0;;;2,0;6,0;6,0;;2,0;;;;11,0;118,0;;;;;;;12,0;;;;;2,0;;;;;;;;;;;2,0;;25,0;;;6,0;13,0;;;;6,0;;;8,0;;3,0;;;12,0;;;;;5,0;1,0;;;;;;;2,0;1,0;23,0;;;;;8,0;3,0;;;2,0;;;;;;2,0;;;;;;;4,0;17,0;;1,0;6,0;22,0;;4,0;29,0;;3,0;;17,0;3,0;;3,0;29,0;;40,0;;4,0;8,0;30,0;7,0;4,0;;;;;4,0;;;;1,0;;;62,0;7,0;;;17,0;;;35,0;;;;;;2,0;17,0;;;1,0;1,0;;;1,0;1,0;;3,0;;;5,0;;;;;1,0;;9,0;1,0;3,0;1,0;1,0;;;;;;3,0;;;;1,0;1,0;;;;;;;;7,0;24,0;8,0;;2,0;;;;;6,0;5,0;3,0;;;;;;;;;;;;;1,0;;;1,0;2,0;;;;3,0;;;;;;2,0;;;;1,0;;1,0;;5,0;5,0;;;;1,0;;;12,0;;2,0;;;;;;;;;1,0;1,0;;;;;1,0;;;;1,0;6,0;;;;6,0;1,0;;;;;1,0;;;;;;;;;;;;;;;;;;1,0;1,0;;;;1,0;1,0;;1,0;1,0;1,0;;;;;6,0;;;7,0;;;;;5,0;1,0;1,0;4,0;;;;;1,0;;;;;;;;19,0;;;;;;;;;;;1,0;1,0;;;1,0;;;;;;;;;;1,0;;3,0;;;;;;;43,0;;;1,0;;;;10,0;;;;;;3,0;6,0;;;;;;;;;;;;;;;;;;;;;1,0;;;;;;;;;;;;1,0;5,0;;;;;;;;
couple;;4,0;2,0;6,0;70,0;;33,0;165,0;2,0;66,0;26,0;1,0;;1,0;14,0;4,0;;1,0;50,0;36,0;;114,0;;1,0;4,0;;1,0;47,0;3,0;4,0;9,0;18,0;338,0;;78,0;;3,0;26,0;2,0;117,0;9,0;3,0;61,0;125,0;1,0;2,0;6,0;10,0;24,0;2,0;41,0;23,0;2,0;20,0;3,0;325,0;138,0;;10,0;299,0;8,0;;74,0;3,0;4,0;103,0;17,0;2,0;4,0;6,0;54,0;2,0;3,0;19,0;7,0;;3,0;22,0;49,0;41,0;3,0;92,0;178,0;2,0;;;7,0;2,0;1,0;12,0;221,0;;;58,0;12,0;8,0;1,0;22,0;19,0;126,0;108,0;163,0;8,0;9,0;1,0;2,0;13,0;250,0;1,0;2,0;45,0;13,0;64,0;107,0;7,0;;2,0;7,0;58,0;147,0;18,0;7,0;1,0;134,0;4,0;;119,0;16,0;;;29,0;2,0;4,0;4,0;2,0;39,0;37,0;12,0;5,0;2,0;7,0;2,0;41,0;11,0;39,0;18,0;42,0;71,0;2,0;3,0;7,0;22,0;62,0;3,0;2,0;62,0;50,0;203,0;16,0;96,0;3,0;;29,0;3,0;1,0;11,0;6,0;74,0;1,0;2,0;188,0;7,0;248,0;183,0;13,0;;24,0;45,0;4,0;5,0;6,0;3,0;13,0;;23,0;7,0;102,0;103,0;;258,0;1,0;9,0;6,0;69,0;2,0;4,0;2,0;3,0;42,0;27,0;12,0;10,0;5,0;82,0;1,0;4,0;3,0;6,0;55,0;102,0;7,0;1,0;2,0;4,0;67,0;14,0;17,0;20,0;;7,0;41,0;23,0;1,0;1,0;2,0;;11,0;;;1,0;1,0;10,0;44,0;12,0;10,0;42,0;19,0;4,0;10,0;3,0;78,0;10,0;5,0;21,0;56,0;6,0;25,0;8,0;6,0;13,0;9,0;2,0;3,0;75,0;;1,0;6,0;6,0;2,0;2,0;1,0;28,0;10,0;10,0;14,0;1,0;30,0;7,0;2,0;1,0;26,0;24,0;26,0;1,0;11,0;38,0;;18,0;1,0;13,0;12,0;18,0;5,0;104,0;22,0;7,0;15,0;10,0;6,0;12,0;8,0;;3,0;13,0;1,0;;2,0;5,0;1,0;1,0;8,0;9,0;9,0;2,0;17,0;1,0;26,0;4,0;30,0;;8,0;14,0;;3,0;28,0;;32,0;12,0;15,0;5,0;2,0;31,0;72,0;34,0;;35,0;5,0;17,0;10,0;5,0;26,0;;40,0;;4,0;;;;;;3,0;9,0;;1,0;1,0;8,0;;1,0;11,0;6,0;2,0;2,0;25,0;3,0;;;3,0;;;1,0;1,0;;;;4,0;;1,0;;11,0;;;9,0;;3,0;6,0;77,0;;6,0;;5,0;1,0;5,0;1,0;3,0;;;1,0;2,0;;18,0;6,0;;2,0;;36,0;;;1,0;2,0;;6,0;;2,0;;1,0;;3,0;2,0;5,0;10,0;1,0;15,0;3,0;3,0;9,0;9,0;3,0;;47,0;9,0;7,0;7,0;;29,0;4,0;7,0;;20,0;;2,0;1,0;;8,0;5,0;;1,0;7,0;1,0;5,0;5,0;2,0;1,0;3,0;48,0;6,0;77,0;7,0;8,0;;9,0;1,0;8,0;11,0;9,0;;1,0;1,0;;10,0;;;;1,0;;33,0;9,0;21,0;6,0;4,0;;2,0;16,0;34,0;1,0;10,0;3,0;33,0;4,0;1,0;1,0;1,0;;;1,0;;36,0;4,0;5,0;3,0;5,0;3,0;38,0;6,0;12,0;72,0;19,0;;7,0;;;2,0;1,0;1,0;5,0;20,0;20,0;;9,0;;12,0;6,0;;;3,0;23,0;28,0;104,0;;;;21,0;23,0;1,0;;;;17,0;8,0;;;9,0;;3,0;;;6,0;1,0;2,0;5,0;;;;3,0;3,0;10,0;;156,0;3,0;1,0;1,0;;9,0;6,0;3,0;47,0;;14,0;4,0;;;25,0;;9,0;;21,0;;6,0;;;2,0;;3,0;3,0;1,0;3,0;;9,0;;2,0;65,0;;3,0;2,0;;;33,0;12,0;1,0;;3,0;21,0;20,0;3,0;3,0;14,0;71,0;2,0;;1,0;2,0;13,0;1,0;2,0;1,0;21,0;1,0;1,0;5,0;18,0;8,0;7,0;3,0;1,0;;;;11,0;1,0;15,0;;3,0;10,0;;2,0;3,0;1,0;1,0;14,0;12,0;3,0;;51,0;26,0;15,0;8,0;16,0;5,0;46,0;44,0;24,0;5,0;;3,0;19,0;;;;2,0;;2,0;;1,0;2,0;28,0;12,0;9,0;;4,0;11,0;;2,0;;;;8,0;4,0;;1,0;7,0;;5,0;;2,0;;5,0;5,0;2,0;;;;16,0;8,0;;;7,0;48,0;;;;;;2,0;;;;;12,0;1,0;6,0;;3,0;;12,0;;;1,0;;1,0;;7,0;2,0;;;1,0;1,0;;19,0;6,0;;6,0;7,0;4,0;9,0;15,0;;;2,0;;;5,0;5,0;1,0;1,0;;;1,0;;;;6,0;;2,0;4,0;1,0;;;2,0;;;;;;1,0;4,0;;;;4,0;;11,0;;4,0;;;5,0;;;8,0;;;;2,0;3,0;2,0;;39,0;;6,0;;1,0;3,0;2,0;3,0;4,0;;2,0;;;;1,0;;;2,0;;4,0;;;15,0;;;;;;35,0;;2,0;;;2,0;;;;;2,0;4,0;3,0;1,0;3,0;;;;;1,0;9,0;;;;;2,0;3,0;;3,0;3,0;21,0;1,0;2,0;3,0;1,0;18,0;;3,0;;2,0;6,0;5,0;;;;;52,0;3,0;4,0;7,0;;;;17,0;24,0;5,0;;11,0;1,0;6,0;7,0;1,0;;;6,0;9,0;6,0;;1,0;1,0;1,0;7,0;2,0;3,0;;;;;3,0;;8,0;48,0;;1,0;;1,0;6,0;;5,0;;7,0;;2,0;2,0;;;;1,0;11,0;6,0;7,0;;;10,0;;;;5,0;;;;;;;;;2,0;;;;2,0;;1,0;;1,0;2,0;9,0;;;;;1,0;2,0;;;;1,0;;;;5,0;;;;1,0;;;;1,0;;1,0;;2,0;1,0;;;3,0;;;;;;;;;1,0;;4,0;8,0;;;;2,0;25,0;;;1,0;;;;;7,0;;4,0;;;;1,0;;;;;;;;;
cover;;3,0;5,0;;112,0;;26,0;149,0;;18,0;10,0;;;;8,0;2,0;;;12,0;3,0;10,0;23,0;;4,0;4,0;;11,0;20,0;5,0;18,0;10,0;12,0;120,0;;51,0;;;40,0;1,0;38,0;3,0;3,0;12,0;72,0;;;10,0;2,0;16,0;1,0;7,0;8,0;1,0;1,0;3,0;143,0;153,0;;45,0;513,0;8,0;;49,0;;1,0;12,0;32,0;3,0;;14,0;91,0;3,0;39,0;12,0;34,0;2,0;3,0;12,0;215,0;10,0;22,0;10,0;8,0;3,0;2,0;3,0;35,0;2,0;11,0;2,0;63,0;;2,0;17,0;10,0;19,0;4,0;1,0;7,0;77,0;294,0;36,0;;12,0;;;6,0;109,0;;3,0;35,0;32,0;22,0;82,0;84,0;;23,0;;47,0;201,0;10,0;1,0;4,0;40,0;;3,0;104,0;24,0;;29,0;;1,0;;26,0;1,0;11,0;84,0;29,0;12,0;16,0;2,0;2,0;21,0;59,0;18,0;22,0;136,0;24,0;;32,0;;24,0;40,0;1,0;22,0;43,0;99,0;170,0;;109,0;9,0;4,0;82,0;22,0;;62,0;8,0;75,0;;35,0;320,0;7,0;125,0;154,0;20,0;157,0;110,0;2,0;5,0;3,0;30,0;23,0;14,0;;5,0;10,0;184,0;64,0;3,0;223,0;60,0;14,0;;77,0;8,0;;1,0;8,0;20,0;21,0;13,0;69,0;23,0;188,0;6,0;7,0;;1,0;22,0;70,0;4,0;6,0;5,0;;2,0;7,0;6,0;164,0;;9,0;48,0;11,0;1,0;2,0;42,0;;64,0;;1,0;8,0;8,0;;1,0;20,0;17,0;2,0;4,0;18,0;101,0;5,0;48,0;10,0;13,0;57,0;;53,0;;66,0;8,0;2,0;11,0;1,0;5,0;104,0;7,0;3,0;12,0;77,0;1,0;6,0;2,0;5,0;33,0;16,0;47,0;18,0;39,0;6,0;6,0;;9,0;143,0;4,0;2,0;11,0;10,0;1,0;15,0;3,0;12,0;35,0;5,0;1,0;46,0;21,0;23,0;39,0;15,0;22,0;21,0;;;8,0;14,0;1,0;;1,0;5,0;9,0;5,0;19,0;4,0;4,0;9,0;3,0;12,0;;19,0;58,0;47,0;6,0;6,0;3,0;;23,0;2,0;18,0;2,0;2,0;50,0;7,0;13,0;17,0;53,0;;18,0;10,0;9,0;9,0;;6,0;;;;;;;;;;2,0;;;3,0;;2,0;;6,0;16,0;1,0;66,0;;1,0;1,0;;3,0;;;173,0;;;;;1,0;;2,0;;;1,0;;;3,0;;2,0;;;2,0;;;6,0;1,0;7,0;2,0;1,0;1,0;;;;;8,0;3,0;1,0;3,0;5,0;27,0;;;15,0;;;;;3,0;4,0;;;10,0;2,0;;;12,0;21,0;13,0;3,0;;1,0;4,0;;4,0;1,0;7,0;1,0;;6,0;7,0;8,0;;;;1,0;;;1,0;;1,0;9,0;;;4,0;11,0;7,0;7,0;3,0;;2,0;3,0;1,0;4,0;3,0;3,0;2,0;;14,0;33,0;6,0;;2,0;;;;;;1,0;;7,0;47,0;77,0;1,0;28,0;;;11,0;1,0;;9,0;;9,0;1,0;;1,0;;2,0;;;;32,0;9,0;8,0;;8,0;1,0;11,0;1,0;15,0;15,0;61,0;;5,0;6,0;;;;;;47,0;4,0;;1,0;2,0;11,0;35,0;;;2,0;4,0;5,0;13,0;;;;11,0;4,0;2,0;16,0;;1,0;5,0;;;4,0;;;44,0;2,0;;;10,0;5,0;1,0;1,0;;;;7,0;28,0;2,0;;4,0;;;1,0;2,0;19,0;;3,0;10,0;5,0;6,0;3,0;6,0;4,0;3,0;;;4,0;;39,0;;3,0;;2,0;;;;10,0;;12,0;;2,0;;;;11,0;;;35,0;3,0;;;;;49,0;;;6,0;;2,0;2,0;;;;;2,0;;4,0;;3,0;3,0;14,0;6,0;4,0;5,0;5,0;;1,0;;;14,0;7,0;5,0;;1,0;11,0;3,0;;;1,0;8,0;37,0;;;53,0;2,0;20,0;;1,0;;1,0;7,0;2,0;;;9,0;33,0;4,0;;;2,0;4,0;8,0;4,0;19,0;;7,0;11,0;4,0;9,0;7,0;2,0;2,0;4,0;2,0;;5,0;;16,0;3,0;5,0;;;;;16,0;6,0;4,0;;10,0;1,0;;;;;;;;;2,0;;;3,0;;5,0;;;;;2,0;8,0;2,0;;4,0;;;1,0;24,0;4,0;7,0;;1,0;2,0;;2,0;1,0;2,0;;;;1,0;;21,0;6,0;2,0;5,0;;;;;;5,0;;;;4,0;;;2,0;;;;2,0;;6,0;1,0;2,0;;;;;;;10,0;;;2,0;;;;;3,0;18,0;;;;3,0;;6,0;2,0;1,0;;;;;2,0;;;;;;3,0;;;3,0;;;;;;3,0;;1,0;;;;4,0;;;;35,0;3,0;1,0;;;;8,0;;;6,0;;;;;;;2,0;1,0;;;;1,0;;;;4,0;1,0;;2,0;3,0;;2,0;1,0;8,0;17,0;1,0;1,0;5,0;;5,0;;;3,0;;;12,0;;;3,0;;;;2,0;7,0;;;3,0;;;10,0;;14,0;3,0;2,0;;2,0;2,0;1,0;4,0;;2,0;;1,0;11,0;1,0;2,0;;1,0;;16,0;;;;;15,0;;8,0;27,0;4,0;11,0;2,0;;;;;;;;;;;;4,0;;;;;;;19,0;;;;;;;8,0;;;;;;;;2,0;;;;;;;2,0;;;;2,0;;1,0;;;;;1,0;;;;1,0;;;;;;;5,0;4,0;11,0;4,0;;4,0;;;;2,0;;;;;;;1,0;;;;;2,0;4,0;;5,0;;;;;;;;;3,0;;;2,0;;;;;4,0;;;;;;;;
cross;;2,0;;;7,0;;40,0;5,0;2,0;5,0;3,0;;9,0;2,0;;2,0;;;;;1,0;3,0;3,0;;;2,0;;8,0;1,0;;1,0;3,0;11,0;;5,0;;;20,0;;13,0;;;1,0;1,0;2,0;;;;;2,0;1,0;;;;;28,0;9,0;;2,0;17,0;2,0;;6,0;;;2,0;3,0;;;;37,0;;4,0;2,0;;;;16,0;6,0;;;;;;;;8,0;;1,0;13,0;7,0;4,0;;1,0;;1,0;;;;2,0;24,0;4,0;;;;;2,0;4,0;;;;1,0;1,0;2,0;9,0;;1,0;;1,0;11,0;;;;2,0;;;2,0;;;2,0;;;;;;;18,0;;1,0;;;;;6,0;;;8,0;13,0;;;;3,0;2,0;;1,0;1,0;2,0;5,0;;5,0;;1,0;;;;;1,0;3,0;1,0;1,0;96,0;4,0;10,0;6,0;;18,0;;4,0;;;;;4,0;;5,0;17,0;6,0;13,0;;26,0;;2,0;;1,0;8,0;;;;5,0;6,0;;33,0;;27,0;;;3,0;;5,0;21,0;;;;;1,0;3,0;;;;;5,0;3,0;1,0;;;;2,0;;;;;;;1,0;;8,0;;1,0;29,0;;12,0;1,0;;;;2,0;1,0;;6,0;2,0;;;;12,0;;;1,0;8,0;;3,0;;;20,0;;11,0;;26,0;1,0;;9,0;2,0;3,0;1,0;;;;;;3,0;1,0;;;;3,0;;2,0;2,0;18,0;7,0;4,0;;3,0;;1,0;;2,0;;5,0;3,0;;;;6,0;8,0;3,0;1,0;1,0;;7,0;1,0;7,0;7,0;;;7,0;1,0;;;2,0;2,0;;;24,0;;;;1,0;5,0;;;1,0;;;;;;;;;;;;;;;;;;;;;;;;;1,0;;;;;;;;;;;;;;;;4,0;;;1,0;;;;;5,0;;1,0;;;;;;4,0;;3,0;;1,0;1,0;;;;;5,0;3,0;;1,0;;;;;;2,0;;;;;2,0;1,0;;;2,0;1,0;;2,0;;;;;;1,0;;1,0;;;;;;;;;;;1,0;;;;;;;1,0;;;;;1,0;1,0;;;3,0;1,0;;;;;;;;;;1,0;;;;;;;;3,0;;;;;;;;;;;;;3,0;5,0;;;2,0;8,0;;;10,0;;4,0;1,0;10,0;1,0;;;;;;5,0;2,0;;3,0;;;1,0;;;1,0;;1,0;;;;;;1,0;;;;;;;;;;;;;2,0;;;;;;;;;;;;15,0;;;;;;;;;7,0;;;;;2,0;;;;1,0;;;3,0;;;;;;;1,0;;;;;;;;1,0;;;5,0;;;;;;1,0;;;2,0;;;1,0;;;;;;;;;1,0;;1,0;;;;;;;;;;;;;;;;;;;;;;;2,0;;;;1,0;3,0;;4,0;;;;5,0;;3,0;;;;;;1,0;1,0;;;;;3,0;;;3,0;;;;;;;;;;5,0;;;;2,0;7,0;;;;;1,0;4,0;;;;;;;;;;;;;;;;2,0;6,0;;;1,0;;;;;2,0;2,0;;;;;;;;;;2,0;;;;;1,0;2,0;;;;;;;;;;2,0;;;2,0;;;;;;;;;1,0;;;;;;;1,0;;;;;2,0;1,0;4,0;;;;;;2,0;;3,0;;;;;;;2,0;;;;;;;;1,0;;;;;;;;;;;;;;1,0;;;;1,0;;;;;;;;;;;;;;2,0;2,0;;;;;;;;;;;;;;;1,0;3,0;2,0;;;;;1,0;;;;;;;;;;;;;1,0;;;;;;;;;;1,0;;;;;2,0;;1,0;;;;;;;;4,0;;;;;;;;;1,0;1,0;1,0;;;;;;;;;;;;;;;;;;2,0;;;;;;;1,0;;;;;;;;;;;;;;;;;;;;;;;;;;4,0;;;;;;;2,0;;;;1,0;;;;;;;;1,0;;;;;;;;;;;;;;;;;;;5,0;;;;;;;;;2,0;;;;;;;;;;;;;;;;
define;;9,0;12,0;3,0;78,0;;52,0;114,0;13,0;65,0;23,0;13,0;7,0;2,0;27,0;15,0;;;11,0;13,0;17,0;52,0;82,0;15,0;3,0;;10,0;98,0;20,0;26,0;35,0;40,0;216,0;23,0;105,0;4,0;5,0;34,0;;55,0;40,0;1,0;6,0;38,0;6,0;2,0;;26,0;36,0;17,0;54,0;8,0;;15,0;28,0;302,0;155,0;;34,0;261,0;1,0;4,0;161,0;;7,0;11,0;21,0;9,0;4,0;19,0;57,0;12,0;32,0;17,0;31,0;2,0;1,0;47,0;163,0;9,0;;21,0;12,0;3,0;4,0;2,0;136,0;6,0;19,0;15,0;36,0;7,0;3,0;43,0;21,0;103,0;;15,0;10,0;30,0;242,0;158,0;;7,0;;6,0;5,0;141,0;3,0;;16,0;21,0;31,0;34,0;24,0;9,0;5,0;;70,0;116,0;7,0;3,0;3,0;52,0;;9,0;52,0;16,0;7,0;6,0;77,0;10,0;3,0;14,0;9,0;36,0;30,0;1,0;4,0;5,0;;23,0;14,0;42,0;14,0;;46,0;82,0;1,0;8,0;;92,0;27,0;;6,0;77,0;232,0;128,0;16,0;63,0;43,0;;81,0;21,0;16,0;14,0;5,0;65,0;;10,0;74,0;1,0;146,0;85,0;10,0;141,0;43,0;13,0;1,0;;17,0;13,0;5,0;2,0;10,0;79,0;83,0;203,0;;210,0;4,0;21,0;13,0;243,0;19,0;;;;23,0;13,0;1,0;43,0;9,0;98,0;12,0;6,0;16,0;2,0;22,0;66,0;3,0;23,0;;1,0;17,0;52,0;5,0;12,0;3,0;7,0;40,0;16,0;2,0;2,0;163,0;;41,0;;;9,0;8,0;1,0;8,0;20,0;8,0;111,0;29,0;2,0;190,0;5,0;113,0;3,0;28,0;64,0;4,0;6,0;64,0;27,0;7,0;16,0;1,0;1,0;9,0;48,0;1,0;;68,0;;18,0;12,0;6,0;3,0;20,0;12,0;37,0;4,0;52,0;2,0;25,0;6,0;23,0;13,0;12,0;;2,0;12,0;7,0;2,0;60,0;22,0;3,0;5,0;2,0;39,0;6,0;31,0;2,0;116,0;2,0;23,0;12,0;4,0;4,0;33,0;2,0;11,0;;9,0;26,0;2,0;6,0;4,0;37,0;18,0;17,0;3,0;14,0;52,0;14,0;62,0;65,0;19,0;;;12,0;4,0;2,0;7,0;8,0;7,0;16,0;2,0;12,0;8,0;2,0;12,0;11,0;10,0;17,0;5,0;77,0;;8,0;1,0;;;1,0;;3,0;2,0;1,0;20,0;4,0;3,0;9,0;;3,0;3,0;26,0;3,0;4,0;3,0;6,0;6,0;1,0;3,0;;;;;3,0;;8,0;4,0;7,0;1,0;;1,0;24,0;36,0;;4,0;3,0;4,0;18,0;5,0;7,0;2,0;;35,0;3,0;12,0;3,0;12,0;2,0;;4,0;11,0;1,0;30,0;4,0;15,0;4,0;;14,0;4,0;8,0;92,0;14,0;2,0;15,0;10,0;2,0;;23,0;;44,0;15,0;5,0;;24,0;26,0;6,0;2,0;2,0;21,0;14,0;;35,0;2,0;23,0;2,0;10,0;13,0;7,0;2,0;3,0;2,0;17,0;23,0;2,0;3,0;;;8,0;4,0;2,0;2,0;2,0;1,0;6,0;7,0;1,0;;6,0;40,0;3,0;;;3,0;;5,0;50,0;23,0;;3,0;1,0;;3,0;;2,0;7,0;;9,0;;16,0;5,0;2,0;35,0;;3,0;25,0;9,0;;8,0;1,0;33,0;1,0;;;1,0;6,0;1,0;2,0;1,0;12,0;57,0;14,0;3,0;24,0;4,0;7,0;12,0;3,0;36,0;105,0;3,0;5,0;9,0;;4,0;;1,0;5,0;127,0;13,0;;3,0;;10,0;92,0;;;11,0;12,0;21,0;7,0;2,0;8,0;3,0;;15,0;8,0;8,0;;5,0;4,0;;;4,0;1,0;;3,0;1,0;;2,0;3,0;2,0;3,0;1,0;;;1,0;2,0;33,0;;7,0;5,0;;;6,0;16,0;5,0;1,0;5,0;11,0;4,0;14,0;3,0;5,0;53,0;;1,0;;7,0;;15,0;;2,0;;6,0;;3,0;;68,0;9,0;68,0;2,0;4,0;4,0;2,0;;37,0;1,0;2,0;5,0;58,0;;2,0;4,0;1,0;8,0;;18,0;10,0;2,0;1,0;2,0;;8,0;;;20,0;;1,0;;11,0;6,0;8,0;;10,0;6,0;6,0;;6,0;;5,0;;;2,0;;1,0;;4,0;;2,0;;;1,0;;;3,0;9,0;13,0;6,0;1,0;21,0;1,0;7,0;2,0;2,0;1,0;3,0;10,0;3,0;3,0;1,0;1,0;10,0;11,0;2,0;11,0;;4,0;18,0;;4,0;3,0;13,0;6,0;10,0;7,0;;8,0;4,0;;;5,0;9,0;;;;1,0;3,0;18,0;;2,0;13,0;;;;;1,0;11,0;37,0;1,0;;;;;1,0;2,0;;;4,0;;1,0;18,0;1,0;1,0;6,0;;2,0;;2,0;13,0;;1,0;7,0;12,0;;6,0;1,0;;;;;;2,0;6,0;2,0;;12,0;6,0;3,0;8,0;;;;;1,0;;7,0;;8,0;3,0;5,0;16,0;3,0;3,0;1,0;3,0;;;5,0;;12,0;2,0;;1,0;1,0;;;2,0;3,0;13,0;3,0;5,0;8,0;11,0;;1,0;5,0;;1,0;1,0;9,0;2,0;2,0;7,0;9,0;1,0;6,0;25,0;;7,0;4,0;;2,0;1,0;1,0;3,0;;;2,0;12,0;34,0;5,0;;;3,0;7,0;7,0;1,0;19,0;5,0;;8,0;1,0;4,0;1,0;1,0;;4,0;3,0;4,0;5,0;;12,0;;3,0;13,0;1,0;8,0;5,0;;2,0;;;1,0;;2,0;6,0;;12,0;;10,0;2,0;10,0;2,0;3,0;11,0;3,0;1,0;4,0;1,0;3,0;20,0;5,0;1,0;2,0;6,0;17,0;;;9,0;;;;1,0;;;3,0;3,0;3,0;17,0;12,0;1,0;;12,0;11,0;3,0;1,0;5,0;2,0;;4,0;;;2,0;2,0;1,0;5,0;;21,0;;33,0;;1,0;;2,0;3,0;;;3,0;;;2,0;9,0;;;;;;8,0;;2,0;2,0;3,0;2,0;;5,0;1,0;6,0;2,0;;;3,0;1,0;;13,0;2,0;;3,0;;1,0;;;;;;7,0;;;;8,0;;1,0;;;4,0;2,0;;;5,0;;2,0;;;3,0;;;3,0;10,0;;;;31,0;;4,0;;4,0;;8,0;;18,0;1,0;;;8,0;4,0;;1,0;36,0;;;;1,0;1,0;;;3,0;3,0;7,0;;;1,0;;1,0;;2,0;;1,0;7,0;;1,0;5,0;;;1,0;2,0;;;6,0;;;;;;
detachably;;3,0;1,0;;7,0;;2,0;10,0;;;;1,0;;;;;;;1,0;;;2,0;;;1,0;;;;;;;;13,0;;6,0;;;1,0;;;;;;7,0;;;;;1,0;1,0;;;;;;17,0;6,0;;;94,0;;;1,0;;;;;2,0;;;26,0;;;;;8,0;;;1,0;;1,0;6,0;1,0;;;;;;;;1,0;;;3,0;;;;11,0;;;4,0;13,0;;1,0;;;1,0;56,0;;;2,0;;;10,0;88,0;;1,0;;;76,0;;;;;;;3,0;2,0;;21,0;11,0;;;;;;;;;;;;1,0;4,0;;;2,0;7,0;;;;;;;;4,0;1,0;11,0;;10,0;;;;;;;;;2,0;;7,0;;9,0;60,0;;;1,0;;;;1,0;;;;;;;10,0;;12,0;;2,0;;14,0;;;;1,0;;8,0;;3,0;;5,0;;;;;;20,0;;6,0;;;1,0;;1,0;;;1,0;1,0;2,0;;;;;;;;;;;;;;2,0;;;;;;;;;;2,0;;;;;;2,0;2,0;28,0;;;1,0;;;;;;2,0;;;4,0;2,0;7,0;;;;2,0;;;;4,0;;;;;2,0;;;6,0;;;;;1,0;2,0;;;;;;;;9,0;;;4,0;;;;1,0;;9,0;;2,0;;;;;;;;;;;;;;;;;;3,0;4,0;;;2,0;;;;;;;;;;;;4,0;;;;;;;2,0;;;;;;;;;3,0;;;;;;2,0;;;;;;2,0;;;;8,0;2,0;;;;;;5,0;;;;;;;;2,0;1,0;;;;;;;;;;;;;;;;;;;;;1,0;;;;;;;;;;;;;1,0;;;;;;;;;;;13,0;;;;2,0;;;1,0;;4,0;1,0;;;;;;;1,0;1,0;;;;;;;;;;;;;;;;;;;;;;;1,0;1,0;;;;;;;;4,0;;;;;;;;;1,0;;;;;;2,0;;;;3,0;4,0;;;;;;;;;;6,0;1,0;;;;;9,0;;;;;;6,0;;;;;;;;;;;;;;;;2,0;;;;;;;;;;;1,0;;3,0;;;;;;;;6,0;;;;;;;;;;;;1,0;;;;;;;;;5,0;;;;;9,0;;;;;;;1,0;;;;;;;;;19,0;5,0;;1,0;;;;;;;;;;;;;;;;;;;;;;;1,0;;;;;;;;2,0;;;;;;;;;;;;;;;;;;;;;;;;;;;;;;;;;;;;;;;;;;;;;;;;;;;;;;;;;;;;2,0;;;;;;;;;2,0;;;;;;;;;;;;;;;;;;;;;;;;;;;;;;;;;;;;;;;;;;;;1,0;;;;;;;;;;;;;;;;;;;;;;24,0;;;;;;;;1,0;;;;;;;;;;;2,0;;;;;;;;;;;;;;;;;;;2,0;;;;;;;;;;4,0;;18,0;4,0;;;;;;;;;;;;;1,0;;;;1,0;;;;;;6,0;;;;;;;;3,0;;;;;;;;;;;;;;;;;;;;;;;;;;;1,0;;;;6,0;;;;;;;;;;;1,0;;;;;;;;;;;;;;;;;;;;;;;1,0;;;;;;;;;;1,0;;;;;1,0;;;;;;;;;;;;;;;;;;1,0;;;;;;;;;;;;;;;;;;;;;;;;;;;;;;;;;;;;;;;;;;;;
dispose;;2,0;1,0;;34,0;;157,0;105,0;;38,0;25,0;8,0;5,0;;16,0;2,0;1,0;1,0;45,0;7,0;7,0;31,0;1,0;;8,0;;8,0;6,0;16,0;15,0;91,0;8,0;224,0;;60,0;29,0;10,0;110,0;2,0;82,0;15,0;;39,0;232,0;;;5,0;12,0;107,0;;4,0;6,0;4,0;130,0;4,0;336,0;149,0;;9,0;772,0;3,0;8,0;44,0;;;28,0;17,0;14,0;3,0;24,0;311,0;29,0;69,0;8,0;16,0;15,0;7,0;14,0;194,0;39,0;2,0;11,0;7,0;2,0;1,0;7,0;113,0;15,0;;16,0;171,0;3,0;2,0;58,0;2,0;61,0;;17,0;7,0;146,0;431,0;91,0;;15,0;;2,0;22,0;293,0;;1,0;12,0;13,0;129,0;67,0;3,0;10,0;17,0;7,0;65,0;138,0;4,0;5,0;1,0;71,0;5,0;;55,0;64,0;1,0;37,0;84,0;;25,0;36,0;2,0;51,0;;15,0;64,0;28,0;2,0;2,0;12,0;82,0;59,0;10,0;51,0;132,0;3,0;8,0;6,0;43,0;86,0;5,0;45,0;46,0;56,0;331,0;12,0;164,0;5,0;;100,0;72,0;2,0;90,0;1,0;180,0;4,0;53,0;300,0;70,0;179,0;79,0;5,0;93,0;83,0;35,0;8,0;;32,0;16,0;12,0;9,0;20,0;68,0;92,0;257,0;2,0;262,0;8,0;28,0;7,0;25,0;7,0;11,0;12,0;7,0;30,0;9,0;66,0;29,0;11,0;378,0;20,0;8,0;33,0;9,0;62,0;80,0;3,0;39,0;8,0;1,0;17,0;5,0;16,0;55,0;;6,0;54,0;42,0;2,0;2,0;36,0;6,0;31,0;5,0;;10,0;3,0;5,0;16,0;86,0;7,0;17,0;4,0;9,0;40,0;1,0;116,0;14,0;14,0;49,0;3,0;7,0;11,0;32,0;58,0;51,0;64,0;1,0;14,0;56,0;6,0;;43,0;30,0;;;2,0;52,0;30,0;28,0;23,0;12,0;33,0;;27,0;11,0;20,0;57,0;5,0;3,0;16,0;13,0;;1,0;3,0;7,0;27,0;49,0;3,0;58,0;9,0;6,0;17,0;91,0;18,0;79,0;10,0;2,0;12,0;18,0;;14,0;36,0;32,0;4,0;16,0;22,0;14,0;28,0;13,0;8,0;22,0;5,0;7,0;27,0;9,0;5,0;22,0;1,0;4,0;32,0;1,0;7,0;17,0;21,0;4,0;23,0;9,0;48,0;19,0;4,0;41,0;29,0;26,0;8,0;;5,0;3,0;;1,0;;;1,0;1,0;1,0;3,0;15,0;4,0;1,0;4,0;3,0;1,0;;;35,0;3,0;58,0;1,0;1,0;9,0;;;;;;14,0;;2,0;3,0;;;;;;5,0;;;11,0;;4,0;6,0;22,0;3,0;;;63,0;;27,0;6,0;;8,0;;;1,0;2,0;7,0;1,0;1,0;6,0;2,0;31,0;;2,0;15,0;5,0;;5,0;;;;;3,0;6,0;9,0;;2,0;18,0;2,0;10,0;10,0;2,0;5,0;8,0;;11,0;10,0;38,0;1,0;2,0;10,0;3,0;2,0;;22,0;;6,0;8,0;;;;;4,0;3,0;;;7,0;15,0;;22,0;1,0;2,0;4,0;28,0;;;9,0;;1,0;31,0;31,0;3,0;;1,0;;;;;;;;4,0;17,0;60,0;;;;3,0;7,0;10,0;2,0;8,0;7,0;29,0;;;1,0;6,0;;;2,0;;14,0;10,0;;1,0;3,0;;31,0;4,0;2,0;32,0;23,0;;3,0;16,0;;;;;;64,0;8,0;;10,0;;33,0;30,0;;;1,0;10,0;27,0;13,0;;;;;17,0;;6,0;;5,0;3,0;4,0;;;3,0;;14,0;;;;7,0;2,0;;;;;;14,0;23,0;3,0;15,0;2,0;;3,0;5,0;4,0;6,0;;;2,0;4,0;10,0;2,0;1,0;216,0;8,0;2,0;;9,0;;29,0;;;;1,0;;;;15,0;7,0;20,0;1,0;7,0;7,0;;;26,0;2,0;;56,0;10,0;;;;17,0;14,0;3,0;;15,0;8,0;2,0;9,0;2,0;18,0;11,0;;7,0;5,0;8,0;;10,0;4,0;11,0;2,0;1,0;5,0;8,0;;;;9,0;2,0;2,0;1,0;8,0;2,0;9,0;7,0;4,0;;;1,0;12,0;10,0;;35,0;1,0;4,0;3,0;4,0;30,0;18,0;6,0;4,0;;1,0;13,0;22,0;;;10,0;1,0;13,0;4,0;;48,0;;11,0;22,0;10,0;2,0;4,0;4,0;4,0;4,0;5,0;;;14,0;2,0;1,0;6,0;8,0;7,0;3,0;;;5,0;20,0;1,0;29,0;;;;6,0;;;;24,0;3,0;25,0;8,0;;2,0;1,0;4,0;;;;2,0;41,0;36,0;4,0;4,0;4,0;;1,0;;9,0;27,0;15,0;1,0;2,0;4,0;;1,0;5,0;5,0;3,0;;13,0;8,0;;9,0;33,0;8,0;7,0;2,0;2,0;;;;;;;;1,0;8,0;;2,0;;;;2,0;;3,0;1,0;;;;9,0;3,0;;;2,0;4,0;;12,0;2,0;;;;2,0;4,0;;4,0;;1,0;;;;8,0;9,0;;;13,0;12,0;4,0;4,0;10,0;;1,0;;;;1,0;;;;8,0;;;;;;;;;5,0;;;12,0;;1,0;;;;1,0;;;18,0;;;;1,0;;;5,0;1,0;;3,0;;;;5,0;;9,0;;;3,0;1,0;;17,0;;17,0;18,0;3,0;1,0;1,0;;;36,0;3,0;4,0;5,0;;10,0;2,0;1,0;4,0;12,0;;;6,0;2,0;1,0;;;;1,0;8,0;;12,0;5,0;11,0;5,0;6,0;13,0;8,0;;7,0;7,0;;1,0;;3,0;5,0;;15,0;;6,0;;4,0;3,0;10,0;1,0;3,0;16,0;25,0;;;9,0;1,0;;;11,0;;12,0;;;7,0;;;12,0;;12,0;;1,0;2,0;2,0;;;;;10,0;;;1,0;;4,0;;;;11,0;;6,0;6,0;;3,0;;1,0;5,0;;1,0;;8,0;;;2,0;;2,0;;;1,0;;;;7,0;;;;;;;39,0;5,0;1,0;6,0;;6,0;12,0;1,0;6,0;;3,0;;;;;14,0;;;;;;;3,0;;33,0;;2,0;2,0;;;;;;;21,0;10,0;18,0;;;;;12,0;;;;;;;2,0;
door;;2,0;3,0;;51,0;;7,0;;;;1,0;;;;;;;;;2,0;;2,0;;;;;1,0;1,0;;;;;10,0;;;;;2,0;;1,0;8,0;;;;;;;;;;;2,0;;;1,0;2,0;5,0;;1,0;15,0;;;2,0;;1,0;;;;;;;;;;7,0;;;1,0;12,0;;;;;;;2,0;;;;;2,0;;;;;8,0;;;;;25,0;1,0;;;;;;17,0;;1,0;7,0;4,0;;2,0;2,0;;;;1,0;37,0;;;;;;;12,0;2,0;;12,0;29,0;;;;;;15,0;;;;;;;4,0;;3,0;25,0;9,0;;;;3,0;8,0;;;;15,0;2,0;;;;2,0;1,0;1,0;;;;;;;47,0;3,0;;9,0;9,0;26,0;1,0;;;;;3,0;4,0;;;;2,0;;;;;7,0;;2,0;;;;;23,0;13,0;;7,0;;3,0;;;;;;14,0;;2,0;;;;;;;6,0;;;2,0;;1,0;2,0;;1,0;;;;;;;;;;;;;;;;;;;;;;;;;;;11,0;;;;1,0;;;;;;20,0;4,0;;18,0;;;;;;;;3,0;;;;;2,0;11,0;;;;;;5,0;;;2,0;;;3,0;;;;;;;;50,0;;;;;;1,0;;;4,0;;;;;;;;;1,0;;;;;38,0;;;;2,0;;;;;;;;;;;;;;;;;;;;;;;8,0;;;;;;;;;;;;;;;;;;;;;;;;;;;;;;;;;;;;;;;;;;;;;;;;;;6,0;;;;;;;;;;;3,0;;;;;;;1,0;;4,0;;;;;;;;;;;;;;;;;;;7,0;;;;;2,0;;;;;;;;;;;;;;;;;;;;;;1,0;;;;;;17,0;;1,0;;;;;;;;;;;28,0;;;;;;;;;;;;;;;1,0;;;;;;;;;;;;;;;;;;;;;;;;;;;;;;;;4,0;;;;;;;;;;;5,0;2,0;;10,0;;;;;;;;;;;;;;;;;;;;2,0;;;;;;;;;;;;;;;;;;;17,0;;;;;;;;;;;;4,0;;;;;;;3,0;;;;;;;;;;;;;;1,0;;;;;;;;;;;;;;1,0;;;;;;2,0;;;;;;2,0;;;;;;;;;2,0;;;;;;6,0;3,0;;;;;1,0;;;;;;;;;;;;1,0;;;;;;;;;;;;;;;;;;;;;;;;;;;;;;;;;;;;;;;;;;;;;;;2,0;;;;;;;;;;;;;;;;;;;;;;;;;;;;;;;;;;;;;;;;;;;;;;;;;;;;;;;;;;;;;;;;;;;;;;;;;;;;;;;;;;;;;;;;;;;;;;4,0;;;;;;;;;;;3,0;;;;;;1,0;;;;;;;;;;;;;;;5,0;;;;;;;;;;;;;;;;;;;;;;;;;;;;;;;20,0;;;11,0;;;;;;;;;;;;;;;;;;;;;;;;;;;;;;;;;;;;;;;;;;;;;;;;;;;;;;;;;;;;;;;;;;;;;;;;;;;;;;;;;;;;;3,0;;;;;;;;;;;;;;;;;;;;;;;;;;;;;;
edge;;3,0;39,0;;33,0;;13,0;79,0;29,0;17,0;40,0;10,0;;3,0;14,0;;;;65,0;4,0;;13,0;;2,0;3,0;5,0;38,0;34,0;3,0;93,0;35,0;39,0;22,0;19,0;26,0;22,0;1,0;49,0;;33,0;7,0;;3,0;8,0;2,0;1,0;6,0;2,0;23,0;5,0;8,0;19,0;;5,0;8,0;296,0;52,0;1,0;10,0;44,0;1,0;;100,0;;13,0;;8,0;1,0;;12,0;11,0;10,0;5,0;19,0;3,0;2,0;;55,0;35,0;;;28,0;17,0;;1,0;;37,0;;;27,0;12,0;13,0;;4,0;3,0;28,0;;4,0;2,0;11,0;93,0;25,0;;1,0;;1,0;8,0;20,0;;;3,0;14,0;8,0;15,0;15,0;3,0;;;1,0;12,0;1,0;1,0;;3,0;;;32,0;10,0;10,0;10,0;33,0;26,0;;;;18,0;30,0;;8,0;4,0;;;5,0;30,0;49,0;;65,0;34,0;;;;4,0;2,0;1,0;7,0;3,0;13,0;17,0;1,0;23,0;;;14,0;16,0;;4,0;14,0;13,0;1,0;5,0;40,0;8,0;25,0;35,0;1,0;27,0;34,0;6,0;;;25,0;4,0;4,0;;12,0;11,0;27,0;45,0;1,0;122,0;;1,0;1,0;8,0;3,0;2,0;;3,0;2,0;1,0;3,0;21,0;1,0;83,0;;;4,0;;9,0;47,0;;;;;1,0;2,0;;7,0;1,0;2,0;52,0;4,0;1,0;;4,0;;32,0;2,0;;4,0;7,0;;3,0;13,0;3,0;24,0;15,0;11,0;51,0;;11,0;1,0;16,0;69,0;2,0;3,0;;7,0;1,0;;2,0;;;14,0;;2,0;12,0;20,0;;2,0;;3,0;;6,0;8,0;17,0;77,0;4,0;14,0;7,0;2,0;23,0;;;;;;;6,0;57,0;2,0;;6,0;3,0;1,0;3,0;5,0;51,0;;22,0;;3,0;;9,0;;10,0;;1,0;6,0;2,0;2,0;;14,0;4,0;8,0;4,0;;8,0;16,0;12,0;116,0;7,0;;;6,0;;1,0;;1,0;;4,0;;2,0;;;1,0;2,0;;1,0;;3,0;;11,0;;;;;2,0;;;11,0;13,0;2,0;1,0;8,0;;16,0;;1,0;6,0;15,0;;24,0;;1,0;;13,0;;;1,0;1,0;;1,0;;17,0;20,0;;;10,0;;1,0;16,0;;10,0;3,0;5,0;3,0;;;47,0;;2,0;;1,0;8,0;;3,0;8,0;4,0;3,0;;15,0;;;;2,0;;8,0;16,0;;;;2,0;;4,0;;4,0;6,0;;;18,0;5,0;16,0;13,0;;;11,0;;25,0;;16,0;1,0;;3,0;;4,0;;1,0;2,0;1,0;;;;2,0;2,0;;;;;;;4,0;;1,0;;1,0;1,0;6,0;1,0;8,0;;;17,0;;;;;;1,0;;;;;22,0;;2,0;8,0;10,0;7,0;;;30,0;5,0;;;2,0;16,0;;3,0;;1,0;1,0;;;2,0;2,0;5,0;5,0;2,0;;;1,0;;6,0;2,0;12,0;;;;;1,0;;8,0;12,0;17,0;3,0;;;;;2,0;;;;;2,0;1,0;;;;2,0;;;4,0;;;2,0;;17,0;1,0;;;3,0;;1,0;;;1,0;2,0;;1,0;;;;1,0;2,0;;9,0;;;1,0;3,0;;;;;3,0;1,0;2,0;21,0;32,0;;;;1,0;1,0;4,0;;;;;;;;8,0;;32,0;;8,0;;3,0;;3,0;3,0;;7,0;4,0;;;7,0;;3,0;;;;;;;16,0;20,0;;;;7,0;;;;4,0;;;;4,0;;;;;;;;;;;;;;;;;23,0;2,0;;1,0;1,0;1,0;3,0;;;;1,0;;;1,0;6,0;;;;;;1,0;1,0;17,0;3,0;;;;;10,0;;1,0;5,0;8,0;;;;;5,0;;4,0;;39,0;;;;6,0;23,0;;;6,0;;;;;;8,0;2,0;;;;16,0;;;;;;7,0;;;39,0;6,0;;;;;;3,0;9,0;;;4,0;9,0;;2,0;;2,0;;;1,0;;;5,0;;3,0;1,0;;;1,0;;;;;;5,0;2,0;1,0;;1,0;;9,0;;1,0;1,0;;1,0;1,0;1,0;;;15,0;;5,0;;;;57,0;1,0;7,0;2,0;1,0;12,0;;11,0;;1,0;;;;4,0;;;;1,0;;;;1,0;1,0;3,0;1,0;;;;6,0;;;;;1,0;;;;;;;;1,0;;;;4,0;1,0;;;1,0;;;;7,0;;17,0;;1,0;1,0;;22,0;;;;;;;2,0;;17,0;;;2,0;;;7,0;4,0;19,0;;9,0;;6,0;;4,0;;;;;;11,0;;;;;;1,0;6,0;5,0;;3,0;4,0;;;1,0;;;7,0;4,0;1,0;1,0;;1,0;;2,0;;;4,0;;;2,0;;;;1,0;;;;;;;;;;;;;;;;6,0;;4,0;1,0;1,0;;;4,0;1,0;1,0;2,0;3,0;;;2,0;;;8,0;1,0;;1,0;;;;2,0;;5,0;;;;2,0;;;2,0;;;;;;;;1,0;;;;;;;;;;1,0;;4,0;;6,0;;;;2,0;;8,0;;5,0;;1,0;;2,0;2,0;5,0;;;;;;;;4,0;;;1,0;;1,0;;;9,0;;;;;;2,0;;;;;;;;;1,0;;;;;;;
elastic;;1,0;1,0;;9,0;;15,0;17,0;;;3,0;;;;4,0;2,0;;;34,0;;;3,0;;;;;;;;;;;23,0;5,0;7,0;;;32,0;;1,0;3,0;;7,0;149,0;;;;;1,0;;;12,0;;1,0;;8,0;22,0;;1,0;121,0;;;2,0;;;4,0;15,0;;;5,0;20,0;;;1,0;3,0;;1,0;2,0;36,0;;3,0;;;;2,0;;;;;2,0;3,0;;;4,0;;7,0;;;;6,0;16,0;6,0;;;;;1,0;37,0;;;;16,0;;7,0;7,0;10,0;;;3,0;132,0;;;;2,0;;;18,0;21,0;;10,0;16,0;;;10,0;3,0;;28,0;20,0;2,0;;2,0;;5,0;8,0;1,0;86,0;42,0;11,0;;;;6,0;22,0;;11,0;13,0;12,0;15,0;;5,0;;1,0;32,0;5,0;;;1,0;6,0;;10,0;272,0;;64,0;12,0;16,0;5,0;28,0;1,0;;;12,0;;3,0;;4,0;1,0;12,0;31,0;;122,0;;7,0;;19,0;2,0;;;2,0;16,0;9,0;;13,0;8,0;20,0;3,0;;;1,0;8,0;38,0;;4,0;;;;;;;2,0;;7,0;2,0;6,0;;4,0;;;;;12,0;1,0;;5,0;2,0;1,0;1,0;6,0;16,0;;;30,0;;;3,0;;3,0;;;2,0;11,0;;;11,0;39,0;;;4,0;12,0;;5,0;;8,0;6,0;;11,0;5,0;12,0;;1,0;5,0;5,0;1,0;1,0;8,0;9,0;;;;2,0;8,0;10,0;12,0;;8,0;;;7,0;;2,0;14,0;;;;;1,0;;;;;7,0;4,0;20,0;1,0;5,0;1,0;3,0;;2,0;;;;3,0;;;29,0;;1,0;;6,0;4,0;3,0;1,0;8,0;5,0;4,0;;;40,0;;;3,0;;;;;1,0;;;;1,0;2,0;;;;;;;;;;10,0;;;;;;;;;;;;;;;;;;5,0;;;;;;;;;;;4,0;;2,0;;;;;;;;;3,0;1,0;1,0;;2,0;;;;;;;;;;;;;;;2,0;;6,0;;;;;;;;;4,0;;;3,0;;;;;;;;;;;;;;;;;;;;;;;8,0;;;;;;2,0;;;;;;;;;;;;;;16,0;;;;;2,0;;;1,0;;1,0;;;;;;;;;7,0;;;;;;;;;4,0;;;;;;2,0;;;;6,0;;;3,0;;1,0;4,0;;;;3,0;7,0;1,0;;;;;;;;;;;;;;3,0;;;;;;;1,0;;;;;;4,0;2,0;;6,0;;;1,0;;;3,0;;;10,0;;;;;2,0;2,0;;;;;4,0;;1,0;;;;;;3,0;;6,0;;;;2,0;;;;;6,0;2,0;;;;;;;5,0;;;;;1,0;;;;;1,0;;;;;;;;39,0;;;;;;;;;;;;;;;;2,0;;5,0;;5,0;;;;3,0;;3,0;5,0;;2,0;;2,0;4,0;1,0;;;;;;;;;1,0;2,0;;4,0;;;7,0;1,0;;;;;;;3,0;3,0;;5,0;;1,0;1,0;1,0;;;;;;;;;;;;;;;;;1,0;1,0;;;;;1,0;;;;;;;;;;;;;;;;;;;;;;1,0;2,0;;;;;;;;;;;;;;;;;;;;;;;;;;;;;;;;;;;;6,0;;;1,0;;;;;;;;;;;;;;;1,0;;;2,0;;;;;;;;;;;;;;;;;1,0;;;;;;;;;;;;;;;;;;;;2,0;;;;;;;;1,0;;;;;;;;;3,0;;5,0;;;;;;;;;3,0;;;;;;;5,0;13,0;;;;;;1,0;;15,0;;8,0;;;5,0;;;3,0;;;;;;;;2,0;1,0;;;;;;;;3,0;3,0;;;;;;;;;;;;4,0;;;;;;;1,0;1,0;;6,0;;;;;;;;;;;;;;;;;;;;;;;5,0;;;;;;;;;;;;;;;;;;;;;5,0;;;2,0;;;;;;;;;;;;;;;;2,0;;;;;;;;;;;;;;;;;;;;;;;;;;;;;;
electrode;;4,0;;;19,0;;3,0;16,0;;3,0;9,0;;;;;3,0;;;3,0;5,0;;16,0;;;;;;;5,0;1,0;7,0;;70,0;3,0;1,0;1,0;9,0;84,0;;12,0;6,0;;38,0;92,0;;;;;4,0;;2,0;23,0;;21,0;11,0;56,0;104,0;;2,0;45,0;7,0;;15,0;;;;10,0;;;2,0;17,0;5,0;1,0;9,0;25,0;;18,0;;69,0;12,0;;6,0;12,0;2,0;;5,0;102,0;;;8,0;27,0;2,0;;77,0;1,0;10,0;;2,0;3,0;177,0;116,0;5,0;;641,0;;6,0;4,0;27,0;;1,0;4,0;120,0;32,0;23,0;12,0;;2,0;1,0;4,0;12,0;1,0;;;32,0;2,0;9,0;15,0;47,0;;5,0;12,0;16,0;14,0;;4,0;;64,0;;;61,0;;;24,0;7,0;2,0;16,0;221,0;8,0;;;1,0;6,0;;11,0;;2,0;85,0;2,0;;38,0;;;11,0;3,0;;371,0;;72,0;;73,0;37,0;;25,0;13,0;;9,0;42,0;10,0;;;;3,0;6,0;;;8,0;13,0;203,0;1,0;100,0;2,0;;;12,0;1,0;7,0;5,0;;;3,0;46,0;8,0;2,0;53,0;;;9,0;4,0;9,0;4,0;;3,0;;4,0;;4,0;;53,0;;4,0;14,0;;3,0;;21,0;6,0;;;;;;;26,0;69,0;5,0;;1,0;75,0;17,0;;14,0;;;1,0;;;51,0;13,0;;1,0;54,0;;19,0;250,0;2,0;1,0;;4,0;;;10,0;50,0;8,0;2,0;4,0;;52,0;;1,0;;15,0;3,0;2,0;;;4,0;;;;23,0;;;;;;;23,0;;;54,0;;1,0;;13,0;1,0;7,0;31,0;;4,0;;4,0;;14,0;1,0;;1,0;;8,0;2,0;;;20,0;;;;;;;1,0;;;;;;;12,0;;1,0;58,0;;;1,0;;;;3,0;;;1,0;;;;;;;;;8,0;4,0;;7,0;;;;;;;;;;;;;2,0;;2,0;;1,0;3,0;;;1,0;3,0;;;7,0;2,0;;;26,0;;14,0;;;22,0;;;;;;;;;;1,0;;;;;;;;;;1,0;;;;;3,0;;;4,0;;;;;;2,0;;4,0;;;1,0;;;;36,0;;;;;;;;;;;;;;;;;14,0;;31,0;;;;;;19,0;;;;;;;;;;;;;1,0;;;;;1,0;4,0;;;;;20,0;;;;9,0;;;;;;;;;;;22,0;1,0;;1,0;4,0;;74,0;;;;;;;5,0;;;;;;;;;;;8,0;;;;;;;;;;4,0;;;;;;;2,0;;;;;;;;;42,0;;;;;;;;;;;5,0;;;8,0;;;1,0;;20,0;13,0;;;;;22,0;;;;;;;;;;;;;;;;;;;18,0;;;;;;3,0;;4,0;1,0;53,0;;;;1,0;;;;;;;;2,0;;7,0;;5,0;;;;;;;;;10,0;;1,0;11,0;2,0;;;1,0;;;;69,0;;;;;8,0;;;;;;3,0;;;;;3,0;;;;58,0;;;1,0;;4,0;;;4,0;4,0;;;;3,0;3,0;;;;;2,0;;;5,0;31,0;;;;;;2,0;22,0;;1,0;;2,0;6,0;;;3,0;9,0;23,0;;;;3,0;109,0;12,0;;;;;2,0;;;;15,0;;;2,0;1,0;;2,0;15,0;;;120,0;;;;17,0;;;;20,0;;;;;;1,0;;;1,0;;;;;;;;;;7,0;;;;1,0;;;;;;;;;;;23,0;1,0;;;;;;;;;;;;1,0;;;;;;;;;;;;;;;;;;;;;;3,0;;;;;;;;;;;;;1,0;;52,0;;1,0;;;;;;;;;;;;8,0;;;;;6,0;;;;1,0;;;;;2,0;;;;;;32,0;;;;12,0;;;;;;;;;;;;;;2,0;;;3,0;;;;;;;2,0;;6,0;;;;2,0;;7,0;;1,0;;;;;8,0;;1,0;;;;;;;;;;;1,0;;;;;;;;;;;3,0;42,0;;;;;;;;;;;;;;;;;;;1,0;;;;;;;;;;;;;;;2,0;;;7,0;;;66,0;5,0;2,0;1,0;;;1,0;1,0;;6,0;4,0;;;;;;;;;;;;;;6,0;;;;;;;;;;;;;;;;;;;;;;;;;
electronics;;8,0;;;7,0;;;4,0;;6,0;2,0;;;;;;;;5,0;1,0;8,0;14,0;;;;;;9,0;2,0;3,0;1,0;2,0;135,0;;6,0;;;4,0;;16,0;1,0;;12,0;6,0;;16,0;;1,0;;;8,0;2,0;;18,0;;31,0;31,0;;;31,0;;;5,0;;;4,0;;;;7,0;1,0;;;;;;;1,0;4,0;73,0;;12,0;;1,0;;;;;;3,0;8,0;;;11,0;;2,0;;9,0;;;8,0;65,0;;1,0;;;;24,0;;;3,0;1,0;3,0;;16,0;;;;;2,0;;;;;;;11,0;;;13,0;;;;;;2,0;11,0;;;;;;4,0;1,0;;;14,0;8,0;;;;;;;;;;6,0;14,0;5,0;;;1,0;;2,0;;2,0;3,0;;1,0;5,0;1,0;18,0;;;3,0;5,0;5,0;;;;;;;;4,0;;8,0;;4,0;;;2,0;11,0;;;;;3,0;;;;;3,0;;1,0;;;;2,0;;;;;;;;;;3,0;;;;4,0;1,0;;;;;;;;2,0;;;;;;;;;;;;;;;;;;;;;11,0;;;;;;2,0;;1,0;;;;4,0;2,0;;;;;1,0;1,0;;3,0;7,0;;;;1,0;1,0;;;1,0;;2,0;;;1,0;;6,0;;;;;;;;;;;;1,0;;;;;;1,0;;;;;;;;;;;;;;;;;2,0;;;8,0;;1,0;;;;;;;;;;;6,0;;;;;;3,0;;;1,0;;;4,0;;;;;;8,0;;1,0;;;;;;;8,0;;;;;1,0;2,0;;;;;;;;;5,0;;;;;;30,0;;;2,0;;;;;;;;;;1,0;;;;;;;1,0;;1,0;;;;;;;;;1,0;;;1,0;2,0;;;2,0;;;;;;;;;1,0;;7,0;1,0;;;;;;2,0;;5,0;;;;2,0;;1,0;;;;;;;;;;;;;;;1,0;;;6,0;;;;;;;;;;;;1,0;;2,0;;;;;;17,0;;;7,0;3,0;;2,0;;;;;;4,0;1,0;5,0;;;;;;;;;14,0;3,0;1,0;;;;;;;;;;;;;;;;;;;;;;;;;;;;1,0;;;;;;;;;;;;2,0;;;;4,0;;;;;;;;;;;;;;;;;;;;;;2,0;;;57,0;;;;;;;;;;;;;;;;;;;;;;;;;;;;;;1,0;;;2,0;1,0;;;;;;;;;;;;3,0;;;;;;;;;;;;;;;;1,0;;;;;;;;;;;;;;;;;;;;;;;;;;;;;;;;;;;;;;;;;;;;2,0;;;;;;;4,0;;;;;;;;;;;6,0;;;;;;;;;;;;;;;;;;;;;;;;;;;;;;;;;;;;;;;;;;;2,0;;;;;1,0;;;;1,0;;4,0;;;;4,0;;;;;;;;;;;;;;1,0;;;;;;;;;;;;;;;;;;;;;;;;;;;2,0;;;;;;;;;;;;;;;;;;;;;;;;;;;;;;;;;;;;;;;;;;;;;;;;;;;;;;;;;;;;;;;;;;;;;;;;;;;;;;;;;;;;;;;;;;;;;;;;;;;;;;;;;;;;;;;;;;;;;;;;1,0;;;;;;;;;;;;;;;;;;;;;;;1,0;;1,0;;;;;;;;;;;;;;;;;;4,0;;;;;;;;;;;;;;;;;;;;;;;;;;;;
emit;;1,0;115,0;;33,0;;22,0;33,0;19,0;15,0;8,0;9,0;;;86,0;5,0;;;20,0;2,0;3,0;82,0;;1,0;6,0;;;20,0;;19,0;11,0;31,0;277,0;;17,0;8,0;19,0;18,0;;24,0;17,0;;3,0;227,0;;;;2,0;7,0;5,0;10,0;18,0;;10,0;;59,0;55,0;;1,0;41,0;1,0;;33,0;;;;3,0;;2,0;5,0;61,0;6,0;8,0;;1,0;6,0;;8,0;30,0;23,0;3,0;4,0;3,0;4,0;3,0;6,0;13,0;;5,0;6,0;18,0;;3,0;61,0;;;;11,0;5,0;44,0;42,0;46,0;;;;3,0;15,0;110,0;1,0;2,0;17,0;15,0;17,0;10,0;6,0;2,0;2,0;7,0;1,0;15,0;;;4,0;10,0;;5,0;39,0;11,0;2,0;2,0;16,0;1,0;3,0;4,0;;19,0;28,0;;61,0;;16,0;;;19,0;21,0;;24,0;12,0;25,0;2,0;6,0;;11,0;1,0;;1,0;5,0;17,0;93,0;17,0;14,0;15,0;2,0;4,0;1,0;28,0;12,0;1980,0;;22,0;76,0;5,0;18,0;14,0;;3,0;3,0;11,0;;;2,0;1,0;11,0;;1,0;9,0;4,0;179,0;;69,0;;;68,0;50,0;;66,0;;;;1,0;92,0;10,0;;8,0;;2,0;2,0;;4,0;11,0;9,0;;4,0;1,0;2,0;54,0;8,0;4,0;;27,0;2,0;3,0;;20,0;1,0;63,0;3,0;;;;;;;17,0;14,0;21,0;;1,0;5,0;2,0;1,0;2,0;4,0;;;7,0;;19,0;;2,0;;;;3,0;;;2,0;5,0;5,0;;1,0;;4,0;;;2,0;1,0;;;;;4,0;;2,0;2,0;2,0;;;;7,0;;;6,0;1,0;1,0;2,0;2,0;26,0;7,0;3,0;3,0;4,0;;7,0;;;;19,0;1,0;;7,0;;29,0;5,0;4,0;;;14,0;2,0;3,0;11,0;13,0;;;;3,0;1,0;;1,0;4,0;;7,0;;3,0;;269,0;;;25,0;;1,0;2,0;;;;;8,0;;;3,0;;9,0;;;;;7,0;2,0;2,0;2,0;;;;1,0;;3,0;;;;;;1,0;;5,0;4,0;2,0;5,0;;2,0;;;;;17,0;1,0;;;;;3,0;8,0;9,0;3,0;3,0;16,0;17,0;;21,0;;6,0;3,0;11,0;;;8,0;2,0;9,0;6,0;6,0;5,0;6,0;;1,0;1,0;;;;;;1,0;;11,0;3,0;2,0;;2,0;2,0;;4,0;58,0;2,0;;;2,0;31,0;3,0;1,0;1,0;;3,0;;2,0;;;;;3,0;;1,0;;2,0;;5,0;1,0;;22,0;;4,0;3,0;;;1,0;8,0;188,0;;;1,0;;2,0;;;;;2,0;4,0;5,0;1,0;;;;;4,0;;;;;;3,0;;;;;4,0;2,0;;5,0;19,0;;;6,0;6,0;8,0;19,0;29,0;6,0;10,0;2,0;7,0;;;;;;;1,0;;;;5,0;;;;;2,0;5,0;1,0;;;;;;;6,0;;;166,0;6,0;1,0;;;1,0;;8,0;;;2,0;;2,0;;;1,0;16,0;;;;8,0;;;;;;;;;;;2,0;2,0;1,0;1,0;5,0;;;;1,0;;6,0;1,0;;;;;;;8,0;4,0;;;;;;;73,0;;1,0;7,0;;;2,0;;1,0;;;27,0;1,0;4,0;;;6,0;;;26,0;6,0;;;;1,0;;;;;;;;;;5,0;;;5,0;;;3,0;1,0;;;;;2,0;;;;3,0;2,0;2,0;;58,0;;;;;;6,0;;;;;;1,0;;;2,0;;;1,0;;;;;;1,0;;;;3,0;;;;;1,0;70,0;;;;2,0;;;;1,0;;;;1,0;8,0;;4,0;1,0;9,0;;;33,0;10,0;;;;;1,0;;;;;7,0;;1,0;1,0;;4,0;2,0;;3,0;;4,0;;1,0;;;;3,0;;;2,0;7,0;;;;1,0;;;;;;;;6,0;;;;;;;18,0;;;2,0;;1,0;;6,0;;;;;;;;;;2,0;8,0;4,0;;3,0;2,0;;;;;4,0;6,0;;3,0;299,0;1,0;2,0;1,0;3,0;1,0;;;;;;;;1,0;1,0;;;;;7,0;;;;2,0;;;2,0;;;;;;5,0;;;5,0;;1,0;1,0;;;;5,0;;;4,0;;1,0;;;1,0;;;1,0;3,0;;;93,0;10,0;;1,0;2,0;;;;18,0;;4,0;;1,0;2,0;;5,0;;;;;;;2,0;;1,0;1,0;;;;;;10,0;;;;;12,0;;2,0;;;;4,0;;4,0;;;;;;;;11,0;;;;;;;;;;;;;;;;;;;;1,0;;;;;1,0;;;2,0;;;5,0;;15,0;;3,0;;;4,0;;8,0;;1,0;;;3,0;;5,0;34,0;;1,0;;;;;;;2,0;;5,0;;;;1,0;;;;1,0;1,0;1,0;8,0;;4,0;;;;3,0;;;2,0;1,0;1,0;;;;;;;;2,0;;;;;;;;;;;8,0;;;;2,0;;;;;;;;;;;;;;;
emitter;;1,0;;;19,0;;1,0;;;;;;;;;;;;1,0;;;4,0;;;;;;1,0;;3,0;;3,0;3,0;;;;6,0;4,0;;2,0;1,0;;;;;;;;;4,0;;6,0;;10,0;;4,0;17,0;;;6,0;;;2,0;;;;;;;1,0;;;1,0;;;;;;2,0;6,0;2,0;;2,0;1,0;;;;1,0;;;2,0;;;22,0;;;;;;;2,0;6,0;;;;1,0;;5,0;;;2,0;9,0;30,0;;;;;;3,0;5,0;;;;3,0;;;9,0;;;1,0;;;;;;4,0;;;;26,0;4,0;;;1,0;;;3,0;;;;;;;;;;;;19,0;;;;;;;;8,0;50,0;;;;;3,0;1,0;1,0;;;1,0;;;;;;;;;;10,0;;2,0;;;20,0;15,0;;1,0;;;;;;;;;;;;1,0;;;;;;;;2,0;;;;;;;;;;;1,0;;;;;;;;;5,0;;;;;;;;;;;;;;;;;;6,0;;;;;;;;;;;;;;;;;;;;;;;;;;1,0;;;;;;;;;2,0;5,0;;;;;;;;;;;1,0;;2,0;;;;;;;;;3,0;;;;;;;;;;;;;;7,0;;;1,0;;;;;;;;;;;;;1,0;;;;;;;;;;;;;;;;;;;;;;;;2,0;;1,0;;;;;;;;;;;;;2,0;;;;3,0;;;;;;4,0;;;;;;;;;;21,0;;;;;;;;;2,0;;;;;;;;;;1,0;;;;;;;;;;;;;;;;;;;;;5,0;;;1,0;;3,0;;;;1,0;;;;3,0;;;5,0;;2,0;;;;;;1,0;1,0;1,0;;;;;;;;;;2,0;;;;;;;;;;;;;;;;;14,0;1,0;;;;;;;;;;;;;;;;;;;;1,0;;;;;;;;;;;;1,0;;;;;;;;;;;;;;;;;;;;;;;;;;;;;;;;4,0;;;;;;;;1,0;;;;;4,0;;;;;;;;;;1,0;4,0;;;4,0;;;;;;;;2,0;;;;;;;;;;;;;3,0;;;;;;;;;;;;;;;;;;;;;;;;;;;;3,0;;;;;;;;;;;;;;6,0;;;;;;;;;;;;;;;;;;;;;;;;;;;;;;;;;;;;;;;;;;;;;;;;;;;;;20,0;;;;;;;;1,0;;;;;;;4,0;;;;;;;;;;;;;;;;;;;;;;;;;;;;;;;;;;;;;;;;;;;;;;;1,0;;;;;;;;3,0;;;;;;;;;;;;;;;;;;;;;;;;;;;;;;;;;;;1,0;;;;;;;;;;;;;;;;;;;;;;5,0;3,0;;;;;;;;;6,0;;;;;;;;;;;;1,0;;;;;;;;;;;;;;;;1,0;;;1,0;;;2,0;;;;;2,0;;;;;;;;;;;;;;;;;;;;;;1,0;;;;;;;;;;;;;;1,0;;1,0;;;;;;;;;;;;;;;;;;;;;;;;;;;;;;;;;;;;;1,0;;;;;;;;;3,0;;;;;;;;;;;;;;;;;;;;;;;;;;;;;;;;;;;;;;
engage;;14,0;;;20,0;;30,0;85,0;;15,0;7,0;;2,0;;;;;;12,0;;2,0;24,0;1,0;1,0;;;4,0;3,0;;;;;34,0;;10,0;;4,0;102,0;;5,0;2,0;;49,0;67,0;;1,0;2,0;;8,0;;2,0;2,0;;11,0;;40,0;68,0;;7,0;232,0;5,0;;11,0;;;58,0;14,0;6,0;;30,0;23,0;;3,0;2,0;7,0;10,0;4,0;18,0;69,0;;4,0;10,0;;;;;8,0;2,0;;8,0;30,0;;3,0;10,0;6,0;9,0;;3,0;;6,0;83,0;15,0;1,0;;;5,0;1,0;96,0;;;7,0;6,0;;29,0;15,0;4,0;9,0;;12,0;45,0;2,0;1,0;;6,0;2,0;;83,0;27,0;;14,0;47,0;;;11,0;2,0;;23,0;4,0;4,0;;;;14,0;10,0;3,0;18,0;84,0;36,0;;1,0;;106,0;71,0;;22,0;49,0;112,0;112,0;15,0;6,0;;;61,0;7,0;3,0;1,0;;2,0;;3,0;348,0;12,0;34,0;114,0;10,0;36,0;46,0;2,0;2,0;;4,0;4,0;6,0;;22,0;4,0;40,0;73,0;;411,0;3,0;38,0;1,0;41,0;2,0;;;1,0;30,0;3,0;1,0;18,0;4,0;36,0;19,0;2,0;3,0;21,0;28,0;90,0;;2,0;;1,0;5,0;1,0;1,0;;1,0;6,0;18,0;1,0;;;31,0;;6,0;;;5,0;21,0;;5,0;4,0;12,0;;15,0;3,0;10,0;1,0;107,0;;7,0;6,0;;22,0;13,0;5,0;8,0;8,0;;2,0;;21,0;;;20,0;37,0;4,0;4,0;;27,0;8,0;11,0;;56,0;38,0;2,0;2,0;4,0;2,0;9,0;6,0;6,0;8,0;4,0;;21,0;3,0;7,0;31,0;1,0;;43,0;3,0;;10,0;3,0;6,0;10,0;;2,0;;;;;2,0;5,0;2,0;5,0;5,0;4,0;10,0;11,0;37,0;10,0;17,0;3,0;10,0;38,0;4,0;5,0;;4,0;17,0;7,0;13,0;6,0;57,0;10,0;15,0;;82,0;16,0;;1,0;2,0;11,0;2,0;;12,0;;13,0;;;1,0;;;;;;1,0;1,0;;;;;;2,0;;12,0;2,0;;;;;;;2,0;1,0;;;;;;;;;;2,0;;;;;3,0;;;;;7,0;;1,0;;;;;;;;1,0;19,0;;11,0;;42,0;;1,0;;;;27,0;;;;;;;1,0;2,0;;2,0;8,0;2,0;2,0;1,0;1,0;10,0;;;;1,0;;;1,0;10,0;;;;;;1,0;;;;;3,0;;;;7,0;6,0;;;;4,0;1,0;;;;6,0;;2,0;2,0;9,0;;;;;;;;;;;;2,0;18,0;1,0;;;;3,0;;;1,0;;7,0;;;;;;;;;32,0;1,0;;;6,0;;7,0;;3,0;4,0;2,0;1,0;;;;1,0;;;;30,0;12,0;;5,0;;7,0;21,0;;;1,0;10,0;17,0;5,0;;;;;2,0;1,0;2,0;;;2,0;;;8,0;;;4,0;1,0;;;;5,0;;;;;;3,0;24,0;;22,0;1,0;;4,0;;4,0;1,0;3,0;;;2,0;10,0;;;10,0;;8,0;;2,0;;4,0;;3,0;;;;;;9,0;12,0;20,0;;2,0;;;;1,0;;;2,0;114,0;;;;;1,0;;4,0;;3,0;;;;11,0;;;1,0;18,0;;;4,0;1,0;3,0;2,0;10,0;17,0;;;;;1,0;5,0;;;;;;5,0;;1,0;;14,0;7,0;6,0;;;6,0;9,0;;24,0;1,0;31,0;26,0;1,0;5,0;;1,0;2,0;;;;;2,0;;;;;1,0;7,0;6,0;1,0;7,0;;;1,0;;;;;;;2,0;6,0;7,0;;;3,0;;1,0;2,0;;;;;;3,0;;;;;;1,0;;;;2,0;;;;;;1,0;;;2,0;;;;;10,0;;;;;;9,0;;;;;;;5,0;5,0;;;;;;;;;;;;;;;;;;;;2,0;;;;;;1,0;;;;;;1,0;;;;;;;2,0;6,0;1,0;;;;;;;;;;;;;1,0;;20,0;;6,0;1,0;;;;;8,0;;3,0;1,0;;;;;3,0;;3,0;2,0;;1,0;;;2,0;;;;4,0;;;;;2,0;;;1,0;;;;1,0;;;;3,0;;;;;;;;;1,0;;2,0;7,0;;;;;;47,0;2,0;2,0;;;4,0;;;;;;;74,0;3,0;;;;;;2,0;;17,0;;6,0;3,0;;35,0;1,0;;;;;22,0;;;5,0;;27,0;;;;1,0;;;6,0;;5,0;14,0;;4,0;;;;;;;;;;;;;3,0;;;6,0;;1,0;;;;;;;;;;;;1,0;;;;;;;;;;;;;7,0;;;;;;;;6,0;;;;;;;;;;;;;;;;1,0;;;;;2,0;2,0;;;;;;;;;;;4,0;;;;32,0;2,0;;;;;;;;3,0;;;1,0;;;;;;;;;;;;;
engagement;;2,0;;;8,0;;3,0;33,0;;;1,0;;;;;;;;2,0;;;3,0;;;;;;;;3,0;;;14,0;;;;;44,0;;;3,0;;4,0;10,0;;;6,0;;;;1,0;;;;;4,0;27,0;;1,0;29,0;;;4,0;;;1,0;14,0;;;2,0;4,0;;1,0;1,0;;;1,0;17,0;25,0;1,0;;;;;;;6,0;;;1,0;5,0;;;;4,0;2,0;;3,0;;1,0;50,0;7,0;;;;;;39,0;;;4,0;7,0;2,0;3,0;4,0;;;;;8,0;;;;7,0;;;15,0;20,0;;1,0;18,0;;;1,0;;;12,0;;;2,0;;;2,0;5,0;;5,0;26,0;4,0;;;;9,0;4,0;;7,0;3,0;15,0;15,0;;2,0;;;4,0;6,0;;;;;;;83,0;7,0;27,0;11,0;5,0;6,0;10,0;;;;9,0;;;;;;14,0;13,0;;75,0;;14,0;;20,0;;;;2,0;7,0;7,0;;12,0;;14,0;1,0;2,0;;2,0;9,0;18,0;;6,0;;2,0;1,0;1,0;2,0;;;1,0;2,0;;;;5,0;;;1,0;;3,0;5,0;;3,0;;;;2,0;;1,0;;12,0;4,0;3,0;7,0;;2,0;1,0;;2,0;;;;5,0;3,0;1,0;;;4,0;;;;5,0;17,0;5,0;56,0;;9,0;6,0;;;1,0;4,0;;2,0;7,0;3,0;;8,0;1,0;;22,0;;;3,0;;1,0;6,0;1,0;;2,0;;;;;;;;;;;1,0;21,0;1,0;8,0;29,0;5,0;1,0;;3,0;5,0;;2,0;1,0;;9,0;;1,0;;11,0;;;;13,0;2,0;;1,0;;;;;3,0;;;;;;;;;;;;;;;;;;;;;;;;;;;;;;;;;;;;2,0;;;;;1,0;;;;;;;;4,0;;1,0;;;;;;;;;17,0;1,0;5,0;;;;;;;;3,0;;;;;;;;;;6,0;6,0;;;;;1,0;;;;;;;;1,0;1,0;;1,0;;;;;;;;2,0;;;;;;;;;;;;;;;;;;1,0;;;;;;;;;;;;;15,0;;;;;2,0;;;;;;;;;;;;;;3,0;;;;;;;;5,0;1,0;;;;;;;;;;1,0;5,0;;;;;;;;;;10,0;3,0;;;;4,0;3,0;;;;;;;;;;;1,0;;;;;;;;;;;;;;4,0;;;;;;1,0;;;;;1,0;1,0;;;;;;;2,0;6,0;;;;;;;;;1,0;1,0;;;;;;;;;;18,0;;;;;;;;1,0;2,0;;;;;4,0;;;;1,0;1,0;1,0;;3,0;;;6,0;;;;;;;;;;;;;;3,0;5,0;2,0;2,0;1,0;;2,0;;;1,0;2,0;;;;1,0;;6,0;;;;;;;;;;2,0;;;;;;7,0;;;;;;;;4,0;;7,0;9,0;5,0;;;;;2,0;2,0;;;;;;;;;;;;;;;;;;;;;;1,0;;;4,0;;;;;;;;;;;;;;;;;;;;;;;;;;;;;;;;;;;;;;;;;;;;;;;;;;;;;;;;;;;;;;;;;;;;;;;;1,0;;;;;5,0;;;;;;;;;;;;;;;;;;;;;;;;3,0;;;;;;;;;;;;;;;;;;;;;2,0;;;;1,0;;;;;;;2,0;;;;;;;;;1,0;;;;;;;11,0;;;;;;;2,0;;6,0;;8,0;;;;;;;;;1,0;;3,0;;;;;;;;;;;;;;;1,0;;;;;;;;;;;;;;;;;;;;;;;;;;;;;;;;1,0;;;;;;;;;;;;;;;;;;;;;;;;;;;;;;;;;;;;;1,0;;;;;;;;;;;;;;;;;;;4,0;;;;;;;;;;;;;;;;;;;;;;;;;
enter;;1,0;9,0;;3,0;;16,0;4,0;;8,0;;;;;8,0;;;;1,0;1,0;3,0;19,0;;;9,0;;;5,0;;10,0;2,0;20,0;32,0;;15,0;;2,0;8,0;;14,0;1,0;;2,0;14,0;;;;;12,0;;1,0;4,0;;1,0;;72,0;3,0;;4,0;47,0;;;4,0;;;;;;;15,0;84,0;1,0;29,0;;;8,0;;6,0;11,0;13,0;13,0;5,0;;;;2,0;1,0;;;5,0;24,0;;4,0;14,0;;4,0;;;5,0;13,0;40,0;21,0;;;;2,0;1,0;6,0;;;7,0;4,0;1,0;2,0;;;1,0;;1,0;5,0;;;;4,0;;;8,0;1,0;;;4,0;;;1,0;;1,0;;;;;2,0;;3,0;2,0;5,0;;10,0;;1,0;;;3,0;2,0;;4,0;;1,0;2,0;6,0;16,0;6,0;;2,0;;;9,0;2,0;232,0;;10,0;12,0;24,0;4,0;2,0;3,0;6,0;4,0;1,0;;;;;10,0;;;2,0;;5,0;;15,0;;2,0;;11,0;;15,0;;;1,0;;;;9,0;17,0;1,0;;;;4,0;2,0;;;;;;12,0;13,0;;;;2,0;1,0;;;1,0;;;;;;;;;;4,0;3,0;1,0;;17,0;1,0;6,0;;7,0;1,0;2,0;2,0;;3,0;;;;;;;;;;4,0;;;8,0;;1,0;;8,0;;;;;;;;;;;1,0;;;;;;;;1,0;;6,0;1,0;13,0;6,0;;;;;;;;2,0;6,0;6,0;;7,0;;8,0;;;;;4,0;;2,0;1,0;1,0;10,0;1,0;;;;;;;;2,0;;;;6,0;;;4,0;;15,0;;;;;;;;;;;3,0;;;;;1,0;;;;7,0;14,0;;;2,0;;;;;;;;17,0;;;2,0;;;;;;;;1,0;;;;1,0;;;1,0;3,0;;1,0;;1,0;;;;7,0;;2,0;;1,0;4,0;;1,0;;7,0;;;;;;;;3,0;;;;1,0;25,0;;;;1,0;;;6,0;;2,0;;;8,0;53,0;2,0;;;;;;;;;;;;;;;3,0;1,0;;;11,0;1,0;2,0;4,0;;1,0;;2,0;5,0;;;;;;1,0;;;1,0;5,0;;1,0;2,0;25,0;6,0;;;;9,0;;1,0;;;;;;;;;2,0;;;;15,0;3,0;;2,0;;2,0;;4,0;2,0;11,0;;;;;1,0;;;;17,0;;;;30,0;1,0;3,0;;;;;;2,0;;;;;;1,0;;;;1,0;;1,0;;1,0;;;;1,0;;;;;;;;;;5,0;;1,0;;;;;;;;1,0;;3,0;;;1,0;6,0;;;;;;;;;;;;;;1,0;;;;;;;;21,0;;;5,0;;;;;2,0;;;;;;;4,0;;;;;3,0;;;;;;;;;;1,0;;;1,0;;;;;;;;7,0;;;;;;;;;;2,0;;;37,0;;;9,0;;3,0;;;;;;;;;;;;;;;;;;;;;;;;;;;;;;;2,0;;;;2,0;;;;;;;;;;;;;;;1,0;1,0;;3,0;;;1,0;1,0;;;;;1,0;;;4,0;;;;4,0;;;;;;;;;8,0;;;;;;1,0;;;1,0;;1,0;;;;;;;;;;;1,0;;;;;;;;;5,0;;;;1,0;;;;1,0;;;;;;;;;;;;2,0;;;;;;;;2,0;;;;;;;;;;;;;;;3,0;;;;;;;;;;;;;6,0;;;;;;;3,0;;;;;1,0;;;;;1,0;;;;;21,0;;;;;2,0;;1,0;;;;;;;;;;;;;;;1,0;;;;;;1,0;;;;;;;;1,0;;2,0;;;;;;;;;;;;;;;;;;;;;;;1,0;;;;;;;;;;7,0;;;;;;;;;1,0;;;;;;;;1,0;;;;2,0;;;;;2,0;;;;;1,0;;;;;;;;;;;;;;;;1,0;;;1,0;;1,0;4,0;1,0;;;;;;2,0;;;;;;;;;;;;;;;;;;;;;;;;;;;;;;;;;;;;;;;;
execute;;2,0;;3,0;64,0;;1,0;31,0;11,0;17,0;1,0;22,0;1,0;;49,0;2,0;;1,0;7,0;191,0;6,0;158,0;4,0;20,0;70,0;;1,0;87,0;;30,0;34,0;36,0;130,0;4,0;36,0;2,0;9,0;7,0;3,0;50,0;9,0;9,0;7,0;4,0;;;;12,0;44,0;15,0;32,0;22,0;9,0;14,0;;333,0;105,0;;8,0;27,0;3,0;1,0;157,0;;2,0;2,0;8,0;;3,0;106,0;10,0;7,0;1,0;8,0;;36,0;;6,0;24,0;2,0;1,0;317,0;242,0;3,0;1,0;;4,0;;;20,0;13,0;7,0;20,0;26,0;7,0;;;24,0;99,0;;2,0;57,0;;8,0;13,0;7,0;2,0;256,0;;;9,0;3,0;1,0;1,0;1,0;2,0;;;;;;;3,0;63,0;;;58,0;;5,0;8,0;;7,0;;;;2,0;1,0;;;1,0;;;3,0;9,0;4,0;;2,0;18,0;;;;;1,0;;;;;;2,0;25,0;1,0;;;;5,0;;7,0;20,0;7,0;1,0;1,0;;12,0;;11,0;3,0;;30,0;;;4,0;;1,0;;;;;35,0;;18,0;;;;21,0;;;;;5,0;;;;;;;9,0;;;;;;27,0;1,0;;5,0;34,0;13,0;;;;;1,0;;;;;;;;;;;;;17,0;3,0;;2,0;10,0;6,0;2,0;;18,0;;;3,0;;;;;4,0;9,0;;7,0;;;;5,0;;;;6,0;;;2,0;;1,0;;;1,0;;;;;;11,0;6,0;;1,0;1,0;;;;2,0;;16,0;2,0;20,0;23,0;;;;;9,0;;;52,0;46,0;;;;;20,0;1,0;1,0;;;7,0;;;12,0;3,0;;;;;;;;;;6,0;;8,0;;1,0;;;;;11,0;1,0;;;;;;;2,0;;;9,0;;;6,0;;39,0;2,0;;6,0;5,0;35,0;13,0;;1,0;;;;;;2,0;;;;6,0;7,0;1,0;;1,0;4,0;5,0;;;4,0;84,0;29,0;1,0;2,0;;15,0;9,0;2,0;7,0;221,0;1,0;;1,0;;11,0;29,0;6,0;17,0;;;10,0;8,0;3,0;3,0;5,0;;7,0;;2,0;1,0;6,0;;3,0;26,0;8,0;1,0;;8,0;;5,0;4,0;11,0;1,0;;18,0;;3,0;16,0;3,0;7,0;35,0;1,0;1,0;33,0;2,0;5,0;20,0;3,0;2,0;;2,0;2,0;1,0;;;;1,0;1,0;1,0;2,0;3,0;30,0;118,0;1,0;5,0;2,0;1,0;;;10,0;;3,0;1,0;1,0;207,0;1,0;3,0;1,0;2,0;;1,0;4,0;;;3,0;;2,0;101,0;;;;1,0;30,0;1,0;10,0;8,0;5,0;1,0;3,0;2,0;;1,0;10,0;2,0;1,0;8,0;6,0;12,0;;2,0;23,0;21,0;;;2,0;;2,0;7,0;;2,0;9,0;;;;;;;;7,0;79,0;10,0;;2,0;3,0;1,0;4,0;;;1,0;;;36,0;15,0;;;2,0;;;;1,0;9,0;1,0;;1,0;;;;1,0;;;;;3,0;11,0;3,0;2,0;9,0;5,0;;1,0;16,0;;6,0;;1,0;1,0;36,0;;3,0;6,0;;2,0;;;;1,0;;2,0;;;;;;32,0;;;11,0;1,0;11,0;;3,0;8,0;;;1,0;2,0;3,0;;;;;7,0;;;1,0;;2,0;;56,0;;;1,0;;;;1,0;;2,0;;;;1,0;1,0;;;5,0;;;4,0;1,0;;;;;2,0;;;;;57,0;6,0;;;;3,0;;;;;;1,0;11,0;;1,0;;;1,0;;;;;;;;1,0;;;;8,0;;;;4,0;;;1,0;1,0;;1,0;;;3,0;;2,0;8,0;;;;;2,0;2,0;1,0;;4,0;;;6,0;6,0;5,0;4,0;;2,0;;1,0;17,0;1,0;5,0;1,0;2,0;1,0;;;;;;120,0;4,0;1,0;;6,0;;;;1,0;;;;;;;1,0;;;;;;10,0;;1,0;13,0;1,0;;1,0;1,0;14,0;;;;;4,0;1,0;7,0;2,0;8,0;2,0;;;;;;8,0;4,0;2,0;;;2,0;1,0;;;1,0;;;;4,0;7,0;2,0;4,0;;;3,0;1,0;2,0;1,0;;;1,0;11,0;;;;;3,0;25,0;1,0;;;2,0;;;4,0;;1,0;12,0;;;;13,0;;9,0;;;;;1,0;7,0;;;;;;;;;;1,0;;;2,0;1,0;;;;;;;;;;10,0;;;;1,0;;1,0;;;5,0;;;2,0;;;;;;1,0;;7,0;11,0;2,0;;;;;;;;;;;;6,0;;4,0;;;;3,0;;;4,0;;1,0;;;1,0;;;;;;;;;;;;;;;;4,0;1,0;;1,0;20,0;;;;;;;;;;1,0;;1,0;4,0;7,0;;;;;;;;;;;3,0;32,0;;;;;;;;;19,0;;;;;;;;;;;;;;1,0;;;;;;;;;;;;;;;;;;1,0;;;;;;;;;;;;;1,0;;;;;;;1,0;;2,0;4,0;;;;;2,0;;;;
exposure;;2,0;133,0;3,0;83,0;;5,0;174,0;187,0;216,0;5,0;16,0;;4,0;;2,0;6,0;48,0;;4,0;221,0;612,0;8,0;127,0;117,0;1,0;1,0;95,0;;54,0;50,0;337,0;231,0;37,0;106,0;;4,0;9,0;1,0;25,0;6,0;;5,0;85,0;9,0;5,0;;7,0;89,0;18,0;19,0;64,0;8,0;5,0;;732,0;87,0;;15,0;30,0;;8,0;166,0;;2,0;;16,0;;10,0;129,0;42,0;11,0;23,0;;;39,0;;83,0;45,0;3,0;4,0;43,0;39,0;5,0;2,0;;37,0;10,0;5,0;69,0;92,0;13,0;27,0;156,0;6,0;4,0;3,0;20,0;29,0;1,0;22,0;67,0;;8,0;1,0;9,0;24,0;279,0;;;3,0;4,0;13,0;17,0;1,0;80,0;1,0;;4,0;33,0;;;10,0;65,0;;;88,0;;2,0;2,0;2,0;13,0;2,0;;;32,0;7,0;;;6,0;8,0;2,0;9,0;1,0;18,0;4,0;8,0;89,0;;;;;;;;;;19,0;21,0;222,0;4,0;32,0;1,0;;;1,0;104,0;127,0;;;23,0;2,0;17,0;13,0;4,0;29,0;;52,0;;;;3,0;4,0;11,0;1,0;4,0;1,0;222,0;;11,0;;;4,0;26,0;;8,0;;;3,0;4,0;;1,0;3,0;15,0;;2,0;7,0;;5,0;2,0;1,0;;;;;911,0;7,0;1,0;6,0;;;1,0;8,0;;;31,0;2,0;;;;1,0;;5,0;1,0;193,0;3,0;;15,0;28,0;4,0;;;2,0;;;12,0;13,0;;;;5,0;1,0;;9,0;;;;20,0;19,0;;34,0;3,0;;;1,0;;1,0;;;;;1,0;;;;1,0;;;7,0;;;;5,0;23,0;;50,0;3,0;41,0;11,0;1,0;;;4,0;12,0;;3,0;;111,0;;;;1,0;99,0;;;;;55,0;3,0;;34,0;17,0;;2,0;1,0;;2,0;;;;;21,0;;;;2,0;;2,0;2,0;;4,0;3,0;;;;16,0;39,0;6,0;1,0;;;46,0;;25,0;;;104,0;3,0;1,0;47,0;18,0;46,0;;3,0;3,0;16,0;;2,0;;;4,0;1,0;1,0;;3,0;27,0;2,0;8,0;7,0;3,0;4,0;;3,0;29,0;4,0;17,0;19,0;19,0;;3,0;211,0;13,0;1,0;17,0;1,0;52,0;5,0;19,0;2,0;19,0;11,0;60,0;;;101,0;24,0;201,0;45,0;51,0;3,0;;;;5,0;4,0;;;9,0;7,0;11,0;;10,0;;14,0;;;;;20,0;;33,0;1,0;;4,0;111,0;2,0;2,0;29,0;5,0;34,0;4,0;5,0;;16,0;;;4,0;;;13,0;12,0;22,0;1,0;9,0;1,0;54,0;12,0;7,0;3,0;1,0;;56,0;10,0;52,0;;;1,0;2,0;18,0;;;;4,0;7,0;;7,0;8,0;1,0;149,0;;6,0;97,0;;;;2,0;;1,0;;;;;;2,0;6,0;1,0;2,0;1,0;1,0;141,0;;23,0;;1,0;49,0;17,0;1,0;6,0;3,0;;;;3,0;6,0;43,0;;;;13,0;;;;;1,0;3,0;;;5,0;;34,0;;;3,0;;;54,0;;;;3,0;1,0;2,0;22,0;;;20,0;;1,0;;;;4,0;6,0;;;1,0;;1,0;;4,0;4,0;;;15,0;1,0;;8,0;1,0;;49,0;144,0;5,0;;3,0;;;5,0;2,0;;;;6,0;;;;;;3,0;;;;;70,0;7,0;9,0;3,0;;;;9,0;;;;2,0;5,0;19,0;;;1,0;;;;;7,0;;;11,0;;;18,0;;6,0;;;;;2,0;5,0;;20,0;;;75,0;;;;;;9,0;;;;1,0;79,0;;;8,0;1,0;2,0;;;18,0;;;;;;1,0;;;12,0;40,0;;;;;;;5,0;;;;;;;2,0;7,0;;;;26,0;;;;1,0;;;7,0;;;1,0;3,0;16,0;70,0;4,0;;;2,0;18,0;;2,0;11,0;12,0;;18,0;;1,0;2,0;17,0;2,0;32,0;;;;3,0;;7,0;1,0;;15,0;5,0;;6,0;6,0;16,0;1,0;;;10,0;;2,0;;;5,0;;;;15,0;3,0;;81,0;4,0;8,0;;;2,0;1,0;5,0;2,0;;14,0;9,0;;8,0;;1,0;17,0;12,0;5,0;;;;;6,0;;1,0;;24,0;;1,0;10,0;8,0;;14,0;5,0;;;1,0;5,0;3,0;9,0;;;;;1,0;41,0;20,0;5,0;;;1,0;;3,0;;;11,0;11,0;;2,0;2,0;;;;1,0;;6,0;;;2,0;;;;;;13,0;;;9,0;2,0;;;;10,0;;2,0;3,0;1,0;5,0;;;12,0;;;63,0;1,0;;;15,0;3,0;;6,0;13,0;;;;;;1,0;;6,0;;1,0;4,0;;;;;;;;;43,0;;7,0;;4,0;;;;1,0;3,0;26,0;1,0;;;;;;;;;11,0;;;;3,0;;;;;;22,0;;;;;;;;;;;;5,0;;1,0;;2,0;7,0;1,0;;;;;;;;3,0;;1,0;;1,0;5,0;;1,0;;;;;3,0;2,0;;;;1,0;;;;;;1,0;5,0;;;;;;;;;12,0;1,0;;;1,0;;;;2,0;;;;;;;;;;;;;1,0;;;;;22,0;;;;;;;;;;;;;;18,0;;;;;;;;;;;;;;;;;;
extend;;7,0;5,0;1,0;42,0;;189,0;165,0;;33,0;20,0;;8,0;1,0;6,0;2,0;1,0;;37,0;1,0;;6,0;3,0;;7,0;;10,0;55,0;7,0;3,0;1,0;2,0;68,0;9,0;24,0;;1,0;422,0;3,0;26,0;32,0;;30,0;51,0;3,0;;9,0;;22,0;2,0;8,0;4,0;;4,0;4,0;89,0;89,0;;32,0;269,0;1,0;;36,0;;6,0;20,0;3,0;3,0;;13,0;133,0;3,0;26,0;19,0;34,0;2,0;4,0;39,0;140,0;28,0;5,0;3,0;12,0;1,0;;1,0;36,0;;2,0;4,0;22,0;16,0;1,0;24,0;3,0;44,0;1,0;4,0;6,0;14,0;195,0;41,0;;36,0;1,0;;;52,0;;;7,0;38,0;37,0;45,0;25,0;1,0;5,0;;48,0;131,0;2,0;8,0;;44,0;;;39,0;51,0;;30,0;39,0;;;74,0;4,0;9,0;33,0;18,0;52,0;1,0;;3,0;14,0;40,0;8,0;6,0;90,0;62,0;;1,0;;60,0;73,0;5,0;11,0;35,0;101,0;90,0;9,0;85,0;;1,0;57,0;5,0;3,0;25,0;3,0;26,0;;14,0;182,0;3,0;80,0;88,0;8,0;58,0;64,0;14,0;1,0;;18,0;20,0;9,0;;33,0;47,0;102,0;104,0;;431,0;4,0;61,0;;39,0;13,0;2,0;;;13,0;10,0;17,0;41,0;10,0;219,0;26,0;2,0;6,0;21,0;18,0;164,0;;10,0;;8,0;15,0;20,0;7,0;6,0;2,0;17,0;34,0;18,0;;2,0;86,0;;12,0;;1,0;6,0;7,0;;8,0;13,0;6,0;31,0;13,0;1,0;40,0;2,0;86,0;13,0;9,0;94,0;18,0;18,0;25,0;14,0;11,0;28,0;16,0;1,0;14,0;93,0;;;38,0;52,0;1,0;3,0;;14,0;77,0;12,0;38,0;9,0;;3,0;68,0;10,0;19,0;78,0;6,0;;18,0;16,0;1,0;2,0;2,0;18,0;20,0;11,0;1,0;18,0;7,0;5,0;20,0;35,0;6,0;41,0;;30,0;2,0;4,0;1,0;51,0;2,0;23,0;15,0;2,0;3,0;11,0;23,0;11,0;28,0;6,0;18,0;28,0;31,0;24,0;15,0;6,0;35,0;12,0;31,0;1,0;8,0;4,0;17,0;9,0;14,0;9,0;60,0;33,0;;8,0;8,0;27,0;11,0;;1,0;1,0;2,0;;;;;;;;3,0;;;;;;;3,0;14,0;4,0;11,0;2,0;;;;2,0;;;;1,0;;;;3,0;;9,0;;;2,0;;;21,0;;2,0;;4,0;3,0;;;94,0;18,0;3,0;2,0;;2,0;;;;;9,0;4,0;;37,0;;18,0;;7,0;4,0;1,0;;5,0;;;;1,0;;9,0;5,0;;;9,0;10,0;2,0;1,0;;;6,0;;4,0;3,0;10,0;1,0;;4,0;12,0;8,0;;3,0;1,0;1,0;3,0;;;;2,0;3,0;;;;3,0;;;2,0;;5,0;;1,0;2,0;;9,0;;1,0;13,0;10,0;4,0;;;3,0;;;;;;2,0;;2,0;19,0;1,0;;;;4,0;16,0;3,0;8,0;7,0;20,0;;;;;;;;1,0;23,0;3,0;;;2,0;;6,0;;3,0;8,0;19,0;5,0;;1,0;;4,0;;3,0;;59,0;3,0;;8,0;;2,0;28,0;;;;7,0;17,0;15,0;;;;2,0;26,0;2,0;4,0;;;2,0;1,0;;;;;7,0;;;;10,0;1,0;;;;;;1,0;11,0;2,0;4,0;2,0;;7,0;1,0;4,0;2,0;;1,0;13,0;3,0;2,0;;2,0;40,0;;3,0;;11,0;;13,0;;2,0;;2,0;;;;46,0;;47,0;;3,0;2,0;2,0;;12,0;1,0;;14,0;12,0;;;;2,0;3,0;10,0;1,0;1,0;1,0;2,0;2,0;3,0;26,0;2,0;;1,0;3,0;17,0;;1,0;4,0;1,0;4,0;4,0;6,0;;;;;4,0;;;1,0;1,0;1,0;;5,0;2,0;3,0;;;9,0;11,0;;44,0;7,0;12,0;;1,0;17,0;19,0;21,0;3,0;6,0;1,0;2,0;6,0;6,0;;2,0;;3,0;4,0;;21,0;;11,0;30,0;6,0;6,0;2,0;4,0;7,0;3,0;8,0;;1,0;4,0;7,0;;11,0;5,0;28,0;;;;8,0;21,0;2,0;3,0;3,0;;;;2,0;2,0;;2,0;;;8,0;;;;1,0;;;;;10,0;20,0;;;;;;2,0;1,0;2,0;;;;3,0;1,0;;;6,0;;;3,0;2,0;;4,0;4,0;;13,0;4,0;;6,0;;;;;1,0;;;7,0;;3,0;2,0;;;;;;;;;;1,0;7,0;;;;1,0;;;;;;;17,0;;;;;;;;1,0;;;;1,0;;7,0;;;9,0;2,0;;2,0;;;;;;;6,0;4,0;1,0;;;;;;3,0;4,0;1,0;;5,0;;9,0;1,0;;;14,0;;;4,0;3,0;10,0;;;3,0;;;13,0;;;1,0;1,0;;3,0;;8,0;;;;;;;;3,0;3,0;1,0;;;2,0;;1,0;2,0;;;;16,0;;;4,0;;;;9,0;2,0;;;;1,0;;3,0;;3,0;2,0;20,0;;;19,0;;;;3,0;2,0;10,0;1,0;;3,0;;22,0;;;;5,0;;;;4,0;4,0;1,0;;;3,0;2,0;;;4,0;;;;;;;;2,0;3,0;24,0;9,0;20,0;;;;2,0;;;3,0;;;;;;;;2,0;;;7,0;1,0;;2,0;6,0;3,0;;5,0;7,0;;;;;;;;;;;;;;1,0;;;;2,0;;6,0;1,0;;;7,0;;11,0;1,0;;;13,0;2,0;;;7,0;;;;;;;;;;;2,0;2,0;;;;;;;;2,0;;;8,0;2,0;;;;;;;;1,0;;;;
external;;16,0;6,0;;45,0;;2,0;56,0;2,0;41,0;;3,0;;;14,0;;1,0;5,0;6,0;28,0;5,0;96,0;;1,0;;;;130,0;;11,0;2,0;15,0;774,0;2,0;115,0;9,0;5,0;13,0;3,0;83,0;6,0;;14,0;20,0;;1,0;;2,0;;4,0;7,0;18,0;2,0;4,0;;269,0;46,0;;6,0;103,0;;;78,0;;;10,0;;1,0;7,0;71,0;39,0;4,0;5,0;6,0;5,0;10,0;;14,0;39,0;70,0;9,0;10,0;7,0;1,0;;2,0;30,0;;3,0;17,0;40,0;;1,0;106,0;2,0;9,0;;61,0;20,0;20,0;116,0;109,0;;51,0;1,0;30,0;3,0;142,0;7,0;1,0;16,0;14,0;3,0;29,0;5,0;3,0;;;9,0;13,0;2,0;;2,0;33,0;3,0;3,0;68,0;36,0;;41,0;21,0;1,0;;;4,0;12,0;12,0;;24,0;;;17,0;;13,0;9,0;35,0;42,0;58,0;;;1,0;5,0;11,0;2,0;1,0;6,0;13,0;57,0;16,0;33,0;8,0;13,0;8,0;4,0;;3,0;1,0;124,0;;1,0;34,0;9,0;32,0;34,0;2,0;6,0;19,0;46,0;4,0;;9,0;5,0;2,0;2,0;1,0;2,0;7,0;59,0;;49,0;;;4,0;140,0;1,0;1,0;3,0;;10,0;12,0;1,0;1,0;5,0;24,0;1,0;4,0;2,0;;7,0;5,0;1,0;7,0;6,0;4,0;2,0;12,0;76,0;6,0;;5,0;3,0;60,0;1,0;;54,0;;8,0;1,0;1,0;;;9,0;12,0;5,0;10,0;5,0;;12,0;13,0;1,0;33,0;2,0;6,0;8,0;3,0;10,0;2,0;12,0;3,0;2,0;2,0;1,0;2,0;117,0;2,0;;3,0;14,0;;4,0;;2,0;5,0;5,0;14,0;2,0;14,0;;;2,0;1,0;17,0;2,0;;8,0;54,0;2,0;;;12,0;1,0;3,0;5,0;7,0;1,0;3,0;;15,0;8,0;4,0;;;2,0;1,0;;1,0;;7,0;2,0;;5,0;2,0;31,0;;7,0;2,0;;5,0;3,0;2,0;5,0;6,0;1,0;;10,0;;;2,0;2,0;2,0;2,0;6,0;2,0;10,0;;63,0;;6,0;45,0;;24,0;;;;;;;;;;3,0;19,0;1,0;2,0;;1,0;1,0;5,0;;5,0;3,0;28,0;;;;2,0;;;;;2,0;;2,0;1,0;43,0;9,0;;;6,0;1,0;;;;;24,0;31,0;2,0;2,0;;2,0;;11,0;6,0;1,0;2,0;;1,0;4,0;;27,0;;22,0;;;13,0;21,0;;5,0;;;;1,0;5,0;;;3,0;;;1,0;1,0;1,0;16,0;1,0;1,0;3,0;1,0;;;31,0;1,0;27,0;2,0;2,0;18,0;20,0;4,0;1,0;7,0;;15,0;3,0;;;1,0;2,0;3,0;4,0;1,0;3,0;10,0;38,0;;1,0;4,0;3,0;42,0;1,0;23,0;;;;3,0;1,0;116,0;;8,0;18,0;11,0;7,0;2,0;;;;;6,0;9,0;3,0;4,0;22,0;;;20,0;;;6,0;;6,0;2,0;;;7,0;;4,0;;;7,0;6,0;7,0;;9,0;2,0;12,0;11,0;8,0;46,0;22,0;2,0;9,0;5,0;;1,0;;;1,0;9,0;4,0;;2,0;2,0;7,0;;1,0;;3,0;79,0;47,0;22,0;;7,0;5,0;1,0;;;1,0;;8,0;2,0;1,0;2,0;3,0;9,0;;10,0;37,0;14,0;;3,0;;1,0;1,0;;6,0;;;4,0;;4,0;;6,0;;1,0;4,0;;1,0;7,0;;3,0;;1,0;13,0;12,0;;41,0;;;2,0;9,0;7,0;4,0;4,0;;3,0;10,0;;7,0;;5,0;1,0;4,0;;;2,0;1,0;4,0;3,0;57,0;37,0;2,0;;;18,0;;;;10,0;10,0;;5,0;;;4,0;;9,0;;3,0;;;1,0;;2,0;7,0;5,0;;1,0;;;16,0;4,0;1,0;1,0;;;;2,0;3,0;;;2,0;12,0;;1,0;9,0;;2,0;;;;1,0;;1,0;1,0;1,0;;;1,0;;;;;;1,0;13,0;1,0;1,0;;3,0;1,0;1,0;;;;;;;1,0;1,0;;;1,0;;;;1,0;4,0;;;;;;;6,0;2,0;;8,0;7,0;3,0;;6,0;8,0;;;5,0;;;;;1,0;1,0;;;1,0;1,0;;;;;;;;5,0;;;;4,0;3,0;;;1,0;;16,0;1,0;2,0;1,0;;;;;;1,0;;;2,0;;;;;;;;;;;8,0;;3,0;;5,0;3,0;;;;3,0;;;;1,0;;;1,0;;;;;;;;3,0;1,0;;;3,0;;1,0;;;;7,0;5,0;2,0;;;;;;;;6,0;7,0;2,0;8,0;7,0;;2,0;4,0;25,0;1,0;;5,0;;1,0;;;;4,0;;;;;3,0;;;;;2,0;;;2,0;;;;1,0;;1,0;;;;;;10,0;;2,0;;2,0;1,0;;1,0;1,0;25,0;10,0;;1,0;3,0;2,0;4,0;4,0;;;;1,0;3,0;;;;2,0;;;10,0;;;2,0;3,0;;;;;2,0;3,0;2,0;;2,0;;;4,0;;;1,0;;;;;;;;;;;;1,0;;2,0;;4,0;;;;;;;;;1,0;1,0;;2,0;;;;;1,0;;;;;4,0;;;;;5,0;;2,0;;3,0;;5,0;;;;;;3,0;2,0;;;;;2,0;;;4,0;;;;;4,0;;;;;15,0;;;1,0;;;;;;;;;;;;3,0;;;;;;;;;;2,0;;5,0;;1,0;;;;;;;;;;;;5,0;;;;;;;;1,0;
eyepiece;;12,0;1,0;;1,0;;7,0;6,0;;;;;;;;;;;;;14,0;12,0;;;;;;;;;;;11,0;;5,0;;;8,0;;26,0;;;;;;;;55,0;1,0;;;;;;;81,0;23,0;;50,0;85,0;;2,0;5,0;;;;;9,0;;4,0;84,0;4,0;11,0;;;;;;5,0;1,0;;3,0;;1,0;;3,0;;;;;2,0;;;;;1,0;;;;;6,0;57,0;;;;1,0;;25,0;;;2,0;9,0;;8,0;1,0;;;;1,0;9,0;;;;;;;4,0;3,0;;1,0;;;1,0;;;;5,0;;;;;;;9,0;;3,0;8,0;6,0;;4,0;;;2,0;;;;;;3,0;12,0;1,0;;;2,0;;;;18,0;;2,0;12,0;8,0;13,0;18,0;;1,0;3,0;;;;1,0;;;2,0;;17,0;3,0;3,0;;57,0;;;;1,0;;7,0;;;1,0;2,0;;1,0;4,0;8,0;;;;;;2,0;;;;;;3,0;;4,0;1,0;16,0;2,0;;;;;;32,0;;1,0;;;;;5,0;2,0;;;1,0;;;2,0;;2,0;1,0;;1,0;;3,0;;;;;;6,0;;;;;;;;;7,0;1,0;18,0;;3,0;;;;;3,0;4,0;;;;;;;1,0;1,0;;;3,0;;;2,0;11,0;6,0;4,0;;;;;;;;2,0;;;;;;;;;;2,0;5,0;;;;;;3,0;;;;;;;;;;;;;;;;2,0;2,0;;;;;;;;;;1,0;;;;;;1,0;;6,0;3,0;;;;;;;;;;;;4,0;;;;;;1,0;;;;;;;;;;;;;9,0;;;;;;1,0;;6,0;1,0;;;;8,0;;;;;;;;;1,0;;;;;;;;;;4,0;;;;;;;;;;;;;;;;;;;;;;1,0;;1,0;;1,0;;;;;;;;;;;;;;;;;;;;;;;;;;;1,0;;;;;;;;;;;;;;;;;;;;;;;;;11,0;;;3,0;41,0;8,0;;;;;;;;;;;;;3,0;;;;;;4,0;;;;;;;;;;;6,0;10,0;;;;;;;;;;;;;;;;2,0;;;;;;2,0;;;;;;;1,0;;;6,0;;;1,0;;;;1,0;;;;;;;;;;;;;;;;;;;;;;;;;;;;;;;;;;;;7,0;;;;;;;;;;;;;;1,0;;;;;;;;;;;;;;;;5,0;1,0;;;11,0;;;;;;1,0;;;;;;;;;7,0;;;;;;;;;;;;2,0;;;;;;;;;;;;;;;;;;;;;;;;;;;;;;;;;;;;;;;;13,0;;;;;;;;;;;;;;;;;1,0;;2,0;;;;;;;;;;;;;;2,0;;;;;;;;1,0;;;;14,0;;3,0;;;;;;;23,0;1,0;;;;;;;;;;;;;;;;;1,0;;;;;;;;;;;;;;;;;;;1,0;;;;;;;;;;;;;;;;;;;;;;2,0;;;;;;;;;6,0;;;;;3,0;2,0;;;;;;;;;;;1,0;;;;;;;;;;;;;;;;;;;;;;;;;;;;;;;;;;8,0;;;;;;;;;;;;;;;;;;;;;;;;;1,0;;;;;;;1,0;;;5,0;;;;;1,0;;;2,0;;;;;;;;;;;;;;;;;;3,0;;;;;;;;;;;;;;;;2,0;;;;;;;;;;;;;;;;;;;;;;;;;;;;;;;;;;;;;;;;;;;;;;
face;;5,0;90,0;3,0;60,0;10,0;29,0;178,0;18,0;64,0;47,0;4,0;7,0;;27,0;8,0;;2,0;70,0;7,0;12,0;131,0;20,0;4,0;5,0;;6,0;405,0;21,0;776,0;350,0;197,0;318,0;1,0;47,0;;9,0;224,0;7,0;171,0;43,0;;12,0;164,0;;6,0;1,0;6,0;50,0;2,0;22,0;87,0;1,0;37,0;2,0;1355,0;219,0;;3,0;362,0;1,0;2,0;138,0;9,0;;1,0;4,0;;2,0;22,0;73,0;46,0;8,0;20,0;7,0;8,0;9,0;100,0;279,0;7,0;5,0;164,0;15,0;3,0;11,0;5,0;136,0;5,0;30,0;25,0;49,0;2,0;85,0;28,0;137,0;21,0;1,0;43,0;61,0;88,0;458,0;62,0;1,0;4,0;4,0;;4,0;203,0;4,0;3,0;11,0;57,0;4,0;19,0;25,0;1,0;4,0;;33,0;149,0;;2,0;;11,0;;6,0;49,0;51,0;;11,0;59,0;1,0;13,0;26,0;3,0;11,0;82,0;4,0;7,0;19,0;2,0;1,0;13,0;;21,0;9,0;119,0;120,0;3,0;2,0;;40,0;34,0;2,0;6,0;6,0;25,0;64,0;18,0;58,0;16,0;6,0;46,0;21,0;;30,0;24,0;84,0;2,0;14,0;131,0;32,0;82,0;91,0;14,0;40,0;57,0;10,0;2,0;1,0;6,0;8,0;16,0;2,0;3,0;52,0;75,0;164,0;;175,0;;25,0;23,0;43,0;5,0;14,0;2,0;2,0;14,0;9,0;6,0;26,0;5,0;418,0;5,0;12,0;15,0;17,0;6,0;61,0;3,0;14,0;4,0;2,0;3,0;47,0;5,0;28,0;3,0;2,0;45,0;12,0;5,0;4,0;38,0;8,0;62,0;3,0;3,0;22,0;1,0;;5,0;20,0;20,0;55,0;14,0;33,0;605,0;18,0;37,0;1,0;11,0;68,0;;46,0;5,0;17,0;29,0;22,0;;;8,0;24,0;5,0;;6,0;42,0;;;9,0;34,0;30,0;8,0;10,0;5,0;40,0;;18,0;13,0;1,0;166,0;9,0;1,0;;1,0;2,0;1,0;1,0;31,0;2,0;38,0;;11,0;;9,0;17,0;285,0;15,0;67,0;;1,0;2,0;15,0;11,0;10,0;13,0;62,0;10,0;26,0;3,0;1,0;51,0;7,0;10,0;7,0;6,0;37,0;101,0;7,0;13,0;11,0;;;11,0;2,0;3,0;22,0;8,0;9,0;3,0;17,0;6,0;22,0;1,0;16,0;3,0;5,0;1,0;;60,0;4,0;1,0;;;4,0;14,0;5,0;;6,0;2,0;14,0;2,0;33,0;1,0;1,0;14,0;20,0;;13,0;20,0;6,0;8,0;;2,0;;2,0;;5,0;;8,0;1,0;5,0;;52,0;28,0;8,0;8,0;3,0;10,0;1,0;2,0;;6,0;10,0;33,0;1,0;;6,0;28,0;8,0;4,0;2,0;4,0;;;3,0;9,0;3,0;55,0;6,0;6,0;15,0;;9,0;;2,0;174,0;15,0;6,0;23,0;;7,0;;;;6,0;17,0;3,0;2,0;7,0;30,0;;2,0;;;83,0;;24,0;2,0;17,0;;;5,0;5,0;7,0;3,0;17,0;6,0;28,0;3,0;;5,0;;7,0;1,0;;2,0;1,0;1,0;16,0;75,0;1,0;;3,0;26,0;6,0;13,0;50,0;19,0;1,0;9,0;4,0;42,0;3,0;;12,0;4,0;5,0;;;9,0;;3,0;13,0;7,0;26,0;4,0;38,0;3,0;;96,0;1,0;;;5,0;28,0;2,0;198,0;439,0;36,0;;;5,0;;22,0;40,0;;;19,0;2,0;20,0;;17,0;34,0;28,0;2,0;;1,0;;2,0;2,0;26,0;2,0;7,0;7,0;7,0;3,0;1,0;13,0;4,0;11,0;2,0;5,0;5,0;10,0;6,0;2,0;68,0;44,0;4,0;13,0;;2,0;;30,0;2,0;;;2,0;2,0;2,0;13,0;;;;2,0;3,0;;;;1,0;;7,0;5,0;4,0;1,0;2,0;;;26,0;3,0;;;1,0;1,0;2,0;;;7,0;15,0;4,0;;13,0;14,0;74,0;9,0;;3,0;;;;;;;;5,0;;1,0;;;4,0;176,0;6,0;1,0;18,0;4,0;16,0;4,0;10,0;;5,0;;;5,0;9,0;;;;6,0;1,0;1,0;1,0;9,0;2,0;;;;;1,0;2,0;6,0;1,0;3,0;;;5,0;;;1,0;;5,0;2,0;6,0;;1,0;1,0;1,0;;;;7,0;;;2,0;10,0;3,0;;12,0;;;2,0;25,0;1,0;33,0;;;;;14,0;78,0;14,0;;6,0;5,0;;10,0;;2,0;19,0;10,0;;;3,0;48,0;;4,0;;;4,0;;;3,0;1,0;3,0;;1,0;2,0;9,0;;;;3,0;24,0;;;;1,0;;3,0;;;;2,0;17,0;2,0;1,0;6,0;;;2,0;;;;;;;21,0;4,0;41,0;;4,0;1,0;1,0;;1,0;1,0;1,0;20,0;;17,0;1,0;1,0;;;;5,0;1,0;1,0;;6,0;;17,0;12,0;;;85,0;;5,0;3,0;;11,0;;;6,0;4,0;2,0;3,0;2,0;1,0;;4,0;;8,0;;;;;2,0;3,0;;3,0;;54,0;6,0;3,0;5,0;7,0;14,0;2,0;22,0;;38,0;;;20,0;1,0;4,0;3,0;1,0;;;;140,0;;;31,0;17,0;;;;1,0;;16,0;4,0;;;;17,0;;;;;1,0;;35,0;2,0;1,0;;1,0;3,0;6,0;;2,0;11,0;;;1,0;14,0;;;;3,0;;;16,0;;;7,0;3,0;10,0;36,0;1,0;1,0;;1,0;;;;9,0;;;9,0;;7,0;5,0;;;3,0;;1,0;;3,0;2,0;4,0;;3,0;3,0;2,0;;;;;29,0;17,0;;;16,0;;7,0;2,0;;;;1,0;;;;;;1,0;;;3,0;3,0;;1,0;7,0;2,0;;;;23,0;;;4,0;1,0;;;1,0;;1,0;;;;;;;92,0;;8,0;;;3,0;1,0;;2,0;;17,0;;;1,0;1,0;9,0;;4,0;33,0;;;;;3,0;;;;;11,0;;7,0;4,0;;;;;;;;3,0;;1,0;1,0;;;12,0;;;;1,0;13,0;2,0;4,0;;;8,0;;5,0;;1,0;;;;;;;25,0;2,0;;1,0;;;;38,0;;2,0;;;;;;;7,0;;;;;88,0;;;;3,0
feature;;3,0;54,0;4,0;22,0;;1,0;132,0;27,0;56,0;8,0;4,0;;3,0;10,0;6,0;;;25,0;16,0;5,0;26,0;24,0;3,0;1,0;3,0;1,0;131,0;1,0;100,0;16,0;111,0;84,0;12,0;20,0;1,0;3,0;3,0;3,0;1,0;13,0;4,0;;9,0;3,0;4,0;;2,0;35,0;1,0;7,0;32,0;;12,0;2,0;428,0;82,0;;13,0;13,0;1,0;2,0;141,0;12,0;24,0;2,0;8,0;;2,0;5,0;18,0;;;4,0;;;;317,0;163,0;5,0;;36,0;12,0;;;1,0;33,0;4,0;25,0;47,0;11,0;4,0;1,0;7,0;10,0;7,0;1,0;6,0;44,0;;23,0;34,0;;;10,0;;3,0;7,0;;;5,0;;10,0;10,0;5,0;3,0;;;;5,0;;;;;;;30,0;3,0;1,0;3,0;4,0;5,0;2,0;;3,0;13,0;8,0;;;2,0;3,0;;;83,0;7,0;;44,0;172,0;;;;1,0;11,0;1,0;;6,0;;10,0;2,0;7,0;;;6,0;;8,0;;10,0;6,0;;2,0;7,0;;69,0;13,0;39,0;;2,0;20,0;2,0;;;;1,0;;;18,0;4,0;60,0;;32,0;;;;12,0;2,0;2,0;;;7,0;3,0;;8,0;;;1,0;12,0;9,0;;16,0;12,0;9,0;1,0;;;5,0;9,0;1,0;2,0;1,0;;5,0;6,0;;;2,0;;34,0;;1,0;;;;;5,0;16,0;2,0;;6,0;27,0;11,0;1,0;;12,0;;;;4,0;;;;1,0;;;3,0;;1,0;;14,0;9,0;;2,0;;11,0;;10,0;1,0;6,0;;;9,0;;;14,0;;;5,0;;;4,0;5,0;17,0;;;;6,0;21,0;4,0;76,0;1,0;;;;1,0;16,0;;;;3,0;7,0;;1,0;;31,0;5,0;;;;1,0;2,0;;23,0;14,0;;;;;;;;;;9,0;;;;1,0;;;;4,0;16,0;;;;1,0;;;;3,0;1,0;;27,0;1,0;20,0;;;4,0;2,0;;17,0;2,0;;4,0;;;;;;3,0;2,0;17,0;1,0;;;57,0;8,0;;20,0;;2,0;1,0;;;17,0;7,0;3,0;2,0;;;3,0;1,0;21,0;6,0;14,0;;6,0;;5,0;3,0;8,0;2,0;12,0;4,0;;1,0;6,0;;110,0;17,0;5,0;69,0;;4,0;;23,0;;;3,0;;;7,0;1,0;5,0;1,0;;3,0;;;19,0;12,0;34,0;;;19,0;1,0;;;3,0;20,0;31,0;17,0;20,0;;;;;;1,0;;;;45,0;;;;2,0;;;1,0;;;1,0;13,0;3,0;;;2,0;2,0;12,0;;2,0;2,0;;;1,0;5,0;1,0;;12,0;;;17,0;;;1,0;10,0;2,0;;5,0;23,0;4,0;6,0;;3,0;;11,0;8,0;2,0;;5,0;1,0;2,0;;1,0;33,0;25,0;2,0;;;;1,0;;4,0;13,0;1,0;2,0;3,0;;;;4,0;;4,0;11,0;17,0;1,0;3,0;;20,0;14,0;;;14,0;;;;6,0;;6,0;;;6,0;;;7,0;;;;2,0;;;8,0;;;5,0;;;1,0;2,0;4,0;65,0;;;1,0;8,0;;4,0;;;7,0;17,0;1,0;;;;15,0;13,0;;;3,0;;;;1,0;;;;1,0;8,0;;;;57,0;12,0;;7,0;4,0;1,0;;14,0;;;;;;;3,0;;6,0;1,0;;;;;;;;;;;10,0;;;;;;3,0;;;3,0;;;;3,0;3,0;;;;;;;;;;11,0;;2,0;;;3,0;;1,0;;2,0;;;;1,0;4,0;;117,0;;;;;;;;7,0;3,0;3,0;;;;;7,0;;;;1,0;;;1,0;;;1,0;;4,0;;;;;16,0;;70,0;;;;3,0;;;;3,0;1,0;1,0;;;3,0;3,0;;;;;2,0;1,0;;;14,0;2,0;5,0;;;1,0;3,0;4,0;;;1,0;;;2,0;8,0;;;;2,0;4,0;;;;1,0;;25,0;2,0;3,0;1,0;;1,0;2,0;1,0;4,0;1,0;;1,0;3,0;1,0;;1,0;6,0;5,0;;;;;22,0;11,0;3,0;;2,0;4,0;1,0;;7,0;10,0;11,0;;;;28,0;;2,0;;;;40,0;3,0;;12,0;;2,0;;;;9,0;46,0;;49,0;1,0;;;10,0;2,0;;;;4,0;;2,0;9,0;3,0;1,0;1,0;;;;2,0;;;;;;;;8,0;;;;;;;;;8,0;;;;;;;;;1,0;4,0;;;;;;2,0;;;;;;;1,0;;;;;;;8,0;43,0;4,0;;;1,0;;;;;;;1,0;;1,0;;;1,0;;;1,0;;;;;;;;2,0;;;;;;;;1,0;;;;2,0;1,0;;;;;;;4,0;;;;;;;;;;7,0;;;;9,0;;14,0;;;;7,0;14,0;;23,0;;4,0;1,0;1,0;;;;6,0;;2,0;2,0;2,0;;;;;;;;;;;;5,0;;;;;;;;22,0;;;2,0;2,0;12,0;;;;;;;1,0;;;3,0;;;;;;;4,0;;;4,0;80,0;;2,0;;;;;;2,0;;;;;12,0;;1,0;;;
flange;;2,0;;;2,0;;11,0;19,0;;;1,0;;1,0;;;2,0;1,0;;;;;1,0;;;;;2,0;;;;;;5,0;1,0;9,0;;1,0;9,0;;;;;3,0;;;;;13,0;;;;;;2,0;4,0;8,0;35,0;;13,0;55,0;;;2,0;;;;;3,0;;1,0;13,0;;2,0;5,0;11,0;;;2,0;11,0;;2,0;;;;;;1,0;;;;6,0;;;2,0;;13,0;;;;;22,0;11,0;1,0;;;;;11,0;;;10,0;5,0;;3,0;6,0;;1,0;;2,0;41,0;;5,0;;3,0;;;7,0;8,0;;2,0;6,0;;;18,0;;;27,0;;1,0;;;;;18,0;1,0;2,0;30,0;3,0;;;;11,0;9,0;;4,0;17,0;15,0;19,0;;2,0;;;16,0;2,0;;2,0;;8,0;;1,0;47,0;;13,0;71,0;4,0;19,0;19,0;;;;;;4,0;;;;3,0;8,0;;42,0;1,0;6,0;;14,0;4,0;;;1,0;;10,0;;5,0;6,0;22,0;3,0;;;4,0;1,0;8,0;;6,0;;1,0;3,0;2,0;;;;4,0;6,0;1,0;;;6,0;;;;;15,0;;;;5,0;;3,0;17,0;;1,0;;18,0;2,0;3,0;6,0;;4,0;;;7,0;35,0;;;;22,0;;;19,0;25,0;;;;;14,0;1,0;2,0;;68,0;4,0;;60,0;1,0;3,0;;1,0;6,0;;;1,0;3,0;10,0;5,0;8,0;;1,0;;;4,0;;3,0;6,0;;;2,0;;2,0;4,0;;;;;;;3,0;3,0;1,0;12,0;;2,0;1,0;;1,0;;;;7,0;;2,0;2,0;3,0;1,0;37,0;;;2,0;;;;2,0;1,0;;;;;;;;;;;;;;;;;;;;1,0;;;;;;;;;;;;;;;;;1,0;;;;;;1,0;;;;;;;;;;;;;;;;;;;;;;;;;;;;;;;1,0;;;;;;;;1,0;1,0;;;;;;;;;;;;;;;;;;;;;;;;1,0;;;;;;;;;;;;;;;;;;1,0;;;;;;;;;;;;;;;;;1,0;2,0;;;;;;;;;;;;;;;;;;;;;;;;3,0;;;;;;;;;21,0;;;;;;4,0;;;;;;2,0;;;;;3,0;;;;;;;;;;;;;;;1,0;1,0;;;;;;;;;2,0;;;;;;;;2,0;1,0;;;;;;;;;;;;;;;2,0;;;;14,0;;4,0;;;;;;;;;;4,0;;;;;1,0;;;;;;;;;;;;;;;;10,0;;;2,0;10,0;2,0;;;;;;;;;;;;;;5,0;;;;;2,0;2,0;;;;;;;;;;;;;;;;3,0;;;1,0;;;8,0;;1,0;;;;;;;;;2,0;;;;;;;;;;1,0;;;;;;;;;;;;2,0;;;;1,0;;;;;;;;;;;;;;;;;;1,0;;;;;;;;;;;;;1,0;;;;;;;;2,0;;;;;;;;;2,0;;;;3,0;;;;;;;;;;;;;;;;;;;;;;;;;;;;2,0;;;;5,0;;;;;;;;;;;;;;;;;;;2,0;;;;;;;;;1,0;;;;;;;;;;;;;;;;;;;2,0;;;;1,0;;;;;;;;;;2,0;;;;;;2,0;;;;;;;1,0;;;;;;;;;2,0;;4,0;;;;;;;;;;;;;;3,0;1,0;;;;;;;;3,0;2,0;;;;4,0;;;;;;;;2,0;;;;;11,0;;;;;;;;;;;;;;;;;;;;;;;;;;;;;;;;;;;;;;;;;;;;;;;;1,0;2,0;;;9,0;;1,0;;;1,0;;;;;;;;;;;;;;;;;;;;;;;;;;;;5,0;;;;;;;;;;;;;
flash;;19,0;58,0;2,0;90,0;;41,0;61,0;28,0;140,0;2,0;46,0;;;98,0;6,0;4,0;21,0;90,0;9,0;49,0;247,0;16,0;12,0;5,0;1,0;1,0;98,0;2,0;20,0;33,0;129,0;428,0;20,0;84,0;;26,0;18,0;;47,0;7,0;;10,0;11,0;;3,0;;5,0;20,0;66,0;37,0;14,0;1,0;2,0;5,0;313,0;110,0;;6,0;45,0;1,0;2,0;178,0;5,0;1,0;2,0;7,0;;10,0;52,0;20,0;3,0;2,0;2,0;;10,0;;2,0;146,0;28,0;2,0;33,0;26,0;58,0;2,0;;16,0;;23,0;14,0;63,0;2,0;32,0;67,0;9,0;6,0;;7,0;36,0;3,0;36,0;64,0;;4,0;;15,0;3,0;534,0;;;13,0;4,0;2,0;11,0;15,0;29,0;;3,0;7,0;80,0;;;5,0;64,0;;1,0;91,0;15,0;;9,0;33,0;;;;1,0;4,0;31,0;;;188,0;8,0;5,0;116,0;42,0;7,0;10,0;26,0;22,0;2,0;3,0;1,0;6,0;6,0;2,0;12,0;1,0;16,0;12,0;62,0;37,0;;6,0;;;;5,0;24,0;485,0;1,0;;114,0;;87,0;29,0;35,0;7,0;;30,0;;;2,0;1,0;5,0;2,0;20,0;3,0;7,0;50,0;6,0;75,0;2,0;3,0;1,0;72,0;;19,0;;4,0;9,0;;13,0;1,0;;10,0;;5,0;3,0;;17,0;17,0;19,0;14,0;33,0;;2,0;90,0;8,0;;;17,0;6,0;;;3,0;;9,0;10,0;;;;7,0;;28,0;7,0;72,0;11,0;;6,0;3,0;;;;3,0;5,0;;3,0;58,0;;4,0;;;;;84,0;;;;23,0;6,0;;;11,0;;;9,0;1,0;10,0;;1,0;;;18,0;;5,0;;5,0;;;6,0;3,0;16,0;;;21,0;;3,0;7,0;24,0;32,0;3,0;;1,0;1,0;1,0;;3,0;;33,0;5,0;;1,0;2,0;19,0;38,0;2,0;;;23,0;2,0;13,0;10,0;5,0;44,0;6,0;2,0;10,0;5,0;;2,0;;4,0;7,0;2,0;;;77,0;;9,0;9,0;;17,0;1,0;;;;2,0;;1,0;2,0;;;11,0;;;;6,0;20,0;;;8,0;;3,0;7,0;;3,0;;;;;;;;1,0;;3,0;2,0;;8,0;7,0;;8,0;;;47,0;2,0;47,0;10,0;2,0;;3,0;37,0;4,0;;1,0;26,0;61,0;3,0;9,0;3,0;8,0;6,0;18,0;11,0;;19,0;21,0;11,0;6,0;3,0;;;;1,0;5,0;;;;3,0;;42,0;8,0;4,0;4,0;4,0;;23,0;3,0;;30,0;18,0;;1,0;1,0;10,0;38,0;;16,0;2,0;10,0;21,0;5,0;;;1,0;1,0;;2,0;;;16,0;8,0;1,0;5,0;1,0;;49,0;1,0;6,0;;9,0;;10,0;7,0;;5,0;1,0;;4,0;9,0;;2,0;;1,0;22,0;;2,0;9,0;;48,0;;2,0;36,0;;1,0;1,0;;;9,0;;;2,0;;23,0;2,0;;9,0;5,0;;;34,0;3,0;3,0;92,0;1,0;2,0;3,0;6,0;17,0;7,0;1,0;2,0;2,0;8,0;;28,0;;1,0;;2,0;16,0;1,0;;;1,0;23,0;15,0;26,0;;;1,0;1,0;3,0;;;;178,0;1,0;;3,0;;;;1,0;;4,0;1,0;4,0;3,0;4,0;;;7,0;6,0;;;12,0;;;1,0;;7,0;1,0;1,0;;;;4,0;;10,0;3,0;25,0;;;;1,0;;16,0;;;;;;;;1,0;;2,0;1,0;1,0;;;;55,0;7,0;4,0;3,0;;;;7,0;41,0;;2,0;2,0;;42,0;3,0;;1,0;3,0;1,0;3,0;52,0;;;1,0;;3,0;7,0;;;;;;;;47,0;1,0;;1,0;;;12,0;1,0;;;;;25,0;;;3,0;;20,0;;;3,0;;;;;;2,0;;;;13,0;;;1,0;1,0;2,0;;;;;;13,0;;;7,0;;;;7,0;2,0;;;;;8,0;;;;;;;;;;;8,0;2,0;11,0;;29,0;;;;1,0;5,0;10,0;2,0;;;;;2,0;;;1,0;;;1,0;;1,0;;5,0;;3,0;;1,0;5,0;;6,0;;1,0;9,0;;;;;;;1,0;9,0;;;;4,0;;3,0;11,0;4,0;;;;;;;98,0;5,0;;3,0;;15,0;;4,0;;;;1,0;;4,0;;;;2,0;7,0;2,0;3,0;1,0;;;3,0;2,0;1,0;;1,0;1,0;15,0;49,0;3,0;4,0;;;22,0;8,0;2,0;;;;;1,0;27,0;;;46,0;;;13,0;;;;19,0;;;4,0;5,0;;;;;;;1,0;14,0;1,0;;;;3,0;;;;9,0;1,0;5,0;4,0;;;7,0;2,0;;16,0;1,0;;;46,0;2,0;;3,0;;;;;;;5,0;1,0;1,0;;2,0;3,0;;2,0;;7,0;;6,0;1,0;;;;3,0;;;;35,0;;;;;;1,0;;;;;;1,0;1,0;;;;1,0;3,0;3,0;;;;;4,0;4,0;1,0;;;;;9,0;;;;1,0;;;3,0;;;1,0;1,0;;;;;;;;3,0;;;;;9,0;;1,0;;;;;1,0;;;;3,0;4,0;;3,0;8,0;;;;5,0;;;3,0;;;;;;;;;;;;;;;;;;;;;;;;;;;;;;;;;;;;;;;;1,0;2,0;;;;;;;;;;;;;;;;;;14,0;2,0;;;;
force;;4,0;2,0;;30,0;;97,0;17,0;3,0;;7,0;;;;;1,0;;;11,0;;6,0;18,0;2,0;3,0;6,0;;;1,0;;;;;58,0;5,0;6,0;;;159,0;8,0;3,0;4,0;1,0;168,0;39,0;1,0;;1,0;9,0;1,0;;2,0;190,0;;11,0;;21,0;16,0;;3,0;120,0;18,0;;7,0;;;44,0;20,0;;4,0;21,0;76,0;8,0;2,0;;;1,0;7,0;20,0;51,0;16,0;5,0;;;30,0;;;;3,0;;1,0;18,0;5,0;5,0;4,0;;;;;1,0;4,0;16,0;18,0;;11,0;1,0;;;60,0;6,0;2,0;10,0;6,0;;5,0;8,0;18,0;17,0;1,0;9,0;17,0;;4,0;1,0;1,0;;;19,0;6,0;;18,0;22,0;14,0;;9,0;;1,0;10,0;3,0;16,0;;9,0;;35,0;9,0;;;2,0;34,0;;;;;8,0;;11,0;12,0;6,0;32,0;2,0;4,0;;1,0;;3,0;;6,0;3,0;2,0;1,0;;262,0;67,0;22,0;14,0;12,0;14,0;5,0;7,0;;;5,0;1,0;;;6,0;13,0;10,0;2,0;;79,0;;1,0;;46,0;;3,0;;9,0;70,0;14,0;;;;13,0;2,0;5,0;35,0;12,0;15,0;33,0;;3,0;;;7,0;4,0;117,0;;4,0;1,0;;3,0;1,0;;;;;;5,0;6,0;;1,0;21,0;1,0;8,0;5,0;2,0;161,0;3,0;2,0;16,0;1,0;3,0;2,0;1,0;6,0;;;1,0;62,0;;4,0;1,0;5,0;;1,0;1,0;;3,0;;;256,0;;86,0;18,0;5,0;6,0;10,0;2,0;;;;;1,0;5,0;;;11,0;;2,0;10,0;74,0;2,0;59,0;3,0;2,0;49,0;4,0;;4,0;;;;;15,0;4,0;;4,0;;1,0;3,0;1,0;16,0;;9,0;;;1,0;2,0;1,0;;4,0;3,0;5,0;10,0;;3,0;8,0;16,0;;7,0;6,0;27,0;16,0;;24,0;;59,0;5,0;;3,0;1,0;7,0;1,0;;1,0;1,0;;;3,0;;1,0;;1,0;;6,0;;;;9,0;16,0;;;;;;;;2,0;;;;1,0;3,0;;;;;;;1,0;;11,0;;;;;;;8,0;;4,0;;;1,0;;1,0;;;1,0;5,0;20,0;43,0;1,0;19,0;;2,0;1,0;1,0;2,0;1,0;1,0;;;;2,0;2,0;1,0;;3,0;;11,0;;2,0;;4,0;;2,0;7,0;;;;;6,0;;;;;1,0;;;;;;;;;;;;10,0;;1,0;;;;8,0;22,0;;1,0;;;3,0;10,0;;;;;;;;;;4,0;;2,0;42,0;1,0;;;;2,0;4,0;1,0;;;1,0;2,0;;;;;;1,0;;38,0;1,0;;;;;11,0;;;4,0;1,0;1,0;1,0;;;;;;;5,0;2,0;;4,0;;;;1,0;;;4,0;;2,0;;;;;1,0;;;;;3,0;;;;;;4,0;;;;;;;;;;1,0;;;;5,0;;;;1,0;2,0;1,0;;;;;;5,0;1,0;;2,0;;;1,0;;15,0;;3,0;;;;;;;;1,0;;;;;;4,0;;;5,0;5,0;;;;;;2,0;4,0;;6,0;;;;;;;4,0;3,0;;;;;1,0;;;3,0;;;;;;;;;;;;;;;4,0;;19,0;;;16,0;2,0;3,0;;;;9,0;3,0;;;;;;1,0;;;1,0;;;;;;1,0;;;;3,0;;;2,0;;;;3,0;2,0;;;;;1,0;;1,0;1,0;3,0;;;;;;;3,0;3,0;;;;;1,0;;;;4,0;3,0;;;;;3,0;;;;;;;;;;;;3,0;;;;;;;;10,0;;2,0;1,0;;;;;1,0;;;;;;;1,0;1,0;;;4,0;;;;;2,0;;;;;;;;;;;;;;;;3,0;;2,0;;;;2,0;;;;2,0;;;1,0;;1,0;;;;;5,0;1,0;;;;;;;;;;;;;;;3,0;2,0;1,0;;;;2,0;1,0;;;;;;;;;;;;;;6,0;1,0;;1,0;;1,0;1,0;;;;;;2,0;;;;;;;;;;;2,0;;3,0;;;;1,0;1,0;;;;;27,0;8,0;;;;;;1,0;3,0;78,0;;11,0;42,0;;6,0;;;1,0;3,0;;1,0;;;1,0;;;;;;;;;;1,0;3,0;5,0;;;;;;;;;;;;1,0;;2,0;2,0;;;;1,0;8,0;;2,0;;;;;;;;;;;;10,0;;;;;;;;;;;2,0;;;;;;;;;;;;;;;;;;;;;;;;;;;;;;;;;;;;;2,0;;;1,0;;2,0;2,0;;11,0;;;;;;;;;;;;9,0;;;;;;;;;;;;;
form;;2,0;10,0;;124,0;5,0;98,0;190,0;;128,0;53,0;9,0;25,0;4,0;45,0;14,0;3,0;5,0;25,0;10,0;29,0;124,0;5,0;19,0;10,0;4,0;27,0;191,0;20,0;38,0;18,0;13,0;349,0;15,0;123,0;24,0;18,0;188,0;4,0;133,0;11,0;5,0;55,0;248,0;4,0;7,0;18,0;20,0;31,0;24,0;28,0;35,0;;78,0;5,0;2303,0;285,0;5,0;24,0;1097,0;23,0;46,0;271,0;3,0;23,0;30,0;28,0;19,0;2,0;7,0;817,0;29,0;59,0;49,0;42,0;84,0;13,0;71,0;197,0;16,0;10,0;53,0;31,0;10,0;2,0;18,0;286,0;7,0;13,0;56,0;305,0;13,0;10,0;168,0;25,0;135,0;3,0;10,0;29,0;315,0;945,0;605,0;5,0;93,0;1,0;15,0;83,0;322,0;1,0;12,0;38,0;106,0;75,0;89,0;46,0;9,0;20,0;1,0;87,0;178,0;41,0;3,0;6,0;122,0;19,0;12,0;95,0;116,0;3,0;42,0;136,0;9,0;10,0;37,0;12,0;34,0;51,0;25,0;221,0;24,0;1,0;1,0;42,0;119,0;69,0;2,0;;213,0;2,0;27,0;3,0;180,0;130,0;32,0;40,0;151,0;296,0;208,0;38,0;240,0;37,0;10,0;163,0;50,0;;416,0;5,0;359,0;2,0;190,0;386,0;70,0;255,0;168,0;12,0;153,0;147,0;107,0;19,0;4,0;26,0;20,0;39,0;28,0;6,0;115,0;166,0;457,0;;828,0;22,0;105,0;8,0;134,0;44,0;46,0;14,0;21,0;40,0;17,0;135,0;195,0;42,0;287,0;22,0;4,0;46,0;25,0;81,0;162,0;;57,0;22,0;34,0;8,0;56,0;27,0;142,0;9,0;12,0;101,0;17,0;2,0;14,0;149,0;14,0;54,0;;2,0;6,0;20,0;;28,0;51,0;14,0;83,0;63,0;7,0;154,0;4,0;143,0;20,0;64,0;116,0;5,0;27,0;54,0;83,0;36,0;59,0;20,0;5,0;93,0;188,0;5,0;1,0;48,0;46,0;8,0;14,0;8,0;31,0;65,0;42,0;84,0;26,0;90,0;5,0;30,0;34,0;16,0;85,0;20,0;2,0;47,0;21,0;;9,0;8,0;35,0;28,0;27,0;4,0;48,0;56,0;47,0;23,0;318,0;6,0;71,0;2,0;3,0;18,0;130,0;3,0;16,0;49,0;50,0;24,0;5,0;14,0;6,0;65,0;53,0;64,0;43,0;5,0;17,0;41,0;121,0;18,0;67,0;16,0;14,0;55,0;27,0;5,0;18,0;36,0;43,0;26,0;46,0;65,0;42,0;;43,0;10,0;43,0;9,0;;27,0;9,0;1,0;2,0;1,0;6,0;1,0;1,0;;5,0;16,0;10,0;1,0;5,0;1,0;1,0;3,0;4,0;19,0;14,0;52,0;3,0;5,0;4,0;;2,0;;2,0;3,0;;3,0;1,0;4,0;14,0;34,0;4,0;6,0;2,0;19,0;2,0;;17,0;;5,0;14,0;21,0;18,0;2,0;;49,0;5,0;73,0;19,0;22,0;7,0;;2,0;3,0;3,0;31,0;;34,0;10,0;3,0;38,0;1,0;3,0;27,0;10,0;1,0;17,0;;3,0;5,0;18,0;;5,0;225,0;2,0;;33,0;18,0;28,0;38,0;2,0;4,0;44,0;;28,0;15,0;21,0;;;19,0;4,0;3,0;2,0;17,0;1,0;109,0;5,0;8,0;2,0;;2,0;8,0;5,0;4,0;15,0;4,0;;;;8,0;23,0;18,0;60,0;113,0;1,0;8,0;;2,0;65,0;26,0;23,0;33,0;2,0;;12,0;3,0;;4,0;;1,0;9,0;7,0;42,0;6,0;10,0;1,0;;9,0;3,0;;6,0;22,0;60,0;1,0;1,0;7,0;2,0;9,0;1,0;9,0;8,0;41,0;35,0;6,0;1,0;8,0;11,0;6,0;5,0;11,0;96,0;67,0;7,0;16,0;1,0;3,0;1,0;4,0;;1,0;72,0;27,0;4,0;24,0;1,0;7,0;43,0;;;11,0;15,0;66,0;28,0;8,0;25,0;;2,0;12,0;7,0;18,0;;4,0;3,0;;3,0;10,0;2,0;1,0;20,0;;6,0;;16,0;1,0;;4,0;3,0;11,0;4,0;6,0;23,0;1,0;17,0;5,0;4,0;1,0;13,0;4,0;70,0;2,0;3,0;34,0;10,0;2,0;1,0;29,0;165,0;4,0;3,0;;2,0;;16,0;5,0;4,0;;1,0;2,0;;;117,0;;49,0;1,0;40,0;1,0;11,0;2,0;258,0;1,0;;76,0;64,0;4,0;17,0;5,0;2,0;18,0;2,0;2,0;37,0;28,0;5,0;4,0;4,0;8,0;14,0;3,0;8,0;8,0;4,0;;7,0;16,0;5,0;14,0;5,0;38,0;;;15,0;1,0;2,0;1,0;6,0;;1,0;9,0;;17,0;4,0;4,0;7,0;;15,0;10,0;;110,0;2,0;11,0;37,0;24,0;68,0;29,0;13,0;9,0;8,0;9,0;33,0;27,0;5,0;1,0;5,0;4,0;4,0;9,0;7,0;211,0;1,0;10,0;15,0;14,0;15,0;12,0;7,0;1,0;7,0;22,0;1,0;7,0;30,0;26,0;1,0;12,0;9,0;7,0;5,0;1,0;;8,0;30,0;;42,0;5,0;4,0;;6,0;2,0;16,0;8,0;11,0;11,0;33,0;41,0;;17,0;;18,0;;1,0;5,0;3,0;23,0;42,0;9,0;;22,0;6,0;4,0;15,0;16,0;7,0;33,0;;;29,0;15,0;2,0;1,0;4,0;5,0;7,0;51,0;;;38,0;25,0;9,0;11,0;8,0;2,0;;1,0;;;;5,0;1,0;12,0;11,0;;3,0;8,0;2,0;;2,0;2,0;6,0;;4,0;8,0;3,0;8,0;1,0;11,0;;2,0;17,0;3,0;6,0;;9,0;3,0;37,0;21,0;31,0;1,0;5,0;11,0;12,0;5,0;1,0;2,0;4,0;6,0;;2,0;6,0;3,0;14,0;13,0;5,0;10,0;7,0;5,0;1,0;1,0;8,0;3,0;;4,0;1,0;5,0;1,0;;;2,0;;;18,0;10,0;;;6,0;1,0;4,0;2,0;;;21,0;;1,0;6,0;2,0;17,0;;5,0;3,0;;;22,0;;1,0;5,0;3,0;;2,0;1,0;5,0;;2,0;21,0;4,0;7,0;35,0;6,0;10,0;17,0;4,0;1,0;;;2,0;10,0;;4,0;1,0;12,0;36,0;;3,0;10,0;20,0;1,0;;26,0;8,0;;;11,0;7,0;2,0;3,0;;1,0;15,0;5,0;3,0;19,0;25,0;28,0;4,0;1,0;22,0;5,0;12,0;9,0;2,0;11,0;;22,0;5,0;27,0;3,0;1,0;4,0;9,0;7,0;3,0;17,0;11,0;34,0;4,0;12,0;1,0;;2,0;1,0;2,0;12,0;23,0;5,0;4,0;;;7,0;9,0;11,0;1,0;9,0;1,0;;4,0;;1,0;2,0;57,0;3,0;1,0;11,0;;60,0;13,0;;3,0;1,0;5,0;6,0;2,0;;3,0;11,0;1,0;2,0;1,0;3,0;2,0;1,0;;;1,0;2,0;5,0;5,0;4,0;1,0;;;1,0;23,0;1,0;;5,0;8,0;8,0;6,0;64,0;16,0;61,0;21,0;4,0;23,0;8,0;26,0;9,0;15,0;4,0;;;8,0;;8,0;4,0;1,0;;;2,0;2,0;1,0;1,0;6,0;6,0;;3,0;8,0;;2,0;2,0;;14,0;;2,0;9,0;2,0;;;3,0;50,0;5,0;1,0;;15,0;;;;
frame;;3,0;88,0;3,0;131,0;;188,0;291,0;102,0;452,0;105,0;7,0;1,0;17,0;66,0;23,0;24,0;1,0;66,0;23,0;30,0;142,0;51,0;105,0;52,0;16,0;11,0;458,0;21,0;159,0;63,0;336,0;435,0;222,0;164,0;13,0;11,0;291,0;61,0;319,0;60,0;;171,0;110,0;18,0;6,0;2,0;7,0;95,0;17,0;18,0;426,0;15,0;148,0;;2734,0;331,0;12,0;17,0;1064,0;3,0;11,0;361,0;3,0;11,0;10,0;360,0;1,0;12,0;78,0;215,0;51,0;10,0;20,0;22,0;40,0;;141,0;382,0;37,0;17,0;204,0;63,0;41,0;;8,0;249,0;4,0;62,0;164,0;101,0;55,0;12,0;260,0;129,0;56,0;;44,0;161,0;33,0;106,0;245,0;6,0;35,0;8,0;6,0;10,0;360,0;5,0;4,0;26,0;88,0;38,0;60,0;104,0;10,0;12,0;;37,0;101,0;;7,0;7,0;102,0;;3,0;208,0;36,0;9,0;71,0;24,0;51,0;;62,0;6,0;11,0;132,0;9,0;8,0;12,0;2,0;7,0;58,0;120,0;105,0;34,0;213,0;;;;4,0;46,0;81,0;5,0;174,0;112,0;15,0;22,0;43,0;97,0;1,0;18,0;70,0;52,0;;;57,0;75,0;2,0;21,0;300,0;28,0;177,0;200,0;99,0;57,0;86,0;188,0;4,0;;21,0;19,0;34,0;34,0;13,0;32,0;20,0;896,0;5,0;353,0;4,0;3,0;;156,0;48,0;4,0;;3,0;49,0;24,0;11,0;21,0;3,0;161,0;1,0;10,0;4,0;47,0;41,0;269,0;6,0;7,0;4,0;3,0;28,0;251,0;84,0;10,0;3,0;;38,0;58,0;12,0;1,0;35,0;;39,0;;9,0;15,0;6,0;1,0;10,0;74,0;51,0;32,0;1,0;16,0;220,0;3,0;104,0;15,0;104,0;16,0;1,0;21,0;23,0;8,0;14,0;41,0;8,0;120,0;4,0;118,0;23,0;7,0;11,0;82,0;7,0;2,0;48,0;216,0;34,0;11,0;36,0;4,0;62,0;3,0;3,0;4,0;6,0;27,0;5,0;9,0;10,0;14,0;1,0;2,0;13,0;51,0;11,0;25,0;13,0;28,0;14,0;317,0;182,0;271,0;20,0;28,0;4,0;5,0;16,0;61,0;13,0;14,0;1,0;40,0;10,0;1,0;50,0;9,0;177,0;18,0;9,0;7,0;8,0;39,0;23,0;35,0;252,0;93,0;99,0;264,0;19,0;;22,0;4,0;8,0;28,0;12,0;39,0;36,0;40,0;2,0;262,0;11,0;17,0;7,0;23,0;25,0;5,0;15,0;1,0;;11,0;1,0;1,0;2,0;17,0;10,0;67,0;1,0;31,0;63,0;105,0;7,0;17,0;4,0;51,0;14,0;4,0;54,0;6,0;3,0;24,0;10,0;2,0;;3,0;35,0;6,0;;2,0;81,0;48,0;8,0;1,0;12,0;21,0;15,0;17,0;9,0;29,0;27,0;190,0;36,0;31,0;;34,0;156,0;29,0;4,0;18,0;7,0;;244,0;22,0;6,0;118,0;7,0;57,0;14,0;;25,0;14,0;34,0;168,0;92,0;9,0;96,0;;12,0;;135,0;14,0;14,0;41,0;4,0;;45,0;30,0;8,0;103,0;3,0;381,0;172,0;;62,0;17,0;73,0;7,0;;2,0;33,0;2,0;5,0;66,0;74,0;21,0;71,0;19,0;;;2,0;46,0;1,0;10,0;28,0;8,0;2,0;33,0;3,0;;2,0;33,0;3,0;23,0;11,0;19,0;8,0;18,0;89,0;22,0;5,0;40,0;5,0;2,0;42,0;1,0;;;2,0;3,0;5,0;41,0;102,0;11,0;51,0;;8,0;87,0;;;1,0;11,0;21,0;5,0;1,0;;9,0;8,0;25,0;8,0;;70,0;33,0;8,0;11,0;48,0;6,0;63,0;;5,0;865,0;72,0;45,0;5,0;1,0;19,0;1,0;32,0;;11,0;4,0;4,0;;21,0;2,0;7,0;1,0;;8,0;22,0;18,0;19,0;;17,0;;1,0;7,0;10,0;6,0;11,0;;4,0;9,0;;4,0;;1,0;6,0;8,0;180,0;4,0;2,0;2,0;;1,0;;2,0;9,0;3,0;70,0;;2,0;7,0;18,0;;3,0;40,0;2,0;16,0;2,0;9,0;;9,0;8,0;3,0;257,0;259,0;;1,0;;6,0;1,0;140,0;156,0;1,0;10,0;52,0;7,0;2,0;;28,0;9,0;2,0;4,0;1,0;4,0;3,0;28,0;95,0;105,0;4,0;8,0;1,0;4,0;;27,0;8,0;9,0;;1,0;2,0;3,0;;4,0;25,0;13,0;8,0;;89,0;6,0;2,0;1,0;1,0;135,0;8,0;;;6,0;1,0;;6,0;;7,0;5,0;1,0;12,0;;9,0;;45,0;8,0;;1,0;9,0;26,0;;;2,0;8,0;27,0;1,0;3,0;27,0;26,0;46,0;10,0;5,0;39,0;2,0;;;1,0;;1,0;17,0;5,0;147,0;10,0;;8,0;1,0;3,0;26,0;13,0;7,0;5,0;2,0;;;;;42,0;9,0;1,0;2,0;7,0;4,0;1,0;;3,0;26,0;1,0;;21,0;6,0;3,0;1,0;;31,0;40,0;20,0;1,0;;21,0;7,0;;;;5,0;;1,0;;3,0;38,0;8,0;2,0;52,0;;;20,0;63,0;10,0;4,0;2,0;8,0;73,0;4,0;44,0;21,0;47,0;44,0;2,0;1,0;2,0;;6,0;2,0;14,0;4,0;;4,0;;2,0;23,0;2,0;;2,0;16,0;73,0;57,0;3,0;;11,0;;3,0;4,0;7,0;;2,0;16,0;;27,0;2,0;55,0;2,0;38,0;3,0;33,0;1,0;2,0;15,0;13,0;25,0;;7,0;10,0;;1,0;5,0;2,0;22,0;2,0;2,0;;36,0;5,0;36,0;;8,0;;;56,0;17,0;8,0;3,0;;7,0;4,0;3,0;5,0;24,0;1,0;56,0;28,0;1,0;;6,0;1,0;;;9,0;13,0;3,0;4,0;11,0;;;;1,0;13,0;;53,0;;24,0;33,0;5,0;1,0;19,0;127,0;11,0;3,0;1,0;;;2,0;4,0;;22,0;3,0;7,0;10,0;4,0;4,0;;2,0;12,0;15,0;19,0;8,0;2,0;;;2,0;;;4,0;;20,0;57,0;4,0;;5,0;;8,0;4,0;7,0;3,0;;90,0;42,0;6,0;4,0;4,0;;20,0;1,0;6,0;18,0;8,0;37,0;;1,0;4,0;1,0;8,0;4,0;2,0;7,0;46,0;;1,0;5,0;5,0;;19,0;18,0;;;18,0;2,0;13,0;;2,0;5,0;2,0;;;;2,0;;22,0;;37,0;;;;70,0;11,0;8,0;;4,0;;19,0;6,0;;;104,0;2,0;;3,0;7,0;4,0;;2,0;20,0;;17,0;12,0;;16,0;2,0;60,0;2,0;1,0;;19,0;4,0;7,0;;11,0;;2,0;7,0;1,0;;;2,0;23,0;31,0;21,0;;8,0;;35,0;;6,0;2,0;;5,0;;;12,0;;;2,0;1,0;;;;;;1,0;;10,0;;1,0;5,0;69,0;;;3,0;;;1,0;2,0;12,0;;31,0;1,0;7,0;;5,0;;2,0;;69,0;17,0;;1,0;;3,0;;;;;
front;;1,0;;1,0;21,0;9,0;42,0;57,0;3,0;12,0;18,0;;;;1,0;1,0;;;62,0;1,0;;9,0;4,0;3,0;4,0;;1,0;11,0;;8,0;18,0;;84,0;2,0;23,0;;6,0;81,0;;77,0;18,0;;3,0;48,0;;;;14,0;9,0;1,0;4,0;1,0;;54,0;6,0;97,0;111,0;;6,0;296,0;4,0;;14,0;;;2,0;23,0;11,0;;2,0;92,0;4,0;4,0;5,0;2,0;3,0;;16,0;156,0;8,0;6,0;10,0;2,0;2,0;2,0;1,0;7,0;2,0;1,0;5,0;47,0;1,0;8,0;21,0;1,0;10,0;;;1,0;65,0;487,0;47,0;;;2,0;;;65,0;11,0;;4,0;69,0;8,0;23,0;48,0;2,0;27,0;;23,0;126,0;;;4,0;21,0;3,0;1,0;46,0;17,0;4,0;24,0;143,0;;1,0;13,0;1,0;13,0;57,0;;3,0;4,0;1,0;8,0;17,0;166,0;24,0;;85,0;27,0;2,0;15,0;;3,0;7,0;;15,0;13,0;18,0;93,0;4,0;53,0;7,0;1,0;15,0;6,0;;25,0;9,0;67,0;2,0;2,0;158,0;9,0;56,0;107,0;8,0;35,0;28,0;3,0;;8,0;56,0;5,0;2,0;5,0;5,0;23,0;164,0;50,0;1,0;209,0;1,0;16,0;5,0;34,0;7,0;6,0;1,0;1,0;10,0;26,0;4,0;14,0;24,0;260,0;;2,0;4,0;12,0;21,0;55,0;;7,0;1,0;2,0;2,0;10,0;1,0;32,0;20,0;9,0;16,0;65,0;;1,0;5,0;7,0;18,0;4,0;;6,0;5,0;;4,0;10,0;21,0;18,0;6,0;18,0;19,0;;48,0;;1,0;57,0;2,0;48,0;1,0;8,0;2,0;2,0;1,0;;8,0;52,0;3,0;2,0;3,0;13,0;1,0;5,0;1,0;3,0;23,0;1,0;9,0;4,0;78,0;5,0;3,0;7,0;2,0;;1,0;1,0;6,0;1,0;;3,0;;71,0;17,0;1,0;9,0;28,0;4,0;12,0;13,0;25,0;;20,0;;2,0;;1,0;;2,0;7,0;21,0;4,0;;;8,0;7,0;27,0;23,0;11,0;;8,0;271,0;13,0;4,0;2,0;3,0;4,0;13,0;6,0;2,0;;2,0;5,0;5,0;;15,0;12,0;;15,0;1,0;10,0;4,0;;7,0;;24,0;;;4,0;;;;;1,0;1,0;;1,0;1,0;;;1,0;11,0;2,0;29,0;;;1,0;;;;;9,0;;1,0;;2,0;;;;;;;;;3,0;;3,0;;2,0;1,0;;;12,0;;20,0;;;;;;;;2,0;2,0;7,0;;1,0;16,0;;13,0;6,0;;;;;;;;;2,0;4,0;1,0;;6,0;7,0;4,0;2,0;;;;;5,0;;;;;6,0;;16,0;1,0;;;5,0;1,0;;1,0;;;4,0;8,0;;;;3,0;;;1,0;;3,0;;7,0;;12,0;1,0;;11,0;18,0;5,0;;;;1,0;;;;4,0;;8,0;9,0;11,0;8,0;4,0;1,0;1,0;9,0;11,0;;;;6,0;1,0;;2,0;1,0;;;;;18,0;48,0;;;2,0;4,0;2,0;;1,0;24,0;31,0;2,0;18,0;;1,0;;;;;25,0;4,0;;2,0;1,0;19,0;3,0;9,0;;;3,0;2,0;2,0;;;;2,0;11,0;;3,0;;3,0;3,0;;2,0;;1,0;;18,0;1,0;;;3,0;3,0;;;;;;9,0;10,0;7,0;3,0;2,0;;3,0;;;8,0;;;7,0;4,0;2,0;;;6,0;;;;;6,0;18,0;;1,0;;;2,0;;;4,0;7,0;18,0;;;;;;11,0;4,0;;5,0;6,0;;;;1,0;;1,0;;1,0;4,0;;;5,0;3,0;1,0;;1,0;3,0;1,0;;;1,0;;;1,0;25,0;6,0;;1,0;;2,0;3,0;8,0;;9,0;;;6,0;;3,0;;3,0;2,0;;;;12,0;8,0;1,0;;8,0;;13,0;;;;3,0;19,0;;;;1,0;5,0;2,0;;2,0;;3,0;7,0;1,0;8,0;3,0;1,0;9,0;1,0;;;;2,0;2,0;1,0;10,0;;6,0;;;2,0;2,0;1,0;1,0;;3,0;;1,0;;;;3,0;6,0;;;;;;;1,0;;;;;3,0;;3,0;;;;;;;;;;;1,0;;3,0;;;;;8,0;1,0;;4,0;5,0;;3,0;;3,0;;;;;;;;;;;;;;;3,0;;;;;;2,0;;;4,0;;32,0;3,0;;;;;;1,0;4,0;2,0;;;;1,0;1,0;;2,0;1,0;2,0;;;4,0;5,0;;;10,0;;;1,0;;;;;4,0;;10,0;;1,0;;;;;;18,0;2,0;;;11,0;;;;2,0;;;;;2,0;;;;;;2,0;17,0;;;;;10,0;;;;4,0;;;1,0;;;5,0;6,0;18,0;2,0;;2,0;;1,0;3,0;;;;2,0;1,0;1,0;;;16,0;;;3,0;;7,0;;;;;;8,0;;;;11,0;;;1,0;5,0;;3,0;4,0;;1,0;1,0;;;;1,0;1,0;;;;;;21,0;3,0;;1,0;3,0;;5,0;10,0;;;2,0;;;;;;;;;;11,0;3,0;;;;;;;;2,0;;;5,0;;9,0;;;6,0;1,0;;1,0;;;;;;;;;;;2,0;;;;;;;;;;;;;;;;;;;;;4,0;;2,0;;;;;;;;4,0;4,0;;;;;;1,0;;3,0;;;;;;1,0;;;;;1,0;;1,0;;;;;;;;;;3,0;;;;
grip;;1,0;;;32,0;;26,0;7,0;;;3,0;;;;;;;;2,0;;;6,0;;;;;;;;2,0;6,0;;15,0;;21,0;;1,0;32,0;;10,0;;;;6,0;;;;;;;3,0;;;;;38,0;33,0;;1,0;9,0;;;5,0;;1,0;;15,0;;;4,0;11,0;1,0;;2,0;1,0;;;1,0;27,0;1,0;1,0;;;;;1,0;;;;;1,0;;;;;1,0;;;;;42,0;14,0;;;;1,0;;2,0;;;;2,0;;6,0;6,0;;;;2,0;59,0;;;;2,0;;;6,0;1,0;;1,0;10,0;3,0;;5,0;;1,0;7,0;;;;;;3,0;2,0;;;16,0;2,0;;;;;;;5,0;;4,0;7,0;1,0;3,0;;;2,0;3,0;;;;;;3,0;18,0;;6,0;15,0;5,0;6,0;7,0;;;;;;;;13,0;;8,0;3,0;;99,0;;2,0;;;6,0;;;;8,0;2,0;;16,0;;19,0;;1,0;;2,0;1,0;3,0;;;;1,0;;2,0;2,0;;;;2,0;;;;1,0;;;;;;4,0;;;8,0;;2,0;1,0;2,0;2,0;;5,0;;1,0;1,0;;;;;;;;;;7,0;1,0;;2,0;3,0;1,0;;;;;;;;10,0;;1,0;1,0;1,0;3,0;;1,0;;;;;1,0;2,0;6,0;;;12,0;2,0;;4,0;7,0;6,0;5,0;;11,0;2,0;;;1,0;;8,0;1,0;;;;;;;2,0;;1,0;2,0;1,0;;;1,0;;6,0;;28,0;;2,0;;;;13,0;;;1,0;;;;;17,0;;2,0;;;;;;;2,0;;;1,0;;;;;;1,0;;1,0;;;;;;;;;2,0;;;;;;;;;;;;3,0;;;;;;;;10,0;;15,0;;;;;;;;;3,0;2,0;15,0;;2,0;;;;;;10,0;;;;;;;2,0;2,0;6,0;;12,0;;;;;;;1,0;;;;;;8,0;;;;;;;;;;;;;;;3,0;;;;;;;;;;;;;;4,0;1,0;;;;;;;;;;;;3,0;;;;;;;;;;;;;;;;;;;29,0;;;;2,0;;1,0;;5,0;;;;;;;1,0;;;;;2,0;;;;;;;;;;2,0;;;;;;1,0;;;;;2,0;;;;;;1,0;;;;;21,0;;;;;;1,0;;;;;;;;;;;;;;;1,0;;;;;;6,0;;12,0;;;;;;;;;;1,0;;;;;;4,0;;;1,0;;;;;1,0;;2,0;;5,0;;5,0;;;;;;;;29,0;;;;1,0;;;3,0;1,0;;;;;1,0;;;;;;;;;;1,0;;;;;;;;;1,0;;7,0;1,0;;;;;1,0;;;;;;;;;2,0;1,0;1,0;2,0;;;;;;;;;;;;;3,0;;;;;1,0;;;;;;;;;;;;;;;;;;;;;;;;;;;;;;;;;;;2,0;;;;;;;;;;;;;;;;;;;;;;;;;;;;;;;;;1,0;1,0;;;;;;;;;;;;;;;1,0;;;;;;;;;;;;;;;;;3,0;;1,0;6,0;;;;;;;;;;;;;;;;1,0;;;3,0;;3,0;;;;;;;;;;;;;;;;;;1,0;1,0;2,0;;;;;;;3,0;;;;;;;1,0;;;;;;1,0;;;1,0;2,0;;;;;;;1,0;1,0;;;;;;;;;;;;1,0;;;;;;2,0;;;;;3,0;;;;;;;;;;2,0;;;;;;;;;;;;;;;;;1,0;;;;;1,0;;;;;;;1,0;;;;;;;;;;;;;;;;;;;;;;;;;;;;;;;;;;;;;;;;3,0;;;;;;;;;;;;;;;;;;;;;;;2,0;;;;;;;;;;;;;;;;;;;;;;;
groove;;1,0;3,0;;14,0;;21,0;52,0;;;12,0;;3,0;;;;1,0;;;;;2,0;;;;;4,0;;2,0;;;;39,0;1,0;10,0;;;95,0;;;;;14,0;8,0;;;15,0;;5,0;;;;;4,0;3,0;16,0;64,0;;12,0;159,0;16,0;;3,0;;;2,0;22,0;1,0;;2,0;35,0;;;22,0;6,0;;;9,0;40,0;;3,0;;;1,0;;;11,0;;;;11,0;;;;;19,0;;;4,0;10,0;164,0;3,0;1,0;;;;;49,0;;2,0;8,0;11,0;6,0;33,0;5,0;;6,0;;10,0;35,0;6,0;;;1,0;;;20,0;26,0;;22,0;24,0;1,0;1,0;38,0;3,0;;43,0;3,0;6,0;;;;5,0;40,0;4,0;;180,0;46,0;;;;;158,0;;5,0;27,0;19,0;38,0;;22,0;;;53,0;8,0;;5,0;;3,0;;6,0;88,0;1,0;58,0;22,0;7,0;9,0;60,0;1,0;;;1,0;5,0;6,0;;7,0;6,0;45,0;91,0;;106,0;;46,0;;87,0;16,0;;;1,0;11,0;7,0;5,0;40,0;;56,0;2,0;;1,0;1,0;12,0;43,0;;2,0;;;1,0;;1,0;8,0;;1,0;11,0;1,0;;;31,0;;1,0;;;;18,0;;2,0;3,0;3,0;9,0;15,0;;20,0;6,0;57,0;8,0;4,0;36,0;1,0;7,0;3,0;4,0;31,0;11,0;1,0;;5,0;15,0;2,0;;19,0;92,0;;3,0;;7,0;4,0;6,0;106,0;9,0;60,0;;11,0;7,0;;3,0;;2,0;36,0;;;5,0;2,0;36,0;27,0;;;31,0;3,0;1,0;15,0;1,0;1,0;9,0;;1,0;;3,0;;7,0;;5,0;;1,0;8,0;4,0;4,0;10,0;17,0;6,0;1,0;10,0;4,0;19,0;2,0;;1,0;;32,0;;1,0;;2,0;11,0;13,0;;18,0;129,0;10,0;1,0;8,0;3,0;;;1,0;2,0;6,0;;;;;;;;;;;;;;;1,0;;1,0;;;;;;;;;;;;;;;;;;;;;;4,0;;;;;;;;29,0;;1,0;;;;;;;;;;;11,0;;2,0;;;;;;;;;;;;;16,0;;;6,0;3,0;;1,0;;;1,0;;;;;;;5,0;;2,0;;;;;;;;;1,0;4,0;;;;;2,0;;2,0;;2,0;;;;;;;;;6,0;;;;;;;;;;4,0;;;8,0;;;;;;;;;;;;;;;;;;;20,0;;;;;;;;2,0;1,0;;;;;;;;;;2,0;3,0;;37,0;;1,0;2,0;;;;7,0;3,0;;;;;;;;4,0;;;2,0;1,0;;3,0;;;2,0;;;;;;;;;1,0;;6,0;11,0;;2,0;;;;;;;;;;;8,0;;;;;;;1,0;;8,0;;;;;;;;22,0;;24,0;;1,0;;;;;;;19,0;1,0;;;;;10,0;;;;;;;;3,0;;;;;;;2,0;1,0;4,0;;;2,0;;;;;;;1,0;;;;;3,0;;;;;;1,0;;1,0;;2,0;;14,0;;;;;4,0;;8,0;;1,0;;;1,0;34,0;;;;1,0;6,0;1,0;6,0;;13,0;;1,0;1,0;2,0;;1,0;;1,0;;3,0;;16,0;2,0;;;2,0;1,0;;6,0;;;;;;;;;;;;;;;4,0;;;;;1,0;9,0;;;3,0;;;;;3,0;;;;;;;;;;;;1,0;;;4,0;;;;;5,0;;;;;17,0;;;2,0;;;;;;;;;;;;;;;;;;1,0;;;;;;;9,0;2,0;;;;;;1,0;;;;;;;;;;2,0;;;;;;;;;;;;;;;;3,0;;;13,0;;;3,0;;3,0;;;;;;;;;2,0;;;;;;;;;;;;;;1,0;;;2,0;;;;;1,0;4,0;1,0;;;1,0;1,0;;;1,0;;;5,0;;;;;;;7,0;;;;;;;1,0;;4,0;;;;1,0;2,0;;;;3,0;;20,0;;;7,0;;2,0;;;;2,0;;3,0;;;4,0;7,0;;;;;;;;;;;;;;;;;;;;;;5,0;;;;;;;;;;;1,0;;;;;;;;;1,0;;;2,0;;;;;;;;;;;;;;;;;;;4,0;;;;17,0;1,0;;5,0;;;3,0;6,0;;;;;;;;;;;7,0;;;;;;;1,0;;;;;;;;;1,0;;;;;;;;;1,0;;;;
hand;;1,0;8,0;;14,0;;2,0;21,0;;21,0;5,0;4,0;1,0;;3,0;2,0;2,0;;4,0;7,0;;17,0;22,0;3,0;14,0;;;6,0;1,0;31,0;4,0;26,0;71,0;;39,0;1,0;;3,0;;19,0;;;5,0;4,0;;;;1,0;4,0;6,0;3,0;4,0;;;;100,0;13,0;;1,0;5,0;;2,0;21,0;;2,0;1,0;3,0;;;11,0;;;;;;;;28,0;34,0;2,0;1,0;3,0;2,0;;;;2,0;;;13,0;3,0;4,0;4,0;3,0;4,0;1,0;;;11,0;;;20,0;;;1,0;1,0;1,0;2,0;;;2,0;1,0;1,0;6,0;13,0;;;;;3,0;;3,0;;1,0;;;18,0;2,0;;2,0;5,0;2,0;;;;5,0;2,0;;;2,0;;;;3,0;;;1,0;;4,0;;;;;;14,0;;;10,0;;4,0;;;;;;;;4,0;1,0;;4,0;;2,0;12,0;7,0;3,0;;1,0;;;;;;;1,0;;1,0;1,0;;8,0;;;4,0;7,0;;;;;4,0;;;4,0;;6,0;;;;3,0;;10,0;;;;;3,0;;2,0;;;;;;3,0;;;;11,0;;;;1,0;;;;8,0;2,0;;1,0;3,0;;;2,0;1,0;1,0;1,0;;;;;;;;;6,0;;;;2,0;7,0;;;2,0;1,0;1,0;5,0;;1,0;;1,0;;;3,0;;47,0;;2,0;1,0;;2,0;1,0;1,0;;;17,0;;3,0;1,0;26,0;14,0;1,0;;;;4,0;;;;;;;23,0;;2,0;;;;;2,0;;;20,0;2,0;;;2,0;;1,0;;;;;;8,0;;;2,0;;2,0;1,0;;107,0;;14,0;;;;;;;1,0;;8,0;;1,0;2,0;;;2,0;;19,0;4,0;4,0;;;;;;;;;;;;1,0;4,0;8,0;;;;;;;;;;1,0;;;;1,0;;;;1,0;;1,0;;;;;1,0;2,0;;;7,0;2,0;;1,0;;;2,0;;;;;;1,0;5,0;;1,0;2,0;;;1,0;;;;;20,0;;1,0;2,0;;1,0;6,0;3,0;;;;5,0;;;;;;1,0;;;;3,0;12,0;;;;;13,0;;;1,0;2,0;;1,0;;3,0;;;;1,0;;;;;;;;22,0;1,0;3,0;5,0;;;5,0;2,0;3,0;2,0;;;;1,0;4,0;;;;;;2,0;2,0;2,0;;2,0;;;;2,0;21,0;2,0;;;;1,0;1,0;;;;;;;;;2,0;;;;1,0;1,0;;;;;;;1,0;;;;;1,0;2,0;;;;;;;;;21,0;;;;;1,0;;;;;1,0;;;;6,0;;;;;;;;;;2,0;;;;2,0;;8,0;;;;;;;;;;1,0;;;;;;3,0;;;;;;;;1,0;;1,0;;1,0;;1,0;;;;;;1,0;;7,0;;;1,0;;;;7,0;;;;;;;1,0;;;;;;;;;;;;;;6,0;;;;;;1,0;;2,0;;;;;;;2,0;;;3,0;3,0;;;1,0;;1,0;;;;18,0;;;;;2,0;24,0;;;;1,0;;1,0;;;;;;;;;;;;;;;;;;;1,0;2,0;;;;;1,0;;;;;;;;;;;;3,0;;1,0;2,0;2,0;;;;;;;;;;;;1,0;;;;;6,0;;;;;;;;;;;;;;18,0;;;;;1,0;;5,0;;;;;;1,0;1,0;;;;;1,0;;;7,0;;;;;;;1,0;;11,0;;;;3,0;;;;9,0;;;;;;;;;;5,0;4,0;;;;;27,0;1,0;23,0;;;;;;;1,0;;;;;;;3,0;;;;;;;;;;;;;;;9,0;4,0;;;1,0;;;;;;;;;2,0;;;;;;2,0;1,0;;;;;;;;;;;;;1,0;;;1,0;;2,0;;;1,0;;;1,0;;;;;;;;;;;;;;12,0;;;;1,0;;;3,0;1,0;;;;;1,0;;1,0;;;;;3,0;;;;4,0;1,0;;;2,0;;;;;;;;5,0;;1,0;;;3,0;;;;;;;;;;;;;;1,0;;;;;;1,0;;;;;;;;;;;;;;;;;;;;;5,0;;;;;2,0;;;;;;;;;;;;;;;;;;;;;;;;
handheld;;1,0;;;14,0;;;2,0;;35,0;;;;;2,0;3,0;;;2,0;10,0;;9,0;5,0;;;;;10,0;;2,0;;11,0;293,0;;20,0;1,0;;4,0;;26,0;;;;5,0;;;;;;;;1,0;;1,0;;68,0;20,0;;1,0;1,0;;;57,0;;;;;;;5,0;6,0;;;;;;;6,0;24,0;;1,0;15,0;7,0;1,0;;;;1,0;;4,0;16,0;;;2,0;;;;4,0;11,0;2,0;4,0;23,0;;1,0;1,0;;6,0;1,0;;;;;2,0;21,0;2,0;;;;1,0;12,0;;;;;;;10,0;;;5,0;1,0;;;;3,0;;;;;;;;1,0;;;;;1,0;;;;;;;8,0;;;9,0;2,0;8,0;;;;;;1,0;;3,0;;1,0;4,0;;18,0;2,0;7,0;;;1,0;1,0;;;;;;;;;1,0;;9,0;1,0;;;4,0;;;;;2,0;20,0;;1,0;;;;;;;6,0;1,0;;;;;1,0;7,0;1,0;;;;;;;1,0;;;;;;;;2,0;;;;4,0;;;;;1,0;;;;;;;;;;;;;7,0;;;1,0;3,0;;;;;2,0;;;;;;;;;;;;;1,0;;;1,0;2,0;1,0;;;4,0;;6,0;2,0;4,0;11,0;;;;;;;;;1,0;;;76,0;;;;;;;;;;;2,0;;;;;;;;;;8,0;;;;1,0;;;;;36,0;;;;;5,0;;2,0;1,0;;;9,0;;;;;;;;7,0;2,0;1,0;9,0;;1,0;;;;;1,0;;;;;8,0;;;;2,0;;;;;5,0;;1,0;;;;;;1,0;;2,0;;;;;;1,0;;;;;;;;2,0;;1,0;3,0;;3,0;;1,0;;2,0;2,0;1,0;2,0;;;;1,0;;;2,0;4,0;3,0;1,0;2,0;;;41,0;5,0;7,0;1,0;;1,0;;;;;;;4,0;;1,0;2,0;3,0;;;;;;6,0;;;;;;;3,0;4,0;;;;;;;;;1,0;;;;;;;;;6,0;1,0;;2,0;;16,0;1,0;;;3,0;;;;;;3,0;;;;;1,0;;;13,0;5,0;;1,0;;;2,0;;1,0;;;;;;;;;;;2,0;26,0;8,0;;;;;;;1,0;;;;1,0;;;;;;;;;;;;;;;;;;;;;;;;;9,0;;2,0;6,0;;;2,0;;;;;4,0;;;;;;;;3,0;2,0;12,0;1,0;;1,0;;1,0;;;;;;;;1,0;;;;;14,0;;;;8,0;;;;;;;;;;;2,0;;;;2,0;;1,0;1,0;;;3,0;4,0;;;;;;;3,0;;;;7,0;;;;;;;;;;;;;;2,0;;;;;;2,0;4,0;;;;;;;;;;;;6,0;;;;;;;;;;;;;1,0;;;;2,0;;;;;;;;;;;;;;;;;;;;;1,0;;;;;;;;;;;2,0;;;;;;;;3,0;;;;;;2,0;;;;;;;1,0;;;;;;;;1,0;;;;;;;;;;;;;;2,0;;;;1,0;1,0;;;;;;;;;;;;;;;;3,0;;;;;;3,0;;;;;;;;;;;;;;3,0;4,0;;;;;2,0;23,0;;;;;;;3,0;;;;;;;;;;;1,0;;;;;;;;;;;;1,0;2,0;;;;;;;;;;;;;;;;;;;;;;;;;;;;;;;;;;;;;;;;20,0;;;;;;;;;;;;;;;;1,0;;;;;;;;;;;;;1,0;;;;;2,0;;;;;;;;1,0;;;;;;;;;;;;;;;;1,0;;;;;;;;;;3,0;;;1,0;;;;;;;;;;;1,0;;;;;;;;;;;;;;;;;;;;;;;;;;;;;;;;;2,0;1,0;;;;;;;;;;;;
handle;;1,0;;;3,0;;11,0;23,0;;1,0;1,0;;;;1,0;2,0;2,0;;6,0;;;7,0;3,0;;;;;25,0;;;;;20,0;6,0;5,0;;;;;5,0;;;;4,0;;;;;;;;4,0;;;;37,0;29,0;;4,0;3,0;;;14,0;;;;;;;5,0;;;;;;;;4,0;3,0;2,0;;2,0;2,0;;;;2,0;;;;2,0;;;7,0;3,0;1,0;;;;;11,0;91,0;;;;;;24,0;;;5,0;;;21,0;12,0;;;;;5,0;;;;;;;6,0;;;21,0;4,0;6,0;;;;2,0;8,0;3,0;;;;;3,0;2,0;1,0;;4,0;2,0;2,0;;;;;1,0;5,0;;2,0;5,0;1,0;7,0;;;;2,0;;5,0;;5,0;;;20,0;;13,0;23,0;1,0;1,0;;11,0;;;;;1,0;;2,0;2,0;7,0;20,0;;20,0;4,0;3,0;1,0;6,0;1,0;;;;5,0;9,0;;3,0;;7,0;;;;7,0;1,0;30,0;;;6,0;;2,0;6,0;1,0;2,0;;;;5,0;1,0;;;;;;2,0;;;;;2,0;;2,0;;;1,0;;;;;1,0;7,0;2,0;;;;;;;;5,0;;;;1,0;;;;;;;;1,0;17,0;;;3,0;;1,0;1,0;3,0;;3,0;;;;4,0;1,0;;;;;;;;1,0;1,0;;;;;;4,0;;;;;14,0;;;;;;;6,0;5,0;1,0;;;;;4,0;;;;7,0;1,0;;1,0;19,0;;;2,0;;;;2,0;26,0;;3,0;;;;;;;;;;;;;;;5,0;;;;;;;;;;;;;;;;;;;;;1,0;;;;;;;;2,0;;;1,0;;;;;;;;;;;1,0;;;;5,0;;;;;;;;;;;;2,0;;;;;2,0;3,0;;;;;;;;;;;;;;;;;;;;;;;;;;2,0;2,0;;;;;1,0;1,0;;4,0;;;;;1,0;;;11,0;;;;;;;;;;;;1,0;;;;5,0;12,0;;;;;;;;;;4,0;;;12,0;;;;;;;;;14,0;4,0;;;2,0;;;;;;;;;;;;4,0;;;;1,0;1,0;;;;;;3,0;;2,0;;;1,0;1,0;1,0;;;;;;;;29,0;7,0;;;;2,0;;;1,0;1,0;;;;;;;;;2,0;;4,0;;1,0;;1,0;;;1,0;10,0;;12,0;;;;;;2,0;;;;;;;;;4,0;;;;;;;;;;;;;;;;;;;;;;;;;;;;;;;;;1,0;;6,0;6,0;4,0;;;;;2,0;;;;1,0;;;;;1,0;5,0;;;2,0;;;;;;1,0;;;;;;;;;3,0;;;1,0;;1,0;;;1,0;4,0;2,0;;;;;;;;;;;;;;5,0;;;;;;;;;;;;;;;;;;;;;2,0;;;;;;;;;;;;;4,0;;;;;;;;2,0;;2,0;;;;;;1,0;;2,0;;;;;;;;;;;;;1,0;;;;;;;;;;;;;;;;;;;;;;;;;;;;;;;;;;;;1,0;;1,0;;;;;;;;;;;;;;;;;;;;;1,0;1,0;;;;;;;;;;;;;;;;;;;;;;;;;;1,0;;;;;;;2,0;;;;;;;;;;;;;;;;;;;1,0;;;;1,0;;1,0;;;;;;;;;;;;2,0;;;;2,0;;;;;;;;2,0;;6,0;;;;1,0;;;;;;;;;;;;;;2,0;;1,0;;;;;;;;;;1,0;2,0;;;;;;;;;;;;;;;1,0;;;;;;;;;;;;;;;;;;;;;;;;;;1,0;;;;;;;;;;;;;;;;;;;;2,0;;;;;;;;;;;;;;;;;;;;;;;
host;;1,0;;;;;;7,0;1,0;1,0;;;;;;;;1,0;;18,0;;13,0;;1,0;;;;14,0;;;;6,0;38,0;;9,0;;;;;2,0;1,0;;;;;;;;;;;12,0;;;;31,0;6,0;;;9,0;;;9,0;;;;;;;1,0;;4,0;;2,0;;;;1,0;1,0;1,0;;3,0;4,0;;;;;;;10,0;8,0;;;8,0;;4,0;;;4,0;;;15,0;;2,0;;;1,0;20,0;;;;;;;;;;;;;;;;;;;7,0;;;1,0;;1,0;;;;;;;;;;;;;;;;1,0;;;;;;;;;;;1,0;3,0;;;;;;;;;;;;;26,0;;;;;1,0;;;;;;;;;;1,0;;;;;;8,0;;;;;;;;;;;;;;;;;;;;;;5,0;1,0;;;;;2,0;;;;;;;;;;;;;;;;;1,0;;;;;;;;;;;;;;;7,0;;;;;;;;;;;;1,0;;;;;;;;;1,0;14,0;;;;3,0;;;4,0;;;1,0;;8,0;2,0;;1,0;;;;;;;;;;;;;;;;;;;;;;;;;;;;;;;1,0;;;;2,0;;;;;8,0;;2,0;;;;;;1,0;;;;;;;;;;;1,0;;7,0;1,0;;4,0;;;;;;;;;;;1,0;;;;;;;;;;12,0;;;;;;;;1,0;;;;;;;;;;;4,0;;2,0;;;;;;;;;2,0;;;;;;;;;2,0;1,0;;;;;10,0;;;;;;;;;;;;;;;;;;;;1,0;;1,0;3,0;15,0;1,0;;;;;;1,0;;1,0;;1,0;;;;1,0;;;1,0;;;7,0;;;1,0;;;1,0;;;4,0;;;1,0;;;3,0;;8,0;;;;;1,0;;;;1,0;;;12,0;;2,0;;;;;2,0;;1,0;1,0;1,0;;;;;;;;;3,0;4,0;2,0;;;;;;;;;;1,0;;;;1,0;;;1,0;9,0;;;;2,0;;;;1,0;;;;;1,0;;;4,0;;;;11,0;;;;;;;;1,0;;;;6,0;;;;;5,0;1,0;23,0;;;;1,0;;;;1,0;;;;;;4,0;;;4,0;;;;;;;;;;;;;;;;;;;;;;;;;;;;;1,0;;;;1,0;;;;;2,0;;;;;;2,0;;;;;;;;;;;;;;;;;;;;;;;;;;;;;;;;;;;;;;;;;;;;;;;;;;;;;;;;;;;;;;;;;;2,0;;;;;;;;;3,0;;;;;;;;3,0;;;;;;;;;;;;;;;1,0;;;;;;1,0;;;;;;;;;;;;;;;;;;;;;;;;;;;;;;;;;;;;;;;;;;;;;;;;;;;;;;;;4,0;;;;;;;;;;;1,0;;;;;;;;;;;;;5,0;;;;;;;;;;;;;;1,0;;;;;;;;;;;;;;;;;;;;;;;;;;;;;;;;;5,0;;;;;;;;;;;;;;;;;;;;;;;;;;;;;;;2,0;;;;;;;;;;;3,0;;;;;1,0;;;;;;;;;;;;;;;;;;3,0;4,0;;;;2,0;;;;;;;;;;;;;;;;;;;;;;;;;;;;;;;;;;;;1,0;;;;;;;;;;;;;;;;;;;;;;;;;;;;
house;;15,0;16,0;1,0;177,0;;63,0;162,0;2,0;96,0;24,0;1,0;7,0;;;3,0;1,0;;42,0;12,0;10,0;43,0;2,0;5,0;5,0;;4,0;50,0;10,0;39,0;8,0;10,0;290,0;2,0;85,0;;16,0;42,0;14,0;135,0;23,0;;29,0;130,0;3,0;3,0;3,0;13,0;24,0;;7,0;22,0;;26,0;11,0;359,0;430,0;;21,0;870,0;5,0;1,0;71,0;;1,0;40,0;25,0;17,0;1,0;30,0;187,0;7,0;22,0;11,0;11,0;7,0;1,0;24,0;283,0;38,0;9,0;33,0;35,0;9,0;;4,0;25,0;14,0;;4,0;212,0;;8,0;25,0;16,0;88,0;;25,0;19,0;45,0;415,0;164,0;;10,0;;4,0;11,0;302,0;3,0;6,0;76,0;40,0;10,0;225,0;91,0;19,0;5,0;;87,0;123,0;23,0;6,0;1,0;93,0;3,0;2,0;142,0;70,0;;203,0;170,0;1,0;1,0;7,0;15,0;71,0;331,0;2,0;2,0;17,0;7,0;3,0;57,0;64,0;49,0;32,0;208,0;22,0;14,0;9,0;;38,0;28,0;20,0;20,0;46,0;92,0;;16,0;83,0;2,0;1,0;131,0;105,0;;10,0;2,0;119,0;;37,0;277,0;9,0;391,0;331,0;42,0;128,0;75,0;10,0;24,0;;31,0;35,0;49,0;;25,0;76,0;62,0;128,0;;328,0;6,0;33,0;13,0;141,0;10,0;11,0;;4,0;55,0;119,0;2,0;66,0;32,0;181,0;32,0;;1,0;22,0;72,0;184,0;3,0;7,0;22,0;4,0;8,0;11,0;27,0;87,0;;11,0;111,0;29,0;2,0;12,0;111,0;1,0;90,0;9,0;;4,0;38,0;1,0;14,0;29,0;8,0;21,0;7,0;8,0;33,0;7,0;116,0;4,0;13,0;134,0;21,0;26,0;20,0;12,0;11,0;21,0;;1,0;31,0;174,0;5,0;5,0;56,0;128,0;4,0;10,0;4,0;13,0;17,0;15,0;112,0;15,0;90,0;14,0;19,0;9,0;16,0;93,0;20,0;7,0;39,0;31,0;1,0;3,0;8,0;104,0;18,0;22,0;6,0;73,0;13,0;40,0;66,0;34,0;15,0;24,0;14,0;2,0;3,0;1,0;3,0;15,0;;21,0;6,0;2,0;68,0;8,0;20,0;25,0;25,0;23,0;6,0;6,0;33,0;25,0;4,0;1,0;13,0;3,0;24,0;2,0;52,0;27,0;15,0;38,0;4,0;6,0;14,0;38,0;2,0;77,0;20,0;30,0;19,0;;34,0;1,0;6,0;4,0;;1,0;;5,0;2,0;10,0;7,0;5,0;;5,0;2,0;4,0;1,0;15,0;18,0;2,0;42,0;;34,0;;;;;;34,0;4,0;;1,0;11,0;9,0;1,0;6,0;;;26,0;1,0;;7,0;;14,0;2,0;29,0;5,0;1,0;;14,0;2,0;33,0;8,0;1,0;;;;;;21,0;4,0;;13,0;;22,0;;2,0;16,0;;1,0;;;7,0;;;10,0;;6,0;2,0;7,0;22,0;38,0;21,0;13,0;6,0;3,0;10,0;;10,0;10,0;18,0;1,0;;19,0;10,0;8,0;;;;4,0;;;3,0;;2,0;2,0;;2,0;6,0;53,0;6,0;;6,0;10,0;8,0;33,0;;9,0;4,0;7,0;;;19,0;12,0;7,0;;;;;;;;;;9,0;13,0;28,0;;;;2,0;6,0;4,0;3,0;12,0;;56,0;1,0;1,0;;;;;4,0;;115,0;14,0;5,0;2,0;2,0;1,0;26,0;11,0;4,0;44,0;68,0;;;4,0;8,0;7,0;;;;83,0;10,0;;11,0;16,0;8,0;72,0;4,0;;12,0;29,0;9,0;43,0;;;;11,0;11,0;;9,0;;3,0;18,0;6,0;3,0;2,0;3,0;;52,0;12,0;;2,0;7,0;10,0;9,0;3,0;1,0;;;66,0;59,0;1,0;18,0;2,0;;3,0;1,0;9,0;30,0;;12,0;4,0;16,0;8,0;5,0;3,0;;4,0;21,0;;16,0;;53,0;;10,0;1,0;14,0;;;;97,0;;48,0;2,0;6,0;4,0;;5,0;6,0;;;90,0;27,0;;;;8,0;16,0;;1,0;12,0;;7,0;2,0;4,0;5,0;6,0;;19,0;;5,0;;8,0;1,0;2,0;1,0;29,0;13,0;16,0;;;;5,0;3,0;6,0;;;3,0;;19,0;1,0;5,0;12,0;4,0;7,0;16,0;;12,0;14,0;10,0;4,0;2,0;3,0;;49,0;12,0;7,0;1,0;6,0;7,0;8,0;;;5,0;13,0;50,0;2,0;6,0;3,0;38,0;34,0;1,0;9,0;3,0;10,0;7,0;23,0;14,0;;6,0;2,0;8,0;16,0;37,0;17,0;;;;;8,0;5,0;3,0;2,0;1,0;;2,0;;;;;1,0;;;;;;;5,0;7,0;;1,0;;2,0;15,0;5,0;9,0;5,0;;;;5,0;23,0;;;1,0;9,0;1,0;3,0;;6,0;;;;8,0;;42,0;1,0;;1,0;3,0;;1,0;1,0;;8,0;;3,0;;;;;;;2,0;;23,0;;;;;2,0;;;;6,0;;;4,0;2,0;7,0;;;;;9,0;25,0;1,0;1,0;;4,0;;4,0;9,0;;;;2,0;;3,0;;;5,0;;8,0;2,0;;;7,0;;;;4,0;;1,0;;3,0;;;;;11,0;;;55,0;;6,0;1,0;;;11,0;;;12,0;;2,0;;;2,0;;14,0;;4,0;;;;3,0;2,0;;1,0;4,0;;3,0;5,0;4,0;6,0;2,0;3,0;15,0;4,0;6,0;8,0;4,0;;60,0;21,0;;2,0;;30,0;12,0;4,0;;;2,0;;13,0;;;;;;;21,0;1,0;11,0;;;;5,0;5,0;;6,0;8,0;5,0;;;;;;1,0;17,0;16,0;1,0;;;;;3,0;;8,0;52,0;;8,0;3,0;1,0;1,0;;6,0;;;2,0;;;;;2,0;;2,0;1,0;2,0;4,0;;;1,0;1,0;;;2,0;;4,0;;;1,0;;2,0;;;5,0;3,0;;;3,0;4,0;2,0;;1,0;;;;1,0;13,0;;;15,0;1,0;13,0;;;3,0;;;;;;;2,0;3,0;;8,0;1,0;;10,0;1,0;;;5,0;;;;;;;1,0;;2,0;;3,0;;;;;;;;;;1,0;;;;1,0;1,0;61,0;;;;;;;;;12,0;;;;
identification;;1,0;2,0;;29,0;;;32,0;6,0;30,0;;3,0;;;3,0;;;1,0;4,0;;2,0;33,0;4,0;;1,0;1,0;;160,0;;6,0;28,0;15,0;58,0;;12,0;;;;;36,0;22,0;;3,0;;;;;;27,0;21,0;4,0;14,0;2,0;4,0;;248,0;41,0;;;26,0;;;32,0;;;;;;;1,0;2,0;9,0;;;;11,0;;8,0;47,0;1,0;;10,0;6,0;;4,0;;2,0;2,0;3,0;12,0;9,0;;4,0;31,0;;1,0;;16,0;40,0;;;62,0;;7,0;2,0;;1,0;123,0;1,0;;;;;;9,0;;;;;2,0;;;;1,0;;;16,0;4,0;;1,0;2,0;;;;1,0;;1,0;;;1,0;;;18,0;12,0;;;2,0;5,0;;;;;;;;;;;;34,0;4,0;;;;54,0;;;1,0;;;1,0;;27,0;1,0;6,0;;;10,0;;;;;;;;;;39,0;;12,0;;;4,0;28,0;;1,0;;;;;;;;;;5,0;;;;1,0;2,0;;;;;4,0;51,0;;;;;1,0;;1,0;;;;;;;;;;;;8,0;;1,0;11,0;1,0;1,0;;1,0;;;4,0;;;;;;;;2,0;;;;1,0;;;;4,0;;;;;;;;;;;;;;2,0;;;;1,0;;;;;;;;24,0;;;16,0;;;;;;;43,0;;;;;1,0;1,0;17,0;;;1,0;;;13,0;1,0;;;;;;;;;;4,0;;;;9,0;;;;;46,0;;;;;;;2,0;;;;10,0;;6,0;1,0;;7,0;1,0;;1,0;;;;5,0;;;;;;;;;;;99,0;4,0;2,0;;;2,0;4,0;;;21,0;13,0;27,0;;2,0;;;1,0;;3,0;1,0;;;1,0;;;28,0;;7,0;;1,0;;8,0;;12,0;2,0;;5,0;;;;;;;;;1,0;;5,0;;2,0;;;2,0;;15,0;;9,0;;;5,0;3,0;;1,0;33,0;;;;;1,0;;1,0;;;;;2,0;;;3,0;;;6,0;;;12,0;;;1,0;;;;;;;2,0;;3,0;2,0;;;;;;;6,0;;;10,0;;;;;4,0;25,0;6,0;2,0;5,0;;4,0;;;;8,0;;;2,0;;;;;25,0;1,0;;;;;1,0;18,0;;1,0;;1,0;;;;;;;;11,0;36,0;;;;;;;;4,0;1,0;;;8,0;;;;;;;;10,0;;;;;3,0;;3,0;;;;;3,0;;;;2,0;;;;20,0;;3,0;;4,0;;10,0;;9,0;;;6,0;3,0;1,0;;;;7,0;23,0;;;;;;;;;;12,0;3,0;;9,0;;4,0;;;5,0;;;;1,0;;;;;;;5,0;1,0;;;;1,0;;;;;5,0;;;3,0;;2,0;;;;;;;2,0;;;;;11,0;;;;;;;;1,0;;;;;;;;;;5,0;;;;9,0;;;;;;;;;;;;;;;;;;;;;;;;;;7,0;1,0;;1,0;;;1,0;;1,0;;;;;;;2,0;;;;;;;;;;4,0;;;;;;;;3,0;;;;;;;;;2,0;5,0;;1,0;;;;;;;;;1,0;;5,0;3,0;;;;;;;;3,0;4,0;;;;;;;;;;;;;;;;;;;;;2,0;2,0;;;;11,0;1,0;1,0;;;;;1,0;;;;;1,0;;;6,0;;2,0;5,0;1,0;;;;;2,0;3,0;6,0;;;;;;;1,0;;;;;;6,0;;1,0;1,0;;;4,0;;;;;;;;;;;;;;;;;;2,0;;;;;1,0;;2,0;;;;;6,0;1,0;;;;;;;;1,0;1,0;5,0;;7,0;;;;;;;;;;;;;;;;;;;;8,0;;5,0;;;;;;;;;;;;;;1,0;;;;;;1,0;;;;;;;;;;13,0;;3,0;;;1,0;;;8,0;;;;;;;;;;;;1,0;;;;;;;;1,0;;;;;;1,0;;;;2,0;2,0;;1,0;;;;;;;;;;;;;;;;;;;;;;;;;;;;;;;2,0;;;;;1,0;;;;;;;;;;;;;;
illumination;;6,0;45,0;;67,0;;31,0;43,0;5,0;55,0;4,0;14,0;;;51,0;11,0;6,0;;25,0;10,0;70,0;151,0;1,0;2,0;57,0;2,0;5,0;150,0;19,0;47,0;10,0;73,0;183,0;4,0;30,0;2,0;49,0;13,0;;117,0;8,0;;;35,0;1,0;7,0;;;13,0;12,0;12,0;55,0;1,0;19,0;1,0;209,0;86,0;;;95,0;19,0;2,0;129,0;28,0;7,0;1,0;9,0;3,0;;27,0;84,0;1,0;68,0;;;10,0;;14,0;66,0;43,0;1,0;28,0;10,0;7,0;1,0;;26,0;;4,0;65,0;56,0;5,0;4,0;13,0;4,0;7,0;;1,0;26,0;;25,0;176,0;;;;1,0;;221,0;;1,0;11,0;16,0;19,0;20,0;4,0;2,0;1,0;2,0;6,0;16,0;;1,0;1,0;26,0;;;39,0;14,0;1,0;16,0;;2,0;;;1,0;13,0;12,0;;;93,0;17,0;4,0;16,0;18,0;22,0;2,0;38,0;43,0;;2,0;2,0;;6,0;3,0;4,0;;;16,0;;59,0;21,0;8,0;2,0;5,0;;;103,0;585,0;;;23,0;20,0;82,0;16,0;11,0;3,0;;21,0;1,0;;2,0;;5,0;1,0;1,0;10,0;21,0;109,0;5,0;66,0;;7,0;29,0;48,0;;40,0;;;7,0;3,0;13,0;10,0;;7,0;;6,0;;;3,0;;14,0;;;;;29,0;8,0;3,0;1,0;;;6,0;;71,0;22,0;39,0;4,0;;;1,0;;;;9,0;27,0;7,0;49,0;9,0;19,0;;3,0;;3,0;;;1,0;9,0;10,0;1,0;;;;;13,0;;1,0;1,0;16,0;4,0;1,0;3,0;1,0;1,0;;15,0;;9,0;;;1,0;1,0;4,0;;;2,0;2,0;20,0;;;12,0;;;3,0;4,0;;2,0;8,0;94,0;11,0;1,0;12,0;;6,0;48,0;;2,0;;16,0;;;15,0;;25,0;23,0;;1,0;;26,0;;3,0;9,0;11,0;2,0;;19,0;;2,0;;;;;2,0;;1,0;;255,0;;;10,0;;2,0;2,0;1,0;;;;;11,0;;;;11,0;;2,0;;1,0;;2,0;;21,0;4,0;3,0;5,0;4,0;;6,0;1,0;;;;2,0;2,0;;;2,0;16,0;;1,0;11,0;1,0;15,0;;;27,0;4,0;4,0;2,0;7,0;;4,0;7,0;25,0;1,0;6,0;2,0;7,0;3,0;8,0;4,0;16,0;5,0;9,0;2,0;;10,0;3,0;3,0;14,0;6,0;;2,0;;3,0;5,0;;;1,0;4,0;;4,0;2,0;6,0;;11,0;2,0;39,0;2,0;;13,0;2,0;3,0;1,0;;1,0;55,0;1,0;;;1,0;182,0;2,0;;;;;;;;;7,0;4,0;2,0;6,0;3,0;;18,0;3,0;;3,0;;;2,0;62,0;62,0;;;;1,0;18,0;;;;;7,0;;8,0;1,0;;3,0;;;14,0;2,0;1,0;6,0;;;;;;;;;;2,0;9,0;16,0;5,0;;21,0;;2,0;24,0;17,0;6,0;28,0;;11,0;;;;;;6,0;35,0;;7,0;2,0;13,0;;;;;2,0;14,0;;6,0;;;;;2,0;33,0;4,0;;56,0;;4,0;6,0;6,0;;;;;;;1,0;;2,0;;4,0;2,0;;;;10,0;;;1,0;;10,0;;;8,0;;;35,0;1,0;;1,0;15,0;;;;;;35,0;;;21,0;;1,0;;;;1,0;;;;;;6,0;39,0;9,0;;;;;;;1,0;;;90,0;2,0;;2,0;;2,0;;14,0;19,0;21,0;3,0;1,0;1,0;;;1,0;;1,0;;;;;;19,0;;5,0;;;;1,0;6,0;2,0;;;;10,0;;;;9,0;6,0;11,0;;108,0;;;11,0;;;;2,0;;;;;;;11,0;8,0;;1,0;;;;;;;2,0;;;;2,0;5,0;;;;;8,0;;2,0;;2,0;1,0;;11,0;;;;;11,0;7,0;;1,0;;;8,0;;5,0;;7,0;;4,0;;;;1,0;4,0;9,0;1,0;;2,0;2,0;;;;2,0;2,0;;1,0;2,0;9,0;;;;12,0;;;1,0;;4,0;;1,0;;;;;;1,0;;3,0;7,0;;;1,0;;;1,0;62,0;1,0;;7,0;6,0;;4,0;2,0;2,0;;;;;3,0;;;;3,0;2,0;2,0;2,0;6,0;3,0;;;1,0;;3,0;2,0;6,0;5,0;5,0;1,0;40,0;;;2,0;10,0;9,0;;;;;;;4,0;;;;1,0;1,0;;;;;;;;;;;;;;;15,0;;3,0;1,0;2,0;;;1,0;70,0;;2,0;36,0;;4,0;;;;;;3,0;1,0;;;160,0;14,0;1,0;;17,0;2,0;;;1,0;;;;1,0;11,0;3,0;;;;;;;;2,0;;;;11,0;;1,0;;2,0;10,0;6,0;;;;7,0;;1,0;;;;;;;;;;3,0;1,0;;;10,0;;3,0;;;;;;;;;5,0;1,0;;;;;;;3,0;;3,0;;;;;;;;1,0;1,0;11,0;;37,0;;4,0;19,0;;;;5,0;;;;;;;44,0;6,0;;;6,0;;;;;;18,0;;2,0;;6,0;;;;;1,0;;;;;8,0;;;;;1,0;;;;1,0;;;;;;;5,0;;;;;;1,0;2,0;;1,0;;5,0;;;;;;1,0;2,0;;;;;;;;;;;;;;
inner;;2,0;2,0;;9,0;;27,0;70,0;3,0;8,0;14,0;;13,0;;;;;;21,0;;;;;;;;4,0;;1,0;4,0;;;23,0;2,0;10,0;;;25,0;;5,0;2,0;;3,0;43,0;;;5,0;;2,0;;3,0;;;3,0;3,0;24,0;67,0;;1,0;236,0;4,0;;10,0;;;7,0;3,0;;;4,0;42,0;2,0;1,0;80,0;78,0;;;3,0;69,0;1,0;5,0;;2,0;;;;3,0;5,0;;;23,0;;;2,0;7,0;60,0;;;4,0;18,0;681,0;14,0;;;;;10,0;65,0;;2,0;;23,0;6,0;17,0;61,0;5,0;13,0;;13,0;43,0;8,0;1,0;1,0;6,0;3,0;;14,0;58,0;;29,0;82,0;1,0;;129,0;6,0;;100,0;1,0;11,0;2,0;;;8,0;46,0;31,0;;163,0;70,0;;;;53,0;33,0;1,0;13,0;66,0;43,0;131,0;2,0;11,0;8,0;2,0;;22,0;;35,0;2,0;16,0;;11,0;69,0;10,0;79,0;77,0;11,0;74,0;302,0;1,0;3,0;;3,0;3,0;2,0;;27,0;5,0;25,0;61,0;;314,0;;24,0;1,0;36,0;6,0;7,0;;9,0;36,0;8,0;1,0;7,0;;114,0;12,0;1,0;2,0;1,0;48,0;115,0;;3,0;;;;1,0;1,0;21,0;;50,0;27,0;;1,0;2,0;160,0;1,0;17,0;;;11,0;8,0;;5,0;23,0;3,0;2,0;117,0;4,0;18,0;1,0;227,0;9,0;5,0;24,0;3,0;20,0;11,0;6,0;55,0;18,0;;;11,0;76,0;;1,0;51,0;81,0;;70,0;;3,0;14,0;32,0;61,0;4,0;57,0;7,0;16,0;2,0;4,0;15,0;2,0;2,0;4,0;;;;15,0;14,0;2,0;35,0;;12,0;4,0;;12,0;;1,0;19,0;;;;5,0;4,0;3,0;1,0;;8,0;1,0;;1,0;5,0;7,0;7,0;20,0;2,0;1,0;6,0;35,0;;1,0;16,0;2,0;155,0;;6,0;22,0;21,0;12,0;7,0;5,0;70,0;6,0;;;11,0;16,0;;;;;3,0;;;;;;2,0;;;;;;;;;3,0;7,0;1,0;3,0;;;;;;;;4,0;;;;;;;;1,0;;;;;4,0;;;;;2,0;;;12,0;;;6,0;;;;;;;;1,0;1,0;10,0;;3,0;;;;;;;;2,0;;3,0;;;5,0;;;5,0;5,0;1,0;1,0;;;6,0;;4,0;4,0;;;;1,0;;;;;;;;;;;;6,0;;;;1,0;;;;1,0;;;2,0;;;3,0;;;;;1,0;;;;;;;;;2,0;2,0;;17,0;;;;2,0;2,0;;;5,0;;7,0;;;;;;;;;26,0;;;;;;12,0;;4,0;10,0;1,0;;3,0;1,0;;;;;;13,0;8,0;;5,0;;12,0;15,0;;;;5,0;8,0;4,0;;;;;15,0;;;;;3,0;;;2,0;1,0;;8,0;;;;2,0;;;;;;;15,0;;;;2,0;;;;;1,0;;;5,0;;;;2,0;6,0;;;;;;14,0;;;;;;;;23,0;;7,0;;;;;;2,0;;;5,0;97,0;;;;4,0;2,0;;1,0;;1,0;;;1,0;;1,0;;1,0;;;;;6,0;;;4,0;7,0;4,0;;;;1,0;1,0;;;;;;5,0;;1,0;;;;;;2,0;9,0;2,0;;3,0;3,0;;3,0;;4,0;;9,0;11,0;;;;;9,0;;;6,0;;;29,0;2,0;9,0;5,0;;;;1,0;;15,0;2,0;;;6,0;15,0;2,0;;;;;6,0;;1,0;;;;;;;;;;;3,0;;;;;;;;;;1,0;;;3,0;;;;;169,0;1,0;;;;;2,0;;;;;4,0;;;3,0;3,0;;11,0;;;;;;;;;;;;;;1,0;;;1,0;;;;;;;2,0;;;;;;;2,0;;;;;;;;;;;;;3,0;;;;;;1,0;;;7,0;;;;;;;;;;;;;;;;;;;3,0;;;;;;;;;6,0;;;;;5,0;;;;;1,0;11,0;;;;;;;;;;;;;;;;;;;3,0;;3,0;;;;;;;25,0;1,0;;2,0;;;;8,0;;;;;;;2,0;;7,0;;5,0;4,0;1,0;1,0;12,0;;;;;1,0;;;2,0;;11,0;;;;;;;1,0;1,0;6,0;7,0;;;1,0;1,0;;;;;;;;;;;1,0;;3,0;;1,0;;;1,0;;;;;;;;;;;;;;;;;;;;;;;;;;;;;;;1,0;;1,0;;;;3,0;;;;;2,0;;1,0;;;9,0;;1,0;;;1,0;1,0;;;;;;;;;;2,0;;;;;2,0;;;;;;;;;2,0;;;1,0;;;;;;;;;1,0;;;;
install;;1,0;;;5,0;;;33,0;;3,0;14,0;;;;;;;1,0;26,0;1,0;;5,0;;;;;;;;6,0;2,0;6,0;43,0;;16,0;;1,0;21,0;;3,0;5,0;;13,0;5,0;;;1,0;8,0;1,0;1,0;2,0;4,0;;7,0;;9,0;15,0;;6,0;142,0;4,0;;15,0;;;10,0;4,0;;;2,0;10,0;;2,0;12,0;1,0;4,0;;3,0;26,0;;1,0;;1,0;;;;;;;12,0;22,0;;3,0;5,0;;12,0;;;3,0;7,0;28,0;10,0;;1,0;;;1,0;38,0;;;4,0;;;14,0;7,0;;;;30,0;46,0;;;;19,0;;;6,0;6,0;;3,0;7,0;1,0;;5,0;;1,0;14,0;5,0;;;;2,0;;7,0;58,0;;6,0;70,0;;5,0;;6,0;14,0;;2,0;25,0;7,0;66,0;;4,0;;;15,0;33,0;;;;17,0;;;40,0;5,0;49,0;16,0;1,0;9,0;14,0;;2,0;;3,0;3,0;1,0;;2,0;;23,0;26,0;;16,0;;;;3,0;1,0;;;5,0;6,0;2,0;;2,0;;22,0;2,0;3,0;4,0;;7,0;25,0;1,0;13,0;1,0;;6,0;;1,0;9,0;;19,0;14,0;29,0;;;8,0;;;1,0;;;3,0;;3,0;5,0;8,0;2,0;4,0;3,0;5,0;;25,0;1,0;7,0;14,0;;9,0;;2,0;3,0;22,0;2,0;;;5,0;;;;2,0;;;;22,0;;4,0;3,0;;1,0;;;;2,0;9,0;;;1,0;4,0;;2,0;1,0;;1,0;23,0;;8,0;3,0;;11,0;3,0;;2,0;;;;3,0;11,0;;;6,0;;;7,0;;10,0;;;;;8,0;3,0;7,0;;4,0;;;19,0;;4,0;7,0;4,0;;2,0;2,0;13,0;6,0;;;3,0;1,0;1,0;;4,0;1,0;15,0;;;;;;;;1,0;2,0;1,0;;;;;1,0;;;1,0;;;;;;;;;;1,0;;;;6,0;;;;;;;2,0;;;;11,0;;;;1,0;;;;;;;;;;5,0;;;2,0;;9,0;;;2,0;;;;;1,0;;;;;19,0;;;1,0;3,0;1,0;;;;;;3,0;;2,0;;3,0;2,0;;3,0;;;;;;;1,0;;;3,0;;;;4,0;3,0;;;;;;;;1,0;;;;;;;;;;1,0;;;;;;3,0;7,0;10,0;;;;;3,0;2,0;;;;4,0;;;2,0;;;;;;15,0;6,0;;;;;8,0;;;10,0;6,0;3,0;;;;2,0;;6,0;;6,0;;;10,0;;2,0;4,0;;3,0;;3,0;3,0;1,0;;2,0;;2,0;;;;;1,0;;;;;1,0;;1,0;;;;1,0;;;3,0;;3,0;;;;1,0;;;;;;2,0;;;3,0;1,0;;2,0;;;4,0;;1,0;;;;4,0;;;;4,0;;;3,0;6,0;;3,0;27,0;;;;;;;;14,0;;;;;3,0;;;;1,0;;;;1,0;;;;;2,0;;;;;;;;2,0;;;1,0;;;1,0;;;;2,0;;1,0;;;1,0;;1,0;;;2,0;3,0;17,0;;16,0;;1,0;4,0;;;;;6,0;;;;;;;1,0;2,0;1,0;1,0;;;;;;1,0;5,0;;;;;4,0;;;;;;;;;2,0;;;;;;;;;;9,0;;;;;;;;;;;;;2,0;;;2,0;;;;;;;;;;;;;1,0;;;;;;;;;2,0;;;;;;;;8,0;;1,0;;1,0;;;;;8,0;;;;;;;;;;;;;;1,0;;;;1,0;;1,0;;4,0;;;;;;;4,0;;;;;;;1,0;;;;;;;;;;;;;;;;;;;3,0;;;1,0;;;;;;;;;;;;;;;;;2,0;;;;;;;;;;;2,0;;;;;;1,0;;;;;;;;;;;5,0;;5,0;;;;;3,0;1,0;;1,0;;;;4,0;1,0;;;1,0;;;1,0;;;;;;;;;;;;1,0;;;;;;3,0;;2,0;11,0;;;2,0;4,0;;;;;;;1,0;;;;2,0;;2,0;;;;;;;;;;;;;;;;;;;;;1,0;;;;;;3,0;5,0;;;;;;;1,0;;;;;;;;;;;1,0;;;;;;;;;;;;;;;;;;;1,0;;1,0;;;;;;2,0;1,0;;;;;;;;;1,0;;2,0;;;;;;;;;;;;;
instruction;;1,0;2,0;3,0;24,0;;5,0;64,0;16,0;124,0;1,0;1,0;;3,0;5,0;3,0;1,0;1,0;2,0;156,0;23,0;171,0;17,0;13,0;5,0;;;83,0;1,0;20,0;4,0;53,0;143,0;3,0;44,0;1,0;14,0;5,0;;102,0;6,0;11,0;8,0;9,0;;;;3,0;19,0;3,0;4,0;34,0;6,0;3,0;;426,0;110,0;;4,0;12,0;;4,0;54,0;1,0;2,0;2,0;39,0;;2,0;73,0;18,0;10,0;4,0;;;10,0;;10,0;57,0;2,0;;62,0;237,0;16,0;8,0;;23,0;1,0;4,0;76,0;23,0;7,0;32,0;97,0;9,0;6,0;3,0;57,0;132,0;4,0;5,0;86,0;;2,0;30,0;11,0;1,0;261,0;;;6,0;14,0;1,0;4,0;;9,0;;;;1,0;;;23,0;23,0;;1,0;55,0;;;10,0;;6,0;;;6,0;;;;;2,0;;;7,0;5,0;1,0;;12,0;42,0;;;;;;1,0;;;;;18,0;26,0;;1,0;;;2,0;;5,0;69,0;5,0;;25,0;;10,0;;23,0;2,0;;55,0;;;;;;3,0;1,0;4,0;;42,0;;43,0;;;;134,0;1,0;;;;4,0;;;3,0;;1,0;;1,0;;1,0;2,0;4,0;1,0;43,0;;;3,0;52,0;22,0;;;;;1,0;;;;;;;;;;;;;16,0;6,0;;8,0;24,0;12,0;;1,0;;;;5,0;;;;;;7,0;;2,0;2,0;;;3,0;;;7,0;2,0;1,0;;;;;;;2,0;;1,0;;;1,0;17,0;;;;2,0;1,0;;;6,0;;7,0;5,0;23,0;60,0;;;1,0;;2,0;;;;37,0;;;6,0;;32,0;3,0;6,0;;;16,0;;;23,0;9,0;3,0;;;;;;;;;2,0;;5,0;;2,0;;;1,0;;121,0;;;;;1,0;;10,0;;;;6,0;1,0;7,0;1,0;4,0;10,0;10,0;;37,0;;14,0;17,0;;;;;1,0;;;3,0;;;;20,0;17,0;1,0;5,0;;3,0;5,0;;;5,0;228,0;44,0;2,0;;;2,0;11,0;26,0;38,0;136,0;11,0;1,0;2,0;6,0;47,0;51,0;23,0;106,0;;;21,0;11,0;62,0;6,0;3,0;4,0;5,0;3,0;;;11,0;;3,0;15,0;4,0;1,0;;14,0;;2,0;1,0;2,0;12,0;;85,0;2,0;12,0;5,0;18,0;9,0;27,0;;4,0;11,0;2,0;11,0;38,0;;1,0;;29,0;;;2,0;1,0;;25,0;3,0;6,0;;2,0;13,0;2,0;5,0;35,0;;1,0;207,0;1,0;9,0;;8,0;2,0;53,0;;1,0;5,0;6,0;4,0;;8,0;4,0;;16,0;6,0;14,0;;100,0;;5,0;;1,0;43,0;2,0;;3,0;5,0;1,0;6,0;31,0;;4,0;3,0;12,0;;27,0;1,0;51,0;;2,0;17,0;8,0;;1,0;4,0;;1,0;;;5,0;5,0;;;;;;;;9,0;16,0;5,0;;;8,0;;6,0;;;2,0;18,0;;51,0;8,0;;;1,0;;;;20,0;12,0;2,0;;;;;;;10,0;1,0;;3,0;5,0;18,0;;1,0;15,0;27,0;;2,0;12,0;;9,0;2,0;1,0;13,0;11,0;;8,0;;;4,0;3,0;23,0;;;;8,0;2,0;1,0;;;;6,0;;;;3,0;7,0;1,0;3,0;3,0;;2,0;;26,0;9,0;;;4,0;;1,0;;;;;;2,0;18,0;;;;1,0;;;;;4,0;;;2,0;;8,0;;;8,0;3,0;;14,0;2,0;;;;;;;;1,0;;17,0;;;2,0;1,0;;;;1,0;;;1,0;7,0;;7,0;;;6,0;;1,0;;;;;;;4,0;2,0;;;;;2,0;1,0;;;;;;;;;;;;;2,0;;;3,0;;5,0;;;3,0;;;1,0;;;;2,0;;;;1,0;;;;;12,0;;2,0;;;4,0;24,0;;;1,0;1,0;;4,0;;1,0;6,0;;;;;;1,0;;;;;;;;10,0;8,0;;3,0;2,0;1,0;15,0;;1,0;;;3,0;3,0;3,0;;1,0;9,0;;;;;;17,0;6,0;1,0;5,0;;;;8,0;1,0;;1,0;;;1,0;5,0;;7,0;;1,0;;7,0;3,0;3,0;3,0;3,0;;6,0;;;2,0;;1,0;3,0;4,0;;;;;;8,0;8,0;4,0;41,0;;2,0;4,0;1,0;1,0;2,0;;;24,0;;6,0;5,0;2,0;;;2,0;1,0;;6,0;2,0;;1,0;;2,0;;5,0;;3,0;;;;18,0;1,0;3,0;;3,0;;;;;;2,0;;;;;3,0;;1,0;;1,0;;;;;;;;;;1,0;;;;;1,0;;2,0;4,0;2,0;;8,0;;;;;;;;;;;;;;;2,0;;;;;;3,0;;;2,0;;;;2,0;;5,0;;25,0;;;;;;;;;;3,0;;;13,0;;;;;;;3,0;1,0;;;;13,0;;;;;1,0;4,0;2,0;;;73,0;;;;;;;;1,0;;15,0;2,0;;;;;;;;;2,0;;;;;;;2,0;;;;;;;;;;;;;;;;;;1,0;;;;;;2,0;2,0;;;5,0;;;;;;;;;
interchangeable;;4,0;11,0;;13,0;;3,0;5,0;;6,0;1,0;14,0;;1,0;3,0;;;;2,0;;2,0;39,0;;4,0;11,0;;;5,0;1,0;20,0;21,0;19,0;26,0;1,0;43,0;;1,0;4,0;1,0;11,0;;1,0;4,0;3,0;;;;8,0;17,0;;8,0;1,0;;3,0;;40,0;73,0;;7,0;653,0;;;22,0;;1,0;9,0;;;;16,0;38,0;;;;;6,0;;13,0;20,0;11,0;;4,0;;1,0;;;1,0;;;5,0;1,0;3,0;1,0;8,0;;;;16,0;5,0;1,0;6,0;92,0;;;;;48,0;82,0;;;1,0;3,0;;3,0;43,0;;5,0;;;126,0;;;4,0;1,0;1,0;;27,0;7,0;19,0;1,0;3,0;;;;;7,0;10,0;;;1,0;;;;;7,0;;7,0;1,0;1,0;;;2,0;;;4,0;1,0;;8,0;;34,0;;;;;;;;15,0;;;8,0;4,0;;73,0;5,0;6,0;1,0;2,0;;;2,0;2,0;6,0;;;;2,0;17,0;;13,0;;;;7,0;;;;;;;;;;5,0;;;;2,0;;2,0;;;;;2,0;10,0;7,0;;;;;;7,0;;;;;;2,0;;;;1,0;;;7,0;3,0;7,0;2,0;;12,0;;;;;;;;;;;;;12,0;6,0;;;11,0;;1,0;;1,0;;;4,0;1,0;1,0;;;;;;;;;;;;5,0;2,0;;;3,0;7,0;;1,0;;8,0;1,0;;;;;;;;;4,0;2,0;;;;5,0;;;;;11,0;;;;;;;6,0;;;;;;;;;;;3,0;;;5,0;;;;2,0;;;;;1,0;;;;5,0;;10,0;16,0;;;;;4,0;10,0;;;;;;;;;;;;;;;3,0;;;;;8,0;;;;;;;;;;7,0;1,0;;;;;;;;2,0;;;2,0;;;1,0;3,0;;;;;;;;;;;5,0;2,0;;;13,0;;5,0;;;;;;;2,0;;;;4,0;;;4,0;;;2,0;;;6,0;;13,0;;;;;;;2,0;;1,0;11,0;;2,0;;2,0;;;;;;;1,0;;1,0;;6,0;;1,0;3,0;;1,0;1,0;;;;;6,0;;;2,0;;;;;1,0;;;1,0;;;1,0;1,0;;3,0;3,0;;1,0;1,0;1,0;1,0;4,0;1,0;;;;;;;;4,0;8,0;;;;;;;;;16,0;10,0;;;;7,0;19,0;;;;;;2,0;;;;;;;;;;;;;;;;;;;2,0;;;;;;;;;;;;;1,0;;;;;;;;3,0;;;;;;;;;;1,0;;;;;;11,0;;;5,0;;;;;;;;1,0;;;;;;1,0;;3,0;11,0;;;;;15,0;;;;7,0;;;;;;5,0;14,0;;9,0;;;;;;;;2,0;;;;1,0;6,0;;;1,0;;;;;;;;;;;;;;;;;;;;;;;;;;;;;1,0;13,0;;;;;;;;;;;;;;;;;;;;;;;;;;;;;;;;;;;;;;;;;;;1,0;;;;;;;;;6,0;;;;;;;;;;;;;;;;;;;;;;;;;4,0;;;;;1,0;;;;;;;;;;;;;;;;;1,0;;;;;4,0;;;;;3,0;;;1,0;;;;;;;;;;;;;;;;8,0;;;;;;;;;;;;;;;;;;;4,0;;;;;;;;;;7,0;;;;;;;;;;;;;;;;;;;;;;;;;;;;;;;;;;;;1,0;;;;;;;;;;;;1,0;;;;;;;;1,0;;;;;;;;;;;;;;;;;;;;9,0;;;;1,0;;;;;;;1,0;;;1,0;;;;;;;;;;;;;;;2,0;;;;;;;;;;;;;;;;;;;;;;;;;;;;;;;;;;;2,0;;;;;;;;;;;;;;;;;;;;;;;;;;;;;;;;;;;;
interface;;3,0;;;29,0;;;26,0;7,0;53,0;3,0;3,0;1,0;;9,0;1,0;2,0;;3,0;55,0;2,0;160,0;11,0;1,0;;;3,0;125,0;;14,0;2,0;13,0;167,0;2,0;84,0;;4,0;7,0;7,0;145,0;2,0;2,0;19,0;24,0;1,0;1,0;;;7,0;3,0;4,0;19,0;2,0;16,0;9,0;336,0;147,0;;3,0;40,0;;1,0;97,0;2,0;;;4,0;;;20,0;14,0;3,0;8,0;18,0;1,0;;;3,0;38,0;17,0;;39,0;76,0;5,0;;1,0;51,0;;4,0;39,0;73,0;;3,0;99,0;12,0;7,0;2,0;43,0;22,0;4,0;47,0;195,0;;25,0;1,0;;64,0;130,0;;;27,0;10,0;7,0;8,0;6,0;;1,0;;10,0;49,0;17,0;;;88,0;;;110,0;18,0;;38,0;10,0;2,0;;;3,0;3,0;13,0;;4,0;2,0;2,0;;54,0;1,0;15,0;;21,0;14,0;1,0;;;;9,0;;;1,0;1,0;31,0;2,0;22,0;;;;5,0;;15,0;1,0;12,0;;8,0;3,0;12,0;227,0;31,0;2,0;3,0;;50,0;;5,0;2,0;14,0;;1,0;1,0;3,0;2,0;72,0;;14,0;;;3,0;101,0;;14,0;2,0;;;3,0;;12,0;;49,0;2,0;5,0;;;1,0;11,0;;;7,0;;2,0;12,0;45,0;3,0;;;;6,0;;;2,0;;19,0;;;2,0;;;7,0;11,0;6,0;4,0;;10,0;40,0;1,0;11,0;;2,0;10,0;5,0;;3,0;22,0;;;6,0;4,0;;104,0;;;3,0;12,0;3,0;;;1,0;;;4,0;3,0;16,0;;;;;1,0;3,0;;8,0;;3,0;;4,0;14,0;6,0;;11,0;10,0;;19,0;2,0;15,0;16,0;;;;3,0;3,0;;;;1,0;;;15,0;;2,0;;1,0;;;22,0;;;;21,0;;;;;;;;;;10,0;;2,0;;11,0;;1,0;1,0;;457,0;1,0;1,0;2,0;;;;;;;3,0;13,0;4,0;2,0;2,0;7,0;1,0;4,0;;4,0;2,0;14,0;5,0;;;;;;;;1,0;;;;20,0;3,0;3,0;5,0;8,0;1,0;;;;15,0;7,0;46,0;4,0;;;13,0;7,0;3,0;4,0;24,0;;;;1,0;3,0;21,0;1,0;21,0;;;;6,0;;3,0;3,0;;8,0;;5,0;1,0;3,0;;2,0;4,0;8,0;5,0;;25,0;;3,0;141,0;16,0;5,0;;66,0;;16,0;11,0;3,0;15,0;5,0;5,0;;12,0;5,0;9,0;3,0;;;;2,0;13,0;7,0;1,0;;4,0;5,0;1,0;17,0;22,0;11,0;62,0;;3,0;;2,0;3,0;11,0;3,0;5,0;;34,0;2,0;;17,0;11,0;;1,0;10,0;2,0;1,0;47,0;4,0;23,0;9,0;;;6,0;3,0;1,0;30,0;;27,0;4,0;3,0;;;6,0;2,0;9,0;;1,0;25,0;12,0;5,0;23,0;3,0;7,0;2,0;;82,0;29,0;4,0;7,0;2,0;;7,0;4,0;6,0;;1,0;1,0;;;1,0;2,0;5,0;;17,0;24,0;169,0;21,0;23,0;;12,0;;4,0;;;2,0;2,0;;27,0;1,0;;1,0;1,0;;1,0;2,0;19,0;;;2,0;1,0;;;;1,0;4,0;1,0;;6,0;6,0;2,0;2,0;;2,0;;3,0;144,0;;13,0;16,0;5,0;12,0;1,0;;20,0;;6,0;;12,0;;;7,0;;11,0;4,0;5,0;1,0;;11,0;2,0;;4,0;;11,0;8,0;;;23,0;;4,0;;2,0;68,0;;;;;10,0;;;4,0;;7,0;;1,0;;3,0;14,0;;;;1,0;13,0;;2,0;;2,0;;12,0;;;;;;;2,0;;;;;27,0;3,0;;8,0;;1,0;;;;;;;;3,0;;3,0;;3,0;;1,0;1,0;1,0;;3,0;;;;;;;;;7,0;;9,0;;;;1,0;;2,0;;;;1,0;;;5,0;3,0;1,0;9,0;1,0;;;1,0;;1,0;;;;;;;3,0;;;;;1,0;2,0;3,0;;;;4,0;;;;12,0;1,0;2,0;11,0;;1,0;;4,0;;;;1,0;;1,0;1,0;1,0;1,0;;;;;;;2,0;;;;;;;;;1,0;1,0;;;;1,0;3,0;;2,0;;;;;;;1,0;;;7,0;4,0;2,0;4,0;;7,0;;;;4,0;;2,0;;;;;2,0;;;28,0;;;;4,0;;;;;;;;1,0;;;;;1,0;2,0;58,0;3,0;1,0;3,0;;1,0;;6,0;;1,0;1,0;;;3,0;12,0;15,0;;;;7,0;;;;;;;1,0;1,0;6,0;6,0;1,0;;;10,0;;6,0;;;2,0;;;;;8,0;7,0;;;1,0;;11,0;;;;2,0;;;;;3,0;1,0;;;2,0;1,0;;;;;;;;1,0;2,0;;;;6,0;10,0;;;;;10,0;;2,0;;;;;;4,0;;2,0;;20,0;6,0;;;;;1,0;;4,0;1,0;17,0;;3,0;;;;2,0;;;11,0;1,0;;;;1,0;3,0;;5,0;;;;2,0;;1,0;2,0;;49,0;;;2,0;;;1,0;;;2,0;;2,0;1,0;1,0;;;;1,0;1,0;;;;;13,0;;1,0;;;;;;;1,0;;;;;;;;;;;1,0;;;;7,0;1,0;;;;3,0;;;;;;;1,0;1,0;;9,0;12,0;;;;;;;;;;;;
interior;;15,0;;;13,0;;1,0;14,0;;2,0;2,0;;;;8,0;;;;2,0;3,0;;7,0;;;;;1,0;;;;;;15,0;;;;3,0;5,0;;8,0;;;;12,0;;;;1,0;;;;1,0;;;;25,0;11,0;;1,0;27,0;;;12,0;;;6,0;;3,0;;;2,0;1,0;1,0;8,0;2,0;;;2,0;26,0;;4,0;;;;;1,0;25,0;2,0;;;3,0;;;;2,0;35,0;;4,0;1,0;14,0;101,0;15,0;;;;;;12,0;;;3,0;;;11,0;12,0;;;;5,0;20,0;;;;1,0;1,0;;2,0;8,0;;10,0;28,0;2,0;2,0;1,0;1,0;13,0;23,0;2,0;;;;;4,0;5,0;;;23,0;;;2,0;;11,0;4,0;;2,0;5,0;2,0;59,0;;5,0;1,0;;;21,0;;;;19,0;;7,0;9,0;23,0;6,0;28,0;3,0;10,0;4,0;;2,0;;6,0;1,0;2,0;;6,0;;;5,0;;44,0;;;;16,0;;;;;7,0;2,0;;2,0;;14,0;1,0;;;;18,0;10,0;;1,0;;;5,0;;;9,0;1,0;4,0;2,0;23,0;;1,0;17,0;;30,0;12,0;1,0;;;;;14,0;;3,0;3,0;2,0;30,0;;2,0;1,0;;1,0;9,0;7,0;;;;2,0;;;;10,0;1,0;1,0;2,0;33,0;1,0;;;1,0;1,0;2,0;24,0;;11,0;;;;3,0;10,0;;;1,0;1,0;;;;12,0;1,0;;;1,0;7,0;;;12,0;8,0;;1,0;;;;;1,0;;1,0;;;;;1,0;;6,0;;;;6,0;;;1,0;;;;;2,0;;3,0;5,0;;11,0;4,0;;;1,0;8,0;;;;4,0;1,0;;;;;;;;;3,0;;;;;;;2,0;15,0;1,0;2,0;;1,0;;;;;;1,0;;;;8,0;;;;1,0;;;;;3,0;;;;;;;;;;;;;;;1,0;;;;;;;;;;;5,0;;;;;;;;;;;;;;6,0;;;;;5,0;;;;;;;;;;;;;;1,0;;;;;1,0;;;;3,0;;3,0;;1,0;;;;;;;1,0;;5,0;;;;;;;;;;;;;1,0;;;1,0;;18,0;;;;;;5,0;;;;;;;;;11,0;1,0;;;7,0;;;1,0;2,0;;5,0;;;3,0;;4,0;;;;20,0;1,0;;;;3,0;51,0;;;;3,0;;2,0;;;;;;;;;;;;1,0;5,0;;;;;;2,0;;;;;;;;;;;1,0;;;;3,0;;;;;;1,0;;2,0;;;;;;;;;;;;;;;;4,0;;;;;;;;;;;;2,0;;;;;;;;;;;6,0;;;1,0;;;;1,0;;;;;;1,0;1,0;2,0;1,0;;;;;;;;;;4,0;1,0;;;3,0;;;;5,0;2,0;;;;;;;;;;;56,0;;;;;4,0;1,0;;;;;3,0;1,0;;1,0;2,0;1,0;;2,0;;;3,0;2,0;;;;;;;;1,0;;2,0;;;;;;;;;;;;;;;;;;;;;;;;;;;;;;;;;;;;;;;;;;;;9,0;3,0;;;;;;;;;;;;;;;;;;;;;;;;;;;;;;;;;;;;;;;;;;;;;2,0;;;;;;1,0;3,0;;;1,0;;;;;;;;;;;3,0;;;;;;;;7,0;;;44,0;;;;;;;;;1,0;;1,0;;;;;5,0;;4,0;;;;;;;;;;;;;;;;;;;;2,0;2,0;;;;;;;;;1,0;;;;;1,0;;;;;;;;;;;;5,0;;1,0;;;;;3,0;;;;;2,0;2,0;;;;;;;;1,0;2,0;1,0;;2,0;;;;;;;;;;;;;;;;;;;;;;;;;;;;;;;;;;;;;;;;;;1,0;;;;;;;;1,0;;;;;;;;;;2,0;;;;;;3,0;;;;;;;;;;;;;2,0;;;;;;;;;;;;;;;;;;;;;;;;;2,0;;;;;;;6,0;
intermediate;;28,0;1,0;;14,0;;27,0;40,0;6,0;4,0;2,0;;;;48,0;3,0;3,0;;1,0;1,0;1,0;18,0;3,0;3,0;10,0;;2,0;22,0;3,0;;9,0;5,0;10,0;2,0;4,0;;;5,0;1,0;;14,0;;;7,0;1,0;5,0;4,0;4,0;11,0;;7,0;61,0;3,0;10,0;1,0;122,0;17,0;;2,0;57,0;2,0;;16,0;1,0;;4,0;4,0;;;1,0;15,0;2,0;3,0;6,0;;2,0;;19,0;68,0;6,0;;17,0;18,0;;;;1,0;;;1,0;7,0;5,0;;26,0;2,0;45,0;;3,0;7,0;6,0;15,0;15,0;;;;;5,0;14,0;;;3,0;4,0;;7,0;37,0;;;;1,0;22,0;;;;8,0;;;18,0;10,0;;5,0;3,0;4,0;;4,0;;;4,0;;2,0;;;;1,0;;2,0;;16,0;135,0;;;;1,0;10,0;;;;;1,0;;3,0;;;6,0;;;2,0;;9,0;2,0;;5,0;4,0;6,0;5,0;1,0;1,0;8,0;9,0;;;8,0;;2,0;1,0;2,0;10,0;7,0;39,0;;47,0;;;;7,0;2,0;3,0;;;9,0;9,0;;2,0;2,0;12,0;1,0;;;;;9,0;;;;;3,0;2,0;1,0;2,0;2,0;16,0;4,0;;;;2,0;;;;;;;;;5,0;1,0;9,0;2,0;;12,0;;8,0;;3,0;2,0;;8,0;3,0;;;;4,0;2,0;;14,0;5,0;;;6,0;;;;;4,0;;1,0;;4,0;3,0;10,0;;1,0;1,0;1,0;1,0;2,0;;;2,0;1,0;2,0;;;5,0;3,0;;;;13,0;1,0;4,0;;;15,0;;;;;16,0;4,0;;;;6,0;;;;;23,0;;6,0;9,0;3,0;1,0;;3,0;;;;;;;;35,0;;;31,0;;;2,0;;;;;;;2,0;;;;;7,0;1,0;4,0;;;8,0;16,0;4,0;;2,0;6,0;;2,0;1,0;;4,0;;;;;;;;;5,0;2,0;;;3,0;;11,0;2,0;1,0;;1,0;3,0;;2,0;;5,0;;;;;;;;3,0;;;;2,0;2,0;;;1,0;1,0;;1,0;;;;;;;;;;;;;;;5,0;;;;;6,0;;;;3,0;;4,0;;;;41,0;;2,0;;;;;70,0;;;;;;;;2,0;;1,0;2,0;11,0;;;;;;3,0;;11,0;;;;;12,0;;;4,0;;4,0;;;27,0;;;9,0;;;;;;1,0;;;;;;;;;;;;1,0;;8,0;;;85,0;;;17,0;;;;;;;;9,0;;;;;;;;2,0;1,0;4,0;;;;;5,0;;;;;;;;;;;;;1,0;1,0;7,0;;1,0;;;;3,0;;;;;13,0;;1,0;;3,0;;;;;;3,0;;;39,0;10,0;;;;;;4,0;;;;;1,0;;;;;;;;;;9,0;3,0;;;1,0;;;;;1,0;;;;;;;;;;;;;;;;15,0;;;;4,0;;;;;;2,0;;5,0;;9,0;;;2,0;;;;;;;;;;;;;1,0;;13,0;;;3,0;;;;;;;1,0;;;;;;;2,0;;;;;1,0;1,0;;;;1,0;;;2,0;4,0;;;;1,0;;;;;;;;;;1,0;3,0;;;;;;;;1,0;;;;;;;;;;9,0;2,0;1,0;;;;;3,0;;3,0;;;;9,0;2,0;;;;;;;;;2,0;;;;;;;;;;;;;;;;;;21,0;;2,0;;13,0;;;;;;;;;;;;;;;;;;1,0;;5,0;;;;;;;;1,0;;1,0;;1,0;;;;;;;;;;2,0;;;;1,0;3,0;;;;;;;;;;;;;;1,0;;;2,0;;;;;;;;;;;;4,0;;;;;;;1,0;2,0;;;;;;;;;;;2,0;;;;;3,0;;;;;;;;;1,0;;;;14,0;;;;;;;;;;;;;;;;;;;;;;;;;;;;;;;;;;;;12,0;;;;;;;;;;;;;;;;;;;;2,0;;;1,0;1,0;3,0;;1,0;;;;;;5,0;;;;;;;;;;;;;9,0;;;;;1,0;;;;;;;;;;;;;1,0;;;;;;;;;;;;;;;;;;;;;;;;;;;;;;;;;;;;;;;
item;;2,0;1,0;;40,0;;;18,0;3,0;16,0;;;;;17,0;2,0;;;1,0;2,0;5,0;24,0;;;;;;243,0;;3,0;3,0;3,0;20,0;3,0;12,0;;;5,0;;82,0;;;1,0;9,0;1,0;1,0;;;15,0;;;3,0;2,0;26,0;1,0;96,0;55,0;13,0;;5,0;;;26,0;;;;17,0;;2,0;12,0;;17,0;1,0;1,0;;;;;18,0;;;4,0;5,0;;;1,0;17,0;;6,0;60,0;;;16,0;3,0;1,0;;;12,0;21,0;;2,0;14,0;;7,0;;;;20,0;;;;;;2,0;;;;;;1,0;;;;8,0;;;13,0;2,0;;;1,0;1,0;;;13,0;;;;;;;;2,0;2,0;;;;1,0;;;;;2,0;;1,0;;;1,0;20,0;5,0;;;;;;21,0;;10,0;;;2,0;;3,0;;3,0;5,0;;30,0;;;;;;2,0;;;;77,0;;2,0;;;;26,0;;;;;;2,0;3,0;;;1,0;;1,0;;;3,0;;;;;;;10,0;5,0;2,0;;;;;;2,0;;2,0;1,0;;;2,0;;;;;;1,0;;;2,0;1,0;1,0;;;1,0;;3,0;;;;;;1,0;;;;;;7,0;4,0;;1,0;;;;;;1,0;;;2,0;;;;;3,0;3,0;;;6,0;;;;;;;7,0;3,0;3,0;3,0;2,0;1,0;;;;;1,0;4,0;3,0;;;;;22,0;2,0;;;;5,0;;;1,0;38,0;;;;;;;;;;;;;;;;;;;15,0;;;2,0;;;;3,0;;;;10,0;1,0;;;;1,0;1,0;;3,0;3,0;2,0;2,0;;;;;1,0;;;;;;;4,0;11,0;1,0;;1,0;;2,0;;;14,0;;9,0;3,0;1,0;;;4,0;;3,0;1,0;;;2,0;;2,0;4,0;;9,0;;;3,0;;7,0;15,0;;;;;;;;;;1,0;;;2,0;;;;;;;;;;;;2,0;;10,0;;;;;15,0;2,0;;;;4,0;;;;;;;;1,0;;;;1,0;14,0;2,0;;1,0;6,0;;;;;;;;;;28,0;;;;5,0;;2,0;2,0;;;24,0;;;;;212,0;;;1,0;1,0;6,0;;;;;28,0;55,0;;46,0;;2,0;;;10,0;5,0;;;;;;1,0;;;;;;1,0;;;;;;114,0;1,0;;;4,0;;;;;;1,0;3,0;;2,0;;;;5,0;;;;;4,0;;1,0;;;;;;;;;;1,0;;;2,0;2,0;;;;;;;3,0;;;;;7,0;;;2,0;2,0;;18,0;;4,0;2,0;;;;6,0;;1,0;2,0;;;1,0;;;1,0;;;;1,0;;;;;;;;;6,0;;;;;;;;;;;;;;;;;;;;;;;;;1,0;;;;;;;;;1,0;;;;;;;;;;;1,0;;42,0;;;;;;;;;;;;;;;;;;;;2,0;;;;;;;;;;;;;;;;;1,0;;;;;;;;;;;6,0;;;;;;;;;;;;;;;;6,0;;;;7,0;;;;;2,0;;;;;;;;;3,0;;;;;;;;;;;;;;;;;;;;;;;;;;;;;;;;2,0;1,0;;;;;;;;;;1,0;;3,0;;;;;3,0;1,0;;;;;2,0;;;;;;;;;;;;;;;;;;;;;;;;;;;;;;;;;;;;;;;;;;;;;1,0;;1,0;;7,0;;;;;;;;;4,0;;;;;;;;;;;;;;;1,0;;;;;;;;;;;;;;;;;;;;;;;;;;;;;;;;;;;;2,0;2,0;;;1,0;;;;;;;;;;;;;;;;;2,0;;;;;;;;;;;;1,0;;;2,0;;1,0;;;;;;;;;1,0;;;;;;;;;;2,0;;;;;;;;;;;;;;;;;;;;;;;;;;;;;;;;;;;;;;;;;;;;;;;;;;
judge;;1,0;9,0;;1,0;;4,0;18,0;5,0;69,0;1,0;3,0;;;6,0;;;;3,0;1,0;7,0;30,0;;1,0;50,0;22,0;;23,0;4,0;18,0;15,0;7,0;91,0;10,0;17,0;;;6,0;;8,0;9,0;;;3,0;;2,0;;13,0;9,0;3,0;;;1,0;3,0;;87,0;54,0;;;34,0;;;16,0;;;;10,0;;18,0;13,0;3,0;1,0;1,0;;;2,0;;4,0;13,0;14,0;;9,0;8,0;;;;3,0;3,0;;2,0;22,0;2,0;11,0;7,0;;;;31,0;8,0;;11,0;32,0;;3,0;;;1,0;152,0;;;;;18,0;;22,0;2,0;6,0;;;11,0;;;3,0;9,0;;;13,0;;1,0;;;;;;;3,0;;;;;;1,0;;1,0;2,0;1,0;;15,0;;;3,0;;;;;;;;15,0;10,0;;;;;;;8,0;6,0;;;1,0;;2,0;6,0;1,0;;;44,0;2,0;;;;;;;;;1,0;;20,0;;;;3,0;2,0;6,0;;;1,0;;;;;;;12,0;;;;;1,0;;;;;31,0;1,0;;;;;1,0;;;;;;;;;;;;;4,0;;;;10,0;4,0;1,0;;4,0;;;9,0;;;;;;;;;;;;;;;2,0;3,0;1,0;;;;;;;;;;;;5,0;;2,0;;;2,0;;;;;;47,0;14,0;101,0;;;;;1,0;;;2,0;;14,0;;;;;25,0;;;;;29,0;;;3,0;;2,0;;;;;;;;;;;;;11,0;;;10,0;;40,0;;;1,0;;;;2,0;;;;;;14,0;64,0;;;2,0;;24,0;2,0;;4,0;16,0;;1,0;;;;;;;;;1,0;3,0;;2,0;;;;;2,0;3,0;31,0;5,0;;;;2,0;1,0;3,0;;;6,0;1,0;2,0;;;17,0;;;;;10,0;1,0;2,0;;13,0;;;;;3,0;;4,0;;;;;;;;;;;1,0;;1,0;;;;;6,0;7,0;;;1,0;2,0;24,0;;;;;;15,0;2,0;;;2,0;12,0;7,0;;1,0;;4,0;1,0;;3,0;;;5,0;1,0;8,0;;6,0;4,0;;5,0;;129,0;;;;;1,0;;;;;2,0;8,0;;;;3,0;;;4,0;;2,0;;;1,0;;1,0;1,0;5,0;;;;7,0;3,0;;58,0;;;1,0;;;;;;;;18,0;;;;;;;;2,0;5,0;;;;;;2,0;;4,0;;;;;;;;;;;;17,0;;;;;1,0;;9,0;1,0;;;2,0;;;;;1,0;1,0;;;;;13,0;;;1,0;5,0;1,0;;;;;3,0;;;;;6,0;1,0;;;;;;;;;;19,0;;1,0;;;;;17,0;;;;;;;;;;;;;4,0;;;;8,0;11,0;;;;1,0;;;;;;;;10,0;;;4,0;;;;;;;;;;;27,0;;;1,0;;;;;;;;;;;;;;1,0;;;;;;;;;;;;;;;;;;;;4,0;;;;;;;;;;;;2,0;20,0;;;;;;;;;13,0;;;;;;;4,0;;;;;;;;;4,0;6,0;;7,0;;3,0;1,0;;;;;;;;;;;;;;;3,0;2,0;;1,0;;;;;;;;;4,0;;7,0;;;3,0;2,0;5,0;2,0;;;;;;;1,0;;;;4,0;;;;2,0;;;;;;2,0;;;;;16,0;2,0;;;;1,0;;;3,0;;;1,0;2,0;;;;;;2,0;;;;;;;;;;;;;;;;;;;;;;;;;;;;;;;;;;;2,0;;;;;;;;;;;8,0;;;;;;;;;;;;;;;20,0;;;;;;;;;1,0;;;;;;;;;4,0;;;;;;;;;;;;;;;;;;;;;;;2,0;;;;;;1,0;;;;;;;;;;;;;;;;;;;;;;;;;;;;;;;;;;;12,0;;;;;;;;;;;;;;;;;;;1,0;;;;;;;;;;;;1,0;;2,0;;7,0;;1,0;;;;;;;;;;;;;;;;;16,0;;;;;;;;;
judgment;;1,0;2,0;;4,0;;2,0;13,0;2,0;5,0;;2,0;;;7,0;;;;;;1,0;11,0;;1,0;3,0;8,0;;20,0;;10,0;11,0;21,0;30,0;1,0;9,0;;;3,0;;9,0;12,0;;1,0;3,0;;2,0;;7,0;24,0;;;1,0;;4,0;;24,0;13,0;;;18,0;;;2,0;;;;7,0;;1,0;6,0;;;;;;2,0;;8,0;5,0;14,0;;6,0;2,0;;;;5,0;;;1,0;17,0;3,0;5,0;14,0;;;;8,0;2,0;;;9,0;;3,0;;;1,0;112,0;;;;;6,0;;5,0;;;;;2,0;;;1,0;1,0;;;;;1,0;;;1,0;;;;;;;;;;2,0;;;;;;;;;;;;;;;;;;7,0;;;;;;;9,0;8,0;;;;;;;7,0;1,0;;28,0;;;;;;;;;;5,0;;17,0;;;;;;;;;1,0;;;;;;;8,0;;;;;1,0;;;;;18,0;;;;;;;;;;;;;;;;;;;5,0;;;;12,0;;;;;;;7,0;;;;;;;;;;;;2,0;;;;4,0;;;;;;;;;;;;;3,0;;;;;;;;;;;;3,0;18,0;;;;;;5,0;;;;5,0;;;;;48,0;;;;;2,0;;;7,0;;;;;;;;;;;;;;;6,0;;;13,0;;1,0;2,0;;;;;;1,0;;;;;;4,0;5,0;1,0;;2,0;;21,0;1,0;;;;;;;;;;;;;;3,0;3,0;;;;;129,0;;;;5,0;2,0;;2,0;;;12,0;2,0;;;3,0;3,0;;;;17,0;;;;;8,0;1,0;4,0;;4,0;;4,0;;;2,0;;;;;;;;;;;;;2,0;;1,0;;7,0;;;14,0;11,0;;;4,0;;11,0;;;;;2,0;15,0;;;;;8,0;;;;;;1,0;;1,0;;;3,0;;2,0;;1,0;3,0;;5,0;;;;;;;1,0;1,0;;2,0;;;15,0;;;;;;2,0;;;;;;;;;;6,0;;10,0;12,0;1,0;;;;;;3,0;;;;;;;;2,0;;;;;;;;;9,0;;;;;4,0;;;;;;;;;;;;;;;1,0;;;;;3,0;;;;;;;;;;;;3,0;;;1,0;;1,0;;2,0;1,0;4,0;3,0;;;;;4,0;;;;;6,0;1,0;;;;;;;;;;22,0;;2,0;;;;;12,0;;;;;;;;;;;;;;;;;6,0;12,0;;;;1,0;;;;;;;;;;;;;;;;;;;;;;6,0;;;;;;;;1,0;;;;;;;;;;;;;;;;;;;;;;;;;;;;;3,0;;;;;;;;;;;;3,0;2,0;;;;;;;;;1,0;;;;;;;;;;;;;;;;4,0;3,0;;;;2,0;;;;;;;;;;;;;;1,0;;;1,0;;7,0;1,0;;;;;;;;2,0;;5,0;;4,0;;;;2,0;;;;;;;;;;;4,0;;;;8,0;;;;;;3,0;;;;;6,0;2,0;;;;;;;2,0;;;;2,0;8,0;;;;;;;;;;;;;;;;;;;;;;;;;;;;;;;;4,0;;;;;;;;;;;;;;;;;;;;;;;;;;;;;;;;;;6,0;;;;;;;1,0;;;;;;;;;;;;;;;;;;;;;;;;;;;;;;;;;;;;;;;;;;;;;;;;;;;;;;;;;;;;;;;;;;;;;;;2,0;;;;;;;;;;;;;;;;;;;;;;;;;;;;;;;;;;;;;;;1,0;;3,0;;;;;;;;;;;;;;;;;11,0;;;;;;;;;
layer;;7,0;8,0;;11,0;;4,0;61,0;;4,0;14,0;;;2,0;83,0;1,0;;1,0;6,0;4,0;;8,0;;;;;3,0;1,0;1,0;7,0;9,0;1,0;178,0;4,0;15,0;;1,0;45,0;1,0;62,0;5,0;;1,0;53,0;;;;3,0;;;12,0;9,0;;18,0;;77,0;185,0;;4,0;134,0;;;67,0;1,0;;1,0;6,0;;;3,0;142,0;5,0;2,0;12,0;4,0;;43,0;3,0;13,0;2,0;2,0;9,0;2,0;4,0;12,0;4,0;131,0;;8,0;13,0;54,0;12,0;6,0;41,0;2,0;11,0;;;7,0;176,0;205,0;29,0;;136,0;;;103,0;27,0;2,0;56,0;5,0;48,0;31,0;26,0;10,0;;15,0;15,0;36,0;9,0;17,0;;;77,0;22,0;8,0;10,0;28,0;;11,0;62,0;;67,0;4,0;;15,0;90,0;;371,0;28,0;6,0;;3,0;30,0;108,0;6,0;416,0;;2,0;24,0;7,0;5,0;13,0;15,0;1,0;6,0;40,0;10,0;;106,0;11,0;2,0;35,0;1,0;;;10,0;199,0;;217,0;8,0;7,0;73,0;24,0;;37,0;8,0;8,0;5,0;;5,0;12,0;14,0;;;10,0;40,0;126,0;;153,0;18,0;3,0;4,0;23,0;3,0;7,0;73,0;;;;53,0;6,0;25,0;75,0;;;;;21,0;9,0;;3,0;17,0;7,0;;9,0;24,0;128,0;;;29,0;13,0;;8,0;7,0;8,0;3,0;11,0;;3,0;1,0;;20,0;34,0;5,0;1,0;;31,0;69,0;2,0;5,0;;15,0;12,0;1,0;1,0;3,0;27,0;2,0;24,0;;;135,0;34,0;14,0;4,0;;14,0;;;18,0;27,0;4,0;;1,0;;25,0;;2,0;7,0;7,0;25,0;6,0;;;15,0;21,0;;;17,0;;5,0;;;12,0;;2,0;;2,0;22,0;;1,0;;31,0;;11,0;36,0;;5,0;;6,0;;6,0;;;;;4,0;8,0;;;14,0;;;;;1,0;;;17,0;5,0;;;;;12,0;12,0;;10,0;;1,0;3,0;;;;5,0;1,0;;;;;4,0;;;;;;;1,0;;10,0;;;;;;;;;;;;1,0;;;3,0;4,0;;;;;2,0;2,0;;;2,0;;;2,0;7,0;5,0;29,0;;;3,0;;;9,0;;3,0;1,0;1,0;;;3,0;;;;3,0;;;;;;1,0;;;;;;3,0;13,0;3,0;;;1,0;;;2,0;;1,0;;1,0;;;;5,0;18,0;;;;1,0;;;;;2,0;;;;;;;5,0;11,0;;39,0;4,0;;;;;18,0;5,0;;;;;;;;;;1,0;;3,0;;;;;;2,0;;;;;24,0;;;;2,0;;;;;;6,0;21,0;;8,0;;7,0;2,0;1,0;10,0;9,0;1,0;12,0;1,0;;1,0;1,0;;;2,0;;;1,0;2,0;;2,0;;1,0;12,0;;9,0;5,0;6,0;;;;;3,0;;;;;;1,0;9,0;;;12,0;;;;;;1,0;;;13,0;1,0;;;;;4,0;;;;;52,0;;14,0;28,0;;;;;72,0;10,0;;;;;4,0;;;;;;;;3,0;;1,0;;10,0;;;12,0;;;2,0;6,0;1,0;;;;;46,0;;4,0;18,0;23,0;2,0;;13,0;;;;1,0;;5,0;;;2,0;;3,0;;;;;;;;;;;1,0;3,0;1,0;10,0;;;;;1,0;;;116,0;2,0;;1,0;3,0;;4,0;;2,0;;;12,0;;6,0;13,0;;;;1,0;;173,0;;1,0;;;1,0;;13,0;3,0;3,0;;21,0;;22,0;9,0;;;1,0;;;;;64,0;45,0;;6,0;;23,0;;;1,0;;1,0;;5,0;42,0;1,0;;25,0;;1,0;1,0;2,0;;12,0;6,0;2,0;1,0;;;;;;;6,0;23,0;;;3,0;12,0;1,0;3,0;1,0;;;30,0;;;2,0;90,0;;8,0;2,0;12,0;;;;14,0;;;;;;;;;;;;;5,0;;;2,0;;;3,0;1,0;;;;;;;;;1,0;10,0;;;;;2,0;;17,0;1,0;;;;;;6,0;;;;;1,0;;;;;;;;;;;;;;;;;;1,0;;;;;;;;;;;1,0;;4,0;;7,0;;;;;;;;;;;;4,0;;;;;;11,0;;;4,0;;;3,0;;;;;2,0;1,0;;21,0;;;;6,0;;;;1,0;;;;;;;;1,0;;;;;2,0;;;2,0;;;;21,0;;7,0;;;6,0;10,0;;;1,0;2,0;;;;;35,0;;26,0;;;;;;;3,0;3,0;;;2,0;;;;;;;;;;;;5,0;1,0;;;;1,0;;;;6,0;;;;;;;;;;;5,0;;;;;;;;;;;;;;;;;9,0;2,0;2,0;153,0;29,0;45,0;12,0;;3,0;;43,0;;3,0;;;;;;;4,0;;;2,0;;;;;;;;1,0;9,0;;;;;;;;16,0;;;;;35,0;;1,0;;2,0;;;;
light;;22,0;684,0;2,0;256,0;4,0;236,0;344,0;47,0;185,0;46,0;107,0;7,0;6,0;605,0;47,0;16,0;6,0;318,0;18,0;130,0;719,0;14,0;34,0;48,0;8,0;6,0;257,0;23,0;269,0;116,0;282,0;1187,0;12,0;212,0;17,0;253,0;185,0;6,0;196,0;94,0;4,0;40,0;841,0;;4,0;1,0;32,0;131,0;35,0;67,0;351,0;6,0;116,0;58,0;1510,0;457,0;3,0;23,0;1177,0;23,0;;413,0;4,0;;45,0;19,0;37,0;6,0;67,0;773,0;34,0;319,0;28,0;29,0;86,0;;220,0;327,0;109,0;62,0;44,0;48,0;110,0;31,0;88,0;266,0;16,0;52,0;100,0;609,0;34,0;39,0;470,0;11,0;37,0;39,0;25,0;48,0;200,0;779,0;708,0;1,0;19,0;1,0;8,0;93,0;787,0;6,0;80,0;108,0;232,0;219,0;76,0;36,0;22,0;30,0;111,0;33,0;98,0;;1,0;24,0;116,0;18,0;45,0;475,0;24,0;12,0;74,0;75,0;22,0;17,0;3,0;24,0;106,0;180,0;;72,0;1980,0;54,0;69,0;124,0;84,0;437,0;2,0;359,0;75,0;10,0;15,0;123,0;3,0;389,0;10,0;11,0;21,0;55,0;119,0;585,0;591,0;713,0;36,0;16,0;34,0;1,0;199,0;171,0;;1,0;94,0;320,0;231,0;268,0;116,0;24,0;90,0;22,0;239,0;8,0;7,0;35,0;19,0;461,0;8,0;11,0;129,0;116,0;602,0;47,0;638,0;9,0;1,0;20,0;1118,0;10,0;839,0;60,0;;10,0;14,0;174,0;50,0;226,0;206,0;1,0;37,0;7,0;4,0;66,0;30,0;37,0;38,0;34,0;15,0;8,0;328,0;463,0;103,0;33,0;70,0;22,0;122,0;4,0;539,0;25,0;517,0;98,0;7,0;2,0;;7,0;4,0;12,0;51,0;138,0;205,0;82,0;21,0;203,0;10,0;61,0;1,0;159,0;13,0;2,0;17,0;52,0;64,0;9,0;7,0;24,0;;6,0;68,0;25,0;10,0;5,0;65,0;68,0;13,0;37,0;9,0;13,0;6,0;2,0;;26,0;1,0;8,0;4,0;7,0;67,0;5,0;1,0;36,0;12,0;10,0;;14,0;90,0;;6,0;11,0;59,0;;11,0;16,0;528,0;36,0;17,0;56,0;10,0;11,0;44,0;4,0;25,0;65,0;194,0;12,0;2,0;32,0;1,0;236,0;136,0;78,0;10,0;;181,0;37,0;10,0;43,0;131,0;23,0;;28,0;1,0;7,0;2,0;4,0;13,0;;119,0;;6,0;;1780,0;5,0;;73,0;;19,0;51,0;1,0;;6,0;33,0;13,0;9,0;7,0;12,0;9,0;72,0;;37,0;2,0;2,0;19,0;10,0;15,0;79,0;40,0;5,0;9,0;9,0;;17,0;7,0;1,0;12,0;4,0;35,0;20,0;33,0;7,0;40,0;49,0;1,0;29,0;39,0;6,0;6,0;2,0;4,0;109,0;38,0;15,0;16,0;2,0;;75,0;80,0;108,0;9,0;12,0;125,0;233,0;15,0;118,0;3,0;90,0;11,0;62,0;4,0;2,0;86,0;8,0;78,0;116,0;51,0;37,0;30,0;;18,0;6,0;13,0;3,0;3,0;20,0;;22,0;22,0;162,0;9,0;24,0;;30,0;6,0;;111,0;119,0;36,0;;3,0;25,0;146,0;3,0;4,0;24,0;6,0;224,0;19,0;23,0;4,0;;3,0;6,0;7,0;;;15,0;9,0;;11,0;6,0;1,0;99,0;126,0;190,0;18,0;14,0;1,0;20,0;154,0;485,0;4,0;;1,0;3,0;69,0;;8,0;2,0;7,0;25,0;2,0;25,0;37,0;6,0;27,0;;;122,0;;;1,0;6,0;39,0;9,0;4,0;4,0;42,0;9,0;19,0;20,0;3,0;29,0;83,0;29,0;20,0;44,0;4,0;50,0;186,0;84,0;95,0;111,0;30,0;30,0;8,0;;3,0;;7,0;26,0;140,0;11,0;;9,0;35,0;7,0;13,0;4,0;;30,0;26,0;12,0;5,0;3,0;;8,0;;3,0;75,0;7,0;;1151,0;29,0;5,0;6,0;232,0;4,0;14,0;28,0;2,0;;19,0;;4,0;3,0;1,0;6,0;23,0;6,0;17,0;19,0;27,0;;7,0;;2,0;11,0;5,0;2,0;7,0;10,0;8,0;87,0;8,0;15,0;31,0;331,0;26,0;;;3,0;2,0;49,0;3,0;6,0;1,0;;2,0;3,0;;16,0;2,0;2,0;3,0;;10,0;;3,0;573,0;5,0;12,0;7,0;;3,0;2,0;1,0;2,0;8,0;1,0;124,0;41,0;134,0;2,0;5,0;30,0;3,0;3,0;50,0;127,0;18,0;5,0;;15,0;9,0;5,0;;;1,0;4,0;;3,0;;38,0;;1,0;21,0;;2,0;41,0;117,0;11,0;;;;62,0;1,0;;7,0;23,0;59,0;15,0;;823,0;24,0;3,0;6,0;;5,0;10,0;6,0;;27,0;5,0;10,0;6,0;7,0;5,0;80,0;1,0;4,0;3,0;1,0;;1,0;1,0;11,0;8,0;12,0;;;102,0;43,0;1,0;2,0;2,0;7,0;191,0;;1,0;12,0;33,0;15,0;23,0;5,0;14,0;;5,0;8,0;53,0;75,0;13,0;9,0;4,0;10,0;1,0;15,0;45,0;61,0;10,0;3,0;6,0;2,0;6,0;33,0;17,0;44,0;19,0;52,0;;19,0;1,0;2,0;55,0;2,0;;15,0;;18,0;2,0;25,0;2,0;16,0;9,0;9,0;;14,0;27,0;2,0;4,0;35,0;4,0;55,0;;11,0;4,0;;10,0;5,0;16,0;50,0;;1,0;4,0;;;4,0;352,0;18,0;1,0;10,0;1,0;64,0;16,0;110,0;19,0;;39,0;2,0;3,0;17,0;;8,0;4,0;15,0;11,0;60,0;3,0;139,0;8,0;11,0;13,0;1,0;;16,0;6,0;3,0;21,0;395,0;1,0;54,0;3,0;42,0;62,0;16,0;4,0;;;9,0;5,0;1,0;;33,0;;6,0;;13,0;12,0;;;8,0;17,0;;2,0;15,0;;1,0;;;;1,0;;;100,0;2,0;20,0;2,0;;;14,0;65,0;;6,0;205,0;2,0;8,0;5,0;1,0;11,0;6,0;4,0;11,0;44,0;1,0;1,0;551,0;24,0;16,0;28,0;70,0;;4,0;;20,0;;24,0;8,0;142,0;17,0;19,0;6,0;1,0;5,0;;;;1,0;3,0;;10,0;4,0;2,0;;2,0;13,0;;16,0;12,0;;18,0;6,0;66,0;;14,0;1,0;;;9,0;12,0;16,0;;;;20,0;8,0;6,0;4,0;98,0;;14,0;;;2,0;2,0;2,0;3,0;10,0;3,0;1,0;1,0;;2,0;4,0;;;;31,0;3,0;10,0;;;;1,0;;;8,0;7,0;13,0;36,0;1,0;62,0;;59,0;18,0;;5,0;42,0;52,0;2,0;13,0;;;13,0;;151,0;110,0;2,0;17,0;38,0;1,0;;18,0;1,0;2,0;4,0;;7,0;;;;1,0;;;1,0;5,0;4,0;18,0;10,0;15,0;17,0;48,0;;;9,0;;18,0;31,0;25,0;6,0;1,0;62,0;1,0;2,0;1,0;18,0;1,0;4,0;1,0;3,0;3,0;6,0;1,0;2,0;3,0;;22,0;;10,0;;;5,0;62,0;80,0;;;3,0;;4,0;16,0;5,0;1,0;;24,0;;;2,0;
linkage;;1,0;;;4,0;;4,0;;;;12,0;;;;;;;;;;;1,0;;;;;;2,0;;;;;5,0;2,0;1,0;;;3,0;;;;;10,0;1,0;;;;;;;;;;;;8,0;19,0;;3,0;15,0;1,0;;4,0;;;16,0;3,0;;;1,0;3,0;;1,0;;;;;4,0;14,0;;;;;;;;;;;;;;;2,0;;4,0;;;;;1,0;15,0;;;;;;10,0;;;2,0;8,0;;1,0;10,0;;;;;2,0;;;;;;;6,0;;;18,0;14,0;;;;;;11,0;;;;;;;;;1,0;5,0;8,0;;;;4,0;1,0;;;;;2,0;1,0;5,0;;;;;;;;5,0;;;33,0;;;23,0;8,0;;;;;;;;;;6,0;1,0;5,0;2,0;;4,0;;;;4,0;;;;1,0;5,0;;;2,0;;6,0;;;;;;8,0;;1,0;;;27,0;;1,0;;;;2,0;2,0;;;;;;;;;;;;2,0;;;;;3,0;;6,0;;;;;;;;;;;;;8,0;;;;8,0;;;;1,0;;;3,0;3,0;1,0;;;;;;8,0;;;;;9,0;4,0;;3,0;;6,0;41,0;;10,0;4,0;;;6,0;;;;;;;;;;;;;;2,0;1,0;;5,0;8,0;;;;;;;4,0;;;;;;;;;;;;;2,0;;;;;3,0;;;;;;;4,0;;;;;;;;;;1,0;;;;;;;;;;;;;;;;;;;;;;;;;;;;;;32,0;;;1,0;;;;;;;;;;;;;;;;;;;;;;;;;4,0;;;;;;;;;;;3,0;;;;;;;;;;;;;;;;;;;;;;;;;;;1,0;;1,0;;;;;;7,0;;;;;;;;;;;;;3,0;;;;;;18,0;;;;;;;;;;;;;;;;;;;;;;2,0;3,0;;;;;;;;;1,0;;;;;;;;;;1,0;2,0;;;;;;;;;;;;;;;;;;;1,0;;1,0;;;;;;;;;;26,0;;;1,0;;;;;;;;;3,0;;;3,0;;;;;4,0;;;;1,0;;;;;;3,0;;;;;;;;;;;;;;;;;;;;8,0;;;1,0;;;;;;;;;;;;;;;;;7,0;;;;;1,0;;;;;;;;;;;1,0;2,0;;;;;;;;;;;;;;;;;;;;;;;;;;;1,0;;;;;;;;;;2,0;;;;5,0;6,0;;;;;;;;;;;;;;;;;;;;;;3,0;;;;;;;;;;;;;;;;;;;;;;;;;;;;;;;;;;;;;;;;;;;;;1,0;;;;;;;;;;;2,0;;;;;;;;;;;;;;;;;;;2,0;;;15,0;;1,0;1,0;;;;;;;;;;;;;;;;;;;;;;;;;5,0;;;;;;;;;;;;;;;;;;;;;;1,0;;;;;;1,0;;;;;;;;;;;;;;;;;;1,0;;5,0;;;;;;;3,0;;;;;;;;;;1,0;;;;;;;;;;;;;;;5,0;2,0;;3,0;;;;;;;;;;;;;;;;;;;;;;;;;;;;10,0;;;;;;;1,0;;;;;;;;;;;;;;;;;;;;;;;;;;;;;;;;;;;;;;;;;;;;;;;;;;;7,0;;;;;;;;;;;;;;;;;;;;;;;;;;;
locate;;14,0;2,0;1,0;16,0;;42,0;63,0;5,0;30,0;52,0;;;;7,0;1,0;1,0;1,0;40,0;5,0;1,0;9,0;21,0;29,0;10,0;;1,0;37,0;5,0;24,0;14,0;39,0;155,0;;53,0;12,0;4,0;65,0;1,0;38,0;60,0;1,0;6,0;80,0;;1,0;1,0;5,0;12,0;;3,0;19,0;6,0;33,0;9,0;335,0;48,0;2,0;11,0;297,0;1,0;3,0;53,0;;3,0;13,0;16,0;14,0;;7,0;117,0;;36,0;9,0;8,0;;;105,0;262,0;20,0;;20,0;10,0;1,0;;2,0;141,0;7,0;1,0;4,0;74,0;9,0;17,0;19,0;1,0;36,0;3,0;2,0;6,0;34,0;139,0;72,0;;8,0;;;4,0;79,0;;;5,0;6,0;24,0;23,0;1,0;;4,0;;10,0;36,0;8,0;1,0;1,0;12,0;;;17,0;14,0;;13,0;12,0;2,0;1,0;9,0;1,0;15,0;7,0;2,0;23,0;7,0;;1,0;12,0;31,0;7,0;2,0;35,0;51,0;1,0;5,0;;36,0;19,0;13,0;7,0;8,0;13,0;104,0;12,0;78,0;2,0;;14,0;26,0;;17,0;16,0;90,0;2,0;2,0;79,0;52,0;50,0;36,0;16,0;27,0;31,0;23,0;;2,0;14,0;1,0;9,0;2,0;15,0;64,0;22,0;94,0;;138,0;2,0;2,0;2,0;45,0;5,0;29,0;1,0;4,0;10,0;14,0;5,0;5,0;4,0;165,0;8,0;3,0;9,0;4,0;9,0;20,0;6,0;1,0;;;15,0;6,0;7,0;7,0;;3,0;8,0;34,0;3,0;3,0;21,0;2,0;6,0;9,0;4,0;1,0;1,0;2,0;12,0;20,0;2,0;11,0;9,0;;58,0;1,0;26,0;2,0;27,0;15,0;3,0;6,0;7,0;7,0;;24,0;8,0;2,0;1,0;31,0;2,0;;16,0;22,0;1,0;2,0;1,0;11,0;57,0;8,0;7,0;;18,0;4,0;10,0;1,0;7,0;71,0;5,0;;4,0;14,0;;1,0;3,0;;4,0;9,0;14,0;19,0;1,0;10,0;6,0;134,0;6,0;43,0;;5,0;2,0;6,0;5,0;;12,0;20,0;5,0;11,0;9,0;15,0;34,0;6,0;23,0;1,0;2,0;10,0;17,0;19,0;36,0;20,0;7,0;1,0;9,0;2,0;8,0;;3,0;10,0;20,0;;3,0;8,0;;64,0;1,0;7,0;25,0;;7,0;;3,0;;;;;;;;3,0;17,0;;2,0;1,0;4,0;2,0;3,0;5,0;2,0;37,0;;13,0;;;;2,0;;;;;2,0;;1,0;14,0;3,0;1,0;1,0;1,0;5,0;2,0;5,0;1,0;11,0;1,0;3,0;2,0;;;4,0;4,0;16,0;1,0;2,0;;;;6,0;1,0;7,0;3,0;12,0;1,0;;32,0;1,0;7,0;44,0;2,0;;26,0;;;;4,0;;8,0;3,0;;;4,0;;;;2,0;1,0;5,0;;20,0;17,0;56,0;;;3,0;;;;7,0;1,0;10,0;1,0;3,0;3,0;;;3,0;2,0;;;3,0;1,0;4,0;;1,0;5,0;7,0;12,0;;3,0;;1,0;1,0;21,0;3,0;1,0;1,0;1,0;;2,0;3,0;;1,0;3,0;6,0;4,0;20,0;20,0;1,0;4,0;3,0;1,0;3,0;8,0;;3,0;1,0;11,0;;;;;;;;1,0;12,0;39,0;;;3,0;1,0;1,0;2,0;1,0;79,0;41,0;7,0;;2,0;;;;;;40,0;3,0;;;3,0;7,0;4,0;6,0;;18,0;6,0;6,0;7,0;;;;;9,0;;14,0;;;1,0;2,0;;;4,0;3,0;5,0;4,0;;;2,0;1,0;2,0;4,0;;9,0;;;12,0;2,0;;2,0;;1,0;1,0;5,0;1,0;;2,0;;2,0;;;2,0;101,0;;5,0;;5,0;;51,0;;4,0;;7,0;;3,0;;8,0;1,0;8,0;;4,0;4,0;;3,0;11,0;2,0;;5,0;8,0;;;;2,0;5,0;;23,0;4,0;4,0;;3,0;5,0;1,0;1,0;1,0;;1,0;4,0;3,0;2,0;2,0;;;1,0;2,0;12,0;;13,0;;49,0;1,0;;5,0;;;;3,0;12,0;1,0;;;6,0;1,0;;29,0;;3,0;12,0;4,0;21,0;18,0;1,0;3,0;2,0;;;1,0;2,0;1,0;;;;;6,0;14,0;;2,0;5,0;1,0;;;4,0;13,0;;7,0;3,0;4,0;6,0;1,0;;4,0;;;3,0;2,0;;7,0;16,0;2,0;1,0;;1,0;;;;;1,0;9,0;;;;;;1,0;5,0;;;;;6,0;22,0;6,0;;10,0;;5,0;;2,0;8,0;;1,0;1,0;5,0;;;;8,0;2,0;;;1,0;;4,0;2,0;4,0;;2,0;;;;;;;1,0;;7,0;;;1,0;1,0;1,0;1,0;4,0;;2,0;3,0;6,0;3,0;4,0;;6,0;;;;;;7,0;4,0;7,0;;1,0;;7,0;;4,0;1,0;;1,0;1,0;;2,0;1,0;;1,0;;1,0;;;16,0;;2,0;;;;1,0;;;;7,0;2,0;;;;;;;3,0;1,0;;;3,0;1,0;1,0;3,0;;;;1,0;1,0;2,0;1,0;6,0;;;1,0;2,0;19,0;;;;;2,0;;;;7,0;;;;1,0;;;3,0;;1,0;1,0;2,0;1,0;;;7,0;10,0;;5,0;;7,0;2,0;2,0;4,0;;;2,0;;5,0;2,0;1,0;;;;4,0;;1,0;3,0;10,0;;10,0;1,0;5,0;;;4,0;;1,0;;3,0;2,0;;1,0;6,0;7,0;;5,0;;;4,0;;;;4,0;;21,0;1,0;;;10,0;;;;1,0;;;;3,0;;2,0;1,0;1,0;;;1,0;6,0;;3,0;5,0;;;;;2,0;6,0;;;2,0;4,0;2,0;;;;;;;;;;;;;;;;;4,0;2,0;;;1,0;1,0;;;4,0;3,0;;;13,0;12,0;4,0;6,0;;13,0;1,0;;1,0;1,0;2,0;;2,0;13,0;;;;;;;4,0;10,0;8,0;5,0;;;2,0;4,0;1,0;;6,0;;;1,0;4,0;4,0;1,0;;;;;2,0;;;17,0;;;;;
loop;;1,0;;;10,0;;1,0;1,0;;9,0;;;;;;;;;;;5,0;79,0;;9,0;7,0;;;;1,0;;;;4,0;;;;;1,0;;;;;;;;;;;;;;;2,0;1,0;;11,0;4,0;;1,0;3,0;;;2,0;1,0;;1,0;;;;3,0;1,0;;;;1,0;;;7,0;5,0;;;1,0;1,0;;;;;;2,0;;;;;2,0;;1,0;;2,0;3,0;;2,0;7,0;;8,0;;;;6,0;;;2,0;9,0;;25,0;5,0;;;;;2,0;;;;;;;8,0;;;8,0;6,0;;;;;;2,0;;7,0;;;;2,0;1,0;;;14,0;;;;;;6,0;;5,0;;1,0;1,0;;;;;;;;3,0;2,0;;;7,0;1,0;;6,0;3,0;;1,0;2,0;;;;3,0;;;3,0;;;;5,0;;61,0;;1,0;;1,0;;;;;;3,0;;3,0;;;;;;1,0;36,0;;;;;;;2,0;;;;1,0;;;;;1,0;;;;;;;1,0;;;;;;;;;3,0;;;;;4,0;;10,0;;;;;;6,0;;;;;2,0;;;;;;2,0;;4,0;29,0;;;1,0;;;;1,0;1,0;;;;;;1,0;;;;;;;1,0;3,0;;;;;;1,0;;;;;;;2,0;;;;;1,0;;;;1,0;;;;;;;1,0;;;;;;;1,0;;;;;1,0;;;;;;;;;;1,0;;;;;;;1,0;;;16,0;;;;;;;;1,0;;;1,0;;;;;;;;;;;;;;12,0;;;;2,0;;;;;;;;;;;;4,0;;;;;5,0;;;;;;;;;;;4,0;;;1,0;1,0;;;;;;;;;3,0;;;;;;;1,0;;;;;;3,0;;;;;;;2,0;;;;1,0;;;;1,0;;;1,0;;;;;;;;;;;;1,0;;1,0;;;;;;6,0;;;;;;;;;;;;;;1,0;;;;1,0;;;;;6,0;;;1,0;;;;3,0;;;;;;;;;;;;;;;;;;;1,0;;;;;;;;;;;;1,0;;;14,0;;;2,0;;;;;;;;;;;;;;;;;;;2,0;;1,0;;;;;;;;;;;;;;;;;;2,0;;;;;;8,0;;;;;;;;2,0;;;;1,0;;;;;;;18,0;;;;;;;;;;;;;;;;;;;;;;;7,0;1,0;17,0;;;;17,0;1,0;;;;;;;;3,0;;;;;;;;;;1,0;;;;;;;;;;;;;;;;1,0;;;;;;;;;;;;;;;;;;;;;1,0;;;;;;;;;;;;;;;;;;;;;;2,0;;;1,0;2,0;;;;;;;3,0;;;;;;;;;;;3,0;2,0;2,0;;;;;2,0;;;;;;;;;2,0;;;;;;;;;;;;;;;;;;;;;;;;;;;;;;;;;;;;;;;;;;2,0;;;;;;;1,0;;;;;;;;;;;;;;;;;;;;;;;;;;;;;;;;;;2,0;;;;;;;;;;;;;;;;;8,0;;;;;;;;;;;;;;;2,0;;;;;;1,0;54,0;;;;;1,0;;;;;;;;;;;;;;;;;;;;;;;;;;;;7,0;;;;;;;;;;;;;;;;;;;;;;;;;;;;;;;;;;;;3,0;;;;;;;;;;;;;;1,0;3,0;6,0;;;;;;;;;;;;;;;;;;;;;;;;;;;;;;;;;;;;;;;;;;;;;
manipulate;;2,0;;;3,0;;11,0;2,0;;45,0;1,0;;;;6,0;;;;3,0;4,0;;32,0;3,0;1,0;;;;34,0;4,0;2,0;;2,0;50,0;1,0;9,0;;2,0;4,0;2,0;2,0;;;;8,0;;;;;;;;3,0;;1,0;;134,0;21,0;;;9,0;;;21,0;;;;1,0;;;2,0;2,0;3,0;16,0;1,0;;;;4,0;14,0;1,0;;14,0;15,0;3,0;;;3,0;;;2,0;2,0;3,0;;9,0;;;;1,0;;;;9,0;1,0;;;;;33,0;;;8,0;;;29,0;1,0;;;;;9,0;;;;;;1,0;13,0;;4,0;1,0;;;;1,0;;;3,0;;;;;2,0;;;;;1,0;3,0;;;;;;;;;;3,0;;2,0;;26,0;;;;;12,0;2,0;;;10,0;;2,0;7,0;1,0;2,0;;3,0;;;2,0;1,0;;;3,0;;;10,0;;23,0;;;;11,0;;;;;2,0;;;;;6,0;;;;1,0;7,0;6,0;;;;;1,0;;4,0;;;;;;;;;;;;;;;;3,0;;13,0;3,0;1,0;2,0;1,0;;;1,0;;;3,0;;;;;;;;;;;;;;;;;;;1,0;4,0;;7,0;;;;;3,0;;;;2,0;;;;1,0;;;;1,0;;;;20,0;13,0;4,0;;;;1,0;;;;;;;1,0;;4,0;;;;;;;1,0;;;1,0;;;;;;;;;3,0;;;;1,0;;;1,0;;13,0;;;;;;;;;4,0;;;;;;;;;;;;7,0;;;;7,0;;;;;;;;;5,0;;;;;1,0;;;;;;;2,0;;;1,0;;;;3,0;;;;;1,0;3,0;;4,0;;1,0;;;;;1,0;;1,0;;;;;;3,0;;3,0;;;1,0;;1,0;;;4,0;;7,0;;;;;;;;;;;1,0;;;;;;;1,0;;;;2,0;;2,0;;;7,0;;;;;;2,0;4,0;;;;;;1,0;;;;1,0;;;2,0;;2,0;;;;1,0;;;;;32,0;;;;;1,0;4,0;;;10,0;;;;;;2,0;3,0;;2,0;13,0;;;1,0;;1,0;;;;;2,0;;;;;1,0;;;3,0;1,0;;;;4,0;;;2,0;;;;;3,0;;;;;;8,0;;;;;;;;;;;;;;;;;;;8,0;;;1,0;;1,0;;;;1,0;;;;2,0;;17,0;;;;;6,0;1,0;;;;;;;;;;;;;;;;2,0;;;;;;;;;;;;;;4,0;2,0;;;;;1,0;;;;;;;;;;;;;;;;;;;;;;;;;;;;57,0;;;;;;;;;;;;;1,0;;;;;;;;;;12,0;9,0;;;;;;;;;;;;;;;1,0;;;;;;;;;;;;2,0;;;;;;;;;;;1,0;;3,0;;;;;;;;;2,0;;;;;;;;;;;;;;;;;3,0;;;;;;1,0;;;;;;;;;;;;;;;;;;;;2,0;;;;;;;;;;;;;;;;;;;;;;;;;1,0;;;;;;;;;;;;;;;;1,0;;;;;;;;;;;;;;;1,0;;;;;;;1,0;;;;;;;;;;;;;;1,0;;;;;;;;;;;;;;;;;;;;;;;;;1,0;;;;;1,0;;;;;4,0;;2,0;;;;;1,0;;;4,0;;;;;;;;;;;;;;;;;;;;;;4,0;;;;2,0;;;;;;;;;;;;;;;;;;;;;;;;;;;;;;;;;;;;;;;;;;;;;;;;;;;;;;;;;;;;;;;;;;;;3,0;;;;1,0;1,0;;;;;;;;;;;;;;;;;;;;;;;;;;
mate;;3,0;;;6,0;;;32,0;;;;;;;;;2,0;;6,0;;;;;;;;;;;;;;14,0;;4,0;;1,0;;;1,0;;;;7,0;;;;;;;;;;;;;17,0;;;16,0;;;3,0;;;;;4,0;;;4,0;;;7,0;;;;;10,0;;1,0;;;;;;;1,0;;;;;;;3,0;;;;;;26,0;8,0;;;;;2,0;;;;6,0;2,0;;17,0;;;;;1,0;4,0;8,0;;;1,0;;;9,0;14,0;;7,0;4,0;1,0;;;;;1,0;;;;;;7,0;2,0;;;5,0;;;;;;3,0;;2,0;1,0;25,0;29,0;1,0;;;;4,0;;;;;;;;8,0;;3,0;13,0;1,0;3,0;;;;;;;1,0;;6,0;17,0;1,0;1,0;;11,0;1,0;5,0;;14,0;;;;;;4,0;;3,0;;;5,0;;11,0;1,0;1,0;6,0;;;;;;;;;;;3,0;;;;3,0;;1,0;;;;3,0;;2,0;4,0;2,0;;;;5,0;;6,0;;;7,0;;;;;;;;;;;;;1,0;10,0;;;;;;;10,0;;4,0;;2,0;2,0;2,0;1,0;;;;13,0;;;;1,0;1,0;8,0;;14,0;;;1,0;;;;1,0;;3,0;;;;;;1,0;;6,0;;;;1,0;;;;;1,0;;;;;29,0;;;;4,0;2,0;;;51,0;1,0;;;;;1,0;;;;;;;;;;;;;1,0;4,0;;;;;;;;;;;;;;;;;;;;;1,0;;;;;;;;;;;;;;;;;;;;;;;;;;;;;;;;;;;;;1,0;;;;;;;;;;4,0;1,0;;;;;10,0;;;;;;;;;;;;;;;;;;;;;;;;;;;;;;;;;;;;;;;;;;;;;;;;;3,0;1,0;;;;;;;;;;1,0;;;;;;;;;;;;;;;;;;8,0;;;;;;;;;;;11,0;;4,0;;;;;;;;3,0;11,0;;;;;;;;;;;;;;;;;;;;;;;;;;;;1,0;;;;;;1,0;1,0;;;;;;;;;;;;;;;2,0;;;;1,0;;;;8,0;;1,0;;;;;;;;;;15,0;;;;;;;3,0;;;;;;;;;;;;;;4,0;;;;;2,0;;;;;3,0;;;;;;;;;6,0;;;7,0;;;;;3,0;;;;4,0;;;;;;;;;5,0;;;;;2,0;;;;;7,0;4,0;;;;;2,0;;;;;;;;;;;;;;;;;;;;;;;;;;;;;;;;;;;;;;;;;;;;;;;;;;;;;;;;;;;;;;;;;;;;;;;;;;;;;;;;;;;;;;;;;;;;;;;1,0;1,0;;;;;;;1,0;;;;;;;;;3,0;;;;;;;;;;;;;;;;;;;;;;1,0;;;;;;1,0;;;;;;;;;;;;;;;;;;;1,0;;;;;;;;;;;;;;;22,0;;;;;;;;;;;;;;;;;;;1,0;;;;7,0;;;;;;;;;;;;;;;;;;;;;;;1,0;;;;;;;;;;;;;;;;;;3,0;;;;;;;;;;;;;;;;;;;;;;;;;3,0;;;27,0;;;;;;;;;;;;;;;;;;;;;;;;;;;;;;;;;;;;;;;;;;;;;;;;;;;;;;2,0;;;;;;;;;;;;;;;;
mechanism;;4,0;21,0;;110,0;;96,0;90,0;3,0;46,0;5,0;1,0;;;;2,0;8,0;26,0;13,0;3,0;;209,0;2,0;12,0;71,0;3,0;;19,0;1,0;26,0;19,0;30,0;213,0;2,0;35,0;7,0;10,0;75,0;28,0;50,0;7,0;;489,0;33,0;2,0;;2,0;5,0;163,0;;3,0;22,0;1,0;24,0;1,0;134,0;320,0;;9,0;339,0;13,0;2,0;22,0;2,0;;98,0;85,0;6,0;2,0;39,0;120,0;4,0;9,0;5,0;;6,0;6,0;18,0;279,0;11,0;18,0;19,0;24,0;1,0;;15,0;4,0;1,0;;16,0;33,0;37,0;4,0;60,0;6,0;10,0;;7,0;11,0;6,0;80,0;130,0;;74,0;;19,0;2,0;88,0;;;13,0;35,0;1,0;36,0;32,0;10,0;21,0;;16,0;94,0;2,0;2,0;20,0;17,0;;;112,0;7,0;2,0;104,0;46,0;;;34,0;1,0;21,0;58,0;;;1,0;6,0;1,0;7,0;11,0;12,0;59,0;48,0;28,0;;;;31,0;38,0;32,0;30,0;12,0;21,0;73,0;4,0;58,0;3,0;1,0;12,0;11,0;5,0;;;59,0;4,0;3,0;154,0;107,0;159,0;96,0;63,0;50,0;20,0;13,0;;;;;8,0;4,0;123,0;2,0;38,0;31,0;;167,0;2,0;5,0;1,0;34,0;1,0;40,0;;4,0;94,0;68,0;3,0;10,0;12,0;37,0;7,0;;8,0;4,0;56,0;174,0;30,0;;;2,0;100,0;51,0;31,0;;;;11,0;5,0;26,0;1,0;5,0;;2,0;1,0;;2,0;2,0;8,0;56,0;2,0;48,0;8,0;3,0;14,0;6,0;19,0;32,0;;22,0;10,0;;4,0;1,0;9,0;13,0;5,0;3,0;;3,0;138,0;3,0;;8,0;39,0;;2,0;2,0;173,0;3,0;8,0;43,0;3,0;18,0;7,0;1,0;1,0;13,0;28,0;;;6,0;10,0;;16,0;5,0;19,0;121,0;6,0;15,0;;1,0;29,0;76,0;18,0;23,0;6,0;4,0;8,0;;;2,0;11,0;;45,0;2,0;4,0;3,0;;17,0;4,0;16,0;8,0;5,0;43,0;11,0;14,0;;10,0;16,0;21,0;28,0;12,0;28,0;3,0;7,0;4,0;;2,0;121,0;27,0;;9,0;;35,0;26,0;;24,0;2,0;10,0;;;3,0;;1,0;1,0;;;6,0;1,0;17,0;5,0;2,0;;25,0;1,0;15,0;19,0;3,0;7,0;1,0;;2,0;;;2,0;;;;;1,0;8,0;3,0;3,0;2,0;7,0;;;1,0;1,0;8,0;;7,0;1,0;4,0;;8,0;11,0;15,0;;4,0;1,0;3,0;1,0;1,0;;2,0;28,0;17,0;111,0;;132,0;19,0;21,0;15,0;5,0;;12,0;;5,0;1,0;;;3,0;18,0;;22,0;7,0;25,0;;1,0;;2,0;;;14,0;2,0;3,0;;;2,0;13,0;1,0;;1,0;;;;3,0;;;;17,0;;1,0;;3,0;4,0;;4,0;;1,0;65,0;8,0;20,0;;2,0;1,0;2,0;11,0;21,0;5,0;;;3,0;6,0;;;;2,0;5,0;;6,0;62,0;2,0;5,0;;;25,0;9,0;;;2,0;68,0;2,0;;;;;;1,0;;84,0;14,0;;3,0;5,0;;48,0;2,0;6,0;18,0;25,0;5,0;5,0;;;1,0;;;1,0;118,0;13,0;;7,0;;16,0;4,0;4,0;;5,0;6,0;11,0;18,0;1,0;;;6,0;;;45,0;;5,0;19,0;4,0;;1,0;;;2,0;20,0;;1,0;12,0;17,0;4,0;;;;1,0;8,0;1,0;;10,0;7,0;;1,0;;22,0;1,0;2,0;5,0;;21,0;17,0;2,0;4,0;15,0;6,0;4,0;;;;22,0;;1,0;;9,0;2,0;1,0;;;;7,0;;;4,0;;2,0;9,0;1,0;;30,0;13,0;;;;2,0;;1,0;1,0;;58,0;1,0;;5,0;3,0;1,0;;23,0;3,0;;;7,0;3,0;41,0;;14,0;4,0;1,0;;4,0;;1,0;7,0;;;9,0;;1,0;7,0;;;2,0;21,0;17,0;1,0;;3,0;7,0;154,0;5,0;10,0;9,0;24,0;6,0;;;1,0;;1,0;;;;2,0;2,0;;;6,0;3,0;20,0;3,0;3,0;2,0;18,0;4,0;;10,0;;;2,0;6,0;6,0;44,0;;2,0;;18,0;;;4,0;2,0;4,0;;1,0;;2,0;;6,0;;1,0;;;1,0;;;;;17,0;4,0;;2,0;;5,0;;7,0;;;;;5,0;1,0;3,0;;;;2,0;;1,0;2,0;1,0;;;;40,0;;;;;6,0;;;;1,0;1,0;1,0;;7,0;;1,0;2,0;3,0;;17,0;;6,0;2,0;;8,0;;;;23,0;;3,0;;;2,0;3,0;4,0;1,0;;;;1,0;2,0;6,0;2,0;1,0;;;1,0;;1,0;;;;1,0;;9,0;1,0;;15,0;4,0;8,0;22,0;;;;1,0;2,0;;;1,0;;1,0;;;;;;2,0;;;;2,0;;;;;1,0;;1,0;1,0;;;2,0;;;1,0;2,0;;10,0;;3,0;;13,0;2,0;;5,0;3,0;;5,0;;1,0;4,0;4,0;1,0;4,0;10,0;2,0;;3,0;3,0;31,0;;9,0;;;4,0;;;;;;;37,0;7,0;36,0;;;;;11,0;13,0;22,0;;52,0;;;1,0;1,0;;1,0;2,0;3,0;;1,0;;;;5,0;;;;2,0;7,0;;15,0;2,0;4,0;3,0;1,0;12,0;5,0;2,0;2,0;;;;2,0;;;1,0;;2,0;62,0;;10,0;12,0;1,0;;;39,0;;;4,0;2,0;3,0;;1,0;;;;;1,0;;;;;;;1,0;;;3,0;;;;;;2,0;;5,0;;;1,0;;;;5,0;;;;;;;;1,0;;5,0;4,0;;;;1,0;;;;;;;;1,0;;1,0;;;;3,0;;;;1,0;2,0;4,0;;;;;;1,0;;;;;;;;;;;;;;;
member;;8,0;26,0;;259,0;;355,0;402,0;5,0;15,0;36,0;3,0;9,0;11,0;7,0;17,0;1,0;11,0;75,0;3,0;12,0;364,0;6,0;11,0;112,0;;19,0;12,0;16,0;69,0;15,0;18,0;453,0;1,0;68,0;;9,0;964,0;33,0;87,0;31,0;5,0;431,0;185,0;12,0;1,0;22,0;6,0;58,0;8,0;28,0;106,0;2,0;75,0;17,0;270,0;537,0;;34,0;1261,0;38,0;2,0;43,0;;;66,0;437,0;6,0;2,0;301,0;591,0;27,0;47,0;68,0;34,0;22,0;8,0;54,0;723,0;63,0;78,0;4,0;9,0;9,0;;63,0;35,0;16,0;2,0;79,0;205,0;7,0;19,0;111,0;15,0;117,0;2,0;9,0;22,0;57,0;528,0;139,0;1,0;12,0;;;14,0;338,0;12,0;45,0;52,0;173,0;13,0;82,0;376,0;;198,0;2,0;26,0;338,0;7,0;1,0;8,0;17,0;9,0;;249,0;357,0;;188,0;320,0;1,0;2,0;24,0;20,0;20,0;300,0;47,0;37,0;76,0;12,0;;34,0;131,0;33,0;262,0;386,0;300,0;;5,0;1,0;88,0;429,0;94,0;415,0;92,0;177,0;277,0;23,0;98,0;35,0;3,0;69,0;47,0;2,0;8,0;7,0;320,0;3,0;63,0;;45,0;240,0;506,0;181,0;140,0;120,0;77,0;4,0;;29,0;12,0;48,0;19,0;137,0;80,0;245,0;183,0;2,0;837,0;24,0;45,0;;142,0;16,0;208,0;5,0;113,0;280,0;143,0;27,0;122,0;42,0;302,0;8,0;11,0;89,0;213,0;129,0;1285,0;5,0;27,0;8,0;32,0;25,0;22,0;77,0;118,0;7,0;15,0;149,0;20,0;154,0;7,0;48,0;1,0;41,0;;5,0;73,0;14,0;11,0;99,0;64,0;37,0;24,0;92,0;85,0;53,0;8,0;245,0;37,0;32,0;73,0;6,0;56,0;24,0;28,0;26,0;102,0;7,0;10,0;39,0;333,0;27,0;;90,0;74,0;7,0;22,0;1,0;356,0;40,0;272,0;348,0;83,0;182,0;63,0;47,0;53,0;66,0;158,0;6,0;21,0;65,0;3,0;2,0;32,0;40,0;79,0;162,0;237,0;7,0;154,0;7,0;49,0;320,0;49,0;123,0;91,0;1,0;30,0;17,0;;6,0;55,0;1,0;74,0;15,0;6,0;38,0;4,0;77,0;44,0;79,0;90,0;59,0;57,0;107,0;33,0;19,0;32,0;62,0;62,0;74,0;1,0;107,0;40,0;112,0;118,0;5,0;12,0;319,0;230,0;4,0;30,0;15,0;122,0;20,0;14,0;32,0;3,0;1,0;;;2,0;;;1,0;;9,0;11,0;1,0;16,0;14,0;13,0;;29,0;;31,0;107,0;24,0;1,0;;;5,0;;;7,0;12,0;5,0;;4,0;1,0;;50,0;9,0;;6,0;;1,0;9,0;;13,0;5,0;9,0;2,0;;;151,0;;32,0;;1,0;3,0;33,0;;1,0;;8,0;46,0;33,0;92,0;2,0;70,0;6,0;7,0;8,0;2,0;;16,0;1,0;1,0;;;;;13,0;2,0;3,0;6,0;50,0;14,0;9,0;;1,0;7,0;;11,0;5,0;9,0;;;16,0;65,0;4,0;1,0;4,0;;;;3,0;;1,0;3,0;37,0;;;;9,0;29,0;;;;16,0;12,0;34,0;43,0;4,0;18,0;1,0;1,0;5,0;114,0;3,0;;1,0;5,0;25,0;;;7,0;1,0;1,0;8,0;23,0;724,0;2,0;1,0;;19,0;19,0;14,0;;;2,0;7,0;6,0;;;24,0;;;1,0;;340,0;12,0;2,0;2,0;24,0;4,0;69,0;3,0;41,0;45,0;28,0;6,0;9,0;3,0;;;;;1,0;41,0;72,0;;28,0;;37,0;17,0;88,0;;;49,0;56,0;15,0;;;;7,0;51,0;7,0;5,0;;10,0;20,0;2,0;1,0;12,0;2,0;;12,0;;;;18,0;4,0;4,0;;;2,0;1,0;40,0;9,0;1,0;119,0;;;10,0;2,0;;31,0;;;17,0;8,0;6,0;35,0;3,0;;8,0;;;37,0;21,0;281,0;8,0;23,0;;41,0;1,0;;;22,0;;34,0;1,0;3,0;;4,0;;38,0;;;127,0;50,0;;;;3,0;22,0;2,0;10,0;;15,0;1,0;6,0;16,0;96,0;5,0;;23,0;12,0;20,0;;8,0;5,0;33,0;1,0;8,0;24,0;16,0;3,0;2,0;;1,0;5,0;14,0;4,0;;9,0;13,0;29,0;3,0;8,0;3,0;4,0;74,0;23,0;;50,0;17,0;3,0;4,0;22,0;32,0;19,0;42,0;16,0;48,0;1,0;4,0;5,0;4,0;;;3,0;10,0;9,0;;22,0;;89,0;23,0;13,0;20,0;56,0;2,0;10,0;8,0;6,0;;1,0;115,0;12,0;13,0;12,0;21,0;19,0;2,0;;4,0;10,0;12,0;9,0;1,0;1,0;6,0;;;;2,0;2,0;8,0;;2,0;3,0;;;;33,0;6,0;;;;;8,0;2,0;1,0;17,0;;1,0;;;1,0;;;;11,0;;24,0;;;;;;46,0;;1,0;;;3,0;;;4,0;;1,0;4,0;;7,0;;2,0;1,0;10,0;;1,0;6,0;;3,0;;6,0;2,0;;3,0;28,0;9,0;1,0;4,0;;4,0;22,0;3,0;1,0;;;;;10,0;28,0;1,0;;4,0;4,0;;7,0;4,0;;;;2,0;;9,0;1,0;;40,0;;19,0;79,0;;;;;;;5,0;;;;;;4,0;;1,0;3,0;;6,0;49,0;;1,0;4,0;;;16,0;;21,0;34,0;;9,0;1,0;1,0;2,0;;1,0;13,0;2,0;;2,0;1,0;6,0;;;23,0;2,0;;15,0;1,0;;14,0;2,0;31,0;15,0;3,0;26,0;;28,0;2,0;;;2,0;;2,0;56,0;1,0;5,0;4,0;;;;26,0;62,0;;1,0;;;;4,0;;202,0;1,0;49,0;6,0;3,0;14,0;17,0;;14,0;;4,0;;1,0;;16,0;;118,0;5,0;4,0;;15,0;;;12,0;8,0;54,0;63,0;6,0;;9,0;1,0;;;3,0;;;;;1,0;;3,0;29,0;;92,0;2,0;22,0;14,0;1,0;21,0;;;;4,0;;;8,0;;2,0;;;3,0;7,0;;1,0;1,0;;;3,0;;;;10,0;1,0;;;;1,0;;13,0;;;;;;;;;;;;;;2,0;;29,0;36,0;;13,0;;;10,0;8,0;10,0;;1,0;;;1,0;;;2,0;;;;3,0;;9,0;9,0;;;12,0;;;2,0;1,0;4,0;;2,0;41,0;;;;;;;;;10,0;;;;
memory;;2,0;14,0;1,0;113,0;;4,0;58,0;21,0;128,0;1,0;14,0;;3,0;21,0;4,0;6,0;1,0;17,0;66,0;1,0;162,0;9,0;10,0;20,0;;1,0;609,0;3,0;27,0;12,0;44,0;351,0;6,0;254,0;3,0;9,0;11,0;;117,0;11,0;1,0;12,0;93,0;8,0;2,0;;;36,0;4,0;14,0;23,0;2,0;8,0;;1116,0;129,0;3,0;1,0;130,0;2,0;8,0;124,0;;4,0;1,0;25,0;;1,0;37,0;18,0;61,0;1,0;2,0;;3,0;;14,0;50,0;12,0;;71,0;192,0;13,0;2,0;;36,0;7,0;12,0;43,0;56,0;1,0;3,0;272,0;17,0;70,0;1,0;118,0;1096,0;14,0;12,0;111,0;4,0;26,0;10,0;11,0;20,0;411,0;;;21,0;21,0;9,0;14,0;17,0;11,0;;;2,0;21,0;;;;64,0;;;123,0;2,0;;77,0;;6,0;;1,0;7,0;14,0;22,0;;7,0;;2,0;1,0;31,0;33,0;18,0;;21,0;190,0;;3,0;;;2,0;;15,0;2,0;4,0;29,0;4,0;64,0;1,0;1,0;;3,0;3,0;2,0;3,0;15,0;24,0;2,0;9,0;2,0;57,0;11,0;6,0;;;92,0;;;;3,0;;7,0;;;;188,0;;27,0;;;;63,0;;;;3,0;1,0;3,0;10,0;72,0;;7,0;;21,0;3,0;;6,0;3,0;3,0;2,0;;9,0;;49,0;13,0;;;;2,0;4,0;1,0;;4,0;1,0;;;14,0;;;1,0;;3,0;8,0;11,0;;14,0;103,0;14,0;6,0;;31,0;1,0;1,0;15,0;5,0;;;;7,0;14,0;;82,0;;1,0;;5,0;2,0;2,0;5,0;1,0;5,0;;;;4,0;1,0;;;;2,0;;18,0;8,0;46,0;9,0;;5,0;3,0;;;3,0;7,0;;25,0;11,0;20,0;19,0;3,0;2,0;;4,0;22,0;19,0;1,0;3,0;24,0;;;11,0;;35,0;2,0;2,0;1,0;;9,0;;;12,0;19,0;;1,0;2,0;;;;;;;9,0;;;;7,0;;;17,0;1,0;34,0;;2,0;2,0;2,0;3,0;11,0;8,0;9,0;4,0;;21,0;7,0;2,0;3,0;161,0;5,0;1,0;;9,0;;34,0;31,0;;;;1,0;4,0;;;6,0;;;2,0;13,0;23,0;;2,0;5,0;2,0;5,0;;4,0;6,0;39,0;;3,0;2,0;;14,0;17,0;8,0;4,0;86,0;3,0;2,0;9,0;1,0;8,0;175,0;1,0;10,0;1,0;;11,0;8,0;2,0;12,0;12,0;6,0;2,0;;12,0;1,0;1,0;1,0;2,0;13,0;1,0;2,0;4,0;10,0;;7,0;10,0;8,0;3,0;;35,0;2,0;106,0;17,0;;13,0;26,0;1,0;4,0;141,0;4,0;14,0;46,0;1,0;;2,0;1,0;3,0;26,0;;;12,0;8,0;3,0;107,0;13,0;36,0;86,0;9,0;24,0;10,0;1,0;;29,0;16,0;47,0;;8,0;27,0;4,0;44,0;;2,0;1,0;1,0;;;23,0;;;40,0;;2,0;35,0;1,0;;3,0;2,0;19,0;2,0;2,0;2,0;43,0;1,0;4,0;2,0;;1,0;4,0;6,0;7,0;16,0;11,0;33,0;4,0;;123,0;4,0;1,0;1,0;1,0;62,0;22,0;70,0;12,0;2,0;1,0;3,0;1,0;;10,0;1,0;;1,0;4,0;41,0;29,0;14,0;14,0;4,0;1,0;1,0;2,0;;2,0;;;;1,0;;4,0;;;1,0;;1,0;55,0;2,0;;1,0;1,0;4,0;;10,0;1,0;11,0;;1,0;6,0;9,0;15,0;;5,0;14,0;19,0;1,0;45,0;;18,0;10,0;2,0;31,0;115,0;;25,0;1,0;;25,0;6,0;8,0;;23,0;;5,0;9,0;5,0;;;34,0;21,0;;;3,0;1,0;43,0;4,0;7,0;16,0;;4,0;7,0;10,0;1,0;;;2,0;44,0;;1,0;;1,0;;;;17,0;;;12,0;;3,0;;12,0;;4,0;;;;2,0;10,0;63,0;;2,0;;;7,0;6,0;2,0;;;1,0;9,0;;;34,0;;12,0;7,0;;;;;;;3,0;;;;9,0;20,0;;2,0;6,0;5,0;3,0;4,0;;;1,0;;;3,0;;2,0;;2,0;;;4,0;;;;;;;1,0;;5,0;3,0;;;1,0;;7,0;9,0;5,0;8,0;24,0;4,0;;4,0;3,0;;;14,0;1,0;;2,0;;5,0;31,0;;4,0;6,0;;;;4,0;2,0;;;9,0;27,0;15,0;8,0;4,0;6,0;;6,0;27,0;2,0;2,0;;1,0;2,0;;2,0;;3,0;2,0;1,0;;;;17,0;14,0;;1,0;;;;4,0;2,0;4,0;2,0;1,0;4,0;;;9,0;4,0;;4,0;;;;44,0;1,0;5,0;3,0;5,0;;8,0;;2,0;4,0;4,0;4,0;3,0;;2,0;10,0;5,0;7,0;;;;;3,0;3,0;;;4,0;;3,0;;1,0;2,0;;3,0;2,0;1,0;2,0;;;1,0;5,0;6,0;;5,0;;;;2,0;2,0;;;;3,0;;;;2,0;;;1,0;3,0;;1,0;;;4,0;;;2,0;;1,0;;;;;6,0;;6,0;7,0;;;;;6,0;;3,0;38,0;;1,0;;;;1,0;2,0;;;;;;6,0;4,0;;;;;;;;5,0;1,0;;;1,0;2,0;;1,0;;;3,0;6,0;;;3,0;1,0;;;;;;1,0;;;;;;;3,0;;;;5,0;;;23,0;;3,0;;1,0;;;;;;;4,0;;;;;1,0;;1,0;;;;;;4,0;1,0;2,0;;3,0;8,0;;14,0;;;18,0;;1,0;1,0;;13,0;1,0;1,0;;;;;1,0;3,0;6,0;5,0;;1,0;;;;;;;;2,0;;;;;2,0;;;;;;;1,0;1,0;;;6,0;;4,0;;;;;4,0;;;3,0;;;;;11,0;2,0;;;;;1,0;;;;;;;
mirror;;15,0;12,0;;55,0;;69,0;11,0;;17,0;13,0;16,0;3,0;4,0;2,0;;;;24,0;;3,0;52,0;9,0;12,0;;;41,0;15,0;9,0;20,0;7,0;20,0;104,0;3,0;71,0;1,0;40,0;73,0;;45,0;20,0;15,0;239,0;43,0;2,0;;;19,0;11,0;7,0;11,0;16,0;;7,0;;252,0;106,0;;1,0;112,0;5,0;;40,0;;;36,0;20,0;12,0;2,0;24,0;261,0;8,0;109,0;;;27,0;;15,0;339,0;1,0;2,0;21,0;9,0;6,0;;75,0;19,0;2,0;3,0;12,0;38,0;;6,0;35,0;6,0;4,0;;6,0;3,0;;203,0;171,0;;1,0;;;4,0;51,0;;6,0;14,0;53,0;3,0;36,0;14,0;;;;5,0;25,0;;;;43,0;5,0;2,0;37,0;25,0;1,0;7,0;7,0;1,0;1,0;2,0;14,0;15,0;70,0;3,0;;5,0;;4,0;9,0;32,0;18,0;67,0;70,0;28,0;1,0;2,0;;1,0;34,0;;7,0;;2,0;9,0;20,0;82,0;44,0;1,0;10,0;14,0;;7,0;1,0;231,0;1,0;6,0;45,0;;10,0;44,0;20,0;5,0;;15,0;1,0;;;4,0;36,0;6,0;11,0;53,0;11,0;53,0;;120,0;;;46,0;35,0;1,0;412,0;;8,0;23,0;1,0;;12,0;2,0;111,0;;2,0;;;12,0;29,0;;1,0;;10,0;27,0;22,0;32,0;3,0;6,0;;14,0;29,0;;6,0;57,0;15,0;6,0;2,0;;;;;2,0;1,0;2,0;22,0;8,0;6,0;5,0;;;;8,0;1,0;;1,0;;;;1,0;5,0;;;19,0;2,0;4,0;1,0;1,0;1,0;;3,0;43,0;8,0;;12,0;7,0;3,0;;;1,0;;9,0;;4,0;5,0;12,0;;42,0;;52,0;13,0;;2,0;107,0;;3,0;48,0;23,0;7,0;13,0;3,0;1,0;;;;5,0;2,0;40,0;9,0;;;;15,0;19,0;3,0;;;6,0;8,0;1,0;15,0;4,0;74,0;1,0;6,0;;8,0;;4,0;3,0;1,0;1,0;3,0;5,0;;24,0;;18,0;;1,0;2,0;6,0;3,0;;;;3,0;;1,0;4,0;8,0;;;;;;;2,0;3,0;5,0;14,0;;2,0;5,0;;1,0;10,0;;1,0;;2,0;;2,0;;;1,0;3,0;;;3,0;;5,0;1,0;14,0;1,0;2,0;;;;23,0;6,0;9,0;;;;1,0;;;;8,0;10,0;9,0;1,0;;64,0;1,0;20,0;10,0;2,0;3,0;1,0;;2,0;;12,0;;;9,0;1,0;1,0;2,0;13,0;1,0;;;;;;19,0;29,0;15,0;;;2,0;42,0;;;2,0;;10,0;1,0;;;;;2,0;;;;5,0;1,0;;;;3,0;19,0;1,0;;;3,0;;;25,0;;21,0;;;5,0;;;;;3,0;2,0;;2,0;246,0;;9,0;;;10,0;;;;8,0;2,0;;;1,0;;;;;;51,0;26,0;5,0;5,0;8,0;2,0;36,0;;10,0;29,0;64,0;26,0;;;;;1,0;;;74,0;15,0;;;1,0;;;;;5,0;;;;;;;;;;1,0;;3,0;3,0;;1,0;24,0;;;;;;;;;;;;;;5,0;23,0;;4,0;;;;;1,0;;2,0;;;;;3,0;4,0;2,0;;;;;;7,0;;;;;3,0;;;;;5,0;;;;;;57,0;1,0;5,0;1,0;;;;;;;;18,0;;38,0;1,0;;5,0;4,0;1,0;;2,0;8,0;;;4,0;4,0;;;;;1,0;44,0;;2,0;1,0;;;1,0;;;;18,0;1,0;;;;10,0;;1,0;;3,0;;1,0;;139,0;8,0;;;;5,0;27,0;;10,0;;;1,0;;;;12,0;;;;1,0;;;;14,0;8,0;;1,0;;74,0;;1,0;;;;;;;;4,0;4,0;;1,0;1,0;;13,0;;;2,0;1,0;1,0;4,0;8,0;;;;6,0;1,0;;;;7,0;7,0;10,0;;;;;6,0;;;;;;4,0;;1,0;;17,0;;;9,0;;;;1,0;;2,0;;1,0;6,0;;;;;1,0;;;;2,0;;;;;;2,0;5,0;;4,0;2,0;;4,0;18,0;;;11,0;;;5,0;;1,0;;1,0;;3,0;;;2,0;4,0;;;;2,0;;2,0;;;;11,0;;4,0;;7,0;;;;15,0;;;2,0;;;;;;;;;;;;;6,0;;;;;;;;;9,0;;7,0;3,0;1,0;2,0;;2,0;;;;2,0;1,0;;;;2,0;;;19,0;;;3,0;8,0;6,0;24,0;;27,0;;;;;;5,0;2,0;;4,0;;;;;;;5,0;2,0;;;4,0;;;1,0;6,0;22,0;;;;44,0;;10,0;;;;;;1,0;;;;;2,0;5,0;;3,0;;1,0;;;;;15,0;;;;;;;;;;;;;;26,0;;;;1,0;;;;;;;37,0;5,0;;4,0;;9,0;10,0;;3,0;;;;4,0;;;;;3,0;;1,0;;;;;;;1,0;2,0;;2,0;;;;;;;;;;2,0;;1,0;2,0;8,0;;;;;4,0;15,0;;6,0;;;;;;;;;;;8,0;;;;;1,0;;;;;;;;6,0;;;;;;;;;;29,0;;;;
mode;;2,0;60,0;28,0;98,0;;8,0;101,0;15,0;214,0;2,0;13,0;;4,0;66,0;17,0;1,0;17,0;18,0;34,0;37,0;494,0;1,0;11,0;195,0;3,0;1,0;213,0;10,0;166,0;72,0;200,0;430,0;2,0;196,0;;13,0;6,0;;464,0;20,0;2,0;44,0;74,0;;5,0;;16,0;158,0;47,0;76,0;61,0;1,0;7,0;;1031,0;278,0;;5,0;118,0;6,0;3,0;223,0;12,0;8,0;17,0;155,0;;6,0;454,0;56,0;11,0;5,0;;;54,0;1,0;22,0;178,0;187,0;11,0;152,0;65,0;4,0;2,0;;13,0;;6,0;714,0;59,0;59,0;486,0;205,0;52,0;3,0;;29,0;53,0;3,0;9,0;165,0;3,0;49,0;8,0;1,0;18,0;503,0;1,0;;8,0;20,0;29,0;13,0;4,0;9,0;6,0;4,0;;59,0;;;48,0;92,0;;2,0;153,0;1,0;6,0;4,0;7,0;2,0;1,0;;2,0;9,0;3,0;;;31,0;4,0;;20,0;5,0;19,0;;4,0;33,0;;;;;;;35,0;1,0;;10,0;55,0;148,0;1,0;3,0;;;1,0;;17,0;146,0;10,0;1,0;65,0;42,0;57,0;10,0;41,0;7,0;1,0;192,0;;;7,0;2,0;6,0;47,0;;;2,0;224,0;;98,0;2,0;;1,0;101,0;;12,0;;;10,0;;;3,0;;16,0;;25,0;2,0;1,0;4,0;36,0;34,0;;;31,0;16,0;106,0;63,0;;;2,0;1,0;;102,0;6,0;;3,0;7,0;;2,0;;;3,0;14,0;2,0;28,0;41,0;2,0;9,0;52,0;16,0;20,0;;7,0;;;19,0;5,0;2,0;;1,0;2,0;6,0;;6,0;2,0;1,0;;7,0;5,0;1,0;;142,0;;;10,0;1,0;12,0;;;;;;;3,0;1,0;5,0;10,0;;1,0;;19,0;;3,0;13,0;;62,0;10,0;68,0;214,0;1,0;8,0;;4,0;20,0;;;;387,0;1,0;1,0;16,0;;84,0;12,0;65,0;;5,0;46,0;;;8,0;18,0;9,0;;2,0;;1,0;;;;;108,0;;;5,0;12,0;;1,0;26,0;;109,0;9,0;;;1,0;2,0;5,0;62,0;18,0;;1,0;24,0;;15,0;132,0;3,0;17,0;33,0;;189,0;29,0;28,0;;2,0;4,0;;1,0;1,0;;1,0;3,0;;6,0;;7,0;62,0;5,0;4,0;4,0;3,0;7,0;;;12,0;55,0;26,0;9,0;1,0;;1,0;28,0;24,0;2,0;23,0;3,0;4,0;16,0;47,0;1,0;280,0;20,0;75,0;;;29,0;161,0;30,0;21,0;18,0;1,0;10,0;;7,0;34,0;1,0;1,0;3,0;23,0;32,0;28,0;1,0;18,0;;4,0;3,0;25,0;1,0;;44,0;2,0;3,0;;14,0;57,0;;39,0;22,0;94,0;13,0;42,0;12,0;10,0;15,0;;5,0;4,0;8,0;8,0;4,0;9,0;76,0;;1,0;;20,0;90,0;20,0;17,0;20,0;9,0;2,0;35,0;17,0;38,0;2,0;29,0;3,0;16,0;27,0;1,0;11,0;25,0;105,0;8,0;;72,0;26,0;6,0;20,0;87,0;;134,0;;;2,0;;141,0;;4,0;5,0;40,0;;3,0;7,0;;6,0;42,0;202,0;66,0;394,0;16,0;627,0;5,0;41,0;126,0;142,0;26,0;4,0;;2,0;2,0;14,0;2,0;15,0;26,0;3,0;;;15,0;;;;3,0;5,0;86,0;11,0;2,0;11,0;;23,0;1,0;;2,0;5,0;;62,0;39,0;;1,0;53,0;;6,0;;;52,0;9,0;8,0;6,0;5,0;;;2,0;4,0;;;;6,0;6,0;1,0;;10,0;9,0;;1,0;38,0;;20,0;;4,0;133,0;87,0;;13,0;2,0;;1,0;29,0;139,0;12,0;1,0;1,0;1,0;;6,0;3,0;;;;;;;3,0;53,0;2,0;5,0;24,0;;1,0;;10,0;52,0;;;9,0;;25,0;;;;1,0;2,0;;111,0;;;;4,0;4,0;;;;12,0;3,0;;3,0;;6,0;;1,0;;2,0;;32,0;;;2,0;4,0;;44,0;3,0;;;6,0;4,0;13,0;;1,0;;3,0;;;2,0;;;;4,0;3,0;28,0;;;26,0;;1,0;2,0;;1,0;;;1,0;1,0;5,0;2,0;;;;11,0;6,0;;;;17,0;2,0;18,0;;4,0;3,0;;7,0;6,0;3,0;1,0;1,0;1,0;12,0;1,0;4,0;;4,0;82,0;;;20,0;7,0;2,0;6,0;;;9,0;4,0;7,0;6,0;;2,0;4,0;1,0;;;7,0;10,0;29,0;23,0;27,0;3,0;75,0;18,0;11,0;;6,0;52,0;;;;;1,0;3,0;2,0;;23,0;;;133,0;5,0;11,0;58,0;1,0;5,0;2,0;;18,0;;2,0;1,0;27,0;;;37,0;1,0;;;;;4,0;4,0;16,0;;;;14,0;;2,0;38,0;19,0;3,0;4,0;2,0;1,0;;7,0;4,0;4,0;21,0;;;12,0;;13,0;13,0;5,0;77,0;;9,0;15,0;;3,0;5,0;9,0;15,0;8,0;;;8,0;;;11,0;21,0;2,0;11,0;;;;10,0;;;4,0;;72,0;;7,0;5,0;45,0;2,0;6,0;;14,0;;1,0;15,0;1,0;5,0;;10,0;;;;4,0;4,0;;;6,0;4,0;1,0;7,0;19,0;2,0;;;;;3,0;4,0;;7,0;;;2,0;;;;;;16,0;33,0;4,0;3,0;4,0;;3,0;8,0;3,0;1,0;;14,0;3,0;;;;3,0;;4,0;;;;52,0;;;;4,0;;2,0;1,0;;;;3,0;1,0;;3,0;;;7,0;;2,0;2,0;;5,0;;1,0;2,0;2,0;11,0;21,0;;;;;;;2,0;;;3,0;2,0;;70,0;;12,0;;;;;6,0;2,0;;;1,0;5,0;;;;;7,0;3,0;3,0;;1,0;;2,0;;;;;;;;14,0;;;;;;;;;9,0;;3,0;;;;2,0;;;;;;;;;4,0;19,0;;3,0;;;1,0;;;;;;4,0;;;;;;;4,0;;3,0;;;;;;;;;;
mount;;141,0;1,0;;228,0;;64,0;427,0;;67,0;57,0;6,0;5,0;;8,0;6,0;;;51,0;15,0;5,0;69,0;7,0;4,0;2,0;;7,0;19,0;7,0;41,0;11,0;21,0;333,0;1,0;106,0;1,0;32,0;93,0;1,0;112,0;30,0;2,0;40,0;154,0;;;6,0;9,0;13,0;;15,0;17,0;2,0;19,0;4,0;407,0;342,0;1,0;24,0;1315,0;6,0;;170,0;;6,0;149,0;44,0;30,0;1,0;10,0;118,0;11,0;12,0;10,0;8,0;38,0;14,0;52,0;238,0;36,0;12,0;15,0;21,0;4,0;;4,0;13,0;9,0;;22,0;361,0;3,0;8,0;23,0;14,0;38,0;;1,0;5,0;175,0;489,0;318,0;1,0;6,0;;1,0;24,0;436,0;;12,0;91,0;59,0;29,0;274,0;185,0;10,0;36,0;;195,0;343,0;5,0;16,0;1,0;147,0;1,0;;163,0;63,0;1,0;183,0;154,0;;7,0;17,0;13,0;46,0;79,0;9,0;13,0;14,0;3,0;1,0;34,0;91,0;34,0;14,0;168,0;200,0;6,0;4,0;;22,0;31,0;14,0;58,0;84,0;119,0;331,0;16,0;137,0;11,0;1,0;77,0;40,0;4,0;24,0;6,0;116,0;6,0;26,0;506,0;44,0;338,0;;29,0;91,0;104,0;14,0;26,0;;62,0;6,0;8,0;14,0;87,0;42,0;427,0;196,0;;431,0;;26,0;6,0;216,0;10,0;3,0;1,0;9,0;48,0;87,0;19,0;30,0;8,0;176,0;22,0;8,0;8,0;72,0;213,0;361,0;8,0;91,0;1,0;2,0;96,0;14,0;14,0;20,0;2,0;46,0;48,0;193,0;11,0;3,0;45,0;2,0;46,0;28,0;9,0;12,0;15,0;1,0;22,0;38,0;57,0;51,0;32,0;9,0;68,0;20,0;234,0;13,0;39,0;82,0;14,0;34,0;5,0;117,0;8,0;90,0;7,0;6,0;12,0;175,0;;3,0;10,0;85,0;18,0;20,0;;68,0;35,0;12,0;114,0;11,0;88,0;6,0;71,0;25,0;23,0;107,0;15,0;4,0;36,0;31,0;;5,0;14,0;36,0;22,0;71,0;11,0;96,0;27,0;24,0;39,0;30,0;20,0;53,0;3,0;1,0;1,0;8,0;38,0;28,0;4,0;25,0;15,0;1,0;14,0;16,0;26,0;15,0;56,0;12,0;97,0;11,0;46,0;87,0;12,0;29,0;3,0;;114,0;16,0;25,0;18,0;88,0;12,0;74,0;29,0;52,0;48,0;;46,0;25,0;15,0;20,0;8,0;12,0;;60,0;;;;4,0;10,0;;10,0;9,0;6,0;3,0;6,0;;;;8,0;5,0;12,0;16,0;2,0;1,0;;;;;;14,0;1,0;5,0;;10,0;;5,0;3,0;;;10,0;;6,0;3,0;;1,0;3,0;11,0;18,0;;;45,0;4,0;62,0;;;;;;4,0;;18,0;10,0;9,0;5,0;3,0;23,0;;2,0;6,0;;;22,0;;3,0;;6,0;;;2,0;;4,0;22,0;33,0;80,0;4,0;;2,0;13,0;;5,0;15,0;18,0;1,0;;14,0;10,0;1,0;;20,0;;3,0;2,0;1,0;1,0;5,0;;49,0;;2,0;;24,0;8,0;;15,0;5,0;11,0;25,0;4,0;2,0;;41,0;1,0;;19,0;29,0;4,0;;1,0;;;;;2,0;;;3,0;14,0;59,0;5,0;2,0;;4,0;19,0;101,0;1,0;7,0;;66,0;10,0;1,0;4,0;;;;;;65,0;9,0;2,0;1,0;;1,0;33,0;9,0;12,0;100,0;61,0;17,0;1,0;;;;;;;41,0;52,0;;4,0;;26,0;42,0;1,0;;;29,0;40,0;85,0;;;;60,0;46,0;2,0;;;2,0;17,0;2,0;;2,0;8,0;;18,0;3,0;;;15,0;12,0;2,0;;12,0;10,0;1,0;16,0;28,0;4,0;34,0;24,0;;7,0;2,0;11,0;15,0;3,0;2,0;11,0;8,0;10,0;23,0;6,0;6,0;;14,0;;15,0;;68,0;1,0;1,0;;8,0;3,0;;3,0;32,0;2,0;25,0;;5,0;9,0;;2,0;5,0;;;65,0;50,0;;;;9,0;10,0;17,0;1,0;;4,0;1,0;17,0;7,0;6,0;;1,0;13,0;18,0;23,0;;73,0;5,0;23,0;3,0;13,0;19,0;14,0;2,0;;2,0;9,0;31,0;39,0;8,0;;20,0;;24,0;2,0;6,0;6,0;4,0;3,0;70,0;3,0;41,0;66,0;25,0;12,0;9,0;19,0;9,0;302,0;44,0;23,0;1,0;8,0;3,0;;;;8,0;3,0;5,0;;12,0;20,0;16,0;13,0;38,0;2,0;26,0;7,0;9,0;31,0;;;2,0;2,0;12,0;4,0;10,0;15,0;3,0;;;2,0;2,0;37,0;2,0;8,0;12,0;;2,0;;;;;3,0;3,0;;;;;3,0;16,0;2,0;;1,0;;;18,0;15,0;;8,0;;;1,0;;4,0;;;;24,0;;4,0;;5,0;;;;7,0;;17,0;8,0;;2,0;;;2,0;;;;;11,0;;;2,0;;;1,0;;;32,0;1,0;1,0;1,0;;1,0;2,0;2,0;2,0;3,0;;;9,0;;7,0;;1,0;3,0;;4,0;12,0;;;4,0;;;3,0;10,0;;;1,0;1,0;10,0;4,0;1,0;;174,0;;18,0;4,0;;;6,0;;5,0;;3,0;;1,0;4,0;;;;;1,0;9,0;;1,0;6,0;;6,0;;;;10,0;;;8,0;1,0;3,0;10,0;;;;3,0;13,0;2,0;;;;1,0;2,0;;;7,0;;11,0;13,0;;1,0;1,0;11,0;12,0;5,0;9,0;2,0;;1,0;;6,0;6,0;;;11,0;3,0;2,0;2,0;;4,0;;33,0;4,0;;2,0;;;;38,0;10,0;14,0;4,0;;;4,0;8,0;;;1,0;18,0;1,0;15,0;3,0;1,0;3,0;1,0;15,0;1,0;4,0;;2,0;3,0;5,0;6,0;;2,0;78,0;;4,0;9,0;7,0;;;8,0;1,0;;3,0;;;;;6,0;;13,0;22,0;1,0;3,0;;2,0;;;;1,0;1,0;1,0;5,0;;7,0;;1,0;;3,0;;6,0;8,0;;;3,0;1,0;;;3,0;1,0;;;;1,0;;5,0;;;4,0;;;1,0;;;;;;1,0;;5,0;1,0;11,0;2,0;1,0;6,0;;;1,0;2,0;;;;;6,0;;4,0;;3,0;;17,0;21,0;3,0;;1,0;5,0;5,0;;;;3,0;11,0;7,0;3,0;;;4,0;;;;;;;;;2,0;;;2,0;
open;;3,0;13,0;;32,0;;54,0;89,0;;67,0;19,0;;10,0;;3,0;6,0;;;4,0;2,0;;14,0;;;4,0;;13,0;4,0;11,0;20,0;8,0;11,0;97,0;;23,0;;17,0;47,0;1,0;56,0;14,0;;32,0;35,0;;2,0;5,0;1,0;14,0;1,0;6,0;3,0;;14,0;1,0;154,0;116,0;;3,0;399,0;;2,0;35,0;;;4,0;31,0;8,0;2,0;59,0;98,0;8,0;19,0;22,0;10,0;12,0;;4,0;405,0;10,0;5,0;7,0;3,0;2,0;1,0;3,0;25,0;;;6,0;42,0;10,0;10,0;20,0;22,0;43,0;;9,0;9,0;21,0;369,0;43,0;;;;2,0;3,0;126,0;;3,0;16,0;26,0;8,0;33,0;32,0;;52,0;;26,0;92,0;2,0;2,0;2,0;14,0;1,0;3,0;55,0;36,0;;;157,0;;2,0;52,0;2,0;10,0;93,0;26,0;9,0;3,0;5,0;;6,0;40,0;21,0;14,0;153,0;57,0;1,0;1,0;;9,0;28,0;5,0;8,0;23,0;44,0;128,0;3,0;58,0;8,0;7,0;74,0;21,0;;37,0;1,0;90,0;;11,0;140,0;5,0;123,0;91,0;14,0;;54,0;5,0;3,0;;28,0;23,0;35,0;;7,0;17,0;55,0;43,0;;242,0;3,0;26,0;;101,0;54,0;5,0;;6,0;9,0;4,0;3,0;64,0;26,0;108,0;10,0;;;4,0;14,0;49,0;;1,0;3,0;;;24,0;21,0;18,0;3,0;12,0;24,0;32,0;;5,0;92,0;;17,0;9,0;;3,0;11,0;;6,0;18,0;2,0;25,0;11,0;7,0;72,0;;66,0;4,0;19,0;23,0;;59,0;16,0;2,0;5,0;6,0;3,0;1,0;3,0;41,0;2,0;7,0;32,0;141,0;1,0;14,0;;9,0;27,0;5,0;36,0;6,0;58,0;6,0;19,0;3,0;7,0;35,0;;2,0;29,0;3,0;5,0;8,0;2,0;27,0;36,0;1,0;1,0;50,0;1,0;7,0;51,0;12,0;10,0;34,0;1,0;;14,0;3,0;;9,0;8,0;12,0;;2,0;4,0;4,0;24,0;16,0;12,0;10,0;;22,0;34,0;24,0;4,0;4,0;29,0;14,0;13,0;;1,0;2,0;5,0;16,0;2,0;15,0;22,0;18,0;;18,0;;28,0;;;7,0;1,0;;;;;3,0;2,0;;;2,0;2,0;2,0;;;;;1,0;11,0;15,0;264,0;;;1,0;1,0;;;1,0;6,0;;;2,0;4,0;;5,0;8,0;;;;;;5,0;;5,0;;;1,0;;;16,0;11,0;13,0;1,0;4,0;3,0;;4,0;2,0;;17,0;8,0;6,0;;;135,0;;5,0;5,0;;;;;2,0;;;;;15,0;;;28,0;40,0;16,0;3,0;;2,0;;;1,0;4,0;4,0;;;23,0;7,0;32,0;;4,0;;;;;;;;6,0;;;1,0;7,0;1,0;;;;11,0;4,0;4,0;2,0;3,0;3,0;;3,0;6,0;7,0;10,0;1,0;;1,0;2,0;;1,0;;2,0;10,0;1,0;24,0;20,0;;2,0;;;11,0;1,0;1,0;8,0;;7,0;7,0;;;;;;;;25,0;3,0;2,0;;5,0;1,0;48,0;2,0;7,0;18,0;44,0;2,0;;4,0;;5,0;;;;108,0;3,0;;4,0;;15,0;19,0;;;;9,0;11,0;38,0;;;11,0;;4,0;;2,0;;3,0;17,0;;2,0;6,0;;;35,0;;;;6,0;3,0;;;;;;9,0;10,0;;1,0;1,0;;2,0;1,0;;3,0;;;18,0;2,0;9,0;4,0;4,0;6,0;;1,0;;5,0;;16,0;;2,0;;;;;;17,0;3,0;35,0;;2,0;;;;14,0;;;45,0;40,0;;;;3,0;1,0;;1,0;9,0;1,0;;9,0;;18,0;3,0;;29,0;1,0;1,0;;6,0;1,0;;1,0;3,0;13,0;5,0;;;1,0;2,0;5,0;4,0;;;;;6,0;;;2,0;7,0;11,0;2,0;;15,0;2,0;1,0;2,0;5,0;7,0;39,0;22,0;13,0;2,0;;8,0;3,0;3,0;;;3,0;2,0;3,0;;14,0;;9,0;9,0;25,0;32,0;;4,0;;7,0;12,0;;6,0;2,0;11,0;;5,0;5,0;4,0;2,0;;;1,0;2,0;;1,0;1,0;;;;;;1,0;;;;;;;;5,0;;1,0;;;9,0;2,0;1,0;;5,0;;;;2,0;40,0;;;;2,0;;4,0;;;;1,0;;1,0;;21,0;3,0;;2,0;;;5,0;;;;;2,0;2,0;2,0;4,0;;;12,0;;;5,0;;12,0;;2,0;;;;4,0;2,0;;;;;4,0;;;;;4,0;1,0;;4,0;1,0;1,0;4,0;;3,0;1,0;2,0;2,0;;;3,0;;;10,0;6,0;5,0;;;;;;3,0;;;;3,0;9,0;;1,0;;;;15,0;;;1,0;;1,0;;;;4,0;;1,0;3,0;;1,0;;;2,0;;1,0;7,0;;;;;;;;1,0;;4,0;4,0;;3,0;1,0;1,0;2,0;1,0;4,0;1,0;;;;;7,0;2,0;;;12,0;;;;;;;2,0;;;;;;;6,0;;11,0;3,0;1,0;;;1,0;4,0;;;;;;;;2,0;;24,0;;8,0;;;;;7,0;;3,0;4,0;;;;;2,0;;;;;;;2,0;;;9,0;;8,0;5,0;;;;;;;;;;;;;;;;;;;;;;;;;;;;;;2,0;;;;1,0;;;;;;;;;;;;;4,0;20,0;2,0;1,0;;;25,0;;;1,0;;;;;;;;;;;;;;;;1,0;;4,0;;3,0;;;1,0;;4,0;;;;;;;;;;;;2,0;;;;
operate;;4,0;10,0;;62,0;;13,0;14,0;4,0;25,0;6,0;10,0;;;19,0;8,0;1,0;1,0;17,0;22,0;59,0;189,0;10,0;5,0;35,0;;;38,0;5,0;26,0;5,0;39,0;215,0;3,0;72,0;2,0;4,0;51,0;3,0;86,0;14,0;;23,0;42,0;;1,0;1,0;3,0;22,0;28,0;29,0;16,0;5,0;10,0;;205,0;54,0;;12,0;76,0;3,0;1,0;164,0;3,0;;13,0;5,0;4,0;6,0;136,0;20,0;6,0;1,0;;2,0;5,0;;39,0;79,0;41,0;8,0;47,0;29,0;3,0;;;17,0;1,0;1,0;58,0;35,0;5,0;6,0;64,0;5,0;1,0;;11,0;30,0;1,0;58,0;152,0;;3,0;;4,0;;183,0;3,0;;22,0;9,0;9,0;20,0;13,0;3,0;1,0;;2,0;34,0;1,0;2,0;5,0;64,0;;4,0;75,0;14,0;6,0;6,0;22,0;1,0;7,0;;1,0;20,0;18,0;;;7,0;1,0;19,0;8,0;15,0;6,0;;6,0;20,0;2,0;;;1,0;1,0;3,0;4,0;;4,0;15,0;11,0;26,0;1,0;3,0;1,0;6,0;5,0;2,0;6,0;36,0;3,0;2,0;123,0;7,0;51,0;20,0;13,0;10,0;2,0;20,0;;;7,0;4,0;4,0;2,0;5,0;6,0;12,0;53,0;;140,0;6,0;3,0;;46,0;;;;;13,0;6,0;;5,0;;8,0;1,0;16,0;2,0;1,0;3,0;12,0;2,0;;1,0;;42,0;75,0;13,0;;;;2,0;6,0;7,0;3,0;2,0;;6,0;;4,0;23,0;1,0;;13,0;;26,0;27,0;;6,0;25,0;20,0;11,0;3,0;5,0;4,0;2,0;15,0;25,0;5,0;4,0;;3,0;3,0;5,0;19,0;;;;2,0;1,0;3,0;;22,0;;2,0;6,0;;6,0;;3,0;1,0;1,0;;;13,0;1,0;16,0;3,0;20,0;3,0;6,0;25,0;2,0;;23,0;;16,0;16,0;14,0;;10,0;1,0;2,0;1,0;;;3,0;1,0;28,0;;;9,0;;50,0;15,0;9,0;;;22,0;;2,0;12,0;1,0;6,0;1,0;25,0;;9,0;;;2,0;1,0;9,0;14,0;4,0;;10,0;;;17,0;;59,0;4,0;1,0;1,0;;6,0;;2,0;;;1,0;13,0;;5,0;30,0;;4,0;9,0;;34,0;3,0;19,0;2,0;6,0;;1,0;1,0;;4,0;;;;;2,0;1,0;13,0;;1,0;13,0;2,0;;;;18,0;5,0;19,0;14,0;;;8,0;18,0;13,0;;13,0;4,0;1,0;4,0;3,0;;32,0;12,0;14,0;3,0;1,0;31,0;9,0;28,0;5,0;3,0;4,0;1,0;7,0;1,0;2,0;1,0;;1,0;17,0;2,0;2,0;;43,0;;4,0;;2,0;1,0;;27,0;2,0;29,0;1,0;;14,0;214,0;;4,0;11,0;1,0;5,0;7,0;4,0;;4,0;8,0;4,0;1,0;3,0;;11,0;51,0;5,0;9,0;4,0;3,0;50,0;1,0;1,0;10,0;4,0;;23,0;7,0;32,0;;4,0;;8,0;60,0;;;;3,0;1,0;3,0;15,0;9,0;21,0;22,0;1,0;;19,0;1,0;17,0;1,0;;17,0;4,0;2,0;6,0;1,0;;1,0;1,0;2,0;11,0;38,0;14,0;13,0;46,0;9,0;146,0;24,0;9,0;28,0;17,0;3,0;16,0;3,0;;1,0;1,0;3,0;;7,0;;;2,0;17,0;;10,0;;1,0;4,0;23,0;8,0;1,0;;;;1,0;;;1,0;;;13,0;;1,0;6,0;4,0;1,0;1,0;7,0;4,0;1,0;6,0;14,0;11,0;1,0;;1,0;;;8,0;29,0;1,0;8,0;3,0;13,0;;2,0;;1,0;10,0;;6,0;5,0;;13,0;18,0;4,0;14,0;;;;4,0;6,0;7,0;;;6,0;6,0;;2,0;1,0;;7,0;;1,0;6,0;9,0;15,0;2,0;;13,0;2,0;;;;24,0;1,0;2,0;1,0;;3,0;;;;7,0;1,0;2,0;11,0;6,0;1,0;2,0;1,0;1,0;;1,0;;;;;2,0;2,0;10,0;;1,0;4,0;;;3,0;5,0;1,0;;8,0;;5,0;1,0;;1,0;1,0;6,0;4,0;;3,0;3,0;;;;;;;;;;2,0;;1,0;9,0;;1,0;;;;;;;1,0;3,0;;6,0;;;1,0;3,0;;;;1,0;;2,0;;2,0;2,0;;;;;;1,0;;4,0;9,0;1,0;;9,0;;;;3,0;13,0;;;;1,0;;10,0;;14,0;;3,0;1,0;1,0;;;1,0;;4,0;2,0;1,0;2,0;3,0;;;3,0;1,0;;2,0;8,0;;2,0;1,0;5,0;2,0;2,0;;;;3,0;3,0;1,0;1,0;1,0;;;;1,0;;;14,0;;16,0;9,0;;;1,0;;;;1,0;1,0;7,0;;;;4,0;1,0;5,0;;3,0;4,0;7,0;5,0;;;;;;11,0;;;;;13,0;6,0;5,0;14,0;1,0;1,0;;;1,0;;17,0;16,0;;;;1,0;;;8,0;1,0;;5,0;1,0;;4,0;21,0;;2,0;;2,0;2,0;;;;1,0;;1,0;1,0;6,0;;1,0;5,0;;1,0;1,0;8,0;;1,0;1,0;;4,0;;;12,0;1,0;8,0;4,0;2,0;;;;;1,0;11,0;;;;;4,0;1,0;5,0;;2,0;;1,0;;4,0;;5,0;1,0;;6,0;;4,0;;2,0;4,0;;;;2,0;5,0;;;1,0;;3,0;11,0;;;;;;;;;;1,0;6,0;5,0;;2,0;;;4,0;;7,0;;8,0;;;;;;9,0;1,0;;;;;;;;;;;1,0;1,0;6,0;;;;2,0;;;3,0;5,0;1,0;;8,0;;;;2,0;;;1,0;;1,0;2,0;1,0;;;;;;;2,0;;;;;2,0;;;;;1,0;1,0;;;;;;;;;;;2,0;;;3,0;;;;1,0;;;;;1,0;;;;;;;;;;10,0;;;;;;1,0;;;;;;;
opposite;;3,0;3,0;;17,0;14,0;17,0;23,0;;;8,0;;;;7,0;;;;7,0;;;5,0;;1,0;;;5,0;2,0;1,0;3,0;2,0;;35,0;1,0;11,0;;5,0;321,0;19,0;41,0;8,0;;7,0;47,0;;;;6,0;8,0;3,0;1,0;2,0;2,0;5,0;;65,0;31,0;2,0;7,0;131,0;;;19,0;;;5,0;9,0;;;1,0;26,0;7,0;13,0;;3,0;;2,0;14,0;44,0;1,0;;3,0;2,0;1,0;;6,0;24,0;3,0;1,0;3,0;41,0;9,0;1,0;4,0;;12,0;;;3,0;39,0;285,0;1,0;;3,0;;;40,0;34,0;4,0;;4,0;44,0;5,0;11,0;38,0;1,0;3,0;;11,0;31,0;;;;6,0;1,0;;10,0;35,0;;12,0;21,0;1,0;;8,0;;12,0;79,0;2,0;54,0;3,0;;;4,0;67,0;9,0;4,0;71,0;28,0;4,0;;12,0;9,0;18,0;;3,0;30,0;19,0;24,0;1,0;27,0;2,0;;19,0;5,0;;22,0;;17,0;;2,0;91,0;13,0;36,0;53,0;8,0;34,0;14,0;2,0;1,0;6,0;22,0;2,0;;;31,0;8,0;23,0;13,0;1,0;140,0;3,0;3,0;4,0;17,0;1,0;7,0;;;13,0;6,0;11,0;9,0;7,0;367,0;;;13,0;4,0;10,0;59,0;;5,0;;1,0;5,0;5,0;;23,0;6,0;2,0;6,0;3,0;;;42,0;;15,0;;;4,0;;;3,0;21,0;6,0;12,0;4,0;13,0;19,0;1,0;19,0;2,0;8,0;17,0;;11,0;3,0;2,0;15,0;31,0;1,0;;1,0;42,0;;;3,0;23,0;2,0;;;16,0;22,0;14,0;10,0;2,0;41,0;2,0;6,0;10,0;2,0;20,0;;;6,0;;2,0;3,0;5,0;43,0;2,0;50,0;;6,0;2,0;3,0;24,0;2,0;10,0;;1,0;4,0;;1,0;9,0;5,0;4,0;;4,0;21,0;5,0;7,0;10,0;11,0;3,0;6,0;2,0;;7,0;21,0;7,0;8,0;;;1,0;7,0;1,0;1,0;14,0;6,0;13,0;8,0;27,0;17,0;1,0;7,0;5,0;13,0;4,0;;;;5,0;;;5,0;;1,0;;4,0;1,0;4,0;;;1,0;1,0;1,0;;4,0;;;;2,0;1,0;;;;;;;2,0;;;;;2,0;;;;;;14,0;4,0;;1,0;3,0;;;4,0;6,0;;4,0;;;1,0;;;;;1,0;;;22,0;;18,0;2,0;;;;;;;;;2,0;1,0;6,0;2,0;;3,0;3,0;2,0;5,0;;;;;;3,0;1,0;1,0;;;;1,0;;;1,0;;;3,0;;;;;;;;;;2,0;;1,0;;;1,0;3,0;;1,0;;;;16,0;3,0;1,0;;;;;;;;;;4,0;1,0;17,0;3,0;;;;;6,0;;2,0;1,0;3,0;;;1,0;;;;;;19,0;9,0;;;;;;;;10,0;7,0;;4,0;;;;;;;6,0;7,0;;1,0;;4,0;9,0;;;4,0;;3,0;14,0;8,0;;;2,0;4,0;;1,0;;;;;;;;;5,0;;;;5,0;1,0;;;;;;2,0;;;7,0;;;4,0;;;2,0;;;6,0;;;;;15,0;7,0;;;;;7,0;;;;1,0;;;;88,0;;11,0;;1,0;;;;1,0;;;8,0;;;;;;;1,0;1,0;6,0;7,0;;;;4,0;;5,0;1,0;4,0;1,0;;;4,0;6,0;3,0;;2,0;4,0;;;;1,0;;;;5,0;2,0;;1,0;1,0;;1,0;4,0;1,0;;;8,0;;1,0;;9,0;7,0;2,0;3,0;5,0;2,0;;2,0;;;;;;;1,0;;9,0;;4,0;12,0;9,0;5,0;2,0;3,0;2,0;2,0;;;;2,0;;4,0;3,0;7,0;8,0;;;;2,0;2,0;;4,0;1,0;;;2,0;8,0;;;;1,0;43,0;;1,0;4,0;;7,0;;;;8,0;4,0;2,0;1,0;;;;5,0;;;1,0;;;;1,0;1,0;;;;;;19,0;5,0;;;;;;;;;;;;2,0;;;;;;;3,0;;;;;;;;;;;;;;;;;1,0;;;;;;1,0;2,0;;;;;;;;;1,0;;2,0;5,0;;;2,0;;1,0;1,0;;;;;;;;1,0;;2,0;;;;;;2,0;;;2,0;;1,0;;;;2,0;;;;;;;;;;2,0;2,0;;;;2,0;1,0;;;;;;;;;1,0;;4,0;;;7,0;;;;;1,0;6,0;;;1,0;1,0;1,0;3,0;7,0;;;2,0;2,0;;;;;;;1,0;1,0;1,0;6,0;;;2,0;;;;2,0;;;;1,0;;;4,0;;4,0;;2,0;;2,0;4,0;1,0;;3,0;1,0;7,0;;;;;;;;;1,0;;;;;;2,0;;;;;;;;4,0;;2,0;;;;;3,0;;;;;2,0;1,0;;;;;;;;;;;;;;;;20,0;1,0;;;;;;;;5,0;;;2,0;;;6,0;;5,0;;3,0;4,0;1,0;4,0;;;;;;;1,0;;1,0;;;3,0;;25,0;3,0;;2,0;;;;;;1,0;;;1,0;;;;;;;;;1,0;;;;
outer;;2,0;;;9,0;;53,0;59,0;;4,0;29,0;;11,0;;3,0;;;;4,0;;;2,0;;1,0;;;;;;2,0;;;44,0;3,0;7,0;;;47,0;;61,0;6,0;;11,0;102,0;;;4,0;;12,0;2,0;7,0;5,0;;3,0;7,0;35,0;91,0;;5,0;293,0;1,0;;5,0;;;5,0;1,0;;;2,0;59,0;;6,0;159,0;135,0;;4,0;6,0;71,0;;4,0;2,0;;;;3,0;26,0;2,0;;;19,0;1,0;2,0;1,0;4,0;20,0;1,0;1,0;;25,0;660,0;28,0;;;;;;86,0;;4,0;3,0;33,0;;36,0;93,0;1,0;9,0;;9,0;75,0;;4,0;;16,0;;;22,0;45,0;;24,0;110,0;3,0;1,0;131,0;;;83,0;1,0;42,0;3,0;;;19,0;57,0;6,0;5,0;147,0;86,0;;4,0;;60,0;23,0;2,0;12,0;36,0;43,0;75,0;;16,0;2,0;1,0;302,0;21,0;;8,0;3,0;22,0;;14,0;120,0;;62,0;104,0;3,0;54,0;;;7,0;;2,0;3,0;4,0;;23,0;7,0;36,0;79,0;1,0;346,0;4,0;13,0;;24,0;6,0;4,0;;2,0;9,0;20,0;2,0;15,0;;89,0;18,0;1,0;;12,0;21,0;91,0;;5,0;;2,0;1,0;1,0;5,0;30,0;;58,0;23,0;7,0;;2,0;98,0;1,0;24,0;;1,0;10,0;;;4,0;8,0;4,0;1,0;112,0;3,0;45,0;1,0;202,0;5,0;;16,0;2,0;63,0;;12,0;62,0;19,0;;;20,0;63,0;;;51,0;43,0;;54,0;;10,0;34,0;28,0;46,0;10,0;64,0;16,0;19,0;9,0;3,0;28,0;;1,0;7,0;;;4,0;;31,0;11,0;23,0;;20,0;2,0;1,0;8,0;5,0;2,0;14,0;;;1,0;9,0;6,0;12,0;1,0;1,0;6,0;21,0;3,0;1,0;7,0;27,0;10,0;14,0;4,0;3,0;6,0;21,0;;;6,0;1,0;164,0;;10,0;23,0;24,0;23,0;4,0;7,0;20,0;16,0;5,0;5,0;2,0;28,0;;;2,0;;7,0;;;;;;;;2,0;;;;;1,0;;1,0;3,0;;11,0;;;2,0;;;;;2,0;;;;;6,0;;;;;1,0;;;1,0;;;;;;;;15,0;;;;;;;;1,0;;;;;1,0;2,0;;;;1,0;;;;;;;;;;1,0;2,0;2,0;2,0;3,0;;1,0;1,0;1,0;2,0;;6,0;2,0;2,0;;;5,0;1,0;5,0;;;;;;;1,0;;;1,0;;1,0;;1,0;4,0;;;;;2,0;1,0;;;1,0;;;1,0;;3,0;;;;;;;;;1,0;2,0;6,0;17,0;;;;3,0;3,0;;;4,0;;8,0;;;;;;;;;26,0;;;;;;13,0;;2,0;;;;;;;;;;;10,0;5,0;;3,0;3,0;17,0;10,0;;;1,0;1,0;8,0;4,0;;;;1,0;6,0;;;;;1,0;;;4,0;;;19,0;1,0;;;7,0;;;;;;;14,0;4,0;;;4,0;;;1,0;4,0;2,0;;1,0;1,0;1,0;;1,0;1,0;5,0;;1,0;;1,0;;15,0;;;;2,0;;;;30,0;;12,0;;2,0;;;;1,0;;;10,0;98,0;;;;1,0;3,0;;;1,0;;2,0;;1,0;;5,0;;;3,0;;;1,0;8,0;;2,0;;12,0;7,0;;;;;;;;;;;11,0;;1,0;;;;;;10,0;12,0;7,0;;7,0;1,0;;11,0;;8,0;1,0;3,0;18,0;4,0;;;;15,0;1,0;;5,0;5,0;;40,0;1,0;;;;1,0;;;;19,0;;1,0;;20,0;6,0;5,0;;;1,0;;3,0;;1,0;1,0;;;;;;;;;;;;;;;;;;;;5,0;;;5,0;;;;;129,0;;;;;;4,0;;;;;;;;7,0;7,0;;11,0;;;2,0;;;3,0;;1,0;;;5,0;;;1,0;;;1,0;;;;;1,0;;;;4,0;;;;;;;;;;9,0;;;;;;;;6,0;;;;;;;;;3,0;;;1,0;;;;;;;1,0;;;;;;;;;1,0;;;2,0;;2,0;;;;;;;;;4,0;;;;;;10,0;;;;2,0;;4,0;;1,0;;;;;;;;4,0;;;5,0;;;;3,0;;;;;20,0;;;;;;;9,0;6,0;;;;;;1,0;;7,0;;3,0;;;3,0;;;;1,0;;1,0;;;;;8,0;1,0;;;;;;;1,0;4,0;5,0;;2,0;;;;;;;;;;;;;;;3,0;;;1,0;;1,0;;;;3,0;;;;;;;;;;;1,0;;;;1,0;1,0;;;;;;;;;;;1,0;1,0;1,0;;;;;;;;3,0;;1,0;1,0;;1,0;2,0;4,0;;;;;;;;;1,0;;;;;;;;;;;5,0;2,0;;;;;;;;2,0;;;3,0;;;;;;;;;;;;;
output;;3,0;33,0;8,0;211,0;;18,0;410,0;121,0;191,0;7,0;52,0;;67,0;212,0;5,0;9,0;;52,0;9,0;43,0;498,0;37,0;97,0;63,0;1,0;6,0;1230,0;4,0;140,0;413,0;235,0;681,0;85,0;349,0;6,0;11,0;110,0;2,0;421,0;45,0;3,0;88,0;160,0;19,0;8,0;13,0;32,0;371,0;36,0;55,0;421,0;20,0;10,0;;3279,0;206,0;22,0;32,0;164,0;2,0;10,0;386,0;11,0;4,0;80,0;27,0;;3,0;153,0;126,0;22,0;94,0;;;37,0;;42,0;173,0;33,0;3,0;337,0;84,0;129,0;1,0;;35,0;5,0;54,0;388,0;686,0;24,0;56,0;2350,0;97,0;39,0;5,0;52,0;128,0;21,0;38,0;182,0;;62,0;4,0;12,0;2,0;832,0;19,0;1,0;58,0;38,0;115,0;7,0;13,0;22,0;3,0;8,0;13,0;17,0;;;29,0;384,0;;8,0;196,0;3,0;3,0;45,0;2,0;9,0;1,0;;6,0;42,0;35,0;;10,0;11,0;7,0;1,0;46,0;10,0;54,0;7,0;107,0;188,0;2,0;1,0;5,0;1,0;1,0;;36,0;;2,0;10,0;21,0;455,0;25,0;12,0;1,0;6,0;1,0;8,0;113,0;239,0;21,0;7,0;77,0;15,0;89,0;14,0;93,0;5,0;;;2,0;;3,0;1,0;11,0;13,0;;26,0;2,0;433,0;;116,0;;;9,0;155,0;;12,0;;;44,0;;17,0;5,0;;132,0;;7,0;84,0;2,0;67,0;;12,0;8,0;12,0;6,0;10,0;189,0;67,0;2,0;4,0;;6,0;11,0;52,0;3,0;1,0;11,0;2,0;;3,0;;1,0;;44,0;7,0;63,0;11,0;;35,0;114,0;7,0;5,0;1,0;18,0;5,0;7,0;13,0;10,0;8,0;1,0;;55,0;13,0;;184,0;8,0;2,0;2,0;13,0;17,0;;12,0;35,0;6,0;1,0;2,0;;14,0;;;;;3,0;;17,0;3,0;50,0;30,0;;28,0;23,0;;;;13,0;;72,0;12,0;132,0;20,0;2,0;2,0;;8,0;43,0;1,0;14,0;40,0;56,0;;1,0;7,0;;235,0;8,0;8,0;;;85,0;2,0;;102,0;46,0;;;2,0;;1,0;41,0;7,0;;;55,0;39,0;;1,0;55,0;;;41,0;;94,0;16,0;3,0;1,0;7,0;14,0;1,0;2,0;14,0;31,0;4,0;32,0;;37,0;44,0;54,0;28,0;19,0;1,0;54,0;5,0;77,0;10,0;29,0;;12,0;10,0;6,0;;1,0;52,0;8,0;2,0;;28,0;44,0;;26,0;34,0;2,0;44,0;;8,0;45,0;27,0;92,0;25,0;17,0;;20,0;39,0;134,0;;5,0;48,0;8,0;12,0;39,0;1,0;81,0;3,0;68,0;5,0;2,0;17,0;9,0;50,0;75,0;40,0;8,0;32,0;;14,0;3,0;6,0;21,0;4,0;59,0;;11,0;4,0;21,0;5,0;69,0;2,0;14,0;20,0;1,0;303,0;2,0;18,0;15,0;23,0;10,0;192,0;2,0;9,0;76,0;25,0;68,0;40,0;6,0;23,0;;7,0;4,0;98,0;6,0;83,0;13,0;12,0;8,0;2,0;22,0;1,0;95,0;134,0;103,0;21,0;24,0;;30,0;51,0;30,0;;55,0;10,0;;55,0;1,0;28,0;3,0;2,0;20,0;6,0;31,0;2,0;;42,0;7,0;3,0;92,0;1,0;;27,0;5,0;107,0;;1,0;17,0;76,0;3,0;16,0;8,0;;16,0;233,0;28,0;45,0;43,0;34,0;105,0;22,0;15,0;366,0;71,0;3,0;227,0;1,0;4,0;11,0;78,0;;13,0;8,0;;8,0;;4,0;1,0;;;;12,0;35,0;33,0;19,0;3,0;;;;;13,0;41,0;1,0;21,0;19,0;;4,0;1,0;1,0;1,0;6,0;10,0;18,0;57,0;;1,0;1,0;;1,0;34,0;1,0;;;;3,0;2,0;14,0;3,0;4,0;1,0;;22,0;13,0;;42,0;8,0;;55,0;1001,0;47,0;40,0;;;1,0;21,0;2,0;1,0;2,0;;10,0;5,0;;;20,0;1,0;1,0;;;;56,0;115,0;15,0;41,0;161,0;;5,0;17,0;12,0;4,0;;;2,0;19,0;78,0;;;;4,0;5,0;1,0;52,0;;11,0;1,0;2,0;9,0;;;;15,0;;;3,0;1,0;6,0;;1,0;11,0;20,0;;23,0;3,0;1,0;;;;21,0;;;6,0;1,0;53,0;2,0;;31,0;;;;;3,0;;;;8,0;14,0;;;11,0;30,0;9,0;1,0;;;;;11,0;15,0;;8,0;;4,0;;;9,0;15,0;;;;14,0;2,0;3,0;;39,0;4,0;6,0;9,0;11,0;;203,0;46,0;59,0;18,0;5,0;30,0;9,0;12,0;35,0;27,0;2,0;106,0;8,0;2,0;10,0;24,0;19,0;41,0;55,0;19,0;15,0;21,0;22,0;17,0;37,0;1,0;;2,0;5,0;61,0;17,0;5,0;1,0;44,0;13,0;4,0;59,0;3,0;2,0;;2,0;5,0;2,0;22,0;5,0;2,0;10,0;4,0;;11,0;3,0;55,0;38,0;6,0;4,0;2,0;8,0;3,0;4,0;;26,0;19,0;17,0;29,0;3,0;11,0;8,0;53,0;18,0;;3,0;17,0;11,0;12,0;;17,0;4,0;26,0;6,0;10,0;1,0;2,0;3,0;4,0;42,0;;;79,0;8,0;2,0;58,0;4,0;2,0;8,0;;7,0;28,0;20,0;4,0;2,0;24,0;2,0;1,0;4,0;8,0;3,0;12,0;4,0;34,0;;15,0;;4,0;5,0;6,0;6,0;5,0;1,0;5,0;1,0;1,0;6,0;3,0;;1,0;9,0;5,0;5,0;29,0;6,0;3,0;1,0;4,0;33,0;;;10,0;31,0;4,0;7,0;53,0;14,0;10,0;1,0;11,0;2,0;;;26,0;5,0;3,0;21,0;11,0;1,0;;;6,0;11,0;6,0;30,0;1,0;2,0;7,0;8,0;16,0;2,0;;20,0;1,0;4,0;;1,0;1,0;6,0;2,0;2,0;8,0;;15,0;;35,0;25,0;;5,0;2,0;1,0;2,0;;28,0;;2,0;3,0;46,0;;;;17,0;4,0;1,0;;1,0;;;8,0;;4,0;;;;;;3,0;;121,0;18,0;7,0;40,0;;7,0;4,0;40,0;;;;;;;5,0;5,0;4,0;;5,0;2,0;1,0;47,0;13,0;;;;;28,0;10,0;;2,0;5,0;2,0;4,0;9,0;31,0;;25,0;26,0;2,0;;;2,0;14,0;;;1,0;;;6,0;8,0;1,0;1,0;1,0;3,0;;;;;2,0;17,0;;;;;;;1,0;3,0;9,0;;;;;;;6,0;;17,0;;;;;;;6,0;;;;;;2,0;7,0;;;;;5,0;2,0;5,0;;;1,0;;;;
panel;;10,0;1,0;;53,0;;5,0;21,0;;2,0;2,0;;;;5,0;3,0;;;20,0;1,0;5,0;40,0;2,0;;;;;3,0;6,0;6,0;8,0;;37,0;;20,0;;;8,0;;313,0;;;11,0;9,0;;;;;5,0;;3,0;2,0;;;1,0;73,0;86,0;;;26,0;;;8,0;2,0;;9,0;6,0;;;13,0;9,0;1,0;;;;3,0;;2,0;63,0;7,0;4,0;;2,0;;;4,0;7,0;1,0;2,0;5,0;25,0;2,0;2,0;11,0;3,0;7,0;;5,0;2,0;7,0;81,0;13,0;9,0;;;;;105,0;;1,0;4,0;10,0;6,0;22,0;14,0;;;;8,0;48,0;;;;27,0;;;21,0;16,0;;6,0;30,0;3,0;88,0;;1,0;1,0;32,0;;;2,0;2,0;1,0;9,0;6,0;2,0;5,0;26,0;21,0;;;;1,0;;;3,0;1,0;8,0;31,0;2,0;9,0;6,0;4,0;3,0;1,0;8,0;5,0;2,0;35,0;;7,0;29,0;;27,0;62,0;4,0;28,0;2,0;3,0;1,0;;;3,0;6,0;2,0;4,0;5,0;13,0;27,0;;74,0;1,0;2,0;1,0;15,0;;;;;2,0;7,0;;3,0;7,0;78,0;;5,0;8,0;;10,0;29,0;;1,0;;1,0;1,0;2,0;;50,0;;3,0;42,0;20,0;1,0;;14,0;;8,0;;;;6,0;;17,0;5,0;1,0;4,0;;;11,0;;;1,0;;39,0;2,0;15,0;;;;;3,0;;;27,0;2,0;5,0;;17,0;;;;2,0;25,0;12,0;4,0;9,0;18,0;3,0;;10,0;5,0;56,0;;2,0;1,0;2,0;;;;14,0;;;2,0;;3,0;15,0;5,0;12,0;7,0;22,0;;;4,0;;;6,0;;7,0;34,0;1,0;4,0;9,0;12,0;2,0;14,0;6,0;;;20,0;24,0;25,0;2,0;;;;;3,0;;2,0;;;1,0;2,0;31,0;;10,0;;4,0;5,0;;5,0;1,0;;;;;1,0;;;;2,0;6,0;4,0;;;;;;;;6,0;2,0;;;;;;;;;;;;;;5,0;;;5,0;;;2,0;;;;;4,0;;;12,0;;;3,0;;;8,0;1,0;1,0;;10,0;2,0;3,0;;2,0;15,0;;1,0;;1,0;;;;1,0;;;;1,0;1,0;;;;3,0;;;;;;;11,0;;3,0;;;;7,0;;;;;;;;6,0;;;;;;;7,0;6,0;1,0;4,0;1,0;;16,0;;;1,0;;;4,0;5,0;2,0;;;;;;;;;;;4,0;7,0;16,0;;;;;;;1,0;8,0;;;;;;;;;;;4,0;20,0;;;;10,0;14,0;;;5,0;24,0;1,0;1,0;;;5,0;;;;13,0;2,0;;;;5,0;;;;;3,0;2,0;;;;;1,0;;;;;;10,0;;2,0;;;;9,0;;;;;;;2,0;5,0;;2,0;3,0;6,0;2,0;1,0;1,0;;2,0;2,0;;3,0;;4,0;;4,0;1,0;5,0;;4,0;;;;;;14,0;4,0;;;;1,0;2,0;;5,0;;;;;;2,0;4,0;4,0;;;8,0;;;;;4,0;;;;;;2,0;3,0;;;;;;1,0;;;2,0;8,0;;3,0;;;1,0;;;;1,0;;;;;5,0;;1,0;;;2,0;3,0;;;;2,0;7,0;3,0;;;;;5,0;4,0;;;;;;;;;;9,0;;2,0;;10,0;;;9,0;1,0;;;2,0;;;;;;;;;1,0;;;;2,0;;;;;;;;;;4,0;;3,0;;;;;;2,0;1,0;;;;;;;;;;;1,0;4,0;;;;;;;1,0;;3,0;;;;1,0;;3,0;87,0;13,0;;;;;1,0;;;;;;;;;1,0;1,0;;;;;;;;;;;1,0;;;;2,0;;;;1,0;;;;;2,0;;;;;;2,0;;1,0;;;;7,0;;;;;2,0;;;;;;;;;1,0;1,0;;;2,0;;;;;1,0;;24,0;;;;;;;1,0;;;;3,0;;;;2,0;;;;3,0;;;;;;2,0;1,0;;2,0;;;18,0;2,0;20,0;8,0;1,0;1,0;21,0;4,0;;;2,0;2,0;1,0;;3,0;;1,0;;;;;;1,0;;;;;;4,0;;2,0;1,0;;2,0;7,0;;;;96,0;4,0;;3,0;;;3,0;;;1,0;;;;;;;;;2,0;;;;;;;;;;;;;;;;;2,0;;;;;;2,0;;;1,0;;;;;;;;;;1,0;;;;;;;;;;;;;;;;;;;;;;;1,0;;;;5,0;;;;;;;;;;;;;;;;;4,0;;;;;;;;2,0;2,0;;;;;;;;5,0;;;;;;;;;;;;;;;;;;
pattern;;2,0;;17,0;25,0;;5,0;36,0;17,0;66,0;9,0;24,0;4,0;1,0;73,0;3,0;1,0;5,0;25,0;8,0;4,0;38,0;25,0;4,0;;3,0;1,0;33,0;1,0;65,0;20,0;51,0;70,0;3,0;24,0;21,0;5,0;24,0;16,0;60,0;13,0;11,0;6,0;19,0;;1,0;;;;16,0;6,0;38,0;1,0;21,0;4,0;378,0;88,0;2,0;9,0;16,0;;;120,0;;3,0;;14,0;;1,0;14,0;16,0;1,0;2,0;7,0;;11,0;;47,0;66,0;;7,0;32,0;15,0;12,0;;3,0;28,0;;3,0;58,0;22,0;6,0;1,0;34,0;2,0;2,0;1,0;7,0;24,0;36,0;52,0;72,0;6,0;4,0;2,0;;6,0;52,0;;;3,0;64,0;26,0;;3,0;4,0;;;24,0;16,0;3,0;1,0;6,0;51,0;;1,0;23,0;15,0;12,0;13,0;14,0;13,0;;;6,0;7,0;18,0;;13,0;7,0;1,0;;1,0;15,0;49,0;;130,0;61,0;3,0;;4,0;3,0;2,0;;1,0;1,0;7,0;1,0;48,0;19,0;;1,0;5,0;1,0;;31,0;11,0;44,0;6,0;27,0;;;23,0;8,0;2,0;3,0;9,0;43,0;2,0;;;1,0;3,0;;;32,0;16,0;111,0;1,0;39,0;2,0;3,0;6,0;9,0;2,0;5,0;;;6,0;;2,0;35,0;1,0;5,0;;20,0;1,0;;6,0;;52,0;4,0;27,0;6,0;3,0;8,0;4,0;1,0;;1,0;10,0;1,0;16,0;3,0;;1,0;5,0;;;1,0;;;3,0;2,0;4,0;11,0;;8,0;61,0;2,0;;;1,0;1,0;;3,0;;5,0;;;4,0;;10,0;26,0;7,0;1,0;;33,0;5,0;1,0;3,0;1,0;9,0;;;;4,0;;;4,0;5,0;1,0;12,0;;;3,0;;;;6,0;;;;;;38,0;;73,0;;1,0;;1,0;8,0;;;4,0;4,0;29,0;1,0;;;;105,0;58,0;8,0;1,0;;5,0;;4,0;52,0;16,0;;;;;;;;;;4,0;;;;16,0;;;;;16,0;;;;;;13,0;;1,0;10,0;4,0;9,0;1,0;6,0;2,0;5,0;;8,0;;22,0;;15,0;7,0;;;1,0;2,0;;;4,0;7,0;1,0;;21,0;29,0;13,0;3,0;1,0;2,0;;;;;3,0;16,0;22,0;7,0;36,0;;7,0;2,0;1,0;3,0;6,0;7,0;;1,0;4,0;5,0;21,0;;7,0;1,0;2,0;8,0;9,0;1,0;153,0;;14,0;6,0;;11,0;1,0;;;1,0;1,0;3,0;;;1,0;;;;;16,0;;19,0;34,0;15,0;1,0;1,0;1,0;20,0;;1,0;7,0;6,0;6,0;30,0;24,0;;;;;;;;;;6,0;;;4,0;4,0;5,0;4,0;;9,0;;9,0;25,0;1,0;;;;;2,0;;5,0;;;;;;;;15,0;;26,0;20,0;;11,0;;5,0;32,0;;43,0;45,0;1,0;1,0;;;;2,0;10,0;2,0;;9,0;4,0;10,0;1,0;1,0;20,0;22,0;;2,0;1,0;;1,0;4,0;7,0;21,0;19,0;;9,0;;2,0;;;;;29,0;2,0;21,0;1,0;;;;;;16,0;;;;7,0;;1,0;;;;12,0;1,0;;11,0;;4,0;;;;;;3,0;;4,0;;5,0;;1,0;26,0;5,0;6,0;16,0;;;2,0;2,0;1,0;6,0;67,0;;1,0;;;;6,0;;;;;;3,0;;;1,0;;1,0;2,0;3,0;7,0;1,0;8,0;;;16,0;;;;4,0;;3,0;;4,0;11,0;;;;19,0;1,0;;;12,0;;;;;;;;;1,0;;;;;2,0;;;;;;2,0;1,0;;;;;;;;5,0;;;1,0;;1,0;;;;;;;;1,0;3,0;;1,0;7,0;;9,0;26,0;;;;;;1,0;7,0;1,0;2,0;;;1,0;;10,0;;;;3,0;;;;;6,0;2,0;;;;1,0;1,0;2,0;3,0;5,0;102,0;;;4,0;;;;;1,0;;1,0;;2,0;2,0;;5,0;7,0;4,0;;;;7,0;3,0;1,0;5,0;8,0;;1,0;28,0;14,0;;;;;;;;5,0;;;;;;;;18,0;2,0;5,0;15,0;7,0;1,0;1,0;;;;;22,0;2,0;;10,0;2,0;2,0;3,0;;1,0;;;;;2,0;1,0;6,0;1,0;;10,0;4,0;;1,0;6,0;;2,0;6,0;1,0;8,0;1,0;2,0;2,0;;4,0;;41,0;5,0;15,0;;;3,0;;;;2,0;2,0;13,0;1,0;;;;;;;20,0;;1,0;3,0;;;;1,0;1,0;;;;;;;2,0;;;;;5,0;;;;;4,0;;;;3,0;;;;;2,0;22,0;;6,0;7,0;;;;;;;2,0;;;;6,0;;;;;1,0;;;;4,0;;2,0;;;;5,0;;4,0;;3,0;;;;;;7,0;;;1,0;;3,0;;;;9,0;3,0;;;2,0;;;;;;;;;;;;;;1,0;13,0;;;;;3,0;1,0;;;;;;1,0;5,0;2,0;3,0;;;;;;;;;;4,0;10,0;;;;;;;;;;;;1,0;2,0;1,0;7,0;;;;;;4,0;;;;;5,0;;;4,0;3,0;;2,0;;5,0;11,0;;;;;;2,0;;;;;20,0;;;;;;8,0;;;;2,0;1,0;;;4,0;;9,0;;;;1,0;;;;8,0;;;;;;;;
perform;;19,0;74,0;30,0;130,0;;26,0;144,0;27,0;120,0;11,0;26,0;4,0;3,0;103,0;5,0;6,0;16,0;56,0;111,0;16,0;655,0;34,0;45,0;288,0;12,0;11,0;270,0;14,0;94,0;180,0;115,0;390,0;15,0;114,0;15,0;15,0;62,0;4,0;135,0;24,0;19,0;43,0;33,0;33,0;8,0;4,0;23,0;254,0;8,0;164,0;103,0;3,0;17,0;;1334,0;102,0;56,0;14,0;136,0;7,0;24,0;503,0;6,0;18,0;18,0;76,0;3,0;6,0;576,0;78,0;21,0;21,0;;;21,0;1,0;48,0;123,0;42,0;3,0;806,0;219,0;8,0;3,0;;67,0;8,0;8,0;87,0;69,0;17,0;80,0;392,0;20,0;6,0;1,0;22,0;83,0;8,0;14,0;214,0;5,0;21,0;10,0;8,0;6,0;513,0;4,0;;30,0;20,0;19,0;7,0;4,0;53,0;4,0;1,0;2,0;30,0;3,0;;15,0;99,0;;5,0;177,0;3,0;10,0;16,0;11,0;8,0;3,0;;3,0;8,0;7,0;;4,0;4,0;2,0;3,0;20,0;96,0;69,0;2,0;9,0;87,0;20,0;;4,0;;;1,0;6,0;2,0;2,0;6,0;14,0;189,0;5,0;16,0;2,0;;2,0;2,0;14,0;122,0;2,0;2,0;19,0;10,0;45,0;19,0;28,0;11,0;3,0;92,0;1,0;;;1,0;19,0;6,0;2,0;19,0;10,0;108,0;1,0;75,0;;;7,0;49,0;;1,0;;;10,0;2,0;1,0;4,0;1,0;20,0;;6,0;9,0;;7,0;6,0;22,0;25,0;16,0;11,0;12,0;108,0;9,0;;2,0;;1,0;7,0;5,0;10,0;;4,0;5,0;;1,0;;;3,0;4,0;3,0;68,0;11,0;1,0;14,0;102,0;44,0;7,0;;41,0;;1,0;11,0;1,0;9,0;;3,0;20,0;214,0;1,0;11,0;3,0;10,0;;25,0;8,0;;22,0;50,0;30,0;2,0;3,0;2,0;4,0;;2,0;1,0;;9,0;1,0;7,0;;6,0;24,0;1,0;6,0;3,0;;;9,0;25,0;2,0;137,0;19,0;132,0;19,0;;4,0;2,0;26,0;20,0;;;28,0;110,0;;;20,0;;121,0;3,0;8,0;1,0;;46,0;3,0;2,0;44,0;15,0;4,0;2,0;6,0;;2,0;;;1,0;;14,0;1,0;3,0;;24,0;;;24,0;2,0;56,0;18,0;1,0;;;;10,0;9,0;11,0;;;20,0;13,0;39,0;97,0;4,0;56,0;3,0;1,0;34,0;10,0;38,0;32,0;;2,0;4,0;;1,0;1,0;;6,0;5,0;7,0;12,0;18,0;22,0;4,0;4,0;1,0;5,0;8,0;;;10,0;47,0;35,0;23,0;22,0;;22,0;38,0;40,0;1,0;97,0;6,0;1,0;12,0;3,0;11,0;66,0;25,0;42,0;1,0;9,0;67,0;23,0;35,0;35,0;18,0;2,0;39,0;1,0;6,0;2,0;7,0;;13,0;91,0;45,0;12,0;3,0;29,0;2,0;14,0;3,0;10,0;17,0;;57,0;14,0;16,0;13,0;1,0;27,0;134,0;18,0;35,0;33,0;35,0;17,0;5,0;30,0;;2,0;1,0;3,0;15,0;1,0;7,0;26,0;12,0;3,0;3,0;6,0;1,0;61,0;177,0;28,0;10,0;3,0;3,0;101,0;38,0;36,0;;5,0;10,0;17,0;100,0;5,0;15,0;5,0;16,0;6,0;1,0;61,0;7,0;17,0;39,0;;;;3,0;3,0;;3,0;35,0;12,0;55,0;21,0;6,0;3,0;2,0;6,0;;23,0;17,0;18,0;1,0;46,0;7,0;108,0;29,0;17,0;64,0;37,0;5,0;4,0;7,0;;3,0;4,0;8,0;1,0;22,0;2,0;;5,0;3,0;;;14,0;3,0;50,0;133,0;6,0;2,0;;5,0;8,0;;;9,0;19,0;7,0;111,0;9,0;;1,0;9,0;11,0;12,0;1,0;;20,0;15,0;;5,0;6,0;1,0;;9,0;;3,0;;2,0;;15,0;4,0;1,0;41,0;8,0;;4,0;12,0;;16,0;4,0;;18,0;182,0;1,0;6,0;20,0;1,0;3,0;33,0;6,0;1,0;1,0;;3,0;17,0;26,0;;;1,0;12,0;1,0;2,0;6,0;4,0;33,0;3,0;10,0;39,0;;5,0;22,0;18,0;17,0;;2,0;2,0;1,0;15,0;;;;;6,0;;97,0;;5,0;1,0;6,0;9,0;;6,0;;3,0;;;3,0;1,0;8,0;;;9,0;14,0;2,0;5,0;8,0;1,0;;;1,0;20,0;1,0;;4,0;1,0;124,0;8,0;;8,0;2,0;1,0;;;10,0;;5,0;1,0;9,0;5,0;6,0;1,0;4,0;19,0;3,0;5,0;1,0;;;;;;1,0;1,0;;;4,0;;9,0;49,0;;;1,0;1,0;;2,0;;14,0;4,0;1,0;1,0;1,0;3,0;9,0;1,0;5,0;14,0;40,0;4,0;;29,0;34,0;;;25,0;;;3,0;;3,0;17,0;13,0;5,0;9,0;2,0;3,0;3,0;7,0;;2,0;;18,0;304,0;4,0;1,0;4,0;19,0;2,0;11,0;3,0;8,0;7,0;;3,0;3,0;;2,0;;;14,0;14,0;1,0;;14,0;16,0;11,0;23,0;2,0;5,0;2,0;7,0;9,0;;2,0;3,0;;25,0;12,0;86,0;5,0;33,0;7,0;12,0;;4,0;;8,0;18,0;28,0;33,0;12,0;7,0;2,0;17,0;16,0;6,0;2,0;43,0;1,0;2,0;6,0;1,0;3,0;43,0;1,0;;2,0;4,0;24,0;19,0;5,0;19,0;2,0;14,0;;7,0;2,0;1,0;;87,0;3,0;1,0;;4,0;4,0;2,0;13,0;7,0;5,0;8,0;1,0;13,0;3,0;21,0;14,0;2,0;3,0;4,0;8,0;;4,0;11,0;;1,0;12,0;1,0;19,0;;;5,0;;1,0;;10,0;;2,0;;;2,0;;;8,0;1,0;2,0;6,0;32,0;;;;;;2,0;1,0;;3,0;;3,0;21,0;1,0;;4,0;7,0;1,0;1,0;;2,0;19,0;4,0;1,0;9,0;;1,0;2,0;9,0;5,0;2,0;;9,0;;;;8,0;;1,0;2,0;6,0;;;5,0;8,0;;1,0;;10,0;;;1,0;;;;;3,0;;;2,0;7,0;12,0;;1,0;2,0;;3,0;11,0;18,0;2,0;;;;;;2,0;4,0;7,0;4,0;;;45,0;;4,0;2,0;;;;2,0;18,0;;1,0;5,0;4,0;4,0;;;;10,0;5,0;2,0;;5,0;26,0;10,0;;;10,0;;6,0;;13,0;4,0;5,0;4,0;2,0;1,0;;;;4,0;1,0;3,0;3,0;;;;;;1,0;1,0;;4,0;;;5,0;;7,0;;;1,0;;2,0;;2,0;1,0;3,0;;3,0;14,0;;;;;;1,0;2,0;1,0;9,0;1,0;;;3,0;;;1,0;;
period;;2,0;20,0;2,0;38,0;;;31,0;15,0;95,0;;4,0;;;;;;3,0;20,0;8,0;9,0;105,0;;6,0;;4,0;;94,0;;49,0;16,0;37,0;92,0;10,0;44,0;;;13,0;;78,0;17,0;;28,0;22,0;2,0;;;3,0;24,0;9,0;4,0;46,0;5,0;2,0;;296,0;52,0;;16,0;38,0;;2,0;71,0;;1,0;1,0;25,0;;18,0;89,0;8,0;5,0;;;;;;32,0;17,0;18,0;1,0;61,0;18,0;2,0;;;8,0;;14,0;28,0;34,0;4,0;1,0;198,0;2,0;;1,0;24,0;12,0;7,0;;29,0;2,0;32,0;1,0;4,0;;147,0;3,0;;;4,0;10,0;;;;2,0;;;;;;10,0;23,0;;1,0;30,0;;;1,0;1,0;1,0;;;;9,0;;;;8,0;1,0;1,0;;8,0;3,0;;5,0;156,0;;1,0;;;2,0;1,0;3,0;;;2,0;7,0;107,0;1,0;8,0;;;;5,0;14,0;80,0;;;;6,0;1,0;4,0;20,0;11,0;;39,0;;;;6,0;7,0;4,0;;;;55,0;;20,0;;;;30,0;;7,0;1,0;;2,0;;;;;23,0;;10,0;6,0;2,0;1,0;;1,0;;11,0;;;920,0;11,0;2,0;2,0;;;3,0;6,0;;;2,0;;;3,0;;;;;;18,0;4,0;;22,0;16,0;;2,0;;3,0;;;11,0;1,0;;;;22,0;4,0;;2,0;2,0;;;3,0;;;49,0;24,0;;;;;18,0;;;;;;1,0;6,0;;7,0;4,0;;4,0;4,0;;;1,0;11,0;;7,0;5,0;17,0;18,0;;;;38,0;2,0;;;13,0;12,0;;;3,0;;245,0;1,0;1,0;;;10,0;;;22,0;6,0;;;;;;;;;;3,0;;;;14,0;;;7,0;;16,0;10,0;;9,0;;10,0;4,0;1,0;1,0;;2,0;2,0;;13,0;3,0;21,0;9,0;8,0;;42,0;16,0;7,0;8,0;3,0;;;;;;;2,0;2,0;;6,0;13,0;13,0;2,0;;7,0;10,0;1,0;;1,0;18,0;20,0;17,0;23,0;4,0;;3,0;;9,0;2,0;2,0;33,0;;7,0;6,0;;44,0;6,0;9,0;1,0;;40,0;12,0;61,0;6,0;2,0;4,0;8,0;;3,0;10,0;;1,0;3,0;17,0;;12,0;;2,0;2,0;6,0;;23,0;1,0;;18,0;;7,0;;;;28,0;;8,0;51,0;;7,0;;1,0;;;;;27,0;;;4,0;4,0;3,0;;;1,0;3,0;11,0;4,0;9,0;2,0;1,0;9,0;28,0;37,0;;3,0;1,0;;11,0;;12,0;;;2,0;;5,0;;1,0;20,0;;;38,0;;;1,0;5,0;;;2,0;2,0;17,0;;1,0;1,0;;;4,0;6,0;;38,0;;31,0;3,0;8,0;101,0;5,0;;47,0;;7,0;;;1,0;1,0;7,0;;;;;;;;9,0;;2,0;;;;;1,0;;;;;;55,0;1,0;;;1,0;;;13,0;;2,0;2,0;;;;2,0;1,0;1,0;;;;;;1,0;;;5,0;;;2,0;1,0;;9,0;;1,0;13,0;75,0;;;;;;8,0;2,0;;;;;;1,0;;;;;;2,0;;7,0;11,0;6,0;12,0;3,0;;;;26,0;;;;;1,0;40,0;;;;;;2,0;211,0;;;;7,0;;;;;3,0;1,0;;3,0;;2,0;;;19,0;13,0;;5,0;2,0;;;;;10,0;;;;1,0;4,0;1,0;;;;;;10,0;5,0;;;;;;;;;1,0;1,0;;;;;;;2,0;;1,0;;;;;1,0;12,0;;;6,0;22,0;;1,0;;24,0;;;;7,0;1,0;;;2,0;6,0;;11,0;;3,0;23,0;1,0;1,0;;11,0;;3,0;1,0;9,0;92,0;6,0;20,0;17,0;;6,0;;1,0;;2,0;1,0;5,0;7,0;41,0;7,0;8,0;25,0;;;1,0;4,0;;;;1,0;6,0;;;1,0;;3,0;;;2,0;17,0;7,0;11,0;1,0;1,0;;;;1,0;;;10,0;8,0;2,0;7,0;1,0;19,0;;;;;;;;;1,0;;6,0;;;2,0;;;46,0;;;1,0;1,0;5,0;4,0;;5,0;;;2,0;8,0;2,0;4,0;1,0;;;;10,0;4,0;1,0;7,0;;;;24,0;;;;;1,0;5,0;;;;;;;;;2,0;;;4,0;;;9,0;1,0;;;;1,0;;3,0;;32,0;9,0;;;7,0;;;;;;;8,0;;;4,0;;2,0;3,0;;7,0;;2,0;2,0;;;4,0;3,0;4,0;;;;9,0;10,0;1,0;;;1,0;;11,0;1,0;11,0;6,0;8,0;;;;;;;;;;;2,0;;;2,0;;;;;;7,0;1,0;;;;;;;;;9,0;36,0;13,0;;3,0;;;3,0;3,0;;;;;;;;;;;;;11,0;;;;;;;2,0;;;;3,0;1,0;;;;;;;;;;;1,0;;;;;4,0;1,0;;2,0;;;;;;;;;3,0;;;;;;;;;;;;;;;;5,0;;;;;;;;;;;;;;;;;;5,0;;;;;;;;;;1,0;;
photograph;;15,0;41,0;2,0;84,0;;128,0;187,0;50,0;60,0;17,0;21,0;1,0;;9,0;1,0;4,0;6,0;24,0;4,0;92,0;307,0;;23,0;45,0;1,0;;210,0;6,0;121,0;41,0;103,0;287,0;4,0;176,0;;3,0;134,0;1,0;214,0;79,0;3,0;56,0;37,0;5,0;11,0;;46,0;55,0;7,0;45,0;79,0;7,0;36,0;;1323,0;246,0;;22,0;759,0;;19,0;154,0;2,0;;9,0;78,0;7,0;17,0;263,0;558,0;50,0;76,0;20,0;14,0;83,0;;35,0;308,0;2,0;3,0;56,0;56,0;4,0;8,0;2,0;38,0;;9,0;66,0;64,0;10,0;29,0;158,0;21,0;1,0;1,0;28,0;63,0;;43,0;545,0;;12,0;3,0;;2,0;442,0;;;7,0;28,0;1,0;15,0;66,0;9,0;16,0;;;48,0;;;42,0;7,0;;3,0;73,0;1,0;11,0;5,0;5,0;7,0;4,0;11,0;1,0;13,0;32,0;;;19,0;1,0;3,0;7,0;62,0;9,0;4,0;50,0;40,0;;6,0;1,0;5,0;21,0;;;;;21,0;16,0;66,0;6,0;2,0;;5,0;4,0;;8,0;194,0;2,0;5,0;74,0;40,0;52,0;25,0;16,0;12,0;1,0;56,0;;;7,0;;35,0;19,0;;22,0;8,0;150,0;;63,0;3,0;;2,0;41,0;6,0;29,0;;;4,0;5,0;1,0;8,0;6,0;21,0;;38,0;17,0;;1,0;18,0;3,0;1,0;;;;137,0;51,0;1,0;17,0;3,0;3,0;21,0;9,0;18,0;;1,0;9,0;;2,0;2,0;;2,0;4,0;11,0;52,0;47,0;;4,0;66,0;2,0;57,0;3,0;11,0;2,0;;27,0;;2,0;;;;10,0;;5,0;;2,0;;9,0;13,0;;13,0;38,0;1,0;;5,0;;23,0;;;7,0;;21,0;4,0;3,0;14,0;1,0;3,0;1,0;4,0;20,0;;;;45,0;;41,0;38,0;349,0;28,0;;4,0;11,0;2,0;29,0;;13,0;2,0;;1,0;1,0;23,0;;59,0;1,0;;6,0;;90,0;3,0;;44,0;9,0;36,0;11,0;;;4,0;;;1,0;;2,0;3,0;1,0;;26,0;;;2,0;;40,0;8,0;;;;1,0;4,0;;1,0;1,0;;10,0;;12,0;9,0;;20,0;18,0;2,0;77,0;21,0;29,0;7,0;;;4,0;1,0;6,0;;9,0;;3,0;2,0;;12,0;68,0;2,0;8,0;;;14,0;;3,0;42,0;9,0;24,0;;3,0;;2,0;12,0;107,0;1,0;9,0;6,0;10,0;3,0;4,0;;46,0;14,0;31,0;;;31,0;19,0;44,0;31,0;14,0;2,0;5,0;;9,0;;;18,0;3,0;39,0;1,0;2,0;4,0;12,0;;11,0;;8,0;3,0;;51,0;;69,0;1,0;;39,0;387,0;3,0;8,0;15,0;3,0;21,0;5,0;1,0;;;;1,0;;1,0;1,0;;45,0;;;;;30,0;2,0;9,0;9,0;5,0;;46,0;19,0;33,0;2,0;2,0;43,0;13,0;37,0;1,0;5,0;;4,0;6,0;2,0;31,0;44,0;11,0;42,0;;;110,0;;;;;10,0;2,0;25,0;11,0;24,0;;7,0;;4,0;48,0;31,0;11,0;8,0;65,0;26,0;111,0;5,0;3,0;33,0;38,0;36,0;1,0;;2,0;;22,0;;7,0;30,0;1,0;2,0;;;6,0;1,0;4,0;1,0;;37,0;2,0;1,0;4,0;;6,0;9,0;;6,0;9,0;;14,0;14,0;;3,0;6,0;5,0;;1,0;;2,0;2,0;8,0;;1,0;;;;;6,0;1,0;;;;;;7,0;;1,0;;2,0;1,0;;;9,0;38,0;5,0;;;14,0;;2,0;9,0;11,0;1,0;6,0;5,0;1,0;3,0;;;5,0;;;;;5,0;2,0;360,0;4,0;;32,0;;;;10,0;7,0;;;;;2,0;;;;5,0;;;111,0;2,0;;;4,0;16,0;;;;5,0;3,0;;;;4,0;4,0;2,0;11,0;2,0;;7,0;1,0;2,0;;;;29,0;;;1,0;1,0;23,0;29,0;1,0;28,0;;21,0;;;2,0;;;;1,0;2,0;6,0;;;19,0;3,0;;1,0;;;3,0;;2,0;;15,0;;;;;10,0;24,0;;;4,0;17,0;4,0;;2,0;2,0;9,0;6,0;;2,0;;;;3,0;23,0;2,0;1,0;;56,0;8,0;;1,0;10,0;8,0;1,0;2,0;3,0;;5,0;1,0;;5,0;;;4,0;3,0;;;;36,0;28,0;;3,0;2,0;4,0;;1,0;;4,0;2,0;1,0;15,0;;3,0;;;8,0;;6,0;;;29,0;;8,0;24,0;;9,0;3,0;;;;3,0;2,0;1,0;2,0;;1,0;;;3,0;;1,0;2,0;10,0;;5,0;;1,0;1,0;4,0;;;;;2,0;5,0;;10,0;;5,0;3,0;15,0;;3,0;137,0;;22,0;9,0;1,0;26,0;;;10,0;5,0;50,0;2,0;6,0;3,0;10,0;3,0;;3,0;;;;5,0;2,0;3,0;1,0;2,0;;;;1,0;;;11,0;;;2,0;;2,0;2,0;2,0;17,0;;;;;7,0;;;3,0;5,0;8,0;1,0;1,0;;;28,0;;21,0;5,0;;1,0;1,0;;;;2,0;;2,0;1,0;1,0;;5,0;1,0;;;;1,0;1,0;1,0;;;;;;2,0;5,0;5,0;;2,0;4,0;1,0;;;;;;;;;7,0;;;;;;;;;;;;;;;;2,0;;;;7,0;;;21,0;8,0;;10,0;3,0;;;;;;;;;2,0;;5,0;21,0;4,0;4,0;;;;;;;;;1,0;;;1,0;2,0;;;;10,0;;1,0;;;;18,0;;;;;;;;;;10,0;;;2,0;;1,0;;2,0;;;;;;2,0;;;;;;;;8,0;;3,0;;7,0;;;;;4,0;;20,0;;;3,0;;;4,0;;;1,0;;;;;8,0;;20,0;3,0;;;;
piece;;1,0;;;23,0;;5,0;37,0;9,0;4,0;3,0;1,0;;4,0;11,0;;;;8,0;4,0;1,0;68,0;2,0;4,0;6,0;;;132,0;;25,0;2,0;5,0;5,0;;3,0;3,0;;6,0;4,0;17,0;2,0;;1,0;7,0;4,0;2,0;;;4,0;;;18,0;;15,0;;159,0;42,0;;3,0;77,0;;3,0;10,0;;;;;1,0;;3,0;16,0;3,0;;1,0;2,0;;;2,0;25,0;;;8,0;;;11,0;;2,0;2,0;;31,0;4,0;1,0;8,0;;4,0;15,0;;29,0;43,0;6,0;40,0;7,0;;12,0;;;;70,0;;;;3,0;;3,0;6,0;2,0;;;;20,0;;;2,0;;1,0;;11,0;19,0;;3,0;5,0;2,0;;1,0;;10,0;5,0;;5,0;;;;5,0;6,0;;3,0;38,0;6,0;;;;2,0;4,0;;2,0;10,0;40,0;13,0;;10,0;;;7,0;1,0;;;;1,0;3,0;12,0;24,0;;18,0;19,0;;13,0;12,0;15,0;;1,0;;1,0;;;;6,0;13,0;106,0;;29,0;;;;25,0;2,0;;1,0;;2,0;;;;7,0;36,0;;6,0;1,0;;1,0;49,0;;;7,0;;;27,0;;7,0;;1,0;10,0;;;;4,0;;3,0;;2,0;;2,0;2,0;;2,0;8,0;;1,0;6,0;11,0;;2,0;;8,0;27,0;;10,0;;10,0;;2,0;;;30,0;23,0;2,0;1,0;;6,0;2,0;1,0;7,0;;4,0;39,0;17,0;6,0;6,0;;10,0;26,0;1,0;25,0;12,0;9,0;24,0;;;;;2,0;39,0;1,0;;4,0;25,0;;1,0;3,0;;2,0;;2,0;3,0;1,0;;;;5,0;;;;2,0;3,0;3,0;8,0;6,0;;1,0;2,0;1,0;3,0;10,0;;;3,0;;1,0;;18,0;;;;4,0;1,0;;3,0;;49,0;;;1,0;;;;;;;;;;;5,0;;4,0;;;;1,0;;3,0;;2,0;;;;;;;;;;;;;38,0;1,0;;;2,0;;1,0;;;2,0;12,0;4,0;4,0;1,0;;3,0;3,0;;4,0;;;;;;;22,0;;1,0;;;2,0;;;;4,0;;2,0;;;;;;;7,0;;;7,0;2,0;12,0;2,0;;2,0;;;4,0;;;;;;12,0;;;13,0;1,0;3,0;1,0;;;;;;;;;1,0;;3,0;;;;1,0;;1,0;1,0;1,0;;2,0;1,0;;;;5,0;1,0;4,0;;1,0;4,0;;;;;;;3,0;;;3,0;;;;;1,0;;;5,0;8,0;;10,0;;;1,0;;10,0;;3,0;;;;1,0;;1,0;;;;;;3,0;;1,0;4,0;6,0;;;;;;;;;2,0;7,0;1,0;1,0;1,0;4,0;;1,0;11,0;;1,0;;;;;;9,0;;13,0;;14,0;;3,0;7,0;1,0;15,0;;;;2,0;1,0;;;;1,0;;1,0;;7,0;;;;1,0;1,0;2,0;;6,0;;3,0;;;;;;;;;;;;;;;;1,0;;;;;;;5,0;4,0;1,0;7,0;1,0;;2,0;;;;;1,0;;;;;;6,0;;;;7,0;;;;;;;;1,0;;;3,0;;;;;;3,0;;;1,0;;1,0;;;17,0;3,0;11,0;;1,0;;;1,0;;2,0;;2,0;1,0;;;;7,0;;1,0;4,0;;;;;6,0;2,0;;;;;;;;1,0;1,0;;2,0;4,0;;;;;;;;;1,0;;;;;;;1,0;;;;;;;;;;;;;;;;1,0;;;;;7,0;;;;2,0;;;;;;;;;;3,0;;;;;;3,0;;;;;;;;;;;;;;;;;;;;;;5,0;;;;;;2,0;;;;;;1,0;;;;2,0;;;1,0;;;;1,0;;;;;1,0;;;2,0;;;;;1,0;;;;;;;;;;;;;;;;;;;;;;;1,0;;;;2,0;;;;3,0;;;;;;;;5,0;;;;;;;;;2,0;;;;;;;2,0;;;;;;;;;;;;5,0;;15,0;3,0;;;;;;;5,0;;;5,0;5,0;;;2,0;;4,0;;;39,0;;13,0;8,0;;;;;;;;;;2,0;;;1,0;;;;;;;;;;;;;1,0;;;;;;;;;;;;;;2,0;;;;;;;;;;;2,0;;;3,0;;;;;;;;;;;;;;;;;;;;;;;;3,0;;;2,0;;;;;;;;;9,0;;;;;5,0;;;;;2,0;;;;;77,0;;;;;;;;;;;;;;;;;;;
pixel;;1,0;98,0;16,0;138,0;;6,0;383,0;232,0;209,0;73,0;47,0;;103,0;692,0;6,0;22,0;23,0;219,0;31,0;30,0;202,0;120,0;122,0;106,0;9,0;7,0;849,0;10,0;136,0;664,0;466,0;552,0;199,0;261,0;117,0;3,0;235,0;20,0;107,0;128,0;;59,0;200,0;2,0;4,0;;11,0;611,0;26,0;39,0;318,0;14,0;242,0;8,0;2650,0;822,0;73,0;19,0;47,0;25,0;11,0;482,0;26,0;20,0;;36,0;;28,0;108,0;142,0;29,0;16,0;8,0;8,0;9,0;;116,0;318,0;38,0;1,0;278,0;76,0;53,0;45,0;;411,0;21,0;125,0;445,0;491,0;105,0;4,0;1486,0;64,0;48,0;;91,0;158,0;38,0;47,0;164,0;;135,0;11,0;3,0;34,0;948,0;;;6,0;392,0;867,0;5,0;4,0;25,0;1,0;59,0;10,0;3,0;;;32,0;338,0;;14,0;159,0;5,0;9,0;25,0;4,0;40,0;17,0;;9,0;82,0;216,0;;20,0;5,0;47,0;1,0;12,0;15,0;248,0;;165,0;259,0;4,0;;92,0;;7,0;4,0;29,0;;2,0;;15,0;699,0;47,0;17,0;6,0;5,0;;72,0;157,0;331,0;7,0;5,0;;2,0;68,0;6,0;14,0;6,0;5,0;1001,0;;;4,0;1,0;10,0;5,0;;40,0;10,0;1837,0;;185,0;;;4,0;141,0;4,0;15,0;;;;5,0;37,0;21,0;26,0;76,0;;45,0;4,0;5,0;32,0;7,0;62,0;1,0;17,0;53,0;;231,0;51,0;7,0;1,0;1,0;32,0;14,0;;15,0;7,0;34,0;21,0;;;;2,0;;;243,0;97,0;19,0;;76,0;327,0;17,0;;;239,0;8,0;;21,0;27,0;46,0;4,0;2,0;412,0;18,0;8,0;118,0;35,0;12,0;;53,0;14,0;2,0;37,0;79,0;32,0;2,0;10,0;;40,0;;;2,0;1,0;6,0;1,0;3,0;6,0;1,0;;;5,0;101,0;;;;15,0;;108,0;6,0;140,0;18,0;15,0;3,0;;13,0;67,0;;5,0;223,0;5,0;4,0;;4,0;;283,0;21,0;8,0;;;156,0;5,0;;239,0;188,0;;;;;;;;;;72,0;;;1,0;63,0;;;45,0;2,0;15,0;21,0;;;;33,0;5,0;11,0;19,0;1,0;18,0;181,0;;59,0;63,0;17,0;48,0;21,0;;119,0;37,0;1,0;51,0;3,0;1,0;5,0;22,0;2,0;;14,0;57,0;10,0;;16,0;69,0;102,0;5,0;14,0;37,0;64,0;5,0;;9,0;153,0;24,0;115,0;66,0;73,0;;11,0;75,0;113,0;5,0;17,0;38,0;21,0;32,0;67,0;2,0;85,0;;71,0;1,0;;30,0;18,0;26,0;227,0;140,0;31,0;11,0;;6,0;12,0;40,0;2,0;58,0;30,0;2,0;3,0;25,0;9,0;11,0;74,0;;28,0;17,0;;179,0;6,0;186,0;10,0;1,0;8,0;87,0;1,0;6,0;384,0;69,0;39,0;98,0;83,0;;;;;99,0;4,0;1,0;;;17,0;;8,0;6,0;48,0;228,0;103,0;34,0;2,0;;36,0;70,0;25,0;;29,0;10,0;;11,0;2,0;4,0;;3,0;30,0;2,0;16,0;;;66,0;;9,0;182,0;;;;22,0;1,0;;;7,0;25,0;57,0;;3,0;1,0;8,0;24,0;74,0;16,0;41,0;;11,0;9,0;7,0;94,0;58,0;4,0;60,0;1,0;14,0;1,0;53,0;13,0;31,0;23,0;;11,0;;9,0;;;;;32,0;7,0;18,0;;;;13,0;;;23,0;;;;15,0;;1,0;6,0;;10,0;45,0;;1,0;57,0;;2,0;;;1,0;47,0;3,0;4,0;;;1,0;1,0;1,0;1,0;31,0;2,0;;23,0;;;19,0;14,0;;73,0;;12,0;1,0;;;2,0;65,0;;;3,0;;;22,0;;;3,0;;7,0;;;2,0;3,0;40,0;7,0;3,0;5,0;;;44,0;34,0;1,0;2,0;;5,0;97,0;137,0;;;9,0;2,0;4,0;;144,0;;1,0;;;10,0;;;;6,0;15,0;;;1,0;3,0;;;4,0;69,0;;114,0;21,0;20,0;;;;18,0;;;7,0;;67,0;19,0;;;;;;;8,0;;;;3,0;124,0;1,0;9,0;;51,0;13,0;;;;;;2,0;22,0;;1,0;;;43,0;3,0;29,0;2,0;;;2,0;;;;10,0;154,0;1,0;1,0;39,0;15,0;7,0;30,0;26,0;220,0;114,0;25,0;10,0;3,0;2,0;20,0;13,0;19,0;43,0;18,0;;67,0;16,0;17,0;132,0;29,0;15,0;21,0;10,0;10,0;2,0;38,0;;48,0;5,0;1,0;90,0;81,0;49,0;29,0;91,0;17,0;9,0;118,0;2,0;3,0;1,0;9,0;;8,0;4,0;12,0;7,0;1,0;19,0;;29,0;4,0;29,0;104,0;8,0;15,0;3,0;1,0;15,0;7,0;;96,0;;;49,0;;119,0;41,0;64,0;6,0;11,0;2,0;;3,0;14,0;34,0;26,0;38,0;11,0;14,0;27,0;;17,0;3,0;10,0;21,0;20,0;;38,0;39,0;4,0;27,0;;2,0;1,0;1,0;10,0;182,0;26,0;;1,0;;4,0;3,0;;9,0;;32,0;;3,0;;1,0;;;8,0;5,0;4,0;;;7,0;;;;;;;;;2,0;12,0;28,0;22,0;;2,0;14,0;;;;3,0;8,0;;16,0;;29,0;;;2,0;;;38,0;;26,0;18,0;33,0;2,0;1,0;;4,0;4,0;;9,0;94,0;5,0;48,0;;;;9,0;;46,0;;;;62,0;13,0;14,0;2,0;;;23,0;13,0;14,0;6,0;25,0;;3,0;;;;1,0;;;3,0;26,0;;;1,0;21,0;;132,0;41,0;5,0;;17,0;;;;;6,0;1,0;;;1,0;5,0;30,0;11,0;11,0;;;5,0;;9,0;;1,0;;;;;12,0;9,0;84,0;11,0;21,0;8,0;2,0;;10,0;7,0;;;;53,0;52,0;;3,0;;2,0;;66,0;1,0;1,0;3,0;55,0;;4,0;50,0;;2,0;;;;;9,0;3,0;139,0;2,0;32,0;11,0;18,0;;4,0;6,0;36,0;;2,0;;6,0;6,0;5,0;;5,0;6,0;1,0;;3,0;;;10,0;25,0;;13,0;;5,0;;1,0;;;;3,0;16,0;1,0;23,0;;;2,0;2,0;;;;;8,0;;12,0;1,0;;3,0;;;;;
plate;;17,0;6,0;;100,0;;97,0;356,0;;3,0;33,0;6,0;8,0;;1,0;26,0;;;9,0;;1,0;29,0;1,0;2,0;10,0;;3,0;3,0;15,0;10,0;7,0;15,0;119,0;2,0;16,0;;2,0;139,0;1,0;11,0;3,0;;33,0;56,0;;;3,0;11,0;3,0;2,0;12,0;2,0;;7,0;3,0;74,0;150,0;;12,0;150,0;12,0;1,0;63,0;11,0;;46,0;48,0;5,0;;3,0;124,0;6,0;12,0;4,0;11,0;;5,0;16,0;178,0;8,0;28,0;5,0;2,0;4,0;3,0;6,0;21,0;6,0;;32,0;34,0;;;3,0;14,0;32,0;;;;55,0;198,0;47,0;;10,0;;;21,0;54,0;;8,0;34,0;50,0;20,0;67,0;73,0;21,0;9,0;;27,0;59,0;8,0;3,0;3,0;18,0;3,0;;70,0;68,0;;102,0;184,0;4,0;56,0;10,0;2,0;8,0;92,0;2,0;13,0;4,0;11,0;2,0;7,0;75,0;34,0;10,0;166,0;20,0;;39,0;;45,0;103,0;12,0;20,0;51,0;77,0;62,0;21,0;27,0;;2,0;25,0;23,0;;40,0;10,0;116,0;1,0;28,0;245,0;11,0;77,0;427,0;12,0;55,0;36,0;2,0;1,0;;13,0;7,0;35,0;4,0;38,0;63,0;;105,0;8,0;255,0;8,0;13,0;11,0;71,0;16,0;20,0;3,0;3,0;111,0;103,0;4,0;65,0;41,0;251,0;2,0;3,0;47,0;83,0;23,0;272,0;8,0;13,0;10,0;48,0;93,0;;11,0;89,0;1,0;;93,0;51,0;;11,0;30,0;2,0;7,0;1,0;3,0;4,0;7,0;;26,0;14,0;14,0;30,0;16,0;8,0;41,0;2,0;31,0;12,0;8,0;74,0;25,0;22,0;2,0;27,0;1,0;6,0;2,0;19,0;8,0;113,0;5,0;1,0;12,0;83,0;17,0;11,0;;23,0;27,0;12,0;40,0;14,0;102,0;10,0;3,0;37,0;1,0;164,0;9,0;6,0;13,0;2,0;;16,0;6,0;22,0;112,0;9,0;5,0;38,0;;11,0;42,0;21,0;12,0;23,0;5,0;10,0;;16,0;;28,0;4,0;8,0;9,0;1,0;6,0;12,0;9,0;16,0;16,0;8,0;13,0;10,0;72,0;30,0;27,0;15,0;;;49,0;6,0;21,0;5,0;24,0;3,0;1,0;1,0;25,0;37,0;;22,0;10,0;26,0;5,0;5,0;4,0;2,0;3,0;;;;5,0;;;;3,0;8,0;;;;1,0;;8,0;4,0;6,0;16,0;;;;;;;;1,0;2,0;1,0;;2,0;2,0;;1,0;;;3,0;;;6,0;;;;;5,0;;;95,0;;11,0;;;;;1,0;2,0;;16,0;9,0;1,0;1,0;4,0;35,0;4,0;;18,0;;;8,0;;2,0;;;;;6,0;;;7,0;29,0;40,0;3,0;;;4,0;;;12,0;13,0;;;;2,0;;;;1,0;5,0;1,0;;;;2,0;39,0;;;;9,0;5,0;;;;8,0;1,0;;1,0;;1,0;;;6,0;7,0;5,0;;;;;;;;;;;6,0;81,0;;;;1,0;10,0;1,0;;2,0;;68,0;;;;1,0;;;;;33,0;1,0;;;;;9,0;1,0;1,0;11,0;8,0;;8,0;1,0;;3,0;;1,0;;68,0;37,0;;5,0;;2,0;15,0;;;;3,0;7,0;25,0;;;;;19,0;;4,0;;3,0;1,0;;;;2,0;;26,0;1,0;;;8,0;1,0;;;;;;23,0;;;4,0;4,0;;;;;47,0;;;5,0;11,0;9,0;4,0;;10,0;4,0;1,0;;11,0;9,0;56,0;;1,0;;4,0;;;;12,0;;30,0;;3,0;;;;3,0;;;10,0;24,0;;;;;9,0;1,0;2,0;7,0;6,0;1,0;6,0;2,0;6,0;;;1,0;3,0;7,0;;2,0;7,0;5,0;;1,0;13,0;8,0;;5,0;;1,0;18,0;3,0;;;1,0;;23,0;;4,0;;;5,0;7,0;1,0;18,0;30,0;2,0;35,0;16,0;24,0;19,0;42,0;;3,0;1,0;;1,0;4,0;;;8,0;22,0;5,0;;10,0;;2,0;8,0;1,0;12,0;5,0;6,0;10,0;28,0;;;1,0;3,0;;4,0;4,0;2,0;;1,0;;;12,0;19,0;4,0;8,0;;;;;;;2,0;1,0;;2,0;4,0;;9,0;;71,0;;;;;;20,0;;;5,0;;;4,0;;6,0;;1,0;;14,0;;2,0;;;;;;12,0;;8,0;19,0;;18,0;;;;;;;;;;3,0;;;;3,0;;;;;6,0;;;;;1,0;;;;5,0;;;;;2,0;;1,0;3,0;2,0;;1,0;1,0;;;3,0;4,0;;;;;3,0;3,0;9,0;;16,0;;21,0;1,0;;;;1,0;;;;;;;;;;;;;;;3,0;;1,0;;;;2,0;;;14,0;;3,0;4,0;;1,0;;;8,0;;;;1,0;;5,0;;1,0;1,0;;3,0;1,0;;6,0;1,0;1,0;6,0;;2,0;4,0;;5,0;;9,0;1,0;;;2,0;;;1,0;;;;8,0;26,0;;;;;;2,0;3,0;13,0;2,0;13,0;;1,0;1,0;1,0;;2,0;4,0;1,0;11,0;2,0;;2,0;;13,0;;;;;;33,0;7,0;;1,0;17,0;1,0;2,0;4,0;5,0;;;;;;1,0;1,0;12,0;;;11,0;;40,0;14,0;11,0;3,0;;;;;;5,0;1,0;;3,0;;1,0;1,0;;1,0;;;3,0;2,0;;;;1,0;1,0;;2,0;;;;;;;;;;2,0;;;;;;;;1,0;2,0;;7,0;;3,0;19,0;11,0;3,0;;;;3,0;;;;1,0;;;;;;;;1,0;;;;1,0;;;2,0;;;;2,0;4,0;;2,0;2,0;;;;;;;;;;;;;
plurality;;14,0;64,0;4,0;342,0;1,0;102,0;430,0;77,0;529,0;51,0;42,0;2,0;64,0;370,0;38,0;13,0;8,0;169,0;61,0;59,0;502,0;38,0;55,0;48,0;9,0;20,0;747,0;17,0;205,0;275,0;305,0;865,0;87,0;333,0;60,0;31,0;240,0;40,0;359,0;76,0;15,0;95,0;794,0;16,0;18,0;4,0;41,0;274,0;25,0;76,0;317,0;19,0;337,0;12,0;3817,0;1307,0;11,0;45,0;1397,0;35,0;51,0;548,0;9,0;21,0;30,0;102,0;10,0;7,0;143,0;467,0;45,0;46,0;20,0;31,0;54,0;16,0;293,0;465,0;70,0;7,0;238,0;155,0;49,0;20,0;8,0;393,0;9,0;79,0;509,0;610,0;27,0;86,0;603,0;44,0;80,0;10,0;97,0;390,0;166,0;319,0;606,0;;196,0;14,0;38,0;103,0;881,0;30,0;1,0;70,0;424,0;272,0;160,0;77,0;9,0;7,0;8,0;93,0;83,0;22,0;2,0;31,0;275,0;3,0;49,0;352,0;116,0;21,0;103,0;64,0;46,0;31,0;51,0;28,0;148,0;257,0;;203,0;179,0;36,0;12,0;59,0;164,0;320,0;2,0;457,0;896,0;11,0;13,0;11,0;91,0;69,0;18,0;87,0;102,0;113,0;128,0;109,0;602,0;52,0;3,0;61,0;29,0;9,0;126,0;94,0;602,0;49,0;36,0;183,0;53,0;267,0;196,0;35,0;43,0;79,0;433,0;10,0;;27,0;14,0;67,0;27,0;23,0;51,0;105,0;;8,0;406,0;3,0;59,0;21,0;414,0;12,0;44,0;18,0;24,0;27,0;23,0;80,0;47,0;12,0;123,0;2,0;20,0;46,0;8,0;77,0;129,0;20,0;79,0;;4,0;23,0;384,0;71,0;46,0;8,0;10,0;32,0;67,0;19,0;13,0;60,0;91,0;69,0;;;8,0;31,0;9,0;32,0;161,0;79,0;96,0;11,0;39,0;560,0;6,0;142,0;7,0;118,0;57,0;8,0;27,0;101,0;134,0;16,0;41,0;182,0;16,0;28,0;370,0;36,0;17,0;17,0;203,0;28,0;9,0;124,0;41,0;45,0;31,0;73,0;13,0;104,0;23,0;8,0;2,0;30,0;50,0;9,0;17,0;16,0;72,0;77,0;1,0;6,0;94,0;6,0;26,0;19,0;31,0;5,0;153,0;64,0;330,0;53,0;13,0;24,0;13,0;27,0;111,0;5,0;21,0;107,0;150,0;4,0;6,0;5,0;6,0;203,0;31,0;41,0;20,0;10,0;107,0;22,0;35,0;192,0;219,0;7,0;21,0;31,0;6,0;2,0;3,0;15,0;8,0;13,0;112,0;5,0;9,0;2,0;111,0;21,0;13,0;69,0;2,0;144,0;36,0;126,0;5,0;5,0;12,0;20,0;36,0;9,0;11,0;16,0;218,0;2,0;34,0;18,0;25,0;32,0;6,0;41,0;77,0;17,0;47,0;41,0;7,0;4,0;1,0;11,0;3,0;6,0;11,0;25,0;20,0;1,0;1,0;125,0;51,0;9,0;13,0;19,0;59,0;1,0;29,0;5,0;71,0;43,0;188,0;27,0;18,0;;71,0;55,0;64,0;3,0;77,0;58,0;16,0;17,0;15,0;10,0;168,0;7,0;82,0;4,0;;63,0;26,0;7,0;106,0;52,0;11,0;71,0;5,0;10,0;2,0;81,0;18,0;31,0;114,0;4,0;7,0;44,0;14,0;28,0;86,0;26,0;72,0;60,0;;199,0;18,0;200,0;14,0;11,0;30,0;224,0;17,0;13,0;114,0;62,0;117,0;38,0;17,0;;;27,0;14,0;26,0;3,0;26,0;38,0;61,0;39,0;28,0;13,0;14,0;92,0;123,0;67,0;43,0;47,0;6,0;35,0;205,0;50,0;7,0;15,0;39,0;11,0;42,0;4,0;5,0;9,0;6,0;11,0;39,0;121,0;43,0;4,0;226,0;5,0;21,0;108,0;4,0;8,0;37,0;27,0;73,0;3,0;9,0;15,0;20,0;33,0;12,0;16,0;9,0;19,0;79,0;78,0;26,0;143,0;21,0;60,0;17,0;36,0;443,0;208,0;3,0;35,0;8,0;2,0;11,0;13,0;15,0;23,0;55,0;8,0;8,0;9,0;5,0;2,0;10,0;;5,0;61,0;54,0;65,0;9,0;33,0;11,0;20,0;10,0;9,0;32,0;8,0;1,0;45,0;18,0;;4,0;5,0;10,0;1,0;33,0;12,0;46,0;4,0;3,0;1,0;1,0;17,0;11,0;64,0;6,0;26,0;5,0;50,0;34,0;9,0;3,0;10,0;34,0;49,0;4,0;5,0;56,0;50,0;44,0;10,0;3,0;105,0;1837,0;8,0;7,0;16,0;3,0;9,0;58,0;;4,0;4,0;;16,0;42,0;24,0;38,0;29,0;77,0;2,0;29,0;16,0;;63,0;164,0;12,0;7,0;121,0;16,0;14,0;6,0;102,0;30,0;8,0;99,0;11,0;165,0;51,0;;1,0;30,0;13,0;8,0;10,0;222,0;3,0;20,0;1,0;17,0;39,0;2,0;5,0;1,0;106,0;9,0;;8,0;4,0;47,0;6,0;1,0;6,0;30,0;3,0;19,0;51,0;22,0;1,0;;8,0;21,0;2,0;;93,0;16,0;49,0;22,0;36,0;63,0;33,0;67,0;9,0;2,0;5,0;13,0;13,0;;6,0;2,0;17,0;2,0;4,0;83,0;48,0;2,0;2,0;3,0;1,0;15,0;18,0;12,0;9,0;30,0;10,0;7,0;4,0;11,0;14,0;15,0;8,0;2,0;8,0;10,0;;3,0;2,0;57,0;3,0;17,0;43,0;11,0;28,0;30,0;10,0;113,0;90,0;33,0;12,0;4,0;15,0;19,0;36,0;;37,0;3,0;;58,0;31,0;6,0;43,0;45,0;10,0;48,0;5,0;19,0;7,0;92,0;36,0;95,0;10,0;29,0;77,0;17,0;26,0;25,0;68,0;11,0;11,0;106,0;11,0;5,0;17,0;18,0;37,0;3,0;51,0;5,0;9,0;4,0;18,0;;13,0;17,0;12,0;87,0;7,0;1,0;1,0;10,0;1,0;2,0;6,0;30,0;11,0;6,0;14,0;21,0;19,0;29,0;20,0;17,0;4,0;2,0;11,0;10,0;25,0;118,0;7,0;37,0;10,0;17,0;35,0;11,0;74,0;11,0;16,0;9,0;49,0;1,0;39,0;42,0;20,0;37,0;59,0;4,0;17,0;8,0;18,0;78,0;8,0;1,0;31,0;7,0;3,0;15,0;31,0;6,0;7,0;23,0;34,0;;2,0;4,0;;13,0;38,0;12,0;;7,0;4,0;2,0;22,0;;24,0;1,0;40,0;4,0;17,0;3,0;5,0;78,0;75,0;8,0;8,0;13,0;41,0;7,0;;2,0;1,0;12,0;;40,0;2,0;17,0;7,0;5,0;2,0;1,0;3,0;64,0;29,0;6,0;14,0;16,0;3,0;;1,0;20,0;;51,0;;73,0;7,0;46,0;6,0;8,0;83,0;4,0;;;7,0;5,0;4,0;66,0;17,0;13,0;6,0;98,0;1,0;9,0;6,0;16,0;9,0;5,0;12,0;2,0;8,0;1,0;16,0;3,0;4,0;7,0;14,0;5,0;3,0;19,0;6,0;34,0;;12,0;8,0;16,0;;13,0;2,0;1,0;7,0;2,0;16,0;6,0;;1,0;22,0;33,0;46,0;22,0;5,0;9,0;1,0;14,0;2,0;35,0;13,0;12,0;7,0;;4,0;2,0;4,0;;3,0;39,0;3,0;13,0;32,0;18,0;10,0;2,0;;1,0;6,0;44,0;14,0;3,0;7,0;2,0;16,0;1,0;44,0;15,0;;19,0;53,0;;;149,0;4,0;14,0;1,0;1,0;5,0;;;4,0;55,0;42,0;7,0;5,0;20,0;;10,0;18,0;46,0;;12,0;3,0;1,0;8,0;1,0;25,0;9,0;13,0;;11,0;2,0;1,0;;1,0;18,0;;9,0;;2,0;2,0;18,0;17,0;;;6,0;13,0;8,0;17,0;3,0;9,0;8,0;7,0;;9,0;27,0;;9,0;25,0;17,0;;;3,0;8,0;;;;
portion;;27,0;55,0;;180,0;;187,0;409,0;31,0;241,0;100,0;22,0;38,0;13,0;121,0;4,0;9,0;25,0;76,0;25,0;9,0;334,0;47,0;47,0;114,0;3,0;61,0;267,0;21,0;153,0;110,0;129,0;514,0;48,0;264,0;2,0;26,0;608,0;17,0;697,0;83,0;;140,0;299,0;1,0;10,0;19,0;29,0;144,0;17,0;29,0;123,0;4,0;81,0;6,0;2015,0;699,0;;94,0;1122,0;66,0;7,0;312,0;;17,0;38,0;136,0;8,0;3,0;147,0;373,0;18,0;68,0;305,0;81,0;15,0;35,0;95,0;480,0;17,0;29,0;85,0;41,0;43,0;6,0;8,0;277,0;8,0;43,0;168,0;407,0;46,0;35,0;198,0;49,0;126,0;23,0;32,0;81,0;224,0;797,0;218,0;3,0;69,0;4,0;9,0;21,0;333,0;10,0;24,0;48,0;280,0;89,0;234,0;215,0;1,0;41,0;12,0;93,0;428,0;17,0;;13,0;81,0;15,0;7,0;407,0;360,0;15,0;258,0;223,0;11,0;7,0;94,0;35,0;33,0;262,0;;100,0;69,0;8,0;3,0;49,0;175,0;127,0;79,0;828,0;353,0;11,0;15,0;3,0;106,0;150,0;19,0;129,0;251,0;208,0;328,0;66,0;178,0;48,0;21,0;314,0;71,0;6,0;153,0;21,0;638,0;12,0;80,0;837,0;120,0;416,0;431,0;61,0;242,0;346,0;116,0;15,0;22,0;74,0;38,0;105,0;20,0;82,0;75,0;255,0;406,0;1,0;;11,0;85,0;16,0;519,0;43,0;61,0;13,0;49,0;109,0;210,0;43,0;195,0;78,0;551,0;49,0;15,0;75,0;106,0;196,0;523,0;2,0;21,0;15,0;32,0;36,0;53,0;53,0;121,0;12,0;15,0;384,0;51,0;37,0;20,0;372,0;23,0;149,0;18,0;5,0;73,0;28,0;5,0;43,0;229,0;41,0;65,0;237,0;46,0;319,0;63,0;236,0;63,0;43,0;191,0;29,0;51,0;55,0;54,0;126,0;93,0;36,0;18,0;56,0;485,0;26,0;6,0;163,0;210,0;15,0;98,0;38,0;154,0;122,0;122,0;411,0;75,0;431,0;61,0;42,0;73,0;69,0;209,0;17,0;18,0;85,0;14,0;2,0;12,0;23,0;138,0;67,0;61,0;8,0;167,0;30,0;80,0;103,0;207,0;140,0;140,0;70,0;24,0;76,0;39,0;18,0;41,0;73,0;63,0;69,0;28,0;24,0;22,0;152,0;197,0;100,0;190,0;12,0;75,0;114,0;188,0;110,0;90,0;50,0;15,0;60,0;13,0;31,0;27,0;143,0;92,0;36,0;72,0;148,0;99,0;129,0;65,0;19,0;105,0;36,0;;78,0;19,0;6,0;;;33,0;1,0;10,0;3,0;5,0;33,0;73,0;1,0;8,0;109,0;18,0;21,0;4,0;16,0;40,0;85,0;3,0;26,0;2,0;6,0;2,0;9,0;1,0;17,0;3,0;22,0;;9,0;15,0;90,0;17,0;;4,0;18,0;22,0;20,0;15,0;2,0;25,0;42,0;27,0;9,0;5,0;;104,0;20,0;117,0;31,0;40,0;2,0;4,0;6,0;24,0;2,0;99,0;47,0;25,0;53,0;7,0;93,0;8,0;38,0;47,0;22,0;8,0;39,0;1,0;13,0;15,0;42,0;;2,0;40,0;2,0;1,0;27,0;82,0;30,0;22,0;6,0;12,0;32,0;2,0;59,0;6,0;119,0;2,0;;15,0;98,0;16,0;5,0;12,0;10,0;105,0;27,0;;26,0;1,0;23,0;13,0;14,0;8,0;24,0;8,0;52,0;8,0;6,0;5,0;8,0;37,0;54,0;87,0;5,0;12,0;;18,0;161,0;75,0;19,0;4,0;12,0;;43,0;;17,0;2,0;24,0;3,0;24,0;38,0;244,0;2,0;16,0;;2,0;75,0;12,0;;3,0;;66,0;;;2,0;10,0;28,0;;1,0;5,0;174,0;51,0;35,0;2,0;56,0;10,0;64,0;28,0;21,0;156,0;242,0;15,0;10,0;19,0;1,0;2,0;;;10,0;94,0;60,0;;22,0;7,0;17,0;36,0;1,0;;19,0;17,0;137,0;31,0;28,0;2,0;4,0;12,0;91,0;53,0;14,0;1,0;5,0;49,0;8,0;5,0;15,0;11,0;1,0;50,0;1,0;2,0;3,0;99,0;8,0;9,0;1,0;;20,0;17,0;16,0;44,0;8,0;36,0;14,0;;23,0;17,0;10,0;31,0;17,0;3,0;11,0;26,0;;2,0;52,0;185,0;11,0;6,0;;48,0;1,0;139,0;1,0;16,0;7,0;28,0;13,0;4,0;;42,0;;89,0;3,0;38,0;5,0;1,0;15,0;119,0;3,0;2,0;135,0;65,0;;7,0;26,0;6,0;59,0;;8,0;12,0;111,0;5,0;17,0;9,0;26,0;4,0;2,0;11,0;57,0;20,0;;13,0;47,0;4,0;61,0;11,0;29,0;5,0;;1,0;;3,0;4,0;2,0;4,0;23,0;28,0;13,0;55,0;;18,0;7,0;46,0;22,0;43,0;;63,0;2,0;30,0;;36,0;48,0;20,0;46,0;8,0;15,0;12,0;121,0;111,0;10,0;8,0;;7,0;32,0;8,0;19,0;94,0;;70,0;67,0;45,0;41,0;19,0;9,0;18,0;21,0;13,0;;2,0;33,0;26,0;11,0;10,0;19,0;55,0;10,0;;15,0;22,0;49,0;5,0;15,0;3,0;19,0;;;12,0;34,0;18,0;26,0;3,0;21,0;10,0;9,0;60,0;11,0;17,0;17,0;4,0;;48,0;89,0;34,0;19,0;3,0;13,0;3,0;1,0;3,0;19,0;17,0;8,0;1,0;1,0;53,0;7,0;33,0;2,0;14,0;2,0;1,0;23,0;33,0;6,0;17,0;23,0;7,0;48,0;13,0;7,0;10,0;;1,0;2,0;1,0;9,0;;12,0;5,0;51,0;6,0;12,0;;3,0;3,0;28,0;10,0;2,0;30,0;7,0;8,0;9,0;15,0;7,0;7,0;21,0;7,0;4,0;8,0;;8,0;4,0;4,0;34,0;5,0;5,0;16,0;3,0;57,0;4,0;6,0;8,0;3,0;10,0;10,0;31,0;6,0;29,0;19,0;6,0;163,0;32,0;25,0;6,0;3,0;11,0;11,0;41,0;16,0;4,0;13,0;11,0;5,0;2,0;;;5,0;;5,0;14,0;3,0;;25,0;4,0;1,0;2,0;1,0;;32,0;23,0;2,0;8,0;2,0;5,0;3,0;3,0;2,0;4,0;10,0;41,0;6,0;;;12,0;4,0;1,0;1,0;11,0;4,0;3,0;14,0;5,0;7,0;82,0;8,0;52,0;66,0;11,0;17,0;27,0;5,0;2,0;6,0;21,0;16,0;;4,0;90,0;9,0;4,0;;2,0;;3,0;25,0;60,0;;9,0;;14,0;;59,0;;10,0;5,0;44,0;4,0;22,0;85,0;15,0;;13,0;15,0;8,0;50,0;6,0;3,0;21,0;;21,0;6,0;50,0;;18,0;3,0;1,0;4,0;18,0;30,0;31,0;10,0;1,0;4,0;3,0;1,0;;2,0;;;27,0;3,0;6,0;;2,0;13,0;6,0;43,0;2,0;8,0;1,0;2,0;9,0;2,0;8,0;2,0;3,0;;8,0;6,0;2,0;11,0;2,0;;6,0;11,0;6,0;11,0;4,0;1,0;1,0;9,0;1,0;19,0;13,0;3,0;2,0;3,0;;1,0;10,0;27,0;2,0;;;28,0;;;1,0;4,0;;2,0;3,0;13,0;;3,0;34,0;;17,0;66,0;17,0;27,0;2,0;16,0;5,0;12,0;5,0;8,0;;1,0;;;;47,0;4,0;3,0;1,0;35,0;17,0;3,0;10,0;1,0;;;9,0;;;4,0;;12,0;17,0;1,0;17,0;8,0;;8,0;;12,0;1,0;4,0;;40,0;;;7,0;
post;;1,0;;;4,0;;13,0;25,0;;3,0;8,0;;;;;;;;;1,0;;1,0;;;;;;;;1,0;;;2,0;;1,0;;;4,0;1,0;;2,0;;;3,0;;;;1,0;;;;1,0;;3,0;;9,0;24,0;;;3,0;;;8,0;;;2,0;2,0;;;;;;;;;;;;17,0;;;3,0;;;;;1,0;;1,0;;3,0;;;;2,0;3,0;;;;;19,0;;;;;;;3,0;;;;;;3,0;10,0;;;;1,0;2,0;;;;4,0;;;3,0;4,0;;9,0;4,0;;;;3,0;1,0;14,0;;;;;;2,0;1,0;;1,0;6,0;9,0;;;;4,0;7,0;;1,0;1,0;12,0;8,0;;2,0;;;1,0;;;;3,0;1,0;;;4,0;;27,0;16,0;;4,0;1,0;;;;9,0;1,0;;;2,0;;12,0;6,0;;22,0;;;;14,0;1,0;;;;3,0;3,0;;;1,0;22,0;2,0;;;;;12,0;;5,0;;;1,0;;;;;;3,0;3,0;;;;;;;1,0;4,0;1,0;;1,0;1,0;1,0;8,0;;2,0;2,0;;;;;10,0;3,0;;;;;4,0;;;;18,0;1,0;;2,0;4,0;;2,0;;1,0;;20,0;4,0;21,0;11,0;;;;;8,0;;;11,0;;;;;15,0;2,0;;1,0;;;;5,0;;;7,0;1,0;;;;;;;;;5,0;;;;2,0;;5,0;;1,0;2,0;1,0;;3,0;;;;;2,0;;1,0;;9,0;2,0;;1,0;;1,0;;10,0;;;;;2,0;;;;;;;;;;;;;;;;;;;;;;;;;;;;;;;;;;;;;;;;;;;;2,0;;;3,0;;;;;;;;;;;2,0;;;;5,0;;;;;;1,0;;;;;1,0;;;;;;2,0;;;;;;;2,0;;1,0;;;;;;;;;;1,0;;;;;;;;;;1,0;;;;;;;;;;;;;2,0;;;;;;1,0;;;;;;;1,0;;;;;;3,0;;;;;;;;;;;;;3,0;;;;;;;1,0;;;1,0;;;;;;;;;13,0;19,0;;;;;;;;;;10,0;;;;;;5,0;;;;;;;1,0;;;;1,0;;;;;;;;;;;;;;;;;;;;;1,0;;;;;;;;;;;4,0;;1,0;;2,0;;;;;;;1,0;6,0;;;;;;;;;;9,0;;;;;;;;;;;;;;;;1,0;;;;;;;;;2,0;;;;;;;;;;;;;;;;;;1,0;;2,0;;;;;;3,0;;;;;;;;;;;;;;;;;;1,0;;1,0;;;;5,0;;;;;;;7,0;;;;;;;;;;;;;;;;;;;;;;;;;;;;;;;;;;;;;;;;;2,0;;;;;;;;;;2,0;;;;;;;;;;;;;;;;;;;;;;;;;;;;;;;;1,0;;;;;;;;;;;;;;;;;;;;;2,0;;;3,0;;;;;;1,0;;;;;;;;;;;;;;;;;;1,0;1,0;;;;;;;;;;;;;;;;;;;;;;;;;;;;;;;;;;;;;;;;;;4,0;;;;;;;2,0;;;;;;;;;;;;;;7,0;;;;;;;;;;;;;;;;;;;;;3,0;;;;;;;;;;;;;;;;;;;;;;;;;;;;;;1,0;;;;;;;;;;;;;;;;;;;;;;;;;;;;;;;;;;;;;;;1,0;;;;;;;;;;;;;;;;;;2,0;;;;;;;;;;;;;;;;;;;;;;;;;;;;
predetermine;;1,0;224,0;2,0;145,0;;70,0;145,0;94,0;121,0;47,0;23,0;2,0;8,0;160,0;4,0;;11,0;62,0;20,0;184,0;217,0;82,0;17,0;52,0;8,0;9,0;279,0;17,0;155,0;103,0;162,0;181,0;91,0;132,0;6,0;2,0;235,0;;148,0;196,0;3,0;46,0;88,0;13,0;27,0;3,0;44,0;101,0;56,0;45,0;86,0;;50,0;17,0;1098,0;177,0;4,0;111,0;302,0;;39,0;294,0;16,0;4,0;19,0;57,0;;11,0;119,0;144,0;24,0;19,0;4,0;2,0;12,0;;120,0;423,0;18,0;5,0;198,0;30,0;5,0;9,0;3,0;197,0;17,0;21,0;122,0;75,0;18,0;51,0;284,0;112,0;33,0;8,0;39,0;70,0;25,0;91,0;144,0;2,0;20,0;14,0;10,0;13,0;299,0;5,0;;4,0;29,0;26,0;25,0;8,0;9,0;1,0;;6,0;31,0;3,0;1,0;19,0;47,0;4,0;3,0;36,0;14,0;19,0;9,0;4,0;;5,0;2,0;3,0;27,0;28,0;;14,0;29,0;6,0;4,0;31,0;51,0;26,0;16,0;65,0;177,0;5,0;;;4,0;2,0;5,0;17,0;3,0;8,0;20,0;25,0;94,0;23,0;23,0;5,0;1,0;2,0;6,0;158,0;236,0;10,0;14,0;77,0;15,0;40,0;26,0;61,0;24,0;7,0;235,0;;;12,0;;18,0;7,0;;31,0;9,0;203,0;;152,0;;10,0;1,0;49,0;15,0;4,0;;6,0;57,0;23,0;4,0;9,0;12,0;64,0;2,0;;10,0;7,0;2,0;21,0;14,0;4,0;2,0;2,0;54,0;613,0;32,0;13,0;5,0;7,0;23,0;11,0;31,0;20,0;4,0;94,0;21,0;;1,0;7,0;1,0;1,0;8,0;7,0;36,0;128,0;1,0;52,0;221,0;15,0;14,0;5,0;42,0;;2,0;40,0;20,0;4,0;4,0;4,0;18,0;72,0;1,0;30,0;3,0;3,0;;37,0;1,0;11,0;28,0;35,0;14,0;1,0;10,0;1,0;23,0;;3,0;;;7,0;;4,0;16,0;2,0;22,0;3,0;68,0;34,0;6,0;9,0;13,0;17,0;;80,0;71,0;185,0;50,0;10,0;;4,0;19,0;105,0;;14,0;7,0;59,0;;;6,0;;;24,0;32,0;;;343,0;14,0;1,0;119,0;35,0;2,0;3,0;4,0;;1,0;1,0;4,0;6,0;;15,0;9,0;5,0;;35,0;7,0;2,0;16,0;;99,0;18,0;1,0;6,0;3,0;9,0;11,0;6,0;5,0;24,0;12,0;28,0;;13,0;41,0;17,0;25,0;10,0;4,0;82,0;15,0;14,0;9,0;4,0;42,0;13,0;;;5,0;5,0;20,0;4,0;;3,0;12,0;72,0;4,0;;34,0;6,0;25,0;;7,0;39,0;30,0;35,0;2,0;7,0;;18,0;245,0;51,0;5,0;16,0;30,0;34,0;59,0;52,0;4,0;64,0;8,0;58,0;13,0;1,0;19,0;86,0;58,0;106,0;284,0;2,0;13,0;;8,0;14,0;36,0;;46,0;30,0;4,0;4,0;14,0;15,0;1,0;10,0;;32,0;31,0;;72,0;14,0;75,0;2,0;3,0;28,0;84,0;5,0;;51,0;29,0;19,0;13,0;7,0;;;1,0;2,0;;9,0;4,0;13,0;13,0;4,0;10,0;5,0;4,0;46,0;17,0;19,0;18,0;6,0;1,0;20,0;59,0;19,0;5,0;30,0;1,0;4,0;32,0;1,0;48,0;6,0;2,0;12,0;;21,0;29,0;6,0;62,0;;13,0;121,0;1,0;7,0;;14,0;7,0;17,0;3,0;8,0;19,0;3,0;8,0;2,0;2,0;49,0;27,0;36,0;2,0;47,0;2,0;68,0;88,0;9,0;98,0;54,0;5,0;63,0;1,0;1,0;;17,0;3,0;10,0;31,0;4,0;2,0;;5,0;;2,0;;6,0;35,0;29,0;10,0;3,0;17,0;2,0;7,0;;4,0;6,0;3,0;;25,0;22,0;;;8,0;;1,0;7,0;1,0;16,0;10,0;;2,0;;3,0;;6,0;5,0;10,0;1,0;2,0;;1,0;3,0;4,0;14,0;4,0;1,0;3,0;7,0;;7,0;2,0;2,0;25,0;283,0;13,0;4,0;6,0;4,0;;35,0;1,0;9,0;3,0;;5,0;4,0;;;1,0;13,0;2,0;;5,0;;9,0;62,0;7,0;;20,0;5,0;2,0;6,0;19,0;11,0;;;4,0;8,0;19,0;;;2,0;6,0;1,0;2,0;99,0;;;;5,0;6,0;;2,0;;3,0;1,0;4,0;;;2,0;;1,0;13,0;1,0;;11,0;18,0;1,0;;;;23,0;4,0;1,0;4,0;4,0;20,0;8,0;;12,0;;2,0;;;2,0;;3,0;8,0;10,0;10,0;;7,0;1,0;35,0;10,0;;13,0;;;;2,0;19,0;6,0;28,0;;3,0;3,0;;7,0;30,0;;;20,0;4,0;;1,0;8,0;6,0;;;13,0;3,0;5,0;11,0;;35,0;113,0;52,0;;2,0;18,0;25,0;1,0;;9,0;78,0;6,0;23,0;1,0;1,0;18,0;7,0;10,0;125,0;1,0;;1,0;5,0;;;4,0;3,0;46,0;3,0;19,0;14,0;20,0;1,0;5,0;5,0;12,0;6,0;1,0;10,0;11,0;1,0;1,0;1,0;34,0;3,0;5,0;;16,0;5,0;7,0;25,0;4,0;;;4,0;5,0;1,0;;10,0;8,0;;15,0;21,0;19,0;42,0;7,0;70,0;28,0;10,0;2,0;5,0;2,0;18,0;;7,0;14,0;51,0;2,0;5,0;24,0;3,0;2,0;19,0;1,0;;1,0;3,0;11,0;17,0;;4,0;2,0;;5,0;69,0;19,0;2,0;;20,0;;6,0;2,0;1,0;1,0;21,0;18,0;1,0;;2,0;;;27,0;2,0;3,0;2,0;5,0;7,0;6,0;18,0;4,0;2,0;16,0;5,0;5,0;2,0;2,0;21,0;3,0;8,0;9,0;;36,0;1,0;1,0;1,0;1,0;25,0;4,0;4,0;6,0;12,0;;4,0;1,0;;;20,0;4,0;3,0;5,0;19,0;;;;5,0;;2,0;6,0;;7,0;3,0;3,0;5,0;2,0;;2,0;;2,0;4,0;;22,0;;2,0;2,0;2,0;;9,0;8,0;4,0;5,0;2,0;3,0;;5,0;;1,0;14,0;;;;10,0;3,0;;;3,0;;2,0;8,0;1,0;;;1,0;;;;2,0;;2,0;;;;4,0;9,0;18,0;1,0;;10,0;14,0;36,0;1,0;;;2,0;4,0;;1,0;;4,0;4,0;2,0;6,0;1,0;2,0;6,0;1,0;;;;2,0;19,0;;5,0;2,0;4,0;;11,0;3,0;;7,0;21,0;;;2,0;;1,0;1,0;;;;;;19,0;;8,0;;;;;;;;1,0;;17,0;1,0;;5,0;4,0;1,0;1,0;;;;;;4,0;2,0;1,0;1,0;25,0;3,0;1,0;1,0;;1,0;;8,0;;;5,0;4,0;;2,0;;;2,0;3,0;8,0;1,0;;;;1,0;;;;;
priority;;1,0;;;5,0;;;8,0;2,0;;;;;;2,0;;;;2,0;1,0;2,0;22,0;;;;;;25,0;;;1,0;4,0;7,0;;;;;1,0;;5,0;4,0;;;;;6,0;;;3,0;;2,0;1,0;;2,0;;46,0;7,0;;;2,0;;;6,0;;;;1,0;;;;;59,0;;;;6,0;;;2,0;;;5,0;1,0;;;;;;2,0;3,0;;;3,0;2,0;;;;3,0;2,0;;;1,0;;;;;;11,0;;;;2,0;;;;;;;;;;;;4,0;;;;;;;;;;;1,0;2,0;;;;;;;;13,0;;;;;;;;;;;1,0;;;;;3,0;;;;;;;23,0;;;;;;;;;;;;;;;;;;;;;16,0;;;;;;;;;;;;;;;;;;2,0;;;;;;;;;;1,0;;;;;;;;;;;;;;;;;;;;;;;9,0;2,0;;;;;;;;;;;;;;;;;;;;;;;;;;;;;;;;;;;;;7,0;;1,0;;;;;;;;;3,0;;;;;;;;;;14,0;;;;;6,0;;;;;8,0;;;;;;;;;;;;;;;;;;;;;;;;;;;;;;;;;;;;;;1,0;3,0;;;2,0;2,0;;;;;;;;;;;;;;;5,0;;2,0;;;;;;;;1,0;1,0;;;;;;;;;;;;1,0;6,0;;;;;3,0;3,0;;6,0;10,0;;1,0;;;;;;;;;;;;;;;;;;2,0;;5,0;;;;2,0;;1,0;;;2,0;6,0;;;;;;;;;;;;;;;3,0;;;;;;6,0;4,0;;;;;;;;;3,0;;;;38,0;;;11,0;;;20,0;;;;;;;;11,0;7,0;;;;;;1,0;4,0;;7,0;;2,0;;1,0;4,0;3,0;;;;;2,0;;;;1,0;;;;;;;;;;1,0;6,0;;;;1,0;;;;;1,0;;;;;;;;;;1,0;;;;;;;;;;;;;;;;;;;;6,0;;2,0;;1,0;;;;;;;4,0;10,0;;;1,0;;;1,0;1,0;;;;;;;;;2,0;;;;;;;7,0;;;;;;;;;;;;;3,0;;1,0;;;;;;;;;;;;;;;1,0;;;;;;;;;5,0;;;;;;;;;;5,0;;;;;;;;;;;;;;;;;;;;;;;;;;;;;;;;;;;;;;;;;;;;;;;;;;;;;;;;;;;;;;1,0;;;;;;;;32,0;4,0;;;;;;;;;;;;;;;;;2,0;;;;3,0;;;;;;;;;;;;;;5,0;;;;;2,0;;;;;;;;;;;;;;;;;;;;;2,0;;;;;;;;;;;;;11,0;;;1,0;24,0;;;;;;;;;2,0;;;;;;;;;;;;;;;1,0;;1,0;;;;;;;;;;;;;;;;;;;;;;;;;;;;;;;;1,0;;;3,0;;;;17,0;;;;;;;;;;;;;;;;;;;;1,0;;;;;;1,0;;;;;;;;;;;;;;;;;;;;;;;;;;;;;;;;;;;;;;;;;;;;;;;;;;;;;;;;;;;;;;;;;;;;;;;;;;;;;;;;;;;;;;;;;;;;;;;;;;;;;;;;;;;;;;;;;;;;;;;;;
proximate;;2,0;;;7,0;;10,0;2,0;;2,0;1,0;;;;;;;;;13,0;4,0;2,0;;;;;;2,0;;2,0;;5,0;13,0;;3,0;;;;;8,0;7,0;;2,0;2,0;;;;;;;;;;;;30,0;1,0;;;38,0;;;4,0;;;4,0;3,0;;;1,0;;;;;;;;2,0;14,0;;;1,0;2,0;;;;6,0;;;2,0;25,0;;;1,0;;1,0;;;;;17,0;11,0;;;;;;;;;1,0;6,0;;6,0;2,0;;;;;4,0;3,0;;;;;;1,0;;;1,0;5,0;;;;;;8,0;;;;;3,0;;1,0;;;;1,0;1,0;;;;;;;7,0;;16,0;;4,0;;;4,0;2,0;;;;4,0;;;16,0;1,0;3,0;14,0;;5,0;7,0;;;5,0;1,0;;;;2,0;1,0;8,0;9,0;;5,0;;;;6,0;;;;;;;;;;6,0;6,0;;;;3,0;;;;;;;4,0;;;;4,0;1,0;8,0;;;;;1,0;2,0;;;;;;2,0;;2,0;;1,0;1,0;;2,0;;;2,0;;;;;;;;;;2,0;;;;6,0;;;;;;;;;;;2,0;;;6,0;;;;2,0;;;;12,0;;7,0;3,0;1,0;;5,0;;4,0;;4,0;;;;;;1,0;;3,0;1,0;;;;1,0;;;;1,0;3,0;2,0;2,0;;4,0;;;;;;;1,0;;;1,0;1,0;;;1,0;;;;;;;;;;;;;;;1,0;;;;;;;;;;;;;;;;;;;;;;1,0;;2,0;;;;;;;;;;;;;;;1,0;1,0;;;;;;;;;;;4,0;;;;;;1,0;;;;;;;;;;;;;;;;;;;;;;;;;;;3,0;;;;;;;;;;;;;;;;;1,0;;1,0;1,0;;;;;;;;15,0;;;;;;;;;;;;;1,0;2,0;4,0;;;;;3,0;;;;;;;;;;;;;1,0;;;;;;1,0;;;18,0;19,0;;;1,0;;;;;;3,0;;;;;;;;;;;;;;;;;4,0;;;;;;;;1,0;;;;2,0;;;1,0;;1,0;;;1,0;;;2,0;;;;;;1,0;;;;;;;;;1,0;15,0;;;;1,0;;;;;;;;;;;;;;;;;;3,0;;;1,0;;;;;;;;;;;;;;;;;;;;;;;;;2,0;;;1,0;;;;;2,0;;;;;;3,0;;;;;;;;;;4,0;;8,0;;1,0;;;;;;;;;;;;;;;;;;;;;;;;;;;;;;;;;;;;;;;;;;;;;;;;;;;;;;;;;;;1,0;;;;;;;;7,0;;;;;;;;;;;1,0;;;2,0;;;;;;;;;;;;;;;;;;;;;1,0;;;;;;;;;;;;;;;;;;;;;;;;;;;;;;;;1,0;;;;;;;;;;;;;;;;2,0;;;;;;;;;;;;1,0;;;2,0;;;;;;;;;;;1,0;;;;;;;;;;;;;;;2,0;;;;;;;;2,0;;;;;;;;;;;;;;2,0;;;;;1,0;;;;;;;;;;;;;;;;;;2,0;;;;;;;;;;;;;;;;;;;;;;;;;;;;;;;1,0;;;1,0;;;;;10,0;;1,0;;;;;;;;;;;;;;;;;;;2,0;;;;;;;;;;;;;2,0;;;;;;;;;;;;;;;;;;;;;;;;;;;;;;;;;;;;;;8,0;;;;;;;;;;;;;;
rail;;4,0;;;1,0;;11,0;10,0;;;;;7,0;;;;;;8,0;;;2,0;;;;;10,0;;;;;;4,0;;2,0;;;8,0;;;;;22,0;7,0;;;2,0;;;;;;;4,0;;1,0;4,0;;2,0;21,0;4,0;;1,0;;;3,0;9,0;;;4,0;;;15,0;;3,0;;7,0;;9,0;11,0;1,0;;;;;;1,0;;;3,0;1,0;;;;1,0;6,0;;;;3,0;1,0;22,0;;;;;;19,0;;;3,0;18,0;;5,0;4,0;1,0;;;1,0;;;7,0;1,0;7,0;;;2,0;4,0;;26,0;;;;13,0;;20,0;5,0;1,0;;;;;;6,0;;;5,0;8,0;2,0;;;1,0;80,0;;1,0;13,0;2,0;6,0;;1,0;;;2,0;;;;2,0;;;;59,0;;10,0;97,0;11,0;;4,0;;;;;2,0;1,0;;9,0;3,0;13,0;10,0;;12,0;;;2,0;16,0;;;;;7,0;9,0;;6,0;;3,0;;;;;2,0;39,0;;6,0;;;;;;;;11,0;4,0;2,0;;;;;;;;2,0;;;8,0;2,0;1,0;;;2,0;3,0;;;10,0;3,0;;;;8,0;;;;2,0;;2,0;6,0;;1,0;;14,0;;;;5,0;;;17,0;1,0;18,0;;;;5,0;;;1,0;;;;;;2,0;;;;5,0;;3,0;1,0;;;2,0;;;;;;2,0;;;9,0;;;;;2,0;;;;3,0;;3,0;1,0;2,0;;;1,0;1,0;1,0;;4,0;;1,0;;5,0;10,0;5,0;2,0;3,0;;1,0;7,0;;;4,0;;;;;;;;5,0;;6,0;;;1,0;;2,0;;;3,0;;;;;;;;;;;;;;;;;;;;;1,0;;;;;;;;13,0;;;;;;;;;;;1,0;1,0;1,0;;;;;;;;7,0;;;;1,0;;;;;;3,0;5,0;6,0;;;;;;;;;;;8,0;5,0;;;;;;;;;;;;;;;;;;;;3,0;;;;;1,0;;;;;;;;;;;;;;;;;6,0;;;;;;2,0;;;;1,0;;;;;;;;;;;;;;;;;;2,0;;;;;;;;;;;;;4,0;;1,0;;;;;;;1,0;;;;9,0;;;;;;;;;;;;;;;;;;;;;;;;;;7,0;;;;;;;;;;;6,0;;;;;;;;;9,0;;;;;;;3,0;;;3,0;;;;;;;;;2,0;;;;;15,0;;;3,0;;;;;;1,0;;;;;;;;;5,0;;;;1,0;;;;;;;;;;;;;1,0;;1,0;;3,0;;;6,0;1,0;;;2,0;;;;;;;;11,0;;;1,0;;;;;;;2,0;;2,0;;1,0;5,0;1,0;;;;;;;;;;;;;;3,0;;;;;;;;;;;;;;;;;;;;;;;;;;;;;;;;;;;;;;;;;;;;;;;;;;;;;;;;;;;;;;;;;;;;;;;;;;;;;;;;;;;;;;;;;;;;;;;;;;;;;;;;;;;;;;;;;;;;;;;;;;;2,0;;;;;;;;;;;1,0;;;;;;1,0;;;;;;;;;;;;;;;;;;;;;;15,0;;;;;;;;;;;;;;;;;;;;21,0;;;;9,0;;;;;;;;;;;1,0;;;1,0;;;;;;;;;;;;;;;;;;;;;;;;;;;;2,0;;2,0;;;;;;;;;;;;;;;;;;;;;;;;;;;;;;;;;;;6,0;;;;;;;;;;;;;;;;;;;;;;;;;;;;;;;;1,0;2,0;;;;;;;;;;;;;;;;;;;;;;;;;;;
rearview;;1,0;;;;;;1,0;;16,0;12,0;;;;;;;;;;;;;;;;;;;;1,0;5,0;1,0;;;;;4,0;;14,0;1,0;;;;;;;;;;;;;;;32,0;5,0;;;;;;;;;3,0;;;;;;;;;;;;;4,0;;;;;;;;;;;;;;;;;;;;;;;6,0;;;;;;1,0;;;;;;;3,0;;;;;;;;;;;;3,0;;;;;;;;;;;;;;;;1,0;3,0;;;;;;;;;;;;;;;;;;;;;;;;;;;3,0;44,0;2,0;2,0;4,0;;;;;;;;;;;8,0;;;;;;;;;;;;;;;;2,0;;12,0;;;;;;;;;;;;;;;;;;30,0;;;;;;;;;;;;;;2,0;;;;;;;;;;;;;;;;;;;;1,0;;;;;;;;;;;;;;;;;;;;;;;;;;;;;;;;;;;;;;;;;;;;;;;4,0;5,0;1,0;;;;4,0;2,0;;;;;;;;;;;;;;;4,0;;;;;;;;;;;;;;;;;;;;;;;;;;;;;;;;;;;;;;;;;;;;;;;;;4,0;;;;;;;;;;;;;;;;1,0;;;;;;;;;;;;;;;;;;;;;;;;;;;;;;;4,0;;;;;;;;;;;;;;;;;;;;;;;;;1,0;;;;3,0;;;;;;;;;;;;;;;;1,0;;;7,0;;;;;;;4,0;;;;;;;;;;;;;;;;;;;14,0;;;;;;;;;;;;;;;;;;;;;;;;;;;;;;;;;;;;;;;;;;;;;;;;;;1,0;;4,0;;;;;;;;;;;;;;;;;;;;;;;;;;;;;;;;;;;;;;3,0;;;;;;;;;;;;;;;;;;;;;;;;;;;;1,0;;;;;;;;;;;;;;;;;;3,0;;;;;;;;;;;;;;;;;;;;;;;;;;;;;;;;;;;;;;;;;;;;2,0;;;;;;;;;;;;;;;;;;;;;;;3,0;;;;;;;;;;;;;;;;;;;;;;;;;;;;;;;;;;;;;;;;;;;;;;;;;;;;;;;;;;;;;;;;;;;;;;;;;;;;;;3,0;;4,0;;;;;;;;;;;;;;;;;;;;1,0;;;;;;;;;;;;;;;;;;;;;;;;;;;;;;;;;;;;;;;;;;;;;;;;;;;;;;;;;;;1,0;;;;;;;;;;;;;;;;;;;;;;;;;;;;;;;;;;;;;;;;;;;;;;;;;;;;;;;;;;;;;;;;;;;;;;;;;;;;;;;;;;;;;;;;;;;;;;;;;;;;;;;;;;;;;;;;;;;;;;;;;;;;;;;;;;;;;;;;;;;;;;;
receive;;25,0;47,0;4,0;191,0;;55,0;275,0;13,0;246,0;40,0;36,0;4,0;1,0;95,0;9,0;8,0;3,0;109,0;80,0;27,0;374,0;43,0;10,0;7,0;;6,0;893,0;20,0;69,0;61,0;86,0;653,0;6,0;216,0;12,0;29,0;97,0;2,0;154,0;28,0;3,0;49,0;276,0;1,0;4,0;7,0;24,0;36,0;56,0;43,0;122,0;13,0;65,0;2,0;2181,0;335,0;;12,0;913,0;3,0;7,0;371,0;1,0;10,0;37,0;48,0;10,0;5,0;137,0;242,0;16,0;73,0;3,0;6,0;22,0;1,0;55,0;236,0;142,0;3,0;206,0;189,0;33,0;1,0;7,0;131,0;4,0;36,0;94,0;394,0;4,0;14,0;1106,0;35,0;106,0;4,0;38,0;103,0;81,0;239,0;274,0;1,0;73,0;2,0;26,0;23,0;819,0;17,0;7,0;145,0;119,0;80,0;62,0;23,0;5,0;7,0;8,0;53,0;126,0;5,0;;6,0;143,0;;4,0;578,0;29,0;1,0;69,0;77,0;20,0;;9,0;18,0;67,0;25,0;2,0;12,0;50,0;25,0;4,0;140,0;43,0;88,0;46,0;134,0;156,0;1,0;4,0;12,0;87,0;50,0;8,0;39,0;135,0;120,0;141,0;48,0;229,0;42,0;3,0;36,0;12,0;8,0;23,0;20,0;1118,0;11,0;9,0;142,0;35,0;348,0;216,0;38,0;101,0;24,0;155,0;7,0;1,0;15,0;12,0;39,0;24,0;12,0;41,0;71,0;414,0;;519,0;10,0;32,0;114,0;;3,0;49,0;;5,0;23,0;41,0;18,0;24,0;10,0;52,0;23,0;26,0;18,0;14,0;67,0;60,0;15,0;40,0;17,0;;24,0;131,0;261,0;16,0;8,0;1,0;29,0;19,0;4,0;53,0;73,0;7,0;13,0;12,0;4,0;4,0;4,0;;20,0;8,0;17,0;23,0;10,0;19,0;100,0;10,0;323,0;6,0;33,0;51,0;20,0;23,0;67,0;52,0;11,0;35,0;7,0;2,0;24,0;96,0;2,0;3,0;18,0;243,0;4,0;8,0;9,0;72,0;8,0;19,0;41,0;20,0;39,0;10,0;14,0;13,0;9,0;34,0;5,0;5,0;11,0;101,0;26,0;2,0;2,0;45,0;13,0;27,0;16,0;34,0;4,0;31,0;23,0;235,0;46,0;17,0;9,0;;1,0;9,0;11,0;7,0;27,0;41,0;3,0;3,0;32,0;14,0;49,0;15,0;13,0;8,0;16,0;25,0;24,0;84,0;66,0;62,0;;12,0;26,0;8,0;5,0;27,0;31,0;4,0;15,0;70,0;31,0;13,0;;51,0;7,0;32,0;25,0;9,0;241,0;3,0;10,0;;;5,0;4,0;16,0;;2,0;3,0;41,0;2,0;6,0;4,0;13,0;7,0;26,0;30,0;38,0;12,0;167,0;12,0;4,0;3,0;3,0;8,0;;;3,0;11,0;5,0;2,0;4,0;50,0;40,0;27,0;30,0;40,0;10,0;3,0;2,0;;19,0;37,0;63,0;14,0;;;18,0;30,0;65,0;2,0;63,0;15,0;3,0;2,0;;6,0;129,0;30,0;129,0;3,0;5,0;21,0;13,0;39,0;68,0;4,0;12,0;27,0;;6,0;;1,0;2,0;9,0;32,0;10,0;13,0;14,0;19,0;6,0;8,0;20,0;41,0;12,0;6,0;380,0;10,0;49,0;14,0;32,0;50,0;101,0;4,0;4,0;23,0;8,0;101,0;42,0;1,0;9,0;2,0;6,0;10,0;30,0;;89,0;25,0;23,0;11,0;21,0;24,0;28,0;107,0;22,0;52,0;17,0;13,0;2,0;21,0;58,0;72,0;3,0;12,0;28,0;1,0;134,0;5,0;;13,0;10,0;1,0;21,0;67,0;40,0;10,0;71,0;6,0;5,0;49,0;6,0;;20,0;2,0;36,0;62,0;11,0;7,0;19,0;3,0;102,0;20,0;2,0;24,0;35,0;74,0;6,0;28,0;23,0;49,0;32,0;;327,0;36,0;20,0;18,0;3,0;2,0;22,0;7,0;1,0;11,0;66,0;12,0;2,0;2,0;6,0;25,0;108,0;1,0;22,0;77,0;221,0;28,0;40,0;6,0;3,0;2,0;14,0;2,0;27,0;20,0;5,0;10,0;17,0;;;11,0;8,0;5,0;4,0;44,0;93,0;8,0;;7,0;4,0;25,0;;9,0;3,0;3,0;16,0;2,0;21,0;7,0;5,0;11,0;6,0;14,0;3,0;14,0;85,0;4,0;44,0;27,0;7,0;57,0;141,0;5,0;18,0;;;1,0;15,0;;2,0;1,0;15,0;69,0;72,0;8,0;20,0;1,0;70,0;3,0;;19,0;3,0;44,0;61,0;2,0;6,0;93,0;35,0;19,0;1,0;33,0;121,0;13,0;;4,0;6,0;64,0;2,0;8,0;;1,0;11,0;15,0;26,0;1,0;6,0;8,0;7,0;7,0;4,0;1,0;14,0;25,0;6,0;;49,0;2,0;70,0;1,0;11,0;1,0;14,0;;7,0;14,0;2,0;1,0;3,0;11,0;36,0;6,0;;23,0;2,0;13,0;6,0;17,0;182,0;4,0;18,0;8,0;12,0;;4,0;3,0;;4,0;3,0;8,0;23,0;10,0;21,0;16,0;5,0;12,0;13,0;3,0;;23,0;2,0;6,0;24,0;8,0;5,0;;1,0;2,0;;15,0;14,0;9,0;1,0;;16,0;;21,0;15,0;11,0;3,0;12,0;5,0;12,0;6,0;3,0;7,0;31,0;7,0;2,0;12,0;4,0;;;21,0;;;2,0;;19,0;15,0;16,0;10,0;13,0;12,0;2,0;1,0;6,0;7,0;9,0;;;56,0;4,0;3,0;10,0;11,0;8,0;3,0;17,0;7,0;8,0;6,0;;;;15,0;;;11,0;3,0;;2,0;6,0;26,0;25,0;8,0;5,0;33,0;1,0;1,0;6,0;2,0;27,0;4,0;8,0;4,0;;;3,0;4,0;;;20,0;;11,0;5,0;1,0;14,0;3,0;10,0;4,0;13,0;9,0;7,0;3,0;2,0;21,0;5,0;;23,0;3,0;4,0;15,0;4,0;4,0;;2,0;70,0;12,0;12,0;5,0;30,0;11,0;1,0;9,0;3,0;;6,0;35,0;3,0;;;25,0;;;1,0;39,0;;3,0;9,0;;1,0;;13,0;4,0;11,0;3,0;;4,0;2,0;7,0;3,0;2,0;;;8,0;4,0;9,0;13,0;4,0;;;1,0;1,0;10,0;4,0;6,0;6,0;;3,0;3,0;3,0;9,0;15,0;21,0;;2,0;1,0;2,0;12,0;117,0;1,0;3,0;7,0;18,0;30,0;33,0;14,0;;15,0;;7,0;3,0;3,0;10,0;2,0;;3,0;15,0;;4,0;3,0;4,0;22,0;;12,0;16,0;4,0;3,0;1,0;21,0;12,0;2,0;4,0;4,0;;7,0;;14,0;4,0;8,0;2,0;3,0;9,0;2,0;1,0;22,0;5,0;;;5,0;23,0;4,0;20,0;1,0;12,0;;;23,0;;5,0;9,0;7,0;4,0;14,0;2,0;;;1,0;;4,0;;2,0;10,0;1,0;3,0;11,0;1,0;;;;5,0;19,0;8,0;6,0;2,0;11,0;13,0;;53,0;3,0;3,0;14,0;9,0;;;;2,0;;1,0;;2,0;;;2,0;4,0;3,0;1,0;6,0;2,0;;;;13,0;;1,0;3,0;2,0;6,0;;3,0;1,0;;;;25,0;1,0;;1,0;;2,0;1,0;4,0;4,0;8,0;;;4,0;3,0;;;;4,0;1,0;4,0;;14,0;28,0;8,0;6,0;;;26,0;3,0;1,0;;1,0;;;;;3,0
reception;;6,0;;;17,0;;;5,0;;3,0;1,0;;;;;4,0;;;;;;9,0;;;;;;17,0;;17,0;;1,0;35,0;;26,0;;1,0;1,0;;4,0;;;3,0;;;;;;;15,0;3,0;1,0;;;;43,0;12,0;;;11,0;;;6,0;;;;;;2,0;;4,0;;1,0;;;;;2,0;21,0;;;1,0;16,0;3,0;;;;;1,0;8,0;3,0;;;15,0;;;;2,0;2,0;;3,0;11,0;;;;1,0;;69,0;6,0;;2,0;;;;;;;;1,0;2,0;;;;1,0;;;2,0;;;;1,0;2,0;;;;;;;;;;;;;;;15,0;6,0;;;;;;;;2,0;;;;5,0;;;;;;;2,0;3,0;1,0;;2,0;;;;;;;3,0;;;;;1,0;;;;5,0;8,0;;1,0;;;;49,0;;;;;;1,0;;;;;;;;;1,0;1,0;;;;;;5,0;5,0;;;;;;;;;;;;;;;;;;;;;;5,0;;4,0;;;;;;1,0;;;;;;;3,0;;;;6,0;;;;;;;;;;;;;;1,0;;1,0;;2,0;;;;13,0;;;;4,0;;1,0;;13,0;2,0;;;;;;;;;;;;;;;;;;;;;;;;;;;;;;;;;;;;;8,0;;;;;6,0;;;;;;;;;;;;;;;;;;;;;8,0;;;;;;;;;;;;;;7,0;;;;;;;;;;;;;;;3,0;;;;;;;;;1,0;;;;;;;2,0;;;;;;;;;;;;;3,0;;;;;3,0;;;;1,0;;1,0;;2,0;1,0;3,0;7,0;;;;;;;;;;1,0;;;;;;;;;;;;;;;;;;;;;3,0;;2,0;;;;;;;;;;;;;3,0;;;;;;10,0;;;;2,0;2,0;;;;1,0;;;;4,0;;;;2,0;;2,0;;;;;2,0;;;1,0;;;;;;;;;;8,0;;;;2,0;;;;;;;;3,0;;1,0;;;;;;4,0;;;;;;;;;1,0;;;1,0;;1,0;;1,0;;;;;;3,0;;1,0;;;2,0;;;2,0;1,0;;;;;;2,0;1,0;;;;;;;;;;3,0;;;;;;;;3,0;;;;;;;;;;;;;;1,0;;;;;;;1,0;;;;;;;;;;;2,0;;;;;;16,0;;;;;;;;1,0;;;;;1,0;;;;;;;;;;;;;;;;;2,0;;;;;;;;;;;;;;;1,0;;;;;;;;;;;;;;;;;;1,0;;;;;;;;;;;;;;;;;;;;;;;;;;2,0;;;;;;1,0;;;;;;;;;;;;;1,0;;;4,0;;;;;;;;;;;1,0;;;;;;;;;;;9,0;1,0;;;;;;;;;;;;;1,0;;;;3,0;;;1,0;;;;;;;;;;;;;;;;;;;;;;;;;;;;;;;;;;;;;;;;;;;;;;;;;;;;;;;;;;;;;2,0;2,0;;;;;;;;;;;;;;;;;;;;;;;;;;;;;;;;;;;;;;;;;;;;;;;1,0;;;;;;;;;;;1,0;;;;;;;;;;;;;;;;;;;;;;;;;;1,0;;4,0;;;;;;;;;;;;;;2,0;;2,0;;;1,0;;;;;;;;;;;;;;;;;;;;;;;1,0;;;;;;;;;;;;;;;;;;;;;;;;;;;
record;;5,0;16,0;;210,0;;5,0;82,0;10,0;170,0;7,0;1,0;;4,0;37,0;;;1,0;5,0;62,0;43,0;461,0;3,0;30,0;20,0;4,0;1,0;1368,0;3,0;86,0;25,0;60,0;583,0;;181,0;1,0;8,0;16,0;;320,0;16,0;;13,0;60,0;3,0;8,0;;3,0;14,0;84,0;40,0;96,0;7,0;29,0;;2880,0;147,0;;3,0;51,0;;1,0;271,0;;;12,0;206,0;;5,0;191,0;149,0;11,0;84,0;;1,0;34,0;;35,0;77,0;94,0;3,0;122,0;48,0;26,0;5,0;2,0;11,0;9,0;54,0;138,0;61,0;15,0;78,0;242,0;20,0;1,0;2,0;97,0;181,0;2,0;43,0;198,0;2,0;49,0;33,0;7,0;5,0;653,0;;;43,0;4,0;5,0;3,0;12,0;2,0;;3,0;3,0;10,0;3,0;;17,0;37,0;;;59,0;20,0;;18,0;8,0;11,0;1,0;;2,0;2,0;7,0;;;6,0;6,0;1,0;27,0;55,0;18,0;1,0;31,0;118,0;2,0;;5,0;;5,0;;10,0;;1,0;21,0;16,0;124,0;10,0;2,0;;4,0;5,0;3,0;3,0;90,0;138,0;8,0;8,0;8,0;26,0;18,0;25,0;17,0;;81,0;;;10,0;5,0;1,0;6,0;;1,0;16,0;168,0;5,0;99,0;2,0;;;129,0;2,0;3,0;1,0;;11,0;2,0;;3,0;;2,0;;5,0;3,0;;4,0;1,0;6,0;31,0;11,0;3,0;5,0;197,0;37,0;29,0;;1,0;2,0;24,0;1,0;11,0;;1,0;33,0;;;;3,0;;6,0;6,0;5,0;8,0;;13,0;99,0;;;;4,0;1,0;10,0;25,0;1,0;1,0;;;;13,0;;46,0;5,0;;;30,0;13,0;;8,0;3,0;3,0;;1,0;;9,0;;;2,0;2,0;2,0;;1,0;8,0;21,0;4,0;;9,0;7,0;4,0;;1,0;2,0;1,0;57,0;10,0;107,0;32,0;1,0;5,0;;3,0;21,0;3,0;;4,0;46,0;2,0;;18,0;;64,0;1,0;11,0;;;3,0;3,0;4,0;19,0;41,0;4,0;;2,0;;1,0;;;1,0;;19,0;;;;15,0;;;23,0;;49,0;;1,0;2,0;5,0;2,0;;11,0;2,0;;;49,0;7,0;3,0;28,0;24,0;7,0;9,0;6,0;20,0;4,0;23,0;2,0;1,0;;2,0;9,0;1,0;;;;1,0;2,0;;44,0;26,0;1,0;9,0;5,0;;17,0;1,0;;21,0;1300,0;175,0;8,0;2,0;;2,0;44,0;83,0;13,0;73,0;16,0;;5,0;7,0;30,0;;18,0;24,0;;4,0;22,0;35,0;48,0;22,0;30,0;4,0;17,0;;2,0;6,0;1,0;;3,0;6,0;1,0;5,0;;23,0;;6,0;;52,0;8,0;;27,0;2,0;36,0;3,0;16,0;3,0;280,0;6,0;32,0;124,0;14,0;19,0;19,0;4,0;1,0;1,0;7,0;2,0;;3,0;113,0;14,0;40,0;8,0;31,0;;;55,0;67,0;15,0;18,0;2,0;;29,0;42,0;8,0;;38,0;28,0;30,0;51,0;5,0;17,0;17,0;18,0;6,0;37,0;23,0;7,0;14,0;69,0;9,0;;66,0;;;10,0;10,0;10,0;;3,0;30,0;22,0;1,0;12,0;7,0;;5,0;16,0;31,0;5,0;27,0;35,0;68,0;15,0;5,0;439,0;38,0;5,0;;3,0;53,0;10,0;8,0;2,0;2,0;17,0;4,0;15,0;;4,0;2,0;1,0;;3,0;27,0;27,0;6,0;;68,0;1,0;17,0;2,0;;2,0;;12,0;13,0;14,0;1,0;1,0;7,0;14,0;1,0;7,0;5,0;152,0;3,0;;;1,0;17,0;;3,0;6,0;5,0;;4,0;3,0;4,0;42,0;3,0;13,0;133,0;1,0;7,0;35,0;;11,0;4,0;7,0;105,0;85,0;;2,0;6,0;;33,0;1,0;30,0;;5,0;;10,0;11,0;;;13,0;12,0;2,0;;5,0;;23,0;104,0;3,0;7,0;17,0;1,0;29,0;;6,0;7,0;;;4,0;1,0;9,0;;1,0;1,0;3,0;30,0;;19,0;6,0;;;2,0;;;;;22,0;;1,0;1,0;34,0;14,0;16,0;4,0;3,0;8,0;;1,0;17,0;5,0;;2,0;;8,0;1,0;;;2,0;2,0;2,0;;70,0;;3,0;;;5,0;;;;8,0;4,0;1,0;;5,0;22,0;38,0;;;;5,0;;;;2,0;5,0;;3,0;;;3,0;1,0;;;1,0;;;;;1,0;;7,0;;;15,0;;;;6,0;3,0;;;2,0;;;;13,0;10,0;;1,0;;;2,0;2,0;2,0;11,0;2,0;;6,0;;2,0;;1,0;9,0;20,0;;24,0;15,0;23,0;2,0;11,0;;13,0;7,0;2,0;1,0;6,0;;2,0;;4,0;1,0;16,0;;;14,0;16,0;3,0;4,0;;1,0;2,0;;1,0;;11,0;;1,0;4,0;6,0;1,0;17,0;1,0;1,0;;1,0;;6,0;2,0;;;;4,0;2,0;3,0;1,0;;4,0;9,0;3,0;;;7,0;18,0;;9,0;;4,0;2,0;;19,0;;6,0;1,0;;4,0;1,0;1,0;24,0;;4,0;;22,0;1,0;;14,0;;;6,0;7,0;;;1,0;;;3,0;3,0;1,0;;12,0;10,0;2,0;;22,0;8,0;5,0;;2,0;2,0;;3,0;;3,0;5,0;;;;1,0;;1,0;3,0;;;4,0;;2,0;11,0;1,0;;;;;;4,0;;6,0;1,0;4,0;7,0;3,0;;;;7,0;;1,0;;4,0;10,0;;;5,0;;;;;3,0;;;;1,0;16,0;;23,0;;;3,0;5,0;;;;;;;;;;;1,0;1,0;;;;1,0;;;;10,0;;2,0;1,0;34,0;;1,0;5,0;21,0;;;;;;;;;;1,0;8,0;;2,0;;2,0;;;;;1,0;;4,0;;16,0;4,0;;;2,0;;25,0;18,0;1,0;;;1,0;3,0;;;;;;2,0;;;;1,0;;;;;2,0;;;;;;;;;;1,0;;1,0;1,0;;1,0;10,0;1,0;;;4,0;;;;;10,0;;;;15,0;;;;;1,0;;17,0;;;21,0;;;;;;1,0;;;
recorder;;1,0;;;4,0;;1,0;4,0;;5,0;;;;;;;;;;1,0;;4,0;;;;;;7,0;;2,0;1,0;;11,0;;13,0;;;;;6,0;;;4,0;1,0;;;;;;1,0;;4,0;1,0;1,0;;30,0;5,0;;;;;;6,0;;;;;;;2,0;;;;;;;;;6,0;;;1,0;;1,0;;;;;;1,0;1,0;;;3,0;;;;1,0;2,0;;3,0;9,0;;;;;;1,0;;;1,0;;;;;;;;;;;;;;;;6,0;;;;;;;;;;;;;;;;;;;;1,0;;;;;;;;;;;;;1,0;;;;;;;;;;1,0;;2,0;;2,0;;1,0;;1,0;;;;;;;;;;4,0;;;;;;2,0;;;;;;;;;;;;1,0;;;;;;;;;;;;;;;;;;;;;;;;;;;;;1,0;1,0;;;;;;;;;;;;;;;;;;;;;;;;;;;;;;;;;;;;;;;;;;;;;;;;;;;;1,0;2,0;;;;;;;;;;;;;;;;;;;;;;;;;;;;;;;;;;;;;;;;;;2,0;;;;;;;;;;;6,0;;;;;;;;;;1,0;;;;;;;;;;;;;;1,0;;1,0;;;;;;;1,0;2,0;;;;;;1,0;;;;;1,0;;;34,0;;;1,0;1,0;3,0;;;;;;;;;;;;;;;;;;;;;1,0;;;1,0;;;;;1,0;;;1,0;;6,0;3,0;;;;;;;;;7,0;;;;;;;;;;;1,0;;1,0;;;;;;;;;;;;;;2,0;;;2,0;1,0;;1,0;;;;;1,0;;;;;;;;;;1,0;;;2,0;;1,0;;;29,0;;;;;;;;;;;;;;;;;;;;2,0;;;;;;;;;;;;3,0;;;1,0;;;1,0;;;;;;3,0;;;;;;;;;;;;;;;;2,0;;2,0;;;9,0;1,0;;;;;;;;;;;1,0;;;;2,0;;;;;;1,0;;;;;;;;;;;;;;;;;3,0;;1,0;;;;;;;;;;;;;;;;;;;;;;;;;;;;;;2,0;;;;;;;;;;;;;;;;;;;;;;;;;;;;;;1,0;;;;;;;;;;;;;;;;;;;;;;;;;;;;;;;;;;;;;;2,0;;;;;;;;;;;;;;;;;;;;;;;;;;;;;;;;;;;;;;;;;;;;;;;;;;;;;;;;;;;;;;;;;;;;;;;;;;;;;;;;;;;;;;;;;;;;;;;;;;;;;;;;;;;;;;;;;;;;;;;;;;;;;;;;;;;;;1,0;;;;;;;;;;;;3,0;;;;;;;;;;;;;1,0;;;;;;;;;;;;1,0;;;1,0;;;;;;;;;;;;;;;;;;;;;;;;;;;;;4,0;;;;;;;;;;;;;;;;;;;;;;;;;;;;;;;;;;;;1,0;;;;;;;;;;;;;;;1,0;;;;;;;;;;;;;;;;;;;;;;;;;;;;;;;;;;;;;;;;;;;;;;;;
register;;9,0;9,0;;18,0;;;16,0;10,0;13,0;1,0;9,0;1,0;1,0;4,0;3,0;3,0;6,0;2,0;1,0;1,0;88,0;;5,0;;3,0;;61,0;5,0;7,0;5,0;14,0;37,0;2,0;20,0;2,0;;31,0;;29,0;4,0;;;;5,0;;;;1,0;10,0;;15,0;3,0;12,0;;171,0;23,0;5,0;1,0;14,0;;;37,0;;;2,0;;;;11,0;1,0;15,0;;;;23,0;;2,0;5,0;3,0;;9,0;4,0;2,0;;;6,0;;;19,0;27,0;91,0;12,0;48,0;1,0;;;48,0;61,0;;;18,0;;40,0;;;1,0;90,0;;;1,0;4,0;4,0;;15,0;;;;;;;;;33,0;;2,0;25,0;;;1,0;;2,0;;;;10,0;6,0;;9,0;;;;7,0;36,0;8,0;;2,0;9,0;;;;;;;;;;;;16,0;;1,0;;2,0;2,0;2,0;13,0;42,0;2,0;;24,0;;15,0;;4,0;;;76,0;;;;;;2,0;;;1,0;20,0;;10,0;;;7,0;19,0;;10,0;;;;;;;;4,0;;22,0;59,0;;10,0;2,0;;2,0;7,0;1,0;1,0;23,0;12,0;;;;2,0;;;10,0;;;;;;;;;;1,0;3,0;;4,0;2,0;11,0;;6,0;;1,0;;;;2,0;1,0;;;7,0;;;31,0;;;;1,0;;;1,0;7,0;1,0;;;;;;;;;1,0;;;;;1,0;;;;1,0;;;;;15,0;;13,0;1,0;;1,0;4,0;;1,0;;;2,0;24,0;;;;;19,0;;;;;5,0;;;;11,0;;;;1,0;;;;;;2,0;;;;;;;1,0;3,0;48,0;;;;;3,0;;2,0;4,0;4,0;1,0;4,0;1,0;2,0;;;;;;1,0;;6,0;1,0;;3,0;;;;;;1,0;;;;5,0;7,0;;;7,0;;2,0;;;;5,0;43,0;3,0;1,0;;;17,0;1,0;;;14,0;;;2,0;;22,0;;4,0;;2,0;20,0;;2,0;2,0;;;3,0;;4,0;;;8,0;;;;;;2,0;2,0;13,0;;4,0;4,0;;27,0;;;2,0;;1,0;40,0;;;12,0;;19,0;6,0;;;;1,0;;4,0;;;;;2,0;1,0;;12,0;5,0;4,0;2,0;6,0;10,0;;5,0;13,0;2,0;;2,0;5,0;2,0;5,0;1,0;;4,0;;;;;;;25,0;;1,0;6,0;;;;2,0;7,0;;1,0;23,0;;;;2,0;;1,0;2,0;;5,0;18,0;;7,0;29,0;;14,0;8,0;;;6,0;;1,0;3,0;;1,0;;4,0;;;;;;;;5,0;7,0;;;1,0;7,0;;;;11,0;;2,0;;;;2,0;;;1,0;;1,0;1,0;;;;3,0;2,0;;4,0;;;;;;;43,0;;2,0;4,0;;;14,0;1,0;1,0;1,0;2,0;;25,0;16,0;;7,0;;65,0;3,0;;;;;;3,0;;;;13,0;;;;;24,0;2,0;12,0;;4,0;;;;;;;1,0;;2,0;24,0;;;;;;;;;;3,0;;;;;;8,0;;;;;;;;2,0;17,0;;;1,0;;;;;1,0;;;;;;;;;;1,0;;2,0;;;5,0;;5,0;;;;2,0;7,0;;;;;;;;;;;;1,0;;;;;;;;;;;2,0;43,0;;;;;;2,0;;;;;;;;9,0;;;2,0;4,0;;;;;37,0;;4,0;;;;;;;;;;6,0;1,0;;;3,0;1,0;;1,0;;;;;;;;;1,0;;;;;;1,0;;;;16,0;;;4,0;;;1,0;;;;;1,0;9,0;;;;;;8,0;;;;8,0;;;;1,0;4,0;1,0;2,0;1,0;2,0;;3,0;1,0;;;;;;6,0;1,0;;;;1,0;;6,0;47,0;;;;;;;3,0;;1,0;;1,0;;;;;;;;;;;1,0;;;;;;;;;;;;;;;18,0;1,0;;;;;;;;;;2,0;;;;;;;;;;1,0;;;;;9,0;;;;;;5,0;3,0;;;;1,0;;;;3,0;;;;;;;;;;;1,0;;;;;;;;;;20,0;;;;;;;3,0;;;3,0;;2,0;;;;1,0;;1,0;;;;;;;1,0;;1,0;;;;;;;;;;;;;;2,0;2,0;2,0;;;;;7,0;;;;;;;;;3,0;;;;12,0;1,0;;;;;1,0;;;;;;;;;;;;;;;;;;;;;;2,0;;;;;;;;;;11,0;;;;;;;;;;;1,0;;4,0;;;;;
release;;2,0;;;5,0;;1,0;5,0;;15,0;1,0;;;;;;;1,0;2,0;4,0;9,0;16,0;;;;;;8,0;;28,0;2,0;12,0;25,0;;39,0;;1,0;9,0;1,0;18,0;1,0;;5,0;6,0;;;1,0;;6,0;;1,0;8,0;;3,0;;66,0;23,0;;2,0;18,0;;;4,0;;;4,0;5,0;;;97,0;4,0;3,0;1,0;1,0;;;;2,0;48,0;2,0;2,0;3,0;2,0;;;;1,0;;5,0;1,0;6,0;;18,0;51,0;;;;;12,0;1,0;9,0;21,0;;;;3,0;2,0;22,0;;;1,0;1,0;;5,0;5,0;;;;1,0;14,0;;;;7,0;;;27,0;9,0;;6,0;3,0;;;;;10,0;1,0;;;3,0;6,0;;;6,0;;5,0;;7,0;;;;;6,0;2,0;;1,0;1,0;4,0;5,0;5,0;;;1,0;1,0;;1,0;;11,0;1,0;1,0;46,0;10,0;7,0;10,0;3,0;8,0;;3,0;;;2,0;;1,0;;12,0;;9,0;7,0;;47,0;;;;30,0;;;;4,0;9,0;3,0;;2,0;1,0;3,0;;7,0;;;2,0;4,0;;1,0;;;3,0;21,0;7,0;;;;;1,0;;;;;;;;;;8,0;2,0;6,0;2,0;1,0;;;5,0;8,0;;;;;5,0;3,0;;;;1,0;;;;3,0;;;;4,0;2,0;;;2,0;;3,0;19,0;17,0;4,0;;;1,0;4,0;2,0;;7,0;;1,0;;8,0;;3,0;20,0;;;28,0;;;7,0;;12,0;;;;;;1,0;;;14,0;;;3,0;2,0;8,0;;2,0;1,0;1,0;2,0;;6,0;;;1,0;6,0;1,0;;3,0;;;;;3,0;9,0;1,0;;3,0;;18,0;4,0;;6,0;;5,0;1,0;;;;;;;;2,0;;;;7,0;;6,0;;4,0;2,0;19,0;;;;1,0;;;;;;;;;1,0;4,0;2,0;;4,0;;;;;;1,0;1,0;;;;;6,0;1,0;6,0;;1,0;2,0;;;;18,0;;32,0;;;167,0;2,0;8,0;;;;;;;;;;;2,0;1,0;8,0;;10,0;;;;4,0;2,0;;11,0;;2,0;3,0;;;20,0;;;1,0;;;;;;3,0;2,0;2,0;;;;;223,0;;;;2,0;;;;;1,0;;6,0;;6,0;1,0;;;5,0;23,0;;;;4,0;;;2,0;3,0;3,0;1,0;;;25,0;;;;;2,0;;;;;;4,0;5,0;;5,0;1,0;;1,0;9,0;;35,0;;5,0;;6,0;;;;1,0;;;;;;1,0;;;;;;1,0;;;2,0;2,0;;;;;1,0;5,0;;;;1,0;19,0;;;;;;;;;1,0;3,0;1,0;;;;;;;;;1,0;;;;;;;;;;4,0;;;1,0;;3,0;;;;;;;1,0;;;;;;;;3,0;;;;;;6,0;;;2,0;;;;6,0;;;;2,0;;4,0;;;1,0;;;4,0;11,0;1,0;1,0;;;;;;;;;;;;;1,0;;;;;;1,0;;1,0;;;;;;2,0;;1,0;;;;;;;;;;1,0;;;;;;;1,0;;;;;;;2,0;;;;;;;;;;2,0;;1,0;9,0;;;;;;;;;;;;;;;;;3,0;;;;;;;;;1,0;;;;5,0;;;;;;;;;2,0;;5,0;;;3,0;;;17,0;;;;;1,0;1,0;;;;;;;;;1,0;4,0;;;;;;;;;;;2,0;;;;2,0;;;;;;;;;;3,0;2,0;;;;1,0;;;;;;7,0;1,0;;;;;8,0;;3,0;3,0;;;;;1,0;;;2,0;3,0;;;;;;;1,0;;;;;3,0;;;;;;;;;;;;;;;;;;;;;;3,0;;1,0;;2,0;1,0;;2,0;2,0;17,0;;2,0;;;2,0;;;;;;;;;;;;;;2,0;31,0;1,0;;;;;;;3,0;;;;10,0;;;;5,0;;;2,0;;;;;;;;;;;;;;;;;;;;;;;;;;;1,0;;;;;1,0;;;;;;;;;;;;3,0;;;;;;;;;;;1,0;3,0;;;;1,0;;;;;;;;;;;;;;;;;;;;;;;;1,0;;;;;;;;;;;;;;;;;;;;;;;1,0;;;;;;;;;;;;;;;;;;;;;;;
remote;;3,0;1,0;1,0;48,0;;13,0;32,0;;28,0;41,0;1,0;;;;;;;3,0;12,0;3,0;196,0;;;;;;78,0;1,0;8,0;;6,0;177,0;;54,0;2,0;5,0;5,0;1,0;86,0;6,0;1,0;3,0;3,0;;;6,0;1,0;1,0;2,0;2,0;10,0;;2,0;;100,0;52,0;;;8,0;;;83,0;;;2,0;1,0;;3,0;64,0;8,0;;4,0;;;1,0;;1,0;27,0;7,0;3,0;16,0;7,0;2,0;;;1,0;;1,0;6,0;8,0;;2,0;161,0;;12,0;3,0;12,0;4,0;4,0;6,0;175,0;;3,0;;6,0;2,0;75,0;;;3,0;;3,0;22,0;4,0;24,0;;;;10,0;;3,0;1,0;4,0;;;19,0;;;11,0;;1,0;;;1,0;4,0;9,0;;;5,0;;1,0;16,0;5,0;;;2,0;7,0;2,0;;;;;;;;;5,0;19,0;15,0;;;1,0;;;;;38,0;1,0;1,0;1,0;1,0;10,0;9,0;7,0;2,0;;6,0;;;1,0;1,0;11,0;1,0;1,0;;1,0;47,0;1,0;3,0;;;2,0;70,0;;;;1,0;31,0;;;6,0;1,0;10,0;;;;;3,0;6,0;;6,0;2,0;;5,0;5,0;52,0;1,0;;;;6,0;;1,0;;;1,0;;1,0;;;;;;1,0;1,0;;;5,0;1,0;;1,0;;;1,0;;10,0;4,0;;;;4,0;;13,0;1,0;;;5,0;;;;;;;1,0;;4,0;;;;;2,0;2,0;;2,0;12,0;;;2,0;49,0;;;;1,0;;4,0;3,0;10,0;10,0;1,0;;;;2,0;;;;4,0;;;2,0;;2,0;2,0;7,0;;;3,0;2,0;;;;;1,0;1,0;;2,0;;;1,0;;;4,0;;;17,0;;;1,0;;24,0;;;;;;;;1,0;;1,0;6,0;;;;;;4,0;;2,0;2,0;15,0;22,0;;;;;;;;;;;;;;1,0;2,0;;2,0;;;;;;10,0;;;;6,0;2,0;;3,0;;5,0;;;;;14,0;;11,0;;1,0;51,0;;;2,0;1,0;;1,0;4,0;3,0;;;;;12,0;;6,0;;7,0;1,0;;3,0;3,0;3,0;;8,0;1,0;120,0;;1,0;36,0;6,0;9,0;;;2,0;7,0;2,0;;4,0;;;4,0;10,0;1,0;27,0;1,0;1,0;;5,0;1,0;3,0;68,0;;2,0;;;;1,0;4,0;47,0;;2,0;2,0;2,0;8,0;3,0;;;3,0;;10,0;127,0;;4,0;1,0;1,0;;8,0;2,0;;2,0;;2,0;5,0;2,0;;;;6,0;2,0;;;12,0;3,0;;3,0;3,0;4,0;;1,0;236,0;42,0;5,0;;;;;;;;;2,0;;;;;;;;;27,0;6,0;14,0;;2,0;;;6,0;;;;1,0;7,0;;;;2,0;;;1,0;2,0;;;;4,0;;;;;;;2,0;3,0;4,0;;;;1,0;;;33,0;;;1,0;3,0;2,0;3,0;;;;2,0;;2,0;;;3,0;;3,0;17,0;14,0;;4,0;2,0;;;55,0;;3,0;5,0;;10,0;24,0;;;;;52,0;;;;1,0;;1,0;;;;;;2,0;1,0;6,0;;;2,0;7,0;;;;;;;;;;;;;;;5,0;1,0;;;;16,0;1,0;;5,0;;3,0;3,0;;;2,0;;;;;;;;;;;;;4,0;;;;;8,0;;;;1,0;;;14,0;;;;;;;;;;3,0;;2,0;1,0;;;;2,0;;;;;1,0;;;;1,0;;;;;;;;;2,0;;;;;4,0;1,0;;;;;1,0;2,0;;;;1,0;;;;1,0;;;;;;3,0;;2,0;;;2,0;;;9,0;1,0;;1,0;;;;1,0;;;;2,0;1,0;;;;;;;;1,0;;;;;2,0;;;;;;1,0;;;;;;;;;;;;;22,0;;;;;;;;1,0;;11,0;;;;;20,0;;;5,0;11,0;;;;;;;;;;13,0;1,0;;1,0;;;;;2,0;2,0;;2,0;;;;;1,0;1,0;1,0;1,0;;;;;;4,0;;;4,0;;;;;;33,0;;;15,0;;49,0;2,0;;;;;;;;;;;;4,0;;;;;;;;;;;;;;;1,0;;;;;;;;;;1,0;;30,0;;;;;;1,0;;6,0;;;1,0;;5,0;;5,0;;;;;;;;1,0;;;;;1,0;;;;;;;;;2,0;1,0;;;;;;1,0;;;6,0;;;;;;;;;;;;;;;;;;;;;2,0;;;;;;;;1,0;;;;;;;;;;;;1,0;;;;3,0;21,0;;;;;1,0;;;;;1,0;;;;;;;;;;;;;
removable;;7,0;;;4,0;;9,0;2,0;;2,0;;1,0;;;;;;;;;;11,0;;;;;;14,0;;;;;26,0;;11,0;;;5,0;;4,0;;2,0;1,0;104,0;;;;;1,0;;1,0;;;5,0;;19,0;15,0;;;24,0;;;8,0;1,0;;;5,0;;;;94,0;;1,0;;;;;;18,0;;;;;;;;;;;;2,0;;;1,0;;;;11,0;7,0;;5,0;11,0;;;;;;12,0;;;2,0;1,0;;6,0;7,0;;;;;13,0;;;;;;;10,0;1,0;;1,0;14,0;;;;;;2,0;;;;;;4,0;;;;1,0;5,0;;4,0;;;;;5,0;6,0;;3,0;;6,0;;;1,0;1,0;;;;;3,0;;5,0;;;31,0;1,0;5,0;;;;;;1,0;;1,0;;;18,0;6,0;;4,0;2,0;;;1,0;;;;;;3,0;;;1,0;;2,0;1,0;;;2,0;9,0;;1,0;3,0;;;;;;;;;1,0;;;1,0;;;;;;1,0;;;;;;;;1,0;;;;;3,0;;;;;;;;;;4,0;;;;;1,0;;;;;;5,0;;;;;;;3,0;;;5,0;;;;;1,0;;;;7,0;;;4,0;;;;;;;;;;;4,0;7,0;;3,0;;;;;;;;6,0;5,0;;;6,0;14,0;8,0;;;;;1,0;;;;;;;1,0;;;;5,0;;;;;;;2,0;;;;1,0;;;;;;7,0;;5,0;;;;;;;;;2,0;;;;;;;;;;;;;;;;10,0;63,0;1,0;;;;;;;1,0;;;;;;16,0;1,0;;;;2,0;;;;;;;;;;;;;;;;;1,0;;;;;;;;;8,0;;;9,0;;;;8,0;1,0;;;;;;;;;;;;;;39,0;;3,0;;;;;;;;1,0;1,0;;;;;;;;;;;;;26,0;;;;;;;;2,0;;2,0;;;;;;;;;;;;;4,0;;;;1,0;;;;;;;;;;;;8,0;;;;4,0;;;;;;;6,0;;;;;;;;;;;;;;;;;;4,0;;1,0;;;;;1,0;;1,0;;;;;;;;4,0;;;5,0;;2,0;;1,0;;;;;;;;;;;1,0;;;;;;;6,0;;;;;;2,0;;;;;;;;;;;;;;;;;;;;5,0;;6,0;;5,0;;;;3,0;3,0;;;;;;;;;;;;;;;;;;1,0;;;;1,0;;;;;4,0;2,0;;;;;;;;;;;;;;;;;;4,0;;;2,0;;;;;4,0;;;;;;;;;;1,0;;;;;;;;;;;;;;;;;;;;;;;1,0;;;;;;;;;;;;;;;;;;;;;;;;;;;;;;;;;;;;;;;;;;;;;;1,0;;;;;;;;;;;;;;;;;;;;;;;;;;;;3,0;;;1,0;;;;;;1,0;;;;;;;;;;;;;;;;;;1,0;;;;2,0;;;;;;;;;;1,0;;;;;;;;;;;;;;;;;;10,0;;;;;;;1,0;;;;1,0;;;;;;;;;;;;;;;;;;;;;;;1,0;;;;;;;;;;;;;;;;;;1,0;;;;;;;;;;;;;;;;;;;1,0;;;;;;;;;;;;;;;;1,0;;;;;;;;;;;;;;;;;;;;;;;;;;;;;;;;;;;;;;;;;;;;;;;;;;;;;;;;;;;;;;;;;;;;;;;;;;;;;;;;;
removably;;11,0;;;8,0;;;3,0;;;;;;;;;;;4,0;;;2,0;;;;;;3,0;;;;;13,0;;10,0;;;2,0;;1,0;;;;2,0;;;;;;;;;;;1,0;8,0;1,0;;;41,0;;;2,0;;;;4,0;;;;;;;;;1,0;;;3,0;6,0;;3,0;4,0;1,0;;;;;;;4,0;;;1,0;;1,0;;8,0;2,0;;;4,0;;;;;;26,0;;;2,0;3,0;;9,0;38,0;;;;1,0;48,0;;;;;;;1,0;1,0;;15,0;7,0;;;;;;2,0;1,0;;;;;1,0;;;;6,0;1,0;;5,0;;1,0;;;;2,0;4,0;6,0;5,0;9,0;;;;;;;;1,0;;;14,0;;37,0;39,0;;4,0;;1,0;;;;;;;;;3,0;1,0;;2,0;;;;11,0;;;;;;15,0;;2,0;1,0;5,0;;;;;;5,0;;;;;;1,0;;2,0;;;1,0;;;;5,0;;;;;;;;;;;;1,0;;;;2,0;;;1,0;1,0;;;;;;;;;8,0;1,0;;;;;;;;;;;;;;;;;8,0;;;3,0;;;;;;1,0;;;;;;;2,0;1,0;;3,0;;;;;1,0;;2,0;;;2,0;;1,0;;;;;;2,0;;;1,0;;;2,0;;;;2,0;2,0;;;1,0;;;4,0;;3,0;2,0;;;;;;;;;;;;;1,0;;;;;;;;;1,0;;;;;;;;;1,0;;;;;;;;;;;;;;;6,0;;;;;;;1,0;;;;;;;;4,0;;;;;;;;1,0;;;;;;;;;;;;;;1,0;;;;;;;;;1,0;;;;1,0;;;;;;;;;;;;;;;3,0;;;;;;;2,0;;;;;;;;;;;;;;;;;;;;1,0;;;;;;;;;;;;;;;;;;;;1,0;;;;;;;;2,0;;;;;;;;;;;4,0;;;;;6,0;;;;5,0;;;;;;;4,0;;2,0;;;;;;;;;;;;;;1,0;;;;;;;;;;;;;;1,0;;;;;;;;;;;2,0;;1,0;;;;;;;;;;;;;;;;;;;;;;1,0;;;;;;;1,0;;;1,0;;1,0;;2,0;;;;4,0;;14,0;5,0;;;;;2,0;;;;;;;;;;;;;2,0;;1,0;;;;;8,0;;1,0;;2,0;;;15,0;;;3,0;1,0;;;;;;;;1,0;;;;;;1,0;;;;;;;;;;2,0;;;;;;;;2,0;;;;;;;;;;;;;;;;;;;;;;;;;;;;;;;;;;2,0;;;;;;;;;;;;;;;;;;;;;;;;;;;;;;1,0;;;;;;;;;;;;;;;;;;;;;;;;;;;;;;;;;;;;3,0;;;;;;;;;;;;;;;;;;;;;;;;1,0;;;;;;;;;;;;;;;;;;;;;;;;1,0;;;1,0;;;;;;;;;;;;;;;;1,0;;;;;;;;;;;;;;;;;1,0;;1,0;;;;;;;;;;4,0;;;;1,0;;;;;;;;1,0;;;;;1,0;;;;;;;;;;1,0;;;1,0;;;;;;;;;;;;;;;;;;;;;;;;;;;;;;;;;;;;;;;;;;;;;;;;;;;;;;;;;;;;;;;;;;;;;;;;;;;;;;;;;;;;;1,0;;;;;;;;;;;;;
require;;3,0;22,0;;5,0;;;18,0;10,0;13,0;4,0;1,0;;;;;1,0;;;2,0;;15,0;;;28,0;;2,0;25,0;4,0;1,0;;22,0;12,0;;7,0;;;;;;1,0;;1,0;1,0;;1,0;;2,0;32,0;;;1,0;4,0;;2,0;66,0;;;2,0;20,0;;;17,0;;1,0;5,0;10,0;;;7,0;7,0;2,0;1,0;;;2,0;;19,0;11,0;8,0;1,0;15,0;3,0;8,0;6,0;;1,0;;5,0;5,0;8,0;;3,0;4,0;1,0;3,0;;;4,0;2,0;1,0;14,0;;;;;;26,0;;;;;2,0;1,0;1,0;1,0;;;;4,0;;;;1,0;;;2,0;;;;5,0;;;;1,0;;1,0;;;5,0;;;1,0;1,0;;;;12,0;;2,0;;;;;4,0;;;;;2,0;1,0;1,0;;;1,0;;;21,0;;;4,0;1,0;;8,0;3,0;;;11,0;;;;;;;;3,0;;6,0;;4,0;;;1,0;1,0;;;;;6,0;2,0;;;;1,0;;;1,0;;1,0;1,0;;;;1,0;7,0;85,0;4,0;;;;;1,0;;1,0;;1,0;;1,0;;;1,0;;3,0;;2,0;8,0;;3,0;7,0;;;;1,0;;;3,0;;1,0;;;;6,0;;;;;;2,0;1,0;;;13,0;;;;;1,0;;;;;;;;;;;;1,0;5,0;;;;;;24,0;;6,0;4,0;;;;3,0;;;;;11,0;;;;;13,0;;;;;13,0;;;4,0;;;;;;;;;;;1,0;;;;;;;;;5,0;;;;;;2,0;1,0;;1,0;;3,0;;;28,0;;2,0;;;4,0;;1,0;8,0;;;1,0;;;3,0;;11,0;;;;;2,0;;;;5,0;10,0;;;6,0;1,0;2,0;3,0;;;1,0;19,0;;;2,0;;;3,0;1,0;;3,0;;;;;;;12,0;5,0;1,0;;1,0;;;;;;;4,0;1,0;2,0;;;;;;5,0;3,0;;1,0;11,0;1,0;;;;;;1,0;1,0;3,0;;;;;8,0;;;;1,0;;;1,0;;1,0;2,0;1,0;2,0;;3,0;4,0;;;5,0;2,0;1,0;1,0;;;;8,0;1,0;;;;;;2,0;;;1,0;;;9,0;;;;;5,0;;;;2,0;;;;;2,0;;;;1,0;;;;;1,0;4,0;;;;;;;;;;1,0;;;;;;1,0;;;2,0;2,0;;;;;;;;7,0;;7,0;;;;;;;;;;;;;;;;;1,0;;;;;;;;2,0;;;1,0;2,0;;1,0;;;3,0;4,0;;;1,0;;;4,0;;;;;4,0;;;;;;;;;;;4,0;;;;;;;;1,0;;;;;;;;;;1,0;;20,0;;;1,0;;;;;;;;;;;;;;;;;;1,0;;;;;1,0;;;;;5,0;1,0;;;;;;;4,0;;2,0;;;;;;;1,0;;;;;;;;;;1,0;;;;;;;;;;2,0;;;;3,0;;;;;;;;3,0;;1,0;;;;7,0;;;5,0;1,0;;1,0;;;3,0;;2,0;1,0;;;;;;1,0;;4,0;1,0;;;;2,0;;;;;5,0;;;4,0;;;;;;2,0;;;3,0;;;;;;;;;1,0;;;;;4,0;;;;;;;;;1,0;;;;;1,0;;;2,0;;;8,0;;;;;;6,0;;;;2,0;1,0;1,0;;;;;;;;;;;;;;;;;;;;;;;;;;;;;;;;1,0;;1,0;;;;;;;;;;;;1,0;;2,0;11,0;;;;;;;;;;;3,0;;;;;;;;;;;;;;;;;;;1,0;;;;;;;;;;;;;3,0;;;;;;1,0;;;;;;;;;;;;;;;;;;3,0;3,0;;;;;2,0;8,0;;;;;;;;;;;9,0;;;4,0;;;1,0;;;;;12,0;;;;;1,0;;;;;;;;1,0;;;;;;;;2,0;;;;;;;;;;;;;;;;;;;;;;;;;;;;;;4,0;;;;;;;;;;;;;;;;;;;;;;;;;;;
reset;;6,0;1,0;;7,0;;;4,0;;;;1,0;;;;;;;9,0;;6,0;50,0;;;;;;2,0;;2,0;12,0;4,0;43,0;1,0;4,0;;;2,0;1,0;3,0;;;;6,0;;;;;4,0;;6,0;7,0;2,0;;;36,0;23,0;;;24,0;;;11,0;;;;;;;47,0;3,0;;;;;;;1,0;7,0;12,0;;;1,0;1,0;;;17,0;;1,0;7,0;7,0;16,0;;160,0;;;;5,0;8,0;8,0;4,0;8,0;;19,0;;;7,0;98,0;;;4,0;5,0;6,0;;1,0;;1,0;;;6,0;;;;21,0;;;14,0;;;3,0;;2,0;;;;;8,0;;10,0;;;;;;;;1,0;;;;;;;;7,0;;1,0;;;22,0;;1,0;;;;1,0;5,0;;;;;;2,0;;;;;20,0;;;;;;;;;;30,0;;23,0;;;;14,0;;;;;;;1,0;;;8,0;;;2,0;;;;;;;;;36,0;4,0;;;;;;;;;;;;;;;;;1,0;2,0;;;6,0;31,0;;9,0;;18,0;;;;2,0;;;;2,0;;1,0;34,0;2,0;;;;;;;10,0;;;;;1,0;;;;;9,0;;3,0;;;;1,0;;;;;;9,0;;;;1,0;;5,0;;;3,0;;;;21,0;2,0;;;;;1,0;;;;;1,0;;;7,0;2,0;;;;;;;;;;2,0;;;;3,0;;1,0;49,0;;3,0;2,0;;;;5,0;;;2,0;;;;2,0;2,0;;2,0;;;;25,0;;;1,0;2,0;;;;;;;3,0;;;3,0;1,0;6,0;;;5,0;;;;;;;;;8,0;;;13,0;28,0;;;44,0;;;;;8,0;;13,0;;;4,0;;5,0;;5,0;;;;2,0;;;;;1,0;;;;;3,0;1,0;;;;;13,0;;6,0;;;;2,0;;;14,0;;;1,0;;;;;;6,0;;;;;;;2,0;;5,0;25,0;2,0;7,0;;;;1,0;;;;;;3,0;;;;;2,0;;1,0;;;;;;14,0;;;;;1,0;;;;17,0;;;;;;;1,0;2,0;22,0;;36,0;;1,0;1,0;;;50,0;;;;4,0;;4,0;;4,0;;;;;;;;;;;;;;;;;2,0;;;;;;;;;;;;2,0;;;;;;;;;;;;;1,0;;;;;;;;;;;;;69,0;24,0;;;;1,0;;2,0;;;;;;;;;;;;;;;1,0;;3,0;10,0;;;;;;;;;3,0;35,0;;;;;;;;;;;9,0;9,0;;;;;;;;;;;;;;;;2,0;;;;;;;;1,0;;5,0;;;;2,0;;;;;;;;;;;;;;;;;;;;;;;1,0;;;;;3,0;2,0;;;;;;;;4,0;;;;6,0;;12,0;14,0;;;;10,0;5,0;;12,0;24,0;1,0;17,0;;;;46,0;35,0;2,0;;;4,0;3,0;38,0;;;1,0;1,0;;4,0;;1,0;;1,0;14,0;;;175,0;;1,0;;;;;;;;;3,0;;;;9,0;;2,0;1,0;;;;;;;;;3,0;;;;;3,0;1,0;;;1,0;;;;;;;;2,0;;;1,0;1,0;;;1,0;;3,0;;;;;;;;;;;;;;;1,0;;10,0;;;;1,0;;;;;;;;;;;;;;;;;;;;;;;;;;;;;;8,0;;;;;;;;1,0;;;;;;;;;;;;;;;;1,0;;25,0;;;1,0;;;;;2,0;;;;9,0;;3,0;1,0;;;;;;;;;1,0;;;;;;7,0;4,0;;;;;;;;;;;;;;;;1,0;;;;;;;;;;;;;;;;;;;;;;;;;;;;;;;;1,0;;;;;1,0;;1,0;;;;;;;;;;;;;;;;;;;;;;;;;;;;;;;;;;;1,0;;;;1,0;;;;;;;;;2,0;;;;;;;;;4,0;;;;;;;;;;
rigid;;3,0;;;10,0;;2,0;8,0;;;;;;;;;;;3,0;;;1,0;;;;;;;;;;2,0;4,0;;;;;;;;1,0;;5,0;1,0;;;;;;;;6,0;;3,0;;1,0;16,0;;9,0;6,0;;;5,0;;;;;;;;;;;;;;;4,0;;;;3,0;;;;;;12,0;;;;;;1,0;1,0;1,0;;;;3,0;2,0;2,0;;;;;;10,0;;;1,0;;1,0;9,0;1,0;;;;31,0;;;;;29,0;3,0;;1,0;;;10,0;1,0;;;;;1,0;2,0;;;;;;;5,0;;;9,0;9,0;;;;;;;;;;3,0;;4,0;;;;1,0;;3,0;;2,0;;3,0;9,0;;1,0;20,0;;;;;;;5,0;;2,0;;9,0;4,0;1,0;3,0;;28,0;;;3,0;;;;;;;2,0;;2,0;;;;;1,0;;2,0;1,0;;;3,0;;;;;2,0;;;;;6,0;;2,0;;6,0;;;;;;;1,0;;8,0;;3,0;1,0;;2,0;;2,0;;;1,0;;;;;;;1,0;2,0;;;;1,0;;;;;;;;;1,0;;;;8,0;;;1,0;;;;;;;;;8,0;;;3,0;;2,0;;2,0;;;;;;;;;1,0;;;;;;;;;;;;;4,0;;;;;6,0;;;;;;;;;;;;;;;;23,0;;;;;;;;1,0;;;;;;;;;;;;;;;;;;;;;;;;;;;;;;;;;;;;;;;;;1,0;;;1,0;;;;;;;;;;;;;;;;4,0;;;;;;2,0;;;;;2,0;;;;;;;;;;;;;;;;;;;;;;;;;;;;;;;;;2,0;;;;;;;;;;;;;;;;;;;;;;;;;;;2,0;;;;;28,0;;4,0;;;;;;;3,0;;;;;;;;;;;;;;;;;;;2,0;;;;;;;;;;;1,0;1,0;;;;;4,0;;;;;;6,0;;;;;2,0;;;;;;;;;;;2,0;;;;;;;;;1,0;;;;;;;;;;;;12,0;;1,0;;;;1,0;;;;;;;;;;;;;;;1,0;;;;;;;8,0;;;;;;4,0;;;;;;;;;;1,0;;;;;;;;;;;;;;;;;;2,0;1,0;;;;6,0;;;;;;;8,0;2,0;;;;;;;;;;;;;;1,0;;;;;;;;;;;;;;;;;;;;;4,0;;;;;;;;;;;;;;;;;;;;;;;4,0;;;;;;;;;;;;;;;;;;;;;;;;;;;;;;;;;;;;;;;;;;;;;;;;;;;;;;;;;;;3,0;;;;;;;;;2,0;;3,0;;;;;3,0;;;;;;;;;;;;;;;;;;;;;;;;;;;;;;;;;;;;;;1,0;;;;;;;;;2,0;;;;;;;;;;;;;;;;;;;;;;;;;;;;;;;;;;;;;;;;;;;1,0;;;;;;;;;;;2,0;8,0;;;;;;;;;;;;;;;;;;;;;;;;;;;;;;;;;;;;1,0;;;;;;;;;;;;;;;;;;;;;;;;;;;;;;;;;;;;;;;;;;;;;;;;;;;;;;;;;;;;;;;;;;;;;;;;;;;;;;;;;;;;;;;;;
rotational;;2,0;10,0;;25,0;;227,0;17,0;4,0;5,0;29,0;;;;3,0;3,0;;;23,0;2,0;;13,0;7,0;1,0;9,0;;;1,0;26,0;13,0;27,0;18,0;34,0;3,0;7,0;;;137,0;6,0;13,0;8,0;;64,0;35,0;3,0;;;7,0;;6,0;3,0;5,0;;2,0;;22,0;25,0;;14,0;52,0;5,0;;9,0;1,0;;32,0;21,0;;;18,0;45,0;;3,0;2,0;2,0;;;6,0;94,0;5,0;17,0;;;;;;6,0;;;1,0;16,0;;4,0;13,0;1,0;5,0;;;;3,0;9,0;17,0;;46,0;;;;36,0;;;1,0;19,0;;13,0;5,0;;4,0;;;70,0;;;3,0;2,0;2,0;;18,0;3,0;;2,0;3,0;;;27,0;;4,0;6,0;;;;;;;15,0;7,0;43,0;10,0;14,0;;1,0;;11,0;8,0;;;30,0;6,0;13,0;2,0;6,0;1,0;4,0;10,0;1,0;2,0;;;4,0;1,0;1,0;92,0;1,0;4,0;5,0;45,0;;1,0;5,0;;;;1,0;3,0;;24,0;2,0;1,0;4,0;;53,0;;12,0;;3,0;;;;4,0;25,0;2,0;;2,0;;15,0;3,0;;4,0;;1,0;69,0;2,0;2,0;;;11,0;;11,0;;;;2,0;;;4,0;;;;;;;2,0;;6,0;1,0;10,0;33,0;4,0;2,0;;;6,0;10,0;;;;1,0;3,0;;11,0;3,0;;;;9,0;2,0;;1,0;4,0;1,0;;;52,0;;1,0;11,0;5,0;37,0;;;;2,0;;;;6,0;;;2,0;13,0;1,0;11,0;2,0;;111,0;2,0;7,0;29,0;4,0;3,0;22,0;;8,0;2,0;1,0;;9,0;;;;2,0;1,0;;13,0;2,0;5,0;2,0;1,0;12,0;2,0;4,0;2,0;;4,0;;18,0;1,0;32,0;23,0;19,0;;;;123,0;;1,0;2,0;;3,0;;;1,0;3,0;2,0;1,0;;;;7,0;;7,0;2,0;1,0;;4,0;4,0;;;;;4,0;7,0;;;2,0;;;;;;;3,0;;;;1,0;4,0;;;2,0;;;;;;1,0;1,0;;2,0;;23,0;1,0;2,0;;;;;;;;;;4,0;;;13,0;23,0;;10,0;1,0;;;;;;6,0;;;;;;5,0;8,0;;;;1,0;4,0;2,0;3,0;;3,0;;;;;;;;;;;;;;;;;;;1,0;1,0;;;;;6,0;2,0;8,0;2,0;2,0;;;1,0;11,0;;;;;;;;;;;;1,0;26,0;;1,0;;;1,0;;;1,0;;;;;;;;;1,0;;94,0;;;;1,0;;3,0;;1,0;7,0;1,0;;;;;;1,0;;1,0;6,0;;;14,0;;;;;;;1,0;6,0;;;;;;;;;;;4,0;;;;;;3,0;2,0;;;15,0;;;;;;1,0;2,0;;;;;;;;;;1,0;;;;;6,0;3,0;1,0;;;;;;44,0;;;;;;;;;;;;;;;;;;;1,0;;;;;;;;;1,0;;;;;1,0;2,0;;;;;;2,0;2,0;;;;;;;;1,0;;;;;;;;;;;;;13,0;;;5,0;;3,0;3,0;2,0;;9,0;3,0;;;;;;;;;;;;2,0;;;2,0;;;;;2,0;;7,0;;;;;3,0;4,0;;;;;;;;4,0;;;;;;;;;;;;;;;;;9,0;;;;;;1,0;;;3,0;;;;;;;;;;;;;2,0;;;;;;3,0;;;8,0;;;3,0;;;;;;;;;;;;;;;;;;;;;;;;;;;;;;4,0;;;;;;;;;;;;;;;;;2,0;;;6,0;;7,0;3,0;;;;;;;;;;;;;1,0;;;;;;;2,0;;;;;4,0;;;;;1,0;;;;;;;;;;;;;;;;;;2,0;;;4,0;;7,0;;1,0;;;;;;2,0;;;2,0;;;;;;;16,0;;;;;;;4,0;;5,0;;;;;18,0;;;;2,0;2,0;;;;;;3,0;;;;;;;;;9,0;8,0;;;;;;;;;;;;;;;1,0;;;;;;;1,0;;;;;;;;;;;;10,0;;;;;;;;;;;;;;;;;;;1,0;;1,0;;;1,0;;;;;;;;;;;;;;;;;1,0;;;;;;;;;21,0;;;;;;4,0;1,0;3,0;;;;;;;;;;;1,0;;;;;;;;;;;;
secure;;7,0;1,0;;31,0;;18,0;77,0;;2,0;1,0;;3,0;;1,0;1,0;;;9,0;2,0;1,0;2,0;;1,0;5,0;;1,0;45,0;3,0;1,0;;2,0;132,0;;22,0;;;27,0;;13,0;3,0;;1,0;33,0;;;3,0;;7,0;;1,0;9,0;;8,0;3,0;22,0;53,0;;5,0;107,0;1,0;;43,0;;;1,0;18,0;1,0;;3,0;37,0;7,0;2,0;4,0;;;;;65,0;5,0;3,0;7,0;5,0;;;;11,0;3,0;;2,0;4,0;;14,0;11,0;11,0;2,0;;24,0;3,0;29,0;35,0;31,0;;5,0;;;;12,0;;1,0;33,0;8,0;6,0;49,0;16,0;;;;7,0;46,0;;2,0;;9,0;;;41,0;3,0;;27,0;21,0;5,0;;6,0;;7,0;9,0;13,0;3,0;1,0;2,0;;12,0;9,0;14,0;14,0;17,0;24,0;1,0;;;7,0;10,0;6,0;9,0;15,0;12,0;119,0;3,0;9,0;;;8,0;3,0;;;6,0;14,0;1,0;9,0;143,0;1,0;31,0;87,0;1,0;4,0;20,0;;2,0;;7,0;2,0;4,0;1,0;21,0;13,0;103,0;23,0;2,0;210,0;;6,0;;41,0;1,0;1,0;2,0;2,0;12,0;;3,0;8,0;10,0;21,0;9,0;;9,0;9,0;100,0;73,0;;4,0;1,0;;;;1,0;5,0;1,0;12,0;12,0;19,0;;1,0;16,0;;16,0;;1,0;;2,0;;;;1,0;;7,0;3,0;3,0;3,0;25,0;4,0;17,0;16,0;11,0;9,0;3,0;13,0;2,0;26,0;;3,0;2,0;7,0;;;1,0;13,0;2,0;;;1,0;1,0;9,0;3,0;7,0;10,0;6,0;10,0;22,0;5,0;26,0;4,0;1,0;9,0;3,0;2,0;7,0;;14,0;20,0;19,0;3,0;68,0;6,0;;5,0;11,0;6,0;6,0;2,0;;;;10,0;4,0;5,0;5,0;5,0;3,0;8,0;3,0;23,0;3,0;;1,0;9,0;20,0;18,0;7,0;;7,0;1,0;;7,0;;8,0;;3,0;15,0;1,0;;21,0;9,0;;5,0;18,0;14,0;;;14,0;;3,0;;;;;2,0;;;1,0;1,0;;;;;;10,0;;1,0;5,0;4,0;;;;;;;1,0;;;;;;3,0;;1,0;;3,0;;;2,0;;;;3,0;2,0;;;4,0;;4,0;;;;;;;;2,0;3,0;;2,0;5,0;7,0;1,0;;;;;;;1,0;;1,0;;;;;;11,0;4,0;2,0;;;2,0;3,0;;1,0;1,0;15,0;;;;;;;1,0;5,0;;;;;;;;;;;3,0;;;3,0;;;;;;;2,0;;;3,0;;;;;;;;;;;;1,0;1,0;23,0;4,0;;;;2,0;6,0;;1,0;;4,0;;1,0;;;;;2,0;;10,0;1,0;;;;2,0;;;1,0;1,0;11,0;3,0;1,0;2,0;1,0;8,0;;;;30,0;12,0;;;;;1,0;;;;4,0;12,0;24,0;;;;8,0;3,0;;;;;3,0;5,0;;;;;;;;2,0;2,0;;20,0;;;;;2,0;2,0;;;;;;1,0;;2,0;;4,0;2,0;10,0;;1,0;1,0;5,0;;;;4,0;;9,0;;;;;;;;21,0;;9,0;;1,0;1,0;;;1,0;;;2,0;3,0;;;;;8,0;;;2,0;;2,0;;;6,0;;;4,0;2,0;9,0;;;9,0;;3,0;4,0;;;;1,0;;;3,0;15,0;2,0;;2,0;;3,0;;;1,0;29,0;1,0;3,0;;14,0;11,0;4,0;;2,0;4,0;;56,0;2,0;2,0;;2,0;;;;;;;;;;2,0;6,0;12,0;2,0;4,0;14,0;1,0;2,0;6,0;;;;;;5,0;3,0;5,0;;;;;;3,0;;5,0;;;;;;;;;;;;;;;2,0;;;;;;1,0;;;1,0;;;;;1,0;1,0;;;1,0;;;;;;;;1,0;;4,0;;;;;;;;;;;;;;;;1,0;;;;2,0;;2,0;;;3,0;;1,0;;;;;5,0;;;;;;;;1,0;;4,0;;;;;;;;;;2,0;;;;9,0;;2,0;;;;;;4,0;;;;;;;;;;;;;;;;;;;;4,0;;;;1,0;;;;;;;4,0;;;;2,0;;;;;;;;1,0;;;;;8,0;;3,0;;;4,0;;3,0;1,0;;;;;;;;;;3,0;8,0;;;;;;1,0;;;;5,0;4,0;;;;3,0;;;;1,0;;2,0;;;2,0;;;;;;;;1,0;2,0;;;;3,0;;;;;;;;;;;;5,0;;2,0;5,0;1,0;1,0;;;;;;;1,0;;;;;;;;;;2,0;;;;1,0;;;;;;;;;;;;;;;;;;;;;;;;;1,0;;;3,0;;1,0;;;;;;;;;;1,0;;;;;;;;;2,0;1,0;;;;;;;;;;;1,0;;;;;;;;;1,0;;;;
sensitivity;;1,0;2,0;;3,0;;;23,0;10,0;32,0;;44,0;;;8,0;;;10,0;2,0;;15,0;34,0;;1,0;8,0;;;13,0;;2,0;23,0;27,0;77,0;;13,0;2,0;;5,0;;6,0;1,0;;;7,0;1,0;;;;26,0;;10,0;7,0;;2,0;;73,0;18,0;;2,0;5,0;;;13,0;2,0;;;;;1,0;19,0;6,0;2,0;;;;13,0;;;2,0;1,0;;1,0;;;1,0;;35,0;;3,0;23,0;41,0;2,0;16,0;24,0;;;;14,0;17,0;;;20,0;;;1,0;;1,0;49,0;;;;3,0;34,0;;;1,0;;3,0;;;;;4,0;41,0;;;6,0;2,0;;;11,0;1,0;;;;8,0;9,0;;1,0;3,0;;;;2,0;2,0;;;;;;3,0;;;;;;;;1,0;93,0;;11,0;;1,0;;1,0;18,0;41,0;;;13,0;;9,0;;1,0;;;23,0;;;;;;;;;;19,0;;13,0;;;;7,0;;;;;;;;1,0;;4,0;;1,0;1,0;;1,0;;;;9,0;10,0;;18,0;;;;;2,0;;;;;18,0;;;1,0;;;;1,0;;77,0;;;;5,0;;;;1,0;;;;1,0;2,0;;;4,0;;;1,0;3,0;;;;;;;;;;;;;;;;;;;;;;;;4,0;;;;;1,0;;3,0;;4,0;3,0;;;;;2,0;;;;7,0;2,0;;;;11,0;;;;;37,0;;;1,0;6,0;;;;;;;;;;5,0;;;;;;;;;3,0;14,0;;;;;7,0;;2,0;;;;;1,0;7,0;;14,0;;;2,0;;1,0;;;;1,0;;2,0;;;1,0;;;1,0;2,0;22,0;;;;;4,0;;;3,0;1,0;7,0;;3,0;;;5,0;4,0;;;;1,0;;;;1,0;;5,0;;;7,0;10,0;1,0;;18,0;;1,0;;;;;;;;;;;1,0;;;;;;;1,0;;1,0;;;;32,0;;;2,0;11,0;1,0;;;;;;;;;;;;;;;;2,0;;3,0;13,0;;;4,0;18,0;12,0;;;;;14,0;;;;;2,0;1,0;;;;2,0;;;5,0;;;;;;;;;;;;;;;;;;48,0;;13,0;2,0;;;12,0;;3,0;;;;;1,0;;3,0;;;;;;;;;;1,0;;;12,0;;4,0;;;;;;7,0;1,0;;2,0;;;;;;;5,0;;;;;;;;;;;;;;;1,0;;;;;;;;;4,0;114,0;;;;;;;;;;;;;;;;;;;;;;20,0;;;;;;;;1,0;;;;;;;;;;;;75,0;;;;;;;;;;;;2,0;;;;;;;;;;;;;;;1,0;;;3,0;35,0;;;;;;;;;;;;;1,0;;;;;;;;;;;;;;;;;;;;6,0;;;;;;;;2,0;;;;;;3,0;3,0;1,0;9,0;1,0;;;;;;;;11,0;;1,0;;;2,0;;;;;;1,0;1,0;;;;;;;;;;1,0;;2,0;;4,0;;2,0;;;;;;;6,0;;;6,0;;2,0;;;1,0;;;;;;;;1,0;;1,0;;;10,0;;;;;;;;;7,0;;;;8,0;2,0;;;;;;3,0;;3,0;;;1,0;;;3,0;;;;;;;;;;;1,0;;;;;;;;;;;;;;;;;;;;;;2,0;;1,0;;;;;;;;;;;;;;;;;;;;;1,0;;;;;;;;;1,0;1,0;;;;;;;;;;2,0;;;;;;;;;;;;;;;;;;;;;;;;1,0;1,0;;;;;;;;;;;;;;;;;;;;;2,0;;;;;;;;;;;;;;;;;;;;;;;;;;;1,0;;71,0;1,0;;;;;;;;2,0;;;;;;;;;;;;;;;1,0;;;;;;;;1,0;;;;;;;;;;5,0;;;;;;;;;;;;;;;6,0;;;;;;;;;;;;;;;
separate;;3,0;1,0;;18,0;;16,0;13,0;;27,0;4,0;1,0;1,0;;20,0;;1,0;;32,0;4,0;;19,0;;;8,0;;2,0;44,0;1,0;1,0;;4,0;65,0;3,0;15,0;;3,0;38,0;;34,0;31,0;;3,0;41,0;4,0;;2,0;;1,0;5,0;12,0;17,0;1,0;14,0;1,0;183,0;35,0;;;71,0;;;40,0;;;10,0;4,0;6,0;;;53,0;;8,0;1,0;1,0;7,0;2,0;11,0;25,0;31,0;5,0;12,0;11,0;2,0;2,0;;39,0;;2,0;13,0;20,0;;;52,0;;17,0;;7,0;3,0;6,0;31,0;39,0;;7,0;;;14,0;81,0;;;11,0;19,0;19,0;7,0;8,0;;;3,0;2,0;7,0;;;;5,0;;1,0;26,0;1,0;;2,0;3,0;;;;6,0;2,0;7,0;;11,0;1,0;;;2,0;6,0;14,0;;17,0;45,0;;;4,0;3,0;9,0;;;10,0;2,0;19,0;6,0;32,0;2,0;4,0;5,0;2,0;;10,0;2,0;117,0;;2,0;29,0;18,0;31,0;24,0;6,0;6,0;11,0;3,0;1,0;20,0;1,0;;7,0;;2,0;7,0;23,0;51,0;13,0;55,0;;4,0;;14,0;;2,0;;;;3,0;2,0;9,0;1,0;14,0;3,0;4,0;7,0;1,0;7,0;23,0;;1,0;4,0;;;6,0;8,0;4,0;;;3,0;6,0;;12,0;10,0;48,0;5,0;;;;4,0;;;6,0;1,0;3,0;2,0;4,0;8,0;;1,0;;11,0;3,0;2,0;;22,0;4,0;;;;;1,0;8,0;1,0;2,0;2,0;4,0;1,0;;7,0;2,0;;;5,0;;5,0;7,0;;1,0;;6,0;2,0;;;2,0;1,0;;;3,0;;2,0;;7,0;3,0;13,0;4,0;13,0;5,0;1,0;5,0;;3,0;1,0;2,0;1,0;6,0;1,0;1,0;2,0;2,0;;18,0;13,0;;9,0;;16,0;5,0;4,0;2,0;10,0;1,0;;11,0;;;;;1,0;;11,0;4,0;12,0;;18,0;10,0;;13,0;;3,0;;;;;;1,0;2,0;;2,0;2,0;5,0;;;;2,0;3,0;3,0;1,0;3,0;;;2,0;;;;;;;;3,0;;1,0;;1,0;1,0;;;1,0;2,0;;;;1,0;1,0;6,0;2,0;1,0;;6,0;2,0;2,0;;2,0;;;1,0;;;17,0;1,0;1,0;;;11,0;3,0;;1,0;4,0;;1,0;;;;3,0;;;1,0;;;5,0;2,0;13,0;8,0;;4,0;3,0;;1,0;3,0;13,0;;4,0;11,0;;1,0;;1,0;6,0;10,0;7,0;;;;;2,0;;;1,0;4,0;2,0;;;;;5,0;6,0;1,0;1,0;;;1,0;10,0;1,0;;;2,0;8,0;2,0;;;;;;;;2,0;2,0;;;2,0;8,0;1,0;;;;8,0;;;;1,0;1,0;;;;1,0;2,0;2,0;;1,0;;2,0;;;18,0;7,0;;;;;;;1,0;;6,0;2,0;;2,0;;7,0;9,0;;;2,0;4,0;6,0;4,0;;;;;1,0;1,0;10,0;1,0;5,0;4,0;;2,0;7,0;;5,0;;;2,0;;;;3,0;;;4,0;;1,0;4,0;;1,0;;;;1,0;2,0;;;2,0;;9,0;;;;21,0;;2,0;;1,0;;2,0;;;;;2,0;1,0;;3,0;1,0;;;;3,0;;;30,0;;1,0;2,0;;2,0;;;8,0;2,0;;18,0;9,0;;;12,0;;;;;;;2,0;1,0;;2,0;;;;3,0;;;;;5,0;;;1,0;2,0;;;;;;1,0;;2,0;2,0;;4,0;;;;2,0;11,0;;9,0;;;;;;;;;;;;2,0;4,0;20,0;;;;2,0;;4,0;1,0;;;;;3,0;4,0;;;3,0;4,0;3,0;;;;2,0;1,0;2,0;;;;;2,0;2,0;2,0;;;2,0;;;2,0;;;;;;1,0;;2,0;2,0;1,0;1,0;2,0;;;;;2,0;;;9,0;1,0;1,0;;6,0;;;5,0;1,0;;3,0;6,0;;;;7,0;;2,0;;;;;2,0;1,0;;;;;;2,0;;2,0;;;;;2,0;2,0;3,0;;;;;;;;;;;;5,0;;1,0;;;;3,0;;;;;;;;;;18,0;3,0;1,0;;1,0;4,0;3,0;1,0;;;1,0;1,0;;;;;;;;;;;3,0;;;;;;2,0;3,0;;4,0;2,0;3,0;;11,0;;;1,0;;;;;;;;;2,0;;;1,0;;;;1,0;6,0;2,0;6,0;;;;;;12,0;;;3,0;1,0;;;;;;6,0;;1,0;;;;;;;;1,0;;;;;;1,0;;;4,0;;;;;4,0;;1,0;;;;;;1,0;2,0;;1,0;;;;;2,0;2,0;;;;;1,0;;;;;1,0;3,0;1,0;13,0;1,0;;;;1,0;;;1,0;1,0;;;;6,0;2,0;;;3,0;;4,0;;;2,0;;;1,0;;;;;;;7,0;;2,0;;;;;;;1,0;4,0;;;;;;2,0;1,0;;;;;;;3,0;;;;;;;;;;;;;;;;;;;;;;;;;;3,0;2,0;2,0;;;2,0;;5,0;;;;;;;;
shape;;4,0;3,0;;45,0;11,0;45,0;80,0;12,0;8,0;17,0;9,0;42,0;2,0;19,0;7,0;;3,0;2,0;5,0;21,0;26,0;1,0;7,0;9,0;;23,0;2,0;5,0;10,0;9,0;18,0;122,0;6,0;30,0;12,0;10,0;59,0;;28,0;3,0;;14,0;118,0;5,0;1,0;3,0;2,0;8,0;6,0;3,0;15,0;;17,0;6,0;132,0;73,0;;8,0;211,0;4,0;;52,0;;21,0;2,0;13,0;3,0;1,0;1,0;64,0;3,0;3,0;3,0;13,0;23,0;4,0;25,0;53,0;14,0;2,0;14,0;12,0;;4,0;3,0;44,0;1,0;4,0;10,0;41,0;1,0;3,0;23,0;73,0;21,0;4,0;5,0;6,0;9,0;107,0;35,0;2,0;12,0;1,0;;11,0;56,0;4,0;8,0;9,0;58,0;11,0;17,0;17,0;6,0;;;21,0;108,0;7,0;4,0;8,0;22,0;1,0;;25,0;7,0;;10,0;69,0;5,0;2,0;19,0;11,0;3,0;29,0;7,0;8,0;10,0;;1,0;1,0;26,0;21,0;;195,0;21,0;2,0;;;40,0;21,0;;13,0;24,0;30,0;66,0;10,0;57,0;2,0;9,0;7,0;22,0;;6,0;;50,0;;19,0;122,0;12,0;69,0;30,0;5,0;64,0;15,0;5,0;6,0;;3,0;3,0;1,0;;6,0;28,0;65,0;47,0;1,0;195,0;7,0;20,0;1,0;24,0;159,0;5,0;10,0;9,0;5,0;8,0;;;7,0;109,0;3,0;3,0;11,0;6,0;14,0;53,0;;7,0;;14,0;8,0;6,0;;13,0;;1,0;23,0;23,0;4,0;4,0;15,0;;8,0;;;3,0;1,0;;18,0;8,0;6,0;11,0;23,0;13,0;50,0;6,0;33,0;10,0;8,0;25,0;5,0;14,0;6,0;3,0;6,0;8,0;29,0;1,0;1,0;38,0;4,0;5,0;64,0;43,0;5,0;4,0;1,0;22,0;21,0;13,0;18,0;12,0;41,0;;5,0;27,0;3,0;14,0;;1,0;12,0;12,0;;2,0;4,0;5,0;6,0;8,0;2,0;10,0;3,0;5,0;8,0;66,0;5,0;9,0;2,0;2,0;;35,0;;6,0;;8,0;6,0;5,0;;;9,0;9,0;25,0;10,0;6,0;15,0;4,0;34,0;17,0;10,0;10,0;;41,0;3,0;7,0;3,0;9,0;4,0;;;16,0;9,0;12,0;17,0;1,0;17,0;1,0;;8,0;7,0;;2,0;;;;;;;3,0;2,0;;3,0;;;1,0;;5,0;48,0;10,0;;;5,0;;3,0;;1,0;3,0;;32,0;;9,0;;3,0;4,0;3,0;3,0;;3,0;;;;6,0;2,0;72,0;1,0;39,0;;21,0;;3,0;6,0;2,0;16,0;;;6,0;;3,0;2,0;5,0;2,0;1,0;12,0;2,0;;40,0;;;1,0;;;3,0;;;1,0;1,0;;;6,0;6,0;6,0;4,0;;1,0;8,0;;;4,0;10,0;;;2,0;3,0;1,0;;3,0;;1,0;;4,0;;;;1,0;;3,0;;;;2,0;1,0;2,0;11,0;;4,0;5,0;2,0;;;;12,0;1,0;15,0;4,0;;;3,0;;;;;1,0;;6,0;22,0;;9,0;;;4,0;4,0;;;2,0;9,0;;;6,0;;6,0;;3,0;1,0;10,0;3,0;7,0;2,0;5,0;;7,0;;;1,0;32,0;1,0;12,0;10,0;;;3,0;1,0;;37,0;6,0;;3,0;;3,0;12,0;;;2,0;4,0;10,0;10,0;;;;3,0;2,0;;3,0;;;3,0;;;;;;;;;;16,0;4,0;1,0;;;;;2,0;2,0;2,0;6,0;;;;21,0;;17,0;8,0;;4,0;4,0;;1,0;;21,0;;2,0;;;;4,0;;;;;;;;6,0;;47,0;;;;;;6,0;;;3,0;;;;;;;;;24,0;1,0;1,0;1,0;2,0;33,0;;;1,0;1,0;3,0;;;2,0;2,0;3,0;3,0;;;2,0;;;6,0;;2,0;;;2,0;1,0;9,0;;;1,0;3,0;;2,0;;37,0;12,0;3,0;4,0;3,0;4,0;13,0;7,0;2,0;2,0;;31,0;6,0;29,0;;3,0;;20,0;20,0;;27,0;;4,0;16,0;;2,0;3,0;;2,0;17,0;;;2,0;6,0;1,0;;3,0;1,0;3,0;;;;2,0;8,0;;2,0;;;;;2,0;8,0;;4,0;;1,0;;;;;1,0;6,0;;2,0;;6,0;4,0;;;2,0;4,0;1,0;;4,0;1,0;;;8,0;3,0;;1,0;;;;;;;;4,0;5,0;;1,0;;;;;;1,0;17,0;1,0;;1,0;4,0;;;;1,0;;;4,0;2,0;;4,0;6,0;;2,0;1,0;5,0;1,0;;3,0;1,0;2,0;6,0;1,0;1,0;;10,0;8,0;;4,0;;;;1,0;7,0;1,0;;;;2,0;4,0;8,0;56,0;7,0;;3,0;;2,0;;;;;;2,0;10,0;;2,0;;;1,0;;;;6,0;;7,0;;1,0;;;;7,0;1,0;3,0;2,0;;3,0;;;;;1,0;5,0;;;;;;;1,0;1,0;;;1,0;4,0;8,0;3,0;3,0;3,0;;2,0;;;;1,0;;;6,0;;;8,0;;;;2,0;2,0;;9,0;1,0;;;;4,0;;1,0;;;12,0;1,0;;5,0;;5,0;;1,0;;;5,0;2,0;1,0;;;8,0;1,0;18,0;;;;2,0;;;1,0;3,0;1,0;3,0;;;;;;;;;;;;;1,0;5,0;2,0;1,0;2,0;;;4,0;;;;13,0;1,0;;;;;3,0;;3,0;2,0;;4,0;3,0;;;;;;;;;1,0;;;8,0;;2,0;1,0;3,0;;;;;15,0;;;;1,0;;1,0;6,0;;;6,0;1,0;26,0;;;1,0;5,0;;;;;;1,0;;;;;;1,0;;;2,0;;;;2,0;;;;;29,0;;;;12,0;;;;;;1,0;;35,0;;;;
share;;4,0;;;8,0;;8,0;3,0;;7,0;;;;;4,0;3,0;;;6,0;;;5,0;;;;;;27,0;;1,0;;;9,0;;13,0;;;;;;7,0;;;2,0;;;;1,0;2,0;;1,0;;;13,0;;44,0;7,0;;;9,0;;2,0;10,0;;;1,0;7,0;;;;19,0;;10,0;;;;;5,0;2,0;3,0;;;;;;;8,0;;;;4,0;;;4,0;;;;;2,0;3,0;10,0;21,0;;6,0;;;1,0;10,0;;;;3,0;13,0;3,0;;;;;7,0;2,0;;;;7,0;;;2,0;;;3,0;;;;;;1,0;4,0;;2,0;;;;3,0;;;;4,0;8,0;;;;;1,0;;1,0;;;1,0;2,0;4,0;1,0;;;;;;;11,0;;;3,0;1,0;12,0;2,0;3,0;;;1,0;;;;1,0;1,0;;4,0;;;22,0;;;;;3,0;2,0;;;;;2,0;;;;;1,0;;;;;1,0;3,0;;;;;;1,0;1,0;;;;;3,0;;2,0;;;;;;;;;;4,0;;;;1,0;18,0;;;;4,0;;;;4,0;1,0;;;3,0;;;;2,0;;;;1,0;;1,0;2,0;;;;;2,0;;;;;;;;;;;;2,0;12,0;;;;;;;;1,0;1,0;1,0;5,0;;;;;;6,0;2,0;;;1,0;;1,0;;2,0;1,0;;;;;;5,0;;;;;;;1,0;;;1,0;;;;1,0;;;2,0;;2,0;;;;;1,0;;;;;;;3,0;;;;;;;;;;1,0;;;;;;;1,0;;;;;;1,0;;;;;;;;;;2,0;;;;;;8,0;;;1,0;;;;;5,0;;;;;;;;;;;4,0;;3,0;1,0;1,0;;;1,0;;;;1,0;;;;;3,0;;;1,0;;1,0;;2,0;;;;2,0;;;;;;;;;;1,0;;1,0;;;;1,0;1,0;2,0;13,0;;;;;;;;;;;;;;;1,0;;;5,0;;;;1,0;;;1,0;;;;;;5,0;;;;;1,0;;;2,0;;;;;;;;;12,0;;;;;;;;;;11,0;;;;;;;;1,0;;8,0;;;3,0;;;;;1,0;;;;;;;;;;;;7,0;;;;;;;;;;1,0;;1,0;;;;;;;;4,0;;;;;2,0;20,0;;;;;;;;;;;5,0;2,0;;;;2,0;;;;;;;;;1,0;;;;;3,0;;;1,0;2,0;;;;;;;;;;;;;;;;;;3,0;;;;1,0;;;;;;;;;;;;;;;1,0;;;;;11,0;;;;;;;;;;;;;;;;;;;;;;;;;;;;;;;;;;;;;;;;;;;;;;;;;;;;;7,0;;;;;;7,0;;;;;;;;;;;4,0;1,0;;;;;;1,0;;;13,0;;;;;1,0;;1,0;;;;;;;;;2,0;;;;;;1,0;;;2,0;5,0;;;;;;;;1,0;;;1,0;;;;;;2,0;;;;;;;;;;;;;;;;;;;;;6,0;;;;;3,0;6,0;;;;;;;;;;;;;;;;;;1,0;;;;1,0;;;;;;2,0;;1,0;;;;;;;;;;;;1,0;;;;;;;;;;15,0;;;;;11,0;;;;;;;;1,0;;;;;4,0;;;;;;;1,0;;;;;2,0;;;;;;;;;;;;;;;;;;;;;;;;;;;;;;;;;;;;;;;;;;;1,0;;3,0;;;;;;;;;;;;;;;;;;;;;;;;;;;;;1,0;;;;;1,0;;;;;;;;;;;;;;;;;;;;;;;;;;;;;;;;;;;;;;;;;;1,0;;;;;;;;;;
shoulder;;1,0;;;8,0;;;5,0;;;;;;;;;;;;;;;;;;;;;;;;;1,0;;;;;;;1,0;;;;4,0;;;;;;;;;;;;1,0;3,0;;3,0;2,0;;;4,0;;;;;;;;;;;;;;;;3,0;;1,0;;1,0;;;;;;;4,0;;;;;;1,0;;;;;2,0;6,0;;;;;;;;;;1,0;;1,0;17,0;;;;;2,0;;2,0;;;;;2,0;3,0;;1,0;;;;;;5,0;;;;;;;;1,0;;;4,0;;;;;;;;;;;5,0;;2,0;;;1,0;1,0;;;;;;;8,0;;1,0;6,0;;;1,0;;;;;1,0;;;;5,0;4,0;1,0;;18,0;;;;1,0;;;;;;;;;;4,0;1,0;;;;;7,0;;;;;;;;;;;;;;;2,0;;;;;;1,0;;;6,0;1,0;;4,0;;10,0;;;;;;;;;;;;;1,0;;2,0;;;1,0;2,0;;1,0;;;;;1,0;3,0;3,0;;;;;3,0;;1,0;;;;;;1,0;;;;;;;;;;;;;;;;;;;;;;;;;;1,0;1,0;;1,0;;;;;;6,0;;2,0;;;;;;;2,0;;;;;;;5,0;;;;;;;;;;;;;;;;;1,0;;;6,0;;1,0;;;;;;;;;;;;;;;;;;;;;;;;;;;;;;;;;;;;;;1,0;;;;;;;;;;;;;;;;1,0;;;;;1,0;1,0;;;;;;;;;;;;2,0;;;;;;;;;;;6,0;;;;;;;;;;;;;;;;;;;;;;;;;;;;;;;;2,0;;5,0;;;;;;;;;;;;;;;;;;;;;;;;;3,0;7,0;;;;;;;;;7,0;;;1,0;;;6,0;;;;;;;;;;;;;;;;2,0;;;;;;;;;;;;;;;;;;;;;;;;;;;;;;;;;;;;;;;;;;;;;;;;;;;;;;;;1,0;;;;;;;;;;;;;;;;1,0;;;;;;;;;;;7,0;;;;;;;;;2,0;;;;;;;;;35,0;;1,0;;;1,0;;;;;;;;1,0;;;;;;;;1,0;5,0;;;;;1,0;;;;6,0;;;1,0;;;;;;;1,0;;;;;;;;;;;;;;;;;;;;;;;;;;;;;;;;;;;;;;;;;;;;;;;;;;;6,0;;;;;;;;;;;;;;;;;;;;;;;;;;;;;;;;;;;;2,0;;;;;;;;;;;;;;;1,0;;;;;14,0;;;;;;;;;;;;;;;;2,0;;;;;;6,0;;;1,0;;;;10,0;;;;;;;;;1,0;;;;;;;;;;;;;;;;;;;;;;;;;;;;;;;;;;;;;;;;;;;;;;;;;;;;;;;;2,0;;;;;;;;;;;;;;;1,0;;;;;;;;;;;;;;;;;;;;;;;;;;1,0;;;;;;;;1,0;;;;;;;;;;;;;;;;;;;;;;1,0;;;;;;;;;;;;;;;;;;;1,0;;;;;;;;;;;;;;;;;;;;;;;;;;;;;;;;;;;;;;;;
side;;2,0;7,0;;52,0;21,0;133,0;211,0;4,0;29,0;16,0;2,0;1,0;;20,0;1,0;;;63,0;2,0;34,0;58,0;6,0;7,0;19,0;;8,0;79,0;13,0;28,0;24,0;7,0;201,0;6,0;43,0;;33,0;176,0;2,0;125,0;166,0;;45,0;822,0;;;3,0;35,0;22,0;14,0;8,0;15,0;6,0;400,0;24,0;1842,0;179,0;;75,0;2302,0;5,0;17,0;59,0;12,0;;31,0;29,0;2,0;;100,0;347,0;418,0;21,0;41,0;21,0;63,0;8,0;72,0;263,0;107,0;3,0;21,0;7,0;4,0;;18,0;141,0;27,0;10,0;8,0;91,0;9,0;22,0;67,0;22,0;67,0;;20,0;15,0;129,0;1605,0;314,0;;27,0;;;12,0;737,0;;2,0;8,0;316,0;28,0;48,0;80,0;;14,0;;45,0;236,0;8,0;9,0;8,0;54,0;3,0;1,0;101,0;58,0;7,0;82,0;188,0;1,0;2,0;57,0;2,0;14,0;378,0;3,0;53,0;8,0;;1,0;24,0;418,0;41,0;13,0;287,0;161,0;1,0;6,0;;56,0;73,0;29,0;17,0;41,0;47,0;181,0;7,0;168,0;43,0;14,0;114,0;11,0;;75,0;7,0;206,0;3,0;38,0;302,0;111,0;210,0;176,0;19,0;108,0;89,0;132,0;3,0;23,0;78,0;10,0;47,0;2,0;43,0;60,0;251,0;123,0;;551,0;5,0;19,0;6,0;52,0;51,0;49,0;68,0;;11,0;21,0;59,0;109,0;21,0;;3,0;11,0;9,0;12,0;29,0;149,0;2,0;19,0;1,0;3,0;1,0;60,0;8,0;62,0;10,0;8,0;158,0;80,0;3,0;3,0;256,0;;43,0;;;32,0;5,0;;7,0;65,0;21,0;44,0;24,0;15,0;68,0;6,0;77,0;12,0;14,0;249,0;14,0;39,0;8,0;10,0;11,0;53,0;2,0;8,0;37,0;203,0;20,0;3,0;3,0;98,0;1,0;6,0;8,0;70,0;83,0;20,0;36,0;14,0;219,0;7,0;22,0;46,0;10,0;260,0;14,0;9,0;20,0;49,0;1,0;10,0;11,0;165,0;20,0;66,0;;37,0;7,0;11,0;108,0;1794,0;8,0;367,0;3,0;6,0;6,0;5,0;13,0;32,0;20,0;21,0;19,0;10,0;12,0;22,0;64,0;47,0;42,0;36,0;3,0;50,0;114,0;43,0;7,0;26,0;8,0;3,0;29,0;20,0;10,0;2,0;21,0;6,0;30,0;25,0;62,0;4,0;11,0;13,0;4,0;13,0;4,0;1,0;22,0;2,0;4,0;;;7,0;;2,0;1,0;;6,0;1,0;;3,0;;5,0;6,0;4,0;13,0;11,0;184,0;;6,0;;;21,0;;;2,0;4,0;1,0;;19,0;8,0;12,0;65,0;;;1,0;;;71,0;;15,0;6,0;7,0;4,0;;8,0;72,0;23,0;10,0;1,0;;;;1,0;13,0;;2,0;3,0;4,0;15,0;;30,0;3,0;2,0;13,0;4,0;8,0;12,0;;2,0;1,0;2,0;;10,0;163,0;;;9,0;7,0;8,0;11,0;1,0;1,0;;;130,0;4,0;4,0;;;31,0;16,0;43,0;1,0;1,0;;;3,0;;;;;4,0;;13,0;4,0;11,0;8,0;1,0;;;21,0;15,0;15,0;12,0;3,0;12,0;10,0;;20,0;10,0;8,0;;;;1,0;;;1,0;;13,0;7,0;49,0;69,0;1,0;4,0;;2,0;20,0;9,0;2,0;4,0;;26,0;11,0;;1,0;4,0;;2,0;;2,0;29,0;32,0;;2,0;2,0;1,0;40,0;14,0;10,0;28,0;39,0;3,0;23,0;;2,0;1,0;82,0;;;45,0;13,0;;49,0;1,0;18,0;5,0;1,0;;;40,0;27,0;54,0;;;1,0;5,0;13,0;;55,0;;3,0;3,0;;;17,0;5,0;;43,0;;;;19,0;6,0;;;;2,0;;22,0;14,0;;18,0;;;6,0;7,0;;6,0;;8,0;3,0;2,0;;2,0;6,0;76,0;4,0;;;4,0;1,0;43,0;;2,0;;;6,0;1,0;2,0;20,0;2,0;30,0;;1,0;;1,0;;39,0;4,0;2,0;45,0;8,0;;;;;9,0;;4,0;8,0;19,0;1,0;6,0;61,0;27,0;3,0;;15,0;8,0;7,0;;5,0;12,0;6,0;;;36,0;6,0;12,0;;;10,0;;5,0;1,0;8,0;;4,0;14,0;1,0;4,0;7,0;6,0;12,0;6,0;;30,0;16,0;9,0;1,0;1,0;25,0;5,0;12,0;2,0;11,0;;144,0;25,0;178,0;4,0;2,0;1,0;2,0;3,0;1,0;34,0;;15,0;8,0;9,0;12,0;9,0;6,0;15,0;11,0;2,0;;152,0;16,0;1,0;3,0;9,0;10,0;14,0;2,0;48,0;;19,0;10,0;;9,0;1,0;1,0;;3,0;;;4,0;1,0;6,0;7,0;3,0;;7,0;1,0;10,0;1,0;11,0;2,0;11,0;19,0;27,0;;;44,0;;8,0;;1,0;2,0;10,0;;;3,0;4,0;6,0;1,0;4,0;;;17,0;2,0;;28,0;7,0;1,0;3,0;;;3,0;;;;;6,0;3,0;;1,0;;1,0;;;;2,0;1,0;4,0;3,0;;1,0;1,0;1,0;;38,0;;2,0;;;12,0;;1,0;;2,0;13,0;7,0;;9,0;;;1,0;20,0;2,0;2,0;2,0;1,0;2,0;7,0;19,0;;;29,0;6,0;4,0;;;;;;;;8,0;16,0;1,0;;;3,0;2,0;;4,0;6,0;6,0;;27,0;1,0;6,0;3,0;;1,0;2,0;1,0;;8,0;;20,0;1,0;5,0;3,0;3,0;10,0;13,0;;;3,0;2,0;;;1,0;6,0;;;4,0;5,0;;27,0;2,0;123,0;6,0;;2,0;7,0;3,0;;;3,0;10,0;;4,0;11,0;1,0;;6,0;12,0;;;16,0;1,0;;2,0;6,0;;;6,0;1,0;6,0;6,0;5,0;29,0;2,0;23,0;31,0;;5,0;7,0;;14,0;1,0;;4,0;1,0;19,0;1,0;32,0;;7,0;;;7,0;;11,0;15,0;4,0;8,0;1,0;1,0;;;4,0;;1,0;1,0;;;;;20,0;;16,0;3,0;8,0;;;;;;;4,0;2,0;1,0;2,0;;1,0;5,0;1,0;2,0;12,0;;3,0;;;;4,0;5,0;;;;2,0;;;;;;1,0;;2,0;4,0;;7,0;;1,0;;6,0;;23,0;;5,0;9,0;;13,0;7,0;4,0;8,0;4,0;3,0;19,0;21,0;3,0;1,0;;38,0;;64,0;3,0;1,0;;1,0;6,0;;;1,0;5,0;;;4,0;;;;;;20,0;;;2,0;;;;1,0;2,0;;2,0;;192,0;;;1,0;
sidewall;;3,0;;;9,0;;3,0;108,0;;;;;2,0;;;1,0;;;;;;;;;;;;;;;;;7,0;;10,0;;1,0;19,0;;3,0;6,0;;;5,0;;;;;;;;;;3,0;2,0;8,0;20,0;;2,0;43,0;;;4,0;;;;2,0;;;;8,0;1,0;;13,0;13,0;3,0;;;6,0;;3,0;;;;;;7,0;;;;13,0;;1,0;;4,0;12,0;;;;8,0;61,0;;;;;6,0;;6,0;;;;3,0;1,0;6,0;6,0;;;;13,0;8,0;1,0;3,0;;;;;5,0;9,0;;3,0;10,0;;;;2,0;;15,0;;;8,0;;;7,0;;1,0;;117,0;28,0;;5,0;;22,0;3,0;;12,0;18,0;30,0;97,0;;3,0;;;23,0;5,0;;3,0;;16,0;;3,0;22,0;;39,0;32,0;;17,0;30,0;;2,0;;5,0;;;;;94,0;12,0;38,0;;42,0;;13,0;;20,0;;;;;;21,0;1,0;6,0;4,0;20,0;;;;1,0;;5,0;;3,0;;;;;;3,0;;1,0;18,0;;;;40,0;;10,0;;;;;;;12,0;;7,0;;;13,0;3,0;7,0;3,0;6,0;53,0;;10,0;1,0;2,0;;15,0;;;2,0;39,0;;;16,0;68,0;;4,0;;7,0;8,0;3,0;9,0;;46,0;;14,0;1,0;2,0;4,0;;;3,0;1,0;;;;8,0;5,0;1,0;;;;;1,0;;2,0;88,0;;2,0;;;;2,0;;;;;;;;11,0;6,0;1,0;;;3,0;6,0;;;;;11,0;;;4,0;;1,0;5,0;1,0;3,0;4,0;;;4,0;3,0;;;1,0;;;;;;;;;;;;;;;;;;2,0;;;;;;;;;;;;;;;;;;;;;;;;;;;;;;;10,0;;;;;;;;;;;;;;;;;;;;;;;;;;;;;;;;2,0;4,0;;;;;;;;;;;;3,0;6,0;;;;;;;;;;;;;;;;;;;;2,0;;;;;;;;1,0;;;;;;;;;;;;;1,0;;;;;;;;;;;;;;;;;;;2,0;;;;;;2,0;;;;2,0;;;;;1,0;;;;4,0;;;;;2,0;27,0;;;;;1,0;18,0;8,0;;;;;;;;;;;;1,0;;;2,0;;;;;;;;3,0;;;6,0;4,0;;;;;;;;;;;;;;;;;;;;;;;;;;;;;;;;14,0;;5,0;;;;3,0;;;4,0;;;;;;3,0;;;;;3,0;;3,0;1,0;;;;;;;;;;;8,0;;;;;;;;;;;;;3,0;;;;;;1,0;;;;;;4,0;;;7,0;;;;3,0;;;;;;;1,0;;1,0;;;1,0;;;;;2,0;;2,0;;;;;;;4,0;;;;;1,0;5,0;;;;;;;;;;;;;;;;;;;;;;;4,0;;;;;;;;;;;;;;;;;;;;;;3,0;;;5,0;;;;;;;;;;;;;;2,0;;;;;;;;;;;;;;;;;;;;;;;;;;;;;;;;;;;;;;;1,0;;;;;;;;;;;;;;;;;;;10,0;;;;;;;;;2,0;;;13,0;;;;;;;;;;;;;;;;;;;;;;;;5,0;;;;;;;7,0;;1,0;;;5,0;;;;;;;;;;;;;;;;;2,0;5,0;;;2,0;;;;;;;;;;;;;;;;;;;;1,0;1,0;1,0;;;;;;;;;;;;;;;;5,0;;;;;;;;;;;;;;;;;;;;;;;;;;;;;;;;;;;;;;;;;;;;;;;;;1,0;8,0;;;;7,0;;;4,0;6,0;;;;;;;;5,0;;;;;;;;;;;;;;;;;;;;;;;;;;;;2,0;;;;
site;;7,0;;;9,0;;;;;2,0;10,0;;;;;;;;;;;9,0;;;;;;34,0;;;3,0;1,0;1,0;;4,0;;;1,0;;3,0;;;;2,0;;;2,0;;;;;1,0;;3,0;;9,0;5,0;;;5,0;1,0;;5,0;;;;;;;1,0;1,0;;;;;1,0;;;1,0;;;;1,0;;;;8,0;;;;3,0;;;;;;;1,0;1,0;1,0;7,0;15,0;;;;;;24,0;;;1,0;8,0;2,0;;;;;;9,0;6,0;;;;10,0;;;;2,0;;;;;;;;;7,0;;;4,0;;;;;;;;9,0;;;;;;;;;;;1,0;2,0;;;;;;;;2,0;1,0;;;;;2,0;;3,0;;20,0;;;;;;;;;;29,0;;;;;8,0;1,0;1,0;;;;2,0;;;;;2,0;;;;;;1,0;1,0;;;;;2,0;;;;;;;;1,0;;;;;1,0;;;;;2,0;;5,0;;2,0;1,0;;;;4,0;;1,0;1,0;;;;;;;;32,0;;;;9,0;;;;;;;12,0;1,0;;;;;1,0;7,0;;;4,0;;;;;1,0;;;;;;;1,0;;1,0;;;;;1,0;;;;5,0;;;;1,0;1,0;;;;;;;;;3,0;;;;;;2,0;;;;;1,0;;;;;;;;5,0;;;;;;;;;;;1,0;;;;;;;;;;;;;;;;;;;;;;;;1,0;;;;;;;;1,0;;;2,0;;;;;;;;;;;;;13,0;;;;3,0;;;;;;;;;;;;1,0;;1,0;;;;1,0;;;;39,0;;;4,0;;7,0;;;;;;;;;7,0;1,0;11,0;;;;;;;;;;;;20,0;;2,0;;;;;;;1,0;;;;;;;3,0;;;;;;;;;;;;;;;;;2,0;;;;;;1,0;;;;;;;;;;;;;19,0;;;;;14,0;;;;;;;;;;;;;;3,0;20,0;;;;;;4,0;12,0;;;2,0;1,0;12,0;;;;;1,0;7,0;;;;;1,0;;;;;;;;2,0;;;;;;;;7,0;;;;;;3,0;;;;;;;;;1,0;;;1,0;;;;;;;1,0;;;1,0;1,0;;;;;;;;;;;;;;;;;;;;;;;;;;;;;;;;2,0;4,0;;;;;;;1,0;;;;;2,0;;;;;;;;;;;;;;;;;;;;;;;;;;;;;;;;;;;;;;1,0;;;;;;;;;;;;;;;;;;;;;;;;;;;;;;;;;;;;;;;;;;;;;;;1,0;;;;;;;;;;;;;;;;;;;;;;;;;;;;;;;;;;;;;;;;;;;;;;;;;;;;;;;;;;;;;;;;;;;;;;2,0;;;4,0;;;;;;;;;;;;;;;;;;;;;;;;;;;;;;;;;;;;;;;;;;;;;;;;;;;;;;;;;;;;;;;;;;;;;;;;;;;;;;;;;;;;;;;;;;;;1,0;;;;;;;2,0;;;;;;;;;;;;;;;;;;;;;;;4,0;;;1,0;;;;;;;;;;;;;;;;;;;;;;;;;;;;;;;;;;;;;;;1,0;;;;;3,0;;;;;;;;;;;;;;;2,0;;;;;;;;;;;;;;;;;;;;;;;;;;;;;
source;;3,0;5,0;;138,0;1,0;41,0;42,0;8,0;59,0;7,0;22,0;;7,0;176,0;20,0;;3,0;13,0;12,0;24,0;101,0;27,0;4,0;16,0;1,0;;86,0;12,0;91,0;45,0;93,0;170,0;8,0;41,0;14,0;34,0;94,0;30,0;68,0;28,0;;108,0;38,0;;;;;6,0;12,0;22,0;110,0;2,0;8,0;;371,0;166,0;;;121,0;5,0;;154,0;;15,0;11,0;6,0;;5,0;24,0;57,0;7,0;43,0;;3,0;1,0;;72,0;105,0;413,0;2,0;57,0;21,0;33,0;1,0;3,0;156,0;;25,0;34,0;63,0;11,0;12,0;166,0;2,0;19,0;10,0;17,0;12,0;34,0;60,0;188,0;3,0;9,0;1,0;4,0;36,0;176,0;;;16,0;29,0;28,0;17,0;10,0;8,0;1,0;3,0;5,0;19,0;;1,0;6,0;79,0;5,0;12,0;74,0;3,0;1,0;35,0;18,0;14,0;6,0;1,0;2,0;49,0;41,0;;12,0;269,0;57,0;36,0;63,0;16,0;38,0;24,0;43,0;262,0;59,0;3,0;6,0;1,0;11,0;32,0;13,0;2,0;1,0;77,0;255,0;67,0;9,0;4,0;;7,0;2,0;12,0;27,0;1780,0;14,0;11,0;30,0;24,0;51,0;46,0;4,0;18,0;5,0;55,0;;;10,0;1,0;13,0;3,0;6,0;35,0;22,0;111,0;4,0;65,0;;;76,0;51,0;1,0;30,0;;;14,0;5,0;12,0;17,0;9,0;13,0;;7,0;3,0;6,0;22,0;13,0;13,0;1,0;5,0;;;31,0;20,0;13,0;5,0;1,0;2,0;1,0;;54,0;9,0;11,0;33,0;;;2,0;3,0;;3,0;12,0;12,0;19,0;7,0;13,0;18,0;;10,0;8,0;26,0;3,0;;4,0;16,0;1,0;1,0;12,0;7,0;;10,0;107,0;15,0;2,0;3,0;12,0;6,0;;6,0;46,0;1,0;;1,0;1,0;8,0;3,0;;1,0;4,0;15,0;5,0;;;11,0;;;8,0;64,0;;;;9,0;;25,0;5,0;81,0;10,0;7,0;18,0;;1,0;16,0;;4,0;1,0;26,0;7,0;2,0;12,0;1,0;35,0;18,0;48,0;;2,0;35,0;9,0;6,0;30,0;5,0;;;3,0;;4,0;;2,0;1,0;2,0;7,0;2,0;1,0;;;1,0;;92,0;1,0;9,0;3,0;4,0;;;2,0;1,0;8,0;3,0;10,0;3,0;14,0;2,0;13,0;5,0;5,0;1,0;2,0;3,0;24,0;5,0;5,0;5,0;17,0;;5,0;2,0;;;1,0;22,0;1,0;;1,0;14,0;5,0;3,0;3,0;52,0;6,0;11,0;1,0;3,0;4,0;6,0;7,0;5,0;4,0;;17,0;14,0;8,0;9,0;9,0;16,0;1,0;;4,0;2,0;15,0;3,0;20,0;2,0;2,0;27,0;6,0;2,0;67,0;8,0;;17,0;;4,0;1,0;8,0;;10,0;3,0;1,0;7,0;7,0;3,0;8,0;8,0;1,0;18,0;1,0;;9,0;93,0;60,0;;9,0;5,0;12,0;2,0;6,0;8,0;42,0;21,0;4,0;4,0;;;;8,0;11,0;;41,0;34,0;1,0;;;;;28,0;3,0;13,0;7,0;1,0;;1,0;47,0;77,0;;2,0;9,0;;2,0;;6,0;;;;1,0;16,0;;1,0;11,0;;;24,0;1,0;;2,0;;4,0;1,0;2,0;7,0;;6,0;;9,0;;17,0;6,0;18,0;8,0;6,0;141,0;46,0;14,0;30,0;51,0;37,0;;49,0;;;;3,0;4,0;10,0;14,0;1,0;1,0;3,0;16,0;1,0;3,0;1,0;4,0;7,0;12,0;5,0;7,0;9,0;2,0;7,0;;6,0;11,0;3,0;1,0;20,0;9,0;1,0;2,0;6,0;;8,0;9,0;;;11,0;1,0;2,0;1,0;;;5,0;5,0;;1,0;4,0;;3,0;;1,0;;3,0;12,0;6,0;1,0;;18,0;6,0;5,0;33,0;63,0;11,0;4,0;;6,0;;31,0;;4,0;2,0;;8,0;2,0;;;;;2,0;1,0;3,0;;2,0;30,0;;;5,0;;;1,0;15,0;3,0;;1,0;12,0;7,0;15,0;1,0;7,0;4,0;;2,0;7,0;2,0;;2,0;2,0;3,0;31,0;;1,0;;3,0;1,0;;8,0;;17,0;;4,0;;3,0;;;18,0;1,0;;;;33,0;1,0;;21,0;8,0;;4,0;;99,0;2,0;;6,0;;3,0;2,0;4,0;;;;;1,0;8,0;;7,0;;4,0;;;;;2,0;2,0;1,0;1,0;;1,0;6,0;7,0;;1,0;;4,0;42,0;;1,0;6,0;3,0;;1,0;1,0;;;21,0;24,0;7,0;9,0;20,0;;8,0;1,0;;5,0;;17,0;1,0;;;2,0;23,0;11,0;4,0;3,0;9,0;9,0;5,0;1,0;4,0;1,0;;5,0;;7,0;;;1,0;15,0;;5,0;106,0;11,0;3,0;11,0;5,0;;;;3,0;1,0;;;2,0;;1,0;2,0;7,0;9,0;4,0;;;;;;11,0;2,0;;7,0;5,0;3,0;;22,0;5,0;1,0;2,0;10,0;8,0;;;2,0;8,0;23,0;3,0;17,0;;3,0;5,0;;;;4,0;7,0;4,0;1,0;13,0;15,0;2,0;7,0;7,0;9,0;9,0;2,0;;;;4,0;;;;1,0;64,0;;;3,0;;;;;3,0;;;5,0;1,0;;;;;;19,0;1,0;10,0;;7,0;;;8,0;;4,0;;4,0;5,0;;;;;3,0;5,0;2,0;1,0;;;;147,0;6,0;12,0;;1,0;;;7,0;2,0;;21,0;;;1,0;9,0;22,0;4,0;;58,0;;;6,0;;;;1,0;;;2,0;3,0;6,0;;4,0;8,0;;2,0;2,0;;12,0;;9,0;;;3,0;1,0;;;;11,0;1,0;5,0;;13,0;;;;;;;2,0;1,0;1,0;;;;;;;;;3,0;;2,0;1,0;;;;1,0;;;;;1,0;8,0;1,0;8,0;2,0;7,0;;1,0;3,0;;6,0;4,0;8,0;;2,0;5,0;;14,0;25,0;;;;1,0;1,0;4,0;;;;;1,0;;;5,0;3,0;2,0;;2,0;;;2,0;8,0;6,0;;7,0;;;2,0;3,0;;4,0;3,0;;1,0;;;;;;;;2,0;1,0;;1,0;;;4,0;;;;;;;;1,0;3,0;2,0;1,0;;;;;;;;;;;;
specific;;13,0;3,0;;8,0;;9,0;15,0;5,0;16,0;2,0;8,0;;;31,0;1,0;;2,0;6,0;1,0;23,0;35,0;2,0;1,0;11,0;;1,0;17,0;;42,0;9,0;9,0;45,0;26,0;19,0;1,0;;45,0;;21,0;12,0;;;5,0;4,0;8,0;;6,0;13,0;11,0;45,0;36,0;1,0;2,0;;147,0;26,0;1,0;20,0;45,0;1,0;;33,0;;2,0;;9,0;;11,0;27,0;4,0;2,0;;;;7,0;;38,0;75,0;3,0;;3,0;8,0;5,0;4,0;;52,0;;4,0;40,0;4,0;;;12,0;10,0;;5,0;9,0;13,0;2,0;23,0;26,0;;3,0;1,0;2,0;;64,0;;3,0;3,0;4,0;10,0;;31,0;5,0;;2,0;5,0;5,0;;;3,0;20,0;;1,0;10,0;1,0;;4,0;7,0;1,0;3,0;;4,0;33,0;8,0;;;2,0;;1,0;4,0;12,0;14,0;5,0;4,0;10,0;;3,0;6,0;;14,0;1,0;;;;;6,0;22,0;1,0;;1,0;1,0;;;12,0;37,0;;1,0;11,0;2,0;10,0;8,0;7,0;;1,0;7,0;;;5,0;1,0;3,0;;;18,0;3,0;20,0;;15,0;;;1,0;26,0;;1,0;;;;;;3,0;;11,0;;;3,0;4,0;2,0;7,0;;;;4,0;;63,0;5,0;1,0;;;;;2,0;1,0;;20,0;10,0;;;;;;;6,0;5,0;2,0;;1,0;66,0;;;;7,0;1,0;;8,0;1,0;1,0;;;4,0;;;4,0;;;;6,0;1,0;;;5,0;;;2,0;2,0;2,0;;;;;2,0;;1,0;;5,0;1,0;;;3,0;;;;;;;2,0;94,0;16,0;;;2,0;2,0;20,0;;3,0;1,0;38,0;;;1,0;;;;;;;15,0;;;32,0;;;;;;;;;;;;1,0;1,0;;7,0;;;3,0;;11,0;;;;;;;2,0;2,0;8,0;;5,0;;1,0;4,0;;1,0;4,0;;25,0;1,0;13,0;;;;;;2,0;;;8,0;1,0;;;11,0;5,0;4,0;1,0;6,0;4,0;12,0;;;1,0;2,0;21,0;;2,0;;6,0;10,0;;1,0;9,0;;3,0;;3,0;;5,0;7,0;1,0;;;1,0;3,0;1,0;19,0;1,0;;1,0;;;3,0;;1,0;;2,0;1,0;;;1,0;2,0;;3,0;2,0;12,0;;9,0;;17,0;2,0;;2,0;25,0;1,0;2,0;7,0;1,0;21,0;4,0;;;4,0;;;;;1,0;;7,0;;;;3,0;5,0;;4,0;5,0;2,0;;9,0;2,0;5,0;;1,0;5,0;;1,0;3,0;8,0;1,0;;;1,0;;5,0;;17,0;;;6,0;;1,0;;19,0;1,0;;2,0;2,0;22,0;;1,0;1,0;;3,0;2,0;2,0;;17,0;;27,0;23,0;2,0;38,0;9,0;;;;;;2,0;8,0;3,0;2,0;1,0;1,0;;;;;;;;5,0;6,0;11,0;2,0;;;;;3,0;;;;1,0;;;;;;;6,0;14,0;;1,0;;;;;3,0;;3,0;;;1,0;;;;1,0;1,0;;;2,0;;5,0;;;9,0;45,0;;1,0;2,0;;4,0;2,0;;;;;1,0;;;;;;1,0;;1,0;;6,0;20,0;;;14,0;;;;;2,0;;;2,0;;;;;1,0;;1,0;;2,0;;;;;;;;;6,0;;;;1,0;;1,0;;;;;1,0;4,0;;;;;3,0;;;;;;;;1,0;;;;;;;;1,0;;;4,0;;;6,0;;1,0;;;;;;;;;;3,0;;;4,0;1,0;;;3,0;;;;;1,0;;;1,0;;1,0;;;1,0;6,0;2,0;;;1,0;;;;;9,0;;1,0;;;2,0;3,0;;29,0;;;;;;;2,0;2,0;2,0;;;;15,0;;3,0;;4,0;1,0;;1,0;;;7,0;;;;;;4,0;;;;;;;1,0;;;;3,0;;;4,0;;;14,0;1,0;12,0;3,0;;;;3,0;4,0;;;;2,0;10,0;;5,0;5,0;2,0;6,0;;;;2,0;;;;;;;;5,0;6,0;1,0;;1,0;;;8,0;4,0;;7,0;;;;;;;35,0;3,0;;5,0;;1,0;;;;;;;2,0;;1,0;2,0;;;;;1,0;;;;;1,0;;;6,0;;;;;;;3,0;1,0;;;;;;;1,0;;;1,0;;;;;1,0;14,0;;;;;2,0;;11,0;1,0;3,0;1,0;1,0;;2,0;;1,0;3,0;;;;;;;;;1,0;;12,0;;;;7,0;;;;7,0;;;;;;;;;;;3,0;;;;;;;3,0;1,0;;;;;1,0;;;;2,0;;2,0;3,0;;;;;;;;;;;;;;1,0;;;2,0;;17,0;;;;;;;;;1,0;;;5,0;16,0;;;;;;1,0;;;;;;;;;;2,0;;;;;;;;;;;;4,0;;;;;;;1,0;;;1,0;;;;;;2,0;;;;;;;3,0;;;;;
stand;;3,0;;;1,0;;1,0;3,0;;1,0;1,0;;;;;;2,0;1,0;;;;;;1,0;;;;;;;;;27,0;;5,0;4,0;;3,0;;2,0;;;1,0;16,0;;;1,0;;;;;;;2,0;;7,0;1,0;;1,0;1,0;;;1,0;;;;;3,0;;1,0;;1,0;;;;;;;19,0;3,0;;2,0;;;;;;;;2,0;;;;;;;;;1,0;;1,0;5,0;;;;;;2,0;;;;;;6,0;2,0;;;;1,0;;;;;1,0;;;4,0;;;1,0;1,0;3,0;1,0;4,0;2,0;2,0;;;;;;;;1,0;;4,0;7,0;1,0;1,0;;;;;;;8,0;2,0;12,0;;2,0;;;;2,0;;;;;;;3,0;;5,0;6,0;;2,0;;;;;2,0;;;;4,0;;;;;7,0;;;1,0;3,0;;;;;;1,0;;1,0;1,0;7,0;1,0;;;;;15,0;;;;2,0;;;;;;;;;;;;;;;;;;;;;1,0;3,0;;1,0;;;;;;5,0;1,0;;8,0;;;;;;;1,0;;;;;;1,0;;;;;;5,0;;1,0;5,0;;;;;;1,0;;;;;;;;;2,0;;7,0;;1,0;8,0;1,0;;;;;;;;;;;;;;3,0;;;;1,0;;;;;;;;;;;10,0;;;;;1,0;;;;;2,0;;2,0;;2,0;;;;;;;;;;;1,0;;;;;;;;;1,0;;;;;;;;;;;;;;;;1,0;;;;;;;;1,0;;;;;;1,0;;;;;;;2,0;;;;;1,0;;;;;;;;;;;;;;;;;;4,0;;;;;;;;;;;1,0;4,0;;;;;;;;;;;2,0;;;1,0;2,0;;;;;;;;;;;;;1,0;;;;;;;;;;;;;;;;;;;;;;;;1,0;;;;;;;;;1,0;2,0;;;;;1,0;;;1,0;;;;;8,0;;;;;;7,0;;;;;;;;;;1,0;;;;;;;;;;;;;;;1,0;;;;;;;;;;;;;1,0;;;1,0;;;;;;;;1,0;;;;;;;;;;;;2,0;;;;;;;;;;1,0;;;;;;6,0;;;;13,0;;;;;;;;;;2,0;;;;;;;;;;;;;1,0;6,0;1,0;;;;;;;;;;2,0;;1,0;;;;2,0;;2,0;;;1,0;2,0;;;;;;;;;;;;;;;;;;;;;;;;;3,0;;4,0;;;;;;;;1,0;;3,0;;;;1,0;;;;;;;;;;;;;;;1,0;;;;;;;;1,0;6,0;;;;;;;;;;;;;;;;;;;;;;;;;;;;;;;;;;;1,0;;;;;;;;;;;;;;;;;;;;;;;;;;;;;;;;;;;;;;;;;;;;3,0;;;;;;;;;;;;;;;;1,0;;;;;;;;;;2,0;;;;;;;;;;;;;;;1,0;;;;;;;;;;;;;;;;;;;;;;;;;;;;;;;;;;;;;;;;;;1,0;;;;;;;;;;;;;;;1,0;;;;;;;;7,0;3,0;;;;;;;;;;;;;;;;;;;;;;;;;;;;;;;;;;;;;;;;;;;;;;;;;;;;;;1,0;;;;;;;;;;;;;;;2,0;;;;;;;;;;;;;;;;;;;;;;;;;;;;;;;;;;;;;;;;;;;;;;
start;;1,0;2,0;1,0;17,0;;3,0;20,0;17,0;136,0;2,0;1,0;;;2,0;;;;;3,0;9,0;177,0;1,0;8,0;19,0;;1,0;47,0;;17,0;7,0;71,0;50,0;16,0;20,0;1,0;6,0;12,0;2,0;50,0;7,0;;28,0;20,0;2,0;;;7,0;58,0;3,0;6,0;13,0;12,0;7,0;;304,0;12,0;;5,0;67,0;;1,0;29,0;9,0;1,0;15,0;16,0;6,0;4,0;123,0;4,0;10,0;13,0;1,0;;2,0;;179,0;181,0;29,0;;25,0;6,0;7,0;;3,0;6,0;;;20,0;22,0;7,0;8,0;86,0;2,0;9,0;;9,0;5,0;;2,0;25,0;;16,0;;;1,0;146,0;;;1,0;2,0;;1,0;;;4,0;;;14,0;;1,0;4,0;24,0;;;24,0;;1,0;;;1,0;;;;6,0;2,0;;;9,0;;;;2,0;;2,0;3,0;34,0;;;;;1,0;;;;;2,0;3,0;32,0;;3,0;;8,0;2,0;;5,0;78,0;;;7,0;20,0;3,0;2,0;16,0;5,0;;50,0;;;1,0;;2,0;10,0;;1,0;;7,0;;38,0;;;;39,0;;;;;13,0;;;;;2,0;;1,0;7,0;;;;;4,0;;;;200,0;8,0;;21,0;;;2,0;2,0;;4,0;;1,0;;3,0;;;;;1,0;9,0;2,0;;2,0;15,0;22,0;;;4,0;;;2,0;2,0;;;1,0;5,0;3,0;;3,0;;;;8,0;;;6,0;43,0;;;1,0;;7,0;;;;;13,0;;4,0;;;7,0;;2,0;7,0;;2,0;;21,0;;26,0;18,0;22,0;28,0;;;;;1,0;;;;44,0;;;2,0;;58,0;;;;;10,0;7,0;;5,0;10,0;;;;;;;;;;7,0;1,0;1,0;;2,0;;;26,0;;9,0;2,0;;1,0;;1,0;;14,0;;;1,0;;2,0;5,0;12,0;;9,0;1,0;;25,0;12,0;58,0;;8,0;;;;;;;2,0;;;;1,0;12,0;;2,0;;;2,0;;3,0;6,0;8,0;2,0;;;;5,0;61,0;28,0;;4,0;4,0;;4,0;;;48,0;8,0;37,0;;;34,0;15,0;;18,0;5,0;;21,0;;;;2,0;2,0;;40,0;8,0;1,0;1,0;8,0;;2,0;;;;;12,0;;;;;10,0;30,0;;;14,0;1,0;;8,0;;;4,0;1,0;;;;8,0;;30,0;;1,0;;;19,0;2,0;2,0;5,0;7,0;;3,0;3,0;11,0;1,0;2,0;;8,0;62,0;;4,0;4,0;3,0;1,0;;3,0;5,0;2,0;1,0;;;35,0;;;;;7,0;6,0;;;2,0;;;3,0;1,0;6,0;1,0;1,0;;12,0;7,0;44,0;2,0;2,0;19,0;8,0;;1,0;8,0;2,0;;64,0;;;11,0;2,0;;;;;;14,0;;19,0;16,0;;;3,0;;3,0;;;2,0;;;153,0;10,0;;;1,0;8,0;;;;;;;;;8,0;;;2,0;;;5,0;;;;;1,0;;;2,0;2,0;;;;;16,0;26,0;1,0;4,0;;;;1,0;1,0;;;;1,0;;;;;;;;;;;1,0;3,0;;2,0;;;;;;;;;;8,0;;;;;;;201,0;;;2,0;3,0;1,0;;5,0;;;;;2,0;;;;;12,0;5,0;;1,0;;;;;;8,0;;;;;20,0;;;;4,0;;;;8,0;;;;39,0;;;;1,0;;;;;;;;;;;;;;;;;2,0;;;;73,0;;1,0;;1,0;;;;10,0;7,0;;;;1,0;;1,0;;1,0;3,0;;1,0;5,0;;;4,0;;3,0;2,0;3,0;;14,0;;;;;;2,0;;7,0;30,0;13,0;1,0;;9,0;3,0;;1,0;1,0;;;;;;;;21,0;;;;;2,0;3,0;;16,0;;;;;;;;;;4,0;;1,0;;2,0;;;;1,0;;1,0;;;;5,0;2,0;;5,0;;;4,0;;;;1,0;;6,0;13,0;9,0;1,0;2,0;;4,0;;;1,0;2,0;8,0;;;;;;14,0;9,0;;;2,0;;;3,0;1,0;;;;;;;4,0;5,0;;;3,0;;1,0;16,0;;;1,0;;;;5,0;;;7,0;;1,0;1,0;;;7,0;;;;1,0;;2,0;;3,0;;;;;;;1,0;;;;;;;2,0;6,0;;;1,0;;;;;;1,0;;;;;13,0;;;;;1,0;;3,0;;;;;;;;;;;;;;;;;;;;;;;;;3,0;;;;;3,0;5,0;;;;;;;;;1,0;;6,0;;;10,0;1,0;;;;;;;7,0;;;1,0;1,0;;;;;;;1,0;;;;1,0;;;;;;;2,0;;;;;;;;1,0;;;;;;;;;;;;;;;;;;;;2,0;;3,0;;;;;;;;;;;;;;;;;;;;;;;;;;
stationary;;2,0;1,0;;50,0;;38,0;5,0;1,0;11,0;18,0;;;;1,0;2,0;;;14,0;;;15,0;6,0;;2,0;;;4,0;6,0;15,0;4,0;13,0;47,0;;1,0;;;91,0;;1,0;1,0;;17,0;;;;;2,0;;;2,0;1,0;;17,0;;50,0;34,0;;3,0;57,0;;;18,0;;;14,0;43,0;;1,0;;13,0;4,0;2,0;3,0;;;;25,0;51,0;5,0;2,0;3,0;1,0;1,0;;;15,0;;;4,0;34,0;5,0;1,0;3,0;;4,0;;;3,0;;17,0;28,0;;2,0;;;;47,0;;3,0;;2,0;;11,0;18,0;;;;105,0;14,0;;4,0;;1,0;;1,0;9,0;16,0;;6,0;1,0;;;1,0;4,0;3,0;9,0;;4,0;;;4,0;;17,0;;12,0;25,0;47,0;9,0;;;1,0;34,0;;1,0;;27,0;22,0;;;;;1,0;1,0;;;1,0;4,0;;6,0;213,0;;13,0;72,0;7,0;4,0;12,0;2,0;;;;;3,0;;14,0;14,0;83,0;8,0;;106,0;1,0;;;14,0;3,0;;;3,0;8,0;9,0;;6,0;;12,0;15,0;4,0;74,0;;2,0;247,0;;;;;6,0;6,0;;;;;1,0;8,0;4,0;;1,0;;;;;;;;2,0;10,0;5,0;1,0;4,0;;2,0;;20,0;;;6,0;2,0;;2,0;;;9,0;;;;6,0;;1,0;;2,0;2,0;1,0;;2,0;;1,0;21,0;2,0;21,0;;4,0;;2,0;12,0;1,0;2,0;;;;;11,0;4,0;;7,0;1,0;4,0;;10,0;16,0;55,0;1,0;4,0;;9,0;2,0;;;5,0;;;1,0;;1,0;;7,0;5,0;7,0;;;8,0;16,0;7,0;5,0;2,0;;;41,0;;25,0;;16,0;;;;10,0;4,0;;6,0;;;2,0;;;1,0;;;;;;;;;;5,0;;1,0;1,0;;;;;6,0;12,0;;2,0;;;;;;;;1,0;;;;1,0;2,0;;;2,0;4,0;;;;2,0;;;;;;32,0;2,0;6,0;;;;;;;;;;;;;2,0;;;7,0;1,0;;2,0;;;1,0;;1,0;;1,0;;1,0;;2,0;3,0;;;1,0;;;;;5,0;;;1,0;1,0;;;;;;1,0;1,0;;;;;;;;;;;;;1,0;;;;1,0;;;;14,0;;;;;;1,0;;;;;;2,0;3,0;85,0;;;;;;;;;;3,0;;;;;;;;;43,0;;;;;;6,0;;2,0;14,0;10,0;;1,0;;;;;;;29,0;;;;;;;;;;3,0;;;;;;;;2,0;;;;1,0;;;;;;;;;;2,0;3,0;;1,0;;;;;;;7,0;1,0;;1,0;;2,0;;;1,0;;1,0;;;;5,0;;1,0;;;;42,0;;1,0;;;;;;1,0;;;;;1,0;;;;;1,0;;;;;;4,0;;;;;;3,0;;;;;1,0;;;7,0;;2,0;;;1,0;1,0;;;;;;;;;;;;;1,0;;;;;;;;;;;;5,0;;;1,0;5,0;;;6,0;;;;;;1,0;1,0;;1,0;;;;3,0;;;;;2,0;;;;;;7,0;;;;;;;1,0;;;;;;;;;;3,0;;;;;;;;;;;;;;;6,0;;4,0;;;;;;;;;;;7,0;;;;4,0;;;;;;;;;;1,0;;;;;;;1,0;;;1,0;;;;;1,0;;;;;;;2,0;;;;1,0;;;;3,0;;;1,0;1,0;;;;;;;;;;2,0;;;;;1,0;10,0;;2,0;;;;;;3,0;;;;;;;;;;7,0;;;;;;;1,0;2,0;;;1,0;;5,0;;1,0;;;;;;5,0;;;;;;;1,0;4,0;;;;;;1,0;;;;;10,0;;;;;6,0;;;;4,0;;;2,0;;;;;;;;;;;15,0;;1,0;;;10,0;;3,0;;;;2,0;;;;;2,0;;10,0;;;;;;;;;;;;;;6,0;;;;1,0;;;;;;;;;;;;;;;;;;1,0;;1,0;;1,0;;;1,0;;;;;;;;;;;;;;;;;;;;;;;;;;;;;;;;;1,0;;;;13,0;;;;;;;;;;;;;;2,0;;;;;;;;;;;;;;;;;;;;;;;;;;;6,0;;;;
stitch;;1,0;;;2,0;;;;;4,0;;;;;3,0;;2,0;;6,0;;;2,0;3,0;;;;;16,0;4,0;;;2,0;;;;;;2,0;;3,0;1,0;;;1,0;2,0;;;;;;;;;;;55,0;1,0;;;2,0;;;17,0;3,0;;;;;;;1,0;1,0;;;;;;10,0;1,0;;;;14,0;;;;;;;1,0;8,0;;;;;4,0;;;;;2,0;6,0;;;;;;;;;;1,0;1,0;4,0;;;;;;;;;;;;;3,0;;;;;4,0;;;;;;;;;;;;;;;11,0;3,0;;;;;;;;;;;;;;;;;;;;;;1,0;4,0;;1,0;;4,0;;;;;;2,0;;1,0;;;3,0;;;;1,0;;;;3,0;;;;;;;;;;1,0;;;;;;;;;;;;;;1,0;;;2,0;;;;;;2,0;;;;;;;;1,0;;;;7,0;;;;;;;;;;;;;;;2,0;;2,0;;2,0;;;;;3,0;2,0;;;2,0;;;;;;;;;;;;;;;;;;;2,0;;3,0;6,0;;;;1,0;7,0;;;;5,0;;;;;;;;;;;;;;8,0;;;;;;;;;;;;;;;;;;;2,0;1,0;;;;;;;;;4,0;;;;;;;;;;4,0;;;;;;;;;;2,0;;;;;;;;;;;;;;;3,0;;;;;;;;;;;;;;;;;;;;;;;;;;;;;;;1,0;;;1,0;;1,0;;3,0;;;;;5,0;;;;;;;;;5,0;1,0;1,0;2,0;;;;;;;;;;;;;;1,0;1,0;;;;;3,0;11,0;3,0;;;1,0;;;;;;;;;;;;;;;;6,0;;;;1,0;;;;2,0;;;;;;1,0;;;;;;;;;5,0;3,0;;;;;2,0;;;;1,0;;;;;;;;;;;;;;;;;;;;;;;;;;;;;;;;;;;;;;;;;;;17,0;;;1,0;;;;;;;;;;2,0;;;;;;;;;;;;;;;;;2,0;;;;;;;;;;;;4,0;;;;;;;;;;;;;;;;;;;;;;;;;;;;;;;;;;;;;;;;;;;;;3,0;;;;;;;1,0;;;;;;;3,0;;;;;;;;;;;;;;;;;;;;;;;;;;;;;1,0;;;;;;;2,0;;;;;;;;;;1,0;;;;;;;;;;;;;;;1,0;;;;2,0;;;;;;;;;;6,0;;;5,0;;;;;;1,0;;;7,0;;1,0;;;;;;;;;;;;;;;;;;2,0;1,0;;;1,0;;1,0;;1,0;;;;;;;;;;;;;;1,0;;;;14,0;;;;;2,0;;;;;;;;;;;;;;;;;1,0;;;;;;;;;;;;;;;;;;;;;;;;;;;;;;;;;;;;;;;;;;;;;;;;;;;;;;;;;2,0;;;;;;;;;;;;;;;;;;;3,0;;;;;;;;;;;;;;;;;;;;;;;;;;;;;;;3,0;;;;1,0;;;;;;;1,0;;;;;;;;;;;;;;;;;;;;;;;;;;;;;;;;;;;;;;;;;;;;;;;;;;;;;;;;;;;;;;;;;;;;;;;6,0;;;;;;;
strap;;4,0;;;14,0;;;3,0;;;;;;;;;;;1,0;;;2,0;;;;;;;;;;;12,0;;1,0;;;;;;;;;2,0;;;4,0;;;;;;;1,0;;1,0;7,0;;1,0;11,0;;;2,0;;;;;;;;;;;;;1,0;;;2,0;;;;;;;;;;;;;;;;2,0;1,0;;2,0;;;1,0;32,0;;1,0;;;;;;;;;;3,0;45,0;1,0;;;;6,0;;;;;;;11,0;2,0;;14,0;8,0;;;;;;1,0;;1,0;;;;2,0;1,0;;;;9,0;1,0;;;;1,0;;;;5,0;4,0;;;;;;;;;;;;3,0;4,0;;;4,0;;7,0;;;;;3,0;;5,0;;;;;8,0;;46,0;;;;11,0;;;;;;29,0;;3,0;;6,0;;;;;15,0;6,0;;1,0;;;;1,0;;;;;1,0;;;;;;;;;;;;;7,0;;;;;6,0;;;;;2,0;;5,0;2,0;;;;;;;17,0;;;;;;;;;;2,0;14,0;2,0;;3,0;;;2,0;3,0;;;;;;;;;1,0;;;21,0;;;1,0;3,0;;4,0;;;;;;;;;;;;;;;;1,0;1,0;;2,0;;;1,0;;2,0;1,0;;;;1,0;;;;;;;;;2,0;;;5,0;2,0;;;;;;;;;;;;;;;;2,0;;;11,0;;;;;;;;;;;;;;;;;;3,0;;;;;;;1,0;;;;;;;;;;;;;;;;;;;;;;;;;;;;;;;;;;;;2,0;;;;;;;;;2,0;;;;;;;;;;;;;;;;;;;1,0;;;;;;;;;;;;;;;;;;;;;;;;;;;;;;;;1,0;;;;;;;;;;;;;;;;;;;;;;;;;;;;;;;;;16,0;4,0;;;;;;;;;;;5,0;;;;;1,0;;;;;1,0;;;;;;3,0;;;;1,0;;7,0;;;;;;3,0;;;;;;;;1,0;;;;;;1,0;;;;;;3,0;;;;;;;;;;;;15,0;;;;;;;;;2,0;9,0;;;;;3,0;;;;;;2,0;1,0;;;;;;1,0;;;;;17,0;;;;;;;;;1,0;;;1,0;;;;35,0;2,0;;;1,0;;;12,0;2,0;;2,0;;;1,0;;6,0;;;;;;;;;;2,0;;;;;;;;;;;;;;;;;;;;;;;;;4,0;;;;;;;;;;;;;;;;;;;;;;;;;;;;;;;;;;;;;;;;;;;;12,0;;;;;;;;;;;;;;;;;;;;;;;;;;;;;;;;;;;;1,0;;;;;;2,0;;;;;;;;;;;;;;;;1,0;;;;;;1,0;;;;;;;;;;;;;;3,0;;;;;;;;;;;;;;;;1,0;;;;1,0;;;;;;;;;;;;;;;;;;;;;1,0;;;;;;;;;;;;;;;;;;;;1,0;;;;;;;;;;;7,0;;;;;7,0;;;;;;;;;;;;;;;;;;;;;;;;;;;;;;;;;;;;;;;;;;;;;;;;;;;;;;;3,0;;;;;;;;;;;;;;;;;;;;;;;;;;;;;;;;;;;;;;;;;;;;;;;;;;;;;;;;;;;;;;;;;;;;;;
structure;;3,0;;2,0;59,0;;39,0;72,0;2,0;19,0;11,0;2,0;4,0;;16,0;1,0;5,0;8,0;24,0;1,0;;12,0;5,0;;10,0;;4,0;42,0;2,0;13,0;29,0;26,0;88,0;4,0;23,0;1,0;5,0;39,0;;21,0;3,0;1,0;29,0;79,0;;;6,0;;25,0;2,0;10,0;4,0;;12,0;1,0;130,0;142,0;5,0;17,0;230,0;5,0;1,0;26,0;;6,0;9,0;9,0;1,0;;17,0;29,0;5,0;1,0;9,0;2,0;;13,0;19,0;70,0;3,0;11,0;39,0;15,0;2,0;;3,0;35,0;4,0;6,0;1,0;53,0;4,0;2,0;17,0;2,0;9,0;;6,0;6,0;40,0;59,0;129,0;;10,0;1,0;1,0;1,0;75,0;;8,0;11,0;26,0;9,0;50,0;57,0;3,0;1,0;;5,0;34,0;6,0;;2,0;15,0;2,0;2,0;33,0;20,0;1,0;55,0;22,0;4,0;1,0;3,0;12,0;19,0;62,0;;9,0;4,0;;1,0;7,0;6,0;7,0;15,0;81,0;41,0;1,0;3,0;;12,0;14,0;17,0;40,0;26,0;8,0;72,0;3,0;33,0;2,0;3,0;48,0;9,0;1,0;21,0;8,0;66,0;2,0;18,0;129,0;12,0;66,0;213,0;9,0;14,0;21,0;67,0;2,0;16,0;10,0;2,0;2,0;3,0;1,0;10,0;23,0;77,0;3,0;196,0;1,0;10,0;4,0;67,0;4,0;;6,0;16,0;14,0;100,0;5,0;14,0;3,0;29,0;1,0;2,0;3,0;2,0;;381,0;1,0;6,0;1,0;5,0;11,0;6,0;5,0;30,0;;8,0;11,0;50,0;5,0;1,0;7,0;9,0;6,0;9,0;;10,0;4,0;2,0;4,0;10,0;3,0;11,0;2,0;16,0;18,0;3,0;34,0;;12,0;6,0;;7,0;4,0;13,0;;3,0;5,0;;8,0;51,0;4,0;;1,0;22,0;1,0;7,0;2,0;2,0;9,0;8,0;28,0;9,0;18,0;22,0;1,0;4,0;;21,0;7,0;1,0;1,0;1,0;3,0;2,0;9,0;9,0;13,0;1,0;7,0;56,0;2,0;29,0;6,0;22,0;3,0;10,0;1,0;;;6,0;;3,0;4,0;1,0;3,0;1,0;;;2,0;2,0;4,0;3,0;2,0;3,0;13,0;6,0;12,0;8,0;;3,0;9,0;;21,0;;15,0;62,0;1,0;5,0;2,0;1,0;;22,0;1,0;2,0;4,0;;4,0;1,0;4,0;;;;;4,0;3,0;1,0;2,0;8,0;;2,0;;;1,0;17,0;;6,0;1,0;;4,0;1,0;;1,0;;;3,0;2,0;10,0;2,0;;3,0;7,0;;;;2,0;;;8,0;;15,0;4,0;6,0;2,0;;;11,0;1,0;5,0;1,0;3,0;1,0;;1,0;3,0;1,0;4,0;2,0;13,0;1,0;;5,0;2,0;;27,0;;1,0;5,0;;;;1,0;;;4,0;;;4,0;11,0;2,0;;;1,0;16,0;;2,0;5,0;5,0;;;2,0;4,0;;;5,0;;7,0;2,0;;;;;;;;;2,0;4,0;;1,0;;;2,0;6,0;1,0;2,0;;;;16,0;17,0;2,0;;;;2,0;;;;;2,0;;4,0;72,0;;7,0;3,0;;7,0;;;5,0;3,0;17,0;;;;10,0;4,0;;;;12,0;1,0;;;;;1,0;8,0;2,0;41,0;11,0;;1,0;4,0;;1,0;;2,0;1,0;11,0;12,0;;3,0;;9,0;4,0;;;3,0;12,0;22,0;6,0;;;;;4,0;1,0;14,0;;;7,0;;;4,0;1,0;;;4,0;;;1,0;;6,0;;;6,0;;7,0;18,0;;3,0;4,0;;7,0;1,0;2,0;22,0;;5,0;;;;5,0;;32,0;3,0;4,0;;2,0;;31,0;;;;1,0;;;;;;2,0;;;;;;7,0;;;7,0;3,0;;;;3,0;6,0;5,0;1,0;2,0;5,0;2,0;;8,0;5,0;;;5,0;;1,0;;;;;36,0;1,0;1,0;3,0;;1,0;;3,0;2,0;;1,0;;2,0;1,0;7,0;1,0;;;15,0;3,0;3,0;;10,0;9,0;7,0;2,0;1,0;;1,0;14,0;5,0;7,0;1,0;3,0;10,0;;1,0;;3,0;;;7,0;13,0;1,0;3,0;13,0;2,0;;11,0;;;6,0;4,0;4,0;;;1,0;;;;;;;;2,0;11,0;3,0;5,0;;1,0;;1,0;;3,0;2,0;4,0;1,0;;;;;2,0;4,0;;;;;4,0;11,0;;1,0;1,0;2,0;;4,0;;1,0;;;;7,0;1,0;5,0;;5,0;;2,0;6,0;;;1,0;3,0;9,0;1,0;;;;4,0;;;;9,0;;;;;1,0;;;;10,0;2,0;;1,0;;1,0;;;3,0;2,0;;;1,0;32,0;;;2,0;3,0;;3,0;9,0;;3,0;;3,0;;1,0;3,0;1,0;1,0;;;2,0;1,0;;;3,0;10,0;;;;;;;;;;;;;;;;;;;;;3,0;11,0;;;;;;;;11,0;;1,0;1,0;;;2,0;4,0;2,0;;;;1,0;;;;2,0;;;4,0;1,0;2,0;5,0;1,0;2,0;1,0;2,0;4,0;3,0;1,0;2,0;27,0;1,0;;;3,0;10,0;1,0;;4,0;27,0;;;;10,0;;;;;7,0;1,0;;14,0;2,0;;4,0;;2,0;;;24,0;25,0;;41,0;;;1,0;6,0;10,0;;;;1,0;;;;1,0;;1,0;2,0;;1,0;2,0;;;;;;;6,0;1,0;;;;;4,0;4,0;;;;14,0;;;;3,0;;5,0;;;1,0;;;;;;;2,0;;;;;;2,0;13,0;;;;;;3,0;1,0;;;;;;;1,0;;;2,0;;1,0;;;1,0;1,0;;;;;1,0;;;;2,0;;1,0;2,0;;1,0;3,0;;;4,0;;;;;2,0;;;4,0;;;;;6,0;;;;;;1,0;;;;;;1,0;1,0;;;
supply;;4,0;9,0;;36,0;;12,0;20,0;2,0;3,0;;1,0;;;13,0;1,0;1,0;;10,0;3,0;8,0;176,0;;2,0;1,0;;;112,0;;28,0;22,0;3,0;136,0;2,0;28,0;;4,0;26,0;1,0;29,0;1,0;;22,0;25,0;;1,0;;1,0;;32,0;4,0;36,0;;4,0;;103,0;67,0;;;47,0;1,0;;20,0;;1,0;12,0;5,0;2,0;;34,0;11,0;3,0;1,0;;;1,0;2,0;5,0;18,0;944,0;;23,0;20,0;;;;8,0;;4,0;25,0;28,0;4,0;1,0;319,0;;2,0;;10,0;9,0;21,0;18,0;60,0;;33,0;;;3,0;233,0;2,0;;7,0;14,0;3,0;7,0;;;;;8,0;16,0;;;3,0;96,0;;;81,0;4,0;;10,0;9,0;1,0;14,0;;7,0;11,0;8,0;;58,0;25,0;33,0;;45,0;1,0;13,0;5,0;9,0;7,0;1,0;;;;7,0;3,0;3,0;2,0;5,0;19,0;10,0;21,0;;3,0;;;;10,0;26,0;73,0;12,0;14,0;20,0;;43,0;20,0;;;;41,0;1,0;;5,0;;;;;3,0;5,0;69,0;;36,0;;;;25,0;;;;1,0;1,0;;7,0;1,0;;4,0;;3,0;14,0;2,0;4,0;6,0;;2,0;;;;17,0;5,0;4,0;;1,0;5,0;1,0;;;1,0;2,0;1,0;;;1,0;3,0;2,0;4,0;4,0;5,0;;;11,0;2,0;;10,0;1,0;2,0;;5,0;2,0;4,0;;;23,0;5,0;;12,0;104,0;1,0;1,0;1,0;17,0;2,0;;3,0;51,0;1,0;;2,0;;11,0;;1,0;;2,0;4,0;14,0;4,0;2,0;1,0;;;;25,0;1,0;3,0;;26,0;1,0;1,0;1,0;6,0;17,0;4,0;;1,0;1,0;;1,0;;4,0;2,0;;1,0;10,0;;16,0;;2,0;;1,0;9,0;1,0;;17,0;18,0;2,0;;1,0;4,0;;4,0;;7,0;5,0;18,0;5,0;1,0;;92,0;;2,0;;;7,0;6,0;1,0;;;3,0;;;7,0;;;2,0;2,0;2,0;;2,0;11,0;1,0;4,0;20,0;;2,0;1,0;17,0;;1,0;2,0;;;1,0;;;;10,0;1,0;6,0;;1,0;12,0;;10,0;;;;15,0;17,0;;;;;7,0;6,0;1,0;1,0;28,0;;;8,0;;23,0;4,0;8,0;;;3,0;;26,0;;7,0;;2,0;;;;;;;;;1,0;;3,0;2,0;3,0;8,0;;;;15,0;;1,0;;;15,0;26,0;10,0;;8,0;;1,0;;;;;;1,0;5,0;;1,0;57,0;38,0;;;6,0;2,0;43,0;10,0;12,0;;2,0;;;2,0;9,0;;3,0;;1,0;1,0;;13,0;2,0;1,0;;2,0;2,0;3,0;;;;;24,0;;;6,0;;72,0;;;1,0;1,0;;;1,0;;2,0;;17,0;2,0;10,0;;97,0;12,0;33,0;40,0;;1,0;152,0;;;;8,0;;;;;3,0;1,0;;3,0;;;;;33,0;7,0;15,0;1,0;2,0;;;;6,0;;;22,0;2,0;1,0;;4,0;;;1,0;9,0;1,0;;;1,0;;;;;;1,0;;3,0;1,0;;5,0;1,0;;64,0;2,0;;7,0;;5,0;;7,0;4,0;45,0;5,0;11,0;;;;2,0;;1,0;;17,0;1,0;1,0;;;;4,0;;;4,0;;;;2,0;1,0;29,0;3,0;;;;11,0;3,0;;12,0;2,0;14,0;3,0;8,0;1,0;;8,0;1,0;2,0;;;;5,0;2,0;;;1,0;;;;;;1,0;;2,0;;49,0;;;13,0;2,0;;2,0;;1,0;1,0;;111,0;;4,0;;;;;;3,0;;;;10,0;;13,0;;;;;3,0;4,0;;;1,0;;1,0;;;;;8,0;;;;4,0;2,0;;;;;;4,0;1,0;1,0;;2,0;;2,0;;5,0;3,0;13,0;5,0;;13,0;;2,0;;3,0;1,0;95,0;2,0;;;1,0;7,0;12,0;;4,0;;;3,0;;;;;;;2,0;1,0;4,0;;9,0;;;33,0;;;;18,0;;;;;;;;6,0;;2,0;73,0;2,0;;;;;;;;;;21,0;16,0;;6,0;;1,0;4,0;;;13,0;;8,0;;;4,0;2,0;1,0;27,0;4,0;2,0;;;1,0;;;3,0;1,0;;;9,0;3,0;;;14,0;6,0;2,0;;;;1,0;;;;2,0;;;;;;;;;2,0;;;;;;;;;;;1,0;1,0;;;2,0;;;;1,0;1,0;1,0;1,0;;;;;;;;;;;6,0;1,0;;;3,0;;;;1,0;;;1,0;3,0;;2,0;2,0;1,0;;1,0;8,0;;;;;;1,0;;;;12,0;;15,0;;;5,0;;6,0;;;;1,0;;;1,0;15,0;;;6,0;;;;;;;;;3,0;;;;;;;;1,0;;1,0;2,0;;;;;;9,0;;;;;;;;;;;;;1,0;;4,0;;;2,0;;;;;;1,0;1,0;;;;;1,0;;;;1,0;;;;;;;;;1,0;;;;;;;8,0;1,0;;1,0;2,0;;;;;1,0;;;;;;;;;;;;1,0;1,0;;;;;;;;;;;1,0;;;5,0;;;;;;;;;;;;;
support;;15,0;3,0;;146,0;;145,0;289,0;;38,0;26,0;1,0;2,0;6,0;3,0;4,0;3,0;9,0;37,0;10,0;;38,0;4,0;4,0;31,0;;7,0;10,0;4,0;10,0;22,0;16,0;283,0;;54,0;;7,0;327,0;2,0;84,0;24,0;;93,0;267,0;;;12,0;5,0;52,0;;23,0;2,0;;52,0;11,0;139,0;295,0;;57,0;661,0;18,0;;60,0;;;54,0;100,0;4,0;;4,0;183,0;14,0;14,0;29,0;2,0;9,0;7,0;51,0;225,0;13,0;11,0;5,0;5,0;4,0;;;35,0;5,0;4,0;15,0;106,0;2,0;5,0;11,0;20,0;27,0;;12,0;;82,0;289,0;220,0;;3,0;;;;246,0;;6,0;38,0;60,0;5,0;132,0;168,0;7,0;;2,0;218,0;216,0;10,0;25,0;;30,0;13,0;;103,0;85,0;;102,0;70,0;2,0;;99,0;13,0;16,0;80,0;14,0;4,0;11,0;;;5,0;61,0;13,0;33,0;162,0;269,0;;;;43,0;81,0;3,0;74,0;93,0;138,0;184,0;;104,0;3,0;4,0;115,0;17,0;3,0;9,0;27,0;30,0;1,0;14,0;1285,0;29,0;162,0;361,0;29,0;49,0;91,0;;4,0;2,0;29,0;6,0;11,0;9,0;84,0;50,0;272,0;129,0;;523,0;1,0;79,0;;60,0;9,0;;;7,0;109,0;73,0;17,0;53,0;4,0;149,0;2,0;7,0;70,0;247,0;381,0;;4,0;18,0;3,0;1,0;43,0;1,0;1,0;19,0;3,0;47,0;93,0;22,0;6,0;3,0;25,0;;6,0;1,0;7,0;9,0;9,0;5,0;30,0;39,0;38,0;23,0;24,0;12,0;27,0;;103,0;55,0;26,0;66,0;8,0;21,0;6,0;25,0;13,0;23,0;21,0;5,0;12,0;163,0;9,0;3,0;18,0;66,0;22,0;6,0;;37,0;47,0;38,0;90,0;18,0;164,0;10,0;8,0;26,0;15,0;55,0;10,0;4,0;41,0;11,0;;5,0;8,0;20,0;23,0;22,0;3,0;174,0;8,0;5,0;73,0;30,0;12,0;59,0;1,0;16,0;;;;29,0;;18,0;7,0;3,0;34,0;12,0;21,0;12,0;24,0;10,0;39,0;14,0;41,0;65,0;10,0;20,0;8,0;4,0;70,0;7,0;59,0;3,0;32,0;7,0;5,0;6,0;132,0;30,0;1,0;13,0;23,0;71,0;6,0;1,0;28,0;;21,0;;;;;1,0;;1,0;6,0;6,0;6,0;;4,0;;1,0;24,0;1,0;8,0;5,0;1,0;;;;;;;13,0;1,0;;;2,0;;;;;;3,0;;;9,0;;5,0;8,0;3,0;6,0;;;104,0;;12,0;8,0;;;;;7,0;;1,0;4,0;8,0;69,0;11,0;23,0;7,0;;4,0;1,0;;13,0;1,0;1,0;;11,0;;;5,0;9,0;;23,0;15,0;7,0;2,0;5,0;4,0;12,0;;6,0;3,0;13,0;;;20,0;36,0;3,0;3,0;2,0;1,0;2,0;;;;1,0;;34,0;;;;7,0;23,0;2,0;9,0;3,0;1,0;21,0;;2,0;;28,0;1,0;;22,0;17,0;12,0;2,0;1,0;;4,0;;;;1,0;2,0;18,0;17,0;296,0;16,0;2,0;4,0;;6,0;31,0;;;;44,0;1,0;1,0;1,0;2,0;1,0;;1,0;;72,0;6,0;9,0;;1,0;7,0;9,0;9,0;5,0;61,0;11,0;4,0;;6,0;4,0;1,0;;;1,0;33,0;43,0;;21,0;;7,0;13,0;;;7,0;9,0;40,0;9,0;;;1,0;20,0;31,0;;8,0;;;15,0;6,0;;2,0;6,0;;6,0;;;;3,0;10,0;1,0;;;2,0;;25,0;10,0;6,0;101,0;14,0;2,0;6,0;1,0;3,0;4,0;;10,0;16,0;5,0;6,0;24,0;2,0;7,0;;20,0;;6,0;4,0;96,0;;5,0;;2,0;;;2,0;5,0;1,0;20,0;;;4,0;;;13,0;;;29,0;47,0;;;;18,0;6,0;11,0;7,0;22,0;1,0;2,0;4,0;5,0;21,0;2,0;;2,0;2,0;30,0;;2,0;9,0;8,0;;6,0;49,0;;;1,0;;6,0;9,0;5,0;1,0;;1,0;;23,0;3,0;7,0;15,0;6,0;1,0;13,0;;18,0;48,0;34,0;2,0;17,0;18,0;8,0;108,0;19,0;3,0;1,0;13,0;6,0;;;1,0;3,0;5,0;4,0;;7,0;16,0;4,0;14,0;10,0;7,0;;1,0;5,0;13,0;;;3,0;12,0;8,0;4,0;8,0;11,0;;4,0;;1,0;2,0;34,0;2,0;2,0;14,0;;;;;;;;;;2,0;;;1,0;6,0;;;;;;39,0;2,0;;1,0;;;;3,0;7,0;;;;1,0;;2,0;;1,0;;;;1,0;21,0;13,0;;;36,0;;;9,0;;;6,0;;2,0;;;1,0;;;;2,0;1,0;14,0;;1,0;;;;4,0;2,0;;;;2,0;27,0;9,0;6,0;;;;1,0;1,0;7,0;1,0;;;1,0;;;;;1,0;;;7,0;8,0;;2,0;39,0;;6,0;;;;4,0;;9,0;;;;;1,0;;;;;10,0;5,0;;3,0;11,0;;1,0;;;;26,0;;2,0;;;1,0;2,0;;;;4,0;6,0;;;;1,0;;;;;7,0;;28,0;6,0;;;;3,0;14,0;3,0;3,0;;3,0;;;3,0;2,0;2,0;;22,0;2,0;2,0;7,0;;;;22,0;5,0;17,0;;;;;13,0;6,0;16,0;;4,0;24,0;3,0;8,0;2,0;;7,0;5,0;;4,0;;;2,0;13,0;39,0;2,0;1,0;;;3,0;;;12,0;42,0;68,0;;;2,0;10,0;;;;2,0;;;;;;;2,0;;3,0;20,0;4,0;1,0;;18,0;;;;;;;11,0;;;;3,0;3,0;;;15,0;4,0;;;;;;;12,0;;;;;;;4,0;3,0;;4,0;;;1,0;1,0;;;;;;;2,0;;11,0;10,0;;3,0;;;1,0;1,0;;;;;;1,0;;;;;;4,0;10,0;;4,0;2,0;19,0;;;;;1,0;1,0;;;;2,0;;;;;;;;;;;;1,0;
switch;;5,0;9,0;1,0;87,0;;4,0;41,0;2,0;33,0;2,0;2,0;1,0;;13,0;10,0;;9,0;8,0;9,0;8,0;365,0;15,0;3,0;44,0;;;64,0;;50,0;49,0;53,0;286,0;2,0;88,0;1,0;;47,0;2,0;262,0;1,0;;19,0;90,0;2,0;1,0;1,0;2,0;47,0;27,0;123,0;26,0;4,0;11,0;;416,0;159,0;2,0;19,0;149,0;;22,0;117,0;2,0;1,0;8,0;7,0;5,0;3,0;424,0;62,0;15,0;15,0;;2,0;7,0;;19,0;188,0;238,0;7,0;49,0;42,0;2,0;;3,0;29,0;;;75,0;30,0;14,0;34,0;260,0;4,0;;;35,0;10,0;8,0;49,0;122,0;;55,0;2,0;21,0;23,0;407,0;;;27,0;15,0;5,0;6,0;7,0;;1,0;;1,0;39,0;;;30,0;178,0;;;98,0;21,0;1,0;38,0;11,0;;14,0;;;3,0;31,0;;22,0;8,0;8,0;;12,0;20,0;20,0;11,0;6,0;63,0;;;;;;;38,0;5,0;1,0;26,0;2,0;54,0;2,0;1,0;12,0;1,0;;7,0;10,0;50,0;11,0;6,0;69,0;36,0;94,0;33,0;7,0;48,0;13,0;105,0;;;14,0;1,0;3,0;7,0;1,0;3,0;9,0;60,0;;64,0;2,0;2,0;2,0;49,0;1,0;1,0;;;10,0;;1,0;7,0;;40,0;;27,0;6,0;6,0;1,0;9,0;;4,0;5,0;;3,0;99,0;30,0;4,0;;;3,0;5,0;2,0;1,0;1,0;3,0;1,0;;3,0;;;3,0;19,0;7,0;12,0;13,0;;19,0;30,0;57,0;22,0;;5,0;;1,0;15,0;3,0;1,0;2,0;6,0;18,0;;5,0;168,0;1,0;1,0;1,0;7,0;2,0;;2,0;35,0;1,0;;7,0;;6,0;1,0;;;7,0;2,0;;10,0;4,0;7,0;2,0;5,0;18,0;1,0;1,0;;4,0;48,0;;6,0;9,0;7,0;146,0;;3,0;;;10,0;;;11,0;111,0;5,0;;3,0;;68,0;;4,0;2,0;;19,0;1,0;;27,0;11,0;5,0;1,0;;;7,0;;;3,0;;28,0;1,0;5,0;;46,0;;3,0;97,0;;39,0;2,0;;;;4,0;1,0;18,0;3,0;;;5,0;3,0;8,0;25,0;;;34,0;;34,0;42,0;10,0;;4,0;;;2,0;;;1,0;;2,0;;4,0;;53,0;2,0;3,0;12,0;;7,0;;;5,0;32,0;33,0;9,0;1,0;;25,0;31,0;14,0;;;9,0;;2,0;4,0;;68,0;35,0;60,0;3,0;;79,0;1,0;44,0;12,0;15,0;;3,0;;1,0;;;;29,0;36,0;4,0;19,0;;7,0;3,0;9,0;;13,0;2,0;;63,0;;3,0;7,0;5,0;26,0;627,0;5,0;;33,0;;1,0;1,0;;;;11,0;2,0;1,0;5,0;17,0;5,0;73,0;;1,0;;;70,0;19,0;7,0;11,0;12,0;;12,0;7,0;3,0;;7,0;;29,0;51,0;;1,0;6,0;11,0;;21,0;26,0;9,0;8,0;3,0;1,0;;108,0;;;8,0;;25,0;;9,0;2,0;7,0;;15,0;11,0;;10,0;57,0;69,0;42,0;77,0;2,0;;6,0;150,0;53,0;46,0;13,0;35,0;9,0;;;1,0;;;5,0;2,0;6,0;;;;4,0;;15,0;9,0;43,0;45,0;5,0;2,0;;2,0;;;;;;2,0;5,0;;;2,0;;;2,0;41,0;18,0;;1,0;;1,0;;1,0;;7,0;8,0;;;;;6,0;2,0;1,0;;;;12,0;;65,0;3,0;1,0;6,0;11,0;7,0;10,0;2,0;;6,0;;50,0;;;;2,0;;6,0;2,0;;;;1,0;;;11,0;5,0;3,0;2,0;43,0;1,0;;;;10,0;;;25,0;4,0;14,0;;;;;17,0;;23,0;11,0;;1,0;1,0;8,0;;;;;1,0;;;1,0;4,0;;;;36,0;;13,0;2,0;;;1,0;;18,0;;;16,0;3,0;8,0;5,0;;6,0;;1,0;;;15,0;;1,0;;6,0;;;;3,0;;3,0;;1,0;;4,0;;2,0;;;5,0;;2,0;;1,0;1,0;4,0;;;;;;3,0;;2,0;1,0;;;4,0;1,0;30,0;2,0;1,0;2,0;2,0;38,0;;7,0;43,0;4,0;10,0;29,0;4,0;;;5,0;40,0;1,0;;2,0;5,0;;17,0;;1,0;;1,0;;;36,0;7,0;;;7,0;;3,0;32,0;20,0;7,0;3,0;41,0;11,0;;;;;;8,0;;;69,0;21,0;4,0;10,0;1,0;;1,0;;1,0;2,0;;;;8,0;;;;11,0;;;;;3,0;;;;4,0;23,0;3,0;;10,0;10,0;;;14,0;;14,0;5,0;1,0;7,0;4,0;4,0;4,0;20,0;;3,0;;4,0;46,0;;;;;4,0;;1,0;15,0;1,0;;;1,0;2,0;;;2,0;;5,0;;;4,0;2,0;;10,0;1,0;2,0;5,0;;1,0;;1,0;2,0;5,0;;1,0;;26,0;;;1,0;;18,0;2,0;;;;2,0;;;;3,0;7,0;;;16,0;6,0;1,0;;;5,0;1,0;;7,0;;4,0;1,0;;12,0;4,0;;6,0;11,0;;2,0;4,0;;;6,0;1,0;22,0;;13,0;4,0;1,0;;;;5,0;1,0;5,0;1,0;;;12,0;;1,0;;24,0;1,0;;2,0;;;1,0;;;;1,0;;;4,0;;;;7,0;;;;;3,0;;;1,0;;2,0;;;;;;;;10,0;;4,0;;3,0;;;;;;;;;2,0;4,0;;;1,0;;11,0;2,0;5,0;;2,0;4,0;;1,0;;;;;2,0;;;;2,0;;;;3,0;;;;1,0;;;;;;;;;;;;13,0;2,0;;;;1,0;;;;;;;;;;;;;;;1,0;16,0;;;;;;;1,0;;;;;
terminal;;8,0;2,0;4,0;180,0;;12,0;32,0;3,0;15,0;3,0;;;1,0;4,0;;2,0;;1,0;14,0;13,0;99,0;1,0;1,0;7,0;;1,0;66,0;3,0;25,0;28,0;39,0;251,0;4,0;67,0;;4,0;35,0;;252,0;10,0;;1,0;19,0;4,0;1,0;;2,0;;;68,0;38,0;;91,0;;169,0;215,0;;2,0;153,0;1,0;;92,0;;;20,0;4,0;;1,0;67,0;12,0;;2,0;3,0;3,0;2,0;5,0;13,0;62,0;52,0;3,0;51,0;14,0;3,0;;2,0;63,0;2,0;2,0;23,0;47,0;;99,0;113,0;6,0;14,0;;27,0;21,0;46,0;65,0;74,0;1,0;13,0;3,0;2,0;23,0;168,0;;;22,0;27,0;4,0;64,0;15,0;2,0;;;32,0;209,0;1,0;;12,0;53,0;;;40,0;158,0;;33,0;35,0;2,0;4,0;;1,0;4,0;56,0;17,0;18,0;7,0;;;57,0;18,0;3,0;5,0;76,0;8,0;;;;19,0;17,0;1,0;7,0;16,0;21,0;90,0;;86,0;;;5,0;3,0;;6,0;2,0;7,0;;8,0;127,0;1,0;149,0;65,0;8,0;45,0;10,0;161,0;2,0;;8,0;2,0;;3,0;11,0;2,0;10,0;121,0;;135,0;;11,0;;93,0;1,0;1,0;;11,0;31,0;2,0;12,0;3,0;2,0;45,0;;14,0;13,0;;7,0;29,0;1,0;7,0;;2,0;;8,0;56,0;2,0;3,0;;3,0;;;;13,0;;5,0;;2,0;;;;5,0;12,0;19,0;14,0;;11,0;112,0;2,0;59,0;;28,0;16,0;20,0;6,0;7,0;5,0;;2,0;;;54,0;335,0;7,0;2,0;;5,0;1,0;1,0;;3,0;7,0;6,0;2,0;;14,0;;;;13,0;5,0;24,0;1,0;3,0;23,0;1,0;;;5,0;9,0;1,0;;30,0;;14,0;4,0;17,0;13,0;8,0;;;7,0;16,0;;6,0;;32,0;;;372,0;;20,0;12,0;3,0;5,0;2,0;5,0;8,0;14,0;23,0;6,0;1,0;;;;1,0;;;;1,0;12,0;5,0;9,0;;5,0;2,0;2,0;29,0;;67,0;;;;;2,0;;6,0;1,0;2,0;2,0;7,0;2,0;;;1,0;;1,0;;7,0;49,0;19,0;;;;1,0;;;;21,0;;1,0;;;5,0;10,0;2,0;;3,0;;;3,0;;5,0;13,0;16,0;21,0;;;10,0;3,0;11,0;1,0;9,0;;3,0;;5,0;4,0;17,0;2,0;11,0;1,0;9,0;12,0;;2,0;6,0;2,0;;;;2,0;;;;;14,0;5,0;4,0;;10,0;9,0;1,0;24,0;6,0;7,0;;108,0;;28,0;5,0;4,0;508,0;24,0;7,0;;5,0;25,0;3,0;;;11,0;;;13,0;;5,0;4,0;4,0;11,0;;3,0;;19,0;7,0;;1,0;37,0;6,0;;8,0;;3,0;5,0;1,0;9,0;9,0;3,0;3,0;;12,0;;;2,0;55,0;13,0;1,0;3,0;;;39,0;;;14,0;;9,0;68,0;3,0;6,0;4,0;;28,0;1,0;;35,0;4,0;4,0;6,0;2,0;;43,0;10,0;17,0;85,0;11,0;1,0;40,0;;;10,0;51,0;;5,0;1,0;9,0;4,0;1,0;;2,0;12,0;;6,0;1,0;301,0;71,0;60,0;;;9,0;5,0;3,0;1,0;2,0;;;11,0;;;5,0;2,0;;23,0;;1,0;;1,0;;1,0;;;1,0;;14,0;;;11,0;3,0;1,0;;6,0;;1,0;;58,0;3,0;11,0;9,0;;1,0;5,0;2,0;2,0;;;;7,0;;;1,0;;4,0;16,0;6,0;4,0;;4,0;4,0;6,0;2,0;;;13,0;3,0;6,0;;;;;2,0;48,0;7,0;;;;2,0;;;;5,0;57,0;4,0;3,0;;;;5,0;1,0;;;;5,0;1,0;;;;24,0;;;;10,0;1,0;;2,0;1,0;;;2,0;7,0;;;14,0;;2,0;;;;;2,0;;;;4,0;;;1,0;;2,0;;2,0;;2,0;;4,0;3,0;1,0;2,0;;1,0;;;;9,0;;;;;2,0;19,0;2,0;;3,0;;15,0;8,0;;;11,0;;;9,0;;;;;34,0;;5,0;;7,0;;11,0;;;;7,0;1,0;3,0;;1,0;41,0;;;;;2,0;;;;5,0;;;1,0;1,0;;;14,0;;;2,0;6,0;;;13,0;;;;;;1,0;3,0;22,0;5,0;;2,0;;;;;;2,0;;;;1,0;;;3,0;;;;;;1,0;;2,0;;;15,0;23,0;1,0;;;2,0;4,0;4,0;;9,0;;4,0;2,0;1,0;;;;3,0;;3,0;;2,0;;;;1,0;;;3,0;;;;;;;;32,0;;;2,0;;;;6,0;7,0;;;3,0;;;;;;;;;;1,0;2,0;;5,0;;;5,0;;;;2,0;;;;;;1,0;;;;;;;4,0;;;2,0;4,0;1,0;9,0;55,0;3,0;;;;2,0;;1,0;;;1,0;1,0;;1,0;;19,0;3,0;;10,0;;;;4,0;3,0;;2,0;1,0;24,0;;;4,0;;;;4,0;;3,0;;;5,0;;;;;1,0;;;;23,0;3,0;;;;12,0;;9,0;;;;2,0;;;;2,0;;;;;1,0;;5,0;;;;;;9,0;;;10,0;;1,0;;;;5,0;;;;;4,0;;1,0;;;;;;;1,0;;;5,0;3,0;4,0;;;;;;1,0;;;;;;;;;;;;;;;;;;;;5,0;;;1,0;;;;;;;;;15,0;;;;;;;;;;;;
thereon;;6,0;;;15,0;;3,0;26,0;;17,0;4,0;2,0;;;7,0;;;;16,0;28,0;;16,0;3,0;1,0;;;;18,0;1,0;3,0;;13,0;27,0;;18,0;;7,0;17,0;1,0;51,0;1,0;1,0;8,0;15,0;;;;;5,0;;4,0;1,0;;23,0;2,0;122,0;28,0;5,0;2,0;99,0;;;14,0;;;3,0;5,0;2,0;;2,0;9,0;;;;;;;9,0;15,0;6,0;;19,0;15,0;4,0;;1,0;1,0;;;3,0;27,0;;2,0;9,0;;3,0;;27,0;83,0;15,0;20,0;25,0;1,0;2,0;;1,0;;47,0;;1,0;11,0;32,0;13,0;8,0;5,0;;;;13,0;11,0;;;;14,0;4,0;;18,0;10,0;;1,0;6,0;18,0;;1,0;2,0;8,0;39,0;2,0;3,0;;6,0;;7,0;14,0;3,0;3,0;57,0;7,0;;3,0;;2,0;4,0;2,0;4,0;11,0;9,0;7,0;;7,0;14,0;;3,0;2,0;;3,0;;38,0;3,0;3,0;27,0;1,0;23,0;91,0;9,0;1,0;5,0;8,0;3,0;;1,0;;4,0;1,0;3,0;1,0;13,0;79,0;;21,0;2,0;25,0;2,0;40,0;;;1,0;2,0;;4,0;;7,0;;19,0;1,0;;;;6,0;18,0;1,0;;;;5,0;3,0;9,0;2,0;;5,0;5,0;2,0;;;;;2,0;;;;1,0;;1,0;2,0;5,0;;2,0;7,0;8,0;3,0;15,0;1,0;2,0;6,0;;1,0;;18,0;2,0;46,0;;8,0;3,0;22,0;;1,0;;23,0;;2,0;;9,0;;4,0;2,0;6,0;10,0;;6,0;;3,0;7,0;;;;;;;;1,0;;16,0;;;;3,0;5,0;4,0;;5,0;1,0;2,0;;4,0;4,0;;1,0;1,0;1,0;;;5,0;4,0;5,0;3,0;4,0;6,0;1,0;1,0;1,0;4,0;8,0;;;9,0;;1,0;;2,0;;21,0;3,0;3,0;;9,0;1,0;3,0;;2,0;;4,0;;;;;;;;;;3,0;;;;;2,0;;4,0;;;1,0;;10,0;;;;;;;;;;;;1,0;3,0;;;;;;;;1,0;67,0;2,0;3,0;1,0;;14,0;;1,0;;65,0;;;;;15,0;31,0;1,0;4,0;2,0;;10,0;;4,0;6,0;;;;;;;;;;13,0;1,0;;;4,0;1,0;1,0;;;1,0;;;6,0;3,0;1,0;;;;;;;;1,0;2,0;;;;5,0;1,0;;;;1,0;1,0;;3,0;1,0;;2,0;;1,0;;1,0;1,0;27,0;;14,0;;;;;43,0;;;;;;3,0;;13,0;;2,0;;;25,0;;;;;23,0;;;1,0;2,0;;;;;3,0;7,0;5,0;;3,0;;4,0;2,0;;7,0;1,0;;;;20,0;;;;;;;;5,0;;1,0;4,0;;;11,0;1,0;6,0;;;;;6,0;2,0;;4,0;;;1,0;;;;1,0;;;2,0;;;;;;;;;;13,0;1,0;;2,0;1,0;;;;2,0;2,0;;;2,0;1,0;;4,0;6,0;1,0;;;;;2,0;3,0;1,0;;;2,0;;;;3,0;;;1,0;;;;;5,0;;;7,0;15,0;1,0;;;;;;;8,0;;;1,0;3,0;;;;;;;;;;1,0;;;;;;;;6,0;1,0;;;;;;1,0;;;;1,0;;2,0;1,0;7,0;;;3,0;;5,0;4,0;4,0;;;;2,0;3,0;;1,0;;;;;;7,0;1,0;;;;;;;1,0;1,0;;;;1,0;1,0;;;;1,0;;;;;;;;;;;;;;;3,0;;;1,0;2,0;;;;;;;;;2,0;1,0;;1,0;;;;;;;;;2,0;;;;;;;;;;;;;;;;;;;;;;;2,0;;;;;;1,0;;9,0;;;;;;;;;;;;;;1,0;;;;;;;;;;2,0;;1,0;;2,0;;3,0;;;2,0;2,0;6,0;;1,0;;;;;;;;;;;;;;;;;;1,0;9,0;1,0;;;;;;1,0;;;2,0;;;;;;;;;;;;;;;;;2,0;;2,0;;;1,0;;;1,0;;;;;;;;;;;2,0;5,0;;;;;;3,0;1,0;;;;;;1,0;;;1,0;;;;4,0;1,0;1,0;;;;1,0;1,0;;;;;;;1,0;;;;;;2,0;4,0;1,0;;2,0;;;;;;;;;;;;;7,0;;;;;;1,0;1,0;;;;;;;;2,0;;;;;;;;;;2,0;;;;;;;;;;21,0;;;;;1,0;;;;;;;;;;1,0;;;1,0;;;;1,0;1,0;;1,0;;;;;;;;;;;;;;;;;;1,0;;;;;;;;3,0;;;;;4,0;;;;1,0;;;;
thread;;5,0;;;7,0;;9,0;19,0;;;1,0;;2,0;;;;1,0;;2,0;;;;;;;;;;;;;;9,0;;19,0;;4,0;5,0;;;1,0;;9,0;5,0;;;;;10,0;;;;;2,0;;4,0;34,0;;;154,0;;;8,0;;;2,0;5,0;3,0;3,0;1,0;7,0;;;12,0;23,0;2,0;;;11,0;2,0;;;;;;;2,0;1,0;;6,0;2,0;;;;20,0;1,0;;;;;57,0;4,0;;;;;2,0;32,0;;;2,0;4,0;9,0;5,0;5,0;;;;9,0;13,0;;;;;;;9,0;4,0;;12,0;3,0;;;4,0;4,0;;10,0;;;;;;37,0;4,0;;5,0;64,0;1,0;;;;1,0;2,0;;2,0;46,0;37,0;27,0;;2,0;;;97,0;5,0;;1,0;;;;;50,0;;25,0;50,0;1,0;40,0;98,0;;;;;;4,0;;1,0;;24,0;16,0;;65,0;;4,0;;35,0;;;;10,0;23,0;3,0;;;;8,0;11,0;;;;3,0;47,0;;15,0;;;;;;;;1,0;6,0;;;;51,0;;3,0;;;;3,0;;;1,0;3,0;10,0;9,0;2,0;4,0;2,0;108,0;;3,0;6,0;;4,0;;;7,0;1,0;;1,0;;16,0;;1,0;7,0;58,0;;2,0;;3,0;4,0;2,0;114,0;18,0;12,0;;4,0;3,0;;6,0;;1,0;6,0;;;1,0;;8,0;3,0;1,0;;13,0;3,0;;;;2,0;;;;;;1,0;1,0;;;3,0;2,0;;9,0;5,0;;;3,0;;;;3,0;;;;;2,0;;2,0;19,0;94,0;;8,0;;49,0;1,0;;;7,0;4,0;3,0;;;;5,0;;;;3,0;;;;;;;;;;;1,0;;;1,0;;;;;;;;;;;;;;;;;;;;;;;;;;1,0;;;1,0;;;;;;;;1,0;;1,0;;;;;;;;;;;;;;;;;;;;;1,0;3,0;6,0;2,0;;;4,0;;;;;;;;;;;;;;2,0;;;;;1,0;;;;6,0;;;;;;;2,0;;;;;;2,0;;;;;;;;;;;;;2,0;9,0;;;;2,0;;;;;;2,0;;;;;;;;;3,0;;1,0;;;;1,0;;;3,0;2,0;;1,0;;;1,0;;;;28,0;12,0;;;;;2,0;;;;;2,0;4,0;;;;;;;;;;;;;;;;;1,0;;;;;;;;;;;2,0;;;;;;;4,0;2,0;;;6,0;;4,0;;;;;;;;;;;;;5,0;;;;;;6,0;;;;;;;;;;;;;;;6,0;;1,0;6,0;;;;2,0;;;;;;;;;;;;15,0;4,0;;;;;;;1,0;;;;;;;;13,0;9,0;1,0;14,0;;;;18,0;;1,0;;;;;2,0;;;;;;;;;;;;;;5,0;;;;4,0;;;;;;1,0;;;1,0;2,0;;;;;;1,0;;;;;;;;;;;;;;;;;;;;;;;;;;;;;;;4,0;;;;2,0;;;;;;;;;;;;;;;;;;;;;;;;;;;;;;;;;;;;;;;;;;;;;;;;;;;;;;;;;;;;;;;;;;15,0;;;;;;;;2,0;;;;;;;;;;;;;4,0;2,0;;;;;;1,0;;;;;;;;;;;;;;;;;;;;;;;;;;;;2,0;;;;2,0;;;5,0;;;;2,0;;;;;;;8,0;;;;;;;2,0;;;;2,0;;7,0;9,0;;;;;;;;;;;7,0;;;;;;;;;;;;;;;;;;;;;;;;;;;;27,0;;;;1,0;;;;;;;;;;;;;;;;;;;;;;;;;;;;;;;;;;;;4,0;;;;;;;;;;;;;;;;;;;;;;;;;;;;;3,0;;;8,0;12,0;;;;;;;;;;;1,0;;;;;;;;;;;;;
time;;5,0;165,0;10,0;84,0;;47,0;211,0;207,0;314,0;17,0;25,0;3,0;3,0;30,0;5,0;10,0;41,0;31,0;20,0;90,0;509,0;9,0;35,0;129,0;8,0;6,0;409,0;4,0;151,0;62,0;345,0;341,0;95,0;207,0;4,0;5,0;53,0;1,0;253,0;42,0;;83,0;97,0;44,0;15,0;;19,0;97,0;51,0;44,0;167,0;35,0;40,0;2,0;1492,0;209,0;6,0;134,0;284,0;12,0;25,0;351,0;20,0;8,0;37,0;81,0;;45,0;167,0;63,0;33,0;15,0;;;31,0;;252,0;152,0;44,0;4,0;118,0;42,0;19,0;10,0;4,0;48,0;5,0;42,0;106,0;169,0;102,0;115,0;608,0;26,0;10,0;1,0;53,0;94,0;10,0;9,0;160,0;2,0;83,0;9,0;53,0;5,0;652,0;8,0;3,0;16,0;7,0;69,0;12,0;12,0;9,0;;;7,0;47,0;1,0;;21,0;78,0;;5,0;110,0;4,0;2,0;14,0;7,0;11,0;3,0;2,0;;46,0;5,0;;4,0;54,0;7,0;5,0;12,0;47,0;14,0;4,0;56,0;251,0;4,0;3,0;;;2,0;;32,0;2,0;;11,0;29,0;250,0;4,0;34,0;1,0;2,0;3,0;9,0;81,0;328,0;8,0;5,0;22,0;22,0;44,0;14,0;100,0;24,0;1,0;189,0;1,0;;2,0;6,0;23,0;38,0;;12,0;;384,0;;53,0;1,0;;4,0;131,0;;8,0;;;5,0;;1,0;6,0;3,0;60,0;;63,0;16,0;6,0;6,0;1,0;2,0;3,0;10,0;3,0;24,0;;44,0;9,0;32,0;2,0;1,0;18,0;13,0;3,0;;41,0;12,0;;;;;6,0;2,0;;156,0;30,0;;70,0;80,0;4,0;29,0;1,0;17,0;;;30,0;33,0;2,0;;;22,0;11,0;;17,0;;2,0;;52,0;23,0;2,0;29,0;162,0;2,0;;1,0;1,0;20,0;;2,0;2,0;1,0;10,0;2,0;3,0;6,0;12,0;10,0;;70,0;6,0;;;12,0;51,0;;90,0;56,0;180,0;75,0;5,0;;;51,0;8,0;;14,0;7,0;137,0;2,0;;13,0;;613,0;5,0;5,0;1,0;;130,0;9,0;;47,0;32,0;11,0;3,0;2,0;;;;1,0;;;29,0;;;;31,0;;;17,0;;74,0;22,0;;17,0;1,0;21,0;12,0;49,0;12,0;11,0;4,0;92,0;3,0;49,0;82,0;5,0;50,0;14,0;;135,0;10,0;64,0;43,0;7,0;5,0;18,0;2,0;5,0;2,0;;35,0;7,0;17,0;8,0;23,0;36,0;7,0;4,0;88,0;11,0;31,0;2,0;4,0;130,0;55,0;49,0;42,0;9,0;;12,0;920,0;80,0;4,0;17,0;111,0;25,0;32,0;36,0;6,0;197,0;21,0;49,0;;3,0;83,0;53,0;200,0;79,0;55,0;26,0;20,0;;10,0;9,0;13,0;32,0;19,0;98,0;11,0;21,0;5,0;15,0;;25,0;1,0;84,0;9,0;;99,0;4,0;112,0;16,0;4,0;10,0;106,0;3,0;14,0;78,0;28,0;42,0;11,0;8,0;;84,0;1,0;;9,0;;34,0;14,0;29,0;6,0;3,0;8,0;5,0;74,0;8,0;12,0;23,0;10,0;1,0;34,0;58,0;90,0;4,0;16,0;4,0;3,0;52,0;1,0;18,0;9,0;18,0;64,0;4,0;18,0;15,0;3,0;48,0;1,0;;108,0;;1,0;3,0;;19,0;2,0;4,0;6,0;23,0;15,0;8,0;9,0;1,0;15,0;14,0;34,0;1,0;120,0;7,0;99,0;25,0;45,0;133,0;75,0;41,0;59,0;10,0;4,0;2,0;7,0;1,0;10,0;42,0;4,0;5,0;4,0;6,0;;;3,0;24,0;22,0;17,0;9,0;6,0;2,0;3,0;14,0;;2,0;4,0;1,0;4,0;103,0;5,0;1,0;1,0;12,0;1,0;;20,0;3,0;30,0;22,0;2,0;;7,0;12,0;;16,0;11,0;;;4,0;;2,0;3,0;;31,0;3,0;;3,0;13,0;;21,0;4,0;36,0;123,0;231,0;8,0;3,0;1,0;;5,0;40,0;37,0;;2,0;1,0;15,0;14,0;1,0;;2,0;;5,0;;2,0;;35,0;57,0;25,0;48,0;8,0;;;;113,0;9,0;1,0;;;18,0;62,0;;;5,0;3,0;;2,0;911,0;3,0;6,0;5,0;10,0;2,0;;2,0;;27,0;4,0;;5,0;;5,0;;1,0;85,0;36,0;;18,0;6,0;1,0;;;1,0;18,0;4,0;;3,0;8,0;81,0;9,0;;13,0;;1,0;;10,0;41,0;;3,0;;12,0;;1,0;1,0;;15,0;7,0;;2,0;;;;;37,0;2,0;14,0;8,0;6,0;1,0;;7,0;31,0;3,0;;4,0;7,0;29,0;;6,0;24,0;1,0;;8,0;18,0;22,0;3,0;6,0;84,0;17,0;5,0;5,0;;19,0;86,0;;4,0;28,0;39,0;2,0;25,0;2,0;4,0;8,0;8,0;320,0;328,0;2,0;2,0;6,0;2,0;1,0;2,0;4,0;78,0;36,0;54,0;24,0;13,0;65,0;13,0;;3,0;14,0;9,0;;12,0;5,0;;7,0;3,0;15,0;2,0;12,0;;3,0;6,0;117,0;17,0;36,0;6,0;20,0;2,0;23,0;1,0;1,0;38,0;2,0;;74,0;5,0;34,0;5,0;82,0;31,0;13,0;;;2,0;14,0;16,0;2,0;17,0;14,0;14,0;7,0;2,0;57,0;14,0;21,0;66,0;;;3,0;2,0;12,0;70,0;18,0;7,0;19,0;3,0;11,0;35,0;14,0;8,0;3,0;;;20,0;12,0;15,0;1,0;8,0;16,0;2,0;6,0;65,0;;;5,0;9,0;34,0;21,0;;16,0;;2,0;;;1,0;;1,0;;4,0;42,0;8,0;;9,0;5,0;10,0;;9,0;4,0;;9,0;;28,0;146,0;5,0;;74,0;1,0;;;16,0;5,0;;9,0;28,0;3,0;2,0;;2,0;7,0;34,0;4,0;11,0;1,0;1,0;2,0;7,0;26,0;2,0;8,0;;3,0;3,0;;49,0;13,0;;2,0;7,0;4,0;9,0;4,0;3,0;86,0;;1,0;1,0;;2,0;;13,0;;2,0;;16,0;;;2,0;5,0;;;7,0;;;1,0;3,0;;;1,0;;2,0;1,0;;;3,0;42,0;11,0;;2,0;;;42,0;48,0;24,0;;;;3,0;;;3,0;14,0;11,0;23,0;;18,0;1,0;1,0;;;;6,0;9,0;23,0;5,0;;5,0;25,0;;;;;3,0;5,0;31,0;;;;6,0;3,0;;;;12,0;5,0;10,0;;;;2,0;;4,0;;4,0;1,0;1,0;;2,0;;;;4,0;;;;;;;;2,0;;3,0;;7,0;5,0;2,0;;;5,0;;;;;;2,0;3,0;29,0;;3,0;3,0;;;1,0;;;;;;;;;
transmission;;6,0;;;47,0;;9,0;21,0;1,0;27,0;5,0;3,0;;2,0;8,0;2,0;2,0;1,0;;3,0;4,0;73,0;;;5,0;;;152,0;1,0;8,0;1,0;15,0;87,0;;35,0;;;12,0;;29,0;6,0;;39,0;24,0;;;;;2,0;73,0;7,0;22,0;7,0;5,0;;205,0;57,0;;3,0;18,0;1,0;;53,0;;8,0;8,0;6,0;;;5,0;15,0;3,0;54,0;1,0;;4,0;3,0;2,0;16,0;58,0;;11,0;8,0;3,0;7,0;;41,0;;;15,0;10,0;;4,0;103,0;3,0;4,0;1,0;6,0;7,0;2,0;2,0;81,0;;2,0;;3,0;2,0;189,0;3,0;;;12,0;2,0;;2,0;;;;1,0;15,0;;;6,0;18,0;;;19,0;10,0;;12,0;37,0;;;;;4,0;12,0;;;2,0;6,0;;12,0;;23,0;19,0;15,0;26,0;1,0;;;;5,0;3,0;3,0;;6,0;7,0;10,0;67,0;3,0;4,0;;3,0;29,0;1,0;26,0;62,0;7,0;;74,0;10,0;30,0;3,0;2,0;11,0;;21,0;;;;;17,0;1,0;1,0;;5,0;21,0;;22,0;;;5,0;36,0;;4,0;1,0;2,0;11,0;1,0;;;;12,0;;3,0;;;3,0;1,0;;;3,0;;4,0;18,0;175,0;1,0;;1,0;;2,0;;4,0;;5,0;5,0;;;;4,0;;3,0;3,0;2,0;2,0;;2,0;4,0;;1,0;;;;2,0;4,0;3,0;;;;;7,0;1,0;28,0;3,0;1,0;;1,0;;;;19,0;23,0;;7,0;2,0;9,0;;;;;2,0;;3,0;4,0;27,0;;4,0;2,0;6,0;;2,0;1,0;17,0;;3,0;1,0;8,0;5,0;1,0;;;;;;1,0;;29,0;;;5,0;;23,0;4,0;14,0;;;5,0;3,0;1,0;;2,0;1,0;;;;4,0;1,0;1,0;1,0;;5,0;27,0;2,0;;33,0;;;1,0;;10,0;3,0;;;;;;;2,0;;;2,0;;;;;;1,0;;1,0;4,0;13,0;;;;;;;;;12,0;;;;3,0;3,0;;;;;;;;7,0;12,0;9,0;;;;2,0;10,0;7,0;;1,0;4,0;;14,0;;;8,0;;12,0;13,0;;2,0;3,0;8,0;10,0;8,0;;;;2,0;3,0;;;;5,0;;;;20,0;4,0;6,0;9,0;1,0;;;14,0;4,0;4,0;;3,0;6,0;44,0;;;6,0;;;;2,0;;;;6,0;;1,0;12,0;7,0;1,0;2,0;;5,0;7,0;4,0;6,0;4,0;;4,0;;2,0;4,0;25,0;;8,0;11,0;;;5,0;;1,0;5,0;;;6,0;1,0;;3,0;;2,0;20,0;;;;;5,0;19,0;;;1,0;3,0;5,0;2,0;2,0;8,0;10,0;2,0;;4,0;;18,0;1,0;4,0;55,0;13,0;3,0;;;1,0;;22,0;2,0;;9,0;2,0;;;1,0;;;;1,0;2,0;65,0;13,0;6,0;;2,0;;;;;;;4,0;9,0;;;;3,0;;2,0;;25,0;;;;;;;;23,0;1,0;;;2,0;;2,0;;;;;2,0;40,0;;4,0;1,0;1,0;7,0;18,0;;3,0;5,0;;1,0;;;6,0;1,0;;2,0;14,0;1,0;;2,0;;2,0;;3,0;;4,0;14,0;;;7,0;1,0;1,0;;6,0;52,0;;;;;4,0;;;;;;;9,0;;;2,0;2,0;;;;;1,0;;;16,0;;16,0;;;1,0;;;;2,0;;;;;;;;1,0;;;;;10,0;;1,0;1,0;;7,0;;;;;;;2,0;;;2,0;;;;;;;;;1,0;4,0;14,0;;;2,0;;;;;;;;3,0;;;;;;;3,0;;;;3,0;;;;;;;;;;;;1,0;;1,0;;1,0;5,0;;1,0;;;;1,0;;;;;;;2,0;;5,0;3,0;;1,0;;;1,0;;;;2,0;;;;;13,0;;;;;;;;;3,0;1,0;13,0;10,0;;;;;1,0;;;;;;;;;;1,0;4,0;2,0;17,0;3,0;4,0;;;;;1,0;;;;5,0;1,0;6,0;4,0;;;;;;;;2,0;;;5,0;;;;;;;;7,0;;;;;;;;;;2,0;;;1,0;;;;;;;;;;;;;8,0;6,0;;;;;;;4,0;;;1,0;;1,0;;;;;7,0;;;1,0;10,0;18,0;4,0;;1,0;;;11,0;;2,0;1,0;;;;4,0;;;;;2,0;;;;;;;2,0;2,0;;2,0;13,0;;;;15,0;;1,0;;;;;5,0;;;;;;3,0;;3,0;;4,0;;;3,0;;15,0;;5,0;;;;;;;;;;;1,0;1,0;;;;;;;;1,0;;;;11,0;;2,0;9,0;1,0;;5,0;;;;;1,0;1,0;1,0;;;;;;;3,0;;1,0;;;;;;;;;;;;;;;;;;;;;;;;;2,0;1,0;;1,0;;;;;;;1,0;;;;;;;;;5,0;;;;;;;;;
transmit;;14,0;23,0;3,0;84,0;;25,0;69,0;3,0;101,0;16,0;18,0;;;37,0;3,0;5,0;5,0;18,0;32,0;5,0;193,0;9,0;1,0;8,0;;;597,0;5,0;36,0;16,0;33,0;269,0;4,0;148,0;1,0;14,0;28,0;;91,0;17,0;1,0;73,0;69,0;4,0;;;6,0;12,0;69,0;6,0;67,0;1,0;36,0;;855,0;97,0;;;175,0;5,0;1,0;181,0;;1,0;35,0;7,0;;6,0;33,0;107,0;12,0;17,0;;9,0;14,0;;16,0;48,0;72,0;;48,0;33,0;2,0;3,0;9,0;17,0;2,0;15,0;57,0;75,0;5,0;4,0;555,0;6,0;2,0;4,0;23,0;46,0;8,0;56,0;98,0;;24,0;;3,0;6,0;286,0;14,0;17,0;33,0;18,0;10,0;6,0;7,0;;3,0;1,0;14,0;60,0;;;5,0;54,0;1,0;8,0;143,0;17,0;;17,0;6,0;7,0;3,0;4,0;;9,0;16,0;;;8,0;1,0;2,0;76,0;5,0;87,0;117,0;27,0;84,0;;10,0;7,0;1,0;5,0;8,0;2,0;5,0;5,0;27,0;8,0;76,0;17,0;1,0;1,0;4,0;22,0;24,0;16,0;463,0;15,0;6,0;77,0;32,0;86,0;14,0;14,0;21,0;5,0;67,0;1,0;1,0;;1,0;14,0;7,0;;3,0;11,0;71,0;2,0;53,0;1,0;1,0;16,0;261,0;1,0;33,0;6,0;;26,0;1,0;;;1,0;8,0;1,0;5,0;3,0;;5,0;1,0;2,0;9,0;7,0;2,0;8,0;44,0;;7,0;1,0;7,0;;10,0;4,0;69,0;5,0;29,0;11,0;;;;;;7,0;5,0;10,0;18,0;;3,0;16,0;;5,0;;13,0;;12,0;1,0;2,0;2,0;;5,0;2,0;;3,0;32,0;;2,0;;5,0;4,0;2,0;4,0;69,0;;;1,0;2,0;7,0;1,0;;;4,0;1,0;2,0;1,0;1,0;45,0;5,0;1,0;;7,0;2,0;4,0;;31,0;;12,0;2,0;39,0;13,0;;1,0;;;4,0;;1,0;3,0;51,0;;;23,0;;32,0;3,0;1,0;5,0;;11,0;1,0;;8,0;28,0;;;2,0;;1,0;5,0;6,0;;;18,0;14,0;3,0;;20,0;1,0;;5,0;2,0;48,0;3,0;4,0;;;2,0;;;1,0;;;20,0;;5,0;4,0;;;2,0;1,0;4,0;5,0;69,0;4,0;;;1,0;1,0;;;;6,0;;;1,0;16,0;16,0;16,0;4,0;6,0;1,0;1,0;;;6,0;12,0;13,0;4,0;;;2,0;11,0;13,0;;9,0;6,0;;1,0;14,0;1,0;37,0;7,0;27,0;11,0;;12,0;1,0;8,0;31,0;1,0;;13,0;4,0;11,0;;;;2,0;13,0;2,0;4,0;3,0;15,0;1,0;1,0;31,0;14,0;1,0;1,0;36,0;7,0;26,0;5,0;35,0;33,0;63,0;5,0;;13,0;3,0;21,0;6,0;1,0;3,0;1,0;4,0;6,0;6,0;16,0;20,0;3,0;6,0;3,0;2,0;2,0;12,0;51,0;9,0;27,0;12,0;6,0;;13,0;11,0;8,0;;8,0;51,0;10,0;22,0;6,0;;6,0;4,0;;10,0;36,0;6,0;8,0;34,0;;;9,0;1,0;;10,0;;26,0;45,0;2,0;5,0;12,0;6,0;52,0;4,0;;8,0;16,0;13,0;2,0;21,0;8,0;30,0;9,0;2,0;188,0;40,0;6,0;13,0;3,0;3,0;12,0;27,0;;3,0;28,0;2,0;;;5,0;3,0;3,0;1,0;31,0;43,0;158,0;31,0;12,0;4,0;2,0;1,0;1,0;;;1,0;;9,0;6,0;2,0;;13,0;10,0;;4,0;1,0;62,0;;2,0;2,0;1,0;16,0;;6,0;1,0;1,0;;11,0;19,0;1,0;10,0;4,0;;6,0;1,0;2,0;110,0;;7,0;4,0;2,0;32,0;51,0;;17,0;;;1,0;3,0;2,0;;2,0;;;90,0;7,0;;;;;;8,0;;15,0;40,0;3,0;4,0;56,0;;8,0;;33,0;82,0;;;;5,0;2,0;;;;;;;7,0;;1,0;1,0;7,0;1,0;1,0;;;;;;5,0;;52,0;;;4,0;4,0;;;8,0;1,0;;;;175,0;;;6,0;;7,0;1,0;;41,0;3,0;;;;18,0;;;;2,0;6,0;;;;7,0;18,0;;1,0;;;1,0;3,0;;;3,0;;7,0;;15,0;;2,0;;;;;;1,0;2,0;2,0;4,0;11,0;;;1,0;;1,0;1,0;4,0;4,0;1,0;;1,0;1,0;;;6,0;;;;;2,0;5,0;5,0;1,0;17,0;20,0;5,0;;;1,0;5,0;;1,0;27,0;;9,0;2,0;7,0;;1,0;;2,0;2,0;2,0;5,0;2,0;;3,0;;1,0;3,0;;;2,0;;18,0;3,0;3,0;1,0;;;;;3,0;3,0;;7,0;10,0;;1,0;1,0;2,0;;;3,0;;;1,0;;;;1,0;1,0;12,0;1,0;13,0;;1,0;;8,0;;4,0;;;4,0;;;1,0;;29,0;;4,0;;;2,0;;;3,0;;;9,0;2,0;;;22,0;;1,0;;16,0;;;;;1,0;1,0;;;;2,0;;1,0;;1,0;;;;2,0;1,0;;8,0;;;;;7,0;7,0;2,0;1,0;;5,0;1,0;;3,0;1,0;;2,0;2,0;;;;;;31,0;3,0;;4,0;;125,0;18,0;;;1,0;;25,0;;6,0;5,0;;;;13,0;8,0;1,0;;;7,0;;12,0;1,0;;;;15,0;6,0;;;12,0;;;;3,0;4,0;;1,0;3,0;1,0;;9,0;;1,0;;;;31,0;;6,0;1,0;11,0;;3,0;20,0;;19,0;6,0;25,0;;;;;;;;1,0;;7,0;;;1,0;;;;;;;21,0;3,0;;;9,0;2,0;;7,0;;;10,0;3,0;2,0;;;1,0;;1,0;;;;;;3,0;11,0;;5,0;3,0;1,0;;;;;1,0;;;;;1,0;;;;4,0;;;;;;;;;2,0;1,0;;;;6,0;;;;;1,0;;;;1,0;3,0;6,0;;;20,0;;2,0;;1,0;;4,0;;;
tripod;;1,0;;;2,0;;;18,0;;;;;1,0;;1,0;;;;2,0;;;15,0;;;;;;4,0;;5,0;;1,0;22,0;;25,0;;;;;2,0;;;;66,0;;;;;;;;;;;1,0;3,0;9,0;;3,0;19,0;;;2,0;;;;;;;1,0;;;;;;1,0;;;;1,0;7,0;2,0;4,0;;;;;;;2,0;;;;3,0;1,0;;;;;;19,0;7,0;;;;;;2,0;;;4,0;1,0;1,0;2,0;15,0;;;;;4,0;;;;;;;;4,0;;3,0;;;;;12,0;2,0;10,0;;;;;;;;;;10,0;;;;;1,0;;;2,0;;26,0;16,0;;;;;;;;;;1,0;;;23,0;;;70,0;;2,0;;;;;;;;;;1,0;7,0;2,0;;43,0;;5,0;;6,0;;;;;1,0;3,0;;2,0;;6,0;;;;;3,0;13,0;1,0;2,0;;;1,0;4,0;;;;;7,0;;;;2,0;;;;;;;;1,0;;1,0;2,0;;;1,0;;;;1,0;5,0;;;;;;;;1,0;;75,0;;;1,0;;;;;;2,0;5,0;6,0;1,0;11,0;;;4,0;;;;;4,0;3,0;;;;1,0;1,0;;;1,0;;;1,0;1,0;1,0;;;;;;;1,0;;;;;;1,0;4,0;;;;3,0;;;;;1,0;1,0;;;;;;15,0;;;;2,0;;;1,0;;;1,0;;5,0;;;;;;;;;;1,0;;;;;;;;;;1,0;;;;;;;;;;;;;;;;;;;;;;;;;;1,0;;;;;;;;;;;;;1,0;;;;;;;;;;;1,0;;;;;;;;;;;1,0;;;;;;;1,0;;;;;;3,0;;;;;;;;;;;1,0;;;2,0;1,0;;;;;2,0;;;;;;;;;;;;;;;;;;;;;;8,0;;;;;1,0;2,0;;1,0;;;;;;;;;;;;;;;;;;;;1,0;;;;;;;;;;1,0;10,0;;;;1,0;16,0;;;1,0;1,0;;2,0;;;;;1,0;;;;;;;;;;;;;;;;;;;;;;;;;;;;;;;;;;;;;;;;;;;;;;;;;;;;;1,0;;;;;;;;;;;;14,0;;;;;;;;;;;1,0;;;;;;;;;;;;;7,0;;;;;;1,0;1,0;;;;;1,0;2,0;;1,0;2,0;1,0;;;;;1,0;1,0;;;;;;2,0;;;;;;;;;;;1,0;;;;;;;;;;;;;;;;;;6,0;;;;;;1,0;;;;;;;;;;;;;;;;;;;;;;;;;;;;;;;;;;;;;;;1,0;;;;;;;;;;;;;;;;;;;;;;;;;;;;;;;;;;;;;;2,0;;;;;;;;;;;;;;;;;;;;;;;;17,0;;;;;;;;1,0;;;;;;;;;;;;;;;;;;;;;;;;;;;;;;;;;;;;;;;;;1,0;;;;;;1,0;;;;;;;;6,0;;;;;1,0;;;;;;;;;;;;;;;;;2,0;;;;;;;;;;;;;;;;;;;;;;;;;;;;;;;;;;;;;;;;;;2,0;2,0;;;;;;;;;;;;;;;;;;;;;;;;;;;;;;;;;;;;;;;;;;;;;;;;;;;;;;;;;;;;;;;;;;;;3,0;;;;;1,0;;;;;;;1,0;;;;;;;;;;;;;;;;
vehicle;;20,0;;1,0;40,0;1,0;21,0;65,0;21,0;57,0;9,0;17,0;;;8,0;6,0;7,0;;38,0;2,0;6,0;81,0;12,0;5,0;5,0;2,0;3,0;123,0;8,0;25,0;11,0;64,0;168,0;3,0;20,0;6,0;7,0;52,0;6,0;186,0;31,0;1,0;25,0;130,0;;;1,0;8,0;;1,0;15,0;26,0;;5,0;7,0;249,0;133,0;;16,0;123,0;1,0;;153,0;1,0;2,0;205,0;73,0;4,0;3,0;12,0;12,0;13,0;2,0;2,0;2,0;11,0;;35,0;119,0;22,0;1,0;30,0;35,0;4,0;;;46,0;4,0;5,0;8,0;96,0;5,0;;57,0;6,0;19,0;2,0;9,0;1,0;3,0;108,0;377,0;;;1,0;1,0;4,0;100,0;;6,0;25,0;18,0;10,0;55,0;61,0;;;;7,0;64,0;;2,0;4,0;4,0;2,0;;40,0;1,0;1,0;23,0;11,0;1,0;;;7,0;;42,0;2,0;;3,0;8,0;34,0;60,0;12,0;7,0;3,0;17,0;58,0;1,0;43,0;;1,0;5,0;;5,0;5,0;2,0;29,0;6,0;94,0;5,0;2,0;;32,0;12,0;13,0;3,0;122,0;1,0;27,0;20,0;29,0;19,0;193,0;42,0;32,0;7,0;11,0;;23,0;20,0;4,0;20,0;;1,0;27,0;51,0;67,0;;51,0;2,0;1,0;4,0;19,0;;11,0;2,0;;29,0;19,0;;23,0;;80,0;4,0;;;8,0;50,0;22,0;1,0;2,0;1,0;;4,0;18,0;10,0;3,0;16,0;;5,0;;;4,0;11,0;2,0;26,0;45,0;2,0;;11,0;;;18,0;8,0;45,0;;7,0;72,0;;;1,0;;;3,0;14,0;;;;;7,0;;;14,0;;3,0;2,0;16,0;1,0;;;11,0;4,0;2,0;1,0;;18,0;;1,0;1,0;2,0;65,0;31,0;1,0;1,0;6,0;;;;34,0;1,0;;1,0;5,0;2,0;50,0;28,0;76,0;6,0;3,0;1,0;;;1,0;;7,0;;21,0;;;8,0;3,0;11,0;1,0;1,0;3,0;2,0;35,0;143,0;4,0;5,0;13,0;4,0;;;;;;1,0;7,0;7,0;2,0;;2,0;2,0;1,0;;;1,0;6,0;7,0;;28,0;13,0;;;;1,0;;6,0;2,0;20,0;;5,0;;6,0;1,0;6,0;;2,0;11,0;17,0;7,0;;3,0;;;;;1,0;23,0;4,0;;2,0;28,0;6,0;1,0;10,0;1,0;5,0;1,0;20,0;;17,0;3,0;4,0;3,0;;4,0;7,0;3,0;1,0;1,0;4,0;;;;1,0;;24,0;1,0;7,0;;1,0;1,0;71,0;2,0;14,0;11,0;2,0;8,0;7,0;;3,0;3,0;29,0;9,0;;24,0;7,0;;6,0;;3,0;1,0;4,0;6,0;;2,0;2,0;29,0;;2,0;4,0;;;;;;24,0;4,0;1,0;;;1,0;;1,0;;;2,0;;1,0;;2,0;1,0;4,0;;;;54,0;2,0;1,0;29,0;;;;1,0;;1,0;1,0;;;2,0;;;30,0;3,0;11,0;19,0;;4,0;7,0;6,0;;2,0;1,0;;;;3,0;;1,0;;1,0;18,0;2,0;6,0;;;8,0;;5,0;;11,0;45,0;92,0;;;1,0;;;;1,0;1,0;1,0;2,0;;;;5,0;;;;;4,0;4,0;3,0;2,0;;;2,0;;;;;1,0;3,0;;2,0;1,0;4,0;8,0;;4,0;;;;;;;;6,0;2,0;29,0;23,0;;2,0;;;;5,0;;;1,0;5,0;;9,0;;;5,0;14,0;6,0;;;;;37,0;;1,0;2,0;3,0;;1,0;4,0;;;1,0;;;10,0;;1,0;18,0;1,0;1,0;;;;;5,0;10,0;;1,0;;;;;4,0;4,0;3,0;;;1,0;;5,0;2,0;;;2,0;;;;8,0;30,0;;;6,0;1,0;;1,0;;;;6,0;3,0;;;;2,0;;12,0;2,0;3,0;;3,0;;6,0;;36,0;;;;2,0;2,0;;;;2,0;4,0;;;;;;2,0;;4,0;7,0;5,0;6,0;20,0;;;3,0;1,0;2,0;;;;3,0;;;1,0;;1,0;131,0;;8,0;;;;;;2,0;23,0;;;1,0;;;;3,0;;;2,0;;2,0;7,0;;1,0;;;3,0;3,0;;;;4,0;;5,0;;2,0;;1,0;;;;;;;;3,0;4,0;;;4,0;;;8,0;;1,0;;8,0;;;3,0;;;5,0;4,0;5,0;;;;2,0;2,0;;;;;1,0;3,0;32,0;1,0;;1,0;1,0;;14,0;30,0;;;9,0;;;;;;;;1,0;1,0;13,0;;15,0;6,0;1,0;3,0;;33,0;2,0;;;4,0;1,0;1,0;1,0;;6,0;;;2,0;;9,0;;;1,0;46,0;;;;;;1,0;1,0;;12,0;;2,0;;;4,0;;7,0;;;;1,0;2,0;;1,0;;;;;;;;9,0;2,0;21,0;;7,0;5,0;;;2,0;;3,0;35,0;;2,0;5,0;3,0;;11,0;;;;7,0;;;3,0;;;;11,0;2,0;;2,0;1,0;;;;;1,0;;;;;1,0;;2,0;;5,0;;9,0;;;8,0;;;;1,0;4,0;;3,0;;;1,0;2,0;;1,0;;;;3,0;;2,0;;;1,0;;1,0;;;;2,0;;;;1,0;;2,0;;4,0;;10,0;18,0;;4,0;;;;;4,0;4,0;;;;;;;;;;3,0;;;;;;1,0;1,0;;;;2,0;;;;;;;;5,0;;;2,0;7,0;;5,0;1,0;;9,0;;1,0;3,0;;;;5,0;18,0;;;3,0;1,0;;;;4,0;10,0;;;;;;;;;;;;;;1,0;;11,0;;
vehicular;;1,0;1,0;;;;;1,0;5,0;;;;;;;;;;;;;1,0;;;;;;4,0;;;;;;;;;;1,0;;1,0;;;;;;;;;;;;;;;;6,0;2,0;;;;;;2,0;;;;;;;;;;;;;;;;1,0;;;2,0;4,0;;;;;;;1,0;4,0;;;;;;;;;;;14,0;;;;;;;;;;;;1,0;;;;;;;;;;;;4,0;;;;;;;;;;;;;;;;;1,0;;;;;;;;;;5,0;;;;;;;;;;;;;;;;;;;1,0;;3,0;;;;;;;;;;;;;1,0;;;;;;;;;;;;;;;;;;;;;;;;;1,0;;;;;;;;;;12,0;;;;;;;;;;;;;;;;;;;;;;;;;;;;;;;;;;;;;;;;;;;;;;;;;;;;;;;;;;;;;;;;;;;;;;;;;;;;;;;;;1,0;;;;;;;;;;;;;;;;;;;;;;;;;;;;;;;;;;;;;;;;;;;;;;;;;;;;;;;1,0;;;;;;;;;;;;;;;;;;;;;;;;;;;;;;;;;;;;;;;;;;;;8,0;;;;;;;;;;;;;;;;;;;;;;;;;;;;;;;;;;;;;;1,0;;;;;;;;;;;;;;;;;;;;;;;;;;;;;;;;;;;;;;;;;;;;;4,0;;1,0;;;;;;;1,0;2,0;;;;;;;;;;;;;;;;;;;;;;;;;;;;;;;;;;;;;;;;;;;;;;;;;;;;;;;;;;;;;;;;;;;;;;;;;;;;;;;;;;;;;;;;;;;;;;;;;;;;;;;;;;;;;;;;;;;;;;;3,0;;2,0;;;;;;;;;;;;;;;;;;;;;;;;;;;;;;;;;;;;;;;;;;;;;;;;;;;;;;;;;;;;2,0;;;;;;;;;;;;;;;;;;;;;;1,0;;;;;;;;;;;;;;;;;;;;;;;;;;1,0;;;;;;;;;;;;;;;;;;;;;;;;;;;;;;;;;;;;;;;;;;;;;;;;;;;;;;;;;;;;;;;;;1,0;;;;;;;;;;;;;;;;;;;;;;;;;;;;;;;;;;;;;;;;;;;;;;;;;;;;;1,0;;;;;;;;;;;;;;;10,0;;;;;;;;;;;;;;;;;;;;;;;;;;;;;;;;;;;;;;;;;;;;;;;;;;;;;;;;;;;1,0;;;;;;;;;;;;;;;;;;;;;;;;;;;1,0;;;;;;;;;;;;;;;;;;;;;;;;;;;;;;;;;1,0;;;;;;;;;;;;;;;;;;;;;;;;
video;;2,0;24,0;14,0;294,0;;36,0;247,0;19,0;793,0;11,0;27,0;1,0;2,0;70,0;15,0;2,0;2,0;66,0;87,0;15,0;366,0;14,0;16,0;14,0;3,0;2,0;692,0;12,0;165,0;37,0;192,0;937,0;27,0;584,0;5,0;22,0;45,0;7,0;754,0;50,0;9,0;11,0;37,0;2,0;1,0;;15,0;26,0;39,0;14,0;565,0;61,0;22,0;3,0;1536,0;455,0;;16,0;117,0;2,0;1,0;562,0;13,0;11,0;1,0;36,0;3,0;18,0;93,0;28,0;28,0;107,0;14,0;;6,0;;130,0;201,0;43,0;4,0;245,0;143,0;55,0;6,0;4,0;129,0;12,0;52,0;180,0;115,0;9,0;15,0;1511,0;41,0;51,0;1,0;94,0;201,0;12,0;41,0;970,0;;43,0;12,0;11,0;9,0;411,0;20,0;;30,0;13,0;62,0;41,0;64,0;33,0;;2,0;4,0;26,0;;5,0;8,0;71,0;;10,0;263,0;7,0;9,0;72,0;15,0;34,0;5,0;;3,0;22,0;32,0;;1,0;6,0;2,0;28,0;46,0;34,0;20,0;4,0;96,0;865,0;1,0;;1,0;1,0;7,0;;1,0;10,0;7,0;44,0;6,0;196,0;;12,0;10,0;5,0;13,0;10,0;43,0;95,0;15,0;1,0;45,0;29,0;106,0;100,0;61,0;18,0;;366,0;;17,0;5,0;6,0;7,0;1,0;14,0;9,0;11,0;443,0;1,0;156,0;;2,0;2,0;327,0;2,0;;;;17,0;1,0;1,0;1,0;81,0;28,0;;38,0;9,0;14,0;41,0;61,0;3,0;7,0;;;23,0;133,0;188,0;7,0;4,0;4,0;6,0;45,0;5,0;1,0;;2,0;64,0;;;;5,0;;1,0;44,0;47,0;31,0;1,0;21,0;107,0;2,0;;3,0;18,0;9,0;32,0;25,0;9,0;19,0;;;;36,0;;113,0;;2,0;;36,0;7,0;;16,0;7,0;2,0;4,0;4,0;1,0;8,0;1,0;;2,0;3,0;24,0;3,0;3,0;18,0;82,0;10,0;1,0;3,0;79,0;4,0;;33,0;18,0;;75,0;40,0;287,0;28,0;10,0;;;34,0;20,0;;;;33,0;6,0;;24,0;;98,0;5,0;17,0;;2,0;23,0;17,0;;60,0;52,0;;2,0;2,0;;8,0;;;2,0;;33,0;9,0;6,0;;51,0;;;40,0;2,0;88,0;2,0;4,0;;;5,0;11,0;1,0;9,0;1,0;;108,0;1,0;2,0;12,0;39,0;2,0;6,0;11,0;42,0;28,0;31,0;29,0;1,0;;1,0;11,0;;;3,0;13,0;2,0;;2,0;106,0;36,0;4,0;11,0;23,0;36,0;58,0;2,0;3,0;7,0;77,0;123,0;41,0;12,0;;5,0;101,0;10,0;3,0;53,0;10,0;2,0;41,0;3,0;15,0;439,0;;51,0;7,0;1,0;5,0;29,0;19,0;258,0;50,0;4,0;158,0;1,0;30,0;;3,0;5,0;16,0;66,0;17,0;14,0;33,0;25,0;4,0;48,0;14,0;142,0;33,0;;159,0;6,0;92,0;13,0;15,0;45,0;126,0;20,0;46,0;32,0;49,0;109,0;156,0;3,0;7,0;30,0;5,0;27,0;106,0;7,0;175,0;30,0;7,0;63,0;8,0;15,0;4,0;111,0;21,0;73,0;14,0;17,0;11,0;23,0;283,0;2,0;;86,0;25,0;3,0;17,0;24,0;;8,0;47,0;5,0;69,0;288,0;9,0;11,0;101,0;10,0;;64,0;19,0;17,0;17,0;1,0;5,0;7,0;11,0;3,0;14,0;19,0;37,0;14,0;;9,0;65,0;36,0;3,0;51,0;;53,0;2,0;9,0;;260,0;24,0;6,0;13,0;1,0;7,0;2,0;6,0;44,0;5,0;11,0;3,0;1,0;;;6,0;;20,0;75,0;77,0;23,0;35,0;120,0;2,0;;1,0;6,0;18,0;3,0;9,0;;84,0;16,0;2,0;2,0;25,0;2,0;1,0;76,0;42,0;10,0;;21,0;13,0;;2,0;162,0;9,0;10,0;;2,0;30,0;3,0;3,0;2,0;20,0;16,0;;11,0;110,0;;124,0;2,0;17,0;82,0;94,0;;3,0;4,0;5,0;;25,0;18,0;;2,0;2,0;35,0;17,0;5,0;;;6,0;12,0;;10,0;5,0;380,0;48,0;6,0;36,0;85,0;3,0;4,0;;15,0;108,0;;5,0;2,0;5,0;;3,0;;14,0;;7,0;1,0;49,0;3,0;14,0;12,0;1,0;85,0;2,0;6,0;8,0;;18,0;14,0;2,0;29,0;236,0;;2,0;1,0;1,0;;;18,0;12,0;3,0;1,0;;55,0;1,0;2,0;3,0;8,0;16,0;2,0;4,0;94,0;;29,0;;64,0;11,0;1,0;7,0;;34,0;;6,0;2,0;;43,0;23,0;2,0;2,0;5,0;5,0;1,0;1,0;1,0;9,0;32,0;;18,0;;1,0;26,0;2,0;;;;;;30,0;;10,0;13,0;;6,0;2,0;69,0;3,0;1,0;2,0;6,0;69,0;;;3,0;;;;8,0;1,0;5,0;1,0;;1,0;22,0;13,0;;16,0;2,0;7,0;2,0;15,0;81,0;;36,0;;105,0;;4,0;8,0;24,0;21,0;26,0;2,0;1,0;;7,0;4,0;7,0;;27,0;;10,0;28,0;2,0;;;16,0;23,0;45,0;19,0;3,0;12,0;;;12,0;;4,0;2,0;11,0;3,0;7,0;13,0;4,0;71,0;3,0;;4,0;31,0;11,0;21,0;11,0;3,0;2,0;9,0;2,0;5,0;3,0;1,0;15,0;4,0;18,0;1,0;7,0;11,0;12,0;;8,0;;9,0;;3,0;10,0;68,0;5,0;1,0;10,0;;6,0;;29,0;18,0;10,0;5,0;1,0;1,0;2,0;15,0;3,0;;14,0;32,0;6,0;7,0;1,0;13,0;;61,0;;;1,0;113,0;12,0;;24,0;45,0;3,0;3,0;13,0;8,0;12,0;;5,0;;7,0;1,0;;4,0;25,0;14,0;4,0;3,0;7,0;1,0;;7,0;13,0;11,0;4,0;2,0;16,0;;;1,0;;30,0;5,0;3,0;5,0;2,0;20,0;5,0;8,0;;;6,0;;1,0;4,0;10,0;11,0;3,0;9,0;194,0;5,0;;1,0;12,0;8,0;;;;12,0;7,0;;126,0;;;1,0;10,0;;2,0;2,0;12,0;;2,0;2,0;7,0;19,0;;14,0;;;2,0;;4,0;4,0;;;3,0;;87,0;3,0;133,0;25,0;;;203,0;7,0;2,0;;1,0;3,0;;8,0;;;17,0;9,0;42,0;11,0;3,0;29,0;;;13,0;;1,0;5,0;1,0;3,0;11,0;14,0;3,0;1,0;;;22,0;30,0;;;2,0;2,0;37,0;5,0;;;;;25,0;1,0;4,0;1,0;7,0;22,0;;;;3,0;;2,0;;;;;;;;;;;3,0;;1,0;1,0;;;;13,0;;;;1,0;;1,0;;8,0;2,0;12,0;;4,0;;2,0;;1,0;1,0;;7,0;;;4,0;;;1,0;;;
viewfinder;;16,0;10,0;;6,0;;4,0;7,0;;23,0;;;;;;1,0;;;1,0;;;40,0;;;21,0;;;12,0;7,0;;2,0;27,0;118,0;;43,0;;12,0;47,0;;110,0;2,0;;2,0;10,0;;1,0;;;4,0;;20,0;7,0;;;;201,0;34,0;;;29,0;;;22,0;;;;3,0;1,0;;8,0;170,0;;136,0;;;10,0;;9,0;23,0;;;3,0;;2,0;;;7,0;;9,0;9,0;63,0;;2,0;17,0;5,0;1,0;;2,0;3,0;;4,0;143,0;;2,0;;;;17,0;;;4,0;43,0;;8,0;1,0;;4,0;;5,0;9,0;;;2,0;4,0;;;10,0;3,0;;;;3,0;1,0;1,0;;;;;;2,0;;;2,0;2,0;;1,0;7,0;45,0;;15,0;;;12,0;;;;;;;19,0;;1,0;;;;1,0;5,0;30,0;;1,0;6,0;26,0;2,0;17,0;;2,0;;3,0;;;1,0;;;;;5,0;;3,0;;15,0;;;;20,0;1,0;20,0;;;;3,0;;1,0;;3,0;;;;;;4,0;;;;4,0;;41,0;6,0;;;;2,0;;2,0;;2,0;;2,0;;;;;;;;14,0;;;1,0;3,0;;;;3,0;;;3,0;;7,0;;;3,0;;;5,0;;;;3,0;;;;9,0;;;1,0;;5,0;;;;;2,0;2,0;;;4,0;;;1,0;7,0;;;;5,0;;17,0;2,0;8,0;3,0;;7,0;;;;;1,0;;36,0;1,0;;;;5,0;5,0;;;;4,0;5,0;;;3,0;6,0;1,0;;;3,0;;;;1,0;1,0;;4,0;;;;;1,0;;20,0;;;;;;;;;;;10,0;;4,0;10,0;;;3,0;;1,0;3,0;;;;;4,0;;;;1,0;;;;;;3,0;3,0;;2,0;4,0;;;;7,0;1,0;1,0;4,0;;;1,0;;10,0;1,0;;;;19,0;9,0;;5,0;;;;;8,0;8,0;;21,0;;;;;;;;;;14,0;;3,0;2,0;4,0;;1,0;;3,0;2,0;;5,0;;18,0;;;;26,0;;1,0;2,0;24,0;4,0;;;;;1,0;3,0;1,0;8,0;;;1,0;;;;;3,0;;2,0;;;;;9,0;6,0;;;;1,0;;;;;11,0;;;15,0;7,0;;;;;5,0;;;;;;;;;;;;;;6,0;17,0;2,0;;3,0;;13,0;;2,0;24,0;34,0;;;;;;;;2,0;6,0;;;;;;;;;3,0;1,0;9,0;;;;;;;;;;;;;5,0;;;;;;;;;;;;;;1,0;3,0;;;;;1,0;;1,0;;;;;;;;;15,0;4,0;;;;;;4,0;;;;;;;;;;;;;;;;41,0;;2,0;1,0;;;;20,0;;;;;;;;;;1,0;;;1,0;8,0;;2,0;1,0;;;;;;;;2,0;;5,0;;;;;;;;;;;;3,0;;;;2,0;1,0;;;117,0;;;;;;;;;;;;;;;4,0;;;;;;;;;5,0;;;;;;4,0;;;;;;;;;15,0;;;;;;;10,0;6,0;;;;2,0;;;;;;;10,0;;;;;;1,0;;;10,0;;2,0;6,0;1,0;10,0;;;;;;;;;;;;2,0;;1,0;6,0;1,0;;;;;;;16,0;;;;;1,0;;;;;;;;;1,0;;;;;9,0;;;;;;;;;;;;;;;2,0;;;;1,0;17,0;4,0;;;;8,0;;;1,0;;;1,0;;6,0;1,0;;;;1,0;;;;;;;16,0;;;;;;;;;;12,0;;;;;;;;4,0;;;;;;;;;;;;;;;2,0;;1,0;;7,0;2,0;;;;;2,0;;7,0;5,0;;;1,0;;;;;;;;;;;;;;;;;;3,0;;;;8,0;;;;2,0;;;;;;13,0;;;;;;1,0;;;;4,0;;;;;;;;;1,0;;;;;;;;;;;;;;;;10,0;;1,0;;;;;;;;;;;;;;;;;;;;;;;5,0;;;;;;1,0;1,0;;;;;;;;1,0;;;;;;;;;;;;;;;;;;;;;;;;;;;;;;;;;8,0;13,0;;;1,0;;;;;;;;;;;
windshield;;10,0;5,0;;;;;1,0;;;;;;;;;;;;;;;;;;;;;;1,0;;;;;;;;;;;7,0;;;13,0;;;;;;;;;;;;;2,0;;;1,0;;;;;;7,0;;;;;2,0;1,0;;;;;;;;;;;2,0;;;;;;;;6,0;;;;;1,0;;;;2,0;23,0;8,0;;;;;;4,0;;16,0;1,0;;;17,0;18,0;;;;2,0;;;;;1,0;;;;3,0;;;;;;;;;5,0;;;;;;1,0;3,0;;;;;;;;;;;;;;9,0;;4,0;;;;14,0;;11,0;;7,0;;;;2,0;;28,0;;9,0;;;;2,0;;1,0;;;;;1,0;;;18,0;;;;12,0;;;;;;;;;;;;;;;9,0;1,0;;;;;;;;2,0;;;;45,0;;;;;5,0;;;;;;;;;1,0;;;;;;;;;3,0;;;;;4,0;1,0;;;;;;;;;;;;2,0;;;1,0;;;;;;4,0;;;;;;;;9,0;;;;1,0;;;;1,0;;;;;;;;;;;;;;;;;;;;;;;;;;;;;;;;;;;;;;;;;;;;;;;;;;;;;;;;;;;;;;;1,0;;;;;;;;;;;;;;1,0;;;;;;;2,0;;6,0;;;;;;3,0;;;;;;;;;;;;;;;;;;;;;;;;;;;;;;4,0;;;;;;;;;;;;;;;;;;;;;;;;;;;;;;;;;;;;;;;;4,0;;;;;;;;;;;;;;;;;;;;;;;;;;;;;;;;;;;;;;;;;;;;;;5,0;;;;;;;;;;;;;;;;;;;;;;;;;;;;;;;;;;;;;;;;;;;;;;;;1,0;12,0;;;;;;;;;;;;;;;;;;;;;;1,0;;;;;;;;;;;;;;;;;;;;;;;;;3,0;;;;;;;;;;;;;;;;;;;;;2,0;;;;;;;1,0;;;;;;;;;;;;;1,0;;;;;;;;;;;;;;;;;;;;;;;;;;;;;;;;;;;;;;;;;;;1,0;;;;;;;;;;;;;;;;;;;;;;;;;;;;;;;;;;;;;;;;;;;;;;;;;;;;;;;;;;;;;;;;6,0;;;;;;;;;;;;;;;;;;;;7,0;;;;;;;;;;;;;;;;;;1,0;;;;;;;;;;;;;;;;;;;;;;;;;;;;;;;;;;;;;;1,0;;;;;;;;;;;;3,0;;;;;;;;;;;;;;;;;;;;;;;;;;;;;;;;;;;;;;;;7,0;;1,0;;;;;;;;;;;;;;;;;;;;;;;;;;;;;;;;;;;;;;;;;;;;;;;;;;;;;;;;;;;;;;;;;;;;;;;;;;;;;;;;;;;;;;;;;;;;;;;;;;;;;;;;;;;;;;;;;;;;;;;;;;;;;;;;;;
wire;;1,0;;;33,0;;14,0;27,0;;;6,0;;;;;1,0;;;12,0;4,0;;33,0;;;;;3,0;2,0;4,0;;5,0;;102,0;;20,0;;1,0;21,0;;52,0;13,0;;11,0;51,0;;;10,0;;;;5,0;1,0;;9,0;;54,0;55,0;;61,0;47,0;;;18,0;;1,0;3,0;5,0;;;1,0;28,0;;;2,0;7,0;;;22,0;27,0;79,0;7,0;8,0;4,0;;;;7,0;1,0;;15,0;26,0;1,0;;84,0;;8,0;;2,0;;153,0;36,0;26,0;;14,0;;;;47,0;;;2,0;50,0;;14,0;15,0;;;;67,0;10,0;30,0;;;41,0;4,0;;5,0;23,0;;51,0;53,0;3,0;2,0;3,0;2,0;;35,0;;69,0;;;;9,0;7,0;6,0;16,0;110,0;2,0;;;;1,0;36,0;9,0;11,0;5,0;29,0;12,0;;17,0;;4,0;2,0;;;116,0;1,0;7,0;20,0;19,0;50,0;;55,0;41,0;3,0;15,0;10,0;6,0;7,0;;2,0;5,0;22,0;;12,0;3,0;18,0;93,0;;63,0;3,0;2,0;;23,0;;;;;4,0;14,0;16,0;37,0;10,0;30,0;1,0;;;;10,0;18,0;;7,0;;14,0;2,0;3,0;6,0;7,0;;3,0;12,0;2,0;2,0;1,0;2,0;;;;;;2,0;18,0;3,0;36,0;2,0;5,0;;43,0;16,0;;3,0;;;9,0;19,0;1,0;11,0;83,0;;27,0;1,0;;9,0;263,0;2,0;1,0;3,0;3,0;;4,0;;12,0;1,0;5,0;;2,0;44,0;2,0;2,0;1,0;35,0;;21,0;12,0;2,0;8,0;;;;29,0;17,0;2,0;;3,0;4,0;1,0;9,0;2,0;1,0;8,0;;;2,0;5,0;;2,0;3,0;1,0;2,0;;6,0;2,0;4,0;9,0;;6,0;;4,0;;12,0;;23,0;;;2,0;;4,0;;6,0;4,0;;;2,0;1,0;;21,0;;10,0;111,0;;;2,0;;;;;1,0;;;3,0;;2,0;;;;;;1,0;8,0;1,0;5,0;;;;;;;;;3,0;;;;;;;2,0;;;;;1,0;2,0;1,0;2,0;34,0;;;;5,0;;6,0;;;14,0;;;;;;2,0;7,0;5,0;1,0;15,0;;;;14,0;;;;;;;;;;;;;1,0;6,0;3,0;3,0;1,0;;;6,0;;7,0;;;2,0;;;;3,0;;;;;;;;;;;;;;;;2,0;9,0;5,0;8,0;;;8,0;;;4,0;3,0;;;;;1,0;;;;;;;6,0;2,0;;;;;4,0;;;;;74,0;;;;;;;;;4,0;;7,0;;;;16,0;29,0;1,0;3,0;5,0;;18,0;;;;;;;;2,0;;3,0;;;2,0;;;;12,0;57,0;33,0;;;;;2,0;;;;;;1,0;;;;;1,0;2,0;;;;;;;;1,0;;2,0;5,0;;2,0;;;;1,0;;72,0;3,0;12,0;3,0;;;1,0;;7,0;2,0;2,0;;1,0;;1,0;;;;;1,0;;;;;12,0;;5,0;;;;2,0;;;14,0;;;;;21,0;19,0;;93,0;6,0;1,0;1,0;;2,0;2,0;3,0;;;;;;;;;17,0;;17,0;;;;;5,0;;;;1,0;6,0;;4,0;1,0;;;;1,0;;;;;;;;;18,0;;1,0;;;4,0;;;;;;2,0;1,0;;21,0;;2,0;2,0;1,0;2,0;;1,0;;2,0;;;;;13,0;1,0;;4,0;;;;;3,0;1,0;;;;;;9,0;4,0;;;;;;;;3,0;;8,0;;;;5,0;13,0;6,0;16,0;;;1,0;;;;;4,0;1,0;;2,0;7,0;;;;;;8,0;;;2,0;;;1,0;;;;;;1,0;;2,0;;;1,0;;;4,0;;;1,0;;;;;;;;;;;;;;;;;;;9,0;;;;;;;;;;;;;;;;;3,0;;8,0;;2,0;;;;;;;;;1,0;;2,0;;;;7,0;;;;;;;;;5,0;;;1,0;3,0;6,0;;;;;;4,0;;;;1,0;;;;;;;;11,0;;;3,0;;2,0;;;;;;;1,0;1,0;;;10,0;;;;1,0;;;9,0;;;;;;;;;;;1,0;;8,0;48,0;;;2,0;1,0;;2,0;;;1,0;;4,0;5,0;;;;;;;;2,0;;;;1,0;1,0;;;;;;;;;;1,0;;;;;;;;;;;;3,0;1,0;;;;1,0;;;;;;;;;1,0;;;;;8,0;;;;;;;;;;;;;;;;;;;;;46,0;8,0;3,0;;;3,0;;;6,0;18,0;3,0;;;;;;;;;;;;;;;3,0;;;;;;;;;;;9,0;3,0;;;;;;;;;;;1,0;
acceleration;;;3,0;;20,0;;10,0;26,0;4,0;1,0;;1,0;;;;;1,0;;;3,0;;15,0;;11,0;7,0;;;4,0;;101,0;25,0;9,0;5,0;7,0;;;;16,0;1,0;;3,0;;2,0;;;;;;;4,0;;3,0;;;;23,0;11,0;;;1,0;;1,0;20,0;;3,0;4,0;7,0;;;4,0;1,0;;;;;;;;4,0;1,0;;;1,0;;;;;;1,0;4,0;54,0;;;5,0;1,0;;;1,0;5,0;;;14,0;;;1,0;;;17,0;;;2,0;;;2,0;1,0;;;;;13,0;;;1,0;15,0;;;6,0;;;;;;;;1,0;22,0;1,0;;;;;1,0;;;2,0;1,0;2,0;1,0;;;;;;;8,0;;;4,0;;;;9,0;;;;;5,0;;;;;;;;5,0;;;1,0;;;;;;5,0;;;;5,0;;;;;;;;;;;1,0;;;2,0;;;;;;;;;;;;;1,0;17,0;;;;;;13,0;10,0;;;;;;;;;;2,0;;1,0;10,0;;5,0;4,0;;;;;;;;;;;;;;;;;;;1,0;;;;20,0;;;;;;;;;;;;;;2,0;2,0;;;;;;;;;7,0;1,0;15,0;1,0;;;2,0;;;;;;;;;;;6,0;;;;;;;;4,0;2,0;;;;;;;;;;3,0;;;;;;;;;;;1,0;;2,0;3,0;1,0;1,0;4,0;62,0;2,0;1,0;2,0;1,0;2,0;1,0;4,0;1,0;1,0;6,0;3,0;1,0;5,0;1,0;1,0;4,0;1,0;6,0;1,0;1,0;3,0;3,0;1,0;1,0;3,0;3,0;1,0;8,0;3,0;3,0;1,0;12,0;9,0;2,0;1,0;2,0;3,0;1,0;2,0;1,0;9,0;2,0;2,0;3,0;24,0;5,0;6,0;1,0;2,0;2,0;1,0;8,0;1,0;2,0;1,0;14,0;1,0;1,0;21,0;1,0;2,0;1,0;1,0;3,0;3,0;14,0;3,0;3,0;;;;;;;;;;;;;;;;;;;;;;;;;;;;;;;;;;;;;;;;;;;;;;;;;;;;;;;;;;;;;;;;;;;;;;;;;;;;;;;;;;;;;;;;;;;;;;;;;;;;;;;;;;;;;;;;;;;;;;;;;;;;;;;;;;;;;;;;;;;;;;;;;;;;;;;;;;;;;;;;;;;;;;;;;;;;;;;;;;;;;;;;;;;;;;;;;;;;;;;;;;;;;;;;;;;;;;;;;;;;;;;;;;;;;;;;;;;;;;;;;;;;;;;;;;;;;;;;;;;;;;;;;;;;;;;;;;;;;;;;;;;;;;;;;;;;;;;;;;;;;;;;;;;;;;;;;;;;;;;;;;;;;;;;;;;;;;;;;;;;;;;;;;;;;;;;;;;;;;;;;;;;;;;;;;;;;;;;;;;;;;;;;;;;;;;;;;;;;;;;;;;;;;;;;;;;;;;;;;;;;;;;;;;;;;;;;;;;;;;;;;;;;;;;;;;;;;;;;;;;;;;;;;;;;;;;;;;;;;;;;;;;;;;;;;;;;;;;;;;;;;;;;;;;;;;;;;;;;;;;;;;;;;;;;;;;;;;;;;;;;;;;;;;;;;;;;;;;;;;;;;;;;;;;;;;;;;;;;;;;;;;;;;;;;;;;
accept;;;2,0;;5,0;;;3,0;;12,0;;;;;1,0;1,0;;;;5,0;3,0;30,0;1,0;;;;;21,0;;;;8,0;7,0;;15,0;;;;;23,0;;;;;;;;;4,0;2,0;1,0;5,0;;8,0;;81,0;9,0;;;6,0;;;12,0;3,0;;;1,0;2,0;;41,0;;;4,0;;;;;1,0;2,0;4,0;;13,0;3,0;;;;1,0;;2,0;3,0;1,0;2,0;2,0;19,0;;2,0;;3,0;2,0;;2,0;1,0;;;;1,0;2,0;62,0;;;5,0;;;2,0;1,0;;;;;;;;;;;;10,0;;;;1,0;;;;;;;;;;;;2,0;7,0;;;2,0;2,0;2,0;;;1,0;;;;;;2,0;;;;;;1,0;;;6,0;3,0;;;3,0;;2,0;;;;;7,0;;;;;;;;;2,0;27,0;;23,0;;;;6,0;;;;;5,0;;;;;;;;;;;;;5,0;;;;1,0;4,0;;;;;1,0;;;1,0;;5,0;;;;;;;1,0;5,0;;;;2,0;;;;;;;2,0;2,0;;;;;2,0;;;;;;8,0;;;;;2,0;;;;2,0;;;;;;;;;2,0;4,0;;;;;;;;;;;11,0;8,0;;;;;;;;;;;;;;1,0;;;;;1,0;1,0;;1,0;;;;;;;;;;;;;;;;;;;;34,0;;;;;;;;;4,0;;;;;;1,0;;;;2,0;;6,0;;;;;;;;;;1,0;;;;1,0;4,0;;;;;;;;2,0;1,0;;;;;;1,0;;3,0;;;;16,0;;7,0;2,0;1,0;;;3,0;;1,0;1,0;4,0;;;;;;;;;;;;;1,0;;;;;;;41,0;;6,0;;;;5,0;2,0;;1,0;;;1,0;;1,0;;;2,0;4,0;14,0;2,0;2,0;4,0;1,0;1,0;1,0;7,0;1,0;1,0;2,0;4,0;1,0;1,0;2,0;2,0;1,0;6,0;2,0;1,0;2,0;29,0;1,0;2,0;1,0;2,0;2,0;2,0;1,0;1,0;4,0;3,0;3,0;1,0;1,0;2,0;1,0;2,0;1,0;10,0;1,0;1,0;1,0;1,0;6,0;6,0;1,0;1,0;4,0;2,0;8,0;2,0;7,0;1,0;11,0;4,0;1,0;5,0;8,0;1,0;3,0;1,0;5,0;;;;;;;;;;;;;;;;;;;;;;;;;;;;;;;;;;;;;;;;;;;;;;;;;;;;;;;;;;;;;;;;;;;;;;;;;;;;;;;;;;;;;;;;;;;;;;;;;;;;;;;;;;;;;;;;;;;;;;;;;;;;;;;;;;;;;;;;;;;;;;;;;;;;;;;;;;;;;;;;;;;;;;;;;;;;;;;;;;;;;;;;;;;;;;;;;;;;;;;;;;;;;;;;;;;;;;;;;;;;;;;;;;;;;;;;;;;;;;;;;;;;;;;;;;;;;;;;;;;;;;;;;;;;;;;;;;;;;;;;;;;;;;;;;;;;;;;;;;;;;;;;;;;;;;;;;;;;;;;;;;;;;;;;;;;;;;;;;;;;;;;;;;;;;;;;;;;;;;;;;;;;;;;;;;;;;;;;;;;;;;;;;;;;;;;;;;;;;;;;;;;;;;;;;;;;;;;;;;;;;;;;;;;;;;;;;;;;;;;;;;;;;;;;;;;;;;;;;;;;;;;;;;;;;;;;;;;;;;;;;;;;;;;;;;;;;;;;;;;;
accumulate;;;11,0;;5,0;;;12,0;6,0;2,0;;2,0;;3,0;3,0;;2,0;3,0;4,0;2,0;;11,0;;4,0;2,0;3,0;1,0;14,0;;8,0;11,0;7,0;30,0;;3,0;;2,0;9,0;;;;;;20,0;;1,0;;;3,0;2,0;;25,0;;;;57,0;12,0;;1,0;1,0;;;16,0;;11,0;;;;;;3,0;;4,0;;;;;1,0;7,0;;;;5,0;1,0;;;56,0;;3,0;;13,0;16,0;;70,0;;;;3,0;1,0;;5,0;1,0;;55,0;;;5,0;105,0;;;10,0;1,0;1,0;;;;10,0;;;;;;;10,0;;1,0;7,0;;;;;;;;;3,0;;;3,0;;7,0;;;4,0;2,0;1,0;6,0;11,0;;;;;;;12,0;;;1,0;;12,0;7,0;;;;;5,0;2,0;33,0;;;2,0;;;;35,0;;;14,0;;;;;;1,0;;;;12,0;;33,0;;;;5,0;;;;;;;6,0;;1,0;7,0;;;4,0;;;;;;;;;21,0;2,0;;;;;;;;;;;;;;;;;2,0;;;;1,0;1,0;;1,0;;;;;;;;;;;;3,0;1,0;;;;;1,0;;1,0;;;1,0;1,0;;;;;;;4,0;;;;;;;;;;;;3,0;;4,0;;2,0;6,0;5,0;;;;;;;80,0;1,0;;;1,0;;9,0;;;;;;;;;1,0;;;;;;;;;;;;;;2,0;;;3,0;;1,0;;;3,0;2,0;;;;;3,0;;;;4,0;;1,0;1,0;;;;1,0;;3,0;;;;6,0;;;;3,0;;;7,0;1,0;3,0;;1,0;;;;;;;2,0;3,0;1,0;;;;10,0;5,0;;1,0;4,0;;;;;2,0;;5,0;;;2,0;;1,0;;13,0;2,0;1,0;;1,0;;7,0;;;;1,0;;;;132,0;;;2,0;;12,0;2,0;;5,0;;;2,0;2,0;1,0;;19,0;;2,0;;;;;;;1,0;;;;;2,0;;;;4,0;74,0;9,0;;;;;2,0;2,0;;;;;1,0;;;;;;;10,0;;;;;;;;;;;;;;;3,0;;;1,0;;;;;;;;4,0;;;5,0;1,0;;4,0;;;;;;;;;;;;;;;1,0;;7,0;;;;;4,0;;;4,0;;;2,0;2,0;;;;;;2,0;;;;;;5,0;;;;;;;;;;;;5,0;;;1,0;1,0;;2,0;;;1,0;33,0;12,0;;;;;;;;;;5,0;;;;;;;;;;2,0;5,0;3,0;;2,0;;;;;1,0;;;;9,0;184,0;;;;;;;16,0;;;;;2,0;;;;;;;;;;;;;5,0;;;;1,0;;;;;;;;;;;;;;;;;2,0;;;;3,0;;;;;1,0;1,0;;;;;;;3,0;;;;;;;;;;;;;;;3,0;13,0;;;2,0;13,0;1,0;2,0;19,0;8,0;2,0;13,0;24,0;5,0;1,0;4,0;7,0;10,0;46,0;2,0;1,0;2,0;6,0;4,0;11,0;3,0;6,0;7,0;1,0;1,0;1,0;4,0;2,0;22,0;1,0;1,0;4,0;3,0;1,0;3,0;1,0;1,0;2,0;23,0;;;;;;;;;;;;;;;;;;;;;;;;;;;;;;;;;;;;;;;;;;;;;;;;;;;;;;;;;;;;;;;;;;;;;;;;;;;;;;;;;;;;;;;;;;;;;;;;;;;;;;;;;;;;;;;;;;;;;;;;;;;;;;;;;;;;;;;;;;;;;;;;;;;;;;;;;;;;;;;;;;;;;;;;;;;;;;;;;;;;;;;;;;;;;;;;;;;;;;;;;;;;;;;;;;;;;;;;;;;;;;;;;;;;;;;;;;;;;;;;;;;;;;;;;;;;;;;;;;;;;;;;;;;;;;;;;;;;;;;;;;;
accumulation;;;5,0;;1,0;;;3,0;;4,0;;;;;1,0;;;;;2,0;;22,0;;;1,0;;;5,0;;8,0;3,0;2,0;2,0;;2,0;;;;;;;;;7,0;;4,0;;;;;13,0;3,0;2,0;;;7,0;5,0;;;;7,0;;2,0;;;;;;;;;1,0;1,0;;;;;;;2,0;4,0;;;;;2,0;34,0;;;7,0;8,0;1,0;;26,0;;;;1,0;;9,0;14,0;1,0;;5,0;;;12,0;19,0;;;;4,0;2,0;;;;;;;;;;;19,0;;;3,0;;;;;;;;1,0;;;;;1,0;;;;9,0;;;4,0;6,0;;;;;;;;;;;;4,0;2,0;5,0;;;;23,0;2,0;14,0;;;6,0;1,0;;;;;;11,0;;;;2,0;;1,0;;;;11,0;;19,0;;;;12,0;;;;;;;3,0;;;1,0;;;;;1,0;;;;;;;18,0;;;;;;;;;;;;;;;;;;9,0;;;;;;;;;;1,0;;;1,0;;;;;;;;;;;;1,0;;;;;;;;;;;;;;;;;9,0;;;;1,0;;;;;;;;1,0;;;;;;;;;11,0;2,0;;;;;3,0;;;;;;;;1,0;;;;;;;;;;;;;;;;;;2,0;;;;;;;13,0;;;;;;;;;;;;3,0;;;;;;;;;;;;;;;;1,0;;;;;;;;;;;;1,0;;;;;7,0;2,0;;;;2,0;1,0;;;;;;;;;;10,0;;;;;;;;;;;;;;;1,0;7,0;;;;;;;;;;;;6,0;;;3,0;;;;;;;;;;;;;;;;;9,0;;22,0;1,0;1,0;;;8,0;1,0;;;;;;;;;;;1,0;;1,0;;;;;;1,0;;;;;;;;;;;;;;;;;;;;4,0;;3,0;2,0;;;3,0;;;;;;;5,0;;;;;;;;;;;;;;;;;;2,0;;;3,0;;;;;;;;;;;;;;;;;1,0;;;;;;;;;;;;4,0;;;;;;15,0;;;;;;1,0;;;;;;;;;;;2,0;;;;;;;;;;;;;;;;;;69,0;;;;;;;;;;;;;;;;;;;;;;;;;6,0;;;;;;;;;;;;;;;;;;;;;2,0;;;;;;;;;;;;;;;;;;;;;;;;;;;;;;;;;;;;;;;1,0;3,0;;;;1,0;3,0;;;;;16,0;;;;1,0;11,0;;;;2,0;;;;;;7,0;;;;11,0;;;;;;5,0;3,0;2,0;1,0;1,0;1,0;4,0;1,0;1,0;1,0;1,0;1,0;3,0;;;;;;;;;;;;;;;;;;;;;;;;;;;;;;;;;;;;;;;;;;;;;;;;;;;;;;;;;;;;;;;;;;;;;;;;;;;;;;;;;;;;;;;;;;;;;;;;;;;;;;;;;;;;;;;;;;;;;;;;;;;;;;;;;;;;;;;;;;;;;;;;;;;;;;;;;;;;;;;;;;;;;;;;;;;;;;;;;;;;;;;;;;;;;;;;;;;;;;;;;;;;;;;;;;;;;;;;;;;;;;;;;;;;;;;;;;;;;;;;;;;;;;;;;;;;;;;;;;;;;;;;;;;;;;;
achieve;;;1,0;;1,0;;4,0;1,0;2,0;3,0;;4,0;;;2,0;;1,0;;;;5,0;19,0;1,0;4,0;;;;5,0;12,0;3,0;3,0;7,0;11,0;;10,0;;;6,0;;4,0;2,0;3,0;2,0;10,0;;;1,0;7,0;38,0;1,0;4,0;;;6,0;1,0;50,0;;;4,0;40,0;3,0;23,0;19,0;;;;11,0;2,0;1,0;1,0;8,0;3,0;;;;2,0;;5,0;10,0;2,0;1,0;2,0;;;;;;;;4,0;5,0;;;6,0;5,0;1,0;;;4,0;1,0;;5,0;;;;;1,0;24,0;;;;1,0;;;;;;;;3,0;;;1,0;3,0;;;1,0;;;;;;3,0;;;;1,0;;;8,0;1,0;;;14,0;10,0;1,0;1,0;1,0;;;;;1,0;;;1,0;;;;4,0;;;;;;1,0;14,0;13,0;;;;3,0;1,0;4,0;13,0;3,0;;1,0;;;1,0;;;;;5,0;5,0;20,0;;1,0;;;;4,0;;;;;2,0;;;;;;;;;;;;;;1,0;1,0;1,0;12,0;;;;3,0;;;10,0;;;;;;;;;;1,0;4,0;10,0;22,0;;1,0;4,0;;;;;;;4,0;;;;;;;;1,0;;;;1,0;9,0;;2,0;2,0;;;;;;;;;1,0;;;;;;;;;;;;;;;2,0;1,0;6,0;;;;;4,0;13,0;;;;4,0;;;;;11,0;;;;;9,0;;;;;;;;;;;;;;2,0;3,0;1,0;;1,0;;;;;1,0;5,0;;1,0;;;;3,0;;;;1,0;;;;;5,0;1,0;;15,0;;1,0;;;;;;;;;;;;;;1,0;;;;2,0;;;1,0;1,0;;11,0;2,0;3,0;;5,0;4,0;1,0;;2,0;1,0;;4,0;;;;;;;;1,0;1,0;;2,0;;;;;2,0;;;;1,0;6,0;;;;;2,0;3,0;;;;;;;3,0;1,0;;1,0;5,0;1,0;3,0;;4,0;;;;;;;;1,0;1,0;;;;;;;;;1,0;;;;;;1,0;;1,0;;;;;1,0;;;;;;;;;5,0;;;10,0;;;;;1,0;1,0;2,0;6,0;;1,0;;;;;1,0;;;1,0;;1,0;;2,0;11,0;28,0;;;;;;;1,0;;3,0;;;;;;;;;;;2,0;;;;;;;;;;2,0;2,0;1,0;;;;;1,0;;;;;;;;;;;;;;;;;;4,0;;;;1,0;;;;;;5,0;;;;;;;;;;;;;;;;;3,0;;;;;8,0;;2,0;;3,0;;;;2,0;;;;;2,0;;;2,0;;;;39,0;;;;;;;;;;;;;;;;;2,0;;;7,0;1,0;;;;;;;;1,0;1,0;7,0;2,0;2,0;;;3,0;;;;;;;;;1,0;;;;1,0;;;;;;;;;1,0;;;1,0;;1,0;;;;;;;;1,0;;1,0;;1,0;;;;;;10,0;9,0;;;;;;;;;;;;;;;;;;;;;;;;;;1,0;;1,0;3,0;;;;;;;3,0;;;;;;1,0;;;2,0;1,0;1,0;2,0;1,0;1,0;2,0;1,0;1,0;1,0;1,0;1,0;1,0;2,0;2,0;2,0;5,0;1,0;1,0;3,0;3,0;2,0;2,0;1,0;2,0;3,0;1,0;1,0;23,0;1,0;;;;;;;;;;;;;;;;;;;;;;;;;;;;;;;;;;;;;;;;;;;;;;;;;;;;;;;;;;;;;;;;;;;;;;;;;;;;;;;;;;;;;;;;;;;;;;;;;;;;;;;;;;;;;;;;;;;;;;;;;;;;;;;;;;;;;;;;;;;;;;;;;;;;;;;;;;;;;;;;;;;;;;;;;;;;;;;;;;;;;;;;;;;;;;;;;;;;;;;;;;;;;;;;;;;;;;;;;;;;;;;;;;;;;;;;;;;;;;;;;
acquisition;;;9,0;;21,0;;11,0;3,0;8,0;15,0;7,0;;;2,0;12,0;3,0;;;;;3,0;21,0;;3,0;11,0;;;52,0;12,0;13,0;8,0;6,0;64,0;6,0;28,0;;;2,0;30,0;3,0;;;2,0;9,0;2,0;;;;6,0;1,0;1,0;6,0;1,0;1,0;;272,0;23,0;;;23,0;;2,0;37,0;;6,0;;4,0;;1,0;50,0;8,0;;;;;3,0;;;48,0;;;19,0;16,0;2,0;;;4,0;2,0;;12,0;6,0;;14,0;28,0;;3,0;;13,0;15,0;;;41,0;;1,0;;2,0;;156,0;;;4,0;3,0;1,0;11,0;1,0;;;;;9,0;;;;10,0;;2,0;37,0;1,0;6,0;;;;;;;6,0;1,0;;;;3,0;;;5,0;;;1,0;1,0;1,0;;;;;;;2,0;;5,0;11,0;20,0;;;;;;;;9,0;;;;;7,0;10,0;3,0;2,0;;2,0;1,0;;;1,0;;;;;;36,0;;10,0;;;;16,0;;;;;9,0;2,0;2,0;;;2,0;;2,0;1,0;;4,0;1,0;;;;;;49,0;;;;;;1,0;;;1,0;;1,0;;;;;;;1,0;5,0;17,0;;;4,0;;;;;;2,0;2,0;;1,0;;;;;;10,0;;4,0;;;;;1,0;;2,0;;;;;;;1,0;;;;;;;3,0;;;;;;;1,0;;12,0;;9,0;2,0;1,0;;;4,0;;;1,0;;;2,0;;3,0;;6,0;;1,0;;;15,0;;;7,0;1,0;;;;;2,0;1,0;;;;14,0;;;;8,0;;;;;6,0;;;1,0;;;3,0;;2,0;;;1,0;1,0;1,0;;1,0;2,0;;;6,0;1,0;;;;;;;;;;1,0;;;;1,0;11,0;;;6,0;2,0;2,0;;;3,0;;8,0;1,0;1,0;;;1,0;10,0;1,0;10,0;;2,0;18,0;;;11,0;;;7,0;;1,0;1,0;14,0;5,0;3,0;1,0;;;;1,0;;;4,0;3,0;;2,0;;;;1,0;;16,0;;;3,0;;1,0;4,0;;;62,0;;;;9,0;7,0;;8,0;;1,0;;;;;;;1,0;;;5,0;;6,0;;;;1,0;;;14,0;1,0;;;2,0;;10,0;;1,0;;;;;;1,0;;6,0;;;9,0;;;1,0;2,0;1,0;;;3,0;2,0;;1,0;;;2,0;;1,0;;3,0;;18,0;;;1,0;17,0;;;;;;12,0;;;2,0;;3,0;;;;;;;;5,0;17,0;;;;;;;;;;;2,0;;;;;1,0;;;;1,0;;;2,0;9,0;;;;;;;;;1,0;;;;;;26,0;;31,0;;;7,0;11,0;;;;;;3,0;;3,0;1,0;2,0;;2,0;;;;;3,0;;;;;4,0;2,0;2,0;6,0;;;;;;;;;;;;;;;;;6,0;;;;1,0;;;;;;;;;;;2,0;;1,0;;;;2,0;;;;;;;;;;;;;1,0;;;;;;;;;;;;;2,0;;3,0;;;;;;;;;1,0;1,0;;;;;;;;;;;;;;;;;;3,0;1,0;;;1,0;;;;;;;;;;;;;;;4,0;;4,0;;;;;;;;;;1,0;;;10,0;;;1,0;;;;;;;;;;;;;;2,0;;3,0;3,0;;3,0;;;;;1,0;;;5,0;;2,0;;1,0;;;;;2,0;;;;2,0;;;1,0;1,0;1,0;2,0;2,0;1,0;4,0;1,0;1,0;1,0;4,0;3,0;2,0;1,0;1,0;2,0;2,0;4,0;1,0;1,0;3,0;1,0;1,0;3,0;1,0;2,0;1,0;5,0;1,0;6,0;1,0;2,0;1,0;;;;;;;;;;;;;;;;;;;;;;;;;;;;;;;;;;;;;;;;;;;;;;;;;;;;;;;;;;;;;;;;;;;;;;;;;;;;;;;;;;;;;;;;;;;;;;;;;;;;;;;;;;;;;;;;;;;;;;;;;;;;;;;;;;;;;;;;;;;;;;;;;;;;;;;;;;;;;;;;;;;;;;;;;;;;;;;;;;;;;;;;;;;;;;;;;;;;;;;;;;;;;;;;
activate;;;1,0;1,0;15,0;;;11,0;;13,0;;6,0;;;;9,0;;;21,0;1,0;2,0;37,0;;;;;;5,0;;13,0;2,0;56,0;67,0;1,0;4,0;;;2,0;;21,0;1,0;;1,0;21,0;;7,0;;;23,0;;29,0;6,0;;;;51,0;11,0;;2,0;4,0;;4,0;31,0;;;21,0;3,0;;;15,0;1,0;1,0;1,0;;;;;1,0;14,0;10,0;2,0;4,0;8,0;3,0;;;7,0;;;11,0;13,0;;2,0;52,0;1,0;2,0;3,0;1,0;2,0;;4,0;48,0;2,0;;;7,0;4,0;9,0;;;6,0;3,0;;4,0;3,0;1,0;;;2,0;5,0;;;;9,0;;2,0;25,0;;;10,0;;;;;;19,0;2,0;;3,0;1,0;1,0;4,0;1,0;2,0;2,0;3,0;;;;;;;;9,0;3,0;4,0;;7,0;4,0;5,0;;;;1,0;;;6,0;22,0;2,0;;3,0;1,0;41,0;4,0;1,0;;2,0;11,0;;;;;;;3,0;;;7,0;;1,0;1,0;;;13,0;;;;;3,0;;;;;;;;;1,0;;;8,0;;;;;21,0;4,0;;;;;7,0;4,0;;;;2,0;4,0;;;;;4,0;;4,0;;;5,0;1,0;8,0;;;;;;9,0;1,0;;;;;;;;;;;;1,0;;;10,0;;2,0;;;;;;;2,0;;;;;5,0;;1,0;;;;;;22,0;;14,0;1,0;5,0;2,0;3,0;;;;;;;;2,0;;;3,0;;4,0;;;;;1,0;;;;2,0;;;;;;;;6,0;;6,0;;1,0;;7,0;;3,0;1,0;;19,0;;2,0;;3,0;;;2,0;;;;4,0;;;4,0;;;;;;;1,0;;;;;;;;;;;;;1,0;4,0;;;2,0;;;;;2,0;1,0;2,0;1,0;;;1,0;12,0;5,0;;15,0;1,0;;;;;5,0;8,0;19,0;;;7,0;15,0;1,0;1,0;9,0;3,0;10,0;;;3,0;;;;7,0;;;;5,0;;;1,0;13,0;;;8,0;;4,0;1,0;1,0;3,0;28,0;12,0;;1,0;;;;;15,0;;;;2,0;;4,0;3,0;13,0;;5,0;2,0;;34,0;2,0;;;1,0;;1,0;;42,0;;2,0;1,0;;1,0;;;;;;2,0;7,0;;5,0;;;;12,0;;;1,0;;6,0;;;;;;1,0;;;5,0;;1,0;1,0;6,0;;19,0;10,0;5,0;14,0;5,0;3,0;;;;;;;;;1,0;;2,0;1,0;;;2,0;;4,0;3,0;2,0;;;;;;;;;;;3,0;;;;1,0;;;1,0;;;6,0;1,0;2,0;;;1,0;;;;;;1,0;;;;;;;;;5,0;1,0;4,0;4,0;3,0;4,0;;;;;2,0;;;;;1,0;;;;;;1,0;;3,0;1,0;;1,0;;1,0;4,0;;;;;2,0;;;;1,0;1,0;;;;;1,0;2,0;11,0;;;;;;;;;;;;3,0;;6,0;;;2,0;;;;;;;;;;;;;;;1,0;;3,0;;;;;;;9,0;;;;1,0;;;;;1,0;;;;;2,0;;;11,0;;;;;;2,0;1,0;;;;;;;;;;;;4,0;;;;;;;;;9,0;;;;;;;;;;;;1,0;;;;;;;;3,0;8,0;;;;;;;7,0;;;1,0;;;;;;;;1,0;;;3,0;3,0;1,0;1,0;;;;;;;;1,0;;;1,0;;;1,0;;;;;;;;;;1,0;;;1,0;1,0;1,0;;16,0;;;;;;21,0;1,0;;;;;;;;2,0;;;;;;;7,0;2,0;;;2,0;;10,0;;;1,0;;;;;;;;;;;1,0;;2,0;;;;;1,0;;2,0;5,0;1,0;4,0;3,0;4,0;2,0;1,0;1,0;2,0;2,0;1,0;3,0;3,0;16,0;4,0;2,0;4,0;6,0;1,0;1,0;4,0;5,0;3,0;5,0;3,0;1,0;1,0;4,0;4,0;3,0;;;;;;;;;;;;;;;;;;;;;;;;;;;;;;;;;;;;;;;;;;;;;;;;;;;;;;;;;;;;;;;;;;;;;;;;;;;;;;;;;;;;;;;;;;;;;;;;;;;;;;;;;;;;;;;;;;;;;;;;;;;;;;;;;;;;;;;;;;;;;;;;;;;;;;;;;;
activation;;;1,0;;1,0;;;;;2,0;;;;;;;;;;;;11,0;;;2,0;;;1,0;;1,0;2,0;;3,0;;;;;;;3,0;;;1,0;;;;;;2,0;;6,0;1,0;;2,0;;7,0;4,0;;;8,0;;;5,0;;;17,0;;;;3,0;;;;;;;;4,0;;2,0;;1,0;6,0;;;;1,0;;;;14,0;;;15,0;;;1,0;;;;1,0;9,0;;;;2,0;;7,0;;;2,0;;;;4,0;;;;;1,0;;;;;;;5,0;;;3,0;;2,0;;1,0;;;;;;;;;;;;1,0;;1,0;;;;;;;;;;4,0;2,0;3,0;;;;;;;;6,0;;;2,0;;7,0;2,0;3,0;;;;;;;;;;;;;;;6,0;;;;9,0;;;;;;;;;;;;;;;;;1,0;;;;;9,0;8,0;;;;;;;2,0;;;;1,0;;;;;12,0;;4,0;;;;1,0;9,0;;;;;;;;;;;;;;3,0;;;;;;;;;;;1,0;;;;;;;;;;;;;;;;;;;10,0;;3,0;;;1,0;;;;;;;;;;;;;;1,0;;;;;;;;;;;;;;;;;;;;;;;4,0;;;1,0;;5,0;;;;;;;;;;;;;;4,0;;;;;;;;;;;;;;;;2,0;;;;;;;;;;;;;;;1,0;;;;;;;;3,0;;;;;;3,0;;2,0;;;8,0;;5,0;;;;1,0;;;;;;;;;2,0;;1,0;;;;;;;;;;;;;1,0;;;;;;;;;;;;;;;1,0;9,0;;;;;7,0;;;;;;;;9,0;;;;;6,0;;;;;;;7,0;;;;;;;;;1,0;;;;;;;;;5,0;;;1,0;;2,0;2,0;;26,0;;1,0;5,0;;;1,0;;;;;;;;1,0;;;;;4,0;1,0;;;1,0;;;;;;;;;;;;3,0;;;;;;;;;;;3,0;;;;;1,0;;4,0;;;;;1,0;;;;;;;;;;;;1,0;;;;;1,0;;;;;2,0;;;;;;;;;;;;;;1,0;;;;;3,0;;;;;;;;;;;;2,0;;;;;;;;;;;;;;2,0;;;;;;;;;;;;;;;;;;;;1,0;;;;;;;;;;;;;;;;;;;;;;;;;;;;;;;;;;;;;;1,0;;;;;;;1,0;;;;;;;;;;;;;;;;;;;;;;;;;;;;5,0;;;;;;;3,0;;;;;;;;;;;;;;;;;;;;;;;;;;;;;;;;;;;;;;;;;;;;;;;;;;;;;;1,0;;;;;;;;3,0;;;;;;;;;;;;1,0;;;;;;;;;;;;;;;;2,0;;;;;;;1,0;;;;;;3,0;;1,0;;;;;;1,0;1,0;;;;;;;;;;;;;;;1,0;;;1,0;2,0;3,0;1,0;1,0;2,0;;;;;;;;;;;;;;;;;;;;;;;;;;;;;;;;;;;;;;;;;;;;;;;;;;;;;;;;;;;;;;;;;;;;;;;;;;;;;;;;;;;;;;;;;;;;;;;;;;;;;;;;;;;;;;;;;;;;;;;;;;;;;;;;;;;;;;;;;;;;;;;;;;;;
activity;;;16,0;3,0;;;;22,0;;10,0;;12,0;;;1,0;;;;1,0;3,0;;2,0;;;;;;1,0;;12,0;2,0;32,0;;;;;;;;14,0;3,0;;;;;;;;;;;6,0;;12,0;;4,0;11,0;;6,0;;;;14,0;11,0;2,0;;;;10,0;;;3,0;;;;;;8,0;;;;2,0;;;;;1,0;;2,0;20,0;3,0;;;1,0;;7,0;;1,0;1,0;;;7,0;;;;4,0;;;;;;;;;;;;;;;;;;;;;2,0;;;;;1,0;;;;4,0;;;;;;;;;;;;3,0;;;2,0;;;;;;;2,0;;;;;;;;;4,0;;;;;;1,0;2,0;;;;;;;;;;;;;;28,0;;;;;;5,0;;;;;;;;;;;;1,0;;;;;;;;;;22,0;1,0;;;;;;;1,0;;;1,0;;;;;;;3,0;;2,0;;;2,0;;;;;;;;4,0;;;;;;;;;1,0;;;;;;;;;;;;;;;;1,0;;;;1,0;;;;;;;;2,0;;11,0;;3,0;;;;;;1,0;;;;;;;;;5,0;;;;;;;;1,0;7,0;;;;;;;;;;;;;;;;;;;3,0;1,0;;;;1,0;;3,0;2,0;;;1,0;;1,0;;;;1,0;;9,0;12,0;;11,0;;2,0;;;;;;;;;;9,0;9,0;;;;11,0;;;;6,0;1,0;;9,0;;;;1,0;;;;;;;;1,0;15,0;;;;;;;7,0;26,0;7,0;;;;;;;;1,0;;;4,0;;;;;;35,0;;;;;2,0;;;;3,0;;;;1,0;30,0;;;;;;;;;;;;;;;;2,0;;;7,0;;;;14,0;;;;1,0;;2,0;;;;23,0;;;3,0;;;;8,0;;3,0;;;;;;;;1,0;;;;;;;1,0;;;;;1,0;;;69,0;23,0;;;;;;;2,0;;;;;;;;;;;2,0;1,0;;;;;;;;;;;;;;;;;;;;;;;;;;;6,0;;;;;;;;;;;;;1,0;;;;;;7,0;;;;;;;;;;;;;1,0;;;;;;;;32,0;;;4,0;;;;;;5,0;;;;4,0;;;;8,0;1,0;;;;;;;;;;;;;;;;;2,0;;;;;;;;;;;;;;;;;;;;;;;;;;;;;;;;;;;;;;;;;;;;;;;;;;;;;;;;;;;;;;;;;;3,0;;;;;;;;;;;;7,0;;;;;;;;;;;;;1,0;;;;;;1,0;;;;;1,0;;;;;;;;;;;1,0;;;2,0;;;;;;;1,0;;;4,0;;3,0;;;;;;3,0;;;;;;;2,0;;;;;;;;;;;;;;;;;;;;;;;;;;;;;;;;;;;;;;;;;;;;;;;21,0;;;;102,0;;;;;2,0;;;2,0;;;;5,0;;;;20,0;;;;;;;;;;;;;;;;;;;;;;;;;;;;2,0;2,0;1,0;8,0;1,0;3,0;;;;;;;;;;;;;;;;;;;;;;;;;;;;;;;;;;;;;;;;;;;;;;;;;;;;;;;;;;;;;;;;;;;;;;;;;;;;;;;;;;;;;;;;;;;;;;;;;;;;;;;;;;;;;;;;;;;;;;;;;;;;;;;;;;;;;;;;;;;;;;
addition;;;5,0;;5,0;;6,0;6,0;6,0;2,0;1,0;;;2,0;13,0;;1,0;;19,0;1,0;2,0;46,0;5,0;9,0;6,0;;;20,0;;7,0;8,0;2,0;10,0;3,0;9,0;;;4,0;;9,0;;1,0;1,0;8,0;;15,0;;1,0;2,0;1,0;;8,0;;2,0;;50,0;20,0;;1,0;13,0;;;9,0;6,0;1,0;;2,0;;;23,0;7,0;;1,0;3,0;;;;6,0;6,0;32,0;;8,0;;2,0;;;2,0;;3,0;4,0;6,0;7,0;;113,0;14,0;;;8,0;9,0;2,0;3,0;9,0;;7,0;;;;10,0;;;;1,0;;;;;;;;2,0;;;3,0;3,0;;;7,0;1,0;;;;;;;;;1,0;;1,0;;;;;;;;;2,0;;;;;;;3,0;;1,0;2,0;;9,0;;1,0;2,0;;1,0;;37,0;7,0;;;1,0;1,0;5,0;;2,0;;;14,0;;;;;;;;1,0;;9,0;;3,0;;;;;;1,0;;;;;;;;1,0;;2,0;;;3,0;;;;;;;12,0;1,0;;1,0;;4,0;;;;;4,0;1,0;;;;;;;1,0;2,0;1,0;;3,0;4,0;;;;1,0;1,0;;2,0;1,0;;;;;;;1,0;;;;3,0;;;;5,0;;;;;;;;;;;;;1,0;;;;7,0;;;;;1,0;1,0;2,0;1,0;7,0;;;;;1,0;1,0;;;;1,0;;;;;5,0;2,0;;;;1,0;;;8,0;5,0;;;;;;;;;;;;;;3,0;;;7,0;;6,0;;;4,0;;;;2,0;;2,0;;;;3,0;2,0;;;;;10,0;;;8,0;;3,0;;2,0;;;;;;;;;1,0;;1,0;13,0;;;;;1,0;;9,0;1,0;2,0;;3,0;1,0;2,0;1,0;2,0;1,0;;2,0;6,0;;2,0;;4,0;;;1,0;;;6,0;;;3,0;;1,0;5,0;;;;2,0;;;;;;6,0;;;3,0;1,0;11,0;;3,0;;;1,0;18,0;;;4,0;3,0;;;;;;;;;;;;2,0;;3,0;1,0;;4,0;2,0;;4,0;;;2,0;1,0;2,0;;;;;;;;;1,0;6,0;;;;;3,0;;;11,0;;6,0;;;5,0;;2,0;;4,0;;;;;;;;2,0;4,0;3,0;3,0;;;9,0;2,0;;;;;;;;;;;;;;;;;;;1,0;;;1,0;1,0;;;;;;;;1,0;;;;;;;;3,0;1,0;;;1,0;;;;;;;;;;1,0;;;;;;;;;;;1,0;19,0;;;;;;;2,0;;;;;;1,0;;;;1,0;;1,0;;2,0;1,0;;;1,0;;;1,0;1,0;1,0;;;;2,0;3,0;1,0;;;;;;1,0;;;1,0;;;;;;;;;;;1,0;;;;2,0;;2,0;;;;;;2,0;;;;;;;;2,0;;1,0;;;;1,0;;;1,0;;1,0;;;1,0;;;;1,0;;;;1,0;;1,0;;;;;;1,0;;;;;;;;24,0;;;7,0;;2,0;;;;7,0;;1,0;;;;;;1,0;;;;;;14,0;1,0;3,0;;2,0;;;;;;1,0;;12,0;;;;;;;;;;;;;;;;;;;;;;;;;;1,0;;;;;;;;6,0;;;1,0;;1,0;;;;1,0;;;;;;;1,0;;;;;;1,0;;;;;3,0;;;;1,0;3,0;2,0;;;1,0;;;;;;;;;;;;;;;1,0;;;;2,0;;;;;;;;;;;;;;;;;;;;;;2,0;;4,0;;;;;;;2,0;7,0;1,0;;;1,0;;;;;;;;;;;;;;;;;1,0;;;;;;;;;2,0;;;;;;;;;;;;;;;;2,0;;;;;;;;;;;;;;;;;;;1,0;;;;;;;;;;;;;;;1,0;;1,0;;;;;;;;;;;;;;;;;;2,0;;;;;;;;;;;2,0;1,0;;;;;;;;;;;;;;;;;;;;;;;;;;;;;;;;;;;;;;;;;;;;;;;;;;;;;;;;;
adjacent;;;2,0;;14,0;;14,0;39,0;7,0;14,0;10,0;;1,0;;38,0;1,0;;;14,0;6,0;;8,0;;4,0;2,0;;2,0;8,0;1,0;10,0;31,0;14,0;35,0;25,0;11,0;4,0;;92,0;;58,0;26,0;;8,0;113,0;;;;4,0;14,0;2,0;;16,0;;12,0;5,0;136,0;45,0;2,0;6,0;197,0;6,0;;37,0;;;2,0;6,0;1,0;;2,0;33,0;;2,0;38,0;4,0;1,0;1,0;23,0;130,0;5,0;3,0;9,0;4,0;;;;87,0;2,0;4,0;18,0;52,0;9,0;9,0;28,0;4,0;18,0;1,0;;;62,0;133,0;34,0;;19,0;1,0;;33,0;84,0;3,0;;;52,0;15,0;7,0;5,0;;6,0;;10,0;29,0;2,0;3,0;;8,0;3,0;1,0;14,0;38,0;;12,0;20,0;1,0;3,0;4,0;4,0;19,0;86,0;;69,0;17,0;;;5,0;20,0;7,0;1,0;51,0;74,0;1,0;;12,0;3,0;18,0;2,0;1,0;19,0;14,0;29,0;9,0;43,0;9,0;1,0;23,0;3,0;;34,0;;51,0;;13,0;64,0;1,0;32,0;38,0;10,0;18,0;8,0;7,0;1,0;;5,0;2,0;;;2,0;17,0;14,0;161,0;;229,0;1,0;4,0;;8,0;5,0;10,0;;1,0;7,0;;7,0;8,0;;65,0;1,0;6,0;;10,0;10,0;39,0;2,0;2,0;3,0;2,0;1,0;;5,0;19,0;;4,0;3,0;18,0;1,0;;14,0;;28,0;;;3,0;2,0;;6,0;;4,0;10,0;;4,0;83,0;;30,0;1,0;11,0;9,0;2,0;6,0;9,0;13,0;26,0;13,0;27,0;;1,0;25,0;28,0;1,0;8,0;20,0;1,0;4,0;7,0;10,0;13,0;2,0;4,0;;13,0;;5,0;1,0;2,0;10,0;2,0;;5,0;11,0;;;3,0;20,0;7,0;15,0;2,0;2,0;2,0;1,0;13,0;32,0;;21,0;4,0;2,0;21,0;2,0;;7,0;13,0;11,0;;11,0;3,0;1,0;7,0;11,0;;2,0;2,0;4,0;15,0;8,0;10,0;27,0;1,0;4,0;3,0;3,0;;1,0;1,0;4,0;6,0;3,0;5,0;3,0;20,0;12,0;3,0;3,0;4,0;;;1,0;3,0;;;2,0;4,0;1,0;1,0;;2,0;1,0;;;;;;1,0;7,0;1,0;11,0;;10,0;;;;1,0;;;;;;4,0;5,0;10,0;6,0;;4,0;;6,0;;7,0;;14,0;;3,0;;;;18,0;;1,0;;1,0;;;;4,0;;6,0;6,0;;1,0;1,0;5,0;2,0;1,0;4,0;2,0;1,0;3,0;;;;1,0;;;4,0;;;;2,0;3,0;12,0;;37,0;5,0;;8,0;1,0;14,0;2,0;;1,0;2,0;;;;4,0;5,0;;;;;1,0;;;;;2,0;;;;;;2,0;14,0;8,0;;2,0;;;13,0;7,0;;;;;;;;;;;6,0;18,0;13,0;;5,0;;5,0;3,0;5,0;;;1,0;5,0;;;;1,0;;;1,0;1,0;12,0;11,0;2,0;;4,0;;7,0;;;44,0;14,0;;1,0;2,0;;;;;;15,0;4,0;;;1,0;4,0;2,0;;;2,0;2,0;1,0;;;;4,0;;4,0;2,0;3,0;;;;;;;1,0;;2,0;;;;8,0;;;;;5,0;;5,0;14,0;1,0;7,0;1,0;;;2,0;;;;1,0;2,0;6,0;1,0;;2,0;243,0;1,0;;;6,0;;7,0;;;;9,0;;1,0;;12,0;2,0;4,0;;3,0;6,0;;1,0;10,0;;;12,0;1,0;;;;1,0;2,0;;24,0;83,0;4,0;;;11,0;1,0;;;1,0;5,0;2,0;;;5,0;2,0;;4,0;2,0;2,0;;;;;;;;1,0;1,0;;6,0;4,0;6,0;;7,0;3,0;;;36,0;1,0;2,0;;;3,0;1,0;2,0;2,0;4,0;;2,0;;;;;;;;;5,0;;2,0;;;7,0;;2,0;2,0;;;;;1,0;2,0;;;;;;;;;7,0;;2,0;18,0;9,0;3,0;1,0;;39,0;3,0;;;;;;;;4,0;1,0;;14,0;3,0;19,0;12,0;2,0;2,0;3,0;;4,0;;5,0;;18,0;2,0;;3,0;;10,0;;12,0;;;3,0;;;1,0;3,0;;3,0;;2,0;2,0;;;;;;;2,0;1,0;1,0;;2,0;;;;3,0;;;1,0;1,0;;4,0;3,0;;;1,0;1,0;;;;;;;15,0;7,0;2,0;;1,0;;;2,0;;;1,0;1,0;;3,0;;;;2,0;17,0;6,0;8,0;;;;;4,0;;3,0;;;;;;;;;3,0;;;4,0;1,0;1,0;;;;3,0;;;;;13,0;;8,0;;;1,0;;;;;5,0;;1,0;3,0;;;;1,0;4,0;;1,0;1,0;2,0;2,0;;3,0;5,0;;;3,0;4,0;;;2,0;;;1,0;14,0;3,0;;;;;;2,0;1,0;;;1,0;;2,0;1,0;5,0;;2,0;2,0;5,0;;5,0;;2,0;;;1,0;3,0;;1,0;;2,0;;1,0;5,0;2,0;2,0;3,0;;3,0;2,0;;4,0;;;;;;;;;;;;1,0;6,0;4,0;;4,0;;;1,0;;;4,0;;;1,0;;;;4,0;;;1,0;;5,0;;;;7,0;1,0;;;;;;;;;;;;3,0;;;;;3,0;;;;2,0;;5,0;3,0;;;1,0;3,0;27,0;3,0;2,0;2,0;3,0;4,0;1,0;1,0;1,0;;;;;;;;;;;;;;;;;;;;;;;;;;;;;;;;;;;;
adjust;;;98,0;3,0;91,0;;49,0;110,0;40,0;111,0;11,0;68,0;5,0;3,0;141,0;3,0;5,0;2,0;43,0;5,0;56,0;155,0;9,0;19,0;50,0;1,0;9,0;64,0;1,0;39,0;31,0;87,0;273,0;18,0;38,0;;2,0;30,0;2,0;64,0;81,0;1,0;24,0;30,0;2,0;4,0;1,0;44,0;462,0;15,0;61,0;39,0;9,0;10,0;3,0;558,0;96,0;;60,0;276,0;1,0;20,0;203,0;7,0;3,0;10,0;38,0;9,0;2,0;52,0;111,0;17,0;15,0;;1,0;3,0;5,0;55,0;262,0;9,0;;27,0;18,0;;2,0;;40,0;6,0;5,0;18,0;85,0;13,0;37,0;212,0;48,0;9,0;5,0;9,0;18,0;8,0;40,0;183,0;1,0;12,0;;;2,0;358,0;1,0;;15,0;16,0;31,0;44,0;7,0;62,0;3,0;5,0;7,0;15,0;7,0;1,0;13,0;54,0;;9,0;118,0;1,0;20,0;10,0;17,0;1,0;3,0;1,0;2,0;17,0;7,0;;5,0;14,0;6,0;13,0;10,0;20,0;7,0;8,0;14,0;51,0;7,0;;6,0;3,0;6,0;;6,0;11,0;4,0;8,0;27,0;155,0;10,0;12,0;3,0;1,0;1,0;5,0;106,0;138,0;;1,0;37,0;2,0;62,0;57,0;17,0;2,0;4,0;63,0;1,0;;1,0;;6,0;2,0;1,0;8,0;14,0;79,0;;41,0;1,0;1,0;;17,0;;2,0;4,0;;31,0;1,0;1,0;6,0;6,0;21,0;2,0;5,0;15,0;5,0;3,0;38,0;7,0;5,0;8,0;;16,0;156,0;10,0;1,0;2,0;3,0;4,0;8,0;2,0;1,0;2,0;4,0;13,0;;10,0;1,0;2,0;;24,0;4,0;;32,0;1,0;11,0;96,0;23,0;13,0;;29,0;1,0;5,0;8,0;7,0;;4,0;2,0;1,0;;;19,0;5,0;;;8,0;8,0;1,0;;23,0;3,0;1,0;12,0;;6,0;;;;;21,0;;1,0;;6,0;;2,0;5,0;2,0;4,0;;2,0;48,0;;8,0;15,0;67,0;26,0;6,0;12,0;1,0;7,0;4,0;;1,0;1,0;52,0;;;2,0;1,0;36,0;5,0;4,0;;1,0;93,0;5,0;3,0;65,0;11,0;;;28,0;;2,0;;7,0;;;6,0;3,0;14,0;;12,0;4,0;4,0;5,0;1,0;30,0;8,0;4,0;1,0;;;10,0;5,0;2,0;9,0;;12,0;;8,0;14,0;;12,0;9,0;;26,0;5,0;5,0;15,0;5,0;;8,0;;;5,0;;1,0;5,0;;;1,0;2,0;;6,0;4,0;1,0;4,0;1,0;22,0;13,0;5,0;8,0;8,0;5,0;;1,0;18,0;32,0;;9,0;67,0;25,0;9,0;14,0;1,0;5,0;2,0;37,0;10,0;;24,0;57,0;9,0;23,0;35,0;4,0;6,0;;8,0;;1,0;1,0;13,0;81,0;;4,0;6,0;3,0;4,0;8,0;;4,0;16,0;;43,0;11,0;19,0;;;7,0;28,0;5,0;15,0;3,0;20,0;29,0;;;5,0;5,0;5,0;;9,0;2,0;9,0;14,0;1,0;;;4,0;2,0;82,0;7,0;5,0;;6,0;;17,0;35,0;72,0;;;;;16,0;;5,0;;;18,0;4,0;24,0;9,0;4,0;100,0;;;68,0;3,0;;;1,0;20,0;;14,0;2,0;3,0;;;8,0;;22,0;15,0;3,0;1,0;142,0;3,0;12,0;69,0;4,0;47,0;62,0;14,0;54,0;6,0;;;1,0;;6,0;59,0;2,0;;1,0;;;;;;8,0;4,0;3,0;;3,0;;2,0;;;4,0;1,0;;8,0;8,0;1,0;3,0;4,0;;;1,0;;;56,0;;8,0;;;;8,0;;8,0;;10,0;13,0;2,0;;13,0;7,0;4,0;;;6,0;;22,0;2,0;;43,0;97,0;2,0;;;;7,0;45,0;;;5,0;5,0;;2,0;;;;4,0;1,0;;;1,0;1,0;50,0;4,0;1,0;19,0;3,0;;11,0;16,0;4,0;;1,0;;;;;;;;;;193,0;2,0;;;;1,0;;;2,0;8,0;;;;1,0;1,0;;;2,0;2,0;;77,0;1,0;;1,0;1,0;;2,0;1,0;;2,0;27,0;156,0;3,0;;13,0;1,0;6,0;;1,0;1,0;1,0;;;;;;;;10,0;;;;;;1,0;;7,0;1,0;30,0;;;1,0;;;;1,0;;;14,0;;5,0;6,0;3,0;;1,0;14,0;;;2,0;;13,0;23,0;2,0;;;5,0;8,0;1,0;;4,0;1,0;;19,0;;;6,0;13,0;;1,0;2,0;;2,0;4,0;;;;3,0;14,0;;;5,0;9,0;;8,0;1,0;8,0;4,0;;10,0;4,0;2,0;3,0;;6,0;8,0;;;14,0;18,0;34,0;5,0;;3,0;4,0;;;;;33,0;2,0;;151,0;;3,0;1,0;22,0;;;;2,0;12,0;3,0;6,0;;2,0;5,0;7,0;13,0;9,0;5,0;6,0;1,0;5,0;;;5,0;7,0;6,0;19,0;5,0;6,0;1,0;4,0;6,0;14,0;6,0;3,0;2,0;;;2,0;1,0;2,0;;25,0;1,0;;;2,0;;;2,0;1,0;4,0;;;;6,0;;;1,0;3,0;5,0;1,0;;6,0;2,0;3,0;6,0;;1,0;4,0;;4,0;2,0;;;;;;3,0;1,0;7,0;5,0;;2,0;7,0;;3,0;9,0;6,0;3,0;6,0;1,0;1,0;;;;;;2,0;;3,0;36,0;4,0;4,0;;8,0;1,0;;;;4,0;;3,0;2,0;8,0;;27,0;;;;4,0;;4,0;4,0;5,0;1,0;;;1,0;;1,0;;23,0;1,0;;14,0;;;;1,0;5,0;;;;6,0;;1,0;;;4,0;1,0;;8,0;;;22,0;9,0;5,0;2,0;1,0;;;1,0;;;2,0;;1,0;;8,0;;2,0;;;1,0;;;6,0;;1,0;;;5,0;14,0;;3,0;1,0;11,0;;;33,0;;;;;;;;1,0;9,0;;;;4,0;;;;;;;;;1,0;;1,0;;;;;;4,0;2,0;3,0;3,0;1,0;23,0;4,0;2,0;1,0;2,0;1,0;;;;;;;;;;;;;;;;;;;;;;;;;
adjustment;;;50,0;2,0;35,0;;16,0;159,0;33,0;57,0;5,0;5,0;;22,0;132,0;5,0;;1,0;3,0;3,0;69,0;175,0;;7,0;21,0;5,0;1,0;46,0;2,0;33,0;31,0;77,0;200,0;2,0;34,0;1,0;;30,0;2,0;23,0;40,0;;32,0;34,0;2,0;9,0;;94,0;379,0;1,0;22,0;12,0;;2,0;2,0;206,0;54,0;;27,0;95,0;1,0;3,0;88,0;;8,0;1,0;7,0;1,0;2,0;57,0;82,0;4,0;26,0;;2,0;23,0;;31,0;101,0;;1,0;17,0;9,0;7,0;;;25,0;4,0;14,0;2,0;15,0;8,0;14,0;115,0;4,0;4,0;;8,0;9,0;;35,0;107,0;1,0;11,0;2,0;;2,0;252,0;;;9,0;7,0;3,0;8,0;2,0;123,0;;;2,0;5,0;4,0;3,0;5,0;62,0;;;29,0;;12,0;15,0;20,0;;;;;17,0;4,0;;;2,0;;;2,0;;;3,0;11,0;27,0;;;2,0;2,0;1,0;;2,0;2,0;30,0;10,0;6,0;71,0;;3,0;2,0;1,0;10,0;;20,0;59,0;;1,0;3,0;;5,0;25,0;9,0;1,0;7,0;53,0;;;3,0;;3,0;2,0;;8,0;2,0;49,0;;30,0;;3,0;;13,0;;2,0;;;5,0;4,0;5,0;3,0;4,0;9,0;;;5,0;;7,0;34,0;;;1,0;;14,0;81,0;7,0;;;2,0;7,0;;;;2,0;;1,0;;1,0;;2,0;;2,0;2,0;156,0;17,0;;5,0;53,0;19,0;3,0;3,0;6,0;4,0;;8,0;2,0;;10,0;;2,0;;;23,0;;;;13,0;8,0;2,0;;9,0;1,0;;9,0;;12,0;;;;;8,0;;4,0;5,0;1,0;;;1,0;3,0;3,0;;2,0;154,0;;2,0;4,0;13,0;6,0;1,0;3,0;;;;;1,0;1,0;23,0;;23,0;;;20,0;4,0;20,0;3,0;1,0;54,0;2,0;;19,0;6,0;;;82,0;;1,0;;53,0;;2,0;24,0;1,0;2,0;;;;;4,0;;13,0;6,0;;;;;7,0;;;;;29,0;;11,0;3,0;;2,0;5,0;;9,0;4,0;21,0;4,0;;4,0;;;;6,0;;2,0;;;;5,0;18,0;;;1,0;;27,0;;;1,0;3,0;12,0;4,0;2,0;;2,0;4,0;5,0;;3,0;51,0;33,0;2,0;5,0;;2,0;1,0;20,0;3,0;;2,0;1,0;20,0;15,0;14,0;2,0;3,0;;7,0;3,0;;;3,0;26,0;;;8,0;10,0;;2,0;;;;;9,0;5,0;1,0;4,0;;1,0;4,0;;5,0;8,0;1,0;12,0;2,0;1,0;1,0;;;7,0;6,0;1,0;3,0;;1,0;;;;;26,0;3,0;;;;;57,0;8,0;20,0;;;;;17,0;;6,0;;;2,0;;18,0;13,0;1,0;23,0;;;124,0;;;1,0;7,0;4,0;;;;;3,0;;2,0;;10,0;2,0;3,0;;20,0;1,0;8,0;30,0;;16,0;13,0;1,0;2,0;;;;;;;27,0;2,0;;2,0;1,0;4,0;14,0;1,0;;;1,0;;;;;16,0;;1,0;2,0;;;2,0;3,0;;3,0;2,0;;1,0;1,0;;;11,0;;;;;;7,0;;17,0;;;1,0;2,0;;;3,0;;;;1,0;;4,0;;7,0;25,0;67,0;;;;1,0;;8,0;;;;;7,0;;;;;;;;;;1,0;24,0;6,0;;2,0;18,0;;2,0;12,0;;;;;;;1,0;;;;;;79,0;1,0;5,0;;6,0;;2,0;;;11,0;;;;;3,0;1,0;;5,0;5,0;;35,0;;;;2,0;2,0;;1,0;;;20,0;;1,0;;4,0;;9,0;;;3,0;;;;;;;;;;;;;;;;;2,0;;5,0;;;;;;;;;;;;3,0;;5,0;1,0;;5,0;;;2,0;;3,0;8,0;3,0;;;4,0;2,0;;;1,0;;;1,0;;;1,0;2,0;;4,0;;;1,0;2,0;1,0;;;;7,0;;;4,0;3,0;;1,0;;9,0;11,0;;;;;;;;;;;;26,0;22,0;3,0;1,0;5,0;;1,0;;1,0;1,0;5,0;1,0;;170,0;;2,0;6,0;20,0;10,0;;;9,0;1,0;1,0;1,0;;1,0;;;10,0;16,0;;;5,0;6,0;;;;8,0;4,0;14,0;;2,0;;;16,0;17,0;;21,0;;;;4,0;;;;6,0;;;;;;;;;2,0;1,0;;;;;;;;;2,0;;1,0;;;10,0;;;;;;;;2,0;;1,0;;2,0;;;;;5,0;3,0;;1,0;6,0;5,0;1,0;;;8,0;;3,0;3,0;;;;1,0;;;;;;9,0;;1,0;;;6,0;1,0;18,0;;;;;;;;;;;;;1,0;;;3,0;;;1,0;;;;;;;2,0;3,0;1,0;;;;;;;;;1,0;;;;;2,0;1,0;;;4,0;;;;9,0;;;;;;;;;;;;1,0;;;3,0;;;;4,0;3,0;;3,0;1,0;7,0;;;;;;1,0;;;;;;;;;5,0;;;;;;;;;;;;;;2,0;1,0;;;;;;;;;4,0;;;2,0;;16,0;;;2,0;2,0;;;;;;;;;;;;;;;;;;;;;
align;;;2,0;1,0;20,0;;106,0;38,0;1,0;19,0;40,0;2,0;2,0;;12,0;;1,0;;15,0;3,0;;6,0;12,0;4,0;;1,0;1,0;40,0;9,0;1,0;3,0;20,0;25,0;7,0;7,0;1,0;;83,0;9,0;18,0;7,0;1,0;;9,0;;;;4,0;20,0;1,0;;4,0;;7,0;;180,0;15,0;;5,0;194,0;3,0;;63,0;;13,0;1,0;2,0;3,0;;;72,0;8,0;3,0;;2,0;;;49,0;51,0;;;4,0;3,0;3,0;;;17,0;2,0;;5,0;40,0;;;13,0;;8,0;1,0;1,0;1,0;10,0;17,0;23,0;;2,0;;3,0;;20,0;;;7,0;8,0;11,0;25,0;1,0;;2,0;1,0;6,0;21,0;9,0;;;6,0;;;25,0;7,0;3,0;1,0;12,0;;30,0;2,0;;14,0;18,0;;;;;;1,0;7,0;3,0;;33,0;45,0;1,0;14,0;;6,0;7,0;;2,0;3,0;65,0;22,0;2,0;21,0;;1,0;5,0;4,0;6,0;3,0;4,0;22,0;;;6,0;2,0;26,0;22,0;3,0;28,0;2,0;4,0;;;;;3,0;;3,0;19,0;7,0;44,0;;27,0;;2,0;;14,0;;1,0;;;12,0;11,0;1,0;6,0;;9,0;1,0;;5,0;;4,0;23,0;7,0;;;;;5,0;3,0;12,0;;1,0;2,0;;;13,0;4,0;2,0;8,0;;3,0;;2,0;3,0;2,0;;6,0;10,0;;1,0;14,0;;9,0;;19,0;5,0;3,0;;1,0;2,0;11,0;3,0;1,0;;;2,0;2,0;;3,0;24,0;8,0;3,0;;;18,0;;2,0;6,0;9,0;2,0;1,0;;1,0;6,0;;2,0;6,0;;2,0;;1,0;4,0;1,0;5,0;;7,0;;4,0;;18,0;;3,0;6,0;1,0;;;;7,0;1,0;4,0;;7,0;;;14,0;2,0;11,0;;3,0;1,0;;3,0;31,0;7,0;;11,0;2,0;;;;3,0;1,0;;2,0;3,0;2,0;;7,0;19,0;;;;7,0;;1,0;;6,0;;;;;;2,0;3,0;;1,0;1,0;;;1,0;3,0;;4,0;;3,0;;;;;2,0;;;;;;;;2,0;;;;17,0;;;;;2,0;4,0;3,0;;;15,0;;3,0;;1,0;;;;;;;;;5,0;;13,0;;1,0;10,0;;;3,0;1,0;;;;;13,0;1,0;;;;4,0;3,0;6,0;;;7,0;1,0;3,0;3,0;7,0;;;2,0;1,0;;;;;;2,0;2,0;;;;;;;;;;;;;1,0;;;;;3,0;;;9,0;8,0;;;;;;;;;;;;;7,0;;6,0;;;3,0;;;;1,0;9,0;;;;;;;;;9,0;8,0;;;2,0;;;;5,0;33,0;13,0;2,0;1,0;;;2,0;;2,0;;11,0;1,0;;;;;3,0;;;;;;;;;;;;;;;2,0;;1,0;3,0;1,0;;;2,0;7,0;;;;2,0;;;;8,0;;1,0;;;;1,0;;;;5,0;;;;8,0;3,0;;3,0;9,0;25,0;;;;;;5,0;;;;2,0;4,0;;;;;6,0;;3,0;11,0;;;2,0;;;;1,0;;;;;;;2,0;;;;;;;;;;;;;;;;1,0;4,0;7,0;;;;;;;;;;;;5,0;;;;;;;;;;8,0;16,0;1,0;7,0;18,0;10,0;;;1,0;;6,0;;;;;2,0;;;3,0;;;1,0;;2,0;2,0;7,0;;;;;3,0;2,0;3,0;;1,0;3,0;11,0;;;;3,0;2,0;;14,0;;;;;;;4,0;7,0;;;1,0;;;;5,0;;;;;;12,0;17,0;;3,0;;;2,0;;2,0;;;;4,0;;1,0;;5,0;1,0;;;;;2,0;27,0;;1,0;;;;;;;;;;1,0;;;3,0;;;;;;2,0;;;;3,0;2,0;;;;;2,0;;;;1,0;;;;4,0;;3,0;;;;1,0;2,0;;;;;;;2,0;;6,0;;4,0;;;;1,0;;;;;;;;;;;;2,0;1,0;;;6,0;;;;;;;;;;3,0;;1,0;2,0;;;14,0;;;;2,0;;;;;;;;1,0;;;1,0;1,0;4,0;7,0;4,0;1,0;1,0;;;;2,0;;;;1,0;;;2,0;3,0;2,0;;;;;;1,0;3,0;;;3,0;;;;;1,0;;;2,0;;1,0;;;;1,0;;;2,0;;6,0;;;3,0;1,0;;2,0;2,0;;;;2,0;;;;2,0;;;;;;;;;;;;;;;1,0;1,0;;1,0;10,0;;2,0;2,0;;;;;;;1,0;5,0;;;;;1,0;;;;;;2,0;1,0;;;5,0;;;3,0;;;;;;;;4,0;;;;;;;;;;;;2,0;1,0;;;1,0;;;;;;;2,0;1,0;;;;;20,0;;;;;;;;;;;;;;;;;;;;;;;
alignment;;;21,0;;7,0;;70,0;38,0;;1,0;5,0;4,0;;;;;;;3,0;1,0;7,0;9,0;10,0;3,0;5,0;;;10,0;3,0;21,0;19,0;22,0;16,0;26,0;5,0;;7,0;2,0;;17,0;18,0;;2,0;14,0;;;;;3,0;18,0;4,0;7,0;;11,0;;117,0;34,0;3,0;;68,0;2,0;2,0;30,0;;1,0;;11,0;;;;65,0;8,0;1,0;;;;;23,0;33,0;;;1,0;4,0;;1,0;;4,0;1,0;6,0;8,0;50,0;;;4,0;;2,0;2,0;;6,0;2,0;10,0;109,0;;;;;1,0;49,0;;;;11,0;7,0;29,0;3,0;;;;3,0;1,0;;;;;;;19,0;2,0;;8,0;;1,0;3,0;;;6,0;3,0;;;2,0;;;;2,0;8,0;;37,0;1,0;2,0;;;;9,0;;1,0;1,0;4,0;4,0;11,0;11,0;;;;;2,0;1,0;;15,0;;;4,0;1,0;4,0;12,0;2,0;2,0;;2,0;;;;3,0;;3,0;;6,0;35,0;22,0;;;;;4,0;6,0;;1,0;;;2,0;;2,0;4,0;;1,0;2,0;;;;2,0;2,0;17,0;3,0;;;;9,0;1,0;3,0;;3,0;;3,0;;;1,0;;5,0;;1,0;;1,0;1,0;5,0;;3,0;4,0;1,0;;2,0;;3,0;;;;;;2,0;;;;;;;;;;;6,0;2,0;5,0;;2,0;3,0;;;1,0;;1,0;;1,0;;1,0;;;5,0;;;;;12,0;1,0;;2,0;5,0;;1,0;2,0;13,0;4,0;;;;;1,0;;1,0;1,0;29,0;4,0;;;;8,0;7,0;8,0;;;13,0;;;17,0;6,0;;;2,0;;;;;;;1,0;;1,0;;4,0;1,0;;;1,0;11,0;8,0;4,0;;;;2,0;;;;;2,0;;;;;;;1,0;9,0;;;;;;;3,0;21,0;;;;;;;;12,0;1,0;;;;;;;5,0;5,0;7,0;1,0;;;1,0;1,0;;;;;;;;;2,0;;1,0;3,0;;1,0;;;43,0;;1,0;9,0;;;3,0;;;7,0;;;1,0;16,0;;;;;;11,0;;3,0;12,0;9,0;;;;13,0;;;1,0;;2,0;;;;1,0;;;;;;;;;;;;4,0;;;1,0;;;6,0;;;;;;;;;;;;;;1,0;;;9,0;;;8,0;;;;;13,0;;;1,0;;;;;;1,0;5,0;;;;;5,0;;5,0;2,0;17,0;;;;;;;;;1,0;2,0;;3,0;;;1,0;;;;;;;;;;;;;;;;5,0;;1,0;;;1,0;;;;;;;;;;2,0;;;;;;1,0;;;2,0;;;;;;3,0;;9,0;;19,0;;1,0;;;4,0;15,0;;;;;;;;;;5,0;2,0;;2,0;3,0;;18,0;;2,0;;;;;1,0;1,0;1,0;;8,0;2,0;;;;;;;3,0;;;;2,0;;;;;3,0;;4,0;;;;3,0;;1,0;1,0;;;;;;;;;;;;;;1,0;;;16,0;2,0;;1,0;;;;;;;1,0;;;;12,0;1,0;;;;;;;;;;;;2,0;;;;;1,0;1,0;;;;;2,0;38,0;3,0;;;;;;2,0;;8,0;;;;;;;;;;;;;3,0;;;;;27,0;;;;;;;1,0;;;;3,0;2,0;;;3,0;;;3,0;;;;;2,0;1,0;;;;20,0;;4,0;;;;;;;;;1,0;;1,0;;;;;11,0;;2,0;;;;;3,0;3,0;;;;;19,0;2,0;;;;;;;;;2,0;2,0;19,0;;3,0;;5,0;4,0;;;;;;;;;;;;;;;;;;;;;;;;;;;;;;7,0;;;;;;;;;;;;;;1,0;;;;3,0;;;12,0;;2,0;3,0;2,0;;;;;1,0;;;;;;;1,0;;;;;;;1,0;;;;2,0;1,0;;3,0;;;;;;2,0;;;;;;;;;;;2,0;;;;;;;;;;;;;;;;;;;;;;;;;;;;;;;;;;31,0;9,0;;;;;4,0;;;;;;;;;;;4,0;;;;13,0;;;;;;;;3,0;;;;;;;;;3,0;;;;;;;;;;;;;;1,0;13,0;;;;;;;;;;;;;2,0;;;;;;;;3,0;9,0;;;;;;;;;;;;;;
allow;;;3,0;1,0;18,0;;21,0;17,0;;31,0;2,0;6,0;;;6,0;1,0;3,0;5,0;9,0;7,0;6,0;139,0;2,0;4,0;5,0;;;39,0;;1,0;5,0;3,0;52,0;;38,0;3,0;1,0;18,0;;51,0;4,0;;3,0;21,0;;;;8,0;14,0;;11,0;5,0;1,0;11,0;2,0;186,0;32,0;;6,0;103,0;3,0;2,0;31,0;3,0;;9,0;4,0;1,0;;20,0;39,0;3,0;22,0;1,0;;13,0;1,0;11,0;54,0;5,0;3,0;6,0;2,0;;;2,0;11,0;3,0;;63,0;18,0;1,0;18,0;7,0;6,0;5,0;;7,0;11,0;6,0;23,0;51,0;;3,0;;;13,0;42,0;;;17,0;9,0;5,0;15,0;6,0;9,0;2,0;1,0;5,0;41,0;;1,0;1,0;42,0;;;70,0;12,0;;15,0;21,0;1,0;3,0;13,0;1,0;2,0;2,0;3,0;;11,0;;3,0;16,0;30,0;3,0;11,0;18,0;30,0;1,0;1,0;;3,0;3,0;;11,0;8,0;21,0;38,0;6,0;5,0;4,0;11,0;5,0;2,0;;13,0;7,0;162,0;5,0;3,0;50,0;13,0;22,0;33,0;37,0;40,0;3,0;21,0;;;3,0;4,0;68,0;;6,0;1,0;29,0;14,0;;82,0;1,0;6,0;11,0;19,0;1,0;10,0;;6,0;23,0;4,0;1,0;6,0;3,0;7,0;2,0;1,0;;2,0;11,0;15,0;;4,0;9,0;;20,0;15,0;15,0;14,0;1,0;;4,0;6,0;;10,0;5,0;10,0;10,0;;1,0;;2,0;;6,0;2,0;3,0;;;8,0;15,0;8,0;7,0;;2,0;3,0;6,0;4,0;7,0;4,0;;;;2,0;4,0;12,0;;;4,0;26,0;5,0;;5,0;3,0;5,0;6,0;8,0;6,0;10,0;1,0;1,0;2,0;6,0;7,0;1,0;;6,0;25,0;;6,0;4,0;;5,0;6,0;6,0;25,0;2,0;10,0;31,0;30,0;43,0;2,0;;;2,0;1,0;;2,0;3,0;12,0;;1,0;2,0;2,0;15,0;1,0;;1,0;5,0;13,0;3,0;;3,0;3,0;3,0;8,0;6,0;;8,0;;1,0;4,0;;3,0;11,0;5,0;;3,0;;4,0;3,0;;200,0;;1,0;;1,0;;;;;;2,0;7,0;1,0;;;3,0;2,0;1,0;1,0;7,0;15,0;2,0;;;;;;;;;;2,0;7,0;5,0;2,0;5,0;1,0;3,0;;2,0;;;;2,0;5,0;10,0;6,0;;;;2,0;2,0;1,0;7,0;;1,0;2,0;;1,0;23,0;10,0;;8,0;1,0;11,0;2,0;8,0;3,0;2,0;1,0;3,0;;1,0;3,0;;;8,0;10,0;2,0;5,0;4,0;;2,0;1,0;4,0;8,0;1,0;;13,0;;10,0;11,0;;13,0;18,0;2,0;3,0;1,0;2,0;10,0;1,0;2,0;1,0;;1,0;2,0;1,0;;3,0;3,0;15,0;;;2,0;4,0;25,0;;1,0;6,0;2,0;;8,0;7,0;4,0;;1,0;5,0;;14,0;1,0;;1,0;;1,0;4,0;12,0;9,0;8,0;4,0;2,0;;29,0;8,0;;2,0;1,0;27,0;;2,0;10,0;2,0;1,0;;;;23,0;4,0;24,0;4,0;9,0;;7,0;1,0;3,0;25,0;42,0;4,0;5,0;2,0;;8,0;;1,0;;25,0;10,0;1,0;3,0;;1,0;1,0;;1,0;6,0;16,0;2,0;7,0;10,0;2,0;;1,0;8,0;;10,0;6,0;;;;;25,0;13,0;;4,0;;1,0;;12,0;;;1,0;;;;3,0;6,0;1,0;6,0;1,0;;1,0;2,0;;;;5,0;2,0;8,0;;;5,0;9,0;;2,0;;;1,0;12,0;;;1,0;4,0;3,0;;1,0;2,0;1,0;10,0;;;1,0;1,0;;25,0;3,0;;10,0;3,0;;;;4,0;5,0;;3,0;;4,0;1,0;;;2,0;1,0;;10,0;;2,0;;13,0;;;1,0;1,0;2,0;;;;;7,0;1,0;1,0;;;2,0;1,0;2,0;1,0;1,0;;2,0;20,0;1,0;;1,0;12,0;10,0;;13,0;5,0;;5,0;;3,0;2,0;;1,0;;;;2,0;1,0;1,0;6,0;2,0;;6,0;1,0;5,0;1,0;;4,0;2,0;2,0;7,0;;;4,0;5,0;;;;;;;2,0;5,0;1,0;;;15,0;1,0;;;;;1,0;5,0;;4,0;;;;;4,0;;;;;4,0;1,0;3,0;3,0;;;;6,0;2,0;;;;2,0;1,0;;;2,0;1,0;;;;;;6,0;7,0;;1,0;;;4,0;1,0;;2,0;;2,0;1,0;;1,0;;1,0;1,0;;;;1,0;;1,0;1,0;;1,0;;;1,0;;;2,0;1,0;4,0;1,0;;;1,0;13,0;2,0;;;1,0;2,0;4,0;;;;1,0;;4,0;;;1,0;1,0;4,0;;7,0;8,0;;;;;2,0;;;;7,0;;;;;;46,0;5,0;;;;;3,0;;3,0;;;;;;;;;2,0;3,0;;9,0;;1,0;;;4,0;1,0;;;1,0;;3,0;4,0;1,0;;4,0;;;7,0;2,0;1,0;1,0;1,0;;;1,0;;1,0;;;2,0;17,0;;;1,0;;5,0;12,0;;;;;;;;;3,0;2,0;;;;2,0;;;;;;1,0;;;;;;5,0;;;;;;;;;;3,0;;1,0;1,0;;;;1,0;1,0;9,0;3,0;;;;;;1,0;;;;1,0;;;;;1,0;;5,0;;1,0;1,0;;;;;;;;1,0;4,0;1,0;1,0;1,0;;2,0;;;;;1,0;;;;;;;1,0;;;;;;;3,0;;;3,0;;;;;;;;;;;;;;;1,0;;;;;;;;;;;;;2,0;;;;;;4,0;3,0;;;;;;;;;;;;
amplify;;;1,0;;;;;20,0;;;;;;;2,0;;2,0;;;;;12,0;;;2,0;;;13,0;1,0;4,0;4,0;1,0;24,0;;4,0;;;1,0;;;1,0;;6,0;40,0;;;;;;2,0;1,0;26,0;;;;39,0;33,0;;;6,0;;;4,0;;;1,0;;;;33,0;2,0;4,0;;4,0;;;;;2,0;3,0;;;;3,0;;2,0;37,0;;12,0;5,0;8,0;;;141,0;;;;1,0;4,0;;;1,0;;17,0;1,0;;16,0;101,0;;;;8,0;2,0;;;;;;;;;;;19,0;;;15,0;;;8,0;;;;;;3,0;;;22,0;;;;2,0;;4,0;3,0;2,0;;;;;;;;11,0;;;;;9,0;2,0;;;;;1,0;5,0;8,0;;;;;;;;;;46,0;;;;;1,0;;;;;10,0;;12,0;;;4,0;6,0;;;;;;;8,0;2,0;;;;;;;;;;;2,0;;;6,0;1,0;;;;;;2,0;;;1,0;;;;;;;;;;;;5,0;;;2,0;;;;;;2,0;1,0;;;22,0;;;32,0;3,0;;;;;;;;;;3,0;;2,0;;;;;;;2,0;;;;;;;;;;6,0;;;;4,0;1,0;8,0;;;;2,0;;;26,0;;;;;;;;;;;1,0;;;1,0;2,0;;;;;;;;;;;;;;24,0;;;3,0;;;;;;;19,0;;;;;;2,0;;;;;;;;;;;;;;;;;;;;;;3,0;;8,0;;;;;;;;;;9,0;;9,0;;;;11,0;;;4,0;;1,0;;;;;;;;6,0;;;;10,0;;;;;;;;;;;;;;30,0;;;;;;9,0;;;;;;1,0;;;;;8,0;;;;;;;17,0;;3,0;;;;;;;;29,0;9,0;;;;;1,0;8,0;;;;;;;;1,0;;;;;;;1,0;;;1,0;;;1,0;;;;;;;;;;;;;1,0;;1,0;;2,0;;;1,0;;;70,0;;4,0;;;;;;;;;;;;;;;;;;;;;;;;;;;3,0;;;;;;6,0;;;14,0;;;;;;2,0;;;;;;;;;;;;;;;2,0;;;;26,0;10,0;;;;;;;;;;;;;;;;;;;;;;1,0;;;;;;;;;;;10,0;25,0;;;1,0;;;;3,0;;;;;;;;;;;;;;;;;;14,0;;3,0;2,0;;;;;;;;4,0;;;;;;3,0;;;;;;;;;;4,0;;;1,0;2,0;;;;;;;2,0;;;;;;;17,0;;;;;;;;;4,0;4,0;;;3,0;;51,0;;;3,0;;19,0;13,0;;;13,0;;6,0;;;1,0;15,0;45,0;1,0;;;;1,0;18,0;;;;9,0;;;;;;;;;;168,0;;;;;;;;;;;;;;;;;;;;;;;;;;;1,0;;;;1,0;;;;;;;;;;7,0;;;;;;;;;;2,0;;;1,0;;;;;;7,0;;;;;;;;;;;;;;;;;;;;;;1,0;;;;;;;;;;;;;;;;;1,0;;;;;;;1,0;;;;;;;;;;;;;;;;;;;;;;;;13,0;;;;;;;;;;;;;;17,0;;;;;;;;2,0;;;;;;;;;;;;;;;;;2,0;;;;;;;;;;;;;;;;;;;;;;;;;;;;;;;;;;;;;;;;;;;;;;;;;;;;;;;;;;;;;;;;;;;;;;;;;;;;;;;;;;;;;;;;;;;;;;;;;;;;;;;;;;;;;;;;;;
amplitude;;;2,0;1,0;1,0;;;5,0;3,0;;;;;1,0;;;;;1,0;;;4,0;;1,0;;;2,0;;;;5,0;13,0;;3,0;;;;;;;2,0;;2,0;3,0;;;;;;19,0;2,0;2,0;;2,0;;9,0;12,0;;;1,0;;;10,0;3,0;;3,0;1,0;;;;1,0;1,0;;;;;;;;;;1,0;5,0;;;;;6,0;5,0;;6,0;;;19,0;;;;;;;;3,0;;;;;2,0;10,0;;;;;16,0;;;4,0;;;;;;;;;;;1,0;;;5,0;;;;;;;;;;;;12,0;;;4,0;;;;;;17,0;;;;1,0;;;;;3,0;;;;;;;1,0;;;;;;3,0;;6,0;;;11,0;;;;6,0;3,0;;;;;13,0;;1,0;;;;2,0;;;;;;;;17,0;;;;4,0;;;;;;;;;;3,0;2,0;;;;;;8,0;;;;;;;;;;;;14,0;;;4,0;;;;;;1,0;;;;;;;2,0;;;1,0;;;;;;;;;;;;;;;;;;;;;;2,0;;;6,0;;;;;;;10,0;;1,0;;2,0;;;;18,0;;;;;;;;;16,0;;;;;29,0;;;4,0;1,0;;;;;;;;;;;;;2,0;;;;;;;;;;;;2,0;;;;;;;2,0;;;;;;16,0;;;4,0;;;;;;;;7,0;1,0;;;;;;;;;3,0;;;2,0;;;;16,0;;;;;;;1,0;;;1,0;;;;;;;;;;;14,0;;;;;5,0;;;;;;;;;;;;;;;;;;;;1,0;;;;;;1,0;;;;;;;5,0;;1,0;2,0;;;;1,0;;5,0;;1,0;;;;;;4,0;;;;;;;;;;6,0;;;;;;;;;;;1,0;;;;;;;;;;;;;;;;;;1,0;;;;;3,0;;;;;;;;;;;;;;;;;;;;;;;;;;;;;;;;;;;;;;9,0;;;;;;;;;;;;;;;;;;;;;;;;4,0;29,0;;;;;;;;;;;;;;;;;;;;;;;;;1,0;;;;;;;;;13,0;;;;;;;;;;;;;;;;;;;;;;;;;;;;;;;;;;;;;;;;;;;;;;;;;;;;;;;;;;;;;;;;3,0;;;;;;;;;;;;;;;;;;;;;1,0;;;13,0;3,0;;;;;;;;;2,0;1,0;2,0;;;;1,0;;;1,0;;;;;;3,0;;;;;1,0;;;;;;;;;;;;;;;;;;4,0;;;;;;;;;;;;;12,0;;;;2,0;;;;;;;;;;;;;;3,0;1,0;;2,0;;;;;;;;;;;;;;;;;;;;;;;;;;;;;;;;;;;;;;;;;;;;;;;;;;;;;;;;1,0;;;;;;;;;;;;1,0;;;;;;;;;;1,0;;;;;;;;;;;;;;;;;;;;;;;;;;;;;;;;;;;;;;;;;;;;;;;;;;;;;;;;;;;;;;;;;;;;;;;;;;;;;;;;;;;;;;;;;;;;;;;;;;;;;;;;;;;;;;;;;;;;;;;;;;1,0;;;;;;;;;;;;;;;;;;;;;;;;;;;;;;;;;;;
analog;;;2,0;;3,0;;;25,0;1,0;8,0;;;;;4,0;1,0;;;;;2,0;23,0;;;2,0;;;54,0;;17,0;6,0;11,0;22,0;5,0;138,0;;;2,0;;3,0;;;1,0;16,0;;;;;;;;28,0;5,0;6,0;;102,0;23,0;;1,0;1,0;;;8,0;1,0;;1,0;;;;6,0;5,0;;;;;;;1,0;1,0;1,0;;21,0;16,0;1,0;;;10,0;2,0;6,0;8,0;22,0;3,0;5,0;673,0;;2,0;;1,0;7,0;3,0;;23,0;;2,0;;;1,0;83,0;;;4,0;;16,0;;;;;;;;;;5,0;21,0;;;34,0;;;7,0;;;;;;1,0;3,0;;;3,0;;1,0;4,0;;2,0;;5,0;1,0;3,0;;;;;;11,0;;;;;149,0;4,0;;;;;2,0;48,0;7,0;;;;;1,0;;;;;98,0;;;;;1,0;;;1,0;;26,0;;14,0;;;;30,0;;1,0;;;3,0;;;;;;;;1,0;;;;1,0;;1,0;;;9,0;6,0;;;;1,0;1,0;;;;;8,0;;;;;;;;9,0;1,0;;11,0;;;2,0;;;;1,0;;3,0;1,0;;;26,0;;;8,0;;;;2,0;;;;;;;;;;;;;;8,0;;8,0;;7,0;;;;2,0;;;;;;11,0;;1,0;1,0;;;;1,0;;;;;;;;;;;;;;;7,0;;;44,0;9,0;;;;;;;;;;2,0;;;;11,0;;;5,0;;2,0;;;;;1,0;1,0;;;;;3,0;;;;;;1,0;;6,0;;1,0;2,0;;;;;;;;10,0;;;;;6,0;;;1,0;1,0;2,0;;13,0;;;26,0;;1,0;;1,0;27,0;3,0;;;18,0;6,0;1,0;;;;;8,0;;;;1,0;;;;;;;;;;;;1,0;1,0;2,0;;1,0;;5,0;;;;;35,0;;1,0;;;;8,0;;;11,0;3,0;5,0;;;;;4,0;;;;16,0;;;;3,0;3,0;;6,0;38,0;105,0;;;;1,0;;2,0;;10,0;;;;;;;;1,0;;4,0;;;1,0;;;15,0;;;;;;;;;4,0;;;;;;1,0;;;;1,0;1,0;;;106,0;3,0;1,0;60,0;1,0;;;;;;;;;;;;;;;;4,0;;6,0;;;1,0;;;6,0;;;;7,0;;;;1,0;;;;;8,0;;;;;;2,0;;;;;5,0;;;1,0;;;;;10,0;;;;;2,0;99,0;;;;;;1,0;;;;;;;;;;;;;;;3,0;11,0;;;;;;;;2,0;;;;26,0;11,0;;;6,0;;1,0;;4,0;;;;;;;;;;;;;;10,0;;;;6,0;;;;;;;;;;;;;6,0;;;;;;;;;;;;;;;;;;;;;;;;7,0;;;;;;;;;;;;;;;;;;;;;;;9,0;17,0;;2,0;;12,0;;2,0;3,0;;;38,0;;;;;;;1,0;1,0;;;;;;;;;;5,0;;;;2,0;1,0;;1,0;;;;;;;9,0;6,0;;;;;5,0;2,0;13,0;12,0;;8,0;;;;;;1,0;;;21,0;;1,0;2,0;23,0;;;;;;;;;;1,0;;;;1,0;;;2,0;;;81,0;;1,0;;;;;;2,0;2,0;;;;;;;;1,0;;;;;;;;;;;;;;;;;;;;;;;;;;;;;1,0;;;;;;;1,0;3,0;;;;;;;;;;;;;;;;3,0;1,0;;;;;;;;;2,0;;;;1,0;;14,0;;;;;;;;;;;;;;;8,0;;;;;;;;;;;;;;;;;;;;;1,0;;;;4,0;3,0;;3,0;;;;1,0;;;;;;;;;;;;;;;;;;;;;1,0;;;4,0;2,0;;1,0;;;;;;;;;2,0;;;;;;;2,0;;;;;;;;2,0;;;;;;;;;;;;;;;;1,0;;11,0;;8,0;;;;;;;;;;;;;;;;;;;;;;;;;;;;
angle;;;24,0;;55,0;;191,0;131,0;177,0;81,0;35,0;;;;;5,0;19,0;1,0;4,0;3,0;7,0;79,0;13,0;36,0;27,0;;12,0;48,0;390,0;49,0;23,0;92,0;130,0;39,0;34,0;4,0;19,0;162,0;14,0;90,0;55,0;37,0;11,0;39,0;10,0;;3,0;92,0;10,0;2,0;31,0;16,0;;20,0;36,0;442,0;105,0;1,0;88,0;256,0;5,0;31,0;134,0;15,0;2,0;67,0;12,0;;4,0;10,0;165,0;9,0;6,0;2,0;1,0;9,0;;65,0;241,0;5,0;2,0;26,0;16,0;5,0;;4,0;44,0;12,0;29,0;35,0;123,0;6,0;23,0;20,0;10,0;4,0;;6,0;37,0;4,0;168,0;213,0;;6,0;3,0;2,0;6,0;152,0;10,0;;13,0;13,0;21,0;21,0;13,0;2,0;;;3,0;36,0;;;41,0;4,0;2,0;;52,0;5,0;4,0;42,0;2,0;3,0;14,0;9,0;9,0;22,0;17,0;;;21,0;8,0;;5,0;55,0;20,0;5,0;83,0;32,0;12,0;2,0;;9,0;8,0;;6,0;2,0;2,0;21,0;7,0;74,0;112,0;11,0;2,0;;14,0;1,0;2,0;205,0;1,0;3,0;24,0;22,0;43,0;51,0;33,0;25,0;1,0;11,0;;4,0;4,0;;7,0;2,0;2,0;118,0;30,0;96,0;14,0;65,0;;3,0;7,0;23,0;;18,0;;;233,0;;;11,0;;44,0;;2,0;3,0;1,0;11,0;23,0;6,0;;1,0;3,0;266,0;30,0;18,0;12,0;3,0;;16,0;45,0;2,0;4,0;23,0;;18,0;1,0;1,0;5,0;1,0;;1,0;10,0;32,0;;1,0;5,0;53,0;1,0;6,0;;4,0;5,0;;13,0;;;3,0;3,0;2,0;;;20,0;3,0;1,0;1,0;111,0;13,0;;41,0;14,0;24,0;1,0;;;31,0;;3,0;2,0;1,0;18,0;13,0;5,0;2,0;4,0;1,0;;209,0;11,0;1,0;2,0;4,0;8,0;;15,0;10,0;96,0;27,0;12,0;3,0;2,0;1,0;11,0;1,0;20,0;;47,0;9,0;;2,0;8,0;128,0;9,0;13,0;;;84,0;1,0;1,0;32,0;27,0;2,0;;5,0;;16,0;4,0;3,0;;4,0;19,0;25,0;2,0;2,0;19,0;;1,0;;5,0;9,0;22,0;41,0;10,0;;;22,0;17,0;1,0;35,0;5,0;13,0;1,0;11,0;5,0;;22,0;4,0;;92,0;11,0;6,0;38,0;5,0;;13,0;5,0;26,0;10,0;;5,0;;3,0;2,0;8,0;19,0;8,0;;14,0;7,0;;6,0;9,0;96,0;2,0;11,0;2,0;;205,0;23,0;4,0;36,0;6,0;1,0;3,0;;;6,0;1,0;8,0;1,0;7,0;33,0;;2,0;9,0;2,0;25,0;8,0;;12,0;1,0;1,0;80,0;12,0;4,0;11,0;105,0;;;10,0;;4,0;2,0;;6,0;2,0;1,0;6,0;14,0;73,0;;;24,0;41,0;;;3,0;8,0;6,0;3,0;;1,0;;;1,0;1,0;;;;;;;1,0;5,0;14,0;;2,0;;5,0;;3,0;97,0;11,0;2,0;;8,0;6,0;6,0;;;8,0;;29,0;;27,0;7,0;;24,0;;;11,0;6,0;;;3,0;1,0;5,0;4,0;13,0;;;6,0;5,0;;74,0;38,0;;;25,0;;13,0;;3,0;31,0;757,0;;;3,0;2,0;;;;5,0;21,0;9,0;;1,0;;3,0;1,0;;;7,0;8,0;;1,0;;;2,0;2,0;2,0;4,0;6,0;;;7,0;;;3,0;;;;1,0;1,0;;2,0;2,0;4,0;;;6,0;;2,0;3,0;5,0;16,0;6,0;;3,0;3,0;;;2,0;3,0;;4,0;1,0;;4,0;19,0;1,0;;;4,0;;171,0;;6,0;;27,0;;1,0;;7,0;5,0;6,0;;;7,0;;2,0;36,0;1,0;;14,0;10,0;;;;;;;5,0;2,0;;;;7,0;8,0;;5,0;3,0;;2,0;;7,0;9,0;;;;;2,0;2,0;;1,0;1,0;;;8,0;;8,0;;3,0;;;3,0;;2,0;2,0;;5,0;6,0;17,0;4,0;;27,0;;15,0;;;;4,0;8,0;4,0;;1,0;3,0;;;6,0;;;2,0;1,0;;3,0;;42,0;13,0;35,0;;;5,0;9,0;1,0;;1,0;1,0;9,0;9,0;27,0;;2,0;45,0;1,0;;5,0;;2,0;;;4,0;;7,0;;;2,0;2,0;1,0;;4,0;28,0;;6,0;;;58,0;1,0;;17,0;;2,0;2,0;;3,0;;;14,0;24,0;1,0;1,0;;4,0;;;;1,0;;1,0;;2,0;1,0;1,0;;8,0;5,0;;;;;;12,0;;;1,0;;8,0;;15,0;1,0;2,0;1,0;2,0;3,0;;3,0;1,0;10,0;;8,0;3,0;3,0;9,0;;4,0;6,0;4,0;6,0;4,0;;5,0;1,0;;4,0;;6,0;;6,0;;7,0;10,0;9,0;;9,0;15,0;2,0;8,0;8,0;1,0;;5,0;7,0;2,0;1,0;;;6,0;3,0;;;8,0;;8,0;;2,0;;;;;1,0;;;8,0;17,0;;9,0;2,0;9,0;20,0;1,0;24,0;9,0;24,0;;;3,0;;2,0;;3,0;;1,0;;2,0;9,0;;;15,0;7,0;4,0;2,0;5,0;1,0;;2,0;1,0;;1,0;1,0;;1,0;1,0;1,0;;23,0;;;;1,0;;;6,0;;;;15,0;2,0;4,0;1,0;;;178,0;30,0;24,0;1,0;1,0;;;;;;;;1,0;;5,0;3,0;5,0;18,0;22,0;;;1,0;9,0;;;;;1,0;;4,0;;;;;;;4,0;;;2,0;2,0;;;;2,0;1,0;;;;3,0;10,0;;;;1,0;4,0;;5,0;;9,0;5,0;;;;2,0;4,0;2,0;;6,0;;;5,0;4,0;;1,0;;3,0;1,0;;9,0;;5,0;;;1,0;;;;;;;1,0;;;1,0;;30,0;14,0;6,0;1,0;;52,0;;;;;;;5,0;;60,0;;;;;;;;2,0;;;1,0;;;;;3,0;;;;1,0;17,0;1,0;;;;;
angular;;;8,0;;12,0;;11,0;62,0;7,0;11,0;2,0;;;2,0;;;2,0;1,0;5,0;1,0;7,0;16,0;;23,0;12,0;;3,0;5,0;68,0;175,0;46,0;2,0;35,0;11,0;4,0;;1,0;31,0;107,0;1,0;4,0;1,0;3,0;1,0;6,0;;;4,0;3,0;;5,0;1,0;;;;64,0;14,0;;4,0;3,0;;;21,0;;;;2,0;;11,0;4,0;14,0;;;;;;;5,0;67,0;;;14,0;4,0;1,0;;;2,0;5,0;6,0;;74,0;4,0;1,0;114,0;;1,0;;3,0;5,0;2,0;12,0;25,0;;;;;;25,0;;;1,0;5,0;4,0;;1,0;;;;;21,0;;1,0;1,0;;;;15,0;;;;;;13,0;;;33,0;3,0;;;3,0;;;;6,0;10,0;3,0;5,0;17,0;;;;;;;;;3,0;10,0;;7,0;5,0;4,0;;;;;25,0;12,0;;;;4,0;7,0;10,0;4,0;;;31,0;;;;;;;;15,0;;11,0;;5,0;;;;2,0;;2,0;;;21,0;;;;;;;8,0;;;1,0;1,0;2,0;;2,0;;2,0;11,0;;;;;;6,0;9,0;;;;1,0;;;;;;2,0;;9,0;35,0;;8,0;6,0;;;;;;;8,0;;;;3,0;;;;;;;;2,0;2,0;;;2,0;;1,0;;;;;;;;;1,0;;;;;;6,0;;;;;;;5,0;2,0;8,0;;4,0;;;;10,0;;;;1,0;;;;;24,0;;;;;20,0;;;24,0;;1,0;;8,0;;2,0;3,0;;;;8,0;1,0;1,0;;10,0;;;;6,0;;12,0;2,0;62,0;;3,0;;;2,0;;;;1,0;5,0;6,0;1,0;2,0;;;8,0;;1,0;4,0;8,0;;;2,0;7,0;;;15,0;;;;;3,0;;7,0;6,0;;;;9,0;21,0;1,0;4,0;1,0;;6,0;4,0;;10,0;;;;5,0;11,0;1,0;1,0;;;6,0;7,0;;2,0;8,0;;2,0;1,0;;;;;;1,0;304,0;;1,0;;;;;;1,0;;;1,0;;;11,0;5,0;;;2,0;;;;1,0;1,0;;;;;;4,0;;;;;;;;;;;2,0;;2,0;;;;;19,0;;;;;;;;;;;2,0;;3,0;;;1,0;;;;3,0;;;5,0;;;;;4,0;;;;;14,0;1,0;;;2,0;;;;;1,0;22,0;;;;;;;;;2,0;;;;;;;;;;;;;;;;;;2,0;;;;;;;;;;;;;;2,0;1,0;;;;;;;;;5,0;1,0;;4,0;;;;;;;;;;;1,0;;;;;;35,0;;;;;;;;;;1,0;;;;;;;;;2,0;;;;;;;;;;;;;;;;;;;;;;;4,0;;;;;;;;;;;1,0;;;;2,0;;;;;;;;3,0;2,0;;;;4,0;;1,0;;;;;;;;;;;;8,0;;;;;;;;4,0;5,0;33,0;;;;;;19,0;;;;;;;;5,0;1,0;;;;;;;1,0;;2,0;;;;;;;;1,0;;2,0;;;2,0;;4,0;11,0;;;;;;;;4,0;;;1,0;;1,0;;;;;;;10,0;;;;;;;;;;;;1,0;;;;;;;;1,0;;;;1,0;;4,0;;2,0;;;;;1,0;1,0;;;;1,0;;;;1,0;;4,0;1,0;;;;;2,0;;;;;4,0;;;;2,0;;;;2,0;;;;;8,0;;;;;;;;;;;;;;;;;;;;2,0;;7,0;;;;;;;;;;;;;;;;;;;2,0;;;;;;;;;;8,0;;;;;;1,0;;;;;;;;;;;;;;;;;4,0;;;;;;1,0;;;;;;;;;;;5,0;;;;2,0;;;;;;;;;;;;1,0;;;;;;1,0;;;;;;;;;10,0;;;;;;;;;;;3,0;;;;;4,0;;;;;;;;1,0;;;;;;;;1,0;6,0;;;;;;;;1,0;;;;3,0;;;;;;;;;;;;;;;;;;;;;;;;;;;;;;;;;;;;;;;;;;;;
area;;;49,0;9,0;146,0;;17,0;241,0;41,0;383,0;132,0;20,0;3,0;2,0;129,0;13,0;13,0;1,0;33,0;22,0;17,0;227,0;15,0;21,0;26,0;10,0;10,0;291,0;25,0;497,0;225,0;284,0;304,0;73,0;82,0;7,0;20,0;98,0;18,0;596,0;119,0;1,0;12,0;117,0;3,0;79,0;;58,0;390,0;2,0;22,0;142,0;5,0;49,0;6,0;2452,0;407,0;5,0;17,0;189,0;9,0;31,0;283,0;4,0;15,0;3,0;167,0;3,0;10,0;56,0;149,0;14,0;11,0;48,0;74,0;33,0;;111,0;255,0;1,0;3,0;172,0;22,0;25,0;;;72,0;29,0;54,0;158,0;234,0;33,0;260,0;152,0;180,0;19,0;19,0;93,0;95,0;60,0;235,0;196,0;2,0;4,0;8,0;1,0;11,0;412,0;;;12,0;74,0;119,0;13,0;14,0;11,0;1,0;3,0;22,0;28,0;10,0;;55,0;62,0;18,0;15,0;105,0;55,0;11,0;10,0;101,0;16,0;28,0;3,0;3,0;38,0;40,0;;17,0;5,0;17,0;3,0;13,0;605,0;54,0;3,0;154,0;220,0;3,0;6,0;;20,0;12,0;5,0;5,0;3,0;27,0;33,0;19,0;281,0;4,0;25,0;18,0;65,0;;69,0;90,0;203,0;4,0;14,0;53,0;5,0;87,0;68,0;95,0;72,0;45,0;114,0;3,0;;11,0;20,0;36,0;22,0;;80,0;41,0;560,0;;319,0;5,0;4,0;7,0;100,0;43,0;13,0;13,0;;8,0;3,0;10,0;50,0;2,0;68,0;;66,0;9,0;2,0;18,0;27,0;1,0;8,0;38,0;6,0;22,0;80,0;16,0;49,0;;2,0;17,0;72,0;;16,0;16,0;;35,0;;3,0;1,0;3,0;;3,0;83,0;96,0;53,0;7,0;54,0;;28,0;13,0;;96,0;2,0;;22,0;4,0;105,0;13,0;;3,0;12,0;11,0;104,0;5,0;10,0;1,0;190,0;22,0;9,0;89,0;11,0;51,0;;10,0;1,0;40,0;4,0;1,0;1,0;65,0;19,0;3,0;1,0;24,0;40,0;2,0;;29,0;58,0;;3,0;;6,0;1,0;103,0;75,0;476,0;25,0;19,0;5,0;2,0;112,0;61,0;;10,0;17,0;66,0;11,0;2,0;1,0;2,0;221,0;19,0;49,0;8,0;3,0;54,0;13,0;13,0;88,0;59,0;6,0;;4,0;;;;;26,0;2,0;83,0;;1,0;5,0;18,0;5,0;;2,0;;43,0;6,0;;4,0;;1,0;4,0;4,0;4,0;6,0;11,0;35,0;3,0;21,0;55,0;72,0;35,0;3,0;;194,0;55,0;7,0;9,0;;1,0;7,0;;2,0;;;33,0;1,0;16,0;7,0;175,0;48,0;6,0;4,0;24,0;111,0;10,0;2,0;;26,0;46,0;103,0;21,0;3,0;;22,0;16,0;64,0;5,0;13,0;7,0;19,0;8,0;61,0;9,0;99,0;5,0;72,0;;;8,0;9,0;15,0;197,0;30,0;23,0;68,0;;35,0;4,0;42,0;1,0;32,0;62,0;30,0;1,0;14,0;15,0;1,0;9,0;4,0;36,0;27,0;;58,0;4,0;94,0;1,0;1,0;9,0;52,0;;13,0;39,0;79,0;38,0;7,0;13,0;1,0;;2,0;1,0;;11,0;6,0;5,0;21,0;31,0;1,0;2,0;2,0;29,0;28,0;14,0;137,0;25,0;;10,0;158,0;3,0;1,0;5,0;11,0;4,0;24,0;2,0;12,0;12,0;4,0;8,0;;256,0;41,0;3,0;11,0;;261,0;102,0;;2,0;1,0;33,0;69,0;;24,0;107,0;11,0;5,0;6,0;4,0;;10,0;63,0;31,0;1,0;211,0;;30,0;84,0;4,0;107,0;193,0;3,0;4,0;4,0;13,0;2,0;;1,0;13,0;32,0;8,0;;;;6,0;3,0;;;26,0;58,0;8,0;3,0;44,0;2,0;24,0;;1,0;26,0;18,0;;3,0;14,0;;;17,0;;4,0;10,0;;2,0;11,0;2,0;3,0;;;1,0;25,0;2,0;5,0;30,0;9,0;2,0;10,0;13,0;1,0;17,0;;4,0;9,0;27,0;6,0;40,0;;17,0;14,0;327,0;;1,0;9,0;3,0;27,0;44,0;4,0;21,0;8,0;2,0;5,0;1,0;;13,0;1,0;21,0;;5,0;7,0;7,0;4,0;195,0;5,0;;112,0;4,0;;3,0;39,0;12,0;36,0;;1,0;6,0;5,0;9,0;;8,0;29,0;;;28,0;;1,0;1,0;2,0;12,0;3,0;;5,0;11,0;1,0;;5,0;;5,0;1,0;;7,0;31,0;1,0;5,0;8,0;18,0;10,0;;6,0;4,0;1,0;;16,0;1,0;53,0;2,0;;21,0;;;6,0;;8,0;4,0;2,0;4,0;;;1,0;6,0;19,0;83,0;19,0;;1,0;;;4,0;2,0;35,0;7,0;8,0;4,0;;21,0;15,0;40,0;3,0;;;6,0;1,0;5,0;3,0;3,0;24,0;3,0;6,0;27,0;;2,0;;;25,0;24,0;6,0;;;4,0;2,0;;;;6,0;1,0;13,0;;3,0;35,0;17,0;1,0;4,0;;2,0;15,0;119,0;19,0;1,0;1,0;28,0;50,0;;47,0;19,0;108,0;3,0;16,0;2,0;;4,0;25,0;31,0;8,0;6,0;4,0;;18,0;2,0;6,0;;;4,0;;31,0;6,0;5,0;3,0;18,0;;2,0;1,0;10,0;;2,0;16,0;68,0;10,0;22,0;19,0;8,0;8,0;1,0;;2,0;3,0;2,0;9,0;6,0;20,0;37,0;9,0;14,0;7,0;;30,0;10,0;1,0;4,0;1,0;10,0;10,0;44,0;;4,0;3,0;3,0;22,0;106,0;7,0;4,0;;3,0;;3,0;25,0;17,0;;137,0;13,0;1,0;;;;13,0;9,0;4,0;48,0;;12,0;30,0;5,0;2,0;6,0;;;1,0;4,0;4,0;16,0;23,0;1,0;4,0;9,0;4,0;14,0;;1,0;5,0;2,0;16,0;;6,0;;24,0;1,0;;1,0;;;35,0;4,0;22,0;30,0;8,0;3,0;2,0;;7,0;;19,0;1,0;19,0;18,0;126,0;13,0;;10,0;;;2,0;1,0;;;88,0;10,0;9,0;3,0;68,0;3,0;1,0;7,0;25,0;4,0;2,0;5,0;4,0;;39,0;2,0;1,0;;1,0;4,0;24,0;;1,0;1,0;74,0;;3,0;2,0;;;13,0;;;3,0;;1,0;5,0;4,0;;4,0;9,0;;20,0;9,0;7,0;;4,0;1,0;11,0;8,0;1,0;;;;;;15,0;20,0;16,0;30,0;4,0;1,0;;4,0;20,0;;3,0;3,0;8,0;8,0;1,0;;;11,0;;1,0;;;15,0;18,0;1,0;;87,0;;10,0;18,0;;8,0;;;;5,0;;7,0;4,0;12,0;9,0;5,0;14,0;105,0;3,0;14,0;;8,0;4,0;1,0;1,0;39,0;21,0;;;;;;;11,0;;;;24,0;2,0;9,0;;;;9,0;10,0;3,0;5,0;5,0;1,0;11,0;;;1,0;;;1,0;1,0;19,0;3,0;;35,0;1,0;1,0;2,0;;
arrangement;;;1,0;;17,0;;5,0;15,0;;9,0;1,0;4,0;3,0;;4,0;8,0;;;1,0;1,0;;34,0;;;1,0;;2,0;18,0;1,0;4,0;9,0;9,0;91,0;2,0;3,0;7,0;2,0;28,0;;8,0;8,0;1,0;1,0;59,0;;6,0;;8,0;5,0;;2,0;2,0;;4,0;;43,0;72,0;;3,0;45,0;2,0;;37,0;;;18,0;1,0;;;4,0;35,0;3,0;1,0;1,0;;;;51,0;29,0;2,0;;28,0;7,0;4,0;;;13,0;2,0;1,0;;67,0;6,0;;8,0;3,0;5,0;;1,0;3,0;1,0;13,0;29,0;;5,0;;;3,0;67,0;;;32,0;36,0;5,0;3,0;;1,0;;1,0;4,0;10,0;1,0;1,0;2,0;13,0;;;10,0;2,0;1,0;11,0;18,0;;;;2,0;2,0;4,0;;1,0;4,0;5,0;1,0;;3,0;27,0;2,0;31,0;10,0;;9,0;;2,0;5,0;4,0;1,0;2,0;;25,0;2,0;7,0;;;;4,0;;;;60,0;;8,0;28,0;3,0;8,0;12,0;;1,0;;10,0;;50,0;;1,0;;;1,0;14,0;2,0;35,0;;5,0;;;2,0;13,0;;16,0;12,0;;9,0;1,0;;8,0;;7,0;;10,0;;1,0;9,0;7,0;1,0;;7,0;;5,0;7,0;12,0;13,0;;;;30,0;;2,0;;;14,0;7,0;1,0;;;2,0;1,0;7,0;13,0;4,0;;1,0;9,0;;;;;;;;;1,0;;2,0;9,0;3,0;;13,0;;;1,0;11,0;;;;;;1,0;6,0;;;1,0;;1,0;4,0;2,0;;;3,0;4,0;2,0;;;7,0;4,0;10,0;5,0;6,0;;;3,0;9,0;5,0;1,0;4,0;;8,0;4,0;;2,0;2,0;;;;2,0;;2,0;4,0;21,0;8,0;;1,0;;;36,0;7,0;1,0;;7,0;1,0;;;;10,0;;1,0;5,0;1,0;4,0;17,0;;3,0;27,0;3,0;4,0;;1,0;;;;;1,0;1,0;;;1,0;;;;;;7,0;2,0;3,0;;;;1,0;;;;;;;2,0;2,0;;;2,0;;;;2,0;;;;;;1,0;8,0;3,0;;;21,0;;2,0;3,0;1,0;;;4,0;;;3,0;2,0;2,0;;;20,0;;;6,0;1,0;;;;2,0;;;2,0;;3,0;1,0;;4,0;2,0;;2,0;;;4,0;;3,0;2,0;19,0;;;3,0;2,0;1,0;;;1,0;1,0;;;;;;;;;;;1,0;;1,0;;2,0;5,0;;;;;;2,0;6,0;2,0;;;;;;;;;;;1,0;3,0;5,0;;;;;2,0;2,0;;1,0;;13,0;;1,0;11,0;;;;;1,0;1,0;4,0;;;16,0;;;;2,0;5,0;22,0;;;;2,0;;;;;15,0;7,0;1,0;;;;;;;;4,0;3,0;1,0;;;;;;7,0;;;;1,0;;;;;;;8,0;9,0;;;;;;;;;1,0;;1,0;1,0;;2,0;;;7,0;;1,0;1,0;;5,0;1,0;1,0;2,0;27,0;;8,0;;;;9,0;;;;2,0;;;;;;1,0;;;;1,0;;;;;23,0;;;;;;3,0;;;1,0;;;;;;;;1,0;;;;;;;;1,0;1,0;;;;;;;;;;;;5,0;2,0;;;;4,0;;;;3,0;10,0;;;14,0;;;;;;;;1,0;;;2,0;2,0;;2,0;;;;;;;1,0;3,0;2,0;;;;1,0;;;;;;1,0;;;1,0;;1,0;;1,0;;;;;;;;13,0;;;;;;;1,0;1,0;;;;;4,0;1,0;;;;;;;;;;;6,0;;;;6,0;;;;1,0;;2,0;;;;;;;;;;;;;2,0;1,0;;1,0;;;;10,0;1,0;;;;;;2,0;;;1,0;;;;1,0;;;;;;;;8,0;6,0;13,0;2,0;;;6,0;1,0;;2,0;1,0;;1,0;11,0;2,0;;;;;;1,0;;;;5,0;;2,0;;;;;;;1,0;;1,0;;;;;;;;;;;;;;;;;;;;5,0;;;;;;1,0;1,0;;;;;3,0;;;2,0;;;1,0;;;;1,0;;;;1,0;;;;;;;;;;;;;;;;1,0;;;;;;5,0;;;12,0;;;;;1,0;;1,0;;;;;17,0;2,0;;;;;;;1,0;2,0;;;;;4,0;;;;;;;;;;;;;;;;;;1,0;;;;;;;;;;;;;;6,0;;;;3,0;3,0;;;;;;;;;;;;;9,0;;;;1,0;;;;;;;;;;;2,0;2,0;;;;;;;2,0;;;;;;;;;;;;;;;;;1,0;;1,0;;;;;;;;;;;;;;
array;;;11,0;3,0;58,0;;19,0;54,0;9,0;105,0;13,0;18,0;;24,0;84,0;1,0;;1,0;13,0;7,0;7,0;45,0;10,0;5,0;8,0;3,0;;191,0;3,0;56,0;61,0;20,0;221,0;20,0;146,0;115,0;3,0;46,0;3,0;38,0;20,0;2,0;8,0;159,0;;1,0;;103,0;33,0;7,0;3,0;58,0;1,0;12,0;;507,0;287,0;7,0;7,0;281,0;31,0;;143,0;1,0;1,0;;7,0;23,0;1,0;6,0;118,0;8,0;25,0;;6,0;;;11,0;88,0;7,0;2,0;52,0;65,0;25,0;;;21,0;3,0;11,0;31,0;520,0;9,0;2,0;126,0;7,0;4,0;2,0;6,0;13,0;96,0;71,0;154,0;;47,0;;2,0;7,0;86,0;2,0;5,0;17,0;132,0;;41,0;1,0;5,0;;15,0;22,0;3,0;3,0;;1,0;92,0;7,0;12,0;94,0;6,0;12,0;64,0;22,0;4,0;6,0;;3,0;366,0;129,0;;32,0;17,0;9,0;2,0;3,0;4,0;107,0;;75,0;38,0;4,0;;17,0;6,0;;2,0;3,0;;17,0;10,0;19,0;217,0;18,0;3,0;6,0;;;31,0;3,0;219,0;2,0;2,0;13,0;3,0;45,0;29,0;9,0;8,0;;115,0;;;6,0;;20,0;;;134,0;20,0;272,0;2,0;89,0;;;44,0;80,0;4,0;5,0;5,0;;;6,0;37,0;11,0;;28,0;;10,0;1,0;;9,0;5,0;5,0;13,0;5,0;4,0;1,0;69,0;10,0;30,0;;9,0;11,0;10,0;;10,0;4,0;52,0;2,0;;1,0;;1,0;;14,0;15,0;31,0;21,0;1,0;6,0;119,0;6,0;14,0;;7,0;2,0;;1,0;44,0;44,0;3,0;;64,0;1,0;1,0;16,0;1,0;1,0;5,0;31,0;4,0;1,0;8,0;5,0;8,0;;;2,0;37,0;;;1,0;5,0;8,0;;;6,0;7,0;;;;24,0;;;2,0;1,0;;1,0;20,0;45,0;9,0;5,0;25,0;9,0;8,0;26,0;;10,0;72,0;1,0;6,0;;5,0;;26,0;9,0;2,0;;;53,0;2,0;;15,0;44,0;;;2,0;;;;;3,0;;41,0;;;;28,0;;;3,0;;4,0;2,0;;;;1,0;;1,0;;4,0;8,0;40,0;;1,0;1,0;1,0;;;;2,0;4,0;;10,0;2,0;1,0;;;;;8,0;5,0;;;;;;;;47,0;1,0;18,0;2,0;;5,0;1,0;9,0;20,0;1,0;;17,0;10,0;8,0;;1,0;;1,0;4,0;4,0;2,0;5,0;;2,0;;;19,0;3,0;;11,0;8,0;1,0;4,0;;2,0;3,0;2,0;;6,0;;;;11,0;5,0;3,0;9,0;;1,0;10,0;;29,0;1,0;28,0;4,0;;4,0;29,0;;1,0;41,0;26,0;41,0;3,0;6,0;3,0;;;;16,0;1,0;9,0;;;;2,0;14,0;10,0;43,0;23,0;6,0;4,0;8,0;;1,0;43,0;2,0;;2,0;;1,0;1,0;;6,0;;;6,0;74,0;12,0;2,0;;9,0;;;19,0;;;;;5,0;;1,0;2,0;4,0;18,0;;;;;3,0;3,0;9,0;9,0;;5,0;4,0;3,0;62,0;26,0;;8,0;2,0;;;2,0;6,0;3,0;30,0;3,0;;;;;3,0;;;10,0;2,0;1,0;;1,0;;;;;4,0;;;;6,0;;4,0;1,0;2,0;1,0;12,0;2,0;1,0;;;1,0;2,0;;;25,0;1,0;;;;;;;;4,0;4,0;3,0;14,0;1,0;6,0;11,0;;;13,0;867,0;;;;;;37,0;;;1,0;;;;;1,0;2,0;1,0;1,0;;;1,0;1,0;6,0;1,0;10,0;4,0;9,0;;;8,0;;;;;84,0;5,0;;;5,0;1,0;3,0;30,0;13,0;;;;;;;;;;;;;;3,0;;;2,0;6,0;1,0;34,0;19,0;13,0;;;;2,0;1,0;;;;3,0;7,0;11,0;4,0;;;;;1,0;2,0;5,0;;8,0;4,0;1,0;1,0;5,0;2,0;1,0;;;;;;1,0;8,0;4,0;3,0;;;;;2,0;;;;2,0;;;;1,0;6,0;2,0;19,0;3,0;2,0;;3,0;2,0;2,0;3,0;3,0;;;;;8,0;;4,0;1,0;;;7,0;21,0;20,0;46,0;31,0;;4,0;;;2,0;1,0;10,0;;;21,0;25,0;10,0;9,0;18,0;1,0;;1,0;;;3,0;1,0;5,0;;220,0;51,0;6,0;;2,0;;16,0;6,0;1,0;8,0;1,0;;16,0;5,0;;1,0;;70,0;;21,0;;;;;83,0;;;;;;3,0;;;;;;5,0;;17,0;3,0;1,0;;4,0;;3,0;7,0;3,0;7,0;10,0;2,0;;8,0;16,0;6,0;3,0;;;4,0;1,0;;;;;1,0;;;2,0;;6,0;;;2,0;;;;2,0;;;;;;;;;;21,0;12,0;1,0;1,0;1,0;2,0;;;;;7,0;;3,0;;7,0;;;;;;4,0;;;;5,0;;;;;;7,0;;27,0;;;4,0;;;1,0;;2,0;;;;;1,0;;;;3,0;;1,0;;;;2,0;2,0;;1,0;;1,0;;1,0;1,0;8,0;;;;7,0;;;6,0;4,0;;6,0;;;5,0;;4,0;;;2,0;;;2,0;5,0;;;;;;;;;;;;;4,0;1,0;;;;1,0;;;;2,0;;;4,0;2,0;3,0;3,0;;;;;21,0;18,0;;;38,0;;;50,0;;2,0;;;1,0;;;1,0;7,0;;;;;;;;38,0;;;;;111,0;;6,0;19,0;2,0;;;;;;2,0;2,0;;2,0;;;;;;;;;;2,0;;;;;241,0;;;;;;;4,0;3,0;;;3,0;;;;
assign;;;15,0;;12,0;;;12,0;2,0;17,0;3,0;;;;45,0;;;;3,0;11,0;;4,0;9,0;;;;1,0;15,0;;6,0;31,0;10,0;28,0;;3,0;2,0;;5,0;;10,0;3,0;;;2,0;;19,0;;;2,0;;40,0;2,0;;2,0;;139,0;17,0;;;11,0;;;56,0;;;;2,0;;;4,0;8,0;2,0;2,0;;;;;17,0;15,0;;;3,0;4,0;1,0;4,0;;17,0;1,0;3,0;13,0;;;;5,0;1,0;4,0;;4,0;11,0;;6,0;18,0;;;1,0;;;17,0;;;;1,0;;;;;;4,0;;;;;;;;;8,0;;3,0;7,0;;1,0;;;;22,0;;;;1,0;;;;3,0;;;;90,0;4,0;;4,0;;;;2,0;;;;;15,0;;;;3,0;5,0;;;10,0;5,0;1,0;1,0;;7,0;2,0;;;;1,0;;;;2,0;;;;;;66,0;;9,0;;;1,0;10,0;;;;;;;;;;2,0;;11,0;;;;;;;;;;49,0;5,0;;;;2,0;3,0;;;;13,0;18,0;;;;;;;2,0;;6,0;;;88,0;;;;3,0;;;;16,0;;;;6,0;;;1,0;;;;3,0;;;1,0;;3,0;;;;;;;;;;;;;3,0;;;;1,0;;;;;;;;18,0;;;;;;;;;1,0;;;;;;22,0;;;;;15,0;;;6,0;9,0;;;;;;;;;;6,0;;;;;;6,0;1,0;;4,0;;;;;;;;;;;9,0;;;2,0;;;;;;;;3,0;3,0;5,0;1,0;3,0;;;;1,0;1,0;1,0;1,0;1,0;;;;1,0;2,0;;;;;6,0;6,0;2,0;;;8,0;10,0;;1,0;1,0;;;;4,0;1,0;4,0;;11,0;;;;;;14,0;13,0;;4,0;;;3,0;1,0;;6,0;;;;;;;4,0;;20,0;8,0;;;;16,0;;;1,0;4,0;6,0;;3,0;;8,0;;;;;;;;;;;1,0;2,0;;;;7,0;1,0;1,0;2,0;;;7,0;6,0;;;;1,0;;;;;2,0;;;;2,0;;;4,0;;;2,0;;;;2,0;2,0;;;1,0;5,0;;8,0;;;;2,0;;;2,0;;2,0;12,0;;10,0;3,0;;;;1,0;;8,0;;;1,0;;;;;;;1,0;4,0;14,0;;;;;;5,0;;;2,0;;;;3,0;;;;;;;2,0;4,0;;;;;22,0;;7,0;;1,0;;;;;;;;2,0;;;1,0;;2,0;3,0;;;62,0;;;17,0;;;5,0;;;1,0;;;16,0;;;;;1,0;;7,0;;;;;;1,0;;5,0;;1,0;;;;11,0;1,0;;;;;;;;43,0;;1,0;;;;;;;15,0;;;;;;;;;;;2,0;;;;;;1,0;;;;;;1,0;;;;;;;;;;;;;;;;4,0;1,0;;;;;;;;;2,0;;;;;;;;;;;;;;10,0;1,0;;11,0;;2,0;;;7,0;2,0;;;;;;;;;;;;;;11,0;6,0;;;;;4,0;13,0;;;;;5,0;;;;;;;;;;;;6,0;;;;;;;;;;;;;;;;;;;2,0;;2,0;;1,0;;;1,0;;4,0;;;;;;;;3,0;;;;12,0;;2,0;;;;;;;2,0;;;;;;;;;1,0;;;;;;;26,0;32,0;;;;;;;;;11,0;;;;;;;;;;;;1,0;;;;;8,0;;;;2,0;;;;;;;;;;;;;;1,0;2,0;;;;;;;;7,0;;2,0;;;27,0;;;;;;1,0;;;;1,0;10,0;;;;2,0;;;;;;4,0;;;;;;;;;;2,0;;6,0;;;;;;;;;;;;;;;;;;1,0;;4,0;;;;;;;;;;1,0;2,0;;;;1,0;;;;;;;;;;19,0;;;;;;;;2,0;;;12,0;;;;;3,0;;;;;;;1,0;;;;;;;;;1,0;;;;;;;;;;;;;;;;;;;;;;;;;21,0;;;;;;;;;;;;;;;;;;;
associate;;;23,0;1,0;22,0;;25,0;83,0;10,0;93,0;1,0;38,0;;;81,0;6,0;;3,0;19,0;20,0;9,0;65,0;32,0;3,0;10,0;1,0;16,0;324,0;1,0;46,0;16,0;113,0;201,0;25,0;89,0;8,0;4,0;15,0;;121,0;15,0;8,0;32,0;26,0;1,0;5,0;8,0;13,0;25,0;10,0;58,0;67,0;;19,0;;672,0;97,0;1,0;13,0;55,0;2,0;10,0;155,0;;32,0;7,0;3,0;3,0;4,0;26,0;31,0;1,0;7,0;;;;;85,0;94,0;7,0;1,0;42,0;44,0;4,0;;;81,0;;10,0;58,0;90,0;1,0;1,0;68,0;11,0;17,0;1,0;13,0;55,0;1,0;35,0;101,0;2,0;7,0;5,0;3,0;8,0;43,0;;;10,0;5,0;40,0;18,0;3,0;2,0;;;6,0;9,0;;;4,0;27,0;;;34,0;3,0;4,0;9,0;;11,0;;;1,0;33,0;4,0;;;9,0;;5,0;19,0;14,0;52,0;1,0;10,0;67,0;;2,0;;;5,0;1,0;3,0;6,0;;5,0;11,0;33,0;;2,0;;2,0;13,0;4,0;13,0;72,0;1,0;11,0;11,0;;38,0;6,0;25,0;2,0;;32,0;;;6,0;2,0;7,0;;;14,0;8,0;218,0;2,0;73,0;;;6,0;41,0;;3,0;;4,0;1,0;1,0;3,0;2,0;;1,0;;5,0;;5,0;8,0;6,0;2,0;;9,0;4,0;2,0;92,0;20,0;1,0;1,0;1,0;;20,0;4,0;2,0;3,0;70,0;1,0;;;;;;3,0;1,0;12,0;13,0;;8,0;35,0;2,0;5,0;;7,0;;6,0;5,0;5,0;1,0;;;11,0;6,0;;1,0;;;;20,0;;;1,0;6,0;13,0;;1,0;;;;;1,0;;1,0;1,0;3,0;;13,0;10,0;;;17,0;1,0;;2,0;6,0;;36,0;9,0;105,0;13,0;4,0;13,0;;2,0;9,0;1,0;2,0;5,0;10,0;;;11,0;;28,0;;;;;49,0;1,0;;61,0;32,0;;;12,0;16,0;;;;;;22,0;3,0;;;14,0;;1,0;2,0;3,0;93,0;1,0;;1,0;2,0;;1,0;1,0;;;2,0;;6,0;3,0;13,0;;1,0;;1,0;24,0;2,0;20,0;10,0;1,0;;1,0;13,0;2,0;;;21,0;;;7,0;34,0;4,0;6,0;8,0;9,0;25,0;;;;19,0;8,0;21,0;11,0;3,0;;6,0;2,0;5,0;18,0;29,0;1,0;26,0;11,0;15,0;11,0;49,0;2,0;10,0;1,0;;12,0;28,0;;23,0;12,0;;25,0;;;1,0;8,0;6,0;18,0;25,0;3,0;4,0;3,0;7,0;;3,0;;43,0;27,0;;29,0;5,0;57,0;5,0;6,0;20,0;24,0;11,0;5,0;17,0;8,0;12,0;12,0;2,0;;6,0;;1,0;3,0;;10,0;6,0;10,0;23,0;2,0;9,0;1,0;11,0;6,0;4,0;7,0;15,0;1,0;9,0;57,0;11,0;2,0;;10,0;;6,0;;;2,0;4,0;;2,0;21,0;3,0;1,0;103,0;1,0;1,0;20,0;;;;3,0;11,0;1,0;4,0;9,0;4,0;8,0;15,0;3,0;3,0;1,0;4,0;13,0;;21,0;6,0;5,0;21,0;4,0;108,0;45,0;10,0;3,0;1,0;;2,0;4,0;3,0;;18,0;7,0;18,0;;;2,0;;;6,0;18,0;10,0;5,0;7,0;4,0;3,0;;;;3,0;;2,0;;28,0;;;3,0;2,0;;2,0;6,0;38,0;3,0;;8,0;9,0;23,0;;33,0;1,0;2,0;;;2,0;6,0;;;10,0;15,0;;;9,0;;12,0;2,0;2,0;39,0;181,0;5,0;1,0;;;;18,0;1,0;;8,0;5,0;4,0;9,0;;;1,0;3,0;2,0;;7,0;;17,0;48,0;5,0;8,0;7,0;;4,0;4,0;27,0;7,0;;;3,0;10,0;;;7,0;;;6,0;1,0;46,0;1,0;;;5,0;1,0;;;1,0;5,0;;;;6,0;6,0;1,0;1,0;3,0;;;;5,0;;;;;2,0;;;2,0;;29,0;2,0;;7,0;1,0;;1,0;24,0;;;1,0;;3,0;;;7,0;1,0;9,0;2,0;1,0;1,0;;4,0;;;3,0;1,0;30,0;;8,0;;;11,0;1,0;;;1,0;;;7,0;4,0;;;1,0;9,0;;1,0;1,0;2,0;20,0;13,0;8,0;;;;2,0;1,0;;;6,0;2,0;12,0;1,0;2,0;;2,0;5,0;15,0;;7,0;1,0;2,0;4,0;;;12,0;5,0;1,0;5,0;3,0;4,0;5,0;7,0;3,0;;;;;9,0;;5,0;;1,0;4,0;1,0;;;4,0;40,0;6,0;;4,0;;3,0;3,0;4,0;;3,0;3,0;;;5,0;1,0;;1,0;;;;;;7,0;;3,0;3,0;2,0;;1,0;6,0;29,0;8,0;1,0;9,0;;;6,0;;1,0;5,0;;;;;7,0;;1,0;3,0;1,0;;1,0;2,0;1,0;7,0;;3,0;4,0;;;;;;15,0;10,0;19,0;;;;1,0;;8,0;;1,0;5,0;;;;13,0;3,0;1,0;;;20,0;;;16,0;;;;10,0;5,0;11,0;;2,0;;;;3,0;16,0;4,0;4,0;8,0;;1,0;;2,0;1,0;4,0;;6,0;3,0;;7,0;5,0;32,0;;;;1,0;;21,0;9,0;16,0;1,0;2,0;12,0;4,0;;1,0;;3,0;;;;3,0;5,0;;2,0;1,0;2,0;;3,0;;;;2,0;;;;2,0;;;;;;;;3,0;;;;4,0;8,0;;1,0;4,0;;;;1,0;;1,0;;2,0;;;;2,0;10,0;2,0;16,0;;;1,0;1,0;2,0;1,0;;;3,0;1,0;1,0;5,0;;1,0;;2,0;;;;;1,0;;1,0;;;2,0;;;;;1,0;30,0;1,0;23,0;9,0;4,0;;2,0;1,0;3,0;;;;4,0;;;;2,0;2,0;;1,0;6,0;;;;2,0;;;1,0;;;7,0;;;3,0;1,0;2,0;;2,0;1,0;;;13,0;;;;;4,0;30,0;;;;3,0;;;;;
audio;;;2,0;3,0;12,0;;;19,0;2,0;50,0;;;;1,0;;3,0;;;14,0;2,0;;24,0;4,0;;;;;257,0;;10,0;1,0;15,0;108,0;1,0;28,0;;2,0;4,0;;14,0;;3,0;;1,0;;;;8,0;;21,0;;60,0;1,0;2,0;;102,0;31,0;;2,0;;;;37,0;;;;;;;7,0;;12,0;;;;;;8,0;16,0;11,0;;46,0;7,0;;;;;;5,0;23,0;27,0;;;166,0;;3,0;;31,0;14,0;;;50,0;;5,0;;;;30,0;2,0;;4,0;;9,0;;;;;;;;;;1,0;;;3,0;21,0;;;5,0;4,0;3,0;;;;2,0;;;;1,0;;2,0;3,0;1,0;3,0;;15,0;28,0;;6,0;;;;1,0;;;;6,0;;1,0;;;;;1,0;;6,0;;1,0;;;;25,0;;;1,0;;83,0;;;;;;;;;;26,0;;24,0;;;;89,0;;;;;;;;;;4,0;;1,0;;;;;;;;;1,0;34,0;20,0;;;;;;;;;;4,0;;;;;;1,0;;9,0;;;;6,0;;;4,0;;;;;1,0;;;;;3,0;;6,0;;;;2,0;;;;;;;;;;;;;;;;;;;;;;;;;;;;2,0;;15,0;;;;;;;;;;1,0;;;4,0;;4,0;1,0;;;;1,0;;;1,0;;;;;;;;;;;10,0;;;;41,0;;;1,0;;4,0;;;;;;;;;;;10,0;2,0;;;;1,0;;;3,0;;8,0;4,0;;;;3,0;;;;;;;;5,0;13,0;;3,0;;;;;;;5,0;;;;;;;4,0;;5,0;;;3,0;4,0;2,0;113,0;;1,0;;;1,0;;8,0;8,0;;;18,0;;;;;;2,0;1,0;2,0;4,0;;3,0;;1,0;;4,0;;;38,0;;16,0;;3,0;;4,0;16,0;4,0;2,0;;;1,0;2,0;25,0;;2,0;1,0;16,0;;;7,0;;;;2,0;;6,0;;1,0;;;;;4,0;;;1,0;;;1,0;;;;;;78,0;5,0;;;4,0;6,0;;7,0;;;3,0;;3,0;4,0;1,0;5,0;;;;;;;;;;14,0;40,0;17,0;;;175,0;3,0;;;;;;;2,0;6,0;;;;;3,0;;;;1,0;9,0;52,0;2,0;;37,0;;;;;;;2,0;;10,0;;;;;;;;3,0;;;;2,0;;;1,0;6,0;;;;5,0;5,0;;;;1,0;;;7,0;;8,0;4,0;;3,0;1,0;;;;;;1,0;;;2,0;;1,0;1,0;2,0;;;;;;;;26,0;;;2,0;4,0;;;;;20,0;;;;;;;;2,0;;7,0;;;;2,0;;;;;;;;;;;7,0;27,0;;;;;;;1,0;;;1,0;;12,0;2,0;;;;3,0;;;;;;;1,0;;;;;1,0;;;;;;;;;;;;;;;;;;;;;;;;;;;1,0;;1,0;;;1,0;;;;3,0;;;;;;;;;;;;;;;;;1,0;;1,0;2,0;;;;;;3,0;;25,0;;7,0;;;;1,0;;;;;;;;;;;3,0;;;1,0;1,0;4,0;4,0;;;;;;;;3,0;;;2,0;;;;3,0;;;;;;;;;;;;;;;3,0;;;;;1,0;;;;;;;2,0;2,0;;;;;;;;;;1,0;;1,0;;;9,0;;2,0;1,0;2,0;;;;;;;;;1,0;;;;2,0;;;;;;11,0;;;;;;;;;;;;;;;;;;;;;;;;;16,0;;;;;6,0;5,0;;;;;;;;;;;2,0;1,0;1,0;;;;;;;;2,0;;;19,0;;;1,0;;;;;;;;;;;;;;;;;;2,0;;1,0;;;;1,0;3,0;;;;3,0;;;;;;;;;;;;;;;;;;;;;;;;;1,0;;;;;;1,0;;;;;;;;;;;5,0;;;;3,0;;;;;;;;;;;;;;;;;;;;;;;;;;;;;11,0;;;1,0;;;;;;;;;2,0;1,0;;2,0;;;;;;;;;
autofocus;;;5,0;;37,0;;6,0;26,0;4,0;15,0;2,0;1,0;;;;;;;;1,0;5,0;80,0;;2,0;;;;15,0;1,0;7,0;12,0;43,0;42,0;7,0;21,0;;;13,0;;1,0;14,0;;4,0;27,0;;2,0;;1,0;63,0;1,0;30,0;5,0;;10,0;;120,0;16,0;;2,0;111,0;2,0;3,0;31,0;;;6,0;4,0;;;55,0;16,0;2,0;7,0;;;2,0;;10,0;28,0;2,0;;11,0;4,0;;;;7,0;;2,0;6,0;17,0;1,0;;18,0;1,0;;;;21,0;1,0;4,0;85,0;;8,0;;1,0;2,0;46,0;;;1,0;3,0;6,0;;2,0;5,0;;;2,0;4,0;;;4,0;7,0;;;13,0;10,0;5,0;3,0;5,0;;;;;3,0;1,0;;;2,0;;;1,0;18,0;1,0;2,0;4,0;3,0;;;;6,0;;;;;1,0;7,0;;3,0;;;1,0;1,0;;2,0;;10,0;;2,0;8,0;;29,0;20,0;3,0;;1,0;7,0;;;;;;2,0;;;2,0;6,0;;63,0;;1,0;;10,0;;;;;;3,0;;6,0;;6,0;;;;;3,0;;;3,0;;;3,0;4,0;;;;;;;;;1,0;2,0;5,0;;;1,0;;;1,0;;23,0;1,0;;6,0;28,0;;5,0;;4,0;4,0;;;;;1,0;29,0;;;;21,0;;;;5,0;;;;3,0;;;1,0;;2,0;;;;;;;1,0;;1,0;1,0;;6,0;1,0;2,0;2,0;;19,0;;1,0;5,0;12,0;20,0;1,0;;;;2,0;;;;2,0;3,0;;;;15,0;;;;;7,0;;;4,0;5,0;;;;;;2,0;;;4,0;2,0;;;;;;;;;5,0;1,0;;;;;;;;;;2,0;;3,0;1,0;2,0;;;;7,0;;3,0;7,0;;;;;2,0;;2,0;2,0;1,0;;3,0;;4,0;;;;3,0;4,0;;;9,0;1,0;14,0;;;;3,0;;8,0;;2,0;;;;;;;8,0;2,0;;;;2,0;22,0;5,0;1,0;;2,0;;1,0;;;;;12,0;;8,0;;8,0;;1,0;;;11,0;;5,0;1,0;7,0;8,0;;1,0;16,0;;;;;7,0;;;;1,0;;;;;;;3,0;;;8,0;1,0;14,0;;;;3,0;;6,0;3,0;;;;1,0;;12,0;;;;1,0;;;1,0;7,0;8,0;;;;44,0;;;;;;;10,0;5,0;;;;;;;1,0;2,0;1,0;8,0;;57,0;;22,0;2,0;3,0;;;;;;;2,0;3,0;;;;;;;;;;;1,0;1,0;3,0;;;;;;;;;;1,0;;;1,0;;;1,0;;;;;;;;;;5,0;;;3,0;;;;;;;;;;;;2,0;;6,0;17,0;;;2,0;;;7,0;;;;;;;;3,0;;3,0;;1,0;;;;11,0;;1,0;2,0;2,0;;;;1,0;1,0;;10,0;;;;;;;;;4,0;;;;;;;;;;;;;;1,0;;;;;;;;;;;;;;;;2,0;19,0;;;2,0;;2,0;;;2,0;;;;;;;;;1,0;;;;;1,0;;;;;1,0;;;;;;6,0;2,0;;;;;;;;;;;;;;;;;;;;2,0;;;;3,0;;;;;;2,0;1,0;;3,0;;;2,0;;;;;;12,0;;;4,0;2,0;4,0;;;;;;;;;;;2,0;;3,0;;;3,0;;;1,0;;;;;1,0;;;2,0;;3,0;;;2,0;;;;;4,0;;;;;;;;;;;;;;;;;;;9,0;;;;;;;;3,0;;;;;;;;25,0;;;;;;;;;;;;;;;;;1,0;;2,0;;;1,0;2,0;;;;;;9,0;;;;;;;;;;;;;;;;2,0;6,0;;;;;;;;;;;;;;;;;2,0;1,0;;;5,0;;;;;;;;;5,0;;;;;;3,0;;;;2,0;;;;1,0;;;1,0;;;;;;;;;;;;;;;;;;;;;;3,0;;;;;;;;;;;;;;;;;;;;;;;1,0;2,0;;;;;;;;;;;;;;;;;;;;;;1,0;;;;;;;;2,0;;;;8,0;;;;;;;;;;;;;;;;;;2,0;;;;;;;;3,0;1,0;;;;;;;;;;;;;
automatic;;;3,0;6,0;8,0;;7,0;10,0;6,0;30,0;;;;;4,0;1,0;4,0;1,0;3,0;;19,0;84,0;1,0;1,0;3,0;;;11,0;;10,0;38,0;10,0;58,0;;28,0;;;18,0;;4,0;1,0;;12,0;5,0;;;;21,0;55,0;1,0;35,0;3,0;;7,0;;97,0;32,0;;;11,0;5,0;1,0;67,0;;1,0;3,0;21,0;1,0;;54,0;19,0;5,0;;;;3,0;1,0;23,0;24,0;;3,0;1,0;;;;;11,0;;;20,0;22,0;1,0;1,0;26,0;5,0;1,0;;1,0;;1,0;14,0;62,0;;1,0;;19,0;1,0;90,0;;;;;6,0;2,0;;7,0;;;;12,0;;1,0;1,0;6,0;;;3,0;;4,0;5,0;;;;;1,0;;;;1,0;;;;;6,0;1,0;;5,0;2,0;1,0;;;17,0;5,0;;;3,0;;3,0;1,0;18,0;;;;1,0;;;5,0;10,0;;;7,0;1,0;26,0;11,0;3,0;2,0;1,0;3,0;;;;;1,0;;1,0;;;17,0;;9,0;;;;6,0;;;;;5,0;;;1,0;;6,0;;;;;9,0;2,0;2,0;;;;3,0;6,0;;;;;3,0;1,0;;;;;1,0;;;;;2,0;3,0;;18,0;;;1,0;4,0;3,0;2,0;;;9,0;;;;;;;;;;2,0;1,0;;;1,0;;;3,0;15,0;;;;;1,0;;2,0;;;;2,0;;;;;;;1,0;;1,0;;7,0;;15,0;1,0;8,0;3,0;;;;2,0;2,0;;4,0;1,0;29,0;;;;;5,0;2,0;;;;20,0;;;;;;2,0;2,0;;;;;;;1,0;6,0;15,0;;1,0;;;2,0;;1,0;1,0;1,0;;;;1,0;2,0;;;;4,0;;;;;4,0;2,0;;;1,0;;2,0;;;;;;;1,0;;;;;2,0;1,0;;;;;2,0;2,0;;1,0;;;4,0;;;;2,0;3,0;;2,0;;;;;;14,0;;2,0;;;8,0;4,0;2,0;4,0;8,0;1,0;8,0;;1,0;;2,0;;2,0;5,0;5,0;3,0;;2,0;;;1,0;;1,0;;2,0;;;;;10,0;133,0;;;20,0;;4,0;2,0;4,0;;;;;2,0;1,0;1,0;;1,0;1,0;;;1,0;11,0;1,0;;;1,0;;10,0;;;;;1,0;;;;1,0;;2,0;;;5,0;3,0;;6,0;;;14,0;;;2,0;;;;2,0;;;;;;;1,0;;15,0;;23,0;1,0;69,0;1,0;;16,0;6,0;;;;;;;2,0;;2,0;;;26,0;;;;;;1,0;2,0;;;;;;;;;;;4,0;10,0;;;1,0;;1,0;;;;19,0;;6,0;1,0;;;3,0;6,0;8,0;;;;2,0;;;1,0;;;;;;;;;9,0;4,0;;;3,0;;;1,0;;1,0;;;1,0;;2,0;;;;;;2,0;;;2,0;;;3,0;;;;;2,0;;;;;1,0;;;2,0;;;;81,0;;;;;;;;;;;;;;;;;3,0;;;6,0;;;;;;;;;2,0;;26,0;20,0;3,0;2,0;;;;;4,0;;;;;;;;;;;;;;;;;;;;;;;;;;;;;;;;;;2,0;;;;;;;;1,0;17,0;;;;;;;;;;1,0;;;10,0;4,0;;2,0;;;;;;;;;7,0;;;1,0;1,0;;;;2,0;;;;;;2,0;;1,0;;;;4,0;;;;5,0;1,0;;;;;1,0;;2,0;;;;;;;;;;;;;;1,0;;;;;7,0;;1,0;;;;;;;;;;;3,0;1,0;6,0;;1,0;40,0;;;1,0;;1,0;;;3,0;3,0;;;;;;;1,0;1,0;3,0;;1,0;;;;;;;1,0;;1,0;;;;;1,0;7,0;;;;;;;;;;;;;;;;;;;;;;;;;1,0;1,0;;;2,0;1,0;1,0;;;;;;;;;;;;4,0;;;;;;;;;;;;;;2,0;;1,0;;;;;;;;;;;;;;;;;;;;;;;;;1,0;;5,0;;;;;;1,0;;1,0;1,0;;;;;2,0;;;;;;;;1,0;;;;;;;;;;;;;;;;1,0;;;;;1,0;;;;;;;;;;;;;4,0;;;;;;;;;8,0;;;1,0;;;;;6,0;;;;;;;;;;;;;;;;;;;;;;;;;1,0;;
average;;;15,0;;6,0;;2,0;92,0;183,0;13,0;12,0;;;8,0;82,0;10,0;;2,0;21,0;3,0;6,0;10,0;1,0;17,0;10,0;;6,0;45,0;;8,0;;77,0;10,0;57,0;16,0;1,0;;13,0;15,0;1,0;16,0;;;11,0;5,0;5,0;;;13,0;7,0;19,0;24,0;2,0;46,0;3,0;317,0;31,0;;25,0;14,0;6,0;;70,0;;2,0;;17,0;;;;1,0;;;;;4,0;;16,0;21,0;8,0;;12,0;6,0;11,0;1,0;;51,0;;6,0;18,0;12,0;;;79,0;;2,0;;;12,0;4,0;4,0;10,0;;;4,0;;20,0;17,0;1,0;;;;2,0;;;3,0;;;;4,0;2,0;;1,0;9,0;;7,0;12,0;;2,0;;;14,0;;;1,0;9,0;;;;1,0;3,0;;;3,0;20,0;3,0;16,0;31,0;1,0;;33,0;;;;2,0;;;;11,0;9,0;;1,0;;;;;68,0;53,0;;7,0;2,0;;2,0;;10,0;;;59,0;2,0;;;;1,0;;;;;113,0;;34,0;;;;3,0;;;10,0;;;;;8,0;16,0;;;1,0;;;3,0;;9,0;;;;3,0;84,0;1,0;;;;4,0;;;3,0;1,0;;;;;;;;1,0;39,0;13,0;4,0;;11,0;25,0;;;;14,0;2,0;;4,0;20,0;;;;6,0;;;;;1,0;;1,0;5,0;;4,0;;;;;;2,0;;;;;;;33,0;;1,0;1,0;;;;;;;;;23,0;;24,0;;;;;;3,0;;;;3,0;;;;;35,0;;;;;9,0;;;17,0;24,0;;;;;;;;;;5,0;;;4,0;7,0;;3,0;13,0;;1,0;2,0;;;;8,0;;;;1,0;;20,0;;1,0;11,0;;12,0;;;11,0;;1,0;23,0;2,0;;;;3,0;;;17,0;1,0;;;1,0;;;4,0;2,0;;2,0;;;41,0;3,0;5,0;6,0;23,0;;1,0;2,0;;5,0;8,0;4,0;2,0;5,0;10,0;;;;;;;;15,0;;5,0;32,0;11,0;;;4,0;4,0;32,0;5,0;;4,0;6,0;;;;;8,0;;1,0;16,0;;9,0;;1,0;2,0;;;1,0;;;;7,0;2,0;1,0;;;;;;;;;;;;;5,0;;;;1,0;;;;;15,0;2,0;;;1,0;;3,0;;3,0;;;4,0;;;;;6,0;;6,0;5,0;;;;6,0;;;;1,0;;;;;;;3,0;1,0;;7,0;;1,0;9,0;;2,0;2,0;10,0;1,0;;1,0;;;1,0;;;;1,0;1,0;4,0;;;;;10,0;;;;;;4,0;;;21,0;;;1,0;;;1,0;;;1,0;;;1,0;1,0;;;;;;7,0;;;;1,0;;;;;3,0;;;;;;;;;19,0;220,0;;;;;;7,0;;;;;;;;;;;;;;;;10,0;3,0;;;;;1,0;61,0;;;;;17,0;;;;;;;;16,0;;;;;;;;;;;;;;;;;3,0;;;1,0;2,0;;;;;;;;;;3,0;2,0;;;;;;;;;;;1,0;2,0;;2,0;;11,0;;;;;;;;2,0;;;;;;;3,0;;;;;;;;1,0;11,0;1,0;;26,0;;3,0;;;;112,0;3,0;;;;8,0;;;;1,0;;33,0;;;3,0;;4,0;;;;;1,0;;;;16,0;3,0;;2,0;1,0;1,0;5,0;;;;2,0;;;;5,0;;;;;;;13,0;;;16,0;3,0;;;;3,0;2,0;;28,0;;;6,0;;1,0;4,0;51,0;1,0;8,0;;;;2,0;;5,0;;3,0;5,0;;;3,0;;1,0;10,0;2,0;;1,0;4,0;2,0;1,0;1,0;;;;;58,0;9,0;;;;;;2,0;;;;;;;;;;;;;;;1,0;;;1,0;;;;2,0;;;4,0;;;;;;;;;;9,0;;;4,0;;;2,0;;;;;;;3,0;25,0;;;;1,0;;;;;1,0;3,0;;;4,0;;;;;;;7,0;8,0;8,0;;1,0;;;;6,0;;;;;;1,0;;;;;;;;;;2,0;;11,0;;;;;;;;;;1,0;;1,0;;;4,0;1,0;;;;;;;;;;;;;;5,0;;2,0;;;;;;;;;;;13,0;;;;3,0;;1,0;;;;3,0;;;;1,0;;;;;;4,0;;4,0;4,0;2,0;;;;;;;;;;;1,0;;;;;;;;;;;3,0;;;;8,0;;;;;;;1,0;1,0;;7,0;;;;;;;;2,0;;;;;;;;;;
axial;;;2,0;;9,0;;8,0;;1,0;;12,0;;;;;;;;;;32,0;1,0;;2,0;3,0;;;;9,0;3,0;1,0;3,0;10,0;3,0;5,0;;;295,0;14,0;1,0;72,0;;20,0;54,0;;;;1,0;1,0;;;1,0;;8,0;13,0;38,0;21,0;;32,0;179,0;;1,0;6,0;;;;47,0;;;1,0;230,0;;;;4,0;;2,0;1,0;46,0;;3,0;;;;;;8,0;;;1,0;1,0;;;;;13,0;;;;2,0;33,0;10,0;;;;;;119,0;;;2,0;5,0;;;1,0;;;;6,0;3,0;2,0;5,0;1,0;2,0;;;;;;9,0;1,0;;;;;;10,0;;;;;;2,0;3,0;6,0;4,0;24,0;21,0;;3,0;;37,0;21,0;;16,0;18,0;4,0;11,0;2,0;8,0;1,0;3,0;5,0;8,0;;1,0;;9,0;1,0;2,0;28,0;;27,0;4,0;34,0;4,0;3,0;;;;;;;;7,0;13,0;5,0;9,0;;22,0;;;;2,0;;11,0;;;11,0;;;3,0;;49,0;15,0;;3,0;;3,0;21,0;;5,0;;2,0;4,0;4,0;;2,0;;16,0;4,0;;1,0;;;;;;;;3,0;;11,0;;1,0;1,0;;;;;14,0;2,0;2,0;;;1,0;;;6,0;14,0;;9,0;2,0;9,0;3,0;1,0;10,0;3,0;;2,0;;6,0;;3,0;5,0;;8,0;;;;;2,0;;;3,0;;1,0;;37,0;;1,0;5,0;;7,0;1,0;5,0;19,0;24,0;2,0;1,0;3,0;3,0;1,0;;;31,0;;;;4,0;;;;4,0;1,0;;4,0;3,0;;1,0;;2,0;1,0;;4,0;;;1,0;4,0;;2,0;;56,0;6,0;;3,0;;8,0;1,0;1,0;;;;;;;;;;;2,0;;;;;;;;;;;;;;;;;;;;;;;;;;;;2,0;;;2,0;;;;;;;12,0;5,0;;;;;;;;;;;;;14,0;;3,0;;;;;17,0;;;;;;;;9,0;;2,0;;3,0;;;;;;;;;2,0;;;;;;;;;;;;;;;;;;;;;;;;;;;;;;;;1,0;;;;;;;;;;;;;2,0;7,0;;;;;5,0;;;;;2,0;;;;;;;;;9,0;;;;2,0;;;;2,0;1,0;1,0;;;;;3,0;;;;2,0;2,0;;;;;11,0;;;;;1,0;;;;;;1,0;1,0;;;;;1,0;;;;;;;;;;;;;;;;10,0;;;;;;;;;;;;;2,0;;4,0;;;;;;1,0;;20,0;;;;;;;;;;;;;;;;1,0;;;1,0;;;;;;;;;3,0;;;;;3,0;;;;;;;;;;;4,0;;;;;;;;;;;;;2,0;;1,0;;;;;;3,0;;2,0;3,0;7,0;5,0;;;;;;;;3,0;;;;28,0;;;;;1,0;2,0;;1,0;;;;;;;3,0;;;;;;;;11,0;;51,0;;;;;;;;;1,0;;;;;;;;;2,0;;;;;;15,0;;;;;;;;;;;;;;;;;;;;;;;;;1,0;;;;;;;;26,0;;;;;;;;;;;;;;;;;;29,0;;;1,0;;;;;;1,0;;;;;;;;;;;;;;;;;;1,0;;;;;;;;;;;;;;;;;;;;;;;;;;;;;;;;;;11,0;;;;;2,0;;;;;;;;;;;;;;;;;;;;;;;;;;;;;;10,0;2,0;;;;;3,0;;;;;;;;;4,0;;;10,0;3,0;;;;;;;;;;;1,0;;;;;;6,0;;;9,0;2,0;4,0;7,0;1,0;;;;;;;;;;;;;;1,0;;;;;;;;;;;;;;;;;;;;;;;;;;;;;;;;;;;;2,0;;;;;;;;;;;;;;2,0;;;;1,0;;;;;;;;11,0;;;;;;;;;;;;;;;;;;;;;;;4,0;;;;;;;;;;;;;
balance;;;3,0;;7,0;;3,0;35,0;34,0;14,0;1,0;1,0;;4,0;109,0;6,0;6,0;1,0;3,0;;5,0;93,0;2,0;49,0;35,0;8,0;;29,0;;3,0;1,0;25,0;44,0;2,0;18,0;;;6,0;;3,0;6,0;;1,0;1,0;;6,0;1,0;1,0;20,0;1,0;1,0;3,0;;3,0;;173,0;23,0;1,0;;5,0;;;41,0;;;12,0;3,0;;;18,0;2,0;4,0;2,0;;;2,0;;4,0;19,0;;4,0;20,0;4,0;15,0;;;1,0;;;4,0;2,0;;9,0;37,0;1,0;;;5,0;11,0;;7,0;21,0;;;;;4,0;30,0;;1,0;;1,0;5,0;;5,0;;;5,0;;3,0;;;;11,0;;1,0;12,0;;5,0;;;;;;;3,0;10,0;;;2,0;;;3,0;1,0;2,0;18,0;9,0;10,0;1,0;;9,0;;;;;;;19,0;2,0;11,0;;5,0;5,0;1,0;;;1,0;22,0;2,0;1,0;;;8,0;10,0;3,0;;1,0;22,0;;;;1,0;;11,0;;;21,0;9,0;;1,0;;;;5,0;;1,0;;;2,0;;;6,0;;;;5,0;;;3,0;7,0;3,0;;;;3,0;9,0;;1,0;;1,0;3,0;;4,0;;;;1,0;;;;4,0;;;;62,0;2,0;;3,0;11,0;5,0;;1,0;;1,0;;;3,0;;;;;6,0;;;;;;9,0;;1,0;1,0;;3,0;10,0;4,0;;1,0;;;1,0;;2,0;;;1,0;;;;;;2,0;;;10,0;;;5,0;8,0;3,0;1,0;;;;4,0;;;;9,0;;1,0;5,0;;9,0;;;;1,0;5,0;2,0;;7,0;;1,0;;;5,0;;;;1,0;;2,0;;;;8,0;;;;;;;;;;;;;;;;2,0;;7,0;;;;;;;;;6,0;;;3,0;;;;;;;;;;;1,0;;;;2,0;;;9,0;;11,0;;4,0;;;;;1,0;;;;;4,0;;2,0;;;;;2,0;2,0;;2,0;;2,0;;;2,0;2,0;;;;6,0;;1,0;;9,0;;;1,0;;3,0;;7,0;;1,0;;;1,0;9,0;;17,0;1,0;;8,0;1,0;3,0;;;;1,0;;;;1,0;;;;;1,0;5,0;2,0;3,0;1,0;;;2,0;;29,0;;1,0;;;9,0;;;;;;;4,0;1,0;;35,0;;4,0;53,0;;;;;;;;;;;;;;;;;;18,0;;;12,0;;33,0;;;;1,0;;;;3,0;4,0;8,0;;;;;;;;;;2,0;;;;;;;;;;;;1,0;;2,0;;;;;;;37,0;;;;;;2,0;;;;1,0;;;;;4,0;;;2,0;;1,0;1,0;;;;25,0;;;;;;17,0;;;;5,0;1,0;;;;;6,0;;;;;;2,0;5,0;;2,0;;;;6,0;3,0;;;;2,0;1,0;;;1,0;;;;80,0;;;;;;;;;2,0;;;;;24,0;;;1,0;;;1,0;;;;;1,0;;;;;;123,0;;;;;6,0;;;1,0;;2,0;;;;;;;3,0;;;;1,0;;;;;;;;;;;1,0;;;;;;;;;;;;80,0;;;;;3,0;3,0;4,0;;;3,0;;;;;1,0;;;;;;1,0;;;;;;;;;;;;;;;;;;;;;;;;;;;;;;;4,0;7,0;;;;;;;4,0;1,0;;1,0;;;;;2,0;;;;;;1,0;;;;;;;;1,0;8,0;;;;;;;;;;1,0;;;;;;2,0;12,0;9,0;;;;;;;;;;;;;;;;;;;;2,0;;;;;;;;;;;;;;;;;;;;;4,0;1,0;;;;3,0;;;;1,0;;;2,0;;12,0;;;;;;;;;6,0;;;1,0;;;;;;;;2,0;3,0;;;;;;;2,0;;;;;;;;;;;2,0;;;;;;;;2,0;;1,0;;;;;;;;;;;;;;;;;2,0;;;;;1,0;;1,0;;;4,0;;;;;;;;;;;;2,0;;;;;;;;;;;;;;;;;;;;;;6,0;;1,0;;;;;;;;2,0;;;;;;;;;;;;;;;;;;;;;;;;;3,0;;;;;;;;;;;;;;;;;;;;;
band;;;2,0;;35,0;;;8,0;1,0;6,0;8,0;5,0;;;50,0;;1,0;;3,0;10,0;;11,0;;;1,0;1,0;;5,0;;13,0;3,0;4,0;16,0;7,0;31,0;1,0;16,0;;;;10,0;1,0;;9,0;;;;43,0;10,0;87,0;2,0;9,0;;;12,0;90,0;36,0;;23,0;90,0;3,0;8,0;34,0;;;;2,0;;;;30,0;;6,0;;;;;15,0;1,0;;;32,0;1,0;7,0;;;34,0;;;20,0;20,0;;;31,0;4,0;1,0;;7,0;6,0;1,0;8,0;41,0;;;1,0;;;16,0;;;;6,0;17,0;12,0;2,0;;;8,0;;2,0;;;;1,0;;4,0;20,0;;9,0;4,0;;;;;;3,0;4,0;;;3,0;14,0;;;3,0;131,0;;5,0;1,0;;;8,0;;;;;;;1,0;6,0;17,0;1,0;;;;;;;139,0;;3,0;;;13,0;;3,0;4,0;;2,0;;;;4,0;72,0;;;13,0;1,0;74,0;3,0;16,0;;;53,0;7,0;;;;;;4,0;1,0;4,0;3,0;9,0;;5,0;;;3,0;;;;;;;57,0;13,0;;;;;;1,0;11,0;;364,0;;;2,0;;;;;;5,0;5,0;;1,0;7,0;;;;1,0;8,0;;2,0;12,0;2,0;;;;29,0;;2,0;;;;1,0;1,0;;;;;;;;;;;;;;;;;7,0;;;1,0;4,0;;;;1,0;;;12,0;19,0;3,0;;6,0;1,0;10,0;1,0;;;;;;;;;24,0;;;;;5,0;1,0;;;8,0;;;;;;;;;;1,0;;;;3,0;;;2,0;;3,0;;;;;;;1,0;;;;29,0;;1,0;;;;;;9,0;4,0;;2,0;;;;1,0;;;;3,0;;2,0;;;;;;;;;;2,0;11,0;2,0;2,0;1,0;5,0;;;2,0;;7,0;;2,0;2,0;4,0;;2,0;;;5,0;;;9,0;;;30,0;;;;;;;;;;1,0;;1,0;3,0;;;2,0;5,0;;;;2,0;1,0;1,0;;;5,0;19,0;2,0;;3,0;;8,0;;7,0;;;;;1,0;;;;;;;;14,0;4,0;;1,0;;;;;;1,0;;;;;8,0;;;;;;;;;;13,0;;;16,0;;;;;;;;;1,0;;;;;;;;;14,0;;10,0;3,0;5,0;1,0;;;;;3,0;;;;;1,0;;;;1,0;;;;;;1,0;;;;;;;;6,0;;;;;1,0;;;;;;;;;;;;;;;;4,0;;;;;;;;;;;7,0;;3,0;;;;17,0;;;;;;2,0;;;;;;;;;;;;;;1,0;;;;;;;;;;5,0;;;;;;;;2,0;;1,0;;8,0;;;;;;;;;;;;9,0;;;;;2,0;;;8,0;1,0;;;;2,0;17,0;;;;;;19,0;;5,0;;;;;;;;;;;;;;2,0;;;;;;;;;;;;;;;;;;;;;;;;34,0;;;;;;;;3,0;;2,0;;;;;;;;2,0;;;;;38,0;;38,0;;;;1,0;1,0;;1,0;;6,0;8,0;;;;;;;;;;;;;;;;1,0;;;;3,0;;1,0;;;;;;;;;26,0;;;;;;;27,0;;;;;;1,0;;;;4,0;11,0;8,0;;;;;;;;;;;;3,0;;;;;;;;;;;;;;;;;;;;;;;;;;;;;;;;;;;;;;;7,0;;;;;;;2,0;;;;;;;;;;;17,0;1,0;8,0;1,0;5,0;;;;;;;;1,0;;;;;;;;;;;;12,0;;;;;;;;;;1,0;;3,0;;;;;;;;2,0;;;;4,0;;;;2,0;;8,0;;;;;;;;;;;;1,0;;;;;;2,0;;;;;;;;;;;9,0;;;;;;;;;;;;;;;;97,0;3,0;;;;;;77,0;;;;;1,0;;;;;;;;;;;;;;;;;;;;;24,0;;;;;;2,0;4,0;;;;;;;;;1,0;;;;;;;;8,0;4,0;;;;;;;;;2,0;;;;;
basis;;;42,0;5,0;9,0;;18,0;6,0;27,0;23,0;4,0;16,0;6,0;;46,0;1,0;;;36,0;3,0;27,0;69,0;13,0;36,0;19,0;10,0;1,0;73,0;5,0;85,0;78,0;63,0;33,0;28,0;18,0;3,0;;31,0;3,0;40,0;22,0;1,0;28,0;1,0;4,0;2,0;;15,0;55,0;22,0;2,0;20,0;3,0;4,0;;337,0;17,0;1,0;12,0;70,0;;6,0;22,0;;6,0;4,0;8,0;1,0;1,0;30,0;28,0;5,0;1,0;;;8,0;;23,0;83,0;;;18,0;7,0;22,0;1,0;1,0;20,0;;4,0;11,0;20,0;17,0;7,0;94,0;13,0;1,0;;8,0;12,0;3,0;6,0;30,0;;6,0;;7,0;;45,0;;;1,0;3,0;1,0;;3,0;7,0;;;;11,0;;;1,0;1,0;;2,0;18,0;;25,0;1,0;3,0;;;;1,0;12,0;4,0;;;;;7,0;2,0;33,0;1,0;1,0;5,0;31,0;1,0;;;;;;10,0;2,0;;5,0;2,0;11,0;;;;;;;10,0;37,0;2,0;1,0;16,0;;2,0;6,0;15,0;;;37,0;;;;;;7,0;;14,0;;34,0;;8,0;;;;6,0;3,0;;;;7,0;;;3,0;;3,0;;1,0;4,0;1,0;2,0;;1,0;;3,0;1,0;1,0;49,0;5,0;;;;;5,0;24,0;;;;;;;;;;1,0;;8,0;11,0;;8,0;21,0;3,0;1,0;;5,0;;;4,0;;;;2,0;;;;4,0;3,0;;;3,0;;1,0;6,0;22,0;1,0;;;;;;;;;1,0;;4,0;;2,0;;;5,0;2,0;;;;17,0;;6,0;1,0;42,0;5,0;;2,0;;1,0;6,0;;;;12,0;;;;;13,0;;;;;14,0;4,0;;20,0;9,0;;;;;;;;;;14,0;3,0;1,0;;13,0;;;2,0;2,0;7,0;;;1,0;;4,0;;1,0;3,0;5,0;;3,0;;;13,0;1,0;5,0;1,0;;15,0;;11,0;10,0;12,0;;1,0;;7,0;;;5,0;11,0;;;12,0;4,0;1,0;;33,0;;14,0;;;7,0;1,0;2,0;4,0;;;4,0;13,0;2,0;2,0;3,0;4,0;9,0;;5,0;1,0;3,0;;3,0;4,0;;;5,0;5,0;11,0;2,0;1,0;12,0;;;;10,0;1,0;1,0;8,0;1,0;;1,0;;;1,0;;;20,0;;13,0;4,0;1,0;;;3,0;15,0;;3,0;11,0;5,0;8,0;2,0;;;1,0;;1,0;;;;2,0;;;;;;9,0;1,0;6,0;3,0;8,0;;;20,0;;;5,0;6,0;5,0;7,0;;4,0;2,0;2,0;;;3,0;;;17,0;;7,0;39,0;;;1,0;13,0;;;;1,0;2,0;;;;2,0;2,0;1,0;6,0;5,0;26,0;;8,0;7,0;;2,0;4,0;4,0;11,0;;;;;;3,0;3,0;2,0;;;;;;;;4,0;5,0;1,0;;3,0;;6,0;;;3,0;;;;1,0;;1,0;;3,0;1,0;;;4,0;;;1,0;;2,0;;2,0;;;;;;1,0;3,0;;2,0;;;;;;;;;20,0;59,0;;3,0;;;;8,0;2,0;;4,0;;;2,0;;;;;;;1,0;;;36,0;1,0;;;;;2,0;1,0;1,0;;;2,0;;3,0;;;;;;;25,0;;;;10,0;;;;;4,0;;;;;;;;;2,0;;1,0;;;;1,0;;;;;;2,0;11,0;;;8,0;;;;;;;;;5,0;5,0;2,0;;;14,0;;;;;;;;4,0;;6,0;;;;;1,0;19,0;;;4,0;5,0;;;;;;3,0;;;1,0;1,0;;1,0;7,0;2,0;;;;8,0;;4,0;;;;3,0;;1,0;;3,0;6,0;1,0;;1,0;;;;2,0;;4,0;2,0;;6,0;;2,0;2,0;;2,0;2,0;4,0;;;11,0;2,0;;;;;3,0;;2,0;;5,0;6,0;4,0;2,0;;;1,0;;;4,0;;;3,0;1,0;;12,0;2,0;;;;4,0;;;1,0;3,0;3,0;1,0;2,0;;;1,0;10,0;1,0;11,0;;;;;;9,0;;;;;1,0;23,0;;2,0;;1,0;1,0;;5,0;;;2,0;1,0;8,0;;6,0;;;;;7,0;;;;;;;;;;;;;4,0;;;;;3,0;;;3,0;;1,0;;;2,0;1,0;;;;;;;5,0;;3,0;3,0;;;;;;;;;;;;1,0;;;;;;;;;;3,0;;3,0;;;;;;;;;;;;2,0;;;;;;;;4,0;;;;;;;;;;;;;;;;5,0;;2,0;1,0;;;;;6,0;;;;;;;;;;;;;17,0;;6,0;2,0;;;;;;;;1,0;;;1,0;;;3,0;;;;;;7,0;;;;;;1,0;2,0;;1,0;4,0;;;;;;;;;;;;;;;;;;;;;;;6,0;;;;;;;;;;;;6,0;;1,0;;;;;;4,0;;;1,0;;;;;;;
beam;;;14,0;;23,0;;80,0;22,0;2,0;8,0;7,0;6,0;;;1,0;2,0;;;29,0;;14,0;42,0;;5,0;;;;2,0;9,0;18,0;3,0;12,0;100,0;;20,0;18,0;115,0;94,0;;11,0;7,0;2,0;7,0;34,0;;;;1,0;32,0;4,0;2,0;25,0;;8,0;2,0;245,0;49,0;;8,0;196,0;;;76,0;1,0;4,0;2,0;14,0;2,0;5,0;;253,0;4,0;578,0;;7,0;;;17,0;110,0;2,0;16,0;1,0;2,0;50,0;;16,0;36,0;;;3,0;163,0;13,0;5,0;39,0;1,0;9,0;11,0;;4,0;;99,0;153,0;;;;2,0;;42,0;;;26,0;69,0;4,0;48,0;12,0;;;1,0;1,0;7,0;;;6,0;;;5,0;44,0;1,0;1,0;5,0;;3,0;4,0;;2,0;19,0;30,0;;8,0;58,0;7,0;3,0;;3,0;24,0;;68,0;27,0;;2,0;;;55,0;1,0;1,0;;1,0;3,0;108,0;150,0;72,0;1,0;3,0;3,0;3,0;;2,0;823,0;;;32,0;139,0;102,0;19,0;4,0;7,0;1,0;31,0;;;;;67,0;;11,0;51,0;24,0;63,0;4,0;48,0;;;41,0;182,0;;217,0;3,0;;10,0;4,0;;4,0;8,0;25,0;;1,0;;;;18,0;23,0;5,0;1,0;;9,0;13,0;41,0;6,0;11,0;3,0;;6,0;;38,0;;15,0;5,0;;4,0;;2,0;;;3,0;13,0;27,0;27,0;22,0;21,0;2,0;3,0;1,0;27,0;2,0;;;;28,0;;;;4,0;;10,0;;;2,0;21,0;3,0;9,0;21,0;2,0;;;1,0;;17,0;;;;1,0;8,0;;;8,0;;;;13,0;21,0;;;;9,0;;12,0;2,0;69,0;3,0;7,0;22,0;12,0;8,0;1,0;;5,0;;28,0;;;7,0;;12,0;29,0;11,0;;2,0;7,0;;1,0;5,0;9,0;15,0;;2,0;;12,0;;1,0;;;2,0;2,0;;;99,0;2,0;;;;1,0;3,0;;;;;;1,0;2,0;4,0;;7,0;;8,0;;;;;;4,0;3,0;;;13,0;;3,0;1,0;;;;6,0;2,0;5,0;;1,0;10,0;;;2,0;3,0;1,0;2,0;;29,0;;;1,0;;;47,0;;4,0;;;12,0;8,0;;3,0;;70,0;;11,0;;1,0;6,0;;;61,0;1,0;3,0;5,0;;5,0;1,0;;2,0;;4,0;;3,0;7,0;5,0;7,0;17,0;;;2,0;;82,0;302,0;21,0;;;3,0;1,0;;;;;1,0;8,0;2,0;;;;5,0;;3,0;;;;;;;1,0;6,0;12,0;22,0;;;;;19,0;3,0;;;1,0;;2,0;;;;3,0;;;8,0;7,0;1,0;3,0;;;8,0;3,0;;4,0;;;;;;;;;;;19,0;29,0;;;8,0;;6,0;;1,0;94,0;38,0;117,0;;;;;;;4,0;45,0;;;5,0;1,0;;;;;;;1,0;;;;;;26,0;3,0;;;2,0;5,0;;2,0;37,0;1,0;;2,0;;;;1,0;;;;;;;;;;;;;57,0;;;;;;;6,0;;1,0;9,0;;;;;18,0;;31,0;1,0;1,0;;;;;;;;;;2,0;;;;91,0;;3,0;;;;;;;1,0;;20,0;;1,0;1,0;;;3,0;;;8,0;11,0;2,0;;1,0;1,0;;;;;8,0;;1,0;;;;2,0;;;;;11,0;11,0;;;;10,0;;;;15,0;4,0;16,0;;;;;;;;2,0;;;;;;7,0;;23,0;43,0;;;;;;;5,0;14,0;6,0;;;;16,0;2,0;;;1,0;4,0;;;;;2,0;6,0;;;;;;;;3,0;17,0;;;4,0;;;;;1,0;;2,0;;;2,0;12,0;;;7,0;;1,0;20,0;3,0;;;;;;8,0;;23,0;;;;;;;4,0;;;2,0;;5,0;;;1,0;;2,0;;4,0;;;;;;;;6,0;9,0;;;;;6,0;33,0;4,0;;116,0;10,0;;;;;;;6,0;14,0;;5,0;;1,0;2,0;;;;;;;;;8,0;2,0;1,0;;;;;;;1,0;1,0;;;;3,0;;;;2,0;;;;;;1,0;;;;;;1,0;;;26,0;;12,0;;;;;;;1,0;2,0;26,0;;;;;;;2,0;37,0;5,0;;12,0;1,0;;;5,0;;;;;;12,0;;4,0;;3,0;27,0;;;;;;;;;;2,0;;;;;;;;;1,0;;14,0;;;;;;;;4,0;;10,0;;;;;;10,0;;;;;;;;3,0;;;;;;;;;;;6,0;;;;;;;;;1,0;;;5,0;;;;4,0;7,0;;;6,0;;;3,0;;;1,0;;;3,0;;;;;;1,0;;1,0;2,0;;1,0;;;3,0;;;;;;2,0;;;2,0;;;;;1,0;;;29,0;3,0;;;;;;;;;;;1,0;42,0;;;;;;12,0;;;;;;2,0;204,0;;;;;;;;;;4,0;;;;
become;;;19,0;;7,0;;22,0;6,0;11,0;6,0;29,0;;;1,0;18,0;;;;2,0;;5,0;7,0;1,0;5,0;9,0;1,0;;6,0;;8,0;7,0;15,0;17,0;6,0;8,0;;;40,0;4,0;12,0;13,0;;;3,0;7,0;2,0;;1,0;11,0;;1,0;2,0;;13,0;2,0;56,0;;4,0;3,0;11,0;7,0;3,0;4,0;16,0;;3,0;8,0;;;4,0;15,0;2,0;;;6,0;1,0;;16,0;38,0;3,0;2,0;6,0;2,0;;;;13,0;;;;9,0;;12,0;6,0;6,0;1,0;;1,0;;;5,0;26,0;;;1,0;;;6,0;;;;1,0;7,0;;2,0;;;;;4,0;;;2,0;4,0;;;5,0;;2,0;;1,0;;;;;1,0;;4,0;;1,0;;;;14,0;1,0;;3,0;2,0;;;;;;;1,0;;;;4,0;12,0;14,0;3,0;;;;;10,0;8,0;2,0;;1,0;1,0;3,0;;10,0;;2,0;4,0;;;;3,0;;;1,0;2,0;1,0;12,0;;12,0;;;;;;;;;;2,0;;;;2,0;;1,0;;;1,0;1,0;;;;1,0;2,0;9,0;;;;1,0;;2,0;;5,0;2,0;2,0;;;1,0;;;;;5,0;;2,0;;;16,0;;;;4,0;;1,0;;;;;;;;;;;;;;3,0;;;3,0;;;;;1,0;;;;;10,0;;;1,0;;;;;2,0;;;;;;;5,0;10,0;1,0;2,0;;;1,0;4,0;;3,0;;7,0;;;;;25,0;;;;;4,0;;;13,0;1,0;;;;;;;;;;1,0;;;;;;;;;2,0;;;;;;;;;;;;;1,0;6,0;;;3,0;;3,0;8,0;1,0;1,0;3,0;;1,0;;2,0;;;1,0;;;;;1,0;;;1,0;;;;5,0;3,0;;4,0;;2,0;;2,0;3,0;1,0;;;4,0;1,0;;1,0;;5,0;;;;2,0;;2,0;7,0;5,0;3,0;4,0;2,0;;;;7,0;2,0;;2,0;;4,0;;4,0;;;;;;;8,0;4,0;9,0;;;;5,0;;;1,0;8,0;;;;;;;;;;;2,0;;;1,0;;;;;;;;;1,0;16,0;4,0;;;;;1,0;;;;;11,0;;12,0;;;5,0;;2,0;1,0;;;;;1,0;;;2,0;;;;;;;8,0;3,0;;;;1,0;6,0;;1,0;21,0;;;1,0;;;;;;2,0;;;;;;1,0;;;4,0;1,0;4,0;;;2,0;2,0;;;;;;8,0;;;;1,0;;;;;;;1,0;;1,0;;;;;;;;;;;;;;;;1,0;;1,0;;;3,0;8,0;;1,0;;;;3,0;;;;;;;;;;;;;;;;1,0;;;5,0;;;;;;;;;;1,0;;;;;;;5,0;;;5,0;;;;;;;;;;;;;;;;;;;;;1,0;;;;;1,0;;2,0;;;;;;;;;1,0;;2,0;;;;;;1,0;;;;;;;;4,0;;1,0;;;;;;7,0;;;;4,0;;1,0;2,0;1,0;;;;;;;;9,0;;;;;;;;;2,0;;;;;;;;;;;;;;;;1,0;;;;1,0;;;;;;;1,0;;;;;;;;;1,0;;;;;1,0;;;;13,0;;;;;;;5,0;;;4,0;1,0;;;;;;;;;;;;;;;;;;;;;;;;5,0;;1,0;;3,0;5,0;5,0;1,0;;;;;;;;2,0;;;;6,0;;;19,0;;;;;;;;;;;4,0;;;;;;;;;20,0;;;;;;1,0;;3,0;1,0;;;1,0;;;;;1,0;;;;;;;;;;;;;;;;;;;;;;;1,0;;;;;1,0;;;;;;;;;;;;;;;2,0;;;;;;;;;;2,0;;;;;;;;;;;1,0;;;;2,0;;;;;;;;;;;;;1,0;;;;;;;1,0;;;;;;;;;;;;3,0;;;;;;;;;;;;;1,0;;;;;;2,0;;;;;;;;;;;;;;;;;;;;2,0;;;;;;;;;;;;;;;;;;;;;;;;;;1,0;;;;
bias;;;5,0;;18,0;;10,0;10,0;4,0;17,0;5,0;;;;1,0;;;;26,0;;;36,0;5,0;1,0;6,0;;;1,0;1,0;2,0;1,0;4,0;101,0;3,0;17,0;;;65,0;;;;;21,0;34,0;;;;;2,0;;8,0;28,0;;;;12,0;28,0;;;66,0;8,0;;19,0;;;3,0;8,0;;2,0;4,0;9,0;;;;;1,0;;4,0;37,0;;5,0;;1,0;;;;7,0;1,0;;2,0;5,0;;;15,0;;;;5,0;11,0;26,0;25,0;44,0;;;;;;31,0;;;14,0;9,0;;5,0;3,0;;13,0;;17,0;12,0;;1,0;4,0;24,0;;;34,0;7,0;;5,0;14,0;;;8,0;;1,0;12,0;;;;6,0;;;2,0;;78,0;1,0;20,0;;;;4,0;5,0;6,0;3,0;10,0;7,0;11,0;2,0;5,0;;2,0;7,0;;;1,0;1,0;;7,0;1,0;202,0;22,0;18,0;14,0;11,0;11,0;7,0;15,0;;;2,0;2,0;;;5,0;1,0;13,0;9,0;;10,0;;1,0;;4,0;;;;8,0;13,0;;5,0;;;6,0;4,0;2,0;18,0;1,0;14,0;16,0;;;7,0;;2,0;9,0;1,0;2,0;;4,0;;;2,0;;2,0;;;;;;;3,0;2,0;2,0;8,0;4,0;;25,0;1,0;;9,0;;3,0;;;1,0;14,0;;;4,0;15,0;10,0;1,0;12,0;;;3,0;;1,0;;;3,0;;15,0;17,0;6,0;3,0;2,0;2,0;;;;;;;;;13,0;1,0;1,0;35,0;4,0;;22,0;;1,0;10,0;2,0;4,0;1,0;;2,0;;;;2,0;;5,0;;;1,0;;9,0;2,0;2,0;;;3,0;;3,0;6,0;2,0;5,0;20,0;9,0;;1,0;;10,0;;;2,0;3,0;;;6,0;;66,0;15,0;;;3,0;1,0;;;;;;;;;;;;;;;;;1,0;8,0;;;;;;;;2,0;;;;;16,0;;1,0;;;12,0;;;;;2,0;;;;;;6,0;11,0;1,0;;;1,0;4,0;;;;;3,0;1,0;5,0;;8,0;;;;;;;;;;;2,0;5,0;;;;;;2,0;;;;;;5,0;;5,0;1,0;;1,0;3,0;2,0;;10,0;;;;;;;;;;;;;1,0;;;;;;;;;4,0;;;;35,0;;;;;;;;;;;;;29,0;;1,0;;;1,0;2,0;;;;1,0;;;;;3,0;;;;9,0;;1,0;2,0;1,0;;22,0;1,0;1,0;;2,0;;53,0;;;;;;;1,0;;;;;;;;;;;4,0;;;;;;1,0;5,0;;;;;;1,0;;;;;;;27,0;;;;;;;;;;;2,0;;;;;;;1,0;;;;3,0;;;23,0;2,0;;;;;2,0;;;;;;;;;;;;;;;;;;;1,0;;;;;;;;2,0;;10,0;;;;;;;;;1,0;;;;3,0;;;;;;;;;;;;9,0;;;1,0;;;;1,0;;;;;4,0;;;10,0;;2,0;4,0;;;;;2,0;;;;;;;;;;;;;;4,0;;3,0;10,0;;;;6,0;9,0;1,0;;;1,0;5,0;;;;;2,0;;;;;13,0;;;;;6,0;;;;2,0;;1,0;;;11,0;2,0;20,0;;;2,0;;1,0;2,0;;;;;;;;;;;2,0;;;29,0;1,0;;;;;;;;;;;;;;;;;2,0;;;;;;;;;;;1,0;;;;;;;;1,0;;;;9,0;;1,0;;;1,0;;;;;;;;1,0;1,0;1,0;;;2,0;;;1,0;1,0;;;;;;;;;;;;;;;;;;;2,0;;;;;;;;;;1,0;;;;;;;;;1,0;1,0;;4,0;;;;;;;;;;;;;2,0;;;;;;11,0;;;;;1,0;;1,0;;;3,0;2,0;;;;;;;;;;8,0;;;2,0;;;;2,0;;1,0;;;;3,0;;;;;;;;;2,0;;;;;1,0;1,0;;;;;;;;3,0;;;;;;;;;;;;;;;;;;;1,0;;;15,0;;;2,0;;;;;;;;;;;;;;;;;;;;;;;;;;;;;;;;;;;;;;;;;;;;;;;;;;7,0;;;9,0;;;;;;;;;;;;;;;;;;;;;;;;;
blade;;;2,0;;1,0;;1,0;19,0;;4,0;30,0;;;;;;;;;;;11,0;;;;;;;12,0;;;1,0;20,0;1,0;1,0;;;11,0;;;;;33,0;15,0;;;;;;;9,0;;;;1,0;10,0;18,0;;;20,0;;;16,0;;;4,0;14,0;;2,0;36,0;4,0;2,0;9,0;;;;1,0;;92,0;;1,0;;;;;;;;;;5,0;;;5,0;;5,0;;;1,0;;12,0;;;;;;;1,0;;;;7,0;;24,0;1,0;;50,0;;;2,0;1,0;;;2,0;;;15,0;;;46,0;1,0;;;;;;18,0;;;;;;1,0;;32,0;9,0;29,0;26,0;;;;;25,0;;1,0;;7,0;;;;;;;;;4,0;1,0;24,0;;;19,0;8,0;60,0;9,0;5,0;39,0;;;1,0;;;21,0;18,0;;11,0;8,0;19,0;33,0;;20,0;;2,0;;4,0;1,0;;;;12,0;;;13,0;7,0;5,0;;;;;1,0;8,0;;4,0;;2,0;;;3,0;3,0;;;1,0;;;;4,0;;;;4,0;;1,0;11,0;15,0;1,0;1,0;;;;;;4,0;;7,0;;;4,0;4,0;1,0;;3,0;;;;30,0;;;;1,0;;;;21,0;;3,0;31,0;;19,0;;;;;;1,0;2,0;;;;;;18,0;;3,0;3,0;24,0;;1,0;36,0;;3,0;2,0;;1,0;10,0;;1,0;1,0;;;;4,0;;3,0;;;;;;;;;;;1,0;;;;;2,0;1,0;;;;10,0;;;2,0;;17,0;;;;;;;;;;;;;;1,0;;;;;;;2,0;4,0;42,0;;;;;;;;;;;;;;;;;;;;;;;;1,0;;;;;3,0;;1,0;;;2,0;;;;;;;2,0;9,0;;329,0;1,0;4,0;3,0;1,0;;;;;;;;;;;;18,0;;;;;1,0;;;;;6,0;;;;;;2,0;;;;;;;;;;;;;;;;;;;1,0;;;;;;;;;7,0;;;;1,0;;;;;;;;13,0;;;;;2,0;;;;22,0;2,0;;;;;;;;;21,0;;;;;;;2,0;1,0;;;;;;;;;;;46,0;;;;;4,0;;;;;;;;;;;;2,0;;;;;4,0;;;;;;3,0;;;;;;;;;;;1,0;;;;1,0;;;;;;;;;1,0;;;;;;;;;;5,0;;;;;;;;;;1,0;;;12,0;;;;;;;;;;;;;;;;3,0;;;;;;;1,0;;;;;;;;;;;;;;2,0;;;;2,0;;;;;;;;;;;18,0;;;2,0;;;;;;;1,0;1,0;;;;;;;2,0;;1,0;;4,0;;;;;5,0;;;;;;;;;;;;;;;;;;1,0;;;;;3,0;;;;;;;;;;;;;;;;;;;;1,0;;;;;;;;1,0;;;;;;;;5,0;;;;;;;;;;;1,0;;;;;;;;;;;;;4,0;;;;;;;;;;;;;;;;;3,0;;;;3,0;2,0;;;;;;;;;;;;4,0;;;;;;;;;;;;;;;;;;;;;;;;1,0;;;;1,0;;;;;;;;;;;4,0;;;;;;;;;;;;;;;;;;;;6,0;;;;;;;;1,0;;;;;;;;;;;;;;;2,0;2,0;;;;;;;;;;;1,0;1,0;;;;;;;;;;;;;1,0;14,0;;;;;;;;;;;;;;;;;;;;;;;;;;;;;;;;;;;;;;;;;;;;;;;;;;;;;;;;;;;;;;;;;;2,0;;;;;;;;;;;;;;;;;;;;;;;;;;37,0;;1,0;;;;;;;;;;;;;;;;;;;;;
block;;;7,0;;42,0;;24,0;33,0;55,0;11,0;15,0;;16,0;24,0;24,0;;4,0;1,0;11,0;3,0;3,0;123,0;13,0;7,0;1,0;;3,0;104,0;11,0;28,0;30,0;51,0;47,0;10,0;20,0;19,0;3,0;23,0;3,0;8,0;2,0;4,0;4,0;12,0;6,0;4,0;;1,0;11,0;13,0;;33,0;1,0;12,0;2,0;212,0;66,0;4,0;2,0;66,0;1,0;4,0;49,0;8,0;2,0;4,0;7,0;12,0;1,0;17,0;97,0;3,0;13,0;1,0;;1,0;;8,0;98,0;4,0;;67,0;2,0;;;1,0;20,0;1,0;13,0;16,0;9,0;;;42,0;54,0;18,0;;3,0;17,0;7,0;50,0;31,0;;3,0;;;4,0;121,0;1,0;;3,0;16,0;7,0;13,0;10,0;;16,0;;3,0;2,0;;;6,0;21,0;3,0;;35,0;8,0;2,0;5,0;13,0;;;1,0;;20,0;14,0;;;4,0;;2,0;6,0;11,0;28,0;3,0;64,0;104,0;;;;4,0;16,0;;2,0;5,0;11,0;13,0;3,0;32,0;15,0;1,0;5,0;3,0;;15,0;8,0;159,0;;14,0;32,0;8,0;29,0;39,0;19,0;19,0;;18,0;;;;2,0;7,0;;20,0;2,0;8,0;118,0;2,0;43,0;;15,0;3,0;33,0;15,0;2,0;;;1,0;17,0;;8,0;11,0;14,0;3,0;7,0;;;12,0;26,0;;2,0;;1,0;5,0;17,0;13,0;6,0;5,0;2,0;5,0;;;7,0;12,0;13,0;5,0;;2,0;2,0;;;2,0;11,0;29,0;4,0;;12,0;96,0;4,0;26,0;10,0;;12,0;;2,0;3,0;16,0;3,0;17,0;4,0;37,0;4,0;29,0;7,0;;;28,0;;3,0;50,0;;16,0;;7,0;3,0;9,0;2,0;3,0;;1,0;1,0;;;1,0;2,0;;;8,0;27,0;3,0;2,0;;22,0;1,0;24,0;13,0;13,0;5,0;8,0;15,0;3,0;11,0;1,0;;3,0;2,0;11,0;;;1,0;;42,0;;3,0;7,0;3,0;5,0;4,0;10,0;28,0;13,0;2,0;;2,0;;12,0;;;2,0;27,0;1,0;2,0;3,0;;26,0;12,0;3,0;2,0;8,0;9,0;;4,0;;;;;;1,0;;1,0;7,0;;5,0;1,0;2,0;18,0;5,0;4,0;30,0;4,0;4,0;13,0;4,0;;;3,0;;;;12,0;2,0;;;2,0;2,0;15,0;;10,0;1,0;4,0;1,0;;5,0;2,0;31,0;4,0;;;16,0;3,0;3,0;1,0;1,0;;2,0;6,0;18,0;;4,0;;2,0;;;13,0;2,0;4,0;17,0;17,0;1,0;;;6,0;6,0;44,0;;1,0;8,0;1,0;;19,0;2,0;;16,0;;2,0;12,0;;4,0;;9,0;2,0;1,0;5,0;7,0;;;9,0;3,0;4,0;14,0;;1,0;;;3,0;;;;;2,0;;;1,0;;32,0;3,0;5,0;16,0;11,0;2,0;18,0;1,0;3,0;;3,0;1,0;;;;;1,0;;;;10,0;1,0;;34,0;;2,0;41,0;;;;;3,0;;;;1,0;;1,0;;;7,0;;2,0;;56,0;;5,0;;;18,0;4,0;3,0;;;;;1,0;;3,0;10,0;1,0;;2,0;;;2,0;;;29,0;11,0;7,0;14,0;;;;;;2,0;1,0;;;;1,0;;7,0;2,0;1,0;12,0;;2,0;1,0;1,0;1,0;;;;6,0;;7,0;;;;;;;23,0;2,0;3,0;;4,0;2,0;5,0;2,0;;37,0;239,0;;;;;;20,0;;2,0;;;3,0;2,0;;6,0;4,0;3,0;;3,0;;;14,0;24,0;4,0;;28,0;3,0;;;3,0;;1,0;;;;11,0;;;2,0;;;;2,0;2,0;;;;3,0;;;;8,0;;;;;;;;1,0;18,0;2,0;1,0;11,0;4,0;;;;;1,0;;;3,0;6,0;;;27,0;7,0;18,0;;;;;3,0;;9,0;;;;;16,0;2,0;2,0;;1,0;1,0;;;8,0;;;7,0;;4,0;7,0;4,0;2,0;3,0;14,0;;;;;;3,0;;2,0;6,0;;;;;14,0;8,0;;;;;;;;;;;2,0;;;4,0;1,0;2,0;2,0;;;;21,0;1,0;;;;45,0;;;;53,0;;;;;;;;2,0;7,0;;;3,0;;12,0;;;;1,0;12,0;;;;;4,0;;;13,0;;;2,0;;;2,0;11,0;6,0;23,0;;5,0;1,0;1,0;;2,0;2,0;1,0;;;4,0;1,0;;;3,0;17,0;;;;;31,0;;;;;1,0;9,0;;;;;;23,0;;;;23,0;;;;;;;2,0;6,0;;;;;;;;;;;;;;;;;;60,0;;2,0;;;;4,0;;;;;;;;;;;;2,0;;2,0;;1,0;;;;;;;;16,0;2,0;;2,0;2,0;;;;;;3,0;2,0;;;;;3,0;;1,0;12,0;1,0;1,0;2,0;;;;12,0;6,0;1,0;;9,0;;2,0;3,0;95,0;;8,0;;5,0;3,0;;;2,0;;;1,0;;;;;2,0;;;;5,0;;;4,0;19,0;;2,0;;;;;;;;;;;4,0;;;;;;;7,0;;1,0;;;1,0;;;;;;1,0;;;;;;;;;;14,0;;4,0;;;1,0;2,0;;;;;;2,0;;47,0;12,0;;1,0;;;;;;;;2,0;;;;;;1,0;;1,0;;;;1,0;;;;;1,0;;;;;;12,0;;;;;;;;;;
blue;;;1,0;;5,0;;;2,0;2,0;10,0;;5,0;;;85,0;13,0;;;37,0;;4,0;2,0;;1,0;6,0;;2,0;16,0;;1,0;3,0;6,0;11,0;2,0;11,0;;;;;1,0;1,0;;;14,0;;;;;4,0;8,0;;24,0;;3,0;;100,0;21,0;;4,0;6,0;1,0;;20,0;;;;;;;;3,0;5,0;;;;;;;2,0;;;2,0;;7,0;;;7,0;;7,0;7,0;10,0;2,0;;44,0;;7,0;;;;;;2,0;;1,0;;;3,0;3,0;4,0;5,0;3,0;2,0;15,0;1,0;;5,0;;;;;;;;1,0;;4,0;4,0;1,0;3,0;7,0;;;;;;;7,0;;1,0;7,0;;;;;30,0;1,0;1,0;;2,0;;178,0;;;;;;;;2,0;14,0;;2,0;;;;15,0;1,0;111,0;;3,0;2,0;;2,0;;;;;8,0;;;;;;;;1,0;;8,0;;12,0;;;1,0;8,0;;;;;;;;;;;;2,0;;;;2,0;;;;;;;1,0;;;;;;;2,0;;15,0;;;;;;;;;5,0;;;4,0;3,0;;;;;;;;32,0;8,0;;;;;;;;;;;1,0;;;;;;;;;;;;;;;;;;;;;;;;;;;;;1,0;;;;;;;;;;;;;;;;;;;;8,0;;;12,0;8,0;;;;;;;;;;1,0;;;;3,0;;;;;1,0;;;;;;;;;;;;;;;;;;;1,0;;;;;;;1,0;;;;;;;;;;;6,0;;;;;;;1,0;;1,0;;;;;;5,0;;1,0;;;;;3,0;;;;;;;;1,0;1,0;;;;;;;;;;;;1,0;1,0;;1,0;;;;;;;;;;1,0;4,0;;;;3,0;10,0;;;;;;;;;;;;;;;;;;6,0;;;;;;3,0;;;;;;;;;;;;;;;;;;1,0;;;1,0;;;;;;;;;;;;4,0;;;4,0;;;;;2,0;;;;;2,0;;;;;;;;;;;;;;2,0;1,0;;;;;;;;;;;3,0;;;5,0;;;;;;;20,0;;;;;;;;;;;;;;;;;;1,0;;;;;;;59,0;;;;;;;;;;;;;;;;;;;;;;;;;;;;15,0;;;;;;8,0;16,0;;;4,0;;;;;;;;;;;;;;;;;;;;;;;;3,0;3,0;;;;;;;;;;;;;1,0;;;;;;;;2,0;;;;;;1,0;;;;;;;;;1,0;;;;;;;;;;4,0;;;;;;;;;;;;;;;;;;;;;;;1,0;;;;;;;;;;;;;;3,0;;;3,0;;3,0;3,0;;;;;;;;;;;;;;;;;;;;;;;;;;;;7,0;;;;;;;2,0;;;;;;1,0;;1,0;;;;1,0;;8,0;9,0;4,0;;;;;;;;;;;;;1,0;;;;;;;;;2,0;;;;;;;;;;;;;;;;;;;;;;;4,0;;;;;;;;;;;;;;2,0;;;;;;2,0;;;1,0;;;;;;;;;10,0;;;1,0;;;;;;;;;4,0;;10,0;;;;;;;;1,0;;;;;;;;;;1,0;;;;;;;;1,0;;;;;;;;;;;;;;;;;;;;;;;;;;;;;1,0;;;;;;8,0;;;;;;;;;;;;;2,0;;;;;;2,0;;;;;;;;;;;;;;;;;;;;;;;;;;;;;;;;;;;4,0;;;;;;;;;;;4,0;;;1,0;;;;;;;;;;;;;;;;
blur;;;104,0;;48,0;;32,0;88,0;27,0;65,0;8,0;;;3,0;;5,0;5,0;34,0;23,0;5,0;2,0;67,0;4,0;248,0;762,0;;28,0;36,0;6,0;86,0;44,0;48,0;156,0;51,0;38,0;;;21,0;5,0;14,0;14,0;;35,0;15,0;;;;14,0;10,0;1,0;48,0;39,0;;3,0;4,0;904,0;40,0;;12,0;168,0;4,0;1,0;47,0;;5,0;;35,0;;10,0;56,0;114,0;1,0;;;;2,0;;7,0;14,0;4,0;13,0;20,0;24,0;21,0;;;2,0;;4,0;45,0;7,0;;6,0;54,0;;;;4,0;12,0;;;117,0;;;1,0;;;275,0;;;;2,0;1,0;;3,0;;;;;104,0;;;9,0;1,0;;;66,0;;2,0;1,0;;3,0;;;;14,0;3,0;;;;;;;1,0;6,0;;1,0;63,0;;;;;5,0;;2,0;;;2,0;;28,0;;6,0;;2,0;;;26,0;2,0;;;14,0;;8,0;;47,0;;;44,0;;;;;1,0;4,0;;6,0;;18,0;;109,0;;;;4,0;;;;;20,0;;;;;;;4,0;;1,0;;4,0;;;;;;82,0;4,0;;;;;;43,0;;;;3,0;;;;1,0;5,0;16,0;;14,0;5,0;;6,0;55,0;1,0;2,0;;1,0;;;1,0;;;;2,0;;;;;;;;9,0;6,0;;;8,0;8,0;;;;;;;;;1,0;;;;2,0;;;4,0;1,0;;;1,0;5,0;;153,0;3,0;31,0;30,0;1,0;;;;2,0;;;;9,0;;;;;41,0;1,0;;;;18,0;;;1,0;6,0;;;;;;;;;;3,0;1,0;;;5,0;;1,0;;;4,0;2,0;;2,0;;;;;2,0;6,0;;13,0;;13,0;;;8,0;45,0;;30,0;;8,0;33,0;;;1,0;11,0;2,0;;1,0;17,0;;1,0;;1,0;7,0;;4,0;;;64,0;;;2,0;5,0;3,0;1,0;4,0;;4,0;3,0;2,0;1,0;2,0;;35,0;3,0;17,0;2,0;28,0;;2,0;4,0;;;5,0;12,0;1,0;28,0;;;;4,0;;4,0;9,0;19,0;5,0;4,0;4,0;1,0;;;8,0;;5,0;;;2,0;;1,0;;;1,0;132,0;;2,0;5,0;4,0;6,0;1,0;;;;;1,0;;;;1,0;;;;;;27,0;;;5,0;;;6,0;5,0;;1,0;6,0;1,0;2,0;1,0;;5,0;;;34,0;;;4,0;;6,0;;;97,0;;;;;;;1,0;;;;;;;1,0;1,0;9,0;13,0;9,0;;25,0;;14,0;12,0;4,0;10,0;;;;;;1,0;;8,0;1,0;;;;;;;;;;1,0;;;;1,0;;;;;;;6,0;;1,0;;;3,0;;;1,0;;;2,0;;;;18,0;;;;;;2,0;;;;2,0;;1,0;;;12,0;;;27,0;63,0;;;;;;3,0;;1,0;4,0;;;;;;;;2,0;;;;;26,0;;;;;;;2,0;;;;;;;;;;;;;;;;;16,0;;;;;;;;;;;;;28,0;;;7,0;;;;;;;;;;;3,0;;;;;;1,0;;1,0;;;;;;;1,0;;2,0;;;;;;;;;;2,0;;;26,0;;1,0;48,0;;;2,0;;;;;1,0;;;1,0;;;;;11,0;;;;;;;;;;7,0;;2,0;;;2,0;5,0;2,0;2,0;;;;;;;;1,0;26,0;1,0;;;;;3,0;;21,0;;;;;;;;;;;;;;;9,0;;;;1,0;2,0;;;;;;;;38,0;4,0;4,0;;;;;;;;;;;;;;;;;2,0;3,0;;;4,0;;10,0;;;;;;;;;;;;;;6,0;;;;;;;;;;;;;;1,0;;;;;;;;;1,0;;;;;;;;4,0;;;6,0;;;;10,0;;1,0;;;;;;;2,0;6,0;;;;;;;;;;;;;;;;;;;;2,0;10,0;;;;;;;;;;;1,0;;;;;;2,0;;;;;1,0;;;3,0;2,0;;;1,0;2,0;;;;;1,0;;;;;;16,0;2,0;;;;;9,0;;;;;;;;;;;;;;;2,0;;;;;;2,0;;;;;;;;;;;;;;;;;;;;;;;;;;;;;;;;;;;;;;;;;;;;;;;;;2,0;;;;;;;;;;;;;;;;;;;;;;;;;;;;;
brightness;;;40,0;3,0;24,0;;2,0;96,0;71,0;24,0;5,0;12,0;;;55,0;;2,0;4,0;48,0;2,0;29,0;58,0;;7,0;11,0;;12,0;85,0;;89,0;32,0;74,0;62,0;144,0;28,0;;;5,0;;32,0;2,0;;;46,0;;9,0;;1,0;15,0;9,0;7,0;40,0;;15,0;;343,0;59,0;1,0;;10,0;;;57,0;2,0;2,0;;2,0;;2,0;8,0;3,0;;4,0;;;24,0;;11,0;10,0;;1,0;19,0;4,0;15,0;2,0;;80,0;1,0;13,0;9,0;19,0;;;61,0;13,0;2,0;;8,0;18,0;;10,0;18,0;;2,0;2,0;1,0;;77,0;;;4,0;;3,0;1,0;;3,0;1,0;;;8,0;;;8,0;4,0;;3,0;33,0;;33,0;;;;4,0;;1,0;12,0;;;1,0;8,0;1,0;5,0;8,0;24,0;13,0;;8,0;40,0;3,0;;;;;;;;;;7,0;24,0;8,0;29,0;;;;1,0;333,0;75,0;;;2,0;2,0;20,0;;19,0;1,0;;18,0;;;4,0;;1,0;;;1,0;2,0;90,0;;18,0;;;2,0;7,0;3,0;12,0;;;;;;;;4,0;;6,0;;3,0;2,0;;4,0;;;;;17,0;4,0;;;;9,0;2,0;;;;;;;;;;;;3,0;23,0;;;7,0;24,0;;;;8,0;;;1,0;;;;;;;;;10,0;1,0;;11,0;7,0;;13,0;2,0;8,0;;;;;;;;;3,0;;;;;;;5,0;1,0;;;;1,0;;1,0;1,0;86,0;4,0;;;;1,0;5,0;;;;23,0;;;1,0;;113,0;;;;;21,0;;;24,0;53,0;;;;;;;;;;;;;;9,0;;;5,0;;;9,0;;;;2,0;10,0;1,0;7,0;;;13,0;;7,0;;1,0;12,0;1,0;;50,0;2,0;;10,0;1,0;;8,0;4,0;;;;3,0;3,0;;;;34,0;2,0;;1,0;7,0;20,0;;2,0;74,0;1,0;8,0;5,0;4,0;;;6,0;2,0;9,0;1,0;4,0;5,0;6,0;14,0;1,0;6,0;;4,0;;;5,0;7,0;1,0;8,0;97,0;2,0;;;;33,0;;;;1,0;;;4,0;1,0;;3,0;;;;;13,0;;2,0;1,0;;;12,0;1,0;;;4,0;38,0;6,0;2,0;;;;;2,0;;;1,0;1,0;;1,0;6,0;;7,0;3,0;13,0;2,0;;;2,0;17,0;11,0;;;;;;;2,0;;5,0;14,0;;2,0;;;31,0;;;14,0;;;1,0;;;;2,0;;;1,0;;;6,0;;7,0;1,0;2,0;49,0;;2,0;;3,0;6,0;1,0;6,0;;;;;1,0;;3,0;9,0;;2,0;;;;;;;;;;;;;2,0;;;30,0;;;23,0;1,0;;;;;;;;;4,0;;;;;;;;;;;;;;;4,0;2,0;;1,0;;;;;;63,0;114,0;;;;;;4,0;;;;;;;;;;;;;;;;121,0;2,0;1,0;;;;2,0;;;;;;;;;;;;;;70,0;;;;;1,0;;;;;;;;;;;;;;;9,0;2,0;;;;;;;;;2,0;8,0;;;3,0;;;;;;;;;;;2,0;6,0;;14,0;12,0;;;;;;;4,0;;;;;;;;;;;;5,0;;2,0;;3,0;3,0;;71,0;;;;3,0;112,0;;4,0;;;2,0;;;;;14,0;2,0;3,0;;;1,0;;;3,0;2,0;;;3,0;;;;1,0;4,0;;7,0;2,0;;2,0;3,0;;;;;4,0;2,0;;;;1,0;;3,0;;3,0;1,0;2,0;22,0;;;;;2,0;2,0;1,0;17,0;;;5,0;;1,0;4,0;9,0;2,0;;;;;8,0;;;;1,0;;;2,0;;11,0;9,0;11,0;;3,0;;4,0;;19,0;;;;;;26,0;4,0;;;;;;;;;3,0;;;;;;1,0;;;;;;11,0;;;;;;;5,0;;;1,0;;;;;1,0;;;;7,0;;;;;9,0;;2,0;;;;11,0;8,0;;3,0;32,0;;;;;;;;;3,0;3,0;;;10,0;;;;;2,0;;2,0;;11,0;;;;;;;1,0;;;;;;;;;;;1,0;;;;5,0;;;;;;;;;;;;;;;;1,0;;;;;;;1,0;;;;;;;;1,0;6,0;;6,0;;;;;;;;;;2,0;;;;;;;;;;;2,0;;;;;;;;;;1,0;;;;1,0;;;;;;;;;;1,0;;;;;;;;;;;;6,0;;2,0;;;;;;;;;5,0;;;8,0;;;4,0;;;;;;5,0;;;;;;;;;
buffer;;;3,0;;14,0;;2,0;13,0;;14,0;;;;;17,0;1,0;;;7,0;;;10,0;;5,0;1,0;1,0;;115,0;;1,0;;14,0;31,0;;37,0;;;1,0;;18,0;10,0;;1,0;2,0;;;;;4,0;;3,0;30,0;1,0;3,0;;225,0;17,0;2,0;;4,0;2,0;1,0;22,0;;1,0;;6,0;;;5,0;3,0;3,0;;;;;;;2,0;1,0;1,0;18,0;20,0;;;;6,0;;1,0;3,0;1,0;2,0;5,0;61,0;8,0;11,0;;28,0;169,0;;4,0;19,0;;17,0;;;1,0;57,0;;;3,0;1,0;1,0;3,0;;;;;;;;;2,0;19,0;;;31,0;1,0;;8,0;2,0;1,0;;;;;1,0;;;;;;1,0;1,0;2,0;6,0;1,0;105,0;;;;;;;2,0;1,0;;4,0;1,0;10,0;;1,0;;;;;;2,0;6,0;;13,0;;6,0;;2,0;;1,0;54,0;;;;1,0;2,0;;;;1,0;25,0;;18,0;;1,0;;13,0;;;;;;;;;;5,0;;;3,0;;;;;2,0;;;;5,0;;;;;;6,0;2,0;;;;;;2,0;;;;;;;;;2,0;72,0;2,0;;;2,0;;;;;;;;;3,0;;17,0;;;;;;;4,0;2,0;;;;;;;;;;;;;;7,0;;;1,0;4,0;;;;2,0;;12,0;;1,0;;1,0;;;;5,0;;;;;;;3,0;;17,0;;;;1,0;2,0;;1,0;;;;;2,0;;;;;;;2,0;1,0;1,0;;5,0;;;2,0;;4,0;;;1,0;1,0;1,0;;1,0;;1,0;;;;1,0;;;;;;3,0;;1,0;;2,0;;1,0;;;;;;3,0;;;1,0;;1,0;;;;;;;3,0;7,0;161,0;2,0;1,0;;1,0;21,0;1,0;;3,0;;;;;;24,0;7,0;2,0;;;3,0;;;;2,0;;;;1,0;;;;;4,0;;;;3,0;;;1,0;5,0;;;72,0;;4,0;3,0;;;3,0;;1,0;17,0;3,0;3,0;6,0;;;2,0;1,0;;;;;;1,0;;3,0;1,0;;11,0;3,0;5,0;3,0;3,0;;;74,0;6,0;;1,0;;;4,0;;1,0;;;;;1,0;;;;;;4,0;1,0;;;;;;;;;3,0;;2,0;;;;;4,0;4,0;;;;;39,0;1,0;;4,0;5,0;15,0;1,0;19,0;;;;;;;;;;;;2,0;12,0;;;3,0;;;;;;;;;1,0;;;;;;1,0;;13,0;;;;;;;;1,0;;;;1,0;;;;2,0;;;2,0;1,0;;;;3,0;3,0;17,0;;;1,0;;;;;;1,0;;;;;;;;;;;;1,0;1,0;1,0;;1,0;;;;2,0;1,0;;;;;;;;6,0;;;;;;;;;8,0;;;;;;;;;;;;;2,0;;;2,0;;;;;;;;;;;;;;;;;;1,0;;;;;;;2,0;;;;;;;;;;;;;;;;;;;;;;;;;;;;;;;;1,0;;;1,0;;2,0;;;3,0;;;;1,0;;;;;1,0;1,0;;;1,0;6,0;;17,0;;;;;10,0;;;;6,0;;;;;;;2,0;;;;;1,0;;8,0;;;;;1,0;2,0;;;;;2,0;;;;;;;;;2,0;1,0;;;;;4,0;;;;;;;;;;;1,0;;;3,0;;;;;1,0;;;;;;;;;;;;1,0;;1,0;1,0;;;;;;;;;;;;;;;;;;1,0;;1,0;;;;1,0;;;;;;;;;;1,0;;;1,0;;;5,0;;;;;;;;;;;;4,0;;;;;;;1,0;;;;;;;;;2,0;;;;;;4,0;;;;;;;;;;;1,0;;;;1,0;;;;;;;;;;;;;;;;;;;;6,0;;2,0;;;;;;;;;6,0;;;;;;;;;;;;;;;2,0;;;;;;;;;;;;;;;;;;;;;1,0;;;2,0;;;;;;;;;;;;;;;;;;;;;;;;;;;;;;;;;;;;;;;;;;;;1,0;;;;;;;;;
cable;;;1,0;;57,0;;6,0;14,0;;4,0;4,0;;;;1,0;5,0;1,0;1,0;4,0;;;27,0;;;;;11,0;44,0;1,0;1,0;;;35,0;;20,0;;;1,0;;2,0;1,0;;11,0;1,0;;;;;;2,0;;1,0;;3,0;1,0;20,0;42,0;;9,0;21,0;;;13,0;;;10,0;3,0;;;1,0;3,0;;;;;;;;9,0;18,0;5,0;5,0;7,0;;;;2,0;;;2,0;8,0;;;23,0;1,0;3,0;;2,0;;24,0;15,0;24,0;1,0;1,0;;;1,0;9,0;;;9,0;7,0;;22,0;20,0;;;;;9,0;;;;4,0;;;9,0;5,0;;56,0;;2,0;;;;2,0;3,0;;;;;;3,0;;;1,0;5,0;1,0;;;;1,0;21,0;1,0;2,0;3,0;7,0;21,0;;3,0;;1,0;3,0;2,0;;1,0;16,0;2,0;;;6,0;;8,0;14,0;7,0;;2,0;7,0;3,0;;2,0;2,0;16,0;1,0;5,0;6,0;25,0;8,0;;29,0;;;;20,0;;;;;12,0;11,0;;5,0;;14,0;;;;2,0;;8,0;;;;11,0;21,0;;12,0;;;4,0;5,0;3,0;;;2,0;;;3,0;1,0;5,0;3,0;;17,0;2,0;5,0;;3,0;2,0;;;;;;8,0;;1,0;6,0;;;;;;1,0;92,0;;1,0;;4,0;;;;;2,0;;;;18,0;;;60,0;66,0;2,0;3,0;;4,0;5,0;;;1,0;3,0;5,0;;;;;2,0;2,0;;2,0;;;;;;;;;;;;5,0;3,0;2,0;8,0;11,0;;;;3,0;1,0;;;;;3,0;;2,0;7,0;;1,0;;;7,0;2,0;;;;1,0;5,0;;1,0;;4,0;;;;;2,0;;;;6,0;;;;;;5,0;1,0;3,0;;;2,0;;;;;;;;;;12,0;;;;;;;;;;;;;1,0;;;;2,0;;;1,0;;;;3,0;;;10,0;5,0;;;4,0;2,0;5,0;;;;;;;2,0;;;;;;;;3,0;6,0;2,0;;2,0;;;;2,0;;1,0;;;3,0;;1,0;;;;;;;2,0;;;6,0;1,0;;;;;;5,0;;;2,0;;4,0;;2,0;;;;;3,0;;;;;3,0;;;;;3,0;3,0;5,0;2,0;;;;1,0;7,0;;7,0;;;2,0;;;;;;;;19,0;;;;1,0;;1,0;;1,0;32,0;1,0;;1,0;1,0;;;;;;2,0;4,0;;;;;4,0;;;;8,0;16,0;55,0;;;;;6,0;;;;;3,0;;;2,0;1,0;;;;;;;1,0;;;;;;;9,0;1,0;7,0;;;3,0;;;2,0;;4,0;;5,0;2,0;1,0;;;;1,0;;9,0;;;;;;;2,0;1,0;;;1,0;4,0;;;;;5,0;3,0;;1,0;20,0;;;;;11,0;;;1,0;1,0;;2,0;;1,0;;;;;;7,0;;;;;;;;;;;;1,0;;1,0;;;;;2,0;;;1,0;;2,0;;;19,0;1,0;;;;;;1,0;;;;;2,0;;;;;;;;2,0;;1,0;2,0;;1,0;;;;2,0;;2,0;;;3,0;;1,0;;;;;3,0;;;;;;;;;;;;;;;;;;;;;;;;;;;;1,0;;;;;;;;;;;;;;;;;;;6,0;;;;;;;;;;;;6,0;;;1,0;;;;;;;;;;;;;;;;;1,0;;;;;;;;;;;1,0;;;;;;;;;;;;;4,0;;3,0;;;;;;;;;;;;;;;;;4,0;;;4,0;;1,0;;;;;;;;;;;;;;;2,0;;;;1,0;;;;;;;;;;;;;;;;;;;;1,0;;;1,0;1,0;4,0;;;;;;;;;;;;;;;;;;;;;;;;4,0;;3,0;;1,0;;;;1,0;;;;;;;;;;;;;;2,0;;4,0;;;;;;;;;;;;1,0;;;;;;;;1,0;;;;;;;;;;;;;16,0;;;;;;;;;;;;;;;;;;;;;;;;;;1,0;;;;5,0;;;;;;;;;;;;;;;;;;;;;2,0;;;;;;;;1,0;;;3,0;;;;;;;;;;;;;
calculation;;;41,0;3,0;14,0;;2,0;61,0;309,0;7,0;9,0;7,0;;2,0;26,0;4,0;;;11,0;3,0;9,0;58,0;8,0;5,0;14,0;2,0;6,0;43,0;;17,0;19,0;35,0;61,0;28,0;11,0;;;20,0;;13,0;19,0;2,0;4,0;5,0;2,0;9,0;;5,0;14,0;;15,0;14,0;;;;129,0;33,0;5,0;1,0;9,0;;;28,0;4,0;1,0;9,0;14,0;2,0;;5,0;12,0;2,0;1,0;;;10,0;;39,0;81,0;;;56,0;;;7,0;;14,0;;;8,0;5,0;1,0;3,0;26,0;10,0;1,0;;2,0;3,0;;;20,0;;;2,0;;1,0;293,0;;;2,0;1,0;;;;;;;;;;;;28,0;;;12,0;;1,0;;;;;;;;;;;7,0;;;1,0;14,0;2,0;;3,0;7,0;;;1,0;;;;;;;1,0;;25,0;;3,0;;;;;44,0;19,0;1,0;2,0;;;15,0;;13,0;;;28,0;;;;;;4,0;;1,0;;32,0;;21,0;;;;7,0;;;;;6,0;;;1,0;;6,0;;1,0;;;1,0;1,0;;;1,0;;;50,0;;;;;1,0;1,0;5,0;;;;;;;;;;;;12,0;22,0;;1,0;35,0;;;;18,0;;;2,0;;;;;1,0;1,0;;5,0;3,0;;;3,0;;;;;16,0;;;;;;;;;;;;;1,0;1,0;;1,0;2,0;;;;;;21,0;2,0;29,0;4,0;1,0;;1,0;;;;1,0;;20,0;;;;;25,0;1,0;;;;13,0;;;37,0;;;;;;;;;;;2,0;;;;1,0;;;11,0;2,0;;2,0;;4,0;;1,0;5,0;2,0;;2,0;;1,0;;5,0;8,0;;;2,0;;4,0;;;2,0;;;1,0;;2,0;;;5,0;;;1,0;3,0;11,0;;;;;;;;4,0;8,0;5,0;;;;1,0;9,0;4,0;1,0;6,0;2,0;15,0;;11,0;;7,0;;;;;5,0;18,0;9,0;11,0;12,0;5,0;;;2,0;4,0;13,0;13,0;;1,0;;;;2,0;;;;1,0;4,0;;9,0;;36,0;1,0;;;17,0;;2,0;1,0;1,0;6,0;;1,0;;;;;;;1,0;;;2,0;;5,0;;1,0;19,0;;;;1,0;39,0;1,0;20,0;;;7,0;;10,0;;;;;6,0;;;;;48,0;;;56,0;;;;2,0;;;;;;;;;;1,0;1,0;1,0;;10,0;;;2,0;2,0;2,0;1,0;;3,0;;1,0;;5,0;1,0;;3,0;;;;;;;;;2,0;2,0;1,0;;;2,0;5,0;;;4,0;;;14,0;1,0;;;1,0;;1,0;;;;12,0;;;;;;1,0;;;;;;1,0;;;;1,0;;;;;16,0;;;2,0;48,0;;;3,0;;;8,0;;;;;;;;;;;;;;;;14,0;;;;;;;;;;;;;;;;;;;;104,0;;;;;16,0;;;;;;;;;;;;2,0;;;14,0;3,0;;;;;;;;;;2,0;;;;;;;;1,0;;;;;;;;;8,0;;;;;;;;2,0;;;;;;;;4,0;;;;;;;;;1,0;;2,0;;;;;12,0;12,0;1,0;;;2,0;;;;;1,0;2,0;2,0;;;;1,0;;;;4,0;;;;;;;6,0;;7,0;2,0;1,0;;;;;;;;2,0;;;;3,0;;;;;4,0;;3,0;;;;;7,0;;;;1,0;;11,0;;3,0;3,0;;1,0;25,0;1,0;;;4,0;;;3,0;;;;6,0;;2,0;4,0;1,0;;;;3,0;;2,0;;;;2,0;;9,0;;2,0;;;;;;;;3,0;;1,0;;;;;;;;;;1,0;;;;;;;;;;5,0;;;;;;;;;;;;;;;;;;;;;;;;6,0;;;;;;;;;;;;;1,0;;;;;;;;;4,0;;;;;1,0;;;;;;;;;;;;;;;;;;;;;;;;;;;;;;;;;;1,0;1,0;;1,0;;;;1,0;;;;;;;;3,0;;;;;5,0;;;1,0;;;;2,0;1,0;;1,0;;1,0;;;;;;;;;;;3,0;;;;;3,0;;2,0;;3,0;;;;;;;;;;2,0;;;;;;;;;;;4,0;3,0;;;;6,0;;;;;;2,0;;;;;;2,0;;;;;;;;;;;;;;;;
calibrate;;;1,0;;17,0;;2,0;16,0;2,0;12,0;3,0;;;2,0;19,0;2,0;1,0;1,0;11,0;16,0;;2,0;14,0;2,0;1,0;;;29,0;2,0;11,0;;10,0;42,0;1,0;19,0;5,0;;2,0;;5,0;;2,0;;;5,0;;;1,0;1,0;;1,0;17,0;;;;49,0;16,0;1,0;;4,0;;;178,0;;17,0;;5,0;;;4,0;8,0;3,0;1,0;;;;;22,0;21,0;;;5,0;6,0;2,0;;;4,0;;;7,0;11,0;;;2,0;;;1,0;3,0;5,0;;4,0;95,0;;;;;;7,0;;;;5,0;3,0;6,0;;;;9,0;;4,0;;;;1,0;;1,0;10,0;5,0;2,0;;;;;;;13,0;;;;2,0;;1,0;;;3,0;;11,0;5,0;3,0;;7,0;;;;;;;;3,0;3,0;;1,0;;;;;;8,0;;1,0;4,0;2,0;14,0;4,0;;1,0;;3,0;;;;;2,0;;;1,0;1,0;11,0;;3,0;;;1,0;3,0;;2,0;;;1,0;;;;;;;5,0;1,0;;;;6,0;;;;;14,0;;1,0;;;;9,0;;;;2,0;2,0;;;;;;2,0;1,0;6,0;1,0;;2,0;;;;;;;1,0;;1,0;;;;;;;4,0;;;;5,0;;;;;1,0;;;;;;;;;;;;;;;;;1,0;;;2,0;;;2,0;1,0;21,0;4,0;;2,0;;;6,0;;;;;;;;;3,0;;4,0;;;34,0;;;51,0;;;;;;;;;;;1,0;;;;5,0;;;;2,0;5,0;;;;;;;2,0;;1,0;;8,0;;10,0;;;2,0;;3,0;;;;2,0;1,0;;;;;;;5,0;;;;2,0;;;;;6,0;;;;1,0;9,0;4,0;;;;;;7,0;;7,0;;;;;3,0;4,0;;3,0;;;;;;13,0;;;;2,0;;;2,0;1,0;;;;1,0;;1,0;;;;1,0;7,0;;6,0;16,0;1,0;;;;3,0;;;;1,0;8,0;;;;;;;;2,0;3,0;;;;;;3,0;;;1,0;;;;;3,0;;;;;;1,0;;;;;;2,0;6,0;5,0;;18,0;;;6,0;;;;;;;;;4,0;;;;;;;;;13,0;;;1,0;;15,0;9,0;;1,0;;;;;2,0;;;;;;4,0;;;;;8,0;;1,0;;;;;;;;;;;;;;;;;;2,0;;1,0;;;;;;;;;;;;1,0;;;5,0;;;;1,0;;3,0;;1,0;;3,0;;;;;;1,0;;;;;;;;;;;;;;;;1,0;;1,0;;;;;1,0;;;;3,0;;;;;2,0;;;;;;;;;;;;;;;;1,0;;1,0;;;;;;2,0;;;;;;3,0;;;;1,0;;2,0;;;3,0;;;;;;;;;1,0;;;;;;;;;;;;;;;;;;1,0;4,0;;;;;;;;;;3,0;;;;;1,0;;;11,0;61,0;;;;;;;;;;;;;1,0;;;;;;2,0;;;;;;9,0;;;;;;;;;;;;;;;1,0;;1,0;;;1,0;1,0;;1,0;;;;;1,0;3,0;;10,0;;;2,0;;;;2,0;;;;;;1,0;;2,0;2,0;;;6,0;;;;2,0;1,0;;;;;;1,0;;;;3,0;;;;;;;3,0;;1,0;;72,0;;;;;;;;;;;;;;;;;;;;;;;3,0;;;;;;;;;;;;;;1,0;;;;;1,0;;1,0;;2,0;;;2,0;;;;5,0;;;;;;;;;;;;;21,0;;;;;5,0;;1,0;4,0;;;;4,0;;;;;;;;;;;;;2,0;;;;;;;;;;;;5,0;;;;;;;;;;;;;;;;;;;;;;;;4,0;;1,0;;;;;;;;;;;2,0;;;;;;;;;;;6,0;;;;;;3,0;13,0;;;;;;;;;;;;;3,0;;;;;;;;;;;;2,0;;;;;;;;7,0;;5,0;;;;;1,0;;;;;;;;;;;;;;;;
candidate;;;3,0;;2,0;;;28,0;5,0;3,0;;9,0;;;20,0;8,0;;;;2,0;23,0;5,0;1,0;1,0;3,0;;;60,0;;26,0;12,0;43,0;58,0;1,0;14,0;;;9,0;;21,0;6,0;;;2,0;;3,0;2,0;;25,0;;2,0;17,0;;2,0;;174,0;15,0;;2,0;2,0;;;35,0;;21,0;;;;;2,0;2,0;;;;;;;59,0;5,0;;;16,0;;1,0;8,0;;20,0;4,0;3,0;55,0;;;;8,0;2,0;;;18,0;29,0;;46,0;4,0;;;;;;38,0;;;3,0;;;;;;;;;;;;;;;;11,0;;;1,0;7,0;6,0;;;1,0;4,0;;;;;;;;75,0;4,0;;;33,0;;;;;;;;;;;2,0;23,0;;;;;;;9,0;;;;;;11,0;;;;;8,0;;2,0;1,0;;;3,0;;;;39,0;;8,0;;;;11,0;;;;;1,0;;;2,0;;1,0;;;;;;2,0;;;;;;6,0;3,0;;;;1,0;1,0;;;;;10,0;;;;;;;;;;;5,0;31,0;;;;;;;;;;;;;5,0;;;;;;7,0;;;;;4,0;;;;;;;14,0;;;;;;1,0;;;;4,0;;;;;;8,0;1,0;52,0;5,0;;;;;6,0;;;;;;;;;4,0;;;;;;;;11,0;;;;;;;;;;;;;;;;;;;2,0;13,0;;;;;2,0;;;;;;23,0;;;;;2,0;;;;;;10,0;;;;3,0;;;;1,0;13,0;;;44,0;6,0;;;;1,0;7,0;;;;8,0;3,0;;;;;3,0;;;1,0;;3,0;3,0;3,0;5,0;8,0;;8,0;;;;2,0;;20,0;1,0;2,0;15,0;;3,0;;2,0;;;2,0;;;;;;;;;45,0;;11,0;;4,0;2,0;;;;;;;;4,0;1,0;;;;1,0;;;;;;;;;;;1,0;;;7,0;;;1,0;8,0;1,0;;;;;3,0;;;23,0;;;;1,0;;;2,0;6,0;;3,0;;;;;;;2,0;4,0;2,0;4,0;;;;;;12,0;;2,0;;;;;63,0;39,0;;;;;;;11,0;1,0;;;;;;;;;;2,0;;;;;8,0;;;;;;;;;;;1,0;;;;12,0;;;;;;;;;;;3,0;;;;;;44,0;;;;;;;;;6,0;17,0;;;;;;;;;;;;;;;;;;;;;1,0;3,0;2,0;;;;3,0;;9,0;;;;;;;;;2,0;;;;22,0;;;;;;;;;3,0;1,0;;;;;;;;;;;;;;;;2,0;;;;;;;;;;;;1,0;;;;;5,0;;;1,0;;16,0;;;;;;;;;;31,0;;;;;;;;;;1,0;;;;;;;3,0;;;;;;;;;;;;;;;;;2,0;;;;;;;;;;;53,0;;1,0;;3,0;;1,0;2,0;;1,0;;;;;;;6,0;;;;;;;;;1,0;;9,0;;;;;;1,0;;;;;;;;;;;4,0;;;;;1,0;;2,0;1,0;;;;;;;8,0;2,0;;;1,0;;;;;;6,0;2,0;;;;;;;;;;;4,0;3,0;;;;;;;;;;;;;;;;;;;;3,0;11,0;11,0;;2,0;;;;;;;;;;;15,0;;;;;;;;;;;;;;;;;;;;;;;;;;;;;;2,0;1,0;6,0;12,0;;;;;;;;;;;;;;;;;;;;;3,0;;;;;;;;;;;;;;;;;;;1,0;;1,0;;;4,0;;;;;;;2,0;;;;8,0;3,0;;12,0;;;;;;;;;6,0;;1,0;;;;;;1,0;;;;;;;;;;;2,0;;;;;;;;;;;;;;;;;;4,0;6,0;;;;;;;;;;;;;;;;2,0;2,0;;2,0;32,0;;;;;;;;;;;1,0;;;;;;;
capacitor;;;5,0;;2,0;;;5,0;;;;;;;2,0;;;;4,0;;;16,0;;;;;;15,0;;;8,0;;25,0;;2,0;;;;;1,0;;;;16,0;;;;;;;;5,0;;2,0;;9,0;12,0;;;;;;8,0;;;4,0;;;;8,0;;;3,0;;;;2,0;;1,0;6,0;;;;;;;21,0;;5,0;;1,0;;;36,0;;;;45,0;40,0;;;6,0;;20,0;;;6,0;40,0;;;8,0;8,0;;;4,0;;;;;;;;;50,0;;2,0;8,0;;;48,0;;;;;;;3,0;;2,0;4,0;42,0;;3,0;;;;11,0;1,0;;;;;;;17,0;;;;1,0;;;;;;;5,0;17,0;9,0;;;;1,0;2,0;3,0;;;;30,0;;;3,0;;;;;;;12,0;;3,0;;;;7,0;;;;;;;5,0;;;6,0;;;;;1,0;;;;;;;5,0;1,0;;;;;;;;;;;;;;;;1,0;;;;;1,0;;;;;;;;;;;;;6,0;;1,0;102,0;;;;1,0;2,0;;20,0;;;;;;;;;;;;3,0;1,0;;;;;;;;;;;;1,0;;;1,0;1,0;;;;;;;12,0;1,0;;;;;;;;;;;;;8,0;1,0;;;;;;;;;;;;;;;;;13,0;;;4,0;;;;24,0;;;1,0;;;;;;;2,0;;;;10,0;;;;4,0;;;12,0;;;;;;;1,0;;;;;18,0;;;;;;;4,0;;6,0;;17,0;11,0;6,0;1,0;;3,0;4,0;;4,0;;;;;;;;;1,0;;;;;;;;;;;;;;;;24,0;;;;;;19,0;;;;;;4,0;;;4,0;;;;;;;;;12,0;;;1,0;;;;2,0;;5,0;17,0;1,0;;;;1,0;1,0;29,0;;;;;;;;;;2,0;;;;;;;;4,0;;;;;;;;;;;;;;;;;6,0;;;38,0;4,0;1,0;;;;62,0;;2,0;;;;;;;;;;;;;;;;;;;;;;;;;;5,0;1,0;;;;;;;4,0;;9,0;;;;;;;;;;;;;;;;;;;;;;;;;10,0;3,0;;;;;7,0;;;;;;;;;;;;;;;;;;;34,0;;;;;;;;;5,0;63,0;;;2,0;;;;;;;;;;;;;;;;;;;;;;10,0;;;;;;;;;;;;1,0;;;;;;;;;;;;;;;;;;;4,0;;;;;;;5,0;;;;;;;2,0;;;;;;;;;;;;;1,0;;52,0;19,0;;;;;2,0;;;7,0;17,0;9,0;;;;10,0;28,0;2,0;;5,0;;4,0;33,0;;;;4,0;;;1,0;1,0;1,0;;;;;37,0;;;;;;;;;;;;;;;25,0;;;4,0;;;;;;;;;13,0;;;;11,0;;;;;;;;;;45,0;;;;;;;;2,0;;2,0;;4,0;;;;;;;;1,0;;;;;;;;1,0;;;;;;;;;;;;;;;;;3,0;;;;;;;;;;;;;;;;;;;4,0;;;;;;;4,0;;;;;;;;;;;2,0;;;;;;;6,0;3,0;;;1,0;;;11,0;;;;;6,0;;18,0;;;;;;;;;;3,0;;;;;;;2,0;;;;;;;;;;;;;;;;5,0;;;;;;;;;;;;;;;;;;;;;;;;;;;;;;;;4,0;;;;;;;;;;;;;;;;;;;;;;;;;;;;;;;;;;;;;;;;;;;;;;;;;;;;;;;;;;;;;;;;;;;;;;;;;;
capsule;;;3,0;;49,0;;2,0;4,0;;17,0;;;;;;;;;3,0;2,0;9,0;7,0;;3,0;;;;8,0;3,0;22,0;4,0;21,0;13,0;4,0;5,0;;;2,0;;;;;;9,0;;;;;1,0;;;1,0;;;;48,0;8,0;;1,0;4,0;;;43,0;;;;;;4,0;5,0;;;;;;;;;;11,0;;1,0;2,0;1,0;;2,0;6,0;;;;4,0;;;3,0;;;1,0;12,0;8,0;;8,0;22,0;;1,0;;;1,0;3,0;;;;;;;;;;;;;;;1,0;2,0;;;13,0;;;;2,0;;;;;1,0;;;;5,0;;14,0;2,0;1,0;;;1,0;2,0;;;;;;;;;;16,0;13,0;6,0;;;;;;2,0;;35,0;;2,0;;1,0;1,0;;;;3,0;4,0;;;;2,0;1,0;;;;;5,0;;7,0;1,0;;5,0;6,0;;9,0;;;;;4,0;;;1,0;;;;;;;6,0;;;;;6,0;5,0;11,0;3,0;;;;;;;2,0;13,0;;;;;;;1,0;;;2,0;;;;;;;;;;;;;;;2,0;;2,0;;;;;;;;;;;;;;;;;;1,0;;;;1,0;;;;3,0;;;;;;23,0;1,0;;17,0;;;;;2,0;;;;;;;;;5,0;;;;;5,0;1,0;;;;;;;;;;;;;;;;;16,0;;;;;;;;;;;;;;;;;;;;;;;;14,0;2,0;;1,0;;2,0;2,0;;;;;;;26,0;;;3,0;;;;;;;;;;10,0;1,0;;;;;;;;;;;;;4,0;;;;;;;;;;;;;;2,0;;;;;;1,0;;;;1,0;;4,0;;;;1,0;;;;;15,0;;;;2,0;;;;;;;;;;3,0;;;;;;;2,0;;;2,0;;;;12,0;2,0;;;;;;;;;;;;9,0;;;3,0;;;3,0;;;2,0;;;;;;;;;;;;;;;4,0;;;;;;11,0;;1,0;;;4,0;;1,0;;1,0;;;;;;;;;;2,0;;2,0;;;;;;;;;;;1,0;;30,0;;;;4,0;;;;;;;;;2,0;;;;7,0;;;;;;;;;;;;;;9,0;;;;;;2,0;;;1,0;;;;;;;;;;;;;2,0;3,0;;;;;;;9,0;;;;;;;;;;;;13,0;;;;;;;;;;;;;;;;;;;;;;;;;;1,0;;;;2,0;1,0;;;1,0;;;;;;;;;;;3,0;;11,0;;;;;;;;;;;;;;;1,0;;;;;;;;;;;;;1,0;;;;;4,0;;;;1,0;;;;;;2,0;;;;;;;;;;;;;;;;;;;;;;6,0;;;;;;2,0;;;;;;;;;;;;3,0;;;;;;1,0;;1,0;;;;;;;;4,0;;;;;;;;;1,0;;;;1,0;4,0;2,0;1,0;;;;;;2,0;2,0;;;;;;2,0;;;;8,0;;;;;;;;;;;;;;;;;;;;;;;;;10,0;;;;;;;;;;;;;;;;;;;;;;;;;;;;;;;;;;;;1,0;1,0;;;;;;;;;;1,0;;;;;;;;;;;;;;;;;;;;;;;;;;;;;;;;1,0;;;;;;;;;;;2,0;;;;;;;;;;;;4,0;;;;;;;;;;;;;;;;;;;;;;;;;;;;;;;2,0;;;;;;;;;;;;;;;;;;;;;;;;;;;;;;;;;;;;;;;;;;;;;;;;;;;;;;;;;;;;
carry;;;4,0;;10,0;;7,0;17,0;1,0;16,0;4,0;;;;6,0;;;1,0;3,0;11,0;1,0;83,0;1,0;3,0;80,0;;;46,0;1,0;15,0;68,0;18,0;57,0;2,0;27,0;;1,0;4,0;1,0;25,0;2,0;9,0;6,0;8,0;;;1,0;12,0;13,0;8,0;24,0;13,0;;10,0;;176,0;27,0;1,0;10,0;45,0;1,0;12,0;59,0;8,0;3,0;2,0;62,0;2,0;;148,0;22,0;11,0;3,0;;;2,0;;11,0;15,0;2,0;;90,0;38,0;8,0;;;9,0;2,0;10,0;6,0;22,0;12,0;9,0;50,0;11,0;7,0;1,0;3,0;9,0;;6,0;40,0;;5,0;4,0;;;65,0;;;7,0;2,0;;2,0;1,0;;;;7,0;10,0;4,0;16,0;4,0;13,0;;;26,0;;;1,0;6,0;;2,0;;;6,0;;;8,0;2,0;;1,0;5,0;20,0;8,0;;4,0;17,0;;1,0;;1,0;1,0;;;3,0;1,0;15,0;2,0;28,0;;1,0;3,0;;4,0;;9,0;10,0;1,0;3,0;29,0;2,0;28,0;8,0;9,0;1,0;1,0;19,0;;;;1,0;2,0;1,0;1,0;6,0;8,0;6,0;;4,0;;;;26,0;;3,0;;;1,0;10,0;;;1,0;4,0;;4,0;;;17,0;24,0;13,0;4,0;;4,0;;14,0;2,0;2,0;;4,0;1,0;6,0;1,0;;;;4,0;;;;;;3,0;1,0;9,0;4,0;4,0;3,0;3,0;;7,0;1,0;5,0;;5,0;18,0;4,0;1,0;1,0;;4,0;1,0;;3,0;;1,0;;3,0;;;;8,0;;;;;3,0;4,0;;3,0;;1,0;1,0;;1,0;4,0;1,0;;1,0;3,0;2,0;;;25,0;;9,0;6,0;63,0;9,0;;3,0;;2,0;8,0;;;;18,0;;;;;10,0;;1,0;;2,0;7,0;;;6,0;5,0;3,0;2,0;3,0;3,0;;;1,0;1,0;;1,0;;1,0;;2,0;1,0;1,0;1,0;;6,0;1,0;;1,0;;;1,0;;;;1,0;;;1,0;45,0;;2,0;;;13,0;;2,0;2,0;;;5,0;;;;1,0;4,0;2,0;1,0;;3,0;13,0;;;2,0;;2,0;;3,0;;7,0;1,0;1,0;;;7,0;8,0;2,0;4,0;7,0;;;;;4,0;9,0;6,0;;;;2,0;2,0;1,0;;7,0;;4,0;;;;12,0;;;5,0;4,0;;1,0;1,0;2,0;4,0;;2,0;2,0;1,0;3,0;;4,0;;14,0;2,0;33,0;;;6,0;2,0;2,0;5,0;;;;;1,0;1,0;;;1,0;5,0;;10,0;5,0;;11,0;6,0;6,0;;13,0;;2,0;11,0;;;;1,0;;10,0;;2,0;1,0;7,0;1,0;2,0;7,0;6,0;4,0;4,0;6,0;;3,0;1,0;;;;28,0;;6,0;3,0;;1,0;;;;3,0;1,0;15,0;;3,0;;34,0;2,0;1,0;6,0;15,0;3,0;3,0;;;3,0;;;1,0;12,0;4,0;;;;;;3,0;1,0;6,0;12,0;2,0;4,0;;;1,0;;8,0;1,0;5,0;;;7,0;;;;7,0;4,0;9,0;;;3,0;;2,0;;1,0;;2,0;;1,0;2,0;;;1,0;;;1,0;7,0;;;2,0;1,0;3,0;2,0;;3,0;21,0;;5,0;;;1,0;2,0;;;;8,0;1,0;3,0;;;;;2,0;;;;;7,0;;1,0;1,0;1,0;;1,0;2,0;2,0;;5,0;;;6,0;;1,0;2,0;;3,0;;3,0;1,0;5,0;;;4,0;;1,0;;1,0;;;;;4,0;7,0;;;;;;3,0;;1,0;;2,0;1,0;;;1,0;;5,0;;;;;;3,0;;;;;;;;;2,0;;;1,0;;;;;;3,0;1,0;;1,0;1,0;;;;5,0;1,0;;;;9,0;;;;;;1,0;;3,0;1,0;6,0;;;1,0;2,0;;;;;;;3,0;;;;;;5,0;6,0;6,0;;;2,0;;;;;1,0;;39,0;6,0;;;3,0;;;8,0;;;7,0;3,0;;;;;1,0;;9,0;;;2,0;3,0;1,0;;;;4,0;;;;;;;;;1,0;;10,0;;;;4,0;;;2,0;3,0;1,0;2,0;;7,0;2,0;;;;;;;;;5,0;;;2,0;;;2,0;6,0;;;;3,0;;1,0;;;;5,0;2,0;;;;;;1,0;4,0;;1,0;;1,0;1,0;;;;1,0;1,0;1,0;;;4,0;;;;;;;;;2,0;3,0;;;;;;;;1,0;1,0;2,0;;;12,0;4,0;;;;;;;;;;;;;2,0;;;;;1,0;;;2,0;;;;;;;8,0;;;1,0;;;;;;1,0;;;9,0;;;;12,0;;;;;;;;;1,0;;;1,0;2,0;;;2,0;;;5,0;;;;1,0;;;;;;;;;;3,0;;;;1,0;;;;;1,0;;;2,0;;;;;;;;;1,0;;3,0;;;;;;;;1,0;;;2,0;;;;2,0;;;;;;;;;;;1,0;;;;;;;;;;;;;;;;;;;;;;;;;;;;;;;;;;1,0;;;;;;;
casing;;;1,0;;10,0;;3,0;15,0;;;4,0;;;;;1,0;;;1,0;;2,0;8,0;;;2,0;;;1,0;;;2,0;;46,0;;2,0;;;9,0;;10,0;;;;12,0;;;;;1,0;;4,0;;;;;29,0;37,0;;;48,0;;;2,0;;;;3,0;2,0;;1,0;8,0;2,0;;;;10,0;;1,0;20,0;;1,0;;2,0;;;;3,0;;;;8,0;1,0;;5,0;1,0;7,0;;1,0;;2,0;36,0;7,0;;;;;;35,0;;;3,0;7,0;;7,0;10,0;;;;3,0;11,0;;;;2,0;;;13,0;6,0;;12,0;11,0;;;15,0;;9,0;33,0;;;;;;7,0;13,0;;;7,0;7,0;1,0;;;1,0;30,0;2,0;;2,0;12,0;8,0;;6,0;;;12,0;19,0;;;;7,0;;;37,0;;53,0;26,0;2,0;15,0;17,0;1,0;;;5,0;2,0;6,0;;1,0;;2,0;2,0;;17,0;;10,0;1,0;25,0;;;;;;;;3,0;2,0;18,0;1,0;;;;9,0;7,0;;1,0;;;;;3,0;;;;14,0;5,0;2,0;;29,0;;;;;;9,0;;2,0;4,0;;3,0;;;6,0;;1,0;;;8,0;;2,0;;;;2,0;;;;18,0;;;4,0;10,0;2,0;;;1,0;;1,0;7,0;;2,0;4,0;;;2,0;19,0;11,0;2,0;1,0;2,0;;8,0;4,0;7,0;1,0;;;16,0;4,0;;10,0;;;4,0;;;3,0;;;7,0;;6,0;;;2,0;;;2,0;1,0;5,0;1,0;;24,0;4,0;2,0;1,0;1,0;;1,0;4,0;;;1,0;;2,0;2,0;1,0;8,0;;1,0;;1,0;3,0;;2,0;;;;;;;;;;;2,0;;;;;;;2,0;;6,0;;;;;;;;;;;;;;;6,0;;;1,0;;;;;;;1,0;;;2,0;4,0;;3,0;;;;;;;;2,0;;;;;16,0;;;;;;;;;;;;;;;;;1,0;;;;;;;2,0;;2,0;1,0;;3,0;;3,0;;;;;;;1,0;;;;;;;5,0;1,0;;;;;3,0;;;;;;;;16,0;3,0;;;;;;;;;;2,0;1,0;4,0;;;;3,0;;;;;;17,0;;;1,0;;;;;;2,0;3,0;;;;;;;2,0;;;;;;;2,0;;;;8,0;1,0;;;;;2,0;;;6,0;;2,0;2,0;;;;;;;2,0;;;;3,0;;1,0;;;2,0;2,0;;;;2,0;;;;;;2,0;3,0;1,0;3,0;;;;;10,0;4,0;;;1,0;;;;;;;1,0;;;;10,0;;;;3,0;;;;2,0;;11,0;;;;;;;;;2,0;;;;;;;;;10,0;;;16,0;;;;;;3,0;;;;;;;;;;;;;;4,0;;;;;;7,0;;;;;;1,0;;;;4,0;;;;4,0;;9,0;;;;;;;;1,0;;;;6,0;;1,0;4,0;2,0;;7,0;;;2,0;;;;;;1,0;2,0;2,0;;;;;2,0;;6,0;;;;;;;;;;;;;;;;;;;;;;;;;;;;;;;;;;1,0;;3,0;;;;;;;;;;;;;;;;;;;;;;;;;;;;;;;;;;;;;;;;;;;;;;;;;;;;2,0;;2,0;;;;;;1,0;;;;1,0;;;;;;1,0;;;;;;;;;;;;;;;;2,0;;;;;;;;;;;;;;;;;;;;;;;;;;;;;;;1,0;;1,0;;;;;;1,0;;1,0;;2,0;;7,0;;;6,0;;;;;;;;;;;;;;;;;;;;;2,0;;;;;;;;2,0;;2,0;;;;;;;;;;;;;;;5,0;;;;;2,0;;;;;;;;;;;;;;;;;;;;;;;;;;;;;;;;;;;;;;;;6,0;;;;;;;;;;;;;3,0;;1,0;;;;;;;;;;;;;;;;;;;;;;;;;;;;;;;;;;;;;;;;;;;;;2,0;;;
cement;;;2,0;;;;;;;;;;;;;;;;29,0;;1,0;;;;;;;;;;;;1,0;;;;;;;;4,0;;;207,0;;;;;;;;;;12,0;4,0;50,0;17,0;;4,0;465,0;;;;;;;;;;;2,0;4,0;;;;;;;;17,0;;;;;;;;;;;;;;;;16,0;;;;;35,0;9,0;;;;;;31,0;;;;;;;;;;;;;;;;;;;1,0;4,0;;;;;;;;;14,0;;;;;;;5,0;;;8,0;1,0;;;;;;;;;;;;7,0;;;;;;;;2,0;;1,0;1,0;;;;;;;;;;;;;;;1,0;;;;;;;;;;;9,0;;;1,0;;1,0;;64,0;;;;;;1,0;;;;;;;;;;;;;;;;;;;;;;;;;2,0;;;;;;;;;;;;;;;;;;;;;;;;;;;;;;;;;;;;;;;;;;;;;;;;;;;;;13,0;;;;;;;;;;;;;;;;;;;;;;;;;;;;;;;;;;;;;;;;;;;;;;;;;;;;;;;;;;;;;;;;;;;;;;;;;;;;;;;;;;;;;;1,0;;;;;;;;;;;;;;;;;;;;;;;;;;;;;;;;;;24,0;;;;;;;;;;;;;;;;;;;;;;;;;;;;;;;;;;;;;;;;;;;;;;;;;;;;;;;;2,0;;;;;;;;;;;;;;;;;;;;;;;;;;;;;;;;;;;;;;;;;;;;;;;;;;;;;;;;;;;;;;;;;;;;;;;;;;;;;;;;;;;;;;;;;;;;;;;;;;;;;;;;;;;;;;;;;;;;;;;;;;;;;;;;;;;;;;;7,0;;;;;;;;;;;;;9,0;;;;;;;;;;;;;;;;;;;;;;;;;;;;;;;4,0;;4,0;;;;;;;;;;;;;;;;;;;3,0;;;;;;;;;;3,0;;;;;;;;;;;;;;;;;;;;1,0;;;;;;;;;;;;;;;;;;;;;;;;;;;;;;;;;;;;;;;;;;;;;;;;;;;;;;;5,0;;;;;;;;;3,0;;;;;;;;3,0;;;;;;;;;;;;;;;;;;;;;;;10,0;;;;;;;;;;;;;;;;;;;;;;;;;;;;;;;;;;;;;;;;;;;;;;;;;;;;;;;;;;;;;;;;;;;;;;;;;;;;;;;;;;;;;;;;;;;;;;;;;;;;;;;;;;;;;;;;;;;;;;;;;;;;;;;;;;;2,0;;;;;;;;;;;;;;;;;;;;;;;;;;;;;;;;;;;;;;;;;;;;;;;;;;;;;;;;;;;;;;;;;;;;;;;;;;;;6,0;;;;
change;;;110,0;3,0;70,0;;43,0;156,0;21,0;70,0;26,0;28,0;;11,0;60,0;7,0;3,0;4,0;11,0;11,0;121,0;256,0;21,0;6,0;51,0;;5,0;69,0;10,0;314,0;124,0;154,0;127,0;19,0;60,0;3,0;4,0;249,0;6,0;211,0;61,0;;25,0;43,0;4,0;40,0;;33,0;139,0;37,0;17,0;66,0;4,0;41,0;2,0;595,0;58,0;;48,0;226,0;6,0;132,0;72,0;16,0;5,0;2,0;40,0;;74,0;118,0;129,0;26,0;16,0;4,0;4,0;24,0;;99,0;348,0;22,0;;52,0;31,0;4,0;8,0;1,0;43,0;7,0;6,0;55,0;46,0;13,0;14,0;254,0;69,0;12,0;;13,0;35,0;1,0;17,0;121,0;1,0;4,0;2,0;5,0;77,0;458,0;;;15,0;2,0;2,0;7,0;;;2,0;1,0;2,0;15,0;;;90,0;21,0;;;113,0;8,0;4,0;6,0;1,0;5,0;3,0;;;29,0;3,0;;;2,0;5,0;11,0;5,0;13,0;24,0;9,0;14,0;51,0;8,0;;1,0;1,0;2,0;1,0;2,0;7,0;3,0;2,0;21,0;95,0;2,0;17,0;1,0;3,0;;;40,0;79,0;3,0;;31,0;5,0;17,0;12,0;39,0;15,0;;54,0;1,0;;;6,0;5,0;15,0;;13,0;6,0;77,0;;40,0;1,0;1,0;15,0;38,0;;9,0;2,0;;17,0;1,0;;48,0;;11,0;;25,0;14,0;6,0;6,0;8,0;4,0;;;6,0;18,0;135,0;4,0;;2,0;;11,0;2,0;27,0;6,0;;3,0;2,0;;6,0;;1,0;;7,0;1,0;26,0;92,0;;25,0;194,0;7,0;10,0;1,0;30,0;;3,0;9,0;2,0;;;1,0;1,0;6,0;;5,0;;;;3,0;10,0;;5,0;32,0;6,0;;;;4,0;;;;;2,0;;;;4,0;3,0;;14,0;2,0;8,0;;3,0;15,0;;31,0;31,0;95,0;34,0;;2,0;2,0;4,0;22,0;;2,0;;77,0;;;;;82,0;2,0;1,0;;;118,0;2,0;1,0;43,0;16,0;36,0;38,0;2,0;;2,0;;1,0;1,0;;8,0;;1,0;1,0;24,0;;5,0;20,0;2,0;39,0;11,0;;6,0;;;15,0;6,0;10,0;8,0;;24,0;10,0;15,0;30,0;3,0;4,0;13,0;;;8,0;11,0;27,0;4,0;;27,0;3,0;6,0;;1,0;6,0;2,0;1,0;3,0;3,0;45,0;;14,0;22,0;12,0;24,0;;10,0;4,0;4,0;9,0;6,0;11,0;;5,0;42,0;15,0;;7,0;26,0;9,0;65,0;30,0;2,0;20,0;4,0;48,0;4,0;1,0;6,0;64,0;25,0;25,0;25,0;;22,0;;;16,0;3,0;3,0;37,0;78,0;1,0;;;7,0;;3,0;2,0;10,0;17,0;3,0;41,0;;23,0;4,0;15,0;9,0;189,0;3,0;5,0;5,0;7,0;64,0;22,0;3,0;;;2,0;1,0;6,0;1,0;3,0;2,0;12,0;;35,0;1,0;11,0;52,0;4,0;3,0;17,0;14,0;1,0;6,0;31,0;8,0;2,0;7,0;1,0;8,0;37,0;;21,0;5,0;5,0;9,0;1,0;34,0;8,0;2,0;81,0;23,0;2,0;34,0;;3,0;;2,0;9,0;1,0;1,0;6,0;1,0;;1,0;14,0;1,0;14,0;12,0;30,0;11,0;73,0;2,0;34,0;42,0;2,0;42,0;58,0;1,0;18,0;12,0;;;1,0;4,0;7,0;16,0;;1,0;;14,0;;;;;7,0;31,0;5,0;1,0;9,0;;1,0;2,0;;17,0;;1,0;14,0;19,0;;;;;1,0;;;3,0;1,0;;19,0;7,0;1,0;;2,0;2,0;;1,0;4,0;2,0;2,0;1,0;;2,0;;;2,0;6,0;;24,0;1,0;1,0;29,0;119,0;;1,0;2,0;2,0;;53,0;19,0;7,0;;;2,0;;;;;1,0;1,0;;;;2,0;60,0;1,0;;7,0;;;4,0;16,0;8,0;;;2,0;;2,0;;;10,0;;;;47,0;6,0;;1,0;4,0;2,0;1,0;;;3,0;;;;;2,0;5,0;;4,0;25,0;;2,0;3,0;;;;;1,0;;;1,0;7,0;9,0;9,0;;4,0;4,0;7,0;;1,0;2,0;;;4,0;1,0;2,0;3,0;2,0;1,0;11,0;;;;1,0;;;;2,0;;48,0;;;;;2,0;;;;2,0;4,0;18,0;2,0;3,0;1,0;4,0;;7,0;;9,0;;;11,0;50,0;;10,0;;8,0;4,0;;;4,0;2,0;3,0;7,0;;;3,0;1,0;1,0;25,0;;;20,0;1,0;;;4,0;3,0;26,0;;3,0;2,0;21,0;5,0;;;2,0;;4,0;8,0;1,0;;;;;1,0;4,0;;16,0;;38,0;13,0;3,0;42,0;3,0;3,0;7,0;;2,0;19,0;2,0;;31,0;4,0;22,0;6,0;1,0;4,0;;;;1,0;1,0;;;10,0;28,0;;3,0;4,0;9,0;;1,0;4,0;;5,0;2,0;2,0;15,0;16,0;1,0;6,0;1,0;3,0;4,0;18,0;3,0;3,0;7,0;25,0;;;10,0;8,0;;8,0;2,0;;;;;6,0;44,0;;2,0;1,0;;;4,0;6,0;3,0;;2,0;1,0;;;;17,0;4,0;;3,0;3,0;71,0;;;1,0;;3,0;;5,0;2,0;4,0;;6,0;2,0;;8,0;3,0;15,0;4,0;19,0;1,0;;;3,0;1,0;2,0;2,0;;;4,0;;3,0;5,0;;;3,0;4,0;11,0;1,0;;;5,0;;3,0;4,0;6,0;1,0;;;2,0;;;1,0;;;4,0;4,0;;;;6,0;;2,0;;20,0;1,0;;;;;;23,0;;;;;4,0;;;;1,0;7,0;8,0;;;3,0;26,0;5,0;9,0;1,0;2,0;;;;1,0;;1,0;1,0;10,0;2,0;2,0;5,0;;1,0;2,0;;;;;8,0;;;1,0;2,0;;4,0;7,0;2,0;1,0;;;2,0;;1,0;;1,0;;2,0;;;;1,0;2,0;;;;;;;2,0;;1,0;;;2,0;;1,0;;;3,0;;;1,0;;2,0;;;5,0;;10,0;2,0;;;;;1,0;;;;3,0;23,0;;;;;21,0;;;;;;;;2,0;;;;
changing;;;12,0;1,0;31,0;;24,0;39,0;3,0;20,0;1,0;7,0;;2,0;18,0;3,0;;;2,0;1,0;8,0;77,0;2,0;13,0;20,0;;2,0;23,0;15,0;51,0;3,0;20,0;55,0;2,0;5,0;4,0;;52,0;3,0;92,0;27,0;;8,0;25,0;;;1,0;8,0;20,0;13,0;8,0;5,0;;28,0;;195,0;31,0;2,0;57,0;90,0;1,0;97,0;64,0;1,0;;4,0;25,0;;12,0;57,0;32,0;2,0;11,0;1,0;;2,0;;38,0;136,0;5,0;;20,0;3,0;;8,0;;9,0;4,0;4,0;11,0;7,0;4,0;7,0;51,0;14,0;4,0;;6,0;14,0;;4,0;34,0;;2,0;;2,0;2,0;128,0;;1,0;1,0;3,0;1,0;4,0;2,0;;;;7,0;8,0;;;;12,0;;;26,0;;3,0;1,0;4,0;7,0;2,0;3,0;;1,0;1,0;;;4,0;2,0;3,0;2,0;;7,0;1,0;6,0;7,0;1,0;;;;;1,0;10,0;2,0;;1,0;1,0;31,0;1,0;1,0;1,0;1,0;;;7,0;24,0;;3,0;8,0;;8,0;1,0;10,0;2,0;;29,0;2,0;;;3,0;6,0;5,0;4,0;5,0;3,0;31,0;;13,0;;;;6,0;;1,0;2,0;;11,0;;;8,0;;8,0;3,0;3,0;;;2,0;;;;;;5,0;21,0;5,0;;;;;4,0;;;;;6,0;;15,0;;;;1,0;;13,0;41,0;;17,0;55,0;4,0;2,0;;6,0;1,0;;5,0;4,0;;;;;;;5,0;1,0;2,0;;3,0;;;;13,0;;;;;;;;;2,0;4,0;;2,0;;;;;;1,0;7,0;;;20,0;;5,0;10,0;21,0;5,0;;;;;6,0;;4,0;;42,0;;;;;19,0;;;;1,0;29,0;;;14,0;17,0;8,0;;;;;;;;;4,0;;;3,0;6,0;;;3,0;;5,0;2,0;;1,0;;;1,0;;3,0;1,0;;4,0;;1,0;9,0;2,0;;4,0;;90,0;5,0;1,0;;2,0;;;1,0;;;;1,0;2,0;;;;2,0;3,0;;;1,0;3,0;;;;5,0;;;;;6,0;10,0;14,0;;4,0;5,0;4,0;3,0;8,0;;17,0;;17,0;3,0;;2,0;8,0;4,0;7,0;9,0;;7,0;;;1,0;;2,0;24,0;20,0;2,0;;;1,0;;1,0;;2,0;;;20,0;;7,0;;;6,0;48,0;2,0;;3,0;;2,0;4,0;8,0;1,0;;;;5,0;1,0;1,0;1,0;8,0;;6,0;;;17,0;;3,0;6,0;5,0;;3,0;4,0;5,0;;4,0;;;23,0;;1,0;12,0;1,0;1,0;;3,0;3,0;4,0;16,0;12,0;;15,0;;;;7,0;11,0;4,0;;1,0;;;;6,0;;3,0;6,0;5,0;7,0;20,0;;30,0;2,0;2,0;8,0;42,0;2,0;15,0;9,0;;2,0;;;;9,0;;;1,0;1,0;;;2,0;;1,0;4,0;;;3,0;;;;;4,0;;;2,0;2,0;1,0;;;;;;;5,0;4,0;;;;;;;;;;;;;;;2,0;;;3,0;2,0;;;2,0;;6,0;32,0;4,0;;;2,0;;38,0;4,0;;;;;;;;;;;;2,0;;;28,0;;;12,0;;;4,0;4,0;3,0;;;4,0;1,0;;;;;;;;10,0;;;;4,0;;;;;2,0;;;;;1,0;;;;;;4,0;;;;;;6,0;;;;;5,0;;;6,0;;1,0;;;;1,0;;2,0;;1,0;;;;;;1,0;;;;;;;;13,0;;;6,0;;;;;;4,0;;5,0;2,0;1,0;1,0;2,0;;6,0;;;2,0;;1,0;8,0;1,0;;2,0;2,0;4,0;;;6,0;;;7,0;2,0;;;;;3,0;;1,0;;;;;;2,0;10,0;;;;1,0;;;;;;4,0;7,0;;;;;4,0;;;;;1,0;4,0;3,0;1,0;1,0;;3,0;2,0;;2,0;6,0;1,0;;8,0;;3,0;5,0;5,0;1,0;;;;;;;;3,0;;3,0;2,0;1,0;;;;3,0;;;1,0;2,0;1,0;;;;3,0;;8,0;5,0;2,0;;;;;;1,0;;;5,0;1,0;1,0;;;;;5,0;;3,0;;;1,0;;2,0;;;;;;;1,0;4,0;3,0;;1,0;5,0;17,0;1,0;;;;2,0;;3,0;3,0;1,0;;;;;6,0;;;2,0;;;2,0;;1,0;;;;;;1,0;;2,0;;5,0;;4,0;;1,0;1,0;;;;1,0;1,0;;;4,0;1,0;;;;;;;;;;;;;2,0;;4,0;;11,0;;;2,0;;;;2,0;2,0;;;;4,0;;;;;;;;;;2,0;6,0;;;;;;;;;;2,0;;;;;;;1,0;;;;;1,0;;;;;;;7,0;;3,0;;;;;;;;;;;;;;;;;;;;;;;;;;;;;;;;;;;;;;1,0;3,0;;1,0;;1,0;;;1,0;3,0;;;;;16,0;;;;;7,0;;;;;;;;;;;;
channel;;;2,0;;2,0;;7,0;25,0;3,0;27,0;15,0;4,0;;1,0;72,0;17,0;;1,0;2,0;2,0;;162,0;;2,0;3,0;;11,0;36,0;;4,0;3,0;23,0;45,0;;79,0;;17,0;28,0;;8,0;;;;13,0;;;1,0;;4,0;;6,0;18,0;;;;91,0;46,0;1,0;;16,0;;;28,0;;;1,0;1,0;;;3,0;36,0;;2,0;;;;;;17,0;;;5,0;154,0;2,0;;;18,0;;18,0;7,0;20,0;;;12,0;;11,0;;7,0;15,0;7,0;24,0;29,0;;181,0;;;10,0;28,0;;;2,0;16,0;44,0;5,0;7,0;3,0;;32,0;1,0;2,0;;3,0;4,0;5,0;;11,0;121,0;6,0;1,0;25,0;;5,0;;;1,0;14,0;11,0;;51,0;;2,0;;2,0;5,0;3,0;;54,0;23,0;;;29,0;3,0;20,0;3,0;;5,0;5,0;20,0;9,0;16,0;4,0;;11,0;;;3,0;20,0;52,0;1,0;2,0;24,0;;71,0;5,0;1,0;16,0;;10,0;;;;4,0;8,0;;;8,0;2,0;101,0;;55,0;3,0;2,0;4,0;67,0;;;;;2,0;3,0;4,0;6,0;;8,0;15,0;1,0;;2,0;4,0;6,0;;;1,0;;2,0;33,0;2,0;;1,0;12,0;10,0;;;5,0;18,0;15,0;1,0;;2,0;1,0;;1,0;;9,0;7,0;;6,0;7,0;4,0;;2,0;2,0;3,0;5,0;6,0;1,0;;5,0;;;5,0;;4,0;24,0;;;6,0;64,0;;;5,0;;;;13,0;1,0;25,0;;;;;1,0;;1,0;4,0;3,0;;;2,0;7,0;1,0;;;1,0;3,0;;15,0;;25,0;3,0;1,0;1,0;20,0;;;1,0;2,0;;;;8,0;;20,0;2,0;;;8,0;6,0;;18,0;7,0;15,0;1,0;;4,0;;;;;6,0;;;5,0;1,0;2,0;16,0;;;4,0;5,0;;;;;;;;;1,0;;6,0;5,0;;;;;;4,0;;2,0;8,0;3,0;;;;3,0;;;;1,0;;;1,0;31,0;;2,0;;4,0;3,0;;;;;4,0;;5,0;10,0;3,0;;1,0;1,0;;;3,0;1,0;;5,0;;;1,0;;;3,0;1,0;6,0;;2,0;3,0;2,0;4,0;;2,0;;1,0;;;;2,0;;1,0;1,0;7,0;1,0;9,0;8,0;3,0;4,0;;2,0;;12,0;1,0;;4,0;5,0;2,0;;7,0;;;1,0;;;1,0;2,0;;3,0;;1,0;;;;;;;11,0;5,0;1,0;;;;;4,0;58,0;;;;;;;;;;;3,0;2,0;2,0;;8,0;;;1,0;1,0;;4,0;;;5,0;;2,0;2,0;;;4,0;;1,0;;;;;;3,0;3,0;4,0;9,0;2,0;;9,0;3,0;;3,0;;1,0;;9,0;;3,0;;;;2,0;;;5,0;16,0;2,0;3,0;1,0;;;;;11,0;;;;;9,0;;;;;;7,0;;19,0;;;;;;;9,0;;;;2,0;5,0;;;3,0;;1,0;;9,0;4,0;2,0;6,0;;;27,0;1,0;1,0;;;;3,0;;;1,0;;8,0;;;1,0;;1,0;;;8,0;;6,0;;;;7,0;;;3,0;;17,0;4,0;;1,0;;13,0;;;6,0;1,0;;;13,0;;;;;3,0;;;;;;;1,0;;10,0;;;;2,0;;1,0;22,0;4,0;;8,0;2,0;3,0;;;11,0;1,0;2,0;2,0;2,0;;4,0;;13,0;;;1,0;;;;;;;;2,0;5,0;;;;1,0;;;5,0;;;6,0;;;;2,0;;;;;;;9,0;1,0;5,0;;;;1,0;4,0;;2,0;20,0;;1,0;;;;;2,0;;;;;1,0;2,0;13,0;3,0;9,0;16,0;1,0;;1,0;1,0;;1,0;;;2,0;5,0;1,0;1,0;2,0;;;;28,0;4,0;3,0;;;;2,0;15,0;;;;;3,0;;;;;;;2,0;14,0;1,0;1,0;;10,0;;;1,0;;;;10,0;;;;;3,0;;;;;1,0;17,0;;;12,0;1,0;;;;;;;;2,0;;11,0;;;;1,0;;;;;;;;;;;;;;1,0;;;2,0;8,0;;;1,0;2,0;;;;;;;;;;7,0;;;2,0;;;;;1,0;2,0;;;;3,0;5,0;;2,0;;;10,0;5,0;;1,0;;;;;;;4,0;4,0;;;;;;;;3,0;;;;;;16,0;;78,0;;;;14,0;;11,0;;;;;;;;4,0;;;11,0;;;2,0;;;1,0;8,0;;;;;;1,0;;;;;;;;;;6,0;;;;;;2,0;;1,0;;;;;;;1,0;;;1,0;;;;;;;;;;;;;1,0;;1,0;2,0;;;;;;4,0;;;;;;;2,0;;;4,0;;;;;1,0;4,0;;;;;;;;;2,0;;;;;;;;;;;;1,0;;;;;;;;;;;;;;;1,0;;;;;;;;;;;;6,0;
chip;;;2,0;;18,0;;6,0;52,0;;26,0;;1,0;;2,0;10,0;;;;5,0;;;24,0;;;1,0;;;30,0;;8,0;;3,0;33,0;;44,0;1,0;3,0;;;2,0;1,0;;;25,0;;;2,0;1,0;7,0;;;8,0;;2,0;;552,0;69,0;;1,0;121,0;;;33,0;3,0;;2,0;;2,0;;5,0;114,0;;8,0;1,0;15,0;;;6,0;21,0;4,0;2,0;91,0;5,0;3,0;;;46,0;;;2,0;499,0;;;79,0;8,0;4,0;;4,0;3,0;92,0;106,0;49,0;;14,0;;;9,0;24,0;;;1,0;26,0;44,0;8,0;24,0;;;8,0;61,0;;9,0;;;105,0;;;23,0;15,0;;8,0;66,0;;;2,0;;4,0;32,0;;13,0;19,0;;;12,0;17,0;4,0;;83,0;8,0;;1,0;1,0;4,0;1,0;8,0;9,0;25,0;13,0;12,0;10,0;86,0;2,0;3,0;6,0;2,0;;27,0;1,0;64,0;;20,0;28,0;;134,0;117,0;1,0;2,0;12,0;8,0;103,0;;;3,0;;5,0;;1,0;27,0;134,0;;54,0;;;3,0;52,0;;9,0;;;;13,0;58,0;3,0;2,0;10,0;;1,0;;;13,0;25,0;1,0;18,0;1,0;;;2,0;2,0;32,0;;3,0;16,0;;;;2,0;3,0;;;;1,0;4,0;;1,0;13,0;;;;22,0;105,0;;13,0;;16,0;18,0;;2,0;5,0;;;;;;18,0;123,0;1,0;;;27,0;;;1,0;13,0;7,0;;5,0;;14,0;;;1,0;8,0;8,0;7,0;;1,0;22,0;;;1,0;7,0;;;;9,0;3,0;;;3,0;5,0;2,0;8,0;;;5,0;;;16,0;2,0;2,0;;;;4,0;;;2,0;;2,0;2,0;10,0;;15,0;;;;;;;;8,0;1,0;9,0;;;;1,0;;;;;2,0;;;;;;;1,0;;;2,0;1,0;;;;;;1,0;5,0;;;1,0;;1,0;;;;;;;;;;;1,0;;;;52,0;;;1,0;;;;;4,0;;;6,0;;3,0;;;;;1,0;;;1,0;;;;;3,0;;;;;;;;;;;;;;;;2,0;4,0;35,0;2,0;;;;;7,0;1,0;7,0;2,0;;;2,0;2,0;;1,0;1,0;;;;;;;;1,0;;;;;;;5,0;2,0;;5,0;4,0;;4,0;;;;;;;;;;;;;;;;3,0;;;;;;9,0;;;9,0;1,0;9,0;;2,0;;1,0;9,0;2,0;;;;;;4,0;;;1,0;;;19,0;;7,0;;;;1,0;;;;8,0;;;;;;10,0;;;;20,0;27,0;;;;;;;;;;;3,0;;;3,0;;;6,0;;;;;;;;;2,0;;2,0;;;2,0;;;;2,0;;4,0;;;;;;;5,0;46,0;;;;;;6,0;;;;;;;;2,0;;;;6,0;;;;;;1,0;5,0;;;;;;46,0;;;3,0;;2,0;;2,0;;;;;3,0;;;;;;10,0;;10,0;;;;;4,0;;;1,0;;;2,0;4,0;1,0;;;;;;;83,0;;;;5,0;28,0;1,0;;7,0;;;2,0;;;;;;;6,0;4,0;3,0;;;;;3,0;;1,0;1,0;;;;;;2,0;;;;;;;;;;;12,0;;;;;1,0;;;;;;8,0;;;;3,0;;;;;;2,0;;1,0;;;;;;;;;;7,0;;;;;;;8,0;1,0;;4,0;;;;5,0;5,0;;;;;;;;;;;;;;1,0;;;;2,0;;;1,0;;;;;3,0;;;1,0;;;;;;1,0;;2,0;;1,0;;1,0;;;;;;1,0;;1,0;;8,0;;1,0;;;;;;;;;;;;;;;;;10,0;;;;;1,0;;;;1,0;;;;;;;;;;;;;;;;;;;;;;7,0;;;;;;3,0;;;;;;;;;;;11,0;;;2,0;;;;;;;;;;;11,0;;;;;;;4,0;4,0;;;;;;4,0;;;;;;;;;;;;1,0;1,0;;;;5,0;;;;;;;3,0;;;;;;;;2,0;;;;;;;;;;;;;;;;;;;8,0;;;2,0;;;;;;;;;;;;;;;;;;;;;;;1,0;;;;61,0;3,0;3,0;;;4,0;;;3,0;2,0;;;1,0;;;;;;;;;;;;9,0;;;;;;;;;;3,0;;;;;;;;;;;;;;
client;;;2,0;;29,0;;;2,0;;6,0;;;;;;;;;3,0;7,0;1,0;61,0;;;;;;30,0;;;;3,0;103,0;;8,0;;;;;22,0;;;;;2,0;;;;;;;2,0;;;;46,0;20,0;;;;;;16,0;;;;;;;4,0;;;;4,0;;;;;;;;1,0;1,0;;;;23,0;;;2,0;;1,0;;;;;;1,0;21,0;;;17,0;;20,0;;1,0;;14,0;;;;1,0;;;;;;;;;;;;8,0;;;31,0;2,0;;;;;;;;;;;;;;;;2,0;;;;8,0;;;;;;;;;;;;1,0;;;;;;1,0;;;;;;;;;2,0;;;;;;;;;;;;;5,0;;;;;;22,0;;;;;;;;;;;;;;;;;;;;;;24,0;31,0;;;;;;;;;;;;;;;;;;;;;4,0;;;;;;;;;;;;;;6,0;;7,0;;;;;;;;;;;;;;;;;;;;;;17,0;;;;;;;;;;;;6,0;1,0;;;;;;;;;1,0;;;;;6,0;;;;;;;;3,0;;;;;;;;;;;4,0;;;;4,0;;;;;9,0;;;;;1,0;;;;;;6,0;8,0;;;;;1,0;;;;3,0;;;;;;;;;;;;;2,0;;;;;;;;;3,0;1,0;4,0;;;;;9,0;;;3,0;;;4,0;;;3,0;;6,0;;;;;;;;;1,0;;2,0;;;;;;2,0;;;1,0;;;34,0;2,0;4,0;;;;;;8,0;;3,0;;;1,0;;;;;;;;;;1,0;1,0;;;;;;;1,0;;;;6,0;;7,0;;;;;;;9,0;;;3,0;;;;;;;;;;3,0;;;;;1,0;;1,0;2,0;;;11,0;2,0;;;;1,0;;;;15,0;;;20,0;3,0;;;;1,0;2,0;6,0;;;;;;;;;;;;;8,0;1,0;;4,0;;;;;;;;;1,0;;;;;;;;15,0;;;;;;;;1,0;3,0;;;;;11,0;;;;;1,0;29,0;;;5,0;17,0;;;;;;;;;;;;;4,0;26,0;;;;;;;;;;;1,0;;6,0;;;;;3,0;;;;;;;;;;;;;;;;;;;;;;;;;;;;;;;;;;1,0;;;;1,0;;;;;;;;;;;;;;;1,0;;2,0;;;;;;;;;;;;;;;;;3,0;;;;;;;;;;;;;;;;;;;;;;;;;;;;;;;;;;;;;;;;;;2,0;;;;;6,0;;;;;;;;;;;;;;;;;;;;;;;;;;;;;;;;;;;;;;;;;;;;7,0;;;;;;;;;;;;;;;;;;;;;;;;;;;;;;;;;4,0;;;;;;;;9,0;;;;;;;;;;;;;;;;;;;;;;;;;;;;;;;;;;;;;;;;;;;;;;;;;;;;;;;;;;4,0;;;;;;;;;;;;;;;;;;;;;;;;;;;;;;;;;;;;;;;;;;;;;;2,0;;;;;;;;;;;;;;;;;;;;;;;;;;;;;;;;;;;;;;;;;;;;;;;;;;;;;;;;;;;;;;;;;;;;;;;;;;;;;;;;;;;2,0;;;;;;;;;;;;;;;;;;
clock;;;22,0;;12,0;;;30,0;;6,0;;;;4,0;1,0;;;;;6,0;;61,0;;1,0;3,0;;;106,0;;11,0;;35,0;32,0;1,0;13,0;;;1,0;;3,0;;;3,0;;2,0;;;;;84,0;15,0;43,0;3,0;;;62,0;19,0;;2,0;;;;32,0;2,0;;;2,0;;9,0;24,0;4,0;;;;;;;;1,0;3,0;;10,0;;1,0;;;;;8,0;10,0;31,0;33,0;;426,0;14,0;;;1,0;6,0;;;53,0;;49,0;1,0;1,0;;141,0;;;;3,0;1,0;;;;;;;;;;4,0;15,0;;;8,0;;;1,0;;;;;1,0;;;;;;;;2,0;;;;1,0;16,0;;;;;;;3,0;;;;;26,0;1,0;6,0;;;2,0;;10,0;5,0;;;;;17,0;;1,0;2,0;;55,0;;;;;;27,0;;;;12,0;;;;;;26,0;;;;;;;;;;3,0;;;7,0;;;;13,0;;;1,0;;117,0;18,0;;;;;;;;;;;;;;;;;;34,0;;;2,0;;;;;1,0;;6,0;;;;;;5,0;;;1,0;3,0;;;;2,0;;5,0;3,0;5,0;;;;;;;;1,0;;;2,0;;;;;1,0;;;;;;;;;1,0;3,0;;;;8,0;5,0;;;;;;;;;7,0;;;;;2,0;;;20,0;;;;;;;;;;;;;;;2,0;;;73,0;;;6,0;;;;;1,0;;;;;40,0;;5,0;;;;3,0;;38,0;2,0;1,0;2,0;3,0;;14,0;;;;;;;;1,0;7,0;6,0;;;1,0;;;;2,0;2,0;;17,0;;;;5,0;17,0;22,0;;;37,0;;11,0;;2,0;16,0;;17,0;;;;90,0;3,0;2,0;;2,0;;;1,0;;;;;2,0;;3,0;;1,0;;1,0;8,0;3,0;;;56,0;;;4,0;;;5,0;;;4,0;;3,0;9,0;;2,0;;;;13,0;;4,0;;;;;;1,0;17,0;1,0;1,0;6,0;;;;;3,0;;4,0;;;;;;;;1,0;;5,0;;;;;;16,0;;;1,0;;;;3,0;;1,0;;4,0;;;;;2,0;2,0;15,0;;21,0;;;23,0;;16,0;1,0;;;;4,0;;;;;;;;;;;;;8,0;1,0;;;;5,0;;;;;;;;;;;;;;4,0;;1,0;;;;;;;;;;;;;1,0;;4,0;2,0;;;2,0;;14,0;;;17,0;29,0;;;;;;;;;;;;;;;;;1,0;;;;2,0;;;15,0;22,0;;;;7,0;4,0;;;;;3,0;;;;;;;4,0;;;;;;;3,0;;;;;;;9,0;;;;9,0;;;2,0;;;;;13,0;;;;;22,0;;;;;;;;;;;;1,0;;;;;6,0;;;;;;1,0;12,0;6,0;;;;;;;;;;;;;;;;3,0;;;;;;12,0;;;2,0;;25,0;;2,0;44,0;;;4,0;;;;;1,0;17,0;;4,0;;;;;;;;;;1,0;7,0;;1,0;10,0;;;;;6,0;;;;1,0;;;;;;;;;;10,0;1,0;;;;;;;;;51,0;94,0;1,0;3,0;2,0;17,0;;;;;;4,0;;;;15,0;;;;1,0;;3,0;4,0;3,0;;9,0;;48,0;;3,0;;;;1,0;;2,0;;;;;;;;;;;;;32,0;;;;;;;;;;;;;;;;1,0;;;;;4,0;;;;;;;;;42,0;11,0;;;;;;;;;;4,0;;;;;;;1,0;;;;;;;;;;;;;;;14,0;;;;;;;;5,0;4,0;;1,0;;;;;;;;1,0;;;;;;;;;;;;;;;;;;;;;18,0;;;;;;;;;;;;;;;;;1,0;;;;;;;;;;;;;;16,0;;;;;;3,0;;3,0;;;;;;;;;;2,0;;;;;;;;;;;;;;;;;;;;;;;;;;;2,0;;;;;;;;;;;;;;;;;;;;;;;;;;;;;;
close;;;14,0;;22,0;3,0;16,0;28,0;1,0;20,0;14,0;16,0;;;23,0;;;;12,0;1,0;8,0;31,0;2,0;3,0;;2,0;1,0;11,0;8,0;23,0;12,0;23,0;51,0;;11,0;;2,0;30,0;6,0;38,0;79,0;;18,0;41,0;;2,0;2,0;8,0;36,0;3,0;9,0;1,0;6,0;49,0;3,0;179,0;19,0;2,0;2,0;381,0;6,0;;38,0;1,0;1,0;;48,0;4,0;;47,0;34,0;3,0;8,0;3,0;14,0;7,0;;49,0;546,0;7,0;5,0;5,0;3,0;3,0;;;40,0;3,0;1,0;4,0;12,0;;9,0;24,0;1,0;26,0;;3,0;4,0;25,0;103,0;32,0;;11,0;1,0;;4,0;80,0;;;3,0;27,0;4,0;31,0;12,0;;82,0;;2,0;56,0;;;5,0;32,0;2,0;;42,0;7,0;;2,0;66,0;1,0;1,0;9,0;;8,0;58,0;8,0;7,0;;;;3,0;20,0;9,0;16,0;52,0;14,0;3,0;1,0;;;9,0;1,0;3,0;11,0;20,0;42,0;4,0;29,0;5,0;;3,0;2,0;;10,0;4,0;40,0;;4,0;107,0;14,0;14,0;16,0;20,0;264,0;11,0;5,0;;;6,0;12,0;2,0;;2,0;20,0;16,0;17,0;;85,0;6,0;;1,0;12,0;1,0;5,0;3,0;;11,0;5,0;3,0;10,0;13,0;184,0;;1,0;10,0;12,0;1,0;5,0;;1,0;;;2,0;10,0;5,0;6,0;3,0;1,0;5,0;11,0;1,0;5,0;14,0;;16,0;1,0;;;2,0;;5,0;11,0;5,0;11,0;1,0;8,0;55,0;;7,0;1,0;4,0;5,0;;13,0;8,0;;3,0;;3,0;;2,0;13,0;;2,0;3,0;4,0;;2,0;5,0;10,0;15,0;10,0;12,0;;11,0;;;1,0;3,0;29,0;1,0;;2,0;2,0;3,0;1,0;6,0;37,0;9,0;8,0;2,0;19,0;11,0;33,0;34,0;139,0;3,0;;;;3,0;;;4,0;1,0;21,0;3,0;2,0;25,0;;15,0;3,0;;1,0;3,0;27,0;10,0;;12,0;2,0;3,0;5,0;4,0;2,0;4,0;;;3,0;;5,0;9,0;17,0;;5,0;;7,0;;;10,0;;5,0;3,0;;1,0;;1,0;;;;2,0;;;;;;;6,0;8,0;;1,0;2,0;7,0;;;;;;;;4,0;;2,0;12,0;15,0;;;2,0;23,0;2,0;;2,0;2,0;1,0;;3,0;;;3,0;16,0;2,0;;;13,0;6,0;3,0;;;4,0;2,0;3,0;7,0;;73,0;9,0;12,0;17,0;9,0;4,0;18,0;;;;;;;10,0;;;4,0;15,0;4,0;2,0;;3,0;2,0;;5,0;4,0;34,0;;;31,0;29,0;22,0;;3,0;;5,0;;;;;;;;;;2,0;3,0;;;;29,0;1,0;5,0;;11,0;4,0;;5,0;4,0;;6,0;;;;;;1,0;;;1,0;1,0;21,0;53,0;;2,0;;;10,0;1,0;1,0;1,0;;;;;;;;;;;13,0;2,0;4,0;;4,0;;42,0;31,0;3,0;28,0;23,0;3,0;;;;2,0;;;;29,0;1,0;;;2,0;6,0;3,0;;;;;4,0;2,0;;;5,0;;3,0;2,0;2,0;;;2,0;;;7,0;;;4,0;;2,0;;1,0;4,0;2,0;;;;;1,0;2,0;1,0;5,0;;;;;;;;;4,0;1,0;;1,0;13,0;37,0;;;2,0;3,0;;15,0;;;;;;;;;;;;;;4,0;1,0;30,0;3,0;;49,0;1,0;;;;;;;;8,0;;;4,0;1,0;;1,0;;18,0;3,0;;;10,0;6,0;;16,0;;;;;;;2,0;;1,0;;;;;;;6,0;;11,0;4,0;1,0;;5,0;5,0;4,0;;;3,0;42,0;;;;1,0;39,0;;1,0;;;2,0;1,0;4,0;3,0;7,0;;9,0;1,0;5,0;;;2,0;2,0;1,0;;;1,0;8,0;1,0;;1,0;1,0;5,0;18,0;5,0;13,0;;1,0;;;1,0;;12,0;;;;2,0;3,0;;;1,0;;;;6,0;;;2,0;;14,0;7,0;2,0;2,0;2,0;;;3,0;;1,0;;;1,0;9,0;;1,0;1,0;2,0;;;1,0;2,0;2,0;16,0;3,0;;2,0;;;;;;3,0;;1,0;2,0;4,0;;;4,0;;;;1,0;1,0;4,0;2,0;2,0;1,0;;;;;1,0;;;;2,0;7,0;;;2,0;2,0;;;4,0;;1,0;3,0;4,0;2,0;;2,0;;2,0;;;;;17,0;8,0;4,0;;;;1,0;;8,0;;;12,0;2,0;2,0;;1,0;;;5,0;;2,0;1,0;4,0;;1,0;;;;3,0;1,0;;;;9,0;;;1,0;3,0;;;;;1,0;8,0;;;;4,0;2,0;;2,0;;;2,0;;;;2,0;1,0;;2,0;;;;1,0;;;;;;3,0;;;;;;2,0;;2,0;;;5,0;;8,0;;;;11,0;;;;;;1,0;3,0;;3,0;2,0;;2,0;;;;3,0;3,0;;1,0;1,0;2,0;3,0;;1,0;;2,0;;;2,0;;;;;;;;1,0;;6,0;5,0;;;;;;;;3,0;;1,0;1,0;;;;;;;;;2,0;;;;;;;;;;;;;;;;;9,0;;;;;;;;;;;;;1,0;;;2,0;;3,0;;;;;;;;;;;;;;;;;2,0;2,0;2,0;;;;;;;;;;;;1,0;;;;;;;10,0;;;;
coat;;;14,0;;5,0;;2,0;12,0;9,0;4,0;;;;;;;;;2,0;;;;;;1,0;;;;;4,0;;;12,0;;19,0;2,0;;1,0;;12,0;;;;11,0;;;;;;;1,0;;;7,0;;10,0;66,0;;;34,0;;;64,0;;;1,0;;1,0;;;17,0;;3,0;;;;;;;;1,0;;1,0;;1,0;9,0;2,0;;;4,0;3,0;;;;1,0;;;;;32,0;44,0;19,0;;1,0;;;;2,0;2,0;2,0;;3,0;7,0;3,0;1,0;;1,0;;10,0;6,0;;;;4,0;;;;1,0;;4,0;;;;;;;5,0;;2,0;;;;3,0;;6,0;;19,0;;;2,0;;;;;;;1,0;3,0;;1,0;5,0;;3,0;2,0;;22,0;;18,0;;14,0;9,0;5,0;9,0;1,0;;1,0;;;;;;;;;1,0;7,0;3,0;3,0;;15,0;2,0;1,0;8,0;;;7,0;;;;;;1,0;;3,0;;;;;2,0;13,0;;4,0;1,0;13,0;;;1,0;17,0;;;1,0;2,0;;11,0;;;4,0;;;;;;;3,0;;2,0;;76,0;18,0;;;;3,0;2,0;;;;;;;;;2,0;;3,0;;1,0;;1,0;;;;;;2,0;;;;;;1,0;3,0;;;1,0;;;;;;;1,0;;;1,0;3,0;;2,0;;1,0;;;;;;;;;;;;;4,0;;;;;5,0;2,0;;;;;;;;;;;1,0;;;;;;5,0;;;;;5,0;;;;;;;;;;;;;;;;;;;;2,0;;;;;;;;;1,0;;;;;;;;;4,0;;;2,0;;11,0;;;;;;;;;;;;;;4,0;;;;;2,0;;;;;;;;;;;;;;;;;;;;;2,0;;;;;;;1,0;;;;;;;;;;;;;;;;;;;;;;;;;;;;2,0;;;;3,0;;;;;;;;;;;;;;;;;;;;;;;;7,0;;;;;;;;;2,0;3,0;;;;;;;;;1,0;;;;;;;;;1,0;;;;;;;;;;;;;;;;;;;;;;1,0;;;;;;;;;;;;;;;;;;1,0;;;;;;1,0;;33,0;;;;1,0;;;10,0;;;;;;;;;;;;;;;;;;;1,0;;;;;;;;;;;;;4,0;;;;;;;3,0;;;;;;;;1,0;;;;;1,0;;;;;;;;;;3,0;;;;;;;;;;4,0;;;;;;;;;;;;;;;4,0;;16,0;;;23,0;;1,0;;;;;;;;;;;37,0;7,0;1,0;1,0;4,0;;;;;;;;;;;;;;;;;;;1,0;;;;;;;;;;;;;;;;;;1,0;;;;1,0;;;;;;;;;;1,0;6,0;;;;;;;;;;;;;;;;;;;;;;;;;;;;;;;;;;;;;;;;;;;;;;;;;;;;;;;;;;;;;;;;;;;;;;;;;;;;;;;;;;;;;;3,0;;;;;;;2,0;;;;;;;;;;;;;;;;;;;21,0;;6,0;;;;1,0;;;;;;;;;;;1,0;;;;;;;;;;;;;;2,0;;;;;;;1,0;;1,0;;;;3,0;;;;2,0;;;;;;;;;;;;;;;;;;;;;;;;;;;;;;5,0;;;;;;;;;;;;;;;;;;;;;;;;;;;1,0;;;;;;;;;;;;;;4,0;2,0;;;;;;;;;;;;;;;;;;;;;;;;;;;;;;;;1,0;;;;;;;;;;;;;;;
code;;;85,0;1,0;52,0;;3,0;46,0;15,0;35,0;3,0;2,0;1,0;8,0;25,0;;2,0;;1,0;184,0;;51,0;27,0;19,0;;;;284,0;;31,0;6,0;127,0;83,0;13,0;60,0;11,0;1,0;8,0;;46,0;15,0;3,0;;6,0;19,0;;;;1,0;55,0;5,0;56,0;;3,0;;303,0;181,0;;;5,0;;;135,0;;;;26,0;;1,0;8,0;7,0;1,0;1,0;;;;;14,0;20,0;9,0;;84,0;77,0;6,0;;;30,0;;8,0;25,0;16,0;3,0;;70,0;7,0;;1,0;10,0;45,0;4,0;12,0;102,0;;2,0;8,0;1,0;4,0;95,0;;;10,0;7,0;10,0;14,0;4,0;;;2,0;;2,0;;;1,0;37,0;;;149,0;;;3,0;2,0;11,0;;;;12,0;1,0;;;2,0;;7,0;3,0;5,0;9,0;;11,0;22,0;8,0;;1,0;;5,0;3,0;;1,0;;12,0;2,0;48,0;;1,0;;;;12,0;4,0;30,0;16,0;1,0;;5,0;40,0;;4,0;;1,0;12,0;1,0;;;18,0;1,0;;;1,0;;61,0;;19,0;;;4,0;77,0;13,0;;;;5,0;;4,0;2,0;;;;;1,0;;3,0;7,0;7,0;11,0;;;9,0;22,0;43,0;;;;2,0;;;3,0;1,0;1,0;9,0;;;;;;;2,0;8,0;7,0;;15,0;26,0;;;;29,0;;;;5,0;;;;7,0;60,0;;6,0;;5,0;;11,0;;;1,0;;;;1,0;;;;;;;;;;;24,0;114,0;;5,0;18,0;3,0;;;5,0;;19,0;2,0;35,0;4,0;4,0;1,0;1,0;3,0;29,0;;;;;;;6,0;;35,0;4,0;8,0;;;18,0;;8,0;5,0;26,0;;;;;;;1,0;;;8,0;;;;7,0;;;;;17,0;1,0;;;;;;;;;;18,0;1,0;4,0;;2,0;2,0;6,0;;7,0;;8,0;33,0;;5,0;;1,0;;;;;2,0;;;18,0;5,0;1,0;12,0;3,0;6,0;2,0;1,0;;13,0;34,0;41,0;8,0;1,0;;3,0;;3,0;71,0;303,0;;;7,0;1,0;83,0;27,0;;4,0;;2,0;;1,0;19,0;101,0;10,0;2,0;8,0;;6,0;;;6,0;;2,0;4,0;4,0;;6,0;;3,0;;7,0;11,0;;13,0;;8,0;1,0;8,0;11,0;5,0;;3,0;28,0;3,0;;8,0;4,0;;;;;;3,0;9,0;6,0;;2,0;4,0;;11,0;34,0;3,0;15,0;1,0;4,0;;79,0;21,0;1,0;7,0;9,0;11,0;7,0;16,0;3,0;;7,0;;;;3,0;;;13,0;;;50,0;;;;5,0;13,0;4,0;6,0;2,0;5,0;8,0;5,0;;;1,0;1,0;7,0;;4,0;;9,0;4,0;6,0;75,0;39,0;3,0;4,0;12,0;;3,0;5,0;;3,0;6,0;;;;;6,0;;;;;5,0;1,0;;7,0;9,0;;;;6,0;;;;5,0;;2,0;;7,0;;;1,0;11,0;;;1,0;2,0;4,0;;3,0;4,0;;;;10,0;54,0;;3,0;2,0;16,0;;;5,0;;4,0;;1,0;3,0;32,0;;2,0;;;;7,0;5,0;;9,0;;4,0;;4,0;;;;12,0;;;;10,0;7,0;;10,0;1,0;;5,0;1,0;1,0;8,0;;;;;;;;;1,0;;;1,0;;;;;2,0;;;;;;;;;;;;;;;;2,0;;;;;2,0;1,0;;;;;;;;;;;;2,0;;;;128,0;;3,0;2,0;;5,0;2,0;;;;;;18,0;11,0;8,0;6,0;;6,0;2,0;;5,0;;;;;;;;;3,0;;;;;2,0;;;10,0;;2,0;;;;;;;1,0;;2,0;1,0;;;3,0;6,0;;5,0;;;;1,0;;;;;86,0;;5,0;2,0;6,0;;;;;;;;45,0;;;;;3,0;7,0;;;1,0;;10,0;;;1,0;;;8,0;;;;;12,0;;;;8,0;;;;;;1,0;;1,0;2,0;;;;3,0;;8,0;15,0;;4,0;;2,0;10,0;;5,0;;;;;;1,0;1,0;1,0;3,0;4,0;;;;;8,0;3,0;1,0;;;2,0;;;30,0;9,0;3,0;8,0;;;;;;;;;;;5,0;68,0;;;;;168,0;;;;;4,0;;1,0;3,0;1,0;;;;;;;;;;3,0;;;;4,0;;1,0;;;;4,0;5,0;2,0;;;;;;;;14,0;6,0;3,0;;6,0;;;3,0;;13,0;;;;;;;18,0;;;;;;;5,0;27,0;1,0;10,0;;;;;;;;;4,0;;14,0;;;;;2,0;;6,0;;3,0;;46,0;;;;;;;1,0;1,0;;;;1,0;;5,0;;;;;;;1,0;;;;;;;;;3,0;3,0;;;;57,0;;;;;;;2,0;14,0;;;2,0;6,0;;1,0;;;;;;4,0;9,0;;;2,0;2,0;;;;;;;;;;;;;10,0;;;;;;;;1,0;;7,0;;;;;;;;;;;;;;;;
coil;;;9,0;;17,0;;50,0;74,0;;1,0;18,0;;2,0;;;;;;6,0;;;46,0;;5,0;21,0;;;;5,0;17,0;4,0;;65,0;6,0;11,0;;1,0;182,0;2,0;4,0;7,0;;113,0;33,0;;;;2,0;5,0;;;51,0;;1,0;5,0;37,0;72,0;;11,0;139,0;11,0;;1,0;;;45,0;45,0;;;5,0;28,0;;;12,0;6,0;;;5,0;95,0;20,0;;1,0;2,0;17,0;;;;2,0;;;19,0;2,0;;31,0;;10,0;;;;15,0;38,0;5,0;;5,0;;;;89,0;3,0;;4,0;40,0;;8,0;21,0;;;;24,0;10,0;;;;35,0;;;13,0;7,0;;13,0;2,0;2,0;1,0;35,0;;;51,0;;1,0;2,0;;;2,0;22,0;;62,0;59,0;41,0;;;;11,0;32,0;;11,0;43,0;14,0;21,0;;21,0;;2,0;18,0;7,0;;24,0;1,0;7,0;;5,0;102,0;1,0;45,0;90,0;15,0;6,0;19,0;;;;;;9,0;1,0;1,0;16,0;6,0;41,0;;93,0;;1,0;;35,0;2,0;;;11,0;12,0;26,0;32,0;8,0;5,0;53,0;9,0;;31,0;9,0;3,0;23,0;;46,0;;;;;5,0;;;;72,0;;3,0;;9,0;;;4,0;;11,0;1,0;;53,0;13,0;2,0;3,0;1,0;35,0;;29,0;44,0;4,0;17,0;;;;;;5,0;;;15,0;5,0;98,0;4,0;4,0;30,0;16,0;;12,0;;100,0;;11,0;8,0;;28,0;4,0;35,0;7,0;4,0;2,0;1,0;1,0;1,0;;;;7,0;24,0;1,0;187,0;;5,0;;1,0;30,0;;;31,0;;;6,0;;35,0;6,0;;;40,0;11,0;;4,0;4,0;18,0;;2,0;;11,0;3,0;1,0;1,0;7,0;;4,0;8,0;;3,0;21,0;2,0;;243,0;5,0;4,0;6,0;;12,0;;70,0;23,0;1,0;;;;;;;;;;3,0;;;;2,0;2,0;;;;1,0;1,0;;19,0;;4,0;;2,0;;;;;;;;13,0;;1,0;;;1,0;;;1,0;1,0;;;;1,0;;;20,0;;7,0;;;;;;;;;1,0;8,0;3,0;;7,0;1,0;1,0;;;;;;;6,0;;;1,0;1,0;5,0;;3,0;;1,0;;;;;;;;3,0;2,0;;1,0;1,0;;;;1,0;;;;;;;;;;;1,0;5,0;;;7,0;;6,0;;;;8,0;;;75,0;;;;;1,0;;;;;1,0;;;;42,0;;;;;3,0;;;;;6,0;;;;;;;;;2,0;;;;;;6,0;;7,0;;1,0;;27,0;;;;;;;3,0;;;14,0;;2,0;3,0;;;;;3,0;10,0;;;;;;;;;;;;;;2,0;;;;;;;;;;;;;22,0;2,0;;1,0;;;;;;4,0;;;;;;2,0;;2,0;;;;;;10,0;;;;;;;;15,0;;;;2,0;;;;;;;2,0;1,0;;;;;3,0;;;;;1,0;;;2,0;;;;;;;;;;;;2,0;;;;;;;;;;;;;;;;;;;;27,0;;;;;;3,0;;;;;1,0;;;;;;;;;1,0;;2,0;8,0;;;;;2,0;;;;1,0;;;29,0;;;;;;;5,0;;;;;;;;;;;;;;;;;;36,0;;;;;2,0;;;;;;;;;;;;;1,0;;1,0;;;;;;54,0;;;;;2,0;;;;;;;;;;;;;;;;;;1,0;;;4,0;;;;;1,0;;;2,0;;;;;;;;2,0;7,0;;;7,0;;;;1,0;;;;3,0;2,0;;;;;1,0;;;;;;;;;;;;;;;;;;;;;;;;;;;;;;;;;;;;;56,0;;;;;;;;2,0;;;;;;;;;2,0;;1,0;;;;;;3,0;;;10,0;;52,0;;;;;1,0;;;;;;;;;4,0;5,0;;5,0;;;;;;18,0;;8,0;;;;;2,0;;;;2,0;;;;;3,0;;1,0;;;;;;4,0;;;;;;;;9,0;;1,0;;;;;;;;;;;;;;;;;;;;;;;;1,0;;;;4,0;;;;;;;;;8,0;;;;;;;;;;;;1,0;;;;;4,0;;;;;2,0;;;5,0;;;;;;;;;;;1,0;;;;;;;;;5,0;;;27,0;;;;;2,0;;;;;;;;
collect;;;1,0;2,0;1,0;;2,0;5,0;;9,0;;;;;3,0;;;;1,0;;;5,0;;;;;;99,0;1,0;3,0;1,0;5,0;20,0;;2,0;;;;;7,0;;;;25,0;2,0;;;;2,0;1,0;;6,0;;3,0;;93,0;16,0;;;27,0;;;21,0;;;;;2,0;;;6,0;1,0;2,0;;;;;4,0;11,0;1,0;;9,0;3,0;;;;6,0;;7,0;12,0;15,0;;;15,0;;;;;7,0;;33,0;8,0;;8,0;;;;28,0;;2,0;2,0;;12,0;3,0;;1,0;3,0;4,0;1,0;;;;;4,0;;;13,0;;;;3,0;;;;;15,0;;;9,0;5,0;8,0;;3,0;6,0;15,0;;12,0;3,0;;;4,0;;;;;;4,0;2,0;;9,0;20,0;;;;;8,0;;45,0;;1,0;;2,0;17,0;;;3,0;;8,0;;;;;3,0;;;3,0;;49,0;;7,0;;;17,0;4,0;;9,0;;;;;;;;1,0;;1,0;;1,0;2,0;;;;;;3,0;5,0;8,0;3,0;;5,0;3,0;;;1,0;;2,0;;;;;;;;1,0;9,0;;;4,0;15,0;;;;;;;;11,0;;;;;;;;;1,0;1,0;9,0;;;1,0;;;;;;;;;3,0;;1,0;;;;;;;;;;;;;;;;3,0;4,0;;;;;1,0;;;;3,0;;;1,0;;3,0;1,0;1,0;;;4,0;;;2,0;2,0;;;;;;;;;;4,0;;;;12,0;;;;;1,0;1,0;;;;1,0;;2,0;;;;;;2,0;;;;;;;;;1,0;;;;2,0;;;;1,0;;;;;;;3,0;;1,0;;;;;;;6,0;2,0;;3,0;1,0;;;4,0;;2,0;;1,0;1,0;;;;;;;;;4,0;;;4,0;8,0;3,0;1,0;;;;;;2,0;;;;1,0;;;;;2,0;;3,0;;;;2,0;;;;;15,0;;;;;;;;;3,0;;;;;1,0;1,0;1,0;;9,0;;1,0;;;1,0;1,0;;;;;1,0;;;;;3,0;11,0;;;;5,0;;;5,0;;;;;;;;;2,0;;;;;;1,0;;;1,0;20,0;;;;10,0;8,0;;;;;;;;;5,0;;;;;;;;;;;;;;;;;;;;;;;;;;;;;;;;;;;;;4,0;;;;;;;;1,0;;1,0;;;;;;;;;14,0;11,0;;;;;;;;;;;;;;;;;;;;;7,0;;2,0;;;;;9,0;;;;;1,0;18,0;;;;;;;;;;;;;;;;;;;;;;;;;;;;1,0;;;;;;;4,0;;;;;;5,0;;;;;;5,0;;;3,0;;;;;2,0;;;;;;3,0;;;;7,0;;1,0;;;;;;;;;;;;4,0;;;;;;1,0;;7,0;3,0;1,0;2,0;;;;;1,0;1,0;;;1,0;;;2,0;3,0;2,0;4,0;;;;1,0;;;;;;;;;1,0;;;1,0;;;;;;;;;1,0;;;;;;;2,0;;;;;;;;2,0;;;;;;;4,0;;;;;;;;;;;;;;4,0;1,0;1,0;;;;;;;;;;2,0;;;;;;;;;;4,0;;;1,0;;;;;1,0;;;;;;;;;;;;;;4,0;;;2,0;;;;;;;;1,0;;;;;;;;;;;;2,0;;;;1,0;;;;;;2,0;;;;;;2,0;;2,0;;;;;;;;;;;;;;;;;;1,0;;;;;;;;;;;;;;;;;;;;;;;;;;;;;;;;;;;;;;;;;;;;;;;;;;;;;;;;;;;;;;;13,0;;;;2,0;;;4,0;;;;;;;;;;;;;;;;;;;;;;;;;;;;;;;;;;;;;;;;;;;;;;;4,0;;;;;;;;;;;;;;;;;;
command;;;15,0;8,0;30,0;;;69,0;24,0;28,0;2,0;1,0;;;3,0;1,0;;13,0;8,0;28,0;2,0;298,0;2,0;;;;;80,0;;27,0;13,0;35,0;171,0;1,0;26,0;;4,0;13,0;4,0;46,0;8,0;;9,0;6,0;3,0;;;;23,0;6,0;12,0;76,0;;1,0;;112,0;43,0;;;42,0;1,0;7,0;93,0;2,0;;9,0;34,0;;2,0;28,0;;1,0;4,0;;;1,0;;22,0;66,0;2,0;;10,0;10,0;9,0;;;6,0;;3,0;44,0;8,0;;;133,0;;5,0;;7,0;39,0;;1,0;35,0;1,0;7,0;1,0;2,0;5,0;95,0;1,0;;8,0;;;10,0;1,0;;;;;9,0;;;1,0;3,0;;;39,0;;;2,0;;2,0;;;;2,0;1,0;;;;1,0;;28,0;6,0;3,0;;3,0;4,0;;;;;;;;;;;3,0;6,0;3,0;4,0;;1,0;;;4,0;5,0;;;24,0;;11,0;2,0;132,0;;;77,0;;;2,0;4,0;1,0;;;;;47,0;;3,0;;;;167,0;;;;;3,0;4,0;;;;;;13,0;;;;1,0;;;;;83,0;64,0;69,0;;;;;17,0;;;;;6,0;;;;;;1,0;;5,0;6,0;;29,0;7,0;3,0;1,0;;4,0;;;;3,0;1,0;;19,0;;1,0;;5,0;;2,0;;3,0;;;;6,0;;;2,0;;2,0;;;;;;2,0;;;14,0;2,0;;;;1,0;;1,0;3,0;;18,0;13,0;16,0;19,0;;4,0;;;15,0;;;;29,0;;;14,0;;14,0;;1,0;;;;;;8,0;;2,0;1,0;;;;;;;;8,0;;;;5,0;;;2,0;;72,0;;;1,0;2,0;;1,0;;;1,0;2,0;20,0;;11,0;8,0;1,0;;2,0;;11,0;1,0;;6,0;3,0;;;1,0;;;1,0;2,0;;;;12,0;12,0;1,0;3,0;;4,0;;;3,0;2,0;11,0;34,0;9,0;;;;7,0;;2,0;14,0;;;2,0;1,0;;23,0;19,0;94,0;;;27,0;39,0;58,0;6,0;2,0;3,0;8,0;;2,0;2,0;;5,0;6,0;53,0;13,0;1,0;;2,0;;;;2,0;;;87,0;;18,0;9,0;4,0;17,0;28,0;3,0;;14,0;;3,0;9,0;;1,0;;6,0;;1,0;2,0;8,0;;5,0;;2,0;2,0;21,0;48,0;;3,0;12,0;3,0;4,0;35,0;12,0;3,0;;;;16,0;14,0;2,0;;1,0;;8,0;2,0;8,0;4,0;5,0;6,0;;;38,0;;1,0;1,0;4,0;2,0;7,0;2,0;13,0;6,0;;10,0;5,0;;3,0;13,0;10,0;;18,0;8,0;10,0;;4,0;31,0;22,0;;1,0;;2,0;;10,0;;2,0;;;;;;;;;3,0;8,0;19,0;5,0;2,0;8,0;1,0;;;;;1,0;2,0;24,0;6,0;;;14,0;1,0;;;;2,0;;;4,0;1,0;;;;7,0;;;;2,0;1,0;1,0;7,0;2,0;;;3,0;19,0;;1,0;1,0;;;1,0;;;;;1,0;1,0;6,0;;;;28,0;1,0;;;;;5,0;;11,0;;2,0;10,0;;1,0;19,0;;1,0;;;8,0;;;;;1,0;;;1,0;;;;46,0;;;7,0;;;;;;2,0;;;8,0;1,0;15,0;;;1,0;;;1,0;;;;;;13,0;;;;;21,0;;;;;;;;;;;;22,0;;;;;;;;;;;;;1,0;;1,0;;1,0;;;1,0;1,0;;;;18,0;;4,0;;;;;;;;;;1,0;;;;;;4,0;;;;1,0;;3,0;;;2,0;;;3,0;1,0;;1,0;;;;;7,0;2,0;;;2,0;1,0;2,0;;;21,0;;;;;;;;5,0;;1,0;;;;1,0;2,0;1,0;;;4,0;;11,0;;;;;;;12,0;;;;;;;;;;2,0;;8,0;;;;;;;;;;;;;3,0;;3,0;;;;;2,0;1,0;1,0;2,0;;;2,0;;1,0;2,0;1,0;;;;;;;6,0;;18,0;;3,0;;3,0;20,0;;;;;;3,0;9,0;1,0;;;;;;;;;1,0;;;5,0;3,0;;7,0;;;3,0;;;3,0;;;1,0;;;;;5,0;;;3,0;;9,0;16,0;;;;;;;;;1,0;;1,0;3,0;;;2,0;;10,0;;;;;2,0;;3,0;;;;1,0;;;;;;;;;;;;;;;;6,0;;;;;;;;1,0;;6,0;;7,0;;;;;1,0;;1,0;;;;;;15,0;;;;;;;;3,0;;;3,0;;;;;;10,0;3,0;;;;;;;;;;;;;;;2,0;;;;;;;;;;;;;;;;;;;;;;;;;;;;;;6,0;;;;1,0;1,0;;;;;;;1,0;;;;;;;2,0;;;;
communicate;;;2,0;;24,0;;;22,0;;4,0;;1,0;;;;3,0;;2,0;10,0;22,0;3,0;50,0;;3,0;;;1,0;85,0;;3,0;4,0;8,0;105,0;;23,0;;1,0;1,0;4,0;18,0;;;2,0;3,0;;;;;2,0;;5,0;17,0;;;;79,0;29,0;;;40,0;;;36,0;;;;;2,0;;2,0;13,0;1,0;;5,0;4,0;1,0;;3,0;23,0;7,0;;16,0;18,0;;;;4,0;;1,0;3,0;20,0;;6,0;67,0;;28,0;;7,0;22,0;2,0;9,0;33,0;;11,0;;1,0;2,0;74,0;7,0;;23,0;6,0;2,0;;;;4,0;;5,0;33,0;;;;14,0;;;46,0;4,0;;4,0;;;;2,0;;6,0;5,0;;;2,0;1,0;;25,0;4,0;1,0;2,0;10,0;9,0;;;;13,0;5,0;;5,0;6,0;41,0;11,0;;15,0;2,0;;3,0;1,0;41,0;;;17,0;;;3,0;;48,0;9,0;;15,0;1,0;6,0;;;;;;;2,0;1,0;;12,0;;14,0;;1,0;;39,0;5,0;;;;;;2,0;;;6,0;;3,0;;;;5,0;;;;;4,0;9,0;16,0;2,0;;;1,0;;;;2,0;;15,0;;;;;;;3,0;1,0;;;;4,0;;6,0;;6,0;3,0;4,0;2,0;8,0;10,0;;;;;;7,0;;;;19,0;;2,0;;;1,0;1,0;2,0;;4,0;;2,0;;;2,0;;4,0;;58,0;;;;1,0;;;1,0;2,0;;4,0;;4,0;1,0;2,0;;;;;;;;5,0;;;12,0;;2,0;3,0;;;;9,0;2,0;7,0;;6,0;;;;;;;;3,0;1,0;1,0;1,0;4,0;;3,0;3,0;2,0;2,0;;13,0;;;;;;;;1,0;;1,0;10,0;;;;;;4,0;4,0;;;6,0;2,0;;;;;;;;;;;4,0;2,0;9,0;3,0;;;;;;;;6,0;6,0;;1,0;;3,0;;3,0;;4,0;;;;;;7,0;1,0;13,0;;8,0;;14,0;1,0;9,0;;;9,0;;;;;;;2,0;2,0;;1,0;5,0;;;20,0;4,0;;;6,0;4,0;5,0;;8,0;11,0;21,0;5,0;;;1,0;4,0;;;2,0;;;1,0;;;2,0;;2,0;;2,0;1,0;5,0;17,0;2,0;3,0;;4,0;;;4,0;19,0;;6,0;6,0;;8,0;;;;;;3,0;11,0;;;5,0;;;7,0;;;4,0;;5,0;3,0;;1,0;1,0;9,0;9,0;1,0;;;13,0;;1,0;3,0;;2,0;;1,0;32,0;2,0;;1,0;;;;17,0;1,0;;2,0;2,0;;;;;23,0;;9,0;9,0;93,0;3,0;9,0;1,0;2,0;;2,0;;1,0;;;;11,0;;;;;;;;13,0;1,0;1,0;4,0;4,0;;;;1,0;3,0;7,0;1,0;;2,0;;;3,0;2,0;;;46,0;;9,0;;1,0;2,0;5,0;;17,0;;;;4,0;1,0;;;;;25,0;6,0;10,0;;14,0;;;7,0;;8,0;13,0;;;32,0;;;;;66,0;1,0;;2,0;;1,0;;4,0;;;;;1,0;1,0;;4,0;8,0;3,0;;;;;;;;;11,0;;;;;;;;;;;;7,0;;;7,0;;;;;;;1,0;;;;;;;;1,0;2,0;;;;;1,0;;2,0;;;;1,0;;6,0;1,0;14,0;;;;;1,0;;;;;;;2,0;;;1,0;;;;;;;;;;;;;;;;;;;;3,0;;;;;7,0;;;;;;;;;;;;;;;;;1,0;;;;;;;1,0;;;;1,0;;;;3,0;;;;;1,0;;;2,0;;;;1,0;;;;;;;;;;;;;1,0;;;;;;;;;;;;;;;;6,0;1,0;;;;;;;5,0;;2,0;2,0;;;;6,0;;;;;;;3,0;;;;;;;;1,0;;;2,0;;;;;1,0;2,0;;2,0;;;;;;1,0;2,0;;;;;;3,0;4,0;;;;;;;;6,0;;;;;6,0;;5,0;4,0;3,0;;;;2,0;;;;;1,0;;;;;;;;;4,0;;;3,0;;;;;;;;;;7,0;;;;;;;;;;;4,0;;;;;;;;;14,0;;24,0;;;;;;;;1,0;;;;1,0;1,0;;;;;;;3,0;1,0;;;16,0;;;;;;;;;;;;;;;;;;;;1,0;;9,0;1,0;;3,0;;;;;;3,0;;;;;;;;;;;;;;;;1,0;;;;;;;;;;;2,0;;;;2,0;;;;;;;;;;;;;
compare;;;29,0;;15,0;;2,0;29,0;17,0;41,0;3,0;44,0;2,0;8,0;22,0;3,0;;;3,0;6,0;9,0;27,0;21,0;9,0;8,0;3,0;2,0;104,0;5,0;31,0;18,0;57,0;47,0;28,0;16,0;;1,0;8,0;7,0;14,0;12,0;;2,0;5,0;2,0;2,0;;2,0;17,0;1,0;;23,0;;6,0;1,0;528,0;55,0;;8,0;32,0;;1,0;87,0;3,0;6,0;3,0;9,0;;2,0;8,0;4,0;7,0;2,0;;;4,0;;28,0;80,0;1,0;;22,0;15,0;2,0;;;14,0;;16,0;18,0;21,0;;2,0;124,0;11,0;;1,0;3,0;23,0;2,0;10,0;24,0;;;2,0;6,0;6,0;90,0;1,0;;2,0;4,0;8,0;1,0;1,0;;;;2,0;7,0;;;3,0;23,0;;2,0;45,0;;5,0;1,0;4,0;2,0;;;;6,0;1,0;;;;5,0;;;17,0;18,0;1,0;12,0;73,0;1,0;;;;;;;;;;3,0;6,0;;;;;1,0;;37,0;16,0;;2,0;2,0;;19,0;;22,0;2,0;;38,0;;;;;1,0;7,0;;4,0;3,0;87,0;;12,0;;;2,0;25,0;;;;;6,0;;2,0;1,0;;;;;;1,0;;;22,0;2,0;1,0;1,0;9,0;17,0;3,0;;;;;8,0;5,0;2,0;;19,0;12,0;;1,0;;;;4,0;2,0;5,0;12,0;;4,0;31,0;;;;12,0;;;4,0;;;;;23,0;;;;2,0;;;7,0;2,0;;1,0;;2,0;;;;;;;;;;;7,0;1,0;;;;1,0;7,0;;;;1,0;;30,0;3,0;35,0;1,0;;;;;15,0;1,0;;;8,0;;;;;25,0;;;;;9,0;;;59,0;14,0;;1,0;;;;;;;;8,0;;;;7,0;1,0;;2,0;8,0;11,0;;;;;;2,0;3,0;;1,0;;6,0;2,0;6,0;9,0;1,0;3,0;1,0;;13,0;4,0;2,0;4,0;1,0;;;1,0;1,0;;;4,0;6,0;;;18,0;6,0;;;5,0;5,0;1,0;;11,0;15,0;3,0;14,0;2,0;7,0;;;7,0;;2,0;5,0;1,0;6,0;3,0;1,0;;3,0;1,0;5,0;;;5,0;7,0;;31,0;55,0;2,0;20,0;1,0;2,0;1,0;8,0;2,0;1,0;10,0;1,0;1,0;1,0;;;;;10,0;25,0;;20,0;7,0;21,0;7,0;1,0;2,0;11,0;;6,0;7,0;2,0;16,0;6,0;1,0;;;;;12,0;1,0;4,0;;1,0;9,0;1,0;;;20,0;;3,0;;;;1,0;16,0;11,0;;3,0;5,0;;10,0;;7,0;5,0;10,0;;;8,0;;;11,0;;;11,0;1,0;;;5,0;3,0;;2,0;2,0;;2,0;;1,0;3,0;;3,0;3,0;;9,0;;4,0;19,0;1,0;45,0;12,0;;19,0;;;;2,0;;1,0;;1,0;1,0;;3,0;;;;;10,0;5,0;;;2,0;8,0;;;;3,0;1,0;;;2,0;;2,0;;;4,0;;;5,0;1,0;;;;5,0;;8,0;1,0;1,0;;;;3,0;;1,0;13,0;2,0;;2,0;3,0;;11,0;4,0;;3,0;104,0;19,0;;;;1,0;2,0;;;;;1,0;1,0;;;;;4,0;1,0;;1,0;3,0;25,0;15,0;2,0;5,0;;;;13,0;8,0;;;;;;;;;2,0;;;8,0;;;1,0;;;;2,0;;;;;;;1,0;;;;;;2,0;1,0;2,0;;;;;;;;;3,0;4,0;1,0;4,0;;;;;;;;;3,0;12,0;;;;10,0;1,0;;;;;;1,0;;;8,0;;;;;;1,0;;;;1,0;;1,0;;2,0;3,0;;2,0;;2,0;;;16,0;22,0;3,0;;;3,0;5,0;;;;;3,0;1,0;;1,0;;;;;1,0;;;7,0;;;10,0;5,0;6,0;6,0;3,0;1,0;;8,0;;;;;;;6,0;;;1,0;3,0;;5,0;;;;10,0;;;2,0;;;1,0;1,0;1,0;26,0;3,0;;4,0;4,0;3,0;1,0;7,0;1,0;5,0;;2,0;;;6,0;1,0;1,0;;1,0;2,0;;;1,0;6,0;59,0;;;8,0;4,0;17,0;2,0;;;;1,0;3,0;14,0;;;;;;;;;;14,0;3,0;;;1,0;;;4,0;;;2,0;;;;;;;;;;2,0;1,0;20,0;;;1,0;;1,0;;;3,0;1,0;1,0;;;;2,0;;;;;;5,0;;;;16,0;;;;2,0;9,0;;1,0;2,0;1,0;;;3,0;;;5,0;;;;4,0;;5,0;5,0;2,0;2,0;1,0;;2,0;;1,0;;;;;;;1,0;;;;;;;;;;1,0;4,0;;;;;;;;;;;;4,0;1,0;56,0;;1,0;;;;;1,0;;;;;;;;1,0;;;14,0;;;;2,0;;;;;2,0;2,0;;12,0;;10,0;;1,0;;;1,0;;;;;1,0;;;;;;;;2,0;2,0;34,0;;;;;;;;;1,0;7,0;;;;;;2,0;3,0;;4,0;;;2,0;;51,0;4,0;4,0;;11,0;;;;;2,0;;2,0;4,0;;;;1,0;;1,0;;;5,0;;1,0;;;;;;;
comparison;;;12,0;;24,0;;;116,0;10,0;16,0;2,0;5,0;;9,0;3,0;1,0;;;5,0;1,0;5,0;21,0;;1,0;7,0;1,0;1,0;36,0;9,0;15,0;17,0;38,0;12,0;8,0;10,0;;;3,0;;24,0;2,0;;;2,0;;2,0;;;5,0;;2,0;15,0;;;;115,0;13,0;;;6,0;;;30,0;1,0;;2,0;;;;16,0;;2,0;;;;;;8,0;23,0;;;14,0;1,0;10,0;;;7,0;;4,0;4,0;8,0;4,0;1,0;80,0;3,0;;;3,0;26,0;;2,0;8,0;;;;;;62,0;;;2,0;;;;;;;;;3,0;;;3,0;23,0;;;14,0;;4,0;5,0;;;;2,0;1,0;;;;;;3,0;;;6,0;4,0;;5,0;22,0;;;;;;;1,0;;;;;19,0;;;;;;;23,0;13,0;;;;;45,0;;7,0;4,0;;42,0;;;;;;;;;;9,0;;4,0;;;2,0;21,0;1,0;;;;1,0;;1,0;;3,0;1,0;;6,0;;;;;1,0;2,0;;;4,0;66,0;;;;;;;1,0;;;;;;;;;;;;5,0;4,0;;;10,0;;;;3,0;;;3,0;;;;;5,0;;;5,0;;;;1,0;;1,0;;;;;;;;;;2,0;;1,0;;1,0;;;;;;1,0;;;;1,0;;23,0;;12,0;5,0;;;;;2,0;;;;5,0;;;;;19,0;;;;;14,0;;;24,0;7,0;;;;;;;;;;2,0;;;;;;;1,0;;5,0;;;;;;;1,0;;4,0;;9,0;3,0;11,0;2,0;1,0;1,0;;;4,0;3,0;;4,0;4,0;;;5,0;2,0;;;3,0;3,0;;;5,0;15,0;;4,0;2,0;;2,0;;;6,0;2,0;4,0;;2,0;;;46,0;2,0;;;5,0;;;2,0;1,0;3,0;;22,0;;;2,0;;;22,0;19,0;;2,0;;2,0;;3,0;4,0;5,0;;;16,0;;4,0;;2,0;;;11,0;;4,0;2,0;3,0;;;4,0;2,0;;2,0;4,0;;;4,0;;;;;;2,0;;;;;8,0;;;;1,0;;1,0;;;;;;3,0;;;2,0;;1,0;;8,0;1,0;;;;2,0;;;3,0;;;43,0;;;;4,0;;;1,0;;2,0;;;2,0;;;1,0;2,0;13,0;5,0;;14,0;2,0;;18,0;7,0;;21,0;2,0;;;2,0;2,0;;3,0;;;;1,0;;;;;;5,0;;;2,0;1,0;;;;;;;;;;;;;5,0;;;;;;;;3,0;;;;;;;;;;;3,0;;;1,0;;;4,0;;;3,0;21,0;;1,0;;;2,0;6,0;;;;;1,0;;;;;;;;;;1,0;6,0;2,0;;4,0;;;;3,0;3,0;;;2,0;;;;;;2,0;;;5,0;;;;;;;;;;;;;;;;;8,0;1,0;;;;;;;;;;;;;6,0;;;2,0;;;;;;;;;;6,0;;;;4,0;;;;;;;;;;;;;;;;;;;;;;;;1,0;;;6,0;;;12,0;;10,0;11,0;2,0;;;;26,0;;;;;2,0;;;1,0;1,0;;;;;;;;;;1,0;;11,0;9,0;;;;;;3,0;;;;;;;;;;;2,0;;2,0;;4,0;59,0;;2,0;;;;1,0;;2,0;;;9,0;1,0;2,0;2,0;8,0;;9,0;;;;;2,0;;;;;2,0;;;1,0;;;;;1,0;1,0;2,0;7,0;;2,0;;1,0;;6,0;;2,0;1,0;;;;1,0;;;2,0;6,0;;;3,0;;;;;;;;;;;;;;3,0;;;;;;;;;;;;;;;;21,0;;;;;;;;;;;;3,0;;;;;8,0;;;;;;;;;;;;;;1,0;;;;;;;;1,0;;;;;;;;;;;1,0;;;;;;;;;;;;;;;;;;;;;;7,0;69,0;;;;;;;;;;;;;;;;;5,0;2,0;;;;2,0;;;;;;;;4,0;;;1,0;3,0;;;3,0;;;;;;;;;;;;3,0;;;;;1,0;;;;;;;;;;;;;;;;;1,0;;;;;9,0;1,0;1,0;1,0;;;;;;;;;;;;;;;;;;;;;;;;;;;
compose;;;2,0;;1,0;4,0;20,0;7,0;1,0;2,0;;1,0;;7,0;9,0;3,0;;;12,0;;1,0;1,0;6,0;;;;;11,0;;2,0;;9,0;13,0;5,0;37,0;;;3,0;;3,0;1,0;;1,0;74,0;;;;;2,0;3,0;4,0;4,0;;60,0;;81,0;8,0;;;260,0;;1,0;2,0;;;1,0;;;1,0;1,0;28,0;9,0;;;;;;;11,0;12,0;;;;;1,0;;8,0;;1,0;2,0;5,0;;2,0;29,0;;;;;;4,0;19,0;21,0;;1,0;;;8,0;69,0;;;;5,0;4,0;4,0;1,0;;;;;3,0;;;;;;;2,0;1,0;;;6,0;;1,0;;;1,0;;;;;;;;3,0;12,0;;1,0;2,0;;5,0;;1,0;1,0;;;4,0;2,0;4,0;1,0;12,0;;;;;;17,0;5,0;1,0;;36,0;7,0;;8,0;3,0;1,0;;;;1,0;;;2,0;5,0;;;;3,0;49,0;;6,0;;;;5,0;;9,0;8,0;;;;1,0;1,0;;20,0;;;6,0;;1,0;;;;;;;;8,0;2,0;;3,0;3,0;;1,0;4,0;2,0;1,0;3,0;;;;;;;2,0;;;;;1,0;;;;17,0;2,0;;1,0;;1,0;;;;1,0;3,0;;;;;1,0;;;;;;;;;;;;;2,0;;1,0;;;4,0;;;;1,0;1,0;;;;;;;2,0;;;;;;6,0;;3,0;;;;;;;1,0;;2,0;;;;1,0;;;;;;;;;;;;;;1,0;1,0;;;;1,0;;;3,0;;;;;;;4,0;1,0;1,0;;;;;3,0;;;;;;4,0;;;;;;;;1,0;;;;;;;;;;;;;;;;;3,0;1,0;;;;;3,0;;;;;;;;;;;;;;;;;2,0;;6,0;;;;;1,0;;17,0;;;1,0;;;1,0;;;;;8,0;;;;;;1,0;;;3,0;3,0;2,0;3,0;;;;;;;;;;1,0;2,0;;;;;;;;;;;3,0;2,0;;;;;;;;;;;;;12,0;;;2,0;;1,0;;;;;1,0;;;;1,0;;;;;;;;;;;;;;1,0;11,0;2,0;;;;;;;;;2,0;;;;2,0;;;;4,0;;2,0;;;;;;;;2,0;;;;;;;;;2,0;;;;;;;;;;;;2,0;;;;;;;;;;;;;;;;20,0;;;;;;;;;;;;;;;;1,0;;2,0;1,0;;;4,0;;;4,0;;;;;;1,0;;;8,0;;;;;;;;;;;;1,0;1,0;;;;;;;;;;;;;;2,0;;3,0;;;;;;;;;;;;3,0;;;;;;;16,0;;;;;;1,0;;;14,0;;;;;;;1,0;;;1,0;;;;;1,0;4,0;;;;;;4,0;;;2,0;;;;;;2,0;;;2,0;2,0;;;1,0;;;;;;;2,0;1,0;;1,0;34,0;;;;;;;;;6,0;3,0;;;;;;4,0;;;;1,0;;;;;;;;;;;3,0;;;;;;;;1,0;;;;;;;;;8,0;;;;;;;;1,0;1,0;;;;;;;;;;;;;4,0;;;;;;;;;;;;;;;;;4,0;;;;;;;;;;;1,0;;;;;;;2,0;;;1,0;;;;;1,0;;;;32,0;;;;;;;;;;;;;;;;;;;;;;;;;1,0;;;;;;;;;;;1,0;;;;;;;;;2,0;;;;;;;;1,0;;4,0;;;;3,0;;;;;;;;;;;;;;;;;;1,0;7,0;;;;;;;;;;;;;;3,0;1,0;;;;;;;;;;;;;;;;;;;;;;;;;;;;;;;;;;;;;;;;;;7,0;;;;;;;;;;;;;3,0;;;;;;;;;;;;;;;;;;;4,0;;;;;;;;;;;;;;;
composite;;;1,0;2,0;3,0;;2,0;28,0;4,0;12,0;10,0;1,0;;;7,0;1,0;;;2,0;4,0;44,0;1,0;2,0;2,0;;;2,0;21,0;;1,0;2,0;4,0;13,0;;24,0;1,0;3,0;2,0;;44,0;6,0;;;35,0;;;;111,0;3,0;;2,0;89,0;2,0;10,0;;274,0;16,0;;139,0;174,0;;1,0;27,0;;4,0;;;;5,0;;4,0;2,0;;;;;;1,0;5,0;7,0;;9,0;6,0;2,0;;;9,0;;4,0;21,0;1,0;;;66,0;6,0;;;1,0;;;;36,0;;;;;;21,0;3,0;;2,0;3,0;5,0;;;;;;10,0;1,0;;;;18,0;;;10,0;;;;;11,0;;;;7,0;;;;;;;;;;;23,0;22,0;;;;;;;;1,0;;2,0;;13,0;;;;;;3,0;1,0;2,0;;6,0;;;5,0;3,0;;;;18,0;;;;;;2,0;;2,0;1,0;22,0;;27,0;;;;;;;2,0;;;;;;;1,0;;;;;;;;;;;;11,0;;;;;;;;2,0;;;4,0;;;;;;;;1,0;;;;20,0;;5,0;;;;;;6,0;3,0;;;1,0;;;;;;;8,0;6,0;;;;4,0;;;;;;;1,0;;;;;;1,0;;;;;;;;;;;;16,0;;;;;1,0;1,0;;;;;;;;;9,0;;;;;;;;;;;;;;;;;;;5,0;;;;;;;2,0;;3,0;;;;;;;;;;;;;2,0;16,0;;1,0;;;8,0;;;10,0;;;;;;;;;;;;;;;1,0;;1,0;;;;;3,0;;7,0;1,0;30,0;;13,0;;;;;;8,0;9,0;;2,0;;1,0;;;1,0;;;22,0;;;1,0;;;;;;2,0;;;;;1,0;;15,0;;61,0;;;3,0;;1,0;;;5,0;5,0;;;;9,0;5,0;;;;;;;3,0;;;;;;;;;;1,0;4,0;;;1,0;;6,0;;;;;;;;;;;;1,0;2,0;;1,0;4,0;;;;;;;;15,0;;;;2,0;3,0;;;;;1,0;;;;;;;;87,0;23,0;;;6,0;;;;;;;;;;;;;;;2,0;;;;33,0;;;;;;;;;;;;;;;;;;9,0;;;;;;1,0;;;;;;;;;;;1,0;;;;1,0;;;3,0;11,0;;3,0;;;;;;;;;1,0;;;;;;1,0;;;;13,0;3,0;2,0;;3,0;;;1,0;;;;;;;;;;6,0;;;;5,0;;;;;;;;;;;;;;1,0;;;;;;;1,0;;;;;;;;;;;;;;;;;;;;;;;;11,0;;;;2,0;;;;;;;;;;;;;;;;;;;;;;;;;;;;;;;1,0;;7,0;;;;;;;;;3,0;;;;4,0;4,0;;;4,0;;;2,0;;;;;;;;;3,0;;;;;;;;;;7,0;;;2,0;;;;;;;2,0;;;;1,0;;;;;;;1,0;2,0;4,0;;47,0;;;;;;;1,0;2,0;2,0;;;;1,0;;;;1,0;;;;;;;;;;;;;;;;2,0;;;;;;;;;1,0;;22,0;1,0;;;;;;;;;;;;1,0;;2,0;;;;;;;;;;;1,0;;;;;;;;1,0;;;;;;1,0;;;;;;;;;;;;;;;;;;;;;;;;1,0;;;;;3,0;;;;;;;;;;;2,0;;;;2,0;;;;;;1,0;;;;;;7,0;;;;;;;9,0;;;;;7,0;;;;;;;;;;;;;;;2,0;;;;;7,0;7,0;;;;;;;;;;;1,0;;1,0;;;;;;;2,0;;;;;;;;;;;1,0;;;;;;;;;;;;;;3,0;;;;;;;;;;;;;;;;;;2,0;;;;;;;;1,0;3,0;;;;;;
composition;;;1,0;;9,0;;;5,0;;11,0;;;;;4,0;;;;;;;4,0;;;6,0;;;1,0;;1,0;1,0;12,0;10,0;1,0;8,0;;2,0;1,0;;10,0;;;;15,0;;;;;1,0;2,0;;13,0;;2,0;;78,0;8,0;;;5,0;;;9,0;;;;;;;;5,0;;;;;11,0;;;14,0;;;17,0;;;;;;;;7,0;;;4,0;17,0;2,0;;;;2,0;2,0;4,0;;;;;;;14,0;;;1,0;3,0;;3,0;;;;;;;;;;12,0;;;5,0;;2,0;2,0;;;;;;;;;;;;;;4,0;1,0;;5,0;;;;;;13,0;;;;;;;4,0;;1,0;;;;3,0;1,0;4,0;;1,0;;;;;;;;7,0;;;;;;;;;1,0;5,0;;3,0;;;6,0;;;1,0;;;;;;;;;;;;;6,0;;;;;;1,0;;3,0;;;;;;;;;;;;;;;;;;;;;6,0;9,0;;;;;;;;;;;;2,0;;;3,0;;1,0;;;16,0;;;;1,0;;;;;;;1,0;;;;;3,0;;;;;1,0;;;;;4,0;;;1,0;;1,0;;;1,0;13,0;;;;21,0;1,0;;;;18,0;;;;;;;3,0;6,0;;;;;;;;;2,0;;;;;;;1,0;;;;5,0;;;;;;;;1,0;1,0;;1,0;;1,0;2,0;;;5,0;;;;;;;;7,0;;;;;;;;2,0;;;6,0;;;;2,0;;1,0;;2,0;;;;;;;;;;;;3,0;21,0;;1,0;;;;;;;;1,0;;;;;;;;1,0;;;;;;9,0;;2,0;;;;;1,0;;3,0;;;;;;1,0;1,0;2,0;;;;;;;;;;1,0;;;1,0;;;;1,0;1,0;;;;;;;;;;;;;;;;;;;9,0;;;;;;1,0;;;;;1,0;;;;;;;;;;1,0;1,0;;;;;;;3,0;8,0;1,0;;;1,0;;;1,0;;;;1,0;;;;4,0;;;;;;;;;;;;;;;;;;;;;;;;;;;3,0;;;;;;1,0;;;;;;;4,0;;1,0;;;;;;;1,0;11,0;;;;;;1,0;;;;;;;;;;;;;;;;13,0;;;;;;;;;;;1,0;;;;;1,0;;;;;;;;;;;;;;;;;;;;;;;;;;;;;;;;;;;;;;;;;;;;;;;;;;;;;3,0;;;;;;;;;;;;;;;;;;;;;;;;;;1,0;;;;;;;;;;;;;;;;;;;;3,0;;;;;;;;;;;;;;;;;;1,0;;;;;6,0;;;;;;;;;;;;1,0;;;;;;;;;;;;;;;;;;;;;;;;;;;;;;;;;7,0;;;1,0;;;;;;;;2,0;;;;;1,0;;;;;;;;;;;;2,0;;6,0;;1,0;;;;;;;;;;;;;;;;;;;;3,0;;;;;;;;;;;4,0;;;4,0;;;;;;;;;;;;;;;;;;;2,0;;;;;;;;;;;;;1,0;;;;;;;2,0;;;;;;;;;;;;;;;;;;;;;;;;9,0;;;;;;;;;;;;;;;;;;;;;;;;;;;;;;;;;;;;;6,0;;;;;;;;;;;;;;;;;14,0;;;;10,0;;;;;;;;;;;;;;2,0;;;;;;;;;;;;;;;;;;;;;;;;;;;;;;;;;
compress;;;3,0;;12,0;;1,0;8,0;;13,0;;2,0;;;15,0;;1,0;;11,0;2,0;;8,0;;1,0;;;;288,0;1,0;9,0;1,0;8,0;27,0;1,0;85,0;;3,0;;;8,0;;;;5,0;;;;;4,0;2,0;3,0;32,0;;;;289,0;21,0;;4,0;6,0;;;44,0;;;;8,0;;2,0;9,0;3,0;1,0;2,0;;;3,0;;;4,0;;;21,0;11,0;6,0;2,0;;8,0;;1,0;23,0;19,0;;;106,0;28,0;2,0;;15,0;32,0;8,0;;11,0;;8,0;1,0;;;56,0;;;3,0;;;4,0;;;;;;2,0;;;;5,0;;;10,0;;;2,0;;1,0;;;;;7,0;;;;;;;1,0;;1,0;4,0;37,0;;;;;2,0;;;;;;;1,0;;4,0;;;;;2,0;;;7,0;1,0;;10,0;;;2,0;;40,0;3,0;;;1,0;;;;2,0;12,0;9,0;;6,0;;;;23,0;;;;;;;;;;;;;;;1,0;;;;;;;2,0;20,0;;;5,0;1,0;3,0;1,0;;;;;;4,0;;;;;;8,0;;;3,0;7,0;;1,0;;5,0;;;;;;;;;67,0;;;;;;2,0;;;;;1,0;4,0;;;;;2,0;;;;;;;4,0;1,0;;;;;;;1,0;;;1,0;15,0;;;;;;;;;;8,0;;;1,0;;1,0;;;;;;;;1,0;;;1,0;4,0;;;;;2,0;;;;;;;2,0;1,0;;;2,0;;;;;;;;;;;4,0;;;;6,0;1,0;;;;;1,0;;;1,0;1,0;5,0;;;;;4,0;;;;;1,0;;1,0;;;;;;3,0;23,0;;;;3,0;3,0;;;;;;4,0;1,0;2,0;34,0;1,0;4,0;;;2,0;;;13,0;;;;;;1,0;6,0;;;1,0;;;;3,0;;;2,0;;;;9,0;;;;;;1,0;;4,0;3,0;1,0;;4,0;;;;;;3,0;;3,0;;;;;2,0;;;4,0;16,0;3,0;;;4,0;;3,0;;7,0;;;2,0;;;;;;;;;;9,0;;;2,0;;;;;1,0;;;;;;;;;;;;;;;;;;133,0;3,0;;;;1,0;;;1,0;2,0;;2,0;;;2,0;2,0;;;;6,0;6,0;;;;;;;1,0;;;;;2,0;;;;;;;;14,0;;;1,0;;;;1,0;;;;;2,0;;;4,0;;2,0;;;1,0;;2,0;3,0;;32,0;;;;;;;;;;;;3,0;;;;;1,0;1,0;;;;20,0;11,0;;1,0;;;5,0;;;8,0;;;4,0;;;;;;;;;1,0;;;2,0;;12,0;;;;;;;;;5,0;;;;;;;;;;;;3,0;;;;;;;;;;;;;2,0;;;;;;;;;1,0;;;;;;;;;;;;;;;;;;;;;;;;;;;;;;;;;;;;;;;;;;;;1,0;;;;3,0;;;6,0;1,0;;;;;;5,0;11,0;;;;;;;;;;;;;;;;;1,0;2,0;;;;;;;;;1,0;;;;;;;;;1,0;;6,0;;;;;;4,0;;2,0;;;;;;;;;;;;;;;;;;;;3,0;3,0;;;;;1,0;;;;;;;;;;;;;;;;;;;;;;;;;;;3,0;;;;;;;;;;;;;;1,0;;;;2,0;1,0;;;;;;;;;;;3,0;;;;;8,0;;;;;;;;;1,0;;;;;;3,0;;;;;;;;;;1,0;;;1,0;;;;2,0;;;;;;;;;;;;1,0;1,0;;;1,0;;;;;;;4,0;;12,0;;;;;;;;;1,0;;;;1,0;;;;;;;2,0;5,0;;;2,0;2,0;;;;;;;;;;;;;;;;;1,0;;6,0;;;2,0;;;;;;;;;;;;;;;;;;;;;;;;9,0;;;;;;;;;;;;;;;;;;;;;;;;;;;;
compression;;;61,0;1,0;22,0;;;77,0;2,0;9,0;;1,0;;5,0;2,0;6,0;;;11,0;9,0;191,0;61,0;;;;4,0;;160,0;;11,0;3,0;2,0;62,0;;48,0;4,0;;1,0;;16,0;1,0;;;3,0;2,0;;1,0;;1,0;2,0;4,0;19,0;;3,0;;631,0;29,0;4,0;7,0;8,0;;;79,0;;;;9,0;;3,0;3,0;;6,0;6,0;;;;;4,0;2,0;;1,0;411,0;9,0;14,0;;;32,0;;;57,0;9,0;;9,0;18,0;8,0;2,0;;51,0;50,0;;1,0;14,0;;3,0;1,0;;6,0;207,0;;;2,0;1,0;1,0;;1,0;6,0;;;;2,0;;;;44,0;;;6,0;;;2,0;1,0;1,0;;;1,0;4,0;1,0;;;;;1,0;1,0;;1,0;4,0;5,0;120,0;;;;;2,0;2,0;;;1,0;1,0;;7,0;;;;;;;2,0;;;1,0;10,0;;23,0;6,0;;1,0;;13,0;;;;1,0;1,0;;;;19,0;16,0;;18,0;;;;2,0;2,0;;;1,0;3,0;3,0;;1,0;;8,0;;;5,0;;;5,0;;8,0;;;;11,0;;7,0;;1,0;1,0;;;;;;;;4,0;1,0;1,0;;;;;;;18,0;12,0;;2,0;;37,0;;;;;;;15,0;;;;14,0;;;;1,0;;;6,0;;;;2,0;;1,0;;;;;;;1,0;;4,0;1,0;;3,0;2,0;;;1,0;;5,0;10,0;2,0;15,0;3,0;;;;;;1,0;;;10,0;;;;;72,0;;;;;23,0;;;16,0;6,0;;4,0;9,0;;;;7,0;;;;1,0;;;;;38,0;;;3,0;3,0;;;;;;;;;;6,0;;;;3,0;1,0;1,0;;6,0;;1,0;;;;;;;;;;42,0;;;;;;;1,0;;;;;;1,0;14,0;;;;5,0;4,0;;;2,0;;2,0;93,0;11,0;;13,0;;;;;;;3,0;45,0;;;;;1,0;1,0;11,0;;;;;;;2,0;;2,0;;;;;2,0;;;;;;6,0;;1,0;6,0;13,0;;1,0;;;;2,0;;;;3,0;;;5,0;1,0;10,0;;1,0;18,0;7,0;5,0;;3,0;9,0;;;;6,0;;;7,0;;;;;2,0;;3,0;;1,0;58,0;;;214,0;;;;;;;;;;;;;;;;4,0;1,0;18,0;;;;;36,0;4,0;;;;3,0;;;8,0;;1,0;11,0;;9,0;2,0;;;;6,0;60,0;;;;;;;2,0;;;;;;1,0;3,0;;;;;;;1,0;;;;;;;;;;;;;;;;;2,0;;;3,0;;;;;28,0;18,0;;;;1,0;;;;;;;;;;;;;;;;;;14,0;;;;1,0;2,0;;10,0;3,0;;;2,0;;;;;1,0;;;;1,0;;;;;2,0;;;;;;;;;4,0;;;6,0;;;;;;1,0;;;7,0;1,0;;;3,0;;;;4,0;;;;;1,0;;;;;;;;;;;3,0;;;;;;;;;;;;;;;;;;;;;3,0;;;;;;;;;;;;;;4,0;;3,0;;;;;53,0;;;;1,0;;;;;;;;;;1,0;24,0;;2,0;;1,0;;;;;;;;;;;;;;1,0;;;;;;9,0;10,0;1,0;;;3,0;;;;;;;1,0;11,0;5,0;14,0;;;;;;;5,0;;1,0;;3,0;;29,0;;;;1,0;;;2,0;;5,0;;;;;3,0;1,0;;;;;1,0;;;;;2,0;;;;;;;;;;7,0;;3,0;;;;;;;;;;4,0;13,0;;;;1,0;;;;;;;;;;;;;2,0;;;;;;;;;;;;;1,0;;;;;;;;;;;;;;;;;;;10,0;;;;;;;;;;;;;;;;;;;;;;;;;;;;;;;;;;;;;;67,0;;;;2,0;;;;;;;;;;;;;;;;;;;;;3,0;;;;3,0;;;1,0;;;1,0;;;4,0;;;;;;;;23,0;;;;;;;;;;;;;;;;;;;;;;;;;;;;;3,0;;;;;;1,0;;;;1,0;;;;;;;;;;;;;;;;;;
compute;;;55,0;1,0;23,0;;5,0;106,0;12,0;48,0;13,0;6,0;;13,0;31,0;4,0;;;24,0;21,0;2,0;35,0;16,0;22,0;23,0;6,0;10,0;66,0;33,0;15,0;1,0;30,0;349,0;49,0;47,0;5,0;7,0;38,0;25,0;29,0;47,0;;6,0;5,0;7,0;13,0;2,0;3,0;36,0;;8,0;39,0;;6,0;3,0;178,0;38,0;;2,0;15,0;5,0;;95,0;3,0;6,0;;27,0;;1,0;13,0;26,0;8,0;5,0;;;;;36,0;44,0;9,0;;11,0;36,0;7,0;;;15,0;;14,0;9,0;21,0;13,0;2,0;21,0;;8,0;;10,0;26,0;;9,0;81,0;;4,0;2,0;;2,0;81,0;;;1,0;;10,0;3,0;;6,0;;;;2,0;;;;1,0;;1,0;50,0;;5,0;25,0;1,0;;;;;5,0;1,0;;;;2,0;;;8,0;7,0;;5,0;54,0;;;10,0;;1,0;;;;;34,0;5,0;20,0;;1,0;;;1,0;;13,0;9,0;;;1,0;2,0;37,0;1,0;3,0;;;10,0;;;;;;;;28,0;;41,0;;26,0;;;2,0;12,0;;;;;8,0;;;;;6,0;;;;2,0;4,0;;;10,0;;;14,0;43,0;4,0;;1,0;;;7,0;;;;;1,0;;1,0;;;;;10,0;15,0;38,0;;3,0;9,0;7,0;;1,0;13,0;2,0;2,0;8,0;;;;;;;;10,0;;;;6,0;;;4,0;2,0;24,0;;;;;;;;;;;;;5,0;2,0;;9,0;13,0;;;17,0;7,0;;46,0;1,0;44,0;2,0;2,0;;;2,0;7,0;;;;7,0;11,0;;35,0;;9,0;2,0;2,0;;;28,0;;;27,0;3,0;;;;;;;;;;;;;;5,0;;;1,0;2,0;19,0;2,0;;5,0;;3,0;;;8,0;4,0;;10,0;;10,0;33,0;;2,0;2,0;;27,0;2,0;6,0;;2,0;;;;1,0;;;3,0;1,0;;1,0;6,0;6,0;2,0;1,0;54,0;10,0;4,0;;1,0;31,0;9,0;31,0;4,0;2,0;;9,0;8,0;;1,0;7,0;;17,0;2,0;1,0;7,0;2,0;;14,0;;;;6,0;;5,0;5,0;3,0;17,0;;5,0;1,0;25,0;9,0;6,0;13,0;3,0;;3,0;;;4,0;1,0;17,0;4,0;1,0;18,0;;33,0;1,0;;4,0;;2,0;;2,0;3,0;24,0;7,0;1,0;;;;;2,0;3,0;4,0;2,0;;10,0;;5,0;;6,0;;;2,0;;1,0;13,0;10,0;7,0;;;;;17,0;;;4,0;1,0;11,0;3,0;7,0;;;37,0;;;32,0;;1,0;;;1,0;;2,0;1,0;1,0;;2,0;3,0;;;9,0;2,0;;3,0;;;1,0;;29,0;29,0;;;1,0;;;;6,0;;;;;;1,0;;;;;33,0;9,0;1,0;;;;;;;;;;1,0;2,0;;;;;;;3,0;3,0;23,0;;;9,0;2,0;;4,0;;;1,0;;2,0;13,0;;;3,0;;;4,0;9,0;;4,0;;;38,0;51,0;;1,0;;;5,0;16,0;;;;1,0;5,0;;;;;;7,0;;;;7,0;2,0;1,0;5,0;;;;;;4,0;;;2,0;16,0;;1,0;;;;;;;;;1,0;;2,0;;;;;;;;;22,0;;;8,0;1,0;;;2,0;1,0;1,0;1,0;;;;;;;4,0;;;;;;;;1,0;;;;2,0;;22,0;;;4,0;;4,0;;;;;2,0;4,0;;3,0;;;2,0;;4,0;6,0;;;;;;1,0;;12,0;3,0;;12,0;;11,0;;;23,0;10,0;20,0;;;1,0;3,0;4,0;;;;;17,0;;;8,0;;36,0;6,0;;;1,0;5,0;4,0;;;;36,0;;2,0;5,0;15,0;2,0;;;;5,0;;;;;;;2,0;;;;4,0;2,0;2,0;4,0;;6,0;8,0;;11,0;2,0;;8,0;;;4,0;3,0;;6,0;2,0;3,0;17,0;;3,0;6,0;;2,0;7,0;16,0;;;;1,0;2,0;2,0;;4,0;;;;3,0;1,0;;;;;1,0;2,0;;;2,0;8,0;;1,0;62,0;2,0;5,0;7,0;;;;;;1,0;1,0;;2,0;18,0;6,0;;;;;;;;3,0;;;5,0;29,0;;44,0;;;31,0;;;;;1,0;;;;40,0;4,0;6,0;;2,0;;;3,0;1,0;1,0;14,0;;;;;2,0;4,0;;;1,0;1,0;2,0;;;;;;;;;3,0;1,0;3,0;3,0;;;;;5,0;;;;;1,0;;;;;;;;;;1,0;1,0;;4,0;;;;;;;;;;1,0;4,0;;;3,0;;10,0;;;;;;;;;;;;;;;;;;;;2,0;;1,0;;;;5,0;4,0;;3,0;1,0;1,0;1,0;;;;;;;1,0;;5,0;;;;;;1,0;;15,0;;4,0;;2,0;;2,0;;;;;;1,0;;;;1,0;;;;;;;;2,0;;;;;;;;;;8,0;;;;;;3,0;;;;;;;1,0;;;;;;;;;
conductive;;;5,0;;2,0;;;11,0;;;;;;;;;;;1,0;3,0;;2,0;;;;;;;;9,0;;;26,0;2,0;4,0;;;10,0;;3,0;2,0;;;29,0;;;10,0;;;;6,0;6,0;;4,0;;25,0;40,0;;;19,0;;;15,0;;;;;;;;2,0;1,0;5,0;1,0;3,0;;;7,0;16,0;4,0;4,0;6,0;7,0;;;;21,0;;;1,0;28,0;;;9,0;;2,0;;;1,0;64,0;43,0;;;4,0;;;38,0;7,0;2,0;;5,0;7,0;1,0;2,0;9,0;;;;20,0;8,0;15,0;;;16,0;2,0;;4,0;35,0;;3,0;5,0;;;;;2,0;14,0;;19,0;;;;2,0;8,0;4,0;1,0;93,0;4,0;;1,0;;5,0;;32,0;;9,0;9,0;31,0;;18,0;2,0;;11,0;1,0;;135,0;;6,0;;84,0;39,0;;67,0;12,0;5,0;3,0;20,0;;11,0;;;2,0;;;;4,0;8,0;28,0;;56,0;;;;24,0;;;;16,0;;2,0;2,0;1,0;;37,0;;;;;8,0;12,0;;3,0;7,0;2,0;4,0;;3,0;2,0;;;2,0;;;;4,0;;;;;9,0;;;;1,0;;;;4,0;11,0;;6,0;;4,0;18,0;1,0;1,0;4,0;18,0;;5,0;;;;62,0;;;;9,0;;;1,0;;;11,0;;5,0;14,0;1,0;;10,0;1,0;8,0;12,0;2,0;6,0;;;;3,0;1,0;;;;3,0;;;;;5,0;1,0;;;;10,0;;2,0;;;;;3,0;;1,0;2,0;3,0;;2,0;;;8,0;;10,0;;;3,0;;;;;5,0;;6,0;;;;10,0;;;12,0;;;;;;;3,0;;;;;;;;;;;;;;;2,0;;;;;;;;;;;;;;1,0;;;;;;;2,0;;;;;;;;3,0;;1,0;;;;;;;;;;;;;;;;;3,0;;;;;;;;;;;;;4,0;6,0;;;;;;2,0;;1,0;;;;;1,0;;;;;;;;;;;;;;;;;;;;;3,0;;;;;;;;;;;;;;;;;;;;1,0;;;;;1,0;;;;;8,0;;;;;;;;;;;;;;;5,0;1,0;;;;;1,0;;;;;;;;1,0;;2,0;;;3,0;;;;;6,0;4,0;;;;2,0;;;;;;;;;;;;9,0;;;;;;;;;3,0;;;;;;;;;;;5,0;;;9,0;;;1,0;;8,0;2,0;;;;;;;;;;;;;2,0;;1,0;;5,0;;;;;;;54,0;;;;;;25,0;;;3,0;5,0;;;3,0;;;;;;;;;;;;;30,0;;;;;;;;;1,0;1,0;;1,0;;;;;1,0;;;9,0;;;;3,0;;;;5,0;4,0;;;;;;;;;;;13,0;;;;;3,0;;;;;;;;;1,0;;29,0;6,0;;;;;5,0;12,0;;1,0;;;;;;;;;1,0;;;;1,0;;4,0;;;;;;5,0;;;;;;;;;;;;;;;;;;;5,0;;;2,0;1,0;;;;;;;;;;;;;3,0;;;2,0;;;;;;;;;;;;;;;;;;;;;;;;;;;;;3,0;;;;;;;;;;;;;;;;;;;;;;;;;;;;;;;;4,0;;;;;;;;;;;;;4,0;;;;1,0;;;;;;;;;;;;;;4,0;;1,0;;;;;;;;;;;;5,0;;;;3,0;;;;;;;;;;;;1,0;;;;;10,0;;;;9,0;;;3,0;;;;;4,0;;6,0;;;;;;;;;;1,0;;;;;;;;;;;;;;;;;;;;;;;;;;;;;;;;;;;;;;1,0;;;;;;;;;;;;;;;;;;;;;;1,0;;;7,0;;;;;;;29,0;1,0;;;;;;;;;;;;;;;;;;;;;;;;;;;;;;;;;;;;;;;;;
conductivity;;;1,0;;1,0;;;;;;;;;;;;;;;;;;;;1,0;;;;;;;;21,0;;;;;;;;;;;18,0;;;;;;;;;;;;3,0;28,0;;;7,0;;;1,0;;;;;;;;;;5,0;;;;;2,0;1,0;;;;;;;2,0;197,0;;;;7,0;;;15,0;;;;;3,0;28,0;10,0;;;11,0;;;324,0;3,0;;;1,0;5,0;;1,0;;;4,0;;;;;;2,0;5,0;;;;5,0;;;2,0;;;;;;25,0;;6,0;1,0;;;;;;;33,0;;;;;;;11,0;;;;;;4,0;;;;;;42,0;4,0;4,0;;37,0;2,0;4,0;1,0;;;;;9,0;;;;6,0;;;;1,0;2,0;4,0;;21,0;;;;2,0;;;;;;;165,0;1,0;;7,0;;;;;;;;;14,0;1,0;;;;;;2,0;1,0;;;;;;;;;;;;;;;;;2,0;;;2,0;;;1,0;;;;;;;;;;14,0;;;;;;;;1,0;;;;;;;;;;;;;;;;;;;;;;1,0;;;;;;43,0;;;;;;;7,0;;;;;;2,0;;;;;;;;;;;;;;;;;;;;;;;8,0;;;;;;;;;;5,0;;;;;;;;;;;;;;;;;;;;;;;;;;;;;;;;;;;;;;;;;;;;;;1,0;;;;;;;;;;;;;;;;;;;;;;;;;;;;;;4,0;7,0;;;;;;22,0;;;;;;;;;;;;;;;;;;;;;;;;;;;;3,0;;;;;;;;;;;;;;;;;;;;;;;;;;;;;;;;;;;;;;;;;;;;;;;2,0;;;;3,0;;;;;;;2,0;;;;1,0;;;;;;;2,0;;;;;;;;;;;;;;;;;;;;;;;;;;;;;;;;;;;;;;1,0;;;;;;;3,0;6,0;;;;;;;;;;;;;;;;;;;;;;;;;;;;;;;;;;14,0;;;;;;;;;;;;;;;;;;;;;;;;;5,0;;;2,0;;;;;;;;;;;;;;;;;;;;;2,0;;;;;;;6,0;;;;;;;;;;;;;;;;;;;;;;;;;;;3,0;;12,0;13,0;;;;2,0;;;;18,0;;2,0;;;;17,0;24,0;;;;;;1,0;;;;2,0;;;;;;;;;;71,0;;;;4,0;;;;;;;;;;;;;;;;;;;;;;;;;;;;;;;;;;;;;;;;;;;;;2,0;;;;;;;;;;;;;;;;;;;;;;;;;;;;;;;;;;;;;3,0;;;;;;;;;;;;;;;;;;;;2,0;;;;;;;;;;;;;;;;;2,0;;;6,0;;;;5,0;;;;;;;;;;;;;;;;;;;;;;;;;;;;;;;;;;;;;;;8,0;;1,0;;;;;;;;;;;;;;;;;;;;;;;;;;;;;;;;;;;;;;2,0;;;;;;;;;;;;;;;;;;;;;;;;;;;2,0;;;;;30,0;;;;;;;;;;3,0;;;;;;;;;;2,0;;;;;;;;;;;;;;;;;;;;;;
constant;;;1,0;;7,0;;14,0;9,0;;;;3,0;;3,0;5,0;;;;;;;16,0;3,0;;;;;6,0;;;1,0;12,0;67,0;9,0;3,0;;;12,0;;4,0;13,0;;7,0;6,0;1,0;;;1,0;6,0;14,0;3,0;;2,0;1,0;;13,0;6,0;;3,0;13,0;;;20,0;;;4,0;;;;6,0;25,0;2,0;24,0;;;;;1,0;9,0;8,0;1,0;11,0;;1,0;;;;5,0;;4,0;10,0;1,0;;26,0;4,0;1,0;;;1,0;;10,0;10,0;;;;;;12,0;1,0;;3,0;3,0;2,0;;1,0;;;;;;1,0;;2,0;23,0;;;4,0;;;3,0;1,0;;1,0;;1,0;2,0;9,0;;;1,0;;;;;9,0;;4,0;6,0;;;;;;;;;;;4,0;19,0;;1,0;;;;;10,0;9,0;8,0;;;5,0;1,0;;1,0;1,0;2,0;29,0;;;;;;;;;;7,0;;2,0;;;;4,0;;2,0;11,0;;8,0;;4,0;5,0;;;;;;;1,0;;;;2,0;2,0;;7,0;;;3,0;;1,0;;1,0;;;;3,0;;;;;;2,0;;5,0;5,0;;2,0;;;;;4,0;;;;;1,0;3,0;4,0;10,0;;;17,0;;;;6,0;2,0;5,0;;2,0;;;;;;;;;1,0;1,0;;;;;;;;;;;;1,0;;4,0;5,0;6,0;6,0;1,0;6,0;;4,0;;;;2,0;;;;;;4,0;4,0;;;;7,0;;;8,0;1,0;;;;;;;;;;;;;;17,0;;4,0;17,0;1,0;;5,0;1,0;1,0;;;;;;8,0;;1,0;;12,0;;2,0;;;;4,0;7,0;3,0;2,0;;;;;;;;4,0;;;1,0;;1,0;;;33,0;;16,0;;1,0;1,0;;;;;;5,0;3,0;3,0;;1,0;5,0;;7,0;5,0;;1,0;;;2,0;1,0;1,0;22,0;8,0;1,0;;;;;;;10,0;12,0;2,0;2,0;;;;;;;;;;;6,0;5,0;3,0;1,0;;;2,0;;;;;;;;;;;;;;;;1,0;;;;;1,0;1,0;;;1,0;;;2,0;;;;5,0;;;;;;;2,0;;;3,0;;1,0;;;;1,0;;;;;;1,0;;;;;;;5,0;1,0;1,0;;6,0;;4,0;1,0;;1,0;7,0;;15,0;;;;;;;2,0;;;;;;;;;;1,0;4,0;;1,0;;;;;1,0;;;;;;;;;;;;;;;;;;;1,0;;;;;;;;;;;;;;;;;1,0;;3,0;17,0;;;;;;;;;;;;;;;;;;;;;;;;;;;3,0;1,0;;;;2,0;;1,0;;;;;4,0;;3,0;;;;;1,0;;;;;;;;;;;;;2,0;;;;;;;;;;;;;;;;13,0;;;;;;;;6,0;;;;;;;;;;;;;;1,0;;;;;10,0;2,0;;2,0;;;;;;;;1,0;;1,0;6,0;;;1,0;;2,0;1,0;3,0;4,0;;;;;;4,0;;;1,0;;4,0;;;4,0;1,0;1,0;3,0;;;;;;8,0;2,0;1,0;2,0;;;;;5,0;;;3,0;;;;;;1,0;;;;;;3,0;1,0;;;4,0;;9,0;;;3,0;2,0;;;;;2,0;;1,0;1,0;;;;2,0;;1,0;3,0;12,0;2,0;1,0;;;1,0;2,0;4,0;;;1,0;;1,0;;;;;;;;12,0;;;;;;;;;;2,0;20,0;;;1,0;;;;;1,0;;;;;;;;;;;;;;;;;2,0;;;;;3,0;;;;;;1,0;;;;2,0;;;;1,0;;;;;;;25,0;;;;;1,0;;;2,0;;;;;3,0;;4,0;;1,0;;;1,0;;;;;;;;;;;;;;;;;2,0;;;3,0;;;;;;;;;;;;;;1,0;;;;;;1,0;;;;;;;;;;;;;;;;;;;;;;5,0;;1,0;1,0;;;;;;;;;;;;1,0;;1,0;;;8,0;;;;2,0;;;;;;;1,0;;;;;;;;;;;;;;;;;;;;2,0;;;;2,0;;;;;;;;;;;;;;;;;;;2,0;;;;
content;;;1,0;;9,0;;;33,0;;23,0;;;;;18,0;;;;;8,0;;24,0;;1,0;;;;65,0;;2,0;;11,0;19,0;;16,0;;;1,0;2,0;50,0;;;;2,0;;;;;3,0;;6,0;13,0;;2,0;;242,0;27,0;1,0;;1,0;;;38,0;;;;6,0;;1,0;3,0;11,0;9,0;;;;;;;5,0;1,0;1,0;6,0;2,0;;;;17,0;;18,0;46,0;;3,0;6,0;2,0;;;;2,0;7,0;;1,0;8,0;;;;;6,0;29,0;;;4,0;;1,0;;;;;;;;;;3,0;1,0;;;10,0;2,0;;;;;;;;1,0;;;;;;1,0;;2,0;;;8,0;17,0;;;;;;;;;;;;1,0;;;;;;6,0;;3,0;;4,0;;;1,0;;2,0;;;3,0;;;;;;;;;;33,0;;28,0;;;;6,0;;;;;;;;;;;;2,0;;;;;;;;;;2,0;4,0;;;;;2,0;;;;;18,0;;;;;;;;3,0;;;;44,0;;;;;;;3,0;1,0;;;;;;;10,0;;;;2,0;1,0;;;;;;;;;;;;;;;;1,0;;4,0;;1,0;;;;;1,0;;9,0;6,0;6,0;;8,0;;;;;;;;4,0;;;1,0;;17,0;;;;;1,0;;;;4,0;;;;;;;;6,0;;;;1,0;;9,0;;;1,0;;5,0;2,0;;;;;;;1,0;;;4,0;;3,0;;3,0;;;;9,0;;8,0;;1,0;;;;;;;;;;;;9,0;;;;;;;;;;4,0;1,0;;;;;;;3,0;;;1,0;;;68,0;;2,0;;;;2,0;3,0;3,0;;3,0;;;;;;;;;;;;10,0;;;;;;;8,0;;17,0;;8,0;1,0;11,0;1,0;8,0;1,0;;2,0;3,0;1,0;;;;;;;37,0;;;;;;;1,0;;;;2,0;;3,0;21,0;;;;;1,0;8,0;1,0;;12,0;;1,0;;;;;3,0;;;;;1,0;;;;;1,0;;1,0;;4,0;;;;3,0;2,0;;5,0;;2,0;;;120,0;5,0;;;;;4,0;1,0;1,0;14,0;;;;;;;20,0;;4,0;7,0;1,0;;;;;;;;6,0;1,0;1,0;;;;;;;;;1,0;2,0;;;;;;;;;;;;;;1,0;;;3,0;;;5,0;;;3,0;;9,0;;;;;;;;2,0;;2,0;;;2,0;2,0;8,0;;;;;;;24,0;1,0;;;;;;;9,0;;;;;4,0;;;;1,0;;;;5,0;;;;;;;;;1,0;;;;;;;;;;;12,0;;3,0;;;;;;;;;;;;;;;;;;;2,0;;;5,0;;;;1,0;;;;;;;;1,0;1,0;;;;;;;;;;;;;;;;;1,0;3,0;;;;;;;;;;;;;;;;;;;;;;;;;;;;;;2,0;;2,0;;;10,0;1,0;2,0;;;;1,0;;;;;;;2,0;1,0;;;;;;2,0;;;1,0;;;3,0;;;;;;6,0;;;;;;;;9,0;;;;;;;;;;;;2,0;;;;;;1,0;;;;;;;;1,0;;;;;;;;3,0;2,0;;;;;;1,0;1,0;;;;;;;;;;;2,0;;;;;8,0;;;7,0;;;;;;;;;2,0;;;;;;1,0;2,0;;2,0;;;;;;;;3,0;;1,0;;;;;;;;;;;;;;;9,0;;;;;;;;;7,0;;;;;;;;;;;;;;;;;;;;;;;;;;;1,0;;33,0;;;2,0;;;20,0;;;;;;;3,0;;2,0;1,0;;1,0;;;1,0;;;;;4,0;;;;;;;1,0;;;2,0;;;;;;;;;;;;;;;;2,0;;;;;;;;;;;;;;;;;;;;;;;;;;;;;;;;;;1,0;;;;;;;1,0;;;6,0;;;;;;;;;
continuous;;;5,0;;4,0;;4,0;10,0;1,0;32,0;;;;;10,0;2,0;;;9,0;5,0;3,0;30,0;;;2,0;;3,0;16,0;3,0;2,0;1,0;14,0;10,0;;3,0;;;5,0;;13,0;;;;8,0;;;;5,0;3,0;5,0;34,0;8,0;;;;117,0;32,0;5,0;1,0;12,0;;;17,0;;;1,0;8,0;;;24,0;9,0;8,0;;;;;1,0;17,0;6,0;5,0;;19,0;3,0;;;;1,0;;;2,0;3,0;6,0;137,0;5,0;;;;;1,0;;25,0;12,0;;4,0;;;1,0;51,0;2,0;;1,0;4,0;1,0;1,0;;;;;;3,0;;;1,0;11,0;;;6,0;1,0;;;;2,0;2,0;1,0;2,0;1,0;8,0;;1,0;6,0;;;;12,0;;1,0;11,0;57,0;1,0;1,0;;2,0;;;;2,0;;;7,0;8,0;;;;;;;;50,0;;;1,0;;11,0;2,0;13,0;4,0;5,0;6,0;;;;6,0;;;;4,0;;7,0;1,0;5,0;;;;8,0;;;;;3,0;;1,0;4,0;;1,0;;;8,0;;;1,0;;;;;;36,0;3,0;4,0;;;1,0;;;;2,0;;2,0;;;;;1,0;;1,0;;;2,0;1,0;6,0;1,0;2,0;;;;;;;;1,0;;;9,0;3,0;4,0;;;1,0;;;;;12,0;1,0;;;;7,0;;;3,0;;;;;;;;;;;;;3,0;2,0;;;1,0;8,0;1,0;;;;;7,0;;;;24,0;;;4,0;;4,0;3,0;;;;1,0;;2,0;1,0;;;;;;;;;;;;;;;9,0;;;;;4,0;5,0;;;;;1,0;3,0;;;;;;4,0;;2,0;;;;3,0;;1,0;;;;;;1,0;;;;;;;10,0;1,0;;;3,0;1,0;;;;1,0;2,0;;4,0;;;;11,0;1,0;;;1,0;;;4,0;1,0;4,0;4,0;2,0;;1,0;;1,0;16,0;16,0;1,0;;;;;;;1,0;;2,0;;1,0;;1,0;;;;2,0;2,0;;1,0;;6,0;;;;58,0;;;;9,0;;1,0;;;;;;;;;1,0;2,0;;;2,0;1,0;4,0;3,0;;5,0;;;13,0;5,0;4,0;;3,0;3,0;;8,0;;1,0;;2,0;;;1,0;;1,0;3,0;1,0;;23,0;;;;;;;;;;;;;1,0;;;;;13,0;;10,0;5,0;;19,0;11,0;;;;;;;2,0;;1,0;;;;;;4,0;;;;2,0;;;;;3,0;;;;;;21,0;6,0;;;;;;;;4,0;;;;;;;;;;;;;2,0;;;;;;;3,0;;;;2,0;11,0;8,0;;;;;;2,0;;;;;;;;;;;;;;;9,0;8,0;;;;;;;;;;;;;;;;;;;;;;;;;;;2,0;;;;;;;;;;;2,0;;;;;;1,0;;;;;1,0;;1,0;;;;;;;;;;1,0;;;;;;;;;;;;;;;;;;;;;;;2,0;;;1,0;1,0;;;;1,0;;1,0;;;;;;3,0;;16,0;;;4,0;;;1,0;;1,0;;11,0;;;;1,0;;6,0;;;;;;;1,0;;;;;1,0;2,0;1,0;;;;;;;;;;;;1,0;;1,0;;5,0;1,0;;;;;;;;;;;;21,0;;;;3,0;;;;;;;;;;;;1,0;2,0;;;1,0;;;;;;1,0;1,0;1,0;;;3,0;;;3,0;;;;;;2,0;;;1,0;2,0;1,0;;7,0;1,0;;;;;;;1,0;;;;;;;;;1,0;5,0;;;4,0;;1,0;;;;;;;;;;;2,0;;;;4,0;;;5,0;;;;;;;;;;;3,0;;;;;1,0;;;2,0;;;;;;2,0;;;;;;;;;;;;;;;;1,0;;;;;;;1,0;;;;;;;;;;;;;;;2,0;;;;;;;;;;;;;;1,0;;;;;;;;;;;;;;;;;;;1,0;;;;;;;;;;;;;;;1,0;;;;;2,0;;;;;;;;;;;4,0;;;;;;;;;;;;;;;;;;;;;;;;;;;;;;;;;;;;;;;;;
continuously;;;6,0;;7,0;;2,0;4,0;5,0;77,0;2,0;;;;1,0;;3,0;;;2,0;6,0;23,0;;;;;;10,0;1,0;;3,0;4,0;26,0;;9,0;;1,0;9,0;;40,0;;;5,0;;;;;;2,0;1,0;;10,0;;;;216,0;4,0;4,0;1,0;25,0;;33,0;49,0;;;3,0;6,0;;;36,0;9,0;8,0;;;;1,0;;3,0;13,0;1,0;;14,0;4,0;;;;17,0;;;8,0;9,0;4,0;10,0;17,0;;;;;2,0;2,0;5,0;11,0;;;;3,0;;26,0;2,0;;2,0;;;2,0;;3,0;7,0;;;1,0;;;2,0;;1,0;;3,0;2,0;2,0;;;;;;;1,0;8,0;;;9,0;;;6,0;1,0;;1,0;41,0;21,0;;;;;;;1,0;;3,0;;;24,0;;1,0;3,0;;;1,0;8,0;10,0;;;3,0;8,0;;;4,0;;;12,0;;;;;2,0;3,0;1,0;;4,0;15,0;;10,0;2,0;;;12,0;;1,0;;;6,0;;18,0;;;3,0;;1,0;;;;2,0;;1,0;;;1,0;19,0;1,0;1,0;;;;1,0;;;1,0;2,0;;;;;;;1,0;;5,0;2,0;;1,0;4,0;2,0;1,0;1,0;;;;2,0;;8,0;;;;4,0;;1,0;2,0;;;;;2,0;;7,0;;;1,0;;8,0;;2,0;;;;1,0;2,0;;;;;;;;;;;;17,0;3,0;37,0;9,0;;;;;4,0;;;;56,0;;;1,0;;18,0;;;;;7,0;;;;;4,0;;;;;;;;;5,0;;1,0;;1,0;;1,0;2,0;;2,0;;;;;1,0;;;;;;;;;;;2,0;;;8,0;1,0;;1,0;;;2,0;;;;;;;2,0;;;;;1,0;;1,0;;;;2,0;3,0;4,0;1,0;;;1,0;3,0;1,0;;;;1,0;;;;2,0;3,0;1,0;;;5,0;1,0;1,0;2,0;3,0;;3,0;;2,0;;;;;12,0;;;1,0;;;;;1,0;;;2,0;;1,0;;;6,0;4,0;;;5,0;;7,0;1,0;;;;;;2,0;;;;11,0;;;;;1,0;;;;;;4,0;2,0;;;6,0;;1,0;3,0;;;;4,0;;;4,0;;1,0;2,0;;;29,0;;;;;;1,0;;;;;5,0;;;2,0;;1,0;;2,0;;7,0;;1,0;3,0;4,0;2,0;6,0;;;;;;;;;;;;;;;;;3,0;;;;3,0;;;;;;;;;;;;;;3,0;6,0;2,0;;;;;;;;;;;;;;;2,0;;;;1,0;2,0;;1,0;1,0;;;2,0;8,0;;;;;;;;;;;1,0;;;;;1,0;;;;;21,0;2,0;;5,0;;;;11,0;3,0;;;;3,0;3,0;;1,0;;;;;2,0;;;;;;;1,0;;;;;;;;;;;;;;;;;;;;;;;;4,0;;;4,0;;;;;;;1,0;;;;;1,0;;;2,0;;;;;;;;;2,0;;;;;;;;;;1,0;;;;;;1,0;;;;;;;2,0;1,0;;;;;;;;2,0;;;;;;;;1,0;;1,0;;;;;;;3,0;;1,0;5,0;1,0;;;;1,0;;;;;;;;;1,0;;;;;2,0;3,0;4,0;1,0;;;;1,0;;3,0;;;6,0;;;;;1,0;;;1,0;;;;;;33,0;;;;;;;;;;;;;;;1,0;;;2,0;;4,0;;;;;;;;;1,0;1,0;;;;;;;;2,0;;;;2,0;;;;;;;;;;;;;;;;;;;;;;;;;;1,0;;;;;;;;;;;;;;;;1,0;;;;;;;;1,0;3,0;;;;;;1,0;;;;;;;;;;;;;;;;3,0;;;;;;;;;;;;;;;;;;;;1,0;;;;;;;2,0;;;;;;;;;1,0;;;;;;;;1,0;;;;;;;;;2,0;;;;;;;;;1,0;;2,0;;;;;;;;;;1,0;;;;;;;;;;;;;;;;;;;;;;;1,0;;;;;;;;;;;;;;;;;;;;;;;;;;;;;;
contrast;;;2,0;;7,0;;;65,0;22,0;32,0;;;;;30,0;;;;6,0;4,0;1,0;22,0;;6,0;6,0;;;79,0;;101,0;83,0;34,0;17,0;23,0;3,0;;1,0;4,0;;13,0;4,0;;1,0;;;7,0;;6,0;64,0;1,0;2,0;6,0;;8,0;;206,0;11,0;;1,0;44,0;;;57,0;8,0;;;1,0;;;12,0;16,0;;;;;;;4,0;75,0;;;6,0;1,0;;;;10,0;;3,0;9,0;16,0;;5,0;29,0;;8,0;;2,0;;;4,0;28,0;;;1,0;;3,0;26,0;;1,0;2,0;;12,0;2,0;;5,0;;3,0;;7,0;;;3,0;2,0;;;28,0;;;;;;;;;18,0;1,0;;;2,0;4,0;;;;5,0;;3,0;9,0;5,0;;;;;;;;;;1,0;9,0;;8,0;;2,0;;;3,0;12,0;;1,0;;1,0;;1,0;;;;3,0;;;;;;;;;;21,0;1,0;15,0;;;;1,0;;;;;;;;;1,0;7,0;;;1,0;;1,0;;1,0;;;;;2,0;;;;;;1,0;2,0;1,0;;;;;;;;;;;20,0;4,0;;10,0;11,0;5,0;;;2,0;;;;1,0;;;;;;;;1,0;;;7,0;1,0;;4,0;5,0;10,0;;;;;;;;;4,0;;;2,0;;;;1,0;;;;;2,0;;;7,0;39,0;6,0;;;;1,0;12,0;;;;11,0;;;;;19,0;5,0;;;;11,0;;;6,0;10,0;;;;;;;;;;;;;;1,0;;;;;1,0;;;;;;;6,0;;;;4,0;;25,0;2,0;;1,0;;;4,0;;;5,0;;;3,0;;;;;;;;;1,0;3,0;;;;;1,0;;;21,0;3,0;;1,0;9,0;;;;2,0;9,0;1,0;;;2,0;9,0;3,0;;;;;;4,0;1,0;1,0;24,0;1,0;;;;;;;;;2,0;;;3,0;;;1,0;;;1,0;;;;1,0;;;;6,0;;2,0;;;10,0;;;;;;2,0;;;;;;;;;;10,0;;;;4,0;;5,0;2,0;;;;;;;;1,0;;;14,0;;;1,0;1,0;22,0;;;10,0;;;;;;;1,0;1,0;;;;;1,0;;1,0;;;18,0;;1,0;4,0;;9,0;2,0;;;;;;;;;1,0;;;;;;;;;;;;;;;3,0;;;30,0;;;;;;9,0;;;;;;;;;;;;;2,0;;;;;;1,0;;4,0;1,0;;;;;;;;;;9,0;;;;;;5,0;;;;;;;;;;;;;;;;12,0;1,0;;;;;3,0;;;;;;1,0;;;;;;;;2,0;;;;19,0;;;;;;;;;;;;;;;;;;;;;;;;;;;12,0;;;1,0;;1,0;;;1,0;;;;;;;;;1,0;2,0;;;;;;;3,0;;;;;;;1,0;;;;;;;;;;2,0;;35,0;;;;;2,0;33,0;3,0;;;2,0;;;;;4,0;;2,0;;;;1,0;;1,0;;;1,0;;;;;;6,0;;;;2,0;;;;2,0;4,0;;;;;;;;;;;;4,0;;5,0;;;;1,0;;1,0;;4,0;;;5,0;;2,0;;;;;;;;;;1,0;2,0;1,0;3,0;1,0;11,0;9,0;2,0;;4,0;;;;;;1,0;1,0;;;;;9,0;;4,0;1,0;1,0;;;6,0;;;;;;;;;;;;;;;;;;;;;;;;;4,0;;;;;1,0;;;;;2,0;;;;1,0;;;;;;1,0;;;;6,0;;;;3,0;;;;;;1,0;;;;;;;;;;3,0;;6,0;;;2,0;;1,0;;;;;;;;;;;;;;;;;;1,0;2,0;;;;;;;;;;;;;;;;;2,0;;;;;;;;;;;;;;;;2,0;;1,0;;;;;;;;;;;;12,0;;9,0;;;;2,0;;;1,0;;;;;;;;3,0;;;9,0;;;;;;;;;;;;;;;;;;;;;;;;12,0;;;;;;;;;1,0;;;;;;;;;;;;;;2,0;;;;1,0;;;
convert;;;5,0;4,0;22,0;;13,0;20,0;5,0;32,0;;7,0;2,0;13,0;78,0;;3,0;;9,0;2,0;;42,0;6,0;1,0;3,0;;3,0;345,0;4,0;16,0;22,0;4,0;219,0;;165,0;4,0;2,0;29,0;;45,0;18,0;;4,0;44,0;;27,0;3,0;3,0;10,0;4,0;5,0;39,0;11,0;4,0;3,0;1112,0;80,0;7,0;2,0;65,0;5,0;33,0;65,0;;3,0;1,0;21,0;1,0;1,0;16,0;287,0;6,0;15,0;5,0;2,0;49,0;;9,0;50,0;36,0;;43,0;37,0;11,0;2,0;;8,0;;6,0;6,0;177,0;;19,0;560,0;7,0;30,0;;5,0;54,0;20,0;50,0;49,0;;25,0;;;3,0;297,0;;;7,0;22,0;6,0;2,0;;3,0;;6,0;1,0;8,0;;;3,0;62,0;;9,0;142,0;3,0;;8,0;4,0;3,0;1,0;;;7,0;;;;4,0;5,0;;23,0;13,0;25,0;22,0;113,0;23,0;6,0;3,0;8,0;;3,0;24,0;2,0;;2,0;9,0;;167,0;68,0;4,0;;;;4,0;9,0;190,0;;6,0;43,0;;19,0;2,0;23,0;2,0;;103,0;;;;;9,0;21,0;;10,0;1,0;67,0;;87,0;;;18,0;52,0;2,0;7,0;4,0;;10,0;;4,0;5,0;1,0;12,0;;4,0;1,0;;1,0;2,0;5,0;1,0;2,0;;3,0;12,0;27,0;1,0;5,0;;3,0;;;9,0;1,0;1,0;;;;;;;;8,0;5,0;2,0;;7,0;14,0;;8,0;;5,0;;4,0;1,0;1,0;4,0;;;12,0;7,0;;12,0;;2,0;3,0;;1,0;;2,0;17,0;6,0;;;;2,0;;;;;7,0;;5,0;7,0;3,0;14,0;;16,0;;;;1,0;20,0;;5,0;;157,0;1,0;;1,0;;2,0;4,0;;;78,0;9,0;;;3,0;;19,0;6,0;2,0;;;1,0;;;13,0;13,0;4,0;;;;;3,0;;1,0;;21,0;;2,0;;13,0;3,0;1,0;12,0;;10,0;;1,0;;;9,0;;;;2,0;;4,0;;6,0;;5,0;;6,0;;3,0;;3,0;;;;2,0;;;;;5,0;;;2,0;5,0;12,0;1,0;;;3,0;;;;1,0;3,0;24,0;2,0;1,0;;5,0;4,0;43,0;;3,0;3,0;15,0;2,0;;1,0;15,0;;;8,0;;4,0;2,0;2,0;7,0;1,0;;9,0;;;;;;;26,0;4,0;;;1,0;;1,0;;5,0;;;34,0;10,0;17,0;2,0;1,0;5,0;17,0;1,0;;15,0;14,0;7,0;4,0;3,0;;;2,0;;105,0;;1,0;;;;23,0;16,0;1,0;7,0;136,0;;1,0;;;1,0;7,0;6,0;;67,0;;;5,0;;;1,0;1,0;;5,0;2,0;;;6,0;;;28,0;1,0;;1,0;;4,0;;;5,0;2,0;8,0;;;2,0;5,0;3,0;;;5,0;4,0;7,0;24,0;;73,0;13,0;2,0;35,0;2,0;3,0;;2,0;1,0;1,0;;1,0;;;;;;;;15,0;5,0;12,0;1,0;;2,0;;;;1,0;;;9,0;2,0;;1,0;4,0;;;;;4,0;2,0;;;;;;;;;;;;;1,0;;;;1,0;;12,0;;24,0;;;35,0;103,0;;;;;;3,0;;;1,0;;1,0;1,0;;;;1,0;2,0;;;;9,0;81,0;1,0;2,0;1,0;;2,0;6,0;;;;;;2,0;74,0;;;1,0;;5,0;;7,0;;4,0;;2,0;11,0;1,0;;;1,0;;;;;2,0;;;3,0;2,0;;3,0;1,0;;;;;4,0;;;;;;;;22,0;;;;;1,0;;;;3,0;;;1,0;;2,0;5,0;;;;;1,0;;2,0;;4,0;3,0;1,0;;4,0;2,0;1,0;;;1,0;;3,0;;;3,0;;;;1,0;;5,0;9,0;1,0;13,0;1,0;1,0;;;4,0;9,0;;88,0;;;1,0;9,0;2,0;2,0;1,0;;1,0;6,0;;;1,0;;4,0;;;18,0;6,0;4,0;;12,0;;;;1,0;;2,0;1,0;;;7,0;;1,0;;9,0;;1,0;;1,0;3,0;;;2,0;10,0;;1,0;3,0;3,0;;;3,0;1,0;;;10,0;;;;;;;;5,0;3,0;2,0;1,0;;;1,0;1,0;;1,0;;;76,0;;1,0;;;3,0;5,0;;1,0;19,0;;;;;3,0;;;;;;2,0;;;;;;11,0;3,0;1,0;;;1,0;1,0;;;;;7,0;3,0;;8,0;;;;;;7,0;;;;12,0;;;;1,0;1,0;;;;;;;;1,0;1,0;3,0;2,0;;;;;3,0;;4,0;;;4,0;1,0;5,0;;4,0;;;;;1,0;1,0;;;;;;;3,0;1,0;;1,0;;;;;4,0;1,0;;;;;;;;1,0;;;;;;2,0;;;;;;;;;;;4,0;;16,0;;;4,0;1,0;;;;;;;;;10,0;1,0;1,0;;1,0;;8,0;;;;1,0;2,0;7,0;;;3,0;;;;;;1,0;;;;;;8,0;;;;;;2,0;9,0;12,0;;6,0;;;;;1,0;;;;;;;;;;;;;;;;;;;;;;1,0;;;;;;;;;;;;4,0;;;;1,0;;;;;;;;;;1,0
corner;;;5,0;;5,0;;3,0;24,0;2,0;4,0;12,0;1,0;;;;3,0;;;3,0;6,0;;;1,0;10,0;;;4,0;;3,0;11,0;;32,0;13,0;;12,0;;;2,0;;6,0;8,0;;;;;;;;;;;3,0;;6,0;;63,0;5,0;;;7,0;;1,0;16,0;;;2,0;;1,0;;;10,0;;;1,0;;1,0;;8,0;27,0;;;3,0;6,0;;;;26,0;;6,0;;1,0;;;1,0;;4,0;;;;3,0;15,0;2,0;;;;;;3,0;;;;7,0;;2,0;;;;;3,0;1,0;;;;2,0;;;4,0;4,0;;2,0;4,0;3,0;;;;;6,0;;;;;;;;1,0;;23,0;12,0;;1,0;;5,0;2,0;;1,0;4,0;5,0;10,0;;6,0;;;1,0;8,0;;3,0;;;;;13,0;;12,0;6,0;4,0;25,0;;;;;;;;;;;3,0;1,0;;27,0;;3,0;;2,0;29,0;;;;;1,0;1,0;26,0;;8,0;;;1,0;;;3,0;3,0;;;;;2,0;;;;;8,0;5,0;;;2,0;;;;;;;;;27,0;;;8,0;;8,0;2,0;;;47,0;4,0;;;;;1,0;4,0;8,0;;;5,0;2,0;;5,0;18,0;;;;;5,0;;;1,0;11,0;;1,0;;;2,0;;;;;;;;13,0;;2,0;;;;;;4,0;;5,0;;;;5,0;;;;;2,0;;;;17,0;;2,0;;;7,0;4,0;;;5,0;;;;1,0;2,0;;;;5,0;;2,0;;;;;;;;;;;;;;;;;3,0;;4,0;;;;;2,0;;1,0;;2,0;;1,0;;;;;;;;;;;;12,0;;;;;;1,0;;;1,0;;2,0;;;;1,0;;;1,0;2,0;;;;1,0;;;;;;;;;;10,0;3,0;;1,0;;1,0;;;;;1,0;;;;;;;;;22,0;;2,0;;4,0;;;1,0;3,0;;;;;1,0;;;;;;;;3,0;;;;;;;;;;;;;;;1,0;;1,0;;;;2,0;;;;;;;10,0;1,0;;;;;3,0;;;;;;;;;;;;;;;3,0;;;;;;;;;1,0;;;;;;;;2,0;;1,0;;1,0;;;;;;4,0;;1,0;;;;;1,0;;;;;;;;;;;2,0;;;;;;;;;;;;;;;1,0;;;;1,0;;;;;1,0;;;;6,0;6,0;;;;;;;;;;;;;;7,0;3,0;5,0;;1,0;;;;;;;1,0;;;;;;;;;;1,0;1,0;;1,0;1,0;;;;;;;;;;;;;;;;;;;;;;;;;;;;;;;;3,0;;;;;;;1,0;;;;;;;;;;;;2,0;;;;;1,0;4,0;;;;;;;;;1,0;;;;;;;;;;;;;;;;;;1,0;1,0;;;;;;;;;;;;;;;;;;;;;;;;;;;4,0;;;;;;;;1,0;;2,0;;;;;;;;;4,0;;7,0;;;;;;;;;;;;;;;;;;;;;;;1,0;;;1,0;;;;;;;;;;;;;;;;;;;;;;;;;;;;;;;;;;;;3,0;;;;;;;;;;;;;;;;;;;;3,0;;;;;;;2,0;1,0;;;;;;;;2,0;;;;;;2,0;;;;;;5,0;;;;;;;;;;1,0;;;;;;;;2,0;;;;;;9,0;;;;;;;;;;;;2,0;;;;;;;;;;;;;;;;;;;;;;;;;2,0;;;;;;;1,0;;1,0;;;;;;;;;1,0;;;;;;;;;;;;;;1,0;;;;;;;;;;;;2,0;;;;;1,0;;;;;;;2,0;;;;;;;;;;;;;;;;;;;3,0;;;;;2,0;;;2,0;;;;;;;;;2,0;;2,0;;
correlate;;;8,0;;2,0;;;2,0;;7,0;;2,0;;3,0;20,0;5,0;;;;2,0;;12,0;4,0;4,0;2,0;7,0;4,0;52,0;;10,0;;16,0;6,0;1,0;8,0;2,0;;;;3,0;;;;1,0;;;;;4,0;1,0;1,0;5,0;;2,0;;144,0;21,0;;1,0;5,0;;2,0;21,0;;;;2,0;;;4,0;4,0;;2,0;;;5,0;;1,0;12,0;;;;2,0;1,0;;;3,0;;4,0;16,0;4,0;2,0;7,0;43,0;6,0;2,0;;9,0;14,0;;;14,0;;1,0;;;;32,0;;;;;1,0;;;2,0;;;;;;;;1,0;;;9,0;;;;3,0;;;;;;;;;1,0;;;2,0;2,0;2,0;;11,0;42,0;1,0;;;;;;;;;;;14,0;;;;;;;9,0;4,0;;;;4,0;;;1,0;;;6,0;;;;;;;;;;17,0;;;;;7,0;2,0;;;;;;;;;;6,0;;1,0;;;;;;;3,0;;;13,0;;;;;;;;;;5,0;;;;;;;;1,0;;;;;10,0;5,0;;;2,0;;;;;;;;;;;;;;;3,0;;;1,0;;4,0;;;;;;;;;;;;;1,0;;;;;;;;;;6,0;1,0;27,0;5,0;;;;3,0;2,0;;;;;;;;;;;;;;3,0;;;23,0;8,0;;;1,0;;;;;;;1,0;;;;1,0;;;;;2,0;1,0;;;;;;;;;;16,0;;;10,0;;;2,0;;5,0;2,0;1,0;1,0;;;;;;;;;;;;2,0;6,0;;1,0;;1,0;;;6,0;2,0;2,0;4,0;;12,0;;;1,0;;1,0;;1,0;;;4,0;;10,0;;;;;;;;3,0;4,0;3,0;;;;;2,0;10,0;;1,0;;;1,0;;;7,0;;1,0;43,0;;11,0;;10,0;;;3,0;3,0;;1,0;;1,0;5,0;;9,0;;1,0;;;14,0;;;;;1,0;;;;1,0;;1,0;2,0;;;11,0;2,0;;;;1,0;;;;;;;;;;;;3,0;;;19,0;;;;2,0;3,0;;;1,0;3,0;3,0;2,0;;;;;;;;;4,0;14,0;;11,0;3,0;;2,0;;;;13,0;;;;2,0;;;1,0;;;;;6,0;;;;;2,0;2,0;;;8,0;1,0;1,0;;;;;;;;;;14,0;;;;;1,0;;;;;;;;;;;1,0;;;;;;1,0;;;;13,0;;;;;;2,0;;;;;;2,0;;;;;1,0;;;;4,0;9,0;;;;;3,0;;;;;;;;;;;2,0;;;;;;;;;;;;;3,0;;;;;;;;;;;;;;;;;;;;;;;;;2,0;;;;;;;;;;;;;;2,0;2,0;;;;;;;;;;;;;;;;;;;;;;;;;;;;2,0;;;8,0;;1,0;11,0;;;;;;;;;;;;;1,0;;;3,0;;;;;;;;6,0;;;;;1,0;;;;;2,0;;;;;;;;;;;;14,0;5,0;;;;;;;;3,0;;;9,0;;;1,0;67,0;;;;;;8,0;3,0;;2,0;16,0;;;;;;;;1,0;;;1,0;;;;;;;;1,0;;1,0;1,0;;;3,0;3,0;;;6,0;;;;;;;;;;;;;;;2,0;;;;;;;8,0;;;;;;;;;;1,0;;;2,0;;;;;;;;;;;;;;;;;;;;;1,0;;;2,0;;;;;;;;;;;;;;;;;;;;1,0;;;;;;;;;;;;;;;;;;;;;;;;;;;;;;;;1,0;;;;;;;;;;1,0;;;3,0;;;;;;;2,0;;;;;1,0;;;;;1,0;;1,0;;;;;;;;;;;;;;;;;;;;;;;;;;;;;;;;;;;;;;;;2,0;;;;;;;;;;3,0;;;;;;;;;;;2,0;;;;;;;;;
count;;;4,0;;5,0;;;15,0;;;;;;;4,0;;1,0;;3,0;2,0;1,0;10,0;;;3,0;1,0;;14,0;;8,0;1,0;19,0;7,0;9,0;17,0;;;12,0;;6,0;3,0;;1,0;1,0;;;;;1,0;15,0;18,0;43,0;;;;50,0;10,0;1,0;1,0;6,0;;;28,0;;;1,0;;;;31,0;;2,0;;;;2,0;;7,0;10,0;;2,0;4,0;7,0;;;;;;2,0;10,0;10,0;;;97,0;;;;4,0;28,0;;;2,0;;1,0;;3,0;;48,0;;;1,0;3,0;;;;;;;;;;;4,0;4,0;;;19,0;;;;;2,0;;;;16,0;;;;;;;8,0;;3,0;;;7,0;;;;;;;28,0;;;;8,0;1,0;;3,0;;;;;6,0;1,0;;;;;;;10,0;;;35,0;;;;;;;;;;19,0;;9,0;;;;4,0;;;;;;;;;;;;;6,0;;;;;2,0;;;;86,0;1,0;;;;3,0;;;;;;;;;;;;;;8,0;2,0;;;2,0;;;;;;;;;;;;4,0;;;;1,0;;;;;;8,0;2,0;16,0;;;;;;;;;;;27,0;;;;;8,0;;;;;;;4,0;;;;1,0;;;;;;;;8,0;;;;;25,0;;;;;1,0;;;2,0;8,0;;;1,0;;;;;;;;;;;;;;;;2,0;;;;;4,0;;;;;;2,0;;8,0;;3,0;;;;4,0;;4,0;3,0;;;3,0;;;;;;;;;7,0;12,0;2,0;;;;;;2,0;2,0;;3,0;6,0;;;;23,0;1,0;;;18,0;;;;;;;21,0;;;;;3,0;;5,0;;;;;;2,0;;;;;9,0;;;;;;;3,0;;7,0;;3,0;2,0;;;82,0;1,0;;;;2,0;2,0;;;;;;3,0;;;;;;;;;7,0;3,0;4,0;;;;;;;;2,0;;;;;;;;2,0;;;;;5,0;;;34,0;;;;;5,0;;;;9,0;;;;;;;;1,0;20,0;;43,0;1,0;;;4,0;;;;;;;;16,0;;;;;;;;;;;;;;;;;;;;;;;;;;;;;1,0;;;;;;;;;;;;;;;;;;2,0;;;;;;6,0;;;;20,0;;;;;;;;;;;1,0;;;;;;;;;;;2,0;1,0;;;;;;3,0;1,0;;;;;;;;;;;;18,0;;;;;;;;;;;;;;1,0;;;7,0;12,0;;;;;;;;;;;;;2,0;;;;;;;;;;;;;;;;;3,0;;;;;;;;;;;;;;;;;;;;;;;;14,0;;;3,0;;;;;8,0;;;;;;;;;;9,0;;;;;18,0;;;;;;;;;;1,0;;;;;1,0;1,0;;;;2,0;;;;;;;;;;;;;;44,0;5,0;;16,0;;;;1,0;;4,0;;;;;;2,0;;;1,0;;;;;;;;;;;2,0;;;2,0;26,0;;;1,0;1,0;7,0;10,0;;;;;1,0;;12,0;;;;;;;;;1,0;;;;5,0;;;;;;;;;;;3,0;;;;;;;;;;;;;;;;;;;151,0;;2,0;;;;;;;2,0;;;;;;;;4,0;;2,0;;;;;;;;;;;;;;;3,0;;;;;3,0;;;;;;;;;;;;;;;;;;;;;;;;;;;;;;;;;;35,0;;;;;;;;;;;;;;;;;;;;;;;;;;;;;;;;;;;;;;;;;;;;;;;;;;;;;;;;;;;;;;;;;;;;;;;;;;;;17,0;;;;;;;;;;;;;;;;;;;;;;;;;;;;;;
counter;;;1,0;;6,0;;1,0;16,0;;;4,0;;;;1,0;;;;1,0;;;36,0;;;;1,0;;11,0;;3,0;1,0;5,0;18,0;;5,0;;;6,0;;1,0;;;;1,0;;;;;1,0;14,0;7,0;16,0;;;;38,0;23,0;;1,0;;;;14,0;;;8,0;3,0;;;25,0;;1,0;;;;;;2,0;11,0;;;1,0;1,0;;;;;;;1,0;21,0;;;60,0;;;;4,0;16,0;;;4,0;;;;1,0;;23,0;1,0;;;8,0;3,0;1,0;;1,0;;;;;;;3,0;33,0;;;18,0;;;;;;;;;;5,0;;;;;;1,0;;;1,0;2,0;;;;;;;;10,0;;;2,0;;6,0;;2,0;;;;;4,0;1,0;2,0;;;;;2,0;4,0;;4,0;53,0;;;;1,0;;;2,0;;5,0;40,0;;1,0;;;;1,0;;;;;3,0;;;;;;;;6,0;;;;;;;;1,0;28,0;7,0;;;3,0;;1,0;;;;;;;;;;;;1,0;;3,0;;3,0;6,0;;;;;;;;;;;;6,0;;;4,0;;;;;;2,0;6,0;4,0;2,0;;;;3,0;;;;;;;4,0;;1,0;;;2,0;;;;;2,0;;;1,0;;8,0;;;;;;;;;;;;;;4,0;1,0;;;;2,0;;;12,0;15,0;1,0;;2,0;;;;;;;;;;;;;;;;;;;;;;;;2,0;;;10,0;;;;;;;;5,0;;;;;;5,0;;;;;;;;;;2,0;2,0;;1,0;;;;;5,0;;;2,0;;;;32,0;8,0;;;1,0;;;;;;;13,0;;1,0;;;1,0;2,0;1,0;;;;;;;;;;;4,0;;;8,0;2,0;;;;;18,0;;;2,0;;;10,0;1,0;;;;;1,0;;;;;;1,0;;;;;;;;;9,0;12,0;;;;;;;;;;;;2,0;;4,0;;;;;;;1,0;;;;10,0;1,0;;;;2,0;;;;18,0;;;;;;1,0;;2,0;2,0;;18,0;;;4,0;;;3,0;;;;;;17,0;;;;;;;;;;1,0;;;;;;;;;;;;;;;;;;;;;;;;;;;;;;;;;2,0;;;;;1,0;;;;;8,0;;;;16,0;;;;;;;;;;;;;;;;;;;;;;;2,0;;;;;;3,0;1,0;;;;1,0;;;;;;;;;;;;;;;;;;;;;;1,0;;;;8,0;;;;;;;;8,0;;;;;1,0;;;;;;;;;;;;;;;2,0;;;;;;;;;4,0;;;1,0;;;;;;;;;;;;;;11,0;;;15,0;;5,0;3,0;;;;;;;;151,0;;;1,0;;;;;;13,0;1,0;;;;;;;;;1,0;;;;;;;;;;;;;;;;;;2,0;;;;1,0;;42,0;;;;;;;;;;;;2,0;;;;;;1,0;;;;;;;;2,0;;;;;;;21,0;;;8,0;1,0;;17,0;;;;;2,0;;;;;;;;;;;;;;;2,0;;;;;;;;;;;;;;;;;;;;;;;;;;;;;;;;1,0;;;;;;;;;3,0;;8,0;;;;5,0;;;;;;;;;;;;;;;;;;;;;4,0;;;;;;;;;;5,0;;;;;;;;;;;;;;;;;;;;;;;;;44,0;;;;;;;;;;;;;;;;;;;;;;;;;;;;;;;;1,0;;;;;;;;;;;;;;;;;;;;;;;;;;;;;;;;;;;;;;;;;;;;;;;;;;;;;;;;;;;;;;;;;;;;;;;;;;
criterion;;;2,0;1,0;;;;25,0;1,0;5,0;;;;;;;;;;;2,0;3,0;;1,0;2,0;;;5,0;;6,0;8,0;16,0;1,0;3,0;2,0;;;2,0;;13,0;;1,0;;2,0;;11,0;;;2,0;;;;;8,0;;56,0;11,0;;;1,0;;;20,0;;;;;;;;;;;;;;;;3,0;;;6,0;3,0;2,0;;;;;1,0;11,0;;;;6,0;;;;1,0;15,0;;3,0;3,0;;;;4,0;;16,0;;;1,0;;1,0;;;;;;;;;;;;;;1,0;;;;;;;;;;;;;;;;;2,0;;;;3,0;;;;;;;;;;;;;1,0;;;;;;2,0;;;;;;1,0;;1,0;1,0;;;;;;;;;;;;4,0;;6,0;;;;3,0;;;;;;;;;;;;;;;;;2,0;;;;;5,0;;;;;;3,0;;;;;;;;;;;;;;;;;1,0;;;;;;;;;;;;;;;;;;;1,0;;;;;1,0;;;;;;;;;;1,0;;;;;;;;;;;;;19,0;;3,0;;;;;;;;;;;;;2,0;;42,0;;;;;;;;;;;;;;;;;;;8,0;;;;;;;;;10,0;;;1,0;1,0;;;;3,0;;;;;;;;;;;;;;;;;;;;;;1,0;;;;;;;;;;;;;;;;;;;;;;;4,0;1,0;;;;;;;;;;;;;;7,0;;;;;;;;;;;;;;;;;8,0;;;;;;3,0;;;4,0;;8,0;;;1,0;;;;1,0;;;;;;;;;;;;;;;;;;1,0;1,0;3,0;;;;;;;;;;1,0;;1,0;;;;;;2,0;;;;;;;;1,0;3,0;;;;;;;1,0;;5,0;;;1,0;;;;;;;3,0;;;;;;;;;2,0;;;;;5,0;;;;;;;;;;;;;;;;2,0;;;;;;;;;1,0;;;;2,0;;;;;;;;10,0;;;3,0;;;1,0;;;;1,0;;;;;;3,0;;;;;;;;;;;;;;;1,0;7,0;;;;;2,0;;;;;;;;;;;7,0;;;;3,0;;;4,0;;;;;;;;;;;;;;;;;;;;;;;;;;;;4,0;;1,0;;;;;;1,0;;;;;;;;;5,0;;;;;;;;;;;;;;;;;;;;;;;;;;;;;2,0;;;;;;;;;;;;;;2,0;;;;;;;;;;;;;;;;5,0;;;;;6,0;;;;;;;;;;;;;;;;;;;;1,0;;1,0;;;;;;;2,0;;;;2,0;36,0;2,0;;;;;2,0;;;;;;;;;;;;;;;;1,0;;;;;;;;;;;;;2,0;;;;3,0;;;;;;;;;;;;;;;;;;;;;;;;;;9,0;;;;;;;;;;;;;;;;;;;;;;;;;;;;;;;;;;;;;;;5,0;;;;;;;;;;;;;;;;;;;;1,0;;;;;;;;;;;;;;;;;;;;;;;;1,0;;;;;;;;;;;;1,0;;;;;;;;;;;;;;;;;;;;;;;;;;;4,0;;;;;;;;;;;;;;;;;;;;;;;;;;;;;;;;;;;;;;;;;;;;;;1,0;;;;;;;;;;;;;;;;;;
crystal;;;6,0;;13,0;;2,0;8,0;;1,0;;;;;17,0;;;;4,0;;;27,0;;;;;;3,0;4,0;7,0;1,0;2,0;55,0;1,0;4,0;3,0;;36,0;;197,0;1,0;;;43,0;;;;;;;4,0;5,0;;4,0;;35,0;48,0;;;17,0;;;8,0;2,0;;;6,0;;;1,0;23,0;;;;;;;2,0;3,0;7,0;;5,0;;1,0;;;6,0;;;13,0;5,0;2,0;;9,0;;;;;;28,0;7,0;11,0;;;;;1,0;4,0;;13,0;;7,0;6,0;1,0;;;;;;2,0;;;2,0;5,0;;;7,0;;;4,0;;;;;3,0;14,0;25,0;;14,0;3,0;1,0;;;13,0;23,0;;10,0;;9,0;16,0;;1,0;3,0;1,0;2,0;;6,0;1,0;;12,0;5,0;2,0;;1,0;;67,0;2,0;17,0;;29,0;2,0;1,0;28,0;7,0;;2,0;1,0;1,0;;;88,0;1,0;2,0;;;;56,0;31,0;;7,0;;;1,0;;;2,0;15,0;;14,0;;3,0;2,0;;2,0;;3,0;;;1,0;;;;7,0;4,0;;3,0;3,0;9,0;;2,0;2,0;;;3,0;;4,0;;;;;;;;3,0;3,0;14,0;;4,0;28,0;;;;;;;;;;;1,0;;;;6,0;1,0;2,0;;3,0;1,0;;;5,0;;;;;;;;;2,0;1,0;;;;;;;;1,0;;;;;;;;3,0;7,0;;;;;;;2,0;;4,0;2,0;;4,0;;5,0;;;;;;2,0;;1,0;;;;;;;;;7,0;;;;;;6,0;;;14,0;;11,0;3,0;;;;;3,0;;;13,0;;;;;;;;2,0;;3,0;1,0;;;1,0;;;;;;;;;;;;1,0;;;;;;;;;;;;;;;;;;1,0;7,0;9,0;1,0;1,0;;1,0;;3,0;;1,0;29,0;;;;1,0;;;;1,0;;;;;;;;30,0;3,0;;;;;2,0;;;;;;1,0;;1,0;;;;;;;;;;;1,0;;2,0;;;;;;;;5,0;;1,0;;6,0;;;1,0;;;1,0;;;;;;;;;;34,0;1,0;;;;;3,0;;;;;;;;;;;;;;;;;;1,0;;14,0;8,0;2,0;5,0;1,0;1,0;4,0;1,0;;;;;1,0;12,0;;;;;;;;;;1,0;;;;;;;;3,0;;;;;;;;;;1,0;;;;;;;;;;;;2,0;;;;;;;;1,0;;;;2,0;;;;17,0;1,0;;;;;;;;;;;;;;;;;;;;;1,0;;;4,0;;;;1,0;7,0;;;;;;1,0;;1,0;;;;2,0;1,0;;;;;;;;;;;;;;;;;;;;;;;1,0;;;;;2,0;3,0;;3,0;;4,0;;;;;;;;;;1,0;;;;;7,0;;;;;;;;6,0;14,0;;;;;;;;;;;;;6,0;;;;;;;;;;4,0;;;;;;;;15,0;;;;;;;;1,0;;;;;;;;;;1,0;;;8,0;3,0;;;1,0;;;;506,0;;;;;;;;;;;;;2,0;;;;;;;;;;3,0;;;;1,0;;;;;;;;;;;1,0;;;;;;;1,0;;1,0;;2,0;;2,0;6,0;;;;;;;;1,0;;;;;5,0;;;;;;;;1,0;;;;;;;;;;;;;;;;;1,0;;;1,0;;;1,0;;;;;;;;;1,0;;;8,0;;4,0;;;;;;;;1,0;;;;;;;;;;;;;;;;;;;;;;;;1,0;4,0;;;1,0;;;;3,0;;;;3,0;;5,0;;;1,0;4,0;;;;;5,0;;;;;;;;;;;;;1,0;;;;;;;;;;;;4,0;;;;;;;;;;;;;;;2,0;;;;;2,0;;;;;;;;;;;;;;;;;;1,0;;;;;;;;;;;;;;;;;;;;;;;;;;;;;;;;;;;;5,0;;;;;;;;;;;;;;;
curvature;;;1,0;;;;39,0;3,0;;;;;15,0;;4,0;;3,0;;9,0;1,0;22,0;;;;;;12,0;;3,0;;;2,0;6,0;;1,0;;;;;1,0;7,0;2,0;;78,0;1,0;;;3,0;1,0;;2,0;;;20,0;3,0;103,0;4,0;;2,0;184,0;;;1,0;;;;1,0;;;;23,0;;1,0;4,0;;;;2,0;1,0;;1,0;;;;;;3,0;5,0;4,0;1,0;1,0;2,0;1,0;;;;;;;;392,0;18,0;;;;;;14,0;;;;;;;;;;2,0;;;;;2,0;;;;7,0;3,0;;;4,0;;;;3,0;;;2,0;;;;;1,0;33,0;3,0;1,0;5,0;;;;4,0;1,0;13,0;;;1,0;;8,0;;5,0;;3,0;;;;6,0;;;;;4,0;10,0;1,0;;;3,0;4,0;;;;;1,0;1,0;;6,0;3,0;4,0;;;10,0;;;;;;10,0;;;2,0;;;29,0;;178,0;;1,0;;;;;;;;;;;;2,0;;;1,0;;;;;;;;;;20,0;;;;;4,0;;2,0;4,0;;1,0;3,0;;5,0;;9,0;;;;;;;;;;;;3,0;;53,0;;2,0;;1,0;;;6,0;;;;;;;;;;;;;2,0;;;;;;;;86,0;;;;;;1,0;;;;;;;;;8,0;;;;11,0;19,0;4,0;2,0;2,0;1,0;;;;;;;;;;;;;1,0;;;;;;;;18,0;;;;;;;;;;;;;;;;;4,0;1,0;;;6,0;;2,0;;;;;;;;;8,0;;;;;;;;;;;;;;6,0;1,0;;3,0;;;;;;;;;;2,0;;;;;;;;;36,0;;;;;;;4,0;;;;;22,0;;;;;;;;1,0;;;;;;;;;;;;;;;;;;;;;;;;;;;;2,0;;;1,0;1,0;;;;;;1,0;;;;;2,0;;1,0;;;;;;1,0;;;;;;;;;;;;;;;;;;;;;;;;;;4,0;;;;;;;3,0;;;3,0;;;;;;;;2,0;;;;;;;2,0;;;;;;;;;;1,0;;;;1,0;;;;;;;;;;;;;;3,0;;;;;;;;;;;1,0;;;;;;;;;;;;;;;5,0;;;;;;1,0;;;;;;;;;;18,0;;29,0;;;;;3,0;;;;;;;;;;;;;;;;;;;;;;;;;;;;;;;;;2,0;;;;;;;;;;6,0;;;;;;;;;;;;;;;;;1,0;;18,0;;334,0;;;;;;;;;1,0;;3,0;;;;;;;;;;;;2,0;;;;;1,0;;14,0;;;;;;;;;;;;;;;;;;;;;;;;;;2,0;1,0;1,0;;;;;;;;;;;;;;;;;;;;;;;;;;;20,0;;;;;1,0;1,0;;;;;1,0;;;;;;;;;;;;;;;;;;;;;;;1,0;;;;;;;;;;;;;;;;;;;;;;;;;;;;;;;;;;;;2,0;;;;;;;;;;8,0;;;;3,0;;;;;;;;;;;;;;;;;;3,0;;;;;;1,0;;;;;;;;1,0;;;;;;;;1,0;;;;;;;;;;;;;;;;;;;;;;;;;;;;;;;;;;;;;;;;;;;;;;;4,0;;;;;;;;;;;;;;;;;;;;;;2,0;;;;;;1,0;;;;;1,0;1,0;;;;;;;;1,0;;;;4,0;;;;;;;;;;;;;;;;;;;;;;;;;;5,0;;9,0;;3,0;;;;
cycle;;;9,0;1,0;8,0;;1,0;;4,0;6,0;;;;1,0;1,0;1,0;;;;;;16,0;;1,0;1,0;;;31,0;1,0;8,0;;8,0;14,0;4,0;9,0;;1,0;5,0;;22,0;;;;4,0;;;;;7,0;4,0;;5,0;1,0;1,0;;63,0;23,0;;10,0;;;;31,0;;;;;;10,0;16,0;1,0;;;;;;;;6,0;;;8,0;1,0;13,0;;;1,0;;9,0;2,0;18,0;2,0;;36,0;;;;6,0;3,0;;3,0;29,0;;3,0;;2,0;1,0;14,0;17,0;;5,0;4,0;3,0;;;;;;;;;;1,0;1,0;;;5,0;;;;;;2,0;;;;;;;;2,0;;;2,0;;;;5,0;;;;;;;;;;;6,0;29,0;;1,0;;;;;5,0;3,0;;;;2,0;;1,0;;2,0;;2,0;4,0;;;1,0;;;;;;20,0;;10,0;;;;4,0;;4,0;;;;;;;;1,0;;;;2,0;;;;;;;;12,0;;;1,0;;13,0;;;;;;;;3,0;;;;4,0;1,0;6,0;;;;10,0;;;;;;;;;;;;;;;;1,0;;;7,0;;;;;;;;;;;;;;;;;;;;;1,0;;;;1,0;;;6,0;1,0;2,0;;1,0;;;;2,0;;1,0;;3,0;;;;;11,0;;;;;2,0;;;;4,0;2,0;;;;;;;7,0;;;;1,0;;1,0;;;;;;;;;;;;4,0;;;;1,0;;;;;;5,0;;15,0;;;1,0;1,0;;;2,0;;;;1,0;;;;2,0;;;;;;;;;8,0;;5,0;1,0;8,0;;1,0;5,0;;;1,0;1,0;;1,0;;;;7,0;2,0;;;10,0;12,0;6,0;;;;;;;;;;;;;;;;;;;;;;7,0;;;;;;4,0;;;7,0;;1,0;;;;;;;1,0;;;;7,0;;;;;1,0;;1,0;;;;2,0;4,0;1,0;;;1,0;;;;;;3,0;;;6,0;4,0;;2,0;;;3,0;;;;;;;;;1,0;;;2,0;;;2,0;1,0;;2,0;;7,0;;;;7,0;1,0;;;;;;;;;;;;;;;;;;4,0;;;;;;;;;;;2,0;;;;;;;;;;;;;;;;;;;;;;5,0;;;4,0;;;;;;1,0;;;7,0;4,0;;;;;;1,0;;;;;;;;;;;2,0;;4,0;;;;;4,0;4,0;;;;33,0;;;;;;;;;;;;;3,0;;;;;;;;;;;;;;;;;;3,0;;;;;;;;;;;;;4,0;;;;;;;;1,0;;;;;;;;;;12,0;;;;;;;;;;;;;;2,0;1,0;;;;;;;;2,0;;;2,0;;;;;2,0;;;4,0;;;7,0;;;;;;;;1,0;3,0;;2,0;;;;;;;;;;;;2,0;9,0;25,0;10,0;;;;;;1,0;;2,0;1,0;;;;3,0;;;;48,0;17,0;1,0;;;;;;;;;;5,0;;3,0;;;;;;;;;;;;;;;3,0;;;;2,0;;;10,0;1,0;;;;;;;;3,0;;;1,0;;;;;;;;2,0;;;1,0;;;;;;;;;;;;;;;;;;;;;;;;;;;;;2,0;;3,0;;;;;;;7,0;;;2,0;5,0;;;;;;1,0;;;;;;;7,0;;;;;7,0;;;;;;;;;;;;;;;;;;;;;;;;;;;;;;;;;;;;;;3,0;;;;;1,0;;;;;;;;;;;;;;;;;1,0;;;;;;;;;;;;;;3,0;;;3,0;;;;;;;;;;;;;;;;;;;;;;;;;;;;;;;;;;;;;;;;;;;;;;;;;;;;;;;;2,0;;;;;;;;;;;;;;;;
dark;;;8,0;;10,0;;;2,0;9,0;4,0;;;;;2,0;;;;;1,0;5,0;6,0;;4,0;6,0;;;25,0;;4,0;8,0;23,0;15,0;;7,0;;;6,0;;2,0;3,0;;;20,0;;;;;;;;13,0;1,0;;;137,0;11,0;;;4,0;;;13,0;2,0;;;;;4,0;;8,0;;;;;;;1,0;2,0;;1,0;1,0;3,0;1,0;;;26,0;7,0;2,0;2,0;;;;5,0;;;;;2,0;1,0;8,0;2,0;;;;;1,0;5,0;;;;;2,0;4,0;;;;;;;;;;;;;3,0;;;;;;;;;;;;;;;1,0;;1,0;;;1,0;10,0;;3,0;;;;;;;;;5,0;5,0;;2,0;;;;;10,0;18,0;;;;;;;;;;;;;;;;;;2,0;;18,0;;47,0;;;;;;2,0;;;;;;;;1,0;;;;;3,0;;;;;;;2,0;;;;;;3,0;;2,0;;;;;2,0;;;;;;3,0;;;;11,0;;;;;1,0;;6,0;;;;;;;;;;;;1,0;;;;;;;;;;;;;;;;;;1,0;;;;;;;;;;;;13,0;3,0;1,0;;;1,0;20,0;;;;8,0;;;1,0;;4,0;;;;;4,0;;;2,0;2,0;;;;;;;;;;;;;;;;;;;1,0;;;;;;;;;;;2,0;;;;;3,0;;;;;;2,0;;;2,0;;;;;;;;;;;;;;;1,0;;;;;1,0;;2,0;;4,0;;;;1,0;;;;8,0;;10,0;;;;;;;;;6,0;;;;;;;;;;;;;1,0;;;;;1,0;;;;2,0;1,0;;;;;;;;;;;;;;;1,0;;;;1,0;;;;;2,0;;;;;;1,0;4,0;;;;;;;;;;;2,0;;;;;;;10,0;5,0;;;;;;;;;;;;;1,0;;1,0;2,0;;18,0;;2,0;;;1,0;6,0;;;;;;;;8,0;;;;;;;;;;;1,0;;;;;1,0;;;15,0;;;;;;;;;;;;;;;;;;;;;;;;;;;;;;;;;;;;;6,0;25,0;;;;;;;;;;;;;;5,0;;;;;;;;7,0;;;;;;2,0;;;;;;;2,0;;;1,0;;;;22,0;;;;;;;;;;;;;;;;;;1,0;;;;;;;;;;;;;;;;;;;;;;;2,0;;;;;;;;;;;;;;;4,0;;;;;;;4,0;;;;;;;;2,0;6,0;;;;;;;;3,0;6,0;;;3,0;;;2,0;;1,0;;;;;1,0;6,0;;;;;;;;;;;;2,0;;;6,0;2,0;;;;;;;;;;;;;;;;;1,0;;2,0;;;;;;;;;;;3,0;;;;1,0;4,0;;;;;;;;;1,0;;;;4,0;;4,0;;;;6,0;;;;;;;;;9,0;7,0;;;;;;;;;;;;;;;;;;;;;;;;;;;;;1,0;1,0;;;;;;;;;;;;;;;;;;;;;4,0;;;;;;;;;;;;;;2,0;;;;;;;;;;;;5,0;;;;;;;;;;;;;;;;;;;;;;;;;;;;;;;;;;;;;;;;;;;;;;;;;;;;;;;;4,0;;;;;;;;;;;;;;;;;;;;;;;;;;;;;;;;;;;;;;;;;;;;;;;;;;;;1,0;;;;;;;;;;;;;;;;;;;;;;;;;;;;;;;;;;;;;
decide;;;24,0;;3,0;;;15,0;1,0;5,0;9,0;;;;12,0;4,0;;;;;32,0;20,0;;;;1,0;;10,0;1,0;5,0;1,0;16,0;64,0;2,0;1,0;;;2,0;;23,0;5,0;;2,0;;;;;;4,0;1,0;;3,0;1,0;;;95,0;17,0;;;27,0;;3,0;6,0;2,0;;;3,0;;5,0;7,0;;23,0;;;;2,0;;;48,0;2,0;;1,0;;;;;19,0;;;5,0;3,0;;36,0;31,0;6,0;;;1,0;4,0;;;2,0;;2,0;;;;74,0;;;1,0;;;;;;;;;1,0;;;;8,0;;;4,0;;3,0;;;1,0;;;;1,0;;;;;;;5,0;44,0;1,0;;;1,0;;;;;;;;;;;;8,0;;;;;;;7,0;8,0;;;;;;;;11,0;;;;;;;;;;;;20,0;;4,0;;;;2,0;;;;;;;;;;1,0;;;;;;1,0;;;;;;14,0;1,0;;;;1,0;;;;;;;;;;;;;4,0;2,0;2,0;;1,0;24,0;;;;;;;;;;;;;;;3,0;;;;3,0;;;;2,0;;;;;;;;;;;;;;;;;;;;;;;;;;2,0;;;;;;;;;;6,0;;;;;7,0;;;;;7,0;;;1,0;;1,0;;;;;;;;;1,0;;;;7,0;;;;;1,0;;;;;4,0;;;;;;;;6,0;1,0;;5,0;1,0;;1,0;5,0;;;;;;;;;;;;;;;;;;;;;;;2,0;;1,0;;1,0;;;1,0;1,0;;18,0;;1,0;3,0;5,0;;17,0;;;;;2,0;5,0;3,0;;8,0;;3,0;;;;;;;6,0;;;;;;;;;14,0;;1,0;;5,0;;;;23,0;;1,0;;7,0;3,0;;;;;;;1,0;4,0;;;;;;;;3,0;;;3,0;;;4,0;;1,0;;;;;6,0;;4,0;;;2,0;;3,0;;;;;;8,0;;;;;;;;;;;1,0;;;;14,0;;;;;2,0;;;;;;;;5,0;3,0;;;1,0;19,0;;;;;;;;;;2,0;;;;;;;;4,0;;;;;;;;;;;;4,0;;;;;;;;;;;;;;1,0;;8,0;2,0;;;;;3,0;;;3,0;13,0;;;1,0;;;;;;;;2,0;;;;;;;;;;;11,0;;2,0;9,0;;;;16,0;;;;;;;;;;;;;34,0;;;;7,0;;;;;4,0;;;;;;;;;;;4,0;;;;;;;;;;;16,0;;;;;;;;;;;;;;;;;;;;;;;;;;;;;;;;;;;;;;;;;;;;5,0;;;;;4,0;2,0;;;;;;;;;4,0;;;;;;;;2,0;;;;;;;;;;;;;;2,0;;;3,0;80,0;;;;;;;;;2,0;;;;5,0;;3,0;;;2,0;;;;;11,0;;11,0;;;;2,0;4,0;;;;;1,0;13,0;;;2,0;;;;;;;;;;;;;5,0;;;;;;1,0;;;;;;;1,0;;;;;;;3,0;;;;;;2,0;;;;;;;;;;;;;;2,0;;;;;;;;2,0;;;3,0;;;;;;;;;;;;;;;;;;;;;;;;;;;;;;;5,0;2,0;;1,0;;;;;;;;;;;;;;;;;;;;;;;;;;;;;;;;;;;;;;;;;;;;;;;;;;;;;;;;;;4,0;;;;;;;;;;;;1,0;;;;;;;;;;;;;;;;;;;;;;;;;;;;;;;;;;;;;;;;;;1,0;;;;;;;;;;;;;2,0;;;;;;;;;;;;;;;;;;;
decision;;;5,0;;2,0;;;21,0;1,0;3,0;;;;;10,0;;;;;3,0;14,0;9,0;;;3,0;;;12,0;;10,0;5,0;29,0;66,0;;4,0;;;;;29,0;4,0;;;;;;;;;8,0;;2,0;;;;61,0;13,0;;;8,0;;2,0;7,0;;;;;;;30,0;2,0;2,0;;;;4,0;;;10,0;4,0;;5,0;;2,0;;;12,0;;;12,0;1,0;;14,0;8,0;2,0;;;5,0;4,0;;;15,0;;8,0;3,0;;;74,0;;;;1,0;;;;;;;;2,0;;;;10,0;;;4,0;;4,0;;;;;;;1,0;;;;;;;;20,0;;;;;;;;;;;1,0;;;;;2,0;;;;;;;;;2,0;;;;18,0;;;;;2,0;;;;;;;;;;5,0;;6,0;;;;8,0;;;;;;;;;;;;1,0;;;;21,0;1,0;;;;;9,0;2,0;;;;;;;;;;;;;;;;;;4,0;;;1,0;4,0;;;;;;;;3,0;;;;;;;;;;;2,0;;;;;;;5,0;;;;;;;;;;13,0;;2,0;;3,0;;;;;;;;;12,0;;;;;;;;;;2,0;;;;;6,0;;;;;;;;25,0;2,0;;;;;;;;;;;;;;3,0;;;;;12,0;;;;;;;;;;;;;4,0;;;;;;;2,0;;5,0;;;1,0;;;;1,0;;;;;1,0;1,0;2,0;;;;;;;;9,0;2,0;;1,0;;;;;;3,0;;4,0;;;;7,0;;4,0;;;;;;;4,0;;;;;;;;;;21,0;;;;;;;;;;;;1,0;2,0;;3,0;52,0;;;;;5,0;;;;;;;;;;;4,0;;;;;2,0;;;;;;;;;;;2,0;;6,0;;;;;1,0;;1,0;;;1,0;;;7,0;;;;;3,0;;6,0;;;;;4,0;;;2,0;3,0;;2,0;;7,0;;;;;;1,0;;;;2,0;;;2,0;;;;;;;;;;;;;1,0;;80,0;;;4,0;;;;1,0;;;;;;;;3,0;;;;;;;;;;;;;;1,0;;20,0;2,0;;;;;;2,0;;2,0;3,0;;;;;;;;;;;3,0;3,0;;;;;;;;;2,0;13,0;;;;;;;24,0;;;;;;;;;;;;;10,0;;;;6,0;;;;;;;;;;;;;5,0;1,0;;4,0;;;;;;;;;;;11,0;;;;;;;;;;;;;;;;;5,0;;;;;;;;;;;;;;;;;;;;;;2,0;;;;;9,0;2,0;1,0;;;2,0;;;;;;;;;4,0;3,0;;2,0;;;;;;;;;;;;;;;2,0;;;;;;;;;;;;;;;;;;;;;;6,0;;;;;;;;;;;;;;;;;9,0;;;;;;6,0;;;;;;;;;;;;;1,0;;;7,0;;;;;;1,0;;;;;;;;;2,0;;;;;;;;;;;;;;;;;;;;;;;;1,0;;;;;;;;;1,0;;;;;;;;;;;;;;;;;;;;;;;;;;;;;;;;;;;;;2,0;;;;;;;;;;;;;;;;;;;;;;;;;;;;;;;;;;;;;;;;;;;;;;;;;;;;;;;;;;;;;;;;;;;;;;;;;;;;;;;;;;;;;;;;;;;;;;;;;;;;;;;;;;;;;;;;;;;;;;;;;;;;;;;;;;;;;;;;;;;;;;;;
decrease;;;28,0;;19,0;;4,0;8,0;6,0;9,0;;2,0;;;6,0;;1,0;;2,0;1,0;;25,0;;1,0;5,0;;10,0;4,0;;10,0;1,0;17,0;13,0;16,0;7,0;;;14,0;;7,0;28,0;;1,0;;;6,0;;9,0;12,0;;16,0;;;63,0;;33,0;;;14,0;78,0;1,0;11,0;21,0;;;8,0;1,0;;1,0;6,0;23,0;;5,0;;;1,0;;2,0;14,0;8,0;1,0;7,0;;1,0;;1,0;3,0;2,0;1,0;;4,0;;1,0;13,0;9,0;12,0;;;;;7,0;24,0;;;;1,0;;68,0;;;;2,0;;;;3,0;;;;;;;;5,0;;;1,0;;3,0;;3,0;;;;;;;;;3,0;;;2,0;;;;2,0;24,0;;;3,0;;;;6,0;;1,0;;6,0;2,0;;85,0;;;;;22,0;17,0;2,0;;5,0;1,0;7,0;;1,0;;;12,0;;;;;;;;;;1,0;;2,0;;;;3,0;;;2,0;;2,0;;2,0;3,0;;21,0;;;;;1,0;;;;;;;18,0;1,0;;;;;;2,0;;;;;;2,0;;;;;;8,0;13,0;;;7,0;;;;;;;;3,0;;;2,0;1,0;;;1,0;;1,0;;3,0;;2,0;;;;;;;2,0;;;;;;;;;;;;3,0;;;;1,0;2,0;;5,0;5,0;8,0;1,0;;;;;1,0;;2,0;;4,0;;;;;13,0;;;;;4,0;;;4,0;5,0;;;12,0;;;;;;;1,0;;;;5,0;;;1,0;;1,0;4,0;;4,0;;;;;;;;1,0;;1,0;1,0;1,0;1,0;5,0;;27,0;;;;;;;;;;;;;3,0;;;2,0;;;;;1,0;;9,0;3,0;1,0;;;3,0;;;;1,0;;;2,0;;12,0;17,0;1,0;2,0;1,0;3,0;;2,0;5,0;16,0;;5,0;12,0;;;;;;;;;22,0;;;;;;;;;;;1,0;;;;;1,0;;;1,0;;2,0;;;;;;;3,0;;;;8,0;4,0;;;;;1,0;;2,0;;;;;3,0;;;1,0;;;;;;;;;;2,0;;2,0;9,0;;;4,0;;;;;2,0;;1,0;;;;;;;;;;;6,0;;;;2,0;1,0;;4,0;28,0;16,0;;;;;;4,0;;;;2,0;;;;;;;;;;;;;;;;;5,0;1,0;;2,0;;;;;1,0;;6,0;;;;;;1,0;;;;;;;;7,0;;;;;;;;;;2,0;5,0;;;;;;1,0;;;;;;;;;;;;;;;;2,0;;;1,0;;;5,0;2,0;;;;8,0;;;;;;1,0;;;16,0;;;;;4,0;;;;;;;;;;;;1,0;;;1,0;;;;;;;;;;;;;;3,0;;;;;;;;2,0;;;;;;;;;;;;;;2,0;;;4,0;;10,0;;;;;;;;;;1,0;;;;18,0;;;1,0;;;8,0;;;;2,0;3,0;1,0;;;;;;;;;6,0;;27,0;;;;;;;;4,0;;;1,0;;;;;;;1,0;;;;;;;1,0;;4,0;;;;14,0;;;;;;2,0;;;;1,0;;;;3,0;;;;2,0;;;;1,0;;;;;7,0;;2,0;;;;;;;;;;;;;;;;;;;;;;1,0;;;;;;;;;;;5,0;;3,0;;;;;;;;;;;;;;;;;;;;;;;1,0;;5,0;;1,0;;15,0;;;3,0;;4,0;;2,0;;;;1,0;;4,0;;;;;;;;;;7,0;;;;;1,0;;;;;;;;;;;;;;;;;;;;;;;;;;4,0;3,0;;;;;;;;;;;;;;;;7,0;1,0;;;;;;;;;;;;;;;;;1,0;;1,0;;;;;;1,0;;;;;;;;;;;;;;;;;;1,0;;;;;;;;;;2,0;;;;;;;;;;;;;;;;;;2,0;;6,0;;;;;;;;;;;;;;;;;;;;;;;;;;;;;;
delay;;;10,0;;1,0;;;8,0;2,0;14,0;5,0;;;6,0;;1,0;;;1,0;;;23,0;;;;;;17,0;;3,0;7,0;30,0;7,0;2,0;10,0;;;2,0;;;3,0;;;3,0;;;;;;;2,0;9,0;3,0;;;30,0;3,0;;3,0;;;;12,0;1,0;;;1,0;;3,0;2,0;;1,0;;;5,0;6,0;;3,0;6,0;;;4,0;1,0;1,0;;;1,0;;;;;2,0;1,0;55,0;;;1,0;2,0;9,0;;;15,0;;1,0;;8,0;;17,0;;;9,0;;;;;;;;;;;;3,0;24,0;;;3,0;;;;;;;;;;;;;1,0;;;;;;;1,0;22,0;;;;;;;;;;;;2,0;;;;;;;;11,0;;;;;;;;;;14,0;;;;;;;;;;2,0;;1,0;;;;1,0;;1,0;;;;;;1,0;;1,0;;6,0;;1,0;;;;;;;;146,0;7,0;;;;;;;;;;;;;;;9,0;;3,0;;;;;;;;;;;;;3,0;;;;;;;2,0;;;;2,0;;;;1,0;;;;;;;;;;;;;;1,0;;;;;;;2,0;;;;;7,0;;;;;;;;;;3,0;;;;;6,0;;;;;;;;6,0;1,0;;;;;2,0;;;;;;;;;3,0;;;;;2,0;1,0;;;;;;;;;;5,0;;2,0;;1,0;;;;2,0;;5,0;;;;;2,0;;;;1,0;;;;;;;;3,0;;;;;3,0;;2,0;;;;;9,0;;;3,0;4,0;;;1,0;;;3,0;1,0;;;1,0;2,0;1,0;;;;;;;;;;;;;2,0;;;;;;4,0;;;5,0;2,0;1,0;4,0;;;;;1,0;3,0;;4,0;;;;1,0;;;3,0;;;;;;;;;3,0;;1,0;;;4,0;2,0;6,0;7,0;;;;;;;;;;2,0;;5,0;;;;;;;;;;;;;;;1,0;;2,0;;;;;;;3,0;1,0;2,0;;3,0;25,0;2,0;;5,0;;2,0;;;;;;;;;;;;;;3,0;1,0;;1,0;;;3,0;;;;;;;;;;;;;;;;;;;;;;;;;;;;;;;;;;;;;;;;;;;;;;;2,0;1,0;;;;2,0;;;;;;1,0;;;;;4,0;;1,0;5,0;;;;;1,0;;;;;;;;;;;;12,0;;;;;;;;;;;;;;1,0;;;;;;;;;;;;6,0;;;;;;;;;;;;;;;;;;;;;;;1,0;;;;;;;1,0;;;;;;;;2,0;;;;;;;;;;;;;;;;4,0;;;4,0;;;;;;;;;;;;;;2,0;3,0;3,0;;;;;;;6,0;;;;;;6,0;;;;;;;;;1,0;;;;;;;;11,0;;;;;;;2,0;;1,0;;;15,0;;1,0;;3,0;;;;;;;;;;2,0;;;;;;;;;;1,0;;3,0;;;;;;;;2,0;;;;;;1,0;;;;;;;4,0;;;;;;;;;;;;;;;;;;;;;;;;;1,0;;;3,0;;;;;;5,0;;;;;;;1,0;;;;;2,0;;;;;;;;1,0;;;;;;;;;2,0;;;;;;;3,0;;2,0;;;;;;;;;;;;;;;;;;;;;;;;;;;;;;;;;;;;;;;;;;;;;;;;;;;;;1,0;;;;;1,0;1,0;;;3,0;;;;;;;;;;;;;;;;;;;;;;;;;;;;;;;2,0;;;;;;;;;;;;;;;;;;;;;;;;;;;;;;;;;;;;;1,0;;;;;;;
depth;;;1,0;;19,0;;3,0;32,0;9,0;23,0;2,0;;;1,0;4,0;1,0;;;25,0;7,0;2,0;9,0;;1,0;1,0;;5,0;32,0;;19,0;5,0;40,0;21,0;1,0;4,0;3,0;1,0;20,0;;3,0;15,0;;2,0;4,0;;5,0;;13,0;63,0;1,0;3,0;17,0;1,0;;2,0;188,0;25,0;;3,0;33,0;;;43,0;;;;1,0;;;5,0;14,0;5,0;;1,0;;;;14,0;19,0;;;19,0;4,0;;;;26,0;;13,0;20,0;23,0;3,0;2,0;8,0;4,0;6,0;;;;1,0;21,0;36,0;;3,0;;1,0;;;;;1,0;1,0;7,0;11,0;1,0;;;2,0;;7,0;4,0;;1,0;;;;7,0;1,0;1,0;1,0;4,0;5,0;;;;20,0;9,0;;8,0;;3,0;;1,0;3,0;4,0;;5,0;3,0;;;1,0;1,0;13,0;;1,0;1,0;3,0;1,0;;18,0;1,0;2,0;;;1,0;4,0;;6,0;;;23,0;2,0;19,0;;4,0;1,0;1,0;10,0;1,0;;2,0;1,0;;;;36,0;1,0;17,0;;11,0;;1,0;;10,0;;1,0;;1,0;2,0;;20,0;1,0;;6,0;;;;4,0;2,0;;;;;;;5,0;2,0;;;;1,0;;;;;;;;;;;;;;3,0;1,0;;3,0;24,0;;;2,0;;5,0;;;5,0;;2,0;2,0;;;;;;;1,0;6,0;5,0;;;;17,0;1,0;;2,0;8,0;;2,0;7,0;;4,0;;;1,0;6,0;;;3,0;7,0;;;;5,0;;2,0;4,0;33,0;1,0;;4,0;;2,0;3,0;;3,0;1,0;5,0;;;;;12,0;4,0;4,0;;;23,0;;2,0;3,0;3,0;;;1,0;;;;;;;3,0;2,0;;;5,0;;;;;4,0;3,0;;;;;;;4,0;;2,0;11,0;;1,0;10,0;;;;;4,0;4,0;3,0;40,0;;;1,0;3,0;;1,0;;6,0;1,0;;1,0;2,0;;;;2,0;;;;;12,0;3,0;;3,0;1,0;;;;2,0;;;;;;;2,0;1,0;;;;;1,0;;;1,0;;;;;3,0;12,0;9,0;;20,0;1,0;;1,0;;1,0;;;1,0;;8,0;;15,0;1,0;1,0;4,0;;6,0;;;1,0;;5,0;23,0;1,0;;;;;;;;;;;15,0;;;2,0;10,0;2,0;1,0;;;;1,0;88,0;2,0;1,0;;;;5,0;;;;;;1,0;;;;17,0;;;2,0;;;;;;;;;;;;2,0;;1,0;;;;1,0;;;20,0;;14,0;13,0;;;;1,0;;;2,0;1,0;2,0;;;;;;;;;1,0;;1,0;;2,0;;;;;;;;;4,0;;1,0;;;1,0;1,0;;;;;;;;;;;;;;;2,0;;;;;;7,0;;;1,0;2,0;;44,0;29,0;;;;;;;;;;;;;;;;;2,0;;;;15,0;;1,0;;;;;;;;;;;2,0;;;1,0;;;;;;;;;;;;;1,0;5,0;;;;;1,0;;;1,0;;;;2,0;;;;;;;;;;2,0;1,0;;;;;;;;2,0;;;;6,0;;;;3,0;;;;;20,0;;;;;3,0;;;;;;;;2,0;;;;;2,0;1,0;;4,0;;;;;1,0;;9,0;;;2,0;;2,0;2,0;;;;;2,0;4,0;2,0;1,0;5,0;;;;;;;;;;;15,0;;;1,0;5,0;;;4,0;;;;;;;;;1,0;;;7,0;;;;2,0;;;5,0;;2,0;1,0;;;;;;4,0;;2,0;;1,0;;;;9,0;2,0;;;;;8,0;1,0;5,0;;1,0;;;;;;1,0;;;;;;8,0;3,0;;1,0;;;;;2,0;;;;;;;;;;;;1,0;1,0;;1,0;;3,0;;;;1,0;;;;;1,0;;;;2,0;;;;;;1,0;;1,0;;;;;;;;;2,0;;;7,0;;3,0;1,0;11,0;3,0;;;;;;;;;1,0;;18,0;2,0;;;;;;;;;;;;;3,0;;;;;;;;1,0;;;;;;4,0;2,0;;;;;1,0;;;1,0;;4,0;;;;;;;;;1,0;;;;;;;;;;;;1,0;;;;;;;;1,0;;;;;;;;;;;;;;;;;;;;2,0;;;;;;;;;;;;1,0;;;;;;;1,0;2,0;1,0;;;;;;;;;1,0;;;;;;;;;;;;;;2,0;;;;;;;;;;;;;;;;;;;
derive;;;4,0;2,0;1,0;;2,0;20,0;3,0;5,0;4,0;4,0;;;18,0;;;1,0;;4,0;6,0;13,0;1,0;;12,0;;3,0;58,0;;;5,0;10,0;27,0;3,0;39,0;4,0;;5,0;;3,0;35,0;;;10,0;3,0;3,0;6,0;;;;2,0;5,0;;1,0;;127,0;5,0;1,0;;1,0;;;23,0;;15,0;;2,0;;;2,0;1,0;1,0;1,0;;;;;29,0;51,0;4,0;;13,0;4,0;;;;6,0;2,0;3,0;10,0;12,0;2,0;;58,0;;;;;6,0;1,0;6,0;5,0;;;;;;14,0;;;1,0;3,0;;;;;3,0;1,0;;2,0;;;1,0;1,0;;2,0;7,0;;;3,0;;1,0;;;;9,0;;;;;;;;2,0;3,0;;;10,0;;;1,0;;;;3,0;;;;1,0;9,0;3,0;;;;1,0;;5,0;7,0;;;;10,0;11,0;;5,0;;;10,0;;;;;;;;;;11,0;;9,0;;;1,0;8,0;;;;;;;;;;;;;;;;;2,0;;;1,0;;2,0;1,0;;1,0;;;;;;;;;;;;;;;1,0;;5,0;;4,0;;;;;3,0;;;;;;;;;;;1,0;;;;;;;13,0;;13,0;;;;;;;;;;;3,0;;;;;;2,0;;;;;;7,0;;22,0;1,0;;;;4,0;2,0;;;7,0;1,0;;;;;;5,0;;;;2,0;;;7,0;2,0;;;;;;;;;;;;;;2,0;;;2,0;;4,0;3,0;;1,0;;6,0;;;2,0;2,0;;13,0;;;11,0;;;;;3,0;;1,0;;;;;;;;;5,0;;;;6,0;2,0;;2,0;1,0;;;;1,0;9,0;;1,0;;;;;;6,0;3,0;1,0;;;;;;9,0;;2,0;;1,0;;2,0;;1,0;3,0;;;;;;14,0;9,0;1,0;;;;;;;;;;;;2,0;1,0;4,0;2,0;;5,0;1,0;;2,0;3,0;1,0;8,0;;2,0;;;;;;;3,0;;;3,0;;4,0;;;4,0;;1,0;;;;;;;;;;;;;;;;;3,0;;;11,0;;;;;;;5,0;;;;;;;;;2,0;5,0;;;;1,0;;2,0;;1,0;11,0;9,0;;1,0;;;;;;1,0;;1,0;;;;;;;;1,0;1,0;;;;;;;;;;;;1,0;;2,0;;;;;;2,0;4,0;;;;;;5,0;1,0;;;;;;;;2,0;;;;;;;;;8,0;22,0;;;;;;3,0;;;4,0;;;1,0;;;;;;;;;;3,0;;;;;;;;;;;6,0;1,0;18,0;;;;;;;;;;;;;;;;;;;;;;;;;;;;;;;;;;;;;;;3,0;;1,0;;;;;;;;;;;;3,0;;1,0;1,0;;;;;;;;;4,0;;;;;;;;;;;;;;;;;2,0;;;3,0;;;4,0;9,0;12,0;;;;;;7,0;;;1,0;;;;;;2,0;4,0;2,0;;;;;;2,0;12,0;;;7,0;1,0;;;;2,0;;;;;;;;;;4,0;;;;;1,0;;;;;2,0;;;5,0;;;;;4,0;;;;;;;;7,0;;;4,0;6,0;;;;1,0;;;5,0;;;;;2,0;;;;;;;1,0;;;4,0;;;;;;;;;2,0;;;1,0;;;;;;;1,0;;;;;;;;;;3,0;;1,0;1,0;1,0;1,0;;;;7,0;;;;2,0;3,0;;;;;;1,0;;;1,0;3,0;;;;;;1,0;;;;;;;2,0;;;;;;1,0;3,0;;5,0;;1,0;;;;;;;;;;;;;;;;;;;;;;;;;;;;;;;;;;;;1,0;;;;5,0;;;5,0;3,0;;;;;;;;1,0;;;;;;;;;;;;;4,0;;;;;;;;;4,0;10,0;;;;;2,0;;;;;;;5,0;;;;;;;;1,0;;;;;;;;;;;;2,0;;;;;;;;;;;;;;;9,0;;;;;;;;;;;;6,0;;4,0;;1,0;;;;;
describe;;;1,0;;46,0;1,0;8,0;17,0;;3,0;;1,0;7,0;;8,0;;;;2,0;1,0;2,0;13,0;23,0;;;;5,0;36,0;;1,0;4,0;7,0;89,0;;31,0;1,0;3,0;15,0;;5,0;8,0;;3,0;12,0;;;;1,0;1,0;4,0;4,0;4,0;1,0;8,0;;30,0;18,0;;2,0;124,0;;;52,0;;3,0;5,0;1,0;;;3,0;7,0;1,0;3,0;2,0;;;2,0;12,0;26,0;7,0;1,0;2,0;2,0;1,0;;1,0;;;1,0;6,0;35,0;;1,0;6,0;1,0;6,0;;1,0;3,0;;7,0;57,0;;;;;;9,0;;1,0;;1,0;3,0;4,0;;;;;6,0;5,0;;;;4,0;;;5,0;5,0;;2,0;1,0;2,0;3,0;;;1,0;2,0;;4,0;;1,0;3,0;4,0;3,0;1,0;;12,0;6,0;2,0;1,0;;3,0;8,0;;;8,0;8,0;15,0;1,0;43,0;1,0;;6,0;1,0;2,0;;1,0;24,0;;7,0;20,0;14,0;128,0;13,0;1,0;2,0;;6,0;;;1,0;;;;1,0;1,0;2,0;28,0;;35,0;;3,0;1,0;18,0;2,0;;;4,0;;;;11,0;2,0;2,0;9,0;4,0;1,0;4,0;12,0;13,0;3,0;2,0;;38,0;1,0;;;3,0;;5,0;1,0;7,0;;;3,0;;;;;;;;3,0;4,0;2,0;9,0;5,0;5,0;3,0;;35,0;1,0;;;;1,0;1,0;;;;;1,0;;9,0;1,0;;4,0;9,0;1,0;5,0;;1,0;;3,0;2,0;;4,0;;;2,0;1,0;1,0;;;;3,0;13,0;;;1,0;;4,0;;1,0;3,0;1,0;1,0;13,0;1,0;;;;1,0;6,0;;3,0;;1,0;;;1,0;3,0;3,0;1,0;;1,0;;4,0;;7,0;9,0;;;;3,0;;3,0;4,0;1,0;;;1,0;3,0;3,0;21,0;2,0;5,0;3,0;7,0;;18,0;;;1,0;1,0;;;;;;3,0;1,0;;1,0;;;;;2,0;;;;;1,0;;;;;1,0;;;;;;6,0;;;;2,0;1,0;;;;1,0;3,0;7,0;1,0;;;;;1,0;3,0;;;;;;;2,0;;3,0;;;2,0;1,0;;2,0;;;1,0;2,0;2,0;;10,0;;;1,0;1,0;;;1,0;4,0;2,0;;;3,0;;14,0;1,0;1,0;;;5,0;2,0;3,0;;1,0;;5,0;;5,0;2,0;;;;;8,0;;;;1,0;;;3,0;4,0;1,0;;;;;;9,0;1,0;;;1,0;;6,0;;;;;1,0;1,0;1,0;6,0;;5,0;;;3,0;;;;5,0;2,0;;;;;1,0;1,0;;5,0;1,0;1,0;1,0;1,0;;3,0;;2,0;;3,0;5,0;;;;1,0;;;1,0;1,0;;;;;;;3,0;;;;1,0;;7,0;;2,0;;;2,0;2,0;;;;2,0;;;;;2,0;;;6,0;;;;3,0;;;;;;1,0;1,0;;;;;;1,0;2,0;;;;;1,0;;1,0;9,0;;;1,0;;;1,0;;;;;;;;2,0;;;;;;;;1,0;;;1,0;4,0;2,0;;;;3,0;;9,0;;;1,0;;;;;;;;;;;;;;;;;;;;1,0;;;1,0;;;;6,0;;;2,0;;;12,0;;2,0;1,0;;;;2,0;;;;;;1,0;;3,0;;;2,0;;1,0;;;;1,0;3,0;;;;1,0;2,0;5,0;;;;;;;;;4,0;;;;;;;;;1,0;;;;1,0;1,0;24,0;;;;;;;;;;1,0;;;1,0;;;;;;1,0;1,0;;;;;2,0;1,0;;;;1,0;;;;;5,0;4,0;;1,0;1,0;;;;;;;1,0;1,0;;2,0;;;;6,0;2,0;;;;;;1,0;;2,0;;;;;;;1,0;;;;;;2,0;1,0;;;;1,0;;;;;;2,0;;;1,0;3,0;;;2,0;;1,0;;;;2,0;;;;;;1,0;;;;1,0;;;;;;;;;;;;;;;2,0;;;;1,0;;;;1,0;;;;;;;;;1,0;;;;;;;;;;;;;1,0;;;;;;;;;;;1,0;;;;;4,0;;1,0;;;;;8,0;;;2,0;;;;;;1,0;;;;;2,0;;;1,0;;;;;;;;;;;;;;;;;;;;;;;;;2,0;;;;;;;2,0;;;;;;;1,0;;;;;;;;;;;;;1,0;;;;;;;;;;;;3,0;2,0;;;;;;;1,0;;;7,0;;;;;;;;;;;;;1,0;;;;;;;;2,0;;1,0;;;;2,0;;;;;;;;;;;;;;;;;;;
designate;;;1,0;1,0;37,0;;;20,0;3,0;17,0;6,0;;;;8,0;;;;;1,0;26,0;29,0;67,0;1,0;;;2,0;79,0;3,0;6,0;9,0;30,0;96,0;;50,0;;;18,0;;76,0;12,0;;2,0;9,0;;3,0;;10,0;5,0;;6,0;12,0;1,0;10,0;;248,0;26,0;;6,0;15,0;;5,0;30,0;1,0;;;1,0;;;13,0;11,0;4,0;1,0;;;;;45,0;37,0;;;10,0;8,0;;7,0;;28,0;;;25,0;8,0;17,0;13,0;25,0;7,0;14,0;;9,0;11,0;;18,0;10,0;2,0;5,0;;1,0;;71,0;;;1,0;;4,0;;2,0;1,0;;;2,0;;;;6,0;10,0;2,0;;12,0;;;;3,0;3,0;;;;3,0;;;;3,0;;;;50,0;6,0;;1,0;11,0;;;;;;;;;;4,0;3,0;36,0;1,0;;;;;;3,0;18,0;;;4,0;;3,0;;1,0;3,0;;21,0;;;1,0;5,0;;1,0;;2,0;;43,0;;5,0;;;;17,0;;;;;;;;2,0;;3,0;;5,0;7,0;1,0;2,0;;;;;4,0;;23,0;12,0;;;;1,0;;;1,0;;;;;;;;;;;;;;1,0;137,0;;;;16,0;;;1,0;;;;;;5,0;;2,0;;3,0;;;3,0;;2,0;;1,0;;;;;;;;;;;;;;2,0;;;3,0;;;;;;32,0;3,0;31,0;10,0;1,0;;;4,0;;;;;9,0;;;;;18,0;;;;;35,0;2,0;;15,0;5,0;;;;;;;;;;4,0;;;;7,0;;;;;43,0;2,0;;;;;;;4,0;;;7,0;4,0;3,0;5,0;3,0;;;;17,0;11,0;12,0;2,0;;;;1,0;;;;;4,0;;;2,0;2,0;;;;12,0;3,0;1,0;1,0;1,0;3,0;10,0;;;;4,0;9,0;;;4,0;;;2,0;5,0;;18,0;;8,0;2,0;;4,0;2,0;5,0;20,0;1,0;1,0;10,0;;5,0;1,0;1,0;;;1,0;2,0;;;6,0;;;;1,0;1,0;;35,0;1,0;22,0;;14,0;4,0;20,0;;;31,0;12,0;18,0;2,0;;;;4,0;;;;;;10,0;7,0;;;2,0;5,0;;1,0;;;;5,0;6,0;;;;12,0;1,0;35,0;;1,0;1,0;;;;2,0;;2,0;5,0;;;10,0;;3,0;;1,0;29,0;;;1,0;6,0;3,0;10,0;;;;3,0;9,0;1,0;13,0;;11,0;6,0;;14,0;6,0;;3,0;;;6,0;17,0;1,0;;1,0;;4,0;;2,0;;;;;1,0;8,0;5,0;;;1,0;3,0;;;2,0;;;3,0;2,0;;;;;;;;3,0;1,0;;1,0;;1,0;;;;1,0;;;1,0;;;;3,0;;;;9,0;;1,0;;;2,0;34,0;2,0;5,0;;;2,0;;;;1,0;;;20,0;;;;;;;;;;6,0;1,0;;37,0;;2,0;;5,0;1,0;2,0;;;;4,0;;;;;;;3,0;;;;;;;1,0;;1,0;;;;;;;;4,0;7,0;;13,0;1,0;;;;;;;;;;;1,0;;;;;;;;;;2,0;;1,0;7,0;;;2,0;;;;;;;;;;1,0;;2,0;2,0;;;;;;1,0;2,0;;;;;;;;1,0;7,0;;;;2,0;2,0;;;;;;;;1,0;;20,0;;;2,0;6,0;;5,0;;;;9,0;;;1,0;;81,0;;6,0;;15,0;1,0;;;;;;;;;;;;;;;;;6,0;;5,0;;;8,0;;;;4,0;;7,0;;;;;;11,0;;;;;;6,0;1,0;;;;;2,0;;;2,0;;;1,0;;12,0;;3,0;;;;;;;;;;1,0;;;12,0;;;17,0;8,0;;;;;;2,0;;9,0;;;;;18,0;;;;;1,0;;;6,0;4,0;;;;4,0;;;;;;;;;;;;1,0;;;4,0;;;;;;;;;;;;;;;;;11,0;;;;;;1,0;2,0;2,0;;1,0;12,0;;;;;5,0;;;;;1,0;;;;;;;2,0;;;;;;;;;;;;;;;;;;;;;;;3,0;;1,0;;;;;;;;;;1,0;;;;;;;5,0;;;;;2,0;;;;;;;;;;8,0;3,0;;;;;;;;;;;1,0;;;;;;;;;;;;;;;;;;;;;;;;;;;;;;;;;;;3,0;;;;2,0;;;;;;9,0;;;;;;;;;;;;
desire;;;40,0;;4,0;;2,0;16,0;5,0;10,0;1,0;1,0;;;67,0;1,0;;1,0;3,0;1,0;2,0;27,0;4,0;4,0;1,0;;;54,0;2,0;8,0;1,0;29,0;21,0;2,0;16,0;;6,0;9,0;;44,0;14,0;;1,0;4,0;;;;;32,0;1,0;13,0;10,0;;;2,0;236,0;18,0;;13,0;29,0;;6,0;32,0;;3,0;;6,0;;;10,0;13,0;19,0;;;;;;7,0;83,0;2,0;;18,0;;14,0;9,0;;6,0;;5,0;121,0;3,0;2,0;23,0;20,0;59,0;1,0;1,0;1,0;6,0;;4,0;18,0;;2,0;;1,0;1,0;34,0;;;8,0;1,0;4,0;6,0;;;;1,0;;3,0;3,0;;;;1,0;;11,0;;1,0;2,0;1,0;;1,0;2,0;1,0;3,0;;;;5,0;;7,0;;;3,0;3,0;8,0;7,0;;;;;;;1,0;;;4,0;4,0;4,0;;1,0;;;;;18,0;68,0;;1,0;7,0;1,0;3,0;18,0;3,0;1,0;;17,0;;;;2,0;1,0;;2,0;2,0;17,0;28,0;;15,0;;1,0;;4,0;;3,0;;;13,0;2,0;;5,0;;1,0;;1,0;;2,0;1,0;22,0;;;11,0;4,0;2,0;23,0;4,0;;;;2,0;1,0;3,0;;;4,0;1,0;;;1,0;1,0;;;1,0;8,0;13,0;;7,0;22,0;;;;;3,0;;;;;;;;;;;;1,0;;18,0;;;4,0;3,0;;;4,0;;1,0;;;;;1,0;;;;3,0;4,0;;;1,0;4,0;1,0;;;;8,0;6,0;85,0;1,0;2,0;;;1,0;5,0;;;4,0;13,0;;;2,0;;1,0;;;;;6,0;;;8,0;;;;4,0;;2,0;;;;;;;2,0;;6,0;;2,0;2,0;3,0;27,0;1,0;1,0;;;1,0;9,0;;;2,0;;;;;6,0;;;;;10,0;;;;2,0;;;;4,0;;;;;;1,0;5,0;8,0;;2,0;;8,0;;;;3,0;4,0;2,0;1,0;;;;;;;;7,0;;9,0;33,0;;13,0;2,0;6,0;1,0;;1,0;2,0;;19,0;;;;;;;;;12,0;;;1,0;8,0;5,0;;2,0;3,0;;9,0;;8,0;2,0;28,0;3,0;;;5,0;;7,0;3,0;2,0;12,0;3,0;;;;;;;2,0;;;;;;1,0;2,0;6,0;4,0;1,0;3,0;;;;28,0;6,0;;2,0;;3,0;;3,0;;;;1,0;;8,0;;1,0;7,0;;;8,0;;;;;55,0;;3,0;1,0;;;;1,0;;5,0;;12,0;2,0;3,0;2,0;2,0;20,0;1,0;7,0;36,0;;;2,0;2,0;;1,0;;2,0;;;;;;2,0;;;;;1,0;;;1,0;1,0;;;;;;1,0;55,0;1,0;;;;1,0;;1,0;;14,0;5,0;1,0;7,0;;2,0;;1,0;;;1,0;;;;;;3,0;;;;;;;;1,0;;14,0;;15,0;;;;17,0;;;;;;;1,0;;;1,0;;;;;;22,0;;;1,0;;6,0;;;4,0;;;;;1,0;;;;;;;19,0;;;;;;;2,0;;2,0;;;;;;1,0;;1,0;;;;1,0;1,0;;;;;;;;4,0;8,0;2,0;6,0;3,0;;5,0;;;;;1,0;;;;;9,0;;12,0;;;;;1,0;;;;2,0;14,0;;;;2,0;1,0;6,0;;;;;;;;5,0;4,0;;2,0;1,0;;;;5,0;7,0;;2,0;;;;;;;;;2,0;;;1,0;;;;;;2,0;;1,0;;;;1,0;;1,0;3,0;3,0;;;;;;;1,0;;;3,0;;18,0;1,0;;;;;2,0;2,0;;;;1,0;1,0;;;;;;;1,0;;1,0;;3,0;;;;;;;;;1,0;6,0;;;1,0;;;;;;;;;;2,0;7,0;;1,0;;1,0;6,0;6,0;;;1,0;;3,0;;;;3,0;;2,0;6,0;;;1,0;;;;;;1,0;1,0;;;;12,0;2,0;2,0;;3,0;;;;1,0;;;;;;3,0;;;;5,0;;;;;;;;1,0;1,0;7,0;;;;1,0;;2,0;;;;;2,0;;3,0;;;;;;;;;;;1,0;;1,0;;4,0;;;;;;;;;;;2,0;11,0;;;;1,0;;;;;;;;1,0;1,0;;;2,0;;;;;;6,0;16,0;;;3,0;;;4,0;;2,0;;;;;;;9,0;;;;;;1,0;;;;;7,0;;;;;1,0;1,0;1,0;;;;;;;;;;;;;;;;;;;;;;;;;;;;;;;;;;;;;;;;1,0;;;;3,0;;;;;;;;;;;;;;;;;;;;;;1,0;;;;;
destination;;;1,0;;3,0;;;6,0;;1,0;;;;;1,0;;;;;11,0;;1,0;;;2,0;;;56,0;;3,0;16,0;18,0;39,0;;31,0;;2,0;;;9,0;;;;;1,0;;;;;;;3,0;;;;76,0;11,0;3,0;;;;;17,0;;;;2,0;;;1,0;3,0;;;;;;;5,0;8,0;;;4,0;;;;;2,0;;;8,0;;3,0;;11,0;4,0;;;14,0;6,0;;;15,0;;22,0;;1,0;1,0;6,0;;;1,0;;;;1,0;;;;;;;;2,0;5,0;;;1,0;6,0;;;;1,0;1,0;;;;;;1,0;;;;;;;2,0;;;;;;;2,0;;;;;;;11,0;;;;1,0;;2,0;;;;;3,0;;1,0;;3,0;;;7,0;;;;;;;;;;14,0;;2,0;;;;5,0;;;;;;;;;;;;3,0;;;;;;;;;;;19,0;;1,0;;1,0;2,0;;;;;;;;;;;;;;4,0;;;4,0;;;;;;;;;;;;;;;11,0;;;;3,0;3,0;;;2,0;;;;;;;;;;;;;;17,0;;;;;;;;2,0;;4,0;7,0;9,0;;;;;;;;;;10,0;;;2,0;;10,0;;;;;;;;2,0;6,0;;;;;1,0;;;;;;;;;3,0;;;;;19,0;;;;;;;;;;2,0;;;;;2,0;;;;26,0;;6,0;;;;;;;;;;;;;8,0;6,0;;;1,0;1,0;;;;;;3,0;;;;;;;;;;;;;;1,0;;1,0;;2,0;;;3,0;1,0;;;1,0;;3,0;;;;;;;;;;;;13,0;;;;5,0;;3,0;;15,0;1,0;2,0;1,0;;3,0;;3,0;;;;;;;;;;;;;;;4,0;4,0;;;1,0;;;;;;;;1,0;;5,0;11,0;;;;;;5,0;;2,0;4,0;;;3,0;;;;3,0;;;;;1,0;;;;;;1,0;2,0;;18,0;;3,0;;;;;;;;;;68,0;;1,0;;;;;;;;;2,0;3,0;16,0;9,0;;;;;;;9,0;;;;;;;;;;;;19,0;;;;;6,0;;2,0;5,0;;;;;;;;;;;;21,0;;;;;;5,0;;;;;;;;;2,0;;8,0;7,0;7,0;;;;;;;;;;1,0;;12,0;;;;;2,0;;;;;;;;;;;;2,0;;;;;;;;;;;;;;5,0;;1,0;2,0;;;2,0;;;;;;15,0;;;1,0;;2,0;;;;;;;;;;;;;;;;;1,0;;;;;;;;;;;;3,0;;;;;;;;;;;;;;;;;;;;;;;;;;;;;;;;;;;;;;;;;;;;;;;;;;2,0;;;;;;;;;;;;;;1,0;;;;;;;;;;;;;;;;;;;;;;;;;;;;;;;;;;;;;;;;;;;;;;;;;;;;;;2,0;;;1,0;;;;;;;;;;;14,0;;;;;;;;;;;;;;1,0;;;4,0;;;;;;;2,0;;;;;;;;;;;;;;;;;;;;;;;;;;;;;;;;;;4,0;;;1,0;3,0;;;;;;;;;1,0;;;;;;;;;;;;;;;;;;;;;;;;;;;;;;;4,0;;;;;;;;;;;;;1,0;;;;;;;;;;;1,0;;;;;;;;;;;;;;;;;;;;;;;;;;1,0;;;;;;;;;;;;;;;;;;;;;;;;;;;;;;;;;;;;;;;;;2,0;;;;;;;;;;;;
detector;;;4,0;3,0;91,0;;42,0;32,0;23,0;19,0;10,0;;;7,0;27,0;6,0;4,0;;51,0;5,0;11,0;60,0;2,0;5,0;7,0;;;102,0;4,0;512,0;97,0;45,0;114,0;10,0;89,0;11,0;7,0;47,0;2,0;23,0;18,0;1,0;9,0;208,0;4,0;1,0;;34,0;83,0;25,0;18,0;90,0;1,0;15,0;2,0;376,0;188,0;;3,0;187,0;;;125,0;;3,0;7,0;15,0;3,0;;20,0;58,0;2,0;33,0;;4,0;;;25,0;188,0;15,0;;12,0;43,0;10,0;6,0;4,0;24,0;4,0;;45,0;32,0;6,0;2,0;167,0;1,0;18,0;3,0;12,0;16,0;31,0;67,0;174,0;;3,0;;14,0;2,0;62,0;10,0;1,0;30,0;32,0;366,0;89,0;7,0;3,0;4,0;;6,0;65,0;;;1,0;40,0;;15,0;168,0;26,0;18,0;39,0;11,0;1,0;14,0;;1,0;;51,0;;;19,0;8,0;1,0;12,0;11,0;37,0;1,0;34,0;11,0;44,0;2,0;;;3,0;9,0;8,0;2,0;5,0;71,0;13,0;97,0;20,0;5,0;;5,0;9,0;15,0;65,0;106,0;4,0;7,0;20,0;15,0;76,0;46,0;56,0;10,0;;42,0;;;1,0;3,0;1,0;;1,0;53,0;8,0;148,0;5,0;33,0;;;112,0;67,0;1,0;8,0;8,0;;22,0;7,0;11,0;3,0;1,0;14,0;;33,0;4,0;3,0;19,0;16,0;5,0;8,0;5,0;;21,0;46,0;9,0;1,0;;2,0;4,0;;25,0;7,0;3,0;96,0;2,0;;;2,0;1,0;;12,0;19,0;17,0;22,0;;;38,0;3,0;13,0;1,0;20,0;2,0;2,0;;14,0;4,0;2,0;;2,0;4,0;2,0;25,0;;1,0;;36,0;3,0;1,0;6,0;11,0;18,0;;;;9,0;;;;3,0;13,0;;1,0;9,0;3,0;;;1,0;15,0;;;1,0;21,0;;221,0;24,0;53,0;20,0;12,0;40,0;2,0;1,0;7,0;;9,0;;13,0;17,0;1,0;1,0;1,0;27,0;;5,0;;20,0;30,0;;4,0;18,0;3,0;;;5,0;;1,0;;1,0;19,0;;5,0;;;;49,0;29,0;1,0;11,0;3,0;10,0;4,0;2,0;22,0;;3,0;;6,0;;33,0;4,0;33,0;;12,0;14,0;;;6,0;3,0;29,0;8,0;2,0;5,0;2,0;;;9,0;;;;4,0;1,0;;;7,0;3,0;3,0;2,0;8,0;4,0;3,0;1,0;5,0;23,0;16,0;14,0;47,0;3,0;;5,0;9,0;1,0;;7,0;5,0;5,0;2,0;2,0;;2,0;10,0;11,0;4,0;;30,0;9,0;6,0;8,0;23,0;;19,0;;3,0;2,0;5,0;8,0;6,0;8,0;;19,0;14,0;2,0;1,0;3,0;;14,0;13,0;;27,0;;10,0;1,0;;22,0;9,0;1,0;5,0;5,0;7,0;3,0;;4,0;;;;3,0;1,0;3,0;2,0;10,0;6,0;4,0;53,0;7,0;5,0;62,0;;7,0;3,0;2,0;;2,0;21,0;4,0;;;;;;;;;;3,0;5,0;2,0;4,0;3,0;10,0;;;8,0;;3,0;;2,0;;4,0;2,0;;10,0;;;1,0;;10,0;25,0;4,0;2,0;6,0;22,0;3,0;33,0;3,0;22,0;40,0;;15,0;1,0;;;;2,0;;19,0;18,0;;;1,0;9,0;1,0;;;12,0;12,0;6,0;4,0;1,0;;1,0;;;8,0;;;15,0;8,0;;4,0;1,0;1,0;;9,0;6,0;3,0;;1,0;5,0;;;;1,0;;1,0;13,0;;;;;;;;2,0;;10,0;1,0;19,0;4,0;1,0;3,0;82,0;;;2,0;4,0;;67,0;;;3,0;;4,0;;;;;;2,0;2,0;;;1,0;12,0;2,0;2,0;4,0;;1,0;1,0;;2,0;;;9,0;15,0;13,0;;;3,0;;2,0;4,0;32,0;;2,0;;7,0;;;;;10,0;;;;;4,0;;;;;1,0;8,0;2,0;1,0;5,0;2,0;;4,0;2,0;;;9,0;17,0;6,0;;19,0;;;;;1,0;4,0;14,0;;;3,0;;25,0;;1,0;;1,0;;2,0;13,0;;;11,0;1,0;34,0;;;1,0;3,0;;85,0;;;;;;;3,0;13,0;5,0;2,0;3,0;;4,0;1,0;3,0;9,0;12,0;3,0;;;1,0;16,0;3,0;;5,0;;;2,0;;;13,0;36,0;2,0;1,0;;;1,0;;;3,0;;9,0;43,0;;12,0;;2,0;;;3,0;10,0;1,0;;1,0;;;206,0;;3,0;;;;;;;6,0;1,0;14,0;2,0;;;10,0;;24,0;6,0;;9,0;3,0;;1,0;76,0;;;;;;2,0;;5,0;;2,0;4,0;2,0;;3,0;13,0;7,0;;1,0;;8,0;1,0;;1,0;2,0;;3,0;;51,0;41,0;1,0;2,0;;2,0;1,0;;;2,0;;12,0;1,0;;;1,0;14,0;;3,0;6,0;;;1,0;;2,0;1,0;1,0;;;;;;;3,0;;;;;2,0;;;1,0;;1,0;;;;20,0;1,0;;;7,0;;1,0;3,0;;2,0;12,0;;;;2,0;;8,0;;10,0;;1,0;3,0;17,0;21,0;;;;;;;22,0;;;;2,0;;1,0;;;6,0;4,0;8,0;1,0;2,0;8,0;;2,0;;2,0;;10,0;;1,0;;11,0;;3,0;;;;1,0;11,0;2,0;;;;;1,0;;;;2,0;7,0;;;2,0;;;;1,0;;7,0;;;;;1,0;;7,0;16,0;;;1,0;2,0;4,0;;5,0;;26,0;;;1,0;1,0;1,0;5,0;20,0;15,0;;;1,0;1,0;;;;1,0;;;9,0;;;2,0;60,0;;5,0;;6,0;;1,0;;;;;1,0;;;;;1,0;;;;;;;;;;2,0;;;;;;;;;10,0;;;2,0;;;1,0;2,0;;;;;;1,0;;;;2,0;;;;
determination;;;35,0;;31,0;;4,0;71,0;8,0;30,0;10,0;;;;14,0;;;;3,0;4,0;21,0;65,0;13,0;8,0;14,0;;1,0;31,0;;23,0;15,0;343,0;162,0;6,0;31,0;;4,0;25,0;;37,0;7,0;;;5,0;7,0;;;7,0;36,0;;6,0;26,0;13,0;3,0;;169,0;48,0;;3,0;25,0;;3,0;45,0;;2,0;3,0;12,0;;3,0;64,0;2,0;5,0;;;;4,0;;24,0;95,0;19,0;;6,0;8,0;4,0;2,0;;10,0;1,0;;31,0;17,0;7,0;10,0;39,0;23,0;;;1,0;7,0;;11,0;25,0;;6,0;2,0;;7,0;224,0;;;12,0;;7,0;4,0;4,0;1,0;;;;2,0;;;;14,0;;;54,0;;1,0;;;;;;2,0;1,0;;;;3,0;;1,0;3,0;22,0;;1,0;2,0;36,0;;;;;;;;;;2,0;5,0;10,0;;;;;;;10,0;21,0;3,0;;2,0;;44,0;1,0;15,0;;;58,0;;;;;;;;1,0;;37,0;;31,0;;;;15,0;2,0;;;;8,0;;;;;2,0;;;;;;;;3,0;;;;70,0;4,0;;;;;1,0;;;;4,0;1,0;;1,0;;;;;;19,0;7,0;;;44,0;9,0;;;31,0;;;12,0;2,0;;;;;5,0;;1,0;;;;9,0;;1,0;;2,0;1,0;;;;1,0;;;;;;1,0;;;;1,0;;1,0;1,0;1,0;;;1,0;;17,0;6,0;30,0;11,0;;2,0;;5,0;2,0;;;;15,0;;;;;17,0;;1,0;;;15,0;;;33,0;9,0;;;;;;;;;;6,0;;;;13,0;;;;;3,0;;;;;;;3,0;3,0;2,0;;5,0;;9,0;10,0;;2,0;;;16,0;2,0;3,0;;;1,0;;;;;;6,0;;2,0;;5,0;18,0;4,0;;;;2,0;;3,0;2,0;2,0;7,0;;4,0;;1,0;4,0;4,0;;4,0;;2,0;2,0;7,0;2,0;9,0;1,0;46,0;;;1,0;5,0;13,0;20,0;32,0;;9,0;;4,0;2,0;2,0;;2,0;10,0;2,0;21,0;;4,0;;13,0;;;2,0;6,0;8,0;;17,0;;3,0;2,0;21,0;;7,0;5,0;2,0;9,0;1,0;2,0;;;;;;3,0;;23,0;;;;1,0;;11,0;2,0;;3,0;2,0;;4,0;4,0;15,0;;1,0;1,0;;7,0;;3,0;;;3,0;;3,0;;2,0;6,0;;;43,0;;;;2,0;24,0;;4,0;4,0;;7,0;15,0;16,0;;;27,0;1,0;;24,0;;4,0;6,0;1,0;8,0;2,0;17,0;16,0;;;;;1,0;;;;;;2,0;;;;;5,0;5,0;5,0;;1,0;;5,0;;;2,0;1,0;1,0;24,0;12,0;;;2,0;;;;;;;;;;;;;;;;;;;;;12,0;2,0;;;5,0;;15,0;;;1,0;27,0;4,0;4,0;2,0;;;14,0;2,0;;;2,0;;5,0;;;;;;;;;;15,0;;;2,0;;;1,0;10,0;;;;;1,0;;;;;;;;9,0;;;;4,0;;;;;1,0;;;;;;;;6,0;;;3,0;;;1,0;;;;;;;1,0;14,0;;;;;;;;6,0;;;;;9,0;;;;1,0;;;;;;;;;;13,0;;;1,0;;;12,0;;;;;;;;;;5,0;5,0;;;;1,0;1,0;19,0;;;;;10,0;;;;3,0;;;;;;7,0;1,0;;;;;1,0;1,0;;;;11,0;;1,0;3,0;3,0;;;;;7,0;;3,0;1,0;;;;;1,0;2,0;;;;;2,0;1,0;2,0;;2,0;;;;3,0;;;2,0;4,0;;5,0;2,0;1,0;34,0;;2,0;;;2,0;;2,0;;1,0;2,0;;;1,0;2,0;7,0;4,0;;;;;;;;1,0;;2,0;;;;2,0;4,0;;1,0;3,0;;;4,0;;;;;;;3,0;;;;;1,0;;1,0;2,0;;;4,0;;;1,0;3,0;;;;;3,0;;1,0;5,0;;;;17,0;;;;1,0;;;;;2,0;1,0;2,0;2,0;;;;;;2,0;;;;;;2,0;1,0;;;;;;;2,0;;4,0;;2,0;;1,0;1,0;;;;;;;1,0;;;;;;;;;;3,0;;;;;;;;;;;;;;;;;6,0;;;;1,0;;1,0;;;;;;;;1,0;;;;;;;;1,0;;;;;3,0;3,0;;;;2,0;;;;;3,0;2,0;;;1,0;2,0;;;;;;;;;;;3,0;;;;;;;;;;;;;;;;;;;;;;;;3,0;1,0;;;;;;;3,0;;;;;;;;;;1,0;;5,0;;;;;;;;;
deviation;;;29,0;;4,0;;3,0;9,0;28,0;4,0;;;;;;;4,0;;2,0;3,0;;7,0;1,0;13,0;3,0;;;10,0;;9,0;6,0;10,0;10,0;5,0;;;;;;2,0;6,0;;3,0;1,0;;;;1,0;1,0;;;3,0;;;;33,0;3,0;;;9,0;1,0;;2,0;;4,0;;;;;2,0;16,0;1,0;;;;1,0;;;42,0;;1,0;;;;;;1,0;;;;2,0;;;3,0;;;;;6,0;;1,0;5,0;;;;;;25,0;;;1,0;;;3,0;;;;;;6,0;;1,0;;;;;6,0;;;;;;;;;;;;;;;;;;1,0;;2,0;2,0;;;;;1,0;;;1,0;;;;3,0;;;;;;;;1,0;;;;;;;;1,0;;6,0;;;;;;;;;;3,0;;1,0;;;;;;2,0;;;;;;1,0;;;;2,0;;;;;;;;;;5,0;;;;;;;1,0;;;;;;;;;;;;;26,0;;4,0;2,0;2,0;1,0;;;;;;;;;;;;;;2,0;;;;4,0;;;3,0;;;;;;;;;;;;;;;1,0;;;;;;;;;;;18,0;;;;;1,0;;;;;6,0;;;;;;1,0;;;;3,0;2,0;;4,0;;1,0;;;;;;;;;;;;;;;;;;;7,0;;6,0;;;;;;7,0;;2,0;1,0;7,0;2,0;;2,0;;;6,0;;;1,0;;;;;;;;14,0;1,0;;;;1,0;;;;;;;;1,0;;4,0;;;;;;3,0;;;;;;;;1,0;;3,0;;;;;;7,0;1,0;;;;;;;;4,0;3,0;;;2,0;;;;;;;;;;2,0;;;;1,0;;;;;;;2,0;;;;;;;;;;;;;;;;;;;;;;;;;;1,0;1,0;;;;;;;;6,0;;3,0;;;1,0;;;;1,0;;;;;;;;;4,0;1,0;;;;1,0;;;;;;1,0;;;;;;;;;1,0;;;;;;;;;;;;;;;;;;;;;;;;;;;;;;;;;;;;;1,0;;;;;;;;;3,0;;;;;;;;;;2,0;;;;;;8,0;;;;;;;;;;;;;;;;7,0;;;;;;;;;;;;;;;;;;;;2,0;;;;;;;;;;;;;;;;;;;;2,0;;;;;;;;1,0;;;;21,0;;;;;;;;;;;;;;2,0;;;;;;;;;;;;4,0;;;;;;5,0;;;;;;;;4,0;;;;;;;;3,0;;;;;;;;;;;;;;;4,0;;;;;;;;;;;;1,0;;1,0;;;;;;1,0;;;;;;;;;1,0;;;;;;1,0;1,0;1,0;;;;;;;;;;;;1,0;1,0;1,0;;;;;;;2,0;;;;;;;;;2,0;;;;;;;;2,0;4,0;;;;;;;;;1,0;;;;;;1,0;;;;;;;;;;;;;;;;;;;;;;;;;;;;;;2,0;;;;;;;;;;;;;;;;;;;;;;;;;;;;;;;;;;;;2,0;1,0;;;;;;;;;;;;;;;;;;;;;;;;1,0;;;;;;;;;;;;;;;;;;;;;;;;;;;;;;;5,0;;;2,0;;;;;;;;;2,0;;;;;;;;;;;;;;;;;;;;;;;;;;;;;;;;;;;;;;;;;;2,0;;;;;;1,0;5,0;;;;;;;;;;;;;;;;;;1,0;;;;1,0;;;;;;
diameter;;;1,0;;6,0;;7,0;6,0;;;12,0;;6,0;;1,0;1,0;;1,0;;;1,0;;;;;;;1,0;;3,0;;1,0;6,0;;3,0;;;12,0;;;4,0;;1,0;12,0;;;;5,0;;2,0;;;;3,0;;15,0;11,0;;19,0;153,0;;;5,0;;;;;;;1,0;12,0;;1,0;1,0;;;;7,0;9,0;1,0;;1,0;;;;;6,0;;13,0;1,0;15,0;;2,0;;11,0;;;;;8,0;104,0;13,0;;;;;;6,0;;;1,0;3,0;1,0;4,0;1,0;1,0;;;1,0;12,0;;;;3,0;;;4,0;4,0;;2,0;6,0;;;13,0;5,0;1,0;;;;;;;4,0;;;;14,0;2,0;;;;3,0;2,0;;8,0;;37,0;10,0;1,0;7,0;3,0;5,0;70,0;10,0;;;;13,0;;;22,0;;28,0;20,0;;14,0;54,0;;;;;1,0;12,0;;2,0;6,0;11,0;9,0;;98,0;;;;8,0;2,0;;7,0;2,0;1,0;;1,0;4,0;;6,0;7,0;;2,0;1,0;7,0;6,0;;2,0;;;;2,0;2,0;;;5,0;13,0;;;;18,0;2,0;7,0;;;1,0;;3,0;;4,0;1,0;;3,0;;9,0;;30,0;4,0;3,0;18,0;;;;;16,0;12,0;;;;5,0;;;35,0;12,0;;;;;2,0;5,0;4,0;;3,0;;;;1,0;5,0;;1,0;1,0;;;;;2,0;;;;2,0;;;1,0;;3,0;;;;;1,0;;3,0;;;;;3,0;2,0;11,0;5,0;;1,0;;7,0;6,0;12,0;6,0;1,0;1,0;4,0;25,0;;1,0;;12,0;;2,0;1,0;;;;;3,0;5,0;;;;1,0;;;;;;;;;2,0;;;1,0;;;;;;;2,0;;;5,0;;2,0;;;2,0;;;;;;;;;;;;;;;;;2,0;;;1,0;7,0;;;;;;;;;;;;;;;;;;;;;;;;;;;1,0;7,0;;;3,0;;3,0;;;;;;1,0;1,0;1,0;;;;1,0;;;;;1,0;;;;;;3,0;;;;;2,0;;;;;;;;;;;;3,0;;;;;;;;;;;5,0;;;2,0;;;;;;;;;;;;;;;;;;;11,0;;;;;;;;;;1,0;;2,0;;;;;;;32,0;1,0;;2,0;;;14,0;;;;;;1,0;;;;;2,0;;;;;;;;;;;;;;;;;;;;;;;;;;;;;2,0;;;;;1,0;;;;;2,0;;;;;;;;1,0;;;;;;4,0;;2,0;;;;;;;;;1,0;2,0;;;;;;;;;;;;;3,0;2,0;;;;;;1,0;;;;;1,0;;;;;;;;;;;;;;1,0;1,0;;;;;4,0;5,0;2,0;5,0;1,0;9,0;;;;;1,0;3,0;2,0;53,0;;8,0;1,0;1,0;;;1,0;;;3,0;;4,0;;;6,0;;;;53,0;;2,0;;2,0;;;;;;;;;1,0;1,0;;;;;;;;;;2,0;;;;;2,0;3,0;;;1,0;;1,0;;;;;;;;;;;;;;;;1,0;;;;;;2,0;;;;;;;;;;;;;;;;;;;;;2,0;;;;;;;4,0;;2,0;;;;;;;;10,0;;;;;;1,0;;1,0;;;;1,0;;;;;1,0;;;;;;;;;;;;;;;;;;;2,0;;;;;;;;;;;;;;7,0;;;;;2,0;;;;;;;2,0;;;;;;;;;;;;;;;;;;;;;;2,0;;;;;;;;;;;;;;;;;19,0;1,0;;;8,0;;;;;;;;1,0;1,0;;;;2,0;;;;;;;;;;;2,0;;;;1,0;;;;;;;;18,0;;3,0;;;;;;;;;;;;;;;1,0;;;;;;;;;;1,0;;;2,0;;;;;;;1,0;;;;;;;;;;;;;;;;1,0;;;;;;;;;;;;;;;;;;;;;;;;;;;;;;;2,0;;1,0;3,0;;;;;;;5,0;;1,0;;;;
diaphragm;;;18,0;;11,0;;9,0;7,0;1,0;2,0;;;;;;;;2,0;;;;66,0;;2,0;3,0;;;3,0;;11,0;9,0;5,0;51,0;;9,0;;;11,0;;9,0;;;36,0;2,0;;;;9,0;1,0;;2,0;;;12,0;;37,0;37,0;;1,0;128,0;;;9,0;9,0;;25,0;4,0;6,0;;21,0;24,0;6,0;3,0;;;14,0;;12,0;48,0;4,0;;4,0;;;;8,0;;4,0;1,0;5,0;6,0;;1,0;12,0;13,0;;;;;;7,0;29,0;;;;;;51,0;;;3,0;22,0;;12,0;6,0;2,0;;;;12,0;;;6,0;1,0;;;15,0;;;;4,0;;;;;;12,0;;;;;;;1,0;2,0;2,0;7,0;;;;;;;;;;;2,0;3,0;2,0;7,0;6,0;1,0;;;;;31,0;;;29,0;26,0;9,0;6,0;1,0;9,0;;4,0;;;;;4,0;;;;11,0;2,0;;13,0;;;;9,0;;;;;16,0;5,0;;1,0;1,0;20,0;;1,0;;;;2,0;;;;;;42,0;6,0;;;1,0;;;;;;;;;;;;;;1,0;22,0;;4,0;4,0;1,0;;4,0;;4,0;;;1,0;;;;9,0;;;;3,0;;;;2,0;;18,0;3,0;68,0;4,0;;3,0;;2,0;;;;;;;;;;;;;3,0;;;;62,0;;;6,0;25,0;9,0;;;;;;;;;3,0;;;;;14,0;;;;;15,0;;1,0;;;2,0;3,0;20,0;;1,0;1,0;1,0;;;;1,0;6,0;;;;2,0;;;1,0;7,0;;;;;;;;;;;;;;;;1,0;;5,0;1,0;;;1,0;;;5,0;;;;;;;;;;;;;;;;;;;;;;;;3,0;8,0;;;;8,0;;1,0;;5,0;;;1,0;;30,0;6,0;5,0;;;;;;1,0;;;;4,0;2,0;;;;;;;;;;;2,0;;;;;;11,0;;;;1,0;;;;;;;;;;;;;;;;1,0;15,0;;4,0;;;;1,0;1,0;1,0;;;;;;;;;;23,0;;;12,0;7,0;;;;11,0;;;;;;;;;;;;;;24,0;;1,0;;5,0;;;;;;;;;;;;;;;142,0;;;;;;;;;;1,0;;;;;;1,0;;;;;;;;;7,0;;;;;;4,0;;;;;;;;2,0;;;;;;;;;;;;;;;;;;;;;;;;;2,0;;;;;;;;;;;;;;3,0;;3,0;;;;;;;;;;;;;;2,0;;;1,0;7,0;;;;9,0;;;;;;;;;;;;;8,0;;;;1,0;;;;;;;;;15,0;1,0;;;6,0;;;;;;;;;;;1,0;;;;;;;;;;;;;;;;;5,0;2,0;;;;;;;;1,0;;;;;;;;;;1,0;;;;2,0;;;;3,0;1,0;;;;;;;;;;;;;;;;;;;;;;;;;;;;;;;2,0;;;;;;;5,0;;;;;;;;;;;12,0;;;;;;;1,0;;;;;;;;;;;;;;;;;;;;;;1,0;;1,0;;;;;;;;;;;;3,0;;;;;;;;;;;;;;;;;;;;;;;;;;;;;;;;;14,0;;;;;;;;;;;1,0;;;;;;;;;;;;;;;;;;;;;;;;;;;;;;;;;;;3,0;;;;;;;;;;;;;;;;;;;;2,0;4,0;;;;;;;;;;;;;;;;;;;;;;;;;;;1,0;;;;1,0;1,0;;;4,0;;;;;;;;;;;;;;;;;;;;;;;;;;;;;;;;;;;;;;;;;;;;;;;;;;;;;;;;;;;1,0;;;;;;;;;;;;;;;;;;;;;
dimension;;;9,0;;24,0;;10,0;22,0;9,0;4,0;16,0;;;;16,0;;;;1,0;;1,0;3,0;;2,0;;;;7,0;2,0;4,0;;11,0;10,0;2,0;13,0;1,0;1,0;49,0;;14,0;12,0;;1,0;12,0;;;;5,0;;;2,0;6,0;;3,0;7,0;102,0;12,0;;30,0;15,0;;1,0;42,0;4,0;1,0;;8,0;4,0;;2,0;9,0;;;;18,0;;;;11,0;2,0;;6,0;4,0;16,0;;;13,0;1,0;4,0;13,0;3,0;;;2,0;;7,0;;1,0;;9,0;24,0;12,0;;;;;;6,0;;;8,0;3,0;1,0;5,0;;;;;1,0;1,0;;;;;16,0;;6,0;;;;4,0;;;;;25,0;13,0;;;1,0;;;;;2,0;;4,0;17,0;1,0;;;34,0;5,0;;;;;13,0;;3,0;;1,0;9,0;;;;;6,0;;1,0;10,0;;3,0;3,0;5,0;2,0;15,0;;;;;2,0;;;;2,0;22,0;2,0;;32,0;1,0;;2,0;23,0;6,0;2,0;;;;;;20,0;2,0;2,0;;;2,0;1,0;;5,0;;;;;;1,0;;;;;9,0;4,0;;;1,0;;11,0;;1,0;;1,0;;1,0;;;;;11,0;6,0;;2,0;;;1,0;;1,0;;;1,0;;;;;1,0;;;8,0;10,0;9,0;1,0;1,0;;1,0;;2,0;;3,0;;3,0;;;5,0;1,0;;4,0;1,0;;;4,0;;;;;2,0;;;9,0;34,0;;;;;1,0;7,0;;1,0;;;;;;;7,0;;1,0;;;24,0;;4,0;13,0;41,0;;;20,0;;;;;;;;;;;1,0;4,0;;;;2,0;1,0;;;;;;;;;;7,0;;;1,0;2,0;;2,0;;2,0;1,0;;;;;;3,0;2,0;;;5,0;;;;2,0;;;;;;;1,0;2,0;16,0;1,0;2,0;22,0;;;1,0;;;2,0;;;;;;;;;;;;;;;10,0;;;4,0;;;;;1,0;;;;;2,0;1,0;;;;;4,0;;4,0;3,0;11,0;;;;;2,0;;;;;4,0;6,0;;;;1,0;;;;;;1,0;;;;;;1,0;;;;;12,0;;;3,0;;;;;;;;8,0;;;;;;;;1,0;;;;;1,0;;;;;8,0;;;1,0;;1,0;;;4,0;;;;;2,0;;;;2,0;;;;;;2,0;4,0;;28,0;;;6,0;;;2,0;;;1,0;;;;;;;;;;;;;;;;;;;;;;4,0;;;;;;4,0;;;;;;3,0;;;;;2,0;1,0;;1,0;3,0;9,0;;2,0;;;;3,0;;;;;;;;;;;;;;3,0;;6,0;5,0;;;;;;;;;;;;;;1,0;1,0;;;6,0;;;;;;1,0;;;;;;;;;;;;;;;;;;1,0;;;2,0;;;2,0;;;;;7,0;;;;;;;;;;;;;;3,0;;;;;;;;;;1,0;2,0;;;;2,0;;;;;;;;1,0;12,0;;;;;;;;2,0;6,0;12,0;;;1,0;;;;;;;;;10,0;14,0;;;;;;2,0;1,0;;;;;4,0;;;;1,0;;;;;;;;;;;;;;;;;;;;;;;;;;;;;;;1,0;;;11,0;;;;;;2,0;;;;;10,0;2,0;;;;;;1,0;;;;;;;;;;6,0;;;;;;;;;;;;;2,0;;;;;;;;;;;2,0;;;;;;;;;1,0;;;;;1,0;;;;;;;2,0;;;;;;;;;;;;25,0;;;1,0;;;2,0;;;;4,0;;;;;;;;;;;;3,0;;;;;;;;2,0;;;;;;;3,0;;;;;3,0;;2,0;;1,0;;;;;;;;;;;;;;;;;;;;;;;2,0;;;;;;;;;;;;;;;3,0;1,0;;;;4,0;;;;1,0;;;;;;;;;1,0;;;2,0;;4,0;;;;2,0;;;;;;;;;;;;;;;;;;;;;;;;;2,0;;2,0;;;;;;;;;;;;;;;;;;;;;;;;;;;;;
diode;;;18,0;;9,0;;;5,0;1,0;1,0;;5,0;3,0;;19,0;3,0;;;9,0;;;18,0;;;3,0;;;3,0;;2,0;1,0;5,0;49,0;;;;;1,0;1,0;4,0;;;4,0;7,0;;;;;;3,0;6,0;10,0;;8,0;;2,0;21,0;;1,0;6,0;;;10,0;;1,0;;;1,0;;;5,0;;3,0;;;;;2,0;10,0;12,0;;3,0;;5,0;2,0;;;;;5,0;6,0;2,0;;14,0;;4,0;;5,0;1,0;3,0;2,0;18,0;;;;;;16,0;;;;8,0;10,0;8,0;;;;;1,0;7,0;;;;6,0;;;1,0;;1,0;2,0;;;2,0;;;2,0;13,0;;1,0;299,0;3,0;;;;3,0;;6,0;;;2,0;;;4,0;1,0;;;1,0;;5,0;1,0;;1,0;;2,0;;;1,0;395,0;;;;;7,0;10,0;;;;4,0;;;;;2,0;;;1,0;3,0;59,0;;6,0;;;;4,0;;7,0;;;;2,0;;2,0;;7,0;;;;;2,0;7,0;;;3,0;;2,0;18,0;;;;;1,0;1,0;;;1,0;;;;;;;;;3,0;5,0;10,0;;6,0;;;;;;;;;;1,0;;3,0;;;;8,0;;;;1,0;2,0;;;1,0;;;;;;;2,0;;;4,0;;;;;;;;;;;;;1,0;1,0;;;;2,0;;;;;;;;;;;1,0;;;1,0;;;;;;;1,0;9,0;;;;;;;;;;;;;;15,0;;;9,0;;;;;;;;;2,0;;;;;1,0;;;;;;;1,0;;;;;;;;;;;;;;2,0;;;;;1,0;1,0;;;;4,0;;;2,0;;;1,0;;;;1,0;6,0;;1,0;12,0;;;;;;;1,0;;9,0;2,0;;5,0;4,0;;1,0;;;;;;;1,0;;;8,0;;;;;;;17,0;1,0;;;;;;1,0;;;;;;;;;;;;;;;;;;;1,0;;;;;;;;49,0;;;;;;;;;;5,0;;;;;;;;1,0;;;;;3,0;;;;;;;;;;;;;1,0;;4,0;10,0;1,0;;;4,0;2,0;;;;;;;2,0;;;;2,0;1,0;1,0;;;;;;;;;;;;;;;62,0;;1,0;;;;;;;;;;;;;;;;;1,0;5,0;;;;;1,0;;;4,0;1,0;;;;;;;;;;1,0;;;;;;;;;;;;;;;;;;4,0;;;1,0;;;;;2,0;;;;;2,0;1,0;;4,0;;;3,0;;;;;;;;;;;;;;;;;;;;;;;;;;;;;;;1,0;;2,0;;;;;;;;;;;;;;;;;;;;;;;;;;;;;;;;;;;;1,0;;;;;;;;;;2,0;;1,0;;;;;;;1,0;;6,0;;;;;;;;;;;;;;;4,0;;;;;;;;;;10,0;;;;;;;;;;;;;;;3,0;;1,0;;;;;;;2,0;;;;;;;;;;;;;1,0;;;;;3,0;1,0;1,0;3,0;;;;;;;;;;;;;;;;;;;;;;;2,0;;;;;;;;;;;;;3,0;;;;;;;;;;;;;;;;;;;2,0;;5,0;;;;;;;1,0;;;8,0;6,0;;;;;;;;;;;;;;2,0;;;;;;;;;;;;;;;1,0;;1,0;;;;;;;;;;;;;;;;;;;;;;;;;;;;;;;;;;;;;;;;;;;;;;;;;;;;;;;;;;;;;1,0;1,0;;3,0;1,0;;3,0;;;1,0;;;;;;;1,0;;;;;;;;;;;;;;;;;;;;;;;;1,0;;;;;;;;;;;;;;;;;;;;;;;;;;;;;;;;;;;;;;
discharge;;;1,0;;8,0;;;;;1,0;;11,0;;;;;;;;;;12,0;;;;;4,0;;;;;;3,0;;2,0;;;1,0;;;;;;3,0;;;;;;;4,0;7,0;;;;8,0;6,0;;;;;;1,0;;;;;;;39,0;;;;;;;;;;3,0;1,0;;;;;;;;4,0;;4,0;;;4,0;;;;15,0;24,0;2,0;2,0;2,0;;5,0;;2,0;;13,0;;;16,0;5,0;;;;;;;1,0;;;1,0;;42,0;;1,0;2,0;;;;;;;;;;1,0;;9,0;33,0;26,0;;;;;;;;;;;;;;5,0;;1,0;;5,0;1,0;;;;;;;8,0;45,0;;;;;;3,0;;;;2,0;;;;;;;;;;;;11,0;;;;;;;;;;;;;;1,0;;;;;2,0;1,0;;;;;;4,0;;;;30,0;;;;;;;;;;;;;;;;;;1,0;;;;;;;;;;;;;;;;5,0;;;;1,0;;;;1,0;;;;;;;;;;;;;;;;;;1,0;;;;;;;;;;;;;;;;;1,0;1,0;;;;;;;;;;;;;;;;;;;;;;;;;;1,0;;;;;1,0;;;4,0;;;;10,0;;;;;;;;4,0;;;;;;;;;;;;;;;;;;;;4,0;;3,0;;;;;;;;;;;;;;;1,0;;;;;;;;;;;1,0;;;;;1,0;;;;;;;;;;;;;;;;1,0;;;;;;;;;;;3,0;;;;;;;;;;;;;;;;6,0;;;;;;;;;;;;6,0;;5,0;;;;;1,0;;;;;;;;;;;;;;;;;;;;;;;;;;;;;;;;;10,0;1,0;3,0;;;;20,0;;;;;;;;;;;;;;;;;;;;;;;;;;;;7,0;;;;;1,0;;;;;;;;;;;;2,0;;;9,0;;;;;;;;;;;;;;;19,0;;;;;;;;;;;;;;;;;;;;;;;;;;;;;;;;;;;65,0;;;;;;;2,0;;;;;;;;;;;;;;;;;;1,0;;;;;;;;;;;;;;;;;;;;;9,0;;;;;;;;;;;;;;;;;;;2,0;;;;;;;;;;2,0;;;;;;;;;;;;;;;17,0;;;;;;16,0;;;;;;1,0;;;;;1,0;;;;;;;;;8,0;;;;;2,0;;;;;;;;;;;;;;;;;1,0;;;;;;;;;;;;;;;;;;;;;;;;;;;;;;;;;;;;;;;;;;;;;;;;;;;;;;;;;;;;;;;;1,0;;;;;;;;;;;;;;;;;;;;;;;;;;;;;;;6,0;;;;;;;;;;;;1,0;;;;;;6,0;;;;;;;;;;;;;;;;;;;;;;;;;;;;;;;;;;;;;;;;;;;;;;;;;;;;;;;1,0;;;;;;;;;;;;;;1,0;;;;;;;;;;2,0;;;;;;;;;;;;;;;;;;;;;;;;;;;;;;;;;;;;;;;;;;;;;;;;;;;;;;;;;;;;;;;;;;;;;;;;;;
disparity;;;1,0;;1,0;;;5,0;16,0;;;;;;;1,0;;;6,0;;;;1,0;;;;;;;;;15,0;1,0;19,0;;;1,0;3,0;;;12,0;;;;;;;;;;;2,0;;;;29,0;3,0;;;;;;16,0;;;;;;;;;;;;;;;11,0;;;1,0;;;;;;;;;2,0;;;;;;;;;;;;2,0;;;;;;9,0;;;;1,0;;;;;;;;;;;;;;;;;;;;;;;;;;;;;;;;;;;;69,0;;;;;;;;;;;;;;;;;;;;;;;;;;;1,0;;;;;;;;;;;;;9,0;;8,0;;;;;;;;;;;;;;;;;;;1,0;;;;;;;;;;;;;;;;;;;;;;;;;;;;;;1,0;;;;12,0;;;;;;;;;;;;;;;1,0;;;;;;;;;;;;;;;;;;;;;;;;;;;;;;2,0;;;;;2,0;;;;;;;;;;8,0;;;;;;;;3,0;16,0;;;;;;;;;;;;;;;;;;8,0;;;;;;;;;;;;4,0;;4,0;;;;;;;;;;;;;;1,0;;;16,0;;;;;1,0;;;;;;;;;;;;;;;;;;1,0;;;;;;;;;;;;;;;;;;;;;66,0;;;;;;;;;1,0;;;2,0;;;;;;;;3,0;;;;;;;1,0;;;;;;;;;;;;;;1,0;;1,0;;;;2,0;5,0;;;;;;;;;;;;;;;;8,0;;;1,0;;;;;;;;;;;;;;;;;;;;;;;;7,0;;;;;;;;;;;;;;;;;;;;;;;;;;;;;;;;;;;;8,0;;;;;;;;;;;;;;;;;;;;;;;;;;;;6,0;8,0;;;;;;;;;;;;;;;;;;;;;1,0;;;;;;;;2,0;;;;;;;;;;;;;;;;;;;;;;;;;;;;;;;4,0;;;2,0;1,0;;;;;;;;;;;;;;;;;;;;;2,0;;;;;;;;;;;;;;;;;;;;;;;;;;;;;;;;;;;;;2,0;;;;;;;;;;;;;;;;;;;;;;;;;;;;;;;;;;;;;;;;;;;;;;;;;;;;;;;;;;;;;;;;;;;;;;;;;;;;;;;;;;;;;;;;;;;;;;;;;;;;;;;;;;;;;;;;;;;;;;;;;;;;;;;;;;47,0;;;;;;;;;;;;;;;;;;;;;;;;;;;;;;;;;;;;;;;;;;;;;;;;;;;;;;;;1,0;;;;;;;;;;;;;;;;;;;;;;;;;;;;;;;;3,0;;;;;;;;;;;;;;;;;;;;;;;;;;;;;;;;;;;;;;;;;16,0;1,0;;;;;;;;;;;;;;;;;;;;;;;;;;;;;;;;;;;;;;4,0;;;;;;;;;;;;;;;;;;;
distribution;;;7,0;2,0;18,0;;1,0;49,0;24,0;7,0;5,0;28,0;;;38,0;1,0;4,0;;;2,0;2,0;8,0;12,0;;9,0;7,0;13,0;35,0;3,0;80,0;7,0;35,0;41,0;7,0;9,0;;2,0;6,0;;8,0;29,0;;;10,0;;;2,0;2,0;;16,0;7,0;31,0;3,0;3,0;1,0;151,0;20,0;2,0;2,0;3,0;;;47,0;;14,0;;6,0;;;3,0;2,0;1,0;;;;;;5,0;20,0;22,0;;12,0;3,0;;8,0;;43,0;;8,0;22,0;3,0;;1,0;29,0;;5,0;3,0;16,0;9,0;;13,0;32,0;;9,0;;;;50,0;2,0;;;13,0;4,0;2,0;1,0;;;;;;;;4,0;9,0;;;10,0;;30,0;1,0;2,0;1,0;3,0;;2,0;8,0;;;;6,0;;;;;9,0;;7,0;6,0;3,0;;;;;;;;;;33,0;22,0;2,0;;;;;3,0;31,0;75,0;6,0;;7,0;;9,0;2,0;5,0;;;13,0;;;;;4,0;1,0;;;;32,0;;53,0;;;2,0;27,0;4,0;2,0;;1,0;1,0;;;;1,0;;;3,0;;2,0;1,0;;3,0;;1,0;;;4,0;;;;;;;;;;;;;;;;;;2,0;4,0;4,0;;3,0;26,0;;;;2,0;;;2,0;11,0;;;;;;;2,0;;;;8,0;;;;2,0;;;1,0;;2,0;;;;;;;;9,0;;;;;;;4,0;;;15,0;4,0;1,0;27,0;;;1,0;;2,0;16,0;;;;6,0;;;;;6,0;;9,0;;;8,0;;;1,0;12,0;;;;;;;;;;5,0;;;;11,0;;;6,0;;1,0;2,0;;;;4,0;;;;2,0;;3,0;;3,0;;;4,0;1,0;;17,0;2,0;;;1,0;;;;;;;16,0;;;;18,0;8,0;;3,0;2,0;;4,0;;;11,0;1,0;2,0;2,0;;;11,0;;1,0;2,0;5,0;2,0;3,0;1,0;10,0;1,0;2,0;;16,0;;;;1,0;2,0;;7,0;2,0;1,0;;1,0;;3,0;;;;;;;;;4,0;;11,0;14,0;;8,0;;11,0;;;1,0;2,0;2,0;;13,0;1,0;33,0;;26,0;;;;;6,0;;;;;;;2,0;;2,0;;1,0;2,0;;;1,0;;;;;4,0;;2,0;;;21,0;1,0;8,0;;8,0;;;47,0;;;9,0;;;3,0;;;;1,0;2,0;11,0;1,0;4,0;;;1,0;;1,0;;2,0;;;7,0;;18,0;;;4,0;;;3,0;7,0;2,0;10,0;4,0;;;1,0;;;;;;6,0;7,0;2,0;1,0;6,0;;4,0;;;;;;4,0;1,0;;;1,0;;1,0;;;;6,0;;;1,0;;;10,0;;;;;;;;;1,0;2,0;;5,0;11,0;;4,0;;;5,0;23,0;;1,0;;;;1,0;;;;;2,0;6,0;;;12,0;;;;;;;27,0;;;1,0;;;;2,0;;;;;;2,0;;;2,0;;;;3,0;;;;;;;;;11,0;;;;;;;;;2,0;;;1,0;1,0;;;;;;;;;2,0;;;3,0;;;;;;;3,0;2,0;;4,0;;;;8,0;;;;;;;;;;3,0;;;1,0;;;;;;;;;;;5,0;;4,0;27,0;2,0;;;;21,0;30,0;1,0;;;;;;;;;;7,0;;;4,0;1,0;;5,0;;;;;;;1,0;1,0;12,0;;;;1,0;;2,0;;;4,0;;3,0;;;;;1,0;;1,0;;;;;3,0;;21,0;6,0;;9,0;1,0;;10,0;;;6,0;;2,0;4,0;6,0;;;;;;;;1,0;;;1,0;7,0;;6,0;;1,0;;;;2,0;;;2,0;;;;;;29,0;;;;;;;4,0;;;1,0;;;;;7,0;;;1,0;;;;;;;;;4,0;;5,0;;2,0;2,0;;;;;1,0;;;;1,0;;;;;;;;;;1,0;6,0;2,0;;3,0;1,0;;;;;;;;;;2,0;;;1,0;;;;;;;2,0;8,0;43,0;;1,0;;5,0;;1,0;;;;;7,0;;;;;;;1,0;;2,0;;;;;;;;;;;;;;;;;;;;;;;1,0;9,0;;;;;;;;;;1,0;;;;;;;;;;;;2,0;;;;;;;53,0;;;;;;;;;;;;;;;2,0;;;;;3,0;1,0;;;;;;;;;;;1,0;;;;;;;;15,0;;;;;;2,0;;;;4,0;4,0;;2,0;;;;1,0;;;;;;;;;;;;;;;
divide;;;4,0;;15,0;;11,0;15,0;2,0;18,0;1,0;;;;12,0;5,0;;;9,0;2,0;;12,0;4,0;3,0;2,0;;2,0;64,0;9,0;14,0;10,0;6,0;58,0;11,0;17,0;5,0;1,0;4,0;;39,0;22,0;;;7,0;2,0;1,0;1,0;8,0;12,0;2,0;2,0;12,0;;13,0;;234,0;11,0;;2,0;41,0;4,0;5,0;29,0;;;;7,0;;;6,0;12,0;4,0;3,0;4,0;;35,0;;12,0;14,0;2,0;;25,0;8,0;4,0;1,0;;92,0;2,0;2,0;5,0;9,0;5,0;2,0;53,0;2,0;14,0;2,0;3,0;2,0;4,0;28,0;21,0;;;1,0;;1,0;65,0;;;;6,0;8,0;3,0;;1,0;1,0;;4,0;8,0;;;;6,0;;1,0;8,0;2,0;4,0;1,0;2,0;3,0;;;;6,0;2,0;;10,0;1,0;2,0;2,0;;9,0;7,0;;8,0;48,0;;;;;;;1,0;;;4,0;3,0;14,0;16,0;;;9,0;;18,0;8,0;37,0;;;1,0;3,0;5,0;;;;;12,0;;9,0;;;10,0;;;4,0;;124,0;;38,0;;;1,0;9,0;2,0;1,0;;;2,0;;;1,0;;8,0;;;;;2,0;;5,0;;;;;29,0;4,0;;;1,0;5,0;;2,0;1,0;3,0;2,0;4,0;;3,0;1,0;;;6,0;7,0;;41,0;;4,0;89,0;;2,0;;50,0;;;2,0;5,0;1,0;4,0;;5,0;6,0;1,0;;1,0;2,0;1,0;6,0;4,0;;;1,0;;;;;;;;;2,0;1,0;;;;;1,0;;;1,0;;;1,0;2,0;;6,0;2,0;14,0;;;;;;3,0;;;4,0;13,0;;;;;28,0;;;;;28,0;;;9,0;5,0;;;;;;;;;;;2,0;;;6,0;;;3,0;;2,0;;;;;1,0;2,0;1,0;;;;1,0;1,0;6,0;;4,0;;;;5,0;5,0;;4,0;;;;13,0;;;;;;;;;;;;6,0;1,0;2,0;;2,0;10,0;8,0;5,0;8,0;;;2,0;49,0;1,0;5,0;4,0;3,0;;;5,0;;8,0;;3,0;;;1,0;;6,0;2,0;;;;;1,0;3,0;6,0;;;7,0;;;;5,0;2,0;;;1,0;2,0;;25,0;;;;;4,0;;;1,0;2,0;4,0;1,0;6,0;;;;;;;;;;;;;;;5,0;2,0;2,0;2,0;;;;47,0;;;1,0;;;7,0;;;1,0;;;;9,0;3,0;;10,0;;;22,0;;;;;;;;;1,0;1,0;;;;;14,0;;;2,0;;2,0;2,0;;16,0;28,0;;4,0;;;;;1,0;;16,0;;;;;;;;;1,0;;;;;;;;;;;;3,0;2,0;;;8,0;1,0;;;;4,0;4,0;;;;;;6,0;;;;;;;;;1,0;;;;;;1,0;;;8,0;37,0;2,0;;;;1,0;;;;;;;;;;;;;;;;9,0;13,0;1,0;;;;;1,0;;;;;;2,0;1,0;;;;;;;34,0;;;;;;;;;7,0;;;;;;;;;;;;7,0;1,0;;;;;;;;1,0;;;1,0;21,0;;;;;;;;;1,0;3,0;;1,0;1,0;3,0;4,0;;;4,0;;;;2,0;;;;;1,0;;;;;;;;;;;4,0;;5,0;2,0;;;4,0;;4,0;13,0;1,0;20,0;;;8,0;1,0;;1,0;;;2,0;1,0;;5,0;;;4,0;;;;6,0;;;;;3,0;;3,0;1,0;7,0;;;;;;;;;;;1,0;;;;;;3,0;5,0;1,0;;;;;;;;4,0;;4,0;8,0;;3,0;;6,0;;;4,0;;2,0;;;4,0;;7,0;6,0;;2,0;;;;;;;2,0;;;;;;;;;14,0;;;;;;9,0;1,0;;;5,0;;;;;;;;;;;;1,0;;;;;;;;;;13,0;;;4,0;;;;;;;;;6,0;;;;;;;;1,0;;;3,0;;;;;2,0;;;;;;4,0;;;6,0;1,0;;;;;;1,0;1,0;2,0;;;;;1,0;;;2,0;1,0;2,0;;;;1,0;;;;2,0;;;2,0;;;1,0;;;;;;;;;;;;;;;1,0;;;;;;3,0;;;;;;;;2,0;;;;;;;;1,0;1,0;;;;3,0;13,0;1,0;;;1,0;;;;;;;;;;;;;;;;;;2,0;;2,0;;9,0;;;;;;;1,0;;2,0;;;;;;;;;;;;;;;1,0;;;;;;;;;2,0;;;;;;4,0;;;;;;;;;;;;;
driving;;;28,0;;234,0;;78,0;109,0;18,0;29,0;31,0;2,0;2,0;;2,0;2,0;;5,0;11,0;1,0;6,0;497,0;3,0;12,0;36,0;;;9,0;3,0;33,0;37,0;23,0;555,0;23,0;32,0;;5,0;194,0;12,0;29,0;23,0;;446,0;210,0;;6,0;;6,0;196,0;76,0;18,0;132,0;2,0;47,0;2,0;228,0;135,0;;8,0;757,0;7,0;3,0;280,0;9,0;;403,0;71,0;3,0;;25,0;126,0;5,0;11,0;1,0;2,0;7,0;26,0;8,0;152,0;67,0;4,0;19,0;6,0;47,0;;4,0;21,0;2,0;;20,0;70,0;20,0;6,0;237,0;2,0;8,0;;11,0;13,0;;50,0;102,0;;59,0;1,0;;4,0;670,0;2,0;;10,0;44,0;5,0;35,0;18,0;;23,0;;9,0;53,0;;12,0;13,0;116,0;;;180,0;19,0;5,0;28,0;5,0;;5,0;16,0;1,0;11,0;52,0;;50,0;;;3,0;2,0;34,0;16,0;256,0;31,0;216,0;;;;7,0;14,0;;40,0;38,0;2,0;13,0;1,0;200,0;;;3,0;8,0;;27,0;6,0;9,0;9,0;1,0;356,0;43,0;61,0;68,0;67,0;9,0;10,0;35,0;;;2,0;;10,0;1,0;12,0;18,0;23,0;41,0;;154,0;;7,0;1,0;72,0;;18,0;;1,0;69,0;1,0;3,0;22,0;2,0;70,0;;5,0;54,0;2,0;2,0;37,0;6,0;9,0;;;29,0;162,0;69,0;;7,0;1,0;;11,0;77,0;;10,0;;;;6,0;3,0;1,0;3,0;94,0;10,0;23,0;14,0;8,0;161,0;11,0;3,0;72,0;2,0;;2,0;;6,0;;13,0;2,0;100,0;30,0;;;43,0;5,0;1,0;;3,0;3,0;;1,0;;3,0;8,0;27,0;5,0;14,0;;;1,0;8,0;3,0;;2,0;7,0;1,0;;18,0;2,0;11,0;;78,0;2,0;173,0;;16,0;130,0;15,0;22,0;16,0;23,0;2,0;5,0;1,0;21,0;6,0;2,0;38,0;;15,0;2,0;1,0;35,0;8,0;2,0;3,0;5,0;54,0;14,0;8,0;6,0;18,0;10,0;5,0;17,0;10,0;2,0;10,0;30,0;;38,0;4,0;64,0;22,0;;46,0;;7,0;51,0;12,0;8,0;6,0;3,0;20,0;;;2,0;;5,0;2,0;;6,0;5,0;22,0;8,0;2,0;;8,0;;32,0;10,0;6,0;2,0;2,0;;;;3,0;;;2,0;;;;;2,0;;;11,0;;3,0;;4,0;6,0;;1,0;13,0;;;12,0;24,0;49,0;;1,0;152,0;4,0;31,0;10,0;;3,0;2,0;24,0;52,0;;73,0;88,0;43,0;10,0;2,0;2,0;4,0;;1,0;6,0;;1,0;;108,0;10,0;10,0;;3,0;4,0;7,0;;2,0;;;17,0;5,0;4,0;;;21,0;142,0;2,0;;31,0;6,0;;3,0;;;2,0;;8,0;;;;1,0;6,0;;3,0;;2,0;69,0;15,0;17,0;;49,0;;6,0;8,0;11,0;2,0;2,0;4,0;;2,0;;4,0;;;18,0;1,0;;115,0;;17,0;;;50,0;9,0;;;7,0;7,0;;;;7,0;;;1,0;2,0;91,0;3,0;2,0;2,0;11,0;;35,0;9,0;5,0;7,0;14,0;9,0;98,0;;;;;;;17,0;;;6,0;;1,0;;;;;1,0;6,0;4,0;;;2,0;;;2,0;10,0;;;3,0;;;;3,0;;;;;;;2,0;;;;;;22,0;1,0;;3,0;1,0;;;;;;;;;31,0;;3,0;14,0;79,0;4,0;;;;;33,0;10,0;2,0;;;1,0;;;7,0;;;;;1,0;;;22,0;1,0;12,0;3,0;3,0;;;13,0;5,0;;2,0;;1,0;34,0;1,0;;;;1,0;;3,0;;;;1,0;;1,0;;;;;;;;;;;13,0;10,0;;;2,0;2,0;;;;19,0;;;12,0;3,0;9,0;2,0;;2,0;21,0;;2,0;;2,0;;;2,0;;4,0;2,0;;;2,0;;;5,0;2,0;3,0;1,0;15,0;;;;;;;;;31,0;;;;;;;2,0;28,0;;4,0;;;;6,0;;;2,0;;;1,0;7,0;2,0;4,0;1,0;24,0;5,0;;4,0;6,0;20,0;23,0;4,0;;6,0;;5,0;;;;;;;13,0;;1,0;;25,0;2,0;;13,0;14,0;;;6,0;15,0;2,0;3,0;;;;6,0;2,0;;15,0;3,0;;12,0;;1,0;;3,0;2,0;;;6,0;2,0;51,0;;18,0;9,0;5,0;2,0;;;5,0;;4,0;;;;3,0;;;8,0;;;;;;;3,0;;;2,0;1,0;7,0;;;26,0;;8,0;1,0;1,0;;;;2,0;;;;4,0;;;7,0;1,0;;;;;9,0;1,0;;;;;;3,0;;1,0;;;1,0;;;3,0;;;13,0;;4,0;1,0;3,0;;4,0;1,0;;;;13,0;;;;7,0;1,0;2,0;;1,0;;;1,0;;;4,0;;4,0;5,0;;3,0;;2,0;6,0;;82,0;1,0;;;;;;8,0;4,0;3,0;;;25,0;;40,0;;;;1,0;11,0;1,0;3,0;;2,0;;1,0;;3,0;;2,0;10,0;;;1,0;21,0;12,0;;1,0;4,0;;;;;;1,0;;;;;2,0;68,0;;;;;;;;;;;1,0;;;;;;;;;;;;;;;;;;;3,0;4,0;;;;;;4,0;;1,0;;;;;1,0;8,0;;;;;;4,0;3,0;;2,0;;;;;2,0;;3,0;1,0;;;;;;;;;;2,0;1,0;;13,0;1,0;2,0;;6,0;;;;;;2,0;;2,0;;;;;;;;;;;;;
duration;;;15,0;;;;;13,0;;13,0;;2,0;;;1,0;;;;6,0;1,0;1,0;19,0;1,0;;;;;17,0;;4,0;;41,0;9,0;;1,0;1,0;;;;5,0;;;;2,0;;;;;1,0;;;1,0;;1,0;;31,0;6,0;;6,0;;2,0;;18,0;;;;6,0;;6,0;;;;;;;1,0;;;10,0;3,0;;3,0;;6,0;;;1,0;;1,0;1,0;1,0;;;4,0;;2,0;;;;;2,0;2,0;;;1,0;;;2,0;;;;;;;;3,0;;;;;;;;2,0;;;1,0;;;;;;;;;;;;;1,0;;;;;;;2,0;10,0;1,0;;;;1,0;;;;;;3,0;2,0;;15,0;;;;;;11,0;;;;;;;;4,0;;11,0;;;;1,0;1,0;;;;;5,0;;3,0;;;;6,0;;;;;;;;;;;;;;;;;;;;;;74,0;;;;;;;;;;;2,0;;;;;;;;7,0;2,0;;;;;;;;;;;2,0;;;;;;;;;;;12,0;;;;;;;;;;;;;;;;;;1,0;;;;;;;;;;17,0;2,0;8,0;;;;;;;;;;1,0;;;;;4,0;;;;;;;;;;;;;;;;;;;;;;;1,0;;;;;4,0;;;;;;;;;;;2,0;1,0;;1,0;1,0;;;;6,0;;7,0;6,0;1,0;;15,0;;;;;;;;;1,0;;;;;;;;;3,0;;;;;;;7,0;;;1,0;3,0;3,0;6,0;1,0;1,0;1,0;;3,0;;;1,0;;7,0;;;;1,0;;;;;;10,0;7,0;;2,0;;3,0;;;;10,0;;;3,0;3,0;;;;;4,0;;;;;5,0;1,0;;;;;;;;;;;;;4,0;;;;;;;1,0;;1,0;16,0;;;;;3,0;;;;;;;;;;14,0;1,0;;;;;;;;1,0;;;;;;;;;;;;10,0;;;;;3,0;8,0;;1,0;;;;;;;;;;;;;;;;;;;;;;;;;;;;;;;;;;;4,0;;;;;;;1,0;;;1,0;;;;;;;;;;;;;;;;;;;;;;;;;;;;;;;;;;;1,0;;;;11,0;9,0;2,0;2,0;;;;;;;;;;;;;;1,0;;;;63,0;;;;;;;;;;;;;;;;;2,0;;;;;;;;;;1,0;;;;;;;2,0;;3,0;;;;;;;;;;;;;;;;;;;;;;;;;;;;;;;;;;;;2,0;;;;;20,0;;;2,0;2,0;;;;;;;;;;;;;;;;5,0;9,0;;;;;;;;;1,0;;;;2,0;;;;;;;;;;;;;;10,0;;;;;;2,0;;;;;;;8,0;;;;;;;2,0;1,0;;3,0;;;;;;;;;;;;;;;;;1,0;;;1,0;;;;;;;;;;;;;2,0;;;;2,0;4,0;;;;;;;;;;;;;;;;1,0;;;3,0;22,0;;;3,0;;;;;;;;;;5,0;;;;;;;;;;2,0;;;;;10,0;4,0;;;;;;;;;;;;;;;;;;;;;;;;;4,0;;;;;;;;;;;2,0;;;;;;;;;1,0;;;;;;7,0;;;;;;;;;;;;;;;;;;;;;;;;;;;;;;;;;;;;;;;;;;;;;;;;;;;;;;;;;;;;;;;;;;;;;;;;;;;;;;;;;;;;;;;;;;;;;;;;;;;;;;;;;;;;;;;
dynamic;;;5,0;;5,0;;;12,0;;5,0;;1,0;;;4,0;;;;1,0;1,0;1,0;11,0;3,0;;2,0;;6,0;25,0;2,0;6,0;2,0;;60,0;;5,0;4,0;8,0;4,0;;7,0;;;;;4,0;;;;;;2,0;7,0;;;;165,0;22,0;;1,0;;;;21,0;3,0;;;;;;;2,0;;1,0;;;;;8,0;2,0;;;6,0;4,0;4,0;;;1,0;;;1,0;21,0;;1,0;5,0;10,0;;;;7,0;;;18,0;;6,0;;;;12,0;;;;;16,0;3,0;;;;;;1,0;;;;5,0;;;36,0;1,0;;1,0;2,0;8,0;;;;2,0;2,0;;;;1,0;1,0;;;;;3,0;;1,0;;;;;;1,0;;;;;81,0;;5,0;;;;;2,0;1,0;2,0;;;;1,0;;4,0;;;2,0;;;1,0;;;;;1,0;;1,0;;6,0;;;;33,0;;;;;;1,0;;;1,0;1,0;;;1,0;1,0;1,0;;;;;;2,0;20,0;;;;;;3,0;;;;;;;;;;;;;4,0;1,0;;5,0;3,0;;;;;;;1,0;2,0;;;;;1,0;;;;;;3,0;;;;1,0;1,0;;;;3,0;;;;;;;;;;;;;1,0;;;;;;8,0;1,0;24,0;;;;;;1,0;;;;9,0;4,0;;;;;;;;;98,0;;;;;;;;;;;;;;;;2,0;;;;;;;1,0;5,0;;;;;2,0;3,0;1,0;;;;2,0;;;;;;;3,0;4,0;;8,0;4,0;;;;;;;;;;;;2,0;;;;23,0;;2,0;2,0;;2,0;;;4,0;;;1,0;4,0;;2,0;;;;;;1,0;;24,0;;;1,0;2,0;;;3,0;;1,0;;6,0;1,0;;;;5,0;;;3,0;1,0;1,0;4,0;;;1,0;;1,0;;;;;1,0;5,0;;1,0;1,0;2,0;8,0;;;;;;;;;;;;;;;3,0;;;2,0;;;2,0;;9,0;;;;;;3,0;;;1,0;;;;;;;1,0;;;5,0;;;;;;;;;16,0;3,0;;;;;2,0;;;;;;;;12,0;9,0;;4,0;;;;;;;1,0;;;;;;;;;1,0;;;;1,0;;;;;6,0;;;;1,0;;;;1,0;;;9,0;;16,0;;;;;;4,0;;;;;;;;;;;;6,0;1,0;;1,0;;;;3,0;;;;;2,0;;;;;;;;;;;;;;;7,0;;2,0;;;;;;3,0;;;;;;;1,0;;;;2,0;;;2,0;;;;;;;;;;;;;;;;;;;;1,0;;;;;;;;;;;;;;;;;;;;;;;;;;;;;;;;;;;;;;;;;;;;;;;;;;;;;1,0;;;;;;;;;1,0;;;;;1,0;;;;;;;;;;;;1,0;;;;3,0;1,0;;;1,0;;;;;;1,0;1,0;;;13,0;;1,0;;;;;;;;;;;;;;;;;;;;;;;;;5,0;;;;;;;;;1,0;2,0;;;1,0;;;;;;;;;;;;;;;1,0;1,0;;;;;;;;;;1,0;;;;;;1,0;;;;;;;;;1,0;;;;;;;;;;;1,0;;1,0;;;;;;;;;5,0;;;;;;;;;;;;;;;;;;1,0;;;;;;;;;;;;;;1,0;;4,0;;;;;;;;;;;;;;;;;;;;2,0;;;;;;;;;;;;;;;;;;;;;;;;;;;;;2,0;;;;;;;;;;2,0;;;;;;;;;;;;;;;;;;;;;;;;;;;3,0;;;;;;;;;;;;;;;;;;;;;;;;;;;;;;1,0;;;;;;;;;;;;;;;;;;;;;;;;;;;
electric;;;23,0;;9,0;;12,0;28,0;1,0;8,0;7,0;1,0;;2,0;;2,0;;;11,0;;9,0;49,0;;8,0;10,0;;;15,0;;35,0;18,0;23,0;72,0;4,0;9,0;1,0;1,0;57,0;;9,0;3,0;;58,0;26,0;;;;2,0;3,0;2,0;3,0;55,0;21,0;2,0;;359,0;19,0;;4,0;173,0;1,0;;9,0;;1,0;106,0;10,0;;;62,0;94,0;5,0;3,0;;2,0;34,0;7,0;3,0;27,0;139,0;6,0;9,0;9,0;8,0;;2,0;4,0;;1,0;6,0;18,0;2,0;1,0;598,0;;8,0;;2,0;10,0;8,0;20,0;102,0;;61,0;;1,0;;106,0;7,0;;11,0;7,0;4,0;1,0;8,0;;;;10,0;8,0;1,0;;6,0;55,0;;1,0;29,0;16,0;;2,0;5,0;11,0;15,0;3,0;;5,0;4,0;;23,0;10,0;20,0;;5,0;;16,0;4,0;18,0;;;1,0;;4,0;;;5,0;4,0;2,0;5,0;;44,0;34,0;6,0;;1,0;;1,0;18,0;61,0;2,0;9,0;33,0;6,0;17,0;16,0;2,0;5,0;;106,0;1,0;;2,0;;;2,0;3,0;;71,0;37,0;;17,0;;;;21,0;2,0;5,0;;;49,0;2,0;2,0;1,0;3,0;10,0;;;;;4,0;6,0;;;;2,0;;28,0;6,0;6,0;1,0;5,0;;3,0;1,0;;;1,0;7,0;;;;;;6,0;4,0;4,0;4,0;;67,0;;3,0;1,0;2,0;;2,0;;;;3,0;;36,0;8,0;;4,0;25,0;;;1,0;2,0;;;1,0;24,0;;1,0;2,0;;1,0;;1,0;;1,0;1,0;1,0;;1,0;3,0;;;1,0;5,0;4,0;12,0;2,0;17,0;1,0;2,0;1,0;103,0;3,0;7,0;;1,0;;;5,0;2,0;23,0;10,0;;;;;9,0;1,0;;2,0;;2,0;;3,0;;9,0;3,0;;20,0;;;;;;;;2,0;1,0;;17,0;;;95,0;;;2,0;;;;46,0;;;1,0;;;;;;;;;3,0;1,0;4,0;6,0;;;4,0;;;7,0;;;;;;;44,0;;;;;;;;;5,0;2,0;2,0;14,0;1,0;3,0;;22,0;;1,0;1,0;;10,0;11,0;1,0;6,0;;13,0;;18,0;9,0;;11,0;2,0;5,0;;;;;;;;;;;154,0;;;5,0;4,0;1,0;;;;;;6,0;;2,0;3,0;;3,0;20,0;;;27,0;;;;;;;;;38,0;;;17,0;;;5,0;1,0;;27,0;40,0;88,0;;5,0;;6,0;91,0;10,0;;;2,0;;;;;;;;;3,0;2,0;;;;;25,0;2,0;;;;6,0;2,0;;;2,0;;;;;37,0;2,0;;;1,0;;29,0;7,0;30,0;8,0;;;23,0;;1,0;;;;;2,0;;;2,0;;;;;;1,0;3,0;16,0;7,0;;;;;;;;;;6,0;1,0;;1,0;;;;1,0;;;;1,0;;;;2,0;;;;;2,0;;;;;;;;;;4,0;;;;43,0;48,0;;;;;;;1,0;;;;;;;;;;;;;;9,0;;;11,0;;;;;2,0;;;;2,0;161,0;;;1,0;;2,0;;11,0;;;;;;;;;;;;1,0;;;;;5,0;17,0;;;;;;;;;;;8,0;1,0;1,0;;;;;1,0;;1,0;;;;1,0;;;2,0;;;2,0;2,0;;1,0;;;;2,0;;;;;;;4,0;2,0;2,0;;;;;;3,0;1,0;8,0;;;1,0;16,0;;2,0;6,0;;;;9,0;2,0;;;1,0;16,0;;;;;1,0;;;;;;;3,0;;;;1,0;;5,0;9,0;9,0;4,0;;1,0;;;6,0;7,0;4,0;;10,0;;1,0;13,0;;;;;;;;4,0;;;;;;;;;9,0;;;;;;;;2,0;;;;;;;;;;1,0;1,0;;;;7,0;;;;;3,0;;;6,0;3,0;;;1,0;;2,0;15,0;;;;;;;3,0;;;;;2,0;;;;;;;;;;;;;;;;1,0;;;;;;;2,0;2,0;;;;2,0;4,0;1,0;;;;;1,0;6,0;;;;;1,0;;;;;;;;5,0;;1,0;;;;;;;;5,0;;;;;;;;;1,0;;5,0;;;;;;;;;;;;3,0;;9,0;;;;;;8,0;;;1,0;;;;;;;;5,0;;;;;;;;3,0;;;;;;;;;;;;;;;;32,0;;;;;4,0;1,0;;;4,0;;;;;1,0;;;1,0;;;;;;;;;;3,0;;;;;;;;;;;;;;;;;;;;2,0;;;;;1,0;;;;;;;;6,0;;2,0;;;;;;;;;;;;;;;;;;1,0;;;;
emission;;;293,0;;20,0;;;63,0;20,0;13,0;;7,0;;2,0;90,0;;;;1,0;1,0;5,0;359,0;;;2,0;;;28,0;;12,0;34,0;78,0;244,0;7,0;29,0;;;;;16,0;2,0;;1,0;94,0;1,0;;;;;12,0;2,0;11,0;;;;32,0;27,0;;;3,0;;;20,0;4,0;;;;;2,0;27,0;20,0;9,0;8,0;;;12,0;;59,0;2,0;;1,0;3,0;;1,0;;;13,0;;5,0;25,0;2,0;;11,0;35,0;1,0;;;11,0;23,0;;13,0;21,0;;1,0;;;;218,0;;;15,0;9,0;;;3,0;;;3,0;;1,0;;;2,0;11,0;;;9,0;;;;1,0;;;;;15,0;5,0;;4,0;166,0;4,0;;8,0;30,0;2,0;;4,0;4,0;;;2,0;;12,0;;;;;3,0;56,0;34,0;1,0;3,0;;1,0;;;7,0;1151,0;;;10,0;3,0;;2,0;;3,0;;21,0;;;;;2,0;;;1,0;3,0;45,0;;5,0;;;6,0;10,0;;8,0;;;;;;;1,0;3,0;;;1,0;;;;7,0;;2,0;2,0;;103,0;9,0;1,0;;;1,0;1,0;;;;11,0;12,0;;;;;;;;8,0;;;;3,0;;;;;;;;;;;;;;;8,0;;;;5,0;55,0;;3,0;;;;;;;;;;;3,0;4,0;;4,0;;;;4,0;;;;;5,0;;;;19,0;;;;;2,0;;;;;14,0;;;;;25,0;6,0;;;;9,0;;;3,0;20,0;4,0;;;;;;;;;;;;;20,0;1,0;;22,0;;1,0;4,0;;;;2,0;2,0;;;;;;;;;;14,0;;;14,0;;24,0;1,0;;;5,0;;;;;;;;1,0;;8,0;;;;;;;;6,0;2,0;;;;;4,0;55,0;1,0;2,0;1,0;13,0;12,0;3,0;83,0;;13,0;1,0;18,0;;;1,0;;153,0;;;13,0;;;;2,0;;;;;;;2,0;;;;;;;;1,0;1,0;;;;;62,0;;;16,0;4,0;;;;;;;;;;;;1,0;;;;;16,0;;9,0;3,0;;;36,0;5,0;178,0;;;;5,0;51,0;;;;;7,0;;;;;3,0;;;111,0;;;;;;12,0;;;;;;;;;;2,0;;19,0;2,0;2,0;43,0;;;;;9,0;;;3,0;;;;3,0;;;;;;;;;;;3,0;5,0;;;;;;4,0;;;;7,0;;;;;;2,0;;;1,0;;;;;;;;1,0;;4,0;;;;;4,0;;5,0;;12,0;;2,0;;;;;;;;;;2,0;;;;;1,0;3,0;;;2,0;;;;;;;25,0;2,0;;;;;;;;;;20,0;;10,0;;;;;;;54,0;;;;;;;;;;;;;;1,0;;;7,0;;;7,0;5,0;;;;;4,0;;;;5,0;2,0;;;2,0;;;;;6,0;;;;;;;;;;;;;;;;;;;;1,0;;;;;;;;;90,0;;;;;;;;3,0;;;;1,0;23,0;;5,0;;;;2,0;7,0;;5,0;;;;;;;;5,0;;;;;;;;;3,0;;;;;;;;;;;;;;;;11,0;;8,0;;;4,0;;;21,0;;;;;1,0;;3,0;;;;;26,0;1,0;;;;;;;;;;;;2,0;;;;;;;;;;2,0;2,0;24,0;62,0;;;;1,0;35,0;;1,0;;;;;;;;;;;;5,0;;;1,0;;;;;;;;;;;;;;;;;;;;2,0;;;3,0;;8,0;;;;;;;;;;26,0;3,0;;;;;;;;;;;;;1,0;;;;;;;;;;;;;;;;;;;;;;;;;;;;;;1,0;;;;;;;;;;;;;;;;;;;;;;;;;;;;;;;;;;;;;2,0;;;;16,0;;2,0;;;;;;;;;;;;1,0;2,0;;;;4,0;;;;;;;;;;;;;;;;;;;;;;;;;;;;;;;;;;;;;2,0;;;;;;;;;;;2,0;;;;;;;;;;;;;;;;;;;
enable;;;1,0;3,0;27,0;;3,0;26,0;1,0;45,0;1,0;1,0;;;;1,0;;5,0;5,0;21,0;2,0;54,0;1,0;6,0;25,0;;1,0;43,0;8,0;8,0;15,0;13,0;132,0;1,0;56,0;;2,0;;2,0;43,0;5,0;;50,0;15,0;;;;15,0;50,0;1,0;15,0;23,0;1,0;14,0;2,0;155,0;23,0;;3,0;88,0;4,0;;37,0;2,0;;4,0;14,0;1,0;;42,0;2,0;6,0;1,0;;;1,0;;28,0;38,0;9,0;1,0;17,0;38,0;8,0;;;2,0;;;44,0;24,0;;10,0;30,0;4,0;3,0;;7,0;5,0;10,0;5,0;82,0;;8,0;;4,0;2,0;57,0;1,0;;1,0;5,0;6,0;5,0;19,0;1,0;;;;12,0;;;2,0;4,0;1,0;;49,0;8,0;;17,0;5,0;;;;2,0;8,0;3,0;;;6,0;3,0;1,0;2,0;2,0;3,0;3,0;3,0;9,0;;;;2,0;2,0;;1,0;1,0;1,0;18,0;;46,0;2,0;2,0;3,0;5,0;1,0;;2,0;29,0;;2,0;20,0;3,0;27,0;17,0;15,0;17,0;1,0;19,0;;;10,0;;2,0;;17,0;4,0;1,0;18,0;;49,0;;;;17,0;;;;;16,0;3,0;;3,0;2,0;3,0;1,0;1,0;2,0;1,0;7,0;15,0;1,0;1,0;;;7,0;5,0;6,0;8,0;;;;3,0;;;;2,0;4,0;;;;;8,0;6,0;;8,0;7,0;;11,0;14,0;1,0;;;;;3,0;3,0;;3,0;;;1,0;1,0;;12,0;;2,0;;4,0;1,0;;2,0;3,0;2,0;;2,0;;2,0;;;;;3,0;;;3,0;27,0;2,0;2,0;;1,0;13,0;;2,0;19,0;2,0;29,0;2,0;31,0;13,0;;2,0;;;7,0;;;;14,0;1,0;;6,0;;22,0;;30,0;2,0;;49,0;6,0;;4,0;1,0;;;1,0;;5,0;;;1,0;;5,0;2,0;5,0;;9,0;;;2,0;;112,0;2,0;;;;2,0;2,0;2,0;1,0;;;28,0;2,0;1,0;6,0;1,0;1,0;7,0;;19,0;2,0;6,0;2,0;;;1,0;1,0;;;;6,0;;;1,0;7,0;3,0;1,0;3,0;2,0;3,0;;;;2,0;6,0;1,0;;3,0;;2,0;1,0;3,0;1,0;19,0;;;;;1,0;14,0;19,0;9,0;4,0;3,0;14,0;7,0;10,0;9,0;1,0;;6,0;;1,0;;1,0;;;30,0;3,0;3,0;;;1,0;;;10,0;6,0;;12,0;;1,0;2,0;;30,0;39,0;2,0;;12,0;2,0;6,0;3,0;;1,0;;;3,0;7,0;;10,0;2,0;19,0;;1,0;2,0;5,0;52,0;;2,0;2,0;2,0;;15,0;10,0;1,0;1,0;5,0;8,0;;8,0;5,0;;5,0;1,0;;1,0;1,0;8,0;18,0;1,0;3,0;;9,0;;4,0;4,0;1,0;11,0;7,0;;4,0;;1,0;6,0;;;14,0;3,0;20,0;4,0;8,0;;5,0;;4,0;84,0;22,0;;4,0;1,0;;5,0;1,0;2,0;1,0;4,0;8,0;;;;;1,0;1,0;1,0;5,0;45,0;11,0;5,0;;;;;1,0;1,0;3,0;2,0;7,0;;8,0;2,0;1,0;;6,0;5,0;;7,0;;2,0;1,0;1,0;;;1,0;;;;1,0;2,0;1,0;1,0;3,0;;1,0;1,0;1,0;3,0;;2,0;2,0;;7,0;15,0;2,0;8,0;;7,0;;11,0;;9,0;;5,0;1,0;2,0;4,0;;1,0;;3,0;;;;1,0;12,0;1,0;;11,0;;;;1,0;9,0;;;2,0;;5,0;4,0;;;;;1,0;;6,0;1,0;1,0;2,0;;;;;;;;3,0;3,0;7,0;;;;;;1,0;4,0;;2,0;;1,0;9,0;;;;3,0;3,0;5,0;;5,0;4,0;10,0;4,0;;;;1,0;;;;;;;2,0;;;4,0;1,0;1,0;;;;;1,0;;3,0;;;9,0;16,0;;;;;;2,0;4,0;;3,0;;2,0;;;;3,0;;1,0;3,0;1,0;;;;;;6,0;;;1,0;;;;5,0;1,0;8,0;;;4,0;1,0;;1,0;;2,0;8,0;;1,0;1,0;8,0;;1,0;;11,0;1,0;6,0;;;;;;2,0;;;;;10,0;;2,0;6,0;2,0;1,0;2,0;;3,0;;;;;;;2,0;;1,0;1,0;;;2,0;;;3,0;;;;2,0;1,0;;;;;;;;;1,0;;12,0;;1,0;;;7,0;2,0;;3,0;1,0;;6,0;;3,0;;;;;;;1,0;;;5,0;11,0;;1,0;1,0;2,0;;4,0;;;10,0;;;;;;1,0;;;1,0;7,0;1,0;3,0;;;;;;;4,0;1,0;;3,0;;;2,0;;3,0;4,0;1,0;;1,0;;;;1,0;;;;2,0;;;;;;1,0;2,0;;;3,0;;;;6,0;;;;;;;;;;;2,0;;;1,0;1,0;;;;1,0;;;;2,0;;1,0;;;2,0;;2,0;;4,0;;;2,0;1,0;;;;2,0;;;;1,0;;;;;;;3,0;1,0;;;7,0;;;;1,0;;;;;2,0;;;1,0;;3,0;1,0;;;;;;;;2,0;2,0;1,0;1,0;;;;;;;;;6,0;1,0;;;;;;;;;;;;;;;;1,0;2,0;;;;5,0;;;;2,0;;1,0;;;2,0;;;;;;;;;;;;;;;1,0;;;;;;;
encode;;;10,0;2,0;99,0;;;9,0;;9,0;;;;3,0;2,0;;;;;44,0;;39,0;;;;;;132,0;;14,0;2,0;4,0;19,0;17,0;19,0;;;1,0;;12,0;;1,0;;5,0;;;;;2,0;1,0;;69,0;;;;264,0;36,0;;3,0;;;;123,0;;;;37,0;;;42,0;4,0;3,0;2,0;;;;;13,0;;;;51,0;1,0;4,0;;;6,0;;1,0;14,0;2,0;1,0;2,0;91,0;;;;11,0;14,0;;2,0;22,0;;10,0;4,0;;;58,0;;;12,0;;;2,0;;;;;;;;;;38,0;;;54,0;;;1,0;;6,0;;;;;;;;1,0;;;1,0;;6,0;;9,0;70,0;;;;;;;;;;;;5,0;;1,0;;;;;8,0;3,0;;;;;17,0;;;;;40,0;;;;;17,0;;;;;35,0;;6,0;;;;7,0;;;;;;;;5,0;;;;;;;;;;7,0;2,0;;;48,0;25,0;;;;;;;;;;;;;;;;;6,0;9,0;;;4,0;11,0;;;;19,0;;;14,0;2,0;;;;;2,0;;;;;;;;;;;1,0;;;;3,0;;;;;;;;3,0;3,0;;;;;;;;;;10,0;;6,0;1,0;;;;;3,0;;;;;;;;;36,0;;;;;1,0;;;15,0;;;;;2,0;;;;;;2,0;;;;2,0;;;9,0;5,0;2,0;;;;;;;;;;;1,0;;6,0;9,0;;1,0;;;9,0;;7,0;;;;;3,0;;;;;;;;7,0;5,0;;;3,0;;;;;;46,0;1,0;11,0;1,0;;;3,0;;3,0;25,0;;1,0;42,0;;22,0;21,0;;;;2,0;;;;7,0;;;1,0;;;;7,0;;1,0;;;;;;;;;;4,0;;11,0;;6,0;10,0;;3,0;21,0;;30,0;4,0;23,0;;18,0;2,0;;;;;1,0;;3,0;;;4,0;4,0;;1,0;;;1,0;;;;20,0;1,0;1,0;;10,0;;;25,0;;;;;;;4,0;;;58,0;;;18,0;;;2,0;;3,0;;2,0;;1,0;;;;;;;1,0;;12,0;;;;;203,0;4,0;;;17,0;;;;1,0;;;;;;;;;;;46,0;17,0;;;20,0;;;;;;;;;1,0;;1,0;;;2,0;;;;;;;1,0;6,0;;;;;;;1,0;3,0;;2,0;;1,0;;1,0;6,0;;2,0;4,0;;343,0;9,0;;;;;;;;;;;1,0;;;;;;;;;;56,0;2,0;;2,0;9,0;;;;;;;;;;;;;1,0;;;;1,0;;;;;;;;;;;;;4,0;;;;;;;;3,0;;;;;5,0;;;;;;;;;;;;;;;;;41,0;;;;;10,0;;;;;;;;;;;;2,0;;;;;;;;;;;;;;;;;;;;;;;;;;;;;;1,0;;4,0;;;;;;1,0;8,0;;;;;;;;3,0;;;;;;;;;;;;;;;;;2,0;;;;;;1,0;;3,0;;;;;;1,0;;;;;4,0;;5,0;1,0;;;1,0;;;;2,0;;;;;;2,0;;;;;;;;;;;;;;2,0;;;;;;;;;13,0;;;;;;;;;;24,0;;;;;;;;;;;;;;1,0;;;;;3,0;;;;;;;;;;;;;;;;;;;;;;;;;;;;;;7,0;;;;;;;;;;;;;2,0;;;;;;;;;;;;248,0;;;;1,0;;;;;;2,0;;;;;;;;;;;2,0;;;;;7,0;;12,0;;;;;;;;;;;;;;5,0;;;;;;;;;;;11,0;;;;4,0;;;;;;;;;;4,0;;;;;;;2,0;;;4,0;;1,0;;2,0;;;;;;;;;;;;;;;;;;;;;;;;;;;;;;;;;;;;;;;;3,0;;;;;;;;;;
encoder;;;2,0;;52,0;;2,0;10,0;;13,0;1,0;;;7,0;;;;;;1,0;1,0;29,0;;4,0;1,0;;;21,0;;20,0;4,0;15,0;6,0;;28,0;;2,0;1,0;3,0;;3,0;;3,0;1,0;;;;1,0;8,0;;;3,0;;;1,0;150,0;24,0;;2,0;15,0;2,0;;34,0;;;12,0;39,0;;;6,0;2,0;;1,0;;;;;1,0;63,0;14,0;;2,0;6,0;;;;;;;10,0;45,0;;2,0;54,0;;;;10,0;1,0;3,0;;10,0;;1,0;;;;41,0;;;;;1,0;4,0;;;;;;2,0;;;;12,0;;;18,0;;;9,0;;;;;;2,0;;;;;;;;;12,0;;5,0;8,0;;;;;;;;;;;;1,0;1,0;;;1,0;;;;;;;4,0;;;1,0;2,0;;;28,0;;;;;;;;;1,0;3,0;;8,0;;;;21,0;;;;;1,0;;3,0;;;;;;1,0;;;;;;;;15,0;13,0;15,0;;2,0;;;;;;;;;;;;;1,0;1,0;2,0;5,0;;;;1,0;3,0;;1,0;12,0;;;;4,0;;;;;;;8,0;;;1,0;;;;1,0;11,0;;;;;2,0;;;;;;;;;;;;;;1,0;1,0;;3,0;;2,0;6,0;;;;;;;;1,0;;;;;;;;14,0;;;;;;;;2,0;1,0;;;1,0;;;;;;;5,0;;;;9,0;;;;;;;;;;;;;;1,0;;2,0;;2,0;;;;;;4,0;1,0;3,0;;;;;;;;;1,0;;;;;;3,0;1,0;2,0;;;;;8,0;16,0;1,0;;;;;;;;;7,0;;17,0;;;23,0;;1,0;2,0;;;3,0;3,0;;;;;;;;1,0;;;;;;;;;;;;;;8,0;;;;;;4,0;;4,0;2,0;22,0;;2,0;1,0;;;;;8,0;2,0;19,0;;;;;;2,0;8,0;;4,0;;2,0;;4,0;;;;;;;8,0;4,0;;;;;43,0;1,0;;;7,0;;;8,0;;;;;;;;;;;;;;;;;;2,0;;5,0;;;126,0;;;;3,0;;;4,0;;3,0;;;;;;;2,0;;;18,0;5,0;1,0;;;;;;;;;;;;;;;;;;;;;;2,0;;;;;2,0;;;;1,0;;;;3,0;;;;1,0;;13,0;1,0;;186,0;1,0;;;;;;1,0;;;;;2,0;;;;;;;;;;;;;1,0;3,0;;;;;;;;;;;;;1,0;;;;;;;;;;1,0;1,0;;;;;;1,0;;;;3,0;;;;;2,0;;;;2,0;;;;;;;;;;;;;1,0;;;;1,0;;;;;;;;;;;;;;;;;6,0;;;;;;;;;;;;;;;;;;;2,0;;;;;;;;;;;;;;;;;;;;;;;;;;;;5,0;;;;;;;;;;7,0;;;;;;;;;;;;;1,0;;2,0;;;;;;;;;1,0;;;;;;;;;;;;3,0;;;;;5,0;;;;;;;2,0;;;;;;;;;;;;;;;;;;;;1,0;;;;;;;3,0;;;;;;;;;1,0;;;;;;;;;;;;;;;;;5,0;;;;;;;;;;;;;;;;;;;;;;;6,0;1,0;;;1,0;;;;;;;;;;;;;;;;;3,0;;;;;;;;;;;;;;;;;;;5,0;;;;;;;;;;;;;1,0;;;;248,0;;;;;;;;;;;;;;;;;;;;;;;;;;;;;;;;;;;;;;;;;;;;;;;;;;;;;;;;;;;;;;;;;;;;;;;;;;;;;;;;;;;;;;;;;1,0;;;;;;;;;;
energy;;;14,0;;3,0;;8,0;30,0;4,0;2,0;;1,0;;;;;;3,0;5,0;1,0;;15,0;;3,0;;;5,0;2,0;1,0;41,0;6,0;36,0;23,0;27,0;3,0;2,0;13,0;18,0;;3,0;4,0;;;17,0;;;;;2,0;4,0;29,0;15,0;1,0;;;73,0;5,0;;;3,0;;;21,0;;;;;;;2,0;2,0;;2,0;;;;;8,0;9,0;14,0;1,0;6,0;6,0;22,0;;;4,0;;8,0;13,0;19,0;;;4,0;1,0;;;;40,0;1,0;21,0;19,0;;6,0;;;3,0;15,0;12,0;4,0;37,0;;9,0;8,0;2,0;;;;;2,0;;;2,0;3,0;;8,0;12,0;;4,0;7,0;2,0;5,0;1,0;;1,0;8,0;2,0;;;16,0;;;;2,0;;9,0;1,0;2,0;32,0;;;;;13,0;;;;7,0;17,0;4,0;21,0;3,0;;;;6,0;29,0;54,0;;1,0;12,0;;7,0;3,0;;5,0;;7,0;;;2,0;;6,0;;;2,0;11,0;36,0;;8,0;;;4,0;25,0;;28,0;;;;2,0;;;;;;;1,0;;;;;6,0;9,0;;;7,0;1,0;;1,0;2,0;;8,0;;8,0;;8,0;;;;;;;;;6,0;8,0;;1,0;17,0;;;;;;;;2,0;;;;;;;2,0;;;;;;;2,0;;;2,0;;;;;;;;1,0;;;;2,0;;;;;;;;6,0;;18,0;;6,0;1,0;;;;;1,0;;;;1,0;;;;;6,0;1,0;;;;5,0;;;;2,0;;;1,0;;;;;;;2,0;;;;57,0;;1,0;33,0;;;;;;;7,0;1,0;3,0;;;;;;;;;;;;5,0;;1,0;2,0;;;;;;;;;;;;;;;1,0;;1,0;;;1,0;13,0;;2,0;;2,0;;;1,0;;;;;;;1,0;1,0;6,0;6,0;;;;;;;20,0;8,0;4,0;3,0;;;;;;1,0;;;1,0;;;;;;;3,0;;5,0;10,0;7,0;;;;4,0;;;;;;;;;;;;;;;14,0;;;;1,0;;1,0;15,0;5,0;;;;;1,0;8,0;;;;;;;;;;;6,0;2,0;;;5,0;;;2,0;;;4,0;;;;1,0;;;;;1,0;;;;7,0;;3,0;;8,0;1,0;;2,0;1,0;;8,0;;;;;1,0;;2,0;;;;;;;;;;2,0;;;;;;;;;;;4,0;3,0;;;2,0;;;2,0;;;4,0;;;;;;3,0;;;;;;;;;;;;;;;4,0;;;;47,0;7,0;;;;;12,0;;;;;;;;;;;4,0;;;;;3,0;;;;;;;;1,0;;;;7,0;21,0;1,0;;;;;4,0;8,0;;;;;;;;;;;;;;;;;;;;;;;;;;6,0;;;;;;;;7,0;;;;;;;;;;;;;;;;;;;;;;;;1,0;;;;;;;;;;;;2,0;3,0;1,0;;;;;;2,0;;3,0;1,0;6,0;42,0;;;;;26,0;20,0;;;4,0;;;1,0;6,0;;;7,0;;;4,0;;4,0;;;1,0;;;;4,0;;1,0;;;;;;4,0;1,0;;;;;;;;;;5,0;;1,0;1,0;;3,0;;;1,0;;;18,0;;;;2,0;;;;;;;;;;;;5,0;;14,0;;;3,0;;;;;2,0;;3,0;;;;;;;;;;;;;;;;;;;;;;;1,0;;;;;;;;;;;;;;;;;;;;;;2,0;;;;;;3,0;;;;;;4,0;;;;1,0;;;;;;1,0;;;;;;1,0;3,0;;;;;;;;;;;;;6,0;;;1,0;;;;;;;;;;;;;;1,0;3,0;;;;;;;;;;;;;;;1,0;;2,0;;;;;;;;;;;1,0;;;;;1,0;;;;;;;;;;;;;;;;;;52,0;12,0;;;;;;;;;;;;;;;;;;;;;1,0;;;;;;;;;;;;;;;;;;;;1,0;;;;;;;;;;;1,0;;;;;2,0;3,0;;;;1,0;;;;;;;;;
enlarge;;;3,0;;7,0;;;7,0;;2,0;29,0;;;;6,0;;;2,0;7,0;;;22,0;1,0;2,0;;;;49,0;;9,0;2,0;1,0;76,0;;6,0;;;4,0;27,0;111,0;;;;2,0;;;;;2,0;;1,0;2,0;;;;280,0;7,0;;;5,0;;12,0;2,0;1,0;;;6,0;;;;;1,0;;1,0;;;5,0;1,0;7,0;1,0;;7,0;1,0;1,0;;;;;2,0;3,0;4,0;;;2,0;11,0;;;;;1,0;3,0;1,0;;;;;1,0;21,0;;;;6,0;5,0;;1,0;;;;;;;;3,0;1,0;;;7,0;;1,0;;;;;;;;;;;;;;;85,0;4,0;4,0;8,0;11,0;;;;;;;1,0;;4,0;;1,0;;;4,0;1,0;;;;;4,0;;;1,0;;2,0;1,0;1,0;12,0;1,0;8,0;1,0;;1,0;;;;;;3,0;10,0;;12,0;;;;1,0;;;;;;;;;;;;1,0;;;;;;;;;;2,0;;;;;;;3,0;;1,0;;;;;;;;;2,0;;;;2,0;18,0;;1,0;;;1,0;;;14,0;;;;;;2,0;;;6,0;;5,0;1,0;;;;;;;;2,0;;;1,0;;;;;;;;;;1,0;;;;17,0;;4,0;;22,0;;3,0;;;;;;;;3,0;;;;;4,0;6,0;;;;;;1,0;4,0;2,0;;;;;;;;;;;;;;;;3,0;;;1,0;;;;;;1,0;;;;;3,0;;;1,0;;;4,0;;3,0;;4,0;;;1,0;;;;;;;;;;;4,0;;;;2,0;;;;;1,0;;;;;1,0;;;;;;;6,0;;;2,0;;;;;;1,0;;;;;3,0;;;;;;;8,0;;;;1,0;;;;;;;;;;;;;2,0;;;3,0;;2,0;;3,0;;;;;;1,0;;;;;;;;8,0;5,0;10,0;8,0;;;1,0;2,0;;;;;;2,0;;;;;;;;;;;;1,0;2,0;;;;;;;;;;;;;;;10,0;;;;1,0;1,0;1,0;;;3,0;1,0;;;;;;;;4,0;;;;;;;;;;;;;;;2,0;;;;;;;2,0;;;;;;;;;;;;;;;;;;;;;;;;;;;;;5,0;;;;1,0;1,0;;;;;;;3,0;;;;;;;2,0;;;;;;;;9,0;;;;;4,0;;4,0;;3,0;;;;;;;;;;;1,0;2,0;;;;;;;;;;;1,0;;;;;;;;;;;;;;;;;4,0;;1,0;;;;;;;;;;;;;;;;;1,0;;;;;;;;;;;;;;;;;;;;;;;1,0;1,0;1,0;;;;;;;;;;;;;;;;;;;;;;;;;;;;1,0;2,0;;;;;15,0;;;;;;;;8,0;;;;;;;;;;;;;;;;;;;;;;;;;;;;2,0;;;1,0;1,0;;;;;16,0;;;;1,0;;;;;;;;;;1,0;;2,0;;;;;1,0;;1,0;;;;;;2,0;;;4,0;8,0;;;;;;;;5,0;;;;;;;;;;;;;2,0;;;;;;;;;;13,0;;;;;;;;;;;;;25,0;;;;;1,0;;;;;1,0;;;;1,0;;;;;;;;;;;;;;;;;;;;;;;;;;;3,0;;;;;;;;;;;;;;;;;;;;;;;;1,0;;;;;;1,0;;;;;;;;1,0;;;;;;;;;;;2,0;;;;;1,0;;;;1,0;2,0;;;;;;;;;;;;;;;3,0;;;;;;;;;;;;;;;;;1,0;;;;;;;;2,0;;;;;;;;;;;;;;;;1,0;;;;;;;1,0;;;;;
equation;;;6,0;2,0;;;7,0;2,0;36,0;3,0;4,0;1,0;;6,0;2,0;;1,0;2,0;17,0;2,0;1,0;4,0;14,0;4,0;1,0;;8,0;2,0;;1,0;;14,0;1,0;12,0;3,0;2,0;2,0;11,0;6,0;1,0;15,0;1,0;;6,0;;;2,0;2,0;;;23,0;8,0;;3,0;1,0;42,0;4,0;1,0;1,0;16,0;8,0;;19,0;;1,0;2,0;;;;;4,0;;;;;;;13,0;11,0;;;;1,0;;;;;;25,0;;2,0;4,0;;20,0;;2,0;;;2,0;;6,0;7,0;;;2,0;;;4,0;2,0;;;;;;;4,0;;;;;;;2,0;;;;3,0;;;;;1,0;;;6,0;;;;;;3,0;;;;;;2,0;;;;;;;;1,0;;;2,0;;2,0;2,0;2,0;;;;;1,0;;;;6,0;;;;3,0;;;3,0;;;;;;;;4,0;;1,0;;;;;;1,0;;;2,0;;;;;1,0;;;;;;;;2,0;;;;;;23,0;;;;;;;;;;;;;;;;;;;;8,0;;;;;5,0;;4,0;;;;1,0;;;;1,0;;;1,0;;;;16,0;1,0;;;3,0;9,0;;;;;;;;;;1,0;;;;;;;1,0;;;;;;;2,0;7,0;;;;;;;;;;;;;;;5,0;2,0;;;;3,0;;;;2,0;;;;;;;;;;;;;;;;;;;;;;;;;1,0;;;;;3,0;;1,0;2,0;;7,0;;;7,0;;;11,0;9,0;;2,0;2,0;;;;;;;;;1,0;;;;;;;;1,0;;;;2,0;;3,0;;;1,0;;;3,0;;;1,0;;;;;;;;;;2,0;;;;2,0;;7,0;;1,0;3,0;;;;;;;;;1,0;;13,0;;8,0;;;2,0;;;;;;1,0;;;;;;;;;;;;;;;;3,0;;;;;;1,0;1,0;;;;;;1,0;;;;;;;3,0;;;4,0;;;7,0;;;;;;;;;;;;;;;;;;2,0;;;;;;;;;;;;;;;;;;;;;;;;;;;;;;;;;9,0;;;;;;;;;;;;;;;;;;;;;;;;;;;;;;;;;;;;1,0;2,0;15,0;;;;;;2,0;;;;;;;;;;;;;;1,0;;2,0;;;;;;1,0;;;;;;1,0;;;;;;;;5,0;;;;;;;;;;;;;;;;;;;;;;;;;;;;;;;;;;;;;;;;;;;;;;;;;;;;;;;;3,0;;;;;1,0;;;;;;;;3,0;;2,0;;;;13,0;;;;;3,0;2,0;8,0;;;;;;;;;;7,0;;;2,0;;;;;5,0;1,0;;;;;;4,0;;;;;;;;;;;;4,0;;;;;;;;;;;1,0;;;;;;2,0;;3,0;;;;;;2,0;;18,0;2,0;;;;;;2,0;5,0;2,0;;;;;1,0;3,0;;;;;;;;;;;;;1,0;;;;;1,0;13,0;;;;;;;;;;;;;;;;;;;;;;;;;;2,0;;4,0;;;;;;;;;;;;2,0;;;1,0;;;;;;;;;;;;;;;;;;;;;;;;;;;;;4,0;;;;;1,0;;2,0;;;;;;;;;;;;;;;1,0;;;;;;;;;;;;;;;;;;1,0;;;;;;;;;;;;;;;;;;;;;2,0;;;;;;;;;;;;;;;;;;4,0;;;;;;;;25,0;;6,0;;7,0;;;;;;;;;;;;;;;;;;4,0;;;;;;;;;;;;;1,0;;;;;2,0;;2,0;;;;;;;;;;7,0;;;;;;
estimate;;;10,0;;17,0;;1,0;70,0;20,0;24,0;7,0;3,0;;6,0;4,0;4,0;2,0;;2,0;3,0;;14,0;41,0;19,0;6,0;;2,0;32,0;3,0;37,0;18,0;42,0;13,0;6,0;13,0;8,0;1,0;13,0;5,0;4,0;56,0;3,0;4,0;2,0;19,0;;;15,0;23,0;2,0;9,0;45,0;2,0;2,0;;221,0;46,0;;28,0;12,0;1,0;2,0;104,0;1,0;15,0;;19,0;;3,0;6,0;12,0;1,0;2,0;;;1,0;;56,0;111,0;;;19,0;19,0;1,0;6,0;;11,0;6,0;2,0;17,0;9,0;9,0;3,0;80,0;12,0;;;4,0;18,0;;;32,0;2,0;;1,0;;;55,0;;;4,0;8,0;5,0;;;;;;;;;;1,0;12,0;;1,0;10,0;;;1,0;;2,0;;;;4,0;;;;;;11,0;2,0;8,0;6,0;;3,0;35,0;1,0;;;;;;;;;;2,0;17,0;;;;1,0;;;14,0;35,0;;;5,0;2,0;6,0;5,0;8,0;;;52,0;;;;;;;;2,0;1,0;25,0;;22,0;;;;11,0;;4,0;;;4,0;;;32,0;;1,0;;8,0;;1,0;10,0;;;;;;8,0;35,0;6,0;;;;1,0;23,0;10,0;;;;1,0;;;;;;;;1,0;5,0;;5,0;33,0;2,0;;;12,0;1,0;;7,0;;;;;6,0;;;1,0;;;;3,0;;;;2,0;1,0;;;;;;;;;1,0;3,0;;;1,0;;;;;;;4,0;;;96,0;4,0;70,0;;2,0;;;2,0;7,0;;;;;;;1,0;;20,0;1,0;;;;13,0;;;21,0;13,0;;;;;;;;;;1,0;;;;22,0;;;;4,0;10,0;;;3,0;;3,0;;1,0;;15,0;;21,0;;5,0;17,0;;5,0;4,0;;6,0;;2,0;3,0;4,0;1,0;;5,0;14,0;;;;3,0;;;9,0;3,0;4,0;;;;;3,0;3,0;2,0;4,0;6,0;1,0;130,0;;;2,0;5,0;2,0;1,0;1,0;1,0;6,0;;;;;16,0;3,0;;;8,0;2,0;28,0;1,0;;12,0;;1,0;3,0;28,0;18,0;;5,0;;;;;;5,0;;6,0;17,0;4,0;11,0;;54,0;;;1,0;3,0;;5,0;1,0;;14,0;10,0;14,0;;;;;10,0;;;;;1,0;;1,0;1,0;5,0;2,0;5,0;;;;2,0;14,0;;;;;;3,0;;;;5,0;1,0;;1,0;;;48,0;;;6,0;;;;2,0;;;;3,0;1,0;17,0;;2,0;;3,0;1,0;;3,0;6,0;;;4,0;;13,0;10,0;;;;;1,0;;7,0;2,0;;;;;;;;;;;;;;;1,0;;;;16,0;;;;6,0;;;;;30,0;;;;3,0;;;;;;1,0;;1,0;;;2,0;;;;2,0;;;5,0;3,0;;4,0;;;11,0;57,0;;;;;1,0;23,0;;;3,0;;;1,0;;;;;;;;2,0;2,0;21,0;3,0;1,0;;;;;2,0;;;;;;2,0;;;;;;;4,0;;;;;;;;;;;;;;;;;11,0;3,0;;1,0;3,0;;;;;12,0;;;;;2,0;;;6,0;;;;;3,0;;;;;;;5,0;;4,0;;;;;;;;;;6,0;;;;;1,0;2,0;;;;;;;;2,0;1,0;;1,0;;;;;17,0;3,0;10,0;;;;;6,0;;;1,0;7,0;3,0;;;2,0;;1,0;1,0;;;;;;;3,0;;8,0;;;3,0;2,0;3,0;;;;;;;3,0;6,0;;;;;1,0;;7,0;;;4,0;;9,0;;;;;;2,0;;;1,0;21,0;1,0;8,0;3,0;;;;;;;2,0;11,0;4,0;2,0;1,0;2,0;1,0;3,0;5,0;1,0;3,0;;;;6,0;1,0;6,0;;2,0;;12,0;10,0;44,0;1,0;;2,0;;;;2,0;2,0;;1,0;;;;;;;;;;;;;2,0;1,0;;;4,0;;;;1,0;1,0;;;;2,0;;;2,0;;;1,0;;;1,0;6,0;;;;;;9,0;3,0;;2,0;3,0;;;;;;1,0;2,0;;;;;;;;;2,0;;;6,0;1,0;;2,0;;;;;;;;;;;;;;1,0;;;;1,0;;;;;;;;;;;;;;;;1,0;1,0;;;;;;;;;;;;;;8,0;;;;;;1,0;;9,0;;;131,0;;;;;;;2,0;1,0;6,0;;7,0;;5,0;;;4,0;;;;;;;;;;;;;6,0;;;;;;;;;;;;;;;;1,0;;;;;1,0;;;;1,0;1,0;;;;;;;;1,0;;;1,0;;1,0;1,0;;;;;;16,0;;;;;1,0;;;;;
event;;;1,0;3,0;59,0;;;59,0;10,0;94,0;;10,0;;;8,0;;;;7,0;18,0;4,0;10,0;7,0;;1,0;;;81,0;;105,0;24,0;89,0;39,0;44,0;29,0;2,0;4,0;2,0;;25,0;2,0;;;9,0;2,0;;;2,0;;;10,0;35,0;;7,0;;183,0;91,0;;2,0;10,0;;4,0;131,0;;;2,0;50,0;;61,0;5,0;1,0;;2,0;;;;;13,0;43,0;2,0;;56,0;6,0;7,0;;;3,0;;7,0;31,0;44,0;;1,0;27,0;;;;2,0;13,0;;3,0;199,0;;9,0;3,0;25,0;20,0;24,0;3,0;;6,0;;1,0;;1,0;;;;;1,0;;;2,0;9,0;;;14,0;1,0;;9,0;1,0;21,0;;;;14,0;5,0;;;2,0;;19,0;1,0;;;4,0;4,0;381,0;1,0;;;;1,0;;;3,0;;3,0;39,0;9,0;1,0;;;;;1,0;5,0;30,0;;;1,0;;13,0;2,0;17,0;2,0;1,0;14,0;;;;1,0;1,0;;1,0;1,0;;72,0;;12,0;;;;41,0;;1,0;;;5,0;2,0;;1,0;;1,0;;2,0;;1,0;1,0;4,0;;;;;3,0;84,0;14,0;;5,0;;;4,0;;1,0;;;;;;;;;;37,0;4,0;6,0;;65,0;36,0;;;4,0;2,0;;;2,0;3,0;;;;;;;;3,0;;;21,0;;;1,0;2,0;;;1,0;;;;;;;;;3,0;;16,0;;;;1,0;;;;2,0;;30,0;4,0;121,0;2,0;;;;;;;;;8,0;;;7,0;;32,0;1,0;;;;;;;2,0;;;;;;;;;;;22,0;;;;18,0;;;;;18,0;;;;15,0;2,0;;16,0;;;1,0;43,0;;;5,0;5,0;1,0;2,0;;10,0;3,0;2,0;17,0;;8,0;;;;;;6,0;;;;34,0;3,0;5,0;1,0;;31,0;;;;16,0;11,0;8,0;16,0;;;;23,0;1,0;2,0;10,0;17,0;4,0;;;4,0;52,0;4,0;20,0;1,0;;1,0;;;34,0;50,0;;33,0;5,0;8,0;;20,0;;2,0;7,0;1,0;13,0;;8,0;;30,0;;;3,0;;45,0;;102,0;;;3,0;25,0;;;3,0;3,0;59,0;15,0;;2,0;;;2,0;;;4,0;;;;3,0;;;15,0;;5,0;1,0;;7,0;11,0;18,0;23,0;;2,0;;;2,0;4,0;;;57,0;2,0;4,0;31,0;;14,0;7,0;73,0;;10,0;2,0;;;2,0;;;;1,0;4,0;3,0;;;1,0;1,0;2,0;1,0;;5,0;;13,0;;10,0;142,0;84,0;3,0;;;;;1,0;;3,0;;3,0;4,0;;4,0;;1,0;;2,0;7,0;17,0;2,0;;;;;;;11,0;;;;10,0;;;1,0;;;;3,0;14,0;;;;;7,0;;1,0;4,0;;;;;3,0;3,0;;7,0;;;3,0;24,0;;7,0;;;3,0;28,0;;;;;2,0;9,0;;;;;12,0;;;;39,0;;;;1,0;;5,0;1,0;2,0;3,0;6,0;;1,0;;7,0;1,0;;;;;;;;1,0;2,0;;;;;;1,0;;;;;;2,0;;;;1,0;3,0;;;5,0;;;;4,0;;;;;1,0;;;1,0;;;;;;1,0;;;;;;;;;;;;;9,0;9,0;;;;;;;;;3,0;;;;1,0;14,0;;;;;;;2,0;;5,0;1,0;;11,0;;35,0;;;1,0;;;;;1,0;;;;;;;;;;2,0;7,0;15,0;2,0;;3,0;;;;;2,0;1,0;34,0;;;2,0;;1,0;;;;;;;;;;;;;;;;;3,0;10,0;2,0;;;;;;;;;;;9,0;2,0;6,0;2,0;5,0;1,0;;;;;1,0;;1,0;;;;;;1,0;;;;;;1,0;;;;;;;1,0;;1,0;;;26,0;;;1,0;;;7,0;;;;1,0;;89,0;3,0;4,0;;;;;;2,0;;;;;;;3,0;;2,0;;2,0;11,0;8,0;;;2,0;1,0;;;;4,0;;;10,0;;;;4,0;2,0;;;5,0;;;1,0;;;1,0;;;;;;;;;;4,0;;;;20,0;1,0;;7,0;2,0;;;;;;;1,0;;;11,0;;;;;;4,0;;;1,0;;;;;;;;;;;;;;;;;;;61,0;;;3,0;;;;;;1,0;;;;1,0;1,0;;49,0;;;;;;;;;;1,0;;;5,0;;;;13,0;;;;;1,0;;;2,0;;;;;;;4,0;;;;2,0;29,0;;;;;1,0;;;;;;;;;;;;;;2,0;;;;;;1,0;;;;;;;;;;;;;;1,0;;;;;;;;2,0;;;;;
exceed;;;23,0;;9,0;;3,0;1,0;6,0;3,0;;1,0;;;3,0;1,0;;;1,0;3,0;9,0;5,0;3,0;;;1,0;;13,0;10,0;4,0;7,0;13,0;5,0;15,0;6,0;;;5,0;;5,0;;;1,0;5,0;2,0;4,0;;1,0;8,0;3,0;;4,0;1,0;;2,0;83,0;2,0;;14,0;4,0;;1,0;23,0;6,0;1,0;1,0;3,0;;;9,0;4,0;;;;;;;4,0;3,0;1,0;2,0;;5,0;;1,0;;5,0;;;6,0;3,0;2,0;;25,0;12,0;;;;6,0;;9,0;15,0;;;4,0;;;12,0;;;;1,0;1,0;;;1,0;;1,0;;;;;;6,0;;;2,0;1,0;4,0;;;;;;;;;;;;;;;;1,0;3,0;;5,0;;;;;;;;;;7,0;7,0;3,0;1,0;1,0;;;;1,0;18,0;10,0;;;6,0;1,0;5,0;2,0;3,0;;;8,0;;;1,0;;;;;;;3,0;;17,0;;;;;;10,0;;1,0;;;;6,0;;1,0;;9,0;;;;;;;3,0;;3,0;39,0;;1,0;;;10,0;;1,0;;1,0;;4,0;;;;;;;1,0;1,0;28,0;;1,0;6,0;;;;;;;1,0;;;;;;;;;2,0;;2,0;;;2,0;;5,0;;1,0;;;;;;;;;;;;;;;15,0;;;;3,0;4,0;;15,0;1,0;30,0;13,0;;;;6,0;1,0;;;;8,0;;;;;78,0;;;;;8,0;;;21,0;2,0;;;;;;;;1,0;;5,0;;;;1,0;;;2,0;;1,0;;;;;2,0;;;;1,0;;6,0;;;7,0;1,0;1,0;;;2,0;;1,0;;;;;;;;;1,0;;;;;8,0;1,0;;2,0;1,0;13,0;;1,0;6,0;1,0;1,0;;3,0;;;11,0;;;;;4,0;1,0;3,0;1,0;10,0;;4,0;;;2,0;4,0;;4,0;152,0;2,0;12,0;;;2,0;;;;1,0;;;;;;;;;3,0;;2,0;1,0;;3,0;;1,0;7,0;;;;2,0;2,0;;;;;;;;;;;;;;;;3,0;;;1,0;;;5,0;7,0;2,0;;1,0;;;;;1,0;;;12,0;;1,0;;;2,0;;;;;;;21,0;;;3,0;;4,0;;6,0;;;;;1,0;1,0;;;4,0;5,0;;1,0;8,0;;4,0;5,0;;;;;;2,0;;;;2,0;;;;;;;;;;;4,0;;;;;;5,0;;;;1,0;;;;;;4,0;;2,0;;;;;;;;;;;4,0;;2,0;;;;3,0;;;;;2,0;18,0;3,0;;;;;1,0;;;;;;;;;;;;2,0;;;;;;;;;;;;1,0;;;;;;;;;;;;12,0;;;;;1,0;;;;;;;;;;;;1,0;;;11,0;;;;;;;;;;;;;;1,0;;;;;;;;;;;;;1,0;2,0;;;;;;;;14,0;;2,0;;;;;;;;;;;;;;;;;;;;4,0;;1,0;14,0;;;;2,0;9,0;;;;;1,0;;;;;;;6,0;;;;4,0;4,0;;1,0;7,0;3,0;;;;;;;;;3,0;;;;;;;;;;1,0;2,0;;;;1,0;;;;;;;;;;;;;;;;;;;;;;;;4,0;2,0;1,0;;2,0;;;;;;;1,0;;3,0;;;;2,0;;20,0;;;1,0;;;;;3,0;;5,0;;;;;;;;;6,0;;;;;;;;;;;4,0;;1,0;4,0;;5,0;;;;;;;;;;;;;;;;;3,0;;;;3,0;;;;;;1,0;;;;;2,0;;2,0;;;;;;;;;;;;;;;1,0;;;;;;3,0;;;;;;;;;;;;;;;;;;;;;;;;;;1,0;;;;;;;1,0;1,0;;;;;;;;;;;;;;;;;;;;;1,0;;;;;;;;;;;;;;;;;;;;;;;1,0;;;;;;;;;;;;;;;;;;;;;;;;;;;1,0;;;;;;;2,0;;;;;;;;;;;;10,0;;;;;;;;;
executable;;;3,0;;8,0;;;;;4,0;;;;;;;;;;86,0;;20,0;;;2,0;;;6,0;;1,0;;4,0;22,0;;19,0;;1,0;;;1,0;;;;1,0;;;;;2,0;;3,0;4,0;;;;20,0;30,0;;;2,0;;;13,0;;;2,0;1,0;;;6,0;1,0;;1,0;;;;;;;;;7,0;52,0;;;;;;1,0;2,0;3,0;;;2,0;;;;6,0;41,0;;;8,0;;;5,0;;;4,0;;;;5,0;;;;;;;;;;;;;;;16,0;1,0;;2,0;;;;;;;;;;;;;;;;;2,0;2,0;;;;;;;;;;;;4,0;;;;;1,0;;;1,0;;;;;6,0;;1,0;;;2,0;;;;;;;;1,0;;4,0;;27,0;;;;2,0;;;;;;;;;;;;;;;3,0;;;21,0;;;;;1,0;;;;;;;;;;;;;;;;;;;;;;;;;;;;;;;;;;;;;;;;;;;;;;;;;;;;;;;;;;;2,0;;;;;;;;;;;;;1,0;;;;;1,0;;;;;;;;;;;;;;;;;;;;;;;;;;;;2,0;;;;;;;;;11,0;;;;;;;;;;;;;;;;;;;1,0;;;5,0;;4,0;;;;;;;;;;1,0;1,0;1,0;;;;;;;;38,0;13,0;;;;;;;19,0;94,0;;;;;12,0;1,0;;2,0;;;;;;;1,0;;;;;;;;1,0;;;;;1,0;;1,0;;2,0;2,0;;7,0;1,0;;3,0;3,0;;;;;1,0;;;1,0;;;;;1,0;;;;;;;;;5,0;11,0;;;;;;19,0;;3,0;;;;;73,0;;;;;;;;;;2,0;;;26,0;;;;;;;;;;;;2,0;;;;3,0;;3,0;;4,0;;;2,0;;;;;;;2,0;2,0;;;;;;;;;;;57,0;;;;;;;;;;;;;2,0;;;;;;;;2,0;;;;;;;;;;;;;15,0;;;4,0;4,0;;;4,0;;;;;;;;;;;;;;;1,0;;1,0;;2,0;;;;1,0;;;;;1,0;1,0;;4,0;;;;;2,0;;;;;;;;;;;;;;;2,0;;;;;;;;;;;;;;;;;;;;;;;1,0;;;;;;;;;;;;;1,0;;;;1,0;;;;;;;;;;;;;;;;;1,0;;;;;;;;;;;;;;;;;;;;1,0;;1,0;;;;;;;;;;;;;;;;;;;;;;;;;2,0;;;;;;;;;;;;;;;;;;;;;;;1,0;;;;;;1,0;;;;;;;;;;;;;;;;;;;;;;;;;;;;;;;;2,0;;;;;1,0;;;;;;;;;;;;;;;;;;;;;1,0;;;;2,0;;;;;;;1,0;;;;;;;;;;;;;;;;;;;;;;;;;;;;;;;;;;;;;;;;;;;;;;;;;1,0;;;;;;;;;;;;;;;;;;;;;;;;;;;;;;;;;;;;;;;;;;;;4,0;;;;;;;;;;;;;;;;;;;;;;;;;;;;;;;;;;;;;;;;;;;;;;;;;;;;;;;1,0;;;;;;;;;;;;;;;;;;;;;;;;;;;;;;;;;;;;;;;;;;;;
expose;;;1,0;;5,0;;3,0;21,0;;15,0;;;;;2,0;;;;;;3,0;12,0;;;;1,0;;7,0;;;1,0;4,0;27,0;1,0;20,0;;15,0;6,0;;39,0;;;1,0;15,0;;;1,0;2,0;2,0;;1,0;4,0;;4,0;;197,0;14,0;;6,0;97,0;1,0;;20,0;;;5,0;;3,0;;30,0;7,0;;;;;15,0;;;70,0;3,0;3,0;;2,0;;;1,0;4,0;;;2,0;43,0;1,0;;35,0;2,0;2,0;1,0;;4,0;21,0;108,0;8,0;;;;19,0;;47,0;;;3,0;11,0;12,0;18,0;1,0;;;;7,0;44,0;4,0;;;4,0;;;6,0;14,0;;3,0;44,0;2,0;1,0;;;9,0;14,0;4,0;2,0;8,0;2,0;;10,0;13,0;4,0;4,0;20,0;8,0;;;;2,0;1,0;;;7,0;19,0;52,0;;15,0;2,0;;8,0;1,0;;12,0;3,0;28,0;;4,0;12,0;;15,0;18,0;2,0;35,0;19,0;6,0;;;9,0;14,0;3,0;;4,0;4,0;26,0;33,0;;50,0;4,0;2,0;;4,0;;;;;9,0;;7,0;;3,0;43,0;;;;;;6,0;3,0;;1,0;;;20,0;4,0;11,0;;;5,0;;;;1,0;;21,0;;;;;;;2,0;1,0;;;1,0;10,0;1,0;8,0;1,0;12,0;9,0;;17,0;;6,0;4,0;;1,0;;9,0;6,0;;;;3,0;1,0;;;;3,0;;4,0;1,0;7,0;2,0;;;1,0;18,0;5,0;2,0;;1,0;;;;5,0;6,0;2,0;;2,0;4,0;9,0;9,0;31,0;1,0;5,0;;;;12,0;;1,0;;1,0;;;4,0;1,0;7,0;;2,0;;;1,0;4,0;1,0;1,0;6,0;9,0;1,0;;;7,0;;1,0;4,0;;13,0;2,0;4,0;;9,0;2,0;;1,0;;2,0;;;;;2,0;1,0;;;;1,0;2,0;;;;1,0;;9,0;;;4,0;;;;;;;;;;;;;;;;;;;;;;;2,0;6,0;;3,0;;;1,0;13,0;1,0;;;;;;;;7,0;;2,0;3,0;;23,0;;;;;;2,0;;;;;;;4,0;;;2,0;4,0;6,0;;;;;;;1,0;22,0;;;5,0;;1,0;;10,0;1,0;8,0;;1,0;;;;;;;;;2,0;;;;1,0;8,0;1,0;;;;;;1,0;1,0;;;;;;;;;;1,0;2,0;2,0;2,0;;4,0;;;1,0;;;;;3,0;;;;;;;;;3,0;7,0;;;;;2,0;1,0;1,0;1,0;1,0;;1,0;;;1,0;;;;21,0;;;;;2,0;3,0;;;;3,0;6,0;8,0;;;;;;;;;2,0;5,0;;;;;;;;;;1,0;;;;1,0;;;1,0;;;;;;8,0;3,0;;9,0;;;;2,0;;;;45,0;;;;;;4,0;;;;;;;;2,0;1,0;;;1,0;;;;4,0;5,0;;23,0;;;;;;;;;;1,0;1,0;;;;;;22,0;;;;;;;1,0;;13,0;;;;1,0;;;;;;2,0;;;;;;3,0;2,0;;;1,0;;1,0;;4,0;2,0;3,0;;5,0;;;1,0;;1,0;;;;;;1,0;7,0;;2,0;;6,0;2,0;1,0;3,0;;;;;;1,0;2,0;;;1,0;1,0;;;;;2,0;;3,0;1,0;;;;6,0;;;;;;3,0;1,0;;;;;;;;;1,0;6,0;;;;;;3,0;3,0;4,0;1,0;;2,0;;4,0;;;;;;;;;2,0;;;;;1,0;;;;;;;;;;;;;;;;2,0;;;;;;1,0;;;;;;;;;4,0;;;;;;;1,0;;2,0;;;;;;;;;;2,0;;;;;;;;;;;;;;;;;;;;;;10,0;;;;;;;;;1,0;;;;;;;;;;;;;;;;1,0;;4,0;1,0;;;1,0;;;2,0;;;;;1,0;;;;;;;;;;;;;1,0;;;;;;;1,0;;;;;;2,0;2,0;1,0;;2,0;2,0;;;;;;;3,0;;;;;;;10,0;4,0;;;;2,0;;1,0;;;;;;;;;;;;;;;;;;;;;;;;;3,0;;;;;;;;;;;;;;;;;;;;;4,0;;;;;;;;;;;;;;;;6,0;3,0;2,0;;;;;;;;;;;1,0;;;;;;;;;;;3,0;;;;1,0;;;;;;;;;;;;;4,0;;;;;;;;
expression;;;4,0;;6,0;;7,0;5,0;7,0;2,0;;2,0;;;4,0;;;;;;4,0;12,0;;;;;;1,0;3,0;;3,0;;2,0;6,0;;;;;;5,0;14,0;;;37,0;;;;44,0;1,0;;2,0;;;34,0;3,0;24,0;4,0;;37,0;221,0;2,0;;5,0;4,0;1,0;;;;;1,0;7,0;3,0;;;;;;1,0;;13,0;;3,0;;;6,0;;;;10,0;;2,0;2,0;13,0;;3,0;1,0;;;;;15,0;14,0;;;;;;12,0;;;7,0;1,0;;;;;;;;;;;;2,0;;;6,0;;;;;;;;;;;;;;;;;2,0;2,0;;1,0;;;;;;;;1,0;;;;;18,0;;;;;;2,0;;3,0;;;;;;;;1,0;;2,0;;;;;;;;4,0;;;;4,0;;;;;;;10,0;;;;;;;11,0;;;;;;;;;;;;2,0;;;;;;;;;;;;;;;;;;;;;;;1,0;;;;;;;;;;;;;;;;;;;;;3,0;;;;;;;;;;;;;;;;;6,0;;;;;;;;;12,0;;15,0;;;;;;;;;;1,0;;;;;6,0;;;;;;;;1,0;;;;;;;;;;;;;;;;;;;;;;;;;1,0;;;;;;2,0;;;;;2,0;;;3,0;;;;;2,0;;;;;;7,0;;;;;4,0;;;;;;;;;;;;;;;;1,0;;;;;;;;;;;;;;;;;2,0;2,0;;;;;;;;39,0;;;;;;;;;1,0;;;;;;;;2,0;;;;2,0;;;;;;;;;;;;;;;;12,0;;4,0;;;;;4,0;;;;;;;;;;;;4,0;;;;;;;;;;;;;;;;;;;;;;;;;;9,0;;;;;5,0;3,0;;;;;;;;;2,0;;;;;;;;;2,0;;;;;;;;;;;;;;;;;;;;;;4,0;;;;;;;;;;;;;;;;;;;;;;;;;;;;;;;1,0;;;;;;;;;;;;;;;;3,0;;;;;;;;;;;;;;;;;;;;;;;;;;;;;;;;;;;;;;;;;;;;;;;;;;;;;;;;;;;;;;14,0;;;;;4,0;;;;;;;;;;;;;;14,0;;;;;;;;7,0;;8,0;;;;;;;;;;2,0;;;;;;;;;1,0;;8,0;;;;;;;;;1,0;2,0;;;;;4,0;;;;;;;;;;;;;;3,0;;;;;;1,0;;;3,0;;;;;;;;1,0;;;1,0;;;3,0;;177,0;;;;;;;12,0;;;;;;;;4,0;2,0;;;;;;;;;;;;;;;;;;;5,0;;;;;;;;;;;;;;;;;1,0;;;;;;;;;;;;;;;;;;;;;;;;;;;;;;;;;;;;;;;;;;;;;;;;;;;;;;;;;;;;;;;;;;;;;;;;;;;;;;;;;;;;;;;;;;;;;;3,0;;;;;;;;;;;;;;2,0;;;;;;;;;;;;;;;;;;;;;;;;;;;;;;;;;4,0;;;;;;;;;;;;;;;;;;;;;;1,0;;1,0;;;;;;;;;;;;;;;;3,0;;;;;;;;;;;;176,0;;;;;;
extract;;;38,0;10,0;31,0;;;65,0;38,0;18,0;11,0;24,0;;4,0;22,0;6,0;5,0;4,0;66,0;1,0;9,0;32,0;2,0;12,0;4,0;3,0;;160,0;2,0;21,0;18,0;35,0;51,0;14,0;19,0;2,0;;8,0;;10,0;8,0;3,0;1,0;4,0;;1,0;;3,0;4,0;27,0;1,0;41,0;3,0;5,0;;507,0;58,0;2,0;7,0;10,0;;1,0;88,0;;5,0;1,0;20,0;;;7,0;4,0;1,0;23,0;;;8,0;;69,0;60,0;;;46,0;18,0;;;;121,0;1,0;11,0;29,0;14,0;5,0;11,0;106,0;13,0;;;4,0;8,0;;8,0;20,0;;;2,0;;1,0;180,0;1,0;;1,0;2,0;2,0;;;3,0;;1,0;1,0;2,0;;;;5,0;;2,0;28,0;;1,0;;4,0;2,0;;2,0;;1,0;;;;;;;1,0;78,0;20,0;;7,0;147,0;2,0;;2,0;;;;;4,0;;2,0;11,0;31,0;1,0;;;;;;14,0;5,0;;1,0;;;17,0;;15,0;;;30,0;;;;2,0;2,0;;;7,0;;83,0;;19,0;;;;21,0;1,0;4,0;;;16,0;;;;;1,0;;6,0;;;7,0;;2,0;;;;2,0;15,0;7,0;;;;3,0;;2,0;;;;5,0;;;;2,0;;;;10,0;6,0;;6,0;83,0;1,0;;;16,0;;;1,0;2,0;4,0;;;;;;5,0;;3,0;;2,0;12,0;;3,0;2,0;17,0;;;;;;;;;;;4,0;3,0;;;;;6,0;;;;;2,0;17,0;;147,0;9,0;;;;1,0;9,0;;;;19,0;;;;;35,0;;;;;18,0;;;29,0;4,0;;;;;;;;;;12,0;;;;;;;3,0;5,0;8,0;3,0;;;;1,0;;;1,0;8,0;;9,0;;14,0;2,0;;8,0;;;11,0;3,0;;4,0;;5,0;;1,0;;;;4,0;;;;4,0;5,0;;;11,0;;1,0;;;4,0;5,0;5,0;5,0;6,0;;1,0;1,0;21,0;1,0;7,0;;4,0;;2,0;1,0;22,0;1,0;3,0;2,0;;1,0;;;22,0;13,0;3,0;4,0;;1,0;6,0;3,0;8,0;;3,0;1,0;;;6,0;;17,0;;9,0;117,0;;21,0;;9,0;;;;26,0;6,0;1,0;1,0;;26,0;6,0;8,0;;;;;;;;;;16,0;1,0;7,0;1,0;2,0;1,0;2,0;2,0;;1,0;1,0;;1,0;;3,0;9,0;;6,0;;;;;3,0;2,0;2,0;;2,0;101,0;;2,0;19,0;;;;10,0;10,0;;1,0;5,0;7,0;4,0;;;2,0;5,0;2,0;3,0;;17,0;;;;;43,0;15,0;;;1,0;3,0;;;;9,0;;;2,0;;;;;;;5,0;;;;1,0;;;;;8,0;2,0;;;2,0;;4,0;;;;1,0;;2,0;4,0;;3,0;;;;10,0;;1,0;;;1,0;;;;13,0;3,0;;;3,0;;2,0;;1,0;27,0;51,0;;;;;3,0;6,0;;;5,0;;2,0;;;;;3,0;;;1,0;;9,0;15,0;;;;;;1,0;;;;;;;;;;;1,0;;;12,0;;;;;;;1,0;;4,0;;;;;4,0;;;1,0;;;;2,0;;;;2,0;;1,0;;;;;12,0;;23,0;;;;;4,0;;;;2,0;1,0;;3,0;;;15,0;;;;;;;;2,0;2,0;;;;;1,0;;;;;;;;;2,0;;6,0;;;;2,0;1,0;11,0;14,0;11,0;;;;3,0;;;2,0;2,0;;2,0;;1,0;15,0;4,0;2,0;;;;;44,0;;;;;3,0;;1,0;;2,0;2,0;;;;5,0;;;4,0;;;;1,0;2,0;1,0;;;;6,0;10,0;;4,0;;1,0;;4,0;;;3,0;;6,0;;;8,0;3,0;1,0;5,0;;;1,0;1,0;9,0;4,0;3,0;;;2,0;;2,0;;18,0;4,0;;5,0;1,0;10,0;;1,0;;;;;2,0;16,0;1,0;;6,0;;1,0;;6,0;7,0;;4,0;1,0;2,0;;;;;;;;;;71,0;;;;;;;11,0;;;8,0;;2,0;;;1,0;;;;5,0;1,0;;;;3,0;;;2,0;;;;4,0;;;;;;;3,0;;2,0;;;1,0;;;2,0;;;;3,0;;;;4,0;2,0;2,0;15,0;2,0;;;;5,0;;;;;2,0;;;;;;;;;2,0;;;;;1,0;;;;4,0;;;;;;;;;4,0;;;;1,0;1,0;1,0;;10,0;;;1,0;;;;;1,0;;;;;;1,0;3,0;2,0;;;;2,0;8,0;;5,0;;2,0;3,0;1,0;;;;5,0;2,0;;;;1,0;;;;;;1,0;18,0;;1,0;;7,0;;;;;;;;2,0;1,0;;;2,0;2,0;;;;;;;;;2,0;3,0;5,0;;7,0;;;;;2,0;;1,0;8,0;;;;;;;;;4,0;;1,0;;;;;;;
extraction;;;6,0;;9,0;;;8,0;6,0;;;10,0;;;13,0;;;;9,0;1,0;2,0;13,0;;1,0;6,0;;;7,0;1,0;12,0;1,0;4,0;15,0;7,0;3,0;;;4,0;;2,0;;;2,0;1,0;;;;;2,0;6,0;;;;;;49,0;9,0;2,0;;1,0;;;8,0;;3,0;;1,0;;;;5,0;1,0;5,0;;;;;9,0;5,0;;;1,0;4,0;;;;37,0;;4,0;5,0;4,0;3,0;;18,0;5,0;2,0;;1,0;;;;8,0;;;;;;53,0;;;;;2,0;;;2,0;;;;;;;1,0;;;;15,0;;;;3,0;;;2,0;;;;;;;;;;17,0;1,0;;1,0;11,0;;;;;;;;;;;;6,0;;;;;;;;;;;;;;;4,0;;;5,0;;;;;;1,0;;;;2,0;;4,0;;;;;;;;;8,0;;;;;1,0;;1,0;;;11,0;;;;;;1,0;16,0;;;;;;;;;;;;;;;;;;1,0;;;;;30,0;;;;;;;;2,0;;;;;3,0;;3,0;;;;1,0;;;1,0;;4,0;;;;;;;;;;;;;;;;;1,0;;;;2,0;;;5,0;11,0;;;;;;;;;;2,0;;;;;7,0;1,0;1,0;;;1,0;;;4,0;;;;;;;;;;;;;;;1,0;;;;;3,0;1,0;;;;;;;2,0;;;;2,0;;1,0;;1,0;1,0;;;;3,0;;;;;1,0;;;;;;;;2,0;1,0;;;;;;;;;;;;4,0;;;;;;;;2,0;;;;;;;2,0;;;;;2,0;8,0;;;;;5,0;;7,0;;2,0;1,0;;;;;;;;9,0;;;;;;;;;;;1,0;;;;;;;;;;1,0;;;;;;7,0;;1,0;3,0;1,0;;;;;3,0;5,0;;;;;2,0;;;;;;;;;;3,0;;1,0;13,0;;;;;;;;1,0;;;;;;;1,0;;;1,0;;;;;13,0;;;;;;;;;;;;;;;;;;;;;;;;;;;;;1,0;;;2,0;;;;;;;;2,0;2,0;;;;;;;;;;;;;;;;;;;1,0;;1,0;;;;7,0;;;;;;;;;;;;;;;;;;;;;;8,0;;;;;;;;;;;;;;;;;;;;;;;;;;;;;;;;;;;;;;;;;;;;;;;;;;;;;;;;;;;2,0;;;;;;;;;71,0;;;;;;;;3,0;;;;;;;;2,0;;;;;;;;;;;;;;;1,0;1,0;11,0;;;;;;;;;;;1,0;;;2,0;;2,0;;;;;3,0;;;;;;;;;2,0;;;;;;;;;;;;;1,0;;;;1,0;;;1,0;;;;;;;;;;;;;2,0;;;1,0;;;;2,0;;;;;;;;;;;;1,0;;;;;1,0;;;;;;;;;;;;;;;;2,0;;1,0;;;;;;;;;;;;;;;;;2,0;;;;;;;;;;;;;;;;;;;;;;;;;;;;;;;;;;;;;;;;;;;2,0;;;;;;1,0;;1,0;;2,0;;;1,0;;;;;;;;;;;1,0;;;;;;;;;;;;;;;;;;;;;;;;;;;;;;;;;;;;;;;;;;;;;;;;;4,0;;;;;;;;;;;;;;;;;;;;;;;;1,0;;;;;;;;;;;;;;;;;;;;;;;;;;;;;;;;;;;;;;;;;;1,0;;;3,0;;;;;;;;;
facial;;;3,0;;7,0;;;17,0;11,0;5,0;;;;;2,0;;;;;1,0;2,0;1,0;;16,0;1,0;;;8,0;;9,0;2,0;5,0;22,0;3,0;;;1,0;;;;1,0;;;1,0;;2,0;;;1,0;;;6,0;;;;169,0;9,0;;;;;;19,0;;;;;;;;;3,0;;;;53,0;;4,0;15,0;;;7,0;1,0;2,0;;;20,0;;;;;2,0;;2,0;;;;2,0;12,0;;;7,0;;;;;;3,0;;;;;;3,0;;;;;;5,0;;;;;;4,0;2,0;;;;;2,0;;;;2,0;;;;;;2,0;;38,0;;;2,0;31,0;1,0;;;;;;;;;;;5,0;;;;;4,0;;;;;;2,0;;7,0;11,0;13,0;1,0;;;;;5,0;;;;;;;3,0;;4,0;;;;1,0;;;;;;;;;2,0;;;1,0;;;;1,0;;;;;;;1,0;;;;4,0;10,0;;;;;;;;;;;;;;;;;5,0;;;;;;;;;;;;2,0;1,0;;;;;;;;;;;;;;;;;;;;;;;;;;;;;;;;;;6,0;;11,0;;;;;;4,0;;;;3,0;;;3,0;;5,0;1,0;;;;;;;1,0;1,0;;;;;;;;;;;;;;;;;;;5,0;;;;;;;;;;;1,0;;6,0;;;;;;3,0;;1,0;;;1,0;;;;;;;;;;4,0;2,0;;;;;;;;1,0;2,0;3,0;;;;;;;;3,0;;;;;;;;1,0;;;;;;95,0;;;5,0;;;;1,0;;;1,0;;;;;;;;;80,0;;2,0;;1,0;;;;;;;;;1,0;;;;;;;;;;;;32,0;;;;1,0;;;2,0;;;;;;;;;;;;;1,0;;;;;;;;;;14,0;;;;;;;14,0;16,0;11,0;;;;;;;;;;;;;;12,0;;;;;;;;2,0;;;;;;;;;;2,0;1,0;;;;;8,0;;;;;;;;;;;;;;;;;1,0;;;;;;;;;;;;;;;8,0;;;;1,0;;;;;;;;;;;2,0;;;;;;;;;;;;3,0;;;;1,0;15,0;2,0;;;;1,0;;7,0;;;;;;;;;;;;;18,0;;;;;;;;;;;;;;1,0;;;;;;;;;;;;1,0;;;;;;;;;;;;;1,0;;;;;;;;;8,0;;;;;;;;;;;;;;;;;;;;;;;;;;;;;;;;7,0;8,0;;;;;;;;;;3,0;9,0;;;;;;;;;;;;;;4,0;5,0;;;;;;;;;;;;1,0;;;;;;;;;;;4,0;;;;;2,0;1,0;;;;;;;;;;1,0;;;;;;;;;;;;;;;;;;;;;;;;;;;;;;;;;;;4,0;;;4,0;;;;;;;1,0;;;;;;;;;;;;;;;;;;;;;;;;;;;;;;;;;;;;;;1,0;;;;;;;;;;;;;;;;;;;;;;;;;;;;;;;40,0;;;;;;;;;2,0;;;;;;;;;;;;;;;;;;;;;10,0;2,0;;;;;;;;;;;;;;;5,0;;7,0;;;11,0;;;;;;;1,0;;;2,0;;1,0;;;;;;;;;;;;;;;;;;;;;;;;;;;;;;;;;;;;;;;;;;;;;;;2,0;;;;;;;;;;;;;;;;;;;;;;;;;;;
factor;;;9,0;;8,0;;;74,0;28,0;5,0;3,0;2,0;;1,0;28,0;6,0;5,0;3,0;1,0;2,0;16,0;18,0;3,0;20,0;71,0;;;17,0;8,0;;5,0;81,0;24,0;12,0;17,0;;;12,0;5,0;63,0;8,0;;;3,0;;;;;16,0;1,0;9,0;9,0;;5,0;;208,0;16,0;;4,0;26,0;2,0;153,0;68,0;24,0;5,0;6,0;4,0;;;3,0;3,0;;2,0;;;1,0;;48,0;25,0;2,0;;25,0;5,0;6,0;;;2,0;;14,0;20,0;6,0;24,0;6,0;7,0;7,0;2,0;;3,0;8,0;;;14,0;;;2,0;;1,0;34,0;;;;;;;;;;;;;;;7,0;3,0;;1,0;11,0;;2,0;;;;;;1,0;2,0;;;;;4,0;;;17,0;4,0;;5,0;1,0;1,0;;14,0;;;;;;1,0;1,0;4,0;5,0;;5,0;;;;;7,0;6,0;;;;;3,0;1,0;1,0;;;10,0;;;;;;;;2,0;;58,0;;;;;;2,0;;2,0;;;;;;2,0;;2,0;;1,0;;;;;4,0;;;;1,0;25,0;;;;;;2,0;2,0;;;;;;;;;;;14,0;19,0;6,0;;9,0;13,0;;;;2,0;;;4,0;1,0;;;;5,0;53,0;;2,0;;;;4,0;2,0;;2,0;4,0;7,0;;;;;;;;;;;;;;;;2,0;;;;;2,0;;;1,0;3,0;;;1,0;;;1,0;;2,0;;2,0;;;;;23,0;;;;;14,0;2,0;;7,0;29,0;;;;;;;;;;;;;;;;;;1,0;9,0;1,0;;;;2,0;;;;2,0;;12,0;;3,0;2,0;;2,0;;;7,0;2,0;3,0;17,0;1,0;;;1,0;;;;3,0;2,0;;;;21,0;;1,0;;1,0;;;3,0;12,0;1,0;2,0;;5,0;;1,0;3,0;2,0;5,0;1,0;;;;4,0;1,0;1,0;;3,0;;;2,0;8,0;4,0;;4,0;;3,0;;;4,0;25,0;;;43,0;;;;;;3,0;;;1,0;;65,0;;11,0;;;1,0;6,0;;8,0;;8,0;2,0;;6,0;;;;;;3,0;;;;2,0;;;;8,0;8,0;1,0;20,0;;;;8,0;;;;;2,0;2,0;;;;1,0;7,0;;2,0;;1,0;19,0;;;3,0;;;;;;;;;;1,0;;;;;;;7,0;13,0;2,0;;;;1,0;6,0;10,0;;;;;;;1,0;4,0;;;;;;;;;1,0;;;;;;;;;7,0;1,0;;;1,0;;;3,0;;;;;;25,0;;;;;;10,0;2,0;;;;;;;;30,0;;;1,0;3,0;;;1,0;;;67,0;;;;;;;;;;;;;;;;;;;;1,0;3,0;8,0;;;;;;;12,0;;;;3,0;6,0;;;;6,0;;;;18,0;;;;;;;;;;;;;;;;;1,0;;;1,0;;;;;;;;;;;1,0;;;2,0;;;;;;;;;;;;;1,0;2,0;;;;;;;;3,0;;;;;;;;;;;;;1,0;;;;1,0;;42,0;;7,0;;1,0;33,0;3,0;6,0;;;;;;;;;8,0;;;;2,0;3,0;;;;;7,0;;1,0;;;2,0;3,0;;;;1,0;;;;;2,0;;;;;;;;;;;2,0;1,0;;1,0;11,0;;;;7,0;;;2,0;;;;1,0;26,0;15,0;5,0;10,0;5,0;;;;2,0;20,0;12,0;4,0;4,0;;;;;;;;;;;9,0;;;;;;;;4,0;;;;;;;;3,0;;;4,0;4,0;;;;;;;7,0;;;1,0;;;;;;;;;;;1,0;;;;;;;;;;;;;2,0;;;2,0;;;1,0;;;;2,0;;;;;;;1,0;;1,0;;;;;;;;;;;;;;2,0;;;11,0;;;;2,0;;1,0;;;;;;;;3,0;;;;2,0;;;;;;;;;;;;;;;;;;;;1,0;;;;4,0;;;;;;;;4,0;;;7,0;;;1,0;2,0;;;;;;114,0;;1,0;;1,0;;;;;;;;;;;;;;;;8,0;1,0;4,0;;3,0;;;;;;;;;;;;;;;;;;;;;;;;;2,0;4,0;;;;;;;;;;9,0;;;;;1,0;;;;;;;;;;;;;
feedback;;;26,0;;16,0;;;4,0;8,0;7,0;;;;;;3,0;;;;1,0;1,0;71,0;;3,0;2,0;;;13,0;;;;1,0;17,0;2,0;5,0;;;;;2,0;2,0;;2,0;;;;;;;;;7,0;1,0;;;15,0;12,0;;;7,0;;;15,0;;;4,0;;;;;;;7,0;;;;;2,0;25,0;1,0;;1,0;1,0;;;;3,0;;1,0;;3,0;;;72,0;;;1,0;;;;;12,0;;;;;;40,0;;;1,0;;;;;;;;;;;;4,0;24,0;;;17,0;;;;;;;;;;;;;;;;;;;;1,0;8,0;;1,0;;;;;;1,0;;2,0;;;;;;;;;;;;;;;1,0;4,0;1,0;;;20,0;;;;;;;;;;;;;;;;15,0;;;;;2,0;;;2,0;;;;;;;;;;;1,0;;3,0;8,0;1,0;;;;;;15,0;;;;;;;;;;1,0;;4,0;;;8,0;;;1,0;;;;;;;;;;;;;5,0;;;;;;;;6,0;;;;;;;;;;;;;;2,0;;;2,0;;;;;;;24,0;1,0;2,0;2,0;;;;;1,0;;;;;;;;;2,0;;;;;;;;3,0;;;;;;;;;;;;;;;;;;;;5,0;8,0;;;;;;;;;;;;;;;;;;3,0;;;;2,0;;7,0;;;;;;;;3,0;;1,0;;2,0;;;;;;;;;3,0;;;;4,0;;;;;;4,0;;;;;3,0;;;;;6,0;6,0;1,0;;1,0;;;;;;;;;;2,0;1,0;;;;;;;1,0;;2,0;2,0;4,0;;;;;;;;;;1,0;;;;2,0;;;;;;;;;2,0;1,0;4,0;;;;;3,0;7,0;;;;;1,0;;;;4,0;;;1,0;;;1,0;;;4,0;;;;;;;;;;;;;;;;;;2,0;;4,0;;;;3,0;;5,0;;;;;;;;;;;;;;;;;;;;;;;;;;;;;;;;;;;;1,0;;4,0;;;;;;;;;;;;;;;1,0;;;;;;1,0;;;1,0;;;;;;;1,0;;;;;4,0;;;;;;;;;;;;;1,0;;;;;;;;;;;2,0;;;;;;;;;;;;3,0;;8,0;;;;;;;;;;;;;;;;;;;;;;;;;;;;;;;;;;;;;;;;;;;;;;;;;;;5,0;;;;;;;;;;;;;;;;;;;;;;;;;3,0;;;;;;;;;;;;;;;;;;;;;;;;;;;;;;;;;;;;;;;;2,0;;;;;;;5,0;1,0;;;;;;;1,0;;1,0;;1,0;15,0;;;;;;;;;;;;22,0;1,0;;;;;;;;;3,0;;;;;;;;;;2,0;;;;;;;;;;3,0;;;;;;;3,0;;;;;;;;;;;;;;;;;;;5,0;3,0;2,0;;;;;;;;;;;;;;2,0;;;;;;;;;;;;;;;;;;;;;;2,0;;;;;;;;;;;;;;;;;1,0;;;;;;;;;4,0;;;;;;;;;;;;;;;;2,0;;;;;;;;;;;;;;;;;;;;;;;;;;;;;;;;;;;;;1,0;;;;;;;;;;;;;;;;;;;;;;;;;;;;;;;;;;;;;;;;;;;;;;;;;;;;;;;;;;;;;;;;;;;;;
field;;;8,0;8,0;42,0;;59,0;132,0;124,0;158,0;45,0;1,0;1,0;;90,0;9,0;2,0;;23,0;14,0;9,0;68,0;10,0;12,0;15,0;;6,0;233,0;40,0;71,0;30,0;58,0;154,0;17,0;53,0;7,0;51,0;97,0;4,0;140,0;40,0;4,0;9,0;82,0;2,0;3,0;;16,0;35,0;1,0;22,0;191,0;;6,0;7,0;790,0;134,0;1,0;22,0;191,0;3,0;6,0;178,0;2,0;11,0;2,0;42,0;10,0;11,0;34,0;106,0;7,0;5,0;6,0;;69,0;11,0;31,0;146,0;2,0;5,0;43,0;27,0;19,0;;2,0;112,0;1,0;29,0;59,0;105,0;26,0;8,0;220,0;29,0;26,0;12,0;7,0;122,0;7,0;68,0;169,0;;14,0;6,0;1,0;3,0;75,0;1,0;;29,0;21,0;43,0;79,0;4,0;;3,0;;;12,0;;;4,0;23,0;3,0;1,0;88,0;1,0;2,0;11,0;14,0;20,0;1,0;;9,0;21,0;31,0;;19,0;8,0;1,0;14,0;1,0;4,0;17,0;3,0;65,0;89,0;3,0;6,0;;;3,0;3,0;;7,0;6,0;19,0;62,0;111,0;25,0;13,0;;6,0;1,0;18,0;10,0;154,0;;2,0;5,0;25,0;40,0;19,0;34,0;6,0;1,0;51,0;;;5,0;40,0;32,0;;;34,0;6,0;205,0;3,0;161,0;;;27,0;58,0;5,0;12,0;2,0;;6,0;3,0;16,0;12,0;2,0;20,0;2,0;2,0;2,0;14,0;16,0;22,0;5,0;;28,0;4,0;9,0;58,0;11,0;3,0;6,0;1,0;10,0;29,0;2,0;28,0;;2,0;11,0;;1,0;;1,0;;3,0;13,0;35,0;97,0;;65,0;158,0;3,0;26,0;;1,0;1,0;;6,0;4,0;;1,0;75,0;;;;45,0;5,0;7,0;4,0;50,0;28,0;3,0;47,0;8,0;17,0;2,0;2,0;;13,0;;;2,0;2,0;11,0;8,0;;4,0;3,0;;;3,0;21,0;1,0;54,0;1,0;11,0;1,0;30,0;9,0;209,0;7,0;16,0;4,0;1,0;63,0;25,0;13,0;11,0;3,0;19,0;2,0;3,0;1,0;;59,0;14,0;10,0;;;41,0;7,0;5,0;112,0;41,0;3,0;;;;;2,0;;;4,0;25,0;;;;47,0;;2,0;2,0;5,0;28,0;8,0;;;;2,0;1,0;14,0;1,0;19,0;2,0;57,0;2,0;20,0;5,0;74,0;1,0;11,0;2,0;31,0;4,0;12,0;10,0;2,0;1,0;3,0;;;2,0;;14,0;2,0;4,0;9,0;60,0;21,0;8,0;11,0;75,0;43,0;1,0;;3,0;48,0;5,0;16,0;5,0;4,0;;20,0;28,0;12,0;;6,0;;2,0;8,0;10,0;;42,0;;19,0;1,0;6,0;31,0;39,0;3,0;47,0;5,0;;23,0;1,0;10,0;9,0;7,0;;23,0;35,0;4,0;;9,0;7,0;;36,0;6,0;18,0;13,0;1,0;29,0;9,0;44,0;;;13,0;17,0;5,0;2,0;25,0;8,0;29,0;17,0;2,0;;;2,0;2,0;;;4,0;;;8,0;4,0;8,0;1,0;27,0;6,0;7,0;6,0;9,0;;;;7,0;10,0;14,0;;;1,0;;;2,0;;1,0;;37,0;3,0;3,0;19,0;;;38,0;2,0;1,0;3,0;1,0;4,0;1,0;4,0;16,0;13,0;38,0;;1,0;;7,0;2,0;5,0;1,0;22,0;1,0;7,0;40,0;;283,0;1924,0;9,0;6,0;10,0;13,0;2,0;6,0;3,0;2,0;25,0;6,0;;1,0;12,0;;;;;21,0;4,0;;;21,0;2,0;;1,0;;;12,0;2,0;5,0;10,0;;4,0;5,0;;3,0;1,0;;9,0;5,0;;;3,0;;;7,0;;;5,0;13,0;2,0;9,0;3,0;4,0;4,0;6,0;4,0;20,0;7,0;;11,0;4,0;;1,0;70,0;;;4,0;;;40,0;;;8,0;2,0;1,0;2,0;;;1,0;;6,0;;4,0;3,0;2,0;76,0;7,0;;;2,0;1,0;2,0;13,0;;;;9,0;1,0;20,0;;;20,0;;;;10,0;;1,0;;;;;;;1,0;15,0;;;;4,0;1,0;;2,0;1,0;;18,0;10,0;;;1,0;;4,0;;;4,0;11,0;8,0;;;19,0;;;;1,0;;3,0;3,0;1,0;;2,0;2,0;12,0;;;;;;;1,0;;;20,0;3,0;23,0;1,0;2,0;2,0;11,0;1,0;5,0;1,0;;;;3,0;;3,0;28,0;14,0;7,0;4,0;1,0;14,0;;1,0;15,0;17,0;5,0;1,0;;2,0;;;;91,0;7,0;;8,0;;23,0;42,0;14,0;1,0;10,0;2,0;;;;22,0;4,0;6,0;5,0;18,0;;;9,0;9,0;1,0;1,0;48,0;3,0;;5,0;2,0;6,0;;;;1,0;;54,0;;;;;16,0;5,0;;9,0;2,0;1,0;;1,0;16,0;1,0;13,0;;24,0;;3,0;3,0;3,0;;4,0;1,0;6,0;1,0;;2,0;2,0;4,0;10,0;6,0;;;3,0;4,0;;3,0;;;1,0;4,0;4,0;;4,0;5,0;6,0;2,0;83,0;9,0;;;;16,0;2,0;3,0;3,0;;6,0;4,0;2,0;;3,0;1,0;;8,0;4,0;;;14,0;3,0;1,0;;;;3,0;1,0;;;7,0;20,0;;;3,0;3,0;51,0;20,0;;2,0;;16,0;;;6,0;88,0;;1,0;4,0;;5,0;48,0;1,0;3,0;13,0;18,0;;;;;;;;;8,0;6,0;;1,0;4,0;10,0;3,0;;;;14,0;6,0;2,0;;;8,0;6,0;;1,0;1,0;63,0;7,0;;10,0;12,0;3,0;;;;;2,0;6,0;;;;24,0;;;3,0;3,0;;;1,0;;;;;1,0;;;4,0;;;6,0;;;2,0;;1,0;1,0;;;;;7,0;;1,0;1,0;6,0;7,0;49,0;2,0;;;3,0;1,0;1,0;10,0;;6,0;1,0;;;;;1,0;;3,0;1,0;;1,0;;;1,0;;2,0;;2,0;;;1,0;1,0;;;;2,0;;;4,0;;;;;;1,0;;;;30,0;;1,0;;;;;;4,0;;;3,0;;5,0;;;;19,0;;1,0;;;;;;10,0;;;;;5,0;4,0;;;;;;;;;
film;;;4,0;;11,0;1,0;;22,0;;11,0;9,0;;;;21,0;;;;1,0;8,0;;2,0;;1,0;;;12,0;2,0;;6,0;1,0;5,0;120,0;4,0;30,0;;;2,0;;7,0;3,0;1,0;1,0;30,0;;;;1,0;;3,0;15,0;3,0;;6,0;2,0;77,0;95,0;;5,0;52,0;;;52,0;;;20,0;2,0;;1,0;;63,0;4,0;43,0;7,0;1,0;5,0;;1,0;8,0;1,0;12,0;9,0;5,0;2,0;6,0;78,0;58,0;;3,0;6,0;24,0;;;21,0;6,0;28,0;;;1,0;41,0;93,0;25,0;;13,0;;;10,0;39,0;11,0;;2,0;57,0;1,0;26,0;13,0;;16,0;;1,0;25,0;7,0;;;3,0;23,0;;3,0;16,0;2,0;1,0;19,0;;7,0;;;;48,0;;58,0;2,0;;6,0;13,0;14,0;36,0;;211,0;10,0;;3,0;;;;;5,0;;7,0;6,0;8,0;75,0;7,0;1,0;6,0;5,0;;173,0;3,0;80,0;19,0;29,0;22,0;12,0;21,0;12,0;1,0;14,0;5,0;9,0;9,0;;2,0;;6,0;4,0;;16,0;10,0;48,0;;94,0;51,0;;2,0;16,0;1,0;15,0;48,0;;;;27,0;27,0;11,0;34,0;2,0;;;1,0;13,0;7,0;;7,0;2,0;74,0;;7,0;18,0;134,0;;;82,0;;;;15,0;7,0;1,0;;;;1,0;;5,0;5,0;;;;2,0;19,0;;;;2,0;7,0;2,0;9,0;5,0;3,0;;1,0;1,0;;13,0;7,0;13,0;8,0;;11,0;;1,0;4,0;;3,0;;;2,0;21,0;;1,0;8,0;7,0;2,0;2,0;;2,0;3,0;;;;14,0;;;;6,0;3,0;1,0;;7,0;;9,0;;;;26,0;;;15,0;3,0;;;6,0;;10,0;2,0;4,0;2,0;;6,0;;2,0;;16,0;4,0;;1,0;;;;;31,0;;4,0;;;;7,0;1,0;;4,0;;1,0;;1,0;;;1,0;1,0;3,0;;;;2,0;;;;;;1,0;46,0;;7,0;;;;;;1,0;;;;;;;1,0;1,0;1,0;;;2,0;;;;;;2,0;3,0;1,0;;;1,0;1,0;3,0;;;;;6,0;2,0;;38,0;;;;;7,0;;;2,0;;2,0;1,0;;;1,0;;;;;;;3,0;2,0;1,0;1,0;;9,0;;;2,0;1,0;2,0;;;;;;1,0;4,0;;1,0;2,0;;;;;;;;;2,0;;;1,0;2,0;;;23,0;5,0;;;;;;2,0;;7,0;;;;;;;;2,0;;1,0;2,0;;1,0;;;3,0;;;;;3,0;;;;;;;;;;3,0;;2,0;5,0;;3,0;;2,0;23,0;6,0;4,0;4,0;;;;;1,0;;4,0;;;;;6,0;1,0;;;2,0;;2,0;;;;;;2,0;;;1,0;;;;;;;;7,0;;;;;3,0;;;;4,0;;2,0;;;;2,0;;;;1,0;26,0;1,0;4,0;3,0;;;;7,0;13,0;;;;;;6,0;;;;35,0;;;;1,0;;;;4,0;16,0;;4,0;7,0;1,0;;2,0;;;;;;;;1,0;;12,0;;;3,0;1,0;;;40,0;7,0;3,0;;;;;;;;;;;;;;1,0;;;;;4,0;;;;;2,0;;;21,0;;;1,0;1,0;43,0;1,0;1,0;;1,0;;15,0;7,0;;;;4,0;;7,0;15,0;;;;;1,0;2,0;;;;;1,0;;;19,0;22,0;;4,0;3,0;;;;1,0;103,0;1,0;;3,0;2,0;;;;2,0;;12,0;;4,0;6,0;2,0;;1,0;;2,0;;;;;35,0;;;;;;;;;;9,0;;;1,0;;;4,0;1,0;;;34,0;3,0;;;5,0;;1,0;3,0;;;;;2,0;;;;1,0;;;;;;;;1,0;;;13,0;2,0;;3,0;;;;;;;;;;;;5,0;;;;;1,0;;14,0;;;;12,0;;;;;;;;;;;;;;;;;;1,0;;;;;;1,0;;;;;;;;;;2,0;;;6,0;1,0;6,0;;2,0;;;;;;;8,0;;17,0;;1,0;;;;;;;;;;1,0;;;1,0;;;;;1,0;6,0;;;;;2,0;4,0;;;;;;1,0;2,0;;;;;;3,0;;1,0;1,0;1,0;4,0;;;3,0;;;3,0;1,0;;;;3,0;3,0;;;;;;2,0;;;79,0;;22,0;2,0;;;;;;2,0;3,0;;;;;;1,0;;;;;;;;3,0;;;;6,0;;;;;2,0;3,0;;;1,0;;;;;;;;;;;;;;;2,0;;;;;;;;;;;;;112,0;1,0;35,0;5,0;;;;4,0;;;3,0;;;5,0;;;5,0;;;;;1,0;;;2,0;;;;11,0;;;;;;;;1,0;;;;1,0;17,0;;;;3,0;;;;
filter;;;26,0;2,0;74,0;1,0;31,0;105,0;17,0;27,0;10,0;64,0;2,0;40,0;414,0;14,0;11,0;2,0;59,0;4,0;;41,0;;16,0;38,0;;3,0;117,0;7,0;29,0;22,0;55,0;193,0;30,0;84,0;12,0;16,0;22,0;;15,0;10,0;4,0;30,0;143,0;5,0;;;12,0;13,0;73,0;28,0;94,0;;14,0;;686,0;222,0;23,0;3,0;226,0;14,0;;166,0;8,0;11,0;5,0;22,0;;;30,0;545,0;3,0;91,0;4,0;2,0;2,0;2,0;5,0;134,0;10,0;5,0;132,0;21,0;12,0;;3,0;91,0;;12,0;138,0;146,0;2,0;;117,0;16,0;15,0;;;20,0;26,0;113,0;95,0;;2,0;1,0;1,0;10,0;163,0;12,0;9,0;40,0;71,0;107,0;15,0;35,0;2,0;33,0;30,0;23,0;12,0;13,0;;7,0;94,0;6,0;15,0;140,0;9,0;5,0;39,0;18,0;15,0;23,0;;1,0;37,0;59,0;;2,0;21,0;;;9,0;21,0;;;69,0;105,0;;27,0;37,0;4,0;9,0;;25,0;71,0;15,0;49,0;22,0;91,0;31,0;8,0;31,0;2,0;;108,0;15,0;437,0;;14,0;33,0;18,0;78,0;34,0;7,0;21,0;6,0;54,0;6,0;;2,0;11,0;236,0;6,0;;28,0;34,0;320,0;17,0;127,0;2,0;;42,0;88,0;1,0;9,0;3,0;;16,0;14,0;2,0;21,0;2,0;41,0;;14,0;;;7,0;13,0;2,0;3,0;8,0;;17,0;14,0;87,0;46,0;;6,0;26,0;7,0;22,0;59,0;19,0;88,0;10,0;;1,0;1,0;3,0;;3,0;7,0;7,0;20,0;3,0;75,0;54,0;1,0;29,0;;28,0;4,0;;1,0;3,0;4,0;1,0;;13,0;1,0;4,0;19,0;6,0;;;14,0;3,0;;7,0;16,0;49,0;1,0;3,0;;8,0;;1,0;7,0;;24,0;;1,0;22,0;15,0;;;3,0;7,0;;;2,0;12,0;14,0;24,0;12,0;46,0;6,0;9,0;10,0;4,0;9,0;49,0;;21,0;1,0;9,0;;;1,0;;26,0;6,0;2,0;10,0;;18,0;8,0;4,0;26,0;47,0;9,0;;2,0;;12,0;3,0;;9,0;;41,0;;1,0;;38,0;13,0;;13,0;;7,0;8,0;79,0;2,0;;2,0;10,0;;;10,0;3,0;52,0;7,0;1,0;6,0;2,0;2,0;8,0;;24,0;9,0;3,0;7,0;9,0;;;3,0;1,0;;2,0;6,0;;;3,0;36,0;;;1,0;24,0;6,0;2,0;2,0;;4,0;6,0;18,0;8,0;47,0;;22,0;3,0;23,0;1,0;5,0;;2,0;6,0;4,0;1,0;18,0;;43,0;7,0;;60,0;7,0;;17,0;6,0;;;;5,0;;7,0;11,0;;4,0;2,0;2,0;3,0;3,0;;25,0;;;7,0;;37,0;3,0;;1,0;;6,0;19,0;3,0;5,0;19,0;12,0;33,0;;58,0;;;;2,0;2,0;3,0;3,0;1,0;;4,0;;1,0;18,0;7,0;3,0;25,0;6,0;3,0;2,0;4,0;17,0;7,0;;;;;1,0;3,0;;;;12,0;;;10,0;;8,0;;3,0;69,0;;;;1,0;14,0;8,0;;;8,0;2,0;1,0;3,0;;9,0;7,0;16,0;5,0;11,0;1,0;20,0;31,0;10,0;20,0;13,0;;2,0;1,0;;2,0;;11,0;2,0;40,0;;;6,0;;;7,0;5,0;;9,0;;1,0;2,0;;6,0;1,0;;;9,0;;;2,0;3,0;;19,0;5,0;1,0;;4,0;;;1,0;;;;53,0;;17,0;;58,0;;2,0;1,0;;;;16,0;;;12,0;2,0;3,0;8,0;;2,0;4,0;248,0;1,0;1,0;;;;15,0;1,0;;4,0;;1,0;;;1,0;;;;;;;3,0;18,0;2,0;;3,0;;;3,0;15,0;1,0;14,0;;;7,0;;;;2,0;;;;18,0;;1,0;;7,0;2,0;;;;;;;;;;;;;;;2,0;14,0;;;;;23,0;;;6,0;;;8,0;;24,0;32,0;;3,0;;;4,0;;3,0;;;3,0;2,0;5,0;20,0;36,0;;;;;;1,0;20,0;19,0;1,0;2,0;3,0;;;40,0;10,0;;;3,0;1,0;;1,0;14,0;1,0;;2,0;5,0;;;1,0;4,0;20,0;13,0;8,0;;;;3,0;2,0;;16,0;1,0;2,0;4,0;;;1,0;12,0;;1,0;1,0;;;4,0;2,0;2,0;;;52,0;;3,0;;8,0;3,0;1,0;4,0;;;1,0;14,0;1,0;;2,0;;;6,0;1,0;;4,0;1,0;;18,0;;;;4,0;;1,0;;9,0;5,0;;2,0;;17,0;3,0;7,0;1,0;;7,0;;;1,0;;5,0;2,0;11,0;3,0;27,0;;131,0;3,0;1,0;4,0;12,0;;1,0;3,0;;;3,0;;5,0;;1,0;35,0;2,0;;;;;;;1,0;1,0;1,0;;;;;;;;1,0;1,0;;;1,0;;;;;;;1,0;3,0;;36,0;1,0;1,0;;;5,0;;;1,0;;1,0;;;;4,0;;;;;;4,0;;;6,0;5,0;;7,0;1,0;3,0;4,0;;;1,0;;15,0;;;2,0;;;;;;;;2,0;9,0;;1,0;;;;;;1,0;;1,0;;;;12,0;;3,0;2,0;3,0;;1,0;2,0;12,0;1,0;5,0;1,0;137,0;;3,0;1,0;2,0;;;2,0;;;;5,0;;2,0;;1,0;;;;2,0;6,0;;;;;;;;;6,0;5,0;9,0;1,0;;;3,0;;;;1,0;;18,0;;1,0;;4,0;1,0;74,0;10,0;;;;;;1,0;;;;;;;;13,0;6,0;;;;2,0;;;3,0;2,0;5,0;2,0;;1,0;;;1,0;2,0;2,0;3,0;;;;;;;;14,0;;;;;;;;5,0;;1,0;1,0;;;2,0;5,0;6,0;;;;;;19,0;;;;3,0;;;;
finder;;;4,0;;4,0;;3,0;6,0;4,0;9,0;1,0;;;;1,0;;;;;2,0;5,0;8,0;;;;;1,0;4,0;;1,0;;3,0;120,0;3,0;10,0;;4,0;3,0;1,0;72,0;31,0;;7,0;5,0;;;;4,0;8,0;3,0;6,0;5,0;;5,0;;97,0;50,0;;2,0;52,0;1,0;4,0;2,0;;;;3,0;1,0;;7,0;213,0;;42,0;;;;;6,0;17,0;;;;5,0;;;5,0;2,0;;;4,0;4,0;;1,0;10,0;3,0;;;;;1,0;22,0;139,0;;;;;1,0;47,0;;;1,0;21,0;;;10,0;;;;;15,0;;;;1,0;;;3,0;;;;2,0;;1,0;2,0;1,0;;3,0;;;3,0;;;;16,0;;;21,0;4,0;;;;2,0;10,0;;;1,0;;3,0;1,0;30,0;4,0;;;2,0;;;;44,0;;;15,0;19,0;6,0;11,0;1,0;4,0;;2,0;;;2,0;;5,0;;;3,0;3,0;2,0;;14,0;14,0;;;6,0;;18,0;;;;;;1,0;;4,0;;;;;4,0;28,0;4,0;2,0;;;;1,0;5,0;;;;;;;;1,0;;13,0;;;;;;;1,0;5,0;9,0;;;1,0;;2,0;;;;;1,0;;7,0;;;;;;1,0;1,0;;;;;;;13,0;2,0;;;;;;;;;1,0;;;6,0;;;;;;;;;5,0;;6,0;5,0;10,0;4,0;;6,0;;4,0;;;2,0;;1,0;;;1,0;;1,0;8,0;3,0;;;72,0;;;1,0;1,0;;;;;;;;;;;;;;;;;;;5,0;;;;;;;;;;;;;;;;;;;2,0;2,0;;;;;;;;;;;;2,0;;;6,0;2,0;;;;;1,0;;19,0;;;;;;2,0;;2,0;;;;;;1,0;;3,0;2,0;;;;;;;3,0;;1,0;;;;;;;;10,0;;2,0;1,0;4,0;;1,0;;;;;1,0;11,0;3,0;2,0;;;4,0;;;;;;;;;;;;;;;;;;;;2,0;;;;1,0;;;;4,0;1,0;1,0;;;;;;;;;;;6,0;5,0;;;;;2,0;;;;;;;;4,0;;;;;;2,0;30,0;;;8,0;;2,0;;;7,0;92,0;;;;;;;;;;;;;;;;;;;1,0;;;;;;18,0;;;;;;3,0;;;;2,0;;1,0;;;;;;;;;;;2,0;;;;;;;;;;;;;2,0;;;1,0;2,0;;2,0;;;;;;;;;;;;;;;;;;;;46,0;;;2,0;;;;;;3,0;;2,0;;;;;1,0;;;;1,0;6,0;;;;;1,0;;;;;;;;;;;11,0;;;;1,0;;;;;;;;;;;;6,0;37,0;;;;;;;;;;;;;;2,0;;;;;;;;5,0;;;;;;;3,0;;;;1,0;2,0;;;;2,0;;;;;;;;;;;;;1,0;;;;1,0;;;2,0;;;;;;;;;;;;;;;;;;;;;2,0;;;;;;;;3,0;;;1,0;;;;;;;;;;;1,0;;;;;;;;;;;6,0;;1,0;;1,0;;;;;2,0;;;;;;;;;;;;;;1,0;;;;11,0;5,0;;;;;;;1,0;;;;;;;;;;;;;;;;;;;;;;;;;;;;;;;;;;;1,0;;;;;;;;;;2,0;24,0;;3,0;2,0;;;;;;;1,0;;4,0;;;;;;;;;;;;;;;;;;;;;3,0;;6,0;1,0;;;;1,0;;;;;;;;;;;;;;;;;;;;;;;;;;;;;;;;;;;;;;;;;;6,0;;;;1,0;2,0;;;;;;;;;;1,0;;;;;;;;;;;;;;;;;;;;;;;;;;;3,0;;;;;;;;;;;;;;;;;;;;;;;;;;;;;;;;;;;;;;;;;;1,0;;;;
flat;;;3,0;;6,0;;49,0;21,0;;20,0;3,0;;;;3,0;;;;2,0;2,0;2,0;1,0;;;;;19,0;3,0;;8,0;1,0;8,0;27,0;;12,0;;;8,0;;16,0;1,0;;1,0;8,0;;;2,0;;;1,0;2,0;1,0;;3,0;1,0;35,0;47,0;;;37,0;;;11,0;;;2,0;1,0;;;;41,0;2,0;;2,0;3,0;2,0;;2,0;15,0;3,0;3,0;4,0;;;;2,0;6,0;;;2,0;7,0;;;1,0;2,0;1,0;;1,0;;5,0;236,0;8,0;1,0;;;;;21,0;;;3,0;5,0;1,0;4,0;8,0;1,0;;;1,0;29,0;;;;3,0;;3,0;13,0;18,0;;1,0;;;;1,0;2,0;;11,0;;;;;;2,0;13,0;7,0;;34,0;4,0;;;;7,0;1,0;;2,0;6,0;3,0;9,0;1,0;1,0;;;2,0;2,0;;7,0;;4,0;;;53,0;1,0;14,0;25,0;;3,0;9,0;;;;10,0;;;;2,0;9,0;37,0;2,0;;73,0;1,0;;;13,0;;3,0;;;3,0;22,0;;27,0;;46,0;;;2,0;;4,0;26,0;;;;15,0;3,0;2,0;;3,0;;;14,0;1,0;;;11,0;;3,0;;;5,0;;;;1,0;;2,0;;1,0;1,0;;7,0;;;20,0;60,0;2,0;;1,0;4,0;7,0;;;10,0;28,0;;;5,0;6,0;;;;1,0;7,0;5,0;4,0;;10,0;;60,0;;29,0;7,0;2,0;1,0;3,0;;2,0;3,0;;1,0;3,0;15,0;;1,0;;;1,0;15,0;1,0;10,0;;;;4,0;;19,0;;7,0;5,0;;2,0;;;3,0;3,0;7,0;;1,0;3,0;11,0;;1,0;;;3,0;1,0;;10,0;;2,0;;1,0;6,0;1,0;;1,0;;10,0;;;;;;;;;;1,0;;;;1,0;;;;;;3,0;;;1,0;;;;;;;;;;;2,0;;;;2,0;;;;;;;;;4,0;;;;;10,0;;1,0;;;;;1,0;2,0;2,0;2,0;1,0;1,0;;;1,0;1,0;;;;;;;;;7,0;;;1,0;;;;2,0;4,0;;;;9,0;;;;3,0;;;;;1,0;;;;;;;2,0;;;1,0;;;;;2,0;14,0;;;3,0;;;;;;;1,0;2,0;;;;;;2,0;;;;;;1,0;4,0;1,0;3,0;;;;1,0;;;;;;;;2,0;;;;;;15,0;7,0;;;;;;;;2,0;3,0;;;;;;;;;12,0;;;;;;;;;;;;9,0;;;;;;;1,0;;;;;;;4,0;;;;;;1,0;;;;;;;;;;;;;;;;;;1,0;;;;;;2,0;;;;;;;;;;;;;;1,0;;2,0;1,0;;;;;1,0;;;;3,0;;;;;;;2,0;;;;;5,0;9,0;;;;;3,0;;;;;;2,0;26,0;;;;;;;;;;;;1,0;;;;;;4,0;;1,0;1,0;;1,0;1,0;;;;;;;7,0;;;;;1,0;;;;8,0;;1,0;1,0;;;;;;2,0;;;;;;;;;1,0;;;2,0;;1,0;;3,0;1,0;;;;;;;1,0;;;;;;;;;;;;;5,0;;;;;;;;;3,0;;;;;;;1,0;;;;;;;;;;;1,0;1,0;;;;;;;;3,0;;;1,0;;;;;;;;3,0;;;;;2,0;;;;1,0;;;;;;1,0;;;;;2,0;;;;;;;;;;3,0;1,0;;;;;;;;;;1,0;;;;;;;;;;;;;;;;;;;1,0;;;;;;;;;;2,0;;;;;;;;7,0;;;;;;;;;;;;4,0;;1,0;;1,0;;2,0;;2,0;;;2,0;;;;;3,0;;;;;;;;;;6,0;;;;;;1,0;2,0;;;1,0;;;;4,0;;;;;;;;;;2,0;;;3,0;;;;;;;1,0;1,0;;;;;;;;;;;;;;;;1,0;;;;;;;;;;;7,0;;;;;;;;;1,0;;;;;;;;;;;;1,0;;;;3,0;;;4,0;;1,0;2,0;;;;;;;;;;;;;;;;;;;;;;;;;;;;;;1,0;;;;;;;;1,0;;;;;;;;
fold;;;2,0;;4,0;;5,0;5,0;;;1,0;1,0;;;;;;;1,0;;;;;;;;2,0;;2,0;;;;18,0;;2,0;;6,0;4,0;;23,0;;;;2,0;;;;;;;;1,0;;1,0;;10,0;10,0;;;16,0;;;3,0;;;;;;;8,0;10,0;;;;1,0;;;;30,0;;;;;;;;;;;1,0;;;;1,0;1,0;4,0;;3,0;1,0;8,0;21,0;16,0;;;;;;18,0;;;;;;2,0;;;;;1,0;17,0;;;;2,0;;;8,0;;;;6,0;;;;;;3,0;;;;;;;3,0;;;23,0;5,0;;;;;1,0;;3,0;;;7,0;;10,0;;;1,0;4,0;;;;4,0;;1,0;3,0;21,0;1,0;4,0;;10,0;3,0;;;;;2,0;;;;;5,0;7,0;;19,0;;4,0;;3,0;;2,0;;;2,0;;;15,0;;8,0;;;;;2,0;12,0;;;;;;4,0;;;;;4,0;;;;1,0;;;;;;;;;;;2,0;;;1,0;;1,0;;;3,0;3,0;;;;;;;;;3,0;;;;;;;;2,0;;;;;4,0;;;;11,0;5,0;;;7,0;;;;;1,0;;;;5,0;;;1,0;;;1,0;;;;;;;;2,0;;;2,0;;5,0;1,0;;;;;3,0;7,0;;;4,0;;;;1,0;;1,0;2,0;;;3,0;;;;2,0;;;;1,0;;;;;;1,0;;;;;2,0;;;1,0;;;;;2,0;6,0;;;;;;;;;;;;;;;;;;;;;;;;;;;;;1,0;;;;;;;;;;;1,0;;;;8,0;;1,0;;;;;;;;;;;;;;;;;;;;;;3,0;;;;;1,0;2,0;8,0;;;;;;;;;6,0;;;;;;3,0;;;;;;;;;;;;10,0;5,0;;;;;;;;;;;2,0;4,0;5,0;;;;;;;;;;2,0;;;;;;;;;2,0;3,0;;;;1,0;;;;;11,0;;;;;;;;;1,0;;;;;3,0;;;;7,0;;;;;;;;;;;;;1,0;;;;;;;;;;1,0;;;;;;;;;;;;;;;;;;;;;;;2,0;;;;;;;1,0;;2,0;;;;;;;;;;;;;;2,0;;;5,0;;;;;;2,0;;;;;;;;1,0;;;;;;;;;;;;;;;;;;;;1,0;;;;;;;;;;;;;1,0;;;;;7,0;;;1,0;;;;;;;;;;;;;13,0;;;;;;;;;;1,0;4,0;;;;;;;2,0;5,0;;;;;;;;;;;;;;;;;;;;;;;;;4,0;;;;;;;;;;;;;;;;;1,0;;;;;2,0;;;;;;;;;;;;;;;;;;;;;;;;;;;;;2,0;;;;;;;;;;;;;;;;;;;;;;;;2,0;;;;;;;;;;;;;;;;;;;;;;;;;;;2,0;;;;5,0;;;4,0;;1,0;;;;;;;;;;;;;;1,0;;;1,0;;;;;;;;1,0;;;;;;;;;;;;;;;;;;;;;;;;;;;;;;;;;;;;;;;1,0;;;;;;;;;;;;;;;;;;;3,0;;;;;;;;;;6,0;;;;;;;;;1,0;;;;;;;;;;;;;;;;;;;;;;;;;;;;;;;;;;;;;;;;;;;1,0;;1,0;;;;10,0;;;;;;;;;;;;;;;;;;;1,0;;;;;;;;;;;;;;;;;;;;;
foot;;;3,0;;4,0;;2,0;17,0;;;;;;;;3,0;;;2,0;;;;1,0;;;;;2,0;;2,0;;1,0;14,0;;;3,0;;;;;12,0;;;2,0;;;;;14,0;;;;;3,0;2,0;3,0;11,0;;1,0;8,0;;;5,0;;;;;;;1,0;;;;;;;;;6,0;;;;;;;;1,0;;;;;;;;;4,0;;;;;9,0;2,0;;;;;;;;;2,0;;;9,0;;;;;;2,0;;;;;;;6,0;3,0;;7,0;;;;2,0;2,0;7,0;1,0;;;;;;2,0;;;1,0;9,0;;;;;;;;;;;2,0;;;;;1,0;;;;;;;;22,0;1,0;1,0;1,0;;;;;;;;1,0;;;;8,0;11,0;7,0;;8,0;;;;2,0;;;;;;1,0;;2,0;;8,0;;;;;;4,0;;;;;;;;;;;;1,0;;;1,0;;;;;;;;;4,0;1,0;;;;;;4,0;;;10,0;1,0;;;;;;;;;7,0;;;;6,0;2,0;;;;3,0;1,0;;;20,0;;;;;;3,0;;;;;;;1,0;3,0;;;1,0;;7,0;4,0;;;;;;;;;;;;;;;;;;;;;6,0;;;;4,0;;;4,0;;;;;;;;1,0;;2,0;;;6,0;;;;;;;;;;;;;1,0;;;;;;;;;;;;;;;;;;;;8,0;;;;;;;;;;;;;;;;;;;;;;;;;;1,0;;;;;;;;;;;;;;;;;;;;;;;;;;;;;1,0;;;;;30,0;;;;;;;;;;;;;;;;;;;;;;;;;;;;;;;;;;;;;;;;;;;;;1,0;;;;;;;2,0;4,0;;;;;;;;;;;;;1,0;;;;;2,0;;;;;;;1,0;;;;;;;;;;;;;;;;;;3,0;;;;;7,0;;;;;;;;;;;;;;;;1,0;;;2,0;;;;;;;;;;;;;;;;2,0;;2,0;;;;;;3,0;;4,0;;;;;;;;;;7,0;;;;;;;;;;;;;;;;;;;;;;3,0;2,0;;;;;;;1,0;;;;;;;;;;;;;;;;;1,0;;;;;;2,0;;;3,0;;;;;;2,0;;16,0;;;3,0;;;;;;;1,0;;;;;;;;;;;;;;2,0;;;;;;;;;;2,0;;;;;;;;;;1,0;;;;;;;;;;;;;;;;;;;;;;;;;;;;;;;;;;;;;;;;;;;;;;;;;;;;;;;;;;;;;;;;;;;;;;;;;;;;;;;;;;;;;;;;1,0;;;13,0;;;;;;;;;;;;;;;;;;;;;;5,0;;;;;;;;;;;;;;;;;;;;2,0;;;;;;;;;;;;;;;;;;;;10,0;;;;;;;;;;;1,0;;;;;;;;;;;;9,0;;;;;;;;;1,0;;;;;;;;;;;;;;;;3,0;;;;;;;;;;;;;;;;;;;;;;;;;;;;1,0;;;;;;;;;;;;;;;;;;;;;;;;;;;;;;;;;;;;;;;;;;2,0;;;;;;;;2,0;;;;;;;;;1,0;;;;1,0;;;;;;;;;;;;;;;;;;;;;;;
format;;;2,0;;12,0;;;12,0;;19,0;2,0;;;;12,0;1,0;;;4,0;5,0;;31,0;;4,0;1,0;;;296,0;1,0;4,0;2,0;4,0;43,0;;78,0;;;;;38,0;2,0;;2,0;10,0;;2,0;;1,0;2,0;1,0;;27,0;3,0;12,0;;269,0;108,0;2,0;;10,0;2,0;;44,0;1,0;1,0;;5,0;;1,0;5,0;15,0;;;;;1,0;;10,0;3,0;;1,0;23,0;16,0;3,0;;;1,0;;;27,0;10,0;;23,0;117,0;11,0;;;6,0;14,0;19,0;2,0;39,0;;15,0;1,0;;1,0;59,0;;;2,0;6,0;2,0;2,0;1,0;1,0;;;;11,0;;;4,0;10,0;;;24,0;;;1,0;;4,0;1,0;;;;;;;;;;8,0;;;;33,0;40,0;3,0;;;;;;1,0;;;;;17,0;;;;;1,0;;;;3,0;;;;1,0;;3,0;1,0;;55,0;;;;;2,0;;;1,0;;15,0;;4,0;;;;12,0;4,0;;;;;;1,0;4,0;;;;1,0;;;;2,0;;;2,0;;2,0;16,0;8,0;;;;;;;;;;8,0;;;;1,0;;;;;;;1,0;5,0;;;;3,0;;;;;;;;;6,0;;;;;;3,0;2,0;;1,0;2,0;;;;;;;;;;;;;;34,0;;;1,0;1,0;;;;;;3,0;1,0;2,0;4,0;;;;;;;;;2,0;;;1,0;;30,0;;1,0;;;;;;3,0;;;;;;;;;;;4,0;;;;2,0;;;3,0;;;;;;;;;;;;;;;5,0;6,0;1,0;;;;7,0;;;;;;1,0;;;;;;;;;12,0;4,0;;1,0;;;6,0;;;1,0;27,0;8,0;3,0;;;1,0;3,0;;;5,0;;;;1,0;;38,0;;1,0;;;;;2,0;;;;1,0;;2,0;;;;;1,0;;2,0;;1,0;;5,0;;2,0;;;6,0;2,0;;;;;29,0;;;8,0;4,0;2,0;;;;;2,0;;10,0;1,0;1,0;2,0;2,0;;10,0;6,0;;8,0;6,0;67,0;;;1,0;3,0;14,0;1,0;;;;5,0;8,0;9,0;1,0;1,0;;4,0;;1,0;;;;;;5,0;;;1,0;;4,0;;;;2,0;2,0;;;;;4,0;;1,0;16,0;;7,0;1,0;;86,0;5,0;;;;2,0;;;;;;;;;;;;;;9,0;67,0;;;;2,0;;;;;;;;5,0;;;;1,0;;;;125,0;;;;;;;2,0;;;;;1,0;;2,0;;2,0;8,0;;;;;2,0;;;26,0;29,0;;3,0;;;;;;;;;1,0;;;;;2,0;;;;1,0;8,0;1,0;1,0;9,0;1,0;;3,0;;21,0;;;;;;;;;8,0;;;;;;11,0;1,0;;11,0;;;;;;;;;2,0;;;;;;;;;;;;8,0;;;;;;;;;;;;;;;;;7,0;;;3,0;;3,0;7,0;;;;;;;;;;;8,0;;;;;5,0;;;;;1,0;;;;;;;;;;;;;;;6,0;2,0;;;;1,0;;;;;;2,0;;;;;;;;;;;6,0;;;;2,0;;;;;;;;;;;;;;9,0;;;;4,0;3,0;3,0;;;;;1,0;;;;;;;2,0;;3,0;;;;;1,0;3,0;;2,0;;1,0;2,0;;;;;2,0;;;;4,0;;;1,0;;;;;9,0;1,0;;;;7,0;;;;;;2,0;;;;1,0;;;;6,0;;;;;;;;;;;;;;;;;;;5,0;;;;;;;;;;3,0;;;;;;3,0;;;;;;;;;;;;;;1,0;;;;;;;;;;;;;6,0;;;;;1,0;;;;;;;;;;;2,0;;;;;;;;;1,0;;;;;;;;;;;;;;;7,0;;;;10,0;;;;;;;;;1,0;;;;;;;;;;;;;;;10,0;;;;;;;;;;;;;4,0;;;;;5,0;;;;1,0;;;;;;;;;;;;;;;;;;;;;;;2,0;;6,0;;;;;;;;;;;;;;;;;;;102,0;;;;;;;;;
freedom;;;3,0;;1,0;;2,0;8,0;;4,0;;;;;;;;1,0;;2,0;;1,0;;;;;;1,0;134,0;;;4,0;9,0;;;;;1,0;;1,0;;;;1,0;;;;;;;;1,0;;2,0;;6,0;8,0;;;1,0;3,0;;10,0;;2,0;;;;;;2,0;;;;;;;7,0;11,0;;;1,0;1,0;;;;;;4,0;2,0;1,0;;;;;;;;;;1,0;10,0;;;;;;;;;;;;4,0;;;;;;3,0;;;1,0;;;;;;;1,0;;;;;;;;;;;;2,0;;;;;;;;;;;1,0;;;8,0;;2,0;;1,0;;;;;;;;1,0;;;2,0;;;3,0;22,0;;;;;;;;;;;1,0;;;;4,0;;;;2,0;;;;;;;;;;;;;21,0;2,0;;;;;;;5,0;;;;;;;;;;;;;;;;;;;;1,0;;1,0;;;;;;;;;;;;;;;;;;;;;1,0;1,0;;;;;;;;;;;;;;;;;;;;3,0;;;;;1,0;;15,0;5,0;5,0;;;;3,0;;;;;;;1,0;;;;2,0;2,0;;;;;;;;;;;;;;;;;;;;3,0;;;;;;;2,0;;;;;;;;;;;;;;;;;;;;;;;;;;;;;;1,0;;;;;;;;;;;;;;;1,0;;;;;;;;;;;1,0;;;1,0;;3,0;21,0;;;;;8,0;;;1,0;;;;;;1,0;3,0;;;;;;;;;;;6,0;;;;;;4,0;;;;;;;;;;;;;;;;;;;;;1,0;;;;;;;;;;;;;;;;;;;;;;;;;;;;;;8,0;;;;;;;;;;2,0;;2,0;;1,0;;;;;;;;;;;;;;;;;;;;;;;;;;;;;;;;;;;;;5,0;;;;;;;;;;;;;;;;;1,0;;;;;;3,0;;;;;;;;;1,0;;;4,0;;;;;3,0;;;;1,0;;;;;;;;;;;;;;;;;;;;;;;;;;;;;;;;;;;;;;;;;;;;;;;;;;;;;;;;;;;;;;;;;;;;1,0;;;;;;;;;;2,0;;;;;;;;;;;;2,0;;;;;1,0;;;;;;;;;;1,0;;;;;;;;;2,0;;;;;;;;;;;;;;7,0;;;;;;;;;;;;;16,0;;;;;;;;;;;;;;;;;;;;;;;;;;;1,0;;;;;;;;;;;;;;;;;;4,0;;;;;;2,0;1,0;;;;;;;;;;;;3,0;;2,0;;1,0;;;;;;;;;;;;;;;;;;;;;1,0;;;10,0;;;;;;;;;;1,0;;;;;;;;;;;;;;;;;;;;;;;;;;;;;;;;;;;;;;;;;;;;;;3,0;6,0;;;;;;;;;;;;;;;;;;;1,0;;;;;;;;;;;;;;;;;;;;;;;;;;;;;;;;;;;8,0;;;;;;;;;;;;;;;;;1,0;;;;;;;;;;;;1,0;;;;;;;;;;;;;;;;;;;;;;;;;;;;;;;;;1,0;;;;;;;;;;;;;;;;;;;;;;;
fundus;;;5,0;;4,0;;12,0;4,0;;2,0;3,0;;;;9,0;1,0;;3,0;2,0;;2,0;21,0;;;;;1,0;5,0;1,0;;3,0;;26,0;;1,0;;3,0;2,0;;42,0;9,0;;2,0;26,0;;2,0;;;20,0;;5,0;1,0;;;;121,0;17,0;;;32,0;;;14,0;;;;8,0;4,0;;2,0;79,0;3,0;16,0;12,0;7,0;8,0;;5,0;32,0;7,0;;;;2,0;;4,0;;;;;7,0;;;5,0;2,0;;;;;;;57,0;1,0;;;;4,0;18,0;;;;11,0;;;;;;;;5,0;;;3,0;;;2,0;1,0;3,0;;2,0;;4,0;;;1,0;3,0;4,0;;;2,0;;;;;5,0;;14,0;;;;1,0;;1,0;;;;;;40,0;22,0;;;;;;;;54,0;;;1,0;11,0;4,0;1,0;5,0;;;8,0;;;;;;25,0;;;9,0;17,0;;19,0;;;5,0;;;8,0;5,0;;;;;8,0;;;;;;;;;;2,0;;;1,0;19,0;1,0;;1,0;;;;;17,0;;;;;2,0;;;;2,0;;1,0;;;1,0;3,0;;;1,0;;;;;;1,0;;;;;;;;;1,0;25,0;;;;;;;1,0;;;;;;;;;1,0;1,0;;;;;;;;;1,0;;;1,0;;;;10,0;;;;;;;137,0;;;;;2,0;10,0;6,0;;;3,0;;;1,0;;;;6,0;;;;;;;4,0;;;;7,0;;;;;;1,0;;;;;;1,0;;;;;;;;;;;;1,0;;;;;;;;4,0;;;;;;;;;;3,0;;;;;;5,0;4,0;;;;;;;2,0;;11,0;;;;;;2,0;;;;;;;2,0;36,0;;;;;;;;;2,0;;;;2,0;1,0;;;;;;;3,0;;;;;;12,0;;;;1,0;;;2,0;;;;;;;;;;;;;;;;5,0;;;;3,0;5,0;4,0;;;;;;;;;1,0;;;;2,0;;;;;2,0;;;;1,0;;;;;;;;;;;5,0;2,0;;3,0;;20,0;;;;6,0;;;;;;;;;3,0;;;;;;;;;;;;;;;;;;;;;;;;3,0;;;;;;1,0;;;1,0;3,0;;;;;;;;;;;;;;;;;;1,0;;1,0;;1,0;;;;;;;;;;;;;;;;;;;;;;2,0;;;;;;;;;;;;;2,0;10,0;;;2,0;;;;;;;;;;;;;;;;;;;;;;;1,0;;;;;;1,0;;;;;;19,0;;8,0;;;;;;;;;;;;;;;;;;;;;;7,0;;;;;;;;;;;;;;;;;;;;;;;;;;;;;;;;;;;;;;;;;;1,0;;;30,0;;;;;;;;;;;;;;;;;;;;;;1,0;;1,0;;;3,0;;;;;;;;;;;1,0;;;;;1,0;;3,0;;;;;;;;;;;1,0;;;;;;;;;;;1,0;;;;;;;;2,0;;;;;;;;;;;;;;;;;;;;;;;;;;;;;;;;;;;;;;;;1,0;;;;;;;;;1,0;26,0;;;1,0;1,0;2,0;;1,0;;;;;1,0;;;;;;;;;;;;;;;;;;;1,0;;;;;;;;;;;;;;;;;2,0;;;;1,0;;;;;;;;;;;;;;;;;;;;;;;;;;;;;;4,0;71,0;;18,0;;;12,0;;;1,0;;;;;;;;;;;;;;;;;;1,0;;4,0;;;;;;;;1,0;;;;;;;;;;;;;;;;;;;;;;;;;;;;;;2,0;;;;;;;1,0;2,0;;;;;;;;;;;;;;
gain;;;6,0;;17,0;;;23,0;66,0;14,0;;;;;32,0;2,0;3,0;2,0;15,0;1,0;15,0;71,0;;18,0;24,0;;7,0;58,0;;2,0;2,0;39,0;13,0;15,0;56,0;;;;;3,0;;;;8,0;1,0;3,0;;;2,0;;16,0;26,0;;;;140,0;26,0;;;;;2,0;35,0;16,0;;;;;;3,0;2,0;;;;;;;5,0;;;;13,0;2,0;6,0;;;1,0;2,0;6,0;3,0;18,0;;2,0;103,0;3,0;;;4,0;11,0;;1,0;15,0;;;;;1,0;45,0;;;;7,0;;;;37,0;;20,0;;;;;4,0;56,0;;;6,0;;;6,0;;3,0;;;;;;;;2,0;4,0;;;;1,0;;;2,0;7,0;;10,0;;;;;;;2,0;;7,0;;18,0;;;;;21,0;19,0;;;;;;;;;;57,0;;;;;1,0;;;;;4,0;;3,0;;;;8,0;;;;;;2,0;;;;;;;;;;;;;;;;22,0;;;;;;;;;;;7,0;;;;;;;;56,0;;;5,0;11,0;;;;1,0;;;2,0;19,0;;;;1,0;;;5,0;;;;2,0;5,0;;4,0;;;;;;;;;;;;;;;;4,0;;;;;;2,0;1,0;;2,0;;2,0;1,0;;;;;11,0;;;1,0;2,0;;;;;10,0;;;;;6,0;;;21,0;;;;;;;;;;;4,0;;;;11,0;;;;;6,0;;;;;;;1,0;1,0;;;3,0;;;;;12,0;3,0;;1,0;;;23,0;;;6,0;4,0;;;;3,0;;;;;4,0;;;;;;;7,0;1,0;3,0;2,0;1,0;10,0;;;2,0;10,0;1,0;1,0;;1,0;2,0;1,0;;3,0;1,0;18,0;;;6,0;14,0;;4,0;5,0;5,0;;;;1,0;;;;1,0;;;;;;2,0;;;;;18,0;;;;;2,0;9,0;;2,0;;1,0;1,0;;;;;;;8,0;;;;;;;;;10,0;13,0;2,0;1,0;;;1,0;5,0;1,0;;;;;2,0;;;;;17,0;;;;;12,0;;;15,0;;;;1,0;;;;;;2,0;;;;;;;;21,0;;;;;10,0;3,0;;;;;2,0;;;;14,0;;;;;;;;;;;;;;;;;;6,0;;;1,0;;;;;;;;;4,0;;;;;;;2,0;;;2,0;;;;;;3,0;;;;;;;1,0;;;57,0;;;;;;;;;;;;;;;;;;;;;;4,0;;;;;;13,0;;;;;;;2,0;;;1,0;;;;20,0;;;;;7,0;;14,0;;;;;;;;;;;;;5,0;;;;;;;;;;2,0;11,0;;;;;;;;;;;;;;;;;4,0;;;;;;;;4,0;;;;;;;;;;;;;;;;;;;9,0;;;49,0;14,0;1,0;4,0;;9,0;;;;;;;4,0;4,0;25,0;;;;1,0;5,0;;21,0;;;;;;;;4,0;10,0;;6,0;2,0;;1,0;;;;;;;;;;;;;;9,0;19,0;1,0;1,0;;3,0;16,0;;;;;1,0;1,0;;2,0;;2,0;4,0;14,0;;;;;;7,0;;8,0;35,0;34,0;;;4,0;;1,0;;;;;6,0;;;;;;;;;8,0;2,0;6,0;;;;;;;;;16,0;;;;;;;1,0;;;;2,0;;;;;;;2,0;;;;;;;;;;;1,0;6,0;;;;;;;;;;;;;;1,0;1,0;;;;;;;;;;;;4,0;;;4,0;1,0;;;;;;;;;;27,0;;;21,0;2,0;;;;;;;;;;1,0;;;;1,0;;;;;;;;;;;;;;;;;;9,0;;;;;4,0;;;;;;;;;;;;;;;;;;;;;;;;;;;;;;;;;;;;;;;;;;;;;;;;;;;;;;;;;;;;;;;;;;;;;;;;;;;;;;;;;;1,0;;;;;;;;;;;;;;;;;;
gamma;;;7,0;;4,0;;2,0;14,0;;11,0;;2,0;;1,0;4,0;;;;7,0;2,0;;13,0;3,0;5,0;39,0;;8,0;14,0;4,0;50,0;5,0;36,0;7,0;;4,0;2,0;;32,0;;19,0;7,0;1,0;;16,0;1,0;;;4,0;4,0;;;13,0;;1,0;;55,0;27,0;2,0;3,0;5,0;;;35,0;;3,0;;1,0;;;5,0;2,0;2,0;4,0;;;;;;24,0;2,0;;19,0;5,0;3,0;;;9,0;2,0;;2,0;7,0;;1,0;7,0;;1,0;1,0;;4,0;;2,0;100,0;;;;;;4,0;;2,0;;2,0;4,0;;5,0;1,0;;2,0;;2,0;;;1,0;7,0;;;7,0;1,0;5,0;2,0;;2,0;9,0;;2,0;44,0;3,0;;;25,0;32,0;;;3,0;;;2,0;;;;1,0;;1,0;;;;2,0;14,0;;49,0;21,0;14,0;;;9,0;2,0;;10,0;;4,0;;1,0;;6,0;;1,0;;2,0;;;;;2,0;;;3,0;;11,0;;11,0;;;24,0;1,0;;;;;4,0;1,0;;2,0;;1,0;;;6,0;9,0;1,0;;15,0;;;;5,0;4,0;;;;;;1,0;;1,0;;;;;;;;;;1,0;7,0;12,0;;3,0;3,0;;;;;;;;;;;;;;;1,0;;;;1,0;;;;;;;;;;;;;;2,0;;1,0;;1,0;;;;1,0;;;2,0;;;;1,0;1,0;2,0;4,0;;1,0;2,0;3,0;;;1,0;;7,0;;1,0;;5,0;;2,0;;2,0;6,0;;2,0;1,0;5,0;;;;;;1,0;;;;;;;;59,0;;;1,0;;;1,0;;;;;;1,0;;;;;;1,0;;;;;;8,0;3,0;;;;;;;;;;1,0;;;;1,0;;;;2,0;;;;;1,0;2,0;;;;;3,0;;;;;;2,0;5,0;;;2,0;;;;;;;;;;;4,0;;;;25,0;;;1,0;;;1,0;1,0;1,0;;;1,0;;;1,0;;4,0;;;7,0;;;1,0;;2,0;;;8,0;;;2,0;;3,0;;;1,0;;;;;;9,0;21,0;6,0;;1,0;;;3,0;2,0;;3,0;;;;;;1,0;;;;3,0;;;;;;20,0;;;;5,0;;;;;;;;2,0;;9,0;1,0;;;9,0;;;;;1,0;3,0;;4,0;6,0;;;;;;;;;;;1,0;;;;8,0;1,0;1,0;;;;;;;3,0;;;;;;;1,0;;;;;;7,0;;4,0;;;;;;;;;;;;;1,0;1,0;;;;;1,0;8,0;;;4,0;;;;;;4,0;;;;;1,0;;;;;;;;;;;1,0;;;;;;;;;;;;1,0;;4,0;;;;;;;;2,0;;1,0;;;;;;1,0;;;;2,0;;;;;;;;;;1,0;1,0;1,0;;;;;;2,0;;;;;;;1,0;;;;3,0;;1,0;1,0;;2,0;;;;;;;;;;2,0;;;;;;;;;;;;;3,0;;1,0;;2,0;;;;;1,0;3,0;23,0;;;;;;;;;;1,0;;1,0;;3,0;;;;;;2,0;;;;;23,0;;;;;;;1,0;;;;;8,0;;1,0;;;;;;;1,0;;1,0;1,0;;1,0;;;;;;;;;;;6,0;;1,0;;;;;;;;;;1,0;;;;3,0;;;;7,0;;;;;;;;;22,0;5,0;2,0;;2,0;;;;;;;;;;;;;;;;;;;;;;;;;;;;;;;;;;4,0;;;;;;;;;;;1,0;;;;;1,0;;;;;2,0;;;;;;1,0;;;;;;;;;;;;4,0;1,0;1,0;;;;;;;2,0;;;;;;;;;;;;;;;10,0;1,0;;;;;;;;2,0;;;;;;;;;;;;;;;;;;;;;;;;;;1,0;;;;;1,0;;;;;;;;;;;;12,0;;;;;;;;;;;6,0;;;;2,0;;;;;;;;;;;;;;;;;;;;;;;;;;1,0;2,0;;;;;;;;1,0;;;1,0;;;3,0;;;;;;;;;;;;;;;
gear;;;6,0;;10,0;;27,0;7,0;1,0;;6,0;;;;;;;;1,0;;;9,0;;;;;;;1,0;;;1,0;17,0;;4,0;;2,0;30,0;;1,0;3,0;;132,0;11,0;;;3,0;;6,0;;1,0;1,0;;6,0;;6,0;38,0;;;72,0;1,0;;2,0;;;153,0;7,0;;;3,0;6,0;;;;3,0;;4,0;;9,0;17,0;1,0;;;;;;;;;;;4,0;;;;;;;;;10,0;30,0;;;;;3,0;28,0;;;14,0;3,0;;12,0;13,0;;1,0;;3,0;10,0;;1,0;1,0;3,0;1,0;;11,0;2,0;;52,0;2,0;;;3,0;1,0;;6,0;;;;;;3,0;;;27,0;26,0;7,0;;;;7,0;4,0;;4,0;3,0;7,0;13,0;;3,0;;3,0;8,0;5,0;;;1,0;1,0;;;26,0;5,0;20,0;33,0;5,0;2,0;9,0;4,0;;;;3,0;2,0;;10,0;;8,0;7,0;;25,0;;2,0;;7,0;;4,0;;;35,0;3,0;;9,0;;16,0;;;;;;22,0;;3,0;;1,0;54,0;3,0;25,0;2,0;1,0;;1,0;7,0;;;5,0;;;;;;;;2,0;;8,0;1,0;12,0;3,0;1,0;2,0;8,0;7,0;;4,0;;2,0;;;6,0;1,0;;;;28,0;3,0;;4,0;1,0;;;;82,0;6,0;5,0;74,0;11,0;9,0;;1,0;;;;;;;;;5,0;8,0;;8,0;;1,0;37,0;;;24,0;1,0;1,0;2,0;;;;;;;;1,0;1,0;13,0;;2,0;2,0;;;3,0;;10,0;1,0;;;;;;27,0;;6,0;1,0;28,0;1,0;5,0;;32,0;2,0;;6,0;;2,0;;;;;14,0;;;;;;;;;1,0;;;;;;;;11,0;;;;;;;;;;;;;;;;;;;4,0;;;;;;;;;;;10,0;;6,0;;;;;;8,0;;;2,0;4,0;16,0;3,0;19,0;1,0;;;;;;;;;;;;8,0;;;;5,0;;3,0;;;;;12,0;;;;;;;2,0;;;;;;;;;;;;;;;3,0;;;;;;;;;;1,0;;;6,0;;;;;;;;;;;;;6,0;;;;;1,0;2,0;;;;;;;;;;;;;67,0;;;;;;6,0;;16,0;;1,0;;;;;;;;;15,0;;;;;;;;;;;12,0;3,0;;;;6,0;;;;;;2,0;;;;;;1,0;;;;;2,0;;;;;1,0;3,0;;;6,0;;;;;;;;;;;;;;;;;;;;;;;;;;;;;;;;;;;;;;;;8,0;;;;;1,0;;17,0;11,0;23,0;;;;1,0;;;;;;;;;1,0;;;;;;;;;;;;1,0;;;;;;;;11,0;;;9,0;;9,0;;;;;17,0;10,0;;;;;;;;;;;;;;;1,0;1,0;3,0;;;;;;;;;;;;;3,0;;;;;;1,0;;;;;;;;;;;;1,0;;;;5,0;;;;;;;;;1,0;;;;;;;;;;;2,0;;;;;;5,0;;;;;2,0;;;;;;;;;;;;9,0;;;;;;;1,0;;;;8,0;;;;;;;;;;;;;1,0;;;;;1,0;;;;;;;;;;;;1,0;;6,0;;;;;;;1,0;;;;;;;;;;;;;;;;;;;;;;;;4,0;;;;;;;1,0;;1,0;;;;;2,0;;;;1,0;;;;;;;;;;;;;5,0;;;;;;;;;;;;;;;;;;64,0;3,0;;;;;23,0;;;;;;;;;;;;;;;;2,0;;;;;4,0;;;;;;;;;;;;;;;;;2,0;;;;;;;;;;;;;;;;;;;;4,0;;;;1,0;;;;;;;;;;;;;;;;;;;;;;;;;;;;;;;;;;2,0;;;;;;;;;;;;;;;30,0;;;;;;;;;;;;;;;;;;;;;;;;;
green;;;2,0;1,0;5,0;;;9,0;3,0;19,0;;6,0;;;97,0;5,0;;;42,0;;4,0;2,0;;1,0;9,0;1,0;1,0;14,0;1,0;2,0;10,0;4,0;8,0;4,0;20,0;;;;;6,0;;;;18,0;;;;2,0;6,0;4,0;;32,0;;3,0;;129,0;23,0;3,0;2,0;6,0;1,0;;37,0;2,0;;;;;;;2,0;3,0;;;;2,0;;;1,0;;;4,0;2,0;3,0;;;13,0;;11,0;10,0;23,0;4,0;;57,0;;11,0;;;;;;3,0;;1,0;;;21,0;1,0;2,0;3,0;3,0;4,0;17,0;;;9,0;;178,0;;;;;;1,0;;4,0;4,0;;;7,0;;1,0;;;;;6,0;;1,0;6,0;;;1,0;;37,0;;3,0;4,0;1,0;;;;;;;;;;2,0;12,0;;4,0;;;;7,0;1,0;123,0;;5,0;1,0;;1,0;;;;;5,0;;;;;;;;2,0;;11,0;;3,0;;;5,0;12,0;;;;;;;;;;;;6,0;;;;;;;;;;;7,0;;;;;;;6,0;;18,0;;;;;;;;12,0;6,0;;;4,0;;;;;;;;3,0;29,0;1,0;;;;;;;;;;;;;;;;;;;;;;;;;;;;;;;;;;;;;;;;7,0;;12,0;;;;4,0;;;;1,0;;;;;;;;;;10,0;;;13,0;5,0;;;;;;;;;;1,0;;;2,0;6,0;1,0;;;;;;2,0;;;;;;;;;;;;;;1,0;;;1,0;;;10,0;;;3,0;1,0;;;;;;;;;3,0;;;;;3,0;;;5,0;2,0;;;;;;;;7,0;1,0;1,0;;;;;5,0;;;;;;;;;3,0;;;;;1,0;;;;;;;;;;3,0;;;;;4,0;1,0;;;;;;;;1,0;4,0;2,0;;;;;;;;;;;;;;;;;1,0;8,0;;;;;;1,0;;;;;;;;;;4,0;;;;;;;;4,0;;;;;;;;;;;;;;1,0;3,0;;;2,0;;;3,0;;1,0;;;;;;;;1,0;;;;;;;;;;;1,0;1,0;;;;;;;;;;;2,0;;;18,0;;;;;;;10,0;;;;;;;;;;1,0;;;;;;;;1,0;;;2,0;;;;92,0;;;;;;;;;;;;;;;;;;;;;;1,0;1,0;;;;;9,0;;;;;;56,0;14,0;;;4,0;;;;;;;;;;;;;;;;;;;;;;;;3,0;4,0;;;;;;;;;;2,0;;;;;;;;;;;4,0;1,0;;;;;2,0;;;;;;;;;2,0;;;;;;;;;;4,0;;;;;;;;5,0;;2,0;;;33,0;;;;;;;;;;;;14,0;;;;;;;;;;;;4,0;;;2,0;;1,0;10,0;;;;;;;;;;;;;;;1,0;;17,0;;;;;;;;;;;11,0;;;;;;;4,0;;;;;;2,0;;;;;;;;8,0;7,0;3,0;;;;;;;;;;1,0;;;1,0;;;;;;;;;3,0;;;;;;;;;;;;;;;;;;;;3,0;;;2,0;;;;;;;;;;;;;;1,0;;;;;;2,0;;;1,0;;;;;;;;;11,0;;;;;;;;;;;;4,0;;12,0;;;;;;;;2,0;;;;;;;;;;1,0;;;;;;;5,0;;;;;;;;;;;;;;;;;;;;;;;;;;;;;;2,0;;;;;;10,0;;;;;;;;;;;;1,0;;;1,0;;;;2,0;;;;;;;;;;;;;;;;;;;;;;;;;;;;;;;;;;;4,0;;;;;;;;;;;4,0;;;;;;;;;;;;;;;;;;;
guide;;;6,0;;83,0;;95,0;50,0;4,0;9,0;12,0;;8,0;;;;;;15,0;;;20,0;2,0;3,0;11,0;;22,0;2,0;11,0;2,0;;6,0;132,0;;3,0;;1,0;215,0;14,0;38,0;8,0;;24,0;77,0;;1,0;5,0;;9,0;;3,0;4,0;;42,0;3,0;110,0;54,0;;7,0;301,0;35,0;;22,0;;;6,0;86,0;;5,0;8,0;185,0;2,0;29,0;7,0;5,0;24,0;;3,0;89,0;14,0;13,0;3,0;;1,0;1,0;2,0;8,0;2,0;6,0;3,0;3,0;;4,0;5,0;1,0;21,0;;4,0;6,0;4,0;157,0;106,0;;6,0;;;;74,0;;1,0;18,0;18,0;;24,0;10,0;;3,0;;8,0;52,0;1,0;16,0;;6,0;;;97,0;25,0;;62,0;40,0;3,0;3,0;51,0;8,0;3,0;86,0;8,0;;11,0;;;11,0;34,0;9,0;8,0;130,0;81,0;1,0;;;158,0;;;27,0;77,0;142,0;28,0;6,0;36,0;36,0;;33,0;5,0;5,0;13,0;2,0;389,0;;1,0;429,0;34,0;65,0;31,0;61,0;28,0;23,0;1,0;;3,0;;;19,0;3,0;14,0;22,0;103,0;69,0;1,0;150,0;2,0;118,0;9,0;50,0;2,0;34,0;3,0;2,0;91,0;10,0;1,0;21,0;4,0;73,0;17,0;14,0;10,0;34,0;14,0;81,0;9,0;4,0;;9,0;3,0;2,0;5,0;11,0;12,0;3,0;32,0;5,0;;1,0;34,0;1,0;5,0;;2,0;10,0;2,0;4,0;21,0;18,0;6,0;8,0;4,0;7,0;12,0;;57,0;35,0;16,0;22,0;21,0;4,0;20,0;1,0;8,0;32,0;;2,0;;53,0;2,0;;8,0;27,0;;2,0;;14,0;2,0;22,0;71,0;4,0;73,0;;9,0;1,0;4,0;7,0;;5,0;35,0;9,0;2,0;9,0;18,0;19,0;16,0;17,0;;38,0;2,0;5,0;77,0;33,0;1,0;18,0;3,0;5,0;2,0;2,0;;9,0;;21,0;1,0;2,0;10,0;7,0;2,0;9,0;25,0;10,0;80,0;7,0;6,0;12,0;8,0;6,0;6,0;20,0;7,0;3,0;2,0;1,0;12,0;;22,0;5,0;175,0;73,0;;11,0;5,0;10,0;7,0;14,0;12,0;;;;;;1,0;;;;3,0;5,0;;;5,0;;;1,0;4,0;2,0;9,0;;1,0;;;;;1,0;;;;;;;3,0;;;;;;;;;;4,0;2,0;2,0;;;27,0;2,0;6,0;;;;;;;;5,0;6,0;;8,0;2,0;18,0;;1,0;7,0;;2,0;15,0;;4,0;;;;2,0;7,0;;;7,0;3,0;3,0;4,0;1,0;1,0;11,0;;5,0;1,0;7,0;;;13,0;;2,0;;;;;4,0;;;;;1,0;;;;;;;;;1,0;;2,0;3,0;;1,0;;1,0;3,0;6,0;1,0;;;;;;;;;8,0;;4,0;48,0;;;;;;;;1,0;;11,0;;2,0;;;1,0;;;;33,0;6,0;;;1,0;4,0;;;1,0;7,0;4,0;12,0;2,0;;;;;;;15,0;2,0;;21,0;;30,0;12,0;;;5,0;8,0;;4,0;;;;;6,0;;;;12,0;2,0;;2,0;2,0;;;1,0;;3,0;;;;;1,0;;;1,0;14,0;4,0;1,0;13,0;;;;3,0;4,0;6,0;1,0;;;;8,0;;;7,0;;;;2,0;4,0;13,0;;3,0;;1,0;;;;3,0;;113,0;;2,0;;;;74,0;;;17,0;2,0;;;;;;;3,0;;;;;2,0;2,0;;;;2,0;;;;10,0;1,0;6,0;3,0;4,0;;;;;;;;;;;;9,0;1,0;;;1,0;5,0;;5,0;36,0;3,0;1,0;9,0;14,0;55,0;25,0;3,0;;;1,0;;;13,0;3,0;;;5,0;1,0;;;;2,0;4,0;19,0;14,0;1,0;2,0;1,0;5,0;;;15,0;4,0;3,0;2,0;;;25,0;9,0;;;1,0;9,0;1,0;;;;;;;;;;;;;;3,0;;;;;;;;8,0;;;2,0;;;;1,0;;;;1,0;;;;;;;;;4,0;;2,0;2,0;;2,0;;;1,0;;;;;5,0;;;;;;;;;1,0;;;;;;;;;;;;2,0;;;;;;;4,0;5,0;;;;;;1,0;;;;;;4,0;;1,0;;8,0;3,0;5,0;;;;;;;;;;2,0;;;;;;;5,0;7,0;;3,0;;;;;;6,0;2,0;;6,0;;2,0;;;;;16,0;3,0;;;;;;;;13,0;;1,0;10,0;;;3,0;2,0;2,0;4,0;1,0;;;1,0;2,0;;;;1,0;3,0;2,0;;;;;;;4,0;2,0;;;;;;4,0;5,0;5,0;4,0;9,0;;;4,0;9,0;;5,0;;;3,0;;;4,0;4,0;29,0;;;;1,0;10,0;;4,0;;5,0;7,0;;1,0;;1,0;;;;;;;13,0;2,0;;2,0;;;6,0;;;;;1,0;;;;3,0;;;1,0;;1,0;;;;;;;;;;1,0;;;;;;;;;;;;;;;;;;;;;3,0;;;10,0;;;1,0;14,0;35,0;2,0;;;;;;;;;;;;;1,0;;;;;;;;;;1,0;;;;;;;4,0;4,0;;;;;;;;;;;1,0;;
head;;;3,0;;61,0;;21,0;113,0;3,0;18,0;38,0;;;;1,0;4,0;;1,0;37,0;3,0;;66,0;3,0;;;;3,0;90,0;7,0;13,0;28,0;23,0;57,0;;13,0;3,0;2,0;32,0;;28,0;6,0;;28,0;72,0;;;;;1,0;;8,0;9,0;;;1,0;140,0;131,0;;;14,0;4,0;;59,0;;;15,0;19,0;;2,0;33,0;33,0;;3,0;1,0;;3,0;;10,0;132,0;3,0;2,0;31,0;7,0;1,0;;;9,0;2,0;;6,0;18,0;3,0;3,0;108,0;11,0;1,0;;1,0;5,0;;28,0;89,0;;49,0;;;28,0;64,0;;;4,0;3,0;16,0;68,0;22,0;;4,0;;11,0;89,0;71,0;;8,0;2,0;;;32,0;14,0;;39,0;;2,0;;;;51,0;10,0;;;3,0;;;;20,0;1,0;;5,0;56,0;22,0;;;2,0;8,0;6,0;4,0;2,0;14,0;5,0;;69,0;;;7,0;1,0;3,0;;12,0;42,0;;12,0;40,0;4,0;8,0;174,0;8,0;10,0;3,0;7,0;12,0;;;1,0;8,0;2,0;;17,0;16,0;18,0;;163,0;;;5,0;70,0;;7,0;;;6,0;9,0;;7,0;;29,0;;;;10,0;3,0;39,0;4,0;6,0;;;16,0;11,0;29,0;;;9,0;2,0;6,0;;;2,0;;;;;;;;;2,0;6,0;15,0;3,0;2,0;22,0;;2,0;11,0;1,0;5,0;4,0;6,0;;8,0;2,0;;;3,0;;40,0;;2,0;4,0;7,0;;1,0;;26,0;1,0;;20,0;;9,0;;5,0;1,0;;10,0;6,0;13,0;4,0;28,0;;;;16,0;17,0;;1,0;15,0;;9,0;13,0;9,0;13,0;2,0;;;;5,0;;;1,0;22,0;4,0;;4,0;3,0;5,0;9,0;1,0;4,0;;6,0;4,0;;19,0;;;;21,0;2,0;10,0;;28,0;;1,0;8,0;17,0;1,0;;9,0;;1,0;14,0;5,0;17,0;;1,0;;;;;2,0;3,0;4,0;1,0;7,0;;1,0;;;;2,0;;4,0;17,0;;2,0;;;;;;1,0;1,0;10,0;4,0;;;84,0;3,0;;;3,0;5,0;16,0;2,0;;;5,0;3,0;;;;14,0;2,0;9,0;1,0;8,0;1,0;;1,0;;;19,0;8,0;;6,0;;;3,0;4,0;;3,0;1,0;8,0;;7,0;;;1,0;1,0;7,0;;;6,0;4,0;6,0;;;1,0;3,0;;8,0;;89,0;;;9,0;13,0;;;1,0;;;1,0;1,0;4,0;;;85,0;2,0;;2,0;1,0;4,0;2,0;1,0;1,0;8,0;4,0;6,0;1,0;;3,0;;2,0;2,0;;;9,0;1,0;;3,0;;6,0;4,0;;1,0;24,0;8,0;5,0;;1,0;7,0;;24,0;19,0;4,0;2,0;3,0;32,0;15,0;4,0;13,0;6,0;;1,0;;;45,0;3,0;4,0;;14,0;3,0;3,0;;2,0;10,0;23,0;8,0;;;4,0;;;2,0;;;4,0;;1,0;;1,0;2,0;;;;34,0;8,0;;;1,0;;24,0;21,0;;3,0;;1,0;7,0;8,0;;;1,0;;2,0;5,0;1,0;;3,0;11,0;;;;;;1,0;1,0;;;4,0;;;1,0;2,0;;;3,0;;11,0;;1,0;4,0;10,0;6,0;2,0;;5,0;;25,0;;;;;8,0;;;1,0;;3,0;;;2,0;;;38,0;;;3,0;15,0;;;31,0;8,0;;1,0;;;;4,0;;1,0;;;;1,0;1,0;;;3,0;1,0;15,0;;3,0;1,0;;3,0;1,0;;22,0;1,0;3,0;1,0;;;;18,0;;14,0;;;4,0;17,0;;3,0;3,0;16,0;3,0;4,0;1,0;4,0;2,0;;;;;;;;;;6,0;5,0;2,0;;;15,0;;10,0;3,0;;10,0;2,0;9,0;;;;9,0;4,0;;;3,0;1,0;;;;1,0;3,0;2,0;;;;;;;;;;;;2,0;1,0;;;1,0;;;;;;6,0;1,0;1,0;;;;;;;;2,0;;28,0;;4,0;;4,0;;;;1,0;;28,0;;1,0;;2,0;;4,0;;;1,0;;6,0;1,0;3,0;;2,0;1,0;1,0;;;;1,0;;;;;;;;;;;;;2,0;;;;;;2,0;;;;18,0;;;1,0;1,0;1,0;;2,0;;;;;;;2,0;3,0;;;1,0;;12,0;;;4,0;;;;6,0;5,0;;3,0;6,0;;;2,0;;2,0;1,0;;1,0;;;;;1,0;;1,0;9,0;;1,0;;;;;;3,0;;2,0;;3,0;7,0;;11,0;;;5,0;;4,0;3,0;4,0;;;;;;4,0;;;;5,0;6,0;;;;;2,0;1,0;;;;;;;4,0;4,0;2,0;;;3,0;1,0;2,0;;;;;;;;;1,0;;5,0;;;;;;;;;2,0;4,0;;;;8,0;;;11,0;1,0;;;;3,0;;;;2,0;6,0;11,0;13,0;;;;;;1,0;7,0;;1,0;2,0;;;;;;;2,0;;;;;4,0;5,0;;;;;;;;;1,0;3,0;17,0;;7,0;;;;;;;;;;;;2,0;;;;;;;;1,0;;1,0;;;;;;;3,0;4,0;;;1,0;;;;15,0;;;;;;;;;;;;;;;;4,0;;;;;;;
heat;;;2,0;;8,0;;10,0;;;1,0;;1,0;;;1,0;1,0;;;5,0;;;4,0;;;10,0;;;;;4,0;7,0;1,0;63,0;;;;1,0;10,0;;2,0;2,0;;1,0;43,0;;;2,0;;1,0;;;29,0;1,0;1,0;;36,0;30,0;;14,0;25,0;;;13,0;;;2,0;1,0;1,0;;1,0;29,0;5,0;1,0;;;;;1,0;24,0;11,0;3,0;10,0;6,0;2,0;2,0;;8,0;;;2,0;42,0;4,0;4,0;14,0;;2,0;2,0;;10,0;22,0;24,0;7,0;;24,0;;;;12,0;1,0;6,0;8,0;;2,0;3,0;5,0;;2,0;;8,0;33,0;;;1,0;9,0;;;23,0;8,0;;3,0;1,0;;1,0;;;9,0;5,0;;11,0;1,0;13,0;;2,0;2,0;;;32,0;5,0;;;;;;;1,0;3,0;;20,0;3,0;44,0;;;1,0;5,0;;15,0;2,0;10,0;1,0;81,0;94,0;;24,0;14,0;;5,0;2,0;;;1,0;;4,0;;;;;12,0;18,0;;19,0;1,0;;6,0;8,0;;;;;;6,0;17,0;;1,0;29,0;;1,0;;;17,0;3,0;;2,0;4,0;;;;8,0;1,0;;;6,0;;1,0;;3,0;;2,0;;;;1,0;;2,0;2,0;;;;3,0;5,0;;8,0;;;;1,0;;3,0;8,0;;;;2,0;32,0;23,0;;2,0;;;;;;;1,0;;;;5,0;;;;;;;;2,0;;;;;13,0;1,0;;;32,0;9,0;5,0;;2,0;3,0;;;1,0;;;;4,0;;;;;2,0;;5,0;2,0;6,0;4,0;;1,0;13,0;;;;;;1,0;1,0;;1,0;;4,0;;10,0;;;;32,0;1,0;;3,0;;1,0;;;;;;;;;;1,0;1,0;;;;;;;1,0;1,0;1,0;;;;;;;;;;;;;;1,0;;;;;;;;2,0;4,0;;;;;;;1,0;1,0;;;2,0;;;;;;2,0;1,0;;3,0;1,0;;;;;1,0;;;1,0;;;;;;1,0;9,0;;;;;;;1,0;;2,0;2,0;;;;;;;;1,0;;;;1,0;;;;;;;1,0;;;;;;;;;24,0;;;;;3,0;2,0;;;;;1,0;;;;;2,0;;1,0;;;;;1,0;1,0;;;2,0;;;;;;;;;;;;;;;;1,0;;40,0;;;;;3,0;2,0;;;;;;;;;;;2,0;1,0;;;3,0;7,0;5,0;;;;;;;;;;;;;1,0;;;;;;;;;;;;;;;;;1,0;;;;;;;8,0;;;7,0;4,0;1,0;;;4,0;;;;;;1,0;;;;;2,0;;;;;;;4,0;;;;;;;1,0;;;;;1,0;4,0;;;;;;;2,0;;;;;;1,0;;;;;;;;;;;;;;;;;;;;;;;;3,0;;;9,0;;;;;1,0;;;14,0;;;;7,0;;;;;;;;;;;;;;;;;;;;;;1,0;;;;;;;;;;;;;;;;;;;;;11,0;;;;;;;;;;;;;;;;;;;;;;3,0;11,0;;;;;;;1,0;;;1,0;;;;;;;1,0;;1,0;;;;;;;;;;;;2,0;;;;;;;;;;;;;;;;;;8,0;4,0;;;;;;;;2,0;;;;1,0;;;;6,0;1,0;;;;;;;;;;;;;;;;;;;;;2,0;;1,0;;;;;;;1,0;;2,0;;;;;;;;2,0;;;;;;;;;;;4,0;;;;;;;;;;;2,0;;;;2,0;;;7,0;;;;;;;;;;;1,0;;6,0;;;;;;;;;;;;4,0;1,0;;;;;;;;;;;;;;;;;;;;;;;;;;;;;;4,0;;;;;;;1,0;;;;;;;3,0;;;;;;;;;;1,0;;;;;;;;;;;;;;;;;;;;;;;4,0;1,0;2,0;;19,0;1,0;;;6,0;;;;;;;;;;1,0;;;;;;;;;1,0;;;;;;;;;;;;;;;;;;;;;;;;
hold;;;4,0;;47,0;;50,0;34,0;3,0;20,0;6,0;;2,0;;10,0;5,0;;;23,0;6,0;2,0;40,0;1,0;1,0;65,0;;;55,0;;30,0;9,0;7,0;105,0;;13,0;;;95,0;;18,0;3,0;1,0;78,0;102,0;;1,0;;4,0;12,0;;2,0;3,0;1,0;67,0;1,0;93,0;100,0;;4,0;724,0;;;11,0;;;15,0;43,0;2,0;;16,0;163,0;7,0;3,0;7,0;5,0;3,0;;5,0;103,0;5,0;2,0;5,0;1,0;;;11,0;35,0;;1,0;32,0;11,0;;19,0;128,0;2,0;9,0;;16,0;11,0;5,0;35,0;59,0;;74,0;;;;494,0;;1,0;4,0;41,0;3,0;28,0;16,0;;10,0;;17,0;79,0;3,0;;10,0;54,0;;;76,0;11,0;;2,0;22,0;;2,0;;;8,0;45,0;;;;;;1,0;6,0;25,0;11,0;40,0;174,0;;11,0;;5,0;27,0;1,0;;83,0;16,0;20,0;4,0;50,0;;3,0;13,0;7,0;6,0;1,0;7,0;11,0;2,0;3,0;415,0;7,0;81,0;58,0;8,0;8,0;12,0;36,0;;;3,0;1,0;3,0;2,0;2,0;13,0;20,0;87,0;;129,0;;;;39,0;3,0;;;2,0;17,0;9,0;1,0;13,0;6,0;17,0;3,0;;2,0;1,0;40,0;74,0;;4,0;;;;32,0;2,0;4,0;;6,0;6,0;5,0;16,0;;4,0;;7,0;;;5,0;;;9,0;1,0;6,0;6,0;7,0;4,0;5,0;;161,0;14,0;2,0;1,0;2,0;19,0;;9,0;11,0;11,0;35,0;;;45,0;1,0;;24,0;6,0;1,0;8,0;1,0;40,0;7,0;11,0;22,0;7,0;11,0;11,0;4,0;2,0;1,0;15,0;;49,0;6,0;;1,0;5,0;4,0;7,0;15,0;31,0;;30,0;1,0;3,0;60,0;6,0;4,0;3,0;;4,0;;1,0;;2,0;4,0;;;;2,0;1,0;17,0;8,0;13,0;5,0;1,0;3,0;24,0;17,0;2,0;9,0;9,0;1,0;14,0;;5,0;4,0;7,0;5,0;3,0;6,0;31,0;5,0;2,0;13,0;5,0;14,0;3,0;;16,0;;;8,0;;12,0;;;3,0;;;3,0;;10,0;2,0;2,0;;;;2,0;3,0;;;;;6,0;3,0;;2,0;;;1,0;2,0;3,0;;12,0;;;;;;;7,0;8,0;2,0;15,0;;1,0;;23,0;3,0;10,0;;3,0;;;;;;10,0;;4,0;;;9,0;;;8,0;8,0;;;;;;;1,0;;5,0;;3,0;2,0;11,0;48,0;1,0;1,0;;;;6,0;;;2,0;;;35,0;;;7,0;6,0;;;;1,0;1,0;;2,0;11,0;;;1,0;2,0;;;;;31,0;15,0;2,0;;4,0;;;;12,0;3,0;1,0;;2,0;;;;;;;;2,0;37,0;;4,0;;1,0;6,0;;;5,0;3,0;4,0;;;1,0;;2,0;;;;12,0;1,0;2,0;3,0;13,0;;38,0;1,0;;1,0;11,0;;15,0;;;;;;;2,0;;;16,0;;;7,0;;;;;;5,0;;2,0;;;6,0;;18,0;;;1,0;;2,0;4,0;;;;;;;5,0;14,0;8,0;;;;;2,0;2,0;;;;;;;2,0;;;1,0;;20,0;;;1,0;29,0;;2,0;1,0;;;14,0;;1,0;;;;;;12,0;;2,0;;;;;;3,0;;;7,0;2,0;;;;;7,0;;1,0;15,0;60,0;;;;1,0;;;;;5,0;;4,0;;;5,0;2,0;2,0;;;;;;5,0;;4,0;7,0;;;;1,0;;;;3,0;2,0;;11,0;2,0;2,0;1,0;2,0;1,0;1,0;14,0;;;;;2,0;;;;;;;;5,0;;3,0;7,0;;1,0;7,0;1,0;1,0;2,0;2,0;;;;;1,0;3,0;;;;;2,0;1,0;9,0;;;3,0;;;1,0;11,0;2,0;;2,0;17,0;;1,0;28,0;4,0;5,0;5,0;;1,0;;2,0;2,0;28,0;;2,0;6,0;;1,0;;;;;;;;2,0;;;3,0;;;7,0;;1,0;3,0;2,0;;;;;;;;;1,0;;3,0;;;;1,0;1,0;1,0;;2,0;;;;;;10,0;5,0;20,0;;;;15,0;1,0;1,0;1,0;;;;2,0;1,0;;;;1,0;1,0;;2,0;4,0;;;;;;;;4,0;;2,0;;;;;;1,0;;;3,0;;;;;3,0;;;5,0;;;9,0;;5,0;;;;1,0;;;;;;;;;;;;;;1,0;1,0;;10,0;;1,0;3,0;;;;;;;;10,0;2,0;;;;;;1,0;;;1,0;1,0;;7,0;;3,0;;;4,0;8,0;;2,0;;;;2,0;;3,0;;8,0;;;1,0;;;1,0;;;2,0;;;2,0;;2,0;;;;;;;;;4,0;5,0;;2,0;2,0;1,0;;;;;;;;;;;;;5,0;5,0;;;;;;1,0;;3,0;;;1,0;;;;;;;;;1,0;;5,0;4,0;;;;;;;;1,0;;;;3,0;;;;;;1,0;25,0;;;;;;;;2,0;3,0;;1,0;;;;3,0;;;;;2,0;;;;;5,0;;;;;;2,0;;;;;;;;;;;;;;;;;;;;;;;;
holder;;;1,0;;27,0;;57,0;46,0;;23,0;7,0;1,0;4,0;;1,0;4,0;;;21,0;;2,0;8,0;2,0;1,0;;;5,0;1,0;15,0;13,0;;3,0;120,0;;41,0;;1,0;62,0;4,0;1,0;8,0;;12,0;53,0;;;1,0;;7,0;1,0;1,0;2,0;;3,0;3,0;146,0;155,0;;7,0;1055,0;1,0;;25,0;;;8,0;12,0;26,0;2,0;9,0;83,0;;6,0;13,0;9,0;;2,0;1,0;107,0;;15,0;3,0;12,0;;;3,0;;1,0;2,0;;109,0;2,0;;;2,0;23,0;;11,0;;89,0;137,0;32,0;;6,0;;;3,0;74,0;;1,0;7,0;20,0;;25,0;60,0;;;;59,0;113,0;15,0;;2,0;36,0;;;44,0;21,0;;62,0;43,0;2,0;;14,0;8,0;2,0;46,0;;2,0;1,0;;;6,0;6,0;71,0;12,0;151,0;112,0;;2,0;;27,0;77,0;3,0;83,0;;33,0;46,0;;30,0;;;66,0;34,0;;6,0;;21,0;1,0;19,0;92,0;;302,0;84,0;6,0;23,0;36,0;;16,0;;1,0;1,0;7,0;7,0;7,0;11,0;51,0;102,0;;251,0;1,0;36,0;;135,0;4,0;;;3,0;10,0;15,0;;24,0;;41,0;16,0;;4,0;;26,0;93,0;4,0;11,0;;;;2,0;5,0;13,0;;;40,0;5,0;1,0;;20,0;2,0;11,0;;;1,0;4,0;;17,0;19,0;11,0;2,0;16,0;6,0;3,0;;224,0;60,0;5,0;43,0;3,0;10,0;5,0;25,0;9,0;43,0;6,0;;9,0;57,0;;;57,0;77,0;;;;38,0;3,0;13,0;49,0;3,0;35,0;1,0;17,0;6,0;4,0;13,0;8,0;24,0;29,0;1,0;;1,0;14,0;8,0;;48,0;5,0;12,0;12,0;;22,0;9,0;;30,0;;5,0;;1,0;1,0;5,0;;;4,0;3,0;10,0;1,0;3,0;6,0;5,0;12,0;13,0;2,0;12,0;18,0;8,0;10,0;60,0;10,0;44,0;;;;40,0;10,0;8,0;2,0;29,0;38,0;1,0;2,0;15,0;44,0;2,0;;;;;;;;1,0;2,0;;;1,0;6,0;;2,0;;1,0;;3,0;14,0;7,0;11,0;;;;;;;1,0;;;;;;2,0;3,0;;;;5,0;;;;;1,0;1,0;2,0;1,0;;;3,0;;4,0;;7,0;;;;;;;1,0;1,0;30,0;4,0;3,0;;;;;;;;6,0;;;;;1,0;;4,0;3,0;8,0;26,0;;;3,0;6,0;;1,0;;3,0;;;8,0;1,0;;;;;;;1,0;;;;3,0;;;;;1,0;;;;1,0;1,0;;;;1,0;;;7,0;1,0;;;;;;;;;;2,0;6,0;;34,0;;4,0;;;2,0;3,0;;;4,0;10,0;;2,0;;;;2,0;;;30,0;1,0;;;1,0;;5,0;3,0;2,0;10,0;5,0;;;;;;;;;3,0;15,0;;18,0;;2,0;22,0;;;1,0;2,0;6,0;;;;;4,0;1,0;;;;;1,0;;;;;;7,0;3,0;;;;;;5,0;;1,0;;25,0;5,0;;;;;;;1,0;;;32,0;2,0;8,0;;;;;;;;;;33,0;;1,0;;;;;;18,0;;7,0;;;;;;;;;16,0;46,0;;;;;12,0;;;28,0;8,0;;1,0;;1,0;;;;;;;1,0;;;;1,0;10,0;7,0;;2,0;;;6,0;2,0;;;;;10,0;;;8,0;;;;;5,0;11,0;2,0;1,0;42,0;;;12,0;3,0;4,0;;8,0;;1,0;;;;;5,0;4,0;;;2,0;31,0;2,0;1,0;;2,0;7,0;4,0;;;;4,0;26,0;1,0;;;3,0;1,0;;;1,0;9,0;;3,0;1,0;;;;;;;;;;;;;;4,0;;;;;;10,0;;;;;;;;;;1,0;;3,0;;;;;;;;1,0;;;;;;;;1,0;;;1,0;;3,0;;;2,0;;;;;;;;6,0;;;;;;3,0;;;;2,0;;;;1,0;;;4,0;2,0;;;;2,0;;4,0;;;;;;;9,0;;;2,0;;;;;;;;;;;;;;;;;5,0;;6,0;;;1,0;;;;;;;;;;;;;;;;1,0;18,0;;;;;;;;1,0;;;1,0;2,0;;3,0;;;1,0;;;;;3,0;;;;;;2,0;;2,0;;;1,0;;3,0;2,0;;;;;;;2,0;10,0;2,0;3,0;3,0;;6,0;;;;1,0;;4,0;2,0;;;;3,0;1,0;;;;;;3,0;;4,0;11,0;2,0;2,0;1,0;13,0;;;;;;1,0;;;;;;;15,0;;;;;;1,0;;;;3,0;;;;;;;13,0;;;;;;;;;;;;;;;;2,0;;;;;;;;1,0;;15,0;;;1,0;6,0;2,0;;2,0;5,0;2,0;;4,0;;;;;;;;;;;;;8,0;;;2,0;;;;;;;1,0;;;;;1,0;;;4,0;;;;;;;;;;;;;
hole;;;2,0;;67,0;;50,0;57,0;;1,0;74,0;;3,0;;;2,0;;;;2,0;2,0;8,0;2,0;1,0;4,0;;6,0;1,0;10,0;5,0;;4,0;41,0;;18,0;2,0;;149,0;;6,0;5,0;;15,0;14,0;;;10,0;;1,0;;4,0;6,0;;1,0;;10,0;91,0;;11,0;195,0;7,0;;15,0;;;3,0;;2,0;;3,0;32,0;2,0;1,0;8,0;4,0;2,0;;2,0;110,0;7,0;1,0;;;;6,0;;6,0;;4,0;11,0;37,0;;;13,0;10,0;23,0;;6,0;1,0;35,0;84,0;11,0;;;;;2,0;25,0;;1,0;6,0;59,0;17,0;34,0;24,0;;19,0;;34,0;79,0;14,0;;;20,0;1,0;4,0;24,0;12,0;;50,0;99,0;2,0;6,0;19,0;8,0;5,0;56,0;15,0;85,0;5,0;;;13,0;25,0;15,0;6,0;296,0;15,0;2,0;4,0;;19,0;142,0;;16,0;33,0;;92,0;;16,0;18,0;;43,0;15,0;;40,0;;55,0;;12,0;177,0;2,0;102,0;119,0;24,0;44,0;43,0;2,0;4,0;;8,0;2,0;59,0;1,0;27,0;15,0;77,0;113,0;10,0;208,0;4,0;35,0;;120,0;10,0;1,0;;6,0;31,0;12,0;;30,0;;47,0;4,0;;38,0;27,0;8,0;138,0;;9,0;;6,0;2,0;;5,0;14,0;;1,0;18,0;2,0;;;20,0;1,0;3,0;;;;20,0;;7,0;14,0;4,0;2,0;14,0;3,0;27,0;1,0;71,0;10,0;11,0;58,0;7,0;4,0;5,0;13,0;7,0;14,0;;1,0;9,0;105,0;2,0;1,0;4,0;232,0;;37,0;;2,0;13,0;12,0;112,0;15,0;101,0;29,0;15,0;3,0;8,0;18,0;6,0;7,0;69,0;1,0;;9,0;8,0;13,0;23,0;5,0;2,0;21,0;;;19,0;5,0;4,0;19,0;;2,0;3,0;7,0;;5,0;;;1,0;10,0;14,0;12,0;8,0;10,0;18,0;13,0;2,0;1,0;9,0;9,0;;25,0;2,0;;27,0;;6,0;3,0;130,0;9,0;6,0;;59,0;23,0;;1,0;7,0;19,0;5,0;;1,0;;;;;;;;1,0;3,0;7,0;;1,0;;;;;1,0;2,0;3,0;20,0;;;;;1,0;;;;;;;;2,0;;;;;;;;4,0;;;;4,0;5,0;;;15,0;;;;;;;1,0;;;1,0;1,0;;6,0;1,0;8,0;;;6,0;;;;;;;;;;3,0;;;65,0;21,0;1,0;3,0;;;;;;;14,0;;;4,0;;;;;;;;;1,0;;;;;;;;2,0;;;;3,0;2,0;;2,0;;;;;6,0;16,0;;;;;;;;;;;7,0;6,0;40,0;1,0;;;7,0;2,0;2,0;;;;6,0;4,0;;;;;;;;31,0;6,0;;;1,0;4,0;1,0;;4,0;7,0;1,0;;;;;;;;;19,0;25,0;;4,0;;12,0;4,0;;;;19,0;13,0;3,0;;;;1,0;7,0;;;;;1,0;;;1,0;;;19,0;;;;4,0;;;;;;;7,0;2,0;;13,0;;;;;;3,0;;;12,0;;;1,0;;2,0;;;;;;6,0;;9,0;;;;;;30,0;;14,0;;6,0;;;;;;;21,0;37,0;;;;;9,0;;1,0;;1,0;;6,0;;2,0;;;;;2,0;;;;;1,0;25,0;40,0;;;;;;;4,0;;1,0;;;2,0;;;2,0;5,0;6,0;26,0;;29,0;3,0;30,0;4,0;49,0;1,0;7,0;32,0;3,0;;;3,0;;;;;;;2,0;;7,0;;2,0;16,0;24,0;2,0;1,0;6,0;;3,0;10,0;;;;5,0;2,0;4,0;;6,0;;;1,0;3,0;23,0;1,0;2,0;;;;;;;;;;;3,0;;;1,0;2,0;;;1,0;;;25,0;;;;;;1,0;;;;;;2,0;;1,0;1,0;;;;1,0;;;1,0;5,0;;10,0;;;;;;1,0;;;;;;;;4,0;;;1,0;;;;;;;;;;;;;;;;;;;3,0;;1,0;;;;;2,0;;;1,0;;;1,0;1,0;;2,0;14,0;1,0;;3,0;;;;;;;;;;;;;;;;41,0;;;1,0;;;;;;14,0;;;1,0;;;;;;;2,0;1,0;;;;;;;;3,0;;;;15,0;4,0;2,0;;;;;;;1,0;;;;;;1,0;13,0;;;;5,0;;;7,0;;;;;;;7,0;;7,0;;2,0;1,0;1,0;3,0;4,0;;;;;;;;2,0;;76,0;1,0;3,0;;;;4,0;;;9,0;17,0;;1,0;;4,0;;;;;;;;;;;;;9,0;5,0;;;;4,0;;;;14,0;;;;;;;1,0;;;;;;;;11,0;;;;;;;;;;;;1,0;;;;;;;;;;;;;20,0;1,0;3,0;5,0;;5,0;;;;2,0;;;;;;;;;;;;2,0;;;1,0;6,0;;;;;;;3,0;;;;6,0;;;;;;;;;2,0;;;;
hook;;;1,0;;4,0;;;15,0;;;;;;;;;;;;;1,0;1,0;;;;;;1,0;;;;;13,0;;;;;2,0;;1,0;;;;4,0;;;;;1,0;1,0;;;;1,0;;17,0;7,0;;3,0;3,0;;;1,0;;;;3,0;;;5,0;;;;1,0;;;;;8,0;;;;;;;;;;;;;;;17,0;2,0;;;2,0;;;8,0;13,0;;;;;;7,0;;;6,0;2,0;;51,0;3,0;;;;1,0;12,0;;;;;;;1,0;2,0;;6,0;1,0;;;;;;1,0;;;;;;2,0;7,0;;1,0;12,0;4,0;;;;20,0;3,0;;2,0;4,0;;;;;;;1,0;3,0;;;;;;7,0;;;6,0;15,0;2,0;;1,0;;;;3,0;;;;1,0;;11,0;4,0;;50,0;2,0;;;12,0;1,0;;;;1,0;1,0;;5,0;;14,0;;;;;41,0;4,0;;1,0;;1,0;;;6,0;;;1,0;;;;;1,0;;;1,0;;;;1,0;;;1,0;;;;;;;;6,0;;3,0;4,0;;;1,0;8,0;;;;9,0;;;;2,0;;;;1,0;4,0;;22,0;1,0;10,0;41,0;;;;1,0;2,0;;;;;7,0;1,0;1,0;7,0;3,0;;;1,0;;2,0;1,0;1,0;;;;;;;;;;;;;;;3,0;12,0;;;;5,0;;;;;;4,0;;;;2,0;;;;1,0;1,0;;;;;;;;;;;;;;;;;;1,0;;;;;;1,0;;;3,0;;;;;;;;;;;;;1,0;;;;;;;;2,0;;;;;;;;;;;;;;;;;;;2,0;;;;;;;;;;;;;;;;;;;;;;;;;;1,0;;;;2,0;;;2,0;;;;;;;;;;;;;;;;;10,0;;;;;;;1,0;;;;;;;;;;;;;;;;;;;2,0;2,0;;;;;;;;;;;;;;;;;;;2,0;;;;;1,0;;;;1,0;;;;;;;;;;;;;;;;;;;;;9,0;;;;;;;;;;;;;;;;;;;;2,0;;;;;;;;3,0;;3,0;;;;1,0;;;;;;;;;;;;;;;;1,0;;;;;1,0;;;;;2,0;;;;;;;;;;;;;;2,0;1,0;;;;;;;2,0;;;1,0;;;;;;;;54,0;;4,0;;;;;;;;;;;;;;2,0;;7,0;2,0;;;2,0;2,0;1,0;;4,0;;1,0;;;6,0;;;;;;;;3,0;2,0;;;;;;;;;;;;;;;;;;;;;5,0;;;;;;;;;;;;;;;;;;;;;;;;;;;;;;;;;;;;;;;;;;;;;;;;;;;;;;;;;;;;;;;;;;;;;;;;;;;;;;;;;;;1,0;;;;;;;1,0;;;;;;;;;;;;;;;;;1,0;;;;;;1,0;;;;;;;;;;;;;;;;;;;;;;;;;;;;;;2,0;;;;;;2,0;;;;1,0;;1,0;2,0;;3,0;;3,0;1,0;;;;;;;2,0;2,0;;;1,0;2,0;;;;;;;1,0;;;;;;;;1,0;;1,0;;;;;;;;;;;;2,0;;;;;;;;;;;3,0;1,0;;;;;;;;;;;;;;;;;;8,0;1,0;;;;;;;;;;;;;;;3,0;;;;4,0;;;;;;;;;;;;;;;;;;;;;;;;;;;;;;1,0;4,0;;;;;1,0;;;;;;;;;;;;;;;;;;;;;;;;;;;;;;;;;;;;;;;;;
horizontal;;;30,0;;18,0;;83,0;53,0;33,0;12,0;22,0;;;1,0;9,0;;;5,0;41,0;1,0;2,0;64,0;6,0;1,0;3,0;;2,0;62,0;21,0;21,0;15,0;29,0;41,0;17,0;28,0;;7,0;261,0;4,0;39,0;28,0;;9,0;45,0;;3,0;;4,0;5,0;4,0;2,0;39,0;1,0;8,0;6,0;151,0;40,0;4,0;19,0;25,0;;3,0;55,0;;4,0;2,0;3,0;;;20,0;27,0;5,0;8,0;3,0;;;;17,0;85,0;1,0;2,0;15,0;3,0;4,0;1,0;2,0;66,0;8,0;12,0;26,0;43,0;17,0;2,0;227,0;14,0;12,0;;;35,0;3,0;21,0;14,0;;261,0;2,0;;1,0;159,0;;;2,0;22,0;20,0;6,0;3,0;;;;3,0;8,0;1,0;1,0;;33,0;;2,0;16,0;5,0;;1,0;8,0;1,0;;;1,0;13,0;36,0;;12,0;;1,0;;1,0;6,0;1,0;3,0;42,0;38,0;;3,0;;9,0;8,0;;28,0;10,0;25,0;15,0;;36,0;;1,0;1,0;1,0;1,0;2,0;7,0;33,0;;;8,0;7,0;17,0;18,0;17,0;2,0;5,0;41,0;1,0;;;;7,0;;32,0;71,0;20,0;43,0;;34,0;;;;15,0;;4,0;;1,0;44,0;1,0;;4,0;1,0;27,0;;2,0;25,0;;11,0;39,0;;2,0;;15,0;36,0;8,0;5,0;2,0;1,0;;5,0;7,0;;;5,0;;13,0;;1,0;;;;5,0;12,0;6,0;58,0;;6,0;35,0;2,0;5,0;6,0;4,0;7,0;;1,0;3,0;2,0;2,0;;29,0;;5,0;16,0;4,0;;;18,0;1,0;;5,0;23,0;39,0;1,0;1,0;1,0;20,0;1,0;;5,0;;;;2,0;1,0;2,0;;14,0;1,0;22,0;;;;;;20,0;14,0;9,0;;2,0;;2,0;1,0;2,0;;12,0;;5,0;;;;;18,0;2,0;4,0;1,0;;11,0;3,0;4,0;9,0;12,0;;;;;11,0;;;;;;6,0;1,0;;11,0;4,0;2,0;12,0;4,0;4,0;;6,0;;;11,0;;;14,0;2,0;2,0;;;;2,0;1,0;;5,0;2,0;3,0;7,0;2,0;8,0;;;;;4,0;;;2,0;2,0;1,0;;3,0;3,0;1,0;;4,0;6,0;;12,0;;10,0;1,0;31,0;6,0;;;12,0;92,0;14,0;;;62,0;;6,0;2,0;1,0;2,0;;12,0;1,0;;;2,0;2,0;;;3,0;;;1,0;19,0;5,0;;2,0;9,0;1,0;;12,0;1,0;1,0;;;2,0;3,0;;4,0;;7,0;2,0;;1,0;9,0;;;12,0;9,0;4,0;2,0;7,0;;;;;;;;;;;;;;4,0;4,0;2,0;2,0;8,0;;1,0;42,0;2,0;4,0;;;;;;;;;;3,0;4,0;3,0;13,0;20,0;;;17,0;8,0;;;;;;;;37,0;8,0;;;;17,0;6,0;1,0;;17,0;;1,0;;3,0;22,0;34,0;;1,0;;3,0;;36,0;3,0;;3,0;;;15,0;;;;;;3,0;;1,0;;;;;;;4,0;2,0;;;;;4,0;1,0;;;1,0;;;;;1,0;;2,0;;2,0;;2,0;;3,0;12,0;;;;2,0;;;;1,0;;9,0;;2,0;16,0;132,0;3,0;;;;;13,0;;;;2,0;;;;4,0;;;;;;;;3,0;;19,0;3,0;;;;;;2,0;9,0;;4,0;39,0;;;;6,0;;;2,0;;;;;;3,0;;;;1,0;3,0;;;2,0;;;3,0;2,0;4,0;2,0;2,0;;;1,0;;;;1,0;6,0;2,0;1,0;3,0;;2,0;;;;;;;;;;;;14,0;;15,0;;;6,0;;;;;25,0;3,0;14,0;;;;3,0;;;1,0;;2,0;;;;;390,0;;;1,0;;;3,0;1,0;3,0;1,0;3,0;2,0;;;18,0;;1,0;;;;2,0;1,0;2,0;;;4,0;1,0;;;;3,0;4,0;;;;9,0;10,0;6,0;1,0;56,0;;;;1,0;;3,0;;;1,0;;2,0;;;;;;10,0;17,0;;;;;;2,0;;;;;;33,0;;;;15,0;;;;;33,0;;;1,0;;;38,0;4,0;;38,0;1,0;;1,0;1,0;;2,0;;3,0;;;5,0;;2,0;6,0;18,0;1,0;;;;;;;;;2,0;;;;43,0;;;;3,0;3,0;;;2,0;;;;1,0;3,0;;;;;;;2,0;4,0;;3,0;;;;;;;13,0;;1,0;;;;;;2,0;;11,0;;1,0;1,0;;;;;2,0;1,0;;4,0;2,0;;;15,0;9,0;;1,0;;;;11,0;;;;;;;;3,0;2,0;1,0;4,0;;5,0;;;;;;1,0;;;1,0;;5,0;;;8,0;;;;5,0;;;3,0;2,0;;;;;;2,0;4,0;3,0;;;;;;;;;;;;;;;2,0;2,0;;;;;;;;;;2,0;;;;;;;;;1,0;;;;;;2,0;;;;;26,0;;;39,0;;;;;1,0;;;;;;;;;2,0;1,0;16,0;1,0;;;;;;6,0;;;;2,0;;;;;1,0;1,0;;;;;1,0;3,0;;;;;;;;;4,0;;;;;;;
identifier;;;1,0;;11,0;;;10,0;2,0;12,0;;;;;15,0;;;;2,0;3,0;;3,0;;;;1,0;;18,0;;1,0;;11,0;18,0;;16,0;;;2,0;;77,0;;1,0;;;;;;;2,0;;;5,0;;6,0;;72,0;25,0;;;;;;22,0;;;;;;;4,0;;2,0;;;;;;;16,0;;;;;3,0;;;;;3,0;55,0;8,0;;;5,0;;;;12,0;33,0;;3,0;2,0;;;;;4,0;42,0;;;2,0;2,0;;6,0;;;;;;;;;;;;;10,0;;;;1,0;2,0;;;;;;;;;;;1,0;;53,0;;4,0;;;;;;1,0;;;5,0;;3,0;;3,0;;;;;;;;1,0;;;;;2,0;;;;;;;;2,0;;;;;;;17,0;;1,0;;;;25,0;;3,0;;;;;;;;;;;;1,0;;;;;;;;12,0;16,0;;;;;;;;;;;;;;;;;;;;;;;;;;;2,0;;;;;;;;;;3,0;;;;1,0;2,0;;;;;;;;;;;;;;;3,0;7,0;;;;;4,0;;;;;;;1,0;27,0;1,0;;;;;;;;;;3,0;;;;3,0;;;;;;;;;1,0;;;;;;;;;;;;;;;;;;;11,0;;8,0;;;;;9,0;;;;23,0;11,0;2,0;;;;1,0;;1,0;;;2,0;;;;;;;;;;;6,0;48,0;1,0;;;;;1,0;;;2,0;9,0;4,0;;;;;2,0;;4,0;;;;;;2,0;17,0;;3,0;;;;;8,0;5,0;;;1,0;;;;;;;;;;;1,0;;;;7,0;;;;;4,0;;;6,0;;;;9,0;;;;;;;;;;;;;;;1,0;;;1,0;;;1,0;;;;;;;;3,0;;;;3,0;2,0;;;;;;;2,0;;;1,0;;;;;;;3,0;4,0;2,0;;3,0;;;;;2,0;;;;;;;;;;;;;1,0;2,0;;1,0;;;2,0;;;;;;;4,0;4,0;;;;6,0;;;;;;;;;;;;2,0;;;;24,0;;;;;;;;;3,0;;;1,0;2,0;;;1,0;;;;1,0;;2,0;;;;;;;;;;;;;2,0;;1,0;3,0;2,0;;;;;;;;2,0;;;;;;5,0;;;6,0;;;;;;;;1,0;;;;;;;;;;;;;15,0;;;;;;;;;;;;;;;;;;;;;;;;;;;;;;;;;;4,0;;;;;;;;;;;;;;;8,0;;8,0;;;;;;;;;;;;;;;;;;;;;;;;;;;;;;;;;;;2,0;;;;;;;;;;;;1,0;;;;2,0;;;;;;;;;;;;;;;;;;;5,0;;;;;;;;;;;;;;;;;;;;;1,0;;;;;;;;;;;3,0;;;;;;;;;;;;;;;;;;;;;;;;;;;;;;;;;;;;;3,0;;;;;;;;;;;;1,0;;;;;;;;;;;1,0;;;;;1,0;;;;;;;2,0;;;;;4,0;;;;;;;;;;;22,0;1,0;;;;3,0;;1,0;;;2,0;;;;;;;;;;;;;;;;;;;;;;;;;;;;;;;;;;;;6,0;;6,0;;;;;;;;;;;;;;;;;;;;;;;;1,0;;;;;;;;;;;;;;;;;;;;;;2,0;;;;;;;;;;;;;;;;;;;;;;;;;;;6,0;;;;;;;;;;;;;;1,0;;;;;;;;;;;;
illuminate;;;4,0;;5,0;;13,0;18,0;8,0;50,0;3,0;2,0;;;17,0;1,0;1,0;;2,0;;11,0;68,0;8,0;1,0;6,0;;;24,0;;9,0;8,0;19,0;249,0;;16,0;1,0;2,0;15,0;;31,0;40,0;;2,0;28,0;1,0;;;1,0;4,0;2,0;9,0;14,0;;;;193,0;17,0;;2,0;45,0;;;57,0;1,0;;;1,0;1,0;3,0;9,0;39,0;3,0;2,0;;;35,0;;9,0;17,0;3,0;;8,0;6,0;;;11,0;60,0;;;15,0;8,0;;3,0;15,0;;4,0;1,0;4,0;11,0;28,0;81,0;64,0;;;;1,0;8,0;92,0;2,0;;3,0;20,0;4,0;2,0;;1,0;;2,0;;;;2,0;;4,0;;2,0;28,0;3,0;1,0;2,0;2,0;7,0;8,0;;;1,0;17,0;;;93,0;4,0;1,0;10,0;7,0;4,0;;35,0;2,0;;4,0;2,0;;3,0;;;3,0;2,0;6,0;160,0;67,0;;6,0;;;;11,0;6,0;551,0;;7,0;14,0;3,0;8,0;1,0;;1,0;;26,0;1,0;;18,0;;4,0;3,0;;4,0;6,0;64,0;;82,0;;;5,0;3,0;1,0;35,0;;;;;3,0;3,0;1,0;27,0;;3,0;;1,0;5,0;;7,0;1,0;;1,0;;16,0;3,0;1,0;1,0;6,0;;9,0;;16,0;;23,0;10,0;;;;;;1,0;1,0;7,0;15,0;;;35,0;;;;;1,0;;;5,0;;;;1,0;;4,0;1,0;7,0;;;10,0;;;1,0;;7,0;;1,0;;;;;;;5,0;;;;;1,0;;;;;;;4,0;;4,0;1,0;131,0;12,0;1,0;6,0;;;22,0;;1,0;;28,0;;;2,0;;20,0;6,0;;;;8,0;1,0;4,0;11,0;1,0;;2,0;1,0;;;;;;;7,0;;;;147,0;;;1,0;;2,0;2,0;;;;;;;;;;3,0;;;;;;2,0;;3,0;2,0;;;2,0;;;1,0;;1,0;;9,0;3,0;;;3,0;1,0;;;;1,0;2,0;;;1,0;2,0;6,0;2,0;;;7,0;;3,0;;;7,0;28,0;2,0;5,0;;4,0;2,0;8,0;;;10,0;9,0;1,0;90,0;10,0;;3,0;;;1,0;;;;1,0;;3,0;1,0;4,0;;2,0;;4,0;;;14,0;7,0;5,0;1,0;;1,0;6,0;;4,0;2,0;;83,0;9,0;;3,0;;;;;1,0;;;1,0;;;1,0;;6,0;;;4,0;;;;48,0;46,0;;;;;18,0;;;;;;;14,0;;1,0;1,0;;;8,0;;;;;7,0;;;;;;;;;4,0;2,0;;;;1,0;;4,0;3,0;7,0;48,0;2,0;8,0;;;;;;2,0;6,0;1,0;;;;1,0;;;;;6,0;;;1,0;;;;2,0;6,0;5,0;;26,0;2,0;2,0;;21,0;1,0;;1,0;1,0;;;;;;;4,0;1,0;;;;19,0;1,0;;;;;;;;;;8,0;;;1,0;38,0;;;;1,0;;4,0;;;;;;;;;;3,0;;;;;1,0;88,0;;;;;;;;;;;;13,0;1,0;;;;;;5,0;15,0;;;;;;;;;;;;;;;;;;1,0;;;;1,0;;;;4,0;;;;;3,0;;;12,0;;;;;;;5,0;8,0;;1,0;1,0;;;;;;;;;;;4,0;;;;;4,0;4,0;;;;;;2,0;;;4,0;;;2,0;;;;;;;11,0;7,0;4,0;;;;;6,0;;3,0;;1,0;;3,0;2,0;2,0;2,0;2,0;;;3,0;;;;;;2,0;;;;6,0;;;8,0;;;;18,0;;;;3,0;;;1,0;;;;;5,0;4,0;;;;;;;35,0;3,0;;;6,0;3,0;;4,0;6,0;;;;;2,0;;;;2,0;;3,0;;17,0;;1,0;;;;4,0;2,0;7,0;;8,0;;26,0;;5,0;3,0;4,0;;;;3,0;;;;;;;;;;;;;;;;1,0;;;;;;;;;13,0;1,0;;;;;;2,0;;1,0;7,0;;;;;;;;;2,0;;;;2,0;1,0;1,0;2,0;;;;;;;;;;;;;3,0;1,0;;;;;;;;1,0;;;1,0;;;10,0;;;2,0;;;1,0;;;3,0;1,0;;3,0;;;;;;;;1,0;;3,0;;;;;;;;;;;;;4,0;;;;1,0;;;;;;1,0;;;;;1,0;10,0;;3,0;;;;;4,0;2,0;1,0;;8,0;;;1,0;;3,0;2,0;;;2,0;;;11,0;;2,0;1,0;;1,0;;;1,0;1,0;;;5,0;2,0;;1,0;;;1,0;;;;3,0;;;4,0;;;;;;;;4,0;;1,0;;;;;;;;;;;;;;;;;;;;;;1,0;;;;1,0;;;;
imager;;;3,0;5,0;14,0;;20,0;16,0;1,0;55,0;8,0;;;;;1,0;;;3,0;2,0;5,0;16,0;22,0;1,0;3,0;;;19,0;9,0;3,0;1,0;21,0;26,0;;40,0;6,0;5,0;7,0;3,0;3,0;11,0;;1,0;5,0;;1,0;;6,0;2,0;2,0;5,0;28,0;7,0;;;205,0;58,0;;2,0;35,0;;;41,0;;;2,0;45,0;;1,0;5,0;53,0;;2,0;;;1,0;;10,0;56,0;3,0;;35,0;16,0;13,0;1,0;;8,0;;;6,0;28,0;2,0;;32,0;5,0;;;1,0;2,0;3,0;35,0;94,0;;1,0;;2,0;4,0;9,0;;;;10,0;46,0;8,0;2,0;1,0;;;;6,0;1,0;;;4,0;;3,0;19,0;;1,0;6,0;2,0;2,0;;;;36,0;4,0;;;;6,0;;;;12,0;;9,0;8,0;3,0;1,0;;;;;;;;5,0;1,0;68,0;1,0;;;;1,0;1,0;3,0;17,0;;1,0;2,0;10,0;10,0;15,0;4,0;1,0;;55,0;2,0;;;;4,0;2,0;;19,0;;45,0;;19,0;;;16,0;16,0;;2,0;;;2,0;;2,0;;;;;3,0;;6,0;;2,0;;1,0;1,0;;14,0;8,0;5,0;3,0;;;;;;13,0;;3,0;3,0;;;;;2,0;2,0;2,0;13,0;1,0;;7,0;17,0;1,0;1,0;;1,0;2,0;;;9,0;;;;;1,0;;5,0;;;2,0;1,0;;1,0;;4,0;6,0;;;;;;;;;3,0;;;;3,0;;;;6,0;;;;7,0;;8,0;5,0;18,0;10,0;1,0;;3,0;2,0;;;2,0;1,0;1,0;;;1,0;;7,0;1,0;;;;7,0;;;2,0;2,0;;;;2,0;;;;;;1,0;;;;4,0;;;;;;;;;;3,0;;4,0;1,0;;;2,0;;3,0;5,0;1,0;1,0;6,0;;1,0;2,0;;;;;6,0;;;;;;3,0;;;4,0;;;;2,0;;;;;;;;4,0;;;;6,0;;;1,0;2,0;;1,0;;;2,0;;3,0;;;5,0;;3,0;21,0;3,0;;2,0;;2,0;1,0;;;;15,0;;;17,0;3,0;;7,0;;7,0;3,0;;14,0;;1,0;;;4,0;4,0;;;;;36,0;1,0;;;;;;1,0;;1,0;;;;;4,0;3,0;6,0;;1,0;6,0;5,0;;17,0;14,0;;;2,0;;;1,0;;;;;1,0;;4,0;;;12,0;;;13,0;4,0;;;3,0;;;;;;2,0;;5,0;;8,0;;1,0;1,0;10,0;;;;5,0;13,0;8,0;;;;;;4,0;;8,0;22,0;;1,0;;;;;;;6,0;4,0;1,0;;;;;;;1,0;5,0;;;5,0;;;1,0;;;6,0;;;1,0;;;1,0;;;;;;;;;;;1,0;;2,0;;;2,0;;2,0;;;9,0;29,0;;;;;;9,0;;;;;;;;;;;;;;;4,0;7,0;2,0;5,0;;;;;;;;;;;3,0;;;2,0;;4,0;;17,0;;;;;;;;;;;;;2,0;;1,0;;;;;;2,0;;;6,0;;1,0;;;16,0;;2,0;;;12,0;;3,0;;;1,0;;;;1,0;;;;;4,0;;;;;;;;;1,0;2,0;;;;;;;;;;;;;;;;;;;;2,0;;;;5,0;;;;;;;;;;3,0;;;;;5,0;;1,0;;;16,0;2,0;;;;11,0;;;2,0;;;;;9,0;;;;;;5,0;;;;;;1,0;4,0;;;1,0;;;;;4,0;;;;;;;;5,0;2,0;3,0;;;1,0;1,0;3,0;;;14,0;3,0;2,0;1,0;;;;3,0;;;;1,0;;;7,0;;;;;1,0;8,0;;;;;;;;;;1,0;;;2,0;;2,0;;;;;;;;;;;;;;;;;7,0;;1,0;;;5,0;;;;;;;1,0;;5,0;;;;;;2,0;;1,0;5,0;7,0;;;;;;2,0;;5,0;;2,0;1,0;;;;;;;;;6,0;1,0;;;;;;;2,0;;4,0;;1,0;;;;;;;4,0;;;;;;1,0;;;;;1,0;;;;;;;;;;1,0;;4,0;;3,0;;;;;;;;;;;;;;;;;3,0;;;;;;;;;;;;;;;1,0;;;;;;;;1,0;;;;;;;;1,0;;;;;;1,0;;1,0;1,0;;;;;;;;;;;;;;;7,0;;;;1,0;;;;;;;;;;;;;1,0;;;;;;;;;;;;;;
imaging;;;39,0;7,0;639,0;4,0;196,0;257,0;78,0;416,0;29,0;47,0;;22,0;113,0;13,0;3,0;8,0;85,0;21,0;161,0;418,0;19,0;63,0;77,0;;4,0;500,0;13,0;180,0;212,0;125,0;3869,0;29,0;514,0;52,0;29,0;300,0;13,0;219,0;114,0;7,0;78,0;547,0;19,0;20,0;1,0;139,0;261,0;33,0;41,0;227,0;14,0;62,0;12,0;2288,0;701,0;5,0;76,0;1371,0;5,0;37,0;543,0;5,0;10,0;15,0;82,0;4,0;6,0;199,0;1110,0;64,0;194,0;18,0;8,0;24,0;1,0;74,0;427,0;28,0;8,0;220,0;74,0;93,0;3,0;8,0;420,0;;12,0;192,0;468,0;18,0;86,0;903,0;40,0;15,0;10,0;40,0;77,0;95,0;569,0;1398,0;;68,0;4,0;2,0;25,0;1264,0;7,0;7,0;19,0;96,0;217,0;79,0;54,0;11,0;29,0;14,0;31,0;180,0;;4,0;31,0;130,0;1,0;9,0;246,0;28,0;9,0;96,0;109,0;10,0;12,0;;43,0;97,0;164,0;;38,0;17,0;4,0;10,0;33,0;58,0;91,0;4,0;240,0;97,0;49,0;8,0;12,0;22,0;36,0;44,0;50,0;30,0;16,0;83,0;59,0;;73,0;11,0;11,0;7,0;12,0;106,0;78,0;591,0;9,0;50,0;98,0;82,0;199,0;137,0;91,0;58,0;16,0;455,0;10,0;;9,0;4,0;48,0;42,0;2,0;219,0;27,0;602,0;3,0;178,0;1,0;;15,0;229,0;32,0;58,0;15,0;;23,0;9,0;67,0;57,0;18,0;168,0;;22,0;153,0;;33,0;104,0;14,0;7,0;66,0;61,0;40,0;250,0;76,0;38,0;4,0;3,0;12,0;94,0;16,0;61,0;14,0;22,0;48,0;4,0;2,0;2,0;17,0;;16,0;43,0;155,0;74,0;5,0;35,0;281,0;3,0;119,0;;32,0;7,0;3,0;13,0;16,0;86,0;6,0;21,0;48,0;7,0;18,0;83,0;12,0;3,0;9,0;63,0;4,0;7,0;14,0;200,0;23,0;5,0;6,0;2,0;85,0;;2,0;1,0;8,0;53,0;8,0;14,0;11,0;22,0;5,0;1,0;32,0;78,0;1,0;1,0;8,0;58,0;3,0;39,0;83,0;356,0;26,0;27,0;120,0;25,0;28,0;19,0;;42,0;47,0;66,0;21,0;;12,0;2,0;94,0;13,0;15,0;2,0;1,0;113,0;37,0;5,0;73,0;31,0;28,0;8,0;3,0;;6,0;3,0;1,0;3,0;2,0;12,0;5,0;9,0;1,0;67,0;;1,0;21,0;;50,0;25,0;;;;12,0;4,0;20,0;9,0;7,0;2,0;33,0;2,0;11,0;28,0;10,0;25,0;28,0;6,0;95,0;29,0;6,0;20,0;19,0;;2,0;9,0;3,0;;20,0;17,0;1,0;16,0;1,0;34,0;74,0;2,0;10,0;12,0;16,0;10,0;2,0;1,0;14,0;70,0;64,0;28,0;8,0;;60,0;107,0;47,0;4,0;33,0;85,0;15,0;12,0;29,0;1,0;124,0;5,0;76,0;6,0;;67,0;32,0;32,0;99,0;21,0;11,0;19,0;;13,0;2,0;7,0;1,0;1,0;218,0;13,0;5,0;21,0;5,0;1,0;14,0;8,0;9,0;7,0;;85,0;4,0;40,0;3,0;2,0;32,0;148,0;3,0;2,0;60,0;26,0;90,0;12,0;5,0;;;;8,0;149,0;11,0;1,0;3,0;5,0;23,0;4,0;3,0;16,0;110,0;89,0;167,0;36,0;38,0;;25,0;111,0;37,0;10,0;17,0;34,0;15,0;26,0;;7,0;;8,0;26,0;6,0;53,0;62,0;5,0;168,0;;6,0;189,0;1,0;;3,0;3,0;34,0;7,0;;12,0;16,0;6,0;18,0;5,0;8,0;32,0;22,0;21,0;10,0;58,0;;54,0;39,0;17,0;196,0;144,0;19,0;27,0;25,0;2,0;2,0;6,0;1,0;1,0;178,0;14,0;;8,0;6,0;6,0;4,0;42,0;1,0;48,0;24,0;14,0;18,0;1,0;;8,0;10,0;2,0;22,0;26,0;;34,0;46,0;4,0;2,0;16,0;7,0;1,0;15,0;3,0;6,0;7,0;3,0;4,0;8,0;3,0;;22,0;9,0;4,0;5,0;;4,0;;2,0;2,0;6,0;9,0;15,0;6,0;16,0;2,0;31,0;4,0;;55,0;699,0;3,0;6,0;3,0;1,0;2,0;68,0;5,0;1,0;2,0;2,0;7,0;18,0;;3,0;2,0;3,0;2,0;1,0;;;1,0;332,0;3,0;6,0;86,0;2,0;;;1,0;4,0;1,0;;6,0;6,0;30,0;6,0;;2,0;5,0;5,0;;222,0;12,0;7,0;3,0;34,0;3,0;5,0;;;10,0;4,0;;5,0;1,0;15,0;6,0;9,0;2,0;22,0;4,0;93,0;32,0;4,0;2,0;2,0;;67,0;;;17,0;4,0;71,0;11,0;;150,0;;22,0;22,0;1,0;10,0;7,0;;5,0;;6,0;3,0;3,0;5,0;31,0;75,0;2,0;2,0;6,0;5,0;1,0;3,0;28,0;1,0;23,0;;1,0;;10,0;13,0;36,0;;;6,0;7,0;22,0;;22,0;19,0;26,0;;;4,0;;15,0;9,0;9,0;24,0;16,0;;4,0;24,0;1,0;7,0;1,0;44,0;3,0;18,0;5,0;12,0;19,0;36,0;68,0;26,0;20,0;;1,0;16,0;13,0;;16,0;6,0;7,0;58,0;6,0;;7,0;37,0;14,0;6,0;53,0;7,0;2,0;6,0;6,0;5,0;1,0;3,0;7,0;23,0;5,0;14,0;;3,0;18,0;26,0;6,0;8,0;8,0;81,0;;2,0;14,0;3,0;2,0;4,0;1,0;76,0;7,0;10,0;6,0;30,0;97,0;4,0;8,0;1,0;9,0;4,0;;;13,0;16,0;7,0;7,0;9,0;17,0;3,0;4,0;19,0;12,0;1,0;15,0;19,0;29,0;10,0;1,0;5,0;22,0;2,0;69,0;23,0;9,0;5,0;;4,0;;18,0;5,0;;1,0;31,0;9,0;;;5,0;8,0;;;15,0;2,0;9,0;15,0;6,0;2,0;;5,0;;;4,0;4,0;5,0;2,0;10,0;9,0;3,0;;4,0;9,0;;3,0;;;12,0;;6,0;2,0;18,0;5,0;2,0;30,0;1,0;;67,0;3,0;8,0;10,0;8,0;1,0;3,0;;3,0;;7,0;4,0;9,0;6,0;13,0;;7,0;116,0;2,0;;;3,0;3,0;10,0;15,0;14,0;8,0;;6,0;2,0;5,0;8,0;8,0;5,0;10,0;2,0;2,0;7,0;2,0;;1,0;;21,0;31,0;5,0;;3,0;;3,0;;;5,0;7,0;4,0;10,0;1,0;3,0;18,0;8,0;1,0;2,0;;;;4,0;10,0;13,0;4,0;1,0;;11,0;2,0;5,0;;3,0;;;;;;9,0;;6,0;8,0;2,0;15,0;;27,0;14,0;;6,0;1,0;2,0;7,0;2,0;;3,0;11,0;7,0;61,0;3,0;;4,0;7,0;;;1,0;4,0;12,0;;;13,0;;1,0;11,0;10,0;13,0;;;1,0;;;10,0;7,0;4,0;6,0;;6,0;4,0;9,0;36,0;10,0;12,0;1,0;;2,0;;7,0;1,0;5,0;1,0;9,0;;5,0;;;2,0;;;;12,0;;;5,0;3,0;;1,0;;3,0;;;;;2,0;;41,0;;7,0;3,0;;;1,0
implement;;;1,0;;6,0;;;;1,0;10,0;;;;1,0;2,0;;;;3,0;67,0;2,0;30,0;;1,0;1,0;1,0;;12,0;1,0;11,0;3,0;8,0;27,0;2,0;18,0;5,0;;;;6,0;3,0;1,0;;18,0;;;;;2,0;3,0;9,0;6,0;1,0;3,0;;61,0;7,0;1,0;;;;;106,0;;;3,0;;;;4,0;2,0;1,0;;1,0;;;;4,0;2,0;2,0;2,0;33,0;12,0;;;;1,0;;;10,0;10,0;1,0;;2,0;5,0;1,0;;3,0;2,0;;1,0;37,0;;2,0;1,0;;2,0;14,0;;;5,0;;1,0;1,0;;1,0;;;;;;;;4,0;;;8,0;;1,0;;;1,0;;;2,0;10,0;;;;;;1,0;;5,0;1,0;;;3,0;;;;;;;;;;;;14,0;;3,0;;;5,0;;;;;;;;9,0;;;;;4,0;1,0;;;;;;;1,0;;2,0;;3,0;;;;6,0;1,0;;;;4,0;;;;;;;;;;;1,0;;1,0;;;4,0;1,0;;;;;;5,0;1,0;;;;1,0;;;;;;;;;;;;2,0;1,0;;;;;;;1,0;1,0;;;;3,0;;1,0;;;;3,0;;;;2,0;;;;;;;;;;;;;;1,0;;;;1,0;;;;6,0;;2,0;;7,0;1,0;;;;;;;;;;;;1,0;;1,0;;;;;;;;1,0;3,0;;;;;;;;;;;1,0;;;;;;;1,0;3,0;2,0;;;;;1,0;;;;;4,0;;;;2,0;;;;;;11,0;2,0;;;;;;;;;;;;5,0;;1,0;;2,0;1,0;;;;2,0;8,0;4,0;1,0;3,0;;6,0;;;1,0;16,0;;;;;4,0;1,0;;3,0;;;;;;;1,0;;3,0;;;;2,0;;2,0;3,0;;;;;;;2,0;;2,0;;2,0;;1,0;1,0;1,0;4,0;18,0;1,0;;1,0;1,0;2,0;2,0;;;;;;;;;;;1,0;;1,0;1,0;4,0;;1,0;;;6,0;14,0;;;;1,0;;;15,0;;;1,0;;;;6,0;1,0;1,0;5,0;1,0;;9,0;3,0;;;;;;1,0;;4,0;;;;;;1,0;1,0;1,0;4,0;;1,0;;1,0;12,0;;;;;;;;8,0;;;1,0;;;1,0;;;;;8,0;1,0;1,0;;3,0;;;;;1,0;;;1,0;3,0;1,0;;;;4,0;;3,0;1,0;;;;1,0;;;;;;;;;3,0;;;;1,0;;1,0;3,0;;;;;5,0;7,0;1,0;;;;;;;;;;;;;;;;10,0;;;;;2,0;;;;;;;;1,0;;;;;;;;;;;;2,0;;;1,0;;;;2,0;;;;;;;1,0;;;;;;;2,0;1,0;;;;;;;;;1,0;;;;;3,0;;;;;;;;;;;;4,0;;6,0;;;;;3,0;;;;;3,0;;;1,0;;;;1,0;;;1,0;;;2,0;;;;;;;2,0;2,0;1,0;;;1,0;1,0;;;;;;;;1,0;;4,0;;;;;;;;;1,0;;3,0;;;;1,0;;;;;;;;;;;;;2,0;;;;;;1,0;;;;;2,0;;;;;;;;2,0;;2,0;;;;11,0;;3,0;;;1,0;;;;;;3,0;;1,0;;;;;;;;;;;;3,0;;;;;;;;;2,0;1,0;;;1,0;;;;;;;1,0;;;;;;;;;;;1,0;;;;;;;;;;;;;;2,0;1,0;;;;;;;1,0;;1,0;4,0;;;;;;;;1,0;;;;2,0;;;;;;;;;;;5,0;3,0;;;;;;;;;1,0;1,0;;;;1,0;;;;;;;;;;;;;;;;;;5,0;1,0;1,0;;;;;;;;;;;;;;;;;1,0;;;;;;3,0;1,0;;;;;;;1,0;;;;1,0;;;;;;1,0;;;1,0;1,0;;;;;;;2,0;;;;;;;;;;;;;;;;;;;;;;1,0;;1,0;;1,0;;;;;;;;;1,0;;;;1,0;;;;;;;;;;;;;;;;;;
incident;;;36,0;;9,0;;54,0;4,0;6,0;;5,0;2,0;;;23,0;;;;5,0;1,0;;16,0;;4,0;7,0;;8,0;20,0;1,0;18,0;2,0;3,0;35,0;;9,0;;19,0;27,0;2,0;;20,0;;2,0;38,0;;;;2,0;2,0;;5,0;23,0;;10,0;7,0;172,0;19,0;;5,0;161,0;7,0;;15,0;;;4,0;;4,0;;1,0;162,0;3,0;14,0;;2,0;6,0;;;31,0;;4,0;6,0;1,0;4,0;;16,0;35,0;;14,0;2,0;36,0;3,0;3,0;75,0;4,0;2,0;;;3,0;32,0;227,0;58,0;;3,0;;;;51,0;35,0;1,0;;16,0;18,0;2,0;;;1,0;;;3,0;;;1,0;;5,0;20,0;19,0;2,0;;3,0;9,0;1,0;5,0;;1,0;20,0;5,0;;;14,0;21,0;;8,0;16,0;31,0;;37,0;1,0;21,0;5,0;;;36,0;;;;18,0;2,0;21,0;73,0;;;8,0;2,0;4,0;11,0;7,0;713,0;;7,0;35,0;44,0;6,0;11,0;;8,0;2,0;25,0;;7,0;6,0;;32,0;2,0;;6,0;;52,0;;48,0;;;41,0;42,0;;55,0;1,0;;;;5,0;2,0;1,0;43,0;;1,0;1,0;;2,0;3,0;1,0;14,0;;6,0;;4,0;17,0;3,0;2,0;;2,0;5,0;;1,0;;31,0;15,0;;;;;;;9,0;10,0;112,0;;1,0;4,0;;12,0;;15,0;;;;4,0;2,0;3,0;;2,0;;2,0;;1,0;;;43,0;;3,0;16,0;;;;;;;;;;1,0;7,0;;;;;;;23,0;2,0;;;1,0;3,0;;;;33,0;1,0;2,0;1,0;;;;;3,0;20,0;6,0;;;;;23,0;;;;;10,0;4,0;;1,0;31,0;1,0;;;;;;2,0;;;6,0;;1,0;;9,0;;;;;2,0;18,0;;;;7,0;;;;5,0;;;;;;;;;;2,0;5,0;3,0;;;1,0;;3,0;;;1,0;;;6,0;;;;6,0;3,0;;;;;;14,0;;1,0;1,0;;47,0;4,0;1,0;16,0;;1,0;1,0;37,0;;2,0;;10,0;;5,0;1,0;1,0;12,0;;;1,0;;;;;3,0;;2,0;2,0;;1,0;;;;4,0;3,0;;;1,0;;;1,0;6,0;3,0;;;;1,0;;;4,0;;;1,0;;;;;4,0;4,0;;;;;;;;1,0;2,0;23,0;68,0;1,0;;1,0;1,0;25,0;;;;4,0;;;;;;;;;;4,0;;;;;5,0;;;;1,0;1,0;;;;;3,0;;;;3,0;8,0;;;1,0;;2,0;;;;38,0;;;;;;;;;17,0;;;1,0;;;;;;;;;;;;;;;2,0;;;1,0;2,0;;;6,0;;;2,0;;;;;;;;;;;;1,0;;;;;;;;;;;;12,0;;3,0;16,0;47,0;1,0;;;;;5,0;;1,0;;;;;;;;;;;;;;62,0;;;;;;;;;;;2,0;3,0;25,0;;;;;;;4,0;1,0;;;;;;;;;;;;;;;;1,0;;;;2,0;1,0;;;;3,0;;;;;;;;72,0;;;1,0;;;;;;;;;;;1,0;7,0;;;;;;;;3,0;;;;;17,0;1,0;;;;;;6,0;;3,0;3,0;;;;2,0;;3,0;2,0;;8,0;3,0;;;;;;;34,0;1,0;;;;;;1,0;3,0;;;;;;;26,0;;;1,0;;;;2,0;;;1,0;;;;4,0;;;8,0;;2,0;;1,0;;;;1,0;;;;;;2,0;;;6,0;4,0;;2,0;;;;3,0;;;6,0;;;1,0;;;;2,0;;;;1,0;;;;;;2,0;;;;;;;;;2,0;;;;;;;;;;;;;;;1,0;;;2,0;;;1,0;;;;;;;;;2,0;;;;;;;1,0;;;;;14,0;;;;1,0;;;4,0;;;;1,0;;8,0;1,0;;;;;;2,0;;1,0;7,0;;;;;;;;;;;;;;;1,0;;;;;1,0;14,0;6,0;13,0;;;;1,0;;;;2,0;;;;;;;;7,0;;;;;;;;;;;;;;;;;;;7,0;;;;;;;;;;;;;;;;1,0;;;;9,0;;;1,0;;;;;2,0;;;;;;;;;;;;1,0;;;;;;;;;;;;1,0;;;;;;;5,0;;;;;79,0;;;;;;;;;;;;;1,0;;;;;;;;;1,0;;;;;;4,0;;;;;;;;
increase;;;30,0;;16,0;;18,0;12,0;7,0;41,0;19,0;2,0;;3,0;4,0;;;;4,0;2,0;8,0;23,0;2,0;6,0;6,0;1,0;1,0;14,0;3,0;24,0;2,0;10,0;30,0;17,0;28,0;;;28,0;;27,0;106,0;1,0;1,0;14,0;1,0;;;8,0;8,0;6,0;3,0;1,0;2,0;83,0;4,0;135,0;24,0;1,0;14,0;69,0;;19,0;36,0;;1,0;11,0;6,0;;1,0;7,0;40,0;3,0;4,0;;13,0;2,0;;3,0;27,0;5,0;2,0;23,0;13,0;4,0;;;24,0;4,0;4,0;4,0;19,0;;2,0;28,0;17,0;20,0;;2,0;;1,0;10,0;29,0;;2,0;;3,0;;47,0;;3,0;2,0;;3,0;4,0;;5,0;;2,0;2,0;2,0;1,0;;1,0;7,0;;;20,0;3,0;8,0;;4,0;2,0;2,0;2,0;;5,0;;2,0;;15,0;3,0;;13,0;6,0;8,0;1,0;10,0;18,0;14,0;;4,0;;;;3,0;;;1,0;8,0;11,0;;;2,0;;;2,0;44,0;36,0;4,0;1,0;3,0;1,0;15,0;1,0;16,0;7,0;1,0;12,0;;;4,0;;;;;4,0;2,0;3,0;;21,0;;1,0;;3,0;;;2,0;2,0;5,0;;13,0;9,0;4,0;14,0;;;;;3,0;4,0;;;1,0;;1,0;34,0;1,0;;3,0;;2,0;2,0;;;5,0;1,0;4,0;;2,0;;1,0;;;1,0;12,0;11,0;12,0;3,0;25,0;;4,0;;1,0;1,0;1,0;1,0;;3,0;;2,0;1,0;;;2,0;;1,0;;;1,0;5,0;;;;1,0;;;1,0;1,0;;;;1,0;;;;;;;3,0;;2,0;;1,0;1,0;;8,0;4,0;15,0;3,0;;;;;1,0;;1,0;4,0;2,0;;;;;23,0;1,0;1,0;;;20,0;;1,0;1,0;6,0;;;2,0;;;;;;;1,0;1,0;;;4,0;;;3,0;;3,0;2,0;;9,0;;;;;1,0;4,0;;2,0;;;6,0;1,0;3,0;1,0;;17,0;;4,0;1,0;1,0;;85,0;;;3,0;;;1,0;1,0;1,0;;1,0;;;;;;;6,0;1,0;1,0;1,0;1,0;7,0;;1,0;8,0;7,0;4,0;1,0;9,0;8,0;7,0;14,0;1,0;2,0;;6,0;4,0;1,0;1,0;30,0;3,0;8,0;15,0;2,0;;;;1,0;1,0;;;26,0;4,0;;1,0;11,0;2,0;1,0;;;;;3,0;2,0;;2,0;1,0;;3,0;;4,0;1,0;35,0;3,0;1,0;;;;;;;;;3,0;4,0;;;3,0;;4,0;6,0;4,0;;;1,0;;13,0;6,0;;;;3,0;1,0;;;;;1,0;;1,0;;3,0;13,0;;;16,0;1,0;;;;1,0;;;1,0;1,0;;;;;;1,0;;;12,0;;1,0;8,0;2,0;12,0;4,0;1,0;14,0;32,0;;;;;;12,0;;;3,0;;;;;;1,0;;;;;;;;;;;;3,0;2,0;;;;;;;;;18,0;;;;;;;;;;;;;;26,0;1,0;;;2,0;;;;;;12,0;17,0;;;;;;5,0;;;;;;;;;;2,0;;;;;1,0;10,0;1,0;;;;;9,0;5,0;;;;1,0;1,0;3,0;;;1,0;1,0;;;32,0;;;;;;;;;;;;;;;;;1,0;1,0;;11,0;4,0;;;;;4,0;;;4,0;;3,0;;;1,0;;;;;;;;3,0;;;;1,0;12,0;;1,0;1,0;;;;;;2,0;;;;2,0;8,0;;1,0;;;;;;3,0;;10,0;2,0;;;30,0;5,0;;3,0;;1,0;29,0;;;;1,0;3,0;1,0;;6,0;1,0;;5,0;;1,0;1,0;;;17,0;;;;1,0;;;;5,0;;;;1,0;3,0;;1,0;;;;;;;;;;;1,0;6,0;;;;6,0;;;;5,0;4,0;2,0;3,0;;13,0;2,0;;4,0;;5,0;;13,0;;;;;;3,0;;;;2,0;19,0;;2,0;;1,0;2,0;;;;;;1,0;;1,0;;;;;13,0;4,0;;;;;1,0;;;;1,0;;;;;;;7,0;;5,0;;;;;1,0;;;;;;;2,0;;;2,0;;;;;;;1,0;3,0;;2,0;;2,0;;15,0;;;2,0;6,0;7,0;;1,0;3,0;;;;;4,0;;;;;;;;;;;1,0;3,0;;;;;;;;;2,0;;1,0;;;;;;;;;;1,0;;;;;;1,0;1,0;;3,0;;;;;;;;;;;;;2,0;;;1,0;4,0;;;6,0;1,0;;;;;;;;;1,0;3,0;1,0;;;;;10,0;;;;;6,0;;20,0;;;;;;;;;;;;;3,0;;;;;;;;;;;;;1,0;;;;;;;1,0;2,0;;;;;;;;;;2,0;;;;;;;;;;7,0;;;;;;;;;4,0;;;;;;3,0;;;;;;;
indicate;;;23,0;1,0;33,0;;7,0;28,0;19,0;43,0;1,0;41,0;;1,0;48,0;7,0;1,0;1,0;35,0;1,0;25,0;82,0;15,0;3,0;23,0;4,0;1,0;187,0;15,0;69,0;96,0;33,0;90,0;85,0;37,0;7,0;7,0;154,0;5,0;149,0;26,0;13,0;1,0;15,0;7,0;6,0;;18,0;47,0;20,0;10,0;50,0;;43,0;;408,0;56,0;1,0;16,0;78,0;;8,0;54,0;;;;40,0;2,0;5,0;62,0;11,0;8,0;2,0;;;20,0;;46,0;165,0;7,0;;43,0;11,0;4,0;5,0;2,0;25,0;4,0;3,0;64,0;17,0;6,0;30,0;232,0;28,0;13,0;4,0;26,0;53,0;;11,0;19,0;;8,0;1,0;6,0;1,0;97,0;1,0;;3,0;6,0;;5,0;7,0;;;;;20,0;;;2,0;4,0;;;11,0;4,0;3,0;;2,0;11,0;1,0;;;3,0;;;2,0;2,0;;;9,0;28,0;;;4,0;48,0;;1,0;3,0;;;;12,0;;;6,0;16,0;74,0;;1,0;;;13,0;3,0;57,0;49,0;5,0;;50,0;1,0;9,0;3,0;30,0;8,0;;44,0;;;5,0;2,0;2,0;2,0;;2,0;1,0;51,0;;17,0;1,0;;1,0;40,0;;;;;10,0;;;4,0;;65,0;;5,0;1,0;2,0;;;2,0;3,0;9,0;;17,0;36,0;16,0;;1,0;;14,0;6,0;2,0;;;;3,0;;1,0;;;;;6,0;2,0;19,0;;2,0;48,0;4,0;;;2,0;3,0;;6,0;2,0;;;1,0;;;;5,0;3,0;;;1,0;8,0;;;2,0;20,0;;;;9,0;;1,0;2,0;;;;;;3,0;11,0;6,0;16,0;3,0;;;2,0;3,0;;50,0;10,0;164,0;13,0;2,0;;;;13,0;;;;68,0;;;;;72,0;2,0;5,0;;;35,0;;;46,0;16,0;;1,0;1,0;;;;;;;2,0;;2,0;;5,0;;;6,0;9,0;42,0;6,0;;3,0;3,0;3,0;1,0;11,0;1,0;3,0;;4,0;2,0;4,0;7,0;;11,0;13,0;;45,0;15,0;12,0;6,0;1,0;;2,0;2,0;1,0;;;3,0;1,0;3,0;;3,0;;17,0;2,0;;5,0;3,0;;3,0;15,0;15,0;23,0;1,0;4,0;;;13,0;2,0;;12,0;;6,0;;4,0;2,0;26,0;4,0;18,0;4,0;1,0;;18,0;12,0;33,0;4,0;2,0;25,0;;8,0;2,0;10,0;;7,0;18,0;;4,0;2,0;5,0;;1,0;;3,0;8,0;;38,0;2,0;31,0;;4,0;4,0;62,0;;6,0;17,0;1,0;12,0;1,0;;;;1,0;;6,0;;13,0;4,0;5,0;6,0;;;;13,0;;12,0;2,0;;;7,0;21,0;2,0;;4,0;4,0;3,0;17,0;;3,0;;1,0;;;7,0;5,0;1,0;115,0;;;22,0;;1,0;;27,0;10,0;3,0;;8,0;7,0;3,0;12,0;;;;30,0;12,0;;20,0;12,0;53,0;7,0;2,0;36,0;49,0;3,0;14,0;;4,0;8,0;76,0;2,0;3,0;18,0;;16,0;;3,0;6,0;;3,0;;5,0;15,0;5,0;;9,0;;;;;8,0;2,0;;8,0;3,0;;;2,0;2,0;1,0;;;6,0;4,0;;8,0;;1,0;;4,0;;;;7,0;4,0;5,0;1,0;;2,0;4,0;;;3,0;;10,0;2,0;1,0;15,0;102,0;;;5,0;;5,0;6,0;8,0;;4,0;6,0;1,0;33,0;2,0;;1,0;;;;;;4,0;23,0;;;10,0;;1,0;4,0;7,0;;;;2,0;;1,0;;;;;;2,0;27,0;;;1,0;3,0;2,0;;;;1,0;;;7,0;1,0;;;;2,0;6,0;;22,0;1,0;1,0;;;;3,0;;;;3,0;18,0;12,0;;10,0;;;;;1,0;;;;1,0;;;;;5,0;1,0;;;;1,0;;;2,0;;13,0;1,0;;;;;3,0;;;;;;3,0;4,0;10,0;1,0;;;;9,0;;8,0;;34,0;3,0;;;;12,0;;3,0;;8,0;4,0;21,0;;;3,0;;1,0;2,0;;;6,0;10,0;1,0;;14,0;1,0;16,0;1,0;8,0;;2,0;2,0;;;;1,0;;1,0;6,0;;3,0;;2,0;;;;;1,0;6,0;6,0;1,0;;2,0;4,0;1,0;;4,0;1,0;2,0;;8,0;2,0;1,0;9,0;3,0;1,0;20,0;;2,0;;;;6,0;4,0;4,0;;;2,0;;;;15,0;;;1,0;6,0;;18,0;;;;;3,0;14,0;;5,0;;10,0;3,0;6,0;30,0;;;7,0;;1,0;;5,0;2,0;3,0;8,0;9,0;;3,0;;1,0;;;3,0;;1,0;;;;2,0;8,0;;;10,0;;17,0;;;14,0;1,0;1,0;;2,0;;;1,0;;6,0;;;1,0;35,0;4,0;6,0;1,0;;;;6,0;;4,0;;;8,0;1,0;1,0;;19,0;;1,0;;;2,0;;;6,0;;;2,0;;1,0;1,0;;2,0;;;;;;;;;;;7,0;;;;2,0;;;1,0;;;;3,0;;;;1,0;3,0;;;;;2,0;;;;1,0;6,0;;5,0;;;;;;;1,0;4,0;;10,0;;;1,0;;23,0;;;;;2,0;4,0;;4,0;;;1,0;;;;48,0;;;;;1,0;;;;;;;;3,0;;;1,0;1,0;;;;;;;;;;;;;;;;;4,0;;;;;7,0;;4,0;1,0;7,0;;;;;29,0;;;2,0;;;;;;13,0;;1,0;2,0;;;1,0;;;;2,0;;
indicative;;;12,0;5,0;;;8,0;13,0;1,0;14,0;1,0;27,0;;;36,0;;;;1,0;1,0;7,0;8,0;2,0;;;;;80,0;9,0;13,0;3,0;15,0;17,0;11,0;6,0;1,0;;20,0;6,0;9,0;3,0;;;4,0;4,0;2,0;;3,0;1,0;;;19,0;;16,0;;110,0;12,0;;2,0;9,0;1,0;;7,0;;;1,0;5,0;;;1,0;2,0;;2,0;;;;;3,0;43,0;2,0;;8,0;4,0;15,0;1,0;;5,0;9,0;5,0;3,0;9,0;;4,0;65,0;3,0;1,0;1,0;2,0;11,0;;1,0;11,0;;;;1,0;;3,0;;;;;;;1,0;;;6,0;;;;;;7,0;;3,0;5,0;;;;;1,0;;;;2,0;;;1,0;;1,0;6,0;;8,0;1,0;;2,0;1,0;;;;;;;;;;;1,0;10,0;3,0;;;;;;2,0;29,0;;;;;3,0;;5,0;;;26,0;;;;11,0;;;;1,0;;13,0;;4,0;;;;30,0;;3,0;1,0;;2,0;;;3,0;;;;1,0;4,0;;;;3,0;;;;;4,0;4,0;;;;;10,0;7,0;;;;4,0;;;;;;;4,0;6,0;;;;4,0;;;;;;;;4,0;;;;;;;;;;;1,0;2,0;;;;;;;;;;;;;;;;;5,0;;;2,0;1,0;;;;2,0;;6,0;;30,0;1,0;;;;;1,0;;;;8,0;1,0;;;;;;;;;2,0;;;;8,0;;;;;;;;;;7,0;;;4,0;3,0;;;1,0;2,0;4,0;;;8,0;;1,0;;;1,0;7,0;;8,0;;;4,0;;;;;14,0;;3,0;1,0;;;;2,0;;;;;;;;1,0;2,0;4,0;;;1,0;2,0;;3,0;7,0;2,0;2,0;1,0;;;;;;;1,0;;;4,0;;;9,0;;1,0;;;;4,0;2,0;7,0;2,0;;7,0;;;1,0;2,0;1,0;;6,0;;;;3,0;;;;1,0;20,0;5,0;8,0;;12,0;;1,0;5,0;4,0;;3,0;2,0;;;;2,0;;1,0;;;;;3,0;;;;;;;5,0;;;;;;;11,0;8,0;;1,0;;;5,0;;;;;;;6,0;;;4,0;;;4,0;;;;;7,0;2,0;;1,0;;;3,0;;;;1,0;;;1,0;5,0;3,0;;;11,0;12,0;;2,0;;;;;;3,0;;;;;;;;;;12,0;1,0;;;;;;;;3,0;1,0;;;3,0;;1,0;;;;;;3,0;;;;;;;;;;;;;1,0;;;;5,0;;2,0;;;;;;;14,0;;;2,0;;8,0;11,0;;;;;1,0;;;;;;;;;;;7,0;2,0;;;;;;;;;;;;;;;;;;1,0;8,0;;;;;;;;;;;;;1,0;2,0;;;;;;;;;;;;;;;;;;;;;;;;;;;;;;1,0;3,0;;;;;;;;;;;;;3,0;;;;;;;;;;;;;;1,0;;;1,0;;;;;4,0;;;;;1,0;;;;;;;1,0;;;;;1,0;;;;;1,0;;;28,0;1,0;2,0;;;;;;;;;;;;1,0;;;;;;;;;;;;;;;;;;;6,0;;;;;;1,0;16,0;;;;;;;;;;2,0;;;;;;;4,0;;;;6,0;;;;;3,0;3,0;;2,0;;2,0;;;;;;;;;;;;;;;4,0;;;;;;;;;;4,0;;;;1,0;5,0;;;;;;;;;;;;;;;;;;;;;2,0;;;4,0;;;;;;;;;2,0;2,0;;;;;2,0;;;;4,0;;1,0;;;;;;;;;;;;;;;1,0;;;;;;;;;;;;;;;;;;;;;;;;;2,0;1,0;;;;;;;;;;;;;;;;;;;;;;6,0;;;;;;;4,0;;;4,0;2,0;;;;;;;;;;;;;;;;;;;;;;;;;;;;;;;;;;;;;;;;;;;;;;;;;;;;;;;;;;;;1,0;;;;;7,0;;;;;;;
indicator;;;3,0;;1,0;;4,0;9,0;;12,0;1,0;3,0;;;1,0;;;1,0;;3,0;3,0;8,0;1,0;;;;;11,0;;4,0;2,0;7,0;17,0;1,0;12,0;2,0;;22,0;2,0;81,0;3,0;;2,0;;;4,0;;3,0;18,0;;6,0;;;5,0;;62,0;43,0;;4,0;12,0;;;16,0;;;;1,0;;;10,0;15,0;;;;;;;27,0;26,0;1,0;;;3,0;7,0;;;1,0;;6,0;;6,0;;3,0;7,0;2,0;1,0;2,0;1,0;4,0;;24,0;26,0;;;;;;25,0;;;2,0;4,0;;3,0;;;;;1,0;7,0;;;;;;;17,0;;;3,0;1,0;;;;;3,0;;3,0;;10,0;;;;3,0;;;6,0;12,0;1,0;;;;2,0;;;;;2,0;14,0;3,0;1,0;7,0;;;;;2,0;24,0;;;2,0;8,0;;1,0;;1,0;;5,0;;8,0;2,0;;;1,0;;1,0;1,0;29,0;;8,0;;;;3,0;;2,0;;;;;;3,0;1,0;2,0;;1,0;;;1,0;;6,0;;1,0;;1,0;5,0;1,0;7,0;;;;2,0;4,0;;;;1,0;;;;;;;1,0;;7,0;;;4,0;;;;;;;2,0;;;;;;;;;;;;2,0;;;;7,0;4,0;;;;;;;;;6,0;;;;6,0;;;;3,0;;;13,0;4,0;;6,0;2,0;22,0;1,0;;;;1,0;;;1,0;;;;;;;4,0;2,0;;;;4,0;5,0;;;;;;;;;;;;;;;5,0;;6,0;;;;;15,0;4,0;;;;;;;2,0;2,0;;16,0;2,0;5,0;;;;;;15,0;;;3,0;;;4,0;;;;;3,0;;2,0;;;35,0;15,0;2,0;;;;;;;;;1,0;;;;;;;2,0;;1,0;;;;;2,0;5,0;4,0;5,0;5,0;1,0;;17,0;1,0;;6,0;;;;;;1,0;;;16,0;1,0;;1,0;;;2,0;;;6,0;;6,0;4,0;;;4,0;;1,0;;;3,0;;;;1,0;;;;;;;;;;;;4,0;;;;;;;1,0;2,0;;3,0;;;1,0;;;;7,0;;;1,0;2,0;;20,0;;;1,0;;;;2,0;;;;;;22,0;;;;2,0;9,0;;7,0;1,0;4,0;3,0;;;13,0;6,0;;;;;;;;2,0;;;;;;;;;;;2,0;1,0;;2,0;;;;;2,0;;;3,0;;;;;;;;;;;;;;1,0;;;;;;2,0;;;;1,0;;;;;;;;;;;;1,0;;;;;;;;6,0;;;1,0;;;;;;;;;;1,0;;;;;2,0;;;;;;;;;;;;1,0;;3,0;3,0;;;;;;;;;;2,0;;;;4,0;;;;;;;1,0;;;;;;;;3,0;;;12,0;;1,0;;;;29,0;;;;;;;;;;4,0;;;;;;;;;;2,0;;;;;;;;;;;;2,0;1,0;;;;;;;;;;8,0;11,0;;;;2,0;;;;;;;;;;;;2,0;;;1,0;;;;;1,0;;;1,0;;;;;;;;;;2,0;;;;;2,0;;;;;;;;;;;;1,0;;;;;;4,0;;;;;;;;;;;;;;;;;1,0;1,0;;;;1,0;;;;2,0;6,0;;;;;1,0;1,0;5,0;;;6,0;;1,0;;;;;;;;;;;3,0;;;;;;1,0;;;;;3,0;;;;1,0;;;;34,0;;;;;;;;;2,0;;;24,0;;;2,0;;1,0;;;;;;;;2,0;;;9,0;;;;3,0;;2,0;;;;;;;;;;1,0;;;;;;;5,0;;;;;;;;;;;;;;;;;;;;;;;;8,0;;;;;;;;;;;;;;;;;;;;;;20,0;;1,0;;;;;;;;9,0;;;;;;;;;;6,0;;6,0;;;;3,0;;;;;;;;;;;1,0;;;;;;;;;;;2,0;3,0;;13,0;;;;;;;;;;;;;;;;;;;;;;;;;;;;;;;;;;1,0;;;;
individual;;;1,0;1,0;1,0;;6,0;24,0;8,0;27,0;;;;;25,0;;;;1,0;1,0;5,0;14,0;;22,0;39,0;;;81,0;;6,0;1,0;12,0;44,0;2,0;23,0;2,0;;;2,0;25,0;7,0;;;4,0;12,0;4,0;1,0;;1,0;3,0;1,0;10,0;8,0;20,0;;180,0;80,0;;;45,0;1,0;9,0;21,0;6,0;;;2,0;4,0;6,0;;64,0;;;;;;6,0;8,0;5,0;;;13,0;11,0;;;;7,0;3,0;14,0;14,0;29,0;;4,0;18,0;3,0;1,0;;2,0;42,0;4,0;6,0;18,0;;;;1,0;;38,0;3,0;;3,0;2,0;25,0;9,0;1,0;2,0;;;;1,0;;;;10,0;;4,0;6,0;3,0;2,0;;;1,0;;;;1,0;;;42,0;16,0;3,0;2,0;6,0;1,0;17,0;;11,0;9,0;;1,0;;1,0;;;;1,0;;;2,0;22,0;;;;2,0;;13,0;3,0;23,0;;;2,0;;28,0;10,0;2,0;;;34,0;3,0;;;2,0;2,0;;;4,0;;64,0;;20,0;;;;9,0;;6,0;;;6,0;;10,0;;;2,0;;3,0;;;6,0;2,0;;;;;;16,0;6,0;;;;;6,0;;;;;35,0;;;;;;3,0;5,0;8,0;6,0;;1,0;25,0;;;;6,0;;;1,0;;2,0;;;1,0;;3,0;8,0;;;;;1,0;;6,0;;;;;;;;;;;;;1,0;;;;;;9,0;;;;;;10,0;;52,0;1,0;;;1,0;9,0;;;;;;;;1,0;;6,0;;;;;10,0;;;1,0;14,0;;;;;;;2,0;;;4,0;;;;5,0;;;;;5,0;4,0;;;;;;;;;;33,0;2,0;2,0;18,0;;1,0;2,0;;2,0;;;4,0;1,0;;1,0;5,0;1,0;;;1,0;9,0;;;15,0;4,0;;;4,0;;9,0;;10,0;3,0;;10,0;6,0;;;;1,0;;;12,0;9,0;2,0;1,0;;;3,0;;8,0;;2,0;;3,0;;1,0;;6,0;7,0;;;2,0;3,0;2,0;;;;1,0;8,0;;2,0;5,0;;1,0;8,0;;5,0;;1,0;;;;2,0;;;;26,0;2,0;4,0;;;;;;2,0;;1,0;;;;1,0;;;3,0;3,0;;;;;1,0;7,0;7,0;;2,0;3,0;;;;;;;;;8,0;;;5,0;;2,0;9,0;;;;;;;1,0;;4,0;1,0;4,0;1,0;;;5,0;;;1,0;;;;14,0;162,0;6,0;;;;;2,0;;2,0;1,0;8,0;;;;;;;;;3,0;;;;;2,0;;;;10,0;;;;1,0;;;;;;;6,0;5,0;2,0;;1,0;;;;;;3,0;;;1,0;;;;1,0;;;;;;3,0;;;9,0;47,0;;;;;2,0;4,0;;;;;;;;;;;3,0;;;;3,0;3,0;;;1,0;;;2,0;3,0;2,0;;;;3,0;;;;;;;;4,0;;2,0;;;3,0;;;;;1,0;;;;;1,0;;;;;;4,0;;;;;;;;1,0;;7,0;2,0;;;;;;;;;;;1,0;4,0;;;;10,0;4,0;;;;;;;;;4,0;;;;;1,0;1,0;1,0;;;;;;;1,0;;10,0;;;6,0;1,0;2,0;7,0;;4,0;;;;;;;2,0;;;10,0;;1,0;2,0;;4,0;6,0;;;;8,0;;;5,0;;2,0;;2,0;;5,0;1,0;;;;;;;9,0;;;1,0;;;;;;3,0;;8,0;;;4,0;;;;;3,0;;;;1,0;2,0;3,0;;;;;;;4,0;;;;1,0;9,0;;;;;;;;;1,0;;;;;;;;;;3,0;;;2,0;1,0;;;;;;3,0;;;;;;2,0;;;3,0;;;;;;;;;;;;2,0;1,0;;;;3,0;;;;3,0;;;;;;;;;;;1,0;;;7,0;;;;;22,0;;;;;;2,0;4,0;;3,0;;;;;;;7,0;;;6,0;7,0;;;;;;;;;;1,0;;;;2,0;;2,0;;;1,0;;;;;;;;1,0;;;;4,0;;;;;;;1,0;;1,0;;2,0;;;;;;;;;;;;;2,0;;;;2,0;;;;;1,0;1,0;;11,0;;1,0;;1,0;;;;;;;;;;;;;;;;;;;;3,0;;;1,0;;;;;;;;;;;;;;;;;;;;;1,0;;;;;;;;;;;;3,0;9,0;;;;;;;;;;;;;;;
initiate;;;1,0;;3,0;;3,0;;2,0;52,0;;;;;;;;;;2,0;2,0;29,0;;;;;;18,0;;3,0;4,0;9,0;36,0;;16,0;;1,0;;;9,0;;;;4,0;2,0;;;;1,0;;3,0;1,0;;1,0;;55,0;12,0;;;3,0;;;22,0;;;2,0;2,0;;;17,0;2,0;1,0;;;;;;;9,0;1,0;;5,0;10,0;;;;2,0;;;8,0;5,0;;1,0;6,0;;2,0;;9,0;;;;5,0;;12,0;;4,0;;8,0;;;1,0;1,0;1,0;;;;;;;;;;;6,0;;;7,0;;;3,0;;1,0;;2,0;;;;;;;;;;;;1,0;4,0;3,0;;;;;1,0;;;;;;;9,0;;;;;;1,0;;6,0;;;1,0;;1,0;1,0;5,0;;;1,0;;;2,0;;;;;;;6,0;;17,0;;;;3,0;;;;;3,0;;;;;;;;;;;;;;;;3,0;11,0;1,0;;;;;2,0;;;;;;;;;;;;;;;;;2,0;5,0;1,0;;;;;;9,0;;;;;;;8,0;;;;1,0;;;;;;;;;;;;;;;;;;1,0;;;;;;;;1,0;;;;1,0;;;;;;;;;;;;;;;5,0;;;1,0;;;;;14,0;;2,0;1,0;4,0;;;;;;;;;;;5,0;;;;;28,0;;;;;;;;;;;1,0;;;;1,0;;;;2,0;;7,0;;;2,0;;1,0;;;;;;;;1,0;;;;;;1,0;;;2,0;11,0;1,0;;;;;;;;1,0;2,0;1,0;;;;6,0;;7,0;1,0;;6,0;3,0;2,0;1,0;1,0;;;;;;1,0;;;2,0;9,0;;;;;;1,0;4,0;;;7,0;;;;;1,0;4,0;1,0;;;;;;;;;;;;;6,0;;10,0;;;;3,0;;;;;;;;;6,0;;;;;10,0;8,0;;;;1,0;2,0;;3,0;;;;;;;;;;;;;;;;1,0;1,0;;1,0;;2,0;;2,0;;7,0;;;9,0;5,0;1,0;;;1,0;1,0;3,0;;;;;;;2,0;;;;1,0;4,0;18,0;18,0;;;;;;;;;;;;;;;;;;;2,0;;;;;;;;;;;;;;;;;;;1,0;15,0;;;;;;3,0;;;;;;1,0;;;;;;;;;;;;;;;1,0;;3,0;;;;;;;;;;;;1,0;;;;;;;6,0;;;1,0;;;;;;;;;;;;;;1,0;;;;;;;;;23,0;;;;;;;;;;;;;1,0;;;;1,0;;;;;;;;;;;;;;;;;6,0;;;2,0;;;;;;;;;;;;;1,0;;;;;;25,0;;;;;;2,0;;;;2,0;;;;;1,0;1,0;;;;;;;;1,0;5,0;6,0;;;;;;;1,0;;;;;;1,0;;1,0;1,0;6,0;;;6,0;;1,0;;;;;;;;;1,0;;;;;;;2,0;;;;;1,0;;;;4,0;;;;;;;;;;;;;;;;;;;;;2,0;;9,0;;;;;;;;;;;;;;1,0;;3,0;;;;;;;;;1,0;;;1,0;4,0;;;;2,0;;1,0;;;;;;;;;1,0;;;;;;;;;;;;2,0;;;;;;;;;;;;;1,0;;;;;;;1,0;;;;;;;;;;1,0;;2,0;;;;;;;;;;;;;;;;;;;;;;;;;;;;;;5,0;;;;;;;;;;;;;;;;;;;;;;;;;;;2,0;;;;;;;;;;;;;;;;;1,0;;;;;;;;;;;;;;;;;;;;;;;;;;;;;;;;;;;;;;;;;;;;;;;;;;;;;;;;;
input;;;38,0;3,0;123,0;;10,0;195,0;50,0;104,0;26,0;8,0;;7,0;89,0;4,0;;;38,0;33,0;54,0;286,0;121,0;44,0;50,0;;2,0;404,0;18,0;97,0;39,0;120,0;641,0;16,0;98,0;12,0;8,0;40,0;2,0;164,0;41,0;;19,0;23,0;;6,0;3,0;23,0;17,0;20,0;46,0;133,0;2,0;2,0;;1442,0;156,0;2,0;31,0;91,0;6,0;86,0;167,0;;8,0;6,0;62,0;;6,0;103,0;65,0;22,0;28,0;5,0;3,0;15,0;;95,0;115,0;33,0;;171,0;98,0;21,0;;;87,0;5,0;15,0;106,0;59,0;9,0;5,0;659,0;27,0;58,0;2,0;27,0;97,0;10,0;16,0;188,0;;14,0;8,0;20,0;23,0;372,0;6,0;;25,0;31,0;29,0;11,0;16,0;7,0;1,0;;1,0;21,0;;;20,0;58,0;;2,0;139,0;2,0;;47,0;4,0;1,0;;1,0;14,0;27,0;11,0;1,0;2,0;4,0;5,0;3,0;31,0;24,0;37,0;7,0;28,0;62,0;1,0;1,0;4,0;;5,0;2,0;6,0;1,0;;10,0;13,0;85,0;1,0;3,0;4,0;2,0;1,0;2,0;37,0;111,0;3,0;3,0;11,0;19,0;87,0;5,0;86,0;1,0;6,0;303,0;1,0;5,0;11,0;5,0;6,0;4,0;;10,0;;199,0;2,0;59,0;;;;380,0;1,0;5,0;;;7,0;1,0;1,0;;;130,0;;9,0;4,0;;2,0;6,0;6,0;;2,0;;1,0;99,0;36,0;;;8,0;5,0;2,0;5,0;;;;20,0;;;;1,0;1,0;19,0;8,0;43,0;6,0;1,0;29,0;58,0;5,0;22,0;;4,0;;2,0;1,0;2,0;7,0;;;10,0;2,0;2,0;88,0;;;2,0;35,0;8,0;1,0;25,0;17,0;25,0;;;;4,0;;;;;5,0;;12,0;1,0;66,0;;;1,0;20,0;5,0;;1,0;14,0;;41,0;29,0;54,0;27,0;3,0;1,0;2,0;9,0;19,0;;;1,0;51,0;;;12,0;2,0;72,0;4,0;11,0;;;50,0;;;53,0;15,0;1,0;;;;3,0;;1,0;;;27,0;17,0;2,0;;9,0;;;15,0;2,0;538,0;4,0;1,0;;22,0;2,0;;3,0;11,0;;;29,0;2,0;13,0;2,0;72,0;9,0;3,0;;41,0;5,0;87,0;18,0;6,0;;1,0;2,0;;;;11,0;3,0;4,0;;16,0;38,0;1,0;8,0;7,0;7,0;1,0;;4,0;17,0;18,0;35,0;11,0;3,0;;6,0;18,0;4,0;1,0;21,0;14,0;4,0;;8,0;4,0;27,0;11,0;111,0;3,0;4,0;24,0;7,0;12,0;23,0;13,0;5,0;26,0;;21,0;9,0;19,0;;30,0;19,0;3,0;8,0;3,0;13,0;;13,0;1,0;45,0;19,0;;;8,0;43,0;2,0;1,0;18,0;44,0;2,0;5,0;30,0;8,0;30,0;56,0;10,0;;1,0;41,0;4,0;35,0;2,0;38,0;3,0;18,0;11,0;12,0;5,0;13,0;94,0;26,0;34,0;35,0;7,0;1,0;18,0;29,0;30,0;3,0;6,0;15,0;8,0;85,0;;1,0;4,0;6,0;1,0;15,0;17,0;11,0;23,0;32,0;;;57,0;;18,0;11,0;;35,0;;8,0;7,0;27,0;4,0;12,0;8,0;8,0;8,0;49,0;22,0;44,0;30,0;12,0;63,0;8,0;8,0;159,0;39,0;5,0;79,0;;1,0;;86,0;;1,0;6,0;;;;;2,0;;;;13,0;31,0;18,0;19,0;8,0;1,0;1,0;;1,0;8,0;37,0;2,0;1,0;12,0;;7,0;6,0;4,0;;;1,0;11,0;18,0;1,0;20,0;3,0;;;5,0;7,0;3,0;;;7,0;8,0;5,0;7,0;47,0;2,0;;9,0;4,0;;26,0;3,0;5,0;13,0;179,0;6,0;3,0;2,0;;14,0;25,0;3,0;;1,0;2,0;5,0;1,0;;;4,0;8,0;8,0;;2,0;5,0;6,0;42,0;3,0;4,0;108,0;;1,0;1,0;4,0;5,0;;;22,0;1,0;1,0;1,0;;1,0;2,0;;;20,0;;;;;6,0;3,0;;;4,0;;;1,0;1,0;8,0;;;1,0;13,0;;1,0;1,0;;;;;14,0;1,0;;6,0;8,0;9,0;3,0;;82,0;;;;;;2,0;;;24,0;2,0;;4,0;;21,0;2,0;2,0;;4,0;;;21,0;;4,0;22,0;;3,0;;;1,0;4,0;;;3,0;2,0;;1,0;;5,0;3,0;;2,0;;;32,0;9,0;9,0;13,0;5,0;19,0;22,0;2,0;7,0;3,0;;6,0;2,0;;65,0;2,0;42,0;4,0;14,0;2,0;4,0;;8,0;14,0;4,0;11,0;;;8,0;43,0;1,0;;;11,0;3,0;;45,0;3,0;;;;3,0;;;2,0;;;;;;2,0;56,0;20,0;1,0;5,0;1,0;;13,0;2,0;1,0;7,0;;8,0;4,0;3,0;7,0;17,0;12,0;3,0;7,0;;;1,0;9,0;25,0;6,0;10,0;3,0;1,0;3,0;;2,0;6,0;1,0;4,0;8,0;;29,0;3,0;7,0;8,0;;2,0;3,0;;8,0;27,0;4,0;22,0;2,0;;5,0;;9,0;4,0;;1,0;;;;;;;14,0;6,0;9,0;4,0;;;3,0;8,0;13,0;;1,0;4,0;2,0;9,0;1,0;1,0;6,0;3,0;2,0;1,0;15,0;;;;5,0;8,0;;18,0;5,0;15,0;;3,0;1,0;;;14,0;6,0;2,0;2,0;;;1,0;;4,0;;6,0;2,0;5,0;3,0;1,0;1,0;6,0;;;1,0;;12,0;9,0;5,0;;11,0;;1,0;7,0;2,0;5,0;2,0;9,0;6,0;18,0;2,0;2,0;2,0;24,0;;8,0;;;2,0;10,0;;;;17,0;;6,0;2,0;;;4,0;19,0;1,0;;;1,0;3,0;6,0;;;3,0;38,0;3,0;1,0;9,0;;5,0;2,0;11,0;;;;;2,0;2,0;;3,0;7,0;3,0;2,0;;7,0;8,0;;;;;1,0;28,0;15,0;;;6,0;17,0;5,0;1,0;;;5,0;5,0;;;;7,0;6,0;;;;;1,0;;2,0;;;1,0;;;;;;;5,0;;2,0;4,0;;;;;;2,0;1,0;;;;;6,0;;1,0;2,0;2,0;2,0;;;;;;;;2,0;4,0;3,0;1,0;39,0;;1,0;;;;;2,0;;;4,0;;;;
insert;;;2,0;4,0;8,0;;11,0;33,0;;1,0;2,0;1,0;3,0;;6,0;5,0;;6,0;18,0;;2,0;10,0;1,0;1,0;;;1,0;19,0;;3,0;;30,0;76,0;;24,0;;;22,0;;26,0;;;5,0;30,0;;;1,0;;1,0;;4,0;1,0;;6,0;1,0;72,0;35,0;;3,0;103,0;4,0;;32,0;;;2,0;10,0;1,0;;11,0;53,0;2,0;49,0;9,0;2,0;1,0;;3,0;90,0;4,0;5,0;5,0;2,0;2,0;;;5,0;;;17,0;14,0;1,0;1,0;3,0;3,0;15,0;;38,0;2,0;15,0;27,0;8,0;;;2,0;;1,0;64,0;;;5,0;4,0;6,0;17,0;21,0;1,0;;;14,0;43,0;;3,0;;6,0;1,0;;22,0;3,0;2,0;11,0;11,0;;;5,0;;9,0;16,0;3,0;;2,0;;;8,0;;22,0;5,0;47,0;10,0;;;;36,0;35,0;2,0;6,0;29,0;69,0;39,0;2,0;11,0;;;4,0;8,0;3,0;;;36,0;;6,0;65,0;5,0;51,0;36,0;5,0;29,0;7,0;3,0;;;1,0;7,0;3,0;;;5,0;13,0;16,0;;85,0;;22,0;;11,0;;;;2,0;7,0;9,0;;12,0;3,0;20,0;1,0;;;;1,0;41,0;;;;;;6,0;1,0;1,0;5,0;1,0;16,0;1,0;;3,0;15,0;;7,0;;2,0;2,0;7,0;;3,0;5,0;;2,0;;;24,0;;23,0;25,0;1,0;6,0;4,0;15,0;4,0;1,0;7,0;1,0;;;6,0;23,0;;;15,0;2,0;;1,0;;7,0;;9,0;8,0;7,0;18,0;4,0;6,0;3,0;36,0;6,0;1,0;6,0;;8,0;3,0;;3,0;4,0;14,0;2,0;3,0;6,0;9,0;;5,0;9,0;1,0;6,0;;1,0;1,0;;;2,0;;14,0;8,0;6,0;1,0;11,0;16,0;6,0;4,0;2,0;;;9,0;11,0;1,0;11,0;2,0;5,0;11,0;;;;11,0;43,0;;;38,0;10,0;;;10,0;2,0;2,0;;14,0;;;;;;;;1,0;;;;;;;;;1,0;5,0;;2,0;;;;;;;;7,0;;;;5,0;;2,0;;;;;;5,0;;;3,0;39,0;8,0;2,0;;;7,0;;;;1,0;;1,0;;;1,0;8,0;;;6,0;4,0;4,0;1,0;;;;;1,0;;;;;;5,0;1,0;;;6,0;6,0;8,0;1,0;;;;;1,0;;4,0;;;1,0;1,0;;;4,0;;2,0;1,0;;;;;5,0;;;;7,0;4,0;;25,0;;;;;7,0;;;;;4,0;;7,0;;;;1,0;;3,0;;;4,0;;1,0;7,0;;14,0;;2,0;;;;1,0;;5,0;;;;;;;;;6,0;5,0;;;3,0;;4,0;6,0;1,0;18,0;5,0;;;1,0;;1,0;;;2,0;20,0;15,0;4,0;3,0;;1,0;7,0;4,0;;;;9,0;10,0;1,0;;;;4,0;9,0;3,0;;4,0;3,0;6,0;1,0;;;;;;;;;;;7,0;;;;1,0;1,0;3,0;1,0;;;;3,0;5,0;;;1,0;;;;;1,0;6,0;;;;1,0;;1,0;1,0;;;;;1,0;;3,0;4,0;26,0;;1,0;;;;5,0;;;3,0;6,0;;;1,0;;5,0;;;3,0;;;1,0;2,0;;3,0;;;;;1,0;;2,0;;1,0;;24,0;;;;;2,0;5,0;3,0;;;;;;;;1,0;;4,0;4,0;;2,0;;5,0;5,0;4,0;8,0;;1,0;;;;5,0;3,0;;;;;4,0;;3,0;2,0;1,0;2,0;6,0;20,0;1,0;1,0;1,0;;2,0;7,0;;;;22,0;;1,0;15,0;;;;;;3,0;;1,0;4,0;;;;;;;1,0;;;;;;;1,0;;;;;;1,0;;;2,0;;;;;2,0;;;;;;;;1,0;;;;;13,0;5,0;;;2,0;;;;;;;;;;1,0;;;;;;;1,0;1,0;;;;;2,0;2,0;;;;;;;;;;4,0;;;3,0;;;;;;;;;;;;;;1,0;;4,0;;1,0;;2,0;;;;;;;;;;;;;;;;3,0;;4,0;;3,0;;;1,0;1,0;;;;;2,0;1,0;;;;;1,0;;;;1,0;;;;1,0;;;6,0;;;;;;;;;;;5,0;;1,0;1,0;;1,0;;;;;;;3,0;;1,0;;;;;;;1,0;;;2,0;1,0;;3,0;;;;2,0;;;1,0;1,0;;;2,0;1,0;9,0;;;;1,0;2,0;;5,0;5,0;;;;;;;;;;;3,0;;;;;3,0;;5,0;;2,0;;;;;1,0;;;;;;;3,0;;;;;1,0;1,0;;;;;;;;;;;;;;;;4,0;;;;1,0;;;;9,0;;3,0;5,0;;;;2,0;;;;;;;;;;;;;;;;;3,0;3,0;;1,0;;1,0;;;;;;;;;;1,0;4,0;1,0;;;;;;;;2,0;;;;
insertion;;;2,0;3,0;8,0;;48,0;6,0;;;;;;;1,0;;;1,0;8,0;;;8,0;;;;;;6,0;;17,0;4,0;;9,0;;14,0;;;9,0;;;2,0;;4,0;2,0;;;;;;;;;;;3,0;3,0;15,0;;;92,0;4,0;;8,0;;;3,0;1,0;;;;;;;1,0;;;;16,0;7,0;;1,0;2,0;;1,0;;;1,0;;;;8,0;;;3,0;;4,0;;1,0;;1,0;16,0;8,0;;;;;;31,0;;;2,0;;;7,0;9,0;;2,0;;;24,0;;;;;;;8,0;4,0;;9,0;4,0;;;2,0;;13,0;10,0;;;;;;3,0;;;;14,0;3,0;;;;6,0;19,0;;;2,0;24,0;1,0;;5,0;;;2,0;;5,0;;;1,0;;6,0;13,0;1,0;50,0;38,0;;25,0;1,0;;;;;;7,0;;2,0;;1,0;1,0;;45,0;;3,0;;3,0;;;;6,0;6,0;2,0;;;;9,0;2,0;;;3,0;2,0;10,0;;;;;;;;;1,0;7,0;4,0;;;;13,0;;;;;;1,0;;;;;;;;;1,0;6,0;2,0;1,0;4,0;;18,0;1,0;;;;;;;;4,0;;6,0;;1,0;;;3,0;;;6,0;;6,0;;;;8,0;1,0;;;20,0;;;;2,0;1,0;6,0;1,0;;3,0;;1,0;1,0;1,0;;9,0;;;;;;3,0;;;;;;1,0;;;4,0;2,0;;;2,0;;;;2,0;2,0;;;;;;;;1,0;8,0;;;;;;;;1,0;;;;;;;;;;5,0;4,0;;;;;;;1,0;;5,0;;;;;;;;;1,0;;;1,0;;;1,0;;;;;;;;;5,0;1,0;;;;1,0;;;;;;;;;;5,0;;1,0;;1,0;1,0;;;;;;;;;;1,0;;;;;;;5,0;;4,0;;;;;;;1,0;;;;1,0;;;;;;;;;;;3,0;;;;7,0;;;6,0;;;1,0;;;;3,0;;;1,0;;;;;;;;;;;;1,0;;5,0;;;;;;;;6,0;;1,0;;;;;;;;;4,0;;;;;;4,0;;1,0;5,0;1,0;;;;;;;;;3,0;3,0;;;;2,0;2,0;;;;;3,0;16,0;;;;;11,0;;;;;1,0;1,0;;;;;6,0;;;;1,0;;;;;;;;1,0;;8,0;1,0;;;;7,0;;;;;1,0;;;;;;1,0;;;;1,0;;;;;;;;;;4,0;;;;;;1,0;;;1,0;;;;;;;;;;;;;;;;;;;;;;2,0;;;;6,0;;;;;8,0;;;;;;;;;;;;;;;1,0;;;;;;;;;;;;;;;;;;;;1,0;;5,0;2,0;;;;;;;;;;;4,0;;1,0;5,0;;;;;;;;;;;;;;;;;;;;;;;;;;;;;;;;;;;;;;;;;;;;;;;;;;;1,0;;;;;;1,0;;;;;;;;;;;;;;;;;;;;;;1,0;;;;;;;;;;;;;;;;;;;;;;;;;;;;10,0;;1,0;;;;;;;;;;;;;;;;;;;;;;;;;;;;;;;;;;;;;;;;;;;;;20,0;;;;;;;;;;;;;;;;1,0;;;;;;;;;;;1,0;;;;;;;;;;;;;;;;;;;;;;1,0;;;3,0;;;;;;;3,0;;;;;;;3,0;;;;;;;;;;;;;;;;;;;;;;;;;;;;;;;;;;;;;;;;;;;;;;;;;;;6,0;;;;;;;;;;;;;;2,0;;1,0;;;;;;;;;;;;;;;;;;;;;;;;;;;;;;;;;;;;;;;;;;;;
instruct;;;4,0;;4,0;;;15,0;3,0;12,0;1,0;;;;;;;;;8,0;11,0;36,0;;;2,0;;;16,0;;4,0;5,0;1,0;39,0;;3,0;;7,0;22,0;;44,0;1,0;;4,0;;;;;;;;7,0;4,0;;;;84,0;3,0;;;2,0;;8,0;2,0;;;;11,0;;;56,0;7,0;2,0;;;;;;3,0;21,0;;;8,0;9,0;;4,0;;;;;6,0;6,0;2,0;21,0;13,0;1,0;;;5,0;6,0;;;5,0;;;;;;72,0;;;;;1,0;;;;;;;2,0;;;;1,0;;;8,0;;;;;;;;;;;;;;;;11,0;4,0;;;;2,0;;;;;;;2,0;;;;1,0;15,0;;3,0;;;;;;3,0;4,0;;5,0;5,0;1,0;;;1,0;;;;;;;;;;;;11,0;;;;;;1,0;;;;;3,0;;;;;;;;;;;;;;;;;3,0;10,0;;;;;;;;;;;;;;;;;;;6,0;;1,0;4,0;;;;;;;2,0;;;;1,0;;;;1,0;;2,0;;;3,0;;;;;;;;3,0;;;;;;;;;;;;;;;;;3,0;;;4,0;;8,0;;;;;;;;;13,0;;;1,0;;4,0;;;;;4,0;;;;;;;;;;;;;;;;;;;;;1,0;;16,0;;;;;;;;;;;;;5,0;2,0;;;;;8,0;;16,0;;;;;;1,0;;;;;;;2,0;3,0;;;;;;;;;17,0;4,0;;;;;;14,0;1,0;10,0;;;;;1,0;30,0;5,0;;;;5,0;2,0;8,0;4,0;;;;6,0;1,0;;;;;29,0;;;;;;;;;2,0;;8,0;;3,0;;;8,0;16,0;;;;;;1,0;;;;2,0;;;;;;2,0;;;;;6,0;;;1,0;;;1,0;;4,0;;5,0;;;53,0;;;;;;;;2,0;;;;;17,0;;;;;12,0;;;1,0;2,0;;;;;;5,0;3,0;4,0;2,0;;29,0;;;3,0;4,0;1,0;;;;;;;;;;;;;;;;;7,0;3,0;;;1,0;;;;;;;;5,0;;;;;;;;;2,0;;;1,0;;;;;;;;;;1,0;2,0;;;;;;;;1,0;1,0;;;;;1,0;;;;;4,0;;;;;2,0;3,0;;;;;;;;;1,0;;;9,0;;1,0;;1,0;;;;;;1,0;;;;;;;2,0;;;;;;;;;1,0;;;;;2,0;;;;;;;8,0;;;;;;;;;;;;;;;;;;;;;;;;1,0;;;;;;;;;;;;;;;;;;;;;;2,0;;;1,0;;;;;;;;;;;;;;;1,0;;;;;;;2,0;;;;;;;;;;;;;;5,0;5,0;;;;3,0;;;;1,0;;;;;;;;;;;;;;;;;;;;;;1,0;;;;;;;;;1,0;;;1,0;;;;;;;2,0;;;;;;;;;;;;;;;;;;;;;;;;;;;;2,0;2,0;;;;;;;;;2,0;;;;2,0;3,0;2,0;;;3,0;;;7,0;;;;;1,0;;;;;;;;;;;;;;;;;;;4,0;;;;;;;;;;;;;;;;;;;;;;;;;;;;;;1,0;;2,0;2,0;;;;;;;;;;;;;;;;;;;;;;;;;;;;;;;;;;;;;;;;;;;;;;;;4,0;;;;;;;;;;;1,0;;;;;;;;;;;;;;;;;;;;;;;;;;;;;;;;;;;;;;;;;;;;;;;;;;;;1,0;;;;;;;;;;;;;;;;;;1,0;;;;;
integrate;;;12,0;;32,0;;5,0;17,0;98,0;49,0;1,0;6,0;;4,0;2,0;1,0;6,0;;20,0;3,0;;53,0;1,0;23,0;1,0;;;18,0;1,0;17,0;6,0;5,0;98,0;21,0;45,0;2,0;4,0;3,0;;23,0;3,0;;1,0;19,0;;;;;6,0;;6,0;20,0;2,0;;;143,0;71,0;;6,0;59,0;1,0;;45,0;;3,0;8,0;3,0;3,0;;5,0;27,0;2,0;4,0;1,0;1,0;1,0;;3,0;27,0;38,0;;43,0;16,0;2,0;;1,0;10,0;;;7,0;55,0;4,0;;62,0;1,0;1,0;;3,0;23,0;47,0;16,0;82,0;;5,0;;;2,0;33,0;;;3,0;;47,0;11,0;3,0;;;;3,0;9,0;4,0;;;276,0;4,0;;32,0;;;11,0;1,0;;;;2,0;8,0;5,0;;3,0;2,0;;;6,0;3,0;24,0;;19,0;12,0;2,0;1,0;;;;;;5,0;;26,0;11,0;12,0;;;;;1,0;;23,0;39,0;;;6,0;;24,0;10,0;2,0;;1,0;34,0;3,0;;5,0;3,0;;;;8,0;3,0;19,0;;18,0;;;3,0;40,0;;3,0;;;;3,0;27,0;;;1,0;2,0;6,0;2,0;2,0;2,0;3,0;2,0;;3,0;;6,0;88,0;6,0;2,0;;2,0;;1,0;;13,0;;;4,0;;;;;;3,0;;4,0;14,0;;2,0;24,0;;;;10,0;;;4,0;3,0;52,0;;1,0;3,0;1,0;;7,0;2,0;1,0;;24,0;;;6,0;11,0;10,0;5,0;;;2,0;2,0;;;3,0;;;;;8,0;1,0;1,0;2,0;1,0;3,0;;5,0;7,0;3,0;6,0;;8,0;13,0;;2,0;;3,0;2,0;;;;;;;11,0;;34,0;;2,0;;;6,0;;1,0;19,0;20,0;;;;;;;1,0;;;5,0;;;;52,0;5,0;;12,0;;1,0;;1,0;3,0;;;;6,0;13,0;6,0;;9,0;;33,0;;;;2,0;;22,0;2,0;;54,0;33,0;;;1,0;;;;;;2,0;;;;;;;;;;;;2,0;5,0;;2,0;;4,0;7,0;9,0;3,0;;2,0;;8,0;;1,0;5,0;4,0;7,0;2,0;;1,0;1,0;;;8,0;;;1,0;;8,0;;5,0;;1,0;;2,0;;;1,0;3,0;1,0;;;;7,0;4,0;;2,0;;4,0;4,0;2,0;1,0;;1,0;;;2,0;;;;2,0;1,0;;;4,0;;;;5,0;;19,0;;;;9,0;;1,0;75,0;7,0;;;;;;15,0;;;;;1,0;3,0;;;6,0;;;1,0;;;;;21,0;2,0;;;7,0;;;;;1,0;11,0;;6,0;13,0;;12,0;;;23,0;3,0;2,0;4,0;;;;1,0;1,0;;3,0;2,0;;2,0;;1,0;8,0;;;3,0;3,0;6,0;2,0;;;;;;2,0;;;;2,0;;;;1,0;1,0;;;;;;;2,0;;;4,0;;;;1,0;1,0;;;;2,0;3,0;;1,0;3,0;;1,0;;;10,0;37,0;;5,0;;;;4,0;;;;8,0;6,0;;;;;3,0;;;;;;2,0;;1,0;3,0;;;;4,0;5,0;;;;1,0;33,0;1,0;;;;8,0;;7,0;1,0;1,0;;;3,0;;;;2,0;;;;;;;;;5,0;;;1,0;;;1,0;3,0;;;;;1,0;1,0;;;2,0;;;;;;;;;1,0;;;;;11,0;2,0;;;;;;1,0;;;1,0;1,0;1,0;;;3,0;12,0;;;;;1,0;1,0;;2,0;;2,0;;;;;;2,0;1,0;2,0;18,0;;;;1,0;;;2,0;;;;22,0;4,0;2,0;34,0;26,0;7,0;2,0;;;;;;6,0;2,0;2,0;;;1,0;;3,0;21,0;1,0;;2,0;;;1,0;2,0;;1,0;;;;;;1,0;5,0;3,0;;;;;2,0;1,0;3,0;;;;;;;;;;;;2,0;;;1,0;;2,0;1,0;2,0;;;;;2,0;;;6,0;;;;1,0;;;;3,0;142,0;;;2,0;;;;;;;1,0;;8,0;10,0;;;;4,0;;;;;;;1,0;;;;;;;;;;;;;;;;;;1,0;;1,0;3,0;2,0;2,0;;;;;;;;4,0;;;;;1,0;;;;;;1,0;2,0;;;;;;4,0;;;1,0;;;;1,0;;12,0;;;;;;;;;;2,0;;;;;;1,0;;;;;;;;;3,0;;;;2,0;;1,0;;;5,0;;;;1,0;;1,0;;3,0;;;;;;1,0;;;;;;;;;2,0;1,0;;;;;;;;;6,0;;1,0;;;;3,0;;;4,0;;;;;;;;;1,0;;;;;;;;1,0;1,0;;;;3,0;;;1,0;;;;;;;;;;29,0;1,0;3,0;;;;;2,0;;;;;;;;26,0;;;;;;;;1,0;;;;;;;
interest;;;4,0;3,0;11,0;;10,0;33,0;57,0;23,0;6,0;4,0;;;;;;;;7,0;1,0;7,0;58,0;1,0;;;;18,0;;33,0;4,0;45,0;13,0;8,0;7,0;4,0;1,0;4,0;;16,0;13,0;6,0;;;12,0;;;;9,0;;2,0;20,0;1,0;4,0;2,0;229,0;43,0;1,0;8,0;11,0;;6,0;69,0;;2,0;;34,0;1,0;;4,0;5,0;1,0;10,0;3,0;;;;208,0;145,0;;;12,0;13,0;15,0;;;298,0;;8,0;23,0;4,0;;;16,0;11,0;2,0;;2,0;20,0;;5,0;76,0;;4,0;5,0;1,0;;11,0;;;1,0;2,0;1,0;3,0;;;;;;;;;1,0;1,0;;1,0;6,0;;;;;1,0;;;1,0;4,0;;;;;1,0;6,0;1,0;10,0;6,0;;2,0;21,0;;1,0;;;;;;;;1,0;1,0;16,0;;;;3,0;14,0;;9,0;6,0;;;;3,0;3,0;;16,0;;;2,0;;;;;4,0;;;3,0;;59,0;;22,0;;;6,0;10,0;6,0;6,0;;;2,0;;;3,0;;;;4,0;;4,0;;;;;7,0;;6,0;11,0;1,0;;;;;5,0;;10,0;;7,0;4,0;;1,0;;;;;6,0;1,0;7,0;;4,0;111,0;3,0;;4,0;1,0;;;;;;;;3,0;;;;2,0;1,0;;36,0;8,0;;1,0;;;;2,0;;;;;;;;;;;1,0;;;;5,0;;;3,0;;;23,0;5,0;236,0;2,0;;;;7,0;;;1,0;;;;;;;6,0;6,0;;;;14,0;;;12,0;6,0;;;;;;;;;;6,0;;;;6,0;;;;;23,0;1,0;;3,0;;;2,0;2,0;;;;25,0;;;;;;;;12,0;23,0;4,0;10,0;;;;;;;;;;;1,0;42,0;5,0;;1,0;;;;;;7,0;2,0;2,0;2,0;3,0;;;10,0;1,0;;2,0;;;;1,0;5,0;;;;;;;;;25,0;;;43,0;;;;;;2,0;10,0;;;17,0;2,0;;;;31,0;2,0;;7,0;;18,0;;;;3,0;;1,0;1,0;6,0;21,0;;;;;;;1,0;;;;;1,0;;;;;;3,0;12,0;;;4,0;43,0;;;;2,0;;3,0;;;;1,0;;;5,0;6,0;;12,0;;;5,0;;;;;;;;5,0;;;;;;;;4,0;;3,0;;;;;36,0;67,0;4,0;;6,0;;1,0;;;4,0;;;;;;;;;;6,0;4,0;;;;;;;;;;;;3,0;;;;;;;;;;;;;;1,0;;;;;;;;;1,0;;;;;;;2,0;1,0;;;64,0;;;;1,0;;25,0;;;1,0;;1,0;;;;;;;;2,0;;4,0;35,0;;;;;1,0;;;1,0;;1,0;;;;;;3,0;;;;3,0;;;;;;;;;;;;;;2,0;;;5,0;;;;2,0;;;;;;;;;;;;;3,0;;;;;;;1,0;;3,0;;1,0;;;;;;;;;;;4,0;;4,0;;;;;4,0;;;;;;;;;4,0;;;;;11,0;;;;7,0;4,0;;;1,0;;;;;1,0;;1,0;;;6,0;;;;;;11,0;;1,0;;2,0;;6,0;;2,0;;3,0;4,0;;;;;;;;;;;;;;;;;;5,0;1,0;;23,0;2,0;;1,0;;;3,0;8,0;;1,0;;;;;;;;;;;1,0;;1,0;;;;;6,0;3,0;;;;;;;;1,0;;;;5,0;;5,0;;;;;;24,0;11,0;;;;;;;4,0;;16,0;;9,0;1,0;;;;;;;;;;;1,0;;;;1,0;14,0;7,0;;;;;;;;;;;;;;;1,0;;;1,0;2,0;;;;;;;;1,0;;;;1,0;;;;;;;13,0;2,0;1,0;;1,0;1,0;;;;;;;;1,0;;;;;;;;;;;;1,0;;;;;;;;;;;;;;;;;;1,0;;;;1,0;;;;;;;;;;6,0;;;1,0;;;;4,0;;4,0;;;;4,0;;;;2,0;;;;;;;;;;;;;;7,0;;;;2,0;;2,0;;6,0;;;;;;;;;;;;;;;;;;;;;;;;;2,0;;;;;;;;;;;;;;;;;;1,0;;;;;;;;;
interpolate;;;10,0;;6,0;;;2,0;;2,0;4,0;;;19,0;40,0;;;1,0;60,0;;;;1,0;4,0;7,0;1,0;;69,0;;3,0;1,0;;5,0;4,0;;;2,0;22,0;;;2,0;;;;;1,0;;;;;;10,0;;;;142,0;3,0;23,0;;;1,0;;35,0;;;;;;;;;1,0;;;;;;26,0;15,0;;;18,0;2,0;;;;;;;2,0;1,0;7,0;;32,0;1,0;14,0;;;2,0;;;3,0;;;;;;11,0;;;1,0;;;;;4,0;;1,0;;;;;2,0;2,0;;;12,0;;;;;3,0;;;;;;;3,0;;1,0;;;;6,0;;2,0;;;;2,0;;;;;;;;1,0;;;1,0;;;;;;7,0;;;;;10,0;;;;;4,0;;;;;;;;;;3,0;;2,0;;;;;;;;;;;;;;;;;;;;;;;;;;14,0;;;1,0;;;;;;;;;;;;;;;4,0;2,0;;;3,0;20,0;;;;;;;2,0;1,0;;;;;;;;;;;;;;;;8,0;;;;;;;;;;;;1,0;;;;;3,0;;;;4,0;;;;;;4,0;;;;2,0;;;;;;;;;4,0;;;;;1,0;;;2,0;;;;;;;;;;;;;;;;;;;;;;;;;;;;;;;10,0;;;;;;3,0;;1,0;;;;;;;;;;;1,0;;;;;;;;;;;;;2,0;;;1,0;;;;;;2,0;4,0;;9,0;1,0;2,0;;;;;;;;;;;2,0;;;;;;9,0;;1,0;;;;1,0;;;;;;;;7,0;;;;;;;;;2,0;;1,0;;4,0;;;;;;;;3,0;;;;;;;19,0;10,0;;;;;6,0;;;1,0;;;;;;;;;;;;;6,0;;;7,0;;;;7,0;1,0;;;;1,0;;;;;1,0;;;1,0;;;;2,0;;;3,0;;;;;;;;;;;;;;;;;;;;;;2,0;;;;;;;;2,0;;;6,0;;;;;;;;;;;;;;;;;;;;;;2,0;2,0;;2,0;;;;;;;84,0;;;;;;;;;;;;;;;;;2,0;;;;;1,0;;;;;;;;;;;;;;;;1,0;;;;;;;;;;;;;;;;;;;;;;;;;;;;;;;;;;;;;;;;;;;;;;;;;;;;;3,0;;;;;;;;;;;;;;;4,0;;;;;;;;;;;;;;;;;;1,0;;;;;;;;;;;;;;;;1,0;;;;;;;;;6,0;;;;4,0;;;;;;;;;;;;;;1,0;;;;;;;;;;;;;1,0;;;;9,0;2,0;5,0;10,0;;;;;;;;;8,0;2,0;;;;;;;;3,0;;;;;;;;;;1,0;4,0;;;3,0;;;;;;;;;1,0;;;;;1,0;;;;;;;;;;;;;;;3,0;;8,0;;2,0;4,0;;;;;;;;;;;;;;;;;;;;;;;;;;;;;;;;;;;;;;;2,0;;;;;;;;6,0;;;;;;;;;;;;;;;;;;;;;;;;;;;;5,0;;;;;;;;1,0;;1,0;;;;;;;;;;;;;;;;;2,0;;;;;;;;2,0;;;;1,0;;;;;;;;;;;;;;;;21,0;;;;;;;;;;;;;;;;;;;;;;;;;;;;;;;;;;;;;;;;;;;;;;;4,0;;;;;;;;;
intersect;;;7,0;;3,0;;88,0;5,0;;1,0;3,0;;;;;;;;;2,0;;7,0;3,0;;;;;;4,0;3,0;34,0;21,0;3,0;;;1,0;14,0;37,0;;;5,0;;1,0;2,0;;;;11,0;;;;5,0;;6,0;;27,0;2,0;;1,0;14,0;;;6,0;;1,0;1,0;;;;;55,0;;;;;;;32,0;11,0;1,0;;;5,0;9,0;;5,0;1,0;;;5,0;30,0;;;9,0;;8,0;;;;3,0;21,0;15,0;;;;1,0;;7,0;;;;;19,0;2,0;4,0;;;;5,0;;;;;5,0;;;1,0;;;3,0;2,0;;;;;1,0;;;6,0;2,0;;;;2,0;2,0;;15,0;1,0;;;;6,0;;;3,0;;2,0;5,0;;10,0;;;1,0;;2,0;3,0;;31,0;;;8,0;15,0;;2,0;1,0;;;;;;;;11,0;;;51,0;3,0;9,0;;12,0;;;1,0;1,0;;1,0;;;4,0;;;5,0;;21,0;2,0;2,0;;;;1,0;;;;4,0;1,0;4,0;;2,0;1,0;;;7,0;2,0;2,0;1,0;;;;;;;;;3,0;;14,0;;1,0;39,0;8,0;7,0;;;3,0;;2,0;2,0;3,0;;;6,0;;;;2,0;2,0;;8,0;;;;;2,0;;2,0;;13,0;;;;;;;;;;;;;1,0;;;;;;;;31,0;;1,0;;;;;;2,0;;2,0;;;;;4,0;3,0;;;;;;;4,0;6,0;;;;;;;;;;;3,0;;;4,0;;;1,0;;;;;;;;;;;;;2,0;;;;;;;;;;;1,0;;;;;;;;1,0;;;;1,0;;;;1,0;;;;;;;;;;;4,0;;;;;;;;;;;;;1,0;;1,0;;;29,0;;;;;;;2,0;;21,0;;;;2,0;;;;;;2,0;;;;11,0;;;;2,0;;;1,0;;;;;;;;;;;;;;;;;;5,0;;;;;;;30,0;;10,0;;;;;;;;;;;1,0;4,0;;1,0;;;;;3,0;;;6,0;;;;;;;;;;;9,0;;;;;;;;27,0;;;;;;;;;8,0;;;;;;;;;2,0;;3,0;;;;;;;1,0;;;;;;;2,0;;;;;;;;;;;;;;;;;;;;;;;;;;;;;;;5,0;1,0;;;;;;;;;;;;;6,0;;;;;;;;;;;;;;;;;;;1,0;4,0;;;;4,0;;;;;;;;;;;;;;;;;;1,0;;;;;;1,0;;;1,0;;;;;;18,0;;2,0;;;29,0;;;;;;;;;;;;;;2,0;;;;;;1,0;;;;1,0;;;3,0;7,0;;;;;20,0;;;;1,0;;;1,0;;;;;;;;8,0;;;;;;;;;;;;;1,0;;;;;1,0;;;1,0;;;;;;;;3,0;;;;;;;;;;;;;;;;;;;;;;;;;;;;;;;;2,0;;1,0;;;;;;;;;;;;2,0;;;;;;;;;;;;;;;;1,0;;;;;;;;;;;;;;;;2,0;;3,0;;;;;;;;;;;;;10,0;;19,0;;;;;;;;;;;;;;;;;;;;4,0;3,0;;2,0;;;;;;;;;;;;;;;;;;2,0;;;;;;;;;;1,0;;;;;;;;;;;;;3,0;;;;;;;1,0;;;;2,0;;;;;1,0;;;;;;;;;;;;;;;;;;;;;;1,0;;;;;;;;;;;;;;;;1,0;;;;;;;;;;;;;;;;;;;;;;;;;;;;;2,0;1,0;;;;10,0;;;1,0;;;;;;;3,0;;;4,0;;;;;;;;;;;;;;;;;;;;;;;;;;
interval;;;8,0;;14,0;;37,0;22,0;10,0;45,0;3,0;;6,0;1,0;16,0;;;;5,0;1,0;5,0;34,0;;;2,0;;;14,0;6,0;14,0;12,0;48,0;30,0;4,0;12,0;3,0;;8,0;;18,0;7,0;;24,0;53,0;1,0;2,0;;;20,0;5,0;;14,0;1,0;84,0;;152,0;53,0;3,0;26,0;343,0;2,0;9,0;51,0;22,0;;8,0;2,0;;;24,0;51,0;;;1,0;;;;1,0;71,0;1,0;;10,0;2,0;3,0;;;3,0;;6,0;3,0;27,0;9,0;5,0;44,0;;9,0;;;8,0;;28,0;44,0;;2,0;;3,0;;159,0;;;2,0;22,0;;4,0;;;;;4,0;4,0;;;3,0;8,0;;4,0;7,0;;1,0;3,0;4,0;3,0;;3,0;;1,0;4,0;;;;;1,0;1,0;2,0;1,0;;22,0;52,0;;;;3,0;2,0;;6,0;;;5,0;9,0;20,0;;17,0;3,0;;;;;19,0;;;17,0;;5,0;8,0;7,0;5,0;5,0;15,0;;;;1,0;;5,0;;2,0;5,0;48,0;;13,0;;3,0;;13,0;;2,0;;;7,0;1,0;;2,0;;44,0;;29,0;3,0;4,0;1,0;1,0;2,0;1,0;1,0;1,0;1,0;328,0;17,0;;;1,0;1,0;;7,0;;1,0;;;;;;;;1,0;3,0;1,0;17,0;1,0;24,0;4,0;3,0;8,0;;2,0;2,0;1,0;6,0;1,0;;3,0;;1,0;;;1,0;;;;6,0;;;4,0;6,0;;;2,0;4,0;;;;;;;;;2,0;;;1,0;3,0;10,0;;1,0;6,0;;1,0;9,0;14,0;34,0;14,0;;;;33,0;7,0;1,0;;;5,0;;;;;125,0;2,0;1,0;3,0;;10,0;;1,0;1,0;13,0;;;1,0;;2,0;;;;;1,0;;;;9,0;;1,0;;;2,0;7,0;;;;7,0;;4,0;;11,0;6,0;15,0;;1,0;2,0;;;;;25,0;2,0;3,0;6,0;1,0;;27,0;2,0;;;;1,0;;;;2,0;2,0;;;26,0;;;;;4,0;1,0;6,0;6,0;;;;17,0;2,0;;2,0;30,0;;4,0;;2,0;11,0;5,0;13,0;3,0;;11,0;;14,0;;10,0;;;;;;1,0;15,0;;48,0;;1,0;3,0;;;3,0;;2,0;;;4,0;6,0;2,0;;;4,0;6,0;;1,0;15,0;2,0;6,0;3,0;;;;;;;;1,0;;;;;;;2,0;;1,0;5,0;;1,0;5,0;10,0;1,0;;;;;;1,0;;;1,0;;;7,0;1,0;;4,0;;;9,0;;;;;;2,0;;1,0;;7,0;2,0;;;2,0;4,0;5,0;3,0;13,0;;5,0;11,0;1,0;16,0;5,0;1,0;27,0;;;;;;;2,0;;;;;;;;;5,0;2,0;5,0;1,0;;;2,0;2,0;;5,0;;1,0;5,0;8,0;;;;;;;;;;;;;;;6,0;1,0;2,0;;;;;;3,0;1,0;2,0;;;;2,0;2,0;;;;21,0;;;1,0;;;4,0;;;;;4,0;;;;;;;;;;1,0;2,0;;;41,0;;;;5,0;2,0;;;;;15,0;;;;1,0;;;32,0;;;2,0;;;;;;1,0;;;;;;;;1,0;4,0;;;1,0;;;;;1,0;;;;;4,0;;;;;;;;1,0;;;;2,0;;;;;;;;;;;;;;2,0;;;;1,0;;1,0;;;;;;11,0;;;2,0;;;;2,0;;;;;3,0;;;;1,0;;;;;6,0;;;;;1,0;;63,0;;;;;13,0;;;;4,0;5,0;6,0;;3,0;4,0;3,0;1,0;;;;;;;;;;6,0;;;;;2,0;;;6,0;;;;;;;;;;10,0;1,0;2,0;;12,0;2,0;;;;;;;;;;;;;;;1,0;;34,0;;1,0;;;;;;1,0;;;;1,0;;;;;;;;;2,0;;1,0;;2,0;;;;;;5,0;;;;;;;;;;;;12,0;;5,0;;;;;;;;;;;3,0;;;9,0;;;;2,0;2,0;;21,0;2,0;;;;2,0;;1,0;1,0;;;;1,0;;;;;;1,0;;;;;;1,0;;;;;;1,0;;;;;;;;;;;;;;;;;5,0;3,0;;;1,0;;;;;;;;;2,0;;;;;;;;;1,0;;;;;;;;;1,0;;;;1,0;;;;;;;;7,0;;;1,0;1,0;;;;;4,0;;;;;;;;2,0;;;4,0;;;;;;;;;;;;;;;2,0;;;;;;;;;;;;;;1,0;;;12,0;;;;;;;;;;;;;1,0;1,0;;;;;;;;;;;;
iris;;;15,0;;3,0;;4,0;10,0;8,0;14,0;;;;;3,0;1,0;;;;;3,0;44,0;;2,0;1,0;;;4,0;;2,0;1,0;9,0;17,0;1,0;7,0;;8,0;2,0;;6,0;4,0;2,0;14,0;4,0;;;;;25,0;;30,0;;;12,0;;71,0;13,0;1,0;1,0;52,0;;;20,0;;;13,0;;4,0;;4,0;36,0;2,0;1,0;;;;2,0;;10,0;2,0;;;1,0;;;;6,0;;;;12,0;1,0;9,0;15,0;4,0;;;;2,0;4,0;6,0;27,0;;;;;;7,0;;;11,0;6,0;;1,0;;;;;;1,0;;;1,0;9,0;;;5,0;;;2,0;6,0;;;;;6,0;3,0;;;;;;;11,0;5,0;2,0;6,0;;;;;;;;;6,0;;;1,0;4,0;4,0;2,0;;;;5,0;;18,0;;;6,0;5,0;5,0;1,0;1,0;12,0;;19,0;;;;;3,0;;;3,0;6,0;11,0;;10,0;;;;4,0;;6,0;;;;2,0;;2,0;;4,0;;;;;;1,0;;;;;;2,0;;3,0;;;;;;;;4,0;;;;;;;10,0;;2,0;2,0;;1,0;;2,0;1,0;;;4,0;;;;;;;;;;5,0;;;4,0;3,0;;2,0;;6,0;;;;;;;;;;;;;;;;;8,0;2,0;;;2,0;8,0;;;;;14,0;;;;2,0;2,0;;1,0;;2,0;;;;;8,0;1,0;;;;31,0;;;;1,0;;;1,0;;;;;;;;;;;2,0;;;;;12,0;3,0;;;;;1,0;;;;;3,0;;;;;1,0;;;2,0;4,0;;;2,0;;1,0;;;;;;;;;;2,0;;;;3,0;4,0;;4,0;2,0;;2,0;;;;;;3,0;;2,0;;;1,0;;;;;;;1,0;44,0;4,0;;3,0;7,0;;1,0;;1,0;1,0;;;;13,0;;1,0;2,0;;;;;;1,0;;;1,0;;;2,0;2,0;1,0;;;1,0;1,0;;;;;;;;;;;;;;;;;11,0;1,0;;;14,0;;;1,0;5,0;;;3,0;;;;2,0;;;;;;;;;;;3,0;;;;;;;20,0;;1,0;;;;;3,0;7,0;;;5,0;;;3,0;;2,0;;;;;;;;;;38,0;;;;;;;;;;;;;;;11,0;;;;;;;;;;1,0;;;2,0;;;1,0;;;;;;;1,0;;;;;;;;;;;1,0;;;6,0;;;9,0;;;;;;;;;;;;;1,0;;;;;;;;;;2,0;;;;;;3,0;;;;;;;;;;3,0;;;;9,0;;;;;;;;;;;;;;;;;;;;;;2,0;;;;1,0;;;;;1,0;1,0;;9,0;4,0;;;;;;;;;;;;;3,0;;;;;;;;1,0;;;;;;;;;;;;;;;;;;;;;;;;;;;;;;;;;;;;;;;;;;;;;;;;;;1,0;1,0;;;;;;;;;;;;;;;;1,0;;;;;2,0;;3,0;;;;;;;;3,0;;;;;;;;;;;;;;;;;;1,0;;;;;;;;;;1,0;;;;;1,0;;;;;1,0;;;;;5,0;;;;;;;;;;2,0;;;;;;;;;;;;;;;;;;;;;;;1,0;2,0;;;;;;;;;;;3,0;;;;;;;;;;;;2,0;;;;2,0;;;;;1,0;;;;;;;;;;2,0;;;;;;;;;;;1,0;;;;;;3,0;;;;;;;;;;;;;;;;;;;;;;;12,0;;;;;;;;;1,0;;;;;;;2,0;7,0;;;;;;;;;;;;2,0;;3,0;;;;;;17,0;;;1,0;;;;;;;;2,0;;;3,0;;;;;;;;1,0;;;;;;;;;;;;;;;;;;;;;;;;;;;;;;;;;;;;;;;;;
laser;;;1,0;;40,0;;5,0;16,0;4,0;5,0;;4,0;;;;6,0;;;6,0;5,0;;14,0;6,0;;;;;5,0;1,0;7,0;5,0;24,0;60,0;1,0;11,0;;24,0;5,0;1,0;5,0;31,0;;12,0;10,0;1,0;;;;3,0;3,0;;52,0;;4,0;1,0;70,0;30,0;;1,0;39,0;;;60,0;;;;1,0;;;;33,0;;10,0;;1,0;3,0;;19,0;69,0;5,0;;;6,0;26,0;;1,0;1,0;;5,0;2,0;21,0;2,0;;11,0;3,0;4,0;43,0;;4,0;;47,0;77,0;;;;;;12,0;;;2,0;;1,0;6,0;;;;;;;4,0;1,0;;4,0;;;14,0;;;9,0;1,0;;;;1,0;;10,0;;;58,0;10,0;;1,0;2,0;3,0;;15,0;17,0;;;1,0;;1,0;2,0;;;;10,0;2,0;4,0;6,0;2,0;4,0;1,0;2,0;;1,0;119,0;;1,0;5,0;29,0;16,0;15,0;;4,0;2,0;2,0;1,0;;;;6,0;;;8,0;12,0;18,0;;6,0;;;7,0;10,0;;12,0;;;3,0;1,0;28,0;4,0;;4,0;;;;;5,0;3,0;1,0;6,0;;;;4,0;7,0;3,0;3,0;;;2,0;;15,0;;8,0;;;;;;;2,0;1,0;11,0;14,0;;8,0;4,0;1,0;6,0;;;1,0;;;;1,0;;;;;;1,0;;;;2,0;2,0;1,0;;5,0;;;;;3,0;;;;;;;;;;;;;17,0;;;;2,0;2,0;;1,0;19,0;2,0;1,0;7,0;3,0;;34,0;;;;;;;;;14,0;13,0;7,0;;;14,0;1,0;3,0;15,0;;;;;;5,0;2,0;1,0;;;1,0;;;;93,0;;;;;1,0;;1,0;;2,0;;;;;11,0;1,0;5,0;;4,0;;;;;1,0;;4,0;;;5,0;;;1,0;;;;;;;;1,0;2,0;;;4,0;;;;;51,0;1,0;2,0;;4,0;;31,0;;1,0;;2,0;17,0;11,0;2,0;1,0;;2,0;;3,0;;;5,0;;;47,0;1,0;1,0;22,0;;9,0;;;;1,0;;;;3,0;;;13,0;;;12,0;;8,0;;21,0;;;;2,0;;;;;;;;;;;;;;;;;;;;;;;10,0;1,0;;;;9,0;18,0;;2,0;;;2,0;;;;;4,0;;2,0;;2,0;3,0;;;14,0;;;4,0;2,0;;;;;;;;;;1,0;1,0;;;;;;;;6,0;8,0;;;;;;;;6,0;2,0;;;;1,0;;;;;;;;;;;;;6,0;;;;1,0;;;;;;;1,0;;;;;;1,0;;;;;;;;;1,0;;;1,0;;;;;;1,0;;;;6,0;;;;6,0;;5,0;;;;;;;;;;;;3,0;;;;;;2,0;;;;;;;;;6,0;1,0;1,0;;;6,0;;;1,0;;;;;;;;;;;;;;;1,0;;;11,0;;;;3,0;1,0;;;;4,0;;;;1,0;5,0;12,0;;302,0;;;;;;;4,0;;;;;3,0;;;1,0;;;;;1,0;;2,0;;1,0;;;;1,0;2,0;;;;2,0;;;;;;;2,0;;;;;;;;22,0;;;;;;;;1,0;;;;;;;;6,0;;;;;;;;;2,0;;;;23,0;;;;;;;;;;2,0;;;;;1,0;;;;7,0;;;;;;;;;1,0;;;;;3,0;5,0;;;1,0;7,0;;;;;;1,0;2,0;2,0;;1,0;16,0;2,0;2,0;;;;;;;17,0;1,0;;;;;3,0;;;;;1,0;;;;2,0;;;;;2,0;;;4,0;;;1,0;;;;;;3,0;;;;;4,0;;;;;9,0;1,0;;;;4,0;;;2,0;1,0;;3,0;11,0;6,0;;7,0;;1,0;;10,0;3,0;;;;1,0;4,0;;4,0;;2,0;30,0;;;;;;;;;;;;;8,0;2,0;;;;;1,0;;;;;;;;1,0;;;;;;;;5,0;;;;;;;;;;2,0;;;1,0;;;;;;;;;;;;;;;;;;;3,0;;;;;;3,0;;;;;;4,0;;;1,0;;1,0;;;;;;;;1,0;;;;3,0;;;;;;;;;;1,0;;;2,0;;;;;;;;;;;;;;;;;;1,0;1,0;;;;;;;;;;;;;;7,0;;;;;;;;;;;;;;
lateral;;;1,0;;;;6,0;5,0;;1,0;4,0;;;;2,0;;;;;2,0;1,0;;;2,0;8,0;;;;;;1,0;2,0;4,0;;1,0;;;32,0;;16,0;6,0;;3,0;1,0;;;;;1,0;;;5,0;;6,0;;14,0;12,0;;;18,0;;9,0;6,0;;2,0;2,0;;;;4,0;5,0;;1,0;2,0;;;;2,0;6,0;;1,0;1,0;6,0;;;;4,0;;3,0;;13,0;;;9,0;;2,0;;;;11,0;33,0;13,0;;;;;;11,0;;;2,0;;2,0;;12,0;;1,0;;4,0;9,0;;1,0;;;2,0;;;12,0;;9,0;3,0;;;;;1,0;11,0;;1,0;;;;;2,0;2,0;;17,0;17,0;;1,0;;4,0;;;;;4,0;7,0;;2,0;;;4,0;;;2,0;;2,0;;5,0;9,0;5,0;5,0;3,0;1,0;5,0;1,0;;;;2,0;;;;6,0;12,0;6,0;29,0;;15,0;;;;2,0;;;;;;2,0;;;;71,0;1,0;;;;8,0;9,0;;;;;;2,0;;2,0;;;1,0;20,0;;;22,0;;;2,0;;;;;3,0;7,0;1,0;6,0;;;2,0;;;;1,0;3,0;;2,0;;1,0;;1,0;;;2,0;9,0;;;;4,0;;;;;16,0;;;1,0;21,0;1,0;1,0;;;3,0;1,0;;;;;;;5,0;1,0;3,0;;1,0;;8,0;;4,0;;14,0;;2,0;;;;;;;1,0;;;;;1,0;2,0;;1,0;2,0;1,0;1,0;;2,0;;;;;;;2,0;;;2,0;;1,0;;1,0;;;;;;;2,0;12,0;;;;;;;;;1,0;;;;;;;;;;;;;;;;;;3,0;;;;;;;;;;;;;2,0;;;;1,0;;1,0;;2,0;;;;;1,0;;;1,0;;1,0;;;;3,0;;;;;;;;;;2,0;;1,0;;;;;2,0;;;;;;;;1,0;;;;;;;;;;;;;;;;;;;;;;;;;;;;1,0;5,0;;;;;;;;;;;;;;;;;1,0;;;;;;1,0;;;;;;;;;;;1,0;;;4,0;;;;3,0;;;;2,0;;;;;;;;;;;;;2,0;;;;;;1,0;;2,0;1,0;;;;;;;;;;;;;;;6,0;;;;;3,0;;;;;;;2,0;3,0;;;;;;;;;;2,0;2,0;;;;;;;;;1,0;;2,0;;;;;;;;;;2,0;1,0;;;;;;;;3,0;;;;;;;;;;2,0;1,0;;;4,0;;;;;;;;2,0;;;;;;;;;;;;;;;;;;;;;;;;1,0;;;;;2,0;;22,0;;;;;;;;;;1,0;;;;;;;;1,0;;7,0;1,0;1,0;;;;;;;9,0;;;;1,0;;1,0;6,0;;;;;;2,0;;;;;;;;;2,0;;;;;;2,0;2,0;12,0;;;;;;;;;1,0;;;;;;;;;;2,0;;;;;;;;;;;;;;2,0;;;;;2,0;;;;;;;;;;;;;1,0;;;;;;;;;;2,0;;;;;;;;;;;;;;2,0;;;2,0;;1,0;;;;;;1,0;;;;;;;;;;;;6,0;;;;7,0;;;;;1,0;;;;17,0;;2,0;;;;;;;;;;;;;;;1,0;;;;;;;1,0;;;;;;;;;2,0;1,0;1,0;;;4,0;;;;;;;;;;;;;;;;;1,0;;;;;;2,0;1,0;;3,0;;;;;;;;;;;;;;;;;;;;;;;;;;;;;;;;;;;;;;;;;2,0;;;;;;;;;;;;;;;;;;;;;;;;;;;;;;;;;;17,0;;;;;;;;;;;;;;;;;;;;;;;;;1,0;;;;;;;;;;;;;;;;;;;2,0;;;;;;;;
left;;;2,0;;4,0;;3,0;14,0;3,0;29,0;5,0;;;;33,0;2,0;1,0;;30,0;2,0;3,0;6,0;3,0;2,0;;;4,0;32,0;;3,0;;5,0;5,0;;18,0;7,0;;28,0;4,0;67,0;16,0;;2,0;5,0;;;;2,0;1,0;;1,0;14,0;;;2,0;211,0;14,0;;2,0;33,0;1,0;;9,0;;;1,0;3,0;;;9,0;13,0;3,0;;;;;;13,0;31,0;;;3,0;1,0;1,0;;1,0;24,0;;5,0;9,0;17,0;3,0;;4,0;1,0;13,0;;1,0;8,0;6,0;20,0;24,0;;;;1,0;;23,0;;;;5,0;;3,0;8,0;;;;1,0;13,0;2,0;;2,0;;;;33,0;1,0;;;8,0;;4,0;;;;17,0;;;;;;2,0;10,0;;;10,0;15,0;;;;1,0;2,0;;;;;3,0;1,0;8,0;;;;;1,0;;;16,0;;3,0;31,0;6,0;2,0;11,0;3,0;2,0;4,0;3,0;;;20,0;;;4,0;1,0;9,0;1,0;6,0;2,0;52,0;;;;9,0;11,0;6,0;;;2,0;;;3,0;;123,0;;;;;2,0;3,0;4,0;;;;5,0;;;5,0;;1,0;21,0;21,0;;28,0;;3,0;4,0;;;;;;;2,0;3,0;4,0;;1,0;22,0;;;;2,0;18,0;;1,0;1,0;;;;;;1,0;3,0;3,0;;;3,0;1,0;;;1,0;19,0;;2,0;;3,0;;;;;18,0;1,0;;;;1,0;1,0;;;1,0;;4,0;1,0;2,0;4,0;2,0;2,0;8,0;4,0;;2,0;3,0;6,0;;;;21,0;;;;;3,0;9,0;6,0;;;3,0;14,0;;2,0;2,0;;1,0;;;2,0;;;;;1,0;;1,0;;12,0;;1,0;;;4,0;;1,0;;;;;;7,0;;1,0;4,0;;;;;;;;4,0;;3,0;1,0;;;;;;;;;;;;;4,0;;;;;;;;;3,0;6,0;;;;12,0;;6,0;;1,0;;;;1,0;1,0;2,0;17,0;4,0;;;22,0;;2,0;1,0;;;;;;;;;2,0;3,0;;4,0;4,0;;;3,0;;;;;2,0;1,0;;;;2,0;1,0;;;1,0;;;;4,0;;;;;;3,0;;;41,0;;;;;;;1,0;;3,0;1,0;;3,0;;;;;;3,0;;;;;;;2,0;;;;;3,0;2,0;;1,0;;2,0;11,0;;3,0;;;3,0;;;;13,0;11,0;3,0;;;7,0;7,0;;2,0;11,0;27,0;1,0;;;1,0;;;;;1,0;1,0;;;;1,0;;6,0;;;;;;;;;;;;;2,0;;3,0;;;;;;;;3,0;;;9,0;1,0;;;;;;;;;;;;3,0;;2,0;;;2,0;;;;7,0;26,0;;6,0;;;;1,0;2,0;;;;;;;5,0;;;;;;;5,0;10,0;;;;;;1,0;;;3,0;;;;;;;;3,0;;;;3,0;;;;1,0;;2,0;;;;;;;;;;;;;;6,0;;;;;;1,0;;;;1,0;;;;;;1,0;;;;;;;;;;;;;;;;;2,0;;4,0;4,0;;;;;;;;;1,0;;;;;;5,0;;;;;;;;;;1,0;;;;;;;;;;;;;11,0;1,0;;;;;;;;;;;;;;;2,0;;4,0;;1,0;;;7,0;;;1,0;;;;;;;;;;;;;;;;;;;;;;;1,0;1,0;;;;;22,0;10,0;;;;;8,0;;;8,0;;;;;;;;;1,0;;6,0;;;4,0;;;1,0;;;;6,0;2,0;;7,0;;;;;;;;2,0;4,0;;;;;;2,0;;;;22,0;;;1,0;;;11,0;;;;;;;;1,0;;;;;;;;;;1,0;1,0;;5,0;;3,0;;;;;;2,0;;4,0;2,0;;;;;;;;;;;;;;;;;;;;2,0;;;;2,0;;;3,0;;;;;;;;;;;3,0;;;;;;;;;;;;;;;;;;;;;4,0;;;;;;;4,0;;;;;;;;;;3,0;;;;2,0;;;;;;;;;;;;;;14,0;;;;;6,0;;;;;;;;;;;;1,0;;2,0;;;;;;;;;;;;;;;;;;;;;;;;;;;;;;;;4,0;;;;;;;;;;;;
level;;;15,0;2,0;88,0;;3,0;134,0;118,0;53,0;7,0;12,0;;8,0;112,0;6,0;13,0;;35,0;16,0;14,0;118,0;3,0;46,0;22,0;3,0;9,0;73,0;2,0;181,0;56,0;119,0;82,0;107,0;44,0;1,0;2,0;5,0;;121,0;15,0;;3,0;12,0;;1,0;;3,0;43,0;28,0;79,0;41,0;4,0;6,0;2,0;492,0;45,0;;3,0;19,0;7,0;14,0;128,0;24,0;1,0;2,0;6,0;;2,0;19,0;13,0;1,0;33,0;;;20,0;;19,0;24,0;127,0;;29,0;6,0;18,0;;;43,0;4,0;21,0;32,0;17,0;8,0;3,0;512,0;23,0;4,0;;10,0;20,0;5,0;11,0;61,0;;13,0;2,0;3,0;7,0;127,0;9,0;1,0;7,0;3,0;3,0;5,0;7,0;1,0;;1,0;4,0;2,0;;;7,0;22,0;;;53,0;;3,0;6,0;8,0;3,0;2,0;;1,0;65,0;1,0;;;12,0;29,0;4,0;1,0;24,0;15,0;3,0;5,0;57,0;;1,0;1,0;;2,0;2,0;7,0;;;2,0;103,0;78,0;7,0;44,0;2,0;5,0;;10,0;;171,0;;;7,0;1,0;15,0;6,0;8,0;1,0;3,0;113,0;1,0;;2,0;;2,0;2,0;3,0;4,0;10,0;94,0;;21,0;;;24,0;20,0;;6,0;1,0;;7,0;6,0;8,0;;13,0;7,0;;12,0;8,0;1,0;8,0;27,0;;;37,0;3,0;;81,0;16,0;;;;4,0;3,0;;7,0;;;5,0;;;;;;5,0;;106,0;2,0;;21,0;90,0;;;;8,0;3,0;16,0;5,0;20,0;1,0;;1,0;8,0;2,0;;7,0;2,0;2,0;;5,0;18,0;;8,0;6,0;14,0;1,0;;;3,0;;;;;9,0;5,0;14,0;;1,0;;;25,0;16,0;;;3,0;;;24,0;;12,0;6,0;;4,0;1,0;1,0;11,0;;;6,0;8,0;2,0;;2,0;3,0;158,0;;;;2,0;38,0;13,0;;73,0;8,0;;;6,0;2,0;1,0;;1,0;;;32,0;3,0;;;27,0;2,0;;26,0;3,0;23,0;5,0;;5,0;1,0;2,0;14,0;;37,0;25,0;;13,0;;10,0;26,0;;44,0;9,0;;40,0;4,0;4,0;13,0;10,0;2,0;22,0;5,0;;;;14,0;2,0;;;9,0;57,0;1,0;2,0;23,0;9,0;8,0;;6,0;18,0;13,0;3,0;3,0;47,0;;3,0;14,0;10,0;16,0;12,0;43,0;2,0;11,0;30,0;3,0;3,0;;36,0;;;5,0;3,0;5,0;12,0;155,0;20,0;5,0;;2,0;10,0;3,0;24,0;1,0;74,0;3,0;6,0;4,0;7,0;1,0;5,0;;5,0;10,0;;37,0;1,0;1,0;2,0;;23,0;17,0;3,0;27,0;37,0;20,0;20,0;3,0;2,0;1,0;1,0;6,0;;48,0;12,0;6,0;62,0;;9,0;;1,0;;8,0;;9,0;3,0;1,0;;7,0;10,0;24,0;;;;;5,0;;9,0;;1,0;17,0;2,0;5,0;1,0;;33,0;;11,0;14,0;23,0;;;3,0;;6,0;;1,0;13,0;1,0;;3,0;1,0;;3,0;4,0;6,0;66,0;24,0;10,0;136,0;9,0;43,0;15,0;5,0;245,0;15,0;;13,0;;;2,0;4,0;1,0;2,0;;;;;;;4,0;;;;;;7,0;;;31,0;;;7,0;2,0;;2,0;2,0;2,0;;3,0;23,0;;21,0;;;;;;3,0;;;;4,0;5,0;1,0;;12,0;12,0;;1,0;11,0;;;8,0;;3,0;25,0;157,0;4,0;;23,0;;3,0;8,0;;3,0;3,0;5,0;;;;;;;3,0;;;;6,0;27,0;2,0;;2,0;;;30,0;;2,0;;;;2,0;9,0;;;2,0;1,0;2,0;8,0;104,0;;;;;;;2,0;;;;;2,0;;;;;;5,0;;18,0;2,0;;;;;26,0;;;1,0;;20,0;;;2,0;1,0;3,0;;;;;;;;;;;;14,0;3,0;;3,0;;;;;2,0;;9,0;4,0;;;;7,0;2,0;;;;2,0;;;;2,0;;22,0;48,0;2,0;4,0;22,0;5,0;68,0;333,0;2,0;17,0;4,0;8,0;6,0;3,0;8,0;18,0;18,0;;7,0;1,0;4,0;7,0;3,0;;;7,0;1,0;1,0;10,0;;1,0;;7,0;20,0;;79,0;3,0;1,0;1,0;6,0;5,0;1,0;;5,0;;;20,0;;1,0;4,0;;;2,0;1,0;5,0;10,0;37,0;;1,0;2,0;;1,0;;;29,0;;;30,0;;2,0;12,0;19,0;;69,0;;8,0;;3,0;;2,0;;4,0;;;6,0;;;4,0;23,0;5,0;;6,0;4,0;5,0;10,0;1,0;;;;12,0;99,0;16,0;;;4,0;2,0;;7,0;5,0;;8,0;2,0;;2,0;3,0;;;;;8,0;2,0;;;;;;2,0;3,0;;4,0;;3,0;4,0;;;2,0;;90,0;;;57,0;7,0;10,0;;4,0;;;;;;;;6,0;2,0;;6,0;3,0;;;;1,0;14,0;1,0;4,0;1,0;2,0;2,0;3,0;2,0;;;;;1,0;;1,0;;9,0;14,0;;;;1,0;;82,0;1,0;;;;;;;;;2,0;;4,0;;;;4,0;;;;;;1,0;;;;;;;;;;4,0;4,0;1,0;1,0;2,0;;;;8,0;;;;;;;;;;2,0;;1,0;;;1,0;;;;;5,0;9,0;;;;1,0;2,0;2,0;;1,0;;;;;1,0;;2,0;1,0;;11,0;;;;1,0;12,0;;;2,0;;;;2,0;;1,0;;;;;;;;;;;;;;10,0;;12,0;;21,0;;;;;;;13,0;;2,0;;;;;;5,0;;;;1,0;;3,0;;;1,0;;;;
limit;;;42,0;;22,0;;21,0;42,0;8,0;9,0;3,0;;1,0;;;1,0;;;5,0;2,0;15,0;31,0;;3,0;8,0;;;14,0;142,0;1,0;4,0;23,0;62,0;1,0;22,0;4,0;12,0;19,0;5,0;19,0;73,0;;8,0;25,0;;1,0;;434,0;16,0;1,0;3,0;;;7,0;43,0;153,0;26,0;;465,0;740,0;1,0;15,0;27,0;14,0;;4,0;8,0;;1,0;16,0;88,0;2,0;1,0;6,0;;;;38,0;32,0;31,0;10,0;7,0;1,0;1,0;;;32,0;6,0;1,0;6,0;29,0;;61,0;23,0;96,0;2,0;;14,0;2,0;1,0;12,0;787,0;;;1,0;;1,0;214,0;;;9,0;4,0;;5,0;4,0;;;;1,0;3,0;;1,0;;2,0;;;19,0;6,0;1,0;1,0;3,0;4,0;;;;1,0;3,0;;;;;;;1,0;3,0;;8,0;13,0;;;;2,0;18,0;;4,0;14,0;8,0;8,0;;32,0;23,0;3,0;15,0;2,0;;;25,0;14,0;;1,0;40,0;;11,0;14,0;74,0;2,0;;28,0;;;;9,0;4,0;;2,0;;6,0;6,0;;23,0;1,0;2,0;;2,0;3,0;5,0;3,0;2,0;37,0;;;4,0;1,0;11,0;4,0;;6,0;11,0;9,0;8,0;;;;;7,0;70,0;;1,0;3,0;;53,0;;3,0;1,0;3,0;;;;;4,0;;;3,0;3,0;5,0;209,0;1,0;5,0;29,0;6,0;12,0;1,0;8,0;1,0;1,0;20,0;2,0;1,0;;7,0;;3,0;3,0;;;;;60,0;;;;2,0;6,0;2,0;3,0;1,0;2,0;;3,0;;;;;;3,0;4,0;6,0;;;3,0;;8,0;4,0;5,0;1,0;37,0;41,0;20,0;3,0;5,0;6,0;;;;2,0;;;4,0;;;1,0;;68,0;;4,0;1,0;;77,0;;2,0;3,0;2,0;6,0;;;;;3,0;;1,0;2,0;6,0;9,0;3,0;;8,0;;6,0;;;6,0;4,0;;;;;;;7,0;6,0;3,0;;;5,0;4,0;1,0;1,0;1,0;;14,0;6,0;;9,0;;;3,0;;;;;;2,0;;;2,0;16,0;2,0;2,0;2,0;;;;1,0;;16,0;5,0;1,0;2,0;19,0;3,0;4,0;3,0;;1,0;;8,0;2,0;10,0;1,0;9,0;;;13,0;2,0;3,0;5,0;2,0;;;;;;;6,0;;;;322,0;;;1,0;4,0;;2,0;1,0;;4,0;;1,0;;6,0;;;8,0;1,0;;2,0;1,0;4,0;2,0;;3,0;;1,0;;;;2,0;;3,0;;;;;;15,0;1,0;16,0;;3,0;;1,0;3,0;6,0;;1,0;;;;1,0;;;;13,0;1,0;10,0;3,0;;3,0;;;6,0;;;;;1,0;;;;;;;;;9,0;;2,0;1,0;33,0;;18,0;1,0;11,0;3,0;65,0;1,0;42,0;;;;;;;6,0;3,0;1,0;37,0;;4,0;1,0;;;5,0;3,0;2,0;3,0;1,0;1,0;;;2,0;;;;4,0;;;;;2,0;;;;1,0;;1,0;2,0;1,0;;;;;1,0;;2,0;11,0;;;;1,0;1,0;;;;;;;;;5,0;1,0;1,0;1,0;;;8,0;;;;;2,0;;;;;8,0;;;;;;3,0;;;;;;;3,0;2,0;;;;1,0;5,0;3,0;1,0;2,0;3,0;;;7,0;;;;5,0;1,0;4,0;;;;;;;;2,0;;;1,0;;;4,0;;2,0;;;;2,0;;;;;1,0;;6,0;13,0;;4,0;;;1,0;;;;4,0;;;4,0;;;;;;1,0;2,0;;;;;;;;1,0;;;;1,0;;;;547,0;;8,0;5,0;;1,0;;;;1,0;;;5,0;;;;;8,0;;;1,0;15,0;;2,0;;;1,0;;;3,0;;;;2,0;;;;;1,0;1,0;7,0;;1,0;;;;;3,0;;;;2,0;;;2,0;;;;6,0;;1,0;1,0;;;;;;;;;8,0;;1,0;;1,0;;;17,0;;;;31,0;;1,0;;;2,0;2,0;;;1,0;;;;;1,0;;;1,0;1,0;;5,0;;;;2,0;;;;;;30,0;;;;8,0;;9,0;;;;;2,0;;4,0;1,0;;;;;;;2,0;;;;;;;;;;1,0;4,0;;;1,0;;;2,0;;3,0;;;;;;;;;2,0;;;;;;;1,0;;;;1,0;;;1,0;;2,0;;8,0;;;;;;;;;1,0;;;;19,0;;;;;;;1,0;;;;1,0;;;3,0;;;;;;;4,0;;3,0;;;;;;;;;;;;;;;;;;;;;;;;;;;;;3,0;2,0;;;20,0;;2,0;;;;;;;3,0;2,0;;;;;;;;;;;;;13,0;;;;;;15,0;;2,0;;;;;1,0;;;;;;;;2,0;27,0;;;;;3,0;;;1,0;;;1,0;;;;;;;;;;;;2,0;;;;;;;;;;;;;
liquid;;;14,0;;17,0;;5,0;7,0;;1,0;;;;;17,0;;;;5,0;;;35,0;;;;;;4,0;;1,0;;2,0;69,0;;4,0;3,0;;42,0;;194,0;;;;48,0;;;;2,0;7,0;;2,0;6,0;;7,0;;71,0;47,0;;2,0;185,0;;;17,0;2,0;1,0;;6,0;;;;28,0;;;;7,0;;;2,0;1,0;16,0;1,0;6,0;1,0;1,0;;;12,0;;;5,0;6,0;1,0;;4,0;2,0;1,0;;;;37,0;8,0;10,0;;;;;;18,0;2,0;;;7,0;1,0;5,0;3,0;;;;;3,0;;;7,0;4,0;6,0;;5,0;16,0;;7,0;6,0;;506,0;;4,0;1,0;33,0;;17,0;2,0;;3,0;1,0;17,0;14,0;1,0;25,0;2,0;;1,0;;4,0;2,0;;2,0;;5,0;1,0;1,0;6,0;4,0;;3,0;;;90,0;;27,0;;26,0;;1,0;38,0;8,0;;3,0;7,0;2,0;;;87,0;2,0;5,0;;;;19,0;18,0;;23,0;;;1,0;;;;16,0;;;;;5,0;;7,0;;1,0;;;3,0;;1,0;;5,0;1,0;;12,0;5,0;15,0;;;5,0;;;5,0;;5,0;3,0;;;;;;;3,0;10,0;;;19,0;31,0;;13,0;;;;;;;;4,0;;;;1,0;6,0;6,0;2,0;;2,0;1,0;2,0;;6,0;;2,0;;;4,0;;;;3,0;5,0;;;;1,0;;;;2,0;;;;;;2,0;8,0;6,0;8,0;;;;1,0;;;3,0;;15,0;5,0;;9,0;;10,0;;;;;1,0;3,0;;1,0;;;;;;1,0;;;11,0;;;;;;5,0;;;18,0;;11,0;2,0;;;;;3,0;;;10,0;;;;;;2,0;;3,0;;8,0;3,0;;;;;;;;;;;;;3,0;;1,0;1,0;;;;;;;;3,0;1,0;1,0;;;;;6,0;;;6,0;1,0;4,0;1,0;;1,0;;;;1,0;31,0;;;2,0;;;;;;;;;;;;;27,0;7,0;;;;;2,0;;;;;;1,0;;;;;;;;;1,0;;;;;;;;;;;;;;4,0;;1,0;;6,0;;;2,0;;;;;;;;;;;;;32,0;;;;;;3,0;;;;;;;;;;;;;;1,0;;;;;;41,0;5,0;2,0;4,0;3,0;2,0;1,0;;;;;;1,0;15,0;;;;2,0;;2,0;;;;1,0;;;;;;;;3,0;;;;;;;;;;2,0;;;;;;;;;;;;3,0;;;;;;;;;;;;1,0;;;;9,0;1,0;;;;;;;;;;;;;;;;;;;;;1,0;;;6,0;;;;1,0;4,0;5,0;;;4,0;;;;3,0;;;;2,0;1,0;;;;;;3,0;;;;;;;;;;;;;2,0;6,0;;;;;;;;;5,0;;3,0;;4,0;;;;;;;;1,0;;;;;;;5,0;;;1,0;;;;;6,0;12,0;;;2,0;;1,0;;;;;;;;2,0;1,0;;;;1,0;;;;;4,0;;;4,0;;;;;10,0;;;;;;;;;;;;;;;;;;3,0;;;6,0;;;;;;;;;;;;;;;;;;;;;;;;;;;;;;;3,0;;;;;;;;;1,0;;;;;;2,0;;2,0;;;;;1,0;;1,0;;1,0;3,0;;3,0;;;;;1,0;;;1,0;;;;;4,0;;;;;;;;;;;;1,0;;;;;;;;;1,0;;;;;;;;;;1,0;;;;;;;;;;;1,0;18,0;;7,0;2,0;;;;;;;;;;;;;;;4,0;;;;;;;;;;;;;;;;1,0;8,0;;;1,0;2,0;;;7,0;;;;;;2,0;;;1,0;5,0;;;;;;;2,0;;;;;;;;6,0;;;;;;;;;1,0;;;;;;4,0;;;1,0;;;;;3,0;;;;;;;;;;;;2,0;;;;;;;;;;;;;;;;;;2,0;;1,0;;2,0;;;;;;;;;;;;;;16,0;;;;;;;;;;;;;;;;;;;;;;;;;;;;;;;;;
logic;;;1,0;4,0;9,0;;1,0;7,0;2,0;14,0;1,0;;;;9,0;3,0;;1,0;;11,0;;46,0;8,0;4,0;;;;40,0;;8,0;12,0;24,0;56,0;1,0;17,0;;2,0;;;13,0;;;;3,0;;;;;13,0;;4,0;2,0;1,0;;;86,0;17,0;;1,0;8,0;;;1,0;;3,0;;1,0;;;5,0;1,0;;;;;3,0;;1,0;3,0;2,0;;49,0;9,0;2,0;;;1,0;;;14,0;8,0;;;22,0;;;1,0;7,0;21,0;3,0;1,0;44,0;;1,0;1,0;4,0;;29,0;;;16,0;;4,0;1,0;4,0;;;;;2,0;;;;14,0;;;53,0;2,0;;7,0;1,0;;;;;1,0;1,0;;;;;;2,0;;1,0;;;7,0;;;;;;;2,0;;;1,0;1,0;3,0;;2,0;;1,0;;;2,0;;2,0;;;;8,0;1,0;3,0;;;15,0;;;;;;;;;;14,0;;2,0;;;;14,0;;;;;1,0;;;;;;;2,0;1,0;;;;;1,0;;;;16,0;5,0;;;;;;;;;;1,0;;;;;;1,0;2,0;;;;1,0;1,0;8,0;1,0;;2,0;;;;1,0;2,0;;2,0;2,0;;;5,0;;;;2,0;3,0;;;;1,0;;;;1,0;;;;;;;;;11,0;;;;;;;;;;8,0;2,0;19,0;1,0;;;;1,0;1,0;;;;1,0;;;8,0;;2,0;;;;;2,0;;;;1,0;;;;;;;;;;7,0;;;;;;;;2,0;18,0;;;;5,0;;1,0;4,0;;;;5,0;;;;3,0;1,0;;;4,0;;9,0;1,0;1,0;3,0;;2,0;;;;;1,0;;1,0;15,0;;9,0;;2,0;;;;;;7,0;17,0;;1,0;;;;;;19,0;;;;;;3,0;3,0;2,0;;;;;;8,0;5,0;;;;4,0;;;;;;;1,0;;11,0;;7,0;1,0;;;;2,0;;15,0;;;5,0;;4,0;4,0;;;4,0;;;2,0;18,0;;;;;;;;2,0;;7,0;2,0;12,0;;2,0;;;;16,0;;1,0;;;;;5,0;;;;;;;1,0;;;;;;13,0;1,0;;;;;;6,0;;2,0;;1,0;;;;;13,0;;1,0;;7,0;2,0;;13,0;1,0;;1,0;;3,0;1,0;5,0;;;;;;;;1,0;;;;1,0;5,0;1,0;;;;;;;;;;;2,0;;;;;;;;2,0;;;2,0;;;;;;;;;;;;;2,0;;;1,0;;;1,0;23,0;;1,0;10,0;;;;;;;;;;;2,0;;;;;;;;;;1,0;1,0;;;5,0;;;;1,0;;;;2,0;;;;;;;;;1,0;;;;;;;;;;;;;;;;;;;;;;1,0;;;;;;;;;4,0;;2,0;;;;;;;;;;2,0;;;;;;;1,0;;;;;;;;;;;;;;;;;;;;;;1,0;;;1,0;;;;;2,0;1,0;2,0;;;;2,0;;;3,0;3,0;;;;2,0;2,0;;;;;;;;;;;;5,0;;;;1,0;;;;;2,0;;;2,0;;;;;;;;;;4,0;7,0;;;;;;1,0;;;;;1,0;3,0;;;5,0;;;;2,0;;2,0;;;;;;;8,0;;;1,0;;;;1,0;;;;;;;;;;;;;;;;;;;1,0;;;;;;;;;;;;;;;6,0;;;;1,0;;;;;;;;;;;;;;;2,0;4,0;4,0;;;2,0;;;1,0;4,0;;;;;;;;;;;;;;;;;;2,0;1,0;;;;;;;;;;1,0;;;;;;;;;;;;;;1,0;;;3,0;;;;;;;;;;;;;;1,0;;2,0;;6,0;;;;;;;10,0;;;;;;;;;;1,0;;;;;;;;;;;;;;;1,0;;;;;2,0;;;;;3,0;;;;;;;;5,0;;4,0;;;;;;;;;;;;;;;;;;;;;;1,0;;;;;;;;;;;;;;;;;;;;;;;;;;;;;;;;
luminance;;;45,0;1,0;30,0;;1,0;53,0;157,0;38,0;2,0;43,0;;4,0;66,0;;9,0;15,0;83,0;2,0;18,0;39,0;;20,0;15,0;;6,0;73,0;;170,0;96,0;55,0;76,0;50,0;23,0;;;7,0;;5,0;4,0;;;22,0;6,0;25,0;;;17,0;;12,0;48,0;;1,0;;236,0;41,0;7,0;6,0;3,0;8,0;;47,0;9,0;10,0;;2,0;2,0;;16,0;10,0;;;;;5,0;;6,0;32,0;1,0;1,0;30,0;21,0;4,0;;;55,0;4,0;19,0;30,0;9,0;1,0;1,0;298,0;;17,0;1,0;4,0;7,0;1,0;1,0;8,0;;;;;;85,0;;;3,0;7,0;6,0;;;2,0;;1,0;;;;;5,0;10,0;;;46,0;;9,0;;;;;;;41,0;;;;1,0;;2,0;7,0;1,0;35,0;;10,0;17,0;5,0;;1,0;;3,0;1,0;;;1,0;;2,0;23,0;2,0;13,0;;1,0;;;99,0;62,0;;;;;7,0;;;6,0;;28,0;;;;;4,0;2,0;;;;78,0;;32,0;;;;12,0;;;;;;;;;;6,0;;5,0;;;10,0;;12,0;;;;;35,0;;;;;3,0;1,0;;;;;2,0;;;;;;;17,0;14,0;2,0;;23,0;106,0;;;;9,0;;;3,0;1,0;;;;2,0;1,0;;;;;;4,0;1,0;;14,0;;3,0;;;;2,0;;;;;;;;;;;;2,0;;;;;4,0;;1,0;;58,0;6,0;;;;2,0;15,0;;;;9,0;;;1,0;;69,0;;;;;30,0;;;16,0;13,0;;;;;;;;;;3,0;;;;9,0;;;6,0;;8,0;1,0;;;;;;4,0;2,0;;;;1,0;23,0;;;9,0;6,0;;18,0;8,0;;;;;;1,0;;;;44,0;19,0;;;;14,0;;2,0;142,0;;2,0;;1,0;34,0;;3,0;1,0;47,0;;;8,0;3,0;;1,0;10,0;;8,0;18,0;;;;7,0;;;1,0;1,0;;45,0;45,0;;1,0;;1,0;44,0;2,0;;;1,0;;;;;;;;;;;27,0;;;;;1,0;13,0;;3,0;1,0;;26,0;;;;;;;2,0;;;;;;;6,0;;2,0;5,0;19,0;;;;1,0;83,0;22,0;;1,0;;;3,0;;2,0;;;14,0;;2,0;;1,0;;;2,0;19,0;;;;;;;;1,0;1,0;;;;;;;2,0;2,0;7,0;;;1,0;;68,0;10,0;;;;;;;;;2,0;;;;;;;;;1,0;;;7,0;;;1,0;;;29,0;;;35,0;2,0;;;;;3,0;;;;8,0;;;;;;;;;;;;;;;;2,0;;;;;5,0;;;10,0;182,0;;;;;;6,0;;3,0;;;1,0;;;;;;;;;;;42,0;;;;;;4,0;;;;;;;;;;4,0;;;;41,0;;1,0;;;;;;;;;;;;;;;1,0;;;3,0;3,0;;;;;;;;;;17,0;;;;;;;;;;;;;20,0;;;;16,0;;;;;;;;;;;;;;;5,0;;;;;3,0;;;;9,0;;;7,0;;;4,0;7,0;58,0;26,0;;;;;;;;;20,0;;4,0;;;18,0;8,0;1,0;;;;1,0;12,0;;;;;24,0;;;1,0;4,0;1,0;;;;1,0;;;;;;;1,0;;;;;;;14,0;;;;;1,0;3,0;;3,0;;;22,0;;10,0;7,0;11,0;;;;;;;;;17,0;;10,0;;2,0;;;;6,0;;;;7,0;3,0;;;;;;;;3,0;;;;;;;;;;2,0;;;;;;;1,0;;;;;;;;;;;3,0;;;1,0;1,0;4,0;1,0;;;;;6,0;;5,0;;;;;;;5,0;;;3,0;1,0;;2,0;2,0;;;;1,0;;;;;2,0;;;;;;;;;;;;1,0;10,0;;;;;;1,0;;;;;;;;;;;;;;;;3,0;;5,0;;;;;;;;;;;;;;;2,0;;2,0;3,0;;;;;;;;;;;;2,0;4,0;3,0;;;4,0;;7,0;;;;;8,0;4,0;;;;;;2,0;;;;;;;;;;;;;;;;1,0;;;;;;;;;;1,0;;;;;;;;;;;;;;9,0;;34,0;;11,0;;;;;;2,0;2,0;;;;;;;;;;;;;;;;;;;;;
magnitude;;;2,0;;1,0;;3,0;16,0;9,0;;;;;;;;;;9,0;;3,0;29,0;;1,0;2,0;1,0;;7,0;4,0;24,0;8,0;14,0;2,0;8,0;3,0;;2,0;18,0;;;1,0;;5,0;1,0;;1,0;;2,0;2,0;4,0;;4,0;;1,0;;31,0;10,0;;3,0;6,0;;;19,0;;;4,0;1,0;;1,0;5,0;12,0;2,0;1,0;;;;;1,0;13,0;;;3,0;5,0;;;;;3,0;17,0;3,0;4,0;2,0;;88,0;1,0;;;;1,0;;;6,0;;;;;;2,0;;;;;;;;;;;;;;;;3,0;;;4,0;;;;;;;3,0;;5,0;;;3,0;;1,0;;;;;11,0;;9,0;;;;;;2,0;7,0;;;;;1,0;;6,0;;;;2,0;6,0;4,0;;;;1,0;;;10,0;;;8,0;;;;;1,0;;;;;5,0;;2,0;;;;;;2,0;1,0;;4,0;;;;;;;;;;;;;;;;2,0;4,0;;;;;;;4,0;;;;7,0;;;;;;3,0;;22,0;9,0;;8,0;;;;;;;;2,0;;;;1,0;;;;;;;;3,0;;;2,0;4,0;;;;;;;;;;;;;;;;;1,0;1,0;;;;1,0;;3,0;3,0;3,0;;4,0;;;;;;;;3,0;;;;;7,0;;2,0;;;43,0;;;8,0;4,0;;;;;;;;;;2,0;;;;3,0;;;;;;;;9,0;;;1,0;;;9,0;;;;;;;;3,0;;10,0;2,0;3,0;1,0;1,0;;9,0;1,0;;;;3,0;;;;;3,0;;3,0;;;2,0;;;;1,0;4,0;;;;;1,0;1,0;;;;18,0;;;;;;3,0;;;;;3,0;;13,0;;2,0;;;3,0;8,0;17,0;1,0;;;;;;;;;;;;4,0;;;;;;;;;;2,0;;;1,0;;;;;13,0;;;;;;;;;5,0;;;1,0;;;;3,0;;;;;;;;;;;1,0;;;;;7,0;;;;;;;1,0;;;;;;;;4,0;;1,0;;;;10,0;;;;;3,0;;;;;;;;2,0;;;;;;;;;;;;;;;;;;;;;;;;;;;;;;;;;7,0;;;;;;10,0;;;;;;;;;;;;;;;2,0;;;;9,0;2,0;;;;;2,0;;;;;;;;;;;;;;;;;;;;;;;;;;;;;;;;;;;;3,0;;;;;1,0;;;;;;;;;;;;;;;;;;;;;;;;2,0;;;;;;;;;;;;;;;;;2,0;;;;;;;;;;;;;;;;;;14,0;;;;;;;;;;;3,0;;;3,0;;;2,0;;;;;2,0;;;5,0;1,0;;3,0;;;;;;;;;;;;;;;4,0;;;;;;;;;;;;;;;2,0;;;;;;;2,0;11,0;;;2,0;;;;;;4,0;;2,0;6,0;;5,0;;;;;;;;;;1,0;;;;;2,0;;;;;;;;;3,0;;;;;;1,0;3,0;;;;;;;;;6,0;;;;;;;;;;;;;;;;;;;2,0;;;;;;;;;;;;;5,0;;;;;;;;;;;;;3,0;;;;;;;;1,0;;;;;;;;;;;;;;6,0;;;;;;;;1,0;2,0;;;;;1,0;;;;;;3,0;;;;;;;;;;;;;;;;;;;;;;1,0;;;;;;;;;;;;;;;;;;;;;;;;;10,0;4,0;;;;;;;;;3,0;;;;5,0;;;;;;;;;;;;;;;;;;;;;;;;;;;;;;;;;;;;;;;;;;;1,0;;;;;;;;;;;;;;;;;;;;;;
maintain;;;7,0;;8,0;;21,0;4,0;;10,0;5,0;;1,0;;7,0;4,0;2,0;1,0;18,0;2,0;4,0;21,0;;2,0;2,0;;;18,0;2,0;2,0;1,0;11,0;29,0;;6,0;;;22,0;;11,0;22,0;;13,0;12,0;2,0;;;6,0;17,0;2,0;1,0;2,0;;13,0;1,0;78,0;11,0;;1,0;39,0;1,0;;35,0;5,0;;6,0;11,0;3,0;;10,0;9,0;2,0;;;;;;18,0;43,0;5,0;;3,0;1,0;;;;2,0;3,0;;24,0;11,0;3,0;5,0;15,0;5,0;10,0;2,0;3,0;3,0;;9,0;19,0;;;;;;10,0;;;4,0;;3,0;11,0;2,0;12,0;2,0;;;1,0;;;2,0;11,0;;;13,0;8,0;;6,0;;2,0;;;2,0;1,0;1,0;;;;;1,0;5,0;4,0;2,0;5,0;7,0;8,0;2,0;;;;5,0;;2,0;;;8,0;10,0;9,0;;4,0;;;1,0;1,0;16,0;16,0;;;19,0;7,0;1,0;18,0;5,0;5,0;;20,0;;;2,0;2,0;1,0;;1,0;4,0;21,0;8,0;;25,0;;1,0;4,0;12,0;;2,0;;;7,0;2,0;2,0;3,0;;4,0;;6,0;2,0;2,0;;6,0;;1,0;;;2,0;14,0;4,0;1,0;;;3,0;3,0;1,0;;;;8,0;1,0;;;;;1,0;6,0;6,0;8,0;;5,0;7,0;;6,0;;;12,0;3,0;1,0;;1,0;;1,0;3,0;;;1,0;;;;;6,0;;;8,0;1,0;2,0;6,0;5,0;;;;;;;;2,0;1,0;;3,0;;;2,0;4,0;1,0;;8,0;;4,0;9,0;37,0;5,0;1,0;;;1,0;;;;;1,0;;;;;19,0;2,0;;;;7,0;;;5,0;1,0;;;3,0;;1,0;;;2,0;;5,0;2,0;;3,0;2,0;2,0;;2,0;1,0;13,0;;;;;;;1,0;;;3,0;1,0;;;;;;;;3,0;4,0;2,0;;12,0;;;;;;;1,0;;4,0;;;;3,0;;;5,0;;1,0;3,0;;3,0;;;;;6,0;2,0;1,0;4,0;;15,0;1,0;;3,0;;6,0;3,0;;7,0;1,0;2,0;;;11,0;11,0;3,0;5,0;;;;1,0;;25,0;6,0;;;4,0;7,0;;;1,0;1,0;12,0;;4,0;3,0;9,0;;;;5,0;1,0;15,0;;8,0;1,0;2,0;5,0;;;;;;3,0;;;2,0;;1,0;1,0;1,0;1,0;3,0;;;;;;9,0;8,0;;;;;3,0;;;2,0;;2,0;;5,0;12,0;3,0;;4,0;;5,0;1,0;;1,0;6,0;3,0;1,0;;;;;1,0;;;12,0;;;2,0;3,0;;4,0;16,0;;5,0;19,0;;5,0;;;;;;;8,0;10,0;;;2,0;;;;;1,0;4,0;2,0;;;1,0;;;;;;;;;;1,0;;;;;1,0;;2,0;1,0;;;;;3,0;;;;;14,0;;;1,0;;1,0;;1,0;1,0;;3,0;;;2,0;26,0;;;;;2,0;1,0;;;;;1,0;5,0;2,0;;;;;3,0;;1,0;2,0;8,0;;1,0;3,0;;;1,0;;;;;1,0;;1,0;2,0;;;;;;20,0;;;;;1,0;1,0;;;;;4,0;;;;;;;;;;1,0;;;3,0;1,0;;;;8,0;3,0;;5,0;;;;;1,0;;;5,0;7,0;;;;;;;1,0;;1,0;;;1,0;;1,0;;;25,0;;;;1,0;2,0;;;;;10,0;;;;1,0;4,0;;;;;3,0;;9,0;4,0;1,0;1,0;;4,0;12,0;;;2,0;;;;;;1,0;;1,0;1,0;;;;;;;;;;;;1,0;;;;;;;;1,0;;;;;;;;1,0;;1,0;2,0;;3,0;1,0;;1,0;;;;2,0;;1,0;3,0;;1,0;7,0;;;;;3,0;1,0;1,0;;;;1,0;4,0;;;;;;;;;1,0;1,0;;;;;;;2,0;3,0;;2,0;;;;;;;;;;;;;1,0;;13,0;;;;2,0;;;;;;2,0;;;;;;;;;;14,0;;;;;5,0;;;2,0;1,0;;;;;;4,0;1,0;;13,0;;;;1,0;;;;;;;1,0;;;;;2,0;;6,0;;;;;;;1,0;;;;7,0;;;;;;5,0;;;1,0;;;;;;5,0;1,0;;6,0;;;;;1,0;2,0;;;;;;;;;;;;;;;;;;;;;;;;;;;;;;5,0;;;;1,0;;;;;;3,0;;;;;;;;;;;;;;;1,0;;;;;;;;;;2,0;;2,0;;;3,0;;;;2,0;;;;;1,0;1,0;;;7,0;2,0;;;;4,0;;;;;;;;;;;;;;;;;;;;3,0;;;5,0;;;;
management;;;2,0;;45,0;;;5,0;1,0;5,0;3,0;2,0;;;;;;;1,0;3,0;;26,0;;;;;;80,0;;;;2,0;18,0;;5,0;;;;;22,0;;;3,0;2,0;;;;;;;3,0;3,0;;6,0;;91,0;29,0;;;;;;25,0;;;;;;;13,0;4,0;1,0;;;;27,0;;;1,0;4,0;;10,0;;;;;14,0;;;4,0;4,0;;1,0;1,0;;;;5,0;27,0;;;16,0;;23,0;;;;69,0;;;;;;;2,0;;;;;;;;;;;;4,0;;;1,0;;15,0;;;;;;;;;;;6,0;;;;4,0;;;;;;;;;;;;1,0;2,0;;;;;;;;;;;;;6,0;;;;;14,0;;;;;;;;;;3,0;;;;;;5,0;;;;;;;;;;;;;;;;2,0;;;;;;3,0;10,0;;;;;;;;;;;;;;;;;;;;;;13,0;;;;;;;;;;;;;;;1,0;;;;;;;;;;;;;;;;;;;;;;2,0;;;;;;;;;;;;;3,0;;;;;;;;;;;;1,0;;3,0;;;;;;;;;1,0;;;;;;;;;;;;;;;;;5,0;;8,0;1,0;;;;;;1,0;1,0;;;;;3,0;;;;;;1,0;;1,0;;;;;;;;;;;;;2,0;1,0;;;;;;;;;10,0;15,0;;;;;;;;7,0;;;;;;42,0;;3,0;;;;;;;;;;;;;;;;;;;;;;;;3,0;2,0;;5,0;;;;;;1,0;;;6,0;;;1,0;;;;;;;;;1,0;;;;;;2,0;;1,0;;;;3,0;3,0;1,0;;2,0;;2,0;;1,0;;4,0;;;;;;;;;;4,0;;;7,0;;7,0;;;2,0;43,0;;3,0;;;;23,0;2,0;;3,0;;6,0;;;3,0;;1,0;;6,0;5,0;1,0;4,0;;1,0;;1,0;;;;;;;11,0;;2,0;;;1,0;;1,0;;;;;;;1,0;;;;;;;;49,0;;;;;;;;;;;;;;;;;;;;4,0;;2,0;;1,0;;1,0;;;;;27,0;;;;;;2,0;19,0;;;;;;;;;1,0;;;;1,0;;;;2,0;;;;;;;;;;;;;;;;;;1,0;;;;1,0;;;1,0;;;;;;;;;;;;;;2,0;;;;;;;;;;;;;;;;;;;;;;;;;;;;;;;;;;;;;;;;;;;;1,0;;;;;;;;;;;;;;;;;;;;4,0;;;;;;;;;;;;;;;;;;;;;;;;;;1,0;;;;;;;;;;;;;1,0;;;;;;;;;;;;;;;;;2,0;;;;;25,0;;;;;;2,0;;;;;;;;;;;;;;;;;;;;;;;;;;;;;;;;;;;;;;;;;;;;;;;;;4,0;1,0;;;;;;;;;;;;;;;;;;;;;;3,0;;;;;;;;;;;;;;;;;;;;;;;;;1,0;;;;;;;;;;;;;;;;;;;;;;;;;;;;;;;;;;;;;;;;;;;;;;;;;;;;;;;;;1,0;;;;;;;;;;;;;;;;;;;;;;;;;;;;;;;;;;;;;;;;;;;;;;;;;;;;;;;;;;;;;;;;;;;;;;;;;;;;;;;;;;;;;;
manner;;;6,0;;14,0;;33,0;9,0;1,0;14,0;11,0;1,0;1,0;;14,0;1,0;3,0;;2,0;1,0;5,0;75,0;;2,0;6,0;;;38,0;1,0;6,0;2,0;3,0;58,0;4,0;11,0;;2,0;19,0;;120,0;6,0;;7,0;26,0;;2,0;2,0;;10,0;4,0;1,0;13,0;;19,0;;259,0;10,0;;;81,0;4,0;5,0;18,0;;;3,0;12,0;;;13,0;48,0;7,0;;;2,0;;;13,0;29,0;4,0;3,0;13,0;9,0;;;;5,0;;2,0;15,0;14,0;6,0;;16,0;12,0;7,0;;2,0;6,0;4,0;27,0;26,0;;10,0;;2,0;;84,0;;;1,0;26,0;;7,0;3,0;2,0;;1,0;;17,0;2,0;;;5,0;;;17,0;6,0;;3,0;17,0;2,0;;;;2,0;18,0;;1,0;1,0;;;;36,0;6,0;;17,0;19,0;;2,0;1,0;4,0;4,0;;10,0;1,0;;15,0;;10,0;8,0;1,0;;3,0;;4,0;6,0;28,0;;;15,0;24,0;10,0;12,0;3,0;1,0;;21,0;;2,0;8,0;9,0;;;8,0;2,0;6,0;14,0;2,0;66,0;;;3,0;15,0;1,0;7,0;;;;8,0;4,0;;;6,0;3,0;;6,0;;1,0;14,0;;1,0;;;1,0;9,0;2,0;2,0;;;;;;;2,0;;4,0;;;;;;;2,0;9,0;2,0;;3,0;30,0;2,0;9,0;;;;;4,0;;3,0;;2,0;4,0;;;4,0;1,0;;;11,0;1,0;;3,0;2,0;;3,0;7,0;;3,0;4,0;;;1,0;2,0;;8,0;;;;4,0;2,0;1,0;6,0;;;4,0;4,0;4,0;41,0;7,0;4,0;;;;10,0;7,0;1,0;1,0;;5,0;1,0;;2,0;;5,0;1,0;4,0;;;11,0;1,0;5,0;5,0;2,0;;;1,0;;6,0;5,0;;7,0;;14,0;;3,0;;;;2,0;3,0;;11,0;12,0;1,0;;;;;;1,0;;5,0;4,0;;3,0;2,0;;;12,0;;19,0;;;1,0;;;2,0;1,0;;;;2,0;;;2,0;;6,0;;;4,0;1,0;;;3,0;2,0;1,0;7,0;1,0;3,0;;6,0;8,0;;2,0;2,0;4,0;;1,0;2,0;;11,0;;1,0;7,0;;1,0;5,0;;3,0;;;4,0;;11,0;2,0;1,0;;1,0;;;2,0;7,0;7,0;2,0;4,0;;;1,0;;2,0;;5,0;;;;7,0;;12,0;1,0;1,0;3,0;;1,0;;;;2,0;;2,0;;1,0;;;;;;;1,0;1,0;;3,0;;;13,0;3,0;;;2,0;;;;;4,0;;;;6,0;21,0;3,0;2,0;;;6,0;;;;;13,0;;;2,0;2,0;;2,0;;;9,0;11,0;;;11,0;;;3,0;1,0;4,0;5,0;;12,0;2,0;1,0;;;;;6,0;3,0;;;;;5,0;;;;1,0;3,0;1,0;2,0;;;;;3,0;;4,0;;4,0;;6,0;;;;2,0;;2,0;1,0;;4,0;2,0;;;7,0;;1,0;;;8,0;;3,0;;;;;3,0;1,0;;3,0;;4,0;5,0;18,0;;4,0;;;;7,0;4,0;1,0;;5,0;;;;;;;;2,0;2,0;;;35,0;;2,0;1,0;2,0;1,0;;1,0;3,0;;2,0;2,0;;4,0;;;1,0;2,0;;;6,0;2,0;;;;2,0;1,0;;;2,0;;;;1,0;;10,0;;;;;;2,0;;;;;1,0;;;2,0;1,0;6,0;2,0;;;;;;;;;3,0;;2,0;1,0;1,0;;2,0;;1,0;;;;;;1,0;;7,0;2,0;4,0;;;8,0;;4,0;;;;;2,0;;1,0;;;;1,0;;;1,0;;3,0;3,0;1,0;;;;;;;1,0;;;;;;;5,0;1,0;21,0;;;;2,0;;3,0;;;2,0;;4,0;2,0;6,0;;;;1,0;;;2,0;;;;;;;2,0;5,0;;;4,0;;5,0;;;25,0;;1,0;;;;;4,0;1,0;;;;;;;;5,0;1,0;;1,0;;;1,0;2,0;;1,0;2,0;;;;;;;2,0;2,0;;2,0;1,0;;3,0;2,0;13,0;;;;3,0;;;;3,0;9,0;5,0;;;;;;;;3,0;;;;;;;;2,0;1,0;;;;1,0;;1,0;;;1,0;;;;;;;3,0;1,0;;;2,0;3,0;;;1,0;;5,0;;;;;;;;2,0;;;8,0;9,0;;;;;;;;;;1,0;;;;;;;1,0;;2,0;;;;1,0;;;;1,0;;;2,0;;2,0;;;;;;2,0;;;2,0;;;;1,0;;;;;;2,0;;4,0;;;;;;;;;;;;1,0;;;3,0;;;1,0;1,0;4,0;;;;;;1,0;;;;;;1,0;;;;1,0;;;1,0;;1,0;2,0;;1,0;;;;2,0;;;;2,0;;;;;2,0;;;;2,0;;2,0;2,0;;;;;;;;;;;;1,0;;;;;;1,0;;;;1,0;;;;;;9,0;;;;;;;;;;;;
manual;;;1,0;;14,0;;6,0;8,0;;1,0;;;;;6,0;4,0;1,0;1,0;;2,0;2,0;48,0;;3,0;2,0;;2,0;12,0;2,0;3,0;4,0;1,0;21,0;;16,0;;;18,0;;8,0;;;35,0;3,0;1,0;4,0;;2,0;53,0;;21,0;1,0;;1,0;;27,0;9,0;;;49,0;;2,0;10,0;;;7,0;3,0;;;153,0;4,0;1,0;1,0;;;1,0;;2,0;31,0;;6,0;6,0;;;;;;;;24,0;;;;21,0;1,0;;;3,0;;;9,0;13,0;;15,0;;1,0;;15,0;;;;;;3,0;;9,0;;;;15,0;;;;2,0;;;11,0;1,0;4,0;;3,0;;;;;2,0;;;;;;;2,0;3,0;;1,0;5,0;3,0;;;;;;;;;3,0;2,0;9,0;5,0;;;;;;;;4,0;;;79,0;;9,0;4,0;3,0;;1,0;4,0;;;;;;3,0;;2,0;1,0;1,0;;6,0;1,0;;;5,0;;;;;32,0;;;;;;;1,0;;;;;;;;;3,0;8,0;;;;;;;;;;;;;;;;1,0;6,0;8,0;3,0;8,0;;2,0;4,0;3,0;;;;;;1,0;;;1,0;;;;;16,0;1,0;;;2,0;6,0;;;1,0;;;1,0;;2,0;;;;;1,0;;;;;1,0;;;;;;;22,0;;2,0;7,0;5,0;14,0;1,0;;1,0;2,0;;;;;26,0;;1,0;3,0;;2,0;1,0;1,0;;;6,0;;2,0;3,0;1,0;;;90,0;;1,0;;;;;;2,0;;;;;;;;21,0;;;;;;;1,0;;;;3,0;3,0;2,0;;;2,0;;;3,0;;1,0;2,0;;;;;;;;;;;;;5,0;4,0;2,0;;;;;;;;;3,0;;;4,0;4,0;1,0;;2,0;;;;1,0;1,0;1,0;3,0;11,0;3,0;;1,0;1,0;1,0;;;;;;;;;;;6,0;;;;8,0;;;;;;;22,0;;;;;;77,0;;3,0;;;;;;;;;;;;;;5,0;;;;;24,0;;;;;;;;2,0;;;;;3,0;1,0;;;;;;;1,0;;;1,0;;19,0;;;;;3,0;;;;;;;4,0;;15,0;;8,0;;11,0;;46,0;2,0;;1,0;5,0;1,0;;;;;;;;3,0;;;;;;;;;1,0;2,0;1,0;;1,0;;;;2,0;;;11,0;1,0;3,0;;;2,0;;;;5,0;7,0;6,0;6,0;;;;;;2,0;;;;;;;;;1,0;;;2,0;;;2,0;;7,0;;;;;;;14,0;;;;;;;;;;;;;;;;;;;;;;;;;;;;;;;;1,0;;;;5,0;;1,0;;1,0;;1,0;;;2,0;;;;;;;;;;;;;;;;;;;;;4,0;21,0;4,0;;;;;;;;;;;;;;;;;;;1,0;;;;2,0;;1,0;;;;;;;;;;4,0;;;2,0;;;;;;;;2,0;;;;4,0;;;;;;;15,0;;;;;;;;;;;;;;;;;;;;;;;;1,0;;2,0;;;;;;;;;;;;;40,0;;;;2,0;;;;;;9,0;1,0;;;;;;;;;1,0;1,0;;;;;;;;;7,0;;;;2,0;;;;;;;;2,0;2,0;;3,0;;2,0;;;;;1,0;;;;1,0;;;;;;;;;;;;;;;;;;;2,0;;;;;;1,0;;1,0;;3,0;;;1,0;;;;;;;;;1,0;;5,0;1,0;;2,0;;;;;;;;;;;;;;;;;;3,0;2,0;;1,0;;;;;1,0;;;;;;;;;;;;;1,0;;;;;;;;;;;;;1,0;;;;;;;;;;;;;;;;;;;;;;;;;;;;;;;;;;;;;;;;;;;;;;;;;;2,0;;;;;;;;;;;;;;;;;1,0;;;;;;;;;;;;;;;;;;;;;4,0;;;2,0;;;;;;;;;;;;;;;;;;;;;;;;
match;;;1,0;1,0;10,0;;8,0;20,0;17,0;15,0;3,0;22,0;;14,0;44,0;;;1,0;12,0;8,0;21,0;4,0;2,0;2,0;3,0;3,0;3,0;84,0;13,0;11,0;6,0;49,0;24,0;6,0;7,0;3,0;1,0;2,0;;26,0;9,0;6,0;;17,0;5,0;;1,0;4,0;13,0;32,0;10,0;20,0;6,0;;4,0;258,0;15,0;3,0;4,0;10,0;1,0;2,0;62,0;;17,0;;7,0;;;;6,0;11,0;1,0;;;7,0;;35,0;37,0;;;4,0;10,0;;3,0;;21,0;4,0;7,0;14,0;10,0;8,0;;9,0;6,0;;;1,0;21,0;;14,0;15,0;1,0;;1,0;6,0;;27,0;;;2,0;;4,0;1,0;5,0;4,0;;;;2,0;;;2,0;2,0;1,0;;17,0;;1,0;;1,0;1,0;;;;;5,0;;;;;1,0;1,0;26,0;16,0;1,0;13,0;40,0;1,0;;;;3,0;;;;;1,0;10,0;6,0;;1,0;;3,0;;;12,0;11,0;;2,0;2,0;;5,0;2,0;3,0;1,0;1,0;4,0;;;2,0;;;;;2,0;;34,0;;17,0;;;;6,0;;1,0;;;2,0;1,0;1,0;21,0;;7,0;;1,0;1,0;;1,0;1,0;1,0;;4,0;;;31,0;;;3,0;1,0;1,0;5,0;8,0;;;;3,0;;;;;;;2,0;7,0;3,0;;6,0;17,0;;;;23,0;7,0;;;3,0;2,0;;;;;;;1,0;;;6,0;3,0;2,0;1,0;;1,0;;;;1,0;;;;;;;;3,0;;2,0;;1,0;1,0;;;;;;6,0;;59,0;;;;;8,0;26,0;;;;7,0;;;2,0;;14,0;;;;;15,0;1,0;4,0;28,0;10,0;;;;1,0;;;;1,0;;;;;1,0;;;;;1,0;24,0;;;;;5,0;4,0;;;;;10,0;4,0;2,0;;2,0;;1,0;5,0;2,0;;2,0;3,0;;10,0;;2,0;3,0;;;2,0;2,0;;3,0;13,0;2,0;;;2,0;;1,0;;;4,0;1,0;5,0;4,0;;;2,0;5,0;;;4,0;;;3,0;8,0;;13,0;;7,0;;;;;1,0;6,0;1,0;3,0;31,0;;6,0;3,0;1,0;;3,0;3,0;;;;2,0;;1,0;;7,0;65,0;;47,0;1,0;16,0;2,0;;1,0;10,0;;3,0;6,0;6,0;4,0;2,0;3,0;;;;1,0;;;;1,0;;44,0;;;1,0;1,0;1,0;;3,0;;;9,0;4,0;7,0;;2,0;2,0;;15,0;;;1,0;6,0;1,0;;;;;11,0;;;41,0;;;;;7,0;;7,0;2,0;2,0;4,0;;;1,0;;11,0;;;8,0;;1,0;6,0;;20,0;6,0;1,0;;;;2,0;16,0;7,0;;1,0;;12,0;;;;;1,0;;2,0;2,0;;;;;8,0;;;1,0;;;4,0;;;;;;;3,0;;9,0;3,0;;6,0;;1,0;;1,0;;;3,0;;;;;;;;;1,0;;;;;;1,0;31,0;;1,0;;;;5,0;;;1,0;;1,0;;4,0;;;;1,0;1,0;;1,0;;10,0;3,0;13,0;6,0;;;;16,0;;;;;;;;;;;;;4,0;;;4,0;;3,0;;;1,0;1,0;1,0;;1,0;;;;;2,0;;;1,0;1,0;;;;;;;;1,0;;3,0;2,0;;;;;;;;;;3,0;;;;3,0;;13,0;;;;;;;;;3,0;1,0;;;2,0;;;;;;;;;;;5,0;;;4,0;;;;;3,0;4,0;8,0;;;;2,0;;;;2,0;;30,0;;;2,0;;;1,0;;;1,0;9,0;;;;1,0;22,0;;;;;;1,0;;;20,0;;;2,0;1,0;;;;;;;;1,0;4,0;13,0;;;;;;;;2,0;;;;;2,0;;;16,0;7,0;;;;2,0;75,0;5,0;1,0;;3,0;;5,0;;5,0;;3,0;;3,0;;;4,0;12,0;1,0;3,0;;1,0;1,0;;;;;1,0;;2,0;4,0;1,0;;9,0;;3,0;;;;3,0;;3,0;1,0;;;;;;4,0;;;;;;9,0;;;4,0;;2,0;;;;;;;;;;;;;;;;;;3,0;;2,0;;3,0;;4,0;;;;;;;;;1,0;;1,0;2,0;;;;;1,0;6,0;2,0;;;;;2,0;;;;3,0;;;;3,0;1,0;;;;;;;1,0;;;;;;;;;;;;;;;;;2,0;;4,0;;;;;;;;;;;;2,0;1,0;2,0;;6,0;;;;;;;;;3,0;4,0;3,0;5,0;;;;5,0;;;;4,0;;;;4,0;5,0;;;5,0;;;3,0;;;;6,0;13,0;;;;;;;;1,0;;;;;2,0;;3,0;;;;2,0;;;4,0;2,0;;;;4,0;;;;9,0;;;8,0;;2,0;;;;;;;;;;;;2,0;;;;
maximum;;;65,0;;20,0;2,0;17,0;27,0;39,0;6,0;3,0;;;;2,0;;;33,0;17,0;;3,0;18,0;8,0;3,0;4,0;3,0;3,0;32,0;2,0;21,0;9,0;23,0;20,0;8,0;11,0;;1,0;7,0;5,0;20,0;45,0;;6,0;4,0;;9,0;;65,0;45,0;2,0;6,0;9,0;;11,0;96,0;259,0;11,0;;60,0;105,0;1,0;9,0;40,0;98,0;;1,0;12,0;;2,0;4,0;29,0;2,0;3,0;;;1,0;1,0;8,0;51,0;;;6,0;5,0;;;;8,0;1,0;6,0;14,0;45,0;;1,0;30,0;78,0;1,0;3,0;3,0;;;22,0;11,0;;2,0;;;;39,0;;;3,0;3,0;6,0;1,0;;;;;;;;;1,0;7,0;;3,0;3,0;;14,0;;;;;6,0;1,0;3,0;;;;2,0;;;;3,0;12,0;4,0;1,0;3,0;;;4,0;4,0;8,0;2,0;;2,0;;;7,0;26,0;;1,0;2,0;;;1,0;17,0;25,0;5,0;;1,0;2,0;10,0;;29,0;10,0;1,0;20,0;;;;;2,0;;;6,0;;11,0;;3,0;;1,0;;1,0;1,0;;;;2,0;;;1,0;;13,0;;;;;2,0;2,0;;;4,0;;;64,0;;;1,0;;1,0;;;;;;;;;;;;3,0;;18,0;29,0;;;8,0;;;;;;;2,0;;;4,0;;1,0;2,0;;2,0;;;;9,0;1,0;5,0;;18,0;22,0;;;;2,0;;;;;;;;4,0;2,0;;;13,0;6,0;;;;5,0;;8,0;13,0;17,0;1,0;;;;1,0;;;;;6,0;;;;;12,0;2,0;;9,0;;25,0;;;8,0;1,0;3,0;1,0;;;;;;;;;;2,0;;;2,0;3,0;;;1,0;;;;;;;;6,0;2,0;;;;;34,0;;6,0;1,0;;9,0;1,0;8,0;11,0;2,0;1,0;;;;;;1,0;;2,0;;5,0;;;;;;;;1,0;8,0;1,0;;;1,0;;;2,0;2,0;;2,0;4,0;3,0;19,0;4,0;;6,0;;1,0;;;1,0;9,0;1,0;5,0;7,0;1,0;;;1,0;;8,0;4,0;3,0;16,0;;;;1,0;;;;2,0;;;1,0;4,0;6,0;;;5,0;8,0;;;1,0;7,0;;;;;;2,0;;1,0;;;7,0;;;;;;4,0;;;;;;;1,0;22,0;;4,0;;;;;;;;;;1,0;10,0;;4,0;;;6,0;;;;;;;;;;;;;;2,0;;5,0;;5,0;;;17,0;;5,0;18,0;;3,0;1,0;;;;2,0;;36,0;;;;;;;;;;;;;1,0;;2,0;;;8,0;1,0;;7,0;;;;;;;1,0;;;17,0;;;;;;;1,0;;;;;;;;1,0;;;;;;8,0;;;;30,0;;;;;;1,0;;;;;;;;;;;;;;;;2,0;;;;;;;;;;;;1,0;;;;;;;;7,0;;;;3,0;4,0;;1,0;;;;;;;;;;;2,0;;2,0;;;;;;;;;;;2,0;;;;;;;;1,0;;2,0;2,0;;;;8,0;;3,0;2,0;;1,0;;;;;1,0;1,0;;;;6,0;;2,0;;;;;;;;18,0;;;1,0;2,0;1,0;;;;4,0;14,0;;2,0;;;2,0;;;;12,0;4,0;7,0;;;;1,0;;;3,0;;;1,0;;;;;1,0;;2,0;2,0;;;3,0;;;1,0;;;;;;4,0;12,0;;;;6,0;;1,0;;;3,0;;;;;;4,0;;;10,0;1,0;;3,0;19,0;13,0;;;;2,0;3,0;;2,0;;2,0;11,0;;6,0;;;;;;1,0;;;;3,0;5,0;;;;1,0;14,0;2,0;;;;;16,0;;;;1,0;;;;;;;;;12,0;;;;;;;;1,0;;;;;1,0;2,0;1,0;;;1,0;;;;2,0;11,0;;;2,0;;;;;;;;;;;;;;;;;;;;;;;;;;;;;;;;;9,0;;;;;;;1,0;7,0;;;;;;;;;;;;;;;;;2,0;;;;;;1,0;;;;;;;;;;;;1,0;;23,0;;;;;;;;;2,0;;;2,0;;1,0;;6,0;;;;;;1,0;;;1,0;4,0;;5,0;;;;2,0;;;;;;;;;;5,0;;2,0;;1,0;;;;;;;;;;;;2,0;;;;;;41,0;;2,0;;2,0;;15,0;;1,0;;;2,0;;;4,0;;;;;;1,0;;;;;;;;;;6,0;;;;;;
measure;;;24,0;;54,0;;12,0;127,0;27,0;36,0;20,0;16,0;;;70,0;3,0;1,0;;14,0;19,0;14,0;22,0;40,0;39,0;6,0;5,0;1,0;46,0;3,0;37,0;13,0;55,0;138,0;20,0;42,0;2,0;1,0;38,0;13,0;31,0;294,0;;4,0;22,0;13,0;2,0;4,0;4,0;28,0;28,0;25,0;15,0;;3,0;21,0;266,0;42,0;;27,0;73,0;2,0;;187,0;;1,0;4,0;10,0;2,0;6,0;6,0;12,0;3,0;28,0;4,0;2,0;12,0;;72,0;210,0;1,0;2,0;19,0;7,0;1,0;3,0;2,0;23,0;1,0;2,0;13,0;95,0;14,0;2,0;59,0;8,0;1,0;8,0;13,0;13,0;2,0;34,0;81,0;;13,0;1,0;;7,0;88,0;1,0;;3,0;11,0;5,0;3,0;;9,0;;;;3,0;7,0;2,0;;16,0;11,0;;42,0;;21,0;3,0;2,0;2,0;;;1,0;23,0;4,0;;;17,0;13,0;6,0;;6,0;4,0;;5,0;29,0;1,0;;5,0;;;4,0;8,0;1,0;;14,0;27,0;14,0;14,0;1,0;;3,0;25,0;;18,0;109,0;;9,0;13,0;14,0;43,0;1,0;30,0;5,0;;45,0;;;;;1,0;;;12,0;;71,0;;25,0;;;10,0;19,0;1,0;12,0;;;18,0;;;6,0;;15,0;;1,0;;2,0;15,0;5,0;4,0;1,0;5,0;;29,0;130,0;6,0;;;2,0;;17,0;2,0;;;2,0;1,0;6,0;3,0;;;;3,0;14,0;13,0;96,0;;10,0;26,0;9,0;;;5,0;1,0;;1,0;4,0;;;;2,0;;;7,0;;2,0;;4,0;3,0;;10,0;6,0;10,0;;;;2,0;;;;;3,0;;;3,0;15,0;14,0;;;11,0;;;;8,0;;7,0;9,0;215,0;18,0;;;;4,0;3,0;;4,0;;42,0;;;;;39,0;;10,0;;;44,0;;;18,0;12,0;;;2,0;;;;;;2,0;1,0;;;;4,0;;;;2,0;8,0;;1,0;2,0;1,0;;1,0;3,0;1,0;21,0;1,0;19,0;;7,0;2,0;3,0;4,0;;;4,0;2,0;2,0;31,0;1,0;;3,0;9,0;1,0;;1,0;2,0;2,0;;3,0;3,0;15,0;2,0;7,0;;7,0;3,0;2,0;;;5,0;6,0;1,0;1,0;;1,0;18,0;2,0;4,0;5,0;1,0;6,0;2,0;17,0;;21,0;;2,0;;;9,0;13,0;6,0;52,0;8,0;3,0;19,0;;3,0;7,0;6,0;1,0;;1,0;;2,0;;2,0;;4,0;;16,0;17,0;;17,0;51,0;48,0;;2,0;10,0;12,0;1,0;10,0;2,0;1,0;32,0;1,0;5,0;;;;;;1,0;;31,0;;;;2,0;;14,0;2,0;1,0;1,0;1,0;;4,0;48,0;47,0;;1,0;21,0;;5,0;;;;;8,0;1,0;18,0;7,0;;35,0;;;10,0;2,0;;3,0;2,0;;2,0;12,0;2,0;;;;2,0;7,0;16,0;11,0;7,0;;5,0;;5,0;57,0;;7,0;24,0;7,0;25,0;1,0;3,0;;;3,0;;1,0;;;;;;1,0;;3,0;13,0;1,0;;;;;2,0;;;11,0;;;6,0;2,0;;;1,0;10,0;1,0;2,0;;3,0;1,0;;;5,0;2,0;;3,0;2,0;;;;;2,0;;;4,0;1,0;1,0;;3,0;;13,0;;;15,0;153,0;1,0;;;;;29,0;;;;7,0;;3,0;;;1,0;;3,0;;;;;58,0;1,0;;5,0;;;;11,0;;;;3,0;16,0;;;;4,0;;1,0;;29,0;;;;;;;;;2,0;;4,0;;;;;;6,0;;;3,0;1,0;;;;;7,0;;;1,0;;1,0;5,0;;29,0;;;;;;;;;;;4,0;16,0;;4,0;;;;;;;;4,0;;11,0;;;;;3,0;;;;4,0;1,0;;;3,0;4,0;;;4,0;;6,0;;;41,0;74,0;30,0;;;2,0;2,0;;;2,0;6,0;;12,0;;;10,0;;4,0;4,0;3,0;;;7,0;;;;17,0;12,0;;6,0;9,0;5,0;;;;;;;;3,0;2,0;;;;;1,0;;2,0;1,0;2,0;15,0;1,0;;;;1,0;2,0;11,0;23,0;2,0;;;1,0;;16,0;2,0;;;;2,0;;1,0;;5,0;3,0;1,0;7,0;;2,0;11,0;1,0;14,0;6,0;;;;;8,0;2,0;4,0;1,0;5,0;1,0;;34,0;;;4,0;;;;1,0;2,0;1,0;;;;;;;;2,0;;;;;;;1,0;;;;;;2,0;;6,0;;;1,0;;5,0;;;20,0;;3,0;;5,0;3,0;12,0;;3,0;19,0;1,0;1,0;1,0;;;2,0;56,0;;;2,0;6,0;;;;4,0;3,0;;;;;2,0;;;;1,0;;;2,0;;1,0;1,0;;2,0;;;2,0;1,0;3,0;;;;;8,0;;1,0;1,0;;;;;;7,0;3,0;;;;;;;;;;;;;;;1,0;;;;;;;;;;;;;;;;2,0;3,0;1,0;;1,0;9,0;;6,0;;;;8,0;11,0;;;;;;15,0;2,0;;2,0;;14,0;6,0;;;;1,0;;3,0;;;;22,0;;7,0;2,0;3,0;;;;;;;1,0;1,0;1,0;;;;2,0;;;;;1,0;;;;2,0;4,0;;;;;;;8,0;1,0;1,0;;1,0;;7,0;4,0;;;;;;10,0;;;;;;;;;
measurement;;;9,0;3,0;21,0;;7,0;83,0;22,0;5,0;5,0;1,0;;3,0;41,0;3,0;;;;3,0;6,0;17,0;3,0;6,0;9,0;;;36,0;4,0;12,0;22,0;61,0;70,0;7,0;22,0;6,0;7,0;21,0;;18,0;99,0;6,0;;31,0;1,0;;;3,0;22,0;2,0;16,0;22,0;;3,0;;57,0;31,0;1,0;23,0;19,0;2,0;;84,0;1,0;1,0;;2,0;2,0;4,0;10,0;9,0;1,0;1,0;11,0;;1,0;;85,0;55,0;;;16,0;5,0;14,0;;;40,0;1,0;;18,0;20,0;;11,0;40,0;2,0;;;6,0;11,0;;25,0;55,0;;;4,0;;;40,0;;;7,0;14,0;5,0;2,0;;;;;;;;;;5,0;21,0;1,0;28,0;;6,0;3,0;1,0;2,0;;;;12,0;3,0;;;2,0;1,0;5,0;2,0;1,0;5,0;;4,0;8,0;;2,0;;1,0;1,0;;2,0;;;4,0;17,0;8,0;1,0;3,0;;;48,0;;3,0;70,0;;3,0;3,0;;14,0;5,0;7,0;4,0;;11,0;;;1,0;;2,0;;;10,0;;16,0;1,0;11,0;;;;21,0;;2,0;;;7,0;;;2,0;;;;;;;2,0;3,0;2,0;;3,0;;5,0;28,0;2,0;;2,0;;;7,0;;;;2,0;;;;;;;8,0;;6,0;5,0;;16,0;8,0;6,0;;;2,0;;;;;;;;;;;3,0;7,0;;;3,0;7,0;;;;9,0;;;;1,0;;;;;;;;;2,0;7,0;;;1,0;;;;10,0;;12,0;2,0;55,0;2,0;;;2,0;;;;;;;;;;;19,0;;;;;14,0;;;8,0;19,0;;;;;;;;2,0;;;;;;1,0;;;;;7,0;1,0;1,0;;;;;;;;;8,0;;3,0;6,0;;6,0;4,0;;1,0;2,0;;14,0;1,0;;;3,0;;;;3,0;1,0;;;;1,0;;4,0;;2,0;;1,0;;56,0;3,0;;5,0;;;;;5,0;;2,0;2,0;7,0;;;1,0;1,0;2,0;2,0;;;8,0;4,0;3,0;13,0;7,0;;17,0;4,0;;3,0;11,0;;5,0;2,0;;4,0;4,0;2,0;;9,0;;5,0;4,0;10,0;;10,0;14,0;;;4,0;19,0;;1,0;;1,0;37,0;2,0;2,0;;;;;;;;10,0;2,0;;;17,0;2,0;5,0;1,0;3,0;;;;10,0;18,0;;;;;4,0;3,0;;;;;;;10,0;1,0;;15,0;;;32,0;;;;;4,0;;;1,0;;;;;2,0;;2,0;2,0;;7,0;;;51,0;;2,0;10,0;7,0;10,0;;;;;2,0;1,0;8,0;;;;;;;;;3,0;;;4,0;;;;;;1,0;;;;1,0;;;;;;;4,0;;1,0;;;;;;;;;;;3,0;2,0;;;2,0;;;;;;6,0;;;20,0;33,0;;;;;;9,0;;;;1,0;;;;;;;;2,0;;;;13,0;10,0;2,0;;;;;;;;;;;3,0;;;1,0;;;;13,0;;;1,0;;;;;;;;;;;4,0;;;;;;1,0;6,0;;;;;;;;;;5,0;3,0;;5,0;;;;;2,0;;5,0;3,0;;;;25,0;;;;;;;;2,0;;;;5,0;;;;;1,0;;;;3,0;1,0;;;;1,0;;;1,0;;;;;25,0;32,0;5,0;;;;;;;;3,0;;2,0;;;1,0;7,0;;2,0;;;;1,0;;;4,0;;11,0;1,0;;;4,0;;;;;;;;;2,0;;;;3,0;;2,0;1,0;;;16,0;;;;;;4,0;;9,0;;;2,0;;1,0;5,0;7,0;3,0;;;;;;;3,0;10,0;;3,0;;4,0;5,0;;;3,0;;;;;5,0;2,0;;;1,0;;4,0;2,0;;2,0;6,0;;;;;3,0;1,0;;;;;1,0;;;;;;;;;;;;;1,0;;3,0;;;;;;1,0;;2,0;;;4,0;;;;;;7,0;;;2,0;;;2,0;;;;;;;;;;;;;17,0;;;;;6,0;;1,0;;;;2,0;;;;;;;;;;;;1,0;;;;;;;;;;;;;;13,0;;;;;;;;;;;;;5,0;;;1,0;;;;;;;;;;;;;;;;;;;1,0;;;2,0;;;;3,0;;;;;3,0;;7,0;2,0;;;;4,0;;;;1,0;;;;;;;8,0;;6,0;;;;;;;;;;;;;;;1,0;;;;;;;;;;11,0;5,0;;;;;;1,0;;;;;;;;;;1,0;;;;;;;;;;;;
mechanical;;;4,0;;10,0;;2,0;16,0;;7,0;1,0;2,0;;;;3,0;1,0;;7,0;;;23,0;57,0;1,0;1,0;;;15,0;4,0;4,0;1,0;18,0;30,0;5,0;15,0;;2,0;6,0;4,0;;12,0;;13,0;4,0;;;;2,0;2,0;2,0;;10,0;1,0;3,0;;24,0;20,0;;;13,0;;;23,0;2,0;;12,0;8,0;;;17,0;7,0;1,0;4,0;;;;;;44,0;;;;2,0;9,0;;;;6,0;3,0;1,0;10,0;;;5,0;;1,0;;2,0;;;5,0;29,0;;;2,0;;2,0;3,0;;;1,0;;2,0;2,0;4,0;;1,0;;;1,0;;;;;;;6,0;1,0;;5,0;1,0;;;1,0;;1,0;3,0;;;6,0;;;5,0;;2,0;2,0;4,0;13,0;2,0;;;;;;;5,0;2,0;6,0;3,0;8,0;1,0;1,0;;;;;3,0;11,0;;;7,0;2,0;52,0;11,0;7,0;1,0;;;;;2,0;;2,0;6,0;1,0;2,0;5,0;19,0;;8,0;;;;16,0;2,0;;;;1,0;3,0;;2,0;4,0;;3,0;;;1,0;7,0;3,0;;;;;16,0;12,0;;3,0;2,0;;;1,0;;;;;3,0;;;2,0;;;3,0;2,0;2,0;4,0;1,0;;;;4,0;;;;;;;;;;;1,0;;16,0;;;;2,0;;;1,0;2,0;6,0;;;;1,0;3,0;;;;9,0;;1,0;3,0;11,0;;;4,0;14,0;4,0;5,0;;15,0;2,0;6,0;4,0;5,0;;;;2,0;;;5,0;;1,0;;;;;1,0;13,0;1,0;;;;2,0;2,0;;;1,0;;1,0;;;;;;;;1,0;;;;;;1,0;;;;;6,0;;;;;;;;;2,0;;;1,0;;;;;3,0;2,0;1,0;17,0;;;1,0;;;;;4,0;;;;17,0;2,0;;;5,0;3,0;;;;;2,0;3,0;1,0;1,0;;1,0;1,0;;;;;2,0;1,0;;;1,0;;3,0;;;73,0;4,0;;4,0;;;4,0;;;;;;2,0;9,0;;;;6,0;2,0;2,0;;;;;1,0;;;;;;3,0;;;4,0;;;;;;;;4,0;;;;2,0;;;;;;1,0;;1,0;;3,0;;;1,0;;;;;;;;;;1,0;;;;;;1,0;;;9,0;7,0;;;;3,0;;;;;;;;;7,0;;1,0;;1,0;;4,0;;1,0;33,0;4,0;;;;;;;;;10,0;9,0;;;;;;;;;26,0;11,0;1,0;;;;;;;;;;2,0;;;;;;;;;2,0;;;;;;;;;;;6,0;;;;;;;1,0;;;;;;2,0;;;;;;;;;3,0;;;;;;;;;;;;;;;;;;;;;;;;;;;;;1,0;;;;;5,0;;;4,0;3,0;5,0;6,0;;;;3,0;;;;;;;;;8,0;;;;;;;1,0;;;;1,0;2,0;2,0;;;3,0;;;;1,0;;;;;;6,0;;;;;1,0;;;;;;;;;;;;;3,0;2,0;;;;;;;;;;;;;;;;;;13,0;;;;;;;2,0;3,0;;;;;;;;6,0;;;;;;;;;1,0;;;;;;;;;;;;;;;;3,0;4,0;;;;;;;3,0;;;;;;;;2,0;;;1,0;;1,0;;;;;1,0;;;;;;;;5,0;1,0;;2,0;;;;;;;1,0;;;;;;1,0;;;;;;;;3,0;;;;;;;;;;;1,0;;;2,0;;;;;;;;;;;;;;;;;;;;;;23,0;;2,0;;1,0;;;7,0;;;13,0;4,0;;;;;;;;;;;;;2,0;;;;;;1,0;;1,0;;;;;;1,0;;1,0;;;2,0;;;;;;;;;;;;;;;;;;;5,0;;;;;;;2,0;;;;;;;;;;;;;;3,0;;;;;;;;;;;;;;;;;;;;;;;;;;;;;;;;;;;;;;;;4,0;;;;;;;;;;;;;;;;;;;;;;;;;;;;1,0;;7,0;;;;;;;;;;;;;;;;;;;;;;;;;;;
media;;;3,0;;7,0;;2,0;17,0;2,0;38,0;;2,0;;;11,0;3,0;;2,0;;29,0;1,0;16,0;;;;;;67,0;;14,0;5,0;11,0;54,0;5,0;38,0;;;3,0;;19,0;1,0;;3,0;1,0;;;;;11,0;;;4,0;;3,0;;132,0;55,0;;9,0;3,0;1,0;;32,0;1,0;;;;;;3,0;;;10,0;;;;;;8,0;;;5,0;16,0;;;;6,0;;1,0;19,0;23,0;;;3,0;5,0;4,0;;42,0;33,0;3,0;8,0;30,0;;1,0;34,0;;10,0;42,0;;;7,0;5,0;4,0;19,0;3,0;;;;;6,0;6,0;;;;;1,0;23,0;;;9,0;2,0;2,0;;;1,0;;4,0;;;;;;4,0;3,0;;2,0;4,0;2,0;1,0;1,0;;;4,0;;2,0;1,0;;9,0;;9,0;;;;;;;;5,0;27,0;4,0;;1,0;11,0;11,0;1,0;;4,0;1,0;;;;;2,0;;;3,0;;49,0;;10,0;;;;14,0;;;;;;;1,0;;;;;1,0;;2,0;2,0;3,0;;2,0;;;1,0;3,0;6,0;;;;;;;4,0;5,0;;;;;;1,0;;;;4,0;;;1,0;;;;;2,0;;;;;;;;1,0;2,0;;2,0;1,0;;1,0;16,0;;;;;3,0;;4,0;;4,0;12,0;;;;;;;5,0;2,0;2,0;;1,0;5,0;;;;22,0;;;;21,0;2,0;;;;1,0;5,0;;;;;1,0;;13,0;;4,0;;;;;;;;4,0;5,0;;;;12,0;;;;;;10,0;;1,0;;3,0;;;64,0;;3,0;1,0;1,0;;;;;;;;;15,0;1,0;;2,0;;1,0;7,0;;;;;;;;;;;;4,0;;2,0;15,0;;1,0;4,0;3,0;5,0;3,0;;1,0;;;1,0;8,0;14,0;;;;;;1,0;;6,0;;;2,0;;33,0;133,0;;;;;;11,0;;9,0;;;1,0;;1,0;2,0;;;;;;;5,0;;;;2,0;;;;2,0;;5,0;;;6,0;9,0;4,0;1,0;;;6,0;;;;;;;;;1,0;;;;10,0;;;5,0;;;;;;5,0;6,0;1,0;;8,0;;;27,0;;3,0;17,0;;;;1,0;4,0;;3,0;;;8,0;;11,0;4,0;;368,0;;;1,0;4,0;;1,0;3,0;;1,0;;3,0;;1,0;;;;1,0;16,0;3,0;;;1,0;3,0;6,0;;1,0;5,0;;;;;;10,0;3,0;;;16,0;5,0;6,0;;3,0;;2,0;;;2,0;;4,0;;1,0;;1,0;;;1,0;;33,0;14,0;;;;9,0;;;;;2,0;;;;;;8,0;;;;2,0;1,0;;2,0;;;;2,0;;26,0;;;;1,0;;;;60,0;2,0;7,0;;;;22,0;1,0;;;;;6,0;2,0;3,0;;4,0;;;;1,0;;;;1,0;;;;1,0;;;;;;;;;;;;1,0;;;;;;1,0;4,0;1,0;;;;;2,0;;;;;;;;;;;;;;;;3,0;;;;3,0;;3,0;3,0;;;;3,0;1,0;;;3,0;7,0;;;;;;;4,0;;;4,0;;3,0;;;;;;;;;;;;;;;;2,0;1,0;;;;;;;;;;;;;;2,0;;2,0;;;;;;;;;3,0;;8,0;;2,0;;;;1,0;2,0;;;;;;;;;1,0;;;;2,0;2,0;;;;;;1,0;;;;;;;;1,0;;;;;2,0;;3,0;;;;;1,0;7,0;;;;;;;;;;;2,0;;;;;2,0;2,0;1,0;1,0;;;;;;;;1,0;;;1,0;;;;;2,0;;;2,0;;;;;;;;1,0;;6,0;;;;;;;;;;1,0;;;1,0;;;;;;;;;;;;;;;1,0;2,0;;2,0;;;;;;;;;;;;;;2,0;;;;;;;;;;;;;;;;;;2,0;5,0;1,0;;2,0;13,0;;;;;;;;2,0;2,0;;;8,0;;;;1,0;;;;;2,0;;;;1,0;;;;;;;;;2,0;2,0;;;1,0;;;;;;;;2,0;;;;;;;;;;1,0;1,0;;;4,0;;;;;;;;;;;;1,0;;11,0;;;;19,0;2,0;;;;;;;;;;;;;;;;;;;5,0;;;;;;;;;;;;;6,0;3,0;;;5,0;;6,0;;;;;;;
medium;;;3,0;;54,0;;;37,0;17,0;40,0;;5,0;;;6,0;3,0;1,0;;10,0;465,0;4,0;87,0;13,0;;5,0;;;488,0;1,0;71,0;16,0;81,0;145,0;9,0;96,0;2,0;;8,0;1,0;157,0;9,0;1,0;1,0;8,0;2,0;;;2,0;13,0;2,0;4,0;37,0;2,0;4,0;;704,0;119,0;;5,0;19,0;;1,0;138,0;1,0;4,0;;21,0;;3,0;39,0;40,0;7,0;12,0;3,0;;3,0;;23,0;41,0;21,0;1,0;77,0;47,0;4,0;1,0;;7,0;;20,0;76,0;32,0;6,0;4,0;55,0;36,0;2,0;;774,0;339,0;2,0;23,0;51,0;;17,0;354,0;;3,0;138,0;;;10,0;2,0;1,0;;42,0;;;1,0;;5,0;;;5,0;5,0;;;31,0;;3,0;6,0;;17,0;;;3,0;16,0;6,0;;;1,0;;3,0;24,0;10,0;6,0;;14,0;27,0;2,0;;2,0;;4,0;;2,0;1,0;;2,0;4,0;70,0;;1,0;;;4,0;;13,0;38,0;85,0;3,0;5,0;1,0;17,0;3,0;5,0;;;27,0;;;;;3,0;4,0;1,0;1,0;;43,0;;42,0;2,0;;;37,0;1,0;1,0;22,0;;;;1,0;2,0;;6,0;;2,0;;;4,0;8,0;;67,0;;4,0;2,0;55,0;12,0;11,0;1,0;;;3,0;2,0;4,0;;;7,0;;;;2,0;;4,0;;5,0;2,0;;12,0;46,0;1,0;;2,0;2,0;1,0;;12,0;;;;;;1,0;;24,0;2,0;;;18,0;4,0;;8,0;;3,0;;3,0;;;;;4,0;;;;;39,0;7,0;;;16,0;1,0;3,0;;2,0;;;9,0;3,0;49,0;5,0;1,0;;;3,0;16,0;;;3,0;9,0;1,0;;16,0;;30,0;3,0;10,0;;;4,0;;;8,0;5,0;3,0;;;;;;;;;16,0;;1,0;;6,0;;;15,0;1,0;67,0;;;1,0;1,0;2,0;;;;1,0;;8,0;8,0;1,0;5,0;7,0;8,0;7,0;1,0;4,0;1,0;11,0;9,0;;;1,0;;;;;4,0;;1,0;;14,0;15,0;;2,0;2,0;2,0;31,0;;1,0;5,0;;39,0;1,0;4,0;;1,0;20,0;6,0;24,0;260,0;;3,0;;2,0;353,0;1300,0;1,0;14,0;1,0;;;27,0;8,0;14,0;12,0;1,0;8,0;;2,0;;4,0;;5,0;5,0;1,0;1,0;2,0;5,0;2,0;;3,0;11,0;7,0;1,0;18,0;1,0;4,0;7,0;11,0;3,0;55,0;1,0;9,0;51,0;4,0;3,0;14,0;;2,0;1,0;2,0;1,0;;1,0;5,0;3,0;;8,0;2,0;;;12,0;14,0;3,0;3,0;;;84,0;5,0;2,0;;27,0;13,0;17,0;228,0;;5,0;7,0;;1,0;;4,0;;1,0;27,0;1,0;;47,0;1,0;3,0;1,0;3,0;68,0;24,0;1,0;;5,0;;1,0;3,0;;5,0;3,0;10,0;1,0;19,0;7,0;32,0;3,0;1,0;77,0;9,0;1,0;13,0;3,0;36,0;13,0;3,0;1,0;;;17,0;6,0;;;;1,0;;1,0;34,0;33,0;8,0;;;1,0;;8,0;;1,0;;7,0;2,0;6,0;1,0;;;2,0;1,0;6,0;6,0;76,0;3,0;;;;9,0;;;11,0;;;;2,0;45,0;10,0;;1,0;8,0;1,0;3,0;8,0;;10,0;4,0;1,0;23,0;24,0;;5,0;;;1,0;3,0;5,0;5,0;1,0;;7,0;6,0;2,0;;;10,0;17,0;;1,0;;6,0;45,0;;;13,0;;6,0;;17,0;2,0;;;2,0;;3,0;;;4,0;1,0;2,0;;4,0;;;;;1,0;;;;12,0;;;;1,0;;10,0;6,0;1,0;;;1,0;1,0;;;;;12,0;;;2,0;;3,0;5,0;;;1,0;;;;1,0;;;;18,0;;1,0;1,0;1,0;5,0;2,0;;;;5,0;;;14,0;;2,0;;;2,0;1,0;3,0;;;;;;;;;1,0;1,0;;3,0;;1,0;;;3,0;1,0;6,0;;;3,0;;;;2,0;1,0;;1,0;;;1,0;;;1,0;;;1,0;1,0;1,0;;13,0;1,0;24,0;;15,0;;6,0;;;;;9,0;;3,0;;;1,0;;1,0;1,0;2,0;;;;;3,0;2,0;;2,0;1,0;;8,0;;5,0;;;;3,0;;;1,0;1,0;;;1,0;;;5,0;3,0;;2,0;;1,0;1,0;2,0;9,0;4,0;2,0;;;;6,0;;2,0;;1,0;4,0;3,0;5,0;;3,0;;1,0;4,0;;;2,0;;2,0;2,0;11,0;;;;;;6,0;6,0;;11,0;;;;13,0;4,0;7,0;;;1,0;;3,0;7,0;6,0;;;;;;;;;;;;;3,0;48,0;;;;;2,0;;3,0;1,0;3,0;;;;26,0;;1,0;;;1,0;;3,0;2,0;;;;;;;2,0;6,0;2,0;;2,0;3,0;1,0;;;;;;;;;;;16,0;;;;6,0;;;2,0;;;;;;;;;;;;24,0;2,0;;;;1,0;;3,0;2,0;3,0;;;;46,0;;;;;;;;;;2,0;;;1,0;1,0;1,0;;;;;2,0;2,0;;;;2,0;6,0;;;;;1,0;;;;38,0;;;;;;;;1,0;;;1,0;;;;;;;6,0;;;;;;;;;2,0;;;;;;;;1,0;;;;;;1,0;;2,0;;11,0;2,0;;;;;;10,0;;;6,0;;;;;;;;;
metadata;;;4,0;;9,0;;;10,0;;10,0;;1,0;;;;;;;;1,0;18,0;24,0;;;;;;58,0;;1,0;3,0;7,0;12,0;;31,0;;;;;17,0;;;;10,0;;;;;1,0;;;18,0;20,0;;;62,0;98,0;;;;;;16,0;;;;8,0;;;;4,0;;;;;;;;;;;15,0;9,0;1,0;;;;;2,0;1,0;8,0;;5,0;18,0;;;;1,0;1,0;;;4,0;;;;;1,0;34,0;;;;;;;2,0;;;;1,0;;;;;;;;2,0;;;1,0;;13,0;;;;;;;;;1,0;;5,0;7,0;;;3,0;17,0;;;;;;;;;;;;;;;;;;;1,0;4,0;;;;;1,0;;;;;5,0;;;;;;;;;;25,0;;;;;;26,0;;;;;;;;;;1,0;;;;;;;;;;;;1,0;20,0;;;;;;;;;;;;;;;;;;;;;9,0;1,0;;;;;;;;;;;;;;;1,0;1,0;;;2,0;;;;;;;;;;;;;;;;;;;;;;;;;;;;;;8,0;;;;;;;;;;;;;;;1,0;;;;;;;;;;;;;;;;;;;;;;;;;;;;;;;;;;;;;;;30,0;2,0;;;1,0;;;;;;;1,0;;;;6,0;;;;;;;;;2,0;;;;1,0;16,0;;;10,0;6,0;;1,0;;;;;;;;;;;;;21,0;;4,0;;;;;;;16,0;;;;1,0;;;;;1,0;;;;;;;;;;;;;;;;;;;;1,0;;2,0;1,0;;;;;;;1,0;2,0;;;;;;;;1,0;;;;;4,0;4,0;;;102,0;;;5,0;;11,0;;;;;;;;4,0;;;9,0;;;;;;;4,0;;;;;;;;;;;1,0;;;;;7,0;;;;;;;;;12,0;;;;;;;;;;;;;;6,0;3,0;;;;;;;;;;;;3,0;;;1,0;107,0;;;;;;;;;;;;;;;;;5,0;;1,0;6,0;;;9,0;;23,0;;;;;;;;;;1,0;;1,0;3,0;;;;;;;;;2,0;;;27,0;;;;;37,0;2,0;;;;;;;;;;;;;;;;;;;;;;;;;;;;;;;;;;;;;;5,0;;;;;;;;;;;;;;;;;;;;;;4,0;1,0;;;;;;;;;2,0;;;;;;;;;;;;;;;;;;;;;;;5,0;;;;;;;;;10,0;;;;;;;;;;;;;;;;;11,0;;4,0;;;;;;;;;;;;;;;3,0;;;;;;5,0;;;;;;;;;;;;;;;;;;;;3,0;;;;;;;;;;;;;;;;;;5,0;;;;;;;;;;;;;;;;;;;;9,0;;;;;;;;3,0;;;;;;;;;;;;;;;2,0;;;;16,0;;;;;;;;;;;;;;;;;;;;;;;;;;1,0;;;;;;;;;;2,0;;;3,0;;;;;;;;;3,0;;;;;;;;;;;;;;;;;;;;;;;;;;;6,0;;;;;1,0;;;;;;;;;;;;4,0;;;;;;;;;;;;;;;;;;;;;1,0;;;;;;;;;;;;;2,0;;;;;;4,0;;;;;;;;;;;;;;;;;;;;;;;;;;;;;;;1,0;;;;;;;;;;;;;;;;;;;
microlens;;;8,0;;1,0;;;;;;9,0;1,0;;;8,0;;;;;;;;;;;;;;;;8,0;;8,0;;;;2,0;;;;1,0;;;27,0;;;;1,0;4,0;;;3,0;;;;21,0;28,0;;;26,0;;;1,0;;;;;;;;8,0;;;;;;;;5,0;;;;;;;2,0;;;;;26,0;3,0;;8,0;4,0;;;;;1,0;3,0;;;;;;;7,0;2,0;;;3,0;4,0;;;;;;;;;;;;;;3,0;;;;4,0;;;;;1,0;12,0;;;;;;;;19,0;;50,0;;;;;;;;;;;;;2,0;4,0;;;;;35,0;;16,0;;2,0;;;;;;;;2,0;;;;;;;;;;17,0;;12,0;;;;3,0;;;3,0;;;;2,0;;;2,0;;;;;;;;4,0;1,0;;;;;17,0;;;2,0;;;;;4,0;;;;;;;;;;;;;19,0;;;;;7,0;;;;;;2,0;;;;;2,0;5,0;;;;;;;;;;;;;;1,0;;;;;;;;;;2,0;;;;;;;;;;;;;;8,0;;;17,0;;;;;;;;;;;3,0;;;;23,0;;;;;;;;;;;;;;;;;;;;;;;;;;;;;;;;;;;;;;;;;;;;;;;;1,0;;;;1,0;;;;;;;;2,0;;;;;;;;;;7,0;;;;;;;;;;;;;;;;;;;;;;;;;;;;;;;;;;;;;;;;;;;;;;;;;;;;;;;;;;;;;;;;;5,0;;;;;;;;;;;;;;;;;;;;;;;;;1,0;;;;;;;;;;;;;;;;;;;;;;;;;;;;;;;;;;;;;;;;;;;;;;;;;;;;;;;;;;;;;4,0;;;;;;;;;;;;2,0;;;;;;;;;;;;;;;;12,0;;;;;;;;;;;;;;;;;;;;;;;;;;;;;;;;;;;;;;;;;;;;;;;;;;;;;;;;;;;;;;;5,0;;;;;;;;;;;;;;;;;;;;;5,0;;;;;;;17,0;;;;;;;11,0;;;;;;;;;;;;;;;3,0;;;;;;;;;;;;;;;;;;;;;;;;;;;;;;;;;8,0;;;;;;;;;;;;;;;;;;;;;;;;;;;;;;;;;;;;;;;;;;;;;;;;;;;;;;;;;;;;;10,0;4,0;;;;;;;;;;;;;;;;;;;;;;;;;;;;;;;;;;;;;;;;;;;;;;;;;;;;;;;;;;;;1,0;;;;;;;;;;;;;;;;;;;;;;;;;;;;;;;;;;;;;;;;;;;;;;;;;;;;;;;;;;;;;;;;;;;;;;;;;;;;;;;;;;;;;;;;;;;9,0;;;;;;;;;;;;;;;;;;;;;;;;;;;;;;;6,0;;;;;;;;;;;;;;;;;;;;;;;;;;;;;;;;;;;;;;;;;;;;;1,0;;;;
microphone;;;2,0;;31,0;;;16,0;;33,0;2,0;;;;;;;;9,0;2,0;1,0;16,0;4,0;;;1,0;;38,0;;20,0;1,0;3,0;33,0;4,0;7,0;1,0;2,0;13,0;;17,0;;;3,0;1,0;;;;5,0;5,0;6,0;1,0;10,0;;;;12,0;40,0;;1,0;5,0;;;11,0;;;7,0;3,0;;;;8,0;2,0;;1,0;;;;5,0;28,0;9,0;1,0;10,0;9,0;1,0;;;;;;4,0;35,0;;1,0;28,0;;7,0;;2,0;;;13,0;26,0;;;;;;18,0;;;;9,0;74,0;1,0;1,0;;;;4,0;10,0;;;;6,0;;11,0;18,0;;;33,0;7,0;2,0;;;1,0;5,0;4,0;;;4,0;6,0;;6,0;13,0;;;9,0;5,0;;;;;;;;6,0;7,0;9,0;;6,0;;;2,0;;;;2,0;2,0;;;8,0;;10,0;3,0;;1,0;2,0;6,0;;;4,0;;;;;5,0;;39,0;;24,0;;;;21,0;;;;;;1,0;;;;7,0;;1,0;;2,0;;18,0;;3,0;;1,0;3,0;4,0;10,0;;;;;;;;;;;;;;;;;6,0;4,0;;;;;;;;;;3,0;1,0;3,0;;;;;;;8,0;;;;;;;;1,0;;;;;;;;1,0;;8,0;;;;1,0;;;1,0;4,0;;;;;;1,0;;4,0;3,0;4,0;;;;;;2,0;;2,0;5,0;;2,0;;;;;;;1,0;;;;;;;;;;;;;;2,0;;;;1,0;;;2,0;;3,0;;;;;;;;;;2,0;2,0;;;;;;2,0;;1,0;1,0;2,0;3,0;;;;;;;;;;;;;;;;1,0;;;;;1,0;;;3,0;1,0;;3,0;;;;1,0;7,0;;;;;37,0;;4,0;;1,0;;1,0;;4,0;;;2,0;;;;;;3,0;2,0;;2,0;;4,0;;;;4,0;1,0;;15,0;;11,0;;;5,0;;;6,0;1,0;;;;;33,0;;2,0;;;;78,0;;1,0;;;;;7,0;;5,0;;2,0;;1,0;;;2,0;;;;8,0;;;;;;;5,0;1,0;;;1,0;;1,0;2,0;;;;;2,0;3,0;5,0;;;;;;;3,0;1,0;;3,0;62,0;21,0;;;69,0;2,0;;;;;;;;;;;;;;2,0;;;;;6,0;1,0;2,0;;1,0;;;;;;;;1,0;;;1,0;;;2,0;;;;;;;;;;2,0;3,0;;;;;;;;;;;5,0;;14,0;4,0;;1,0;2,0;;;;;;1,0;;;;;2,0;;;;;;;;18,0;;;8,0;;;2,0;;;;;13,0;;;;;;;;;1,0;;1,0;;;;;;;;;;;;;;;10,0;;;;;;1,0;;5,0;;;;;;;;2,0;;;;;;;;;;;;;;;1,0;;;2,0;;;;;1,0;;;;;2,0;;;;;;;;;;;;;;;;;;;;1,0;;;;1,0;;;;;;;;;;;;;3,0;;;;2,0;;;;1,0;;;;;;;;;;;;;;;;;;;;;;;;;;;;;;;;;;1,0;;;;1,0;;;;;;;;;;;;;;;;1,0;;;2,0;;;;;;;;;;2,0;;3,0;24,0;;;;;;;;;;;;;;;;;;;3,0;;;;;;;;;;;;;;;;;;;;;;;;;;;;1,0;;;;;;;;;;;2,0;;;;;5,0;;;;1,0;2,0;12,0;;;;;;;;;;;;;;;;;;;;;;1,0;;43,0;;;;;;;1,0;;;;;;;;;;;;;;2,0;;2,0;;1,0;1,0;;;;;;;;;;;;;;;;;;;1,0;;;;;;;;;;;;;;;;;1,0;;;;;;;;;;;;;;;;;;;;;;;9,0;;;;;;;;;;;;;;;;;;;;;;;16,0;;;;;;;;;;;;1,0;;;;;;;;;;;
mobile;;;2,0;;67,0;;33,0;35,0;38,0;60,0;3,0;3,0;;2,0;5,0;1,0;2,0;;2,0;20,0;4,0;97,0;24,0;9,0;4,0;;;53,0;8,0;27,0;15,0;17,0;779,0;;60,0;;6,0;27,0;;120,0;33,0;;3,0;17,0;;2,0;;6,0;4,0;9,0;29,0;14,0;;19,0;1,0;171,0;69,0;;2,0;111,0;1,0;;140,0;2,0;2,0;3,0;36,0;;;57,0;51,0;2,0;5,0;;1,0;1,0;;15,0;128,0;24,0;;20,0;31,0;4,0;;;2,0;;2,0;33,0;36,0;;;56,0;2,0;;;11,0;18,0;3,0;24,0;146,0;;7,0;2,0;;8,0;53,0;;;3,0;;4,0;8,0;2,0;1,0;;1,0;2,0;65,0;;30,0;6,0;2,0;;;16,0;6,0;;29,0;6,0;3,0;;2,0;5,0;22,0;10,0;;1,0;2,0;;;18,0;5,0;6,0;6,0;19,0;2,0;7,0;;;5,0;13,0;;;8,0;4,0;19,0;1,0;32,0;;;1,0;2,0;;;23,0;25,0;2,0;;16,0;2,0;164,0;14,0;15,0;23,0;5,0;10,0;;;;;4,0;;;8,0;;30,0;1,0;15,0;;8,0;;50,0;;;;;18,0;;2,0;2,0;;31,0;;2,0;;1,0;2,0;20,0;;;;20,0;;10,0;33,0;;;;;4,0;4,0;;3,0;2,0;;;2,0;;;;3,0;1,0;7,0;24,0;;1,0;9,0;1,0;22,0;;5,0;1,0;3,0;3,0;4,0;;;1,0;1,0;;;20,0;;2,0;1,0;13,0;;;4,0;21,0;3,0;3,0;1,0;;4,0;1,0;;;;6,0;1,0;;1,0;15,0;;;8,0;3,0;;1,0;;2,0;;9,0;20,0;123,0;14,0;;;;;1,0;1,0;11,0;;39,0;;;20,0;;28,0;;2,0;4,0;8,0;8,0;1,0;6,0;7,0;2,0;1,0;;11,0;;3,0;;;;;11,0;1,0;;;5,0;;1,0;15,0;35,0;83,0;;2,0;;1,0;2,0;1,0;;1,0;2,0;;20,0;;3,0;1,0;;;2,0;;9,0;31,0;17,0;4,0;;;1,0;5,0;;;12,0;1,0;;2,0;1,0;14,0;4,0;1,0;5,0;4,0;;6,0;;;10,0;3,0;13,0;6,0;;;6,0;;;1,0;7,0;;1,0;1,0;;2,0;3,0;;15,0;;;4,0;2,0;10,0;2,0;2,0;;28,0;;5,0;;2,0;;10,0;24,0;13,0;3,0;2,0;13,0;;2,0;15,0;3,0;19,0;1,0;18,0;;45,0;5,0;;;57,0;240,0;1,0;5,0;2,0;13,0;1,0;;6,0;;;;;;;36,0;;;1,0;1,0;14,0;10,0;;5,0;4,0;2,0;1,0;7,0;13,0;10,0;1,0;;5,0;8,0;9,0;2,0;14,0;10,0;8,0;5,0;5,0;5,0;1,0;3,0;5,0;;;27,0;22,0;2,0;2,0;;8,0;48,0;12,0;13,0;1,0;8,0;15,0;1,0;;16,0;6,0;12,0;;6,0;2,0;26,0;6,0;21,0;45,0;20,0;;26,0;3,0;;2,0;1,0;;1,0;3,0;1,0;;;;3,0;;;;11,0;319,0;9,0;4,0;1,0;2,0;;;;1,0;4,0;;;30,0;;12,0;8,0;76,0;;5,0;4,0;;2,0;;1,0;41,0;6,0;;;1,0;2,0;;2,0;7,0;2,0;;;1,0;6,0;;1,0;46,0;;1,0;6,0;;3,0;8,0;1,0;4,0;;;;2,0;;;4,0;;12,0;33,0;13,0;;;3,0;4,0;;12,0;;2,0;1,0;;;508,0;;;;3,0;58,0;4,0;;2,0;2,0;3,0;;;5,0;;1,0;;4,0;;;;;;;;;;;;1,0;1,0;36,0;9,0;;;;;;11,0;2,0;;1,0;;6,0;;;2,0;2,0;1,0;;;3,0;;;2,0;;;3,0;4,0;;8,0;;;;;;;;3,0;;;;1,0;1,0;1,0;7,0;;3,0;;;2,0;1,0;;;;;3,0;;1,0;;;1,0;;;;;;;;1,0;;;6,0;;;3,0;3,0;1,0;;1,0;;;1,0;4,0;;4,0;3,0;;;1,0;;;;1,0;10,0;;2,0;;2,0;;2,0;;1,0;3,0;;;;;10,0;;;3,0;;;1,0;10,0;;2,0;;;1,0;;2,0;4,0;;9,0;2,0;;;;;2,0;;2,0;;;1,0;;4,0;;;;;;3,0;;5,0;;7,0;4,0;;;;1,0;;2,0;;;;;9,0;1,0;;;3,0;;1,0;;;;;14,0;;;2,0;;;;2,0;11,0;;;1,0;;2,0;8,0;11,0;;;1,0;;;6,0;1,0;1,0;;;;10,0;;;2,0;3,0;;;;;6,0;1,0;;;;;1,0;;2,0;;4,0;;;;;;;;1,0;;3,0;2,0;;;;;1,0;;1,0;;1,0;3,0;;;;;1,0;;;;;1,0;;1,0;1,0;;;2,0;1,0;;2,0;;4,0;1,0;3,0;;;;;;;10,0;;;;;;2,0;;5,0;;;5,0;;;;1,0;;3,0;;;;;1,0;;;;;;;2,0;;;;;;;;1,0;1,0;;;;;;;;;5,0;;;;1,0;;8,0;;;2,0;;;;;;4,0;14,0;;3,0;1,0;;;;1,0;;1,0;;;;;;;;;;;;;;;;;;;;;123,0;;;;;;;;;;;1,0;;;;;;;27,0;1,0;;;;
modulation;;;1,0;;1,0;;;1,0;;;;1,0;;;;;;;;1,0;;3,0;;;;;10,0;1,0;1,0;;;;2,0;;;;;;;;1,0;;;1,0;;;;;2,0;7,0;28,0;3,0;;2,0;;7,0;2,0;;;4,0;;;8,0;;;;;;;;2,0;;;;;;;;;;;;4,0;;;;;;;;7,0;;;20,0;;;;;;;;2,0;;19,0;;;;;;;;;;3,0;;;;;;;;;;;;;;;1,0;;;;;;;;;;;;;;;;1,0;;3,0;;1,0;;;;;;;;;;1,0;;;1,0;;;;;;8,0;;;;;2,0;;1,0;;;4,0;;;;;;;;;;;;;;;1,0;4,0;;;;;;;;;;;;;;;;;1,0;1,0;;;;;4,0;;;;;;;;;;;;;;;;1,0;;1,0;3,0;;;;;;;;;;;1,0;;;;;;6,0;;;;;;;;;;;;;;;;;;;;;;;;;;;;;;;;;;;;;;;;;3,0;;;;;;;;;;;;;;;;;;;;;;;;;;;;1,0;;;;1,0;;;;;;2,0;;;;;;;;;;;;;;;;;;1,0;;;;;;;;;;;;;;;;;;;;;;;;7,0;;;;;;;;;;;17,0;;;;;;;;;;;2,0;;;7,0;;1,0;;;;;;;;;;;;;;;;;;;;;;;;;;;;1,0;;;;;;;;;;;;;;;;;;;1,0;;1,0;;1,0;;3,0;;;;;;;;;;;;;;;;;;;;;;;;1,0;;;;;;1,0;;;;;;;;1,0;;;;3,0;;3,0;;;;;;;;;;;;;;;;1,0;1,0;;;;;;;;;;;;;;1,0;;;;;;;;;;;;;;;;;;;;;;;;;;;;;;;;;;;;;;;;;;;;;;;;;;;;;;;;;;;;;;;;;;1,0;9,0;;;;;;2,0;;;;;;;;;;;;;;;;;;;4,0;;1,0;;;;;;;;;;;;;;;;;;;;;;;;;;;;;;;;;;;;;;;;;;;;;;;;;;;;;;;;;;;;;;;2,0;;;;;;;;;;;;;1,0;;;;;;;;;;;;;;;;;;4,0;;;;;;;;;;;;;;;;;;;;;;;;5,0;;;;;;;1,0;;;;;;;;;;;17,0;;;;;;;;;1,0;;;;;;;;;;;;;;;;;;;;;;;;;;;;;;;;;;;;;;;;;;;;;;;;;;;;;;;2,0;;;;;;;;;;;;;;;;;;;;;;;;;4,0;;;;;;;;;;;;;;;;;;;;;;;;;;;;;;;;;;;;;;;;;;;;;;;;;;;;;;;;;;;;;;;;;;;;;;;;;3,0;;;;;;;;;;;;;;;;;;;;;;;;;;;;;;;;;;;;;;;;;;;;;;;;;;;;;;;;;;;;;;;;;;;;;;;;;;;;;;;
module;;;9,0;46,0;169,0;3,0;96,0;284,0;51,0;315,0;26,0;6,0;7,0;6,0;45,0;16,0;5,0;20,0;100,0;46,0;11,0;332,0;14,0;8,0;35,0;1,0;6,0;280,0;23,0;115,0;101,0;87,0;530,0;8,0;581,0;6,0;35,0;117,0;13,0;169,0;79,0;4,0;28,0;180,0;6,0;6,0;4,0;49,0;127,0;7,0;89,0;110,0;5,0;33,0;35,0;1445,0;966,0;10,0;54,0;2211,0;15,0;10,0;347,0;3,0;1,0;40,0;39,0;21,0;4,0;62,0;350,0;4,0;39,0;13,0;23,0;1,0;12,0;64,0;255,0;112,0;12,0;221,0;80,0;18,0;2,0;5,0;63,0;1,0;4,0;72,0;613,0;4,0;26,0;197,0;58,0;64,0;1,0;42,0;46,0;213,0;469,0;370,0;6,0;65,0;;13,0;64,0;343,0;2,0;4,0;56,0;53,0;45,0;173,0;77,0;8,0;5,0;2,0;183,0;259,0;43,0;3,0;8,0;206,0;9,0;17,0;327,0;118,0;;248,0;125,0;7,0;28,0;16,0;128,0;76,0;179,0;;25,0;18,0;7,0;13,0;32,0;82,0;78,0;22,0;255,0;177,0;;30,0;1,0;58,0;65,0;24,0;81,0;302,0;102,0;391,0;82,0;199,0;6,0;15,0;79,0;37,0;;73,0;15,0;268,0;8,0;86,0;240,0;10,0;;338,0;83,0;123,0;62,0;89,0;124,0;;27,0;9,0;38,0;47,0;7,0;57,0;77,0;267,0;3,0;416,0;7,0;57,0;9,0;348,0;19,0;4,0;8,0;19,0;33,0;31,0;60,0;69,0;41,0;210,0;80,0;10,0;1,0;13,0;66,0;162,0;122,0;23,0;6,0;7,0;21,0;44,0;86,0;63,0;;14,0;29,0;19,0;12,0;16,0;156,0;20,0;48,0;;1,0;8,0;19,0;;61,0;32,0;62,0;43,0;30,0;42,0;87,0;29,0;339,0;16,0;29,0;50,0;8,0;25,0;71,0;134,0;2,0;45,0;2,0;23,0;67,0;301,0;12,0;1,0;64,0;146,0;3,0;28,0;5,0;61,0;25,0;64,0;34,0;27,0;80,0;1,0;13,0;14,0;31,0;56,0;23,0;4,0;51,0;227,0;3,0;5,0;11,0;50,0;30,0;57,0;52,0;159,0;30,0;29,0;51,0;76,0;51,0;36,0;17,0;4,0;9,0;23,0;8,0;15,0;;52,0;3,0;11,0;63,0;27,0;40,0;15,0;9,0;14,0;10,0;34,0;12,0;57,0;13,0;42,0;3,0;2,0;62,0;8,0;9,0;4,0;16,0;6,0;27,0;96,0;30,0;49,0;14,0;51,0;18,0;27,0;43,0;1,0;87,0;5,0;3,0;;;;1,0;7,0;5,0;7,0;13,0;38,0;1,0;2,0;8,0;6,0;15,0;28,0;15,0;17,0;14,0;11,0;37,0;1,0;1,0;7,0;11,0;;;11,0;6,0;7,0;4,0;4,0;21,0;9,0;4,0;3,0;24,0;3,0;2,0;5,0;;43,0;17,0;57,0;12,0;5,0;;28,0;1,0;34,0;9,0;60,0;2,0;2,0;6,0;8,0;;26,0;7,0;16,0;4,0;12,0;120,0;2,0;3,0;51,0;5,0;7,0;29,0;13,0;18,0;3,0;4,0;;4,0;30,0;2,0;41,0;26,0;22,0;25,0;20,0;13,0;13,0;69,0;4,0;87,0;16,0;17,0;8,0;1,0;164,0;57,0;18,0;16,0;5,0;4,0;10,0;21,0;1,0;;15,0;2,0;;1,0;8,0;25,0;54,0;6,0;11,0;1,0;18,0;10,0;45,0;19,0;19,0;3,0;10,0;1,0;12,0;40,0;87,0;1,0;1,0;27,0;1,0;10,0;;;5,0;;10,0;10,0;19,0;37,0;9,0;33,0;;2,0;45,0;4,0;;3,0;2,0;135,0;7,0;10,0;8,0;15,0;;1,0;6,0;2,0;76,0;17,0;35,0;2,0;28,0;3,0;94,0;16,0;40,0;106,0;49,0;2,0;10,0;4,0;;2,0;6,0;3,0;3,0;47,0;12,0;1,0;27,0;1,0;53,0;48,0;;;40,0;326,0;74,0;114,0;1,0;1,0;;9,0;30,0;9,0;6,0;;;27,0;4,0;7,0;4,0;32,0;2,0;15,0;6,0;2,0;;6,0;2,0;18,0;2,0;;28,0;1,0;49,0;6,0;16,0;15,0;2,0;6,0;2,0;5,0;11,0;38,0;5,0;34,0;14,0;23,0;11,0;17,0;7,0;68,0;1,0;93,0;;18,0;3,0;41,0;;3,0;2,0;;7,0;5,0;2,0;39,0;;22,0;11,0;22,0;2,0;1,0;1,0;11,0;2,0;;149,0;25,0;;;4,0;30,0;85,0;;;1,0;2,0;55,0;9,0;12,0;10,0;18,0;3,0;17,0;13,0;13,0;26,0;;6,0;;6,0;3,0;18,0;3,0;2,0;;;10,0;;37,0;;2,0;1,0;9,0;31,0;12,0;1,0;5,0;;30,0;;;55,0;4,0;5,0;4,0;7,0;102,0;60,0;26,0;109,0;3,0;2,0;27,0;36,0;1,0;2,0;12,0;;3,0;19,0;17,0;21,0;3,0;5,0;22,0;50,0;2,0;13,0;3,0;9,0;87,0;;7,0;2,0;22,0;10,0;9,0;12,0;92,0;4,0;;;10,0;13,0;5,0;7,0;34,0;3,0;;1,0;;;2,0;20,0;55,0;2,0;1,0;;;;;17,0;5,0;;3,0;;1,0;17,0;10,0;;5,0;5,0;;;3,0;18,0;7,0;;;67,0;;4,0;;15,0;;12,0;1,0;8,0;18,0;21,0;38,0;1,0;7,0;4,0;3,0;2,0;2,0;;4,0;3,0;26,0;17,0;19,0;11,0;;1,0;2,0;;9,0;21,0;5,0;5,0;2,0;1,0;;2,0;12,0;15,0;30,0;;3,0;38,0;2,0;11,0;;15,0;10,0;1,0;15,0;8,0;5,0;13,0;14,0;26,0;45,0;8,0;5,0;7,0;1,0;;44,0;7,0;4,0;4,0;2,0;8,0;7,0;1,0;9,0;16,0;9,0;1,0;17,0;;;53,0;3,0;15,0;;9,0;1,0;;5,0;1,0;48,0;;6,0;11,0;;3,0;;1,0;;6,0;3,0;5,0;5,0;4,0;8,0;4,0;6,0;;1,0;9,0;7,0;7,0;10,0;;3,0;38,0;;;19,0;27,0;;6,0;12,0;10,0;8,0;;2,0;10,0;14,0;6,0;8,0;;9,0;51,0;19,0;;;;15,0;9,0;13,0;1,0;;1,0;;20,0;2,0;2,0;7,0;;;3,0;10,0;5,0;18,0;8,0;14,0;10,0;1,0;22,0;11,0;;3,0;9,0;;6,0;106,0;77,0;6,0;;9,0;21,0;2,0;2,0;1,0;2,0;;;1,0;41,0;9,0;3,0;1,0;18,0;2,0;6,0;;3,0;4,0;3,0;5,0;;10,0;;1,0;9,0;17,0;10,0;1,0;1,0;1,0;;10,0;2,0;41,0;10,0;12,0;3,0;;;9,0;4,0;3,0;12,0;;;4,0;7,0;2,0;4,0;13,0;11,0;;8,0;3,0;;;1,0;16,0;1,0;14,0;6,0;64,0;1,0;;;;;2,0;;;;2,0;5,0;5,0;1,0;6,0;7,0;15,0;23,0;;12,0;3,0;;11,0;;;2,0;9,0;1,0;;;13,0;;;;;17,0;1,0;;2,0;4,0;8,0;;10,0;3,0;3,0;7,0;;3,0;;6,0;12,0;9,0;3,0;;1,0;;1,0;;7,0;24,0;;;;
monitor;;;13,0;4,0;157,0;;26,0;52,0;5,0;105,0;17,0;;;;9,0;2,0;3,0;;8,0;23,0;14,0;102,0;18,0;7,0;10,0;;;67,0;5,0;79,0;39,0;36,0;194,0;2,0;64,0;;;18,0;2,0;388,0;12,0;11,0;2,0;13,0;;12,0;;;17,0;1,0;16,0;44,0;4,0;10,0;5,0;547,0;131,0;2,0;7,0;51,0;;10,0;186,0;;3,0;6,0;34,0;;9,0;21,0;28,0;3,0;13,0;1,0;2,0;12,0;;18,0;94,0;14,0;1,0;41,0;13,0;2,0;3,0;;108,0;3,0;6,0;26,0;44,0;;8,0;127,0;20,0;18,0;4,0;12,0;23,0;2,0;17,0;329,0;;2,0;1,0;4,0;14,0;140,0;;;2,0;11,0;12,0;14,0;15,0;4,0;;;7,0;25,0;;;3,0;19,0;;;46,0;1,0;;9,0;47,0;1,0;34,0;;1,0;2,0;17,0;;1,0;5,0;2,0;13,0;9,0;7,0;;2,0;7,0;41,0;3,0;1,0;;;4,0;1,0;2,0;;6,0;13,0;8,0;53,0;;1,0;;2,0;7,0;3,0;5,0;25,0;;2,0;23,0;2,0;19,0;14,0;23,0;24,0;6,0;31,0;;;7,0;;;2,0;1,0;6,0;6,0;121,0;;38,0;;;2,0;67,0;4,0;;;;10,0;1,0;;6,0;37,0;49,0;;;;3,0;4,0;17,0;3,0;;;;8,0;18,0;36,0;1,0;;2,0;9,0;30,0;1,0;;1,0;;;;2,0;;1,0;;;18,0;24,0;27,0;;5,0;256,0;1,0;1,0;2,0;10,0;3,0;3,0;6,0;2,0;3,0;;;;3,0;;56,0;;4,0;;16,0;8,0;;9,0;;2,0;;2,0;;2,0;4,0;;4,0;3,0;9,0;3,0;21,0;1,0;47,0;5,0;;10,0;20,0;1,0;5,0;;6,0;1,0;35,0;4,0;73,0;15,0;1,0;;;2,0;;;2,0;;31,0;;;;;21,0;3,0;;1,0;;15,0;14,0;;9,0;1,0;;;11,0;;4,0;;1,0;1,0;;1,0;;2,0;;16,0;;;2,0;;33,0;1,0;;;;10,0;;;;3,0;;21,0;4,0;3,0;;1,0;;7,0;1,0;34,0;21,0;8,0;7,0;;1,0;2,0;3,0;;24,0;3,0;1,0;2,0;;1,0;10,0;7,0;4,0;6,0;3,0;5,0;1,0;;;18,0;4,0;23,0;10,0;;;1,0;5,0;10,0;2,0;13,0;;3,0;6,0;6,0;3,0;23,0;2,0;12,0;1,0;6,0;3,0;2,0;3,0;13,0;19,0;8,0;18,0;2,0;;1,0;3,0;;;7,0;;7,0;;12,0;;;4,0;31,0;5,0;;17,0;2,0;51,0;1,0;10,0;5,0;72,0;5,0;2,0;3,0;17,0;17,0;1,0;;;;1,0;;4,0;5,0;5,0;;4,0;1,0;;;6,0;41,0;2,0;2,0;2,0;21,0;11,0;4,0;37,0;2,0;4,0;1,0;;;4,0;1,0;1,0;2,0;6,0;1,0;5,0;;2,0;8,0;36,0;;;61,0;3,0;;4,0;;11,0;;1,0;1,0;;4,0;;7,0;2,0;16,0;32,0;16,0;7,0;14,0;31,0;26,0;5,0;5,0;288,0;49,0;15,0;23,0;;1,0;2,0;;2,0;8,0;8,0;;;2,0;9,0;1,0;;;;3,0;31,0;1,0;10,0;;1,0;3,0;;;8,0;;;;1,0;;1,0;2,0;15,0;;2,0;5,0;3,0;;;22,0;;;;8,0;;7,0;1,0;;;4,0;;2,0;;1,0;2,0;;33,0;;23,0;;1,0;12,0;16,0;;1,0;38,0;1,0;4,0;14,0;;;;2,0;25,0;3,0;3,0;;;4,0;3,0;;30,0;;1,0;91,0;;6,0;55,0;2,0;;;17,0;30,0;;1,0;13,0;;;;1,0;1,0;;;1,0;7,0;;;7,0;1,0;4,0;;1,0;3,0;;1,0;1,0;;2,0;127,0;;;2,0;1,0;;;;;;;;6,0;;;6,0;1,0;18,0;1,0;;8,0;;3,0;;;3,0;;;1,0;1,0;;1,0;;;2,0;1,0;;;;;;;3,0;;25,0;;;;;2,0;;;;1,0;;;5,0;2,0;3,0;5,0;;8,0;1,0;3,0;;;;2,0;2,0;;;4,0;;1,0;;3,0;1,0;;2,0;;1,0;4,0;4,0;;7,0;;10,0;1,0;;;;3,0;1,0;12,0;;4,0;;1,0;;10,0;5,0;;1,0;;32,0;;;1,0;;1,0;2,0;;3,0;;5,0;5,0;8,0;1,0;;;;3,0;6,0;5,0;4,0;;4,0;;19,0;;;3,0;1,0;;;;3,0;;4,0;1,0;11,0;1,0;;3,0;;;6,0;1,0;2,0;;;3,0;;6,0;3,0;;;;;8,0;2,0;5,0;;1,0;2,0;;;9,0;;;1,0;2,0;;;;;22,0;2,0;11,0;;;2,0;;2,0;;;;;10,0;2,0;;;;;;;;18,0;1,0;7,0;;3,0;12,0;;;5,0;;;;6,0;1,0;;14,0;1,0;2,0;6,0;10,0;;;;1,0;;1,0;1,0;;8,0;4,0;4,0;;10,0;;1,0;;;;3,0;2,0;;;4,0;29,0;;;;2,0;2,0;;;;;7,0;;1,0;;;2,0;10,0;;;;15,0;;2,0;2,0;;;;3,0;;;;;1,0;;2,0;;;;2,0;9,0;;;5,0;;4,0;;2,0;1,0;;;;4,0;1,0;;2,0;5,0;;3,0;;;;;2,0;;;;;;;;1,0;;;;27,0;;;;;;;;;;;;2,0;;;;;7,0;;;;2,0;;;;10,0;;;;1,0;;2,0;;;;;;;;;3,0;5,0;;;1,0;;25,0;;;;1,0;;;1,0;;;;;;;;;;;1,0;;;1,0;;
motion;;;161,0;15,0;103,0;;33,0;217,0;125,0;126,0;30,0;1,0;1,0;;17,0;11,0;32,0;4,0;48,0;27,0;8,0;201,0;2,0;48,0;89,0;;1,0;130,0;25,0;345,0;198,0;195,0;179,0;46,0;150,0;6,0;;95,0;15,0;87,0;27,0;4,0;13,0;64,0;66,0;;;;9,0;22,0;21,0;202,0;9,0;9,0;;625,0;188,0;1,0;5,0;39,0;12,0;5,0;263,0;11,0;36,0;13,0;99,0;;11,0;26,0;38,0;15,0;25,0;13,0;;3,0;;82,0;63,0;12,0;9,0;40,0;21,0;10,0;;;66,0;1,0;62,0;43,0;177,0;14,0;21,0;208,0;22,0;10,0;3,0;15,0;49,0;;20,0;156,0;2,0;;;24,0;11,0;134,0;3,0;;8,0;3,0;1,0;61,0;6,0;;;;;29,0;;;5,0;58,0;3,0;;109,0;;;7,0;23,0;19,0;;;1,0;221,0;6,0;;;2,0;18,0;19,0;3,0;9,0;24,0;2,0;47,0;317,0;;;;1,0;5,0;5,0;3,0;;;40,0;2,0;39,0;;8,0;;5,0;;;24,0;11,0;;;49,0;3,0;29,0;24,0;66,0;7,0;1,0;72,0;;;15,0;12,0;1,0;5,0;1,0;14,0;11,0;153,0;;80,0;;;1,0;31,0;5,0;;;;15,0;;;5,0;;11,0;;;19,0;10,0;29,0;5,0;7,0;3,0;3,0;;44,0;90,0;12,0;;6,0;1,0;;50,0;10,0;;1,0;;4,0;;;4,0;;2,0;10,0;1,0;8,0;15,0;;6,0;103,0;1,0;5,0;;24,0;3,0;2,0;6,0;;;;1,0;;10,0;;7,0;;3,0;;31,0;8,0;;6,0;16,0;3,0;;;1,0;5,0;;;;;12,0;;2,0;;19,0;7,0;5,0;37,0;10,0;2,0;3,0;6,0;29,0;;;26,0;230,0;16,0;3,0;15,0;2,0;1,0;38,0;;5,0;;41,0;9,0;;13,0;;80,0;4,0;1,0;;3,0;54,0;1,0;;54,0;33,0;;;3,0;;7,0;;;;;99,0;8,0;17,0;;25,0;;;1,0;10,0;63,0;11,0;3,0;7,0;7,0;4,0;2,0;12,0;2,0;5,0;;36,0;2,0;6,0;153,0;12,0;21,0;9,0;;31,0;33,0;18,0;46,0;4,0;19,0;5,0;7,0;;1,0;;96,0;4,0;;32,0;42,0;50,0;2,0;6,0;6,0;23,0;47,0;8,0;3,0;7,0;9,0;25,0;13,0;5,0;;25,0;7,0;3,0;1,0;10,0;;49,0;6,0;5,0;3,0;57,0;;57,0;7,0;3,0;11,0;33,0;26,0;21,0;66,0;15,0;102,0;;9,0;13,0;406,0;12,0;11,0;25,0;8,0;14,0;4,0;10,0;;5,0;4,0;30,0;21,0;2,0;41,0;;29,0;8,0;2,0;9,0;62,0;;5,0;6,0;15,0;62,0;21,0;11,0;;3,0;;2,0;11,0;4,0;2,0;;3,0;8,0;2,0;2,0;7,0;42,0;2,0;5,0;32,0;8,0;1,0;16,0;30,0;3,0;;3,0;;;7,0;;;1,0;;8,0;1,0;35,0;10,0;10,0;31,0;;;137,0;1,0;4,0;;4,0;18,0;;3,0;3,0;15,0;;1,0;8,0;;18,0;10,0;7,0;2,0;14,0;4,0;6,0;;3,0;75,0;104,0;17,0;;;7,0;6,0;4,0;1,0;14,0;5,0;;;5,0;23,0;;;;;19,0;4,0;;;9,0;;;;;4,0;3,0;2,0;;29,0;;;6,0;6,0;78,0;9,0;6,0;;2,0;;3,0;6,0;;;10,0;;;;;5,0;;;;6,0;;;38,0;8,0;;13,0;2,0;4,0;371,0;108,0;2,0;6,0;;;;81,0;;1,0;2,0;;;;;;;1,0;1,0;;1,0;2,0;54,0;32,0;5,0;;14,0;;5,0;;5,0;1,0;;;14,0;;3,0;;;8,0;2,0;2,0;;50,0;;;1,0;1,0;;10,0;;;;5,0;;1,0;;4,0;;;24,0;;3,0;3,0;13,0;;;7,0;;3,0;;;1,0;5,0;2,0;1,0;;12,0;1,0;6,0;;1,0;1,0;;;;;;2,0;;;17,0;1,0;2,0;;;1,0;;;7,0;4,0;9,0;1,0;;;;5,0;11,0;;;;;;;;20,0;;;9,0;;11,0;;;23,0;1,0;;1,0;;17,0;4,0;;;2,0;15,0;12,0;;;;20,0;8,0;2,0;9,0;;;6,0;4,0;;1,0;21,0;7,0;69,0;;2,0;4,0;17,0;7,0;2,0;;2,0;;7,0;2,0;1,0;;;;1,0;6,0;12,0;;10,0;15,0;;30,0;;4,0;8,0;4,0;;2,0;;1,0;;;;19,0;6,0;2,0;4,0;12,0;;;6,0;13,0;3,0;1,0;8,0;8,0;5,0;;;;;2,0;19,0;23,0;;;;1,0;6,0;17,0;1,0;4,0;;;9,0;1,0;4,0;2,0;6,0;3,0;3,0;;19,0;5,0;1,0;6,0;7,0;;;;;1,0;11,0;4,0;;8,0;;;6,0;14,0;9,0;;;2,0;;;2,0;69,0;;1,0;8,0;1,0;27,0;;3,0;;;;;;;2,0;;17,0;6,0;;;4,0;6,0;4,0;4,0;12,0;;;;;;2,0;;;1,0;;3,0;;8,0;;24,0;16,0;;;2,0;;6,0;3,0;11,0;10,0;7,0;1,0;;;5,0;;;2,0;;5,0;;2,0;;;21,0;2,0;1,0;;;30,0;;1,0;;;3,0;3,0;7,0;;;1,0;;;;;;1,0;;;;;;4,0;;10,0;;;7,0;;;;;;;1,0;4,0;3,0;;7,0;20,0;;;;;9,0;;1,0;;1,0;19,0;;;;1,0;1,0;;;;1,0;;2,0;;;;;;8,0;2,0;;;1,0;5,0;;;;;;;;;4,0;;;;;;;;;;1,0;;15,0;1,0;;9,0;;;;;1,0;;1,0;;11,0;6,0;;4,0;;1,0;;;;;;;;;;;;;;
movable;;;18,0;;54,0;;236,0;40,0;8,0;11,0;12,0;;1,0;;;;5,0;1,0;13,0;3,0;3,0;60,0;3,0;6,0;13,0;;5,0;4,0;2,0;31,0;6,0;9,0;149,0;;44,0;;4,0;446,0;;35,0;8,0;;94,0;169,0;;;2,0;1,0;20,0;6,0;2,0;10,0;;110,0;;133,0;91,0;;8,0;651,0;12,0;;24,0;;;13,0;67,0;5,0;;13,0;370,0;4,0;15,0;3,0;2,0;5,0;4,0;26,0;339,0;16,0;3,0;;;9,0;;15,0;;3,0;4,0;4,0;60,0;2,0;6,0;20,0;;8,0;;1,0;;54,0;64,0;92,0;;1,0;;;;222,0;;;9,0;51,0;2,0;57,0;39,0;1,0;23,0;;46,0;79,0;;3,0;3,0;22,0;;;56,0;53,0;1,0;21,0;77,0;2,0;1,0;107,0;6,0;4,0;60,0;1,0;;1,0;;3,0;3,0;26,0;10,0;42,0;42,0;102,0;;1,0;;8,0;48,0;;37,0;34,0;40,0;28,0;1,0;62,0;4,0;;17,0;12,0;1,0;;1,0;37,0;;;724,0;246,0;37,0;59,0;67,0;20,0;17,0;2,0;1,0;;16,0;3,0;7,0;2,0;9,0;56,0;81,0;43,0;;244,0;4,0;2,0;;40,0;;89,0;;;20,0;23,0;;22,0;5,0;69,0;6,0;5,0;159,0;85,0;72,0;296,0;;13,0;;;1,0;15,0;6,0;;;5,0;2,0;3,0;2,0;;68,0;;;;;;4,0;;41,0;13,0;9,0;7,0;6,0;3,0;41,0;7,0;108,0;;1,0;4,0;5,0;7,0;2,0;;5,0;42,0;17,0;;1,0;66,0;14,0;;5,0;5,0;;2,0;3,0;115,0;8,0;16,0;18,0;15,0;19,0;2,0;;1,0;;11,0;;7,0;7,0;4,0;;12,0;3,0;20,0;50,0;32,0;;62,0;;10,0;121,0;40,0;9,0;17,0;2,0;7,0;3,0;;;31,0;;44,0;1,0;3,0;4,0;1,0;29,0;13,0;11,0;6,0;6,0;34,0;16,0;9,0;22,0;10,0;67,0;26,0;69,0;;11,0;2,0;5,0;;2,0;2,0;39,0;12,0;;;;8,0;3,0;3,0;9,0;5,0;;;;;;1,0;;;1,0;3,0;2,0;;4,0;;;6,0;3,0;8,0;53,0;4,0;;3,0;;;;6,0;1,0;;;;;;;5,0;2,0;;;6,0;;1,0;;7,0;;;2,0;;;46,0;;22,0;1,0;;;;;1,0;;7,0;3,0;14,0;26,0;;30,0;;5,0;17,0;;;14,0;;2,0;;;;;19,0;;;7,0;9,0;1,0;1,0;;;1,0;;11,0;;2,0;;;1,0;26,0;;;;2,0;;;;;2,0;1,0;;;;;4,0;2,0;;1,0;;;13,0;2,0;;;14,0;;;3,0;9,0;5,0;;;2,0;;;1,0;;7,0;10,0;1,0;2,0;;1,0;2,0;;;7,0;3,0;;1,0;;2,0;;;;;;;;;50,0;4,0;;;4,0;;9,0;;6,0;9,0;48,0;7,0;1,0;;;;;;;10,0;1,0;;7,0;;4,0;1,0;8,0;;;1,0;11,0;3,0;;;;;2,0;;1,0;;;8,0;;7,0;25,0;1,0;;2,0;;;;3,0;1,0;;;;;3,0;10,0;;1,0;13,0;;;;;4,0;1,0;;;;1,0;3,0;25,0;3,0;;;;;4,0;;116,0;;4,0;;1,0;1,0;;;1,0;;6,0;;;;;;27,0;;3,0;13,0;9,0;;;;1,0;;;;;5,0;3,0;;;;;1,0;8,0;1,0;;;1,0;;3,0;;1,0;;2,0;;;;;26,0;1,0;;;;;2,0;;;;;1,0;8,0;;2,0;3,0;13,0;;6,0;7,0;13,0;9,0;;;;;;;;;;;1,0;;2,0;;3,0;3,0;5,0;4,0;3,0;;;;;;4,0;13,0;8,0;9,0;2,0;1,0;7,0;2,0;;;;3,0;2,0;;;;;;;;;10,0;;;;;;;2,0;;;;;;3,0;;;1,0;;;7,0;;;;;;6,0;;9,0;1,0;3,0;3,0;;;18,0;;1,0;;;2,0;;;6,0;;;;;3,0;;;;;;;;1,0;;;;;;;;2,0;;;;;8,0;;;;2,0;;;2,0;5,0;;;5,0;;;12,0;;;;4,0;;;6,0;2,0;;5,0;;12,0;1,0;;;;;;;;7,0;;;;;;;;;3,0;;1,0;;;1,0;;;9,0;1,0;;;1,0;;;;;;37,0;;;;;;;;;;3,0;;5,0;;6,0;;2,0;;21,0;1,0;7,0;;;;;2,0;4,0;;;6,0;;;;;;;6,0;3,0;5,0;;;;;;2,0;29,0;;2,0;6,0;;2,0;2,0;;3,0;;;2,0;1,0;;3,0;3,0;10,0;;8,0;;;2,0;;;5,0;4,0;5,0;;4,0;;;;;2,0;;;;;;;;12,0;;15,0;;;;7,0;2,0;;;;1,0;;;2,0;;;;;12,0;13,0;;2,0;2,0;;;;;;;9,0;;1,0;;;;;;;;;;;;;;;;;;1,0;;;2,0;;;1,0;;;;4,0;;;;;;;;;;;2,0;;2,0;2,0;;2,0;;;;;;;;;;;;;;;;;;;;;;;;
move;;;19,0;1,0;60,0;;339,0;74,0;23,0;7,0;16,0;1,0;9,0;;3,0;;17,0;10,0;6,0;1,0;44,0;120,0;33,0;4,0;29,0;;;6,0;5,0;49,0;18,0;52,0;143,0;4,0;7,0;;6,0;542,0;17,0;48,0;81,0;1,0;119,0;116,0;;7,0;;28,0;258,0;;7,0;13,0;;216,0;;239,0;25,0;;4,0;1429,0;14,0;19,0;51,0;2,0;;77,0;141,0;13,0;1,0;26,0;534,0;20,0;35,0;8,0;1,0;8,0;3,0;89,0;527,0;53,0;8,0;8,0;9,0;;;;34,0;5,0;3,0;8,0;41,0;12,0;5,0;41,0;7,0;5,0;2,0;5,0;18,0;15,0;52,0;145,0;5,0;1,0;1,0;3,0;;635,0;2,0;;24,0;10,0;20,0;43,0;11,0;5,0;35,0;;8,0;46,0;;6,0;10,0;6,0;;;222,0;18,0;7,0;15,0;39,0;;;45,0;1,0;24,0;17,0;5,0;23,0;2,0;;5,0;;17,0;12,0;49,0;23,0;182,0;1,0;;;15,0;77,0;;60,0;22,0;19,0;66,0;8,0;83,0;;4,0;12,0;11,0;3,0;2,0;;16,0;1,0;1,0;320,0;48,0;51,0;39,0;106,0;51,0;8,0;12,0;5,0;;5,0;7,0;3,0;7,0;21,0;35,0;42,0;64,0;;103,0;1,0;12,0;;23,0;2,0;12,0;2,0;3,0;56,0;5,0;;8,0;10,0;108,0;;2,0;17,0;16,0;6,0;73,0;2,0;5,0;;;23,0;56,0;2,0;2,0;7,0;4,0;2,0;28,0;14,0;2,0;12,0;;26,0;;4,0;4,0;3,0;6,0;70,0;13,0;15,0;10,0;1,0;16,0;75,0;5,0;128,0;1,0;13,0;3,0;2,0;1,0;15,0;;1,0;30,0;12,0;2,0;;13,0;31,0;1,0;;2,0;6,0;1,0;2,0;130,0;5,0;7,0;10,0;6,0;20,0;1,0;4,0;1,0;1,0;13,0;;1,0;5,0;2,0;3,0;8,0;41,0;6,0;6,0;32,0;4,0;76,0;;26,0;;170,0;16,0;24,0;10,0;13,0;3,0;;7,0;136,0;;38,0;;1,0;7,0;5,0;71,0;5,0;3,0;2,0;1,0;41,0;10,0;5,0;17,0;10,0;26,0;63,0;24,0;2,0;5,0;5,0;28,0;;9,0;3,0;27,0;24,0;2,0;5,0;;14,0;1,0;2,0;26,0;1,0;1,0;1,0;;;1,0;;1,0;2,0;;9,0;1,0;1,0;3,0;;2,0;6,0;5,0;31,0;34,0;13,0;1,0;5,0;;5,0;;;3,0;;4,0;3,0;;7,0;8,0;10,0;;;;5,0;14,0;;3,0;9,0;3,0;11,0;;1,0;;48,0;5,0;30,0;3,0;2,0;2,0;7,0;3,0;2,0;;10,0;7,0;32,0;29,0;;45,0;16,0;18,0;79,0;2,0;;29,0;;;13,0;2,0;2,0;32,0;129,0;2,0;1,0;;31,0;;1,0;;4,0;4,0;1,0;29,0;1,0;31,0;2,0;;20,0;10,0;1,0;;;8,0;12,0;2,0;;;;;;;1,0;;;3,0;1,0;4,0;;3,0;52,0;1,0;;3,0;20,0;;2,0;9,0;7,0;1,0;1,0;;4,0;5,0;;3,0;2,0;2,0;13,0;;4,0;121,0;2,0;1,0;;;19,0;9,0;10,0;;;12,0;;;;;;2,0;;;61,0;14,0;1,0;;12,0;;9,0;23,0;9,0;40,0;25,0;2,0;7,0;1,0;;;;;;18,0;1,0;;19,0;1,0;10,0;3,0;30,0;;2,0;1,0;1,0;;6,0;;;;10,0;1,0;15,0;;;2,0;8,0;5,0;1,0;;1,0;9,0;1,0;12,0;;4,0;1,0;2,0;1,0;;;;11,0;;1,0;10,0;;;;;;;1,0;1,0;;16,0;11,0;15,0;2,0;6,0;1,0;;;;;138,0;;2,0;;1,0;;;;1,0;1,0;25,0;1,0;;5,0;;;30,0;5,0;;4,0;;;;;;;;1,0;5,0;5,0;1,0;;;2,0;;;3,0;2,0;;;;;4,0;;1,0;1,0;;;;;3,0;4,0;;;;;;4,0;;;;1,0;1,0;1,0;;9,0;4,0;4,0;2,0;2,0;2,0;36,0;10,0;;8,0;1,0;3,0;7,0;;;;;9,0;;;;1,0;1,0;;1,0;6,0;;4,0;;15,0;2,0;;;5,0;9,0;2,0;1,0;;6,0;6,0;3,0;;2,0;8,0;7,0;;4,0;;;;;;1,0;3,0;;;3,0;;;;1,0;1,0;;1,0;;;14,0;5,0;;14,0;;4,0;1,0;;;;;8,0;;;5,0;;8,0;;;;7,0;;1,0;8,0;4,0;2,0;4,0;;8,0;;;;;1,0;;3,0;1,0;;1,0;;2,0;;;;;1,0;1,0;;8,0;1,0;;;;;10,0;;4,0;;;;3,0;1,0;3,0;16,0;12,0;1,0;;;;;;;1,0;6,0;;21,0;1,0;;13,0;;9,0;7,0;;;;;2,0;2,0;;13,0;;;;;;;40,0;;4,0;2,0;;5,0;4,0;2,0;;1,0;7,0;2,0;1,0;;;;1,0;;;4,0;43,0;1,0;;;;5,0;3,0;1,0;;4,0;;2,0;5,0;1,0;;1,0;2,0;2,0;41,0;2,0;3,0;;2,0;;2,0;;3,0;;;1,0;;1,0;2,0;;1,0;;24,0;1,0;1,0;;1,0;;;4,0;;10,0;;3,0;6,0;2,0;21,0;3,0;;2,0;;6,0;2,0;;;;;3,0;;5,0;;3,0;;2,0;;;4,0;1,0;;1,0;;12,0;1,0;;;;;;;1,0;;7,0;6,0;;3,0;1,0;4,0;3,0;1,0;2,0;;;;2,0;4,0;;1,0;;;;;18,0;10,0;;1,0;1,0;;;2,0;7,0;1,0;;3,0;;;2,0;1,0;;;;;;;;;;;;;;4,0;;;;2,0;;;;;;;3,0;;;2,0;;;;;;;5,0;5,0;2,0;;4,0;;7,0;;9,0;;;;;;;4,0;;;;;;;;;;;;15,0;;;;
movement;;;247,0;2,0;91,0;;88,0;165,0;96,0;79,0;22,0;1,0;12,0;5,0;9,0;4,0;36,0;28,0;8,0;21,0;33,0;214,0;31,0;33,0;37,0;2,0;2,0;83,0;59,0;320,0;139,0;199,0;287,0;15,0;52,0;2,0;5,0;241,0;18,0;41,0;86,0;;73,0;101,0;14,0;16,0;;13,0;80,0;11,0;12,0;74,0;;63,0;;343,0;81,0;;10,0;441,0;71,0;2,0;149,0;3,0;10,0;30,0;84,0;3,0;18,0;25,0;109,0;19,0;38,0;;;10,0;3,0;65,0;168,0;13,0;20,0;25,0;17,0;8,0;;1,0;95,0;12,0;28,0;21,0;75,0;44,0;2,0;72,0;24,0;5,0;1,0;5,0;6,0;3,0;44,0;191,0;11,0;7,0;9,0;2,0;3,0;257,0;;1,0;11,0;30,0;9,0;22,0;8,0;3,0;13,0;;4,0;70,0;;13,0;10,0;14,0;;;89,0;16,0;;13,0;20,0;9,0;;65,0;1,0;56,0;5,0;9,0;;;;9,0;2,0;14,0;7,0;12,0;12,0;99,0;;;;7,0;61,0;;8,0;6,0;24,0;42,0;11,0;91,0;;16,0;11,0;6,0;1,0;;8,0;24,0;;5,0;181,0;20,0;83,0;29,0;;14,0;3,0;93,0;3,0;;4,0;1,0;2,0;2,0;8,0;15,0;12,0;35,0;;61,0;7,0;3,0;;38,0;;4,0;;;64,0;1,0;;5,0;;19,0;2,0;7,0;25,0;7,0;9,0;29,0;1,0;9,0;;1,0;46,0;100,0;14,0;;1,0;21,0;3,0;42,0;3,0;4,0;2,0;;11,0;;1,0;1,0;1,0;3,0;32,0;10,0;17,0;33,0;;31,0;95,0;3,0;38,0;2,0;19,0;3,0;7,0;22,0;1,0;1,0;4,0;15,0;3,0;;5,0;13,0;;4,0;2,0;10,0;3,0;;;67,0;1,0;16,0;10,0;5,0;8,0;3,0;4,0;;1,0;8,0;;2,0;5,0;2,0;3,0;7,0;74,0;16,0;7,0;17,0;7,0;63,0;;66,0;106,0;256,0;13,0;8,0;6,0;3,0;2,0;2,0;7,0;16,0;;16,0;1,0;1,0;18,0;;61,0;3,0;14,0;2,0;11,0;77,0;;1,0;43,0;14,0;20,0;8,0;10,0;;4,0;13,0;7,0;2,0;7,0;37,0;13,0;35,0;1,0;4,0;;7,0;;;22,0;2,0;3,0;5,0;;35,0;13,0;3,0;2,0;4,0;1,0;25,0;8,0;15,0;47,0;2,0;13,0;9,0;2,0;39,0;20,0;132,0;3,0;1,0;1,0;1,0;5,0;;;;8,0;;;1,0;37,0;30,0;4,0;5,0;2,0;16,0;1,0;1,0;10,0;30,0;5,0;6,0;1,0;1,0;1,0;32,0;20,0;19,0;12,0;8,0;2,0;7,0;8,0;3,0;;25,0;3,0;58,0;45,0;;7,0;98,0;16,0;22,0;19,0;2,0;118,0;;3,0;7,0;33,0;14,0;29,0;56,0;5,0;1,0;3,0;37,0;7,0;11,0;1,0;17,0;39,0;1,0;86,0;;10,0;3,0;4,0;15,0;41,0;1,0;;1,0;8,0;45,0;1,0;3,0;2,0;3,0;;;;3,0;;2,0;7,0;;7,0;;3,0;48,0;2,0;23,0;1,0;2,0;;11,0;34,0;35,0;;3,0;6,0;;23,0;;7,0;;2,0;29,0;;23,0;67,0;6,0;15,0;1,0;3,0;28,0;11,0;1,0;;3,0;6,0;;4,0;;4,0;6,0;2,0;7,0;;51,0;2,0;4,0;;10,0;;7,0;5,0;4,0;61,0;74,0;;;;;;;;12,0;3,0;1,0;;34,0;;2,0;1,0;17,0;2,0;4,0;5,0;;2,0;2,0;;;;5,0;5,0;6,0;;;15,0;2,0;;3,0;;3,0;2,0;4,0;;;5,0;7,0;7,0;;;2,0;5,0;1,0;3,0;;11,0;2,0;;1,0;3,0;1,0;;2,0;1,0;;17,0;1,0;13,0;15,0;14,0;1,0;;;2,0;;115,0;1,0;15,0;;18,0;1,0;;;;;11,0;4,0;;5,0;4,0;;61,0;7,0;3,0;8,0;1,0;;;3,0;1,0;;;2,0;;1,0;;;4,0;;;1,0;4,0;;1,0;;5,0;1,0;8,0;;1,0;;;4,0;;;7,0;1,0;;3,0;;;1,0;6,0;3,0;;;;2,0;;;3,0;6,0;9,0;2,0;4,0;4,0;5,0;8,0;;;4,0;;1,0;;15,0;;;5,0;;15,0;1,0;;1,0;;;1,0;3,0;6,0;7,0;17,0;;;1,0;;2,0;26,0;7,0;;;;10,0;;;14,0;;4,0;8,0;;;;;10,0;19,0;3,0;;;4,0;10,0;;;2,0;3,0;;1,0;;;17,0;4,0;;7,0;3,0;4,0;4,0;3,0;6,0;;;1,0;12,0;;6,0;1,0;26,0;4,0;;;2,0;;3,0;;;3,0;11,0;;;4,0;;;6,0;3,0;1,0;22,0;13,0;;4,0;1,0;3,0;;;4,0;1,0;16,0;;11,0;9,0;;5,0;18,0;;;7,0;;11,0;;2,0;1,0;2,0;;;5,0;3,0;;2,0;7,0;1,0;;;7,0;;15,0;;9,0;5,0;;8,0;;5,0;3,0;5,0;3,0;1,0;;7,0;27,0;;3,0;;;;;3,0;;25,0;;1,0;1,0;;4,0;18,0;13,0;10,0;;5,0;;;;4,0;8,0;;;8,0;;22,0;;3,0;;;10,0;3,0;4,0;;4,0;4,0;;1,0;;3,0;;;3,0;3,0;7,0;8,0;;;;;;3,0;;;;;3,0;4,0;;1,0;1,0;5,0;2,0;12,0;;1,0;;;3,0;1,0;11,0;1,0;;5,0;1,0;;;;5,0;;2,0;2,0;;;;4,0;4,0;;5,0;1,0;;59,0;;;1,0;7,0;2,0;;;;3,0;2,0;;;1,0;;;;;;3,0;1,0;;4,0;;;1,0;8,0;4,0;;2,0;;10,0;1,0;;;;;;;32,0;;;27,0;;1,0;;;1,0;1,0;;;;;;;;1,0;;3,0;;;;;1,0;;;;;;;;;;;;;4,0;;;1,0;1,0;;2,0;;1,0;1,0;;;;22,0;;3,0;;4,0;;1,0;;4,0;;;;;13,0;;;;;2,0;;;1,0;;;;;;;;;;
multiple;;;3,0;;14,0;;7,0;30,0;6,0;36,0;3,0;;1,0;15,0;15,0;5,0;2,0;;7,0;2,0;7,0;24,0;1,0;4,0;1,0;;5,0;84,0;1,0;9,0;11,0;22,0;29,0;18,0;18,0;9,0;;5,0;;16,0;3,0;;;38,0;1,0;1,0;;10,0;13,0;25,0;4,0;12,0;;12,0;;216,0;44,0;4,0;4,0;42,0;;;59,0;;1,0;1,0;3,0;2,0;;8,0;11,0;;4,0;;;;;34,0;17,0;2,0;;13,0;9,0;7,0;;;24,0;;1,0;27,0;38,0;1,0;5,0;16,0;1,0;2,0;;11,0;22,0;7,0;16,0;54,0;;6,0;;9,0;2,0;19,0;;;;10,0;20,0;6,0;2,0;;;1,0;5,0;2,0;;;;5,0;;6,0;8,0;;1,0;;2,0;6,0;;2,0;1,0;47,0;3,0;;2,0;;;3,0;2,0;1,0;8,0;;18,0;36,0;;;;;2,0;;;1,0;5,0;5,0;2,0;28,0;1,0;1,0;2,0;1,0;;;3,0;16,0;3,0;3,0;2,0;;12,0;18,0;1,0;1,0;;25,0;;;4,0;1,0;5,0;;;6,0;5,0;27,0;;9,0;;3,0;2,0;14,0;;1,0;;;;2,0;2,0;1,0;;4,0;;;3,0;;2,0;6,0;3,0;3,0;;;;42,0;4,0;;;4,0;;3,0;2,0;;;1,0;10,0;;;;1,0;;;;8,0;2,0;;11,0;21,0;;1,0;;4,0;1,0;;2,0;10,0;4,0;;1,0;4,0;;;6,0;;12,0;;7,0;1,0;;8,0;13,0;3,0;;;;3,0;1,0;;;;1,0;;;2,0;4,0;3,0;;1,0;2,0;4,0;;1,0;1,0;;13,0;;15,0;14,0;;2,0;;7,0;7,0;1,0;;3,0;;;1,0;3,0;2,0;2,0;3,0;;1,0;;9,0;3,0;;4,0;10,0;5,0;;1,0;;;;2,0;;1,0;;;;;5,0;2,0;;;;8,0;;;3,0;;1,0;2,0;1,0;1,0;1,0;;11,0;;4,0;1,0;2,0;;1,0;;6,0;3,0;9,0;4,0;;;;;;2,0;2,0;1,0;;;;2,0;1,0;;1,0;;2,0;;;;1,0;1,0;3,0;;1,0;;4,0;23,0;;;3,0;10,0;;3,0;;3,0;8,0;;;;;;;;7,0;7,0;;15,0;;1,0;4,0;1,0;1,0;;4,0;;1,0;3,0;6,0;;6,0;;16,0;2,0;;11,0;;15,0;;2,0;6,0;9,0;1,0;8,0;3,0;1,0;7,0;11,0;7,0;;;;;;;;;;;2,0;3,0;1,0;4,0;6,0;2,0;;;4,0;1,0;5,0;10,0;;3,0;;;2,0;;;3,0;1,0;;3,0;10,0;2,0;1,0;7,0;3,0;;23,0;;;;6,0;8,0;;2,0;1,0;3,0;4,0;;1,0;;4,0;3,0;3,0;;1,0;;9,0;1,0;1,0;41,0;52,0;4,0;1,0;1,0;;;;;;1,0;6,0;;;1,0;;1,0;;;8,0;2,0;;;1,0;;;;4,0;2,0;;;;;;;;;6,0;3,0;;;1,0;;;;;;6,0;;;;;;3,0;;2,0;4,0;;;;18,0;;5,0;;1,0;5,0;66,0;;;1,0;;;4,0;;;;1,0;;8,0;;;2,0;4,0;1,0;;1,0;;36,0;14,0;;;21,0;1,0;;;2,0;4,0;;;;1,0;3,0;;;1,0;;;;19,0;;2,0;;;;;;;4,0;;;;;;1,0;;3,0;;;;2,0;;;1,0;;;1,0;;;;4,0;1,0;;1,0;;3,0;;;;;1,0;;1,0;;1,0;22,0;;5,0;1,0;;;1,0;;;1,0;2,0;2,0;2,0;;2,0;;;;;;;;;;;;8,0;;;3,0;;9,0;;;6,0;5,0;8,0;;;1,0;6,0;;;1,0;;;;;;6,0;4,0;;6,0;;1,0;;1,0;;;;;32,0;2,0;;3,0;6,0;6,0;;;;;;1,0;1,0;;;3,0;;;;;;4,0;;2,0;4,0;;;;;1,0;;1,0;;;;1,0;;1,0;3,0;;;2,0;1,0;;;;2,0;;;;3,0;;1,0;;;;1,0;;;;1,0;;2,0;;;1,0;;1,0;;3,0;1,0;;1,0;1,0;1,0;;1,0;6,0;;;;;5,0;2,0;1,0;;;;;;;;;;;1,0;;;;3,0;;;;;5,0;;;;;;;2,0;;3,0;;;;;;2,0;1,0;;1,0;5,0;;;;1,0;;;;;1,0;1,0;1,0;4,0;13,0;;3,0;1,0;;;;2,0;;2,0;;2,0;2,0;;;;;;1,0;;;;;;;1,0;;;;;;8,0;;;1,0;;;;;;8,0;;;;;;1,0;1,0;;7,0;;;;;;11,0;9,0;1,0;;;;;1,0;1,0;1,0;1,0;;;;;;;;;;;6,0;1,0;;2,0;;;3,0;;;;1,0;;;;;;;;1,0;;;;6,0;;2,0;14,0;;;;;;;;;;3,0;;;;;;;;;;;;;;;;;;;;;;;;1,0;;;1,0;;;2,0;;1,0;;1,0;;;;;;;;;
neighboring;;;10,0;3,0;;;;10,0;4,0;;1,0;3,0;;;1,0;;5,0;;3,0;2,0;;;;1,0;1,0;;;;;1,0;1,0;41,0;2,0;1,0;2,0;;;19,0;;;9,0;;;2,0;;;;;;5,0;1,0;4,0;;3,0;;32,0;6,0;;;26,0;2,0;;11,0;;2,0;2,0;;;4,0;;;;;;;;1,0;8,0;13,0;3,0;;1,0;;2,0;;;;;5,0;2,0;5,0;5,0;;2,0;;15,0;;10,0;14,0;;2,0;10,0;;13,0;;;;10,0;;;;14,0;;;;;;;3,0;;;;;1,0;;;2,0;;2,0;;;2,0;;;1,0;3,0;4,0;;7,0;;;;;;5,0;;1,0;19,0;;;;2,0;1,0;;;;;;;;;;;;;;;6,0;;;15,0;3,0;1,0;2,0;;;;1,0;;;;;;;;3,0;;12,0;;18,0;;;;8,0;;;;3,0;;;;;;7,0;;;;;1,0;;1,0;;;;;;;;;;;;;;4,0;;;;;;;;1,0;1,0;;5,0;;3,0;3,0;;2,0;;8,0;;;;8,0;;;2,0;3,0;;;1,0;;;;1,0;;;1,0;2,0;;;1,0;;5,0;;;;;;;;;2,0;;;;5,0;;;;2,0;;1,0;3,0;;;2,0;;;1,0;;;;2,0;;;;;;2,0;;;;;;;;;;;;10,0;;;;;;2,0;;;;4,0;5,0;5,0;;;;;1,0;;;;;;;;;;;;;3,0;;;;1,0;;3,0;;4,0;;;4,0;;;;;;;;;4,0;;;;;;;;;3,0;;;;3,0;;2,0;;;;;;;;;;;;;;;;;;12,0;1,0;3,0;;;;3,0;2,0;;;;;;;;;3,0;;;;;6,0;5,0;;;;;2,0;;2,0;;;;8,0;4,0;;;;;;;;;;;;;;;1,0;;;;;;;;;;5,0;;;2,0;;;;;;2,0;;;10,0;;;1,0;;;;;;;;;;;;;;;;;;;;;;;2,0;;;;;;;;;;1,0;;;;;;;;;10,0;2,0;;;;;;;1,0;;;;;;;;;;;;;;;;;;;;;;;;;1,0;;;;;;;;;;;;;;132,0;;;1,0;;;;;;;;1,0;;;;1,0;7,0;;;;;;;;;;;;;;;;;;1,0;;;;;;;;;;;;;;;;;;;;;;;;;;;;;;;;;;1,0;;;;;;;;;;;;;;;;;;2,0;;1,0;;;;;;;;;;3,0;1,0;;;;3,0;;;;;;;;;;;;;;;;;;;11,0;;;;;;;;;;;;;;;;;;5,0;;;;;;;;;3,0;;;;1,0;;;;;;;;;;;;;;;;;;;1,0;;;;;;;;;;;;;1,0;4,0;;;;;;;;;;;;;;;;;;;;;;;;;;;;;;5,0;6,0;;;;;;;;;2,0;;;;;;;;7,0;;;;;;;;;;;;;;4,0;;;;;;;;;;;;;;;;;;;;;;;;13,0;;;;;;;;;;1,0;;;;;;;;;;6,0;;;;;;;;;;;;;;;;;;;;;;;;;;;1,0;;;;;;;;;;;;;;;;;;;;;2,0;;;;;;;;;;2,0;;;;;;;;;;;;;;;;;;;;;;;;;;;;;;;;;;;;;;;;;;;;;2,0;;;;;;;;;;;;;;;;;3,0;;;;;;;;;;;;;;;;;;;;;;;;;;;
network;;;1,0;;50,0;;5,0;83,0;;36,0;12,0;;;;;1,0;;;3,0;50,0;8,0;111,0;2,0;;;;;289,0;;4,0;12,0;17,0;221,0;3,0;90,0;;;2,0;;30,0;;;2,0;12,0;;;;;;3,0;4,0;19,0;4,0;5,0;;320,0;72,0;;;8,0;;;137,0;;;;12,0;;2,0;10,0;4,0;9,0;1,0;;;;;2,0;18,0;18,0;;34,0;25,0;2,0;;1,0;;;2,0;30,0;26,0;;1,0;63,0;2,0;;;39,0;75,0;;3,0;217,0;;30,0;2,0;2,0;18,0;87,0;;;11,0;7,0;1,0;13,0;12,0;;;;;9,0;;;2,0;69,0;;;61,0;3,0;;47,0;3,0;9,0;;;;10,0;;;;;;3,0;7,0;1,0;2,0;;3,0;9,0;;;;;;;1,0;32,0;;12,0;;16,0;;;;4,0;21,0;14,0;;10,0;9,0;2,0;;;34,0;2,0;1,0;;1,0;13,0;;;4,0;;;3,0;;;;56,0;;3,0;;2,0;;85,0;;;;;2,0;4,0;;;;8,0;;2,0;;1,0;5,0;10,0;;;2,0;;7,0;13,0;110,0;;;;2,0;5,0;;5,0;1,0;;1,0;;;;1,0;;;1,0;6,0;3,0;;1,0;27,0;;;;4,0;;4,0;3,0;9,0;;;;;3,0;;144,0;2,0;;;5,0;;;;;;;;;1,0;1,0;2,0;1,0;;;;;1,0;144,0;;;;2,0;;;;5,0;;8,0;1,0;31,0;10,0;;;2,0;;;;2,0;;2,0;;;6,0;;7,0;;;;;1,0;;;4,0;2,0;;;1,0;;;;;;;7,0;;;;1,0;;;7,0;;105,0;;;;;1,0;1,0;26,0;;;2,0;9,0;;;;1,0;;2,0;;6,0;;19,0;9,0;;;;;;;;3,0;;;;6,0;3,0;6,0;;3,0;;;2,0;;3,0;8,0;45,0;18,0;;;;1,0;11,0;6,0;21,0;;1,0;5,0;;3,0;35,0;;9,0;;9,0;;3,0;2,0;4,0;8,0;;3,0;;18,0;;;;7,0;6,0;2,0;;;5,0;;;42,0;24,0;8,0;;4,0;;21,0;;7,0;46,0;38,0;9,0;1,0;9,0;2,0;6,0;;;2,0;;;48,0;10,0;1,0;7,0;2,0;;;5,0;5,0;113,0;23,0;;12,0;9,0;2,0;1,0;16,0;7,0;;;;20,0;;12,0;21,0;1,0;4,0;6,0;;5,0;33,0;;;1,0;6,0;;12,0;3,0;;7,0;1,0;5,0;18,0;;;14,0;2,0;15,0;5,0;;;3,0;1,0;;12,0;3,0;12,0;;5,0;110,0;27,0;;3,0;;;41,0;66,0;;2,0;;;;;;;;;29,0;5,0;226,0;142,0;6,0;5,0;3,0;;1,0;;11,0;;;12,0;3,0;;;1,0;59,0;;;5,0;83,0;;;;6,0;1,0;;;15,0;3,0;;2,0;16,0;3,0;4,0;1,0;;1,0;;1,0;;;5,0;3,0;;3,0;;;8,0;6,0;;3,0;1,0;;;12,0;;9,0;144,0;28,0;;7,0;3,0;2,0;;5,0;;92,0;4,0;;2,0;58,0;;1,0;;11,0;162,0;;2,0;;3,0;;;;;;;;1,0;;2,0;11,0;;;;;;;;;;2,0;33,0;5,0;;2,0;;;;2,0;4,0;;1,0;;40,0;;;12,0;;1,0;;;;;;;;;;;;1,0;;1,0;;1,0;3,0;4,0;;;;;;;;;;;43,0;;;;;;;;1,0;;3,0;;;;;1,0;4,0;1,0;;;;;;;;2,0;;;;;3,0;;3,0;;1,0;1,0;2,0;;;;4,0;;1,0;;;;6,0;16,0;;1,0;;;;;;;;;;;;1,0;;;7,0;;;;;2,0;3,0;3,0;;1,0;;;3,0;;1,0;;;;6,0;;1,0;;;;;;;2,0;;2,0;;;;1,0;;7,0;1,0;;;;;;;;5,0;1,0;1,0;;;3,0;;1,0;2,0;;1,0;5,0;;;;1,0;2,0;1,0;;3,0;1,0;;;;46,0;;;;1,0;;;;;;1,0;;;1,0;;3,0;;;;;;;;;1,0;;;;;;;;;;;;;1,0;;;;;;;2,0;;;1,0;;5,0;;3,0;;;;;;;1,0;;;1,0;19,0;;;;4,0;;;;;4,0;;;1,0;;;;;;;;;;;;;;;;1,0;;;;;6,0;;;;;;;1,0;;21,0;;6,0;;;;;;;;;;;;;2,0;;;;;;;2,0;3,0;;;1,0;;;;;;10,0;1,0;;;;4,0;;;;;;;;;7,0;;;1,0;;;;;;;;;;;;;;;;;;;2,0;;;;;;;;;;9,0;;;;;1,0;;;;;;3,0;;;6,0;;;;;;;;;
node;;;1,0;;1,0;;;3,0;13,0;;;;;;;;;;;18,0;;11,0;17,0;;;;3,0;;;1,0;;;9,0;1,0;;;;;;;2,0;;;5,0;;;;;;;1,0;22,0;;;;8,0;10,0;3,0;;1,0;;;13,0;;;;2,0;;;15,0;;;2,0;;;;;6,0;1,0;;1,0;;2,0;;;;;;3,0;1,0;9,0;;;20,0;;2,0;;21,0;2,0;;;15,0;;;;;4,0;5,0;1,0;;;2,0;;;2,0;;;;;;;;1,0;13,0;;;7,0;;;12,0;;;;;;;1,0;;2,0;;;;;;;;4,0;;;;;;;;1,0;;;;;1,0;;;;;;;1,0;;;;1,0;;;;4,0;;;22,0;;;;;;;;;;19,0;;1,0;;;;2,0;;;;;;;;1,0;;8,0;;;;;;;;;1,0;;;2,0;5,0;;;1,0;;3,0;1,0;;;;;;;;;;;4,0;;2,0;;;2,0;;;;;;;;1,0;;;;5,0;;;93,0;;;;2,0;;;;5,0;;;;;;;;;;;;1,0;;4,0;;;;5,0;;;;;;;4,0;1,0;3,0;5,0;;;;;;;;;;;;;;;;;;2,0;;;;1,0;;;;;;;;;;3,0;;;;5,0;;;3,0;;;;;;;1,0;;;;;;7,0;;1,0;;6,0;4,0;2,0;;;;;;3,0;;;2,0;;;;;;;1,0;;;1,0;;2,0;;;;;;;;1,0;3,0;;8,0;6,0;3,0;;;;;;;;;;;;;;;;;2,0;;1,0;;;;;4,0;7,0;1,0;1,0;;;;;;;3,0;;;8,0;;;;2,0;;2,0;;;4,0;;;1,0;1,0;;;;;;;;;;;;;;5,0;4,0;;;;;2,0;;;;;;;;;;;;;;10,0;;;1,0;3,0;;3,0;;;;;;;;;;;;;;;;;;8,0;;17,0;;;7,0;14,0;;34,0;2,0;;;;;;;;;;;;;;;;2,0;2,0;;;;;;;;;;;;;;;;;;;;;;;;;;;;;;;;;;;;;;;4,0;;12,0;;;;10,0;21,0;;;;;;;;;;1,0;;;;;;;;2,0;;;;;;;;;;;9,0;;;16,0;;5,0;;;;;;;;;;;;9,0;;;;;;;;;4,0;;;;38,0;;;;;;;;;;;;;;27,0;;;;;;;;;;;;;;;;;;;;;;;;2,0;;;;;;;;;;;;;;;;3,0;;;;;;14,0;18,0;;;;33,0;1,0;1,0;;;1,0;3,0;;;;27,0;16,0;;;;;;;;;;3,0;;;;;;1,0;;;;47,0;;;;;3,0;;;;;;;;;;;;;;;;5,0;;;;;;;2,0;;;;;;;;;1,0;;;;;;;;;;;;;;;;;;;;;;;;;;;;;;;;;;;;;;;;;7,0;;;;;;;;;;;;;;8,0;;;;;;;;;;;;;;;;;;;;;;;;;;;;;;1,0;1,0;;1,0;;2,0;;1,0;12,0;;;;;;;;;;;;2,0;;48,0;;;;;;;;;;;;;;;;;;;;;;;;;;;;;;;;;;;;1,0;;;;;;;;;;;;;;;;;;;2,0;;;;;;;;;;;;;;;;3,0;;;;;;;;;;;;2,0;;;;;;;;;;;;;;;;1,0;1,0;;;17,0;;;;;;;;;1,0;;;;;;;;;;;;;;;;;;;;;;6,0;;;;;
noise;;;8,0;3,0;37,0;;;26,0;17,0;8,0;;3,0;;5,0;40,0;2,0;1,0;;53,0;1,0;3,0;23,0;;55,0;23,0;;;74,0;21,0;7,0;5,0;32,0;63,0;2,0;10,0;;;;;;1,0;;4,0;;8,0;3,0;2,0;;;4,0;10,0;39,0;2,0;6,0;;183,0;57,0;2,0;3,0;;;;73,0;;4,0;1,0;;;7,0;7,0;1,0;1,0;;;;3,0;;5,0;9,0;2,0;2,0;72,0;8,0;;1,0;;2,0;;;6,0;15,0;2,0;;112,0;;5,0;;1,0;5,0;;;12,0;;;2,0;;5,0;92,0;2,0;;4,0;;1,0;4,0;;4,0;;;;;;;;13,0;;2,0;16,0;;9,0;6,0;;;;;;3,0;;;;;2,0;;2,0;;47,0;;2,0;31,0;;;;;;;1,0;;;1,0;7,0;8,0;;7,0;;;;;47,0;2,0;;;;;5,0;;1,0;;;17,0;;;;;1,0;;;;;18,0;;5,0;;;1,0;;;;;;;;;39,0;;;;2,0;1,0;;;;;1,0;1,0;;2,0;9,0;;;;;1,0;;5,0;1,0;;2,0;1,0;;;;;;1,0;;5,0;;;7,0;3,0;;;;;;;3,0;3,0;;;;4,0;;;1,0;;;;2,0;;;;;;;;;;;;;;;;1,0;;;1,0;;2,0;;;;1,0;4,0;;5,0;1,0;;;;;;;36,0;;;;3,0;;;;;7,0;;;;;13,0;;;2,0;5,0;;;;;;;;;;1,0;;;;4,0;;;;;1,0;;;1,0;;;3,0;1,0;2,0;;;3,0;;;4,0;1,0;;;;11,0;;;2,0;;;3,0;;;;;130,0;;;1,0;2,0;4,0;;;2,0;3,0;;1,0;;1,0;4,0;2,0;1,0;;;;4,0;4,0;;4,0;;;6,0;19,0;;2,0;;3,0;2,0;;;;;22,0;8,0;;;;;2,0;;;;3,0;;;;;;4,0;;;;;3,0;4,0;;1,0;;;1,0;;2,0;1,0;8,0;4,0;1,0;1,0;;;;;1,0;;;;;;;;;1,0;1,0;1,0;;;;2,0;4,0;2,0;;;2,0;;;;2,0;;;1,0;1,0;;;;20,0;;;22,0;;;;;;;;2,0;1,0;;;;;;;;;6,0;4,0;1,0;2,0;;12,0;3,0;;14,0;;;;;4,0;1,0;1,0;;;;;;;;;1,0;;;;;;1,0;;;;1,0;;;3,0;;8,0;1,0;;10,0;;;;10,0;;;;;;;;;;;;;;;;;;2,0;;;15,0;;;6,0;73,0;;;;;;;;;;;;;;;;;;;;;2,0;;;;;;;2,0;;;;;;1,0;5,0;;;3,0;;;;19,0;;;;;2,0;;;;1,0;;;;;;;;;8,0;;3,0;1,0;;;;;;;;;;2,0;;;;;;;;;;;;;7,0;;;;6,0;;;;;;;;4,0;;;;;;;47,0;;;;;;;;;;;;1,0;;;10,0;9,0;23,0;4,0;11,0;6,0;;;;;;3,0;3,0;;5,0;1,0;;;;;;2,0;3,0;;1,0;;1,0;;;4,0;1,0;2,0;;;;;;;1,0;;;;;;;;;;;16,0;;;7,0;;1,0;4,0;;2,0;3,0;;2,0;;;2,0;;156,0;14,0;3,0;;;;;;;;;;10,0;;;;5,0;;2,0;2,0;;;7,0;4,0;8,0;4,0;;;;;;47,0;;;;;;;;;;;;;;;;;1,0;1,0;;;;4,0;;;;;;;;;;3,0;;;;;3,0;;;2,0;;2,0;;;;1,0;;;;;;;;;3,0;;;;;;;;;;;1,0;;;;;;;;;;;12,0;3,0;;;;;;2,0;;;;;;;;;;;;2,0;;;;;;3,0;1,0;;;;;;;;;;;;;;;1,0;;;;;;1,0;;;;;;;;;;;1,0;;;;;;;;;;;3,0;;;;;;3,0;;;;;;;;;;;;;;28,0;;14,0;2,0;;;;;;;;;;;1,0;;;;;;;;;;;2,0;;;;1,0;;;;;;5,0;2,0;;;;;1,0;;;10,0;;;;;;;;;;;;;
object;;;41,0;12,0;132,0;6,0;73,0;542,0;162,0;561,0;53,0;99,0;;1,0;206,0;3,0;3,0;;102,0;73,0;100,0;168,0;160,0;28,0;84,0;21,0;4,0;490,0;23,0;715,0;358,0;639,0;456,0;101,0;118,0;72,0;47,0;140,0;26,0;397,0;493,0;2,0;49,0;364,0;49,0;29,0;4,0;77,0;248,0;25,0;28,0;267,0;4,0;236,0;40,0;4060,0;389,0;6,0;94,0;1624,0;9,0;72,0;631,0;6,0;76,0;6,0;987,0;18,0;5,0;41,0;615,0;444,0;92,0;7,0;6,0;178,0;;408,0;848,0;49,0;7,0;114,0;75,0;39,0;82,0;3,0;251,0;27,0;125,0;155,0;259,0;26,0;125,0;284,0;106,0;53,0;18,0;33,0;94,0;2,0;671,0;766,0;2,0;12,0;20,0;1,0;15,0;834,0;;;43,0;150,0;45,0;29,0;17,0;8,0;8,0;1,0;6,0;23,0;;;21,0;40,0;2,0;3,0;240,0;15,0;39,0;10,0;15,0;12,0;3,0;3,0;13,0;53,0;91,0;;;26,0;6,0;79,0;15,0;285,0;46,0;4,0;318,0;271,0;1,0;5,0;7,0;1,0;33,0;2,0;6,0;9,0;5,0;34,0;94,0;356,0;33,0;15,0;;8,0;25,0;;12,0;528,0;;;49,0;23,0;76,0;30,0;256,0;12,0;5,0;132,0;;1,0;12,0;8,0;22,0;87,0;2,0;75,0;21,0;330,0;2,0;207,0;;;54,0;235,0;14,0;104,0;12,0;;14,0;11,0;;66,0;7,0;1794,0;;94,0;5,0;55,0;22,0;30,0;10,0;4,0;34,0;1,0;15,0;180,0;39,0;10,0;17,0;2,0;14,0;76,0;8,0;36,0;9,0;9,0;44,0;1,0;5,0;8,0;7,0;;5,0;32,0;67,0;96,0;2,0;15,0;476,0;12,0;29,0;;13,0;14,0;;9,0;;3,0;;;;15,0;;12,0;9,0;11,0;3,0;116,0;85,0;;14,0;15,0;51,0;;3,0;1,0;35,0;1,0;;15,0;;25,0;12,0;;9,0;15,0;3,0;;20,0;134,0;;;5,0;18,0;2,0;230,0;170,0;;14,0;2,0;1,0;2,0;7,0;73,0;;16,0;5,0;349,0;5,0;;16,0;;185,0;53,0;7,0;3,0;;92,0;1,0;;122,0;56,0;9,0;1,0;9,0;;2,0;;;2,0;;29,0;2,0;5,0;;81,0;;1,0;6,0;7,0;135,0;15,0;6,0;15,0;;2,0;6,0;9,0;7,0;8,0;11,0;105,0;22,0;42,0;31,0;1,0;29,0;63,0;4,0;95,0;139,0;16,0;44,0;6,0;3,0;8,0;22,0;18,0;1,0;4,0;70,0;34,0;6,0;13,0;287,0;164,0;24,0;30,0;8,0;236,0;101,0;4,0;3,0;215,0;49,0;20,0;15,0;;4,0;43,0;17,0;90,0;11,0;38,0;3,0;11,0;14,0;12,0;21,0;107,0;;28,0;4,0;4,0;15,0;17,0;22,0;534,0;29,0;5,0;428,0;1,0;10,0;4,0;58,0;51,0;361,0;136,0;58,0;5,0;18,0;30,0;;29,0;;121,0;76,0;;54,0;19,0;314,0;19,0;2,0;123,0;68,0;1,0;4,0;12,0;15,0;269,0;43,0;9,0;;;11,0;;1,0;8,0;15,0;;6,0;52,0;3,0;4,0;22,0;59,0;9,0;157,0;31,0;2,0;5,0;20,0;209,0;24,0;;2,0;24,0;;23,0;;18,0;4,0;42,0;17,0;4,0;73,0;40,0;6,0;112,0;;3,0;132,0;3,0;5,0;;38,0;8,0;2,0;53,0;72,0;13,0;86,0;3,0;7,0;4,0;16,0;42,0;28,0;2,0;58,0;6,0;7,0;33,0;3,0;287,0;282,0;8,0;2,0;8,0;8,0;1,0;9,0;8,0;48,0;57,0;10,0;4,0;24,0;;;;;6,0;35,0;17,0;1,0;;6,0;25,0;2,0;;;27,0;6,0;1,0;19,0;31,0;;9,0;13,0;14,0;18,0;31,0;3,0;1,0;2,0;7,0;26,0;4,0;27,0;3,0;52,0;1,0;3,0;12,0;;3,0;2,0;;20,0;59,0;21,0;;4,0;31,0;;32,0;10,0;1,0;65,0;140,0;;3,0;3,0;;20,0;195,0;3,0;2,0;7,0;9,0;23,0;13,0;;;;2,0;2,0;;;3,0;11,0;29,0;17,0;1,0;17,0;;;;16,0;4,0;;3,0;29,0;;5,0;;;18,0;18,0;;;41,0;11,0;;8,0;8,0;13,0;;;;3,0;4,0;;13,0;1,0;10,0;;2,0;6,0;1,0;2,0;4,0;13,0;1,0;;1,0;3,0;8,0;1,0;;2,0;1,0;13,0;13,0;1,0;69,0;;19,0;2,0;3,0;4,0;30,0;;86,0;;;;34,0;1,0;147,0;7,0;;2,0;4,0;1,0;1,0;;13,0;23,0;105,0;;;71,0;12,0;20,0;11,0;;;31,0;;9,0;4,0;;16,0;11,0;;16,0;1,0;3,0;;4,0;24,0;86,0;167,0;;;37,0;;12,0;;103,0;30,0;15,0;3,0;;1,0;9,0;18,0;16,0;34,0;;1,0;32,0;9,0;;;41,0;34,0;73,0;;16,0;3,0;37,0;4,0;6,0;;1,0;12,0;;6,0;17,0;2,0;;1,0;25,0;9,0;5,0;1,0;1,0;8,0;1,0;35,0;8,0;4,0;24,0;22,0;7,0;7,0;;10,0;;5,0;7,0;52,0;2,0;16,0;5,0;37,0;5,0;9,0;13,0;18,0;7,0;22,0;15,0;24,0;82,0;18,0;9,0;5,0;19,0;21,0;22,0;12,0;2,0;12,0;1,0;2,0;2,0;30,0;;2,0;;30,0;9,0;58,0;37,0;5,0;9,0;3,0;2,0;11,0;99,0;26,0;;27,0;48,0;1,0;4,0;2,0;6,0;;35,0;4,0;3,0;;5,0;11,0;20,0;6,0;32,0;;1,0;15,0;15,0;1,0;18,0;24,0;2,0;3,0;7,0;53,0;41,0;;;15,0;;10,0;;;7,0;33,0;2,0;8,0;10,0;;;131,0;22,0;2,0;7,0;55,0;4,0;;;1,0;;3,0;;;18,0;8,0;4,0;9,0;5,0;;2,0;4,0;1,0;1,0;17,0;18,0;27,0;24,0;11,0;34,0;1,0;2,0;9,0;;1,0;3,0;;10,0;;18,0;;;1,0;;;7,0;;3,0;3,0;30,0;;;7,0;1,0;;2,0;;3,0;;;;10,0;9,0;;;3,0;2,0;16,0;1,0;15,0;;9,0;25,0;6,0;4,0;;;3,0;2,0;;12,0;8,0;;8,0;11,0;;17,0;5,0;9,0;4,0;9,0;;6,0;3,0;14,0;;14,0;;4,0;8,0;5,0;3,0;;85,0;11,0;;;;;17,0;;;5,0;;6,0;10,0;4,0;;;26,0;46,0;;3,0;;8,0;;;1,0;4,0;;;;31,0;4,0;5,0;;18,0;;13,0;1,0;13,0;5,0;;5,0;4,0;9,0;;1,0;;3,0;;10,0;5,0;13,0;11,0;1,0;1,0;6,0;1,0;;10,0;3,0;2,0;8,0;;2,0;8,0;;197,0;2,0;;;
observe;;;1,0;;12,0;;4,0;13,0;4,0;5,0;;;;;;2,0;;;1,0;;29,0;4,0;2,0;;;;;2,0;;9,0;15,0;5,0;23,0;;1,0;;;13,0;;58,0;3,0;;;3,0;;;;3,0;;;2,0;8,0;;;5,0;189,0;12,0;;2,0;8,0;;11,0;29,0;;4,0;2,0;6,0;5,0;1,0;4,0;65,0;3,0;9,0;;;1,0;;8,0;6,0;;;11,0;;1,0;;6,0;9,0;;;3,0;;;5,0;2,0;2,0;2,0;;3,0;9,0;3,0;6,0;41,0;;;;;;46,0;;;;2,0;;2,0;;;;;;1,0;;;;;;;2,0;4,0;1,0;;1,0;;;;1,0;1,0;;;;1,0;;;;;;;15,0;20,0;;;;;;;;;1,0;;2,0;16,0;;;;;;;1,0;19,0;;1,0;;6,0;;1,0;4,0;;;17,0;;;1,0;;1,0;2,0;;;4,0;7,0;;3,0;;;5,0;1,0;;3,0;;;;;;;;;;;;;4,0;;1,0;;;;;6,0;;3,0;1,0;;;3,0;;;;2,0;;;;;;;;;2,0;2,0;;1,0;15,0;2,0;;;;;;;1,0;;;;;;;;;;;;2,0;;;;;;;;2,0;;;;;;1,0;;;;;;;;;;;5,0;;6,0;1,0;32,0;1,0;;;;1,0;;;;;4,0;;;;;1,0;1,0;1,0;;;8,0;;;1,0;;;;;;;;;;;1,0;;;;1,0;;;;;14,0;;;;;1,0;;;;;;1,0;;;;;;;;20,0;3,0;1,0;1,0;;;;;;;;;;;;;6,0;;;;11,0;;;;;1,0;;;;;;;1,0;;;1,0;;;;;6,0;;;;;;;;4,0;1,0;;;;;;5,0;1,0;1,0;;;;2,0;6,0;;;;;2,0;;14,0;;2,0;;;;4,0;;;;;9,0;;;;;;;;;;;;;;;;1,0;;;;;1,0;1,0;;1,0;;;;;12,0;;;4,0;;;;1,0;7,0;;;;;3,0;;;;;;;;2,0;;;;;;2,0;11,0;1,0;;4,0;;;;1,0;2,0;15,0;10,0;;;;;;;1,0;;;;;;;;;;;;;;;;;;;;;;;4,0;;;1,0;;;;;;;;;;;;;;;;;;;;;1,0;;;;;;;;;2,0;2,0;;;;;;2,0;;;;;3,0;;;;;;;;;;;41,0;;;;;;;;;;;;;;;;;;;;;13,0;;;;2,0;;;;;;;;;1,0;;;;;;1,0;;;;;;1,0;;;;;1,0;;;1,0;;;;;;;;;;;;2,0;;;;;;;;;;;;;;;;;;;;;;;;;;;;;;;;;;;;2,0;;;;;;;;;1,0;7,0;;;;;;;;;;;;;;;1,0;;;;;2,0;;;;;;;;;;;;;;3,0;;;;;;;;1,0;1,0;;;;;;;;;4,0;8,0;1,0;;;;;;;;;;;;;1,0;2,0;;;;;;1,0;;;;;30,0;;;1,0;;;;13,0;;;;;;2,0;;;;;;;;;;;;;;1,0;;;;;;;;;;;;;1,0;;;;;;;;;;;;;;;3,0;1,0;;;;;1,0;;;;;;;4,0;;;;;;;;;;;4,0;;;;;;;;;;1,0;;;;;;;;;;;;;;;;;;;;;;;;;;1,0;;;1,0;;;;;;;;;;;;;;;;;;;;10,0;1,0;;;;;6,0;;1,0;;2,0;;;;;1,0;;;;;;;;;;;;;2,0;;;;;;;;;;;;;;;;;;;;;;;;;;;;;;;;;;;;;;;;;;;;;;;;;;;;;;;;;;4,0;;
offset;;;43,0;;7,0;;40,0;44,0;17,0;11,0;14,0;;;;20,0;;5,0;1,0;2,0;2,0;2,0;10,0;6,0;16,0;5,0;1,0;;37,0;6,0;7,0;1,0;40,0;31,0;10,0;4,0;;;34,0;2,0;4,0;32,0;;2,0;15,0;5,0;;;1,0;43,0;;1,0;7,0;;3,0;;78,0;8,0;8,0;;19,0;1,0;3,0;35,0;1,0;;5,0;15,0;1,0;7,0;5,0;19,0;4,0;12,0;;;;;1,0;46,0;;;2,0;5,0;2,0;;;8,0;1,0;2,0;9,0;32,0;2,0;;12,0;2,0;12,0;1,0;7,0;15,0;1,0;10,0;14,0;;9,0;;;2,0;22,0;;;1,0;4,0;8,0;;1,0;;;;;4,0;;;;7,0;;;25,0;5,0;3,0;11,0;2,0;1,0;;;1,0;11,0;4,0;;;;;;;2,0;20,0;;7,0;7,0;;;;;2,0;;1,0;2,0;6,0;10,0;;28,0;;2,0;;;;13,0;2,0;1,0;;;2,0;;3,0;7,0;6,0;4,0;;15,0;;;;;;;6,0;8,0;6,0;12,0;9,0;9,0;;;;2,0;;3,0;;;3,0;1,0;1,0;;;6,0;;;;;;1,0;6,0;;;;8,0;37,0;;;;;;5,0;;;;;6,0;;;;2,0;;2,0;2,0;7,0;42,0;;4,0;35,0;;1,0;;8,0;;;;5,0;1,0;2,0;;2,0;;;;;;;13,0;;;2,0;;1,0;;;;4,0;6,0;;;;1,0;;;1,0;;;;;4,0;;;;4,0;;7,0;4,0;13,0;;3,0;5,0;;;7,0;;4,0;;2,0;;;;;19,0;;;;1,0;8,0;;;9,0;13,0;;;;;;;;;;;1,0;;;2,0;;;;1,0;1,0;10,0;1,0;;;3,0;;;1,0;4,0;;3,0;;4,0;;;2,0;1,0;;2,0;2,0;1,0;4,0;1,0;;2,0;;;;;;;;;1,0;2,0;;;;4,0;;7,0;;4,0;14,0;3,0;2,0;4,0;;14,0;2,0;1,0;;;;;;1,0;;;;;2,0;;;1,0;;7,0;2,0;;;;1,0;;6,0;4,0;3,0;2,0;;;7,0;4,0;;;;;7,0;;;2,0;4,0;;;1,0;1,0;;;;2,0;2,0;1,0;;;;;;;;;;;;;;;2,0;;2,0;;;;1,0;20,0;;;;;;;;;;;1,0;;3,0;;;22,0;;;;3,0;;1,0;28,0;1,0;;2,0;;;;;;;4,0;2,0;;;3,0;;;;;1,0;;;1,0;;;;5,0;3,0;1,0;6,0;;;;;;;;;11,0;;;3,0;1,0;;;;;;4,0;;;;;;;;;3,0;;;4,0;;;;;;;;;2,0;;;3,0;;;;;;;;;2,0;;;8,0;22,0;1,0;;;;;14,0;;;;;;;;;;;;2,0;2,0;;;4,0;;6,0;1,0;4,0;;;1,0;;;;;1,0;;;;1,0;;;;5,0;;;;;;;;4,0;;;;2,0;;;;;;;;;4,0;;6,0;3,0;;;;;1,0;1,0;2,0;;;5,0;5,0;;;;3,0;;;;;;1,0;;;;;;;;;;2,0;;1,0;9,0;;;;;;;;;;;;;;25,0;2,0;;;;;8,0;2,0;2,0;4,0;1,0;5,0;;;;;;;14,0;;3,0;;;25,0;;;;;2,0;;2,0;;4,0;;;1,0;;1,0;;21,0;;5,0;6,0;;;;;;;;;;;;;3,0;;6,0;;;;;;3,0;;;;1,0;;11,0;;1,0;;2,0;2,0;;;1,0;;13,0;;2,0;11,0;1,0;;3,0;;;;;;1,0;;2,0;;;;;;7,0;;10,0;;;;1,0;;;;;;;1,0;;;;5,0;1,0;;;1,0;;;;3,0;;;;;;3,0;;;;1,0;;1,0;;;4,0;;;;;4,0;;;1,0;;;;5,0;;;4,0;;4,0;;;;;;;;4,0;;;;;;;;;;;;;;;;;;;;;;;1,0;2,0;;;;;;;;;;6,0;;;;6,0;;3,0;2,0;;;;;;;;;;;;;;;;;;;;;;;2,0;;;;1,0;;;;1,0;;;6,0;;;;;1,0;;;2,0;;;;;;;;;;;;;;;;;;;;;;4,0;;;;4,0;;;;;;;;;;;;;4,0;;;;;;;4,0;;;;;1,0;;6,0;;8,0;;;;;;;;;;;;;;;11,0;;;;;;;;
omega;;;1,0;;;2,0;8,0;;;;4,0;;;;;;;;;;132,0;;;;;;;;;;;;;;;;;1,0;;;2,0;;;128,0;;;;75,0;;;;;;;;9,0;;;147,0;226,0;;;;;;;;;;;19,0;6,0;;;;;;;;;;;;;;;;;1,0;;;;;;;;;;;;30,0;122,0;;;;;;72,0;;;;;;2,0;;;;;;;;;;;;;;;;;;;;;;;;;;;;;;6,0;;;;;;;;;;;;;;;;;47,0;;;;;2,0;;;;;;;;;1,0;;;;;;;;;;;;;;;;;;;;;;66,0;;;;;;;8,0;;;;;;;;;;;;;;;;;;4,0;;;;;;;;;;;;;;205,0;;;;;;;;;;;;;;;;;;;;;;;;1,0;;;;;;;;;;;;;;;;;;;19,0;;;;;;;;;4,0;;4,0;;;;;;;;;;;;;;;;;;;;;;;;;;;;;;;;;;;;;;;;;;;;2,0;;;;;;6,0;;;;;;;;;;;;;;;;;;;;;;;;;;;;;;;;;;;;;;;;;;;;;;;;;;;;;;;;2,0;;;;3,0;;;;;;8,0;;2,0;;;;;;;;;;;;;;;;;;;;;;;;;;;;;;;;;;;;;;;;;;;;;;;;;;;;;;;;;;;;;;;;;;;;;;;;;;;;;;;;;;;;;;;;187,0;;;;;;;;;1,0;;;12,0;;2,0;;;;;;;;;;;;;;;;;;;;;;;;;;;;;;;;;;;;;;;;;;;;;;;;;;;;;;;;;4,0;;;;;;;;;;;;;;;;;;;;;;;;;;;;;;;;;;;;;;;;;;;;;;;;;;;;;;;;;;;;;;;;;;;;;;;;;;;;;;6,0;;;;;;;;;;;;;;;;;;;6,0;;;;;;;;7,0;;4,0;;;;;;;;;;;;;;;;;;;;;;;;;;;;;;;;;;;;;;;;;;;;;;;;;;;;;;;;;;;;;;;;;;;;;;;;;;;158,0;;;;;;;;;;;;;;;;;;;;;;;;;;;;;;;;;;;;;;;;;;;;;;;;;;;;;;;;;;;;;;;;;;;;;;;;;;;;;;;;;;;;;;;;;;;;;;;;;;;;;;;;;;;;;;;;;;172,0;;;;;;;;;;;;;;;;;;;;;;;;;;;;;;;;30,0;;;;;;;;;;;;;;;;;;;;;;;;;;;;;;;;;;;;;;;;;;;;;;;;;;;;;;;;;;;;;;;;;;;;;;;;;;;;;;;;;;;;;;;;;;;;;;;;;;;;;;1,0;;;
opening;;;3,0;;5,0;;4,0;4,0;;;3,0;;2,0;;;;;;2,0;;;;;;;;;;;;1,0;;5,0;1,0;1,0;;;9,0;;;;;;7,0;;;;;;;;;;;;10,0;4,0;;3,0;15,0;;;4,0;;;1,0;;;;;13,0;;2,0;;;;;;8,0;;;;;;;;7,0;;;;1,0;1,0;;;;2,0;;;;10,0;15,0;4,0;;1,0;;;;1,0;;;3,0;8,0;6,0;;7,0;1,0;;;4,0;2,0;;;;4,0;;;2,0;2,0;;;10,0;;;;;1,0;2,0;;8,0;;;;;1,0;3,0;;34,0;;;;;;;7,0;;2,0;12,0;4,0;;2,0;;;5,0;;;28,0;;8,0;;13,0;17,0;;14,0;11,0;;18,0;1,0;;;;;;;;;;5,0;50,0;;11,0;;4,0;;4,0;2,0;;;1,0;1,0;2,0;;4,0;1,0;3,0;1,0;;;;;16,0;;2,0;;;;;;9,0;;;;;;;5,0;;1,0;;;;1,0;;;2,0;;;;;6,0;;1,0;;2,0;3,0;;2,0;4,0;;;;2,0;;9,0;2,0;;;;11,0;;1,0;;;;10,0;;;13,0;;1,0;;;7,0;;;;;;;;;2,0;;;;;;;;;6,0;;;1,0;;;;4,0;1,0;;;;;;1,0;;4,0;;;5,0;1,0;;7,0;;;1,0;;;;4,0;;;;3,0;6,0;;;;;;;;;;;;;;;;;;;;;;;;1,0;1,0;;4,0;;;;;;;;;;;;;;;;;;;;;2,0;;;;;;;;;;2,0;;;;;;;;;;;;;1,0;;;;;;;;;;;;;;;;8,0;2,0;1,0;;;;;;;;;;;;;;;;;;;2,0;;;;;;;;;;;;;;;4,0;;;;;;;;;;;;;;;;;;;;;;;;;;;;;;;1,0;;;1,0;;;;;;;;;;;;;2,0;;;;;;;2,0;;;;;;;;;1,0;;;;;1,0;;;;;;;;;;;;;;;;1,0;;;;;;;;;;;;;1,0;;;;;;;;;;;;;;;;;;;;;;;;;;;;;;;;;1,0;;4,0;;;;;;;3,0;6,0;;;;;1,0;;;;;;1,0;;7,0;;;;;;;;;;;;;;;;;;;;;;;;;;;;;;;;3,0;;;;1,0;;;5,0;;;;;;;;;;2,0;;;3,0;;;2,0;;;;;;;1,0;;;;8,0;;;2,0;;;;;;;;;;;;;;;;;;;;;;;;;;;;;;;;2,0;;;;;;;;;;;;;;;;;;;;;;;;;;;;;;;;;;;;5,0;;;;;;;;;;1,0;;;;;;;;;;;;1,0;;;;;;;;;;;;;;2,0;;;;;;;;;;;;;;;;;;;;;;;;;;;;;;;;;;;;;;;;;;;;;;;;;;;;;;;;;;2,0;;;;;;;;;;;;2,0;;;;;;;;1,0;;;;;;;;;2,0;;;;1,0;;;;;;;2,0;;;;;;4,0;;;;;;;;;;;1,0;;;;;;;;;;;;;;1,0;;;;;;;;;;;;;;2,0;;;2,0;;;;;;;;;;;;;;;;;;;;;;;;;;;;;1,0;;;;;;1,0;;1,0;;;;;;;;;;;;;;;;;;;;;;;;;;;;;;;;;;;;;;;;;;;;
operable;;;5,0;;20,0;;2,0;11,0;8,0;91,0;4,0;3,0;;;1,0;;;;8,0;4,0;5,0;96,0;17,0;2,0;14,0;;;30,0;5,0;25,0;9,0;55,0;94,0;19,0;34,0;;4,0;19,0;11,0;41,0;9,0;;21,0;25,0;2,0;17,0;;;9,0;7,0;2,0;37,0;19,0;14,0;;267,0;43,0;;2,0;18,0;;;15,0;4,0;4,0;9,0;35,0;;1,0;15,0;22,0;1,0;7,0;1,0;;;;24,0;72,0;11,0;1,0;62,0;53,0;9,0;;;7,0;1,0;2,0;23,0;34,0;1,0;16,0;67,0;14,0;;2,0;27,0;35,0;1,0;4,0;93,0;;31,0;;5,0;;352,0;;;1,0;2,0;11,0;3,0;8,0;1,0;3,0;;;6,0;;5,0;;17,0;1,0;;8,0;4,0;;14,0;5,0;7,0;2,0;;;19,0;4,0;;;2,0;4,0;1,0;3,0;2,0;8,0;;10,0;9,0;1,0;;2,0;;;4,0;20,0;8,0;;16,0;35,0;31,0;12,0;;;;5,0;;8,0;87,0;1,0;8,0;8,0;;23,0;8,0;17,0;2,0;1,0;42,0;;;4,0;5,0;;;13,0;1,0;11,0;44,0;;26,0;1,0;;5,0;44,0;;9,0;;;1,0;10,0;3,0;4,0;1,0;2,0;;5,0;;1,0;;5,0;1,0;1,0;2,0;3,0;13,0;21,0;7,0;4,0;;2,0;1,0;9,0;1,0;5,0;;4,0;3,0;;;;;;3,0;6,0;22,0;4,0;;5,0;40,0;;1,0;;5,0;1,0;5,0;3,0;2,0;;;;36,0;;;4,0;;1,0;;4,0;;;1,0;31,0;3,0;;2,0;;3,0;;;;;4,0;;2,0;;13,0;;1,0;;2,0;;4,0;;21,0;;13,0;16,0;32,0;6,0;;2,0;2,0;3,0;2,0;;;6,0;;;;5,0;;7,0;4,0;6,0;;;4,0;1,0;;26,0;3,0;3,0;;1,0;;;;2,0;1,0;;10,0;;2,0;;18,0;;;5,0;;26,0;1,0;4,0;;;2,0;;31,0;;;;12,0;;;12,0;;16,0;3,0;;24,0;1,0;1,0;4,0;;1,0;;;;;;4,0;4,0;;7,0;14,0;10,0;;;1,0;2,0;13,0;;2,0;13,0;10,0;18,0;5,0;15,0;;1,0;9,0;8,0;;2,0;3,0;2,0;1,0;;1,0;11,0;4,0;;;;15,0;20,0;;8,0;;;2,0;1,0;3,0;;;;4,0;2,0;;5,0;3,0;8,0;;3,0;1,0;7,0;4,0;;26,0;1,0;9,0;1,0;6,0;1,0;20,0;;;10,0;14,0;6,0;3,0;;;;;;;;8,0;3,0;12,0;;;;2,0;22,0;12,0;24,0;1,0;11,0;;6,0;11,0;4,0;;2,0;3,0;1,0;9,0;;1,0;;3,0;8,0;14,0;23,0;1,0;1,0;23,0;;;16,0;3,0;;;7,0;22,0;1,0;1,0;;1,0;1,0;1,0;;;10,0;10,0;9,0;3,0;4,0;;65,0;;;124,0;19,0;;7,0;;;2,0;2,0;;2,0;6,0;;;2,0;;;;;;4,0;14,0;5,0;2,0;;;3,0;3,0;;4,0;;;2,0;2,0;;1,0;3,0;1,0;1,0;2,0;4,0;2,0;;;;;2,0;;3,0;;;1,0;;1,0;5,0;2,0;1,0;;2,0;;;5,0;;;;;7,0;19,0;;1,0;2,0;;;10,0;;;1,0;7,0;11,0;1,0;;;;4,0;;;1,0;;2,0;9,0;;7,0;11,0;;;;4,0;7,0;;;;1,0;17,0;;;;;2,0;;8,0;1,0;4,0;;;3,0;;;;1,0;;;3,0;2,0;;2,0;;1,0;;;;9,0;;;;;4,0;;;;;4,0;3,0;;6,0;1,0;;;;;;;;;;;1,0;;2,0;;1,0;5,0;;1,0;;;2,0;1,0;1,0;;;;;4,0;;;;1,0;;;;;7,0;7,0;;4,0;;;3,0;2,0;;;2,0;;;1,0;6,0;;;4,0;;;;;5,0;9,0;2,0;;2,0;;12,0;;;;5,0;1,0;;15,0;1,0;1,0;;5,0;;;1,0;9,0;;1,0;1,0;;;;;;;1,0;;;;14,0;11,0;;;1,0;;;;;4,0;6,0;;;2,0;17,0;;;;;2,0;;1,0;;1,0;2,0;15,0;;;5,0;;3,0;3,0;1,0;4,0;;;5,0;;1,0;15,0;;;1,0;1,0;11,0;5,0;3,0;;;;;;5,0;2,0;;1,0;12,0;;;;2,0;1,0;;9,0;;1,0;4,0;1,0;2,0;;;;3,0;;;6,0;;2,0;;;;2,0;1,0;;;1,0;;1,0;1,0;8,0;;1,0;;;2,0;;;8,0;;;3,0;6,0;;;;;;1,0;;2,0;1,0;5,0;;3,0;;;1,0;;;;;2,0;1,0;;;3,0;;;;;;;2,0;;;3,0;;13,0;;;;1,0;;;;7,0;;;2,0;;;4,0;;;;1,0;;2,0;1,0;;;;18,0;1,0;;2,0;;;;2,0;;2,0;2,0;;;;2,0;;;3,0;;;3,0;9,0;;;;;;2,0;2,0;;;1,0;4,0;2,0;;;;;2,0;;;2,0;;;;;;;;;;10,0;;;1,0;;1,0;;;;1,0;;;;;;;;;;;;;;;;;;8,0;1,0;;;;;;;;;;;;;2,0;;;1,0;;;;1,0;;;;;;;
optics;;;6,0;1,0;3,0;;9,0;7,0;;16,0;;2,0;;;2,0;2,0;;;28,0;;4,0;31,0;;3,0;;;;12,0;;2,0;11,0;9,0;35,0;;28,0;;8,0;6,0;;6,0;6,0;1,0;14,0;3,0;3,0;;;;34,0;;;6,0;;5,0;;39,0;42,0;;;30,0;;;16,0;;;3,0;;;;;23,0;4,0;28,0;;;;;2,0;23,0;;;7,0;2,0;7,0;;;;;;;37,0;;;2,0;;3,0;1,0;;3,0;2,0;8,0;37,0;;;;;;30,0;;;4,0;17,0;25,0;17,0;6,0;;;;;4,0;;;;5,0;;;20,0;;;8,0;;1,0;;;;40,0;10,0;;;3,0;;;;;10,0;;2,0;4,0;;;;;3,0;;;;;14,0;12,0;120,0;1,0;;;2,0;;;4,0;56,0;;;1,0;3,0;17,0;3,0;6,0;1,0;;2,0;;;;;7,0;;;4,0;5,0;24,0;1,0;70,0;1,0;;12,0;9,0;;7,0;1,0;;;2,0;1,0;2,0;;3,0;;;7,0;;1,0;1,0;;1,0;;;;;1,0;1,0;;;;1,0;1,0;26,0;1,0;9,0;2,0;;;1,0;;;5,0;4,0;12,0;3,0;;;5,0;;6,0;;15,0;;;;1,0;8,0;;;;;;1,0;;;;12,0;;;;23,0;;;;;;;;;;;;;;;1,0;;6,0;;1,0;;;4,0;2,0;15,0;10,0;1,0;1,0;1,0;;1,0;;;;1,0;;4,0;;;;1,0;;1,0;14,0;;;2,0;;2,0;;;;;1,0;;;;;1,0;1,0;;;;;18,0;8,0;;;;;;;;;;;;;;;13,0;;2,0;;;;3,0;;2,0;;4,0;;6,0;;;;;;;;;;;;;;;2,0;;;;;;;2,0;2,0;;;4,0;;;;;;;;1,0;;5,0;;1,0;;;2,0;15,0;;19,0;;;2,0;;;;1,0;;;1,0;;;6,0;;;;;;;;1,0;7,0;;;;;8,0;;;1,0;;4,0;;;;;;1,0;;3,0;;;;;;;3,0;5,0;;1,0;;3,0;;;4,0;;;;16,0;;;;;;;;;;2,0;;5,0;;;4,0;;;1,0;;;;1,0;;1,0;;;1,0;;;;;;2,0;;3,0;;;;11,0;7,0;;;;;;1,0;;2,0;1,0;;3,0;;;;;;1,0;1,0;4,0;;;;;;;1,0;;;;2,0;;;;;;;;;;;;;;;;;;1,0;;;;;;;;;1,0;;;2,0;;;;3,0;1,0;;;;;8,0;;;;;;;3,0;;;;1,0;;;;;2,0;;;;;;;;;;;1,0;;;1,0;;;;6,0;;;;;1,0;;;;;1,0;;;;;;;;3,0;;;;;5,0;5,0;;;;;;;;7,0;3,0;;;22,0;;;2,0;;;;;;;;;;;;;;;;;;;5,0;;;;;;;;;;;;;;;;;;4,0;;;;;;;;1,0;;;;;;;;;;1,0;;;;;;;;;;;;;;;1,0;;3,0;;;;;;;;;;1,0;;8,0;;;;;1,0;;;;;;;;;;;;2,0;;;;;;;2,0;;;;;;;;;;;;4,0;;6,0;2,0;;;;;;;;2,0;;;10,0;;;;;;;;;;;;1,0;;;;;;;;;;;;;;;;;;;1,0;;;1,0;;;;;;1,0;;;;;;;;;4,0;;;6,0;;;6,0;;;;;1,0;;1,0;;;2,0;;1,0;;5,0;1,0;;;;;;;;;;;;;;;;;;;1,0;;;;;;;;;;;;;;1,0;;;;;;;;;;;1,0;;;;;;;;;;;;;;2,0;;;;;;;;;;10,0;;;;3,0;;;;;1,0;;;;;;2,0;;3,0;;;;;;;;;1,0;;;;;;;;;;;;;;;;;;;;;;;;;;;;;2,0;;;;;;;;;;;;;;;;;;6,0;;;;;;;;;;;;;;;
orientation;;;4,0;;41,0;;19,0;59,0;35,0;30,0;4,0;4,0;1,0;;3,0;;1,0;;1,0;14,0;;45,0;34,0;2,0;1,0;;2,0;60,0;5,0;74,0;6,0;149,0;98,0;3,0;37,0;;1,0;28,0;7,0;47,0;9,0;4,0;;54,0;9,0;;4,0;2,0;3,0;;7,0;13,0;;;3,0;211,0;38,0;;6,0;21,0;4,0;;96,0;;25,0;2,0;4,0;;;11,0;15,0;2,0;3,0;;;20,0;;58,0;261,0;;;9,0;13,0;2,0;;2,0;8,0;3,0;13,0;12,0;21,0;1,0;2,0;12,0;15,0;1,0;;5,0;13,0;2,0;48,0;50,0;1,0;;;1,0;;11,0;;;6,0;3,0;3,0;5,0;5,0;;;;2,0;2,0;;2,0;13,0;;;7,0;44,0;1,0;;2,0;4,0;1,0;14,0;;5,0;34,0;4,0;3,0;4,0;1,0;1,0;6,0;;10,0;1,0;2,0;7,0;2,0;2,0;;;1,0;5,0;;2,0;4,0;3,0;23,0;2,0;23,0;;;;;7,0;3,0;9,0;8,0;;2,0;8,0;8,0;87,0;31,0;17,0;7,0;;8,0;;;2,0;;;;;8,0;28,0;30,0;;21,0;;;;24,0;;1,0;;;15,0;6,0;;17,0;;11,0;;;10,0;2,0;6,0;13,0;3,0;1,0;;;2,0;14,0;3,0;;2,0;2,0;2,0;20,0;;3,0;;;2,0;;;;10,0;;2,0;;30,0;35,0;;5,0;8,0;1,0;;2,0;;15,0;2,0;2,0;;;;;;;;2,0;;1,0;;10,0;14,0;;;;8,0;1,0;1,0;;3,0;;;2,0;;1,0;;8,0;2,0;7,0;;;;;;;;10,0;;9,0;15,0;105,0;3,0;2,0;;;;2,0;;2,0;;15,0;;;;;28,0;2,0;1,0;;1,0;8,0;1,0;;21,0;5,0;1,0;;;;2,0;2,0;1,0;;;2,0;;;;1,0;;;;6,0;21,0;26,0;;;;;1,0;1,0;1,0;33,0;;30,0;;6,0;2,0;;;1,0;3,0;48,0;1,0;1,0;3,0;;;;4,0;4,0;;;6,0;;2,0;;33,0;13,0;;3,0;1,0;4,0;;1,0;;11,0;2,0;2,0;2,0;;;10,0;1,0;13,0;1,0;2,0;;;;1,0;;5,0;;15,0;7,0;;;;;28,0;1,0;;7,0;;2,0;2,0;7,0;2,0;32,0;8,0;;11,0;;2,0;13,0;2,0;;3,0;3,0;;22,0;1,0;46,0;;;7,0;5,0;;;;;8,0;2,0;3,0;;;;;;3,0;;;;31,0;;;8,0;13,0;2,0;4,0;1,0;;;;23,0;7,0;;;;;2,0;;;;2,0;;2,0;25,0;;;45,0;;;1,0;8,0;2,0;;5,0;19,0;;;;;1,0;;3,0;1,0;5,0;9,0;;;7,0;;5,0;;;32,0;43,0;5,0;;;4,0;;;1,0;1,0;2,0;5,0;1,0;;;2,0;;1,0;;6,0;3,0;;;;;;;11,0;3,0;12,0;;;1,0;;;;;2,0;;;1,0;;;18,0;6,0;8,0;;4,0;;5,0;;;;;;9,0;1,0;;;3,0;;;1,0;2,0;;1,0;1,0;;3,0;;;;129,0;;;;6,0;1,0;1,0;;;;3,0;;;;;;2,0;;;;;2,0;;8,0;;;;1,0;1,0;;;;2,0;;;;;;4,0;;;1,0;1,0;;;;;;;1,0;;2,0;;1,0;1,0;;;;;;4,0;;1,0;;;2,0;5,0;5,0;;1,0;6,0;;;;;;;;;1,0;;;1,0;;2,0;;;2,0;;;;;9,0;17,0;;;;;;2,0;1,0;;;1,0;2,0;;;;8,0;2,0;;;;;;;;;16,0;;;2,0;;;2,0;;2,0;;;;;14,0;2,0;;;;;;;;;;;1,0;;1,0;;4,0;;;;2,0;;;12,0;10,0;3,0;2,0;;;2,0;;;;;;8,0;;;;;;;;1,0;;4,0;;7,0;;1,0;1,0;;;;;;2,0;6,0;;1,0;3,0;;;;;;;;;;;;;13,0;;8,0;;6,0;9,0;;25,0;;;;2,0;;1,0;;2,0;;3,0;;;;1,0;1,0;4,0;6,0;;;;;23,0;;1,0;;4,0;7,0;;1,0;8,0;2,0;;;;1,0;4,0;;;;;1,0;;1,0;;3,0;;;;;;;2,0;;2,0;5,0;;;;;;2,0;13,0;;5,0;;1,0;;3,0;;5,0;;;;;2,0;;;;2,0;;10,0;1,0;;;;;;1,0;5,0;;;;;;;;;;;;;1,0;;;;;1,0;;;;3,0;1,0;;;;;;;;;;;;;;;;;;;;;9,0;;;;1,0;1,0;;;;;1,0;1,0;;;;8,0;4,0;;;;;;;;;;;;;1,0;;;1,0;4,0;;;6,0;;;4,0;;;;;;;2,0;;;1,0;4,0;2,0;;;;;;;2,0;;6,0;;;2,0;;;5,0;;8,0;;;;;;;;;;;;2,0;;;;2,0;2,0;;;;
overlap;;;3,0;;4,0;;11,0;28,0;1,0;38,0;1,0;4,0;;;6,0;;7,0;;2,0;3,0;8,0;9,0;1,0;5,0;;;;11,0;4,0;6,0;14,0;5,0;29,0;8,0;20,0;;4,0;34,0;3,0;28,0;10,0;;3,0;21,0;1,0;9,0;3,0;4,0;8,0;4,0;2,0;14,0;2,0;1,0;;174,0;17,0;;16,0;19,0;;;31,0;3,0;;2,0;7,0;;;7,0;26,0;;1,0;2,0;;2,0;;8,0;32,0;;;14,0;;;;;51,0;4,0;;8,0;23,0;7,0;3,0;11,0;2,0;3,0;4,0;;1,0;1,0;5,0;35,0;;1,0;;;;24,0;;;;11,0;8,0;;;;;;;;1,0;;;6,0;;;13,0;2,0;1,0;3,0;8,0;4,0;;;1,0;1,0;12,0;3,0;;;;2,0;2,0;2,0;9,0;;18,0;16,0;2,0;;;;2,0;;;;3,0;3,0;6,0;28,0;;;;1,0;;;1,0;11,0;1,0;;17,0;;9,0;1,0;2,0;14,0;1,0;8,0;;;4,0;46,0;1,0;;;10,0;;27,0;;76,0;;;2,0;1,0;4,0;;;;;;;;3,0;6,0;;2,0;2,0;2,0;;;;;;;;51,0;;;;;;;3,0;6,0;;15,0;8,0;;4,0;2,0;;;2,0;21,0;7,0;1,0;11,0;;112,0;;7,0;;11,0;;;1,0;20,0;;2,0;6,0;;;;;;3,0;;4,0;1,0;;;5,0;;;;;2,0;;2,0;;;;;;1,0;3,0;;;;2,0;;;;;;1,0;3,0;7,0;1,0;;;8,0;;8,0;;7,0;;2,0;4,0;;1,0;;19,0;17,0;9,0;;;28,0;1,0;;14,0;3,0;1,0;;5,0;;;;;;2,0;;2,0;1,0;;1,0;2,0;;1,0;;3,0;;;;;;4,0;4,0;1,0;;;2,0;;1,0;;;;2,0;;4,0;3,0;;2,0;4,0;;;4,0;1,0;;;2,0;1,0;;;12,0;;;;3,0;7,0;1,0;;;4,0;3,0;4,0;7,0;;;5,0;38,0;8,0;;;4,0;17,0;;;2,0;3,0;;;2,0;;9,0;;;14,0;;;7,0;;;;;;1,0;;;;;2,0;;5,0;;;1,0;;9,0;;3,0;1,0;;;4,0;;1,0;;;28,0;1,0;6,0;;;;;1,0;;;;;;;;1,0;1,0;3,0;2,0;4,0;;;;63,0;1,0;;;;;;;;;;1,0;;2,0;3,0;;4,0;;;26,0;;;;2,0;3,0;;;;;1,0;;;;2,0;3,0;;;9,0;;;;;34,0;69,0;;;;;;;;;3,0;;;1,0;;3,0;;;;3,0;1,0;5,0;;;;;;;2,0;;3,0;2,0;;;;;;;;;;;2,0;;;;;9,0;;;;;5,0;;;;8,0;1,0;;;;1,0;3,0;;;;13,0;;1,0;;;;2,0;;;;1,0;;;;;;;;;;1,0;;9,0;;;7,0;;;;;;1,0;;;;3,0;;;;;;;4,0;;;;;15,0;;;3,0;3,0;;;;;;;;3,0;3,0;;;3,0;;;;;;;;2,0;1,0;;;;8,0;10,0;;;;;;;;;;3,0;1,0;;1,0;;;;;;1,0;2,0;;;;;;;;;;;;;;;;;4,0;;;;;;;;;1,0;4,0;;;;;;;;6,0;;;;4,0;1,0;2,0;;33,0;;;1,0;15,0;;;;;;1,0;3,0;;2,0;;1,0;3,0;;;;1,0;6,0;;;;;;;;;2,0;8,0;;;;;;;;;;2,0;;8,0;;1,0;2,0;;;;;;;;;;;;1,0;8,0;;10,0;;;;;;;;;5,0;;;;;;2,0;1,0;2,0;;;2,0;;;1,0;4,0;;;;;;;;7,0;;;;1,0;;;5,0;;;;1,0;;;;14,0;;;;;4,0;;;;;1,0;;;;2,0;;;4,0;;;;1,0;3,0;10,0;;;;;;;;;;;1,0;;;11,0;2,0;;3,0;;;;;3,0;20,0;2,0;;;;;;3,0;2,0;1,0;;;1,0;1,0;;;;;;;;;4,0;;1,0;1,0;;;3,0;1,0;;;;;;;;;;;1,0;1,0;;;;;;;;;;;;;;;;;;;1,0;;1,0;;;;;;;;;;1,0;8,0;;;;12,0;;;;;3,0;;;;;;;;;;;3,0;;;;2,0;;;;;;;;;;;;;;;;1,0;;;;;;;;;;;;;;;;4,0;;;;;;2,0;;;;;;;;;1,0;
package;;;1,0;;;1,0;5,0;4,0;;1,0;;2,0;;;1,0;6,0;;;8,0;;;2,0;;;;;;3,0;;;;;32,0;;19,0;1,0;6,0;1,0;;;;;;7,0;;;;;;;2,0;1,0;;;1,0;167,0;49,0;;1,0;74,0;;;35,0;;;;9,0;;;1,0;4,0;;2,0;1,0;1,0;;;1,0;3,0;;2,0;3,0;;;;;1,0;;;4,0;154,0;;;;5,0;2,0;;;3,0;48,0;16,0;9,0;;;;;8,0;8,0;;3,0;;;;9,0;16,0;;;;14,0;4,0;8,0;;2,0;3,0;;;4,0;7,0;;4,0;5,0;;;8,0;;;8,0;;;;;;4,0;2,0;6,0;;19,0;4,0;;8,0;;;;;;16,0;4,0;24,0;1,0;10,0;;;3,0;2,0;;5,0;1,0;8,0;1,0;11,0;4,0;1,0;124,0;26,0;3,0;3,0;7,0;2,0;;;1,0;;;;;;1,0;10,0;;15,0;;;;7,0;;;;;;2,0;11,0;6,0;;3,0;;;;;2,0;4,0;;3,0;;;;1,0;1,0;2,0;;;10,0;;;;;;3,0;;;1,0;2,0;;;1,0;1,0;;;1,0;3,0;;7,0;;;2,0;3,0;;;103,0;;;;;11,0;18,0;;;1,0;1,0;;;;;;;2,0;;1,0;;;;;;2,0;;;;;;;;4,0;;;;13,0;;5,0;;;1,0;;;;2,0;;;;;;;;;;2,0;;;;3,0;;3,0;;1,0;;;;;;;;12,0;1,0;;;4,0;;;;3,0;1,0;;;;;;;;;1,0;;;;;;;;;;;1,0;1,0;;;;;;;;;;;;;;;3,0;;;;3,0;;2,0;;;;;;;;;;;3,0;2,0;1,0;;;;;;;;;;;3,0;;;1,0;;;2,0;;2,0;;;;;;;;;;16,0;;;;2,0;;1,0;1,0;;;;;;;;;;;;;;;;;;1,0;;;;;;1,0;;;;;;;;;;;;;;;;;;;;;;;1,0;;;;;1,0;;;;;;;;;;;;;;;;;;1,0;;;1,0;;;;;;2,0;;;;;;;7,0;;;;;3,0;;;1,0;1,0;4,0;;;;;;;;1,0;;;;;;;;;;;;;;;1,0;;;3,0;;2,0;2,0;;;5,0;;;;;;;;;;;;;;;;;;;1,0;;;;;;;;2,0;;;1,0;7,0;3,0;;;;;;2,0;;;;;;14,0;;;2,0;;3,0;;;;;;;;;;;;;;;;;;;;;;;;;;;1,0;;;;;;;;7,0;;;;5,0;;1,0;;1,0;;;2,0;;;;;1,0;;;;9,0;1,0;;;;;;;;;;;;;;;;;;;;;5,0;;;2,0;;;;;;2,0;;;;;;;;;1,0;;;;;;1,0;2,0;;;;;;;;;;;6,0;;;;;;;;;;;;;;;;;;;;;;;;;;;1,0;;1,0;;;;;;4,0;;;;;;;;;;;;;;;;;;;;;1,0;;;;4,0;;;;;;12,0;;;;;;;;;;;;;;;;;;;;;;;;;;;;;;;;;;;;;;;;;;;;;;;1,0;;;;;11,0;1,0;;;;;;;1,0;;2,0;;;;;1,0;;;;;;;;;;;;;;;;;;;;;4,0;;;;;;;6,0;;;;;;1,0;;;;2,0;;;;;1,0;;3,0;;;;;;;;;3,0;;;;;;;;;;;;;;;;;;;;;;;;;11,0;;;;;;;;;;;;;;;;;;;;;4,0;;2,0;;;;;;;;1,0;1,0;;;;;;;;;;;;;;;;;;;;;;;;;;;;;;;;;;;;;;;;;;1,0;;;;
packet;;;1,0;;8,0;;;;;;;;;;17,0;;;;8,0;;;5,0;;;;;;56,0;;;;2,0;16,0;;3,0;;;1,0;;;;;4,0;10,0;;;;;;1,0;;20,0;;;;25,0;61,0;;;;;;12,0;;;;;;;;1,0;;;;;;;;;;;4,0;;1,0;;;;;2,0;;6,0;;;142,0;;;;;8,0;;;3,0;;107,0;;;14,0;70,0;;;;;;;;;;;;;;;;;;;1,0;;;;;;;;;;;;2,0;;;;4,0;;;;1,0;;;;;;;;25,0;15,0;;;;13,0;;;;;;;12,0;;;;;;;;;;;1,0;2,0;;;;;;;;;42,0;;;;;;3,0;;;;;;;;;;;;;5,0;;;;;;;;;;11,0;;;;;;;;;;;;;;;;;;;;;;;;;;;;;;4,0;;;;70,0;;;;;;;;;;;8,0;;;;;;;;;;;;4,0;;;;;;;;;;;;;;;;;;;;;;;;;;;;;;;;;;;;;;3,0;;;;;;;;;;;;;;2,0;;;;;;;;;;;;;;;;1,0;;;;;;;;2,0;;;;;;;;;;;;;;;;;;;;;;;;;;6,0;;14,0;;;2,0;;;;;;;;;;;3,0;;1,0;;1,0;;;4,0;;;;;;;;;;;;;;;;;;;;;;;;4,0;;14,0;;;5,0;;;;;;;;;;;;;;;;;;;;12,0;;;;;;;;;;;;2,0;;;;;;;;;;5,0;;4,0;;;1,0;;;;;1,0;1,0;1,0;;;;;;;;;;;;;4,0;;;;;;;4,0;;;;;;;;;;;;;5,0;;;;;;;;;;;;;;;;;;;;;;;;;;;;;;;;;;;;;;;;7,0;;10,0;;;;2,0;;;;;;;;;;;;;6,0;;;;;;;;;;;1,0;1,0;;;;;;;;;;45,0;;;;;;;;;;;;;;;;;;;2,0;;;;;;;;;4,0;;;;;3,0;;;;;;;;;;;;;;;;;;;;;;;;;;;;;;;;;;2,0;;;;;;;;;;;;29,0;;;;;;;;4,0;;;;;;;;;;1,0;;;;;39,0;1,0;;;;;;;;;;;1,0;;3,0;;;;;;;;;;;;3,0;;;;5,0;;;;;2,0;;;;;;;;;;;;;2,0;;;;;;;;;;;;;;;;;;;;;;;;;;;;;;;;;;;;;;;;;;;;;;;;;1,0;;;;;;;;;;;;;;;;;;;;;;;;;;;;;;;;;;;;;;;;;;;;;;;;;1,0;;;;;;;;;;;;;;;;;;;;;;;;;;;;;;;;;;;;;;;;;;;;;;;;;2,0;;;;6,0;;;;;;;;;;;;;;;;;;;;;;;;;;;;;;;;;;;;;;;;;;;;;;;;;;;;;1,0;;;;;;;;;;;;;;;;;;;;;;;;;;;;;;;;;;;;;;;;;;;;;;;;;;
parallax;;;2,0;;2,0;;3,0;61,0;24,0;;;;;;;;1,0;;;;;1,0;;21,0;11,0;1,0;;5,0;9,0;1,0;1,0;9,0;1,0;;;3,0;;;6,0;42,0;7,0;;4,0;4,0;31,0;17,0;;;1,0;;;1,0;;;;84,0;7,0;;;10,0;;;6,0;;;;;;;1,0;2,0;1,0;2,0;;;1,0;;57,0;6,0;2,0;;1,0;;;;;;;13,0;;16,0;3,0;;16,0;2,0;1,0;;4,0;1,0;1,0;;9,0;;;;;;16,0;;;;1,0;;;;;;;;;;;;;;;6,0;;;3,0;;1,0;;;;;;;;;;;;;;;3,0;3,0;;;;;;;;;;;;18,0;;1,0;;;2,0;;;5,0;;;;;17,0;;;;;1,0;;;;;;1,0;;6,0;1,0;15,0;;41,0;;;;9,0;;;;;1,0;;;;;;;;;;;;;;;;;20,0;;;;;;;;1,0;;;1,0;;;;;;;;2,0;7,0;;;3,0;;;;23,0;;;;;;;;;;;;;;;;;;9,0;;;;;;;;;;;;;;;;;;30,0;;;;;1,0;;;;11,0;;;;;;;;;;5,0;;;;;6,0;;;;;1,0;;;;2,0;;;;;;;;;;;;;;;;;;2,0;;;;;;;;3,0;;;;2,0;;;;;;1,0;;;;;62,0;;;1,0;;1,0;;;;;;;;6,0;;;;;;;;;;;1,0;;;;;6,0;;;;;;;;1,0;;;;;;;;8,0;;;;;;;;;;;;;;;;1,0;;;;;;1,0;2,0;;;;;;;3,0;2,0;5,0;;;;;;;;;;;;;;;;;;;;;;;2,0;;;;;;;;;;;16,0;;;;;2,0;;1,0;7,0;;;;;;;1,0;1,0;6,0;;;;;;;;;;;;;;;6,0;;;;;;2,0;;;;;;;;;;;;;;;;;;;;;;;;;;;;;;3,0;;;;;;;;;;;;;;;;;;;2,0;;;;;;;;;4,0;3,0;2,0;;;;;1,0;;;;;;;;;;;;;;;;2,0;;;;;;;;;;;;;;;;;;;;;;;;;;;;;;;;1,0;;;;;;;;;1,0;;;;;;;;;;4,0;;;1,0;;;;;;;;1,0;;;;;;;;;;;;;;;;;;;;;;;;;;;;;;1,0;;;;;;;;;;;;;;;;;;;;;;;;;2,0;;;;;;;;;;;;;;;;;;;;;;;;1,0;;;;;;;;;;;;;;13,0;;;;;;;;;;;;;;;35,0;;;;;;;;;;;;;;;;;;1,0;;;;;;;;1,0;;;;;;;;;;;;;;;;;;;;;;;;;;;;;;;;16,0;;;;;;;;;;;;2,0;;;;;;;;6,0;;;;;;;;;;;;;;;;;;;;;;;3,0;;;;;;;;;;;;;;;;;;;;;;;;;;;;;;;;;;;;;;;;;;;;;;;;;;;;;;;;;1,0;;1,0;;;;;;;;;;;1,0;;;;;;;;;;;;;1,0;;;;;26,0;;;;;;;;;;;;;;;;;;;;;;;;;;;;;;;;;;;;;;;;;;;;;;;;;;;;;;;;;;
parallel;;;4,0;;19,0;;338,0;46,0;5,0;21,0;28,0;8,0;;;1,0;1,0;;;6,0;;3,0;15,0;18,0;1,0;;;4,0;60,0;5,0;9,0;16,0;6,0;60,0;;17,0;3,0;3,0;247,0;4,0;43,0;17,0;1,0;31,0;20,0;;1,0;3,0;6,0;4,0;2,0;4,0;26,0;10,0;6,0;2,0;183,0;62,0;;11,0;124,0;5,0;1,0;37,0;2,0;;12,0;27,0;1,0;4,0;14,0;215,0;;22,0;;3,0;1,0;2,0;39,0;49,0;4,0;;30,0;26,0;4,0;;2,0;15,0;4,0;3,0;21,0;30,0;;5,0;26,0;1,0;32,0;2,0;2,0;9,0;30,0;223,0;40,0;;11,0;;;;39,0;;;9,0;68,0;17,0;6,0;3,0;;10,0;;28,0;13,0;;3,0;6,0;23,0;;3,0;23,0;18,0;;5,0;6,0;1,0;;19,0;;5,0;63,0;;26,0;3,0;;;2,0;28,0;22,0;8,0;49,0;34,0;3,0;3,0;;29,0;27,0;;23,0;3,0;15,0;14,0;4,0;60,0;4,0;1,0;12,0;4,0;;7,0;3,0;75,0;4,0;;151,0;23,0;28,0;45,0;32,0;16,0;15,0;20,0;;2,0;12,0;;21,0;1,0;5,0;219,0;95,0;71,0;2,0;104,0;2,0;3,0;5,0;18,0;11,0;5,0;;;24,0;4,0;5,0;21,0;1,0;72,0;2,0;6,0;6,0;32,0;11,0;104,0;2,0;14,0;;4,0;3,0;12,0;2,0;3,0;9,0;4,0;16,0;7,0;20,0;;7,0;;6,0;3,0;7,0;;;;4,0;18,0;1,0;23,0;1,0;14,0;22,0;3,0;7,0;9,0;16,0;22,0;2,0;3,0;1,0;6,0;3,0;20,0;17,0;5,0;3,0;63,0;1,0;;;35,0;;7,0;2,0;12,0;47,0;4,0;7,0;4,0;94,0;2,0;;10,0;;12,0;6,0;6,0;7,0;13,0;;5,0;3,0;4,0;7,0;6,0;1,0;8,0;;25,0;48,0;43,0;8,0;6,0;4,0;4,0;5,0;7,0;1,0;19,0;;2,0;11,0;1,0;1,0;3,0;18,0;3,0;32,0;3,0;13,0;15,0;4,0;5,0;34,0;8,0;1,0;;;;10,0;;3,0;;5,0;1,0;40,0;14,0;;17,0;;7,0;;10,0;7,0;;;1,0;;;5,0;;3,0;4,0;13,0;6,0;;4,0;4,0;1,0;1,0;7,0;;5,0;3,0;;9,0;5,0;;;;;;;;;;1,0;10,0;;;;4,0;;2,0;1,0;;1,0;1,0;14,0;4,0;;;;3,0;7,0;;1,0;;3,0;1,0;9,0;;2,0;;3,0;23,0;;;20,0;5,0;4,0;1,0;;4,0;;2,0;;11,0;;1,0;;;1,0;15,0;;2,0;3,0;;;3,0;;6,0;31,0;6,0;;;6,0;1,0;2,0;;6,0;;2,0;4,0;;;;;2,0;1,0;7,0;;3,0;;;2,0;2,0;5,0;6,0;6,0;5,0;4,0;2,0;;15,0;20,0;3,0;1,0;1,0;;;2,0;;;;;;3,0;1,0;46,0;;2,0;;2,0;22,0;7,0;;2,0;;3,0;;;;;3,0;;4,0;;12,0;3,0;;;;;25,0;;;5,0;19,0;1,0;7,0;1,0;1,0;1,0;;;;1,0;3,0;;5,0;;4,0;;;;3,0;24,0;1,0;27,0;;;;;;11,0;1,0;;4,0;2,0;3,0;;;;;1,0;;;;10,0;1,0;;;;;;1,0;;;10,0;;;1,0;2,0;;;;;;1,0;;1,0;6,0;11,0;1,0;9,0;;1,0;;9,0;;;;2,0;2,0;;;10,0;;24,0;;;2,0;;5,0;4,0;1,0;;10,0;1,0;;;;;;;;2,0;;9,0;;;5,0;;;3,0;;1,0;;;5,0;32,0;2,0;;3,0;1,0;;;;6,0;;;1,0;;;;6,0;;;;;2,0;;;5,0;1,0;2,0;1,0;;47,0;3,0;1,0;2,0;1,0;1,0;9,0;;1,0;3,0;;1,0;1,0;1,0;1,0;1,0;;2,0;;1,0;1,0;;14,0;16,0;10,0;;;1,0;4,0;;;1,0;;37,0;;;;1,0;17,0;;;;;;29,0;;1,0;;9,0;17,0;;1,0;;;;22,0;;;1,0;;2,0;12,0;;4,0;;;8,0;;10,0;7,0;;;;19,0;;2,0;;7,0;;;6,0;4,0;;;;2,0;4,0;;;;;;1,0;;;5,0;;;2,0;;1,0;3,0;6,0;;;;;;2,0;3,0;12,0;3,0;;;4,0;;1,0;3,0;;1,0;;7,0;5,0;21,0;;;;;;;;12,0;;1,0;1,0;1,0;;;;14,0;;6,0;4,0;;;;;;;3,0;1,0;1,0;;;;6,0;;4,0;3,0;;;2,0;;2,0;3,0;;1,0;;;;;3,0;11,0;;21,0;;;2,0;2,0;;;;2,0;;;;;;;2,0;;1,0;7,0;;12,0;6,0;;2,0;6,0;;1,0;;;;;1,0;2,0;;;;;;;10,0;;;8,0;;;;;1,0;6,0;2,0;2,0;;3,0;3,0;;;;;;;;;2,0;;4,0;;;;2,0;1,0;4,0;3,0;;8,0;;;1,0;;1,0;;;1,0;;;;;3,0;;;;;3,0;;;;;2,0;3,0;;;4,0;;;1,0;8,0;2,0;;;1,0;1,0;;1,0;1,0;;10,0;2,0;2,0;;;;;;;;;;2,0;;;3,0;;8,0;;;;;5,0;;;;1,0;1,0;;10,0;;1,0;2,0;;3,0;4,0;;1,0;;;;;;4,0;;;2,0;3,0;;;;;3,0;2,0;;;;;3,0;2,0;;;1,0;;;;;;;;;;;;;
parameter;;;30,0;4,0;85,0;4,0;6,0;303,0;139,0;140,0;16,0;39,0;4,0;9,0;56,0;5,0;33,0;188,0;7,0;28,0;39,0;142,0;129,0;40,0;41,0;4,0;;156,0;17,0;88,0;43,0;269,0;108,0;11,0;82,0;6,0;3,0;39,0;29,0;42,0;41,0;82,0;3,0;11,0;29,0;6,0;4,0;25,0;60,0;12,0;21,0;80,0;;15,0;4,0;706,0;192,0;14,0;36,0;53,0;;1,0;239,0;4,0;33,0;;6,0;;3,0;25,0;40,0;13,0;32,0;;;;;54,0;110,0;2,0;;62,0;67,0;7,0;12,0;;37,0;;43,0;84,0;27,0;;31,0;56,0;14,0;3,0;8,0;59,0;154,0;;1,0;111,0;;1,0;11,0;;8,0;206,0;;;3,0;5,0;9,0;8,0;1,0;35,0;;;;2,0;;4,0;16,0;21,0;;5,0;108,0;;22,0;4,0;28,0;2,0;;;5,0;10,0;;;;;5,0;3,0;22,0;38,0;8,0;;10,0;51,0;;;;;;;4,0;4,0;;;3,0;168,0;;13,0;;1,0;10,0;;33,0;27,0;2,0;2,0;1,0;9,0;33,0;2,0;15,0;2,0;;42,0;;;;6,0;1,0;;;27,0;;226,0;3,0;16,0;;;;71,0;;1,0;1,0;;24,0;;;9,0;;4,0;;17,0;12,0;;7,0;2,0;8,0;2,0;13,0;;26,0;48,0;34,0;;;;1,0;19,0;;3,0;;;4,0;;;;;;;5,0;100,0;24,0;;14,0;11,0;;;;34,0;;;2,0;8,0;;;;4,0;58,0;;13,0;;2,0;;35,0;7,0;;10,0;17,0;7,0;;;;;;;;;4,0;;1,0;14,0;9,0;2,0;;3,0;4,0;1,0;;1,0;5,0;;31,0;1,0;112,0;22,0;;5,0;;4,0;15,0;;;;42,0;3,0;;2,0;;62,0;2,0;8,0;;;23,0;;;48,0;13,0;;;2,0;;;;;;11,0;7,0;;;;11,0;;;;51,0;31,0;8,0;4,0;;;;5,0;6,0;3,0;1,0;;103,0;2,0;17,0;6,0;;48,0;4,0;;81,0;2,0;6,0;37,0;1,0;;9,0;11,0;3,0;13,0;;48,0;28,0;;;37,0;115,0;;4,0;6,0;12,0;;;7,0;35,0;27,0;40,0;7,0;20,0;;2,0;20,0;3,0;2,0;19,0;;2,0;6,0;4,0;10,0;69,0;1,0;17,0;1,0;;11,0;7,0;1,0;23,0;18,0;;15,0;;8,0;12,0;23,0;1,0;29,0;76,0;5,0;;6,0;4,0;1,0;19,0;;7,0;12,0;;32,0;3,0;42,0;;;5,0;20,0;;4,0;18,0;5,0;46,0;7,0;2,0;;;3,0;;1,0;5,0;4,0;12,0;;2,0;;1,0;8,0;14,0;1,0;6,0;5,0;3,0;;3,0;19,0;48,0;;;6,0;;6,0;;2,0;13,0;;4,0;;36,0;2,0;5,0;;;;39,0;;;;39,0;18,0;;1,0;;25,0;21,0;5,0;9,0;3,0;;2,0;9,0;1,0;161,0;;3,0;4,0;1,0;101,0;43,0;;3,0;;;2,0;4,0;1,0;3,0;8,0;1,0;4,0;;3,0;;;;;13,0;2,0;3,0;;3,0;4,0;;;;47,0;;2,0;3,0;1,0;;1,0;;;8,0;4,0;;11,0;12,0;;5,0;;2,0;;5,0;;;1,0;;1,0;2,0;;;11,0;3,0;;10,0;1,0;;23,0;1,0;;43,0;66,0;2,0;12,0;11,0;;3,0;21,0;;;12,0;5,0;5,0;1,0;;;;;1,0;;;;;12,0;6,0;6,0;3,0;;;;90,0;;;;1,0;;;;;6,0;;1,0;;149,0;;;1,0;;27,0;;;;3,0;;7,0;;2,0;1,0;;;1,0;;;2,0;;1,0;;;;3,0;;;;4,0;23,0;9,0;;3,0;;23,0;;9,0;2,0;;;;10,0;;14,0;;;101,0;1,0;1,0;;;;;;22,0;;45,0;;;4,0;;2,0;4,0;;;9,0;;;4,0;3,0;18,0;1,0;;4,0;;;;1,0;6,0;31,0;89,0;;;2,0;5,0;19,0;;;2,0;;19,0;;;20,0;12,0;;4,0;1,0;1,0;;;;;9,0;12,0;39,0;;2,0;2,0;1,0;5,0;;;;1,0;;;2,0;;1,0;;2,0;;;;;6,0;;11,0;3,0;;1,0;;4,0;5,0;3,0;3,0;;;1,0;;3,0;7,0;12,0;6,0;;;;9,0;18,0;;25,0;147,0;50,0;;;2,0;13,0;18,0;18,0;3,0;;;;2,0;2,0;6,0;;;;;1,0;;;;1,0;;1,0;2,0;;4,0;5,0;;4,0;2,0;;;;17,0;;5,0;;;;3,0;;7,0;;;;;;;;3,0;7,0;;5,0;17,0;5,0;;;1,0;;5,0;;;;17,0;;14,0;;;;1,0;20,0;;2,0;15,0;;;;2,0;2,0;3,0;;;;11,0;1,0;;;;1,0;;;1,0;13,0;4,0;3,0;9,0;;;1,0;1,0;;;1,0;;;;;3,0;;7,0;;1,0;;6,0;;;;;;10,0;3,0;;;;;;;;;;;;;6,0;;4,0;;9,0;2,0;4,0;;58,0;;;;;;;3,0;1,0;6,0;;;;3,0;2,0;1,0;;;;;;8,0;;;;1,0;;3,0;1,0;;1,0;31,0;;;1,0;2,0;3,0;;;;;;10,0;27,0;;;;1,0;;3,0;;;;;;;1,0;;;1,0;;;1,0;;;;;;;7,0;;4,0;1,0;;;;;;;;3,0;;;1,0;;;;2,0;;8,0;4,0;;;;;;;;;
partial;;;14,0;;10,0;;1,0;24,0;14,0;17,0;1,0;14,0;;4,0;25,0;;;;16,0;;;;;7,0;4,0;;;35,0;1,0;9,0;2,0;10,0;14,0;7,0;19,0;;;2,0;4,0;8,0;2,0;;;8,0;2,0;;;3,0;1,0;4,0;2,0;13,0;1,0;;;415,0;22,0;;1,0;1,0;1,0;;20,0;1,0;2,0;;1,0;;3,0;;12,0;1,0;5,0;;;;;3,0;12,0;;;6,0;1,0;4,0;;;105,0;;;14,0;10,0;1,0;;22,0;2,0;;;;4,0;;12,0;8,0;;2,0;1,0;1,0;;27,0;;;1,0;2,0;2,0;;;;;;;1,0;;;;1,0;;1,0;7,0;;;;24,0;;;4,0;1,0;;9,0;;;1,0;4,0;;;;4,0;;16,0;63,0;2,0;;;;1,0;;;;;5,0;2,0;13,0;;1,0;;;;;10,0;1,0;;;;;3,0;;3,0;2,0;;37,0;;;4,0;;;;;7,0;;92,0;;19,0;;;1,0;6,0;;1,0;;;;;;4,0;;1,0;;;;;;3,0;5,0;;;;1,0;2,0;;;;;2,0;;;;;;;;;;;;;5,0;4,0;;3,0;3,0;119,0;;;;21,0;;;;;;;;;;;4,0;;;;2,0;;;6,0;;3,0;;;;1,0;;;;;;;;;;;;2,0;2,0;;;;1,0;1,0;4,0;;9,0;1,0;;;;15,0;;;;2,0;3,0;;;;;5,0;4,0;4,0;;;3,0;;;8,0;5,0;;;3,0;;;;;1,0;;14,0;;;;4,0;;;;2,0;;;;;;4,0;;;;;;2,0;;;;17,0;;;;1,0;;;5,0;;;;;;;;;14,0;;;;10,0;;1,0;;;;;;7,0;1,0;4,0;1,0;1,0;;10,0;1,0;4,0;;1,0;;;;1,0;2,0;;;2,0;;;;1,0;;3,0;4,0;;2,0;;;;8,0;;;1,0;1,0;;;2,0;;29,0;;;1,0;;4,0;;;;;1,0;1,0;;;4,0;1,0;6,0;7,0;3,0;;;;;;;;;;;;;;3,0;;1,0;9,0;3,0;;;;;;;;;;;;1,0;;1,0;;;;;;;2,0;7,0;;;;4,0;;;;;;;;;;4,0;6,0;;2,0;3,0;;1,0;;;15,0;2,0;;;;;;;;;;;;;;;;;2,0;1,0;1,0;;;;;;;;;;;;1,0;;2,0;;;;3,0;4,0;;;;;;;;8,0;;;;;;;;;9,0;;;2,0;1,0;;;;;2,0;38,0;;;;;;;;1,0;;;4,0;;;;;;2,0;;;;;8,0;;;;;;;;;;;;;2,0;;;;;;;3,0;;;;;1,0;;;;;;;;;;;;;;;1,0;;;;;;;;;;;2,0;;;20,0;;;;;2,0;;;;;;;1,0;;44,0;;;;;;1,0;;2,0;;;1,0;;;;;;;;3,0;;;;;6,0;;;3,0;;;;;1,0;3,0;;;;;;;;;4,0;2,0;;;;3,0;16,0;21,0;13,0;;;;;;;;;18,0;;4,0;;6,0;;;;;;;;;;3,0;;;;;;;;;7,0;;1,0;;2,0;;;;4,0;;;1,0;;;1,0;1,0;;4,0;;;4,0;;12,0;;;;1,0;;;1,0;;;;;;;;;1,0;;;;;;12,0;;;1,0;;;;;;;1,0;;;;2,0;;;;;;;;3,0;;;;;2,0;;;;;;;;;;;;;;;;;;;;;;;;;;;;2,0;1,0;;;1,0;;;;;;;7,0;;;;2,0;;5,0;;;;13,0;;;;;;;;4,0;;2,0;;;;;;;;;;;;;;;;;;;;;;;;;;;;;;;;2,0;;;;;;;;;;;;;;;;;;;;;;;;;;;6,0;;;4,0;;;;;;;12,0;;;;;2,0;;;;;;;;;7,0;;6,0;;;;;;;;;;;;;;;;;;;;;;;;;;;;;;;;9,0;;;;;;;;;;;;;2,0;;;;;;;
participant;;;1,0;1,0;8,0;;;1,0;;7,0;;;;;;;;;;;;25,0;;;;;;;;;3,0;21,0;1,0;;;;;1,0;;12,0;;;;1,0;;;;;;;;1,0;;1,0;;10,0;35,0;;;;;;29,0;;;;;;;;;;;;;;;;4,0;;;;;3,0;;;;;;43,0;;;;;4,0;;;1,0;;;;13,0;;;;;;;;;1,0;;;;;;;;;;;;12,0;;;;1,0;;;;;;;;;;;;;;;6,0;;3,0;;;1,0;;;;;;;;;;;;;;;;;;;;;;;;;;;;1,0;;;7,0;;;;;;;;;;5,0;;;;;;6,0;;;;;;;;;;;;;;;3,0;4,0;;;;;;1,0;;;;;;;;;;;;;;;;;;;;;;;;;;;;;;;;;;;;;;;;;;;;;;;;;;;;;;;;1,0;;;;;;;;3,0;;;;;;;;;1,0;;;;;;;;;;;;;;;;;;;;;;;5,0;;;;;;;;;;;;;;;;;;;3,0;;;;;;;;;;;1,0;;;;;;6,0;;23,0;;;;;;;;;;;;;;;;;;;;;;;;;1,0;;3,0;;;;;;1,0;1,0;;;;;;9,0;;2,0;;;;2,0;;;;;15,0;;;;;4,0;1,0;;;;;2,0;;;;73,0;;;;;8,0;;14,0;;87,0;;;;;;;;2,0;;3,0;;;;6,0;;;6,0;;;;;;;;;;;;;;;;;14,0;;;;3,0;;1,0;;;1,0;;;;;;;;;;;;;;;;;;;1,0;70,0;;;;1,0;;;10,0;58,0;;;;;;;;;;;;;;;;;;;10,0;;;;;;;;;;;;3,0;;;;;;;;;;;;;;;;;;;;;;;;;;;1,0;6,0;;;;;;;;;;;;;;;;;;;;;;;;;;;1,0;;;;;;;;;;;;;;;;;;;;;;;;;;;;;;;;;;1,0;1,0;;;;;;;;;5,0;;;;;;;2,0;;;;;;;;;;;;;;;;;;;;;;;;;;;;;;;;;;;;;;;;;;;;;;;8,0;;;;;;;;;;;;;;;;;;;;;;;3,0;;;;;1,0;1,0;;;1,0;;;;;;;;;;;;;;;;;;;;;;1,0;;;;;1,0;;;;;;3,0;;;;;;;;;;;;;;;;;;;;;2,0;;;;;;;;;;7,0;;4,0;1,0;;;;;;;;;;;;;;;;;;;;;;;;;;;;;;;;;;;3,0;;;;;;;;;;;1,0;;;;;;;;;;;;;;;;;;;;;;;;;;;;;;;1,0;;;;;;;;;;;;;;;;;;;;;;;;;;;;;;;;;;;;;;;;;;;;;;;;;;;;;;;;;;;;;;;;;;;;;;;;;;;;;;;;;;;;;;;2,0;;5,0;;;;;;;;;;;;;;;;;;;;;;;;;;;;;;;;;;;;;;;;;;;;;;;;;;;;;;;
partition;;;1,0;;24,0;;2,0;4,0;4,0;1,0;;;;1,0;5,0;;;;;;;2,0;;;;;;3,0;;1,0;;;;;;;;2,0;;3,0;1,0;;;;;;;;;;;30,0;;4,0;;63,0;6,0;;;;;;5,0;;;2,0;;;;;3,0;2,0;;2,0;;;;;19,0;1,0;;;;;;;9,0;;;;;;9,0;9,0;;;;;;4,0;11,0;;;1,0;;;;2,0;;;;;;;;4,0;;;;;;;;;;;2,0;12,0;;2,0;;;;;;;3,0;;1,0;;;;;;3,0;;;8,0;;;;;;1,0;1,0;;7,0;2,0;;6,0;;;2,0;3,0;;;11,0;;;;19,0;;2,0;4,0;3,0;;3,0;3,0;;;;;;;;;1,0;21,0;;2,0;;;;5,0;;;;;;;4,0;;;2,0;1,0;;;;;;;;4,0;;;;;;;;;4,0;;;7,0;;3,0;;;;;;;5,0;;;2,0;;261,0;;;;2,0;;;;;;;;;;;;;;;3,0;;;;;;;;;;;1,0;;;1,0;;;2,0;;;;;1,0;;;;;;;;3,0;;;;;;26,0;;;;;;;;;13,0;;;;;6,0;3,0;;2,0;;;;;;;;4,0;;;;;;;;;;;;;;;;;;;;;;;1,0;;7,0;;;;;1,0;2,0;;;;;;;;;;;;;;;;;;;;;2,0;;;;;2,0;;;;2,0;;;;;;;;1,0;;;;;;;;;;;;;;;;;;;;;;;;;;;;;;;;;;;;;;;;;;;;;;;1,0;;;;;;;;;;;;;;;;;2,0;;2,0;;;;;;;;;;;;;;;;;;;;;;;;;;;1,0;;;;;;2,0;;;110,0;;;1,0;;;;;;;;;;;;;;;;;3,0;;;;;;;;;;;;;;;;;;;;;;;;;2,0;;;;;;;2,0;;;18,0;;;;;;;;;;;;;;;;9,0;;1,0;;;;;;;;;;;;;;1,0;;;;;;;;;;2,0;;;;;;;;;;;2,0;;;;;6,0;;;;;;;;;;;;;;;;;;;;;2,0;;;;;2,0;;;;;;;;;;;;;;;;;;;;;;2,0;;;;;;;;;;;;;;;;;;;;;;;;;1,0;;;;;;;6,0;;;;;;;;;;;;;;;;;;;;;;2,0;;2,0;;3,0;;;;;;;;;;;;;;1,0;;;;;;;;;;;;;;1,0;;;;;;;;;;;;;;;;;;;;;;;;;;;;;;;;;;;;;;;;2,0;;;;;;1,0;;;;;4,0;;;;;;;;;;2,0;1,0;;;;;;;;;;;;;;;;;;;;2,0;;;;;;;;;;;;3,0;;;;;;;;;;;;2,0;;;;;;;;;;;;;;1,0;;;;;;;;;;;;;;;;2,0;;;;;;;;;;;;;;;;;;;;;;;;;;;;;;;;;;;;;;;;;;;;;;;;;;;;;;;;;;1,0;;;;;;2,0;;;;;;;;;;;;;;;;;;;;;;;;;;;;;;;10,0;;;;;;;;;;;;;;;;;;;;;;;;;1,0;;;;;;;
pass;;;17,0;;21,0;;82,0;24,0;2,0;21,0;75,0;4,0;;;8,0;;;;17,0;2,0;2,0;22,0;;1,0;5,0;;1,0;37,0;1,0;12,0;13,0;7,0;35,0;;28,0;1,0;2,0;32,0;;5,0;4,0;;12,0;51,0;;1,0;;28,0;6,0;26,0;4,0;4,0;;24,0;3,0;263,0;32,0;;7,0;331,0;4,0;;55,0;;;1,0;2,0;10,0;;15,0;209,0;1,0;25,0;;;5,0;;16,0;25,0;8,0;15,0;22,0;2,0;5,0;;8,0;11,0;;;5,0;65,0;;6,0;35,0;4,0;6,0;;2,0;2,0;14,0;82,0;61,0;1,0;;;;;63,0;3,0;1,0;4,0;7,0;20,0;24,0;;;5,0;;5,0;13,0;;1,0;6,0;33,0;;3,0;61,0;;;13,0;14,0;2,0;2,0;2,0;;1,0;12,0;4,0;6,0;11,0;6,0;;2,0;16,0;236,0;;39,0;34,0;2,0;2,0;;6,0;19,0;;3,0;7,0;59,0;49,0;5,0;48,0;32,0;;2,0;2,0;;14,0;2,0;461,0;1,0;11,0;48,0;36,0;38,0;8,0;2,0;35,0;4,0;11,0;;;6,0;13,0;;;1,0;35,0;35,0;67,0;3,0;105,0;4,0;1,0;20,0;39,0;4,0;31,0;3,0;2,0;14,0;4,0;;1,0;;47,0;3,0;3,0;1,0;3,0;2,0;11,0;;4,0;6,0;1,0;5,0;23,0;14,0;16,0;2,0;2,0;3,0;20,0;17,0;14,0;1,0;32,0;47,0;;;;2,0;4,0;3,0;;6,0;7,0;1,0;10,0;36,0;;6,0;;7,0;4,0;16,0;4,0;8,0;;16,0;9,0;;1,0;;11,0;1,0;;1,0;5,0;1,0;12,0;10,0;10,0;4,0;3,0;6,0;;9,0;1,0;4,0;;4,0;2,0;6,0;;3,0;;;8,0;4,0;9,0;3,0;10,0;2,0;8,0;4,0;1,0;3,0;22,0;4,0;;7,0;1,0;1,0;3,0;;3,0;5,0;35,0;2,0;4,0;2,0;;18,0;4,0;5,0;;1,0;5,0;2,0;2,0;2,0;7,0;;2,0;8,0;;8,0;;18,0;1,0;;4,0;16,0;2,0;;13,0;;1,0;;;5,0;6,0;;;;;;;;;1,0;7,0;;;1,0;2,0;;2,0;4,0;5,0;2,0;1,0;;;;;;;1,0;;;;11,0;1,0;;2,0;1,0;;;4,0;;;1,0;1,0;3,0;;5,0;1,0;;21,0;7,0;13,0;;;;14,0;1,0;2,0;;1,0;1,0;1,0;3,0;;25,0;1,0;2,0;2,0;9,0;2,0;;;6,0;;;;1,0;5,0;;;3,0;68,0;;4,0;;1,0;1,0;;6,0;6,0;9,0;;;4,0;6,0;2,0;2,0;;;8,0;4,0;14,0;;;;;1,0;;;2,0;;;;;2,0;2,0;5,0;9,0;;;;1,0;32,0;5,0;;2,0;;;;;;;1,0;2,0;;;7,0;;1,0;;;19,0;;;;;14,0;2,0;;;;;;;;10,0;4,0;2,0;;8,0;;3,0;3,0;6,0;7,0;17,0;;2,0;1,0;;;;;;65,0;;;;1,0;6,0;7,0;;;1,0;2,0;;;;;;;2,0;4,0;51,0;;2,0;2,0;;1,0;10,0;;;3,0;1,0;;1,0;;;;;;2,0;;1,0;2,0;;12,0;1,0;;;;2,0;;1,0;;;;;6,0;1,0;10,0;;;;;;3,0;;2,0;;;;;;;;7,0;;;;1,0;2,0;69,0;;;;4,0;;1,0;;;;;2,0;;;;1,0;;4,0;;;4,0;;1,0;;6,0;2,0;;;1,0;;;;1,0;;11,0;;;;;2,0;;7,0;1,0;;;5,0;17,0;;;22,0;2,0;3,0;;;67,0;18,0;;;2,0;;1,0;;1,0;13,0;;;;;2,0;6,0;;2,0;3,0;7,0;6,0;;;13,0;;3,0;;;3,0;2,0;;1,0;;15,0;;;;3,0;1,0;;;1,0;;;2,0;1,0;1,0;1,0;;;;2,0;;;;;;;;;3,0;7,0;4,0;;;1,0;;1,0;;;2,0;;;4,0;;;;2,0;;;;;;2,0;5,0;;10,0;;2,0;4,0;;;;3,0;1,0;;1,0;;;;;;;2,0;;3,0;;;2,0;6,0;;5,0;1,0;;4,0;;;1,0;;;;6,0;1,0;;;72,0;2,0;;;5,0;;1,0;;;;2,0;11,0;;4,0;8,0;4,0;1,0;;1,0;3,0;2,0;;;2,0;;;;;;5,0;2,0;;1,0;;;;5,0;;;;;;5,0;;;4,0;;;;;;;5,0;2,0;;2,0;;;;;;;;1,0;5,0;;4,0;4,0;;;;2,0;;;;1,0;1,0;;10,0;;;1,0;;;2,0;;;;2,0;;;;;;;;;;1,0;5,0;1,0;4,0;6,0;7,0;;;;;;;2,0;1,0;;3,0;1,0;8,0;;;;6,0;;;1,0;1,0;;;;;;;;;;;;;;;4,0;17,0;;;;;;;;;;5,0;;;;;1,0;19,0;;1,0;5,0;;1,0;1,0;1,0;1,0;;;16,0;2,0;;;;;;;;;1,0;;2,0;;;;;;;1,0;5,0;;2,0;;;2,0;2,0;;;;;2,0;11,0;7,0;;;3,0;;;;;;4,0;;;;;;;;;;;;;;2,0;2,0;2,0;;;;;;;;;;4,0;;;;
passage;;;2,0;;2,0;;1,0;2,0;;1,0;;;6,0;;;;;;;;;;;;;;4,0;;;;;;3,0;;1,0;;;;;;;;;2,0;;;;;;;1,0;2,0;;;;2,0;3,0;;;14,0;;;3,0;;;;1,0;;;;;;;;5,0;;;;3,0;;1,0;;;;;;10,0;;;;;1,0;;1,0;3,0;26,0;;;;;5,0;2,0;;;;;1,0;1,0;;;;2,0;;5,0;1,0;;4,0;;1,0;1,0;;;;1,0;;;5,0;5,0;;;2,0;;;;;;5,0;;;;;;;;2,0;;22,0;;;;;2,0;;;2,0;;10,0;14,0;;;;;1,0;;;;4,0;12,0;;;6,0;;;;;12,0;;;;;;;3,0;;;2,0;;10,0;;13,0;;;;8,0;;;;;;;;;;2,0;;;;;4,0;;;;;;;8,0;;;;;;;2,0;;;;1,0;;;;3,0;;;;;;2,0;;4,0;;9,0;;7,0;;;;6,0;;;;;;;10,0;;;2,0;7,0;;;;;;;;;8,0;2,0;;;7,0;;;;7,0;;;;;7,0;;;;;;1,0;2,0;;;;;;;;;2,0;;;;;2,0;5,0;;;;;;1,0;;;;3,0;;;;2,0;1,0;;;39,0;;1,0;;2,0;;1,0;;2,0;8,0;;;4,0;;;;;;1,0;;;;;;;;;;1,0;;;;;;;;4,0;;;;;;;;9,0;;1,0;;;1,0;;;;;;;;;;;;;;;;;;;;;;;;;;2,0;;;;;;18,0;;;;;;;;;;;7,0;2,0;;;;;;;;;;;;2,0;;;;;;;;;;;;;;;;1,0;;1,0;;;;;3,0;;;;;1,0;;;;;;;;;;;;;;;;;;;;;;;;;;;;;;;;;1,0;;;;;2,0;;;;;2,0;;4,0;1,0;;;;;;;;;;;;;;;;;;1,0;;;;;;;;;1,0;;;;;;;;;;;;;;;;;;;2,0;;;;;;;;;;;1,0;;;5,0;;;;1,0;;;;;;;;;;;;2,0;;1,0;;;;;;;;;;;;;;;;1,0;1,0;;;;;;;;;;;2,0;;;1,0;;;;;;;;;;;;;;;;;;1,0;;;4,0;;;;;;;;;;;1,0;;;;;18,0;;;;2,0;;;1,0;;;2,0;;;;;;;;;;;;;;;;;;;;;;;;;;;;;;;;;;;;;;;;;;;;;;;;;;1,0;;;;;;;;;;;;;;;;;;;;;;;;5,0;;;;;;;;;;;;;;;;1,0;;;;;;;;;;;;;;;;;;;;;1,0;;;;;;;;;;;;;;;;;;;;;;;;;;;;;1,0;;;;;1,0;;;;;;;;;;;;1,0;;;;;;;;;;;;;;;;;;;;4,0;;;;1,0;;;;;;;;;;;2,0;;;;;;;;;;;;;;;;;;;;;;;;;;;;;;;;;;;;;;;;;;;;;;;;;;;;;;;2,0;;;;;;;;;;;;;;;;;;;;;;;;;;;;;;;;;;;;;;;;;;;;;;;;;;;;1,0;;;;;;;;;;;;;;;;;;;;;;;;;;;;;;;;;;;;;;;;;;;;;;
permit;;;1,0;;3,0;;3,0;6,0;;19,0;;1,0;;;;;;;4,0;1,0;;69,0;;;;;;20,0;2,0;;;;27,0;;10,0;;1,0;5,0;;34,0;1,0;;;2,0;;;;1,0;3,0;;;2,0;;3,0;;26,0;7,0;;2,0;4,0;;1,0;3,0;;;;2,0;;;6,0;7,0;2,0;;;;;;3,0;11,0;7,0;;2,0;;;;;;;;4,0;5,0;;10,0;3,0;2,0;1,0;;1,0;4,0;4,0;7,0;14,0;;5,0;1,0;;;24,0;;;3,0;;;11,0;3,0;;;;;7,0;;;;1,0;;;9,0;1,0;;;3,0;;;;;1,0;2,0;;1,0;1,0;;;1,0;;2,0;5,0;1,0;3,0;;;;;;;;;1,0;5,0;;;3,0;;;;;;3,0;15,0;;4,0;35,0;3,0;17,0;23,0;13,0;4,0;1,0;;;;5,0;2,0;6,0;;4,0;1,0;4,0;3,0;;2,0;;1,0;4,0;7,0;;2,0;;;7,0;1,0;;1,0;;2,0;1,0;;;;5,0;24,0;;4,0;;;3,0;36,0;2,0;;;2,0;;;;1,0;;4,0;;;;;2,0;;4,0;;;;1,0;;17,0;;1,0;1,0;;;1,0;;;;;2,0;;;1,0;8,0;;1,0;;3,0;1,0;;;3,0;2,0;;;1,0;;;;;;;;;;5,0;3,0;4,0;;;;;;2,0;5,0;4,0;15,0;1,0;;;;;;1,0;;2,0;;9,0;1,0;;1,0;;2,0;;;;;2,0;;1,0;;;;;3,0;;;;;;;;7,0;2,0;;5,0;;1,0;7,0;1,0;27,0;;;;;;;;;;;2,0;4,0;;;3,0;;;;1,0;1,0;;;1,0;;;;;;;;;;3,0;;1,0;;;;;;;;;1,0;2,0;1,0;;;1,0;1,0;1,0;;;;;;;1,0;7,0;;1,0;6,0;;;;;;;;1,0;;;;;;;;;4,0;3,0;;;;;;;;5,0;;;;;;4,0;;;3,0;;3,0;1,0;;;;;;;;;;4,0;;;4,0;;;;;;1,0;;1,0;;10,0;;;4,0;;1,0;;2,0;;;;;1,0;25,0;11,0;;;;;2,0;;;;;;;;2,0;;;;;11,0;1,0;3,0;;1,0;;1,0;;;17,0;5,0;;;;6,0;3,0;4,0;;;6,0;3,0;;4,0;;;;;17,0;1,0;13,0;1,0;9,0;;3,0;;;;;;;;;;;;;;;;;;1,0;;;;;;;;2,0;;;;1,0;;;;;;;;;4,0;;1,0;;;;1,0;3,0;;2,0;;;;;2,0;10,0;;;;;;;;;;;;;;;;;;;;;;;;;;;;;4,0;;;1,0;;1,0;;3,0;;;2,0;;;1,0;;3,0;1,0;;;;;;;;;;1,0;1,0;;;1,0;;7,0;9,0;;1,0;;2,0;;4,0;;;;;;;;1,0;;1,0;;;4,0;;;;;;1,0;;5,0;;1,0;;;;2,0;;;;;;;2,0;1,0;;;;;;;;;;;;;;;;;;;;;;2,0;;1,0;;4,0;;;;;;;;;;;;1,0;;;;1,0;;1,0;;;;;;5,0;;;;;;;;2,0;;;;1,0;;;;;;;;;;;;;;;;;;;;;;1,0;;;1,0;;;;;1,0;;;;;;1,0;;1,0;;;;;;;;1,0;;;;;;;;;;;1,0;;;;;;;;;1,0;;;;;;;;;;3,0;;;;;;1,0;;;;;;;;;;;;4,0;;;;1,0;;;3,0;;;;;;;;;;;;;;;;;;1,0;;;;;;;;1,0;;;;;;;;;;;;;;;;;1,0;;;;;;;;;;;;;;;;;;;;;3,0;2,0;1,0;;;;;;;;;;;;;;;;;;;;;;;;;2,0;1,0;;1,0;;;;;;;;;;;;;;;;;;;;;;;;;;;;;;;;;;;;1,0;;;;;;;;;;;;;;;;;1,0;;;;;;;;;;;;;;
perpendicular;;;6,0;;13,0;;579,0;31,0;9,0;12,0;5,0;;1,0;;1,0;;1,0;2,0;10,0;1,0;12,0;8,0;;3,0;29,0;;7,0;5,0;1,0;2,0;8,0;;29,0;;4,0;6,0;1,0;666,0;2,0;15,0;10,0;;5,0;56,0;;;;16,0;11,0;4,0;1,0;5,0;;3,0;12,0;78,0;9,0;;7,0;94,0;;1,0;12,0;;;1,0;21,0;;;1,0;436,0;2,0;12,0;;1,0;;1,0;12,0;36,0;;2,0;4,0;1,0;;;18,0;5,0;1,0;3,0;3,0;15,0;5,0;3,0;;;;;1,0;2,0;17,0;177,0;11,0;;8,0;;;2,0;112,0;;;1,0;22,0;10,0;2,0;5,0;;;;1,0;19,0;;;4,0;1,0;;;18,0;4,0;;;;;2,0;4,0;3,0;9,0;14,0;;7,0;;;;1,0;10,0;21,0;4,0;16,0;14,0;;1,0;;7,0;9,0;4,0;2,0;5,0;5,0;15,0;2,0;42,0;3,0;1,0;3,0;;;11,0;;25,0;;1,0;55,0;5,0;15,0;28,0;16,0;9,0;12,0;14,0;;4,0;6,0;;3,0;;2,0;155,0;28,0;21,0;8,0;41,0;;1,0;3,0;7,0;;6,0;;;21,0;4,0;2,0;6,0;4,0;32,0;1,0;3,0;6,0;5,0;3,0;29,0;3,0;;;;10,0;14,0;1,0;3,0;;2,0;13,0;7,0;5,0;;10,0;;9,0;;3,0;1,0;;;6,0;7,0;1,0;20,0;1,0;3,0;10,0;;7,0;;3,0;6,0;;8,0;1,0;;6,0;6,0;;;2,0;16,0;;;;11,0;;3,0;;6,0;10,0;;;;51,0;;4,0;19,0;1,0;2,0;2,0;3,0;2,0;;1,0;;;;2,0;6,0;;11,0;;5,0;136,0;16,0;3,0;5,0;1,0;5,0;7,0;4,0;;;;13,0;6,0;;;;14,0;4,0;3,0;4,0;2,0;4,0;;;20,0;;3,0;;;;2,0;;;;;1,0;9,0;7,0;;4,0;;;;;;1,0;;;;;;1,0;;;;2,0;;;;;1,0;;;2,0;4,0;;;;;2,0;;;;;;;;;;;;;;1,0;2,0;;;4,0;;1,0;;;;19,0;;10,0;1,0;1,0;;;;;;;;6,0;9,0;;4,0;;;;;1,0;;;;;6,0;;9,0;41,0;;;7,0;2,0;;1,0;;;;;;;;;;11,0;;1,0;;;;;;;;;;;;;;;6,0;;;;;;1,0;;;1,0;;;11,0;3,0;;;;;;;;;;;2,0;2,0;31,0;;;;;;2,0;;;;;;;;;;;;;19,0;1,0;;;2,0;;;;4,0;;29,0;1,0;2,0;;;;;;;2,0;;;31,0;;7,0;;;;;3,0;;1,0;;;;;;;1,0;;;;;;;;;1,0;;;;1,0;;;;;;;;1,0;;3,0;1,0;;;;;;;2,0;;;1,0;2,0;2,0;5,0;;;;1,0;;9,0;;;;5,0;;;;2,0;;4,0;;;1,0;;;;;;6,0;1,0;;;;;;;;;;;;;2,0;;;3,0;;4,0;;;;;1,0;;;1,0;;;;;;1,0;;;;;1,0;;;;;1,0;1,0;;2,0;6,0;1,0;1,0;;5,0;1,0;1,0;;;;2,0;1,0;;;;;1,0;;;;;6,0;;3,0;;1,0;4,0;19,0;2,0;2,0;;;5,0;;1,0;2,0;;8,0;;2,0;;2,0;8,0;;4,0;;;;;;;;;;;;;;;2,0;;;2,0;;;12,0;2,0;;;;;;;;;;;;;1,0;;;;1,0;;2,0;;;3,0;;;;;2,0;;;;;4,0;;;;;;;;;;;1,0;;;;;;;;;1,0;10,0;;;;;;;5,0;2,0;1,0;;;;;3,0;;;1,0;1,0;;;2,0;;;;;;;;;;;;;1,0;1,0;;;;;2,0;;;;1,0;;1,0;;1,0;;;;1,0;;;;;7,0;;;;;1,0;2,0;;;;3,0;;;;3,0;;;2,0;1,0;;1,0;1,0;;1,0;;1,0;;;;;;1,0;;;;;;;;;;;;;;;;;;1,0;2,0;;;;;;;;;;;;;2,0;1,0;;1,0;;;;;1,0;9,0;;;;;;;1,0;;;;;;;;;;;;;;1,0;;;;;5,0;;;;;;;;;;;;;;;;;;;;;;;2,0;;;;;;;1,0;;;2,0;;;;;;;;;;;;;;1,0;;;3,0;;5,0;2,0;2,0;;;2,0;;;;;;;1,0;3,0;;;;;5,0;;;;;;;;;;;;;;;;;;;;;;;
person;;;3,0;1,0;15,0;;;33,0;3,0;37,0;2,0;;;;3,0;1,0;1,0;;4,0;1,0;5,0;20,0;;2,0;2,0;;;55,0;;74,0;8,0;32,0;36,0;;5,0;;;38,0;;56,0;;;;;;1,0;;;10,0;;;15,0;;8,0;4,0;236,0;44,0;;;3,0;1,0;;43,0;;2,0;;20,0;;;8,0;2,0;2,0;8,0;3,0;;1,0;;19,0;30,0;;;10,0;2,0;1,0;3,0;;8,0;1,0;12,0;7,0;1,0;1,0;21,0;11,0;7,0;1,0;;10,0;10,0;;1,0;25,0;;;3,0;1,0;;13,0;;;;1,0;;;1,0;;;;;7,0;;;1,0;1,0;;4,0;7,0;6,0;6,0;4,0;;3,0;;;2,0;;;;;;;3,0;;140,0;;;;5,0;;3,0;;;;;1,0;;;;;5,0;;;;1,0;5,0;;7,0;1,0;;;;;;5,0;7,0;3,0;;4,0;;;;6,0;;;1,0;;;31,0;;16,0;;;;3,0;;2,0;;;1,0;4,0;;;;;;8,0;;3,0;;9,0;;;3,0;2,0;;12,0;3,0;;;;4,0;4,0;;3,0;;1,0;;;;;;;;4,0;1,0;2,0;;3,0;25,0;;;1,0;;;;;;;;;;;;2,0;;;;;3,0;;1,0;2,0;;;8,0;;;;;;;4,0;1,0;;;;2,0;;;;;;3,0;2,0;;19,0;2,0;99,0;1,0;;;;;2,0;;;;50,0;;;7,0;;2,0;;1,0;;;8,0;;;2,0;4,0;;;;;;;;;;;3,0;;;;;;;;14,0;;;;;;;1,0;;2,0;;1,0;;5,0;;;;;;10,0;8,0;2,0;2,0;;2,0;;;;;1,0;2,0;2,0;;;22,0;30,0;;;;24,0;3,0;1,0;;1,0;2,0;1,0;1,0;;;;10,0;;3,0;3,0;;;2,0;2,0;;24,0;1,0;6,0;;;3,0;1,0;;6,0;3,0;1,0;59,0;;;;;1,0;38,0;4,0;6,0;;;2,0;;;;1,0;9,0;;9,0;;2,0;;2,0;;3,0;;;7,0;;37,0;;6,0;;;;;;1,0;;;1,0;;;;;;;;12,0;;;;3,0;1,0;;;6,0;;2,0;1,0;2,0;;1,0;;;9,0;;;;;;2,0;;1,0;;;;;3,0;29,0;47,0;;;;;;6,0;1,0;;7,0;3,0;4,0;;1,0;29,0;35,0;6,0;;;;;1,0;;2,0;;1,0;;;;;;;;;11,0;;2,0;;3,0;1,0;1,0;;4,0;;2,0;;3,0;;;;3,0;;;;;;;9,0;;;;;;;;1,0;4,0;;;;4,0;;;1,0;;;5,0;;1,0;6,0;;;;11,0;;9,0;5,0;;;;;;1,0;;;2,0;;;;;;;23,0;;1,0;1,0;2,0;;2,0;;;;;;;2,0;;;3,0;;;;3,0;;;;;;;;;1,0;;;;;1,0;;;;;;;;;;;1,0;2,0;1,0;;;;;;;1,0;;;;;2,0;;;;;;1,0;;;6,0;;;;;;;;;;1,0;;;;;;;;;;;;;;;7,0;;;;;;;2,0;;3,0;;;;;;;;;5,0;;;;;;;;;;;;;;4,0;;3,0;;1,0;2,0;;;;;;;;;;2,0;5,0;;;;;;;1,0;;;2,0;;;2,0;;;;;5,0;;;;;6,0;2,0;;1,0;;6,0;;;2,0;;;;2,0;;;;1,0;;1,0;;;;;;3,0;;;;;12,0;;;;;;;;;;;4,0;8,0;;;;;;3,0;5,0;1,0;;;;;14,0;;;;34,0;;;;2,0;;;;3,0;4,0;;;;1,0;;;;1,0;;;2,0;1,0;;;;1,0;2,0;;;;;;;;;;1,0;;;4,0;18,0;;;;2,0;;;;;3,0;;;;4,0;;;;;;;;;;;;1,0;;;;;;;8,0;;;;;;;;1,0;;;;;;;;6,0;;;;;1,0;1,0;;;;;;;;;;2,0;;;;;;;;8,0;;;;;;;;;;;;;3,0;;;;;;;;;;;;;;;;;4,0;;;;;;;;2,0;;;;;;;;;;;;;;;;;;;;;;;;;3,0;;4,0;;1,0;;;;;;;;;;;;;;;;
phase;;;32,0;;14,0;;2,0;42,0;25,0;2,0;11,0;2,0;;4,0;9,0;2,0;;5,0;20,0;2,0;1,0;66,0;2,0;1,0;1,0;13,0;;18,0;27,0;39,0;88,0;27,0;119,0;155,0;30,0;;;13,0;;1,0;5,0;;11,0;23,0;2,0;;;6,0;26,0;12,0;28,0;17,0;;;;86,0;47,0;;;23,0;8,0;;103,0;5,0;8,0;16,0;;;3,0;7,0;16,0;;4,0;;9,0;;;4,0;26,0;10,0;3,0;1,0;;;;14,0;59,0;;2,0;4,0;14,0;54,0;;198,0;;;;10,0;19,0;;7,0;30,0;;30,0;;;15,0;54,0;14,0;;;;;;;;1,0;;1,0;1,0;;;8,0;8,0;;;4,0;;5,0;1,0;2,0;1,0;3,0;;;9,0;;;7,0;2,0;18,0;;;;2,0;;4,0;16,0;;;;;;;;;;;7,0;76,0;2,0;4,0;;;;;30,0;10,0;3,0;2,0;;4,0;1,0;;;2,0;;29,0;;;;;;;;3,0;;14,0;1,0;30,0;;;;4,0;;14,0;;;10,0;;10,0;4,0;;;;4,0;3,0;;;;;;;7,0;;74,0;10,0;;;;;;6,0;2,0;;6,0;;;;;;;1,0;1,0;151,0;2,0;;20,0;16,0;3,0;;;2,0;;;;1,0;;;4,0;3,0;;;9,0;1,0;5,0;;;;;8,0;51,0;1,0;;;;;;3,0;;;;;;;1,0;;3,0;1,0;6,0;;;;;;;1,0;7,0;16,0;;;;8,0;10,0;;;;2,0;;;;;15,0;1,0;3,0;;;8,0;;;51,0;10,0;;;;;;1,0;;;;9,0;;;;7,0;;;16,0;;2,0;;10,0;;;;2,0;5,0;6,0;;;;;3,0;;;11,0;;;31,0;2,0;;4,0;;2,0;;;;;;1,0;;;;2,0;8,0;;;;;7,0;;2,0;;;4,0;;2,0;;;8,0;2,0;;2,0;244,0;;2,0;1,0;;4,0;;2,0;;;;1,0;4,0;22,0;3,0;2,0;8,0;;5,0;3,0;;4,0;;;;;;1,0;14,0;;;;1,0;;4,0;;;1,0;;;;;;;3,0;3,0;12,0;2,0;;;;7,0;21,0;;2,0;;;;;;1,0;4,0;9,0;3,0;;2,0;;4,0;;3,0;;;;;3,0;;5,0;;;10,0;1,0;;;;1,0;;;25,0;;;1,0;;;;2,0;;;;2,0;;;2,0;;;;19,0;6,0;8,0;8,0;;3,0;;;15,0;;;;;;;;;;;;;;;;12,0;;;;;;11,0;;;6,0;;;;;;;;;;;;;2,0;1,0;;;;;;;;;;;;;;;;;;;;;;;;49,0;;;;;;5,0;3,0;;;;;;;;;;;;;;;3,0;;15,0;;;;;;2,0;;;;;;1,0;;1,0;;;;8,0;;;;4,0;21,0;;;;;;;;;1,0;;;;3,0;;1,0;;;;;;10,0;;;;;170,0;1,0;;;;;;;;;1,0;;;;;;;6,0;13,0;;;;;;;11,0;;;;;;;1,0;;;;;;;;7,0;7,0;;;;;;8,0;1,0;6,0;5,0;7,0;13,0;;6,0;;;;;;1,0;;;;33,0;;4,0;10,0;3,0;;;1,0;;;;;3,0;3,0;;2,0;1,0;;;;;;;3,0;;;;;;;3,0;;12,0;;94,0;4,0;21,0;12,0;;;;;;;;;;;;1,0;133,0;;;;;;;;9,0;;9,0;;;;;2,0;;9,0;;;;;5,0;2,0;;;;;;22,0;3,0;;;;;;;;17,0;;;;;5,0;;;;;;;;;;;;;;;;;6,0;;;;1,0;;;;;;;5,0;;2,0;15,0;;;;;;1,0;;;;4,0;2,0;;;;;;;3,0;;;;;;;;;2,0;;;;;9,0;6,0;;;;;;;6,0;2,0;;;;;;1,0;;;;;;;;;;;;;;;;;;;;;;;4,0;;10,0;;;;;;;;;;;;;;;;;;;;;;;;;;;;;;;;;;;;;;;;;2,0;;;;;;;;;31,0;;;;1,0;;;;;;;;;;;;;;;;;;;;3,0;;46,0;;2,0;;;;;;;2,0;;;;;;;;;;;;;;;;;;;;;
phone;;;1,0;;9,0;;2,0;17,0;;30,0;;;;;;;;;;10,0;;12,0;;;;;;11,0;;11,0;11,0;1,0;86,0;;22,0;;5,0;;;34,0;2,0;;2,0;;;;;2,0;1,0;7,0;33,0;3,0;;5,0;;45,0;31,0;;4,0;59,0;;;28,0;;;2,0;1,0;1,0;;18,0;3,0;;5,0;;;;;1,0;50,0;2,0;;4,0;13,0;;;;;;;8,0;14,0;1,0;3,0;21,0;;;;1,0;12,0;2,0;8,0;17,0;;;2,0;;3,0;32,0;;;1,0;;;5,0;;;;;1,0;24,0;;;2,0;;;;25,0;1,0;;7,0;8,0;;;2,0;3,0;1,0;2,0;;;3,0;;;4,0;7,0;3,0;;3,0;2,0;;;;2,0;2,0;;;;;8,0;1,0;3,0;;;;;;;3,0;3,0;;1,0;4,0;;18,0;1,0;1,0;32,0;5,0;2,0;;;;;2,0;;2,0;;;17,0;;16,0;;1,0;;4,0;;;;;;;;1,0;;43,0;1,0;1,0;6,0;;;3,0;;;;;;3,0;5,0;1,0;;;;;;;;;1,0;;;;;;;;5,0;;;1,0;;;;;;;1,0;2,0;2,0;2,0;;;;;1,0;6,0;;;;2,0;;;;2,0;4,0;;;1,0;8,0;;;1,0;1,0;16,0;;1,0;;5,0;;;;;;;;1,0;;;1,0;1,0;;;;;;;;1,0;;3,0;;;15,0;;5,0;;;1,0;;1,0;21,0;;;1,0;;;;;;;;;;1,0;;;;2,0;;1,0;10,0;;14,0;;;;1,0;1,0;1,0;;;;;11,0;;;;;;;14,0;3,0;22,0;3,0;2,0;;;;;;;;;;2,0;;2,0;;;;2,0;;;;;1,0;1,0;1,0;1,0;;;2,0;;2,0;1,0;11,0;;;;;1,0;6,0;;1,0;;;4,0;;;1,0;;;;;;;;;;7,0;;12,0;;2,0;;;4,0;;;;2,0;;;4,0;;240,0;39,0;;;;;2,0;;;17,0;;2,0;;;;16,0;3,0;4,0;;;;;;;1,0;;;1,0;1,0;5,0;;8,0;;;;;1,0;;1,0;;;;5,0;;;;;;18,0;;1,0;3,0;;4,0;1,0;;;;;;;;5,0;2,0;;;3,0;;5,0;;3,0;20,0;;;;4,0;;;6,0;;;1,0;1,0;;;;3,0;;;;;11,0;5,0;1,0;1,0;;;;;2,0;3,0;;;2,0;;;2,0;2,0;;1,0;;;;;3,0;7,0;;;;1,0;3,0;;;3,0;;;;;4,0;;;9,0;;;;;;1,0;;4,0;;;;;;1,0;;;2,0;;1,0;6,0;;2,0;;;;;;;;;7,0;;;2,0;5,0;8,0;;;3,0;24,0;2,0;;;3,0;;;;2,0;;;;;;;;;;;;7,0;;9,0;;;;;;;1,0;;;;;;;;;;;;;;;;;1,0;;1,0;2,0;;1,0;;;2,0;;6,0;;;4,0;;;1,0;1,0;;4,0;;;;;;;;;;;;;8,0;;;;;;;;;;;1,0;;;;;1,0;;;;;;;;;;;;;;;;;;;;1,0;3,0;;1,0;;2,0;;;;6,0;;;;;;;;;;;;;;;;;;;;;1,0;;;;;;;;;;;;;;;;;;;;1,0;1,0;;2,0;;;;;;;;;;;;;;;;1,0;;;;;;;;;1,0;;;8,0;;;;4,0;5,0;;1,0;;;1,0;3,0;;;;;3,0;;1,0;;;;;;2,0;;;;;;;1,0;;;1,0;;;;;;;;;;;;;;;;;;;;;7,0;;;;;2,0;;;6,0;;;;;;2,0;;;;;;;;;;;;;;;;4,0;;;;;;;;;;;;;;;;;1,0;;;;;;;1,0;;;;;;;;;;;;;;;;;;;;;;;;;;;;;;;;1,0;;;;;;;;;;;;;;;;;;;;;;;1,0;;;;;;;;;;;;;;;;;;;;;;11,0;;;;;;;;;;;;;;;;;;;;2,0;;;;
photo;;;2,0;;5,0;;;5,0;1,0;24,0;;;;;7,0;;3,0;8,0;;;;5,0;;;2,0;;;31,0;;5,0;3,0;1,0;17,0;;44,0;3,0;;3,0;;19,0;2,0;;1,0;18,0;1,0;;;;;;1,0;16,0;;;;54,0;38,0;;;45,0;;;27,0;;;;6,0;;;1,0;17,0;;13,0;;;;;;17,0;1,0;;9,0;14,0;1,0;1,0;;7,0;;;1,0;39,0;;;14,0;;;;;5,0;10,0;2,0;10,0;;6,0;;;1,0;;;;1,0;18,0;220,0;7,0;;;2,0;;;;;;;1,0;;;29,0;;;15,0;;1,0;;;1,0;206,0;2,0;;;;;;;;2,0;;8,0;;1,0;;;;;;;;;3,0;;3,0;8,0;;;;;2,0;;35,0;;;;;4,0;;11,0;;;22,0;;;;;;;;10,0;;51,0;;13,0;;;9,0;15,0;;;;;;;2,0;;1,0;;;7,0;;;;;;;1,0;;;7,0;3,0;;;;;;;4,0;;15,0;;;;;;;12,0;;3,0;1,0;;;4,0;;;;;;;;15,0;5,0;;;;;;;;1,0;;6,0;3,0;;;3,0;;;;;4,0;;;;;;;;;;;;;2,0;;;;;;;4,0;;1,0;;8,0;;;;;;2,0;;;;1,0;;1,0;2,0;;;;;;;;2,0;;;;;;;;;;;;;;;;;;;8,0;;;;;;;;;;;5,0;;;;;;;;;;;;;;;;;;;;;4,0;;7,0;3,0;;;2,0;;;;;;1,0;2,0;;;;;;;;;;;;;;2,0;1,0;10,0;;;1,0;2,0;;;;;;;;;1,0;;;;;;;;;6,0;;;;;;2,0;18,0;;;10,0;1,0;;;3,0;;5,0;;;;;;;9,0;;;;1,0;;;7,0;;;17,0;7,0;;;;;;;;;;;;1,0;;;;;;1,0;;;1,0;;;2,0;;;;;5,0;;;;;2,0;;;;;;2,0;;2,0;;;;2,0;27,0;13,0;6,0;;;;;3,0;;;;;;;;;;;;;1,0;;;;1,0;;;;;;;;;;;;;;;;;;;;2,0;;;;1,0;;;;;;;;;;;;1,0;;;;;1,0;4,0;;2,0;;;;10,0;;;;;;;3,0;;;;;;;6,0;;11,0;4,0;;13,0;;11,0;;;;;;2,0;;1,0;;;;;;;5,0;;;;;;;;;;;;1,0;;3,0;;;;;;;;1,0;;;;;;1,0;;1,0;;;;2,0;;;;4,0;;;;;;;;;;;3,0;;;;;;;;;2,0;;1,0;;;;;;;;;;;;;;;;1,0;;;;;;;;;;;;;13,0;;3,0;;;;;5,0;;;;;;3,0;;;;;5,0;2,0;;;;;;;;;;;;;;;;;;;;2,0;;;;;;;;;;16,0;;;;;;;52,0;;;;;;;;;;;;;;;;;;;;5,0;;1,0;;;;;;2,0;;;;;;;1,0;5,0;;;;;;;;;;;;;;;;;;;;;1,0;6,0;;2,0;;;;;;;;;;;;;;1,0;;;;3,0;;;;;1,0;;;;;;4,0;;21,0;;;3,0;;;;;;;;;;;;;;;;;;;;;;;1,0;;;;;;;;;;;;;;;9,0;3,0;;;;;2,0;;;;;;;;;7,0;;;;;2,0;;;;;;;;1,0;;;;;;;;;;;;;4,0;1,0;;;;;;;4,0;;;;;;;;1,0;;;;;;1,0;;3,0;;;3,0;;;;;;3,0;;;;;;;;;;;;;;;;3,0;;;;;;;;;7,0;;;;;;;;;;;;;;;;;;;;;
photodiode;;;1,0;;7,0;;1,0;;;;3,0;;;;7,0;;;;;;;4,0;;;;;;;;;;1,0;37,0;;7,0;2,0;;5,0;;;10,0;;;9,0;;;;;;;8,0;50,0;;;;19,0;57,0;;;3,0;;;6,0;;;;;;;;2,0;;8,0;;;;;;24,0;;1,0;5,0;;;;;65,0;;;;12,0;9,0;;86,0;;;;;12,0;37,0;34,0;5,0;;49,0;;;17,0;7,0;;;9,0;28,0;10,0;;;;;3,0;;;;;;;;;19,0;;;;7,0;;;;;3,0;15,0;;15,0;4,0;4,0;;;;2,0;;33,0;4,0;;;4,0;;;;;;;;;16,0;26,0;;1,0;;;23,0;1,0;55,0;;;;;7,0;;;;;;;;;;2,0;;;;;95,0;;8,0;;;4,0;9,0;4,0;5,0;;;;1,0;37,0;;;10,0;;;;;;;;;;;;2,0;5,0;;;;2,0;;;;;11,0;;;;;;;;18,0;;;;;1,0;;;;;;;;;;;;15,0;;;19,0;8,0;;;;;;;;;;;;;;;3,0;;;;;;12,0;;;;;;;;;;1,0;;;;;;;;3,0;;;4,0;;;;;;;;;;;2,0;;;;19,0;;;;;;;;;;3,0;;;;;;;;;;9,0;;;;22,0;;;;;;;;2,0;;;;;;;;;;;;;;;;;;;;2,0;;;;;;;;1,0;;;;;;1,0;;;2,0;3,0;;;1,0;1,0;;;;;;;;;1,0;;2,0;;;;;;;;;;;;;;;;8,0;6,0;;;;;;;;;;;;;1,0;23,0;;;;;;;;;;;;;;;;;;;1,0;4,0;;;;;4,0;;;;;;;;;;;;;;;;;;2,0;2,0;;;;;;;;;;;;;;;;;4,0;2,0;;1,0;;;;;6,0;5,0;;;;;;;;;;;;;;;;;;;;;;;;;;;;;1,0;;;4,0;3,0;;4,0;;;;;;;;;;;;;;;;;;;;;;;;5,0;;;1,0;48,0;5,0;;;;;;;;;;;;;;;;;;;;;;;;;;;;;;;;;;117,0;;;;2,0;;;7,0;;;;;;;;;;;;;;;;;1,0;1,0;;;2,0;4,0;;;;;;;4,0;;;;;;;;;;;3,0;;;;;;;;;9,0;;;;;;;4,0;;;;;;;;;;;;;;;;11,0;;;;7,0;;3,0;9,0;;;;4,0;2,0;;;17,0;;1,0;;;;19,0;18,0;;;;;;3,0;;;;;;;;21,0;;;;;;46,0;;;;;;;;;;;;;;;;;;;1,0;;;;;;;;;;;;;;;;;;;;;;;;;;1,0;;;;;;1,0;;;;4,0;;;;;;;;;;;;;;;;;;;;;;;;;;;;;;;;;;;3,0;;;;;;;;;;;;;;;;;;;;;;;;;3,0;;;;;;;6,0;;;;;2,0;;;;;;;;;;;;;;;;;;;;;;;;;;;;;;;;2,0;;;;;;;;;;1,0;;;;;;;;;;;;;;;;;;;;;;;;;;;;;;1,0;;;;;;;;;;;;1,0;;;;;;;;;;;;;;;;1,0;;;;;;;13,0;;;;;;;1,0;;;;;;;;;;;;;;;;;;;;;;;;;;;;;;;;;;8,0;;;;1,0;;;;
photoelectric;;;4,0;;27,0;;;32,0;;1,0;2,0;;;;5,0;;;;1,0;;;31,0;;;;;;13,0;;7,0;6,0;;147,0;;13,0;5,0;;6,0;;3,0;;;;193,0;;;;15,0;9,0;;8,0;75,0;;11,0;;89,0;138,0;;;19,0;3,0;;17,0;;;;;;;19,0;10,0;;5,0;;;1,0;;5,0;4,0;;;1,0;;5,0;;1,0;127,0;;;11,0;40,0;2,0;;100,0;4,0;7,0;;33,0;14,0;34,0;29,0;17,0;;97,0;;;9,0;329,0;2,0;;13,0;54,0;72,0;;;;17,0;;7,0;;;;;15,0;;;24,0;3,0;;2,0;1,0;;;;;;36,0;;31,0;;;;;13,0;1,0;;49,0;1,0;1,0;;;;;;4,0;;;;;47,0;20,0;4,0;1,0;;;36,0;6,0;65,0;;4,0;1,0;2,0;;4,0;;8,0;1,0;40,0;;;;3,0;5,0;;;;4,0;107,0;;73,0;;;;27,0;2,0;;;;;5,0;20,0;;2,0;20,0;;1,0;;;4,0;;;1,0;;;;7,0;3,0;7,0;;;2,0;;;1,0;;3,0;;;;1,0;;;;13,0;1,0;;;2,0;17,0;;;;2,0;;;;2,0;16,0;;;4,0;;;9,0;;2,0;;;4,0;;4,0;2,0;;;2,0;;2,0;;;;;7,0;3,0;1,0;;;4,0;;;12,0;;;1,0;;;;;5,0;1,0;4,0;;;;4,0;;;;2,0;;;;;7,0;;;;;1,0;;;2,0;5,0;;;;;;;;1,0;;2,0;;;;1,0;;;4,0;;1,0;;;;;80,0;;;;;;5,0;;;;;;;;;1,0;;;2,0;;;7,0;;;4,0;;;;9,0;;;;;;;;;;;3,0;3,0;3,0;;;;13,0;44,0;;;;3,0;;;;4,0;;;;;3,0;2,0;;;;;;;1,0;;;;;1,0;;;1,0;3,0;89,0;4,0;;;;;1,0;;;;;;;;;38,0;;;;;;;;;;;;;;;;;2,0;;841,0;78,0;;2,0;;52,0;3,0;;;;;;;;;;;;;;;;;;;28,0;;;;;7,0;;;;2,0;4,0;;;;;;;;;;11,0;;;;;;4,0;;;;;;;3,0;;;;;;;;;;;;;;;;;;;;;;;;;2,0;;;;;;1,0;;;;;;;;;;;;;;;;;;;;4,0;6,0;;;;223,0;17,0;;;;;;;;;;;;;;;;;;;;;5,0;1,0;;;;;;;;;;;18,0;144,0;;;;;;;;;;;;;;;;;;;;;;;;;21,0;;;6,0;6,0;;;;;;;3,0;;1,0;1,0;;;;;;;;;;;;;;;2,0;;15,0;;;;;;;;;;;;;;;;;;;;;;2,0;10,0;;1,0;;11,0;;3,0;26,0;;;;12,0;7,0;;;9,0;1,0;23,0;;;;42,0;9,0;;1,0;;;;;;2,0;;4,0;;;1,0;6,0;4,0;;5,0;;;32,0;1,0;;2,0;;;2,0;2,0;;;;;;;1,0;;;;;;;;;;;;;;;;;;;;;;;;;;;;1,0;2,0;;;;;;;;38,0;1,0;;;;;;;1,0;;;;;;;;;;;;;;;;;;;;;;;;;;;;;;;;;;;1,0;;;1,0;;;;;;;;;1,0;;;;;;;;;;;;;;;;;;;;4,0;;;;4,0;;;;;;1,0;;;;;;;;;;;2,0;;;;;;;;;;;;1,0;;;2,0;1,0;;;;;;9,0;;;;;;;;;;;;;;;;;1,0;;;;;;;;;;;;;;;;;;;;;;;;;;;;;;;;;;;;;;;;;19,0;;;;;;;14,0;;;;;;;1,0;;;;;;;;;;;;;;;;;;;;;;;;;;;;;;;;;;17,0;;;;;;;;
photography;;;8,0;;1,0;;;26,0;2,0;12,0;4,0;;;2,0;1,0;;1,0;;21,0;1,0;69,0;42,0;;;1,0;;;8,0;;10,0;;18,0;109,0;;42,0;2,0;6,0;8,0;;51,0;;;;1,0;;;;;;;9,0;3,0;;4,0;;70,0;12,0;;;11,0;;;32,0;;1,0;;12,0;2,0;4,0;43,0;24,0;2,0;3,0;;;28,0;;2,0;16,0;1,0;1,0;8,0;2,0;4,0;;;3,0;;3,0;1,0;9,0;8,0;;8,0;;;;2,0;17,0;;;57,0;;;;1,0;7,0;31,0;;;4,0;3,0;;9,0;2,0;;;;;8,0;;;;6,0;;;16,0;;1,0;;8,0;2,0;;;;;1,0;;;15,0;;;4,0;3,0;;;11,0;3,0;;;;;1,0;;1,0;;;4,0;37,0;15,0;;;;;;;;62,0;;;8,0;4,0;;5,0;;;;1,0;;;;;;;;;3,0;32,0;;6,0;;;;3,0;;2,0;;;;;;;2,0;2,0;;;2,0;;;11,0;3,0;;;;;18,0;1,0;;;;;2,0;;10,0;;2,0;;;;;;;;;8,0;;1,0;1,0;1,0;;;;4,0;;;;;;;;;;;3,0;;;;3,0;;;;;;;;;;;;;2,0;5,0;;;;3,0;2,0;;;;;;;1,0;;;1,0;17,0;6,0;;;;;;;;;4,0;;;1,0;;1,0;;;;;16,0;2,0;1,0;1,0;1,0;;;;;;;;;;;;;;8,0;;;1,0;;10,0;;;;;;;;;;;;4,0;17,0;;;5,0;1,0;;5,0;1,0;15,0;;;;1,0;;2,0;;;;;;;4,0;1,0;;;;;;2,0;;1,0;1,0;;;;;1,0;11,0;;1,0;1,0;;;;;;2,0;3,0;15,0;;;2,0;2,0;10,0;5,0;;;;;1,0;;;;;2,0;;;2,0;5,0;;;;;;;7,0;;2,0;;;;70,0;;;2,0;1,0;;5,0;;;;;;;;;;4,0;;;;1,0;;;1,0;;;;4,0;;9,0;;;1,0;4,0;13,0;;;1,0;;1,0;1,0;3,0;2,0;;3,0;;;45,0;;;;2,0;1,0;;;;;;;;;2,0;2,0;5,0;;30,0;;4,0;;2,0;11,0;;1,0;;;;;1,0;;;;1,0;;;;;;;;;2,0;;;;;4,0;;;;1,0;;16,0;;;;;;;3,0;;;;1,0;1,0;1,0;;;;;;;;;;1,0;;;1,0;;;2,0;;3,0;3,0;;;2,0;;1,0;;;;;1,0;;;;1,0;;;;;;1,0;;;;2,0;24,0;2,0;;1,0;;;;;1,0;;;1,0;;2,0;;;;;;1,0;5,0;;;;1,0;;;;;;10,0;;;;;;;4,0;;;;;3,0;;;;;;;;;;;1,0;;;3,0;;;;;;;;;;;;;6,0;;;;;;;6,0;;;;;;4,0;;;1,0;;;;;;;;;;;;;;;;;;;;;;;;;;;;;;;3,0;;1,0;;;;;;;;2,0;1,0;;;;2,0;;;;;;;1,0;;;;;;;;;;2,0;;;;;;;;3,0;;;;;;;3,0;;;;;;;;;;;;;;;;;;;;;;;;;;;;18,0;;2,0;4,0;;;;;;;;;;;;1,0;;;;;;1,0;;;;;1,0;;;;;;1,0;;;;;;;;;;;;;;;;;;;;;;;3,0;;;1,0;1,0;;;;;;;;;;1,0;;;;;;;;;;1,0;;;;;;;;;;;;1,0;;;;;;;;;;;;;;;;3,0;;;;;;;;;;;;;;;;1,0;;;;;;;1,0;;;;;;;;;;;;;;;;;;;;;4,0;;;;;;;;;;;;;;;3,0;;;;;;;;;;;;;;;;;;;;;;;;;4,0;;;;;;;;;;3,0;;;;;;;11,0;;;;;;1,0;;;;;;;;;3,0;;;
physical;;;3,0;;1,0;;2,0;22,0;5,0;14,0;2,0;15,0;;;;8,0;;;;8,0;3,0;4,0;13,0;;1,0;;;16,0;;29,0;3,0;14,0;27,0;1,0;8,0;;;12,0;;4,0;2,0;2,0;;1,0;1,0;;;;;;1,0;3,0;;2,0;;60,0;15,0;;6,0;;;;26,0;;11,0;;4,0;;2,0;2,0;7,0;3,0;;;;;;15,0;16,0;3,0;;3,0;10,0;;6,0;;;1,0;12,0;14,0;12,0;;;16,0;14,0;1,0;;;3,0;;10,0;23,0;;;1,0;4,0;;12,0;;;3,0;1,0;;2,0;;;1,0;;;1,0;;;;3,0;;;6,0;10,0;;;;2,0;;;1,0;3,0;;;;;;11,0;3,0;6,0;;;8,0;;;;;;;;;;;2,0;6,0;7,0;;;;;;2,0;;1,0;;;3,0;2,0;;1,0;11,0;;1,0;3,0;4,0;;;2,0;2,0;;1,0;;;21,0;;7,0;;;;;2,0;;;;2,0;3,0;;6,0;;1,0;;;;;1,0;;;;;;6,0;5,0;;;1,0;3,0;;2,0;;3,0;;;9,0;;;;;;;1,0;;3,0;;;68,0;;;;;;;;;;;;;;;;;;1,0;5,0;1,0;;;;1,0;;;;;;;3,0;;;;;;3,0;;;;3,0;;;1,0;;;19,0;;52,0;9,0;;;;;2,0;;;;;;;;;21,0;1,0;1,0;;;9,0;1,0;;3,0;5,0;;;;;;;;;;8,0;;;;5,0;;;;;12,0;1,0;;;;;2,0;;;1,0;;5,0;;1,0;;;;;;4,0;1,0;;3,0;;;;;;;;21,0;;;;6,0;2,0;;;;1,0;;;6,0;1,0;3,0;;1,0;;;2,0;2,0;;;;;30,0;1,0;4,0;1,0;6,0;2,0;7,0;;1,0;;;;8,0;;;;;;;9,0;;32,0;;;1,0;;;1,0;;;9,0;3,0;;3,0;;36,0;3,0;;;;;;1,0;;;;;;;;5,0;;3,0;;1,0;2,0;;;;1,0;;1,0;1,0;;;;1,0;24,0;;;;;;3,0;;;;;1,0;;19,0;;;;3,0;;12,0;;;;1,0;;;2,0;1,0;;;;3,0;;2,0;4,0;;;;;;5,0;;7,0;25,0;;;;;;;;;2,0;;1,0;;;;;;;;;2,0;;6,0;;;;;;1,0;;;;;;;;3,0;;;;;;18,0;;;;1,0;;;;;2,0;2,0;;;;;;;6,0;;2,0;;;;;;;5,0;;3,0;13,0;;;;;2,0;;;;;;;;;;;2,0;;;1,0;;;;8,0;2,0;;;1,0;;;;;;1,0;;;;1,0;;;;;;;;;;;;;;1,0;;4,0;;;;;;;;;;;;;;;;;;;;;;;2,0;;;;;1,0;1,0;;;2,0;;;;;;1,0;;;7,0;1,0;;;;;;;;;;;;;;;;1,0;;3,0;;;;;1,0;;;;;;;;;;1,0;;;;;;1,0;;2,0;;;;;;;3,0;;2,0;;;;;;;;;;;;;;1,0;;2,0;;;;1,0;4,0;;;;;;;;;;;;;;7,0;;4,0;;;;;;;;;1,0;;;;;;;1,0;;;;;;4,0;;;;6,0;;;;;;;;;;;9,0;;;;;;;6,0;;;;;;;;;;;;;;;;;;;;;1,0;;;;;;;;;4,0;;;;1,0;;6,0;4,0;;1,0;;1,0;;;;;;;;;;;;4,0;;1,0;;;;;1,0;;;2,0;;;;;;;;;;;;;;;1,0;;;;;;;;;;;;;;;1,0;;;;;;;;;1,0;;;;;;;;;;;;;4,0;;9,0;;;;;;;;;;;1,0;;;;;;;;;;8,0;1,0;;;;;;;;;;;;2,0;;;;4,0;;;;;;;;;;;;;;;;1,0;;;;;;;;;;;1,0;;;;4,0;;;;;;;;;;;;;;;;2,0;2,0;;;;
pickup;;;10,0;;176,0;;36,0;74,0;9,0;97,0;14,0;4,0;1,0;;29,0;1,0;2,0;;1,0;2,0;18,0;93,0;4,0;18,0;6,0;;4,0;134,0;5,0;45,0;9,0;17,0;1364,0;;40,0;13,0;8,0;70,0;2,0;62,0;22,0;;19,0;358,0;;2,0;;13,0;43,0;1,0;13,0;93,0;1,0;4,0;1,0;3341,0;157,0;1,0;6,0;217,0;2,0;5,0;35,0;2,0;;9,0;39,0;9,0;1,0;32,0;346,0;2,0;74,0;4,0;3,0;6,0;1,0;1,0;97,0;5,0;3,0;120,0;1,0;7,0;;2,0;58,0;;;8,0;29,0;13,0;12,0;228,0;7,0;9,0;;2,0;12,0;39,0;101,0;228,0;;24,0;;;24,0;389,0;;;9,0;39,0;8,0;2,0;25,0;;1,0;;29,0;35,0;3,0;;14,0;43,0;;;55,0;6,0;2,0;5,0;7,0;;;;1,0;1,0;27,0;;14,0;9,0;;;11,0;4,0;23,0;4,0;73,0;29,0;;;;1,0;6,0;1,0;10,0;4,0;;33,0;25,0;47,0;16,0;7,0;;;;29,0;10,0;108,0;2,0;1,0;32,0;9,0;34,0;62,0;19,0;13,0;;134,0;3,0;;;1,0;13,0;121,0;;11,0;11,0;64,0;;117,0;;7,0;4,0;65,0;1,0;12,0;;;6,0;4,0;12,0;3,0;9,0;10,0;;;7,0;6,0;5,0;12,0;6,0;1,0;;2,0;6,0;80,0;13,0;3,0;1,0;;2,0;1,0;6,0;1,0;;1,0;1,0;;;;3,0;;3,0;1,0;32,0;36,0;;14,0;64,0;8,0;14,0;3,0;3,0;;;7,0;;3,0;;7,0;15,0;;1,0;22,0;2,0;3,0;;12,0;;;1,0;49,0;2,0;2,0;1,0;1,0;3,0;;;1,0;2,0;20,0;1,0;3,0;;3,0;;;3,0;16,0;;2,0;;15,0;;3,0;30,0;90,0;13,0;4,0;;1,0;8,0;1,0;;10,0;44,0;107,0;1,0;;;;51,0;3,0;;;;11,0;1,0;9,0;9,0;10,0;4,0;;;;;;1,0;9,0;;2,0;3,0;2,0;;8,0;;6,0;6,0;;;8,0;;2,0;;5,0;1,0;10,0;2,0;10,0;;5,0;;2,0;2,0;1,0;4,0;2,0;;15,0;2,0;;;3,0;;1,0;6,0;3,0;;1,0;5,0;;;;3,0;2,0;;;9,0;1,0;3,0;2,0;1,0;2,0;6,0;8,0;;4,0;;7,0;9,0;;;3,0;2,0;;;1,0;1,0;83,0;1,0;6,0;2,0;;17,0;10,0;28,0;4,0;1,0;;3,0;;1,0;;;4,0;;30,0;1,0;5,0;3,0;2,0;4,0;1,0;;1,0;21,0;;4,0;1,0;6,0;;;;24,0;2,0;4,0;22,0;;14,0;;1,0;;;1,0;;3,0;1,0;4,0;;;;;;;20,0;86,0;43,0;;4,0;;2,0;12,0;4,0;;;;14,0;26,0;;2,0;;6,0;2,0;;10,0;22,0;;3,0;;;40,0;;;;1,0;15,0;;5,0;3,0;1,0;;;;;15,0;1,0;4,0;1,0;6,0;;14,0;8,0;5,0;10,0;41,0;10,0;12,0;;4,0;;2,0;;2,0;3,0;10,0;;;;3,0;1,0;;;3,0;3,0;4,0;;;;1,0;5,0;;1,0;2,0;;1,0;3,0;;;3,0;;;1,0;1,0;;10,0;15,0;;1,0;;;;;;;;;;;;;1,0;;;11,0;2,0;8,0;9,0;1,0;7,0;113,0;2,0;;;;;39,0;;;;;4,0;;;;;;;;;;;131,0;;2,0;11,0;;;;4,0;;5,0;;;6,0;18,0;;;;1,0;;;13,0;9,0;;;1,0;;;;;;;;;1,0;;;1,0;;28,0;1,0;4,0;2,0;8,0;;;;7,0;;;6,0;;5,0;;;4,0;1,0;;;;;2,0;2,0;3,0;;;;;;21,0;3,0;;2,0;;;;;1,0;1,0;13,0;;;;2,0;2,0;11,0;;;;;;3,0;;12,0;;;;2,0;;10,0;11,0;;2,0;2,0;6,0;1,0;1,0;1,0;1,0;;1,0;;1,0;2,0;1,0;9,0;14,0;;;2,0;;3,0;1,0;4,0;;3,0;;3,0;15,0;2,0;2,0;;;;1,0;33,0;;;;6,0;;;;1,0;4,0;;;;;3,0;22,0;;1,0;;4,0;;;;;;3,0;;2,0;;;3,0;11,0;2,0;;;;;;;;;2,0;1,0;2,0;;;7,0;1,0;2,0;3,0;;2,0;2,0;;4,0;;3,0;2,0;;9,0;3,0;1,0;1,0;;2,0;;6,0;;1,0;;8,0;5,0;;;5,0;;;2,0;3,0;;1,0;;;;;;;;;1,0;;;2,0;1,0;1,0;1,0;;;;;;;1,0;;8,0;;2,0;1,0;;2,0;;;3,0;;6,0;;5,0;;;;;;;;;;7,0;2,0;;1,0;2,0;;;6,0;4,0;;;;;;;;1,0;;;;1,0;2,0;4,0;;;;;;10,0;;7,0;;;;;;;11,0;;;;;3,0;2,0;;;;;;;;1,0;;;;;;8,0;;;;;;;;;;;;2,0;;;;;3,0;;4,0;;;;;;;1,0;;;;;1,0;;;;;;5,0;;;;;;;3,0;;;;;;;2,0;;4,0;3,0;;;;;;;;;;;;;;;;;1,0;;15,0;;;;;;;;8,0;;;3,0;;;2,0;5,0;;;;7,0;;;;;;;;
picture;;;21,0;;88,0;;;55,0;15,0;98,0;10,0;21,0;;4,0;16,0;3,0;;;7,0;16,0;4,0;70,0;4,0;7,0;9,0;3,0;17,0;191,0;;62,0;27,0;34,0;141,0;31,0;180,0;10,0;7,0;17,0;1,0;151,0;11,0;4,0;14,0;117,0;5,0;1,0;;;27,0;39,0;9,0;120,0;25,0;30,0;;268,0;53,0;;;63,0;;10,0;119,0;;;3,0;186,0;;17,0;28,0;16,0;4,0;14,0;9,0;;;;10,0;43,0;5,0;1,0;73,0;14,0;17,0;2,0;;57,0;6,0;25,0;35,0;39,0;12,0;35,0;148,0;29,0;18,0;;32,0;48,0;;19,0;62,0;2,0;15,0;5,0;4,0;2,0;168,0;;;6,0;10,0;13,0;3,0;;;;;;8,0;;;6,0;41,0;10,0;;55,0;;;;6,0;41,0;;;1,0;3,0;1,0;;;1,0;;;13,0;7,0;4,0;1,0;29,0;257,0;;8,0;;;;;1,0;;;3,0;1,0;55,0;16,0;12,0;2,0;2,0;4,0;;25,0;31,0;;2,0;3,0;4,0;7,0;6,0;15,0;4,0;1,0;55,0;;;;1,0;1,0;7,0;;5,0;;105,0;;52,0;;;;57,0;;1,0;;;;1,0;;;;6,0;;9,0;2,0;;;2,0;;6,0;;;;123,0;32,0;6,0;;3,0;;5,0;;1,0;;;5,0;;;;;;3,0;2,0;43,0;4,0;;3,0;14,0;6,0;3,0;;37,0;;;3,0;;5,0;;;;28,0;;6,0;13,0;1,0;;5,0;;;8,0;14,0;21,0;;;;2,0;;;;;;;;1,0;12,0;;;;2,0;;;2,0;4,0;;371,0;2,0;65,0;13,0;;;;;6,0;;2,0;;38,0;;;3,0;;25,0;2,0;2,0;;;24,0;;;71,0;42,0;;;;;;;;1,0;1,0;7,0;;;;33,0;;;4,0;4,0;23,0;3,0;;;;1,0;;7,0;1,0;;;39,0;3,0;20,0;27,0;3,0;2,0;3,0;;29,0;13,0;;38,0;;;2,0;8,0;;;;11,0;10,0;;;4,0;15,0;;;10,0;;1,0;;;15,0;23,0;31,0;5,0;6,0;;6,0;13,0;7,0;2,0;4,0;;1,0;39,0;2,0;10,0;105,0;1,0;8,0;3,0;;1,0;22,0;16,0;14,0;3,0;2,0;;;1,0;8,0;8,0;;6,0;20,0;2,0;4,0;9,0;5,0;;1,0;;3,0;7,0;;13,0;;8,0;1,0;;3,0;133,0;;17,0;14,0;60,0;19,0;12,0;7,0;;;;1,0;2,0;3,0;3,0;;2,0;6,0;4,0;9,0;1,0;9,0;;35,0;2,0;2,0;;1,0;1,0;3,0;2,0;26,0;;;13,0;;1,0;;2,0;;1,0;12,0;3,0;;43,0;;;18,0;2,0;;;;40,0;1,0;8,0;3,0;;;;;2,0;1,0;4,0;3,0;;8,0;7,0;6,0;;;82,0;23,0;15,0;;1,0;6,0;2,0;2,0;2,0;1,0;;1,0;1,0;;;;;;;3,0;8,0;2,0;;9,0;;3,0;;;5,0;2,0;10,0;;7,0;;8,0;1,0;3,0;2,0;;;23,0;;;;;;;9,0;;;;;1,0;11,0;;;1,0;;;7,0;3,0;;7,0;2,0;1,0;;73,0;;12,0;;;;4,0;;;4,0;;2,0;2,0;;;;3,0;;;;;79,0;21,0;;3,0;1,0;;1,0;;;4,0;;;17,0;;1,0;;;1,0;;;;49,0;6,0;;;;39,0;;1,0;;;1,0;;;9,0;2,0;;;3,0;;;4,0;;2,0;;;;7,0;;;;;25,0;;1,0;9,0;;;;;6,0;;1,0;;64,0;;;3,0;;27,0;7,0;;;;;;;8,0;4,0;1,0;;;;;8,0;1,0;;;;;;4,0;;;;;2,0;;;;;19,0;63,0;;;;;;;;;2,0;;;;;16,0;9,0;1,0;;;;2,0;2,0;;1,0;;;35,0;;3,0;;1,0;4,0;;;;2,0;16,0;;13,0;;1,0;;;1,0;4,0;;4,0;9,0;17,0;3,0;11,0;;;1,0;2,0;5,0;;1,0;9,0;;;;10,0;;19,0;;;;;14,0;;;;;8,0;;2,0;1,0;;;17,0;3,0;;;1,0;;7,0;1,0;;;;;4,0;10,0;2,0;7,0;;;1,0;4,0;6,0;16,0;1,0;3,0;1,0;;;;;;2,0;2,0;9,0;12,0;;;4,0;6,0;;;;;6,0;;;;;;1,0;;24,0;;;;1,0;3,0;;;;44,0;;;1,0;;;1,0;;7,0;5,0;20,0;;;;;;13,0;;;2,0;2,0;13,0;;;;1,0;;;2,0;;;;6,0;;13,0;;;;;;;;;2,0;;;186,0;;;;4,0;;;;;;;;;;;;;;;;;;;1,0;1,0;;3,0;1,0;32,0;;;;343,0;;;;;;;2,0;;;;4,0;;;;19,0;2,0;;;;2,0;15,0;;;;;1,0;;;1,0;4,0;;;3,0;;;2,0;;;;;;23,0;;;;1,0;;;;;;;;;6,0;;;;;;;;;;;;6,0;;;;2,0;1,0;;;;;;;;2,0;;;;;;;;;6,0;23,0;;;;;;;;;
pitch;;;1,0;;4,0;;27,0;6,0;1,0;2,0;;;;;;;1,0;;;2,0;;1,0;2,0;1,0;3,0;;;2,0;1,0;1,0;5,0;39,0;7,0;;2,0;;;35,0;;;5,0;;2,0;16,0;;7,0;;4,0;11,0;;;3,0;;2,0;2,0;26,0;10,0;1,0;3,0;53,0;5,0;;9,0;1,0;;2,0;7,0;;;;6,0;;;;;;;11,0;12,0;;;;;;;;3,0;;;;26,0;3,0;;3,0;;;;;;;1,0;3,0;;;;2,0;;4,0;;;1,0;13,0;6,0;1,0;;;;;;4,0;;;2,0;;;;1,0;;;;;;1,0;;;;3,0;;;;;;;;1,0;;4,0;18,0;;;5,0;;10,0;;;;;;;5,0;;3,0;;;2,0;1,0;;4,0;;;;;2,0;3,0;59,0;;;;;;;;;;;1,0;;8,0;;3,0;;;1,0;2,0;;;;;1,0;;;;;;;;;;;3,0;;;;;3,0;7,0;1,0;;;;;8,0;;;;;;;;;;;5,0;5,0;14,0;18,0;;;2,0;1,0;;;;;;13,0;;;3,0;;;;;;;;2,0;;;;;10,0;;;;;;;;;;;;;;;;;;;;;;7,0;;;;7,0;;;;2,0;1,0;;;1,0;1,0;;;;;;8,0;;;;;5,0;;;7,0;2,0;;;;;;;2,0;;;;;;;;;;;;;;;;;;;;;5,0;3,0;;;;2,0;;;;;;3,0;;;3,0;;3,0;;1,0;;;;;2,0;;;1,0;;;;;;;;;;;1,0;1,0;;1,0;;11,0;;;;;;;;;;4,0;;;;;;;4,0;;;;;1,0;;4,0;;;;;3,0;;;;;;;;2,0;;1,0;;;;1,0;;;;;;;;;;;;;;;;;;;;;1,0;1,0;;;;;;3,0;;;;;;;;;;;2,0;;2,0;2,0;;3,0;;;;2,0;;;;;;;;;;;;;;;;;3,0;;2,0;;;2,0;7,0;;;;;;;;1,0;2,0;;;;;;;;;;;;;;;;;;;;;;2,0;;;;;;;;;;;;;;;;;;;;;;;;;;;;;;2,0;1,0;;;41,0;;;;;;;;;;23,0;;;;;;;;;;3,0;;2,0;;;4,0;;;3,0;;;;;;;;;;;;;;;;;;1,0;;;;;;;;;;;;;;;;;;;;;;;;;;4,0;;;;;;;;;;;;;;;;;;1,0;;;;;;;;2,0;;1,0;;;;;;;;;;;;;2,0;4,0;;;;;;;;;;;;;;;;;;;;;;;8,0;;;3,0;;;;;;;;;;;;;13,0;;;;;;;1,0;;;9,0;;;;;;;;;4,0;1,0;;;;;;;;;;;;;;;;;;;;;;;;;6,0;17,0;;;;2,0;;;;;;;;;;;;;;;;;;1,0;;;;;;;;;;;;;;;;;;;;;;;;;;;;;;;;;;;;;;;;;;;;;;;;;;;;;;;;;9,0;;;;;;;;;;;2,0;;;;;;;;;;;;;8,0;;;;;;;;;;;;;;;;1,0;;;;;;;;;;;;;;;;;;;;;;;;;;;;;;;;;;;;;;2,0;;;;;;;;;;;;;;;;;;;;;;;;;;;;;;;;;;;;;;;;;;;1,0;;;;;;;3,0;;1,0;;;;;;1,0;;;;;;;;;;;;;;;;;;;;;;;;;
plane;;;2,0;;23,0;3,0;284,0;91,0;26,0;57,0;29,0;;3,0;3,0;52,0;2,0;5,0;;55,0;6,0;1,0;12,0;23,0;6,0;15,0;;3,0;67,0;39,0;19,0;32,0;24,0;78,0;4,0;19,0;25,0;22,0;171,0;6,0;32,0;67,0;;13,0;88,0;;;5,0;240,0;40,0;;21,0;22,0;;71,0;35,0;759,0;113,0;;11,0;302,0;6,0;8,0;99,0;;3,0;2,0;38,0;9,0;3,0;3,0;325,0;7,0;22,0;;;25,0;2,0;119,0;158,0;20,0;;22,0;11,0;12,0;;8,0;39,0;12,0;19,0;32,0;103,0;5,0;65,0;24,0;14,0;24,0;;;5,0;25,0;162,0;119,0;;8,0;3,0;;3,0;25,0;;1,0;4,0;62,0;134,0;27,0;31,0;;5,0;1,0;10,0;25,0;2,0;;5,0;3,0;7,0;3,0;36,0;5,0;;7,0;10,0;4,0;;16,0;1,0;53,0;68,0;;8,0;9,0;2,0;;2,0;52,0;28,0;13,0;115,0;32,0;3,0;11,0;2,0;6,0;22,0;;13,0;11,0;15,0;76,0;10,0;219,0;6,0;4,0;5,0;10,0;2,0;10,0;4,0;129,0;;1,0;80,0;53,0;57,0;42,0;15,0;17,0;7,0;26,0;;1,0;5,0;;35,0;;11,0;;63,0;51,0;8,0;75,0;;5,0;9,0;41,0;3,0;24,0;1,0;;37,0;13,0;;28,0;;60,0;;18,0;13,0;14,0;10,0;50,0;;1,0;4,0;1,0;10,0;12,0;3,0;4,0;;;30,0;27,0;4,0;12,0;10,0;14,0;7,0;;;5,0;2,0;;;17,0;8,0;118,0;;6,0;80,0;;13,0;;2,0;28,0;6,0;2,0;8,0;1,0;2,0;16,0;3,0;;4,0;18,0;1,0;6,0;4,0;79,0;2,0;6,0;4,0;18,0;11,0;1,0;4,0;;47,0;5,0;;9,0;;23,0;43,0;;5,0;3,0;;2,0;;64,0;5,0;1,0;2,0;2,0;;14,0;35,0;75,0;6,0;8,0;4,0;87,0;10,0;32,0;;155,0;;22,0;16,0;;9,0;;31,0;30,0;27,0;7,0;3,0;16,0;3,0;7,0;55,0;18,0;3,0;2,0;2,0;;11,0;;1,0;1,0;4,0;12,0;19,0;8,0;;35,0;6,0;2,0;3,0;18,0;5,0;1,0;4,0;;;;5,0;;1,0;15,0;;14,0;;14,0;6,0;;1,0;6,0;3,0;13,0;20,0;;28,0;;;;;;;2,0;2,0;;15,0;;8,0;2,0;;1,0;8,0;3,0;;12,0;;12,0;1,0;;6,0;;;219,0;;11,0;;;;1,0;;4,0;;1,0;;1,0;2,0;;16,0;5,0;1,0;86,0;7,0;1,0;12,0;;5,0;5,0;21,0;2,0;47,0;18,0;;;19,0;1,0;;13,0;;1,0;18,0;;10,0;8,0;40,0;;;8,0;;;3,0;2,0;2,0;17,0;1,0;3,0;1,0;;;1,0;1,0;3,0;;;;;4,0;;1,0;4,0;14,0;10,0;2,0;1,0;;;34,0;3,0;;1,0;;;4,0;;;;;6,0;5,0;6,0;56,0;;27,0;;;19,0;4,0;1,0;;3,0;5,0;1,0;2,0;2,0;;;;;3,0;20,0;11,0;1,0;;16,0;20,0;3,0;1,0;1,0;9,0;50,0;5,0;1,0;;;;;;;11,0;2,0;;13,0;;;;;;1,0;1,0;3,0;12,0;;;;;;;;;1,0;4,0;;;2,0;;5,0;4,0;;;;;;;;;4,0;;;;5,0;2,0;7,0;;;2,0;3,0;2,0;1,0;;;1,0;;1,0;5,0;40,0;;;;;;28,0;1,0;;;6,0;;;;94,0;;2,0;4,0;;;3,0;;29,0;;;2,0;;;;;;;5,0;;;1,0;6,0;;1,0;17,0;4,0;;4,0;17,0;2,0;;;10,0;1,0;;17,0;6,0;1,0;8,0;;;;;;3,0;;4,0;;7,0;;5,0;;;;1,0;;3,0;5,0;8,0;6,0;;51,0;8,0;31,0;18,0;;;12,0;4,0;3,0;;;;2,0;6,0;7,0;16,0;;;;;3,0;1,0;8,0;9,0;8,0;2,0;;6,0;3,0;2,0;6,0;1,0;;5,0;;2,0;;3,0;63,0;3,0;1,0;;;;;;;1,0;65,0;;1,0;;;;;;;4,0;2,0;;;71,0;19,0;5,0;2,0;;;;7,0;4,0;;;;3,0;;3,0;1,0;5,0;;2,0;;2,0;;;;3,0;1,0;10,0;;2,0;;;;;;;4,0;4,0;;1,0;;4,0;1,0;;;3,0;;3,0;;;12,0;8,0;4,0;;4,0;;3,0;2,0;;9,0;;;4,0;14,0;;13,0;1,0;9,0;;;12,0;2,0;1,0;;1,0;1,0;;;7,0;17,0;;4,0;2,0;;;2,0;6,0;;3,0;15,0;;7,0;;;;5,0;;3,0;1,0;1,0;;7,0;;2,0;1,0;;;;3,0;;2,0;;27,0;;8,0;1,0;;;;;;;2,0;;;;36,0;;;3,0;;1,0;4,0;1,0;9,0;2,0;10,0;;2,0;;;;;1,0;4,0;1,0;;;;;;;11,0;;;;;;1,0;;2,0;;1,0;11,0;3,0;;;;6,0;;;3,0;;;;4,0;3,0;;;;3,0;;3,0;1,0;;;;6,0;4,0;;;2,0;5,0;;;2,0;;;2,0;;2,0;;;;;;;8,0;;;;4,0;;;9,0;1,0;;;2,0;6,0;15,0;;;21,0;;3,0;;;;;2,0;5,0;;;;;;;;1,0;4,0;;;;;;;17,0;;;;5,0;;;;7,0;2,0;2,0;;;;;22,0;51,0;5,0;;;22,0;;1,0;1,0;2,0;1,0;;;;;;;;;;;;;;;2,0;10,0;;;;;;;;;3,0;;7,0;;;;
plural;;;3,0;;23,0;;5,0;14,0;10,0;15,0;;;1,0;;9,0;1,0;;;15,0;;;7,0;3,0;6,0;1,0;;;55,0;2,0;23,0;3,0;4,0;32,0;1,0;15,0;;;18,0;4,0;152,0;4,0;;;3,0;;;;;1,0;14,0;32,0;16,0;;7,0;;328,0;45,0;;4,0;9,0;4,0;16,0;18,0;;;;9,0;1,0;;7,0;8,0;;4,0;;;;;17,0;35,0;3,0;1,0;17,0;3,0;;;;24,0;1,0;;32,0;20,0;2,0;12,0;18,0;3,0;3,0;;4,0;25,0;3,0;5,0;18,0;;1,0;;;;54,0;;;;14,0;8,0;;5,0;2,0;2,0;1,0;;5,0;;;2,0;;1,0;;15,0;6,0;;1,0;2,0;;;3,0;;10,0;5,0;;6,0;4,0;;;4,0;;3,0;1,0;11,0;46,0;;;1,0;7,0;4,0;;2,0;;2,0;;;5,0;2,0;;2,0;;;7,0;4,0;16,0;;;16,0;;6,0;3,0;;2,0;;46,0;;;3,0;;1,0;;;3,0;2,0;5,0;;21,0;;7,0;;4,0;1,0;;;;1,0;;3,0;;;4,0;;12,0;;2,0;1,0;2,0;;;;3,0;;16,0;12,0;1,0;;;;2,0;;;2,0;;1,0;;;;;1,0;;3,0;1,0;;;4,0;24,0;2,0;3,0;;9,0;1,0;;;;;2,0;;;;;24,0;1,0;;;5,0;11,0;1,0;2,0;2,0;2,0;;5,0;;3,0;;;;;;;;;;;;;2,0;;;;;;2,0;;7,0;11,0;;;;;3,0;;1,0;;7,0;;;;;10,0;;;;;2,0;;;12,0;1,0;;;;;;;;;;3,0;;;;1,0;;;;;4,0;;;;;;;;;;;3,0;;;;1,0;;9,0;;6,0;2,0;1,0;;;1,0;;;;;5,0;1,0;;;;3,0;7,0;;;;;4,0;3,0;;;6,0;6,0;;2,0;;2,0;;7,0;;1,0;;1,0;3,0;3,0;;5,0;;1,0;;;;;;3,0;;;;;;;;;;3,0;;;;;;5,0;;4,0;1,0;;10,0;;;1,0;;2,0;52,0;;2,0;9,0;;6,0;3,0;1,0;;;;;;3,0;;;;;;;;1,0;;;;3,0;;3,0;6,0;;1,0;2,0;;;;;;;;;;10,0;3,0;4,0;6,0;;2,0;6,0;;;;;16,0;;;;1,0;;;;;4,0;12,0;;11,0;3,0;;12,0;;3,0;10,0;1,0;;;;;;12,0;;2,0;8,0;2,0;;;;;;;;;8,0;2,0;2,0;;;;;;1,0;;;1,0;;;;;;;;;2,0;1,0;;;;;;2,0;;;;;2,0;;;;;1,0;;;;;1,0;;;4,0;26,0;;6,0;1,0;;;;;;;;;;;;;;;;;;3,0;5,0;;;24,0;;;2,0;3,0;;;;8,0;6,0;1,0;;;1,0;;;2,0;11,0;;;;;;;;;39,0;;;;;;;;;;;;4,0;;;;;13,0;;;1,0;;3,0;;;4,0;;4,0;;;;;;1,0;1,0;2,0;;;;;;;16,0;;;;;6,0;;;;;;;;;;;;;;;;2,0;;;;;;;;;1,0;;;;3,0;;;;3,0;;;3,0;;;;;;;;;;;;;;;4,0;;;;6,0;2,0;16,0;;;;;;;;;;;;;;;1,0;1,0;;1,0;;;3,0;;;;;;;;;;;;;;1,0;;;1,0;1,0;;2,0;;1,0;1,0;;2,0;;;;4,0;;1,0;1,0;;;;;;;1,0;;;;;;1,0;;;;;;2,0;;;;4,0;;;;;;;1,0;;;;;30,0;;;;;;1,0;;;;;;;;;;;;;;;;;;;3,0;;;2,0;;;;;;;13,0;;;;;4,0;1,0;;;;;;;;;;;;;;;1,0;;;;;;;;;;2,0;;;;;;;;;;;;;;;3,0;;;;;;;;;;2,0;;;;;;1,0;;;;;;;;1,0;;;;;;;;;;;;;;;;;;2,0;1,0;;;3,0;;1,0;;4,0;;;;;;;;;;;;;;;;;;;10,0;;;;;;3,0;3,0;;;;;;;;;;;2,0;;;;;;;;;;;;;;;;;;;;;;;;;;;;
polarize;;;1,0;;3,0;;3,0;;;;2,0;;3,0;;;3,0;;;7,0;;;7,0;;;3,0;;;;5,0;;;2,0;11,0;5,0;2,0;;;23,0;;7,0;1,0;;;3,0;;;;;;;;1,0;;;;9,0;24,0;;;1,0;4,0;;7,0;;;;2,0;;;;8,0;;3,0;;;;1,0;;1,0;;;;2,0;;;;27,0;;;;5,0;;;6,0;;;;;;;10,0;28,0;;;;;;1,0;;;4,0;3,0;4,0;;3,0;2,0;;1,0;;1,0;;;;;2,0;;1,0;;;;;;4,0;;;;10,0;;1,0;11,0;;;;1,0;137,0;;9,0;;;2,0;;3,0;;;;;4,0;;10,0;7,0;7,0;;;1,0;;2,0;;98,0;;;;1,0;;5,0;;;;1,0;2,0;;;;6,0;;;;33,0;16,0;17,0;1,0;;;;3,0;;5,0;;;1,0;;;2,0;;;;7,0;;;;;;;;;;;3,0;2,0;;1,0;;;;;;2,0;;;1,0;;;;5,0;2,0;;22,0;1,0;7,0;;;;;5,0;;;;;;;;;;;;;;;2,0;;;;;;;;;;;;;;;;;1,0;;;;;;;;;;;;2,0;1,0;;2,0;;4,0;;2,0;;9,0;;;;;;;1,0;2,0;;;;;;;;2,0;;;;;1,0;;;;;8,0;;;;13,0;;;;;;;;;;;;;;;;2,0;;;;;;;;;;;;;;;;;;;;;;;;;;;;;;;;;;;;;;4,0;;;;;;;1,0;;;;;6,0;;;;;;;;;;;;;;;;;;;1,0;;;;;;2,0;;;;2,0;;;;;;;;;;;;;;;;;;;;;;;2,0;;;1,0;;;;;1,0;3,0;;;;;;;;;;;;;;;;;;;10,0;;;;;;;;;;;;;;7,0;12,0;;;2,0;;;3,0;;7,0;;;6,0;;;;;;;11,0;;;6,0;;;;;;;;;;;;;;;;;;;;;;;;;;;;;;;;;;;;;;;;;;;;;;;;;;;;;5,0;;;;;;4,0;;;;;;;;;;;;;;;;4,0;;;;;;;;;;;;2,0;;;;;;;;;;;;;;;;;;;;;;;;;;;;;1,0;;;;;;;;;;;;;10,0;;;;;;;;;;;;;;;;;;;;;;;;;;;;;;;;;;;;;;1,0;;;;;;;;;;;;;;;;;8,0;;;;;;;;;;;;;;;;;;;;;;;;2,0;;;;;5,0;;;3,0;;;;;;;;;;;;;;;;;;;;;;;;;;;1,0;;;;;;;;;2,0;;2,0;;;;;;;;;;;;1,0;;;;;;;;;;;;1,0;;;;;;;;;;;;;;;;;;;;;;;;;;;;;;;;;;;;;;;;;;;1,0;;3,0;2,0;;;;;;;;3,0;;;;;;;;;;;;;;;;;;;;;;2,0;;;;;;;;;;;;;;;;;;;;;;;;;;;;;;;;;;;;;;;;;;;;;;;;;;3,0;;3,0;;;;;;;;;2,0;;;;;;;;;;;;;;;;;;;;;;;;;4,0;;;;;;;;;;;;;;;;;;;;;;;;;;;;;;;;;;;;;;11,0;;;;;;;;;;;;;;
potential;;;1,0;;1,0;;;13,0;;8,0;;9,0;;;;;;5,0;;;;18,0;;;;;;2,0;7,0;17,0;31,0;30,0;35,0;60,0;22,0;8,0;2,0;3,0;;2,0;;;7,0;1,0;;2,0;;;;;;19,0;2,0;5,0;6,0;62,0;6,0;;4,0;;;;11,0;;;5,0;;;7,0;6,0;;;4,0;;;;;14,0;1,0;3,0;;2,0;1,0;;;;36,0;5,0;9,0;2,0;1,0;3,0;;62,0;3,0;1,0;;;2,0;1,0;1,0;10,0;;42,0;;;9,0;31,0;;;;5,0;;;;;57,0;;2,0;;;;4,0;36,0;;11,0;4,0;4,0;;;3,0;;1,0;1,0;;;8,0;;13,0;;7,0;;;4,0;1,0;2,0;4,0;;;;;;;;;;;4,0;;3,0;1,0;;;;;10,0;4,0;26,0;14,0;8,0;8,0;;1,0;;1,0;;;47,0;;;;;;;;;4,0;8,0;;11,0;;;;5,0;4,0;;;;1,0;;9,0;;1,0;4,0;;;7,0;;3,0;;;;;;;8,0;;;;;;6,0;;;;;1,0;;;;;;;1,0;2,0;1,0;;25,0;;;;;;;;;1,0;;;;;;2,0;15,0;;;;;;;2,0;4,0;;2,0;;;;;;;;;10,0;;;;;;1,0;;1,0;;;6,0;;2,0;1,0;;4,0;7,0;1,0;;;;;;17,0;;;;;;13,0;;;;;6,0;;;27,0;8,0;;;;;;;;;;6,0;;;;11,0;;;5,0;;1,0;;;;;12,0;;;;;;5,0;;;;;;;;;;;;17,0;;;;;;;;2,0;;;15,0;;;;;;1,0;;2,0;1,0;;;;;;1,0;;2,0;;;9,0;;;;;;3,0;6,0;;;;;1,0;9,0;6,0;;6,0;;2,0;;;;;;;4,0;;;5,0;;;;1,0;;6,0;;13,0;;;1,0;;;;23,0;1,0;;;;;;;;;;;3,0;;;;;;;13,0;;2,0;;;;;;;;;;;;3,0;;;;;;;;2,0;;;1,0;;2,0;;;2,0;3,0;;;16,0;;;;;1,0;;;4,0;3,0;;7,0;;3,0;;;;59,0;;;1,0;;;;;;;;;;;;;;;;;;;;;;;;1,0;;2,0;;;;;;;;;;;;;;;;;;;;;;;;;;;;;;;;;;12,0;;;;;;9,0;;;;;;;;;;;;;;;;;;;2,0;;;;3,0;;;;;;51,0;;;;;;;5,0;;;;;;3,0;;;;;;2,0;;;;;;24,0;;;;;;;;;;;2,0;;;;;;;;;;;;;1,0;;;;;2,0;;;;;;;;;1,0;;;;;;;;;;;;;;;;6,0;;;;;;3,0;10,0;;;;3,0;6,0;8,0;;15,0;;48,0;3,0;;;19,0;31,0;3,0;;3,0;;5,0;21,0;;;;5,0;3,0;;;7,0;6,0;;;;;25,0;;;;1,0;1,0;;;;;;;;;;;19,0;;;;;;1,0;;1,0;;;;;;;;;;;;;;;;;;;;;;;;;;;;;;4,0;;;;;6,0;;;;;;;2,0;;;;;;;;;;;1,0;;;;;;;;;;;;1,0;;;;;4,0;2,0;;;;1,0;;2,0;;6,0;;;;;;;;;;1,0;;;;;;;;;;;;;;;;;6,0;;;;;;;;;;;;2,0;;1,0;;;;;;;;;;;;;;5,0;;;;;;;;;;;;;;;;;;;2,0;;;;;;;;;;;;;;;;;;;;;20,0;;;;;;;;;;;;;;;;;;;;;;;;;;;;;;;;;;;;;;;;;;;3,0;;1,0;5,0;1,0;;;;;;;4,0;;;;;;;;;2,0;;;;;;;;;;;;;;;;;;;;;;
predict;;;2,0;;11,0;;;26,0;;4,0;3,0;;;;;;;;2,0;;34,0;4,0;;1,0;4,0;;6,0;;;6,0;1,0;5,0;6,0;6,0;8,0;4,0;;1,0;;2,0;;;3,0;;4,0;;;;1,0;;1,0;7,0;;;;45,0;1,0;;;1,0;;;18,0;;7,0;;5,0;;3,0;;;;10,0;;;1,0;;25,0;55,0;;;1,0;8,0;;;;4,0;;2,0;;3,0;1,0;;;3,0;;;;;;;3,0;;;;;;25,0;;;1,0;;;;;;;;;2,0;;;;;;;15,0;;;;;;;;;2,0;;;;1,0;;;;;1,0;;4,0;24,0;;;;;;;;;;;;;;;;;;;5,0;;;;;2,0;;;27,0;;;8,0;;;;;2,0;;;3,0;;6,0;;4,0;;;;;;;;;;;;;;;;4,0;;;;;;;35,0;;;15,0;;;;;;1,0;;;;;4,0;;;;;;6,0;;2,0;1,0;;1,0;17,0;;;;;;;2,0;;;;;;;;1,0;1,0;;;2,0;;;;;;;;;;;;;;;;;;;;;;;;;;;;5,0;2,0;26,0;;;;;1,0;2,0;;;;2,0;;;;;1,0;;;;;;;;4,0;;;;;;;;;;;;;;2,0;;;;;;2,0;;;;;;;2,0;;;;7,0;;;6,0;1,0;;;;8,0;;;5,0;;;;;;;;2,0;;;;2,0;;;;;11,0;;;;2,0;;2,0;;;;;4,0;1,0;;;;;;;;;;1,0;;;;8,0;;1,0;4,0;;3,0;;;;3,0;;;;;;;;;;;;46,0;;4,0;;5,0;;;;5,0;;;;5,0;4,0;4,0;;;;;;1,0;1,0;;;;;;;;;;;;;;;3,0;27,0;;;;;;;;;;;;;;;4,0;;;1,0;;;;;;;;;;;;;;;;;;;;;21,0;;18,0;9,0;1,0;;;;;;;;;;;;;;;;;;;;;;;;;;;;;;;;;;;;;;;;;;;;;;;;;;;;;;1,0;;;;;;2,0;;;16,0;9,0;;;;1,0;;;;;;;;;;;;;;;;;4,0;6,0;;;;;;;;;;;;;;;;;;;;;;;;;;;;;;;;;;;;;;1,0;;;;;;;;;;;;;;;;;;;;;;;;;;;;;;7,0;;;;;;;;;;;;;;;;;;;;;;;;;;;;;;;;;;4,0;;;;;;;;3,0;;3,0;;;;;;;;;;;;;;;3,0;;;;;;;;;;;;;;;;;;;;;;;;;;;;;;;;;2,0;;;;;;;;;;;;;;;;;;;;;;;;;;;;;2,0;;;;;;;;;;;;;;;1,0;;;;;;;;;;;;;;;;;;;;;;;;;;;;;;;;;;;;;;;;;;;;;;3,0;;;;;;;;;;;;;;;;;1,0;;;;;;;;;;;;;;;;;;;;;;;;;;;4,0;;;;;;;;;;;;;;;;;;;;;;;3,0;13,0;;;;;;1,0;;;;;;;;;;;;;;;1,0;;;;;;;;;;;;;;;;;;;;;;;;;;1,0;;;;;;;;;;;;;;;;;;;;;;;;;1,0;;;;;;;;;;;;;;;;;;;;;;;;;;;
presence;;;1,0;;1,0;;;14,0;;11,0;;1,0;;;7,0;;;;;2,0;6,0;2,0;;;;;;8,0;;39,0;8,0;55,0;16,0;6,0;1,0;;;4,0;;1,0;;1,0;;11,0;;;;;;2,0;4,0;6,0;1,0;3,0;;46,0;3,0;;;6,0;;;16,0;;;;14,0;;;2,0;2,0;2,0;;;;4,0;;3,0;;3,0;;4,0;4,0;;;;4,0;5,0;5,0;7,0;6,0;;;9,0;;1,0;;12,0;;;;7,0;;;;;;9,0;;;;;;;;;;;1,0;1,0;;;;;;;5,0;;;1,0;;1,0;;;;;1,0;;;2,0;;;;21,0;;;;2,0;;1,0;;;;;;1,0;;;;6,0;;;;;7,0;;;2,0;9,0;4,0;;;;;;;;2,0;;;;1,0;;;;;1,0;10,0;;1,0;;;2,0;;;;;;;;;;1,0;;;2,0;;;;;;;;;;4,0;;;;;;4,0;;6,0;;;3,0;;;;;;;2,0;;;;;1,0;;;;;;;;;;;;;;;1,0;1,0;;;1,0;;;;;;;;;;;;;;;;;;1,0;;;;1,0;;;;;;21,0;;41,0;1,0;;;;;1,0;;;;;;;;;4,0;;;;;1,0;;;3,0;;;;;;;;1,0;;;;;;;5,0;2,0;;;;3,0;;;;;1,0;;;1,0;;;;;;;;;1,0;;4,0;;;;;;;;;;;3,0;;;;8,0;14,0;;28,0;;2,0;;;;;13,0;;;;;;1,0;;1,0;1,0;1,0;;3,0;;;1,0;;1,0;;;1,0;1,0;;5,0;3,0;;;;8,0;1,0;;;;1,0;;;;;;1,0;;2,0;14,0;;;;5,0;;;;7,0;;;;;3,0;4,0;;;;;;;;3,0;;;1,0;;;;1,0;;;1,0;;;;6,0;5,0;;;;;;;;;;;;3,0;;;9,0;1,0;;;;;;;;;;;;2,0;;1,0;;;;3,0;;;;;;;36,0;7,0;1,0;;;;;;11,0;6,0;1,0;;;;;;;;;;;;;2,0;1,0;;;;1,0;;;;;;;;;;1,0;;;;;;;;;5,0;;;;;5,0;;;;;;;;;;1,0;;;;5,0;3,0;;;;;;;1,0;;;;;;;;;2,0;;;;;3,0;;;;;;;2,0;3,0;;;;;;;;;;;;1,0;;;;;;;;;;;;;;;;;;;;;;1,0;;;;1,0;;;1,0;;;;;;;;;;;;;;;;;;;;;;;;;;;;;;;;;;;1,0;;;;4,0;;;;;;;;;1,0;;;;;;;;;1,0;;;;1,0;;;;;;;;;;;;;;;;;;;;;1,0;;;;;;;;2,0;;;;;;3,0;;3,0;;;10,0;1,0;;;;;1,0;;;;;;;;;6,0;;;;;;;;;;2,0;1,0;;;;;;1,0;;;;3,0;;;;;;;2,0;;;;;;;;4,0;;;;;;;;;;;;;;;;;;;;;2,0;;;;1,0;;;;;;;;;;1,0;;1,0;;;;;;;;;;;;4,0;;;;;;;;;;;;1,0;;;;;;;;;;2,0;;;;;;;;;;;;;;;;;;;;;;;;;;;;;;;;;;;;;;;;;;;;;;;;;;;;;;;;;1,0;;;;;;;;;;;;2,0;;;;;;;;;;;;;;;;;;;;;;;2,0;;;;;;;;;;;;;;;;;;;;;;;1,0;;;;;;;;;;;;;;;;;;;;;;;;;;;;;;
preset;;;1,0;;8,0;;;5,0;;6,0;;2,0;;;2,0;2,0;;;1,0;4,0;63,0;42,0;;4,0;1,0;;;1,0;3,0;6,0;3,0;7,0;4,0;3,0;;;1,0;9,0;;22,0;1,0;;;5,0;;;;1,0;5,0;3,0;11,0;5,0;;;;61,0;6,0;;1,0;9,0;;;20,0;;;;6,0;;;5,0;;31,0;;;;;;;9,0;2,0;;3,0;1,0;3,0;;;6,0;;;12,0;3,0;5,0;1,0;25,0;4,0;;;4,0;11,0;;;5,0;;6,0;1,0;1,0;;38,0;;;1,0;;;;;;;;1,0;;;;2,0;1,0;;;;;;;1,0;;;;;9,0;2,0;;;;;;;4,0;;;;8,0;;;;;1,0;3,0;;;;1,0;2,0;7,0;;5,0;;15,0;;;7,0;;;;;;;;1,0;;;5,0;;;;;;;;;;29,0;;1,0;;;;;;;;;4,0;;;8,0;;;;2,0;4,0;;;;;;;;12,0;78,0;1,0;;7,0;;;;;;;;3,0;;;;;;;;3,0;14,0;;;28,0;;;;;;;2,0;2,0;;;;;1,0;;;;;;7,0;;;;;4,0;;;;;;;;;;;;;2,0;;;;1,0;;;;;;7,0;8,0;34,0;;;;;;5,0;;;;36,0;;;;;3,0;;;;;2,0;;;12,0;;;;;;;;;;;1,0;;;;;;;;;1,0;;;;;1,0;;;;4,0;;12,0;;4,0;1,0;;;;;3,0;1,0;7,0;;8,0;;4,0;2,0;;;;;;;;;1,0;1,0;1,0;6,0;;4,0;;;17,0;1,0;9,0;;;;;5,0;3,0;;5,0;4,0;;;1,0;2,0;9,0;;1,0;;;;1,0;7,0;32,0;18,0;2,0;19,0;;;;;15,0;;6,0;;3,0;;2,0;;;;1,0;2,0;;8,0;;3,0;;;1,0;10,0;1,0;;2,0;;;2,0;;1,0;;;;;;;2,0;;;;;1,0;12,0;;;;;;;5,0;;;;;5,0;4,0;;4,0;;;;;1,0;;;12,0;1,0;3,0;18,0;;;;;;;;;;;;;;2,0;5,0;2,0;1,0;10,0;;;9,0;;;7,0;10,0;;3,0;2,0;;;;;2,0;;;;;;;;;;;;;;;;;;1,0;;;;2,0;;;;;;;;4,0;;;;;;;;1,0;;;;;;;;1,0;;;;6,0;;;;;;1,0;;;32,0;;3,0;;;;;;;;;;;;;;;;;1,0;;;;;;;26,0;;;;4,0;;;;;;;;;;;;;;;;;;;;;;;1,0;;;4,0;4,0;;;;;;;;;;;;;;;;;;;;;1,0;;;;;;;;;;;;;;;;;;;;;;;;;2,0;;;;;;3,0;;;;;;;;;;16,0;1,0;1,0;;;;;;;5,0;7,0;;2,0;;;;;;4,0;;;;;;;;;;;5,0;;1,0;;;;;;;;;;;;;;1,0;;;;;5,0;;;;;;;;3,0;1,0;;;;;1,0;;24,0;;;;;2,0;;;;;;;2,0;6,0;;;;;1,0;;;;;;;;;;;;;;;;;;;;;;;;7,0;;;;;;;;;;;;;;;;;;1,0;4,0;;10,0;;;;;4,0;;;;;6,0;;;;;;;;1,0;;;;;;;;;;;;;;;;;;;;;;;;;;;;;;;2,0;;;;9,0;;;;;;;;;;;;;;;;;;;;;;;;;;;;;;;;5,0;;;;;;;;;;;;;;;;;2,0;;;;;;;;7,0;1,0;;;;;;;;1,0;;7,0;;;;;;;;;;;;;;;;;;;;;;;;;;;;;;;;;;;;;;;;;;;;;;;;;4,0;;;;;;;;;;;;;;;;;;
primary;;;7,0;;4,0;;8,0;11,0;;38,0;11,0;;;;145,0;1,0;;;14,0;;;5,0;;1,0;;;;29,0;;18,0;17,0;2,0;7,0;;7,0;2,0;;1,0;;12,0;5,0;;;12,0;;;;;;;1,0;5,0;;2,0;2,0;164,0;6,0;;;13,0;;;19,0;3,0;;;;2,0;;7,0;41,0;3,0;12,0;;;;;1,0;20,0;7,0;;11,0;7,0;5,0;;;1,0;2,0;;13,0;4,0;;;11,0;28,0;;;3,0;1,0;1,0;40,0;31,0;;3,0;2,0;2,0;6,0;25,0;7,0;;5,0;4,0;;3,0;;;;8,0;;3,0;;;;3,0;;;16,0;;;;;;;;;2,0;4,0;;;3,0;;2,0;;;3,0;;60,0;4,0;;;10,0;;1,0;3,0;;;;;4,0;27,0;1,0;;;3,0;;1,0;1,0;59,0;;;2,0;9,0;4,0;7,0;;;;13,0;;16,0;;;1,0;;;6,0;1,0;10,0;;11,0;;;;1,0;;4,0;;;;;;;3,0;1,0;;;14,0;;1,0;;;2,0;;;;1,0;;;;;;4,0;;;;2,0;8,0;;;;;;;;2,0;;;;4,0;;;;;;;2,0;;;;;;;;4,0;;;;1,0;;;1,0;;;;;;;;;;;9,0;;;;5,0;;;2,0;2,0;;;;;;20,0;;9,0;;;3,0;;;;;;;;;;1,0;;6,0;;;;;3,0;;;15,0;3,0;;;1,0;;;;;;;;2,0;;;7,0;;;4,0;;4,0;;;;;;;;;;1,0;1,0;;6,0;2,0;;;;;1,0;;;;;;1,0;;;;;;;1,0;46,0;;23,0;1,0;;2,0;4,0;;;;;1,0;;;;;2,0;;;;;;;;2,0;;2,0;;;;;;;;;;;2,0;1,0;;;;;;6,0;;;;1,0;;;;;;;;;;;;;12,0;;3,0;;;2,0;1,0;1,0;;;;;;;;;;;;;;;;8,0;5,0;;;;3,0;1,0;;;;;;;;;;6,0;;;;4,0;1,0;;;4,0;;;;;5,0;;;;;;;;;;;7,0;;3,0;;3,0;;15,0;29,0;5,0;;10,0;;;;;;;9,0;;;;;;;;;;6,0;3,0;;1,0;;;;;;;;2,0;1,0;;2,0;;;;;21,0;;;;;;;;2,0;;;;;;;;;;;;6,0;;2,0;;;;19,0;10,0;;;;;;4,0;;;;;;;;;;;;;;;19,0;19,0;;;5,0;;;;;;;;;;1,0;;;1,0;;;1,0;1,0;;2,0;;;;;;;2,0;1,0;;;;;;;;;;;6,0;;;;;;;1,0;1,0;;;;;4,0;;;;;;1,0;;;;;;;;3,0;;;;;;;;;1,0;1,0;;;;;;;;;;;;;;;;;;;;;;;;;;;;;;1,0;32,0;;;2,0;;;;;;;;2,0;;;;1,0;;;5,0;;;;;;;;;;7,0;;;;;;;;;;;;;2,0;;;2,0;;2,0;;;;2,0;;;;;1,0;;;;;;;;;;;;;;;;;;2,0;;;;2,0;;1,0;;;;;;7,0;;;1,0;;;;;;;;;;;;;;;;38,0;;;;;;;;;;;;;;;;1,0;;6,0;;;;;;;;1,0;;;;1,0;;;;;;4,0;;;;;;;;;;;1,0;;;;;;;;;;;;;;3,0;;1,0;;1,0;;;;1,0;;;;;;;;;;;;;;;;;;;;;;;;;;;;;2,0;2,0;;;;;1,0;;1,0;;;1,0;;;;;2,0;;;;;;;1,0;;;;;10,0;;;;;1,0;2,0;;;;;;;;;;;;;;;;;;;;;;;;;;;;;;;;;;;;;;;;;;;;;;;;;;;;;;;;;;;2,0;;;;;;;;;;;;;
print;;;2,0;;112,0;;7,0;44,0;;61,0;1,0;;;;55,0;2,0;7,0;5,0;5,0;19,0;12,0;41,0;;;;;;287,0;;15,0;2,0;49,0;144,0;2,0;128,0;3,0;1,0;11,0;;105,0;;9,0;13,0;11,0;;;;;;1,0;9,0;19,0;2,0;8,0;1,0;746,0;228,0;;22,0;41,0;;;167,0;;1,0;6,0;42,0;2,0;;44,0;14,0;;21,0;;1,0;25,0;;6,0;61,0;5,0;;31,0;22,0;35,0;;;2,0;1,0;10,0;99,0;50,0;26,0;12,0;14,0;91,0;5,0;;10,0;41,0;54,0;57,0;224,0;;5,0;;;;171,0;;;20,0;36,0;5,0;54,0;7,0;;;;458,0;17,0;;7,0;11,0;461,0;7,0;;115,0;12,0;;33,0;9,0;2,0;;;2,0;;29,0;;20,0;;;;6,0;28,0;14,0;1,0;60,0;21,0;;;;;11,0;;4,0;10,0;6,0;56,0;;34,0;1,0;1,0;7,0;15,0;;24,0;;39,0;;34,0;7,0;2,0;135,0;66,0;6,0;7,0;8,0;107,0;;;;2,0;14,0;5,0;;5,0;68,0;73,0;;66,0;;4,0;;36,0;1,0;1,0;;;1,0;4,0;;9,0;9,0;26,0;;1,0;2,0;3,0;17,0;44,0;;23,0;;;;19,0;26,0;4,0;;3,0;21,0;;;2,0;3,0;;1,0;;;;1,0;1,0;6,0;5,0;20,0;1,0;;36,0;69,0;;2,0;1,0;3,0;2,0;;9,0;;9,0;;6,0;;;8,0;66,0;1,0;;1,0;33,0;55,0;;;7,0;16,0;1,0;7,0;;20,0;12,0;;;114,0;6,0;1,0;2,0;5,0;27,0;212,0;;1,0;11,0;5,0;2,0;3,0;68,0;;18,0;12,0;8,0;17,0;3,0;;1,0;3,0;32,0;;;7,0;10,0;5,0;;6,0;;7,0;;;;1,0;;3,0;4,0;15,0;14,0;;;;11,0;;1,0;;;1,0;23,0;1,0;1,0;;4,0;1,0;2,0;72,0;;12,0;1,0;1,0;;;;1,0;1,0;5,0;;1,0;11,0;1,0;;;;;28,0;;9,0;;2,0;1,0;;;2,0;;;;;;;15,0;;9,0;10,0;;7,0;21,0;;;;;;68,0;19,0;8,0;;;3,0;;15,0;1,0;1,0;;;4,0;7,0;;10,0;2,0;7,0;;;;;7,0;18,0;;;4,0;;2,0;11,0;1,0;;;;5,0;6,0;9,0;27,0;1,0;3,0;2,0;;2,0;;35,0;;7,0;;1,0;8,0;141,0;4,0;20,0;3,0;;4,0;;1,0;;;10,0;;;6,0;3,0;;58,0;;2,0;1,0;;8,0;;4,0;29,0;;;30,0;4,0;;2,0;4,0;4,0;12,0;43,0;;;14,0;;;;11,0;2,0;;18,0;;;35,0;;;1,0;;;1,0;;1,0;7,0;17,0;2,0;6,0;;1,0;105,0;16,0;7,0;43,0;;25,0;1,0;2,0;5,0;5,0;;2,0;;1,0;3,0;1,0;2,0;;2,0;1,0;;2,0;;17,0;6,0;1,0;1,0;13,0;6,0;14,0;34,0;;2,0;;1,0;;;75,0;1,0;;11,0;;;;;;3,0;25,0;22,0;;;;16,0;;;;;4,0;5,0;;;37,0;7,0;32,0;7,0;368,0;;1,0;5,0;;22,0;2,0;;40,0;1,0;2,0;207,0;;;6,0;12,0;10,0;;;169,0;;;;;2,0;27,0;;3,0;;;;6,0;13,0;;9,0;2,0;16,0;;;;6,0;;;;;;;1,0;;;2,0;;;;;;;;;1,0;1,0;;;;1,0;2,0;2,0;;5,0;1,0;28,0;;8,0;;;1,0;;5,0;;;74,0;;4,0;13,0;1,0;;2,0;;8,0;;5,0;;10,0;;;;;1,0;1,0;10,0;3,0;;;1,0;1,0;;;1,0;;19,0;;;;;;3,0;1,0;;1,0;;;;1,0;2,0;9,0;;;;;;;;;5,0;;;;5,0;;;6,0;;;;;;;;;;;;;;;;;;19,0;;6,0;17,0;3,0;;;;3,0;3,0;3,0;;;1,0;5,0;;;1,0;;;;;;3,0;;;;;;;;;;;;;;;;1,0;;;;1,0;;;10,0;;1,0;8,0;13,0;;;;;;1,0;;1,0;;;24,0;3,0;8,0;;;32,0;;3,0;3,0;;8,0;;;;;;;4,0;;;;;;2,0;5,0;1,0;2,0;7,0;;;;;;;;3,0;;8,0;2,0;;;;;2,0;;;;1,0;1,0;;2,0;;;;;;;1,0;7,0;;11,0;13,0;4,0;;;1,0;;;;4,0;;4,0;6,0;;;;;;;;2,0;;2,0;3,0;;;;;1,0;;;;3,0;2,0;;;;2,0;;;1,0;5,0;16,0;;1,0;2,0;;;;;;;;3,0;2,0;;;30,0;;;;;;4,0;15,0;1,0;1,0;;;;3,0;;;;;;;3,0;;1,0;1,0;;;1,0;;5,0;;;;;17,0;;;;1,0;1,0;;;;;;;;;;;4,0;2,0;;;;;2,0;;;;;1,0;;2,0;2,0;;;96,0;;;;;;6,0;;;;;;;;;;;;;;;;;;;;;;;;;;;10,0;;;;;;;;;;;;;
probe;;;2,0;;4,0;;7,0;6,0;1,0;3,0;5,0;;;;;;;;;1,0;;;;;;;;2,0;3,0;6,0;2,0;1,0;3,0;;;;;2,0;;2,0;;;;4,0;;;;;;;;;;;;37,0;4,0;;;3,0;;;8,0;;2,0;;;;;;;4,0;4,0;;;;;1,0;11,0;;;;2,0;5,0;;;1,0;;2,0;1,0;3,0;1,0;;;;;;2,0;;;9,0;16,0;;;1,0;;;7,0;;;;;;;;;;;;2,0;;;;5,0;;;2,0;6,0;;4,0;;;;;;;;;;;;;;;;;2,0;5,0;2,0;;;7,0;;;;;;3,0;;;;;;;;;;1,0;;;;;;17,0;3,0;;;;;;;;;;;;;;;1,0;;;3,0;4,0;;;;;6,0;;;;;6,0;;;;;4,0;;12,0;;;;;;;;;;;;;;;;;;10,0;;;;;;4,0;5,0;;;;;;;;;;;;;;;;;;3,0;;;;;;;;;;;4,0;;;6,0;;;;1,0;;;3,0;;;;;4,0;;;1,0;;;;2,0;5,0;;;;;;;;1,0;;;;;;;1,0;;;;;;1,0;;16,0;;;;;;;;;;;;;;;2,0;;;;;;;;;;;;;;;;1,0;;;2,0;;;;;;;;;;;;;1,0;;;;;;;;;;;1,0;;;;;4,0;1,0;;;;;2,0;;1,0;;;;;;;;;;;;;;;;7,0;;;2,0;;3,0;;;;1,0;;;;2,0;;;;;;3,0;;1,0;1,0;;;;;;;;;;;;;;;;;;;;;;;;;;;;;;;;;3,0;;;;;;;;;;;;;3,0;2,0;;;;;;;;1,0;;;;;;;;;;;;;;;;;;;;;;;;;;;;;;;;;;;;;;;;;1,0;;;;;;;;;;;;;;;;;;;;;;5,0;;;;;;;;;;;;;2,0;;;;;;;;;;;;;;;;2,0;;;;;2,0;;;;2,0;;;;10,0;;;;;;;;;;;;;;;;;1,0;;;;;;;;;;;;;;;5,0;;;;;;;;;;;;;;;;;;;;;;;;;;;;;;;;;;;;;2,0;;3,0;;;;;;;;;2,0;6,0;;;;;;;;;4,0;;;;;;;;;;;;;;;5,0;;;;;;;;;;2,0;;;;;;1,0;;;;;;;;;13,0;;;;;;;;;;;;;;;;;;;;;;;4,0;;;;;;;3,0;;;;;;;;;;;;;;;;;2,0;;;;;;;;1,0;;;;;;3,0;;;;;;;;;;;;;;;;;;;;;;;;;;;;;;;;;;;;;;;;;;;;;;;;;;;;;2,0;;;;;;;;;11,0;;;;;;;;;;1,0;;;;;;;;;;;;;;;;;;;;;;;;;;;;;;;;;;;;;;;;;;;;;;;;;2,0;;;;;;;;;;;;;;;;;;;;;;;;;;;;;;;;;;;2,0;;;;;;;;;;;;;;;;;;;;;;;;;;;;;;;;;3,0;;;;;;;;;;;;;;;;;;;;;;;;;;;;;;;;;;;;;;;;
process;;;7,0;5,0;46,0;;6,0;93,0;16,0;76,0;3,0;9,0;;5,0;47,0;6,0;9,0;4,0;36,0;25,0;12,0;189,0;106,0;19,0;54,0;9,0;6,0;376,0;6,0;60,0;40,0;90,0;91,0;13,0;68,0;9,0;1,0;8,0;;103,0;10,0;3,0;5,0;18,0;4,0;3,0;1,0;4,0;148,0;24,0;1,0;103,0;;22,0;2,0;1151,0;96,0;20,0;4,0;41,0;;;143,0;;5,0;5,0;20,0;8,0;4,0;54,0;25,0;16,0;4,0;;;;;17,0;141,0;1,0;1,0;293,0;138,0;58,0;1,0;;22,0;;20,0;35,0;48,0;7,0;17,0;383,0;3,0;7,0;;30,0;74,0;18,0;9,0;129,0;;17,0;8,0;5,0;4,0;173,0;1,0;;33,0;9,0;21,0;27,0;3,0;;;3,0;5,0;24,0;6,0;1,0;10,0;52,0;1,0;;120,0;;6,0;7,0;2,0;12,0;1,0;;2,0;43,0;4,0;;2,0;3,0;1,0;4,0;5,0;41,0;52,0;3,0;29,0;73,0;23,0;1,0;2,0;;;11,0;;3,0;2,0;9,0;2,0;58,0;1,0;;;1,0;;3,0;20,0;15,0;2,0;5,0;11,0;4,0;67,0;24,0;12,0;2,0;;61,0;6,0;;;1,0;4,0;1,0;;3,0;14,0;77,0;1,0;53,0;;;6,0;56,0;;;;;;1,0;2,0;3,0;;3,0;;2,0;7,0;;7,0;1,0;8,0;2,0;1,0;1,0;9,0;36,0;27,0;;;1,0;2,0;5,0;2,0;2,0;;13,0;6,0;;2,0;;;;1,0;3,0;14,0;24,0;;29,0;50,0;12,0;;2,0;45,0;;;6,0;5,0;7,0;;1,0;;24,0;;14,0;4,0;2,0;;12,0;1,0;;3,0;13,0;9,0;;;;3,0;1,0;1,0;;;1,0;2,0;;;11,0;6,0;;1,0;5,0;4,0;;1,0;2,0;5,0;69,0;;73,0;4,0;1,0;1,0;1,0;;8,0;1,0;;1,0;28,0;;1,0;5,0;2,0;46,0;2,0;2,0;;;33,0;;;24,0;7,0;;;1,0;;;;;3,0;;9,0;;1,0;;7,0;;;2,0;2,0;18,0;3,0;;;;4,0;;;12,0;;;5,0;8,0;2,0;26,0;10,0;6,0;39,0;8,0;26,0;9,0;2,0;36,0;2,0;5,0;;12,0;1,0;;3,0;8,0;1,0;;1,0;39,0;16,0;;2,0;2,0;6,0;6,0;;4,0;12,0;24,0;27,0;32,0;4,0;;19,0;7,0;15,0;3,0;25,0;;2,0;9,0;10,0;2,0;20,0;2,0;7,0;;;12,0;43,0;30,0;14,0;9,0;1,0;15,0;;3,0;2,0;5,0;1,0;10,0;13,0;26,0;8,0;4,0;1,0;;13,0;;34,0;5,0;;43,0;2,0;25,0;5,0;4,0;10,0;29,0;3,0;2,0;19,0;12,0;17,0;1,0;22,0;;5,0;;;5,0;6,0;25,0;14,0;10,0;3,0;;6,0;5,0;16,0;62,0;18,0;81,0;5,0;;120,0;18,0;3,0;;6,0;3,0;5,0;24,0;;3,0;1,0;1,0;1,0;;12,0;6,0;;39,0;;;304,0;;1,0;1,0;2,0;19,0;3,0;15,0;9,0;6,0;1,0;14,0;5,0;;6,0;8,0;7,0;1,0;8,0;4,0;36,0;11,0;1,0;105,0;40,0;;8,0;5,0;11,0;;6,0;6,0;7,0;2,0;;;;;1,0;1,0;1,0;6,0;86,0;19,0;2,0;2,0;2,0;;;2,0;;12,0;6,0;;3,0;8,0;;4,0;;3,0;37,0;2,0;2,0;7,0;4,0;2,0;3,0;2,0;1,0;;2,0;5,0;;;;;1,0;;2,0;22,0;3,0;1,0;24,0;16,0;;15,0;7,0;;35,0;90,0;;2,0;4,0;;2,0;5,0;6,0;;3,0;;8,0;12,0;;;;2,0;3,0;7,0;6,0;1,0;36,0;25,0;7,0;;5,0;2,0;;1,0;1,0;9,0;3,0;;1,0;;5,0;1,0;;1,0;;6,0;1,0;15,0;;4,0;3,0;1,0;3,0;;2,0;;2,0;;;;;2,0;;2,0;1,0;;;;9,0;;;;;;;;2,0;;7,0;1,0;;;1,0;;;;16,0;;3,0;;9,0;14,0;2,0;4,0;;3,0;1,0;1,0;;;;;;1,0;;1,0;;1,0;;;9,0;;1,0;;;2,0;;1,0;;5,0;12,0;11,0;30,0;;;;;3,0;4,0;45,0;1,0;;3,0;;;;9,0;3,0;4,0;3,0;;;9,0;11,0;;5,0;2,0;;1,0;18,0;1,0;;;;;1,0;4,0;12,0;;1,0;4,0;;1,0;2,0;;3,0;;;5,0;1,0;1,0;5,0;1,0;;;7,0;1,0;6,0;;2,0;1,0;15,0;4,0;3,0;;;1,0;3,0;3,0;3,0;9,0;6,0;17,0;4,0;;;;6,0;2,0;;1,0;9,0;3,0;2,0;6,0;3,0;8,0;9,0;6,0;11,0;6,0;24,0;2,0;1,0;;11,0;;;;1,0;28,0;24,0;;;2,0;8,0;3,0;;3,0;3,0;;77,0;;;;;;1,0;8,0;;3,0;5,0;;;;45,0;;1,0;;8,0;3,0;;;10,0;1,0;2,0;3,0;3,0;6,0;;5,0;1,0;2,0;;;;;15,0;;1,0;;1,0;;2,0;;;2,0;11,0;;;;;;4,0;1,0;;;;;4,0;1,0;;;7,0;;;;5,0;6,0;3,0;;5,0;;;;25,0;2,0;5,0;;;;4,0;;5,0;;10,0;;4,0;;;3,0;3,0;;3,0;;;;3,0;;;2,0;;;;;;1,0;;;;;11,0;;;;3,0;;;;;;;1,0;;6,0;;2,0;;1,0;2,0;5,0;;4,0;;;2,0;17,0;;1,0;1,0;;1,0;;26,0;;;9,0;;4,0;;2,0;3,0;;;;;2,0;;2,0;1,0;2,0;3,0;4,0;;;;;1,0;1,0;;;;;;;;;;;4,0;;1,0;2,0;;2,0;13,0;1,0;;;;;3,0;;;;;5,0;;1,0;;;;;;;11,0;;6,0;;;;;;;
product;;;9,0;;8,0;;;11,0;5,0;4,0;3,0;4,0;;;8,0;2,0;;;2,0;303,0;;16,0;3,0;1,0;5,0;;;17,0;;4,0;2,0;17,0;43,0;6,0;22,0;;1,0;3,0;;8,0;4,0;1,0;;;;1,0;;2,0;1,0;4,0;21,0;8,0;;3,0;1,0;70,0;67,0;;5,0;;;1,0;31,0;;1,0;;4,0;;1,0;12,0;6,0;1,0;;;;1,0;;7,0;18,0;;;13,0;6,0;;;;5,0;;;4,0;5,0;;;6,0;1,0;2,0;;2,0;13,0;;5,0;16,0;;;24,0;;4,0;5,0;2,0;;1,0;6,0;;8,0;;1,0;;5,0;3,0;1,0;;;;1,0;;;28,0;1,0;9,0;1,0;2,0;;;;3,0;;6,0;;;3,0;;;6,0;2,0;1,0;;19,0;4,0;;;7,0;;;;;;;8,0;1,0;4,0;;4,0;6,0;;1,0;;16,0;9,0;;;;;9,0;;12,0;1,0;;;2,0;;3,0;;;;1,0;;;3,0;;31,0;;;16,0;2,0;2,0;;;;4,0;;1,0;6,0;1,0;1,0;;1,0;;;1,0;8,0;;;5,0;;1,0;4,0;;;;;2,0;1,0;;;;2,0;8,0;;;;;;;;;6,0;;1,0;5,0;;;1,0;1,0;;1,0;;;;;;;;;3,0;;;;3,0;;;5,0;;;;;;2,0;;;;;;2,0;;;4,0;3,0;;;1,0;;;;;;1,0;3,0;11,0;;;;;;3,0;;1,0;;1,0;2,0;;;;5,0;10,0;;;;3,0;;;1,0;12,0;;;;;;;;;;1,0;;;;9,0;;1,0;1,0;1,0;4,0;;;2,0;;;;1,0;1,0;;;18,0;;2,0;1,0;;1,0;4,0;3,0;;;2,0;1,0;;;;3,0;;;;2,0;1,0;;2,0;2,0;;;;3,0;;;;;4,0;24,0;4,0;;;;;2,0;;;261,0;;1,0;3,0;5,0;19,0;13,0;6,0;;;;2,0;2,0;;17,0;7,0;;10,0;;;;29,0;;;;2,0;;;1,0;1,0;;1,0;2,0;6,0;;1,0;;2,0;;;1,0;2,0;1,0;4,0;7,0;3,0;;2,0;1,0;;;;;;;;1,0;1,0;;2,0;;;;;;;2,0;2,0;7,0;;;;;3,0;1,0;38,0;;;;;;;2,0;1,0;;2,0;1,0;;1,0;;;;;1,0;3,0;;2,0;;;1,0;;;;3,0;3,0;;4,0;;;7,0;;3,0;4,0;1,0;;;;1,0;;;1,0;1,0;;;;;;;;;71,0;1,0;4,0;1,0;;;;;;2,0;1,0;2,0;2,0;1,0;;;;;;;;2,0;1,0;;;;4,0;;;;;;;15,0;4,0;;;;;;;6,0;;;;;2,0;5,0;;;;;;1,0;;;;;;;1,0;;;;4,0;;;;2,0;3,0;;;1,0;;;1,0;;;;;;;;4,0;;;;;;1,0;;;;;;1,0;;;4,0;;;;;3,0;;;;;;;;;;1,0;;;;;;;;;;;;;;1,0;1,0;;;;;1,0;1,0;2,0;;1,0;;;2,0;;;;;;;1,0;;1,0;;;1,0;1,0;12,0;;;;;;;;;;12,0;;;;;5,0;9,0;15,0;1,0;;;;;;1,0;;;5,0;;;;;;;;;;;;;1,0;;3,0;;;1,0;8,0;;;;;;;;2,0;;;;;2,0;;;;;;2,0;;;;;1,0;1,0;;10,0;;;;;;;;;;;;1,0;;3,0;;15,0;3,0;;3,0;;7,0;;13,0;;;;;;;;;;;15,0;1,0;;4,0;;2,0;1,0;;;3,0;;;;2,0;;;;;;;;;;;;;;1,0;;1,0;;1,0;;2,0;;;;;;5,0;;;4,0;;;;;;;;;;;;;;;2,0;;;;;;;;;;;;;;;;;;;;;1,0;1,0;;;1,0;;;;;;;;;;;;;;;;;;;;2,0;;;;;;;5,0;;;;;;;;;;;;;;;;;3,0;;;;;;;;1,0;2,0;;;;1,0;;;;;;;;3,0;;3,0;;;;2,0;;2,0;;;;;;19,0;;;;;;;1,0;;;;;;;;;;;;;1,0;;;;;;;;;;;1,0;;;;;;;;;;;;;;;;;2,0;;;;;;;;;3,0;;;;;;;
program;;;6,0;1,0;78,0;;3,0;21,0;7,0;16,0;1,0;4,0;;4,0;10,0;;;1,0;4,0;672,0;7,0;151,0;5,0;11,0;10,0;;;59,0;;15,0;3,0;62,0;320,0;4,0;33,0;2,0;12,0;8,0;1,0;51,0;8,0;4,0;;7,0;1,0;4,0;;;6,0;;52,0;27,0;1,0;3,0;;375,0;112,0;;;10,0;1,0;;139,0;;4,0;2,0;10,0;;1,0;13,0;13,0;8,0;5,0;;;1,0;;3,0;17,0;1,0;;154,0;169,0;7,0;8,0;;5,0;;4,0;53,0;21,0;;21,0;27,0;9,0;5,0;1,0;115,0;254,0;1,0;17,0;81,0;;4,0;53,0;1,0;;98,0;;;19,0;20,0;1,0;4,0;4,0;;;;1,0;5,0;;;4,0;4,0;;4,0;76,0;;1,0;3,0;1,0;6,0;1,0;1,0;;7,0;;;;3,0;;;1,0;4,0;5,0;;22,0;18,0;;;1,0;;;;3,0;7,0;;1,0;6,0;33,0;1,0;1,0;;;1,0;;12,0;12,0;7,0;;1,0;;60,0;;8,0;4,0;;5,0;1,0;;;;;2,0;1,0;;;77,0;;40,0;;;;63,0;;;;;1,0;;;2,0;;;;9,0;1,0;;3,0;;;65,0;5,0;;2,0;17,0;9,0;;1,0;;;4,0;;;;;1,0;;;;;;5,0;1,0;9,0;1,0;;9,0;13,0;2,0;;;1,0;;;;3,0;;;;;2,0;;14,0;;3,0;;12,0;;;4,0;1,0;1,0;;;;;;;;1,0;;;4,0;1,0;24,0;1,0;;1,0;2,0;2,0;;;4,0;;10,0;2,0;38,0;13,0;;;;;6,0;;1,0;;9,0;1,0;;8,0;;16,0;2,0;2,0;;;8,0;;;9,0;4,0;;;;;;;;;;4,0;;1,0;;9,0;;;1,0;;29,0;3,0;;3,0;;1,0;2,0;10,0;2,0;;;29,0;1,0;3,0;2,0;3,0;6,0;7,0;;7,0;;14,0;7,0;1,0;4,0;;1,0;;;4,0;1,0;1,0;2,0;1,0;21,0;12,0;1,0;1,0;;2,0;;;;5,0;260,0;86,0;3,0;4,0;;1,0;2,0;3,0;261,0;;;2,0;;;60,0;73,0;;10,0;;1,0;;1,0;4,0;7,0;7,0;1,0;37,0;1,0;;;;2,0;5,0;7,0;;15,0;1,0;7,0;1,0;7,0;1,0;10,0;14,0;;21,0;2,0;10,0;19,0;;7,0;23,0;11,0;7,0;26,0;;3,0;10,0;2,0;;;3,0;1,0;;;5,0;;1,0;1,0;3,0;2,0;3,0;25,0;1,0;3,0;4,0;2,0;5,0;221,0;6,0;1,0;;5,0;1,0;10,0;136,0;3,0;;;1,0;2,0;1,0;13,0;;;19,0;1,0;;97,0;1,0;1,0;1,0;2,0;1,0;;6,0;5,0;;3,0;1,0;1,0;;;4,0;10,0;5,0;15,0;6,0;;2,0;;53,0;11,0;;;1,0;28,0;1,0;3,0;;2,0;24,0;1,0;;;;;;1,0;3,0;303,0;18,0;1,0;;3,0;1,0;18,0;;;5,0;1,0;3,0;1,0;19,0;;;1,0;;1,0;;3,0;47,0;1,0;;1,0;2,0;;;12,0;1,0;;;;4,0;12,0;7,0;3,0;4,0;6,0;;;21,0;;2,0;;;4,0;17,0;;1,0;;;1,0;3,0;3,0;;;1,0;5,0;10,0;2,0;;;;45,0;;2,0;;13,0;13,0;;1,0;9,0;;;2,0;15,0;;;;;;;;;;;5,0;;17,0;;;1,0;;;;;;;;;;;;1,0;;2,0;;;;2,0;;;;;1,0;;;;;3,0;;;;;;;1,0;2,0;;;;11,0;4,0;;;;7,0;;1,0;;;;;;;;2,0;;;;;;1,0;;;;;;4,0;;;;7,0;;;;;;8,0;1,0;5,0;;;;;;;;;;1,0;;;;1,0;;2,0;;;;1,0;;;1,0;5,0;25,0;;1,0;6,0;1,0;;1,0;;5,0;3,0;;;3,0;;;;;5,0;1,0;;;2,0;;5,0;;;2,0;;;16,0;;;2,0;;2,0;;4,0;;2,0;6,0;;;;;3,0;9,0;4,0;4,0;1,0;;1,0;;;7,0;15,0;;;;2,0;;1,0;4,0;1,0;2,0;11,0;1,0;8,0;1,0;;2,0;3,0;4,0;;;3,0;;5,0;4,0;;;;;2,0;1,0;9,0;4,0;;37,0;1,0;;;26,0;1,0;;4,0;;1,0;;;21,0;;1,0;;;4,0;;3,0;3,0;1,0;;2,0;;3,0;;20,0;1,0;;;;;2,0;1,0;2,0;2,0;;;;1,0;;;;;;1,0;1,0;3,0;;;;;;2,0;;1,0;;;1,0;5,0;;;;1,0;;;;;;;;;;;;1,0;;;9,0;7,0;;;;;;;;;;;;;2,0;;;;;;;;;;;25,0;;;;;;;;2,0;4,0;1,0;;;1,0;;;;;;;;;;;;5,0;;1,0;;;;3,0;;;;94,0;;;;1,0;;;2,0;;;;5,0;;;;;;;;;2,0;;;;;;;;;;;;1,0;;;;;;;;;;;;;1,0;3,0;;2,0;;;;;;1,0;;;8,0;;1,0;;;;;
project;;;5,0;;19,0;;11,0;55,0;13,0;25,0;19,0;;7,0;;4,0;2,0;;;37,0;3,0;;21,0;20,0;7,0;1,0;;8,0;39,0;2,0;14,0;6,0;5,0;77,0;1,0;9,0;7,0;13,0;48,0;4,0;30,0;21,0;10,0;3,0;16,0;;;6,0;4,0;5,0;3,0;13,0;27,0;;8,0;;433,0;46,0;;2,0;75,0;1,0;;36,0;;2,0;3,0;1,0;4,0;1,0;8,0;101,0;1,0;12,0;6,0;14,0;4,0;;72,0;82,0;1,0;;7,0;2,0;2,0;;;23,0;1,0;3,0;4,0;31,0;;2,0;14,0;1,0;11,0;11,0;1,0;2,0;29,0;98,0;73,0;;;;;;50,0;;;10,0;13,0;9,0;5,0;2,0;;1,0;;2,0;41,0;;1,0;;3,0;;1,0;47,0;10,0;5,0;2,0;9,0;1,0;;8,0;1,0;;13,0;;1,0;5,0;1,0;;;7,0;6,0;;53,0;18,0;;;;10,0;9,0;2,0;8,0;6,0;10,0;25,0;23,0;13,0;;1,0;7,0;3,0;;;;136,0;;;44,0;19,0;15,0;15,0;3,0;16,0;27,0;8,0;2,0;1,0;2,0;4,0;4,0;1,0;3,0;30,0;16,0;31,0;;197,0;;;5,0;15,0;2,0;5,0;;2,0;1,0;3,0;;9,0;2,0;47,0;;;4,0;5,0;2,0;12,0;3,0;5,0;;;2,0;5,0;3,0;22,0;;2,0;6,0;1,0;;20,0;15,0;;28,0;;1,0;6,0;4,0;;3,0;11,0;5,0;9,0;7,0;3,0;19,0;;27,0;;;8,0;8,0;1,0;2,0;;3,0;18,0;;;2,0;5,0;;9,0;3,0;18,0;;5,0;;8,0;4,0;5,0;11,0;8,0;11,0;;3,0;3,0;13,0;27,0;;;6,0;;2,0;2,0;;6,0;2,0;5,0;1,0;4,0;;4,0;5,0;53,0;15,0;11,0;1,0;5,0;17,0;58,0;;4,0;;1,0;;;1,0;2,0;24,0;;130,0;1,0;2,0;;8,0;3,0;11,0;5,0;17,0;2,0;7,0;;4,0;;6,0;6,0;4,0;6,0;3,0;8,0;;18,0;2,0;2,0;;;1,0;;;;;;;;2,0;;;;;;1,0;;1,0;;;2,0;3,0;;2,0;4,0;;;5,0;1,0;;3,0;1,0;;4,0;;18,0;2,0;;;;6,0;;1,0;;;3,0;2,0;3,0;;;3,0;1,0;3,0;10,0;2,0;;;;6,0;;1,0;;3,0;2,0;;4,0;;;29,0;;;3,0;;11,0;2,0;14,0;;23,0;;;;2,0;1,0;;2,0;;1,0;5,0;;4,0;13,0;5,0;;;;12,0;;1,0;;;11,0;25,0;;;;;;;3,0;1,0;;3,0;;;2,0;1,0;1,0;;6,0;;;1,0;1,0;14,0;38,0;1,0;;1,0;;3,0;;;;;2,0;;3,0;13,0;;2,0;;;3,0;;1,0;;;;;;;;;;;;1,0;31,0;1,0;;;1,0;;;1,0;5,0;33,0;5,0;;;;;;2,0;;18,0;2,0;;4,0;;2,0;2,0;;;4,0;2,0;14,0;7,0;;;;;4,0;;;;6,0;;;;;;2,0;;2,0;;;;;;;;;;;;;1,0;;;;;;1,0;1,0;;1,0;4,0;;;2,0;21,0;;;;;;2,0;;;;;;;;11,0;;4,0;4,0;;5,0;;;16,0;;;12,0;;;;;;1,0;;4,0;;1,0;;;;8,0;;;;;;;;;2,0;;;3,0;;5,0;;;2,0;;;;;;;13,0;;;3,0;;4,0;;;9,0;2,0;4,0;7,0;;29,0;;;4,0;;;;5,0;;;;;;1,0;;2,0;;;;;2,0;12,0;;6,0;2,0;;;6,0;1,0;;;;2,0;6,0;;;3,0;;;;;2,0;;;;;;;20,0;;;;;;;1,0;;;;;;2,0;1,0;;2,0;1,0;;1,0;4,0;;;;;2,0;;2,0;;;;;;1,0;;;;;2,0;2,0;8,0;;;1,0;;;2,0;;;3,0;;;6,0;2,0;;;1,0;1,0;;1,0;1,0;;2,0;;;;;;;3,0;;1,0;8,0;1,0;2,0;4,0;1,0;;;;;;1,0;;;;;1,0;12,0;10,0;11,0;9,0;;2,0;1,0;;;;;;;61,0;2,0;1,0;;;;9,0;;;3,0;;;;1,0;;;;;;4,0;;;;4,0;;;3,0;;4,0;;;;;;;1,0;;4,0;;;8,0;;;6,0;2,0;9,0;1,0;;;;1,0;;;;1,0;;1,0;3,0;;;5,0;;;;;2,0;;;;;;;;2,0;2,0;1,0;1,0;2,0;;18,0;;1,0;;;3,0;;;;;;;;;;;2,0;4,0;;1,0;1,0;;;;;3,0;;;;;;;;;;;;;;;;;;;;;5,0;;;;2,0;;;;;1,0;;2,0;;1,0;;5,0;;;4,0;;;;;;2,0;;;1,0;;;;;;26,0;;;;;;;;;;4,0;;;;;;3,0;;;;;;;1,0;;2,0;4,0;;;1,0;;;;;1,0;2,0;;;1,0;;;;;;;;;;;2,0;;;;;;;
projection;;;2,0;1,0;46,0;;12,0;22,0;13,0;32,0;5,0;4,0;3,0;1,0;10,0;;2,0;;14,0;;;45,0;3,0;1,0;7,0;;;26,0;4,0;2,0;13,0;4,0;143,0;;10,0;1,0;1,0;93,0;;62,0;13,0;4,0;7,0;6,0;;;8,0;1,0;5,0;;3,0;6,0;;;2,0;261,0;50,0;;1,0;84,0;13,0;;63,0;;5,0;4,0;15,0;3,0;;41,0;78,0;;16,0;4,0;2,0;31,0;;23,0;93,0;3,0;2,0;4,0;2,0;1,0;;;4,0;4,0;1,0;35,0;10,0;25,0;;16,0;4,0;3,0;;8,0;3,0;16,0;99,0;70,0;1,0;;;;3,0;96,0;;;3,0;20,0;2,0;11,0;7,0;;;;;20,0;2,0;;;1,0;;1,0;26,0;15,0;;17,0;3,0;1,0;;27,0;;5,0;8,0;;;4,0;;;7,0;10,0;2,0;9,0;64,0;9,0;2,0;;;17,0;25,0;6,0;13,0;5,0;18,0;25,0;;15,0;;1,0;7,0;6,0;1,0;;;78,0;;5,0;79,0;3,0;9,0;56,0;14,0;12,0;10,0;8,0;;;14,0;;5,0;;4,0;27,0;16,0;41,0;;100,0;2,0;2,0;3,0;13,0;9,0;2,0;;3,0;5,0;;2,0;25,0;1,0;42,0;;;7,0;7,0;4,0;24,0;3,0;3,0;;3,0;1,0;5,0;1,0;23,0;;;2,0;1,0;;1,0;12,0;;6,0;;;9,0;1,0;;7,0;;4,0;13,0;;3,0;49,0;;29,0;5,0;3,0;3,0;11,0;2,0;;;27,0;;;;3,0;5,0;;;7,0;17,0;;;;2,0;8,0;1,0;37,0;29,0;28,0;;1,0;3,0;14,0;23,0;;;4,0;1,0;;6,0;4,0;23,0;17,0;;;16,0;;1,0;3,0;7,0;9,0;3,0;14,0;3,0;9,0;8,0;;3,0;;;3,0;;2,0;;32,0;130,0;;6,0;;5,0;14,0;36,0;9,0;4,0;;5,0;4,0;;3,0;5,0;;;1,0;;6,0;4,0;;48,0;;17,0;2,0;;4,0;;;;;;;1,0;;;3,0;;;;;;;1,0;;1,0;;1,0;2,0;;;;;;;1,0;;;;;7,0;5,0;;;2,0;;;2,0;2,0;10,0;10,0;2,0;;;;32,0;1,0;;;2,0;;;2,0;1,0;;11,0;2,0;1,0;5,0;1,0;4,0;;;8,0;;1,0;1,0;;1,0;;8,0;;4,0;7,0;;;11,0;;1,0;;;;;;11,0;7,0;23,0;;3,0;2,0;65,0;;;;2,0;5,0;5,0;1,0;;;;1,0;;;;;;;;;;7,0;;2,0;;;;1,0;10,0;2,0;;1,0;17,0;;6,0;;;;;;;;11,0;1,0;8,0;;;8,0;;;;;;;4,0;;;2,0;;;;27,0;76,0;;;;;4,0;;2,0;17,0;22,0;;;1,0;;;;3,0;1,0;5,0;;;1,0;;1,0;3,0;;;8,0;1,0;;;;;;1,0;6,0;9,0;3,0;;;30,0;;;;;;2,0;;3,0;;;;;;;;;;6,0;;;;;;;;;1,0;;;6,0;;;2,0;8,0;;;;;;2,0;1,0;;;1,0;2,0;;;6,0;;;4,0;;;;2,0;4,0;1,0;3,0;3,0;;;;;;1,0;;2,0;;3,0;;;;3,0;;;;;;;;;1,0;;1,0;8,0;;1,0;;;7,0;;;;;;;;2,0;;;;14,0;;;;;20,0;8,0;;11,0;;;17,0;;;;;;;;;1,0;2,0;;4,0;;2,0;;4,0;;;;13,0;1,0;;;3,0;6,0;5,0;;;;8,0;;;;2,0;6,0;;;3,0;;;;;;;3,0;;;;;;;;;;;;;4,0;;;1,0;1,0;;1,0;4,0;;;;;2,0;;5,0;;;;;;;;;;;2,0;;;;;1,0;;;;;;;;;;;;;1,0;;;3,0;1,0;;;;;;;;2,0;1,0;;4,0;8,0;;8,0;21,0;;;4,0;;;2,0;;;1,0;;1,0;;6,0;6,0;3,0;1,0;;;1,0;;;1,0;;1,0;;38,0;;;;;;1,0;;;;;;;1,0;;;;;1,0;4,0;;2,0;;2,0;;;;1,0;1,0;;;;;;;;;4,0;;;3,0;;;;;6,0;4,0;;;;;;3,0;;2,0;;;3,0;;;;;;4,0;;1,0;;;;20,0;;;;2,0;3,0;;1,0;;;1,0;;;;;12,0;;;;;5,0;;2,0;;;;;;;;;;;;;;;;;;;;;;;;;2,0;;;;1,0;;1,0;1,0;;;7,0;;;;;;;;;;;;;;;;;;;;;;1,0;2,0;;;16,0;3,0;;;;;29,0;;;;;;;;;;;;2,0;;;;;;;;;;;;;;;;;;;;;;;;;;;;2,0;;;;;1,0;;;;;;;;;;;
pulse;;;21,0;;7,0;;;32,0;12,0;3,0;;9,0;;;22,0;;;1,0;;;;117,0;;;2,0;;;13,0;;51,0;9,0;13,0;77,0;2,0;16,0;;8,0;16,0;;;2,0;;50,0;25,0;;;;;;31,0;1,0;66,0;2,0;10,0;;24,0;39,0;;2,0;10,0;;;30,0;1,0;;19,0;2,0;;1,0;7,0;9,0;;1,0;;;;1,0;11,0;24,0;50,0;1,0;2,0;7,0;2,0;;1,0;46,0;;2,0;2,0;8,0;33,0;;178,0;;;;;15,0;8,0;4,0;47,0;;88,0;;23,0;;59,0;;;3,0;;;;;;;1,0;;;;;5,0;25,0;;;27,0;;;;1,0;;7,0;;;5,0;8,0;;22,0;16,0;;;2,0;;;1,0;7,0;7,0;;;1,0;;;2,0;;;;;2,0;85,0;1,0;9,0;;;;3,0;43,0;125,0;8,0;1,0;3,0;;2,0;;2,0;3,0;;48,0;;;;;;;;;;58,0;;2,0;;;;15,0;;14,0;;;1,0;;4,0;16,0;;;;;13,0;;1,0;;2,0;;1,0;;;111,0;6,0;;;;;;;;;;1,0;;;;;;;;67,0;3,0;;98,0;7,0;;;;;;;;1,0;;;;4,0;;;11,0;7,0;;;2,0;7,0;;3,0;152,0;8,0;;;;2,0;;;;;;;;;;;;;;1,0;;;1,0;;;2,0;3,0;4,0;1,0;;;4,0;7,0;;;;6,0;;;;;30,0;;;;;3,0;;;65,0;12,0;;;;;;;;;;2,0;;;;16,0;;;28,0;;;5,0;;24,0;;4,0;1,0;;1,0;;;1,0;2,0;4,0;;;2,0;;;26,0;13,0;;;5,0;1,0;2,0;;;;;1,0;;;5,0;;;;;2,0;;6,0;;;1,0;;3,0;10,0;;;;33,0;2,0;;;;2,0;;9,0;;16,0;1,0;7,0;;;3,0;;4,0;3,0;9,0;;;;1,0;1,0;;;;;;1,0;;;;;;17,0;;;14,0;17,0;;;;;3,0;;1,0;35,0;;6,0;2,0;1,0;;;;;18,0;;;12,0;;;;1,0;;10,0;2,0;3,0;;1,0;;1,0;;26,0;;;;;11,0;;3,0;;;4,0;7,0;;;;;;;6,0;;;;;;7,0;;;14,0;;;4,0;;;1,0;1,0;;15,0;;9,0;34,0;12,0;10,0;1,0;;67,0;;;;2,0;;;;;2,0;;;;;;;;2,0;;;;;;;;2,0;;;13,0;;;;;;;;;;;;;;;;9,0;2,0;;;;;;;;;;;;;;3,0;;;;38,0;9,0;;;;;2,0;;;;;;;;;;;;;;;1,0;;1,0;11,0;;;;;3,0;;;;;;5,0;;;2,0;;;3,0;1,0;;;;;;;;;;;;;;5,0;;;;44,0;1,0;;;1,0;;;;4,0;;;14,0;;51,0;;;12,0;2,0;;;;;;;;;2,0;;;;;;;;;;;;;;;;;;;;;;;;2,0;;;;22,0;;4,0;;;;2,0;4,0;4,0;4,0;2,0;3,0;;;18,0;3,0;;10,0;;;;;31,0;62,0;2,0;3,0;30,0;7,0;;1,0;;;1,0;1,0;4,0;;;;;;;;9,0;1,0;;;6,0;;7,0;;2,0;12,0;;1,0;1,0;1,0;;37,0;1,0;1,0;;;;;;;10,0;;2,0;244,0;;;1,0;153,0;;;;;;3,0;;;;;102,0;;;2,0;;2,0;5,0;;;1,0;;1,0;;6,0;2,0;;;1,0;10,0;15,0;;;;;;;;;1,0;;;1,0;62,0;;;;;;;;;;;;;;;;;;;;;;;;;;6,0;;4,0;1,0;1,0;4,0;;;3,0;;;;7,0;;;4,0;2,0;;;;;;;1,0;2,0;;;;;5,0;1,0;;;;;;;1,0;;;;11,0;1,0;;;18,0;;;;;;;7,0;;;;;;;;2,0;17,0;;;;;1,0;;;;;;;;;1,0;;4,0;;;;;;;;;;;;;;;;;;;;;;;;;;;4,0;;;;;1,0;;1,0;;;6,0;;;;1,0;;;;;;;;;;;;;1,0;;;;;;;;;;;;;;;;;;;;;;77,0;;;;;;;;;;;;;;;1,0;;;;;;;;;;;;;;;
pupil;;;2,0;2,0;;;11,0;2,0;;;5,0;;;;;;;;2,0;;1,0;5,0;4,0;;1,0;;;6,0;2,0;;1,0;8,0;2,0;;3,0;;7,0;4,0;;7,0;14,0;;;3,0;;;;1,0;2,0;;2,0;;;;;38,0;1,0;;;58,0;;;1,0;;;;;7,0;;;26,0;2,0;1,0;;;;;;18,0;;;;;;;;;2,0;2,0;;;1,0;;;15,0;;;;;;5,0;26,0;;;;;;1,0;;;1,0;2,0;2,0;7,0;;;;;;;;;1,0;;;;1,0;;;;;1,0;;;;4,0;;;;;;;;2,0;;;13,0;;1,0;;;;;;;;;1,0;19,0;14,0;;10,0;;;;;;18,0;;;;10,0;3,0;;;;;;;;;;19,0;;;15,0;1,0;2,0;;2,0;;;;;;4,0;;;2,0;;;3,0;;5,0;;;;;;;;;;;;;;;;;;;;;;4,0;1,0;;;;;;;4,0;;1,0;;;20,0;;;;;;;;;;;;;;;;;;;;1,0;1,0;1,0;;2,0;;1,0;;;;;;;;;;3,0;;;;;6,0;;;;;;;;4,0;;3,0;;;1,0;;;;;;4,0;;;;1,0;;;;;8,0;;;;1,0;;;3,0;;2,0;;;;;;;;;;;;;1,0;1,0;1,0;;;;;;;;;;2,0;;2,0;;;1,0;;;2,0;;;1,0;;;;;;;;;;13,0;;11,0;;;6,0;1,0;;;;;6,0;;;;;;;;3,0;;;;;;;;;;1,0;;;;;;1,0;;;3,0;;;;;;;9,0;;;;1,0;;;;;14,0;;;3,0;2,0;;;;;;;;;;;;;;;2,0;;;;;;;;;;;;;;1,0;;;1,0;;;;8,0;;;;;;;;;;;;;;;2,0;;;;;;;;;;;;;;;4,0;1,0;;15,0;;;;;;1,0;;;;;;;;;5,0;;;;;;;;;;;;;;;;;;;;;;;;;1,0;;;;;;;;2,0;;;;;;;;;;;;;;;;;;;;;;2,0;7,0;;;;;;2,0;;;;;;;;;;;;;;;;6,0;;;;;;;;;;;;;;;;;;;;;1,0;;;;2,0;;;;;;;;;;;;1,0;;;;2,0;;;;;;;;;;;4,0;1,0;7,0;;;;;;1,0;;;;;;3,0;;2,0;;;;;;;;;;;;;2,0;;;;;;;;;;;;;;;;;;;;;4,0;;;1,0;;;;;;;;;;;;;;;;;;;;;;;;;;;;;;;;;;1,0;;;;;;;;;;;;;;;;;;;2,0;7,0;;;;;1,0;;1,0;;;;;3,0;;;;;;;;;;2,0;;;;;;;;;;12,0;;;;;;;;;;8,0;;;;;;;;;;;;;;;;;;;;;;;;;;;;;;;;;;;;;;;1,0;;;2,0;;;;;;;2,0;;;;;;;;;;2,0;;;;;;;;;;;;;;;;;1,0;;;;;;;;;;;;;;;;;;;;2,0;;;;;;;;;;;;;;;;;;;;1,0;;;;;;;;;2,0;;;;;;;1,0;;;;1,0;2,0;;;;;;1,0;;;;;;;;;;;1,0;;11,0;;;;;;;;2,0;;1,0;;;;;;;;;;;;;;;;;;;;;;;1,0;;;;;;3,0;;;;;;;;;;;;;;;;;;;;;
quality;;;3,0;2,0;53,0;;4,0;16,0;2,0;20,0;1,0;4,0;;;5,0;19,0;;;4,0;3,0;3,0;62,0;;1,0;3,0;;;66,0;1,0;9,0;1,0;14,0;14,0;;12,0;1,0;;8,0;;74,0;;;;6,0;;1,0;;;5,0;5,0;27,0;2,0;;1,0;;423,0;23,0;;;4,0;1,0;;54,0;;;;2,0;;;31,0;4,0;4,0;;;;;;6,0;;1,0;;20,0;;1,0;;;1,0;;1,0;11,0;2,0;;4,0;8,0;10,0;1,0;;7,0;12,0;;2,0;31,0;;;;1,0;;26,0;;;1,0;;1,0;1,0;;17,0;;;;1,0;;;;7,0;;;7,0;;2,0;;;11,0;;;;5,0;;;;1,0;;;1,0;3,0;5,0;;2,0;5,0;1,0;1,0;;;;;;;;;;2,0;;4,0;;;;5,0;27,0;4,0;;1,0;1,0;;16,0;;;;;9,0;;;;;2,0;2,0;;3,0;;13,0;1,0;5,0;1,0;;;4,0;;2,0;;;;;;;;1,0;;2,0;;;;3,0;7,0;;;1,0;;14,0;;;;;1,0;;8,0;;;;;;;;;;2,0;;15,0;;;4,0;13,0;;;;;;;7,0;;;;;;1,0;;;;;;3,0;7,0;;1,0;;;;;;;;;;;1,0;;;;;;;2,0;;;;;;;5,0;;4,0;4,0;;;;1,0;1,0;;;;8,0;;;1,0;;;1,0;;;;3,0;;;1,0;20,0;;;;;;;;;;;;;;6,0;;;;;9,0;;;;1,0;;3,0;;;;;5,0;;3,0;2,0;1,0;2,0;;;5,0;;;;;8,0;1,0;2,0;;;;5,0;3,0;;;2,0;6,0;3,0;3,0;1,0;1,0;;;;10,0;9,0;4,0;8,0;2,0;;;8,0;4,0;4,0;7,0;1,0;;1,0;1,0;3,0;32,0;;2,0;;;;1,0;;4,0;4,0;;1,0;;1,0;;;;3,0;5,0;;;;3,0;2,0;;;;;;5,0;;6,0;4,0;;1,0;22,0;;;2,0;1,0;6,0;;1,0;;3,0;;1,0;;5,0;4,0;1,0;;;;;;;;;;;;1,0;2,0;16,0;;;1,0;;4,0;;;2,0;;;6,0;2,0;;1,0;4,0;;;35,0;;;;;20,0;;;;;5,0;1,0;1,0;;;6,0;2,0;;30,0;63,0;;;;46,0;5,0;1,0;;;1,0;1,0;;2,0;1,0;5,0;;3,0;;;;;;;3,0;1,0;3,0;;8,0;;1,0;;;;6,0;;;;;3,0;;;;;;;2,0;;;1,0;;;;;;;;;;;;3,0;1,0;3,0;4,0;1,0;;;;;17,0;6,0;;;1,0;;;;;;;1,0;;;;;;;;;;;41,0;1,0;;;;;;1,0;1,0;1,0;;;2,0;;;;;;1,0;;;2,0;;;;;;;;;;;;;1,0;;;;1,0;;;;;;;;;;;;;;5,0;;;;2,0;9,0;;;;;;;1,0;3,0;;;;1,0;1,0;;;;;;;;;;;;;;;3,0;;;;;;;1,0;;;;;;;;;;;1,0;;;;;;;;;;8,0;;;;;;1,0;;;;;;1,0;;;2,0;;;;2,0;;;;;;;;;;;;;1,0;;;;;;6,0;;;1,0;;;;;1,0;;;;;1,0;;;4,0;;;;;;;1,0;;1,0;;;;;;;2,0;;2,0;;;;7,0;1,0;1,0;;;;3,0;15,0;3,0;;4,0;;;;;;;3,0;;;;;;;;;2,0;;;;;;;;;;;4,0;;1,0;;;;2,0;;;;;;;;1,0;1,0;;;;;;4,0;1,0;;12,0;1,0;;;;1,0;;;;;;6,0;;3,0;;;;;;;;;1,0;;;;;;;;6,0;;;;;;;4,0;;1,0;;2,0;;;;;;2,0;;;;;;;;;;;;;;;;;1,0;4,0;;;;30,0;;;;;;;1,0;1,0;;;;;;4,0;3,0;;;;;;8,0;;;;;;;3,0;;;;;;;;;;;;;;2,0;;;2,0;;;;;;;;;;;;;;;;;;;;;;;;;;;;;;;;;;;;;;;;;;;;;;;1,0;;;;;;;
quantity;;;1,0;;3,0;;7,0;55,0;52,0;5,0;;;;;3,0;2,0;1,0;;4,0;1,0;5,0;62,0;7,0;38,0;21,0;;;23,0;;58,0;21,0;41,0;12,0;7,0;27,0;;;55,0;42,0;11,0;1,0;;6,0;7,0;1,0;;1,0;4,0;10,0;;;3,0;;;;123,0;22,0;;;29,0;5,0;1,0;34,0;2,0;;;1,0;;;13,0;18,0;2,0;;;2,0;2,0;;4,0;2,0;;;3,0;8,0;1,0;;;;2,0;16,0;17,0;6,0;;2,0;36,0;1,0;;;4,0;3,0;;;14,0;;;2,0;;;44,0;;;2,0;;1,0;;;;;;;;;;4,0;7,0;;2,0;4,0;;;;;;9,0;;;5,0;;;;17,0;;;;;2,0;;;;2,0;;;;;;;;;;7,0;15,0;37,0;8,0;;;;;2,0;233,0;;7,0;33,0;1,0;2,0;;7,0;;;8,0;;;8,0;;14,0;12,0;;1,0;;16,0;;4,0;;;;3,0;;;;;8,0;;;;;;;3,0;;;;;;;;;;25,0;;;;;;;28,0;;;;1,0;;;;;;;;25,0;;;;19,0;;22,0;;2,0;;;6,0;;;;;1,0;2,0;;;;;;;;;;4,0;;;;;;;;;;;;;1,0;;;;8,0;;;;2,0;3,0;;49,0;7,0;11,0;1,0;;;;17,0;;;;3,0;10,0;;;;;34,0;;;;;32,0;;;1,0;4,0;;;;;;;;;;;;;;1,0;;;;;4,0;5,0;;5,0;;;;2,0;;5,0;;26,0;;9,0;35,0;;15,0;;;9,0;6,0;;17,0;;;;;;;;1,0;;;3,0;;6,0;;;;;1,0;;18,0;6,0;3,0;2,0;;;;3,0;;;1,0;2,0;2,0;;5,0;4,0;;;2,0;13,0;;;13,0;5,0;;14,0;18,0;16,0;;;1,0;;9,0;;;1,0;;;;1,0;;5,0;;4,0;6,0;;4,0;11,0;;;;1,0;4,0;;;1,0;;9,0;;;;;;;6,0;3,0;;;2,0;3,0;;;;8,0;;15,0;;;;;2,0;61,0;;;;;1,0;;3,0;;;3,0;;3,0;;;2,0;;;1,0;;;;;;;;;;2,0;;;;7,0;;4,0;;1,0;;;2,0;;2,0;1,0;;;;;;;;1,0;6,0;;;;;;;5,0;;;;;;;;1,0;;;3,0;;;12,0;;;;1,0;;;;;;1,0;;1,0;;;;2,0;1,0;;;;;;;;;;;;1,0;;2,0;;;1,0;21,0;;;;;;12,0;;;;;;;;;;;;;;;;37,0;1,0;;3,0;;;3,0;;;;;;;10,0;;;3,0;;;;52,0;;;;;;;;;;;;;;;;;;;;1,0;;;;;;;;;;;33,0;;;8,0;;;;;;;;;;;;;;4,0;;;;;;;;;;;;;;;;3,0;;;;5,0;;;;;;;;2,0;;1,0;;2,0;5,0;;4,0;;1,0;;;;11,0;4,0;;;;;;;3,0;;;;;;;1,0;;;2,0;;;;1,0;;;;;4,0;;1,0;;;;;2,0;;;;;;;6,0;;;;;3,0;;;1,0;;;;30,0;;;;4,0;2,0;;1,0;;;;3,0;;;2,0;;;2,0;;2,0;;;;;5,0;;2,0;;;;;;;1,0;;;;;;;;;;;;;;;;1,0;;;;;2,0;;;;;;;2,0;;;;;;;;;;;;;1,0;;;;;;3,0;;;;28,0;1,0;;;7,0;;;;;;;2,0;;;;;;24,0;;;;;;;;;;;;;4,0;;;;;;;;;;;;;;1,0;;;;;;;;;;;;;;;;;;;;;;;;;;;8,0;1,0;;;;;;;;;9,0;;;;;;;;;;;12,0;;;;;;;1,0;;;;;;;;;;;;;;;;;;;;1,0;;;;;;;;;;;;;;;;;;;;;;;;;;;;;;;;;;;;;;;;;;;;;;;;;;;;
radiation;;;1,0;;12,0;;6,0;23,0;;5,0;2,0;1,0;;;;;4,0;2,0;4,0;;;2,0;;;;;;9,0;3,0;68,0;32,0;13,0;15,0;6,0;12,0;3,0;52,0;14,0;;3,0;5,0;;;35,0;;;1,0;12,0;6,0;19,0;2,0;18,0;;1,0;;61,0;72,0;;;15,0;2,0;;39,0;;1,0;5,0;;;1,0;;55,0;8,0;23,0;;;;;6,0;22,0;11,0;;12,0;20,0;13,0;1,0;3,0;27,0;1,0;3,0;8,0;35,0;4,0;;56,0;;;1,0;;;7,0;28,0;54,0;;;;;1,0;16,0;;3,0;3,0;15,0;44,0;20,0;;;2,0;1,0;;;;;;6,0;8,0;17,0;37,0;;;6,0;;;1,0;;1,0;112,0;7,0;;;68,0;4,0;5,0;4,0;23,0;42,0;;8,0;;24,0;;5,0;;9,0;6,0;;;;13,0;29,0;15,0;41,0;;1,0;1,0;4,0;4,0;24,0;20,0;;5,0;;46,0;9,0;6,0;;;;9,0;;1,0;1,0;3,0;20,0;;;9,0;11,0;21,0;;16,0;1,0;;;114,0;;55,0;;;1,0;;;1,0;4,0;6,0;;1,0;;;4,0;;;2,0;22,0;;4,0;4,0;16,0;8,0;2,0;;;4,0;;29,0;;42,0;4,0;;;;;;;;;7,0;;;7,0;;;;3,0;;;;4,0;3,0;;;;;;4,0;;1,0;;13,0;;;1,0;1,0;1,0;;1,0;;;;;;;5,0;;1,0;;3,0;;;;2,0;;;;1,0;;1,0;;54,0;;4,0;12,0;;2,0;6,0;;3,0;;2,0;;;;;1,0;5,0;3,0;;2,0;49,0;5,0;2,0;;10,0;;;;;;;;;;29,0;;;;76,0;;;;;;1,0;1,0;;;;;;;;;6,0;;;;;;;2,0;15,0;1,0;;2,0;;;;1,0;;;;;;2,0;2,0;5,0;1,0;;;3,0;6,0;;;;10,0;;;2,0;1,0;;5,0;;4,0;16,0;;;;6,0;;;;;6,0;;;;;;11,0;2,0;;12,0;;1,0;;;;;;;;;11,0;;;;;;;;7,0;5,0;;;;1,0;;;;;16,0;;;;;;;;;;;;;;;;3,0;;18,0;;;;;27,0;1,0;;;4,0;;;;;;;;;2,0;;;;;;7,0;;;;;;;;;7,0;6,0;;7,0;;;5,0;1,0;;;;2,0;17,0;;2,0;16,0;;2,0;1,0;;;;;1,0;10,0;;;;5,0;1,0;2,0;;;4,0;1,0;4,0;;;;;;;2,0;;;6,0;;;;;;;;;;;;4,0;;;;;;;;;;1,0;;;;;;4,0;;;5,0;9,0;4,0;;4,0;;;;;;11,0;;;;;;;;;8,0;;1,0;;;;;9,0;;;;;;;;;;;2,0;4,0;;;6,0;;;2,0;20,0;4,0;;1,0;;;;;;;;;;;;2,0;;;1,0;;3,0;;;3,0;;1,0;;5,0;;;;;;4,0;;41,0;;;;;;;1,0;;;;;2,0;1,0;;2,0;;;;;;;;4,0;;;;;;;;;;;;;;;;;1,0;;;;;4,0;;2,0;5,0;;;;;;;;;;;;1,0;;16,0;4,0;;4,0;;5,0;1,0;;4,0;2,0;;6,0;;;1,0;6,0;;;;;;;1,0;1,0;;9,0;;1,0;;1,0;;;;;2,0;;;;;;;;15,0;;;;;;;54,0;;;1,0;;;;;4,0;;3,0;;2,0;;53,0;1,0;7,0;2,0;;;6,0;;;;;4,0;5,0;;5,0;;4,0;;;;;;;;;;;;;;11,0;;;;;;1,0;;;;;;;;;1,0;;;;;;;3,0;;;;;;;;;;;;;;;5,0;;;3,0;;;3,0;;;;10,0;;12,0;;;6,0;;2,0;;;;;;;1,0;7,0;;;;;;;;;;;4,0;;2,0;;;;;;;;;;2,0;1,0;;1,0;;;;;;;;;;;;;;;;6,0;;;;;;;;;;;;;2,0;;;5,0;;;;;;;;;3,0;;;;;;;28,0;13,0;;;;;;;;;;;3,0;;;;2,0;;;;;4,0;;;1,0;;;;;1,0;;;1,0;;;;;;;;;;;3,0;;;;;;;;;;;;;;;5,0;;;;;;;;;;;;;;4,0
range;;;44,0;5,0;63,0;;52,0;122,0;68,0;97,0;31,0;24,0;;10,0;130,0;1,0;1,0;28,0;56,0;10,0;15,0;130,0;25,0;11,0;23,0;1,0;5,0;227,0;62,0;55,0;40,0;296,0;186,0;31,0;62,0;7,0;15,0;62,0;3,0;83,0;152,0;8,0;95,0;24,0;40,0;9,0;1,0;47,0;248,0;110,0;7,0;64,0;2,0;22,0;17,0;489,0;172,0;2,0;57,0;299,0;2,0;15,0;196,0;15,0;3,0;6,0;56,0;15,0;4,0;96,0;85,0;10,0;11,0;1,0;;83,0;;61,0;165,0;26,0;5,0;27,0;28,0;11,0;3,0;1,0;48,0;2,0;17,0;50,0;115,0;10,0;92,0;139,0;77,0;4,0;;10,0;24,0;2,0;57,0;109,0;;6,0;2,0;;5,0;149,0;6,0;;7,0;8,0;53,0;14,0;4,0;5,0;11,0;8,0;;6,0;;;29,0;17,0;5,0;4,0;55,0;3,0;11,0;4,0;19,0;3,0;;14,0;4,0;30,0;7,0;;8,0;14,0;5,0;17,0;5,0;37,0;18,0;1,0;17,0;39,0;6,0;;10,0;10,0;7,0;1,0;3,0;2,0;1,0;6,0;26,0;113,0;10,0;20,0;1,0;4,0;;4,0;38,0;181,0;;2,0;57,0;6,0;34,0;11,0;77,0;22,0;3,0;85,0;3,0;;;32,0;5,0;4,0;3,0;16,0;10,0;107,0;;75,0;;1,0;49,0;25,0;5,0;2,0;8,0;;23,0;20,0;3,0;15,0;9,0;50,0;;15,0;3,0;8,0;3,0;14,0;14,0;1,0;2,0;;12,0;130,0;11,0;10,0;18,0;;3,0;35,0;;45,0;2,0;243,0;17,0;;;1,0;1,0;;5,0;4,0;93,0;84,0;;12,0;54,0;7,0;9,0;;5,0;7,0;;9,0;6,0;2,0;;11,0;4,0;23,0;;4,0;7,0;;4,0;52,0;6,0;7,0;28,0;54,0;8,0;2,0;3,0;;28,0;;2,0;1,0;;8,0;1,0;4,0;;22,0;5,0;1,0;77,0;10,0;;3,0;2,0;43,0;;54,0;41,0;92,0;22,0;;2,0;;28,0;5,0;;4,0;1,0;90,0;3,0;;;1,0;343,0;;5,0;6,0;3,0;;;;36,0;10,0;;1,0;;2,0;3,0;2,0;1,0;;;21,0;2,0;;;35,0;;;9,0;;13,0;12,0;;;;;9,0;15,0;1,0;20,0;;49,0;8,0;14,0;18,0;2,0;13,0;7,0;;118,0;27,0;;28,0;7,0;;4,0;2,0;3,0;4,0;1,0;13,0;7,0;;;10,0;35,0;2,0;2,0;6,0;14,0;29,0;2,0;43,0;44,0;4,0;9,0;9,0;13,0;;15,0;10,0;11,0;3,0;8,0;3,0;32,0;7,0;15,0;1,0;3,0;2,0;11,0;12,0;;12,0;19,0;10,0;43,0;38,0;5,0;15,0;;6,0;2,0;2,0;;45,0;39,0;;1,0;1,0;13,0;2,0;12,0;1,0;;1,0;1,0;50,0;14,0;12,0;2,0;;8,0;46,0;1,0;3,0;4,0;10,0;21,0;4,0;2,0;;3,0;1,0;1,0;7,0;3,0;1,0;6,0;;;;;4,0;17,0;6,0;1,0;35,0;7,0;;7,0;41,0;23,0;;;1,0;4,0;16,0;;2,0;;;25,0;1,0;15,0;34,0;;23,0;;6,0;46,0;;19,0;;;;7,0;;6,0;5,0;;;;4,0;19,0;8,0;4,0;;93,0;3,0;19,0;84,0;6,0;23,0;78,0;4,0;9,0;;1,0;;;;1,0;328,0;;;3,0;5,0;;;;;18,0;30,0;2,0;;1,0;;7,0;;;8,0;5,0;;9,0;49,0;;;4,0;3,0;;1,0;;;6,0;1,0;2,0;;;;10,0;;8,0;;8,0;4,0;2,0;;;15,0;;;4,0;1,0;;4,0;;2,0;24,0;156,0;6,0;;8,0;;3,0;47,0;;9,0;7,0;;3,0;1,0;;;;;;;;;;56,0;5,0;22,0;5,0;;;7,0;4,0;23,0;1,0;;1,0;1,0;6,0;10,0;;2,0;;;;55,0;2,0;6,0;;11,0;23,0;8,0;1,0;;1,0;3,0;;;;3,0;;;13,0;1,0;;37,0;16,0;;;1,0;;5,0;;;4,0;25,0;54,0;13,0;6,0;7,0;;2,0;;;;;5,0;19,0;1,0;;;24,0;1,0;18,0;6,0;;;2,0;;;;8,0;3,0;8,0;1,0;1,0;19,0;2,0;3,0;3,0;;1,0;;8,0;1,0;;10,0;3,0;2,0;;8,0;;;1,0;1,0;9,0;21,0;25,0;;;7,0;1,0;;;2,0;8,0;;14,0;;;11,0;7,0;7,0;10,0;;2,0;8,0;3,0;;2,0;1,0;2,0;33,0;2,0;2,0;5,0;19,0;;3,0;1,0;1,0;;3,0;1,0;6,0;15,0;;;5,0;1,0;4,0;;29,0;20,0;2,0;9,0;1,0;2,0;98,0;;3,0;;;12,0;31,0;;8,0;9,0;;7,0;14,0;4,0;4,0;;7,0;6,0;1,0;;;5,0;13,0;9,0;1,0;8,0;5,0;34,0;;14,0;;1,0;3,0;2,0;2,0;15,0;;;3,0;1,0;6,0;30,0;7,0;6,0;1,0;1,0;7,0;1,0;8,0;;4,0;105,0;4,0;1,0;;;;;48,0;9,0;3,0;;;1,0;;8,0;;;;;1,0;;;;;3,0;;;72,0;1,0;;1,0;3,0;4,0;;2,0;;23,0;;;72,0;;;8,0;4,0;3,0;11,0;14,0;1,0;1,0;;;;1,0;;12,0;4,0;;1,0;2,0;1,0;;;;10,0;;;15,0;3,0;5,0;;1,0;1,0;3,0;5,0;5,0;1,0;2,0;1,0;;;2,0;;;;;;2,0;;1,0;;3,0;;;5,0;;;;2,0;;;1,0;1,0;1,0;1,0;;;4,0;;;;;;;15,0;1,0;1,0;;6,0;;;;1,0;7,0;1,0;13,0;;;16,0;13,0;3,0;8,0;12,0;;;;27,0;;1,0;;;;31,0;3,0;;1,0;9,0;;;4,0;;14,0;11,0;;9,0;;;3,0;1,0;;2,0;2,0;4,0;;;;4,0;;;3,0;7,0;;;;;;;;23,0;1,0;;;4,0;;40,0;;4,0;;;2,0;1,0;;;1,0;;;;6,0;2,0;;1,0;;;;;;3,0;;;2,0;;3,0;;;1,0
rate;;;12,0;1,0;12,0;;8,0;29,0;23,0;12,0;;;;;10,0;3,0;;2,0;1,0;4,0;7,0;40,0;;;4,0;;10,0;102,0;4,0;11,0;2,0;47,0;36,0;4,0;28,0;4,0;;5,0;;29,0;;1,0;6,0;;;15,0;;;27,0;8,0;5,0;16,0;2,0;1,0;;206,0;15,0;;2,0;13,0;;8,0;47,0;;;;3,0;;1,0;11,0;13,0;1,0;2,0;;;;;3,0;12,0;10,0;1,0;18,0;5,0;1,0;;;;;2,0;18,0;22,0;;;29,0;13,0;12,0;;4,0;2,0;;1,0;37,0;;5,0;;1,0;4,0;21,0;2,0;;;4,0;4,0;23,0;;;;;;;;;3,0;1,0;;;7,0;;2,0;1,0;;;1,0;;;2,0;;;;;;1,0;1,0;3,0;6,0;1,0;2,0;244,0;5,0;;;;;;;;1,0;;3,0;12,0;;7,0;;;;;11,0;15,0;3,0;;;;6,0;;8,0;4,0;;12,0;;;1,0;;1,0;2,0;;;1,0;17,0;2,0;6,0;;;6,0;2,0;;;;;10,0;;;;;1,0;;;;;1,0;;;;;16,0;;32,0;1,0;;;;2,0;;4,0;;;;;;;;;;;;9,0;;;;8,0;;;;6,0;;3,0;1,0;5,0;1,0;;;2,0;93,0;;;;;;4,0;9,0;;;31,0;3,0;;;;;;;1,0;;;;;;;2,0;;2,0;;;;1,0;1,0;;6,0;3,0;14,0;4,0;;;;;1,0;;;;3,0;;;;;59,0;;2,0;;;7,0;;;4,0;10,0;;;;;;;;;;4,0;;2,0;4,0;;;5,0;;;2,0;;;6,0;;;4,0;18,0;2,0;11,0;;11,0;;;3,0;;;;;65,0;3,0;2,0;2,0;7,0;;12,0;;;;;6,0;1,0;;;;;;4,0;8,0;;2,0;1,0;;2,0;;9,0;3,0;6,0;;1,0;7,0;;3,0;;;5,0;;3,0;;5,0;;10,0;;;1,0;3,0;4,0;50,0;5,0;;1,0;;1,0;15,0;;5,0;4,0;19,0;;;;2,0;;;;;;;;2,0;1,0;;;1,0;16,0;;1,0;8,0;63,0;13,0;2,0;3,0;;;;;1,0;1,0;3,0;;;3,0;;;;6,0;;2,0;2,0;;1,0;1,0;8,0;3,0;;;1,0;;2,0;;;;;19,0;;6,0;;;6,0;;;12,0;2,0;;3,0;;4,0;2,0;6,0;;;;;3,0;;3,0;;2,0;;6,0;;2,0;15,0;1,0;41,0;;19,0;3,0;1,0;;;;9,0;;7,0;;;;;;;;4,0;7,0;1,0;;;1,0;;3,0;;;1,0;;;3,0;;;;;;;;2,0;1,0;2,0;;;;;;1,0;;;1,0;;;;;;3,0;2,0;;3,0;5,0;;1,0;;;39,0;32,0;;;;;;1,0;;;;2,0;1,0;;;;;;1,0;;;;1,0;16,0;1,0;5,0;;;1,0;3,0;1,0;2,0;;;;;;;;1,0;;;;5,0;;;;;;;;;;;;;1,0;;;;3,0;;;;1,0;;;;;14,0;;;;6,0;2,0;;;;;;;;;;;;;;;;;;6,0;;;;;;;;;;;2,0;;;1,0;;;;;;;;;;;;;1,0;;2,0;1,0;5,0;6,0;;;;;;;;1,0;1,0;;;;;6,0;1,0;;4,0;1,0;;;;;;3,0;;9,0;4,0;2,0;1,0;;;;;;;;4,0;;;;4,0;;11,0;1,0;;;;11,0;3,0;;;;6,0;;;;14,0;1,0;;2,0;1,0;37,0;;42,0;7,0;;;;;;;;;4,0;;4,0;2,0;4,0;;;;;;;;1,0;2,0;1,0;;;;1,0;8,0;;;1,0;;;;2,0;;;4,0;8,0;1,0;;;;;4,0;;;;;;;1,0;;;;;;;;1,0;4,0;;;;6,0;;;;;;;;;;;6,0;;;;2,0;;;1,0;;;;;;;1,0;;;;;3,0;1,0;;;4,0;;;;;;;;1,0;;;;;;;;;;;2,0;;17,0;;;2,0;3,0;;;;;;;;1,0;;;;;;;;;;;;;;8,0;3,0;4,0;;;;42,0;;;1,0;;;;;;1,0;;;4,0;;;;;;;;;2,0;;;4,0;;;1,0;1,0;;;;;;;;;;;;;;1,0;;;;;;;;;;;;;;;;;;;;;;;;;;1,0;;;1,0;;;;;;;;;;;;;;;;;;;;;;;;;;;;
ratio;;;91,0;6,0;21,0;1,0;8,0;34,0;83,0;19,0;11,0;3,0;;27,0;64,0;;2,0;;17,0;1,0;19,0;52,0;5,0;10,0;22,0;;1,0;40,0;3,0;20,0;6,0;108,0;66,0;14,0;14,0;;;9,0;;40,0;31,0;;4,0;13,0;1,0;1,0;;13,0;23,0;44,0;8,0;8,0;2,0;7,0;7,0;249,0;26,0;;22,0;34,0;3,0;62,0;36,0;13,0;;5,0;5,0;;;6,0;14,0;12,0;4,0;;;;;19,0;14,0;9,0;1,0;7,0;2,0;;4,0;;28,0;2,0;2,0;6,0;34,0;1,0;5,0;39,0;20,0;;;16,0;25,0;1,0;5,0;7,0;;;;;;50,0;2,0;;;;4,0;;;4,0;;;;1,0;2,0;;8,0;1,0;4,0;1,0;2,0;;9,0;2,0;;;1,0;;;2,0;1,0;;;21,0;1,0;2,0;4,0;9,0;4,0;;3,0;22,0;;;;;;;;;;;8,0;29,0;2,0;14,0;;;;9,0;30,0;118,0;;11,0;1,0;;8,0;4,0;3,0;2,0;1,0;39,0;;;1,0;;2,0;3,0;;4,0;2,0;15,0;;24,0;;;;;3,0;;1,0;;;;;6,0;;13,0;;3,0;4,0;;3,0;7,0;;;1,0;;;36,0;14,0;;;;2,0;1,0;;;;3,0;3,0;;;;;;;4,0;14,0;6,0;;18,0;61,0;;2,0;;18,0;;;;;;;;;11,0;;;;;;11,0;33,0;;5,0;10,0;8,0;;;;;;;2,0;;;1,0;;;1,0;;;10,0;6,0;;;;1,0;;5,0;2,0;12,0;3,0;;1,0;;;4,0;;;;4,0;;9,0;;;52,0;6,0;1,0;;;15,0;;;26,0;12,0;;;;;;;;;;8,0;;;;4,0;;;8,0;;5,0;6,0;1,0;1,0;;;;;6,0;1,0;;15,0;;5,0;17,0;;11,0;;;30,0;;1,0;1,0;5,0;;17,0;;;;;;1,0;;1,0;1,0;4,0;;;;1,0;;;;17,0;2,0;1,0;;19,0;;9,0;6,0;1,0;5,0;;9,0;4,0;3,0;;;7,0;;14,0;;;1,0;3,0;;16,0;16,0;2,0;1,0;;;17,0;7,0;;;52,0;;;;;1,0;10,0;;;5,0;;8,0;1,0;14,0;;;;47,0;;1,0;17,0;7,0;1,0;;;;;16,0;;;238,0;4,0;;;3,0;;;4,0;9,0;14,0;;5,0;;;;10,0;9,0;;1,0;;;6,0;;;;;4,0;;6,0;1,0;;4,0;;1,0;3,0;;;;1,0;7,0;;;;2,0;;;;;;8,0;;;16,0;1,0;4,0;12,0;;3,0;8,0;9,0;9,0;;;;4,0;2,0;4,0;50,0;;;;;;;;;1,0;4,0;;;;2,0;5,0;;;10,0;2,0;;83,0;;;;;;;;;;1,0;;;;;;;;;;;;;;;8,0;;;6,0;;;;;;2,0;67,0;;;;;1,0;2,0;;;5,0;;;;;;;;;;;;;4,0;;;5,0;1,0;;2,0;1,0;3,0;;;;;4,0;1,0;;;4,0;;;19,0;1,0;;;;3,0;;;;;;;;;;;;1,0;;;;;;;;;;;;;4,0;5,0;;;3,0;;;;;;;;;;1,0;;;;2,0;2,0;;;;;;;1,0;;1,0;;;;;2,0;;;;;;15,0;;3,0;2,0;;;33,0;;;1,0;;10,0;14,0;;4,0;;;;;;6,0;3,0;;4,0;1,0;;2,0;;;;;;;1,0;;;;1,0;10,0;;2,0;1,0;;;;1,0;;;;1,0;2,0;;;;2,0;;;;1,0;;;1,0;4,0;;;;;;;10,0;;;1,0;4,0;9,0;2,0;13,0;7,0;6,0;;;1,0;10,0;;;1,0;3,0;18,0;;2,0;;;1,0;2,0;;;2,0;2,0;;7,0;12,0;;;2,0;;18,0;3,0;1,0;;;13,0;;2,0;;;5,0;;;;;3,0;;;;9,0;;;;;;;;;;;;2,0;;;2,0;;;;;;;;1,0;;;1,0;;;1,0;1,0;;;5,0;;1,0;2,0;;;;;10,0;;;;;;;;;2,0;;;;8,0;;;4,0;4,0;2,0;1,0;11,0;;;2,0;;;1,0;;;;1,0;;;;;;3,0;;;;1,0;;;;;;;;;;;;;;;;8,0;;9,0;21,0;1,0;;;1,0;;;;;;;;;;2,0;2,0;;;;;2,0;;;;4,0;;;;2,0;;;;2,0;3,0;;;6,0;;5,0;;;1,0;;;;;;1,0;;;;;;;;;;;;;1,0;1,0;;;;;;;1,0;;;2,0;8,0;;;;;;;;;;;;;;;;1,0;;;;;;;;;;2,0;4,0;;;;;
reach;;;22,0;;7,0;;;3,0;;6,0;2,0;9,0;;;2,0;;;;1,0;1,0;2,0;30,0;5,0;;;;2,0;5,0;2,0;9,0;5,0;9,0;11,0;8,0;8,0;;2,0;5,0;;1,0;13,0;;9,0;2,0;2,0;1,0;;8,0;5,0;3,0;;2,0;;6,0;2,0;48,0;4,0;;12,0;60,0;;;24,0;12,0;;7,0;;6,0;;;10,0;2,0;;2,0;;;;6,0;79,0;1,0;3,0;1,0;1,0;;;;1,0;4,0;1,0;2,0;18,0;;12,0;13,0;6,0;1,0;;;11,0;;2,0;19,0;;;1,0;4,0;;6,0;;;1,0;;6,0;5,0;;;;;1,0;4,0;;1,0;4,0;;;1,0;;;;;;1,0;;10,0;;3,0;;;;1,0;;;;;;1,0;;;;;;5,0;1,0;;;1,0;;1,0;;23,0;2,0;;;;;;4,0;55,0;2,0;1,0;4,0;6,0;2,0;2,0;;5,0;2,0;2,0;;;;;4,0;;2,0;2,0;;9,0;;10,0;;;1,0;;2,0;5,0;;;6,0;;;;;3,0;1,0;;;1,0;;9,0;;;;;3,0;15,0;1,0;;;;1,0;4,0;;1,0;2,0;9,0;4,0;;;;;;1,0;2,0;6,0;8,0;;;18,0;2,0;16,0;;3,0;4,0;;1,0;;;;;;;;1,0;;;;8,0;18,0;;;;1,0;;;;6,0;;;1,0;;;;;;;;;2,0;;;;3,0;;;1,0;8,0;25,0;2,0;;;;;;;2,0;;8,0;1,0;;;;34,0;;;6,0;;5,0;;;6,0;;;;;;1,0;;1,0;;2,0;;;1,0;;1,0;;1,0;;;6,0;;;;;;;;;;;1,0;;;;1,0;3,0;1,0;;;;5,0;2,0;1,0;;1,0;;;;;;;;;;2,0;;;1,0;;;;;;1,0;3,0;;;;;1,0;4,0;;;12,0;2,0;;2,0;1,0;4,0;;2,0;3,0;;1,0;2,0;21,0;23,0;8,0;;1,0;;1,0;;;5,0;;3,0;1,0;;;4,0;;;;;2,0;;;;19,0;;;;2,0;;;3,0;;2,0;8,0;;;;;;;;;;;;;;;;;1,0;;;;;1,0;9,0;;;;;;;;;;12,0;;1,0;6,0;5,0;2,0;;;;;;;;;;;;1,0;;;;;1,0;2,0;;;;;;2,0;;10,0;2,0;;3,0;;;;;;;4,0;;;;;;1,0;;;;1,0;;;2,0;;;;;1,0;;;11,0;2,0;;;1,0;;;1,0;;1,0;;;1,0;;;;;1,0;;;;2,0;1,0;;;;;;;;;;;5,0;;7,0;;;;;;;;;;;1,0;;;;;1,0;1,0;;;;;4,0;2,0;;;;;1,0;;;;;;;;;;;;;;;;1,0;;;2,0;;;;3,0;;;;;2,0;;;;;;;;;;;;;;;;1,0;;2,0;;5,0;;;;;2,0;;;;;;;;;1,0;;;;1,0;1,0;;;;;;;;;;;;;;;3,0;;;;;;;;1,0;;1,0;;;1,0;;;;;;;;;;;;;;;;;6,0;;;;;;;;;1,0;;;1,0;;;;;;;;;;1,0;;2,0;;;;;;1,0;;3,0;;;;;;;;;1,0;;;1,0;;;1,0;;;;;;;;;;2,0;1,0;;1,0;1,0;;;;;;;;;;;;1,0;;4,0;1,0;;;;;;;;;;2,0;;;;;;;;;;;;;1,0;;;;1,0;;;;;;;;;;1,0;;;;2,0;;;2,0;;1,0;;;;;;;;;;;;;;;;;;;;;;;;;2,0;;;;;;;1,0;;3,0;;;;;;;;;;;;;;;;;;;;;;;;;;;;;;;;;;;;;;;;;;;;;1,0;;;;;;;;;;;;;;;;;;;;;;;;;;;;;;;;;;;;;;;;;;;;;;2,0;;;;;;;;;;;;;;;;;;;;;;2,0;;;3,0;;;;;;;;;;;;1,0;1,0;;;;;;;;;;;;;;
read;;;8,0;;48,0;;;73,0;7,0;28,0;;9,0;;;38,0;3,0;1,0;;10,0;18,0;2,0;95,0;15,0;4,0;19,0;;;418,0;1,0;13,0;43,0;24,0;161,0;3,0;33,0;5,0;1,0;30,0;;77,0;4,0;1,0;15,0;36,0;1,0;3,0;;2,0;29,0;5,0;3,0;26,0;4,0;14,0;;613,0;86,0;;6,0;74,0;1,0;8,0;96,0;;;;3,0;;;51,0;21,0;12,0;1,0;;;4,0;;3,0;21,0;1,0;;69,0;11,0;;;;31,0;;7,0;36,0;91,0;4,0;20,0;504,0;7,0;;;55,0;80,0;5,0;3,0;26,0;2,0;103,0;;;13,0;235,0;;;3,0;7,0;41,0;8,0;5,0;1,0;;;;10,0;;;3,0;117,0;;;49,0;2,0;;20,0;;;;;1,0;5,0;22,0;;36,0;1,0;;;7,0;17,0;19,0;;17,0;66,0;;;1,0;;;1,0;7,0;;;;;60,0;4,0;1,0;;;;18,0;37,0;24,0;;;4,0;2,0;5,0;20,0;1,0;4,0;;76,0;;;;;;;;2,0;;114,0;;12,0;1,0;;;23,0;;1,0;;;;1,0;8,0;3,0;;1,0;;7,0;;;5,0;2,0;;;;18,0;;78,0;13,0;;3,0;;;;2,0;;;1,0;;;;;;;1,0;;3,0;3,0;;18,0;39,0;;;;9,0;;;2,0;7,0;1,0;;;43,0;6,0;;50,0;3,0;1,0;;2,0;3,0;;2,0;31,0;1,0;;;1,0;3,0;;;;;;2,0;8,0;4,0;12,0;;;1,0;7,0;;;4,0;1,0;;6,0;;12,0;11,0;1,0;1,0;;;7,0;;;38,0;15,0;;;3,0;;51,0;;;;;4,0;;;21,0;13,0;;;;4,0;;;;;;24,0;;;6,0;8,0;;;8,0;;18,0;;;;2,0;19,0;;;4,0;1,0;;17,0;;11,0;5,0;17,0;1,0;6,0;;5,0;3,0;14,0;2,0;;;;3,0;;;;1,0;;;3,0;13,0;17,0;;2,0;;1,0;1,0;;;2,0;51,0;141,0;3,0;1,0;;6,0;51,0;22,0;7,0;26,0;35,0;1,0;8,0;17,0;2,0;124,0;1,0;45,0;;;6,0;2,0;14,0;5,0;1,0;;;;2,0;;;;;18,0;;1,0;;1,0;4,0;7,0;;3,0;3,0;;30,0;;36,0;;;5,0;94,0;;2,0;;2,0;;11,0;;;5,0;1,0;;11,0;1,0;2,0;;1,0;;44,0;2,0;11,0;29,0;25,0;15,0;31,0;2,0;;33,0;25,0;2,0;;8,0;33,0;;11,0;;4,0;9,0;19,0;1,0;1,0;3,0;;;18,0;;;33,0;;;7,0;;3,0;4,0;3,0;2,0;12,0;2,0;16,0;;;;2,0;12,0;;14,0;;33,0;19,0;8,0;32,0;19,0;2,0;35,0;;31,0;;20,0;;6,0;1,0;;27,0;;;;;;1,0;28,0;13,0;9,0;;1,0;4,0;;;;13,0;;1,0;16,0;12,0;;;;;;10,0;;30,0;;;;;9,0;;;;;;;1,0;8,0;6,0;;6,0;;1,0;11,0;9,0;;10,0;4,0;3,0;14,0;384,0;23,0;1,0;;;;3,0;18,0;;;;12,0;13,0;1,0;;;;;;;5,0;;9,0;1,0;2,0;5,0;;16,0;1,0;4,0;;;;1,0;9,0;135,0;;;2,0;;2,0;;29,0;;;;4,0;;;1,0;;13,0;;;;;;8,0;;1,0;14,0;;2,0;1,0;2,0;;;;6,0;;;3,0;;8,0;1,0;;;;;;;3,0;;;;2,0;2,0;;;;1,0;4,0;;;;;;;;;;;;;;;2,0;;;;;;;;18,0;;6,0;;3,0;;24,0;;;;7,0;4,0;;5,0;;7,0;;27,0;;;;6,0;79,0;12,0;;2,0;15,0;;4,0;;4,0;;23,0;;2,0;19,0;33,0;;2,0;39,0;1,0;6,0;46,0;1,0;;;;;2,0;3,0;23,0;3,0;;14,0;;;20,0;4,0;7,0;;2,0;1,0;3,0;;1,0;;;1,0;;;1,0;;;4,0;;;;;;7,0;;;;6,0;;;;3,0;;;4,0;3,0;;2,0;4,0;7,0;5,0;;;;;1,0;1,0;;;;;;3,0;7,0;;;1,0;6,0;;;8,0;;;5,0;;1,0;;;1,0;;2,0;;;;;;;;4,0;;1,0;;;3,0;;;1,0;2,0;1,0;;;3,0;;7,0;;;;;2,0;;1,0;1,0;;;;1,0;11,0;;;16,0;;;;4,0;;;3,0;;;;;;3,0;;;;;;10,0;;;;;;;;;4,0;2,0;;;;9,0;;;;18,0;;;;;;;1,0;;;;3,0;;;;;2,0;6,0;;1,0;3,0;;3,0;;4,0;;;;;;;;;2,0;5,0;;;2,0;;;;;;;3,0;3,0;2,0;;;6,0;;1,0;;;2,0;2,0;;;2,0;1,0;;;;;;;1,0;9,0;5,0;;9,0;;;;4,0;2,0;;;;;;;;1,0;;;;;;;;;;;;2,0;;3,0;;;;;;;7,0;;;;;;;3,0;;;1,0;;;;;;;;;
readable;;;2,0;;4,0;;1,0;5,0;1,0;8,0;;4,0;;1,0;5,0;1,0;;;3,0;413,0;1,0;14,0;;;1,0;;;20,0;;5,0;3,0;11,0;63,0;6,0;6,0;1,0;;2,0;;13,0;1,0;;;2,0;;;;;2,0;3,0;4,0;12,0;;;;49,0;31,0;;1,0;2,0;;2,0;27,0;;4,0;;5,0;;;7,0;;1,0;1,0;;;;;5,0;13,0;;;14,0;51,0;;;;3,0;;;7,0;15,0;;;2,0;;4,0;;124,0;89,0;;2,0;15,0;;;156,0;;1,0;3,0;;;1,0;;2,0;;;;;;;;;;;;;1,0;10,0;;3,0;;;1,0;;;;;2,0;;;;1,0;;;3,0;1,0;;3,0;6,0;;;;;;;;;;;4,0;1,0;;1,0;;;;;3,0;3,0;1,0;;;;;;;;;1,0;;;;;;;;;;10,0;;2,0;;;;6,0;;;;;1,0;;;;;;;;;;1,0;;;15,0;;;;6,0;1,0;;;;;;;;;;1,0;;;;;;;;1,0;1,0;;2,0;9,0;;;1,0;;;;;;;;;1,0;;;;;;;1,0;;;;;4,0;;;;;;;2,0;;;;;1,0;3,0;2,0;;1,0;1,0;;;;;;3,0;;21,0;;;;;2,0;5,0;;;;;;;6,0;;4,0;;;;;1,0;;;2,0;2,0;;;;;;;;;;;;;;2,0;;;;;10,0;;;2,0;;;;;;1,0;;11,0;;1,0;2,0;;;4,0;;2,0;;;7,0;;;1,0;;;;;;;;;2,0;2,0;;;1,0;5,0;;;;;353,0;8,0;3,0;;;;;1,0;19,0;60,0;;;;;;30,0;;;;;;;;;6,0;;4,0;;;;;;;;;;;1,0;;;;4,0;3,0;;4,0;;8,0;;;2,0;1,0;1,0;3,0;2,0;;3,0;2,0;;1,0;;;;;;2,0;;;5,0;;;1,0;5,0;;1,0;;;;11,0;;3,0;;;;1,0;47,0;;;11,0;;;;3,0;;;10,0;;;11,0;;;1,0;1,0;;;;1,0;;;;;;;;;;2,0;3,0;;4,0;;15,0;6,0;;2,0;;;;;;;;;3,0;;;;;;;83,0;3,0;;;;;;;;1,0;1,0;;;1,0;;;;1,0;;;;1,0;;;;;2,0;;;;;;;;95,0;;1,0;;33,0;;;3,0;;1,0;;1,0;10,0;2,0;;;1,0;;;1,0;;;;;2,0;;1,0;;;;6,0;;;;;1,0;1,0;1,0;4,0;;;;;;;;;1,0;;;;;;;;2,0;;;;;;;;;;;;;;;;;;;;;;;;;;;;;;;;;;;;;;;;;;;7,0;;;;;1,0;;;;;;;;;;;;;;;1,0;;;;;;;;;;;;;;1,0;1,0;;;1,0;4,0;;;;;;;;1,0;;1,0;;;1,0;;;2,0;;;;2,0;;;;2,0;2,0;;;;8,0;;;;2,0;;;;;;;;1,0;;;;;;2,0;;1,0;;;;1,0;4,0;;;;;;1,0;;;;;;;;;;1,0;;;;;;;2,0;3,0;;1,0;;;;1,0;;2,0;;;;2,0;;;;1,0;;;;;;;;;;;;;;;5,0;;;3,0;;;;3,0;1,0;;;;;;10,0;4,0;;1,0;1,0;;;;;;;;;;;2,0;;1,0;;;;;;1,0;;1,0;;;;2,0;;;;;;;;;1,0;;;;;;;1,0;;;;;;;;;;;;;;;;;;;;;;;2,0;;;;;;;;;;;;;;;;;;;;;2,0;;;;22,0;;;;;;;;1,0;;;;;;;;;;;;;2,0;;;;;;;;;;1,0;1,0;;;12,0;;;;;;;;1,0;;;1,0;1,0;;;;;;;;;;;;;;;;;;;;;;1,0;;1,0;;4,0;;;;;2,0;;1,0;;;;;;;;;;;;;;;;;;;
realtime;;;1,0;;;;;10,0;;20,0;;;;;1,0;;2,0;;;3,0;;8,0;;;;;;25,0;4,0;3,0;;6,0;9,0;;4,0;;1,0;;;31,0;3,0;;;;;;;;;;;5,0;;;;106,0;2,0;;;1,0;;;18,0;;6,0;;34,0;;2,0;;1,0;1,0;;;;;;1,0;;;;9,0;9,0;3,0;1,0;;1,0;;;;7,0;;;8,0;;;;;;;;23,0;;;;;;13,0;;;;;;;;;;;1,0;;;;;;;;5,0;;;2,0;;2,0;;;;;;;;;;;;5,0;6,0;;1,0;2,0;;;;;;1,0;;;;1,0;;5,0;;1,0;;;2,0;;;;;;;;2,0;;4,0;;;10,0;;;1,0;;;;;;;4,0;;;;;;11,0;;;;;;;;;;;;;;;4,0;;;;;;;2,0;3,0;;;;;;;;;;;;;;;;;;8,0;5,0;;2,0;2,0;;;;;;;;;;;;;;;3,0;;2,0;;;1,0;;;;;;;;;;;;;;;;;;;;;;;;4,0;1,0;;6,0;;9,0;2,0;;;;;;;;;;;;4,0;;3,0;;;;;1,0;;;7,0;;;;;;;;;;;1,0;;;;;;;;;2,0;;;;;;1,0;;;;;4,0;1,0;;;;;;;1,0;;;;;;;;1,0;;;;;;;6,0;;;;;;;;;;1,0;2,0;;;;;;;2,0;5,0;;;11,0;;;1,0;;3,0;;;;;;;;;;;;;;;;2,0;1,0;;;1,0;;;2,0;;4,0;;;;;;;3,0;;;1,0;;1,0;;;;1,0;;;;;;3,0;;;;;;;;1,0;;;2,0;3,0;;;;;;;;;1,0;;;;;;2,0;;;;;;14,0;;;;;1,0;2,0;6,0;;;;;;;;1,0;;;;;;1,0;;28,0;2,0;;;;;;;;;;;;;;;;;;3,0;;;;1,0;;;;;;7,0;;;;;;;;;;;;;;;;;;;1,0;;;;;;;3,0;;;;;7,0;;;;;1,0;1,0;;;2,0;;;1,0;;;;;;;1,0;;;;2,0;;;5,0;20,0;;;;;;;;3,0;;;;;;;;;;;;;;;;;;;;;;;;;;;;;;;;;;2,0;;;;;2,0;;;;;;1,0;;;;;;;;;2,0;;4,0;;;;;2,0;;;;;;;;;;2,0;;9,0;;;;;;;;;;;;;;;;1,0;;;;;;2,0;;;1,0;;;;;;;;;;;;;;;;;;;;;;5,0;;;;;;;;;;2,0;;;;;;;;;;;;;;1,0;;;;;2,0;;;;;;;;;;;1,0;;;5,0;;;2,0;;;;;;;1,0;;;;;;;;1,0;;;;;;;;;;;;;;;;;;;;;;;1,0;1,0;2,0;;;1,0;;;;;;;2,0;;;2,0;8,0;;;;4,0;;;;;;;;;;;;1,0;;1,0;;2,0;;;3,0;;;;;;;;;;;;1,0;;;;;;;;;;;;6,0;;;;;;;;;1,0;;;;;;;;;;;;;;;;;;;;;;;;;;;;;2,0;;1,0;;1,0;;2,0;;;;;;;1,0;;;;2,0;;;;;;;;;1,0;;2,0;;;;;;;;;;;;;;;;;;;;;1,0;;;1,0;;;;;;;;;;1,0;;;;;;;;;;;;;;;;;;;;;;;;;;;;;;;;;;3,0;;;;;;;;;
rear;;;4,0;;21,0;;19,0;55,0;;6,0;;;;;;;;;33,0;;;2,0;;5,0;3,0;;;3,0;1,0;9,0;4,0;;54,0;;3,0;;8,0;30,0;;54,0;3,0;;3,0;134,0;;;;7,0;22,0;;;2,0;;44,0;;39,0;31,0;;;175,0;;;8,0;;1,0;4,0;2,0;;;3,0;49,0;5,0;;4,0;4,0;1,0;2,0;17,0;62,0;2,0;1,0;1,0;;;;;16,0;6,0;;2,0;16,0;;3,0;5,0;2,0;15,0;;2,0;4,0;34,0;298,0;39,0;;;;;3,0;42,0;1,0;;5,0;16,0;2,0;19,0;37,0;2,0;3,0;;32,0;97,0;;;;17,0;2,0;;20,0;19,0;;30,0;58,0;;2,0;12,0;;;27,0;;2,0;2,0;;;3,0;101,0;8,0;2,0;41,0;23,0;;2,0;;4,0;6,0;13,0;24,0;12,0;9,0;33,0;;37,0;4,0;;6,0;3,0;;8,0;13,0;37,0;;;107,0;8,0;12,0;46,0;;34,0;6,0;2,0;;;20,0;;2,0;1,0;11,0;3,0;72,0;22,0;;114,0;;10,0;5,0;24,0;;5,0;;1,0;2,0;18,0;;4,0;10,0;114,0;;;2,0;16,0;13,0;41,0;;1,0;1,0;1,0;4,0;9,0;1,0;13,0;12,0;2,0;17,0;143,0;;;35,0;2,0;11,0;;;1,0;5,0;;1,0;15,0;5,0;1,0;13,0;16,0;13,0;;34,0;;4,0;15,0;3,0;20,0;;2,0;1,0;3,0;1,0;;;28,0;;;;14,0;;6,0;;14,0;16,0;;10,0;3,0;31,0;5,0;1,0;3,0;2,0;271,0;2,0;;9,0;;;2,0;;17,0;9,0;1,0;2,0;11,0;1,0;1,0;10,0;1,0;;7,0;;6,0;1,0;;;;;3,0;1,0;;5,0;2,0;14,0;8,0;14,0;12,0;;;;7,0;2,0;2,0;1,0;1,0;12,0;6,0;7,0;;6,0;6,0;;;14,0;7,0;;9,0;;;1,0;;5,0;;;;;;;;;;;1,0;;4,0;;;;;16,0;2,0;10,0;;;;;;;2,0;;;;;;3,0;;;;;;;;1,0;;;;;3,0;;;4,0;;1,0;;;;;;;;3,0;;;2,0;;7,0;2,0;7,0;;1,0;;;;;;;;1,0;2,0;;;;3,0;2,0;1,0;;;2,0;;;1,0;;;;1,0;;21,0;;;1,0;;;;1,0;;1,0;6,0;;;;;;;;;2,0;;;;2,0;1,0;;;7,0;2,0;3,0;;;;;;;;;;;14,0;16,0;;;;3,0;3,0;;;26,0;;3,0;;;;;;;;;25,0;18,0;;;;;1,0;;1,0;17,0;18,0;5,0;4,0;2,0;;14,0;;;;9,0;4,0;;;1,0;24,0;;;;;2,0;1,0;2,0;;;;2,0;17,0;;3,0;;;6,0;;;;;;4,0;;;;2,0;;;;;;;3,0;6,0;;2,0;;;;1,0;;1,0;;;5,0;1,0;;;;5,0;;;;9,0;;12,0;;;;;;;;3,0;;5,0;;;;;;4,0;;;8,0;;;;;;1,0;;;2,0;;;2,0;10,0;7,0;1,0;;3,0;5,0;5,0;;;;;;;2,0;2,0;4,0;;;2,0;6,0;2,0;;;;;5,0;;1,0;;2,0;3,0;;;;42,0;2,0;;1,0;;;;;1,0;;;9,0;4,0;;;;;;;;;5,0;;2,0;7,0;;;2,0;1,0;;;;2,0;;;;;1,0;;1,0;3,0;;;6,0;;1,0;;;;;;;;;;;;;;;;;2,0;;2,0;3,0;;;;;;;;;;;;;;;;;;;;1,0;;;3,0;;3,0;;1,0;;;;;;;;;;;;;;;;;;;;1,0;;1,0;;;;20,0;2,0;;;;;;;;;;1,0;;;;1,0;;2,0;2,0;;;;9,0;;;4,0;;;;;;;;;;4,0;;;;;;;;;2,0;;;6,0;;1,0;1,0;;;3,0;;;;;;;;;;1,0;2,0;;;;;;;;;;;;;;1,0;5,0;14,0;1,0;;1,0;;;;;;1,0;;;1,0;;;;;;;1,0;;;;;;;;;;;5,0;;;;3,0;;2,0;;;5,0;1,0;;;;2,0;1,0;2,0;;;;;17,0;;3,0;1,0;2,0;2,0;1,0;;;;;;;;;;;;;;12,0;2,0;;;1,0;;;;;;;;2,0;;;;;5,0;;;1,0;;;;1,0;1,0;;;2,0;;;;;;;;;;1,0;;;;;;;;;;;;;;2,0;;4,0;;;1,0;;;;;;;;;;;;1,0;;;;;;;;;;;;;;;;;;;;;;;;;;;;;
rearward;;;1,0;;;;12,0;1,0;;2,0;2,0;;;;;;;;8,0;;;1,0;;;;;;;;;;5,0;51,0;;1,0;;;14,0;;8,0;2,0;;;12,0;;;;;;;;;;7,0;;21,0;2,0;;;16,0;;;1,0;;;;15,0;;;1,0;20,0;;;;;;;1,0;2,0;;5,0;;;;;;;4,0;;;;1,0;;;;;;;;;3,0;14,0;;;;;;;;;1,0;6,0;;1,0;;;;;4,0;;;;;;;;4,0;5,0;;;;;;;;5,0;;;;4,0;;;5,0;17,0;;10,0;3,0;20,0;;;;;;;;13,0;;2,0;;6,0;;;;;;;;5,0;;;3,0;3,0;;;32,0;;;;;;;;1,0;;;;1,0;1,0;;6,0;;;;;;;;;4,0;;;3,0;;2,0;;;;;;3,0;;;;;;;;;;;7,0;18,0;;7,0;;;;;;;;;;;1,0;;;;3,0;;;;;;;;;;;;2,0;;;1,0;;;;;;;;;5,0;;;1,0;2,0;;;;;6,0;;;;;;3,0;20,0;;1,0;;;1,0;;;18,0;;;;;;;;;;;;;;;;;;;;;;5,0;;;;;6,0;12,0;;;;;2,0;;;10,0;2,0;;3,0;;;2,0;;;;;;;;;;;;;;;;;;;1,0;;;;;;;;;;;;;;;;;;;;;;;;;;;;;;;;1,0;;4,0;;;;;;;;;;;10,0;;8,0;;;;;;;;;;;;;;;;;;;;;;;;;;;;;;;;;;;;4,0;;;;;;;;;;;;;;;;;;;;;;10,0;;;;;;;;;;;;;2,0;12,0;;;;;;;;;;;;;;;;;;;1,0;;;;;;;;;13,0;15,0;;;;;;;;;;;;;;;;;;;;;;;;;;;;;;;;;;;;;;;;;;;;;;;;;;;;;;;;;;;;2,0;;;;;;;;;;;;;;;;;;;;;;;;;;;;;;;;;;;;;;;;;;;;;;;;;;;;;;;;;;;;;;1,0;;;;;;;;1,0;;;;;;;;1,0;;;;;;;;;;;;;;;;;;2,0;;;;;;;1,0;2,0;;;;;;;;;;;;;;;;3,0;;;;;;;;;;;;;;;;;;;;;;;;;;;;;;;;;;;;2,0;;;;;;;;;3,0;;;;;;;;;;;;;;;;;;;;;;;;;;;;;;;7,0;;;;;;;;;;;;;;;;8,0;;;;;19,0;;;;;1,0;;;;;;;;;;;2,0;;;;;;;;;5,0;;;;;;;;;;;;;;;;;;;;;1,0;;;;;;;;;;4,0;;3,0;;;;;;;;;;;;;;;;;;;;;;;;;;;;15,0;;;;;;;;;;;3,0;;;;;;;;;;;;;;;;;;;;;;;;;;;;;;;;;;;;;;;;;;;;;;;;;;;;;;;;;;;;2,0;;;;;;;;;;;;;;;;;;;;;;;;;;;;;;;;;;;;;;;;;;;2,0;;;;;;;;;;;;;;;;;;;;;;;;;;;
receiver;;;1,0;1,0;29,0;;1,0;24,0;4,0;18,0;;;1,0;;1,0;;;;3,0;2,0;;32,0;5,0;;;;;33,0;;4,0;1,0;15,0;34,0;1,0;9,0;3,0;6,0;2,0;;20,0;2,0;;1,0;6,0;23,0;;;;2,0;24,0;;6,0;;;2,0;65,0;62,0;;;11,0;;;29,0;;;;;;;8,0;15,0;;1,0;;;;;;27,0;12,0;;4,0;11,0;;;1,0;2,0;;2,0;5,0;8,0;;;128,0;;;;6,0;1,0;2,0;3,0;40,0;;;;1,0;;57,0;2,0;;8,0;19,0;7,0;8,0;1,0;;;;;5,0;;;;2,0;1,0;2,0;7,0;;;18,0;;;1,0;;1,0;8,0;3,0;;;4,0;1,0;;10,0;;;;;;;;;;;2,0;1,0;;;21,0;;7,0;2,0;;;;;;1,0;24,0;;;;;19,0;6,0;;7,0;;6,0;;;2,0;;;;20,0;;9,0;51,0;;21,0;;;10,0;117,0;;2,0;;;;3,0;4,0;;;3,0;;;;6,0;1,0;3,0;;;;;;34,0;31,0;;;;2,0;3,0;;2,0;3,0;3,0;;;;;;;5,0;4,0;;1,0;;;19,0;;;;;;1,0;;4,0;;;;2,0;;;18,0;;1,0;3,0;5,0;2,0;;;;;;2,0;;2,0;;;1,0;;;;;1,0;7,0;;;1,0;10,0;2,0;;;;;2,0;;3,0;11,0;1,0;2,0;;;2,0;;;;2,0;;;4,0;;2,0;;;;;1,0;;;4,0;3,0;;;;;1,0;;;;;;3,0;;;21,0;;;1,0;;3,0;;;;;;;;;;2,0;4,0;;;;;;;;2,0;;5,0;4,0;;;;1,0;;;;1,0;;4,0;;;4,0;;;;;;;;;1,0;3,0;;;;;;;;;;;1,0;;;4,0;;3,0;;;23,0;2,0;;2,0;;;13,0;;2,0;;;;;;;3,0;2,0;1,0;;;2,0;1,0;2,0;;6,0;4,0;19,0;;2,0;;3,0;;;;;5,0;;;1,0;;;;1,0;;16,0;3,0;;;;;;9,0;;3,0;;;;1,0;;5,0;;;2,0;;2,0;;;;2,0;;5,0;1,0;2,0;2,0;3,0;;;2,0;;;1,0;;;17,0;2,0;;;;3,0;2,0;;;;;;5,0;;5,0;;2,0;30,0;;2,0;;;;;;;;27,0;;;;;1,0;;1,0;;1,0;9,0;1,0;1,0;;;;;;;;;;1,0;;;;;1,0;;;;;;;;;;;;;;;1,0;1,0;;;;2,0;;2,0;2,0;;1,0;3,0;3,0;13,0;;;2,0;;;;5,0;;;;;;;9,0;;;;;;3,0;;4,0;13,0;;;4,0;5,0;;;;52,0;;;;;;;;;;;6,0;1,0;;;;;;;;;2,0;;;;;33,0;1,0;;;;;;12,0;15,0;;;1,0;7,0;6,0;;1,0;;3,0;1,0;1,0;12,0;;8,0;;;;;;;;;;2,0;;2,0;;;;;1,0;;;4,0;1,0;2,0;;;;2,0;;;;;;;;2,0;;2,0;;;;;;15,0;;;;;;;;;2,0;;;1,0;;;2,0;;2,0;2,0;;1,0;;1,0;;;;6,0;;;4,0;;;;;;;;;;;;2,0;;21,0;;;;;;;1,0;1,0;;;4,0;;;;;;;;;;;;;1,0;;;;;;;;;;1,0;;1,0;;;5,0;;;;;;;1,0;2,0;;;;;4,0;;;;8,0;;;;;;;2,0;;;;4,0;;;;6,0;;;1,0;;;;;;;;;;;1,0;;;;;1,0;;;;;;;;;;;;;;;;2,0;;2,0;;;;;;;;;4,0;;;40,0;;;;;;;7,0;;;;;;2,0;;;;;1,0;;;;;;;;2,0;;;13,0;;;;;;;9,0;;;;4,0;;;;;;1,0;;11,0;;;;;3,0;;;;;;;;;;;;;;;;;;;;;;;;;1,0;;;;;2,0;;;;2,0;;;;4,0;;;;;1,0;;;;;;;;;;;;;;;;;;;;;;;;;6,0;;;;;;;1,0;;;;;;;;;;;;;;;;;;;;;;;1,0;;;;;
recognize;;;8,0;7,0;12,0;;;75,0;8,0;31,0;1,0;2,0;;;1,0;;;;5,0;5,0;7,0;16,0;;3,0;;;;179,0;;41,0;5,0;78,0;67,0;;2,0;2,0;1,0;11,0;3,0;19,0;7,0;;1,0;;2,0;5,0;;;7,0;;1,0;49,0;;16,0;;307,0;18,0;;;4,0;;;39,0;;;;3,0;;1,0;6,0;12,0;4,0;;;;3,0;;27,0;34,0;;1,0;34,0;9,0;4,0;14,0;;11,0;;;18,0;3,0;;10,0;14,0;6,0;;;3,0;10,0;;1,0;8,0;;;;;25,0;53,0;;;;1,0;2,0;1,0;;;;;;4,0;;;1,0;19,0;;;10,0;;1,0;1,0;1,0;4,0;;;;;1,0;;;;;;;439,0;;;7,0;;;;;;;;1,0;;;;;12,0;;1,0;;1,0;;;1,0;4,0;1,0;;;1,0;8,0;4,0;;;;17,0;;;;;;;;2,0;;15,0;;2,0;;;;7,0;;;;;10,0;;;6,0;;1,0;;2,0;;;;1,0;;1,0;;;;6,0;5,0;;1,0;;;3,0;;1,0;;;1,0;;;;;;;;2,0;13,0;;2,0;107,0;5,0;;;;;;2,0;2,0;;;;;;;;;;;;1,0;;;;;;;;;;;2,0;;2,0;2,0;;;;1,0;;;;;;;;;3,0;;72,0;6,0;1,0;;;;45,0;;;;11,0;;;2,0;;8,0;;;;;6,0;;;2,0;;;;;;;;;;;;;;;7,0;;;1,0;;19,0;;;;;;6,0;3,0;;;2,0;9,0;;1,0;;;;3,0;;6,0;;13,0;1,0;;1,0;;;;;;3,0;1,0;;;8,0;8,0;3,0;1,0;;5,0;;;;2,0;;2,0;1,0;2,0;;;2,0;3,0;2,0;5,0;;;;;1,0;30,0;;5,0;;1,0;2,0;2,0;;86,0;;;13,0;;;;;;;1,0;2,0;;;10,0;;;;1,0;23,0;;7,0;;27,0;;;13,0;5,0;;;2,0;;;;;1,0;;1,0;;;;5,0;;;4,0;;;;;;5,0;1,0;1,0;2,0;8,0;16,0;;;;2,0;1,0;3,0;;;1,0;;;5,0;1,0;;;;;;21,0;;;;1,0;1,0;;92,0;;23,0;2,0;3,0;;2,0;2,0;1,0;;1,0;6,0;11,0;2,0;;1,0;3,0;2,0;;;1,0;;;12,0;;5,0;1,0;;;;;1,0;;;2,0;2,0;;;;;4,0;;;;2,0;3,0;2,0;;4,0;;;;;;;;20,0;;;4,0;;4,0;;;;2,0;;2,0;;;2,0;;2,0;1,0;;;;;;;;3,0;7,0;;1,0;11,0;;3,0;;;;;;1,0;4,0;;;;;;;2,0;2,0;3,0;10,0;;;6,0;;;;;;;;;;;;;4,0;;;;;;;;1,0;;;;;5,0;;;;;;;;;;;;;;;;;;;;;;;1,0;2,0;;;;;;2,0;;;;;2,0;;;;5,0;;;;;;;;;;;;;;;;1,0;;;;;;2,0;;;;3,0;;;1,0;;;1,0;;;;;;;;;;;;;;;;;;1,0;;;2,0;;;;;;9,0;;;1,0;;;1,0;;;;;;;;;;;;;;;;;2,0;;;;;;;;;;;;1,0;;2,0;;;;;;;;;;;;;11,0;;;;17,0;;;1,0;;6,0;;4,0;;;;3,0;13,0;1,0;;;1,0;;;1,0;29,0;;;5,0;1,0;;;;;;34,0;1,0;;;;1,0;;;9,0;;;;;;;;;;;;1,0;;;;;2,0;;;;;;;4,0;;;;;;2,0;1,0;;;;;;;;;;;;10,0;2,0;;;;;;;1,0;1,0;;;;;;;;;;;;;;;;;;;;;;;;;;;;;;;;;;;;;;4,0;5,0;;;;;;;;;;;;;;;;;;;;;;;;;;;;;;;;;2,0;;;;;;;;;3,0;;2,0;;;;;;;;1,0;;16,0;;;;;;;;;;;;;;;3,0;;;;;;;;;;;;2,0;;;;;;;2,0;16,0;;;;;;;;;;;;;5,0;;;;;
rectangular;;;3,0;;6,0;;6,0;20,0;;1,0;11,0;;1,0;6,0;2,0;2,0;;;;;;;11,0;;;;;12,0;;8,0;2,0;3,0;55,0;;12,0;;;7,0;2,0;11,0;;;;2,0;;;2,0;;;1,0;;3,0;;1,0;;69,0;27,0;;4,0;15,0;;2,0;10,0;;1,0;;2,0;;;1,0;19,0;1,0;2,0;;6,0;25,0;2,0;10,0;15,0;;;;1,0;10,0;;;51,0;;4,0;2,0;6,0;;;3,0;9,0;3,0;;;11,0;2,0;14,0;4,0;;2,0;;;1,0;7,0;;1,0;;3,0;4,0;2,0;1,0;;;;5,0;16,0;;;;4,0;;;4,0;2,0;;2,0;8,0;;;1,0;2,0;1,0;7,0;;1,0;;;;1,0;5,0;1,0;;44,0;48,0;;;;16,0;2,0;;3,0;4,0;10,0;10,0;;32,0;;;6,0;10,0;;3,0;;10,0;;2,0;16,0;1,0;19,0;10,0;;54,0;6,0;;;;;1,0;4,0;;;3,0;16,0;12,0;;43,0;;6,0;;3,0;;;;;;1,0;1,0;159,0;5,0;51,0;;;;3,0;4,0;9,0;;;;3,0;;;1,0;3,0;;;5,0;;1,0;;8,0;;6,0;;;1,0;2,0;;;5,0;;;;2,0;43,0;;15,0;;15,0;4,0;;7,0;;;1,0;2,0;1,0;2,0;;5,0;;;11,0;19,0;;2,0;2,0;;3,0;2,0;2,0;;13,0;1,0;4,0;;;7,0;;;;;;;3,0;5,0;4,0;;2,0;1,0;6,0;5,0;2,0;14,0;;1,0;;1,0;4,0;2,0;;;2,0;6,0;;;4,0;1,0;15,0;2,0;9,0;;;5,0;;2,0;;2,0;;;;1,0;;;1,0;;;1,0;;1,0;;1,0;;8,0;;;3,0;;;;;;;;;;;;;3,0;;;;;4,0;;1,0;;;;;;;;;;;;;;;;;;;6,0;2,0;;;1,0;1,0;;;;;11,0;;1,0;2,0;;;;;3,0;;2,0;;;;;1,0;;;;3,0;;;;1,0;;5,0;;;;;;;1,0;2,0;;;;2,0;;1,0;;;;;;;;;;;;;;;;;;;;;;1,0;;;;;1,0;;2,0;;;;;5,0;;;4,0;;;1,0;;;;;1,0;;4,0;;1,0;;;;;;;;;1,0;;;;;;;;;2,0;;;;2,0;;1,0;;;2,0;17,0;1,0;1,0;;;;;;1,0;6,0;2,0;;;;;12,0;;;13,0;1,0;;;;;;;;4,0;2,0;;;;;;;;;;;;;6,0;;;;;;;1,0;;;;;;;;;;;;2,0;;6,0;;;4,0;4,0;1,0;;;;;;;;;;;;;1,0;;;;;;1,0;5,0;;;1,0;;;;;;;;;4,0;;;;3,0;8,0;;;;;1,0;;;2,0;;;;2,0;;;;;;;;;;;;;;;;;;;;;;;;1,0;;1,0;1,0;;;;;;;;;;6,0;;1,0;1,0;;;5,0;;;;;1,0;;;;;1,0;;;;;1,0;;;;3,0;4,0;;;;;;;;;3,0;;;;;;;;2,0;;;;;2,0;;;;;;;;;;4,0;;;;;3,0;;6,0;;;;;;1,0;;4,0;;;;2,0;;;;;;;;;;;;;1,0;;;;;;2,0;1,0;;;;3,0;2,0;;;2,0;;3,0;1,0;;7,0;;;;;;1,0;;5,0;;;;2,0;;;;;;;;;;;;;;;;16,0;;;;;1,0;;;5,0;1,0;;;;;;;;1,0;;;;2,0;;;;;;;2,0;;;;;;;;;;;;;;1,0;;11,0;1,0;;;;;1,0;;;;;;6,0;;;;;;1,0;;;;;;;;1,0;;;;;;;;3,0;;5,0;;;1,0;;;1,0;;1,0;;12,0;;;;;;;1,0;;;;;;;;;;;;;;;;;;;;;;;;;;;;;;;;;;;;;2,0;;;;;;;;;;;;;;;;;;;;;;;4,0;;;;;;;;;;1,0;;29,0;;;;;;;;;;;;;;;;;;;4,0;;;;2,0;;;;;6,0;;;;;;;;;;;;1,0;;;;
reduction;;;36,0;;67,0;;14,0;8,0;2,0;7,0;;3,0;;2,0;17,0;2,0;7,0;;8,0;1,0;3,0;42,0;;3,0;20,0;;;50,0;21,0;13,0;6,0;13,0;93,0;;11,0;;2,0;40,0;1,0;10,0;1,0;;18,0;1,0;;1,0;;;1,0;4,0;7,0;36,0;3,0;;;139,0;14,0;;1,0;46,0;;9,0;49,0;;;1,0;10,0;;;8,0;30,0;3,0;3,0;;;7,0;;4,0;19,0;6,0;;42,0;3,0;;;;;;;8,0;1,0;1,0;1,0;23,0;5,0;4,0;;;2,0;;1,0;23,0;;;;;2,0;111,0;;;3,0;;;3,0;;2,0;1,0;;1,0;1,0;;;3,0;4,0;;;7,0;;2,0;;;;;;;;;;;1,0;;1,0;;4,0;17,0;;3,0;27,0;;;;;;;10,0;;;;;10,0;;5,0;;;;;2,0;64,0;;;28,0;;2,0;2,0;9,0;;;11,0;;;;;6,0;;1,0;;;19,0;;8,0;;;;;1,0;;;;;;;;;1,0;;;;;;4,0;;;;;;34,0;1,0;;;;1,0;2,0;149,0;;;;;;;;;;13,0;;3,0;;;3,0;10,0;;7,0;;;;;;;1,0;;;;1,0;;1,0;;;;;;;3,0;18,0;;;1,0;;;;;;;2,0;;;2,0;;;;1,0;4,0;;2,0;;23,0;;6,0;8,0;2,0;;;;;1,0;2,0;;;;1,0;;;;;19,0;;;;;;;;2,0;4,0;;;;;;;1,0;;;11,0;;;;3,0;;;6,0;;3,0;2,0;;;;;5,0;2,0;;;;1,0;;;38,0;;3,0;1,0;;22,0;;12,0;;;;3,0;4,0;;;5,0;1,0;;;;;1,0;;;;;;;;;;;;156,0;;3,0;7,0;;;4,0;;;37,0;9,0;;1,0;;;;;1,0;6,0;1,0;10,0;8,0;;;;;2,0;;;;1,0;;;3,0;1,0;;;;2,0;1,0;;7,0;;4,0;;;;37,0;;1,0;;3,0;1,0;;8,0;;;;;1,0;;;;;;;;;1,0;3,0;;;;;7,0;;15,0;;2,0;;;3,0;;4,0;;;;;;;;3,0;;;86,0;;;;;;;;;;;;;;;1,0;6,0;;3,0;;;;;13,0;;1,0;;;;;;3,0;;;;;;;;;1,0;;;;;;;;;;;2,0;;;26,0;2,0;;;;;;;;;2,0;;;;;;2,0;;;;;;;;;2,0;;;;;;17,0;;;10,0;119,0;;;;;;2,0;1,0;;;;;;;;;;;;;;2,0;15,0;;;;;;4,0;3,0;;;;;;3,0;1,0;;;;;;1,0;;;;;2,0;;;;;;;;;;;;;;;1,0;2,0;;;;;;;;;;2,0;;;;;;;;;;;;;3,0;;;;;;;;;;;;1,0;;;;;;;2,0;1,0;;;;;;;1,0;;;;3,0;;;;;1,0;1,0;;;;;;;;;;;26,0;;;;;;2,0;;;;;;;;;9,0;;;;4,0;;2,0;;2,0;;;;;;;;;;;;;;3,0;3,0;;;;2,0;;2,0;;;;;;;;;;1,0;;;;;;;;1,0;;;;;;;1,0;2,0;;;;;3,0;;;;;;;10,0;1,0;;;;;;;;;;1,0;;;;;;;;;;;;;;;;;;;;1,0;;;;;;;;;2,0;5,0;;;;1,0;;;;;;;3,0;;;;1,0;;;;;;;;;;;;;;;15,0;;8,0;;;;;;;;4,0;1,0;;;;;2,0;;;;;;;;;;;;;;;1,0;;;;;;;;;;;;;;;;2,0;;1,0;;;;4,0;;;;;;;;2,0;2,0;;;;3,0;;;;;;;;;;;;;;;;;;;;;;;;;;;;;28,0;;2,0;2,0;;;;;;;;;;;;;;2,0;2,0;;;;;;;;;;;;;;;;;;;;;;;;;;;;;;;;;;;;;;;
reference;;;36,0;2,0;57,0;;65,0;172,0;118,0;109,0;42,0;90,0;;2,0;168,0;6,0;5,0;3,0;92,0;21,0;43,0;118,0;188,0;38,0;44,0;14,0;28,0;174,0;5,0;77,0;57,0;220,0;94,0;47,0;62,0;;;100,0;20,0;123,0;60,0;;11,0;117,0;6,0;3,0;2,0;12,0;50,0;31,0;13,0;104,0;68,0;16,0;6,0;1165,0;72,0;7,0;17,0;67,0;22,0;32,0;169,0;4,0;21,0;4,0;33,0;;;26,0;12,0;3,0;5,0;4,0;;6,0;;333,0;453,0;5,0;2,0;54,0;22,0;10,0;;2,0;206,0;13,0;10,0;75,0;78,0;41,0;3,0;341,0;31,0;8,0;11,0;20,0;89,0;6,0;71,0;224,0;;15,0;2,0;;;206,0;;;15,0;23,0;15,0;;6,0;7,0;;12,0;1,0;7,0;20,0;1,0;14,0;58,0;;2,0;42,0;4,0;6,0;8,0;6,0;5,0;1,0;8,0;9,0;18,0;5,0;;;11,0;;12,0;5,0;13,0;26,0;;18,0;252,0;1,0;;13,0;2,0;8,0;;2,0;8,0;;4,0;9,0;73,0;1,0;1,0;;1,0;1,0;;73,0;43,0;7,0;5,0;19,0;15,0;13,0;12,0;43,0;4,0;;102,0;;;25,0;;2,0;;;55,0;27,0;192,0;;110,0;;;;66,0;;2,0;;;3,0;;;17,0;;7,0;;32,0;2,0;5,0;12,0;10,0;39,0;4,0;26,0;2,0;10,0;47,0;8,0;;2,0;;;5,0;16,0;3,0;;17,0;28,0;;;5,0;;;2,0;10,0;65,0;32,0;;11,0;88,0;4,0;9,0;;28,0;6,0;;3,0;7,0;;;1,0;4,0;16,0;;22,0;2,0;2,0;;65,0;8,0;6,0;9,0;6,0;116,0;;4,0;;15,0;;1,0;;1,0;4,0;7,0;4,0;1,0;;1,0;;3,0;36,0;;;;;;54,0;17,0;122,0;12,0;7,0;;10,0;14,0;52,0;;20,0;2,0;44,0;1,0;;1,0;;119,0;11,0;9,0;8,0;1,0;36,0;2,0;3,0;;23,0;16,0;12,0;;;2,0;;;;;37,0;;;10,0;30,0;;;17,0;6,0;36,0;7,0;;4,0;;;;7,0;8,0;24,0;5,0;61,0;;20,0;1,0;;37,0;6,0;7,0;43,0;12,0;8,0;27,0;8,0;;4,0;7,0;4,0;4,0;;21,0;3,0;;9,0;58,0;46,0;6,0;;19,0;12,0;3,0;;8,0;18,0;8,0;12,0;4,0;2,0;;34,0;22,0;9,0;1,0;9,0;65,0;1,0;4,0;26,0;2,0;19,0;;6,0;2,0;;1,0;26,0;5,0;53,0;13,0;2,0;12,0;;3,0;5,0;23,0;26,0;3,0;19,0;21,0;;31,0;3,0;4,0;7,0;;2,0;23,0;;53,0;15,0;46,0;;;7,0;8,0;;1,0;21,0;4,0;31,0;5,0;15,0;;;1,0;;44,0;;1,0;4,0;1,0;11,0;4,0;;;26,0;73,0;13,0;15,0;7,0;;12,0;112,0;10,0;;3,0;13,0;;23,0;;7,0;4,0;11,0;8,0;;9,0;22,0;1,0;48,0;;2,0;44,0;;;;7,0;15,0;;3,0;2,0;;1,0;5,0;3,0;1,0;18,0;26,0;4,0;;36,0;;27,0;101,0;6,0;60,0;33,0;;199,0;1,0;3,0;;16,0;3,0;19,0;10,0;;4,0;;;2,0;;;3,0;5,0;1,0;;;;2,0;1,0;;2,0;1,0;;;3,0;4,0;;2,0;1,0;;7,0;1,0;3,0;;21,0;;20,0;;;;1,0;14,0;;;;1,0;;;;28,0;4,0;;4,0;4,0;;26,0;;;71,0;239,0;27,0;;;;5,0;53,0;;2,0;3,0;;8,0;5,0;;;;;;1,0;;;2,0;5,0;3,0;;23,0;;;;29,0;;;;19,0;;3,0;;;2,0;7,0;;;34,0;;;;;9,0;;;;3,0;;;;;;;;4,0;7,0;;1,0;2,0;;;;;;;;;2,0;19,0;17,0;1,0;5,0;;;;1,0;2,0;;;2,0;5,0;15,0;;13,0;;29,0;;;;;;;;9,0;6,0;21,0;;;;4,0;;5,0;;;2,0;;;;4,0;2,0;;;7,0;1,0;1,0;10,0;1,0;17,0;24,0;31,0;8,0;;;2,0;;;;21,0;1,0;7,0;;5,0;9,0;2,0;5,0;1,0;3,0;;1,0;8,0;;;3,0;12,0;24,0;7,0;11,0;1,0;3,0;10,0;4,0;7,0;;25,0;;1,0;9,0;3,0;;3,0;6,0;7,0;;;4,0;;20,0;59,0;1,0;4,0;;4,0;;1,0;3,0;15,0;;7,0;51,0;3,0;2,0;16,0;64,0;10,0;6,0;2,0;7,0;1,0;25,0;4,0;2,0;7,0;3,0;3,0;36,0;41,0;;51,0;20,0;24,0;;;12,0;2,0;;33,0;1,0;;1,0;;19,0;16,0;5,0;3,0;1,0;5,0;1,0;;2,0;4,0;7,0;25,0;2,0;;;6,0;;;31,0;;;;;4,0;;5,0;17,0;;3,0;;;;;8,0;9,0;;1,0;2,0;11,0;;;1,0;;13,0;;12,0;6,0;3,0;;;1,0;;;11,0;;2,0;5,0;8,0;1,0;;;;;4,0;2,0;;1,0;8,0;4,0;;4,0;;3,0;1,0;;;;6,0;23,0;2,0;;6,0;1,0;6,0;;9,0;4,0;11,0;;;;;;2,0;;;;12,0;;;;;;;7,0;;;;;;;;;12,0;;;;;19,0;;6,0;1,0;;2,0;;15,0;;;;;3,0;;;2,0;2,0;35,0;;4,0;1,0;;15,0;;;;;5,0;18,0;;;;6,0;2,0;2,0;;;2,0;;;2,0;1,0;;7,0;;;;;;;2,0;;;1,0;11,0;;;;;;;;;1,0;;2,0;4,0;;;;;;;;2,0;;10,0;16,0;27,0;;21,0;;;;;;;4,0;1,0;;2,0;2,0;;;1,0;;3,0;;;;;3,0;;;;;
reflect;;;42,0;;13,0;;41,0;16,0;3,0;44,0;3,0;1,0;;;13,0;1,0;;;12,0;;3,0;22,0;2,0;5,0;1,0;;2,0;8,0;19,0;26,0;13,0;35,0;43,0;7,0;4,0;2,0;25,0;64,0;;7,0;17,0;2,0;30,0;179,0;;2,0;;16,0;7,0;5,0;6,0;13,0;;16,0;;193,0;104,0;;8,0;285,0;1,0;2,0;30,0;;;4,0;1,0;10,0;3,0;3,0;160,0;15,0;48,0;;1,0;11,0;;7,0;90,0;9,0;18,0;3,0;3,0;15,0;;100,0;54,0;5,0;9,0;4,0;54,0;2,0;3,0;43,0;6,0;5,0;1,0;;1,0;6,0;491,0;69,0;;;;;1,0;50,0;20,0;2,0;2,0;28,0;5,0;19,0;1,0;1,0;13,0;;1,0;4,0;;;1,0;5,0;7,0;9,0;44,0;4,0;;4,0;;;2,0;;;8,0;11,0;;7,0;66,0;28,0;1,0;1,0;14,0;9,0;3,0;46,0;4,0;;2,0;;;34,0;;;;1,0;11,0;40,0;58,0;55,0;;7,0;3,0;;7,0;6,0;839,0;;4,0;208,0;412,0;4,0;3,0;4,0;5,0;4,0;12,0;;;;1,0;31,0;;;24,0;20,0;44,0;1,0;61,0;8,0;;55,0;49,0;;;1,0;;7,0;1,0;5,0;5,0;3,0;49,0;1,0;1,0;;;;;;;2,0;12,0;3,0;8,0;33,0;7,0;5,0;2,0;1,0;11,0;;21,0;1,0;18,0;32,0;;1,0;;5,0;;;10,0;2,0;18,0;5,0;2,0;13,0;;2,0;;2,0;1,0;;;;9,0;;;;;;8,0;6,0;;;;3,0;;1,0;18,0;2,0;;;;2,0;;;3,0;;6,0;;;;14,0;;;5,0;29,0;;;;40,0;;;12,0;104,0;;7,0;7,0;;;5,0;;6,0;;29,0;1,0;;;;4,0;5,0;2,0;8,0;;2,0;5,0;;2,0;2,0;10,0;;;;3,0;;;;;3,0;;1,0;;30,0;;;;1,0;22,0;4,0;;;;;;;1,0;2,0;;3,0;;;;;;3,0;4,0;9,0;5,0;;;2,0;;;;2,0;;1,0;4,0;;10,0;1,0;1,0;;5,0;3,0;3,0;6,0;6,0;;2,0;12,0;1,0;;1,0;;;5,0;7,0;12,0;;;14,0;;;;;3,0;;1,0;;;19,0;;;14,0;;3,0;1,0;;1,0;;;;;32,0;;;1,0;10,0;;7,0;;1,0;2,0;;5,0;12,0;11,0;;;;12,0;;2,0;1,0;;28,0;;3,0;;;;1,0;1,0;;;;1,0;;3,0;;2,0;6,0;;7,0;;;;;12,0;19,0;2,0;;1,0;;;;;;1,0;;;;89,0;;1,0;;;1,0;;;;;1,0;;;;10,0;;;2,0;;7,0;16,0;4,0;3,0;1,0;3,0;1,0;;;;51,0;20,0;;;;;;;;4,0;;;11,0;9,0;;1,0;;;;;;;;;;;;2,0;;;8,0;;;;15,0;;;;;;;;;;3,0;;6,0;;;;;;;;;1,0;;4,0;;;;9,0;;2,0;1,0;15,0;;;;;;18,0;;;;;;;;;;;;;;;;90,0;3,0;;1,0;;;3,0;;;;;28,0;;10,0;;;;;;1,0;8,0;7,0;;;;3,0;;;;;;;;;;;;;;;;2,0;;;;;4,0;;;;;2,0;1,0;;217,0;;;;;;3,0;;10,0;;2,0;7,0;2,0;;4,0;15,0;;;;;;;3,0;2,0;1,0;;;11,0;77,0;2,0;;;;;;1,0;;26,0;11,0;2,0;;2,0;;;;;;12,0;2,0;;;1,0;;2,0;;5,0;10,0;;2,0;;1,0;4,0;2,0;;2,0;6,0;;3,0;1,0;;5,0;;;;;2,0;;2,0;;2,0;;;;;;;;;1,0;5,0;;;;;;;;;;;;;;;5,0;6,0;;14,0;;;;19,0;2,0;;2,0;;;3,0;;;1,0;1,0;;16,0;;;2,0;1,0;;9,0;;;;4,0;;7,0;;8,0;;7,0;;2,0;;;;1,0;;2,0;;;;;;;;;;4,0;;;;;;;;;;;;;51,0;;1,0;;;;1,0;;;;;1,0;;;;1,0;1,0;;;18,0;;;35,0;2,0;6,0;7,0;2,0;10,0;;;;;2,0;4,0;2,0;3,0;2,0;3,0;;3,0;;;;4,0;;;;;;;;4,0;;;;;11,0;;22,0;;3,0;;;;;;;;;;;;;;5,0;;2,0;;;;;;;;;;;;;1,0;;;;;;;;;;;;;;;12,0;6,0;;2,0;;4,0;4,0;;;11,0;2,0;;;;;;;5,0;;;;4,0;;;;;3,0;;;;;;;;;;8,0;;;;;;1,0;1,0;;;;;7,0;1,0;;;;6,0;;;;2,0;;;;;;;;;;1,0;12,0;;4,0;;;;2,0;8,0;;;;;;;;;;4,0;;;;
registration;;;5,0;;9,0;;;19,0;8,0;8,0;1,0;;;;;;;;4,0;;1,0;42,0;;;1,0;4,0;;118,0;2,0;7,0;4,0;7,0;9,0;;2,0;;1,0;12,0;1,0;28,0;;;;18,0;;;;;;;;12,0;2,0;8,0;;94,0;6,0;;;1,0;;1,0;66,0;;1,0;;2,0;;;2,0;1,0;5,0;;;;11,0;;17,0;11,0;;;6,0;1,0;;;;1,0;8,0;17,0;36,0;15,0;;2,0;24,0;1,0;1,0;;5,0;10,0;;1,0;9,0;;21,0;;;;111,0;;;1,0;;;;;;;;;;;;;1,0;;;6,0;1,0;;;;;;;;;;;;;;;2,0;74,0;;;;1,0;;;;;4,0;;;;;;;2,0;;;;;;;3,0;2,0;7,0;;21,0;;3,0;;;;;1,0;;;;;;;;;9,0;9,0;;1,0;;;;1,0;;;;;;;;;6,0;1,0;;4,0;;;;4,0;;2,0;;;1,0;5,0;1,0;;;;;;;;1,0;;;;;;;;;;7,0;;;;27,0;;;;;;;;;;;;;;;;;1,0;;;;;1,0;;1,0;;;2,0;;;;;;6,0;;;;;;;;;;;;;;;;20,0;;;;;;;;;;2,0;;;;;;;;;;3,0;;;5,0;;;;;;;;;;;;;6,0;;;;;;;33,0;2,0;;;;;;;;;;;1,0;;;;;1,0;;;;1,0;5,0;;;;;;;;1,0;;;;;5,0;;8,0;;;;;;;1,0;25,0;;;;;;;;1,0;;;;1,0;;33,0;;3,0;;;;;;;;;1,0;;;;;;;2,0;;;;1,0;;2,0;;2,0;15,0;;14,0;;9,0;;;;1,0;;;;;1,0;;;1,0;;;;;;;;;;;;;;;;2,0;6,0;;2,0;;;;;6,0;;4,0;;;;2,0;;;4,0;;1,0;3,0;;;3,0;;;;;6,0;;1,0;3,0;65,0;1,0;2,0;;;2,0;18,0;14,0;;;;6,0;;;;;;;2,0;;2,0;;;;3,0;;;;;;;;;;2,0;;;;;;;;;;;;;;;;;;;;;;;;;;;2,0;;;;;;;27,0;;;;;;3,0;;;;;;2,0;;;4,0;;;;;;3,0;;;1,0;;;;4,0;;;;;;;1,0;;;;;;26,0;;;;;;;;;;;;;;;;;;;;;;;;;1,0;;;;;;1,0;;;;;;;;1,0;;;;;;4,0;;;;;3,0;;;;;;;;;;;3,0;;;;;;;;;;;;;;;;;;;;;;;;;;;;;;;;;;3,0;;;;;;;;;;;;;;;;;;;;;;;;3,0;2,0;;;;;;;;;;;;;;;;;;;;;;;1,0;;;2,0;;;;;;;;;3,0;;;;;;;;;;;1,0;;;;;;;;17,0;2,0;;;;10,0;;;;;;;;;2,0;;;;;;9,0;;;;;1,0;;;;;;;;;;;;;;;;;;;;;;;;;;;;;;;;;;;;;;;;;;;;;;;;;;;;;;;;;;;;;;;;;;;;;3,0;;;;;;;;;;;;;;;;;;;;;;;;;;;;;;;;;;;;;;;;;;;;10,0;;;;;;;;;;;;;;;;;;;;;;;;;;;;2,0;2,0;;1,0;;;;;;;;;;;1,0;;;;;;7,0;;;;;;;;;;;;;;;;;;;;;;;;;;;;;;;;2,0;;;;;;1,0;;;;;;;4,0;;;;;
relationship;;;3,0;;6,0;;11,0;76,0;23,0;3,0;;13,0;2,0;6,0;2,0;2,0;;;2,0;;11,0;2,0;30,0;3,0;4,0;4,0;1,0;14,0;4,0;3,0;1,0;55,0;20,0;;8,0;2,0;1,0;25,0;;18,0;30,0;;;3,0;1,0;4,0;;12,0;17,0;27,0;2,0;4,0;;5,0;2,0;75,0;35,0;;11,0;33,0;7,0;3,0;28,0;1,0;11,0;5,0;3,0;;;1,0;20,0;2,0;;;;;;29,0;29,0;1,0;;;2,0;;;;6,0;;1,0;17,0;10,0;2,0;;10,0;2,0;6,0;;;15,0;1,0;7,0;35,0;;;1,0;;1,0;23,0;;;;10,0;;;;;;;;2,0;;;5,0;;;;10,0;;;2,0;;1,0;;;2,0;1,0;9,0;;;;;;5,0;2,0;3,0;;8,0;2,0;6,0;1,0;;;;;5,0;;;;4,0;6,0;;;2,0;;;;12,0;16,0;4,0;1,0;9,0;4,0;12,0;2,0;;;;8,0;;;;2,0;;;;12,0;1,0;29,0;;9,0;;;;3,0;;;3,0;;3,0;1,0;;2,0;;1,0;;14,0;;;;2,0;;;;;10,0;5,0;1,0;2,0;;;;;5,0;1,0;2,0;;16,0;;;;;;5,0;4,0;1,0;3,0;;20,0;22,0;2,0;;;2,0;;;1,0;;;;;;11,0;;4,0;;1,0;;12,0;1,0;;;9,0;;;;;1,0;;;;;;;;2,0;2,0;;;;;;;1,0;;;2,0;1,0;16,0;;;;;2,0;3,0;;;;;;;;;42,0;2,0;;;;7,0;1,0;;16,0;;;;;;2,0;;;;;;;1,0;;;1,0;;;;2,0;;;;;;1,0;;1,0;4,0;6,0;;;12,0;4,0;;3,0;;;6,0;;;6,0;2,0;;;;1,0;;;8,0;;1,0;;;9,0;;1,0;;;3,0;;5,0;16,0;;9,0;1,0;14,0;;12,0;1,0;3,0;;;1,0;;;2,0;;17,0;;;;;1,0;;;5,0;4,0;;;;;5,0;;6,0;;4,0;1,0;;2,0;;1,0;4,0;;6,0;;;17,0;3,0;2,0;;;2,0;1,0;;;;;11,0;1,0;19,0;;;;;2,0;;;;;;;;2,0;3,0;1,0;;;;;2,0;3,0;;;;;;;;;5,0;;3,0;;;2,0;;7,0;;;5,0;;;;101,0;;;2,0;2,0;1,0;1,0;3,0;;;1,0;1,0;;;5,0;;;13,0;;4,0;5,0;;19,0;;;;3,0;;;1,0;;;;;;;;;;;;;;;;;;4,0;;;1,0;;;;;;;;;;4,0;;;;;;3,0;;;;;3,0;;;;;1,0;;2,0;1,0;1,0;;;;;41,0;;2,0;;;;18,0;;;;;;;;;;;;;;;;2,0;;;;;;;4,0;;;;;;;;;1,0;;;;17,0;;;;;;;;;;;;;;;;;;;;;2,0;;;;;;;;;;6,0;;;6,0;;;;;;;;;;;;;;8,0;3,0;;;;;;;;3,0;1,0;;;;;;4,0;;;;;;;;;;;2,0;;;;;4,0;4,0;10,0;;;;2,0;;;;;3,0;15,0;;;;5,0;2,0;;;;4,0;1,0;;;;1,0;6,0;;;1,0;;;;;;;1,0;;;;;;;;;;;;2,0;1,0;;;5,0;;2,0;;;1,0;;;1,0;7,0;;;4,0;42,0;4,0;;;;5,0;;6,0;;14,0;1,0;2,0;;;;;2,0;;1,0;;3,0;;5,0;;;1,0;2,0;;7,0;7,0;;2,0;;;;6,0;;9,0;;;;;;;;11,0;1,0;;;;2,0;;;;;1,0;;;4,0;;;;;1,0;;7,0;;;7,0;;4,0;;;;2,0;;;;;;;;1,0;;5,0;;;;;;;1,0;;1,0;;;;;;;;;;;;1,0;;;1,0;;;;4,0;;;;;;;;;;;;;;;;;;4,0;;;;;;;;;;;;;;;;4,0;;;;;;;;;;;;;;;5,0;;;;;;1,0;1,0;;;;2,0;3,0;;;;;;;;;;;;;;;;;;;;;;3,0;;;;;;;;;;;;;;;;;;;;;;;;;;1,0;;;;;;;;;;;4,0;;;1,0;;;;3,0;;;;;;17,0;;;;;;
relative;;;22,0;2,0;44,0;;162,0;191,0;65,0;72,0;19,0;2,0;;;14,0;1,0;3,0;;22,0;19,0;1,0;71,0;40,0;5,0;6,0;3,0;;60,0;77,0;63,0;21,0;114,0;141,0;20,0;51,0;6,0;8,0;196,0;35,0;56,0;64,0;;23,0;113,0;2,0;1,0;2,0;9,0;85,0;2,0;6,0;11,0;;32,0;5,0;388,0;38,0;;8,0;333,0;7,0;19,0;119,0;1,0;4,0;3,0;87,0;1,0;;30,0;154,0;8,0;5,0;4,0;;10,0;;57,0;616,0;5,0;18,0;9,0;9,0;2,0;;3,0;30,0;9,0;5,0;48,0;59,0;13,0;3,0;32,0;11,0;13,0;4,0;2,0;2,0;21,0;97,0;86,0;;3,0;2,0;5,0;2,0;94,0;2,0;;5,0;15,0;37,0;50,0;9,0;17,0;10,0;;22,0;148,0;1,0;5,0;38,0;2,0;;;47,0;15,0;5,0;6,0;39,0;4,0;;25,0;1,0;67,0;29,0;2,0;22,0;6,0;12,0;1,0;9,0;9,0;15,0;15,0;16,0;140,0;4,0;1,0;;8,0;13,0;1,0;14,0;33,0;6,0;53,0;35,0;68,0;5,0;5,0;14,0;6,0;5,0;4,0;8,0;49,0;;1,0;281,0;7,0;41,0;68,0;115,0;16,0;15,0;21,0;1,0;4,0;14,0;1,0;3,0;;27,0;28,0;56,0;58,0;2,0;139,0;;4,0;11,0;15,0;;18,0;10,0;;97,0;9,0;;4,0;4,0;43,0;9,0;2,0;18,0;42,0;31,0;96,0;6,0;3,0;9,0;2,0;33,0;40,0;3,0;3,0;;17,0;11,0;37,0;6,0;4,0;9,0;1,0;14,0;1,0;2,0;;1,0;1,0;10,0;7,0;45,0;171,0;1,0;10,0;44,0;7,0;92,0;2,0;20,0;4,0;;11,0;3,0;6,0;2,0;10,0;5,0;;;16,0;1,0;;9,0;15,0;17,0;;;33,0;4,0;4,0;4,0;6,0;13,0;;;;4,0;18,0;10,0;6,0;1,0;12,0;2,0;;8,0;51,0;18,0;4,0;;22,0;1,0;81,0;138,0;195,0;4,0;7,0;8,0;11,0;2,0;6,0;;9,0;;9,0;7,0;;11,0;1,0;35,0;2,0;2,0;1,0;9,0;47,0;12,0;4,0;53,0;8,0;13,0;2,0;20,0;;58,0;11,0;9,0;1,0;2,0;24,0;23,0;36,0;2,0;31,0;;2,0;2,0;6,0;16,0;11,0;;;;;;3,0;;35,0;1,0;18,0;;8,0;3,0;;8,0;2,0;1,0;53,0;15,0;1,0;16,0;;3,0;1,0;3,0;8,0;8,0;;23,0;4,0;1,0;;11,0;6,0;;11,0;4,0;25,0;3,0;2,0;2,0;29,0;3,0;6,0;4,0;;4,0;9,0;8,0;39,0;1,0;3,0;2,0;12,0;1,0;2,0;1,0;1,0;;21,0;44,0;1,0;7,0;20,0;1,0;38,0;16,0;;11,0;;1,0;82,0;30,0;23,0;20,0;3,0;2,0;2,0;5,0;12,0;1,0;4,0;;9,0;13,0;;25,0;5,0;65,0;;;2,0;29,0;;;3,0;;40,0;12,0;3,0;;4,0;;1,0;1,0;5,0;1,0;2,0;2,0;;;1,0;5,0;7,0;3,0;3,0;;;;;40,0;16,0;1,0;;3,0;;3,0;;4,0;;;1,0;1,0;14,0;116,0;;21,0;;;33,0;1,0;;;12,0;12,0;;1,0;;3,0;2,0;3,0;2,0;;179,0;14,0;1,0;;6,0;5,0;;4,0;5,0;25,0;56,0;4,0;9,0;;2,0;2,0;1,0;;5,0;11,0;;4,0;20,0;2,0;10,0;1,0;3,0;;7,0;1,0;1,0;;;;;;10,0;1,0;6,0;;2,0;11,0;;2,0;;;6,0;4,0;1,0;;;12,0;8,0;;;;4,0;1,0;4,0;;4,0;9,0;;;17,0;5,0;1,0;;1,0;1,0;;10,0;1,0;2,0;4,0;65,0;9,0;;10,0;4,0;;;;1,0;;10,0;;;;;;1,0;1,0;;;;;17,0;3,0;;7,0;;;1,0;1,0;;;;;8,0;2,0;;1,0;5,0;;;1,0;5,0;1,0;12,0;6,0;3,0;4,0;4,0;;2,0;;;;;;2,0;;;4,0;;1,0;;2,0;;;2,0;;;;;1,0;16,0;8,0;15,0;;31,0;5,0;23,0;4,0;4,0;;;1,0;;;;1,0;3,0;;6,0;6,0;;;;1,0;3,0;1,0;14,0;13,0;129,0;;;;11,0;1,0;5,0;3,0;;16,0;;3,0;1,0;;15,0;5,0;5,0;2,0;1,0;;;;7,0;4,0;13,0;7,0;;;;;;;1,0;1,0;;2,0;4,0;13,0;9,0;;4,0;;;2,0;;;;;;5,0;;5,0;;13,0;1,0;;2,0;3,0;;1,0;;6,0;8,0;10,0;2,0;;1,0;1,0;;;1,0;;2,0;2,0;2,0;;;2,0;;2,0;12,0;;3,0;5,0;13,0;2,0;18,0;2,0;1,0;;1,0;3,0;;5,0;;;11,0;1,0;1,0;9,0;1,0;2,0;1,0;1,0;6,0;;;1,0;;1,0;14,0;;1,0;;;25,0;6,0;1,0;14,0;5,0;;;1,0;5,0;;6,0;;;1,0;2,0;;10,0;;11,0;4,0;7,0;;1,0;;1,0;8,0;;1,0;6,0;11,0;2,0;4,0;3,0;1,0;;1,0;;4,0;3,0;;1,0;8,0;;3,0;2,0;;2,0;;1,0;;;;;4,0;;1,0;7,0;9,0;14,0;;1,0;;;5,0;;;;5,0;;;;;1,0;;;;9,0;5,0;2,0;;2,0;3,0;1,0;2,0;3,0;1,0;5,0;;;1,0;;10,0;;1,0;1,0;;;;;5,0;;;;;;4,0;;2,0;14,0;3,0;;3,0;;9,0;6,0;;;;;;1,0;;2,0;;;;;1,0;4,0;1,0;;6,0;;3,0;;25,0;1,0;1,0;;25,0;4,0;2,0;;;;3,0;29,0;1,0;;;;;;;4,0;;;;5,0;;;;1,0;;5,0;;;;2,0;;3,0;;1,0;;1,0;;;;;;;7,0;;17,0;;;;;3,0;;;;;3,0;;2,0;1,0;4,0;3,0;;;;1,0;;;1,0;;;;1,0;;3,0;6,0;;;;;;3,0;;10,0;;;;
remain;;;26,0;;7,0;;1,0;9,0;41,0;8,0;4,0;;;;4,0;;;;3,0;3,0;1,0;17,0;1,0;3,0;2,0;;;34,0;17,0;69,0;13,0;34,0;33,0;;21,0;;;4,0;;30,0;9,0;;4,0;26,0;;1,0;;;3,0;;;1,0;;25,0;;128,0;7,0;;5,0;40,0;;;16,0;3,0;;;11,0;;;1,0;17,0;;1,0;;;2,0;;15,0;25,0;7,0;;3,0;1,0;1,0;;;16,0;;1,0;9,0;1,0;2,0;;3,0;;8,0;;15,0;;1,0;20,0;10,0;;3,0;1,0;;;40,0;;;10,0;8,0;10,0;2,0;4,0;;1,0;3,0;;8,0;;;;1,0;;;6,0;11,0;;;2,0;;;;;12,0;1,0;;;4,0;;;;4,0;3,0;;2,0;44,0;;;1,0;;;;;;1,0;3,0;1,0;;;;2,0;;;1,0;79,0;18,0;4,0;1,0;24,0;1,0;4,0;4,0;6,0;4,0;4,0;5,0;;;1,0;;;;;3,0;2,0;26,0;;33,0;;;;3,0;3,0;2,0;;1,0;8,0;;;1,0;;6,0;;;1,0;7,0;5,0;2,0;;;;;2,0;24,0;9,0;;;;;2,0;;2,0;2,0;;1,0;;;;;;;10,0;;1,0;;;47,0;;;;;;;2,0;1,0;;;1,0;3,0;2,0;;4,0;;;1,0;6,0;1,0;;3,0;1,0;2,0;;9,0;;;2,0;;;;3,0;;;;1,0;;;7,0;;;3,0;;1,0;;2,0;5,0;16,0;1,0;;3,0;;3,0;1,0;;1,0;4,0;3,0;;;2,0;;19,0;2,0;5,0;;;2,0;;;11,0;5,0;;;;;;;1,0;;;;5,0;;;;;3,0;4,0;;4,0;;;;;1,0;;;;1,0;;5,0;;6,0;;;7,0;;1,0;3,0;1,0;;2,0;2,0;;1,0;;1,0;;;;;1,0;;2,0;8,0;;;;2,0;7,0;;;6,0;15,0;8,0;;2,0;;2,0;7,0;2,0;;1,0;;;2,0;2,0;;24,0;5,0;1,0;;1,0;;;1,0;7,0;5,0;3,0;5,0;;;1,0;2,0;;4,0;10,0;;;1,0;;3,0;;;;;;;;2,0;;;2,0;27,0;1,0;;;1,0;;1,0;;;;;;;;7,0;64,0;;1,0;;;;11,0;;4,0;6,0;;;1,0;;1,0;;;;;;;;;1,0;2,0;;4,0;9,0;;2,0;1,0;;1,0;2,0;;;;6,0;;;;;;;2,0;1,0;2,0;4,0;1,0;;;;;;15,0;4,0;2,0;;78,0;;;;1,0;;;2,0;2,0;;;;3,0;;;;5,0;2,0;1,0;;;;;;;;;;;1,0;;1,0;;7,0;;4,0;;;;;1,0;;;;2,0;;;;;4,0;;;;;8,0;;3,0;1,0;;1,0;;;3,0;49,0;6,0;;;;;5,0;;;15,0;3,0;;;;;;;;;;;;1,0;;;;;;;;;;;;;9,0;;;;;;;;;;;;3,0;;;;;;;;;;;;;;;;1,0;;;;;;;;;;;;1,0;8,0;;2,0;;;;;;;;;2,0;;;1,0;;;;;;;;1,0;2,0;1,0;;;;;2,0;;;;;2,0;;;;1,0;;;;;;;;2,0;7,0;;1,0;;1,0;;;8,0;4,0;;;;1,0;1,0;6,0;;;;;;;4,0;;;;5,0;4,0;;;1,0;2,0;1,0;;;3,0;;1,0;;;1,0;;;;;1,0;;;;;3,0;;2,0;;;;;;3,0;;;;2,0;;;1,0;3,0;;;;;;;;;;1,0;;1,0;;;1,0;;;;;;2,0;1,0;;;;;4,0;;;;1,0;;;;1,0;;;2,0;;;;;;;3,0;;;1,0;1,0;;;;;;;1,0;;;6,0;11,0;;2,0;;;13,0;;;;2,0;1,0;;;;;;;;;;;1,0;;4,0;;;;;;;;;;;;;;;;;;2,0;;;;;2,0;2,0;1,0;;;3,0;;;2,0;2,0;;;2,0;;;;;;;;;;;;;;;;;;;;;;;1,0;;;;;;;;;;;;;;;;;;;;;2,0;;;;9,0;;;;2,0;;;;;3,0;;;;;;1,0;;;;;;;;;;;;;;;3,0;;;1,0;;;;;;;;4,0;;;;;;1,0;;;;;;;16,0;;;;;;;;;;;;;;;;;;;;;;4,0;;;;;;;;;
remove;;;8,0;;15,0;;1,0;2,0;4,0;6,0;;;;1,0;11,0;1,0;;2,0;22,0;2,0;2,0;7,0;;2,0;1,0;3,0;3,0;20,0;4,0;18,0;4,0;11,0;37,0;5,0;30,0;;2,0;;;14,0;;18,0;1,0;10,0;3,0;;3,0;;3,0;1,0;3,0;11,0;;1,0;;136,0;28,0;;2,0;45,0;;;60,0;;2,0;;1,0;;1,0;16,0;31,0;1,0;20,0;1,0;1,0;;;2,0;32,0;10,0;;11,0;9,0;4,0;;4,0;14,0;;;5,0;12,0;4,0;;26,0;1,0;;;2,0;1,0;10,0;6,0;28,0;;6,0;;3,0;2,0;41,0;;;1,0;1,0;2,0;12,0;6,0;1,0;;;3,0;12,0;;;;19,0;7,0;;8,0;;1,0;4,0;16,0;2,0;;;;;2,0;1,0;3,0;;;1,0;1,0;;40,0;2,0;26,0;42,0;;;;1,0;3,0;1,0;;26,0;5,0;8,0;5,0;13,0;1,0;1,0;;3,0;;9,0;7,0;43,0;2,0;10,0;12,0;;10,0;12,0;2,0;11,0;1,0;9,0;;;;2,0;2,0;;;2,0;;14,0;1,0;26,0;4,0;;;2,0;;2,0;1,0;;;;3,0;1,0;;1,0;;4,0;2,0;;1,0;8,0;;1,0;;;1,0;7,0;;4,0;;;;2,0;5,0;;4,0;8,0;7,0;;;;3,0;;;2,0;;1,0;;10,0;40,0;;1,0;;4,0;;3,0;;2,0;2,0;;;17,0;;1,0;14,0;;;;;1,0;2,0;;;5,0;;;4,0;7,0;;2,0;;;2,0;2,0;;22,0;;2,0;;;1,0;;;3,0;6,0;3,0;5,0;9,0;20,0;1,0;;;;;10,0;;;;10,0;;;1,0;;7,0;;5,0;2,0;;3,0;;2,0;;;;8,0;5,0;;;;;;;4,0;;;;7,0;;3,0;4,0;;8,0;;;;;;1,0;;;;;11,0;;1,0;1,0;;;5,0;;2,0;1,0;1,0;4,0;;;;;;;;1,0;;2,0;1,0;5,0;;;;3,0;4,0;;;;3,0;3,0;4,0;;47,0;;;1,0;2,0;1,0;;;;1,0;2,0;1,0;3,0;;1,0;3,0;;6,0;;;13,0;2,0;;;;;;2,0;;;1,0;;;3,0;5,0;;;;14,0;7,0;;1,0;2,0;2,0;;;2,0;11,0;;;;;1,0;1,0;1,0;;;;;;;;4,0;1,0;;;;;6,0;;2,0;;;;;1,0;2,0;;;;;2,0;;;2,0;1,0;2,0;;2,0;8,0;;2,0;;;9,0;;;;;;;;;;;;;;7,0;;1,0;;;;1,0;1,0;;26,0;1,0;;11,0;;;;;1,0;;2,0;;;;;;3,0;1,0;;5,0;4,0;;;;;;;;;2,0;;;9,0;;;;;;2,0;2,0;;;;2,0;;;;1,0;2,0;4,0;2,0;;;;;;;4,0;5,0;;;8,0;4,0;;;8,0;29,0;;;;;;1,0;;;;;5,0;;;;;1,0;;;;;;;;;;;;;;;1,0;;;;6,0;;;1,0;;;;2,0;;;;1,0;1,0;;;;1,0;;;;;;4,0;;;3,0;;;4,0;;;;;2,0;;;13,0;;;;;2,0;;;;2,0;;1,0;;;;1,0;;2,0;2,0;1,0;22,0;2,0;;;4,0;;;;1,0;2,0;;;2,0;1,0;;1,0;;;;;;;;;;4,0;;;;13,0;17,0;3,0;;4,0;2,0;;;;;;2,0;;;;;10,0;;;;1,0;;;;;;;;;9,0;;2,0;;;;;11,0;2,0;;5,0;1,0;;1,0;;;;;;1,0;;;;;;;;;;1,0;;;;;1,0;;2,0;;;;;;;;;;;;;;;;;4,0;;;;;;;2,0;;;1,0;;;4,0;5,0;2,0;;;;;;;;;;;;;;;;2,0;;2,0;;1,0;;4,0;;;;3,0;;;;;1,0;;;;2,0;;;;1,0;;;2,0;;;;;;3,0;1,0;;;;;;1,0;;;3,0;;;;;2,0;;;;;1,0;;;2,0;;;;;;2,0;;8,0;;9,0;;;;;3,0;;;;;;;2,0;;;;;;2,0;;;;;;;;;;;;6,0;;;;;;;;;;;2,0;;;;;;;;;;;;1,0;2,0;;;;;;;;;;;;;4,0;;;;;;;;5,0;;;;;;;;;;;;;;;1,0;;3,0;;1,0;3,0;;1,0;1,0;;;;;;;;;;;4,0;1,0;;;;;;1,0;;;1,0;;;;;;;;;;;;;;;;;;;;;;
repeat;;;1,0;1,0;3,0;;1,0;4,0;2,0;7,0;3,0;;;;7,0;;;4,0;1,0;4,0;;2,0;;1,0;;;;10,0;;3,0;2,0;13,0;3,0;;;;;5,0;;19,0;2,0;;;;;3,0;6,0;1,0;4,0;3,0;1,0;2,0;;1,0;2,0;51,0;9,0;;7,0;4,0;;;33,0;;;;2,0;;;25,0;5,0;3,0;2,0;;;;;14,0;4,0;;;3,0;;;1,0;;4,0;;;12,0;;1,0;2,0;4,0;;;;;3,0;;;10,0;;11,0;;1,0;;10,0;;;4,0;5,0;9,0;;;;;3,0;;;;;;;;;1,0;;;;1,0;;8,0;;;;5,0;;2,0;;;;;1,0;;;1,0;21,0;;;10,0;;;;;;1,0;;2,0;7,0;;1,0;;;;3,0;3,0;2,0;1,0;;;;;;1,0;;;1,0;;;;;;;;1,0;;25,0;;2,0;;;1,0;10,0;;;;;;;;;;1,0;;;;;;;1,0;;;;;13,0;2,0;;;;6,0;;;;;;1,0;;;;;;2,0;;5,0;;;1,0;19,0;4,0;1,0;;;;;;2,0;;;;3,0;;;4,0;;;;1,0;3,0;;1,0;;;;;;;;;;;;;;;;;;;;;;;2,0;;4,0;;3,0;2,0;;;;;28,0;;;;2,0;;;;;14,0;;;;;5,0;;;1,0;;;;;;;;;;;5,0;;;;1,0;;;;;2,0;;;;;3,0;1,0;;;;;3,0;;;;;2,0;;;2,0;1,0;2,0;5,0;;;;7,0;;;;3,0;;;;7,0;;;;;;;;;9,0;;4,0;3,0;;;;8,0;;1,0;6,0;;;1,0;1,0;;15,0;;2,0;;;1,0;;;17,0;2,0;;5,0;;;;;;;;1,0;;;2,0;;;;2,0;1,0;;;;7,0;;;;3,0;;;2,0;;4,0;9,0;;;;;;;;;;5,0;2,0;;;2,0;3,0;;;;;;;9,0;5,0;;;;;1,0;;;;1,0;2,0;;;1,0;1,0;2,0;;;4,0;;;;;17,0;;;1,0;;;;;;;;;;2,0;;;;4,0;8,0;3,0;;;;;;3,0;;1,0;;;;;;;;;;2,0;;;;10,0;;;;;;;;;1,0;;;;;;;;;6,0;;2,0;;;;;;;;;;;;;;;;;;;;;;;29,0;;;;;;;;;;;;;;;;;;;2,0;;;2,0;4,0;;1,0;;;;1,0;;;;1,0;4,0;2,0;;;;;;;6,0;;;;;;;1,0;;;;;;;;;;;1,0;;;;;;;;;;;;;4,0;;;;;;;;6,0;;;;;1,0;;;;;4,0;;;;;;;;;;;;;;;;;;;;;;;;;;;;;;;1,0;2,0;;;;5,0;1,0;;;;;;;;;1,0;2,0;;3,0;;1,0;;;1,0;;;;12,0;;1,0;;10,0;5,0;;;;;;6,0;;;;;1,0;;1,0;;1,0;1,0;1,0;1,0;1,0;;;;;;;;;;2,0;;;1,0;1,0;;;;;;;2,0;;;1,0;1,0;;;;;;;;;;;9,0;3,0;;;;;;1,0;1,0;;;1,0;;;2,0;;;10,0;;;;1,0;;;;;;;;;;;;;;;;;1,0;;;;;;;;;;;;;;;1,0;;;;;;;;;2,0;;;;;;;;;;;;;;2,0;;;;;;;;;;;;;;;;;1,0;;;;;;;;;;;;;;;;;;;;;;;;;;;;;;;;;;;;2,0;;;;;;;;;;;;;;;;3,0;;;;;;;;;2,0;;4,0;;;;;1,0;6,0;;;2,0;;;;;;;;;1,0;;;;;;;;;;;;;;;;;;;1,0;1,0;;;;6,0;;;;1,0;;;;;;;;;;;;1,0;;;;;;;;;;;;;;;;
representative;;;5,0;;6,0;;;14,0;3,0;21,0;;3,0;;7,0;29,0;;;;1,0;1,0;;11,0;1,0;;5,0;;;111,0;;4,0;3,0;20,0;14,0;5,0;22,0;;;;;6,0;;;;3,0;;;;3,0;;;3,0;26,0;;1,0;;174,0;31,0;;;1,0;;;16,0;;;;;;;2,0;5,0;;;;;4,0;;38,0;28,0;1,0;;9,0;13,0;7,0;;;10,0;;5,0;28,0;6,0;;;86,0;;;;2,0;10,0;;;8,0;;3,0;;;1,0;5,0;;;3,0;2,0;2,0;;;;;;;1,0;;;;2,0;;;7,0;;;;;;;;;26,0;;;;8,0;;;2,0;;;;5,0;17,0;;;;;;;;;;;5,0;2,0;;;;;;;5,0;52,0;2,0;;;;4,0;;;;;28,0;;;1,0;;;;;;;44,0;;6,0;;;3,0;19,0;2,0;2,0;;;;;;;;;;;;;;;;;;;;9,0;21,0;;;;1,0;4,0;;;;;;;;;;;;;;;;;8,0;;;;7,0;;;;;;;;1,0;;;;1,0;2,0;;;;;3,0;;;;;;;;;;;;;;;;;;2,0;4,0;;;;;;9,0;;3,0;3,0;;1,0;;;4,0;;;;;;;;;2,0;;;;;;;;5,0;7,0;;;;;;;;;;2,0;;;;6,0;;;;;4,0;;;;;;;;;;;3,0;;;;;2,0;;;;;;5,0;;;;;;;;;;;;;2,0;;;;;;;10,0;8,0;2,0;4,0;;;;;2,0;;;;4,0;12,0;;;;1,0;;1,0;;;;;;4,0;6,0;;5,0;;;;1,0;;;;;;1,0;;;;;1,0;7,0;;28,0;;;;5,0;1,0;6,0;;;3,0;;7,0;4,0;;;;;;;;;;;;;;1,0;3,0;1,0;2,0;2,0;;;;6,0;1,0;;;;;3,0;;;;;;;;;1,0;;;;2,0;;;;;17,0;3,0;;;;3,0;;;1,0;;;3,0;;4,0;;;9,0;;1,0;13,0;;;;;;2,0;;;;;;;;;;;;;;;;4,0;;;;;2,0;25,0;;;2,0;;;2,0;;;;;1,0;;;;;;;1,0;;;;1,0;;;;;3,0;;;;2,0;;2,0;;;2,0;53,0;;;;;;3,0;;;;;;;;;;;;;;;1,0;6,0;;;;;1,0;1,0;;;;;;;;;;;;;;3,0;;;;;1,0;;;;;;;;;2,0;;;;;;;;;;;;1,0;;;;;;;;;;;;;;;;;;;;;;2,0;;;;;;;;;;1,0;;;;;;;;;;;;;;;;;;;;;;;2,0;;;;;;;;4,0;;;;;;;;6,0;;2,0;;;;;;;;2,0;;;;;;;;;;;;;;4,0;;;1,0;;;;;;2,0;;;;;;;;34,0;;;;1,0;;2,0;31,0;;;;;;;;2,0;;;3,0;;;;;;;;;3,0;;;3,0;;;;;2,0;8,0;;;;;;;;;;;;;;;;;1,0;3,0;;;;;;;;;;;;2,0;;;;;;;9,0;;;4,0;;;;;1,0;;;;;;;1,0;9,0;;;3,0;;;2,0;;;;;;;;;;;;;;;;;;;;;;;;;;;;;;;;;;;;;;;;;;3,0;;;;;;;;;;;;;;;;;7,0;;2,0;;1,0;;;;;;;;;;;;;;;;;;2,0;;;;;;;;;;;1,0;5,0;;4,0;;;;;;;;;;;;;9,0;;;;;;;;;;1,0;;;;;;;;1,0;;;;;;;;;;;;;;;;;1,0;;;1,0;;;;;;1,0;;;;;;;;;;;;
resilient;;;2,0;;7,0;;5,0;2,0;;;;4,0;;;;2,0;;;;;;1,0;;;;;;;2,0;;;;6,0;;;;;9,0;;2,0;5,0;;;61,0;;;;;;2,0;;4,0;;3,0;;3,0;15,0;;;29,0;1,0;;1,0;;;;4,0;;;;3,0;;;1,0;4,0;;3,0;;8,0;7,0;;;;;;;;;;3,0;1,0;;;;;5,0;;;;;10,0;3,0;;;;;1,0;;;16,0;4,0;7,0;;;2,0;;;;;10,0;;;;;;;9,0;4,0;;3,0;8,0;;;4,0;4,0;;7,0;;;;;;;2,0;;9,0;21,0;3,0;;;;1,0;2,0;;2,0;3,0;6,0;4,0;;;;2,0;9,0;;;;;;;14,0;113,0;8,0;19,0;9,0;;6,0;2,0;;;;;1,0;2,0;;1,0;;3,0;24,0;;49,0;;;;5,0;;;;;13,0;2,0;;9,0;2,0;;;;;3,0;16,0;7,0;;2,0;;;;;;;;;1,0;;1,0;;2,0;;;;;;2,0;2,0;3,0;1,0;;;8,0;3,0;;;12,0;1,0;;2,0;;;;;;11,0;;1,0;16,0;18,0;;;;;;2,0;;1,0;3,0;2,0;1,0;2,0;;;1,0;;1,0;1,0;;;2,0;;;;2,0;4,0;3,0;;;4,0;;;3,0;;;;;;;;;;;;1,0;;;;6,0;2,0;3,0;2,0;;;1,0;3,0;;11,0;;;40,0;;;;1,0;4,0;;;11,0;;;;;6,0;1,0;;;;;;;;;;;;1,0;4,0;;;;;;;;;;;;;;;;;;;;;;;;;;;;;;;;;;3,0;;;;;;;;;;;;;;;4,0;;4,0;;;;;;;;;;1,0;;;;;;;;;6,0;;;;;;;;;;;;;;;;;2,0;;;;;;;;;;;;;;;;1,0;;6,0;;;;;;;4,0;;;;;;;;;;;;;;;;;;;;;;;;14,0;;;;;;;;1,0;;;;;;;2,0;;;4,0;;;;;;;;;;;;;;;;;;;13,0;;2,0;;;;1,0;2,0;1,0;;;;;;;;;;;;;;;;;;;;;5,0;;;;;;;;;3,0;;;1,0;;;;;;;;;1,0;;;;2,0;;;;;;;;4,0;;;;;;;;;11,0;10,0;;;;;1,0;;;;;;;;;;;;;;;;;1,0;;;;;;;;1,0;;;;;;;;;;;;2,0;;;;;;;1,0;;;;;;;;;;;;;;1,0;;;;1,0;2,0;6,0;4,0;2,0;;;;;;;;;;;;;;;;;;;;;;;;;;;;;;;;;;;1,0;;;;;1,0;;;;;;;;;;;;;;1,0;;;;;;;;;;;;;;;;;;;;;;;;;;;;;;;;;;;;;;;;;;;;;;;6,0;;;;;;;;;;;;;;;;;;;;;;;;;;;;;;;;;;;;;;;;;;;;;1,0;;;;;;;;;;;;;;2,0;;;;;1,0;;;;;;;;;;;;;2,0;;;;;;;3,0;;;;;;;;2,0;;;;;;;;8,0;;4,0;;;;;;;;;;;;;;3,0;;;;3,0;;;;;;;7,0;;;;;;;;;;;;;;;;;1,0;;;;;;;;;;;;;;;;;;;;;;;;;;;;;;;;;;;;;;;;;;;;;;;;;;1,0;;;;;;;;;;;;;;;;;;;;;;;;;;;;;;;;;;;;;;;;;;;;;;;
resin;;;2,0;;2,0;1,0;;10,0;;;1,0;;;;;;;;1,0;2,0;1,0;;;;;;;;;;;;51,0;;6,0;;;2,0;;10,0;2,0;;;25,0;;;1,0;;;;;;;4,0;;13,0;31,0;;;53,0;;;6,0;;;36,0;;;;1,0;61,0;;;;1,0;;;;2,0;;4,0;1,0;;;1,0;;;;;;;;;1,0;2,0;4,0;1,0;;;15,0;47,0;5,0;;;;;6,0;11,0;1,0;;;;;1,0;1,0;;;;;3,0;4,0;;;;2,0;;2,0;14,0;;;11,0;;;;;;1,0;;2,0;4,0;;;1,0;;5,0;;61,0;5,0;;;;17,0;1,0;19,0;2,0;5,0;3,0;8,0;;4,0;;;;3,0;;45,0;;17,0;;82,0;29,0;2,0;15,0;11,0;;1,0;1,0;2,0;1,0;;;1,0;2,0;;;2,0;3,0;;;17,0;;1,0;;;;1,0;1,0;1,0;;;13,0;;4,0;13,0;;;2,0;;1,0;11,0;;;;2,0;;1,0;;22,0;;2,0;4,0;;;;;1,0;;;;;;;;;;;;2,0;3,0;;;;;1,0;;1,0;;3,0;;;;;;1,0;;;;;;1,0;;;;;;;;;;1,0;1,0;;;1,0;;;;;;4,0;;;;;27,0;;;;1,0;;;;;;;;;;;;2,0;;;;;4,0;;;;8,0;;;;;;;;1,0;;16,0;;;;;;;;;;;;;;;;;;;;;;;;;;;;;;;1,0;;;1,0;;;;;3,0;;;;;;;;;;1,0;;;;;;;;;;;;;4,0;;;;;;;;;;;;;5,0;;;;;;;;;1,0;;;;;;;;3,0;;;;1,0;;;;2,0;;;;;;;;;;;;;;;;;;;;;1,0;;;;;;;;;;;;;;;;;;;;;;;;;;2,0;;;;;4,0;;;5,0;;;;;;;;;;;;;;;;;;10,0;;;;;;;;;;;;;;;;;;4,0;;;;1,0;1,0;;;;;;;;;;;;;;4,0;;;2,0;;;;;;;;;;;;;;;;;;;;13,0;;;;;;;;;;;;;;;;1,0;;;;;;;;;;;;;;;;;;;;;;;9,0;;;1,0;;;;;;;1,0;;;;;;;;1,0;;;;;;;;;;;;;;;;;;;;;;3,0;;;;;;;;;;;1,0;;1,0;;;;;;;35,0;;;;;1,0;;;;;;;;;1,0;;;;;;;;5,0;1,0;;1,0;4,0;;;;;;;;;2,0;;;;;;;;;;4,0;;1,0;;;;;;;;;;;1,0;;;;;;;;;;;2,0;;;;;;;;;;;;;;;;;;;;;;;;;;;;1,0;;;;;;;;;;;;;;;;;7,0;;;;;;;;;;;;;;;;;;;;;;;;;;;;;;;;;;;;;;3,0;;;;;;;;;;;;;;;;;;;;;;;;;1,0;;;2,0;;;;1,0;;;;;;;3,0;;;;;;;;3,0;;;;;;;;;;;;;4,0;;;;;;1,0;6,0;;;;;;;;;;;;;;;20,0;2,0;;;;;1,0;;;1,0;10,0;;;;;;;1,0;;;;;;;;;;;;;;;;;;;;;;;;;;;2,0;;;;;;;;;;;;;;;;;;1,0;13,0;;15,0;;;4,0;;1,0;;;;;;;;;;;5,0;;;;;;;;;;;;;;;;;;;;2,0;;;;;;;;;;;;;
respective;;;33,0;;18,0;;39,0;67,0;41,0;52,0;19,0;7,0;2,0;11,0;56,0;20,0;1,0;;13,0;6,0;5,0;85,0;20,0;2,0;14,0;1,0;1,0;112,0;1,0;25,0;17,0;79,0;69,0;19,0;49,0;9,0;1,0;20,0;3,0;49,0;50,0;1,0;18,0;118,0;;11,0;1,0;16,0;12,0;24,0;25,0;36,0;7,0;9,0;1,0;551,0;58,0;5,0;32,0;118,0;7,0;1,0;81,0;;2,0;7,0;5,0;;3,0;26,0;64,0;6,0;31,0;3,0;;5,0;8,0;66,0;81,0;8,0;;13,0;18,0;23,0;7,0;7,0;68,0;4,0;8,0;19,0;97,0;4,0;12,0;97,0;24,0;13,0;;5,0;53,0;6,0;24,0;73,0;;35,0;2,0;1,0;24,0;90,0;6,0;;3,0;17,0;44,0;10,0;11,0;;5,0;8,0;10,0;16,0;;;17,0;18,0;;2,0;41,0;15,0;10,0;14,0;6,0;;;;;3,0;22,0;;20,0;13,0;2,0;3,0;6,0;11,0;47,0;4,0;67,0;93,0;5,0;;5,0;;6,0;;9,0;10,0;25,0;1,0;11,0;31,0;31,0;6,0;1,0;1,0;;14,0;8,0;131,0;5,0;2,0;32,0;4,0;42,0;29,0;14,0;4,0;;46,0;1,0;;2,0;;7,0;;6,0;18,0;15,0;219,0;2,0;90,0;1,0;1,0;10,0;62,0;2,0;2,0;1,0;11,0;4,0;7,0;;10,0;2,0;26,0;1,0;;7,0;2,0;8,0;20,0;3,0;8,0;2,0;6,0;2,0;32,0;28,0;7,0;;;9,0;13,0;;;6,0;4,0;10,0;;;1,0;;;2,0;27,0;11,0;27,0;5,0;9,0;59,0;5,0;6,0;2,0;13,0;7,0;;;15,0;15,0;1,0;7,0;13,0;6,0;10,0;50,0;11,0;;4,0;19,0;;1,0;5,0;18,0;7,0;3,0;5,0;2,0;6,0;;;1,0;;2,0;;2,0;11,0;21,0;38,0;;2,0;20,0;3,0;2,0;1,0;10,0;;33,0;10,0;56,0;1,0;8,0;;8,0;3,0;16,0;;;5,0;9,0;3,0;3,0;;3,0;35,0;5,0;4,0;1,0;2,0;10,0;2,0;5,0;23,0;;3,0;4,0;3,0;9,0;4,0;;3,0;;4,0;11,0;8,0;;;5,0;1,0;2,0;18,0;2,0;31,0;5,0;13,0;2,0;;1,0;;1,0;5,0;;12,0;32,0;1,0;9,0;6,0;;;5,0;4,0;16,0;2,0;;3,0;1,0;;5,0;2,0;;;;13,0;12,0;;3,0;26,0;16,0;6,0;8,0;20,0;6,0;;2,0;4,0;12,0;5,0;19,0;10,0;5,0;;8,0;6,0;10,0;12,0;4,0;12,0;4,0;10,0;12,0;2,0;41,0;;7,0;;;7,0;1,0;10,0;7,0;20,0;4,0;22,0;;;;3,0;3,0;3,0;9,0;;2,0;7,0;3,0;3,0;7,0;12,0;;14,0;;15,0;;47,0;1,0;;2,0;18,0;1,0;20,0;13,0;9,0;16,0;19,0;1,0;1,0;;;1,0;9,0;;;;5,0;;;4,0;6,0;18,0;5,0;13,0;5,0;2,0;;3,0;41,0;5,0;;;1,0;;9,0;;;6,0;7,0;1,0;;1,0;10,0;;13,0;5,0;;15,0;4,0;;;;14,0;1,0;;;11,0;;;1,0;;3,0;7,0;2,0;1,0;6,0;;11,0;4,0;2,0;52,0;60,0;3,0;15,0;1,0;1,0;3,0;1,0;2,0;2,0;9,0;3,0;;2,0;;1,0;7,0;;;26,0;21,0;9,0;3,0;4,0;;;;9,0;12,0;1,0;;20,0;1,0;3,0;1,0;1,0;;;6,0;1,0;15,0;;;2,0;2,0;1,0;1,0;14,0;;4,0;1,0;;3,0;1,0;1,0;;10,0;5,0;;;2,0;7,0;3,0;3,0;;42,0;188,0;8,0;;;8,0;;8,0;;2,0;4,0;6,0;;1,0;8,0;;3,0;4,0;;2,0;2,0;8,0;17,0;5,0;2,0;;6,0;;2,0;;;1,0;5,0;4,0;3,0;8,0;22,0;;;;7,0;;3,0;17,0;;;;;3,0;;1,0;;10,0;4,0;;;;;;1,0;;2,0;4,0;6,0;10,0;5,0;;;1,0;2,0;1,0;;23,0;;6,0;6,0;6,0;9,0;;2,0;;1,0;3,0;1,0;10,0;1,0;12,0;;;41,0;;4,0;16,0;;1,0;3,0;;4,0;;13,0;1,0;5,0;3,0;;;;;;;1,0;2,0;8,0;;;1,0;17,0;1,0;6,0;9,0;;7,0;;2,0;24,0;53,0;6,0;1,0;;;8,0;;;9,0;2,0;;29,0;;1,0;12,0;2,0;;13,0;;1,0;;5,0;3,0;19,0;;;7,0;5,0;5,0;;5,0;10,0;2,0;11,0;3,0;2,0;;;1,0;;2,0;2,0;;;3,0;2,0;1,0;;;14,0;;4,0;;2,0;2,0;3,0;;34,0;1,0;;10,0;5,0;4,0;;13,0;;1,0;1,0;5,0;1,0;4,0;2,0;2,0;;2,0;11,0;7,0;2,0;8,0;;4,0;7,0;;;13,0;7,0;4,0;9,0;9,0;1,0;;1,0;;13,0;1,0;1,0;1,0;;;2,0;4,0;;;5,0;3,0;;;;;;1,0;6,0;3,0;;;;;;;;;;18,0;2,0;;17,0;14,0;4,0;10,0;1,0;10,0;;;;;1,0;2,0;15,0;1,0;3,0;;;1,0;2,0;5,0;1,0;;2,0;2,0;19,0;;3,0;1,0;;;3,0;;2,0;1,0;2,0;9,0;;24,0;;;6,0;;2,0;;9,0;8,0;2,0;;19,0;8,0;2,0;;;3,0;1,0;;;;;;1,0;;;;1,0;;1,0;;2,0;;;2,0;2,0;;2,0;3,0;3,0;1,0;;3,0;;;;;4,0;21,0;;;;1,0;6,0;;;;4,0;4,0;;;;;1,0;;6,0;;2,0;1,0;1,0;3,0;1,0;;;;7,0;37,0;;1,0;1,0;12,0;1,0;4,0;6,0;;7,0;4,0;;1,0;;;;;;;;;;5,0;3,0;;5,0;4,0;;;1,0;5,0;;;;5,0;2,0;;;6,0;;;;;;;;2,0;;;;;;;;;;;2,0;;;1,0;;;;;;7,0;;16,0;;23,0;;;6,0;1,0;;;;
response;;;24,0;5,0;42,0;;18,0;25,0;11,0;71,0;6,0;24,0;;2,0;17,0;;4,0;;14,0;16,0;11,0;101,0;8,0;8,0;1,0;;6,0;108,0;5,0;82,0;45,0;65,0;150,0;5,0;59,0;1,0;5,0;36,0;3,0;130,0;6,0;1,0;32,0;35,0;;8,0;;7,0;25,0;12,0;58,0;91,0;2,0;;;382,0;38,0;;4,0;51,0;2,0;11,0;92,0;;9,0;22,0;22,0;2,0;8,0;152,0;33,0;6,0;12,0;;;3,0;4,0;19,0;87,0;35,0;;33,0;15,0;7,0;;;7,0;2,0;4,0;54,0;35,0;14,0;8,0;257,0;7,0;5,0;2,0;8,0;28,0;1,0;13,0;60,0;;18,0;1,0;29,0;11,0;79,0;;;4,0;1,0;2,0;10,0;;;1,0;;;10,0;;1,0;17,0;8,0;;;11,0;4,0;;;1,0;1,0;3,0;2,0;3,0;11,0;1,0;;;11,0;;5,0;22,0;6,0;43,0;20,0;34,0;57,0;;;;;;1,0;4,0;1,0;;;9,0;76,0;5,0;6,0;1,0;2,0;2,0;1,0;36,0;62,0;1,0;;33,0;9,0;16,0;9,0;58,0;6,0;;68,0;;4,0;3,0;3,0;1,0;3,0;2,0;1,0;1,0;82,0;;25,0;;;6,0;129,0;;1,0;;;35,0;;3,0;5,0;;4,0;;1,0;;;13,0;8,0;;4,0;10,0;;18,0;49,0;27,0;4,0;;1,0;4,0;7,0;2,0;2,0;;15,0;6,0;;;;;6,0;10,0;;37,0;7,0;;14,0;72,0;2,0;15,0;;2,0;;;3,0;;;;8,0;2,0;;;1,0;;1,0;;15,0;6,0;;3,0;24,0;15,0;1,0;;1,0;;1,0;;1,0;;7,0;;3,0;;21,0;9,0;2,0;;12,0;10,0;;3,0;17,0;;57,0;32,0;28,0;14,0;;1,0;;;7,0;;6,0;;31,0;;1,0;13,0;;58,0;3,0;1,0;;1,0;11,0;;;6,0;7,0;1,0;;;;1,0;;;;;12,0;;1,0;;20,0;;2,0;8,0;3,0;169,0;11,0;1,0;8,0;;5,0;;;4,0;6,0;;10,0;;3,0;2,0;2,0;;;;48,0;3,0;94,0;14,0;;;3,0;2,0;3,0;;;16,0;2,0;3,0;4,0;15,0;18,0;9,0;1,0;7,0;;;1,0;3,0;2,0;14,0;10,0;;3,0;;3,0;9,0;6,0;;10,0;7,0;13,0;10,0;14,0;;24,0;32,0;;4,0;3,0;42,0;5,0;37,0;17,0;25,0;12,0;8,0;;;;2,0;;7,0;22,0;10,0;19,0;;;;3,0;;20,0;12,0;;111,0;3,0;7,0;2,0;7,0;15,0;75,0;1,0;2,0;45,0;;38,0;9,0;3,0;;3,0;1,0;;8,0;2,0;1,0;1,0;37,0;8,0;2,0;1,0;5,0;19,0;3,0;;8,0;11,0;;17,0;19,0;18,0;;1,0;7,0;;106,0;;;8,0;2,0;1,0;4,0;12,0;14,0;9,0;17,0;2,0;;42,0;;1,0;3,0;6,0;7,0;3,0;4,0;5,0;4,0;5,0;74,0;1,0;;14,0;13,0;47,0;2,0;32,0;3,0;60,0;21,0;9,0;51,0;38,0;;21,0;;2,0;1,0;4,0;3,0;5,0;9,0;;;;;;;;6,0;4,0;32,0;5,0;5,0;2,0;2,0;;;;16,0;1,0;5,0;18,0;9,0;;3,0;2,0;3,0;1,0;2,0;;5,0;18,0;2,0;2,0;;3,0;;8,0;7,0;;;;;4,0;3,0;4,0;7,0;;1,0;6,0;9,0;;;;1,0;8,0;71,0;6,0;1,0;;;3,0;21,0;3,0;;;;7,0;20,0;6,0;;;;4,0;;;;;23,0;1,0;2,0;11,0;;3,0;3,0;19,0;3,0;;;;;11,0;1,0;;;1,0;;;60,0;;;;;2,0;;4,0;;1,0;4,0;;;;11,0;;;;13,0;;5,0;1,0;;;;;12,0;;;7,0;3,0;20,0;1,0;;11,0;2,0;;;;2,0;;;2,0;6,0;;1,0;;;3,0;;;;;1,0;;;;3,0;15,0;;;2,0;;1,0;1,0;;1,0;;12,0;;;;19,0;2,0;;;;;;;;4,0;4,0;;;1,0;21,0;;1,0;18,0;4,0;;3,0;;;12,0;3,0;7,0;13,0;2,0;;;2,0;3,0;;1,0;1,0;7,0;;1,0;2,0;5,0;;2,0;;11,0;4,0;;;20,0;;10,0;;2,0;3,0;;;;2,0;17,0;5,0;2,0;;24,0;;;3,0;;1,0;;;2,0;7,0;;;1,0;1,0;6,0;1,0;5,0;;2,0;;2,0;10,0;4,0;4,0;2,0;1,0;5,0;3,0;1,0;22,0;;;;3,0;2,0;46,0;;4,0;;;;7,0;;11,0;;3,0;;;6,0;1,0;;2,0;;;;2,0;3,0;14,0;10,0;13,0;;16,0;;;;;2,0;4,0;2,0;;7,0;;4,0;;;12,0;2,0;1,0;1,0;;2,0;3,0;;;2,0;13,0;1,0;;;3,0;;;;8,0;5,0;4,0;1,0;2,0;4,0;6,0;;4,0;4,0;3,0;8,0;11,0;;;2,0;1,0;2,0;;3,0;;4,0;1,0;4,0;11,0;;;2,0;2,0;9,0;1,0;3,0;;;2,0;;;;4,0;;1,0;;;;1,0;;1,0;;14,0;;;4,0;6,0;;;;;2,0;;;2,0;1,0;;;2,0;5,0;1,0;;4,0;;1,0;;;2,0;;;;;;;;;18,0;2,0;;15,0;2,0;;1,0;;;;1,0;1,0;;4,0;4,0;;;47,0;2,0;1,0;7,0;;;;4,0;2,0;;;;;;;2,0;;3,0;;3,0;;;1,0;;;;;;;;;;;;8,0;7,0;;;;;;3,0;4,0;;2,0;5,0;;;;2,0;;;1,0;;1,0;;;;;;8,0;1,0;;4,0;;;;;;;;;
responsive;;;7,0;2,0;5,0;;1,0;;2,0;30,0;;4,0;;1,0;;;;1,0;;1,0;;47,0;;1,0;1,0;;;21,0;;9,0;20,0;37,0;40,0;;10,0;;1,0;1,0;;16,0;5,0;;;15,0;;1,0;;1,0;27,0;2,0;;14,0;;;;56,0;1,0;;7,0;17,0;;2,0;7,0;;;;3,0;;2,0;6,0;15,0;;;;;;;9,0;12,0;3,0;;8,0;21,0;2,0;;;2,0;;;17,0;10,0;;3,0;42,0;1,0;1,0;;5,0;3,0;;2,0;4,0;;;;1,0;5,0;33,0;;;;2,0;;4,0;;;;;;1,0;;;6,0;8,0;;;5,0;1,0;;1,0;;;;;;1,0;2,0;;;2,0;1,0;2,0;;5,0;3,0;1,0;9,0;8,0;2,0;;;;;;;;;4,0;;5,0;;;;;;;3,0;20,0;;;1,0;;6,0;;7,0;;;8,0;;;;;;;;;;16,0;;1,0;;;7,0;20,0;;2,0;;;5,0;2,0;;3,0;;;;1,0;1,0;;;1,0;;;;;;9,0;4,0;;;;;1,0;;2,0;;;1,0;;;;;;;1,0;8,0;5,0;;;4,0;;;;;;;;4,0;;;;;;;;;;;2,0;1,0;;;1,0;;;;;;;;;4,0;;;;;9,0;;;;;;;;1,0;;8,0;;7,0;1,0;;1,0;;;;;;;;;;;;2,0;;;;;;;;3,0;1,0;;;;;;;;;;7,0;;;;9,0;;;1,0;2,0;27,0;;;;;1,0;;;;;;3,0;1,0;;;2,0;;;;14,0;;5,0;3,0;;;;;;;;2,0;3,0;;;1,0;;1,0;;;;1,0;1,0;4,0;2,0;3,0;2,0;1,0;;;4,0;1,0;;;1,0;4,0;;3,0;;;7,0;5,0;1,0;1,0;;27,0;;3,0;1,0;;1,0;2,0;;;2,0;2,0;;2,0;7,0;2,0;;;;;1,0;7,0;;3,0;1,0;8,0;;5,0;;1,0;1,0;7,0;;1,0;;;11,0;;;;;1,0;;;;;3,0;9,0;;;1,0;1,0;17,0;;;;;1,0;2,0;1,0;2,0;;;;;31,0;;;1,0;2,0;;;7,0;;14,0;9,0;;;6,0;2,0;;;;6,0;;;;2,0;;3,0;;;2,0;;18,0;;11,0;2,0;11,0;;2,0;14,0;6,0;;1,0;;2,0;2,0;1,0;;;2,0;1,0;;;;;;;2,0;;2,0;;;;;;;;;;4,0;;;;;;;2,0;;;1,0;;;;;;;1,0;1,0;;;;;;;;;3,0;;6,0;5,0;;;1,0;;;3,0;;2,0;;;;2,0;6,0;;2,0;;2,0;;;;;;;;;;2,0;1,0;;;1,0;;;;1,0;9,0;;;;;;;;;;1,0;;2,0;;;;;;;;;;;;;;2,0;;;;;;;;;;;;2,0;;;;5,0;2,0;;;;;;;;;;;;1,0;;;;;;;;;;;;;;;3,0;;2,0;;;;;;;;;;;;;;;1,0;;;;;;;;;;;;;;;;;;;1,0;;5,0;;;;;;;;;1,0;;5,0;;2,0;;;;2,0;;;4,0;;;;;;;;;;;;;;1,0;;;;;;;;2,0;;4,0;;3,0;;;;;;;;;;1,0;;;;;;;;;;2,0;;;;;2,0;16,0;;;;2,0;;;;4,0;;;;;;;;1,0;;;;;;;1,0;1,0;;1,0;;;;;;;;;2,0;;;;5,0;;;;;;5,0;;;;;;;2,0;;;;;;;;;;;;;;;;2,0;;;;;;1,0;5,0;;;3,0;;;2,0;;;;;4,0;;;;;;;;;;;;;;;;;;;;;1,0;;;;;3,0;;;;;;;;;2,0;;;;;;;;;;;;;;;;;;;;;;;;;;;;;;1,0;;;;;;;;;;;;;;2,0;;;;;;;;;;;;;;2,0;;;;;;;;;;;8,0;;;;;;;;;;;;;;;;;;;;;;;;;;;;;;;;;;;;;;;
restrict;;;1,0;;;;3,0;4,0;;1,0;;;;;;1,0;;;;;1,0;8,0;;;3,0;;;5,0;2,0;1,0;3,0;1,0;17,0;;3,0;;;2,0;1,0;;6,0;;9,0;4,0;;;;;3,0;;8,0;;;;;10,0;6,0;;;19,0;;;6,0;;;;3,0;;;4,0;10,0;;1,0;;;24,0;;;11,0;5,0;;2,0;;;3,0;;1,0;;;2,0;1,0;1,0;;12,0;;6,0;;2,0;1,0;;2,0;2,0;;;;;;63,0;;;;;;2,0;;;;;;2,0;;;;1,0;;;3,0;1,0;;;3,0;;;4,0;;;;;;;;;4,0;3,0;;3,0;4,0;1,0;;;;;3,0;;1,0;1,0;9,0;10,0;;1,0;1,0;;;1,0;1,0;;3,0;6,0;;;23,0;;3,0;1,0;15,0;2,0;;1,0;;;;;2,0;;;;1,0;4,0;;16,0;;1,0;;2,0;;;;2,0;14,0;;;;;2,0;;;2,0;1,0;;5,0;;;;;;;;;;;;1,0;;;9,0;;;;;;;;;;;6,0;;;21,0;;5,0;;2,0;;;;;;;;;;;;;;;2,0;;1,0;;2,0;;1,0;3,0;;2,0;;;;;1,0;;;;;;1,0;;4,0;;;3,0;1,0;;1,0;2,0;2,0;7,0;;;1,0;;;1,0;;;1,0;;;;2,0;9,0;;;1,0;;9,0;;;2,0;2,0;;;1,0;;;;3,0;;;;;1,0;;4,0;;;1,0;;7,0;;;;;;;3,0;;;;;;;1,0;;;;;7,0;;;;;;;;;;;;3,0;;;;;;;;;;;;;5,0;;;;;;;;;;;;;;;;1,0;;;;;;;;;;;;;;;;;2,0;;;;;;;;;;;;;;;;;12,0;1,0;;;;;;;;;;;;;;;;;;;;;;;;;;;;;2,0;;;;;;;;;;;;4,0;;;;;1,0;;;;;;;;;;;;;;4,0;;;;1,0;;;;;;;;;;;1,0;;;;1,0;;;;;;;;;;;;;;;;;;;;;;9,0;;;;;;;;;;;;;;;;;;;;;;;;;;;;;;;;;;;;;;3,0;;1,0;;;;1,0;;;;;;;1,0;;;;;;;;;;;;;;;;;;;;;;;;;;;;;;;;;;;;;;;;;;;;;;;;;;;6,0;;;;1,0;;;;1,0;;12,0;;;;;;;;;2,0;;;;;;;1,0;;;;;;;;;;;;;;;;;1,0;4,0;;;;;;;;;;;;;;;;;;;1,0;;;;;;;;;;;;;1,0;;;1,0;;;;;;;;;;;;;;;;;;;;;;;1,0;;;;;;;;;;;;;;;;;;;;;;;;;;;;2,0;;1,0;;;;;;;;;;;;1,0;;;;3,0;;;1,0;;;;;;4,0;7,0;;;;;;;;;;;;;;;;;;;;;;;;;;;;2,0;;;;;;;;;;;;;;;;;1,0;;;;;;;;;;;1,0;;;;;;;;;;;;;;;;;;;;;4,0;;;;;;;;;;;;;;;;;;1,0;1,0;;;;;;;;;;;;;;;1,0;;2,0;;;;;;;;;;;;;;;;;;;;;;;;;;;;;;;1,0;;;;;;;;;;;;;;;;;2,0;;;;;1,0;;;;;;;;;;;;;;;;;;;;;;;;;;;;;;;;;;;;;;;;;;;;;;;
retractable;;;1,0;;;;71,0;1,0;;;;3,0;;;;;;;1,0;;;4,0;;;;;;5,0;;6,0;1,0;;24,0;2,0;7,0;;;21,0;3,0;;;;9,0;22,0;;;;;;;;2,0;;27,0;;8,0;33,0;;2,0;619,0;;;3,0;;;;4,0;;;6,0;75,0;;;2,0;;;;8,0;56,0;;;;;;;;;;;;2,0;;;2,0;;10,0;;;4,0;;5,0;157,0;;;;;1,0;10,0;;;;;;5,0;3,0;;;;;3,0;;;;;;;77,0;7,0;;3,0;;;;34,0;;;4,0;;;;;;;;;5,0;14,0;264,0;;;;;20,0;;1,0;10,0;;3,0;;8,0;;;2,0;1,0;;;;;;;62,0;1,0;2,0;;8,0;14,0;1,0;;;;;;2,0;1,0;1,0;2,0;;21,0;;15,0;;;;12,0;;;;;;;;;;3,0;;;2,0;;3,0;4,0;;;;;;3,0;;;;;;;;;10,0;;;;;4,0;;;;4,0;;;;;;;59,0;;;1,0;;;;;;4,0;;4,0;;4,0;;;;;;4,0;;5,0;;;4,0;;12,0;;;;3,0;4,0;;;5,0;;;;;1,0;;;1,0;21,0;;;63,0;1,0;1,0;;;;;;;;;11,0;;;;;3,0;2,0;5,0;3,0;;1,0;1,0;;12,0;4,0;79,0;;10,0;2,0;2,0;;9,0;;;;6,0;;;;;7,0;;;;;;;;;;;;;;;;;;;;2,0;;38,0;5,0;1,0;;;;;;;;;;;;;;1,0;;;;;;;;;;1,0;;;;;;;;;;;;;;;6,0;;;;3,0;;;;;;7,0;;;;;;;;;;11,0;8,0;;;;;;;;;;;;;;;;;;;;;;;;;;;;;;;;;;;;;;;;;;6,0;;;;;;;;;;1,0;;;26,0;;;;;2,0;;;;;;;;;;;;;;9,0;;;;;;1,0;;3,0;2,0;;1,0;;;;2,0;;;;;;;;;;;;;;;;5,0;;;;;;;11,0;;;;;;1,0;;;1,0;;;;;;;;;;1,0;;;;;;;;;;;;;;;;;;;;;;;;2,0;;;;;;;;;;;;;;;;3,0;;;;;;;;;;;;;;;;;;;;2,0;;;;;;;;;;;;;;1,0;14,0;;;;;;;;;;2,0;;;;;1,0;;;;;;;;;2,0;;;;;;1,0;;;;;;;;2,0;;;;;;;;;;8,0;;;;;;;;;;;;;;;;;;;;;;;;;;;;;;;;;;;;;;;;;;;;;;;;;;;;3,0;;;;;;;;;;;;;2,0;;1,0;;;;;;;;;;;;;;;;;;;;;;;;;;;;;;;;;;;;;;;;1,0;;;;;;;;;;;;;;;;;;;;;;;;;;;;;;;;;;;;;;;;;;;;;;;;;;;;;;;;2,0;;1,0;;;1,0;;;;;;;;;;;;;;;;;3,0;;;;;;1,0;;20,0;;;;;2,0;;;;;;;;;;;1,0;;;;;;;;;;4,0;;;;;;;;;;;;1,0;;;3,0;;;;;;;;;;;;;;;;;;;6,0;;;;;;;;;;;;;;;;;;;;;;;;;;;;;;;;;;;;;;;;;;;;;;;;;;;;;1,0;;;;;;;;;;;;;;;;;;;;;;;;;;;;
reverse;;;4,0;;10,0;;4,0;2,0;2,0;3,0;;;1,0;;1,0;;;;;;;20,0;;;;;;4,0;;15,0;2,0;;19,0;;2,0;;;64,0;;6,0;3,0;;19,0;5,0;;;;;4,0;;2,0;;;;;20,0;3,0;;;13,0;;;12,0;;;21,0;5,0;;1,0;6,0;4,0;23,0;3,0;;;1,0;;10,0;7,0;;;4,0;;;;;2,0;;;3,0;5,0;5,0;;23,0;;;;1,0;7,0;;2,0;6,0;;2,0;;;2,0;3,0;;;;7,0;;3,0;;;;;1,0;3,0;;1,0;;1,0;;;;;;;3,0;;;;;;4,0;;;;;;;9,0;;3,0;4,0;4,0;;;;1,0;;;;;;;;4,0;;;;;;2,0;4,0;8,0;;;2,0;5,0;;6,0;3,0;2,0;;30,0;;;2,0;;10,0;;1,0;1,0;1,0;;;16,0;;;;1,0;;4,0;;;10,0;1,0;2,0;6,0;;10,0;;1,0;2,0;;;2,0;;;;1,0;1,0;4,0;3,0;;4,0;;;35,0;3,0;;4,0;;;;;;;;1,0;;;1,0;;15,0;1,0;;;;;;;;;;;3,0;2,0;1,0;;;;;;1,0;;;;4,0;;;2,0;;;;;;;;;;1,0;;;;;;;;;9,0;;;3,0;;;6,0;;;;;;1,0;;;;;;;6,0;1,0;2,0;1,0;;;1,0;;2,0;;1,0;;3,0;;;;;;;1,0;;;;;;;3,0;;;;;;;;;;;8,0;;;;;;4,0;;;;;1,0;;;25,0;;;;;;;2,0;;1,0;;;;;;;;8,0;;1,0;;;38,0;;;;;7,0;;;;1,0;2,0;;;;;;8,0;2,0;;2,0;1,0;1,0;;;;;;;;;8,0;1,0;;;5,0;;;;;;;;;2,0;;22,0;;;;4,0;;;16,0;;;41,0;;;;;1,0;;;;;6,0;;;1,0;;5,0;;;;7,0;;;;1,0;;;;;;;;;;;;1,0;4,0;;;;;1,0;;;;;4,0;;;;;;;;;20,0;1,0;;4,0;;;1,0;;1,0;5,0;2,0;;5,0;;5,0;;;;;;;;;;;;;;;;;;3,0;;;1,0;;;12,0;;;;;;;;;;;;;1,0;;;;;;;;;;;;;;;;;1,0;;;;;;;9,0;;;;;;;;;;;;;;1,0;;;;;;;;5,0;1,0;;;;;2,0;;;;;;;6,0;;;1,0;;;;;;;;;;;;;;;;;;;;;;;;;;;;;;;;;1,0;;3,0;;;;;2,0;;;;1,0;;;;;1,0;;;;1,0;;;;;;;;;13,0;;;;;;;;;;;;;;;1,0;;;;;;;;;;2,0;2,0;;2,0;;;5,0;;;1,0;;3,0;1,0;;;1,0;;1,0;;;;;;;1,0;;;;1,0;;;;;;;;;;;;;;;;;1,0;;1,0;;;;;;;;;;1,0;3,0;;;1,0;1,0;;;;;;;;1,0;2,0;;;;;;;;;;;;;;;;23,0;;;;;;;;;;;;;1,0;;;16,0;;;;;;;;;;;;;6,0;;;;;;;;;;;;;;;;;;1,0;;;;;;1,0;;;;;2,0;;;;;;;1,0;;;;;;3,0;1,0;;;;;5,0;;;;;;;;;11,0;;;;;;4,0;;;;;2,0;;;;;;;;;;;3,0;;;;;;;;;;;;;4,0;;;;;;;;;;;;;;;;;;;;;;;;10,0;;;;;;;;;;;;;;;;;;;;;;;;;;;;;;;;1,0;;;;;;;;;;;;;;;;;;;;;;;;;;;;;;;;;;;;;;;;;;;;;;;;;;
road;;;6,0;;3,0;;;5,0;1,0;5,0;;9,0;3,0;;;3,0;;;;;;3,0;;;;;2,0;19,0;;13,0;6,0;4,0;7,0;;;1,0;;1,0;;;;;;3,0;;;;;;;;3,0;;1,0;6,0;24,0;1,0;;;;;;12,0;;;;;;;;1,0;5,0;;;;;;8,0;3,0;;;;3,0;;;;12,0;;4,0;2,0;5,0;;;;1,0;;;;;;43,0;4,0;;;;1,0;;2,0;;;;;;;;;;;;;;;;;;;2,0;;1,0;;;;;;5,0;;;;;;;;;;;;8,0;;;;;;;;;;;;2,0;8,0;;;;;;;1,0;3,0;;;;;2,0;;;;;;;;;;;;;3,0;;9,0;;5,0;;;;2,0;;;;;;;;1,0;;2,0;;;;;;;;;;;;1,0;;;2,0;;;18,0;;;;;4,0;;;;;;;1,0;;;;3,0;;;;;;;;;;;;;;;;;2,0;;;1,0;;;;2,0;2,0;;;;1,0;;;;;;;;;;;;;1,0;;;;;;;;4,0;2,0;;;;;;;;;4,0;;;1,0;;2,0;;;;;4,0;;;1,0;;;;;;;;;;;;;;;;;;;;;;;;;;;;;;;3,0;;2,0;;;;;;1,0;;;;;;;2,0;4,0;;;;;;;3,0;;;;;;;;;7,0;;;;;;;;;;;;;;;;;;;;;;;1,0;4,0;1,0;;;17,0;;;;;;;;;;;;;;1,0;;;8,0;;6,0;;;;;;;;;;;;;;1,0;;;;;;;;;;1,0;;;2,0;;;;;;;;;;;;;;;;;;2,0;;;3,0;;;;;;;1,0;;;3,0;2,0;;;;;;;;;;;;;;;;;;;;;;;;;;;;;;;;;;;1,0;;;;1,0;;;;;;;;;;;;;;;;;;;;;;;;;;;;1,0;;;;1,0;;;;;;;;;2,0;1,0;;;;;;;;;;;;;;;;;;;;;;;;;;;;;1,0;;;;;;;;;1,0;;;;6,0;;;;;;;;;;;;;;;;;;;;;;;;;;2,0;;4,0;;;;;;;;;;;;;;;;;;1,0;;2,0;;;;;;;;;;1,0;;;;;;;;;1,0;;;;;;;;;;;;;;6,0;4,0;;;;;;;;;;;;;;;;;;;;;;;;;;;1,0;;;1,0;;;;;;;7,0;;;;;;;;;;;3,0;1,0;;;;;;;;;;;;;;;;;;;;;;;;;1,0;1,0;;;;;;;;;;;;;;;;;;;;2,0;;;;;;;;;17,0;;;;;;;;;;;;;;;;;;;;2,0;;;;;1,0;;;;;;;;;;;;;;;;;;;2,0;;;;;;;;;;;;;;;;;;;;;;;;;;;;;;;;;;;;;;;;;;;;;;;;;;;;;;;;;;;;;;;;;;;;;;;;;;;;;;1,0;;;;;;;2,0;;;1,0;;;;;;;;;;;;;;;;2,0;;;;;;;;;;;1,0;;;;;;;;;;;;;;13,0;2,0;;;;;1,0;;;;;;;;;;;;;;;;;;;;;;;;;;;;;;;;
roll;;;1,0;;6,0;;28,0;7,0;;3,0;5,0;;;;;;;;;1,0;;5,0;;;3,0;;;21,0;;3,0;;11,0;20,0;;5,0;;;6,0;;;;;2,0;6,0;1,0;;;;;;1,0;8,0;;;4,0;15,0;63,0;;2,0;;;;15,0;;;10,0;12,0;;;;3,0;;1,0;;;;;;31,0;1,0;;;;;;;;3,0;;;6,0;;;;1,0;1,0;4,0;2,0;10,0;;4,0;12,0;;;;;;22,0;;;12,0;;;19,0;19,0;5,0;;;;2,0;;2,0;;16,0;;;12,0;2,0;;;2,0;;;;;;1,0;;;;;;;;;;1,0;52,0;;;;;1,0;;;;;14,0;;2,0;;;;1,0;;;5,0;;2,0;12,0;41,0;;;8,0;18,0;;2,0;;;;;;;;3,0;6,0;4,0;;;28,0;;;;15,0;;;;;2,0;;;;;;;;;;1,0;2,0;;2,0;;;22,0;1,0;;;;;;3,0;;;;;;;;;;;;9,0;5,0;27,0;;;2,0;;;;;;;;;;;;;;;3,0;;;1,0;6,0;;;;;;;;;2,0;6,0;2,0;;;;4,0;;;;;;;7,0;1,0;;;9,0;;;1,0;9,0;;1,0;;4,0;1,0;;;5,0;;5,0;;;1,0;;;;1,0;;;;;;;6,0;;;;7,0;;;;;;;3,0;;;;;;17,0;;;;;;;;;2,0;;;;5,0;;;;;;8,0;4,0;;;;1,0;;;;;;;;;;;;;6,0;;;8,0;;;;;7,0;;;1,0;;;2,0;;;;1,0;;;2,0;;;;;;;;3,0;;;;;;1,0;;;;;;;1,0;;;2,0;4,0;;;;;;1,0;2,0;;;;;;1,0;;1,0;;;;;;;;;;;;;;;;;;;7,0;;;;;;;2,0;;;;;;;;;;;;;2,0;1,0;;5,0;;;;1,0;;;;169,0;;;;;;;;;3,0;;;;1,0;;;7,0;;2,0;3,0;;;;;1,0;;;;;1,0;;;;3,0;1,0;;;;;6,0;;;;;;;;;;;5,0;;;;;;;5,0;;;;;3,0;;;;;4,0;;;8,0;;;;;60,0;;;;;7,0;;;;;;28,0;;1,0;;10,0;;1,0;;;;;;;;3,0;;;;;;;5,0;;;5,0;;;1,0;;;;;;;;;;;;;;;;;;;1,0;;1,0;;;;;;;;;;;1,0;;;;;;;;;;;;;;;;;;;;;;13,0;;;;;;;;35,0;;;;;;;;;6,0;;;;;;;;;;;;;;;;;8,0;;;;;;;;;;;;;;;;;;;;2,0;;;;;;;;;;;;;;3,0;;;;;;;;;;;;;;;;;;;;;;;;;;;;;;;;;;;;;;;;1,0;;;;;;;;2,0;;;;;;;;;;;2,0;;;;;;;;;;;;;;;;;;;;;;;;;;;;;1,0;;;;3,0;;;;;;;;;;;;;;;;1,0;;;;;;;;;;;;5,0;1,0;;;;;;;;;;;;;;;;;;;;;;;;;;;;;;;;;;;;;;;;;;6,0;;;;;23,0;;;3,0;;5,0;;;;;;;;;;;;;;;;;12,0;;;;;;;;;;;;;;;;;;;;;;;;;;;;;;;;;;;;;;;;;;;;;;;;;;;;;;;;;;;;;;;;;;;1,0;;;;;;;;;;;;;;;;;;3,0;;;;;;;;;;;;;
rolling;;;3,0;;1,0;;2,0;;;22,0;;;;;;;;;;;;4,0;;;;;;;;;1,0;6,0;8,0;;9,0;;;11,0;;;;;1,0;7,0;;;;;;;;1,0;;;;44,0;6,0;;;;;;6,0;;;;;;1,0;;1,0;;;;1,0;;;;7,0;;1,0;1,0;2,0;;;;2,0;;2,0;;11,0;;;;;;;;2,0;7,0;10,0;14,0;;;;1,0;18,0;4,0;;;3,0;;6,0;;;1,0;;;;4,0;;;;;;;2,0;4,0;;;;;;;;1,0;3,0;;;;;;;;3,0;1,0;3,0;18,0;;;;;;;;;;;3,0;10,0;;;1,0;;;;1,0;14,0;;;8,0;;1,0;;1,0;;1,0;;;;;;;;;;;13,0;;18,0;;;;2,0;;2,0;;;;1,0;;;;;;;;;1,0;12,0;;;;;;1,0;;;;;1,0;;;;5,0;;;;;;;;2,0;3,0;;;;;13,0;;1,0;2,0;;;;;;1,0;1,0;;;;;3,0;;;;;;;;1,0;;;;;4,0;;;;;3,0;;;;;;;;;;1,0;;2,0;;3,0;;2,0;1,0;1,0;;;3,0;;;;;;;;;;;;;;;;;;;2,0;;;;3,0;;;;;;1,0;;;;;;;;;;;4,0;;;;;;;;;;;;1,0;;;;;;1,0;;;;;;;;;1,0;;;;;;;;;;;;;;;;1,0;;;;;7,0;;;;1,0;;;;;;;;;;112,0;;;;;;;;;;;;1,0;2,0;;;2,0;;;;;;;;4,0;;;;;;;;;;;10,0;;;;;;;;;;;;;;;;1,0;;;;;;;;4,0;;;;;;;;;;;;;5,0;;;;;;;;;;;;;;20,0;;;3,0;;;;;;;;1,0;;4,0;;;1,0;;;;;;;;;;;;;;;;;;;;;;;;;;;;;;;;;;;;4,0;;;;;;;;;;;;;;;;;;;;;;;;4,0;;;;17,0;;;;;;2,0;;1,0;;3,0;;;;;;;1,0;;;;;;1,0;;;;;;;;;;;;;;;;;;;22,0;;2,0;;;;;;;;;;;;;;;;;;;;;;;;;;;;;2,0;;4,0;;;;;;;;;;;;;;;;2,0;;;;;;;;1,0;;;;;;;;;;;;;;;;;;2,0;;;;;;;;;;;;;;;;;;;9,0;;1,0;;1,0;;;;;;;;;3,0;;;;2,0;;;;;;;;;;;;;;;;;;;;;;;;;;;;;;;;;;;;;;;;;;;;;;;;8,0;;;;;;;;;;;;;;;;;;;;;;;;;;;;;;;;;;;;;;;;;;;;;;;1,0;;;;;;;;;;;;;;1,0;;1,0;;;;3,0;;;;;;;;;;;;;;1,0;;;;;;;;;;;;;;;;2,0;;;;2,0;;;;;;;;;;;;;;;;;;;;;2,0;;;;;;;;;;;1,0;;;;;;;;;;;;;;;;;;;;;;;;;;;;;;;;;;;;;;;;;;;;;;;;;;;;;;;;;;;;;;;;;;;;;;;;;;;;;;;;;;;;;;;;;;;;;;;;;;;;;;;;;
rotate;;;13,0;;102,0;;286,0;104,0;2,0;31,0;36,0;;5,0;;15,0;;3,0;1,0;14,0;7,0;3,0;37,0;3,0;6,0;;;1,0;15,0;106,0;11,0;9,0;3,0;111,0;;27,0;;7,0;241,0;15,0;46,0;6,0;;152,0;42,0;;;1,0;;20,0;2,0;6,0;11,0;;12,0;3,0;261,0;50,0;;1,0;368,0;30,0;;74,0;;;136,0;21,0;8,0;1,0;47,0;82,0;23,0;9,0;4,0;1,0;1,0;4,0;21,0;195,0;7,0;14,0;7,0;6,0;1,0;;;8,0;5,0;;12,0;16,0;15,0;2,0;20,0;2,0;4,0;1,0;4,0;19,0;4,0;39,0;53,0;;24,0;;;5,0;152,0;;;17,0;17,0;;83,0;14,0;;21,0;;19,0;139,0;;4,0;3,0;2,0;2,0;;85,0;17,0;;36,0;32,0;;;102,0;1,0;10,0;14,0;28,0;;5,0;;1,0;7,0;22,0;9,0;38,0;41,0;70,0;9,0;18,0;1,0;20,0;33,0;;12,0;30,0;31,0;115,0;9,0;32,0;3,0;;26,0;7,0;9,0;;;29,0;6,0;;340,0;51,0;76,0;65,0;51,0;25,0;26,0;16,0;;;4,0;7,0;10,0;7,0;30,0;20,0;33,0;19,0;;174,0;;18,0;;24,0;2,0;7,0;;1,0;187,0;10,0;2,0;10,0;2,0;29,0;6,0;3,0;8,0;43,0;12,0;72,0;1,0;3,0;;;65,0;15,0;8,0;;14,0;6,0;5,0;2,0;1,0;;4,0;;2,0;;;;3,0;;15,0;12,0;22,0;74,0;15,0;14,0;10,0;;84,0;2,0;7,0;3,0;19,0;14,0;1,0;;17,0;2,0;4,0;;;46,0;;1,0;35,0;12,0;5,0;11,0;;91,0;2,0;7,0;32,0;3,0;23,0;;;15,0;2,0;18,0;;;6,0;1,0;;20,0;9,0;12,0;7,0;18,0;7,0;84,0;1,0;18,0;61,0;16,0;11,0;19,0;;1,0;2,0;2,0;6,0;19,0;;48,0;;9,0;21,0;3,0;49,0;1,0;27,0;11,0;;19,0;25,0;4,0;18,0;3,0;3,0;9,0;110,0;2,0;33,0;27,0;21,0;;;1,0;84,0;10,0;2,0;17,0;1,0;25,0;2,0;;10,0;5,0;28,0;;;;;2,0;;14,0;;1,0;;2,0;1,0;;1,0;3,0;;14,0;13,0;3,0;;5,0;;;5,0;1,0;7,0;;3,0;;;;;;;;1,0;;1,0;;1,0;16,0;5,0;1,0;4,0;;;12,0;;15,0;;;;7,0;3,0;;;5,0;5,0;14,0;94,0;5,0;20,0;4,0;6,0;8,0;;;1,0;;;;;2,0;20,0;9,0;2,0;5,0;9,0;23,0;9,0;1,0;1,0;1,0;11,0;;8,0;1,0;3,0;;;16,0;6,0;5,0;;;;;1,0;1,0;3,0;;4,0;19,0;;;;5,0;4,0;;3,0;;1,0;16,0;1,0;5,0;;2,0;;1,0;7,0;9,0;2,0;;;;4,0;;;1,0;2,0;2,0;;16,0;50,0;8,0;;;;23,0;5,0;;1,0;;1,0;;;2,0;1,0;;;2,0;;;2,0;;;4,0;;10,0;;18,0;9,0;17,0;6,0;;;;;1,0;;;35,0;10,0;;9,0;;2,0;2,0;;;1,0;7,0;3,0;;;;;4,0;;1,0;2,0;;;14,0;1,0;;;4,0;;3,0;;;;29,0;2,0;;;;;1,0;15,0;11,0;;26,0;2,0;;10,0;;1,0;;;;;10,0;;11,0;1,0;8,0;1,0;;;;2,0;179,0;;4,0;;3,0;;;;2,0;;7,0;;;2,0;1,0;;12,0;;;35,0;3,0;;;1,0;;;3,0;;;5,0;2,0;4,0;;3,0;2,0;;1,0;;12,0;;1,0;;;1,0;;1,0;1,0;;;;;;;2,0;;3,0;;1,0;2,0;;1,0;;8,0;;;4,0;3,0;10,0;1,0;6,0;19,0;21,0;33,0;;2,0;;;55,0;;;1,0;1,0;;;5,0;;;30,0;11,0;4,0;;1,0;4,0;2,0;5,0;1,0;;;7,0;7,0;;1,0;;1,0;;;;;22,0;;;2,0;;;;;;;1,0;;;2,0;;;;37,0;;;;;;17,0;8,0;;2,0;;;2,0;4,0;;;;2,0;6,0;;2,0;;1,0;;1,0;;5,0;;1,0;1,0;;2,0;;;1,0;;;;;1,0;;;;10,0;;;;;3,0;;3,0;;2,0;2,0;;1,0;1,0;;;;;;3,0;;2,0;1,0;;1,0;1,0;;;;1,0;;;;;;;;;14,0;;;45,0;;12,0;15,0;1,0;2,0;3,0;;;;5,0;;4,0;;;;2,0;;;;;;30,0;;2,0;;;;9,0;;;1,0;;2,0;3,0;;;;3,0;5,0;;;;;1,0;;;1,0;;;2,0;;;4,0;2,0;13,0;9,0;;;;;;;;20,0;;2,0;;;;;;;;67,0;9,0;;;;;;5,0;;9,0;2,0;;;;17,0;40,0;2,0;;;;;;;4,0;;2,0;2,0;13,0;;;;7,0;1,0;;16,0;7,0;;2,0;;1,0;;;;;;;;;;;24,0;;3,0;2,0;;3,0;;2,0;;;1,0;9,0;2,0;;2,0;;;;;1,0;;;7,0;5,0;;;;3,0;;;;;;;;1,0;;;2,0;;;;;;;;;;;;;;2,0;;;6,0;;;;4,0;;;;;;;;;;2,0;1,0;;1,0;9,0;2,0;1,0;;1,0;;;;;;3,0;1,0;;4,0;1,0;1,0;;;;;;;;6,0;;;;
rotation;;;54,0;;62,0;;386,0;76,0;19,0;35,0;147,0;;2,0;;16,0;4,0;;1,0;18,0;7,0;7,0;81,0;30,0;19,0;18,0;;3,0;21,0;49,0;64,0;21,0;65,0;135,0;10,0;24,0;;;269,0;23,0;31,0;25,0;;140,0;79,0;3,0;;3,0;2,0;40,0;1,0;26,0;22,0;;4,0;2,0;159,0;51,0;;5,0;171,0;12,0;10,0;56,0;4,0;7,0;143,0;35,0;;2,0;102,0;54,0;12,0;4,0;11,0;3,0;3,0;7,0;17,0;169,0;11,0;41,0;25,0;7,0;2,0;;;16,0;7,0;15,0;14,0;13,0;25,0;7,0;50,0;9,0;17,0;;1,0;6,0;10,0;97,0;57,0;;60,0;1,0;1,0;17,0;127,0;;4,0;7,0;11,0;;43,0;20,0;2,0;7,0;;2,0;84,0;;7,0;11,0;;;;56,0;22,0;;42,0;20,0;;14,0;66,0;;22,0;30,0;23,0;;;;;10,0;14,0;16,0;70,0;40,0;49,0;4,0;4,0;;11,0;91,0;;17,0;10,0;31,0;55,0;7,0;23,0;;5,0;36,0;11,0;27,0;;7,0;10,0;;;280,0;23,0;33,0;48,0;64,0;9,0;9,0;44,0;;;2,0;;14,0;2,0;10,0;37,0;111,0;27,0;;109,0;;11,0;1,0;23,0;;7,0;;13,0;;12,0;;5,0;2,0;11,0;2,0;;5,0;8,0;14,0;109,0;4,0;;;1,0;63,0;5,0;26,0;;8,0;3,0;3,0;29,0;16,0;;2,0;;4,0;;;;3,0;;16,0;7,0;31,0;233,0;4,0;15,0;8,0;;30,0;7,0;1,0;1,0;12,0;4,0;2,0;;;12,0;3,0;3,0;;26,0;2,0;2,0;6,0;23,0;13,0;1,0;2,0;69,0;2,0;16,0;30,0;7,0;13,0;2,0;;3,0;4,0;10,0;10,0;2,0;7,0;;;21,0;37,0;10,0;46,0;28,0;1,0;94,0;;15,0;56,0;14,0;13,0;13,0;;42,0;;6,0;5,0;21,0;;4,0;;6,0;12,0;3,0;57,0;1,0;5,0;7,0;7,0;23,0;2,0;5,0;3,0;4,0;7,0;;95,0;;57,0;12,0;39,0;;;23,0;115,0;4,0;6,0;14,0;4,0;3,0;1,0;53,0;5,0;2,0;31,0;1,0;;;2,0;9,0;;21,0;5,0;1,0;2,0;7,0;20,0;;6,0;1,0;;17,0;11,0;3,0;8,0;8,0;;2,0;;;7,0;;4,0;1,0;;;13,0;10,0;;2,0;;2,0;1,0;;4,0;18,0;;1,0;;;;24,0;2,0;6,0;4,0;1,0;1,0;8,0;10,0;;1,0;11,0;9,0;35,0;25,0;1,0;41,0;33,0;13,0;22,0;6,0;;5,0;;1,0;;9,0;1,0;7,0;40,0;;3,0;12,0;23,0;7,0;2,0;;5,0;7,0;;7,0;3,0;13,0;1,0;;18,0;10,0;;;;3,0;7,0;;3,0;;;5,0;1,0;3,0;;;3,0;3,0;1,0;11,0;;2,0;20,0;6,0;10,0;;3,0;;5,0;6,0;9,0;2,0;;;3,0;4,0;;1,0;1,0;1,0;2,0;;10,0;20,0;22,0;24,0;;;10,0;3,0;;;3,0;1,0;;5,0;10,0;;;;5,0;;187,0;1,0;3,0;;8,0;;10,0;;10,0;17,0;31,0;;1,0;;;;;;3,0;16,0;4,0;;11,0;;;;;;5,0;9,0;1,0;;;;;;1,0;1,0;4,0;;;16,0;3,0;;1,0;;;9,0;;;;8,0;4,0;2,0;;;6,0;3,0;6,0;7,0;2,0;59,0;4,0;;2,0;2,0;;;2,0;2,0;1,0;1,0;;7,0;;;1,0;;;;;97,0;;14,0;;2,0;;;;;2,0;6,0;;;;;;4,0;;6,0;31,0;23,0;;;;;;;5,0;;11,0;5,0;;;5,0;3,0;;3,0;1,0;5,0;;;9,0;5,0;;;2,0;;;;;31,0;;;6,0;;;;;2,0;;;;11,0;1,0;;4,0;6,0;5,0;2,0;12,0;10,0;12,0;22,0;;;3,0;;10,0;2,0;3,0;;2,0;;;16,0;;1,0;9,0;;6,0;1,0;12,0;3,0;5,0;15,0;;;2,0;;;;;;2,0;;;;2,0;36,0;1,0;;1,0;;;2,0;;;;2,0;;;6,0;;;;49,0;;;;;;44,0;2,0;;7,0;;;;;;;;4,0;;;8,0;;;;;;;;;;;3,0;;;6,0;;;;;5,0;;6,0;3,0;1,0;;;;4,0;2,0;;;;10,0;2,0;;3,0;3,0;;;;9,0;;2,0;;1,0;3,0;;;9,0;;;1,0;1,0;1,0;;;1,0;;;8,0;;4,0;;;6,0;;7,0;32,0;;;2,0;1,0;1,0;;14,0;;;2,0;;2,0;;;3,0;;1,0;;10,0;8,0;1,0;7,0;15,0;;13,0;1,0;;;;6,0;;1,0;;4,0;6,0;9,0;;;;;1,0;3,0;;2,0;4,0;;;;1,0;;;2,0;;7,0;;;;;;;10,0;;;;;1,0;3,0;;2,0;;35,0;7,0;;;;;;2,0;;13,0;;6,0;;4,0;23,0;18,0;;;1,0;1,0;1,0;1,0;;1,0;;1,0;;;;;1,0;1,0;;;33,0;15,0;;;;;;;4,0;;;;;;;;16,0;;1,0;;;6,0;;5,0;;;;;;;;1,0;;2,0;;4,0;;;20,0;;;;;;7,0;1,0;;;;;9,0;;;;1,0;3,0;1,0;;;;43,0;;;;;;;;;;;;;;;1,0;4,0;;;;;;;1,0;;;3,0;6,0;1,0;7,0;1,0;6,0;;1,0;;;;1,0;;2,0;;;;1,0;;;;;;;;;;;;;
rotor;;;1,0;;2,0;;7,0;3,0;;;3,0;;2,0;;;;;;;;;;;;;;;;3,0;;;2,0;9,0;;;;;17,0;2,0;;;;7,0;7,0;;;14,0;;;;;7,0;;3,0;;1,0;14,0;;;40,0;4,0;;5,0;4,0;;14,0;1,0;;;2,0;4,0;;;20,0;2,0;;;;16,0;6,0;;;;2,0;;;;;;;;;;;;9,0;;;;;48,0;2,0;;;;;;19,0;;;;6,0;;13,0;2,0;;;;8,0;;;;;8,0;;;16,0;5,0;;12,0;2,0;;;;4,0;;17,0;;;;;;2,0;22,0;3,0;8,0;18,0;4,0;1,0;;;;1,0;1,0;4,0;;3,0;27,0;;3,0;;;22,0;8,0;;;;2,0;;;40,0;;4,0;18,0;13,0;2,0;23,0;41,0;;;;;;;;;5,0;3,0;;27,0;;10,0;;27,0;;;;;12,0;;;3,0;;2,0;3,0;;;;;3,0;;;;;4,0;;5,0;;;;;;;;;;;;;3,0;;;19,0;1,0;;4,0;2,0;;;2,0;23,0;1,0;;5,0;7,0;;;;7,0;21,0;;;;16,0;;;5,0;7,0;;;;10,0;;;6,0;;4,0;;2,0;10,0;10,0;;;;;;;;3,0;;;13,0;;3,0;;;5,0;;;1,0;;;;;3,0;;;;1,0;21,0;;;1,0;;5,0;4,0;;2,0;;13,0;;;;;6,0;;11,0;;;;;;8,0;;;;;;4,0;;;;;;;;;1,0;;3,0;;;;;;;;;;;;;;;;;;;;;;;;;;;;;;;;;;;;;;;;;;;;;;;;;;;;;23,0;;2,0;;;;;;;;;;;;;;2,0;;;;;;;;;;;2,0;;;;;;;;;;;;;;;;;;;;;;;;;;;3,0;3,0;;1,0;;;2,0;;;;;;;;;;;;;;2,0;;;;;;;;;;1,0;;;;;;;;;27,0;;;;;;;;2,0;;;;;;;;;;;1,0;;;1,0;;;;;;;;;;;;;;;;;;;;;;;;;;;;;;;;;;;;7,0;;;4,0;;;;;;;;;;;;;;;;;;;;11,0;;;;;;;;4,0;2,0;;;;;;;;;;;19,0;;;;;;;;;;8,0;;;;;;;;;;;;;;;;;;;;;;;;;;;;;;;;1,0;;;;;;;;;2,0;;;;;;;;;;;;;;;;;;;;;;;2,0;;;;;;;2,0;;;;;;;2,0;;;;;;;;;;;;;;;;;;;;;;;;;;;;;;;;;;;;;;;;;;;;;4,0;;;;;;;;;;;;;;;;;;;;;;;;1,0;;;;;;;;;;;;;;;;;;;;;;;;;;;;;;;;;;;;;;;;;;;;;;;;;;;;;;;;;;;;;;;;;;;;;;;9,0;;;;;;;;;;;;;;;;;5,0;;;;;;;;;;;2,0;;;;;;;1,0;;;;;;;;;;;;;;;;;;;;;1,0;;;;;;;;;;;;;3,0;16,0;;;;;;;;;;;;;;;1,0;;;;;;;;;;;;;;;;;;;;;;;;;;;;;;;;;;;;;;;;;;;;;;;;2,0;;;;;1,0;;;;;;;;;;;;;;;;;;;;;;;;;;;;;;;;;;9,0;;;;;;;;;;;;;
sample;;;3,0;;28,0;;2,0;9,0;9,0;11,0;6,0;3,0;;;40,0;2,0;;;19,0;5,0;3,0;19,0;2,0;1,0;10,0;4,0;2,0;128,0;2,0;58,0;5,0;52,0;46,0;30,0;62,0;5,0;8,0;13,0;1,0;21,0;1,0;;;15,0;;;;5,0;;47,0;5,0;48,0;5,0;7,0;;281,0;35,0;5,0;5,0;6,0;3,0;2,0;66,0;13,0;3,0;;;2,0;1,0;13,0;9,0;;1,0;;;;;21,0;26,0;;;14,0;33,0;;;4,0;24,0;;5,0;6,0;20,0;17,0;2,0;183,0;2,0;19,0;;1,0;13,0;2,0;6,0;19,0;1,0;1,0;2,0;;;19,0;;;11,0;3,0;83,0;;;;;2,0;;;;;5,0;94,0;;4,0;34,0;;;;;6,0;1,0;;;76,0;3,0;;1,0;6,0;2,0;;3,0;3,0;7,0;;1,0;55,0;;;4,0;;;;20,0;3,0;;;2,0;30,0;3,0;13,0;;;1,0;3,0;19,0;110,0;;3,0;1,0;18,0;15,0;2,0;5,0;4,0;;53,0;;;1,0;1,0;5,0;3,0;2,0;8,0;;20,0;;15,0;;;54,0;4,0;;19,0;;;3,0;;1,0;1,0;;;;1,0;17,0;2,0;3,0;;;;;;;82,0;2,0;;1,0;;;;;8,0;;9,0;;;;;;1,0;2,0;3,0;22,0;1,0;;4,0;19,0;;;;11,0;;;;10,0;;;;8,0;5,0;;25,0;;4,0;;2,0;;;6,0;5,0;15,0;;;;7,0;;;;;;;;;;;;;6,0;;;;3,0;;4,0;;5,0;1,0;;2,0;;;;;;;;1,0;;;;7,0;;;;;14,0;;;64,0;13,0;;;;;;;;;;4,0;;;;22,0;;;1,0;;2,0;;;;;;1,0;1,0;;;;1,0;;2,0;4,0;2,0;;10,0;;1,0;;;2,0;;2,0;;;1,0;;;3,0;;;;5,0;3,0;;16,0;;;2,0;;;2,0;1,0;4,0;3,0;3,0;;3,0;19,0;11,0;;2,0;153,0;;42,0;13,0;;1,0;;1,0;;;3,0;1,0;2,0;;14,0;;;;1,0;1,0;2,0;1,0;;;;1,0;;;;12,0;;2,0;1,0;;12,0;5,0;;5,0;;;;;;4,0;22,0;11,0;6,0;;;;;;23,0;;3,0;;;;;;;5,0;1,0;10,0;;;;8,0;3,0;4,0;;3,0;;;1,0;;;;;19,0;;3,0;;;12,0;;;33,0;;;;;;;;;9,0;;;;;1,0;;1,0;;1,0;;11,0;;;71,0;1,0;;25,0;;;;4,0;;5,0;3,0;;;;;;;;;8,0;;;;;2,0;2,0;;;6,0;;;;1,0;;;;;;1,0;8,0;1,0;14,0;;;;;;;;;;;;;;;;;2,0;;;;;;;19,0;64,0;;;;;;2,0;;;;;1,0;;;;;;;;;;6,0;14,0;3,0;1,0;3,0;;;;;;;;;;2,0;;;1,0;;;;12,0;;;;;13,0;;2,0;;5,0;;;;;;;;;;;;3,0;;;;;;;;;3,0;20,0;;;33,0;;;;3,0;;1,0;;;;4,0;;11,0;;3,0;;;;;1,0;;;2,0;1,0;1,0;;;;1,0;;;;;;;;;2,0;7,0;;4,0;11,0;;;19,0;1,0;51,0;9,0;3,0;11,0;;;;;;;;;5,0;;8,0;15,0;2,0;29,0;12,0;;;8,0;1,0;;;6,0;;17,0;;1,0;1,0;3,0;;1,0;3,0;;;;;;3,0;52,0;;1,0;;7,0;;2,0;;17,0;7,0;3,0;;;;;2,0;;85,0;;;133,0;;;4,0;;;;;;;1,0;;;;14,0;;;;27,0;2,0;1,0;8,0;;;8,0;;;2,0;;;;3,0;;11,0;;;;;;;2,0;;;9,0;;;;;;;;;;;;;;;;3,0;;;;;2,0;5,0;;;2,0;;;;;;;1,0;;;3,0;;;2,0;;;;4,0;;1,0;;7,0;;;;;;1,0;1,0;;;;;;;2,0;;;;;1,0;1,0;67,0;;;;;;;7,0;3,0;;;2,0;;;;;;;;;;;;;1,0;;;;;;;;;;;;;;;;;;;6,0;;;;5,0;;;;;;;;;10,0;;2,0;;;;;;;;;31,0;9,0;;;3,0;2,0;;;14,0;;;;;;;;;;;;;;;5,0;;;;1,0;;;;;;;;;;;;1,0;;;;;;;;1,0;;70,0;;;;;;;;4,0;;;;;;;41,0;2,0;;;;;;;3,0;;;;;;;
satisfy;;;22,0;;10,0;20,0;62,0;13,0;7,0;11,0;16,0;3,0;;10,0;1,0;;3,0;;3,0;3,0;709,0;11,0;3,0;;1,0;;;10,0;7,0;9,0;2,0;33,0;7,0;1,0;16,0;;;4,0;1,0;;40,0;;;43,0;;1,0;1,0;182,0;5,0;2,0;2,0;3,0;;61,0;18,0;117,0;9,0;;110,0;624,0;1,0;27,0;25,0;4,0;;;6,0;;2,0;5,0;170,0;;4,0;4,0;3,0;7,0;;8,0;12,0;28,0;;1,0;1,0;5,0;3,0;;;10,0;15,0;2,0;14,0;;8,0;8,0;;5,0;;5,0;1,0;3,0;54,0;365,0;;2,0;3,0;2,0;1,0;41,0;;;1,0;;;;;;2,0;;;2,0;;;1,0;10,0;;;5,0;;;;;;;;;;;;;;;;;2,0;1,0;;11,0;2,0;1,0;5,0;;;;;;;;6,0;2,0;97,0;;;;;;1,0;;19,0;;23,0;4,0;;30,0;3,0;18,0;2,0;4,0;18,0;;;;;1,0;;;4,0;;17,0;;7,0;;;;;;2,0;98,0;;;;;5,0;;38,0;;12,0;;;2,0;;2,0;;;;;31,0;;;;;2,0;;5,0;;;;;;;;;;6,0;;;10,0;;;8,0;;11,0;;6,0;;;;;;;1,0;;14,0;;5,0;;;;;3,0;4,0;;2,0;;;;;;;;;;4,0;;;;;;;17,0;;;1,0;;;;12,0;;37,0;;;;;;1,0;;;;3,0;;;;;70,0;;;;;4,0;;;10,0;;;;;;;;;;;1,0;;;;5,0;;;4,0;;2,0;;;;;;3,0;;1,0;2,0;;;;;;1,0;1,0;;;4,0;;;3,0;1,0;36,0;;;1,0;;;;;;;;1,0;;;;;5,0;1,0;;;1,0;;;;158,0;;;2,0;;6,0;;4,0;7,0;7,0;;1,0;2,0;1,0;;;;;;7,0;5,0;4,0;1,0;;;8,0;;;;331,0;;;;1,0;;7,0;;5,0;6,0;;3,0;;;;;2,0;;;4,0;;2,0;;;;;;;;;;;;;;;;5,0;5,0;;;11,0;;;2,0;3,0;;2,0;;;1,0;9,0;;;;;13,0;;1,0;;;6,0;;;7,0;;;;;1,0;;;;;;10,0;;;;;3,0;1,0;;;;2,0;;3,0;1,0;;;;;;;;;4,0;;;29,0;4,0;;;;;;;1,0;;;2,0;4,0;;;;;;;1,0;;;;;;;;;;;;;;;;2,0;;;;;;2,0;;16,0;;;;;;;;;;6,0;;1,0;;;;1,0;;;;;;2,0;;;;;;;;;;3,0;;;;;;;41,0;;;;;;;;;;;;;5,0;14,0;;;1,0;;;;;;;;;;;;;;3,0;;10,0;;;;;;1,0;;;;;10,0;11,0;1,0;4,0;;;;;;8,0;;20,0;;;;;;1,0;;;;;;;;2,0;;;;;46,0;2,0;;;;;;;21,0;;26,0;;;;;;;;;1,0;2,0;;;;1,0;;;;2,0;;177,0;10,0;;;;3,0;;2,0;;;1,0;;;;;24,0;4,0;;3,0;;;;;;3,0;9,0;;;;;;;;;;2,0;;;;1,0;;1,0;;1,0;18,0;;;1,0;;;;4,0;1,0;42,0;;;;;;;;14,0;;;;;;;;;;;8,0;;;;;1,0;;;3,0;;;;;;;;;;;;;7,0;;;;3,0;;;;;;;;;;;;;;;;4,0;;;;;;4,0;;;;;;;;;;1,0;;1,0;6,0;;;6,0;;;;3,0;;;;;;;;;;;;;;;;;;;;;;;2,0;;;;1,0;;;2,0;;1,0;;;;;;;;;;;;;;;;;;;;;;;;;;;;;;47,0;;;;;1,0;1,0;1,0;;;;;;;;;;;;;;;1,0;;;;;;;;;1,0;;;;;;;;;;;;;;;;25,0;;;;;;;;;;;1,0;;;;;;;;;;;1,0;;5,0;;4,0;;;;;;;;;;;;;;1,0;;3,0;;;;;;;;;;178,0;;11,0;;;;
scan;;;8,0;;14,0;;1,0;27,0;3,0;16,0;6,0;;;;18,0;4,0;;;;1,0;;103,0;1,0;;3,0;;;22,0;;20,0;11,0;26,0;64,0;3,0;40,0;10,0;1,0;102,0;;8,0;17,0;;7,0;27,0;1,0;2,0;;3,0;24,0;9,0;3,0;58,0;;1,0;;226,0;43,0;;1,0;53,0;9,0;5,0;94,0;;1,0;7,0;8,0;;;20,0;27,0;3,0;4,0;;;;;16,0;11,0;;;7,0;18,0;12,0;;;30,0;;2,0;54,0;57,0;7,0;2,0;148,0;2,0;7,0;;6,0;28,0;;4,0;54,0;;8,0;;2,0;1,0;157,0;;;11,0;17,0;18,0;16,0;;;;;1,0;1,0;;;1,0;95,0;;1,0;18,0;;2,0;1,0;2,0;4,0;3,0;;;2,0;5,0;;15,0;1,0;4,0;;4,0;1,0;8,0;;4,0;47,0;;;;;;;3,0;;;6,0;9,0;37,0;2,0;3,0;;;;1,0;1,0;25,0;;2,0;;17,0;15,0;5,0;26,0;;;44,0;;;3,0;2,0;2,0;;;5,0;;68,0;;14,0;;;6,0;11,0;6,0;2,0;;;;;;;1,0;4,0;;15,0;8,0;;5,0;1,0;;;;1,0;1,0;65,0;7,0;3,0;5,0;1,0;;1,0;;;;;3,0;;2,0;;;;3,0;12,0;9,0;4,0;;3,0;108,0;2,0;;;53,0;1,0;;5,0;;;;;44,0;1,0;;3,0;;1,0;1,0;;3,0;;7,0;25,0;2,0;;;;6,0;;;1,0;;;;;1,0;4,0;7,0;;1,0;8,0;;;;1,0;;17,0;8,0;37,0;3,0;;;1,0;2,0;14,0;;;5,0;4,0;;;13,0;;20,0;;;;;19,0;;;3,0;5,0;;;;;3,0;;;;;32,0;;;;15,0;;;9,0;;5,0;;4,0;;;1,0;3,0;10,0;;1,0;;4,0;;2,0;;6,0;1,0;3,0;;21,0;2,0;1,0;15,0;;;;1,0;;;;2,0;;;;3,0;2,0;;;1,0;3,0;3,0;;;5,0;6,0;6,0;6,0;;;7,0;25,0;;8,0;1,0;;1,0;;;8,0;23,0;;5,0;2,0;;4,0;34,0;9,0;18,0;;;5,0;;5,0;;1,0;9,0;;1,0;;;5,0;1,0;;2,0;;;3,0;1,0;11,0;23,0;16,0;1,0;;2,0;75,0;2,0;2,0;39,0;3,0;19,0;11,0;1,0;;;;;2,0;;;;;;1,0;;4,0;12,0;17,0;12,0;15,0;;;6,0;9,0;;;2,0;;3,0;1,0;;2,0;;;;;1,0;3,0;;1,0;;;19,0;;;1,0;;3,0;;;;3,0;;;;;1,0;3,0;;2,0;44,0;;7,0;;;24,0;16,0;;3,0;;1,0;;23,0;1,0;;9,0;;;;;;;;;6,0;;1,0;;1,0;;;;;1,0;52,0;;;8,0;;;;;;;3,0;1,0;2,0;;2,0;;2,0;;5,0;;1,0;;;;9,0;;;;2,0;;;;;5,0;2,0;1,0;1,0;91,0;;1,0;;;;13,0;;;;;;;;;1,0;;;;;2,0;;5,0;;2,0;1,0;;;;;;;;;3,0;2,0;;;;;;;6,0;;;;;;;2,0;;;;;;;1,0;;;2,0;14,0;;;6,0;1,0;;;;;1,0;;;1,0;3,0;3,0;;23,0;;;3,0;;11,0;;;;15,0;;8,0;1,0;;2,0;1,0;;2,0;;;;;21,0;1,0;4,0;;;;;;7,0;;;;;;;;41,0;;;;;1,0;1,0;;1,0;;4,0;;;1,0;1,0;;;1,0;;;1,0;;;56,0;;5,0;4,0;;;;6,0;;;1,0;1,0;;3,0;2,0;10,0;;2,0;;;;;;;2,0;1,0;;;;;6,0;;;1,0;10,0;;2,0;;;;;1,0;;6,0;;3,0;1,0;;4,0;;3,0;;;;1,0;;1,0;;;;3,0;1,0;6,0;4,0;;;;;;;5,0;;25,0;3,0;;1,0;;;4,0;4,0;;;2,0;;;;;;;8,0;;;;3,0;1,0;;;;;;;2,0;;;;;;1,0;;;;1,0;2,0;;;;;;;;;;;;;5,0;2,0;2,0;;3,0;;6,0;;2,0;6,0;4,0;1,0;;;1,0;;;1,0;;1,0;5,0;;;3,0;;;3,0;;;;;;;;2,0;;2,0;;;1,0;;;1,0;;;;;;;1,0;6,0;;;;;;1,0;13,0;;;2,0;;;;;2,0;;;;;;;3,0;;;;;;;;;;;;;;;4,0;;;;2,0;3,0;;;;;;;4,0;11,0;;;7,0;;;;;;;;;1,0;;;;;;;;2,0;6,0;;;1,0;;;;;11,0;;;;;1,0;;4,0;3,0;10,0;;;;;;;2,0;;;;;;;;;;;;;;;;;;;;;;;;;;;;;;;;
scene;;;16,0;43,0;26,0;;1,0;86,0;15,0;287,0;;12,0;1,0;;97,0;10,0;5,0;3,0;61,0;28,0;48,0;41,0;8,0;31,0;9,0;2,0;4,0;150,0;5,0;88,0;13,0;117,0;83,0;15,0;145,0;28,0;12,0;12,0;;110,0;75,0;2,0;;7,0;5,0;10,0;3,0;11,0;45,0;2,0;8,0;122,0;2,0;5,0;;1177,0;109,0;9,0;2,0;125,0;;;197,0;10,0;16,0;;24,0;3,0;13,0;31,0;61,0;3,0;22,0;4,0;;2,0;;58,0;49,0;24,0;;53,0;20,0;37,0;;2,0;47,0;;49,0;55,0;128,0;4,0;63,0;103,0;4,0;4,0;;6,0;42,0;;27,0;96,0;;;2,0;7,0;49,0;75,0;;;2,0;7,0;41,0;11,0;;8,0;;10,0;;8,0;;;2,0;11,0;;15,0;31,0;4,0;10,0;2,0;1,0;2,0;;1,0;5,0;3,0;6,0;;;3,0;;5,0;15,0;28,0;33,0;;109,0;21,0;;1,0;2,0;;;;;;;4,0;182,0;90,0;;3,0;;2,0;;;20,0;224,0;;;;10,0;10,0;3,0;45,0;;;68,0;;;;2,0;8,0;6,0;;17,0;5,0;117,0;;105,0;;;16,0;101,0;;28,0;;;7,0;;1,0;1,0;;;;21,0;7,0;;7,0;2,0;3,0;1,0;1,0;;;42,0;21,0;1,0;6,0;;;24,0;;;;3,0;;;;;;;3,0;5,0;29,0;6,0;;12,0;38,0;7,0;;;4,0;;;5,0;;;;;1,0;;;11,0;1,0;2,0;;23,0;12,0;1,0;1,0;;1,0;;;;1,0;;;;;5,0;;4,0;2,0;9,0;15,0;;2,0;10,0;;;;;;62,0;12,0;269,0;5,0;;4,0;;28,0;6,0;;;;21,0;;;5,0;;19,0;11,0;5,0;;;21,0;;;31,0;16,0;;;;;;;;2,0;;28,0;;;;21,0;;;1,0;3,0;53,0;1,0;;;1,0;2,0;;7,0;;;;12,0;4,0;8,0;6,0;3,0;6,0;2,0;;64,0;5,0;3,0;24,0;;1,0;;8,0;;;;14,0;6,0;;3,0;23,0;12,0;2,0;;;21,0;24,0;;;32,0;3,0;14,0;7,0;4,0;;2,0;7,0;14,0;;3,0;6,0;9,0;13,0;1,0;3,0;19,0;;38,0;;1,0;18,0;;;70,0;4,0;6,0;20,0;;6,0;5,0;2,0;;24,0;21,0;3,0;;;10,0;;18,0;1,0;59,0;31,0;;30,0;;41,0;4,0;4,0;13,0;42,0;2,0;6,0;;14,0;;11,0;27,0;;;;;5,0;1,0;;;2,0;4,0;;2,0;1,0;8,0;;7,0;18,0;;;5,0;29,0;21,0;;2,0;;;11,0;;11,0;8,0;24,0;;;17,0;;;46,0;;;17,0;;;;1,0;4,0;;3,0;;19,0;16,0;;11,0;;;1,0;12,0;;24,0;1,0;1,0;5,0;1,0;109,0;90,0;4,0;;1,0;;;;19,0;17,0;7,0;;;;;;;;;;4,0;;5,0;2,0;1,0;3,0;;;33,0;;;;6,0;;7,0;;;1,0;8,0;;1,0;1,0;;5,0;;;2,0;2,0;;;;;5,0;;;1,0;4,0;6,0;;14,0;6,0;;6,0;;3,0;19,0;39,0;;;2,0;;1,0;40,0;;;;;5,0;5,0;;;7,0;;;;2,0;1,0;12,0;14,0;;;3,0;;2,0;7,0;16,0;3,0;;;3,0;5,0;;;;1,0;;;;34,0;;;;;;;;;3,0;;;;3,0;7,0;;;;;;1,0;10,0;;;;;;;;;;12,0;2,0;;1,0;;;;;3,0;;;;;;1,0;;;26,0;1,0;;;;;;;2,0;;8,0;;;;3,0;1,0;;;;;1,0;1,0;;;4,0;3,0;;1,0;;30,0;1,0;8,0;2,0;38,0;8,0;;;7,0;2,0;;;;2,0;;2,0;;2,0;4,0;36,0;8,0;6,0;1,0;;9,0;6,0;;;3,0;;17,0;;;4,0;19,0;5,0;;;;5,0;;;1,0;;5,0;1,0;2,0;;4,0;;1,0;4,0;3,0;16,0;;;8,0;2,0;1,0;2,0;;12,0;;;3,0;;1,0;11,0;11,0;;;;;1,0;;1,0;;5,0;2,0;3,0;1,0;7,0;8,0;8,0;;;2,0;;4,0;1,0;1,0;9,0;;;;;;26,0;1,0;;;5,0;10,0;5,0;37,0;4,0;9,0;2,0;6,0;;;;;;6,0;4,0;2,0;3,0;;;;2,0;;;;8,0;20,0;;39,0;;1,0;;4,0;14,0;2,0;;;3,0;1,0;;;;4,0;23,0;;5,0;;1,0;;83,0;3,0;;3,0;37,0;;;;;;5,0;;4,0;30,0;5,0;;;;;;6,0;;;;8,0;5,0;7,0;10,0;2,0;;;;;1,0;;;;1,0;;;;;;2,0;6,0;;;;;;;;;;10,0;;;;;;11,0;6,0;;;22,0;;5,0;;;3,0;3,0;;;;;;;;;;1,0;1,0;1,0;2,0;4,0;;9,0;2,0;;;;;7,0;13,0;;;;2,0;;87,0;3,0;;;19,0;;4,0;;;;1,0;;;;;4,0;2,0;;;4,0;1,0;;;;1,0;;;;1,0;;;;;;;;;;;1,0;;;;;;;1,0;;;;;;1,0;;1,0;;;1,0;1,0;;;;;2,0;;;;;;;;;
score;;;9,0;;2,0;;;15,0;3,0;;;;;;;;;;;;;;;;;12,0;;4,0;;12,0;;22,0;1,0;;;;;;;;;;;;;1,0;;;;;3,0;6,0;;11,0;;6,0;4,0;;3,0;;1,0;;29,0;;;;;;;;;2,0;;;;;;;;;;;4,0;1,0;;;;;2,0;13,0;;6,0;;;2,0;;;;5,0;;;3,0;;4,0;;;;;;;1,0;;;;;;;;;;;;;;;;5,0;;;2,0;;;;;;1,0;;;;;;;;9,0;1,0;;;16,0;;;;;;;;;;;;;;20,0;;;;;;;;;;;4,0;;1,0;;;2,0;;;;;1,0;;;;;7,0;;1,0;;;;2,0;;;;;;;;;;;;;;;;;;;;;;;;;;;2,0;;;;;;33,0;;;;;;;;1,0;;;1,0;;;;;;;;;;;;;;;;;;;;;;;;;;;;;;;;;;;;;;;;;;;;;;;;;;14,0;;;;;;;;;;;;;;;5,0;1,0;;;;1,0;;;;1,0;;;;;;;;;;;;;;;;;;2,0;;;;;;;;;;;;5,0;;;;;1,0;;;;;;3,0;1,0;;;;;;;6,0;1,0;;;;4,0;;4,0;;;;;;;;;;;;;;;3,0;;;;;2,0;;;;4,0;;;;;;8,0;13,0;;8,0;;;;3,0;;1,0;;;;;;;1,0;;5,0;23,0;;;;1,0;;;;;;;;;;;;;;;;;;;;;6,0;;;7,0;;;;;;;;;;;;;;;;;;;;;;;;;;;1,0;;;;;;;;;2,0;;1,0;;;;;;;;;;;;3,0;;;;;;;;;;1,0;;;;;;;;;;;;;;;;;;;;;;1,0;;;;;2,0;;;;;;;;;;11,0;;;;;;;;;5,0;;;;;;;;;;3,0;;;;;;;;;;;1,0;;;;;;;;;;;;1,0;;;;;;;;;;;;;;;;;;;;;;;;1,0;;;;;;;;;;;;;;;;;;;;;;;;;;;;;;;;;;;;;;;;;;;5,0;;;;;;;;;;;;;;;;;;;;;;;;;;;;;;;;;;;;;;;;;;;;1,0;;;;;;;;;;;;;2,0;;1,0;;3,0;2,0;;;;;;;;;;;;;;;;;;;;12,0;;;;;;;;;;;;;;;;;;;;;;;;;;;;;;;;4,0;;;;;;;;;;;;;;;;;;1,0;;;;;;;;;;;;;;;;;;;;;;;;;;10,0;;1,0;;;;;;;;;;;;;;;;;;;;;;;;;;;;;;;;;;;;;;;;;;19,0;;;3,0;1,0;;;;;;2,0;;;;;;;;;;;;;;;;;;;;;;;;;;;;;;;;;;;;;;;;;;;;;;;2,0;2,0;12,0;;;32,0;;;;;;;;;;;;;;;;;;;;;;;;;;;;1,0;;;;;1,0;;;;;;;;;;;;;;;;;;;;;;;;;;;;;;;;;;2,0;;;;;;;;;;;;;;;;;;
screen;;;2,0;2,0;55,0;;5,0;57,0;3,0;69,0;31,0;1,0;1,0;;9,0;9,0;;3,0;;28,0;12,0;66,0;25,0;2,0;;;;68,0;1,0;47,0;10,0;40,0;192,0;1,0;50,0;9,0;6,0;40,0;1,0;1091,0;24,0;;12,0;11,0;;;;4,0;7,0;3,0;11,0;34,0;1,0;5,0;6,0;637,0;144,0;;;33,0;2,0;2,0;249,0;1,0;2,0;4,0;24,0;;;25,0;53,0;7,0;2,0;7,0;4,0;10,0;;53,0;102,0;4,0;;20,0;7,0;4,0;3,0;6,0;44,0;11,0;5,0;61,0;26,0;1,0;25,0;30,0;37,0;12,0;;8,0;20,0;5,0;77,0;101,0;;4,0;2,0;;;152,0;;;11,0;28,0;3,0;10,0;3,0;;;4,0;;20,0;;;6,0;3,0;3,0;1,0;23,0;7,0;1,0;4,0;9,0;20,0;;;1,0;25,0;10,0;;;19,0;;4,0;6,0;40,0;7,0;1,0;35,0;33,0;1,0;21,0;3,0;;6,0;;1,0;1,0;6,0;14,0;16,0;22,0;8,0;1,0;;6,0;3,0;6,0;3,0;83,0;;19,0;12,0;26,0;17,0;9,0;2,0;3,0;;233,0;;1,0;20,0;;4,0;2,0;1,0;11,0;1,0;79,0;;51,0;1,0;;5,0;35,0;;16,0;;;1,0;1,0;;3,0;7,0;32,0;;2,0;;;1,0;6,0;;7,0;2,0;;;14,0;16,0;4,0;2,0;2,0;2,0;6,0;;4,0;;;3,0;;;;6,0;1,0;5,0;11,0;15,0;38,0;;3,0;63,0;1,0;1,0;;;6,0;;5,0;;;;;;;;6,0;;2,0;;57,0;;;14,0;3,0;5,0;;1,0;;3,0;;;7,0;;48,0;;;5,0;25,0;28,0;;;39,0;1,0;;;14,0;1,0;10,0;14,0;42,0;38,0;9,0;;1,0;3,0;10,0;;1,0;;31,0;1,0;;5,0;;27,0;31,0;76,0;;;8,0;18,0;;26,0;7,0;5,0;;;;2,0;;;2,0;;10,0;;3,0;;6,0;;;;;42,0;5,0;1,0;;;;1,0;;;1,0;;4,0;;1,0;1,0;;1,0;1,0;;12,0;2,0;13,0;9,0;1,0;;;;;;;1,0;;;;17,0;30,0;5,0;1,0;11,0;;1,0;4,0;;11,0;3,0;4,0;3,0;;;3,0;4,0;1,0;3,0;4,0;1,0;;;8,0;;16,0;1,0;13,0;;;3,0;;1,0;13,0;2,0;1,0;5,0;;10,0;;;;49,0;8,0;2,0;;8,0;4,0;;9,0;2,0;2,0;8,0;1,0;49,0;1,0;25,0;;;6,0;42,0;2,0;6,0;2,0;10,0;1,0;14,0;;3,0;;2,0;;1,0;8,0;;3,0;11,0;;1,0;;;15,0;1,0;3,0;3,0;;;10,0;2,0;5,0;3,0;4,0;8,0;5,0;3,0;3,0;;7,0;;;3,0;32,0;4,0;1,0;2,0;1,0;2,0;17,0;1,0;15,0;;;105,0;;2,0;1,0;2,0;4,0;6,0;;;2,0;;21,0;;59,0;1,0;57,0;;3,0;65,0;106,0;17,0;;;4,0;;6,0;;;9,0;2,0;;;;3,0;;;;1,0;2,0;;;3,0;;14,0;;;;3,0;7,0;;3,0;1,0;;15,0;;2,0;7,0;2,0;5,0;;;2,0;3,0;;;5,0;;6,0;1,0;;1,0;28,0;23,0;;11,0;;;3,0;3,0;;10,0;;1,0;4,0;24,0;;;1,0;;18,0;14,0;9,0;;2,0;;;2,0;;;;;;1,0;;;4,0;89,0;1,0;;4,0;;1,0;2,0;9,0;1,0;2,0;;;;3,0;;;3,0;5,0;;;2,0;;;;1,0;;;;;;;;1,0;1,0;12,0;;1,0;;;;;2,0;;;2,0;;10,0;;1,0;;;2,0;5,0;1,0;29,0;;;;;;;;;1,0;;2,0;1,0;;2,0;3,0;;2,0;;;;;2,0;24,0;9,0;;;;1,0;;;;;4,0;;;;;4,0;5,0;;;;1,0;;;3,0;7,0;3,0;;;;;;;2,0;;;;;2,0;6,0;;;4,0;;;11,0;6,0;;;;5,0;8,0;;4,0;;3,0;1,0;2,0;;4,0;2,0;;;;2,0;;;2,0;1,0;;;;;;3,0;;1,0;2,0;10,0;;1,0;;1,0;7,0;;;4,0;1,0;1,0;;;;6,0;;3,0;;1,0;18,0;2,0;;6,0;4,0;;;;2,0;1,0;;;;8,0;2,0;27,0;;;5,0;;3,0;;;;8,0;;;;6,0;;30,0;;3,0;;1,0;;;1,0;2,0;13,0;;4,0;2,0;1,0;1,0;38,0;;;;4,0;32,0;1,0;1,0;;;;11,0;5,0;5,0;;1,0;;6,0;8,0;;1,0;;;;;30,0;;;2,0;9,0;11,0;11,0;2,0;;16,0;;;;;1,0;;11,0;;;;2,0;;;1,0;;;;2,0;;;;;;;3,0;1,0;4,0;1,0;;1,0;;53,0;;;2,0;;;12,0;;;;1,0;;;;12,0;;;;;;;;1,0;;;;;;1,0;1,0;;;1,0;;;;;1,0;;;;2,0;1,0;;13,0;2,0;3,0;2,0;;;4,0;;;;;4,0;;;;5,0;;;;;;;;;;;;;;;;;2,0;1,0;;;5,0;;;;;;;1,0;;3,0;;;;;;;;;;;;1,0;;;;;;;;;;;;;1,0;;;1,0;;;;6,0;1,0;;;;;;;;;1,0;;
search;;;2,0;;10,0;;1,0;20,0;5,0;21,0;3,0;41,0;;;13,0;;;1,0;;3,0;37,0;11,0;8,0;;4,0;1,0;;85,0;1,0;52,0;7,0;47,0;42,0;11,0;34,0;6,0;1,0;7,0;8,0;20,0;5,0;;;2,0;1,0;2,0;;29,0;84,0;2,0;11,0;10,0;;24,0;;293,0;47,0;;9,0;43,0;;;39,0;1,0;;;15,0;;;98,0;3,0;10,0;;;;;;38,0;100,0;;;22,0;3,0;;18,0;;78,0;;;14,0;;12,0;;16,0;18,0;25,0;;6,0;8,0;;23,0;77,0;2,0;;;;1,0;129,0;;;;24,0;1,0;;3,0;;;;;;;;5,0;1,0;;1,0;14,0;;;;;1,0;;;;12,0;;;;;;;6,0;31,0;1,0;;5,0;56,0;;;;;;;3,0;;;;;31,0;;1,0;;9,0;;;8,0;;;2,0;;;3,0;;3,0;;;12,0;;;1,0;;;2,0;;;;23,0;;11,0;;;;35,0;16,0;;;;;;;10,0;;16,0;;7,0;1,0;;;;5,0;;;;7,0;8,0;9,0;;1,0;;;1,0;9,0;;;;10,0;;;;;;;;25,0;;;5,0;137,0;25,0;;;23,0;;;7,0;;;;;;2,0;;;;6,0;2,0;34,0;;;5,0;;1,0;;1,0;;4,0;;;;;;;;;;;;8,0;2,0;;;;1,0;;6,0;13,0;27,0;16,0;1,0;;;;1,0;;1,0;;3,0;;;;;21,0;2,0;;;;105,0;;;25,0;5,0;;;;;;;;;;1,0;;;;64,0;;;;;4,0;;;;;;;5,0;;;;3,0;2,0;2,0;;1,0;3,0;5,0;;8,0;12,0;2,0;;;;;;;;;1,0;1,0;;;14,0;7,0;3,0;;1,0;;1,0;;6,0;;2,0;3,0;6,0;;;1,0;7,0;8,0;;4,0;1,0;;4,0;5,0;;;2,0;2,0;;;;2,0;14,0;36,0;8,0;;11,0;;2,0;;9,0;;;1,0;1,0;7,0;;;;;;7,0;49,0;;1,0;2,0;27,0;1,0;;14,0;15,0;1,0;;1,0;;2,0;;;;;;;;;;;3,0;4,0;;;;53,0;;;17,0;;2,0;25,0;6,0;;;2,0;5,0;2,0;3,0;6,0;;1,0;;1,0;;1,0;7,0;;;;;87,0;;;;1,0;;;2,0;5,0;;4,0;18,0;1,0;;;;1,0;;19,0;;15,0;;2,0;5,0;6,0;;;;;;;9,0;16,0;;;2,0;;;;;;4,0;3,0;5,0;;;3,0;9,0;;;;1,0;;;;;;;;;;;;12,0;;;;;;;;;;3,0;;;;;;9,0;1,0;;1,0;2,0;;1,0;;;3,0;32,0;;4,0;1,0;;;;;7,0;4,0;;7,0;39,0;;;4,0;;1,0;;;2,0;;10,0;8,0;;3,0;;2,0;;1,0;15,0;;;;;;;;;;;;11,0;;;;;;;;;;;;;;;;;;10,0;;;1,0;6,0;;;;5,0;;;;;6,0;;;;;;;;;;;;;;;;6,0;4,0;;;;;;;;1,0;;;;;;;;17,0;;;;;;;;;;;;;;;;;3,0;;;;1,0;1,0;;;;5,0;;;;;2,0;1,0;;2,0;;;2,0;1,0;;;;;77,0;;2,0;10,0;8,0;;;;;;;;;;;;2,0;;;;;3,0;;14,0;1,0;;;4,0;;1,0;;;;;;;;;9,0;7,0;8,0;;1,0;;2,0;12,0;;1,0;;2,0;;1,0;;;;2,0;;2,0;;4,0;;4,0;;;;;4,0;;;1,0;4,0;6,0;1,0;;4,0;1,0;;;;;;;;;8,0;2,0;;1,0;;2,0;;;;;;;8,0;1,0;;2,0;;4,0;;;;;;;;2,0;;;;;3,0;;;;;;;;9,0;;;;;;;2,0;;;;1,0;;;;;;;;;;26,0;6,0;5,0;;;;;;;1,0;5,0;;;;5,0;;;;;2,0;;9,0;;;6,0;;2,0;;;;;;;;;;;;;2,0;;;;;;1,0;;;;;;;;;;;1,0;;;;;;;;;;;;;;;;;;;;;;;;;;;;;;;;;;;;;;9,0;;;1,0;;;;;;;;;;;1,0;;;;;;2,0;;;46,0;;;;;;;;;;;1,0;4,0;1,0;2,0;;;;;;;;;1,0;;29,0;;;;;
segment;;;4,0;;18,0;;9,0;42,0;16,0;18,0;17,0;17,0;;;44,0;3,0;2,0;;2,0;13,0;2,0;29,0;;2,0;;;3,0;78,0;5,0;25,0;12,0;57,0;20,0;9,0;1,0;1,0;1,0;45,0;;23,0;20,0;;;10,0;;;;1,0;5,0;;2,0;20,0;;31,0;5,0;209,0;48,0;;61,0;;;1,0;71,0;18,0;2,0;;1,0;;2,0;7,0;9,0;18,0;1,0;;;;;42,0;12,0;;2,0;13,0;9,0;11,0;;;11,0;;6,0;30,0;48,0;12,0;;1,0;3,0;3,0;3,0;7,0;;5,0;17,0;21,0;;;;;1,0;6,0;;;;7,0;21,0;1,0;10,0;;;4,0;;;;;4,0;2,0;;2,0;4,0;4,0;4,0;2,0;;1,0;;2,0;2,0;3,0;;;52,0;1,0;;;3,0;;36,0;;17,0;33,0;;;2,0;2,0;2,0;2,0;;;;2,0;1,0;10,0;;;5,0;2,0;;4,0;4,0;20,0;1,0;1,0;9,0;7,0;8,0;3,0;8,0;1,0;4,0;29,0;;;3,0;2,0;;2,0;;27,0;3,0;78,0;;5,0;;;;7,0;;1,0;;;6,0;;;3,0;;20,0;2,0;2,0;;1,0;1,0;1,0;;;;;8,0;42,0;1,0;8,0;7,0;;1,0;2,0;;2,0;3,0;1,0;;;;;;;;13,0;2,0;9,0;;3,0;23,0;1,0;;2,0;;;;6,0;7,0;;;;;4,0;;33,0;;3,0;2,0;12,0;3,0;7,0;13,0;1,0;17,0;;2,0;;10,0;2,0;;;1,0;;;;2,0;12,0;;;;6,0;1,0;;;;;69,0;;24,0;;;;;14,0;2,0;;7,0;;2,0;1,0;;;;21,0;4,0;2,0;;1,0;;;;8,0;17,0;;;;;;;;;;1,0;1,0;;;7,0;;;;2,0;8,0;1,0;12,0;;;;;;;2,0;1,0;13,0;1,0;4,0;;;5,0;4,0;;17,0;9,0;9,0;29,0;;;;3,0;;;;1,0;2,0;;;23,0;8,0;;5,0;;;;17,0;;6,0;7,0;;3,0;3,0;;11,0;4,0;2,0;;21,0;;;1,0;;4,0;22,0;;;1,0;;;;16,0;30,0;18,0;2,0;;;1,0;;;;2,0;7,0;8,0;2,0;;;;7,0;;;;;1,0;4,0;47,0;;;1,0;5,0;;;4,0;;;22,0;2,0;;;;;;1,0;;;;11,0;;;1,0;3,0;1,0;;6,0;;;7,0;20,0;;1,0;;;7,0;5,0;;;;;1,0;;;;;3,0;;;11,0;3,0;1,0;;;2,0;;;;;3,0;;;2,0;2,0;;4,0;;7,0;;;7,0;;45,0;12,0;;5,0;;;;;;5,0;1,0;;;;;;;;;68,0;;;;;;;;;2,0;;;;;;;;;;;;2,0;;;1,0;;;;2,0;1,0;;1,0;;2,0;;4,0;1,0;;;;;;;2,0;;;;12,0;;;;;;1,0;;;3,0;;;;;;;;5,0;;;;20,0;4,0;2,0;;;;;;3,0;;;;;;;;;5,0;;2,0;;9,0;;;;;1,0;;;;;;;;;;;;1,0;;;;3,0;1,0;;;;;;;6,0;;;7,0;;12,0;;2,0;;;;2,0;;;14,0;;;1,0;;8,0;6,0;;;;;;;1,0;1,0;2,0;;;;;1,0;;;1,0;7,0;;;;2,0;5,0;;;3,0;;102,0;;;4,0;1,0;3,0;;;;;;;;1,0;;;;;;7,0;;12,0;;8,0;;;;;1,0;1,0;10,0;;11,0;;1,0;;;;;;;;;;;;;2,0;;;;;;20,0;5,0;;;2,0;2,0;;;;;;;;;;5,0;;;7,0;;;1,0;;;;;5,0;;;;3,0;;;1,0;;;;;3,0;;;;;;1,0;;;34,0;;;;2,0;;1,0;2,0;;;;;3,0;;1,0;2,0;27,0;3,0;;;2,0;2,0;;;2,0;;;;;;;5,0;;;;;;;;;;;;1,0;;22,0;;;;;;;1,0;;1,0;;;;;1,0;;;2,0;2,0;1,0;;;;;1,0;4,0;;;1,0;8,0;2,0;6,0;;;1,0;6,0;;;;;;;3,0;;;;1,0;;;;1,0;;;;4,0;;;;1,0;1,0;;;;;;;;;;;;;3,0;;1,0;;1,0;;;;;;;;;3,0;;5,0;2,0;;;;;;;;;;;10,0;;7,0;;;;;;;;5,0;;;;;;;;;1,0;4,0;;;;5,0;;;4,0;;;;;;;;1,0;19,0;6,0;;;;;;;;;;;1,0;;;;;;;;;;;;8,0;;;;;;;;;;;;2,0;;;;
selection;;;5,0;;26,0;;1,0;19,0;2,0;33,0;3,0;4,0;;;12,0;;;;;8,0;30,0;97,0;5,0;6,0;11,0;;;39,0;4,0;20,0;45,0;9,0;115,0;;26,0;;2,0;8,0;;84,0;5,0;;2,0;38,0;;1,0;;23,0;16,0;5,0;22,0;18,0;;13,0;;245,0;58,0;;;14,0;1,0;2,0;51,0;;1,0;;2,0;;8,0;10,0;13,0;;6,0;;3,0;5,0;;54,0;29,0;22,0;2,0;37,0;7,0;;2,0;;52,0;;5,0;289,0;7,0;14,0;29,0;41,0;6,0;;;10,0;7,0;;;25,0;;20,0;;1,0;8,0;182,0;;;5,0;1,0;3,0;4,0;;;;;;2,0;;;5,0;24,0;;;34,0;10,0;;5,0;8,0;4,0;;;1,0;4,0;;;;;7,0;5,0;7,0;;16,0;;6,0;8,0;;;;;;;2,0;;;5,0;5,0;21,0;;;;;;21,0;4,0;29,0;1,0;;2,0;5,0;35,0;2,0;4,0;2,0;;28,0;;1,0;;;2,0;3,0;;1,0;;78,0;;35,0;;;1,0;74,0;;4,0;;;3,0;;4,0;7,0;;;;2,0;5,0;;;9,0;;5,0;;;;34,0;13,0;1,0;;;;;;7,0;;27,0;;;;;;;;2,0;3,0;;;2,0;31,0;2,0;;;2,0;;;;;;;;8,0;4,0;;20,0;1,0;;;14,0;12,0;;;2,0;5,0;;;;;;;;;;;;;12,0;55,0;;2,0;;;;1,0;;;7,0;1,0;28,0;14,0;;;;;2,0;;;;11,0;;;4,0;;36,0;1,0;;2,0;;4,0;;;4,0;2,0;;;;;;;;;;;1,0;;;18,0;;;17,0;6,0;111,0;;;;;;;1,0;;;;13,0;;6,0;9,0;;1,0;15,0;;30,0;4,0;10,0;2,0;1,0;1,0;;;;;;;;;2,0;15,0;12,0;5,0;;;4,0;5,0;;;7,0;10,0;6,0;3,0;;;;6,0;4,0;3,0;10,0;1,0;4,0;2,0;;;31,0;;47,0;;;6,0;;1,0;2,0;;;6,0;;;;;;6,0;3,0;1,0;1,0;;24,0;4,0;4,0;;1,0;2,0;;22,0;;6,0;13,0;9,0;12,0;202,0;;2,0;12,0;12,0;12,0;9,0;;;1,0;8,0;;;;;1,0;12,0;12,0;1,0;2,0;3,0;7,0;;;9,0;6,0;;2,0;5,0;;;;;3,0;12,0;;6,0;19,0;;5,0;1,0;16,0;;17,0;9,0;70,0;;18,0;;;;;16,0;;;;;;;18,0;;;21,0;;8,0;15,0;1,0;69,0;;;36,0;18,0;2,0;14,0;;;;9,0;;1,0;1,0;;2,0;;;;;;1,0;7,0;5,0;;;2,0;;;;;1,0;;3,0;2,0;20,0;;;3,0;1,0;;;3,0;;;;2,0;;2,0;;;2,0;;;;2,0;;2,0;;;3,0;;3,0;1,0;;9,0;;3,0;3,0;74,0;;1,0;4,0;;14,0;1,0;2,0;;;;3,0;;;;;;;;;;;4,0;3,0;;4,0;1,0;3,0;;3,0;3,0;;;6,0;;;;;;;;;1,0;;;1,0;;;;;;10,0;;;;;3,0;;;;1,0;;;2,0;;;;;2,0;;;7,0;;3,0;;;;;3,0;;;;;;;;;;;;3,0;;;;;;;;;;;;;;;1,0;1,0;;;;;;;;2,0;1,0;;13,0;;;3,0;1,0;1,0;1,0;;;;1,0;;;;;1,0;;;;1,0;1,0;1,0;;5,0;;;1,0;;4,0;;3,0;2,0;7,0;;1,0;;;;;7,0;1,0;3,0;;;;;2,0;;;;;;;15,0;2,0;3,0;;;;;;1,0;;4,0;;;;;6,0;;1,0;3,0;;;;2,0;;;;2,0;;;;1,0;;;;2,0;;;;2,0;1,0;1,0;;;2,0;2,0;4,0;2,0;;8,0;2,0;1,0;;;1,0;;;1,0;;;;;;;11,0;;;1,0;;;;;;;;7,0;1,0;;1,0;4,0;25,0;;;;1,0;;;;5,0;3,0;;;;;1,0;;;;;;;3,0;;2,0;4,0;6,0;;;;;;;3,0;;;;5,0;1,0;;;;;;;;;3,0;3,0;;1,0;;;;;;;;2,0;1,0;;;;;;;1,0;;9,0;;;;;;;;1,0;;;;5,0;;;;;;;1,0;;2,0;2,0;1,0;1,0;;;;;;;1,0;;;1,0;;1,0;5,0;;7,0;1,0;;;;3,0;;;;;2,0;1,0;;;;;4,0;;;;3,0;;1,0;;;;;1,0;;;;;;;;;;;;;;2,0;;;9,0;;;;;;;;2,0;2,0;1,0;;5,0;;;;;2,0;;;;;;;;;;;9,0;;;;;;;;;;;;
selector;;;2,0;;2,0;;1,0;3,0;1,0;1,0;;3,0;;7,0;10,0;4,0;2,0;;5,0;1,0;3,0;35,0;3,0;;13,0;;;53,0;;6,0;1,0;2,0;9,0;1,0;11,0;;1,0;;;23,0;1,0;;2,0;1,0;;2,0;;;;;6,0;1,0;;;;105,0;23,0;2,0;2,0;16,0;1,0;7,0;3,0;;;;1,0;;1,0;2,0;4,0;;;;;;;;3,0;;;1,0;3,0;;;;2,0;;;122,0;9,0;;4,0;60,0;;1,0;;5,0;4,0;;1,0;16,0;;3,0;;;;25,0;;;8,0;1,0;9,0;;;;;;;15,0;;;7,0;12,0;;;34,0;;;3,0;;1,0;;;1,0;2,0;1,0;;;;;;;;5,0;;1,0;11,0;;;;;;;3,0;;;2,0;;10,0;;;;;;;6,0;20,0;;;2,0;5,0;2,0;1,0;;;;45,0;;1,0;;;;;;;;26,0;;2,0;;;;6,0;;3,0;;;;;;2,0;;2,0;;;12,0;;;;;;;;;1,0;2,0;;;;;;;;;;;;;;;;;;1,0;;;;1,0;1,0;;;;;;;;4,0;;;6,0;1,0;;15,0;;;;3,0;2,0;;;2,0;2,0;;;;;;;;;;;;;5,0;;;1,0;;;;;3,0;;2,0;;2,0;13,0;;;;;;;;;8,0;;;;;2,0;;;;;;;;;1,0;;;;;;;;;;;;;;8,0;;;2,0;;16,0;;;;;;;;2,0;;;;;5,0;13,0;4,0;;;;11,0;;;;;;;;;;;3,0;;;;1,0;;1,0;;6,0;;;;;;1,0;7,0;;;;;;1,0;;5,0;;;;;;5,0;1,0;2,0;;;;2,0;;;3,0;;;;;;1,0;;;;;1,0;;4,0;;;;;;;44,0;;1,0;;;;66,0;;;;1,0;;9,0;;;;2,0;;;;;;1,0;;;;;16,0;5,0;;1,0;;;1,0;1,0;;;1,0;;4,0;;;;;;;;7,0;;;1,0;;;1,0;;;1,0;;7,0;;;1,0;5,0;3,0;;;;;;8,0;;6,0;1,0;42,0;;6,0;3,0;2,0;;2,0;;;;4,0;;;;;;;;;;;;;2,0;;;;;;;;;;2,0;;4,0;;;;;;;;;;;;;;;;;;;;;;;;;;;5,0;;;3,0;1,0;;;16,0;4,0;;;;;;;;;;;;;;;;1,0;;;;;3,0;;;6,0;;;;;;;;5,0;;;;;;;;;1,0;;;;3,0;;;;;;;;;;;;;;2,0;;;;;;;;;;;;;;;;;;;;;;;;;;;;;;;2,0;;;;;;;;;;;;;;;4,0;;;;;;;;14,0;;;;;;;;;2,0;;6,0;;;1,0;;;;1,0;;7,0;;4,0;;1,0;;3,0;;;;2,0;1,0;4,0;;1,0;1,0;;;;2,0;;;;1,0;;;;;;;;;;;;;;2,0;;;;;;;1,0;;;;;;;;;;1,0;;;;;;;;;;;;;;;;13,0;;;;;;;;;;2,0;;2,0;2,0;;;;1,0;;;;;;;;;;;;;1,0;;;;;;;;;;;;;;;;;;;;;2,0;;;;;2,0;;;;;;;;;7,0;;;;;;;;;;4,0;;;;;;;;;;;;;;;;;3,0;;2,0;;;7,0;;;;;;;;;;;11,0;;;;;;;;;;;;;;;;;;;;;;;;;;;;;;;;;;;;;1,0;;2,0;;;4,0;;;;;;;;;;;;;;;;2,0;2,0;;;;;;1,0;;;;;;;;1,0;;;;;;;;;;;2,0;;;;;;;;;;;;;;;;;;;;;;;;;;;;;;;;;;;;;;;;;;;
send;;;1,0;;20,0;;;7,0;;9,0;3,0;;;;1,0;;;;2,0;16,0;;76,0;2,0;;;;;114,0;;10,0;1,0;8,0;57,0;;29,0;;;1,0;;8,0;;;;1,0;3,0;1,0;;1,0;2,0;;;9,0;1,0;;;135,0;18,0;;;39,0;;;23,0;;4,0;2,0;3,0;;1,0;5,0;;2,0;1,0;;;;;1,0;11,0;4,0;;20,0;14,0;;;;5,0;2,0;1,0;7,0;8,0;;3,0;116,0;;;;6,0;5,0;1,0;;22,0;;4,0;;4,0;;108,0;2,0;;6,0;6,0;;1,0;13,0;1,0;;;;22,0;;;;9,0;;;21,0;;;3,0;;19,0;;;;4,0;;;;;;4,0;3,0;;1,0;;2,0;7,0;1,0;;;;;2,0;;;;;1,0;7,0;;;;1,0;;;;2,0;;;1,0;3,0;7,0;3,0;1,0;;;10,0;;;1,0;;;7,0;;;;16,0;;13,0;;;;69,0;;;;;;;;;;6,0;;1,0;;;;;;;1,0;;;15,0;;;;;3,0;;;;;;6,0;;;;;;;;;;;;5,0;;;;3,0;;2,0;;8,0;;;;;;;;;;;;;;;1,0;;;;;;;;;;2,0;;;;11,0;4,0;;2,0;;;;;2,0;;;;23,0;6,0;;;;;;;;;1,0;;;3,0;;5,0;;2,0;;;3,0;;;8,0;;;;;;;;;;;7,0;;;;8,0;;;1,0;5,0;16,0;;;;;5,0;;;;;;4,0;;;;;;1,0;;2,0;;28,0;5,0;;;;;;;;;1,0;;;11,0;1,0;1,0;1,0;6,0;1,0;6,0;;;;7,0;5,0;;;;2,0;;4,0;;5,0;;;1,0;;2,0;10,0;;7,0;;3,0;;2,0;1,0;6,0;;;4,0;1,0;;;;;;1,0;10,0;1,0;4,0;3,0;;1,0;1,0;12,0;;;5,0;;5,0;2,0;25,0;12,0;1,0;2,0;;12,0;;5,0;4,0;;;2,0;;;;;1,0;;4,0;;;2,0;2,0;27,0;;1,0;;;;2,0;1,0;;;1,0;7,0;;8,0;4,0;6,0;2,0;;;2,0;25,0;1,0;;5,0;;;3,0;;;3,0;;;1,0;3,0;1,0;;;15,0;2,0;;;;3,0;;6,0;3,0;2,0;1,0;;35,0;;;;;1,0;3,0;11,0;;;;2,0;2,0;;;;;;4,0;4,0;45,0;7,0;2,0;;;2,0;;;2,0;;;1,0;1,0;;3,0;;1,0;;;;5,0;;;;2,0;1,0;;;;;;;1,0;;2,0;6,0;1,0;2,0;;;9,0;;11,0;1,0;2,0;2,0;;;;;;;;;;1,0;;;19,0;10,0;;;;2,0;;3,0;;2,0;1,0;1,0;;4,0;;4,0;;;29,0;;;;;;;;1,0;;;4,0;6,0;;;5,0;;1,0;;;;;;;2,0;1,0;3,0;;;4,0;;;;2,0;5,0;;;;2,0;;;1,0;;7,0;;;;;;;;1,0;;;;;;;;;2,0;;;;;;;;;;1,0;;2,0;;;5,0;;;;2,0;;;5,0;;;1,0;;;;;;;;;;;;;1,0;;;;;;;;;;;;4,0;;1,0;3,0;4,0;;;;;8,0;;;;;;;;2,0;3,0;4,0;;;;;;1,0;;;;;1,0;;1,0;;;;;;;;;;;;2,0;;;1,0;;;;;;;;;;;;;;;;2,0;1,0;;;;;;;;;;;8,0;1,0;1,0;;1,0;14,0;1,0;;;;1,0;7,0;4,0;;;2,0;;1,0;3,0;;;;;;;;;4,0;;;;;2,0;;;;;;1,0;;2,0;;;;;;2,0;;2,0;;;1,0;;;;;;;;;;;;;;;;;4,0;1,0;;;4,0;;;;;;;;;2,0;;;;;;;;;;;;2,0;1,0;;;;;;;;;1,0;;;;;2,0;;;;;;2,0;;1,0;;;1,0;;3,0;;8,0;;1,0;;;;;1,0;;;;;;;;1,0;;;;;;;;;;1,0;5,0;;;;;;;;;;;1,0;;;;;;;3,0;;;;7,0;;;;;;;;;;;;;;;;;;;;;;;;2,0;1,0;;;;;;;;;2,0;;;;;;;3,0;;;1,0;;;;;;;;;
sense;;;22,0;;66,0;;14,0;55,0;18,0;23,0;4,0;18,0;;16,0;48,0;2,0;2,0;2,0;33,0;9,0;4,0;98,0;2,0;;11,0;12,0;;138,0;4,0;43,0;5,0;11,0;258,0;1,0;20,0;;2,0;12,0;2,0;60,0;8,0;4,0;13,0;112,0;2,0;;2,0;2,0;12,0;5,0;7,0;46,0;1,0;;6,0;979,0;80,0;;2,0;104,0;;2,0;91,0;1,0;;;12,0;;2,0;20,0;51,0;2,0;12,0;;;4,0;1,0;2,0;73,0;9,0;;60,0;20,0;5,0;;;40,0;;8,0;5,0;209,0;6,0;4,0;135,0;4,0;21,0;;7,0;17,0;1,0;32,0;58,0;;;;1,0;9,0;400,0;;;23,0;3,0;41,0;6,0;10,0;2,0;3,0;1,0;8,0;13,0;;;4,0;24,0;;4,0;66,0;10,0;;31,0;13,0;2,0;;;1,0;5,0;9,0;;;7,0;2,0;6,0;6,0;17,0;41,0;6,0;46,0;39,0;;;1,0;;5,0;10,0;6,0;2,0;;6,0;2,0;12,0;6,0;1,0;5,0;7,0;;;32,0;119,0;;7,0;12,0;1,0;96,0;29,0;37,0;15,0;7,0;55,0;;;1,0;12,0;4,0;4,0;;12,0;1,0;112,0;;72,0;;1,0;29,0;70,0;1,0;3,0;;;23,0;;22,0;;8,0;25,0;4,0;;1,0;;5,0;6,0;1,0;3,0;;;5,0;29,0;18,0;5,0;;7,0;4,0;2,0;29,0;19,0;5,0;20,0;;;;11,0;;3,0;4,0;3,0;6,0;19,0;;6,0;83,0;2,0;11,0;;1,0;2,0;;5,0;;9,0;;5,0;;;6,0;27,0;;;;2,0;;1,0;;4,0;;1,0;;;9,0;;;1,0;1,0;;6,0;;;10,0;;;6,0;;1,0;9,0;1,0;2,0;34,0;99,0;3,0;29,0;9,0;8,0;;2,0;;4,0;3,0;1,0;2,0;2,0;;;17,0;2,0;15,0;6,0;;5,0;;21,0;;;37,0;11,0;;;4,0;1,0;;;;5,0;;;;;;7,0;;;18,0;1,0;6,0;;;3,0;;;2,0;14,0;;8,0;7,0;22,0;;14,0;3,0;2,0;2,0;1,0;5,0;8,0;5,0;8,0;;;8,0;1,0;;;;;1,0;;;2,0;10,0;2,0;;7,0;5,0;6,0;;2,0;2,0;1,0;16,0;9,0;;1,0;;1,0;3,0;2,0;1,0;4,0;2,0;;4,0;8,0;;19,0;3,0;12,0;;;5,0;;7,0;36,0;24,0;;11,0;;12,0;1,0;6,0;4,0;;18,0;;6,0;2,0;3,0;;;;22,0;9,0;;27,0;1,0;16,0;7,0;;11,0;108,0;1,0;;24,0;;28,0;;3,0;;2,0;;;2,0;;10,0;5,0;2,0;;3,0;1,0;2,0;11,0;;21,0;4,0;2,0;;6,0;25,0;7,0;;4,0;4,0;;2,0;1,0;;;;;2,0;1,0;2,0;;7,0;;;14,0;10,0;;;;23,0;1,0;;;2,0;;1,0;7,0;;1,0;10,0;;;;1,0;28,0;51,0;;33,0;14,0;1,0;20,0;;;1,0;;;;2,0;;;;;2,0;10,0;;4,0;8,0;10,0;;;;1,0;1,0;;;5,0;1,0;;;5,0;;;2,0;3,0;;13,0;;2,0;4,0;;;8,0;;;4,0;;2,0;11,0;1,0;;1,0;;3,0;;10,0;;6,0;7,0;;10,0;1,0;;7,0;72,0;6,0;;;;;24,0;;;1,0;;7,0;;1,0;1,0;;1,0;;4,0;1,0;;;52,0;;;12,0;;;;6,0;;1,0;;;1,0;2,0;;;1,0;;;;21,0;;1,0;1,0;;;;;;;1,0;;;;;;;1,0;2,0;;5,0;11,0;1,0;;;;5,0;;;;2,0;24,0;1,0;;2,0;;;6,0;;;;14,0;;;;;;3,0;12,0;4,0;;;;1,0;;;;;2,0;1,0;;;;4,0;14,0;;;;;;;;;1,0;;;;;4,0;;5,0;;1,0;;;5,0;;;;;5,0;;;;16,0;;1,0;;1,0;1,0;3,0;1,0;14,0;1,0;3,0;;1,0;9,0;;;5,0;32,0;;;14,0;5,0;;4,0;;;;;;;1,0;;2,0;;1,0;;8,0;;16,0;;;;;;3,0;;18,0;9,0;8,0;11,0;;4,0;1,0;;;2,0;;;;;8,0;12,0;;1,0;;1,0;1,0;;2,0;;;5,0;;;6,0;;;4,0;;8,0;3,0;5,0;;;;;;;;;1,0;;;;;;;;1,0;;;11,0;;2,0;;;;3,0;;;;;1,0;;;;1,0;59,0;;;16,0;;1,0;;;;3,0;1,0;;;;;7,0;;1,0;14,0;;;;;;;;1,0;6,0;;4,0;3,0;1,0;6,0;2,0;;;;1,0;18,0;6,0;1,0;;1,0;16,0;2,0;2,0;1,0;;;;;1,0;;1,0;3,0;5,0;;;;3,0;;;;5,0;1,0;;;8,0;;1,0;;;;;;3,0;;;1,0;;;5,0;;;;;;2,0;;;;;1,0;;1,0;1,0;;;4,0;;;2,0;;;;;;2,0;1,0;;;;;;2,0;;2,0;6,0;;;;;2,0;;;;;;;;;;;;1,0;;;;1,0;;;4,0;;2,0;;;;;;;;1,0;;;;;;;;;;;;1,0;;;;;;;2,0;;2,0;;;;;;;2,0;;;;;;;
separation;;;5,0;;2,0;;1,0;17,0;;2,0;;;4,0;1,0;28,0;;;;1,0;;13,0;1,0;;;;;;7,0;1,0;;3,0;7,0;4,0;1,0;2,0;3,0;;5,0;;16,0;23,0;;4,0;10,0;;;;6,0;2,0;;;3,0;1,0;7,0;;35,0;15,0;4,0;;12,0;;;9,0;;;;;;;;33,0;;;;;2,0;;5,0;4,0;;;;2,0;;;;4,0;;6,0;1,0;12,0;5,0;;12,0;;1,0;;3,0;2,0;16,0;2,0;17,0;;;1,0;;8,0;53,0;;;4,0;1,0;1,0;;;;3,0;;;;;;;;;;16,0;;;;;;1,0;;;;1,0;;1,0;;;;;3,0;1,0;;5,0;1,0;;;;;;;;;;;;3,0;;2,0;;;;7,0;;;;2,0;1,0;1,0;6,0;;;;;3,0;;;;;;;;8,0;;8,0;;3,0;;;;2,0;;;6,0;;1,0;;;;;5,0;;;;;;;2,0;;;;;;;;;;1,0;;;1,0;2,0;3,0;;;;;;;;8,0;6,0;1,0;;;4,0;;;;;;;6,0;;;;;;;4,0;1,0;4,0;;;3,0;;;;;1,0;;;;;;;;;;;1,0;;;;;;;;1,0;;;;1,0;;3,0;;;;;;;;;1,0;2,0;1,0;;;;8,0;;;;;3,0;;;;4,0;;;;;;;;;;;;;;;;;;;;5,0;;;;;;;;7,0;;1,0;;;;;;;;;;;44,0;;;;1,0;;;;;;;;1,0;;;;;;;2,0;;;;;;;;21,0;;1,0;;1,0;;;;2,0;1,0;5,0;;12,0;;;;;;;2,0;;;;;;;;3,0;;2,0;;2,0;2,0;;;;;;;3,0;;4,0;;;;2,0;;;1,0;;;;10,0;;;;;;;;;;;;;;;1,0;;;;;;;;;;1,0;;;;;;;1,0;;;;;;;;1,0;;;;2,0;;;;;;;;;;;;;;4,0;;2,0;;;3,0;;;;;;;;;;;;;;;;;;;;;;;8,0;;2,0;;;;;;;;;;;;;;;;;;;;;;;;;;;;;;;4,0;;;;;;;;;;22,0;4,0;;;;;1,0;;;;;;;;;;;;;;;;2,0;;;;;;;;;;;;6,0;;;;1,0;;;;;;;;;;;;;2,0;;;;;;;;1,0;;1,0;;11,0;;;;;;;;;;10,0;;;;;;;;;1,0;;;;;;;;2,0;2,0;;;;;;;1,0;;;;;;;;;;;;;;;;2,0;;2,0;;;;;;;;;;;;;;;;;;;;1,0;2,0;1,0;;5,0;;;;;;;;;2,0;;2,0;;;;;;;;;;;;;;;;2,0;;;;;;;;;;4,0;;;;;;;;;;;;;;;18,0;;;;;2,0;1,0;;;7,0;;;;;;;;;;;;;;9,0;4,0;;;;;;16,0;;;;4,0;;2,0;;;;;;;2,0;;;;;;;;;;;;;5,0;;;;;;;;;;;;;;;;;;;;;;11,0;1,0;;;;;;;;;;;;;;;;;6,0;;;;;;;;;;;;;;;;2,0;;;;;;;;;;;;;;;;;;;;;;;;;;;;;;;;;;;;;;;;;;;;;8,0;;;1,0;;;;;;;;;;;1,0;;;;5,0;;;;;;;;;;;;;;8,0;;;;;;;;;;;;;;;;;;;;;;;;;;;;1,0;;;;4,0;;;;;;;2,0;;;;;;;;;;;;;;;6,0;;;;
sequence;;;1,0;4,0;14,0;;2,0;24,0;5,0;74,0;1,0;2,0;;;16,0;1,0;;;1,0;5,0;;27,0;;1,0;6,0;;;75,0;1,0;54,0;2,0;39,0;25,0;1,0;44,0;1,0;;9,0;34,0;81,0;1,0;;3,0;31,0;;2,0;;;2,0;2,0;4,0;61,0;;;;516,0;38,0;1,0;;16,0;;;86,0;;6,0;2,0;17,0;;5,0;2,0;4,0;8,0;10,0;;;7,0;;22,0;15,0;3,0;;41,0;35,0;1,0;2,0;;4,0;;15,0;22,0;6,0;15,0;;37,0;;;;2,0;38,0;;;39,0;;11,0;3,0;5,0;1,0;31,0;;;1,0;5,0;3,0;2,0;;1,0;;;;1,0;;;4,0;4,0;;;31,0;;;1,0;;4,0;;;;;8,0;;;;;9,0;3,0;3,0;;;5,0;71,0;;;;;4,0;;;;;;2,0;12,0;1,0;1,0;;;;;3,0;19,0;3,0;;;1,0;21,0;2,0;1,0;;;40,0;;;;;4,0;;;1,0;1,0;38,0;;27,0;;;;42,0;;;;;;;1,0;;;3,0;;4,0;;1,0;2,0;;;2,0;;;;11,0;6,0;;1,0;;;4,0;;;;;7,0;;;;;;;;;3,0;;15,0;7,0;;1,0;;14,0;;;;1,0;;;;1,0;1,0;;8,0;2,0;1,0;;2,0;3,0;;6,0;3,0;;;1,0;;3,0;;;;;1,0;;;1,0;3,0;2,0;1,0;;1,0;;;;;;21,0;2,0;43,0;7,0;3,0;;;1,0;30,0;;;;5,0;;;;1,0;13,0;25,0;5,0;;;4,0;;;5,0;19,0;;;;;;;;;;;;;;4,0;;;;;6,0;1,0;1,0;;3,0;;;;;;;12,0;;2,0;1,0;6,0;;5,0;;22,0;;9,0;7,0;;;;;;;;10,0;2,0;;;11,0;1,0;1,0;;;;;;;1,0;14,0;46,0;11,0;1,0;;4,0;;;2,0;10,0;2,0;;2,0;;2,0;19,0;;9,0;;;1,0;2,0;8,0;47,0;7,0;;14,0;;5,0;;2,0;;2,0;8,0;;;2,0;1,0;;2,0;1,0;15,0;17,0;;56,0;;52,0;;;1,0;12,0;;;11,0;7,0;11,0;;;;17,0;1,0;;;;1,0;;;1,0;;1,0;;6,0;2,0;4,0;2,0;;;20,0;17,0;5,0;;;;1,0;38,0;1,0;;;3,0;;;1,0;;1,0;7,0;;;5,0;1,0;;1,0;1,0;;;;;6,0;;2,0;;;1,0;14,0;9,0;9,0;6,0;;1,0;;1,0;156,0;11,0;;1,0;;22,0;1,0;4,0;;9,0;2,0;;;;;;;;;8,0;;;;3,0;;;;;;;29,0;;3,0;;1,0;;;2,0;;;;;;;;;;4,0;;;1,0;8,0;5,0;1,0;1,0;;2,0;;;22,0;;;3,0;;1,0;12,0;98,0;;;6,0;;;12,0;;;1,0;;4,0;;;;1,0;;;;3,0;2,0;4,0;12,0;4,0;10,0;;2,0;;;8,0;;;;;;;;;1,0;;;;4,0;;;;2,0;2,0;;;;1,0;;;;;2,0;;;;1,0;;;7,0;;;;;;;;;;2,0;;;8,0;;;;;2,0;;;;8,0;;;4,0;;6,0;2,0;;;;;1,0;;1,0;10,0;2,0;;;;;1,0;;;;;;;;;;1,0;;;;;;;1,0;6,0;;;;1,0;2,0;;;;;;;;1,0;2,0;1,0;4,0;3,0;;1,0;;7,0;;;4,0;2,0;1,0;3,0;1,0;9,0;11,0;9,0;4,0;1,0;;;;;1,0;;;;8,0;;;;;2,0;9,0;6,0;1,0;;;;;2,0;;6,0;;;12,0;;;1,0;6,0;;;;63,0;;;;2,0;1,0;1,0;;;1,0;;;;4,0;3,0;;;14,0;;1,0;;4,0;;1,0;1,0;;2,0;;10,0;;;;;4,0;20,0;;1,0;;;1,0;;;1,0;;1,0;14,0;;;;;1,0;;;1,0;1,0;1,0;;22,0;;;2,0;1,0;5,0;;;;3,0;;;1,0;;1,0;;1,0;;;;9,0;;;;2,0;;;;;;;41,0;;;;;;;1,0;;1,0;;1,0;;;;4,0;;5,0;;;;;2,0;;;;;;1,0;2,0;;;;3,0;;;;;;8,0;;;;;;;;;;;;;;;;;;4,0;;;;18,0;;;;;;;;;;1,0;;1,0;5,0;;1,0;;;4,0;2,0;4,0;;;;4,0;10,0;;;;8,0;;;1,0;;;1,0;;1,0;;;;1,0;1,0;;;;;;;;;;;;;;;;;;;;2,0;;;;;;;4,0;;1,0;;;;;;;;;;;;;;;;;;;1,0;;;;;;;;;
sequential;;;3,0;;1,0;;;8,0;11,0;48,0;;;;;39,0;;;;2,0;2,0;;76,0;4,0;;;;;70,0;;5,0;6,0;18,0;12,0;7,0;6,0;;;1,0;;10,0;;;;1,0;;;;;;;1,0;5,0;;8,0;;108,0;3,0;;;9,0;;;17,0;;;;;;;6,0;;15,0;2,0;;;;;4,0;1,0;;;3,0;;20,0;;;6,0;;;7,0;;;13,0;12,0;;1,0;;1,0;7,0;;;15,0;;8,0;;;1,0;11,0;;;;6,0;2,0;;;;;;;;;;;5,0;;;;;;;;;;;;;;;;;;;;1,0;1,0;;;23,0;;;1,0;;;;;;;;;14,0;1,0;6,0;;;;;;11,0;;;1,0;;;;;;;4,0;;;;;;4,0;;;;18,0;;1,0;;;1,0;3,0;;;;;;;;;;;;;;;;;;;;;;12,0;;;;;;;;;;2,0;;;;;;;;;;;;9,0;6,0;3,0;;;12,0;;;;;;;;5,0;1,0;;;;;;;;;;6,0;;;;;;;;;;;;;;;3,0;;;;;;;1,0;;12,0;;5,0;;;;;;;;;;6,0;;;;;5,0;1,0;1,0;;;4,0;;;;3,0;;;;;;;;;;;;;;;;;;;1,0;;;;;;;;;;;1,0;;3,0;;8,0;;9,0;;4,0;;1,0;;;;4,0;4,0;;;;1,0;;;;;;;;;;;;;1,0;2,0;1,0;;;;;3,0;;;1,0;1,0;;1,0;;;16,0;;;;;6,0;;;1,0;;;1,0;;;;4,0;;2,0;;;1,0;;;;;;;;;;;;;;;23,0;;;14,0;;4,0;;;;;;;;;;;1,0;;;;;1,0;1,0;9,0;;;;;54,0;;;9,0;;;;;1,0;;;;;;;;;;;14,0;;;;;;;;;;;;;;;;;;;;8,0;;;2,0;7,0;;;;2,0;;;;;2,0;;3,0;;;;;;;7,0;1,0;;;;;2,0;;;1,0;;;8,0;;;;;;;;;3,0;;;;;;;;6,0;;;;;;;;;1,0;;;;;1,0;4,0;;4,0;19,0;;;;;;1,0;;;;;;;;;;;;;;;;4,0;2,0;;;;;;;;;;;6,0;;;;12,0;;;;15,0;;2,0;;;;;;;;;;;;;;;2,0;3,0;;6,0;;;;;;;;;;;;;;;;;;;;;;;3,0;;;;;1,0;;;;;;;;;;;;;;;;;;;;;;;;5,0;;;;1,0;;;;;3,0;;;;;;;;;;;;;;;;;;;;;;;;3,0;1,0;1,0;;1,0;1,0;6,0;;;;;;;;;;;;;;;;;;;5,0;;;;;;;;;;;3,0;2,0;;;7,0;;;;;;;;;;;;;;;;;2,0;;;;;3,0;2,0;;1,0;1,0;;;;;;;;;;;;;;5,0;;;;;;;;;;;;;;;;;;;;;;;2,0;1,0;;1,0;;;;;1,0;;;;;;10,0;;;;1,0;;;2,0;;;;;;;;;;;;;;;;;1,0;;;;;;;;;;;;;;;;;;;;;;;;;;;;;;;;;;;;;;;;;;;;;;;;2,0;;;;;;;;;;;;;1,0;;;;;;;;;;;;;;;;;;1,0;;;;;;;;;;;;;;;;6,0;5,0;;;1,0;;;;;;;;;;;;;;;;;;;;;;;;;;;;;;;;;;;;;;;;;;;;;;;;;;;;
server;;;2,0;1,0;36,0;;;34,0;4,0;24,0;26,0;2,0;;;;;1,0;6,0;;28,0;3,0;37,0;6,0;;;1,0;;144,0;;1,0;1,0;8,0;94,0;;31,0;;;;;20,0;;;;3,0;;;;;1,0;;;3,0;;16,0;;446,0;51,0;;;;;;19,0;;;;;;;13,0;2,0;;;;;;;;6,0;4,0;;15,0;;;;;1,0;;;17,0;;;;15,0;2,0;2,0;;21,0;45,0;;;45,0;;32,0;;;1,0;29,0;;;3,0;5,0;;;3,0;;;;;;;;;;;;22,0;;;3,0;;6,0;;;;;;;;;;;10,0;;;;;2,0;;;;;;;;;;;;18,0;;;;;21,0;;;3,0;7,0;;;;5,0;;;;;5,0;;;2,0;6,0;;1,0;;;;42,0;;4,0;;;;72,0;;;;;;;;;;1,0;;;;;;;;;;;;14,0;90,0;;;;;1,0;;;;;1,0;;;;;;;1,0;2,0;1,0;;;1,0;;;;2,0;;1,0;;;;;;;;;36,0;;;;3,0;;;;;;;;;;;;;;;;;1,0;4,0;2,0;;;3,0;;;;1,0;;;;13,0;6,0;;;;;3,0;;;;3,0;;;21,0;;4,0;;;;;1,0;;;5,0;1,0;;;;;;;;;;;;;;2,0;;;1,0;9,0;43,0;;;;;;;2,0;;;;9,0;;2,0;;;;3,0;;;;1,0;;;;;1,0;;;;1,0;;;;6,0;33,0;6,0;;;;1,0;;;3,0;6,0;9,0;8,0;;;;;;;10,0;;;;;;11,0;;20,0;;2,0;;2,0;;6,0;;;;;;;;;8,0;;6,0;;;;;;12,0;;;;1,0;;20,0;;10,0;33,0;;;;13,0;;5,0;;;;;;;;;1,0;;;;;;;4,0;1,0;1,0;20,0;;;;2,0;;;;23,0;2,0;2,0;21,0;1,0;;3,0;;;3,0;;;1,0;;;17,0;;;;;;1,0;28,0;4,0;3,0;4,0;50,0;;;;2,0;;;2,0;;;;;17,0;5,0;;;;4,0;14,0;42,0;;3,0;;;1,0;;;;;;26,0;;112,0;20,0;2,0;2,0;14,0;;;;6,0;;;3,0;2,0;;;;1,0;;;;10,0;;;;12,0;3,0;;;;;;2,0;;;19,0;1,0;;7,0;;;144,0;;1,0;3,0;10,0;2,0;22,0;;;1,0;;1,0;;;;7,0;;19,0;;12,0;;1,0;;1,0;;;;6,0;2,0;;;16,0;;;;14,0;15,0;;;;;1,0;;;;;;;;;2,0;1,0;;;;;;;;;1,0;;17,0;;;;;;;1,0;2,0;;;;14,0;;;;;;;;;;;;;;;;;;21,0;;;;;;;;;;;;;;1,0;;5,0;;;;;1,0;;;;;;;;;;;;;;;;;;;;1,0;;;;;;;;;;;;;;;;;;;;;;12,0;;;;;;;;;3,0;;;;;;;;;;;;;;1,0;;;;;;;;;1,0;;;;;;;2,0;;;;;;;;;1,0;;;;;;;;;;;;;5,0;;;;;;;5,0;;;;;;1,0;;;39,0;;;;;;;1,0;25,0;;;;;;;;;;;;;4,0;;;;;;;;;;;;;;;;3,0;;;;;;1,0;;;;;;;;;;;;;;;;;;;;;;;16,0;2,0;;;3,0;;;;;;;;;1,0;;;;;;;;;;;;;;;;;;;;;;;;1,0;;;2,0;;;;;;7,0;;;;;;;;;2,0;;;;;;;;;;;;;;1,0;;;;;;;;;;;;;;;;;;;;;;;;;9,0;;;;;;;;;;;;;;;1,0;;;;;;;;;;;;;;;;;;;;;;;;;;;;;3,0;;;;;;;;;
setting;;;23,0;8,0;61,0;;21,0;107,0;16,0;148,0;18,0;26,0;;48,0;65,0;40,0;;24,0;18,0;16,0;89,0;223,0;6,0;10,0;9,0;;;116,0;;38,0;30,0;87,0;202,0;24,0;88,0;4,0;1,0;22,0;;215,0;29,0;1,0;12,0;28,0;4,0;2,0;;42,0;154,0;11,0;38,0;49,0;6,0;10,0;9,0;553,0;145,0;;23,0;86,0;4,0;12,0;172,0;6,0;5,0;3,0;12,0;1,0;3,0;113,0;18,0;13,0;2,0;;;41,0;;32,0;110,0;21,0;1,0;58,0;47,0;2,0;8,0;;37,0;5,0;18,0;139,0;19,0;15,0;94,0;121,0;34,0;2,0;9,0;18,0;68,0;;9,0;67,0;;3,0;7,0;5,0;5,0;473,0;2,0;;13,0;10,0;9,0;3,0;8,0;18,0;;4,0;;18,0;6,0;;20,0;58,0;;1,0;82,0;4,0;18,0;5,0;8,0;15,0;1,0;;;6,0;3,0;;;6,0;3,0;3,0;9,0;19,0;11,0;;8,0;48,0;9,0;;2,0;;1,0;;13,0;1,0;1,0;2,0;21,0;58,0;1,0;12,0;;;;8,0;66,0;44,0;13,0;;24,0;8,0;28,0;;10,0;5,0;;43,0;1,0;;;;8,0;1,0;4,0;16,0;;143,0;1,0;56,0;;;;28,0;2,0;1,0;2,0;;8,0;;;5,0;1,0;2,0;;17,0;11,0;;;1,0;22,0;3,0;8,0;;26,0;120,0;21,0;2,0;;;10,0;8,0;2,0;2,0;;7,0;2,0;;1,0;;;;10,0;4,0;142,0;25,0;;4,0;211,0;8,0;1,0;;56,0;;1,0;17,0;;;;;2,0;18,0;;15,0;;;;24,0;3,0;;2,0;11,0;;;6,0;;2,0;;;;4,0;2,0;;1,0;3,0;23,0;46,0;1,0;33,0;3,0;4,0;;1,0;5,0;;14,0;12,0;58,0;46,0;;2,0;;9,0;9,0;;2,0;;65,0;;;;;47,0;;;;;93,0;;;36,0;6,0;;;2,0;;;;;3,0;;;;1,0;;6,0;;;10,0;;86,0;2,0;3,0;;;;1,0;3,0;4,0;2,0;;21,0;1,0;26,0;9,0;4,0;10,0;3,0;1,0;73,0;4,0;18,0;3,0;6,0;5,0;6,0;1,0;1,0;1,0;;6,0;5,0;;;10,0;20,0;1,0;1,0;13,0;3,0;;;10,0;5,0;19,0;16,0;1,0;6,0;;;38,0;6,0;4,0;15,0;15,0;1,0;6,0;16,0;2,0;27,0;9,0;32,0;1,0;18,0;33,0;31,0;12,0;32,0;85,0;1,0;29,0;;5,0;;5,0;5,0;25,0;120,0;2,0;6,0;2,0;9,0;;;5,0;5,0;5,0;;30,0;;12,0;1,0;;6,0;394,0;3,0;30,0;14,0;11,0;24,0;6,0;;8,0;8,0;7,0;3,0;;11,0;14,0;1,0;21,0;2,0;3,0;1,0;19,0;13,0;54,0;5,0;13,0;;1,0;8,0;22,0;34,0;;16,0;2,0;2,0;27,0;2,0;10,0;;10,0;5,0;3,0;14,0;4,0;1,0;161,0;;110,0;46,0;;;6,0;;43,0;2,0;2,0;6,0;18,0;;3,0;11,0;;4,0;59,0;15,0;6,0;;8,0;77,0;17,0;7,0;51,0;47,0;3,0;31,0;;;11,0;23,0;1,0;2,0;72,0;3,0;37,0;2,0;4,0;;1,0;;;4,0;23,0;8,0;;5,0;7,0;;;;2,0;;;19,0;8,0;;;2,0;1,0;;;;5,0;21,0;2,0;2,0;;;;1,0;2,0;;7,0;7,0;1,0;2,0;3,0;;8,0;1,0;;14,0;12,0;;4,0;;1,0;8,0;41,0;3,0;1,0;7,0;;;6,0;12,0;1,0;6,0;1,0;6,0;2,0;;;;1,0;3,0;;;;;23,0;5,0;6,0;2,0;;;;4,0;1,0;;;2,0;;2,0;;;3,0;2,0;;;141,0;;;;3,0;1,0;;1,0;;3,0;;;;2,0;3,0;4,0;;1,0;22,0;;48,0;1,0;;;;;4,0;;;;9,0;20,0;;;8,0;;13,0;;;7,0;;;;;6,0;1,0;4,0;;17,0;5,0;;;;;;;3,0;4,0;7,0;;1,0;;;;2,0;;;1,0;3,0;;7,0;;9,0;4,0;;78,0;;;1,0;1,0;7,0;49,0;1,0;;;2,0;20,0;3,0;;1,0;;9,0;13,0;2,0;;17,0;10,0;4,0;13,0;;8,0;4,0;3,0;;2,0;;10,0;8,0;1,0;;2,0;44,0;;4,0;14,0;5,0;2,0;;;;;2,0;;;;;;;23,0;15,0;9,0;13,0;;;;2,0;4,0;;6,0;5,0;2,0;19,0;;3,0;5,0;1,0;;;;1,0;;6,0;;;2,0;3,0;4,0;16,0;3,0;14,0;13,0;5,0;5,0;;;6,0;7,0;2,0;24,0;1,0;;3,0;;14,0;7,0;3,0;11,0;;1,0;3,0;;7,0;;;19,0;6,0;;;2,0;;8,0;5,0;3,0;5,0;;;1,0;;1,0;;2,0;;;32,0;;3,0;7,0;5,0;4,0;5,0;3,0;13,0;;2,0;3,0;6,0;;;2,0;3,0;1,0;5,0;10,0;8,0;;;;1,0;;11,0;7,0;;;1,0;6,0;5,0;5,0;;;12,0;5,0;1,0;;3,0;1,0;2,0;;;4,0;;2,0;;1,0;;2,0;;1,0;;12,0;5,0;2,0;;1,0;;;;2,0;;3,0;;3,0;;;;4,0;;;3,0;2,0;;;;;;;;2,0;2,0;;;;5,0;;;;2,0;18,0;5,0;12,0;;;;;;;;3,0;;2,0;;;30,0;;3,0;15,0;;;;4,0;;;;5,0;3,0;1,0;;;;1,0;3,0;3,0;;6,0;3,0;4,0;1,0;;;;;;4,0;;;3,0;;;2,0;;;;;;;;;;;6,0;;;2,0;;;;18,0;1,0;4,0;;3,0;;3,0;;;3,0;;2,0;;;;1,0;;;;;2,0;;;1,0;;;;3,0;;3,0;;;
shade;;;1,0;;19,0;;;16,0;5,0;;;28,0;;;5,0;;3,0;;;5,0;1,0;1,0;;2,0;9,0;;;38,0;;37,0;3,0;7,0;24,0;3,0;4,0;;;;;6,0;;;;2,0;8,0;;;;1,0;8,0;;1,0;;2,0;;47,0;9,0;;;67,0;;;29,0;;13,0;;;;2,0;;1,0;;;3,0;;;;14,0;;;12,0;16,0;3,0;;;;5,0;;;1,0;6,0;;;2,0;;;;;2,0;;11,0;3,0;;3,0;;;1,0;12,0;;;;4,0;;;;3,0;;;;;;;;6,0;;;;;1,0;;;;;;;10,0;;;;;;;1,0;;;;8,0;2,0;1,0;;;;1,0;;;1,0;;;5,0;12,0;;;;;;9,0;13,0;22,0;;;12,0;;10,0;;;3,0;;6,0;;;;;;;;;2,0;13,0;;9,0;;;;;2,0;12,0;;;;;;2,0;;;;1,0;;;4,0;;;1,0;;;;;;;;;;;;;;;;;;;;;;;;;;1,0;10,0;;;;1,0;;;;;;;;;;;;;;;1,0;;;;6,0;;;;;;2,0;;;;1,0;;;;;;;;1,0;;;;4,0;;1,0;;10,0;;;;;;1,0;;;;20,0;;;;;8,0;2,0;;;;1,0;;;;2,0;;;;;;;;;2,0;;;;;;;;;;;;;;;;;;;;;2,0;;;;;;;;;;;;;;;9,0;;;;;;;;12,0;29,0;;;;;;;;1,0;2,0;4,0;;2,0;;;;;;;;;;;2,0;;;;;;2,0;;;;5,0;;;;;1,0;;;;;;;;;;4,0;;;;;;;;;;;;;;;;;;;;;;;;;1,0;;;2,0;;;;;1,0;;;;;;1,0;;1,0;;;;;;;;;;;;;;;;;3,0;;;2,0;;;;;;;;;;;;;;;2,0;;;;;;;;;;;;;;;4,0;;;;;;;;;;;;;;;;;;4,0;;;;;;;;;;1,0;;;;;;;;;;;;;;;;;;9,0;;2,0;;;;;;;;16,0;;;;;;;;;;;;;;;;;;;;;;8,0;;;1,0;;;;;;;;;;;;;;;;;;;;;;;;;;;;;;;;;;;;;;;;;;;;;;;;2,0;;;12,0;1,0;;;;;;;;;;;;;2,0;11,0;;1,0;;;;;;;8,0;;;;;;;;;;;;;;1,0;;;;;;;;1,0;5,0;21,0;;;;;;;;2,0;;;;;;;;;;;;;;;;;;;;;;;;;;;;;;1,0;7,0;;;;;;;;;2,0;;;;;;;;;;;2,0;4,0;;;;;;;;;1,0;;1,0;;;;;;;5,0;;;;;;;;3,0;;2,0;;;;2,0;;;;;;;;;;;;;;;;;;;;;;;;;;;;;;;;;;;;;;;;;;;;;;;;;;;;;;;;;;;;1,0;;;;;;2,0;;;;;;;;;;;;;;;;;1,0;;;;;;;;;;;;;;;;;8,0;;;;;;;;;;;;;;;;;;;;;;;1,0;;;;;;;;2,0;;;;;;;;;3,0;;;;1,0;;;;;;;;;;;;;;;;;;;;;;;;;;;;;;3,0;;;;;3,0;;;;;;;;;;;;;;;;;;;;;;;;;;;;;;;;;;;;;;;;;;;;
shaft;;;3,0;;28,0;;104,0;82,0;;1,0;40,0;;7,0;1,0;;1,0;;1,0;5,0;;3,0;5,0;;;7,0;;;;5,0;;3,0;4,0;55,0;;8,0;;2,0;79,0;;11,0;8,0;;146,0;50,0;;;4,0;;1,0;;6,0;3,0;;15,0;;24,0;75,0;;3,0;80,0;11,0;;9,0;;;97,0;33,0;;;11,0;73,0;;3,0;40,0;3,0;2,0;3,0;8,0;37,0;19,0;4,0;3,0;4,0;;;;2,0;4,0;;2,0;3,0;6,0;;1,0;2,0;10,0;;;;1,0;60,0;34,0;;4,0;;;;81,0;;;3,0;18,0;;19,0;13,0;;33,0;;2,0;76,0;1,0;1,0;;5,0;;;51,0;8,0;;72,0;17,0;;;50,0;3,0;;48,0;;;;;;2,0;6,0;;27,0;65,0;36,0;;;;18,0;175,0;;31,0;29,0;59,0;14,0;;5,0;;1,0;70,0;5,0;3,0;;3,0;;;3,0;319,0;3,0;30,0;52,0;13,0;22,0;20,0;39,0;;;2,0;;16,0;;143,0;19,0;25,0;5,0;;148,0;;6,0;;31,0;;;;11,0;115,0;21,0;;16,0;4,0;62,0;2,0;1,0;;10,0;2,0;132,0;;3,0;;;85,0;;14,0;;1,0;;8,0;;;;4,0;;;;2,0;29,0;1,0;;6,0;5,0;3,0;25,0;10,0;3,0;;;10,0;32,0;2,0;4,0;7,0;8,0;5,0;;14,0;4,0;2,0;1,0;;47,0;5,0;3,0;14,0;12,0;;;2,0;64,0;2,0;8,0;82,0;13,0;60,0;3,0;;6,0;2,0;15,0;1,0;4,0;38,0;;;12,0;9,0;3,0;13,0;8,0;;121,0;;8,0;27,0;2,0;14,0;27,0;;8,0;2,0;;;9,0;;3,0;7,0;;17,0;;9,0;3,0;6,0;;5,0;2,0;14,0;21,0;;8,0;8,0;6,0;28,0;;68,0;8,0;11,0;;;;;13,0;;2,0;;25,0;5,0;1,0;;;6,0;;;;3,0;;;1,0;;3,0;7,0;3,0;1,0;1,0;;;6,0;;9,0;;;;;;;;;;;;;;;;;;;;;;;;;;;;;40,0;;3,0;;;;;;;;;9,0;;123,0;;7,0;1,0;1,0;;;;;;;;;;1,0;1,0;1,0;;3,0;11,0;;;;;;;17,0;;;;;1,0;;;;;;;;;;;;;;;;1,0;1,0;;;;1,0;;;;;1,0;;;;2,0;3,0;;;;;;;;;;;;39,0;;;;;1,0;3,0;;;;1,0;;;;;;;;;84,0;;1,0;;;;1,0;;16,0;9,0;;;4,0;;;4,0;;;;15,0;10,0;;56,0;;1,0;7,0;;;;2,0;23,0;;;;;;;;;;;2,0;12,0;;;;;2,0;;;;13,0;8,0;;;;;;13,0;4,0;;21,0;;;;;;;;;3,0;;;7,0;;;;;;2,0;;23,0;;;;3,0;;;;3,0;1,0;5,0;;;;;;4,0;;;5,0;49,0;;;;;;;1,0;;1,0;2,0;;;24,0;;;;;19,0;;;35,0;;;51,0;4,0;1,0;;;;4,0;;1,0;;;;;4,0;;;;;27,0;2,0;;2,0;3,0;1,0;;27,0;2,0;10,0;27,0;1,0;7,0;;;36,0;;;;1,0;;;;;;13,0;41,0;8,0;8,0;;1,0;1,0;;;;;;;;8,0;;1,0;;;3,0;;6,0;;;;;;;;;;;;;;;;;2,0;;;;;;6,0;;;;;;;;;;;;;;5,0;;;;;;1,0;;;;;9,0;;;;;;;;6,0;;;;;;;;1,0;2,0;;;;;;;;;;;;6,0;;;;1,0;4,0;;;5,0;;;;;;1,0;12,0;;;;;;;;;17,0;;2,0;2,0;;;;;3,0;;;;;;;;1,0;;;1,0;;;32,0;;;;;;8,0;;;;;1,0;;;;;;;;;;;;;;2,0;;;;;;;;;;;1,0;;;;;3,0;;;;1,0;;;;;;;32,0;8,0;4,0;;;;;1,0;10,0;3,0;2,0;14,0;;;7,0;;;;;;1,0;;2,0;;;12,0;;;;;;;;;85,0;30,0;;3,0;;4,0;;;;;;;;;;;1,0;;3,0;3,0;1,0;2,0;;;;;;;;;;;2,0;;;10,0;;;;;;;;;;;41,0;;;;;;;;;;;;;;;;;;1,0;;;;;;3,0;;2,0;;;;3,0;;;;;;;;;;;;;2,0;;;;;;;;;;1,0;;;;;;;;;;;;;;;;;
shake;;;122,0;;106,0;;24,0;22,0;5,0;19,0;1,0;;;;;13,0;12,0;7,0;12,0;2,0;8,0;71,0;2,0;139,0;290,0;;;24,0;;330,0;139,0;16,0;107,0;6,0;28,0;;;69,0;;;;;8,0;8,0;;3,0;;;2,0;;56,0;1,0;;;;213,0;19,0;;;122,0;;1,0;28,0;;;1,0;20,0;;7,0;31,0;48,0;;2,0;1,0;;;4,0;6,0;8,0;;4,0;24,0;1,0;20,0;;;4,0;;1,0;20,0;109,0;10,0;13,0;11,0;;1,0;;2,0;3,0;1,0;3,0;62,0;;;;;;160,0;;;;3,0;;;2,0;;;;14,0;65,0;;;;4,0;1,0;;49,0;;;;3,0;;;;;85,0;1,0;;;;;;;4,0;10,0;;1,0;9,0;;;;;2,0;;1,0;1,0;2,0;16,0;;36,0;;;;;;;2,0;1,0;;;13,0;1,0;9,0;4,0;26,0;;;15,0;;;;;;1,0;;6,0;4,0;15,0;;11,0;;;;;;;;;;5,0;;;;3,0;;1,0;45,0;7,0;;4,0;;;;;5,0;31,0;2,0;;;;;;8,0;;;;2,0;;;;1,0;17,0;20,0;;;;;14,0;3,0;6,0;;;2,0;;;;;;;29,0;;;;2,0;;;;;6,0;;;31,0;;;;;;;;;;1,0;;;;1,0;;;;;;9,0;2,0;44,0;;11,0;2,0;11,0;3,0;4,0;;;;;;1,0;;24,0;;;;;30,0;;;;;3,0;;;5,0;;;;;;;;;;;14,0;;;;;;;2,0;;1,0;;;;;;;;1,0;19,0;;1,0;;19,0;48,0;;4,0;1,0;;;;1,0;6,0;2,0;;;;5,0;;;2,0;;;;;3,0;;;12,0;;;;14,0;;;;;;;;12,0;11,0;1,0;1,0;;3,0;;;;1,0;;1,0;4,0;;12,0;5,0;2,0;;6,0;;;;;;;17,0;;16,0;;2,0;;;;;;;;;4,0;;;;;1,0;6,0;;3,0;2,0;;;;;;2,0;;;;;;;;;;;2,0;44,0;2,0;1,0;;;;4,0;5,0;;;;;;1,0;;;;;;;;9,0;;4,0;;;49,0;;;;1,0;3,0;;;1,0;;;;;;;;1,0;4,0;2,0;;4,0;;;2,0;2,0;4,0;7,0;;;;;;;;;;;;1,0;;;;;;;;;;;;;;;;;16,0;;;;;;;;;;;24,0;;;;1,0;;;;;;1,0;;;;;;;;;;;;1,0;2,0;;1,0;;;;5,0;;;;;;;;;1,0;;;;1,0;;;13,0;;;;;;;;;;;;;;;;;;;;7,0;;;;13,0;;;1,0;;;;;;;;;;;2,0;;6,0;;;;;;;;;1,0;;;;;;;;;;;;;;;;;;;;;;;;;;;;;1,0;;;;;1,0;;;;;;;;;;;;;;;;;;;;;;;;;;2,0;;;;;;;;8,0;;;;;;;;1,0;2,0;;;;;7,0;;;;10,0;;;;;;;;;;;;;;;1,0;2,0;;;;;;;;;;;;1,0;4,0;;;;;12,0;;;;;;1,0;;;;;;;;1,0;;;;1,0;12,0;;;;;;;;;;;;;;;;17,0;;;;;;;;;;3,0;;2,0;;;;;;;;;;;;;;;;1,0;;;;7,0;;;2,0;;1,0;;;;;;;;4,0;;;;;;;;;;;1,0;;;;;;;;3,0;;;;;;;;1,0;;;;;2,0;;;;;;;;;;3,0;2,0;;;;;;;;;;;;;;;;;;;;;;;;;;;;;;;;;;;4,0;;;;;;;;;;;;;;;;;;;;;1,0;;;;;;;;;;;;;;;;;;;;;;;;;;;;;;;;;;;;;;;;;;;;;;;;;;;;;;;;;;;;;;;;;;;;;
shutter;;;8,0;;35,0;;20,0;85,0;10,0;64,0;20,0;;;3,0;;2,0;3,0;6,0;6,0;1,0;1,0;216,0;4,0;16,0;1,0;;1,0;21,0;1,0;40,0;7,0;42,0;292,0;;84,0;;2,0;59,0;3,0;15,0;10,0;;175,0;66,0;;;;12,0;15,0;;56,0;20,0;;14,0;;315,0;100,0;;5,0;176,0;;;59,0;;1,0;24,0;35,0;;5,0;199,0;52,0;8,0;10,0;;;1,0;3,0;5,0;133,0;6,0;2,0;11,0;12,0;4,0;;;4,0;;1,0;25,0;54,0;;14,0;137,0;5,0;8,0;;3,0;22,0;2,0;47,0;120,0;1,0;;;31,0;18,0;201,0;;;15,0;37,0;19,0;94,0;7,0;2,0;;;8,0;26,0;;;2,0;20,0;;;97,0;15,0;4,0;36,0;27,0;;29,0;;2,0;30,0;31,0;;1,0;8,0;;;13,0;9,0;60,0;19,0;38,0;25,0;;2,0;;2,0;18,0;1,0;9,0;3,0;8,0;22,0;10,0;67,0;12,0;1,0;3,0;3,0;;3,0;5,0;86,0;;8,0;70,0;64,0;120,0;23,0;7,0;135,0;;17,0;3,0;;15,0;10,0;25,0;22,0;45,0;16,0;35,0;63,0;;93,0;2,0;;;21,0;1,0;19,0;;;41,0;7,0;;12,0;8,0;30,0;1,0;1,0;6,0;2,0;5,0;23,0;;10,0;;;;83,0;12,0;9,0;27,0;;2,0;1,0;9,0;;15,0;2,0;1,0;;5,0;;4,0;17,0;37,0;5,0;24,0;2,0;3,0;12,0;8,0;;14,0;;13,0;;2,0;9,0;6,0;3,0;;7,0;;;;57,0;;;;14,0;1,0;;1,0;73,0;;2,0;42,0;;18,0;;;1,0;;16,0;2,0;3,0;4,0;;3,0;33,0;3,0;32,0;5,0;33,0;73,0;132,0;;11,0;45,0;15,0;31,0;18,0;2,0;2,0;9,0;8,0;6,0;4,0;3,0;31,0;;5,0;2,0;5,0;19,0;4,0;4,0;;;12,0;7,0;3,0;1,0;7,0;3,0;3,0;;1,0;9,0;2,0;;;;5,0;7,0;;;27,0;10,0;10,0;3,0;;28,0;28,0;;1,0;;2,0;1,0;1,0;1,0;2,0;1,0;12,0;;;;3,0;5,0;2,0;1,0;6,0;73,0;27,0;;1,0;;5,0;;;;3,0;;2,0;;1,0;3,0;;1,0;;1,0;;10,0;;;9,0;;11,0;;;;;40,0;17,0;2,0;;3,0;13,0;1,0;1,0;;22,0;167,0;42,0;13,0;;;256,0;34,0;4,0;8,0;;;;4,0;;;;15,0;9,0;3,0;7,0;13,0;11,0;;2,0;;1,0;1,0;;24,0;5,0;24,0;;;4,0;29,0;4,0;;6,0;1,0;18,0;1,0;;;14,0;3,0;1,0;;;1,0;;229,0;;1,0;2,0;2,0;34,0;2,0;4,0;4,0;24,0;;10,0;31,0;19,0;8,0;;;5,0;21,0;;8,0;;1,0;1,0;;3,0;30,0;5,0;11,0;;;67,0;;;;2,0;;;;2,0;20,0;;;27,0;;20,0;3,0;6,0;;33,0;5,0;79,0;3,0;37,0;5,0;4,0;8,0;3,0;;1,0;1,0;;;2,0;168,0;;;3,0;;16,0;;;;;6,0;4,0;;;;2,0;;;;1,0;;1,0;14,0;;5,0;4,0;2,0;;23,0;;1,0;6,0;2,0;7,0;;;;;6,0;9,0;;;;;;;;;;;;1,0;15,0;;;1,0;30,0;;;3,0;1,0;;7,0;;;;3,0;;;;;;;4,0;;;;;16,0;3,0;;12,0;;;3,0;;54,0;1,0;;;;144,0;1,0;;5,0;;;;101,0;8,0;5,0;4,0;;;;;;2,0;;;;3,0;51,0;2,0;;;4,0;;7,0;11,0;;;1,0;;2,0;;;15,0;1,0;2,0;1,0;;6,0;329,0;;2,0;;2,0;1,0;;;;;;;3,0;1,0;7,0;;7,0;;1,0;;;;;;2,0;;;;6,0;12,0;;;1,0;;;;3,0;;;1,0;;;;1,0;6,0;;5,0;;;;5,0;;;;11,0;2,0;;2,0;;18,0;;5,0;1,0;11,0;1,0;;;;;1,0;1,0;;12,0;8,0;;1,0;4,0;3,0;23,0;;33,0;;1,0;31,0;;2,0;1,0;;1,0;;6,0;;;8,0;;5,0;;;1,0;;;;;;44,0;;;;1,0;1,0;3,0;;;;;;2,0;;;;5,0;1,0;20,0;5,0;9,0;;1,0;2,0;;;;;10,0;1,0;1,0;;;;;1,0;2,0;1,0;;;;;3,0;;;;36,0;;;5,0;;;;;;;;;4,0;;;;;;4,0;;;;;;2,0;;;6,0;8,0;;;;;;1,0;1,0;;1,0;;;;10,0;5,0;22,0;1,0;8,0;;2,0;;;;23,0;2,0;;;4,0;40,0;;;;;;19,0;36,0;;;;;;;12,0;8,0;1,0;;;44,0;;;;2,0;;;;6,0;;;;1,0;2,0;8,0;;;;;;112,0;;21,0;2,0;5,0;;;;;;;;1,0;;2,0;;;30,0;;;;;;;;;;;;;;2,0;;;;;8,0;;;;;;;6,0;3,0;;;;;;4,0;;;;;;11,0;;;2,0;1,0;;;;;;;;3,0;;5,0;1,0;;;;;2,0;1,0;;;;;;;;;;;;1,0;;;;;;;2,0;;;;;;;;;;;;;;;;;;;;;
sign;;;10,0;;1,0;;1,0;1,0;;;;5,0;;5,0;;;;;;;;;;;;;;5,0;;4,0;2,0;4,0;8,0;;;;;2,0;1,0;1,0;3,0;;;33,0;;;;;;;1,0;;;;;13,0;4,0;;1,0;31,0;;;5,0;;;3,0;1,0;;;;40,0;;1,0;;;;;2,0;8,0;40,0;;;;;;;;;;;;;;4,0;;;;3,0;3,0;;17,0;;;;;;;5,0;;;;;;12,0;;;;;;;;;1,0;;;;2,0;;;;;;;;;;;;;;;;2,0;;;;;1,0;;;;;;;;;;;;;;;;;;;;;;;;;;4,0;;9,0;;34,0;;;;;;;;;;;;2,0;;;;;;;;;2,0;;;2,0;;;;;;;;1,0;;;;;;2,0;;;;;;6,0;;;;;;;;;;;;;;3,0;;;1,0;;;;;;;;;;;;;;;;;;;;;;;;;;;;;;;;;;;;;;;;9,0;;;;;1,0;;;;1,0;;2,0;;;;;;;;3,0;;;;;1,0;;;;;1,0;;;;;1,0;;;;;;;;;;;;;;;;;;;;;;;;;6,0;;8,0;;;;8,0;;;1,0;;;;2,0;;;20,0;;;2,0;1,0;;;;;;;;1,0;;;8,0;;;;;;;1,0;;;;;;;;;;;1,0;;;1,0;;;;;;;;;;;;2,0;;;;;;10,0;;;;;;;;;;;;;;;;;;;;;;;;;;;;;;;;;;;;;;;;;;;;;2,0;;;;;;;;8,0;;;;;;;;2,0;;;1,0;;;;;;;3,0;;;;;;17,0;;;;;;1,0;;;;1,0;5,0;1,0;;;;;;;;;;;;;;;;;;;;;;1,0;;;;;;;;;;;;;;;;;;;;;;;;;;;;;;;;3,0;;;;;;;;;;3,0;;;;;1,0;1,0;;;;;;;;;;;;;;;;1,0;;;;;;;;;;;;;;;;;;;;;;;;;;;;;;2,0;;;;;;;;;;;;;;;;;;1,0;1,0;;;;;;;;;;;;;;;;;2,0;;2,0;;;;;;;;;;;;;;;;;;;;;;;;;1,0;;;;;;;;;;;;;;;;;;;4,0;;;;;4,0;1,0;;;;;;;;;;;;;;;;;2,0;;;;;;;;;;;;;;;;1,0;;;;;;;;;;;;;;;;;;;;;;;;;;;;;;;;;;;;;;;1,0;;;;;;;;;;;;;;;;;;;;;;;;;;1,0;;;;;;;;;;;;2,0;;;;;;;;;;;;;;4,0;;;;;;;;;;;;;;;16,0;;;;;;;;;;;;;;;;;;;;;;;1,0;;;;;;;;;;;;;1,0;;;;;;;;;;;;;;;;;;;;;;;;;;;;;;;;;;1,0;;;;1,0;;;;;2,0;;;4,0;;;;;;;;;;;;;;;;;;;;;;;;;;;;;;;;;;;;;1,0;;;1,0;;1,0;;10,0;;;;;;;;;;;;;;;;;;;;;;;;;;;;;;;;;;
similarity;;;9,0;;3,0;;2,0;26,0;28,0;1,0;;1,0;;2,0;4,0;;;;;;;;2,0;;1,0;3,0;;4,0;99,0;1,0;;12,0;5,0;1,0;;;;;;5,0;4,0;;;;;;;;2,0;;1,0;17,0;;;;49,0;1,0;;;;;;4,0;;;;;;;;;;;;;;;4,0;10,0;;;;2,0;;;;8,0;1,0;;4,0;;;;;;;;2,0;1,0;;2,0;4,0;;;4,0;;;54,0;;;;1,0;;;;;;;;;;;;2,0;;;;;;;;;;;;;;;;;;;;1,0;;;;38,0;;;;;;;;;;;;4,0;;;;;;;69,0;;;;;;;;;;;;;;;;;;;;;4,0;;7,0;;;;;3,0;;;;;;;1,0;;;;3,0;;;;;;;;;;13,0;;;;;;;;;;;;;;;;;;;;;;2,0;8,0;;;;23,0;;;;;;;;;;;;;;;1,0;;;;;5,0;;;;;;;2,0;;;;;;;;;;;;;;;;;;5,0;;;;;;;;;;;;;;;28,0;;;;;4,0;;;6,0;1,0;;;;;;;;;;;;;;1,0;;;;;;;;;;;3,0;;;;;;;;;;25,0;;;;1,0;;17,0;1,0;2,0;2,0;;;;;;;;;;20,0;3,0;;;;2,0;;;;;4,0;;;;;;;;;;2,0;;6,0;;;;6,0;;;;;;;11,0;3,0;;;;;4,0;;;;;;;;;10,0;;1,0;5,0;;7,0;;;;;;;;;;;;;;;;;;;;;;;4,0;;;;4,0;;;;;;;;;;;;;;;2,0;;;;;;;;;;;12,0;;;;;;;;;;;;;;;;;;;;;;;;3,0;;;;;;;2,0;1,0;;;;;;;;;;;;;;;;;;;;;;;;;;;;;;;;;;1,0;;;;;;;;;;;;;7,0;;;;;;;;;;11,0;;;2,0;;;;;;;;;;;;;;;;;;;9,0;;;;;;1,0;2,0;;;;;;;;;;;;;;;;;;;;;;;;;;;;;;;1,0;;;;;;;;;;;;;;;;;;;;;;;;;;;;;;5,0;;;;;;;;;;;;;;;;;;;;;;;;;;;7,0;;;;;8,0;;;;;;1,0;;;;;;5,0;;;;;;;;;;4,0;;;;;;;;;;;;;;;;;;;;;;1,0;;;;;;5,0;;;;1,0;2,0;;;;;;;;;4,0;;;;;;;;16,0;4,0;;;;1,0;2,0;;;;9,0;;;;4,0;;34,0;;;;1,0;;;;;;;;;1,0;;;8,0;;;;;;;;;;;;1,0;;;;;;;;;2,0;;;;;;;;;;;;;1,0;;;;;;;;;;;;;;;;;;;;;;;;;;;;;;;;4,0;;;;;;;;;;;;;;;;;;;;;;;;;;;;;;;;;;;;;;;;;;;;;;;;;;;;;;;;;;;;;;;;;;;;;;;;;1,0;;;;;;;;;;;;;;;;;;;;;;;;;;;;;;;;;;;;;;;;;;;;;;;;;;;;;;;;;;;;;;;;;;;;;;;;;;
slide;;;6,0;;21,0;;29,0;32,0;;;2,0;;1,0;;;;;;11,0;1,0;1,0;16,0;;;1,0;;1,0;4,0;4,0;;1,0;1,0;39,0;;13,0;;;114,0;9,0;9,0;4,0;;5,0;13,0;;;;;4,0;;1,0;1,0;;24,0;1,0;37,0;34,0;;8,0;81,0;6,0;1,0;3,0;;;4,0;28,0;;;6,0;24,0;;4,0;1,0;;;;5,0;64,0;3,0;7,0;2,0;2,0;;;;;4,0;;3,0;12,0;;;1,0;;4,0;;1,0;7,0;;69,0;4,0;;;;;3,0;22,0;;;16,0;11,0;;32,0;26,0;;13,0;;4,0;64,0;;40,0;;;;;39,0;33,0;;34,0;53,0;;;6,0;3,0;;19,0;38,0;;3,0;;;10,0;22,0;1,0;16,0;42,0;40,0;;;;129,0;73,0;;5,0;38,0;23,0;38,0;1,0;9,0;1,0;;6,0;2,0;;;;6,0;;;230,0;5,0;49,0;48,0;35,0;18,0;16,0;;4,0;;31,0;2,0;2,0;;15,0;8,0;37,0;9,0;;99,0;;26,0;;13,0;1,0;1,0;;;4,0;9,0;;9,0;5,0;4,0;18,0;1,0;3,0;4,0;1,0;30,0;;;;;;;3,0;;2,0;;;2,0;1,0;;7,0;;1,0;;;8,0;14,0;;19,0;3,0;14,0;2,0;1,0;2,0;1,0;;21,0;20,0;3,0;8,0;2,0;4,0;1,0;;1,0;6,0;2,0;;;20,0;;;5,0;8,0;2,0;;;22,0;;5,0;16,0;2,0;33,0;1,0;2,0;1,0;1,0;12,0;;2,0;10,0;2,0;;6,0;3,0;8,0;12,0;5,0;;27,0;;17,0;24,0;5,0;4,0;17,0;;;1,0;;;7,0;;1,0;;6,0;16,0;1,0;5,0;8,0;4,0;;10,0;;7,0;61,0;;;7,0;;1,0;;;;10,0;2,0;;;13,0;;21,0;1,0;;10,0;1,0;1,0;3,0;1,0;;;;;1,0;;;1,0;;;;1,0;;1,0;;1,0;;1,0;17,0;;;;;;;;;;;;;;;2,0;;;;;;1,0;;;1,0;;;;;14,0;;2,0;;1,0;;;2,0;;;;1,0;1,0;;;;;1,0;;;;3,0;;;;;;;2,0;;1,0;2,0;5,0;;;;;;;2,0;;2,0;;;;;;;;;;;;;;;;;;;6,0;4,0;;;;;;;2,0;;;;8,0;;;;;;;5,0;;;;;2,0;;2,0;12,0;;;;;3,0;;;;;1,0;;;;;;;;;10,0;3,0;;;1,0;;5,0;;;6,0;2,0;4,0;;;;;;;;6,0;;;6,0;;8,0;7,0;;;;;1,0;3,0;1,0;;;;3,0;;;;;5,0;1,0;;;1,0;;4,0;;5,0;;;;;;;;;6,0;;;3,0;;;;;1,0;;;;6,0;2,0;;2,0;;;;;;1,0;6,0;36,0;5,0;1,0;;;;;;4,0;;36,0;;;;;;1,0;;;9,0;1,0;;;;;;;;;;;5,0;;;;;;;;;;;;;1,0;1,0;;;;;;;;;;;;12,0;;2,0;1,0;;2,0;;;1,0;3,0;2,0;1,0;16,0;;;2,0;;;;6,0;;;;;;;;;;;16,0;2,0;;;7,0;;;;2,0;;;;;;4,0;;;;;;;3,0;;;;;;;;;;;;;1,0;;;1,0;1,0;;;;;;1,0;;;;;;;;1,0;;;;1,0;;;;;;;;1,0;;2,0;;;;;;1,0;;;;;15,0;;;;;2,0;;;;;;;;;;;1,0;;;;;;;;;;;;1,0;1,0;;;;;;1,0;10,0;;;1,0;;;;;;1,0;;;;;;;;;;;;;;;;;;;4,0;;;;;;;;;12,0;;;;;;;;;;;;;;;;3,0;;;;;;;;;;5,0;1,0;3,0;;2,0;3,0;;;;;;;1,0;1,0;;;1,0;;;;2,0;5,0;;;;;;1,0;;;;5,0;;;4,0;;;2,0;2,0;;1,0;;;;;2,0;;;;;;;;;5,0;1,0;;4,0;;;;;;;;;;;;;6,0;;3,0;1,0;;1,0;;1,0;;;;;;;;;;;;2,0;;;;;;;;;;;7,0;;;1,0;;;;;;;;;;;;;;;;;;;;;1,0;;;;;2,0;;;;;;;;1,0;;3,0;;;;2,0;;;;;;;;;;;;;;4,0;;;;;;;;;9,0;;;;
software;;;2,0;1,0;15,0;;;4,0;2,0;5,0;;4,0;;;4,0;1,0;;;33,0;20,0;4,0;13,0;;1,0;3,0;;;24,0;;5,0;5,0;12,0;36,0;;11,0;;;3,0;;11,0;;;;;;4,0;7,0;;1,0;;4,0;6,0;;1,0;;33,0;20,0;;;5,0;;;22,0;;1,0;;;;;6,0;2,0;1,0;1,0;12,0;;;;2,0;4,0;;;14,0;21,0;2,0;;;1,0;;;4,0;4,0;;;4,0;;;;4,0;20,0;;;27,0;;;2,0;;;1,0;;;7,0;;1,0;1,0;;;;;;;;;;2,0;;;23,0;;;;;3,0;;;;2,0;1,0;;;;4,0;;1,0;;;;1,0;4,0;;;;;;;;;;2,0;;2,0;;;;2,0;1,0;;3,0;3,0;3,0;;1,0;;11,0;;4,0;;;1,0;1,0;;;;;;;4,0;;2,0;;3,0;;;1,0;3,0;;;;;;;;;;;;1,0;;;;;1,0;1,0;;;;5,0;;;;;1,0;;;;;;;;;;;;;;1,0;;;;;;;1,0;;;;;;;;;;;;1,0;;;;2,0;;;;;;;;;;;;1,0;;;;;;2,0;;;;;;;;;;1,0;1,0;2,0;7,0;;1,0;;;1,0;;;;;;;2,0;;2,0;4,0;4,0;;;;;;;;;;;;;;;2,0;;;;;;2,0;;;;;15,0;;;;;;3,0;3,0;1,0;;;2,0;1,0;;2,0;;;2,0;;1,0;;5,0;7,0;;;;;;;2,0;;2,0;;;1,0;;;;;;;1,0;;3,0;17,0;21,0;1,0;;;;;;4,0;45,0;;;1,0;;6,0;2,0;;4,0;;;4,0;;;1,0;1,0;;2,0;;2,0;;;;6,0;;2,0;1,0;;;;3,0;;;1,0;;8,0;;1,0;;;4,0;;;;;1,0;;;1,0;;;;;;;;;;;;;;1,0;1,0;2,0;;;4,0;32,0;6,0;1,0;;;;;6,0;1,0;;;;;;3,0;;;1,0;;;12,0;3,0;;;;;;3,0;;;;;;;;;;1,0;3,0;;;1,0;;12,0;8,0;;;;;3,0;;10,0;8,0;;;;;;;;;;12,0;4,0;1,0;5,0;;;;;;;1,0;;;3,0;1,0;1,0;;;;;1,0;;;;;1,0;;;3,0;;27,0;;;;9,0;;;1,0;1,0;;;2,0;;;;;;7,0;;;;;;1,0;;1,0;;;2,0;1,0;1,0;;;;;;2,0;2,0;;;;3,0;4,0;;;;3,0;;;;;;;1,0;;;;;;3,0;;;1,0;;;;2,0;;;;;;;;;;;;;;;;;;;2,0;;;;1,0;;2,0;;;;;;;1,0;;;;2,0;;;;;;;8,0;;;;;;;;;;2,0;;;;;;;;;;;;1,0;4,0;;;2,0;;;;;;1,0;;;1,0;;;;;;;;;;;;;;2,0;;;2,0;;;2,0;;3,0;;;;;;;;2,0;;;;;;;;1,0;2,0;;;;;1,0;4,0;;;;;;10,0;;;;;;;;;;;;;1,0;;;;;;;;;;;;;;;;;;2,0;;;;;;;;;;2,0;;1,0;;;;;1,0;;;;14,0;;;2,0;;;3,0;;;;;;;;;;;;5,0;;;;;;;;;;;2,0;;1,0;2,0;;1,0;;;;;;;;;;;;2,0;;;;;;;;;;;;;;;;1,0;1,0;;;;;;;;;;;;;;;;;1,0;1,0;;;;1,0;;;;;;;1,0;;;;;;1,0;;;;;;1,0;;1,0;;;;;;;;;;;;1,0;2,0;;;;1,0;;;;;;;;;1,0;;;;;;;;;;;;;1,0;1,0;;;;;;;3,0;;;3,0;;;;;;;;;;;;;;;;;;;;;;;;;;;;;;;;;;;3,0;;;;;1,0;;;;;;;;;;;;;
spatial;;;5,0;;4,0;;7,0;19,0;6,0;19,0;14,0;8,0;;1,0;8,0;3,0;;1,0;13,0;2,0;;1,0;8,0;4,0;;3,0;;23,0;;5,0;;34,0;19,0;10,0;1,0;5,0;10,0;8,0;1,0;6,0;;5,0;;4,0;;;;2,0;5,0;42,0;7,0;3,0;;;;99,0;9,0;12,0;;4,0;;;47,0;;12,0;;5,0;;;3,0;1,0;4,0;3,0;;;;;5,0;47,0;;;23,0;1,0;4,0;;;4,0;;;7,0;9,0;2,0;1,0;6,0;3,0;2,0;;;2,0;;1,0;15,0;;;;;;14,0;;;2,0;9,0;6,0;;;3,0;;;;;;;8,0;;;;7,0;;;;;;;;5,0;4,0;;;;2,0;;2,0;;;58,0;;8,0;19,0;8,0;;;;;1,0;;1,0;;;;5,0;;;;;1,0;1,0;2,0;23,0;;;3,0;;1,0;1,0;3,0;;;6,0;;;;1,0;14,0;;;3,0;;17,0;;;;;;1,0;;3,0;;;3,0;;;4,0;;;;;;1,0;;;2,0;;3,0;;1,0;8,0;1,0;;;;;1,0;;;;;;;;;;;;;;;;6,0;13,0;;;;;;;;;;;;;;;;;5,0;;3,0;;;;;;;;;;;;;;;;;;;;;3,0;3,0;;;;3,0;;11,0;;9,0;4,0;;;;6,0;24,0;;;;1,0;;;;;7,0;;1,0;;;2,0;;;15,0;1,0;;;1,0;;;;;;;3,0;;;;4,0;;;;;3,0;;;;1,0;;;8,0;;;;2,0;;;;;1,0;;;3,0;;;1,0;;;;2,0;2,0;;;14,0;;;;;;;2,0;2,0;;;;1,0;5,0;;1,0;7,0;1,0;;;1,0;1,0;1,0;2,0;1,0;;3,0;;;4,0;;3,0;;;;;;;2,0;;;;;9,0;7,0;;1,0;;;;2,0;2,0;;1,0;;;20,0;;10,0;;18,0;;;;10,0;;1,0;;34,0;27,0;;;;4,0;;;;;2,0;;;;;;;1,0;6,0;3,0;;;;3,0;2,0;;;;;;;;;;;;;;;;2,0;;;30,0;;;;3,0;1,0;;;;;;;;;1,0;;;;;;;1,0;;3,0;4,0;;;1,0;;;;;;3,0;;;;;;;;;4,0;;;;1,0;;;;;26,0;;;;;;;;;2,0;1,0;;;;;;;;;;;;;;;;;;3,0;;;3,0;;2,0;;;;7,0;83,0;;;;;;3,0;;;;;;;;;11,0;;1,0;;;;;4,0;;;;;;;;;;;;;;;;;;;;5,0;;;;;;;;;;;;;;;;;;;;;;;;;;2,0;;;;;1,0;;;2,0;;;;;;;;;2,0;;;6,0;;8,0;;;;;;;;;;3,0;;;;;1,0;;;;;;;;;4,0;;;;;;;;;2,0;19,0;;;;;;;;;;6,0;;;7,0;;;;2,0;1,0;;3,0;;;;;22,0;;;;1,0;;;;;;;1,0;;;;;;;;;;4,0;;1,0;;;;3,0;;;;1,0;;;2,0;;8,0;19,0;;;;1,0;;;;;1,0;;;;;5,0;7,0;;;;;;;;;2,0;;;2,0;;1,0;;5,0;;1,0;;3,0;;6,0;;;;;;;;;;;;1,0;;;;;;;;4,0;;;;;2,0;;10,0;;6,0;;;;;;;;;;;;;;;;;;4,0;1,0;2,0;;;;;;;;;;1,0;;;;;;;;;;;9,0;;;1,0;;;;;;;;;;;;1,0;;;;1,0;;2,0;;;;4,0;;;;;;;;;;;;;;;;;;;;;;2,0;1,0;;;;;;;;4,0;;;;;;1,0;;;;;;;1,0;;;;3,0;13,0;;;;1,0;;4,0;;;;;;;;;;2,0;;;;;;;;;;;;;;;;;;;1,0;;;;;;;;;;;;;;;;;;3,0;;;;;;;;;1,0;;;;;;;;;;
spectral;;;1,0;1,0;19,0;;10,0;16,0;;5,0;1,0;99,0;;;20,0;;3,0;;57,0;1,0;;;;;;1,0;;16,0;;68,0;16,0;8,0;22,0;1,0;8,0;1,0;10,0;;;;;;;12,0;;;;4,0;6,0;;23,0;2,0;;2,0;;39,0;10,0;9,0;3,0;1,0;2,0;;40,0;;;;;;;;13,0;;1,0;;;;;1,0;1,0;26,0;;7,0;;6,0;7,0;;20,0;;13,0;15,0;16,0;;;13,0;;;;;10,0;;13,0;24,0;;;;;;19,0;3,0;;5,0;4,0;21,0;;;;;;;1,0;;;;;;13,0;23,0;;9,0;1,0;;4,0;;;;20,0;5,0;;;5,0;52,0;;;;74,0;;2,0;1,0;;;1,0;;;;;;;2,0;44,0;61,0;2,0;;;;;;2,0;151,0;;5,0;;3,0;8,0;;1,0;;;9,0;;;;;16,0;;;5,0;1,0;44,0;2,0;19,0;;;28,0;53,0;;5,0;;;7,0;;1,0;;;;;;;;;;;;;;5,0;;7,0;;;;;;1,0;;;21,0;2,0;;;;;;;;14,0;4,0;;;1,0;;;;;;;;1,0;;;;1,0;;;;;2,0;;1,0;1,0;;;;;;;;;;;;;;;;;2,0;;;3,0;;;;;;;;1,0;5,0;;;;;8,0;;;;;;;;;;11,0;;;;;31,0;;;2,0;4,0;;;1,0;;;;;;;2,0;;;;14,0;;;;;;13,0;;;;;;;;;;2,0;;1,0;;;;;;4,0;;;;;;;;;;;5,0;;;;;;;2,0;1,0;;;;;15,0;;14,0;3,0;;;;;;2,0;1,0;1,0;1,0;1,0;2,0;;;;47,0;;;;;;20,0;;;;;;3,0;;;;;;;;1,0;;;;13,0;1,0;;1,0;1,0;2,0;;;;;;;1,0;;87,0;;13,0;;;;;1,0;;;;;;;5,0;;;;;;;;;;3,0;;;;;;;;;;5,0;;;;;3,0;;;;;;;;;;;;;;;;;;;;;;;;1,0;;1,0;;;;;;;;;;;;;;;;;;;;2,0;;;1,0;;;;;53,0;;;1,0;;1,0;;;;;;;;;;;;;;1,0;;;;;;1,0;;;5,0;;;13,0;;;;;;;66,0;;;;;;;;;;;;;;;;;;;;;;;;1,0;;;;;;;;;10,0;;;;;;;;;;;;;;;;;;;;;;;1,0;;;;;;71,0;1,0;;;;;9,0;;;;;;4,0;;;;;;;;;;;;;3,0;;;1,0;;;;;;;;;;;;;;;;;;;;;;;;;1,0;;;;;;;1,0;;3,0;;;;;;;;;;;;;;;;;;;;;;1,0;;;;;;;;;;;;;;;;;;;;;1,0;;;;;1,0;1,0;;;;;;;2,0;;;;;;;;;;;;;;;;;2,0;7,0;;;97,0;;;3,0;;;;;3,0;;3,0;;;;;2,0;;;;;;;;;;;;;;;;;;;;;;;;;;;;;;;2,0;;;5,0;;;;;;;;;;;;;;;;;;3,0;;;1,0;7,0;;;;3,0;;;;1,0;;;;;;;;;;;;;1,0;;;;;;;;;6,0;;1,0;;;;;;1,0;;1,0;;;;8,0;;;;;;;;;;;;;;;;;5,0;;;;;;;;;;;;;;;;1,0;;;;;;2,0;;;;;1,0;;;;;;;;;;;;;;;;;;;1,0;;;;;;;;;;;;2,0;;;;;;;;;;;;;;;;;;4,0;;;;;;;;;;;;;;;;3,0;;;;;;;;;;;;;;
speed;;;9,0;;44,0;;5,0;96,0;18,0;5,0;;75,0;;3,0;12,0;4,0;;;;3,0;1,0;194,0;3,0;14,0;23,0;;1,0;91,0;1,0;74,0;11,0;183,0;86,0;24,0;41,0;;;43,0;;36,0;10,0;2,0;13,0;11,0;2,0;2,0;;3,0;21,0;15,0;8,0;19,0;1,0;;;154,0;29,0;;1,0;43,0;2,0;4,0;59,0;9,0;;72,0;85,0;;;58,0;11,0;1,0;2,0;;;;;19,0;59,0;5,0;4,0;31,0;11,0;4,0;;;11,0;2,0;1,0;6,0;19,0;7,0;7,0;29,0;6,0;1,0;;4,0;7,0;9,0;10,0;49,0;;11,0;2,0;;;179,0;;;6,0;11,0;3,0;3,0;1,0;2,0;2,0;;;7,0;;;8,0;18,0;;;19,0;;1,0;;;;;;1,0;9,0;;;;2,0;;;21,0;;7,0;;1,0;14,0;;1,0;;;;;;;;;3,0;32,0;;30,0;;;;;3,0;8,0;;;6,0;1,0;2,0;;98,0;;;9,0;;;;;1,0;1,0;;5,0;4,0;26,0;;8,0;;;;13,0;;;;;33,0;1,0;;2,0;;3,0;;3,0;;;2,0;7,0;;;;;33,0;53,0;1,0;;16,0;;;71,0;6,0;3,0;;;;;;;;;2,0;2,0;57,0;9,0;;8,0;9,0;2,0;4,0;;2,0;;5,0;13,0;;;;1,0;3,0;;;;;;;4,0;2,0;;;88,0;2,0;;;;;;;1,0;;;;;1,0;6,0;;;5,0;1,0;;;4,0;19,0;;33,0;16,0;17,0;9,0;2,0;15,0;;;9,0;;;2,0;19,0;;;1,0;;86,0;;;;;19,0;2,0;;26,0;1,0;;;9,0;;;;;;;;1,0;;;6,0;;;;;5,0;33,0;6,0;14,0;;;1,0;1,0;;8,0;;28,0;;5,0;5,0;;18,0;2,0;;64,0;9,0;39,0;6,0;22,0;;16,0;2,0;;;;8,0;;;2,0;4,0;18,0;;4,0;1,0;;1,0;3,0;;13,0;27,0;8,0;;;2,0;20,0;12,0;10,0;2,0;1,0;;5,0;3,0;3,0;;35,0;2,0;5,0;23,0;;256,0;;15,0;7,0;18,0;;4,0;;;7,0;2,0;10,0;;16,0;1,0;15,0;;2,0;;;;;6,0;;7,0;;4,0;;;2,0;161,0;;1,0;2,0;11,0;;2,0;;1,0;1,0;;4,0;1,0;;;4,0;;2,0;4,0;;;37,0;2,0;2,0;2,0;3,0;2,0;8,0;39,0;21,0;;;8,0;2,0;11,0;;1,0;1,0;;9,0;1,0;2,0;;;7,0;2,0;;23,0;;;9,0;;;;;2,0;;;;;;4,0;;;2,0;31,0;;1,0;1,0;5,0;29,0;4,0;8,0;10,0;;25,0;22,0;;;1,0;19,0;;;;;;;;;1,0;40,0;1,0;;2,0;;5,0;;;1,0;8,0;1,0;;7,0;;1,0;;;3,0;;;;14,0;;2,0;;;;3,0;3,0;;;3,0;;;;;;11,0;;2,0;3,0;;20,0;;;22,0;18,0;;;3,0;;;20,0;3,0;;;;2,0;2,0;;;;;;;;;1,0;42,0;3,0;1,0;;;;;;10,0;;;;;1,0;;;1,0;;;;24,0;;;;1,0;1,0;;;;;;;;;;;;;;;10,0;3,0;;;;;3,0;;;;;1,0;;;;1,0;;;;1,0;;;;;;;;;;;;;;;;;1,0;;;;;1,0;;;5,0;;;1,0;;;;;1,0;;;;;;2,0;;15,0;7,0;;;;1,0;;;;2,0;4,0;;8,0;;;2,0;;1,0;;;;;1,0;;;1,0;1,0;43,0;1,0;;;34,0;;16,0;;;;3,0;;;;2,0;;2,0;;;;;4,0;90,0;7,0;1,0;;2,0;1,0;;;1,0;1,0;4,0;1,0;1,0;;6,0;;1,0;;;;;;2,0;;;;35,0;;;3,0;;;;;;;1,0;4,0;12,0;5,0;;3,0;;;3,0;1,0;;1,0;;;;;1,0;8,0;;2,0;30,0;;;7,0;;;2,0;14,0;6,0;;;;;3,0;;;;;;;;;1,0;;4,0;;5,0;;;;;2,0;;;2,0;;;;;;;9,0;1,0;;5,0;4,0;;;;;;2,0;1,0;;;;;;;;;8,0;1,0;;1,0;;;;;;;;;;;;;8,0;;;;3,0;;;;;;;;;2,0;;;;;;3,0;;;3,0;;;;;;;;;;;;;6,0;;;;;;;1,0;;;;;;;2,0;;;;;;;;8,0;2,0;;17,0;;;;;;3,0;;;;;;;1,0;;;;;2,0;;1,0;;;;;;;;;;;;;;;;;;;;;;;;;;;1,0;3,0;;;;;;;;;;;;;;;;;;;;;;;;;;;
splitter;;;1,0;;3,0;;4,0;;;;3,0;;;;1,0;;;;;;;;;1,0;;;;;;;;;16,0;;2,0;;11,0;9,0;;;1,0;;;7,0;;;;;2,0;4,0;;;;5,0;;22,0;9,0;;;27,0;;;;;;;;;;;26,0;;24,0;;;;;;12,0;;;;;;;;2,0;;;1,0;16,0;;;;;;;;;;3,0;15,0;;;;;;;;;;10,0;;2,0;;;;;;2,0;;;;;;;16,0;1,0;;;;;;;;2,0;10,0;;;;2,0;;;;6,0;;2,0;5,0;;;;;4,0;;;;;1,0;2,0;;1,0;;;;;;;80,0;;;2,0;6,0;6,0;;;;;7,0;;;;;2,0;;;;2,0;;4,0;1,0;;;5,0;28,0;;8,0;;;;;;;1,0;;;;;;;;;;;;;;1,0;;;;;;;;;3,0;5,0;;;;;;;;;;;;;3,0;;;;;;;;3,0;;;;;;;;1,0;;1,0;;1,0;;;;;;;;;;;;1,0;;;1,0;;;;;4,0;;;;;;1,0;;1,0;;;;;;;;;;;;;6,0;;;;;;;1,0;;;;;;;;;1,0;;;;;2,0;;;;3,0;;;;;1,0;;;;;;;;;;;;;;;;;;;;;;;;;;;;;;;;1,0;;;;;;;;;;;;;;;;;;;;;;;;;;;1,0;;;;;;;;1,0;;;;;;;;;;;;;;;;;;;;;39,0;7,0;;;;;;;;;;1,0;;;;;;;;;;;;;;;;;;4,0;;;;;;;;;1,0;;;;;1,0;;;;;;;;;;;;;;;;;;;;;;;;4,0;;;;;;;;;2,0;;13,0;;;;;;;;3,0;;;;;;;;;;;;;;;;;;;;;;;;;;;;;;;;;;;;;;;;;;;;;;;;;;;;2,0;;1,0;;;;;;;;;;;;;;;;;;;;;;;;;;;;;;;;;;;;;;1,0;;1,0;;;;;;;;;;;;;;8,0;;;;;;;;;;;2,0;;;;;;;;;;;9,0;;204,0;;;;;;4,0;;;;;;;;;;;;;;;;;1,0;;;;;1,0;;;;;1,0;;;;;;2,0;;;;;;;;;1,0;;;;;;;;;;;;;;1,0;;;;;;;1,0;;;;;;;;;;;;;;;;;;;;1,0;;;;;;;1,0;;;;;;;;;;;;;;;2,0;;;22,0;;;;;;;;;1,0;;4,0;;;;;;;;;;;;2,0;;;;;;;;;;;;;;;;;;;;;;;;;;;;;;;;;;;;;;;;;;;;;;;;;;;;;;;;;;;;;;;;;;;;;;;;;;;;;;;;;;;;;;;;;;;1,0;;;;;;;;;;;;;;;;11,0;;;;;;;;;;;;;;;;;;;;;;;;;;;;1,0;;;1,0;;;;;;;;1,0;;;2,0;;;;;3,0;;;;;;;;;;;;;;;;;;;;;;;;;;;;;;;;;;;;;;;;;;;;;;;;;;;;;;;;;;;;;;;;;;;;4,0;;;;
stabilize;;;2,0;1,0;33,0;;15,0;31,0;;4,0;2,0;;;;;;;;1,0;;;26,0;;2,0;8,0;;;2,0;;8,0;18,0;18,0;64,0;;4,0;;;27,0;;33,0;2,0;;5,0;4,0;;;;;3,0;1,0;1,0;14,0;;1,0;1,0;291,0;27,0;;2,0;30,0;;;42,0;;4,0;;2,0;;7,0;4,0;35,0;1,0;;;;;;;31,0;16,0;1,0;4,0;2,0;;;;15,0;;2,0;12,0;17,0;;;1,0;3,0;1,0;2,0;1,0;4,0;;2,0;45,0;;;1,0;;;44,0;;;3,0;;;;6,0;1,0;;;;1,0;;;;9,0;;;13,0;;;;;;;;;;4,0;;;;;1,0;3,0;4,0;;;17,0;33,0;;;;1,0;2,0;;15,0;2,0;;4,0;;1,0;;;;;;;8,0;2,0;;3,0;22,0;;38,0;9,0;7,0;;;17,0;;;2,0;3,0;;;;;;11,0;;7,0;;;;;;;;;9,0;5,0;;3,0;;;;;4,0;1,0;1,0;27,0;;;;;3,0;;;;;;;3,0;2,0;2,0;;;;;;;;;1,0;1,0;2,0;3,0;;;;4,0;2,0;;5,0;1,0;1,0;;;;;2,0;;;;2,0;;3,0;;;;;;5,0;;;1,0;;1,0;;;;1,0;3,0;;6,0;;;;;;;1,0;1,0;1,0;3,0;;6,0;10,0;13,0;1,0;;;;;;;10,0;;2,0;2,0;;6,0;1,0;2,0;;;;;7,0;2,0;;7,0;5,0;2,0;;;;;;1,0;;;2,0;6,0;;;10,0;;;13,0;;4,0;;;;;;2,0;;;;;;;4,0;;;;4,0;;;;;3,0;;;;;;;;;;;;9,0;2,0;;;;;;;;2,0;1,0;;1,0;;;;;;;;;1,0;;;;;;5,0;;;;;1,0;5,0;;;1,0;;;2,0;;;;6,0;;;2,0;2,0;;;;;;;;7,0;3,0;2,0;;1,0;4,0;;;;;;63,0;;;2,0;;;;;;2,0;;;;;1,0;;;;;;;;1,0;1,0;;;;1,0;;;;;;;;;8,0;;;;;4,0;18,0;;;;;;;;;;;;;;;;;1,0;;;;;31,0;1,0;;;;;;;;;;1,0;;1,0;;;;;;;;;;;;;;3,0;;;;;2,0;;;;;;;;;;;5,0;;;;;;;;;;;;;;2,0;;1,0;;;;1,0;;;;;;;4,0;;3,0;;;;1,0;;;;;;;1,0;;;;;2,0;;;;;;;;;;;;;;1,0;;;1,0;;;;;;;;;;;;;;;;;1,0;;;;;;;;;;;;;2,0;;;;9,0;;2,0;10,0;;1,0;;;2,0;;;;;;;;;;;;;;;1,0;;1,0;;;;;;;;12,0;;3,0;1,0;;;;6,0;;;;;;;;;;;;;;1,0;;;;;;;;;;;1,0;;;;;;;;;;;;;;;1,0;1,0;;;;;1,0;;;;;;;;;;;;;2,0;;;;;;11,0;;;;;;;;;;;;;;;;;;5,0;;;;;;;;;;;;;;2,0;;2,0;;;;;3,0;1,0;;;;;6,0;;;1,0;;;;;;;;;3,0;;;;;;;;;;1,0;;;;;;;;;;;;;;;;;;;;;;;;;;;;5,0;;;;;;;;;;;1,0;;;;;;;;;;;;;;;;;;;;;;;;;;;;;;2,0;;;;;;;;;2,0;;;;;;;;;;;;;;;;;1,0;;;;;;;;;;;;;;;;;;7,0;;;;;;;;;;;6,0;;;;;;;;;;2,0;;;;;;3,0;;;;;;;;;;;;;;;;;;;;;;;;;;;;;;;;;;;;;;;;;;;;;;;;;;;;;;
stage;;;9,0;1,0;365,0;;41,0;9,0;1,0;58,0;4,0;;;;3,0;2,0;2,0;;4,0;2,0;;59,0;2,0;5,0;41,0;;;28,0;18,0;38,0;35,0;9,0;23,0;1,0;8,0;;;202,0;3,0;8,0;2,0;;32,0;32,0;;3,0;;2,0;40,0;;;29,0;;;;149,0;71,0;;4,0;47,0;;;29,0;;;6,0;39,0;;1,0;10,0;19,0;13,0;;;1,0;;;1,0;53,0;2,0;;43,0;5,0;8,0;;;17,0;;2,0;31,0;112,0;32,0;3,0;67,0;1,0;;;;1,0;1,0;21,0;30,0;;59,0;;3,0;3,0;37,0;;3,0;;12,0;1,0;118,0;20,0;;;;18,0;7,0;5,0;;;30,0;;;14,0;8,0;1,0;3,0;;1,0;;;1,0;4,0;33,0;;9,0;2,0;1,0;2,0;2,0;15,0;;35,0;46,0;4,0;6,0;;;1,0;10,0;;2,0;4,0;38,0;1,0;;153,0;1,0;;2,0;;;;8,0;7,0;;2,0;89,0;;1,0;8,0;25,0;;;84,0;;;8,0;1,0;1,0;;7,0;13,0;47,0;46,0;;75,0;;;;18,0;;;;;5,0;9,0;1,0;11,0;;9,0;;3,0;;74,0;3,0;70,0;1,0;;;;10,0;16,0;3,0;;;;2,0;;;;;;1,0;;1,0;6,0;1,0;;17,0;;15,0;3,0;;1,0;9,0;;;;;;;;;;;31,0;19,0;5,0;;24,0;;2,0;;16,0;;2,0;;54,0;4,0;;3,0;;6,0;;;2,0;;4,0;;;;;;;6,0;9,0;;8,0;;8,0;2,0;19,0;17,0;5,0;2,0;13,0;7,0;11,0;2,0;1,0;;6,0;;17,0;14,0;;;;10,0;4,0;7,0;;;3,0;2,0;1,0;2,0;7,0;;2,0;1,0;8,0;2,0;;6,0;;;1,0;;3,0;;3,0;;9,0;14,0;;2,0;;;;;4,0;;1,0;;;;;;4,0;;3,0;;;;14,0;10,0;;;;;;;;;;;;;;5,0;1,0;;4,0;2,0;;;;;;;3,0;3,0;1,0;;6,0;6,0;7,0;;1,0;13,0;;;4,0;;3,0;;;4,0;;6,0;;7,0;1,0;;;8,0;;2,0;;;;;6,0;1,0;;5,0;;;;;;9,0;;4,0;;2,0;1,0;;;2,0;6,0;;;6,0;7,0;;;;;;;1,0;3,0;;;8,0;;;;9,0;4,0;;1,0;7,0;14,0;;;2,0;3,0;;;;;;;;;;;;;159,0;4,0;12,0;;;9,0;;;;;2,0;;;;59,0;;;1,0;;8,0;;5,0;12,0;11,0;;6,0;;;9,0;1,0;;3,0;;;;;2,0;2,0;;4,0;;3,0;;;;;;1,0;;;;;;;;;;33,0;;1,0;2,0;;;;;;;6,0;1,0;;;;;;;;;4,0;;1,0;19,0;;;;1,0;;1,0;4,0;;;;;;2,0;4,0;7,0;;;;;18,0;;2,0;;;;;;;;3,0;;;;;;;20,0;;13,0;;;;;;5,0;;;;;;;;3,0;;;7,0;;;;;;;;11,0;1,0;;;;;;;;1,0;2,0;1,0;1,0;7,0;;;;;;;;;;5,0;;11,0;;;;;1,0;1,0;;;;;5,0;;2,0;;;;;;;;;;;;10,0;;;;;2,0;45,0;;;2,0;;;;7,0;49,0;;37,0;;;;7,0;;;;;;;;6,0;;;;;;;;;25,0;;;3,0;;;;;;;;4,0;7,0;;1,0;;8,0;1,0;;;;;;;;2,0;;;;;;;;;7,0;;8,0;;1,0;;;;;3,0;;;3,0;;;;17,0;;;;4,0;;5,0;;;;;;;2,0;;1,0;1,0;;6,0;;3,0;;;;;1,0;;;;;2,0;;;;;;;;;1,0;2,0;;;;;;;;;1,0;;;;;;1,0;9,0;;;;;;;;;;;4,0;;;;;;6,0;;;;;;;;;;;6,0;;8,0;;;;;;2,0;1,0;;4,0;;6,0;2,0;2,0;;;;;;;;;;;1,0;18,0;;;15,0;;;;;;;1,0;;2,0;;;;10,0;;2,0;;;;;;;;;2,0;;2,0;;;;;;;;;;;;;;;;;;;;;;;;;;2,0;;14,0;;;;;;;;;5,0;;;;;;1,0;;;;;;;;;;;;;1,0;5,0;1,0;;;;;;;2,0;;9,0;1,0;;;;;;2,0;;;;;;;21,0;;;;;;;;;;;;;;;2,0;;;;;;;;;;;;;;;;
standard;;;5,0;;10,0;;4,0;4,0;9,0;6,0;3,0;;;1,0;4,0;;;;18,0;2,0;;7,0;;25,0;7,0;;2,0;11,0;;3,0;4,0;8,0;15,0;45,0;10,0;;2,0;3,0;;3,0;;;;;;21,0;2,0;1,0;4,0;;10,0;7,0;;2,0;;150,0;2,0;;;16,0;28,0;1,0;21,0;;;;2,0;;;2,0;15,0;;;7,0;;;;12,0;27,0;17,0;;1,0;;3,0;;;6,0;1,0;;4,0;61,0;10,0;3,0;22,0;21,0;;;7,0;13,0;;26,0;13,0;;1,0;;;5,0;47,0;;;;5,0;;;2,0;;;;;;;;1,0;;;;7,0;1,0;;8,0;2,0;;;;;;;;;;;;;;;2,0;2,0;69,0;;12,0;;;;;;2,0;2,0;;;5,0;;;;;;;21,0;3,0;;;;;17,0;21,0;;;;17,0;;;;;;;;;1,0;2,0;;35,0;;;;4,0;;;;;1,0;;;1,0;;;;4,0;;;;4,0;4,0;;;;;7,0;2,0;;;;;5,0;;;;;;;1,0;;;;;;2,0;;;;24,0;;;;;;;1,0;1,0;;;;;3,0;;9,0;;;;3,0;;;1,0;2,0;;;;;;;;;;;;;3,0;7,0;;;1,0;10,0;;;;;;9,0;;4,0;1,0;;;;;;;3,0;;7,0;;;;2,0;25,0;;;;1,0;4,0;;;27,0;;;1,0;;;;;1,0;;;;;;;1,0;;;1,0;;;6,0;;;;;;;;;;;;;;;6,0;;;10,0;;;;;;;;5,0;;;;;;;;4,0;;;3,0;;7,0;;;;;6,0;;1,0;;3,0;;;;;;;1,0;;1,0;4,0;;2,0;;1,0;1,0;1,0;2,0;8,0;1,0;;;;;;;;;;;;1,0;;;;;;;;2,0;1,0;2,0;;;;3,0;;;2,0;1,0;;1,0;;;;;;8,0;;;1,0;;;1,0;;;1,0;;;;;;;;;;6,0;;;;;1,0;1,0;;1,0;;5,0;;;4,0;;;;;;;3,0;;;;;2,0;;;;;1,0;;5,0;;3,0;1,0;1,0;;;13,0;;;;;;;;;;;3,0;;;;;1,0;;;;3,0;;27,0;;;;;;;;;;;2,0;;;1,0;;;;;;;;;;;1,0;;;;;;;;;;;;;;;8,0;;;2,0;5,0;;;;;;1,0;;;;;1,0;;;;;;;;;;1,0;1,0;;;;3,0;;;;;;;;;;2,0;;;;4,0;;;;;1,0;;;;;;;;;;;1,0;;;;1,0;;;;;;;;2,0;3,0;;;;;;;1,0;;;;;;;;;;9,0;;;;5,0;1,0;;;;;;;;;;;4,0;;;;;;;2,0;;;;;;;;2,0;;;;;8,0;;;;;;;;;;1,0;;4,0;;;2,0;;;;;;;;;;;;1,0;;;1,0;;;;;;;;;;;;;;;;;;;;4,0;;;;2,0;;;;;;;2,0;;;;;;;;;;;;;;;;;;;;;1,0;;;;;;1,0;;;;;;11,0;;;;;;;;;;;;;;;;;;1,0;;;;;;;;;;;;;;1,0;3,0;;;;;;;;;;;;;;;;;;;;;;1,0;5,0;;;;;;1,0;;;;;;;;;;;;;;;;;;;;7,0;;1,0;3,0;1,0;;;;;;;;;;2,0;;;;;;;;;;;;;;;;;;;;;;;;9,0;;;;;;;;;;;;;;3,0;;;;;;;;;;;4,0;;;5,0;;;;;;;;;;1,0;;;;;;;;;;;;;;;;;;;;;;;;;;;;;;;;;;;;;;;;;;;;;;;;;;;;;;;;;;;;;;;;;
straight;;;2,0;;5,0;;8,0;11,0;5,0;2,0;6,0;;22,0;;9,0;6,0;;;;;;1,0;11,0;;2,0;;;1,0;10,0;;2,0;22,0;9,0;;10,0;1,0;;37,0;;8,0;18,0;;2,0;2,0;;;;;;;;5,0;;1,0;;36,0;6,0;;13,0;19,0;3,0;;15,0;;3,0;;12,0;;;;7,0;;4,0;1,0;;;;66,0;28,0;;;4,0;7,0;;;;2,0;2,0;1,0;3,0;5,0;;;4,0;;3,0;2,0;;;2,0;3,0;9,0;;;2,0;;1,0;;;;;6,0;2,0;8,0;;;;4,0;1,0;2,0;;;4,0;1,0;;;6,0;1,0;;;;;;2,0;4,0;;7,0;;;1,0;;;;4,0;3,0;;7,0;7,0;;2,0;4,0;16,0;25,0;;;3,0;6,0;;;6,0;;;2,0;;2,0;;;7,0;;;19,0;;4,0;3,0;;4,0;5,0;;;1,0;1,0;;15,0;;;5,0;;8,0;;55,0;;14,0;;9,0;1,0;;;;2,0;;;3,0;;14,0;;3,0;2,0;;;;;1,0;;;1,0;4,0;;2,0;3,0;;;3,0;2,0;;4,0;;;;;;1,0;;4,0;;;9,0;;3,0;6,0;;5,0;;;2,0;;;;;;;;;;8,0;;;;;;;;;39,0;;7,0;5,0;28,0;;;1,0;;6,0;;;;;;;;;;;;;;;6,0;31,0;;8,0;;3,0;;3,0;;8,0;;4,0;;3,0;;;20,0;6,0;8,0;;;;1,0;;2,0;2,0;1,0;;;;;;;;;;1,0;;;4,0;;;;;;;;;;;;;;;;1,0;;4,0;2,0;;;;;2,0;5,0;;;;;;;;;;;;;;23,0;;;;;;;;;4,0;;;;;;37,0;6,0;;;;;;;;;1,0;1,0;;;;1,0;1,0;;5,0;;;;;;;1,0;6,0;83,0;;;;11,0;;;;;;1,0;;3,0;2,0;1,0;;;;;;;;;;;;;;;;;;;;1,0;;;;;6,0;;1,0;1,0;;;1,0;;;;;;2,0;;;;;;;;1,0;7,0;;9,0;;;1,0;;5,0;;9,0;1,0;;;;;;;;1,0;1,0;4,0;;;1,0;;;;;;2,0;;;;;;;;;;;;;;;2,0;;;;;;;;3,0;;;;;;;;;;;;;;1,0;;;;3,0;;;;;;;;;;1,0;;;;;;;2,0;;;1,0;;;;2,0;;;;;;16,0;;;;;2,0;;;;;43,0;;;;;;;;;2,0;;;;;;;;;;;;;;5,0;;;;;;;;4,0;;;;;;;;;;;;;;;;4,0;;;;;;;;;1,0;;1,0;;4,0;;;;;;;;;;;;;;;;;;;;4,0;;;2,0;1,0;;;1,0;;;;;;;;;;3,0;;;;;;;;;;;7,0;;;;;;;;;;;;;2,0;;;;;;;3,0;;;;;;;;;;;;;;;;;;;;;;;;;;;;;1,0;;;;;1,0;;;;;;;;;;;;;1,0;;;;;;;;1,0;;;;;;;;;;;;;;;2,0;1,0;;;4,0;;;;;;;;;1,0;;;;;;8,0;;;;;;;;;;1,0;;;;;7,0;;;;;6,0;;;;;;;;;;;;1,0;;;;;;;3,0;;;;;;;;;;2,0;;;;;;;3,0;;;;;;;;;1,0;3,0;;;;;;;4,0;;;;;;;;10,0;;;;;;;;;;;;;;;;;;;2,0;;;;;;;;3,0;;;;;;1,0;;;2,0;;;;;;;;;;;;;;;2,0;;;;;;;;;;;;;;;;;;;;;8,0;;;;;;;;;;;;3,0;20,0;26,0;;;;;;;;;;4,0;2,0;1,0;;;;;;;;;;;;;1,0;;;4,0;;;;;;;;;;;
stream;;;5,0;;15,0;;1,0;6,0;2,0;40,0;;6,0;;1,0;5,0;3,0;;;13,0;6,0;;14,0;4,0;;;;;294,0;;3,0;1,0;10,0;30,0;;63,0;3,0;3,0;;;23,0;;;;1,0;;1,0;;2,0;;;;57,0;7,0;2,0;;162,0;29,0;;4,0;3,0;;;37,0;;;;3,0;;6,0;5,0;6,0;4,0;;;;;;7,0;1,0;1,0;;15,0;7,0;5,0;;;;;7,0;29,0;1,0;;;13,0;2,0;6,0;;3,0;18,0;;3,0;56,0;;5,0;1,0;2,0;;10,0;;;3,0;;1,0;;;;;;4,0;;;;;8,0;;;11,0;;;3,0;;10,0;;;;1,0;;;;;;;2,0;4,0;3,0;;2,0;28,0;;;;;;;;;;5,0;6,0;1,0;;1,0;;;1,0;12,0;6,0;3,0;;;;;1,0;2,0;;;;56,0;;;4,0;;2,0;;;;;63,0;;15,0;;;;44,0;1,0;;;;;;;;;;;6,0;;;;;;;2,0;2,0;;35,0;15,0;;;;;1,0;;;;;;;;;;;;1,0;1,0;2,0;;1,0;4,0;;13,0;;14,0;;5,0;;6,0;;;;;;;11,0;;;;;;;9,0;;;;;;;;;;;;;;;11,0;;;;3,0;;;;2,0;;54,0;;11,0;9,0;;;;;1,0;;;;2,0;;;;;9,0;;2,0;;;;;;2,0;17,0;;;;;;;;;;;;;;2,0;;;;;10,0;1,0;;;;2,0;;;2,0;;;17,0;4,0;;;1,0;;;;2,0;1,0;2,0;7,0;;1,0;;;;;;2,0;;;;13,0;4,0;;;;4,0;;;;;6,0;1,0;36,0;2,0;;5,0;7,0;;2,0;13,0;1,0;;1,0;;;23,0;;;;;;1,0;;3,0;;;;;;;;;;;3,0;;;;;43,0;3,0;5,0;;;6,0;;25,0;1,0;;2,0;3,0;;41,0;;2,0;12,0;4,0;;;;;;3,0;2,0;26,0;;;1,0;;4,0;2,0;;;9,0;;1,0;4,0;1,0;2,0;;;8,0;;;3,0;8,0;;;2,0;;;1,0;;;;1,0;;4,0;;;;;;1,0;;3,0;24,0;;;2,0;;;4,0;;;;;11,0;;;380,0;19,0;;;;1,0;2,0;1,0;;1,0;;;;;;;;;;10,0;1,0;;;24,0;1,0;;;;;;;;1,0;;;;7,0;;;1,0;2,0;;;;;2,0;;3,0;1,0;;;;;;1,0;;;;;7,0;92,0;;2,0;2,0;;79,0;3,0;;;;;;;1,0;;1,0;;2,0;6,0;;;;;;;;;;;10,0;2,0;;;;;17,0;6,0;;;16,0;;;;;1,0;;;1,0;;;4,0;1,0;;9,0;;;;;;;;1,0;3,0;;;;;;;;;;;;4,0;;;;;1,0;;;;;;;;2,0;;;;29,0;;;;;9,0;4,0;;;;;;;;;;;8,0;;1,0;;;;;;;;;;;1,0;;;;32,0;;;;;;;;;;;;;;;3,0;;;;4,0;1,0;1,0;2,0;;;;;;;;36,0;;;;;;;;;2,0;;;;;;;;20,0;;;;;2,0;3,0;9,0;;;;;;;;;4,0;;;2,0;;6,0;;;;;35,0;;;;;2,0;;;;;;;1,0;;;;;;;;;;;;;2,0;;;;;;;4,0;4,0;;;;;;;;;8,0;;;;;;;;;;;2,0;;2,0;20,0;;;;;19,0;;;;;;;;;15,0;;11,0;;;;1,0;;5,0;;;;;;;;4,0;;;;;;;;;;1,0;;;;;4,0;2,0;;17,0;;;;;13,0;;;;;;;;;;1,0;3,0;;;;;;;;;;;;;;;;;;;1,0;;;13,0;;20,0;;;;56,0;;;;;;;;1,0;;1,0;;3,0;2,0;;19,0;;;;;1,0;2,0;;;2,0;2,0;;;;;;5,0;;;;;;;;;;;5,0;5,0;;;;3,0;;;;;;;;;;;;;;;;;;;;;;;;1,0;;;;;;;;;;1,0;;;;;;;1,0;1,0;2,0;;;;;;;;;
strobe;;;6,0;;11,0;;;6,0;8,0;24,0;;2,0;;;41,0;;;;;;;47,0;;2,0;;;;3,0;3,0;3,0;;26,0;60,0;5,0;4,0;;;6,0;;1,0;7,0;;1,0;13,0;1,0;;;4,0;2,0;;;1,0;;1,0;;13,0;14,0;;;5,0;;3,0;4,0;;;;4,0;;2,0;6,0;4,0;;1,0;;;;;43,0;18,0;2,0;;;;;;;;;;3,0;1,0;;24,0;5,0;;;;5,0;;;;1,0;;;;;;33,0;;;;;;44,0;;;;;;11,0;;;;5,0;;;5,0;;;5,0;;;;;;;3,0;;2,0;70,0;;;;;1,0;1,0;5,0;4,0;;;;2,0;9,0;;;1,0;;;8,0;7,0;;;;;;;2,0;191,0;;;2,0;;;;;2,0;;14,0;;;;;;1,0;;;1,0;10,0;;10,0;;;;1,0;;;;;;;;;;2,0;;;;;;4,0;;;;;;7,0;;2,0;;2,0;;;3,0;;;;;;;;4,0;;;;14,0;9,0;;;1,0;;;;;1,0;;17,0;;;;;;;;44,0;;;;;;;;;;5,0;;;;;;;;;;1,0;;;;7,0;;3,0;8,0;;;18,0;;;6,0;;1,0;;;;;;;;;17,0;;;;;4,0;;;;;8,0;;;;8,0;1,0;;;;;;;;;;;;;42,0;;9,0;;;1,0;5,0;;;;;;;;;;;;5,0;;;;9,0;;4,0;18,0;18,0;;;;;;;;;;;;;;;;;;;4,0;;;1,0;;;;;;;22,0;;;;2,0;5,0;;;;;9,0;12,0;;;;;73,0;;;;;;;1,0;;;;5,0;;;;;;;;;;;2,0;;3,0;;;;17,0;;;;;1,0;;;;;;;;;;3,0;;1,0;;;;;;;2,0;;;1,0;;8,0;;;;;;;3,0;;;;;;2,0;;;;;1,0;;;;;;2,0;;;;;;;;;;;;3,0;;;29,0;;;;;;;;;;;;;;;;;;;;;;;;;;;;;;;;;90,0;;;;;;;;;;;;1,0;;;;;;;;;28,0;;;;;;;;1,0;;;;;;;;;;;;;;;;;;;;;;2,0;;;;;;22,0;;;;;;;;;;;;;9,0;;;;;;;26,0;;;;;;2,0;;;;;;;;;;;2,0;;;;3,0;;;3,0;;;;;;;;;;;;;;;4,0;;;;;;;;;;;;;;;;;;;2,0;;;;;;;;;;;;;;;;;;;;;;;5,0;;;;1,0;;;2,0;;;;;;;;;;;;;;;;;4,0;;2,0;;2,0;;;;;;;;;;;;;;3,0;;;;;;;1,0;1,0;;;;;;;;;;;;;;;;;;;;;;;;2,0;;;2,0;;;;;;;;;;;1,0;;;;;3,0;10,0;;;;;;;;;;1,0;;;8,0;;;;;;;;;;;;;;;;;;;2,0;;;;;;;;;4,0;;;;;;;2,0;;;2,0;;;;1,0;;;;;;;;;;;;;;;;;;;;;;;;;;5,0;;;;;;;;;;;5,0;;;;;;;;;;;;;;;9,0;;;;;;;;;;;;;;;;;;;;;;;;;;;;;;;;;;;;;;;;;;;;;;;;;;;;;;;;;;;;;;;;;;;;;;;;;;3,0;;;;;;;;;;;;;;;;;;;;;;;;;;;;;;;;;;;;;;;;;
subject;;;86,0;3,0;34,0;2,0;53,0;194,0;45,0;453,0;11,0;2,0;;6,0;90,0;3,0;1,0;4,0;40,0;21,0;88,0;138,0;5,0;49,0;45,0;;25,0;491,0;12,0;290,0;40,0;203,0;349,0;13,0;93,0;6,0;10,0;82,0;2,0;297,0;243,0;12,0;11,0;77,0;8,0;5,0;;13,0;135,0;7,0;10,0;209,0;3,0;60,0;6,0;3151,0;150,0;1,0;7,0;297,0;8,0;11,0;115,0;5,0;7,0;14,0;72,0;3,0;15,0;28,0;343,0;20,0;48,0;1,0;;249,0;;51,0;300,0;7,0;4,0;124,0;18,0;21,0;4,0;6,0;133,0;5,0;127,0;37,0;126,0;8,0;92,0;225,0;37,0;18,0;3,0;8,0;71,0;;58,0;216,0;2,0;4,0;9,0;;5,0;452,0;1,0;;9,0;12,0;6,0;6,0;1,0;2,0;1,0;;;39,0;;;28,0;6,0;;7,0;126,0;3,0;12,0;2,0;11,0;20,0;1,0;3,0;1,0;12,0;26,0;;;73,0;3,0;45,0;1,0;176,0;18,0;4,0;258,0;95,0;1,0;;1,0;;74,0;;3,0;;;6,0;39,0;332,0;62,0;10,0;2,0;4,0;16,0;;27,0;573,0;;1,0;38,0;57,0;11,0;5,0;61,0;14,0;1,0;115,0;;;4,0;;69,0;26,0;;29,0;3,0;164,0;2,0;119,0;;1,0;9,0;61,0;5,0;90,0;;;4,0;1,0;2,0;6,0;7,0;39,0;;20,0;;;7,0;13,0;2,0;5,0;;2,0;1,0;57,0;40,0;2,0;10,0;2,0;8,0;18,0;3,0;8,0;3,0;2,0;1,0;;;;3,0;;1,0;10,0;50,0;36,0;6,0;22,0;195,0;11,0;11,0;;24,0;15,0;3,0;8,0;;;3,0;;1,0;14,0;;1,0;8,0;7,0;;37,0;22,0;;13,0;22,0;3,0;;1,0;;12,0;;;1,0;1,0;11,0;;2,0;5,0;8,0;1,0;;3,0;11,0;1,0;;;9,0;;32,0;30,0;29,0;15,0;1,0;2,0;;9,0;8,0;;;5,0;360,0;;;10,0;;62,0;16,0;4,0;;;56,0;4,0;;5,0;5,0;3,0;3,0;11,0;;;;;;;52,0;4,0;1,0;;30,0;;;;;72,0;4,0;2,0;;;5,0;8,0;4,0;1,0;;1,0;48,0;;36,0;26,0;1,0;14,0;7,0;;60,0;30,0;10,0;2,0;;7,0;2,0;3,0;7,0;;2,0;21,0;10,0;;1,0;72,0;23,0;7,0;7,0;2,0;35,0;19,0;;;58,0;45,0;43,0;14,0;;;4,0;11,0;131,0;3,0;13,0;;37,0;16,0;4,0;1,0;104,0;6,0;23,0;;;16,0;42,0;1,0;41,0;23,0;;97,0;;;10,0;10,0;;36,0;29,0;;1,0;2,0;25,0;;24,0;11,0;1,0;57,0;;42,0;;29,0;1,0;;1,0;53,0;;1,0;9,0;5,0;14,0;12,0;4,0;2,0;;;4,0;11,0;1,0;;;6,0;3,0;1,0;;1,0;13,0;20,0;81,0;6,0;7,0;;11,0;76,0;55,0;2,0;1,0;12,0;1,0;7,0;;22,0;1,0;13,0;2,0;8,0;91,0;27,0;;12,0;;;33,0;;;;1,0;6,0;12,0;8,0;10,0;2,0;;;1,0;;12,0;89,0;4,0;3,0;23,0;3,0;5,0;29,0;2,0;48,0;98,0;41,0;1,0;;5,0;1,0;;2,0;4,0;48,0;;1,0;1,0;2,0;;3,0;11,0;;7,0;32,0;;;1,0;;11,0;;;27,0;3,0;;25,0;12,0;2,0;;21,0;;3,0;4,0;;6,0;4,0;4,0;3,0;;;;3,0;;;;1,0;3,0;;;;10,0;6,0;;;4,0;;9,0;;;21,0;40,0;;;2,0;;;17,0;;;;;1,0;2,0;;3,0;1,0;;;;;;;;6,0;4,0;13,0;;2,0;1,0;3,0;10,0;;;22,0;;4,0;;;12,0;1,0;2,0;4,0;70,0;;;;11,0;3,0;;;;;3,0;;3,0;;5,0;2,0;;4,0;1,0;;20,0;30,0;;1,0;6,0;;14,0;;;2,0;2,0;24,0;18,0;;91,0;;;;1,0;6,0;4,0;;1,0;1,0;;;6,0;;15,0;7,0;;;;1,0;2,0;;4,0;1,0;2,0;;;;12,0;;13,0;;;;22,0;;;2,0;4,0;;1,0;;;;;;10,0;121,0;;;;21,0;2,0;;;9,0;;3,0;8,0;6,0;;3,0;7,0;1,0;2,0;;;41,0;8,0;;;3,0;1,0;25,0;;1,0;2,0;5,0;1,0;9,0;;1,0;13,0;;1,0;1,0;6,0;11,0;2,0;4,0;;4,0;;;2,0;;25,0;8,0;;2,0;9,0;2,0;2,0;2,0;13,0;2,0;;3,0;2,0;15,0;2,0;14,0;3,0;9,0;2,0;2,0;2,0;2,0;3,0;;1,0;8,0;;;3,0;;1,0;1,0;6,0;4,0;6,0;4,0;16,0;;15,0;4,0;5,0;2,0;;38,0;42,0;8,0;;;;2,0;2,0;23,0;6,0;;10,0;16,0;1,0;;;2,0;;17,0;13,0;7,0;3,0;;8,0;;;;;;;;8,0;1,0;4,0;;2,0;1,0;;4,0;;;2,0;;1,0;;;4,0;;1,0;9,0;46,0;;;88,0;1,0;10,0;35,0;13,0;1,0;;;10,0;;13,0;5,0;;30,0;14,0;;6,0;2,0;;;3,0;;2,0;;;9,0;;1,0;6,0;1,0;;;9,0;;7,0;1,0;12,0;;;;;;;;5,0;;;;7,0;;;2,0;4,0;;;;;;2,0;;;1,0;;;8,0;;3,0;13,0;11,0;4,0;;3,0;2,0;;;;;;;;19,0;1,0;;7,0;;24,0;;19,0;6,0;;;8,0;6,0;16,0;2,0;;;11,0;;;;;;;;;;1,0;8,0;;;1,0;;1,0;1,0;;;4,0;;8,0;;;;;;;;;;;3,0;;;;;;;;;7,0;;4,0;;1,0;;3,0;2,0;;;;8,0;;;15,0;;;;;;1,0;;;;;;1,0;;2,0;1,0;;;
subsequent;;;12,0;1,0;4,0;;2,0;13,0;7,0;39,0;;;;;;3,0;2,0;1,0;1,0;1,0;8,0;16,0;;2,0;1,0;;;44,0;1,0;3,0;2,0;17,0;10,0;4,0;2,0;;;;;5,0;3,0;;;17,0;;2,0;;3,0;2,0;;;4,0;1,0;1,0;4,0;191,0;25,0;;1,0;65,0;;4,0;39,0;;;;4,0;;2,0;24,0;16,0;7,0;;;;6,0;;1,0;9,0;16,0;1,0;12,0;4,0;4,0;;;4,0;;1,0;15,0;11,0;;1,0;10,0;;;;3,0;19,0;;10,0;30,0;;6,0;;5,0;1,0;41,0;;;;;1,0;1,0;;5,0;;;;2,0;1,0;;;33,0;;;;;1,0;;;2,0;;;;2,0;2,0;;;;;;4,0;6,0;2,0;;1,0;105,0;;;1,0;;;;;;;;9,0;3,0;;1,0;;;;;2,0;5,0;;;;1,0;2,0;;7,0;;;15,0;;;;2,0;;;;;;12,0;;3,0;;;;2,0;;3,0;;;;;;;;4,0;;;20,0;;;;;;;;;25,0;3,0;;;;3,0;1,0;;;;;;;;;;1,0;;;4,0;1,0;;1,0;5,0;;2,0;;4,0;;;;;;;;;;;;2,0;;;1,0;;;1,0;1,0;3,0;;;;1,0;;;;;4,0;1,0;;;;;;;2,0;;;;1,0;;5,0;5,0;17,0;2,0;;;;;;;;1,0;4,0;;;;;7,0;;1,0;;;5,0;;;3,0;2,0;;;;;;;;;;;;;;;;;2,0;;8,0;1,0;;;;3,0;;2,0;;;;5,0;;1,0;;1,0;;;;1,0;3,0;;1,0;;;;;;;;3,0;1,0;;2,0;9,0;;;2,0;;;;;;1,0;;4,0;;;;1,0;6,0;;;;1,0;1,0;1,0;;1,0;3,0;;1,0;;1,0;3,0;3,0;3,0;13,0;7,0;;2,0;;;;3,0;;;17,0;;;;3,0;;3,0;;2,0;12,0;1,0;3,0;;22,0;;1,0;;2,0;;;1,0;;;4,0;;;;;;;;;;1,0;2,0;;;;;1,0;1,0;1,0;;;;7,0;7,0;;1,0;3,0;;1,0;;;;;;;;;;6,0;;;3,0;;;;1,0;13,0;;2,0;;12,0;2,0;2,0;;;;1,0;3,0;;5,0;;3,0;2,0;;6,0;10,0;;1,0;;1,0;1,0;;;1,0;;;;;3,0;;;;1,0;;2,0;2,0;;;;;;;;5,0;;2,0;1,0;;;;;1,0;5,0;;2,0;;;;;;;;3,0;;;;;;;;3,0;2,0;;;;;;;;;7,0;;;;;1,0;3,0;;;2,0;5,0;1,0;;;;1,0;;;1,0;1,0;;10,0;6,0;;;3,0;;1,0;;1,0;;1,0;;;;;;;;;;;7,0;;;;;;;8,0;;;;;;;;;;;;;;;;;;;;;;;;6,0;;;;;;;;;;;;12,0;;;5,0;;;1,0;;;;;;;;;;;;;1,0;;;;;;;;;;;;;;;;;1,0;3,0;2,0;5,0;;;2,0;1,0;;;;;;;;1,0;;2,0;;;;;;;;;;;7,0;;;4,0;;1,0;;1,0;;;;;;;4,0;;2,0;;2,0;;;;;15,0;;1,0;;;;;;;;;;;;;3,0;;;;;;;;;;;2,0;;;;;;2,0;;;;;;;;;;;;;;;;;;;;;;8,0;;;;;;;;;;2,0;;;;;;;;;2,0;;;2,0;;;1,0;;;;;;;;1,0;2,0;;1,0;;2,0;;;;;;;;10,0;;;;;;;1,0;;;;;;;;;1,0;;;;;;;;;;;;;;;;;;1,0;;;;;;;2,0;;;;;;;;;1,0;;;;;;;;;;;;2,0;;;;1,0;;;;;;;;;;;;;;;2,0;;;;;;;;;;1,0;;;;;;;;10,0;;;;1,0;;;;;;;;;;;;;;;;;;;2,0;;;;;;;;;2,0;;;;;;;;;;;;;;;;;;2,0;;;;;;;;;;;;;;;;;;
subset;;;1,0;;9,0;;1,0;1,0;;10,0;4,0;;;4,0;5,0;;2,0;31,0;;3,0;3,0;2,0;;;;;;46,0;1,0;4,0;;10,0;7,0;2,0;46,0;4,0;;;1,0;7,0;13,0;7,0;;9,0;;;2,0;;1,0;;;3,0;2,0;;;157,0;25,0;;;4,0;;;33,0;;2,0;;12,0;;;2,0;;3,0;1,0;;;;;59,0;4,0;4,0;2,0;;3,0;1,0;;;7,0;;3,0;45,0;62,0;;;8,0;1,0;;;;1,0;;1,0;12,0;;;;;2,0;2,0;;;1,0;;38,0;;;;;;;;;;;;;2,0;2,0;;2,0;;;;;;;1,0;8,0;;;;;1,0;2,0;3,0;;;1,0;7,0;;;;;;;;;;;6,0;7,0;;;;;;;;38,0;;;;;1,0;;;;;26,0;;;;;;;;;;53,0;;3,0;;;;9,0;;4,0;;;;;;1,0;;;;;;;;;;;;;;5,0;3,0;;;;;;;;;;1,0;;;;;;;;11,0;;;;18,0;;;;1,0;;;;;;;;;1,0;;;;1,0;;2,0;;;;;;;;;;;;1,0;;;;;;;;;;;;;;;;;;11,0;1,0;;;;12,0;;;;;;;;;;21,0;;;;;9,0;;;;4,0;;;;;;;;;;;;;;;;;;;16,0;;;;;;;;;;;;;;;;;;;;;3,0;;;;;10,0;;;;;;;;6,0;;;;3,0;;;;;;1,0;;1,0;;;;;;;3,0;;;;6,0;1,0;18,0;;;;;;;;;1,0;;3,0;;;;;;;;;;;;;6,0;;;6,0;;5,0;;10,0;;;;3,0;;;2,0;3,0;19,0;;1,0;;;;;;;1,0;;;1,0;;;;;;;3,0;;;;1,0;;;;;;4,0;;;;;2,0;;;1,0;;31,0;;;5,0;;;;;;;;;;13,0;4,0;;;;;4,0;2,0;3,0;;2,0;4,0;;30,0;1,0;;;;;;;;14,0;;;;;;;;;;3,0;;;;;;;;;;;;;;;;;;;;2,0;;;;;;;;;;;;;;;;;4,0;1,0;;;1,0;;2,0;1,0;;;55,0;;;;;;;;;;;;;4,0;;;;;;;;5,0;;10,0;;;;;;6,0;1,0;;;;3,0;;;;;;;;1,0;;;4,0;;;;;;;;;;;;;;;;;;;;;;;;;;;;;13,0;;;;;;;;;;;13,0;;;;;5,0;;;;;;;;;;;;;;;;;;;;;;;;;;;;;;;;3,0;2,0;2,0;;;;;;;;;;;;;;;;;;3,0;;12,0;;;;;9,0;;;6,0;;;;;;;;;;;;;;;;;;;;;;;;2,0;;1,0;;;;;;1,0;;;;;;;;;1,0;;;;;;;;;;;;;;;;;2,0;;3,0;;6,0;;;;;;;;;;;;;;;;;;;;;;;;;;;;;;;3,0;;;;;;;;11,0;;;;;;;;;;;;;;;2,0;;;1,0;;;;;;;;;12,0;;;;;;;;;;;;2,0;;;;;;;;;;;;;;;;;;;;;;;;;;;;;;;;;;;;;;;;;;;6,0;;;;;;;;;;;;;;;;;;;;;;;;;;;;;;;;;;;;;;;15,0;;;1,0;;;;;;;;;;;;;;;;;;;;;;;;;;;;;;;1,0;;;;;;;;;;;;;;;;;;;;;;;;;;;;;;;
successive;;;2,0;;1,0;;;7,0;;18,0;2,0;;;;;;;;;1,0;3,0;3,0;1,0;;;;;11,0;;7,0;5,0;12,0;11,0;;20,0;;;1,0;;13,0;2,0;;1,0;7,0;;1,0;;;4,0;;1,0;8,0;3,0;;;117,0;6,0;;;4,0;;;17,0;;;;2,0;;;3,0;1,0;;;;;;;15,0;1,0;;;2,0;;2,0;;;1,0;;1,0;2,0;12,0;;17,0;7,0;;;1,0;;1,0;;;3,0;;;;8,0;;3,0;;;;;1,0;1,0;;;;;;;;;;;;;;;;1,0;;;;;1,0;;3,0;;;;;1,0;3,0;;3,0;;5,0;44,0;;;;;;;;;;;;14,0;;;;;;;1,0;2,0;;;;;;;4,0;;;13,0;;;;;;;;;;11,0;;2,0;;;;8,0;;;;;;;;;;;;;1,0;;;;;;;;;13,0;;;;;;;;;;;2,0;;;;;;;;;;;1,0;3,0;4,0;;;;;;;;;;;;;;;;;;;;1,0;;2,0;;;;;;;;;;;;;;;;;;2,0;;;;;;7,0;;4,0;;;;;;;;;;;;;;;1,0;;;;;;;;10,0;10,0;;;;;;;;1,0;;;;;;;;;;;;;;;;1,0;;;;;4,0;5,0;;2,0;;;;;;5,0;;2,0;2,0;;6,0;;;;;;3,0;1,0;;;1,0;2,0;;;;4,0;1,0;;;;;;6,0;;;;;;;;;;;;;2,0;3,0;;;;3,0;;3,0;;;;1,0;;;;1,0;;;;;;1,0;;;;;1,0;4,0;;3,0;;4,0;;;;18,0;;;1,0;3,0;5,0;9,0;;;;;;1,0;;;;1,0;1,0;;;;1,0;;;1,0;;2,0;;1,0;6,0;1,0;;;;;;;;1,0;;;;3,0;;5,0;;;2,0;;;;;;;;;1,0;1,0;;;1,0;;1,0;;;;;;;;21,0;1,0;;;1,0;1,0;;;2,0;2,0;1,0;;;;6,0;;;;;;;;;2,0;;2,0;;;;1,0;;;;;1,0;;;;;;;;;;;;;1,0;;;;;;;;;;;;;;;;;;4,0;17,0;;;;;;1,0;;;;;;;;;;;;;;;;1,0;1,0;;;;;;;;;;;;;;;;;;;16,0;;;;;;;;;;;;;;;;;;;;1,0;;;;;;2,0;;;;;;2,0;;;;;;25,0;2,0;;;;;;;;;2,0;;;;;;;;;;;;;;;;;;;;;;;;;;;;;;;;5,0;2,0;;;;;;;;;;;;;;;;;3,0;;;2,0;;2,0;;;;1,0;;1,0;5,0;2,0;;;;;;;;;;;;;;;;;;;8,0;1,0;;;;;;;4,0;;;;;;;;;;;1,0;;;;;;1,0;;;;;;;;;;;;10,0;;;;;;;1,0;;;;;;;;;;;40,0;;;;;;;;;;;;;;;;;;;;;;;;;;;;;;;;;;6,0;;;;;;;;;;;;;;;;;;;;;;;;3,0;;;4,0;;1,0;;;1,0;;;1,0;;;;;;;;;;;;;;;;2,0;;;;;;;;;;;;;;;;;;;;;;;;;;;;;;;;;;;;;;1,0;;;;;;;;;;;;;;;20,0;;;;;;;;;;;;;;;;;;;;2,0;;1,0;;;;;;;;;;;;;;;;;;;;;;;;;;;;;;;;;;;;;;;;;;;;;;;;;;;;
surveillance;;;1,0;;58,0;;1,0;42,0;;21,0;1,0;3,0;;;1,0;;3,0;;23,0;5,0;1,0;25,0;15,0;;;;;9,0;;16,0;3,0;2,0;36,0;;6,0;;;6,0;;15,0;16,0;1,0;6,0;6,0;;1,0;;10,0;;;;16,0;3,0;3,0;;84,0;39,0;;14,0;16,0;;9,0;66,0;;6,0;4,0;24,0;;;10,0;14,0;;1,0;;;1,0;;3,0;45,0;41,0;3,0;8,0;8,0;;4,0;;6,0;;;13,0;17,0;;31,0;25,0;;2,0;;3,0;11,0;2,0;16,0;307,0;;2,0;2,0;;;116,0;;;4,0;2,0;;20,0;3,0;;;;3,0;;;;;5,0;;;20,0;;;17,0;10,0;3,0;;1,0;1,0;2,0;8,0;;;;;1,0;10,0;3,0;1,0;1,0;3,0;4,0;;;;1,0;4,0;1,0;2,0;;7,0;21,0;1,0;6,0;1,0;;2,0;;;;;2,0;;;4,0;1,0;10,0;38,0;3,0;6,0;1,0;8,0;;1,0;4,0;;;1,0;;2,0;2,0;98,0;;59,0;2,0;;;15,0;1,0;;;;2,0;1,0;;1,0;;6,0;;1,0;;15,0;1,0;13,0;5,0;1,0;;;10,0;7,0;13,0;2,0;;2,0;;11,0;;;;1,0;3,0;;;;;;;1,0;3,0;15,0;;2,0;68,0;;;;;2,0;;1,0;;11,0;;;;;;25,0;;;1,0;12,0;1,0;;;8,0;1,0;1,0;2,0;2,0;3,0;;;;1,0;8,0;;;;2,0;1,0;;;4,0;1,0;;;11,0;;10,0;4,0;34,0;6,0;;;;;;;;;;;;;;2,0;;;3,0;21,0;1,0;;1,0;6,0;19,0;1,0;1,0;13,0;;10,0;;9,0;;;16,0;1,0;1,0;;2,0;;3,0;12,0;;1,0;;;;;;;;;;1,0;12,0;2,0;3,0;;;;;;4,0;5,0;3,0;;1,0;;;1,0;;4,0;;;;;2,0;8,0;2,0;;;1,0;1,0;;;;1,0;3,0;;2,0;;;;1,0;;1,0;5,0;;;;11,0;;5,0;;2,0;4,0;25,0;;;1,0;20,0;;;13,0;1,0;3,0;;;;1,0;4,0;;;;;;;;2,0;;;7,0;8,0;5,0;;;;3,0;;;;;2,0;5,0;1,0;;;;;;1,0;1,0;;;;;;13,0;6,0;;;12,0;;;;8,0;;;6,0;7,0;;;1,0;;;4,0;;;29,0;;;;;1,0;9,0;;;3,0;1,0;;;;;;;1,0;4,0;;5,0;;3,0;3,0;2,0;;6,0;;1,0;194,0;33,0;;;;;;;;;2,0;;;;;;4,0;;;6,0;2,0;4,0;;9,0;;;;3,0;1,0;;;;6,0;;;1,0;10,0;;1,0;1,0;;;;;;;8,0;7,0;1,0;4,0;;;;;1,0;;;;;;19,0;;3,0;;1,0;13,0;;;;;;;3,0;;;;;2,0;3,0;2,0;;;2,0;;;;;17,0;6,0;;1,0;1,0;2,0;;;27,0;86,0;;1,0;1,0;;3,0;;4,0;;;;;4,0;;1,0;;;1,0;;;1,0;;1,0;1,0;;1,0;4,0;;;;;;;;4,0;;;;4,0;;10,0;;;18,0;2,0;;;;3,0;;;2,0;;;1,0;1,0;;;;7,0;2,0;;;;1,0;;;;;;2,0;;3,0;;;8,0;;;;;;;27,0;;;1,0;;;;1,0;;;1,0;;8,0;;;1,0;;;;;;;;;;;;;;;;;;1,0;;;;5,0;;1,0;;2,0;1,0;1,0;;;;4,0;;;;;;3,0;6,0;;;;4,0;;2,0;2,0;;4,0;;;3,0;10,0;;;;;;;1,0;;;;;;;;;;;;;;;;5,0;;;;;;;;2,0;;;;;4,0;;1,0;;;;;;;;;;1,0;;3,0;;;;;1,0;;;;1,0;;;;;;;;;;;;;1,0;;1,0;;;1,0;;;;;;;;;;;;;;;;;;2,0;;;;2,0;;;;3,0;6,0;;10,0;;;1,0;;;;10,0;;;;;1,0;;;;;;;;;;6,0;;;1,0;;;;;;1,0;;;;;;;;;;;;4,0;;;;;;1,0;;;;3,0;;2,0;;;;;;6,0;;;;;;1,0;;;3,0;;;;;;1,0;;1,0;;;;;;;2,0;;;;;1,0;;;;;;;;;;;2,0;;;;;;;;;;;;;;;;;2,0;10,0;;;;;;;;;;;;;;;;1,0;;1,0;;;;;;;;3,0;;;;;;;;2,0;
synchronization;;;4,0;;;;;11,0;1,0;3,0;;;1,0;;;;;;;;3,0;23,0;;;;;;43,0;;14,0;2,0;;25,0;1,0;9,0;;;;;1,0;1,0;;2,0;;7,0;;;;5,0;4,0;2,0;12,0;;;;21,0;8,0;;;16,0;;;19,0;;;;;;3,0;3,0;;;;;;;;;6,0;;;1,0;2,0;;;;;;;2,0;2,0;6,0;12,0;158,0;;2,0;;4,0;3,0;;;5,0;;7,0;;2,0;;6,0;;;;;;;;;;;;14,0;;;;;;;11,0;;;;;1,0;;;;1,0;;;;7,0;;;7,0;;;;2,0;6,0;;;;;;;;;;;1,0;5,0;;;;;;;3,0;12,0;3,0;;;;1,0;;;1,0;;15,0;;;2,0;;5,0;;;;;4,0;;;;;;25,0;;;;;2,0;;;;;3,0;;;;;;;4,0;;;;;65,0;22,0;;6,0;;;;;;;2,0;;;;;;;;;2,0;;;;;;;;;;;;1,0;;;;;;;11,0;8,0;;;3,0;6,0;;;7,0;;;;;;;;;;;;;;;;;;;;;;;;;;2,0;1,0;;;;;;;;;3,0;;;1,0;;2,0;;;;;;;;6,0;;;;;;;;;;;;;;;;;;;;;;;;;;;2,0;;;;;;6,0;;;;;;;1,0;;;;;;;;;3,0;;;;;;5,0;;;;;;;;;;;;;;;24,0;5,0;;;62,0;;;;;14,0;;2,0;;;5,0;7,0;2,0;;;;;;1,0;;1,0;;;3,0;;2,0;;;;;;1,0;10,0;;;;2,0;;;;8,0;;;8,0;;;1,0;;;;;;;;9,0;;;;;2,0;1,0;8,0;1,0;;;;;2,0;3,0;13,0;;1,0;;;;;;8,0;;;;;;;;;;4,0;;;;;;;;;3,0;1,0;;;;;;;;2,0;;1,0;;2,0;15,0;;;;;;;;;;;;;;;;;;;2,0;2,0;3,0;26,0;;;3,0;;;;;;5,0;1,0;;;;;;;;;;;;;;1,0;;;;;;;;;;;;;;1,0;;;;;;1,0;;;;;;;3,0;;;;2,0;;;;;;14,0;;;;;;;4,0;;;;;3,0;2,0;;;;;;;;;;;;2,0;;;;;;;;;;;;;;20,0;;;;1,0;;;;;;;;;;;2,0;;;;;;;;;;4,0;;;;;;;;;;;;;;;;1,0;5,0;;;;2,0;;;;;;;;8,0;;;;24,0;;;;;;;;;;;;;;5,0;;;2,0;;;;;;43,0;;;2,0;;;;2,0;;;;7,0;;;;1,0;3,0;;;;;;;;2,0;;;;;;;;;;32,0;1,0;7,0;;;;;;;;;;5,0;;;;;3,0;;;;;;;;;;;;;;;;3,0;;;;;1,0;;;;;;6,0;;;;1,0;;;;;;1,0;;;;;;;;;6,0;;;;;;;;;;;;;;;;;;;;;1,0;;;6,0;;2,0;4,0;;;;;;;;;;;1,0;;;;;;4,0;;;;;2,0;;;;;;;;;;;;;;;;;;;;;;;;;;;;;;;;;;;;;;;;;;;;;;10,0;;;;3,0;1,0;;;;;;;;;;;;;;;;;;;;;;;;;;;;;;;;;;;;;;;;;;;;;;;1,0;;;;;;;;;;;;;;;;;;;;;;;;;;;;;;;;;;;;;;;;;;;;;;;;;9,0;;;;;;;;;
synthesize;;;1,0;;3,0;;;15,0;;18,0;;1,0;;;4,0;1,0;1,0;;3,0;;1,0;9,0;;;;;;36,0;;4,0;;1,0;47,0;1,0;10,0;15,0;;;;63,0;7,0;;;8,0;;;;2,0;;;7,0;40,0;;3,0;;344,0;4,0;;4,0;6,0;;;21,0;;;;2,0;;;2,0;;;;;;;;;2,0;;;14,0;5,0;5,0;1,0;;17,0;;1,0;;;;4,0;41,0;;;;;4,0;;;10,0;;1,0;;;;46,0;;;;;;;;;;;;;;;;3,0;;;18,0;;;;;1,0;;;;;;;;;1,0;;;1,0;1,0;;7,0;2,0;;;;;;;;;;;;6,0;;1,0;;;;;6,0;16,0;;;;;12,0;;;1,0;;4,0;;;;;;2,0;;2,0;;11,0;2,0;1,0;;;;3,0;;2,0;;;;;;;;;;3,0;;4,0;2,0;;;;;;;;1,0;;1,0;;;;;;;1,0;;;;;;;;;8,0;;;4,0;16,0;;;;;;;;;;;;;;;;;;;;;;;;;;;;;;;;;;;;;;;;;;;;;;;2,0;;6,0;;;;;1,0;;;1,0;;1,0;;;;;5,0;;;;;3,0;;;4,0;2,0;;;;;;;;;;;;;;5,0;;;;;2,0;;;;;2,0;;;;;;7,0;;;3,0;;;;;;;;;;;;;;;;;;;;;;;;3,0;;;;;;;6,0;;;;;;1,0;;1,0;;;;;;11,0;;2,0;;;23,0;16,0;;;;;;;;;;;;1,0;;;;;;1,0;;;;;;;;;;2,0;11,0;;;6,0;1,0;;4,0;;;;;;;;1,0;;;;;;;1,0;;;;;;;1,0;;;;;;4,0;;;;1,0;3,0;;10,0;;3,0;;;;11,0;;;;;;;;1,0;;;;2,0;;1,0;2,0;;;4,0;;3,0;;;26,0;1,0;;;;;;;;;;;;;;;;;;;;;;;;;;;2,0;;;;1,0;;;;;;;;;1,0;;;;;;;;;;;;;;;1,0;;;;;;;;;;9,0;;;;;;;;;;;;;;;;;;;;;;9,0;;;;;;7,0;1,0;;;;12,0;;2,0;;;;;;;1,0;;;;;9,0;;;;;;;;;;;;;;;;;;;;;;;;;;1,0;;;;;;;;6,0;;;;1,0;;;;;;;;;;;;;5,0;3,0;;;;;;;;;;;;;;;;;;6,0;;;;;;3,0;;;;;;;;;;;;;;;;;1,0;1,0;;;;;;;;4,0;;;;;;;;;;;;;;;;;;;;;;;;;;1,0;;;;;;;;;;2,0;;1,0;;;5,0;;;;;;;;;;;;;;;;;;;;;;;;;;;;1,0;;;;;;;;;2,0;;;;;;1,0;;;;;;;;;;;10,0;;;6,0;;;;;;;;;;1,0;;;;;;;;2,0;;;;;4,0;;;;;;;;;;;6,0;1,0;;;;;;;;;;;;;;1,0;;;;;;;;;;;;;;;;16,0;;;;4,0;;;;2,0;;;;;;;;;;;;;;;1,0;;;;;;;;;;;;;2,0;;1,0;;;;;;;;;;;1,0;;;;;;;;;;;;;;;1,0;;;;;;1,0;;;;1,0;;;;;;;;;;;;;;;;;;;;;;;;;;;;;;;;;;;;;;;;;;;;;;;;;;;;;
table;;;7,0;;8,0;;15,0;23,0;4,0;5,0;16,0;;;2,0;12,0;1,0;;1,0;3,0;3,0;1,0;35,0;5,0;12,0;20,0;1,0;;52,0;;8,0;3,0;23,0;20,0;;15,0;;3,0;;;5,0;12,0;3,0;;1,0;;;8,0;;2,0;;12,0;11,0;;;;58,0;35,0;2,0;4,0;13,0;13,0;;43,0;2,0;21,0;1,0;2,0;;;3,0;5,0;1,0;;;;;;7,0;18,0;;1,0;11,0;10,0;1,0;;;6,0;;3,0;12,0;2,0;;;13,0;3,0;4,0;;8,0;84,0;;7,0;23,0;1,0;2,0;2,0;1,0;1,0;41,0;;;;1,0;3,0;1,0;2,0;;;1,0;;1,0;;;;7,0;;;15,0;2,0;;4,0;2,0;8,0;;;1,0;2,0;12,0;;;;;1,0;;8,0;1,0;;6,0;2,0;;;2,0;;;;1,0;;;7,0;3,0;4,0;1,0;3,0;2,0;1,0;;;3,0;17,0;1,0;1,0;1,0;5,0;11,0;7,0;11,0;4,0;;12,0;;;;;1,0;;;2,0;;25,0;;8,0;;;;5,0;2,0;3,0;;;2,0;;;2,0;;12,0;;3,0;5,0;;;6,0;;;;;7,0;14,0;1,0;1,0;2,0;;;1,0;;;;;;;;;;;;;3,0;9,0;;;3,0;;;;1,0;5,0;;1,0;;1,0;;;;;;10,0;;;;2,0;;;;4,0;57,0;;;;;;;1,0;;;2,0;;;1,0;;;;7,0;;;;1,0;;3,0;4,0;7,0;7,0;1,0;;;;2,0;;;;;;;;;2,0;3,0;1,0;;;1,0;;;25,0;4,0;;;;;;;;;1,0;;;;;;;;8,0;;;;;;;;2,0;;;1,0;;7,0;3,0;;;4,0;4,0;;;1,0;2,0;;;2,0;;1,0;7,0;;;;;;;;6,0;;;;;;;;;1,0;;44,0;;;;3,0;;;;3,0;3,0;;;10,0;;2,0;;2,0;;;2,0;2,0;1,0;11,0;1,0;;3,0;;3,0;1,0;;1,0;;8,0;;;;4,0;;12,0;;;;;9,0;;3,0;2,0;;4,0;16,0;;;7,0;;;;;;;;;;;;14,0;1,0;;;;1,0;3,0;3,0;;;;;;1,0;4,0;;3,0;;;;;;3,0;;3,0;;;;;18,0;;;8,0;;;7,0;2,0;;;;;8,0;;;;;3,0;;;;6,0;;;6,0;9,0;21,0;3,0;;;;;;58,0;;5,0;2,0;;1,0;;;;;;7,0;1,0;2,0;;;;2,0;1,0;1,0;;;;;;;;;;;2,0;;;;7,0;;;;1,0;;4,0;1,0;1,0;;;3,0;;25,0;;2,0;3,0;;9,0;2,0;;;6,0;;;14,0;;;;;;5,0;;;1,0;;;;;;;;;1,0;;;;2,0;;;1,0;;;;;;;;;1,0;;;;;;;;6,0;;;;;;2,0;;;2,0;;;;;;;;1,0;;;;;1,0;;;;;;;;;1,0;;2,0;;;;;;;;;1,0;3,0;;;2,0;;1,0;;1,0;;;;;;13,0;1,0;2,0;;;;;;;;;;;;;;1,0;;;2,0;;;;;2,0;8,0;18,0;;;;;;;;;;2,0;;;;3,0;;;;1,0;;;1,0;;;2,0;2,0;;;;1,0;;;;;;;;8,0;;;;;;;;;;4,0;;;;;;;3,0;;4,0;;;;;;5,0;1,0;;;;;;;;;2,0;;;1,0;;1,0;1,0;;;;;;;;;1,0;;;1,0;2,0;;1,0;;;;4,0;;;;;2,0;1,0;;;;;;;;;;;2,0;;;;2,0;1,0;;;;;1,0;;;;;1,0;;;3,0;;;;;;2,0;;;;;;2,0;;10,0;1,0;;;;;;;;;;;;;;6,0;;;;;;;;8,0;;2,0;;;1,0;;;1,0;;;;;;;;1,0;;;1,0;;;;2,0;;;;;;;;;;;;;;;;;;;;4,0;;;;;;;;;;;;;;;;;;;;3,0;;;;;;6,0;;1,0;;;;;;;1,0;;;;;;;;6,0;;;;;;;;;;2,0;;;;2,0;;;;;;;;;;;;;;;;;;;2,0;;;;1,0;;1,0;;;;;;;;;;;;;;;;5,0;;;;;
target;;;74,0;11,0;56,0;;15,0;200,0;73,0;126,0;19,0;29,0;;1,0;30,0;4,0;4,0;;14,0;19,0;2,0;91,0;111,0;30,0;8,0;4,0;5,0;98,0;15,0;207,0;28,0;219,0;160,0;13,0;22,0;14,0;23,0;45,0;7,0;105,0;127,0;4,0;46,0;39,0;5,0;13,0;;7,0;75,0;10,0;11,0;58,0;;26,0;9,0;813,0;217,0;;10,0;50,0;;10,0;223,0;4,0;16,0;3,0;34,0;;8,0;9,0;62,0;2,0;10,0;4,0;1,0;2,0;;144,0;312,0;3,0;2,0;54,0;30,0;27,0;14,0;2,0;107,0;20,0;18,0;70,0;36,0;4,0;20,0;115,0;90,0;26,0;4,0;13,0;13,0;10,0;90,0;230,0;1,0;1,0;6,0;;16,0;127,0;;;25,0;5,0;11,0;9,0;4,0;2,0;1,0;1,0;;1,0;1,0;9,0;7,0;4,0;;4,0;29,0;3,0;24,0;1,0;15,0;12,0;;;2,0;8,0;15,0;;;6,0;20,0;12,0;5,0;174,0;17,0;1,0;27,0;168,0;;;;;7,0;;8,0;;6,0;16,0;14,0;99,0;1,0;8,0;;21,0;12,0;;12,0;116,0;;;8,0;10,0;51,0;6,0;22,0;5,0;1,0;75,0;1,0;;;;2,0;3,0;;86,0;18,0;106,0;;47,0;;;11,0;68,0;;14,0;;;22,0;;;40,0;;13,0;;19,0;1,0;7,0;27,0;4,0;17,0;6,0;1,0;1,0;13,0;79,0;31,0;;3,0;;12,0;14,0;8,0;30,0;;26,0;28,0;;;;;;;4,0;23,0;25,0;;16,0;197,0;5,0;;3,0;17,0;2,0;;2,0;3,0;;;;7,0;45,0;;9,0;4,0;;;92,0;19,0;;2,0;10,0;8,0;;;;4,0;2,0;;;1,0;6,0;;;;3,0;15,0;;;44,0;1,0;;4,0;15,0;2,0;21,0;79,0;534,0;5,0;;19,0;;14,0;153,0;;;;31,0;13,0;;7,0;;106,0;29,0;8,0;;;43,0;;;53,0;7,0;;;2,0;;3,0;;;;;36,0;;;2,0;67,0;;;;2,0;35,0;;2,0;1,0;;;2,0;5,0;6,0;2,0;2,0;23,0;;11,0;1,0;;11,0;;3,0;25,0;17,0;6,0;5,0;1,0;;5,0;1,0;7,0;;;28,0;10,0;;;104,0;33,0;;7,0;;25,0;;;;52,0;14,0;12,0;7,0;22,0;;4,0;6,0;4,0;17,0;7,0;3,0;14,0;50,0;16,0;;22,0;;17,0;10,0;3,0;4,0;7,0;18,0;;4,0;;193,0;;14,0;2,0;2,0;7,0;6,0;44,0;1,0;1,0;10,0;3,0;;3,0;1,0;34,0;110,0;;23,0;47,0;119,0;8,0;;2,0;21,0;1,0;4,0;5,0;23,0;70,0;47,0;;;;1,0;;;8,0;8,0;;1,0;20,0;;2,0;;18,0;9,0;7,0;20,0;1,0;;3,0;47,0;6,0;;;12,0;4,0;6,0;;;6,0;;5,0;4,0;13,0;17,0;1,0;23,0;;;35,0;3,0;4,0;4,0;4,0;18,0;1,0;12,0;86,0;2,0;5,0;3,0;1,0;4,0;8,0;13,0;2,0;;32,0;4,0;12,0;1,0;3,0;258,0;106,0;21,0;1,0;26,0;1,0;;5,0;1,0;12,0;14,0;4,0;4,0;;;;;;;101,0;40,0;;;3,0;9,0;;;;;;1,0;;9,0;;1,0;;2,0;1,0;;2,0;;4,0;;1,0;2,0;5,0;;1,0;1,0;2,0;5,0;;;2,0;;;6,0;9,0;;2,0;4,0;;8,0;;;14,0;227,0;9,0;;6,0;;;38,0;1,0;;15,0;;6,0;6,0;1,0;;;;1,0;;2,0;;3,0;41,0;13,0;;6,0;;1,0;;6,0;1,0;;;;7,0;;;;21,0;5,0;;;45,0;;;;;;;;;;1,0;;;;2,0;;1,0;5,0;;;;1,0;;;;;10,0;;;;3,0;15,0;43,0;;61,0;3,0;;;;3,0;;6,0;;4,0;;;10,0;;22,0;2,0;2,0;;;;;;7,0;;28,0;;;3,0;7,0;13,0;;;;5,0;;;;;4,0;;;2,0;;26,0;;;5,0;8,0;197,0;;;2,0;;;;;4,0;;;;;;21,0;;;;;4,0;3,0;;;5,0;32,0;14,0;;7,0;17,0;18,0;;;;;;;2,0;13,0;1,0;;;23,0;;1,0;;;4,0;2,0;31,0;16,0;;;;;;;5,0;3,0;;22,0;8,0;10,0;5,0;;7,0;;;5,0;;11,0;12,0;;6,0;;7,0;6,0;2,0;30,0;13,0;17,0;22,0;;6,0;;17,0;;20,0;2,0;3,0;36,0;30,0;;45,0;11,0;;2,0;8,0;;8,0;6,0;1,0;;36,0;10,0;;;;;;12,0;9,0;;;;2,0;;8,0;;;;5,0;;;5,0;30,0;7,0;;3,0;2,0;28,0;;;;3,0;5,0;2,0;2,0;;1,0;;;3,0;;;90,0;17,0;1,0;3,0;13,0;2,0;3,0;;4,0;;2,0;;;3,0;9,0;1,0;3,0;9,0;;6,0;1,0;;;;14,0;3,0;;9,0;20,0;;;1,0;1,0;;38,0;;8,0;;3,0;;;;;;3,0;;;;;;12,0;;;;;;;;;;2,0;;;;42,0;2,0;22,0;1,0;13,0;1,0;1,0;;7,0;;;;;11,0;;1,0;1,0;;26,0;13,0;;5,0;;;1,0;;;;4,0;1,0;4,0;8,0;;;5,0;20,0;;;;;;4,0;7,0;;6,0;;;;;;2,0;3,0;;;5,0;5,0;;;;;;3,0;;10,0;;;;29,0;3,0;;;;;;;;8,0;;7,0;8,0;2,0;1,0;;;5,0;;;;5,0;95,0;2,0;;;1,0;;;;;;;;;;2,0;;;;
technique;;;1,0;1,0;11,0;;;12,0;1,0;8,0;;;;;2,0;1,0;3,0;;;13,0;1,0;1,0;;;;;;7,0;;1,0;15,0;14,0;14,0;;11,0;1,0;1,0;;;3,0;;;;;2,0;;;;4,0;1,0;5,0;21,0;;1,0;;43,0;17,0;3,0;;;1,0;;43,0;;;1,0;2,0;;2,0;1,0;;1,0;;;;1,0;;5,0;5,0;4,0;;10,0;2,0;;;;;;;8,0;8,0;;;2,0;;;1,0;;1,0;3,0;;27,0;;2,0;;1,0;;2,0;;;;;1,0;1,0;;;;;;;;;;8,0;;;4,0;;3,0;;;;;;3,0;2,0;;;;;;;;;13,0;;1,0;31,0;;;;;;;;1,0;;3,0;;11,0;;;;;;;;;;;;;2,0;1,0;1,0;;;6,0;4,0;;;;;;1,0;;;4,0;;1,0;;;;2,0;;;;;;;;;;;;5,0;;;;1,0;;;;;;5,0;;;;;;1,0;;;;;3,0;;;;;;;;1,0;;;11,0;;;;;;;;2,0;;;;;;23,0;;;;;;3,0;;;;;;;;;;;;;;;;;1,0;1,0;;;;1,0;;;4,0;;;8,0;;10,0;2,0;;;;;4,0;;;;;;;;;;;;;;3,0;;;;;;;;;;;;;;;;;;5,0;;;;;9,0;;1,0;;;;;;1,0;1,0;;1,0;;1,0;;;;;;;;;;;;;;;;;;;;;5,0;;;;;;;;;;;1,0;;28,0;;;1,0;;1,0;2,0;;;1,0;1,0;;2,0;;2,0;1,0;;1,0;2,0;;2,0;;;20,0;;6,0;;2,0;;1,0;1,0;;;;1,0;;2,0;1,0;4,0;;;;;6,0;;;;;;2,0;1,0;5,0;4,0;1,0;;3,0;;;;;;5,0;1,0;;2,0;;;;;;2,0;1,0;;;;1,0;;;5,0;1,0;;;;;;;;;2,0;;;10,0;2,0;;;;;;;2,0;;7,0;;;;;;;;2,0;1,0;;;3,0;2,0;;;25,0;4,0;1,0;;;;;;;;;;;;;;;;;2,0;1,0;;;;;;;;2,0;;;;;;;;;2,0;;;;;;;1,0;;;;1,0;;;;;1,0;;;3,0;;;1,0;;;;;;23,0;3,0;;;;;;;;;;;3,0;;;;;;;1,0;;;5,0;1,0;;1,0;;4,0;;;1,0;2,0;;;;;;;;1,0;;;;1,0;;;;;9,0;;;;;;;;;;;;2,0;;;;;1,0;;;;;;1,0;;;;;1,0;3,0;;;;;;;;;;;;;;1,0;;;;;;;;;;1,0;;;;;;;;;;;;;;;11,0;;;;;;;;;8,0;;;;;;;3,0;;;1,0;;;;;;;;;;;;;;;;;;;2,0;;1,0;;;;;;3,0;;1,0;;;;;;;1,0;2,0;;1,0;;3,0;;;2,0;;;;;;;28,0;;;;;;;;;1,0;;14,0;1,0;;;1,0;;3,0;;3,0;;;;;;;;;;;;;;;;;;;;;;;;;;;;;;;;2,0;;;;;;;;;;;;1,0;;;;;;;;;;;;;;;;;;;;1,0;;;;;;;;;;;;;;;;;;;;;;;;;;;;;;;;;;;;;;1,0;;;;;;;;;1,0;;;;;;;;;;;;;;;;;;;;;1,0;;;;2,0;;;;;;;;;;;;;;;;;;;;;;;1,0;;;;;;;;;;;;;;;;;;;;;;;;;;;;;;;;;;;;;;4,0;;;;;;;;;;;;;;;;;;;;;;9,0;;;;;;1,0;;;;;;;;;;
telephoto;;;15,0;;;;3,0;;;;;;;;;;;;;;15,0;;;;;;;;;;;;4,0;;1,0;;;4,0;;;31,0;;;;;;;209,0;6,0;;2,0;;;31,0;;24,0;3,0;;383,0;401,0;;43,0;1,0;3,0;;;3,0;;;;26,0;;;;;;;3,0;57,0;4,0;;;;;;;2,0;3,0;;;;;39,0;;3,0;1,0;;;;;7,0;285,0;;;;;2,0;143,0;;;;;;;;;;;;;;;5,0;1,0;;;;;;;;;;;;;;;;;;;;;;;1,0;1,0;;;;;;;;;;;;22,0;6,0;3,0;;;;;;;;;;;;;10,0;;;2,0;;;;;;;;2,0;;;;;;;;;;1,0;;;;;;;;48,0;;;;;;;;;;;;29,0;;;;;;;;;;;;;;;2,0;;;;;27,0;;;5,0;;16,0;;;;;18,0;;;;;;;;;;;;;;;;;;;;;;;;;;;;;;;;;547,0;2,0;;;;;;;3,0;9,0;;;;;;;;2,0;;4,0;;;;;;;;;;1,0;1,0;;;;;;;;;;;;;;;;;;;;;;;4,0;;;;;;;;;;;;;;;;;2,0;18,0;5,0;;;;;;;;;;;;;;1,0;;;;1,0;;;1,0;;;;;;;7,0;;;;;;;;;15,0;;;;;;;;;;;;;;;;8,0;;;;285,0;;;;;;;;;;;;;1,0;;;3,0;2,0;;;;;1,0;;;;;;;;;;;;;;;;;;3,0;;;;;3,0;;2,0;;;;;;;;;;;;;;;;;;;;;;;;;;;;;;;;;;;;;;;;;;;;;;;;;;2,0;;;11,0;;;;;;;;;;;;;;;;;;;;;;;;;;;;;;;;;;;;;;;;;;;;;;;;;;;;;;;;;;;3,0;;1,0;;;;;;;;;;;;;;;;;3,0;;;;;;;;;;;;;;;;;;;;;;;;;;;;;;;;;;;;;;;;;;;;;;;;;;;;;;;;;;;;;;3,0;;;;;;;;;;;;;;;;;;;;;;;;;;3,0;;;;;;;;;;;;;;;;;;;;7,0;1,0;;;;;;11,0;;;;;;;;;;;;;;;;;;;;;;;;;;;;;;;;;;;;;3,0;;;;;;;;;;;21,0;;;;;;;;;;;;;;;;;;;;;;;;1,0;;;;;;;;;1,0;;;;;;;;;;;;;;;;;;;;;;;;;;;;;;;;;;;;;;;;;;;;;;;;;;2,0;;;;;;;;;;;;;;;;;;;;;;;;;;;;;;;;;;;;;;;;;;;;;;;;;;;;;;;;;;;;;;;;;;;;;;;;;;;;;;;;;;;;;;;;;;;;;;;;;;;;;;;;;;;;;;;;;;;;;;;;;;;;;;;;;;;;;;;;;;;;;;;;;;;;;;;;;;;;;;;;;;10,0;;;;;;
temperature;;;19,0;;20,0;;3,0;48,0;23,0;44,0;8,0;8,0;;1,0;600,0;1,0;12,0;7,0;10,0;3,0;39,0;41,0;1,0;3,0;30,0;2,0;5,0;20,0;24,0;146,0;51,0;81,0;172,0;14,0;13,0;1,0;;5,0;;33,0;6,0;;5,0;57,0;;;;2,0;29,0;3,0;3,0;10,0;1,0;;;118,0;33,0;;6,0;57,0;;1,0;92,0;17,0;1,0;3,0;1,0;;;5,0;8,0;3,0;4,0;;4,0;;;18,0;50,0;8,0;;11,0;12,0;2,0;3,0;;5,0;3,0;4,0;9,0;127,0;;24,0;61,0;3,0;1,0;6,0;3,0;16,0;10,0;16,0;29,0;;1,0;4,0;;1,0;36,0;1,0;;7,0;3,0;4,0;12,0;;12,0;;;3,0;2,0;;;2,0;15,0;;;41,0;;4,0;6,0;1,0;5,0;8,0;;2,0;33,0;4,0;;1,0;19,0;1,0;9,0;11,0;;31,0;;5,0;;;;3,0;;;40,0;1,0;3,0;;11,0;24,0;39,0;;8,0;;5,0;2,0;2,0;136,0;186,0;1,0;16,0;3,0;;16,0;9,0;5,0;2,0;;22,0;1,0;;;;3,0;;;1,0;1,0;17,0;;28,0;;;17,0;32,0;;;;2,0;;;;;;14,0;;23,0;;;8,0;9,0;;2,0;67,0;;1,0;25,0;9,0;1,0;;;;;1,0;1,0;;;1,0;;;;;;5,0;;69,0;;;4,0;84,0;;9,0;;;;;3,0;3,0;;;;;;1,0;3,0;;;;12,0;20,0;;2,0;9,0;;;;;;;;;;;;1,0;6,0;2,0;;;1,0;2,0;;;;2,0;;;23,0;33,0;24,0;;;;;1,0;;;;5,0;;;6,0;1,0;88,0;;;;;84,0;;;101,0;4,0;4,0;;;;;;;2,0;;51,0;;;;14,0;;;12,0;;2,0;24,0;1,0;;;;;;;;;21,0;8,0;7,0;;;2,0;2,0;2,0;42,0;31,0;;1,0;1,0;1,0;;;;;;4,0;;;1,0;;7,0;3,0;;;;3,0;;;57,0;3,0;4,0;1,0;2,0;;;3,0;8,0;7,0;2,0;34,0;2,0;15,0;12,0;4,0;15,0;;21,0;;;3,0;1,0;2,0;1,0;44,0;21,0;;;;44,0;;;;5,0;;10,0;;1,0;;;;;;;8,0;;7,0;2,0;;6,0;5,0;;;19,0;3,0;5,0;;1,0;;2,0;4,0;;;;;22,0;;;;;4,0;22,0;6,0;24,0;6,0;;;;40,0;92,0;;1,0;;;;;;2,0;;17,0;;5,0;;;4,0;;1,0;29,0;;;;;1,0;;;;29,0;;;;;;;;;17,0;;6,0;;;2,0;2,0;;7,0;;;;;4,0;;10,0;;;;;;2,0;;;4,0;;3,0;;;;;;;7,0;2,0;;43,0;;;;;4,0;;1,0;;;;;;;;;;;;1,0;15,0;;;;3,0;6,0;;5,0;6,0;;;;;;;9,0;;;;;;4,0;;;3,0;7,0;1,0;;;;;;1,0;4,0;;;;29,0;2,0;;10,0;;;;4,0;;;;;2,0;;;;;;;;;;;;1,0;;;;;;;;;;;;;;;;2,0;;;;;;1,0;;;29,0;11,0;30,0;;;;2,0;;;;;;1,0;;;;;;;;;;;;;1,0;;;;;;;;;1,0;;;;;29,0;;;;;;;;;;1,0;;9,0;;;4,0;;;1,0;;1,0;7,0;5,0;;;;1,0;;;8,0;11,0;1,0;;;;;;;9,0;11,0;;;;;;;;;;2,0;5,0;;;;;2,0;1,0;;6,0;1,0;1,0;;19,0;5,0;;;1,0;;;;3,0;3,0;;8,0;5,0;;13,0;;2,0;;;;;6,0;;;;11,0;2,0;;;3,0;1,0;10,0;2,0;;;1,0;;;6,0;10,0;;;;;1,0;16,0;2,0;;;;;;21,0;;;;;;;;;;;;;1,0;;;;;;;;;2,0;;7,0;;;1,0;;;;;45,0;;6,0;;;;20,0;;;;;1,0;4,0;;;3,0;51,0;;;3,0;12,0;;;;;;;;1,0;4,0;;;;;;;12,0;14,0;2,0;;;;1,0;;;;;;;;;;;;;;;;;;;;;;3,0;;;;;2,0;;;;;;;;;;;;;;;;;;;;;;;1,0;2,0;;;;;;;;;;;9,0;;;;;4,0;;1,0;8,0;;;4,0;;;;;;;;;;;;;;;;;;;;4,0;10,0;4,0;;;;;;;;;;;;;;;;;;;;1,0;;;;;;;;;;;;;;;;;;;;;;;;;;
template;;;14,0;;1,0;;;5,0;15,0;1,0;;11,0;;;16,0;;;;14,0;8,0;16,0;;2,0;;;;;9,0;5,0;3,0;1,0;13,0;4,0;;1,0;;;;;1,0;2,0;;;;;;;;;;;3,0;;;;482,0;39,0;;;;;27,0;20,0;;6,0;;;;;;;;;;;;;3,0;9,0;;;1,0;2,0;;;;14,0;;1,0;107,0;5,0;;;1,0;7,0;;;8,0;20,0;;;9,0;;;6,0;;;19,0;;;;;;;;;;;1,0;;;;;;;;6,0;;;;;;;;;;2,0;;;;;;;;;;;15,0;;;;;;;1,0;;;;;;;;;;;;;;;;;;;;;;;;;;;;;;;;;118,0;;;;;;1,0;;;;;;;;6,0;;;;4,0;;;;;;1,0;;;;16,0;;3,0;;;;;;;;;;;;;;;;;6,0;;;;2,0;;;7,0;;;;4,0;;;;;;;;;1,0;;;3,0;;;;;1,0;;;;;;;;;;;;;;;;1,0;4,0;;;;;;1,0;;22,0;;;;;;1,0;;;;5,0;;;;;18,0;;;;;;;;4,0;2,0;;;;;;;;;;;;;;;;;;;1,0;;;;;;3,0;;;1,0;;;;1,0;;;;2,0;;;7,0;;2,0;;2,0;;;;;;2,0;;;;2,0;;;;;;;;;;5,0;1,0;;;;;;;3,0;9,0;;;;;1,0;;;;;;;;;12,0;;;2,0;;3,0;;;;;;;;;1,0;;3,0;;1,0;22,0;;25,0;;16,0;;;;;;;;2,0;1,0;;;;;;;;;;;;1,0;;;;;;;6,0;;;8,0;;;;;;;17,0;;;2,0;1,0;;;4,0;;;;;;18,0;;;;;;;1,0;;;14,0;;1,0;;;1,0;;;;;;;;11,0;1,0;;;;;;;;1,0;;;;;;;;;;;;;;;;13,0;;;;;;;3,0;;;1,0;;;;;;;;;;;;;;;;;;;;;75,0;;;;;;1,0;;;;34,0;;;;;;;;;1,0;;;;;;;;;;;;;3,0;;;;;;;131,0;;;;;;;;;;;;;;;;;;;;;;;;;;;;;;;;;;;;;;;;;;;;1,0;;;;;;;;;;;1,0;;;;;;9,0;;;;;;;;;;6,0;;;;;;;;;;;;;;;;;2,0;;;;;;;2,0;;;;;;;;;;20,0;;;;;;;;;;12,0;;;;;;;;2,0;;;;;;6,0;;;;;;;;;;;;;;6,0;;;;16,0;;;;;;;;;;;;14,0;16,0;;;;;;;;;;;;;;;2,0;;;;6,0;;2,0;;;;5,0;;;;;;;;;2,0;;;12,0;;;;;;;;;;;;;;;;;;;;;;;;;;;;;;;1,0;;;;;;;;;;;;;;;;;;;;;;;;;;;;;;;3,0;;;;;3,0;;;;;;3,0;;;;;;;1,0;;;;;;1,0;;;;;;;;;;;;;;;;;;;;;;;;;;;;;;;;;;;;;;;;;;;;;;;;;;;;;1,0;;;;;;;;;;;;;;;;;1,0;;;;;;;;;;;3,0;;;;;;;;;;;;;;;;;;;;;;;;;;;;;;;;;;;;;;;;;;;;;;
test;;;5,0;;45,0;;4,0;26,0;14,0;26,0;2,0;2,0;;1,0;17,0;4,0;;;2,0;;26,0;12,0;2,0;4,0;2,0;1,0;;28,0;2,0;6,0;5,0;23,0;93,0;14,0;29,0;;3,0;;4,0;3,0;9,0;4,0;;19,0;;;;;3,0;;7,0;27,0;;15,0;1,0;285,0;47,0;2,0;;13,0;1,0;;103,0;1,0;1,0;1,0;;;;1,0;9,0;;;;;;;1,0;22,0;6,0;;4,0;24,0;3,0;;5,0;71,0;;;29,0;22,0;;;80,0;6,0;4,0;;;15,0;;15,0;69,0;;18,0;;;4,0;19,0;;1,0;4,0;7,0;5,0;1,0;;3,0;;;;13,0;;;;18,0;;;20,0;;1,0;7,0;4,0;1,0;;;3,0;5,0;3,0;;;9,0;;1,0;1,0;3,0;2,0;;;6,0;15,0;;;;9,0;;;4,0;;3,0;14,0;14,0;1,0;;;;;;;37,0;;2,0;5,0;;122,0;8,0;1,0;;;12,0;;;;;;2,0;;;8,0;20,0;;2,0;;;;15,0;;;;;4,0;;6,0;;;2,0;;;1,0;;1,0;4,0;;1,0;;;;2,0;2,0;7,0;;;;1,0;;;;4,0;1,0;;8,0;;;;;2,0;7,0;6,0;;;1,0;;1,0;;;4,0;;;;1,0;;;2,0;;;9,0;;1,0;;3,0;;;5,0;6,0;;;;;;;;;;;;1,0;;;;;;6,0;;;;30,0;;7,0;2,0;10,0;2,0;;;;;52,0;;3,0;;3,0;;;;;14,0;3,0;3,0;;;14,0;;;39,0;3,0;;;;;;;;5,0;;1,0;;;;13,0;;;;;2,0;;;;;;;;;2,0;;2,0;;1,0;;;;13,0;;4,0;;;;;2,0;;2,0;;;;;3,0;5,0;;1,0;2,0;;3,0;2,0;;1,0;;;4,0;;3,0;3,0;;;2,0;1,0;6,0;;;2,0;;;;;6,0;;;2,0;1,0;;;;17,0;6,0;;;;1,0;;27,0;;;;6,0;8,0;7,0;;;;;;9,0;;6,0;1,0;6,0;;2,0;;34,0;;7,0;;5,0;3,0;;2,0;;;;;1,0;2,0;;;;;;;;14,0;;5,0;;;;;5,0;19,0;;;2,0;;1,0;;1,0;;;;;3,0;;;8,0;;;22,0;;;;;;;;;;;;;;1,0;;;;22,0;;;;;3,0;10,0;;;;;;;1,0;6,0;;;;;6,0;;;;;7,0;;;3,0;;;;;;3,0;;;7,0;1,0;;;;16,0;;3,0;1,0;;;;;;;;;;1,0;;;;1,0;;;1,0;;4,0;;;;1,0;;;;62,0;;;;;;6,0;;;;;;;;;1,0;1,0;1,0;1,0;7,0;;;2,0;;;1,0;;;;;;;;;;;;;3,0;;;;1,0;;;;;;;;;;;;;;;;;;;;;;;;;;;1,0;;;;;17,0;;23,0;;;;;2,0;;6,0;;;16,0;;;;2,0;;;;;;;;6,0;;3,0;;;;;;;;3,0;;;;;;;19,0;;;;;;;9,0;4,0;24,0;;;;;;;;;;4,0;;;;;;2,0;;;1,0;5,0;;;;;8,0;;;1,0;;;;;;1,0;;1,0;;;;;;;;;;2,0;13,0;22,0;;;;;;;6,0;11,0;;;;;;;;2,0;;;;;;;2,0;;;;1,0;;;6,0;;1,0;;;1,0;;;;;;;4,0;4,0;12,0;;;;;;;;;;5,0;;;1,0;4,0;;;;;;;;;;;;;6,0;;;;;;;2,0;;;8,0;;1,0;;;;;;;;;;4,0;;;7,0;6,0;4,0;;2,0;1,0;1,0;;;;;;;;;;;;;;;;;;;;3,0;;5,0;;;;;3,0;;;;;;;;;;;;;;;2,0;1,0;1,0;;;;;;;;;;;;;4,0;;;;;;;;;;;;;;;;;;;;;;3,0;;;;;;;;7,0;;;;;;;2,0;;;;;1,0;;;;;;5,0;;;;;;;;;;;;;;;;3,0;6,0;;;;;;;;;;;;;;12,0;4,0;;;;;;;;;;;;;1,0;;;;;;;;;;;;;;;
thermal;;;1,0;;8,0;;1,0;16,0;6,0;33,0;1,0;26,0;;24,0;14,0;;1,0;;6,0;6,0;46,0;;;1,0;;;;91,0;;2,0;1,0;3,0;29,0;;3,0;;1,0;9,0;;30,0;1,0;;;7,0;;;;;;;;14,0;;;;272,0;30,0;;;17,0;;;42,0;;3,0;;9,0;;;;2,0;;;;;;;23,0;5,0;;;18,0;11,0;7,0;3,0;;3,0;1,0;2,0;3,0;15,0;;;2,0;;1,0;;4,0;3,0;3,0;6,0;20,0;;16,0;;;;10,0;;1,0;28,0;5,0;5,0;1,0;3,0;;8,0;;1,0;1,0;;;;5,0;1,0;;12,0;15,0;;2,0;5,0;3,0;7,0;;;5,0;8,0;;;4,0;9,0;;6,0;4,0;8,0;;22,0;4,0;;;;;;4,0;;;;22,0;;66,0;;1,0;;2,0;;17,0;37,0;34,0;;32,0;8,0;;6,0;1,0;;3,0;;12,0;;;;23,0;6,0;;;4,0;10,0;;;15,0;;;22,0;17,0;;2,0;;;;1,0;;;1,0;1,0;;;;;1,0;3,0;;;;1,0;;10,0;7,0;1,0;;2,0;;1,0;1,0;27,0;;;2,0;;;;;;7,0;3,0;8,0;1,0;;4,0;38,0;;;;;;;2,0;1,0;1,0;;;4,0;;7,0;4,0;2,0;2,0;1,0;;11,0;;;;;;;;;;;;;1,0;;;;7,0;;;;;;;;;;3,0;;34,0;1,0;;;;;27,0;;;;;3,0;;5,0;;2,0;;;;;2,0;1,0;;26,0;2,0;;;;;;;;1,0;;;;;;5,0;1,0;;;;7,0;3,0;;;;;1,0;;;2,0;;9,0;;3,0;;;1,0;;;;;;;2,0;;;;;;1,0;;;;26,0;4,0;9,0;1,0;;3,0;7,0;;;;5,0;;;;1,0;;;11,0;;5,0;5,0;1,0;;;1,0;;11,0;;10,0;;;;;;1,0;;2,0;;;1,0;;;;;;;;;9,0;2,0;;;;;;2,0;;;;;;;;;;;1,0;;3,0;;;;;1,0;1,0;;;;;;;;6,0;;2,0;;;;1,0;28,0;33,0;;2,0;;;;;;;;4,0;;;;;13,0;;4,0;16,0;;;;;;;;;7,0;;;;;;2,0;;;8,0;;5,0;67,0;;;28,0;;4,0;;;;;;;;1,0;;;;;;;;;;1,0;;;;;;;1,0;;;2,0;;;;;;;1,0;;;;;;;;;;;1,0;;;;;;;4,0;;9,0;;2,0;;2,0;7,0;;;17,0;;;;2,0;;9,0;;;3,0;;1,0;;;;;;;;;;2,0;;;;;;;;;;;;;;;;;;;;;;;6,0;;;;;;;7,0;;;;;2,0;3,0;;;;3,0;9,0;4,0;;;;;3,0;;;;;1,0;;;1,0;;1,0;4,0;;;;;;;;;;1,0;;2,0;;;;;2,0;;;;;;;;;;;;;;;;;4,0;9,0;;;;;;2,0;2,0;;;;;14,0;;;;;;3,0;;;;3,0;;1,0;;1,0;;1,0;;;;;;;1,0;;;;;;;3,0;;;;5,0;;1,0;1,0;;;;;;;;;1,0;;;;;;;;;;;;;;;;;;;;;;;;;;;7,0;;;;;;;;;;;;3,0;;;;;;;;;;2,0;;3,0;35,0;;;;;;;;;;;;;;;;;;;;;;;;;;;;;6,0;;;1,0;;;;;;;;;;;;;1,0;;;3,0;;;;1,0;;;;;2,0;11,0;;;1,0;;1,0;;;;;;3,0;;;;;7,0;;;;;1,0;2,0;;;;;;;;;;;2,0;;;;;;;;;;;;;2,0;;;;;;;;;;;;2,0;;3,0;;;;;;;;;;;;;;;;;;;;;;;;;;;;;;;;;;;;;;;;;;;;;;;;9,0;;;;;;;;;;;;;;;;;;;;;;;;;;;;;4,0;;;;;;;3,0;;;;;1,0;7,0;;;;;;;1,0
thickness;;;2,0;;13,0;;24,0;7,0;;;68,0;;;;8,0;;2,0;;;;34,0;6,0;;;;;;;3,0;4,0;4,0;8,0;22,0;;1,0;;;73,0;;26,0;7,0;;;39,0;;;;7,0;;;2,0;1,0;;8,0;5,0;24,0;16,0;;14,0;208,0;1,0;1,0;2,0;;;2,0;2,0;;;1,0;161,0;2,0;2,0;2,0;6,0;;1,0;3,0;7,0;1,0;1,0;;;;;7,0;27,0;;;;8,0;;3,0;10,0;4,0;2,0;;1,0;;52,0;21,0;11,0;;2,0;;;;118,0;7,0;;;6,0;1,0;10,0;1,0;;2,0;;2,0;37,0;;;1,0;2,0;;;4,0;;;;6,0;;6,0;2,0;;3,0;5,0;;5,0;;3,0;;4,0;1,0;14,0;1,0;8,0;3,0;3,0;1,0;;2,0;1,0;;1,0;1,0;3,0;8,0;;22,0;3,0;10,0;;1,0;;64,0;;12,0;;15,0;10,0;;13,0;2,0;;1,0;;;5,0;;2,0;1,0;3,0;;;3,0;12,0;2,0;;22,0;2,0;2,0;;;3,0;26,0;14,0;;2,0;;2,0;2,0;1,0;19,0;;;7,0;1,0;2,0;2,0;;;4,0;5,0;;6,0;2,0;6,0;1,0;;;;;1,0;3,0;16,0;1,0;;;;1,0;;3,0;;6,0;2,0;;2,0;3,0;;10,0;;;;;;1,0;;;5,0;;3,0;5,0;2,0;2,0;;4,0;3,0;;;;2,0;6,0;1,0;;;8,0;;;;2,0;2,0;;;;;;;8,0;7,0;;;;4,0;;;2,0;;;2,0;;;;;;2,0;2,0;2,0;;;12,0;;8,0;;2,0;;;10,0;;3,0;4,0;1,0;;;2,0;;;;;1,0;;;;;;6,0;5,0;4,0;1,0;;;5,0;;;;3,0;1,0;;;;;4,0;;;;;;;;3,0;;;;;;1,0;;;2,0;;;;1,0;;;4,0;;;;;;1,0;;3,0;;;;;4,0;1,0;;;;;;;;3,0;;;;;;;3,0;;;;;29,0;;;;;;;;1,0;;;3,0;5,0;;;;;;;;;;;;1,0;;;1,0;;;;;;;;;;;;;5,0;;;;1,0;;;4,0;;;2,0;;;3,0;;;;;;;;;;;18,0;;2,0;;;3,0;;;;;;;;1,0;;;;2,0;;;;;;;;;;;;;;;8,0;;4,0;;;;;;;2,0;1,0;;51,0;;2,0;;;;;5,0;;;;;;;4,0;;2,0;;;4,0;;;;;;;;;;;;1,0;;;;;;1,0;;;;;;;;;;;;;;;;10,0;;;;2,0;;;;;;;;;;1,0;;;;;;;;2,0;;;15,0;;;;;;3,0;;1,0;1,0;3,0;;;3,0;2,0;;;;;;;;1,0;;;;;;;1,0;;;;;;;;;;;;;;3,0;;;3,0;;;;;;;;;;;;;;;;;1,0;;;103,0;;;;;;;;;;;;;;;;;;3,0;;3,0;;;1,0;;;;;;;;1,0;;;;;;;;;1,0;;8,0;;;6,0;;;;;;;;;;;;;;;;;;;;6,0;;;1,0;2,0;;3,0;;;;;;;;;;;;;;1,0;2,0;;2,0;;;;7,0;;1,0;;2,0;26,0;;;6,0;;;;;;;9,0;;;;;;;4,0;;;;;;;;;;1,0;;;;;;;;;;;;;;;;;;;;1,0;;;;;;;;;;;;;2,0;;;;;;;;;;2,0;;;;2,0;;;;;;4,0;1,0;;1,0;;;;;;;;;;1,0;;;;;;;;;;;;;;;;;;;;1,0;10,0;;8,0;;;3,0;;;1,0;;;;;;;;;2,0;;;;;;13,0;;1,0;;;;;;;;;;;;1,0;;1,0;;;;;4,0;;;;;;;;;;;;;8,0;;;;;;;;;;;;;;;;;;;;;;3,0;;;;;;;;2,0;25,0;;5,0;;;;;;;1,0;;;;;;3,0;;2,0;;;;;;;4,0;;;;;;;;;;;;;;;;;3,0;;1,0;;8,0;;;;
thin;;;2,0;;60,0;;5,0;3,0;;1,0;2,0;;;2,0;1,0;;;;;;;12,0;;;;1,0;;27,0;3,0;1,0;;2,0;15,0;1,0;3,0;;;10,0;;;;;;5,0;;;;4,0;;1,0;2,0;;;7,0;1,0;29,0;6,0;;1,0;4,0;1,0;8,0;13,0;;;;7,0;;;;30,0;;;2,0;;;;9,0;1,0;1,0;;14,0;3,0;2,0;;8,0;;;;3,0;4,0;;;7,0;3,0;1,0;;1,0;7,0;5,0;12,0;10,0;;2,0;1,0;;;3,0;7,0;7,0;;1,0;4,0;;;;;;;3,0;1,0;;;5,0;13,0;;2,0;1,0;;4,0;;;4,0;;38,0;;1,0;;4,0;1,0;;;4,0;2,0;;;34,0;3,0;;1,0;;;9,0;;;;6,0;4,0;;61,0;6,0;;;2,0;;7,0;3,0;15,0;;;32,0;10,0;7,0;2,0;1,0;;2,0;6,0;;;1,0;;1,0;;1,0;1,0;48,0;4,0;;32,0;;2,0;;;3,0;12,0;5,0;;1,0;;;14,0;1,0;3,0;1,0;4,0;;;5,0;1,0;;;1,0;;;3,0;2,0;22,0;;;2,0;;;1,0;10,0;;2,0;;;;;;;2,0;;3,0;3,0;;6,0;;1,0;;1,0;2,0;11,0;;;;;;1,0;;2,0;3,0;3,0;;;1,0;4,0;;;;;;1,0;2,0;8,0;;1,0;15,0;;2,0;;;;;;;;;;;;2,0;;;;1,0;;1,0;;;;6,0;;;;;;;1,0;;2,0;;3,0;;;;1,0;;2,0;6,0;;;2,0;;;;;2,0;;;;;;;;1,0;;;;1,0;;;;;1,0;;;;;4,0;;1,0;;;;4,0;;6,0;;;;2,0;;;1,0;;;;;;;;;;;;;;;;;;4,0;9,0;;;;4,0;;2,0;;;;;16,0;;;3,0;;;;;;;;1,0;;;;;;;;;;13,0;;;;;;;;;;;;;2,0;;;20,0;31,0;;1,0;18,0;7,0;;;;;;;;;;;2,0;;;;3,0;;1,0;1,0;;4,0;;;;4,0;;;;;;;;;;;;1,0;;;;;;;11,0;;;;;;;;;1,0;;;;;;;;;;;;;;;1,0;4,0;1,0;;4,0;;;;;9,0;;;2,0;;;;;;;;2,0;;;;;;;;;;2,0;;;;;;;;;;;1,0;;;;;;;;;;;;;;;;2,0;1,0;;;3,0;;;;53,0;;;;;;2,0;;;;;;;;;;;;;;;2,0;2,0;;;2,0;;;;;;;;1,0;;1,0;1,0;;;;;;;;;;;;;;;;;;;;;;;1,0;;;10,0;;;;2,0;;;;;14,0;1,0;;;;;2,0;;;;;;;;;1,0;;;;;74,0;;;1,0;;;;;;;;;;;;;;;;;;1,0;5,0;2,0;;1,0;;;;1,0;;;;1,0;;1,0;;;;;2,0;;;;;6,0;15,0;;;1,0;;;;;2,0;;;;1,0;;;;1,0;;;9,0;;;;1,0;;;;;;;;;;;1,0;1,0;;;;;;;;;;;7,0;;;;;;;1,0;;;;;;;;2,0;;;;;;;;;;;;;;;;;;;;;;;;;2,0;;;;;;;;;;;;;;;;;;;;;;;;3,0;;;;;;4,0;2,0;;;;1,0;;;;;;;;;;1,0;;;;;;1,0;;;;;1,0;;;;;;;;;;1,0;;;;;;;;;;;;;;;;;;;;1,0;;;3,0;;;1,0;5,0;;;;;;;;;;;;;;;;;;;;;;;;;;;;;;;;;;;;;;;;;;;;;1,0;;;;;;;;;;;;;;;;;;;;;;1,0;;;;;;;1,0;;2,0;5,0;;;;;;4,0;3,0;;;;;;3,0;;;;;;;;;;;;;;;;;;;;2,0;;;;;;;;;;;;;
threshold;;;46,0;;78,0;;;45,0;28,0;37,0;;12,0;;10,0;11,0;;;2,0;1,0;14,0;49,0;79,0;5,0;11,0;6,0;2,0;1,0;57,0;6,0;64,0;17,0;134,0;42,0;132,0;31,0;;1,0;1,0;;12,0;4,0;2,0;;4,0;33,0;5,0;;18,0;17,0;5,0;23,0;31,0;;19,0;2,0;263,0;49,0;3,0;21,0;5,0;2,0;20,0;218,0;6,0;8,0;4,0;5,0;;3,0;16,0;6,0;24,0;;;;;;23,0;23,0;;;27,0;11,0;;3,0;;45,0;;16,0;38,0;27,0;1,0;6,0;76,0;11,0;5,0;4,0;9,0;21,0;;7,0;38,0;;1,0;7,0;11,0;1,0;88,0;5,0;;2,0;;8,0;3,0;;;1,0;1,0;;2,0;;;9,0;30,0;;;17,0;;1,0;2,0;;3,0;1,0;;;23,0;5,0;;;6,0;8,0;;;15,0;6,0;1,0;10,0;92,0;;;3,0;;;;8,0;;;;6,0;21,0;;15,0;;;;3,0;155,0;51,0;;;2,0;2,0;5,0;;19,0;;;40,0;;;1,0;;9,0;2,0;;7,0;;52,0;;22,0;;;2,0;4,0;3,0;;;;6,0;;3,0;;4,0;4,0;;1,0;;1,0;;1,0;6,0;;;;3,0;55,0;1,0;;;;7,0;11,0;7,0;;;;5,0;;;;;;;2,0;35,0;8,0;;18,0;30,0;1,0;;;17,0;;;6,0;2,0;;;;;;3,0;;1,0;;;14,0;;;;2,0;16,0;;;;1,0;;;;;;;;;3,0;;;;2,0;;;;5,0;;66,0;2,0;29,0;3,0;;;;;;;;;14,0;;;;;284,0;;;;;38,0;1,0;;13,0;20,0;;;1,0;;;;;;;24,0;;;2,0;8,0;;1,0;7,0;;10,0;5,0;;21,0;;13,0;;3,0;;1,0;;12,0;;2,0;28,0;2,0;12,0;7,0;;25,0;9,0;2,0;5,0;;7,0;12,0;3,0;1,0;;1,0;1,0;4,0;;;19,0;4,0;1,0;2,0;8,0;;13,0;;13,0;8,0;12,0;12,0;7,0;8,0;;1,0;2,0;1,0;7,0;7,0;9,0;18,0;5,0;16,0;6,0;30,0;;25,0;1,0;;8,0;18,0;5,0;4,0;;4,0;15,0;;5,0;4,0;2,0;4,0;;37,0;;9,0;;2,0;;;;50,0;17,0;;13,0;1,0;9,0;5,0;;2,0;18,0;;4,0;1,0;;4,0;7,0;2,0;;;4,0;;;;;8,0;;1,0;;;;8,0;3,0;1,0;1,0;;;5,0;5,0;3,0;;;2,0;;3,0;;4,0;;;7,0;;19,0;;;18,0;;;18,0;;;;;;;2,0;;;;;;1,0;;2,0;;3,0;85,0;3,0;15,0;44,0;1,0;50,0;4,0;;75,0;1,0;;;;3,0;1,0;2,0;;;;;;;1,0;;10,0;3,0;;;;;8,0;;;7,0;;;;1,0;;;7,0;;3,0;;;;5,0;;;;;;;1,0;;;;;1,0;;1,0;1,0;;;9,0;8,0;;;;;3,0;140,0;6,0;;10,0;;;16,0;;;;;;;;;;;1,0;;;;;23,0;7,0;;2,0;;1,0;5,0;1,0;3,0;;;;;10,0;;;9,0;3,0;;;51,0;;;;;1,0;;;;4,0;;;;;1,0;;;1,0;5,0;;18,0;4,0;;;;;8,0;;;14,0;4,0;14,0;;;1,0;1,0;;;;;;;;1,0;;;;;13,0;;;;;;;2,0;2,0;;1,0;;;;;2,0;6,0;;;;;;;;;;;26,0;;7,0;5,0;10,0;32,0;97,0;8,0;;;3,0;5,0;;;;152,0;2,0;4,0;;9,0;;3,0;;10,0;;2,0;1,0;4,0;21,0;;3,0;18,0;9,0;;5,0;2,0;;;;25,0;;4,0;;;;;;;8,0;;;;14,0;8,0;;55,0;1,0;4,0;3,0;;2,0;1,0;2,0;29,0;7,0;;3,0;;8,0;4,0;14,0;5,0;11,0;1,0;;;1,0;;1,0;;35,0;10,0;1,0;6,0;;;2,0;19,0;2,0;;1,0;4,0;;32,0;;;;2,0;3,0;45,0;11,0;;1,0;5,0;;;3,0;4,0;;8,0;;;;;;1,0;;;;;1,0;8,0;;;;;;;3,0;6,0;;18,0;4,0;2,0;8,0;;6,0;;;;1,0;3,0;;1,0;;;;;;;;10,0;1,0;;;7,0;;;;1,0;;;;1,0;2,0;;;;2,0;;1,0;;;;;13,0;4,0;5,0;;;2,0;;;10,0;;;;;;2,0;;;;;;;;;;;7,0;1,0;4,0;;;;;;;;;1,0;;;;4,0;1,0;;;;;;;;;;;;;;;;2,0;1,0;;;;;;;;;;6,0;1,0;;13,0;;1,0;;;;;1,0;1,0;;;;1,0;;;;1,0;;;;2,0;4,0;17,0;;;;;;3,0;;;;3,0;2,0;;;;;;;;;;;6,0;;4,0;;1,0;;;;;;2,0;5,0;;1,0;;;;;;;2,0;;;16,0;;;;;;;;;
tilt;;;11,0;;59,0;;152,0;34,0;36,0;16,0;62,0;;2,0;1,0;5,0;6,0;15,0;;11,0;7,0;7,0;138,0;82,0;8,0;3,0;;5,0;39,0;35,0;35,0;10,0;44,0;33,0;5,0;5,0;2,0;2,0;133,0;5,0;4,0;29,0;10,0;128,0;17,0;3,0;;1,0;12,0;10,0;;23,0;31,0;;1,0;7,0;91,0;104,0;;21,0;92,0;6,0;22,0;53,0;;10,0;212,0;29,0;;;27,0;62,0;8,0;4,0;;;;;46,0;192,0;9,0;17,0;5,0;7,0;3,0;;1,0;11,0;1,0;9,0;12,0;26,0;2,0;11,0;12,0;1,0;3,0;;7,0;13,0;;69,0;48,0;;;2,0;;;53,0;;1,0;3,0;7,0;1,0;12,0;12,0;3,0;;;1,0;6,0;;22,0;5,0;;;3,0;23,0;13,0;;67,0;2,0;1,0;;;1,0;21,0;17,0;;;2,0;;;2,0;3,0;17,0;7,0;8,0;28,0;5,0;;;1,0;3,0;;;;2,0;8,0;;40,0;;1,0;;2,0;4,0;;;8,0;1,0;;25,0;27,0;21,0;96,0;46,0;;1,0;10,0;;3,0;1,0;3,0;5,0;;28,0;10,0;93,0;23,0;;36,0;;;4,0;24,0;;3,0;;;63,0;;;8,0;;1,0;;;10,0;6,0;11,0;43,0;;5,0;;;;24,0;8,0;;4,0;2,0;;4,0;1,0;;;;1,0;;;7,0;;2,0;2,0;1,0;16,0;266,0;;4,0;22,0;3,0;1,0;;5,0;3,0;21,0;4,0;2,0;;;;;;4,0;31,0;;1,0;;17,0;2,0;;;29,0;1,0;;5,0;1,0;15,0;;3,0;3,0;8,0;2,0;4,0;;;2,0;;;7,0;15,0;;;16,0;100,0;;44,0;23,0;15,0;42,0;5,0;;1,0;;3,0;;10,0;;;1,0;;;1,0;54,0;2,0;1,0;;;12,0;4,0;;10,0;2,0;;;59,0;;15,0;4,0;;;;5,0;85,0;;;;;3,0;;4,0;2,0;4,0;9,0;1,0;;;1,0;;;2,0;;2,0;;1,0;;;;;;18,0;2,0;83,0;14,0;;;;;;6,0;1,0;8,0;;;;3,0;17,0;;;6,0;6,0;;;2,0;29,0;2,0;;;2,0;;3,0;;6,0;1,0;2,0;;;;;;5,0;3,0;18,0;11,0;2,0;;33,0;;13,0;3,0;;11,0;;;;3,0;16,0;6,0;140,0;1,0;;;20,0;;;;3,0;5,0;;1,0;;5,0;;;;16,0;;;;;;;1,0;;1,0;;2,0;;;1,0;;;;;;;9,0;;3,0;;;;5,0;9,0;2,0;;2,0;;;3,0;;;3,0;;;3,0;8,0;1,0;;26,0;;;12,0;39,0;;;4,0;;;;;1,0;;1,0;;;65,0;;;;26,0;;3,0;1,0;8,0;23,0;30,0;;;;;;;;;35,0;1,0;3,0;4,0;;;;;;9,0;;2,0;1,0;;1,0;;1,0;1,0;;;;;7,0;;;;;2,0;;;;;;3,0;1,0;;;;3,0;6,0;5,0;;55,0;;;1,0;;1,0;;;7,0;;13,0;;3,0;;;;;;;1,0;33,0;;;;22,0;;;;;;4,0;;;;;;1,0;;;;;;;;1,0;;4,0;;;;;;;1,0;;;;;2,0;;2,0;3,0;27,0;;;;;;;;5,0;;;7,0;;;;;;;;;4,0;1,0;;2,0;4,0;14,0;;1,0;9,0;;69,0;;;1,0;;;;2,0;;;;1,0;2,0;;1,0;;8,0;;;;8,0;;2,0;;;;;1,0;5,0;;;1,0;;;2,0;;25,0;;;;;;;;3,0;;10,0;;;1,0;;;;;3,0;;1,0;;;36,0;14,0;;1,0;;;;1,0;;;;12,0;9,0;;2,0;;1,0;;;;2,0;;5,0;;;;;;3,0;;;;;3,0;;9,0;;3,0;2,0;;;4,0;3,0;;;3,0;;6,0;;10,0;;;;;3,0;;7,0;;1,0;;2,0;;5,0;;;;;4,0;;;;1,0;;;2,0;;1,0;3,0;16,0;;2,0;3,0;;;;;;;;7,0;2,0;;;;;;;4,0;;7,0;;1,0;2,0;;;;2,0;;;;3,0;8,0;;;;;8,0;1,0;;;;2,0;1,0;1,0;;;;;;;;;1,0;5,0;1,0;5,0;1,0;;;12,0;;;1,0;;;2,0;;;;;3,0;;54,0;;3,0;;;;;10,0;27,0;2,0;;;;;;2,0;;4,0;;15,0;;;;;;3,0;1,0;3,0;;;3,0;;;;2,0;8,0;;;;1,0;;;;;;;1,0;;;;;;;17,0;;;;13,0;;;;;;;;;;;;;;;2,0;;;;;;5,0;;;2,0;;;;;;;;;;;;;7,0;;;;4,0;;;;;;;4,0;;;;1,0;1,0;;;;;;;;;5,0;;;;2,0;;2,0;;2,0;1,0;;;;;;2,0;;;;;;;;;;;;;;;;
timer;;;1,0;;;;;2,0;;9,0;;;;;;;;;;;;;;;;;;4,0;;1,0;;;;;2,0;;;2,0;;;;;;;;;;;1,0;;1,0;1,0;;;;14,0;2,0;;;;;;4,0;;;;;;;;;;;;;3,0;;;;1,0;;3,0;1,0;;;;;;2,0;;1,0;;3,0;3,0;1,0;;;;;;;8,0;;;1,0;2,0;;16,0;;;2,0;1,0;;;;;;;;6,0;;;;2,0;;;;;;;2,0;;;;;1,0;;;;;;;;;;;;;;;;;;;;;;;;;;;;;;;;1,0;;;;;16,0;;;2,0;;2,0;;;;;;2,0;;;;;;;;;;;;;;;;;;;;;;;;;;;;;;;;31,0;2,0;;2,0;;;;;;;;;;;;;;;;;;;;1,0;;;;;;;;;;;;;;;5,0;;;;;;;;;;;;;;;;;;2,0;;;;;;;;;;;;;;;2,0;;;;;;;;;;;1,0;;;;;;;;;;;;;;;;;;;;;;;;;;1,0;;1,0;;;;;1,0;;;;;;;;;;;1,0;;;;;;3,0;;;;;;;;;;;;;;;;;;;;;;;;;;14,0;;1,0;;;;;;;;;;;;;1,0;1,0;;;;;4,0;;1,0;;;;;;;;;;;;;;2,0;;;;;1,0;;;;;;;;;3,0;;;;;;1,0;;;;;;;;;;;;;;;1,0;;;;;;;;5,0;;;;;2,0;;2,0;;;;;;;;;;;2,0;;;;;;;;;;;;;;;;;;3,0;;5,0;;;;;;;;;;;;;;;;;;;;;;;;4,0;;;;;1,0;;;;;4,0;;;;;;;;;;;;;;;;;;;;3,0;;;;;;1,0;;;;;;;1,0;;;;2,0;;;1,0;;;;;;;;;;;;;;;;;;;;;;;;;;;;;;1,0;;;;;;;5,0;;;;;;;;;;;;;;;;;;1,0;;;;;;;;;;;;;;;;;;;;;1,0;;;;;;;;;2,0;;;;;;;;;;;;;;;;;;;;;;;;;;;;;;;;;;;;;;;;;1,0;;;;;;;;;;;;;;;;;7,0;;1,0;;;;;;;;;;;;;;;;;;;;;3,0;;;;;;;;;;;;;;;;;;;;;;;;;;;;;;;;;;;;;;;;;;;;;;;;;;;;;;;;;;;;;;;;;;;;;;;;;;;;;;;;;;;;;;;;;;;;;;;;;;6,0;;;4,0;;;;;;;;;;;;;;;;;;;;;;;;;;;;;;;;;;;;;;;;1,0;;;;;;;;;;;;;;;;;;;;;;1,0;;;;;;;;;;;;;;;;;;;;;;;;;;;;;;1,0;;;;;;2,0;;;;;;;;;;;;;;;;;;;;;;;;;;;;;;;;;;;;;;;;;;;;;;;;;;;;;;;;;;;;;;;;;;;;;
total;;;26,0;;4,0;;2,0;13,0;21,0;1,0;;;;;11,0;;;;1,0;;7,0;2,0;1,0;2,0;;3,0;;14,0;;2,0;10,0;2,0;3,0;11,0;5,0;;3,0;8,0;;20,0;20,0;;;1,0;;;;43,0;5,0;;2,0;;;3,0;1,0;74,0;8,0;;56,0;78,0;;;3,0;3,0;1,0;4,0;;;;;31,0;3,0;;;;3,0;2,0;2,0;1,0;11,0;;7,0;;;;11,0;7,0;20,0;2,0;2,0;11,0;2,0;;22,0;1,0;9,0;;2,0;8,0;2,0;7,0;15,0;;1,0;;1,0;;29,0;;;;;1,0;;;2,0;;;;10,0;;;;4,0;;;11,0;;;;;;;;;;;;;5,0;4,0;;;6,0;;2,0;1,0;9,0;;3,0;;;2,0;1,0;;;;1,0;;11,0;;2,0;;;;;20,0;37,0;1,0;3,0;;3,0;7,0;;2,0;;;8,0;;;;;2,0;;;1,0;;11,0;;8,0;;;;12,0;;3,0;;;;;;;;8,0;;;;;1,0;;;;2,0;;;26,0;;;;;;2,0;;;;;;;;;;;;1,0;4,0;;;;23,0;;2,0;;1,0;;;;4,0;;;;4,0;;;;2,0;;;2,0;;;;2,0;;;;;;;;;;;;;;;;;;;;;;;;15,0;;5,0;4,0;;;;;14,0;;1,0;;2,0;;;;;2,0;;1,0;;;5,0;;;2,0;4,0;;;;;;;;;;;;;;;;2,0;;;;;;1,0;;2,0;;1,0;;;1,0;;;1,0;;;5,0;;;;4,0;3,0;3,0;;;;;;;;;;;;;2,0;;;;;;;;3,0;1,0;6,0;;;3,0;;4,0;;;1,0;;16,0;;2,0;;4,0;;12,0;;;;;;;4,0;;8,0;;;;2,0;1,0;3,0;2,0;;3,0;;1,0;;2,0;;;5,0;;5,0;1,0;;;;;1,0;;;;1,0;6,0;;;;;;;;;;8,0;;2,0;;;;;;;1,0;;;;;;;;;;4,0;;;;;1,0;;8,0;;3,0;;;;2,0;;;;;;;;;;;;1,0;;;1,0;;;1,0;;;21,0;;4,0;3,0;;;2,0;;;;;;;;;17,0;;;;;;2,0;;;;3,0;;;;;2,0;;;13,0;;;;;;;;;;5,0;;;1,0;;;6,0;;;;;;;;;3,0;;;;;;;;;2,0;31,0;;;;;;;;;3,0;;;;;;;;;;;;;;;;;;;;;;;;;;3,0;;;;;;;3,0;;;;;;;;;;;;;;;;;;;;;;;;;;;;;;1,0;2,0;1,0;;3,0;;;;;2,0;;;;;;;;;3,0;2,0;;;;;;;;;;;;;;;;;;;;;5,0;29,0;2,0;1,0;;3,0;;;1,0;;11,0;2,0;;;;;;;;;2,0;2,0;;;;3,0;;;;;;;;;;;2,0;1,0;;3,0;;;;;;;;;;;;;;;;;;;1,0;2,0;2,0;;;;;;;;;;;2,0;;;;;4,0;3,0;;;;;;;;;4,0;;;;;1,0;;;;;;;;5,0;;;;1,0;;3,0;;;;;;1,0;;;;;;;;;;1,0;;1,0;;;;;;;;;;;;;2,0;;;;;3,0;;;1,0;;4,0;;;;;;;1,0;;;;;;;;;;;;;;;;;;;;;;;;;;;;3,0;;;;;;;;;;;3,0;;;;;;;;;;2,0;;;;3,0;;;;;;;;;;;;;;;;;;;;;;;;;;;;;;;;;;;;;;;;;;;;;;;;;;;;;;;;;;;;;;;2,0;;;;;;;;;;;;4,0;;;;;;;;;;;;;;;;;;;;;;;;;;;;;;;;;;;;;;;;;;;;;;
touch;;;2,0;3,0;22,0;;4,0;9,0;;4,0;23,0;;1,0;;;;;;;;2,0;13,0;;;;;;;4,0;19,0;27,0;8,0;23,0;;13,0;;;9,0;;63,0;;;2,0;4,0;;;;;2,0;;2,0;2,0;;;1,0;43,0;15,0;;;7,0;;;10,0;;4,0;;17,0;;;8,0;28,0;;;1,0;;;;16,0;22,0;;2,0;32,0;2,0;;;;11,0;;4,0;12,0;10,0;;;8,0;6,0;;;;;;49,0;87,0;8,0;;;;;23,0;;;;3,0;1,0;9,0;;;;;;3,0;;;;;;;4,0;21,0;;;;;1,0;;;8,0;7,0;;;2,0;;;3,0;;;1,0;1,0;4,0;;;;;5,0;;1,0;;;8,0;1,0;2,0;;;;;;2,0;;14,0;;;14,0;;3,0;1,0;5,0;;;2,0;;;96,0;1,0;;2,0;;;2,0;1,0;;13,0;;;2,0;3,0;5,0;3,0;;;;;;1,0;;5,0;;;;;24,0;7,0;;;;;4,0;2,0;;1,0;;;2,0;;1,0;1,0;;;;;;;;;2,0;5,0;4,0;1,0;;;39,0;;;;;3,0;;1,0;;;;;;;;1,0;;;;4,0;;;;;2,0;3,0;;;;;;1,0;;3,0;;;;2,0;;;;;1,0;;;1,0;;5,0;2,0;18,0;5,0;;;;1,0;;;;;;;;;;;1,0;;;;2,0;2,0;;;;;;;;;;;3,0;;1,0;;2,0;;12,0;;2,0;;;18,0;;;;;;;;;;;5,0;;;;;;;;;;2,0;;;;;;;;;;;;;8,0;;;;;;;;;;;2,0;;;;;;;;;;;2,0;1,0;;16,0;5,0;4,0;;;2,0;;1,0;3,0;2,0;;1,0;;;;;;3,0;1,0;;;;;;;;11,0;1,0;;24,0;;4,0;;;1,0;3,0;;;;;;;;;;;;;3,0;;;9,0;;4,0;4,0;;6,0;;;1,0;;;6,0;3,0;;;;;;2,0;;;;;;1,0;7,0;3,0;;3,0;;;;;2,0;;;;;;;;3,0;;;;;53,0;2,0;;;;5,0;;;7,0;3,0;8,0;;;;;;;;;;;;;2,0;;;;;1,0;2,0;;;;;;;;;;;;;;2,0;;;2,0;;;;;1,0;;;;1,0;1,0;;;;;;;2,0;;;;;;;3,0;;;;;;;;;;10,0;1,0;;;;;;;;;;;;;;;;1,0;;;;;;;;;;;;;;;;1,0;;1,0;;;;;;;;;;;;;;;;;;;;;;;;;;;;;;2,0;;;;;;;;;;;;;;;;;;4,0;;;;;;;;;;;5,0;;;;4,0;;;;;4,0;;;;;;;;;;;;;1,0;;;;;;;;;;3,0;;;;;;;;;1,0;;;;1,0;;;;4,0;;2,0;;;;;;1,0;;;1,0;;;;;;;;;;;;;;;;;;1,0;;;;1,0;;;;;;;;;;;;1,0;;;;;;;;;;;;2,0;;;;1,0;;;;;;;5,0;;3,0;;;;;;1,0;5,0;;;;;;;2,0;;1,0;;;;2,0;;;;;;2,0;;;3,0;;;;;;;;;;;;;;;;;;;;1,0;;2,0;;;;;;;;;;19,0;;2,0;;2,0;;;;;;1,0;;4,0;;;;;;;3,0;;;;;;;;;;;;;;;1,0;;;;;;;;;;;;;;;;;;;;;;;;;;;;;;;;;;;;;;;;;;;;;;;;;;;;;;;;;;;;;;;;;;;;1,0;;;;1,0;;;;;;;2,0;;9,0;;;;;;;;;;;;;;;;;;;;;;;;;;;;;;;;;2,0;;;;;;;;;;;
track;;;1,0;1,0;72,0;;4,0;88,0;27,0;31,0;2,0;;;;8,0;1,0;;;7,0;28,0;3,0;92,0;18,0;23,0;;5,0;2,0;72,0;1,0;47,0;58,0;78,0;163,0;15,0;39,0;6,0;6,0;4,0;3,0;28,0;15,0;;13,0;7,0;;;;3,0;31,0;5,0;;70,0;1,0;8,0;;496,0;110,0;;7,0;11,0;1,0;3,0;203,0;;15,0;1,0;66,0;;2,0;16,0;12,0;17,0;8,0;;;18,0;;56,0;129,0;2,0;;39,0;32,0;9,0;5,0;;48,0;2,0;5,0;30,0;42,0;;1,0;26,0;18,0;7,0;11,0;2,0;15,0;;11,0;219,0;;;5,0;;;106,0;;;4,0;4,0;4,0;4,0;3,0;;;;;8,0;;2,0;7,0;2,0;;4,0;45,0;;;6,0;;4,0;;;1,0;19,0;5,0;6,0;;6,0;3,0;2,0;;23,0;;1,0;17,0;96,0;4,0;;;;15,0;;;;;;2,0;19,0;;;;29,0;9,0;;5,0;30,0;;1,0;16,0;1,0;29,0;22,0;118,0;;;32,0;2,0;2,0;;6,0;;1,0;;12,0;8,0;71,0;;39,0;;;12,0;27,0;;1,0;;;5,0;;;1,0;;12,0;;1,0;8,0;2,0;5,0;13,0;;;;;11,0;20,0;13,0;3,0;5,0;;;8,0;;;3,0;;10,0;;;;8,0;;4,0;3,0;6,0;12,0;;4,0;68,0;2,0;;;;2,0;;2,0;;;;;;;;2,0;;;;15,0;;;;4,0;;;27,0;3,0;5,0;;;;;;1,0;1,0;1,0;8,0;;;;26,0;;;4,0;12,0;;102,0;29,0;428,0;1,0;;2,0;;7,0;6,0;;;;5,0;;;5,0;1,0;13,0;3,0;1,0;;7,0;15,0;;2,0;12,0;22,0;14,0;7,0;;11,0;1,0;;;;;11,0;;3,0;;17,0;;;2,0;1,0;12,0;11,0;28,0;2,0;;1,0;;;3,0;;;25,0;3,0;12,0;;;;4,0;;22,0;18,0;8,0;17,0;;;;;;;;12,0;2,0;1,0;3,0;36,0;25,0;1,0;7,0;;43,0;;;2,0;19,0;8,0;2,0;15,0;;;4,0;8,0;3,0;10,0;37,0;;;1,0;1,0;4,0;17,0;;8,0;;;;4,0;21,0;193,0;15,0;8,0;;;2,0;1,0;3,0;2,0;13,0;41,0;7,0;10,0;3,0;3,0;4,0;10,0;;33,0;69,0;;26,0;22,0;27,0;;13,0;28,0;10,0;;1,0;;;20,0;14,0;;3,0;;;;;;18,0;;;15,0;;;;14,0;;9,0;10,0;;9,0;7,0;23,0;;;1,0;5,0;;5,0;;4,0;;1,0;;2,0;18,0;14,0;2,0;15,0;15,0;;39,0;;1,0;;2,0;4,0;3,0;19,0;13,0;3,0;;19,0;2,0;;1,0;5,0;6,0;;29,0;1,0;3,0;;4,0;158,0;45,0;;;;;10,0;;8,0;9,0;1,0;;;;;;;;1,0;8,0;7,0;;;;;3,0;;;1,0;76,0;4,0;;6,0;;2,0;;;7,0;2,0;2,0;1,0;;10,0;2,0;3,0;1,0;;7,0;;;;;;;;1,0;31,0;1,0;;;3,0;;2,0;;1,0;;11,0;6,0;;1,0;;1,0;11,0;;;;1,0;4,0;;;;;7,0;2,0;;;;;97,0;2,0;;;;;;1,0;4,0;;7,0;;;;;;3,0;1,0;;21,0;;;;;;;;;1,0;2,0;;;;;1,0;;;1,0;;4,0;1,0;1,0;4,0;;;;;1,0;;;;3,0;9,0;;5,0;;8,0;3,0;;2,0;;;36,0;;;1,0;4,0;;4,0;1,0;;;;;;;;;7,0;18,0;;2,0;;;;;1,0;;;;1,0;;;1,0;;2,0;;;;;;;10,0;;;3,0;;;;;12,0;;3,0;;6,0;;2,0;;;4,0;1,0;;2,0;1,0;;;19,0;15,0;;5,0;5,0;5,0;1,0;;;;;;;5,0;;;;1,0;;1,0;;;8,0;;20,0;;;1,0;3,0;;3,0;;;1,0;3,0;8,0;;;;;1,0;;;1,0;;3,0;2,0;2,0;6,0;;2,0;;;;;;2,0;6,0;;;4,0;;9,0;4,0;3,0;;1,0;8,0;1,0;5,0;;2,0;1,0;;;59,0;3,0;;11,0;2,0;;2,0;;1,0;;4,0;9,0;1,0;6,0;;;3,0;5,0;;;;;3,0;1,0;2,0;;;;;1,0;8,0;;1,0;;;2,0;14,0;;;;;1,0;;;;3,0;6,0;;4,0;17,0;3,0;;;4,0;;13,0;;1,0;;2,0;4,0;1,0;1,0;;1,0;2,0;;;15,0;4,0;;8,0;2,0;13,0;;;;;;;;;;1,0;3,0;;;;;;;;;5,0;1,0;;;;4,0;;;;;;;;;;;4,0;;1,0;;;;1,0;;1,0;1,0;;;2,0;;1,0;1,0;1,0;;;28,0;;;11,0;2,0;3,0;9,0;;;5,0;3,0;;8,0;;11,0;2,0;;;;1,0;3,0;;;;;4,0;;;4,0;;;20,0;1,0;;;2,0;;;1,0;;;;;;1,0;;;;;;;;;;;;;1,0;;2,0;;;;;;;;;;3,0;5,0;3,0;;;;;;5,0;;;;;;;;;;;
transform;;;1,0;4,0;10,0;;1,0;23,0;18,0;10,0;;4,0;1,0;15,0;25,0;;;;15,0;1,0;3,0;9,0;47,0;3,0;2,0;5,0;1,0;74,0;;8,0;;19,0;10,0;2,0;5,0;12,0;;;;6,0;5,0;5,0;;;7,0;;1,0;4,0;;1,0;4,0;21,0;;;;290,0;15,0;1,0;3,0;1,0;9,0;;52,0;;18,0;;6,0;;;3,0;10,0;;;;;;;11,0;18,0;;;16,0;9,0;2,0;2,0;;;3,0;;2,0;7,0;;;15,0;1,0;16,0;;1,0;3,0;;5,0;15,0;;;3,0;;;21,0;;;2,0;2,0;;;;;;1,0;;;;;;5,0;;;16,0;;1,0;;;5,0;;;;5,0;;;;;;;1,0;;5,0;;9,0;13,0;;;;;;;;1,0;;;;;;;;;9,0;;2,0;8,0;2,0;;;1,0;15,0;1,0;2,0;;;17,0;;;1,0;;;;;9,0;2,0;7,0;1,0;8,0;;;4,0;14,0;3,0;;;;1,0;;;1,0;;1,0;1,0;;;3,0;2,0;;2,0;;;;1,0;2,0;;3,0;;;2,0;1,0;;;;;;;;;;;;;;4,0;;38,0;9,0;;;;2,0;;;;;;;;4,0;5,0;;2,0;;;;13,0;;;4,0;;7,0;;;;;;;;;;2,0;;;;;;;7,0;;;;;;8,0;;15,0;;;;1,0;;6,0;;;;;2,0;;;;;1,0;4,0;;;;;;2,0;2,0;;;;;;;;;;;1,0;;;2,0;;1,0;;;;;;;;;1,0;;;;4,0;3,0;;3,0;;;;3,0;;;;2,0;7,0;1,0;;;;2,0;;;11,0;;;;2,0;6,0;;;1,0;1,0;;;;5,0;3,0;5,0;2,0;;;1,0;;;;4,0;;3,0;;;;;;2,0;4,0;;;;;;1,0;;2,0;;1,0;1,0;6,0;;44,0;1,0;1,0;;1,0;;;;;;11,0;;6,0;;11,0;;;;;;1,0;;2,0;;2,0;1,0;;;;;;;;;;;;2,0;2,0;2,0;;5,0;1,0;;6,0;4,0;2,0;;;2,0;;;6,0;;;;;2,0;;1,0;2,0;;25,0;;;28,0;;3,0;;;10,0;;;;;;;;;2,0;18,0;;;;1,0;;;;3,0;27,0;;;6,0;;;1,0;1,0;;;;;;;;;;;1,0;;;;;;;;;1,0;;;;;;1,0;;;;;;;8,0;;;;;;;;;;;;;;;5,0;;;;2,0;;2,0;1,0;;;26,0;;;;;1,0;;;;;;;;;;;;;;;2,0;;;;;2,0;;;8,0;2,0;;;;;;;;;2,0;;;;1,0;;;;;;;;;;;;;;;;;;;;;;;2,0;;1,0;;;;;;;3,0;;;;;;;;;;;;;1,0;;;4,0;;;;;;;;2,0;;;;;;;;;;;;;;;;1,0;;;1,0;;;;;5,0;;14,0;;;;;;;;;12,0;12,0;;;1,0;;;;1,0;;;;;;;;1,0;;;;;;;;;;;;1,0;;;;;2,0;;;;1,0;;1,0;;;1,0;;2,0;;;;;1,0;9,0;;;6,0;;;4,0;;;;;;;24,0;;;;;;2,0;;;;;;1,0;;;;;;;;;;;;;;;;;;;2,0;;;;;;3,0;;;;;;;9,0;;;;8,0;;;8,0;;;;;4,0;;;;;;;;;;;;;;;;;;;1,0;3,0;;;;;;;1,0;;;3,0;;;;;;;;;1,0;;;8,0;;;;;5,0;;6,0;;;;;;;3,0;;;;;;;;9,0;;;;;;;;;;;;;;;;;;1,0;;2,0;;;;2,0;;;;;;;;2,0;;;;;;;;;;;;2,0;5,0;4,0;;;4,0;;;;;;;;;8,0;;;;;;;;;36,0;;;1,0;1,0;;;;;;;;1,0;;;;;;;3,0;;;;;;;1,0;;;;;;;;;1,0;;;;;3,0;2,0;;;;;;;;;;;;;;;
transformation;;;4,0;;30,0;;2,0;79,0;40,0;11,0;;;;5,0;35,0;;3,0;;7,0;4,0;18,0;6,0;148,0;4,0;5,0;;3,0;47,0;4,0;1,0;1,0;57,0;15,0;3,0;4,0;6,0;1,0;4,0;5,0;8,0;2,0;6,0;;;15,0;;;;;;31,0;12,0;;;;108,0;13,0;7,0;1,0;1,0;5,0;;34,0;5,0;5,0;;3,0;;;2,0;5,0;3,0;8,0;;;;;29,0;34,0;;;14,0;14,0;;10,0;;2,0;1,0;5,0;34,0;6,0;;;56,0;1,0;1,0;;1,0;5,0;;4,0;59,0;;;;;;73,0;;;4,0;5,0;;;;;;;;;;;3,0;;;;1,0;;2,0;;;3,0;;;;;;;;;;;;;2,0;;3,0;25,0;;;;;;;;;;;;13,0;;;;;1,0;;;4,0;;;;;10,0;3,0;1,0;;;4,0;;;;;;;;;;37,0;;4,0;1,0;;;3,0;1,0;1,0;;;3,0;;;1,0;;;;;;;3,0;;;;;;;17,0;;1,0;;1,0;;1,0;;;;;;;;;;;;;2,0;6,0;;61,0;6,0;;;;2,0;;;;;;;;;;;1,0;;;;3,0;;;;;2,0;6,0;;;;;;;;;;;4,0;7,0;;;;;;;;;;8,0;;24,0;;;;;;1,0;;;;1,0;5,0;;;;7,0;8,0;8,0;;;5,0;;;7,0;;;;;;;;;;;8,0;4,0;;;8,0;;;4,0;;5,0;;;;;;1,0;2,0;;;;3,0;;3,0;;;3,0;1,0;;10,0;;;16,0;3,0;;;4,0;;;;4,0;;;;11,0;4,0;;;;;1,0;;1,0;3,0;;3,0;;;;;1,0;;15,0;4,0;;;;1,0;;;;10,0;;;;;;6,0;;;6,0;;;1,0;2,0;;1,0;;;;;;;;;1,0;3,0;;10,0;;2,0;;;;;;;;;5,0;1,0;;;;;;;;;;;2,0;;3,0;;3,0;;3,0;;;8,0;2,0;2,0;;;;;;1,0;;;;;;;11,0;;;147,0;;;33,0;;;;1,0;;;;;;;;;;1,0;2,0;2,0;;2,0;;4,0;;;2,0;1,0;;;;;;;1,0;;;;;;;;;;;2,0;;;;;;;;4,0;;1,0;;;;4,0;;;;;4,0;;;35,0;;;1,0;;;;;;;;4,0;;;;1,0;;;;;;15,0;;;;38,0;;;;;;11,0;;;;;;;;;;;;;;1,0;;1,0;;9,0;;;;44,0;1,0;;;;;;;;;;2,0;;;;;;;;;;;;;;;;;2,0;;;;;3,0;;;;;;;;;;;;1,0;3,0;;;;;;;;;;;;;;;;3,0;;;;;;;;11,0;;1,0;;;;;;;;;;;;;;;;;;;;;;;;12,0;;;;;;;;;;4,0;;;;14,0;;;;;;;;;;;9,0;;;;;;;;;;;;5,0;;;;;;;;;;;1,0;;;2,0;;5,0;1,0;;1,0;;1,0;;;1,0;;;;;;5,0;;2,0;;24,0;;3,0;1,0;;;;2,0;10,0;;1,0;;;;;2,0;;;;18,0;;17,0;;;;;;;;;;1,0;1,0;;;;;;;;1,0;;;;;;;;;5,0;;;;;;;;1,0;1,0;;;;;;;;;;;;;;;;;;;10,0;;1,0;;2,0;;;2,0;;1,0;4,0;3,0;;;;;;;;3,0;;2,0;10,0;;;;;;;7,0;;;;;;;;;;;2,0;;;;4,0;;;;;;;;;;;;2,0;;;;;;2,0;;;;;;;;;;;;;1,0;;8,0;;;;;1,0;;;;;;;2,0;;;;;;;;;;;;2,0;5,0;;;;;;;;14,0;16,0;;;1,0;1,0;;;;;;;;;;;;;;3,0;1,0;;;;;;4,0;;2,0;;;;;;;;;;;;;2,0;;;;;;;;;;;;;;;;
translation;;;6,0;;7,0;;3,0;5,0;9,0;;;;;;1,0;;;;4,0;;;4,0;14,0;1,0;;;;9,0;;7,0;;40,0;14,0;;2,0;;;14,0;9,0;6,0;7,0;;3,0;7,0;8,0;;;2,0;;;;2,0;;;1,0;17,0;20,0;;2,0;;11,0;;21,0;6,0;3,0;2,0;1,0;;;;1,0;8,0;1,0;;;;;9,0;12,0;;;;1,0;;;;;;1,0;4,0;1,0;;;;;1,0;;;;;1,0;9,0;;;2,0;;3,0;7,0;;;;2,0;;2,0;;;;;;;;25,0;;;;;1,0;;;5,0;;;;;;3,0;;;;;;3,0;;;;;;23,0;;;;;14,0;;;;;;;;;;;;1,0;;3,0;;;;14,0;1,0;1,0;8,0;;;;;;;;;;;;18,0;5,0;2,0;;;;;;9,0;;1,0;;;53,0;;;;;1,0;;;;;;1,0;;;;;4,0;;2,0;;;;;6,0;;;;;;;;1,0;;;6,0;;1,0;5,0;;;;;;;8,0;1,0;;;5,0;;;1,0;;;;;;;;5,0;3,0;;;12,0;;;;;;;;;;;5,0;;;;;;;;;;;;;10,0;2,0;7,0;;;;;;;;;;;;;1,0;;;;;;7,0;;;;6,0;2,0;;;;;2,0;;;;;1,0;1,0;1,0;;1,0;;;;;5,0;;1,0;;;;;;;6,0;;3,0;;2,0;;;2,0;;;2,0;;;2,0;1,0;;;;;;;4,0;;;;3,0;9,0;;2,0;;;;;;2,0;1,0;1,0;;;;10,0;;;1,0;;;;;;;;;3,0;;;;;;2,0;;;1,0;;;;30,0;;;1,0;;;;;;;;;4,0;;2,0;;1,0;2,0;;35,0;;;;;;3,0;;;;;;;;;;;;2,0;;;1,0;;;;;;;;5,0;;;;;;;;;;;;;;3,0;1,0;51,0;;;2,0;;;;;;;;;3,0;;;2,0;;;;6,0;;;;;;;2,0;1,0;;;;;;;;;;;;1,0;;;;;;;1,0;;;;;;;;;;;;;;;;1,0;;;;;;;;;;;;;;;;;;;;1,0;;;;;;;;1,0;4,0;2,0;;;;;;6,0;;;;;5,0;9,0;;;;8,0;;;;;;;;;;;;;;;;;;;;;;;;;;;;2,0;;;;;;;;;;;;;;;;;;;;;;;;;;;;;;1,0;;;;8,0;;;;;;;1,0;;;;;5,0;;;;;;;;1,0;;6,0;;;;;;;;;;;;;;9,0;1,0;;1,0;;;;;;;3,0;;;;;;;;;;1,0;;;4,0;;;;;;;2,0;;;;;2,0;;;;;;;;2,0;;;;1,0;;;;;;;;;;;8,0;;4,0;;;;1,0;;;;;;;;;;;;;;;;;;;;;3,0;;;2,0;;;;;;;;;;;;1,0;5,0;;1,0;;;;;2,0;;;3,0;;;;;;;;;;;;;;;;;;;;;;;2,0;;;;8,0;;;;;;;;;;;;;;;;;;;;;;1,0;;;;;;;;;;;;;;;;;;;;1,0;;;;;;;;;;;;;;;;;;;;;;;;;;;;;6,0;4,0;;;;;;;;;;;;;;;;5,0;;;;1,0;;;;;;;;;;1,0;;1,0;;;;;3,0;;2,0;;;;;;;;;;;;;;;;;;;;47,0;;;30,0;;;;;;;;;;;;;;;;;;;;;;;;;;;;;;;;;;1,0;;;;;;;;;8,0;;;2,0;;;;;;;
travel;;;4,0;;5,0;;4,0;7,0;2,0;;2,0;;;;;;;;1,0;;;64,0;;3,0;3,0;;;2,0;14,0;;1,0;4,0;8,0;;1,0;;;51,0;;19,0;11,0;;4,0;1,0;2,0;;;;;;;22,0;;6,0;;27,0;2,0;;2,0;32,0;1,0;;21,0;;;3,0;4,0;;;;3,0;4,0;24,0;;6,0;;;4,0;4,0;;;;1,0;;;;2,0;1,0;1,0;1,0;4,0;3,0;;;;1,0;;1,0;2,0;;3,0;7,0;;;;;;16,0;22,0;1,0;3,0;3,0;;2,0;1,0;;1,0;;;3,0;;3,0;;10,0;;;2,0;;;;;;;;;;;6,0;;;1,0;;;3,0;;4,0;9,0;3,0;;;;;12,0;;;;;;1,0;4,0;2,0;3,0;;4,0;;;;33,0;;;7,0;6,0;;2,0;1,0;3,0;;4,0;;;;;2,0;;;;1,0;8,0;;12,0;;;2,0;8,0;;5,0;4,0;;8,0;1,0;;;;10,0;;;;;;3,0;;;;;4,0;32,0;1,0;;;;;16,0;22,0;;;;;;;2,0;;;;;2,0;3,0;;;;;5,0;;5,0;;;;1,0;;;;;;;;;;;3,0;;;;7,0;1,0;2,0;1,0;;2,0;;;;;20,0;;;5,0;;;;3,0;;;;2,0;;;6,0;7,0;17,0;;6,0;;1,0;;;;;;17,0;;;3,0;;5,0;;;;;18,0;12,0;;2,0;;1,0;;;;;;;;;;1,0;2,0;;5,0;1,0;;;;7,0;1,0;;;;;;;1,0;;;1,0;;;;;;;4,0;2,0;3,0;;1,0;3,0;;;1,0;;;;;;1,0;;;1,0;1,0;;;;;;;;1,0;;;;;9,0;2,0;1,0;;1,0;;;;;;;;;;;27,0;16,0;21,0;3,0;;;5,0;;;;;1,0;2,0;4,0;;;;1,0;;;;5,0;1,0;;;3,0;1,0;;;;;;;3,0;;6,0;1,0;;;;;;;;;;;;;;;2,0;;5,0;;4,0;;;6,0;;;;;;;;;;6,0;1,0;;;;;;;;2,0;7,0;2,0;;;;;;1,0;;;;;2,0;14,0;2,0;;;;;;;1,0;4,0;12,0;;;;;;;;1,0;2,0;;;;3,0;;;;;;;;;;;;;1,0;;3,0;;;;;;;;;;3,0;;;;;;;;;;;1,0;;7,0;;;;3,0;;;;;;;;;;1,0;;;;;;;;;;;;;;;;;;;1,0;;;10,0;;;3,0;;;;;;;;;;3,0;;;;;;;6,0;1,0;;;;2,0;;;;;;;;;;;;;;;;;;;;;;;;;;;;;11,0;;;;;;;;;;;;;;;;;;;1,0;;;;;2,0;;;4,0;10,0;;;;;3,0;;;;1,0;;;;;;;;;;;;;;;;;;1,0;;;;;;1,0;;;;;;1,0;;;;;7,0;;3,0;;;5,0;;1,0;;;;;;;;;;;;;;;;;;;;;;;;;;;;;1,0;;;1,0;;;4,0;;;2,0;;;;;1,0;;;;;;;;;;;1,0;;;;1,0;;;;;;7,0;;;;;;;1,0;;;;6,0;;;;;;;;;;1,0;;;;;;;;7,0;;;;;1,0;;;;;;;;;;;;;;;1,0;;;;2,0;;;;;;;4,0;;;;1,0;;;;;;1,0;2,0;;;;;;;;;;;;;;;;;;2,0;;;;;;;;;;;;;;;;;;;;1,0;;;;;;;;;;1,0;;;;;;;;;;;1,0;;;;;;;;;;1,0;;;;;;;;;;;;;2,0;;;;1,0;;;;;;;;;;;;;4,0;;;;1,0;3,0;;;;1,0;1,0;;1,0;;1,0;1,0;;;;;;;;;;;;2,0;;;;;;;;;;;;;;;;;;;;;;;
turn;;;3,0;;18,0;;12,0;26,0;3,0;7,0;2,0;1,0;2,0;1,0;8,0;2,0;;2,0;5,0;3,0;1,0;60,0;;1,0;3,0;;7,0;5,0;2,0;20,0;6,0;12,0;50,0;;36,0;;2,0;20,0;;42,0;;;29,0;15,0;;;;;8,0;;25,0;5,0;;3,0;;65,0;17,0;;2,0;51,0;;;21,0;;;11,0;1,0;1,0;1,0;24,0;8,0;1,0;7,0;;;1,0;;2,0;29,0;91,0;;12,0;7,0;2,0;;7,0;6,0;;;15,0;8,0;;2,0;39,0;;1,0;;1,0;3,0;2,0;23,0;34,0;;15,0;;;1,0;48,0;;;2,0;3,0;3,0;17,0;6,0;;;;8,0;32,0;;;2,0;40,0;;;10,0;7,0;;12,0;15,0;1,0;2,0;8,0;;3,0;2,0;;;29,0;;;8,0;17,0;10,0;;11,0;5,0;;;;2,0;1,0;;;2,0;4,0;4,0;17,0;17,0;;2,0;4,0;5,0;1,0;1,0;9,0;84,0;;;41,0;10,0;40,0;12,0;4,0;7,0;2,0;15,0;;;;2,0;6,0;;2,0;1,0;1,0;36,0;;21,0;;5,0;;;;;;;10,0;1,0;1,0;;;10,0;;2,0;;2,0;2,0;5,0;;;;;8,0;45,0;2,0;1,0;1,0;;6,0;11,0;;;;;9,0;;;;;;;;4,0;3,0;;11,0;4,0;22,0;1,0;;;;1,0;;4,0;;;7,0;;;;3,0;;;;3,0;1,0;;;5,0;6,0;;3,0;5,0;3,0;4,0;;;2,0;1,0;;2,0;1,0;;;1,0;11,0;1,0;;;1,0;6,0;;3,0;9,0;3,0;9,0;;;;;1,0;;4,0;;3,0;;1,0;5,0;;9,0;1,0;2,0;;;6,0;1,0;;6,0;2,0;4,0;3,0;8,0;;1,0;2,0;3,0;;1,0;;16,0;;6,0;30,0;1,0;;33,0;;15,0;;;;;;2,0;;;;;4,0;3,0;;14,0;;2,0;1,0;2,0;2,0;3,0;4,0;;;;2,0;1,0;;7,0;;;;;16,0;1,0;2,0;1,0;;;;;;;;1,0;;1,0;;;;8,0;5,0;;;12,0;;1,0;;;5,0;5,0;9,0;1,0;;37,0;5,0;2,0;3,0;1,0;;4,0;;;;;;;11,0;;5,0;5,0;3,0;4,0;;;10,0;1,0;;8,0;;2,0;;;21,0;41,0;3,0;;8,0;;1,0;1,0;;1,0;2,0;1,0;2,0;;;;6,0;23,0;;1,0;;;27,0;;;;;;2,0;;1,0;;;;;2,0;2,0;;;;;;5,0;6,0;2,0;1,0;;;17,0;;;;;2,0;;3,0;1,0;;;;2,0;;18,0;3,0;;6,0;7,0;;150,0;;;9,0;3,0;2,0;23,0;4,0;;;;;2,0;;;;2,0;;2,0;;;;6,0;8,0;1,0;;;;;;;;;;;4,0;;;4,0;13,0;;1,0;1,0;4,0;;5,0;2,0;;;;14,0;;;2,0;;;;;;;1,0;;;5,0;2,0;;;;;7,0;3,0;;1,0;;;5,0;1,0;;;;;;;;;2,0;;;;;;2,0;;2,0;17,0;;;;6,0;;;;1,0;;3,0;;;;10,0;;14,0;1,0;;;;1,0;;;;;1,0;;;;;1,0;1,0;;;1,0;;;;;;;;4,0;;1,0;1,0;2,0;;5,0;;1,0;1,0;1,0;1,0;;;1,0;;;;;1,0;;;;2,0;;3,0;;1,0;2,0;;;;;;2,0;1,0;;;;;;;;;5,0;;3,0;1,0;;;3,0;;12,0;;;3,0;3,0;1,0;2,0;1,0;;;3,0;30,0;;;;;8,0;3,0;5,0;;1,0;;;1,0;;;;;;1,0;;15,0;4,0;;;;29,0;5,0;;4,0;2,0;;;2,0;;;;;;;;;1,0;;;;;;1,0;;1,0;;;;;;;;;;;;;9,0;;;;;9,0;2,0;;5,0;;1,0;;;;;;;1,0;1,0;2,0;;;2,0;;;;1,0;1,0;;;1,0;;;2,0;2,0;;;2,0;;;;1,0;;;4,0;;5,0;;;5,0;14,0;1,0;2,0;;;;;;;;;;1,0;;;;;;3,0;;;;;;1,0;3,0;;2,0;1,0;;;;;;;2,0;1,0;;;2,0;5,0;1,0;;;;;16,0;5,0;;;;;;1,0;;1,0;3,0;3,0;;2,0;1,0;;;;;;;;;3,0;;2,0;;;;;;;;4,0;;10,0;;;;;;;;;1,0;;;;;;;;;;;;;;;;;;;;2,0;;15,0;;;;;;;;;;1,0;;;;;2,0;;;;;;;;;;;;;;;;;;;;2,0;;;;;;;;;;;;;;;;;;;;;;;1,0;;1,0;;;;;;;1,0;;;;1,0;;;;;;;;2,0;;;;;
update;;;11,0;;7,0;;5,0;45,0;1,0;41,0;4,0;4,0;;3,0;30,0;;;;;8,0;57,0;17,0;2,0;;3,0;;;196,0;;1,0;3,0;46,0;17,0;7,0;10,0;;;10,0;;43,0;;;;2,0;14,0;1,0;;;2,0;9,0;3,0;12,0;;1,0;;414,0;31,0;;;1,0;;;58,0;3,0;13,0;;2,0;;;9,0;5,0;4,0;;;;1,0;;9,0;16,0;;;13,0;8,0;1,0;;;12,0;;26,0;36,0;9,0;6,0;;39,0;;2,0;;14,0;51,0;;;33,0;;1,0;6,0;9,0;1,0;62,0;;;1,0;2,0;8,0;;;6,0;;;;10,0;;;4,0;8,0;;9,0;32,0;;;3,0;;1,0;1,0;;;;;;;;;6,0;;10,0;15,0;;5,0;27,0;;;;;;;;;;;;1,0;;5,0;;;;;;1,0;1,0;;;;4,0;;3,0;;;12,0;;;;;;;;;;102,0;;26,0;;;;33,0;;;;;;;;;;;;;;;;;;;;;;113,0;33,0;;;;;5,0;;;;;;;;;;;;;16,0;;;2,0;39,0;;;;3,0;;;7,0;;;;;;10,0;;;;;;4,0;;;;13,0;7,0;;;;;;;;;;;;1,0;2,0;1,0;;3,0;;;;;;;5,0;;16,0;;;;;;4,0;;;;10,0;;;2,0;;19,0;;;;;4,0;;;29,0;;;;;;;;;;;6,0;;;;15,0;;;;;7,0;;;;;;;;1,0;;5,0;27,0;;1,0;2,0;2,0;;2,0;;16,0;;;;1,0;;2,0;;;;;2,0;;;;3,0;7,0;;;4,0;;17,0;;;11,0;17,0;10,0;2,0;;;;26,0;4,0;;15,0;3,0;;1,0;1,0;;6,0;6,0;19,0;;;;;;6,0;1,0;;1,0;;1,0;1,0;;;7,0;3,0;;;;;;25,0;;7,0;14,0;;4,0;;10,0;1,0;1,0;3,0;10,0;5,0;1,0;4,0;;16,0;8,0;;;;;1,0;;;;;6,0;9,0;;;1,0;5,0;;;5,0;1,0;1,0;2,0;13,0;7,0;;21,0;;1,0;26,0;5,0;12,0;1,0;7,0;;;17,0;;1,0;90,0;;;18,0;;;;;;2,0;1,0;;;2,0;41,0;1,0;1,0;1,0;9,0;3,0;;4,0;;;4,0;6,0;15,0;28,0;20,0;4,0;;;2,0;;4,0;;;;;;;;;;;1,0;1,0;1,0;;9,0;5,0;16,0;;;2,0;;;;1,0;;;;5,0;;;;23,0;;;;;;;3,0;;;;;;;2,0;;16,0;;;;11,0;;4,0;;;;34,0;3,0;;7,0;;26,0;1,0;;;20,0;1,0;;14,0;;;;;3,0;;;4,0;17,0;3,0;1,0;15,0;2,0;;;;;;;;;;;;;;;;;9,0;;;;;;;;;1,0;;;;;;;;;;;;;;;;;6,0;;;;2,0;12,0;1,0;;;;;;;;;;;1,0;5,0;;;;;;;;;;;;1,0;;8,0;;4,0;;;;;;;;;;;;;;;11,0;;;;;61,0;;1,0;;;11,0;3,0;;;;;;12,0;;;;;;5,0;;;;;;;2,0;26,0;1,0;;;1,0;;;1,0;;;24,0;;1,0;;;;;;3,0;;;;;7,0;13,0;;;;4,0;;;;1,0;;;;8,0;3,0;4,0;;41,0;2,0;;;;;131,0;2,0;1,0;;;;;;1,0;;3,0;;;;;33,0;10,0;;;;;31,0;;;;;;;;;;;1,0;;;;3,0;;3,0;;;;2,0;;;;;1,0;;;;;1,0;1,0;3,0;;;3,0;;;;;;;;;3,0;;;;;;;;;;;1,0;;;;;;;;;;;;;;;;;;;;;1,0;;;;27,0;;;;;;;;;;;;;;;;3,0;;;;3,0;;;;;;;;;;;;;;;;;;;;;1,0;;;;;;;;;;;;;1,0;;;;1,0;;;;;;;2,0;;;;;;;;;11,0;6,0;;;21,0;;;;;;;;1,0;;;34,0;1,0;4,0;;7,0;;;;;;;;;;;;;;;;;;;;;;;;;;;;;;;;7,0;;;;;;;;2,0;37,0;;2,0;;;;;;;
upper;;;11,0;1,0;12,0;;7,0;77,0;2,0;4,0;11,0;;;;7,0;;;;21,0;1,0;2,0;2,0;3,0;;;;23,0;24,0;10,0;2,0;6,0;8,0;34,0;6,0;17,0;2,0;;19,0;;13,0;6,0;;4,0;20,0;;1,0;3,0;;;2,0;3,0;2,0;;16,0;14,0;85,0;72,0;;5,0;129,0;;;19,0;;1,0;4,0;6,0;3,0;;11,0;16,0;10,0;2,0;15,0;6,0;2,0;;13,0;102,0;1,0;7,0;10,0;5,0;2,0;;2,0;51,0;1,0;2,0;3,0;35,0;3,0;5,0;29,0;3,0;25,0;;3,0;1,0;74,0;319,0;10,0;;8,0;;;6,0;95,0;;4,0;1,0;20,0;11,0;15,0;65,0;3,0;;;15,0;82,0;5,0;;;15,0;1,0;3,0;8,0;13,0;;41,0;48,0;;2,0;9,0;1,0;4,0;54,0;;14,0;2,0;;;3,0;45,0;26,0;;101,0;38,0;;2,0;;11,0;32,0;6,0;6,0;40,0;18,0;111,0;;12,0;2,0;2,0;27,0;4,0;4,0;29,0;4,0;22,0;;6,0;149,0;14,0;29,0;48,0;3,0;24,0;23,0;6,0;10,0;;42,0;1,0;3,0;3,0;21,0;30,0;93,0;32,0;;384,0;4,0;10,0;;29,0;5,0;1,0;;1,0;3,0;12,0;4,0;23,0;7,0;158,0;;;2,0;1,0;11,0;93,0;;5,0;;2,0;;1,0;;29,0;;11,0;;5,0;;3,0;83,0;;31,0;;;3,0;9,0;;4,0;3,0;4,0;16,0;11,0;4,0;17,0;;47,0;2,0;5,0;34,0;5,0;55,0;10,0;16,0;;72,0;5,0;1,0;2,0;52,0;8,0;;23,0;40,0;2,0;13,0;5,0;;52,0;7,0;18,0;2,0;34,0;1,0;6,0;14,0;;16,0;;7,0;16,0;;;2,0;53,0;8,0;13,0;33,0;;11,0;13,0;;2,0;14,0;2,0;6,0;;;;10,0;10,0;13,0;2,0;3,0;1,0;1,0;;3,0;23,0;6,0;2,0;6,0;4,0;3,0;17,0;39,0;;9,0;;;13,0;7,0;2,0;;3,0;24,0;37,0;4,0;8,0;;9,0;2,0;8,0;40,0;5,0;;8,0;;;;;;;;4,0;;12,0;;;;;;1,0;1,0;7,0;11,0;5,0;;;1,0;;;;;3,0;;1,0;2,0;;;6,0;14,0;;;;;;1,0;;;;2,0;;1,0;;16,0;;2,0;2,0;;;;2,0;2,0;;2,0;;4,0;2,0;;2,0;;;12,0;7,0;;;;1,0;;;;;4,0;;;2,0;4,0;1,0;1,0;;;5,0;;5,0;;5,0;;;;1,0;;1,0;;;;;;;;;1,0;1,0;;;3,0;;1,0;;;1,0;;2,0;3,0;1,0;;;;10,0;6,0;4,0;;;;;;;;;1,0;;9,0;2,0;;1,0;;;1,0;;;2,0;;21,0;;;;2,0;;;;;5,0;2,0;;;10,0;;3,0;;6,0;6,0;6,0;2,0;;;;4,0;;;;18,0;16,0;1,0;4,0;;14,0;10,0;;;2,0;1,0;33,0;2,0;;;1,0;1,0;;;2,0;;1,0;;;;2,0;;;5,0;;;;2,0;;;;;;;14,0;2,0;;4,0;4,0;;;1,0;;7,0;;2,0;;1,0;;;;32,0;;;;;;11,0;;;;;3,0;;;18,0;;11,0;1,0;14,0;18,0;2,0;;8,0;3,0;;3,0;6,0;;;;;6,0;;;;2,0;;1,0;2,0;5,0;;;;2,0;;;;4,0;2,0;;3,0;10,0;1,0;;;;;;1,0;;;;2,0;3,0;;;;1,0;;7,0;;12,0;6,0;7,0;;25,0;;1,0;16,0;7,0;;;11,0;10,0;1,0;1,0;;;9,0;;3,0;82,0;;3,0;;4,0;4,0;;;;2,0;;;;1,0;;;4,0;4,0;;;;;;3,0;;4,0;9,0;;;;;4,0;9,0;;;1,0;;3,0;1,0;;;10,0;;;;;5,0;;;1,0;;;;2,0;11,0;2,0;;;2,0;;;6,0;;;;;3,0;;;5,0;;28,0;;;1,0;;;2,0;;3,0;;;1,0;;;;;;;;;;;;1,0;;;2,0;;1,0;;;;;2,0;;;2,0;;;;;1,0;;3,0;;7,0;;13,0;;1,0;2,0;;;2,0;3,0;3,0;;;;;;4,0;;;;;;;;;;;1,0;;;2,0;;;;;;;;;1,0;;1,0;;1,0;;;;5,0;;;;;16,0;;;1,0;;;;1,0;;;;21,0;;;;;;3,0;;2,0;;;2,0;2,0;;5,0;1,0;;;1,0;1,0;1,0;;2,0;;;;;;;;8,0;;4,0;10,0;1,0;;2,0;;;;;;;;3,0;;81,0;;;;;;1,0;;3,0;4,0;;2,0;5,0;;;;;;;;1,0;;1,0;;;1,0;;;1,0;;;;1,0;;;;;;;;;;7,0;;1,0;4,0;;2,0;;;;;;;;;;;;;;;;;;;;1,0;;6,0;;5,0;;;4,0;;4,0;1,0;;8,0;;1,0;2,0;;8,0;;;;;;;;;;;;;;;1,0;;;;;;4,0;;1,0;;;;;;;;2,0;;;;2,0;;;;
user;;;17,0;2,0;104,0;;3,0;172,0;12,0;159,0;21,0;41,0;3,0;;21,0;4,0;4,0;1,0;20,0;68,0;38,0;307,0;37,0;4,0;3,0;13,0;;172,0;6,0;79,0;60,0;75,0;429,0;1,0;231,0;2,0;14,0;14,0;3,0;347,0;19,0;2,0;1,0;25,0;4,0;4,0;2,0;8,0;35,0;5,0;34,0;62,0;6,0;49,0;8,0;765,0;188,0;;21,0;52,0;1,0;5,0;296,0;1,0;11,0;;24,0;2,0;1,0;176,0;30,0;12,0;5,0;4,0;;6,0;;81,0;129,0;14,0;14,0;64,0;47,0;10,0;5,0;5,0;69,0;2,0;27,0;395,0;48,0;6,0;14,0;61,0;15,0;8,0;3,0;77,0;83,0;1,0;27,0;178,0;2,0;24,0;5,0;6,0;19,0;185,0;;;20,0;9,0;4,0;31,0;21,0;;;1,0;;45,0;;;5,0;8,0;5,0;1,0;151,0;38,0;1,0;26,0;6,0;23,0;11,0;;18,0;10,0;5,0;;;1,0;;37,0;24,0;60,0;7,0;3,0;27,0;25,0;;10,0;;1,0;12,0;1,0;16,0;;1,0;34,0;2,0;50,0;2,0;3,0;;1,0;4,0;1,0;23,0;19,0;1,0;3,0;32,0;2,0;87,0;12,0;22,0;7,0;2,0;94,0;;3,0;5,0;16,0;5,0;2,0;2,0;5,0;4,0;144,0;;78,0;;;;241,0;3,0;22,0;;;5,0;14,0;;8,0;2,0;22,0;1,0;11,0;2,0;;4,0;28,0;2,0;4,0;7,0;;2,0;74,0;48,0;7,0;7,0;;8,0;7,0;5,0;15,0;3,0;;9,0;;3,0;1,0;3,0;;12,0;;30,0;9,0;;34,0;43,0;5,0;2,0;;9,0;2,0;1,0;3,0;;2,0;;;;3,0;;24,0;5,0;2,0;1,0;77,0;27,0;;2,0;8,0;3,0;3,0;12,0;3,0;1,0;1,0;;;7,0;7,0;;13,0;14,0;457,0;15,0;1,0;6,0;7,0;;;;24,0;;63,0;26,0;135,0;59,0;;;;3,0;16,0;;;1,0;40,0;1,0;;59,0;;99,0;1,0;4,0;;;13,0;5,0;3,0;36,0;31,0;1,0;;7,0;;2,0;;;;;6,0;;3,0;;9,0;;;7,0;5,0;;2,0;1,0;;1,0;1,0;1,0;6,0;6,0;;1,0;93,0;;7,0;4,0;4,0;;6,0;;39,0;10,0;72,0;19,0;;10,0;1,0;4,0;;;;10,0;;;;67,0;42,0;30,0;4,0;1,0;23,0;40,0;;;8,0;67,0;34,0;8,0;1,0;;7,0;16,0;;4,0;29,0;;4,0;2,0;5,0;10,0;49,0;6,0;169,0;1,0;4,0;28,0;5,0;9,0;35,0;10,0;;12,0;;5,0;1,0;2,0;1,0;65,0;39,0;51,0;19,0;7,0;200,0;;6,0;19,0;18,0;16,0;2,0;538,0;1,0;47,0;18,0;10,0;83,0;109,0;14,0;9,0;18,0;1,0;53,0;6,0;3,0;3,0;5,0;34,0;3,0;2,0;3,0;4,0;1,0;37,0;13,0;7,0;11,0;15,0;54,0;1,0;10,0;43,0;3,0;2,0;11,0;28,0;17,0;1,0;;46,0;16,0;121,0;18,0;1,0;25,0;5,0;1,0;3,0;33,0;9,0;3,0;31,0;3,0;;56,0;2,0;2,0;3,0;1,0;12,0;11,0;6,0;19,0;48,0;22,0;44,0;27,0;;10,0;42,0;111,0;16,0;86,0;9,0;39,0;2,0;15,0;88,0;155,0;20,0;;;2,0;53,0;24,0;1,0;3,0;3,0;11,0;2,0;;;2,0;3,0;;9,0;17,0;76,0;11,0;5,0;5,0;12,0;1,0;2,0;1,0;1,0;5,0;7,0;1,0;112,0;;;15,0;3,0;1,0;2,0;3,0;11,0;6,0;17,0;107,0;36,0;11,0;;5,0;28,0;4,0;4,0;2,0;13,0;7,0;8,0;13,0;24,0;3,0;;7,0;105,0;;26,0;7,0;27,0;23,0;15,0;1,0;;;1,0;33,0;16,0;2,0;7,0;1,0;;16,0;43,0;30,0;1,0;5,0;1,0;15,0;;4,0;2,0;10,0;72,0;8,0;3,0;67,0;;8,0;;7,0;6,0;;;12,0;;;1,0;2,0;6,0;1,0;1,0;;4,0;2,0;26,0;8,0;;;;1,0;;1,0;;;6,0;2,0;24,0;5,0;;5,0;3,0;;3,0;3,0;2,0;5,0;2,0;5,0;10,0;5,0;;;17,0;13,0;11,0;;1,0;;1,0;;1,0;1,0;;;;4,0;3,0;3,0;2,0;1,0;8,0;1,0;3,0;1,0;;1,0;;3,0;1,0;5,0;21,0;;3,0;1,0;;8,0;1,0;;;;1,0;;4,0;;4,0;4,0;;2,0;;3,0;;;1,0;;8,0;;;2,0;2,0;;;;1,0;;9,0;;;4,0;;;2,0;;;14,0;;;;3,0;1,0;18,0;;4,0;2,0;5,0;;2,0;;6,0;12,0;;11,0;3,0;6,0;8,0;1,0;6,0;2,0;1,0;;;1,0;;11,0;4,0;;1,0;1,0;;3,0;;;12,0;1,0;2,0;12,0;3,0;2,0;2,0;2,0;;;4,0;2,0;;1,0;;5,0;4,0;4,0;4,0;;3,0;5,0;;5,0;3,0;1,0;;2,0;;3,0;;;;6,0;17,0;8,0;13,0;21,0;10,0;17,0;8,0;;14,0;2,0;1,0;4,0;10,0;;;;;6,0;50,0;13,0;10,0;3,0;2,0;3,0;46,0;6,0;34,0;;;17,0;16,0;2,0;5,0;8,0;55,0;;9,0;1,0;20,0;;5,0;;8,0;2,0;;;2,0;4,0;5,0;4,0;5,0;;1,0;2,0;15,0;4,0;11,0;7,0;3,0;8,0;2,0;34,0;;3,0;;2,0;7,0;6,0;;25,0;6,0;;5,0;3,0;;6,0;;4,0;2,0;;2,0;1,0;1,0;;1,0;2,0;;;;;1,0;18,0;;;;;5,0;4,0;;2,0;1,0;28,0;;;;;;;;;;2,0;;23,0;4,0;;;2,0;1,0;3,0;5,0;2,0;6,0;19,0;1,0;2,0;1,0;;;;;;6,0;9,0;;13,0;;1,0;10,0;8,0;4,0;1,0;;;;4,0;4,0;;;;1,0;4,0;;;5,0;7,0;16,0;1,0;2,0;2,0;11,0;9,0;;;;1,0;1,0;9,0;3,0;;;6,0;;;;;;;1,0;;;3,0;;;;;;;;;;;1,0;2,0;1,0;;;;4,0;;;3,0;;;;1,0;5,0;;;;1,0;5,0;8,0;1,0;;;;;;;;;;;
variable;;;2,0;1,0;19,0;;5,0;22,0;3,0;14,0;1,0;5,0;;;16,0;;1,0;10,0;2,0;;17,0;66,0;9,0;;;;;21,0;;14,0;2,0;16,0;30,0;2,0;13,0;;;7,0;;;11,0;;2,0;15,0;;;3,0;28,0;14,0;21,0;;20,0;1,0;13,0;1,0;128,0;39,0;;33,0;140,0;3,0;110,0;25,0;1,0;;;5,0;;;7,0;28,0;13,0;11,0;;;31,0;;9,0;11,0;26,0;;5,0;5,0;;;;12,0;;6,0;8,0;42,0;6,0;1,0;40,0;1,0;4,0;;3,0;16,0;;1,0;44,0;;;;;;64,0;2,0;;;2,0;;;;;;;;1,0;;;;18,0;;;9,0;;1,0;4,0;;;;;;2,0;;;;2,0;;;;;11,0;3,0;37,0;;;;;;;;;;;;3,0;16,0;2,0;2,0;;;;1,0;4,0;15,0;16,0;;;1,0;1,0;;2,0;;;26,0;;;;;6,0;;;;1,0;10,0;1,0;4,0;;;3,0;10,0;;1,0;;;;;1,0;;;2,0;;;;;;1,0;;;;;2,0;14,0;1,0;;;;;;;12,0;;;4,0;;;;;;;;5,0;4,0;;18,0;20,0;;8,0;;1,0;;;;1,0;;;;1,0;1,0;;24,0;2,0;;;5,0;1,0;;7,0;3,0;1,0;;;;;;;;;1,0;;;;4,0;;;2,0;1,0;;;;1,0;;5,0;3,0;82,0;4,0;;;;;;;;;1,0;;;;;14,0;1,0;;;;13,0;;;3,0;2,0;;;;1,0;;;;;;12,0;;;;23,0;;;2,0;;4,0;22,0;;;;;23,0;;;;;2,0;;1,0;;;;2,0;;28,0;2,0;8,0;;12,0;;;6,0;;;;2,0;1,0;;;;4,0;2,0;2,0;2,0;1,0;;;;1,0;2,0;5,0;;10,0;;7,0;;2,0;3,0;1,0;;;4,0;3,0;;4,0;;4,0;;;5,0;35,0;5,0;;35,0;;;;;;;;;23,0;;1,0;;1,0;;;;;;;3,0;1,0;4,0;;;;14,0;;1,0;6,0;3,0;2,0;1,0;;;;;;1,0;;;;;1,0;;;;9,0;1,0;2,0;;3,0;;;4,0;2,0;;1,0;;;5,0;;;;;2,0;;1,0;;;50,0;;;12,0;;;;;1,0;;;;8,0;;;;;;;;;3,0;;23,0;11,0;;9,0;10,0;;27,0;;;;;1,0;;1,0;1,0;;1,0;1,0;;;;;;;;;;;2,0;;;;3,0;;;;;;;;;;;;34,0;;1,0;1,0;;;1,0;4,0;1,0;;;;;;;;;;1,0;;;;;;8,0;11,0;;;;;;1,0;;;;;;1,0;;;;;;;;;2,0;8,0;;;;;;1,0;;;;;;;;;;2,0;1,0;1,0;;24,0;23,0;;;;;;;;;;;;;;;;;;;7,0;;;;;;;;;;2,0;;;;;;;;;;;;;13,0;;5,0;;;;;;;;;1,0;;1,0;;3,0;;;;;;1,0;;;;2,0;;;;;;;1,0;;2,0;37,0;7,0;3,0;1,0;;45,0;;33,0;;2,0;;;4,0;;4,0;;;;3,0;4,0;;;;;;;;2,0;;3,0;1,0;;1,0;3,0;1,0;;7,0;;;;;;;;;2,0;;;;;;15,0;;;;;;2,0;;2,0;2,0;;8,0;9,0;1,0;;14,0;14,0;;;;;;;;;3,0;;;;;4,0;;;;1,0;;;;;;;;;;;;1,0;;;;;;;;;;;;;;;;;;;;;;;;;;1,0;;;;;;;2,0;10,0;;;;;9,0;;;;2,0;2,0;;;;2,0;;;2,0;;;;;;;;4,0;;1,0;;;;6,0;;;2,0;;22,0;;;;4,0;3,0;16,0;2,0;;;;9,0;;;;;;1,0;;;;;;;;;;;;;;;;;;;;;;;;;;;;;;2,0;;;;;;;;;;;;;;;2,0;;;;;;;;;;;;;;;;;;2,0;1,0;;;;;;;;;1,0;;;;;1,0;5,0;;;;;;;;;;;;;;;;;;;;;;3,0;;1,0;;;;;;;;;;;;;;;;;;;;;;;;;;;;;;;;
variation;;;60,0;;1,0;;4,0;26,0;93,0;4,0;2,0;4,0;;;13,0;;24,0;5,0;22,0;3,0;8,0;7,0;3,0;11,0;3,0;;6,0;14,0;;21,0;2,0;29,0;11,0;20,0;5,0;3,0;;5,0;;;5,0;;;6,0;;6,0;;6,0;21,0;8,0;7,0;8,0;;4,0;;84,0;14,0;;10,0;43,0;;28,0;14,0;2,0;;;;;2,0;;11,0;2,0;5,0;;;;;9,0;18,0;1,0;1,0;2,0;;5,0;;;4,0;;1,0;9,0;21,0;3,0;;37,0;1,0;;;2,0;4,0;;2,0;4,0;;1,0;;;2,0;27,0;;;;;3,0;;1,0;2,0;;;;;;;1,0;;;1,0;7,0;1,0;;;4,0;;;;;2,0;;;;1,0;;1,0;;;;;5,0;;;;1,0;;;;;;;;5,0;2,0;;1,0;;;;;10,0;6,0;;;;;3,0;;7,0;;;3,0;;;;;;;;5,0;;2,0;;15,0;;;;;;;;;;;;3,0;;1,0;;3,0;;1,0;;;;;;;;9,0;;;;;;3,0;;;;;;;;;;;;;;80,0;;3,0;4,0;;;;6,0;;;3,0;1,0;;;6,0;1,0;1,0;;;;;;;;;3,0;6,0;;;;;;;;;;;4,0;;;1,0;;;6,0;;;6,0;;1,0;;13,0;13,0;4,0;2,0;;;;;1,0;;;;;;;;;14,0;2,0;;;;2,0;;;5,0;;;;;;;;;;;1,0;;;;1,0;;1,0;;;1,0;6,0;;3,0;;;;1,0;5,0;;;1,0;;;;;4,0;;;16,0;;2,0;1,0;;;;;;;;3,0;10,0;;;;2,0;;1,0;8,0;;3,0;;3,0;7,0;;1,0;4,0;2,0;;;10,0;;;;1,0;;15,0;17,0;;6,0;;;;;;7,0;;2,0;4,0;;1,0;;;;11,0;;;8,0;;3,0;;3,0;;3,0;;;;;9,0;;;;;;34,0;;;;1,0;5,0;;9,0;;;;;;;;;;;;1,0;;;1,0;;1,0;;;1,0;9,0;5,0;;;;;;;2,0;;1,0;;;1,0;;;12,0;;;2,0;;;;;11,0;;;;;;;2,0;;;;;;;;;44,0;;;2,0;;;;;;;;;1,0;;;;2,0;;1,0;;;;;;;;;;;;;1,0;;2,0;;;10,0;;;;;;;1,0;;;;;;2,0;;;;;;;;;3,0;2,0;;1,0;;;;;;8,0;12,0;;5,0;;;;82,0;;;;;;;;;;;;;;;;10,0;;;;;;;1,0;;;;;;;;;;;;;5,0;1,0;;;;;;;;;;;;;;;;;;;;;1,0;;;;3,0;;;;2,0;3,0;3,0;;1,0;;;;;;;;;;;2,0;;;6,0;1,0;;;;;;;;;2,0;;;;;;;;;;1,0;8,0;;;9,0;2,0;;;;;;;4,0;33,0;;;;;;;;;2,0;;4,0;;;19,0;1,0;;;2,0;;;;;;1,0;;2,0;;1,0;;;;;;;;;;;;;2,0;;;;;5,0;;;1,0;;;1,0;;;;;10,0;1,0;;3,0;;2,0;5,0;1,0;8,0;;;2,0;;1,0;;1,0;1,0;;;;;;;1,0;;;1,0;1,0;;;2,0;;;;;;44,0;;;;1,0;;;;;;;;;;;;;;;;;;5,0;;;;;;;;1,0;;;;;;;;;;;;;;;;12,0;;;;;;1,0;;;2,0;3,0;;;1,0;;;;;;;;;;;;;;;;;3,0;;;;;;;;;;;;;;;;;;6,0;;;;;;;;3,0;1,0;;;;;;;;;;;;;;;;;1,0;;;;;;;;;;;;;;;;;;;;;;;;;4,0;;;;;;3,0;;;;;;;;;;;;;;;;;;;;;;;;;1,0;;;;;;;;;;;;;;;;;;;;4,0;;;;;;1,0;;;;;;;;;;;;;;;;;;;;;
vary;;;38,0;;16,0;;14,0;9,0;7,0;2,0;;16,0;;3,0;16,0;;;;;2,0;5,0;45,0;1,0;1,0;10,0;;6,0;9,0;1,0;15,0;;3,0;23,0;12,0;7,0;;;5,0;;30,0;54,0;;4,0;9,0;5,0;7,0;;13,0;13,0;7,0;18,0;13,0;;6,0;;71,0;18,0;;21,0;46,0;;88,0;42,0;;;10,0;7,0;4,0;;8,0;33,0;10,0;;;;3,0;1,0;10,0;39,0;32,0;;2,0;2,0;1,0;;;1,0;3,0;;4,0;7,0;;20,0;35,0;29,0;;;2,0;3,0;;16,0;15,0;;4,0;1,0;;;47,0;;;3,0;3,0;2,0;;;;;;;;;;2,0;17,0;;1,0;29,0;;;;;1,0;3,0;;;4,0;3,0;;1,0;2,0;;;;4,0;8,0;1,0;9,0;5,0;1,0;;;2,0;;;;;;1,0;2,0;25,0;18,0;2,0;;;;3,0;5,0;51,0;5,0;2,0;3,0;6,0;5,0;;2,0;1,0;;16,0;;;1,0;;6,0;;1,0;1,0;2,0;36,0;2,0;19,0;;;1,0;3,0;;4,0;2,0;;2,0;;;7,0;;2,0;;;;1,0;1,0;;;;3,0;1,0;4,0;22,0;3,0;;1,0;1,0;;;;;2,0;;1,0;;;1,0;18,0;;;1,0;8,0;22,0;3,0;1,0;6,0;1,0;4,0;;;;;1,0;;;;;;3,0;;5,0;;;;;1,0;1,0;;6,0;;;;;1,0;;;;;;;;;1,0;;;4,0;;;2,0;;2,0;;11,0;1,0;15,0;4,0;;;;;;;1,0;;8,0;;;;;18,0;;;;;12,0;;1,0;7,0;5,0;;;4,0;;;;;;;;;1,0;;3,0;;;6,0;;2,0;;8,0;;;;5,0;;;12,0;;1,0;;;2,0;;2,0;1,0;;11,0;;;2,0;5,0;;4,0;3,0;7,0;;;;;;1,0;;6,0;;;;1,0;;;;;;;;;;;10,0;8,0;;3,0;5,0;5,0;;6,0;;;;11,0;3,0;;28,0;33,0;2,0;;5,0;;11,0;;;6,0;;;;16,0;3,0;;;;10,0;;1,0;;;;4,0;;3,0;;;;9,0;;;;4,0;1,0;1,0;;;;;;;;;4,0;;;;;;14,0;;;2,0;;;1,0;8,0;1,0;;;;;;;2,0;;;;;1,0;5,0;1,0;8,0;;;18,0;;;;;1,0;;;;;;;;;5,0;5,0;;;2,0;;2,0;24,0;;2,0;7,0;;21,0;;;;2,0;;;8,0;2,0;;;;;;;;1,0;1,0;;;2,0;;;;;2,0;;;4,0;2,0;;;;;;;;;;;;;;;4,0;;1,0;1,0;;;;1,0;;;1,0;;1,0;;;1,0;;;3,0;21,0;;;;;2,0;11,0;1,0;;;;;;;;;;;;;1,0;1,0;4,0;1,0;;;;;;;;;;;;;;3,0;;;;;3,0;2,0;;;;;;;;;;;;;;;;;2,0;;14,0;;;;;2,0;3,0;;;2,0;3,0;6,0;8,0;;3,0;;9,0;;;;;;;;;;1,0;;3,0;;;;;;;;10,0;;26,0;4,0;;3,0;;;;;;;5,0;4,0;;5,0;;;;;;1,0;;;2,0;9,0;;4,0;;;;;4,0;2,0;;;1,0;;1,0;;;7,0;7,0;;;;;;9,0;;;3,0;1,0;;;;;;2,0;2,0;;2,0;2,0;2,0;;;;;;;;;1,0;6,0;;5,0;;5,0;;;2,0;2,0;6,0;3,0;;;1,0;2,0;;;;;;;;;;;;22,0;10,0;;;;;;;;;;2,0;;;;;1,0;;;1,0;;;;;;;;;;;;;;;;;;;;;;1,0;;;;;;;;;;1,0;;5,0;;;;;;1,0;;;;;1,0;3,0;;;;;;2,0;4,0;;12,0;1,0;1,0;;;;;;;;1,0;;;;2,0;;8,0;;;;;;1,0;;1,0;;;3,0;;;;;;;;;;;;;;;;;;25,0;2,0;1,0;;;;;;4,0;;;;;;;;;;;;;;;7,0;;;;;;;;;;;9,0;4,0;;;;;1,0;;;2,0;;6,0;;;;6,0;;13,0;;;7,0;;;;;;1,0;;;;;;;;;;;;;;;;;;;;;;;;;;;;;;;;;;;6,0;2,0;;;;;2,0;;;;;;;;;;2,0;;;;;;;;;;;;
vector;;;18,0;3,0;25,0;;33,0;116,0;175,0;5,0;35,0;1,0;;3,0;21,0;59,0;1,0;;51,0;;2,0;5,0;51,0;193,0;28,0;5,0;1,0;58,0;;30,0;15,0;88,0;25,0;30,0;11,0;8,0;13,0;46,0;57,0;2,0;6,0;196,0;;5,0;2,0;;;3,0;2,0;;19,0;145,0;;8,0;;203,0;45,0;;10,0;2,0;1,0;;81,0;5,0;4,0;;39,0;;1,0;8,0;22,0;;4,0;;;1,0;;51,0;37,0;;;21,0;27,0;;6,0;;20,0;;67,0;5,0;24,0;3,0;15,0;14,0;7,0;2,0;;1,0;51,0;;8,0;32,0;;;4,0;;3,0;25,0;;;;;2,0;;;;;;4,0;3,0;;;;3,0;;;23,0;;;1,0;;1,0;;;10,0;5,0;;;1,0;;;;;;7,0;;18,0;135,0;25,0;;;;;;;;;;;7,0;2,0;1,0;3,0;;3,0;1,0;3,0;13,0;;;;12,0;4,0;6,0;33,0;;;6,0;;;;;;;;21,0;;81,0;6,0;42,0;;;;1,0;5,0;;;;9,0;1,0;;;;2,0;;;;;1,0;11,0;27,0;;;;3,0;13,0;;;;;;3,0;;;;;17,0;;;;;;;1,0;1,0;12,0;;8,0;42,0;;;;44,0;;;;;;;;8,0;11,0;;5,0;3,0;4,0;;23,0;;;6,0;;4,0;;;;1,0;;;7,0;;;1,0;;;3,0;;;;4,0;;;;;;406,0;2,0;58,0;1,0;2,0;1,0;6,0;;;;6,0;;;;;;;36,0;14,0;8,0;;1,0;2,0;;;23,0;3,0;;;;;;;;;;6,0;;;1,0;8,0;;;;30,0;2,0;;;3,0;;7,0;;;;1,0;;8,0;;10,0;4,0;;13,0;12,0;;3,0;;;25,0;10,0;;;14,0;;;;28,0;;;9,0;25,0;10,0;;2,0;;;;;8,0;6,0;4,0;1,0;1,0;;;11,0;;;29,0;;;9,0;;7,0;;1,0;;2,0;6,0;;;2,0;2,0;2,0;2,0;2,0;3,0;;2,0;11,0;;33,0;;2,0;;;;;;5,0;;20,0;23,0;1,0;19,0;;8,0;;;2,0;1,0;;;;19,0;2,0;2,0;7,0;;;;;;;;;;2,0;;;;5,0;;;1,0;;1,0;6,0;7,0;;;;;;11,0;;;;;8,0;;3,0;;;23,0;;;7,0;1,0;;;12,0;1,0;;;;;3,0;;2,0;;;;;1,0;5,0;;;;;3,0;9,0;;;2,0;;;;1,0;3,0;;;;;;;;;;;;;;;;;;;3,0;;;;1,0;;;;;9,0;;;;;;;1,0;;;3,0;1,0;;;;;12,0;;;1,0;;;;;;;;;8,0;40,0;;1,0;;;;30,0;;;;;;;;;;;;;;;;10,0;3,0;1,0;;;;;;;;;;;;;;3,0;;;;4,0;;;;;;;;;;;;;;;;;;;;;3,0;1,0;;;;;;;;;;;;;;;;;;;;;;;;;;3,0;;;;;1,0;;;6,0;;7,0;;;;;2,0;;;;1,0;;;;;3,0;;;3,0;;;;;32,0;;7,0;;;;2,0;;;;;;25,0;;;5,0;;;1,0;;;5,0;8,0;;;;;5,0;;2,0;;1,0;1,0;;;;;;;;;1,0;;;;4,0;;;2,0;;8,0;;2,0;;;7,0;2,0;;;;;;9,0;;;2,0;;4,0;;;;;;6,0;2,0;;2,0;;;;2,0;;3,0;;;;;;2,0;;;;;;2,0;1,0;;7,0;;;;;3,0;;9,0;;;;1,0;;;2,0;;;;;;4,0;;;;;;;;;;;;8,0;42,0;3,0;;;;;7,0;;;;9,0;;;;;;;;;1,0;11,0;;;;;;;;;;2,0;;;;;;;;;;1,0;2,0;;;;3,0;;;;5,0;;;;;;;1,0;;;;;;;;3,0;;2,0;;;;;;;;;;;;;;3,0;;;;6,0;;;;7,0;;;;;1,0;;;;9,0;;;;;;;;;;;1,0;3,0;;3,0;;;7,0;;5,0;;;;;;;;;;;;;16,0;2,0;12,0;;;;2,0;;;;2,0;;;;;4,0;;;2,0;1,0;;;2,0;;;;;;;;;;;;;;;;;10,0;1,0;;;;;4,0;;;66,0;;;;;;;;;;
velocity;;;6,0;;19,0;;5,0;37,0;28,0;1,0;;2,0;;2,0;2,0;;1,0;;2,0;5,0;6,0;17,0;2,0;20,0;13,0;;1,0;4,0;;145,0;25,0;37,0;9,0;8,0;3,0;;1,0;40,0;;6,0;3,0;1,0;18,0;8,0;9,0;;;2,0;;;;13,0;;;;25,0;18,0;;7,0;13,0;2,0;;38,0;;;;8,0;7,0;10,0;2,0;19,0;1,0;6,0;4,0;;;;5,0;23,0;;;10,0;7,0;;;;2,0;;;8,0;78,0;;;122,0;;;;2,0;2,0;;1,0;21,0;4,0;;;;;18,0;;;;;;;1,0;;;;;9,0;;;2,0;;;;13,0;;;;;;;;;8,0;3,0;;;;;;3,0;;11,0;2,0;;14,0;;;;;;;1,0;;;10,0;;1,0;2,0;;;;;;24,0;3,0;;;;;;;14,0;;;21,0;;;;;;;;2,0;;18,0;;;;;;2,0;;;;;1,0;;;;;;;1,0;;1,0;;;;;;;16,0;32,0;;;1,0;;;29,0;1,0;;;;;;;;;;;;1,0;4,0;;10,0;1,0;;2,0;;;;;8,0;;;;;;;;;;1,0;;;;;;1,0;;;;;;;;;;;;;;;;;;;;;;;;12,0;2,0;51,0;;1,0;;;;;;;;18,0;;;;1,0;;;;;;;;;26,0;3,0;;;;;;;;;;4,0;;;;;;;;;1,0;;3,0;14,0;;;;;;304,0;;6,0;;1,0;9,0;;13,0;;;3,0;;5,0;9,0;12,0;;;9,0;;;;18,0;;;;;;;1,0;5,0;;4,0;2,0;17,0;1,0;;1,0;1,0;;8,0;;1,0;4,0;;2,0;;;5,0;;;;;;;;;10,0;2,0;7,0;4,0;1,0;2,0;;;;33,0;;;1,0;;;;;;1,0;1,0;;;1,0;;;1,0;;;;1,0;;;;;;;;;;;;;;;;;;;;;3,0;;;;;2,0;;;;;;;;;1,0;;;;4,0;;;;;1,0;4,0;;;;;;6,0;;;;;8,0;;;;;2,0;;;;5,0;;;;;5,0;1,0;;;;;;1,0;;;;;;;;;;;;6,0;;;;;;;;;;;;;;;;;;3,0;;;;;;;;;;2,0;;;;;;;;;;;;;;;;1,0;;;2,0;;;;;;23,0;;;;;;;;;1,0;;;;;;;;;;;;;;;;;;;;;;;1,0;;;;;;;2,0;;;;;;;;;;;;;;;;;;;;;;;;;;;2,0;;;;2,0;;;;;;;;;;;;1,0;;8,0;;;;;;;;4,0;;2,0;;;;;;17,0;;;6,0;;;1,0;;;;;;;;;;5,0;;1,0;;;;;;;;;;;;;;;10,0;15,0;;4,0;1,0;;;;;15,0;1,0;;;;9,0;;;;;;;;;;;;5,0;;;;;;;2,0;1,0;;;;;;;;;;4,0;;;6,0;1,0;;;;;;1,0;;;;;;2,0;;;1,0;;4,0;1,0;;;;;;;;;3,0;1,0;;;;7,0;;;;1,0;;;;;;;;;;;;1,0;;;7,0;;;;;;;;;;;;;;;;;;;;2,0;;;;;;;;;;;;;;;;;;19,0;;;8,0;;;;;;;;;;;;;;10,0;;;;;2,0;;;;;;;;;;;;;;;;;;;;;4,0;;;;;;;;;;;;;;;;1,0;;;;;;;;;;;;;;;;;;;;;;;;;;;;;;;;;;;;;;;;;;;;;;;;4,0;;;;;;;;;;;;;;;;;;;;;;;;;;;;;3,0;;;;;;;;;;;;;;;;;;;;;;;;;;;
vertical;;;22,0;;8,0;;89,0;59,0;32,0;8,0;21,0;;2,0;1,0;23,0;;;9,0;36,0;1,0;;47,0;5,0;1,0;3,0;;3,0;12,0;18,0;14,0;14,0;25,0;31,0;18,0;20,0;8,0;;236,0;5,0;17,0;43,0;;14,0;25,0;;3,0;;3,0;;1,0;1,0;35,0;3,0;9,0;23,0;133,0;56,0;2,0;16,0;47,0;;3,0;37,0;3,0;4,0;2,0;7,0;;;4,0;41,0;3,0;20,0;;;;;15,0;71,0;2,0;;15,0;4,0;1,0;;2,0;63,0;1,0;1,0;30,0;26,0;18,0;3,0;376,0;15,0;6,0;;3,0;8,0;7,0;25,0;16,0;;255,0;2,0;;;133,0;;;;29,0;6,0;5,0;;;;;6,0;6,0;1,0;;1,0;22,0;;4,0;16,0;4,0;;5,0;4,0;;;;;13,0;20,0;;31,0;2,0;1,0;;;3,0;1,0;3,0;30,0;26,0;;;;1,0;9,0;;9,0;9,0;23,0;5,0;2,0;19,0;3,0;2,0;6,0;1,0;1,0;45,0;2,0;33,0;;;12,0;4,0;5,0;37,0;14,0;2,0;3,0;39,0;;;;3,0;1,0;;11,0;63,0;19,0;57,0;;49,0;;;;21,0;4,0;11,0;3,0;;36,0;3,0;3,0;8,0;;10,0;;1,0;49,0;;11,0;34,0;;;9,0;2,0;25,0;24,0;2,0;;;3,0;3,0;1,0;;;8,0;;;;1,0;;1,0;;5,0;7,0;3,0;45,0;;6,0;24,0;;6,0;6,0;3,0;12,0;;;5,0;;;;89,0;;12,0;62,0;12,0;;7,0;18,0;5,0;;4,0;28,0;23,0;1,0;1,0;2,0;21,0;1,0;;1,0;;1,0;;;3,0;;;11,0;5,0;16,0;;;;2,0;;20,0;8,0;16,0;2,0;2,0;;8,0;4,0;6,0;;8,0;10,0;2,0;3,0;;;;6,0;;6,0;;3,0;3,0;;2,0;2,0;17,0;;;5,0;;8,0;2,0;;1,0;4,0;;6,0;3,0;;3,0;1,0;2,0;1,0;9,0;4,0;;;;;13,0;;;24,0;5,0;4,0;;;;1,0;;;;;1,0;1,0;;12,0;1,0;;;;4,0;;;2,0;1,0;;;;10,0;;1,0;2,0;4,0;;6,0;;4,0;1,0;5,0;8,0;;;17,0;24,0;12,0;;;22,0;;;2,0;;1,0;;19,0;4,0;;;1,0;1,0;4,0;;2,0;;;3,0;9,0;3,0;;2,0;7,0;;;2,0;1,0;2,0;;;5,0;;;5,0;;11,0;1,0;;;4,0;;;18,0;4,0;4,0;;4,0;;;;;;;1,0;2,0;;;;1,0;2,0;6,0;17,0;3,0;;6,0;;;28,0;;;;;;;;;;;;;3,0;3,0;14,0;18,0;;;14,0;6,0;;;2,0;2,0;;1,0;;43,0;;;;;22,0;4,0;2,0;14,0;9,0;;2,0;;3,0;10,0;23,0;;1,0;;;;4,0;3,0;;5,0;;;;;;;;;3,0;2,0;;;;;;;;5,0;;;;;;4,0;;;;2,0;;;;1,0;;;;;1,0;;2,0;;;17,0;;;;5,0;;;1,0;;;7,0;;2,0;;154,0;6,0;1,0;;;;15,0;;;;;;;;5,0;;1,0;1,0;;;;;4,0;;15,0;8,0;1,0;;;;;2,0;;;8,0;70,0;;;;7,0;;;1,0;;;;;;5,0;;;;;2,0;;;2,0;;;3,0;4,0;4,0;2,0;2,0;;;1,0;;;1,0;;1,0;5,0;5,0;2,0;;2,0;;9,0;;;;;2,0;3,0;;3,0;;12,0;;2,0;1,0;;3,0;;;1,0;;25,0;1,0;8,0;;;;5,0;;;7,0;;;;;;1,0;;;;;;;1,0;4,0;11,0;3,0;;;;;14,0;3,0;;8,0;;;;6,0;1,0;390,0;;;2,0;;3,0;;6,0;;11,0;;;5,0;;1,0;;41,0;;;4,0;;;;1,0;;1,0;;4,0;;;5,0;;;;3,0;2,0;1,0;2,0;;1,0;;;3,0;;;;7,0;;;;7,0;;;;;1,0;1,0;;1,0;;;20,0;1,0;;34,0;;;1,0;;;5,0;5,0;2,0;;;;;4,0;3,0;9,0;1,0;;;;;1,0;;;1,0;;;;;24,0;;;;2,0;2,0;;;;;1,0;;;;;;;;5,0;;2,0;;;3,0;;1,0;;;1,0;;11,0;;1,0;;2,0;2,0;;;;;5,0;;1,0;1,0;;;;1,0;2,0;;4,0;2,0;2,0;;;11,0;5,0;;2,0;;;;10,0;;;;;;;3,0;3,0;2,0;2,0;2,0;5,0;1,0;;;;;;;2,0;2,0;1,0;;3,0;;;4,0;1,0;;;2,0;1,0;;;;;;;;;1,0;;;;;;;;;;2,0;;;;;;;;;;;;;;;;;;;;;;;;;;;;;;;;;1,0;;;;;9,0;;;29,0;;;;;;1,0;;1,0;1,0;;;;;6,0;;14,0;;;;;;;6,0;;;;;;;;;;2,0;1,0;;;;;2,0;;;;;;;;;4,0;;;;;;;
vibration;;;29,0;;71,0;;35,0;27,0;18,0;6,0;19,0;23,0;;;;;10,0;11,0;8,0;;5,0;47,0;;16,0;20,0;;;1,0;4,0;258,0;99,0;5,0;78,0;9,0;17,0;;;51,0;;6,0;1,0;;57,0;64,0;;;;;;54,0;1,0;83,0;2,0;1,0;;111,0;14,0;;;111,0;;3,0;44,0;;;17,0;19,0;;8,0;18,0;65,0;9,0;1,0;7,0;;8,0;7,0;4,0;29,0;;;18,0;;11,0;;;2,0;4,0;;2,0;37,0;12,0;1,0;102,0;4,0;2,0;;1,0;2,0;3,0;3,0;62,0;;;1,0;;;162,0;49,0;5,0;;10,0;;2,0;1,0;4,0;;;;55,0;;;;32,0;;;35,0;;2,0;1,0;1,0;;;;;25,0;2,0;;3,0;;;;1,0;5,0;22,0;1,0;2,0;12,0;;;;;;1,0;16,0;1,0;;2,0;;16,0;;;1,0;;;;;4,0;;7,0;154,0;;12,0;11,0;3,0;;;52,0;;;1,0;;17,0;;1,0;4,0;;19,0;;37,0;;;;4,0;1,0;;;1,0;16,0;;;4,0;;3,0;;2,0;;4,0;5,0;6,0;;;1,0;;1,0;13,0;4,0;;22,0;5,0;;;;;;;9,0;;;;;;121,0;1,0;2,0;2,0;2,0;25,0;;;23,0;;;;;3,0;;;;3,0;;;;;;;;2,0;3,0;;2,0;77,0;1,0;6,0;;;;;;;;;;;;;;;3,0;3,0;1,0;3,0;;26,0;;10,0;14,0;8,0;7,0;;1,0;2,0;3,0;16,0;;5,0;;9,0;;;2,0;;31,0;;;;;;;;16,0;;;;;;;;;5,0;;29,0;;1,0;;;;;;;5,0;;;10,0;;;10,0;;;9,0;;4,0;;24,0;43,0;2,0;5,0;1,0;;27,0;1,0;;;1,0;;2,0;;1,0;1,0;4,0;10,0;;;;;2,0;;7,0;;;;;4,0;2,0;2,0;1,0;2,0;5,0;;20,0;6,0;6,0;;;;28,0;4,0;;;1,0;;2,0;;1,0;9,0;6,0;2,0;8,0;7,0;;;;;;;1,0;;6,0;2,0;4,0;;;;;;;;;5,0;;;;;4,0;102,0;;8,0;2,0;;;;;;;;;;;;;;;;;;1,0;13,0;;;7,0;;;2,0;;;;;;;;;;1,0;;;1,0;2,0;;;;;5,0;;;;;;;;;;;;;;1,0;;;;2,0;5,0;2,0;1,0;;5,0;2,0;2,0;4,0;;;;;;;2,0;2,0;;1,0;;2,0;1,0;;;;;;;;;;;;;;;;;6,0;;;;;;;;;;3,0;;;;;;;;;;;;;8,0;;;;;;1,0;;;;;;;;;;6,0;1,0;;;;;;;;;;;;;;;3,0;;;;;;;;;;;;;;1,0;;;1,0;;;8,0;;1,0;;7,0;;;;;;;;;;;;;;;6,0;;;;;;;;;;2,0;;;;;;;2,0;;;1,0;;;;;;;;;2,0;;;;;;7,0;;;;;2,0;;;;5,0;8,0;;;2,0;3,0;;;;;;;;;;1,0;2,0;;;;;;;;;;1,0;1,0;;2,0;;;;;;7,0;;1,0;;;;;;;2,0;;;;;;;;;;;;;;;;;;;1,0;8,0;;;5,0;;;;3,0;;1,0;;4,0;;;6,0;;149,0;5,0;;5,0;;;2,0;;;;;;;;;;1,0;;1,0;1,0;1,0;;;;;;;;;;;;1,0;;;1,0;;;;;;9,0;1,0;;;;;;;;;;;;;;;;;;;;;;;;;;3,0;;;;;;;;;;;;;;;;4,0;;;;;;;;;;3,0;;;;;1,0;;;15,0;;;;;;;;;;;2,0;;;;;;;;1,0;;;;;;;;;;;;;;;;;;;;;;;;;;;1,0;;;1,0;;;;;;1,0;;;;;;;;;;;;;;;;;;;;;;;;;1,0;1,0;;;;;;;;;;;;;;;;;;;;;;;;;;;;;;;2,0;;;;;;;;;;;;;;;;;;;;;;;;;;;;;;;;;;;;;;;;
view;;;9,0;3,0;67,0;;136,0;168,0;54,0;235,0;88,0;6,0;6,0;;34,0;21,0;1,0;1,0;23,0;50,0;83,0;168,0;68,0;39,0;9,0;;4,0;143,0;232,0;81,0;47,0;106,0;251,0;11,0;131,0;30,0;52,0;196,0;4,0;441,0;38,0;13,0;1,0;172,0;3,0;;;20,0;29,0;5,0;18,0;74,0;;9,0;21,0;1128,0;282,0;4,0;19,0;190,0;11,0;6,0;303,0;2,0;24,0;10,0;67,0;9,0;12,0;55,0;244,0;1,0;29,0;11,0;;11,0;;220,0;285,0;1,0;3,0;76,0;44,0;31,0;;;200,0;5,0;43,0;126,0;121,0;15,0;10,0;52,0;49,0;35,0;16,0;6,0;30,0;8,0;83,0;310,0;;7,0;10,0;1,0;4,0;156,0;;;36,0;16,0;26,0;115,0;9,0;;1,0;;;32,0;1,0;;42,0;4,0;1,0;8,0;118,0;1,0;2,0;19,0;61,0;20,0;1,0;;5,0;40,0;23,0;;4,0;10,0;1,0;59,0;22,0;28,0;13,0;1,0;67,0;72,0;3,0;7,0;;;4,0;;11,0;5,0;1,0;68,0;28,0;144,0;38,0;4,0;1,0;6,0;8,0;9,0;15,0;111,0;2,0;7,0;28,0;64,0;49,0;61,0;74,0;44,0;;71,0;;17,0;24,0;43,0;17,0;2,0;4,0;50,0;8,0;208,0;;242,0;14,0;5,0;16,0;36,0;17,0;51,0;;4,0;31,0;11,0;1,0;32,0;2,0;39,0;;9,0;1,0;10,0;11,0;11,0;10,0;1,0;28,0;1,0;30,0;75,0;40,0;19,0;12,0;5,0;6,0;92,0;2,0;35,0;;;29,0;5,0;3,0;;2,0;3,0;;14,0;62,0;757,0;;12,0;193,0;3,0;4,0;6,0;4,0;2,0;1,0;19,0;2,0;;;1,0;;4,0;;13,0;1,0;10,0;6,0;105,0;36,0;1,0;28,0;14,0;12,0;;2,0;;19,0;;3,0;3,0;6,0;31,0;3,0;5,0;5,0;29,0;5,0;;65,0;41,0;;3,0;4,0;25,0;1,0;104,0;25,0;282,0;17,0;7,0;11,0;9,0;69,0;22,0;;29,0;;38,0;1,0;;4,0;1,0;54,0;33,0;22,0;;;78,0;18,0;1,0;33,0;60,0;4,0;;3,0;;;;;5,0;1,0;14,0;;2,0;;37,0;;;;1,0;155,0;7,0;6,0;;;1,0;28,0;17,0;2,0;22,0;1,0;45,0;4,0;4,0;4,0;1,0;1,0;15,0;5,0;58,0;23,0;22,0;29,0;7,0;;;9,0;1,0;;;10,0;1,0;3,0;2,0;46,0;49,0;5,0;12,0;3,0;67,0;;;;24,0;9,0;4,0;52,0;3,0;187,0;19,0;5,0;41,0;4,0;11,0;1,0;1,0;;8,0;6,0;38,0;6,0;38,0;1,0;15,0;4,0;4,0;8,0;106,0;4,0;3,0;45,0;3,0;9,0;2,0;9,0;1,0;172,0;43,0;5,0;5,0;13,0;42,0;;14,0;;84,0;25,0;;39,0;8,0;97,0;1,0;;20,0;142,0;;5,0;19,0;9,0;90,0;11,0;4,0;;;8,0;;3,0;6,0;3,0;;7,0;39,0;1,0;17,0;11,0;30,0;7,0;13,0;6,0;20,0;6,0;21,0;1924,0;3,0;11,0;5,0;1,0;4,0;8,0;4,0;;8,0;215,0;18,0;2,0;49,0;48,0;10,0;43,0;58,0;;37,0;10,0;24,0;21,0;4,0;5,0;;1,0;2,0;8,0;47,0;4,0;6,0;;17,0;106,0;18,0;2,0;47,0;3,0;46,0;2,0;3,0;260,0;;34,0;;16,0;2,0;;;;5,0;33,0;3,0;2,0;1,0;11,0;;;1,0;3,0;39,0;11,0;;;5,0;;;;10,0;;8,0;1,0;;22,0;6,0;8,0;11,0;2,0;;1,0;1,0;9,0;3,0;;2,0;5,0;;;6,0;5,0;6,0;5,0;13,0;5,0;16,0;;13,0;6,0;3,0;1,0;6,0;27,0;;19,0;4,0;5,0;23,0;58,0;;6,0;3,0;1,0;;56,0;;;6,0;3,0;;5,0;;2,0;19,0;1,0;8,0;;18,0;3,0;19,0;98,0;10,0;1,0;11,0;2,0;4,0;4,0;28,0;3,0;2,0;;34,0;9,0;2,0;;1,0;2,0;4,0;3,0;;17,0;41,0;4,0;;4,0;;3,0;;;1,0;19,0;;;;42,0;;;4,0;;;12,0;7,0;;7,0;;;13,0;;;5,0;14,0;13,0;17,0;;38,0;;11,0;;3,0;;2,0;2,0;;;;3,0;;11,0;15,0;6,0;;1,0;;1,0;;1,0;;13,0;43,0;2,0;;2,0;10,0;1,0;2,0;;;2,0;;;1,0;8,0;23,0;8,0;;6,0;;23,0;;;2,0;1,0;9,0;;;4,0;4,0;;;;8,0;3,0;6,0;;;34,0;8,0;;5,0;5,0;14,0;15,0;2,0;20,0;;7,0;7,0;40,0;;2,0;3,0;16,0;1,0;1,0;;9,0;;12,0;3,0;3,0;;13,0;;2,0;2,0;7,0;2,0;;6,0;;12,0;11,0;;9,0;3,0;;;2,0;1,0;;17,0;;25,0;;5,0;1,0;1,0;3,0;11,0;1,0;34,0;3,0;1,0;27,0;1,0;10,0;14,0;22,0;;;9,0;5,0;7,0;11,0;1,0;;15,0;7,0;2,0;;4,0;6,0;4,0;23,0;10,0;19,0;5,0;6,0;;28,0;6,0;35,0;9,0;;6,0;6,0;5,0;;;;2,0;47,0;2,0;4,0;5,0;14,0;;2,0;21,0;;;2,0;58,0;1,0;22,0;12,0;12,0;6,0;;14,0;19,0;77,0;;;2,0;;21,0;;;2,0;13,0;;8,0;92,0;;1,0;48,0;6,0;27,0;5,0;10,0;6,0;;;;;;2,0;1,0;1,0;8,0;;3,0;2,0;;3,0;3,0;1,0;2,0;15,0;3,0;3,0;;;33,0;4,0;2,0;1,0;1,0;1,0;175,0;1,0;1,0;14,0;3,0;;;1,0;1,0;;1,0;;1,0;;11,0;3,0;;7,0;;;;2,0;1,0;;;3,0;6,0;4,0;;;2,0;;23,0;8,0;3,0;18,0;;;4,0;;1,0;;;24,0;1,0;1,0;2,0;3,0;7,0;;1,0;;;5,0;1,0;;15,0;;13,0;8,0;4,0;;;3,0;6,0;;2,0;;;1,0;;2,0;;;6,0;;;5,0;;3,0;4,0;14,0;;;4,0;10,0;;1,0;;;;3,0;;1,0;;;2,0;27,0;1,0;2,0;;32,0;1,0;;;6,0;;;;;8,0;;;;23,0;;;;3,0;;;7,0;7,0;;;;;7,0;;;1,0;4,0;7,0;;;;;
virtual;;;3,0;;25,0;;24,0;42,0;4,0;30,0;12,0;;;4,0;;;;;46,0;27,0;;193,0;38,0;5,0;;;;65,0;2,0;11,0;;97,0;48,0;1,0;7,0;41,0;33,0;116,0;;125,0;45,0;;;11,0;;;;5,0;40,0;;5,0;95,0;;3,0;7,0;250,0;40,0;2,0;14,0;27,0;;;115,0;3,0;38,0;1,0;30,0;;;56,0;12,0;2,0;14,0;4,0;;7,0;;174,0;139,0;;;6,0;30,0;1,0;;;6,0;;12,0;44,0;2,0;;;2,0;;137,0;;10,0;12,0;;4,0;123,0;2,0;;9,0;;;19,0;;;;3,0;6,0;;1,0;;3,0;;;2,0;;;24,0;;;;27,0;;;3,0;10,0;6,0;;;;6,0;6,0;;;;1,0;134,0;;6,0;;2,0;5,0;14,0;;;;;2,0;;;;;;1,0;1,0;;;;;;;1,0;3,0;1,0;;;;4,0;;29,0;;;4,0;;1,0;1,0;;1,0;;14,0;47,0;;31,0;;2,0;;;;9,0;;;;;7,0;;;1,0;;10,0;;;;;;;;;;;6,0;19,0;2,0;;2,0;;;9,0;;8,0;3,0;;;;1,0;;;;;;13,0;11,0;;3,0;32,0;;;;1,0;;;;;;;1,0;;;;4,0;;;;44,0;12,0;1,0;;;4,0;;;;9,0;;;;;2,0;;;5,0;2,0;;;;8,0;;;2,0;3,0;;11,0;32,0;361,0;1,0;6,0;;2,0;1,0;1,0;;9,0;;3,0;;;;;46,0;23,0;4,0;;;45,0;1,0;;3,0;3,0;;;13,0;;;;;;1,0;;1,0;;;10,0;;10,0;;;65,0;;2,0;3,0;;;1,0;4,0;;;;18,0;2,0;1,0;19,0;;;;;37,0;;6,0;6,0;2,0;;;1,0;4,0;;;;;;;8,0;7,0;;;;2,0;;;1,0;;5,0;2,0;;;;1,0;3,0;;;5,0;;;4,0;;;3,0;;7,0;;;15,0;;;6,0;;3,0;13,0;1,0;;;;;;;2,0;;13,0;8,0;;3,0;;2,0;;;30,0;1,0;33,0;;;10,0;3,0;;3,0;;;24,0;2,0;1,0;;;;;;;2,0;;13,0;;17,0;1,0;;41,0;;;;1,0;1,0;3,0;23,0;;;;;;3,0;;;;5,0;3,0;3,0;;;;29,0;1,0;;13,0;;44,0;;;;;;;;5,0;;2,0;;20,0;49,0;6,0;;25,0;;29,0;;;16,0;172,0;;;1,0;;;;;;4,0;;;;;;;;;;1,0;;;;5,0;;;;;;;;;;19,0;3,0;;;;2,0;;;;1,0;2,0;;;;;;;;;13,0;;3,0;3,0;;;3,0;7,0;;4,0;;;6,0;58,0;;;;;;20,0;;;;;;8,0;;;;;6,0;;;1,0;;36,0;;;;;;;7,0;1,0;;;;;;;;3,0;2,0;;;;;2,0;;;;;;;;;;;;;;;;;2,0;;;;1,0;;;;;;;;3,0;7,0;;;;;;2,0;2,0;;;;;;;;;;;1,0;;1,0;;;;3,0;11,0;32,0;;;4,0;;;;;;83,0;;;;;2,0;;;;;1,0;;;;;1,0;;;;;;;;;;;;;2,0;;;;;7,0;1,0;;;;;;10,0;;4,0;;;;;;;;;;2,0;;;;;;2,0;;;2,0;;1,0;;;;;1,0;2,0;;;;;;32,0;;;;;;;;2,0;;;44,0;1,0;;;;;;;;5,0;;;;;;2,0;;;2,0;;1,0;;25,0;;6,0;;2,0;;38,0;;;;1,0;;;;;;105,0;;;;;;1,0;71,0;;;4,0;50,0;;;25,0;2,0;;3,0;;33,0;119,0;;;;;;;;;20,0;;10,0;;;;;1,0;2,0;1,0;5,0;3,0;;;;;;1,0;;11,0;3,0;;;1,0;;;;;;;6,0;;;8,0;1,0;;5,0;16,0;;;;;;;3,0;;;;;;;;;;93,0;;;;;;1,0;2,0;;;;;1,0;3,0;;;;;2,0;;;6,0;;4,0;1,0;;;;;3,0;;2,0;;1,0;1,0;;;;;;;;;;;6,0;;1,0;;;3,0;;;;;;;;;1,0;;;;;;;1,0;10,0;;;;9,0;;2,0;;;;;;;;;;21,0;18,0;;;;;;3,0;;1,0;;1,0;;1,0;;;;;;;;;;59,0;;;;;2,0;22,0;;;;;;;;;;;
visible;;;1,0;;18,0;;4,0;22,0;;45,0;1,0;6,0;;;92,0;4,0;;;105,0;2,0;;6,0;;;;;;54,0;;9,0;1,0;4,0;24,0;;10,0;1,0;10,0;1,0;4,0;37,0;9,0;;;10,0;1,0;;;;11,0;5,0;1,0;26,0;;;;227,0;50,0;;;25,0;1,0;;34,0;;;2,0;13,0;2,0;;;31,0;;45,0;;;8,0;;10,0;12,0;;5,0;5,0;10,0;8,0;2,0;9,0;8,0;;5,0;17,0;35,0;;;15,0;1,0;;6,0;;;8,0;17,0;50,0;;;;;;9,0;1,0;6,0;7,0;3,0;10,0;10,0;;;;2,0;;12,0;;;;;11,0;1,0;51,0;;1,0;1,0;2,0;;3,0;;;7,0;2,0;1,0;;20,0;8,0;;;4,0;59,0;;14,0;1,0;1,0;;6,0;;1,0;;;;;12,0;71,0;61,0;1,0;;2,0;6,0;1,0;8,0;7,0;539,0;;8,0;7,0;6,0;16,0;3,0;4,0;5,0;2,0;3,0;;;;1,0;14,0;4,0;;12,0;11,0;13,0;;20,0;1,0;;29,0;53,0;;21,0;;;;1,0;;4,0;4,0;3,0;;1,0;;;1,0;3,0;;;27,0;1,0;;3,0;69,0;11,0;;;3,0;4,0;;;;121,0;;;;;;;;;1,0;4,0;59,0;;16,0;;;;7,0;;;2,0;5,0;;;;;;;1,0;;;;2,0;;;1,0;;;;;;2,0;;;;;1,0;;;3,0;;2,0;;1,0;3,0;;;;1,0;;;2,0;36,0;3,0;;26,0;;6,0;3,0;;;1,0;18,0;;;2,0;;20,0;20,0;1,0;;;45,0;;;3,0;;;;12,0;;;;;;;19,0;;;;54,0;;;;;15,0;;;;;;;;;;;2,0;;;;;;;;6,0;5,0;;;;;;;;;;;;1,0;;5,0;;;;13,0;10,0;;;;;4,0;;;1,0;;;;1,0;;;;;;;;11,0;;2,0;4,0;;;3,0;;30,0;;;;;1,0;;;;8,0;;;;13,0;10,0;;8,0;;1,0;;;;15,0;6,0;;;;6,0;;;;;;;;;;;;;;;;;;;;;;;9,0;1,0;;;;28,0;3,0;;;1,0;;;;;1,0;;;;;;;3,0;;;10,0;;1,0;;;2,0;;1,0;1,0;10,0;5,0;;2,0;;;4,0;7,0;;2,0;;1,0;1,0;;1,0;35,0;;;;;;;;1,0;;;2,0;;;;2,0;;;3,0;1,0;;;;;;;;;;;;;2,0;;;;;;;1,0;;;;1,0;;;;;;1,0;27,0;1,0;;;;;4,0;1,0;1,0;5,0;;5,0;1,0;1,0;1,0;15,0;;;;;;4,0;;;;;;;1,0;;1,0;;;;;;;8,0;;;;;;;;;;;;5,0;1,0;;6,0;2,0;;4,0;;;;;;;;;;;;;;;;1,0;;;1,0;;;;12,0;2,0;;;;4,0;;;1,0;2,0;;;;38,0;;;;;;;;;;;;;;;;1,0;;;;;;;;3,0;;;;;;;;;;;;1,0;1,0;;;;;;1,0;;;3,0;;4,0;;;;;;;;;;;;;;13,0;;;2,0;;;;;;6,0;;2,0;;2,0;;;;;;;;;5,0;;;4,0;;1,0;;;;;;;2,0;;;;;;;;7,0;;;2,0;3,0;;1,0;8,0;;;1,0;2,0;3,0;;;;;12,0;;2,0;;11,0;;;;4,0;;7,0;;;;;;17,0;;;;;;;;;1,0;3,0;;2,0;;;;;;;;11,0;;;;;;;;;;;;;3,0;;2,0;;1,0;;;4,0;;2,0;9,0;;5,0;;;;;;;;;;16,0;;28,0;;;;;;;;2,0;;3,0;3,0;;;;;;;;;;;;;;;;1,0;;;1,0;;;;;;1,0;;;;;;;;;;4,0;;;;;;;;;;;;;;;;;;2,0;;;1,0;;;;;;;;;;;6,0;;10,0;4,0;;10,0;;;;;7,0;;;1,0;;;;;;;42,0;;;;;;;;;;;3,0;;;;;;;;;;;;;;;;;8,0;;;2,0;1,0;;;;;;;2,0;;3,0;;;;;;;;;;;;;;;;;;;;;;;;;;;;;2,0;1,0
visual;;;4,0;;21,0;;58,0;31,0;4,0;70,0;7,0;9,0;3,0;;4,0;;;;13,0;6,0;3,0;54,0;28,0;4,0;;;1,0;64,0;7,0;16,0;5,0;35,0;50,0;1,0;21,0;;6,0;116,0;8,0;128,0;37,0;1,0;;66,0;2,0;;;7,0;9,0;;5,0;43,0;;6,0;3,0;292,0;28,0;;;20,0;1,0;;84,0;;;;38,0;;1,0;3,0;33,0;5,0;8,0;;;8,0;;293,0;244,0;3,0;3,0;37,0;15,0;8,0;1,0;2,0;18,0;1,0;5,0;16,0;18,0;;;43,0;;20,0;7,0;1,0;3,0;3,0;7,0;127,0;;1,0;;;;65,0;;;8,0;1,0;2,0;1,0;;;1,0;;;3,0;;;17,0;3,0;2,0;;19,0;;1,0;2,0;2,0;3,0;1,0;;;2,0;5,0;;;5,0;;6,0;2,0;2,0;5,0;;;11,0;4,0;2,0;;;16,0;;;1,0;2,0;14,0;70,0;9,0;1,0;;1,0;2,0;;;90,0;65,0;;;1,0;2,0;9,0;3,0;22,0;1,0;;33,0;;7,0;;;5,0;;1,0;;;41,0;;10,0;;;3,0;8,0;;;1,0;;6,0;;;1,0;;10,0;;1,0;;;4,0;4,0;8,0;;6,0;4,0;8,0;10,0;1,0;2,0;1,0;;;7,0;3,0;4,0;;2,0;;;19,0;;;;2,0;1,0;4,0;24,0;1,0;9,0;14,0;;;;;;;;;;;;;1,0;;9,0;;;;8,0;;2,0;;;22,0;;;;;;;;;17,0;;;;7,0;;;1,0;19,0;;;;2,0;;27,0;43,0;41,0;6,0;2,0;1,0;;4,0;5,0;;1,0;1,0;17,0;;;3,0;;36,0;4,0;1,0;1,0;;72,0;1,0;;11,0;10,0;;;;;;;;;;59,0;;;;4,0;;;1,0;;20,0;;;;;;;;;;;20,0;4,0;3,0;;;;;;71,0;;;31,0;2,0;9,0;;1,0;;;;;;;;13,0;17,0;;;;7,0;;;;5,0;;3,0;5,0;3,0;;2,0;;;5,0;4,0;;;6,0;;;2,0;;1,0;;;;5,0;;28,0;6,0;3,0;8,0;;4,0;;3,0;;119,0;1,0;1,0;1,0;14,0;9,0;;;;8,0;8,0;;15,0;9,0;10,0;;;10,0;14,0;2,0;2,0;3,0;;2,0;5,0;;;;;;1,0;;11,0;1,0;;;11,0;;1,0;22,0;5,0;7,0;4,0;1,0;2,0;;51,0;;;5,0;4,0;1,0;1,0;;;;6,0;1,0;;18,0;37,0;2,0;5,0;3,0;;19,0;;79,0;2,0;;2,0;;5,0;1,0;;2,0;;;1,0;3,0;5,0;1,0;;13,0;1,0;1,0;;;12,0;77,0;4,0;;;;;;2,0;1,0;12,0;;1,0;;;;;;;168,0;11,0;3,0;;7,0;3,0;;2,0;;1,0;;;2,0;7,0;;2,0;3,0;14,0;;;;;;;;;1,0;;3,0;2,0;;5,0;;;;;;;;;5,0;;;1,0;5,0;3,0;24,0;14,0;;3,0;1,0;;;3,0;;;14,0;;1,0;;;;;;;;1,0;;19,0;4,0;;;;;2,0;;;1,0;;;2,0;;;;;2,0;2,0;;;10,0;;;;4,0;;;;;;;;;;2,0;1,0;;;;;;1,0;;1,0;;1,0;;;;;;;;;;;;;;;;1,0;;37,0;;;1,0;;1,0;;;;;;;;4,0;1,0;4,0;;;10,0;;;;;;6,0;;;;;3,0;;;;;2,0;;;;1,0;;;;;;;;2,0;;;;;;3,0;5,0;;;;;1,0;;;;;;6,0;;13,0;;;;;;;;;;3,0;;;;1,0;4,0;1,0;3,0;;7,0;;1,0;1,0;;1,0;;;;;;;19,0;;1,0;;7,0;;;;;;14,0;1,0;;;1,0;;;;;;;;;1,0;;;1,0;;3,0;;;;2,0;;;14,0;1,0;;1,0;;;4,0;;;;;;;;;1,0;108,0;1,0;;;2,0;;;6,0;;;;6,0;;;3,0;;;;3,0;4,0;;;1,0;32,0;;20,0;;;;;;;;;;2,0;34,0;;1,0;2,0;;;;2,0;;1,0;;;9,0;;;;;;5,0;;;;21,0;8,0;;;;1,0;;;8,0;;;;;2,0;1,0;;;;2,0;;;;;;;;;;;;;;5,0;;;;;;;;;;;;;;;;;3,0;;;;;13,0;;;9,0;4,0;;6,0;1,0;;2,0;6,0;;;;;9,0;;;;;;;;8,0;;;11,0;;;;;;;;1,0;;;;1,0;;;;;;;;1,0;;;;;1,0;;;;;;;;;;;;1,0;;;;;1,0;;;;;;;;;;;;;;;;;2,0;;;;;;;;;
voltage;;;5,0;;27,0;;2,0;29,0;41,0;4,0;1,0;17,0;;;;1,0;4,0;3,0;30,0;1,0;1,0;183,0;;8,0;13,0;;4,0;6,0;2,0;74,0;96,0;83,0;81,0;31,0;51,0;;9,0;21,0;;4,0;6,0;;42,0;37,0;;;;6,0;1,0;36,0;8,0;130,0;23,0;;1,0;33,0;25,0;;6,0;33,0;2,0;;62,0;10,0;;52,0;4,0;;5,0;33,0;6,0;8,0;4,0;;2,0;4,0;11,0;19,0;;73,0;;3,0;2,0;2,0;;;12,0;2,0;17,0;31,0;16,0;1,0;;247,0;3,0;;;4,0;23,0;14,0;30,0;12,0;;27,0;1,0;2,0;3,0;117,0;7,0;;17,0;9,0;8,0;3,0;;;;;1,0;;;;15,0;285,0;;;37,0;4,0;;7,0;5,0;8,0;4,0;;;15,0;3,0;;74,0;7,0;8,0;;9,0;;2,0;1,0;16,0;5,0;4,0;;;;2,0;3,0;15,0;;;;11,0;27,0;;14,0;3,0;;;12,0;245,0;30,0;20,0;8,0;9,0;;10,0;1,0;;;;227,0;;;1,0;;2,0;;;1,0;8,0;35,0;;10,0;;;2,0;18,0;1,0;;2,0;;1,0;1,0;16,0;12,0;;23,0;;;3,0;1,0;1,0;;;;4,0;1,0;;59,0;13,0;1,0;;3,0;;;4,0;;;2,0;;;;;;;3,0;1,0;54,0;;;316,0;4,0;;;;;2,0;1,0;;9,0;;1,0;27,0;65,0;;1,0;67,0;3,0;1,0;;5,0;;2,0;4,0;98,0;;;;;;;;;;18,0;8,0;;;7,0;;;42,0;;;4,0;;5,0;;;7,0;2,0;16,0;4,0;;;;2,0;;2,0;4,0;1,0;8,0;;1,0;;63,0;;;;;9,0;4,0;5,0;199,0;15,0;;;;;;;;;2,0;20,0;4,0;;10,0;49,0;;;152,0;;;21,0;;;;4,0;;;;;;3,0;;11,0;;4,0;3,0;3,0;;18,0;;1,0;;15,0;;28,0;1,0;;;;;;;12,0;;14,0;;2,0;4,0;;1,0;;;25,0;13,0;1,0;1,0;14,0;;7,0;47,0;12,0;;;67,0;;3,0;9,0;2,0;;;21,0;;;3,0;10,0;1,0;1,0;75,0;;;;1,0;;;;;;;;1,0;5,0;3,0;;;;;;79,0;;;1,0;;26,0;4,0;;;35,0;;;1,0;;;;3,0;;60,0;;;98,0;;;;2,0;;19,0;18,0;35,0;3,0;1,0;;;6,0;17,0;;;;;1,0;;3,0;;;3,0;;23,0;1,0;;3,0;;;4,0;;;2,0;;2,0;1,0;;;;;;1,0;;;;14,0;2,0;31,0;;35,0;7,0;23,0;6,0;;;;;;;;;;3,0;;;;1,0;;;;;4,0;3,0;;;;;;;;4,0;;;9,0;4,0;;;;6,0;;1,0;1,0;;;;;1,0;;;;;;;;1,0;;;;;;1,0;1,0;3,0;;7,0;;;;60,0;59,0;;;;;9,0;;;1,0;;;;;;;;;;;;;1,0;1,0;1,0;40,0;1,0;;;4,0;;;;;;42,0;1,0;;;10,0;2,0;;6,0;;;;;17,0;;1,0;;;;;;;;;;;50,0;;3,0;;;;;;;;;18,0;3,0;2,0;;;;;;;;;;;4,0;;2,0;;;;;4,0;;;;;;2,0;1,0;;;4,0;;2,0;;11,0;7,0;;;;;;;4,0;1,0;;;;3,0;;61,0;70,0;1,0;;1,0;62,0;3,0;6,0;;4,0;20,0;23,0;4,0;;;7,0;99,0;1,0;;10,0;27,0;2,0;34,0;;;;5,0;;;8,0;1,0;78,0;;3,0;;;120,0;3,0;1,0;;1,0;;22,0;;;3,0;;;;3,0;;1,0;19,0;;;4,0;;;;;4,0;;;15,0;;;19,0;25,0;;;;;;;;;;27,0;7,0;;2,0;;1,0;3,0;21,0;;;54,0;;;16,0;2,0;12,0;;;;;5,0;;;4,0;;;;;;;;;;;;;1,0;1,0;;;;;;;;;;;;;;5,0;;;;;;;1,0;;;;;3,0;5,0;;;1,0;;;;8,0;;;12,0;10,0;;;;1,0;4,0;;5,0;;;;;;1,0;38,0;5,0;;;;;;2,0;;;;;53,0;;60,0;3,0;;1,0;;;;7,0;;;1,0;1,0;;;1,0;;;3,0;;;6,0;;;;;;;;;;;;;10,0;;;;;;;;;;;;;;;;;1,0;;;;;10,0;;;;;;;;;;2,0;;;;1,0;4,0;;;;;;;;;;;;;;;;;7,0;;;6,0;1,0;;;;;;;;;;;;;;;;;;3,0;;;;;;;;3,0;;;;;;3,0;;;;;;;;;;1,0;;;;;;
wavelength;;;10,0;;12,0;;4,0;11,0;;20,0;7,0;5,0;;;85,0;;;;81,0;;;9,0;;;;;;88,0;;13,0;3,0;5,0;39,0;;61,0;;14,0;;;7,0;2,0;;;13,0;;;;7,0;10,0;;3,0;38,0;;;;129,0;94,0;;3,0;32,0;;;31,0;;;;;;;;59,0;;8,0;;;;;;20,0;2,0;2,0;6,0;6,0;12,0;;7,0;36,0;;;18,0;35,0;1,0;;54,0;2,0;;1,0;3,0;3,0;8,0;10,0;41,0;;;;;2,0;14,0;6,0;6,0;3,0;16,0;52,0;4,0;;;16,0;15,0;;;;;;;;2,0;28,0;;;;;1,0;4,0;1,0;;96,0;6,0;;6,0;63,0;8,0;;;8,0;88,0;;14,0;;;;18,0;;1,0;;;2,0;1,0;1,0;39,0;22,0;31,0;1,0;1,0;;;8,0;;517,0;;7,0;1,0;15,0;20,0;2,0;;;1,0;11,0;;;;10,0;32,0;;;14,0;2,0;91,0;;23,0;;;42,0;7,0;;18,0;3,0;;;;5,0;;1,0;;;20,0;;;9,0;;4,0;;;;;41,0;29,0;7,0;;;;2,0;;121,0;;;;;;;;;1,0;;4,0;;;1,0;;2,0;;;13,0;;;;15,0;3,0;;;;;;;2,0;;;;4,0;2,0;2,0;;;;;;;;;;;7,0;;;;;2,0;;;2,0;;;;;;;;9,0;;;9,0;;15,0;1,0;;;3,0;1,0;;;;;94,0;;;;;243,0;2,0;;17,0;4,0;;;;;;;;1,0;;20,0;;;;11,0;;;2,0;;;;;;;;;;4,0;;2,0;70,0;;;;;;;;3,0;;;;;;;;;;;;;;;;;;;;7,0;;;;2,0;;1,0;1,0;2,0;;;2,0;1,0;2,0;;;;;3,0;;1,0;;15,0;;;2,0;;;26,0;;;;2,0;;;;;;;;;2,0;10,0;;2,0;;;;;;8,0;2,0;;1,0;2,0;3,0;;;1,0;4,0;3,0;;;;;;;;;;;;;;;2,0;1,0;3,0;1,0;;;;;2,0;9,0;;;;;;;;;;;;;;;;;;4,0;;;;;;;;;;;;;;;;27,0;;7,0;;3,0;;;2,0;;;2,0;;;8,0;;;1,0;3,0;;;;2,0;;;;;1,0;;;;;;;;;;;;11,0;2,0;;;;4,0;;;;;;;;;;7,0;;;;;2,0;;;;;;;;;;;4,0;;4,0;;34,0;;;;;;1,0;;;;;;;;;;;;;;;;2,0;;2,0;;;;;;2,0;;;3,0;;10,0;;;2,0;;;;31,0;;;;;;;;;;;;;;;;;1,0;;;18,0;48,0;;;;;5,0;;;;;;;;15,0;;;;;;1,0;;;;3,0;;;1,0;;7,0;;;;;;;;;;;;;;8,0;;;;;;;;16,0;;;;;;;;1,0;;;4,0;;;2,0;;;;1,0;;;;;;;3,0;41,0;;1,0;;2,0;;;11,0;;;13,0;;;;;;1,0;;;;1,0;5,0;8,0;;15,0;;9,0;;2,0;;;;;19,0;;;;;;;;41,0;4,0;;6,0;;;;9,0;;;;;;;;;;;4,0;;;364,0;2,0;3,0;;1,0;;;2,0;;4,0;;;;;;;;;;;1,0;;1,0;;6,0;;;;;2,0;;;;;;;;;;;;;;;;;;1,0;;3,0;;;2,0;;;2,0;;2,0;;;;;;;;;;23,0;;3,0;;2,0;4,0;;;2,0;;3,0;;10,0;;;1,0;;;;;;;;;13,0;5,0;;;1,0;;;;;;2,0;;;;;;;;;;;;;;;;;;2,0;;;;;2,0;;;;;;;;;;;;;;;;;;;;;;;3,0;;;1,0;;2,0;;2,0;4,0;;;;;;;;;;;21,0;20,0;;;;;;75,0;;;14,0;;4,0;;;;;;;;;;;;1,0;1,0;;;;;;;;;;;;;;;;;21,0;;;;;;;1,0;;;;;;;1,0;8,0;3,0;;;;;;4,0;;;;;;;;
weight;;;6,0;;11,0;;;40,0;29,0;7,0;9,0;8,0;;19,0;10,0;;1,0;1,0;4,0;;;8,0;1,0;;;4,0;;17,0;4,0;5,0;1,0;77,0;11,0;17,0;11,0;;;;;7,0;8,0;;1,0;2,0;7,0;2,0;;;;;16,0;26,0;5,0;3,0;;69,0;17,0;1,0;4,0;10,0;;;51,0;6,0;3,0;6,0;2,0;;;4,0;4,0;;;3,0;;;;9,0;42,0;;6,0;6,0;3,0;2,0;2,0;;9,0;1,0;2,0;24,0;2,0;;20,0;8,0;7,0;;3,0;5,0;11,0;;8,0;11,0;;;2,0;;4,0;80,0;;;;;3,0;4,0;7,0;80,0;;;;3,0;;;6,0;;;;10,0;;35,0;;1,0;4,0;;;;3,0;;1,0;;;;;;2,0;5,0;;5,0;21,0;2,0;3,0;5,0;;;;3,0;1,0;;1,0;11,0;;;30,0;;;;;48,0;5,0;;7,0;1,0;1,0;3,0;12,0;8,0;1,0;1,0;9,0;;;;;1,0;;;;;43,0;;3,0;;;;3,0;;2,0;;;1,0;;;;;1,0;;1,0;;;;14,0;;;;;;8,0;;;;3,0;9,0;8,0;;;;;;;;;2,0;;1,0;18,0;14,0;5,0;;12,0;27,0;;1,0;3,0;6,0;;;;;;;;;;;2,0;;;1,0;13,0;2,0;1,0;2,0;;6,0;;;;3,0;;;1,0;;3,0;;3,0;4,0;1,0;;;;;2,0;;;1,0;;9,0;4,0;16,0;;1,0;;;;;;;;;;;3,0;;13,0;2,0;3,0;;;8,0;1,0;;7,0;9,0;2,0;;;8,0;;;;;;;;;;1,0;;;;1,0;2,0;;;;;2,0;1,0;;7,0;;;9,0;;;1,0;;2,0;;;7,0;1,0;;12,0;6,0;;18,0;2,0;;;;1,0;;;;15,0;;2,0;1,0;;;;;3,0;4,0;3,0;;3,0;1,0;;;;;12,0;;;;;33,0;;;;;;;;;;2,0;26,0;3,0;2,0;;;;3,0;;;1,0;;;;15,0;7,0;6,0;;11,0;4,0;;2,0;;13,0;1,0;;;7,0;;;;113,0;1,0;;;;;;;;;1,0;;;3,0;;;;3,0;6,0;;;;;2,0;4,0;;;;1,0;;;;;13,0;;2,0;;8,0;;4,0;4,0;;;1,0;1,0;;;;;;;;;;;1,0;;2,0;;13,0;;78,0;;;;;6,0;6,0;;;;;;;;;;;;;1,0;;;;;;1,0;;;3,0;;5,0;;;27,0;;;;2,0;;;;;2,0;1,0;;;9,0;;;2,0;;;;;;;;2,0;;;;4,0;;;1,0;1,0;;4,0;;;2,0;39,0;;;;;;2,0;;;;8,0;;;;;;9,0;;;;1,0;;;;;11,0;;;3,0;11,0;;;;;15,0;;3,0;;;;;;7,0;;;;;;;;;1,0;;;;;;;;;;;;;;;;;;;;;;5,0;;;;;;;;;;;;;;;;;;2,0;;;;;1,0;;;;;;;;;;;1,0;;;;;;;;;;;;;;;26,0;71,0;;;;;3,0;;;1,0;;;42,0;;;1,0;;1,0;;;;;3,0;2,0;;;;30,0;;;;;;6,0;;;9,0;2,0;;;;;;;;;;;;;2,0;;;;;13,0;;;;;;;1,0;3,0;2,0;11,0;;7,0;;;;2,0;2,0;1,0;;1,0;;;;;;2,0;6,0;;;;;2,0;5,0;;;;;;7,0;;;;;;;;;;;2,0;;;;;;;1,0;;;;;;;;;;;;;;3,0;;;;;;;;;;;11,0;15,0;;;;;;;;;;;1,0;1,0;22,0;;1,0;;;;;;;;;;;;;;;;;11,0;;9,0;14,0;;;;;;;;;;;;;;;;;;;;;;;;;;;2,0;;;;;;;;;;;;;1,0;;;;;;1,0;;;;;;;;;;;;;;;;;;;;9,0;;;;;;;;2,0;;;;;;;;;;;;8,0;;9,0;;;;;;;;;4,0;;;;;;;;;;;;;;;;;;;2,0;;;;;;;;4,0;;;;;;;;;;;;;;;;;;;;
width;;;4,0;;8,0;;5,0;21,0;12,0;8,0;6,0;3,0;1,0;1,0;2,0;;1,0;1,0;;;2,0;32,0;2,0;1,0;2,0;;;3,0;3,0;5,0;2,0;20,0;39,0;3,0;11,0;;;65,0;2,0;59,0;11,0;;10,0;7,0;1,0;;;3,0;2,0;;;6,0;;2,0;39,0;103,0;26,0;;35,0;22,0;;2,0;29,0;;5,0;;;;;;10,0;;7,0;;2,0;1,0;1,0;11,0;23,0;;;2,0;5,0;;;;26,0;;7,0;8,0;29,0;;;21,0;15,0;5,0;;1,0;;44,0;5,0;7,0;;22,0;;4,0;;10,0;;;;4,0;;10,0;1,0;;;;;20,0;9,0;;3,0;10,0;;;3,0;1,0;3,0;;3,0;;1,0;;;4,0;2,0;;23,0;8,0;;;1,0;2,0;3,0;;21,0;7,0;1,0;;;9,0;4,0;8,0;2,0;4,0;3,0;9,0;2,0;7,0;;19,0;;;;10,0;;11,0;;2,0;10,0;;15,0;4,0;;4,0;9,0;6,0;;;;;1,0;;;4,0;3,0;17,0;;34,0;;4,0;;4,0;7,0;;;6,0;;;8,0;10,0;2,0;13,0;4,0;2,0;;1,0;3,0;1,0;;;;2,0;;14,0;1,0;;1,0;;2,0;14,0;;;;4,0;9,0;;;;;;4,0;15,0;7,0;6,0;1,0;3,0;37,0;;7,0;;;1,0;;;17,0;;8,0;;;;;9,0;;;4,0;8,0;6,0;10,0;6,0;;12,0;;2,0;;17,0;;;;;4,0;;1,0;;2,0;;;2,0;;;;;2,0;;;1,0;18,0;1,0;;;;1,0;10,0;;5,0;1,0;4,0;;;3,0;;51,0;2,0;8,0;;;9,0;;3,0;3,0;11,0;;;9,0;;;;;;;;;1,0;;3,0;1,0;;1,0;;4,0;10,0;;;;;1,0;;;1,0;;;;2,0;;;;;;;2,0;;;2,0;;7,0;;;2,0;;1,0;2,0;1,0;;;;;;1,0;;;2,0;;7,0;;;;;;5,0;6,0;1,0;;;102,0;2,0;;18,0;;2,0;3,0;4,0;;;1,0;;2,0;7,0;10,0;4,0;2,0;;;;2,0;;;;;;;13,0;;5,0;;;2,0;;1,0;2,0;2,0;;;;;1,0;;;1,0;3,0;;;;;;1,0;;1,0;;3,0;1,0;;2,0;;;;1,0;1,0;;1,0;;;10,0;7,0;;2,0;;2,0;;;;;;11,0;;;2,0;;;;;7,0;;;;;8,0;;;;;;;;1,0;1,0;6,0;;;4,0;;3,0;2,0;9,0;2,0;14,0;;7,0;1,0;;;;;;18,0;1,0;;;;;;;;;;2,0;3,0;;;;;6,0;1,0;5,0;;2,0;2,0;;;1,0;;;;;;;1,0;1,0;;;;9,0;;;;;;;;;3,0;1,0;9,0;;;1,0;;;;;14,0;;2,0;;;;1,0;;2,0;;;;;;;;3,0;;;;;;;2,0;;15,0;;;;;;;;;;2,0;4,0;;;4,0;;;;1,0;;;;;;;1,0;;;;;;;;;1,0;;;;;;;;;1,0;;;9,0;;;;;6,0;3,0;;;8,0;;2,0;;;;;;10,0;;;5,0;;;;;;6,0;;2,0;;;;7,0;;;;;;;;;;9,0;20,0;;1,0;;;;;;5,0;;1,0;;;;;1,0;;1,0;2,0;;;;4,0;38,0;2,0;2,0;;6,0;;;1,0;;;1,0;;2,0;;1,0;1,0;1,0;;;13,0;;;;2,0;2,0;2,0;;7,0;1,0;;;;;;;1,0;;2,0;;1,0;;;;5,0;1,0;;;;;1,0;;;;9,0;;13,0;;;;1,0;;;;;11,0;;;;;;1,0;1,0;;1,0;3,0;;;;;10,0;4,0;;;;;;2,0;;;2,0;;;;;;;;;;;;;2,0;;;;;;;;;5,0;;1,0;;;;;;;;;;;;8,0;;;;;;;;8,0;1,0;3,0;;;;;3,0;;;;;;;;3,0;3,0;1,0;;1,0;;;;;;;;;;;3,0;;11,0;;;;;;;;;;1,0;;3,0;;4,0;17,0;;6,0;;;;;1,0;1,0;;;;;;;;;;;;;;;;1,0;;;;;;;;;;;;;;;;;;;3,0;;;;;1,0;;7,0;;;;;;2,0;;;1,0;;;1,0;;39,0;;;;;;;;;;;;1,0;;1,0;;;;;;4,0;;6,0;;;;;;2,0;;;;;;;;;;;;;;;;;;;;;;;;;1,0;;;;;
window;;;1,0;;24,0;;18,0;44,0;12,0;16,0;26,0;8,0;1,0;;6,0;;;;1,0;;;29,0;9,0;;2,0;1,0;;56,0;1,0;11,0;1,0;34,0;86,0;6,0;17,0;;10,0;27,0;6,0;109,0;19,0;;;24,0;;5,0;;1,0;3,0;;10,0;6,0;;41,0;5,0;258,0;77,0;3,0;1,0;98,0;;;83,0;;;1,0;;;;7,0;36,0;3,0;1,0;;;4,0;;87,0;139,0;;2,0;9,0;18,0;2,0;;6,0;96,0;4,0;5,0;24,0;28,0;3,0;38,0;24,0;36,0;15,0;;1,0;19,0;3,0;107,0;27,0;;;1,0;;2,0;15,0;3,0;2,0;9,0;14,0;2,0;37,0;10,0;1,0;;;12,0;24,0;3,0;;6,0;11,0;4,0;;32,0;5,0;;11,0;64,0;8,0;;;;2,0;31,0;1,0;;3,0;;6,0;8,0;62,0;10,0;;54,0;39,0;;18,0;;1,0;5,0;2,0;7,0;11,0;3,0;90,0;4,0;48,0;15,0;4,0;17,0;11,0;;3,0;5,0;98,0;;19,0;41,0;6,0;48,0;46,0;11,0;17,0;24,0;2,0;3,0;3,0;8,0;8,0;47,0;;;7,0;7,0;69,0;;149,0;2,0;1,0;4,0;13,0;6,0;32,0;;;4,0;16,0;;8,0;4,0;43,0;;10,0;1,0;;6,0;6,0;1,0;2,0;2,0;2,0;1,0;12,0;11,0;133,0;;11,0;31,0;26,0;9,0;;35,0;;;5,0;;;;;;28,0;13,0;18,0;7,0;3,0;35,0;5,0;2,0;;5,0;2,0;;7,0;1,0;;4,0;;;;;5,0;;;2,0;41,0;1,0;7,0;4,0;;32,0;;6,0;;12,0;;;3,0;3,0;18,0;4,0;;7,0;19,0;1,0;;;6,0;3,0;;3,0;2,0;51,0;4,0;26,0;44,0;6,0;15,0;2,0;;8,0;5,0;;9,0;;9,0;4,0;;7,0;;21,0;28,0;6,0;;;17,0;11,0;4,0;28,0;10,0;;;;;;;;14,0;;;;1,0;;33,0;1,0;;1,0;;9,0;1,0;;;;;;1,0;1,0;1,0;;1,0;;;3,0;;;4,0;3,0;2,0;16,0;6,0;1,0;3,0;;;;;1,0;;1,0;12,0;2,0;;23,0;3,0;8,0;4,0;4,0;4,0;;;7,0;1,0;7,0;;10,0;1,0;;6,0;;1,0;8,0;1,0;1,0;1,0;;3,0;1,0;33,0;;6,0;;;1,0;;1,0;28,0;5,0;;10,0;;5,0;;17,0;;;;;2,0;8,0;10,0;;;;;34,0;;20,0;;1,0;1,0;1,0;;7,0;1,0;;;3,0;;7,0;;4,0;;5,0;;8,0;;4,0;2,0;2,0;10,0;;1,0;;;;;;;;;11,0;10,0;;8,0;;;;;;;;;;;;;4,0;;3,0;5,0;2,0;;;;1,0;;;1,0;;;;1,0;4,0;2,0;3,0;;;2,0;;1,0;1,0;9,0;64,0;29,0;2,0;;;;7,0;;;1,0;28,0;9,0;;;13,0;;15,0;11,0;;9,0;4,0;;;18,0;;;;1,0;;16,0;;12,0;4,0;3,0;;;4,0;;21,0;;2,0;7,0;;11,0;;;;35,0;;;30,0;;;;;;3,0;;;;1,0;1,0;3,0;;;5,0;21,0;1,0;;;;;14,0;;;;;6,0;1,0;;10,0;;30,0;;5,0;;2,0;;1,0;;2,0;5,0;3,0;3,0;1,0;;;4,0;;;3,0;;;;;2,0;;1,0;2,0;32,0;;;;;;;1,0;3,0;1,0;;;;1,0;;;;;6,0;;5,0;;;;;5,0;;;;1,0;1,0;5,0;;5,0;;3,0;;;;;11,0;;;;;11,0;7,0;5,0;1,0;;;;;;;6,0;4,0;2,0;1,0;;;13,0;7,0;2,0;;;;;;;1,0;;;;;;1,0;;;;;3,0;;;;;;;7,0;4,0;;;;;13,0;3,0;;;;;;;4,0;;3,0;3,0;6,0;;1,0;1,0;3,0;2,0;;;;;4,0;3,0;;;;1,0;4,0;;;1,0;;1,0;;12,0;2,0;;;;;1,0;1,0;1,0;;;;9,0;;16,0;;;;;;;;;;;4,0;9,0;14,0;;;2,0;;;3,0;;2,0;;;1,0;;;;;;2,0;8,0;;;2,0;5,0;1,0;;4,0;;10,0;;;;;;2,0;;15,0;1,0;;21,0;;;;;;;;19,0;11,0;;;;;;;;;;;;;;;;;1,0;2,0;13,0;;1,0;10,0;1,0;4,0;4,0;;2,0;4,0;;;;;;;;11,0;1,0;;6,0;;;;;1,0;;18,0;;;;3,0;;;;;;14,0;6,0;;;;;;;;;1,0;;;;3,0;;;;;;;;2,0;;2,0;;;;;;1,0;;4,0;;;;;;;3,0;;;;;;;;;;;2,0;;;8,0;1,0;;;8,0;;;4,0;33,0;;;1,0;2,0;;;21,0;1,0;;;;;;;;;;;3,0;;;;;7,0;;1,0;1,0;;;3,0;;;;;3,0;;;;;;;;1,0;;;;;;;;;;;;;;;;;3,0;;5,0;;7,0;;;;;;;;;;;;
work;;;1,0;;4,0;;12,0;;4,0;;3,0;;;;;;;;3,0;6,0;;25,0;2,0;2,0;;;;;1,0;;;2,0;;;1,0;;;6,0;;1,0;29,0;;;;;;;;;;1,0;;;;1,0;21,0;4,0;;;14,0;;;5,0;;;2,0;;11,0;;11,0;4,0;;;;;;;20,0;25,0;;;;1,0;1,0;;2,0;2,0;;;;11,0;;;10,0;;6,0;;4,0;3,0;;20,0;11,0;;;;1,0;1,0;3,0;;1,0;;;1,0;;6,0;;;;;3,0;;;15,0;;;;1,0;;;;1,0;;;;;;;;;;;1,0;1,0;3,0;1,0;5,0;2,0;9,0;;;;;2,0;;;;;;;2,0;;2,0;;1,0;;;;2,0;;;5,0;;1,0;9,0;1,0;;1,0;3,0;;;;;;;2,0;;3,0;;;5,0;;;;4,0;;1,0;;;;1,0;;;;;;;1,0;;;7,0;8,0;;;;;;;;;;;2,0;;;;;;;;;;;;;10,0;1,0;;;3,0;;;;2,0;;1,0;;2,0;;;;;4,0;;;;;;;;;3,0;6,0;;;;;1,0;;;;1,0;;2,0;;2,0;;;;;4,0;;;;;;;4,0;5,0;4,0;;;2,0;4,0;;;3,0;;2,0;;;;1,0;1,0;1,0;;;;;;;;;;;;;1,0;;;;;;2,0;;;;;;;;3,0;;;;;;;;;;;;;;;2,0;;;;6,0;;;1,0;;;2,0;;;1,0;;;;;;;1,0;;;;1,0;;;;3,0;;14,0;;;;7,0;3,0;;;;;;;;;;;;;;5,0;;3,0;;;;;;;;;;1,0;;;;3,0;1,0;;;;;1,0;;;;1,0;;;2,0;2,0;;;;;;;;;;;;;;;;2,0;;;;;;;;;;;;1,0;;;;;;;;;;;;;2,0;;;;;;1,0;;3,0;;;;;;;;;;;;;;;;1,0;;3,0;;;;3,0;;;;;;;;;3,0;2,0;;;;;2,0;;;;;2,0;;;;;;;;;;;;2,0;1,0;;1,0;;;;;;;;;;;;;;1,0;;;1,0;;;;;;;;;;;;;;;;;;;2,0;;;;;;;;;1,0;;;;4,0;;;;;;2,0;;;;;;;;;;;;;;;;;;1,0;2,0;;2,0;;;;;2,0;;;;;1,0;;;;;;1,0;;;;;;;;;;1,0;1,0;1,0;;4,0;4,0;;;;;;;;;;;1,0;;;;;;;;;;;;;;;;;;;;;;;;;;1,0;;;;;;1,0;;;;;;;;;;;;;;;;;1,0;;;;;;;;;;;;2,0;;;;2,0;;;;;;;;;;;;;;;;;;;1,0;;;;;;;2,0;;;;;;;;;;;;;;;;;;;;1,0;1,0;2,0;;;;;;;;3,0;1,0;;;2,0;;;;;;;;6,0;;;;;;;;;;;;4,0;;;;;;;;;;;;;;;;;;;;19,0;;;;;1,0;;;;;;;;;;;;;;;1,0;;;;;;;;;;;;6,0;;;;;;;;;;;;;;;;;;;;;;;;;;;;;;;;;;;1,0;;;;;;;;;;;;;;;;4,0;;;;;;;;;;;;;;;;;;;;;;;;;;;;;;;;;;;;;;;;;;;;;;;;;;;;;;;;;;;;;;;;;;;;;;;2,0;;;10,0;1,0;;;;;1,0;1,0;;;;;;;;;;;;;;;;;8,0;;;;;
zoom;;;32,0;;64,0;14,0;195,0;69,0;30,0;61,0;6,0;3,0;;2,0;12,0;7,0;7,0;3,0;8,0;6,0;86,0;250,0;3,0;4,0;6,0;;12,0;58,0;11,0;38,0;6,0;121,0;270,0;2,0;150,0;5,0;1,0;98,0;5,0;51,0;60,0;4,0;44,0;136,0;1,0;1,0;;325,0;155,0;;130,0;43,0;1,0;336,0;17,0;646,0;174,0;;298,0;3167,0;2,0;316,0;126,0;51,0;1,0;52,0;92,0;;1,0;129,0;552,0;148,0;7,0;;2,0;38,0;2,0;33,0;334,0;116,0;4,0;51,0;19,0;15,0;2,0;;31,0;12,0;21,0;39,0;52,0;21,0;29,0;165,0;19,0;5,0;;5,0;40,0;;73,0;1558,0;3,0;2,0;4,0;;46,0;413,0;;;32,0;7,0;;9,0;1,0;6,0;;;3,0;2,0;;;20,0;23,0;;;83,0;;2,0;2,0;2,0;4,0;;5,0;1,0;8,0;9,0;;;;;2,0;;17,0;4,0;1,0;225,0;41,0;1,0;;;16,0;7,0;;5,0;1,0;3,0;6,0;4,0;218,0;1,0;26,0;5,0;6,0;3,0;;74,0;20,0;;9,0;13,0;9,0;30,0;2,0;56,0;15,0;1,0;59,0;;;1,0;2,0;5,0;;;18,0;6,0;114,0;;40,0;;;;32,0;;32,0;12,0;;40,0;;;1,0;;163,0;;2,0;6,0;1,0;4,0;5,0;;13,0;;13,0;140,0;98,0;13,0;2,0;4,0;;4,0;;6,0;;;;;;;;1,0;;7,0;4,0;81,0;105,0;;11,0;62,0;12,0;48,0;;8,0;;;3,0;2,0;;;1,0;3,0;;;5,0;10,0;1,0;2,0;15,0;;7,0;7,0;108,0;6,0;;1,0;;5,0;;;1,0;;4,0;;;1,0;4,0;1,0;;322,0;3,0;;;9,0;18,0;;25,0;129,0;136,0;17,0;2,0;1,0;5,0;;1,0;;41,0;1,0;39,0;;;7,0;;30,0;;7,0;;;39,0;2,0;;19,0;9,0;1,0;;14,0;;2,0;;4,0;;2,0;18,0;1,0;2,0;;3,0;;;;1,0;39,0;16,0;;3,0;;;6,0;3,0;2,0;1,0;;25,0;;8,0;5,0;4,0;1,0;5,0;;78,0;10,0;53,0;13,0;2,0;;22,0;;3,0;1,0;2,0;5,0;1,0;;;4,0;18,0;;6,0;1,0;10,0;;1,0;;1,0;5,0;13,0;4,0;3,0;2,0;;17,0;30,0;;7,0;;1,0;19,0;52,0;;6,0;2,0;22,0;;2,0;9,0;16,0;40,0;44,0;37,0;2,0;41,0;;8,0;8,0;2,0;1,0;;;5,0;7,0;1,0;10,0;;3,0;;7,0;3,0;;19,0;;2,0;;;24,0;23,0;7,0;5,0;18,0;14,0;21,0;8,0;;;5,0;;;1,0;1,0;1,0;;8,0;2,0;;;3,0;27,0;3,0;26,0;1,0;15,0;4,0;26,0;35,0;3,0;;1,0;;29,0;15,0;;;4,0;;16,0;2,0;7,0;19,0;;76,0;;;91,0;;;;2,0;;;;1,0;;1,0;;7,0;;9,0;8,0;3,0;;120,0;1,0;36,0;5,0;11,0;66,0;43,0;14,0;;13,0;2,0;1,0;;;3,0;24,0;;3,0;9,0;;;;;;2,0;10,0;6,0;;;1,0;6,0;;;;6,0;;;30,0;1,0;2,0;;2,0;2,0;4,0;;;1,0;2,0;5,0;2,0;;;;2,0;19,0;;;;2,0;;;3,0;;;4,0;6,0;;2,0;;;20,0;30,0;;;;;2,0;3,0;;2,0;1,0;1,0;1,0;;;;1,0;;;;3,0;;;29,0;17,0;;14,0;;;;3,0;2,0;;1,0;;;;7,0;;24,0;;;;9,0;;;;5,0;;4,0;4,0;;7,0;;;;;12,0;;;4,0;1,0;;;1,0;1,0;;;;5,0;;;;20,0;26,0;;;4,0;;;2,0;;1,0;18,0;;4,0;;;4,0;;;3,0;;;;;;3,0;;2,0;;8,0;;;4,0;5,0;1,0;16,0;;1,0;;5,0;285,0;5,0;1,0;7,0;;;1,0;;;1,0;;4,0;1,0;5,0;;;12,0;;;;154,0;1,0;39,0;43,0;;;9,0;15,0;;48,0;;1,0;;1,0;;;1,0;6,0;13,0;;10,0;;1,0;;1,0;;9,0;;;;;4,0;;;3,0;2,0;;;;5,0;2,0;10,0;2,0;;5,0;8,0;3,0;3,0;;;13,0;2,0;;;1,0;4,0;;331,0;;1,0;6,0;;8,0;;1,0;;23,0;;3,0;7,0;1,0;;7,0;;17,0;3,0;;15,0;;10,0;;;;;7,0;1,0;6,0;6,0;;;;;4,0;;1,0;1,0;15,0;10,0;;3,0;3,0;;;2,0;23,0;13,0;;2,0;4,0;;;1,0;;;;;;7,0;;;8,0;;1,0;;;;;2,0;;;;1,0;;7,0;10,0;;;1,0;;3,0;;2,0;6,0;;;23,0;;;;;1,0;2,0;;;;;;;8,0;;4,0;;1,0;;12,0;4,0;;;;;1,0;1,0;3,0;16,0;;1,0;;;;;;3,0;;;1,0;5,0;;;;;;2,0;;;;5,0;;;;;;;;;;1,0;;;2,0;;;;;;;;;;;5,0;;2,0;2,0;;6,0;9,0;;;8,0;;48,0;1,0;;1,0;;;;;;;;;;41,0;;;;;;;1,0;1,0;1,0;;;;3,0;;;;;;;;1,0;;;;;2,0;;;8,0;;24,0;4,0;;3,0;;;;2,0;;;;2,0;;;;;1,0;;;;;;2,0;;;1,0;;;51,0;1,0;3,0;;;;
alert;;;;1,0;2,0;;;23,0;;1,0;;;;;;;;;2,0;2,0;5,0;;;;;;;4,0;;12,0;2,0;7,0;17,0;;;;;;;2,0;;;;;;;;;;;;25,0;;2,0;;7,0;11,0;;;;;;19,0;;;;1,0;;5,0;;;;;;;;;;;1,0;;1,0;2,0;;;;;;;2,0;;;;12,0;;;;3,0;;;;24,0;;;;2,0;;;;;3,0;;;1,0;;;;;;;;;;4,0;;;2,0;;;2,0;;12,0;;;;;;;;;;;2,0;;;;;;;;;;;;;5,0;;;;;;;;;;;;;;;;;5,0;;;;;4,0;;;;;;;;;;13,0;;;;;;;;;;;;;;;;;;;;;;;;;;;;;1,0;;;;;;;;;;2,0;;;;;;;;;;;;13,0;;;;;;;;;;;;;;;;;;;7,0;;;;;;;;;;;;;;;;;;1,0;;;;;;;;;;1,0;;;;;;;;;;;;;;;4,0;;;;;;;;;;;;;;;;;;;;;;;;;;;;;;6,0;;;;;;;;;;;;;;;;;;;6,0;;;1,0;;;;;;;;;;;;;3,0;;;;;;;;;;1,0;2,0;;;;;;;1,0;;;;;;;;14,0;;2,0;;;;;1,0;;;;;;;;;;2,0;10,0;;;;13,0;;89,0;;;;;4,0;;;;;;;;;;;;;;;;;;2,0;1,0;;;;;;;;;;;3,0;;;;;;2,0;;;;;;;;;22,0;;2,0;17,0;;;2,0;;;;;;;;;1,0;;;;;;1,0;;;8,0;;;;;;2,0;;;;;;;;;;;;;;;;;;;7,0;;;;;;;;;;;;;;;;;1,0;;;;;;;;;;;;;;;1,0;;;;3,0;;;;;;1,0;;;;;;;;;;;;;;;1,0;;;;;;;;;;;;;;;;;;3,0;;;;;;;;;1,0;;;;;;;;;;;;;;;;;;;;;;;;;;;;;;;;;;;;;;;;;;;;;;;;;;;;;;;;;;;;;;1,0;;;;;;;;;;;;;;;1,0;;;;;;;;1,0;;;;;;;;;;;;;;;;;;;;;;;;;;1,0;;;;;;;;;;;;;;;;;;;;;;;;;;;;;;;;;;;6,0;;;;;;;;;;;;;;;;;;;;;;;;;;;;;;;;;;;;6,0;;;;;;;;;;;;;;;;;;;;;;;;;;;;;;;;;1,0;;;;;;;;;;;;;;;;;;;;;;;;;;;;;;;;;;;;;;;;;;;;;;;;;;;;;;;;;;;;;;;;;;;;;;;;;;;;;;;;;22,0;;;;;;;;;;;;;;;;;;;;;;;;;;;;;;;;;;;;3,0;;;;;;;;;;;;;;;;;;;1,0;;;;;;;;;;;;;;;;;;;;;;;;;;;;;;1,0;;;;;;;;;;;;;;;;;;;;
algorithm;;;;25,0;4,0;;;7,0;20,0;15,0;;3,0;;1,0;7,0;;3,0;1,0;2,0;2,0;1,0;14,0;2,0;2,0;5,0;6,0;;23,0;;16,0;9,0;20,0;8,0;7,0;14,0;;;1,0;;;3,0;1,0;2,0;;3,0;;4,0;1,0;3,0;;11,0;7,0;;4,0;1,0;126,0;48,0;;1,0;1,0;2,0;;64,0;1,0;6,0;;2,0;;2,0;4,0;;2,0;;;;;;20,0;12,0;1,0;;59,0;5,0;1,0;;;1,0;;;3,0;4,0;;;9,0;;;;;7,0;;;6,0;;;;;;4,0;;;;;6,0;3,0;;3,0;;;;;;;;;;;5,0;;;1,0;;;;;1,0;2,0;;;;;1,0;;;26,0;11,0;;;;;;1,0;;;;;;;;;1,0;;;;;;;;7,0;;;;;3,0;;;;;;;;;;;;;;1,0;15,0;;;;;;1,0;;;;;;;;1,0;;;;8,0;2,0;;2,0;;1,0;;;;;1,0;;;;;;1,0;;;;;;;;;;;;;;;;21,0;1,0;2,0;;;;;;;1,0;;;;;8,0;;2,0;;1,0;;1,0;;;1,0;;8,0;;;;3,0;;;;;;;;;6,0;;;;;;;;;;1,0;;8,0;3,0;;1,0;;;7,0;;;;;1,0;;;;3,0;2,0;3,0;;;;;;3,0;2,0;;;;;;;;;;;;;;4,0;;;;;1,0;;;;;;1,0;;;;;3,0;1,0;;1,0;;1,0;;;4,0;;;6,0;;;;;;;;7,0;1,0;;3,0;6,0;2,0;;;1,0;;;;2,0;3,0;1,0;12,0;;4,0;;;1,0;;;;;;9,0;2,0;;2,0;;3,0;;;;;;1,0;3,0;;8,0;;18,0;;1,0;;;;;;2,0;1,0;;4,0;1,0;;4,0;;;;5,0;;;;2,0;;2,0;;2,0;19,0;;;;;;6,0;;1,0;2,0;;;11,0;;2,0;;2,0;;1,0;1,0;;;;3,0;8,0;;;;;;;;;;2,0;;2,0;;;1,0;;;8,0;;;;;2,0;;8,0;;;3,0;;;;;;;;1,0;;;4,0;;6,0;;;;;;2,0;;;5,0;;;;;1,0;;;;;;;;;1,0;;;;;2,0;;;;2,0;;2,0;;;;;;;;;;1,0;;;2,0;;6,0;;;;1,0;;;7,0;1,0;;2,0;;;;;;2,0;13,0;;;;;;;;;;;;;;;;;10,0;;;;;2,0;;;;;;3,0;4,0;;;;;;;6,0;;4,0;;;;3,0;;;;;;;;;;;;;;;;;;;;1,0;1,0;;;;;2,0;;;;;;;;;;;;;2,0;;;;1,0;;;;;;1,0;;;;;;;3,0;;1,0;;;;;1,0;;;;;;;;;3,0;;;;;2,0;;;1,0;;;;;;;1,0;;;;;;;;3,0;;;;;;;;;;11,0;;6,0;;;;1,0;2,0;;;;;;;;;;;;;;;;2,0;;;2,0;;;;;8,0;;2,0;;;;;3,0;;;;2,0;;;;;;1,0;1,0;1,0;;;;;2,0;;2,0;;;;2,0;;1,0;;;;;2,0;;;;;;;;;;;9,0;;;;;;;;1,0;;;;;;;;;;;1,0;;;;;;;;2,0;;;;;;;;;2,0;;;;;;;;;;2,0;;;;1,0;;;;;;;;1,0;;;;;;;;;;2,0;;;;;;;;;;;;;;;;;;;;;;;;;;;;;;;;;;;;;;;;;1,0;1,0;;;;1,0;1,0;;;;;;;;;;;;;;;;;;;;;;;;;2,0;;;;;;;;;2,0;2,0;;;;;;;1,0;;;;;;1,0;;;;;2,0;;2,0;;;;2,0;;;2,0;;;;;;;;;;;;;;2,0;;;6,0;2,0;1,0;7,0;;;;;;;;;;;;;;;;
analyze;;;;19,0;15,0;;;15,0;2,0;52,0;;11,0;;;4,0;4,0;;1,0;15,0;2,0;5,0;9,0;3,0;4,0;4,0;;;51,0;2,0;22,0;3,0;35,0;21,0;3,0;41,0;6,0;;4,0;;3,0;11,0;;2,0;7,0;;1,0;;2,0;1,0;1,0;11,0;24,0;;1,0;;364,0;15,0;;2,0;4,0;;1,0;84,0;;;1,0;2,0;3,0;;6,0;3,0;6,0;10,0;;;3,0;;24,0;32,0;1,0;;18,0;19,0;9,0;9,0;;17,0;;;18,0;12,0;;;45,0;;1,0;1,0;2,0;7,0;;5,0;20,0;;;;;;60,0;;;1,0;4,0;3,0;7,0;1,0;4,0;;;;;;;;;;;19,0;;;5,0;;2,0;1,0;;1,0;;;;;;;;1,0;2,0;2,0;;1,0;11,0;;;;;;;;;;;6,0;1,0;;;;2,0;4,0;;2,0;26,0;;;1,0;;3,0;;12,0;;;13,0;;;;;;;;;;23,0;;10,0;;;1,0;11,0;1,0;;;;3,0;;;;;;;3,0;2,0;;1,0;1,0;6,0;;;;;10,0;3,0;;1,0;;;1,0;;1,0;;1,0;1,0;;;;;;;;6,0;5,0;;1,0;13,0;3,0;;;3,0;;;5,0;;;;;2,0;;;;;;;5,0;2,0;;;;12,0;;;;;;;;;;;;2,0;;;;;;;;;1,0;;14,0;;48,0;;;;;;21,0;;;;7,0;;;2,0;;10,0;;1,0;;;1,0;;;19,0;2,0;;;;;;;;;;;;;;10,0;;;;;3,0;;;;;;;;;;;;;3,0;;;;1,0;;7,0;;2,0;;;;;1,0;;;;2,0;;;;13,0;3,0;7,0;3,0;;4,0;;;;;;2,0;;1,0;;;1,0;2,0;1,0;2,0;;1,0;;4,0;;2,0;;5,0;1,0;;2,0;1,0;;12,0;1,0;;9,0;;10,0;;3,0;;;3,0;;;;;;7,0;;3,0;13,0;;1,0;6,0;26,0;;9,0;1,0;15,0;;1,0;6,0;1,0;17,0;9,0;;1,0;;;;;;6,0;;;1,0;;;;9,0;;1,0;;;;2,0;2,0;;;;1,0;;5,0;;;;;;;8,0;;;3,0;;;1,0;;;;;;;5,0;5,0;1,0;;;;;;;1,0;;2,0;10,0;;;2,0;44,0;5,0;2,0;;;;2,0;;5,0;;2,0;;;;;;;;;3,0;;;;14,0;;1,0;;;10,0;;;;1,0;;;;;1,0;;;;;;;;1,0;;1,0;;;;;;2,0;1,0;;;5,0;;;2,0;;2,0;2,0;;1,0;31,0;;;;;;5,0;;;;;;3,0;;;;;8,0;;;;1,0;4,0;1,0;;5,0;;;7,0;;1,0;;;;1,0;;;;;;4,0;;6,0;;;1,0;;;;;;1,0;;;;;;;;;4,0;;;;;;;;;;;;;;;;4,0;;;;3,0;;;;;1,0;2,0;;;;9,0;;4,0;;;;;;1,0;;1,0;;;;;;;;;;;;;;;1,0;;;;;;;;3,0;7,0;;;;16,0;;;;;;1,0;;;;8,0;;;2,0;;1,0;;;;6,0;;7,0;;;1,0;;2,0;;;;;;1,0;;;;;;;;;;;;1,0;;;;;;;;7,0;;;;;;;5,0;;1,0;;;;5,0;1,0;;;;;;;;;;;;;;;;;;;;1,0;;;;;;;;;2,0;;;16,0;6,0;;;;2,0;;;;;;;;;;;;;1,0;2,0;;;5,0;1,0;;;;1,0;;;;14,0;;;17,0;;1,0;;;;;;2,0;2,0;;;1,0;;;;;;;;1,0;;;;;;;;;;;;;;12,0;;;;;;;;;;;1,0;;;3,0;;;;2,0;;;;1,0;;;1,0;;;;;;;;;;;;;;;;;2,0;2,0;1,0;;;;;;;;;;;;;;;;;;;;;;;;;;;;;;1,0;;;14,0;;;;;;;;;;;;;;;;;;;;;;;;2,0;;;;;;;2,0;2,0;;;;8,0;;;;;;;;;;;;;1,0;;;;;;;;;;12,0;;3,0;;;;;;;
aspect;;;;1,0;7,0;;;9,0;3,0;19,0;11,0;;;;;2,0;;;3,0;;2,0;17,0;;;;;;15,0;;1,0;;22,0;17,0;;25,0;;1,0;2,0;;34,0;;;;2,0;;;;4,0;;;1,0;2,0;;;1,0;130,0;27,0;;1,0;7,0;;3,0;20,0;;;;1,0;;;5,0;6,0;;;;;;;5,0;2,0;;;5,0;1,0;;;;4,0;;;2,0;18,0;;;4,0;1,0;;;;1,0;;;13,0;;;;;1,0;5,0;;;2,0;;1,0;;1,0;;;;;1,0;1,0;;1,0;;;;6,0;;;1,0;;1,0;2,0;;8,0;3,0;;;;;;1,0;1,0;2,0;3,0;;4,0;10,0;;;;;;;;;;2,0;;11,0;;;;;1,0;;12,0;;;5,0;;;8,0;2,0;3,0;;1,0;6,0;1,0;;;;;;;3,0;;3,0;;8,0;;;;;;;;;;;;3,0;;13,0;;;3,0;;;;2,0;;1,0;;;;16,0;;;;;;;;;;;;;;;;1,0;;2,0;;;3,0;11,0;;;;;;;1,0;;;;;;;;;;;;2,0;2,0;;;;;;;;;;;;;;;;;1,0;;;2,0;;;;;1,0;;4,0;1,0;8,0;3,0;;3,0;1,0;;;;;;1,0;;;;;9,0;3,0;;;;3,0;;;;;;;;;;;;;;;;;;;;;;;3,0;;;;;;1,0;;;;;;;;;;;;;1,0;;2,0;3,0;;;;;;;;;;;;;;;;;;;;;1,0;1,0;;;;;7,0;;1,0;;;;3,0;1,0;238,0;;3,0;;2,0;;;;;;8,0;;;;;1,0;;;;;1,0;;;;;;;;;1,0;;2,0;;;;;;8,0;;5,0;1,0;;1,0;;;;;14,0;;;;;;;;;;3,0;;;;;;;;;;;1,0;;;2,0;;;;;;;5,0;;;5,0;;;1,0;;;;;6,0;;1,0;;;;;;;;8,0;;;11,0;;5,0;;;7,0;6,0;8,0;;;;;;1,0;;2,0;;;;;;;;1,0;3,0;1,0;;;;;4,0;;;;;;;;;;;;;;;;;;;1,0;;;;;;;;;;;;;;;5,0;1,0;;;;;3,0;4,0;;;;;;5,0;;;;;;;;;;;;;;;2,0;1,0;;;5,0;;;;;1,0;;;3,0;;;;;;1,0;;;;1,0;;;;;;;;;;;;;1,0;;;1,0;;;;;1,0;;;;1,0;;;;1,0;1,0;;1,0;3,0;;;;;1,0;;;;1,0;;;;;;;;;;;;;;;3,0;;;;;;;;;;;;;;;;;;;;;;;;2,0;;;;;;;;;;3,0;;;;;;;;;;;;;;;6,0;;;;;;;;;;;;;;;;;;;;;1,0;;1,0;;;;1,0;;;;;;;;3,0;;;;;;;;;;;;;;1,0;;;;2,0;;;;;;;;3,0;;;;;;;3,0;;;;12,0;;1,0;1,0;;;;;1,0;;;;;;1,0;;;1,0;;10,0;1,0;;;2,0;;;7,0;1,0;;;;;;;;;;;;;;;1,0;;;;;1,0;;3,0;2,0;;;;;;;;;1,0;;;2,0;;;;;;;;;;;;;1,0;;;2,0;;;;;;;3,0;;2,0;;;;3,0;;;;;;;;;;;;;;;;;;;;1,0;;;;;;;;;;;;;;;;1,0;;;;;;;;;;;;;1,0;;;;;;;;;;;;5,0;;;1,0;;;;;;;;;;;;;;;;;;;3,0;;;;;;;;;;;;;;;;;1,0;1,0;;;;;;;;;;;;;;;1,0;;1,0;;;;;;;;;
assist;;;;2,0;10,0;;;1,0;;;;;;;1,0;;;;1,0;;3,0;9,0;;1,0;;;;3,0;;2,0;1,0;4,0;4,0;;141,0;;;;;4,0;;;;;;;;;2,0;26,0;7,0;4,0;;;;122,0;3,0;;;1,0;;;21,0;;;;15,0;;;;9,0;;32,0;;;;;;3,0;;;33,0;;;;;1,0;;1,0;1,0;14,0;;1,0;79,0;;;;;2,0;;1,0;8,0;;3,0;;;;22,0;;;;20,0;;;1,0;;2,0;;;1,0;;;;;;;;;;3,0;;;;;;;;;;;;;;1,0;;1,0;5,0;;;;;;;;1,0;;;;;;;1,0;;;;;7,0;2,0;;;2,0;2,0;;;;;;31,0;;;;1,0;;;;;;1,0;;;;;;4,0;;1,0;;2,0;;;;;;3,0;;;;;;;;;;;;;;;;;;1,0;;;;;;;;;;;;;;;;;2,0;;;;;;;;2,0;;;;;;;3,0;;;;;;;;1,0;;;;;1,0;;;;;;;;;;;;1,0;;;;;3,0;;;;;;;;;;;;;;;;;;;1,0;;;;;3,0;;;;;;;1,0;1,0;;;;5,0;;;;;;;;;;;8,0;;1,0;;;;;;;;;;;;;;;2,0;;;1,0;;;;;;7,0;;;;;;;1,0;;1,0;;;;;;;;;;;;;;;;;;1,0;;;;;;3,0;;;;;;;;3,0;1,0;;;;;;;;;;;1,0;2,0;;;;;1,0;;;5,0;;1,0;;;3,0;1,0;;;2,0;1,0;1,0;3,0;;;;;;;;;;;;;;;;1,0;12,0;;;;;;5,0;;;;;;;;;;2,0;;3,0;;;;;;;;;;;1,0;;;;;1,0;;;;;6,0;5,0;;6,0;;;;;7,0;;;;;;;;;14,0;6,0;;;;;;;;;;;;;;;;;;1,0;;;;;;;;;;;1,0;;6,0;1,0;;;;;3,0;;;;;;;;;;1,0;;;;;;;;1,0;3,0;2,0;;;;;;;;;;;;;;;3,0;;;;;;;;;;;;;;;;;2,0;;;;;;;;;1,0;;;;;;;;;;;;;;;;;;;;;;;;;1,0;;;;;;;;;26,0;;;;;;;;;;;;;;5,0;8,0;;;;;;;;;;;;;;;;;;;;;;;;;;;;;;;;7,0;;;;;;;;;;;;;;;;;;;;;;;;;;2,0;;2,0;;;;1,0;3,0;;;;;;;;;2,0;;;;;;;1,0;;;;;;;;;2,0;;;;5,0;;;;;;;;;1,0;;;;;;;2,0;;;;32,0;;;;;;;;;;;;;;;;;;1,0;;;;;;;;;;2,0;;;;1,0;;;;2,0;;;;;;;;;;;;;;;;;;;;;;;;;;;;;;;;;;;;;;;;3,0;;;;;;;;1,0;;;2,0;;;;;;1,0;;;;;;;;;;;;;;;;;;;;;;;;;;;5,0;;;;;;;;;;3,0;;;;14,0;;;2,0;2,0;;;;;;;;;;;;;;;;;;;;;;;;;;;;;;;;;;;;;;;;;;;;;;;;;;;;;;;;;;;;;;;;;;;;;;;;;;2,0;;;;;;;;;;;;;16,0;;;;;;;;;
calibration;;;;1,0;36,0;;9,0;65,0;44,0;33,0;6,0;8,0;;3,0;13,0;9,0;4,0;1,0;14,0;10,0;;7,0;73,0;20,0;17,0;;;168,0;1,0;4,0;8,0;38,0;111,0;5,0;22,0;12,0;;5,0;;7,0;4,0;6,0;;1,0;6,0;;;4,0;;7,0;7,0;46,0;;10,0;6,0;264,0;95,0;1,0;6,0;14,0;2,0;1,0;206,0;2,0;16,0;2,0;2,0;;3,0;7,0;21,0;;1,0;;;;;77,0;144,0;;;7,0;41,0;2,0;;;4,0;6,0;5,0;20,0;62,0;;;41,0;7,0;9,0;;2,0;39,0;3,0;17,0;194,0;;;2,0;;;26,0;;;1,0;11,0;3,0;1,0;;4,0;1,0;;6,0;2,0;;;1,0;2,0;;1,0;33,0;;3,0;7,0;;2,0;;;24,0;3,0;24,0;;;;6,0;2,0;7,0;;8,0;;11,0;20,0;23,0;;;;;;2,0;;;1,0;;16,0;3,0;;;;2,0;;2,0;13,0;;2,0;8,0;1,0;55,0;3,0;3,0;;;5,0;;;;1,0;;;;65,0;1,0;33,0;;26,0;;;5,0;31,0;;2,0;;;2,0;;;4,0;1,0;1,0;;2,0;;;4,0;;24,0;3,0;;1,0;10,0;5,0;4,0;52,0;;;;23,0;;4,0;;4,0;3,0;;;;;;6,0;;2,0;7,0;;5,0;6,0;;1,0;;;;;;1,0;;;;;;;4,0;;4,0;;37,0;;;1,0;;2,0;;;;2,0;;;1,0;;6,0;;;1,0;1,0;;;;9,0;;;13,0;;;;3,0;167,0;9,0;;1,0;;4,0;102,0;;;;2,0;16,0;;;;52,0;20,0;3,0;;;25,0;;;31,0;6,0;;;;;;;;;;1,0;;;;20,0;;;;3,0;8,0;;;;;13,0;9,0;;;2,0;;8,0;1,0;2,0;;;1,0;2,0;10,0;;3,0;;20,0;3,0;;;9,0;;;;10,0;;;;15,0;3,0;;;2,0;4,0;;;;30,0;6,0;24,0;8,0;11,0;;9,0;;2,0;15,0;5,0;2,0;;;;4,0;3,0;;4,0;;;;;;197,0;8,0;;10,0;1,0;5,0;;7,0;1,0;1,0;5,0;;;7,0;5,0;;9,0;;;70,0;;5,0;22,0;29,0;2,0;;1,0;1,0;;1,0;7,0;;8,0;;19,0;;;;;;2,0;;;;;;1,0;5,0;;;1,0;2,0;;;2,0;5,0;;;;1,0;;5,0;;;;;;1,0;2,0;10,0;1,0;89,0;;;40,0;;;;1,0;5,0;;;;;;;;4,0;1,0;3,0;;;1,0;;2,0;;3,0;69,0;9,0;;1,0;2,0;2,0;;;;7,0;3,0;;;;;;;;;2,0;;2,0;;;;;;;1,0;;;;3,0;1,0;;;;4,0;;;;;;;;;;4,0;25,0;9,0;;;;;;;8,0;1,0;;;;;2,0;;;;25,0;;;;;3,0;13,0;;;;;;;;;;;1,0;;7,0;2,0;;;5,0;3,0;;;;;1,0;;;;;;;;;9,0;;;;4,0;;;;;3,0;;;;1,0;;;;;1,0;;;1,0;;;1,0;;;;;;3,0;;;;;3,0;8,0;;17,0;;;;;;;;;;;;12,0;;11,0;;;;;;;;1,0;;16,0;;;;1,0;4,0;;;;7,0;;;;;;20,0;;;;;;;3,0;4,0;;;;1,0;;;;;;;6,0;;1,0;3,0;5,0;;;;;2,0;;;;;1,0;45,0;;;;4,0;;;;;;;;4,0;;;;;2,0;;;;17,0;;3,0;16,0;;1,0;;8,0;1,0;;1,0;;1,0;7,0;1,0;;10,0;3,0;;;;;;18,0;2,0;14,0;12,0;;1,0;13,0;1,0;2,0;61,0;10,0;2,0;;;1,0;6,0;;;;2,0;;1,0;;;1,0;4,0;4,0;;2,0;;3,0;4,0;68,0;;2,0;;;;;;;;;1,0;;;1,0;;1,0;;;;;;5,0;3,0;;;;1,0;;;;;;;;;;;;;;6,0;;7,0;11,0;1,0;1,0;5,0;;7,0;;;;;;;;;6,0;;;;;;;;7,0;;1,0;;;8,0;;;2,0;;;;;;;;;;;2,0;;;;;;;;;;;;;;;;;;87,0;;;;;;7,0;;;;;;;;;1,0;;;;;1,0;1,0;1,0;;10,0;;;;4,0;;;;;;1,0;;1,0;;;3,0;1,0;;;2,0;;4,0;;1,0;13,0;;;;;;8,0;31,0;;;;;;;;;;1,0;2,0;1,0;1,0;;;8,0;4,0;;1,0;;;;;;2,0;2,0;5,0;;5,0;;;;3,0;;21,0;;;;;;;1,0;;;;;;;;;;;;1,0;;
characterize;;;;1,0;2,0;;9,0;21,0;;1,0;;2,0;;1,0;3,0;;3,0;;3,0;2,0;;59,0;9,0;6,0;;;;40,0;1,0;46,0;11,0;16,0;62,0;2,0;6,0;;1,0;6,0;;11,0;11,0;;5,0;37,0;;5,0;;6,0;8,0;;;1,0;1,0;1,0;;103,0;36,0;;6,0;5,0;;;90,0;;2,0;5,0;1,0;;;3,0;16,0;;;;;;;68,0;28,0;1,0;1,0;7,0;2,0;;;1,0;3,0;;18,0;3,0;28,0;;9,0;18,0;2,0;;;2,0;10,0;;20,0;32,0;;;;;;17,0;;;14,0;2,0;1,0;1,0;2,0;;;4,0;8,0;1,0;19,0;4,0;;6,0;;1,0;1,0;;;;3,0;;;;;7,0;1,0;;;;;;;54,0;1,0;2,0;12,0;2,0;;;3,0;;;;1,0;2,0;;4,0;;4,0;;2,0;;;14,0;2,0;4,0;11,0;;3,0;4,0;4,0;26,0;;2,0;1,0;;4,0;;;;1,0;;;1,0;9,0;;16,0;;57,0;;;7,0;2,0;;1,0;;;1,0;;;;;;;2,0;1,0;;3,0;1,0;;;;;;21,0;1,0;1,0;;;1,0;;1,0;;;3,0;;;;;;;;;1,0;;;1,0;30,0;;5,0;;;;;1,0;;1,0;;7,0;4,0;;;1,0;;;;;;;;;;;;;;;;;;1,0;;1,0;;;;;;;1,0;6,0;;;;19,0;;22,0;7,0;;;;;;;;;2,0;;;;;2,0;;;;;;;;20,0;4,0;;;1,0;;;;;1,0;;;;;;;;6,0;;;;;;;;;;2,0;;;;1,0;;1,0;;;4,0;;;1,0;1,0;;;2,0;;;;;;;1,0;4,0;;;2,0;;;;;3,0;;;;14,0;4,0;4,0;;2,0;;;;1,0;13,0;15,0;2,0;2,0;;1,0;;9,0;1,0;1,0;;;1,0;;4,0;17,0;2,0;1,0;;;;1,0;;;;7,0;;;;2,0;;;;;10,0;;1,0;2,0;9,0;1,0;;7,0;4,0;;;;1,0;;;;;;;;;;;;2,0;;;;;5,0;;;2,0;;;1,0;4,0;;;2,0;2,0;;;;;;;;;1,0;;;18,0;;;2,0;;;;;;;3,0;17,0;1,0;;;;;1,0;2,0;;;5,0;;;10,0;1,0;4,0;5,0;;3,0;;2,0;;;;;;;;;2,0;2,0;;;;15,0;;;;;;;;;1,0;;;;;;;;2,0;;1,0;2,0;;;;1,0;;;;;;;;;1,0;;;;;;;;;;1,0;;;17,0;10,0;;;;;17,0;1,0;;;;;2,0;;;;;;;;;1,0;;1,0;;;2,0;;;;;;;;1,0;;2,0;;;;;4,0;1,0;14,0;;;;;;;;;2,0;;;;;;;;;1,0;;;;;;;;4,0;;;;;5,0;;;1,0;2,0;;;;;;;;;1,0;2,0;;;18,0;1,0;;;;;;;;;;;;;;;;;;;;;1,0;;;;;2,0;;;;;1,0;9,0;10,0;;;;2,0;;;7,0;;4,0;;;;;3,0;5,0;1,0;;;;;;;;;6,0;;1,0;;;;;2,0;;;;;;;;;;;;;;;3,0;6,0;1,0;;;;3,0;;;;;;;;1,0;;1,0;;;;;1,0;;;;10,0;;;13,0;;;2,0;;;;1,0;;;;2,0;;;;;18,0;;;;;;;;;;;;;;;;;;;;;;;;;;;;;;;;;;;;;;;;;;;;;;;;;;;;;1,0;;;;;;;;;;;;1,0;;2,0;1,0;2,0;6,0;;;;1,0;;1,0;2,0;;;;;;;;2,0;5,0;1,0;;;;;;;;3,0;;;;1,0;;;;;2,0;;;;;;;;;9,0;;;;;;;;;;;;;;;;3,0;;;;6,0;;4,0;;2,0;;1,0;;2,0;;;;;;;;;;;;;;;;;1,0;;;;;;;;;;1,0;;;;;;;;1,0;;;;;;;;;;;;;;;;4,0;1,0;;;;;;;;;;;;;;;;;;;;;;;;;;;;;;;
classify;;;;3,0;7,0;;;10,0;2,0;4,0;;;;;3,0;;;;;1,0;4,0;2,0;;1,0;;;;4,0;;3,0;3,0;4,0;1,0;;14,0;1,0;;3,0;;;1,0;;;1,0;;;;;;2,0;4,0;5,0;2,0;4,0;;107,0;10,0;;;;;;37,0;;2,0;;1,0;;;3,0;1,0;;2,0;;;3,0;;2,0;5,0;;;5,0;2,0;;;;25,0;;;1,0;;1,0;;2,0;8,0;;;;7,0;;1,0;1,0;;;;;23,0;19,0;;;2,0;3,0;;;;;;;;;;;;;;;;;;;;3,0;;;;;;;;;;;;23,0;;;2,0;2,0;;;;;;;;;;;1,0;4,0;;2,0;;;;;4,0;1,0;;;;;4,0;1,0;1,0;;;;;;;;;;;;;33,0;;;;;;1,0;;;;;;;;;;;;;;1,0;;2,0;;;;;;3,0;1,0;;;;;1,0;;;;;1,0;;;;;;;;;;;2,0;9,0;;;;2,0;;;;;;;;;;;4,0;;;;;;;;;6,0;;;;;;;;;;;;;;2,0;;;;;;;;;1,0;;3,0;;;;;;;;;;7,0;;;;;;;;;;4,0;;;;4,0;;;;;;;;;;;;;;;;;;;2,0;;;;;;;;;;;4,0;;5,0;;;;2,0;;1,0;;;3,0;;;;1,0;;;;;;;;7,0;;;;5,0;;;;;;1,0;;1,0;;;;9,0;;;;;;;8,0;;10,0;;2,0;;;;;;42,0;4,0;;4,0;;;;3,0;;;;;;;;;;;;2,0;;3,0;;1,0;;;;2,0;;;2,0;;22,0;;;;;;;;1,0;;;;;;;;1,0;;;;;;;;;;;1,0;;2,0;;;;;;;;;;6,0;;;7,0;;;;;;;;5,0;3,0;;;;;;;;;;;;;;3,0;2,0;;;;;;;;;;;;;;;;;;;;;;1,0;2,0;;;;;;;;1,0;;;;;;;;4,0;;;1,0;;;;;;;;;;1,0;;;;;;;;;;;;1,0;5,0;;;;;;;;;1,0;;;2,0;;;;;;;;;;8,0;;;;;;;;;;;;7,0;;;;;;;;;;;;;;;;;;;;;;;;;3,0;;;;;;;;;;;;;;;;;;;;;;;;;;;;;;;4,0;;3,0;;;;;;;;;;;;;;;;;;;;;;;;;;;;;;;1,0;;;;1,0;;;;;1,0;;;;;;1,0;;;;;;;;;;;;;;;;;;;;;;;;;;;;;;;;;;1,0;;;;;;;;;;;;;;;;;;;;;;;;;;;;;;;;7,0;;;;;;;;;;;1,0;;;;;;;;6,0;;;;1,0;;;;;;;;;;;;;;1,0;;;;;;;;;;2,0;;;;;;;;;;;;;;;;;;;;;;;;;;;;;;;;;;;;;1,0;;;;;;2,0;;;;;;;;;;;;;;;;;;;;;;;;;;;;;;;;;;;;;;;3,0;;;;1,0;;;;;;;;;;;;;;;;;;;;;;;;;;;;;4,0;;;;;;;2,0;;;;;;;;;;;2,0;;1,0;;;;;;;;;;;;;;;;;;;;;;;;;;;;;;;;;;;10,0;;;;;;;;;6,0;;;;;;;;;
combine;;;;4,0;31,0;;;32,0;5,0;46,0;8,0;5,0;;7,0;35,0;26,0;6,0;;27,0;4,0;5,0;24,0;2,0;7,0;15,0;;;108,0;2,0;2,0;8,0;5,0;69,0;;34,0;;4,0;15,0;;62,0;6,0;7,0;;14,0;6,0;2,0;;24,0;8,0;6,0;5,0;98,0;;1,0;;561,0;27,0;;24,0;66,0;;;63,0;1,0;;;3,0;;1,0;1,0;26,0;3,0;2,0;;;;;6,0;33,0;2,0;;43,0;12,0;9,0;;;9,0;;11,0;20,0;32,0;9,0;1,0;121,0;1,0;1,0;;6,0;12,0;4,0;27,0;36,0;;;;;1,0;64,0;;;7,0;7,0;9,0;7,0;;;;1,0;3,0;3,0;;;1,0;35,0;2,0;1,0;29,0;;1,0;3,0;3,0;18,0;;1,0;2,0;3,0;10,0;;;2,0;;;1,0;2,0;25,0;2,0;38,0;103,0;;3,0;3,0;1,0;4,0;;1,0;;3,0;13,0;11,0;14,0;;1,0;1,0;;;;5,0;24,0;;;9,0;;20,0;4,0;11,0;3,0;1,0;69,0;;;;4,0;4,0;3,0;1,0;13,0;3,0;86,0;;22,0;;4,0;;8,0;;7,0;;;2,0;;;4,0;2,0;11,0;;;;;;2,0;;1,0;;;;25,0;1,0;8,0;;;1,0;3,0;;8,0;1,0;2,0;;;;;;;2,0;12,0;8,0;2,0;;3,0;9,0;1,0;7,0;;16,0;;;;9,0;2,0;2,0;;1,0;2,0;;7,0;7,0;2,0;4,0;2,0;2,0;;;7,0;13,0;;2,0;;1,0;2,0;;;;2,0;;;1,0;3,0;;;2,0;;;;2,0;1,0;;5,0;1,0;29,0;4,0;;;;5,0;;;1,0;4,0;11,0;1,0;;2,0;;10,0;2,0;;;;12,0;1,0;;7,0;7,0;;;;;;;7,0;;;;;;;8,0;;;3,0;;6,0;;;;1,0;;3,0;1,0;6,0;1,0;4,0;3,0;;1,0;8,0;;;4,0;;3,0;2,0;;4,0;;;;;;;;5,0;2,0;;;;1,0;;;3,0;;;;;4,0;;7,0;6,0;4,0;;3,0;6,0;1,0;;7,0;;5,0;;10,0;;6,0;;3,0;;;2,0;;2,0;3,0;;2,0;10,0;;;3,0;5,0;1,0;3,0;3,0;;;6,0;1,0;1,0;;1,0;30,0;1,0;;13,0;13,0;2,0;7,0;;2,0;4,0;;;7,0;10,0;18,0;2,0;1,0;;;;6,0;5,0;;1,0;;;;;8,0;;6,0;2,0;1,0;;;;5,0;36,0;4,0;;5,0;2,0;;2,0;;;;3,0;;;;1,0;2,0;19,0;;;14,0;;;1,0;1,0;3,0;;1,0;;13,0;7,0;;1,0;;1,0;9,0;4,0;;;2,0;9,0;;;48,0;14,0;1,0;;;;;4,0;4,0;7,0;;;;;1,0;;;10,0;;3,0;4,0;3,0;3,0;;;;;;4,0;;1,0;;;;1,0;;;1,0;;;1,0;2,0;;1,0;1,0;;;5,0;;;;;;;;1,0;1,0;;;6,0;;;3,0;3,0;;1,0;74,0;;5,0;;;2,0;4,0;;;10,0;;1,0;;;;;6,0;3,0;;;3,0;43,0;24,0;3,0;1,0;1,0;2,0;;2,0;25,0;;;;;6,0;1,0;;;;;;;14,0;4,0;;;5,0;5,0;;;;2,0;;;;;;;;;1,0;;;8,0;;;;;6,0;;;3,0;;2,0;;;17,0;;;;;;;;;5,0;4,0;4,0;;;17,0;1,0;1,0;1,0;;4,0;;;;;2,0;;;;;;;;;;;;2,0;;;;2,0;6,0;;;;;8,0;3,0;9,0;;;;;;;;;;3,0;;;;7,0;;3,0;;;;29,0;;6,0;1,0;;13,0;1,0;;;2,0;;1,0;;;;;;;;6,0;;;;;;;;1,0;;;;4,0;;;;;;;2,0;;;;4,0;12,0;7,0;10,0;15,0;;3,0;12,0;3,0;;;;5,0;2,0;;2,0;;;2,0;1,0;;;;;13,0;;3,0;;;;;;;1,0;;9,0;1,0;;;1,0;;;;;;;13,0;;;;1,0;;;;;;;;;5,0;;5,0;7,0;;;;;;;;3,0;;;;2,0;;;;;1,0;;;2,0;;3,0;4,0;9,0;;;;;;;;;3,0;;;5,0;4,0;;;1,0;3,0;;;4,0;7,0;1,0;1,0;;;;;2,0;11,0;;;1,0;2,0;;;;;;;5,0;;;2,0;;;3,0;;;;;;5,0;;;;6,0;1,0;;;;;15,0;2,0;;;;;;4,0;;;;;;6,0;;;2,0;;;;1,0;;;;;;;;;1,0;;;3,0;;;;;6,0;;4,0;;1,0;;;;;;1,0;2,0;;;;;6,0;;;;;;1,0;;;;;;;;;;;;;;;;;;;;;;;;;4,0;;;;;;;;;;;1,0;;;;3,0;;1,0;;;;
communications;;;;1,0;9,0;;;8,0;;14,0;;2,0;;;;1,0;1,0;;1,0;2,0;;11,0;;;;;;53,0;;3,0;1,0;1,0;79,0;;20,0;;4,0;;;12,0;;;;15,0;;;;2,0;;14,0;2,0;1,0;;1,0;;41,0;24,0;;1,0;;;;36,0;;;;;;;6,0;;;;;;;;;1,0;1,0;;3,0;10,0;;;;;;;28,0;4,0;;2,0;13,0;;;;;3,0;;1,0;14,0;;7,0;;;49,0;35,0;;;;4,0;;3,0;;1,0;;;;9,0;;;;4,0;;;32,0;23,0;;9,0;;;;;;;2,0;;;;;;3,0;;;;2,0;3,0;;;;;1,0;;1,0;;;6,0;2,0;8,0;;;;;;;;;;;;;13,0;;1,0;;1,0;2,0;;;;;;;;;;26,0;;6,0;;;;20,0;;;;;;;;;;1,0;6,0;3,0;;;;5,0;;;;;;1,0;31,0;;;;;1,0;;;1,0;;;;;;;;;;;;;3,0;4,0;;;;;;2,0;;8,0;;;;;;;11,0;;;2,0;2,0;3,0;;;;;;1,0;;;;;;;;;;;141,0;;;1,0;2,0;1,0;;;;;4,0;;;;;;;;;;;;;;;24,0;;;;;;;1,0;;;;12,0;;;;;;;;;;;;;;1,0;;;8,0;;19,0;1,0;;;1,0;;;;;;;;1,0;;;1,0;;;;2,0;;;1,0;;;;;;;;;;;;16,0;;;;1,0;;;;;;3,0;10,0;;;;;;;1,0;1,0;;;;;;;;;;;;;;1,0;;;;;3,0;;;1,0;;;;1,0;;4,0;;1,0;;;;;1,0;;1,0;1,0;;15,0;3,0;4,0;;;;1,0;1,0;;3,0;;;;;;;1,0;;;;5,0;5,0;6,0;;;;3,0;;4,0;6,0;;;;;;1,0;4,0;;3,0;;;;4,0;;;;;;3,0;;;7,0;;2,0;2,0;;;;;;7,0;;1,0;2,0;;;5,0;;;;;14,0;;;;;;1,0;;1,0;;;;;;;;;;34,0;;6,0;2,0;;;;;;1,0;;;;;;1,0;;;1,0;;;;12,0;;;;;;;;1,0;;;;8,0;;;;;2,0;;;42,0;;1,0;4,0;;;;;;;;;;;;3,0;;1,0;12,0;8,0;;;;;;3,0;;3,0;11,0;;;24,0;;;;;51,0;;;;1,0;;;;;;;;;;;2,0;;;;;;;;;3,0;;3,0;;;;;;;;;;;;9,0;;;3,0;;;;;;;;;;;;;;10,0;;;;;;;;;;;;;;;;;4,0;;;;;;;;;;;;;;;;;;;;;;;;;;;;;;;;;;;;;;;;;;;;;;;;;;;;;;;;;;;;;;;;2,0;;;;1,0;8,0;;;;;;;2,0;;;;1,0;;;;;;;;;;;;;;;;;;;5,0;;;;;;;;;;;2,0;;;;;1,0;;;;;;;;;;;;;;;;;20,0;;;;;;;;;;;;;;;15,0;;;;;;;;;;;;;1,0;;;;;;;;;;;;;;;;2,0;;;;;1,0;2,0;3,0;;;;;;;;;;;;;;;3,0;;;;;;;;;;1,0;;;;;;;;;;;;;;;;;;;;;;;;;;2,0;;13,0;;;;;;;;;1,0;;;;;;;;;;;;;;;;;;;;;;;;;;;;;;;;;;;1,0;;;;;;;1,0;;1,0;;;;;;;;;;;;;;;;;;;;;;;;;;;;;;;;;;;;;;;;;;;;;;;;
decode;;;;3,0;30,0;;;17,0;;6,0;;;;;6,0;;;;2,0;8,0;14,0;25,0;1,0;22,0;;;;157,0;1,0;3,0;1,0;28,0;15,0;;6,0;6,0;2,0;1,0;;14,0;2,0;;;;2,0;;;;13,0;3,0;1,0;26,0;;5,0;;181,0;18,0;3,0;16,0;;;;83,0;;;;;;2,0;39,0;;16,0;2,0;;;;;2,0;2,0;;14,0;5,0;4,0;3,0;;;3,0;;;33,0;9,0;;;14,0;1,0;;;18,0;28,0;;6,0;5,0;;2,0;;;1,0;81,0;;;;2,0;8,0;;;;;;;;;;;21,0;;3,0;26,0;2,0;;;;2,0;;;;;;;;;;;;;;;1,0;1,0;3,0;;1,0;;3,0;;;;;;;;;;;;;13,0;;27,0;1,0;;;;2,0;;15,0;;;8,0;;;;;13,0;;;;;6,0;;8,0;;;;4,0;;;;;3,0;;;;;4,0;;;;;1,0;;;1,0;;;2,0;12,0;2,0;;;;1,0;;;;;;;;;;1,0;;;;;;;;;;5,0;;9,0;;;;;;;;1,0;;;5,0;;;;3,0;;;1,0;;;;;;;;;;;;;;;3,0;42,0;;4,0;1,0;;;;;;;;;;;;;;3,0;;;;1,0;;;2,0;;10,0;;;;;1,0;;;5,0;12,0;;;;;;;;;;;;;;;;;13,0;1,0;4,0;;;;;3,0;;;1,0;;;3,0;;5,0;;;;;;1,0;;22,0;2,0;;;;;;;;;;;;3,0;1,0;;;1,0;3,0;;;;;18,0;9,0;1,0;;;3,0;;;;11,0;;;;;7,0;8,0;;6,0;;;;;39,0;4,0;1,0;;;;;;;;;;;;;;;5,0;10,0;;;;24,0;;3,0;2,0;3,0;8,0;4,0;1,0;1,0;2,0;;;8,0;2,0;;;;;;1,0;1,0;;;5,0;5,0;;3,0;7,0;;3,0;;;;11,0;;;;7,0;;;7,0;;;;;;;1,0;;;10,0;;;9,0;;;;;;;3,0;;5,0;;;1,0;;;1,0;;;;4,0;6,0;;;34,0;;;;;;;2,0;1,0;1,0;;;;;;;;;2,0;128,0;1,0;;;;3,0;;;;;;;;;;;;;;;;;;;;;4,0;;1,0;1,0;;;;;4,0;;;;3,0;;;1,0;;;;;64,0;3,0;;;;;;;3,0;;3,0;;;;;;;;2,0;;;;29,0;1,0;12,0;;1,0;;1,0;;1,0;1,0;;;;;;;;;;;;;;;;;;;;;;;;;;;;;;;;;;;;;;;;;;;;;;;;;;;;;;;;;;;;2,0;;;;;;;;;1,0;1,0;;;;;;;;;;;;;;;;;;;;;;1,0;;;;;;;;;;;;;;;;1,0;;2,0;;;;;;;;;9,0;;;;15,0;;1,0;;;;;;;;;;;4,0;3,0;;;;1,0;3,0;;;;;;;;;;;;;;;;;;;;;3,0;;;;13,0;;;;;;;;;;;;;;;1,0;;;;;;;;;;;;;;;;;;;;;;;;;;;;;;;;;;;;14,0;;;;;37,0;;;;;;;;;;;;;;;;;;2,0;;;;;;;;;;;;;;;;;;;;;;;;;1,0;;;;;4,0;;;;;;;1,0;;;;1,0;;;;;;;;;;;;;;;;;;;;;;;;;;;;41,0;;;;;;;;;;;;;;;;;;;;;;;;;7,0;;;;;;13,0;;;1,0;1,0;;;;;;;;;;;;;;1,0;;;;;;;4,0;;;;;;;;;;;;;;;;;15,0;;;;;;;;;;;;;;;;2,0;;;;;;;;;;
defect;;;;2,0;32,0;;;9,0;10,0;5,0;;;;;;;12,0;19,0;;1,0;;1,0;;27,0;7,0;;;21,0;;96,0;22,0;9,0;6,0;;7,0;;;5,0;;;1,0;;1,0;;;1,0;;;;;;6,0;;;;62,0;7,0;;;;;;41,0;;;;;;;;11,0;3,0;1,0;;;;;;36,0;;;5,0;2,0;;;;54,0;;;4,0;10,0;;;17,0;6,0;;;1,0;14,0;;4,0;21,0;;1,0;;1,0;;5,0;;;;;4,0;;;;;;;;;;1,0;;4,0;;3,0;;;;;11,0;1,0;;;3,0;10,0;;;;;;;;;;5,0;;;2,0;;;;;;;;;;6,0;;;;;;;;5,0;;;;;12,0;;;;;14,0;;;;1,0;;;;;;2,0;;;;;;3,0;;2,0;;;;;;3,0;1,0;2,0;;;5,0;;;1,0;16,0;;;1,0;;;6,0;;;;;;;;;3,0;;;;;7,0;;;;;1,0;;9,0;;;;;;;;;;;;;;;;;;;;1,0;;8,0;3,0;4,0;;;;;2,0;;;;;;;;;;;;;;;;;;;;;;;;;;;;;;;2,0;;;1,0;;10,0;;;;;;;;15,0;;;;;;;;;;;;;;;;;;;;3,0;;;;;;;;;;;;;5,0;;;;;;2,0;;;;;;;;;;;;;;;;;;1,0;;;;;;;;20,0;;7,0;;;;;1,0;4,0;2,0;;;1,0;;4,0;;;;;;;;;;;;;;;;;;;;;;;;4,0;;;;;2,0;;;;;;3,0;;3,0;2,0;;;;;;;;;;;;;;;;;1,0;1,0;;;1,0;;;;2,0;13,0;;;5,0;;;5,0;;;;;;;;;;;;5,0;;;;;;;;2,0;;;;;;1,0;;;;6,0;;;;;;;;2,0;;;;;;2,0;;;;;;;;;;;3,0;;;5,0;;;;;4,0;;;;;;;;;;;;;;;;;;;4,0;;;;;;4,0;;;;3,0;1,0;;;;;;;;124,0;;;;;;;;;;;;21,0;;;;;;;4,0;;;;;;;;;;5,0;;;;;;1,0;;;1,0;;;;;;;;;;;;;;;;;;;;;;;;1,0;;;;;;;;;;;;1,0;;;;;;;2,0;;4,0;;;;;;;1,0;;;;;;;;;;;;;;;1,0;;;;;;;;;3,0;;95,0;;;;;;2,0;;;;;;;;;;;;;;;;;;;;;;;;;;;14,0;;;1,0;;;;;;;;;1,0;;;;;;;;;;;12,0;;;;;;;;;;;;;3,0;;4,0;;;;;;;;;;;;;;;1,0;1,0;6,0;;;;;;9,0;;;;;;20,0;;;;;;;;;;;;;;;;;;1,0;;;;;;;;;;;;;;;;;;;;;;;;;;;;6,0;;;;;;1,0;;;1,0;;;;;;;;;;;;;;;;;;;;;;;;;;;;;;;;;;;;;;;1,0;;2,0;;;;;;2,0;;;;;;;;;;;;;;;;;;;;;;;;;;;;;;;;;;;;;;;;;;;;;;;;;;;;;;;;;;;;;;;;;;;;;;;;;;;2,0;;;5,0;;;;;;;;;;;;;;;9,0;;;;;;;;;;;;;;;;;;;;;;;;;;;;
evaluate;;;;3,0;9,0;;;14,0;8,0;16,0;;14,0;;;;;;;1,0;6,0;5,0;14,0;;4,0;;;;28,0;3,0;6,0;3,0;22,0;10,0;6,0;8,0;;;1,0;;4,0;9,0;;;1,0;;36,0;1,0;;18,0;9,0;4,0;;;5,0;;82,0;9,0;;;4,0;;;30,0;;;;1,0;;;2,0;14,0;7,0;;;;;;18,0;13,0;;;15,0;8,0;1,0;1,0;;9,0;3,0;;7,0;4,0;;;17,0;1,0;;;;1,0;;12,0;8,0;;;;1,0;2,0;63,0;;;3,0;;;1,0;;;;;;;;;2,0;1,0;;;13,0;;;;;1,0;;;;1,0;2,0;;;1,0;;;;1,0;;;1,0;6,0;;;;;;;1,0;;;1,0;2,0;1,0;;1,0;;;1,0;;2,0;20,0;;;;;7,0;;;2,0;;8,0;;;;;;;;;;20,0;;;;;;5,0;;;;;1,0;;;;;;;1,0;;;2,0;;3,0;;;;;7,0;;;;;2,0;4,0;;;;;12,0;;;;;;;;5,0;;;;1,0;1,0;;;2,0;;;;;;;;;42,0;;1,0;;;;;;;;;;;;;;;;2,0;;;;;;;;;2,0;2,0;;;;;;4,0;3,0;34,0;;;;;1,0;1,0;;;;3,0;;;;;4,0;;;;;7,0;;;3,0;12,0;;;;;;;;;;;;;;1,0;;;;;;;;3,0;;;;;;;;;;11,0;;3,0;;2,0;;2,0;4,0;;1,0;;;;;1,0;;;3,0;;;;9,0;1,0;;;;;;;;2,0;;;;;;;2,0;;1,0;1,0;;;1,0;1,0;;1,0;;2,0;;;2,0;;;10,0;4,0;;2,0;;4,0;10,0;;;;1,0;;;;2,0;;2,0;;;1,0;3,0;3,0;;1,0;1,0;;;;;3,0;;;6,0;2,0;;;;1,0;;;;;;;13,0;;5,0;2,0;2,0;;;4,0;;;;2,0;;;;;;;;;;;;;2,0;;;28,0;;;5,0;;;;;;;;1,0;;;;3,0;;;;;;5,0;;2,0;;;2,0;1,0;;;;;;;1,0;;;;;;;;;;;2,0;;;;;;;;;;;;;;;10,0;;;4,0;;;;;;;;;;9,0;;;;;1,0;;;;2,0;2,0;;;;;4,0;;;10,0;10,0;2,0;;;;;4,0;;3,0;;;1,0;;;;;;2,0;;;;;10,0;1,0;;1,0;;;;;1,0;;;2,0;;;;;2,0;;1,0;;1,0;;;;;;;1,0;;;;;;;;;;;;;;;;;;;;;;;;;;;2,0;;;;;;;;;;;;;;;;;;;;;;;;;;;;;;;;;;;;;;1,0;;;;;;;;1,0;3,0;;;;;;;;;;;2,0;;;2,0;3,0;;;;;;14,0;1,0;;;;1,0;;;;;1,0;;;;;;;;;;;;;;;1,0;;;6,0;;;;;;;;13,0;;;;;;;;;;;;;;;;;1,0;2,0;2,0;;;;4,0;3,0;;1,0;;;;;;;;;4,0;19,0;;;;;;;2,0;;;1,0;2,0;;;;;;;;;;;;;;1,0;;;;;;;2,0;;;;;;;;;;;;;;1,0;;;;;;3,0;;;;1,0;;;;;;;;3,0;;;;;1,0;;;;;;;1,0;;;;;;;;;;;;;;;;;;;;;;;;;;;;;;;;;;;;;;;;;;;;4,0;;;;;;;;;;;;;;;;;;;;;;;;;2,0;;1,0;;;;;1,0;;1,0;;;;;;;;;;;;;;;;2,0;2,0;;;;;;;;;;;;;;;;;;;;;;;;;;;;;;;;;;;;1,0;;;;;;;;;;;;;;;;
flow;;;;2,0;5,0;;;5,0;2,0;;1,0;20,0;;;2,0;;;;7,0;1,0;;18,0;;;;;;6,0;;14,0;6,0;7,0;12,0;2,0;2,0;;15,0;7,0;;;6,0;;4,0;7,0;;;;;;1,0;;14,0;;;;11,0;3,0;1,0;1,0;12,0;;;12,0;;23,0;;2,0;;;;22,0;;9,0;2,0;;;1,0;2,0;10,0;4,0;4,0;16,0;1,0;1,0;;;19,0;;;1,0;13,0;;;8,0;1,0;7,0;;1,0;3,0;;7,0;4,0;;2,0;;;;21,0;1,0;;12,0;1,0;;1,0;;;;;;;;;;27,0;;;1,0;1,0;;;1,0;;;;;;;;2,0;5,0;;;1,0;;3,0;3,0;14,0;2,0;;;;;;;3,0;2,0;2,0;9,0;;1,0;;1,0;;;;;;7,0;3,0;12,0;1,0;;4,0;;1,0;;6,0;;;;;;1,0;;;;2,0;1,0;;15,0;;;2,0;4,0;;1,0;;;;;;;;8,0;;;;;3,0;;;;26,0;;;8,0;1,0;;;3,0;;2,0;;;1,0;;;;;;;;1,0;5,0;;2,0;1,0;3,0;7,0;3,0;;;;;;3,0;31,0;;;13,0;9,0;;;;;3,0;;4,0;1,0;;;;;;;;3,0;;;;;;;;;;;;;1,0;;;;1,0;9,0;32,0;7,0;13,0;2,0;;;;;21,0;;;9,0;;;;;;3,0;;;;;;3,0;1,0;9,0;3,0;;;;;;;;3,0;;2,0;;;;1,0;;;10,0;;;1,0;;1,0;;7,0;;;;;;7,0;;;;;1,0;;5,0;3,0;2,0;;1,0;1,0;;;;;1,0;;;;1,0;;;;;;;1,0;;;;3,0;;2,0;;1,0;;1,0;6,0;;2,0;1,0;5,0;3,0;;1,0;;;;4,0;;;1,0;2,0;;;;;3,0;;;;9,0;;;;;;;5,0;11,0;;;;;;;;9,0;1,0;;1,0;;;;3,0;;3,0;;;;;;;;;;;;;;;;;9,0;2,0;;;2,0;;9,0;;;;;;;;;;;;;1,0;;;;;;12,0;;;;;;;2,0;;;;;;;;;2,0;;;;4,0;1,0;16,0;2,0;2,0;;12,0;1,0;;2,0;;3,0;;;;;;;;3,0;;;;;;;;;;;;;;;1,0;1,0;;;;;;;;;;;1,0;;6,0;;;;;;;;;;;3,0;;;;;;7,0;;3,0;;16,0;;;;;;;;;;;;;;;;;;;;;;1,0;2,0;;;;;;;;5,0;;;;5,0;;;;;;;;;;;;;;;1,0;;;;;;;;;;3,0;;1,0;;;;;;;;;;;;;;;;;2,0;;;2,0;;;;;;;;;1,0;;;;;;;;;;9,0;;;;1,0;;;;;;;;;;;;;1,0;;7,0;3,0;;;;1,0;;;;2,0;4,0;44,0;;;;2,0;;;;3,0;;;1,0;;;;2,0;;;1,0;;;;;;;4,0;8,0;;;3,0;;;;;;;;4,0;;;1,0;;;;;;;;;;;;;;;;;;;;;;;;;;;;;;;;;;;;;;;;2,0;;;;;;;;;;;;;;;;;;;;;;;4,0;;;;;;;;;;;;3,0;;;;;;;;;;;1,0;;;;;1,0;;;;;2,0;;;;2,0;;;;1,0;;;;;;;;;;;1,0;3,0;;;;;1,0;;;;2,0;9,0;16,0;;3,0;;;;;;;;;1,0;;;;;;;;;;;;;;;;1,0;;;;;;;;5,0;;2,0;;;;;;;;;;;;;;;;;;;;46,0;;;;;;;;;;;;;;;;;;;;;;;;;;;;;;;;;;1,0;;;;;;;;;;;;;;;;;;;;;;;;;;;;;;;;;;2,0;;;;;;;;1,0;;;;;;;;
grid;;;;4,0;1,0;;;4,0;1,0;8,0;4,0;;;;;;;;;;6,0;5,0;;;;;;1,0;4,0;4,0;;1,0;55,0;;1,0;1,0;;;;7,0;1,0;;;2,0;;;;;1,0;;1,0;1,0;;5,0;;18,0;19,0;;;1,0;;;13,0;;;;;;;2,0;1,0;;;;;;;2,0;2,0;;;;2,0;;;;3,0;;;1,0;4,0;;;;2,0;;;;2,0;;11,0;15,0;;;;;1,0;4,0;;;;10,0;111,0;;;;;;;;;;;3,0;;;8,0;;;1,0;;1,0;;;;;12,0;;1,0;3,0;;;;;;;8,0;;;;;;;6,0;;;;1,0;1,0;4,0;;1,0;;;;;;9,0;;;;;3,0;;;;;;;;;;;;;;;8,0;;2,0;;;1,0;6,0;;;;;;;;;;4,0;;;;;;;6,0;;;;;;;;;;;;;8,0;;;;;;;;;;3,0;1,0;1,0;;;4,0;;1,0;;12,0;2,0;;;;4,0;;;;;;11,0;;;;1,0;;;2,0;;;;;;1,0;;;;;;;;;1,0;;;;1,0;;;;;;4,0;;;;;;;;11,0;;3,0;;;;;;;1,0;;;;;;;;1,0;2,0;;;;;;;;;;2,0;;;;2,0;;;;;3,0;;;;;;;;;;;;;;;;;;;2,0;;;;;;;;;;;;;;;1,0;;;;3,0;;;;;1,0;;;3,0;1,0;;2,0;;;;;;;;1,0;;;;;;;;;;;2,0;;;;;;4,0;;;;;;;;;;;;;;4,0;;2,0;;;;;;;;;;;;;;;;;;;;;;;;;1,0;3,0;;;;;;;;;;;;;;;;;;;;;;1,0;;;;;;;;;;;;;;;;;;;2,0;2,0;;;;;;;;;;;;;;2,0;;4,0;;;;;;;;;9,0;;;;;;;;;;;;;;;;;;;;;;;;;;;;;;;;;;;;;;;;;;;;;;;6,0;;;;;;7,0;;;;;;;;;;;;;;;;;;;;;;;;;;;;;;;;6,0;;;;;;1,0;;;;;;;2,0;;;;;;;;;;;;;;;;;;;;;;;;11,0;1,0;;;;;;;;;4,0;5,0;;;;1,0;;;;;;;;;3,0;2,0;;;;;1,0;;;;;;;;;;;;;;;;;1,0;;1,0;;;;;;;;;;;;;;;;2,0;;;;;;;;;;;;;1,0;;;1,0;;;;;;;;;;1,0;;;;;;;;;;;;;;4,0;;;;;;;;;;;;;;;;;;;;;;3,0;;;;;;;;;;;;;;;;;;;;;;;;;;;;;;;;;;;;;;;;;;;;;;;;;;;1,0;;;;;;;;;2,0;;;;;;3,0;;;2,0;;;;;;;;;;;;;;;;;;;;;;;;;;;;;;;;;;;;;;;;;;;;;7,0;;;;;;;;;;;;;;;;;;;;;;;;;;;;;;;;;;;;2,0;;;;;;;;;;;;;;;;;;;;;;;;;;;;;;;;;;;;;;;;;;;;;;4,0;1,0;1,0;;;;;;;;;;;;;9,0;;;;1,0;;;;;;;;;;;;;;;;;;;;;;
hardware;;;;2,0;9,0;;1,0;7,0;;2,0;;;;;1,0;;3,0;;1,0;1,0;5,0;1,0;1,0;;1,0;;;4,0;1,0;4,0;;3,0;14,0;;8,0;;;;;2,0;;1,0;;;;;;;;;4,0;;;2,0;;14,0;7,0;1,0;;7,0;;;14,0;;;7,0;1,0;;;2,0;;;;;;;;;;;;7,0;10,0;;;;1,0;;;3,0;4,0;;;;;;;;;;2,0;11,0;;;;;;5,0;;;;3,0;;16,0;7,0;;;;1,0;;;;1,0;;;;;;;2,0;;;;;;1,0;;;;;;;1,0;;;;1,0;;;;;1,0;;;;;;3,0;;2,0;;1,0;;;;;;1,0;;;;;3,0;20,0;;;5,0;1,0;1,0;;;;;;;;;2,0;;;;;;5,0;;;;;1,0;2,0;;;;;;1,0;;;1,0;16,0;;1,0;;;1,0;;;;;;;;;1,0;2,0;;;;;;1,0;;;;;;;2,0;;;;;2,0;;;;;;;;;3,0;;;;;;;;;;;;;;;;7,0;;;;;;;1,0;;;;;;;;1,0;3,0;;2,0;1,0;;1,0;;;;;;;;;;;;;;;;;;;;;;;;;;12,0;;;;;;;;;;;;;;;;3,0;;;;;;;;;;;1,0;;;;;;;;;;;4,0;;;;;;;;;;;;;;;;;;;;;;;4,0;;;;;;;;1,0;;;;;;;;;;;;;;2,0;;;;;1,0;;;;1,0;;;1,0;;;;1,0;;;;;2,0;;;1,0;;;1,0;;;;;;;;;;;;;;;;;;;;;;;;;;;;;;;;;;1,0;;;;;;;;;;1,0;;;5,0;1,0;1,0;;;;;;;;;;;;;;;;;;;;;2,0;;;;;;;;;4,0;;;;;;;;;;;1,0;1,0;;;;;;;;;;;;;;;;;;;;;;;;;;;;1,0;;;;;;;;;;;;;1,0;;;;;;;;;;;;;;;;;;;;;8,0;;;;;;;;;;;;;;;;;;;;;1,0;;;;;;;;;;;;2,0;;;;;;;;;;;;;20,0;;;;;;;;;1,0;;;;;;8,0;;;;;;;;;;;;;;;;;;;5,0;;;;;;;;2,0;;;;;;;;;;;;;;;;;;;;;;;;;;;;;;;;;;;;;;;;;;;;1,0;;;;;;;;;;;;;;;;;;;;;;;;;;;;;6,0;3,0;;;;;;;;;;;;;;1,0;;;;;;;;;;;;;;;1,0;;;;;;;;;1,0;;;;;;;;;;;;;;;;1,0;1,0;;;;;;1,0;;;;;;;;;;;;;;;;;;;;;;;;;;;;;;;;;;;;;;;;;;;;;;;;;;;;;;;;;;;;;;;;;;;;;;;;;;;;;;;;;;;;;;;;;;;;3,0;;;;;;;;;;13,0;;;;;;;;;;;;;;;;;;;;;;;;;;;;;;;;;;;;;;;;;;;;;;;;;;;;;;;;;;;;;;;;;;;;;;;;;;;;;;;;;;;;;;;;;;;;;;;;;
histogram;;;;6,0;4,0;;;28,0;37,0;23,0;3,0;;;;96,0;;;;1,0;2,0;6,0;;4,0;1,0;11,0;28,0;2,0;15,0;;5,0;1,0;33,0;8,0;7,0;7,0;1,0;1,0;;;3,0;;1,0;;;;;2,0;;;13,0;6,0;57,0;1,0;;;81,0;10,0;;;;1,0;;33,0;;9,0;;;;;3,0;;;;;;;;1,0;8,0;;;5,0;3,0;;9,0;;28,0;4,0;5,0;2,0;2,0;;;;;4,0;;;2,0;;;8,0;;;;;2,0;11,0;;;;2,0;;;;3,0;;10,0;;;;;1,0;;;;5,0;;6,0;;;5,0;;;4,0;;;;;;;;;4,0;9,0;;7,0;6,0;1,0;;12,0;;;;;;;;11,0;8,0;;;;;;;14,0;2,0;;;;;;;;;;2,0;;;;;;;;1,0;;13,0;;14,0;;;;;;;;;;;;4,0;;;;3,0;;;;;3,0;;;;;;;;;;;;;;;;;;;;;;;;4,0;;;4,0;9,0;;;;;;;;78,0;;;;2,0;;;;;1,0;;3,0;;;2,0;;;;;;1,0;;;;;;;;;;;;;;;;;;;3,0;;24,0;1,0;;;;20,0;;;;;;;;;;2,0;;20,0;;;5,0;;;2,0;2,0;;;;;;;;;;;;;;;;;;1,0;;;;;;;;;;;;1,0;;3,0;;;4,0;;;;;;3,0;4,0;;;5,0;2,0;;;2,0;;;;10,0;;;;;;20,0;;;;;;2,0;3,0;;;;;;;;;;2,0;;;;;;;;;;;5,0;;8,0;;;;;;;;;;3,0;;;1,0;;;4,0;;;;4,0;;;;4,0;;;;;7,0;4,0;;;;;;;;;;;6,0;;;;1,0;;;;;;2,0;;3,0;;;5,0;;;;6,0;;;9,0;;;;;9,0;;;4,0;;;;;;;;;;;;;;;;;;1,0;;;2,0;;3,0;;;;;;;;2,0;12,0;;;;;;;;;;3,0;;;;;;;;;43,0;;;;;;;;;;;;;;;;;;;;;;;2,0;3,0;;;1,0;6,0;;;;;;;;;6,0;14,0;;;;;;;;;;;;;;;;;;;;;2,0;;;;;;;10,0;;;;;;;;;;;;;;7,0;;;;;;;;;;;;;;;;;;2,0;;;;;;;;;;;;;6,0;;;;;;;;;;;;;;;3,0;;2,0;;;;;;;;;3,0;;;;;;2,0;;;;;;;;;;;;9,0;;1,0;;;8,0;11,0;;;;;3,0;;;;;;;;;;;;;;;;;;;2,0;;3,0;;2,0;;;;;;;;;;;;;;1,0;;;;;;;5,0;;;1,0;;4,0;;;12,0;;;6,0;;;;;;;;;;;;8,0;10,0;2,0;;;;;;;;;;;;;4,0;;;;;;10,0;;;;;;;;;;5,0;;;;;;;;;;;;1,0;;;;;;;;;1,0;2,0;;;;;;;;;;;;;;;;;;;;1,0;;;;;;;;;;;;;2,0;;;;;;;;;;;;;;;;;;;;4,0;;;;;;;;;;;;;;;;;;;;;;;;;;;;;;;2,0;;;;;;;;;2,0;;;;;;;1,0;;;;1,0;;;;;;;;;18,0;;;;;;;;;;;;;;;;;;;;7,0;;;;;;;;;;;;;;;;;;;;;;;;;;5,0;;9,0;;;;;;;;3,0;;;3,0;;;3,0;;;;;;;;;;;;;;;;
identify;;;;11,0;31,0;;1,0;89,0;14,0;92,0;30,0;12,0;49,0;;27,0;1,0;;;3,0;17,0;12,0;49,0;32,0;1,0;2,0;;;158,0;;40,0;27,0;64,0;192,0;22,0;52,0;8,0;1,0;31,0;;41,0;23,0;2,0;3,0;22,0;1,0;2,0;;1,0;2,0;4,0;7,0;44,0;1,0;21,0;;652,0;110,0;;6,0;19,0;;;200,0;5,0;17,0;5,0;26,0;;8,0;13,0;17,0;12,0;6,0;;;16,0;;141,0;126,0;3,0;;45,0;59,0;6,0;32,0;;55,0;9,0;18,0;38,0;24,0;11,0;10,0;63,0;30,0;17,0;20,0;11,0;51,0;2,0;14,0;68,0;;2,0;2,0;2,0;34,0;150,0;3,0;;7,0;6,0;;2,0;3,0;;;;;14,0;;;;3,0;;;59,0;2,0;1,0;4,0;;4,0;;;6,0;7,0;;;;4,0;;1,0;43,0;52,0;36,0;;34,0;81,0;1,0;;;;3,0;1,0;;3,0;;1,0;2,0;34,0;;;;1,0;6,0;;9,0;40,0;;1,0;;;21,0;5,0;37,0;5,0;;28,0;3,0;;;8,0;;6,0;;8,0;;125,0;;90,0;;;5,0;50,0;;1,0;;;13,0;3,0;;3,0;;12,0;;11,0;5,0;1,0;7,0;;1,0;1,0;4,0;;3,0;23,0;16,0;;;;6,0;28,0;;5,0;;;23,0;1,0;;;;;;10,0;1,0;8,0;;4,0;175,0;;1,0;;2,0;;;;;1,0;;;5,0;;1,0;20,0;;;;7,0;5,0;;;;17,0;;;;;;;;;;8,0;;2,0;20,0;4,0;;2,0;14,0;;;17,0;8,0;;42,0;8,0;287,0;1,0;;;;12,0;29,0;;;;12,0;3,0;;9,0;;12,0;18,0;7,0;;;10,0;;;58,0;26,0;;;;;;;;;;10,0;;;;14,0;;;1,0;3,0;67,0;;1,0;3,0;;1,0;;1,0;;;;34,0;;12,0;1,0;1,0;3,0;3,0;;3,0;12,0;12,0;6,0;;;;6,0;;;;9,0;9,0;;;;3,0;1,0;1,0;;42,0;1,0;;;3,0;14,0;13,0;2,0;2,0;;10,0;13,0;3,0;2,0;21,0;;;;1,0;2,0;44,0;1,0;15,0;1,0;3,0;3,0;4,0;1,0;104,0;19,0;;36,0;;14,0;;25,0;;8,0;4,0;2,0;1,0;;2,0;;;16,0;34,0;57,0;3,0;16,0;1,0;122,0;15,0;;14,0;7,0;2,0;2,0;13,0;13,0;23,0;11,0;;;;;;;;5,0;;1,0;44,0;10,0;2,0;5,0;12,0;1,0;5,0;2,0;1,0;;6,0;60,0;3,0;;12,0;99,0;2,0;20,0;2,0;3,0;8,0;1,0;5,0;;10,0;;5,0;37,0;;;18,0;;;;13,0;9,0;1,0;8,0;8,0;5,0;1,0;1,0;1,0;3,0;;17,0;15,0;1,0;10,0;;;;1,0;106,0;46,0;;;1,0;;;4,0;6,0;13,0;1,0;;;;;;;;2,0;18,0;37,0;3,0;;;9,0;;2,0;;18,0;10,0;;;7,0;;5,0;;;1,0;;6,0;28,0;;;4,0;8,0;48,0;;15,0;1,0;6,0;;;8,0;1,0;2,0;5,0;13,0;1,0;;;6,0;;14,0;;;4,0;69,0;15,0;5,0;;;;11,0;;;3,0;;11,0;6,0;3,0;;;;1,0;;1,0;;13,0;72,0;9,0;1,0;5,0;;1,0;12,0;3,0;8,0;;;;2,0;1,0;;;1,0;;;;3,0;;;;;5,0;;;;38,0;2,0;;;;;;;;1,0;;2,0;1,0;;;;;3,0;;;;;5,0;;;1,0;;;;;4,0;;;8,0;3,0;;1,0;2,0;;4,0;1,0;;;;;;;1,0;3,0;33,0;;9,0;13,0;;5,0;;;;23,0;;1,0;;;;;;15,0;;9,0;;;1,0;;15,0;;;;7,0;;;;;;;;;3,0;4,0;;2,0;;;;;19,0;;8,0;;39,0;;2,0;7,0;3,0;1,0;;;1,0;1,0;8,0;;38,0;;7,0;;;6,0;;;;2,0;7,0;18,0;10,0;;;;;5,0;;7,0;;3,0;2,0;6,0;;;5,0;;;;9,0;;6,0;2,0;2,0;11,0;;;2,0;;;2,0;2,0;5,0;;;;3,0;2,0;5,0;;;;;84,0;;;;;15,0;1,0;;22,0;2,0;6,0;14,0;10,0;;;;;;14,0;2,0;3,0;;;2,0;24,0;;18,0;;;;;1,0;2,0;23,0;25,0;1,0;10,0;2,0;13,0;;;;;;;;;2,0;;1,0;;;;3,0;;;;;;;;2,0;;;;1,0;;1,0;;;;;;3,0;;;7,0;1,0;2,0;10,0;3,0;8,0;;;1,0;;1,0;;;;3,0;8,0;;;;;;3,0;;;;5,0;;4,0;;;;;;;;;;4,0;;;;7,0;;;;;11,0;8,0;;7,0;1,0;;;;;;1,0;13,0;;1,0;;;4,0;1,0;;11,0;;;;;1,0;;;4,0;;;;;;;6,0;;;;1,0;;;;;;;5,0;;;;10,0;2,0;;;;;;;;12,0;1,0;;;1,0;1,0;23,0;1,0;1,0;;;;;;8,0;;;7,0;;;;;;12,0;;14,0;4,0;;1,0;;;;;1,0;;;;20,0;;6,0;2,0;;;;
joint;;;;1,0;11,0;;13,0;7,0;3,0;4,0;3,0;;2,0;;;;;;5,0;;;;;;;;;1,0;12,0;;;15,0;22,0;;1,0;;;18,0;;;;;1,0;2,0;;;2,0;;;;4,0;8,0;;6,0;;7,0;18,0;;;18,0;;;7,0;;1,0;;;;;;3,0;;;;;;;2,0;47,0;;;4,0;3,0;;;;;;;;5,0;;;1,0;;11,0;3,0;;;4,0;44,0;15,0;;;1,0;;;8,0;;;4,0;;;21,0;5,0;;3,0;;4,0;5,0;7,0;;;2,0;;;5,0;;;35,0;8,0;;;;;;1,0;;;5,0;;;4,0;1,0;;;21,0;13,0;;;;;6,0;;1,0;;14,0;11,0;;;;;6,0;;;;3,0;1,0;;4,0;16,0;;6,0;10,0;5,0;4,0;;;;;;;5,0;;10,0;;2,0;40,0;;32,0;;2,0;;11,0;1,0;;;1,0;13,0;4,0;;7,0;;2,0;;;9,0;;;26,0;6,0;1,0;;;2,0;1,0;;1,0;;;;1,0;;;2,0;;;;;;;3,0;11,0;3,0;3,0;8,0;4,0;2,0;;1,0;13,0;;;4,0;;;;1,0;;;;;;37,0;;;;4,0;;;;3,0;;;4,0;;14,0;2,0;1,0;;7,0;;;;1,0;1,0;;;2,0;;4,0;;;1,0;;;7,0;1,0;;2,0;;4,0;;;;1,0;;;1,0;;;;16,0;;1,0;;;;3,0;5,0;3,0;;;;1,0;;12,0;;1,0;2,0;;3,0;8,0;12,0;;;1,0;;;;;;;;;;;;;;1,0;1,0;;;;;;1,0;;2,0;3,0;;;;;;;;4,0;9,0;4,0;;;;;1,0;;4,0;;;;;;;;;;;;;;;1,0;4,0;;;;;;;;2,0;4,0;;;;;;;;;;;;;;4,0;;6,0;;;;3,0;;;;;;1,0;3,0;;;;;4,0;;;;;;;4,0;;;;;;;1,0;;;;;1,0;;2,0;;;;2,0;;;3,0;;5,0;;;;;;;;;1,0;;;9,0;2,0;;;;3,0;;;;;;;;;;;;;;9,0;;;;;;1,0;;14,0;1,0;2,0;;;;;;;;;;;;;;;;;;;;2,0;1,0;;;;;6,0;4,0;;;;10,0;;;;;;;;;;;;;;;;;;;;58,0;;;;;;1,0;;;;3,0;;1,0;;;;;;2,0;;6,0;;;;3,0;;;;2,0;;;;14,0;;1,0;;;;;;1,0;;;;;1,0;10,0;;;;;;;;;;;;;;;;5,0;;1,0;;2,0;;;;;2,0;;;;;;2,0;;;2,0;;;;;5,0;5,0;;;4,0;1,0;1,0;1,0;;;;;;;;;;;;;2,0;;38,0;4,0;;13,0;;;;4,0;;;;;3,0;;;;1,0;;;;;;;;;;;;;;;;;;;;;;;;;;;;3,0;;;;;;;2,0;;;;;;;;;;;;;8,0;;;;;;;;1,0;;;;;;;;;;;;;;;;;;;;;1,0;;;;;;2,0;1,0;;;;1,0;;;;;;;;;;;;;;;3,0;;;;;2,0;;;;;;;;;;;;;;;;;;;;;;;;;;;;;;;2,0;;;;;;;;;;;;;;1,0;;;;;;;;;2,0;1,0;;;;;1,0;;;;;;;;;;;;;;6,0;;;;;;;;;2,0;;;;;;;;1,0;;3,0;;30,0;;2,0;;;;;;;;;6,0;;1,0;1,0;;;;;;;;;;;;;;;;5,0;;;;;1,0;;;;;;;;;;;;;;;;;;;;;;;;;;;;;;;;;;;;;;;;;4,0;;2,0;;3,0;;;;;;;;;;;;;;;;10,0;;;;;;;;3,0;;;;;;;;;;;;;;;;;;;;;;;
lane;;;;2,0;1,0;;;2,0;;1,0;2,0;;;;;1,0;;;;5,0;;1,0;;;;;;2,0;;7,0;5,0;14,0;6,0;;;;;;;;2,0;;;1,0;;;;;;;1,0;4,0;;2,0;;8,0;;;5,0;;;;14,0;;;;1,0;;;;;2,0;;;;;;;;;;4,0;;;;;1,0;;1,0;3,0;;;;3,0;;;;;;;;5,0;;;;;;1,0;;;;;;;;;;;;;;;;;;;;;;;;;;;;;;;;1,0;;1,0;;;3,0;;;;;;;;;;;;;;;1,0;;;;;;;;6,0;;;;6,0;2,0;;2,0;;;3,0;;;;;;;;;;;;8,0;;;;;;;;;;;;;;1,0;;;2,0;;2,0;;;;;;;;;;1,0;;;5,0;;;;;;;;;;;;1,0;;1,0;;3,0;;;;;;;;;;;;;;;;;;;;;;;;1,0;5,0;;;;;;;;;;;;;;;;;;;;;;;;2,0;5,0;;;;;;;;;;;;;;;1,0;;;;;;;;;;;;;;;;;;;;;;;;;;;;;;;;;;;;;;;;;;;;;;;3,0;;;;;;;;;;;;;;;23,0;;;;;;;;;;;;;;;1,0;;;;;;;;;;1,0;;8,0;;6,0;;;;;;;;1,0;;;;;;;;;;;;;;;;;;;4,0;;;;;;;;;;;;;;;;;;;;;6,0;;;;;;;;1,0;;;1,0;;;;;;;;;;;;;2,0;;;;;;1,0;;;;;;;4,0;3,0;;;;;13,0;;;;;;;;;;;2,0;;;;;;;;;;;;;;;;;;;;;;;;;;;;;;;;;1,0;;;;;;;;;;;;;;;;;;;;;;;;;;;;;;;;1,0;1,0;;;;;;;;;;;1,0;;;;;;;;;;;;;;;;;;;;;;;;;;3,0;;;3,0;;;;;;;;;;;;;;;;;;;;;;;;;;;;;;;;;;;;;;;;;;;1,0;;;;;;;;;;;;;;;;2,0;;;;;;;;;;;;;;;;;;;;;;;;;;;;;;;;;;;;;1,0;;;;;;;;;;;;;;1,0;;;;;;;;;;68,0;;;;;;;;;;;2,0;;;;;;;;;;;;;;;;;;;;;;;;3,0;;4,0;;;;;;;;;;;;;1,0;;;;1,0;;;;;;3,0;;;;;;;1,0;;;;;;;;;;;;;;;;;;;;;;;;;;;;;;;;;;;;;;;;;13,0;;;;;;;;;;;;;;;;;;;;;;;;;;;;;;;;;;;;;;;;;;;;;;;;;;;;;;;;;;;;;;;;;;;;;;;;;;;;;;;;;3,0;;;;;;;;;;1,0;;;;;;;;;;;;;;;;;;;;;;4,0;;;;;2,0;;;;;;;;;;;;;;;;;;;;;;;;;1,0;;;;;;;;;;;;;;;;;;;;;;;;;;;
load;;;;2,0;2,0;;;9,0;3,0;5,0;2,0;9,0;;;1,0;;;;2,0;6,0;6,0;29,0;1,0;;2,0;;;34,0;;25,0;11,0;2,0;66,0;2,0;8,0;1,0;2,0;4,0;;18,0;;;2,0;1,0;;;;;;19,0;;2,0;5,0;;;81,0;22,0;1,0;;11,0;1,0;;27,0;;;12,0;1,0;;5,0;13,0;4,0;1,0;11,0;;;;1,0;3,0;4,0;3,0;;7,0;6,0;;;;;;;;1,0;;;34,0;;3,0;;14,0;10,0;;;28,0;;6,0;1,0;;1,0;81,0;;3,0;3,0;;2,0;7,0;3,0;2,0;;;1,0;4,0;;;;39,0;;;17,0;1,0;;1,0;;;;2,0;;4,0;4,0;;;;;;;2,0;;1,0;2,0;2,0;;;;;;1,0;2,0;1,0;;;;9,0;;4,0;;3,0;1,0;;;1,0;;;3,0;1,0;8,0;6,0;;;;21,0;1,0;;;;1,0;;;;1,0;49,0;;12,0;;;;11,0;;;;;;1,0;4,0;;;3,0;;;;;2,0;1,0;;3,0;;;1,0;8,0;15,0;;;;;1,0;;;;;;;;;1,0;;;;;1,0;;17,0;4,0;;1,0;;;;;8,0;1,0;;;;1,0;;;36,0;;;;;;;;9,0;1,0;;;;;;;;;2,0;;;;;;;;2,0;;;;4,0;;;1,0;;3,0;;;;1,0;6,0;;;;2,0;;;1,0;;10,0;;;;;;;;7,0;5,0;;;;;;;;;;;;;;14,0;;10,0;12,0;;1,0;5,0;;;;;;;;;;1,0;;2,0;;6,0;1,0;1,0;11,0;3,0;;;;8,0;;2,0;;;;;;;;3,0;;5,0;;;;;;;;;85,0;24,0;3,0;;;4,0;;2,0;;7,0;8,0;;3,0;;1,0;138,0;1,0;1,0;1,0;1,0;;;;;;1,0;;;;;;;1,0;;;2,0;;5,0;5,0;;;;;;3,0;;3,0;2,0;;2,0;10,0;;;;;;3,0;;;;;;;;1,0;11,0;;;;;5,0;;;;;25,0;;7,0;;1,0;;3,0;;4,0;5,0;;;;;5,0;;;;;2,0;;;2,0;;;1,0;2,0;;8,0;;1,0;2,0;;6,0;;;6,0;;1,0;;13,0;;11,0;1,0;;15,0;2,0;;20,0;1,0;;;;;;;2,0;;1,0;;;2,0;;;16,0;1,0;;;;2,0;;2,0;;6,0;;;;;;;;1,0;;;;3,0;;;1,0;;;;;;;;;;4,0;;;;27,0;;1,0;9,0;;1,0;;;;7,0;14,0;;;;7,0;;;;;2,0;;7,0;;;1,0;6,0;3,0;;8,0;;;;;;;;;;1,0;1,0;;;;;;;1,0;;1,0;;;;;;;;2,0;;;;3,0;;;1,0;;1,0;3,0;;;;;;;;;;;7,0;;;20,0;;;;;;;;;;;;1,0;;1,0;;1,0;;;;19,0;;;;;;2,0;;;;;;;;2,0;;;;;;;3,0;;;;;;;;4,0;;;;;;;;;;;2,0;;;;;14,0;;;;;;;;;;;9,0;;2,0;;4,0;1,0;;;;69,0;;2,0;;;1,0;;;;2,0;;;;;;;;;;2,0;;;;;;;;3,0;;;4,0;;;;;;;1,0;;2,0;;16,0;;;1,0;;;;;;;;;;3,0;;;;;;;;;;;;;;;1,0;;;;;3,0;;;;;;;;;;;;;;;;;;1,0;;;;;;;;;;2,0;;2,0;;;;;;;;;;;;;;;;;;;;;;;;;;3,0;;;;1,0;;5,0;;;;;;7,0;;;;;;;;;;;;;;;;;;;;;;;;;;;;;;;9,0;;;;;;;;;;;;;;;;;;;;;;;;;;;;;;;2,0;1,0;;;;;;;;;;;;;;;;;;;;;;;;;;;;;;1,0;;1,0;;;;;;;;;;;;;;;;;;;1,0;;;;1,0;;;;3,0;;;;;;;9,0;;;;;1,0;;;;;;;
location;;;;3,0;56,0;;30,0;172,0;73,0;78,0;27,0;6,0;12,0;;16,0;4,0;;;25,0;27,0;5,0;76,0;61,0;5,0;3,0;;;173,0;2,0;69,0;29,0;278,0;197,0;7,0;74,0;42,0;18,0;61,0;;108,0;69,0;4,0;;59,0;3,0;1,0;5,0;8,0;27,0;3,0;13,0;38,0;6,0;6,0;4,0;546,0;99,0;;7,0;27,0;;;291,0;;5,0;5,0;36,0;4,0;19,0;3,0;35,0;29,0;16,0;;1,0;;;154,0;108,0;1,0;1,0;65,0;22,0;23,0;1,0;1,0;66,0;1,0;38,0;53,0;87,0;6,0;20,0;58,0;31,0;26,0;12,0;12,0;43,0;5,0;74,0;118,0;1,0;7,0;;7,0;11,0;69,0;4,0;;13,0;16,0;28,0;9,0;14,0;1,0;;;1,0;12,0;2,0;1,0;7,0;54,0;1,0;3,0;48,0;6,0;1,0;7,0;7,0;6,0;;;1,0;10,0;38,0;4,0;4,0;2,0;7,0;6,0;27,0;17,0;;;21,0;73,0;4,0;1,0;;;7,0;;;3,0;14,0;18,0;3,0;40,0;3,0;;;3,0;2,0;1,0;1,0;36,0;3,0;;9,0;15,0;17,0;18,0;10,0;4,0;2,0;18,0;;;3,0;10,0;9,0;2,0;10,0;40,0;13,0;200,0;;119,0;;1,0;5,0;49,0;;11,0;;;13,0;15,0;;10,0;;4,0;;17,0;2,0;5,0;5,0;13,0;6,0;3,0;;2,0;5,0;112,0;26,0;3,0;1,0;;5,0;29,0;;6,0;1,0;2,0;1,0;;1,0;;;1,0;2,0;14,0;19,0;73,0;;2,0;94,0;7,0;;5,0;9,0;6,0;1,0;10,0;12,0;7,0;4,0;3,0;9,0;;1,0;14,0;;;;23,0;28,0;1,0;;4,0;16,0;4,0;1,0;;10,0;2,0;;3,0;;;13,0;4,0;4,0;16,0;;;6,0;56,0;;;;3,0;2,0;29,0;31,0;314,0;29,0;1,0;;;3,0;15,0;;;;69,0;;6,0;18,0;1,0;75,0;5,0;23,0;2,0;;12,0;;;46,0;47,0;;;;;4,0;;;;2,0;16,0;;2,0;;60,0;;2,0;1,0;1,0;47,0;3,0;2,0;;8,0;5,0;3,0;1,0;3,0;5,0;9,0;57,0;;1,0;1,0;4,0;36,0;4,0;1,0;23,0;34,0;18,0;33,0;3,0;;;4,0;2,0;;2,0;54,0;1,0;1,0;9,0;122,0;31,0;6,0;12,0;;18,0;;1,0;;48,0;4,0;106,0;15,0;;;6,0;7,0;6,0;2,0;10,0;;;1,0;14,0;8,0;36,0;2,0;7,0;3,0;;24,0;4,0;;119,0;9,0;;27,0;8,0;12,0;;8,0;1,0;33,0;2,0;8,0;4,0;7,0;10,0;;2,0;1,0;102,0;34,0;;43,0;21,0;;15,0;4,0;45,0;3,0;;6,0;36,0;15,0;41,0;52,0;18,0;1,0;;6,0;;1,0;;16,0;;1,0;4,0;2,0;2,0;;11,0;3,0;17,0;22,0;13,0;;3,0;44,0;;;;9,0;3,0;12,0;5,0;7,0;2,0;13,0;6,0;11,0;51,0;2,0;;42,0;8,0;;16,0;2,0;;;14,0;7,0;3,0;77,0;27,0;;9,0;16,0;5,0;6,0;3,0;25,0;6,0;1,0;12,0;10,0;3,0;7,0;2,0;92,0;97,0;18,0;;4,0;19,0;;2,0;5,0;26,0;4,0;9,0;;2,0;;2,0;5,0;;;8,0;26,0;6,0;;17,0;4,0;5,0;;1,0;11,0;;12,0;;1,0;;1,0;2,0;;6,0;22,0;;15,0;;;1,0;2,0;4,0;;1,0;;2,0;;;6,0;8,0;;;16,0;5,0;;8,0;21,0;;9,0;2,0;;8,0;186,0;13,0;;5,0;1,0;9,0;65,0;;;8,0;;5,0;20,0;;;7,0;3,0;1,0;;13,0;;25,0;29,0;22,0;2,0;28,0;;;;10,0;14,0;;;;6,0;;;;1,0;;1,0;;33,0;;;10,0;2,0;;;3,0;;;;4,0;1,0;;120,0;8,0;1,0;1,0;6,0;;1,0;13,0;;;;2,0;4,0;;;7,0;;1,0;9,0;4,0;21,0;6,0;;2,0;;2,0;;1,0;1,0;3,0;;;11,0;;9,0;2,0;;;;1,0;;;4,0;6,0;46,0;;1,0;1,0;1,0;2,0;;;1,0;1,0;3,0;1,0;;;11,0;2,0;;13,0;;2,0;;;1,0;2,0;29,0;;;1,0;3,0;;;2,0;;;11,0;;24,0;7,0;1,0;2,0;2,0;;;2,0;;8,0;;5,0;3,0;25,0;4,0;2,0;7,0;16,0;4,0;;2,0;1,0;1,0;;;13,0;;18,0;;19,0;;;;;;;21,0;6,0;;;;8,0;1,0;;11,0;;;;36,0;4,0;2,0;;;;;3,0;4,0;3,0;16,0;11,0;2,0;4,0;2,0;19,0;1,0;1,0;1,0;9,0;3,0;;;;6,0;;17,0;1,0;;;4,0;89,0;;9,0;;4,0;;;2,0;2,0;5,0;4,0;27,0;3,0;;;2,0;1,0;4,0;8,0;5,0;47,0;;2,0;;;2,0;;;;2,0;3,0;;20,0;47,0;2,0;4,0;;3,0;10,0;1,0;;;1,0;9,0;;;1,0;1,0;;;3,0;;;5,0;6,0;;5,0;14,0;7,0;;;;;19,0;22,0;;;;17,0;3,0;3,0;;2,0;2,0;;;;16,0;10,0;4,0;1,0;5,0;;5,0;2,0;;1,0;;3,0;;3,0;4,0;;;2,0;;2,0;;;2,0;;19,0;;;1,0;2,0;;;;;;2,0;;5,0;;;;1,0;;1,0;3,0;;;3,0;;6,0;;;30,0;;3,0;;;;;3,0;1,0;;2,0;1,0;;2,0;24,0;;;;4,0;;1,0;;1,0;;2,0;;;1,0;10,0;;;7,0;;1,0;;;2,0;;;6,0;4,0;;;17,0;1,0;;14,0;;3,0;;1,0;;4,0;2,0;;;11,0;;4,0;;;4,0;;1,0;2,0;;4,0;;2,0;;9,0;;;5,0;2,0;;;4,0;1,0;;1,0;3,0;;;2,0;;;;;;;4,0;;;;;
marker;;;;2,0;2,0;;4,0;2,0;5,0;8,0;1,0;1,0;;;3,0;;;;;5,0;;1,0;26,0;1,0;;;;14,0;;16,0;7,0;42,0;16,0;;10,0;;;;;14,0;6,0;1,0;;;;3,0;;;5,0;;4,0;10,0;;2,0;;63,0;20,0;;3,0;;;;26,0;;1,0;;4,0;;;1,0;11,0;;;;1,0;;;7,0;38,0;;;2,0;2,0;2,0;3,0;;2,0;;;2,0;1,0;;;3,0;;2,0;2,0;;4,0;;;36,0;;;;;;2,0;;;1,0;2,0;5,0;;12,0;;;;;;;;;;;;1,0;;;4,0;2,0;;;;;;8,0;;;7,0;4,0;5,0;2,0;1,0;1,0;;9,0;14,0;8,0;;;;;;;;;;;5,0;;;;;4,0;;;2,0;1,0;;;;1,0;;;;;5,0;;;13,0;;;;;3,0;;37,0;;7,0;;;1,0;;4,0;;;;;;;;;1,0;;;;;9,0;;;;;;;5,0;2,0;;;;;3,0;;;;8,0;;;;;;;;;4,0;2,0;;3,0;8,0;;;;2,0;;;;;;;;;;;1,0;;;;;;;;15,0;3,0;;;;;;;;;;;;;1,0;;;;4,0;;;;;;1,0;4,0;17,0;;;1,0;;6,0;5,0;;;;;;;;;11,0;;;;;6,0;;;9,0;1,0;;;;;;;;;;;;;;;;;;1,0;3,0;2,0;;;;;;;;;;9,0;;11,0;;;2,0;;;1,0;;;;;;;;;;;3,0;;;;38,0;6,0;1,0;1,0;;;;;;3,0;;2,0;1,0;;;2,0;1,0;;2,0;3,0;;;;2,0;;6,0;;20,0;;;;;;13,0;;;5,0;;;;;;2,0;;;;;;;;;;8,0;;3,0;;13,0;2,0;;;;;;;;1,0;1,0;;;;;;;;;;;6,0;;;;3,0;;;;;;;6,0;;;;1,0;;;;;;;;;;;;2,0;;;3,0;;;;;;;;;;;;;7,0;;;;;;;11,0;;;7,0;3,0;;;;;;;;;;;;;;;;;;45,0;;;;;4,0;;;;;2,0;1,0;;;;1,0;;;;;;;;;;;;;9,0;;;;;;;;;2,0;;;;;;;1,0;;13,0;;1,0;;;;;6,0;;;;;;;;;;;;;;;;1,0;;;;;;;;;;;;;;;;;1,0;;;;;;;;;;;;;;;;;;;;4,0;;;;;1,0;;;;;;;;;;;;;;;;;;;;1,0;;1,0;1,0;;;4,0;;;;;;;;;;10,0;;;;;;;;;;;;;;;;;;1,0;;;;;2,0;4,0;;;;;;;;;;;;;;;;;;3,0;;;;;2,0;;;;;;2,0;;;;;;;;;;;;;;;;;;;6,0;;;1,0;;4,0;;;;;;;;;;;;;;;;8,0;;1,0;5,0;;2,0;;;;;;;;1,0;;11,0;;1,0;;;;;1,0;;;;;2,0;;;;;4,0;;;;;2,0;;;;;;;;;;4,0;;;;1,0;;;;;;;;2,0;3,0;;;;;;;;;;;;;;;;2,0;;;;;;;25,0;;2,0;;;6,0;;;;;;;;;;;6,0;;;4,0;;;;3,0;;;;;;;;;;;;;;;;;;;;;;;;;;;;;;;;;;;;;;;;;;;;;;;;;;;1,0;;;;1,0;;1,0;;;;;;;;;;;;;;;;;;;;;;;;;;3,0;5,0;;;;;;;;;;;;2,0;;;;;;68,0;;;;;;;;;;;3,0;;;;;;;;;1,0;;3,0;;;;;;;;;;;;;;;;
message;;;;4,0;6,0;;;13,0;;8,0;;;;;;;;;1,0;;;40,0;;;;;;11,0;;1,0;;9,0;41,0;;5,0;;2,0;4,0;;24,0;;;;;14,0;;;;;1,0;;12,0;;2,0;;35,0;60,0;;;1,0;;;37,0;2,0;;;1,0;;;4,0;;;2,0;;;;;;;2,0;;5,0;4,0;;;;;;4,0;3,0;;;1,0;20,0;;;;6,0;;;;11,0;;12,0;2,0;;1,0;8,0;;;;4,0;;4,0;3,0;;;;;1,0;;;;3,0;;;4,0;2,0;;;;10,0;1,0;;;;2,0;;;;;;2,0;;;;;;;1,0;;;;;;;;;;2,0;;1,0;;;;1,0;;3,0;;;;;1,0;;4,0;;;23,0;;;;;;;;;;11,0;;;;;;32,0;;;;;;;;;;;;;;;;;2,0;;;;;4,0;35,0;;;;;2,0;;;;1,0;1,0;;;;;;;;;;;;1,0;;;;1,0;;;;;;;;;;;;;;;10,0;;;;;;;;;;;;;;;;;;3,0;2,0;;;;;;;;;2,0;;2,0;;;;;;1,0;;;;;;;2,0;;3,0;;3,0;;;;;;;;;;;;;;;;;;;;;9,0;;;;;10,0;;;;1,0;;;;;;;6,0;;;;;;14,0;;15,0;;4,0;;;;;;;;;;;;;;4,0;3,0;1,0;;;;;;2,0;11,0;;2,0;;;;;;;;;;;;;16,0;;7,0;;;;;;;;;13,0;1,0;;;;;;;;1,0;;;;;;;;;1,0;;4,0;;;;14,0;;;;;4,0;;;;;;;;;3,0;5,0;;;;;;8,0;;1,0;14,0;;;3,0;;1,0;;;;;18,0;3,0;;1,0;;;;10,0;;;;14,0;;1,0;;;;;1,0;;1,0;;;;9,0;1,0;;;;9,0;;;15,0;5,0;;;15,0;;;;;;2,0;6,0;;9,0;;3,0;;;;;;;8,0;8,0;11,0;;;8,0;;;;;;3,0;;;;;;;;;;;4,0;;;;;;;;;3,0;;;2,0;;;;;;;;7,0;;6,0;;;;1,0;;;;;;;;;;;25,0;10,0;16,0;;;;;;;;;;1,0;;4,0;;;;1,0;21,0;;;;;;;;1,0;;;;;;;;;3,0;;;;;;;2,0;;1,0;;;;;;;4,0;;;;;3,0;;;;;;;;;;;;;;;;;3,0;;;;;;;;;;;;;;;;;7,0;;;;;;;;;;1,0;;;;;;;;;;;;;;;;;;;;;;;;;;;;;;2,0;;;;;;;4,0;;;;;;;;;;;1,0;;;;;;;;;;;;1,0;;;;;;1,0;;;2,0;;;;;;;;;;;;;;;;;;;;;;;;;;;;;3,0;;2,0;;;;;;;;20,0;;;2,0;;1,0;;;;;;;;;8,0;;;;;;;;;;;;;;;;;;;;;;;;;;;;;;;;;;;;;;;;;;;;2,0;;;;;;8,0;;;4,0;;;;;;;;;;;;;;;;;;;;;;;;;;;;;;;;;;;;;;;;;;;;;;;;;;;15,0;;;;;;;;;1,0;;;;;;;;;;;;;5,0;4,0;;;;;;;;;7,0;;;;;3,0;;;;;;;;;4,0;;7,0;;;;;;;;;;;;;;;;;;;;;;;;;;;1,0;;;;;;;;;;;;;;;;;;;;;;;;;;
modify;;;;2,0;8,0;;4,0;18,0;1,0;43,0;;;1,0;23,0;35,0;2,0;;1,0;11,0;1,0;3,0;11,0;;;17,0;;;14,0;;9,0;;14,0;32,0;1,0;16,0;;3,0;4,0;;9,0;5,0;4,0;;;;;;9,0;11,0;;3,0;5,0;;7,0;;178,0;9,0;6,0;8,0;16,0;1,0;;52,0;;6,0;;2,0;;;5,0;12,0;;1,0;;;;;;7,0;3,0;1,0;28,0;2,0;31,0;;;4,0;;;19,0;2,0;;2,0;10,0;1,0;1,0;;9,0;14,0;;1,0;29,0;;4,0;;;;10,0;;;1,0;1,0;14,0;;;2,0;;1,0;;;;;3,0;24,0;;;22,0;;;3,0;;3,0;;;;;;;;;;;1,0;;12,0;;2,0;2,0;;;1,0;;1,0;;;;;;8,0;6,0;;2,0;;;;;11,0;7,0;1,0;;;2,0;5,0;3,0;2,0;;;22,0;;;;2,0;1,0;;;1,0;;5,0;;17,0;;;4,0;14,0;;;;;2,0;;;8,0;;;;;4,0;;;;;;;1,0;;3,0;2,0;;;;;1,0;;1,0;;;;;;;;;;;;2,0;;3,0;9,0;;;;;;;;;;;;;;;1,0;;;;1,0;;;;;;;3,0;;;2,0;;;;;;;;3,0;;;;;;;1,0;2,0;;38,0;1,0;4,0;1,0;;1,0;;;16,0;;;;;;;;1,0;3,0;1,0;1,0;;;4,0;;;4,0;;;;;;;;;;;6,0;;;;6,0;;;;;7,0;1,0;;;;1,0;;;;;;;2,0;;1,0;2,0;;;;2,0;;3,0;4,0;;3,0;;;;;;5,0;;;;;;;2,0;1,0;;;;;;3,0;1,0;;2,0;;;2,0;;;;;;3,0;6,0;;7,0;;6,0;1,0;;;2,0;2,0;2,0;9,0;;;;1,0;1,0;;;3,0;4,0;;;;;;6,0;;3,0;1,0;3,0;9,0;;8,0;1,0;;1,0;1,0;;4,0;11,0;3,0;14,0;22,0;3,0;;;;;;5,0;;;;;1,0;6,0;;4,0;;;;;;1,0;20,0;;;;;;2,0;;;;;;;;;2,0;10,0;1,0;;4,0;;;;;1,0;2,0;;;;1,0;;6,0;;;3,0;3,0;5,0;14,0;;;6,0;;11,0;6,0;;1,0;;;1,0;4,0;2,0;;1,0;;;;;;;;1,0;;1,0;;;;;;;;5,0;;;;1,0;1,0;1,0;;;24,0;;;;;;;2,0;;;;1,0;;;;;;;;1,0;2,0;;;1,0;;;;;7,0;23,0;;;;;;1,0;;;;;;;;;;;;;;;7,0;;;;;;;;;;;;;;;;;;;;;15,0;;;;;;;;;;;;;;;;;1,0;;;;;;;;;2,0;;;3,0;5,0;;;;;;;;;;;;;;;6,0;;;;1,0;;;;;;;;;3,0;;;;;;;;;2,0;;;;;1,0;1,0;;1,0;;;;;;1,0;;;1,0;1,0;;;;;;;1,0;;1,0;;;;;;;;2,0;2,0;;;;24,0;;3,0;;;;;;1,0;;;;;;;;;;;;;;;2,0;;;6,0;;;1,0;;;1,0;;;;;2,0;;;;;1,0;1,0;9,0;;;;1,0;;1,0;;;;;1,0;;;;2,0;;;4,0;;;4,0;;;1,0;;;;;;1,0;;;1,0;;;;;;;1,0;;;;;;;;;;;;;;;;;;;;5,0;;;1,0;;;;;;7,0;;;;2,0;;;;;3,0;;;;;1,0;;2,0;1,0;;;;;;;;;;;;;;;;;;1,0;1,0;;;1,0;;;1,0;;;;;;2,0;;;;;;7,0;;;;;;;;;;;;9,0;;;;;;;;;;;;1,0;;;;;;;;;2,0;;;;;;6,0;;;;;;;;;;;;13,0;;;;;;;;;;;;;;;1,0;;;;;;;;;;;;;;;;;;;;;;;;;;;;;;;;;;1,0;;;;;;;;;;;;;;1,0;;4,0;;;;;;;
operator;;;;1,0;5,0;;;2,0;;10,0;2,0;;;;;;;;1,0;;7,0;28,0;;;4,0;;;11,0;;2,0;4,0;6,0;44,0;;12,0;;4,0;3,0;;23,0;;;;;1,0;;;;2,0;;8,0;7,0;;;;43,0;9,0;;;14,0;;2,0;17,0;;;;2,0;;6,0;29,0;;4,0;;;;;;6,0;11,0;2,0;2,0;5,0;4,0;2,0;;;8,0;;8,0;6,0;;;2,0;36,0;;;;1,0;5,0;;1,0;27,0;;3,0;1,0;;1,0;20,0;;;5,0;4,0;;;10,0;;;;;8,0;;;4,0;1,0;;;7,0;;1,0;6,0;1,0;;;;;3,0;;;;;;1,0;4,0;4,0;;1,0;6,0;11,0;;;;;;;;;1,0;;;5,0;;3,0;;;;;;6,0;;;2,0;;9,0;5,0;6,0;;;;;;;;;;1,0;;;4,0;;2,0;;;;10,0;1,0;;;;22,0;4,0;;;;1,0;;;4,0;;;16,0;;;;;;3,0;8,0;1,0;;;;11,0;;;;;;;;;;;5,0;;4,0;;;1,0;3,0;8,0;;;;2,0;2,0;1,0;;;;;;1,0;;;;2,0;;2,0;1,0;;;;10,0;;1,0;;1,0;;;3,0;;8,0;;4,0;;23,0;2,0;;;1,0;;;;2,0;;10,0;2,0;6,0;21,0;3,0;;;;;;;;11,0;;;1,0;;6,0;;1,0;;;;;;1,0;;;;;;;;;1,0;;;;;;1,0;;;;1,0;3,0;1,0;;;;;;;;;;1,0;;;;;;4,0;;2,0;;5,0;;;;2,0;;;1,0;;;;;;5,0;1,0;;;;;;;;;1,0;;1,0;;;;1,0;;;;;;;;;14,0;3,0;9,0;;;5,0;;2,0;1,0;;3,0;2,0;1,0;4,0;;;;;;;5,0;;8,0;;2,0;;14,0;;;23,0;2,0;;;;3,0;6,0;;1,0;;2,0;;1,0;;;;4,0;;;;;;3,0;;;5,0;;2,0;;;2,0;;1,0;;3,0;;;;;;16,0;;;1,0;2,0;;;8,0;1,0;;5,0;1,0;;17,0;;;1,0;;;;;;;;;14,0;;8,0;1,0;17,0;;1,0;;8,0;;2,0;11,0;10,0;;;;;;3,0;;;;5,0;;;;;;;;;1,0;;;;1,0;;;;;;;;18,0;;2,0;6,0;;;;;1,0;;;3,0;;;;;;;;;1,0;4,0;;2,0;;;;2,0;;;1,0;3,0;11,0;;;;;;7,0;1,0;;3,0;;;;;;;;;;;;;;;;;;1,0;;;;1,0;;;;2,0;;;;2,0;;;;;1,0;;1,0;;;;;;;;4,0;;;;4,0;;;;;;;2,0;;2,0;;;;;;;;1,0;;;1,0;;;;;;;;;;;;;;2,0;;;;;;;;;1,0;;;;;;;;;;;;;;;14,0;;;4,0;;;;;;;1,0;;;1,0;;;;;;;1,0;;;13,0;;1,0;;;;;;;;;;;;;1,0;;;3,0;;;;5,0;;;;;;5,0;;;;;;;;1,0;;;;;1,0;;;;;;;;;;;;;;;;;;;;;;;;;;;;;;;;2,0;;;;;;1,0;3,0;;1,0;;;;;;;;;;;;;2,0;;;;;;;;;;;2,0;;1,0;;;;;;;;2,0;;;;;;;1,0;;;;;;;;1,0;;;3,0;;;;;;;2,0;;;;;2,0;;1,0;;;;;;;;;;;;;;;;;;;;;;;;2,0;;;4,0;;;;;;;;;;;;;;;;1,0;;;;;;1,0;;;;2,0;7,0;;;;;;;;;3,0;;;;;;;4,0;;;;;1,0;;;;;1,0;2,0;;;;;;;;;;;;;;;;;1,0;;;4,0;;;;;;;;;;;;;;;;;;;;;;;;;;;;;;;4,0;;;;;;;;;;;;;;;;;;;;;;
perspective;;;;1,0;1,0;;;19,0;;54,0;;;;;4,0;;;;;8,0;;4,0;;3,0;6,0;;;;;;;7,0;10,0;;1,0;20,0;;2,0;;45,0;8,0;4,0;;5,0;;;;;1,0;;;13,0;;;;54,0;9,0;;;2,0;1,0;;36,0;;10,0;;1,0;;;;;;2,0;;;;;8,0;9,0;;;9,0;4,0;;;;5,0;;2,0;19,0;;1,0;;;;9,0;;;;;2,0;13,0;;;;;;3,0;;;;;;;;;;;;;;;;;;;8,0;;;;;1,0;;;;;;;;;;2,0;;;;;;;;;;;2,0;;;;;;;4,0;;;;;;;;;;;;;3,0;;;;;1,0;;;1,0;;;;;3,0;;4,0;5,0;23,0;;;;3,0;;;;;1,0;;;1,0;;1,0;;;;1,0;;;;;;;;;2,0;;;;;1,0;;;;;;;;;;;;;5,0;17,0;;;1,0;;;;;3,0;;;;;;;;;;;;;;3,0;12,0;;;;;;;;;;;1,0;;;;;;1,0;;;;1,0;;;;;;2,0;2,0;15,0;2,0;;1,0;;1,0;;;;;;;;;;5,0;4,0;4,0;;;;;;;;;;;;;;;;;;;;;19,0;;;;;17,0;;;;;;;;;;;5,0;;;;;;1,0;;1,0;1,0;;3,0;;;;;;;;;;;;;;;;;;;1,0;;;;;1,0;;;;;;;;;;;;;12,0;;;;;;;;5,0;;;;;;;;;50,0;;1,0;;;;;;;;;;4,0;;2,0;;;1,0;;;;;;8,0;1,0;;;;;;;2,0;;;;;;5,0;;;2,0;7,0;;;;;1,0;;;;;;;;;;11,0;;;10,0;1,0;;;;;4,0;;;;;;;;;;;;;;;4,0;7,0;;;;2,0;;1,0;113,0;58,0;;;;;;;;1,0;;;1,0;;;;;;;;;;;;;;;1,0;;;;;;;;;1,0;;;;;;;;;;;;;;;;;;;;;;;;1,0;;;;;;;;;;;;11,0;;;;;;;;;;;;;;;;;;1,0;;;;;;;;;;;;;;;;;;;;;;;;;;;;;;;;13,0;;;;;;;3,0;1,0;10,0;;;2,0;;;;;;;;;;;;;;;;;;;;;;;;;;;;;;3,0;;7,0;;;;;;;;;;;;1,0;;;;;;;21,0;;;;;;;;;;;;;;;;;;;;;;;;;;;;2,0;;8,0;;1,0;;1,0;;10,0;;;;;;1,0;;1,0;;;;;;;;;;;;;;;;;;;;;;;;;;;;;2,0;;;8,0;5,0;;;;;;;;3,0;;;;;;4,0;;;;;;;;;2,0;;;;34,0;;1,0;;;;;;;;14,0;;;;;;;15,0;;;;;2,0;;4,0;;;;2,0;7,0;6,0;;;;;4,0;;;;;;1,0;;;;;;22,0;1,0;;;;;;;;;;;;;;2,0;;;;;;;;;;;;;;;;;;;;;;;;;;;;;;;;;;;;;;;;;;;2,0;;;;;;;;;;;;;;;;;;;;;;;;;;;;;;;;;4,0;;;;;;;;;;;;;;;;;;;;;;;;;;;;;;;;;;;;;;;;;1,0;;;;;;;;;;;;;;;;;;;;;1,0;;;;;;;;;1,0;;;;;;;
pick;;;;1,0;25,0;;1,0;9,0;8,0;4,0;1,0;16,0;;;10,0;;;;1,0;;3,0;29,0;3,0;4,0;7,0;;;37,0;1,0;7,0;1,0;12,0;144,0;;16,0;;;17,0;6,0;38,0;3,0;6,0;;53,0;;3,0;;1,0;14,0;;2,0;7,0;;;;755,0;35,0;;;47,0;;;10,0;1,0;;;6,0;;15,0;7,0;38,0;;;8,0;;1,0;;2,0;13,0;;;6,0;;;;;6,0;;;19,0;22,0;4,0;;24,0;2,0;5,0;;4,0;11,0;1,0;23,0;31,0;;;1,0;;;131,0;;2,0;2,0;11,0;;;2,0;11,0;;;9,0;6,0;;;5,0;14,0;;;37,0;8,0;;;;4,0;;;;;9,0;;;;;;2,0;2,0;6,0;;28,0;34,0;;;;;3,0;;2,0;7,0;1,0;;1,0;42,0;2,0;;;;;;2,0;8,0;;1,0;19,0;6,0;47,0;14,0;2,0;;;13,0;;;2,0;;;;;;4,0;27,0;;20,0;1,0;;;24,0;;;;;2,0;1,0;3,0;;;2,0;;;;;3,0;9,0;2,0;1,0;;;;38,0;7,0;2,0;;;3,0;;;4,0;;;;;;;;;1,0;;2,0;2,0;1,0;;22,0;2,0;6,0;;;;1,0;1,0;;5,0;;1,0;;;;11,0;;;2,0;2,0;;;;1,0;;;;;;;;;;5,0;;;;1,0;2,0;;;2,0;;;6,0;4,0;;5,0;7,0;87,0;2,0;;;;;;;;;19,0;;;;;7,0;1,0;;;;4,0;1,0;;;;;1,0;1,0;;1,0;;;8,0;1,0;4,0;;;;3,0;;;;;2,0;;;5,0;;1,0;;;;;;;;7,0;4,0;;4,0;1,0;;15,0;;;;;;;;;;;;;;;6,0;2,0;;;;;;;;;4,0;7,0;;;;1,0;4,0;121,0;;2,0;;12,0;2,0;3,0;;6,0;;3,0;;;22,0;1,0;10,0;3,0;2,0;;1,0;;;;;;;;;;;;;3,0;;;;;4,0;;2,0;;;;47,0;;2,0;;;6,0;;;;;;;;;;;;3,0;;;;1,0;;21,0;1,0;;;;;2,0;;;;;3,0;;;;;;;2,0;2,0;;;;;6,0;;;;;5,0;;;;2,0;;;;;7,0;2,0;3,0;;1,0;;7,0;;;1,0;2,0;;;;1,0;;;;;2,0;;;;;;1,0;;;;;;1,0;;;;;;1,0;5,0;;;;;;;1,0;;;;;;;;;;;;;;;;;;;;;;;;3,0;;;9,0;;7,0;5,0;;;;;;;1,0;;;;7,0;1,0;;;;;;;;;;26,0;;;3,0;;;;;;;;;1,0;;;;;;;;11,0;2,0;;;;1,0;;3,0;;;;;;;1,0;1,0;;;;;;;;;;;1,0;;;;;2,0;3,0;;;;;;;;;;;;;;;;;4,0;;;;;;;;;;;;;;;1,0;;;;1,0;;4,0;;;;;;1,0;;;;;;;;;3,0;;;;2,0;;;;;;;2,0;;5,0;;;2,0;;;;;;1,0;;;;;;2,0;;;;;;;;;;;;4,0;;;;27,0;7,0;;;;;;;;1,0;;;;;;;3,0;;;;;;;;;;;;;;;;;;;;;;;;;;25,0;;2,0;2,0;;3,0;;;;1,0;;;;2,0;;;;;;;;;;;;1,0;1,0;;;;;;2,0;;;2,0;;;;;;;;;;;;;;;;;;1,0;;3,0;1,0;4,0;;;;;;;;;;4,0;9,0;;;;;;;;;;;;;;;1,0;;;;;;;;;;2,0;;;;;;;;;1,0;4,0;;;;;;;;1,0;;;;;;;1,0;;;2,0;;;;;;;;;;;;;;;;;19,0;;;;;;;;;;2,0;;;;;;;;;;;2,0;;;;;;;;;;;;;;;;;;;;;;;;;;;;;;;;;;;;;;;;;;;;;;;;;;;;;;;;;;;;;;;;;;;
portable;;;;10,0;88,0;;3,0;36,0;1,0;40,0;2,0;;;;8,0;1,0;;;2,0;70,0;2,0;29,0;;;6,0;;;32,0;4,0;4,0;7,0;20,0;670,0;;82,0;;1,0;21,0;2,0;98,0;4,0;;;17,0;;;;3,0;;1,0;23,0;6,0;;4,0;5,0;96,0;81,0;;2,0;92,0;1,0;;80,0;;;;4,0;;;23,0;15,0;1,0;3,0;2,0;;5,0;;3,0;34,0;16,0;;8,0;18,0;1,0;;;;;;6,0;28,0;;;26,0;1,0;1,0;;16,0;20,0;3,0;42,0;106,0;;2,0;;;3,0;38,0;;;10,0;3,0;5,0;58,0;4,0;5,0;1,0;;11,0;98,0;;;;7,0;;1,0;19,0;10,0;;8,0;19,0;1,0;4,0;;1,0;1,0;22,0;50,0;4,0;7,0;;;5,0;3,0;1,0;3,0;14,0;50,0;1,0;;;8,0;10,0;2,0;2,0;10,0;14,0;68,0;15,0;12,0;;;;1,0;1,0;6,0;2,0;32,0;1,0;7,0;38,0;;63,0;14,0;18,0;4,0;3,0;7,0;;;4,0;1,0;2,0;;1,0;9,0;6,0;5,0;;24,0;;;;32,0;4,0;;;;12,0;8,0;1,0;;;12,0;8,0;1,0;;1,0;;34,0;;;5,0;1,0;;13,0;23,0;1,0;3,0;;;8,0;2,0;2,0;1,0;;7,0;;;1,0;2,0;9,0;;3,0;2,0;2,0;;2,0;1,0;;25,0;;1,0;3,0;5,0;2,0;8,0;;;;;;3,0;25,0;;2,0;4,0;6,0;2,0;3,0;;2,0;2,0;4,0;5,0;1,0;3,0;;;2,0;;;1,0;14,0;1,0;15,0;;;1,0;9,0;4,0;1,0;;3,0;;13,0;7,0;16,0;9,0;5,0;;5,0;1,0;;;;;23,0;5,0;;;;6,0;1,0;2,0;2,0;;;5,0;1,0;1,0;;;;2,0;;;;;;;17,0;17,0;16,0;;12,0;;4,0;10,0;1,0;59,0;;;;;1,0;;3,0;;;;11,0;1,0;;;3,0;;;1,0;;25,0;14,0;35,0;;2,0;;;;;13,0;1,0;;;;9,0;;2,0;;11,0;;;;;;16,0;11,0;3,0;;;1,0;3,0;;;8,0;;;;;6,0;18,0;3,0;13,0;1,0;1,0;2,0;1,0;2,0;7,0;;;5,0;;;;;;;7,0;1,0;3,0;;2,0;;2,0;24,0;7,0;1,0;;12,0;;18,0;8,0;2,0;20,0;16,0;15,0;1,0;3,0;1,0;5,0;;;13,0;;;1,0;;;4,0;18,0;2,0;;4,0;;;10,0;1,0;3,0;;;;;1,0;1,0;2,0;1,0;;1,0;6,0;2,0;;;;;2,0;;4,0;1,0;2,0;;;20,0;;6,0;10,0;;6,0;;4,0;2,0;;;11,0;;1,0;21,0;5,0;4,0;;;1,0;3,0;6,0;5,0;24,0;4,0;;1,0;;;5,0;5,0;;2,0;;4,0;;;;2,0;3,0;;;6,0;67,0;14,0;;1,0;;;4,0;;;4,0;;;6,0;;;7,0;12,0;;4,0;;;;;23,0;76,0;;;1,0;;7,0;;;9,0;4,0;1,0;1,0;2,0;13,0;;;6,0;;5,0;;1,0;3,0;4,0;;6,0;;;;11,0;;;;1,0;3,0;21,0;3,0;;;3,0;2,0;;;;;10,0;;3,0;372,0;;;;2,0;39,0;;;2,0;6,0;;;2,0;1,0;;;1,0;;;14,0;;;;;;6,0;;;;;;2,0;3,0;2,0;;;;;2,0;1,0;;;;5,0;;;6,0;1,0;;;;7,0;;1,0;;3,0;1,0;2,0;15,0;;2,0;1,0;;;;;6,0;;;1,0;;;;;5,0;;2,0;;;1,0;1,0;;;;;;;;12,0;;1,0;;3,0;;;;;;1,0;;;;1,0;;;;;;;;;;;1,0;;;;;;;;;;;5,0;;2,0;;13,0;;;;;;;9,0;;;1,0;3,0;;4,0;;;;;;;4,0;;;;;1,0;;2,0;;;;;;;;;;;6,0;;;;;;;3,0;2,0;1,0;;;;;;;1,0;;;;1,0;;;;4,0;1,0;;3,0;2,0;1,0;;;7,0;;;;;;;1,0;;4,0;;12,0;2,0;2,0;4,0;;;3,0;;;;;2,0;1,0;3,0;;;;;;3,0;;;;;;;;;;6,0;;1,0;;;2,0;;;2,0;;1,0;;;1,0;;4,0;;;;1,0;;13,0;1,0;;;;;;;;;;;;;1,0;1,0;1,0;3,0;;;1,0;2,0;;;;;2,0;5,0;;;3,0;;;;;;;1,0;;;;;;;;2,0;;1,0;;;;;1,0;;2,0;;;5,0;;;;;;;;;;;;1,0;;1,0;;;;;;;;;5,0;;1,0;;;3,0;2,0;;;;1,0;;;;;;;;;;;;6,0;;;;;;2,0;;;;;;;;;;;;;;;1,0;;;;;;;;;;;;;;3,0;;;;6,0;;1,0;;;;;1,0;;;3,0;;;;
recognition;;;;3,0;14,0;;;41,0;5,0;6,0;;;;1,0;1,0;1,0;;1,0;5,0;19,0;1,0;12,0;7,0;;;;;22,0;;15,0;13,0;10,0;101,0;;7,0;2,0;;12,0;1,0;16,0;14,0;;;2,0;;;;;12,0;;23,0;5,0;;2,0;;158,0;18,0;1,0;;7,0;;;43,0;;;;;;;5,0;18,0;;;;;1,0;;;23,0;;1,0;22,0;6,0;1,0;1,0;;3,0;2,0;;8,0;4,0;;1,0;16,0;2,0;;;;15,0;;3,0;74,0;;;1,0;;;42,0;3,0;;7,0;6,0;1,0;;;;;;6,0;;;;;;;;3,0;;1,0;1,0;;;;;;2,0;;;;;1,0;;;198,0;;;1,0;1,0;;;;;2,0;;;2,0;;1,0;;;;;;;;;;4,0;;;;;10,0;1,0;4,0;;;1,0;;;;;;;;2,0;;9,0;;;;;;11,0;;;;;5,0;1,0;;;;;;2,0;;;;1,0;;;;;;4,0;2,0;;;;;;;1,0;;;;;;;;;;;14,0;4,0;;2,0;24,0;10,0;;;;;;5,0;;2,0;;;;;;4,0;;;;;3,0;;;;3,0;;;;;;;;;;;;;3,0;;;;;;;;;;3,0;;53,0;2,0;;1,0;;;43,0;;;;25,0;;;4,0;;3,0;;4,0;;;;;;3,0;;;;;;;;;;;;;;;2,0;;;;;6,0;;;;;;2,0;;2,0;;;4,0;5,0;;1,0;;;6,0;;1,0;;2,0;2,0;1,0;;1,0;;;;;;;;2,0;8,0;;4,0;;;;4,0;;;12,0;1,0;2,0;2,0;;;;2,0;5,0;;6,0;;;6,0;;;3,0;;4,0;;1,0;;;;12,0;2,0;;19,0;2,0;3,0;;;;;;3,0;;;2,0;;1,0;;;5,0;;8,0;;77,0;6,0;1,0;12,0;4,0;;;3,0;;3,0;;;1,0;;1,0;;;1,0;1,0;;;2,0;;;;11,0;;;;;7,0;10,0;4,0;;;;6,0;;;;;;;;3,0;1,0;;;1,0;;;55,0;;;;6,0;;;;92,0;1,0;1,0;;;3,0;;2,0;;;2,0;8,0;9,0;;3,0;11,0;1,0;;;;1,0;1,0;;8,0;5,0;;;;;;;;;1,0;6,0;3,0;;;1,0;4,0;;;;1,0;3,0;;;;;2,0;;;;;1,0;;;;1,0;;3,0;;1,0;;;;;;;;;7,0;;;;;;1,0;;;8,0;;;;;;1,0;1,0;;;;;3,0;28,0;;;;;3,0;;;;;8,0;2,0;;3,0;;;;1,0;;;5,0;4,0;;;;;;;;;;;;;;;;;;;;;;;2,0;;;;;4,0;;;;;;;;;;;;;;;;;;;;;;;;3,0;;;;;1,0;;;;;;;;2,0;1,0;;;;;;;;;;;;;;;1,0;2,0;;;;;;;;2,0;;;;;;;;;3,0;;;;;;;;;;;;;;;;;15,0;;;;;;;;;6,0;;;;;;;;6,0;;;;2,0;3,0;2,0;;;;;;1,0;;;20,0;;2,0;2,0;;2,0;;;;;;;;1,0;;;;;1,0;;;;3,0;1,0;;;;;;4,0;;;;;4,0;;;;3,0;;;1,0;3,0;;;2,0;1,0;3,0;;;;;29,0;;;;;;;;1,0;;;;;;;;;;;;5,0;;;;;;;;;;;;;;;;;3,0;;;;;;;;2,0;;1,0;;;;10,0;;;;;;;;;;;;;;;;;;;;;1,0;;;;;;2,0;;;;;;;;;;;;;;;;;;;;;;;;;;;;;2,0;;;;;;;;1,0;;;;;;;;;;;;;;;;;;2,0;;;;1,0;;;;;;12,0;;;;;;7,0;;;;;3,0;;;;;;;;;;;;;;4,0;;;;;;;;;;;;2,0;;;;;;;;14,0;;;;;;1,0;1,0;;4,0;;;;4,0;;;;;
representation;;;;1,0;1,0;;;22,0;3,0;15,0;;5,0;1,0;11,0;22,0;1,0;;;;1,0;;6,0;;;;;;27,0;6,0;23,0;1,0;22,0;12,0;2,0;86,0;6,0;;1,0;;48,0;;;;1,0;;;;1,0;1,0;;1,0;24,0;;;;206,0;17,0;3,0;;;1,0;;45,0;;9,0;;1,0;;;;5,0;;2,0;;;;;4,0;32,0;;;7,0;4,0;1,0;;;6,0;;2,0;19,0;23,0;;;20,0;5,0;4,0;;2,0;19,0;;6,0;20,0;;;;;1,0;3,0;;;10,0;;18,0;3,0;;;;;2,0;2,0;;;;3,0;;;2,0;;;;2,0;4,0;;;1,0;;;;;;;4,0;;;2,0;;9,0;8,0;;;;;1,0;;2,0;;;;;6,0;3,0;;;;;;1,0;9,0;;;;;;;6,0;;;3,0;;;;1,0;;;;;;33,0;;28,0;;;6,0;3,0;;;;;;;;6,0;;;;;;;4,0;1,0;;;;;;15,0;6,0;;;;;1,0;;5,0;;;;;;;;;;;;;;;5,0;;;;;;;;;9,0;;;1,0;;;1,0;;10,0;;6,0;;;1,0;;1,0;;;;;;;;;;;;;6,0;6,0;;;;;;;;;;;86,0;;;;;1,0;1,0;;;4,0;;;;;;3,0;;2,0;;;;;;1,0;;;;;;;;;;;;;;;6,0;;;;;22,0;;;;;;1,0;;;;;8,0;;;;3,0;;1,0;;;;;;;;;;;2,0;;17,0;;;;1,0;3,0;;;;;;;;;;1,0;4,0;;;3,0;;;;3,0;;2,0;;;;1,0;;5,0;;2,0;;;;5,0;;;;;1,0;;3,0;;5,0;1,0;;;;1,0;;7,0;;3,0;6,0;;4,0;;9,0;;;8,0;;;5,0;2,0;6,0;16,0;;;;;6,0;;;;;;;4,0;;;;3,0;;8,0;3,0;;;1,0;38,0;;;2,0;;;1,0;1,0;;;9,0;;;4,0;;;21,0;;;3,0;;;;1,0;17,0;;1,0;2,0;;;;;;;4,0;;3,0;;;;;;19,0;47,0;;;5,0;;;;3,0;;;;;;;;;;;8,0;1,0;;;;2,0;;;;1,0;4,0;;;1,0;;;;;;;;;2,0;;;;;;1,0;;;;;2,0;;;1,0;4,0;;;1,0;2,0;;1,0;;;;57,0;;;;;1,0;2,0;;;7,0;;;4,0;;;;;;;;;;;2,0;7,0;;;1,0;;2,0;;;;;9,0;1,0;3,0;;;;;;;;;;;;;;;;;;2,0;;;;;;;;;1,0;;;;;3,0;;;;;3,0;;;;;;;6,0;;;;;;;;8,0;;4,0;;;;;;;;;1,0;1,0;;;;;;;;;;;;;;;;;;;;;;;1,0;;;;;;;;;;;1,0;;;8,0;2,0;;7,0;;;;;;;2,0;;1,0;;;;;1,0;;;;;;;;;2,0;;;;;;;;;2,0;;;3,0;;;;;;;;;;;1,0;;;;;;;;14,0;;;;;;;;;;;;;;;;7,0;;;;;;;;;2,0;4,0;1,0;;;;;4,0;;;;1,0;;;2,0;9,0;;;;;;1,0;;;;;2,0;;15,0;3,0;6,0;;;;2,0;;;;1,0;;;;;;;;;;;;22,0;3,0;;;;;;;;;;;4,0;4,0;;;;;;;;;;;3,0;;;;;3,0;;;1,0;;;;;3,0;;;;;;;;;;3,0;;;;;;;;;;;1,0;;;;;;;3,0;;;;;;;;;;;;;1,0;;;;;;;;;;;;;3,0;2,0;;;;;;;;;5,0;13,0;;;;;;;;;;;;;1,0;;;;;;;;;;;;;;;;;;;;;;;;;;;;;;;;;;;;;;;;;;;;;;;;;;;;;;;
resolution;;;;1,0;8,0;;2,0;30,0;4,0;44,0;;2,0;;;36,0;2,0;1,0;1,0;1,0;2,0;;18,0;3,0;5,0;9,0;1,0;;107,0;9,0;6,0;1,0;36,0;43,0;11,0;41,0;3,0;;6,0;8,0;27,0;3,0;1,0;;5,0;;;;3,0;5,0;6,0;3,0;35,0;1,0;2,0;;520,0;17,0;3,0;3,0;33,0;2,0;1,0;60,0;;16,0;1,0;10,0;1,0;7,0;3,0;24,0;3,0;;5,0;;1,0;;2,0;34,0;1,0;;20,0;4,0;8,0;1,0;1,0;21,0;;2,0;20,0;56,0;2,0;71,0;19,0;11,0;27,0;;14,0;15,0;1,0;;43,0;;14,0;2,0;;;90,0;;;2,0;2,0;26,0;14,0;;;;3,0;;;;;;6,0;;;6,0;;;;;16,0;;;;7,0;;;;;;;;6,0;12,0;1,0;1,0;74,0;2,0;;4,0;;;;6,0;;;;1,0;26,0;;35,0;;;;;20,0;6,0;;;;;4,0;;8,0;;;25,0;;;;2,0;;;;2,0;1,0;62,0;;10,0;;;;8,0;;;;2,0;3,0;5,0;;;;;;1,0;6,0;;;1,0;5,0;;;7,0;;28,0;3,0;;;;;;;;;4,0;3,0;;;;;;;4,0;20,0;8,0;;4,0;79,0;;1,0;;3,0;;;2,0;;1,0;;1,0;2,0;13,0;;;;;;17,0;2,0;;4,0;6,0;2,0;;;;1,0;;;;;;;3,0;;5,0;;;4,0;1,0;;;;;;15,0;8,0;15,0;1,0;;;2,0;;6,0;;;;3,0;;;1,0;;29,0;;2,0;;;10,0;1,0;;4,0;9,0;;;;;;;;;;;;;;42,0;;;;;1,0;4,0;;;2,0;;4,0;9,0;3,0;1,0;;8,0;;5,0;4,0;3,0;1,0;2,0;;7,0;;;3,0;;;2,0;1,0;;;;;;;;13,0;1,0;;;1,0;6,0;2,0;;2,0;1,0;4,0;4,0;1,0;8,0;;;;;3,0;;;;63,0;7,0;;14,0;;;;;1,0;11,0;1,0;23,0;;1,0;;;;1,0;19,0;;;14,0;;;;2,0;;10,0;;3,0;20,0;;8,0;;15,0;;;2,0;13,0;;1,0;2,0;;14,0;7,0;34,0;;;;;3,0;;;;;;;;;1,0;56,0;14,0;12,0;;;2,0;8,0;10,0;;4,0;;;2,0;;;13,0;;7,0;;17,0;2,0;2,0;5,0;;;35,0;;;1,0;;;;;;;6,0;;;;;10,0;12,0;1,0;11,0;;;3,0;;49,0;9,0;24,0;;9,0;2,0;;;2,0;1,0;6,0;;;;2,0;;;;;3,0;5,0;;;;;7,0;;;1,0;2,0;;4,0;2,0;;20,0;;;;1,0;;24,0;1,0;;;1,0;;;26,0;;;;;;1,0;;;6,0;;;3,0;2,0;;14,0;;;60,0;69,0;1,0;;;;;;;;;;;;4,0;;;;1,0;;;1,0;2,0;5,0;;2,0;25,0;;;1,0;;2,0;;;;7,0;;1,0;;1,0;;;;5,0;;;;;41,0;;;;1,0;;;;6,0;2,0;1,0;;3,0;;;11,0;6,0;;;;;;;;;;1,0;;;;;;;;1,0;;;;;;1,0;;;;;;;;;;;2,0;;;;;;;;;;;;;;;;4,0;4,0;;113,0;;1,0;;;7,0;4,0;;;;;;;;;2,0;2,0;8,0;;;9,0;;1,0;2,0;;;;1,0;;;;;12,0;;1,0;;3,0;3,0;1,0;;;;;;;;;1,0;;1,0;;;;;;2,0;9,0;;2,0;;;1,0;1,0;1,0;1,0;;3,0;;3,0;;22,0;2,0;;;;;;2,0;2,0;;3,0;1,0;1,0;1,0;;1,0;1,0;;3,0;;;4,0;;2,0;;;1,0;6,0;;;8,0;;;;;2,0;;5,0;2,0;;5,0;;;;;;;1,0;4,0;;;;;;;;;;5,0;;9,0;;6,0;;;;;;;;1,0;8,0;;;;5,0;1,0;;;;;;;;1,0;1,0;;;;;;;;;;;;1,0;;;;;;;;;1,0;;13,0;;;;;;;1,0;;;;;;22,0;;;1,0;;;;;;1,0;;;;;;;;;;;;;;;;;9,0;2,0;1,0;;;1,0;23,0;;;;;1,0;;;1,0;;1,0;;;1,0;;;;;;1,0;;13,0;;;;2,0;;;3,0;;;3,0;;;;;;;;;;;5,0;;;;;;;;;;;;;;;;;;;;;1,0;;;;;;;;1,0;;;;;;1,0;;;;;;;;;;;;;;;4,0;2,0;;;;;;
rule;;;;3,0;1,0;;;25,0;;;;1,0;;;;2,0;;;;2,0;;;;1,0;8,0;;;;;4,0;2,0;9,0;4,0;;;;;;;1,0;;1,0;;;;;;;2,0;;;1,0;;;;9,0;21,0;;;;;;28,0;;;;;;;1,0;1,0;3,0;;;;;;3,0;4,0;;;;1,0;;;;1,0;1,0;;5,0;;;;;;;;1,0;1,0;;12,0;9,0;;;;;;4,0;;;;;;;;;;;;;;;1,0;;;;1,0;;;;;2,0;;;;;1,0;;;;;9,0;;;;;2,0;4,0;;;;;;;;;;;;;;;;;;;;;;;;;3,0;;;;;2,0;;;;;;;;;;6,0;;;;;;3,0;;;;;;;;;;;;1,0;;;7,0;;;;;;;2,0;;;;;;;;;;;;;;;;;;;;;;2,0;3,0;;;;;;;;;;;;;;;;;;;17,0;;;;;;;;;;;;;;;;;;;;;;;;;;;;11,0;;11,0;;;;;2,0;;;;;;;;;;2,0;;;;;;;;;;;;;;;;;;;1,0;;;;;;;;;2,0;1,0;;;;;;;;;;2,0;;;;2,0;;;;3,0;;1,0;3,0;;;;;1,0;;;;;;;3,0;;;;;1,0;;;;1,0;2,0;;;;;;;;;1,0;;;1,0;1,0;;;;2,0;;;;;;9,0;;;2,0;;;;;;8,0;12,0;;;;;;1,0;;7,0;;;1,0;;1,0;;;;;;;;13,0;10,0;;;;;;;;;2,0;;;12,0;;;;;;;1,0;;;;;;;;;;;;;3,0;;;;4,0;;;;1,0;;1,0;;;;;;;;;;;;;;;;3,0;;;;;;;9,0;;;;;;;;;;;;;;;;;;;;;;;;;1,0;;;;;;;;;;;;;;1,0;;;;;;;;6,0;;;;;;5,0;;;2,0;;;;1,0;;;;;;2,0;;;;;;2,0;;;;;;;;;;;;;;;;1,0;;;1,0;;;;;;;;;;;;;;;;;;;;;;;;;;;;;;;;;;1,0;;;;;;;;;;;;;;1,0;;;;;;;;;;;;;;1,0;;;15,0;;;;;;;;;;;;;;;;;;;;;;;;;;;14,0;;8,0;;;;;;;;;;;;;;;2,0;;;;;;1,0;;;;;;;;;;;2,0;;;;;;;2,0;;;4,0;;;;;;;;;;;2,0;;;;;;5,0;;;;;;2,0;;;;2,0;;;;;2,0;;;;;;;;;;;;;;;2,0;;;;;;;;;;;;;;;;;;;;;;;;;;;;;;;;;;;;;;;;6,0;;;;;;;;;;;;;;;;;;;;;;;;;;;;;;;;;;;;;;;;;;;;1,0;;;;;;;9,0;;;;;;;;;;;;;;;;;;;;;;;;;;;;;;;;;;;;;;;1,0;;;;;;;;;;;;;;;;;;;;;;;;;3,0;;;;;;;;;;;;;;;;;;;;;;;;;;;;;;;;;;;;;3,0;;;;;;;;;;;;;;;;;;;;;;;;;;;;;;;;;;;;;;;
selectable;;;;2,0;6,0;;;4,0;;1,0;;;;;;10,0;;;2,0;;4,0;4,0;;;;;;7,0;;;;1,0;4,0;;13,0;;3,0;2,0;;44,0;;;1,0;26,0;;;1,0;;;;;2,0;;3,0;;77,0;19,0;;;4,0;;;9,0;;;;;;;;1,0;;;;;4,0;1,0;1,0;5,0;;;36,0;;;;;1,0;;;27,0;3,0;4,0;7,0;1,0;3,0;;;5,0;8,0;;1,0;9,0;;4,0;1,0;;11,0;27,0;;;2,0;5,0;12,0;;;;;;;;;;3,0;;;;5,0;;;;;;;;;;;;;1,0;;;;1,0;1,0;;;5,0;;;;;;;;;;;2,0;9,0;;;;;;;;2,0;;;1,0;3,0;4,0;10,0;;;;6,0;;;;;;;;;4,0;75,0;;3,0;;;;3,0;;;;;;;;;;1,0;;;;;1,0;2,0;;;;;;8,0;;;;;;;;;;;;;;;;;;;3,0;20,0;;;1,0;2,0;;;;;;;;;;;;13,0;;;;;;;;;;;;;;;;;;;;;;;1,0;15,0;;;;;;;;2,0;;;1,0;2,0;1,0;;;;;;;;;;;;;;3,0;;;;;;;;9,0;14,0;;;;;;;;;;;;;;;;14,0;2,0;;55,0;;;;;;;;;;;3,0;;;;;;;;4,0;;1,0;;;;;;;;;;;;;25,0;;;;;;;;;;6,0;2,0;;;;;;1,0;;;;;4,0;;;8,0;;;;;;1,0;;7,0;4,0;;;;;;;;;;1,0;;1,0;;;;15,0;2,0;;;6,0;;2,0;;;1,0;45,0;;1,0;;6,0;1,0;;;;;;;;;;;;11,0;;;1,0;2,0;;;4,0;;;;;;;;1,0;;2,0;;;3,0;;2,0;;;;;7,0;;;;;;;;;;;;;6,0;;5,0;;3,0;;25,0;;5,0;;1,0;;;3,0;6,0;;;;;;;;1,0;;;;11,0;;;;;;;;1,0;;;;;;4,0;;1,0;;;1,0;;;;;;;;;;;;;;;1,0;4,0;;;;1,0;;1,0;;;;;;3,0;;;;;;28,0;;;;4,0;;;;;;;;;;;;;;;;;;;;;;;;;;;;;;;;;;;;;;2,0;;;;;;;;;;;;;;;;;;;;2,0;;;;;;;;;;;;;;;;2,0;;;;;;;;;;;;;;;;;;;;;2,0;;;;;;;;;;;2,0;;;;;;;;;;;;;;;;;;;;;;4,0;;1,0;;;;;;;;;;;;;;4,0;1,0;;;;2,0;;;;;1,0;;;;;;;;8,0;;;;;;;;;;;;;;;;;;;;;;;;;;2,0;;;;;;;;;;;;;;;;;;;;;;;1,0;1,0;;;;1,0;;;;;;;;;;;;;;;;;;;;;;;;;;;;;;;;;;;;;;;;;;;;;;;;;1,0;;;;;;;2,0;;;;;;;;;;;;;;;;;;;;;;;;;;;;;;;;;;;;1,0;;;;;;;;;;;;;;;;;;;;;;;;;;;;;;;;3,0;;;1,0;;;;;;;;;;;;;;1,0;;;;;;;;;;;;;;;;;;;;;;;;;;;;;;;;;;;;;;;;;;;;;;;;;;3,0;;;;;;;;;;;;;;;;;;;;;;;;;;;;
shot;;;;1,0;10,0;;;35,0;2,0;12,0;2,0;;;;;3,0;;;;1,0;16,0;11,0;;1,0;1,0;;;51,0;1,0;13,0;4,0;15,0;52,0;;32,0;;;6,0;;42,0;3,0;;;2,0;2,0;27,0;;3,0;3,0;;2,0;4,0;4,0;;;442,0;28,0;;3,0;2,0;;8,0;13,0;;;;18,0;;;33,0;;6,0;9,0;1,0;;1,0;;6,0;43,0;;;19,0;1,0;5,0;1,0;;;;4,0;7,0;6,0;;45,0;11,0;12,0;;;14,0;28,0;;;6,0;;;;;;22,0;;;;2,0;;;2,0;;;;;;;;1,0;1,0;;;6,0;;;;3,0;3,0;;;;1,0;;;;;;;7,0;17,0;;;1,0;28,0;;;;;2,0;;;;;1,0;;9,0;;;;;;;2,0;6,0;;;;;15,0;1,0;;3,0;;4,0;;;1,0;;;;;7,0;;34,0;;5,0;;;;3,0;;;;;;;;;;1,0;;;2,0;;;;;;;;2,0;16,0;2,0;;;;;;1,0;;;;;;;;;;;;1,0;6,0;;;13,0;;;;;;;1,0;;;;;;;;4,0;;;;5,0;3,0;;;4,0;;;;;1,0;;;;;1,0;;;;1,0;;;;;;;;;;7,0;;48,0;;;;;;;;;;10,0;;;;;18,0;1,0;;;;4,0;;;2,0;3,0;;;;;;;;;;;;;;;;;;;10,0;;;;;;;1,0;;;;4,0;;1,0;;1,0;;2,0;;2,0;2,0;1,0;;2,0;3,0;;;;;;;2,0;;;10,0;;;;;;2,0;;;;11,0;2,0;;;;1,0;;5,0;2,0;;;;8,0;;;22,0;3,0;;;;36,0;30,0;9,0;10,0;;;2,0;;6,0;;;;1,0;15,0;2,0;2,0;;7,0;;;;;1,0;;;;3,0;;;;8,0;;3,0;6,0;5,0;6,0;1,0;;;;;;;;1,0;;2,0;3,0;;;1,0;;;2,0;8,0;;;1,0;4,0;46,0;;;1,0;2,0;4,0;;2,0;;;;;2,0;;;4,0;;4,0;3,0;;;;;4,0;;1,0;1,0;;;1,0;;;4,0;3,0;;;6,0;;1,0;;2,0;1,0;6,0;;;1,0;2,0;;;;6,0;4,0;;;;;;;;;1,0;8,0;;;2,0;6,0;;;;;;;;;;;;;;;1,0;2,0;16,0;;;;;;3,0;;;;;;;;;;;;;1,0;;12,0;;;1,0;;;;24,0;;;;;;2,0;;4,0;;;;;;;;;;;16,0;;2,0;;;1,0;;;;;;;;;;;;;;;11,0;;;;;;;;;;;;;;;;;;;;1,0;;;;;;;;;;;;;2,0;3,0;;;;;;;;;;;;;;1,0;1,0;;;;;;;;;3,0;;;;;;;;;1,0;1,0;;;;;;;2,0;;;;;;;2,0;;;1,0;;;;;;;4,0;;;;;;;;;;;;;;;;;;;;40,0;2,0;;;;;;;;;;;;5,0;;;3,0;;3,0;2,0;;;8,0;;;;;;;;;1,0;;;;;;;;1,0;;2,0;1,0;;;2,0;;;;;6,0;4,0;;;;2,0;;;;;;;2,0;;;;1,0;;;8,0;;;;;;;;;;2,0;;;;;;;;;;;;;;;;;;1,0;;;;;;;;;;;;;2,0;;;;;;;5,0;;;;;4,0;;;;;;2,0;;;;;3,0;;;1,0;;32,0;;;;1,0;;;;;;;;;;;;1,0;;;;2,0;;;;;;;;;;;;;;;;;;;;1,0;;;;;;;;;;;;;;;;;;1,0;;;;;;;;;;;;;;;17,0;;;;;;;;;;;;;;;;;;1,0;;;;;;;;2,0;;;;;;;;;;;;;;;;;;;;;;;;;1,0;;;;;;;;;;;;;;;;;;;;;;;
sound;;;;4,0;45,0;;;17,0;;13,0;1,0;;;;4,0;;;;8,0;3,0;;13,0;;;;;;51,0;;62,0;19,0;6,0;35,0;1,0;3,0;;2,0;42,0;;76,0;;;1,0;;8,0;;;1,0;;11,0;1,0;29,0;1,0;;;102,0;22,0;;1,0;1,0;;;28,0;;;1,0;34,0;;2,0;4,0;;14,0;;;;;;8,0;17,0;14,0;1,0;14,0;5,0;5,0;;;;;;24,0;4,0;;7,0;71,0;;;;;5,0;;4,0;11,0;;;;6,0;;45,0;;;;3,0;;;;;;;12,0;3,0;;;;15,0;;20,0;21,0;;;3,0;1,0;12,0;;;3,0;22,0;;;;6,0;;;2,0;2,0;1,0;;11,0;6,0;;;;;4,0;1,0;;;4,0;1,0;;;;;;;;;24,0;4,0;;;4,0;2,0;3,0;1,0;;1,0;;34,0;;;10,0;;;;;20,0;;21,0;;10,0;;;;23,0;;3,0;;;;2,0;;;;1,0;;;;;;7,0;;;;;;7,0;8,0;2,0;;;;;5,0;;;;;;;;;;;;3,0;;;;;;;;;;;;;;;;;;;;;;;4,0;2,0;;;;;;;;;;;;1,0;4,0;;;;3,0;;;;1,0;;;;;;4,0;;6,0;9,0;;;;;4,0;1,0;;;26,0;;;1,0;;2,0;1,0;;;;3,0;;;;;;;;;;;;;;1,0;;;;141,0;;;;;9,0;;;;;;;;3,0;;;6,0;;;;;;;;2,0;;8,0;;;;;;;;;;;;;;12,0;;5,0;;;;3,0;;;7,0;11,0;;4,0;;;;;;6,0;;;;1,0;3,0;35,0;;3,0;;;5,0;;7,0;4,0;3,0;;1,0;;;;;;;1,0;;;;;;2,0;;;1,0;;12,0;;10,0;;15,0;2,0;16,0;;63,0;;;1,0;;;20,0;;1,0;;1,0;;40,0;;;;;;;2,0;;4,0;;;;6,0;1,0;3,0;1,0;;;;1,0;;12,0;;;;62,0;31,0;;;;;;7,0;;;;;;;8,0;11,0;;;;2,0;;;1,0;1,0;1,0;8,0;;2,0;;;;3,0;;;;;;;;10,0;;;;;;;;;;;8,0;;;;3,0;;;;;;;2,0;;;;;;;;;24,0;;;;;;;;;;;;;1,0;;;;;;;3,0;;;2,0;;7,0;;;;;;;5,0;22,0;;;;3,0;;;;;;;;9,0;;;3,0;;;;;;9,0;;;;;1,0;;;;;;8,0;;;;;;;;;;;;;;;4,0;;3,0;;;;;;;;;;;;;;;;;1,0;;;;;;;;;;;;4,0;;1,0;;;;;;;;;;;;;;2,0;;;;;;;;;;;1,0;;;;;;;;;;;;;;;;;;;;;;2,0;;;;;;;;;;;;;;;4,0;;;;;;;;;;;;;;;;;;;;;1,0;;;;;;1,0;;;;8,0;;;6,0;;;;;;;;;;;;1,0;;;;;;;;;;;;;;;;;1,0;;;3,0;;;;;;;;3,0;;;;;1,0;;;;;2,0;;;;;;;;;;;;;;;;;;;;1,0;;;;;;;;1,0;;;;;;;1,0;4,0;7,0;;;;;1,0;;;;;;3,0;2,0;;3,0;;;;;;;;;;;;;;;;;13,0;;;;;;;;;;;;;;;1,0;;;;;;;1,0;;;;;;;;;;;;;;;;;;;;;;;;;;;;;;;;;;;;;;;;;;;2,0;;4,0;;;;;;;;;;;;;;3,0;;;;;;;;;;;;;;;;;;;;;;;;;;;;;1,0;;;;;9,0;;;;;;;;;;;1,0;;;;;;;;;;;;
speaker;;;;2,0;9,0;;;14,0;;10,0;;;;;1,0;1,0;;;;2,0;;10,0;;;;;;8,0;;3,0;4,0;5,0;12,0;;1,0;;1,0;;;26,0;;;;;;;;;;;3,0;1,0;;1,0;;6,0;16,0;;;2,0;;;4,0;;;;;;;;;;;;;;;;15,0;;;6,0;2,0;1,0;1,0;;;;;1,0;3,0;;4,0;3,0;;;;;1,0;;9,0;5,0;;;;;;9,0;;;;1,0;3,0;4,0;;;;;3,0;6,0;;;1,0;2,0;;;2,0;;;8,0;1,0;;;;2,0;;;;;;;;;5,0;;;2,0;;;2,0;;;;;1,0;;1,0;3,0;;;;;;;;;1,0;4,0;;;;;;1,0;2,0;;1,0;23,0;;;6,0;1,0;;;;1,0;;;;26,0;;;;9,0;;;;;;;;;;;;;;;;;;;;;;;3,0;;;;;;;;;;4,0;;;;;;;;5,0;1,0;;;1,0;;;;1,0;;2,0;;;;;;;;;7,0;;;;;;;;;;;;;;;;2,0;;1,0;;;;;;;;3,0;;;;;;;;;;;;;;;;;;;;;13,0;;;;;;;;1,0;;;1,0;;;;;;;;;;;;;;;;;;;3,0;;;;4,0;;;;;;;;;;;;;;;;;1,0;;;;;;;;;;;;;;;;;;;;;;;2,0;;;;;;;;;;;;;;1,0;1,0;;;;;;1,0;;;;;3,0;;;;;;;;;15,0;;1,0;;;3,0;2,0;;;;;1,0;2,0;;6,0;15,0;17,0;;;;;;;;;1,0;;;;25,0;;;;;2,0;;;;;;2,0;;2,0;;;;;1,0;;1,0;;;;;;33,0;;;;;2,0;;;4,0;;;;;;1,0;1,0;;;;;;3,0;3,0;;;8,0;20,0;;;1,0;7,0;;;;2,0;;;;;1,0;;;;;;1,0;;;;;6,0;;2,0;;;;;;;;;;1,0;;;;;;;;;;;;;;;;;1,0;;;;;;;;;;;2,0;;;;;;;;;;;1,0;;;;;;;;;;;;;;15,0;;;2,0;;;11,0;;;;;2,0;;;;;;;;1,0;;;;;;;;;;;;;;;;;;4,0;;;;;;;;;;;;;;;;2,0;1,0;;;;;;;;;;;;;;;;;;;;;;;;;;;;;;;;;;;;;;;1,0;;;;;;;;;;;;;;;;;;;;;;;;;;;;;;;;;;;;1,0;;;;;;;;;;;;;;;;;;1,0;;;;;2,0;;;;;;;;;;;;;;;;;;;;;;;;;;;;;;;;;;;;;;;;;;;;4,0;;;;;;;;;;;;;;;;;;;2,0;;;;;;;;;;;;;;;;;;;;;;;;;;;;;;;;;;3,0;;;;;;;;;;1,0;;;;1,0;;1,0;;;1,0;;;;;;;;;;;;;;;;;;;;;;;;;;;;1,0;;;;;;;;;;;;;;3,0;;1,0;;;;;;;;;;;;;;;;;;;;;;;;;;;;;;;;;1,0;;;;;;1,0;;;;;;;;;;;;3,0;;;;;;;;;;;;;;;;;;;;;;;;;;;;;;;;;;21,0;;;;;;;;;;;;;;;;;;;;;;;
square;;;;1,0;3,0;;;8,0;4,0;1,0;10,0;;4,0;;2,0;;;;7,0;2,0;4,0;;5,0;2,0;;;;3,0;;1,0;;12,0;5,0;8,0;4,0;;;2,0;;1,0;5,0;;1,0;9,0;12,0;;1,0;3,0;2,0;;2,0;;;13,0;1,0;24,0;5,0;;4,0;13,0;;;18,0;3,0;;1,0;;;;;2,0;;;;2,0;;1,0;4,0;7,0;2,0;;3,0;;;;;2,0;;;5,0;;;;2,0;2,0;;;;1,0;;4,0;5,0;;;;;;6,0;30,0;;;2,0;;2,0;;;;1,0;1,0;5,0;;;;;;;2,0;;;;3,0;;;;;;;;;;;;;2,0;2,0;;14,0;7,0;;;;;;;;1,0;;;;;;;2,0;;;;;5,0;;;4,0;;3,0;3,0;;4,0;2,0;;;;;1,0;2,0;;;2,0;4,0;8,0;;12,0;;;;;6,0;;;;;;;29,0;;20,0;;;2,0;;6,0;;;;;;2,0;3,0;;;;;1,0;;;;2,0;1,0;3,0;;;;;;;;;1,0;;2,0;11,0;;;;1,0;;1,0;;;;;5,0;8,0;;;5,0;;;1,0;7,0;;2,0;;;2,0;;3,0;;2,0;;;1,0;;1,0;;;;1,0;;;;1,0;;3,0;;;;4,0;4,0;1,0;;1,0;;1,0;4,0;9,0;;;;;;;;;;;2,0;1,0;;2,0;;;2,0;;;;;;;;1,0;;;2,0;;;;;;;1,0;;;;;;;;;;;;;;;1,0;;;2,0;;;;;;3,0;;;;;;;;1,0;1,0;;2,0;1,0;;;;;;;;;7,0;;;1,0;1,0;;2,0;;3,0;2,0;2,0;;;;1,0;;;;;;;;;;;;;;;4,0;;;;;;;;;;;;;;2,0;;3,0;;1,0;;;;;;;;;;;;;;;;;;;;;;;;;;;;;;;;;;;;;;;;;;;1,0;;1,0;;;1,0;;;;;;;;;;;;;;;;;1,0;1,0;;;;;;;;4,0;7,0;;3,0;;;;;7,0;;3,0;;;;;;;;;7,0;;;;;;;;;;;;;;;;;;;;;;;;;;;;3,0;;;;;;;;;2,0;;;;;;;;;;2,0;;;;;;;;;;;;;;;;;;;;;;;;2,0;;;;;;;;;;5,0;;;;;2,0;;;;;;;;;;;2,0;;;;;;;;;;;;;;;;;;;1,0;;;;;;;;;;2,0;;;;;;;;;;1,0;;;;;4,0;;;;;3,0;;;;;;;;;;;;;;;2,0;;;;;;;;;;;;;;;;;;;;;;;3,0;;;;;;;;;;;;1,0;;;1,0;;;;;;;;;3,0;;;;;;;;;;;;;;;;2,0;;;;;;;;;1,0;;3,0;;;;;;;3,0;2,0;;;1,0;1,0;;1,0;;;;;;;2,0;;;;;;;;;;;;;;1,0;;;2,0;;;;;;;;;;;;;;;;;;1,0;;;6,0;8,0;;;;;;;;;;;;;;;;;;;;;;;;;;;;;;;;;;;;;;;;;;;;;;3,0;;;;;17,0;2,0;;;;;;;;;;;;;;;;;;;;;;;;;;;;;;;;;;;;;;;;;;;;;;;;;;;;;;1,0;;;;;;;;;;;;;;;;;;;;;;;;;;;1,0;9,0;1,0;;2,0;;;;1,0;;;;;;2,0;;;;;4,0;;;;;;;;;;;;;;;;;3,0;;;;;;;;;;;;;;;;;;;;;;
stabilization;;;;3,0;4,0;;;4,0;;10,0;;4,0;;;4,0;;;1,0;;;;17,0;;1,0;30,0;;;11,0;;7,0;7,0;1,0;13,0;1,0;25,0;;;;;4,0;;;9,0;2,0;;;;;3,0;2,0;1,0;16,0;;1,0;;168,0;13,0;;1,0;10,0;;;26,0;;;;;;;2,0;4,0;1,0;9,0;;;;;4,0;5,0;;;7,0;2,0;;;;;;;2,0;4,0;;;18,0;;;;;5,0;;;61,0;;;;3,0;;21,0;;;1,0;;;3,0;;;;;;3,0;;;;3,0;;;11,0;;;5,0;;;;;;;;;;;;;1,0;;;;;;;;;;;;1,0;;;;;;;;;;;;1,0;;;;1,0;;15,0;5,0;3,0;;;;;;;3,0;;;;;;;;1,0;;;;2,0;;;;;;;;;;;;4,0;;;;1,0;;;;;1,0;84,0;1,0;;;;;;;;;;;;;;;4,0;;;5,0;;;8,0;;1,0;;;;;;;1,0;;;;;;;;;;;;;;;2,0;2,0;;;;;;;;;;;;;;;;1,0;;;;;;;3,0;;;4,0;;;;;;;;;;;;;;;;;;;3,0;;;;;;;;;;;;;;2,0;;;;;;;;;5,0;;;;7,0;;;1,0;;;;6,0;;1,0;;2,0;;;;;;;;;1,0;;;;;;;;;;;;4,0;1,0;;;;;;;1,0;2,0;;;;;;;;;;;;;;1,0;3,0;3,0;;;14,0;1,0;4,0;;;;;;2,0;;;;;5,0;;;;;;;;;;;1,0;;;18,0;;;;;3,0;5,0;;;17,0;4,0;;;;;;;;;;;;;;;;;;;;;;1,0;;;;;;;;;;;;;2,0;;;;;2,0;;;;;;;;;;;;;;;;1,0;;8,0;;;2,0;2,0;30,0;;;;;;;;;;;;;;;;;;;;;;;;;;;;;;;;;;1,0;;;;;;;;;;;;;;;;;;;;;;;;;;;;;2,0;;;;;;;;;4,0;;;;;2,0;;;;;;;;;;;;;;;;;;;;;;;;;1,0;;;;;;16,0;;;;6,0;;;3,0;;;;;;;;;;8,0;;;;;;;;;;;;;;;1,0;;;;;;;;;;;;;1,0;;;;;;;;;;;;;;;;;;;2,0;;;;;;;;;;;;;;;;;;;;;;;;;;;;;;;;;;;;;;;;;;;5,0;;;;;;;;;;;;;;;;;;;;;;;;;;;;;;;1,0;;;;;;;;;;;2,0;;;;;;;;;;;;;;;;;;;;;;;;;;;;;;;;;;;;;;;;;;;;;3,0;;;;;;;;;2,0;;;;;;;;;;;;;;;;1,0;;;;;;;;1,0;;;;;;;;;;;;;;;;;;;;;;;;1,0;;;;;;;;;;;;;;;;;;;;;;;;;;;;;;;;;;;;;;;;2,0;;;;;;;;;;;;;;;;;;;;;;;;;;;;;;;;;;;;2,0;;;;1,0;;;;;;;;;;;;;;;;;;;;;;;;;;;;;;;;;;;;;;;;;;;;;;;;;;;;;;;;;;;;;;;;;;
status;;;;3,0;6,0;;;18,0;1,0;8,0;;;;;2,0;1,0;;;;1,0;2,0;43,0;;;;5,0;;20,0;;10,0;60,0;19,0;17,0;1,0;6,0;;;6,0;;47,0;;;2,0;;;8,0;;;8,0;;1,0;5,0;;;;48,0;15,0;;;;3,0;;12,0;;;;108,0;;1,0;20,0;4,0;1,0;;1,0;;;;;;5,0;;15,0;;;;;;;8,0;3,0;;;;43,0;;;;2,0;12,0;;10,0;12,0;;7,0;;;;50,0;2,0;;1,0;1,0;;;;;;;;1,0;;;3,0;1,0;;;7,0;;;;;;2,0;;1,0;;;;;1,0;;;3,0;;;;2,0;4,0;;;1,0;;;;;;;;;4,0;;;;;;5,0;;17,0;;5,0;1,0;;;1,0;;;;25,0;;;;;;;;;;19,0;;2,0;;;;14,0;;;;;;;;;;2,0;;17,0;1,0;;;;;;;;2,0;3,0;10,0;;;;;;;;;;21,0;;;;;;;;1,0;6,0;;5,0;15,0;;;;;;;;;;;;;;;1,0;;;;4,0;;;;4,0;;;;;;;;;;;;;;1,0;1,0;;;;;;;;;1,0;;85,0;;;;;;;;;;10,0;;;2,0;;7,0;;;;;1,0;;;2,0;7,0;;;;;;;;;;6,0;;;;;;;1,0;;7,0;7,0;;;;;;;2,0;;;;;3,0;;;;1,0;;1,0;;10,0;;;;;4,0;;;;4,0;1,0;;;;48,0;16,0;;;;;;3,0;2,0;;18,0;;;;;;1,0;;;6,0;;;;;25,0;;7,0;;4,0;;3,0;;;1,0;;1,0;;1,0;;;;;;;;;2,0;;;;;;;5,0;;1,0;2,0;7,0;5,0;7,0;1,0;;2,0;;;;;1,0;;;;;;;3,0;2,0;;;;4,0;6,0;;1,0;8,0;1,0;;;;;;;;;1,0;1,0;;;;;1,0;27,0;;;1,0;;1,0;10,0;;;;;;4,0;1,0;;7,0;5,0;;;;;;;2,0;1,0;;11,0;;2,0;22,0;;;4,0;;1,0;;4,0;;;;;;;;;;2,0;;3,0;;4,0;;2,0;;;;;;;;;;;;1,0;3,0;4,0;;;2,0;;;;;;;;;;;8,0;;;;;;;;;10,0;;;;1,0;4,0;3,0;;;;;2,0;;;1,0;;;;;4,0;;;;;;;;;;;;5,0;;;;11,0;;;;;;3,0;;;;;;;;;1,0;3,0;;;;;;;;;4,0;;6,0;;;;1,0;;;;;;;;5,0;;;;;7,0;;;;;;;;;;;;;;;;;;;;;;;;;;;;;;;;;1,0;;;;;;;;;;;;;;;;;;;;;;;;;;;;;;;1,0;;;4,0;;;;;;;;1,0;;;;1,0;;;;;;;;2,0;;;;;;;;;;;3,0;1,0;;;;1,0;;;1,0;;3,0;;;8,0;;;;;;;;;;;;;;;3,0;;;;;3,0;;;;;;3,0;1,0;;;;;;;;;;;;;;;;;;;;;3,0;;;;;;;2,0;;;;;;14,0;;;;;;;;;;;;;3,0;;;;;;;;;;;6,0;;;;;;;;;2,0;;;;;;3,0;;;1,0;;;;;;;;;2,0;;;;;4,0;;;;;;;;;;;3,0;;;;;;;;;;;;;;;;;;;;;;;;;;;;;;;;;;;;;;;;;;;;;1,0;;;4,0;;;;1,0;;;;;;;;2,0;;;;;;;5,0;;;;;;;;;;;;;;;;;;;;;;;;;;;;;;;;;;;;;;;;;;;;;;;;12,0;;;1,0;;;;;;;;;
superimpose;;;;1,0;6,0;;2,0;11,0;3,0;1,0;;2,0;;;1,0;1,0;;;4,0;1,0;4,0;17,0;1,0;;;;;17,0;;1,0;;2,0;27,0;;1,0;;;5,0;;83,0;;;4,0;11,0;;;;3,0;12,0;1,0;2,0;24,0;;;;201,0;8,0;;;2,0;;;8,0;;9,0;;;;;3,0;10,0;2,0;;;1,0;4,0;;9,0;15,0;11,0;;17,0;1,0;;;;;;;4,0;2,0;;1,0;39,0;;;;4,0;1,0;1,0;;6,0;;;1,0;;;26,0;;;;4,0;;;;;;;2,0;;;;1,0;9,0;;;13,0;;;;;;;;;;;;;2,0;;;3,0;;;;12,0;20,0;;;;;3,0;;1,0;;1,0;;11,0;6,0;7,0;;;;;;2,0;17,0;;;2,0;;;;;;;2,0;;;;;;9,0;;1,0;;7,0;;4,0;;;;7,0;;3,0;;;;;;;;4,0;;;;;3,0;;;;2,0;;;1,0;4,0;;;;2,0;2,0;;3,0;;;;;;;;;9,0;2,0;;1,0;1,0;;18,0;;;;;4,0;1,0;;;;;;;;;1,0;;;;6,0;;;;4,0;;;;;;;;;;1,0;;;1,0;1,0;4,0;;;;;;;;;1,0;;18,0;;;;;;;;;;1,0;;;;;7,0;1,0;;;;4,0;;;1,0;1,0;;;;;;;;;;;;1,0;;1,0;;;2,0;;7,0;1,0;1,0;;;;;;;;;3,0;;;;;;;;4,0;;3,0;1,0;;;;;;;;;;;;;8,0;10,0;2,0;;;;2,0;;3,0;1,0;1,0;1,0;;;1,0;2,0;;;;;;;;;1,0;;;;;;;;3,0;2,0;;;;1,0;;;;11,0;1,0;;1,0;;;;3,0;;;;;3,0;;;;;;7,0;;;;;30,0;;;;;;2,0;;;;;;;;;1,0;1,0;1,0;;;;;5,0;8,0;;;;;;;;;;5,0;;;8,0;;;;;;3,0;;;;;4,0;;;;1,0;4,0;;;;2,0;11,0;3,0;;12,0;3,0;7,0;;;5,0;1,0;5,0;;;;;;;;;;;;;;;;;;9,0;;1,0;1,0;2,0;;;;;;;;;;;;;;;1,0;;;;;;4,0;;;;;;;1,0;;;;;;;;1,0;;1,0;;;2,0;5,0;;;;;;;2,0;;;;;;;;;;;;;;;30,0;;2,0;2,0;;;;;;;;2,0;;;;;;;;;;;;;;;;;;;;;;;15,0;;;;;;1,0;3,0;;;;;1,0;;1,0;;;;;;;;;;;;;;;;;;;;1,0;;;;;;;;;;5,0;;;;;;;;;;;;;1,0;2,0;;;;;;;;1,0;3,0;;;;1,0;;;;1,0;;;1,0;;;4,0;;;;;1,0;4,0;;;;;;;;;;1,0;;6,0;;;;;;6,0;;3,0;;;;;;;;;1,0;;;;1,0;;;;;;;;;;1,0;;;;;;;;;;1,0;;;;;;;;;;;;;;;;;;;;2,0;;;1,0;;;;;;;;;;;;;;2,0;;;;;;;;;;;;2,0;;1,0;2,0;;;;;9,0;;;;3,0;;;;;;;;4,0;;;;9,0;4,0;8,0;17,0;;;;;;;;;;1,0;;;;;;3,0;;;;;;2,0;;;;;;;10,0;;;3,0;;;;;;;;;;;;16,0;;;;;;;7,0;;;;;;;;;;;;;;;;;;;;;;;;7,0;;;18,0;1,0;1,0;;;;;;;;;5,0;2,0;;;;;;;;;;;;;;;;;;;;;;;;2,0;;;;;;;;;;;;;;;;;;;;;;;;;;1,0;1,0;;;;;;;;;;;;;;4,0;;;;;;;;;;;;
symbol;;;;2,0;1,0;;;3,0;;3,0;;;7,0;;;6,0;;;;4,0;;;;;;;;2,0;;;;1,0;1,0;;2,0;;;5,0;;13,0;;;;;4,0;;;;;;;4,0;;7,0;;14,0;19,0;;2,0;;;;6,0;;;1,0;4,0;;;;6,0;;1,0;;;;;;14,0;;;2,0;2,0;;;;;;8,0;;;;;3,0;;1,0;;;5,0;;6,0;3,0;;;;;;3,0;;;;3,0;;;;;;;;;;;1,0;;;;1,0;;;;;;;;;;;;;;;;;;;;1,0;;;;;;;;;;;;1,0;;;;;;;;;6,0;;;;;;;;;;;;;2,0;;;;;;;18,0;;3,0;;;;;;;6,0;;1,0;;;;;1,0;;;;;;;;;;;;2,0;;;;;;;;;;;;;;;;;;;2,0;;;;9,0;;;;;;;;;;;;5,0;;;;;;;7,0;;;;;;;;;;;;;;;;;1,0;;;;;5,0;;;;;;;;;;;;;;8,0;;;;;;;;;1,0;;;;;;;;21,0;;;;;;;;;;;;;;;1,0;;;;;4,0;;;;;;;;;;;7,0;;;;;;;;;;;;;;;;;;;;;;;;7,0;;;;;1,0;;;;;4,0;;;;;;;;;;;;;4,0;;;;;;;;3,0;1,0;;;;;;;;;;;;;;;;;;;;;2,0;;9,0;;1,0;;;;;3,0;;1,0;;;;;;;;1,0;;;;;;;;;;1,0;;;;;;;;;;;;;3,0;;;;;;2,0;;;;;;;;;;;;2,0;2,0;;;;;;2,0;;;;3,0;;;1,0;1,0;;;;;;;;;;;;;;;;;;;;10,0;6,0;;;;;;;;2,0;;;;;;;;;;;;;;;;;6,0;;;;;;;;;;1,0;;5,0;;;;;;;;;1,0;;;;;;3,0;;;;;;;;;;;;;;;;3,0;;;;;;;;;;;;;;;;;;;;;;;;;;;;;;;;;;;;;;;;;;;;;;;;;;;;;;;;;;;;;;;15,0;;;;;7,0;;;;;;;;;1,0;2,0;;;2,0;;;;;;;;;;;;;;;;;;;;;;;;;;;;;;;;;;;;;12,0;;;;;;;;;;;;;;;;;;;;;;;;;;;;;;;;11,0;;;;;;;;;;;;;;;;;;;;;;;;;;;;;;;;;;;;;;;;;;;;;;;;;;;;;;;;;;;;;1,0;;;;1,0;;;;;;;;;;;;;4,0;;;1,0;;;;;;;;;;;;;;;;;;;;;;;;;;;;1,0;;;;;;;;;;;;;;;;;;;;4,0;;;;;;;;;;;;;;;;;;;;;;;;;;;;;;;;;;;;;;;;;;;;;;;;;;;2,0;;;;;;;;;;;;;;;;;;;;;;;;;;;;;;;;;;;4,0;;;;;;;;;9,0;;;4,0;1,0;;;;;;;;;;;;;;;;;;;;;;;;;;;;;;;;;;;;;;;
text;;;;2,0;2,0;;;17,0;;17,0;;;;;4,0;;;;;4,0;1,0;2,0;;;;;;12,0;;;;19,0;29,0;;4,0;;;39,0;;56,0;4,0;;;16,0;;;;;;;;7,0;;;;88,0;7,0;;;2,0;;;32,0;;;;;;;;2,0;;;;;2,0;;4,0;19,0;;;2,0;;8,0;;;;1,0;1,0;1,0;1,0;;;1,0;;4,0;;1,0;6,0;;;6,0;;1,0;3,0;;;10,0;;;;;;;;;;;;1,0;;;;;;;;;;;;3,0;;;;;;;;;;;;;;;5,0;;;;;;3,0;;;;;;1,0;;;;;;;;;1,0;;;;;2,0;;;;;1,0;;;;;1,0;;;;;5,0;;3,0;;;;6,0;;8,0;;;;;;;;;;;;;2,0;;;;;;;;5,0;;;;;;;;;;;;;;;;;;;1,0;;2,0;4,0;;;;1,0;;;;;;;;;;;9,0;16,0;;;;;;;;;;;;;;;;;;;5,0;9,0;;;;;4,0;;;;;;1,0;;26,0;;;;;;;;;;10,0;;;6,0;;;;;;;2,0;;;1,0;5,0;;;;;;;;;;;;;;2,0;;;;30,0;6,0;;;;;;;;;;;9,0;2,0;4,0;;2,0;;;;;;2,0;;;;;;;;;;2,0;;;10,0;1,0;;;;;;;;2,0;1,0;;14,0;;;5,0;;;;5,0;;;;;1,0;1,0;;3,0;;;;;;5,0;;;2,0;;;;;;;;;;;;;;;2,0;;;1,0;;17,0;;7,0;14,0;;;;9,0;;4,0;;;;;;;;;3,0;;2,0;;;1,0;1,0;;1,0;6,0;;;;;2,0;;;1,0;2,0;;2,0;;;2,0;2,0;;;;;4,0;;;;4,0;;;;;;;;16,0;;;;;;;5,0;;;3,0;;2,0;;;7,0;4,0;;;;;;1,0;;;;;;;;;;;;2,0;4,0;;;2,0;;;;;;2,0;;;6,0;;;1,0;;;;;1,0;;;;;2,0;;;;;;;5,0;;;;6,0;;;;;;;;;1,0;11,0;;;;;;;;;;;7,0;9,0;1,0;;;;3,0;;;;;;;;;;;;1,0;;;;;;;;;;;;;;;;;;;;;;;;;2,0;;;;;;;;;;;;;;1,0;;;;;;;;;;;;;8,0;;;;;;;;;;;;;3,0;;;;;;6,0;;;;;;;;;8,0;;;1,0;;;5,0;;;;;;;;;;;;1,0;;;;;;;;;;;;;;;;;;;;2,0;;3,0;;;;1,0;;1,0;;;;;;;;;;;1,0;;;;;;;;;;3,0;;;;;;;;;;;;;;;;;;;1,0;1,0;;;;;;;;;;2,0;;1,0;;3,0;;;;;;;;;;;;;4,0;;;9,0;;;;;;;12,0;9,0;;;;;;;;;;;;;;;;;;;;;;;;;;;;;;;;;;5,0;;;;;;;;1,0;;;;;2,0;;;8,0;1,0;;;;;;;1,0;;;;2,0;;;;;;;;;;1,0;;;;;1,0;;;;;;;;;;;;;;;;;;;;;1,0;;;;;;1,0;;;;;;;;;6,0;;;2,0;;;;;;;;;;;;;;;;;;;;;;;;;;;;;;;;;;;;;;;;;;;;;;;;;;;;;;;;;;;;;;;;;;;;;;12,0;;;;;;;2,0;;;;;;;;;;;;
tool;;;;1,0;1,0;;3,0;7,0;;2,0;6,0;;;;9,0;1,0;;;1,0;6,0;;2,0;3,0;;1,0;;;3,0;;3,0;;3,0;7,0;;4,0;2,0;1,0;;;6,0;4,0;;2,0;14,0;;;;;12,0;;;2,0;;;;6,0;15,0;;;7,0;;;36,0;;4,0;;1,0;;2,0;1,0;;2,0;;;;;;5,0;21,0;;;5,0;4,0;;;;12,0;;3,0;2,0;7,0;;;2,0;1,0;9,0;;;;;4,0;10,0;;;;;;;;;3,0;3,0;;2,0;;;;;;;5,0;3,0;4,0;;;;5,0;;;1,0;;;;;;;1,0;;;;;;;2,0;;;1,0;2,0;;;;;1,0;;1,0;13,0;4,0;1,0;;2,0;;;1,0;;4,0;;;3,0;;1,0;1,0;;2,0;7,0;3,0;;;;;;;;;;;5,0;5,0;6,0;;3,0;1,0;;;5,0;;;;;;;;;;1,0;;;;6,0;2,0;10,0;;;2,0;;1,0;2,0;;56,0;1,0;;5,0;;;;;;;;;;;;3,0;;6,0;;;;5,0;;;2,0;;;;;;;;;;;;2,0;;3,0;;9,0;2,0;;;;;;;;2,0;;4,0;;2,0;10,0;;;;20,0;;;;1,0;;;2,0;2,0;;;12,0;10,0;;;;;;;;;;2,0;;;;;;;;;;1,0;;;12,0;;;;;;;;;4,0;;3,0;4,0;;;1,0;;;;;23,0;;;;;;;;;;;3,0;;;1,0;;;1,0;;4,0;2,0;6,0;1,0;;;;;;;;1,0;;;;4,0;3,0;;;;;;;;;2,0;;;;;1,0;;;;;;;;;;1,0;;2,0;;;;;;2,0;1,0;;;;;;;;1,0;;;;;1,0;;6,0;;;1,0;;3,0;2,0;5,0;;;;;;;;;11,0;;;;;;;;;;;;;;;;;7,0;;;;;;1,0;;;;;;;;;;;;;1,0;;1,0;;;;3,0;2,0;;;;;;;;;;;;;1,0;1,0;5,0;;2,0;;;;;4,0;6,0;;;;;;;;;;;;;;;;;;;;2,0;2,0;;;;6,0;2,0;;;;;4,0;;;;;;1,0;;;;;12,0;;;;;;4,0;;;;1,0;;;;;;9,0;;;2,0;;;;1,0;;;;2,0;;9,0;;;;;;;;;;;1,0;;4,0;;;;;;;;;;;;;;;;;;;;;;;;;1,0;;;;;;;1,0;;;;;;;1,0;;;;;2,0;;;;;;;;1,0;6,0;;;;3,0;;;;;;1,0;1,0;;;;;;;;2,0;;;;3,0;;;;;3,0;;;;;6,0;;;;;;;;;;;;;;;;;1,0;;87,0;;;;;;;;;;;;;;;;;;;1,0;;;;;;;;;;;;;;;;;;;;;;;;;;;;;;;;;;;5,0;;;;;;;;;;;;;;;;;;2,0;;;2,0;;;5,0;9,0;;;;;;3,0;;;;;;8,0;;;;;;;;;;;;;;;;;;;;;;;;;;;;;2,0;1,0;;11,0;;;;;;;;;;;;;;;;;7,0;;;;;8,0;;;;;;;;1,0;;;;;2,0;;;;;;;;;;;;;;4,0;;1,0;;3,0;;;;;;;;;;;;;;;;;;;;;;;;;;1,0;;;;;;;;7,0;;1,0;;;;;;2,0;;;;;;;5,0;1,0;;;;;;;;;;;;;;;;;;;;;;;;;;1,0;;;;;;;;;;;;;1,0;;;;;1,0;;;;;1,0;;;;;;;;;;;;;;;;;;;;;;;;;;;;;;;;;;;;;;;;
utilize;;;;1,0;8,0;;;6,0;1,0;22,0;1,0;1,0;1,0;2,0;5,0;14,0;;;28,0;3,0;1,0;13,0;;;;;;33,0;;13,0;4,0;13,0;31,0;1,0;19,0;1,0;;2,0;;3,0;3,0;;;3,0;2,0;;5,0;2,0;4,0;3,0;10,0;5,0;;2,0;;107,0;20,0;;;18,0;;;45,0;;9,0;2,0;6,0;;;3,0;14,0;;3,0;;;;;6,0;32,0;3,0;1,0;15,0;7,0;2,0;1,0;;7,0;;;6,0;16,0;1,0;9,0;38,0;1,0;1,0;;3,0;5,0;;15,0;42,0;;2,0;;2,0;2,0;16,0;;;;;2,0;6,0;;2,0;;;1,0;1,0;;;;2,0;;3,0;9,0;;;2,0;3,0;5,0;1,0;;2,0;3,0;;;;1,0;;1,0;5,0;7,0;5,0;;3,0;12,0;;1,0;;;4,0;1,0;;6,0;;7,0;3,0;13,0;3,0;;2,0;;;;2,0;18,0;;1,0;1,0;2,0;18,0;3,0;3,0;2,0;;14,0;2,0;;1,0;;6,0;;;5,0;2,0;10,0;;13,0;2,0;;1,0;6,0;1,0;1,0;;1,0;1,0;1,0;;;1,0;2,0;;;2,0;;;1,0;1,0;;1,0;;;10,0;11,0;;;;1,0;;;1,0;1,0;;5,0;;;;;;;;8,0;1,0;;;35,0;1,0;;;6,0;;2,0;2,0;;;;;;1,0;;10,0;;;;2,0;;;1,0;1,0;2,0;;;;;;1,0;;1,0;;2,0;1,0;;5,0;;;;;;;;5,0;1,0;9,0;;10,0;1,0;;;;;11,0;;;1,0;9,0;;;;;8,0;11,0;1,0;;;6,0;;;3,0;;5,0;;;;;;1,0;;;12,0;;;;4,0;;;;;5,0;;;1,0;8,0;1,0;2,0;;1,0;;;;;;4,0;1,0;2,0;;;;;2,0;5,0;;;;;;;2,0;1,0;4,0;;;14,0;8,0;;;;;;;;3,0;2,0;12,0;1,0;;;2,0;3,0;1,0;;;1,0;1,0;1,0;;;2,0;;;;1,0;4,0;;;14,0;5,0;;2,0;;;;2,0;;;8,0;;;;1,0;;;3,0;8,0;4,0;2,0;21,0;9,0;12,0;4,0;;5,0;7,0;;1,0;2,0;;6,0;5,0;;;2,0;;;;1,0;;;;3,0;;1,0;13,0;2,0;2,0;;5,0;5,0;;2,0;10,0;1,0;;2,0;;1,0;;;;;;1,0;;;2,0;4,0;8,0;;;6,0;;;;;2,0;2,0;3,0;;4,0;1,0;;;;;10,0;;;5,0;;1,0;;;30,0;9,0;;1,0;;;1,0;;18,0;10,0;2,0;;;;;;;;2,0;6,0;7,0;;;;;;;;1,0;2,0;;;1,0;;1,0;;1,0;;;;8,0;;;;3,0;;;;;1,0;;;1,0;1,0;;;6,0;1,0;;1,0;18,0;;3,0;1,0;;1,0;6,0;2,0;;;;;1,0;;;6,0;;;;1,0;;;1,0;2,0;;;;;;;;2,0;;;;1,0;4,0;;;;;2,0;;;;;1,0;;;;;;;;;;;;;;;;3,0;;;;2,0;;;;3,0;;;;2,0;;;;1,0;7,0;;1,0;5,0;;;;;;;;;;;;;;1,0;;1,0;9,0;;;;;1,0;;2,0;;;;;;;1,0;;;;;;;3,0;2,0;;;;;;;4,0;;5,0;;;2,0;;;;;;;;;;1,0;2,0;;;;;;;;;8,0;;3,0;;;;5,0;;;;;;;;;1,0;;;1,0;;;;;1,0;1,0;2,0;;2,0;6,0;;2,0;;;2,0;1,0;;5,0;;;;1,0;;;;;;3,0;3,0;1,0;;;;2,0;;;;;2,0;;;;;;4,0;1,0;;;;7,0;1,0;;;;1,0;;;;;1,0;2,0;6,0;;;1,0;;;;;;;;;;;;;;;2,0;;;1,0;;;;;4,0;;;;;;;;;3,0;;;;;;;;;11,0;;;;;;;2,0;;;1,0;;5,0;1,0;;;;;;1,0;;;;;;3,0;;;;;;;1,0;;;;;;;;;;;;;;;;;;;;1,0;;1,0;;;;1,0;;;;1,0;;;;;3,0;1,0;;;;;;;1,0;;;;;;;1,0;;;;;;;;;;;;;1,0;;;;1,0;;;;1,0;;;;;;;;6,0;8,0;;;;1,0;;1,0;;;;;;1,0;;;;;;;3,0;;2,0;;;;;;3,0;;1,0;;;;1,0;;;;;;;4,0;;;;;;;1,0;;;;;;;;;
abut;;;;;7,0;;10,0;2,0;;1,0;1,0;;;;;1,0;;1,0;;;;;;;;;;;;3,0;;;;;;;;13,0;;2,0;;;7,0;17,0;;;2,0;;;;;1,0;;2,0;;11,0;3,0;;;56,0;;;1,0;;;1,0;4,0;6,0;;;10,0;1,0;;2,0;3,0;;;6,0;23,0;;7,0;2,0;;;;;2,0;2,0;;;4,0;;;;;4,0;;;1,0;3,0;79,0;1,0;;;;;;21,0;;;4,0;1,0;;11,0;1,0;;2,0;;;4,0;;;;;;;6,0;14,0;;1,0;8,0;;;1,0;;2,0;10,0;;;;;;;22,0;1,0;6,0;6,0;15,0;;;;;10,0;;5,0;1,0;;4,0;1,0;2,0;;;11,0;;;3,0;;;;;73,0;;8,0;12,0;1,0;3,0;10,0;;1,0;;;;;;;5,0;4,0;8,0;;73,0;;12,0;;4,0;1,0;;;;;;;3,0;4,0;32,0;;;6,0;;10,0;9,0;;;;;7,0;;;;2,0;1,0;3,0;;;;8,0;;;;;;1,0;5,0;2,0;3,0;1,0;5,0;3,0;1,0;1,0;1,0;24,0;5,0;2,0;12,0;5,0;4,0;1,0;1,0;4,0;11,0;1,0;1,0;9,0;1,0;1,0;1,0;1,0;9,0;1,0;1,0;1,0;3,0;4,0;12,0;5,0;3,0;6,0;1,0;15,0;5,0;5,0;6,0;2,0;2,0;2,0;2,0;2,0;2,0;4,0;1,0;1,0;7,0;2,0;2,0;4,0;4,0;4,0;8,0;23,0;4,0;1,0;1,0;2,0;1,0;4,0;1,0;1,0;2,0;3,0;2,0;1,0;4,0;7,0;6,0;9,0;11,0;2,0;1,0;1,0;3,0;5,0;1,0;1,0;4,0;3,0;2,0;1,0;3,0;2,0;1,0;10,0;11,0;29,0;8,0;8,0;2,0;1,0;1,0;1,0;1,0;1,0;1,0;2,0;;;;;;;;;;;;;;;;;;;;;;;;;;;;;;;;;;;;;;;;;;;;;;;;;;;;;;;;;;;;;;;;;;;;;;;;;;;;;;;;;;;;;;;;;;;;;;;;;;;;;;;;;;;;;;;;;;;;;;;;;;;;;;;;;;;;;;;;;;;;;;;;;;;;;;;;;;;;;;;;;;;;;;;;;;;;;;;;;;;;;;;;;;;;;;;;;;;;;;;;;;;;;;;;;;;;;;;;;;;;;;;;;;;;;;;;;;;;;;;;;;;;;;;;;;;;;;;;;;;;;;;;;;;;;;;;;;;;;;;;;;;;;;;;;;;;;;;;;;;;;;;;;;;;;;;;;;;;;;;;;;;;;;;;;;;;;;;;;;;;;;;;;;;;;;;;;;;;;;;;;;;;;;;;;;;;;;;;;;;;;;;;;;;;;;;;;;;;;;;;;;;;;;;;;;;;;;;;;;;;;;;;;;;;;;;;;;;;;;;;;;;;;;;;;;;;;;;;;;;;;;;;;;;;;;;;;;;;;;;;;;;;;;;;;;;;;;;;;;;;;;;;;;;;;;;;;;;;;;;;;;;;;;;;;;;;;;;;;;;;;;;;;;;;;;;;;;;;;;;;;;;;;;;;;;;;;;;;;;;;;;;;;;;;;;;;;;;;;;;;;;;;;;;;;;;;;;;;;;;;;;;;;;;;;;;;;;;;;;;;;;;;;;;;;;;;;;;;;;;;;;;;;;;
accelerometer;;;;;5,0;;6,0;5,0;1,0;;;;;;;;;;3,0;;;1,0;;;;;;18,0;;16,0;;3,0;10,0;;4,0;;;;;1,0;;;;;;;;;;;;4,0;;;;15,0;7,0;;;5,0;1,0;;5,0;;;3,0;;;;;;;;;;;;;;;;;2,0;;;;;;;3,0;11,0;;;1,0;;;;1,0;;;4,0;6,0;;;;;;;;;;;;;;;;;;;;;;1,0;;;;;;4,0;;;;;1,0;;;;;;;;;;;;1,0;;;;;;;;;;;;;;;;;;;;1,0;6,0;;;;;;;;;;7,0;;;;;;;;;;5,0;;;;;;;;;;;;;;;;;;;;;;;;;;;;1,0;;;;;;;;;;;;;;;;;;;;;;;;;;;;;;;;;;;;;;;;;;;;;;;;;;;;;;;;;;;;;;;;;;;;;;7,0;;;;;;2,0;;;;;;;;;;;3,0;;;;;;;;;;;;;;;;;;;;;;;;;;;;1,0;;;2,0;;2,0;;;;;;2,0;;;;1,0;;;;;;2,0;;;1,0;;;;;;;;;;;3,0;;;;;;;;1,0;1,0;2,0;;;;;;;;;;;;;;5,0;;;;;;;;;;;;;8,0;;;;;;1,0;3,0;6,0;1,0;1,0;1,0;1,0;15,0;1,0;6,0;22,0;2,0;8,0;5,0;1,0;1,0;1,0;1,0;1,0;2,0;2,0;1,0;3,0;1,0;4,0;7,0;;;;;;;;;;;;;;;;;;;;;;;;;;;;;;;;;;;;;;;;;;;;;;;;;;;;;;;;;;;;;;;;;;;;;;;;;;;;;;;;;;;;;;;;;;;;;;;;;;;;;;;;;;;;;;;;;;;;;;;;;;;;;;;;;;;;;;;;;;;;;;;;;;;;;;;;;;;;;;;;;;;;;;;;;;;;;;;;;;;;;;;;;;;;;;;;;;;;;;;;;;;;;;;;;;;;;;;;;;;;;;;;;;;;;;;;;;;;;;;;;;;;;;;;;;;;;;;;;;;;;;;;;;;;;;;;;;;;;;;;;;;;;;;;;;;;;;;;;;;;;;;;;;;;;;;;;;;;;;;;;;;;;;;;;;;;;;;;;;;;;;;;;;;;;;;;;;;;;;;;;;;;;;;;;;;;;;;;;;;;;;;;;;;;;;;;;;;;;;;;;;;;;;;;;;;;;;;;;;;;;;;;;;;;;;;;;;;;;;;;;;;;;;;;;;;;;;;;;;;;;;;;;;;;;;;;;;;;;;;;;;;;;;;;;;;;;;;;;;;;;;;;;;;;;;;;;;;;;;;;;;;;;;;;;;;;;;;;;;;;;;;;;;;;;;;;;;;;;;;;;;;;;;
accommodate;;;;;2,0;;9,0;11,0;;;2,0;;;;1,0;;;;;1,0;;;;;2,0;;;;;;1,0;;24,0;;2,0;;;13,0;;14,0;10,0;;2,0;42,0;;;;1,0;2,0;;1,0;;;2,0;;20,0;17,0;;6,0;112,0;1,0;;2,0;;;;;2,0;;2,0;20,0;8,0;1,0;6,0;;;;;20,0;4,0;1,0;;;;;;2,0;;;2,0;17,0;;1,0;1,0;17,0;18,0;;;;2,0;22,0;4,0;;;;1,0;3,0;47,0;;;;;1,0;9,0;;4,0;;;1,0;13,0;;;;;;;15,0;;;1,0;8,0;;;20,0;;1,0;3,0;;;;;;;1,0;3,0;;20,0;6,0;;;;18,0;2,0;1,0;;4,0;20,0;38,0;;17,0;;1,0;8,0;4,0;;1,0;;7,0;1,0;;14,0;;19,0;15,0;1,0;11,0;;1,0;2,0;;6,0;6,0;2,0;;1,0;2,0;7,0;31,0;;28,0;;1,0;;4,0;2,0;5,0;;2,0;3,0;2,0;;1,0;;5,0;;;1,0;;4,0;9,0;;1,0;;;;;;;;1,0;9,0;11,0;;;;;;;;1,0;;;4,0;2,0;2,0;1,0;1,0;;3,0;;18,0;3,0;;1,0;3,0;22,0;;4,0;2,0;1,0;;1,0;;3,0;;;;8,0;1,0;;;1,0;7,0;1,0;21,0;5,0;7,0;;;;3,0;5,0;;;7,0;;;1,0;;1,0;1,0;;;2,0;;;3,0;7,0;1,0;;;;;;;;;;1,0;;2,0;1,0;1,0;4,0;1,0;;;1,0;5,0;7,0;;;3,0;;4,0;;1,0;;3,0;11,0;;;1,0;14,0;;3,0;;3,0;3,0;;3,0;18,0;18,0;;;;;;;;;;;;1,0;;;;4,0;1,0;2,0;;;;;;;;2,0;;;;;;;;;;;;;;;;2,0;;1,0;;;;;3,0;;;;;;;;3,0;;;2,0;;4,0;;;;;;8,0;;;;;;;1,0;;;2,0;2,0;10,0;;;;;;1,0;;;;;;;;;;;;;;;;;2,0;;;;8,0;;;3,0;;1,0;;;;;;;;1,0;7,0;;1,0;;;;;;;;;;1,0;4,0;;;;;;;;;;1,0;;;;;;;;;3,0;6,0;;;;;;;;5,0;2,0;;;;;1,0;;;;;;;3,0;;9,0;3,0;;;;1,0;2,0;;;;;;;;;;;;1,0;;;3,0;;;;;;4,0;1,0;;;;;;3,0;;;;;;;;1,0;;;1,0;1,0;;;2,0;;2,0;;;;;;1,0;;;;;;;;;;3,0;;;1,0;;;3,0;;;;3,0;;;;2,0;;36,0;;9,0;;;5,0;;;;;1,0;;;;;;;;3,0;2,0;;;;;;1,0;;1,0;;;;4,0;;1,0;;;4,0;;;2,0;3,0;2,0;1,0;11,0;2,0;1,0;10,0;1,0;2,0;1,0;2,0;4,0;20,0;1,0;7,0;2,0;1,0;3,0;2,0;1,0;1,0;1,0;3,0;1,0;2,0;2,0;2,0;1,0;10,0;3,0;2,0;1,0;4,0;3,0;1,0;5,0;2,0;1,0;4,0;2,0;1,0;1,0;1,0;1,0;15,0;2,0;;;;;;;;;;;;;;;;;;;;;;;;;;;;;;;;;;;;;;;;;;;;;;;;;;;;;;;;;;;;;;;;;;;;;;;;;;;;;;;;;;;;;;;;;;;;;;;;;;;;;;;;;;;;;;;;;;;;;;;;;;;;;;;;;;;;;;;;;;;;;;;;;;;;;;;;;;;;;;;;;;;;;;;;;;;;;;;;;;;;;;;;;;;;;;;;;;;;;;;;;;;;;;;;;;;;;;;;;;;;;;;;;;;;;;;;;;;;;;;;;;;;;;;;;;;;;;;;;;;;;;;;;;;;;;;;;;;;;;;;;;;;;;;;;;;;;;;;;;;;;;;;;;;;;;;;;;;;;;;;;;
action;;;;;2,0;;1,0;26,0;;6,0;;;;;;;;;1,0;10,0;9,0;41,0;3,0;;14,0;;;7,0;;6,0;5,0;36,0;32,0;;17,0;;1,0;5,0;;8,0;3,0;;;;;;;;;;5,0;8,0;;11,0;;62,0;19,0;;1,0;13,0;;2,0;28,0;;;1,0;55,0;;;1,0;11,0;;;;;;;6,0;11,0;3,0;;;8,0;1,0;1,0;4,0;18,0;;1,0;15,0;1,0;1,0;;3,0;;;;2,0;2,0;;3,0;9,0;;2,0;;;;22,0;;;5,0;3,0;;;;;1,0;;;7,0;;;2,0;;;;11,0;;;5,0;;1,0;;4,0;1,0;;;;;;;5,0;1,0;3,0;2,0;;2,0;4,0;;;;;;1,0;;;;2,0;;13,0;;4,0;;;;;3,0;;;;2,0;1,0;2,0;;5,0;;2,0;;;;;;;;2,0;;;4,0;;2,0;;1,0;;10,0;;;;;;;;;;;;1,0;1,0;;;9,0;6,0;1,0;;;1,0;11,0;2,0;;;;;24,0;2,0;;;;;;;;;;3,0;;;;;1,0;30,0;;1,0;;1,0;;;1,0;;;;5,0;;;;;;;;5,0;;;;10,0;;;2,0;;;;;;;1,0;;;;8,0;;6,0;;;;1,0;;;;8,0;2,0;58,0;2,0;;;;;3,0;;;;1,0;;2,0;1,0;;4,0;;;;;;;;21,0;;1,0;;;;1,0;2,0;;;;;1,0;;;1,0;;4,0;;;51,0;3,0;;;1,0;1,0;;;;;;3,0;;1,0;4,0;;;4,0;;1,0;;13,0;3,0;;;;;;;;;;;;2,0;;1,0;;;;;;;;1,0;1,0;;;;;;1,0;2,0;;;;;;;1,0;1,0;10,0;;;3,0;1,0;8,0;1,0;;;7,0;;;;;;2,0;5,0;;;;2,0;;;;1,0;;2,0;3,0;;8,0;;;13,0;32,0;;;;;3,0;;;;;;;1,0;;2,0;;;;;1,0;;4,0;;4,0;2,0;;2,0;8,0;4,0;;;;;;4,0;;;8,0;;;;;;;5,0;;;45,0;;2,0;;12,0;5,0;;3,0;2,0;;;;2,0;;2,0;2,0;1,0;;2,0;;4,0;;;17,0;5,0;;;3,0;;;;;;;;;;;;;;2,0;4,0;;;;;1,0;;;;;;;;3,0;;;;;;;;17,0;;2,0;;1,0;;;;9,0;;;;1,0;1,0;;3,0;;;;;2,0;;;2,0;;2,0;2,0;;;;;;2,0;;;;;10,0;6,0;;;;;2,0;;;;3,0;;;1,0;5,0;;;;;;;;;;;;;5,0;;;;7,0;;;;2,0;;;;;;;;;;;;;1,0;;;;;;;;;;;;;;;;;;;;;;1,0;;;;;;;;;1,0;;;;;;;;;;;;;;;;;;;;;;;;;;;;;;;;6,0;;;;;;;;;;;;;;;1,0;;;;;1,0;;1,0;;;;;26,0;;;1,0;;;;;3,0;21,0;;;;4,0;;;1,0;1,0;;;;5,0;;1,0;;;;;;;;1,0;;;;;;1,0;;;;;;;;;1,0;;;;1,0;;;;;;;;;;;2,0;;;;;;;;;;4,0;;;6,0;;;1,0;2,0;;;;;2,0;31,0;2,0;5,0;3,0;1,0;1,0;12,0;1,0;4,0;1,0;6,0;1,0;1,0;1,0;1,0;8,0;1,0;2,0;2,0;3,0;1,0;1,0;;;;;;;;;;;;;;;;;;;;;;;;;;;;;;;;;;;;;;;;;;;;;;;;;;;;;;;;;;;;;;;;;;;;;;;;;;;;;;;;;;;;;;;;;;;;;;;;;;;;;;;;;;;;;;;;;;;;;;;;;;;;;;;;;;;;;;;;;;;;;;;;;;;;;;;;;;;;;;;;;;;;;;;;;;;;;;;;;;;;;;;;;
actuate;;;;;1,0;;4,0;7,0;;26,0;1,0;;;;3,0;1,0;;;3,0;;4,0;20,0;;2,0;33,0;;;5,0;7,0;6,0;2,0;3,0;53,0;;13,0;;2,0;15,0;7,0;1,0;2,0;;26,0;19,0;;2,0;;;4,0;3,0;6,0;1,0;;;;52,0;17,0;;;33,0;;;19,0;;;14,0;11,0;;2,0;20,0;8,0;;;;;;10,0;10,0;36,0;;;6,0;14,0;1,0;;;;;;6,0;5,0;;;32,0;;;2,0;2,0;4,0;;;15,0;;;;2,0;;24,0;;;2,0;3,0;;20,0;10,0;;;;;3,0;;;;2,0;;;22,0;;2,0;6,0;1,0;;;1,0;;10,0;8,0;;;3,0;;;1,0;1,0;;10,0;;2,0;;;;1,0;4,0;;;1,0;;8,0;12,0;7,0;;;;1,0;;;1,0;9,0;;1,0;46,0;;8,0;7,0;2,0;1,0;;3,0;;;1,0;1,0;;;;2,0;12,0;11,0;;33,0;;;;7,0;;;;;;1,0;;;;2,0;;4,0;;;;1,0;;;;;2,0;14,0;2,0;;;;3,0;;;;;;;;;;;20,0;30,0;;8,0;1,0;;6,0;;;3,0;;;2,0;;1,0;4,0;1,0;;54,0;;;;6,0;;;;;;;;14,0;;;;;2,0;;;;;1,0;;;;1,0;;7,0;;1,0;2,0;19,0;;40,0;;2,0;7,0;1,0;1,0;5,0;;;;;1,0;2,0;1,0;4,0;;;;;12,0;1,0;;1,0;;1,0;1,0;;;3,0;;3,0;;;2,0;;5,0;1,0;;5,0;1,0;1,0;;11,0;;;;2,0;6,0;2,0;;;;;;;;;;;;2,0;21,0;;;;;2,0;2,0;21,0;;;;;2,0;1,0;;;;;;8,0;1,0;;;;1,0;;;;;;;2,0;;;;4,0;4,0;;;5,0;1,0;;;;2,0;13,0;17,0;11,0;;;33,0;;1,0;;;;;;;;;;;9,0;3,0;;;;;;;;1,0;;3,0;;1,0;;;1,0;6,0;6,0;;1,0;;;;;;;;;;;;;24,0;;;;1,0;11,0;;1,0;;;;1,0;3,0;9,0;;;;1,0;1,0;;;;;;;;18,0;;;;;8,0;1,0;;;;3,0;;;;;;;;;5,0;4,0;1,0;1,0;5,0;;20,0;;5,0;1,0;9,0;;3,0;;;;4,0;;;2,0;;;;;;;;;;;;;;;3,0;;;;;;;11,0;;;;;;;;;;;;3,0;;;;1,0;;;;2,0;1,0;;;;1,0;;1,0;;;9,0;;1,0;;2,0;;;;;;3,0;;;;;2,0;;14,0;;;;2,0;;1,0;;;1,0;;;;;;;;3,0;;;;;3,0;;;;;;;;;2,0;3,0;;;;;;;;;2,0;;1,0;;;;;;;1,0;;;;;3,0;;;;;9,0;3,0;2,0;;5,0;;;;2,0;;;;;;;;1,0;;3,0;;;;;;;;;2,0;;;;;2,0;10,0;;;;;;;;;2,0;;;3,0;;;;;;;;;1,0;2,0;2,0;;7,0;;;;2,0;7,0;1,0;9,0;;;;;;;;;;;1,0;;3,0;;;;;;;;1,0;;;4,0;;;;;;;;2,0;;;;;;8,0;;;;2,0;;;;;2,0;;;3,0;;;;;;;;;;;1,0;;;;;;;;;;;;;;;;1,0;;;2,0;;;;;;;;;;2,0;;;;;;;;;1,0;;;;;;8,0;;2,0;;;;;;;;;;;;;;10,0;;;;;;;;1,0;;;1,0;1,0;;;;;;;;;;;;1,0;;1,0;;;;5,0;3,0;;;;;;;1,0;1,0;7,0;1,0;1,0;3,0;3,0;2,0;4,0;1,0;;;;;;;;;;;;;;;;;;;;;;;;;;;;;;;;;;;;;;;;;;;;;;;;;;;;;;;;;;;;;;;;;;;;;;;;;;;;;;;;;;;;;;;;;;;;;;;;;;;;;;;;;;;;;;;;;;;;;;;;;;;;;;;;;;;;;
actuator;;;;;60,0;;36,0;30,0;2,0;2,0;4,0;10,0;;;;2,0;;;2,0;;2,0;136,0;;10,0;25,0;;;2,0;5,0;16,0;;2,0;56,0;1,0;22,0;;1,0;173,0;3,0;13,0;4,0;;121,0;43,0;;;;1,0;7,0;15,0;4,0;21,0;;9,0;;45,0;83,0;;5,0;178,0;10,0;;48,0;;1,0;34,0;80,0;6,0;;1,0;35,0;6,0;2,0;;2,0;;77,0;1,0;110,0;7,0;5,0;;19,0;5,0;;;;4,0;;11,0;15,0;1,0;;81,0;1,0;2,0;;1,0;3,0;20,0;17,0;49,0;;5,0;;;10,0;66,0;;;24,0;7,0;14,0;40,0;6,0;;;;5,0;10,0;;7,0;1,0;15,0;;;78,0;15,0;;44,0;1,0;;;2,0;3,0;12,0;16,0;;26,0;;;;12,0;5,0;3,0;21,0;28,0;10,0;;;;2,0;21,0;2,0;9,0;17,0;7,0;14,0;;16,0;;;5,0;2,0;;20,0;5,0;12,0;;5,0;99,0;2,0;61,0;22,0;32,0;6,0;4,0;44,0;;;17,0;11,0;3,0;1,0;;;26,0;32,0;;43,0;;2,0;;20,0;;;;3,0;16,0;;;18,0;;7,0;7,0;;17,0;2,0;4,0;30,0;;1,0;7,0;;2,0;2,0;7,0;1,0;;10,0;4,0;;121,0;;4,0;1,0;;;;2,0;4,0;1,0;;6,0;24,0;1,0;11,0;28,0;3,0;1,0;81,0;;2,0;;17,0;1,0;;1,0;;53,0;;;;48,0;2,0;2,0;2,0;8,0;;;6,0;94,0;3,0;5,0;5,0;3,0;8,0;;;;4,0;4,0;;1,0;3,0;7,0;;1,0;3,0;12,0;5,0;21,0;3,0;56,0;;10,0;70,0;5,0;13,0;3,0;5,0;2,0;2,0;3,0;2,0;6,0;;4,0;2,0;7,0;;1,0;8,0;3,0;7,0;1,0;8,0;5,0;1,0;4,0;2,0;2,0;2,0;;3,0;;3,0;19,0;;1,0;;4,0;6,0;19,0;;3,0;1,0;3,0;4,0;6,0;12,0;;;2,0;;;1,0;;;2,0;;3,0;3,0;1,0;16,0;;;3,0;1,0;7,0;5,0;1,0;;2,0;;;;;;1,0;;;;1,0;;;;;3,0;;;3,0;3,0;3,0;4,0;;;1,0;;4,0;;3,0;;5,0;;;;;;6,0;2,0;10,0;6,0;;37,0;2,0;;;;;4,0;;;;;;;7,0;3,0;4,0;2,0;6,0;1,0;2,0;;;;;19,0;2,0;2,0;1,0;;3,0;14,0;;2,0;1,0;;3,0;;;;;;;;1,0;1,0;;;;;1,0;;32,0;7,0;;;26,0;;;3,0;28,0;;;;;;;;;;3,0;;;41,0;5,0;;;;4,0;3,0;;;;6,0;;;;;;;;;15,0;5,0;;;10,0;;19,0;5,0;;1,0;;;3,0;;;;;;;15,0;1,0;;11,0;;2,0;;;;;6,0;5,0;;;;;;;;;;;6,0;;;;;;;;;;;;;;;3,0;;3,0;;;8,0;2,0;;3,0;;;4,0;;;;3,0;3,0;4,0;3,0;;;;;1,0;;10,0;;;;;;;;;;15,0;;;;;;1,0;;;5,0;;;;;;;;;;;;;2,0;;2,0;;5,0;;;;1,0;;;;2,0;;;;;;;;;3,0;;;1,0;;;;;;3,0;1,0;;3,0;;2,0;5,0;;;15,0;;;;;;;;;;1,0;1,0;;;5,0;;;;;5,0;;2,0;8,0;2,0;;;;;;20,0;;;4,0;;;;3,0;5,0;1,0;;1,0;;;1,0;;1,0;;6,0;1,0;;1,0;;;;6,0;;;;;;5,0;2,0;;1,0;;;;;;;;;1,0;;;2,0;3,0;;;;30,0;;;;;;12,0;;1,0;;;;;3,0;;4,0;;;;;;;;4,0;10,0;5,0;1,0;;13,0;5,0;2,0;6,0;;;1,0;;;;;;;4,0;1,0;;;2,0;;;;;;;4,0;;;2,0;2,0;;;;1,0;6,0;;;;;;6,0;;;;;;;;;;;;;;;;;;;11,0;;;;;;;;;;2,0;5,0;12,0;;;;12,0;;;;;;;1,0;1,0;1,0;;;;8,0;3,0;;9,0;;;5,0;1,0;;9,0;3,0;;36,0;;;1,0;;2,0;;17,0;;;;;;1,0;2,0;1,0;;;;;;;2,0;;1,0;;3,0;;;;3,0;3,0;1,0;1,0;1,0;5,0;5,0;2,0;2,0;6,0;2,0;1,0;2,0;2,0;3,0;1,0;;;;;;;;;;;;;;;;;;;;;;;;;;;;;;;;;;;;;;;;;;;;;;;;;;;;;;;;;;;;;;;;;;;;;;;;;;;;;;;;;;;;;;;;;;;;;;;;;;;;;;;;;;;;;;
address;;;;;6,0;;1,0;48,0;2,0;;;;;5,0;2,0;1,0;;;2,0;7,0;;51,0;;;5,0;;;67,0;;3,0;;17,0;28,0;6,0;17,0;;7,0;;;49,0;;1,0;5,0;;5,0;;;;1,0;1,0;;11,0;;;;131,0;32,0;;12,0;1,0;1,0;;28,0;;;;;;;5,0;5,0;;;;;;;;6,0;;;3,0;1,0;2,0;;;8,0;;1,0;37,0;1,0;1,0;1,0;43,0;;39,0;;46,0;108,0;;;11,0;;44,0;;1,0;4,0;60,0;;;;3,0;2,0;;;;;;;;;;;47,0;;;8,0;3,0;;1,0;;;;;;;;;;;;;;2,0;;;4,0;32,0;;;;;;;;;;;;6,0;;;;;25,0;1,0;;;;;;1,0;6,0;;;;;78,0;;;;;;;;;;13,0;;;;;;7,0;;;;;;;;3,0;;82,0;;2,0;;;;;;;;;;7,0;27,0;;;;;;;;;;;;;;;;;;1,0;;;1,0;;;;;1,0;;;6,0;;;;;6,0;;;3,0;;;;;1,0;;;;;;;;;;;;;;;;;4,0;1,0;;;;;;;;;4,0;;9,0;1,0;;;;;4,0;;;;22,0;;;5,0;;17,0;;;;;;;;16,0;1,0;;;;;;;;;;;;;;3,0;;;8,0;;24,0;2,0;;;;;;12,0;;;;4,0;2,0;;;19,0;5,0;;;1,0;;10,0;;;;;;;;1,0;;;;;4,0;76,0;;;1,0;;;;;;3,0;70,0;;;;;;2,0;;3,0;2,0;;;4,0;;8,0;;4,0;1,0;;;;64,0;5,0;;;;;;;;1,0;;;;;;;;4,0;;1,0;;;86,0;;2,0;5,0;6,0;1,0;14,0;6,0;;20,0;;;4,0;;;;;13,0;;;;;;;;1,0;;11,0;;2,0;17,0;;;7,0;6,0;2,0;;;18,0;;;14,0;;;;;;;;3,0;4,0;;;4,0;;;21,0;;1,0;;;12,0;3,0;;2,0;1,0;;1,0;6,0;9,0;4,0;23,0;;1,0;;;2,0;;;;;2,0;3,0;;;;;;;;;;;;6,0;5,0;105,0;2,0;;1,0;2,0;;;;7,0;;;;1,0;;;;;;;;4,0;;;;;2,0;;;3,0;;;;1,0;;4,0;;16,0;;;4,0;66,0;;2,0;4,0;4,0;2,0;53,0;;;;;;1,0;;;1,0;;11,0;42,0;6,0;;;;;;;;1,0;;;;51,0;;;;;3,0;;;;;;;;;;;;;;;2,0;;;;3,0;;3,0;;;2,0;;;;;;4,0;;;;;;;;22,0;;;;;;;;;;;;;;;;;2,0;;;;;;;;;;;;;5,0;;;;15,0;;;;;;;;;;;;4,0;;;;;;;;;1,0;;;;;;;;;;;;;2,0;36,0;4,0;;;;;;;;;;;6,0;;1,0;3,0;23,0;;;4,0;4,0;2,0;;;;;3,0;;;;;;;;4,0;2,0;;;;;;;;;;;;;;3,0;4,0;;;;;;58,0;;1,0;;;;;;;;;2,0;;;;2,0;;;;;;;;;;;;;;2,0;1,0;;;;;;;;;;;17,0;;3,0;;;;;;;;;2,0;;;;;;;;;;;;;;;;;;;;;;;;;;;;;;;;;;;;;;;;;;;;;;;8,0;13,0;;;;;;;;25,0;;;;1,0;;;4,0;;;;12,0;;;;;;;;;;;;;;;1,0;;;;;;;;;;;68,0;;;;;;;;;1,0;;;;;;1,0;;;;;;;2,0;;;;1,0;;;;;;4,0;;;;;2,0;;;;;;;;4,0;4,0;4,0;1,0;;;;;;;;;;;;;;;;;;;;;;;;;;;;;;;;;;;;;;;;;;;;;;;;;;;;;
adjustable;;;;;17,0;;20,0;29,0;3,0;3,0;22,0;1,0;2,0;;11,0;2,0;1,0;;22,0;;;23,0;;2,0;;;;3,0;1,0;6,0;;1,0;22,0;;3,0;;3,0;2,0;;31,0;19,0;;;18,0;;;5,0;24,0;25,0;;;1,0;;;8,0;36,0;38,0;;37,0;88,0;1,0;3,0;10,0;12,0;;5,0;13,0;1,0;;3,0;27,0;;;;;1,0;;8,0;32,0;17,0;;4,0;;;1,0;;;;;3,0;18,0;;;9,0;3,0;;;1,0;;;3,0;29,0;;;;;;21,0;;;4,0;1,0;;36,0;22,0;;;;;1,0;2,0;1,0;;2,0;;;22,0;2,0;;26,0;2,0;2,0;3,0;6,0;1,0;9,0;1,0;1,0;;3,0;;;;;;2,0;2,0;8,0;;;;;3,0;;2,0;11,0;3,0;14,0;9,0;4,0;;;9,0;;1,0;2,0;;23,0;;2,0;17,0;3,0;4,0;66,0;6,0;2,0;12,0;1,0;;;7,0;;2,0;;2,0;5,0;30,0;16,0;;2,0;;;;2,0;;;10,0;;6,0;11,0;;12,0;2,0;16,0;;;;;9,0;48,0;;;;1,0;4,0;8,0;;1,0;;10,0;6,0;3,0;;2,0;8,0;;1,0;1,0;1,0;;3,0;;;1,0;27,0;6,0;;4,0;1,0;2,0;3,0;5,0;3,0;20,0;1,0;1,0;1,0;;;;;3,0;;10,0;;;6,0;9,0;4,0;5,0;1,0;3,0;1,0;;6,0;;7,0;6,0;2,0;1,0;;12,0;1,0;;;;1,0;;;;4,0;;1,0;7,0;;5,0;4,0;1,0;1,0;;7,0;11,0;1,0;;;6,0;;1,0;1,0;;1,0;;4,0;2,0;;;6,0;25,0;42,0;;2,0;;;1,0;8,0;;4,0;;;;2,0;2,0;3,0;3,0;;8,0;;;;;17,0;3,0;1,0;;;;1,0;;;2,0;;;;2,0;;;;;;7,0;5,0;;;;;;;;;;;;;;;3,0;;;1,0;;;;;;;;;;;1,0;1,0;;;;;;6,0;4,0;;2,0;;3,0;;2,0;1,0;;;3,0;4,0;1,0;;;1,0;2,0;;2,0;;20,0;;;;12,0;7,0;;;;;;8,0;1,0;;;;2,0;6,0;;;;;;;;2,0;;;;;1,0;;;1,0;;;;;6,0;;;;2,0;;;11,0;;1,0;;;;;;;;;;2,0;1,0;3,0;;4,0;2,0;;1,0;1,0;;;;;;;;;;;5,0;;3,0;;;;9,0;;3,0;11,0;2,0;8,0;14,0;2,0;3,0;;;;;;;25,0;10,0;;;2,0;;;;;;;2,0;;;;;1,0;2,0;;;;5,0;3,0;;;;;;;;;2,0;;6,0;;;;;;3,0;2,0;4,0;6,0;2,0;;;;;;5,0;;;;;;;;;;;;;16,0;;1,0;;;;;;;;;1,0;;;;;2,0;;;;;;;2,0;1,0;;2,0;;;;2,0;;;;;;1,0;5,0;1,0;;1,0;;1,0;1,0;;3,0;;;;;;;8,0;;;;3,0;;;1,0;1,0;12,0;;1,0;;;;20,0;;;15,0;;8,0;;;;;4,0;2,0;;;;;;;;1,0;;;;1,0;;1,0;;5,0;;;;;;;;;1,0;;;;;5,0;;;;;;1,0;;;2,0;;1,0;;;;;;1,0;;;;;;2,0;;;;;;;;;;;;;;;;1,0;;;;;;;5,0;;;1,0;;1,0;;;;;;;;;;;;;;;;;;;;;;3,0;;;;;2,0;;;;;2,0;;3,0;;;1,0;;;;;;;;1,0;1,0;1,0;;;3,0;;3,0;4,0;;;;;;;;;;;;;;;;;;;;;;;;;5,0;;;;;;;;;;;;;;;;1,0;;;;;;;;;;;;1,0;;1,0;;;2,0;;;;;;;;;;;;;;;;;;;;;;4,0;;5,0;;;;;;;;;2,0;;;;;;;;;;4,0;;;;;8,0;;;;6,0;;;;;;;;;;;15,0;;15,0;1,0;3,0;1,0;;;1,0;;;;4,0;;;;;;;;;;1,0;;;;;;;;6,0;;;;;;;;;;;;;;;;;;;;;;;;;;;;;;;;;;;;;;;;;;;2,0;;;1,0;1,0;;;;;;;;;;;;;;;;;;;;;;;
aircraft;;;;;3,0;;;4,0;;2,0;;;;;;;;;1,0;;;9,0;;3,0;;;;8,0;;;;5,0;2,0;;;;;;;;;;;;;;;;;;;2,0;;;;6,0;6,0;;;;;;10,0;;;;4,0;;;;;;;;;;;;25,0;2,0;;;;;;;;;3,0;;;;;9,0;;;;2,0;1,0;;1,0;12,0;;;;;;3,0;;;;1,0;;;1,0;;;;;;;;;;;;;;;;;;;;;;;;;;;2,0;3,0;;;;;;;;;;;;2,0;;;;;;;;;;;;;1,0;;;;;;6,0;1,0;;;;;;4,0;;;;;;;1,0;;;;;;1,0;;;;;;;;;;;;;;;2,0;;;;;;;;;;1,0;;;9,0;;;1,0;;;;;;;;;;4,0;;;;;;;;;;;;;;;;;;;;;;;;;;;;;;;;;;;;;4,0;6,0;;;;;;;;;;;;;;;;2,0;;;;;;;;;;;;;;;;;1,0;;1,0;;;;;;;;;;;;;;1,0;;;;;;;;;;;1,0;;;;;;;;;;4,0;;;;;;;1,0;;;;;;;;2,0;;;1,0;;;;;4,0;;;;;;;;;;;;;;;;;;;;;;;;1,0;;;;1,0;;;;;;;;;2,0;;;;;;;;;;;;;;;;;;4,0;;;;;;;;;;;;;;;;;;;;;;;;;;;;;;;;;;;;;;;;;;;;;;;;;;;4,0;1,0;;;;;;;;;;;;;;;;;;;;;;3,0;1,0;;;;;;;;;;;;;;;;;;;;;;;;;;;;;;;2,0;;;;;;;;;;;;;;;;;;;;;;;;;;;;;;;;;;;;;;;;;;;;;;;;;;;;;;;;;;;;;;;;1,0;;;;;;;;;;;;;;;;;;;;;;;;;;;;;;;;;;;;;;;;;;;;;;;;;;;;;;;;;;;;;;;;;;;1,0;;;;;;;;;;;;;;;;;;;;;;;;;;;;;;;;;;;;;;;1,0;;;;;;;;;;;;;4,0;;;;;;;;;;;;;;;;;;;;1,0;8,0;;4,0;;;;;;1,0;1,0;;;;;;;;;;;;;;;;;;;;;;;;;1,0;;;;;;;;;;;;;1,0;;;;;;;;;;;;;;;;;;;;;;;;;;;;;;;;;;;;;;;;;;;;;;;;;;;;;;;;1,0;;;;;6,0;;;;1,0;;;;;;;;;;;;;;10,0;;;;;;;;;;;;;;;;;;;;;;;;;;;;;;;;;;;;;;;;;;;;;;;;;;;;;;;1,0;;4,0;;;;;;;;;;;;;;;;;;;;;;;;;;;;;;;;;;;;;;;;;;;;;;;;;;;;;;;;;;;9,0;;;;;;;;;;;;;;;;;;;;;;;;;;;
ambient;;;;;1,0;;;29,0;3,0;7,0;;4,0;;;8,0;2,0;5,0;;4,0;1,0;28,0;7,0;;;3,0;;;11,0;;12,0;;23,0;19,0;;5,0;;1,0;;;33,0;1,0;;;3,0;;;;;7,0;7,0;7,0;;;1,0;;31,0;8,0;;;7,0;3,0;;24,0;;;;;2,0;;;3,0;;;;;;;2,0;2,0;2,0;;;;3,0;1,0;1,0;1,0;;1,0;6,0;22,0;;;2,0;;;;1,0;4,0;;1,0;9,0;;;;;;3,0;;;1,0;1,0;;;;;;;2,0;;;;;7,0;;1,0;17,0;;;1,0;;;1,0;;1,0;1,0;3,0;;;4,0;2,0;6,0;2,0;;1,0;;1,0;;;;;;;2,0;;;;;36,0;;;;;;;;57,0;205,0;;;;;10,0;;;;;10,0;;;3,0;;2,0;;;;;2,0;;;;;;13,0;;;;;;;;;5,0;;;;;;;;;;1,0;;;4,0;;3,0;;1,0;;;;9,0;;2,0;;;;;;;;;2,0;3,0;;;5,0;;;;;;;;1,0;;;;;;;;;;;2,0;;;;4,0;;;;;;;;;;;;;;;;;;;;;;;;;;15,0;5,0;;;;;;;;;;;;;;1,0;;;;;1,0;;4,0;1,0;;;;;;;;;;;16,0;;;;5,0;;;1,0;;;1,0;;;;;;;;;;16,0;3,0;3,0;;;;;;1,0;;;;;;;;;;;;;;;;14,0;;;;;;;;20,0;;;;2,0;;;1,0;;4,0;3,0;6,0;;;;;;;3,0;;;;;;;;1,0;;;;;;;;;;5,0;;;;3,0;;2,0;;;;;;;;2,0;15,0;;;1,0;;3,0;;;;;;;;;;1,0;;;;1,0;;;;;;;;;2,0;1,0;;;;;2,0;;;;;;;;;;1,0;;;5,0;;;;;;;;;;;;;;;;;;3,0;;;45,0;;;2,0;;;;;;;;;;;;;;;;;;;1,0;;;;;;;;;;;3,0;;;;;;;;;;1,0;;;;;;;;;;;;;;;;;;1,0;;;1,0;;;;;;;;;;8,0;;;;;;;;;;;;;;;;2,0;;;2,0;;;;;;;;;;;;;1,0;;;;3,0;2,0;;;;;;;;;;;;;;;;;;;;;1,0;;;;;;;;;;;;2,0;;;;;;;;;;;;;;;;;;;;;;;;;;;;;1,0;;;;;;;;;;;;;;2,0;;;;;;;;;;;;;;;;;;;;;;;;;;;;;4,0;1,0;;;;;;;;;;2,0;1,0;;;;;;;;;;;;3,0;;;;;;;1,0;8,0;1,0;;;;2,0;7,0;;;;;;;3,0;;;;9,0;;5,0;1,0;;;;;;;;;;5,0;2,0;;;;;6,0;;;;;;;;;;;;;;;;;;2,0;;;;;;;;;;;;;;;;;;;32,0;;;;;;;;;;;;;;;7,0;;;;4,0;;1,0;3,0;;;;;3,0;;6,0;;;;;;;;;;;;;;1,0;;;;;1,0;;;;;;;;;;;;;;;;;;;;;;;;;;;;;;;;;;;;;;;;;;;;;;;3,0;;;;;;;;;;;;4,0;;;;;;;;2,0;;;;;;;;;;;;;;;;;;;;;;6,0;;;;;;;;;;;;;;;;;;;;;;;;;;;;;;;;;;;;;;3,0;;;;;;;;;;;
amplifier;;;;;3,0;;;1,0;;;;;;;1,0;;;;7,0;;;22,0;;;;;;12,0;;11,0;;1,0;53,0;;4,0;;;1,0;;3,0;;;9,0;19,0;;;;;1,0;;;2,0;;1,0;;16,0;50,0;;;2,0;;;10,0;;;3,0;;;;23,0;;;11,0;;;;;3,0;1,0;14,0;;1,0;1,0;;;;6,0;;4,0;13,0;9,0;2,0;;121,0;;;;2,0;2,0;;;2,0;;6,0;;;13,0;28,0;;;2,0;2,0;3,0;;;;;;;;;;2,0;59,0;;1,0;14,0;4,0;;16,0;;;;;;1,0;6,0;;2,0;;2,0;;6,0;;1,0;;6,0;1,0;;;;;;;1,0;;;;;15,0;3,0;3,0;;;;;22,0;5,0;4,0;3,0;;13,0;;;;;;203,0;;;;;2,0;;;;;30,0;;;;;;12,0;;;;;2,0;;2,0;;;3,0;;;7,0;;1,0;;;;2,0;1,0;;3,0;;;;;;;1,0;;;;;;1,0;;;;1,0;1,0;2,0;;;6,0;;;2,0;;;;;;;;;;57,0;;;99,0;2,0;1,0;;;;;4,0;6,0;;;;;;;;;;;;;;;;;1,0;;;;;;;;;;;2,0;;;;1,0;;;3,0;;;;;;11,0;;;;;1,0;;;10,0;;;;;;;;;;;4,0;;;1,0;21,0;;;5,0;;;;;;;2,0;;1,0;;;;1,0;1,0;1,0;;1,0;;6,0;;;;;;1,0;;1,0;3,0;;;;;;;7,0;;;;;;;;2,0;3,0;;;7,0;;10,0;;29,0;;10,0;;;2,0;1,0;2,0;1,0;1,0;;;;;;1,0;2,0;;;5,0;1,0;;;;;;;;1,0;;;;;6,0;;;;;;32,0;;;;;;1,0;;;24,0;;1,0;;;;;;;9,0;;;;;;;;;;4,0;5,0;;11,0;;;;;;;;;;;;;;;1,0;;;;;;;9,0;;;2,0;;;;;;2,0;;;;;;;3,0;;1,0;;30,0;1,0;12,0;3,0;;;61,0;;2,0;;;;;;;;;;;;;;;;2,0;;;;;;;;;;;;;;;;;;;;49,0;;;;;;1,0;;;;;;;;;;;;;;;3,0;;;;30,0;3,0;;;;;;;;;;;;;;;;;;;;;;;;9,0;;;1,0;;;;;;2,0;7,0;;;;4,0;;;1,0;;;;;;;;;;;;;;;;;;12,0;;3,0;;;;;;3,0;;;9,0;1,0;2,0;;;;;;;;;;;;;;;;;2,0;;;;;;;;8,0;;;;;;;13,0;;;;;;;;;1,0;;;;1,0;;;51,0;;;;52,0;12,0;;;8,0;;2,0;4,0;;;11,0;21,0;3,0;2,0;;;2,0;14,0;;;;3,0;;;;4,0;;;1,0;;;108,0;;;;;;;;1,0;1,0;;;;;;12,0;;;13,0;;;;;;;;;8,0;;;;19,0;;;;;;;;;;37,0;;;;;1,0;;12,0;;;4,0;;;;2,0;;;;;4,0;3,0;2,0;;;;;;;;;;;;;;;1,0;;;;;;;;;2,0;;;;;;;;;;;;;;;;;;3,0;;;;;;;;;;;1,0;;;;;;;15,0;;;;;3,0;;1,0;5,0;;;;;;;;;;;;13,0;;2,0;;;;;;;5,0;;;;;;;;;;;;;;;;;;;;;;;;;;15,0;;;;;;;;;;;;;;;;;;;;;;;;;;;;;;;;;;;;;;;;;;;;;;;;;;;;;;;;;;1,0;;;;;;;;;;;;;;;;;;;;;;;;;;1,0;;;;;;;;;;;;;;;;;;;;;;
annular;;;;;2,0;;7,0;15,0;;;2,0;;2,0;;;;;;;;;2,0;;;;;4,0;;6,0;;;;8,0;;4,0;;2,0;10,0;;4,0;;;6,0;20,0;;;;;3,0;;;1,0;;;;8,0;35,0;;;58,0;;;;;;3,0;2,0;1,0;;;6,0;;12,0;21,0;10,0;;2,0;;6,0;;;;;;;;16,0;;;;;;;;1,0;85,0;5,0;;;;60,0;9,0;1,0;;;;1,0;5,0;;;3,0;8,0;1,0;14,0;22,0;;2,0;;4,0;17,0;;1,0;;;;;8,0;17,0;;19,0;4,0;1,0;;3,0;5,0;;4,0;;1,0;;;;;14,0;3,0;2,0;63,0;1,0;;;;15,0;4,0;;7,0;16,0;14,0;7,0;49,0;5,0;;12,0;117,0;21,0;;;;82,0;;3,0;92,0;8,0;30,0;32,0;;11,0;112,0;;;;;;1,0;1,0;3,0;;16,0;11,0;1,0;237,0;1,0;5,0;;10,0;;5,0;;8,0;4,0;7,0;;23,0;5,0;24,0;1,0;;;4,0;2,0;24,0;;2,0;;3,0;;;;;;;11,0;;2,0;59,0;18,0;;7,0;;;3,0;1,0;;11,0;;1,0;1,0;;1,0;7,0;;32,0;6,0;;1,0;3,0;;6,0;;1,0;1,0;;;;20,0;;;2,0;29,0;;3,0;;8,0;15,0;6,0;15,0;2,0;13,0;;17,0;;1,0;6,0;;1,0;;;;1,0;1,0;9,0;3,0;7,0;1,0;3,0;;;1,0;2,0;;4,0;;1,0;11,0;;6,0;1,0;;;;;;;1,0;7,0;;22,0;;;13,0;8,0;;5,0;;;101,0;;8,0;2,0;1,0;7,0;1,0;;10,0;1,0;;7,0;8,0;10,0;;;;3,0;;;;;;;;;3,0;;;;;;;4,0;;;1,0;;;;;;;;;;;;3,0;1,0;;;;;;;;;;;;;;;;1,0;;;;;;;;;;;;;4,0;;3,0;;;;;;;;;;;;;;;;;;;;;;;;1,0;;;;;;2,0;;;;;;;;;;;3,0;;;;;;;;;2,0;;1,0;;;;;;;;;;;;;;;;;;;;6,0;;;;2,0;1,0;;;;;;;;;4,0;;;;;15,0;;;;;;;;;1,0;;;;8,0;;;;;;5,0;4,0;;;2,0;;2,0;;;;;;;;;;;;;;;;;;;1,0;;;;;;;1,0;;;;;;;4,0;3,0;;;;;1,0;;;;;;;;;1,0;;;;;;5,0;;1,0;;;;;;;;;;23,0;;;;;;6,0;;;;9,0;;;;;5,0;;1,0;;;;;;;;;;;;;3,0;2,0;;;;1,0;;;;;;;1,0;;;;;2,0;;4,0;;;;;;;;;1,0;4,0;27,0;;7,0;;2,0;;;;;;;;;20,0;;;;;;;;;;;;2,0;;4,0;1,0;;;4,0;;;;;;;;;;;;;;;;;;;;;;;;;;;;;;;;;1,0;;;;3,0;1,0;;;;;;;;;;;;;;;;;1,0;;;;;;;;;;;2,0;;;;;;;;;;;;;;;;;;;;;;;;;1,0;;;;;;;;;;;;;;;;;3,0;;;;;;5,0;;;;;;;;;;;;;;;;1,0;;2,0;;;;4,0;;;;;;;;;;1,0;6,0;;;;;;;;;;;;6,0;;;;;;;;;;;;;;;1,0;4,0;;;3,0;;;;12,0;4,0;;;;;;;;;1,0;;;;;;;;;;;;;;;2,0;;;;;;1,0;;;;9,0;;;3,0;;;;;;;;;;;;4,0;;;;;1,0;;;;;;;;;1,0;;;;;;;;;;;;;;;;;;;;;;;;;;;;;;;;;;;;;;;;3,0;;8,0;;;2,0;;;;;;;;;;1,0;;;;;;;;;;;;;;;;;;;;;;;;;;;;;;;
antenna;;;;;1,0;;1,0;6,0;;;1,0;;;;;;;;;;;7,0;;;;;;8,0;;;1,0;;8,0;;2,0;;;;;2,0;;;;;;;;;;2,0;2,0;;;;;8,0;9,0;;;2,0;;;3,0;;;;;;;;;1,0;;;;;;1,0;8,0;1,0;;1,0;;;;;;;;;13,0;;;11,0;;;;2,0;4,0;;3,0;19,0;;;;;1,0;13,0;1,0;;3,0;;;;1,0;;;;;15,0;;;;1,0;;;6,0;;;5,0;;;;;;;11,0;;;;1,0;;4,0;;5,0;;1,0;;;;;;;;;;;6,0;5,0;;;;;1,0;;;;1,0;;;3,0;;3,0;8,0;;;;3,0;;;;;;1,0;;2,0;;22,0;;2,0;;;;20,0;;;;;4,0;;;;;4,0;;3,0;;;;;4,0;;;;;;6,0;;;;;;;;;;;;;;;;;;;4,0;;;4,0;;1,0;;;;4,0;;;;;4,0;;;;2,0;;;;;;1,0;;;;;;;4,0;;;;;2,0;2,0;;;;;;;10,0;;;;;;;;;7,0;;;;;;;;;;;;1,0;;;;;2,0;;;;;;;;;7,0;;1,0;;;;;1,0;;;;;;;1,0;;;;;;;;;;;;;;;;;;;;;;2,0;;;;;;;;;;;;;;;;;;;;;;;;;;1,0;;;1,0;;;;;1,0;;;;;;;;;;;;;;;;;;;;;;;;;;2,0;;;;;;;;;1,0;;2,0;;5,0;2,0;1,0;;;;;;;1,0;;;;;;1,0;;;;5,0;1,0;;1,0;;;;;;;4,0;;3,0;;;;;;;;;;2,0;;2,0;;;;;2,0;;;;;;7,0;;4,0;;;;2,0;;;;;;;;;;;;;;;;;;;;;;;;;;5,0;;;;;13,0;3,0;;;;;;2,0;;;;;2,0;1,0;;;2,0;;;;;;;;;;;;;;;;;;;;;1,0;2,0;;;;;;;1,0;1,0;;;;;;;1,0;;;;1,0;;;;;;;;;;1,0;;;;;;;;;19,0;;;;;;;;1,0;;;;;;;;;;;;;;;;1,0;;6,0;;;;;;;;;;;;3,0;;;;;;;;;;;;;;;;;;;;;;;;;1,0;;;;;;;;;;;;;;;;;;;3,0;;;;;;;;;;;;;;;;;;;5,0;;;;;2,0;;;;2,0;;;1,0;;;;;;1,0;;;;;;;;;;;;;;;;;;;;;;;4,0;;;;;;;;;;;4,0;;;;;;;;;;;;;;;;;;;;;;;;;;;;;;;;11,0;;;;;;;;;;;2,0;;;;;;;;;;;3,0;;;;;;;;;;;;;;;;;;;;;;;;;;;;;;;;;;;5,0;;;;;;11,0;;;;;4,0;;;;;;;;;;;;;;;;;;;;;;;;;;;;;;;;;;;;;;;;;;;;;;3,0;;;;;;;1,0;;;;;;;;;;;;;;;;;;;;;;;;;;;;;;;;;;;;;;;;;;;;;;;;;;;;;;;;1,0;;;;;;;;;;;;;;;;;;2,0;;;;;;;;;;;;;;;;;;;;;;;;;;;;;
attribute;;;;;8,0;;;16,0;1,0;8,0;;2,0;;;5,0;4,0;;;;3,0;14,0;5,0;4,0;;;;4,0;106,0;;2,0;;5,0;1,0;;1,0;;;;;1,0;;;;;;;;;;;;2,0;8,0;4,0;;80,0;15,0;;;7,0;;;12,0;;;;;;;;;;;;;;;1,0;;4,0;;9,0;;;;;5,0;;2,0;13,0;;;;;;8,0;;12,0;42,0;;;4,0;;;;;;41,0;;;2,0;;;;19,0;;;;;3,0;;;;;;;1,0;;;;;;;;;;;;;;;;;7,0;;;4,0;;;;;;;;;;;;7,0;;;;;;;;2,0;;;;;;1,0;;;;;8,0;;;;;;;;;;8,0;;;;;;2,0;;;;;;;;;;;;1,0;;;;;;;;;3,0;5,0;;;;;1,0;;;2,0;;;;;;;;;;;;;;;;;;;;;;2,0;3,0;;;;;;;5,0;;;;;;;;;;;;;;;;;;;;;4,0;;;;1,0;;;;;;;;;4,0;;;;;;9,0;;;;2,0;;;;;2,0;;;;;;;;4,0;;;;;;;;;;;;;;;1,0;;;3,0;;2,0;;;;;;;3,0;;;;18,0;;;;;;;;1,0;;;;;;;;;;;;;;;;16,0;1,0;;;;;;;;6,0;1,0;;;;;;;;;2,0;;;;3,0;15,0;;;;;;;;4,0;;;;;;;;;;3,0;;;;1,0;;;;4,0;3,0;;;;;;;;;;3,0;27,0;;;;;;;;;;;;;;;;;;2,0;;;4,0;;;;;1,0;;;;;;;;3,0;;;;;;;4,0;;;;;;8,0;;;;;;;;10,0;;;;;2,0;;37,0;;6,0;;;3,0;2,0;;;;;6,0;;;;;;;;;;;;;;;8,0;;;;;;;;;;;;;;;;;;;12,0;;;;;2,0;;;;;;;;;;;12,0;;;;;;;;;1,0;11,0;;;;;;4,0;;;;;2,0;1,0;;;;;;;;;;1,0;;;4,0;;;;;;;;;;;;;4,0;;;;;;;;;;;;;;;;;;;;;;;;;;;;;;;;;;;;;;;;;;;;;;;;;;;;2,0;;;;;;;;;;1,0;;;;;;;;;;;;;;;;;;;;;;1,0;2,0;;;;;;;;;;;;;;;1,0;1,0;;;;;;;;;;;;;;;;;;;;;;;;;;;;3,0;;;;;1,0;;;;;;;;;;;;1,0;;;;;;;;;1,0;;;;;;1,0;;;;;;;;;;;;;;;;;;;;;;;;;;;2,0;;;;;;;;;;;;;;;;1,0;;1,0;;;;;;;;;1,0;;;;;;;;;;;;;;;;;;;;;;;;;;;;;;;;;;;;;;;;;;;;;;;;;;;;1,0;;;;;;;;;;;;;;;;;;;;;;;;;;;;;;1,0;;;;;;;;;;;;;;;;;;;;;;;;;;;;;;;;;;;;;;;;;;;;;;;;;;;;;;;;;;;;;;;;;;;;;;;;;;;;;;;;;;;;;;;;;;;;;;;;;;;;;;;;
auto;;;;;45,0;;2,0;10,0;;2,0;;;;;3,0;;12,0;;;;;66,0;;;2,0;;28,0;5,0;;12,0;10,0;6,0;10,0;3,0;32,0;4,0;;3,0;1,0;12,0;6,0;;2,0;;;;;6,0;299,0;2,0;6,0;9,0;;2,0;;18,0;9,0;;3,0;30,0;1,0;4,0;46,0;;;1,0;3,0;;1,0;28,0;12,0;;;;;2,0;;6,0;13,0;;;4,0;5,0;;;;1,0;;;7,0;2,0;4,0;2,0;7,0;;;;;;;2,0;15,0;;;;;1,0;52,0;10,0;;1,0;;;;;8,0;;;;6,0;;;1,0;11,0;;;12,0;;11,0;;;;;;1,0;;;;;;;;;;;;1,0;;;;;;;;;;1,0;1,0;2,0;9,0;;2,0;;;;;6,0;3,0;1,0;;1,0;;5,0;;5,0;;;1,0;;;2,0;;;;;;;11,0;;5,0;;;;9,0;;;;;;;;;;;;;2,0;;;1,0;;;;;;2,0;1,0;;;;;;;;;;;;1,0;;;;;2,0;9,0;;;;14,0;;2,0;;4,0;;;;;;;7,0;;;;1,0;;;;;;;2,0;8,0;11,0;;1,0;;;;;;;;;;;;1,0;;;;;2,0;1,0;2,0;;;16,0;5,0;;2,0;;;;;2,0;1,0;;;;;1,0;;5,0;1,0;;;;8,0;;;41,0;2,0;;;;;;;;;;;;;;;;1,0;4,0;;;;;;;;;1,0;;;;6,0;;;;;6,0;2,0;;4,0;;;1,0;;;2,0;;;;;1,0;;;;;2,0;;;;;4,0;;;2,0;1,0;;;;;;;;;;;;2,0;2,0;;1,0;;1,0;;;5,0;3,0;5,0;2,0;6,0;;;;;;;;;7,0;;1,0;;;;;;;1,0;;;;1,0;8,0;;;38,0;;;;1,0;7,0;1,0;5,0;;;;;;;;;;;;;;25,0;;;2,0;;;1,0;;3,0;;;;;;;4,0;;;6,0;;;;;2,0;;;17,0;;;;;;;;;;;;;;;;1,0;;3,0;;10,0;;;3,0;;;2,0;;;;;;;;;;;;;;;;3,0;;;1,0;;;;;;;;;;;;;;;;;;;4,0;;;;;;;;;;;;;;;5,0;;;;;;;1,0;;1,0;;;;;;;1,0;;1,0;;;;;;;;;;;;;;3,0;;;1,0;;;;;;;;;;;3,0;;;;;;10,0;;;;;;;;;;;;;;;;;;2,0;;;;;;;;2,0;;;;;16,0;;;;;;;;3,0;;;;;;;;;;;;;;;;;;;;;;;;;;;;;2,0;;;;;;;;;;;;;2,0;1,0;;;;2,0;;;;;;;;;;;;;;;;;;;;2,0;3,0;;1,0;;4,0;;;;;;;2,0;;;;;1,0;;;;;7,0;;;2,0;;;;;;;;;;;;;;;;2,0;1,0;;;;;;;;;;;;;;;;1,0;;;3,0;;1,0;;;;;2,0;;7,0;;;;;;;;1,0;;;;;;;;;;;;;;;;;;;;;;;;;2,0;;;;;1,0;;;;;;5,0;;;;;;;;;;4,0;;;;;;;;;;;;1,0;;;;;;;;;;;;;;;;;;;;1,0;;;1,0;5,0;1,0;;;;2,0;;;;;;;;;;;;;;;;;;;;;;;;;;;;1,0;;;;;;;;;;;;;;;;;;;;;;;;;;;;;;;;;;;;;;;;;1,0;;;;;;;;;;;;;;;;;;;;;;;;;;;;;;;;;;;;;;;;;1,0;;;;;;;;;;;;;;;;
ball;;;;;15,0;;2,0;2,0;2,0;2,0;1,0;;;;;;;;2,0;2,0;;3,0;1,0;;;;;;;;;5,0;7,0;;5,0;;;22,0;;;3,0;;;8,0;;;;;;;;;;3,0;4,0;16,0;29,0;;6,0;5,0;;;11,0;;;1,0;;;;;8,0;;;;;;;1,0;17,0;;1,0;;2,0;;;;;;;3,0;8,0;;;;;;;;;4,0;53,0;6,0;;;;;1,0;9,0;;;1,0;2,0;11,0;23,0;5,0;;;;7,0;1,0;4,0;;;2,0;;;5,0;14,0;;16,0;1,0;;;1,0;;;4,0;;;;;;;10,0;;;24,0;3,0;;4,0;;14,0;14,0;;2,0;42,0;49,0;2,0;;;;;3,0;4,0;;3,0;;;;1,0;22,0;;7,0;9,0;4,0;5,0;7,0;;5,0;;;2,0;;;5,0;;16,0;36,0;;36,0;;;;17,0;1,0;;;1,0;12,0;2,0;;3,0;;1,0;;;11,0;5,0;1,0;17,0;;;;;1,0;;;;;;25,0;;;;;;;;;;11,0;;;;;;4,0;;;;1,0;29,0;;32,0;;2,0;2,0;5,0;3,0;;;;3,0;12,0;2,0;;;1,0;6,0;1,0;1,0;;;3,0;24,0;2,0;1,0;3,0;;1,0;;;8,0;2,0;4,0;;;2,0;6,0;4,0;;4,0;;10,0;;;2,0;1,0;;9,0;;;;;;;;1,0;;;;;;;;9,0;;6,0;1,0;9,0;1,0;6,0;;;3,0;;1,0;;7,0;;;;27,0;16,0;;;;13,0;;;;;;;;;2,0;;;;;;;;;;;;;;;;;;1,0;;;;;;;;;;;;;;;;;;;;;;;;;;;;;;;;;;;;;;2,0;;;;;;;;;;1,0;;;;;;;;1,0;13,0;;;;;;;;;4,0;2,0;;;;;;;;;;;;;;;;1,0;;;;;;;;1,0;;;;;;;;;;;;;;;;;;;;;6,0;;;;;;1,0;;;;1,0;;;2,0;;;;;;6,0;1,0;;;;;;;;4,0;;;;;;;;;;1,0;1,0;;7,0;;;;;;;;4,0;;;;;;8,0;;;;;;;;;;;4,0;;;;;;;;;;;16,0;;;;;;;;;2,0;;;1,0;;;;1,0;;;;;7,0;;;;;;;;;;4,0;;;;23,0;;;;;;;;1,0;;;;;2,0;;;;;;;3,0;1,0;;;;;;;;;;;;1,0;;;;;;;;;;;;2,0;;;;2,0;;;;;;;;;;;22,0;;1,0;;;;;;;;;;;1,0;;;;;1,0;;;;1,0;;;;;;;;;;;;;;;;;;;;;;;;;;;;;;;;;;;;;;;;;;;;;;;;;;;1,0;;;;;;2,0;;;;;;;;;;;;;3,0;;1,0;;;;;;;;;;;;;;;;1,0;;;2,0;;2,0;;;;;;;;;;;;3,0;;;;;;;;;;4,0;;;;;;;;;;;;2,0;;;;;;;;;;;;1,0;;;;4,0;;;;;;;;;;;;;;;;;;;;;;6,0;;;;;;;;;;1,0;;;1,0;;;;;;;;;;;;11,0;;;;;;;;10,0;;;;;;;;;;;4,0;1,0;;;;;;;;;;;;4,0;;1,0;;;;;;;;;;;;;;;;;;1,0;;;;;;;;;;;1,0;;;1,0;;;;;;;;;;;;;4,0;;;;;;;;;;;;;1,0;;;;;;;;1,0;;;;;;11,0;;;;;;;;;;;;;;;;;;;;;;;;;;;;;;;;;;;;;;;;;;;
barrier;;;;;18,0;;25,0;6,0;;;;;;;3,0;;;;;;8,0;112,0;;;;;;;;2,0;;;14,0;;1,0;;1,0;14,0;;;;;32,0;8,0;;;;;;;3,0;9,0;;4,0;7,0;11,0;31,0;;;241,0;;;9,0;;;3,0;10,0;;;12,0;41,0;;22,0;2,0;;;;4,0;114,0;;12,0;;;;;;23,0;1,0;;3,0;4,0;;1,0;8,0;;36,0;;;9,0;;21,0;13,0;;21,0;;;6,0;56,0;;1,0;1,0;5,0;;;6,0;;;;;10,0;;;;;1,0;3,0;57,0;16,0;;2,0;23,0;;;12,0;;4,0;17,0;;2,0;2,0;;;;4,0;33,0;17,0;20,0;12,0;;7,0;;6,0;3,0;2,0;10,0;;19,0;5,0;1,0;29,0;1,0;;13,0;;;15,0;;30,0;;1,0;198,0;;5,0;36,0;13,0;52,0;9,0;3,0;;;;;5,0;;;5,0;9,0;7,0;;41,0;;;2,0;7,0;;13,0;;;7,0;;12,0;;;14,0;;;;;1,0;;;;8,0;;;;3,0;1,0;1,0;;;;;;;16,0;;;;2,0;;;;6,0;3,0;;2,0;1,0;1,0;;52,0;;16,0;1,0;;8,0;;;;;;;;7,0;;2,0;;5,0;;;1,0;23,0;;;9,0;;5,0;;1,0;;4,0;27,0;3,0;3,0;;1,0;;5,0;;4,0;;;1,0;21,0;;;35,0;8,0;1,0;3,0;;;;;;;17,0;16,0;;;1,0;;1,0;1,0;;1,0;;11,0;3,0;5,0;;5,0;31,0;;2,0;;;;;6,0;;3,0;33,0;13,0;;1,0;;18,0;;;;;;;;10,0;;;;;;;;;;;;;4,0;2,0;82,0;;;;;;3,0;;;2,0;;;;;;;;;;;6,0;1,0;;;;;;;;10,0;2,0;1,0;;;;;;;;;;1,0;4,0;;;2,0;4,0;1,0;1,0;;;;;;;;3,0;;1,0;;2,0;2,0;2,0;;;;;;1,0;;;;;;6,0;;;;;;;;;;;;;;;;;;;;;;21,0;;;;;;3,0;;;;;;;;;;;;;;23,0;;;;;4,0;;;;;;;;;;;;;;21,0;;;;;;1,0;;;;1,0;4,0;;;;;;;;3,0;;;;;;1,0;;;;;8,0;;;;;1,0;;;;;;;;;1,0;;;;;;;;;;;;;;;;;3,0;;;;;;1,0;;;;3,0;1,0;;;1,0;57,0;;;;;10,0;;;;;;;;;;;;;;;;1,0;;;;;;;;;;;;;16,0;;;;1,0;;;1,0;;;;5,0;;;;;;;;;;;;;;1,0;;;;;;;;;;;;;;;;;50,0;;;;;;;;;;2,0;;2,0;;16,0;;;;2,0;;;;;;4,0;;;;;;;;;;;;2,0;;;;;;;;;;1,0;1,0;;4,0;7,0;;1,0;;;;;;;10,0;;;;;3,0;;;;;;;;;;1,0;;;;;4,0;;;;;;;2,0;;;;;;;;;;;;;;;;;;;;1,0;1,0;1,0;;;2,0;;;;;;;;;;;;;;;;;;;;;;;;;;;4,0;;2,0;;;;;;;;;;;;;;;;;4,0;;;3,0;;2,0;;;;3,0;;;;;;;3,0;;;1,0;;;;2,0;;;;;;;;;;;;;;;;;;;2,0;;;;;;1,0;;;;9,0;;;1,0;;;;;;;;;13,0;;;;;;;;;;;;;;2,0;;;;;;;;;;;8,0;;4,0;;;;;;;;;;;;;;;;1,0;;;;;;;;;;;;;;;;;;;;;;;;;;;;;;;;;;;;;;;;;;;;;;;;;;;;;;;;9,0;;;;;;;;;;;;2,0;;;;;;;;;;;;;;;;;;;;;;;;;;;;;;
bearing;;;;;3,0;;15,0;;2,0;;4,0;;2,0;1,0;;;;;;;;;;;;;1,0;;;;;;6,0;;;;;7,0;3,0;5,0;;;18,0;10,0;;;;;;;;2,0;;;3,0;25,0;28,0;;;32,0;3,0;;;;;5,0;;;;3,0;17,0;;;;5,0;;;;7,0;;4,0;;1,0;1,0;;;2,0;;;2,0;1,0;;;1,0;1,0;1,0;;1,0;;2,0;38,0;12,0;;;;;;11,0;;;;3,0;;3,0;1,0;1,0;;;3,0;21,0;;;;1,0;;;3,0;7,0;;10,0;10,0;;;;1,0;1,0;14,0;;;2,0;;;2,0;1,0;;1,0;20,0;15,0;;;;8,0;35,0;;14,0;60,0;10,0;4,0;;;;;9,0;5,0;;;;1,0;;1,0;37,0;;16,0;13,0;2,0;4,0;5,0;1,0;;;1,0;;;;8,0;;12,0;7,0;;63,0;;1,0;;6,0;;;;1,0;7,0;4,0;;10,0;;12,0;;;;;;55,0;;1,0;;;;1,0;;9,0;;3,0;2,0;1,0;;;;;;;;5,0;3,0;;;1,0;;;6,0;;;;;;10,0;1,0;;1,0;2,0;;1,0;4,0;;;;10,0;;;5,0;3,0;;4,0;;2,0;1,0;;;4,0;13,0;;2,0;;;;;;25,0;;;;1,0;2,0;;2,0;;;;;1,0;;3,0;2,0;;3,0;;;2,0;;;3,0;;;;;5,0;;5,0;6,0;10,0;;;6,0;;2,0;;;9,0;;5,0;1,0;10,0;;4,0;;32,0;20,0;;8,0;;9,0;1,0;;;;;;;;;;;;;;;;;;;1,0;;1,0;1,0;;1,0;;;;;;;;;;;;;;;;;4,0;;;;;2,0;;;;;9,0;;3,0;1,0;;;;;;1,0;;;;10,0;8,0;;;;3,0;;;;;;;;;;;;;;;;;;4,0;;;;;5,0;;;;;;;;;;;;;;;;;;4,0;;;;;;1,0;;;;;;;;;;;;;;1,0;;;;;;;2,0;;;;;;;2,0;;;;1,0;;;;;;;;;2,0;;;;;;;;;3,0;6,0;;;;;;;;;;1,0;;2,0;;;;;;;;4,0;2,0;;;;;7,0;;;;;;1,0;;;;;1,0;;;;;2,0;;;;;;1,0;1,0;;1,0;;;1,0;;;;;;;;;1,0;;;;;;5,0;;2,0;;;;;;;;3,0;;;1,0;;;;;;;;;;;;;;;1,0;;;;;;;1,0;;;;;;;;;;;;;;;;;1,0;;;;;;;;;;;;;;;;5,0;3,0;;29,0;1,0;;1,0;;;;;;3,0;;;;;;;;;;;2,0;2,0;1,0;;1,0;2,0;;;;;;;;;;;;;;6,0;;;3,0;;;;;;;;;;1,0;;;;2,0;;;;;;6,0;;;;;;;;1,0;;;;2,0;;;;;;;;;;;;;1,0;;;;;;;;;;;;;;;;;;;;;;;;;;;;;;;;7,0;;;;;;;;;;;;;;;;;;;1,0;2,0;11,0;;;;;;;;1,0;;;;;;;;;;;;;;;;;;;;;;;;;2,0;;;;;;;;;;;;;;2,0;;;;;;;;;;;;;;;;;;;;;;;1,0;;;;7,0;;;;;;;;;;;;;;7,0;;;;;1,0;;;;;;1,0;;;;;;;;2,0;1,0;2,0;;;1,0;2,0;;;;;;;;;;;;;;1,0;;1,0;;5,0;;;;;;;;;;;;;;;;;;;;;;;7,0;;;;;;;;;;;;;;;;;;;;;;;;;;;;;;;;;;;;;;;;;;;;;;;;;;;;;;;;;2,0;;;;;;;;;;;;;
bobbin;;;;;3,0;;;1,0;;;;;;;;;;;;;;;;;;;;;3,0;;;;10,0;;;;;5,0;;;1,0;;;;;;;;;;;;;;;;2,0;;;3,0;;;;;;;;;;;;;;;;;;;;;;;;;;;;;;;;;;;;;;;;;;;;;;;;;;;;3,0;;;;;;;;3,0;;;;;;;;;;;;;;;;;;;;;;;;7,0;;;4,0;;;;;;;;;;;1,0;;;;;;1,0;;;;;;;;;;;;;1,0;;;;;;;;;;;1,0;;;;;;;;;;;3,0;;;3,0;;2,0;;;;;;;;;;;;;;;;;;;;;;;;;;;;;;3,0;;3,0;;;;;2,0;;;;;;;;;8,0;;;;;;;3,0;;;;;1,0;;;;;;;;;;;;;4,0;;;;;4,0;;3,0;;;;;;;;20,0;;;;;2,0;;;;;5,0;;;;;3,0;;;;;;;;;;;;;;;;;;;;;;;;;;;;;;;;;;;;1,0;;;;;;;;;;;;;1,0;;;;;;;;;;;;;;;;;;;;;;;;;;;;;;;;;;;;;;;;;11,0;;;;;;;;;;;;;;;;;;;;;;;;;;;;;;;;;;;;;;;;;;;;;;;;;;;;;;;;;;2,0;;;;;;;;;;;;;;;;;;;;;;;;;;;;;;;;;;;;;;;;;;;;;;;;;;;;;;;;;;;;;;;;;;;;;;;;;;;;;;;;;;;;;;;;;;;;;;;;;;;;;;;;;;;;;;;;;;;;;;;;;;;;;;;;;;;;;;;;;;;;;;;;;;;;;;;;;;;;;3,0;;;;;;;;;;;;;;;;;1,0;;;;;;;;;;;;;;;;;;;;;;;;;;;;;;;;;;;;;;;;;;;;;;;;;;;;;;;;;;;;;;;;;;;;;;;;;;2,0;;;;;;;;;;;;;;;;;;;;;;;;;;;;;;;;;;;;;;;;;;;;;;;;;;;;;;;;;;;;;;;;;;;;;;;;;;;;;;;;;;;;;;;;;;;;;;;;;;;;;;;;;;;;;;;;;;;;;;;;;;;;;;;;;;;;;;;;;;;;;;;;;;;;;;;;;;;;;;;;;;;;;;;;;;;;;;;;;;;;;;;;;;;;;;;;;;;;;;;;;;;;;;;;;;;;;;;;;;;;;;;;;;;;;;;;;;;;;1,0;;;;;;;;;;;;;;;;;;;;;;;;;;;;;;;;;;;;;;;;;;;;;;;;;;;;;;;;;;;;;;
bond;;;;;1,0;;1,0;4,0;;1,0;1,0;;1,0;;;;;;1,0;;;;;;;;;1,0;;;;;4,0;;10,0;;;3,0;;3,0;;;;57,0;;;;;;;;;;;3,0;55,0;11,0;;5,0;53,0;;;25,0;;;;;;;10,0;11,0;;;2,0;7,0;;;2,0;31,0;1,0;;;;;;;5,0;;;;47,0;;1,0;;1,0;1,0;1,0;;;34,0;44,0;4,0;11,0;;;;;22,0;1,0;1,0;;;3,0;12,0;5,0;;;;32,0;;;;;14,0;;;;3,0;;18,0;10,0;;;;;;4,0;;1,0;;;;2,0;;13,0;;41,0;;;12,0;;6,0;1,0;;3,0;15,0;14,0;23,0;;;;1,0;8,0;;;17,0;;;;12,0;7,0;;43,0;5,0;;2,0;;;8,0;1,0;;;;;;2,0;8,0;22,0;;17,0;;1,0;;5,0;;;;;;;3,0;7,0;;8,0;;;5,0;;6,0;10,0;;;;1,0;;1,0;;5,0;;;5,0;;;;;;3,0;;;;;;;2,0;7,0;;;;10,0;;4,0;;;3,0;;;;9,0;;;;;15,0;15,0;;;;7,0;3,0;;;;1,0;;2,0;;2,0;;;;3,0;;;;;17,0;;;;8,0;1,0;;;2,0;1,0;;;;1,0;;;;1,0;3,0;;;;;;;;;3,0;;2,0;1,0;;;;5,0;20,0;;;;2,0;;;;;;;;1,0;;;;2,0;;;;;;;;;;;;;;;;;;;;;4,0;;;;;;1,0;;;;;;;;;;;;;;;4,0;;;;;7,0;;;;;;;;3,0;;;;;;2,0;;3,0;;;;;;;;1,0;;;;;;;;;;;;;9,0;;;;;;;;;4,0;2,0;;;;;;;;;;;;;;;;;1,0;;;;;;;;;;;;;;;;;;;;;;;;;;;;;;;;;;3,0;;;;;;;;;;;;;;;;;;6,0;;;;;;1,0;;;;;;;;;1,0;;;2,0;;;1,0;;;;;2,0;3,0;;;;;;;;;;;;;;;;4,0;;;;;;;;;;;;;;;;;;;6,0;3,0;;;;;;;;;;;;;;1,0;;;;;;;;1,0;;;;8,0;;;;;1,0;;1,0;;;;;;28,0;;;;;;;;;;;;;;;;;;;8,0;;3,0;;;;;;;;;;;;;;;;;;;30,0;2,0;4,0;;4,0;;1,0;;;;;;;;;;;;;;7,0;;;;;1,0;;;;;;;;;;;2,0;;;;;;;1,0;;3,0;;;;;;2,0;;;;;;;;;1,0;;;;;;1,0;1,0;;;;;;;;;;;6,0;;;;;;;;;;;;;;;;;;;;;;;;;;;;;;;;;;;;;;;;;;;;;;;;;9,0;1,0;;;;19,0;;;1,0;;;;;;;;;71,0;;;;;;;;;;;;;;;;;;;;;;;;2,0;;;;7,0;;;;;;;;;;;;;;;;;;;4,0;;;;;;;;2,0;2,0;;;;;;11,0;;;;;;;;;;;;;;;;;;;;;;;;;;;;;;1,0;;;3,0;;;;3,0;;2,0;;;;;;;;;;;1,0;5,0;;;;;;;;;;;;;;;;;;;;;;;;;;;;;;;;;;;;;;;;;1,0;;;;;;;;;;;;;;;;;;;;;6,0;8,0;4,0;6,0;;;;;;;;;;;;;;;;;;;;;;1,0;;;;;;;;;;;;;;;;;;;;;;;;
bottom;;;;;17,0;;5,0;65,0;;10,0;5,0;;4,0;;3,0;1,0;;;16,0;;;8,0;;;;;8,0;2,0;;10,0;4,0;3,0;37,0;;24,0;;2,0;12,0;;14,0;9,0;;;33,0;;;;3,0;;;;3,0;;3,0;22,0;78,0;51,0;;23,0;86,0;;;19,0;;;4,0;1,0;1,0;;4,0;15,0;;;1,0;5,0;;;9,0;25,0;3,0;;1,0;4,0;;;1,0;18,0;;;1,0;20,0;;1,0;6,0;2,0;18,0;;2,0;;77,0;460,0;4,0;;;;;1,0;26,0;;;10,0;8,0;2,0;13,0;25,0;1,0;1,0;;22,0;32,0;3,0;2,0;1,0;20,0;2,0;;24,0;34,0;;21,0;57,0;1,0;;17,0;;2,0;49,0;;1,0;;;;8,0;68,0;4,0;2,0;116,0;16,0;;;;36,0;22,0;;1,0;43,0;58,0;134,0;;7,0;;1,0;24,0;9,0;;12,0;3,0;13,0;;2,0;73,0;1,0;50,0;82,0;3,0;23,0;16,0;5,0;2,0;;39,0;1,0;4,0;;10,0;28,0;74,0;57,0;;191,0;1,0;7,0;;51,0;4,0;1,0;;2,0;1,0;16,0;4,0;25,0;11,0;249,0;13,0;1,0;;6,0;6,0;66,0;4,0;6,0;;2,0;3,0;;;32,0;;;34,0;;;;106,0;;2,0;;;12,0;1,0;;;9,0;1,0;5,0;1,0;3,0;2,0;4,0;35,0;1,0;12,0;;8,0;3,0;5,0;18,0;4,0;;7,0;;18,0;67,0;2,0;1,0;9,0;64,0;3,0;18,0;;2,0;69,0;3,0;6,0;7,0;94,0;2,0;6,0;20,0;;57,0;13,0;;6,0;10,0;1,0;;1,0;15,0;3,0;6,0;;10,0;10,0;3,0;3,0;14,0;4,0;17,0;;3,0;;1,0;;6,0;;2,0;30,0;;3,0;10,0;;8,0;3,0;9,0;;7,0;15,0;42,0;6,0;7,0;2,0;1,0;26,0;;3,0;5,0;9,0;10,0;1,0;2,0;4,0;8,0;;3,0;3,0;4,0;;1,0;2,0;;;;;;;;1,0;;;;;;;;;;9,0;;5,0;;2,0;;;;;;;;1,0;;;;;3,0;;;;;;3,0;;1,0;1,0;1,0;1,0;;;22,0;;;;;;;;;;1,0;;;;;;;;2,0;;;2,0;;;;;;;;;;5,0;3,0;;;;;;;;1,0;6,0;;;1,0;;;;;;;;;;;;2,0;;;;3,0;3,0;;1,0;;;;;;;;;;1,0;5,0;3,0;;;;;;;;;;;3,0;4,0;2,0;;;;;1,0;;1,0;;2,0;;;;;;;;;3,0;6,0;;;;;;;;9,0;2,0;;2,0;;;;;;;8,0;7,0;;;;8,0;25,0;10,0;;;;8,0;9,0;;;;;2,0;;;;;;;;1,0;3,0;;9,0;;;;1,0;1,0;;2,0;3,0;;;14,0;1,0;;1,0;2,0;;;7,0;;2,0;;;3,0;1,0;;;;8,0;;;;1,0;;4,0;;;;;;;;53,0;;15,0;;9,0;;;;15,0;;;16,0;6,0;;;;;4,0;;2,0;1,0;1,0;3,0;;2,0;;;;;1,0;1,0;;;2,0;;;7,0;27,0;2,0;;;;;3,0;1,0;;;;;3,0;;;5,0;2,0;;5,0;;9,0;20,0;4,0;;32,0;2,0;;1,0;5,0;;;7,0;2,0;5,0;;;;1,0;;;7,0;;4,0;2,0;4,0;3,0;3,0;;;15,0;;;;1,0;;;5,0;15,0;2,0;1,0;;;;12,0;;4,0;;1,0;;;;2,0;;;;1,0;;;;;2,0;;;;;;7,0;2,0;;2,0;;;;;;;;;;;;;1,0;;;1,0;2,0;;4,0;;;4,0;;;4,0;;;;1,0;9,0;;;;;;1,0;;;;;4,0;;;;;;;;;;1,0;;5,0;;;;;1,0;;;8,0;;;;2,0;1,0;;;;;;;;;5,0;;12,0;;;;;;;;;;;;;;;;;3,0;;;2,0;;1,0;;;;4,0;3,0;;1,0;;;;;;;;2,0;;;;;;;;5,0;;;;4,0;;1,0;;18,0;;;3,0;;;;8,0;;;;4,0;4,0;1,0;;;1,0;;;4,0;2,0;;;;;;2,0;;;5,0;6,0;;7,0;1,0;;;3,0;17,0;;;;;1,0;;10,0;3,0;8,0;;;;;25,0;;2,0;9,0;2,0;;;;;;;;;;;;;;;;8,0;;10,0;4,0;;;;;;;;;;;;;;;;;;;;;3,0;2,0;;;3,0;;;;;;;;1,0;;;;;;;;;;;;;3,0;;1,0;;;4,0;2,0;;2,0;3,0;;;2,0;;;;;1,0;;8,0;;;;;2,0;;;;;;;;;;;;;;;;;7,0;;;;;;;1,0;
boundary;;;;;8,0;;7,0;3,0;;13,0;8,0;;;;3,0;;;;6,0;4,0;;3,0;11,0;;;;;4,0;4,0;9,0;3,0;6,0;11,0;1,0;1,0;;;6,0;1,0;9,0;10,0;;;5,0;12,0;;;;14,0;;2,0;13,0;;7,0;;74,0;13,0;;2,0;12,0;;;14,0;;;2,0;26,0;;;;4,0;;;;4,0;;;8,0;16,0;;;5,0;1,0;5,0;;;56,0;;1,0;9,0;;;;4,0;;;;;1,0;2,0;5,0;12,0;;;;;3,0;;;;;;;;1,0;;;;;;;;;;;;5,0;;;1,0;;;;4,0;;6,0;;;7,0;1,0;;;;3,0;2,0;;8,0;35,0;;;;;;;;1,0;;;;1,0;;;;;;9,0;2,0;5,0;;3,0;;;5,0;;;;3,0;3,0;;;5,0;;5,0;;;5,0;1,0;20,0;;13,0;;2,0;;2,0;;;;;;;;1,0;;23,0;;;;;;;;;;;4,0;2,0;3,0;5,0;;;5,0;2,0;;;3,0;;7,0;;;;;;;2,0;4,0;;;7,0;12,0;1,0;3,0;;2,0;;;;;1,0;;;;;1,0;6,0;;;3,0;31,0;;;9,0;;6,0;;;;2,0;;;3,0;;;;;;13,0;;;15,0;3,0;;;;;;5,0;4,0;46,0;2,0;5,0;;;3,0;5,0;;;;;;5,0;;;;;;1,0;;4,0;;;11,0;4,0;;;4,0;;;2,0;;2,0;;1,0;1,0;;;;;;;;;;;;;;;;;;;4,0;;;;;;2,0;;;;;2,0;;;;;;;;;2,0;;;2,0;1,0;;;;6,0;;17,0;;3,0;;1,0;;;;;;;;;1,0;1,0;;;1,0;;;;;1,0;;;;5,0;;;;;1,0;;2,0;;9,0;3,0;;;4,0;;;6,0;;29,0;5,0;;;;1,0;;;;;;;;;1,0;;;;;;;;;;;;;;;;1,0;;;;;;;;;;;2,0;;;;;;;;;7,0;;;1,0;;;2,0;;;;;1,0;;3,0;;;;;;1,0;;;;;;;;;;22,0;10,0;;7,0;;;;;;;;;;;;;1,0;;;6,0;;;;;;;;;3,0;;;;1,0;;;;;;;;;;;;;;;3,0;;1,0;2,0;;;;;;13,0;1,0;;;1,0;1,0;1,0;;;;18,0;;;;;;1,0;;2,0;;;;;;;;;;;;;3,0;8,0;;;5,0;;;;4,0;;1,0;;;;;;;4,0;1,0;;;;;;;;1,0;;;;;2,0;;;;;;;;;;;;1,0;;;;;;;;;;;;;;;;;;;3,0;1,0;;;;;;7,0;;;;;;;;4,0;;;;;1,0;;;;;;;;;;;;;;;;;;;;;;;;;;;;;;;;;;;;;;;;;6,0;;;;;4,0;;1,0;;;1,0;;;;;;;;;3,0;;2,0;;1,0;;;;;;2,0;;;;;;;;2,0;;1,0;4,0;;;1,0;;;2,0;;;;;1,0;1,0;;;1,0;;;;;1,0;;;;;;;;;1,0;1,0;;;;;;;;;;1,0;;;;;;;;;;1,0;6,0;;2,0;;;;;;;;;;;5,0;;;;;;;;;;;;;;;;;;;7,0;2,0;1,0;;2,0;;;6,0;;;;;;;;;;;1,0;;;;;;;;;;;;;;;;;;;;;;;;;;;;;;;2,0;;;;4,0;;;;;;;;;;;;;;;;2,0;;;;1,0;;;;;;;;;;3,0;;;;;;2,0;;;;;;;1,0;;;;;;;;;;;;;;;;;;;;;;;;;;;;;1,0;;;2,0;;6,0;;;;2,0;2,0;;;;;;;;;;;4,0;;;;;;;;;;;;;;;;;;;;;;;;;;
bracket;;;;;13,0;;18,0;39,0;;7,0;7,0;;9,0;;;;;;3,0;;;4,0;;;;;1,0;7,0;1,0;;;3,0;11,0;;17,0;;;1,0;1,0;5,0;3,0;;1,0;12,0;;;;;;;;;;6,0;2,0;44,0;62,0;;4,0;24,0;;;4,0;;;52,0;4,0;;;1,0;;10,0;;;;;;2,0;58,0;1,0;6,0;21,0;58,0;;;;;;;7,0;12,0;;;;;6,0;;;;3,0;7,0;34,0;;;1,0;;;9,0;;;8,0;2,0;;20,0;84,0;6,0;;;12,0;48,0;;;1,0;10,0;;;21,0;;1,0;44,0;7,0;;;;;;6,0;2,0;;;;;;12,0;;3,0;13,0;46,0;;;;;3,0;;14,0;12,0;32,0;49,0;;22,0;;;3,0;2,0;;;3,0;3,0;;;42,0;;26,0;302,0;8,0;22,0;11,0;;;;5,0;2,0;;;22,0;31,0;42,0;67,0;;46,0;;1,0;;18,0;1,0;;;;22,0;56,0;;7,0;;12,0;;;;1,0;14,0;108,0;;4,0;1,0;;69,0;1,0;;;;2,0;16,0;36,0;2,0;;;;3,0;;;;10,0;;;2,0;6,0;15,0;7,0;;;2,0;;1,0;18,0;1,0;1,0;;;;;;3,0;;;59,0;;;;7,0;5,0;;;;1,0;5,0;26,0;;21,0;2,0;;;;13,0;2,0;;1,0;;;;4,0;1,0;5,0;4,0;;6,0;4,0;6,0;10,0;19,0;;3,0;;4,0;;;;1,0;;21,0;;;1,0;;2,0;;;8,0;;2,0;;4,0;;2,0;;;23,0;;3,0;;4,0;;;;27,0;2,0;;;1,0;11,0;;8,0;1,0;9,0;36,0;;;;3,0;;1,0;1,0;2,0;;;;;;;;;7,0;;;;;;;;;1,0;;;;;;;;;;;;;22,0;;;;;3,0;;;1,0;;;;;;;;;;3,0;;;3,0;;;;;;;;8,0;;;;;;;;;;10,0;5,0;;;;;;;;;;;;;3,0;;9,0;;;;;;;;;1,0;;;;;;;;;;1,0;;;;7,0;1,0;3,0;;;;;;;;;;;;;;3,0;9,0;;23,0;;;1,0;2,0;;;;;;;;1,0;;;;;33,0;;3,0;;13,0;;1,0;;1,0;29,0;11,0;;;1,0;;;;;;15,0;14,0;;;;;;;;;4,0;12,0;;;;;;4,0;;;;;10,0;;;;;;;;;;7,0;1,0;;;4,0;;;4,0;;;16,0;1,0;;;;;2,0;;;5,0;;;2,0;;;;;5,0;13,0;;23,0;;12,0;;;;;;7,0;;4,0;;;;;;;;;2,0;;;;;;;;;;;;;;4,0;;;2,0;;;;;13,0;;;4,0;1,0;1,0;;;;;4,0;;;;8,0;;9,0;;;;1,0;1,0;;;;8,0;9,0;;22,0;;;;3,0;10,0;;;;;;;;;;;1,0;8,0;8,0;1,0;;5,0;3,0;;;;;;;;;;;4,0;;;;;;9,0;;;;;;;;;;;;;;;;;1,0;;;;;;;3,0;;;;;;;;;;;;;2,0;;;;;;;;;;;1,0;;;;;;;;;;;;1,0;;;;3,0;;;;;;;;;;;;;1,0;4,0;;;;;;;;;;;;;;;;;;;;;;;2,0;;;;;;;;;;;;;;;;;;;1,0;;;9,0;;;;;;1,0;;;1,0;;2,0;2,0;;;;;;;;;;;;;;;3,0;;;;;;;;;;;;;;8,0;2,0;;;;;;;;;;17,0;;;;;;;3,0;;4,0;;;;;;;;;;;;;;4,0;;2,0;;;;;;;;;;4,0;;;;;;;;;;;;;;;;;;8,0;2,0;;;;;;;;;;3,0;;;;;;;;;;;;;;;;;;;;;;;;;;;;;;;;;;;;;;;;1,0;;1,0;;;6,0;;;;;;;;;;1,0;;;;;;2,0;;;;;;;;;;;;;;;;;;;;;;;;;
card;;;;;25,0;;2,0;15,0;;8,0;;;;;;;;;1,0;;;12,0;;;;;1,0;49,0;;58,0;4,0;11,0;33,0;;23,0;2,0;;85,0;;28,0;;11,0;3,0;;;;;;2,0;;1,0;2,0;;3,0;;62,0;32,0;;;21,0;2,0;;17,0;;;;3,0;;;4,0;;;4,0;;;;;10,0;68,0;1,0;;8,0;6,0;;;;;;1,0;5,0;29,0;;;26,0;1,0;;;5,0;6,0;62,0;8,0;55,0;;;;;1,0;14,0;;;;;2,0;8,0;;;;;2,0;1,0;;;6,0;1,0;;;58,0;;;3,0;3,0;;;;;53,0;22,0;;;5,0;;;1,0;1,0;;1,0;;3,0;;4,0;;2,0;;;;;;6,0;6,0;4,0;;;;;;;;11,0;;;;;1,0;15,0;7,0;;;2,0;;;4,0;3,0;;;;4,0;;28,0;;6,0;;;;21,0;;3,0;;;11,0;3,0;;1,0;;;;;;;1,0;9,0;;3,0;;;;3,0;2,0;;;;;;;;;;;;;;3,0;;;;;;;1,0;1,0;;;;;1,0;5,0;2,0;;;;;;1,0;;19,0;;;;1,0;;;;3,0;;;;;2,0;;;;;;;;25,0;17,0;1,0;;;;;;;4,0;;2,0;4,0;3,0;9,0;1,0;;;;;;;;;1,0;;4,0;;10,0;;;1,0;;;;;4,0;;;;;6,0;;;;;;3,0;;;;;;;;;7,0;;;;;;;;3,0;;;2,0;;;;3,0;;10,0;;35,0;;2,0;;;;;;;;;;;;;10,0;;;;;;;;;;2,0;107,0;2,0;;;2,0;;;2,0;3,0;;;;;;31,0;;2,0;;;1,0;4,0;1,0;;;;;;;;;;17,0;;;5,0;;;;;;3,0;;;12,0;;2,0;;;1,0;1,0;;;44,0;;;;;;;1,0;;3,0;;;1,0;;;;2,0;2,0;7,0;1,0;23,0;;;;1,0;4,0;5,0;;10,0;3,0;;6,0;;;;;;;;1,0;;;;;3,0;;10,0;1,0;;2,0;;;;1,0;;;;;3,0;1,0;1,0;;3,0;;1,0;;1,0;8,0;1,0;;;;4,0;;;;;;;;;;;;;;4,0;3,0;1,0;11,0;;;;1,0;;;5,0;;;1,0;1,0;;;;;;7,0;8,0;;;;;1,0;;1,0;;;;;;3,0;;2,0;;10,0;;1,0;5,0;;;3,0;;4,0;;;17,0;;;;;;;;;;;1,0;;;51,0;;;;;;1,0;;;3,0;;;;;;;;;;1,0;3,0;;3,0;;;;1,0;;;1,0;2,0;;;;;;;;;;5,0;39,0;;1,0;;;;;;;;;;;;;;;;;;;;;;5,0;;;;5,0;;;;;1,0;1,0;;;;6,0;;;;;;1,0;;;;;;2,0;;;;;;;;;;;;;;;;1,0;;;;;;;;5,0;;;;;;;;;;;;;;;;;;;;;;1,0;;;;;;;;;;;;;;;;;;;1,0;;;;;;;;;;;;;;;;;;;;;;;;;;2,0;1,0;;;;;;;;;1,0;;;;;;;1,0;;1,0;;;;;;;;;;;;2,0;;;;49,0;2,0;;;;;;19,0;;;;;;;;;;;;;11,0;;;;;1,0;;;;;1,0;;;;;;;;;;;;;;;;;;;;;;;;;;;;;;;;;;;;;;;;;;;4,0;;;;;;;;;;;;;;;;;59,0;;;;;;;;5,0;;;;;;;;;4,0;;;;;;;;;;;;;;;;;;;;;;;;6,0;;;;;;;;;;;;;1,0;;;;;;;;;;;;;;;;;;;;;;;;;;;;;;;;;;1,0;;;;;;;;;;;;;;;;;;;;;;;;2,0;;;;
carriage;;;;;6,0;;12,0;10,0;;;5,0;;;;;;;;;;;7,0;;;;;;;;;;1,0;26,0;;4,0;;5,0;7,0;5,0;1,0;;;7,0;10,0;;;;;;;;;;;;;10,0;;;19,0;2,0;;6,0;;;2,0;26,0;;;;;;4,0;;;;;1,0;30,0;;1,0;;;;;;;;;;;;4,0;;;;;;;2,0;9,0;8,0;;;;;;1,0;;3,0;3,0;1,0;;3,0;7,0;;;;;8,0;;;;;;;2,0;2,0;;7,0;1,0;;;;;;5,0;;;;;;;2,0;;4,0;3,0;7,0;;;;;16,0;;;;;6,0;1,0;4,0;;;1,0;1,0;;;;1,0;;;1,0;;3,0;16,0;13,0;2,0;4,0;;;;;;1,0;;;;3,0;2,0;;;;;;;;;;;7,0;2,0;;4,0;;9,0;12,0;;;4,0;;25,0;;;;;22,0;;;;3,0;;;2,0;;;3,0;;;;;;;1,0;7,0;3,0;1,0;;1,0;;;;;;;2,0;;;3,0;;;;;;;;;2,0;2,0;3,0;;;;12,0;1,0;;1,0;;8,0;;5,0;;;;;1,0;3,0;;;;1,0;1,0;;;;2,0;;;6,0;;2,0;;;;;1,0;;;;;;;;;1,0;1,0;;;7,0;;;;1,0;;3,0;;;;3,0;;;;;;1,0;40,0;;1,0;;2,0;;25,0;;;;;;;;;;1,0;3,0;;;;;;;16,0;3,0;;;;;;;;;1,0;;;;;3,0;;;;;;;;;1,0;;2,0;;;;;;3,0;;;;;;;;;;;;1,0;;;;;1,0;9,0;;;2,0;;;;;;;;;;;1,0;;;;;;;;1,0;1,0;;;30,0;;;;;;;;;;;;;;;;;;;;;;;;;;;;;;;;;;;;;;;;;;;3,0;;4,0;;;;;;;;7,0;;;;;;;;;4,0;;;;;;;;;5,0;;;;;;;;;;;;;5,0;;;3,0;;;;;;2,0;;;;;;;;;;;;;;;;;;;;;3,0;;;;;;;;;;1,0;;;;;;;;;5,0;;;;;;;;;;5,0;;;;2,0;;;;3,0;;;;;;;;;;;;;;;;;;7,0;;;;;;;;;;;;;;;;;;;;;;;;3,0;;;;;;;;;2,0;;;;;;;1,0;3,0;;;;;;;;;;;;;;;;;;;;;;;;;;;2,0;;;;3,0;;;;;;;;;;;;;;;;;;;;;;;;;;1,0;;;;;;;1,0;;;;;;;;;;;;1,0;;;;;;;;;;;;;;;;1,0;;;;;1,0;;;;;;;;;;;;;;;;;;;;;;;;;;;;;1,0;;;;4,0;;;;;;;;;;;;;;;;;;;;;;1,0;;;;;;;;;;;;;;;;;;;;;;;;;;;;;;;;;;;;;;;;;;;2,0;;;;;2,0;;;;;;1,0;;;;;;1,0;;;;1,0;;;;;;;;;1,0;;;;;;;;;;;;;;;;;;;;;;;;;10,0;5,0;;;;3,0;;;;;;;;;;;;;3,0;;;;;;;;;;;;;;;;;;;;;;;;;;;;;;;;;;;;;;;;;;;;;;;;3,0;1,0;;;;2,0;;;;1,0;;;;;;;;;;;;;;;;;;;;;;;;;;;;;;;;;;;;;;;;;
chain;;;;;2,0;;;;;1,0;;;;;;2,0;;;;;;;;;;;;10,0;3,0;;;1,0;2,0;;2,0;;;;;;;;10,0;;;;;;;;;;;;;13,0;3,0;;;;;;5,0;;;1,0;;;;;;;;;;;;2,0;6,0;;;2,0;;;;;;;;2,0;1,0;;;;;;;;;;;3,0;;1,0;;;;;;;;;;1,0;3,0;;;;;;;2,0;;;;;1,0;;;;;;;;;1,0;;;;;;1,0;;;;;4,0;;;;;;35,0;;;;;;;;;;;;;;;;;;;;;1,0;;;4,0;;;;;;;;;;11,0;3,0;;17,0;;;;3,0;;;;;;;;1,0;;4,0;;;9,0;13,0;;;;;;;4,0;;;;3,0;;;;;;;;;;;;;;;3,0;;;;;;;;;;;5,0;;;;;;;;;12,0;;2,0;;;;;1,0;;;;;;;;;;;;;;;;;;1,0;;;;;4,0;;;;1,0;;;;;;;;;;;;;;;;;;;;3,0;;;;;;;;;;;;;;4,0;;;;;;;2,0;;;;;;;;;;;;;;;;;;;;;;;;;;;;;;;;;;;;;;;;;;;;;1,0;;;;;;;;;;;;;;;;;;;;;;;;;;;;;;;;;;;;;;;;;;;;;;;;;;;;;;;;;;;;;;;;;;;;;;;;;;;;;;;;;;;;;;;;;;;;;;;;;;3,0;;;;;;;;;;;;;;6,0;;;;;;1,0;;;;;;;;;;;2,0;;;;;;;;;;;;;;;;;;;;;;;;;;;;;;;;;;;;;;;;;;;;1,0;;;;;2,0;4,0;;;;;;;;;;;;;;;;;;;;;;;;;;;;;;;2,0;;;;;;;;;;;;;;;;;;;;;;;;;;6,0;;;;;;;;;;;;;;;;;;;;;;;;;;;;;;;;;;;;;;;;;;;;;;;;;;;;;;;;;;;;;;;;;;;;;;;;;;;2,0;;;;;;;;;;;;;;;;;;;;;;;;;;;;;;;;;;;;;;;;;;;;;;;;1,0;;;;;;;;;;;;;;;;;;;;;;;;;;;;;;;;;;;;;;;;;;;;;3,0;;;;;;2,0;;;;;;;;;;;;;;;;;;;;;;;;;;;;;;;;;;;;;;;;;;;;;;;;;;;;;;;;;;;;;;;;;;;;2,0;;;;;;;;;;;;;;;;;;;;;;;;7,0;;;;;;;;;1,0;;;;1,0;;;;;;;;;;;;;;;;;;;;;;;;;;;;;;;;;;;;;;;;;;;;;;;;;;;;;;;;;;;;;6,0;;;;;;;;;;;;;;;;;;;;;;;2,0;;;;;;;;;;;;;;;;;;;;;;;;;;;
chamber;;;;;14,0;;3,0;21,0;;1,0;2,0;;;;8,0;4,0;;;4,0;;;1,0;;;;;2,0;2,0;9,0;2,0;;;11,0;;4,0;;5,0;4,0;1,0;8,0;;;;4,0;;;;;;;;1,0;;;;38,0;22,0;;4,0;38,0;;;14,0;;;;7,0;11,0;;;15,0;3,0;;2,0;;;;;15,0;1,0;;9,0;1,0;5,0;;1,0;1,0;;1,0;1,0;15,0;1,0;;2,0;1,0;10,0;;8,0;;12,0;6,0;8,0;;19,0;;;;6,0;;;1,0;4,0;;15,0;8,0;;4,0;;7,0;10,0;;3,0;;3,0;;;6,0;;;11,0;16,0;;;;2,0;3,0;35,0;;4,0;2,0;;;;;;;19,0;4,0;;;;;4,0;1,0;;14,0;2,0;18,0;;6,0;;;7,0;46,0;4,0;1,0;;15,0;11,0;;;3,0;15,0;5,0;2,0;11,0;3,0;1,0;1,0;;;1,0;4,0;;;3,0;4,0;41,0;;16,0;;;2,0;30,0;4,0;4,0;;;;;;5,0;;13,0;2,0;;;;;1,0;;;;;;;1,0;7,0;4,0;;7,0;;;;22,0;;3,0;;;;4,0;;1,0;7,0;;;;;;;10,0;;4,0;9,0;1,0;;;5,0;4,0;1,0;;;;3,0;;;;26,0;;;;;1,0;;2,0;;14,0;;1,0;;3,0;11,0;;1,0;5,0;;;;;5,0;;;;1,0;;;5,0;4,0;;4,0;;;;;;;;2,0;;;1,0;;4,0;;;;;;16,0;1,0;7,0;4,0;2,0;;;;;;;3,0;;5,0;6,0;;;3,0;1,0;;4,0;;;;;1,0;;;;;;;;1,0;;;;;;;;;6,0;;;;;;;;;;;;5,0;5,0;;;;;;;;;;;1,0;;;;;;;;3,0;;;;;;;6,0;;;;;1,0;;;3,0;;;;;;;;;;;;;3,0;1,0;;;;;;;;1,0;1,0;;;;;14,0;;;;;;;;;;;;;;6,0;;;;2,0;;;;;;;;;2,0;;;;;;;;;;;;;1,0;3,0;;;;1,0;1,0;;;12,0;6,0;;;;;;;;;;;;;;1,0;;;2,0;2,0;11,0;5,0;;;1,0;;;;;;;;;;;2,0;3,0;2,0;;;2,0;1,0;3,0;;;;;1,0;;;;;;;;;;;;;;;1,0;;;;;;;;15,0;;;2,0;;;5,0;;;;;1,0;;;;;;;;;1,0;;1,0;;;;4,0;;;;2,0;;;;;12,0;;;;;;;;;;;;2,0;;;;;;;;;;;1,0;;;;;;;;;;;;;;;;;;;;;1,0;;;;;;;;8,0;;;1,0;;;2,0;;;;;;15,0;;;;4,0;;8,0;;46,0;;;;1,0;;;;;3,0;;;;2,0;;;1,0;;;;2,0;;;;;;;;;;;;;10,0;;;;;;;1,0;;;;;;2,0;;;;;;;;6,0;;;;8,0;;1,0;;;;;;;;;;;;;;;;;4,0;;;;;;;;;;;;;;;;;;;;;;;;;;;;;;;2,0;;;3,0;;;;;;;;;;;;;;;;;;;;;;;3,0;;;;;;;;;4,0;;;7,0;;;;;;;;;;;;;;;;;;;;;;;;;;;;;1,0;;;;;;;;1,0;;;;;;;;2,0;;;;;;;;;;;;;;;;;;;;;4,0;;;;;;;2,0;;;;;;;;1,0;;;;;;;;;;;;;;;;;;;;;;;2,0;;;;;;;;;;;6,0;;;;;;;;;;;;;;;;;;;;;;;;;;;;;;;;;;;;;9,0;;;;;;1,0;;;;;;;;;;;;;;;;;;;;;8,0;;;;;;;;;;;;;;;;;;;;;;;
character;;;;;55,0;;2,0;28,0;;10,0;1,0;;7,0;1,0;;6,0;;1,0;;25,0;;107,0;3,0;2,0;;;;34,0;1,0;4,0;1,0;22,0;19,0;;15,0;1,0;1,0;99,0;;103,0;27,0;;;5,0;;;;;;;1,0;5,0;;19,0;6,0;82,0;20,0;;3,0;;;;29,0;;;;88,0;;1,0;10,0;15,0;2,0;1,0;;;2,0;;127,0;177,0;;2,0;5,0;13,0;2,0;;;8,0;;7,0;34,0;1,0;;3,0;7,0;1,0;26,0;;3,0;4,0;;1,0;54,0;4,0;;4,0;;2,0;7,0;;;;1,0;;;;;;;;2,0;;;5,0;;;;11,0;;;;4,0;4,0;1,0;;1,0;3,0;;;3,0;;;37,0;4,0;16,0;;3,0;18,0;;;;;;;;;;;;;;;7,0;;;;;;8,0;;1,0;1,0;;1,0;1,0;25,0;;;5,0;;;;3,0;1,0;;;3,0;;38,0;;5,0;;;;1,0;;4,0;;;3,0;;;;2,0;4,0;;35,0;;7,0;;10,0;;;;;;5,0;;;;;;9,0;;11,0;1,0;;;;4,0;;;;;;2,0;8,0;;2,0;9,0;;;;2,0;;;;2,0;;;;;;;11,0;;;;1,0;1,0;;;;;;3,0;;3,0;;;;2,0;18,0;4,0;;;2,0;;;2,0;3,0;1,0;;;;;11,0;40,0;35,0;8,0;;;;7,0;20,0;;;;;;;;;27,0;;;;;48,0;;;31,0;1,0;;;;;;;;;;;;;;;;;;;50,0;;;;;;;;;;;15,0;;;;;;1,0;;44,0;5,0;;;;;5,0;;;4,0;;;;;;14,0;8,0;;4,0;4,0;16,0;2,0;;;2,0;6,0;5,0;1,0;1,0;;4,0;;2,0;;9,0;;1,0;4,0;;5,0;6,0;;10,0;;;;2,0;3,0;12,0;;1,0;4,0;;;;2,0;;105,0;;31,0;;2,0;46,0;;;;3,0;;;14,0;;8,0;;;2,0;11,0;4,0;;5,0;;6,0;1,0;;;;;;;;1,0;;;;49,0;1,0;;17,0;1,0;11,0;2,0;;1,0;4,0;8,0;;;;3,0;;8,0;;;;;;;2,0;;;;;;13,0;;164,0;;;2,0;;29,0;34,0;;2,0;;1,0;;;2,0;11,0;;5,0;2,0;;;;14,0;47,0;;1,0;;3,0;;;;;;;;;;;;;;30,0;7,0;;;1,0;;;;;;7,0;;1,0;5,0;;2,0;3,0;;;;;;;;5,0;3,0;;;2,0;;;;;2,0;;;1,0;;;;1,0;;;;;;2,0;8,0;1,0;;;;;11,0;;;;;3,0;1,0;;;;;2,0;;;;;17,0;;;;;;;;;;;;;;;;9,0;;;;;;;;;1,0;;;;;;;;;5,0;;;;;;;;;;1,0;;;;;;;;;;;;;;;1,0;;;;;;;;;;1,0;1,0;;;;;;;;4,0;;;4,0;;2,0;;;;8,0;;;;;;;1,0;;;;1,0;;;;;;;;;;;;;;;;;;;;;;;;;;;;;8,0;;3,0;;;;1,0;;;;;;;;;;;1,0;;;;;;4,0;;;;;;;;;2,0;;;;;11,0;;;;;;;;;3,0;;;;;;;;;;;;;1,0;;3,0;;;;;3,0;;13,0;;;;;;3,0;;;8,0;2,0;;;;;;;;;1,0;;;;115,0;;;;14,0;;;2,0;1,0;;;4,0;22,0;108,0;;;;2,0;19,0;;;;;;;;;;;;2,0;;;;;;;;;;;2,0;;;2,0;;;;;;;;;;;;;;;;;3,0;;;;;2,0;;;;;;;;;;;;;;;;;32,0;;;;;;;;;;2,0;1,0;2,0;;;;;;;;;;;;1,0;1,0;1,0;3,0;;;;;;;;;;1,0;;;;;1,0;;;;;;;;;;;;;;;;;;;;;12,0;;;;;;;;;;;;;3,0;;;;;;;;;;;;;;1,0;;;;;;;;1,0;2,0;;;;;1,0;2,0;;;;;;;;;;;
circle;;;;;2,0;;10,0;4,0;3,0;1,0;31,0;3,0;;;1,0;;;1,0;;1,0;;2,0;7,0;3,0;;;1,0;2,0;3,0;7,0;3,0;10,0;11,0;;2,0;;4,0;6,0;;3,0;9,0;;1,0;1,0;;;;;5,0;;2,0;2,0;;1,0;2,0;45,0;11,0;;1,0;11,0;;;14,0;;;;;;;1,0;12,0;2,0;;;;;;20,0;5,0;;;;1,0;;;;3,0;;7,0;;2,0;;;;2,0;;;;;;15,0;21,0;1,0;;;;;4,0;;;;10,0;1,0;;;;;;;5,0;;;1,0;;;;2,0;;1,0;;3,0;;;;;;5,0;;;10,0;;;2,0;;;;15,0;1,0;;;;;4,0;;;2,0;;;10,0;8,0;;;;2,0;;;;16,0;;2,0;1,0;;8,0;4,0;1,0;3,0;;;;;1,0;1,0;1,0;;7,0;11,0;2,0;6,0;;5,0;;;;3,0;;;;;;;;12,0;;6,0;;;;;2,0;;;1,0;;;;4,0;;;;;;2,0;;;;;;;;;;;1,0;1,0;;1,0;1,0;2,0;7,0;;1,0;;;5,0;;;;;;5,0;;;;2,0;;;2,0;12,0;;19,0;1,0;;7,0;;;;2,0;;;;;;;;;;;;;3,0;;5,0;1,0;;;;;9,0;;1,0;;;;4,0;;;;5,0;1,0;;1,0;;8,0;2,0;3,0;;;5,0;;;;;;;;;4,0;;;;;1,0;2,0;;;;;;;;1,0;;;;;;;;;;;1,0;;;;;1,0;;;;;2,0;;1,0;;;;;;;;;;;1,0;1,0;;;;;;;;;;;;;;2,0;1,0;;;;;;;2,0;;;;3,0;;;1,0;;;1,0;;;;;;;;;16,0;;;;;3,0;;;;;;;2,0;;2,0;;;;1,0;;;;;;;;;;;;;2,0;;;2,0;;;;;;;;;;;;1,0;;;;;;;;;;;;;;;;;;;2,0;;;;;;;;;;;;;;2,0;3,0;;;;;;;3,0;1,0;1,0;;;;;;;;;4,0;;;4,0;;;;;;3,0;;;;;;;;;;;;;;;;;;2,0;;;;;;;;1,0;;;;;;;;;;1,0;;;;;;2,0;;;;;13,0;;;;;;3,0;2,0;;;;;;;2,0;;;;;;;;;;;;;;;;;;;;;;;;3,0;1,0;;;;;;;1,0;;;;;;;;;;;;1,0;;;;;;;;;;;;;;;;3,0;;;;;;;;;;;;;;;;;3,0;;;;;;;;;1,0;;;14,0;;;;;;3,0;;;;;3,0;;;;;;;;;;2,0;;;;3,0;;;;;;;;;;;;;;;;;2,0;;;;;;3,0;;;;;;7,0;;;;3,0;;;;;;;;;;;2,0;;;;;1,0;;;;2,0;;;;;;;1,0;;;;;;3,0;5,0;;;;;;;4,0;;1,0;;;;;;1,0;;;1,0;6,0;;;;;2,0;;;;;;;;;;;;1,0;;;;;;;;;;;;;;;;;6,0;;;;;8,0;;;;;;;;;;;;;;;;;;1,0;;;;;;;;;;;2,0;;;;;;;;;;;;;9,0;;1,0;;;;;1,0;;;;3,0;;;;;;1,0;;;;;;;;;;;;;;;;;;;;;1,0;;;;;;;;;;;;;;;;;;;;;1,0;;1,0;;;;;;;;;;;;;;;;;;;;;;;;;;;2,0;;;;;;;;;;;;;;;;1,0;3,0;;;;;;;;3,0;;;;;;;;;;1,0;;;;;17,0;;;;;;;;;;1,0;;;;;;
circumferential;;;;;1,0;;18,0;3,0;;;17,0;;;;;;;;2,0;;;;;;;;;;6,0;;;2,0;6,0;;6,0;;;150,0;;;2,0;;1,0;9,0;;;3,0;;1,0;;;2,0;;;5,0;;16,0;;3,0;66,0;4,0;;;;;1,0;3,0;;;;8,0;;;3,0;1,0;;;;25,0;;;;;;;3,0;39,0;;;;1,0;1,0;;;;9,0;;;4,0;;115,0;;;2,0;;;;8,0;;;1,0;2,0;3,0;1,0;1,0;;;;;3,0;;;;1,0;;;5,0;;;6,0;8,0;1,0;;33,0;;2,0;58,0;;;;;;3,0;29,0;1,0;1,0;36,0;14,0;;;;31,0;8,0;;11,0;9,0;7,0;11,0;1,0;6,0;3,0;;55,0;3,0;;2,0;;9,0;;2,0;26,0;;2,0;8,0;4,0;5,0;62,0;1,0;;;;;16,0;;3,0;2,0;1,0;16,0;;126,0;;8,0;;11,0;1,0;;;;;2,0;;6,0;2,0;11,0;;;;;;13,0;;2,0;;;;;;3,0;;3,0;;;;;21,0;;4,0;;;4,0;2,0;;;26,0;4,0;3,0;1,0;1,0;13,0;1,0;45,0;1,0;3,0;4,0;;;;;;5,0;;;;1,0;;;15,0;7,0;;16,0;4,0;2,0;1,0;2,0;8,0;2,0;11,0;;7,0;4,0;;2,0;;;7,0;;;1,0;;;2,0;4,0;;13,0;9,0;;1,0;;4,0;15,0;;;2,0;;3,0;6,0;;;;8,0;;;4,0;3,0;27,0;10,0;;;1,0;1,0;;1,0;;;5,0;;;7,0;32,0;;;;14,0;1,0;;1,0;;4,0;;;;;;;;;;;;;;;1,0;;;;;1,0;4,0;;3,0;;;3,0;;;;;;;;;;;;;;;;;;;;;;;;;;3,0;;;;;;;;;;;;;11,0;;;;;;;;;;;;;;;;;;11,0;;;2,0;;;;;;;4,0;;;;;;;;;;;;;;;;;;;;;;;;;;;;;;;;1,0;4,0;;;;;;;;;;4,0;;;5,0;;;;;;;;;;;;;;;;;;;17,0;;;;;;2,0;;;;;;1,0;;;4,0;;;;2,0;;;6,0;;;1,0;;;;;6,0;3,0;;;;;;;;;;;;;;;;4,0;;;;;;;;;;;3,0;;;;;;;;;;;;;;;;;4,0;;;;;;2,0;;;;;;;;;;2,0;;;;;;3,0;;;;7,0;;;;;1,0;;;;;;;;6,0;;;;;;;;;;;;;;;;;;;;;;;;;;;;;;;;;;10,0;;3,0;;;;;;;;;;;;;1,0;;;;;;;;;;2,0;6,0;;;;3,0;;;;8,0;;;;;1,0;;;;;;;;;;;;;;;;;;;;;;;;8,0;2,0;;;3,0;;;;;;;;;;;;;;;;;;;;4,0;;1,0;;;;;;;;;;;1,0;2,0;;;;;1,0;;;;;;;;;;;;;;;;;;;8,0;;;;;;;;;;;;;;;;;2,0;;;1,0;;;;;;;;;;;;;;;;;;;;;;;;;;;;3,0;;;;;;;;2,0;;;;;;;;2,0;;;;;;;;;;;;;;;;;;;;8,0;;;;;;;6,0;1,0;;;;;;;;;;;;;26,0;;;;;;1,0;;;2,0;;;;;;;3,0;;;1,0;5,0;4,0;;1,0;;;;;;;;;;;;;;;;;;;;;;;;;;;;;;;;;;;;;;;;;;;;;;;;;;;1,0;;;;;;;;;;;;;;;;;;1,0;;;1,0;;;;;;;;;;;;;;;;21,0;;;;;;;;;;;;;;;;;;;;;;;;;
clamp;;;;;33,0;;7,0;58,0;7,0;1,0;;;1,0;;;;;;14,0;1,0;;12,0;;5,0;9,0;;1,0;;4,0;4,0;;2,0;44,0;;17,0;;;14,0;1,0;;;;;59,0;;2,0;1,0;;;;;2,0;2,0;;;23,0;40,0;;;10,0;;;8,0;;;;6,0;;2,0;22,0;8,0;;6,0;;;;;1,0;15,0;1,0;1,0;3,0;;5,0;;;6,0;1,0;6,0;;3,0;2,0;;59,0;;13,0;;3,0;4,0;8,0;62,0;7,0;;;;4,0;;3,0;;;;1,0;;3,0;7,0;;;;3,0;4,0;;;;68,0;;;8,0;;;11,0;2,0;;;;;;11,0;;2,0;;;;3,0;;;11,0;5,0;6,0;;;;;9,0;;8,0;3,0;2,0;;6,0;8,0;;1,0;5,0;;;;82,0;12,0;;2,0;49,0;;14,0;;;1,0;3,0;35,0;;;;;5,0;;;3,0;13,0;16,0;;44,0;1,0;;;4,0;;;;4,0;6,0;5,0;;1,0;6,0;5,0;13,0;1,0;;;;4,0;;;;;;3,0;;;;;8,0;1,0;;1,0;3,0;;;;;;;;;5,0;27,0;;;3,0;25,0;;3,0;;1,0;6,0;;;11,0;;;;8,0;;;44,0;;;2,0;11,0;4,0;1,0;;;4,0;8,0;6,0;8,0;20,0;1,0;4,0;6,0;1,0;11,0;;5,0;2,0;;;1,0;;10,0;6,0;2,0;;52,0;;;3,0;;2,0;6,0;;;;;;;;;;;1,0;;4,0;1,0;;;9,0;5,0;5,0;5,0;9,0;;;;13,0;;2,0;;9,0;;;;14,0;5,0;;4,0;;2,0;;;2,0;;2,0;;;;;;2,0;;1,0;;2,0;;;;;8,0;;;;;5,0;;;;;;;;;;;3,0;;;;;;;;;;;;;;2,0;;2,0;11,0;;;1,0;;;;;;;;;;;;;;1,0;10,0;;;;;;;;;;;;;2,0;3,0;2,0;3,0;;;;9,0;;;;;;;;;;;;;;;;;;;;;1,0;;;;;;3,0;;3,0;;;;;1,0;;;;;;;;;;;;;2,0;2,0;;;;;9,0;;;;;;;;;;;;;;;1,0;;;12,0;;13,0;;3,0;12,0;1,0;;60,0;;;;;;;3,0;7,0;;;;;;;;;1,0;;1,0;;;;;;1,0;;;;;1,0;;;;;;;;;;;;;;;;1,0;;;;;;;2,0;;;;4,0;;;;;;14,0;1,0;;;;;1,0;;;;;;;;5,0;;5,0;;;;2,0;;9,0;;;19,0;2,0;;;;;;;;;;;;;;;;1,0;;;;;14,0;;;7,0;5,0;;;;;;;;;3,0;;;;;;1,0;;;2,0;;1,0;5,0;;;;;;;;;;;;;;;;;;5,0;;;;;;;;;;;;;;;;;;3,0;;;;;;3,0;;;;;;2,0;17,0;6,0;;;18,0;;;;;;5,0;1,0;;;1,0;1,0;3,0;2,0;;;;48,0;;4,0;;;;2,0;25,0;;;;;;;25,0;1,0;;;;;;;;;;;;;;;;;;;;;;;;;;;;;4,0;7,0;;;2,0;;;;;;;;3,0;;;;;2,0;;;1,0;19,0;;;;1,0;;;;;1,0;7,0;;;;1,0;;;;;;;;;;;;;;;;2,0;;;;;;2,0;;;;;;;;;;;;;;;;;;3,0;;;;;;;10,0;;;;;;;2,0;1,0;;;;;;2,0;;;;;;;;;;2,0;;;;;;8,0;;;;;1,0;;;;;;1,0;;;;;;1,0;;;;;;;;;;;;16,0;3,0;;;;;;;;;;;;;1,0;2,0;9,0;;;;;;6,0;;;;;;1,0;;;;;;;;;;;1,0;;;8,0;;;;;;;;;;;;;;;;;;;;;;;;;;2,0;;;;;;;;;;;;;6,0;;;1,0;;;;;;;;;;;;2,0;;;;;;;;;;;;;;;;
clip;;;;;9,0;;1,0;13,0;2,0;13,0;5,0;;;;;;;;;1,0;;;;;;;;5,0;;;;3,0;7,0;;11,0;;;;;57,0;1,0;;;3,0;;;;1,0;3,0;;;2,0;;1,0;;19,0;8,0;;1,0;2,0;;;8,0;;;;1,0;;;1,0;4,0;;;4,0;;;;;5,0;;2,0;;;;;;;;4,0;1,0;;;;6,0;2,0;;;;15,0;;6,0;9,0;;;;;;;;;1,0;;;25,0;8,0;;;;2,0;;;;;3,0;;;3,0;2,0;;5,0;;;;;;;;;;;;;1,0;;;;8,0;5,0;;;;4,0;;;;4,0;;7,0;;1,0;;;4,0;;;;;;;;48,0;;3,0;23,0;;2,0;8,0;;;;;;2,0;;3,0;;3,0;2,0;;15,0;;;;12,0;;;;;;2,0;;2,0;;11,0;;;1,0;;7,0;3,0;;;;;;10,0;;;;;;;;;;;;;;;2,0;;;4,0;1,0;;2,0;2,0;;;;;;;;;;;;;;;4,0;8,0;;;;2,0;;;;;;2,0;5,0;;6,0;2,0;;;9,0;;;;;;;;;2,0;1,0;3,0;;;;1,0;8,0;3,0;;2,0;;;;;;;;;;;3,0;;;;;;;;1,0;1,0;1,0;1,0;;;4,0;1,0;1,0;;;;;;7,0;;2,0;;;31,0;;;1,0;;;;;;;;;;;24,0;;;;;;;;1,0;;;;;;;;;;;;;;;;;;;;;;;;;;;;;;1,0;10,0;;1,0;1,0;;;;;;;;;;;;;;;;;;;;;;;2,0;;;;;3,0;;;;;;;;;;;;;;1,0;;;;;;;;;;1,0;;;1,0;;;1,0;;;;;;;;;;;1,0;;1,0;;;;;;;;1,0;;;;;;9,0;;;;;;;;;;;;2,0;6,0;;;;2,0;;;;;;;;;64,0;3,0;;;;;;;;3,0;;2,0;;;;;1,0;;;;;;;;;;2,0;;;;;;;;;;;;;;1,0;;;2,0;;;;;;;;;;;;;;;;;;;;;4,0;;;;;;;;4,0;;;1,0;;;;;;;6,0;;;;;;1,0;;;;2,0;;;;;3,0;;;;1,0;;;1,0;;;;;;;;;;;3,0;;2,0;;;;;;;;;;;;;;1,0;;6,0;;;;;;;;1,0;;;10,0;;;;;;;;;;;;;1,0;;;;;;1,0;;;;;;;;2,0;;;;;;;;;;;;;;;;;;;;;;;;;;1,0;;;;;;;;;;;;;;;;;;;;;;;25,0;;;;;;;;;4,0;;;;;;;;;;;;;;;;;;;;;;;;3,0;;;;;;;;;;;8,0;;;;;;;;;;;;;;;;;;;;;;;;;;;;;;;;;;;;;;;;;;;;;;;;;;;;;;;;;;;;;;;;;;;;;;;29,0;;;;;;2,0;;;;;;;;;;;;;;;1,0;;;;;;;;;;;;;;;;;;;6,0;;;;;;;;;;;;;;;;;;;;;;;;;;;;;;;;;4,0;16,0;;;;;;;;;;;;;;;;;;;;;;;;;;;;;;;;;;;;;;;;;;;;;;;;;;;;;;;;;;;;;;;;;;;;;;;;2,0;;;;;;;;;;;;;;;;;;;;;;;;
cluster;;;;;3,0;;;12,0;3,0;3,0;4,0;;;;;;;;;1,0;;3,0;;;;;;26,0;;18,0;5,0;6,0;;1,0;10,0;;;4,0;;;;;;36,0;;;;;;1,0;;11,0;;1,0;;33,0;8,0;;;;;;11,0;;4,0;;;;;2,0;3,0;;;;;;;2,0;;;;2,0;;;;;;;1,0;;;;;1,0;;1,0;;;2,0;;;1,0;;;1,0;;;2,0;;;;;;;;;;4,0;;;;;;;;;;;;;;;;;2,0;;;;;8,0;1,0;;;;1,0;;2,0;;;;4,0;;;;;;;1,0;;;;;;;3,0;;2,0;10,0;3,0;;;;3,0;3,0;;;;;;;;;;;;;;17,0;;;;;;4,0;;4,0;;;1,0;;;;;;;;;;;;;;;;;;;;;;;4,0;;;;;;;;;;;;;;2,0;;3,0;5,0;;;;;;;;;;;;;;;12,0;;2,0;;2,0;;;2,0;;;;;;;;;;;;;;;;;;;6,0;;;;;;11,0;;13,0;;;;;;;;;;;;;;;;;;;;;;;4,0;;;;;;;;;;;;;;;;;;;1,0;1,0;;;;;;;;;;;2,0;;;;;;;;;;1,0;;;;;;;;;1,0;;;;14,0;;;;;;;;;;11,0;;1,0;;;;;8,0;;1,0;;;;;1,0;15,0;;;;;;;;5,0;1,0;;3,0;;;;10,0;;;;;;;2,0;;;;;4,0;;;;4,0;;;;4,0;;;7,0;;;;3,0;;;;;;;;;;2,0;;;;;;;;;;1,0;;;;;2,0;;1,0;;;;;;;1,0;;;3,0;;;3,0;;;;;;;;2,0;;;5,0;;;;1,0;;;;;;;;2,0;3,0;;;;;;;6,0;1,0;;;;;;;;;;;;;;1,0;;2,0;;;2,0;;;2,0;;;;;;;;;11,0;;;;;;;;;;;;;;;;;;;;;;;;;2,0;23,0;;;;;;1,0;;;;;2,0;;;;;;;;;;;;;;;;;;;;;;;;;;;;;;;;;;;;;;;;77,0;;;;;;;;;2,0;;;;;;;;;;;;;;;;;;;;;;;;;;;1,0;;;1,0;;;;;;;;;;;;;;;;;;;;;;;;;1,0;;;;;;;;;;;;;;;;;;;;;;;;;;;;;;;;;;;;;;;;;;;;;;;;;;;;;;;;;2,0;;;;;;;;1,0;;;;;;4,0;;;;;;;;;;;;;;;;;;;;;;;;;;;;;;;;;;;;;;;;1,0;;;;;;;;;;;;;;;;;;;;;;;;2,0;;;;;;;;;;;;2,0;;;;;;;;;;;;;;;;;;;;;;;;;;;;;;21,0;;3,0;;1,0;;;;;;;;;;;;;;;;;;;;;;;;;;;;;;;;;;;;;;;;;;;;;;;;;;;;1,0;;;;;;;;;;;;;;;;;;;;;;;;;;;;;;;;;;;;;;12,0;;;;;;;;;;;;;;;;;;;;;;;;;;;;;;;;;;;;;;;;;;;4,0;1,0;;;;;;;;;
column;;;;;12,0;;3,0;11,0;5,0;11,0;;;;;20,0;1,0;;;7,0;1,0;;28,0;;8,0;4,0;1,0;;11,0;1,0;4,0;13,0;8,0;44,0;2,0;18,0;8,0;2,0;112,0;1,0;5,0;1,0;;1,0;28,0;2,0;;;;9,0;;;21,0;2,0;54,0;;71,0;70,0;;1,0;4,0;;;34,0;2,0;;;;;;24,0;3,0;11,0;2,0;;;6,0;;13,0;6,0;8,0;;28,0;23,0;;;;15,0;;2,0;49,0;38,0;5,0;;296,0;1,0;1,0;;6,0;4,0;3,0;7,0;6,0;;156,0;;;6,0;272,0;;;;95,0;64,0;;;;;;8,0;;;;;82,0;;;34,0;1,0;;9,0;11,0;;;;;2,0;64,0;;54,0;;;;2,0;;13,0;;20,0;8,0;;;;1,0;;;35,0;6,0;;;;48,0;2,0;1,0;;;2,0;;8,0;24,0;1,0;;7,0;5,0;2,0;7,0;3,0;3,0;;55,0;;;3,0;;;;;3,0;2,0;182,0;;36,0;;1,0;;7,0;1,0;;;;3,0;;2,0;29,0;3,0;2,0;;4,0;19,0;;5,0;21,0;2,0;;4,0;1,0;;22,0;2,0;;;;5,0;7,0;;;9,0;;;1,0;;1,0;;;;27,0;1,0;2,0;;5,0;3,0;;;;4,0;7,0;;2,0;5,0;;;;;;;69,0;;;;1,0;;;5,0;30,0;2,0;;;;16,0;;;;;1,0;;;;6,0;;;;8,0;;;;3,0;;;12,0;;3,0;1,0;;4,0;;4,0;;;4,0;;;;;;18,0;;;;2,0;4,0;1,0;;4,0;13,0;;;;;;;1,0;;;;2,0;2,0;;7,0;;;5,0;;;;;;;;;;;;1,0;11,0;;;;;1,0;4,0;;1,0;3,0;;;10,0;;1,0;;;;;6,0;;;9,0;5,0;;;;3,0;3,0;;;;2,0;;7,0;4,0;4,0;;17,0;22,0;15,0;;;4,0;1,0;2,0;;1,0;;;2,0;;;;3,0;5,0;7,0;;4,0;;;;1,0;8,0;;;3,0;;;1,0;;;1,0;;;1,0;;10,0;;9,0;2,0;;1,0;2,0;;;43,0;2,0;1,0;1,0;;;;;;26,0;;;;;;;;2,0;5,0;8,0;12,0;;7,0;;4,0;;;;;;;;;;;;1,0;;;17,0;;4,0;;;20,0;;;;;;;;;7,0;1,0;;;;4,0;;8,0;6,0;2,0;;18,0;;;;;3,0;65,0;;;;6,0;;2,0;1,0;;;;;;;;;7,0;1,0;;;;;;;;;;;;1,0;;;;;2,0;1,0;;;1,0;;;;;;1,0;;2,0;;;1,0;;;;;1,0;;;;2,0;36,0;;;;412,0;;;;;;5,0;;;;;;;;;;;;;;;;1,0;;;;;;;;2,0;;;;20,0;48,0;;;1,0;;;;5,0;;;;;4,0;;;;;;;;;;;;;2,0;;4,0;;3,0;;;;;;;1,0;;2,0;;;;;3,0;;;;;;;1,0;;;;;;1,0;;;;;;1,0;2,0;1,0;;;;;;17,0;;;;;;;;;89,0;;;;;;57,0;22,0;6,0;;;6,0;;;4,0;5,0;;8,0;;;5,0;5,0;18,0;29,0;;2,0;1,0;;5,0;;;;15,0;;;;9,0;3,0;3,0;44,0;;;13,0;;;;;;3,0;;;;;5,0;;2,0;;5,0;23,0;;;;;1,0;;;;;6,0;3,0;;;;8,0;;;;;;;;4,0;;1,0;;9,0;;;;4,0;5,0;;;21,0;16,0;;;;9,0;;;;2,0;3,0;;;;;;;;;;;;;;;;;;;;;;;;;;;;;;;;;;;;;;;;;;;6,0;;;;;;;;1,0;;;4,0;;;;;;;2,0;2,0;1,0;;3,0;;;;3,0;;;;;;6,0;;2,0;;;;15,0;;8,0;;;;;;;3,0;;;;;;;1,0;;1,0;;3,0;;;;;;;;;;;;;;;35,0;1,0;2,0;;;;;;;;;;;;;;;;;;;;;;;2,0;;1,0;3,0;;;;1,0;;1,0;;;;;;;;;;;;;;;;32,0;70,0;;;;;;;;;;;8,0;;;;6,0;8,0;;;;;;;;;;;;41,0;5,0;;;;;;;;2,0;;8,0;;;;;;;;;;;;;;;;
comparator;;;;;5,0;;;7,0;4,0;6,0;;;1,0;;;;;;;;;53,0;;;;1,0;;16,0;;5,0;6,0;10,0;20,0;5,0;5,0;;;1,0;;;1,0;;;2,0;;;;;2,0;1,0;4,0;1,0;;;;17,0;49,0;;;;;;2,0;;;;;;;22,0;;;2,0;;;;;2,0;2,0;;;8,0;;4,0;;;3,0;;;1,0;5,0;3,0;;61,0;1,0;;;;17,0;;;15,0;;;;1,0;;37,0;1,0;;5,0;7,0;2,0;;;;;;;;;;;30,0;;;40,0;;;7,0;;1,0;;;;2,0;12,0;;;;2,0;;;;2,0;;12,0;;;;;;;;;;;;;10,0;;;;;;;4,0;;;;;;3,0;;;;;121,0;;;;;;;;;;46,0;;;;;;12,0;;;;;;;;;;1,0;;;;;;;;;;;;42,0;11,0;;;;;;1,0;;;;;;;;;;;;4,0;;;;;;;;;;;;;;;;35,0;;;20,0;;;;;;;1,0;1,0;;;;;;;;;;;;1,0;;;2,0;;;;;;;2,0;;;;2,0;8,0;;;;;;;;;;;;;;4,0;;;;;;;;19,0;21,0;;;;;;;;;;;;;;;;;1,0;;1,0;;;;;;;;;;;8,0;;;;;1,0;;;7,0;;;;1,0;;;;;;;;;;5,0;;2,0;;2,0;;;;;;1,0;;5,0;;;;;36,0;1,0;;;4,0;;;;;;;5,0;;;;;3,0;2,0;1,0;;;;1,0;;;;;;;;;1,0;;;;;1,0;;38,0;;;6,0;;;;;;6,0;;;;;;2,0;;;4,0;;;;;;;;;2,0;5,0;;;;;;;1,0;;;;;;;;;2,0;;1,0;;;;;;;12,0;;;;5,0;4,0;;;;;;;;;;;;;5,0;;7,0;;1,0;;;;10,0;;;;;;;;;;;;;;;;;4,0;;;;8,0;;;;;3,0;;;;;;;;;;;;;;;;;;;;;;;;;;;2,0;;;;;;18,0;4,0;;;30,0;2,0;2,0;;;;;;;;;;;;;;;;;;;;;;;23,0;;;;;;;;;;2,0;;;;;;;;;;;;;;;;;;;;;;;;3,0;1,0;;;;;;;;4,0;;;;;1,0;;;;;;;;;;;;;;;;;;;;;;;;3,0;;;;;;;;;;;;2,0;;;;;1,0;;;;;;15,0;;4,0;;;5,0;;;35,0;;;;;;;;;2,0;;;;;;;;;;;;;6,0;;;;;;1,0;;;;;;;;;;;;;;;18,0;56,0;;;;;;;;2,0;;;10,0;;;;;;;;;;;;;;;;4,0;;;;;69,0;;;17,0;9,0;1,0;6,0;;;;;;2,0;;;;;;;;;;;;;;3,0;;;2,0;;;;;;;;;;;;;;2,0;;;;;;;;;;;;;44,0;;;;;;;;;;;2,0;;;;;;;;4,0;;;;;;;;2,0;;;;;;;;;;;;1,0;;;;;;;;;;;;;;;;;;;;;;;;;;;;;;;;;3,0;;;;;;;;;;;;;;;;;;;;;;;2,0;;;;;;;;;;;;5,0;;;;;;;;;;;;;;;;2,0;;;;;;;;;;;;;;;;;;;;;;;;;;;;;;;;;;;;;;2,0;;;;;;;;;;;;;;;;;;
complete;;;;;12,0;;1,0;20,0;5,0;7,0;;;;5,0;2,0;;;;;1,0;;12,0;;2,0;10,0;;;22,0;1,0;3,0;2,0;6,0;9,0;2,0;7,0;2,0;2,0;9,0;;10,0;;;7,0;1,0;;;7,0;;6,0;9,0;6,0;12,0;2,0;1,0;;83,0;5,0;4,0;;13,0;;;31,0;1,0;2,0;;10,0;;;45,0;4,0;1,0;3,0;;;;;2,0;18,0;1,0;1,0;24,0;4,0;1,0;;;51,0;;5,0;2,0;4,0;1,0;7,0;10,0;;1,0;3,0;1,0;1,0;;8,0;13,0;;6,0;;;;28,0;;;;;1,0;2,0;;1,0;;;;;;;;8,0;;;7,0;;1,0;;;1,0;;;;1,0;1,0;;;;;1,0;1,0;2,0;;;9,0;39,0;1,0;;;;1,0;;;;;1,0;;10,0;;;;;;;;5,0;;;1,0;5,0;2,0;1,0;4,0;;1,0;3,0;;;;1,0;;;;;1,0;5,0;;12,0;;;;;;;;;3,0;;;;;;;;1,0;;1,0;1,0;2,0;;;;1,0;41,0;18,0;;;;;;1,0;;;;;;;;1,0;;;;1,0;;;3,0;8,0;2,0;2,0;;;;;;;;;;;1,0;;4,0;4,0;;;1,0;;1,0;;2,0;1,0;;;6,0;1,0;;;;;;;;;3,0;;;1,0;;;;1,0;1,0;;1,0;1,0;4,0;;;;;;;;;;2,0;;;1,0;;2,0;;;;;;;;2,0;3,0;;2,0;1,0;;;;;;;;;;;3,0;;;;;1,0;;;;;2,0;;;;;;;;;1,0;1,0;1,0;;;2,0;1,0;;1,0;;1,0;;;;;;3,0;;;;4,0;1,0;;;;;;;;;1,0;3,0;;;;1,0;5,0;;1,0;2,0;;;;;;5,0;;2,0;;;2,0;1,0;8,0;3,0;;2,0;2,0;;;;;;2,0;1,0;1,0;;1,0;2,0;;;;;1,0;;;;2,0;;;;2,0;;;3,0;1,0;3,0;2,0;;;;;;;1,0;;;4,0;;5,0;;;2,0;5,0;1,0;;;;;;;;;;;1,0;;1,0;;;1,0;;3,0;;;2,0;;;10,0;;;;;5,0;;;2,0;;;;;;;;;;7,0;;15,0;;;11,0;;;;;4,0;;;2,0;;2,0;;;;;;;;;2,0;;8,0;;;;;;;;;;6,0;;;;3,0;;;;;1,0;;;;2,0;;;;1,0;;;;;1,0;;;;;;;;;;;;6,0;8,0;;;;;;;;;;;1,0;;;;;;1,0;;;1,0;2,0;6,0;;;;;;;;;;;;;11,0;;;;;;;18,0;;;;;3,0;;;;;;;1,0;;;;;4,0;;;;;;;;;7,0;;;;;3,0;;;;1,0;;;;;;;;;2,0;;;;4,0;;;;;;;;3,0;;;;;;;;;;;;4,0;;;;;1,0;1,0;;2,0;;;;;;;;;;;;9,0;;;;;;2,0;;1,0;;1,0;3,0;;;2,0;;;;1,0;16,0;;;6,0;11,0;2,0;6,0;;2,0;;;;;;;;2,0;;;;;4,0;;;;;;;;;;1,0;;;;;;;;;;;2,0;;;;;;;;;3,0;;;;;;2,0;7,0;;1,0;6,0;;;;;;;;;;;;;2,0;;;;;;;4,0;;;1,0;;;1,0;;2,0;;2,0;;;;;1,0;;;;;;;;;;;;;;;;;;;;;;;;;;;2,0;;;;;;;;;;;;;;;;2,0;;;;;;;;2,0;;;;;;;;;;;;1,0;;1,0;;;;;;;;;;;;;;;;;;;;;;;;;;2,0;;;;;;;;;;;;;;;;;;;;;;;;;;;;;;;;;;;;1,0;;;1,0;;;;;;;;;;;8,0;;;;;;;;;;;;;;;;;;;;;;;;;;;;;;;;;;;1,0;;;;;;;;;;;;;;;;;;
compound;;;;;3,0;;2,0;;;;1,0;;;;2,0;1,0;;;2,0;;;;;;;;;5,0;;1,0;;;3,0;;;;;3,0;;;;;;2,0;;;;;3,0;;1,0;2,0;;7,0;;13,0;8,0;;;74,0;;;9,0;;;;1,0;;;;4,0;;;;;;;;;;;;5,0;;;;;;;;3,0;;;;;1,0;;;;;2,0;21,0;;;;;;2,0;1,0;;;;2,0;;;;;;;;;;;;;;1,0;;;;1,0;;;;1,0;;;;;;;;;;;2,0;4,0;;;4,0;;;;1,0;;;;1,0;;1,0;;;;;;4,0;;1,0;;6,0;;;13,0;4,0;;;;;;;;2,0;;;;1,0;;1,0;;;1,0;;;1,0;;;;;1,0;;1,0;;2,0;3,0;;;;;1,0;;;;;3,0;;;;1,0;;;;1,0;;;;;1,0;;;;;;;;3,0;;;;;;;;2,0;;;;;;;;;;;;;1,0;1,0;;;;;;;;;;;;;;;;;;;;;;;;;;;1,0;20,0;1,0;;1,0;;;2,0;;;;;;;;1,0;;;;;1,0;;;;;;;;;;;;;;;;;;;;1,0;;;;;;;;;;;;;;;;;;;;;;;4,0;;;2,0;;;;;;;;;;;;;;;;;;;;;;;;;;;;;;;;;1,0;;;;;2,0;;1,0;;;;;;;;;;;;;;;;;3,0;4,0;;;;;;;;2,0;;;;;1,0;;;;;;;;;1,0;;;;;;;;;;;;;;;;;;;;;;;;;;;;;;;;;;;;;;;;;;;;;;;;;;;;;;;;;;;;;;13,0;;;1,0;;;;;;;;;;;;;;;;;;;;;;;;4,0;;;;;;;;;;3,0;;;;;;;;;;;;;;;1,0;2,0;;;;;;2,0;;;;2,0;;;;;;10,0;;;;;;;;;;;;;;;;;;;;;;;;;;;;;;;;;;;;;;;;;;;;;;;;;;;;;;;;;;;;;;;;;;;;;;;;;;;;;;;;;;;;;;;;;1,0;;5,0;;;;;;;;;;;;1,0;;;;;;;;;;;;;;;;;;;;;;;;;;;;;;;;;;;;;;;;;;;;;;1,0;;;;;;;;;;;16,0;;;;;;;;;;;;;;;;;;1,0;;;;;;;;;;;;;;4,0;;;;;;;2,0;;2,0;;;;;;;;;;;;;;;;;;;;;;;;;2,0;;;;;;;;;;;;;;;;;;;;;;;;;;;;;;;;;;;;1,0;;;;;;;;;;;;;;;;;;;;;;;;;;;;;;;;;;;;;;;;4,0;;;;;;;;;;;;;;;;;3,0;;;;;;2,0;;;;;;;;;3,0;2,0;;;;;;;;;;;;;;;;;;;;;;;;;;;;;;;;;;;;;;;;;;;;;;;;;;;;;;;;;5,0;;;;;;;;;;;;;;;;;;;;;;;;;;;;;;;;;;;;;;;;;;;;;;;
concave;;;;;4,0;;9,0;5,0;;;;;1,0;;3,0;;;;2,0;;;;;;;;;;2,0;;;;11,0;;;;4,0;7,0;;1,0;;;4,0;81,0;;;;16,0;;;;;;56,0;;105,0;28,0;;16,0;305,0;1,0;;3,0;;;;6,0;;;;13,0;5,0;;6,0;3,0;;;;22,0;14,0;1,0;;5,0;;;;3,0;4,0;;;12,0;;;2,0;1,0;3,0;;;1,0;13,0;218,0;17,0;;;;;;9,0;;;5,0;8,0;2,0;7,0;;;;;5,0;3,0;;;1,0;1,0;;5,0;;14,0;;3,0;9,0;;;;1,0;4,0;13,0;;3,0;6,0;;;;25,0;4,0;;33,0;2,0;;;;8,0;;;;8,0;3,0;6,0;;7,0;;;9,0;2,0;;12,0;;10,0;;4,0;4,0;27,0;27,0;8,0;;8,0;3,0;;2,0;;;1,0;1,0;;;12,0;;13,0;;121,0;3,0;3,0;;4,0;;3,0;42,0;;;2,0;3,0;31,0;;144,0;;;;6,0;3,0;13,0;;2,0;;;;;;1,0;;2,0;11,0;2,0;;;15,0;1,0;;;;;2,0;;;2,0;1,0;4,0;;;4,0;;;;;7,0;;;1,0;2,0;;1,0;;;;;2,0;;;3,0;;3,0;;;6,0;2,0;1,0;;2,0;;;7,0;;3,0;;;5,0;;;;;;;1,0;;;3,0;;3,0;30,0;;2,0;;2,0;;;;2,0;;;3,0;;2,0;;;;;1,0;;;;3,0;;1,0;;;;;;;;3,0;;;;6,0;;2,0;1,0;;;;;;;;;;;;1,0;;;;;;;;;;;;39,0;;;;;;;;2,0;1,0;;;3,0;2,0;;;;;;;;;;;;;;;;9,0;;2,0;;;;;;;;;;;;;1,0;;;;;;;;;;;;;18,0;;;;;;;;;;;2,0;;;;;3,0;;1,0;;;;;;;;;;;;;;;;;;;1,0;;1,0;;;;;;3,0;2,0;;;;;;;;;;;;;;;;;;;;;;;;;;;;;;;;;;;;;;;;1,0;1,0;2,0;;;;;;;;;2,0;;;;;;;;;;;;;;;;;;;;;;;;;;;;1,0;;;;;;;;;;;;;;;;;;;;;;;;;;;;;;;;;;;;;;;;;;3,0;;2,0;;;;;;4,0;;;4,0;;;;;;4,0;;1,0;;1,0;;;18,0;5,0;;;;1,0;1,0;;;;;;;2,0;;;;;;;3,0;;;;;;;;;;;;;4,0;;;;;2,0;1,0;;;;;;;6,0;;;;;;;15,0;;;;;;;;;;;;2,0;;1,0;;;;;;;;;;;;;;;;;;;;;;;;;;;;;;;;;;;;;;;;;3,0;;;;;;;;;;;;;;;;2,0;;;;;;;;;;;;;;;;;;;;;;2,0;;;1,0;8,0;;;;;;;;;;2,0;;;;;;;16,0;;;;;;;;;;;;5,0;;;;;;;;;;;;;;;;;;;;;;;;;;;;;7,0;;2,0;;1,0;;;;;;;;1,0;;;;2,0;;;;;2,0;;;;;;;;;;;;1,0;;;4,0;;;;;;;;;;;;;;;;;;;;;;6,0;;;1,0;;;1,0;;;;;3,0;10,0;;;;;;;1,0;;2,0;;;1,0;;;;;;;;;;;;;;;;;;;;;;;;;;;1,0;1,0;;;1,0;;;;;;;;;;;;;;;;;;;;;;;;;;;;;2,0;;9,0;;1,0;;;;;;;;;;;;;4,0;;;;;;;;;;;;;;;;;;;;4,0;;;;;;;;8,0;;77,0;;;;
conditional;;;;;3,0;;;;1,0;;2,0;1,0;;;;;;;;;;;;3,0;;;;6,0;3,0;;;;;;;;;;;;15,0;;;33,0;;;;46,0;1,0;;;;;32,0;3,0;12,0;;;39,0;191,0;;;;4,0;;;;;;;27,0;;;4,0;;;;8,0;5,0;16,0;;1,0;;;2,0;;7,0;;1,0;;;;11,0;3,0;4,0;1,0;;;;;6,0;23,0;;;;;;;;;;;;;;;;;;;;;;;;;;;;;;;;;;;;;;;;;;;;;1,0;;;1,0;;;;;;;;;;41,0;;;;;;1,0;;1,0;;;;;;;;;;;;;;;;;;3,0;;;;4,0;;;;;;;9,0;;;;;1,0;;2,0;;;;;;;;;;;;;;;;;;;;;;;;;;;;;;;;17,0;;;;;;;;;;;;;;;;;;;;;;6,0;;5,0;;;;;;;;;;;;;;;;;;;;;;;;;;;;8,0;;;;;;;;;;;;;;;;;;;;;;;;;;;;;;;;;;;;;;;;;;;;;;;;;;;;;;;;;;;;;;;;;;;;;;1,0;;;;;;;;1,0;;;;;;;;;;;;;;;;;;;;;;2,0;;;;;;;;;;;;;;;;;;;;51,0;;;;;;3,0;;;;;;;;;;;;;;;2,0;;;;;;;;;;;;;;;;11,0;;;;;;;;;;;;;;;;;;;6,0;;;;;;;;;;;;;;;;;;;;;;;;;;;;;;;4,0;4,0;;1,0;;;;;;;2,0;;;;;;;;;;;;;;;;;;;;;;;;;;;;;;;;;;;;;;;;;;;;;;;;;;;;;;;;;;;;;;3,0;;;;;;;;;;;;;;;;1,0;;;;;;;;;;;;;;;;;;;;;;;;;;;;;;;;;;;;;;;;;;;;;;;;;;;;;;;;;;;;8,0;;9,0;;;;;;;;;;;;;;;;;;;10,0;;;;;;;;10,0;;1,0;;;;;;;;;;;;;;;;;;;;176,0;;;;;;;;;;;;;;;;;;;;;;;;;;;;;;;;;;;;;;;;;;;;7,0;;;;;;;;;17,0;;178,0;;;;;;;;;;;;;;;;;;;;;;;;;;;;;;;;;;;;;;;;;;;;;;;;;;;;;;;;;;;;;;;;;;;;;;;;;;;;;;;;;;;;;;;;;;;;;;;;;;;;;;;;;;;;;;;1,0;;;;;;;;;;;;;;;;;;;;;;;;;;;;;;;;;;;3,0;;;;;;;;;;;;;;;;;;;;;;;;;;;;;;;;;;;;;;;;;;;;;;;4,0;;;;;;;;;;;;;;;;;;;;;;1,0;;;;;;;;;;;;;;;;;;;;;;;;;;;;;;;;8,0;;;;
conductor;;;;;3,0;;1,0;1,0;;;;;;;;;;;7,0;;;2,0;;;;;2,0;1,0;;3,0;1,0;;15,0;;1,0;1,0;1,0;;;;;;;29,0;;;;;;;;;;;;2,0;10,0;;;13,0;;;6,0;;;3,0;;;;;1,0;;;;;;;3,0;1,0;9,0;;;;;;;14,0;;;2,0;7,0;;;2,0;;1,0;;;;5,0;9,0;;;2,0;;;;2,0;;;;1,0;;;2,0;;;;1,0;5,0;1,0;;;7,0;;;;5,0;;6,0;2,0;;;9,0;;;7,0;;;;;;2,0;16,0;;3,0;22,0;1,0;;;;3,0;;;;1,0;;5,0;;;;;;3,0;;;;1,0;;1,0;;;9,0;18,0;;;1,0;;;17,0;4,0;1,0;;;;3,0;4,0;16,0;;15,0;1,0;;;1,0;;;;;1,0;;;;6,0;7,0;;;;2,0;25,0;5,0;;;;;;;;9,0;;;;;;;;;;7,0;;;;1,0;;;4,0;;;;2,0;;;;;17,0;4,0;;;;;18,0;3,0;;9,0;38,0;;;;;;;;1,0;;;;;3,0;4,0;;2,0;;4,0;4,0;;2,0;;;;;4,0;;3,0;;2,0;3,0;;;;;2,0;;;1,0;7,0;;;;;;;;;1,0;;;;;;;1,0;;;;;;;2,0;;;;;3,0;;2,0;;;;;1,0;;;;;;;;;;;;;;;;;;;;;4,0;;;;;;;;;;;;;;;;;;;;;;;1,0;;;;;;;;;;;;;;;;;;;;2,0;;;;;;;;3,0;;;;;;;;;;1,0;;2,0;;;;;;;;;;;;;;;4,0;;;1,0;;;;;;;;;;;;;;;;;;;;;;;;;;;;;;;;;;;;;;;;;;;;;;2,0;;;;;;;;;;;1,0;;;;1,0;;;;;;7,0;;;;;;;;;;;;;;;;;;5,0;;;;;;;;;;;2,0;;;;;;2,0;;;;;;;;;;;;;;;;;;;;;;;;;2,0;;;;;;;;;;;;;;;;;;;;;;;;;;;;4,0;;;;;;;;;3,0;;;;;;;;;;;;;;;;;2,0;;;;;;;;;;;;4,0;;;;;;;;1,0;;;;;;;;;;;1,0;;;;;;;1,0;;3,0;;;1,0;;;;;1,0;;;;;;;;;;;;;;3,0;;;1,0;;;;5,0;;;;;;;;;;;;;;;;;;;;;;;;;;;;;;;;;;;;;;;;2,0;;;;;;;;;;;;;;;;;;;1,0;;;;;;;;;;;;;;;;;;;;12,0;1,0;;;;;;;;;;;;;;;;;;;;;;;;;;;;;;;;;;;;;;;;;;;;;;;;;;;;;;1,0;;;;;;;;;;;;;;;;;;;;;;;;;;;;;;;;;;;;;;;;;;6,0;;2,0;;;;;2,0;;;;;;;;;;;;;;;;;;;;;;;;;;;;;;;;;;;;;;1,0;;;;;;;;;;;;;;;;;;;;;;;;;;;;;;;;;;;;;;;;;;1,0;;;;;;;2,0;;;;;;;;;;;;;;;;;;;;;;;;;;;;;;;;;;;;;;;;;;;;;;;;;
configuration;;;;;10,0;;5,0;16,0;;44,0;2,0;3,0;;;;;;;8,0;5,0;2,0;12,0;1,0;;2,0;;;42,0;;15,0;4,0;3,0;46,0;1,0;39,0;6,0;;4,0;;18,0;;;;6,0;;2,0;;1,0;6,0;8,0;3,0;18,0;;17,0;1,0;37,0;46,0;;2,0;14,0;;;46,0;;1,0;;;;;3,0;7,0;1,0;;;;;;1,0;18,0;2,0;;6,0;10,0;2,0;;;18,0;1,0;;20,0;6,0;;;15,0;4,0;1,0;;1,0;35,0;2,0;24,0;29,0;;17,0;;;24,0;6,0;;;3,0;19,0;10,0;7,0;1,0;1,0;;;2,0;18,0;;;;4,0;;1,0;13,0;;;6,0;2,0;;;;3,0;5,0;2,0;2,0;14,0;;;;3,0;3,0;18,0;;23,0;2,0;;;;2,0;1,0;;;1,0;3,0;8,0;;16,0;1,0;;;;;11,0;;1,0;5,0;;16,0;3,0;10,0;11,0;3,0;11,0;;1,0;;;;;2,0;;;1,0;8,0;14,0;;8,0;1,0;1,0;;28,0;;2,0;;1,0;2,0;;2,0;11,0;;21,0;;3,0;9,0;1,0;;1,0;;;;;;5,0;12,0;;;;1,0;1,0;;;2,0;2,0;;;;;1,0;;;;2,0;5,0;2,0;;2,0;1,0;5,0;1,0;;;;;;2,0;;;2,0;;;5,0;;;;6,0;2,0;;;2,0;;;4,0;;5,0;;;3,0;;;;;;11,0;;;;5,0;12,0;;;1,0;;7,0;3,0;22,0;3,0;;3,0;;1,0;4,0;;;2,0;;1,0;;;;4,0;1,0;;;3,0;4,0;2,0;5,0;;6,0;1,0;;3,0;;2,0;;;1,0;;2,0;1,0;;;;;;2,0;1,0;15,0;;38,0;;;;;;;;;1,0;;;;;;;;11,0;29,0;21,0;;;;;;;;;1,0;2,0;;;5,0;;;;;;;;;;;36,0;1,0;;;5,0;1,0;;;3,0;;;;4,0;1,0;;2,0;5,0;;;2,0;;;;;;;;13,0;;;;;3,0;;;1,0;4,0;;;5,0;;;;13,0;;;2,0;;14,0;20,0;;;11,0;;1,0;;;;;7,0;;;3,0;;;;;2,0;3,0;;5,0;;1,0;2,0;;;3,0;1,0;;;;;;2,0;1,0;;;2,0;;;6,0;;;8,0;;;1,0;2,0;;1,0;;;;;;12,0;;;1,0;1,0;1,0;;3,0;;19,0;;;4,0;;4,0;11,0;;;;;2,0;;;;11,0;2,0;;;;;;;;11,0;4,0;10,0;2,0;;;;4,0;1,0;;1,0;;;5,0;;;11,0;;;1,0;;55,0;;;;;;;;3,0;;;;;;;;1,0;;;;113,0;;2,0;;;1,0;6,0;;;;;;5,0;;;24,0;;2,0;;10,0;;;2,0;;;;1,0;2,0;1,0;;;19,0;;;;1,0;5,0;;8,0;;;9,0;1,0;;10,0;1,0;;;1,0;;1,0;15,0;1,0;;;1,0;;;1,0;;;;3,0;3,0;;1,0;;2,0;;;1,0;;;;7,0;2,0;;9,0;;;;;1,0;;;;;;1,0;;;3,0;1,0;;;14,0;1,0;;;;;;;3,0;;;8,0;;8,0;;;;2,0;;;;;;;;2,0;;;;9,0;;;;;;5,0;;;;;;;;;12,0;;;;;3,0;;;;;;;;;;1,0;5,0;18,0;;2,0;4,0;;;2,0;1,0;;7,0;;;;;;;;;;;1,0;1,0;;1,0;;3,0;;;1,0;1,0;;;;1,0;1,0;;2,0;;5,0;;2,0;1,0;;1,0;;2,0;;;;2,0;;14,0;3,0;;;;;;;;;;;;;8,0;;1,0;;;;;;;;;;1,0;;;1,0;1,0;;;5,0;;1,0;9,0;;;;;;;;;;;1,0;1,0;;;;1,0;;;;;;;;;2,0;1,0;;2,0;;;;;;;2,0;;;;1,0;;;;;1,0;2,0;;;;;;1,0;;;;;;;;13,0;;;;;;;;1,0;;;;2,0;;;1,0;;;1,0;;;;;;;8,0;;;;;;;;3,0;;;;;;;;;4,0;1,0;1,0;;;;;;;;;;;;;1,0;8,0;;;;;;1,0;;;7,0;;;1,0;;;;4,0;;;;;5,0;;;;;;;;3,0;;;1,0;;;;;;;;;;;;2,0;;;;;;;;;;;;;;;;;6,0;;;;;;;;;4,0;;;1,0;;;;;;11,0;;;;;;
construct;;;;;9,0;;3,0;5,0;4,0;2,0;1,0;;;7,0;1,0;;1,0;;;3,0;;6,0;2,0;;;;;7,0;;;1,0;4,0;15,0;16,0;1,0;;;;2,0;6,0;5,0;1,0;1,0;8,0;;;;;;;1,0;4,0;2,0;;;93,0;8,0;;4,0;17,0;;;40,0;;22,0;1,0;1,0;1,0;1,0;3,0;3,0;2,0;3,0;;;;;10,0;3,0;2,0;;5,0;7,0;;;;2,0;;;3,0;1,0;;1,0;3,0;;8,0;;1,0;2,0;1,0;5,0;16,0;;;;4,0;2,0;12,0;;;2,0;19,0;1,0;1,0;1,0;;2,0;;;3,0;;2,0;2,0;;;1,0;9,0;;;1,0;3,0;;2,0;;;1,0;;;1,0;;;;;;;1,0;1,0;7,0;;;;;;2,0;;;1,0;5,0;1,0;3,0;;1,0;1,0;3,0;;4,0;2,0;10,0;;3,0;;4,0;1,0;3,0;4,0;7,0;;2,0;;;5,0;2,0;;;;6,0;1,0;17,0;;6,0;;;1,0;3,0;;;;;2,0;;1,0;5,0;;3,0;;;2,0;1,0;;3,0;1,0;1,0;2,0;;1,0;2,0;2,0;6,0;;1,0;;3,0;;;1,0;;;;;1,0;;;2,0;1,0;;1,0;;;10,0;;1,0;;;1,0;1,0;1,0;;;;4,0;;;;4,0;;;;;1,0;;2,0;1,0;2,0;;;;;1,0;;;1,0;2,0;;;;;;;;;1,0;1,0;;;;3,0;1,0;11,0;;;;;3,0;1,0;;;2,0;2,0;;;2,0;;3,0;9,0;;;1,0;;;2,0;2,0;;;;;;;;2,0;;;;3,0;;;2,0;;;1,0;;2,0;;;;;;;4,0;;;;;;;;;;1,0;;;2,0;2,0;;;;1,0;;;;;;;;3,0;;;;;1,0;1,0;;;;2,0;;1,0;12,0;;;;;3,0;;3,0;;;;;;;;1,0;;;;;;;;;;;;;4,0;1,0;;1,0;;;;;;2,0;;;1,0;;;;;;;2,0;1,0;;;1,0;;2,0;1,0;5,0;;;;;;;;;;;;;;;;2,0;3,0;;2,0;;7,0;;;;;2,0;;;;;;;;4,0;;2,0;2,0;;;10,0;;;;;;;;;;10,0;;;;1,0;2,0;;;;;1,0;;;2,0;10,0;;1,0;;;1,0;;1,0;;;1,0;;1,0;;;1,0;;;5,0;;;;;2,0;;;;;;;;2,0;;;;1,0;;;;;;;;;;;;;;1,0;;3,0;;;;;;;;;;1,0;;1,0;1,0;12,0;;;;;1,0;;;;;;;;;;;;;;1,0;2,0;;7,0;;;2,0;1,0;;;;2,0;;;;1,0;;;;;;;;;;;;;;;;;1,0;;1,0;;;;;;;;;;2,0;;;;;1,0;;;1,0;;;;;;;;;;;;2,0;;;;;;;3,0;8,0;;;;;1,0;;;;1,0;;;;2,0;;;;;;;;;;;;;;;1,0;1,0;;1,0;1,0;4,0;;;;;;;;;;;;;;;;;;;;;;;;;2,0;;;;1,0;;;;;;1,0;2,0;;;1,0;;;2,0;;;;;;;;;;6,0;;;;;;;5,0;;;1,0;4,0;;;;3,0;;;;;;;;;;;;;;;;;;;;;1,0;;;2,0;;;;;;2,0;;;;;6,0;;;;;;;;;;;;;;;;;;;;;;3,0;;;;;;;;;;;;;;;;;;;;;;;;;;;;;;1,0;;;;;;1,0;1,0;;;;;;;;;1,0;;;;;;;;;1,0;;2,0;;;;;;;;;;;;;;;;;;;;;;;3,0;;;;;;;1,0;;;;;;;;;;;;;;;;;;;;;;;;;2,0;;;;;;;2,0;;;;1,0;;;;;;;;;1,0;;;13,0;;;;;;;;;;2,0;2,0;;;;1,0;2,0;;;;;;;1,0;;;;;;;;;;;;;;2,0;;;;;1,0;1,0;;;;;5,0;;;;;;;3,0;
container;;;;;3,0;;2,0;;;1,0;1,0;;;;;;;;4,0;7,0;;;;;;;;1,0;3,0;;;12,0;9,0;;2,0;;;11,0;;;7,0;;;;;;;;;;;;;;;16,0;22,0;;1,0;3,0;;;41,0;;;;;;;;;;1,0;;;;;;3,0;;;;;;;;;;;7,0;6,0;;;;1,0;11,0;1,0;4,0;8,0;;8,0;11,0;;;;1,0;5,0;14,0;;;;1,0;5,0;4,0;4,0;2,0;;;5,0;13,0;;;;6,0;;;13,0;;;19,0;33,0;;;1,0;;14,0;22,0;;;;;;;1,0;;;27,0;;;35,0;;;;7,0;2,0;;;7,0;2,0;;;;11,0;18,0;;;;6,0;1,0;2,0;5,0;;36,0;3,0;1,0;3,0;18,0;;;;;;;;;4,0;1,0;13,0;;111,0;;;1,0;3,0;;;;;10,0;;;6,0;;25,0;;;;;10,0;6,0;6,0;3,0;;;;3,0;;4,0;;;10,0;2,0;;;;;11,0;;;;4,0;;;;;8,0;;6,0;2,0;;;;3,0;2,0;2,0;;;;;;;;;16,0;1,0;2,0;2,0;10,0;1,0;2,0;;;;4,0;2,0;;6,0;;;;7,0;19,0;;3,0;3,0;3,0;1,0;;;1,0;;;;1,0;;;7,0;;;;;2,0;;;;1,0;;;1,0;;15,0;;3,0;5,0;;;;5,0;9,0;;;10,0;;;;;9,0;;;43,0;;14,0;36,0;;;4,0;;3,0;10,0;;;;1,0;;;;;;;;10,0;1,0;2,0;;;;;;15,0;;;;;;;;;;;;;;2,0;;;;;;;1,0;;;;;;;1,0;;;;;2,0;;;;;;;;;1,0;;;;;;;6,0;;;;;;;;;;;;9,0;6,0;1,0;;;;;2,0;;;4,0;1,0;;;4,0;;2,0;;;;;;;;;;;;;;;;;;;;;;;;13,0;1,0;;3,0;;;;;;;;;;;2,0;;;;;;;;5,0;;;;;10,0;;;;5,0;;;;;55,0;;;;;;1,0;1,0;;7,0;2,0;;;;;;;;;;;;;;;5,0;;1,0;;;;11,0;2,0;;;;;3,0;;;;1,0;;4,0;;8,0;;;;;;;;;;;;;6,0;56,0;;;17,0;;;;3,0;;;;;;2,0;;1,0;;;1,0;;;;1,0;;;;13,0;;;;;;1,0;;32,0;14,0;;;;;;;;;;;;;;;;;;;;;;;;;;;;;;;;1,0;;;;;;;1,0;2,0;;;;;;;;;;;;;4,0;;;;;;;;;;;;;;4,0;;;;;7,0;;;17,0;;;;;;;;;;;;;;;;;;;;2,0;;;;;;;;;;;;;1,0;;;;;;;;;;;;;;;;;;;;;;3,0;;;;;;;;;;;;;;;;;2,0;;;;;;;1,0;;;;;;;;;;1,0;;;;;;;;;;;;;;;;;;;;;;;;;;;;;;;;;;7,0;;;;;;;;;;;;;;;;;;;;96,0;;;;;;;;;;;;;;;;1,0;;;;;;;;;;;;;;22,0;5,0;;;3,0;5,0;;;4,0;;;;;;;;;;;;;;;;;;;;;;;2,0;;;;;;;1,0;;;;;;;;;;5,0;;;;;;;;;3,0;;;1,0;1,0;;;;;;;;;;;;;;;3,0;1,0;;1,0;;;;;;;;;;;;;;;;;;;;;;;;;;;;;;;;;;;;;;;;;3,0;;;;;;;;;;;1,0;;;;;;;;;2,0;;;;;;;;;;;;;;;;;;;2,0;;;;;;;;;;;;;
context;;;;;1,0;;;8,0;;2,0;;1,0;;;;2,0;;;;3,0;;;;;;;;2,0;;6,0;1,0;19,0;;;;;;;;1,0;;;;;;;;;;;7,0;;;;;5,0;;;;;;;3,0;;;;;;;;4,0;;;;;;;;;;;;1,0;;;;1,0;;;;;;;;;;;;;;;6,0;;;;;;;;;2,0;;;;;;;;;;;;;;;;;;;;;;;;;2,0;;;;;;6,0;;;;;;;;;;;;;;;;;;;;;;;;;;;;;;;;;;;;;;;;;;;;;;1,0;;;;;;;;;;;;;;;;;;;;;;;;;;;;;;;;;;;;1,0;;;;;;;;;;;;;;;;;;;;;;;;;;;;;;;;;;2,0;;;;;;;;;;;;;;;;;;1,0;;;;;;;;;;;;;;;;;;;;;;;;;;;;;;;;;;;;1,0;;;;;;;;;;;;;;;;;;;6,0;;;;;;;;;;;;;;;;;;;3,0;;;;;;;;;;;;;;;11,0;1,0;;;;;;;;;;;;;;;;;;;;;;;;;;;;;;;;1,0;;;;;;;;;6,0;;;;;;;;;3,0;;;;;;;;;2,0;;;;;3,0;;;;;;;;;;;;1,0;;;;;;;;;;1,0;2,0;;;;;;;;;;;1,0;;;;;2,0;;;;;;;;;;;;;;;;;;;2,0;;2,0;;;;;25,0;18,0;;;;;;;;2,0;;;;;;;;;;;3,0;;;2,0;;;;;1,0;;;;;;;;;;;;;;;;;;;;;;;;;;;;;;;;;;;;;;;;;;;;2,0;;1,0;;;;;;;;;;;;;;4,0;;;;;;;1,0;;;;;;;;;;;;;;;;;;;;;;;;;;;;;;;;;;;;;;;;;;;;;;;;;;;;;;;;;;;;;1,0;;;;;;;;;;;;;;;;;;;;;;;;;;;;;;;;;;;;;;;;;;;;;;;;;;;;;;;;;;;;;;;;;;;;;;;;;;;;;;;;1,0;;;;;;;;;;;;;;;;;;;;;;;;;;;;;;;;;;;;;;;;1,0;;;;;;;;;;;;;1,0;;;1,0;;;;;;;;;;;;;;;;;;;;;;;;;2,0;;;;;;;;;;;;;;;;;;;;;;;;;;;;;;;;;;;;;;;;;;1,0;;;;;;;;;;;;;;;;;;;;;;;;;;;;;;;;;;;;;;;1,0;;;;;;;;;;;;;;;;;;;;;;;;;;;;;;;;;;;;;;;;;;;;;;;;;;;;;;;;;;;;;;;;;;;;;;;;;;;;;;;;;;;;;;;;;;;;;;;;;;1,0;;;;;;;;;
contour;;;;;2,0;;;6,0;4,0;;3,0;;2,0;;5,0;;;;2,0;;;;6,0;;3,0;;;;;11,0;8,0;8,0;4,0;;6,0;;;;;4,0;2,0;;;;;;;;;1,0;;;;;2,0;22,0;6,0;;;2,0;;;7,0;;;;;;;;;;;;;;;5,0;13,0;;;1,0;;;;;;;;3,0;;;;4,0;;;;;;;31,0;1,0;5,0;;;;;5,0;;;1,0;;;;;;;;;8,0;1,0;;;;;;18,0;1,0;;;2,0;;;;;;;;;;;;3,0;5,0;;;2,0;2,0;7,0;;;;;;2,0;;;9,0;;1,0;;;3,0;1,0;;1,0;;;;;4,0;;5,0;10,0;;3,0;6,0;;;;2,0;;;;;12,0;4,0;1,0;;8,0;;;;;5,0;;;;;;;7,0;;2,0;2,0;;;;3,0;;;1,0;;;;;;1,0;;;;;;;1,0;;;;;;;;;;;6,0;;1,0;4,0;;5,0;;;1,0;;;;;;;;;;;;;;9,0;;1,0;;;4,0;;;;1,0;;;;;2,0;;;;;;;1,0;;;;;1,0;;;;12,0;;;;;;1,0;;;;10,0;9,0;;;;;1,0;;;;1,0;;1,0;;;;;;1,0;;;;;;;12,0;10,0;;4,0;;;;;1,0;;;;;;;1,0;;;;;;;;;;;;5,0;2,0;;;;;;;;;;;1,0;;;;;;;;;;;;;;;;;;;;;;;;;;;;;;;;;;;;6,0;;;;;;1,0;;;;3,0;;;2,0;;;;;;;;;;;;;;;;2,0;;;;;;;;;;;;;;;;;;;;7,0;;1,0;;;;;1,0;;;;;;;;;;1,0;;;;;;;;2,0;;;;;;;;1,0;2,0;;;;;;;;;;;14,0;;;7,0;1,0;;;;;;;;;;;;;;;1,0;;;;;;;;;;;;;1,0;;;;;2,0;;;;;;;;;7,0;;;;;;;;;;;;;3,0;;;;;;;;;;;;;;;;;;;;;;;;;;;;;;;;6,0;;;;;;;;;;;;;;;;;3,0;;;;;;;;;;;1,0;1,0;;;;;;;;;;;;;;;;;;;;;;;;;;;;;;2,0;;;;;;1,0;;2,0;5,0;;;;;;;;;;;;;;;;;;;;;;;;;;;;;;;;;3,0;;;;;;;;;;;;;;;;;;;;;;2,0;;;1,0;24,0;;;;;;;;;;;;1,0;;;;;;;;;;;;;;;;;;;;;;;;;1,0;;;;;;;;;;;;;;1,0;;;1,0;;;;;;;;;;;;1,0;;;;;;;;;;;2,0;;;;;;;;;1,0;;;;3,0;;;;;;;;;;;;;;;;;;;;;;;;;;;;;;1,0;;;;;;;;;;;;;;;;;;;;;;;;;;;;;;;1,0;;;;;;2,0;;;;;;;;;;;;;;;;;;;;;;;;;;;;;;;;;;;;;;;;;;;;1,0;;;;;;;;;;;;;;;;1,0;;;;;;;1,0;;;;;;;;;;;;;2,0;;;;;;;1,0;;;;;;;;;;;;;;;;;;;;;;;;;;;;;;;;;;;;;;;;;;;;;;
converter;;;;;6,0;;;5,0;;9,0;;3,0;;;1,0;;;;2,0;;;8,0;;;3,0;;;38,0;;2,0;12,0;6,0;31,0;6,0;78,0;;;3,0;;;;;1,0;2,0;;2,0;;;6,0;;;18,0;;;;94,0;39,0;;;3,0;1,0;;14,0;;;2,0;1,0;;;7,0;11,0;;;;;;;;;5,0;;10,0;2,0;2,0;;;1,0;;;5,0;2,0;;4,0;115,0;;;;;1,0;;3,0;17,0;;;;;2,0;52,0;1,0;;5,0;6,0;3,0;;;;;;1,0;;;;1,0;32,0;;;21,0;;;8,0;1,0;;1,0;;;8,0;8,0;;;4,0;;;1,0;7,0;1,0;2,0;4,0;;;;;;;2,0;4,0;;;;3,0;15,0;2,0;;;;;;6,0;16,0;;;;2,0;7,0;;;1,0;;79,0;;;;;1,0;;;2,0;;39,0;;3,0;;;6,0;23,0;;;;;1,0;;;1,0;;2,0;;;3,0;;1,0;;1,0;;;;;3,0;4,0;;;;7,0;;;7,0;1,0;;2,0;;;;;;;;5,0;;;;1,0;;;;;;;1,0;;;;1,0;21,0;;;26,0;;;;2,0;;;2,0;3,0;;;;;;;;;;1,0;;;;2,0;;;;2,0;;;;;;;;1,0;;;;;;8,0;;;38,0;;;;1,0;;1,0;;;;;3,0;2,0;;12,0;13,0;;;;;;;;4,0;;5,0;;;;7,0;;;3,0;;;;;;;;;1,0;;;;6,0;;;;3,0;;;;2,0;;;;1,0;;;;;;;;;;;;1,0;;;6,0;;;;;;;2,0;;7,0;;12,0;1,0;2,0;;2,0;1,0;;;2,0;;7,0;;;;;;1,0;1,0;;1,0;;;;;1,0;;;;;;;;;;;;;;;29,0;;;1,0;;;7,0;;;2,0;;4,0;;;;;;;81,0;;1,0;1,0;;;;1,0;;2,0;24,0;76,0;;;;4,0;;;;4,0;;;1,0;;;;;;;3,0;;;;;;6,0;;;;;1,0;;;;;;;;;;;;;6,0;;5,0;1,0;;11,0;;;54,0;1,0;;;;;;;;;;;;;;;2,0;;;;;;;;;2,0;;;;;;;;;;;;;6,0;;;;;;1,0;;;;;;;;;;;;;;;5,0;;1,0;1,0;38,0;;;;;;1,0;;;;;;;;;;;;;;;;4,0;;1,0;9,0;;;;;;;;;;2,0;;;;;4,0;;1,0;;;;;5,0;;;;;;;;;;;;;1,0;3,0;;;;;;;;;;;;;;;;;;;;7,0;;;;;;;;2,0;1,0;;;;;;;3,0;2,0;;;;;;;;;;;;;;;;5,0;;;;;;4,0;2,0;1,0;;1,0;2,0;;;1,0;;;;;;;;;2,0;1,0;;1,0;;;;;;1,0;;;2,0;;;;5,0;;;;;1,0;1,0;1,0;;;5,0;1,0;;;;;;;9,0;8,0;;1,0;;;;;;;;;;;;;8,0;;;;;;;;;;;1,0;6,0;;;;;1,0;;;;;10,0;;;2,0;;;1,0;;1,0;;;;1,0;;;;;;;;;;;;;;;;;;;;;;;;;;;;;;;;;;;;;;;8,0;1,0;;;1,0;;;;4,0;;;;;;;;;1,0;;;;;;;;;;3,0;;;;;;;;;;;;;19,0;;1,0;;;;;;2,0;;;;1,0;;;;;1,0;;;;;;;;;;;;;;;;17,0;;;;;;;;;;;;;;;;;;;;;;;;;8,0;;3,0;3,0;;;;;;;;;;;;;;;;;;;;;;6,0;;;;;;;;;;;;;;;;;;;;;;;;6,0;;;;;;;;;;;;;;;;;;;;;;;;10,0;;;;;;;;
convex;;;;;3,0;;12,0;10,0;2,0;;3,0;;;;2,0;;;;7,0;;1,0;;;;;;1,0;;;;;2,0;4,0;;;;17,0;;;;11,0;;1,0;125,0;;;;6,0;1,0;;1,0;;;21,0;;86,0;33,0;;;451,0;;;5,0;;;;2,0;;;1,0;35,0;;14,0;4,0;7,0;;;3,0;25,0;54,0;;;;;;10,0;2,0;;;;;;;1,0;2,0;5,0;;;1,0;10,0;255,0;10,0;4,0;;;;2,0;32,0;;;;5,0;3,0;1,0;14,0;;;;;;;;;;;;1,0;14,0;;;;;;;;2,0;;;;;;;;88,0;3,0;;15,0;;;;;1,0;;;;;2,0;12,0;;7,0;;;1,0;;;2,0;1,0;24,0;;2,0;10,0;29,0;24,0;2,0;;2,0;;1,0;1,0;;;;4,0;;;7,0;;8,0;;40,0;;;;;1,0;4,0;33,0;;;1,0;;35,0;;192,0;;;;6,0;1,0;;;1,0;;;;;;;;;2,0;1,0;;;;;;;;;;;;;;;;;1,0;;1,0;;;;;;;;;;;;;;4,0;;;;;1,0;;;;;;;1,0;1,0;;;;3,0;;;2,0;;;;;;;;;;;;15,0;197,0;;1,0;;;;;;;;3,0;5,0;;3,0;;;;;;;;;;;1,0;;;;;;;3,0;;;;;9,0;;;;;;;;;;;;;;;;;;;;;;;;;;2,0;10,0;2,0;;2,0;;;;;;;;;4,0;;2,0;;;;;;;;;;;;;;;;;;;;;;;;;;;;;;;;;2,0;;;;;;;;;;3,0;;;;;;1,0;;;;;4,0;;;;;1,0;;2,0;;;;;;;;;;;;;;;;;2,0;;;;;;;;;2,0;;2,0;;;;;;;;;;;;;;;;;;;;;;;;;;;;;;;;6,0;;;;;;;;;;;;;;;;;;;;;;;;;;;;;;;;;;;;;;;;;;;;;;;;;;;;;;;;;;;;;;;;;2,0;;;;;;;;;;;;;;;;10,0;;;;;;;;2,0;;;;;;;;2,0;;;;;;;;;;;;2,0;1,0;;;;;;;;;;;;;;;;;;;;;;;;;;;;;;;;;;;;;;;;;4,0;;;;;;77,0;;3,0;;;;;;;3,0;;;;;;;;;2,0;;;;;;;;;;;;;8,0;;;1,0;;;;;;;;;;;;;;;1,0;;;;;;;;;;;;;;;1,0;;;;;;;;;;;;;;;;4,0;;;;;;;;;;;;;;;;;;;;;;2,0;;;;11,0;;;;;;;;;;;;;;;;;;;;;;;;;;2,0;;;5,0;;;;;;;;;;;;;;3,0;;;;;;1,0;;;;;;;;;9,0;;2,0;;6,0;;;;;;;;1,0;;;;;;;1,0;;2,0;1,0;1,0;;;;;;;;;;;;;1,0;;;;;;;;;;;;;;;;;;;;7,0;;2,0;;;;;;;;;;;;;;;;;;;;;;;;;;;;;;;;;;;;;;;;;;;;;;;;;;;;;;;1,0;;;;;;;;;;;;;;;;;;;;;;;;;;;;;;;;;;;;2,0;;;;;;;;;;6,0;;;;;;;;;;;;;;;;;;;;4,0;;;;;;1,0;;8,0;;;;;;
core;;;;;4,0;;8,0;2,0;;2,0;;;1,0;;;;;;;;;;;;3,0;;;14,0;5,0;;;;2,0;;5,0;;;1,0;;11,0;;;;;;;3,0;;;4,0;1,0;;;;;13,0;30,0;;5,0;8,0;;;5,0;;;1,0;1,0;;;2,0;;;1,0;;3,0;;;;7,0;1,0;;11,0;33,0;;;;;;;;;;;6,0;;1,0;;1,0;9,0;;2,0;4,0;;;;;;7,0;;;;8,0;;10,0;;;;;;;;;;;;;6,0;10,0;;4,0;2,0;1,0;;3,0;;;18,0;;;;3,0;;;;;9,0;9,0;;;;;1,0;4,0;;;4,0;6,0;61,0;;3,0;;4,0;1,0;;;16,0;5,0;;;;41,0;;12,0;4,0;2,0;;3,0;;;;;;;;;;2,0;9,0;;17,0;;;;8,0;;;3,0;;1,0;1,0;;;;2,0;;;;;;2,0;;3,0;3,0;2,0;;3,0;3,0;;;;;;;;1,0;;;;;;;;;;;;;5,0;1,0;1,0;;2,0;;;3,0;;1,0;;;27,0;;;;19,0;;1,0;5,0;5,0;;3,0;4,0;2,0;;;1,0;;8,0;;5,0;;;;;;4,0;9,0;;;2,0;1,0;;6,0;;;;;;;10,0;1,0;;;;;5,0;;;;;1,0;;;;;;;;;;;;;;;;2,0;;9,0;;3,0;;;;4,0;;2,0;;;5,0;;5,0;;;;;;;;;;;;;;;;;;;;;;;;;;;;;;;;;;;;;;;;;;;;;11,0;2,0;10,0;;1,0;;2,0;;;;;;;;;;;;;;;;;;;;;;;4,0;;;;;;;4,0;;;;1,0;;;;;;;;;;;;;;;;;;;;;;;;;;;;8,0;;;;;;;;;;;;;;;2,0;;;;;;;;;;;;;;;;;;10,0;;;;;;;;;1,0;;;;;;1,0;;1,0;;;;;;;;;;;;;;4,0;;;7,0;;;;8,0;;;;;;;;;;;;;;;;;;;;;;;;2,0;;;;;2,0;;;;;;;;6,0;;;;;;;;;;;2,0;;;;3,0;;;;3,0;;;;;;1,0;1,0;;;;;;;;;1,0;;;;;;;;;;;;;;;;;;;;;;;;;;;;;;1,0;;1,0;;;;;2,0;;;;;;;;9,0;;;;;;;;;;;;2,0;;;;;;;;1,0;;;;;;;;;;;;;;;;2,0;;;;;;;;;;;;;;;;;;;;;;;;;;;1,0;;;;;;1,0;;;;;;;;;;;;;;;;;;;;;;;;;;;;;;;;;;;;;;;;;;;;;;;;;;;;;;;;;;;;;;;;;;;;;;;;;;;;;;;;;;;;;;;;;;;;;;2,0;;1,0;;;;;;;;;;;;;;;;;;;;;;;;;;;;;;;2,0;;;;;;1,0;;;;;;;;;4,0;;;;;;;;;;;;;;;;;;;;;;;;;;;;2,0;;;;11,0;;3,0;;;;;;;;4,0;4,0;;;;;;;;;;;;;;;;;;;;;;;;;;;;;;2,0;;;;;;;;;3,0;3,0;;;;;;;;;;;;;;;;;;;;;;;;1,0;;;2,0;;;2,0;;;;;;;;;;;;;;;;;;;;;;2,0;;;;;;;;;;;;;;;;;;;;;;
correspondence;;;;;8,0;;;19,0;6,0;3,0;;;;3,0;7,0;;;1,0;;1,0;5,0;1,0;1,0;2,0;9,0;;;39,0;14,0;18,0;20,0;60,0;6,0;1,0;2,0;1,0;1,0;3,0;5,0;15,0;3,0;;;8,0;4,0;2,0;;6,0;24,0;;1,0;5,0;;2,0;;99,0;6,0;1,0;5,0;6,0;1,0;2,0;22,0;;;;;;;11,0;11,0;;;;;2,0;;39,0;27,0;4,0;;10,0;4,0;7,0;;;7,0;10,0;4,0;8,0;5,0;;1,0;25,0;6,0;;;3,0;6,0;;1,0;10,0;;3,0;4,0;;2,0;25,0;;;;3,0;7,0;2,0;;;;;;;;;2,0;3,0;;;;;;;;;;;;1,0;9,0;;;6,0;;4,0;;14,0;3,0;;6,0;36,0;;;;;;;;;1,0;;2,0;19,0;;;;;4,0;;4,0;6,0;;;;;1,0;;7,0;2,0;;8,0;;;1,0;;;;;1,0;;42,0;;10,0;;1,0;;3,0;;;;;;;;;;2,0;;2,0;;;1,0;1,0;;2,0;;;1,0;2,0;;;;;;;;;;2,0;;;;;;;;1,0;7,0;6,0;;1,0;10,0;;;;;;;;;;;;16,0;2,0;;;;;;2,0;;;;;;;;;;;;;;2,0;;;;;;;;1,0;;;;;;1,0;;2,0;;;;;;1,0;;1,0;1,0;5,0;;;;;3,0;;1,0;;;2,0;2,0;;2,0;7,0;;;;;;;;;;;;;;4,0;;;1,0;;2,0;2,0;;;;;;1,0;;;;;;;4,0;;3,0;;;2,0;2,0;;3,0;;;;;;;;6,0;;;;3,0;6,0;;6,0;;;;;;;6,0;10,0;;4,0;;;1,0;2,0;;;;5,0;;2,0;1,0;18,0;;3,0;;;;4,0;;17,0;4,0;;4,0;;;;;;;15,0;;;;1,0;;;;1,0;28,0;;3,0;;6,0;;;1,0;4,0;;;4,0;4,0;1,0;14,0;;;;;;;;;;;1,0;1,0;;;;8,0;;12,0;;;7,0;1,0;1,0;;;11,0;;5,0;;;3,0;;;;;;;2,0;;;1,0;;;;;;;;6,0;3,0;;;;;;8,0;2,0;;7,0;;1,0;;;12,0;15,0;;;;6,0;;2,0;2,0;;12,0;;;;;;;;;10,0;2,0;;;;;;;;;;;2,0;1,0;;;;;;;;;;;;;;;;;4,0;;;;1,0;;;;;;2,0;;;;;;;39,0;;;;;10,0;;;;;;;;;;;;;;;;;16,0;;;;;;;;;;;;;;;;;;;;5,0;;;;;;;;;;;;;;;;;;;;3,0;;;;;;1,0;;;;;8,0;;;;;;;;;;;;;;;;;10,0;;1,0;;;;;;;;;;;;;;;;;;;;;;5,0;;;;;;;;4,0;4,0;6,0;;;;1,0;;;3,0;1,0;;9,0;;;;;;;;;1,0;;;;3,0;;1,0;;;;;;;;;;;;11,0;;;;;;;;;;;4,0;;;;1,0;;;;;1,0;;;;;3,0;;;4,0;;;;;6,0;1,0;;;1,0;1,0;;;;;1,0;;;;;1,0;;;;;;1,0;7,0;1,0;;;;;;;;;4,0;;;;;;;1,0;;;;;;;;;;;;;;;;;;;;1,0;;;;;;;1,0;;1,0;;;;;;2,0;;;;;;;;;;;;;;;;;;;;;;;;;1,0;;2,0;;;;;;;;;;;;;;;;;1,0;;1,0;;;;;;;;;;;;;;;;;;;9,0;;1,0;;;;;;;;;;;;;;;;;;;;2,0;;;;;;;;;;;;;;;;;;;;;;;;;;;;1,0;;;1,0;;;;;;;;;;;;;;;;;;;;;;;;;;;;;;;;;;;;;;;;;;;;;4,0;;;;;;;;
create;;;;;12,0;;5,0;29,0;4,0;21,0;1,0;13,0;;;2,0;;;;19,0;12,0;7,0;11,0;;9,0;1,0;2,0;3,0;110,0;1,0;14,0;2,0;9,0;27,0;7,0;37,0;5,0;;3,0;;22,0;2,0;;;1,0;3,0;1,0;2,0;;9,0;6,0;;4,0;;2,0;;402,0;39,0;2,0;;21,0;;3,0;60,0;2,0;15,0;;6,0;;;16,0;15,0;16,0;7,0;;;8,0;;8,0;16,0;1,0;;12,0;33,0;;;;15,0;1,0;;7,0;20,0;1,0;6,0;28,0;1,0;5,0;2,0;14,0;15,0;5,0;6,0;29,0;2,0;;1,0;;;110,0;7,0;1,0;3,0;;4,0;;13,0;;;;;1,0;;;7,0;;;;23,0;1,0;;2,0;1,0;;;;2,0;1,0;;;16,0;1,0;5,0;1,0;1,0;1,0;15,0;14,0;9,0;51,0;2,0;;1,0;1,0;3,0;;;2,0;2,0;1,0;2,0;10,0;1,0;2,0;1,0;1,0;6,0;;3,0;22,0;;;1,0;1,0;7,0;;9,0;;3,0;9,0;;;3,0;2,0;2,0;4,0;;4,0;4,0;46,0;;11,0;;;;20,0;;;;;;5,0;1,0;5,0;;1,0;;1,0;1,0;;4,0;2,0;1,0;18,0;3,0;;1,0;11,0;7,0;;;4,0;;1,0;;;3,0;1,0;8,0;;;;;;;1,0;1,0;3,0;1,0;2,0;16,0;;;;;1,0;2,0;1,0;5,0;;1,0;2,0;;1,0;;2,0;;;;10,0;;;3,0;;26,0;;;;;2,0;;;;;;;;2,0;1,0;;4,0;2,0;1,0;4,0;;;;19,0;;12,0;1,0;1,0;1,0;;4,0;13,0;;;;7,0;;;1,0;;;1,0;1,0;;;3,0;;3,0;5,0;;;;;;;;;1,0;;2,0;;;;14,0;;;1,0;;23,0;1,0;;;;;;;;;1,0;11,0;2,0;;3,0;1,0;;;;5,0;1,0;2,0;;;;;1,0;;;;2,0;1,0;2,0;;4,0;11,0;2,0;1,0;;1,0;;;;2,0;17,0;6,0;6,0;;;1,0;1,0;;;6,0;;;;;1,0;11,0;;1,0;;2,0;;;1,0;12,0;3,0;;4,0;;5,0;;1,0;;6,0;4,0;1,0;;;1,0;;18,0;;21,0;5,0;;1,0;;6,0;;10,0;3,0;2,0;;11,0;;16,0;2,0;4,0;;;;;;;1,0;3,0;;;6,0;;3,0;;2,0;;3,0;3,0;8,0;;7,0;20,0;;;4,0;;;6,0;;1,0;10,0;;;2,0;1,0;2,0;;2,0;;;8,0;1,0;;;1,0;2,0;;;4,0;2,0;4,0;;;;;20,0;4,0;1,0;15,0;12,0;;5,0;1,0;34,0;20,0;3,0;8,0;;11,0;;;;2,0;2,0;1,0;;;;;3,0;12,0;;11,0;4,0;1,0;;;1,0;1,0;;;1,0;1,0;1,0;;;;;;;;2,0;;46,0;3,0;3,0;2,0;;2,0;;1,0;1,0;1,0;2,0;;;;15,0;;1,0;2,0;;3,0;9,0;;7,0;1,0;;41,0;40,0;;;;;;4,0;;;;;19,0;6,0;2,0;;;;3,0;;;4,0;10,0;20,0;2,0;;2,0;;2,0;;1,0;;;;;;;;1,0;1,0;;;;13,0;;6,0;1,0;;4,0;;;1,0;2,0;;;2,0;;1,0;;;;2,0;;1,0;;;;3,0;;;;;3,0;2,0;;1,0;;3,0;;;;;1,0;;;;2,0;11,0;;;;2,0;;;;1,0;;;;1,0;;1,0;;;;;2,0;;;;;;;;;;1,0;5,0;4,0;;1,0;;;14,0;;2,0;;;;2,0;;;11,0;;;;;;1,0;2,0;;3,0;;;;;;;1,0;;12,0;;;;4,0;;1,0;;;;;;;;1,0;;1,0;2,0;;;;;;2,0;2,0;;8,0;;1,0;1,0;;3,0;;;1,0;2,0;;1,0;6,0;;;;;10,0;8,0;;5,0;3,0;;;;;;;;;;;;;;;;;4,0;;2,0;;2,0;;1,0;;6,0;1,0;3,0;;;1,0;3,0;;;1,0;2,0;12,0;4,0;;1,0;;;;2,0;;;;;1,0;;;;1,0;;;;;3,0;2,0;2,0;;;;;;;5,0;;;;;;7,0;;;2,0;2,0;;;;3,0;;;;;;;;;;;;1,0;;;;1,0;;5,0;2,0;3,0;;;;;6,0;;1,0;;;;;;;1,0;;;;;;5,0;;2,0;;;;;;;;;;;;3,0;;3,0;1,0;11,0;;1,0;;1,0;;6,0;;;;;;;5,0;1,0;3,0;1,0;;5,0;2,0;1,0;;1,0;;;;;;;;;;;4,0;;;;;;3,0;;;1,0;;;1,0;;;;;;;3,0;;;;;;;2,0;;3,0;1,0;;;;1,0;;;;;;;;;1,0;;;;;;;1,0;;;;;2,0;;;;;1,0;3,0;;;13,0;;2,0;;;;;;;
crop;;;;;1,0;;1,0;11,0;;38,0;7,0;2,0;;;6,0;;;1,0;;;;25,0;1,0;;3,0;;;4,0;;5,0;1,0;2,0;7,0;;9,0;;;1,0;;13,0;5,0;;;3,0;;;;;;;;2,0;;;2,0;142,0;8,0;;;2,0;;4,0;11,0;9,0;;;19,0;;;8,0;;;;;;;;;22,0;;;1,0;8,0;;;;54,0;3,0;;4,0;3,0;3,0;;3,0;44,0;;;;;;4,0;8,0;4,0;1,0;2,0;1,0;;11,0;;;;3,0;;;;;;;;1,0;;;3,0;;;;8,0;2,0;;;;1,0;;;;;;;;;;;1,0;;1,0;1,0;;13,0;;;;;7,0;;;;;;;2,0;;5,0;;;;1,0;8,0;;;;;;;;1,0;;;6,0;;;1,0;1,0;;;;1,0;;;;3,0;;;;;1,0;;;;1,0;;;6,0;;6,0;;;;;;;;1,0;;;;34,0;;;;;;;;;;;1,0;;;;;;;;4,0;2,0;;;48,0;;;;;;;5,0;;;;;;;;1,0;;;;5,0;;;;;;;;;1,0;;;;;;;;3,0;3,0;;;4,0;;;;;;;;4,0;3,0;;;;;;1,0;;1,0;;2,0;3,0;;2,0;;3,0;;;1,0;;3,0;;;;3,0;;;;;;;;;;;;;;;;;;;10,0;;;;;;;;;;;19,0;;7,0;;;;;;2,0;2,0;;18,0;;;3,0;;;;;;;;;3,0;;3,0;;;9,0;;6,0;;;;;;;;;1,0;;;;;;;9,0;;;;;;;;6,0;;;;1,0;1,0;;;;;1,0;;23,0;5,0;1,0;;;;;;;4,0;;9,0;;47,0;;;;2,0;;;1,0;4,0;2,0;1,0;1,0;;;;;;1,0;;;;;;;;;;1,0;9,0;;;1,0;;;;;;;4,0;;;;;12,0;;;3,0;;;;;5,0;;;;;1,0;;;;;;;;;;;;;5,0;;;;;6,0;4,0;16,0;;;;;;;;;;;;;;;;;3,0;;3,0;;;;;;;;;;;;;;;;;;;1,0;;;;;;;;;;;;;;;;1,0;;;;;;;;;9,0;4,0;;;;;;7,0;;;;;;;;;;;;;;;;7,0;;;;;;;;;;;;;;;;;1,0;;;;;;;;;;;;;;;;;;;;;;;;;;;;;;;;;;2,0;;;;;;;;;;;;;;;;;;;;;;;;;;5,0;;;;;;2,0;;;;;;;;1,0;2,0;;;;;;;;;;;;;2,0;;;;;6,0;;7,0;;;3,0;;;;;;;;;;;;3,0;;;;;;;;;;;;;;;;;2,0;;;;1,0;;;;;;5,0;;;;;;;;;;;;;;;3,0;;;;;1,0;;;;;;;;;;1,0;;;;;;;;4,0;;;;;;;;;1,0;;;;;;;;;;;;;;1,0;;2,0;;;;;;;;;27,0;;2,0;;;;;;;;;;;;1,0;;;;;;;;;3,0;;;;;;;;;;;;;1,0;;;;;;;;;;;;;;;;;;;;;;1,0;;;;;;;;;;4,0;;;;;;;;;;;;;;;;;;;6,0;;;;;;;;;;;;;;;;;;;;38,0;;;;;;15,0;;;;;;;;;;;;;;;;;;;;;;;;;;6,0;;;;;;;;;;;;;;;;;;;;;;;;;;;;;;;;;;;;;;;;;;;;;;;;;;;;
cylinder;;;;;8,0;;73,0;15,0;;;7,0;;2,0;;;;;;17,0;1,0;;11,0;;;;;;;;3,0;;;16,0;;5,0;;;38,0;;;;;31,0;9,0;;;2,0;;1,0;;;2,0;;33,0;;10,0;39,0;;5,0;408,0;64,0;;1,0;;;3,0;9,0;1,0;3,0;;45,0;;;28,0;1,0;;;2,0;87,0;;10,0;1,0;;;;;2,0;;;;1,0;3,0;3,0;2,0;;17,0;;1,0;15,0;;77,0;3,0;;;;;;4,0;1,0;1,0;;5,0;;8,0;43,0;;12,0;;;27,0;;;3,0;2,0;;;56,0;4,0;;4,0;26,0;;;;;;36,0;;;4,0;;;;26,0;;9,0;37,0;62,0;;;;38,0;51,0;;;14,0;19,0;7,0;;;;2,0;129,0;50,0;;4,0;;3,0;2,0;;24,0;2,0;16,0;17,0;65,0;52,0;131,0;;8,0;;;2,0;2,0;;32,0;16,0;10,0;51,0;;94,0;;9,0;;9,0;1,0;;;4,0;66,0;6,0;;19,0;4,0;57,0;3,0;;;1,0;3,0;99,0;;1,0;;;;2,0;4,0;;;;9,0;;;;46,0;1,0;;;;1,0;20,0;;2,0;4,0;1,0;9,0;3,0;2,0;3,0;;101,0;;1,0;17,0;;;;2,0;33,0;35,0;;;;14,0;4,0;;9,0;14,0;2,0;13,0;;16,0;;10,0;11,0;1,0;74,0;4,0;18,0;1,0;;13,0;;;5,0;;;1,0;;9,0;11,0;11,0;1,0;34,0;4,0;;45,0;3,0;;8,0;;;;;;4,0;;11,0;2,0;;;;2,0;8,0;27,0;7,0;13,0;14,0;12,0;1,0;8,0;;26,0;34,0;14,0;;11,0;;4,0;1,0;23,0;;50,0;6,0;6,0;1,0;;24,0;;;;;3,0;;;;;;;;;;1,0;;;;;;;;9,0;;;;;;;;;;;;;;;;;;;;;;3,0;;;1,0;2,0;;;19,0;;;;1,0;;;;;;;;2,0;27,0;;;;;;;;;;;;;;;5,0;4,0;;2,0;13,0;;1,0;;;;;1,0;;;;;2,0;;2,0;;;;1,0;;;;;;;;;;;1,0;;;;;;;;;;;;;;;;;;;;;;;6,0;;;107,0;;;;;;;;1,0;;;;;;;;;;;102,0;;;;;;;;8,0;;;1,0;;1,0;;;;;;;;;;;15,0;4,0;;;;2,0;;;;;;;7,0;;;;;;;;1,0;1,0;;;;;;5,0;;;;;;2,0;5,0;1,0;;2,0;;;1,0;;;;;;;;;;;;1,0;;;;;25,0;;4,0;;;;;;;;;;;;;;3,0;;;;4,0;;;;;;;;;;4,0;;;;;;;;;;;4,0;;;;1,0;;;;;;;;;;;;;;;4,0;;;;;3,0;6,0;;;1,0;;;;;;;;1,0;;;;;;;2,0;;;;46,0;2,0;;;;;;;;19,0;;;;;;2,0;;;;2,0;;;;;;;;;;;;;;;;;;3,0;;;;;;;;;3,0;;;;4,0;;;;;;;;;;;;;1,0;;;;;24,0;;;10,0;;;2,0;;;;;1,0;;;;;;;;;10,0;;;;;;;;;;;;;;;;;;;;;;2,0;;;;;;;;4,0;;;;;;;;;;;;;;;;;;;;;;2,0;;;;2,0;;;;;;;;;;2,0;;;2,0;;;1,0;1,0;;;;4,0;;;;;;2,0;;;;;;;;1,0;;2,0;;5,0;;;;;5,0;;1,0;;;;;3,0;;5,0;;;;;1,0;;8,0;;;;;18,0;;;;9,0;;;;;3,0;;;;;;;;;;;;3,0;;;;;;;;;;;;;;;;;;;2,0;;;;;;;;;;;;;;;;;;;;;;1,0;;;;;;;;;;;;;;;;;;;;;;4,0;;;;;;;;;;;2,0;;;;;;;;;;;;;;;;;;;;;;;;;;;;3,0;;;;;;;;;;;;;
cylindrical;;;;;6,0;;31,0;31,0;;6,0;6,0;;6,0;;;1,0;;1,0;5,0;;;11,0;12,0;;;;;;2,0;;1,0;;29,0;;2,0;;;27,0;1,0;4,0;1,0;;5,0;7,0;;;3,0;1,0;1,0;;1,0;4,0;;;;19,0;78,0;;;139,0;1,0;;8,0;;;4,0;2,0;;;;18,0;;;21,0;;1,0;2,0;;23,0;4,0;4,0;;1,0;;;;16,0;;2,0;;2,0;;;;1,0;7,0;;;1,0;6,0;115,0;10,0;;4,0;;;1,0;52,0;;;1,0;6,0;5,0;41,0;16,0;;;;3,0;77,0;;2,0;;3,0;1,0;1,0;7,0;15,0;;6,0;12,0;;;9,0;4,0;;43,0;;;2,0;;;3,0;6,0;;1,0;48,0;11,0;;;;19,0;8,0;;24,0;57,0;4,0;56,0;1,0;9,0;;;51,0;12,0;;;;5,0;;7,0;90,0;1,0;64,0;10,0;2,0;32,0;51,0;2,0;1,0;;;9,0;1,0;2,0;3,0;4,0;12,0;17,0;;163,0;5,0;10,0;;18,0;11,0;;4,0;;6,0;1,0;;64,0;1,0;3,0;20,0;;;;1,0;18,0;;;1,0;;;;;2,0;;4,0;23,0;2,0;;;149,0;;2,0;;;1,0;;;2,0;8,0;;1,0;2,0;;1,0;;45,0;5,0;;9,0;;4,0;6,0;;15,0;30,0;;;;9,0;;;;68,0;;35,0;1,0;;12,0;4,0;20,0;;38,0;1,0;19,0;5,0;;3,0;;4,0;15,0;3,0;;;;16,0;15,0;6,0;;8,0;36,0;;;3,0;;3,0;;;;;;;;;;3,0;4,0;2,0;;3,0;7,0;2,0;;4,0;;3,0;;4,0;;;3,0;1,0;1,0;5,0;6,0;;3,0;;14,0;5,0;;3,0;;7,0;1,0;;1,0;;;;;;;;;;;;;;;;;;;;3,0;;;;;;;;;;;;;;;;;;;;;;;;;;;;;;;;;;;;;;;;;;1,0;;;;;;;;;;;;;;;2,0;;;3,0;4,0;6,0;4,0;2,0;;;;2,0;;;;;1,0;;;;;;;;;;;;;;;;;;;;;;;7,0;3,0;;4,0;;;4,0;;;;;;;;;;;;;;5,0;;;;;;;;;;1,0;;;;;;;;;35,0;;;;;;1,0;;;;6,0;;;3,0;;;;;;8,0;3,0;;10,0;;4,0;4,0;;;;;4,0;2,0;;;;1,0;6,0;;;;;;;;;;;;;;;2,0;;1,0;;;;;;2,0;;;;;;;1,0;1,0;;;;;9,0;;;;;2,0;;;;9,0;;;;1,0;;;;16,0;;9,0;;;;;;;;;;7,0;;;;;1,0;;;;;;;;1,0;;;;;;;;;;;1,0;;;;;;;;;;;;;2,0;;1,0;;;;1,0;;3,0;6,0;;;;2,0;;;;;;;2,0;;;;;8,0;;;;;4,0;36,0;6,0;1,0;;;1,0;;2,0;;;1,0;;;2,0;;;;;1,0;4,0;7,0;;;1,0;;;;;;;;;;;;;;1,0;2,0;;;;17,0;;2,0;;;;;;;7,0;;;;;;1,0;;1,0;;;;;;1,0;;;;;;;;;1,0;;;;;1,0;;;;;;;;4,0;;;1,0;;;;;;;;;;;;;;4,0;1,0;;;;;;;;;;;;;5,0;1,0;;4,0;;;;;;7,0;;;;;2,0;;;;;;;;;;;6,0;;1,0;;;;;;;;;2,0;;;;;;4,0;;;;;;;;1,0;2,0;;;;3,0;;;;;;;;;;24,0;3,0;;;;13,0;;;;;;;4,0;;;;;;;1,0;;3,0;2,0;2,0;;;;24,0;;;;1,0;;;5,0;;;1,0;1,0;;;;2,0;;;;3,0;3,0;;;;;;;;;;;;;;;;;;;;1,0;;;;;;;;;;;;;;;;;;;;;;;;;;;;;;3,0;;;;3,0;;;;;;;;;3,0;;;;;;1,0;;5,0;;;;;;;;;;;1,0;;;;;;;;;;2,0;;;;;;;1,0;;;5,0;;;;;;;;;;;;;
database;;;;;6,0;;;7,0;;;1,0;;1,0;;;;;;3,0;1,0;;7,0;1,0;;;;;34,0;;1,0;;13,0;20,0;;2,0;;;3,0;;3,0;;;;;;;;;;;;1,0;;;;65,0;19,0;;;;;;4,0;;5,0;;;;;1,0;;2,0;1,0;;;;;4,0;8,0;;;4,0;2,0;;;;;;2,0;3,0;;;;;5,0;5,0;;3,0;46,0;;1,0;18,0;;;;;;10,0;;;2,0;;;;;;;;;;;;;;;;3,0;;;;;1,0;;;2,0;;;;;;;;7,0;68,0;6,0;;25,0;;;;;;;;2,0;;;;;;;;;;;;;;2,0;;;;1,0;;;;;;;;;;;;;;;11,0;;2,0;;;;3,0;;;;;;;;;;;;;;;;;;;;;1,0;3,0;2,0;;;;;;;;;;;;;;;;;;;;;;2,0;;;;;;;;;;;;;;;5,0;;2,0;;8,0;1,0;;;;;;;;;;;;;;;;;12,0;;;1,0;;;;;;;;;25,0;;;;;;;;;;;;;;;2,0;;;;;;;;2,0;;;;;;;;;;;1,0;;;;2,0;;;2,0;;12,0;;;;;;;;1,0;;;3,0;14,0;;;;2,0;;;;;1,0;;;;;;;;;1,0;;;;9,0;;;;;;;;;;1,0;1,0;;;;;;;;1,0;;;;2,0;;1,0;;2,0;;30,0;;;;9,0;;;;;;;;;5,0;1,0;1,0;;;2,0;;;;;20,0;;1,0;;4,0;;;2,0;;;;4,0;;1,0;;;;;;;;;;;;8,0;;;;;;2,0;1,0;;2,0;1,0;2,0;;;2,0;;;;;;3,0;;;1,0;1,0;;1,0;4,0;;;5,0;;;;4,0;2,0;;4,0;4,0;7,0;2,0;4,0;;1,0;;;;;7,0;3,0;;;;2,0;;;;;;1,0;2,0;;;;;;;;;;;;9,0;3,0;;;;;;;;;2,0;;;;;;;;;;;;;;;;6,0;;2,0;;2,0;;;1,0;;;4,0;;;;;3,0;;;;3,0;;;;;;;;;;;5,0;;;14,0;2,0;;;;;;4,0;;1,0;;;;;;;;5,0;;;;;;;;;;;;;;;;;;;;;;1,0;;;2,0;;2,0;;;;;;;;;;;;2,0;;;;;;;;;;;;;;;;;3,0;;;;;;;;;;;;;;;;;;;;;;;;3,0;;;;;;;;;;;;;;;;;;3,0;;;;;;;;;;;;;;;;;;;;1,0;;;;;;;;;;;;;;4,0;;1,0;;;;;;;;;8,0;;;;;;;;;;;;;;;2,0;2,0;;;;;2,0;;;;;;;;;;;1,0;;;;;;;;;;;1,0;;1,0;;;;;;3,0;;;9,0;6,0;1,0;;;;;;2,0;;;;;;;;;;;5,0;;;;;;;;3,0;;;;;2,0;;;;;;;;;;;;;;;;;;15,0;;;;;2,0;;;;;;;;;;;;2,0;;;;;;;;;;;;1,0;;;;;;;;;;;;;;;;;;;;;;;;;;;2,0;8,0;;;;;;;;;;;;;;;;;2,0;;;;1,0;;;;;;;;;;;;;;;;;;;;;;;;;;;;;;;;;;;11,0;;;;;;;;;;;;;;;;;4,0;;;;;;;;;;;;;;;8,0;;;;;;;;;3,0;;;;;;;;;
denote;;;;;1,0;;2,0;;3,0;;16,0;;;;;;;;1,0;;12,0;;5,0;;;;;1,0;;;;2,0;;;1,0;;;;;13,0;14,0;;;2,0;;;;28,0;;;;;;7,0;6,0;44,0;1,0;;36,0;52,0;;;3,0;;;;;;;;10,0;;;;;1,0;;26,0;8,0;;;;;;;;;;21,0;;31,0;;;1,0;;;;;;;;11,0;;;;;;15,0;;;;;;;;;;;;;;;;;;;;;;;;;;;;;;;;;;;;;;;;23,0;;;;;;;;;;;6,0;1,0;;;;;;;;;;3,0;;;;;;;;;;;;;;;;;;;;;;;;;;;4,0;;;;;;;7,0;;;;;;;;;;;;12,0;;;;;;;;;;;;;;;;;;;;9,0;;;;;;;14,0;;;;2,0;;;;;;;;3,0;;;;;;;;;;;;;;;;;;;;;1,0;;;13,0;;;;;;;;;6,0;;;;;;;;;;;;;;;;;;;;;;;;;;;;;;;;;;;;;;;;;;;1,0;;;;;;;;2,0;;;;;;;;3,0;;;;;;1,0;8,0;;;;;;;;;;;;;;;;;;;;;;;;;;8,0;4,0;;;;;;;;;;;;;;2,0;;;;;2,0;;;;;16,0;;;1,0;;;;;;1,0;;;;;1,0;;;;;;;;;;;;1,0;;;;;;;;;;;;;;;;;;;;;;1,0;;;;;;;;;;;5,0;;;;;;;;6,0;;;;;;;;;;;;;;;;;;;;;;;;3,0;;;;;;;;;;;;;;;;;;;;;;;;;;;;;;;;;;;;;;;;;;;;;;;;;;;;;;;;;;;;;;;;;9,0;;;;;;;;;;;;;;;;;;;;;;1,0;;;;;;;;;;;;;;;;;;;;12,0;;;;;;;;;;;;;;;;;;;;;;;;;;;;;;;;;;;;;;;;;;2,0;;;;;;;;;;;;;;;;;;;2,0;;;;;;;;;;3,0;9,0;;;8,0;;;;;4,0;1,0;;;;;;;;;;4,0;8,0;;;26,0;;;4,0;;;;;;;;;2,0;2,0;;;;;;;;;;;;;;;;;;;;;;;;;;;25,0;;;4,0;;;;;;;;25,0;;;;20,0;;;;;;39,0;;;;;;;;;;;;;;;;;;;;;;;;26,0;;;;;;;;1,0;;;;;;;;;;;;;;;;;;;;8,0;;12,0;;;;;;;;;;;;;;;;;;6,0;;;;;;;;;;;;;;;;;;;;;;;;7,0;;;;;;;;;;;;;;;;;;;;;;;;;;;;;;;;;;;;;;;;2,0;;;;;;;;;;;;;;;;;;;;;;;;;;;;;;;;;;;;;;;;;;;;;;;;;;;;;;;;;;;;;;;;;;2,0;;;;;;;;;;;;;;;;;;;;;;;1,0;;;;;;16,0;;;;4,0;;;;;;
design;;;;;8,0;;1,0;14,0;;2,0;;2,0;;;13,0;2,0;2,0;;;3,0;;10,0;;2,0;;;1,0;15,0;;8,0;;5,0;11,0;;5,0;;;2,0;;11,0;;2,0;;13,0;;;;6,0;;;4,0;18,0;2,0;2,0;;18,0;7,0;;6,0;38,0;2,0;;20,0;2,0;4,0;1,0;1,0;;;6,0;19,0;;;4,0;;;;;2,0;;1,0;3,0;2,0;;2,0;1,0;2,0;;6,0;6,0;5,0;3,0;;3,0;1,0;2,0;;;1,0;;;7,0;2,0;;;;;20,0;;;6,0;1,0;1,0;2,0;2,0;;2,0;;;6,0;;;;3,0;;;1,0;4,0;;2,0;2,0;;;;2,0;;1,0;;3,0;;;4,0;;;3,0;1,0;4,0;1,0;1,0;;;1,0;;;;;;5,0;;3,0;;;;1,0;4,0;;;10,0;1,0;2,0;3,0;1,0;;8,0;;3,0;;;1,0;;;;;;3,0;;8,0;17,0;;7,0;;;;8,0;;7,0;;;2,0;;;;;1,0;;4,0;;;3,0;3,0;;;;;;1,0;;;;;;2,0;;;;;;;;;2,0;;1,0;;;3,0;;;1,0;;1,0;;;;;;;;;;;;;1,0;;;;1,0;;1,0;;2,0;;;;;;;;1,0;;1,0;;1,0;;1,0;;;;;;4,0;6,0;2,0;;2,0;;;2,0;;;;3,0;1,0;;;;6,0;;;;;;;;;1,0;;;1,0;;;;1,0;;1,0;;;1,0;;;;1,0;;;;;;;;3,0;;;;;;1,0;;1,0;;;;;2,0;;;;;4,0;3,0;2,0;;22,0;;;;;;;;;;;;1,0;;;3,0;;1,0;;;;4,0;1,0;;1,0;;;1,0;;;1,0;;;;;;;1,0;;1,0;;;;;;;;;1,0;;;2,0;;;;4,0;;1,0;;2,0;;4,0;;;1,0;;;;;;;;28,0;;;;1,0;1,0;;;;1,0;;8,0;;;;4,0;;;;;;3,0;;;7,0;;;1,0;2,0;;;;;1,0;7,0;;;;;;1,0;1,0;;;14,0;;;6,0;1,0;;;;;;;;;;;;;1,0;2,0;;;1,0;1,0;;;1,0;6,0;3,0;;;;;;;;;;1,0;;;3,0;1,0;;;;3,0;;;4,0;;;;;;;;;;;;;;;;;;;;;2,0;2,0;;;;;;;;1,0;;;;;;;6,0;1,0;;;;;;1,0;;;;;;1,0;;2,0;;;;;;;;1,0;;;1,0;;;;;;2,0;;;;;;;;;;4,0;;;;;1,0;;1,0;;;;;;;;5,0;7,0;;;;;;;;;;;;;;;;;;;;;;;;;;;;1,0;;;;;;;;;;;;4,0;;3,0;;;;;1,0;;;;;;;;;;;;;3,0;;;;1,0;;;;;;4,0;;2,0;;;;;;;;2,0;;;;;3,0;;;;;;;;;;;;;2,0;;2,0;;8,0;;;3,0;;;;;1,0;1,0;;;;;;;;;;;;;;;;;;;;;;1,0;;;;;;;;;;;1,0;;5,0;;2,0;;;;2,0;;;1,0;;;;;;2,0;;;;;;;;;;;1,0;;;;;;;;;;;2,0;;;;;;2,0;;;;;;;;;;;;;;;;;;;;;;;;;;5,0;;1,0;;;1,0;;;;;;;;1,0;;;;;;;;;;;;;;;;1,0;;;;;;;;;;;;;;;3,0;;;;;;;;;;;;;;;;1,0;;;;;;;;11,0;;;;;1,0;;;;;;;;;;;;;;;;;;;;;;1,0;;;;;;3,0;;;;;;;;;;;;2,0;1,0;;;;;;;;;;;;;2,0;;;;;;;;;;;;;;;;;;;;;;;;;;;1,0;;;;;;;;;;;;;;;;;;;
detachable;;;;;14,0;;3,0;2,0;;29,0;;;;;1,0;;;;;2,0;;7,0;;;;;;49,0;1,0;9,0;4,0;;71,0;;4,0;;;;;1,0;;;;4,0;;;;;2,0;;;;;;;14,0;20,0;;;36,0;;;5,0;;;3,0;;;;;2,0;;;;;;;;3,0;3,0;;3,0;1,0;;3,0;;;;;5,0;1,0;;;1,0;;;;86,0;16,0;;;13,0;;;;;1,0;14,0;;;3,0;;;3,0;29,0;;;;;17,0;;;;;;;3,0;;;9,0;1,0;;;;;1,0;;;;;;;;;;;;7,0;;1,0;;;;;3,0;;;4,0;;5,0;;;;;1,0;;;4,0;;;2,0;;27,0;7,0;4,0;;;1,0;;;1,0;;;;;;1,0;7,0;;4,0;;;;4,0;;;;;4,0;;3,0;;;;;;;;;7,0;;2,0;;;;;1,0;;;;;;;;;;1,0;;;;;;;;1,0;;;;1,0;;;;;;;;;;;;;;;3,0;;;2,0;;;;;;;;;;;6,0;;;;;;;;6,0;;;;;3,0;;1,0;3,0;;;;2,0;1,0;;;;;;;;;8,0;;;6,0;;;;;;;;;;;;;;1,0;;1,0;;;;;1,0;;;;2,0;;;;;5,0;;;;;;;;;;;;;;;;;;;;2,0;;4,0;;;;;;;;;;;;;1,0;;;2,0;;;;;;48,0;1,0;;;;;;1,0;;20,0;;;;;;;1,0;;;;;;;;;;;;;;;;;;;1,0;;;;;;;;;;;;;;1,0;;1,0;;7,0;1,0;;;;;;;12,0;;1,0;;5,0;;;1,0;;1,0;;;;;;;;;;;3,0;;;;;;;;;;;3,0;;;;;;;;13,0;;;;;;;;;;;;;1,0;;5,0;;;;;4,0;;;;;5,0;;;;;;3,0;;;;;;;;;1,0;5,0;2,0;;;;4,0;;;;;;1,0;;;1,0;;;;;1,0;;;;;;;;;;;;;;;;;;1,0;;;;;;;;;;;;;;1,0;;;;;2,0;3,0;;;;;;;3,0;;;1,0;;;;;;;;2,0;;;3,0;;;;;;;;;;;;;7,0;4,0;;;;;;;;;1,0;;1,0;;;;;;;;;;;;;;;;;;;;;;;;;;;;;;;;;;;;;;1,0;;;;;;;;;;1,0;;;;;;4,0;;;;;;;;;;;;;;;;;;;;;;;;;;;;;;;;;;;;;;;;;2,0;;;;;;;;;;;;;;;;;;;;;;;;;;;;;;;;;;;;;;;;;;;;;;1,0;;;;;;;;;;;;;;;;7,0;;;;;;;;;;;3,0;;;;;;;;2,0;;;1,0;;;;;;;;;;;;;;;;;;;;;;;;;;;;;;;;;;;;;;;;;;;;;1,0;;;;;;;;;;;;;;;;;;;;;;;;;;;1,0;;;;;;;;;;;;;;;;;;;;2,0;;;;;;;;;;;;;;;;;;;;;;;;;;;;;;;;;;;1,0;;;;;;;;;;;;;;;;;;;;;;;;;;;;;;;;;;;;;;;;;;;;;;2,0;;;;;;;;;;;;;;;;;;;;;;;;;;;;;
diffusion;;;;;7,0;;;2,0;;;;1,0;;;1,0;;;;;;;1,0;;1,0;;;;;;;2,0;;31,0;;;;1,0;3,0;;;5,0;;;15,0;1,0;;;;;;;1,0;;;2,0;11,0;13,0;;;3,0;;;4,0;;;;;;;;2,0;;1,0;;;;;;1,0;1,0;;;4,0;;;;142,0;;1,0;1,0;;;;30,0;;;;;2,0;;1,0;6,0;;29,0;;;17,0;31,0;;;4,0;2,0;8,0;;;;1,0;;;;;;;;;;1,0;7,0;;;3,0;;;;;3,0;2,0;;3,0;;;;;3,0;2,0;;17,0;;;;;;3,0;;4,0;;;;;7,0;;1,0;;;;25,0;3,0;15,0;;;;;;;;;;27,0;;;;;;;;;9,0;36,0;;60,0;;;;;;2,0;;;;;3,0;;;7,0;;;;;;;;;;;;;;;;;1,0;;;;;;;;;;;;;;1,0;1,0;;;;;;;;;;;2,0;;;;5,0;3,0;1,0;23,0;;;;;;;1,0;4,0;;;;;;;;;;;;5,0;;;;;;;;;;;;;;12,0;;4,0;;;;;;;9,0;;;;;;1,0;;;;;;;;;;;;;;;;;;;;;;;5,0;;;3,0;;;;;;;7,0;;;;;;1,0;;;;;;;;;;;4,0;;;1,0;;;;;6,0;;;2,0;;;;;1,0;;;2,0;;;;;;;;;1,0;1,0;;;3,0;;;;;;;;;;;;;;;;;;;;;;;;;;;;29,0;;;;;;3,0;;;;;;;;;7,0;;;;;;;;1,0;;;;;;;;;;;29,0;9,0;;;;;;1,0;;;;;;;;;;;;1,0;;;19,0;;;;;;;;;;;;;;;;;;;;;3,0;;4,0;;;;;;4,0;;;;;1,0;;;;;;;;;;;;;;;;;;;1,0;;;;2,0;;;;;;;;;;;;;;;;;;;;;;;;;;;1,0;;;;;;;;13,0;15,0;;;;;;;;;;;;;;;;;;;;;;;;7,0;;;;;;;;;;15,0;;;;;;;;;;;;;;;;;;;;;;;;;24,0;;;2,0;7,0;;1,0;;;;;3,0;;;;;;;;;;;;;;;;;;;;1,0;;;;;;;;;;;;;;;;;;;;;;;3,0;;;;;;8,0;13,0;;;;7,0;18,0;;;;;1,0;;;;203,0;8,0;;;;;;;;;;17,0;;;;;;;;;;50,0;2,0;;;;;;;;;;;;;;;;;;1,0;;;;;;;;;;;;;;;;;;;;;;2,0;1,0;;;;;;;1,0;;;;;;1,0;;;;;;;;;;;;;;;;;;;;;;;;;;;;;;;;;;;;;;;;;;;;;;;;;;;2,0;;;;;;;;;;;;;;;;2,0;;;;;;;;5,0;;;;;;;;;;;;2,0;;;;;;;;;;;;;;;;;;;;;;;;;;;;;;;;;;;;;;;;;;;;;;;;;;;;;;;;;;;;;;;;;;;;;;;;;;;;;;;;;;;;;;;;;;;;1,0;;;;;;;17,0;;;;;;;;;;2,0;;;;;;;;;;;;;;;;;;;;;;;;;;;;;;;;
discrete;;;;;3,0;;;1,0;;21,0;;;;2,0;8,0;;;;4,0;;;;;;3,0;;;18,0;;;;2,0;17,0;;;;1,0;2,0;;1,0;2,0;;;9,0;;;;11,0;2,0;;;11,0;;2,0;;32,0;6,0;1,0;1,0;21,0;;;24,0;2,0;;;;3,0;2,0;1,0;1,0;;;;;;;5,0;37,0;2,0;;5,0;1,0;;;;4,0;;1,0;3,0;2,0;;1,0;2,0;2,0;4,0;;2,0;2,0;1,0;;13,0;;;;1,0;;1,0;;;;;50,0;4,0;;;;2,0;;4,0;;;;6,0;;4,0;;;1,0;1,0;1,0;;;;;;2,0;;;;;;;;1,0;;1,0;;;;2,0;;;;;2,0;;13,0;;1,0;;;;;;;1,0;18,0;;;1,0;;14,0;1,0;;;;;;;;;;;;;;149,0;;10,0;1,0;;;;;;;;;;;8,0;;;;;;;;;;;;;;;;;;;;;;;;75,0;;;;;;;;;33,0;4,0;;;87,0;;;;;;;;4,0;;;;;4,0;;;;;3,0;5,0;;;;;;;;;;;;;;;;;;;;;;;1,0;;;2,0;;1,0;;;2,0;;;;;2,0;;;;;;;1,0;;2,0;2,0;2,0;;;4,0;;;1,0;;;;1,0;;;;;;;;;;;4,0;;;1,0;;2,0;;;;;;;;;1,0;8,0;1,0;;;;;;;;;;;;;;;;;;;;;;;;;;;4,0;;;;5,0;;;;;;;;;;;;1,0;;;;;;;4,0;;;;;;7,0;;;;;1,0;;;;;41,0;;;;;;;;;2,0;;;;7,0;;;1,0;1,0;;;2,0;;;;;;;;1,0;;;;;3,0;;;;;3,0;1,0;;;;;;1,0;;;;;;;;;;;;;;;;1,0;;;5,0;;1,0;;;;;;3,0;;;;;;1,0;;;;6,0;;2,0;;;2,0;;;;;;;;;;8,0;1,0;;;;;;;;;;;;;;;;;;;;;2,0;;;;;;4,0;;;;;;;;;;;;;3,0;;;;;;;;;;;2,0;;;;50,0;;;;;;;;;;;;;;;;;;;;;;;;;;;;;21,0;;;;;;;;;2,0;;;;;;;;;;;;;;2,0;;;;;;;1,0;;;;7,0;;;;;;;;;;;;;1,0;;;;;;;;;1,0;;;1,0;;;;;1,0;;;;;;;;;;;;;;;;;;;;;;;3,0;;;;;;;;;;;1,0;;;;;;;;;;;;;;;;;;;;;;;;;2,0;1,0;;;;;;;;;;;2,0;;;;;;;;;;;;;;1,0;;;;;2,0;;;;;;;;;;;;8,0;5,0;;;;;77,0;;;;;;;;;1,0;;;;;;;;2,0;;;;;;;;;;;;;;;;;;;;;;1,0;;;;;;;1,0;;;;;;;;;;;;;;;;;;;;;11,0;;;1,0;;;;;;;4,0;;;;;;;;;;;;;;12,0;;;;;;;;;;;;;;;;;;;;4,0;;;;;;;;;;;;;2,0;;;;;;;;;1,0;;;;;;;;;;;;;;;;;;;;;;;;;;;;;;;1,0;;;;;;15,0;;;;;;;;;;;;;;;;;;;;;;;;;;;;;;;;;;;;;;;;1,0;;;;;;;;;;;;;;;;;;;;;;;;;;;;
distal;;;;;6,0;;13,0;29,0;3,0;38,0;1,0;;;;;1,0;;;;4,0;;6,0;;;;;6,0;2,0;1,0;2,0;;10,0;50,0;;5,0;;;4,0;;3,0;11,0;;3,0;4,0;;;;8,0;;;;;;;;45,0;14,0;;5,0;8,0;4,0;;7,0;;4,0;;3,0;4,0;2,0;;1,0;;;;1,0;;;7,0;45,0;;;1,0;4,0;;;;11,0;4,0;;;8,0;;;1,0;;4,0;;;1,0;;18,0;5,0;;;;;;8,0;;;1,0;;;14,0;10,0;;;;;18,0;;;;;;;9,0;12,0;;23,0;4,0;;;7,0;2,0;;17,0;;;;;;;13,0;;1,0;12,0;10,0;;;;;6,0;;6,0;1,0;7,0;11,0;2,0;2,0;;;15,0;4,0;7,0;;;3,0;;1,0;51,0;;30,0;46,0;5,0;4,0;6,0;;;;;1,0;2,0;;21,0;;19,0;9,0;;91,0;;;;2,0;;;;2,0;1,0;3,0;;2,0;2,0;13,0;10,0;;;;4,0;31,0;;2,0;;;1,0;2,0;;1,0;1,0;22,0;;;;;7,0;;1,0;;;;;;;4,0;;2,0;;2,0;1,0;;4,0;7,0;;2,0;6,0;1,0;;;;;;;;29,0;1,0;;6,0;15,0;;2,0;;;;;2,0;3,0;26,0;;3,0;;8,0;11,0;;;4,0;;;1,0;2,0;9,0;1,0;2,0;;;;;10,0;;;4,0;;;;;;;;;;1,0;;5,0;4,0;4,0;6,0;2,0;;;17,0;2,0;2,0;9,0;;;;;1,0;;;;;;;3,0;;6,0;;4,0;;;1,0;;14,0;;;;;;;;;;;;;;;8,0;1,0;;3,0;;;;;;;;;;;;2,0;;;;;;;;;;;;;;4,0;;;;;;;;;;;;;;5,0;;;;;;;;;;;;;;;;;;;;;8,0;2,0;;1,0;;;;1,0;6,0;1,0;;;;;;;;;;;;;;;;;;;;;;;;1,0;;;;;;;;;3,0;;;;;;;;;;;;;2,0;;;;;;1,0;;2,0;;;;;;;;;;;;;;;;;;;;6,0;10,0;;;2,0;;4,0;;;;9,0;7,0;;1,0;;;;;;;;;2,0;;;;9,0;;;;;;1,0;18,0;;;;;;;;;1,0;1,0;;;;;;;;;15,0;;;2,0;;;;;;;;;;;;;;;90,0;;10,0;;;;;;;;;4,0;7,0;;;;;;;;;3,0;;;;;3,0;;5,0;;;;;;;1,0;;;;;3,0;;;;;;;1,0;4,0;;;;6,0;;4,0;;;4,0;;1,0;;;;1,0;;1,0;;2,0;2,0;1,0;;8,0;26,0;2,0;4,0;;;;;;;;;;;1,0;;2,0;;;2,0;11,0;;5,0;;14,0;11,0;;;;3,0;;;;;;;;;4,0;;;;;;;;;;;;;;;;1,0;;;;;;;;;;;;;;;;;;;;;;;;;;;;;;;;;;;;;;;;;;;;;;;;;;;;;;;;;;;;;;3,0;;;;;4,0;;6,0;;;;;;;;;;;;;;;;;21,0;;;2,0;;;;;;;;;;;;;;;;;;;;;;;;;6,0;1,0;;4,0;;;4,0;;;;;;;;;;;;;;;;;;;2,0;;;;;9,0;;;;1,0;;;;;2,0;;;8,0;;;;;;;;;;;3,0;;1,0;;;;;2,0;;;;;;;;;;;11,0;;;;1,0;;;;;;6,0;;;;2,0;;;2,0;;;;;1,0;;;;;6,0;;7,0;;;;;;;;;1,0;;;;;;;;;2,0;;;;;;;;;;;;;;;;;;1,0;;;;;;;;;;2,0;;;;3,0;;;;;;;;;;;;;;;;;;;;;;;;;;;;;;;;;;;;;;;;;;;;;;
document;;;;;20,0;;;30,0;;19,0;7,0;2,0;;;;;;;;2,0;;4,0;2,0;1,0;;1,0;;52,0;5,0;5,0;;1,0;72,0;;13,0;;1,0;13,0;;16,0;3,0;;22,0;;2,0;;;;;3,0;2,0;5,0;;;1,0;162,0;54,0;;;7,0;;2,0;48,0;;;;6,0;;;8,0;3,0;4,0;22,0;;;1,0;;1,0;17,0;;1,0;66,0;2,0;13,0;;;;;;11,0;2,0;1,0;;2,0;9,0;;;3,0;3,0;;1,0;35,0;;;1,0;;;4,0;;;1,0;7,0;;14,0;1,0;;;;1,0;;;;;;;;5,0;;;;16,0;1,0;;;;;6,0;;;;;;1,0;2,0;;;18,0;11,0;;7,0;;4,0;;;18,0;;;9,0;4,0;26,0;;;;;;;;7,0;;2,0;5,0;1,0;6,0;;6,0;2,0;;41,0;1,0;;;;51,0;5,0;2,0;;4,0;8,0;;14,0;;;;20,0;2,0;;;;4,0;;;3,0;;55,0;;;33,0;;14,0;8,0;;4,0;;;;1,0;1,0;7,0;3,0;;2,0;;;;6,0;;16,0;;;;;;;3,0;1,0;6,0;;17,0;18,0;;;;1,0;;;;;;;;;;;8,0;;;;8,0;;;;10,0;4,0;;2,0;;4,0;;;1,0;;3,0;;;3,0;2,0;1,0;;;14,0;1,0;;;45,0;;3,0;15,0;6,0;1,0;1,0;;;;;;1,0;;9,0;2,0;;4,0;;3,0;;3,0;;;5,0;3,0;;;1,0;6,0;11,0;;28,0;;;;;;1,0;;;;3,0;;;;;5,0;;;;;;;;;;;;;;;;;5,0;;;2,0;1,0;;;;;;;;;;;;;10,0;2,0;;1,0;;;;;;;;;;1,0;;1,0;;2,0;1,0;1,0;;;;2,0;1,0;;;1,0;;;1,0;8,0;;;;;76,0;;2,0;1,0;;;;6,0;;;;10,0;;;;;;;37,0;;;;3,0;4,0;5,0;3,0;6,0;;2,0;;;;;;;;;;;;;;5,0;;1,0;;;;;;;;12,0;;;;1,0;;18,0;;;;;1,0;;;1,0;;;;;19,0;;;1,0;;75,0;;3,0;3,0;;4,0;;;;2,0;3,0;;;;;;2,0;;3,0;8,0;;;;2,0;3,0;;;;2,0;;;;;2,0;;;;;3,0;;3,0;1,0;2,0;;;;;;;;3,0;;;;;;;9,0;10,0;;;;;;;;;;;;;;;;;;;;;;;;;2,0;;;6,0;;;;6,0;;;;;;;;;;4,0;1,0;;;;;3,0;5,0;;2,0;;;;;;;;;;;2,0;;1,0;;;;;;2,0;;;;;;;;;;;;;;2,0;7,0;;;;10,0;;;;;;;;;;;;;;;;;;;;;;;;;;;2,0;;;6,0;;;;;4,0;;12,0;;;;;2,0;;;;;;;;2,0;;;;;;;;;;;;;;;;;;;;;1,0;;18,0;2,0;5,0;;;;;;;;;;;6,0;;;;52,0;1,0;;;;;;;2,0;;;;;7,0;;;;;;1,0;;;;;;;;;;;;1,0;;;;;;;;;;;;1,0;3,0;5,0;;;;;;;2,0;1,0;;;;1,0;;3,0;;;3,0;;;;;;;;;;;;;;;;;;7,0;;;;;1,0;2,0;;;;;;;;2,0;;1,0;;;;;;;;;;;;;;;;;;;5,0;;;;;;;;;;;12,0;;;;;;;;;;;1,0;;;1,0;;;;;;;;;1,0;;;;;;;;7,0;;;;;;;;;;;;;;;;;2,0;;;;;;3,0;;;;;;;;1,0;;;;;;;;;1,0;;;1,0;;;;;;;25,0;6,0;2,0;;;2,0;;;;;;;;;;;;;;;;;;;;;2,0;;;;;;;;;;;;;;;;;;;;;;;;;;;;;;;;;;;;;;;;;;;;;;;;;;;;;
dome;;;;;7,0;;3,0;22,0;;;9,0;;;;;2,0;;;;;;;;;;;;2,0;;;;1,0;3,0;;;;;6,0;;;2,0;;;;;;4,0;;4,0;;2,0;;1,0;;;;15,0;;8,0;18,0;;;18,0;;;3,0;;;;2,0;10,0;;5,0;;;;;;7,0;;;;;1,0;;;;;4,0;;1,0;;2,0;;;;;;;;17,0;6,0;;1,0;;;20,0;6,0;;;;2,0;;5,0;7,0;;;;;3,0;;;;;;;;2,0;;;173,0;;;;1,0;;;;;;;;;5,0;;2,0;3,0;;;;;;;;2,0;;;34,0;;;;3,0;4,0;6,0;;;;12,0;;2,0;7,0;1,0;;14,0;;6,0;2,0;;;;;;1,0;;;;1,0;6,0;;17,0;;;;;;;;;7,0;1,0;;3,0;;2,0;;;;;3,0;13,0;;;;;6,0;2,0;;3,0;;;3,0;;1,0;;;;1,0;;1,0;;2,0;;;;5,0;10,0;;;;;;;;;;5,0;;;;;;;;;;;;;;2,0;;;;;2,0;;;1,0;;;;9,0;;2,0;7,0;;;;;;4,0;;;2,0;11,0;1,0;3,0;1,0;4,0;;;;;;;;;;;;;;5,0;;;;;4,0;;4,0;4,0;;;;2,0;;7,0;;;;;;;;;;;;;;;;;1,0;;;;;;;1,0;;;;;;;;;;;;;;;;;;;1,0;;;;1,0;;;;;;;;;;;;;2,0;;;;;;;;;;;;;;;;;2,0;;;;;;;;;;;;;;1,0;;;;;;;;;3,0;;;;;;;;;;;;;;;;;;;;;;;;;;;;;2,0;;;;;;;2,0;;;;;;;;;;;;;24,0;1,0;1,0;13,0;;;1,0;;;1,0;1,0;;;;;;2,0;;;;7,0;;;;1,0;;;;7,0;;;;;;;;;;;;2,0;;;;;3,0;;;;;;;;;;3,0;;;;;;;;;;;;;;;;;;;;;;;;1,0;;;;;;;;1,0;;;;;;;;;;;;;;8,0;;;;;;;;;;1,0;;;;;;;;;;;;;;1,0;;;;;;;;;;;;;;;;;;;1,0;;;;;;;;2,0;;3,0;;;;;;;;;;;;;;6,0;;;;;1,0;;;;2,0;;;;;;;;;;;;;;4,0;;;;;;;;;;;;;;;;3,0;2,0;;;;;;;;;;;;;;;;;;;;;;;1,0;;;;;;;;;;;;;;;;;;;;;;;1,0;;;;;;;;;;;;;;;;;;;;3,0;;;;;;;;;;;;;;;;;;;2,0;;;;;;;1,0;;;;;;;;;;1,0;;;;;;;;;;;;;;;;;;4,0;;;;;;;;;;4,0;;;;;;;;;;;;;;;;;;;1,0;;;;;;1,0;;;;;;;;;;;;;;;;;1,0;;;;;;;;;;;4,0;;2,0;;;;;;;;;;;;7,0;;;;;1,0;;;;;;;;;4,0;;;;;;;;;;;;;;;;;;;;;;3,0;;;;;;;;;;;;;;;;;;;;;;;;;;;;;;;;;;;;;;;;;;;;;;3,0;;;;;;;;;;;;;;;;;;;;;;;;;;;;;;;;;;;;;;;;;;;;;;;
driver;;;;;38,0;;47,0;13,0;;11,0;4,0;;;;;1,0;;;1,0;;1,0;151,0;;;;;;4,0;3,0;14,0;4,0;7,0;59,0;1,0;12,0;;;42,0;2,0;29,0;3,0;;52,0;18,0;;;;;71,0;6,0;7,0;2,0;;4,0;;54,0;41,0;;2,0;98,0;;;15,0;;;34,0;13,0;;;15,0;35,0;11,0;5,0;;1,0;1,0;;;38,0;9,0;;5,0;5,0;;;;1,0;;;22,0;25,0;4,0;;56,0;;;3,0;1,0;11,0;9,0;3,0;48,0;;1,0;;;;29,0;;;5,0;1,0;8,0;11,0;2,0;;;;13,0;8,0;;;5,0;47,0;;1,0;26,0;2,0;4,0;9,0;3,0;8,0;6,0;;;2,0;9,0;;;;;;;19,0;3,0;1,0;8,0;19,0;1,0;;;;1,0;;4,0;1,0;;7,0;;38,0;;;3,0;1,0;;;1,0;14,0;25,0;;18,0;3,0;10,0;41,0;2,0;3,0;1,0;24,0;;1,0;;;;;;1,0;1,0;47,0;;12,0;;;;13,0;;;;;3,0;2,0;;;;12,0;;2,0;14,0;;;28,0;;1,0;;;;10,0;6,0;;4,0;;;54,0;7,0;;;;;4,0;;;;;26,0;2,0;6,0;5,0;;8,0;25,0;3,0;9,0;;11,0;;2,0;4,0;;4,0;;8,0;7,0;;;27,0;2,0;;4,0;3,0;;;;49,0;8,0;;6,0;;9,0;;;;7,0;12,0;;;;2,0;;;3,0;;;;3,0;2,0;;8,0;20,0;2,0;4,0;;3,0;;;9,0;;1,0;2,0;5,0;;;;;6,0;;;;1,0;7,0;1,0;;7,0;2,0;;;;;;1,0;;;9,0;2,0;1,0;;;1,0;;;2,0;;3,0;;;;;;;1,0;;;1,0;15,0;21,0;8,0;;3,0;;13,0;;14,0;4,0;3,0;;1,0;;;;;;;;;;;1,0;;;;9,0;;;5,0;;1,0;;1,0;;;;2,0;2,0;4,0;2,0;2,0;1,0;;;;;2,0;1,0;11,0;2,0;;24,0;3,0;7,0;1,0;;;;;5,0;;;;1,0;15,0;;1,0;3,0;2,0;;;3,0;;;;7,0;;13,0;;;2,0;9,0;;;2,0;;;;;2,0;;1,0;;;;;;;;;2,0;;12,0;2,0;;;;;2,0;9,0;9,0;;;;;;;;;;;2,0;21,0;14,0;;3,0;;;3,0;;;;2,0;;;;1,0;10,0;;2,0;;;2,0;;6,0;;;;12,0;;;17,0;20,0;;1,0;;;3,0;;;;2,0;;;;;;;1,0;6,0;4,0;5,0;;4,0;2,0;;;;;;;;;2,0;;1,0;1,0;;;;;;;;2,0;;;;;;;;;;;;;;;;;2,0;;11,0;15,0;1,0;2,0;2,0;;;;;6,0;;;;;;;;;;;3,0;;;;;1,0;7,0;;;6,0;;;;1,0;5,0;;2,0;;;;;;2,0;1,0;;1,0;1,0;;;;2,0;;;;;1,0;;3,0;;1,0;;;;;;;;;;;;;4,0;;;8,0;2,0;;;;;;7,0;;;;;13,0;;;;;;;;;;;;3,0;1,0;;;;;;;;;;;;;;;;;2,0;6,0;4,0;;;;;11,0;;;;;;;;;;;5,0;;;;;5,0;8,0;5,0;1,0;;1,0;;;3,0;;;;;5,0;;;;;;;33,0;;;;6,0;;;;;;2,0;;;;1,0;;;;1,0;;;;;;;14,0;;2,0;;;;;;;;;;;;;;3,0;1,0;;;;;;;;;;;;2,0;;;;;3,0;;;;;2,0;1,0;;;;;;;;;;;;;4,0;;1,0;;;;;;;2,0;;;;;;;;;;1,0;;;;;;;;;;;;;;;;;3,0;3,0;;;;;;;;7,0;;;;;11,0;8,0;;;;;;;;;;;;;4,0;;;2,0;;;;;;;2,0;;;;3,0;;;;;1,0;;;;;;5,0;;;;;;;;;;;;;;;;;;;;;;;;;;;;;;;;;1,0;;;;;;;;7,0;2,0;;;;1,0;1,0;;;;;;;;;1,0;;;;;;;;;;;;2,0;;;;;;;;;;1,0;;;;;;;;;;;;;;;4,0;;;;;;;;;;;;1,0;;;;;;;;;;;
edit;;;;;1,0;;;1,0;1,0;5,0;;1,0;;;;1,0;;;;4,0;;2,0;;2,0;;;;24,0;;;;2,0;2,0;;4,0;2,0;;;;15,0;;;;;2,0;;;;;;;5,0;;;;51,0;5,0;;;;;;13,0;;;;4,0;;2,0;11,0;;;;;;;;;;;;10,0;;;;;;;;2,0;;;;4,0;;;;4,0;5,0;;;6,0;;;;;;10,0;;;;;;;;;;;;;;;;2,0;;;4,0;;;;;1,0;;;;;;;;;;;;;;;;;;;;;;;;;;;;;;;;;;;;;;;;;;;;;;1,0;;;;;;;;;;1,0;;1,0;;;;5,0;;;;;;;;;;;;;;;;;;;;;;4,0;;;;;;;;;;;;;;;;;;;;;;;;;;;;;;;;;;;;;;;;;;;1,0;;;;;;;;;;;;;;;;;2,0;3,0;;;;;;;;;2,0;;1,0;;;;;3,0;;;;;;;;;;;;;;;;;;;;;;;;;;;;;;;;;1,0;;;;;7,0;;;;;;;;;;;2,0;;;;;;;;1,0;;2,0;;;;;;;;;;;;;;;;;;;;;;;7,0;;;;;;;;2,0;3,0;;;;;;12,0;;5,0;;;;1,0;;1,0;;;4,0;;;;;;;;;;;6,0;;1,0;;;;;2,0;;12,0;;;;;;;1,0;;;29,0;;;;;;;;2,0;;;;;;;1,0;;;;;;;2,0;;;;;;;;;;;;;;;;2,0;;;7,0;;1,0;;;1,0;;;2,0;2,0;;1,0;4,0;;;7,0;3,0;2,0;;;;;;9,0;1,0;;;;1,0;2,0;;;;;;;;;;;;;;;;;1,0;;;;;;;;;2,0;;;;;;;;;;;;;;;;;;;;;;;;;4,0;;;;;;;;10,0;;1,0;;1,0;;;;;;;;;;;;;;;;;;;;;;;;;;;;;;;;;;;;;;;;;;;;;;;;1,0;;;;;;;;;;;;1,0;;;;;;;;;;;;;;;;;;;;;;;;;;;;1,0;;;;;;;;;;;;;;;;;;;;;;;;;;;;;;;;;;;;;;;;;;;;;;;;;1,0;;;;;;;;;;;;;;;;;;;;;1,0;;;;;;;;;;;;;;;;;;;;;;;;;;;;;;;1,0;;;;;;;;;;;;;;;;;;1,0;;;;;;;;11,0;;;;;2,0;;;;;;;;;;;;;;;;;;;;;;;;;;;;;;;;;;;;;;;;;;;;;;;2,0;4,0;;;;;;;;;;;;;;;;;;;;;;1,0;;;;;;;;;;;;;;;;;;;;;;;;;;;;;;;;;;;;;;;;;;;;;;;;;;;;;;1,0;;;;;;;;;;;;;;;;;;;;;;;;;;;;;5,0;;;;;;;;;;;;;;;;;;;;;;;;;;;;;;;;;;;;;;;;;;;;;;;;;;;;;;;;;;;;;;;
elongate;;;;;19,0;;4,0;11,0;;;2,0;;2,0;;;1,0;;;;;;;;;;;2,0;2,0;;;1,0;1,0;17,0;;5,0;;;96,0;1,0;3,0;4,0;;;7,0;;;6,0;;;;;1,0;;1,0;2,0;4,0;25,0;;15,0;7,0;;;5,0;;1,0;1,0;6,0;;;;4,0;;1,0;2,0;;;1,0;2,0;10,0;1,0;;2,0;;;;1,0;;2,0;;2,0;2,0;;;;;2,0;;;;;13,0;13,0;;;;;1,0;7,0;;;5,0;2,0;;7,0;6,0;;;;;11,0;3,0;;4,0;1,0;;;3,0;18,0;;7,0;1,0;;3,0;;;1,0;15,0;;;;;;;1,0;1,0;;22,0;1,0;;;;2,0;29,0;;2,0;3,0;76,0;17,0;;3,0;;;11,0;2,0;;;;;;4,0;118,0;;9,0;15,0;4,0;24,0;8,0;;;;;3,0;3,0;;7,0;;13,0;19,0;;21,0;;7,0;;7,0;1,0;;;3,0;1,0;2,0;;8,0;;19,0;1,0;;10,0;10,0;10,0;39,0;;;;;3,0;;;;;4,0;3,0;5,0;;;3,0;;;;;;;;3,0;1,0;1,0;1,0;2,0;2,0;1,0;;2,0;1,0;2,0;10,0;;;2,0;;;2,0;1,0;;;11,0;1,0;;1,0;21,0;;;;1,0;;2,0;27,0;;22,0;2,0;3,0;4,0;3,0;1,0;;3,0;2,0;;;2,0;;1,0;1,0;3,0;;5,0;11,0;;3,0;3,0;;4,0;;4,0;;;1,0;1,0;;;;;3,0;;;;5,0;;1,0;1,0;2,0;4,0;;1,0;;1,0;;;1,0;;1,0;;;;12,0;2,0;;;;5,0;6,0;;2,0;;;;;;;;;;;;;;;;;;;2,0;2,0;;;;;;;;;;;;;;;;;;1,0;;;;;;;;;;;4,0;;;;;;;;;;;;1,0;3,0;;1,0;;;;;2,0;;;;;;;;;;;2,0;;;;;;;;;;2,0;;;4,0;;4,0;;;;;;2,0;;;;;;;;;2,0;;;;1,0;1,0;;;;;;;;;;;;;;;;;;;;;10,0;;;;;;;;;;1,0;;;;;;;;;2,0;;1,0;;;;1,0;;2,0;2,0;1,0;;1,0;1,0;;;;;;2,0;4,0;;1,0;;2,0;2,0;;;;;;2,0;;;;;11,0;2,0;;;;;;;;;;3,0;;;;3,0;1,0;;;;;;;2,0;;6,0;;;4,0;;2,0;3,0;;;;;;;;;5,0;3,0;;5,0;;5,0;;;;6,0;;;;;;5,0;;;;;;;;;;7,0;;;;;;;;;;;;1,0;4,0;;;;;2,0;;;;;1,0;;13,0;2,0;;;;;;;1,0;;8,0;;1,0;;;;7,0;;;;4,0;;;;;10,0;;2,0;;;;;;;;;;3,0;;2,0;;;1,0;4,0;3,0;;;;2,0;;;;;1,0;;2,0;;;10,0;;;;;1,0;;;;;;;;;;;;;;;;;9,0;;;;;;1,0;;;;;;;;;;;;;;;;;;;;;;;;;;;;;;;;;;;;;;;;;;;;;;;;;;;;;;2,0;;;;;;;3,0;1,0;;;;1,0;;;;;1,0;;;;;;;5,0;;;;;;;;;;;;;;;;;;;;;;;;;;;;2,0;;;3,0;;1,0;;;;;;;;;;;;;;;;;;;;;;;2,0;;1,0;;1,0;;;;;;;1,0;;;;;;;;;4,0;;;;;;;;;;;;;;;1,0;;;;;;;;;;;;;;;;;;1,0;;10,0;;;;;;;;;;;;;;;1,0;1,0;;;;;;;;;;;;;;;;;;;;;;;;;;;2,0;;;;;;;;;;;;;;;;;;;;2,0;;;;1,0;;;;;;;;;;;;;;;;;;;;;;;;;;;;;;;;;11,0;;;;;;;;;;2,0;;;
embed;;;;;4,0;;;10,0;2,0;10,0;;3,0;;;;;;3,0;4,0;7,0;1,0;;;;1,0;;;9,0;;5,0;;;37,0;;28,0;;;;;1,0;;;3,0;1,0;;;;;;;;;;5,0;;17,0;10,0;;;10,0;;;10,0;;;;;;;;1,0;;;1,0;;;;;1,0;;;3,0;14,0;;;;1,0;;;;4,0;;;8,0;;4,0;;2,0;4,0;4,0;4,0;;1,0;;;;;10,0;;;2,0;1,0;;1,0;1,0;;;;5,0;14,0;;;;2,0;;;;;;2,0;;;;;2,0;;;;;;1,0;;1,0;;2,0;;5,0;5,0;;2,0;;;;;;1,0;1,0;16,0;;;;;;;;6,0;;;;1,0;5,0;2,0;21,0;1,0;;;1,0;;;;1,0;8,0;1,0;1,0;2,0;;;6,0;;6,0;;1,0;;;;;;;;;;1,0;2,0;1,0;;;;;;2,0;;;2,0;1,0;1,0;2,0;;;;2,0;;;;;5,0;;;;;;;;3,0;;;;;;1,0;;;;3,0;3,0;1,0;1,0;;;;;;;4,0;2,0;;;1,0;;;;2,0;;;1,0;;;;;1,0;;2,0;1,0;2,0;;1,0;;;;;6,0;;3,0;;;1,0;;;3,0;;;;;;;;;1,0;;;;;;;;;;;;1,0;;;;;;;;;;;;;;;;;;;2,0;;;1,0;;;;;;;;;;;;;;1,0;;;;;;;;1,0;;;;;;1,0;;;;;;;;;;;;;;;;2,0;3,0;;;;;;;;9,0;;;;;2,0;;;;;;2,0;;;;;;;;;;;;;1,0;;;;;;2,0;;1,0;;;;;;3,0;;1,0;;;;;;;;;1,0;;;;;;;;;;;;;;1,0;;;;1,0;4,0;;1,0;;;;;;4,0;;;;;1,0;;;;;;;5,0;;;;;2,0;;;;;;;;;2,0;;;;;;;;;2,0;;;;;;;;;;;;;;;;;;;5,0;;;3,0;;;;;;;;;;1,0;;;;3,0;;;;5,0;;;;;;;1,0;;1,0;2,0;;;1,0;;;;13,0;;;;;;;;;1,0;;;;;;;;;;;;;;;;;1,0;2,0;;;;;;1,0;4,0;;;;;;;;;;;;;;;;;;;;;;;;;;8,0;;;;;;;1,0;;;;;;;;1,0;;;;;5,0;;1,0;;;;;;;;;3,0;5,0;;;;;;1,0;;3,0;;;;;;;;;;;;;;;;;2,0;;;;;;;;;;;;;;;;;;;;;;;;;;;;;;;;;;;;;;2,0;;;3,0;;;;;;;;;;;;;1,0;;;;;;;;;;;;;;;;;;;;;;;;;;;;;;;;;;;;;;;;;;;;;;;;;;1,0;;;;;5,0;;;;;;;;;;;1,0;;;;;;;;;5,0;;;;;;;;;;;;;;;;;;;;;;;;;;;;;;;;;;;;;;;;;;;;;;;;;;;;;;;;;;;;;;;1,0;;;2,0;;;;;;;;;;;;;;;;;;;;;;1,0;;;;;;;;;;;2,0;;;;;;;;;;;;;;;;;;2,0;;;;;;;;;;;;;;;;;;;;;;;;;;;;1,0;2,0;;;;;;13,0;4,0;;;;7,0;;;;;;;;;;;;;;;;;;;;;;;;;;;;;;;;;;;;;;;;;;;;;
enclose;;;;;3,0;;;9,0;;6,0;1,0;4,0;;;;;;;1,0;;;1,0;;12,0;;;;2,0;1,0;5,0;;11,0;10,0;1,0;4,0;;;;;7,0;;;;9,0;;;;5,0;;;;12,0;;2,0;2,0;71,0;14,0;;;21,0;;;5,0;;;;1,0;;;4,0;3,0;;;;1,0;;;1,0;2,0;1,0;;7,0;1,0;;;;;;4,0;1,0;11,0;;;;;51,0;;1,0;;;29,0;6,0;6,0;;;;;35,0;;;5,0;3,0;5,0;6,0;1,0;;2,0;;2,0;10,0;;;;2,0;;;6,0;;;2,0;8,0;;;;1,0;;4,0;;;;;;;14,0;5,0;;9,0;5,0;;;;;1,0;;;5,0;2,0;50,0;;5,0;;12,0;;1,0;;1,0;;7,0;;;9,0;;19,0;5,0;;3,0;1,0;11,0;;;9,0;8,0;;;;6,0;5,0;4,0;;8,0;;;1,0;10,0;;;;1,0;;;;20,0;7,0;3,0;1,0;;;1,0;;4,0;;;1,0;;1,0;;;;;;;;;;7,0;1,0;7,0;;;;3,0;;;;;;20,0;;19,0;;6,0;;;;;5,0;;6,0;;;;;;;;;;11,0;;;1,0;;1,0;;;;4,0;;;;;2,0;;;;1,0;;;;;;;;;1,0;;;1,0;1,0;1,0;;;;;;;2,0;;;;;;1,0;1,0;2,0;;;1,0;;1,0;;;;;;;;;;4,0;;3,0;;;;8,0;;;;;1,0;;;;;;;2,0;;;12,0;1,0;;;;;;;8,0;1,0;4,0;;;;;;;;;;;;;;;;;;;;;;;;1,0;6,0;;;;1,0;;;;;;;;;;5,0;;;;1,0;3,0;;1,0;;;;;2,0;;;;;;;;;;1,0;3,0;;;;;;;;;;;;;;;;;;;;;;;;;;;6,0;;;;;14,0;;2,0;;;;;;;1,0;;;;;;;;;;;;;1,0;;;;;4,0;;;;;1,0;;;;2,0;;;;;;;;;;;3,0;;;;11,0;;;11,0;;;;;;;1,0;;;11,0;;1,0;;;;;;2,0;;;;;1,0;;;;;;;;;;;;;;;;;;;;;;;1,0;1,0;;;;1,0;;;;;1,0;;;;;;;2,0;;;;;;;;;;;;;1,0;;;;;;;;;;;2,0;;;;;;3,0;;;;;;;;;;;;;;;;;;;;1,0;;;;;;;;;;;;;;5,0;;;;;;1,0;;;;;;2,0;;;;;;;;;;;;;;7,0;;;1,0;;;;;;;;;;;2,0;;;;;;;;;;;;;;;;;;;;;;;;;;;1,0;4,0;1,0;;;;;;;;;;;;;;;;;;;;;;;1,0;;13,0;;;;;;;;;;;;;;;;;;;;;;;;;;;;;;;;;;;;;;;;;;;;;;;2,0;2,0;;;;;2,0;;;5,0;;;;;;1,0;;;;1,0;6,0;;;;;;;;;;;1,0;;;;;;;;;6,0;;;;;1,0;;;;;;;;;;;;;;;;;;;;2,0;;;;;;;;;;;2,0;;;;;;;;;;;;;;7,0;;;;;;;;;;4,0;1,0;;2,0;;;;;;1,0;;;;;;;;;;;;;;;;;;;;;;;;;;;;;;;2,0;;;;;;;;;;;2,0;;;;;;;;;;;;;;;;;;;;;;;;;;;;;;;;;1,0;2,0;;;;;;;;;;;;;;;1,0;;;;;;;;;;;;;;;;;1,0;;;;;;;;;;;;;;;;
enclosure;;;;;65,0;;5,0;2,0;;;5,0;;;;;3,0;;;8,0;;;7,0;;1,0;;;1,0;2,0;2,0;;;2,0;23,0;;6,0;;;;;;3,0;1,0;;;3,0;;;3,0;;;1,0;;;;1,0;5,0;27,0;;;39,0;;;36,0;;;12,0;;;1,0;1,0;12,0;;;;;;;;29,0;9,0;10,0;;;;;2,0;;;;1,0;36,0;;;9,0;;1,0;;13,0;1,0;3,0;29,0;30,0;;1,0;;;;5,0;;;2,0;;3,0;5,0;12,0;;;;7,0;6,0;;;4,0;7,0;1,0;;22,0;6,0;;6,0;21,0;;;;5,0;;9,0;;;;;2,0;16,0;;1,0;2,0;38,0;6,0;;;;;2,0;1,0;3,0;;1,0;42,0;;6,0;;;3,0;10,0;;2,0;5,0;14,0;;1,0;1,0;;21,0;17,0;3,0;21,0;7,0;;;;3,0;14,0;2,0;;;;8,0;17,0;;17,0;;;;6,0;1,0;;;;;4,0;1,0;4,0;19,0;28,0;;;;;1,0;13,0;;;;;5,0;;2,0;17,0;;4,0;;;;;25,0;1,0;4,0;;;;;;;1,0;;1,0;;2,0;25,0;;;;;4,0;6,0;;;4,0;;;;;2,0;2,0;;1,0;1,0;6,0;;;;;5,0;1,0;5,0;;4,0;3,0;;;;4,0;;;5,0;1,0;;;;4,0;;;;;;7,0;1,0;;2,0;;;;;;;;2,0;1,0;;;;2,0;1,0;;;2,0;;3,0;;1,0;;;2,0;;1,0;;1,0;4,0;;51,0;;4,0;;2,0;;11,0;;;;;;2,0;1,0;;;;;;;;;;;;;;;7,0;;4,0;16,0;;;3,0;;;;;1,0;;;;;;8,0;;;;2,0;;;;;;;;;;;;;;;;;;;;;2,0;;;3,0;;1,0;3,0;;;;;;6,0;;;;;;;;1,0;2,0;6,0;7,0;;;;;;;;;;;;;;;;;;;;;;;;;;;;;;;;7,0;;;2,0;;;1,0;;5,0;;2,0;;5,0;;;;;;;;;;1,0;5,0;;;;;3,0;;;;3,0;;;;;;;;;1,0;;;;;;3,0;2,0;4,0;7,0;12,0;;;;;;;;;7,0;1,0;;;;;6,0;;;;2,0;2,0;7,0;;;;;;;;;;6,0;2,0;;8,0;1,0;;;;;;;;;;;;;;9,0;;;2,0;;;;;2,0;;;;1,0;;1,0;16,0;1,0;;;;;;1,0;;;;;4,0;;;3,0;;1,0;;;;;;;;;2,0;;;;;4,0;;;;3,0;6,0;2,0;1,0;;;;;;;2,0;;;;;;;3,0;2,0;;;;;;;;;;;3,0;;6,0;;12,0;1,0;;;2,0;;;;;;;;4,0;;;;;2,0;;;;;13,0;;;;;7,0;1,0;2,0;;;;;;;;2,0;5,0;;5,0;2,0;;;;;1,0;;;;2,0;1,0;;;;;;;;;;;;;;;;;;;3,0;;;;;;;;;;;;;;1,0;;;;;;1,0;;;;;;;;;2,0;;18,0;;;;;;;13,0;;;;;;;;;;;1,0;;;;;1,0;;;;;;;;2,0;;;;;;;;1,0;;;;;;;2,0;28,0;;;;;;;;;;;;;;;;;;;1,0;;;7,0;;;;;;;;;;;;;;1,0;;;;;2,0;;;;;;;;;;;;;;;;;;;;;;;;2,0;;;;;;;;;;;;;2,0;;;4,0;;;;;;;;;;;;7,0;;;;;;;;;;;;;;;;;;;;;;;;;;;;;;;;;;7,0;;;;;;;;;;;;;7,0;;2,0;;;;;;;;;;;;;;;;;;;;;;2,0;;;;;;;;;;;1,0;;;;;1,0;;;;;;;;;;;;;;;;;;;;;;;;;;;;;;;;;;;;;;;;;;;;
endoscope;;;;;19,0;;4,0;;;6,0;;;;;2,0;1,0;;;2,0;;;1,0;;;;;;1,0;1,0;;;8,0;16,0;;6,0;;2,0;;;1,0;;;;1,0;;;;;;;;5,0;;;;7,0;4,0;;;;;;5,0;;;;;1,0;;;5,0;;;;;;;2,0;5,0;1,0;1,0;1,0;4,0;;;;;;;;1,0;;;1,0;;;;;;;;41,0;;;;;;5,0;;;4,0;;;10,0;6,0;;;;;6,0;;;1,0;;;;1,0;3,0;;8,0;;;;;;;4,0;;;1,0;;;1,0;;;;;;;;;1,0;;;;;;6,0;4,0;4,0;;;;2,0;1,0;;;5,0;;;2,0;;4,0;2,0;2,0;;;;;;;;;;14,0;;;;;8,0;;;;;;;;;3,0;5,0;;;;;;;;;;6,0;;;;;;1,0;2,0;;;2,0;;;6,0;2,0;;;3,0;;2,0;;1,0;;;;1,0;;;;;;1,0;1,0;1,0;;;;9,0;;;;;3,0;;7,0;;;;;;;;;;;;;1,0;;;;;;;5,0;6,0;1,0;;;;2,0;2,0;;;4,0;;;8,0;;;;;;;;;;;;;;;;;;;;;;;;;3,0;;;;;5,0;;;;;;12,0;1,0;;1,0;;;1,0;;;;;;;;1,0;;;;;;;;;;;;;;;;;;;;;;;1,0;;;;;;;;;;;;;;;1,0;;;;;3,0;;;;;;;;;;1,0;;;;;;;;;;;;;;;;;;1,0;;;1,0;;;;1,0;;;;;;;;;;;;;;;;;;;;;;;;;3,0;;;1,0;;;;;;;;;;;;;;;;;;;;;;;;;;;;;;;;;;;;;;;;;;;1,0;1,0;;;;;;;;16,0;6,0;;;;;4,0;;;;;;;1,0;1,0;3,0;2,0;;;;;2,0;;;;;6,0;18,0;;;;;8,0;;;;;;;;;;;2,0;;;;;;;;;1,0;;;;;;;1,0;;;;;;;;;;;13,0;;;;;;;;;;;12,0;2,0;1,0;;;;;2,0;;;;;;;;4,0;;;;;;;;;;;;;10,0;1,0;;;;;;;;;;;;;;;;;6,0;;;;;;;;;;1,0;;;;;;;;;;;;;;;;;;;;;;;;1,0;;;;;;;;1,0;;;;;;;;;;;;;;;;;;;;;1,0;;;;;;;1,0;;;;;;;;;;;;;;;;;;;;;;;;;;;;2,0;;;;;;;;;;;;;;;;;;;1,0;;;;;;;;;;;;;;2,0;;;;4,0;;;;;1,0;;;;;;;;;;1,0;;;;8,0;;;;2,0;;;;;;;;;;;;;;;;;;;;;;;;;;;;;;;;;;;;;;;;;;;;;;;;;2,0;;;;;;;;;;;;;;;;;;;;;;;;;;;;;;;;1,0;;;;1,0;;;;;;;;;;;;;;;;;;;;2,0;;;;;;;1,0;;;;;;;;;;;;;;;;;;;;3,0;1,0;;;;;;;;;;;;;;;1,0;;;;;;;;;;1,0;;1,0;;;;;;;;;;;;;;3,0;;;;;;;;;;;;;;;;;;2,0;;;;;;;;;;;;;;;;;;;;;;;;;;;;
engine;;;;;4,0;;;7,0;1,0;;;;;;1,0;;;;2,0;4,0;2,0;4,0;;;;;;1,0;;5,0;;12,0;1,0;;3,0;;;;;2,0;;3,0;1,0;2,0;2,0;;;2,0;;;1,0;5,0;;;;22,0;1,0;;1,0;;;2,0;8,0;2,0;;1,0;1,0;;3,0;4,0;3,0;;;;;;;1,0;5,0;;;8,0;2,0;2,0;;;;;;;1,0;;;;;;;;;;;4,0;;;;;;;;;;;;;;;;;;;;;;;;;7,0;;;1,0;2,0;;;;;;;;;;;;;1,0;2,0;;;8,0;;;;;;;;;;;;;1,0;1,0;;;;;;1,0;;;1,0;;1,0;1,0;;;;;;;;;;;;;;6,0;;;;;;2,0;;;;;;;;;;10,0;;;;;;1,0;;1,0;;;;1,0;;;;;;2,0;;;;;;;;;;2,0;;;;;;2,0;;;;;2,0;;;;;;;;;3,0;;1,0;;2,0;;;;;;;;;;;;;;;;1,0;;;;3,0;1,0;;;1,0;;;;1,0;;1,0;;5,0;;;;;;;;;;;;;;;1,0;1,0;;;;;;;;;;;;;;;;;;;;;;;;;;;2,0;;;;;;;;;;;1,0;;;;;1,0;;;1,0;;4,0;1,0;;;;;;;;;;;2,0;;;;;;;;;;;;;4,0;;;;1,0;;2,0;5,0;;;1,0;;;;;;;;;2,0;;;;;9,0;;;;1,0;2,0;1,0;4,0;2,0;;;;;;;7,0;;;1,0;;;;;1,0;2,0;1,0;;;;;;;;;1,0;;;;;;;;;;;;;;;;;1,0;;;;1,0;;;1,0;1,0;;2,0;;;;11,0;;1,0;;;;3,0;;;;;;;7,0;2,0;;;;1,0;;;;;;1,0;;;;;11,0;6,0;;;;;;;;;;;;;;;;;;;1,0;;;;2,0;;;;;;;;;;;;;;;;1,0;;;;;;;;;;1,0;;;2,0;;;;;;;1,0;;;;;;;;;;;;;;;;;;;;;;;4,0;;;3,0;4,0;;;;;;;;1,0;;;;;;;;3,0;;1,0;;;;;;;;;;;;;;;;;;;;;;;;;;;;;;;;;;;;;;;1,0;;;;;1,0;;;;;;;1,0;;;;;;;;;;;;1,0;;;;;;;;;;;;;;;;;;;;;;;;;;;;;;;;;;;;;;1,0;;;1,0;;;;;;;;;;;2,0;;;;;1,0;;;;;;;3,0;;7,0;;;;;;;2,0;;;6,0;;;;;;;;;;;;;;;;;6,0;8,0;;;;;;;;;;;;;;;;;;;;;;;;1,0;;;;;;2,0;;;;;;3,0;1,0;;;;;;;2,0;;;;;;;10,0;;;;;;2,0;;;;;;;;4,0;;;1,0;;;;;;1,0;;;;;;1,0;;;;;;;;;;;;;1,0;;;;;;;;;;;;;;;;;;;;;;;;;;1,0;;;;;;;;;;;;;;;;;;;1,0;;;;;;;;;;;;;1,0;;;;;;;;;;;;;;;;;;;;;;;;;;;;;;;;;;;;;;;;;;1,0;;;;;;;;;;;;;;;;;;;;;;;;;;;;;;;;;;;;;;;;;;;;;;;;;;
enhance;;;;;4,0;;;;8,0;19,0;;4,0;;;6,0;1,0;;;27,0;1,0;;7,0;;1,0;;;;13,0;;3,0;7,0;;20,0;11,0;25,0;2,0;3,0;;1,0;9,0;1,0;;;;;;;;5,0;5,0;4,0;15,0;;;1,0;132,0;8,0;;;17,0;1,0;;26,0;;;;;;;3,0;1,0;4,0;;;;;;2,0;10,0;1,0;;8,0;8,0;5,0;1,0;;;;;3,0;3,0;;;10,0;5,0;8,0;;;2,0;;2,0;13,0;;1,0;;;2,0;1,0;;;;;4,0;14,0;;2,0;;5,0;;3,0;;;;1,0;;;8,0;;9,0;;;;;;;4,0;;;;;;;2,0;;19,0;;3,0;4,0;;1,0;18,0;;2,0;1,0;2,0;;;3,0;6,0;2,0;;;;;;1,0;2,0;6,0;;;1,0;1,0;7,0;;;2,0;;4,0;;;2,0;;1,0;;;;;4,0;;5,0;1,0;;;;;;;;;;;;;;;;;;;;;;;;;1,0;;;;;;2,0;;;;;;;1,0;;;;;;3,0;;;1,0;;;;;;;;1,0;;;;;;;;;;;;;;;;;17,0;;;;;;;;;2,0;;;1,0;;;;;;;;;;;;5,0;9,0;1,0;;;;;1,0;;;;3,0;2,0;;;1,0;;;;;;;;;2,0;1,0;;;;;;;;1,0;;;;;;2,0;;;;;;;;;;;;;;;3,0;;;1,0;1,0;;;;;;;;;;;2,0;2,0;;;;;10,0;;;5,0;;;1,0;;;;;;;;4,0;;8,0;;;;;;;;;;;;1,0;;3,0;;2,0;5,0;1,0;;1,0;;;2,0;;1,0;10,0;;;19,0;2,0;;;3,0;;;1,0;;;6,0;;7,0;;1,0;;;12,0;1,0;;3,0;;20,0;7,0;1,0;;;1,0;;;;;;;;;;;;1,0;1,0;1,0;;1,0;;;4,0;3,0;;;;;;;;;;;;1,0;7,0;2,0;1,0;;;1,0;;;;;;;2,0;;2,0;;;;;;;;;;;;;;2,0;8,0;5,0;;;;1,0;;2,0;;2,0;;;;;;;;;2,0;;;;;;;;;;;;;2,0;;;1,0;;;;;;;;;;;;;;;1,0;;;;;;;1,0;;1,0;;;1,0;;;8,0;1,0;;;;;;2,0;;;;;3,0;;1,0;;;;1,0;4,0;;;;;;;;;;2,0;;;;;;1,0;;;;;;;;;;1,0;;;;;;;;;;1,0;;;;;;;;2,0;2,0;;;;;;;;;;3,0;1,0;;2,0;;;;;;;4,0;;;;;;;4,0;;;;;;;;;1,0;;;;;;;;;;;;;1,0;;4,0;;;;;;;;1,0;;;;;;;;;;;;;;;4,0;;;;;;;2,0;;;;;4,0;;1,0;;;1,0;;;;;;;1,0;;;;;;;;;;;2,0;;;;;;;;;;;;;;;;;;;;;;;1,0;;;;;;;;;;;2,0;;;;;;;3,0;;;;1,0;;1,0;;1,0;;;;;;;;;;;;2,0;;;;;;;;;;;;;;;;;;;;2,0;;;;;;;;;1,0;;;;1,0;;;;;6,0;;;;;;;;;;;;;;;;;;;;;;;;;;;1,0;;;;;;;;;;;;2,0;;;;;;;1,0;;;;;;;;;;;;;;;;;;;;;;;1,0;;;;;;;;;6,0;;;;;;2,0;;1,0;;;;2,0;;;;4,0;;;;;;;;;;;;;;;;;;1,0;;;;;;;;2,0;;;;;;;;;;1,0;;;;;3,0;;;;;;;;;;;;;;;;;;;;;;;;;;7,0;;;;;;;
entry;;;;;6,0;;4,0;3,0;;16,0;;;;;2,0;;;;;;;4,0;;;;1,0;;27,0;;;;5,0;20,0;1,0;;;1,0;;;;;;;;1,0;;;;;;;;;;;7,0;17,0;;;2,0;;;15,0;;;;5,0;;;;1,0;;1,0;;;;;;3,0;;4,0;;;;;;2,0;;;5,0;6,0;;;1,0;;;;;7,0;;11,0;7,0;;;;;;3,0;;;;2,0;;;;;;;;2,0;;3,0;;3,0;;;5,0;;;;;;;;;1,0;;;;1,0;1,0;;15,0;1,0;;;6,0;6,0;;;;;10,0;1,0;;2,0;;2,0;;;;1,0;;;3,0;2,0;;18,0;;;;2,0;1,0;;;4,0;1,0;;;;;;2,0;;;;;10,0;;3,0;;;;;;;;;;;;1,0;;5,0;;1,0;;;;;;;;;;4,0;;;4,0;;;;;;;;1,0;;;;;;;5,0;;;;1,0;5,0;;8,0;;;;;;1,0;;;;;;;;;;;4,0;;;;;;;;;6,0;;1,0;;;;;;5,0;1,0;2,0;;2,0;;;;;;;;;3,0;;;;;;;;;;2,0;;;;;;;;;;;;;;;;;;;;;;1,0;;;;;;2,0;;;;;;;;;;;;;;;;2,0;10,0;;;;;;9,0;;;;2,0;;;2,0;;;;;;;19,0;1,0;;;;;;;;;;;;;;;;;;;;;;;;;;;;1,0;;24,0;;;;;;;1,0;;1,0;;;;2,0;;;;;3,0;;;1,0;;;;;1,0;14,0;;;1,0;;;;;;;;;;;;;;;;;;;;;;;;;;;1,0;1,0;4,0;;;;1,0;;;;;2,0;;;;;1,0;;3,0;;;;;;;;2,0;;;;1,0;;;2,0;;;;;;2,0;;;;;;1,0;;;1,0;;;;1,0;;;;;;;3,0;;;;1,0;2,0;;;;11,0;;;2,0;;;;;;;;1,0;;;;;2,0;;;1,0;;;;;;;;;;;;;;11,0;1,0;;;;1,0;;;;4,0;;;;2,0;7,0;1,0;;;2,0;;;;;;;2,0;;;;;;;;;4,0;;;;7,0;;2,0;;;;;;;;;;;2,0;;;;;;;;;;;;1,0;;;;;;;;;;;;;;;;;;;;;;;;;;;;;;;1,0;;;;;;;;;;;;;;1,0;4,0;;;;1,0;;;;;;;;;2,0;;;;;;;;;;;;;;;;;;;;;;;;1,0;;;;;;;;;;;;;;;;;;;;;;;;;;;;;;;;;;;;;;;;;;;;;;;;;;;;;;;;2,0;;;;;;;;;;;;;;;;;;;;;;;;2,0;;;1,0;;;;;;1,0;;;;;;1,0;;3,0;;;;;;;1,0;;;;;;;;;;;;;;;;;2,0;;;;;;;;;1,0;1,0;;;;;;;;;;;1,0;;;;;;;;;;;;;;;;;;;;;;;;;;;;;;;;;;;2,0;13,0;;;;;;;;;;;;;1,0;;;;;;;;;;;;2,0;;;;;;;;;;;;;;;;1,0;;;;;;;;;;;;;;;;;;;;;;;;;;;6,0;1,0;;;;;;;;;;6,0;;;;;;;;;;;;;;;;;;;;;;;;;3,0;;;;1,0;;;1,0;;;;4,0;;;;;;;;;
environment;;;;;13,0;;2,0;21,0;1,0;29,0;1,0;23,0;1,0;;40,0;2,0;2,0;3,0;1,0;20,0;5,0;11,0;;;1,0;;;5,0;2,0;30,0;1,0;21,0;29,0;;15,0;;3,0;11,0;1,0;27,0;1,0;;;6,0;;;;1,0;2,0;8,0;5,0;1,0;;2,0;;68,0;23,0;;1,0;5,0;;1,0;45,0;;13,0;8,0;10,0;;8,0;3,0;3,0;;2,0;;;2,0;;40,0;25,0;1,0;;;8,0;;;;3,0;1,0;5,0;16,0;7,0;;1,0;4,0;;3,0;;1,0;;;;30,0;;;2,0;;8,0;;;2,0;2,0;1,0;2,0;6,0;3,0;;;;;;;;3,0;;;;8,0;;;2,0;2,0;1,0;;;3,0;1,0;2,0;;;;;;17,0;1,0;;;1,0;7,0;;;;;;;;;;3,0;4,0;10,0;;;;2,0;;;4,0;69,0;;;;4,0;13,0;1,0;9,0;;;1,0;;;1,0;4,0;;;;;2,0;12,0;;3,0;;;5,0;4,0;;1,0;;;;;;1,0;;1,0;;1,0;2,0;4,0;1,0;;1,0;;;;;5,0;2,0;2,0;;;;34,0;;;1,0;;6,0;;1,0;;;;;;13,0;;;;3,0;;;;2,0;;;;;;;;;1,0;;;;;;23,0;7,0;;2,0;3,0;;;;;3,0;;;;;8,0;;;;;;;;1,0;;;;1,0;;19,0;5,0;79,0;19,0;;;;2,0;;;;;3,0;;;;;4,0;;;;;17,0;;;12,0;3,0;;;;;;;;;;6,0;;;;36,0;;;;3,0;37,0;;;1,0;;;;;;;;5,0;2,0;7,0;;;;1,0;;11,0;;;;;;;;;;;11,0;;;;1,0;;1,0;6,0;;6,0;1,0;;;6,0;3,0;1,0;3,0;;;;1,0;;;;;;1,0;2,0;;1,0;;5,0;;;;;;12,0;;;2,0;;1,0;1,0;;;134,0;2,0;5,0;4,0;;3,0;;;;19,0;;;3,0;;6,0;;;;;;;;;5,0;9,0;2,0;;;;;1,0;1,0;2,0;;;;;;;3,0;;;;;;;14,0;5,0;;;;;;;2,0;;;;;13,0;3,0;1,0;3,0;6,0;;3,0;;;;;;;;;;4,0;;2,0;;1,0;4,0;5,0;;3,0;;;9,0;;28,0;59,0;;;;;;;;;1,0;;;;14,0;;;;;7,0;;;;1,0;;;;;;;;;1,0;;;;2,0;11,0;;;;;;;;;;2,0;;2,0;;;;;;2,0;1,0;;;;3,0;;1,0;;;;1,0;;;;;;1,0;;;;;4,0;;;;;;;;1,0;;;45,0;;;;;;;6,0;;;;;;;2,0;;4,0;;;;2,0;;;;;;;;;;3,0;;;;1,0;;;;;;;;;;;;;;;;;;;;3,0;;;;;1,0;;;;;;4,0;;;;6,0;;;;;;;;1,0;6,0;;;;;1,0;;;;;;;;;;;;;;;;;;5,0;2,0;;;;;;;;;;;;;;;;1,0;;;;;;;;;4,0;;;;;1,0;;;;;2,0;3,0;5,0;;;;;;;;12,0;;;;;;1,0;;;1,0;2,0;2,0;;;;11,0;1,0;;;;;;1,0;;1,0;;;;;;1,0;;;1,0;;;;;;4,0;;1,0;;;;;;2,0;1,0;;3,0;;5,0;;3,0;;1,0;;;;;;;;37,0;;;2,0;;;;5,0;;;;2,0;;1,0;2,0;;;;;;6,0;;;6,0;;;;;;;;;;;;1,0;;;;5,0;;;;;;;;;;8,0;;;4,0;;;;;;;;;;9,0;1,0;;;;;;;;;;;;;;1,0;;;;;;;;;;;;;;;;;;;;;;;;;;;6,0;;;;;;;;37,0;;11,0;1,0;;;;;;;2,0;;;;;;;;;;;;;;;;1,0;;;;;2,0;;;;;;;;;;;;;;;;;;1,0;;;;;;;1,0;;;2,0;;;1,0;2,0;;;;;;;;;;;;;2,0;;;;;;;;;;;;;1,0;;;;;
equip;;;;;16,0;;1,0;2,0;;1,0;;;;;1,0;;;;4,0;;;2,0;;;;;;3,0;;1,0;;;45,0;;26,0;12,0;;;1,0;14,0;;;1,0;1,0;;;;;;;16,0;3,0;;1,0;;20,0;8,0;;;23,0;;;12,0;;;1,0;5,0;;;9,0;14,0;;;;;4,0;;1,0;3,0;1,0;;4,0;;;;;2,0;;;2,0;5,0;;;;;3,0;;;;2,0;7,0;22,0;;;;;;24,0;;;;2,0;8,0;8,0;;;2,0;;;5,0;;;;2,0;1,0;;;2,0;;1,0;;;;;;;14,0;;;;;;;;2,0;;;3,0;;;;;;;;;;4,0;;20,0;1,0;;;;;;;4,0;;;12,0;;11,0;1,0;;;;1,0;;;;;;;1,0;2,0;2,0;11,0;;3,0;;1,0;;3,0;;1,0;;;;;;;;4,0;;;;;2,0;1,0;;;1,0;;1,0;;;;;;;1,0;4,0;;;;;;;;;;1,0;;;;;;;2,0;3,0;;;;;2,0;1,0;;;;;;;3,0;;;;;;;;;1,0;;1,0;;1,0;;;;;;;;;;;;;;;1,0;;;;;;4,0;;;;;;4,0;;;4,0;9,0;;;13,0;;5,0;3,0;1,0;1,0;;1,0;;;;;1,0;;;;;;;;;;;;;1,0;;3,0;1,0;;;;;1,0;;;;;;;;;;;1,0;;;1,0;;1,0;;1,0;;;;;;;1,0;;;;1,0;;;;;;;;;;;1,0;;;2,0;;;;;1,0;;4,0;;;;;;;;;;;3,0;;;;1,0;;;;2,0;;;;;2,0;;;;;;;;;2,0;;;;2,0;;;12,0;1,0;;;;;;;;;;;;;;;;2,0;;;;;;5,0;;;;;;;;;;;;;;;;;;;3,0;;;;;;;;;;;;;;;;;;;;;;;;;;1,0;;;3,0;;1,0;;;;;1,0;;;2,0;;;;;;;;;;1,0;;;;;;;;;;;;;1,0;;;2,0;;;;;;2,0;;1,0;;;;;;;;;;;;;4,0;;;;;;;;;14,0;;;;;;;;;;;;;;;;;2,0;;;;;2,0;;1,0;21,0;;;;;1,0;;;2,0;;;;;;;8,0;;;;;;;;;;;;;;;;;;1,0;;;;;;1,0;;;;;;;3,0;;;;;;;;;;;1,0;;;;;;;;;;;9,0;1,0;1,0;;;;;;;;;;;;2,0;;;;;;;;;;;;;;;;;;;;;;;;;;;;;;;;;;;;;;;;;;3,0;;;;;;;;;1,0;;;;;;;;;;;;1,0;;;;;;;;;;;;;;;5,0;;;;;;;;;;;;;;;;;;;;;;;;;;;;;;1,0;;;;;;;;1,0;;16,0;;;;;3,0;;;;;;;;;;;;;9,0;;1,0;;;;;;;;;2,0;;;;;;;;;;;;;;;;;;;;;;;;;;;;;;;;;;;;;;;;;;;;;;;;;;;;;;;;;;5,0;;;;;;;;;;1,0;;;;;;;;;;;;;;;;;;;;;;;;;;;;;;;;;;;;;;;;1,0;;;;;;;;;;;;;;1,0;;;;;;;;;;;;;;;;;;;;;;;;;;;;;;;;;;;;;;;;2,0;;;;;;;;;;;;;;;1,0;;;;;;;;
equipment;;;;;8,0;;;5,0;3,0;3,0;;1,0;;;5,0;;;;4,0;7,0;;15,0;;;;;;11,0;;8,0;15,0;5,0;18,0;;14,0;;;1,0;1,0;2,0;;;;5,0;;;;;1,0;;4,0;2,0;3,0;4,0;1,0;31,0;17,0;;2,0;9,0;1,0;;13,0;;;2,0;8,0;;1,0;20,0;2,0;;;;;4,0;;;7,0;1,0;;9,0;7,0;;;;;;1,0;;2,0;;1,0;16,0;1,0;;;3,0;1,0;;;10,0;;6,0;1,0;;1,0;20,0;;;;;2,0;1,0;4,0;;;;5,0;12,0;;;;3,0;;;3,0;;;9,0;;;;1,0;;1,0;3,0;;;1,0;;2,0;9,0;2,0;1,0;;2,0;1,0;;;;;;;;;;3,0;;7,0;;;1,0;;;;2,0;4,0;1,0;;2,0;;32,0;8,0;;;;1,0;;;;;;1,0;;;2,0;10,0;;11,0;;;;8,0;;;;;;;;;;5,0;;;;;1,0;6,0;16,0;1,0;;;;1,0;10,0;;;;;4,0;;;;4,0;4,0;;1,0;;3,0;;;1,0;;;;;;;2,0;;2,0;3,0;1,0;1,0;;;;2,0;;;;18,0;;1,0;;1,0;1,0;;1,0;3,0;;3,0;;;;;;4,0;1,0;1,0;;;;1,0;5,0;;2,0;4,0;;7,0;;;;6,0;;14,0;4,0;;;;;;4,0;;;5,0;;;12,0;;;;;1,0;;3,0;;3,0;;;;;;;;;1,0;1,0;;3,0;;1,0;;;;5,0;;1,0;3,0;;;;;;;;;;;2,0;;3,0;;;;7,0;;;;1,0;;;;;;;;2,0;;;;;;2,0;;;1,0;;;;;10,0;2,0;;;;;;;;;;;;;;1,0;14,0;;3,0;;;2,0;;8,0;2,0;;;;;1,0;;;;;2,0;;1,0;;13,0;;;1,0;;;;4,0;;;;;76,0;;2,0;;;;;;;;;;;1,0;;;10,0;;;;1,0;;2,0;;;;;;;;;;1,0;;;;2,0;;;3,0;;;15,0;1,0;;;;;11,0;2,0;;;;;1,0;;;;;1,0;;;4,0;;1,0;;1,0;;;4,0;13,0;25,0;2,0;;6,0;;;1,0;;;;1,0;;;;;;;;;7,0;2,0;2,0;10,0;;;;;;;;;;;;;1,0;;;;;;;;;;2,0;;;;1,0;;;1,0;1,0;;;;;;;59,0;1,0;1,0;1,0;;3,0;;;;;;;;;;;;1,0;1,0;;;;;;2,0;;;7,0;;;;2,0;;;;5,0;5,0;;;;2,0;2,0;2,0;4,0;3,0;;;;1,0;;;1,0;;;;;;9,0;;;;;2,0;;;;;;;;;;1,0;;3,0;;;;;;;;1,0;;;;;;;8,0;;;;;;;;;;;;;;;;;;;;;;;;;;;;;;;;;;;;;;;;;;;;;;;1,0;;;;;;;;;;;;;;;;3,0;;;3,0;;7,0;;;;;;;;1,0;;;;;;;;;;;;;;;;1,0;;;;;;;;;;;;;;;;;;;;;;;;;;;;2,0;;;;;;;;;;;;1,0;;;;;;;;3,0;;;;;;;;;;;;;;2,0;;;;;;;1,0;;;;;;;;;14,0;;;;;;;;;;;;2,0;2,0;;1,0;;;;;;;;;;;;1,0;;;;;;;;;;;;;;;;10,0;;;;;;;;;;;;;;;;;;;3,0;;;;;;;;;;;;;;;;2,0;;;;;;;;;;;;;;;;;;;;;;;;;;;;;;;;;;;;;;;3,0;;;;;;;;;;;;;;;;;;;;;;;;;;;;;;;;;;;;;;;;;1,0;;;;;1,0;;;;;;;;;;;;;;3,0;;;;;;;;;
estimation;;;;;7,0;;;56,0;3,0;11,0;1,0;;;;;1,0;;;;3,0;;2,0;;2,0;3,0;;;3,0;;2,0;;2,0;16,0;;7,0;1,0;2,0;;;11,0;18,0;;;;2,0;3,0;1,0;;6,0;;3,0;3,0;;;;63,0;16,0;;3,0;;4,0;;40,0;;4,0;;6,0;;;1,0;;;;;;;;7,0;7,0;;;12,0;11,0;2,0;;;2,0;4,0;;1,0;2,0;;2,0;20,0;;;;;;;;19,0;;;;;;20,0;;;1,0;;1,0;;;;;;;;;;;26,0;;;2,0;;;;;;;;2,0;;;;;;;11,0;;2,0;;;1,0;6,0;;;;;;;;;;;;1,0;;;;;;;;14,0;;;;;2,0;;3,0;;;1,0;;;;;;;;5,0;;1,0;;1,0;;;;5,0;;;;;;;;;;;;;;;;;;;;;2,0;;;;;;;8,0;;;;;;;;;;;;;;;;1,0;4,0;;;;1,0;;;;;;;;2,0;;;2,0;;;;;;;;;;;;;;;;;;;;;;;;;;3,0;;;;;;78,0;1,0;18,0;1,0;;;;;;;;;;;;;;1,0;2,0;;;;;;;7,0;;;;;;;;;;;;;;;8,0;;;;;1,0;;;;;;;1,0;;;;;;1,0;3,0;;1,0;4,0;;1,0;;;;;;;;;;;30,0;4,0;;;1,0;1,0;;;1,0;;;6,0;;1,0;1,0;1,0;6,0;10,0;;;;;;1,0;;;;;;1,0;;1,0;;;;3,0;;1,0;3,0;;7,0;;;;9,0;3,0;;2,0;;;;;;1,0;;;6,0;;;;6,0;;;;6,0;;;;;1,0;2,0;2,0;;;;;;;;;;;;;;;;;;;;;3,0;;;;;;;;;;;;;;;;8,0;;;12,0;;;;;;;;;1,0;;;2,0;;;2,0;;;;;;;;2,0;;;;;;1,0;;;1,0;;;;;;;;;;;;;;;;;;;1,0;;;;6,0;;;;;;;;;;;;;;;;;;;;;;;;;1,0;;24,0;;;1,0;;;2,0;10,0;;;;;;6,0;;;2,0;;;;;;;;;;;;;3,0;1,0;;;;;;;;;;;;;;;;;;;2,0;;;;;;;;;;;;;;;;;;;;;5,0;;;;;;;;;;1,0;1,0;;;;;;;;;;;;;;;;;;;;;;;;;;2,0;;;4,0;;;;;;;;;;;;;;2,0;;;;;1,0;;4,0;;;;;;;;;;;;;;;2,0;;;;;;;;;;37,0;;;;;;;;;;;;;;;;;;;;;1,0;;4,0;;;;;;4,0;;;;;;3,0;;;;;;;;;2,0;;;;;;;;;;;5,0;;;;;;;;1,0;;3,0;;3,0;;;;;;3,0;;;;;;;;;;1,0;;;;;;;;;;;;;;;;;;;;;;;;;;;;;;1,0;;;;;;;;;;;;;;;;1,0;;;;;;;;;;;;;;;;;;;;;2,0;;;;;;;;;;;;;;;;;1,0;;;;;;;;;;;;;;;;;;;;;;;;2,0;;;;;;;;;;;;;;3,0;;;;;;;3,0;;2,0;;;;;;;4,0;;;;;;;;;;;;2,0;;;;;;;;;;;;;2,0;;;;;;;;;;;;;;;;;;;;;;;;;;;;;;;;;;8,0;;;;;;;;;;
execution;;;;;10,0;;;3,0;;1,0;;3,0;;;;;;;;17,0;;10,0;;;5,0;;;12,0;1,0;;;2,0;22,0;;10,0;;3,0;;;3,0;;;;1,0;;;;1,0;;;16,0;7,0;;2,0;;17,0;7,0;;;7,0;;;16,0;;;1,0;1,0;;1,0;13,0;;3,0;2,0;;;;;2,0;7,0;;;10,0;19,0;;;;;;;4,0;;;;7,0;;;;1,0;25,0;;;7,0;;4,0;;;;25,0;;;;;;;;;;;;;;;;;;;2,0;;;;;;;;;;;;;;;2,0;;;;;;3,0;;;;;;;;;;;;9,0;;;;;;;2,0;2,0;;;6,0;;6,0;1,0;1,0;;;5,0;;;;;;;;;;7,0;;;;;;3,0;;;;;;;;;;;;5,0;1,0;;;3,0;;9,0;;;7,0;21,0;;;;;;1,0;;;;;;;;;;;;;;;;2,0;;;;;;;;;;;;;;7,0;;;;;;;;;;9,0;;;1,0;;;;;;;;;;;1,0;;;1,0;;;;;;;8,0;2,0;;5,0;;;;;3,0;;;;3,0;;;2,0;;2,0;;;;;;;;;;;;;;;;;;;;;;;;;;;;3,0;;;;;;;;;;;;;;;;;1,0;;1,0;1,0;18,0;6,0;1,0;;;;;;;;;;;;3,0;;;;1,0;;;;;11,0;5,0;;;;;5,0;1,0;;37,0;;;;;3,0;;;16,0;;;;;;;;;6,0;;;;;;;13,0;3,0;;;;;1,0;;;;;4,0;;;;;;11,0;1,0;2,0;;;3,0;14,0;;;3,0;;;;;;;;;;;1,0;3,0;;;;1,0;;12,0;;;;;;2,0;41,0;;;;3,0;;;;;;;;;8,0;;;;;2,0;;;;;;;1,0;;;4,0;1,0;;;;5,0;;;7,0;5,0;;;;;;3,0;;;;;;;;;;;;8,0;;;;;;2,0;;;;;;;1,0;;;;;;;;;;;;;;;3,0;3,0;;;;;1,0;;;;;;;;;1,0;;;12,0;;;;2,0;;;;;;;;;;;;;;3,0;;;;;3,0;2,0;;;4,0;;;2,0;;;;7,0;;;;;;;;;6,0;;;;;;;1,0;;;;;;;;;;;;;;;;;;;;;;;;1,0;;;;;;;;1,0;;;;;;;;;;;;;;;;;;;;;;;;;3,0;;;;;;;;;;;;;;;;;;1,0;;;;;;;;;;;;;;;;5,0;;;;;;;;;5,0;;1,0;;;;;;;;;;;;;;;;;;;3,0;;2,0;;;;;;1,0;;;;;;;;;;;;;;;;;;;;;1,0;;;;;;;;;;;;;;;;;;;;;1,0;;;;;;1,0;;;;;;;1,0;;;;;;;3,0;;1,0;;;3,0;;;3,0;;;;;;;;;;;;;;;;;;;;;;;;;;;;;;;;;;;;;;;;;;;;11,0;;;;;;;;;;2,0;;;;;;;;;;;1,0;;;;;;;;;;;;;;;;;;;;;;;;;;;;;;;;;;;;;;;;;;;;;;;;;;;;;;;;;;;;;;1,0;;;;;;;2,0;;;;;;;;;;;;;;;;;;;;;;;;;;;;;;;;;;;;;;;;;;;;1,0;;;;;;;;;;;;;
extension;;;;;7,0;;38,0;22,0;;;7,0;;;1,0;2,0;;;;3,0;;1,0;1,0;;;;;;;;2,0;;2,0;6,0;1,0;;;;36,0;;;;;;17,0;;;;4,0;2,0;;1,0;2,0;;2,0;;10,0;21,0;;7,0;49,0;1,0;;6,0;;;1,0;;;;;21,0;;;;;;2,0;;27,0;;;;;;;;1,0;;2,0;;2,0;16,0;;;;2,0;;;;1,0;24,0;5,0;;;;;;8,0;;;1,0;3,0;;;10,0;;1,0;;1,0;4,0;;3,0;;;;;7,0;5,0;;11,0;;;;;;1,0;12,0;;;;;;1,0;1,0;;;11,0;11,0;;;;;6,0;4,0;5,0;15,0;9,0;2,0;3,0;;;;3,0;;;;;10,0;;;92,0;;10,0;13,0;4,0;8,0;3,0;;;;2,0;;;;4,0;;40,0;13,0;;43,0;;3,0;;4,0;;;;;1,0;2,0;;2,0;;16,0;1,0;;;;4,0;3,0;;;;;;24,0;;;;1,0;1,0;1,0;;;4,0;;3,0;;;;;;;4,0;5,0;2,0;;1,0;8,0;3,0;16,0;;;8,0;;;;;;1,0;;;;9,0;;;;5,0;4,0;3,0;;;1,0;;;;24,0;5,0;11,0;;;11,0;;;;;;;;2,0;;;;10,0;2,0;;3,0;4,0;;2,0;2,0;;;1,0;;1,0;;;1,0;;5,0;;1,0;;2,0;1,0;;1,0;12,0;;;;;;5,0;;;;2,0;1,0;;;3,0;3,0;;1,0;;2,0;;;1,0;;4,0;;;;;;;1,0;;;;;;;;;2,0;1,0;6,0;;;;;;;;;;;;;;1,0;;;;;;1,0;;;;;;9,0;;;3,0;;;;;;;;;;;1,0;2,0;;;;;;;;;1,0;;;;;;;;;;;;10,0;4,0;;;;;;;;;;;;;;;;;;1,0;;;;4,0;;;;;;;;;;;1,0;;;;;;;;6,0;;;;;;;;;;;;15,0;;;;;2,0;;;;;;;;;;;;;;3,0;;;;;;1,0;;;7,0;;;;;;;;1,0;;3,0;3,0;;1,0;;;3,0;;;;;2,0;5,0;;;;;6,0;;1,0;;;;;;;;;;;;;1,0;1,0;;;;;;2,0;;;4,0;;;;;;;;;1,0;;;;;;;;;8,0;10,0;;;;;12,0;;;;5,0;;;;;;;;;;;;;;;;;;6,0;1,0;;;;;;;;;;1,0;;;;;;;3,0;1,0;;;;;;;1,0;;;;;1,0;;;;;;;;;15,0;;;;;;;;;;;;;;;;2,0;;;1,0;;2,0;;;;;;;;2,0;;;;;;;1,0;3,0;;;;1,0;;;;1,0;;;;;;;;;;;;;1,0;;;;;;;;;;;;;;;;;;;;;;;;;;;;;;;;;;;1,0;;;;;;;;;;;;;;;;;;;;;;;1,0;;;;;;;;;;1,0;;1,0;;;;;;;;;;;;;;;6,0;;;;;;;;;;;;;;;;;;;;;;;;;;;;;;;;;;;;;;;;;;;;;;;;;;;;;;;4,0;;;;;;;;;;;;;;;;;;;2,0;1,0;;;;2,0;;;;;;1,0;;2,0;2,0;;;;1,0;;;;;;;1,0;;;;;;;1,0;;;;6,0;;;;;;;;;;;;;;;;;1,0;;;;;;;;;;;;;1,0;;;;;;;;;;;3,0;;;;;;;;;;;;;;;;;2,0;;;;;;;;;;;;;;;1,0;;;;;;;;;;;;;;;;;;;;;;;;;;;;;;;;;;;;;;;;;
exterior;;;;;11,0;;;17,0;1,0;1,0;1,0;;;;;;;;25,0;5,0;;4,0;;;;;;1,0;;;;1,0;9,0;;3,0;;;6,0;;5,0;;;;10,0;;;;;2,0;;;;;;;15,0;12,0;;;17,0;;;19,0;;;11,0;;1,0;;;4,0;;;8,0;2,0;;;4,0;8,0;2,0;1,0;;1,0;;;;22,0;2,0;;;5,0;2,0;;4,0;;3,0;;;;;71,0;18,0;;;;;1,0;42,0;;;4,0;10,0;;5,0;10,0;;3,0;;6,0;21,0;;;;10,0;;;1,0;11,0;;15,0;35,0;;;;;1,0;12,0;;;2,0;;;5,0;;;;6,0;4,0;;;;3,0;3,0;2,0;9,0;1,0;1,0;55,0;;15,0;1,0;;;6,0;;;;15,0;;;49,0;6,0;11,0;6,0;;1,0;2,0;1,0;;;24,0;1,0;5,0;;;7,0;3,0;4,0;;25,0;3,0;;1,0;9,0;;;;;10,0;;;7,0;3,0;27,0;;;;;3,0;11,0;;1,0;;;;;;4,0;;1,0;2,0;46,0;;;20,0;;21,0;;;;;;;4,0;;;1,0;;12,0;;1,0;;;2,0;4,0;;1,0;;;;;;4,0;6,0;3,0;;6,0;8,0;;;;1,0;;;;;5,0;;;;;11,0;;2,0;4,0;3,0;;;;3,0;2,0;4,0;2,0;;6,0;;;5,0;1,0;2,0;;;1,0;;;1,0;;1,0;5,0;;4,0;;5,0;;;4,0;2,0;;6,0;1,0;;;;;1,0;;3,0;;;2,0;;11,0;32,0;;;5,0;;3,0;;;2,0;;;;;;;;;;;;;;;;;;7,0;;4,0;;;;;;;;;;;;2,0;;;;;;;;;;;;;;;;;2,0;;;;1,0;;;;;;1,0;;;;;;;;;1,0;;;;;;;;;;1,0;;6,0;;;;;;2,0;;;1,0;2,0;;;1,0;;;;;;;;;;;;;;;;3,0;;;;;9,0;3,0;;;;;;;14,0;4,0;;;;;;;;1,0;;;;2,0;1,0;;;;2,0;1,0;;;;;7,0;;;;;;;;;30,0;2,0;;;;;;1,0;4,0;1,0;14,0;;;1,0;;;;;;4,0;;;;;2,0;9,0;;;;;3,0;4,0;;;;;;;;;;1,0;;;;2,0;;10,0;;;;3,0;;;;;;;1,0;44,0;;;;;;;2,0;3,0;;;;4,0;;;;;;;;;;1,0;;;;;;;;;;5,0;;;;;;;;;2,0;2,0;;;;;;;;;;;1,0;;;;;;;;;;;;;1,0;;;1,0;;;;;;;;;;3,0;;6,0;;3,0;;;;;;;;;1,0;;9,0;8,0;;;;96,0;;;;;;1,0;;;;;;;;1,0;;;;;;;1,0;1,0;;;;;;;;;;;;;;;;;;;;;;;;;1,0;;;;;;;;;;;;;;;1,0;;;;;;1,0;;;;;;1,0;;7,0;1,0;;;;;;;;2,0;;;;;;;;;;;;;;;;;;;;;;;;;;;;;;;;;;;;;;;;;;;3,0;;;;2,0;;2,0;;;;1,0;;;;;;;;;;;;;3,0;1,0;;;;1,0;;;;;;;2,0;;;;;;;2,0;;;;1,0;;;;;1,0;1,0;;;;;1,0;;;;;;;;;;1,0;;;;1,0;;;;;;;;2,0;;;;;;;;;;2,0;;2,0;;;;;;;;;;;;;5,0;;;;;;;;;;;;;;;;3,0;;;;1,0;;;;;;;;5,0;;;;;;;;;;;;;;;5,0;;;;;;;;;;;;;;;;;;;;;;;;;;;;;2,0;;;;;;3,0;;;;;;;;;;;;;;;;;;;;1,0;;;;;;;;;;;;;;;;;;;;;;1,0;;;;
fasten;;;;;10,0;;6,0;26,0;;;;;;;;1,0;;;;;;;;;;;;1,0;;;;;19,0;;2,0;;;3,0;2,0;1,0;1,0;1,0;;12,0;;;3,0;;;;;;;2,0;;1,0;7,0;;;45,0;;;1,0;;;3,0;3,0;;;1,0;9,0;;;;;;;;13,0;;;;;;;;;;;2,0;2,0;;2,0;4,0;;4,0;;;;;13,0;4,0;;;;;;2,0;;;;1,0;;25,0;12,0;;;;2,0;5,0;;;;1,0;;;1,0;4,0;;7,0;6,0;2,0;;4,0;;;;;;;;;;;;10,0;5,0;3,0;;;;;;;11,0;1,0;29,0;14,0;;;;1,0;7,0;;;;;1,0;;;63,0;;1,0;6,0;3,0;6,0;16,0;;;;3,0;;1,0;;4,0;5,0;10,0;23,0;;61,0;;;;10,0;1,0;;;;2,0;6,0;1,0;;8,0;7,0;;;;;22,0;10,0;;;;;;;1,0;;;1,0;1,0;;;;7,0;;;;;1,0;;;;;;;;4,0;4,0;;9,0;;2,0;2,0;;;;;;4,0;;;1,0;5,0;;1,0;1,0;2,0;;;;;4,0;;2,0;6,0;3,0;;4,0;;2,0;5,0;;;4,0;;;;;4,0;;3,0;3,0;7,0;4,0;;1,0;1,0;;2,0;;;;;;;;;;4,0;;;;;;1,0;;;5,0;7,0;;;;;6,0;;;;15,0;6,0;2,0;;3,0;1,0;;3,0;;4,0;;;1,0;;2,0;;;;;;;;;;5,0;;;;;4,0;;;;;;;;;;;1,0;;;;;;;;;;2,0;;;1,0;;;;1,0;1,0;;;2,0;;;;;;;;;;;;1,0;;;;;;2,0;;;;;;;;;;;;;2,0;1,0;8,0;2,0;;;;;;;2,0;;;1,0;;;;;;;;;;;;;;;;;;;;;;;;;;;;;;;;;;;;;;;;;;4,0;2,0;;;;;;2,0;;;;12,0;;;;;;;;;;;;;;;1,0;;4,0;1,0;;;;;;;;;;;18,0;;;;4,0;2,0;;;;;;1,0;;;;7,0;;;;;;;;;;;;2,0;;;;;;;;;;;;;;;;;;;12,0;;2,0;1,0;;;;;;;;;;;;;;;;6,0;;;;;;4,0;;;;;;;;;;;;;;;;;;;;;;;1,0;;;;;;;;3,0;;29,0;;;;;;;;;;;;;;7,0;;;1,0;3,0;;;;2,0;6,0;;1,0;3,0;;;2,0;;2,0;;;;;;;;;;;;7,0;;;;;;6,0;;;2,0;;;;;;;2,0;;;;;;1,0;;;;;;;;;;;;;;;;;;;;;;;1,0;;;;;;;;;;;;1,0;;2,0;;;;;;;;3,0;;;;;;;;;;;;;;;;;;;;;;;;;;;;;;;;;;;;;;;;1,0;;;;;;;;;;;;;;;;;;;;;;;;;;;;;;;;;;;;;;;;;;;;2,0;;;;;2,0;;;;;;;;;;;;;;;6,0;;;;;;;;4,0;;;;;;;;;;;1,0;;;;;;;;;;;;;;;;2,0;;1,0;;;;;;;4,0;;41,0;;;;;2,0;;;;;;;;;1,0;1,0;;;;;;;;;;;;;;;;;5,0;3,0;;;;;;;;;;;;;;;;;;;;;;;;;;;3,0;;;;;;;;;;;;;;;;;;;;;;;;;;;;;;;;;;;;;;;;;6,0;;;;;;;;2,0;;;;;;;;;;;;;;;;;1,0;;;;
fastener;;;;;2,0;;2,0;6,0;;;;;;;;1,0;;;;;;;;;;;;;;;;;1,0;;2,0;;2,0;;;2,0;1,0;;;;;;;;;;;;;3,0;;3,0;13,0;;;16,0;;;;;;9,0;;;;;;;;;;;;;11,0;;1,0;;;;;;;;;3,0;2,0;;;;9,0;2,0;;;;1,0;1,0;11,0;;;;;1,0;;;;3,0;2,0;;11,0;7,0;;;;6,0;1,0;;;;2,0;;;3,0;3,0;;6,0;;;;;;;;;;;;;;;;;1,0;8,0;;;;;;;5,0;;5,0;1,0;;3,0;;;;;;;;;;2,0;2,0;;1,0;22,0;;5,0;;;;;;4,0;;;;;14,0;12,0;;2,0;;;;14,0;;;;1,0;;5,0;;1,0;;3,0;2,0;;;;4,0;20,0;;;3,0;;17,0;;;;;;;;1,0;;;;;;;;;;;;2,0;2,0;;;1,0;;;1,0;2,0;;;1,0;1,0;2,0;;;;;;3,0;;;;1,0;;;;;2,0;;6,0;;9,0;3,0;;;;3,0;;;5,0;;;;;1,0;;;3,0;12,0;;;1,0;;;;;;;;;;1,0;;;;;;;;;;2,0;;2,0;2,0;;4,0;;;2,0;;;;2,0;1,0;;;3,0;1,0;;;;4,0;;;;;2,0;;;;;;;;;1,0;;;;;;;;2,0;5,0;;;;;;;;;;;;;;;;;;;;;;;;;;1,0;;;;;;;;;;;;;;;;;;;;;;;;;;;;;;;;;;;1,0;5,0;;;;;;;;;;;;;;;;;;;;;;;;;;;;;;;;;;;;;;;;;;;;;;;;;;;;;2,0;;;;;;;;;;;;;;;;;;;;2,0;;;;;;;;;2,0;1,0;;;;;;;;;9,0;1,0;;;;;;;;;2,0;1,0;;;;;;;;;;;;;;;;;;;;;;;;;;;;;;;;;;;;;;;;;2,0;;3,0;;1,0;;;;;;1,0;;;;;;;;;;3,0;;;;;;;;;;27,0;;;;;1,0;;;;;;;3,0;;;;;;2,0;;;;;7,0;;;;;1,0;;;1,0;;;;;;13,0;;;;;;2,0;;;1,0;4,0;;1,0;;;8,0;;4,0;;;;;;;;;;;;13,0;;2,0;;;;2,0;;;;;;;;;;;;;;;;;;;;;;;;;;;;;;;;;;;;;;;;;;;;;;;;;;;;;;;;;;;;;7,0;;;;;;;;;;;;;;;;;1,0;;;;;;;;;;;;;;;;2,0;;;;;;;;;;;;;;;;;;;;;;;11,0;;;;;;;;;;;;;;;;;;;;;;;;;;;;5,0;;;;;;;;;;;;;;2,0;;;;;;;;;;;;;;;;;;;;;;;;;;;;;;;;;;;;;;;;;;;2,0;;;;;;;;;8,0;;;;;1,0;;;;;;;;;;;2,0;;;2,0;;;;;;;;;;;;;1,0;;;;;8,0;;;;;;;;;;;;;;;;;;;;;;;;;;;;;;;;;;;;;;;;;;;;;;1,0;1,0;;;;;;;;;;;;;;;;;;;;;;;;;;;;;;;;;;;;;;;;;;;;;;
feed;;;;;2,0;;;10,0;;3,0;;;;;;1,0;;;12,0;6,0;;7,0;;1,0;1,0;;;44,0;;10,0;1,0;1,0;151,0;2,0;2,0;;;17,0;;41,0;1,0;;1,0;2,0;;;;;;1,0;;1,0;;;3,0;39,0;16,0;;;;1,0;;12,0;;1,0;;3,0;;;28,0;;2,0;6,0;;;;;2,0;23,0;2,0;;2,0;2,0;5,0;;;11,0;;4,0;94,0;5,0;;;16,0;;;;6,0;1,0;;1,0;12,0;;9,0;;;;10,0;;;1,0;10,0;2,0;5,0;2,0;;;;3,0;5,0;;;;;;;8,0;;;;2,0;;;;;6,0;;;;;;;37,0;;;;;180,0;;;;;;;;3,0;;12,0;;3,0;;;;;;;23,0;2,0;;;;;6,0;3,0;4,0;;1,0;10,0;;4,0;;;1,0;;;;1,0;12,0;;1,0;;;;44,0;;;;;;;;;;;;6,0;6,0;;4,0;;1,0;2,0;;;;3,0;1,0;;3,0;;;4,0;;;;;;;;;;;;;;1,0;;;;;;;;;;;7,0;;;;;;;3,0;;;;1,0;;;;;;;1,0;;;;;;;1,0;;;;2,0;;;;4,0;;;;20,0;;6,0;1,0;3,0;7,0;;;;;1,0;;;;;;;;;1,0;2,0;;;;;;;3,0;1,0;;;3,0;5,0;;;;;;;;;;;;;9,0;;3,0;;2,0;;;;;;;;;6,0;;;;;;;;;;;3,0;;;1,0;;;;;;;4,0;;6,0;;;;;;;;;;6,0;1,0;;;;;;1,0;;3,0;;;2,0;;;5,0;;;2,0;;;;;2,0;;;2,0;1,0;;;;;2,0;;;1,0;7,0;;;;;3,0;;;1,0;;;;;4,0;;;;;;;;;;;;;;;;;;12,0;7,0;;;;;;;;;1,0;;;;;;;20,0;1,0;;;9,0;;;5,0;;;;;;;;;4,0;;25,0;;1,0;;1,0;;;;;;2,0;3,0;;;;41,0;;1,0;76,0;1,0;;1,0;1,0;;5,0;;;;;;;;4,0;2,0;;;;1,0;3,0;;4,0;1,0;;;;;;9,0;;;;;;;;;;;;;;;;;;6,0;;;;;;;;;;33,0;1,0;;5,0;;4,0;;;;;;10,0;;;;1,0;118,0;;;5,0;;;;;7,0;1,0;1,0;;8,0;;1,0;;;;;1,0;;;;;;;;;;;;;;;;;;;1,0;;1,0;;;;;2,0;;;;1,0;;;;;;;;;;;;;;;2,0;;;;;;;;;;;;;;;;;;;;;;;;;;;;;;;;;;2,0;;;;;;;;;;;1,0;;;;;;;;;4,0;;6,0;;;;1,0;;;;;;;;;;;;;4,0;;;;;2,0;;;;3,0;;;;;;;;;;;;;;;;;;4,0;;;;9,0;;;3,0;;;;;;;;;8,0;;;;;;;;;;;;8,0;;;2,0;2,0;;;;;;;;;;;;5,0;;1,0;5,0;4,0;;;;;;;;1,0;;;;;;;;;;;;;;;;;;;;5,0;;;;;;;;;;1,0;;;;;;;;;;2,0;1,0;;;;4,0;;;;;;;;;1,0;;;;;;1,0;;;;;2,0;;;1,0;1,0;1,0;;;;;;;;2,0;;;;;;;;;;;;;;;;;;;;;3,0;;;;;;;;;;;;;;;;;;;;;;;;;;1,0;;;21,0;;;;;;;3,0;;;2,0;;;;;;2,0;;;;;;;;;;;;1,0;;;;;;;;;;4,0;;;;;;;;;;;;;;;;;;;;;;;;;;;;;;;;;;;;;1,0;;;;;;;;;
file;;;;;15,0;;;24,0;;24,0;2,0;2,0;;;8,0;;;;;25,0;1,0;26,0;1,0;1,0;2,0;4,0;;248,0;;3,0;4,0;7,0;146,0;;265,0;;;;;59,0;;;1,0;13,0;;;;;7,0;3,0;1,0;52,0;;18,0;;822,0;171,0;;;6,0;;;78,0;;;;30,0;;;11,0;9,0;3,0;4,0;;;20,0;;;3,0;1,0;2,0;35,0;8,0;20,0;;;;;5,0;88,0;8,0;;31,0;17,0;17,0;;;92,0;185,0;;10,0;46,0;;96,0;3,0;;;55,0;;;2,0;3,0;1,0;;8,0;;;;;3,0;;;5,0;12,0;;;17,0;;;;;46,0;;;6,0;3,0;;;;;;;14,0;;;;6,0;4,0;;;;;3,0;;;;;;;6,0;;;;;5,0;;;;3,0;;;;2,0;;;;;18,0;;;;;;;;;;46,0;;2,0;;;;93,0;;;;;;;;;1,0;;;14,0;1,0;;;;;;;;;30,0;62,0;;;;;;;1,0;;;2,0;;;;;;;;;1,0;;4,0;2,0;;;;2,0;;;6,0;;;;;;1,0;;3,0;8,0;;;;14,0;;4,0;;1,0;;;;;;;;;;;2,0;;19,0;;;1,0;;;;;;;;12,0;1,0;4,0;;;;;;;;;2,0;;;;;16,0;;3,0;;;;;;;15,0;;;;;;;;;;2,0;;5,0;;;;;1,0;;11,0;;;;;;;;3,0;;;38,0;4,0;4,0;1,0;13,0;;;;3,0;2,0;2,0;3,0;;;;2,0;;;;;;;;28,0;6,0;1,0;3,0;;;17,0;;;3,0;76,0;55,0;;;;;2,0;;2,0;47,0;;;1,0;;1,0;152,0;;5,0;;;1,0;;;;;;1,0;;8,0;;;;;;17,0;;;1,0;;1,0;12,0;14,0;7,0;;11,0;;15,0;2,0;4,0;;52,0;;;30,0;24,0;1,0;;;;;;2,0;;;3,0;;8,0;;8,0;1,0;55,0;4,0;;4,0;3,0;;1,0;9,0;9,0;4,0;;125,0;10,0;2,0;12,0;5,0;1,0;27,0;;;;3,0;;1,0;11,0;;2,0;20,0;;;;;22,0;3,0;;20,0;1,0;;20,0;1,0;;;5,0;;;5,0;24,0;18,0;;4,0;42,0;9,0;;;;5,0;4,0;4,0;;;;10,0;12,0;;;;;4,0;15,0;11,0;1,0;9,0;;2,0;;4,0;;;;10,0;;;7,0;;;1,0;;;;;;4,0;;;;24,0;;5,0;2,0;;;;23,0;;49,0;;9,0;14,0;;;83,0;;2,0;;;23,0;1,0;;2,0;1,0;;;;;;18,0;;5,0;10,0;7,0;;;;;;;;2,0;6,0;2,0;5,0;1,0;;35,0;;23,0;2,0;;;;;;1,0;;2,0;2,0;;;;;;9,0;;1,0;1,0;;;14,0;;;4,0;;2,0;4,0;;;2,0;;;2,0;7,0;;;;25,0;;;;;;;;;;;;1,0;1,0;;;;;;;;;2,0;;;;;;;;;;1,0;;8,0;;;;;1,0;;;;;;;;;;;;;;;1,0;;;;;2,0;;;;;;;;;;;;;;;;;;;;;4,0;7,0;;;;1,0;;;;;3,0;;;;;;;1,0;;3,0;;;;;5,0;4,0;1,0;;;;1,0;;;;;;;;;1,0;;;;;;;;;;;;9,0;;;;;;;;;;;;;;1,0;;1,0;;;7,0;;;;;;;;12,0;2,0;;;;;;;13,0;1,0;;;2,0;;2,0;;;;;;;2,0;2,0;;;;;;;;;;;;;;;1,0;;;;;;;3,0;2,0;;;;;;;;;;;;;;;;;;;2,0;;4,0;14,0;;;;;;;;;;;;;;;;;;;2,0;;;5,0;;;;;;;;;;;;;;;;;4,0;;;;14,0;;19,0;;;;;;;;;;;;;;;;;;;;;;1,0;;;;;;;;;;2,0;;;;;2,0;;;;;;;;;;;1,0;;;2,0;;;;;;;;;;;;;;;;;;;;;;;;;;;;;;;11,0;;;;;;;;;;107,0;;2,0;;;;2,0;;;
finger;;;;;3,0;;;28,0;5,0;4,0;2,0;;5,0;;;1,0;;;;;;27,0;;;;;;;;53,0;12,0;9,0;31,0;;9,0;;;6,0;;2,0;;;;;;;;;;;;;;;;48,0;10,0;;;11,0;;;25,0;;19,0;;1,0;;;4,0;;;;1,0;;;;3,0;19,0;;3,0;2,0;3,0;;;;2,0;;1,0;5,0;2,0;;;5,0;1,0;1,0;;;;;6,0;1,0;1,0;;;;1,0;3,0;;;2,0;3,0;;2,0;6,0;;2,0;;1,0;4,0;2,0;;;2,0;;;3,0;17,0;;;1,0;2,0;;;;2,0;1,0;;;;;;1,0;;;2,0;4,0;;;;;3,0;;1,0;5,0;;;6,0;;2,0;;;;3,0;;;;1,0;;;1,0;;3,0;6,0;18,0;1,0;2,0;1,0;;;;;;1,0;1,0;2,0;1,0;22,0;;1,0;;;;1,0;;;;;1,0;;;1,0;1,0;6,0;;;;;;1,0;;;;;2,0;;1,0;;;;;;;;4,0;;;;;;;;;1,0;6,0;;2,0;;5,0;;3,0;;;1,0;1,0;;;1,0;;;;;;6,0;;;1,0;4,0;1,0;;;;1,0;;2,0;;9,0;;;;1,0;;;;3,0;1,0;;1,0;;1,0;1,0;;;;;6,0;4,0;20,0;4,0;1,0;;;;;;1,0;;;;;;1,0;6,0;;;;;;1,0;2,0;;;;;;;3,0;;;;;2,0;;;;;;8,0;;;46,0;;;;;;;;;;;1,0;;;;;;1,0;;4,0;1,0;;;;;;;;;;2,0;;;;24,0;;;;;;;7,0;;;;;;;;2,0;;;;;;;;;;;3,0;;;;4,0;;;;;;3,0;;;;4,0;;1,0;4,0;12,0;;;3,0;;;;;3,0;;3,0;;;;;2,0;;1,0;;;;;;;;;;;;;;;3,0;;;;;2,0;;1,0;;;;;1,0;;2,0;;;;4,0;;;;;;;2,0;;;;;;3,0;;;;;;;;;;;;;;2,0;1,0;;;;;4,0;;5,0;;2,0;;;;;;;;;;;;;;;;;;;;;;;;;;;;2,0;;;;;;;;;;;;;3,0;27,0;2,0;;;;;;;;2,0;;;;;;;;;;2,0;;;4,0;;;;;;;1,0;;;;1,0;;;;;;1,0;;;;;;;;;;;;;;;;;;;;1,0;;;1,0;;;2,0;;1,0;;;;;;;;;;;;;1,0;1,0;;;;;;;;;;;;;;;;;1,0;;1,0;;;;;;;;;;;2,0;;;;;;;;;1,0;;2,0;23,0;1,0;;;;4,0;;;;;;;;;;;;;;;;;;;1,0;;;2,0;;;;;;;;;;;;;;;;;;;;;;;;;;;;;;;;;;;;;;1,0;;;;;;;;;;;;;;;;;;;;;;;;;;;;;;;;;2,0;;;;;;;;3,0;;;;;;;;;2,0;;;;;;;;;;;;;;;;;;;;2,0;;1,0;;;;1,0;;;;;1,0;1,0;2,0;;;;;;;;;;;;;;3,0;;;;;;;;;;;;;3,0;;;;;1,0;;;;1,0;;;;;;1,0;;;;;;;;;;;;;;;;2,0;;;;;;;;;;;;;;;;;;;;;;;;;;;;;;;;;;;;;;;;;;;;;;;1,0;;;;;;;;;;;;;;;;;2,0;;;;;;;;;;;;;;;;;;;;;;;3,0;;;;;;;;;;;;;;;;;;;;;;;;1,0;;;;;;;;;;;;;;;;;;;;;;
flexible;;;;;19,0;;6,0;3,0;;8,0;;;2,0;;;2,0;;;3,0;3,0;;6,0;;;1,0;;1,0;;;;;;31,0;;23,0;;7,0;4,0;;95,0;;;2,0;8,0;;;1,0;;;;;;;6,0;;23,0;37,0;;4,0;20,0;3,0;;11,0;1,0;;2,0;1,0;;;2,0;12,0;;1,0;;9,0;;1,0;;19,0;1,0;5,0;3,0;1,0;;;;19,0;;;;19,0;;;4,0;1,0;1,0;;1,0;;93,0;33,0;11,0;;;;;;91,0;;;3,0;10,0;5,0;12,0;16,0;;4,0;;133,0;39,0;3,0;;2,0;126,0;1,0;;7,0;13,0;;26,0;9,0;;2,0;;1,0;3,0;20,0;;15,0;;;;1,0;1,0;;;16,0;6,0;;;;;4,0;;1,0;4,0;8,0;16,0;1,0;8,0;1,0;;4,0;3,0;;7,0;;7,0;;15,0;66,0;;31,0;23,0;1,0;7,0;3,0;;;;5,0;2,0;4,0;;;;1,0;30,0;;69,0;;;;9,0;;;;1,0;4,0;5,0;1,0;3,0;;10,0;;;;2,0;;15,0;;3,0;;;8,0;1,0;4,0;;;10,0;;2,0;;;2,0;;3,0;;1,0;5,0;3,0;;4,0;2,0;;1,0;1,0;5,0;65,0;;3,0;;1,0;;66,0;2,0;;8,0;;4,0;;;1,0;81,0;4,0;1,0;;23,0;;1,0;2,0;8,0;2,0;5,0;2,0;1,0;19,0;2,0;1,0;29,0;;2,0;;1,0;36,0;;;;;7,0;2,0;;;13,0;;;1,0;;1,0;2,0;;;;5,0;;1,0;;;;;;;;13,0;14,0;;5,0;;2,0;3,0;1,0;;1,0;3,0;1,0;;;10,0;;12,0;;1,0;2,0;1,0;;4,0;2,0;21,0;2,0;;7,0;;;;;;1,0;;;;;;;;;;;;3,0;;3,0;;;1,0;;;;;;;;;;;;;;;3,0;;;;;;;;;;;;;2,0;;1,0;;;;;;2,0;4,0;;2,0;;;;;1,0;;;;;1,0;;;;;;;2,0;1,0;6,0;1,0;;;;;;;;;;;;;1,0;;;;;;;;;;;;;;;3,0;;;2,0;;1,0;;;;7,0;;;2,0;;11,0;;;;;;;;;;;3,0;;;;;;;;;;;114,0;;;;;;;4,0;;2,0;;;;4,0;1,0;7,0;;2,0;3,0;6,0;;;;;;;;;;2,0;;;;2,0;;;;;;9,0;23,0;;;;;8,0;;;;;;;;;1,0;;1,0;;;;1,0;;;;;;;2,0;3,0;;2,0;;;;;;;;;;;;;;1,0;;;;;;4,0;;;;;;;;2,0;1,0;4,0;;5,0;;;;1,0;;;13,0;;;;;;1,0;;;1,0;;;;4,0;2,0;;;;;;;;1,0;;1,0;2,0;1,0;;;;;;;;;;8,0;;;;;;2,0;;;;35,0;;;;;1,0;;;;9,0;;;7,0;;;;;;;;7,0;;1,0;5,0;8,0;2,0;;;;;7,0;;;;;;;1,0;;;;;2,0;;;;;;;;;;;;;;;;;;1,0;;;;;;;;;;;;;;1,0;;;;;;;;;;;;;;;3,0;;;;;;;;;;;1,0;;;1,0;;;;;;;;1,0;;;;;;;;;1,0;;;;;;;;4,0;;;;;;2,0;;;;;;;;;;;;;;;;;;;;;;;;;;;;2,0;;;;;;1,0;;;;7,0;;;;;1,0;;;;;;;;;;;;;;;;;;;;;;;1,0;;;;7,0;;;;;;;15,0;;;1,0;;;;;;;;;;;1,0;;;;1,0;;;1,0;;;;;;;;;;;3,0;2,0;;;;;;;;;;;;4,0;2,0;;;;;;;;;;;;;;;;;;;;;;;;;2,0;;;;;;;;;;;;;;;;;;;;;;;;;;;;;;;;;;;;;1,0;;1,0;14,0;;;;;;;4,0;;;;;;;;;;;;;;;;;;;;;;;;;;;;;;;;;;;;;;;
float;;;;;4,0;;2,0;5,0;;;;;;;;;;;;;;17,0;;;;;;;;6,0;4,0;7,0;45,0;;1,0;;;3,0;;;6,0;;;10,0;;;;;;;;;;2,0;1,0;9,0;10,0;;;2,0;;2,0;2,0;;;;;;;1,0;6,0;;1,0;;;;;;1,0;1,0;;;;;;;124,0;;;;1,0;;;49,0;;;;;2,0;;;5,0;;31,0;;;11,0;34,0;;;2,0;8,0;7,0;;;;;;;;;;2,0;;;;17,0;5,0;;;;;;;;;2,0;;3,0;;;;;2,0;;;3,0;;;;;;;;2,0;;;;;12,0;;;;;;12,0;1,0;2,0;;;;;;;;;;24,0;;;;;;;;;;31,0;;48,0;;;;;;;;;;;2,0;;;11,0;;;;;;;;;;;;2,0;;;;;;;;;;;;;;;;;;3,0;;;;;;;;;;;;;2,0;;;;5,0;;;25,0;;;;;;;1,0;6,0;;;;;;;;;;;1,0;5,0;;;;;;;;2,0;;;;;;;;8,0;;;;;;;42,0;3,0;;2,0;;;1,0;;;;;;;;;;;;;;;;;;;;;;;2,0;;;1,0;;;;;;;6,0;;;;;;1,0;;;;;;;;;;;;;;;;;;;;;;2,0;;;;;;;;2,0;;;;;;1,0;;;1,0;1,0;;;;;;1,0;;;;;;;;;;;;;;;;;;;;;;;;;23,0;;;;;;2,0;;;;;;;;;6,0;;;;;;;;;;;;;;;;;;;30,0;9,0;;;;2,0;;;;;;;;;;;;;;;;;;;;;;;;;;;;;;;;;;;;;;2,0;;5,0;;;;;;7,0;;;;;;;;;;;;;;;;;;;;;;;;;;;;;;;;;;;;;;;;;;;;;;;;;;;;;;;;;;;;;;;16,0;19,0;;;;;2,0;;;;;;;;;;;;;;;;6,0;;;7,0;;;;;;;;;;11,0;;;;;;;;;;;;;;;;;;;;;;;;;46,0;;;1,0;7,0;;;;;;;5,0;;;;;;;;;;;;;;;;;;;;;;;;;;;;;;;;;;;;;;;;;;;6,0;;;;1,0;;11,0;15,0;;;;10,0;17,0;;;203,0;;1,0;;;;;4,0;1,0;;;;;27,0;;;;19,0;;;;;1,0;;;;;61,0;2,0;;;;;;;;;;;;;;;;;;;;;;;;;;;;;;;;;;;;;;;;;;;;;;;;;;;;;;;;;;;;;;;;;;;;;;;;;;;;;;;;;;;;;;;;;;;;;;;;;2,0;;;;;;;;4,0;;;;;;;;;;;;;;;;2,0;;;;;;;;4,0;;;;;;;;;;;;2,0;;1,0;;;;;;;;;;;;;;;;;;;;;;;;2,0;;;;;;;;;;;;;;;;;;;;;;;;;;;;;;;;;;;;;;;;;;;;;;;;;;;;;;;;;;;2,0;;;;;;;;;;;;;;6,0;;;;;;;;;;;;;;;;;;;;;;;;;;;;;;;;;;;;;;;;;;
forward;;;;;5,0;;25,0;7,0;5,0;2,0;;;;;1,0;;;;6,0;;;1,0;;;1,0;;;4,0;1,0;1,0;1,0;;14,0;;2,0;;2,0;61,0;;3,0;;;21,0;10,0;;;;;7,0;;1,0;1,0;;10,0;;22,0;6,0;;2,0;43,0;;;2,0;;;10,0;16,0;;;5,0;44,0;2,0;;;;1,0;;8,0;17,0;3,0;;2,0;1,0;;1,0;;9,0;6,0;;4,0;7,0;10,0;2,0;1,0;;1,0;;;2,0;;12,0;7,0;;14,0;;;;12,0;;;;;2,0;8,0;;;;;1,0;7,0;;;;1,0;;;10,0;5,0;;3,0;2,0;;6,0;4,0;;;12,0;;;1,0;;;1,0;38,0;;1,0;3,0;8,0;;4,0;;;;;;9,0;1,0;3,0;1,0;5,0;;;1,0;;;6,0;;1,0;;;9,0;;4,0;4,0;9,0;3,0;;2,0;;;7,0;3,0;11,0;;6,0;;3,0;4,0;;29,0;;;4,0;4,0;;;;;4,0;;;4,0;;19,0;;;1,0;;1,0;8,0;;;;;;7,0;;2,0;;;2,0;13,0;;;2,0;;;;;;;;2,0;;6,0;9,0;;10,0;4,0;;1,0;;;;;;11,0;;;2,0;9,0;;;3,0;;1,0;5,0;6,0;7,0;;;7,0;;;;1,0;7,0;;;;;5,0;;;;2,0;3,0;;5,0;1,0;;;;9,0;;4,0;21,0;2,0;;5,0;;;;4,0;;2,0;;3,0;;;;2,0;4,0;12,0;6,0;2,0;;;9,0;1,0;;1,0;6,0;1,0;3,0;;1,0;;1,0;;;;;;;2,0;;;3,0;;;;;;;;;1,0;;;;;;;;1,0;;2,0;;6,0;;3,0;;;;;;2,0;;;2,0;;;;;;;;;;;2,0;;1,0;1,0;;;;;;5,0;3,0;;2,0;2,0;;;;;4,0;;4,0;2,0;;;3,0;1,0;3,0;;;3,0;;;;;;;;;;;;;3,0;2,0;;;;2,0;1,0;;;2,0;;;;1,0;;;;4,0;;;;;;;;;;;;;;;2,0;;3,0;;;;;4,0;3,0;2,0;;;;1,0;;;;;;2,0;;6,0;;;;;;;;6,0;;8,0;;;;;;1,0;;;14,0;;;;;1,0;4,0;;2,0;9,0;4,0;;12,0;;;;;;;2,0;;;;;;;;;;;1,0;1,0;;;;;;;3,0;;;1,0;;;;;1,0;;;;;;;;;;;;;3,0;;;;;;3,0;;;;1,0;2,0;;;;;2,0;;;;;;1,0;;1,0;;;;;;;;;;;;;;5,0;;1,0;;;;;;;;;;;1,0;;;;;;;;;;;;;2,0;;;;1,0;;;;;3,0;;;;3,0;;;;;;;5,0;;;;1,0;2,0;2,0;;;;;;;;;;;1,0;;2,0;;2,0;;;;;;;;;;2,0;8,0;;;;;1,0;;;;;;1,0;;;;;1,0;;;;;;;;2,0;;;1,0;;;;3,0;;;;;3,0;5,0;;;;;;;;;;;;;2,0;;;1,0;;;;;;;3,0;;;;;;;1,0;;;;;;;;;;;;;;;;;;;;;;;;2,0;;;;;;;;;;;;;2,0;;;2,0;;;;;;;;;;;2,0;1,0;;;;;;1,0;;;1,0;;;;;;;;;;;;;;;3,0;;;;;;;;1,0;;;;;;;;;;;;;;;;;;;6,0;2,0;;;;;;;;23,0;;;;;;;;;;;;;;;;;;;1,0;;;;2,0;3,0;;;;;;;;;;;;1,0;;;;;;2,0;;;;;;;;;;;;;;;;;;1,0;;;;1,0;;;;;;;;6,0;;;;;;;19,0;;;;10,0;;;;1,0;;;1,0;;3,0;;;;;;;;;;;;;;;;;;;;;;;;;;;;;;;;;;;;;;;;;4,0;;;;;;2,0;;;;;;;;;;;;;;;;;;;;;3,0
friction;;;;;2,0;;3,0;2,0;;;;;;1,0;;2,0;;;1,0;;;6,0;;;1,0;;;;;;;;3,0;;;;;;;;;;1,0;5,0;;;;;;;;1,0;;;;;6,0;;;8,0;;;1,0;;;;;;;;3,0;;;;;;;;1,0;;1,0;;;;;;;;;;1,0;;;;;;;;;;6,0;;;;;;3,0;4,0;;;1,0;;;4,0;3,0;1,0;;;;3,0;;;;;;;;1,0;;;;;;;;;2,0;;;;1,0;;;;;8,0;1,0;4,0;;;;;;;;;;4,0;;;;;;;;;;;;1,0;14,0;;1,0;3,0;1,0;;1,0;;;;;;;;;;3,0;;;1,0;;;;;;;;;6,0;1,0;;;;;;1,0;;;;1,0;;;;;;;;3,0;;;1,0;;;;;;;;;;;;;;;;1,0;;;;3,0;1,0;;4,0;;2,0;;;;;;;;1,0;;;1,0;2,0;;;;;;1,0;1,0;;;;;;;;;;2,0;2,0;;2,0;;;1,0;;;;;;3,0;3,0;;;;;;;;;;;;;;;2,0;;;;2,0;;;;;;;;2,0;;;;;;;;2,0;1,0;;;;6,0;;1,0;;;;;;;;;;;;2,0;;;;;;;;;;;;;;;;;;;;;;;;;;;;;;;;;;;;;;;;;;;;;;;;;;;;;;;;;;;2,0;;;;;;;;;;;;;;;;;;;;;;;;;;;;;;;;;;;;;;;;;;;;;;;;;;;;;;;;;;;;;;;;;;;;;;;;;;;;;;;;;;;;;3,0;;;;;;;;;1,0;;;;;;;;;;;;;;;;;;;;;;;;;;;;;;;;;;;;;;;;;;;;;;;;;;;;;;;;;;;;;;;;1,0;;;;;;1,0;;1,0;;;;;;;;;;;;;;;;;;;2,0;;;;;;;;;1,0;;;;;;;;;;1,0;;;;;;;;;;;;;;;;;;;;;;;;;;;;1,0;;;;;;;;;;;1,0;;;;;;;;;;2,0;1,0;;;;;;;;;;;;;;;;;;;;;;;;;;;;;;;;;;;;;;;;;;;;;;;;;;;;;;;;;;;;;;;;;;1,0;;;;;;;;;;;;;;;;;;;;;;;;;;;;;;;;;;;;;;;;;;;3,0;;;;;;;;;;;;;;;;;;;;;;;;;;;;;;;;;;;;;;;;;;;;;;3,0;;;;;;;;;;2,0;;;;;;;1,0;;;;;;;;;;;;;;;;;;;;;;;;;;;;;;;;;;;;;;;;;;;;;;;;;;;;;;;;;;;;;;;;;;;;;;;;;;;;;;;;;;;;;;;;;1,0;;;;;;;;;;;;;;;;;;;;;;;;;;;;;;;;;;;;;;;;;;;;;;;;;;;;;;;;;;;;;;;;;;;;;;;;;;;;;;;;;;;;
game;;;;;76,0;;;14,0;4,0;16,0;1,0;;4,0;;1,0;;;;;44,0;1,0;52,0;35,0;1,0;;;;3,0;1,0;3,0;4,0;10,0;23,0;1,0;;2,0;2,0;15,0;;80,0;1,0;;;4,0;;;;;;;2,0;2,0;;4,0;;67,0;15,0;;;;;;24,0;;;;1,0;;;3,0;1,0;;;;;;;14,0;18,0;;;1,0;6,0;;;;1,0;;2,0;7,0;3,0;;1,0;;;25,0;;11,0;1,0;;4,0;30,0;;;3,0;;2,0;;;;;;;;;;;;;2,0;;;2,0;;;;4,0;;;;;;;;;1,0;;;;;;5,0;;;;1,0;2,0;;;;;;;;;;;1,0;;;;1,0;;;;;;;;;4,0;;;;13,0;;;1,0;;;;;;;;1,0;;;;2,0;;;;;;;;;7,0;;;;;3,0;;;;1,0;;;;;;;;2,0;1,0;;1,0;;;;;;;;;;;;;;;;;1,0;;;2,0;;;;;;;;;;;;;;;;;;;1,0;1,0;;;;;;;;1,0;;;;;;;;;;;;;3,0;;;;;;14,0;2,0;6,0;21,0;;;;5,0;1,0;;;;;;;3,0;1,0;18,0;;;;;8,0;1,0;;5,0;;;;;;;;;;;;;;;;;;;;6,0;;;;;;;;;;;;;;;;;;;6,0;;3,0;;;;;;;;;1,0;;;;;;1,0;;1,0;;;;;1,0;13,0;2,0;;;;3,0;;;;26,0;;;1,0;;3,0;3,0;;;;;;3,0;;8,0;;;5,0;;;;;;71,0;;1,0;;;;;;;2,0;1,0;;8,0;;2,0;;;8,0;10,0;3,0;;2,0;;2,0;;;;;;;;10,0;;;;;19,0;;;15,0;;;18,0;;2,0;13,0;;;;;;2,0;1,0;4,0;;;;;;;1,0;;7,0;;;21,0;;23,0;;;;;;;;1,0;;;;;38,0;;;1,0;;2,0;;;61,0;21,0;;;1,0;;;;;;;;;;;;;;;;1,0;;;;;;;;;;;;4,0;;;;;;;;2,0;;;1,0;23,0;;;;;;;;;12,0;;;;;;;;;;;;6,0;;;;;;;8,0;;;;;;;;;;;;;;;;;;;;;;;;;;;;1,0;;;;3,0;;;;;;1,0;;;;;;;;1,0;;;;;;;;;;;;;1,0;;;;;;;;;;;;;;;;2,0;;;;;;2,0;;;;;1,0;;;;;;;1,0;;;;;;;;;;;;;;;1,0;;;;;;;;;;;;;;;;;;;1,0;;;;;;;;;;1,0;;;;;;45,0;;;;;;;;;;;;4,0;;;;;;;;;;;;;;1,0;;;;;;;;;;;;;;;;;;;;9,0;;;;;;;;;;;;;;;1,0;;;;;1,0;;;;1,0;;;;14,0;;;;;;;;;;115,0;;;3,0;;;;;;;;15,0;;;12,0;2,0;;;3,0;7,0;6,0;;;;;;;;;;;;;;;;1,0;2,0;;;;;;;;;;;;;;;;;;;;;;;;;;;;;;;;;;;;;;;;;;;;;;;;;;;;;2,0;;;;;;;;;;;;;;;;;;;;;;5,0;;3,0;;;;;;;;;;;;;;1,0;;;;;;;;;;;;;1,0;2,0;;;;;;;;;;;;;;;;;;;;;;;;;;;;;;;;;1,0;;;;;;;;;;;;;;1,0;;;;;;;;;;;;;;;;;
gaming;;;;;1,0;;;;1,0;;3,0;;;;2,0;;;;;2,0;;;;;;;;;;;;4,0;7,0;;1,0;1,0;;;;6,0;;;;15,0;;;;;;;;;;;;1,0;3,0;;;;;;8,0;;;;11,0;;;;1,0;;1,0;;;;;19,0;8,0;;;;;;;;;1,0;;2,0;1,0;;;;;;;;;;;37,0;;;;;;;;;1,0;;;;;;;;;;;;;;;;2,0;;;;;;;;;;2,0;;;1,0;;37,0;;;;;;;;;;;;;;;;;;;;;;;;;;1,0;;;1,0;;;;8,0;;;;;;;;;;;;;4,0;;2,0;;;;;;;;;;;;;;;;;;;;;;;;;;3,0;;;;;;;;;;;;;;;;;;;;;;;;;;;;;;;;;;;;;;;;;;;;;;;;;;;;;;;;;;;;;;;;;;;;;;;1,0;2,0;;;;;;;;;;;;;;;4,0;;1,0;;;;1,0;;3,0;;;;;;;;;;;1,0;;;;1,0;;;;;;;;;;;;;;;;;2,0;;;;;;;;;1,0;;;;;;;;;;;;;;;;;;;;;;;;;;;;;;;;;;;;;;;;;;;;;;11,0;;;;;;;1,0;;3,0;;;;;;;;;;;;2,0;;3,0;;;1,0;;;;;1,0;;;;;;;;;;;;;;;;;2,0;;;;;;;7,0;;;;;;;;;;;;;;7,0;;;;;;;1,0;;;;;;;;;;;;;;;;;;;;;3,0;24,0;;;;;;;;;;;;;;;;;;;;;;;;;;;;;;;;;;;;;;;;;;;2,0;;;;;;;;;;;;;;;;;;;;;;;;;;;;;;;;;1,0;;;;;;;;2,0;;;;;;;;;;;;;;;;;;;;;;;;;;;;;;;;;1,0;;;;;;;;;;;;;;;;;;;;;;;;;;;;;;;;;;;;;;;;;;;;;;;;;;;;;;;;;;;;;;;;;;;;;;;;;;;;;;;;;;;;;;;;;;;;;;;;;;;;;;;;;;;;;;;;;;;;;;1,0;;;;;2,0;;;;;;;;;;;;;;;;;;;;;;;;;;;;;;;;;;;;;;;;;;;;3,0;;;;;;;;;;;;;;;;;;;;;5,0;;;;;;;;;;;;;13,0;;;;;;;;;;;;;;;1,0;;;;;;;;;;;;;;;;;;;;;;;;;;;;;;;;;;;;;;;;;;;;;;;;;;;;;;;;;;;;;;;;;;;;;;;;;;;;;;;1,0;;;;;;;;;;;;;;;;;;;;;;;;;;;;;;;;;;;;;;;;;;;;;;;;;;;;;;;;;;;;;;;;;;;;;;;;;;;;;;;;;;;;;;;;;;;;
gate;;;;;3,0;;;;;;;;;;;;;;;;;34,0;;;1,0;;;;1,0;;2,0;1,0;41,0;;5,0;;3,0;25,0;;1,0;1,0;;;7,0;;;;;;;;2,0;1,0;4,0;2,0;9,0;31,0;;14,0;;;;7,0;;;;;;;3,0;;;5,0;;;;;2,0;10,0;2,0;;4,0;1,0;;;7,0;92,0;;1,0;17,0;4,0;;;35,0;;;;1,0;;17,0;5,0;11,0;;125,0;;;30,0;14,0;;;3,0;17,0;21,0;;;;10,0;;;1,0;;;;14,0;;;3,0;3,0;;12,0;2,0;;;;;;41,0;;109,0;1,0;;;1,0;1,0;;;23,0;3,0;1,0;;;1,0;;;2,0;;;2,0;;19,0;;1,0;;;;6,0;4,0;6,0;14,0;;;7,0;1,0;;;9,0;;19,0;;;;4,0;3,0;;;;;6,0;;89,0;;;1,0;19,0;2,0;1,0;;;;;15,0;6,0;;19,0;;;;;4,0;;;;3,0;6,0;;4,0;2,0;5,0;;;;2,0;;;6,0;;;;;;;;;19,0;;;;15,0;3,0;;;;;;;;13,0;;8,0;2,0;18,0;;;105,0;;;17,0;1,0;;1,0;;20,0;;;;;10,0;;;;;3,0;;;;1,0;;;;6,0;;;;5,0;18,0;;;1,0;1,0;4,0;;;4,0;2,0;;;9,0;;4,0;;;;1,0;;;;;;2,0;;5,0;1,0;;;;;;;;;;16,0;;;;23,0;;;7,0;;;1,0;;;;4,0;;;;;2,0;2,0;;1,0;;;;;;;14,0;;;4,0;;;;;1,0;;;;;;;;;;22,0;;;2,0;;;;5,0;;;;2,0;9,0;9,0;;;31,0;;;;;;1,0;;;1,0;18,0;;3,0;;9,0;;6,0;;;;;;;;;;;4,0;2,0;;;;;;42,0;;24,0;2,0;;;;;;79,0;;2,0;1,0;;;;;;;;;;;;;2,0;;6,0;7,0;2,0;;5,0;;;23,0;;;;;;;;;;;;;1,0;;;;;;3,0;;;4,0;;;;;;;;;1,0;;;2,0;1,0;4,0;;;40,0;1,0;8,0;1,0;;;99,0;;;;2,0;;;1,0;;;;;;10,0;;;;;12,0;;;;;;;;18,0;;;;;;;;;;;;;;;;;;1,0;;;;;;;;;;;;1,0;1,0;;5,0;;;;17,0;31,0;;;;;4,0;;;;;;;;;;1,0;;;;;;;1,0;;1,0;;;;;;;;;1,0;54,0;;;2,0;2,0;;;1,0;;2,0;;;;;;;;;;;;;;;;35,0;;;;;;;;1,0;;;13,0;;;;;;;;;;2,0;;;;;;3,0;10,0;;1,0;35,0;;;;;;3,0;;;;;;;;10,0;;;;;;;;6,0;1,0;;;;11,0;;21,0;45,0;;;1,0;28,0;24,0;;;8,0;;;;;;4,0;;2,0;;2,0;;;16,0;;;;18,0;;;;9,0;1,0;;;;;293,0;7,0;;;;;6,0;;;;;;;;;1,0;1,0;;4,0;;;;1,0;;;;;;;;;8,0;;;;;;;;;;;4,0;;;;;;1,0;2,0;;;;1,0;;;3,0;;;;;;;;;;;;;;;;;2,0;;;;;;;;;;;;;;;;;1,0;1,0;;;1,0;;;;;;;;;;;;2,0;;;;;;3,0;;;;;;;;;;;3,0;;;3,0;;;;54,0;;;;;;;;;;;;20,0;;1,0;2,0;;;;;;;;;;;;;;;;;;;;;9,0;;;3,0;;;;;;2,0;;;;;;;;;;;;;;;;;;;;;;;;;;;;;;;;;;6,0;;;;;;;;;;;;;;;;;;;;1,0;;;;;14,0;1,0;4,0;;;;;6,0;;;3,0;;;;1,0;;;1,0;;;;;;;;;;;;;;;;;;;;;;;;;;;;;;;;
gaze;;;;;1,0;;;1,0;;1,0;;;;;;;;;;;;;1,0;;;;;;;;3,0;;2,0;;;;;1,0;;1,0;6,0;;;;;;;;;;;1,0;;;;3,0;1,0;;;;;;;;;;;;;;;;;;;;;27,0;;;;1,0;;;;;;;;2,0;;;;;;1,0;;;;;;3,0;;;;;;1,0;;;;;;;;;;;;;;;;;;;;;;;;;;;;;;;;;;;;;;;;;;;;;;;;;;;;;;;;;;;;3,0;;;;;3,0;;;;;;;;;;;;;;;;;;;;;;;;;;;;;;;;;;;;;;;;;;;;;;;;;;;;;;;;;;;;;;;3,0;;;;;;;;;;;;;;;;;;;;;;;;;;;;;;;;;;;;;;;;;;;;;;;;;;;;3,0;;;;;;;;;;;;;;;3,0;;1,0;;;;;;;;;;;;;;;;;;;;;;;;;;1,0;;;;;;;;;;;;;;;;;;;;1,0;1,0;;;;;;;;;;;;;1,0;;;;;;;;;;;;1,0;;;;;;;;;;;;;;;1,0;;;;;;;;;5,0;;;;;;22,0;;;;;;;;;;;;;;;;;;;;;;;;;;;;;;;1,0;1,0;;;;;;;;;;;1,0;;;;;;;;;;;;;;;1,0;;;;;;;2,0;;5,0;;;;;1,0;;;;;;;;1,0;;;;;;;;1,0;;1,0;;;;;;;;;;;;;;;;;;;;;;;;;;;;;;;;;;;;;;;;;;;;;;;;;;;;;;;;;;;;1,0;;;;;;;;;;;;;;;;;;;;;;;;;1,0;;;;;;;;;;;;;;;;;;;;;;;;;;;;;;;;;;;;;;;;;;;;;;;;;;;;;;;;;;;;;;;;;;;;;;;;;;;;;;;;;;;;;;;;4,0;;;;;;;;;;;;;;;;;;;;;;;;;;;;;;;;;;;;;;;;;;;;;;;;;;;;;;;;;;;;;;;;;;;;;;;;;;;;;;;;;;;;;;;;;;;;;;;;;;;;;1,0;;;;;;;;;;;;;;;;;;;;;;;2,0;;;;;;;;;;;;;;;;;;;;;;;3,0;;;;;;;;;;;;;;;;;;;;;;;;2,0;;;;1,0;;;;;;;;;;;;;;;;;;;;;;2,0;;;;;;;;;;;;;;;;;;;;;;;;;;;;;;;;;;;;;;;;;;;;;;;;;;;;;;;;;;;;;;;;;;;;;;;;;;;;;;;;;;;;;;;;;;;;;;4,0;;;;;;;;;;;;;;;;;;;;;;;;;;;;;;;;;;;;;;;
generator;;;;;29,0;;2,0;4,0;5,0;;;3,0;;;5,0;;;;2,0;;;26,0;;;;;2,0;21,0;;1,0;5,0;7,0;7,0;3,0;10,0;1,0;;38,0;;5,0;2,0;;8,0;1,0;;1,0;;;;2,0;;99,0;;;;52,0;15,0;;2,0;44,0;;;3,0;1,0;3,0;;7,0;;;7,0;1,0;;;2,0;;;;;7,0;2,0;;4,0;1,0;7,0;;;;2,0;1,0;2,0;5,0;;;112,0;;;;;3,0;;2,0;7,0;;3,0;;;1,0;18,0;;;1,0;8,0;;3,0;4,0;2,0;;;4,0;14,0;;;;3,0;;;45,0;;;1,0;;6,0;;;8,0;6,0;5,0;;;;1,0;;;;;42,0;3,0;18,0;2,0;;;;;;;3,0;1,0;;;5,0;1,0;;4,0;;2,0;;1,0;;;;6,0;;10,0;;5,0;;;25,0;;;2,0;1,0;1,0;;;;;9,0;;4,0;;;;22,0;;;;;;4,0;;;;29,0;;3,0;15,0;10,0;4,0;24,0;3,0;;;;;86,0;7,0;;;;;;;;;;;;;;;;;;;;;2,0;4,0;;19,0;;12,0;;;1,0;;;;5,0;;;;8,0;;;;3,0;;;;25,0;1,0;;3,0;;;;;;;;;;1,0;;;;;;;8,0;;;;5,0;6,0;1,0;4,0;;;;3,0;3,0;2,0;;;2,0;;4,0;3,0;;5,0;1,0;1,0;;;1,0;;4,0;4,0;3,0;;;;;;;;;;;;;;8,0;3,0;;5,0;;;;;;;;;;;;;3,0;;;;4,0;;;;2,0;;10,0;;;;;;;;;;;;;1,0;2,0;;;;;;;1,0;2,0;;5,0;;;;;6,0;;;;18,0;;;;;3,0;;;;;;;13,0;;;;;;;;5,0;;;1,0;;;;;;11,0;;;;;6,0;;1,0;;;;14,0;;6,0;;;1,0;2,0;;;;;;;;;1,0;;;;3,0;;10,0;;1,0;5,0;2,0;;;63,0;;;1,0;;;;;1,0;;;1,0;;2,0;6,0;;1,0;;;5,0;;;;;;;;;3,0;1,0;;;;;4,0;;7,0;5,0;13,0;4,0;;;8,0;1,0;;3,0;;;;25,0;;;;;;;;;;;;13,0;8,0;;;;;;;;;;;;;;;;;;;;;21,0;;;;;;;;;;;;;;;;;;1,0;;;;3,0;;;6,0;;;;;;5,0;4,0;;;;;;;;;;;;;;13,0;;;2,0;3,0;;;2,0;;1,0;;;;;;;;;;;;3,0;;;;;;;;;;;;;;;;1,0;;1,0;;;;;;;;2,0;;;;;;;;;;;;;;;;;4,0;;;;;;1,0;;;2,0;;;;1,0;;;;2,0;;;;;1,0;;;;;;1,0;2,0;;;;;;;;;1,0;;;;;;;;;;;;;2,0;2,0;;;1,0;;;;;;;;;2,0;;;;1,0;;;;1,0;;;;;;;;;;;;;;5,0;1,0;;;;;2,0;;;;;;6,0;;;;3,0;;;;;2,0;1,0;;6,0;7,0;;;;;;;5,0;;;;;;;;;;;;3,0;;;;;;;;;;;1,0;;;;;;;3,0;;;;;1,0;;;;;;;2,0;;;;;;;;;6,0;;1,0;;;;;;;;;;;;;;;2,0;;;;;2,0;2,0;1,0;;;10,0;3,0;;1,0;3,0;;;;;;;;;4,0;;;;;;;;;;;;;;;;;;;;;;16,0;;;;2,0;;;;;;;;;;;;;;3,0;;;;;;;;;;;;;;;;;;;;;;;;;;;;;;1,0;;;;;1,0;4,0;;;;;;;;;;;;;;;;;;;;;;;;;;;;;;;;;;;;;;;1,0;;3,0;;4,0;;;;;;;;;;;;;;;;;;;;;;;;;;
geometric;;;;;3,0;;9,0;15,0;3,0;10,0;5,0;;;;8,0;;;;3,0;4,0;;;1,0;;6,0;;;5,0;3,0;24,0;;14,0;6,0;;1,0;2,0;;;;;;;;;;;;;;;17,0;3,0;;;;53,0;4,0;;29,0;8,0;;;23,0;;6,0;;2,0;2,0;;;1,0;;1,0;;;;;10,0;25,0;;;1,0;4,0;;1,0;;;;2,0;13,0;5,0;;;3,0;;1,0;;;3,0;2,0;10,0;28,0;;1,0;1,0;;;3,0;;;;12,0;8,0;;;;;;;;;;;;;;6,0;;;;;;;;3,0;;4,0;;;1,0;;;;;;;13,0;;;;;;;;;;2,0;;;2,0;;;;;;;;3,0;;;;;2,0;;;;;;;;;;4,0;;;7,0;;8,0;;6,0;;;;2,0;;;;;;;;56,0;;;;;;1,0;;2,0;4,0;2,0;;;3,0;3,0;;;;;;15,0;;;;;;;;;;;;;4,0;9,0;;2,0;3,0;;3,0;2,0;;;;;;;;;;;;;;;;;1,0;;;;1,0;1,0;;;;;;3,0;;;;;;;;;;;;;;;;;;30,0;;;;;;41,0;;;;;1,0;;;;;11,0;3,0;;;1,0;;;;1,0;;;;;;;;;;;;;;7,0;;;;1,0;6,0;;;;;;;2,0;1,0;;;;;;;;2,0;;;3,0;;;1,0;;;;;;;;12,0;;;;;;6,0;3,0;;;;;;1,0;3,0;;1,0;;;;;;15,0;1,0;;;;2,0;2,0;;;;;;;;;30,0;2,0;;1,0;;;;;3,0;;;;;;1,0;1,0;;;;40,0;;;;4,0;;;;;;;;6,0;;1,0;;;;;;;;2,0;;;6,0;;;;;;;;;;1,0;6,0;;;;;;7,0;;;;;;3,0;;;;;;;4,0;;;;;;;;3,0;;;;2,0;;;;2,0;2,0;;;;;;3,0;4,0;;;;;;;;1,0;15,0;;;;;;;;;;;;;;;;;;;;;;;;;;;3,0;;;;;;;;;;;;;;;;;;;1,0;;;4,0;;;1,0;;;;1,0;;;;;;;;;;;;;;;;;;;;;;;;;;;;;;;;;4,0;;;;;;;;;;;;;;;;;;;;;;;;;;2,0;;;;;;;;;6,0;;;;;;;;2,0;;;;;;;;;;;;;;;;;;;;;;;;6,0;;;;;;;;;2,0;;;;;4,0;;;;;;;;;;1,0;;;;;;;;2,0;;;;;2,0;;;;;;;;2,0;;;;1,0;;;;;;;;;;2,0;;;;;;;;;;;1,0;;1,0;3,0;;1,0;;;;;;;;;6,0;;2,0;3,0;;1,0;;;;1,0;5,0;;18,0;;;11,0;;;3,0;;1,0;;;;;;;;;;;;;;;;;;;;;4,0;;;;;;;;;;4,0;;;;;;;;;;;;;;;;;;2,0;;;;;;;;;8,0;;;;;;;;;;;;;;2,0;;;;;;;;;;;;;;;;;;;;;;;6,0;;;;;;;;;;;;;;;;;3,0;;;;;;;;;;;;;;;;;;;;;;;;;;;;;;;;;;;;;;;;;;;;;;;;;;;;;;;6,0;;;;;;;;;;;;;;;;1,0;;;;;;;;;;;;;;;;;;;;;;;;;;;;;;;;;;;;;;;;;;;;;;;;2,0;;;;
gesture;;;;;5,0;;;21,0;;6,0;;2,0;;;;;;;2,0;2,0;;18,0;;;;;;3,0;;12,0;;13,0;9,0;;6,0;;;2,0;;;;;;;;;;;2,0;;;3,0;;;;28,0;6,0;;;5,0;;;25,0;;;;2,0;;;8,0;;;;;;;;1,0;2,0;;;5,0;;;;;;;;4,0;1,0;14,0;;;;;;;9,0;;;3,0;;;;;;5,0;;;;;;;;;;;;1,0;;;;;;;7,0;;;;;;;;;1,0;;;;;;;;;;;;;;;;;;;;;;;;5,0;;;;;;;;;;;;;1,0;;10,0;;;6,0;;;;;;;;;;24,0;;1,0;;;;13,0;;;;;15,0;;;;;;;;;2,0;;;;;;;;;;;;;;;;;;;;;;;;;;;;;;3,0;6,0;;;;;;;;;;;;;;;;;;;1,0;;;;;;;;3,0;;;;;;2,0;;;;6,0;;;;;;;;;;9,0;;32,0;;;;;;1,0;;;;;;;;;4,0;;;;;;;;17,0;;;;;;;;;;;;;;;;;;;;34,0;;;;;;;;;;;8,0;;;;;;;;3,0;;20,0;;;;;;;;;;1,0;;;18,0;3,0;;;;;;;;;4,0;2,0;;;;;;;1,0;1,0;;;;;1,0;3,0;;2,0;;;;;4,0;;;;;;;;;;;;4,0;;;3,0;;;;;1,0;;13,0;;;6,0;;11,0;;;;;;;1,0;;;;;;;1,0;;;;;;;;;;;;;;;;;;;1,0;3,0;1,0;;;;;;;;;;;;;14,0;;;;2,0;;;1,0;9,0;;;;;;;;;;;;;;;;;;;;;;;;;;;;;;;;;;;6,0;;;;;;;;;;;;;;;;;;;;;;;23,0;;3,0;;;;;;;;;;;4,0;;;;;;;;;;;;;;;;;;;;;;;;;;;;;;;;;;;6,0;;;;1,0;;;;;;;;;;;;;;;;;;;;;;;;;;;;;;;;;;;;;;;;;;;;;;;;;;;;;;;;;;;;;;;;;;;;;;;1,0;;;;;;;;;;;;;;;;;;;;;;1,0;;1,0;;;;3,0;;;;;;;;;;;;;;;;;;;;;;;;;;;;;;;;;;;;;;;;;;;;;;;;;;;;;;;;;;;;;;;;;;;;;;;;;;;;;;;;;;2,0;;;;;;;;;;;;;;;;;;;;;;;;;;;;;1,0;;;;;;;;;;;;;;;;;;2,0;;;;;;;;;;;;;;;;;;;;;;6,0;;;;;;;;;;;;;;2,0;;;;;;;;;1,0;;;;;;;;;;;;;;;;;;;;;;;;;;;;;;1,0;;;;;;;;;;;;;;;;1,0;;;;;;;;;;;;;;;;;;;;;;;;;;;;;;;;;;;;;;;;;1,0;;;;;;;;;;;;;;;;;;;;;;;;;;;;;;;;;;;;;;;;;;;;;;;;;;
gimbal;;;;;2,0;;19,0;46,0;;;2,0;;;;;;;;;;;4,0;;;;;;;1,0;;;;2,0;;;;;;;;;;10,0;;;;;;;;;;;;;;5,0;;;7,0;1,0;;;;;;1,0;;;;6,0;;;;5,0;;;1,0;;;;;;;;;;;;;;;;;;;;;;;;;;2,0;;;;;;;1,0;;;;11,0;1,0;;;;4,0;;;;;;;;1,0;;10,0;19,0;;;;;;;;;;;;;;;2,0;4,0;19,0;;;;5,0;1,0;;;;4,0;;;;;;1,0;;;;;;;;21,0;;10,0;2,0;4,0;;1,0;;;;;;;;1,0;;;2,0;;9,0;;1,0;;1,0;;;;;5,0;;;4,0;;;;;;;14,0;18,0;;1,0;;;13,0;;;2,0;;;;;;;;;;;;;;;;1,0;1,0;2,0;;;;;;5,0;;;;;;;;;;;;1,0;;;;;;;;;2,0;6,0;;;;;;;;;;;;;;;;1,0;;;;39,0;;;2,0;;;;;;;;;5,0;;;;2,0;;;;;;;;;;;;;;;5,0;;6,0;;2,0;;;;;1,0;;;;;;;;;9,0;;;;;;;;;;;;;;;;;1,0;;;;;;;;;3,0;;;;;;;;;;1,0;;;;;;;;;;;2,0;;;;;;;;;;;;;1,0;5,0;;1,0;;;;;1,0;;1,0;;;;;;;;1,0;1,0;;;;;;;2,0;;;;;;;;;;;;;;;;;;;;;;;;;;;;;;;;;;;;;;;;;;;;;;;;2,0;;;;;;;;;;;;;;;;;;;2,0;;;;;;;;;;1,0;;;;;;;;;;;;;;;;;;;;;;;;;;;;;;;;;;;;;;;;;1,0;;;;;;;;;;1,0;;;;;;;;;;;;;;;;;;;;6,0;;;;;;;;;;3,0;;;;;;;;;;1,0;;;;;;2,0;;;;;;;;;;;;;;;;;;;;;;;;1,0;;;;;;;;;;;;;;;;;9,0;;;;;;;;;;1,0;;;;;;2,0;;;;;1,0;;;;1,0;;;;;;;;;;;;;;;4,0;;;;;;;;;;;;;;;;;;;;;;;;;;;;;;;;;;;;;;;;;;;;;;;;;;;;;;;;;;;;;;;;;;;;;;;;;;;;;;;;;;;;;;;;;;;;;;;;;;;;;;;;;;;;;;;1,0;;;;;;;;;;;;;;;;;;;;;;;;;;;;;;;;;;;;;;;;;;;;;;;;;;;;;;;;;;;;;;;;;;;;;;;;6,0;;;;;;;;;;;;;;;;;;;;;;;;;;;;;;;;;;;;;;;;;;;;;;8,0;;;;;;;;;;;;;;;;;;;;;;;;;;;;;;;;;;;;;;;;;;;;;;;;;;;;;;;;;;;;;;;;;;;;;;;;;;;;;;;;;;;;;;;;;;;;;;;;;
glass;;;;;2,0;8,0;2,0;3,0;;1,0;4,0;1,0;1,0;;2,0;;;;8,0;;2,0;;;;;;;4,0;8,0;;;;20,0;;4,0;;;1,0;;6,0;;;;31,0;;;;;1,0;;2,0;;;2,0;;43,0;28,0;;1,0;108,0;1,0;;14,0;;;;;3,0;;;65,0;;3,0;;;;;;14,0;2,0;6,0;1,0;;;1,0;3,0;2,0;;2,0;8,0;15,0;;1,0;6,0;;3,0;;3,0;1,0;18,0;37,0;8,0;;;;;7,0;;3,0;19,0;1,0;14,0;;3,0;7,0;;7,0;;12,0;2,0;12,0;;;1,0;2,0;;10,0;5,0;;3,0;32,0;;16,0;;1,0;2,0;8,0;;;2,0;;;;2,0;27,0;;27,0;;;;;;;;11,0;2,0;4,0;9,0;2,0;8,0;5,0;;;;;24,0;1,0;15,0;;50,0;5,0;2,0;30,0;4,0;;1,0;4,0;1,0;8,0;12,0;;4,0;2,0;;;11,0;39,0;13,0;;15,0;4,0;;;4,0;;2,0;7,0;;4,0;;2,0;;1,0;6,0;;3,0;;;3,0;;;3,0;;1,0;;3,0;10,0;21,0;;3,0;2,0;43,0;;;1,0;;18,0;;;;;;;;;2,0;;;6,0;;6,0;;;;;;;1,0;;;;;1,0;5,0;2,0;;;8,0;;;;;;;1,0;;1,0;;;;;15,0;8,0;;;;;;;5,0;;;;;6,0;;;5,0;;;;2,0;;;;1,0;;6,0;;;;;;;;;;;2,0;;;;;;1,0;;;;;;;;;;1,0;3,0;2,0;;;;10,0;;;;;;;;;;;2,0;;;;;;1,0;;;1,0;;;;;;;;;;;;;;;1,0;;;1,0;1,0;;1,0;;;;3,0;;;;3,0;1,0;;;;;;;;;;;;1,0;;2,0;1,0;;;;3,0;;;1,0;;;;;;;;14,0;1,0;2,0;3,0;;;;;1,0;;1,0;;1,0;;;;1,0;;;1,0;;;2,0;;;;;;6,0;;;;4,0;;;;;3,0;;;;;6,0;3,0;;;;;;;;;;;;1,0;1,0;;;;;;;;;;;;;;;;;;;18,0;21,0;;;;;;;;;7,0;15,0;;;;;;;;2,0;1,0;;3,0;;;5,0;;;;1,0;2,0;6,0;;;;;;;7,0;;;;;1,0;;;;;;;;;;;;;1,0;;5,0;2,0;;;16,0;;;;1,0;2,0;;;;;;;8,0;;;;;;;1,0;;;;;;;;5,0;;1,0;;;13,0;;;;;;;;;;;3,0;1,0;;;;;1,0;;2,0;;;;;4,0;;;;;;;;;;;;;;4,0;5,0;2,0;;;;;;;;;;;;;;;;4,0;2,0;;;;;;;35,0;;;2,0;;;;;3,0;;;;;;;;;;;;;;;;;;2,0;;;;1,0;;;12,0;3,0;;;;;;;;;;;;;;1,0;;;;;;3,0;1,0;;;;;;;;;1,0;;1,0;;;;;;;;;;;1,0;;;;;;;;;;;;;1,0;;;;;;;;;;;;;1,0;;5,0;;;;2,0;;;;;;;9,0;;;;;;5,0;;;;;;2,0;4,0;;;;;;;;;;;3,0;;;;;;;;;;;;;;;;;;;;;;;;;;;;;;2,0;;;;;;;;;;1,0;;;;;4,0;;;2,0;2,0;;4,0;;;;;;;;;;;;;1,0;;;1,0;;;;;;;;;;;;;1,0;1,0;;;;;;2,0;;;;;2,0;;;;;2,0;;;;;5,0;;1,0;;;;;;;;;;;;;;;;;;;;;;;;;;;;;;;;;;;;;;;;;;1,0;;;;;;;;;;;;;;;;;;;;;;;;;;1,0;;2,0;;;;;;;;;4,0;3,0;;;;12,0;;;;;;;;;;;;;;;;;;;;;;1,0;;;;;;
gradient;;;;;1,0;;;3,0;6,0;2,0;4,0;;;;;;;;4,0;1,0;;1,0;;;;;;;;1,0;;1,0;;3,0;6,0;4,0;;6,0;;;1,0;;3,0;1,0;;;;;;;2,0;;;;;17,0;4,0;;;5,0;;;10,0;1,0;5,0;;;;;;1,0;;;;;;;2,0;3,0;;;2,0;2,0;2,0;;;1,0;;;3,0;;;;2,0;;;;;1,0;;19,0;3,0;;2,0;;;;1,0;;;;;;1,0;;;;;1,0;;;;3,0;;;;1,0;;;;;;;;;;2,0;;;;;;;1,0;5,0;;3,0;1,0;;;;1,0;;;;;;;;;;7,0;;;;1,0;;;;;;1,0;;;;;;;;;;;;;;;;6,0;;;;;;;;1,0;1,0;;;;;;;4,0;;;;;;;;;;;1,0;;;;;;;;;;;;;;1,0;;;;;;;;;5,0;9,0;2,0;1,0;;;;;;;;;;;1,0;;;;;;;;;;;9,0;;;;;;;;;;;;;;;;;4,0;2,0;;;2,0;;;;;;2,0;;;;2,0;;;;;;;;;;1,0;;;;;;;;;;;;;;;;;;;;;3,0;;;;;;;2,0;;;;;;;;;;1,0;;;;;2,0;;;1,0;;;8,0;;;;;;;;1,0;;;;;;;;;;;;1,0;8,0;;;;5,0;;2,0;;;;;;;;;;;;;;;;;;;2,0;;;;;;;;;;;;;;;;;;4,0;;;;2,0;;;;;;;;1,0;;;;;;;;;;;;;2,0;;2,0;;;;;3,0;;;;;;;;;;;;;;;4,0;;;;4,0;;;;1,0;;;;;;;;;;;;;;;;;;;;;;;1,0;;;3,0;;;;;2,0;;;;;;;;;;;;;;;;;;;;4,0;;;;2,0;;;;;;;;;;;;;;;;;;;;;;;;;;;;;;;;;;3,0;2,0;;;;;1,0;;;;;;;;;;2,0;;;;;;;;;;;;;;;;;;;;;;1,0;;;;;;;;;;;;;;;;;;;;;;;;;;;;;;;;;;;2,0;;;;;;;;;;;;;;;;;;;;;;;;;;3,0;;;;;;1,0;;;;;;;;;2,0;;;;;;1,0;;;;;;2,0;;;;;2,0;;;;;;1,0;;;;;;;;;;;;;;;;;;;;;;;;;;;;;;;;;;;;;;;;;1,0;;16,0;;;;;;;4,0;;;;;;;;;;;;;;;;;;;;;;;;;;2,0;;;2,0;;;;;;;;;;;;;;;;;;;;;;;1,0;;;;;;;;;;;;;;;;;;2,0;;;;;;;;;;;;;;1,0;1,0;;;;;3,0;;;;;;;;;;;;;;;;;3,0;;;;;;;;;;;;;;;;;;;;;;;;;;;;;;;;;;;;;;;;;;;;;;;;;;;;;;;;;;;;1,0;;;;;;;5,0;;;;;;;;;;;;;;;;;;;;;;;;;;;;;;;;;;;1,0;4,0;;;;;;;;;;;;;;;;;;;;;;;;;;3,0;;;2,0;;;;;;;;;;;;;
graphic;;;;;9,0;;;2,0;;2,0;;;;;;;;;;33,0;;1,0;1,0;;;;;25,0;;;;;9,0;;4,0;10,0;;;1,0;32,0;1,0;;2,0;11,0;;;2,0;;;1,0;;2,0;;1,0;1,0;55,0;2,0;;;1,0;;;17,0;;28,0;;3,0;;;1,0;1,0;1,0;;;;2,0;;4,0;2,0;;;29,0;32,0;;;;3,0;;;2,0;;;2,0;3,0;;;;;1,0;;3,0;20,0;;;;;;15,0;;;1,0;;4,0;;2,0;;;;1,0;;;;;2,0;;;1,0;;;;;5,0;;;;;;;;;;11,0;;;;;;6,0;;;;;;;;1,0;;1,0;;;;;;;;;;;;;;;2,0;;;;;5,0;;;2,0;;;;;4,0;;4,0;;2,0;;;;;;;;;;;;;;;;;;;;;;1,0;;;;;;;;;;2,0;;;;;;;;;;;;;;1,0;;2,0;;;;;;;;3,0;;;;;;;;6,0;;;;3,0;;;2,0;;;;;;2,0;;;;;;3,0;;;11,0;;;;6,0;;;;;;;;12,0;;;;;;1,0;;;;;;;;;1,0;;1,0;;;1,0;;;;;;;;;;;;;;1,0;;;;;;;;;6,0;;;;;;;;;;;;;;;6,0;;;;;;1,0;;;;;;;;;;;;;1,0;1,0;1,0;;;;;;;;;4,0;1,0;;;3,0;;;;;;;;;;;;;;;;;;1,0;;;1,0;;;;;;2,0;;;;1,0;;;6,0;1,0;1,0;;;;;;;1,0;;2,0;;1,0;;;;;;;;;;;;;;;2,0;;;;12,0;;;;;1,0;;1,0;;;;;;;;;;1,0;;;4,0;;;3,0;;;2,0;;;;;3,0;;;;1,0;1,0;;;;;2,0;1,0;;;;;;;8,0;1,0;;;;;;1,0;;;;;;;;;;;;1,0;1,0;;;3,0;;;;;;;1,0;;3,0;;;;;;;;;;;;;;;;;;;;;;;;2,0;;;;;;2,0;;;2,0;12,0;;;;;;;;;;;;2,0;;;;;;;;;;;;;;;;;;;;;;;;;;;;;;;;;3,0;;;;;;;;;;;;;;;;;;1,0;;;;;;;;;1,0;;;;;;;;;;;;;;;;;;;;;;;;;;;;;;;;;;;;;1,0;;;;;;2,0;;;;;;;;1,0;;;;;;;;;;;;;;;;;;;;;;;;;;1,0;;;;;;;;;;;;;;1,0;;;1,0;;;;1,0;;;;;;;;1,0;;;;;;4,0;;;;;;;;;;;;1,0;;;;;;;;;;;;;;1,0;;;;;;;;;;;;;;;;;;;;;;;1,0;;;;;;;3,0;;;1,0;;11,0;;5,0;;1,0;;;1,0;;;;;;;;;;;;;;;;;;;1,0;;;;;;;;;;7,0;1,0;;;;;;;;;;;1,0;;;;;;;;;;;;;;;;;;;;;;;;;;;;;;;;;;;;;;;;;;;;;;;;;;;;1,0;;;;;;;2,0;;;;;;;;;;;;;;;;;;;;;;;;;;;;;;;;;;6,0;;;;;;;;;;;;;;;;;;;;;;;;;;;;;;;;2,0;;;;;;;;;;;;;;;;;;;;;
ground;;;;;10,0;;1,0;3,0;2,0;;1,0;;;;;;2,0;;2,0;4,0;2,0;11,0;5,0;1,0;;;;4,0;;6,0;;15,0;9,0;2,0;;;;12,0;;3,0;4,0;;9,0;18,0;;;;;;;5,0;2,0;;;12,0;21,0;25,0;;1,0;19,0;;;27,0;;;11,0;10,0;;;;6,0;;1,0;;;;2,0;20,0;7,0;31,0;3,0;2,0;2,0;1,0;;;2,0;;1,0;;12,0;;1,0;10,0;;5,0;;;;24,0;20,0;7,0;;;;;3,0;24,0;;;2,0;1,0;;3,0;1,0;;3,0;;18,0;12,0;;;;23,0;;;;43,0;;26,0;4,0;;;;;;5,0;;2,0;;;;2,0;9,0;;;20,0;5,0;;8,0;;;;;;8,0;6,0;20,0;;8,0;;;2,0;2,0;;6,0;5,0;5,0;;10,0;6,0;;23,0;15,0;;;;;2,0;;;1,0;6,0;;;43,0;9,0;9,0;;17,0;;;;5,0;;;;;10,0;4,0;;;18,0;14,0;;;;1,0;7,0;10,0;;;;;4,0;2,0;2,0;1,0;;;;31,0;;;;;4,0;;2,0;2,0;;;;2,0;;13,0;;;3,0;;3,0;;;13,0;3,0;;;7,0;;1,0;;;12,0;75,0;;;;12,0;;;;;;1,0;6,0;;6,0;;;2,0;;1,0;;2,0;1,0;3,0;;;;5,0;;;;;;;;12,0;;;;;;12,0;;2,0;3,0;4,0;;;1,0;;;;;2,0;;1,0;2,0;1,0;7,0;;;;;;2,0;;;;;6,0;1,0;;;5,0;;16,0;14,0;5,0;;;1,0;;;;;;;1,0;3,0;1,0;;;;;;1,0;;;1,0;2,0;;;1,0;;;;;;3,0;;;;8,0;;;;;;;1,0;;;;;;;;6,0;1,0;1,0;2,0;;;;;1,0;;;;;;;2,0;;;;;;1,0;;2,0;4,0;1,0;;;;;;;1,0;;;;;14,0;;;;13,0;;;1,0;;;;2,0;;;;;;;;;;;;;;;;;;;;;;;;;8,0;;;;;;;;;;;;;3,0;;;;;;1,0;;3,0;;;1,0;1,0;;2,0;;;;;;;;;;;;;;;3,0;3,0;2,0;8,0;;;;;;;;;;;;11,0;;;;;1,0;1,0;1,0;;;;;;;;;4,0;;;;;;;5,0;;;;;;;;;;;;;;66,0;2,0;;;;;;;;;;;;;1,0;10,0;;;;;10,0;;;;4,0;;;;;;;;3,0;;;;;1,0;;24,0;;;;;;;;;;3,0;;;;1,0;1,0;;;4,0;1,0;;;1,0;8,0;;;12,0;;;;;2,0;;;;;;;2,0;;;;;;;;21,0;1,0;;;8,0;;1,0;2,0;;;;;;;;;;1,0;;;2,0;;;;;5,0;;;;;;;;;2,0;;1,0;4,0;;;;;;;1,0;;;;;;;;;;3,0;;1,0;;;;1,0;;;;1,0;;;;;;;;1,0;;;;;;2,0;;;;;;;11,0;;;;;;;;;;;;;;2,0;;;;;;;1,0;;;;;;;;;;;;;;;;2,0;;2,0;;;;;;;;;;1,0;;;;;1,0;;;;;6,0;;;;1,0;;;;1,0;;;;;;;;;;4,0;;;;;;;;;;;;;;;;;;;;;;;;;;;;;;;;;;;;;1,0;;;;;;;;;;;;;;;;6,0;;;;;;;;;;;;;;;;;;;;;4,0;;2,0;;;;;;2,0;;;;;;;;;;;;;;;;2,0;;;;;;;;;;;;3,0;;;;3,0;;;;;;;;;;;;;;;;;;;;;;;;;;;;;;;;;;;;;;;;;;;;;;;;;;;;;;;;;6,0;;;;;;;;;;;;;;;;;;;;;;;;;;;;;;;;;;;
half;;;;;2,0;;14,0;12,0;4,0;;;;2,0;;;;;;2,0;;;2,0;1,0;18,0;2,0;;;3,0;138,0;5,0;;2,0;;;1,0;1,0;2,0;7,0;;;14,0;;3,0;97,0;;;;1,0;3,0;;1,0;2,0;;3,0;10,0;70,0;11,0;;10,0;174,0;1,0;;13,0;;;;10,0;;2,0;6,0;34,0;;1,0;5,0;1,0;2,0;;;23,0;;;;1,0;;;;12,0;;4,0;1,0;6,0;9,0;;4,0;5,0;10,0;;1,0;2,0;;18,0;8,0;;;;;2,0;71,0;;;1,0;2,0;;;;;;1,0;;;;;;;;;;6,0;;6,0;2,0;;1,0;;;4,0;6,0;;;;;;;;1,0;;19,0;8,0;;;2,0;1,0;;;;;1,0;5,0;;10,0;14,0;;1,0;;;;;18,0;;;3,0;44,0;1,0;4,0;1,0;;;;;;7,0;;4,0;;1,0;;1,0;5,0;;22,0;;1,0;;;;11,0;;;4,0;;;5,0;;2,0;;;;;;3,0;;;;;;;;;;;4,0;;;;;2,0;14,0;;;;;2,0;;2,0;;178,0;;;2,0;5,0;;;1,0;7,0;;;;;;;;;;;;;;1,0;;;2,0;;1,0;;;;;;;;;;;2,0;;;;;19,0;10,0;;2,0;2,0;;87,0;;2,0;3,0;;;1,0;;2,0;;;;;4,0;8,0;2,0;;;2,0;2,0;;;;2,0;;;11,0;1,0;;;;;;;;;;;;;;;;;;;;;;;;;;;;4,0;3,0;;;;;;;;;;11,0;;;;;;;;;;;;;;;;;;;;;;2,0;1,0;;1,0;;;172,0;3,0;8,0;1,0;;;;;;1,0;;;10,0;2,0;;;44,0;;;38,0;;;;;;;;;;1,0;;;1,0;;;;;;;;18,0;1,0;;;;;3,0;;;;1,0;;;;;;;;;;;;18,0;;;;;;;;;;;;7,0;;;;;1,0;1,0;;;;;7,0;;;;;;;;2,0;;;;;3,0;;;;;;;;;;1,0;;;2,0;;1,0;;2,0;;175,0;3,0;;1,0;;;;;;6,0;;;10,0;;;6,0;;;;;;;;;;;;;1,0;;;;;;;;;2,0;;;2,0;;;;2,0;;;;;5,0;;;;;;;;;;;;;;;;25,0;;;;;;;;;;;;;;;;3,0;;;;;;7,0;;;;7,0;;;;;;;;;;;;;;;;26,0;;;;;;;2,0;;;;;;;;;;;;1,0;;;;;;;;;;8,0;;;;;1,0;;;;;;;;;;;;2,0;;;1,0;;;;;;1,0;2,0;;;;;;;;;4,0;;;;;;10,0;2,0;;;;;;;;;;;;;;;;;;;;2,0;;;1,0;4,0;;;;;1,0;2,0;;;;;5,0;;2,0;1,0;;;;;3,0;;;1,0;;;;;;;;;;;4,0;;;;;;;;;;;;2,0;;;;;2,0;;1,0;;;;;;;;11,0;;;1,0;;1,0;;2,0;;1,0;;;;;2,0;;;1,0;;;;;;;;;;;5,0;;1,0;;;1,0;;;;;2,0;2,0;;;;1,0;;;;;;;;;;;;;;;;;;;;2,0;3,0;;4,0;3,0;;;;;2,0;;;;;;;;;;;;;;;;;;;;15,0;;;;;;;;;1,0;;;;;;;;;;;;;;;;;;;;8,0;;;2,0;;;;;;;;;;;;;;;;;;;2,0;;;;;;;;;;;;;2,0;;;;;;;;;2,0;;;;6,0;;;;;;;;;;;;;;;;;;;;;;;;1,0;;;;;;;8,0;;;;;2,0;;;4,0;;;;;1,0;;;;3,0;;;;;;40,0;;;;;;;;;;;;;;7,0;;;;
held;;;;;3,0;;5,0;14,0;1,0;15,0;3,0;1,0;;;2,0;;;;10,0;;;;;;;;;17,0;;3,0;1,0;;51,0;6,0;32,0;;4,0;11,0;;10,0;3,0;;2,0;4,0;;;1,0;;;;6,0;1,0;;6,0;;33,0;6,0;;11,0;54,0;;;4,0;;;1,0;3,0;;;4,0;9,0;;;;1,0;2,0;;;34,0;;;1,0;1,0;;;;2,0;;1,0;7,0;8,0;;;57,0;;1,0;;3,0;2,0;3,0;12,0;9,0;;14,0;;2,0;1,0;76,0;;;2,0;;;5,0;7,0;;3,0;;4,0;15,0;;1,0;2,0;2,0;;;9,0;;;1,0;2,0;;;;;1,0;3,0;;;2,0;;;;1,0;1,0;1,0;2,0;9,0;1,0;;;2,0;5,0;;49,0;24,0;7,0;7,0;;14,0;;;2,0;5,0;;;14,0;1,0;;1,0;21,0;4,0;4,0;4,0;2,0;2,0;1,0;17,0;;;2,0;1,0;;;;;6,0;17,0;;18,0;;1,0;1,0;5,0;;;;;2,0;1,0;;1,0;1,0;9,0;1,0;1,0;;2,0;1,0;4,0;1,0;;;;;3,0;1,0;1,0;;2,0;7,0;1,0;;;;;;;;2,0;;;1,0;;1,0;5,0;1,0;;1,0;1,0;12,0;;;;;3,0;1,0;;;1,0;;1,0;2,0;6,0;;;4,0;;;1,0;;2,0;;8,0;6,0;2,0;;;1,0;1,0;1,0;1,0;2,0;;6,0;;;;;;1,0;;1,0;;3,0;2,0;1,0;;13,0;;;;;;;3,0;1,0;3,0;;4,0;14,0;;4,0;;;;1,0;4,0;;9,0;4,0;2,0;;;3,0;;3,0;;4,0;4,0;2,0;;4,0;2,0;;;1,0;7,0;4,0;;13,0;;;;;;;;;;;3,0;;4,0;;;;;1,0;;;;;;;;3,0;;2,0;;;;;;;;;;;;;;;;;18,0;;1,0;;6,0;6,0;3,0;;4,0;;;;;;1,0;7,0;3,0;;;3,0;;4,0;;;;1,0;;1,0;;;;;;;;2,0;;4,0;;;3,0;;;12,0;;4,0;;;;3,0;1,0;;8,0;3,0;4,0;;;;;;1,0;8,0;;;;8,0;;;;;2,0;1,0;5,0;;;;;;5,0;;;;;;;;;;;;21,0;7,0;4,0;1,0;;;7,0;;2,0;;;2,0;;;;;;;;;;;;;1,0;;10,0;1,0;2,0;3,0;5,0;;;;;;;;;;;;;;2,0;2,0;;;;;;;;;;;;;;;;;5,0;;;;;2,0;;2,0;;1,0;47,0;;3,0;;1,0;;;;;;;;;;;;;;;2,0;;;;3,0;;;;;;6,0;;;;;;;;;;2,0;;;;;;2,0;;;1,0;1,0;;;;;2,0;;;3,0;15,0;;;;;;;;;3,0;;;1,0;;;;9,0;;;1,0;;;;;;3,0;1,0;;;;1,0;;;3,0;;;12,0;;4,0;;2,0;;2,0;;;;;;3,0;;;;1,0;;;4,0;;;;;;;;;;8,0;;;;;;;;;;1,0;;1,0;;;;;3,0;;;;2,0;33,0;;;1,0;;2,0;27,0;5,0;;;;;;5,0;;2,0;;;;;1,0;;;;;;;;;;;;;;;;;;;;;;;;;;;;;2,0;7,0;;;;;;;;;;;;;;;;;;;6,0;1,0;;;;;;1,0;;;;;1,0;1,0;;;;;;;;;1,0;;13,0;;2,0;;;;;;;;;;;;;;;;;4,0;;;2,0;;;;;;;;;;;;;1,0;;;;;;;;;;4,0;;;;;;3,0;;;;;8,0;;3,0;;1,0;;;;;;;;;;;;;;;5,0;;;;;;;;;;5,0;;2,0;;;;;;;;;1,0;;;3,0;;;;;;;;;;1,0;;;;;;;;;1,0;;;;;;;;;;;;;;;;;;;;;;;;;;;;;;;;;1,0;;;;;;;;;;;;;;;;;;4,0;;5,0;;;;;;1,0;1,0;;;;;;;;;;;;;;;;;;;;;1,0;;;;;;;;;;;;;;;;;;;;;;;;;
hinge;;;;;10,0;;34,0;23,0;;;6,0;;;;;1,0;;;3,0;;;2,0;;;;;;;5,0;;;;23,0;;2,0;;;14,0;;36,0;;;3,0;3,0;;;;;;;;;;;;4,0;13,0;;;5,0;;;1,0;;;;;;;3,0;3,0;;;;;;;;14,0;;4,0;;;;;;1,0;;;;1,0;;;;1,0;1,0;;;;;21,0;1,0;;;;3,0;1,0;16,0;;;;1,0;;34,0;9,0;;;;3,0;51,0;;;;1,0;1,0;;11,0;1,0;;28,0;7,0;;;;1,0;;11,0;2,0;;;;;1,0;6,0;;1,0;10,0;8,0;;;;6,0;2,0;;3,0;2,0;2,0;38,0;1,0;2,0;;;;5,0;;1,0;3,0;4,0;;1,0;89,0;;5,0;16,0;1,0;9,0;;;;;10,0;4,0;2,0;;17,0;;2,0;2,0;;70,0;;2,0;;12,0;;;;1,0;9,0;6,0;3,0;4,0;;15,0;1,0;;;;3,0;4,0;;;;;;2,0;1,0;;;;3,0;;;;;;;;;;1,0;;;2,0;;2,0;;;1,0;;;;;4,0;1,0;12,0;;;;2,0;;;;59,0;;;4,0;4,0;;;;5,0;;1,0;1,0;;11,0;;;1,0;1,0;3,0;;;2,0;;;;;2,0;1,0;1,0;;20,0;;;1,0;2,0;;4,0;;;;;;6,0;;1,0;;;;;13,0;;2,0;4,0;;;5,0;3,0;;1,0;;;;;12,0;;1,0;;;;13,0;16,0;;4,0;1,0;;;;1,0;;;;;;;;;;;1,0;;;;;;;;;9,0;;;;;;;;;9,0;;;;;;;;;;;;;;;;;;;;2,0;;2,0;2,0;;;;;;;;;;2,0;3,0;7,0;;;;;;;;9,0;;;;;;;;;6,0;;1,0;;;;;;;;;;3,0;2,0;4,0;;;;;;;;;;;;;;;;;;;;;;;;;;;;;13,0;;;;;;;;;1,0;;;3,0;;;;;1,0;4,0;;;;;;;;;;;;;30,0;2,0;;;;;1,0;;3,0;2,0;1,0;;;;;;;;;1,0;1,0;;1,0;;1,0;1,0;;;;2,0;;;;;;;;;6,0;;;4,0;;;;;;2,0;;;;2,0;;;;;;;1,0;;;4,0;;;;;;1,0;;;;5,0;;4,0;;;;;;1,0;;;;;;;;;;;;3,0;;;;;;;;;4,0;;;;;;;3,0;;;;;;;;;;;;;;;;;;;;;;;;;;;;;1,0;;;;;;;;;;2,0;;;;;;4,0;8,0;2,0;;;;;;;;3,0;;;;;;;7,0;5,0;;1,0;;;2,0;;;;;;;;1,0;;;;;;3,0;;;;;;;;;;;;;;;;;1,0;;;;;;6,0;;;;;;;;;;;;;;;;2,0;;;;;;;;;;;;;;;;;;;;;;;;;;;;;;;;;;;;;;;;;;;;;;;;;;;;;;;;;;;;;;15,0;;;1,0;;;;;;;;;;;;;;;;;;;;;;;;;38,0;;;;;;;;;;;;;;;;;;;;;;;;;;;;;;;;;;;;;;;;;;;;;;;1,0;;;;;;;;;;;;;;;;;;;;;;16,0;;1,0;;;;;;;1,0;;6,0;6,0;;;;;;;1,0;;;;;;;;;;2,0;;;2,0;;;;;;;;;;;;;;;;;;;;;;;;;;;;;;1,0;;;;;;;;;;;;;;;;;;;;;;;;;;;;;;;;;;;;;;;;;;;;1,0;;;;;;;;;;;;;;;;;;;;;
hollow;;;;;5,0;;2,0;9,0;;;7,0;;3,0;;;;;;5,0;;;4,0;;;;;;;;;;;9,0;;8,0;;;3,0;;2,0;;;24,0;11,0;;;;;;;;;;;;6,0;31,0;;;67,0;;;11,0;;;1,0;;;;;5,0;;;2,0;5,0;;4,0;3,0;2,0;;;;;;;;3,0;;;;4,0;;;3,0;1,0;21,0;;;;2,0;17,0;8,0;;;;;;15,0;;;;6,0;;5,0;8,0;1,0;;;4,0;51,0;;;;1,0;;;6,0;5,0;;12,0;11,0;1,0;;46,0;3,0;2,0;22,0;;1,0;1,0;;;;5,0;;;15,0;1,0;;;;1,0;4,0;;7,0;31,0;16,0;34,0;;6,0;;;29,0;10,0;;;;3,0;;;23,0;;22,0;13,0;;9,0;40,0;;;1,0;;1,0;3,0;;;;8,0;3,0;;67,0;;2,0;;13,0;5,0;;1,0;2,0;;12,0;;16,0;;8,0;23,0;;;;13,0;14,0;;;;1,0;8,0;;;2,0;;11,0;;2,0;;;20,0;;;;;;3,0;;;;;1,0;;;;;28,0;;1,0;2,0;2,0;2,0;;;;8,0;;;;9,0;;;36,0;18,0;;3,0;4,0;2,0;;2,0;7,0;;30,0;;8,0;1,0;5,0;7,0;;;6,0;;;1,0;1,0;5,0;;3,0;;3,0;;;;4,0;;12,0;;;;;;;;;;;1,0;;;;;;2,0;2,0;;5,0;;3,0;;;2,0;;2,0;;2,0;5,0;1,0;;41,0;2,0;2,0;;11,0;1,0;1,0;;;;;;;;;;1,0;;;;;;;;;;;1,0;1,0;;;;;;;;;1,0;;;;;;;;;;;;;;;;;1,0;;;;;;;;;;;;;;;;;;;;;;;;;;;;;;1,0;;;;1,0;1,0;1,0;;;;;;4,0;;;;;;;;;;;;;;;;;;;;;;;;;;;;;;;;;;;;;;;;;;;;;;;;3,0;;;;;;;;;;1,0;;;;;;;;;11,0;;;;;;;;;5,0;;;;;;;;;;3,0;;;2,0;;4,0;1,0;;;;;1,0;2,0;;;;;2,0;;;;;1,0;;;;;;;;;;1,0;1,0;;;;;;;3,0;;;;;;;3,0;;;;2,0;;;;;;;;;1,0;;;;1,0;;;;;;1,0;;;;;;;;;;;3,0;5,0;;;;2,0;3,0;;;;;1,0;;;;;;;;1,0;;;;;;;;;;;;;;;;;;;;;1,0;;;;;;2,0;;;;;;;1,0;;;;;17,0;;;;;;1,0;;;;7,0;;2,0;2,0;;;;;2,0;;;;;;1,0;;;;;;;;4,0;;;;;;;;;;;;;;;;;;;;;;;;;;;;;;;;;;;;;;;;;;;;7,0;1,0;;1,0;;;1,0;;;;;;;;;;;;;;;;;;;;;;;;;;;;;;;;;;;;;;;;;;;;;;;;;;;;;;;;;;;;;;;;;;;;;2,0;;;;;;;;;4,0;;;;;;;;;;;7,0;;;;;;;;;;;;;;;;;;;;;;;;;;;;3,0;;1,0;;;;;1,0;;;;;;;1,0;4,0;;;;2,0;;2,0;;;;1,0;;;;;;;4,0;;;;;;;;;2,0;;;;;;;;;;;;;;;;;;;2,0;;1,0;;1,0;;;;;;;;;;;;;;;;;;;;;;;;;;;;;;;;;;;;;;;;3,0;;;;;;;;;;;;3,0;;;;;;;;;;;;;;;;1,0;;;;;;;;;4,0;;;;;;;;;;;;;;;;
human;;;;;2,0;;;5,0;5,0;5,0;;9,0;;;9,0;;;;;4,0;;4,0;;1,0;;;;44,0;5,0;21,0;14,0;6,0;23,0;;15,0;;;2,0;;2,0;28,0;3,0;;;;1,0;;;3,0;;1,0;7,0;;;;84,0;10,0;;;1,0;;;11,0;;1,0;;1,0;;;5,0;2,0;1,0;;1,0;;1,0;;;12,0;1,0;;6,0;;1,0;;;12,0;;2,0;1,0;2,0;;1,0;1,0;4,0;7,0;;4,0;2,0;;3,0;6,0;;;1,0;;;28,0;;;4,0;;1,0;;;;;;1,0;53,0;;;;;;;2,0;;;;;1,0;;;;1,0;;;;2,0;;1,0;1,0;92,0;;;1,0;;;;;;;1,0;1,0;;;1,0;;9,0;;;;;;;;8,0;;;;;41,0;;2,0;;;5,0;;;;;;;;;;;;8,0;;;2,0;4,0;;;;;;;;;;;;2,0;;;;;;;;;;3,0;1,0;;;;1,0;;;6,0;;3,0;;;;;;;;;;;;;15,0;;;;;;;3,0;;;;;;;;1,0;;;;1,0;;;;;;;;;;;;;;;;;;1,0;;;;;;;;;;;;8,0;;;;;;5,0;;;;2,0;;;;;;;1,0;;;7,0;;;2,0;1,0;;;;;;;;;;1,0;;;;;;;;;9,0;;;;;;;;;;;2,0;;;;;3,0;;;1,0;;;;;1,0;;1,0;;;;;;;;13,0;4,0;;;;6,0;;;;;;;1,0;;;;;;1,0;2,0;;;;;1,0;;;;;;;;1,0;1,0;;;1,0;;;;;;;;;;;;;;;1,0;;;3,0;;;;;;;;1,0;;1,0;1,0;;;;;;;;1,0;;;;;;1,0;;10,0;;;1,0;;;;1,0;3,0;;;13,0;;;;;;;2,0;;1,0;;3,0;1,0;;;4,0;;;;;;;1,0;;;;;;;;1,0;;;3,0;;;1,0;;;2,0;;;;;;;;;;;;;4,0;;;;;1,0;36,0;;;;;;;;1,0;;;;1,0;;;1,0;;;;;;;;3,0;;;;;;;;;;;;;1,0;;;;;;;;;;9,0;;2,0;;;;3,0;;;;;;;;;4,0;;1,0;;;;1,0;19,0;;;2,0;;;;;;;;;1,0;;;;;;;;3,0;1,0;;;;;;;;;1,0;;;;;;;;;;;;;;;;;;;;;;;;1,0;;;;;;;;;;;;;;1,0;;;;;;;;;;;;;;;;;;;;;;;;;2,0;;;;;;;5,0;6,0;1,0;;;1,0;;;;;;2,0;4,0;;;;;;;;;;;;;;;;;;;;;2,0;;;;;;;;;;;;;;;1,0;;1,0;1,0;;;;;;;;1,0;;;;2,0;;;;;;;;;;2,0;;;;;;;;6,0;;;;;;;;;;;;;2,0;;;;;;;2,0;;;1,0;;;;;;;1,0;1,0;;;;;;;1,0;;;;;;1,0;;;;;;9,0;;;3,0;;;;;;1,0;;;;;;;;4,0;;;;;;;;;;;;;;;;;;;;;;1,0;;1,0;;;;;;;;;;;;;;;;;;1,0;;;;;;;;;;;;;;;;;;;;;;;;;;;;;;;;;;;;;;;;;;;;2,0;;;;;;;;;1,0;;;;;;;;;;;;;;2,0;;;;;;;;;;;;;;;;;;;;;;;;;;;;;;;;;;;;;;;;;1,0;5,0;;;;1,0;;;;;;;;;;;;;;
icon;;;;;3,0;;;2,0;;3,0;;;;;2,0;;;;;;8,0;16,0;5,0;;;;;2,0;;;;1,0;20,0;;;;;16,0;;107,0;;;;;;;;;;1,0;2,0;3,0;;;;30,0;8,0;;;;;1,0;4,0;;;;;;;2,0;;;;;;;;;1,0;;;;1,0;;;;8,0;;2,0;10,0;16,0;;;;9,0;;;6,0;6,0;;;6,0;;2,0;;;20,0;27,0;;;;;;;;;;;;;;;7,0;;;;6,0;;;;;3,0;;;;;;;;;;;;;;;2,0;2,0;;;;;;;;;;;;;;;;;;;;;9,0;;;;9,0;;;;;;;;;;;;;;;27,0;;8,0;;;;6,0;;;;;;;;12,0;;;;2,0;;;;;;;;;;3,0;6,0;;;;;;;;;;7,0;;;;;;;;;;;;;;;;;;;6,0;;;;;;;;;;;;;;;;;;;;;2,0;;;;;;;;1,0;12,0;;;;;;;;;;;;10,0;;;;;;1,0;;;;1,0;;;1,0;;2,0;;;;;;;;1,0;7,0;;;;;;;;;;;;;;1,0;;;;;8,0;2,0;;;;;;;;;;;5,0;;;;;;;21,0;;;;;;;;;;;;;;;;13,0;9,0;1,0;;;;;;;10,0;2,0;;;;;5,0;5,0;;;;;;;;17,0;;8,0;1,0;;;;;;2,0;;;;;;;;2,0;2,0;;;;3,0;;;;;;;1,0;;2,0;;;1,0;4,0;;;3,0;;;;;;;;;;;2,0;;16,0;;;;1,0;;;;9,0;;;1,0;;;;;;;2,0;;;;;;;;;;2,0;;;1,0;;;3,0;;;;1,0;;;;;;;1,0;6,0;9,0;;2,0;1,0;16,0;;;1,0;;;;;;;;;;;;;;;;;;;;;2,0;;1,0;;;;;;;;;;;;;;;;;;;;;1,0;1,0;;;;;;;2,0;;;;;3,0;;;3,0;;;;;;;;;;;1,0;6,0;;;;;3,0;;;;;3,0;;;;;;1,0;;;15,0;;;;;1,0;;;;;;;;;;;;;;;;;;;;;;;;;;;;;;;;;;;;;;;;;3,0;;;;;;;;;;;;;;;;;;;;;;;;;;;;;;;;;;;;;;;;;;;;;;;;;;;;;;;;;;;;;;;;;;;;;1,0;;;;;;;;;;;;;;;;;;;;;;;;;;;;;;;;1,0;;;;1,0;;;1,0;2,0;;;;;;3,0;;;;;;;;;;;;;;;;;;;;;;;;;;;;;;;;;;;;;;;;;;;;;;;1,0;;;;;1,0;;;;;;;1,0;;;;;;;;;;;;;;;;;;;;;;;;;4,0;9,0;1,0;;;;;;;;;4,0;;;;;;;;;;;;;;;;;;;;;;;;;;;;;;;;;;;12,0;;;;;;;;;;;;;;;;;;;;;;2,0;;;;;;;;;;;;1,0;;;1,0;;;;;;;1,0;;;;;;;;;;12,0;;;;;;;;;;;;;;;;2,0;;;;;;;;;;;;;;;;;;;;;;;;;;;;;;;;;;;;;;;;;;;;;;;;;;;;;
illuminator;;;;;6,0;;;4,0;;1,0;;;;;;;;;;;;12,0;;;;;;;;;;;1,0;;;;;;;;;;;;;;;;2,0;;;;;;;7,0;3,0;;;;;;1,0;;;;;;;;;;;;;;;;1,0;;;1,0;;;;;;;;;2,0;;;;;;;;;;2,0;9,0;;;;;;;;;1,0;;;;2,0;;;;2,0;;;;;;;;6,0;;;;;;;;;;;;;1,0;;;;;;;3,0;2,0;;;;;;;;;;1,0;4,0;;;;;;;;;6,0;;;;;;12,0;;;;1,0;;;5,0;;;;;;;11,0;;;;;;;;;;;;;;;;;;;;;;;;;;;;;;;;;;;;;;7,0;;;;;;;;;;;;;1,0;;;;;3,0;;;;;;;;;;6,0;;;;;;;;;1,0;;;;;;;;;;;;;;;;;;;;;;;;;3,0;;;;;;;;;;;;;;;;;;2,0;;;;5,0;;1,0;;;;;;;;;;;;;;;;;;;;;;;;;;;;;;;;;;;;;;;;;;;;;;;;;;;;;;;;;;1,0;;;;;;;;;;;1,0;;;;;;;;;;;;;;;;;;;;;;;;;;;;;;;;;;;;;;;;;;;;;;;;;2,0;;;;;;;;;;;;;;;;;;;;;;;;;;;;;;;;;;;;;;;;;;;;;;;;;;;;;;;;;;;;;;1,0;;;2,0;;;;;;5,0;;;;;;;;;;;;;;;;;;;;;;;;;;;;;;;;1,0;;;;;;;;;;;;;;;;;;;;;;;;;;;;1,0;;;;;;;;;;;;;;3,0;;;;;;;;;;2,0;;;;;;;;;;;;;;;;;;;;;;;;;;;;;;;;;;;;;;;;;;;;;;;;;;;;;;4,0;;;;;;;;;;;;;;;;;;;;;;;;;;;;;;;;;;;;;;;;;;;;;;;;;;;;;;;;;;;;;;;;;;;;;;;;;;;;;;;;;;;;;;;;;;;;;;;;;;;;;;;;;;;;;;;;;;;;;;;;;;;;;;;;;;;;;;;;;;;;;;;;;;;;;;;;1,0;;;;;;;;;;;;;;;;;;;;;;;;;;;;;;;;;;;;;;4,0;;;;;;;;;;;;;;;;;;;;;;;;;;;;8,0;;;;;;;;;;;;;;;;;;;;;;;;;;;;;;;;;;;;;;;;;;;;;;;2,0;;;;;;;;;;;;;;;;;;;;;;;;;;;;;;;;;;;;;;;;;;;;;;;;;;;;;;;;;;;;;;;;;;;;;;;;;;;;;;;;;;;;;;;;;;;;;;;;
indication;;;;;2,0;;1,0;22,0;5,0;12,0;;;;;4,0;;;;;1,0;2,0;33,0;2,0;;;;;6,0;;5,0;;4,0;25,0;;3,0;;;4,0;;35,0;1,0;;;1,0;;2,0;;3,0;4,0;;5,0;8,0;;1,0;;69,0;13,0;;2,0;3,0;;;27,0;;;1,0;;;1,0;;17,0;;;;;1,0;;3,0;12,0;2,0;;5,0;1,0;;;;1,0;;;9,0;2,0;;;8,0;4,0;1,0;1,0;1,0;3,0;;23,0;17,0;;1,0;;;3,0;2,0;;;1,0;6,0;;;;1,0;;;;6,0;;;3,0;;;;9,0;;;1,0;;2,0;;;;3,0;;;;5,0;;1,0;;8,0;;;6,0;8,0;;;;;;;;;;;;2,0;6,0;;1,0;;;4,0;1,0;1,0;;;9,0;3,0;4,0;;4,0;;;;;2,0;;;1,0;;;;;9,0;;;;;;27,0;;5,0;;;;1,0;;3,0;;;;4,0;;;;;;;1,0;;;7,0;16,0;;1,0;;;1,0;;;;;8,0;;;;;;;;;8,0;;;6,0;;;;15,0;;;2,0;;;;;;;;;;;;;;;;;;;;2,0;;;;;;;;;;3,0;1,0;;2,0;1,0;;;;3,0;;2,0;;24,0;;;;;;3,0;;;;2,0;;;2,0;;4,0;;;;;2,0;;2,0;6,0;6,0;;;;;;;;;;;;;;3,0;;;;;30,0;;;1,0;;;;;;;;6,0;1,0;1,0;;1,0;;;;;;1,0;2,0;;;;;;;;4,0;;;;1,0;17,0;;4,0;;;;;;2,0;;;;;;;2,0;;;1,0;;;;;;1,0;2,0;9,0;;1,0;1,0;;;;1,0;;1,0;;;;;;;;1,0;;;1,0;;;;5,0;;;1,0;;6,0;9,0;3,0;1,0;5,0;;3,0;;;2,0;1,0;;;4,0;4,0;;;;;;4,0;;;;;4,0;;1,0;;;;1,0;8,0;;;;2,0;;1,0;;;;;;;4,0;2,0;;;;;4,0;;;;;;1,0;4,0;3,0;;;4,0;1,0;;;5,0;5,0;1,0;1,0;;2,0;3,0;1,0;4,0;5,0;3,0;;;;;;;7,0;;2,0;1,0;;;;;;;1,0;1,0;;2,0;;;;;;;;;;1,0;;;;;;;;1,0;;;;;;;;;;1,0;;;;;;;3,0;;;6,0;;;;;;5,0;;;;;;;;;;;1,0;6,0;4,0;;;;;;;;;7,0;;;2,0;;;;;5,0;;;;;;;;1,0;;;;2,0;;;;;;;;;;;;;;1,0;;;;;;;;;;;;;;;2,0;;;1,0;;;;;;;;;;;;;;;;;;;;;;;;;;;;1,0;;;;;;;;;;;;;;;2,0;;;;;;2,0;;;;;2,0;;;;1,0;;;;;1,0;;;;2,0;1,0;;;;;;1,0;;;;;;;;;;2,0;;1,0;1,0;;;;;;;;;;;;;;;;;1,0;;;;;;;;;;;3,0;;;;;;;;2,0;;;;;;;;;;;;;4,0;;;;6,0;;;3,0;4,0;;;;;;;;3,0;;;;;;;;3,0;3,0;;;;;1,0;;;;;1,0;;3,0;;;;;;;;;;;;;2,0;;;;;2,0;;;;15,0;;;;;;;;;;;;10,0;;1,0;;;;;;;;;;;;;;;;;;;;2,0;14,0;;;;3,0;;;;;;;;;;;;;;;;;;;;;;;;;;;6,0;1,0;;;;;;;;;;;1,0;;;;;;;3,0;1,0;;;;;;;;;;;;;;;16,0;;;;;1,0;;;;;;;;1,0;;;;;;;2,0;;;;;;;;5,0;;;;;;;;;;;;;;;;;;;;;;;;;;;;;9,0;;;;;;;;;;1,0;;
inertial;;;;;3,0;;3,0;1,0;1,0;1,0;;;;;;3,0;;;;;;2,0;;6,0;4,0;;;8,0;;;;2,0;7,0;;2,0;;;;;2,0;;;;;2,0;;;;;;;1,0;;;;1,0;;;;;;;6,0;;;;1,0;;1,0;;15,0;;;;;;;;17,0;;;1,0;1,0;;;;;;;;20,0;;;1,0;;1,0;;;;;1,0;22,0;;;;;;12,0;;;;;;;;;;;;;;;;;;;3,0;;;;;;;;;;;;;;;;;;;2,0;;;;;;;;;;;;;;;;;;;;;;;;;;;4,0;;1,0;;;1,0;;;;;;;;;;;;2,0;;;;6,0;;;;;;;;;;;;;;;;;;;;;;;1,0;;;;;;;;;;;;;;;;;;;1,0;;;;;;;;;;;;;;;;;;;;;;;;;;;;;;;;;;;;;;;;;;;;;;;;;;2,0;1,0;;;;;;;;;;;;;;;;;;;;;1,0;;;;;;;;;;;;;;;;;;;;;;;2,0;;1,0;;6,0;12,0;;;1,0;;;;;;;;;1,0;;3,0;;;1,0;;;;;;;;4,0;3,0;;;3,0;;;5,0;;;;;;;1,0;;;;;;;;;;;;;;;;;;2,0;;;;;;;;;;2,0;;1,0;1,0;;;2,0;;1,0;;;;;;;;;;;;;1,0;;;;;;;;;;;;;;;;;;;;;;;;;;;;;1,0;;;;;;;;;;;;;;;;;;;;;;;;;;;;;;;1,0;;;1,0;;;;;;;;;;;;;;;;;;;;;;;;;;;;;;;;;;;;;;;;;;;;;;;;;;;;4,0;;;;;;;;;;;;;;;3,0;;;;;;;;;;;;;;;;;1,0;;;;;;;;;;;;;1,0;;;;;;;;;;;;;;;;;;;;;;;;;;;;;;;;;;;;;;;;;;;;;;;;;;;;;;;;;;;;;;;;;;;;;;;;;;;;;;;;;;;;;;;;;;;;;;;;;;;;;;;;;;;;;;;;;;;;;;;;;;;;;;;;;;1,0;;;;;;;;;;;;;;;;;;;;;;;;;;;;;;;;;;;;;;;;;;;;;;;;;;;;;;;;;6,0;;;;;;;;;22,0;;;;;;;;;;;;;;;;;;;;;;;;;;;;;;;;;;;;;;;;;;;;;;;;;;;;;10,0;;;;;;;;;;;;;;;;;;;;;;;;;;;;;;;;;;;;;;;;;;;;;;;;;;;;;;;;;;;;;;;;;;;;;;;;;;;;;;;;;;;;;;;;;;;;;;1,0;;;;;;;;;;;;;;;;;;;;;;;;;;;;;;;;;;;;;;;;;;;;;;1,0;;;;;;;;;;;;;;;;;;;;;;;;;;;
initialization;;;;;1,0;;;;;;;;;;;;;;;;1,0;16,0;;;;;;;;;;11,0;;;3,0;;;;;;;;3,0;;;;;;;;;;;;;1,0;1,0;;;5,0;;;1,0;;;;;;;7,0;7,0;;;;;;;;8,0;;;6,0;;;;;;;;;;;;9,0;;;;8,0;;;;16,0;;;;;3,0;33,0;;;4,0;;;;;;;;;;;;;3,0;;;7,0;;;;;;;;;;;;;;;;;;;;;1,0;;;;;;;;;;;;;;;;;;;2,0;;;;;;;;;;;3,0;;;;;;;;;;1,0;;;;;;4,0;;;;;;;;;;1,0;;;1,0;;;;;;;;;;;;;;;;;;;;;;;;;;;;1,0;;;11,0;;;;;;;;4,0;;;;;;;;3,0;;;;;;;;;1,0;;;;;;;;;;;;1,0;;;;;;;;;;;;1,0;;2,0;;;;;;;;;1,0;;;;;2,0;;;;;;;;;;;;;;;;;;;;;;;;;;;;;;;;;;;;;;;;;;;;;;;;;;;;;;;;;;;;;;;;;;;;;;;;7,0;;;;;1,0;;;;;;;;;;1,0;;4,0;;;;;5,0;;;;;;;;;;;1,0;1,0;;;;;;;;;;;;;;;;;;;;;;;;;;;;;;;;;;;;;;;;;;;9,0;;;;;;2,0;2,0;;;;;;;;;;;;;2,0;;;2,0;;;;;;;;8,0;;;;;;;2,0;;10,0;;5,0;;;;;;;;;;;;;1,0;;;;;;;;;1,0;;;;;;;;;;;;;;;;;;;;;;;;;;;;;;;;;;;;;;;;;;;;;;;;;;;1,0;;;;;4,0;;;;;;;;;;;;;;7,0;;;;;;;;;;;;;;;;;;;;;;;;;;;;;;;;;;;;;;;;;;;;;;;;;;;;;;;;;;;;;;;;;;;;;;;;;;;;;;;;;;;;;;;;;;;;;;;2,0;;;;;3,0;3,0;;;;;;;;;;;1,0;;;;;;;;;;;;1,0;;;;;;;3,0;;;;;;;;;;;;;;;;;;;;;;;;;;;;;;;3,0;;;;;;2,0;;;;;;;;;;;;;;;;;;;;;;1,0;;;;;1,0;;;;;;;;;;;;;;;;1,0;;;;;;;;;;;;;;;;;;;;;;;;;;;;;;;;;;;;;;;;;;;;;;;;;;;;;;;;;;;;;;;;;;;;;;;;;;;;;;;;;;;;;;;;;;;;;;;;;;;;;;;;;;;;;;;;;;;;;;;;;;;;;;;;;;;;;;;;;;;;;;;;;;;;;;;;;;;;;;;;;;;;;;;;;;;;;;;;;;;;;;;;;;;;;;;;;;;;;;;;;;;
inside;;;;;15,0;;11,0;11,0;2,0;13,0;10,0;;4,0;;;1,0;;;8,0;;2,0;11,0;;;;;1,0;1,0;;8,0;;1,0;13,0;;13,0;;4,0;21,0;;13,0;6,0;;5,0;38,0;;;;1,0;;;1,0;12,0;;12,0;1,0;45,0;21,0;;;132,0;;;15,0;1,0;;18,0;4,0;4,0;;4,0;17,0;;4,0;11,0;3,0;2,0;3,0;6,0;49,0;2,0;8,0;1,0;;;;2,0;62,0;;1,0;;17,0;;5,0;5,0;;25,0;;4,0;2,0;5,0;96,0;23,0;;4,0;;;;27,0;1,0;3,0;3,0;15,0;;7,0;24,0;1,0;;;3,0;48,0;;1,0;1,0;2,0;2,0;;8,0;16,0;2,0;3,0;22,0;1,0;1,0;50,0;1,0;5,0;72,0;1,0;3,0;4,0;;2,0;4,0;21,0;2,0;3,0;50,0;52,0;;;;8,0;5,0;5,0;7,0;34,0;15,0;105,0;5,0;7,0;2,0;;22,0;;;1,0;5,0;34,0;3,0;2,0;47,0;14,0;37,0;40,0;6,0;21,0;21,0;6,0;2,0;7,0;1,0;1,0;2,0;;4,0;10,0;23,0;29,0;;71,0;1,0;2,0;1,0;12,0;10,0;3,0;;;11,0;3,0;2,0;22,0;1,0;11,0;3,0;1,0;;1,0;9,0;17,0;;2,0;2,0;2,0;2,0;2,0;4,0;1,0;4,0;7,0;4,0;32,0;;6,0;35,0;;11,0;14,0;1,0;;4,0;;2,0;3,0;1,0;;21,0;1,0;65,0;1,0;46,0;5,0;3,0;9,0;2,0;35,0;;2,0;3,0;7,0;;;1,0;6,0;1,0;3,0;12,0;21,0;;10,0;9,0;8,0;16,0;5,0;7,0;6,0;5,0;;2,0;2,0;3,0;6,0;2,0;5,0;8,0;5,0;;3,0;2,0;26,0;13,0;15,0;;11,0;2,0;5,0;11,0;8,0;6,0;5,0;2,0;;1,0;1,0;;;;5,0;3,0;3,0;1,0;;1,0;3,0;6,0;2,0;;4,0;3,0;16,0;1,0;1,0;3,0;1,0;14,0;;3,0;8,0;5,0;3,0;1,0;7,0;5,0;2,0;2,0;7,0;1,0;6,0;;;1,0;;6,0;;;;;;;;;2,0;;;2,0;;;;46,0;3,0;2,0;1,0;;;;;;;6,0;;1,0;;;;1,0;;;;;3,0;;;;3,0;;3,0;1,0;;;4,0;;;;;;;;;;4,0;1,0;2,0;1,0;1,0;3,0;;8,0;21,0;;;29,0;;;;;;;6,0;;1,0;4,0;2,0;;;;;;;2,0;1,0;3,0;1,0;;2,0;;;;;;2,0;;;;;1,0;;;;;2,0;1,0;;;;;2,0;;;;1,0;;;6,0;;4,0;;;;;;;;;;;2,0;12,0;;1,0;;3,0;;4,0;;2,0;;15,0;;;1,0;2,0;;;;;7,0;6,0;;;;;1,0;5,0;5,0;5,0;6,0;;;6,0;;;;;2,0;3,0;;;8,0;;19,0;9,0;;;;;1,0;;;;;;4,0;;;;1,0;5,0;2,0;;;;;1,0;;;;3,0;;;;;2,0;;33,0;21,0;1,0;3,0;3,0;;;3,0;;4,0;;4,0;;;;;2,0;5,0;;2,0;;;;6,0;;1,0;1,0;1,0;1,0;;;5,0;;2,0;2,0;1,0;2,0;;;4,0;;;3,0;5,0;;;;;3,0;;2,0;9,0;;2,0;7,0;;;;;;2,0;2,0;;;;;;;1,0;2,0;;;;;1,0;;;;1,0;1,0;2,0;;1,0;2,0;;3,0;;;;;1,0;;4,0;3,0;;2,0;;;;2,0;18,0;;;;1,0;;1,0;;5,0;;5,0;10,0;;;;;1,0;;;;;2,0;3,0;;1,0;;;;;;1,0;1,0;;;;;;;;;;;;;;;;;1,0;;;;;;1,0;;;;;;;;2,0;;;15,0;1,0;;;;;;;;1,0;;10,0;;;;;;;;;5,0;;1,0;;;;;;;;;1,0;1,0;;;;;;;;;;;;1,0;1,0;;;;;;4,0;;;;;;;1,0;;;;;2,0;;;;1,0;1,0;;;;;;;1,0;;;9,0;;;;;;;;1,0;;;6,0;;3,0;;;;;;;;;2,0;;;;;2,0;4,0;;;;;;;;;;;2,0;;;;;;3,0;;;;1,0;;;;;1,0;;;1,0;;;;;;5,0;;;3,0;;;;;;;2,0;;;;2,0;1,0;;;3,0;1,0;3,0;;;;;2,0;;8,0;;;;1,0;;;1,0;4,0;;;1,0;;;;1,0;;;;;;;1,0;;;;;;;;;;;;;3,0;;;;3,0;;;;;;;2,0;;;;;;;;;;;;;;;2,0;1,0;;;;;4,0;;;;;;;;1,0;3,0;;;8,0;;;;;;;;;;;;;;;;;;;;;;;;;;;;;;;;;;;;;;;;;;;;
installation;;;;;2,0;;;27,0;9,0;;;;;;;;;;;1,0;;;;;;;;3,0;3,0;4,0;;1,0;11,0;;;;1,0;3,0;;;;;;1,0;;;2,0;;;;;;;;22,0;5,0;10,0;;;1,0;;;4,0;;;1,0;;;;1,0;15,0;;;1,0;;;;1,0;18,0;;;;;;;;;;;5,0;39,0;;1,0;;;3,0;;;3,0;;31,0;7,0;;;;;2,0;13,0;;;;1,0;;;;;;;;;;;2,0;1,0;;;1,0;1,0;;6,0;2,0;;;;;;2,0;;;;;2,0;;3,0;;;2,0;4,0;;;;;1,0;;2,0;;1,0;23,0;1,0;3,0;;;1,0;1,0;;;;4,0;;;3,0;;21,0;32,0;;5,0;1,0;;;;;;2,0;;;;;6,0;;3,0;;;;2,0;;;;;2,0;2,0;;;;2,0;;;;;10,0;14,0;6,0;;;;3,0;1,0;3,0;;;;;4,0;;;20,0;;1,0;6,0;2,0;;;;;;;15,0;;;1,0;;;;;;;;;;1,0;;;;;1,0;;;;3,0;;;;;1,0;;2,0;;;;2,0;;;3,0;;;1,0;1,0;;;;4,0;;4,0;;2,0;;;;;;;;;;;;;;;;;;;;;;;;;;2,0;3,0;;;;2,0;;;;;;1,0;;2,0;;;;;;;;;2,0;;;;;1,0;;;;;;;;;;;;;2,0;1,0;;;;;;;;3,0;;;;;;;4,0;;;1,0;;;;;11,0;;2,0;;;;;1,0;;;;;;;;;;;;;1,0;;1,0;;;2,0;;;;;;;;;;;;;;;;;;1,0;;1,0;;;;;;;;;;1,0;;;;;;;;;;;;;;;;1,0;;;3,0;;;;;1,0;;;;;1,0;;;;;;;1,0;5,0;;;3,0;;;;;;1,0;;;;;;;;;;;3,0;;;;;;2,0;;;;2,0;;;;;;;;;;;;;;;2,0;;;;;;1,0;;;;;;;;;;;;;;;;;;;;;;;;;;;8,0;;;;;;;;;;;;;;1,0;;;;;;;;;2,0;;;;;;;;;;;;;1,0;;;2,0;;;;;;;;;;;;;;;;;;;;;;;;;;;;;;;;4,0;;;;1,0;1,0;;;;;;;;;;;;1,0;;1,0;;;;;;;;;;;;;;;;;;;3,0;;;;;4,0;;;;;;;;;;;;;;;3,0;2,0;3,0;;;;;1,0;;;;1,0;;;;;;;;;;;;;;;;;;;;;;;;;;;;;;;;;;;;;;;;;;;;;;;1,0;;1,0;;;;;;;;1,0;;;;;;;;;;;;;;;;;2,0;;10,0;;;;;;1,0;;;;;;;;;;;;;;;;;;;;;;;;;;;;;1,0;;;;;;;;;;;;;;;;;;;;;;1,0;;;;;;;;;;;;;;;;;;;;;;;;;;;;;1,0;;;;;;;;;;;10,0;;;;;;;;;;;1,0;;;;4,0;;;;;;;;;;;;1,0;;;;;;;;;;;;;;;;;;;;;;;;;;;;;;;;;;;;;;;;;;;;;;;1,0;;;;;;;;;;;;;;;;;;;;;;;;;;;;1,0;;;;;;1,0;;;;;;3,0;;;;;;;;;;;;;;;;;1,0;;;;;;;;;;;2,0;
instrument;;;;;3,0;;19,0;13,0;7,0;26,0;20,0;;;;;;1,0;;;10,0;;7,0;55,0;;;;;35,0;2,0;28,0;16,0;15,0;21,0;;25,0;;4,0;1,0;;19,0;47,0;;1,0;9,0;;2,0;;1,0;;;2,0;1,0;;;;129,0;21,0;;;6,0;;;36,0;1,0;;;;;;;6,0;;3,0;1,0;;;;56,0;49,0;;;;2,0;2,0;1,0;;7,0;5,0;1,0;2,0;9,0;;5,0;5,0;;1,0;;2,0;3,0;2,0;3,0;83,0;;1,0;3,0;;;35,0;;2,0;1,0;9,0;;3,0;5,0;;;;1,0;;;;;1,0;;;6,0;;;1,0;;6,0;;;2,0;9,0;2,0;;;1,0;;;;;;;;;9,0;;;;5,0;;6,0;;;;;12,0;4,0;;;;;;;1,0;1,0;3,0;2,0;;;4,0;1,0;;;1,0;;;8,0;;;;3,0;2,0;;9,0;;6,0;;;4,0;8,0;;;;;27,0;;7,0;;1,0;;;;;;1,0;3,0;;;;;4,0;3,0;22,0;;;;4,0;12,0;;1,0;;;;;;;;;;;1,0;14,0;;;;;;;;;;1,0;;;;;2,0;;;4,0;;;;16,0;;;;;;;3,0;;3,0;;;;;;;;3,0;;;;;;;;;5,0;;;3,0;25,0;5,0;;;;;;;;;4,0;;;1,0;;2,0;;1,0;;;;;;1,0;;;;;;1,0;;;;;;3,0;;;2,0;;;;1,0;4,0;;;;;;;;1,0;;;13,0;;;;;;4,0;4,0;;;;1,0;;;;1,0;;;;;1,0;;;6,0;13,0;;;1,0;14,0;;;;25,0;4,0;3,0;;;;;;;1,0;1,0;;;;;;5,0;;2,0;2,0;;;;2,0;12,0;;;9,0;;;;3,0;;;3,0;;;6,0;;;;;;8,0;;1,0;2,0;2,0;;;;1,0;;;;;;;1,0;;;;;;1,0;1,0;;;;;;;3,0;;;;;;5,0;1,0;;;1,0;54,0;;2,0;;;;;;;7,0;1,0;;10,0;;;2,0;;;;3,0;;;;;2,0;;3,0;;;9,0;3,0;;;;;;2,0;1,0;13,0;8,0;;;1,0;;2,0;25,0;;4,0;;;;;;;;14,0;;;62,0;;;;;;;7,0;;;;;1,0;1,0;;;;;;;5,0;;;;;;;;;;;;2,0;;;;;;;;21,0;;5,0;1,0;;4,0;;;;;;;5,0;;1,0;;;;21,0;;;;;1,0;;;;1,0;16,0;;;;;;;;;;;2,0;;1,0;;;;;2,0;;;;;;;;;;;;;;;;;;;1,0;;;;;;;;;29,0;;;;1,0;10,0;2,0;;3,0;;;;;;;;;;;4,0;;;;;;;;5,0;;;;1,0;7,0;;;;;;;;;2,0;;;;;1,0;;;;;;;;;;2,0;;;;;;;;;;;;;1,0;1,0;4,0;;;;;;;;7,0;;;;;;;;;;;;;;4,0;;;;;2,0;;6,0;;;2,0;1,0;;;;;;5,0;;;;;;;;;1,0;;;;;2,0;;;9,0;1,0;;;;;;;14,0;;;;;4,0;;;;;;;3,0;;1,0;;;;;2,0;5,0;;;;;;;;;;;41,0;;;;;;;;;;;;;;;;;;;;;;;;;;;;1,0;1,0;;;;;;;1,0;;48,0;;;;;;;;;;;;;;;;;;;;5,0;;;;;3,0;;;;2,0;;;;;;;;;;;;;;;;;;2,0;;;;;;;;;4,0;;;;;;;;;;;;;;;;;;;;;;;;;;;;;;;;;;;;;1,0;2,0;;;;;;;;;1,0;;;;;;;;1,0;;;;;;3,0;;;;;;;;;;2,0;2,0;;;;;;;;;;;;2,0;;;;;;;;3,0;4,0;;;;;;;;;;;;;;;;;;
insulate;;;;;5,0;;;9,0;;;2,0;;;;3,0;;;;;;;1,0;;;;;6,0;;;;3,0;1,0;28,0;;1,0;;;1,0;;18,0;;;;24,0;;;;;;;3,0;1,0;;4,0;;4,0;18,0;;;3,0;;;10,0;;;;4,0;;;;5,0;;;8,0;3,0;;4,0;;2,0;2,0;;;;;;;40,0;;;;2,0;;;8,0;;1,0;;;;36,0;13,0;;1,0;4,0;;;;2,0;;;;6,0;;;;;;;3,0;4,0;6,0;1,0;;5,0;;;;5,0;;;5,0;;;;1,0;;39,0;;66,0;8,0;;;;1,0;3,0;;64,0;2,0;;;;;;2,0;;;20,0;3,0;;10,0;;;1,0;;;153,0;;10,0;;47,0;2,0;;6,0;5,0;;20,0;1,0;;;;;;;;;;7,0;18,0;;34,0;6,0;;;;;;2,0;;;1,0;31,0;6,0;10,0;9,0;;;;1,0;;2,0;;1,0;9,0;1,0;;;;;;1,0;4,0;;;;;;1,0;;;;;;;3,0;;;;2,0;14,0;;;;;3,0;1,0;;4,0;;;1,0;;;7,0;19,0;;;;;;;;4,0;;5,0;;;1,0;;2,0;4,0;1,0;;;;;;;;;13,0;1,0;1,0;;;4,0;;;;;2,0;;;;4,0;1,0;;14,0;;;;;;;;;1,0;;;;1,0;;1,0;;;3,0;;;;;1,0;;;;;;8,0;5,0;;8,0;;;;;;;;;;;;;1,0;;;;;;;;;;;;;;;;;;;;;;;;;2,0;;;;;;;;;;;;;1,0;;2,0;;;;;;;;;;;;;3,0;;;;;;;;;;;;;;;;;;;;;;;;;;;;;;;;;4,0;;;;;;;;;;;;;;;;;;;10,0;;;;;;;;;;;;;;;;;;;;;;;;;;;;;;2,0;;;;;;;;;;;;;;;3,0;;2,0;;;;6,0;1,0;;;;;;;;;;;;1,0;;;;;4,0;1,0;;;;;;;;;;;;;;;;6,0;;;;;;;;;1,0;;;;;;;;;;;4,0;;;;;;;;6,0;;;;;;;;;;;;;;1,0;1,0;;;1,0;;;;;;;;;;;;;1,0;;;4,0;4,0;;;;;;;;;;;;;;;;;;;;;;;;;;;;2,0;;;;;;;;46,0;;;;1,0;;2,0;;;;;9,0;;;;;;;1,0;;112,0;;;;;;;;;;;;;;3,0;;;;;;;;25,0;1,0;;;;;;;;;;;;;;;1,0;;;;;;;14,0;;1,0;;;;;;;;13,0;;;;;;;;;;;;;1,0;1,0;;1,0;;;;;;;;;;;;;;;;;;;3,0;;;;;;;;;;;;;;;;;;;;;;;;;;;;;;;;;;;;;;;;;;;;;;;;;;;;;;;;;;;;;;2,0;;;;;4,0;;;;;;;;6,0;;;;;;;;;;;;;;;;;;;1,0;;;;;;;20,0;;;;4,0;;;;;;;;;;;;;;;;;1,0;;;;2,0;;;;;;;;4,0;;;;;;;;;;13,0;;1,0;;;;;;;;;;;;;;;;;;;;;;;5,0;;;;;;;;;;;;;;;;;;;2,0;;;;;;;;;;;;;;;;;;;;;;;15,0;4,0;;;;1,0;;;;;;;;;;;;;;;;;;;;;3,0;;;;;;;;;;;;;6,0;;;;;;;;
intensity;;;;;6,0;;2,0;36,0;14,0;23,0;;6,0;;;30,0;1,0;5,0;;4,0;1,0;14,0;54,0;15,0;6,0;5,0;1,0;3,0;39,0;;50,0;15,0;56,0;28,0;12,0;17,0;;7,0;2,0;;8,0;18,0;;1,0;25,0;;2,0;;1,0;11,0;10,0;13,0;27,0;1,0;4,0;;155,0;24,0;4,0;2,0;10,0;3,0;;54,0;2,0;6,0;3,0;;;;1,0;9,0;3,0;;;;;;28,0;12,0;6,0;;5,0;10,0;;1,0;1,0;10,0;2,0;8,0;12,0;31,0;;;23,0;;5,0;4,0;2,0;7,0;;;36,0;;;;4,0;;30,0;7,0;;1,0;4,0;70,0;3,0;1,0;1,0;;7,0;;;;;6,0;7,0;;2,0;15,0;;4,0;;;3,0;;;;24,0;;;;18,0;1,0;2,0;;;9,0;;2,0;7,0;;;11,0;;;2,0;;;;;62,0;2,0;6,0;13,0;;1,0;;;29,0;352,0;;;;2,0;5,0;1,0;4,0;;;26,0;;;;;;1,0;;;;30,0;;28,0;;;15,0;27,0;;5,0;;;;;11,0;4,0;;1,0;;3,0;3,0;1,0;2,0;;11,0;9,0;;;;38,0;3,0;;;;;5,0;4,0;7,0;;41,0;1,0;;;;;;4,0;3,0;33,0;1,0;;7,0;10,0;;;;13,0;;;;10,0;;;1,0;;;;;;;;1,0;;;4,0;;1,0;;;;;;;;;;;;1,0;;;;;;;;;;;1,0;;10,0;;;2,0;;;22,0;;;;3,0;;;2,0;;10,0;1,0;1,0;;;12,0;;;15,0;34,0;;;;;;;;;;3,0;;;1,0;11,0;;;;;;6,0;;;;;1,0;1,0;;1,0;;3,0;;4,0;;;;;;19,0;1,0;;8,0;3,0;;;5,0;;;;2,0;13,0;;;7,0;1,0;;6,0;3,0;;;;;23,0;5,0;4,0;1,0;2,0;;;;;10,0;;10,0;1,0;14,0;10,0;;11,0;;1,0;;;;1,0;;5,0;29,0;;;;2,0;10,0;;;;;1,0;;;1,0;;;;;4,0;;7,0;;11,0;;;9,0;2,0;;1,0;;1,0;12,0;6,0;1,0;;1,0;;;1,0;;3,0;;;;;1,0;;2,0;;3,0;4,0;;;;16,0;98,0;;;;;1,0;;;;;4,0;;4,0;;;3,0;;;2,0;;;;;;;;;;;;2,0;;;1,0;4,0;;6,0;8,0;;3,0;1,0;4,0;1,0;;4,0;;;;;2,0;7,0;2,0;;;;1,0;;;;;;;;;;;;;;10,0;;;3,0;;;;;;;;;;1,0;;;;;;3,0;;;;;;;;;2,0;;;;1,0;;4,0;1,0;;1,0;96,0;1,0;;;;;12,0;;;;;;;;;;;;;;;;13,0;;;2,0;;;;1,0;;;;;;1,0;;;1,0;;;;14,0;;1,0;;;;;;;;1,0;;;;;;;;;;;2,0;;;;;3,0;;;;;5,0;;;6,0;;;;;1,0;;;;;;;;;;1,0;;;;;;;;;1,0;;;;;;;;;;;;;;;;;;;;;;28,0;17,0;1,0;;;3,0;4,0;;;9,0;;1,0;2,0;;;;;12,0;;13,0;;;4,0;;;;3,0;;;3,0;;6,0;4,0;;;2,0;;;;;;16,0;1,0;;;;;;;;26,0;;12,0;;;3,0;;1,0;;3,0;;;;;1,0;85,0;1,0;;;;;4,0;;;1,0;2,0;5,0;1,0;;26,0;10,0;;2,0;;;;;;3,0;2,0;;;;1,0;3,0;2,0;9,0;;;;;;;;;;;;;;;;;;;;;;;;;;;;4,0;;;;;;;;;;8,0;;;;;1,0;;;8,0;;;;35,0;;;;9,0;;;;;;;;5,0;;;;;;;1,0;1,0;;;;2,0;3,0;12,0;;;;;;;;;;1,0;;;;;;;;;;;;1,0;5,0;;;;;;;;;;;;;;;;2,0;;;;;;;1,0;;;;;;;;;1,0;;;;;;;2,0;;;;34,0;4,0;1,0;;;;;2,0;3,0;;;;;;;;;3,0;;;;4,0;;;;;;;;;;;;;;;4,0;;;;;;;;;;;;;;;;;;;;;16,0;;;1,0;;;;32,0;;;2,0;;;;;;;;;;;;
internet;;;;;5,0;;;6,0;;9,0;;;;;;;;;;8,0;;10,0;;;;;;8,0;;;;;22,0;;18,0;;3,0;;;1,0;;;;;;;;;;2,0;1,0;;;;;21,0;6,0;;;;;;15,0;;;;;;;;1,0;;;;;;;;;7,0;;;3,0;;;;;;;;;;;1,0;;;;;6,0;;;20,0;;9,0;;;4,0;3,0;;;1,0;;;;1,0;;;;;;;;;;;;3,0;;;;;;;;;;;;;;;;2,0;;3,0;;3,0;1,0;;;;;;;;;;;;;;;;;;;;;;;;;;;;;;1,0;;;;;;;;;;4,0;;;;;;5,0;;;;;;;;;;;;3,0;;;;;;;;;;1,0;6,0;;;;;1,0;;;;;;;;;;;;;;;;;2,0;;;;;;3,0;;;;;;;;;21,0;;;;;3,0;;;;;;;;;;;;;;;;;11,0;;;1,0;3,0;;;;;;;;;;;;;;;;;;1,0;;;2,0;1,0;1,0;;;;;;;;;;;;;;;;;;;1,0;;;;;;;;;18,0;;;;;;1,0;;;;;;;;;;;;;;;2,0;;;;;;;;;;;;;2,0;;;;15,0;;;;;;;;;;;;;;;3,0;;;;;;5,0;;;;;;;;;;;;;;;;1,0;;;;;;1,0;;;4,0;4,0;;;;;5,0;;3,0;2,0;1,0;1,0;;;;;1,0;;;;1,0;8,0;;;;;;;;;1,0;;;;;;1,0;1,0;;;;9,0;;;1,0;;;;2,0;;;1,0;;;;;;5,0;;3,0;;;;;;;1,0;1,0;;;;;3,0;;;2,0;;;;2,0;24,0;4,0;;;;;14,0;14,0;;;;1,0;;;;;;;;3,0;11,0;20,0;;1,0;;;;;;;;;5,0;;;;2,0;;;1,0;5,0;;;;;;;;8,0;;;;1,0;;1,0;;;;;;21,0;;;;;;2,0;;;;;;;;;;;4,0;21,0;15,0;;3,0;;1,0;;1,0;;8,0;;;;3,0;;;;5,0;6,0;;;;;;;;;;;;;;;1,0;;;;;;;;;;;3,0;;;1,0;;;;;;;;;5,0;;;;;;;;;;;;;;;;;;5,0;;;;;;;;;;;;;;;;46,0;;;;;;;;;;2,0;;;;;;;;;;;;;;;;;;;;;;;;;;;;1,0;;;;;;;;;;;;;;;;;;;;;;;1,0;;;1,0;;;;;;;;;;;;;;;;;;;;;;;;;;;;;;;;;;;;;;;;;;;;;;;;;;;;1,0;;;;;1,0;;;6,0;;;;;;;;;;;;;;4,0;;;;;;;;;;;;;;;;;;;;;;;;;;;;;;;;;;;;;;;;;;;1,0;;;;;;;;;;;;;1,0;;;;;;;;;;;;4,0;;;;;;;4,0;;;2,0;;;;;;;;;;;;;;;;;;;;11,0;;;;;;;;;;;;;;;;;;;;;;;;;;;;;;;;1,0;;;;;;;;;;;;;;2,0;;;;;;;;;;;;;;;;;;;;;;;;;;;;;;;;;;;;;;;;;;;;;;;;;;;;;;;
intersection;;;;;1,0;;24,0;4,0;7,0;4,0;17,0;;;;;4,0;;;;2,0;;2,0;12,0;;;;;3,0;1,0;2,0;2,0;27,0;4,0;;3,0;;;5,0;2,0;2,0;6,0;;;;;;;8,0;;;;1,0;;;24,0;13,0;2,0;;;6,0;1,0;;5,0;;4,0;;1,0;;;;3,0;1,0;;;;;;105,0;6,0;;;;2,0;3,0;;;16,0;;4,0;8,0;10,0;;;;;1,0;;;;;34,0;10,0;;;;;;3,0;;;;4,0;2,0;;1,0;;;;;;;;;;;;1,0;;;;;1,0;;;;;3,0;;4,0;1,0;;;;4,0;2,0;;4,0;;;;;;;;;;;;1,0;12,0;;;;;2,0;;;25,0;;;10,0;;;;;;;1,0;;;;;7,0;;;5,0;;13,0;;5,0;;;;;;;;;;;;;;3,0;;;;;;;;1,0;;3,0;;;;1,0;;;8,0;;;1,0;;;;;;;;;;4,0;;6,0;;;21,0;;;;;;;;;2,0;;2,0;8,0;;;5,0;;;;4,0;;;;3,0;2,0;;;;2,0;;;;4,0;;;;;;;;;2,0;;2,0;;;;;;4,0;;4,0;;;;;;2,0;;;;;;;1,0;;;;;;;;;;;;;;;;;;;;;;;3,0;;;;;;;;;;;;;;;1,0;2,0;;;;;;;;;;;;;;;;;;;;;;;1,0;;;;;;;;;2,0;;2,0;;;;;;;;;;;;;;;;;;;;;;3,0;;;;;;;1,0;;18,0;2,0;;;1,0;;;;;;12,0;;;;;;;;;;;;;;;;;;;;;;;;;4,0;;;;;;;;;;;;;;;;;;;;;;;;;;;;;;;;;;;;;;;;;;8,0;;;;;;6,0;;;;;;1,0;;;;;;;2,0;;1,0;;;;;;;;;2,0;;;;;;;;;;;;;;;;;;;;;;;;;;;;;;;;;;;;;2,0;;;;;;;;;;6,0;5,0;;;;;;;;;;;;;;;;;;;;;;;;;;;;;;;;;;;;;;;;;;;;;;1,0;;;;;;;;;;;;;;;;;;;;;;;;3,0;;1,0;;;3,0;;;;;;;;;;;;;;2,0;3,0;;;;;;;4,0;;4,0;;;;;;;;;26,0;;;;;14,0;;;;;;;;;;4,0;;;;;;;;;;;;3,0;16,0;;;;;1,0;;;;;;;;;;;10,0;;;3,0;;;;;;;;;;;;;;;;;;;;;;;;;;;;;2,0;;;;;;;;;;;;;;;;24,0;;;;;;;;;;;;;;;;;;;;;;;;;1,0;;;;;;;;;;;;;;;;;;;;;;6,0;;;;;;;;;;;;;;;;;;;;;;;;1,0;;;;;;;;;;;;;;;;;;;;;;;3,0;;;;3,0;;;;;;;;;;;;;3,0;;;;1,0;;;;;;;;;;;;;;;;;;;;;;;;;;;;;;;;;;;;;;;;;;;;;;;;;;;;;;;;;;;;;;;;;2,0;;2,0;;;;;;;;;;;;;1,0;;;10,0;;;;1,0;;;;;;;;;;1,0;;;;;;;;;;4,0;;;;;4,0;;;;;;;;;;;
join;;;;;2,0;;2,0;17,0;;;7,0;1,0;;;;;;;4,0;;;5,0;;;;;;;;;2,0;;1,0;;1,0;;;14,0;;;;;4,0;14,0;;;2,0;;;2,0;;;;;;17,0;2,0;;;22,0;;;4,0;;;1,0;10,0;;;1,0;5,0;2,0;;;1,0;;;2,0;3,0;;;;;;;;;1,0;;;2,0;;;;;;;;;;68,0;5,0;;1,0;;;1,0;14,0;2,0;;;;;7,0;;;;;9,0;17,0;1,0;;;7,0;;3,0;2,0;4,0;;;9,0;;;;;;2,0;;4,0;;;;1,0;10,0;;;15,0;26,0;;;;;14,0;;1,0;1,0;2,0;9,0;;1,0;;;9,0;;;1,0;;;;2,0;20,0;;2,0;2,0;1,0;32,0;;;;;9,0;;6,0;;;3,0;12,0;15,0;;41,0;;;;;;;;4,0;1,0;4,0;;2,0;;12,0;;;;;;7,0;;;2,0;;;;1,0;;;;4,0;4,0;7,0;;5,0;;;;;;2,0;;5,0;7,0;1,0;3,0;;;4,0;;8,0;2,0;;3,0;1,0;;;3,0;;;;;3,0;3,0;;1,0;1,0;4,0;;4,0;;1,0;10,0;4,0;1,0;;6,0;;1,0;;2,0;8,0;5,0;;1,0;;;;;;1,0;;;2,0;;;6,0;1,0;;5,0;;;1,0;;;;;3,0;;;;;;2,0;;2,0;2,0;;7,0;2,0;;4,0;;;4,0;;;;2,0;1,0;6,0;;8,0;;;;1,0;;1,0;;;;;;;;;;;;1,0;;;;;;;;;;;;;;;;;;4,0;;;;;;;;;;;;;1,0;;;;;;;;1,0;;;;;;;;;;;;;;;;;;;;;;;;;;;;3,0;;;2,0;1,0;1,0;;;;;;;1,0;;;;;;1,0;;;;;1,0;;;;;;;;;1,0;;;;;;;8,0;1,0;;1,0;;;;;;;;;;;;;;;;;4,0;;;;;;1,0;;;;;;;;;;;;;;;;;;;;1,0;2,0;1,0;;;;;;;;;;;;;1,0;;;;;;;;4,0;4,0;;;;;;;;;;;;;;;;2,0;;;;2,0;1,0;;;;;;;;;1,0;;;;;;7,0;;;;;;;;;;;;3,0;;3,0;;;;;;;;;;;;8,0;;;;2,0;;;2,0;;;;;;2,0;;;1,0;;;;;3,0;;;;;1,0;;;;;;;2,0;;;;;;;;;;;;2,0;;;;;;;;2,0;1,0;;;1,0;;;5,0;;;;;;;;;;;;;2,0;;;2,0;;;;;;;;;;;;;1,0;;4,0;;;;;1,0;;1,0;1,0;;;;;;;;;;;;;;;;;;;;;;;;;;;1,0;;;;;;;;;;;;;;;2,0;;;;;;;;;;;;1,0;;;;;;;;;;;;;;;;;;;;1,0;;;;;;1,0;;;;;;;;;;;;;;;;;;3,0;;;;;;;;;;;;;;;;;;;;;;;;;;;;13,0;;;;;;;;;;;;;;;;4,0;;;;1,0;;;;;;;2,0;;2,0;;;;;;;;;;;;;;;;;3,0;;;;;;;;;;;;;;1,0;;;;;;;;;;;;;;;;;;;;;;;;;;;;;;;;;;;;;;;;;;;;;;;;;;;;;;;;;;;;;;4,0;;;;1,0;;;;;;;;;;;;;;;;;;;;;;;1,0;;;4,0;;;2,0;1,0;;;;;;;;;;;;;;;;;;;;;;;;;;;;;;;;;;;;;;;;
lamp;;;;;1,0;;;;1,0;2,0;4,0;5,0;;;18,0;3,0;;;1,0;;;4,0;;;1,0;2,0;1,0;2,0;;;;2,0;11,0;2,0;2,0;;1,0;;;29,0;2,0;;;8,0;;;;;;;1,0;2,0;;2,0;;9,0;16,0;;;4,0;1,0;;6,0;;;;1,0;;;6,0;2,0;;;;2,0;6,0;;4,0;8,0;8,0;;3,0;1,0;;;;;;;;1,0;;;2,0;;;;6,0;;5,0;4,0;11,0;;;;1,0;;9,0;;;;5,0;;8,0;2,0;1,0;;;1,0;1,0;;;;;;;3,0;;;;2,0;;;;1,0;;3,0;;;8,0;;;;4,0;2,0;;1,0;2,0;;;1,0;;1,0;1,0;;;;1,0;10,0;;;;;1,0;;;4,0;27,0;;;1,0;;16,0;4,0;;;;;;;2,0;1,0;;;;5,0;;50,0;;8,0;;;;2,0;;;;;2,0;;;2,0;4,0;;;;1,0;;;6,0;;;;;;4,0;11,0;;;;;;;27,0;;2,0;;;;;;;;1,0;10,0;5,0;;;9,0;3,0;;;;;1,0;2,0;;;;;;;;1,0;;;;;;;;;2,0;;;;2,0;;;;;7,0;;;3,0;;;;2,0;2,0;;;;;;;1,0;;29,0;;;;;4,0;;;;;;;;;2,0;;;;;8,0;;;;;;;;;;;;;;1,0;;;;4,0;;;3,0;;2,0;;;;;;;;;;;;;;;;;;;4,0;1,0;;;;;;;;;;;;;;;7,0;;;1,0;;2,0;;;;;1,0;;;;;;;;;;;;;;4,0;;;;;;3,0;5,0;;;;;;;;;;;;;;;1,0;;;;;;;;;;;;2,0;;;;;;;8,0;;;;;;;;;2,0;;;;;;19,0;;;;;;;13,0;12,0;;;;;3,0;;;;;;;;1,0;;;;;2,0;;;;;;;;2,0;;;;;;;;;;7,0;;;15,0;;2,0;13,0;;;1,0;;6,0;;;;;;;;;1,0;;;;;3,0;;1,0;;;;;;;;;4,0;1,0;;;;;;;;;;;;;;;;;1,0;;;;;;;;;;;2,0;;;;;;;;;;;;4,0;;;;;;2,0;;;;;;;;;;1,0;;;;;;;;;;;3,0;;;;;;;;;1,0;;1,0;;2,0;;;;;;;;;;2,0;;;;;;;;;;;;;;;;4,0;;;;;;;;;;;;;;;;;1,0;;;;;;;;;;;;;;;;;;;2,0;;;;;;;;;;;;;;1,0;;;;;;;;9,0;;;;;;;3,0;;;;;;;;;;;;;;;;;;;;;;;;;;;;;;;;;;;;;;;;;;;;;;;;;;;;;;;;;;;;;;1,0;;;;;;;;;;;;5,0;;;;;;;;;;;;1,0;;;;;;;;;;;1,0;;;;;;;;;;;;;1,0;;;;;;;;;;;;;;;;;;;;;19,0;2,0;;;;;;;;;;;;;;;;1,0;;;;;;;;;2,0;;;;;;;;;;;;;;;;;;;;;;;;;;;;;;;;;;;1,0;;;;;;;;;;;;;;;;;;;;;;;;;;;;;;;1,0;;;;;;;;;;8,0;;3,0;;3,0;;;;;;;;;;;;;;;;;;;;;;;;;;;;;;;;;;;;;;;;;;;;;;;;;;;;;;;;;;;;;;;;;
landmark;;;;;3,0;;;7,0;20,0;2,0;;;;;;;;;;2,0;;5,0;29,0;9,0;;;;54,0;;20,0;13,0;10,0;14,0;;1,0;;;2,0;;3,0;5,0;;;;;;;;;;5,0;1,0;;;7,0;59,0;11,0;;;1,0;;2,0;13,0;;;;4,0;;1,0;2,0;;;;;;;;;72,0;;;;1,0;2,0;;;;6,0;;;;;;;;1,0;;;2,0;;;27,0;;;;;;1,0;;;;;;;18,0;;;;;;;;;;;;1,0;;;;;;;;;;;;;;;1,0;;;;;;3,0;;;;;;;;;;;;;;;;;;;;;;;;;7,0;;;;;;;;;;;;;;;3,0;;;;;;1,0;;;;;;;;;;;;3,0;;;;;;;;;;;1,0;;;;;;;;;;;;8,0;;;;;;;1,0;;4,0;35,0;;;;;;;;;;;;;;;;;;;;1,0;;;;;;;;;;;;;;;;;;;;;17,0;;;;;;;;;;;;;;;;;;20,0;;;;;1,0;;;;;2,0;;;3,0;6,0;;;;;;;;;;;;;;;;;;;;;;;;;;;;;;3,0;2,0;;;;;;;;;;;;;;1,0;;;;1,0;;;;6,0;;;;;;;;;;;;;;;;;;;1,0;;;;4,0;;;;;;;;;;;;;;;;;;;;1,0;;;;;;;;2,0;12,0;;;;4,0;;;27,0;;;;;;;;;;;;;;;;;;;;;;2,0;;;;;;;;14,0;;;;1,0;;;;;;;;1,0;;;;;;3,0;;;;;;;4,0;5,0;4,0;;;;;;;;;3,0;;1,0;;2,0;;7,0;;;;;;;;;;;;;;;;;;;2,0;;;;;;;;;;;;;;;;;;;;;;;;;;;;;;;;;;;;;;;;;;;;;;3,0;;;;;4,0;;;;6,0;;;;;;;;;;;;;;;;;;;;;7,0;;;1,0;;;;;3,0;;;;;;;;;;;;;;;;;;;;;;;;;;;;;;;;;;;;;;;;;;;;;;;;;;;;;;;;;;;;;;2,0;;;;;;;;;;;;;;;;;;;;;;;;;;;;;;;;;;;;;;;;;;6,0;;;;;;;;;;;;;;;;;;;;;;;;;;;;;;;;;;1,0;;;;;;;;2,0;;;;;;;;;5,0;;;;;1,0;;;2,0;;;;;;;;;;;;;;;;;;;;;;;;;29,0;;;;;;;;;;;;;;;;;;;;;;;;;;;;;;;;;;;;;;;;;;;;;;;;;;;;1,0;;;;;;;10,0;;;;;;;;;;;;;;;;;;;;;;;;;;;;;;;6,0;;;;;;;;;;;;;;;;;;;;;;;;;;;;;;;;;;;;;;;;;;;;;;;;;;;;;;;;;;;;;;;;;;;;;;;;;;;;;;;;;;;;;;;5,0;;;;;;;;;;;;;38,0;;;;;;;;;;;;;;;;;;;;;;;
latch;;;;;5,0;;;10,0;;;1,0;;;;;1,0;;;;;;;;;;;;14,0;;;;;21,0;;3,0;;;9,0;2,0;1,0;1,0;;;18,0;;;;;;11,0;4,0;1,0;;;1,0;;27,0;;;11,0;;;1,0;;;;2,0;;;2,0;;;;;;1,0;;;36,0;;7,0;1,0;;;;;;2,0;;;1,0;;;26,0;2,0;3,0;;1,0;2,0;;14,0;8,0;;;;;;30,0;;;1,0;3,0;1,0;1,0;1,0;;;;9,0;13,0;;;;14,0;;;11,0;;;4,0;7,0;;;;;;4,0;;;;;;1,0;;1,0;3,0;12,0;13,0;;;;13,0;1,0;;7,0;;1,0;3,0;;3,0;;;5,0;;;;;1,0;2,0;;56,0;;13,0;26,0;3,0;;;11,0;;;1,0;;;;9,0;1,0;5,0;18,0;;19,0;;12,0;;23,0;;;;2,0;12,0;14,0;;3,0;1,0;9,0;4,0;;;;11,0;;;;;;;;3,0;;;;;7,0;;;4,0;;;;;;2,0;;;;;;;;2,0;;;1,0;;3,0;;;;;;;1,0;;;1,0;;;;3,0;;;;15,0;;;7,0;7,0;2,0;;;;;3,0;;;1,0;;;1,0;;;7,0;;;18,0;2,0;;;;;2,0;;;2,0;1,0;;1,0;;;;;;1,0;2,0;12,0;;1,0;;;;7,0;;;5,0;;2,0;;;;;;;;;7,0;;;;3,0;;;3,0;;;;;;;;;;;;;;;;;3,0;;;;;2,0;;;;;;;;;;;;;;;;1,0;;;;;;;;1,0;;;;;;;;;;;;;;2,0;;;;;;;;2,0;;;;;;;;;;;2,0;2,0;;;;;;;;21,0;;;;;1,0;;1,0;;;;;;;;;;2,0;7,0;;;1,0;;;;;3,0;;3,0;;;;;;;13,0;;;;;;;;;;;;;3,0;;;;;;;;;;;;;;;;;;;1,0;;;;;;2,0;;;1,0;1,0;;2,0;;;;;;;;2,0;;;;7,0;;;;18,0;4,0;;3,0;;;;;5,0;;;;;;;;;;;1,0;;;;;;;;;;;;1,0;;;;;;;;;;;;;4,0;;;2,0;;;;;;1,0;;;;;;;;;;6,0;;;;;;;;8,0;;;;;;;;;;;;;;;;;;;;;;;;;;7,0;;;;;;;4,0;1,0;;;;;;;;;;;;;;;;;;;;3,0;;1,0;;;;;;;;;;;;5,0;1,0;;;;;2,0;1,0;;;;;;;;;3,0;;;;;;;;;;;;;;;;;;;;;;;2,0;;;;;3,0;;;;;;;;;;;;;;;;;;;;;;;;;;;;;;;;;;;12,0;1,0;;;;;;3,0;4,0;;;;;1,0;;;;;;;;;;;;;;6,0;1,0;;;;;;;;3,0;;;;;;;;;;1,0;2,0;;;;;;;;;;;;1,0;;;;;;;1,0;;1,0;;;;;;;;;;;;;;;;;;;;;4,0;;;;;;;;;;;1,0;;;;;;;;;;;;;;;;;;;1,0;;;;;;;;4,0;;;;1,0;;;;;;;;;;;;;;;;;;;;;;;;;;;4,0;;;;3,0;;;;;;;;;;;;;;;;;;;;;;;;;;;;;;;;3,0;;;;;;;;;;;;;;;;;;;;;;;;;;;;;;;;;;;;;;;1,0;;;;;;;;;;;2,0;;;;;;;;;;;;;;;;;;;;;;;;
lead;;;;;21,0;;28,0;18,0;;;4,0;;;;1,0;;;;2,0;;;1,0;2,0;;2,0;;;1,0;10,0;1,0;;;12,0;1,0;1,0;;;13,0;;;;;16,0;8,0;;;;;5,0;;;4,0;;3,0;;13,0;25,0;;;19,0;;;9,0;;;17,0;3,0;;;1,0;25,0;;;;;;;1,0;3,0;9,0;3,0;2,0;1,0;;;;24,0;;;;1,0;;;;;6,0;;;;7,0;18,0;4,0;;2,0;;;2,0;9,0;;;;18,0;2,0;2,0;;;;;8,0;9,0;;;;8,0;2,0;;8,0;24,0;;7,0;2,0;1,0;4,0;18,0;;8,0;13,0;;3,0;;;;;29,0;;6,0;25,0;37,0;;1,0;;2,0;4,0;;1,0;6,0;3,0;5,0;;2,0;6,0;;1,0;2,0;;2,0;;6,0;;2,0;14,0;;22,0;8,0;;1,0;3,0;5,0;4,0;;;;6,0;;1,0;;1,0;12,0;;85,0;;;;12,0;;;;;23,0;;3,0;;;23,0;;;;3,0;2,0;8,0;;4,0;1,0;;;1,0;12,0;2,0;;;10,0;;;;;;6,0;;;;;;;2,0;;30,0;;1,0;5,0;;3,0;7,0;1,0;1,0;;;;4,0;26,0;;;;10,0;21,0;1,0;1,0;;5,0;;8,0;1,0;40,0;;5,0;35,0;;19,0;;;;1,0;1,0;;;3,0;;;;;1,0;;5,0;;1,0;5,0;;21,0;;;2,0;;;1,0;;;;2,0;1,0;2,0;;;7,0;3,0;;;1,0;;1,0;;4,0;;;1,0;2,0;;;;;214,0;;3,0;;7,0;4,0;;2,0;;3,0;6,0;;;;;;;;;;;;;;;;;;;1,0;4,0;;;;;;;;;;;;;;;;;;2,0;;;;1,0;1,0;;3,0;;;1,0;;;3,0;;2,0;;;;;;;;;;;18,0;;;;;;;;;;1,0;;;;;3,0;;;;;6,0;;;1,0;;;2,0;;3,0;;;1,0;;;;;;;;;;;;;;;;;;;;;;;;1,0;;;;;;;;;;;;;;;;;;;2,0;;;;;;;;;;2,0;;;;;;;;;17,0;;;;;;;;1,0;;1,0;;1,0;;;;;;;;3,0;;3,0;;;;;;;;1,0;;;;;;2,0;;;;;;;;;;;2,0;;;;1,0;1,0;;;;;;1,0;;;;;;;;;3,0;;;1,0;2,0;;;;;;;;;;;;4,0;;;;;;2,0;;;;1,0;;;;1,0;;;10,0;9,0;;;;;;;;;;;;4,0;;;;1,0;;;;;;;;;5,0;;;;;;;;;;;;;1,0;;;;;;;48,0;;;;;;;;;;;;;;;;;;;;1,0;;;2,0;;1,0;;;;;;;;;3,0;2,0;;;;;;;;2,0;;;;;;;;;;;;;;;;;;;;;;;4,0;;;;;;;;;;;;;;2,0;;;;;;3,0;;;8,0;;;;;;;;;;;;;;;;;;;;;;;;;2,0;;;;;;;;;;;;;;;;;4,0;;;;;;;;;;3,0;;;2,0;;;;;;;;;;;;;;;;;;;;;;;;;;;;;;;;;;;;;;;1,0;;;;;;;;;;;;;;2,0;;;;;;;;;;;;;;1,0;;;6,0;;;;23,0;;;;;;;;2,0;2,0;;1,0;;;;;;;2,0;;;3,0;;;;;2,0;11,0;;;;;;;1,0;;;;2,0;;;;;;;;1,0;;;;3,0;;2,0;;;;;;;;;4,0;;;;;;;;;;;;;;;;;;;6,0;;;;;;;;;;;;;;;;;;;;;1,0;;4,0;2,0;;;;;;;;;;;;;;;;;;;;;65,0;;;;;;;;;;;;;;;;;;;;;;;;;
lever;;;;;9,0;;12,0;11,0;;;6,0;;;;;;;;1,0;;;2,0;;;;;;;;;;;16,0;;;;;18,0;7,0;;;;40,0;4,0;;;;;1,0;;;;;2,0;;2,0;12,0;;;16,0;2,0;;1,0;;1,0;;2,0;;;12,0;8,0;;;;;;4,0;8,0;13,0;2,0;;;;;;;;;;1,0;;;;2,0;;;;;;;3,0;2,0;;;;;;8,0;;;1,0;17,0;;;1,0;;5,0;;;16,0;;;;;;;5,0;3,0;;18,0;15,0;;;1,0;;;1,0;;;;;;;1,0;;11,0;9,0;2,0;;;;5,0;9,0;;5,0;1,0;9,0;3,0;;1,0;;;;3,0;;;;;;;32,0;42,0;5,0;5,0;7,0;8,0;4,0;;;;;;8,0;;19,0;2,0;16,0;1,0;;12,0;;;;2,0;;;;;21,0;7,0;;2,0;;10,0;;;;;2,0;5,0;;;;;;;1,0;;;;2,0;;;;;;;;;2,0;1,0;;1,0;;2,0;;1,0;3,0;;;4,0;;;;;;;;1,0;;;;;14,0;;;;2,0;;;;18,0;;;21,0;8,0;2,0;;1,0;3,0;;3,0;;;;;;;;1,0;46,0;;;16,0;;5,0;8,0;;20,0;3,0;;;;;;;;1,0;;;;;3,0;2,0;6,0;1,0;;1,0;2,0;2,0;;;;;;1,0;3,0;;;;;;12,0;6,0;;;;10,0;;;1,0;;3,0;;;;;;;;;;1,0;;;;;;;;1,0;;;;;;;;;;;;;;;6,0;;;1,0;;;;;;;;;;;5,0;;;;;;;;;;;8,0;2,0;2,0;;33,0;;;;;;;;;;;;;;6,0;1,0;;6,0;;;;;;;;;;;;;;;;;;;1,0;;;;;;;;;;;;;;;;;;;;;;;;;;;;;;;;;;;;12,0;;;;;1,0;;;;;;;;;;;;;;20,0;;;;1,0;;5,0;;1,0;1,0;;;;;;;;;;;;;;;8,0;;;;;;;;;;;;1,0;;;;;2,0;;;;;;;;;;;;;;;;;2,0;;;3,0;;;;;;;;;;1,0;1,0;4,0;;;;;;;;;;1,0;;;;;;;;3,0;;;;;;;;;;1,0;;;;;;2,0;;;37,0;;;;;;;;;;;;2,0;9,0;;;;;;;;;;;;1,0;;;;;;;;4,0;;;;;;;2,0;;;;;;;;;;;;;;;;;;;1,0;;;1,0;;;;;;1,0;8,0;;;;;;7,0;;;;11,0;;;;;;;;;;;;;;;;;;;;;;;14,0;;;1,0;;;;;;;;;;;;;;;;;7,0;;;;;;;;;;;;;;;;;;;;;;;;;;3,0;;;;;;;;;;;;;;;;;;;;;;;;;;;;;;;;;;;;;;;;;;;;;;;;;;;;;;;;1,0;;;;;;;;;;;;;;;;;;;;3,0;;;;;;;;;;;1,0;4,0;;;;;;;;;;;;;;;;;;5,0;5,0;;;;;;;;13,0;;1,0;;;;;;;;;7,0;;;;;2,0;;;;;;;;;3,0;3,0;;;;;;;;;;;;;;;;;;;;2,0;;;;;;;;;;;;;;3,0;;;;;;;;;;;;;;;;;;;;;;;;;;;;;;;;;;;;;;;;;;;;;;;;;;;;;;;;;;;;;;;;;;;;;;;;;;;;;;;;;
link;;;;;42,0;;52,0;41,0;;6,0;22,0;;1,0;;;1,0;;;4,0;2,0;1,0;12,0;2,0;;;3,0;;39,0;6,0;;;4,0;70,0;;25,0;;1,0;40,0;6,0;29,0;13,0;;15,0;16,0;;;;;;3,0;;16,0;11,0;;;67,0;44,0;;26,0;9,0;4,0;;35,0;8,0;1,0;39,0;2,0;;;3,0;;;;;1,0;;;14,0;27,0;1,0;1,0;1,0;4,0;;;;5,0;36,0;1,0;5,0;6,0;;1,0;4,0;;10,0;;2,0;5,0;;6,0;64,0;;1,0;1,0;;6,0;25,0;;;6,0;5,0;;31,0;4,0;;3,0;;3,0;8,0;;;;;;;16,0;;;156,0;;;;2,0;;;15,0;10,0;;;;;4,0;1,0;1,0;5,0;17,0;7,0;;;;2,0;13,0;;;;13,0;18,0;;4,0;;;;3,0;2,0;;5,0;;;;119,0;4,0;15,0;34,0;11,0;1,0;;3,0;;;1,0;;12,0;;24,0;2,0;4,0;34,0;;36,0;;;;21,0;;;;;59,0;;;6,0;;18,0;;1,0;19,0;7,0;3,0;101,0;;2,0;;;55,0;;19,0;;7,0;;4,0;2,0;;1,0;;;;;;;;;8,0;7,0;13,0;16,0;;1,0;2,0;;;1,0;;1,0;7,0;;2,0;2,0;;1,0;1,0;;;60,0;2,0;3,0;;7,0;;;;3,0;;6,0;22,0;4,0;4,0;;2,0;;2,0;3,0;66,0;;1,0;6,0;;3,0;11,0;;8,0;;6,0;10,0;;5,0;10,0;3,0;1,0;7,0;;1,0;5,0;;;3,0;;;1,0;;9,0;;;1,0;;;7,0;4,0;2,0;;1,0;3,0;1,0;;1,0;;10,0;4,0;1,0;;;;21,0;3,0;;;;4,0;1,0;;13,0;;1,0;;;;;;;5,0;3,0;2,0;;;;1,0;;;;2,0;5,0;2,0;2,0;;;;;;;;2,0;1,0;;;8,0;4,0;;;1,0;;;;;;2,0;6,0;;;;10,0;;;15,0;4,0;;;;;;3,0;1,0;;;;;;;;;;;1,0;1,0;;;;;;1,0;;;6,0;2,0;;8,0;;;;7,0;;6,0;;2,0;7,0;6,0;3,0;;1,0;;5,0;5,0;;;;;;5,0;;5,0;2,0;;;;1,0;;14,0;;;1,0;;;3,0;2,0;;;1,0;3,0;;5,0;1,0;;;;;;;13,0;1,0;1,0;;;;7,0;;1,0;;;1,0;;;;2,0;;;1,0;26,0;1,0;2,0;;1,0;;;;;30,0;5,0;;1,0;;;1,0;1,0;;;;2,0;;;7,0;3,0;;;;10,0;31,0;;4,0;;1,0;;;15,0;;;;;2,0;1,0;;1,0;1,0;;;;23,0;;;1,0;;1,0;;1,0;;;1,0;;;;;;;;;;16,0;;1,0;;;1,0;1,0;;;;9,0;;9,0;;;;8,0;1,0;;;;2,0;4,0;;;;;;3,0;;2,0;11,0;;2,0;;;32,0;;;6,0;3,0;;;1,0;1,0;15,0;;;;;;;;13,0;26,0;;;;;4,0;1,0;;3,0;;;;;;;1,0;1,0;;1,0;;2,0;;;2,0;6,0;1,0;;;;;16,0;;;;;;;;;1,0;;;1,0;;;4,0;;8,0;1,0;;;3,0;;;;;;;;1,0;;1,0;28,0;;;;17,0;;;2,0;;;;;;;;;;;;;;2,0;;;;;;12,0;;;;;;;;;;5,0;;;;4,0;;;;;;2,0;;;;;;;;2,0;;;;;;;;;;;;;;;;;;;2,0;;3,0;;;;;;;3,0;;;4,0;;;1,0;;;;1,0;;;;;;;;;;;;;;14,0;;;2,0;;;4,0;;;;;;;;;1,0;2,0;;;;;;2,0;;;;58,0;;;;;2,0;1,0;;;;;;;;;;;2,0;;;;;;;1,0;1,0;;;8,0;3,0;1,0;;;;;1,0;;;1,0;;;;;;;;6,0;1,0;;;;3,0;;;;2,0;;;;;;;;;;1,0;3,0;;;2,0;;6,0;;;;1,0;;;;;2,0;11,0;;2,0;;;1,0;;;;;;;2,0;;;;1,0;4,0;;;;;1,0;;;;;;;;;;;;;;;;;;;;;;;;;;;;;;;;;;;;;;;;5,0;;;;;;;;1,0;1,0;;;;;;;;;;;;;;2,0;;;1,0;;;;;;;;;;;;;;;2,0;;;;;;;;;;;;
list;;;;;10,0;;;8,0;;3,0;;;;;;7,0;;;;1,0;;6,0;;;;1,0;;40,0;;1,0;;5,0;59,0;;;;;1,0;;65,0;2,0;;;19,0;;;;;3,0;4,0;4,0;29,0;2,0;11,0;;139,0;58,0;;;;;18,0;17,0;;;;;;;5,0;;6,0;;;;26,0;;;3,0;3,0;;8,0;4,0;;;;5,0;;20,0;31,0;4,0;1,0;16,0;5,0;3,0;;;21,0;37,0;;;9,0;;;;;6,0;40,0;;;;5,0;;;;;;;;;;;12,0;;;;19,0;28,0;;;;10,0;;;;;;;;;;;;9,0;;;4,0;;1,0;;;;;;;;;;;;;;;;;;;2,0;;;7,0;;5,0;2,0;;;;3,0;;;;;;;;;;9,0;;2,0;;;;13,0;;;;;1,0;;;;;1,0;;1,0;;;;;;;;;3,0;9,0;6,0;;;;;;;1,0;;;;;;;;;;;;8,0;;1,0;12,0;;;;1,0;;;;;;;;;;;;;;;7,0;;;1,0;;;;;;;;;;;;;;;1,0;28,0;;;1,0;;;;;;1,0;2,0;4,0;;;;;;;;;;;;;;;6,0;;;;;;;;4,0;6,0;;;;;;;;;;;;;;;;;2,0;;25,0;;;;;;;;;;;2,0;;2,0;;;;1,0;;5,0;;1,0;4,0;;;;;;;;;;;;8,0;;;;;;;;;;7,0;1,0;3,0;;;;;;;;;;;;11,0;17,0;;8,0;;;;1,0;4,0;6,0;;;;;;;;;;4,0;8,0;;;1,0;;;3,0;;2,0;;4,0;;2,0;;1,0;10,0;25,0;1,0;2,0;9,0;13,0;8,0;;;;;1,0;;;;;;2,0;23,0;;;;4,0;;1,0;1,0;;2,0;1,0;2,0;;;1,0;2,0;;6,0;;;;;;;2,0;;1,0;13,0;;;5,0;;;;;14,0;;;1,0;4,0;;3,0;1,0;;1,0;7,0;19,0;;;;6,0;2,0;;8,0;8,0;;;;1,0;1,0;;;;;1,0;3,0;;;;;;3,0;7,0;3,0;8,0;;12,0;3,0;;;;21,0;;;;5,0;;;1,0;;;;;27,0;;;;;2,0;;;;;;;;11,0;4,0;;1,0;17,0;;;4,0;;;;;;;;1,0;3,0;;;;3,0;;;;2,0;;;;;;;;;;;1,0;;7,0;12,0;;5,0;;1,0;;;;;;;;;9,0;;;;;;;;;;;;;4,0;;;;;;;;;;;;;1,0;;;;1,0;;;;;;;;;;;;;;;;;;;;;;;;;;;;;;;;;;1,0;;;2,0;;;;;;;;;;;;13,0;;;;1,0;;;;;;;;;;;;;;;;;;;;;;4,0;1,0;;;;;1,0;;;;;;;;;;;;;;;;;;;;;;;5,0;;1,0;1,0;;;1,0;;;;;;;;5,0;;;;;;;3,0;2,0;;;;;;;;;;1,0;;;;3,0;;;;;;;4,0;;2,0;;;3,0;;;;;;1,0;;;;8,0;;;;;;;1,0;;;;;;;;;;5,0;;3,0;;;;;;;;;;;;;;;;;;;;;;4,0;;;;;;;;;;;;;;6,0;;;;;;;2,0;;;3,0;;;;;;;;;1,0;;;;;;;;;;;;;;;;;;;;;;;;;;;;;;;;;;;;;;;;;;;;;;;;;1,0;;;;;;;;1,0;;;;;;;;;;;;;;;;;;;;;;;;1,0;2,0;;;2,0;;;;;;;;;;;;;;;;;;;;;;1,0;;;;;;;;;;1,0;;;;1,0;;;;;;;;;;;;;;
live;;;;;1,0;;;9,0;;45,0;1,0;;;;;;;;;;;70,0;2,0;;;;;24,0;;2,0;1,0;12,0;26,0;1,0;41,0;;;7,0;;156,0;;;2,0;3,0;;1,0;;;4,0;;2,0;12,0;;;;153,0;17,0;;;6,0;;1,0;19,0;;;2,0;5,0;;3,0;20,0;4,0;;3,0;;;;;9,0;14,0;;;11,0;;9,0;;;;;1,0;5,0;28,0;20,0;2,0;15,0;1,0;1,0;;2,0;3,0;;;16,0;;;;;;19,0;1,0;;3,0;;;;;;;;;;;;1,0;1,0;;;5,0;;;1,0;1,0;;;;;;;;;;;;;;;;;2,0;;;;;;;;;;;;8,0;;;;;;;1,0;7,0;;;1,0;3,0;;;2,0;2,0;;2,0;;4,0;;;1,0;;;;;6,0;;24,0;;;;10,0;;1,0;;;1,0;;;;;;;;;;;1,0;;;;;;18,0;4,0;;6,0;;;2,0;1,0;;;;;;;;;;;;;;;;4,0;1,0;;;;;;2,0;;;;1,0;;;;;;;;;;;;;;;;;;;;;;4,0;;;;10,0;;;;3,0;;;1,0;2,0;;;2,0;42,0;3,0;;;;;;;;;4,0;;;;;2,0;;;;;;;;11,0;7,0;2,0;;;;;;;;;;;;;;;;1,0;;5,0;;;;;;;;1,0;;;4,0;;2,0;;;;7,0;;5,0;;;1,0;;;;;;;;5,0;;;;1,0;1,0;;;;1,0;;;;;;1,0;1,0;;;;;6,0;;1,0;;;;;;18,0;4,0;2,0;;;1,0;;3,0;;;;1,0;;;1,0;;;5,0;;;;;;;3,0;;57,0;;;6,0;;13,0;;;8,0;105,0;;;19,0;;24,0;3,0;;;;2,0;;;;;1,0;4,0;;;;2,0;2,0;;1,0;;;;2,0;;1,0;;;;;4,0;2,0;;;;;;6,0;7,0;2,0;;3,0;;16,0;2,0;;;;;;;;;9,0;4,0;2,0;;2,0;;;;10,0;;11,0;;;47,0;215,0;11,0;;;;;;;;1,0;;;;;;;;;;;;;;;;;;1,0;;;;1,0;;;5,0;3,0;;;9,0;;;;;1,0;;;;;;;;;;;1,0;6,0;;;;6,0;;3,0;;;2,0;3,0;;;;;2,0;;;;;;;3,0;1,0;;;;;;;;2,0;13,0;;;;;;;7,0;6,0;;;;;;;;;;;;4,0;;;1,0;1,0;;;;;;;;;;3,0;;;;;;;;;;;;5,0;;;;;;;;3,0;;;;1,0;;;;;;;;;;;;;;;;;;;;2,0;;;;;1,0;;;;;;;;;;;;;;23,0;;;;5,0;;;;4,0;;;;;;;1,0;;;;;;1,0;;;;;;;;;1,0;;1,0;1,0;;1,0;1,0;;;;;;;;;;;;;;;2,0;;10,0;2,0;2,0;;;;;;;;;;;;;;;;;;;;1,0;;;;;;;;;;;;;;;3,0;;;;1,0;;;;;;;;;;1,0;;;;;;;;;;;;;3,0;;;;;;;;11,0;4,0;;1,0;;;;;;6,0;;;;;;;;;;;;;;;;7,0;;;;;;;;;2,0;;;5,0;;;;2,0;;4,0;;;3,0;;;;;;4,0;;;;;;;;;4,0;;;;;;;;;;;;;;;;;;;;;;;;;;;;2,0;;;;;;;;;;;;;;1,0;;;;;;;;;;;;;;;;;;1,0;;;;;;;;;;;;;;;;;;;;;2,0;;;;;;;;;;;;;;;;;;;;;;;;;;;;;;;;;;;;;;;;;;;;;;;;;;;;;
lock;;;;;12,0;;15,0;40,0;;12,0;3,0;;;;;3,0;;;14,0;2,0;1,0;48,0;;;;;;21,0;;2,0;;;75,0;;3,0;;;27,0;2,0;3,0;;;5,0;46,0;;;6,0;;13,0;1,0;10,0;;;;1,0;8,0;50,0;;1,0;36,0;5,0;;9,0;;;;3,0;;;24,0;1,0;;;;2,0;;;5,0;122,0;;9,0;;;;;;2,0;1,0;;8,0;5,0;;;8,0;;9,0;;;3,0;27,0;28,0;18,0;;;;;6,0;40,0;;;9,0;8,0;;40,0;15,0;2,0;;;1,0;59,0;1,0;;7,0;;;;29,0;8,0;;12,0;35,0;1,0;;11,0;;;27,0;11,0;;;;;1,0;2,0;;10,0;28,0;11,0;;;;27,0;16,0;1,0;15,0;;23,0;18,0;;1,0;;2,0;2,0;13,0;;;;;;3,0;162,0;13,0;30,0;22,0;7,0;36,0;11,0;;4,0;;;;3,0;;19,0;5,0;112,0;6,0;;67,0;;7,0;;13,0;4,0;;;3,0;46,0;20,0;;6,0;6,0;20,0;7,0;;;;13,0;23,0;;;;;;;2,0;;;;13,0;1,0;1,0;;4,0;;3,0;;;1,0;1,0;;5,0;7,0;4,0;1,0;3,0;2,0;;2,0;6,0;;3,0;3,0;5,0;42,0;1,0;;2,0;1,0;;;;13,0;;1,0;15,0;3,0;4,0;;;;2,0;10,0;31,0;22,0;20,0;;5,0;3,0;2,0;17,0;;1,0;14,0;6,0;;46,0;;4,0;;;4,0;121,0;8,0;2,0;6,0;;25,0;2,0;1,0;;;;;2,0;;;;;4,0;2,0;6,0;2,0;17,0;1,0;;;9,0;3,0;;3,0;2,0;;11,0;;3,0;;5,0;;;1,0;13,0;12,0;;;;42,0;1,0;;;;1,0;;;;;;;;;1,0;2,0;;;;;2,0;;8,0;9,0;1,0;;;;;;;4,0;;;;;;;;;;3,0;;;1,0;;;3,0;;4,0;;;7,0;;;;2,0;1,0;;;;;4,0;20,0;10,0;11,0;1,0;5,0;;;1,0;;;;;;;;;;;;;1,0;5,0;;;1,0;;17,0;;5,0;;;;;;19,0;;;;;;;;;;;3,0;;;;8,0;6,0;;;;12,0;;;;;;;;1,0;16,0;;;;;1,0;;;;;;;1,0;50,0;;1,0;;;;1,0;1,0;1,0;;5,0;1,0;;;1,0;;4,0;;;7,0;1,0;;;4,0;;1,0;;;4,0;;;;;;;;;;1,0;7,0;;1,0;;1,0;2,0;;;3,0;;;11,0;;;;2,0;1,0;;1,0;;;13,0;2,0;;;;;6,0;;;;6,0;1,0;1,0;;;;;1,0;1,0;;8,0;;;;;;;;;2,0;;5,0;;;;1,0;;;1,0;;18,0;;;;1,0;;;;5,0;;33,0;;;4,0;;;1,0;;1,0;9,0;3,0;;;;2,0;;2,0;7,0;;1,0;;;4,0;;1,0;;;1,0;1,0;;;;3,0;;1,0;39,0;;;;;;;1,0;;;;;;;;;1,0;;1,0;;17,0;4,0;3,0;1,0;;;;5,0;;1,0;;;;;;;;;;;;;1,0;;6,0;1,0;7,0;;2,0;;;;1,0;2,0;;;3,0;3,0;;8,0;;1,0;;;1,0;;2,0;;;;;;;;;;;;;;4,0;;;;;;;;;;;;;;2,0;;;;4,0;;;;;;;;2,0;;;;;12,0;;;;;;;;;;;;;;;;;;;;;;;;;;;;8,0;1,0;;;;;;;;4,0;;;;1,0;;1,0;;;;;1,0;;;;;17,0;;4,0;;;;;;;;;;;;;;;;1,0;;;;2,0;;1,0;;;;4,0;;1,0;;;1,0;;;;;;;;;;;6,0;;;;3,0;;;1,0;;;;1,0;6,0;;1,0;;6,0;;2,0;2,0;;;;;;;;;;;8,0;12,0;;;;;;1,0;1,0;35,0;;6,0;;;;;;1,0;;1,0;7,0;;;;;1,0;;;;;;;;;19,0;6,0;;;;;2,0;;;;;;;;;;;;;;3,0;1,0;;;;;;;;1,0;;;;;;1,0;;;;;;;;;;;1,0;;;;;1,0;;;;;;;;;;;;;;;;1,0;;;;;;;;1,0;;;;;;;;;;;;;;;;;;;2,0;;;;;;;;;;;;;;;;;;;;;;
machine;;;;;10,0;;2,0;7,0;1,0;2,0;2,0;2,0;;;3,0;;;;22,0;8,0;;15,0;4,0;;;;2,0;21,0;3,0;5,0;;6,0;22,0;2,0;;2,0;5,0;1,0;3,0;14,0;;;1,0;3,0;;;;;4,0;;5,0;11,0;;;;33,0;37,0;;2,0;3,0;;;20,0;;;4,0;;3,0;;10,0;;1,0;;;;;;2,0;17,0;1,0;;8,0;2,0;1,0;;;3,0;2,0;;3,0;5,0;;;7,0;;4,0;;22,0;18,0;;8,0;25,0;;8,0;22,0;;;15,0;;;1,0;;;1,0;4,0;;;;1,0;10,0;;1,0;;3,0;;;12,0;;1,0;3,0;4,0;;;;;;2,0;;;;;;;2,0;;;5,0;18,0;;16,0;;;;;;;;2,0;;;;;2,0;3,0;;4,0;1,0;7,0;4,0;7,0;;;2,0;24,0;2,0;1,0;4,0;2,0;5,0;;1,0;;1,0;;;7,0;4,0;9,0;;14,0;;;1,0;7,0;;;;;4,0;;;;;;;;;1,0;4,0;14,0;1,0;1,0;;;;2,0;1,0;;;;4,0;;;;;;;;1,0;;;;2,0;1,0;2,0;6,0;;;10,0;;;;;2,0;;;5,0;;;;;;;;;;;5,0;;;;1,0;9,0;;1,0;;2,0;;;;;2,0;2,0;;;6,0;1,0;;;2,0;;;;7,0;1,0;;;2,0;8,0;;;;;5,0;;1,0;;;;;4,0;;1,0;;;;;2,0;;;;1,0;;;;;;;;2,0;;1,0;;;;3,0;;;;;7,0;;3,0;;;;;;;1,0;;6,0;;1,0;2,0;;1,0;1,0;2,0;2,0;;1,0;13,0;;;;;;;;;;;;1,0;5,0;;1,0;;;;;;2,0;45,0;9,0;3,0;;;;1,0;;4,0;12,0;;;;;95,0;4,0;;4,0;;;;;;2,0;1,0;;;;1,0;;12,0;;13,0;2,0;1,0;1,0;1,0;1,0;;;;3,0;1,0;;8,0;1,0;8,0;;;2,0;6,0;;;8,0;1,0;;1,0;;;;;;;;5,0;;;;3,0;;;7,0;;;;;2,0;11,0;9,0;;;;;1,0;18,0;;;11,0;;;;4,0;;4,0;2,0;;;15,0;;;1,0;2,0;37,0;;;;;;;;;2,0;28,0;;;2,0;1,0;;;;3,0;16,0;;;1,0;;4,0;;1,0;2,0;1,0;;;;;;;;;54,0;;;;;;;;;;;;;1,0;;;;1,0;;;;;;;;;2,0;;;;;;;;;;;;;;;3,0;;5,0;4,0;;11,0;1,0;;;;;;;;;;;;;2,0;;;;9,0;1,0;11,0;17,0;;;;;3,0;;;;;;;;;;;;2,0;;;;;1,0;;;1,0;;;;;;;;;;;4,0;;;;1,0;;;;;;;;;;;;2,0;2,0;1,0;;;1,0;1,0;;;1,0;;17,0;;4,0;4,0;;;;;2,0;;;;1,0;;;3,0;;;;;;;;1,0;1,0;;;;;;;;6,0;;;;;;;;;;;;;;;;;;;;;;;;;;;;;;;;;;1,0;;;;9,0;;;;1,0;;2,0;;;;;;1,0;;;;;2,0;;3,0;2,0;;;;;3,0;;;;;;2,0;;;;;;;;;;;;;;;;;;1,0;;;;;;1,0;5,0;;;;;;4,0;;;;;;;;;;;;;;;;;;;2,0;;1,0;;;;12,0;;;;;;;8,0;;;;1,0;;;;;;;;1,0;;;2,0;;;;1,0;;;;;;2,0;;;;;;1,0;;;;;;;;;;;;;;;;;5,0;;3,0;;;;;;;;;;;;;1,0;;;;;1,0;;;;;;;;;;;;;1,0;;;;1,0;;;;;;;;3,0;;;;;;;;;;1,0;;1,0;;;;;;;;;;;;;;;1,0;;;;;;;;15,0;;;;;;;1,0;1,0;;;;;;;;;;;;;;;;;;;2,0;;;;;;;;;;;;;;4,0;;;;;;;;;;;;;;;;;;;;;;;
magnet;;;;;28,0;;20,0;29,0;;3,0;8,0;;2,0;;;1,0;;;2,0;;;2,0;;4,0;10,0;;2,0;;6,0;10,0;1,0;;17,0;;10,0;;3,0;59,0;;;6,0;;27,0;28,0;;;;2,0;3,0;;1,0;48,0;;4,0;4,0;21,0;53,0;;;146,0;1,0;;1,0;;;14,0;9,0;;;1,0;21,0;2,0;;2,0;3,0;1,0;;2,0;50,0;2,0;1,0;;;2,0;;;;;;;32,0;7,0;;11,0;;10,0;;;;2,0;73,0;8,0;;;1,0;;;75,0;2,0;;;49,0;;26,0;12,0;;;;2,0;23,0;;;;11,0;1,0;;13,0;11,0;;18,0;5,0;4,0;;11,0;4,0;;49,0;;;;;;3,0;38,0;;74,0;27,0;25,0;;;;;17,0;;31,0;48,0;5,0;22,0;;1,0;;;35,0;15,0;;5,0;;6,0;;1,0;237,0;;57,0;71,0;17,0;1,0;23,0;;;;;1,0;10,0;;;1,0;9,0;26,0;;61,0;1,0;1,0;;27,0;;;;;28,0;19,0;;8,0;8,0;66,0;1,0;;8,0;7,0;1,0;22,0;;16,0;;;;;4,0;;;;33,0;;3,0;;6,0;;;;;7,0;;;21,0;15,0;;2,0;7,0;6,0;3,0;2,0;40,0;2,0;2,0;6,0;;11,0;;;4,0;187,0;;;;37,0;3,0;1,0;6,0;5,0;1,0;;;78,0;;12,0;1,0;;11,0;3,0;8,0;15,0;;1,0;;;2,0;;;;8,0;9,0;;;5,0;6,0;;3,0;32,0;;2,0;50,0;;;;;185,0;6,0;;;4,0;45,0;1,0;;9,0;5,0;;2,0;;3,0;1,0;3,0;;2,0;;;7,0;;2,0;13,0;;;32,0;9,0;8,0;5,0;;;;4,0;3,0;;;2,0;;;;;;;;;2,0;;;;;;;;;;8,0;;;;;;;;;1,0;;;;;;;;;;;;3,0;;;;;;;;6,0;;2,0;;;;;;;;;;;2,0;;33,0;;2,0;;;;;;;6,0;;;;;1,0;;5,0;6,0;2,0;;;;;;;;;;;1,0;;;;;;;;;;;;;;;;;;;;;;;;;;;;;54,0;;;;;;;;;;;;;5,0;32,0;;;;;;;;;;2,0;;;;;;;;;18,0;;;;;;;;;;3,0;;4,0;;;;;;;1,0;4,0;;5,0;;;3,0;;;;1,0;5,0;4,0;;;;;2,0;4,0;;;;;;;;7,0;;2,0;;;;;;;;;;;23,0;;;;;;;;;1,0;;;;4,0;;;;;;1,0;;1,0;;4,0;;;;;;;;1,0;;;;;;;;;;;1,0;1,0;;;;;4,0;;10,0;;;;;3,0;;;;;;;;;;;1,0;8,0;1,0;7,0;;;;;;;;;;;2,0;;;;;2,0;;;2,0;;;;4,0;;3,0;4,0;;3,0;;1,0;;;;;4,0;;;;;;1,0;3,0;1,0;;;;;;;;;;;9,0;6,0;;;;;;;;;;;;;;;;;;;;;;;;12,0;;;;2,0;;;;;1,0;;;;;;;;;;;3,0;;;;;;19,0;;;;;4,0;;;;;;;;1,0;;;;;;;;;4,0;;;;;;2,0;;;1,0;;;1,0;;;;;;;;10,0;2,0;;;6,0;;;;;;;;;;;;;;1,0;;;;;;;;;;;;;;;;;;;;4,0;;;;;;;;;;;;;1,0;;;;61,0;;;;;;;;;;;;;;;;;;;6,0;;;;;;;;;4,0;;;;;;;;;;;;;;;;4,0;5,0;2,0;8,0;2,0;5,0;;;;3,0;1,0;3,0;;;;;3,0;3,0;;;;;;;1,0;2,0;5,0;;;;;;;;;;;;;;;;;;;;;;;;;;;;;;;;;;;;;;;;;;;;;13,0;;;;;;;;1,0;3,0;;;;;;;;;;;;1,0;;;2,0;;2,0;;;;;2,0;;;;;;;;;;;;;;;;;;;;;;;3,0;;;6,0;;;;;;;;;;;;;
manufacturing;;;;;9,0;;1,0;3,0;;2,0;1,0;1,0;;;3,0;;2,0;2,0;6,0;;;;;3,0;2,0;;;6,0;;1,0;1,0;;55,0;;1,0;;;1,0;;12,0;;;;2,0;3,0;;;;2,0;;1,0;;;;3,0;47,0;13,0;;;22,0;;;226,0;;8,0;;;;1,0;;20,0;1,0;;;;;;1,0;2,0;;;1,0;3,0;;1,0;;1,0;;;;41,0;;;3,0;1,0;;;;3,0;7,0;12,0;7,0;;;;;1,0;9,0;;;;;1,0;12,0;2,0;;;;4,0;2,0;3,0;;;10,0;1,0;;;2,0;;;11,0;1,0;3,0;;1,0;2,0;;;2,0;4,0;;1,0;;2,0;3,0;;9,0;2,0;;2,0;;;;4,0;;2,0;;;;21,0;;1,0;;;;21,0;2,0;9,0;;11,0;1,0;1,0;106,0;3,0;;;;2,0;6,0;;;;;;;;2,0;7,0;;6,0;1,0;;;2,0;;;;;1,0;;16,0;2,0;5,0;1,0;;1,0;2,0;;;;;1,0;;;;2,0;;3,0;;;;1,0;;;;;;;;;;4,0;3,0;;;;;;1,0;;;;1,0;;;;;4,0;;;;;3,0;;1,0;;;2,0;;;;3,0;;;;;1,0;;;1,0;;1,0;;;1,0;6,0;;;;;;;;1,0;3,0;;;;;;;;;1,0;;;;;;;2,0;;;;;;;;1,0;1,0;;;;;;;;1,0;;1,0;;;;;;;2,0;;1,0;;;;;;;;;;;;;2,0;;;2,0;;;;2,0;;;;;;;;;;7,0;;;;;;;;;;;;;1,0;;1,0;;;1,0;;;;;10,0;;;;;;;;;;;;;6,0;;;;;;;;;6,0;;;;;;;;1,0;;;1,0;;;;;1,0;;;;1,0;;;1,0;;;;;;;;;;;;;;;;;;;;1,0;;;;;;;1,0;;;;;;;;;;;;;1,0;;1,0;;;1,0;;;;;1,0;;;;;;;;;;;;;3,0;;;;;;1,0;2,0;1,0;1,0;;;;;;;;;;;;;;;;1,0;;3,0;;;;;;;7,0;;;1,0;;2,0;;;;;;;;;;;;;2,0;;;;;;1,0;;;;2,0;1,0;2,0;;2,0;;;;;;;1,0;;;;;1,0;;;;;;;;;;1,0;2,0;;;;;;1,0;2,0;;;;;;;;;;;;;;;;;;;2,0;;;;;;;;;;;;;;;;1,0;;;;;;;;;;;;;;;1,0;;1,0;;;;1,0;1,0;;;;1,0;3,0;;;;3,0;;;;;;;;;;;;;;2,0;;2,0;;;;;;1,0;;;3,0;;;;;;;;2,0;3,0;;;;;;;;;;;;;;;;;;;;;;;;10,0;;;;;;;1,0;;;;7,0;;;;;;;;;;2,0;;;;;;;;1,0;;;1,0;;;1,0;;;;;;;;;;;;;;;;;;;3,0;1,0;1,0;;;;;;;;;;;;;;;;1,0;;;;;;;;;;;;;;;;;;;;;;3,0;;;;;1,0;;;;;;;;;;;;;;1,0;;;;;;1,0;;;;;;;;;;;;;;;;;;;;;;;;;;;;1,0;;;;;;;3,0;;;;;;;;;;;;;;;;;;;;;;2,0;;;;;;;;;;2,0;;;;;;;;;;;;;;;;;;;;;;;;;;1,0;;;;;;1,0;;;;;;2,0;;;1,0;;;;;;;;;;;;;;;;6,0;;;;;;;;;;;;;;;;;;;;;;;;1,0;;;;;;;;;;2,0;;;;;;;;;;;;;
mark;;;;;14,0;;2,0;4,0;;14,0;;4,0;;;6,0;2,0;;;;2,0;2,0;2,0;2,0;2,0;;;;19,0;;5,0;7,0;7,0;17,0;38,0;4,0;;;;;98,0;39,0;;;5,0;1,0;;;;139,0;;1,0;17,0;;1,0;3,0;83,0;21,0;;;48,0;;;35,0;;;;2,0;;2,0;6,0;2,0;2,0;;;6,0;2,0;;7,0;72,0;;;2,0;5,0;2,0;;1,0;10,0;;9,0;3,0;2,0;3,0;1,0;6,0;4,0;1,0;35,0;;3,0;8,0;8,0;11,0;;;;;;5,0;;;5,0;14,0;;11,0;1,0;;;;2,0;8,0;;;;;5,0;;5,0;;;5,0;;1,0;4,0;;2,0;7,0;10,0;;42,0;;;;;8,0;5,0;;57,0;104,0;;;;;3,0;;3,0;;14,0;;1,0;6,0;;3,0;;;;5,0;2,0;13,0;;7,0;4,0;37,0;12,0;1,0;10,0;;3,0;;;;1,0;;5,0;;;9,0;5,0;39,0;;3,0;;;;2,0;;12,0;;;;;;13,0;;4,0;;2,0;;1,0;3,0;;;;;;;11,0;7,0;8,0;;;;;;10,0;;;;;;;;;;;;;;1,0;16,0;;;;;;;;;;;;;;;3,0;;;;13,0;9,0;;;1,0;1,0;;;;3,0;;;;;2,0;;;;;;;;5,0;;;;2,0;;1,0;2,0;8,0;;;;;;3,0;;;;5,0;;;;;4,0;5,0;;;;13,0;;;35,0;6,0;;;10,0;;;;;;;;;;;1,0;;;;;13,0;9,0;;;;;;;1,0;10,0;;2,0;;;;;;;;10,0;3,0;;;;;;;5,0;;;;;3,0;;1,0;10,0;;;;;;;;3,0;2,0;;1,0;;;4,0;;;;1,0;;;;2,0;;1,0;;18,0;;1,0;;;6,0;26,0;1,0;;;;;;;;1,0;5,0;;;10,0;;;2,0;;49,0;7,0;;3,0;3,0;3,0;1,0;;;3,0;;;5,0;1,0;1,0;1,0;;;;;;;;;;;;;1,0;;1,0;;1,0;;;;1,0;7,0;;1,0;;3,0;;3,0;;;;;;;2,0;1,0;;;;;4,0;;;;;1,0;;;;;;;;1,0;9,0;13,0;1,0;;2,0;;;;;17,0;7,0;;1,0;;;;;;;;;;;;;;;;;;;;1,0;2,0;;;;;1,0;;;;;;;;;;;;;;;;;;;;;;;;1,0;;;;2,0;;;;;3,0;;;;11,0;;1,0;;;;25,0;3,0;;;;;;2,0;;;;;;;3,0;1,0;;;;;;;;1,0;;;;2,0;;;;;1,0;1,0;;;1,0;;;;1,0;;;;;;;;;;;;;9,0;;1,0;;1,0;;1,0;;;;;;3,0;;;31,0;;;;;;;;;;;;;;;;;;;;;;;;1,0;;9,0;;;;8,0;;;;;2,0;;;;;;;;;;;;;2,0;6,0;1,0;;;;;;;;;;;;;2,0;;;;;;;;;;;;;;2,0;;;1,0;1,0;;;;;4,0;1,0;;;;;;;;;;1,0;;;;;1,0;;;;;;;;;;;;;;;;;;;;;;;;;;;4,0;5,0;1,0;1,0;;;1,0;;;;4,0;;7,0;3,0;;;;6,0;;1,0;;;;;1,0;;;;8,0;;3,0;;;;;;;;;;;;;1,0;;;;;;;;;;;;;;;;;;;;;;1,0;20,0;;3,0;;1,0;;;;;;;;18,0;6,0;;;;;;;;;;;3,0;;;;;;;;;;4,0;;;;;;;;;;;;;;;2,0;;;;;;;;;;1,0;;;;;;;;;;;;5,0;;;;;;;;;;;2,0;1,0;;;;;;;;;51,0;;2,0;;;;;;;;;;;;;;;;;;;;;;;2,0;3,0;;;5,0;;;;;1,0;;;;1,0;;3,0;;3,0;;;;4,0;;4,0;;3,0;;;;;;;;;;7,0;;;;;;1,0;;;;;;;;;;;;
mask;;;;;20,0;;;60,0;4,0;11,0;18,0;2,0;10,0;4,0;73,0;;1,0;;;2,0;2,0;38,0;3,0;1,0;3,0;;4,0;15,0;;18,0;20,0;9,0;32,0;3,0;8,0;;2,0;7,0;1,0;27,0;2,0;;1,0;7,0;;;;;1,0;7,0;;55,0;;3,0;;266,0;37,0;;;9,0;;2,0;34,0;;9,0;;10,0;1,0;;8,0;10,0;;7,0;11,0;;;;6,0;33,0;;;58,0;17,0;6,0;;;25,0;;3,0;8,0;5,0;;;40,0;44,0;9,0;;36,0;16,0;;7,0;26,0;1,0;2,0;;;;79,0;;;1,0;4,0;7,0;;3,0;;;;3,0;2,0;2,0;;11,0;2,0;3,0;;31,0;;;3,0;16,0;5,0;5,0;;;11,0;6,0;;2,0;;3,0;;;;12,0;;27,0;5,0;10,0;;;;;;;;3,0;1,0;3,0;3,0;;1,0;;8,0;;10,0;4,0;20,0;;1,0;4,0;5,0;2,0;4,0;5,0;8,0;;17,0;1,0;;;6,0;8,0;4,0;;3,0;;34,0;;50,0;;;2,0;14,0;12,0;;;;;;;18,0;5,0;32,0;;7,0;2,0;;;1,0;2,0;;;5,0;3,0;5,0;3,0;4,0;;;81,0;9,0;;4,0;;;3,0;;;;;;1,0;2,0;23,0;5,0;;6,0;74,0;1,0;;;95,0;8,0;;1,0;;;;;1,0;;;;;;;33,0;1,0;2,0;;3,0;1,0;;;;;;;;;;;;9,0;10,0;;;3,0;7,0;;;;;;30,0;5,0;30,0;;4,0;1,0;;4,0;9,0;;;;;;;;;3,0;;2,0;;;3,0;2,0;12,0;;2,0;;;6,0;;;;1,0;;;5,0;;;13,0;11,0;;;;;28,0;25,0;;;;;;;2,0;;4,0;2,0;;4,0;;1,0;;12,0;;20,0;;;1,0;2,0;;;;;;;;;;;5,0;2,0;;;;1,0;;;;;;1,0;8,0;;;;2,0;;2,0;7,0;2,0;;;1,0;;;;14,0;;;8,0;;;;;;5,0;;;;3,0;;93,0;5,0;;;6,0;5,0;;;;;;;17,0;;19,0;;;3,0;4,0;;;18,0;;;;;;;;;;;;;;3,0;;;;17,0;1,0;;;;;;24,0;3,0;;;8,0;;;;;;;;;15,0;8,0;;;;;8,0;;;;;;;;;;3,0;1,0;;;13,0;1,0;9,0;;4,0;1,0;24,0;;;12,0;11,0;13,0;;;;;;;1,0;24,0;;;;;2,0;;;;27,0;8,0;;;;;;;;;;;;;;;;;1,0;;;;1,0;;;;;;;;;;;;;;;1,0;;3,0;7,0;;4,0;7,0;;;;21,0;;;;;;;;;;;;;;;;;;1,0;;;;7,0;;7,0;;;;;3,0;;;;;;;;;;;;;3,0;8,0;;;;;;;;;;;;;;;;;7,0;;1,0;;;;;;15,0;;;;;;2,0;;;;;;;;10,0;;;;;;2,0;;;3,0;;;;;;;6,0;;;;;2,0;;2,0;;;;;;;;;3,0;;;;;;;;2,0;5,0;;;;;;;;;;;2,0;;;5,0;;;;;;;;;;;;3,0;;;;;;4,0;;;;;2,0;;;;;;;;;;;;;;;2,0;;1,0;;;1,0;3,0;;;;;;;;;;;;2,0;;9,0;4,0;;4,0;;;4,0;2,0;;;3,0;;;;;3,0;;;2,0;3,0;;3,0;1,0;;;;;;8,0;4,0;;6,0;;;;;;;;;4,0;;;;;;;;;;;;;;;;;;;;;;;;;;;4,0;;;;;;;;;;;;1,0;;;;;;;16,0;5,0;;;;;;;;;;2,0;;;;1,0;;;;;16,0;;11,0;;;;;;;;;;;;;;;;;;;;;;;;;;;;;;;2,0;;;;;;;;;;;;;;;;;;1,0;;;;;;;;;4,0;;;;;;8,0;;;;;;;;;;;;;;;;8,0;;;;2,0;;;;;;2,0;;;7,0;;;;1,0;;1,0;;;;;;;1,0;;;;;;;3,0;;8,0;;;;;;;;3,0;12,0;;;;;;;6,0;;;;;
master;;;;;1,0;;;4,0;1,0;8,0;2,0;;;;;;;;;;;6,0;;;;;;29,0;;1,0;;9,0;19,0;;1,0;;2,0;1,0;;9,0;1,0;;;;;;;;;;;5,0;;;4,0;15,0;6,0;;;;;;7,0;;;;2,0;;;1,0;;;;;;;;2,0;6,0;;;10,0;8,0;;;;1,0;;;;;;;62,0;;9,0;;;;;1,0;13,0;;;;;;23,0;;;;;21,0;;;;;;12,0;;;;;12,0;;;5,0;;;4,0;1,0;;;10,0;;;1,0;;;;;;8,0;;;;;2,0;;;;;;;;;;;;1,0;;;;;;;;1,0;;;2,0;;2,0;1,0;16,0;;;17,0;;;;;;;;;;6,0;;2,0;;;;8,0;;;;;;;;;;3,0;;;;;1,0;;;;;;3,0;;7,0;;;1,0;;;;;;;;;;;;;5,0;;;1,0;;;2,0;;;;;;;;;2,0;;;6,0;;;5,0;;;;;;;4,0;2,0;1,0;;;;;;;;1,0;;;;;;;;;3,0;;;;;;;1,0;5,0;;;;;;;;;;1,0;;;;;;;;;;;;;7,0;;;;;;;;;;;18,0;;;;;;;21,0;;1,0;;;;;;2,0;;;;1,0;;;;;;;;;;2,0;;;;;;;;;;;;;;3,0;;;;;8,0;;;;;;1,0;;;;;10,0;;;;2,0;;;;;1,0;;;;;;1,0;;;;;3,0;;;;;;;2,0;;;;1,0;;2,0;1,0;;;;8,0;;;;;;27,0;;;;;;;;;;;;;;;;;;;1,0;;20,0;;;7,0;;;;13,0;;;;4,0;;;;;;;;;4,0;;;;;;;2,0;;;;;;;;;;;4,0;;;;;;2,0;;;;;11,0;17,0;;;;;;;;;;;;;;;;;;;2,0;1,0;;;;;;;;;;;;;;;;;;;;;1,0;;;;;;;;;;;;;;;;;;;;;;;;;;;;;;3,0;;;;;;;;;;;;;;;4,0;;;4,0;;;;;;;;;;;;;;;;;;;;;;;;1,0;;;;;;;;2,0;;;;;;;;5,0;;;;13,0;;;;;;;;;;;;;;;;;;;;;;;;;;;;;;;;4,0;;;;;;;;;;;;;;;1,0;;;;4,0;;;;;1,0;;;;;;;;;;;;;;;;;;;;;;;;;3,0;;;;3,0;;;;;;;;;;;;;;;;;;51,0;;;;;;;;;;;;;;;;;;;;;;;;1,0;1,0;8,0;;;;;;;;;;;;;;;;;;;;1,0;;;;;;;2,0;;;;;;;;;;2,0;;;;;;;;;;;;;;;;;;;19,0;;;;;;;;;;;;;;;;;;;;;;;;;;1,0;;;;;;;;1,0;;;;46,0;2,0;;;;;;;;;;;;;;1,0;;;;;1,0;;;;;;;;;;;;1,0;;;;;;;;;;;;;;;;;;;;;;;;;;;;;;;;;;;;;;;;;;;;;;;;;;;;;;;;;;;;;;;;;;;;;;;;;;;;;;;;;;;;;;;;;;;;;;;;;;;;;;;;;;;;;;;;;;;;
material;;;;;16,0;1,0;2,0;22,0;;5,0;9,0;6,0;;23,0;11,0;3,0;;;15,0;12,0;17,0;7,0;;1,0;2,0;;2,0;13,0;6,0;3,0;;7,0;86,0;4,0;20,0;;2,0;1,0;;40,0;1,0;;5,0;66,0;;;4,0;4,0;1,0;6,0;4,0;1,0;;31,0;1,0;50,0;108,0;;8,0;261,0;2,0;;73,0;1,0;2,0;1,0;9,0;1,0;;;97,0;4,0;2,0;7,0;5,0;;5,0;2,0;18,0;5,0;1,0;2,0;2,0;;7,0;2,0;27,0;;1,0;36,0;31,0;;;6,0;1,0;10,0;3,0;2,0;4,0;78,0;72,0;32,0;1,0;3,0;;;41,0;29,0;;23,0;3,0;23,0;2,0;11,0;8,0;1,0;1,0;3,0;7,0;20,0;12,0;;3,0;5,0;14,0;1,0;11,0;9,0;1,0;2,0;35,0;;29,0;;7,0;7,0;53,0;;73,0;22,0;1,0;;1,0;14,0;14,0;;190,0;21,0;4,0;50,0;5,0;6,0;1,0;81,0;3,0;19,0;12,0;37,0;;50,0;7,0;1,0;11,0;2,0;3,0;217,0;;94,0;;;63,0;6,0;86,0;26,0;5,0;11,0;14,0;7,0;11,0;3,0;7,0;10,0;11,0;1,0;1,0;1,0;28,0;36,0;;80,0;9,0;4,0;5,0;9,0;2,0;4,0;79,0;14,0;;9,0;14,0;19,0;10,0;38,0;;1,0;2,0;6,0;18,0;14,0;2,0;3,0;32,0;;;5,0;6,0;97,0;;9,0;6,0;27,0;7,0;8,0;7,0;7,0;19,0;;;;;;5,0;13,0;1,0;3,0;3,0;19,0;14,0;2,0;19,0;1,0;14,0;2,0;;9,0;2,0;20,0;2,0;5,0;;1,0;84,0;27,0;5,0;3,0;7,0;10,0;1,0;;;1,0;5,0;10,0;3,0;;14,0;;1,0;;15,0;2,0;10,0;1,0;6,0;8,0;;;1,0;2,0;3,0;1,0;;3,0;58,0;;1,0;;2,0;2,0;;;;27,0;1,0;1,0;4,0;5,0;1,0;;7,0;;14,0;;5,0;;;2,0;;4,0;5,0;2,0;;;1,0;;1,0;;;14,0;;7,0;3,0;;;11,0;7,0;2,0;14,0;;3,0;2,0;;;;;;;;;;11,0;;1,0;;;2,0;3,0;;;4,0;;;;;;;;2,0;;;;2,0;12,0;1,0;;;;;;;5,0;;9,0;3,0;2,0;3,0;;;;;1,0;;;1,0;7,0;;11,0;;8,0;1,0;;1,0;;8,0;;;;;3,0;1,0;;1,0;;;;;9,0;;;;3,0;2,0;;;;2,0;;3,0;1,0;;;;;1,0;1,0;1,0;;;;;;;;;;;5,0;;;;;;;;;3,0;6,0;;;;1,0;2,0;;1,0;;;;;;;;;;;2,0;;;2,0;;;2,0;;;;;34,0;;;;;;;;;;19,0;;;;;6,0;16,0;;1,0;7,0;1,0;8,0;1,0;;;;;;5,0;;;2,0;2,0;;8,0;;;1,0;;15,0;2,0;4,0;;;;1,0;;2,0;;;2,0;;;10,0;;;4,0;;;;3,0;;1,0;;;;;;7,0;;;7,0;;;2,0;4,0;26,0;;2,0;13,0;8,0;;4,0;2,0;5,0;8,0;;;;;1,0;;;;12,0;;;;3,0;;;;5,0;;1,0;;1,0;;2,0;8,0;;;;;1,0;13,0;;;;1,0;1,0;;30,0;1,0;1,0;;;2,0;;;;;;7,0;;12,0;;;;1,0;1,0;;;;;3,0;;2,0;;;;3,0;;;;19,0;2,0;1,0;;1,0;;;;2,0;;;4,0;2,0;;;;2,0;1,0;;1,0;29,0;;1,0;;6,0;2,0;;;;2,0;;;;15,0;10,0;;4,0;1,0;;;;;15,0;;5,0;2,0;7,0;;;3,0;;7,0;;2,0;;37,0;;;;;9,0;;;;;;;1,0;;;;;1,0;;1,0;;4,0;;5,0;;1,0;;2,0;;;;1,0;;1,0;26,0;;;;;1,0;;;1,0;;;;2,0;;;;;;;;;;;2,0;;;1,0;3,0;23,0;;;3,0;4,0;1,0;;;;;2,0;8,0;;3,0;1,0;3,0;;36,0;;;;;;;;;;12,0;;;;;;;;;;;2,0;;;;;;;1,0;;;;;;;;;;4,0;;;2,0;;1,0;;2,0;;;;2,0;;;;;;;;;;;;;;7,0;;3,0;;3,0;;8,0;;;;;;;;8,0;;;;;;;;;;1,0;;;;;;1,0;2,0;2,0;;;2,0;5,0;;;1,0;;7,0;11,0;;;;4,0;1,0;1,0;;;;;;;;;23,0;;3,0;1,0;;;;;;6,0;1,0;7,0;;;;;;2,0;;1,0;;;;;;7,0;;5,0;;;;;;;4,0;;;;;;1,0;;5,0;;;5,0;;;;;;;;;2,0;;3,0;;;;;;3,0;;;47,0;;82,0;21,0;;;;8,0;;;;;;;;1,0;6,0;;;;;;;;2,0;;;;;;;;;;1,0;;;;;;;2,0;;;;2,0;;;;
matrix;;;;;7,0;;7,0;27,0;38,0;6,0;2,0;26,0;;11,0;28,0;;;4,0;20,0;2,0;;7,0;19,0;4,0;4,0;8,0;;39,0;2,0;3,0;9,0;40,0;13,0;4,0;2,0;9,0;;8,0;6,0;4,0;8,0;;4,0;52,0;;;4,0;;;;20,0;19,0;;;;68,0;33,0;8,0;;2,0;;;88,0;;;;;;;;1,0;1,0;;;;;;21,0;41,0;;;10,0;4,0;4,0;;;7,0;2,0;3,0;12,0;6,0;;;13,0;;14,0;;;7,0;9,0;5,0;37,0;;2,0;1,0;;2,0;42,0;2,0;;;76,0;7,0;;;6,0;;;;6,0;;;;12,0;;;11,0;;;5,0;1,0;;;;2,0;60,0;7,0;;;1,0;;;;;6,0;;23,0;21,0;2,0;;;;;;1,0;;;;;10,0;;;3,0;4,0;1,0;;1,0;1,0;;;;;;;;;;8,0;;;1,0;;;;;17,0;;55,0;;4,0;;;2,0;4,0;4,0;;;;43,0;;3,0;15,0;;1,0;;16,0;1,0;;1,0;1,0;;;;1,0;7,0;10,0;3,0;7,0;;;1,0;1,0;;;;;;;;;;;;3,0;9,0;5,0;;8,0;5,0;;;;4,0;;;1,0;;;;;32,0;;;2,0;;13,0;;10,0;;;2,0;1,0;1,0;;;;1,0;;;1,0;;;;;;;;;;1,0;;;;5,0;;2,0;;4,0;;;;4,0;;;;;19,0;;;;;;19,0;26,0;29,0;;;1,0;;;2,0;5,0;;;;;;;;;;;;;;3,0;;;1,0;47,0;3,0;;;;;;;;;6,0;;30,0;;2,0;;1,0;2,0;2,0;;1,0;;;15,0;;;;5,0;;;;6,0;;;;;3,0;1,0;;1,0;2,0;;;;22,0;1,0;3,0;6,0;;;;;3,0;;;;;;;1,0;;;;;;;;2,0;3,0;2,0;;1,0;;8,0;;12,0;4,0;10,0;1,0;;;;;;;;;;;2,0;;4,0;5,0;;;;;;9,0;;2,0;;2,0;;;;;2,0;;;;;;;;3,0;;43,0;9,0;;;;;;;;;;;1,0;;;;;2,0;;;;1,0;27,0;;;13,0;;;;;;;;;12,0;;;;;;1,0;;;4,0;;;;;1,0;14,0;1,0;;;;;4,0;1,0;;1,0;;;;;;;;;14,0;1,0;;;;;;;;;;;;;;1,0;;;;;1,0;;;;1,0;;;;;;;;;;1,0;;;;;;;;;;;;;139,0;;;;;1,0;2,0;;;;;;;;;;;3,0;;;;5,0;;;;;;;;;;;;;4,0;2,0;;;;2,0;;;;;;;;;;;;;;;;;;;;;;;;1,0;;;;;;;;;;;;;;;;;;;;;;;;;2,0;;18,0;;;;;;;;4,0;;4,0;;;;;;;;;;;;;;;;;9,0;;;;;4,0;;31,0;;;;;;;;;;4,0;2,0;;;;;;;2,0;;;;1,0;;;2,0;2,0;;1,0;6,0;;;1,0;;;;;5,0;;;;;1,0;6,0;;;;;2,0;;;;;6,0;;;;;;31,0;2,0;;3,0;5,0;;;;;6,0;;;36,0;16,0;5,0;;9,0;;;13,0;1,0;;;;6,0;1,0;;;;;;;;1,0;;;1,0;;;;;;9,0;;1,0;;;;;;;;;;;;;;;;;;;;2,0;4,0;;;4,0;;1,0;;;;;1,0;;;;;;;;;;1,0;;;2,0;8,0;;;;;;;;;;2,0;;;;;;;;;;;;;;;;;2,0;;;;;1,0;;;1,0;;;;;;;;2,0;8,0;;;;;;;;;;;;;;;;;2,0;;;;;;;;2,0;;;;;;;;21,0;;;;;2,0;;;;;;9,0;;1,0;;;;;;;;;;;4,0;;;;;;;;;;;;;;;;6,0;;1,0;;;;;;;;;2,0;;;;;;;;1,0;;;;;;;;;;;;;;;1,0;;;;;;;2,0;;;;;;;;;
metal;;;;;9,0;;1,0;9,0;;;;;;;;2,0;;;1,0;;;;;;2,0;;3,0;;;;2,0;;36,0;;1,0;;;9,0;;;;;4,0;8,0;;;;;1,0;;3,0;;;18,0;;6,0;27,0;;1,0;13,0;;;23,0;;;;;;;;3,0;;;2,0;5,0;;;4,0;7,0;2,0;;;1,0;1,0;;;1,0;;;19,0;9,0;;;3,0;;3,0;;;;10,0;15,0;10,0;1,0;1,0;;;;3,0;;;;2,0;3,0;3,0;8,0;;1,0;;15,0;6,0;3,0;;;14,0;33,0;;2,0;6,0;;6,0;19,0;;1,0;;2,0;2,0;6,0;;5,0;;;;;;;1,0;70,0;16,0;;2,0;;;6,0;8,0;;;3,0;30,0;;15,0;;;1,0;4,0;;52,0;1,0;2,0;;26,0;31,0;;38,0;15,0;;3,0;2,0;;;;3,0;8,0;;;;2,0;47,0;4,0;;31,0;;1,0;;3,0;;4,0;1,0;3,0;;2,0;30,0;17,0;11,0;6,0;;;1,0;;22,0;4,0;4,0;2,0;9,0;2,0;;;1,0;1,0;;;7,0;;;1,0;3,0;;;;;;;;4,0;;;;;5,0;4,0;;3,0;;3,0;2,0;2,0;1,0;1,0;4,0;;4,0;;;5,0;20,0;1,0;;1,0;5,0;;;;;;3,0;1,0;1,0;2,0;;;;;8,0;;;;;;;;1,0;;1,0;;1,0;9,0;;;;;2,0;;;;6,0;;;;1,0;;2,0;;;1,0;1,0;;3,0;;;1,0;1,0;;;;;4,0;;;;1,0;;;;;;;12,0;1,0;16,0;2,0;;;;;;;;;;;;;;;;;;;;;;;;;;;;;;1,0;;;;;;;;;;;;;;;1,0;1,0;19,0;;;;;;;;;;;;;;1,0;;1,0;;;;;;;;;;;;;;;;;;;;;1,0;;;;;;;;;;;;;;3,0;1,0;;;;;;;;;;;;;;;;;;;;1,0;;;;;4,0;1,0;;;;;;;;;;;;2,0;1,0;;;;;;;;;;;;;;;;;;;;;;;;;;5,0;;;1,0;;1,0;;;1,0;;;;;;;;;4,0;2,0;;;;5,0;3,0;4,0;;;;;;;;;5,0;1,0;;;;;;9,0;1,0;;;;;;;;;;;;;;;;;;;;;;;;;;;;;;;;;;;;;;;;;;;;;4,0;;;;;;;1,0;2,0;;;;2,0;;;12,0;3,0;1,0;;;14,0;;;;;;;;;;;;;7,0;;;;;;;;;;1,0;;;;;;1,0;;;;72,0;;;;2,0;;;2,0;10,0;;;;;;;1,0;;;;;26,0;;1,0;;;7,0;;;;;;;;4,0;5,0;;5,0;4,0;;;;;;;;;;;;;;;;;;;;;1,0;;;;;;;;;;;;;;;;;;;;1,0;;;;;;;1,0;;;2,0;;;1,0;;;;;;;;;;;;;;;;;;;;;;;;;2,0;;;;;1,0;;;;;;9,0;;;;;;;;;;;;;;;;;;;;;;;;;;;;;;;;;;;;;;;3,0;;;;;;1,0;;;;;;;;;;;;;;;;;;;;1,0;;;;;;;2,0;;;;6,0;;;;;;;;1,0;;;;;;;;;;;;;;;;;;;;;3,0;;;;;;;1,0;;;;3,0;;3,0;;;;;;;;;4,0;;;;;;2,0;;;1,0;1,0;;;;;;;;;;;;;;;;;;;;;;;;;;;;;;;;;;;;;;;;;;;;;;;;;;;;;;1,0;4,0;;13,0;6,0;4,0;;;;;;;;;;;;;;;;;;;;;1,0;;;2,0;;;;;;;;;;;;;;;;;;;;;
modular;;;;;2,0;;;;;3,0;;;;;2,0;;;;5,0;;;2,0;;;;;;6,0;;;;;9,0;;23,0;;3,0;;;4,0;;;;;;;;;;1,0;2,0;1,0;;;;19,0;19,0;;;3,0;;;2,0;;;3,0;;;;2,0;2,0;;;;;;;;2,0;23,0;;21,0;4,0;;;;;;;;6,0;;;1,0;;2,0;;;6,0;;;85,0;;2,0;;;1,0;12,0;;;;;1,0;74,0;;;;;1,0;5,0;;;;;;;2,0;1,0;;1,0;1,0;;;;;;3,0;;;;;;;;2,0;;2,0;7,0;;;;;;1,0;;;;;;31,0;;;;;;;;12,0;;;;;77,0;1,0;;;;3,0;;;;;2,0;;;4,0;;14,0;;3,0;;;;4,0;;;;;;2,0;;1,0;;;;;;;;;;;;;;;;;;;;;;;5,0;;;;;;;2,0;;1,0;;;;1,0;4,0;;;;;;1,0;;11,0;;;;;;;8,0;;;5,0;1,0;2,0;1,0;;;;;;3,0;;;;;;;;1,0;1,0;10,0;;;;3,0;;;;;;21,0;;;3,0;1,0;;;;;;2,0;;;;;5,0;;;;;;1,0;;;;;;;;;;;;;;;;2,0;;;3,0;;;15,0;;5,0;;;;;;;;;;;;;;;;;;;;3,0;;;;;;;;;;;;;;;;;;;;;;;1,0;;3,0;;;;;;;;;;;2,0;;;3,0;;;;;;;;;;;;;;;;;;;;;1,0;;;;;;;;2,0;;2,0;;;;;;;;1,0;2,0;;;;;;;;;1,0;1,0;;;;;1,0;;1,0;;;;;;2,0;1,0;;;;;;;;;;;;2,0;;;;;;2,0;;;;;5,0;;2,0;;;;;;;;;;;;;;;;1,0;;;1,0;;;;;;;;;;;;;;;;;6,0;1,0;8,0;;;;;;;;;;1,0;;;;;;;;;;;1,0;20,0;;;;;;;;;;;1,0;;5,0;;;;;;;;;3,0;;18,0;;;;;;;;;;;;;;5,0;1,0;;;;1,0;;;1,0;1,0;;;;;;;;;;;2,0;;;;;;;;;;1,0;;;;;;;;;1,0;1,0;;4,0;;;;;;;;;;2,0;;;;;;;;;;;18,0;;;;;;;;;;;;1,0;;;;1,0;;;;;;;;;;;;;;;;;;;;;;;;;;;;;;;;;;;;;;;;;;1,0;4,0;;;;;;;;;;;;;;;1,0;;;;;;;;;;;;;;;;;;;;;;;;;;4,0;;;1,0;;;;;;;;;;;;;;;;;;;;;;;;;;;;;;;;;;;;1,0;;;;;;;;2,0;;;2,0;;;;;;;;;;;;;;;;;;;;;;;;;;;;;;;;;;;;;;;;;;;;;;;;;;;;;2,0;;;;;;;;;2,0;;;;;;;;;;;;;;2,0;;;;;;;;;;;;;;;;;;;;;;2,0;;;;;;;;;1,0;;;;;;;;;;;;;;;;;;;;;;;;;;;;5,0;;;;;;;;;;;;;;;;;;;;;;1,0;;;;;;;1,0;;;;;;;;;;;;;;;;;;;;;;;;;;;;2,0;;;;;;;;;;;;;;;;;;
modulate;;;;;5,0;;;10,0;11,0;4,0;;3,0;;;;;;;4,0;;;28,0;;1,0;;;;22,0;;3,0;1,0;5,0;12,0;5,0;1,0;;1,0;1,0;;;1,0;;;1,0;;;;;;7,0;4,0;15,0;;3,0;;29,0;8,0;;;2,0;;;16,0;2,0;;1,0;;;;;2,0;;;;;;;;5,0;8,0;;6,0;1,0;2,0;;;2,0;;;2,0;3,0;2,0;;66,0;;1,0;;;4,0;;1,0;4,0;;1,0;;;;19,0;3,0;;;1,0;4,0;;;;3,0;;;;;;;5,0;;;;;;;;;;;;;;;;7,0;7,0;;1,0;;1,0;;6,0;;;;;;;;;;;;1,0;;;;;;;;7,0;52,0;;;;;5,0;;3,0;;;21,0;;;;;1,0;;;;;5,0;;3,0;;;4,0;12,0;;6,0;;;;;;4,0;;;;;;;2,0;;;;;;;2,0;20,0;;;;;;;2,0;;1,0;;;;;;;;;2,0;;;;;;;;;;;;;;;;;;;1,0;;;;;;;;;;;;;;;;;;;;;;;;;;;;;;;;;;;;;;;;4,0;;;;;;;;;1,0;1,0;1,0;;;;;;3,0;;;;;;;;;;;1,0;;;;9,0;;;;;;;;;;1,0;;;2,0;;;;;;;1,0;;;;;;1,0;;1,0;;;4,0;;;;;;;;;;2,0;;7,0;;;;;3,0;;;;2,0;;;;;;;7,0;;1,0;;;2,0;;2,0;;;1,0;;;;;;4,0;;;2,0;;;;;;;;;2,0;;;;;;;;;;;3,0;;;;;;1,0;;2,0;;;;;;;2,0;;;;;;;1,0;;6,0;;1,0;;1,0;2,0;;;;4,0;;;;;;;3,0;2,0;;;;1,0;;;2,0;;;;;;2,0;;;;;;;;;;;;;;;1,0;;2,0;5,0;;2,0;;;;;;2,0;;;;;;;;;;;5,0;;;;;;;;;;;;;;;;;;;;;21,0;;;;;;;;;;;;;;;;;;;;;;;4,0;;10,0;5,0;;;;;;;;;;;;;;;;2,0;;;;2,0;;;;;;;;;;;;;;8,0;;;;;;20,0;;;;;;;;;;;;;;;;;;;3,0;;;2,0;;;;;5,0;;;1,0;;;;;7,0;1,0;;;;3,0;;;;;;;;;;;;;;;;;;;;;;;1,0;;;;;;;;;;;;;;;;2,0;1,0;;2,0;;4,0;;;;;;;;;;;;;1,0;4,0;;;;;;;;;;2,0;;;;;;1,0;4,0;;;;;;;;;;;;;1,0;;;1,0;;;1,0;;;;;13,0;;;3,0;;;;;;;;;;;;1,0;;;6,0;;;;;;;;;;;;;;;;;;;;;;;;;;;;;;;;;;;;;;;;;;;;;;;;;;;;;;;;;;;;;;;3,0;;;;;;;;;;;;;;;;;;;;;;;;;;;;;;;;3,0;;;;;1,0;;;;;;;;1,0;;;;;;;;;;;;;;;;;;;;;;;;;;;;4,0;;6,0;;;;8,0;;;;;;;;;;;;;;;;;;;;2,0;;;;;;;;;;;;;;;;;;;;;;;;;;;;;;;;;;;;;;;;;;;;;;;;;;;;;;;;;;;;;;;;;;;;;;;;1,0;;;;;;;
mold;;;;;5,0;;;11,0;;1,0;2,0;;;;;;;;9,0;;;;;;;;;;;;;;4,0;;3,0;;;8,0;;1,0;;;8,0;21,0;;;;;;;;;1,0;2,0;;13,0;31,0;;1,0;65,0;;;25,0;;;;7,0;;;;2,0;;;9,0;2,0;;;;17,0;;;1,0;;;;;26,0;;;;19,0;;;1,0;;9,0;;;;36,0;35,0;3,0;1,0;1,0;;;;12,0;;;;4,0;;1,0;10,0;;;;5,0;15,0;1,0;;;8,0;1,0;;6,0;2,0;;22,0;21,0;;;4,0;3,0;;9,0;;;1,0;;;1,0;;14,0;3,0;56,0;14,0;;6,0;;3,0;2,0;9,0;1,0;12,0;;13,0;;3,0;;;4,0;2,0;;12,0;;;;58,0;7,0;;30,0;27,0;;1,0;2,0;;13,0;;3,0;1,0;4,0;;;;;5,0;;30,0;3,0;;;4,0;6,0;;;;;6,0;2,0;3,0;1,0;7,0;;;2,0;;2,0;8,0;;;;;;;;2,0;;;13,0;2,0;;;2,0;;51,0;;;4,0;;;;2,0;;;;;1,0;;15,0;;1,0;10,0;;;3,0;3,0;9,0;;;5,0;;4,0;;;36,0;6,0;;;;;1,0;;3,0;;7,0;4,0;;;;4,0;;3,0;9,0;;;;1,0;1,0;8,0;;2,0;1,0;;;;2,0;;2,0;2,0;;;;;;;;1,0;;;;;;;2,0;;;1,0;4,0;;;;;;;;;;3,0;;34,0;;;;;2,0;1,0;1,0;;;;;;;;;;1,0;;;;;;;;;;;;11,0;;;;;;;;11,0;;;;1,0;9,0;;;;;3,0;;;;;;;;;;;;;;;;;;;;;1,0;;;2,0;;;;;2,0;;;;;1,0;;;;;;;;;2,0;;;;;6,0;;;2,0;2,0;;;;;;;;;;;;;;;;;;;;;;;;;;;;;;;;1,0;;;;;;;;;;;;;1,0;;;;;;2,0;;;5,0;;;;;;;;;;;1,0;1,0;;;;;;;;;1,0;;;;;;;;;2,0;2,0;;1,0;;4,0;41,0;;;;1,0;;;;;;;;15,0;;;;2,0;;;;;;4,0;;;;2,0;;;;;;;3,0;7,0;;;1,0;;;;;9,0;;;;;;5,0;;;;;;;;1,0;;;;;;;;;;1,0;;10,0;;;;;;;;3,0;;;;;10,0;;;;;;;3,0;;;;;;;;;;;;;25,0;;;;;;;;;;;;3,0;;;;;;;;4,0;;;;;;;4,0;;;;3,0;;;;;;;1,0;2,0;3,0;;;;;;2,0;;;;;;;;3,0;;;1,0;;;;;;;;6,0;;;;;;;;;;;;;;;1,0;;;;;18,0;;;;1,0;;;;1,0;;;;;5,0;;;;;;;;;;;;;;;;;;;;;;;;;;;;;;;;;;;;;;;;;;;;;;;;;;;;;;;;;;;;;;1,0;;;;;;;;;;;;;;;;;;;;;;;;;;6,0;;;;;;;;;;;;;;;;;;;;;;;;;;;;;;;;;2,0;4,0;;;1,0;;;;;;;;;;;;;;;;1,0;;;;;;;;;;;;87,0;5,0;;;;3,0;;1,0;3,0;;;;11,0;1,0;;;;;;;;;;1,0;2,0;;;;;;;;;4,0;;;;;;2,0;;;;;;;;;;;;;;;;;;;;4,0;;;;1,0;;;;;;;;;;;;;;;;;;;;;;;1,0;;4,0;;27,0;;;;;;;;;;;;;;20,0;;;;;;;;;3,0;;;;;;;;;;;;;;;;;;;;;;;;
moveable;;;;;7,0;;15,0;;;8,0;;;;;;;;;2,0;1,0;;11,0;;;;;;1,0;3,0;;;5,0;12,0;;2,0;;1,0;15,0;;2,0;;;4,0;19,0;;;2,0;3,0;4,0;;8,0;3,0;;9,0;;17,0;9,0;;2,0;37,0;;;4,0;;;4,0;11,0;;;;32,0;;;;2,0;;;2,0;20,0;;2,0;2,0;;1,0;;;1,0;;;;1,0;;;2,0;;4,0;;;1,0;;10,0;5,0;;;;;;10,0;;;1,0;;;8,0;2,0;12,0;;;;6,0;;2,0;2,0;;;;11,0;;;21,0;1,0;;;1,0;;;1,0;;;;;;1,0;1,0;;;1,0;2,0;;;;;;;;;;6,0;2,0;1,0;;;3,0;;;;;;;;26,0;27,0;6,0;9,0;8,0;1,0;5,0;1,0;;;1,0;;;;;;2,0;3,0;;17,0;;;;;;10,0;;;;3,0;;;;2,0;;;8,0;10,0;4,0;3,0;1,0;;;;1,0;3,0;;;;2,0;;5,0;;;;4,0;2,0;;1,0;;;;3,0;3,0;3,0;1,0;;2,0;3,0;;;;;3,0;;;;;;1,0;;;;12,0;;;;1,0;;;;1,0;;5,0;;2,0;;;;;;2,0;;3,0;;;;;;2,0;1,0;6,0;;2,0;;;3,0;4,0;;7,0;1,0;;;;;1,0;;1,0;;;1,0;;;;;;;1,0;1,0;;1,0;;1,0;1,0;9,0;;;;;;1,0;;1,0;2,0;;;;;;;3,0;1,0;;;;;;;;;;;;;;;;;;;1,0;1,0;;;;;;;;;;;;;;;;;;;;;;;;;;;;2,0;;;;;;;;;;;;4,0;1,0;1,0;;;;2,0;;;3,0;;;;;;3,0;6,0;;6,0;1,0;1,0;3,0;;;;;;;3,0;7,0;;;;2,0;;;;;;;;;;;;;;;;3,0;;;1,0;;;;2,0;;;;;;;1,0;;;;;;;;;;2,0;;7,0;;;;;;17,0;;;;;;;;;;;;;;;4,0;;;;16,0;;;16,0;6,0;2,0;;;;;;;;1,0;;;;;;;;;;;;;;;;;9,0;;;;;;;;2,0;;;;;;;1,0;;;;;;;;;;1,0;;;;;;;;;;;;;;2,0;;;;5,0;;14,0;;;;;;;;;;1,0;;;3,0;;;1,0;;;;;;;;;;;;;;;;;;;;;;2,0;;;;;;;;;;;;;;;;;;;;;;;;1,0;;;;1,0;1,0;2,0;;;;;;;;;;;;;;;;;;;;;;;;;;;;;;;;;;;;;;;;1,0;;;22,0;;;;;;;;;;;;;;;;;;;;1,0;;;;;;;;;;;;;;;;1,0;;;;;;;;;;;;;;;;;;;;;;;;;;;;;;;1,0;;;;;;;5,0;;;;;;;;;;;;;;;;;;;;;;2,0;;;;;;;;;;;;;;;;;;;;;;;;;;;;;;;;;;;1,0;;;;3,0;;4,0;;;;;11,0;8,0;;;;;;;;;;3,0;;;;;;;;;;;;1,0;;;;;;;;;1,0;;;;;;;2,0;;;;;;;;;;;;;;;;1,0;;;;;;;;;;2,0;;;;;;;;;;;;;;;;;;;;;;;;;;1,0;;;;;;;;;;;;;;;;;;;;;;;;;;;1,0;;3,0;;;;;;;;;;;;;;;;;;;;;;;;;1,0;;;;;;;;;;;;;;;;;;;;;;1,0;;;;;;;;;;;;;
navigation;;;;;6,0;;1,0;12,0;1,0;1,0;;;;;;;;;;1,0;;8,0;2,0;4,0;6,0;2,0;;18,0;2,0;1,0;3,0;3,0;76,0;1,0;3,0;;;37,0;4,0;27,0;1,0;;1,0;;4,0;;;;;2,0;;20,0;;;;26,0;10,0;;1,0;4,0;;;42,0;;1,0;2,0;1,0;;1,0;3,0;;;13,0;;;;;3,0;54,0;;;1,0;16,0;;;;3,0;;;6,0;12,0;1,0;;45,0;;5,0;;1,0;2,0;;3,0;96,0;;;;;;12,0;;;1,0;8,0;;;;;;;;;;;;;;;23,0;;1,0;1,0;;1,0;;;1,0;;;;;;;3,0;;1,0;;;1,0;;2,0;;;;;;;;;;;;;;;;;;;;;;;;16,0;;5,0;;;2,0;;;;1,0;1,0;;;;;31,0;;3,0;;;;30,0;;;;;;;;2,0;;;;;;;;;;;;;;3,0;;;7,0;;;33,0;;;;;;;;;;;;;2,0;1,0;;;;;;;;;;;;;;;;;;6,0;;;;1,0;;;;1,0;;;;;;;;;;;1,0;;2,0;4,0;;;;;;;;;;6,0;;9,0;1,0;;;;;3,0;;;;;;;2,0;;;;;;;1,0;;;1,0;1,0;;;;;;;;;;;;;;;;;;;10,0;;;;;;;3,0;1,0;2,0;;1,0;;;;;;;;7,0;;1,0;8,0;;;;4,0;;;;2,0;;;;;;;;2,0;;;;;4,0;1,0;4,0;1,0;;;;1,0;;2,0;3,0;;;1,0;;;;;;;;;;2,0;2,0;1,0;;2,0;1,0;;;7,0;7,0;6,0;;;2,0;;;;1,0;;;2,0;22,0;2,0;;4,0;;;3,0;;;;;;;10,0;1,0;;;;;;;;;;;;;;6,0;;;;;;1,0;;;;;;;;;;;;;;1,0;;1,0;1,0;;;2,0;;2,0;;;;;3,0;1,0;;2,0;;;2,0;1,0;8,0;2,0;;;;;;1,0;10,0;6,0;;;1,0;;;;;;;;;;;;;;;3,0;;3,0;;;;;;;;;;;1,0;2,0;1,0;;;;;4,0;;;;3,0;3,0;;;;;;;;;;;;;;;;;;;;;;1,0;;;;;;5,0;;1,0;;;1,0;;;;;;2,0;;;;;;;;2,0;;;;;1,0;;;;;;;;;;;;;;;;;1,0;;;;;;;3,0;;;;;;;;;1,0;;;;;;;;2,0;;;;;;;;;;;;;;;;;;;6,0;;;;;;;;1,0;;;;;;1,0;;;;;;;;1,0;;;;;;;;;;;;4,0;;;;;;;;1,0;;;;;;;1,0;;;;;1,0;;;;;2,0;;1,0;;2,0;;;;;;;;;;;;;;;;;;;;;;;;;;;;;;;;;2,0;;;;;;;;;;;;;;;;;;1,0;;;;;1,0;2,0;;1,0;;;;;;;;;;;;;;4,0;;;;1,0;;;;;;;;;;1,0;;;;2,0;;;;34,0;;;;;;;;;;;;;;;;;;;;;;;;6,0;;;;;;8,0;;;1,0;;;;;;;;;;;1,0;1,0;;;;1,0;1,0;2,0;;;;;;;3,0;;;;;;;;;;;;;;;;;;;;;;;;;;;;;;;;;;;;;;;3,0;;;;3,0;;;;;;1,0;;;;;;;;;;1,0;3,0;;;;;;;;;;1,0;;;;;;;1,0;;;;;;;;;;;;;;;;;;;;;;;;;1,0;;;;;;;;5,0;;;;;;;;;;;;;;;;;;;;;;;
notification;;;;;5,0;;;17,0;;5,0;;;;;2,0;;;;;;;3,0;;;;;;13,0;;11,0;10,0;3,0;10,0;1,0;3,0;;;;;14,0;;;;;4,0;;;;;;;40,0;;2,0;;25,0;17,0;;;2,0;;4,0;13,0;;;;;;1,0;12,0;;2,0;1,0;;;;;3,0;;;;1,0;1,0;;;;;;;4,0;15,0;;6,0;42,0;;;;6,0;2,0;;;10,0;;;;;10,0;54,0;;;;1,0;4,0;;;;;;;;;;;;;;11,0;;1,0;3,0;;;1,0;;;2,0;;;;;;;;;;;1,0;7,0;;;;;;;;;;;;4,0;;;;;;;4,0;;;;;;9,0;;3,0;;;24,0;;;;;3,0;;;;;7,0;;11,0;;;;11,0;;;;;;;;;;;;1,0;;;;;;;;;;;2,0;;;;;2,0;1,0;;;;2,0;;;;;;;;;;;;3,0;;;;;;;1,0;;;;;;;;;;;;1,0;;;;;;;;;;;;;;;;;;;;;;;;;;;;3,0;;3,0;1,0;;;;;;;;;;;;1,0;;20,0;;;;;1,0;;;5,0;;;;;;;;;;;;;;;;;;;;17,0;;;;;;;1,0;;;;;;1,0;;;;3,0;;25,0;;2,0;;;;;;;;;;;;;15,0;10,0;;;;;1,0;;;;4,0;;;;;;;2,0;1,0;4,0;;;;;;4,0;;3,0;;;;;8,0;8,0;5,0;;1,0;;1,0;1,0;;;;;4,0;;;;;;;26,0;;;;;;;20,0;;9,0;;4,0;;;5,0;;;;;;;;;;;;;;;;2,0;;;1,0;2,0;1,0;11,0;;;;7,0;1,0;;6,0;;;3,0;;;;2,0;;;;;;14,0;;;;;8,0;;;;1,0;4,0;;;;2,0;;1,0;;1,0;;;;1,0;;;;4,0;;2,0;;;;;;;;;;;;;;4,0;3,0;;;;;;;;;;;;;;;;;;;;;;;;;;;2,0;9,0;;;;2,0;;;;1,0;;;;1,0;;;;;;;;;;;;;;;;;14,0;;1,0;;;;;;;;;;;;;;;;;;;;;;;;;2,0;;;;;;;;;;;;;;;;;;;;;;;;;4,0;6,0;;;;;;;;;;;;;;;;;;;;;;;;;;;;;;;;;;;;;;;;;;;;;;;;;;;;;;;;;;;;;;;;;;;;;;;;;;;;;;;13,0;;;;;;8,0;;;1,0;;;;;;;;1,0;2,0;;;;;;;;;;;;;;;;;;;;;;;;;;;;;;;;;;;;;;;;;;;;;;;;;4,0;;;;;;;;;;;;;;;;6,0;1,0;;;;;6,0;;;;1,0;;;;;;1,0;;;;;;;1,0;;;;1,0;;;;;;;;;;;;;;;;;;;;;;;2,0;;;;;;;;;;;;;;1,0;;;;;;;;;;;;;;;;;;;;;;;;;;;;;;;;;;;;;;;;;;;;;;;;2,0;;;;;;;;;;;;6,0;;;;;;;;;;;1,0;;;;1,0;;;;;;;;;;;;;;;;;;;;;;;;1,0;;;;;;;;;;;;;;;;;;;;;;;;;;;;;;1,0;;;1,0;;;;;;;;;;;;;;;;;
observation;;;;;11,0;;;10,0;1,0;;1,0;;;;;;;;1,0;;;1,0;;;;;;13,0;1,0;37,0;3,0;7,0;39,0;5,0;;;2,0;4,0;;51,0;1,0;;;19,0;;;;1,0;;;1,0;12,0;;;;124,0;10,0;;;14,0;;;21,0;;;;5,0;9,0;;2,0;89,0;;21,0;;;1,0;;17,0;9,0;;;;2,0;;;1,0;;;;12,0;;;2,0;13,0;2,0;;;1,0;;;1,0;59,0;;;1,0;;;10,0;;;2,0;1,0;;;;;;;;3,0;;;;;;;;;2,0;;;;;;;16,0;;;;5,0;;;;;9,0;;3,0;2,0;1,0;;;;;;;3,0;;2,0;11,0;8,0;;1,0;;3,0;;1,0;;36,0;;;;5,0;3,0;1,0;1,0;;;5,0;;;;;;19,0;;1,0;1,0;3,0;;;;;5,0;10,0;;6,0;;;;1,0;;1,0;1,0;2,0;4,0;3,0;;;;;;;;;;23,0;;;;;;1,0;;4,0;;1,0;;;;;;;;;1,0;3,0;;2,0;30,0;;;;;;1,0;2,0;;;;;;;;2,0;;;;2,0;;;;;;;;;;;;1,0;;;;;;;;;;;;;;3,0;;4,0;4,0;11,0;1,0;2,0;10,0;;;;;;;21,0;;;;;2,0;;7,0;;;;;;;;;;;;;;;;;4,0;;;;8,0;;;;;;4,0;;;;;;;;;;16,0;;;;;;;;2,0;;;;;;;;;;;9,0;;;;;;;;;1,0;;;;1,0;;;;1,0;;;;2,0;;;;;;;;8,0;;2,0;;;;;;13,0;;;28,0;;;;;;;;;;;1,0;;;;;;;2,0;;1,0;;;;2,0;;;;;2,0;;;;;;;;;;;;8,0;;;;1,0;;1,0;;;;;49,0;;;;;;;;;;;2,0;;5,0;;;;;;;;;;;;;;;;;;;;2,0;2,0;;2,0;;;10,0;;;9,0;;10,0;;;;;;;;2,0;;;;;;4,0;;;;1,0;;;;;;;;;;;;7,0;3,0;;;;;;;;;;;;;;2,0;;;;;;;;;6,0;;;;;;;;;4,0;21,0;;;;;;1,0;;;;;;;;;1,0;;;;;;;7,0;;;;;;;;;;;;;;;;;;;;;5,0;;;;;;;;;;;;;1,0;;;;;;;1,0;1,0;;;;1,0;;;1,0;4,0;;9,0;;5,0;;;;;;;;;;;;;;;;;;;;;;;;;;;;;1,0;;;;;;;;;;;;;;;;;;;;;;;;;;;;;7,0;;;2,0;;;;;;10,0;;;;1,0;;2,0;;;;;;;;;;;;;;;;;2,0;;;;;;14,0;;;;;;;;;;;;;;;2,0;;;1,0;;1,0;;;;;;;1,0;;9,0;;;2,0;;;;;;;;6,0;71,0;;;;;;;;;;;;;;;;;;;;;;;;;;;;;;;;;;;5,0;;;;;6,0;;;;;1,0;;;;;;;6,0;;;10,0;;;;;;;;;;;;;1,0;2,0;;;;;;;;;;;;;;;;;;;;;;2,0;;;;;;;;;;;;;;;;3,0;;;;;;;;;;;;;;;;;;;1,0;;;;;;;;;;;2,0;;;;13,0;;;;;;;;26,0;12,0;;;;;;;;;;;;;;;;;;;;;;;;;;;;;;;;;;;;;;;;;1,0;;;;;;;;;;;;;;;;;;;;;1,0;;;;;;;;;;;;;;
opaque;;;;;8,0;;;3,0;;1,0;;1,0;;;2,0;;;;;;;;;;;;;;;3,0;;;11,0;;4,0;;;3,0;;4,0;;;;3,0;;;;;;;;;;;;7,0;17,0;;;7,0;;;8,0;;;;;;;;1,0;;;;;;;;;;6,0;;;;;;;;;;4,0;;;1,0;;;;;;;32,0;3,0;;;;;;2,0;;;;2,0;;;;;;;;;;;;;6,0;;;;;1,0;5,0;;;;;;1,0;;;;;;;;7,0;;;;2,0;4,0;;;;;;;;8,0;;3,0;;;;;;3,0;;4,0;;8,0;;;8,0;2,0;;;;;;;21,0;;;;;2,0;4,0;;;27,0;;;3,0;2,0;;;;;;;;;;7,0;;;;;3,0;;1,0;;;1,0;;2,0;;27,0;;2,0;;;;;1,0;;4,0;;;;;;;5,0;6,0;;;;2,0;;;;1,0;;;;;;;;;;;;;;;4,0;;;;;6,0;;;;;;;4,0;;;;;;;;;;1,0;;;;;1,0;;;;;;;;;;;;;1,0;;;;;;;;;;1,0;;2,0;;3,0;;;;;3,0;;;;;;;3,0;;;;;;1,0;8,0;;;;;;;;1,0;;;1,0;;;;;;;1,0;;;;;;;;;;;;;;;;;;;;;;;;;;;;;;;6,0;4,0;;;;;;;;;;;6,0;;;2,0;;;3,0;;;;;;;;;;;;1,0;1,0;1,0;;;;;;;1,0;;;;;;;;;;;;;;;;;;;;;;;;;;;;;;;;;;;;;;;;;;;;;;;;;;;;;;;;;;;;;;;;1,0;;;;16,0;6,0;;;;6,0;;;;;;;;;;;;;;;;;;;;;;;;1,0;;;;;;;;;;;1,0;;;;;;;;;;;1,0;;;;;;;;;;;;;3,0;;6,0;;;;;;;;1,0;;;;;;;;;;;;;;;;;;;;;;;;;;;;;;;3,0;;;;3,0;;;;;;;;;;;;;;;;;;;;;;;;;;;;;;;;;;;;;;;;;;6,0;;;;;;;;;;;;;;1,0;;;;;;;;;;;;;2,0;;;;2,0;;;;;;;;;;;;;;;;7,0;;;;;;;;;;;;;;;;;;;1,0;;;;;;;;;;;;;;;;;;;;;;;;;;;;;;;;;;;;;;;;;;;;;;;;;;;;;1,0;;;1,0;;;2,0;;;;;;;;;;;;;;;;;;;;;;;;;;;;;;;;;;;;;;;;;;;;;;;;;;;;;;1,0;;;;;;3,0;;;;;;;;;;;;;;;;;;;;;;;;;;;;;;;;;;2,0;;;;;;;;;;;;;;;;;;;;1,0;;;;;;;;;;;;;;;;;;;;;;;;;;;;;;;;;;;;;;;;;;;;;;;;;;;;;;;;;;;;;;;;;;;;;;;6,0;;;;;;2,0;;;;;;;;;;;;;;;;;;;;;;;;;;;;;;;;;;;;;;;;;;;;;;
operative;;;;;11,0;;;3,0;;24,0;3,0;;;;;;;;1,0;5,0;3,0;20,0;1,0;;3,0;;;14,0;;3,0;;8,0;33,0;;10,0;;3,0;;;12,0;;;6,0;2,0;;;;1,0;17,0;;;10,0;2,0;;;92,0;8,0;;;37,0;;;3,0;;;;;;3,0;1,0;1,0;;;;;;3,0;;7,0;;6,0;17,0;3,0;1,0;;;10,0;4,0;;5,0;8,0;;;12,0;;;;1,0;16,0;15,0;4,0;21,0;;1,0;;;;36,0;;;1,0;;;2,0;2,0;;1,0;;1,0;6,0;;;2,0;8,0;;;3,0;;;4,0;6,0;1,0;;;1,0;4,0;10,0;;;2,0;;;;;;;2,0;8,0;8,0;;;8,0;8,0;1,0;;;;8,0;1,0;4,0;;;;;1,0;;;8,0;;;6,0;;11,0;10,0;1,0;9,0;;8,0;;;1,0;;;9,0;;;9,0;10,0;;;;;9,0;27,0;6,0;;;;;;;;6,0;;;;;;;6,0;;;7,0;;;4,0;4,0;;;9,0;;;;1,0;2,0;;;;;;;;3,0;1,0;2,0;1,0;;3,0;;2,0;;;2,0;;2,0;;6,0;;;;;;;;;;9,0;14,0;;;;;1,0;;10,0;1,0;2,0;;;;;2,0;;;;16,0;;1,0;;;5,0;;;17,0;;2,0;11,0;10,0;5,0;;;;;2,0;;1,0;;;;;;;2,0;;;;6,0;;;4,0;;3,0;;;2,0;;;;;;4,0;1,0;;;;6,0;;;;;7,0;;;;;;;;;;;2,0;36,0;;;;;2,0;;1,0;;1,0;;;;;;;;;;;;;;2,0;;;;1,0;;;;;4,0;10,0;;;;;;9,0;;;;;;;;4,0;;;;;;;;;;;;;1,0;;;1,0;;;2,0;1,0;;;;3,0;4,0;;;;3,0;;2,0;23,0;;6,0;;;;4,0;;;;;;2,0;;2,0;;;4,0;2,0;1,0;;3,0;;;31,0;;;;15,0;;;4,0;;;;;1,0;2,0;;;;;;4,0;;3,0;3,0;1,0;;;4,0;;;;;2,0;3,0;;;1,0;;;1,0;;;;;1,0;;2,0;3,0;;;2,0;4,0;;;;;1,0;4,0;;2,0;;3,0;;;;;;;5,0;;12,0;21,0;5,0;3,0;;;;;;;;;2,0;;;;1,0;;;;;1,0;;;2,0;;;;;2,0;;;;4,0;;;;;;;3,0;;;;4,0;2,0;14,0;;;;;;1,0;;;;;1,0;3,0;1,0;;;;;;;;2,0;;;;9,0;4,0;;;;2,0;;;;1,0;;;;;;;;1,0;;;;;;;2,0;;1,0;;;;;1,0;;;;;;;;;;;;1,0;;;;;;;;;;;;;;;2,0;;;;;;;;;;;;;;4,0;;;2,0;;;;;;;;;;;;;;;;;;;;;;;;;;;1,0;;;;;;;1,0;;;;;;;;;;;;;;;7,0;;;;2,0;;;;;2,0;;;1,0;;;;;;4,0;;;;;4,0;;;;;;;1,0;1,0;;;;;;;;;;2,0;1,0;;6,0;;1,0;;;;1,0;1,0;;;;;;;;;;;;;;;;;;2,0;;;;;;;;;;;;;;;;;;;;;;;;;;;;;2,0;;;;;;5,0;;;;;;;;;2,0;;;;;;;;;;;;;;;4,0;3,0;;;;;4,0;;;;;;;;;3,0;;;;;;3,0;;;3,0;;;;;;2,0;1,0;;;;;;;;;;;1,0;;;;;;;;;;;;;;4,0;;;3,0;;;;4,0;;;;;;;;;;;;;3,0;;;;;;;;;1,0;;;2,0;;;;;;1,0;;;;;;;;1,0;;;;;;9,0;;;;;;;;;;;;;;;;;;;;;;;;;;;;;;;;;;;;;;;;;;;;;9,0;;;;;;;;;
orthogonal;;;;;3,0;;197,0;5,0;;;;;;;;;;;10,0;;;4,0;12,0;;7,0;;;4,0;5,0;4,0;2,0;2,0;10,0;1,0;3,0;1,0;;222,0;1,0;3,0;1,0;;7,0;2,0;1,0;;;;1,0;;;;;;2,0;7,0;4,0;;;25,0;8,0;;2,0;;;2,0;8,0;2,0;;1,0;129,0;;5,0;;;8,0;;2,0;14,0;;1,0;;;;;;1,0;1,0;2,0;;3,0;1,0;;;7,0;1,0;;;2,0;;29,0;13,0;;3,0;;;;6,0;;;3,0;19,0;9,0;6,0;3,0;;;;4,0;7,0;;;;2,0;;;5,0;;;;;;;;;2,0;2,0;;1,0;4,0;;;;1,0;4,0;;3,0;5,0;1,0;2,0;;1,0;5,0;1,0;4,0;5,0;2,0;2,0;;25,0;;;;;;1,0;1,0;10,0;;;30,0;1,0;4,0;1,0;3,0;;;;;;;7,0;1,0;;1,0;87,0;10,0;13,0;16,0;24,0;;2,0;;;1,0;;;;42,0;;;2,0;;6,0;;2,0;11,0;9,0;;16,0;;2,0;;;1,0;;;;1,0;;;;2,0;;1,0;;;;2,0;1,0;;;2,0;2,0;1,0;2,0;1,0;;2,0;;2,0;3,0;3,0;3,0;;1,0;1,0;;;;4,0;;;7,0;3,0;;;4,0;;;;2,0;3,0;;2,0;;30,0;;;;;2,0;;;1,0;;;;;5,0;;;2,0;8,0;;2,0;13,0;2,0;2,0;4,0;1,0;;8,0;1,0;;5,0;;11,0;7,0;;5,0;;4,0;5,0;3,0;4,0;;;6,0;;10,0;8,0;;;1,0;;10,0;;1,0;;;2,0;8,0;;;;;1,0;1,0;;;;;2,0;2,0;;;;;;;;;;;;1,0;;;2,0;;;;;;;;;;;;;;;;;;;;;;2,0;;;;;;;;4,0;;1,0;;;;;;;;;;;8,0;;2,0;;;;;;;;;;6,0;;2,0;5,0;;;1,0;;;;;;;;2,0;3,0;;;;;;;;;2,0;;;;;;;;;1,0;;;;;;;;;2,0;;;;;;1,0;1,0;;;;;1,0;;;;;;;;7,0;;;;;2,0;;;;;1,0;;;;4,0;;;;;1,0;1,0;;;;;;;;;9,0;;;;;;;;;1,0;;;3,0;;;;;;1,0;;1,0;;;;;;;;;;;;;;;;;;;;;11,0;;;;;1,0;;;;;1,0;;;;;;;;2,0;;2,0;;;;;;;;;;11,0;;1,0;;4,0;;;;2,0;;;;;;;;;;;;;;;;;;;;5,0;1,0;;;;3,0;;;;;;;;;;;;2,0;;;;;;;;;;;;;;;;;;;;;11,0;;;;12,0;1,0;4,0;;;;2,0;2,0;;;;;;;;;;;;;;;;1,0;;;;;;;;;;3,0;;;;;8,0;3,0;;;;;;;;;;;;;;;;1,0;;;;;;2,0;3,0;;;;;;;;;;;1,0;;;;1,0;;;;;;;;;;;;;;;;;;;;;1,0;;;;;;;;;;;;;;;;;;;;;1,0;;;;;;1,0;;;;;;;;;;;;;;;;;1,0;;;;;;;1,0;;;;;;;;;;;;;;;;;;4,0;;;5,0;;;;;;;;;;;;;;;;;;;;;;;;2,0;;2,0;;;;;;;;;;;;;;;;;;2,0;;;;;;;;2,0;;;;;;;;;;;;;;;;4,0;;;;;2,0;4,0;6,0;;4,0;;;;;;;;;;;;;;;;;;;;;;;;;;;;;;;;;;;;;;;;;;;1,0;;;;;;;;;;;;;;;;;4,0;;;;;;;;;;;;;;;5,0;;;;;;;;;;3,0;;;;;;;;;;;;;;;1,0;;;;;;;;;;;;;;;;
panoramic;;;;;4,0;;2,0;9,0;;28,0;;;3,0;;;;;;3,0;2,0;;10,0;4,0;1,0;;;;11,0;10,0;1,0;1,0;2,0;11,0;;10,0;;;1,0;;7,0;;;;;1,0;;;3,0;;;;19,0;8,0;;;208,0;15,0;;;17,0;;;27,0;;5,0;2,0;;;;;;;;;;;;4,0;7,0;1,0;2,0;2,0;;5,0;;;1,0;;;5,0;9,0;;3,0;2,0;;;;;2,0;;5,0;30,0;;;;1,0;;11,0;;;1,0;;1,0;5,0;;;;;;1,0;;;;;;;10,0;;;2,0;3,0;6,0;;;;1,0;1,0;;;;;5,0;;;;;8,0;4,0;;;;;;;;;;7,0;;;;;;;;;2,0;9,0;;;;15,0;1,0;6,0;1,0;;;2,0;;;;;2,0;;;2,0;;3,0;;11,0;;;;1,0;;1,0;;;2,0;;;;;;;;;;;4,0;;;2,0;;;;;3,0;;;;;;;;1,0;5,0;;6,0;;;;;;;5,0;5,0;;;;;;;;;;;;;;;1,0;;5,0;;2,0;7,0;3,0;1,0;;;;6,0;;;;;;;;;;;;;;;;;1,0;;;;;;3,0;;2,0;;;;;2,0;;;;;10,0;;;;1,0;;;1,0;;;7,0;;;1,0;;;;;;;;;;;;;;;4,0;;;1,0;;8,0;;;;;;;1,0;;;;1,0;;1,0;;;;;;;1,0;;1,0;;;;;;;;;;;;1,0;3,0;;;;;;;;;;3,0;1,0;;;;;;;;;;;13,0;;1,0;;;;;;;;;;;;;;;;;2,0;;;;1,0;;;9,0;;;;;5,0;;;;;1,0;15,0;;;;;10,0;;3,0;;;;;;12,0;;;;;;;;;;3,0;;1,0;;;16,0;;;;;;;;;;;;;;;;1,0;;;;;;;;;;;;;1,0;;;;3,0;;;1,0;3,0;;;;;6,0;28,0;1,0;;;;;;;;;;;;8,0;1,0;2,0;;;;;;;;;;;;;;;;6,0;;1,0;;;;;;;;;;;;;1,0;;;;;;;;;;;;;5,0;;;;;1,0;4,0;;;;;;;;;;;1,0;;;;;;1,0;;;14,0;;2,0;;;;;;;;;;;;;;1,0;;;1,0;1,0;;1,0;;;;;;;;;;;;;;;1,0;;;;;;3,0;;;;;;;;;;;;;;;;;;;;;;;;;;1,0;1,0;;;;;;;;;3,0;2,0;;;;;;;;;;;1,0;;;;1,0;;;;;;;;;2,0;;;;;;;;;;;;;;;;;;;;;1,0;;;;3,0;;;;;;;;;;;;;;;;;;;;;1,0;;;;;;;1,0;;;;;;;;;;;;;;;;4,0;;;;;;1,0;;;3,0;;;;;1,0;;;;;;;;1,0;;;;;;;;;;;1,0;;;;;;;;;;;1,0;;;;;;;;;2,0;;;;;;;;;;;;;;;;;;;;;;3,0;6,0;;3,0;;;;;;;;;;;3,0;;;;;;;;;;;;;;;;;;1,0;;;;;;;;;;1,0;;1,0;;;;;;;1,0;;;;;2,0;;;;;;;;;;2,0;1,0;1,0;;;;;;;;;;;;;;;;;;;;;;;;;;;;;;;;;;;;;1,0;;;3,0;;;;;;;;;;;;;;;;;;;;;;;;;3,0;;;;;;;;;;;;;;;;;;;;;;;;;;;;;;;;;;;;;;
partially;;;;;8,0;;2,0;6,0;;13,0;2,0;;;;;;1,0;3,0;1,0;;;3,0;1,0;1,0;;;1,0;18,0;;1,0;;1,0;13,0;5,0;10,0;;4,0;12,0;;6,0;;1,0;4,0;17,0;;1,0;1,0;;1,0;6,0;3,0;5,0;;;;45,0;20,0;;1,0;21,0;;;18,0;;;4,0;8,0;;;;10,0;;1,0;;;;;6,0;16,0;2,0;;6,0;;2,0;;2,0;20,0;;;;17,0;;;5,0;1,0;4,0;;;1,0;7,0;15,0;11,0;;3,0;1,0;5,0;;21,0;;3,0;1,0;9,0;;8,0;3,0;1,0;;;8,0;3,0;;;3,0;4,0;;;12,0;5,0;;3,0;23,0;2,0;1,0;2,0;;3,0;16,0;3,0;3,0;1,0;;4,0;5,0;8,0;11,0;1,0;20,0;19,0;;4,0;;5,0;;4,0;1,0;1,0;2,0;35,0;;4,0;;;3,0;1,0;;12,0;;19,0;;10,0;12,0;4,0;9,0;6,0;1,0;23,0;3,0;1,0;;;3,0;;13,0;;4,0;;7,0;14,0;;38,0;;;3,0;12,0;1,0;1,0;;1,0;;2,0;5,0;3,0;;10,0;9,0;1,0;1,0;;2,0;6,0;;;23,0;;3,0;6,0;1,0;2,0;;1,0;1,0;4,0;;1,0;11,0;10,0;8,0;1,0;;;6,0;;11,0;2,0;;;;;20,0;;11,0;;2,0;1,0;2,0;1,0;4,0;3,0;;;;1,0;2,0;6,0;1,0;2,0;9,0;13,0;2,0;1,0;;;4,0;;4,0;;20,0;;;;2,0;5,0;1,0;1,0;7,0;14,0;;;9,0;1,0;;1,0;;;1,0;12,0;7,0;8,0;4,0;2,0;;7,0;46,0;1,0;;;3,0;;;;1,0;1,0;;4,0;;;2,0;32,0;;2,0;;;2,0;;3,0;;;;;;;12,0;;2,0;;1,0;;1,0;;;16,0;;;;;;;1,0;;;6,0;2,0;;;;1,0;;1,0;1,0;6,0;12,0;4,0;;;;;;;;;;;;;8,0;2,0;;11,0;3,0;;;;;;;3,0;1,0;;;;6,0;1,0;;;;;;;;5,0;;3,0;1,0;;10,0;;;;;;6,0;;;;;;;2,0;;;;4,0;2,0;4,0;;1,0;;;5,0;;10,0;;;;2,0;;;;2,0;2,0;;1,0;1,0;3,0;;;;;;;6,0;;3,0;;;;3,0;;5,0;;;;40,0;1,0;2,0;;;;;;;;;;;;3,0;;6,0;;;1,0;;;;2,0;2,0;;;;;1,0;;;;7,0;;;;;;1,0;;2,0;6,0;43,0;;;1,0;;;;;;8,0;;;;2,0;2,0;;;;18,0;;4,0;1,0;;;;;1,0;;;;;;;;;;;14,0;;;;;;;;;2,0;;3,0;1,0;1,0;;;;1,0;;;8,0;2,0;;;5,0;;2,0;1,0;1,0;;2,0;;;;1,0;;;;;;6,0;;;;9,0;;;1,0;;;;2,0;;2,0;;;1,0;;;;1,0;;1,0;;;;1,0;;;;3,0;;;;2,0;;;;;1,0;;;;;1,0;1,0;;;;;;;1,0;1,0;;;;;;5,0;;;3,0;2,0;;21,0;2,0;1,0;;1,0;1,0;;1,0;;1,0;;2,0;8,0;2,0;;;4,0;1,0;;;;;;;;;;2,0;2,0;;;;;;;;1,0;3,0;1,0;;;2,0;;;;;;1,0;;6,0;;;;;;;;;;4,0;;;4,0;1,0;;;;;;;1,0;;1,0;2,0;;;2,0;;;;1,0;;14,0;2,0;;;;;;;;;6,0;;;;6,0;;;;;;;;;;;2,0;;2,0;1,0;;;;3,0;;;;;;;;1,0;;4,0;;1,0;;2,0;;;;1,0;;;3,0;;;1,0;;2,0;;1,0;;;;6,0;;3,0;;;;;;;;3,0;;1,0;;1,0;;;;;;;;;;;2,0;;;;;;2,0;;;1,0;3,0;;1,0;;1,0;;1,0;;;;;;;9,0;;;;;;;;;;;21,0;1,0;;;;;;3,0;;;2,0;;;;;;2,0;1,0;;1,0;;;1,0;1,0;1,0;1,0;;;;;;;3,0;8,0;6,0;;;;;;;;;3,0;;;;;;;;;;;1,0;;;;;;4,0;1,0;;;;;;;;;;;;;;;;1,0;;;;;;;;;;1,0;;;;;;;;;;;;;;;;;;;;;;;1,0;;;;;;;;;;;;;;2,0;;;;;;;;;;;;;;;;;1,0;;;;;;;;;;;;;;;;
patch;;;;;1,0;;;;;2,0;;;;;18,0;;;;;;;;;1,0;;;;;;;;2,0;2,0;;;;;;;;;;;;;;;;;;6,0;2,0;;1,0;;15,0;4,0;;;2,0;;;4,0;;6,0;;;;;;;;;;;;;;2,0;;;;;;;;;;;5,0;;;1,0;;;;;;;;5,0;;;;;;;;;;;;;;;;;;;;;;;;;;;;;;;;;;;;;;;;;;;;;;;;;;;;;;;;;;;;;;;;;;;1,0;;;1,0;;9,0;;;;;9,0;;;;;;;;;;11,0;;;;;;;;;;;;;;;;;;;;;;;;;;;;;4,0;;;;;1,0;;;;;;;;;;;;1,0;;;;3,0;;;;;;2,0;;;;;;;;;;;;;;1,0;;;;;;;;;;;;;;;;;;;;;2,0;2,0;;;;;;;;;;;;;;2,0;;;;;;;;;;;;;;;;;;;;;;;;;;;;;;;;1,0;;;;;;;;;;;;;;;;1,0;;;;;;;;;;;;;;;;;;;;;;;1,0;;;;;;;;;;2,0;;;;;;;;;;;;;;;;;7,0;;;;;;;;;;;3,0;;;;;;;;;;;;;;;;2,0;;;;;;;;;;;;2,0;1,0;;;;;;;;;;;;;;;;;;;;;;;;;;;2,0;;;;;;;;;;1,0;;;1,0;;;;;;;;;;;;;2,0;;;;;;;;;;;;;;;;;;;2,0;;;;;;;;;;;;;;;;;;;;;;;;;;;;;;;;;;;;;;;;;;;;2,0;;;3,0;;;;;;;;;;;;;;;;;;;;;;;;;;;;;;;;;;;;;;;;;;;;;;;;1,0;;;;1,0;;;;;;;;;;;;;;;;;;;;;;;;;;;;;;;;1,0;;;;;;;;;;;;;;;;;;;;;;;;;;;;;;;;;;;;;;;;;;;;;;;;;;1,0;;;;;;;2,0;;;;;;;;;;;;;;;;;;;;;1,0;;;;;;;;;;;;;;;;;;;;3,0;;;;;;;;;;;;;;;;;;;;;;;3,0;1,0;;;;;;;;;;;;;;;;;;;;;;;;;;;;;;;;;;;;;;;;;;;;;;;;1,0;;;;;;;;;;;;;;;;;;;;;;;;;;;;;;;;;;;;;;;;;;;;;;;;;;;;;;;;;;;;;;;;;;;;;;;;1,0;;;;;;;;;;;;;;;;;;;;;;;;;;;;;;;;;;;;;;;;;;;;;;;;;;;;;;;;;;;;;;;;;;;;;;;2,0;;;;;;;;;;;;;;;;;;;;1,0;;;;;;;;;;;;;;;;;;;;;;;;;;;;;;;;
patient;;;;;1,0;;5,0;11,0;;3,0;;;;;2,0;1,0;;;1,0;2,0;;1,0;1,0;1,0;;10,0;;18,0;2,0;3,0;;13,0;9,0;;1,0;2,0;;;;2,0;;;;1,0;;;;;;;;3,0;;1,0;;60,0;10,0;;;9,0;;;15,0;;;1,0;1,0;;;;3,0;;6,0;;;1,0;;1,0;5,0;1,0;2,0;2,0;;2,0;;1,0;3,0;;;5,0;4,0;;;;;;;;;;1,0;22,0;;;;;10,0;;;;;;1,0;1,0;;;;;;17,0;;;;;;;8,0;2,0;;1,0;1,0;1,0;;;;9,0;1,0;;;5,0;;;4,0;4,0;;;1,0;;6,0;;;;;;;;;13,0;2,0;13,0;1,0;;1,0;;;;11,0;7,0;;2,0;;2,0;;4,0;;;1,0;1,0;;;;;2,0;;;;2,0;5,0;;28,0;;;3,0;2,0;;;;;1,0;;;;;4,0;;1,0;;;;4,0;5,0;;;;;;;1,0;;;;;;3,0;;4,0;;;;;;;;;;1,0;;;8,0;;;;;;;;;;;;;;;;;;;3,0;;;;;;;;;;;;;;;;;;;1,0;;;2,0;;;;1,0;;;;5,0;;1,0;;;;;;2,0;;;1,0;;;;;;;;6,0;9,0;1,0;;;;;;;;;;;;;;;;;1,0;;;;;;;;;;;;;;;;;;;;;;;;2,0;9,0;;;;;1,0;;;;;;;;;;;;;;7,0;;;;3,0;;;1,0;;;3,0;;;;1,0;;;;;;;;;1,0;;;;;;1,0;;4,0;;;;;;;;;;3,0;;;;;;;;;3,0;2,0;;;2,0;;;;;;;;;;;;;;;;;;;;;;;;;;1,0;;;;;;;;;;;;;;;;;;;;;;10,0;;;;;;;;;3,0;;;;;;;;;;;;;;;5,0;;;2,0;;;;;;3,0;;;;2,0;;;;;;;;;;;;;1,0;;;;;;1,0;;;;;;;;;;;3,0;;;;;;;;;;;;5,0;;;;;;;1,0;;;;;;;1,0;;5,0;;;1,0;;;;;;;;;;;;;1,0;;;;;;;;;;;;;;2,0;;1,0;;;;;;;;;;;;;;;;;;;;;;;;;;;;;;;;;;;;3,0;;1,0;;;;;;;;;;;2,0;4,0;;;;;;;6,0;;;;1,0;1,0;;;;;;;;;;;;;;;;;;;;;;;;;;;;;;;;;;;;;;;;;;;2,0;;;;;;;;;;;;;;;;2,0;;;;;;;;;;;;;;;;;;;;;;1,0;;;;;;;;;;2,0;;6,0;;;;;1,0;;;1,0;;;;;;;;;;;;4,0;;7,0;;1,0;;;;;;;;;;;;;;1,0;;;;;;;;;;;;;;;;;;;;;;1,0;;;;;;;;;;;;;;;1,0;;;1,0;;3,0;;;;;1,0;;;;;;;;;;;;;;3,0;;;;;;;;;;;;;;;;;;;;;;;;;;;;;;;;;;;;;;;;;;;;;;;;;;;;;;;;2,0;;;;;3,0;;;11,0;;;;;;1,0;;;;;1,0;;;5,0;;;;;;;2,0;;;;;;;;;;;;;;;;;;;;;;;;;;;;;;;;;;;;;7,0;;;;;;;;;;;;;;;;;;;;;;;;;
peak;;;;;6,0;;;12,0;7,0;;5,0;2,0;;;8,0;;;;3,0;1,0;;5,0;;1,0;;1,0;;6,0;;62,0;11,0;2,0;6,0;;3,0;;;;;2,0;3,0;;;2,0;;11,0;;;23,0;3,0;;1,0;1,0;6,0;;20,0;4,0;;;12,0;;;12,0;;1,0;;1,0;;;4,0;3,0;;;;;;;1,0;32,0;;;;;;;;1,0;1,0;3,0;6,0;;4,0;;11,0;;;;3,0;3,0;;;;;;;;1,0;33,0;1,0;;;;2,0;;;;2,0;4,0;;1,0;;;3,0;4,0;;;3,0;;12,0;;;1,0;;;;2,0;;3,0;;2,0;1,0;;;;14,0;1,0;;1,0;1,0;;4,0;;;;5,0;;;;;9,0;;;2,0;;;2,0;12,0;4,0;;;;;;;;;;6,0;;;;;4,0;;;;;9,0;;3,0;;;;1,0;;;;;3,0;;;;;1,0;;;;;;;;;;;;3,0;;;;;;;;3,0;;21,0;;;;;;;;;23,0;;;4,0;;;;;;8,0;;;;;;;;;;;;;;;;;;;4,0;2,0;;;;;;;;;;;;;;;;;;;;;;1,0;5,0;;;1,0;;;;;;;;3,0;;;;;1,0;4,0;;;;40,0;;;10,0;;;;;;;;;;;;;;;;;;;;1,0;;;;;;;;;;;;;6,0;;;;;;5,0;;;;;;6,0;;;;;1,0;;;;8,0;7,0;;;29,0;;2,0;;;2,0;;;;;;;5,0;;;;77,0;;;;1,0;;;4,0;;;;;;;4,0;;;;;;;;;;;;;;;;;;;;;;4,0;;;;19,0;;;;;;4,0;;;;;;11,0;;;;;;;;;3,0;;;;;;;;;;2,0;;;;;;;;15,0;;;;;7,0;;;7,0;;;;;;;;;;;;;;1,0;;1,0;;4,0;;;;;;;;3,0;;;;;;;;;;;;;;;;;;;;;;;;;;;;2,0;;;;;;;;;;;;;;;;;;;;;2,0;;;;4,0;;;;;;;;;;13,0;;;;;;;;;;;;;;;;;;;;;;4,0;;;;;;;;;;;1,0;;;;;;;;;;;;;;;;;;;;;;;;;;;;;5,0;;;;;;;;;;;4,0;;;;;;;;;;;;;;;;;2,0;;;;;;;;;;;;;;;;;;;;;;;;;;;;;;;;;2,0;2,0;;;1,0;17,0;;;;;;;;;;;;;;;;;;;1,0;;2,0;;;;;;;;;;;;;;3,0;;2,0;;;;;;2,0;51,0;;;;;;;;;;;46,0;;;1,0;70,0;;;;;;;;1,0;;;2,0;;;;;;9,0;;;;;;;;;;;4,0;34,0;;;;;;;;;;46,0;;;;;;;;;;;;;;;;;;;;;;;;1,0;;;;;;;;2,0;;;;;;;;;;1,0;;;;;;;;4,0;;;;;;;;;;;;;;;;;2,0;9,0;;;;;;;1,0;;;;;;;;;;;;;;;1,0;;;;;;;;;;;;;;;;;;;;;;;;;;;;;;;;;;4,0;;;;;;;;;;;;;;;;;4,0;2,0;;;;;;;;;;;;;;;;;;;;;;;1,0;;;;;;;;;;;;;;;;;;;;;;;;;;;;;;;;;;;;;;;;;;;;;;;;
perimeter;;;;;6,0;;1,0;13,0;;11,0;3,0;;;;;;;;2,0;6,0;;16,0;3,0;;;;1,0;;4,0;1,0;;7,0;94,0;;2,0;;1,0;11,0;;6,0;4,0;;;9,0;;;;;;;;;;;;24,0;33,0;;;36,0;;1,0;17,0;;;;1,0;;;;2,0;;;;;;;4,0;15,0;;;5,0;;2,0;;;5,0;;1,0;17,0;4,0;;;4,0;;4,0;;;1,0;;105,0;4,0;;;;;;26,0;;;2,0;;1,0;;2,0;;;;3,0;11,0;;;;;1,0;;3,0;3,0;;1,0;4,0;;;;;;27,0;;;;;;;;2,0;;7,0;10,0;;;;3,0;;;;;;23,0;;;;;169,0;2,0;;6,0;;2,0;;1,0;1,0;;18,0;4,0;6,0;40,0;129,0;1,0;;;;;;;2,0;4,0;6,0;36,0;;17,0;;2,0;;7,0;;;;;;1,0;;1,0;;2,0;;;;;1,0;7,0;;;;2,0;;1,0;1,0;6,0;;2,0;11,0;;;;10,0;;4,0;;;;;;;;;3,0;1,0;2,0;19,0;;;1,0;1,0;;;;1,0;;;;;;;;;;7,0;13,0;1,0;;;;9,0;;10,0;;2,0;;;;1,0;;;;2,0;;;;;8,0;2,0;;;3,0;;;;;;1,0;;;;7,0;;;;;;;;;;;;;;;;2,0;;3,0;;;1,0;;;;;1,0;1,0;1,0;;1,0;;1,0;;;;;;;;;;2,0;;;;;;4,0;;;;;;;6,0;;1,0;;4,0;;;;;;;;;1,0;1,0;;19,0;1,0;;;;1,0;;;;;1,0;2,0;;;;7,0;;;;;;;;;;2,0;;3,0;;;;;;;21,0;;1,0;;;;;;;;;;2,0;;;;;;;;11,0;;8,0;;;;;;;;;;;;;;;;;;;;;53,0;;;;1,0;;;;;;;22,0;1,0;;;;;2,0;;;;;;1,0;;;;;;;;;;;;;;;;;;;;;;;4,0;1,0;;;;;;81,0;20,0;2,0;;;;;;;;2,0;;;;;;;;;;;;6,0;;;;;;;;;;;;;;;;3,0;;;;;;;;;;;;;;;;;;;;;2,0;;;;;;;;;;;;;;;;;;;;;;;;;;;;;;;;2,0;4,0;;;;;1,0;;;;;;;;2,0;;;;;;;;;;;;7,0;7,0;;;;;;;;1,0;;;;;;;;;;;;;1,0;;;3,0;;;;;;;;;;;;;;;;;;;;;;;;;;;;1,0;;;;2,0;;;;;;;;1,0;2,0;;;;;;;;;;;;;;;4,0;;1,0;;;4,0;2,0;;;;;;;;;;;1,0;;;1,0;;2,0;;1,0;;;;;;;;;;;;;;;;;;;3,0;;;;;;;;;;;;;;;;;;1,0;;;;;;;;;;;;;2,0;;;;1,0;;;;2,0;;;;;;;1,0;;;;;;;;;;;;;;;;1,0;;;;;;;;;;2,0;;;;;;;;;;;;;;;;;;;;;;;;;;;;;;;;;;;;;;;;;;;;;;;;;1,0;;;2,0;;;;;;;1,0;;;;;;;;;;;;;;;;;;;;;;;;;;;;;;;;;;;;;;;;;;;;;;;;;;;;;;;;;;;;;;;;;;;;;;;;;;;;;;;;;;;;;;;;;;;;;1,0;;;;;;;;;;;;;;;;;;;;;;;;;1,0;1,0;;;;;;;;;;;;;;
permanent;;;;;5,0;;5,0;4,0;;;;;;;;1,0;;;;;;;;;3,0;;;1,0;4,0;2,0;;;2,0;;5,0;;;7,0;;;3,0;;11,0;2,0;;;;1,0;3,0;;;9,0;;;;24,0;5,0;;;48,0;;;3,0;;;2,0;1,0;;;;12,0;;;1,0;1,0;;;1,0;11,0;;;;;;;;;;;;15,0;;;;;;;;2,0;;4,0;;;;;;;18,0;;;;12,0;;;;;;;;7,0;;;;;;;5,0;;;1,0;1,0;;;;;;;;1,0;;;;;11,0;;15,0;3,0;13,0;;;;;;;;1,0;;3,0;;;;;4,0;;;;;4,0;;1,0;6,0;;8,0;38,0;7,0;;6,0;1,0;;;;;;;;;;5,0;;18,0;;;;11,0;;;;;5,0;10,0;;;1,0;13,0;;;;;;;;4,0;;;;;;;;;10,0;;;;;;;;;4,0;;;2,0;;;1,0;6,0;1,0;;;11,0;2,0;;;;;;;3,0;35,0;;1,0;;2,0;1,0;;;2,0;;;;21,0;;1,0;;;1,0;;2,0;;;;;;;;;;2,0;5,0;;185,0;5,0;2,0;;;7,0;;;9,0;;;;;;;;;1,0;3,0;;;;;;;;;;;;;;;;;;3,0;;;6,0;3,0;;;;;;;1,0;;;;;;;;;;;;;1,0;;;;;;;;;;;;;;;;;;;;;;;;;;;;;;;;;;19,0;1,0;;;1,0;;;;;;;;;;3,0;1,0;;;;6,0;;;;;;;;;;;;;;;;;;;;;;;;;;;;;1,0;;;;;;;;;;;;2,0;;;;;;;;;;;;;;;;;13,0;;;;;;;;;;;;;;;;;;;;;;;;;;;;;;;;;6,0;;;;;1,0;;;;;;;;;;;;;;1,0;;;;;;4,0;;;;;;;;;;;;;;;;;;;;4,0;;;;;;;;;;;;;11,0;;;;;;;;;;;;;;;;;;;;;1,0;;;;1,0;;;;;;;;;;;;;;;;;;1,0;;;;;;;;;;;;;;;;;;;;;;;;;;;;;;;;;;;;;2,0;;;;;;;;;;;;;;1,0;;;;;;;;;;;;;;;;;;;;;;;;;;;;;;4,0;;;;;;;;;;;;;;;;;;;;;;;;5,0;;;;;;;;;1,0;;;;;;;;;1,0;;;;;;;;1,0;;;;;1,0;;;;;;;;;;1,0;;;;;;;;;;;;;;;;;;;;;;;;;;;;2,0;;;;;;;;;;;;;;;;;;;;;;;;;;;;;;;;;;;;;;;;;;;;;;;;;;;;;;6,0;;;;;;;;;;;;;;;;;1,0;;;;;;;;;;;3,0;;;;;;;;;;;;;;;;;;;2,0;;;;;;;1,0;;;;;;1,0;;;;;;;;;;;;;;;;;;;;;;;;;;;;;;;;;;;;;;;;;;;;;;;;;;;;;;;11,0;;;;;;;;1,0;2,0;;;;;;;;;;;;1,0;;;;;;;;;;;;;;;;;;;;;;;;;;;;;;;;;;;;5,0;;;;;;;;;;;;;
photodetector;;;;;3,0;;;3,0;;;;;;;1,0;;;;6,0;1,0;;5,0;;;;;;6,0;;9,0;1,0;;2,0;;45,0;2,0;;6,0;;6,0;1,0;2,0;;;;;;2,0;2,0;;;3,0;;2,0;;19,0;9,0;;2,0;9,0;;;9,0;;;;2,0;;;;18,0;;10,0;;;;;;;;;5,0;4,0;6,0;;;;;;;7,0;;;14,0;;;;;;19,0;;10,0;;;;;1,0;2,0;;;;13,0;241,0;;;;;;;;;;;3,0;1,0;;;1,0;;7,0;;;5,0;;;1,0;21,0;;;2,0;;;;;5,0;;;;3,0;;;;;;;;;1,0;1,0;1,0;;;;;;;;62,0;;1,0;;;;;;;;2,0;;;;;2,0;;;10,0;;7,0;;17,0;;;;14,0;;2,0;;;;;18,0;;;;;;;;;;1,0;;;;;29,0;;;;;;;;;;8,0;;;;;;;;;;;;;;;;;;;;;;;;;;;;2,0;;;;;;;;2,0;;;;;;;;;;;;;;1,0;;;;4,0;;;;1,0;;;;6,0;;;6,0;;;;;;;4,0;;;;;2,0;;;;;;;6,0;2,0;;;;;;;;;;;;;;;1,0;;;;;;;;;;;;;;;;13,0;;;;;;;;;;;;;;;;;;;;;;;;;;;26,0;;;;;4,0;;;;;;;;;;;1,0;;;;;;;;;;;;;;;;;;;;;;;;;;;;;;;;;;1,0;;3,0;;;;;;;;;1,0;;;;;;;;;;;;;;2,0;4,0;;;;;;;;10,0;;;;;;;;;;;;;;;;;;;;;;;;;;;;;;;;;;;;;;;;;;;7,0;8,0;;;;;;;;8,0;;;;;;;;;;;;;;;;;;1,0;;;;;;;;;;;;;;;;;;;9,0;;1,0;;;;;;;;;;;;;;;;;2,0;;;;;;1,0;;;1,0;;;;;;;;;;;;;;;;;;;;;;;;;4,0;;;;;;;;;;;;;;;;;;;;;;;;;;;;6,0;3,0;;;;;;;;;;;3,0;;2,0;;;;;;;;;;;;;;;;;;;;;;;;;;;;1,0;;;;;;;;;;;;;;;;;;;4,0;;;;;;;;;;;;;;;;32,0;;;;;;1,0;;;;;;;;;;;;;;;;;;;;1,0;;;;;;;;;;;;;;;32,0;;;;;;;41,0;;;;;;;;2,0;;;;;;8,0;;;;4,0;;;;;;;;1,0;;;;;;;;;;;;;;;;;;;;;;;;;;;;;;;;;;;;;;;;;;;;;;;;;;;;;;;;;;;;;;;;;;;;;;;;;;;;;;;;;;;;;;;;;;;;;;;;;;;;;;;;;;;;;;;;;;;;;;;;;2,0;;;;;;;;;;;;;;;;;;;;;;;;;;;;;;;;;;;;;;;;;;;;;;;;;;;;;;;;;;;;;;;;;;;;;;;;;;;;;;;;;;;;;;;;;;;;;;;;;;;;;;;;;
photosensitive;;;;;1,0;;;3,0;;5,0;;;;;;;;;;;;1,0;;;;;;15,0;;;2,0;;9,0;;11,0;25,0;;4,0;2,0;;;;2,0;34,0;;1,0;;14,0;4,0;2,0;;5,0;;;;40,0;6,0;;;4,0;13,0;;5,0;1,0;;1,0;3,0;1,0;;;;1,0;;;;;;;9,0;;;1,0;;;;;;2,0;;;75,0;;;7,0;4,0;3,0;;;;4,0;3,0;7,0;;;;2,0;;9,0;;;;8,0;38,0;;;;;;3,0;;8,0;;;5,0;4,0;;8,0;;;1,0;4,0;;;;;;5,0;;5,0;;;;;;2,0;;16,0;;;;;;;;;2,0;1,0;;8,0;7,0;1,0;;;1,0;;29,0;2,0;15,0;1,0;;;1,0;7,0;1,0;;2,0;;;;;;;;;;7,0;;46,0;;;;;1,0;13,0;;;;;;;;;;;;;;;1,0;;;;;;;4,0;;;;;;;;;;1,0;;;;;;;;;;;;5,0;105,0;;;;;;;;;61,0;;;;;;;2,0;;;4,0;;;;3,0;2,0;;;;;;;;;;;;;;;;;12,0;;;;1,0;;;2,0;8,0;;;;;2,0;3,0;;;;1,0;;;;;;;;;;4,0;;;;5,0;;;;;;;;9,0;;1,0;;;;6,0;;;1,0;;;;;;;;;;;1,0;;3,0;;;;;;;;2,0;;;;;;;1,0;;;;;;;;;;;;1,0;;;;;;;;;;;1,0;;;;;;;;;;2,0;;;;;;;1,0;;3,0;;;;;;2,0;;;;;;;;2,0;;1,0;;;;;;3,0;;;;;;;2,0;;1,0;;;;;;;2,0;;;;;;;;;;;1,0;;2,0;;;;;;;;;;;;;;;;2,0;;;;;;;;;;;;;;;;;;;;2,0;;;;;;;4,0;;3,0;;1,0;1,0;;;;;;;;;;2,0;;1,0;2,0;;;;;;;;;;;;;;;;;;2,0;1,0;;;3,0;;;;;;;;;;;;;;;;;;;;;;;;;;;;36,0;;;;;;;;;;;;;;8,0;;;;;;;;;;;;;;;;;9,0;;;2,0;;;;;;1,0;;;;;;;;;;;;;;;1,0;2,0;;;;;;1,0;1,0;;;;;;;;8,0;;;;;2,0;;;;;;;;;;;;;2,0;;1,0;;;;;;;;;;;;;;;;;;;;;;;;;;;;;1,0;;;;;;;;;;;;;;;;1,0;;;;;;;;;;;;;;;;;11,0;;;1,0;;;;;;;;;;;;;;;;;;;;;;;;;;;;;;;;;;;;;;;;;;;;;;;1,0;;;;;;;;;;;;2,0;;2,0;1,0;;;;;;;;;2,0;;;;;;;;;;;;;;;;;;;;;;;;;;1,0;;;;;;;;;;;;;;;;;;;;;;1,0;;;;;1,0;;19,0;;;;;;;;;;;;;;;;;;;;1,0;;;;;;;;;;;;;;;;;;;;;;;;;;;;;;;;;;;;;;;;;;;;;;;;;;;;;;;;;;;;;;;;;2,0;;;;;;;;;;;;;;;;1,0;;;;;;;;;;;;;;;;;;;;;;;;;;1,0;;;;;;;;;;;;;;;;;;;;;;;;;;;;;;
photosensor;;;;;1,0;;;;;15,0;1,0;;;;;;;;;;;4,0;;1,0;;;;3,0;;;;2,0;10,0;;7,0;10,0;1,0;4,0;;1,0;;;;3,0;;;;;;2,0;;2,0;;;;20,0;13,0;;;9,0;;;10,0;;;;;5,0;;3,0;4,0;1,0;;;;;;;2,0;;;;1,0;;;;6,0;;1,0;;7,0;2,0;;31,0;2,0;;;;7,0;7,0;5,0;;;20,0;;;;;;;1,0;2,0;51,0;1,0;;;;;;;;;;1,0;;;5,0;;;;;;;;;;2,0;2,0;20,0;;;;;;;;2,0;4,0;;;;;;;;;;;1,0;7,0;;;;;;12,0;1,0;4,0;;;;1,0;3,0;;;;;5,0;;;;;2,0;;;;;5,0;;7,0;;;;;;1,0;;;;;7,0;;;;;;;;;;;;;;;3,0;;;;;;;;;;;1,0;;;;;;;2,0;;;;2,0;;;;;;;;;;5,0;;;;;;1,0;;;;3,0;;;1,0;;;;;;;;;1,0;;3,0;;;;;;;;;;;;;;;;1,0;5,0;;;;;;;;;;;;3,0;;1,0;8,0;;;;;1,0;;3,0;2,0;;;;;;;;;;;;;;3,0;;;;;1,0;;;;;;;;;;;;;;;;;;;;;;;;;;;;;;;;;;;;;;;;;;2,0;;;;3,0;;;;;1,0;;;2,0;;4,0;;;;;;;;;;;;;;;;;2,0;;;;;;;;;;;;;;;2,0;;;;;;3,0;;;23,0;1,0;1,0;;;;;;;6,0;;;;;;;;;;;;;;;1,0;;1,0;;;;;1,0;;;;;4,0;;;;;;;;;;;;;;;;;;;;;;;;;;;;;;;;;1,0;;2,0;;;;;;;;;;;;;;;;;;;;;;;;;;;;;;;;;;;;;;;;;;;1,0;;;;;;;;;;;;;;;;;;;12,0;;;;;;2,0;;;;;;;;;;;;;;;;2,0;;;;;;;;;;;;;15,0;;;;;;;;;;;;;;;;;;;;;;;;;;;;7,0;;;;;;;;;;;;;;;;;;;;;;;;;;;;;;;;;;;;;;;;;;;;;;;;;;;4,0;;;;1,0;;1,0;;;;;;;;;;;;;;;;;2,0;;3,0;;;;;;;;;;1,0;;;;;;;;;;;;;;;;2,0;;;;;;;1,0;;;;;;;;1,0;;;;;;;;;;;;;;;;;;7,0;;;;1,0;;;;;1,0;;;;;;;;;;;;;;;;;;;;;;;;;;;;;;;;;;;;;;;;;;;;;;;;;;;;;;;;;;;;;3,0;;;;;;;;;;;;;;;;;2,0;;;;;;;;;;;;;;;;;;;;;;;;;;;;;;;;;;;;;;;;;;;;;;;;;;;;;;;;;;;;;;;;;;;;;;;;;;;;;;;;;;;;1,0;;;;;2,0;;;;;;;;;;;;;;;;;;;;;;;;;;;;;;;;;;;;;;;;;;;;;;;;;;;;;;;;;;;;;;;;;
pivot;;;;;6,0;;95,0;31,0;;;12,0;;3,0;;;1,0;;;7,0;1,0;;8,0;;;;;1,0;;5,0;6,0;;1,0;10,0;;4,0;4,0;3,0;25,0;1,0;7,0;2,0;;14,0;48,0;;;;1,0;;;2,0;;;;3,0;2,0;29,0;;1,0;32,0;4,0;;8,0;;;5,0;9,0;;;3,0;7,0;1,0;5,0;;;1,0;;36,0;45,0;2,0;4,0;;1,0;;;1,0;;7,0;;;;;;;;9,0;;;;;17,0;40,0;;;;;;22,0;;1,0;4,0;8,0;;22,0;46,0;;;;1,0;51,0;;;4,0;1,0;1,0;;24,0;5,0;;23,0;5,0;;;32,0;1,0;1,0;20,0;;;1,0;;;1,0;3,0;;6,0;6,0;13,0;;;;7,0;14,0;;2,0;7,0;27,0;25,0;1,0;2,0;;;27,0;4,0;3,0;;3,0;11,0;;1,0;137,0;11,0;7,0;87,0;8,0;7,0;23,0;;;;4,0;4,0;1,0;;;11,0;38,0;23,0;;82,0;1,0;5,0;;12,0;;;;1,0;10,0;21,0;;6,0;4,0;43,0;5,0;;7,0;14,0;1,0;84,0;;3,0;;1,0;28,0;;;;;11,0;21,0;1,0;1,0;;3,0;;;;2,0;;1,0;;;2,0;1,0;2,0;3,0;;;;;8,0;20,0;10,0;5,0;5,0;;;3,0;1,0;;;;29,0;;;3,0;10,0;2,0;2,0;;12,0;12,0;4,0;22,0;;33,0;4,0;;2,0;;5,0;;;;1,0;;19,0;2,0;15,0;19,0;;1,0;123,0;;1,0;21,0;2,0;5,0;31,0;;1,0;;;;2,0;;;;;1,0;2,0;;3,0;4,0;1,0;9,0;3,0;11,0;8,0;;6,0;3,0;1,0;3,0;;39,0;;;;8,0;;143,0;15,0;;6,0;;12,0;;;2,0;1,0;12,0;;;;;;;;;;4,0;;;;;1,0;;;2,0;;;;;;;;;1,0;;;;;;;;;;;;6,0;;;1,0;;;;;5,0;;;1,0;1,0;;;;;;;12,0;2,0;24,0;;45,0;;;;;;;;;;;;14,0;;2,0;3,0;3,0;6,0;7,0;1,0;;1,0;;;;;10,0;;;;;2,0;;;;;;;;;;3,0;;;;;2,0;;;1,0;;2,0;;;;;;;;20,0;;;;;1,0;;;;;;;1,0;9,0;1,0;;;;2,0;;;;;;;;;;;;;;30,0;1,0;;;4,0;;1,0;;2,0;14,0;4,0;;;;;1,0;;;;4,0;5,0;;7,0;;1,0;3,0;;;;1,0;7,0;2,0;;;;;21,0;;2,0;;;17,0;14,0;;;;;4,0;;;;13,0;1,0;;;;;;2,0;6,0;;24,0;;;3,0;;;;;;;13,0;;4,0;;;;;;2,0;;27,0;;;;3,0;;;;;;11,0;;;;;;;;;11,0;1,0;;;;;;5,0;4,0;;3,0;;;;5,0;;;1,0;;2,0;;;2,0;6,0;;6,0;;2,0;;;;1,0;;;;;9,0;;2,0;4,0;;4,0;;1,0;;;12,0;2,0;;;5,0;11,0;11,0;22,0;;3,0;;;;6,0;;;3,0;;;;;;17,0;;2,0;;9,0;6,0;1,0;;;;;;;;3,0;6,0;;;;;;11,0;;;;;;;;;;;;;1,0;;;;3,0;;;;;;32,0;;;;;;;;2,0;;;;;;;;;;;;;;;;;11,0;;;2,0;;;;;1,0;;;;;;;;;;;;;;1,0;1,0;;2,0;;;;;;;;;;;;1,0;;;;1,0;;;;;;;;;6,0;;;;;1,0;;;;;;1,0;;;;;;;;;;;2,0;;;;;1,0;;;;10,0;;;;;;;;;2,0;1,0;;;;;1,0;;2,0;;;;;;2,0;;;;1,0;8,0;;;;;;;20,0;1,0;;;;;;;;;;10,0;;;;;;;;;5,0;7,0;;;1,0;1,0;;;;;;1,0;;;;;7,0;2,0;;;;;;;;;5,0;;;;;1,0;;;;;;;;;;;;4,0;;;;;1,0;;;;;;;;;;;;;;;8,0;;;;;;;;;;;;;;;;;;;;;1,0;;;;;;;;;;;1,0;;;;;;;;;;;;;;;;;;;;;1,0;;;;;;;;;;;;;;;;;;;;;;;;;
planar;;;;;5,0;;5,0;11,0;3,0;4,0;;;;1,0;;;;;2,0;;1,0;7,0;1,0;;;;;1,0;;4,0;8,0;8,0;24,0;;2,0;4,0;;36,0;;5,0;2,0;1,0;30,0;9,0;1,0;;;;;;;;;3,0;;46,0;44,0;;2,0;26,0;;;24,0;;;3,0;3,0;;;;5,0;;2,0;2,0;13,0;;;4,0;10,0;;;1,0;3,0;;;;19,0;;;;1,0;;;;;12,0;1,0;;;42,0;176,0;22,0;;;;;;;;;2,0;2,0;6,0;22,0;10,0;;;;3,0;3,0;;;;1,0;;;6,0;7,0;;1,0;9,0;;2,0;2,0;;17,0;4,0;;4,0;1,0;;;2,0;10,0;;;24,0;10,0;7,0;;;;1,0;;;4,0;1,0;6,0;;21,0;;;8,0;3,0;;5,0;2,0;12,0;;1,0;15,0;9,0;3,0;15,0;1,0;;6,0;;;;34,0;;2,0;;;16,0;9,0;4,0;;69,0;;2,0;;3,0;;1,0;3,0;1,0;;5,0;;6,0;2,0;19,0;;;14,0;1,0;3,0;7,0;;1,0;3,0;;1,0;2,0;;;;;1,0;;;;5,0;;4,0;;;3,0;1,0;;2,0;;;9,0;;9,0;11,0;3,0;1,0;;;30,0;;;;2,0;;40,0;;;;3,0;;;;26,0;;;;;6,0;;2,0;;15,0;;;5,0;;4,0;;;8,0;;;;;5,0;;4,0;;2,0;1,0;9,0;;5,0;;4,0;;7,0;4,0;1,0;1,0;6,0;;1,0;;;5,0;;;;3,0;;9,0;3,0;1,0;4,0;1,0;3,0;;;2,0;;;1,0;;1,0;;;7,0;;;7,0;3,0;;;;1,0;;;;;;;2,0;;;;;;;;;;;;;3,0;;11,0;;;;;;;;;;4,0;;3,0;;;1,0;;;;1,0;;;1,0;;;;;11,0;;1,0;2,0;1,0;;;;;;2,0;;;;;;;;13,0;;;;;;;;;;;;;;;;1,0;;;7,0;;;;;;;;1,0;;;;;;;;;;;;;;;2,0;;;1,0;;1,0;1,0;;;;;;;2,0;5,0;;;;;;;;;;;5,0;;1,0;;3,0;;;;3,0;;;;5,0;;;;;;;;;;1,0;;;;;5,0;;;6,0;1,0;1,0;8,0;;;;;1,0;;5,0;1,0;;;;;1,0;;;;2,0;;1,0;;;;;;;2,0;;;1,0;;2,0;6,0;;;;;;;1,0;;;3,0;;;;;;;1,0;;;;;1,0;;;;;;;1,0;;4,0;;;;;;7,0;;;;;;;;;;;;;;;;;;;;3,0;;;;;2,0;;;;;2,0;;;3,0;;;;;;;2,0;4,0;;;1,0;;1,0;;;;;7,0;;;;1,0;2,0;1,0;;;;;;;;2,0;1,0;;4,0;;;;;;;;3,0;1,0;;;;;;;;;;;;;;;;4,0;;;;;10,0;;;;;;;;;;3,0;;1,0;;;;;;;;16,0;;;;;;;;;;;;4,0;;;;;;;;;;;;;;;;;;;;;;;;5,0;;1,0;;;1,0;;;;;;;;;;4,0;;;;;;;;;;;;1,0;;;;2,0;1,0;;;2,0;5,0;;;;;;;;;;9,0;;;;;;;;1,0;4,0;;;;;;;;;;;;;;;;;;;;3,0;;5,0;;;;;;1,0;;;6,0;;1,0;;1,0;;;;;;;;;;;;;;;;;;;;;1,0;;;;;1,0;;;;;;3,0;;;;;;;1,0;;;;;;;;;;1,0;;;8,0;2,0;4,0;;;;;;;;;;;;;;;;;;;;;1,0;;2,0;;;;;;;;1,0;;;;;;1,0;;;;;;;;;;;;;;;4,0;;;;;;;;;;;;;1,0;;;;1,0;;;;;;1,0;;;;;;;;;;;;;;4,0;;2,0;;;;;;;;;;;1,0;;1,0;;;;;;;;;;;;;;;;;;;;;;;;;;;5,0;;;;
platform;;;;;2,0;;3,0;;;15,0;18,0;;;;;;;;1,0;6,0;;3,0;;;1,0;;;2,0;;;;2,0;3,0;;10,0;3,0;;4,0;;1,0;;;28,0;4,0;;;;;;;;;;;;22,0;27,0;;2,0;6,0;;;18,0;;;27,0;13,0;;6,0;;;;9,0;;;;;2,0;24,0;1,0;;1,0;;1,0;;;;;;2,0;2,0;;1,0;1,0;;;;;;;28,0;43,0;;;;;;3,0;;;9,0;;;8,0;13,0;;;;;;;;;;;;16,0;;;34,0;1,0;1,0;;;;;10,0;17,0;;;;;;1,0;;4,0;3,0;;;;;;;;;3,0;2,0;4,0;2,0;1,0;;1,0;;4,0;;;23,0;;;;14,0;;4,0;101,0;11,0;1,0;;1,0;;;;;;;;4,0;1,0;4,0;;12,0;;;;6,0;;;;;3,0;6,0;;4,0;;9,0;;;;;;31,0;;;;;39,0;;1,0;;7,0;;;6,0;;;1,0;;2,0;;;;;;3,0;5,0;3,0;6,0;;2,0;;;3,0;2,0;;1,0;7,0;;1,0;;;;;;;26,0;;;;9,0;;;;9,0;5,0;;;;16,0;2,0;;;;11,0;;;;3,0;;;;8,0;1,0;;7,0;9,0;;1,0;9,0;3,0;1,0;6,0;;;;;;2,0;;;3,0;;;3,0;1,0;;;;2,0;;;;;4,0;1,0;;;1,0;;;;;1,0;10,0;3,0;;;1,0;;;;;2,0;;12,0;;;;;;;3,0;;;;;;1,0;;1,0;;;1,0;;;1,0;;;;;;;;;;;;;;;;;;1,0;;2,0;1,0;1,0;;;;7,0;;;;1,0;;;2,0;;;;;;;;;;;3,0;;;;;;;1,0;;;;;;;8,0;;;;2,0;;;;;2,0;1,0;;22,0;;;;;;;1,0;;4,0;;2,0;;;;;;;;;;2,0;2,0;;1,0;;;;;2,0;;;;;;;;;;2,0;;2,0;3,0;3,0;;;;;3,0;;;;;;;;;;;;2,0;;5,0;1,0;;;;;;;;19,0;10,0;;;;;;;;;;3,0;;;;;;;;;2,0;;1,0;;;;;1,0;;;;;;;;;2,0;;;;;;;2,0;1,0;;;;;2,0;;;7,0;;;;;;;;3,0;;3,0;;2,0;2,0;;;;;;;1,0;;;;1,0;;;;;;;3,0;;;;;;;;;;;;;;;;;;;;4,0;6,0;3,0;;;;;12,0;;;;18,0;;;;3,0;;;;2,0;;;;;;;1,0;;;;;;2,0;;;1,0;;;1,0;3,0;;2,0;;;;;;;;;1,0;;;;;1,0;4,0;;;1,0;;3,0;7,0;8,0;;;1,0;;;;;;;;;;;6,0;;;1,0;;;;;;;;;;;;;;2,0;;;;;;8,0;4,0;;;;;;;;;;;;;2,0;;;;;;1,0;;3,0;;;;;;;;;;;;;1,0;;;;;;3,0;;;;2,0;;;;;;;;;18,0;;;;;;;;2,0;;;;;;;;;;;;;;;;19,0;;1,0;;;;;;;;1,0;;;;1,0;;;;;;;;;;;;;;;;;;;3,0;;;;;;;;;;;;1,0;;;;;;;;;;;;;17,0;;;;;;;;;;;;;;;;2,0;;4,0;;;;;;7,0;2,0;;;;;;;;;;;;;;;;;;;;;2,0;;;;;2,0;;;;2,0;;;;;;;;;;;;;;;2,0;;;;;;;;;;;;;;;;;;;;;;;;;;;;;;;;;;;;;;;;;;;;;;;;;;;;;;;;;;;;;1,0;;;;;;;;5,0;;;;15,0;;;;;;;;;;;;;;;;;;;;;;3,0;
player;;;;;7,0;;;9,0;;;;;;;;;;;;2,0;;10,0;3,0;;;;;5,0;;7,0;2,0;2,0;7,0;;6,0;1,0;1,0;10,0;;8,0;4,0;;1,0;3,0;;;;;;;;6,0;;4,0;6,0;10,0;2,0;;9,0;;;;7,0;;;;37,0;;;43,0;;;;;;;;53,0;44,0;;;;5,0;;;;;;;5,0;1,0;;;2,0;;5,0;;4,0;;;2,0;17,0;;;3,0;;;;;;;;;;;;;;;6,0;;;;;;;3,0;;;1,0;;;;;;3,0;2,0;;;;;;;;;1,0;;;;;;;;;;;;3,0;1,0;;;;;;;;;;;;;;;1,0;1,0;1,0;;;;;1,0;;;;;1,0;;8,0;;;;;;;;;;;;;;;;2,0;;1,0;;;;;;;;;;1,0;;;2,0;;;;;1,0;;;;;3,0;;;;;;;;;;2,0;;;;;;;;;;;;;;;;;;;;;;;;;;;;3,0;;;;;;3,0;2,0;;1,0;;;;;1,0;;;;;4,0;10,0;5,0;17,0;;;;;11,0;;;;;;;6,0;;7,0;1,0;;;;19,0;;;;;;;;;;;;;;;;;;;;;;;2,0;;;;;;;;6,0;;;;;;;;;;;3,0;1,0;1,0;1,0;;;;;;;;;;;;;1,0;;;;;;;;;3,0;;;;;;;;;1,0;;;;;;;;1,0;;;;;;4,0;;;1,0;;;;;;44,0;;2,0;;;;;;;;;;18,0;;;;;2,0;;1,0;;;;;;;;;1,0;;;;;;;;10,0;;;7,0;;;3,0;;;;1,0;1,0;;;;;5,0;3,0;;;;;;;;;;;;3,0;;;;;;;;;;;;;;;15,0;;;;;;;;17,0;24,0;;;;;;;;;;;;;;;;;;;1,0;;;1,0;;;;;;;1,0;;4,0;;;1,0;;;;;;;;3,0;;;;;;;;;;;;;;11,0;;;;;;;;;;2,0;;;;;;;;;;;;;;;;;;;;;;;;;;;;;;;;;;;;;;;;;;;;;;;;;;;;;;;;;;;;;;;;;;;;;;;;;;;;;;;;;;;;;;;;;;;1,0;;;;;;;;2,0;;;;;;;;;5,0;;;;;;;;;;;;;;;;;;;;;;;;;;;;;;;;;;;;;;;;1,0;;;;;;;;;;;;;;;;;;;;;;;;;;;;;;;;;;;;;;;;;;;;;;3,0;;;;;;;;;;;;;;;;;;;;4,0;;;;2,0;;;;1,0;;;;;;;;;;164,0;;;;;;;23,0;;;;;;;;1,0;;;4,0;3,0;79,0;;;;;;;;;;;;;;;;;1,0;;;;;;;;;;;;1,0;;;;;;;;;;;;;;;;;;;;;;;;2,0;;;;;;;;;;;;;;;;;;;;;;;;;;;;;;;;;;;;;4,0;;1,0;;;;;;;;;;;;;;;;;;;;;;;;;;;;;1,0;;;;;;;;;;;;;;;;;;;;;;;;;3,0;;;;;;;;;;;;;;;;;;;;;;;2,0;;;;;;5,0;;;;;;;;;;;
plug;;;;;4,0;;;1,0;;;;;;;;;;;;;;;;;;;;;1,0;;;;2,0;;;;1,0;;;;;;;;;;1,0;;2,0;;;;;;;10,0;7,0;;;8,0;;;10,0;;;2,0;;;;;;;;1,0;;;;1,0;;;;;;;;;4,0;;;;11,0;;;;;1,0;;;;2,0;;3,0;;;;;;7,0;;;;;;1,0;;;;;;;1,0;;;;;;4,0;5,0;;2,0;;;;;;;;;;;;;;2,0;;;6,0;;;;;;;1,0;2,0;;6,0;;;;;;;;;;;2,0;;;9,0;;4,0;5,0;;;2,0;;;;;;;;;;1,0;;;1,0;;;;4,0;;;;;;1,0;;;;;;;;;2,0;2,0;;;;;;;;;;;1,0;3,0;;;2,0;;;;;;;;;;;;;;;;;;;;2,0;2,0;;9,0;;;;;;12,0;2,0;;;;;;;1,0;;;2,0;;2,0;;;;;;;;1,0;;;;;;;;;;3,0;;;;;3,0;;;;;;;;;;;;;;;;;;1,0;;1,0;;;;;;;;;2,0;1,0;;;;;;;;;;;;;;;;;;;;;;;;;;;;;;;2,0;;;;;;;;;;;;2,0;;;;;;;;;;;;;;;;;;;;;;;;;;;;;;1,0;;;;;;;;;;;;;;;;;;;;;;;;;;;;;;;;;11,0;;;;;;;;;;;;;11,0;1,0;;;;;6,0;;;;;;;;;1,0;;;;;;;;;;;;;2,0;;;;;;;;1,0;;;;;;;;;;;;;;;;;;;1,0;1,0;;;;;;;;;;;;;;;;;;;;;5,0;9,0;;;;;;;;;;;;;;;;;;;;;2,0;;;;;;1,0;;;;;;;;;1,0;;;;;;;;;;;;1,0;;;;;;;;;1,0;;;;;;;;;;;;5,0;12,0;;;;;;;;;1,0;;;;;;;;;;;;;;;;2,0;;;;;3,0;;;;;;;;;;;;;;1,0;3,0;1,0;;;;;;;;2,0;;;;;;;;;;;;;;;;;2,0;;;;;;;;;;2,0;;;;;;;;;;;;;;;;;;;;;;;;6,0;;;;;;;;;;;;;;;;;;;;;;;;;;;;;;;;;;;;;;;;;;;;;;;;;;;;;;;;;;;;;;;;;;;;;;;;;;;;;;;;;;;;;;;2,0;;;;;;;;;;;;;;;;;;;;;;;;;;;;;;;;;;;;;;;;;;;;;;;;;;;;;;;;;;;;;;;;;;;;;;;;;;;;;;;;;;;;3,0;;;;;;;;;;;;;;;;;;;4,0;;;;;;;;;;;;;;;;;;;;;;;;;;;;;;;;;;;;;;;;;;;;;;;;;;;;;;;;;;;;;;;;;;;;;;;;;;;;;;;;;;;;;;;;;;;;;;;;;;;;;;;;;;;;;;;;;;;;;;
polarization;;;;;7,0;;2,0;8,0;2,0;2,0;;;;;;;;;2,0;;;4,0;;;;;;3,0;8,0;;;2,0;8,0;1,0;;;;4,0;1,0;;;;;16,0;;;;;;;3,0;;;;;23,0;3,0;;;7,0;24,0;;9,0;;;;;;;;5,0;;;;;;1,0;;2,0;;;;3,0;;21,0;1,0;5,0;;;;4,0;;;;;;;;;;2,0;5,0;;;;;;2,0;;4,0;4,0;2,0;2,0;1,0;1,0;;;;;2,0;;;;;;;;;1,0;;3,0;;;;;5,0;2,0;;1,0;;;;;;17,0;;;5,0;;;;;1,0;;;;10,0;;5,0;3,0;;;;;;;;47,0;;;2,0;;3,0;;;;1,0;;;;;;3,0;;;8,0;8,0;8,0;;1,0;;;;;;1,0;;;;2,0;;1,0;;;;;;;3,0;;;;;;;;2,0;1,0;;;;;;;;;;;;;;;;;;14,0;1,0;;;;;;2,0;;;1,0;;;;;;;;;;;;;;;;;1,0;;;;;;;;;1,0;;;;;;;;;;;;;;;;2,0;;1,0;1,0;16,0;;1,0;;8,0;;;;;;;;;;;;;;;;2,0;;;;;;;;;;;;;;4,0;;;;;;2,0;;;;;;;;;1,0;2,0;;;;;;;;;;;;;;;;;;;;;;;;;;;;;;;;;;;;;;2,0;;;;;;;2,0;;;5,0;;;;;;;;;;;;;;;6,0;;;;;;;;;;;;;;2,0;;;;;1,0;;;1,0;;;;;;;;;;;;;;;;;;;;2,0;;;;;;3,0;6,0;;;;;;;;;;;;;;;3,0;;;1,0;;;;;;;;;;;;;;;;;;1,0;;;;;1,0;;;;;;;;;;5,0;;;;;;;;;;;;;;;;;;;;;;;;;;;;;;;;;;;;;;;;;;;;;;;;;;;;;;;;;;;;;;2,0;;;;;;;;;;;;;;;;2,0;;;;;;;;;;;10,0;;;;;;;;;;;;;;;;;;;;;;;1,0;;;;;;;13,0;;;;;;;;;;;;;4,0;;;;;;;;;;;;;;;;;;;;;;9,0;;;;;;;1,0;;;;;;;;;;;;;;;;;;;;;;;;;;;;;;;;;;;;;;;;;;;;1,0;;;;;;2,0;;;;;;;;;;;;;;;;;;1,0;;;;;;;;;;1,0;;;;;;;;;;;;1,0;;1,0;;;;3,0;;;;;;;;;;;;;;;;;;;;;;;;;;;;;;;;;;;;;;;;;;;5,0;;;;;;;;;;;;;;;;;;;;;;;;;;2,0;2,0;1,0;;;;;;;;;;;;;;;;;;;;;;;;;;;;;;;;;;;;;;;;;;;;;;;;17,0;;;;;;;;;;;;;;;;;;;;;;;;;;;;;;;;;;;;;;;;;;;;;;;2,0;1,0;;;;;;;;;;;;;;;;;;;;;;;;;;;;;;;;;;;;;;;;;;;;;;;;;;;;;;;;;4,0;;;;;;;;;;;;;;
pole;;;;;7,0;;7,0;7,0;;;3,0;;;;;;;;;;;;;;;;2,0;;;;;;5,0;;;;;8,0;;;;;3,0;7,0;;;;;;;;5,0;;;;;7,0;;;4,0;;;2,0;;;3,0;;;;;;;;20,0;;;;;13,0;2,0;;;;;;;;;3,0;;;2,0;;2,0;;4,0;;;;;27,0;;;;;;;1,0;;;;15,0;;;1,0;1,0;;;1,0;14,0;;;;;;;2,0;16,0;;1,0;5,0;;;;;1,0;16,0;;;;;;;26,0;;1,0;5,0;1,0;;;;1,0;2,0;;;3,0;10,0;2,0;;;;;1,0;3,0;;;;2,0;;;6,0;;11,0;1,0;1,0;2,0;21,0;1,0;;;1,0;;4,0;;;;1,0;6,0;;28,0;;20,0;;3,0;;;;;6,0;3,0;2,0;5,0;;10,0;;;;;1,0;3,0;;;;;;;;;;1,0;1,0;;;;1,0;;;;;2,0;;;7,0;11,0;;;;;2,0;;5,0;;;;;;;;8,0;11,0;;;;23,0;;;3,0;2,0;;;;15,0;2,0;7,0;5,0;;2,0;4,0;;;;;;4,0;6,0;;;;;11,0;;45,0;;4,0;;;1,0;;;21,0;;;;;3,0;;;1,0;;;;5,0;;;;11,0;;;;1,0;;3,0;;;4,0;;1,0;21,0;1,0;;;;;6,0;;2,0;5,0;;1,0;;;;;;;;;;;;;;;;;;;;;;2,0;;;;;;;;;;;;;;;;;;;;;;;;;;1,0;;;1,0;;;;;;;;9,0;;;;1,0;2,0;;5,0;;;;;;;;;;;;;;2,0;;7,0;1,0;;;;;;;;;6,0;;;;1,0;;;;;;;;;;;;;;;;1,0;;;;;;;;;;;;3,0;;;;;;;;;;;;;;3,0;;;;;;;;;;;;;;;;;;;9,0;;;;;;;;1,0;;;;;;;;;;;;;;4,0;;;1,0;;;;;;1,0;;;;;1,0;;;;;;;;;;;;;;;;;;;;;;;;;;;;;;;2,0;;;;;;;;;;;;;;;;;;;;;;;;3,0;;;;;;;;;;2,0;;;;;;;;;;;;;;;;;;;;;;;;;;;;;;;;;;;;;2,0;;;;;;;;;;23,0;;;;4,0;;;;;;;;;;;;;;;;;;;;;;;;;;;;;;;;3,0;;;;;;;;;;;;;;;;;;;;;;;;;;2,0;;;;;;;;;;;;;;1,0;;;;;;;;;;;;;;;;;;;;;;;;;;;;;;;;;;;;;;;;;;;;;;;;;;;;;;;;;;;;;;;;;;;;;1,0;;;;;;;;;;;;;;;;;;;;;;;;;;;;;;;;;;;;2,0;;;;;;;;;;;;;1,0;;;;;;;;;;;;;;;;;;;;;;13,0;;;;;;;;;;;;4,0;2,0;;;;;;;;;;;;;;;;;;;;;;8,0;;;;;;;;;;;;;;;;;;;;;;2,0;;;;;;;;;;;;;;;;;;;;;;;;;;;;;;;;5,0;;;;;;;;;5,0;;;;;;;;;;;;;;;;;;;;;;;;;;;;;;;;;;;;;;;1,0;;;;;;;;;;;;;
port;;;;;26,0;;1,0;5,0;;1,0;1,0;;;;1,0;2,0;;;;5,0;;23,0;;;;;;30,0;;1,0;;;32,0;;5,0;;;1,0;;13,0;;;;;;;;;;;2,0;;;5,0;;33,0;19,0;;;13,0;;;18,0;;;2,0;;;;2,0;1,0;;;;;;;;4,0;1,0;;13,0;7,0;;;;;;;11,0;14,0;;;13,0;;;1,0;17,0;8,0;;5,0;20,0;;7,0;;3,0;;21,0;;;9,0;2,0;;3,0;1,0;;;1,0;1,0;1,0;;;;3,0;;;20,0;;;10,0;9,0;;;1,0;;;8,0;1,0;;;4,0;;6,0;;;;6,0;1,0;;;;;1,0;2,0;5,0;;;12,0;6,0;3,0;;;5,0;2,0;;;;1,0;1,0;;;;3,0;7,0;;8,0;4,0;27,0;;;8,0;;;;;;2,0;37,0;;3,0;;;;20,0;;;;;;1,0;;;;4,0;;;;;5,0;;;;;;;3,0;10,0;5,0;;;2,0;2,0;;;1,0;;;;;;;;;;;;;;1,0;;3,0;;;1,0;7,0;10,0;4,0;9,0;;;;;;30,0;;;;8,0;;;;;;1,0;1,0;;8,0;;;;;;;;1,0;30,0;;;;3,0;1,0;;;;5,0;;;;1,0;2,0;1,0;;;;;;;;;;10,0;;;;;;;;26,0;;;;;;;;;;;4,0;;;;;;2,0;;;6,0;;3,0;;;;;;;1,0;;;;;;1,0;;;;;12,0;;1,0;1,0;;;;;;;1,0;;;;;;;;;;;;;;;3,0;1,0;3,0;;;;2,0;1,0;;;1,0;;;3,0;;1,0;10,0;;3,0;1,0;;;9,0;;4,0;;;;;;;;;;;;1,0;;2,0;;1,0;7,0;;1,0;;11,0;4,0;;;;2,0;2,0;3,0;;7,0;1,0;;1,0;;;;2,0;;;;3,0;2,0;;;1,0;;1,0;19,0;;1,0;;;;;3,0;1,0;;1,0;;;;;;;;;;4,0;1,0;1,0;;;;;;;;2,0;1,0;1,0;;;;;11,0;;;1,0;;;1,0;6,0;;8,0;;;17,0;21,0;;2,0;;;34,0;21,0;;;;;8,0;;2,0;;2,0;1,0;;;38,0;20,0;10,0;;;;;2,0;3,0;1,0;;;4,0;;;;;;;4,0;;;;2,0;2,0;;;;;;;;1,0;1,0;7,0;;;4,0;;;7,0;;;;;;;;;;1,0;;;;;1,0;;3,0;;8,0;;;;;;3,0;;;;;;14,0;;;;;10,0;;;;1,0;2,0;;2,0;7,0;;;;;;;4,0;2,0;;;;;;;;;;2,0;2,0;;;;;;;;;;;;1,0;;;;1,0;;;4,0;;;;;;;;;;;;;;;;;;;6,0;;;1,0;;;;1,0;;;;;;;;;;;;;;;;;;2,0;1,0;;1,0;;;;;;;;;;;;;4,0;;;;;;;;;;;;;1,0;;;;1,0;;;;;;;;;;;;;;;;1,0;2,0;1,0;;;;;;;;1,0;;;;1,0;;;;;;;;;;7,0;;;;;;1,0;;;;;;;;;;;;;6,0;;;2,0;;1,0;;;;;;;;;;;;2,0;;;;;4,0;;;;;;;;2,0;;;;;;;;;;;2,0;;1,0;;;;;;;;13,0;;;;;;;;;;;;;;;1,0;;;;;2,0;;;;;;;;;;;;;3,0;1,0;;;;;;;;;;;;;;;;;;;;;;;;;;;;;;;;;;;;;;;;;;;2,0;;;;;;;;;;;;;;;;;;;;;;;;35,0;;;;;;;;;;;;;;;;;;;;1,0;;;;;;;;5,0;;;;;;;;;;;;;;;;;;1,0;;;;;1,0;2,0;;2,0;;;;;;;;;3,0;;;;;;;;;;;;
pose;;;;;13,0;;;30,0;;14,0;;;;;1,0;;;;2,0;2,0;;7,0;;;;;;6,0;10,0;21,0;;61,0;8,0;;;1,0;;;;4,0;;;;;;;;;;;;22,0;;;;46,0;3,0;;;;;;43,0;;5,0;2,0;3,0;;;1,0;;1,0;5,0;;;;;25,0;7,0;;;;;;;;;6,0;1,0;14,0;;;;3,0;;;;4,0;11,0;;;8,0;;12,0;1,0;;;4,0;;;9,0;1,0;;;;;;;;;;;;;;;2,0;;;;;1,0;;;;1,0;;;;;;;;1,0;;;;7,0;;;;;;;;;;;;;;;;;;;;;;;;;9,0;;;;;47,0;;;;;;;;2,0;;18,0;;2,0;;;;11,0;;;;;1,0;;;;;;;;;1,0;;;;;;;;1,0;;;;;;;;;;;;;;;;;;;;;;;;;;;;;;;;;;;;;;;;;;;;;;;;;;;;;;;;;;;;;;;3,0;;;;;;;7,0;;5,0;;;;;1,0;;;;;;;;;1,0;2,0;2,0;;;;13,0;;;;1,0;;;;;;;;;;2,0;;;;2,0;;;;1,0;8,0;;;;;;;;;;;1,0;;;;;;;;;;;2,0;;;;;;;;131,0;;;;1,0;;3,0;;;;;;;9,0;1,0;1,0;;;;8,0;;;;;;;;;;;;2,0;;;;;1,0;;;;11,0;;;;;;;;;;;;;1,0;;;9,0;;8,0;;1,0;;;;;;4,0;;;9,0;;;;;;;;;;;;12,0;;;8,0;;;;;;;7,0;;;;;;;;;;;;;;;;;2,0;;;;;;;;;;;;;;;;;;;;4,0;;;;;;3,0;;;;;;;;;;;;;;;;;;;5,0;;;;;1,0;;;;;;;;;;;;;3,0;;;;;;;;;;;;;;;;;;;;;;;;;9,0;;;;;20,0;;;;;25,0;;;;;;;;;;;;;;1,0;;;;;;;;;1,0;;;;;;;10,0;;;;;;;;1,0;;;;10,0;;;;;;;;;;;;;;;;;;;;;;;;;;;;;;;;;;;;;;;;;;1,0;;;;;;;;;;1,0;;;;;;;;;;;;;;;;;;;;;;;;;;;;;;;;;;1,0;;;;;;;;;;;;;;;2,0;;9,0;3,0;3,0;;;;;;;;1,0;;;;;;;;;;;;;;;;;1,0;;;;;;;;;;;;;;;;;;1,0;;;;;;1,0;1,0;;;;;;;;;;;;;;5,0;;;;;;;;;;;;;;;;;;;;;;;;;;;;;;;;;;;;2,0;;;;;;;;;;;;;;;;;;1,0;;;;;;;;;;;;;;;;;;;;;;;;;;;;1,0;;;2,0;;;;;;;;;;;;;2,0;;;;;;;;;;;;;;;;;;;;;;;;;;;;;;;;;;;;13,0;;;;;;;;;;2,0;;32,0;;;;;;;;;;;;;;;;;;;;2,0;;;;;;;;;;;;;;;;;;;;;;;;;8,0;;;;;;;;;1,0;;;;;;1,0;;;;;;;;;;;;;;;;
positional;;;;;13,0;;6,0;47,0;8,0;7,0;20,0;;14,0;6,0;36,0;;;;41,0;2,0;3,0;5,0;8,0;29,0;41,0;;;55,0;9,0;29,0;6,0;43,0;4,0;85,0;;;;5,0;;2,0;15,0;;;;2,0;1,0;;;7,0;;;15,0;;;;84,0;25,0;5,0;;9,0;;2,0;21,0;;;1,0;7,0;;4,0;;7,0;2,0;;;;;;23,0;33,0;;;2,0;10,0;4,0;1,0;;;6,0;5,0;14,0;4,0;75,0;;1,0;1,0;3,0;;;1,0;1,0;7,0;11,0;;5,0;1,0;;;45,0;;;;3,0;;;2,0;;;;2,0;;;;7,0;;;;3,0;;;3,0;;1,0;;;5,0;2,0;7,0;;;;;;;5,0;1,0;;22,0;11,0;5,0;;;;;;3,0;4,0;;;;3,0;1,0;;;;3,0;;3,0;6,0;2,0;;2,0;8,0;2,0;;3,0;;;5,0;;;;2,0;;;;3,0;;27,0;;;;;;2,0;;;;;3,0;;;2,0;;;;19,0;;;3,0;;;;;;4,0;;;;;;;1,0;;;2,0;;;;;;;;;1,0;1,0;3,0;;2,0;33,0;;1,0;;;;;;;1,0;;;;;;;;;;1,0;;;;7,0;2,0;;;;7,0;;;;;;;;;;;;;1,0;;;;2,0;;4,0;;38,0;;1,0;;;2,0;5,0;;;;;;;;;14,0;;;;;;;;7,0;;;;;;;;;;7,0;;;;;;;;;;1,0;;;;;;;2,0;;5,0;;3,0;;13,0;;;2,0;;6,0;2,0;;4,0;;;;;5,0;1,0;1,0;;2,0;;1,0;;13,0;27,0;;;;;3,0;;1,0;2,0;3,0;2,0;6,0;;;;5,0;1,0;;2,0;;;;1,0;1,0;10,0;;6,0;;1,0;2,0;;;4,0;;;2,0;;;;12,0;6,0;;2,0;12,0;;1,0;1,0;;1,0;;2,0;10,0;;;2,0;14,0;;;;;;;;;1,0;1,0;3,0;;;1,0;;;;;;;;;;;;;;1,0;2,0;;1,0;1,0;;;;;;1,0;;;;;;;;;;39,0;;;3,0;;;2,0;;;;6,0;1,0;2,0;1,0;3,0;;1,0;;;;;;;;;;1,0;4,0;;;;;;;;;;2,0;;;;;;;;5,0;;;;;4,0;;;;;;;;1,0;;;;;;;;;1,0;;;;;;;;;;;;2,0;;;;;;;1,0;;7,0;;;;22,0;;;;;;12,0;;;;;;;;;;;;;4,0;1,0;;1,0;1,0;;;;;;;1,0;;;;;;;;;;;;2,0;;;;;;;;;;;4,0;;;;;;;;;;;;;;;;;;;;7,0;;;;22,0;;;;;;;;;;;;;10,0;;;;;;;;28,0;;5,0;;;;;;1,0;;;9,0;;;2,0;;2,0;;;;;;;;6,0;;1,0;;;;;;;;21,0;;;;;;3,0;;;;;;4,0;;;;;2,0;;;;;;;;;;;;;;;;;;;;;;;5,0;;;;;;;;;;;;1,0;;101,0;;;;;;;2,0;;;1,0;;;;;;;;4,0;;;;;;2,0;;;1,0;;3,0;;6,0;;;;;;;;;1,0;;;;;1,0;;;;;;;;;;2,0;;;;;4,0;;;;2,0;;;;;;;;;;;;;;;;;3,0;;2,0;2,0;;;;;;;;;;;;;;;;;;;;;;2,0;2,0;;;1,0;;;;;;;;;;;;;;;;;;;;;;;;;;;;;;;;;;;;;5,0;;;;;3,0;;;;;;;;;;;7,0;;;;2,0;;;;;;;;;;;;;;;;;;;;;;;;;;;;;;;;;;;;;;;;;;;;;;;;;;1,0;;;;;8,0;;;3,0;;;;;26,0;;;;;;;;;;;;;;;;1,0;;;;;;;
posture;;;;;2,0;;1,0;5,0;5,0;;1,0;;;;;;;;;;;32,0;;1,0;;;;;;;;7,0;1,0;;;;;8,0;;1,0;;;;;;;;;;;1,0;;;;;;2,0;;;3,0;;;1,0;;;;1,0;;;35,0;;;;;;;;;5,0;;;;4,0;;;;;;;3,0;;;4,0;;;;;3,0;2,0;;2,0;;;;;;;19,0;;;;;;;;;;;;;;;16,0;;;;1,0;2,0;;;;;;;;;;;;;;;;;;;;1,0;;;;;;;;;3,0;;;3,0;;;;;;;;;;;1,0;;;7,0;;;;;;;;;;;;;2,0;9,0;;;;;;4,0;;;;;2,0;;;;;;;;;;;1,0;;;;;;2,0;;;;;;;;;;;;;;;;;;;;;;;1,0;;;;;;;;;;;;;;;;;;;1,0;;;;;;;;;;;;;;;;;;;;;;;;;;;;;;1,0;;;;;;;;;;;;;;;4,0;;;;;6,0;;;;;;;;;;;;;4,0;;1,0;;;;;;;;;;;;;;;;;;;;;;;;;;;23,0;;;;;;;;;;;1,0;;;;;;;;;;;;;;;;;;;3,0;;;;;;;;;;;;;;;;;;2,0;;;3,0;;;;;;59,0;;;;;;;;;;;;4,0;;;;;;;;;;;;;;;;;;;;;;;;;;;;;;;;;;;;;;;;;;;;;;;;;;;;;;;2,0;;;;;;;;;;;;3,0;;;;1,0;;;;1,0;;;;;;;;;1,0;;;;;;;;;;;;;;;;;;;;;;;;;;;;;;;;;;;;;;;;;;;;;;;;;;;;;;;;;;;;;;;;;;;;;;;;;;;;;;;;;;;;;;;;;;;1,0;;;;;;;;;;;;;;;;;;;;;;;;;;;;;;;;;;;;;;;;;;;;;;;;;;;;;;;;;;;;;;;;;;;;;;;;;;;;;;;;;;;;;;;;;;;;;;;;;;;;;;;;1,0;;;;;;;;;;;;;;;;;;;;;;;;;;;;;;;;;;;;;;;;;;;;;;;;;;;;;;;;;;;;;;;;;;;;;;;;;;;;;;;;;;;1,0;;;;;;1,0;;;;;;;2,0;2,0;;;;;;1,0;;;;;;;;;;;;;;;;;;;;;;;;;;;;;;;;;;;;;;;;;;;;;;;;;;;;;;;;1,0;;;;;;;;;;;;;;;;;;;;;;;;;;;;;;;;;;;;;;;;;;;;;;;;;;;;;;;;;;;;;;;;;;;;;;;;;;;;;;;;;;;;;;;;;;;;;;;;;;;;;;;;;;;;;;;;;;;;;;;;;;;;;;;;;;;;;;;;;;;;;;;
press;;;;;5,0;;3,0;1,0;;2,0;2,0;;;;;;;;3,0;;1,0;6,0;;;1,0;;1,0;2,0;;1,0;;3,0;9,0;;9,0;;;14,0;;5,0;2,0;;2,0;8,0;;;;;;;;7,0;;3,0;;11,0;10,0;;3,0;12,0;;;3,0;;;;;;;22,0;3,0;;;10,0;3,0;;;;16,0;1,0;1,0;;2,0;;;;2,0;;1,0;;2,0;;5,0;9,0;;1,0;;;;2,0;21,0;1,0;;;;1,0;;8,0;;;1,0;;;1,0;3,0;;;;4,0;12,0;;;1,0;2,0;;;8,0;3,0;;3,0;7,0;;;;;;2,0;5,0;;2,0;;;;1,0;;8,0;8,0;3,0;;1,0;;;2,0;;8,0;2,0;;;2,0;3,0;;;;;;1,0;;3,0;1,0;;62,0;2,0;2,0;4,0;2,0;;6,0;;;;1,0;;;;;;26,0;5,0;;60,0;;1,0;;3,0;;;;2,0;7,0;8,0;1,0;1,0;;1,0;;2,0;;;10,0;5,0;;1,0;;;;3,0;;;2,0;;1,0;;;;;;1,0;;;;;4,0;;;1,0;;4,0;1,0;;1,0;4,0;;;2,0;;2,0;;;1,0;;;;;4,0;2,0;;;;;;;1,0;5,0;13,0;3,0;;2,0;;;3,0;;7,0;;5,0;1,0;;;5,0;;5,0;12,0;;;7,0;1,0;;1,0;1,0;;2,0;;2,0;;;;;;1,0;;;;;4,0;2,0;1,0;;;;;1,0;;2,0;;3,0;6,0;;;;;3,0;;1,0;8,0;5,0;;;;17,0;;;6,0;;;;;;;;;;;;;;;;;1,0;;1,0;;;;;;;;;;;;;;;;2,0;;;;;;;;1,0;;;;;;;;4,0;;2,0;;;;;;1,0;31,0;1,0;;;36,0;;1,0;;;;;;1,0;;;;;;;;;12,0;;;;;;;9,0;;;;;1,0;16,0;;;;;;1,0;;;;;4,0;;;;;45,0;;;;;1,0;;;;;;1,0;;1,0;;;;;;;;;3,0;;;;3,0;;1,0;;;1,0;;;;;2,0;;;;;;;;;9,0;;;;4,0;;11,0;;5,0;1,0;2,0;;;;;;;;;3,0;;;3,0;;;1,0;;;;1,0;;4,0;;;;;;;1,0;;;;;;1,0;;;;;2,0;;1,0;1,0;;;;;;1,0;1,0;;1,0;;;;;;;;;1,0;;;;2,0;;;;;;;;;;;;;;;;;2,0;;;;;;2,0;;;2,0;;;;;;;;;;;;;;;;1,0;;;;;;;;;;5,0;;;;;;;;;;;;1,0;;;;;;;;;;;;11,0;;;;;1,0;;;;3,0;;;;;;;;;1,0;;;;1,0;;;;;;;;;3,0;;;;;;;;;;;;;;;;;2,0;;1,0;;3,0;;;;;;;;;;;;;;;;;;;;;;;;;;;1,0;;;3,0;;;;;;;;;;;;;;;;2,0;5,0;;;;;;;;;;;;;;;;;;;;;;;;;;;;;;;;;;;7,0;;;;;;;;;3,0;;1,0;;;;;;;1,0;;;;;;;;;;2,0;;1,0;;;;;;;;;;;;;;;;1,0;;;;;;;;;;;;;;;;;;;;3,0;;;7,0;;;;;;;;;;;;;;;;;;;;2,0;;;;15,0;;;;1,0;;;1,0;;;;;;;;;;;;2,0;;1,0;;;;;;;;;;;;2,0;;;;;;1,0;;;;;;;;;;;;;;;;;;;;;1,0;;;;;;;;;;;;;;;;;;;;;;;;;;;;;;3,0;4,0;;;;;;;;;;;;;;;;;;;;;;;;;;;;;;;;;;;;;;;;;;;;;;
pressure;;;;;4,0;;;1,0;;;;;;;;;;;4,0;;;1,0;;;;;;;;;1,0;;;1,0;;;;;;3,0;;;11,0;4,0;;;;;;;;21,0;;;;1,0;2,0;;;3,0;;;;;;;;;;;3,0;3,0;;;;;;;2,0;2,0;;;;;;;3,0;;;;5,0;;;;;1,0;;;;;2,0;2,0;;;;;;5,0;;;1,0;;;3,0;;;;;;;;;1,0;;;;11,0;1,0;;2,0;;;;2,0;;;;1,0;;;;;1,0;1,0;1,0;;;;;;;1,0;1,0;;;;1,0;4,0;;;;;3,0;1,0;;;;;;;28,0;;;;;;;;1,0;;4,0;;;;;;;1,0;;5,0;;;;1,0;;;;2,0;;;;;;3,0;;;;;1,0;3,0;;;;;;;;;;;;;;;;;;;;;;;9,0;;1,0;2,0;;9,0;;;3,0;;;;;;;;;;;;;;;;;1,0;;;;;;;;;2,0;;;;7,0;1,0;;1,0;;;;;;;6,0;;;3,0;;;2,0;;;;1,0;;;;;;;;;;;;;1,0;;;;;;;;1,0;;;;;;;;5,0;;;;;;7,0;;4,0;1,0;;2,0;;1,0;;;;;;;;;;;;;;;;;3,0;2,0;;;;;1,0;;;;;;;;1,0;;;;;;;;;;2,0;;;;;;;;;;;;;;;;;2,0;;;;;;;;;;;;;1,0;;;;;;1,0;;1,0;;;;1,0;;;;;;;;;;;;1,0;;;;;;;;;;;;;2,0;;;;;;;;;;;;;;;;;;;;;;;;;;;;;;;;;;;;1,0;;;;;;;;;;;;;1,0;1,0;1,0;3,0;;;;;;1,0;;;;;;;;;;;;5,0;1,0;;;;;;;;;;;;;;;;;;1,0;;;;;;;;;;;;;;;2,0;;;;;;;1,0;;;;;;;1,0;;;;;;;;1,0;;;;;;;;;;;;;;;;;;;;2,0;;;;;;;;;;;;;;;;;;;;;;;;;;;;;;;;;;;;;;;;;;;;;;;;;1,0;;;;;2,0;;;4,0;;;;;1,0;;;;;;;;;;;;;1,0;;;;3,0;;;;;;;;;;;;1,0;;;;;;;;;;;;;;;;;;;;;;;;;;;1,0;;;;;;;;;;;;;;;;;;;;;;;;1,0;;;;;;;;;;;;;;;;;;;;;;;;;;;;;;;;;;;;;;;;;;;;;1,0;;;;1,0;;;;;;;;;;;;;;;;;;;;;;3,0;;;;;;;;;;;;;;;;;3,0;;;;;;1,0;;;;1,0;3,0;;;;;;;;;;;;;4,0;;;;;;;;;;3,0;;;;;;;;;;2,0;;;;;;;;;;;;;;1,0;;;;;;;;;;;;;;;;;;;;;;;;;;;;;;;;;;;;;;;;;;;;;;2,0;;;;;;;;;;;;;;;;;;;;;;;;;;;;;;1,0;1,0;1,0;;;;;;;;;;;;;;;;;;;;;;;;;;;;;;;;;;;;;;;;;;;;;;;
preview;;;;;1,0;;;10,0;;12,0;;;;;8,0;9,0;;1,0;;;2,0;8,0;;;;;;80,0;;11,0;2,0;20,0;25,0;;63,0;;;;;62,0;;;3,0;3,0;;;;;1,0;;1,0;3,0;;;;234,0;9,0;;;;;;25,0;;;;3,0;;;17,0;6,0;1,0;;;;;;;9,0;;;6,0;8,0;2,0;;;23,0;;2,0;18,0;8,0;;;12,0;12,0;8,0;;3,0;14,0;;;9,0;;;;;;37,0;;;;3,0;;;;;;;;;;;;1,0;;4,0;5,0;;;2,0;;;;;;;;;;;;;;35,0;1,0;;1,0;53,0;;;3,0;;;;;;;;15,0;4,0;;;;;;;4,0;;;;21,0;;5,0;;;1,0;;9,0;;;;;;2,0;;;;17,0;;2,0;;;;;;;;;;;;3,0;;;;2,0;;;;2,0;;;;;;1,0;;;;;;;;;;;19,0;;;;;;;;1,0;;;;4,0;2,0;;;;;;3,0;;;;;;;;;;;;4,0;2,0;;;1,0;;;;;;;;;;;;;;;;;;1,0;1,0;;;1,0;;;1,0;15,0;2,0;;;;;;;;;11,0;;;2,0;;5,0;;;;;1,0;;;;18,0;;;;;;;;;;;;;;1,0;;;1,0;;16,0;;;;;;;;;;;;;;;1,0;;1,0;;;;;;;;;;;;1,0;;;;;;;1,0;;;;;;2,0;;1,0;3,0;;;;;2,0;1,0;1,0;1,0;;2,0;;;;10,0;;7,0;;;4,0;;3,0;;3,0;;3,0;;2,0;;;;;;1,0;;;;;5,0;;;2,0;;2,0;;3,0;1,0;;;72,0;3,0;;;5,0;20,0;1,0;;;2,0;;;;;;;2,0;;;;;1,0;;3,0;1,0;;;;;1,0;;;;3,0;24,0;;;;4,0;;;2,0;;1,0;;;;8,0;;;;;3,0;;;;1,0;2,0;3,0;2,0;;;32,0;1,0;;32,0;;5,0;;2,0;12,0;1,0;12,0;;;2,0;;2,0;1,0;2,0;6,0;;;;;;;;;;;;;2,0;5,0;;;;5,0;;;;;;;;;;;;;2,0;;;;;;;1,0;;;;;;;;;1,0;;;;;;;;6,0;;1,0;;;;;2,0;;;;;;;;;;;;;;;2,0;;2,0;;3,0;;;1,0;;;;;;;;;;;;;;13,0;;;1,0;;;;;;;;;;;1,0;;;;;;;;;;;;;;;;;2,0;;;;;;;;1,0;;;;;;;;;11,0;;;;;;;;;;;;;;;;;;;;;;;;;;;;;;;;2,0;5,0;;;;;;;;;;;;;;;;;;;;;;;;;;3,0;;;;;;;;2,0;;;;;;6,0;;;2,0;;;;1,0;;;;;;;;;;;;;;;;;;;;;1,0;;;;;;;;;;;;;;2,0;;;;;;;;;;;3,0;;2,0;;;;;;;;8,0;;;;;;;;1,0;;3,0;;2,0;;;;;;2,0;;;;;;;;;;;;;;;;;;;;;;;;;3,0;;;3,0;;;;;;;;;2,0;;;;;;;;;;;;;;;;;;;;2,0;;;;;2,0;;;;;;;;;;;;;;;;;;;;;;1,0;;;;;;1,0;;;;;;;;;;;;;11,0;;;;;2,0;1,0;;;;;;;;2,0;;;;5,0;;;;;14,0;3,0;;;;;;;;;;;;;;;;;;;;;;;;;;;;;;;;;;;;;;;;;;;;;;;;;;;;;;;;1,0;;;;;;;;;;;;
principal;;;;;1,0;;9,0;4,0;4,0;;;;;;;;;;;7,0;;;4,0;1,0;;;;1,0;10,0;1,0;;2,0;;;2,0;;3,0;2,0;;;16,0;;;8,0;;;;28,0;19,0;;1,0;10,0;;16,0;6,0;66,0;;1,0;24,0;55,0;;;13,0;;1,0;;;;;1,0;16,0;;;;;;;74,0;2,0;;;;6,0;2,0;;;15,0;;;1,0;38,0;;20,0;;;1,0;;;;19,0;32,0;1,0;;;;;;10,0;;;;5,0;;6,0;;;;;;;;;;;;;;;;;;;;;;;;;;;;;;8,0;;;8,0;;;;;;;;;;;;;2,0;79,0;;;;;;;62,0;;;;;1,0;;1,0;;1,0;;;;;;3,0;;;22,0;1,0;2,0;;1,0;;;;25,0;;6,0;;;;;1,0;;;38,0;;;;;1,0;;;;;;;;;;1,0;;;;;;;;;;;;;;;1,0;;52,0;;1,0;;;3,0;;;;;;;1,0;;5,0;;;;3,0;;;;36,0;;;;;;;;;7,0;;;;;4,0;;;;;;;27,0;13,0;;;;;;;;18,0;;;;;;;;2,0;;;;;;;;;;;;23,0;;;;;;;;;;;;;;;;;;;;;;;;;;;;;;;;;;6,0;;;;;;;;;;;;;;;2,0;;;;;;2,0;;1,0;;;;;;;;;;;;;;;;;;;;;;;1,0;;1,0;;;;3,0;;;;;;;;;;;2,0;;;8,0;;;1,0;;;;;;;;1,0;;;;;;;;;;1,0;;;;;;;;;;;;;;;;;;;;;;;;;;;;;;;;;;;41,0;;;;;;;;;;;;1,0;;;;;;;;;;;;;;2,0;;;;;;32,0;;;;;;;2,0;2,0;;;;11,0;;;;;;;;;;;;;;;;;;;1,0;;;;;;1,0;;;;;;;;;;;;;;;;;;;;;;;;;;;;3,0;;;;;;3,0;;;;;;;;;;;;;;;;;2,0;;;;;;;;;;15,0;1,0;1,0;;;;;;;;;;;2,0;;;;;;;;;;;;;;;;;;;;;;;;;;;;13,0;;;;;;;;;;;;;;;;;5,0;;;;;;;;;;;;;;;;;;;;;;;;;1,0;;;;;;;;;;;;;;;;;1,0;;;;;;;;;17,0;;;;;;;;;;1,0;;;;;;;;;;;;;;;;;;;;;;;;1,0;4,0;;;;;;;1,0;;;;1,0;;;;;;;;;;6,0;;;;;;;;;;;;;;;;;;;1,0;;;;;;;;;;;1,0;;;;;;;;;;;;;;;;;;;;;;;;;;;;;;;;;;;;;;;;;;;;;;;;;;;;;;;;;;;;;;;;;;;;2,0;;;;;;2,0;;;;;;;;;;;;;;;;;;;;;;;;;;;;;;;;;;;;;;;;;2,0;;;;;;;3,0;;;;;;;;;;;4,0;;;;;;;;;;;;;;;;;;;;;;;;;;;;;;;;;;;;;;1,0;1,0;;;;;;;;;;;;;;;;;;;;;;;;;;;;;;;;;1,0;5,0;;;;;
printer;;;;;13,0;;;3,0;;26,0;;2,0;;;44,0;1,0;;5,0;;8,0;1,0;15,0;;;;1,0;;83,0;;12,0;5,0;13,0;47,0;;88,0;1,0;;1,0;;16,0;;9,0;3,0;5,0;;;;;;;3,0;;1,0;;;193,0;47,0;;;5,0;;;26,0;;;;;;2,0;11,0;;2,0;4,0;1,0;;;;;3,0;6,0;;9,0;15,0;6,0;;;;;1,0;20,0;9,0;1,0;;;12,0;5,0;;5,0;20,0;;2,0;45,0;;3,0;;;1,0;42,0;;;1,0;12,0;;30,0;3,0;;;;1,0;25,0;;;;3,0;;;36,0;;;9,0;;;;;;;2,0;;;;;;41,0;;1,0;;3,0;1,0;;;;;;;2,0;;;21,0;;6,0;;;;2,0;;;;;;;;;93,0;14,0;;1,0;1,0;40,0;;;;2,0;;;;;1,0;7,0;;6,0;;;;18,0;1,0;;;;;;;2,0;;;;1,0;;1,0;4,0;20,0;;;;;;3,0;17,0;;;;;;;;;;;;;;;;;;;;;8,0;1,0;;;;;;1,0;;1,0;;;;;;;13,0;3,0;;2,0;1,0;15,0;;;;;;8,0;;3,0;;;;;;;;;20,0;;;1,0;5,0;;1,0;;4,0;;6,0;;3,0;14,0;;;;1,0;1,0;;;;;;;6,0;;4,0;;;;;;;;;;;;;7,0;;;;;;;;;;4,0;;;11,0;;;;;;;;;;;;;1,0;;3,0;;;;5,0;;1,0;;;1,0;;;;;;;;;;2,0;;5,0;;;;5,0;;;;;;5,0;25,0;;;;9,0;;;;1,0;;;;;;2,0;;1,0;;;;;4,0;;;;;;;5,0;1,0;;;;;;;2,0;;5,0;;;;;3,0;;;;;4,0;13,0;4,0;;1,0;;;;;;;;;;;;1,0;7,0;;17,0;1,0;;3,0;;;5,0;;;3,0;;;;3,0;9,0;1,0;8,0;;;1,0;;;;1,0;;;12,0;;1,0;6,0;;;;;207,0;4,0;;1,0;;;;2,0;;;;1,0;;1,0;;10,0;;;3,0;6,0;;;;1,0;1,0;;;;2,0;;;;;1,0;;;;2,0;25,0;11,0;5,0;;;;;;1,0;6,0;;;8,0;;;;;;;10,0;2,0;;;;4,0;;;;;1,0;;;;;;;1,0;26,0;;;8,0;;1,0;;;12,0;1,0;;;;;;;3,0;;;28,0;;;;;;14,0;;;;;;;;;2,0;;8,0;;;6,0;;;;;;1,0;;;;;;;1,0;;1,0;;;;;;3,0;;;;;;;2,0;;;;;2,0;;;;;3,0;;;2,0;;;1,0;;;;;;;;;1,0;;;;;2,0;;;;;;;1,0;;;;;3,0;1,0;;;;;1,0;;;;;;;;1,0;;;;;;;;;;;;;;;;;;;;;;;;;;;;;;;;;;;2,0;;;;1,0;;;;;;;;;;2,0;;;;;;;;;;;;;;;;;;;;;;;2,0;;1,0;;;;;;;;;;2,0;8,0;;;;;1,0;;;;;;4,0;;;;;2,0;;;;;;;;;;1,0;4,0;;;;;;;;17,0;;;;;;;;;;;;;;;;;;;3,0;;;;;1,0;;;;;;;2,0;;3,0;;;6,0;4,0;;;;;;;2,0;;;;;;;;;;;;;;;;;;;;;;;;;;;;;;;;1,0;18,0;6,0;;3,0;;;;;;;;;;;;;4,0;;;;;;2,0;3,0;;;;;;;;;;;;;;2,0;;1,0;;;1,0;;;;;;;;2,0;1,0;;1,0;;;;;;;;2,0;;;;3,0;;;;;;;;;;;;;;;;;3,0;;;;;;;;;;;;;;;;;;;;;;;;;;;;;;;;;2,0;;;;;;;;;;;;;
prism;;;;;5,0;3,0;14,0;;;4,0;2,0;;;1,0;2,0;3,0;2,0;;2,0;;;12,0;;;;;;1,0;1,0;1,0;2,0;;45,0;;8,0;;2,0;7,0;;3,0;1,0;;2,0;23,0;;;;;3,0;;10,0;;;16,0;3,0;53,0;24,0;;1,0;57,0;;;8,0;;;4,0;4,0;1,0;;2,0;55,0;;13,0;;;;;;30,0;5,0;;;;1,0;;11,0;3,0;;;3,0;4,0;;;;;5,0;;;;;79,0;36,0;;;;;;12,0;;;2,0;4,0;2,0;23,0;1,0;;;;;6,0;;;;;;1,0;9,0;;;1,0;1,0;;;;2,0;1,0;8,0;;;12,0;;;;17,0;1,0;;28,0;;;1,0;;;9,0;;;;4,0;;7,0;2,0;13,0;;12,0;1,0;;;;66,0;;5,0;17,0;10,0;11,0;;;4,0;;2,0;;;;1,0;7,0;;;6,0;1,0;2,0;;15,0;;;4,0;16,0;3,0;22,0;3,0;;18,0;;;5,0;;31,0;;;;;;2,0;;1,0;2,0;;2,0;1,0;1,0;;;;1,0;;;;;;;;;;;;;5,0;4,0;24,0;;;4,0;;;;2,0;;;;;4,0;;;;;;;;;24,0;2,0;;;2,0;;1,0;;1,0;;;;;;;5,0;;;;;;;;5,0;;;;1,0;;2,0;3,0;10,0;;;;;;;;;;;4,0;;1,0;;;18,0;1,0;;;;3,0;;;;;;2,0;;2,0;;;;;1,0;;;;2,0;;;;;;;;;;;;;;;;;;;1,0;;;;;1,0;;;;;;;;;;;;;14,0;;;;14,0;;;1,0;;;;;;;;;;;;4,0;;;;;;;;;;;;1,0;;8,0;;8,0;;3,0;;;;;;;;16,0;;;;2,0;;1,0;;;1,0;;2,0;;;;;;;;;;;;;;;;;7,0;;;;;;;;;1,0;;;;;;;;10,0;1,0;;;;2,0;2,0;;;1,0;;;;;2,0;;;;;9,0;;;;;;;;;;;;;;40,0;1,0;;;1,0;;;;;;1,0;;;;;;;;;;;;;;;;;;;;;;;;;;;;;;;;1,0;;1,0;;;1,0;;;;;;;;;;;;1,0;;;;;4,0;3,0;;;1,0;;;;;1,0;;3,0;;;;;;1,0;;;;;;;;;;;;;;;;12,0;;;;;;;;;;;;;;2,0;;13,0;2,0;;;;;;;;;;;;5,0;;;;;;;;;;;;1,0;;;;;;;;;;;;;14,0;;;;;;6,0;;1,0;;;;;;;4,0;;;;;;;;2,0;;;;1,0;17,0;;;;;;;;;8,0;5,0;;;;;;;;;;;;;;;;;;;;1,0;;;;1,0;;;;;;;;;;9,0;;;;;1,0;;;;2,0;;;;;;1,0;;;;;;;;1,0;;;;;;;;;1,0;;;;;;;2,0;1,0;;;;1,0;;;;;1,0;;5,0;1,0;3,0;;;;;;;;;;;;;;;;;;;;;;;;;;;;;;;;;;;;;;;;;;;;;4,0;;;;2,0;;;2,0;;;;;;;;;;;;6,0;;;;5,0;;;1,0;;;;;;;4,0;;3,0;1,0;;;;;;;;;;;;;;;;;;;;;;;;;;3,0;;;;;;;;;;;;;;;;;;;;;;;;;;;;;;;;;;;;;;;;;;;2,0;;1,0;;1,0;;;;11,0;;;;;;;;1,0;1,0;;;;;;;;;;;;;;;1,0;;;;;;;;;;;;;;;;;;;;;;;;;;;;;5,0;;;;;;;;;;;;;1,0;;;;;;;;;;2,0;;;;
profile;;;;;3,0;;;16,0;;17,0;;;;1,0;2,0;;;;;1,0;;;;;;;;4,0;;2,0;;31,0;7,0;;33,0;;;;;;;;;2,0;2,0;1,0;;2,0;10,0;;4,0;7,0;;11,0;;40,0;18,0;;2,0;4,0;1,0;5,0;20,0;;;;4,0;1,0;;;2,0;2,0;;;;;;;6,0;;;;7,0;;1,0;1,0;4,0;;11,0;7,0;1,0;;;;;;;17,0;18,0;6,0;6,0;20,0;;;2,0;;6,0;1,0;;;;2,0;;;;;2,0;;;;;;;;;;8,0;1,0;3,0;3,0;5,0;3,0;;;;2,0;;;2,0;18,0;;;1,0;;3,0;;2,0;2,0;;;;1,0;2,0;;;3,0;;;1,0;3,0;;;;;;;1,0;20,0;;;2,0;;9,0;1,0;;;;6,0;;;;;1,0;;;;5,0;20,0;;2,0;;;;2,0;1,0;;;;;4,0;;1,0;;;;1,0;;;2,0;;;;1,0;;12,0;2,0;;4,0;;;3,0;2,0;;;;2,0;;;;;;3,0;;;1,0;1,0;;1,0;7,0;;;;;;;;;;;;;;;2,0;;;;3,0;1,0;;2,0;1,0;4,0;;;;;;2,0;1,0;;3,0;;;5,0;;;;;;;;;3,0;;;;1,0;;;;;;;;;;;1,0;;1,0;;5,0;;;;15,0;;;;;;;;;;;;1,0;;;;;;;2,0;;;;;34,0;;;;;;;;;;;2,0;;;;;;;;1,0;;;;;;;;;;;;;;;2,0;6,0;;;1,0;;;;;6,0;26,0;6,0;1,0;;;1,0;2,0;;;1,0;;;;10,0;2,0;;;4,0;;;;;;4,0;1,0;;4,0;;;;;19,0;;23,0;;4,0;;;1,0;;;;;;4,0;;;;;;;;1,0;11,0;;;;;;;;;;;;;;;;;1,0;;;;;;1,0;1,0;;;;;1,0;;;;;;;;;1,0;;;2,0;;;;;;;;;;;;;;;;;;;;;6,0;;;12,0;;1,0;;;1,0;;;;;1,0;;;;;;;1,0;1,0;;;4,0;;;2,0;;15,0;;;;;;;;;;;;;;1,0;;;;;;;2,0;;22,0;2,0;;2,0;;;;;;4,0;2,0;;1,0;;;;;;;4,0;;;;;;;;;;;;;;;;;2,0;;;;;10,0;;;;;;;;;;;;;1,0;;;;1,0;;;;;;;;;;;;;;;;;;;;3,0;;;;;;;;;;;;;2,0;8,0;;;;;;;;;;;;;;;;;3,0;;;;;;;;;1,0;;;;;;;;;;;;;;;;;;;;;;;1,0;;;;;;;;;;;;;;;;;1,0;2,0;;;;;;;;;;;;;1,0;;;;;;;;25,0;;4,0;;;;;;;;;2,0;;;;1,0;;;;;;;;;;;;;;;;;;;;2,0;4,0;;;;;;;;;;;;;;;;;2,0;;1,0;;;;2,0;;;;;;;4,0;;;;;;;;;;;;;;;;;;;;;;2,0;;;;2,0;;;;;;;;2,0;11,0;;10,0;;;;;;;;;;;;;;;;;;1,0;;;;;;;;;;;;;;;;;;1,0;2,0;;;;;;;;;;;;;;;;;;;;;;;;;;;;;;;;;;;;;;;;;;;;;;;;;;;;;;;;;;;;;;;;;;3,0;52,0;;;;;;;;;;;;;;;;;;1,0;;;;;;;3,0;;2,0;;;;;;;;;;;;;;4,0;;;;;;;;;1,0;;;;;;;;;;;;;;;;;;;;;
projector;;;;;5,0;;;6,0;2,0;9,0;;;;;19,0;;;;9,0;3,0;;23,0;8,0;;;;;42,0;;1,0;2,0;2,0;61,0;;14,0;8,0;2,0;4,0;;9,0;;;;2,0;;;;;1,0;;1,0;12,0;;;;58,0;26,0;;;1,0;;;34,0;;;2,0;;;;15,0;7,0;1,0;1,0;;;5,0;;10,0;5,0;6,0;;;2,0;;;;6,0;;;3,0;1,0;;;5,0;;1,0;;1,0;;;12,0;78,0;;;1,0;;;32,0;;;1,0;2,0;;;3,0;;;2,0;;1,0;;1,0;;;;;27,0;;;2,0;;;5,0;;;;8,0;;;1,0;;1,0;;;1,0;;1,0;1,0;;;3,0;;;;;;;4,0;4,0;1,0;;;;;;;;33,0;1,0;;5,0;;53,0;3,0;;;1,0;3,0;;;;3,0;;;;15,0;;7,0;;13,0;;;;6,0;;;;;14,0;;;2,0;;8,0;;;;;;;;;;;;1,0;;;;;;1,0;;2,0;1,0;6,0;;;;;;;;3,0;;;;;;;;;;;;;;;;;;;;;1,0;;;12,0;;;;;;;3,0;;6,0;;;1,0;;10,0;;;;;;;;7,0;;;;;;1,0;;;17,0;;1,0;1,0;4,0;13,0;;1,0;;6,0;;;;;1,0;61,0;38,0;;;4,0;4,0;;7,0;;;;;;;;;;;;;;;1,0;;;2,0;3,0;1,0;;10,0;;;;;1,0;;;;;;;;;;;3,0;;;1,0;7,0;;;;;;;16,0;;;;;6,0;;;;;;;;;1,0;2,0;;1,0;;;3,0;1,0;;;5,0;;;;;;4,0;;;;;;;;;;;;;1,0;;;;;1,0;;;;;;1,0;;;;;;;4,0;;1,0;;9,0;;;;2,0;9,0;20,0;;;;;;;;1,0;4,0;;;;;;1,0;;;;;;3,0;;;;;2,0;;1,0;;;;;;;;;;5,0;;;;1,0;;;;;;;;;;;;;5,0;30,0;;;;;1,0;;;10,0;;;;;;;;;;;;;;;;;;;8,0;1,0;;;;;;;;;;;;;;;;;;;;;;;;;;;;;;;;;;;;;;;;1,0;;;;;1,0;;;1,0;;;;6,0;;4,0;;;1,0;;;;;;;;;;4,0;;;6,0;;;;;;;;;2,0;;;;;;;;;;;;;;;;;;;;;;;11,0;;;;;;;1,0;3,0;;;;;;;;;;;;;;;;;;;;;;;;;1,0;;;;;;;;;;12,0;2,0;;;;;;;;;;;;4,0;;1,0;1,0;;;;;;;;;68,0;1,0;;;;;;3,0;;;;;;;;;;;;;;;;;;;;;;;;;;;2,0;;4,0;4,0;;;;;;;;;;;;;;1,0;;;2,0;;;;;17,0;9,0;;9,0;;;;;;;;;;;;;5,0;;;72,0;;;;;;;;;;1,0;;4,0;;;;;;;;;;;;;;;1,0;1,0;;;;2,0;;;;;;;;;;1,0;;;;1,0;;;;1,0;;;;;;;;;;;;;;;;;;7,0;3,0;1,0;;;;;;;1,0;;;;;;;;;;;;;;;;;;;;;;;;;;;1,0;;;;;;;;;;;;;;1,0;;;;;;;;;;;;;;;;;;;;;;;;;;;;;;;;;;;;;;;;;;;;;1,0;;;;;;;;;;;1,0;;;;;;;9,0;;;;;;;;;;;;;;;;;;;;;;;;;;;;;;;;;;;;;;;;;;;;;;;;;;;;;;;;
protocol;;;;;8,0;;;6,0;;;;;;;;;;;;5,0;;9,0;;;;;;8,0;;1,0;;3,0;20,0;;14,0;;;;;2,0;;;;;;;;;;5,0;1,0;;;;;29,0;27,0;;;;;;23,0;;;;;;;12,0;;;;;;;;;;1,0;;;1,0;;;;;;1,0;9,0;1,0;;;6,0;;;;4,0;1,0;;;11,0;;12,0;;1,0;8,0;2,0;;;5,0;;;;9,0;;;;;;;;;9,0;;1,0;9,0;1,0;;;;;;;;;;;;;;;;;3,0;;1,0;;;;;;;;;;;;;1,0;;2,0;;;;21,0;;;;;;1,0;7,0;;;;;4,0;;;;;;;;;;7,0;;;;;;5,0;;;;;;;;;;;;3,0;;;4,0;;;;;;;6,0;7,0;;;;;;;;;;;;;;2,0;;;;;;;;;;;;;;2,0;;;;;;;;;7,0;;;;;;;;;;;;;;;;;;;;;;9,0;;;;3,0;;;;;;;;;6,0;;;;;;;;;;;;;;3,0;;;;;1,0;;;;;;;;;;;;;;;;;;;;;;;3,0;;;;;;;;;;;8,0;;;;;;;;;;1,0;;;;;;;;;;;;;9,0;;1,0;;1,0;;;;;;;2,0;2,0;;;;;;1,0;;;;2,0;;;3,0;;;;;;;;;;;;1,0;;;;;;;;;;;;;4,0;;;;3,0;;1,0;;7,0;3,0;;;;;;;;;;;;3,0;;;;;;;;;8,0;2,0;;1,0;2,0;;1,0;8,0;2,0;;;8,0;;;;46,0;;1,0;;;;;;;;;;;;;1,0;;;;;;1,0;;1,0;2,0;;;;;;1,0;;2,0;;2,0;18,0;;;;;;;15,0;;;;;;;;;;;3,0;6,0;10,0;5,0;;;;;;;;;;;3,0;;;;;;;;8,0;;;;;8,0;;;6,0;;;;;;;;;4,0;;;43,0;;;;;;;;;;;;;;;;;2,0;5,0;4,0;;;;2,0;;;;8,0;;;;9,0;;;;4,0;9,0;;;;;;;;;;;;;;;;;;;;;;;;;;14,0;;;;;;;;;;;;14,0;;;;;;;;;;;;;;;;;;;;;;;;;;;;;;;;;;;;;;;;;;;;2,0;;;;;;;;;;;;;;;;;;;;;;;;;;;;;;;;;;;;;1,0;;;;;;;;;;;;;;1,0;;;9,0;;;;;;;;;;;;3,0;;;;;;;;;;;;;;;;;;;;;;;;;;;;;;;;;;;;;;;;;;;;;;;;;;;1,0;2,0;;;;14,0;;;;;;;;;;;;;;;;;;;;;;;;;;;;;;;;;;;;;;;;;;;;;;;;;;;;;;;;;;;;;;3,0;;;;;2,0;;;;;;;6,0;;;;;;;;;;;;;;;;;;;6,0;;;;;;;;;;;3,0;;2,0;;;;;;;;;;;;;;;;;;;;;;;;6,0;;;;;;;;;;;1,0;;;;;;;;;2,0;;;;;;;;;;;;;;;;;;;;;;;;;;;4,0;;;;;;;;;;;;;;;;;;;;;;;;;;;;
protrude;;;;;8,0;;30,0;13,0;;;;2,0;3,0;;;1,0;;;4,0;;;6,0;;;;;3,0;;;1,0;;;9,0;;5,0;;2,0;45,0;;12,0;;;2,0;24,0;;;1,0;;;;;;;;;14,0;35,0;;1,0;60,0;;;2,0;;;;2,0;;;5,0;27,0;1,0;2,0;3,0;6,0;;;8,0;35,0;8,0;;;2,0;;;;5,0;;;;4,0;;;;;1,0;;2,0;6,0;3,0;64,0;6,0;;;;;;7,0;;;;;;10,0;4,0;;1,0;;6,0;46,0;1,0;;;2,0;;;4,0;24,0;;1,0;12,0;;;7,0;1,0;;22,0;;1,0;;;;2,0;7,0;10,0;;43,0;7,0;;;;6,0;10,0;4,0;5,0;12,0;13,0;23,0;1,0;2,0;;;20,0;2,0;;;;10,0;;;90,0;;14,0;12,0;2,0;10,0;14,0;;;;6,0;;;;1,0;7,0;8,0;20,0;;190,0;;36,0;;8,0;;8,0;;2,0;7,0;1,0;4,0;10,0;;36,0;1,0;;;;3,0;10,0;;4,0;;;;1,0;5,0;;;5,0;6,0;3,0;;;5,0;;;;;11,0;;;1,0;2,0;;;22,0;;8,0;;24,0;6,0;7,0;9,0;;;;2,0;10,0;2,0;;;;15,0;1,0;;2,0;3,0;;1,0;;3,0;4,0;3,0;10,0;5,0;6,0;1,0;12,0;7,0;;11,0;2,0;;2,0;;;1,0;1,0;1,0;1,0;2,0;;8,0;2,0;;2,0;3,0;;6,0;;4,0;;1,0;;4,0;;6,0;;11,0;2,0;5,0;;1,0;6,0;;;6,0;12,0;6,0;8,0;1,0;1,0;3,0;9,0;;1,0;4,0;5,0;1,0;1,0;5,0;;;;;8,0;3,0;;;;;;;;;;;;;;;;;;;;;;;1,0;;;;;;;;;1,0;;;;;;;;;;;;;;;;1,0;1,0;;;3,0;;;;;;;;;;;1,0;;2,0;;;;;;;;;;;;;;;;;;;1,0;;;;;;;;;2,0;;;4,0;;1,0;;;;;;;;;;;;;;1,0;;;1,0;;;;;;;;;;;;;;;;;;;;;9,0;;1,0;6,0;;;;;1,0;;;;;;;;;;;;;;11,0;;2,0;;;;2,0;;;;;;;;;;;;;4,0;1,0;;;;5,0;1,0;;;;1,0;5,0;2,0;;;;;2,0;;;;;2,0;;;;1,0;;;;;;2,0;;;;2,0;;1,0;;;;;;;;;;3,0;;;4,0;;;;;;;;;;;1,0;;1,0;;;;;;1,0;;9,0;;;;;;;;;5,0;3,0;;;;;;;4,0;1,0;;;;;1,0;;;;;;;;;;;;6,0;;;;;;;;;;;;9,0;1,0;1,0;;1,0;;;;6,0;;3,0;;9,0;;;8,0;;;;1,0;;;;;;;;;2,0;;4,0;;2,0;2,0;1,0;;;;;;;;2,0;;;;;;;;;;;;;;;;;;;;;;;;;;2,0;;;;;;1,0;;;3,0;;;;;;;;;;;;;;;;;1,0;;2,0;;;;;;6,0;;;;;;;;;;;;;;;;;;;;;;;;;;;;;;;;;;8,0;;;;;;;;;;;;;2,0;;;4,0;;;;;;;;;;;;;;;;;;;;1,0;;4,0;;;;;;;;;;;;;;;;1,0;3,0;;;;;;;;;;;;2,0;;;;;;;;;;;;;1,0;;;1,0;;;;;;;3,0;;;;;;;3,0;;;;;;;1,0;;;;;;;;;;;;;;;;;;;;;2,0;;;;;;;2,0;;;;;;;;;;1,0;;;;;;;;;;;;;;;;;;;;;;;;;;;;;;;;;;;;3,0;;;;;;;;;;1,0;;;1,0;;4,0;1,0;;;;;;;;;;;1,0;;;;;;;;;;9,0;;;;;;;;;1,0;;;;;;;;;;;;;;;;
protrusion;;;;;4,0;;16,0;29,0;;;8,0;;7,0;;;;;;;;;;;3,0;;;2,0;;1,0;;;1,0;14,0;;2,0;;;31,0;1,0;4,0;3,0;;1,0;9,0;;;6,0;;;;;;;4,0;8,0;44,0;29,0;;2,0;92,0;;;6,0;;;2,0;2,0;;;;13,0;;;8,0;2,0;;1,0;;32,0;;8,0;3,0;;;;1,0;1,0;;;2,0;20,0;;;1,0;;10,0;;;;;85,0;2,0;;;;;;36,0;1,0;1,0;10,0;13,0;;9,0;6,0;;;;25,0;17,0;1,0;;;10,0;1,0;;13,0;23,0;;9,0;14,0;;;9,0;3,0;;28,0;7,0;;;;;;25,0;;1,0;105,0;3,0;;;;46,0;118,0;;;36,0;35,0;33,0;7,0;;;1,0;24,0;2,0;;3,0;;1,0;;4,0;45,0;;57,0;26,0;3,0;26,0;13,0;;;;2,0;;1,0;;5,0;5,0;13,0;59,0;;85,0;2,0;;;32,0;6,0;;;;11,0;6,0;;20,0;1,0;19,0;2,0;;;;10,0;79,0;;25,0;;2,0;;;1,0;;;;10,0;1,0;;;8,0;;1,0;;;12,0;1,0;;2,0;4,0;1,0;3,0;5,0;2,0;4,0;1,0;32,0;1,0;15,0;7,0;;15,0;2,0;;8,0;1,0;1,0;;;73,0;;;10,0;21,0;1,0;;;7,0;1,0;7,0;38,0;14,0;61,0;;6,0;;;16,0;;1,0;22,0;;;;2,0;2,0;7,0;1,0;;5,0;;;12,0;;3,0;3,0;;2,0;;3,0;;1,0;;;2,0;20,0;;;10,0;;2,0;36,0;;1,0;10,0;11,0;;1,0;;;9,0;;6,0;10,0;4,0;;2,0;1,0;6,0;26,0;25,0;;13,0;9,0;;;;;;;;;;;;;;;;;;1,0;;;;1,0;;;;;;;;;;1,0;;;;;;;;;;;;;;;;;3,0;;;3,0;;7,0;;;;;;;;;;;12,0;2,0;;;;;;;;;;;;;;;1,0;;2,0;6,0;;4,0;;;;;;;1,0;;;8,0;;1,0;;;;;;;;;;;;;;;1,0;;;;1,0;;;;;;;;;3,0;4,0;;;;;;;;;1,0;;;2,0;;;;;;;;;;4,0;;;;;;;;;18,0;;;;;;2,0;;5,0;2,0;5,0;;;;;;;;;1,0;2,0;;;;10,0;8,0;;;;4,0;4,0;1,0;;;;2,0;;;;;;;;;2,0;;;2,0;;;;2,0;;;;;;;;;;;;;;;;1,0;;2,0;4,0;;;1,0;;;;;;;;4,0;;1,0;;;;;;13,0;;41,0;;;;;;1,0;;;11,0;4,0;;;;;5,0;;;1,0;;;;;2,0;;;;;3,0;;;;;1,0;5,0;;;;;;;;;;;;;4,0;;;;;;5,0;;2,0;;3,0;;;;2,0;1,0;;;;3,0;;;;;;;;;;;2,0;2,0;3,0;;12,0;;4,0;;;;;;;;1,0;2,0;14,0;;;;2,0;;;;;;;;;;;;;;;;;;;;;;;;;;;3,0;;;;;2,0;;;;;;;;;;;;;;;;;1,0;;;;;;;;;;;;;;;;;;;;;;;;;;;;2,0;;;;;;;;4,0;;;;;;;;;;1,0;;;;;;;;;1,0;;;;;;;;;;;;;;;;;1,0;;;;;;;;;2,0;;;;;;;;;;;2,0;;;;;;;;1,0;;;;;;;;;;;;;;;2,0;;;;;5,0;;;;;;;2,0;1,0;;;;;;;;1,0;;;;1,0;;;;;;;;;;7,0;;7,0;1,0;;;;;;;;1,0;5,0;;1,0;;;;;;;;;;;;;;;3,0;;;;;1,0;;;;;;;;;;;;;;;;;;;;;;;;;;;;;;;;;;;;;;;;;2,0;;;;;1,0;1,0;;3,0;;;2,0;;;;;;;;;;;;;;;;;;;;;;;;;;;;;;;;;;;;;;;;;
radio;;;;;8,0;;;9,0;;3,0;;;;;;2,0;;;2,0;;;11,0;;;;;;27,0;;6,0;;6,0;79,0;;5,0;;;;;3,0;;;1,0;4,0;;;;;;83,0;1,0;4,0;;3,0;;25,0;13,0;;;4,0;;;14,0;;;;7,0;;;5,0;1,0;2,0;;;;;;1,0;;1,0;;1,0;3,0;;;1,0;;;1,0;;15,0;;;78,0;;;;1,0;11,0;;1,0;25,0;;;;1,0;;22,0;31,0;;7,0;;;;;;;;3,0;26,0;;;4,0;16,0;;;4,0;;;4,0;1,0;;;;;4,0;;;;3,0;;;2,0;2,0;8,0;2,0;1,0;5,0;;;;;;;;;4,0;1,0;;7,0;;;;;;;6,0;9,0;8,0;;6,0;;7,0;10,0;;7,0;;;;;;;2,0;;;1,0;;3,0;;;;;;62,0;;;;14,0;;;2,0;;;11,0;;;;;;1,0;;;;;;2,0;45,0;;;;;;;;;;;;;;;;;;;5,0;;2,0;;;;;;;2,0;;5,0;;;;;;;4,0;1,0;;;1,0;;;;;;;;;;;;;;1,0;1,0;;;4,0;;;;;1,0;;;2,0;;;;2,0;4,0;;;;;;;;;2,0;;;;;17,0;;;;;7,0;;;;1,0;;;;;;;;;;1,0;;;;1,0;;;;;11,0;;;;;;1,0;;;;;1,0;;;;;;;;1,0;;7,0;;;;;;;;;;;;;1,0;3,0;1,0;2,0;2,0;;;;;2,0;24,0;2,0;;;;;;;3,0;;7,0;;2,0;;;;;3,0;;;;;6,0;1,0;;;3,0;;2,0;;;;;;;;;;;;2,0;;;;;;3,0;;;48,0;;1,0;;4,0;;;;;;;1,0;6,0;;;4,0;2,0;;;;1,0;;4,0;;;;;;1,0;1,0;9,0;;;25,0;;2,0;;2,0;;;;2,0;;;;;;;12,0;;;1,0;;1,0;;;;;;;;;;;;;2,0;;;;;7,0;;;1,0;;;;;;;;3,0;;;;;;;;4,0;139,0;7,0;3,0;;;;1,0;;;;;12,0;7,0;;;;1,0;;;;3,0;;;;1,0;;;;;;;;1,0;;;;;;;2,0;18,0;1,0;1,0;3,0;;1,0;;3,0;4,0;;;;;;;;;1,0;1,0;;;;;;;;;1,0;12,0;;;68,0;;;;2,0;15,0;;;;;;;;5,0;;;;1,0;;;1,0;;1,0;;;;;;;10,0;;5,0;;;;;;;;5,0;;;;19,0;;;;;;;;;;;;;;;;;;;;;;;;;;;;;;;;;;;;;;;;;;2,0;;;;;;;;;;;;;;;;;1,0;;;;2,0;;;;;;;;;2,0;2,0;;;;;;;;3,0;;;;;;;;;;;;;;;;;2,0;;;;;;;;;;;;;;;;;;;;;;;;;;;;;;;;;;;;;;;;;;;;;;;;;15,0;;1,0;;;;;;;;;;;;;;;;;3,0;;;;;;;;;;;;;;;;;;;;;;;;;;;;;;1,0;;;;;;;;;;;;;;17,0;;;;;19,0;;;;;;;;;;;;;;;;;;;;;;1,0;;;;;;;;;;;;1,0;;;;;;;;;;;;4,0;;7,0;;;;;;;;;;;;;;;;;;;;;;;;;;;;;3,0;;;;;;;;2,0;;4,0;;;;;;;;;;;;;;;;;;;;;;;;;;;;;;;;;;;;;;;;;;;;;;;;;;;;;;;;;;;;;;;;;;;;;
radius;;;;;3,0;;19,0;7,0;4,0;2,0;11,0;;16,0;;5,0;2,0;;;10,0;3,0;32,0;;1,0;3,0;;;2,0;2,0;2,0;;;28,0;4,0;8,0;2,0;;;7,0;;;12,0;;1,0;85,0;;;;;1,0;;3,0;;;30,0;2,0;116,0;4,0;;7,0;201,0;1,0;;3,0;;;;;;;;28,0;;7,0;4,0;;;;10,0;6,0;1,0;;1,0;;1,0;;;4,0;4,0;3,0;1,0;;;1,0;2,0;;;;1,0;;;268,0;22,0;;;;;;12,0;;;2,0;;;5,0;1,0;;;;;1,0;;;6,0;;;;;1,0;;;5,0;;;19,0;;1,0;;;;;;;;3,0;;;7,0;;;;;1,0;15,0;;;;;6,0;;;;8,0;15,0;;;;;;;;1,0;;2,0;2,0;1,0;6,0;19,0;;;;;;;;;6,0;1,0;4,0;;2,0;;;;;;11,0;24,0;;2,0;;;2,0;;152,0;1,0;;;;;3,0;;;;;;1,0;;;4,0;;;3,0;;;;;;;;;1,0;;;;1,0;5,0;4,0;;21,0;;;;4,0;;;;;;3,0;1,0;;;;1,0;1,0;;;8,0;;53,0;1,0;;;;;;1,0;;;;;;;;;;;1,0;1,0;4,0;1,0;;;2,0;;;;71,0;;;;;;1,0;;;;;;;;;3,0;6,0;3,0;;;19,0;;;;;;;31,0;;;;;;;;;;;1,0;;;;;1,0;3,0;4,0;;;;1,0;;;;;;;;26,0;;;;;;1,0;;2,0;10,0;;10,0;;;;;;;;;13,0;;;;;;;;;;2,0;;;;6,0;1,0;;;;;;;;;;;;2,0;;;;1,0;;3,0;;;2,0;;;;;;4,0;4,0;;;3,0;;;;;;;;;;1,0;;;;;;;;;;;;;;;;;;;;;;;;;;;;2,0;;;;2,0;;1,0;;;;;;;;;6,0;;;4,0;;4,0;;;4,0;1,0;;;;;;;;;;;;;;;;;;;;;1,0;;2,0;;2,0;;;;;;;1,0;;;3,0;;;;;;2,0;;;;;;;;;1,0;;;;;1,0;;;;4,0;;;;;;;;;;;;;;;;;;;2,0;;;;;;;;1,0;;43,0;;;;;;;;;;;;;;;;1,0;;;;;;;;;;;;1,0;;;;;;29,0;;;;1,0;;;;;2,0;;;;;;;2,0;;;;;;;;;;;;;;;;;;;;;;;;2,0;;;;;;;;2,0;;334,0;;;;;;;;;;;;;;;2,0;;;;;;2,0;;;;1,0;;;;;;;;;;;;;;;;;;;;;;;;14,0;;;;;;;1,0;;;;;;;;;;;;;;;;;;;;2,0;;;;;;;;;;;;;;;;;1,0;;;;;;;;;;;46,0;;;;;;;;;;7,0;1,0;;;;;;;;;;;1,0;;;;;;;;;;;;;;;;;;;;;;;4,0;;;;;;;;;;;;;;;;;;4,0;;10,0;;;;;;;;;;;;;;;4,0;;;;;;;;;;;;;;;;;;;;;;;;;;;;;;;14,0;;;;;1,0;;;;;;;;;;;;2,0;;3,0;;;;;;;;;;;;;;;;;;;;;;;;;;;;;;;;;;;;;;2,0;;;4,0;;;;;;;;;;;;;;;;;;;;;;2,0;;;;;;1,0;;;;;;;;;;;;3,0;;;;;;3,0;1,0;;;;;;;2,0;;;;;;;;;;;;;;;;;;;;10,0;;;;;;
readout;;;;;6,0;;;5,0;;7,0;1,0;;;;1,0;;;;;;;20,0;;;1,0;;;2,0;;;;4,0;9,0;6,0;4,0;1,0;;4,0;;;;;;3,0;;;;1,0;;1,0;2,0;2,0;;;;24,0;18,0;;;;;;9,0;;;;1,0;;2,0;2,0;4,0;2,0;;;3,0;;;;4,0;;;9,0;;;;;6,0;;1,0;1,0;18,0;3,0;1,0;93,0;;;;1,0;4,0;3,0;3,0;9,0;;5,0;;;;59,0;;;;3,0;25,0;;1,0;;;;;;;;;65,0;;;17,0;;;2,0;;;;;1,0;;;;1,0;;;;;;;;15,0;4,0;;;;;;;2,0;;;1,0;;6,0;;;;;;12,0;;;;;;;;;;;;17,0;;;;2,0;;;;;;17,0;;7,0;;;;4,0;;;;;;;;;;4,0;;;;;1,0;;;;;;;54,0;;;3,0;;;;;;;;;;;;;;;;;1,0;;;;;;;;;;;1,0;;;;9,0;;;2,0;;;;;;;;;;;;;1,0;;;;;;;;;;;;1,0;;;;;;;;;;2,0;1,0;;;1,0;;;;6,0;;;;;;3,0;;;;;2,0;;;7,0;5,0;;;;;;;;;;;;;;;;;1,0;;;1,0;;;;3,0;1,0;1,0;;;1,0;1,0;;;1,0;;;6,0;;;;;;1,0;;;;;;;;;;;;1,0;;;2,0;;;;;;;15,0;2,0;1,0;;;41,0;2,0;;;;;4,0;;;;;;;;8,0;1,0;13,0;;;;;;;;;;;;;;;;;1,0;;;;;1,0;;4,0;;;;23,0;;;33,0;;;3,0;;;;;;;;;;;;;4,0;18,0;14,0;7,0;6,0;;;;4,0;;;;;;;;;;;;;;;;;;;;4,0;;;;;;;;;1,0;;;;;;;;;1,0;;7,0;;;;;;1,0;;;;;;;;;;;;;;;;;;;;;;;;;;;;;;;;4,0;;;;;;10,0;;;;;;;6,0;;;;;;;;;;;;;;1,0;;;;81,0;7,0;;;;;;;;;;;;;;;;;;;;;;;;;;;;;;;;;5,0;45,0;;;;;;;5,0;;;;;;;;;;;;;;;;;;1,0;;;1,0;;;;;;;;7,0;;;;;;;;;;;;;;;;;;;;;;;;;;;;;;;;;;;;;;;;;;;;;;;11,0;;4,0;;;;;1,0;;;;;;9,0;;;;;9,0;10,0;;;6,0;;;;;;21,0;;;1,0;;;;3,0;;;9,0;;;;;;;2,0;;;;;;;;7,0;6,0;;1,0;;;;;;;;;3,0;;;;;;;;;;;;;;1,0;;;;;;;9,0;3,0;;;;;;;2,0;;;;;;;;;;;;;;;;;;;;;;;;;;;;;;;;;;;;;;;;;;;;;;;;;;;;;;;;;;;;1,0;;;;;;;;;;;;;;;;;;;;;;;;;;;;;;;;;;;;;;;;;;;;;;;;;;;;;;;;;;;;;6,0;;;;;;;;;;;;;;;;;;;;;;;;;;;;;;;;;;;;;;;1,0;;;;;;;;;2,0;;2,0;;;;;;;;;;;;;;;;;;;;;;;;;;;;;;;;;;;;;;;;;;;;;;;;;;;;;;;;
recess;;;;;6,0;;2,0;27,0;;;1,0;;6,0;;;;;;7,0;;;;;;;;;;1,0;;;;30,0;;26,0;;;20,0;;11,0;2,0;;2,0;51,0;;;10,0;;;;;1,0;;;1,0;22,0;33,0;;3,0;52,0;;;10,0;;;;8,0;2,0;;5,0;5,0;;;8,0;7,0;;;6,0;33,0;;8,0;3,0;1,0;;;;2,0;1,0;;;11,0;;;1,0;5,0;13,0;;;;20,0;125,0;3,0;;;;;2,0;33,0;;;1,0;5,0;;7,0;7,0;;5,0;;18,0;31,0;5,0;;;11,0;;;13,0;3,0;;;47,0;3,0;;1,0;7,0;4,0;9,0;4,0;;3,0;;;2,0;7,0;4,0;1,0;121,0;35,0;2,0;;;19,0;12,0;;17,0;18,0;9,0;25,0;3,0;5,0;;1,0;35,0;16,0;;;;10,0;;4,0;33,0;1,0;57,0;87,0;1,0;24,0;21,0;;3,0;;24,0;2,0;2,0;;8,0;7,0;30,0;35,0;;188,0;2,0;11,0;2,0;84,0;2,0;;;3,0;5,0;7,0;6,0;34,0;4,0;43,0;;;1,0;7,0;6,0;65,0;;1,0;;;;;;2,0;;;39,0;4,0;;;33,0;;4,0;;;3,0;7,0;1,0;4,0;8,0;3,0;1,0;8,0;4,0;13,0;;18,0;6,0;10,0;42,0;1,0;;18,0;10,0;1,0;1,0;;;8,0;10,0;1,0;2,0;3,0;62,0;;12,0;;8,0;12,0;;38,0;5,0;24,0;7,0;;11,0;3,0;13,0;1,0;9,0;11,0;;;2,0;2,0;19,0;3,0;3,0;;14,0;4,0;;5,0;;2,0;21,0;2,0;;;4,0;;;;;4,0;1,0;1,0;1,0;1,0;3,0;36,0;6,0;3,0;;7,0;;3,0;5,0;2,0;;4,0;1,0;6,0;13,0;4,0;3,0;2,0;;21,0;61,0;;6,0;1,0;1,0;;;3,0;1,0;;;;;;;;;2,0;;;;;1,0;;;1,0;1,0;;;;;;;;;4,0;;;;;1,0;;;2,0;;1,0;;;1,0;;;;;;;;5,0;;9,0;;;;;;;;4,0;6,0;;4,0;;3,0;;;;;;2,0;;;;;;;;;;3,0;;2,0;;;;;;;3,0;;;;6,0;;;;;;;;;;;;;;;;2,0;;;;;5,0;;;;;;;;5,0;13,0;7,0;;;;;;;;;;;;9,0;;;;;2,0;;;;;4,0;;;;;;;;;4,0;;;;;;;;;;1,0;;5,0;;;1,0;;;;11,0;;;1,0;;4,0;9,0;;;8,0;11,0;7,0;;;;;;2,0;;;;;;;;2,0;3,0;;1,0;;;;1,0;;;;5,0;;;7,0;;;;;;1,0;4,0;;1,0;;;1,0;;4,0;1,0;;;;;;;;4,0;;;;;;;;6,0;;15,0;;3,0;;;;;;;14,0;3,0;;;;;10,0;;;;;;;;1,0;;;;;1,0;;;6,0;;;1,0;1,0;2,0;2,0;;;;5,0;;;;;;4,0;;;;;1,0;;;12,0;;;;9,0;1,0;;4,0;;1,0;;3,0;;2,0;;;1,0;4,0;1,0;;2,0;;3,0;5,0;;2,0;7,0;;1,0;;;;;3,0;2,0;;1,0;4,0;;;;;3,0;2,0;;2,0;;;;;;;;;;;;;;;3,0;;;;;;4,0;;;1,0;;;;;2,0;;;;;;;;;;;;;;1,0;;;13,0;;;;;;;;;;;2,0;;;1,0;;;2,0;;;;;;;;;;;;;;;;;;;3,0;;;;;;;;1,0;;;;;;1,0;;;;;;2,0;;;;;;;;;;;;;;;;7,0;;;1,0;;2,0;;;;5,0;;;;;;;;;;;2,0;;4,0;;;;;;2,0;;;;3,0;2,0;4,0;;;5,0;;;2,0;;;8,0;;;;;5,0;;;;;;;;1,0;;;;;;1,0;;3,0;;5,0;4,0;;4,0;;;;1,0;;;1,0;;;;4,0;;12,0;;;;;3,0;;;1,0;2,0;;;;;;;;;;3,0;;;;1,0;;;2,0;;;;;;;;;;;1,0;;;;;;;;2,0;;;;;;;;5,0;;;;;;;;;;;;;;;;;;;2,0;;1,0;;8,0;5,0;;;;;3,0;;;;;;;;;;;;;;;;2,0;1,0;;;;;;;;;6,0;;;;;;;;;;;;;;1,0;
reflective;;;;;5,0;;11,0;3,0;;9,0;5,0;;;;;;;;2,0;3,0;2,0;1,0;;7,0;;;1,0;1,0;1,0;3,0;2,0;1,0;19,0;2,0;1,0;;19,0;5,0;;5,0;4,0;;3,0;102,0;;;;;;;1,0;;;17,0;;54,0;38,0;;;132,0;;;17,0;;;;;;;;51,0;;9,0;;;1,0;;4,0;19,0;1,0;5,0;;;;;3,0;;;;5,0;20,0;;;4,0;5,0;1,0;;;;2,0;266,0;21,0;;;;1,0;;55,0;;;;8,0;;5,0;;;;;;5,0;;3,0;;;37,0;;9,0;1,0;;8,0;;;;;;3,0;14,0;;3,0;3,0;;;1,0;48,0;;3,0;30,0;;;;;;4,0;;;4,0;;2,0;2,0;10,0;17,0;;2,0;2,0;;22,0;;102,0;;15,0;115,0;74,0;22,0;2,0;;2,0;;;;;;2,0;3,0;;;3,0;3,0;11,0;;33,0;;;;1,0;1,0;77,0;11,0;;;;;6,0;;16,0;2,0;;;;;12,0;;1,0;;;;;15,0;7,0;10,0;17,0;1,0;1,0;;;1,0;;13,0;;;;4,0;;;1,0;;9,0;1,0;;15,0;;4,0;;7,0;1,0;;;;;;;;;;8,0;;2,0;1,0;4,0;2,0;;;;;;;;4,0;;;;;2,0;;;;;;8,0;;6,0;2,0;;;6,0;;;5,0;12,0;;2,0;;;;;;5,0;;;10,0;;1,0;;;1,0;6,0;;;2,0;2,0;3,0;4,0;;;;;;;;;;;;;;;6,0;;4,0;;;;;;;;;;;;;;;;;;;;;2,0;;8,0;;;2,0;;;;;;;;;1,0;;;;;;;;;;;;1,0;;;;;4,0;;2,0;;;;;;;;;;;;;;;;7,0;;;;;;;;;;5,0;;;2,0;4,0;;;;1,0;;;;1,0;1,0;;;;;;;;;3,0;;;;;;5,0;;;;;;;;;;;;4,0;;;;;11,0;7,0;4,0;;;;;;;;;;;;13,0;;;;;;;;;;;;;;;;;;;7,0;1,0;;;;;1,0;;;1,0;10,0;;;;;;;;;3,0;;;;1,0;;;;;;;;;;;;;3,0;;;;;;;;;;;1,0;;;;;;;;;;;;3,0;;;;;;;;4,0;;;;;;;;3,0;;;;1,0;;11,0;;;;;;;;;;3,0;;;;;1,0;12,0;1,0;;;1,0;;;;;;;;;;;;;;;;;;;;;;;;;1,0;;;;;;;;;;;;3,0;;;;;;;;;;;;;16,0;;;;;;;;;;;;;;;19,0;;;;;;;;2,0;;;;;;1,0;;;;;;;;;5,0;;;;;;;;;;1,0;;;;;;;4,0;;;;;;3,0;;;;1,0;;;;1,0;;;;;;;;;;;;;;2,0;;;1,0;;;;;;;;;;;;;;;;;;;;;;;;;1,0;2,0;;;;;;;;;;;;;;1,0;;;;;;;;;;;;;9,0;;1,0;;1,0;;;;;;;;;;;;;;;;;;1,0;;;;;;;;;5,0;;;;;;;;;;;;;;;;;;;;;;4,0;;;8,0;;;2,0;;;;2,0;;1,0;;;;;;;;;;;;;;;;;;6,0;;;;;;17,0;;4,0;;;;;;;;1,0;;;;;;;;;;1,0;;;;;;;;;;;;;;;5,0;;;;2,0;;;;;;;8,0;;;4,0;;;;;;;;;;;;;;;;;;;;;;;1,0;;;;;;;;;;;;;1,0;;;;4,0;;;;;3,0;7,0;;;;;;;;;;;;;;;;;;;;;;;;;1,0;1,0;;;;;;;;;;;;;;
reflector;;;;;13,0;;6,0;;;13,0;;;;;2,0;;;1,0;7,0;;;2,0;;;;;;2,0;;4,0;;2,0;23,0;;;;3,0;4,0;;;2,0;;;;;;;;;1,0;;;;1,0;;19,0;3,0;;;21,0;;;13,0;;;5,0;1,0;;;;4,0;;;;;3,0;;2,0;43,0;1,0;;2,0;;;;8,0;2,0;;;;6,0;;;2,0;;9,0;1,0;;;1,0;37,0;15,0;;;;;2,0;8,0;;;;1,0;;;8,0;;;;4,0;5,0;;;;6,0;3,0;;16,0;;;;6,0;;;;;;18,0;;1,0;5,0;;1,0;;2,0;3,0;;6,0;;;;;;6,0;1,0;;;1,0;12,0;;5,0;2,0;;;;;1,0;;100,0;;2,0;34,0;9,0;5,0;8,0;;3,0;;5,0;;1,0;;;4,0;;;2,0;14,0;3,0;;8,0;;;1,0;4,0;;51,0;;;;;;2,0;;8,0;;;;5,0;11,0;;;2,0;;;;;1,0;1,0;;;1,0;12,0;;3,0;5,0;;11,0;;;;;;;;;9,0;;;4,0;;;;;1,0;;;;;3,0;;;;;12,0;;;;5,0;2,0;;;;7,0;;;;4,0;;;;;2,0;;;;;;;;2,0;;;;1,0;;;;1,0;;;;5,0;;;;;;;6,0;;1,0;;2,0;;2,0;;;;;;;2,0;;;2,0;;;;;;;;;;;10,0;;;1,0;;2,0;;;;;;;;;;;;;;;;;;;;;;;;;;;;;;;;2,0;3,0;1,0;;;;;;;;;2,0;;;;;;;;;;;;;;;;2,0;;;;;;;;;6,0;;1,0;;;1,0;;;;;1,0;1,0;;;;;;;;;9,0;;;;;;;;;;;;1,0;;;;;;;;;;;;;;;;;;;;;;;14,0;4,0;;;;;;;;;;;;;;;;;;;;;4,0;;;;;;;;;;1,0;1,0;;;;;;2,0;;;22,0;;;1,0;;;;;;;;;;10,0;;1,0;;;;;1,0;;;;;;4,0;;;;;;;;6,0;;;1,0;;;;;;;;;;;;1,0;;;;;;;;;;;;6,0;;;;;;;;1,0;;4,0;;;;;;;;13,0;;;;;;;;8,0;;;;;;;1,0;1,0;;;2,0;;;;;;;;1,0;;;;;;;;;;1,0;;;;;;;;;;;;4,0;;;;;;;;1,0;;;;;26,0;;1,0;;;;7,0;;;;;;;6,0;;6,0;;;;;;;;;1,0;;;;5,0;;;;;;;;;;;;;;;;;;;;;;;;;;;1,0;4,0;;;;1,0;;;;;;;;;;3,0;;;;;;;;;;;;;;1,0;;;;;;;;;;;1,0;2,0;;;;;;;;4,0;;;;;;4,0;;4,0;;;;;;;;;;;;;;;;;;;;;;;;;;;;;;;;;2,0;;;;;1,0;;;;;;;;;;;2,0;;1,0;;;;;;;;;;;;;8,0;;;2,0;;;;;;;;;;;;;13,0;;;;;;;;;;;;;;2,0;;;;;;;;;;;;;;;;;;;;;;4,0;;;;;;;;;;3,0;;;;;;;;;;2,0;1,0;;;;;;;;;;;;;;;;;;;;;;;;;1,0;;;;;;;;;;2,0;;;;;;;;;;;;;;;;4,0;;;;;;;;;;;;;;;;;;;;;;;10,0;;;;;;;;1,0;;;;;;;;;;;;;;;;;;;;;;;;;;;;9,0;;;;
refractive;;;;;5,0;14,0;64,0;5,0;;;1,0;1,0;;12,0;1,0;2,0;2,0;1,0;8,0;;75,0;2,0;;;;;3,0;;;;;;20,0;5,0;;;;;;5,0;4,0;;;285,0;;;;1,0;1,0;;1,0;;;156,0;33,0;67,0;33,0;;4,0;563,0;;;5,0;;;;;;;;105,0;4,0;6,0;20,0;7,0;;;18,0;3,0;189,0;;;;;;3,0;12,0;27,0;11,0;5,0;5,0;;1,0;1,0;;4,0;;;;20,0;169,0;42,0;;;;;;19,0;;4,0;;9,0;5,0;8,0;;;;;;6,0;;;2,0;;;;;1,0;;2,0;1,0;;15,0;;;8,0;12,0;;5,0;;;;3,0;2,0;3,0;;14,0;;;7,0;;;3,0;;;;;;;15,0;1,0;2,0;;;;73,0;1,0;60,0;;79,0;5,0;;8,0;1,0;;;;;;11,0;;;3,0;;;1,0;3,0;18,0;;13,0;1,0;;;;;1,0;;;;2,0;1,0;10,0;;68,0;;;;;6,0;;;1,0;;5,0;;;6,0;29,0;4,0;;;2,0;;;3,0;3,0;;;;;;;;;4,0;;;2,0;13,0;;;;;;;;;;;;;;;1,0;3,0;;4,0;;;7,0;;;;;;;;;;;;1,0;;;;2,0;;;3,0;1,0;;;;;;;2,0;12,0;;;1,0;;;;;;;;3,0;;;;;;;;;8,0;;;;1,0;;;;;;;;;;;;;;;;;;;;2,0;;;;;;;;;;;;;;;;;;2,0;3,0;;;11,0;;2,0;;;;;;;1,0;;;;;1,0;;;;;1,0;;22,0;;;;66,0;;1,0;;;;;;;1,0;;1,0;;;;;;;;;;;;;;;;;;12,0;;;;;;;;;;;;;;;;;;;;;;;;;;;;;;;;;;;;;;;;4,0;;;;;2,0;;;;;;;;;;;;;;;;1,0;;;;;;;;;;;;;;;;;;;;;2,0;;;;;;;;2,0;1,0;;;;;;11,0;;;;;;;;;;;;;;;;;;;;;;;;;;;;;;;;;;;;;;;;;;;;;;;;1,0;;;;;;;;;;;;;;10,0;;;;;;;;;;;;;;;;;;;;;;;;;;;;1,0;;;;3,0;;;;;;;;;;;;;1,0;;;;;;;;;;;;;;;;;1,0;;;;10,0;;;;3,0;;;;;;42,0;;;;;;;;;48,0;;;1,0;;;;;;;;;24,0;11,0;1,0;;;;;;;;14,0;3,0;;1,0;;;;;;10,0;;;;;;;;;;;10,0;;;;;;;;;;;;;;;;;;;;;;;;;;;16,0;;;;;;;;;;;;;;;;;2,0;;;;;;;;;3,0;;98,0;;;;;;;;;;;12,0;;;;;;8,0;;;;;;;;5,0;;;;;;;;;;;;;;;;;;;;;;;;;;;;;;;;;;;;;6,0;;;1,0;;;;;;;;;;;;;;1,0;;;;;;;;;;;;;;;;;;;;;;;;;;;;;;;;;;;;;3,0;;;;;;;;;;;;;;;;;;;;;15,0;;5,0;;;;;;;2,0;;;;;;;;;;;;;;;;;;;;;;;;;;;;;;;;;;;;;;;;;;;;;;;4,0;;;;;;;;;2,0;;1,0;;;;;;;;;;;;;9,0;;;;;;;;6,0;;;;1,0;;;;;;;;;3,0;;;;;3,0;;9,0;;33,0;;;;
render;;;;;2,0;;1,0;3,0;;11,0;;;;;26,0;;;1,0;6,0;12,0;;10,0;;;;1,0;;16,0;;2,0;;8,0;28,0;8,0;28,0;2,0;;1,0;;46,0;;;4,0;5,0;;;;1,0;16,0;;;11,0;;;;115,0;8,0;;;1,0;;;29,0;;6,0;;3,0;;;5,0;1,0;1,0;1,0;;;;;5,0;7,0;;;10,0;5,0;9,0;;;15,0;;;20,0;11,0;;;5,0;1,0;22,0;;1,0;3,0;;4,0;21,0;;;1,0;;;5,0;;;1,0;1,0;;1,0;;;;;;;;;1,0;;;;7,0;;;;;;;;;;;;;;;2,0;;1,0;;;2,0;24,0;;;;;;;;;;;3,0;2,0;;2,0;;;;;3,0;2,0;;;;;4,0;1,0;4,0;;;5,0;;;;;;;;;;5,0;;2,0;;;;2,0;2,0;;;;;1,0;;;;;;1,0;;;;;;;;3,0;3,0;4,0;;2,0;;;;;;;;;;;;;;;;;6,0;2,0;;;16,0;;;;;;;;;;;;;;;;;;;;;;;;;;;;3,0;;;;;;;;;3,0;;;;1,0;;;;;;2,0;;18,0;;;1,0;;;;;;;;;;3,0;;2,0;;;;;;;;;;;;;;1,0;;;;;;;;;;;;;;5,0;;;;;;;;;;;;;;1,0;1,0;;;;;;3,0;5,0;;;;;;;;1,0;;;;2,0;2,0;3,0;1,0;;1,0;;;;;3,0;;;;;3,0;;;2,0;;;;;2,0;10,0;;;4,0;;;;;1,0;5,0;;;2,0;;;;;;25,0;;1,0;;3,0;;;5,0;;3,0;;;1,0;;20,0;;;6,0;7,0;1,0;4,0;;9,0;39,0;;;;;;;;7,0;2,0;;;3,0;;1,0;;3,0;;8,0;;;10,0;1,0;7,0;1,0;;;6,0;;6,0;;;5,0;1,0;;;;1,0;;;;;4,0;;;;;8,0;;;;;15,0;;;;;1,0;1,0;;3,0;;1,0;;;24,0;12,0;;;;;;;;;;;;;;;;;;5,0;;2,0;;;;;;;2,0;2,0;;;;;;;;;;5,0;2,0;;;;3,0;;;;;;;1,0;;8,0;;;9,0;6,0;;;1,0;;;2,0;;;2,0;;;;;;3,0;;;;;2,0;4,0;;;;;;;;;2,0;1,0;;;;;;;1,0;;;;;;;;;;;;;;;;;;;;;;;;;;;1,0;;;;;;;2,0;;;;;1,0;;;3,0;;1,0;;;;;;;;;;;;;;;;;;1,0;;;;;;;;4,0;8,0;;;;;;;;;;;;;;;;;;;;;;;;5,0;;;;;;;;;;;;1,0;;;;;;;;;2,0;;;;;;6,0;1,0;;;6,0;;;;;;;;2,0;;;;;;;1,0;;1,0;1,0;;;;;1,0;;;;;6,0;;1,0;;2,0;;2,0;;;1,0;;;8,0;;;;;;;;;;;;;;;1,0;;;;;1,0;;;;;;;;;;;;;;;;;;2,0;;;;;;1,0;12,0;;;;4,0;;;;;;;;1,0;3,0;;;;;;;;;;;3,0;;;;1,0;;1,0;;;;;;;;;;;1,0;;;;;;;;;;;;;1,0;;;;;;;;;;;;;;;;;;;;;;;;;;;;;;;;;;11,0;;;;;2,0;2,0;;;;;;;;;;;;;5,0;1,0;;;;;;;;;;;;;;;;;2,0;;2,0;;;;;;;1,0;1,0;;;;;;;;2,0;;;;;;;;;;;;;;;;;;;;;;;;1,0;;;;;;;;;;;;;;;;6,0;;;;;;;;;;;;;;;;
reproduction;;;;;27,0;;;5,0;;;3,0;2,0;1,0;;5,0;;;;;1,0;3,0;30,0;1,0;;2,0;;;27,0;;3,0;4,0;6,0;122,0;;4,0;;;1,0;;91,0;;;;1,0;;;;1,0;;2,0;3,0;2,0;1,0;2,0;;132,0;7,0;;;1,0;;3,0;20,0;1,0;;;4,0;;;38,0;7,0;;3,0;;;3,0;;1,0;12,0;;;2,0;;;;;1,0;;;29,0;2,0;14,0;;41,0;;;;10,0;11,0;;;1,0;;;;;;56,0;;;;4,0;;;;;;;;1,0;;;4,0;3,0;;;2,0;;;;;;;;;;;;;1,0;;;7,0;;1,0;;5,0;156,0;;;;;;;;;;;;5,0;;;;;;;;3,0;;;8,0;;;1,0;1,0;;;2,0;;;4,0;;;1,0;;1,0;;;;1,0;;;;;;;;;;;;;;;;;;;;;;1,0;;;;37,0;2,0;;;;;;1,0;;;;;;;;;;;;;;;;4,0;;;;;;;;;;;;;;;2,0;1,0;;;;;;;10,0;;;;;;;;;;;;;1,0;;2,0;;;;;;;;;;;3,0;6,0;;;;;;;;;11,0;;;;;1,0;;1,0;;;;;;;;;;;;;;;;;;;5,0;;;;;;;2,0;1,0;;;;;;;2,0;;;1,0;;2,0;;;;;;19,0;;6,0;;;;;;;;;;;;;;8,0;;;;;;;;;5,0;8,0;;;;;2,0;;;3,0;;;;;;30,0;;3,0;;2,0;;3,0;1,0;1,0;;;;;;;;;;;;;;;;;;;;;3,0;;;;;;139,0;;;18,0;;;;;;;;;;;;;3,0;;;;;;;;;;;;;;;;1,0;4,0;23,0;;;3,0;;;;;;3,0;;;;6,0;;;;;10,0;;;;;;;6,0;;;9,0;2,0;;12,0;22,0;50,0;;1,0;18,0;;;;;;1,0;;;;;;;;;;;;;5,0;1,0;;;2,0;;;;;;;;;;;;;;;;118,0;;;;;;;;;;;;;;;;;;;;;;;;;;;;;3,0;;;;;;;;;;;;;;;;;;;1,0;;;;;;;;;;;;;;;;;;3,0;;;2,0;;;;;;;;;;;;;;;;;;2,0;;;;;;;;;;;;;;;;1,0;;;;;;;;;3,0;;;;;;;;;;;;;;;;;;;;;;;;;;;;;;;;;;;;;;;;;;;;;;;;;;;;;;;;;;;;;;;;6,0;;;;;;;;;;;;;;;;;;;;;;;;;;;3,0;;;;;;;3,0;;1,0;;;;;;;;;;;;;;;;;;;;;;;;;2,0;;;;;;;;;;;;;;;;;;;;3,0;;;;1,0;;;;;;;;;;;;;;;;;;;;;;;;;;;1,0;;;;;;;;;2,0;4,0;;;;;;;;;;2,0;;;;;;;;;;;;;;;;;;2,0;;4,0;;;;;1,0;;;;1,0;;;;;;;;;;;;;;;;;;;;;1,0;;;;;;;;;;;;;;;;;;;3,0;;;1,0;;;;;;;;;;;;;;;;;;;;;;;;;;;;;;;;;;;;;;;;;;;;;;;;;;;;;;;;;;;;;;;;;;;;;;;;;;;;;;;;;;;2,0;;;
request;;;;;42,0;;;15,0;1,0;10,0;;;;;;;;;;7,0;2,0;64,0;;;;;;66,0;;4,0;;48,0;38,0;;19,0;;;4,0;;43,0;;;;;;2,0;;;;7,0;1,0;8,0;1,0;1,0;;152,0;14,0;;;4,0;;1,0;44,0;;1,0;;1,0;;3,0;31,0;;;;;;1,0;;;10,0;;;10,0;2,0;;;;;;;41,0;;;1,0;47,0;;;;8,0;20,0;;;18,0;;45,0;1,0;;3,0;38,0;;;6,0;;;;;;;;;17,0;;;;4,0;;;15,0;;;;;;;;1,0;;;;;4,0;;;4,0;;1,0;;1,0;25,0;;;;;;;;2,0;;;;18,0;;;;;3,0;;;19,0;6,0;;;;1,0;;2,0;;;16,0;;;;;;;;;;12,0;;;;;;102,0;;;;;;;;;;2,0;;1,0;;;;;;;;;1,0;8,0;52,0;;;;;;;;;;;;;;;;;;;6,0;;;6,0;;;;1,0;;;17,0;;2,0;;;;;;9,0;;;;1,0;;;;;;;;;;;;;;;;;;2,0;;;;;4,0;;;;;1,0;2,0;3,0;1,0;;;;;;;;;7,0;;;11,0;;8,0;;;;;;;;5,0;;;;;;;;;;;1,0;;;;;;;;;44,0;;;;;;;1,0;;;;15,0;1,0;;;;;;;1,0;;10,0;2,0;;;;;;;;;;;;1,0;12,0;4,0;3,0;;;;;;;1,0;4,0;;;;;1,0;;1,0;1,0;;;;;;12,0;4,0;74,0;;1,0;;;;3,0;;;19,0;;;;;;;;;1,0;;;;;;;;;12,0;;16,0;1,0;9,0;15,0;3,0;;1,0;16,0;;;2,0;;;;6,0;;;;;;;;;;;5,0;;;10,0;2,0;;3,0;;23,0;;;4,0;;6,0;;;3,0;4,0;;;;;;5,0;;;2,0;;;11,0;3,0;2,0;;;3,0;;;;3,0;;;6,0;;;3,0;;15,0;;;37,0;4,0;;;;;1,0;2,0;;;;;10,0;;;;;;11,0;5,0;8,0;7,0;6,0;4,0;4,0;1,0;;;4,0;;1,0;;6,0;;;2,0;1,0;;;;20,0;;;;;3,0;;4,0;1,0;;;;;;3,0;4,0;;1,0;;;15,0;;1,0;;;;;;;;;2,0;3,0;;;21,0;;15,0;50,0;8,0;;1,0;;;;;;;;2,0;;28,0;;3,0;;41,0;2,0;;;;;;;;;;;;;;4,0;8,0;1,0;;;;;10,0;;;2,0;;6,0;;;;;;;;1,0;;;;5,0;;;;;;;;;;;;;;;;;;;;;;;;;;;;;;;;;;1,0;;;;;;;;;;;;;;;;;;;;;;;;;5,0;;;;;6,0;;;;;;;;2,0;;;;;;;;;14,0;;;;;;;;;;;;;;;;;;;;;;4,0;;;;;;;;;;;;2,0;;;3,0;;10,0;;;;;;;;;;;;;;;;;;;;;;15,0;;1,0;;;1,0;;1,0;;;;;;;;;18,0;1,0;;;;;;;9,0;;;;;;;;8,0;;;3,0;;;;;;;;;;;;;;;;2,0;;;;;;;;;;2,0;;;1,0;;;;3,0;;;;;;;;;;;;;;8,0;2,0;;;1,0;;;;;;;;;;;;;;;;;;;;1,0;;;;;;;;;;;;;;;;;;;;;;;;;;;;;;;;;;;;;;;;;;;;;;;1,0;1,0;;;;;;;4,0;;;;;;;;;;;;;;;;;;;;;;;;;;;;;;;;;;;;;;;;;;;;;;;;;5,0;;;;;;;;;;;;;;;;;;;
retract;;;;;2,0;;47,0;8,0;;3,0;3,0;1,0;;;;;;;;;3,0;28,0;;;;;;9,0;;2,0;;1,0;30,0;1,0;13,0;;;14,0;;4,0;3,0;;20,0;13,0;;;;1,0;;;;;;29,0;;40,0;13,0;;;295,0;;8,0;9,0;;;1,0;9,0;;;12,0;109,0;;52,0;;;12,0;;23,0;367,0;6,0;7,0;1,0;;;;11,0;8,0;;;;;4,0;7,0;3,0;1,0;4,0;;4,0;;;1,0;67,0;;;;;;64,0;;;1,0;;;19,0;;1,0;31,0;;;29,0;;3,0;8,0;;;;43,0;;;;3,0;;;26,0;;;1,0;;;;;;1,0;;9,0;3,0;16,0;99,0;;;;1,0;6,0;;9,0;60,0;2,0;13,0;2,0;28,0;1,0;;16,0;3,0;;;;23,0;;;62,0;74,0;3,0;3,0;20,0;29,0;6,0;;;;;2,0;;;3,0;3,0;;7,0;;50,0;;;;;;10,0;;;7,0;1,0;;10,0;1,0;8,0;1,0;;;;;8,0;;;;;;11,0;;;1,0;;;4,0;;;15,0;;;;;1,0;3,0;;2,0;1,0;;2,0;;5,0;6,0;;59,0;;2,0;2,0;;1,0;1,0;;;;;;;7,0;;;;;;1,0;;10,0;;;;1,0;35,0;;;;1,0;3,0;;;2,0;;;;6,0;7,0;2,0;;;16,0;;;26,0;9,0;6,0;;;;1,0;;;3,0;;36,0;;;;;2,0;17,0;;1,0;;;1,0;2,0;16,0;3,0;;79,0;1,0;2,0;5,0;;2,0;;;;8,0;7,0;;;;1,0;2,0;;1,0;;;;;;;;;1,0;;;;;;;;3,0;2,0;36,0;3,0;2,0;;;;;;1,0;;1,0;;;;;;;;;;;2,0;;;;3,0;;5,0;;;1,0;;4,0;;;;;;;;4,0;1,0;1,0;4,0;;3,0;;;;;;14,0;;5,0;;;;;1,0;1,0;;;3,0;;;;;;;1,0;;;;;1,0;9,0;;;;;;;;;;;;;;;;4,0;;;;1,0;;;4,0;;;;;3,0;44,0;4,0;;;;3,0;;;;2,0;3,0;;;67,0;;;;;4,0;1,0;;;;;;;;;;;;;3,0;5,0;;;;;5,0;4,0;4,0;;4,0;6,0;;;;3,0;;;;4,0;;;1,0;;1,0;;28,0;;;;1,0;3,0;;;1,0;;;;6,0;;4,0;;;;10,0;;;9,0;;;;1,0;;;;;;2,0;;;;1,0;;;1,0;;;;;;;3,0;;;;;;;;;;13,0;;;;;;;;;;;;;;;;3,0;;;1,0;;;;;;;;;;;2,0;;;;;;;;;;;1,0;;;;;;;;;;6,0;;;;;;1,0;;;;;1,0;1,0;;;;;;;15,0;1,0;;;;;;;;;;;;;;4,0;;;;2,0;;5,0;;;1,0;;;;;;;;;1,0;1,0;;;;;;;2,0;;;;;;;;;;4,0;;;;3,0;;;;;;;;;;;;;;;;;;;;;;;;;;;;2,0;;;1,0;;;;;;;;;;;;;;;;;;;;;;;;;;;;;2,0;;;;;;;;1,0;;;;;;;;;;2,0;;;6,0;;;;;;;;;;;;;;;;1,0;;;;;;;;;;;;;;;;;;;;;;;2,0;;;;;;;;;1,0;;;;;;;;;;;;;1,0;;;;;;1,0;;;;;;;;;;;;;;;;;1,0;;5,0;;;;;1,0;;;;;;;;;;;;;;;;;;;;1,0;;;;;;;;;;;;;;;;2,0;;;;;;;;;;;;;;;;;;;;;;;;;;;;;;1,0;;;;;;;;;;;;;;;;;;;;;;;;;;;;;1,0;;;;;;;;;;;;;;;;;;;;;;;;;;;;;;;;;;;;;;;;;
retrieve;;;;;1,0;;;1,0;;25,0;;;;2,0;;2,0;1,0;;5,0;2,0;2,0;1,0;;;16,0;;4,0;86,0;;1,0;;8,0;27,0;12,0;19,0;;2,0;;;15,0;5,0;;;2,0;;;;;;7,0;;;;;;148,0;7,0;;;6,0;;;18,0;;;;5,0;;;1,0;;;;;;;;;15,0;2,0;;3,0;12,0;;;;18,0;;;21,0;7,0;1,0;2,0;6,0;1,0;;;17,0;22,0;;;6,0;;;;1,0;5,0;5,0;;;;;1,0;;;;;;;;;;;6,0;;;4,0;4,0;;2,0;;;;;;3,0;;;;;;;4,0;;4,0;;;10,0;;;;;;;;;;1,0;21,0;2,0;;;;1,0;;;3,0;1,0;;;;;2,0;;;;;2,0;;;;;;;;;;4,0;;7,0;;;;1,0;;;;;;;;;;;;;;;;;;;3,0;;;2,0;2,0;;;;;2,0;;;;;;;;;;;;;5,0;;;3,0;8,0;;;;;;;;1,0;;;;;;;1,0;;;;;;;;;;;;;;;;;;;;;;7,0;18,0;;;;;;;;;2,0;;7,0;;;;;;;;;;6,0;;;;;3,0;;;;;7,0;;;3,0;4,0;;;;;;;;;;1,0;;;;2,0;;;;;1,0;;;;;;;1,0;;;;8,0;;4,0;4,0;1,0;;;;;;;;;;;4,0;;;;3,0;;;;3,0;4,0;;;;1,0;;;;;1,0;23,0;;;;;;;;;;;;5,0;;5,0;;;;;;;;15,0;;3,0;;;6,0;;;;;1,0;;;;1,0;;10,0;3,0;;3,0;;1,0;;8,0;;;4,0;1,0;;;;;;1,0;;;;;;;;2,0;;;;;;24,0;8,0;;1,0;1,0;;;1,0;8,0;;;;;;;;;;;;;;;;12,0;;;1,0;;;1,0;;;;;;;7,0;21,0;2,0;;;2,0;;;6,0;;;3,0;;2,0;6,0;;1,0;;;1,0;1,0;;;;;;;1,0;;;;;9,0;1,0;;;2,0;5,0;;;;;;;;;;;;;2,0;;;18,0;;;;;2,0;;;;;;;;;;;1,0;;;;12,0;;1,0;;;4,0;3,0;;;1,0;;3,0;;;;;;1,0;7,0;2,0;;1,0;;;;;;1,0;;2,0;;1,0;;;;20,0;1,0;;;;;;;;3,0;;;;;;;;;;;;;;;;;;3,0;1,0;;;;;;;;;;;1,0;;;;;;;;;;;;1,0;;;;;3,0;;;;;5,0;;;;;;;;;;;;;;;;;;;;;;;;;;;;;;;;;;;;;;;;;;;;;;;;;;;;;;;;;;;3,0;;15,0;;;;;;;;;;;1,0;;;;;;;;;;;;;;;;;;;;;;;;;;;;;;;1,0;1,0;;;;;;;;;;;;;;;;;;;;;;;;;;;;;;;;4,0;2,0;;;;;;;;;;;;;;;;;;;;;3,0;;;;;14,0;;;;;;;;;;;;;;;;6,0;;;;;;;;;;;;;;;;;;;;;;;1,0;;;;;;;;;;;;;;;;;;;;;;;;;;;;;;;;;;;;;1,0;;;1,0;;;;;;2,0;;;;;;;;;;;;;;;;;;;;;;;;;;;;;;;;;;;;;1,0;;;;1,0;;;;;;;;;;2,0;;;;;;;;;;;;;;;;;;;;;;;;;1,0;;;;;;;;;;1,0;;;;;;1,0;;;;6,0;;;;;
ring;;;;;24,0;;50,0;38,0;;;96,0;;1,0;;;4,0;;;2,0;;;16,0;1,0;;;;3,0;3,0;1,0;;;1,0;24,0;3,0;6,0;;10,0;40,0;;;28,0;;124,0;61,0;;;1,0;18,0;28,0;1,0;;8,0;;2,0;6,0;8,0;55,0;;23,0;295,0;;;7,0;;;56,0;8,0;3,0;;94,0;35,0;1,0;;7,0;8,0;12,0;;4,0;46,0;5,0;9,0;1,0;1,0;;;;10,0;1,0;;2,0;2,0;1,0;1,0;3,0;3,0;47,0;5,0;;2,0;;76,0;37,0;;37,0;;;8,0;28,0;;;20,0;3,0;2,0;50,0;45,0;;2,0;;11,0;30,0;2,0;;;15,0;;;15,0;14,0;;28,0;23,0;;;14,0;3,0;5,0;32,0;;;;1,0;;10,0;11,0;2,0;10,0;55,0;19,0;;1,0;;32,0;7,0;1,0;14,0;44,0;27,0;24,0;19,0;3,0;;2,0;155,0;14,0;;;6,0;28,0;;1,0;74,0;6,0;62,0;114,0;10,0;13,0;164,0;2,0;;;;3,0;8,0;1,0;3,0;2,0;49,0;31,0;;60,0;1,0;9,0;;26,0;;;;40,0;95,0;7,0;;41,0;;29,0;2,0;;1,0;41,0;9,0;70,0;;9,0;;2,0;59,0;2,0;2,0;;;2,0;13,0;;;12,0;7,0;;;;;3,0;4,0;;3,0;3,0;28,0;5,0;101,0;3,0;4,0;;23,0;9,0;2,0;26,0;3,0;;4,0;;5,0;8,0;;9,0;3,0;105,0;;;3,0;12,0;4,0;25,0;;17,0;6,0;29,0;17,0;9,0;31,0;6,0;7,0;3,0;1,0;13,0;;3,0;11,0;;;;;9,0;11,0;7,0;;28,0;;3,0;24,0;9,0;25,0;1,0;1,0;1,0;5,0;;;;;;2,0;4,0;2,0;;4,0;7,0;4,0;9,0;1,0;;12,0;4,0;;3,0;1,0;10,0;;;20,0;6,0;18,0;13,0;7,0;4,0;28,0;1,0;;3,0;2,0;3,0;1,0;;7,0;4,0;3,0;;;;;;;8,0;;12,0;3,0;;;2,0;;3,0;;2,0;4,0;;;;;12,0;;;2,0;;;;;;;1,0;;;;;;;;2,0;;2,0;1,0;;;;;;;;;;;;;2,0;1,0;;18,0;6,0;;9,0;;2,0;1,0;;;;;;;;13,0;14,0;;;2,0;6,0;;;;;;;;;;;;11,0;2,0;;;;;;;1,0;;;;33,0;;;;;2,0;;;;3,0;3,0;;;;;;;;2,0;;;;;;;;;;;;11,0;69,0;;2,0;;;6,0;;;;;;;;;;;;;;110,0;;;;2,0;;;;8,0;2,0;3,0;;;;;;;;;61,0;11,0;;4,0;;1,0;2,0;;;;;1,0;1,0;;;;;;;;;;1,0;;;;;;;3,0;;;6,0;2,0;;;;;4,0;19,0;;;1,0;;;;;;4,0;;1,0;1,0;1,0;2,0;3,0;;;;;;3,0;;20,0;;1,0;;;;;;11,0;;28,0;;;;;;11,0;;;;2,0;;;;;;;8,0;;;;2,0;2,0;7,0;;;1,0;3,0;4,0;;6,0;3,0;4,0;;29,0;3,0;;;;;1,0;8,0;2,0;;;;;11,0;;6,0;;1,0;;;;2,0;8,0;82,0;2,0;3,0;2,0;;23,0;4,0;4,0;1,0;;;;;;;20,0;;;1,0;12,0;;2,0;;4,0;2,0;;;;;;31,0;;5,0;;;;;;;1,0;2,0;5,0;1,0;;;;;;;;;;;;;1,0;;;20,0;;;;;;;;;1,0;;;;3,0;1,0;;;;1,0;;;;;;;;;;1,0;;;;;;;;;;;2,0;;;;2,0;;;;;2,0;;1,0;;;;;;;;;;;;;;;;;9,0;7,0;;;;1,0;;;;;;;;;3,0;6,0;;21,0;;3,0;90,0;;;;;;;;;;;;;;;;;;;1,0;;;;;;1,0;;;2,0;;;;;;;;;;;1,0;;;2,0;;1,0;1,0;;;3,0;;1,0;;;1,0;;9,0;;;;9,0;;3,0;;;5,0;;;;1,0;;;27,0;6,0;;;1,0;;;13,0;;9,0;;13,0;;;;2,0;;;;1,0;4,0;;;;;;;6,0;;10,0;;;;;2,0;9,0;;;;;;;7,0;;;;;4,0;;;20,0;;5,0;2,0;4,0;2,0;;5,0;;;;10,0;;;;;1,0;3,0;;12,0;;;;;;;;10,0;1,0;;9,0;;;;;1,0;;;;;;;;;;;;;4,0;;;3,0;;;;;;;;;;;;;;;;;;;;;;;;13,0;;;;;;;;;;;;;;;;;;;;;;;;;
robot;;;;;6,0;;4,0;8,0;34,0;35,0;33,0;;;;;1,0;;;9,0;1,0;;52,0;12,0;9,0;;;;;3,0;14,0;5,0;12,0;4,0;;;;;3,0;;33,0;3,0;;;;;;;;;;;2,0;;;5,0;53,0;19,0;;;;;;15,0;;;;10,0;;2,0;2,0;;3,0;;;;;;1,0;63,0;1,0;;3,0;;;;;;2,0;;;2,0;;;;2,0;1,0;;1,0;;;12,0;35,0;;6,0;;;;3,0;;;;;;;7,0;;;;;18,0;;;1,0;;;;;;;25,0;;1,0;;;1,0;;2,0;;;;;;5,0;;;;;;;;;;;;;;;;1,0;;1,0;;;;;;;3,0;1,0;;;;8,0;5,0;4,0;4,0;;;;;;;;;;;;;;;;;;3,0;;;;;1,0;;;;;;;;;;;19,0;;;;;2,0;5,0;6,0;;2,0;;;1,0;;;;1,0;;;1,0;;;;;;;;;;;;;;;;;;;;;;;;;3,0;;;2,0;1,0;;;;2,0;;;;;;;;;;;;;;3,0;;;;2,0;;;;1,0;;1,0;9,0;3,0;1,0;;;;;;;5,0;;4,0;;;;;1,0;;;;;;;;;;;;;;;;;;;1,0;;;;4,0;;;;;3,0;;;;;;;;;;;3,0;;;;;;;8,0;;2,0;6,0;;2,0;;;;;;2,0;;;;;;;;;2,0;;;;;;1,0;;;;;3,0;;;;;;;;;;10,0;1,0;2,0;3,0;;;;;5,0;;;;;1,0;;;;;2,0;;;20,0;;;;;;;;;;5,0;;;123,0;;;;;;;;;21,0;;;;;;;;;;;;;10,0;;;;4,0;;;19,0;2,0;;;;1,0;;;;;;;16,0;25,0;;;;;;2,0;15,0;;2,0;26,0;;;;;;;;;;1,0;;2,0;;3,0;9,0;;;;;23,0;;;;;;;;;;;;;;;4,0;;;;6,0;;;;;;;;;;;;;;;;1,0;;;;;;2,0;;;;;;;;;;;4,0;;;;;;1,0;9,0;;;;;;;;;;;;;;;;;;;;;;;;;39,0;;;;;;;;;;;;;;3,0;;;;;;;;;;;2,0;;;;;;;;;;;;21,0;;;;;;;;;;;;;1,0;;;1,0;;2,0;;;37,0;;;;;;;;;;;;;;;;;;;;;8,0;;5,0;;;;;;;;;;;;;;;;;;;;;;;;3,0;;;;;;;;;;;;;1,0;;;;;;;;;;;;3,0;;;;;;;;;;;;;;;;;;;;;;;;;;;;1,0;;;;;;;;;;;;;;;1,0;1,0;;;;;;;;1,0;7,0;;;;;;;;;;;;;15,0;;;;5,0;;;;;;;;1,0;;;;;;;;;;;;;;;;3,0;;;;;;;;;;;;;;;;;;;;;;;;;;;;;;;;;;;;;;;;;;1,0;;;;;;;;;;;;4,0;;;;;;;;;;;;;1,0;;;;;;3,0;;;;;;;;;;;;;;;;;;;;;;;;;;;1,0;;;;;;;;;;;;;;;;;;;;;;;;;;;;;;;;;;;;;;;;;;;;;;;;;;;;;;;;;;;;;;;;;1,0;;;;;;;;;;;;;;;;;;;;;;;;;;38,0;;;;;
roller;;;;;10,0;;3,0;10,0;;;;;;;;;;;;;;6,0;;;;;2,0;;;;;;3,0;;;;4,0;2,0;;;3,0;;51,0;2,0;;;;;;;;;;;;2,0;19,0;;;;;;1,0;;;;;;;;;;9,0;;;;;;5,0;;;;;;;;;;;;;;;;;;;;;;18,0;3,0;;;;;;9,0;;;;5,0;;27,0;6,0;5,0;;;;6,0;;;;;;;8,0;18,0;;;2,0;;;;;;1,0;;;3,0;;;;2,0;;;27,0;;;;;;3,0;1,0;;;;2,0;;;;;;;;;2,0;1,0;;;1,0;;8,0;16,0;;;;;;;;;;;;;6,0;6,0;;13,0;;;;8,0;1,0;;;;;;;3,0;;20,0;;;8,0;;;7,0;;;;;;;;;;;7,0;;;;1,0;;;;;2,0;;;;3,0;;;;;;;;;;;;;;;;;;;;2,0;1,0;;1,0;4,0;;;;10,0;;;7,0;;1,0;;;1,0;;6,0;;;;;;1,0;;2,0;;;;12,0;;;2,0;;;7,0;;;;;;;;;;;;;;;;;1,0;2,0;6,0;1,0;;9,0;2,0;2,0;;;1,0;;;;;1,0;;;;;;;4,0;;;;;;;;;;;;;16,0;;;;;;3,0;;;2,0;;;;;;;;;;;;1,0;;;;;;;;;;;;;;;;;;;;;;;;;;;;;;1,0;;1,0;;;;;;11,0;;;;;;;;;;;;;;;;;;;;;;;;;;;4,0;;;;;;;;;;;;;;;6,0;;;;;;;;;;;10,0;;;;;;;;;;;;;;;;;;;1,0;;;;11,0;;;;1,0;;;;;2,0;;;;;;;;;;;;;;;2,0;;;;;;;;;4,0;1,0;;;;;;;;;;;;;28,0;;;;;;;;;;5,0;;;;;;;;;;;;;;;;;1,0;12,0;;;;;;;;;;;7,0;;;;;;;;7,0;;;;;;4,0;;;;;;;;;;;;;;;;;;;;;;;1,0;;;;;;;;;;;;;;;;;;;;;;;;;;;;;;;;;;;;;;;;;1,0;;;;;;;1,0;;;;;;;;;;;;;;2,0;;;;;;;;;;;;;;;;8,0;;;;;;;;;;;;;;;;;;;;;2,0;;;;;;;;;;;;;;;;;;;;;;;;;;;;;;;;;;;;;;;;;;;;;;;;;;;;;;;;;;;1,0;;1,0;;;;;;;1,0;;;;;;;;;2,0;;;;;;;;;;;;;;;;;;;;;;;;;;;;;;;;;;;;;;;;;;1,0;;;;;;;;;;;;;;;;;;;;;;;;;;;;;;;;;;;;;;;;;;;;;;;;;;;;;;;;;;;;;;;;;3,0;;;;;;;;;;;;;;;;;;2,0;;;;;;;;;;;;;;;;;;;;;;;;;1,0;;;;;;;;;;;;;;;;;;;;;;;;;;;;;;1,0;;;;;;;;;;;;;;;;;;;;;;;;;;;;;;;2,0;;;;;;;;;;;;;
rotary;;;;;5,0;;41,0;61,0;;1,0;10,0;;3,0;;;;;;2,0;1,0;;79,0;;1,0;4,0;;1,0;3,0;;24,0;3,0;;27,0;;5,0;;;79,0;;;7,0;;13,0;17,0;;;;;;;5,0;1,0;;1,0;;6,0;12,0;;;24,0;;;;;;9,0;7,0;;;52,0;15,0;1,0;2,0;2,0;1,0;2,0;;5,0;42,0;3,0;;;;;;1,0;2,0;;;;1,0;6,0;;30,0;2,0;4,0;;2,0;4,0;;10,0;6,0;;5,0;;;;36,0;;;;;;7,0;2,0;;8,0;;1,0;17,0;;10,0;2,0;5,0;;;5,0;8,0;;8,0;8,0;;;;;11,0;16,0;;;;;;;3,0;1,0;3,0;17,0;2,0;;;;4,0;5,0;;4,0;4,0;9,0;8,0;;1,0;;;6,0;1,0;;;;;;;54,0;;41,0;2,0;7,0;3,0;4,0;8,0;;;;;1,0;;;6,0;1,0;2,0;;30,0;;1,0;;1,0;1,0;;;;33,0;2,0;;1,0;;11,0;8,0;;;;;42,0;;2,0;;;2,0;3,0;9,0;;;1,0;;1,0;;;;;;;;;;;6,0;;1,0;1,0;;3,0;;;15,0;1,0;;2,0;;13,0;;1,0;5,0;3,0;;;;15,0;;;3,0;;;;;21,0;;3,0;5,0;;4,0;1,0;3,0;;;;;;5,0;;;3,0;4,0;;19,0;2,0;;4,0;;7,0;4,0;;6,0;;;4,0;1,0;;;;;;;;;;1,0;1,0;;;;2,0;3,0;;;3,0;1,0;;2,0;;3,0;3,0;1,0;;2,0;;85,0;5,0;;;;1,0;3,0;6,0;;;2,0;;;;;;;2,0;;;2,0;;2,0;;;;;23,0;2,0;;;;;;;;;;;;;;;3,0;;;3,0;;;;;;;;;;;8,0;1,0;;5,0;;;;;;;1,0;;;9,0;;;3,0;;;;;;;1,0;;;;2,0;;;;2,0;;;;;;;;19,0;;;;;10,0;3,0;;;1,0;;;;;;;;;;;;2,0;4,0;;59,0;;;10,0;;2,0;;5,0;;;1,0;4,0;;;;;2,0;;;;;;;3,0;4,0;;;;;1,0;;;;;3,0;;;;;;;;;16,0;;;;;1,0;;;;14,0;2,0;;;;;;;;;;;;9,0;;;;;;;2,0;1,0;1,0;;;;;;;;;;;;;;;;;;;;;;;;;1,0;;2,0;1,0;;2,0;;;;;2,0;;;;;;;;;;;;;;;14,0;;;;;2,0;;;1,0;;1,0;;;;;;;;;;;;;;1,0;;3,0;1,0;;;;;;1,0;;;;;;;;;5,0;;1,0;;;;;;30,0;1,0;1,0;;;;;1,0;;;7,0;;5,0;;;2,0;;3,0;;;;1,0;;;;;1,0;;;;;;;;4,0;;;6,0;2,0;;;;;;;;;;;;;;;;;;;;2,0;;;;;;;;;;;;;;;;;1,0;;;;;;5,0;;;;;;;;;;;;;;;;;;;;;;;;;;;;;;;;;;;;;;;;;;1,0;;;1,0;;;;;;;;;2,0;;;;;;;;;;;;;;;;;;;;;;;;2,0;;1,0;;;;;;;;;;;;;;;;32,0;;;;;;;2,0;;;6,0;;;;;1,0;;;;;5,0;;;;;2,0;;;;;;;;;;;;;2,0;;;;;;;4,0;;;7,0;1,0;;;;;;;;1,0;2,0;;;;;;;;;;;;1,0;;;;;5,0;3,0;;;;;;;;;;;;;2,0;;8,0;;;;;;;;;;;;;;;2,0;;;;;;;;;;;;;;;;;;;;;;;;;;;;;;;;;;;;;;;;;;;;;;;;;;;;;;;;;;;;2,0;;;;;;;;;;;;;;;;;;;;;;;;;;;;;;;;;;;;;;;;
rotatable;;;;;15,0;;126,0;23,0;;3,0;8,0;;5,0;;1,0;2,0;;;18,0;3,0;;4,0;4,0;;;;2,0;;5,0;;;;18,0;;7,0;2,0;;37,0;2,0;12,0;2,0;;17,0;21,0;;;;;;;1,0;;;1,0;;9,0;17,0;;;37,0;9,0;;4,0;;;16,0;;;;2,0;30,0;;1,0;;;;;14,0;38,0;3,0;5,0;;;1,0;;3,0;;10,0;;1,0;11,0;;;1,0;;2,0;;;;;17,0;12,0;;;;;1,0;11,0;;;;4,0;;33,0;6,0;;;;3,0;82,0;;3,0;;2,0;;;2,0;8,0;;32,0;18,0;;;11,0;3,0;1,0;7,0;;;1,0;;;;3,0;12,0;3,0;5,0;22,0;;;;1,0;2,0;;5,0;;6,0;52,0;2,0;6,0;;;6,0;3,0;1,0;1,0;1,0;7,0;;1,0;107,0;8,0;9,0;25,0;4,0;1,0;10,0;1,0;;;3,0;;8,0;1,0;39,0;11,0;21,0;2,0;;31,0;2,0;6,0;;5,0;;3,0;;;57,0;8,0;;7,0;;10,0;2,0;;2,0;25,0;21,0;59,0;;1,0;;;15,0;;1,0;;;;2,0;;;;;;;;1,0;1,0;1,0;;3,0;;2,0;16,0;8,0;2,0;;;7,0;5,0;12,0;3,0;2,0;5,0;;;;3,0;;;;23,0;;;1,0;2,0;2,0;1,0;;2,0;1,0;1,0;13,0;1,0;8,0;;2,0;;;2,0;2,0;3,0;;;;3,0;;8,0;3,0;2,0;;28,0;;7,0;5,0;2,0;9,0;1,0;;10,0;;;;2,0;;4,0;;1,0;;2,0;1,0;4,0;3,0;1,0;1,0;3,0;7,0;6,0;2,0;4,0;5,0;2,0;20,0;1,0;;11,0;2,0;;2,0;;68,0;;;4,0;;1,0;;2,0;2,0;;14,0;;;;;2,0;;2,0;1,0;;;;;;;;;2,0;4,0;;;;;;;;7,0;;;;;;;;;;;;;;;;;;;;;10,0;;;;;;;;;;1,0;3,0;1,0;32,0;;9,0;;;3,0;;;1,0;;;;;;;2,0;1,0;;;8,0;;;;;;;3,0;5,0;4,0;;;3,0;1,0;;;;;;;;;;;1,0;;;;;6,0;;;;2,0;;;;;;;;;5,0;1,0;;;;;;;;;;;4,0;11,0;;;;;2,0;;;;;;;;;;;;;;33,0;2,0;;;;;7,0;;1,0;8,0;;3,0;;;;;;;;20,0;7,0;;;;;4,0;;;;2,0;13,0;5,0;;;;;1,0;;;;;5,0;5,0;;;;;7,0;;;;28,0;1,0;;;;;;4,0;2,0;;10,0;;;;;;;;;;;;;;;;;;1,0;;58,0;;;;;;;;;;8,0;;;;;;;;;1,0;2,0;;;;;;7,0;;;1,0;;;;;;;2,0;;;;;;;;;1,0;;;;;2,0;;;;;6,0;;;;2,0;;;4,0;;;4,0;4,0;1,0;;1,0;12,0;;3,0;1,0;1,0;;;9,0;;;;;;;;;;12,0;2,0;;;;;1,0;2,0;1,0;;;;;;;;;;;;;8,0;;;;;;;;;;;;;;;;;;;;;;;11,0;;;2,0;;;;;;;;;;;;;3,0;;;;2,0;;1,0;1,0;;6,0;;;1,0;;;;;;;;;;;;;;;;;;;;;2,0;;;;;;;;;;;;;;;;;;;;;;;;;;1,0;;;10,0;;1,0;1,0;;;;;;;;;;;;;;;;;;;3,0;;3,0;;;;12,0;;;;1,0;;;;;;;2,0;;;;;;;2,0;;1,0;;;;;;;2,0;6,0;;;3,0;;;;1,0;;;;;3,0;;;;;;6,0;;;;;;;10,0;;1,0;4,0;2,0;;;;2,0;;;2,0;;;;;;;1,0;;;;;;1,0;1,0;;3,0;7,0;;3,0;;;;;1,0;;;;;;;1,0;1,0;;;;;;;6,0;;;;;;;;;;2,0;;;;;;;;;;;;;;;;;;;;;;;;;;;;;;;;;;;;;;;2,0;;;;;;;;;;;;;;;;;1,0;;;;;;;;;;;;;1,0;;;;;;;;;;;;;;
rotatably;;;;;6,0;;8,0;28,0;;1,0;4,0;;6,0;;;;;;;4,0;;2,0;;2,0;;;;;;;;;22,0;;;;;10,0;;18,0;;;11,0;6,0;;;;1,0;;;;;;;;6,0;13,0;;;34,0;5,0;;3,0;;;11,0;2,0;;;4,0;12,0;;1,0;;3,0;;;2,0;7,0;;;2,0;;;;2,0;;;;1,0;3,0;;1,0;1,0;;4,0;;;;1,0;13,0;11,0;;;;;;31,0;;;1,0;2,0;;14,0;32,0;;;;2,0;80,0;;5,0;2,0;2,0;;;8,0;1,0;;48,0;27,0;;;3,0;;2,0;25,0;11,0;;;;;;3,0;2,0;5,0;11,0;13,0;;;;7,0;7,0;;5,0;11,0;17,0;52,0;;3,0;;;7,0;4,0;;;;;;;63,0;;9,0;78,0;2,0;4,0;5,0;;;;2,0;;1,0;1,0;5,0;4,0;17,0;1,0;;31,0;1,0;5,0;;22,0;;;;;15,0;;;3,0;;15,0;6,0;;;;1,0;68,0;;4,0;;;8,0;;;;;2,0;3,0;4,0;;;5,0;;2,0;;;;;;2,0;3,0;5,0;9,0;9,0;3,0;;;9,0;2,0;2,0;9,0;;3,0;1,0;;4,0;;;;;85,0;;;3,0;3,0;1,0;;;12,0;;3,0;14,0;;1,0;1,0;2,0;2,0;;1,0;;1,0;5,0;4,0;;3,0;;;6,0;5,0;;3,0;;;1,0;3,0;5,0;3,0;;;;;;;;;;8,0;;3,0;;1,0;;2,0;;;1,0;1,0;;3,0;;4,0;9,0;;7,0;16,0;2,0;;5,0;;30,0;1,0;;;;3,0;;4,0;;4,0;13,0;;;;;;;;;;;;;;;;;;3,0;;;;;;;;4,0;;;;;;;;;;;;;;;;;;;;;;;3,0;;;;;;;;1,0;;;8,0;2,0;21,0;;;;;;;;;;;;;;;;;;9,0;5,0;;;;;1,0;;;;;;1,0;;;;;;;;;;;;;;;;;;;;;;;;;;;;;1,0;;;;;;;;;;;;;5,0;;;;;;2,0;;;;2,0;;;;;;;;;7,0;;1,0;;;;;;10,0;;1,0;;;;;;;;;8,0;5,0;;2,0;;;3,0;;;;;2,0;1,0;;;;1,0;6,0;;;;;2,0;2,0;;;;;;;;;2,0;;;;;;;11,0;2,0;;11,0;;;;;2,0;;;1,0;;;;;;;;;;3,0;;3,0;;;;5,0;;;;1,0;;;;;;;;;;;5,0;;;;;;;3,0;;;;;;;1,0;;;;;6,0;;;;2,0;;;;;;;;;;;;;;;;;1,0;3,0;;;;;;8,0;1,0;;1,0;;14,0;4,0;;;;;3,0;;;;;;;;;;6,0;;;;;;;1,0;;;;1,0;;;1,0;3,0;;9,0;;;;1,0;;;;;;;;;;;;;;;;;;;;;2,0;;;;;;;;;;;;;;;;;;;;;;;;;;;3,0;;;;;;;;;;;;;;;;;;;;;;;;;;;;;;;;;;;;1,0;;;;;;;;;;;;;;;;;4,0;;2,0;1,0;;;2,0;;1,0;;;;;;;;;;;;;;;;;;;;;;;2,0;;;;;;;;2,0;;;;;;;;;;;;2,0;;;;;;;2,0;;;;;;;;;;;;;;;;4,0;;;;;;;;;;;;;;;;;;;;1,0;;;3,0;;1,0;;;;;;;;;8,0;;;1,0;;;;;;;;;;;;;4,0;;;;;;;;;;;;;;;;;;;;;;;;;;;;;;;;;;;;;;;;;;;;;;;;;;;;;;;1,0;;;;;;;;;;;;;;;;;;;;3,0;;;;;;;;;;;;4,0;;;;;;;;;;;;;
scale;;;;;20,0;;3,0;13,0;12,0;8,0;1,0;;;;6,0;;;2,0;2,0;4,0;;11,0;;4,0;7,0;;;37,0;2,0;4,0;1,0;32,0;28,0;17,0;10,0;;1,0;;8,0;67,0;34,0;1,0;5,0;2,0;;;;4,0;144,0;;12,0;27,0;;;;224,0;22,0;;10,0;59,0;2,0;4,0;44,0;;12,0;;;;;13,0;13,0;2,0;;;;;;13,0;41,0;;;9,0;12,0;2,0;1,0;;29,0;3,0;9,0;12,0;5,0;;;18,0;11,0;;;;2,0;1,0;3,0;13,0;;1,0;;;7,0;55,0;;;1,0;10,0;3,0;10,0;2,0;2,0;;;;2,0;;;1,0;8,0;;;21,0;;;;2,0;;;;;;6,0;;;;;;;1,0;18,0;;6,0;12,0;;;;;;;;;;5,0;;7,0;;6,0;;;;;9,0;2,0;1,0;;1,0;;7,0;6,0;27,0;;1,0;10,0;11,0;;;;1,0;2,0;8,0;3,0;3,0;14,0;;11,0;;;;8,0;;;;;20,0;2,0;;4,0;;3,0;;;;;;15,0;7,0;;;1,0;2,0;23,0;3,0;;;;4,0;;;1,0;;;;;;;;;;5,0;6,0;9,0;;;8,0;;;;;;;;;8,0;;;3,0;3,0;;4,0;5,0;;;7,0;7,0;;13,0;;;;;;7,0;;;;;1,0;;;1,0;1,0;;;;2,0;;;;;4,0;;1,0;14,0;5,0;2,0;;;;10,0;;;;;;;;;19,0;2,0;;;;27,0;1,0;2,0;18,0;37,0;;;;;;;;2,0;;1,0;;;2,0;4,0;;;;3,0;4,0;6,0;;;;;;;;3,0;;1,0;;;2,0;;1,0;2,0;;8,0;;3,0;4,0;5,0;;1,0;4,0;;;;2,0;2,0;;;1,0;4,0;;;;4,0;;;4,0;11,0;2,0;1,0;6,0;;;1,0;;;3,0;;;;2,0;;2,0;;;1,0;;;;8,0;7,0;1,0;1,0;;3,0;;;4,0;3,0;;6,0;48,0;;;5,0;;6,0;;;;14,0;;15,0;;4,0;;4,0;1,0;2,0;;8,0;3,0;13,0;13,0;;;;;;;1,0;1,0;;;;;;;;;1,0;7,0;;;;;1,0;;;;;;1,0;;;1,0;;1,0;;;2,0;;8,0;;;18,0;;;;;;;;;;2,0;;1,0;;7,0;4,0;;;;;;;;5,0;8,0;;;;3,0;;;;;;1,0;;;;;;;;1,0;;;;;;;;2,0;;6,0;;;;;2,0;;;3,0;;;;;;;;;;1,0;;;;;;;;;4,0;2,0;;;3,0;;2,0;;;15,0;52,0;;2,0;;;;29,0;;;;;;1,0;2,0;;;;;;;1,0;2,0;16,0;;;9,0;;;14,0;2,0;;;;3,0;;;;;;;;;2,0;;;;;3,0;1,0;;;;;;;;1,0;;;12,0;;;;4,0;;;;;;;;;1,0;3,0;;;;;;;;;;;;;;1,0;4,0;;8,0;;;;;;;;2,0;;1,0;;;;;;;;;;;;;;;;14,0;9,0;;;;;13,0;;;;;;;;;1,0;1,0;;114,0;;;2,0;;;7,0;;;2,0;6,0;;;;7,0;17,0;;;;4,0;;1,0;;;;;;;;1,0;;;;;;;1,0;;2,0;;;;2,0;;1,0;;4,0;;;;;;3,0;9,0;;;;;;;;5,0;2,0;;;;;;;;;;;3,0;;;3,0;1,0;;;;;4,0;;;;1,0;;;;1,0;;;;4,0;;;;;;1,0;15,0;;;4,0;;1,0;;;;4,0;2,0;;;;1,0;;;;;;;;;;;;1,0;;;;;;;;;;1,0;;;;;;;1,0;;;5,0;;;;;;;;4,0;;;;;18,0;;1,0;;2,0;;;;;;;;;;;;1,0;;;;;;4,0;;;;;;;;;;;;;;;;;;7,0;;5,0;;;;11,0;;;;;;;;;;51,0;;1,0;;2,0;10,0;;;;;;;;;;;;;;;;;;;;;;;;;;;;;;6,0;;;;;;;;;;1,0;;;;;;;;4,0;;;;;;;;4,0;1,0;;;;;5,0;;;;;;;;;;;;;;;1,0;;;;;;;
scanner;;;;;6,0;;5,0;1,0;1,0;3,0;;1,0;;2,0;;;;;1,0;2,0;;1,0;;;;;;4,0;2,0;;;1,0;6,0;;13,0;1,0;;5,0;;;;;;;;;;;;;3,0;9,0;;;;44,0;15,0;;2,0;1,0;;;11,0;;;1,0;;;;1,0;7,0;;;1,0;;;;6,0;4,0;;;;;;;1,0;;;;;4,0;;;;;2,0;;;3,0;;2,0;4,0;;;;;;10,0;;;1,0;3,0;3,0;;;;;;;1,0;;;;;;;;;;;;;;;;;6,0;;;1,0;;;3,0;1,0;;;2,0;;;;;;;;1,0;;;3,0;;2,0;1,0;;;2,0;;;;13,0;;;1,0;4,0;2,0;8,0;;;;;;;;;1,0;;;;2,0;3,0;;4,0;;;;6,0;;;;;;;;3,0;1,0;;;;;;2,0;4,0;;;;;;5,0;;2,0;;;;;;;;;4,0;;;;;;;;;5,0;;;1,0;;;;1,0;;;;;;;;;;;;;;;;;;1,0;;2,0;;;;1,0;;;7,0;;;;;1,0;2,0;;;;;;;;;;1,0;1,0;;1,0;1,0;;;;;;;;1,0;;;;;;;;;;;;;;;;;;;;;;;;;;;;8,0;;;;;;;;;;;;;;;;1,0;;;;2,0;;;;;2,0;;;;;;;2,0;;1,0;1,0;;;;;;;;;;;;;;;2,0;1,0;3,0;;1,0;;;;;;;;;;4,0;;;;;;2,0;;4,0;;;;;;;;;;1,0;;;;;;;;;;;;4,0;;;;;;;;2,0;;;;1,0;;;;;;;;;;;;;;1,0;;;;;;;;;;;;;;;;;;;;;2,0;;;;;;;;;;;;;;;;;;;5,0;;;;;;;;;1,0;4,0;;;;;;;;;3,0;;;;;;;;;;;;;;;;1,0;;;2,0;;;;;;;;;;3,0;;;;;;;;;;1,0;;;;;;;3,0;;;;;;;1,0;;;;;1,0;;;;1,0;;;;;;;;;;;1,0;;;;;2,0;;;;;;;;;;;;1,0;;;;;;;;;;;;;;;;;;;;;;;;;;;;;;;;;;;;;;;;;;3,0;;;;;;;;;;;;;;;1,0;;;;;;;;;;;;;;;;;;;;;;;;;;;;;;;;;1,0;;;;;;;;;;;;;;;;;;;;;;;;1,0;;;;;11,0;;;;;;;;;;;;;2,0;;;;;;;;;;;;;;1,0;;;;;;;;;;;;;6,0;;4,0;;;;;;;;;;;;;;;;1,0;10,0;;;;;;;;;;;;;;;;;;;;;;;;;;;;;;;;;;;;;;;;;;;;;;;;;;;;;;;;8,0;;2,0;;;;;;;;;;;2,0;;;;;;;;;1,0;;;1,0;;;;;;;;;;;;;;;;4,0;;;;;;;;;;;2,0;;;;;;;;;;;;;;;;;;;;;;;;;;;;;;;26,0;;;;;;;;;;;;;;;;;;;;;;;;;;;;1,0;;;;1,0;;;;;;;;;;2,0;;;;;;;;;;;;;;;;;;;;;;;;;;;;;;;;2,0;;;;;;;;;;;;;;
screw;;;;;28,0;;25,0;18,0;;;3,0;;;;;1,0;;;1,0;1,0;;;;;;;1,0;;1,0;6,0;;;18,0;;2,0;;;8,0;;;;1,0;15,0;25,0;;;1,0;;5,0;;;1,0;;8,0;;;41,0;;;92,0;;;10,0;;;18,0;10,0;2,0;;3,0;17,0;;;2,0;2,0;;;;23,0;12,0;3,0;;;;;;;;;6,0;3,0;;;;;;;;;;13,0;1,0;;2,0;;;3,0;9,0;;;8,0;9,0;;12,0;25,0;;;;5,0;10,0;;;;2,0;;;6,0;12,0;;15,0;2,0;;;4,0;1,0;1,0;21,0;1,0;1,0;1,0;;;2,0;8,0;;16,0;36,0;8,0;;;;2,0;12,0;;7,0;40,0;130,0;15,0;;1,0;2,0;;21,0;5,0;;;1,0;4,0;;;112,0;4,0;16,0;88,0;7,0;5,0;24,0;7,0;;;2,0;;18,0;;;1,0;24,0;15,0;;143,0;;4,0;;31,0;1,0;;;1,0;39,0;3,0;;9,0;;21,0;2,0;;6,0;16,0;15,0;32,0;;2,0;;;;1,0;6,0;;;4,0;3,0;1,0;;;6,0;;;;;2,0;3,0;;;1,0;7,0;3,0;1,0;;;;30,0;10,0;;9,0;;1,0;;;32,0;2,0;1,0;7,0;;25,0;;2,0;6,0;8,0;;12,0;;30,0;1,0;6,0;57,0;11,0;17,0;15,0;3,0;;;2,0;;4,0;11,0;;;;;3,0;5,0;;;7,0;;;28,0;;;14,0;;1,0;;;;;;;;1,0;;1,0;4,0;6,0;;5,0;4,0;1,0;6,0;4,0;;3,0;2,0;9,0;18,0;;2,0;;;1,0;2,0;;11,0;10,0;;2,0;4,0;6,0;;;;;1,0;;;;;;;;;;;;;;;1,0;;1,0;;;;;;;;;;;;;1,0;;;;;;1,0;;;2,0;;;;;2,0;;;3,0;;1,0;;;;;;;;;;;19,0;1,0;;;;;;;;;1,0;;;;;4,0;;;3,0;1,0;11,0;7,0;;;;;1,0;1,0;;;;;;;;;;;;;;;;;;;;1,0;;;;;;;;;;;;;;2,0;1,0;;;;;;;;;;;1,0;5,0;;;;4,0;;;;;;;;;;;;;;;21,0;;;;;;;;3,0;;;;;;;;;;;;2,0;;4,0;;1,0;15,0;;;1,0;;3,0;9,0;;;;;;;;;;;;;;1,0;;1,0;;;;2,0;;;;;2,0;;4,0;3,0;;1,0;;;;;;1,0;;;4,0;2,0;;;;;;;;;;9,0;;3,0;;;;;;;;;;;;;;;;;;94,0;;;;;3,0;;;;;;;5,0;2,0;;;;;7,0;;;;;1,0;4,0;18,0;1,0;;;;;;2,0;;;;;;1,0;;10,0;1,0;1,0;15,0;;6,0;;53,0;;7,0;1,0;1,0;4,0;1,0;;;;;;;;1,0;;;;;;1,0;2,0;;2,0;;;;1,0;;;;;;;;;;;;;;;;;;;;;;;;;;;;;;;;;;;;;;;;;;;;;;;1,0;;;;1,0;;;;;;5,0;;;;;;;;1,0;;;;;;;;;;;;;;;;;;;;1,0;;;;;;1,0;;;;;;;;;;;;;;;;;;;;;1,0;;;28,0;;;;;;;;;;;;;;;;;;;;;;;;;;;;1,0;;;;;;;;;;;;;;;;;;;;;;;2,0;1,0;;;;;;;;;1,0;;;;;;1,0;;;;;;;28,0;;;;;;;9,0;3,0;10,0;;9,0;;;214,0;;;;;;2,0;;;;;1,0;;1,0;;;2,0;;;;1,0;2,0;;;2,0;;;;;;;;;;;;1,0;;2,0;2,0;;;;2,0;;;;;;;;;;;;;;;;;;;;2,0;;;;;;;;;;;;;;;;;;;;;;1,0;;;;;;;;;;2,0;;;;;;;;;;;;;1,0;;;70,0;2,0;;;;;;;;1,0;;;;;;;;;;;;3,0;;;;
seal;;;;;26,0;;4,0;4,0;;;;;10,0;;;1,0;;;4,0;;;2,0;;;;;;;1,0;3,0;;5,0;40,0;2,0;3,0;;;5,0;;2,0;;;1,0;13,0;;;2,0;1,0;2,0;;;1,0;;2,0;;46,0;25,0;;7,0;53,0;;;30,0;;;;;1,0;1,0;1,0;19,0;;3,0;15,0;20,0;;;1,0;6,0;;4,0;;5,0;;;;43,0;6,0;;4,0;15,0;;;1,0;3,0;84,0;;;;28,0;11,0;10,0;;;;;;20,0;;;2,0;8,0;3,0;25,0;3,0;1,0;6,0;;2,0;7,0;;;;2,0;1,0;;8,0;6,0;;5,0;50,0;1,0;7,0;1,0;;19,0;4,0;;;4,0;;;2,0;9,0;9,0;;43,0;28,0;;;;11,0;;4,0;5,0;10,0;9,0;38,0;;3,0;;;12,0;3,0;;17,0;;13,0;;14,0;118,0;3,0;6,0;12,0;2,0;16,0;23,0;;12,0;;;;1,0;8,0;;1,0;3,0;8,0;;92,0;2,0;;;4,0;;;;4,0;;15,0;;4,0;1,0;6,0;;;;;62,0;7,0;5,0;;1,0;2,0;;;;28,0;;;24,0;7,0;5,0;;8,0;1,0;14,0;;;1,0;11,0;;1,0;4,0;;;7,0;6,0;26,0;;8,0;;2,0;10,0;1,0;3,0;6,0;8,0;;;;;5,0;11,0;2,0;;;7,0;;;;;;4,0;10,0;;9,0;6,0;1,0;2,0;12,0;5,0;;4,0;43,0;;;;1,0;10,0;;;;4,0;3,0;;;2,0;2,0;6,0;1,0;;;;;;1,0;1,0;1,0;;;;6,0;6,0;;1,0;;;6,0;3,0;;;;;13,0;;;;1,0;;;5,0;;2,0;;1,0;5,0;5,0;7,0;;;;;;;;;;;;;;;;;;;1,0;3,0;1,0;3,0;;;;;;;;;;;;2,0;3,0;;;;;;;;;;;;;;;;;;9,0;;;;;;;;1,0;;;;;;;;;;;;;;;;;;;;6,0;1,0;4,0;;;;;;;;;;;;;;;;;;2,0;;;;;;;;;;;;;;;1,0;;;1,0;;;;;;;2,0;;;;;;;;;;;1,0;;1,0;;;;1,0;;;4,0;;;;;;;;;;;;2,0;;;3,0;;3,0;2,0;;2,0;5,0;;;3,0;;2,0;;;;7,0;;;;;;24,0;;;;1,0;8,0;2,0;6,0;;;;;;;;;1,0;;1,0;;1,0;;4,0;;;;;;;;;;;;5,0;;;2,0;;;1,0;;;;;;1,0;;;1,0;;;;;;;1,0;;;;;;;;1,0;;2,0;2,0;9,0;26,0;;;;;;;;;;;;10,0;;6,0;3,0;;;2,0;;2,0;;;;;1,0;;;;;;2,0;;;;;;1,0;1,0;2,0;;;;;1,0;;;;;1,0;;;4,0;;;;;;;;1,0;;;3,0;43,0;;;;;;4,0;;31,0;;;5,0;;1,0;;;;;39,0;;;;;;;;;;;;1,0;1,0;;;;;;;;;;;;;;;;;;1,0;;;;;;;;;;;;1,0;1,0;;;;3,0;;;;;1,0;;;1,0;;51,0;11,0;;;;;;;;16,0;;;;;;;;;;;;;;;;;;;;;;;;;;;;;;;10,0;;;;1,0;;;;4,0;;7,0;;;;;;;;2,0;;;;;;;;;;;;;;;;;3,0;;;2,0;;;;;;2,0;;;;;;;;;;;;;;5,0;;1,0;;;;;;;1,0;3,0;;;;7,0;2,0;;;5,0;;;;;;;28,0;;;;;;;1,0;3,0;;;;;;;;;;;;;;;;3,0;;;;1,0;;;;;;;;;;;;;;;17,0;;;4,0;;;;;;;2,0;2,0;;;;;1,0;1,0;;;;;;;;;;;;;;;;2,0;;;2,0;;;;4,0;;;;;;;;;;;;;;;;;;;;;;2,0;;1,0;1,0;9,0;16,0;2,0;;;;;;;;;;;;;;;;;;;;;;1,0;;;;;;;;;;;3,0;;;;;;;;;;;;;
seat;;;;;5,0;;9,0;37,0;;;3,0;;;;;;;;2,0;;;;;;1,0;;;;;2,0;;5,0;18,0;;7,0;;;7,0;;1,0;5,0;;;14,0;;;;1,0;1,0;;;4,0;;;2,0;3,0;35,0;;4,0;58,0;;;6,0;;;3,0;8,0;;;2,0;8,0;;;;2,0;1,0;;7,0;16,0;1,0;;;;;;;;;;2,0;8,0;;;;1,0;4,0;;;;1,0;6,0;8,0;;;;;;30,0;;;5,0;17,0;;2,0;;;;;7,0;21,0;;;;7,0;;;1,0;2,0;;2,0;7,0;;;23,0;;;23,0;;;;;;2,0;3,0;;7,0;26,0;12,0;;;;13,0;22,0;;3,0;8,0;6,0;4,0;;2,0;;;7,0;1,0;;5,0;;;;;5,0;1,0;27,0;74,0;7,0;2,0;4,0;;1,0;;;;;1,0;8,0;4,0;1,0;13,0;;36,0;;2,0;;15,0;;;;;;1,0;;;5,0;30,0;6,0;;;;1,0;5,0;;21,0;;;;;;;;;37,0;7,0;;;5,0;;;;;10,0;;;;6,0;;4,0;1,0;2,0;2,0;4,0;25,0;4,0;27,0;1,0;;2,0;;1,0;;243,0;;;;27,0;;;3,0;16,0;;2,0;;38,0;4,0;3,0;15,0;;14,0;2,0;37,0;;;5,0;;2,0;;;;;2,0;20,0;;32,0;;;;;9,0;;1,0;13,0;1,0;;2,0;;6,0;;;;;;;9,0;;4,0;1,0;1,0;1,0;;;2,0;;4,0;;;7,0;;2,0;;2,0;;;;;;;2,0;;12,0;5,0;;;;;;;;;;;;;;;;;;;;;;;;;;;;;;;;;;;;;;;;;;;;;2,0;;;1,0;;;5,0;;;;;;;;;;;;;;;;;;;;;;;;;;;1,0;2,0;;;;;2,0;;;;;;;;2,0;;;;;;;;;;;;;;;;;;;;;;;;;;;;;9,0;;;4,0;4,0;;;;;;;;;;;;;2,0;;11,0;;;;1,0;;;7,0;1,0;;;;;;;;;;;;;;;;;1,0;;1,0;1,0;2,0;;;;;;;;8,0;;2,0;;2,0;;;;;;;2,0;;;;;;;;;;;;;;;;;;;;;;;;;;;2,0;;;;;;;;;;;;;;4,0;;1,0;;;;;;;2,0;;;;;;;;5,0;;;;;;;;;;;1,0;8,0;;;;1,0;1,0;;;;;;;;;;;;;;;;;;;;;;;;;;;;;;;;;;;;;;;;;2,0;2,0;;;;;;1,0;;;;;;;;;;;;;;;1,0;;6,0;;;;;;;;;;;;2,0;;;;;;4,0;;;;;;;;;;;;;;;;;;;;;;;;;;;;;;;1,0;;;;;;;;;;;;;;;;;2,0;;;2,0;;;;;;;;;;;;;;1,0;;;;;;;;;;;;;;1,0;;;;;;;;;;;;;;;;;;;;;;1,0;;;;;;;;;;;;;;;;;;;1,0;;;;;;;;;;;;;;;;;;;;3,0;;;;;;;;;;;;;;;;;;;1,0;;;;;;;;;;;;;;;;5,0;;;;;;;;;;;;;;3,0;;;;;;;;;;1,0;;;;;2,0;;;;;2,0;5,0;;;;;;;;;;;;;;;;;;;;;;;;;;;;;;;;;;;;;;;;;;;;;;;;;;;;;;;;;;;;;;;;;;;;;;;5,0;;;;;;;;;;;;;;;;;;;;;;;2,0;;;;4,0;;;;;;;;;;;;;;;;;
security;;;;;8,0;;10,0;13,0;;3,0;1,0;;;;2,0;;1,0;;;18,0;;5,0;;;2,0;;;8,0;;3,0;;2,0;55,0;;26,0;;;2,0;;;;1,0;;1,0;;;;;;;8,0;1,0;;;;13,0;21,0;;;1,0;;;28,0;;3,0;13,0;3,0;;;;;;;;;;;1,0;2,0;1,0;3,0;;7,0;1,0;;;;;;1,0;4,0;;;7,0;;;;2,0;14,0;;4,0;57,0;;;;;;4,0;;;;10,0;;2,0;1,0;;;;;1,0;;;;;;;8,0;;;;5,0;2,0;1,0;;;;2,0;;;;;;;;;1,0;3,0;;;;;;2,0;3,0;;4,0;1,0;;;;1,0;1,0;;1,0;;;;2,0;1,0;;2,0;;12,0;3,0;;;2,0;2,0;;;2,0;;;;;;4,0;;;7,0;;2,0;;5,0;;;;;1,0;5,0;;1,0;;;;;;;;11,0;1,0;;;;2,0;3,0;;2,0;;;;1,0;1,0;;;;;;;;;;;1,0;;;;3,0;;;;8,0;;;4,0;1,0;1,0;;;;;;;3,0;;;;;;;;;;;;;;;;;;1,0;;;4,0;;;;2,0;;1,0;;;;;3,0;;4,0;1,0;;;;;2,0;;;;;;;1,0;;1,0;;1,0;;;;;;;;;;6,0;;;;1,0;;;;;;;2,0;;;;;4,0;;;2,0;;;;;;;;;15,0;;;;;;;1,0;;;;1,0;;2,0;1,0;;2,0;;;;;;3,0;1,0;1,0;;;;;;;;;;;;;;;;;1,0;;;;;;4,0;;3,0;;;;;;3,0;;;;;1,0;;;;;2,0;;;;1,0;;;;;;;4,0;;;;;;;;;;;1,0;;;;;;;;;;;;;;;;;;;;;;;6,0;;;;1,0;;;;;;;;1,0;6,0;;;;;;9,0;;;;1,0;;;1,0;1,0;2,0;2,0;1,0;;;5,0;;;;18,0;;;;;1,0;15,0;;;;;;;;;;;;;;;;;;2,0;7,0;2,0;;;30,0;;;;;;;;3,0;;2,0;1,0;;;;;;;;;;;;2,0;;;;;;;;1,0;;;;;9,0;;;;;;;;;;;;1,0;2,0;;;;3,0;2,0;;;3,0;1,0;;;1,0;;;;1,0;;9,0;;;;;1,0;;;1,0;;;;;;;;;;;;;;;;;;;;;;1,0;1,0;;;;;;;;;;;;;;;1,0;2,0;;;;1,0;;;;;;;;;;;;;1,0;;;;3,0;;1,0;;;;1,0;;;;;;;;;;;;;;;;1,0;;;;;;;;;;;;;;;;;;;;;1,0;;;;;;;;;;;;;;;1,0;;;;;;;;;1,0;;;;;;;;;;;;;1,0;;;;;;1,0;;1,0;;;1,0;;;;;;;;;;;;;;;;;;;;;;;;;;;;;;;;;1,0;;;;;;;;;;;;;;;2,0;;8,0;;;;;;;;;;;;;;;;;;;;;;;;2,0;;1,0;;;;;;;;;5,0;;;;1,0;;;;;;;;;;;;2,0;;;;3,0;;;;;;;25,0;;;;;;;;1,0;;;;;;;;;;;;;;;;;;;;2,0;;;;;1,0;;;;;;;;;2,0;;2,0;;;;;;5,0;;;;1,0;;;;;;;;;;;;;;;;;;;;4,0;;;;;;;;;;;;;;1,0;;;1,0;;24,0;;;;;;;;;;;;6,0;;3,0;1,0;;;;;;;1,0;1,0;;;;;;;;;;;;;;;;;;;;;;;;;;;
semiconductor;;;;;22,0;;;7,0;;2,0;;;;;12,0;;;;1,0;;;8,0;;;;;;2,0;;;4,0;5,0;261,0;2,0;26,0;10,0;1,0;10,0;;1,0;7,0;;1,0;168,0;;;;;1,0;;6,0;4,0;;2,0;4,0;188,0;68,0;;;16,0;;;41,0;;;;1,0;;;;8,0;;4,0;;2,0;;;1,0;10,0;2,0;;18,0;11,0;1,0;;;419,0;;;;139,0;;;50,0;1,0;5,0;;4,0;10,0;274,0;111,0;13,0;;28,0;;;178,0;30,0;1,0;3,0;;33,0;37,0;3,0;6,0;;12,0;;3,0;6,0;3,0;;;33,0;;;8,0;28,0;;12,0;13,0;1,0;3,0;;;11,0;66,0;;46,0;92,0;;;1,0;6,0;2,0;;135,0;11,0;;2,0;;5,0;1,0;17,0;1,0;;;2,0;13,0;67,0;5,0;13,0;1,0;2,0;7,0;53,0;8,0;174,0;4,0;14,0;27,0;;60,0;19,0;;3,0;2,0;17,0;11,0;;;5,0;;3,0;;;4,0;80,0;;43,0;3,0;;;18,0;1,0;5,0;1,0;;;3,0;;;2,0;59,0;;;1,0;;5,0;17,0;6,0;;;;;1,0;;4,0;;;4,0;;;;;5,0;;;;;;;;7,0;1,0;;;3,0;10,0;;1,0;;;4,0;;;4,0;58,0;;32,0;2,0;;2,0;31,0;8,0;1,0;;1,0;;1,0;;3,0;3,0;;1,0;;17,0;1,0;;;1,0;4,0;;;;;3,0;;;5,0;;;;3,0;2,0;;;;;11,0;1,0;;;2,0;;2,0;20,0;1,0;;2,0;1,0;;4,0;;2,0;4,0;;3,0;;6,0;;;;;;;;;;;;22,0;;;;12,0;;;7,0;;;;;;;6,0;;2,0;;;2,0;3,0;;;;;;;;;3,0;;;4,0;;2,0;;;;;;;;;;;;;27,0;;;;;;1,0;10,0;2,0;;;5,0;;12,0;1,0;;4,0;;;;;;;3,0;;;;;;;3,0;;;;;;;;;;;;1,0;1,0;5,0;;;;;;1,0;28,0;;;;2,0;;;;8,0;;1,0;1,0;;;;;;;;;;;;;10,0;2,0;;27,0;4,0;;;;;16,0;13,0;;1,0;;;;;;;;;;;;;;;4,0;1,0;;;;;;2,0;;;;;;;;2,0;;4,0;;;;1,0;;1,0;1,0;1,0;;16,0;;;;;;;;;;;4,0;;1,0;;;4,0;2,0;5,0;;;;;;;;;;;;;;;;;7,0;;;;;;;;;10,0;;;;;;;;;1,0;1,0;30,0;;;;3,0;;;;37,0;9,0;;;;;;;;;;;;;1,0;;;;2,0;;;;2,0;;;12,0;;;;;;2,0;;;10,0;19,0;;;;;;;;;;;;;;;;;;;;;;;;;1,0;;;2,0;;;;;;;;16,0;;5,0;2,0;;;;;;;;3,0;;;;;;;;;27,0;;3,0;;;;;1,0;;;;;;;3,0;;;;;;;;2,0;3,0;1,0;3,0;;3,0;;2,0;8,0;;;;5,0;165,0;18,0;;3,0;;2,0;;;;2,0;15,0;;2,0;;;;;;;;37,0;;;2,0;;;;;;;31,0;;;1,0;;;;2,0;7,0;;;;;;;;2,0;1,0;;;;;;;11,0;;;10,0;;;;1,0;;;;;;;;;;1,0;8,0;;;1,0;;;1,0;1,0;;;;;;;;;;;;2,0;;;;;;;;;;;;;;;;;2,0;;;;;;;;;;;;;;;;;;;;;;;;;;;;20,0;3,0;;;;;3,0;;;4,0;;;;;;;4,0;2,0;;;14,0;;;;7,0;;;;1,0;;;;;;;;5,0;;;;;3,0;;;;;3,0;;16,0;;3,0;;;;;;;;;;;;;7,0;;6,0;;;;;;;;;;;;;;;;;;;;;;;;;;;;;;;;;;;;;;;;1,0;;;;;;;;;;;;;;;;3,0;;;;;;;31,0;;13,0;3,0;;1,0;;23,0;;;;;;1,0;;;1,0;;;;;;;;;;;;;;;;;;18,0;;;;;;;2,0;;;;;;;;
sensitive;;;;;5,0;;;;;;;;;;19,0;;;;7,0;;;3,0;;1,0;1,0;;;2,0;;1,0;2,0;8,0;16,0;;5,0;;;;;;;;;81,0;;;;4,0;4,0;3,0;3,0;1,0;;1,0;;27,0;10,0;;;12,0;;;7,0;;;;;;;1,0;;;;;;1,0;;3,0;6,0;;;;;;;;;;;3,0;19,0;;;15,0;;;;1,0;3,0;;7,0;10,0;;;;;3,0;3,0;;;2,0;3,0;27,0;1,0;;;;10,0;;;;;;3,0;;;7,0;;;3,0;;;;;;10,0;5,0;;;1,0;;;1,0;;1,0;;1,0;;1,0;;11,0;;1,0;;;;;2,0;1,0;9,0;1,0;;;1,0;;1,0;1,0;142,0;;;;2,0;;;;;;1,0;;;1,0;;;4,0;;4,0;;73,0;;;;;12,0;3,0;;2,0;;;;;;;;;;;1,0;;;2,0;;;;;;11,0;;;;1,0;;;;3,0;;10,0;;;;;;;;;;;;;19,0;;;;;;;;;;;;1,0;;;;;;;2,0;;;;;;;;;;;;2,0;;2,0;;;;;;;;5,0;;;;;;;;;;;1,0;;;;;;;2,0;;;;;;;;;;12,0;;;;2,0;;;;;;;;;;6,0;;;;;;;;;2,0;;;;;;;;;;;6,0;;;;;;;;;;;;;;;;;;;;3,0;;;1,0;;;;;1,0;;;;4,0;;;;;;;;;;;2,0;;;;;6,0;;11,0;;;;;;;1,0;;1,0;;;;;;;;;3,0;;1,0;;;;;;;5,0;4,0;;;;1,0;;;;;;4,0;;;;;;;;1,0;;;;;;;;3,0;;4,0;;;;;;1,0;;;;;;;;;;;;;;;;;;;;;;;;;1,0;;;;;;;;;;;;;;;;3,0;1,0;7,0;;;;;;;1,0;;;;;;2,0;;;;;;1,0;;;;;;;;;;;;;;;1,0;;;;;;;;;;;;;;;;;;;;;;;;;;2,0;;;;94,0;;;;;;;;;;;;;;;;;;;;;;;;;;;;;;;;;2,0;22,0;;1,0;;;;;;6,0;;;;;;;;;;;;;;;;;;;;;;;;;;;;;;;;;;4,0;;;;;;;;;;;;;;;6,0;;;;;;;;;;;;;1,0;2,0;;;;;;;;;4,0;;;;;;;;;;;;;;;;1,0;;;;;;;;5,0;;;;;;;;;;;;;;;;;;;;;2,0;;;;;;;;;;;;;2,0;;;1,0;;;1,0;;5,0;2,0;;;;;;;;;;;;;;;;;;;;1,0;;1,0;;;;;;;;;;1,0;;;;;;;;;;1,0;;;;;;;;;;;;;;;;1,0;;;;;;;;;;;;;;;;;3,0;;;;;;;;;;;;;;;;;;;4,0;;;4,0;;;;;;1,0;;;;;;;;7,0;;;;;;;;;;;;;;19,0;;;;;;;;;;;;;;;;;;;;;;;;;;;;;;;;;;;;;;;;;;;;;;;;;;;;;;;;;;;;;1,0;8,0;;;12,0;;;;;;;;;;;;;;;;;;;;1,0;;;;;;;;;;;;;;;;;;;;;;;;;;;;;;;;;;;;;2,0;;;;;;;;;;;
serial;;;;;8,0;;;11,0;;1,0;;;;;;3,0;;1,0;1,0;9,0;;15,0;;;;;;85,0;;;1,0;;47,0;;34,0;;;;;2,0;;;2,0;;;;;;;2,0;;13,0;8,0;1,0;;35,0;31,0;;1,0;13,0;;;11,0;;;1,0;;;3,0;6,0;1,0;;;4,0;;1,0;;;1,0;10,0;;;2,0;;;;;;;1,0;12,0;;;61,0;;;;3,0;1,0;1,0;;6,0;;5,0;;;1,0;15,0;;;8,0;;;2,0;1,0;;;;;16,0;;;;14,0;;;6,0;1,0;;;;;;;;1,0;3,0;;;;;;5,0;;;;3,0;2,0;;;;;;;5,0;;;;;3,0;;;;;;;;;;;;;13,0;;;;;5,0;;;;;1,0;;;;;2,0;;1,0;;;;11,0;;;;;;;;;;;;;5,0;;;;;;;;;5,0;9,0;;;;;;;;;;;;;;;;;;;;;;;1,0;;;;;16,0;;;2,0;;;;;;27,0;;;;;;;;;;;;;2,0;;;;;;;;;49,0;;;;;;;;;;1,0;;;8,0;;;;;;;;;;;;5,0;;2,0;;;;;;;;;1,0;;;;;;;;;;;;;;2,0;;;1,0;;;;;;;;;;;;;;;1,0;;;;;;1,0;;3,0;1,0;1,0;;;;;;;;;;;4,0;;;;;;;;;;;3,0;2,0;;;10,0;3,0;;;;;;4,0;;;16,0;1,0;4,0;;;;17,0;1,0;;;;;;;;;;;1,0;;;;1,0;;;;;;;6,0;;;;;;1,0;;;;;;4,0;;1,0;;;4,0;4,0;;;3,0;;;6,0;2,0;;6,0;1,0;3,0;;7,0;;;;3,0;;10,0;;1,0;;;;;;1,0;;;;;;;;5,0;;;35,0;;1,0;;;;2,0;;1,0;;;;;;;5,0;;2,0;;;11,0;;;;;;;1,0;;;1,0;;;;;;;;;;47,0;9,0;29,0;;;;;;;;;;;;;;;;;;;;;5,0;;1,0;;;;;;;;;;;;;;;1,0;;1,0;;;;;;1,0;;;;;;;;;5,0;;;;;;;;;;2,0;;;;10,0;;;;;8,0;;;;;;;;1,0;;;;;;;;;;;;;;;;;;;;;;;;;2,0;;;;;11,0;;;1,0;;;;;;;;;;;;;;;;;;;;;;;;;;;;;;;6,0;;;;;;1,0;;;;1,0;;;;;;;;;;;;1,0;;;;;;;4,0;;;;;;;;;1,0;;;;4,0;;;;;1,0;;;;;;;2,0;;;;;;;;;;;;;;;16,0;;;;;;;;;;;;;;;;3,0;;;;;;1,0;;;;;;;;;;;;;;;;3,0;;3,0;;;;;;3,0;;;;;;;;;;;;;;;;;16,0;;;;;;;;;;;;;;;;;;;;;;;;;;;3,0;;1,0;;;;;;;;;;;;;;;;;;;;23,0;;;;;;;;;;;;;;;;;;1,0;;;;;;;;;;5,0;;;;;;;;;;;;;;;;;;;;;;;;;2,0;;;;;;;;;;;;;;;;;4,0;;;;;;;;;;;;;;;;;1,0;;1,0;;;;;;;;;;;;;;;;;;;;;;;;;;;;;;;;;;;;;;;5,0;;;;;;;;;;;;;;;3,0;;;;;;;;;;;;;
series;;;;;5,0;;3,0;15,0;;47,0;;;;1,0;5,0;;;;7,0;;4,0;11,0;;2,0;1,0;;;33,0;1,0;7,0;2,0;7,0;30,0;;18,0;1,0;;10,0;;17,0;;;3,0;9,0;1,0;;;;5,0;;1,0;27,0;1,0;;;203,0;29,0;;1,0;26,0;;;10,0;;;;10,0;;3,0;11,0;2,0;;;;;5,0;;12,0;12,0;1,0;;3,0;12,0;8,0;;;2,0;;6,0;5,0;12,0;6,0;4,0;23,0;;4,0;4,0;4,0;10,0;1,0;8,0;19,0;;1,0;;;6,0;28,0;2,0;;2,0;3,0;;8,0;1,0;;;;;;;;;6,0;;;13,0;1,0;12,0;1,0;;;2,0;1,0;;1,0;;;;3,0;;;;4,0;4,0;;11,0;60,0;;;;;1,0;1,0;4,0;;11,0;3,0;;11,0;;;;;1,0;;1,0;13,0;;1,0;3,0;;11,0;3,0;;;1,0;2,0;;;;;;;;;;16,0;;9,0;;;;13,0;;;;;;1,0;;;;4,0;;1,0;;;;;;2,0;;;;25,0;2,0;;;;;4,0;;;1,0;;;;;;;;;7,0;;;;1,0;11,0;2,0;10,0;;1,0;3,0;;;1,0;;;1,0;1,0;3,0;1,0;23,0;;;;8,0;;;1,0;;2,0;;;;6,0;;;;;;;;;;1,0;;;;;;;1,0;1,0;19,0;2,0;4,0;;;;;;;;;;1,0;;;;;4,0;5,0;;;;;1,0;;6,0;12,0;;;;1,0;;;;4,0;;;;;;5,0;;;1,0;;1,0;6,0;;;;;;;;;;1,0;;;;;1,0;;;2,0;;;1,0;;;;;;;;7,0;;;;;;;;6,0;2,0;;;;;2,0;8,0;;;;2,0;1,0;1,0;;5,0;1,0;;;;;4,0;3,0;;;;6,0;;1,0;;1,0;;11,0;;;;;;;;;;;4,0;;;;;4,0;;17,0;1,0;1,0;1,0;;;5,0;;;6,0;2,0;2,0;10,0;;;;;;2,0;;1,0;6,0;;1,0;;;;;;;;2,0;;3,0;;4,0;;;;;13,0;;;;1,0;4,0;;;;1,0;1,0;;;4,0;;;;;1,0;;;2,0;2,0;;;;;;5,0;2,0;;3,0;;4,0;4,0;1,0;14,0;3,0;;2,0;;2,0;;;;;2,0;;;;;;;;;;6,0;8,0;1,0;;;1,0;;;;2,0;;;3,0;;4,0;2,0;;;;2,0;;;;;;;;1,0;2,0;;;;;;;;;;;;;;4,0;2,0;;;2,0;;;;;;;;;;;;;;;;6,0;;;;;2,0;11,0;;;;;;;;;;;;;;;;;;;;1,0;;;;;;;;;;;;;;;;;;1,0;;1,0;;;;;;;;;;;4,0;;;1,0;;;;;;;;;7,0;;;1,0;;2,0;;;;;;4,0;3,0;;;8,0;;;;;4,0;;;;2,0;;;;;;;;;;;;;3,0;;;4,0;2,0;2,0;;;2,0;;;;1,0;;6,0;;;;1,0;;;;;;;;;;;;4,0;7,0;20,0;;10,0;;;;;;;;;;;;;;;;10,0;;;;;;1,0;;;;;;;;;2,0;1,0;1,0;;;;;1,0;4,0;;;1,0;6,0;;;2,0;;;;;;;;2,0;1,0;;;;4,0;;;;1,0;1,0;;;;;1,0;;17,0;;;;;;1,0;;;;;;;;;;;;5,0;;2,0;7,0;;;;;;;;;;;;1,0;;;;;;;7,0;1,0;;;;3,0;;;;;;;;;;;;;;;;;1,0;;;;;;;;1,0;;;;;;;;;;;;;;;;;;;;;;;;;;;;;;1,0;;;;;;;;;2,0;;;;4,0;;;;;;;;1,0;;;;;;;;;;;;;;;;;;;;;;;;;;1,0;;;;;;;;;;;;;;;;;;;;;;;;;;;;;;;;;;;;;;;;;;;;;;;1,0;;;;;3,0;;;;;;;;;;;;;
service;;;;;2,0;;;3,0;;4,0;2,0;;;;;;;;6,0;5,0;;10,0;;;;;;13,0;;;;;21,0;;37,0;;1,0;;;5,0;;;;18,0;;;;;;;3,0;2,0;;1,0;;58,0;30,0;;;;;;34,0;;;;;;;12,0;;3,0;;;;;;;3,0;1,0;;5,0;;;;;;;;17,0;;;;4,0;;;;1,0;4,0;;;21,0;;20,0;2,0;;;50,0;;;1,0;;;2,0;;;;;;;;;;2,0;;;20,0;;;1,0;;2,0;;;;;;;;;;;;;;;;;;;;;;;;;;;;;;;;;;;;;;;;;2,0;3,0;;;;;;;;;;;;;;24,0;;;;;;8,0;;;;;;;;;;2,0;;;;;;2,0;;;;;;1,0;7,0;;;;;4,0;;1,0;;;;;;;;;;;;;;;;;;;;;;;;;;;;;;7,0;;;;;1,0;;;;;;;;;;;;;;;;;5,0;;;;;;;;;;;;;;;3,0;;;;;;;;;;3,0;;;;;;3,0;;;;;8,0;;;;;;;;;;1,0;;;;;;;;;30,0;;;;;;;;1,0;;;;;;;;;;;;;;;;;;;;;;;;;;3,0;2,0;4,0;;;;;;;;2,0;5,0;;;;;1,0;;1,0;2,0;;;;;1,0;;;6,0;;;;;;1,0;;;;;1,0;;;;;;;;;1,0;;;8,0;;1,0;;;;;;16,0;13,0;6,0;1,0;;1,0;4,0;;;;;;;;;;2,0;;;;1,0;;10,0;7,0;;;;;;;;;;;;3,0;1,0;15,0;;;1,0;;;3,0;;;;;;26,0;;;8,0;;;;;;;;8,0;;;;;;;;;6,0;;;5,0;;;;;;2,0;6,0;;;;;;;;;;;;4,0;27,0;10,0;4,0;2,0;2,0;;;;;;;;4,0;;1,0;;;;;;7,0;;;;1,0;2,0;;;;3,0;;;;2,0;;;4,0;;;;28,0;;;1,0;;;;;;1,0;;;;;;2,0;;10,0;12,0;;;;;1,0;;;;;;;;6,0;;4,0;;;28,0;;;;;;;;3,0;;;;;;;23,0;;;;;;;;;;;14,0;;;;;;;;;;;;1,0;;;;;;;;;;;;;;;;;;;;;;;;;;;;;;;;;;4,0;;;;;;;;;;;;;;;;;1,0;;;;;;;;;;;;;;;;;;;;;;;;;;;;;;;;;;;;;;14,0;;;;;;3,0;;;1,0;;;;2,0;;;;;;;;;;;;;;;;;;;;;;;;;;;;;;;;;;;;;;;;;;;;;;;2,0;;;1,0;;;;;;;;;;;;;;6,0;;;;;;;;;;;;;;;;;;;;;;;;;;;;;;;;;;;;;;;;;;;;9,0;;;;;4,0;;;;;;;;;;;;;2,0;;;;;;;;;;;;;;;;;;;;;;;;;;;;;;;;;;;;;;;;;;7,0;;;;;;;;;;;;2,0;;;;;;;;;;;2,0;;;;;;;;;4,0;4,0;;;;2,0;;;;;;;;;6,0;;1,0;;;;;;;;;;;;;;;;;;;;;;;;;;;;;1,0;;;;;;;;;;;;;;;;;;;;;;;;
sharpness;;;;;3,0;;;12,0;17,0;10,0;;;;;2,0;3,0;;;;;;;;;;;;2,0;;7,0;;36,0;4,0;16,0;2,0;;;;;2,0;;;;;;4,0;;;15,0;1,0;;2,0;;;;231,0;6,0;;;5,0;;;7,0;;2,0;;;;;;;;;;;;;;6,0;;;2,0;1,0;1,0;;;24,0;;4,0;3,0;;;;4,0;;;;;14,0;;;3,0;;;3,0;;;8,0;;;;;;;;1,0;;;;;;;;11,0;;;;;9,0;;;;;;;5,0;;;;;;;;;;;;8,0;;;;;;;;;;;;;;;;;;;;;;;;;;;;;;1,0;;;;;;;;;;7,0;;2,0;;;;1,0;;;;;;;;;;6,0;;;1,0;;;;;;;;;;;;;;6,0;;;;;;;;;;;;;;;;;;7,0;;;;;;;;;;;;;;;;;;;;;;2,0;;4,0;;;;;;;;;;;;;;;;;;;;;;;;;;;;;;;;;;;;;;;;8,0;;;;;2,0;;;;;;;;;;;;;;;;;;;;;;;;;;;;;;;;;;23,0;;1,0;;;3,0;;;;;;4,0;2,0;;;;;;;;;;;;;;;;2,0;;;;7,0;;5,0;2,0;2,0;;;;;;;;;;;;;;;;;;;;;17,0;;;;;;;;;;;;;;;;;;;;;;;4,0;;4,0;;;2,0;;;;;;;;;;;;;;;;;;;;;;;;;;;;;;;;15,0;;;1,0;;1,0;;;;;;;;5,0;;;;;;;;;;;;;;;;;1,0;;;;;;1,0;;;;;;;4,0;;;;;;;;;;;;;;;;;;;;;;;;;;;;;;;;;;;;;;;;;;;;;;;;;;;;;;;;9,0;;;32,0;;;;;;3,0;;;;;;;;;;;;;;;;4,0;;;;;;;34,0;;;;;;;;;;;;;1,0;;;;;;;;;;;;;;;;;;;;;;;;;;;;;;;5,0;;;;;;;;;;;;;;;;;1,0;;;;;;;;;;;;;;;;;;;;;;;;;1,0;;;;;;;2,0;1,0;;;;;;;;;;;3,0;;1,0;;;;;;;;7,0;;;;;2,0;;;;;2,0;;;;;;;;;;;;;;;;;;34,0;;;;;7,0;;;;;;;;2,0;;;;;;3,0;;;;;;;;;;;;;;;;;;;;;;;;;;;;;;;;;;;;;;;;;;;;;;;1,0;;;;;;;;;;;;;;;;;;;;;;;;;;;;;;;;;;6,0;;;;;;;;;;;;;;;;;;;;;;;;;;;;;;;;;;;;;;;;;;;;;;;;;;;;;;;;;;;;;;;;;;;;4,0;;;;;;;;;;;;;;;;;;;;;6,0;;;;;;;;;;;;;;;;;;;;;;;;;;;;;;;;;;;;;;;;;;;;;;;;;;;;;;;;;;;;;;2,0;;;;;;;;;;;;;;;;
sheet;;;;;14,0;;1,0;8,0;;14,0;;;;;;;;;1,0;;;;;2,0;;;2,0;3,0;;;1,0;6,0;12,0;;6,0;;3,0;3,0;;19,0;;;;7,0;;;1,0;;1,0;;;3,0;;;;51,0;18,0;;;15,0;;;10,0;;;;3,0;;;3,0;1,0;;;3,0;4,0;;;1,0;8,0;1,0;;;;1,0;;3,0;;;;;1,0;;;3,0;11,0;8,0;;;1,0;3,0;27,0;23,0;3,0;;;;1,0;18,0;;;;9,0;;11,0;13,0;2,0;;;1,0;4,0;6,0;;;9,0;;;7,0;5,0;;1,0;4,0;2,0;;;7,0;;6,0;;1,0;;;;;12,0;2,0;;21,0;;;;;1,0;14,0;1,0;3,0;2,0;5,0;1,0;;6,0;;;9,0;;;12,0;1,0;48,0;1,0;21,0;36,0;8,0;23,0;2,0;;;2,0;17,0;1,0;;;;2,0;;1,0;2,0;19,0;12,0;;66,0;;1,0;;1,0;1,0;1,0;;;;3,0;3,0;6,0;9,0;7,0;;;;;;10,0;;1,0;;5,0;;1,0;1,0;15,0;1,0;;1,0;;;;7,0;;3,0;;;;;;;1,0;;1,0;3,0;4,0;14,0;;2,0;;2,0;;;1,0;;3,0;;;;;;7,0;;2,0;1,0;8,0;;;;2,0;8,0;2,0;1,0;;7,0;;9,0;2,0;14,0;4,0;;1,0;2,0;;;;;6,0;;2,0;;5,0;;;;;1,0;6,0;;;;2,0;;1,0;;2,0;4,0;;;1,0;1,0;4,0;;1,0;;;2,0;5,0;;;;;;;;;;2,0;;;3,0;1,0;;7,0;;2,0;1,0;;1,0;;;;;;;;;;;;;;;;;;;1,0;;;;;;;;;;;;;;;;;;;;;;;;;6,0;;;;;10,0;3,0;3,0;;;;;;;;;1,0;;;;1,0;;;3,0;;4,0;;;;;;;;;;;;;;1,0;;;;;5,0;;1,0;;;1,0;9,0;1,0;;;;;;;;;;;;;;5,0;1,0;;;;;;;;;;;;;;1,0;;;;;;;;;;9,0;;;;;;;1,0;;;;;96,0;;;;;;;;;;1,0;;;;;;4,0;;2,0;3,0;;;;;;;;;2,0;3,0;;;;;;;;;;;;;;;;3,0;;;;;;3,0;;1,0;;;;4,0;;;3,0;;1,0;;;;;;3,0;;;;;;;19,0;6,0;;;1,0;1,0;;;;2,0;;3,0;;;;;;;;;;;;;;8,0;;;;;;;;;;;;;;;12,0;;;;;;;1,0;;1,0;;;2,0;;;;;;3,0;;3,0;;;;;;;;;;;;;;;2,0;;;;;;;;;;;;1,0;;;;;;1,0;;2,0;2,0;;;;5,0;;;;2,0;;;;8,0;;1,0;;;4,0;3,0;;;;;;;;;1,0;;;;;;;;;;1,0;;;;;;;;;;;;;;1,0;;;;;;;;;;;1,0;;;;;;;;;;;;;;3,0;;;;;;;;;;;;;;;;;;;;;;;;;;;;;;2,0;3,0;;;;1,0;;;;;;;;1,0;;;;;;;;;;1,0;;;;;;;;;;;;;;;;;;;;;3,0;;3,0;;;;;;;;;;;;;;;;;;;;;;;;;;3,0;;;;;1,0;;;;2,0;;3,0;;;;;;;;;;;;;;4,0;;;;;;;1,0;;;;;;2,0;;;2,0;;;4,0;;1,0;10,0;;1,0;;2,0;;;;;;;;;2,0;1,0;7,0;;;;;;;;;;;;;;;1,0;;;;;;;;;;;;;;;;;;1,0;;2,0;;;;;;;;;;;;;;1,0;;;;;;;;;;;;;;4,0;;4,0;;;;;;;;;;;;;;;;;;;;;;;;;;;;;;;;;;;;;;;;;;;;;;;
shell;;;;;7,0;;7,0;;;;;;;;;;;;;2,0;;1,0;;;;;;;;;;;1,0;;2,0;;;4,0;;1,0;;;;2,0;;;;;;;;;;1,0;;1,0;17,0;;2,0;21,0;;;1,0;;1,0;;;4,0;;;;;;;;;;1,0;9,0;1,0;;;;1,0;;;;;;1,0;2,0;;;;;2,0;;;3,0;1,0;7,0;4,0;;;;;5,0;3,0;;;3,0;1,0;;6,0;8,0;;;;1,0;16,0;2,0;;;1,0;1,0;;3,0;6,0;;1,0;5,0;;;;;;6,0;;;;;;;;;;12,0;1,0;;;;3,0;;;3,0;;4,0;37,0;;;;;6,0;1,0;;;;2,0;;4,0;12,0;;12,0;10,0;7,0;5,0;20,0;;;;;;1,0;;3,0;1,0;4,0;8,0;;10,0;4,0;1,0;;15,0;;;;;;3,0;;3,0;;9,0;2,0;;;;;8,0;;;;;;3,0;;2,0;;;4,0;;;;7,0;;;;;;5,0;;;;1,0;1,0;4,0;;;2,0;1,0;;3,0;5,0;1,0;;;;8,0;;;;29,0;6,0;;;2,0;5,0;;2,0;;;4,0;3,0;2,0;7,0;11,0;;;;;10,0;1,0;;1,0;;;;1,0;4,0;3,0;6,0;;;;;1,0;;;3,0;;;;;4,0;2,0;;;;;;;;;;;;;;1,0;;;;;;;;2,0;;;;;8,0;4,0;;1,0;;1,0;;;;;;;;;;;;;;;;;;;;;1,0;;1,0;;;;;;;;;2,0;;;;;;;;;;;;9,0;;;;;;;;1,0;;;12,0;;;;;;;;2,0;;;;;;;;;;;;1,0;;;;;;;1,0;1,0;;;;;;;;;;;;;;;;;;;;;;;;;;;;;2,0;;;2,0;;;;;;;;;;1,0;;;5,0;;;;;;;;;;;2,0;;;;;;;;;;1,0;;;;;;;;;1,0;;;;;;;;;;;;;;;;;;;;5,0;;;;2,0;3,0;;;;9,0;1,0;11,0;;;;;;;;;;;;;;;;;;1,0;;;;;;;1,0;;;;;1,0;1,0;;;;3,0;5,0;;;;;;2,0;;;;;;;;3,0;;;;;;1,0;;;;7,0;;;;;;;;;2,0;1,0;;;;8,0;;;;;;;;1,0;;;;;;;;;;;;;2,0;;;;;;;2,0;;;;;;;;;;;;;;;;;;;;;;;;;;;;;;;;;4,0;;;1,0;1,0;1,0;;;;;;;;;;;;6,0;;;;;;7,0;;;1,0;;;;;;;;;;;;;;;;;;;;1,0;;;;;;;;;;;;1,0;;;;;;;;;;5,0;;;1,0;;;;;;;;;;;;;;;;;;;;;;;;;;;;;;;;;;;;;;;;;;;4,0;;;;;;;;;;;;;;;;;;;;;;;;;;;;;1,0;;;;;;;;;;;;;;;;;;;;;;;;;;;;;;;;;;;;;;;;;;;;;;;;6,0;;;;;;;;;;;;;;;1,0;;;;1,0;4,0;;;;;;;;2,0;;;;;;;;;;;;;;1,0;;;;;1,0;;;;;;;;;;;;;;;;;;;;;;;;1,0;;;;;;;;;;;;;;;;;;;;;;;;3,0;;;;;;;;;;;;;;;;;;;;;;;;;;;;;;;;;;;;;;2,0;;;;;;;;;;;2,0;;;;;;;;;;;;;
shield;;;;;8,0;;5,0;5,0;2,0;5,0;;3,0;;;;;;;10,0;;;9,0;;;;;2,0;2,0;;2,0;;4,0;26,0;;2,0;;2,0;9,0;;11,0;3,0;;9,0;25,0;;;;;;1,0;;1,0;;7,0;;36,0;26,0;;1,0;74,0;1,0;;13,0;;;;5,0;;;3,0;28,0;1,0;3,0;2,0;4,0;2,0;;4,0;22,0;4,0;6,0;18,0;;;1,0;;5,0;;;;6,0;7,0;2,0;41,0;;7,0;;1,0;1,0;9,0;35,0;10,0;;;;;;31,0;3,0;1,0;1,0;4,0;;8,0;7,0;;;;13,0;8,0;;;;3,0;;;13,0;2,0;1,0;5,0;23,0;;;4,0;2,0;1,0;11,0;;2,0;;;;5,0;5,0;2,0;;42,0;3,0;;1,0;;;4,0;1,0;6,0;;;32,0;;18,0;1,0;4,0;;1,0;1,0;25,0;13,0;226,0;;10,0;42,0;2,0;41,0;8,0;;26,0;;;;;7,0;;;;4,0;;41,0;12,0;;78,0;2,0;1,0;4,0;10,0;5,0;3,0;;2,0;2,0;10,0;2,0;7,0;;21,0;4,0;;;;3,0;4,0;;;1,0;1,0;;3,0;1,0;;;3,0;7,0;;;4,0;10,0;1,0;4,0;;;4,0;;;;;6,0;;5,0;;2,0;;11,0;;11,0;11,0;;40,0;;2,0;2,0;5,0;3,0;;;19,0;;;1,0;9,0;;;;2,0;1,0;8,0;4,0;;10,0;8,0;6,0;;;24,0;18,0;1,0;3,0;;;;1,0;4,0;6,0;8,0;4,0;12,0;1,0;;10,0;7,0;;7,0;;;3,0;1,0;1,0;4,0;2,0;6,0;2,0;;;1,0;12,0;2,0;1,0;;;9,0;10,0;4,0;;2,0;1,0;;;;;;;1,0;5,0;8,0;4,0;5,0;;9,0;;11,0;;;2,0;;1,0;;;1,0;;;;;;;;;;;;1,0;;;13,0;;;;;;;;;;;;;;;;;;;;;;;;;;;;;1,0;;9,0;1,0;;;;;;;;1,0;;;;8,0;;;;4,0;;;;1,0;;;;;;;;;3,0;1,0;2,0;;;;;;;;;;;;;;;;;;;;;;;;;;;;;;;;2,0;1,0;1,0;;;;;2,0;;;;;;;;;;;;;37,0;5,0;;;;;1,0;;;;;9,0;;;;;;;;;2,0;7,0;;;1,0;;;;;81,0;2,0;;;;;;;;;2,0;;;;;2,0;1,0;3,0;;;;;15,0;;;;;2,0;1,0;;;1,0;2,0;;;9,0;;;3,0;;1,0;;;;;;;;;;;4,0;;;;;;;11,0;;;1,0;1,0;6,0;;;26,0;1,0;;;2,0;6,0;4,0;;;;;;;;4,0;;1,0;;2,0;;;;7,0;;;2,0;;;;;;;;;;2,0;;;;;;;3,0;4,0;;;;2,0;;;;7,0;;;;;1,0;1,0;1,0;;;;;1,0;;;1,0;;;;;10,0;2,0;4,0;;;8,0;7,0;;;;;;;;;1,0;;2,0;7,0;;11,0;;;;;;1,0;;;;;;;;;;;7,0;;;;;1,0;;;2,0;;;;;;16,0;;1,0;;;;;;;3,0;;;;;;1,0;;;;;;;;;;1,0;;;;;;1,0;;;;;;19,0;;;;1,0;;;;;1,0;;;;;;;1,0;;;;;;;;;;;;;;;4,0;;;;;;;;2,0;;;3,0;;;3,0;;;;;;;;;;;;;;;;;;;;;;;;;;;;;2,0;;;;3,0;;1,0;;;;;;;;;;;;;2,0;;1,0;;5,0;;;;;;;;;;;;1,0;1,0;;;;;;;;;;;;;2,0;;;;;;;;;;;;;;;;;;6,0;;;;;;;6,0;;;5,0;;;;;2,0;5,0;;;;;;;;;;;4,0;;;;;;;;;;;;1,0;;;;;;;;;;;;1,0;;2,0;;3,0;;;;;;;1,0;;;;;;;;;;;;;;1,0;;;;;;;;;;;;;;10,0;;4,0;9,0;;;;;;;;;;;;;2,0;;;;;;;;;;;;;;;2,0;;;;1,0;;;;;;;;;;;;;;
sight;;;;;10,0;;2,0;11,0;3,0;1,0;;;1,0;;;;;;8,0;2,0;;5,0;4,0;;;;;14,0;;28,0;1,0;6,0;6,0;;1,0;;19,0;38,0;4,0;6,0;1,0;;;2,0;;;;;;;4,0;1,0;;;;29,0;15,0;;;5,0;;;29,0;;3,0;1,0;2,0;;;;5,0;1,0;1,0;;;;;1,0;1,0;1,0;;35,0;1,0;;;;;1,0;;1,0;3,0;;;5,0;;;;6,0;2,0;;1,0;17,0;;;;;;38,0;;;2,0;;;;;;;;;2,0;;;;;;;;;;;;;;;;5,0;1,0;;;;;;;33,0;1,0;;1,0;2,0;;;;1,0;;;;;;4,0;;7,0;;;;;2,0;;2,0;;;;;;;1,0;1,0;;1,0;4,0;;;;;;;;2,0;1,0;1,0;;1,0;;;;;;;;;;;;;;5,0;;;;;;;;;;;;;;;;2,0;;4,0;;;;;1,0;;;;;;;1,0;5,0;2,0;;4,0;;;;;;2,0;;2,0;;;;;;;;;;;;;1,0;1,0;;;;;;;3,0;;;;;;;1,0;;;;;;;;;;;;;7,0;8,0;;;2,0;1,0;1,0;;;;;2,0;;;1,0;;;;;;;;1,0;;2,0;1,0;;;10,0;;;;2,0;;;;;;;;;;;;4,0;;;;;;;;;4,0;;;;;;;;;;;;;1,0;;;;;;;;;;;;;1,0;;4,0;;;;;;;6,0;;;;;2,0;;;;;;;;;;;;;;;3,0;;;5,0;;;2,0;;1,0;;7,0;;3,0;;;;1,0;1,0;;3,0;;;1,0;1,0;5,0;;;;;;;;;;;;;3,0;;;;7,0;;;;;;;;;1,0;;;;;;;32,0;1,0;;;;;;;;;;;;;1,0;;2,0;;;;4,0;;;;;;;2,0;;;;;;;3,0;;1,0;;1,0;2,0;;;;3,0;6,0;;;;;;;2,0;;;;;;;;;;;;2,0;;;;;;;;;;;;1,0;;;;;;;;;;;1,0;;;;;;;;;;;;;;;;;;;2,0;;;1,0;;;;;;;;;;;;;;;;;;;;;;;;;2,0;1,0;;;;;2,0;;;11,0;;;;;;;;;;;;;;;;;3,0;2,0;;;;;;;;1,0;;;;;;;;;2,0;;;;;3,0;;;;;;;;;;;;;;;;;3,0;;;;;;;;;;4,0;;;;;;;;;;;;;;;;;;;;;;;;;;;;;;;;;;;;;;;;;;;1,0;;;;;;1,0;;;;;;;;;;;;;;;;;;;;;;;;;;;1,0;;;;;;;;;;;;;;;;;;;;;;;;;;;;1,0;;1,0;;;;;;1,0;;;5,0;;;;3,0;;;;;;;;;;;;;;;;;;;;;;;;;;;;;;;;;;;;;;;;;;;;;;1,0;;;;;;;;;;;;;2,0;;;;;1,0;;;;;;;;;;;;;;;;;1,0;;;;;;;;;;;;2,0;;;;;;;;;;;;;;;;;;;;4,0;;;;;;;;;3,0;;;;;;;;;;;;;;1,0;1,0;;;;;;;;;;;;;;;;;;;;;;;;;;;;;;;;;;;;;;;;;;;1,0;;;;;;;;;;;2,0;;;;;;;;;;;;;;;;;;;;;;;;;;;;;
signature;;;;;5,0;;;12,0;;;;;;;;;;;3,0;;;;;;;;;;;;;;;;;;;;;;;;;;;;;;;;;7,0;1,0;;;;4,0;;;;;;1,0;;;;;;;;;;;;;;;;;;;;;;;;;;;;4,0;;;;;;;;1,0;;;1,0;;;;;;;;;;;2,0;;;;;;;;;;;;;;;1,0;;1,0;;;;;;;;;;;;;;;1,0;;;12,0;;;;;;;;;;;;;;;;;;;;;;;;;3,0;;;;;;;;;;;;;;;8,0;;;;;;;;;;;;;;;;;;;;;;;;;4,0;;;;;;;;;;;;;;;;;;;;;;;;;;3,0;;;;;;;;;;;;;;;;;;;;;;;;;;;;;;;;;;;;;;;;;;;;;;;;;5,0;;;;;;;;;;;;;;;;;;;;;;;;;;;;;;;;;;;;;;;;;;;;;;;;;;;;;;;;;;;;;;;;;;;;;;;;;;;;;;;;;;;;;;1,0;;;;;;;;;;;;;;;;;;1,0;;;;;;;;;;;;;;;;;;;;;;;;;;;;;;;;;;;;;;1,0;;;;;;;;;;;;;;;;;;;;;;;;;;;;;;;;;;;;;;;;;;;;;;;;;;;;;;;;;;;;;;;;;8,0;;;;;;;;;;;;;;;;;;;;;;;;;;;;;;;;;;;;;;;;;;;;;;;;;;;;;;;;;;;;;;;;;;1,0;;;;;;;;;;;;;;;;;;;;;;;;;;;;;;;;;;;;;;;;;;;;;;;;;;;;;;;;;;;;;;;;;;;;;;;;;;;;;;;;;;;;;;;;;;;;;;;;;;;;;;;;;;;;;;;;;;;;;4,0;;;;;1,0;;;;;;;;;;;;;;;;;;;;;;9,0;;;;;;;;;;;;;;;;;;;;;;;;;;;;;;;;;;;;;;;;;;;;;;;;;;;;;;;;;;;;;;;;;;;;;;;;;;;;1,0;;;3,0;;;;;;;;;1,0;;;;;;;;;;;;;;;;;;;;;;;;;;;;;;;;;;;;;;;;;;;;;;;;;;;;;;;;;;;;;3,0;;;;;;;;;;;;;;;;;;;;;;;;;;;;;;;;;;;;;;;;;;;;;;;;;;;;;;;;;;;;;;;;;;;;;;;;;;;;;;;;;;;;;;;;;;;;;;;;3,0;;;;;;;;;;;;;;;;;;;;;;;;;;;;;;;;;;;;;;;;;;;;;;;;;;
silicon;;;;;3,0;;;;;8,0;;;;1,0;;1,0;;;1,0;;;2,0;;;;;;;;1,0;2,0;;19,0;;5,0;;;;;;;;;4,0;;;;;;;;1,0;;1,0;;14,0;22,0;;;9,0;;;3,0;;;;;;;1,0;6,0;;;1,0;;;;;4,0;;;1,0;;;2,0;;18,0;;;1,0;7,0;;;2,0;;;;;;21,0;10,0;3,0;;2,0;;;30,0;1,0;;;;11,0;5,0;2,0;;;4,0;;;;;;;2,0;;;;8,0;;;4,0;;5,0;;;;;;8,0;;;;;;;;34,0;;2,0;5,0;;;;;;2,0;;;;18,0;;;;;;35,0;;2,0;;23,0;6,0;15,0;3,0;;;;;4,0;1,0;;;3,0;;;;;1,0;7,0;;10,0;3,0;;;5,0;;;15,0;7,0;;;7,0;1,0;;4,0;;;2,0;;2,0;;;1,0;;;;;1,0;1,0;;;4,0;;;;3,0;2,0;;;;;;;1,0;2,0;;;;;3,0;;1,0;;;2,0;;;;;;1,0;;;;3,0;;;;;1,0;;;;;;;;;;;;;3,0;;;;;;;3,0;4,0;;;;1,0;1,0;;;;;1,0;;;;;;;9,0;;1,0;;;;;;;;;;2,0;2,0;;1,0;;;;;;;;17,0;;;;;;;1,0;;;;;;;;;;;;;;;;;;;;;1,0;;;;;;;;;;;;;;;;1,0;;;;;;;;;;;;;8,0;;;;;2,0;;;;;;;;;;2,0;;;2,0;;;;;;;;1,0;;;;;;;;;;;;;;;;;;;;;;;;;;;;;;;;;;;;;;;;;;;;6,0;;;;;;;;;;;;;;;;;1,0;;;;;;;;;;;;;;;;;;;;;;;;;;;;;2,0;;;;;;;;;;;;;;;4,0;1,0;;;1,0;;;1,0;;;;;;;;;;;;;;;;;;;;;;;;;;;;;;1,0;;;;;;;;4,0;;;;;;;;;;;;;;;;;;;;;;1,0;2,0;8,0;;;;;;;;;;;;;;;;;;;;1,0;;1,0;1,0;;;;;;;;;;;;2,0;;;;;;;;;;;;;;;;;;;;;;;;;;;;;;;2,0;;;;;;;;;79,0;;;;;;;;;;;;;;;;;;;;;;13,0;;;14,0;;;;;2,0;;;;;8,0;;;;;;;;;;3,0;;;;;;;;;;1,0;;;2,0;;;;;;;7,0;;;;;;;2,0;;;;;;;;;;;;;;;;;;;;;1,0;;;;;;;;1,0;;;;;;1,0;;;;;;;;;;;;;;;;;;;;;;;;;;;;;;;;;;;;;;;;;;;;;1,0;;;1,0;;;;;;;;;;;5,0;;;;;1,0;;;;;;;;;;;;;;;;;;;;1,0;;;;;;;;;;;;;;;;;;;;;;;;;;;;2,0;;;;;1,0;;;;;;;;;;;;;;;;;;;;;;;;;;6,0;2,0;3,0;;;;;;;;;;;;;;;;;;;;;;;;;;;;;;;2,0;;;;;;;;;;;;;;;;13,0;;20,0;2,0;;;;12,0;;;;;;;;;2,0;;;;;;;;;;;;;;;;;;;;4,0;;;;;;;;;;;;;
sleeve;;;;;2,0;;11,0;8,0;;2,0;;;;;;;;;;;;1,0;;;;;;;1,0;;;;45,0;;10,0;;;2,0;2,0;;2,0;;;13,0;;;;;10,0;;1,0;;;;;6,0;43,0;;7,0;35,0;;;3,0;;;12,0;2,0;1,0;;;4,0;;;4,0;2,0;;;;17,0;;;;;;;;;;;;4,0;;;;;6,0;;;1,0;;34,0;;;;;;;9,0;;1,0;1,0;1,0;;21,0;7,0;;;;2,0;3,0;;12,0;3,0;;;;10,0;1,0;;1,0;6,0;;;3,0;9,0;;20,0;;;;;;1,0;5,0;;2,0;22,0;1,0;;;;2,0;17,0;;3,0;16,0;4,0;32,0;;;;;12,0;3,0;;;;1,0;;;8,0;;80,0;22,0;2,0;10,0;18,0;;;;;9,0;3,0;;5,0;;2,0;2,0;;49,0;1,0;2,0;;23,0;;1,0;;;2,0;9,0;;3,0;4,0;3,0;;;;15,0;1,0;2,0;;1,0;;1,0;;;1,0;2,0;;;;4,0;;;16,0;;;;;;;;7,0;1,0;2,0;;1,0;;;;33,0;;3,0;13,0;;;15,0;;;9,0;;;;8,0;;;20,0;12,0;;7,0;;;;3,0;19,0;1,0;26,0;;3,0;;;;;1,0;1,0;2,0;;;4,0;8,0;7,0;1,0;3,0;7,0;;;;;1,0;;;;;;;1,0;;;;;8,0;2,0;2,0;;;1,0;;;;;;1,0;1,0;;2,0;;2,0;3,0;2,0;;6,0;4,0;2,0;18,0;2,0;;;;;;1,0;;;;;;;;;;1,0;;;;;;;;2,0;;;;;;;;;;;;;;;;;;;;2,0;;;1,0;;;;;;;;2,0;;;;;;;;;;;;;3,0;;1,0;;;;;;;;;;;;;;;;1,0;2,0;2,0;;6,0;;1,0;;;;;;;;;1,0;;;;;;;;;;;;;;;;;;;;;;;;;;;2,0;;;;;;;;;;;;;;6,0;;;;1,0;;;;;;;;;;;;;;;6,0;;;;;;;;;;;;;;;;;;;12,0;;;15,0;;1,0;3,0;;;;;2,0;;;;;;10,0;;;;;1,0;;;1,0;;;;;;;;;;;;;;2,0;1,0;;;;;;;;;;;1,0;;;1,0;;;;;;6,0;;9,0;;;;;;;;;;4,0;;;;;;;;;;11,0;;;;;;;;;;;;2,0;;;;;;;;;1,0;;;5,0;;6,0;;;;;2,0;;;;;;3,0;;1,0;1,0;;;;;1,0;;;2,0;;;;;;;;;;;;;;;1,0;;2,0;;1,0;23,0;2,0;;4,0;;;;;;1,0;2,0;;;2,0;5,0;;;;;;;;;;;;;;;;;;;;;;;;;;;;;;;;;;;;;;;;;;;;;;;;;;;;;;1,0;;;1,0;;;;;;;;;;;;;;;;;;;;;;;;;;;;;;1,0;;;4,0;;;;;;;;2,0;;;;;;;;;;;;;;;;;;;;;;;;;;;;;;;;;;;;;;;;;;2,0;;;;;;;;;;;;;;;;;;;;;;;3,0;;;;;;1,0;;;;;10,0;;4,0;;;;;;;;;;;;;;4,0;;13,0;;;;;;;;;;;;;;1,0;;;;;;;;;8,0;6,0;;;;;;;;;;;;;;;;;1,0;2,0;;;;;;;;;4,0;;;;;;;;;;;;;;;;;;;;;;;;;;;;;;;;;;;;;;;;;;;;;;;;2,0;;;;;;;;;;;;;;;;;;;;;;;;;;;;;;;;;;;;;;;;
slot;;;;;26,0;;1,0;43,0;;6,0;;;;;;;;;;;;7,0;;1,0;;;5,0;1,0;10,0;;1,0;;25,0;;27,0;;1,0;27,0;;10,0;6,0;;3,0;3,0;;;1,0;;1,0;;4,0;;;9,0;3,0;12,0;53,0;;7,0;34,0;;;11,0;;;8,0;6,0;;;2,0;;;1,0;2,0;5,0;;1,0;;25,0;;;1,0;;;;;;;;12,0;19,0;;;5,0;3,0;9,0;;3,0;3,0;10,0;49,0;6,0;;;;;4,0;23,0;;;4,0;4,0;1,0;17,0;5,0;6,0;;;2,0;21,0;;;;3,0;;;16,0;2,0;;9,0;12,0;;;;;;20,0;;;;;;5,0;5,0;;1,0;49,0;2,0;;1,0;;24,0;113,0;;2,0;7,0;14,0;48,0;;3,0;;2,0;7,0;2,0;;1,0;;2,0;6,0;;34,0;5,0;22,0;25,0;11,0;35,0;12,0;1,0;;;;9,0;7,0;;11,0;2,0;30,0;77,0;;89,0;;41,0;;70,0;;;;4,0;6,0;9,0;;47,0;1,0;30,0;4,0;;3,0;;2,0;20,0;1,0;;;;4,0;;;1,0;;5,0;11,0;1,0;;;6,0;;30,0;;;;3,0;;15,0;4,0;4,0;6,0;23,0;2,0;21,0;3,0;5,0;;3,0;15,0;4,0;14,0;1,0;;2,0;;;;1,0;50,0;;;9,0;68,0;1,0;2,0;;;32,0;6,0;20,0;1,0;47,0;4,0;4,0;2,0;4,0;18,0;;2,0;26,0;11,0;6,0;3,0;8,0;8,0;33,0;;;7,0;1,0;1,0;25,0;2,0;;11,0;;;;;;4,0;;;;3,0;3,0;6,0;13,0;4,0;;9,0;3,0;;5,0;15,0;;4,0;;;28,0;4,0;8,0;;;2,0;;1,0;5,0;36,0;;;4,0;5,0;4,0;8,0;1,0;;1,0;;;;;;;1,0;3,0;3,0;;;;;;;;1,0;;;;;;;;;1,0;;;;15,0;;;;;;3,0;;;2,0;;;10,0;34,0;4,0;;;24,0;;;;;;;;;;12,0;3,0;;;1,0;;;;;;;7,0;;1,0;;;;;;;;6,0;10,0;2,0;6,0;;;;;8,0;;3,0;;;3,0;;2,0;;;;;;;;;;1,0;;;;3,0;;;51,0;;2,0;3,0;;1,0;;3,0;;;;2,0;;2,0;;;;;;;;;;4,0;6,0;;;;1,0;1,0;;;;;27,0;;;;13,0;;;;;7,0;;;;1,0;;;;2,0;6,0;1,0;;;;;2,0;;;;9,0;8,0;;;;11,0;;3,0;;;4,0;2,0;18,0;;;;1,0;7,0;;4,0;;;;2,0;;;;;;1,0;;;1,0;1,0;;;;;;3,0;;;4,0;;;;;22,0;;;3,0;1,0;4,0;;;3,0;;;14,0;;1,0;4,0;1,0;;;;3,0;;;;14,0;;;;;;;;;;;4,0;6,0;;;;;2,0;;;;;2,0;;1,0;;;;;;;;1,0;;3,0;;1,0;;;;;;2,0;6,0;;;;;;;2,0;;1,0;15,0;;;;12,0;;;5,0;;;1,0;4,0;;6,0;;2,0;1,0;5,0;;;1,0;;;3,0;;;3,0;;4,0;;6,0;;12,0;3,0;1,0;;1,0;3,0;1,0;;7,0;;43,0;2,0;;;;1,0;;;9,0;;;;;;;;;;;;;;;;;;;1,0;;;;;;;;;;;;;2,0;;;;;;;;;;1,0;;;;;;1,0;;;;;;;;;;;;;;;;;;;;;;;;;;;;;;;;;3,0;1,0;;;;;;1,0;;;;;;;;;;3,0;;;;;;;;;;;;;;3,0;;;;;14,0;;;5,0;;1,0;;;;;;;;;;;;;;;;;;3,0;;;;;;;;;8,0;3,0;3,0;;;;;1,0;;;;2,0;;;;;13,0;;;;;;;;2,0;;;;;;2,0;1,0;;;5,0;;3,0;;;;;;;2,0;;5,0;;;5,0;;;;7,0;;;;;1,0;;8,0;3,0;1,0;;;;;;;;;1,0;;;;;;3,0;7,0;;;3,0;;;;;;;;;;;;;;;;;;;6,0;;;;;;;;;;;;;;;;;;;;;;;;2,0;;;;8,0;;5,0;;;;;;;;;;;;;;;;;;;;;;2,0;;;;;;;;;1,0;3,0;;;;;;;;;;;;
smart;;;;;3,0;;;2,0;;;;;;;;;;;;1,0;;4,0;;;;;;2,0;;;;;4,0;;1,0;;;;;;;;;;2,0;;;;;;8,0;1,0;;;;4,0;1,0;;;2,0;;;2,0;;;;;;;2,0;;;;;;;;;;;;6,0;;;;;;;;;;;;5,0;;;;;1,0;;;;;2,0;;4,0;;4,0;;;;;2,0;;;;;;;;;;;1,0;;;6,0;;;1,0;1,0;;;;1,0;;;;;;;;8,0;;;;;;;;;;;;;;;3,0;1,0;;;;;;;;2,0;13,0;;;;;9,0;;;;;;;;;;;;;;;2,0;;;;;;;;;;;;;;;;;;;;;;;1,0;;;;;6,0;;;;;;;;;;;;;;;;;;;;;;;;;;;;;;;;;;;;;;2,0;;;;;2,0;;;;;;;;;;;;;;;;;;;;;;;;;;;;;4,0;;;;;;;;;;;;;;;;;;;;;;;;;;;;;;;;;;;;;;3,0;;;;;;;;;;;;1,0;;;;;;;;;;;;;;;;;;;;;;;;;;;;;;;10,0;;;;;;;2,0;;;;;;;;;1,0;;;;;;;;;;;;;;;;2,0;;;;;;;;;;;;;;;;;;;;;;;2,0;;8,0;;;;;;;;;;;;1,0;;;;;2,0;;;12,0;;;;;;;;;;;;;;;;;;;;;;;;;;;1,0;;2,0;;;;;;;;;;;;1,0;;;;;;;;2,0;;;;;;;;;;;;;;;;;;;;;;;;;;;;;;;;;;;;;;;;;;;;;;;;;;;;;;;;;1,0;;;3,0;;;;;;;;;;;;2,0;;;;;;;;;;3,0;;;;;;;;2,0;;;;;;;;;;2,0;;;;;;;;2,0;;;;;2,0;;2,0;;;;;;;;;;;;;;;;;;;;;;;;;;;;;;;;;;;;;;;;;;;;;;;;;;;;;1,0;;;;;;;;;;;;;;;;;;;;;;;;;;;;;;;;;;2,0;;2,0;;;;;;;;;;;;;;;;;;;;;;;;;;;;;;;;;;;;;;;;1,0;;;;;;;;;;;;;;;;;;;;;;;;;;;;;;;;;;;;;;;;;;;;;;;1,0;;;;;;;;;;;;;;;;;;;;;;;;;;;;;;;;;;;;;;;;;;;;;;;;;;;;;;;;;;;;;;;;;;;;;;;3,0;;;;;;;;;;;;;;;2,0;;;;;;;;;;;;;;;;;;;;;;;;;;;;;;;;;;;;;;;;;;;;;;;;;;;;;;;;;;;;;;;;;;;;;;;;;;;;;;;;;;;;;;;;;;;;;;;;;;;;;;;;;;;;;;;;;;;;;;;;;;;;;;;;
socket;;;;;14,0;;;10,0;;;1,0;;;;;;;;14,0;;;3,0;;;;;;1,0;;;;;9,0;;2,0;;;4,0;;;;;;2,0;;;;;;;;;;;;1,0;27,0;;;;;;8,0;;;;;;1,0;;;;;2,0;;;;;5,0;1,0;;;;;;;;;;;1,0;;;1,0;2,0;2,0;;;;1,0;26,0;2,0;;1,0;;;;2,0;;;1,0;;;4,0;5,0;;;;7,0;;;;;3,0;4,0;;7,0;25,0;;7,0;;;;;;;8,0;;;;;;1,0;;;;9,0;2,0;;;;;;;;;;17,0;;;;;15,0;;;1,0;;2,0;;1,0;21,0;;92,0;15,0;;5,0;6,0;;;;;;;;6,0;;2,0;2,0;;19,0;;2,0;;14,0;;;;;;5,0;;1,0;7,0;10,0;5,0;;;;;11,0;3,0;;;;;;;3,0;;;4,0;;;;6,0;;;;;;2,0;;;;;1,0;;;;;;;14,0;15,0;;;;;;;;;6,0;16,0;;;;9,0;;;;;;3,0;6,0;9,0;5,0;2,0;;;1,0;;4,0;;15,0;2,0;;;;;3,0;;;2,0;1,0;;;;;7,0;;;;;;;;;;;;7,0;;2,0;;;;1,0;;4,0;;1,0;;;;;;;;;2,0;;;;;;;17,0;;;;;;;;;;;;;;;;;;;;;;;1,0;;;;;;;;;;;;;;;;;;;;;;;;;;;;;;;;;;;;;;;;;1,0;;;;;;;;;1,0;;;;;;;1,0;;;3,0;;;;;;;;;;1,0;;;;;;;;;;;;;;;;;;;;;;;;;;;;;;;;;;;;;;;;;;;;;;1,0;;;;;;;;;;;;;;;;;;;;;;;;;;;;;;;;;;;;;;12,0;42,0;;;;2,0;3,0;;;;1,0;1,0;14,0;;;;;;;;;;;;;;;;1,0;;;;;;;;;;;;;2,0;;;;;;;4,0;;;2,0;;;;;;;;;;;;;;;;;;;4,0;;;;1,0;;;;;;;19,0;2,0;;;;;;;;;;;;;;;;;;;;;2,0;;;;4,0;;;;;;;;;;;;3,0;;1,0;1,0;;;6,0;;4,0;;;1,0;;1,0;;4,0;;;;;;;;;;;;;3,0;;1,0;;5,0;;3,0;;;;;;;;;;6,0;;;;;;;;;;;;;;;;;;;;;;;;;;;;;;;;;;;;;;2,0;;;;;;;;;;;;;;2,0;;;;;;;;;;;;;;;;;;;;;;;;;;;;;;;;3,0;;;;;;;;;;;;;;;;;;;;;;;;3,0;;;;;;;;;;;;;;;;;;;;;;;;;;;;;;;;;1,0;;;;;;;;;;;1,0;;;2,0;;;;;;;;1,0;;;;2,0;;;;;;;;1,0;;;;;;;;;;;;;;;;;;3,0;;;;;;;;;;;;;;;2,0;;;;;;;;;3,0;;;;;;;;;;;;;;;;;1,0;;;;;;;;;;;;;;;;;;;;;;;1,0;;;;;;;;;;;;;;;;;;;;;;;;;;;;;;;;;;;;;;;;;;;;;;;;;;;;;;;;;;;;;;;;;;;;;;;;;;;
spectrum;;;;;5,0;;;1,0;1,0;;;34,0;;;63,0;1,0;1,0;;13,0;1,0;;1,0;;1,0;;;;9,0;;5,0;1,0;13,0;2,0;;15,0;;;9,0;;4,0;;;;;;;;;;2,0;2,0;3,0;;1,0;;14,0;6,0;;;5,0;;;15,0;;;;1,0;;;;7,0;5,0;;;;1,0;;3,0;3,0;;;1,0;6,0;9,0;;;23,0;;;3,0;1,0;;;3,0;;;3,0;;;;1,0;20,0;;;;;18,0;1,0;1,0;;3,0;1,0;18,0;1,0;;;;2,0;;;;;7,0;;;;6,0;;;2,0;2,0;;;;;15,0;;;;34,0;12,0;;;;10,0;;1,0;;12,0;;;;;;;;;;6,0;3,0;;;;;;;;110,0;;;;;3,0;;;;;31,0;;;;;2,0;;;;;15,0;1,0;13,0;;;13,0;3,0;;;;;1,0;;;;;;;2,0;;;2,0;;2,0;;;;;;;;;;;;1,0;42,0;;20,0;;;;;;;;;;2,0;;;;;;;;;;;2,0;;;;;1,0;;2,0;;;;;1,0;;;;;;;;5,0;;;;;;;;;;2,0;;2,0;;;;;3,0;;;;3,0;2,0;;3,0;;;;;;;;;;;;3,0;4,0;;;;3,0;;;;6,0;;;;;;;;;;;;;;25,0;;;;;;;;;;;;;;;;;;;;;;;;7,0;;;;;;;;;;;;1,0;;;;;;;;;;;;2,0;;;;3,0;;;;;;;;;1,0;3,0;;2,0;;2,0;;;;;;;;;;;;;5,0;;;;;;;1,0;;;;;;;;;;;;;;;3,0;;3,0;3,0;;;;;;;;;;;;;;;;1,0;;;;;;;3,0;8,0;;;1,0;;;;;;;;;;;;1,0;;;;;;;;;2,0;;;;;;;;;;;;;4,0;1,0;8,0;;;2,0;;;;;;;;1,0;;;;;;;;;;;;;;;;;;;;;;2,0;;;;;;;;;;;;;;;;;;3,0;;;;;;;;;;;;;;;;;1,0;;;;;;;;;;;;;;;;;;;;;;;;;;;;;;2,0;;;;;;;;;;1,0;;;;;;2,0;;;;;;;;1,0;;;;;;;;1,0;;;;;;1,0;;;;;3,0;;;3,0;;;;;;;;;;;;;;;;;;;;;;;;;;;;;;;;;;;;;;;;;;;;;;;;1,0;;;;;;;;;;;;;;1,0;;;;;;;;;;;26,0;;;;;;;;;;;;;;4,0;;;;;;;;;;;;;;;;;3,0;2,0;;;;;;14,0;;;;;;;;;;1,0;;;;3,0;;;;;;;;;;;;;;;;;;;;;;;;;;;;;;;;;;;;;;;;;;;;;;;;;;;;8,0;;;2,0;;;;;;;;;;;;2,0;;;;2,0;;;;52,0;;;;8,0;;;2,0;;;;;;;;;;;;;;;;;;;;;1,0;;;;;;;;;;;;;;;;;;;;;;;;;;;;;;;;;;;;;;;;;;;;;;;;;;;;;1,0;;;5,0;;;;;;;;;;;;;;;;;;;;;;;;;;;;;;;;;;;;;;;;;;;;;;;;;2,0;;;;;;;;;;;;;;;;;;;;;;;;;;;;;;
split;;;;;3,0;;4,0;;;1,0;;;;;;;;;17,0;;;;;;;;;4,0;;1,0;;;15,0;;;;;16,0;;4,0;;;;4,0;;1,0;;;2,0;;;;;;;17,0;7,0;;3,0;17,0;;;8,0;;;;;;;1,0;26,0;;39,0;;;1,0;;;2,0;;1,0;2,0;2,0;;;2,0;12,0;;1,0;;23,0;6,0;1,0;3,0;;;;;;2,0;5,0;18,0;;;;;;7,0;;;1,0;2,0;;;;;;;;41,0;;;;;;;12,0;4,0;;;10,0;;;;;;2,0;;;;;;;;7,0;;2,0;3,0;;;;;;;;;;;;8,0;6,0;;;;;;;39,0;;;4,0;11,0;3,0;;;;;3,0;;;;;4,0;;;4,0;5,0;2,0;;21,0;;2,0;1,0;20,0;2,0;2,0;;;;;;;4,0;2,0;;;;;;2,0;;;;1,0;;;3,0;;4,0;;1,0;1,0;;1,0;;;;;;;;;;1,0;;8,0;;;1,0;;;;;;;5,0;;3,0;;;;;;4,0;;;;1,0;;2,0;4,0;;;;;;;;;;;32,0;;;;;;;;;8,0;;;2,0;;;;9,0;;;;;;;;1,0;;1,0;;;;;10,0;;;;;;20,0;;2,0;1,0;;;;;;;;;;;;;;2,0;;;;;;;1,0;;;;2,0;;;;;;;;;;1,0;;;;;;;;;;;;;;;;;;;;;;;;;;;;;;2,0;;;4,0;;;;;;;;;;1,0;;1,0;;;;;;;1,0;;;;;;;;;1,0;;;;;;15,0;;;;;;1,0;;;;;;;;;;;;1,0;;;;;;;;;;;;;2,0;;;;;;;;4,0;;;;;;;;;;;;;;;;;;;;;;;;;;;;;;;;;;6,0;;;;;;;;4,0;11,0;9,0;;;;;;;;2,0;;;;;;;;;;;;;;;;;;;;;;;;;5,0;;;;;;;;;;;;;;;;;;;;;;;;;;;2,0;2,0;;;2,0;;;;;;1,0;;;;;;;;;;;;;;;;2,0;;;;;;;;;;;;;;;;;;;;;3,0;;;;;;;;;;;1,0;;;;;;;;;;1,0;;;;;;;;;;2,0;;116,0;;;;;;;;;;;;;;;;;;;;;;;;;;;;;;;;;;;;;;;;;;;3,0;;;;;;;;;;;;;;;;;;;;;;;;;;;;;;;;;;;;5,0;;;;;;;;;;;;;;;;;;;;;;;;;;;;;;;;;;;;;;;;;;;9,0;;1,0;;;;;;;;;;;;;;;;;;1,0;;;;;;;;;;;;;;;;;;;;;;;;;;;;;;7,0;;;;;;;;;;;;;;;;3,0;1,0;;;;;;;;;;;;;;;;;;;;1,0;;;;;;;;;;;;;;;2,0;;1,0;;;;;;;;;;1,0;;;;;;;;1,0;;;;;;;2,0;;;;;;;;;;;;;;;;;;;;;;;;1,0;;;;;;;;;;;;;;;;;;;;;;;;;;;;;;;;;;;;2,0;;;;;;;;;;;;;;;;;;;;;;;;;;;;;;;;;;;;;;22,0;;;;;;;;;;;;;;
spring;;;;;32,0;;19,0;13,0;;;3,0;5,0;;;;4,0;;;10,0;4,0;1,0;5,0;;;1,0;;;1,0;;2,0;;;40,0;;2,0;;;77,0;4,0;;1,0;;15,0;37,0;1,0;;;;2,0;;2,0;;;5,0;1,0;7,0;59,0;;4,0;41,0;2,0;;10,0;;;4,0;4,0;;;;7,0;;;4,0;4,0;;3,0;24,0;41,0;2,0;7,0;;;2,0;;;;;;6,0;4,0;;;;7,0;17,0;;;3,0;2,0;31,0;9,0;2,0;;;;;21,0;;;2,0;4,0;;26,0;37,0;;18,0;;4,0;37,0;;2,0;;4,0;;;25,0;37,0;;17,0;9,0;;;24,0;3,0;1,0;26,0;2,0;1,0;;1,0;;6,0;5,0;;59,0;43,0;17,0;;;;3,0;10,0;;14,0;44,0;19,0;30,0;;1,0;;;16,0;6,0;;;;;10,0;2,0;122,0;18,0;27,0;15,0;7,0;28,0;28,0;;3,0;;4,0;1,0;1,0;;12,0;2,0;26,0;13,0;;105,0;;9,0;;32,0;8,0;;;6,0;3,0;14,0;;17,0;11,0;13,0;;;9,0;;2,0;71,0;;;;1,0;3,0;;;;;4,0;40,0;;;;7,0;;;;;1,0;3,0;6,0;3,0;3,0;4,0;1,0;10,0;10,0;;;19,0;9,0;3,0;4,0;1,0;8,0;;;4,0;70,0;;38,0;;18,0;;;7,0;10,0;2,0;5,0;;7,0;;40,0;11,0;;27,0;4,0;2,0;10,0;21,0;10,0;16,0;7,0;2,0;1,0;;10,0;6,0;7,0;42,0;4,0;1,0;35,0;1,0;;14,0;1,0;;13,0;;1,0;;;;;;;;;4,0;10,0;2,0;2,0;17,0;3,0;;;;1,0;;2,0;1,0;7,0;3,0;;1,0;;6,0;5,0;12,0;;25,0;10,0;;;11,0;;2,0;;;;1,0;;;;;;;;;1,0;;;1,0;;;1,0;;5,0;7,0;;;4,0;;;;;;3,0;;;;;;;;;;;;;;;;;;;;7,0;;6,0;1,0;;;;5,0;;;;18,0;2,0;3,0;;10,0;;;;1,0;2,0;;;;1,0;;;10,0;;4,0;3,0;;4,0;5,0;;;;;;;;2,0;;;1,0;1,0;1,0;;;;;;;;;;;;;;2,0;8,0;;;;;;;1,0;;;;;2,0;9,0;;;;;;;;;;3,0;;;8,0;;;;;;;;;;2,0;;;;;;;;;25,0;;;;;;3,0;;;;;;;;;;;;;2,0;33,0;;8,0;;1,0;;;;;;4,0;13,0;;;;4,0;4,0;;;;;;;;;5,0;;;;;;;2,0;;;;;;1,0;;;4,0;;;;;;16,0;;;;;;1,0;;;;;;;;2,0;;;;;;;;3,0;;5,0;;1,0;;;;;;;2,0;4,0;;;;2,0;;;;;5,0;1,0;1,0;7,0;5,0;;;2,0;;;;;;2,0;;;49,0;;;;;;;3,0;;1,0;;;;;;;2,0;;;;10,0;;;;13,0;;17,0;11,0;;31,0;;;3,0;;;;;;;;;;;1,0;;;3,0;;;;2,0;;;4,0;3,0;;1,0;17,0;;9,0;;;4,0;2,0;;;;;;;;3,0;;;;;1,0;;;;;;;;;;2,0;;;1,0;;;;;;;;;;;3,0;;;;;;;;;;;2,0;;;1,0;;;;;;;;;;;3,0;;;;;;;;;;;;;;;;;;;1,0;;;;3,0;1,0;;;6,0;;1,0;;;;;;;;;;1,0;;;;;;;;;;;;;;;;;;;2,0;;;3,0;;8,0;;;;;;;;;;14,0;;;;;5,0;;;;;;;;;;;;2,0;;;;1,0;2,0;;;;4,0;;;;;;;3,0;;;1,0;;;;2,0;17,0;;6,0;;;;3,0;;66,0;;2,0;;;3,0;;;2,0;;;;;;;;5,0;2,0;;;;;;;;1,0;3,0;;1,0;;;;;;;;;;1,0;;;2,0;;2,0;4,0;6,0;6,0;;;;;;;;;;;;;;;;;;;;;;;;;;;;;;;;;;;;;;;;;;;;;;;;;2,0;;;;;;;;;;;;;;;;;;;;;2,0;;;;;;;;;;;;;;;;;;;;;;;;;
station;;;;;8,0;;2,0;81,0;;30,0;5,0;;;;;;;;1,0;1,0;;60,0;;;;;;13,0;;3,0;3,0;5,0;21,0;;;;;11,0;;25,0;;;;2,0;;;;;;;21,0;3,0;;2,0;;23,0;34,0;;4,0;2,0;;;15,0;;;;2,0;;1,0;2,0;;;4,0;;;;;;2,0;4,0;;12,0;4,0;;;;1,0;;;4,0;3,0;;;12,0;;;;4,0;5,0;;5,0;31,0;;6,0;;1,0;4,0;17,0;;;5,0;6,0;;4,0;5,0;;;;;;;;2,0;1,0;;;14,0;;;65,0;;;;;;;7,0;;;;;1,0;;;;;1,0;4,0;;13,0;;;;;;;;4,0;;;;;;2,0;;;;10,0;8,0;;;;2,0;9,0;5,0;;;;3,0;;;1,0;;;;;;16,0;;5,0;;;;19,0;;;;;;1,0;;;;;;1,0;;1,0;;4,0;7,0;;;;;2,0;8,0;;1,0;;18,0;10,0;;;;;;;4,0;;1,0;;;6,0;;7,0;;;7,0;;2,0;;;;;;8,0;;;;;;;5,0;;1,0;;4,0;;;;1,0;;;;;2,0;;;;;;;;;4,0;2,0;;;4,0;4,0;;;4,0;;1,0;5,0;;1,0;;;;;3,0;;1,0;;;;;;;5,0;5,0;;;;;;;;2,0;;;;;;;;26,0;;1,0;;;;3,0;;;4,0;;4,0;;;;;;;;1,0;;;7,0;;1,0;;;;;12,0;;;11,0;;;;;;;;;;;;;1,0;;;;;2,0;;;;;1,0;;1,0;;;2,0;2,0;;;2,0;;;;;;5,0;;;;1,0;;;;2,0;;;;;;;;;;3,0;;3,0;11,0;1,0;;;3,0;1,0;;;2,0;;13,0;;;12,0;;;;;;2,0;3,0;;15,0;;;;;;;4,0;;;;1,0;;;;;;;;;4,0;;;;;;;1,0;;;;;18,0;30,0;;;;;;2,0;;;3,0;4,0;;;;2,0;;;;;;2,0;;;;;9,0;;;;10,0;18,0;;;;;1,0;;;;2,0;;;;;;;;;;5,0;;;;4,0;;;;;;;;;;;;;;;8,0;;;;;;;;;;;;;;11,0;;;;;;;5,0;;1,0;;;;;;;;1,0;;;;;;;3,0;;;;1,0;;2,0;;;;;;1,0;;2,0;;;;;24,0;;;1,0;;1,0;;;1,0;;;;;;;;;;;;;;;;;;55,0;;;;;;;3,0;;;;;3,0;;;;;;2,0;;;12,0;;;;;;14,0;;;4,0;1,0;;;1,0;16,0;;;;;;;2,0;;;;;;;;1,0;;;;;;1,0;;;;;;;;;;;;7,0;;;;;;;;;;;;;;;;;;2,0;;;;;;;6,0;;;2,0;;;;;1,0;;;;;;;;;;;;;2,0;;;;7,0;;;;;1,0;;;;;;;;;;;;;;;;;;;;;;;;;;1,0;;;;4,0;;;;;;2,0;;;;;;;;;;;;;;;;;;;7,0;;;;;;;;;;;;;;;;;;;1,0;;;;;;1,0;;;;3,0;;;;;;;;2,0;;3,0;;;;;3,0;;;;;5,0;;;;;;;;;7,0;;;;;4,0;;;;;;;;;;;;;;;;;;;;;;;;;;;;;;;4,0;;;;;;;;;;;;;;;;;2,0;;;;;;;;;;;;;;;;;;;;;;;;;;;;;;;;;;;;;;;;;;;;;;;;;;;;;;;;;;;;;;;;;10,0;;;;;;39,0;;;;;;;;;;;;;;;;;;;;;2,0;;
steer;;;;;2,0;;5,0;13,0;4,0;;;;;;;;4,0;;;;;30,0;4,0;;;;3,0;15,0;2,0;1,0;;1,0;43,0;;2,0;;2,0;1,0;;9,0;;2,0;3,0;;;;;;;1,0;;6,0;;2,0;;32,0;18,0;;;7,0;1,0;;11,0;;;14,0;;;;;1,0;;;2,0;;;;4,0;9,0;;;2,0;;1,0;;;2,0;;;2,0;8,0;;;10,0;;;;;2,0;;2,0;62,0;;;;;;8,0;;;;2,0;;5,0;;;;;5,0;3,0;;;;;;;6,0;2,0;;;4,0;;;;;;3,0;;;;;;;;;2,0;1,0;;;;;;;;;;;;;;;;;;2,0;;;3,0;1,0;;3,0;8,0;1,0;3,0;4,0;;;;;;2,0;;;;;;;2,0;;17,0;;;;8,0;;;;;7,0;;;;;;;;;;;10,0;;;;;2,0;5,0;1,0;;;;;18,0;;;;;;;;;;;;;1,0;60,0;;;2,0;;;;1,0;;;8,0;;;;;41,0;;;6,0;;;;3,0;3,0;;;1,0;1,0;;;;;;;;;3,0;;;;1,0;;;;8,0;;;7,0;3,0;;;4,0;9,0;;3,0;;;;;;;;;;;;;3,0;1,0;;;2,0;;;;;;;;;;1,0;;;;;;2,0;2,0;;;;;1,0;;;2,0;27,0;;;;;;;;;;;;;;;;;2,0;;;;2,0;;;;;;;;;;;7,0;1,0;;;;2,0;;1,0;;;;;;;;;;15,0;;;;;;;;;;5,0;;1,0;;3,0;;2,0;;;;;1,0;4,0;;3,0;1,0;2,0;;;;;;;;1,0;;1,0;2,0;;;;;;;;;;;;;;;;;;;1,0;;;;;;;;1,0;;;;;;;5,0;;;;;;;;;;;;;;2,0;;1,0;;;1,0;5,0;;;;;;;;;;;;;9,0;;;;;;;;;;8,0;;;;;;;;;;;;;;;;;;;;;;;;;;;;;;;2,0;;;;;;;;;;;;;;;;;;;;1,0;;;1,0;;;;;;;1,0;;;1,0;;;;;;;4,0;;;;;;;;;;;;;;;;;;;;;;;;;;;;;;;;;;;;;;;;;;7,0;;;;;;1,0;;;;;4,0;;;;;;;;;1,0;;;;2,0;2,0;;;42,0;;;;;;;;;;;;;;;;;;;;;;1,0;1,0;;;;;;;;;;1,0;;;1,0;;;;;;;;;;;;5,0;;;;;;;;;;;;;;1,0;;;;1,0;;;;;;;;;;;;;;;;;;;3,0;;;;3,0;;;;;6,0;;;;;1,0;;;;;;;;;;;;;;;;;;2,0;;;;;;;;;;;1,0;;;;;;;;4,0;;;1,0;;4,0;4,0;;;;;;1,0;;;;;;;8,0;;;;;;;;;;;;;;;;;;;;;;;;;;;;;;;;;;;;;;;;;;;;;;;;;;1,0;3,0;;;;;;;;;2,0;;;;;;;;;;;;;5,0;;;;;;;;;;;;;;3,0;;;;;;;;;;;1,0;;;;;;;;;;;;;;1,0;;;;;;;;;8,0;;;;1,0;;2,0;;;1,0;;;;;;;;;;;;;;;;;;;;;;;;;;;;;;;;;2,0;;;;;;;1,0;;;9,0;;;;;;;;;;;;;;;;;2,0;;;;;;;;;;;;;;;;;;
stereo;;;;;19,0;;1,0;19,0;5,0;17,0;;;1,0;;1,0;3,0;;2,0;;1,0;;18,0;;1,0;7,0;;;88,0;2,0;;1,0;9,0;32,0;;54,0;2,0;;1,0;;7,0;9,0;;;23,0;;4,0;;;3,0;;2,0;32,0;;;;225,0;12,0;;;4,0;;;38,0;;;1,0;;;;1,0;66,0;3,0;;3,0;;1,0;;3,0;7,0;;;12,0;;4,0;;;6,0;;;;4,0;;3,0;7,0;3,0;1,0;;2,0;;;3,0;73,0;;;;;;18,0;;;;5,0;2,0;3,0;1,0;;;;;1,0;;;;1,0;;;13,0;;;;;1,0;;;;1,0;2,0;;;;;2,0;2,0;11,0;;;5,0;7,0;;;;;;;;;;;;12,0;;3,0;;;;;2,0;2,0;;;13,0;1,0;64,0;5,0;;1,0;;14,0;;;;;;;;4,0;;14,0;;2,0;;;;;;3,0;;;;;;2,0;1,0;1,0;;;;;1,0;4,0;;;;;;6,0;;;1,0;;;3,0;;;;;;;;;;;;;;1,0;;;10,0;;;;;;;1,0;;;;;;;;;5,0;;;2,0;;1,0;;4,0;;;;;;;;;;;;;;1,0;;;;;;;;5,0;;2,0;;17,0;;;;;3,0;7,0;;1,0;;18,0;;;;;1,0;;;;;14,0;;;7,0;;;;;;;;;;;;;;;;;;;;9,0;1,0;;;;;;;;;;;;7,0;;;3,0;;;;;;;1,0;;;2,0;;;1,0;;;;;;;;;;;12,0;;;;;1,0;;;;2,0;1,0;5,0;;;;;;1,0;;3,0;;;;;;;1,0;6,0;;;4,0;;;;;;;;;;5,0;;;;;;;;6,0;;1,0;;;8,0;2,0;;;;;;;;;;;1,0;2,0;1,0;;;;;;;;;3,0;8,0;;;;;2,0;;;;1,0;;;;;;;;;;;;3,0;;2,0;10,0;;;;;4,0;;12,0;2,0;;;;;2,0;;;;;4,0;;;;;37,0;6,0;5,0;;;;;;2,0;;;;;;;6,0;;;;;23,0;;;;;;;;;;5,0;;1,0;;;;;;;;;;;;;;;;;1,0;;;;;;;5,0;;;;;;;;;2,0;2,0;;3,0;;;;;;;;;;;;;;;1,0;;;;;8,0;;2,0;;;;;;;;;;;;;;1,0;4,0;;;;;;;;;;;;;;;;1,0;;;;;;;2,0;2,0;;;;;1,0;;;;;1,0;;;1,0;;;;;;;;;;;;;;1,0;;;;;;;;;;;;;;1,0;;;;;;;;;;1,0;;;;;;;;;;13,0;;;2,0;;;;;;;;;;2,0;1,0;;;;;;2,0;;;;;3,0;;;;;;1,0;;;;;;;;1,0;;;;;;;;;;;;;;;;;;17,0;;;;;;;;;;;1,0;;;;;;1,0;;;;6,0;;;;;;;;;;;;;3,0;;;;1,0;;3,0;1,0;;;1,0;;;;;;;;;;;;;;;;;;;;;4,0;;;;;;4,0;;;;;;;;;;2,0;;;;;;2,0;3,0;14,0;1,0;1,0;;;;;;;;;;;;;;;;;;;;;;;;;;;;;;;;;;;;;;1,0;;;;;;;;;;;;;;;;;;1,0;;;;;;;;;;;;;;;;;;;;;;;;;;;;;;;;;;;;;;;;;;;;;;;;;;;;;;;;;;;;;;;;;1,0;;;;;;;;;;;;;;;;;;;;;;;;;;;;;;;;;;;;;;;;;;;;;;
stereoscopic;;;;;8,0;;;;;5,0;4,0;;1,0;;;1,0;;;8,0;1,0;10,0;2,0;;;;;;40,0;;;;11,0;10,0;;;1,0;;;;68,0;10,0;;;;;;;;12,0;;;7,0;;;;122,0;9,0;;;18,0;1,0;;27,0;;;;1,0;;;;3,0;3,0;;;;;;10,0;;1,0;;1,0;;1,0;;;2,0;;1,0;;15,0;;1,0;;4,0;;;1,0;4,0;;;54,0;;;2,0;;14,0;4,0;;;1,0;;;1,0;32,0;;;;2,0;2,0;;;;3,0;;;17,0;;;1,0;;10,0;;;;;;;;;;;;;;;3,0;1,0;;2,0;;;;;1,0;;;2,0;;9,0;;;;1,0;2,0;;;3,0;;4,0;3,0;;2,0;;;;;11,0;;;;;;;;3,0;;10,0;;4,0;;;;11,0;;;;;;;;1,0;;;;;;;32,0;9,0;;;;;;2,0;;;;;;32,0;;3,0;;;;;;;;;;;12,0;3,0;;;2,0;;;;1,0;;;;3,0;;;;;;;;;;;;;;2,0;;;;;;;;;;;;;1,0;;;;;31,0;;;;;4,0;;13,0;;18,0;1,0;;;;;;;;;10,0;1,0;;;;5,0;;2,0;;;6,0;;;1,0;1,0;;;;;;;;;;;;;;8,0;;;;;2,0;;1,0;;;;1,0;2,0;1,0;;1,0;;;;;;;;;1,0;;;6,0;;;;;;;;;;;;;;;;2,0;;;;;;;;;;;1,0;;;1,0;;;;;1,0;;6,0;;;;;;;;;;;;;;;;;2,0;;;;;1,0;1,0;3,0;;;;;1,0;;4,0;;;;4,0;;;;;1,0;;;;;;;;;;;1,0;;;;;;;;;;;;6,0;;;1,0;;;;;;;;2,0;;3,0;;;9,0;;;;;;;;1,0;;;;;;;;;;3,0;2,0;;;;3,0;;;11,0;34,0;;;;;;;;;;;;;;;;;;;;1,0;;9,0;;;;;;;1,0;;;2,0;;;;;;;;;;;2,0;;;;;;;;;;;2,0;;;1,0;1,0;;;1,0;;;14,0;3,0;;;;;;;;;;;;;;;;;;;;;35,0;2,0;;;;;;;;;;;;;;1,0;;;;2,0;;;;;;;;;;;;;;;;;;;;1,0;;;;;;;;;;;;2,0;1,0;;;;;4,0;;;;;;;;;;;;1,0;;;;;;;;;;;;;;;;;;;;;;;;1,0;1,0;;;;;;;;;;;;;;;;;;;;;;33,0;1,0;;;;;;4,0;;;;;6,0;;;;;;;;;;;1,0;;;;;;5,0;;;;;;;;;;;;;;;;;;;;;;;;;;;;;;;;13,0;;;;;1,0;;;;;;;;;;;;;;1,0;;;;;35,0;;;;;;;;;;;;;;;;;;;;;2,0;2,0;;;1,0;;2,0;18,0;;;14,0;;;;;;;;;9,0;;;1,0;;;;;22,0;5,0;;;;;;;;;;;;;;;;;;;;;;;;;;;;;;2,0;;;1,0;;;;;;;;;;;;;;;;;;;;;1,0;;;;;;;;;;;;;;;;;2,0;;;;;;;;;1,0;;;;;;;;;;;;;;;;;;;;;;;;;1,0;;;;;20,0;;6,0;;;;;;;;;;;;;;;;;;;;;;;4,0;;;;;;;;;;1,0;;;;;;;;;;;;;;3,0;;;;;;;;;
subsystem;;;;;3,0;;;3,0;;16,0;1,0;;;;;;;;;2,0;;1,0;;;;;;14,0;;;;;5,0;;4,0;;;;;2,0;;;;4,0;;;;;;;2,0;;;;;15,0;3,0;;;2,0;;;5,0;;;1,0;;;;;27,0;;2,0;;;;;;10,0;;;15,0;3,0;;;;;;;;1,0;1,0;;2,0;;;2,0;3,0;2,0;;;17,0;;;;;;1,0;;;;;;1,0;;;;;1,0;;;;;;;;15,0;;;;4,0;;;;;2,0;;;;;;;2,0;;;;4,0;1,0;;;;;;;;;;6,0;;7,0;;;;;;;;;;;;;;;;;;1,0;;;;1,0;;;;;;8,0;;;;;;4,0;;;;;;3,0;;;;;;;;;;;;1,0;;;;;;;;;;1,0;;;;;;;;;;;;;;1,0;;;;;;;;;;;;;;;;;;;;2,0;;;;;;;;;;;;;;;;;;;;1,0;;;;;;;;;;;;;2,0;;;;;;;;;;;;2,0;;5,0;;;;;;;;;;;;;;;;;;;;;;;;;;;;1,0;;;;;;;;;;;3,0;;;;;;;;;;;1,0;;;;;;;;;;;;3,0;;;;;;;;;;;1,0;;;;;;;;;;;;;;1,0;;;;;;;;;;;;;;;;;;;;;2,0;;;2,0;;;;;2,0;;3,0;;;1,0;;;;;;1,0;;;;;;;;;2,0;;;;;;;1,0;;;;;;;12,0;;;;;2,0;4,0;;;;4,0;;;;;;;;;;;;;;;1,0;1,0;;;;;;;2,0;;;;;;;;;12,0;14,0;;;;;;1,0;;1,0;;;1,0;;;;;;;;;;;7,0;1,0;;;;7,0;;;;;;;;;;;2,0;;;;;;;;;;;;;;;;;;;;;4,0;;;;;2,0;;;;;;;;;;;;;1,0;;;;;;;;;;;;;;;;;;;;;;;;;;;;;;;;;5,0;;;;;;;;;;;;1,0;;;;;;;;;;;;;;;;;2,0;;;;;;;;;1,0;;;;;;;2,0;;;;;;;;;3,0;1,0;;;;;;;;;;;;;;1,0;;;;;;;;;;;;;;;;;;;;;;;5,0;;;;;;;;;;;;;;;;;;;;4,0;;;;;;;;;1,0;;;;;;;;;;;;1,0;;;;;;;;;;;;;;;;;;;;;;;;;;;;;;;;;;;;;;;;;;;;;;;;;;;;;;;;4,0;;;;;;;;;;;;;;;;;;;1,0;;;;;;;;;;;;1,0;;;;;;1,0;;;;;;;;;;;;;;;;;;;;;;1,0;;;;;;;;;;;;;;;;;;2,0;;;;;;;;;;;;;;;;;;;;;;;;;;;1,0;;;;;;;;;;;;;;1,0;;;;;;;;;;;;;;;;;;;;;;;;;;;;;;;;;;;;;;;;;;;;;;;;;;;;;;;;;;;;;;;;;;;;;;;;;;;;;;3,0;;;;;;;;;
surround;;;;;6,0;;9,0;22,0;1,0;33,0;4,0;;2,0;;;;;;7,0;2,0;1,0;5,0;9,0;3,0;1,0;;;4,0;6,0;4,0;8,0;8,0;30,0;;12,0;;;4,0;4,0;7,0;;3,0;;23,0;4,0;;5,0;;;;1,0;17,0;;;;151,0;36,0;;;62,0;;;11,0;1,0;;;6,0;2,0;;;15,0;;7,0;11,0;19,0;;;4,0;38,0;;3,0;;1,0;;;;70,0;;1,0;13,0;23,0;2,0;2,0;4,0;2,0;10,0;;;1,0;15,0;65,0;15,0;1,0;2,0;;;3,0;27,0;;;2,0;10,0;;10,0;3,0;6,0;1,0;;8,0;14,0;;;;8,0;;;8,0;11,0;1,0;2,0;12,0;;;5,0;;1,0;10,0;;32,0;;;8,0;2,0;9,0;15,0;;36,0;57,0;;;;5,0;2,0;2,0;1,0;2,0;13,0;30,0;3,0;13,0;;;25,0;;;21,0;2,0;19,0;;8,0;56,0;4,0;15,0;11,0;;12,0;20,0;7,0;1,0;;3,0;21,0;1,0;;;;2,0;46,0;;90,0;3,0;5,0;;18,0;6,0;2,0;;3,0;;;14,0;8,0;2,0;11,0;10,0;;4,0;4,0;10,0;22,0;;2,0;11,0;;2,0;1,0;;10,0;;6,0;2,0;5,0;;;32,0;;11,0;;;;;;3,0;;2,0;1,0;4,0;10,0;126,0;;5,0;;16,0;4,0;1,0;;;11,0;8,0;10,0;3,0;;5,0;7,0;;;13,0;17,0;;2,0;4,0;5,0;11,0;3,0;4,0;1,0;16,0;1,0;2,0;2,0;15,0;1,0;;;;;;;1,0;7,0;;4,0;;4,0;;;1,0;8,0;;1,0;5,0;;1,0;6,0;3,0;;4,0;1,0;3,0;;1,0;4,0;3,0;3,0;3,0;1,0;;;1,0;5,0;8,0;2,0;;;5,0;;;2,0;1,0;28,0;;4,0;1,0;1,0;;9,0;5,0;3,0;2,0;;6,0;;;;;;;;;;2,0;;;;;;;;2,0;;;;1,0;;;;;;;;;;;;1,0;1,0;;2,0;1,0;;;1,0;;;;;1,0;1,0;;2,0;2,0;7,0;;1,0;;;;;;4,0;;;2,0;;4,0;;;9,0;;;2,0;;;;2,0;;3,0;2,0;;1,0;1,0;;;;;;;;1,0;2,0;;;;3,0;;;6,0;;;5,0;;1,0;1,0;;;;;;;;;;;;2,0;;6,0;;;;;;6,0;2,0;;;;;;;;;;;1,0;4,0;6,0;;11,0;;2,0;;;1,0;;;6,0;;;;;4,0;;;;;;;;5,0;2,0;;;2,0;2,0;8,0;;;1,0;;;;;;8,0;;;;1,0;7,0;5,0;;;4,0;;5,0;;;;;;2,0;2,0;;;1,0;2,0;;;;;;;;;;1,0;;;;;2,0;;5,0;;;;;;;;;1,0;;;2,0;5,0;;;2,0;48,0;;;;;;5,0;;1,0;;;;;;5,0;;13,0;;;;;;14,0;;;4,0;2,0;;;;;6,0;1,0;;2,0;;;;;;;;1,0;1,0;;;;2,0;;;;;;;;;;1,0;1,0;;;;1,0;1,0;;;;;10,0;;;10,0;;;;;3,0;1,0;;4,0;;;4,0;;;;;;4,0;2,0;;;;;3,0;;;;;;;;;;;;1,0;6,0;1,0;2,0;;;;;2,0;;3,0;;;;;;3,0;3,0;;;6,0;;;;;;;;;;3,0;2,0;2,0;;;;;;7,0;;;;;;;;;5,0;;1,0;1,0;;;;;;;;;;;;;1,0;2,0;;;3,0;;;;;;;;;;;;;;;;;;;;;;3,0;4,0;6,0;;1,0;;;;2,0;;1,0;;;;;;;;;;5,0;;1,0;;;;3,0;;;;;1,0;2,0;;;;;;;;;;1,0;;;;;;;;;2,0;;2,0;;;1,0;;;6,0;;6,0;;;3,0;;;;1,0;;;;;;;2,0;9,0;;1,0;;;1,0;;;;;1,0;;;;6,0;7,0;;1,0;;;;2,0;1,0;;;3,0;;;2,0;2,0;3,0;;1,0;1,0;;2,0;;;1,0;;2,0;;;1,0;;5,0;;1,0;;;;1,0;1,0;;1,0;;;2,0;;;;;;;;;;;;;;;;;;;1,0;;;6,0;2,0;;1,0;;1,0;2,0;;;;;;;;;;;;;3,0;;;;;;;;;;;;;;2,0;;;;;;;20,0;19,0;3,0;;;5,0;;1,0;;;;;;;1,0;;;2,0;;;1,0;;3,0;;1,0;;;;2,0;;;;;;;;4,0;;;;;;;;;1,0;;;;
suspension;;;;;7,0;;;;;;;;;;;;;;;;;;;;;;;;;;;;;;;;;;;;;;;1,0;;;;;2,0;;;;;;;1,0;1,0;;;6,0;;;;;;;;;;9,0;;;;;;;;5,0;;;;;;;;;;;;;;;;2,0;;;;;;1,0;;11,0;;;;;;;;;;3,0;;;;;;;;;;;;;;;;;;1,0;;;;;;;;;;;;;;;;;;;;;;;4,0;;;;;1,0;;;;;;;;;;;;;;;;1,0;4,0;;;;;;;;;;;;;3,0;;;;;;;;;;;;;;;;1,0;;;;;6,0;13,0;;;;;;;;;;;;;;;;;;;;;;6,0;;;;;;;;;;;;;;;;;;;;;;2,0;;;;;;;;;;;;;;;;;;;;;;;;;1,0;;;;;;;1,0;;;;;;;;;;;;;;;;;3,0;;;;;;;;;;;;;;;;;;1,0;;;;;;;;;;;;2,0;;;;;;;;;;;;;;;;;;;;;;;;;;;;;;;;;;;;;;;;3,0;;;;;;;;2,0;;;;;;;;;;;;;;;;;;;;;;;;;;;;;;;;;;;;;;;;;;;;;;;;;;;;;;;;;;;;;;;;;4,0;;;2,0;;;;;;;;;;;;;;;;;;3,0;;;;;;;;;;;;;;;;;;;;;;;;;;;;;;;;;;;;;;;;;;;;;;;;;;;;;;;;;;;;;;;;;;;;;;;;;;;;;;;;;;;;;;;;;;;;;;;;;;;;;;;;;;;;;;;;;;;;;2,0;2,0;;;;;;;;;;;;;;;;;;;;;;;;;;;;;;;;;;;;;2,0;;;;;;;;;;;;;;;;;;;;;;;;;;;;;;;;;;;;;;;;;;;;;3,0;;;;;;;;2,0;;;;;;;;;;;;;;;;;;;;;;;;;;;;;;;;;;;;;;;;;;;;;;;;;;;;;;;;;;;;;;;;;;;;;;;;;;;;;;;;;;;;;;2,0;;;;;;;;;;;;;;;;;;;;;;;;;;9,0;;;;;;;;;;1,0;;;;;;;;;;;;;;;;;;;;;;2,0;;;;;;2,0;;;;;;;;;;;;;;;;;;;;;;;;;;;;;;;;;;3,0;;;;;;;;;;;;;;;;;;;;;;;;;;;;;;;;;;;;;;;;;;;;;;;;;;;;;;;;;;;;;;;;;;;;;;;1,0;;;;;;;;;;;;;;;;;;;;;;;;;;;;;;;;;;;;;;;;;;;;;;;;;;;;;;;;;;;;;;;;;;;;;;
synchronize;;;;;3,0;;1,0;9,0;4,0;24,0;;;;;15,0;;;;;1,0;;36,0;;;;;;73,0;;3,0;1,0;5,0;43,0;;14,0;;;1,0;;14,0;4,0;;;;2,0;1,0;;;4,0;;2,0;26,0;;;;54,0;22,0;1,0;1,0;11,0;;;24,0;;;8,0;2,0;;;5,0;4,0;;2,0;;;;;4,0;1,0;;;5,0;3,0;1,0;;;1,0;;;3,0;11,0;2,0;2,0;116,0;;;;;5,0;;2,0;14,0;;;;1,0;;22,0;4,0;;;;10,0;2,0;;;;;;1,0;;;;4,0;;2,0;8,0;;;;;;;;;2,0;;;;1,0;;;3,0;1,0;;;;4,0;;;;;;;;;;;;6,0;;;;;;2,0;;12,0;;2,0;;5,0;;;3,0;;;41,0;;;;;;;;;;7,0;;2,0;;;;6,0;;;;;6,0;;;;;2,0;;;;1,0;;;;;;;;48,0;4,0;;;;;1,0;;;;2,0;2,0;;;;;;;;1,0;;;1,0;;1,0;;;;;1,0;1,0;;1,0;;;;;;;;;;2,0;;;;12,0;;;;;;;;;;;;;;;;;;;1,0;;;;;;;1,0;;;;;;;;;;;;;3,0;;;;3,0;;;22,0;;;;;;;;;;;;;;;;;;;;;1,0;;3,0;;6,0;;;;2,0;2,0;;;;8,0;;;;;;1,0;;;;1,0;5,0;;;;;;;1,0;1,0;;;;1,0;;;;1,0;;1,0;;;;;7,0;;;;;12,0;2,0;;1,0;11,0;;5,0;;1,0;7,0;;2,0;;;;1,0;;;;;;;;;1,0;;;;1,0;1,0;;;;1,0;;3,0;;;4,0;2,0;2,0;;;;5,0;;;2,0;2,0;;10,0;;;;;;;;2,0;1,0;;;;2,0;;4,0;;2,0;;;;3,0;;4,0;;9,0;;;3,0;;2,0;7,0;;;;6,0;3,0;;6,0;;;10,0;;;;;;;;;;7,0;;;;;;;;6,0;;2,0;;2,0;36,0;1,0;2,0;1,0;;1,0;4,0;;;;;;;;;;;;;10,0;2,0;;;;;2,0;;;;;;;;;;;;;;;5,0;;;;;;2,0;;;;;;2,0;;;;13,0;3,0;;;2,0;;7,0;;;3,0;3,0;;;;;;;;;;;;;;;;;3,0;;;;2,0;4,0;;;6,0;;;;15,0;;;;;;;;;;;;;9,0;;;;;;;;;;;3,0;;;10,0;;;;3,0;;;1,0;;;;;;;;;;;2,0;;3,0;;;;;;;;;;;;;;;;;;;;;8,0;6,0;;;;;;;;;;;;;;;;15,0;;;;;4,0;;;;1,0;3,0;;;;;;;;;;;;;19,0;5,0;;;;;;;;;;;;;;;2,0;;;;;;;;;;;;;;;;;;15,0;2,0;;;;;;;;;;4,0;15,0;;;;1,0;;;;;;;;;9,0;;;;;;1,0;;;;;1,0;;4,0;;;1,0;;;;;1,0;;;;;;1,0;;6,0;;2,0;;2,0;4,0;;;;;;;;;;;;;;1,0;;;;;;;;;;;;;;;;;1,0;;;2,0;;;;;;;2,0;2,0;;;;;;;;;2,0;;;;;;1,0;;;;;;;;;1,0;;;;;2,0;;;;;;;1,0;;1,0;1,0;;2,0;;1,0;7,0;;;;;;;;;;;;;;;;;;;;1,0;;;3,0;2,0;;;;;;;;;;;;;;;;;;;;;;;;;;2,0;1,0;;;;;;;;;2,0;;;;;;1,0;;1,0;;;;;;;;;;;;;;;;;;;;;;;;;;;;;;;;;;;;;;;2,0;;;;;;;27,0;;;;;;;;;
television;;;;;26,0;;;14,0;;2,0;1,0;;;;1,0;;;;;1,0;1,0;22,0;;;;;;;;;2,0;2,0;31,0;;11,0;;;;;39,0;3,0;1,0;;;;;;1,0;10,0;;14,0;3,0;;1,0;;14,0;15,0;;;23,0;;;19,0;;;;;;;9,0;1,0;;;;;6,0;;;;3,0;1,0;4,0;1,0;;;;;;;4,0;5,0;;;14,0;;;;;;;3,0;36,0;;;;;2,0;31,0;9,0;;;;;;2,0;;;;;5,0;;;2,0;14,0;;;3,0;;;2,0;16,0;;;;;;;;;;2,0;;1,0;3,0;1,0;1,0;;;;;;;;;2,0;;1,0;;2,0;;;;;;;;;1,0;3,0;;4,0;;10,0;2,0;;;1,0;3,0;;;;;;4,0;;;;3,0;;15,0;1,0;;;16,0;;;;;;;;;;;;;;;;1,0;;;;1,0;2,0;;1,0;;;;;1,0;;1,0;;;;;;;1,0;;;;5,0;;;;3,0;;;;;;3,0;1,0;9,0;;1,0;;;;;2,0;;;1,0;1,0;;;;;;1,0;3,0;;;;;2,0;;2,0;;1,0;;1,0;;;;;1,0;;;;;;;4,0;2,0;;;;;;;;;;;;;;1,0;3,0;;;;;3,0;;;;;;1,0;;;;;;;;3,0;;;1,0;;;4,0;;4,0;;;;;;;;;;;7,0;;;;;;;;2,0;13,0;4,0;1,0;;;;;;3,0;;;;;;;3,0;;;1,0;;;;;;;1,0;;;;;1,0;3,0;;4,0;;;;;;;;;;;;;1,0;;;5,0;1,0;1,0;;;;1,0;;5,0;;;;2,0;;2,0;;2,0;1,0;;1,0;;;;1,0;;18,0;8,0;;;;;;;1,0;;;;;;1,0;1,0;2,0;;;;;4,0;;;;;;1,0;;;5,0;1,0;;1,0;;2,0;;;;;;5,0;;;4,0;;;2,0;;;;2,0;;;;2,0;;;;;;;;;;7,0;1,0;3,0;;5,0;30,0;1,0;;;5,0;;;;;;;;;;;;;;;;1,0;4,0;3,0;;;;;;;;;;2,0;;1,0;2,0;;;;;;;;1,0;;;;;;;;;;;1,0;;;;;;3,0;;;;;4,0;;;;;;;1,0;;4,0;;;5,0;;;;;;;;1,0;;;;;;;;;;;1,0;;;3,0;;;;;;;;;;;;;;;;;;;;;;;3,0;;;;;;;;;;;;;;;;;3,0;;;;;;;;;;;1,0;;;;;;;1,0;;;;;;;;;;;2,0;;;;;;;;;;;;;;;;;;;;;2,0;;;;;;;;3,0;;;;;;;;;;;;;;;;;3,0;1,0;;;;;;;;;2,0;;;;;;;;;;;;;;1,0;;;;;;1,0;3,0;;;;;;;;;;;;;;;;;;;;1,0;;;;1,0;;;;;;;;;;;;;;;2,0;1,0;;;;;;4,0;;;;;;;;;;;;;;;;;;;1,0;;;;;;;;;;;;;;1,0;;;;;4,0;;;;;;2,0;;;;;;;;;2,0;;;;;;;;;;;;;;;;;;27,0;;;;;;;;;;;;;;;;;;;;;;;;;;;;;;;;;;;3,0;;;;;;;;;;;;;;;;;;;;;;;;;;;;;;;;;1,0;;;;;;;;;;;;;;;;;;;;;;1,0;;;;;;;;;;;;;;;;;;;;;;;;;;1,0;;;;;;;;;;;;;;;;;;;;;;;;;;;
thumbnail;;;;;5,0;;;5,0;;5,0;;;;;;;;;;3,0;;3,0;;;;5,0;;124,0;;3,0;;;5,0;;17,0;;;;;82,0;;;;;;;;;;;;14,0;;3,0;;308,0;12,0;;;2,0;;;12,0;;;;10,0;;;;2,0;;;1,0;;5,0;;;;;;3,0;;3,0;;;1,0;;18,0;42,0;;;;6,0;3,0;;;1,0;16,0;;;1,0;;2,0;;;;7,0;;;;;;;;;;;;1,0;;;;;;;2,0;;;1,0;;2,0;;;2,0;1,0;;;;;;;2,0;16,0;;;4,0;4,0;;;;;;;;;;;;;;;;;;;;3,0;;;;;;;;;;5,0;;;;;;;;;;14,0;;;;;;19,0;;;;;;;;;;;;;;;;;;1,0;;;;;8,0;;;;;;;;;;3,0;;;;;;;;;;;;;;;;;;;2,0;;;;;;2,0;;;1,0;;;;6,0;;;;;;;;;;;;;;;;;4,0;;;;;;;;;;5,0;;;;;;;;;;;;;;;;;2,0;;;;;;;;;2,0;;;;;;;;;;;;;;;;;;;8,0;;;;;;;;;;;4,0;;;;;;;;;;1,0;;;2,0;;;;;;;;;;1,0;1,0;;;;1,0;;;;;6,0;4,0;;;;;;;;;;;1,0;;;29,0;;3,0;;;;;;1,0;1,0;;;;;;;;;;;;;;;;;1,0;1,0;;1,0;;;;;;1,0;;;16,0;;2,0;;;;;;2,0;;;;;;3,0;;;;12,0;6,0;2,0;2,0;;;;1,0;;;3,0;4,0;1,0;2,0;;;5,0;;;;;;;;;;5,0;;;;;16,0;;;;;1,0;3,0;;;;1,0;3,0;;;;;;;4,0;4,0;;;;1,0;2,0;;;;;1,0;;;;;;;;5,0;1,0;;;;;;;;;;;;;;;;;;;;35,0;;;;;5,0;;;;;;;2,0;;;;;;;;1,0;;;;;1,0;;;8,0;;;;;;;;;4,0;;4,0;;;;;;;;;2,0;1,0;;;;;;;1,0;;;;;;;;;;;;;;;4,0;;;;;;1,0;;;;;;;;;;;;2,0;;;;;1,0;;;;;;;;;;;;;;;;;1,0;;;;;;;;;;;;;;;2,0;;;;;;;;;;;;;;;;;;;;;;;;;;;;;;;;;;;;;;;;;;;;;;;;;;;;;;;;;;;;;;;11,0;;;;;;;;;;;;;4,0;;;;;;;;;;;;;;;;;;;;;;;;;;;;;;;;;;;;;;;;;;;;;;;;;;2,0;1,0;;;;;;;;;;;;;;;;;;;;;;;;;;2,0;;;;;;;;;;;;;;;;2,0;;1,0;;;;;;;;;;;;;;;;;;;;;5,0;3,0;;;;;;;;;;;;;;;;;;;;;;;;;;;;;;;;;;;;;;;;;;;5,0;;;;;;;;;;;;;;;;;;;;;;;;1,0;;;;;;;;;;;;;;;;;;;;;;;;;;;;;;;;;;;;;;;;;;;;;;;;;;;;;;;;;;;;;1,0;;;;;;;;;;;1,0;;;;;;;
tone;;;;;26,0;;;18,0;11,0;23,0;;;;2,0;20,0;27,0;;1,0;7,0;3,0;;5,0;;;25,0;;4,0;37,0;1,0;7,0;5,0;2,0;4,0;6,0;5,0;;;;;1,0;2,0;;1,0;;6,0;;;;;;4,0;12,0;;10,0;;106,0;10,0;;;;;;18,0;;;;;;;1,0;3,0;;;;;;;;;;;19,0;5,0;1,0;;;5,0;;3,0;;2,0;;;22,0;4,0;;18,0;;2,0;;;;;;1,0;30,0;4,0;13,0;;;;;;;;;;15,0;;;;;4,0;;;;7,0;;3,0;;;;;;;1,0;;;;2,0;;;;4,0;3,0;;17,0;;;;9,0;;;;;;;;;;;9,0;;;;;30,0;2,0;;;;;;;;;;17,0;;;;1,0;1,0;;;;;6,0;;7,0;;;;1,0;;3,0;;;;;;;;;;;;;;;;;;;;;;;;;;;;;;;1,0;;;;;;;;11,0;;;2,0;3,0;;;;;;;;3,0;;;;;;;;;;;2,0;;;1,0;;;;;;;;;;;;;;;;;;;;;;;;;;;;;;;;;;;;;;;;;;6,0;;;;;7,0;;;;;;;;;;;;;;;;;;1,0;;;;;;;;;;;;;1,0;;;4,0;;2,0;;;;1,0;;4,0;;;;3,0;;5,0;;;;;;;;;12,0;4,0;;;;;;;;;;7,0;;2,0;;;;;1,0;2,0;;3,0;3,0;2,0;;;;3,0;;;3,0;;;;5,0;;;;;;;;;;;;;;;2,0;;;;;1,0;;;;;;;2,0;1,0;1,0;1,0;7,0;;;;;;;;;;;4,0;;;;;3,0;6,0;6,0;;;;1,0;2,0;;;;;;;;;;;;;;;;;;;22,0;;;;;;;;;;;;;;;2,0;;;;9,0;;;;;4,0;;;;;2,0;;3,0;7,0;;;;;;;;;;1,0;;;;;;;;;;;;;;;2,0;;;;;;;13,0;;;;;;2,0;;;;;;;;2,0;;;;;;;;;;;44,0;;;;;;1,0;;;;;;;;;;;;;;;;1,0;;;;;;;;;;;;;;;;;;;;;;;;;;;;;7,0;;;;;;;;;;;;;;;;;;;;;;2,0;;;;;;;;;;;;;;;;;1,0;;;;;;;;;;;;;1,0;;;;;;;;;;;;;;3,0;;;1,0;;1,0;2,0;;;;;;;;;;;;;;;;;;;;;;;;;;1,0;;;;;;7,0;;;;;;;;;;1,0;;;;;;;;;;3,0;;1,0;;;;3,0;;;;4,0;;;;1,0;;;;;;8,0;44,0;1,0;;;;;;;;;;;;;1,0;;;;;;4,0;1,0;;;;;;2,0;;;;;;;;;;;;;;;;;;;;;;1,0;;;;;;;;;;;;;;;;;;;;;;;;;1,0;;;;;;;;;2,0;;;;;;;;;;;;;;;10,0;;;;;;;2,0;;;;;;;;;;;2,0;;;;;;;3,0;;;;;;;;;;;;;;;1,0;;;;;;;;;;;;;;;;;;;;;;;;;;1,0;14,0;;;;;;;;;;;;;;;;;;;;;;;;;;;;;;;;;;;;;;;;;;;;;;2,0;;;;;;;;;;;;;;;;;;;;;;;;;;;;;;;;
tooth;;;;;9,0;;9,0;3,0;;;2,0;;2,0;;2,0;;;;;;;;;;;;;;4,0;;;;2,0;;;;;4,0;;;2,0;;10,0;;;;1,0;;1,0;;;4,0;;;;4,0;10,0;;;6,0;;;2,0;;1,0;3,0;;;;;;;;;;4,0;;;6,0;1,0;;;;2,0;;;;;;;2,0;;;;;;;;;;3,0;3,0;;7,0;;;;2,0;;;;8,0;;4,0;1,0;;;;;3,0;;;;;;;;12,0;;;5,0;;;;2,0;;33,0;;6,0;;;;2,0;25,0;;11,0;6,0;3,0;;;;;;;;;1,0;;2,0;2,0;;;2,0;;;;;1,0;;2,0;9,0;;2,0;1,0;1,0;1,0;5,0;;;;;;;;1,0;;;17,0;;10,0;;;;;4,0;;;;6,0;2,0;;2,0;;5,0;;;;;;4,0;;;;;2,0;;;;;;;;;;;;;;;;;;;;1,0;;;;;;;;1,0;2,0;;;;;21,0;1,0;;;;1,0;;;;;;;;13,0;1,0;;32,0;4,0;2,0;;;;;;;1,0;;;;;1,0;;;;;;;;7,0;1,0;;25,0;;;;;;;;;;;;;1,0;;;9,0;;2,0;;2,0;;;;;13,0;;;;70,0;;;;;;;;;2,0;;;;;1,0;;;;;;;;;;;;;;;;;;2,0;;;;;;;;;;;;;;;;;;;;;;;;;;;;;;;;;;;;;;;;;;4,0;;;;;;;;;;;;;;;;;;;;3,0;;;;;;;;;;;;1,0;;;;;;;;;;;;;;;;3,0;;;;;;;;;;;;;;;;;;;;;;;2,0;;1,0;;;;;;2,0;;;;;;;;;;;;;;1,0;;;;;;;;;;;;;;;;;;;;1,0;;;;;;;;;;;;;;;;;;;;;1,0;;;;;;3,0;;;;;;;;;;;2,0;;;;;;;4,0;;;;;;;;;;;;;;;;;;;1,0;;;;;;;;;;;;;2,0;;;;8,0;;;;;;;5,0;4,0;;;;;5,0;;;;;;;;;;;;;;;;;;;;;;;;;;;;;1,0;;;;;16,0;;;;;2,0;;;;;;;;;;;;;2,0;;;1,0;;;;6,0;;;;;;;1,0;;;;;;;;4,0;;;;;;;;;;;;;;;;;;;;;;;;;;;;;;;;;;;;;;;;;;;;;;;;;1,0;;;;;;;;;;;;;;;;;;;;;;1,0;;;;;;;;;;;;;;;;;;;;;;;;;;;;;;;;;;;;;;;;;;;;;;;;;;;;;;;;;;;;;;;;;;;;;;;;;;;;;;;;;;;;;;;;;;;;;;;;;;1,0;;;;;;;30,0;;;;;;;;;9,0;;;;;65,0;;;;;;;;;;;;;;;;1,0;;;;;3,0;;;;;;;;;;;;;;;;;;;;;;;;;;;;;3,0;;;;;;;;;;;;;;;;;;;;;;;;;;7,0;;;;;;;;;;;;;;;;;;;;;;;;;;;;;;;;;;;;;;;;;;;;;;;;;;;;;;;;;;;;
traffic;;;;;1,0;;;5,0;;;1,0;;;;;;;;;;2,0;;;;;;;16,0;;1,0;5,0;10,0;;;;;;;;3,0;;;;;;;;;;;1,0;3,0;;;;17,0;1,0;;;;;;9,0;;;;1,0;;2,0;;;;;;;;;;1,0;;;;4,0;;;;;;;;53,0;;;3,0;;2,0;;1,0;1,0;;;4,0;;;;8,0;;;;;;;;;;;;;;;;;;1,0;;8,0;1,0;;;;;;;;2,0;;;;;;;;1,0;;;1,0;;;;;;;;;;;;;;;;;;;;;;;;;1,0;;13,0;;;;;;;;;;;;;;;5,0;;1,0;;;;;;;;;;;;;;;;;;;;1,0;;;;;;;4,0;;;;;7,0;;;;2,0;;;;;;;;;;1,0;;;;;;;;;;;2,0;;;;;;;;;;;10,0;;;;;;;;;;;;;;;;;;;;;;;;;;;;;;1,0;7,0;;;;;;;;;;;;;;;;;;;;;;;;;;;;;;;;;;;;;;;;;;;;;1,0;;;;;;;;;;;;;;;;;;;;;;;;;;;;;;;;;;;1,0;;;;;;;;;;;;;;;1,0;;;;;;;;;;;;;;;;;;;;;;;1,0;;;;1,0;;;;;5,0;;;;;8,0;;1,0;;;;;;;;;;;;;;;;;;;;;;;1,0;;;;;;;1,0;;;;;6,0;3,0;;;;;;;2,0;;1,0;;;;1,0;;;;;;;2,0;;;;;;17,0;;;;;;;;;;1,0;3,0;;;;;;;;;;;;;;;;;;;2,0;;;;;;;;;;;;;;;;;;;1,0;;;;;;;;;;;;;1,0;;;;;;;;;;1,0;;;;;;;;;;;;;;;1,0;;;;;;;;;;;;;;;;;;;;;;;;;;;;;;;;;;;;;;;;;;;;;4,0;;;;;;;;;;;;;;8,0;;;;;;;;;;;;;;;;;;;2,0;;;;;;;;;;;;;1,0;;;;;;;;;;1,0;;;1,0;;;;;;;;;1,0;;;;;;;;;;;;;;;;;;;;;;;;;;;;;;;;;;;6,0;;;;;;;;;;;;;1,0;;;;;;;;;;;;;;;;;;;;;;;;;;;;;;2,0;;;;;;;;;;;;;;;;;1,0;;;;;;;;;2,0;;;;;;;;;;;;;;;;;;;;;;;;;;;;;;;;;;;;;;;;;;;;4,0;;;;;;;;;;;;;;;;;;;;;;;;1,0;1,0;;;;;;;;;;;;;;;;;;;;;;;;;;;;;;;;;;;;;;;;;;;;;;;;;;;;;;;;;;1,0;;4,0;;;;;;;;;;;;;;;;;;;;;;;;;;;;;;;;;;;;;;;;;;;;1,0;;;;;;;;;;;;;;;;;;;;;;;;;;;;;;;;;;;;;;
trajectory;;;;;6,0;;5,0;1,0;2,0;;;;1,0;;;;;;;;;1,0;;;;;;6,0;;1,0;;2,0;11,0;1,0;;;;4,0;;6,0;4,0;;;1,0;;;;;1,0;;;1,0;;1,0;;3,0;3,0;1,0;1,0;4,0;;;13,0;;;;13,0;;;3,0;6,0;;2,0;;;;;5,0;8,0;;;;1,0;;;;;;;1,0;;2,0;;1,0;;;5,0;3,0;4,0;;1,0;7,0;;;;;;4,0;;;;;6,0;;;;;;;2,0;;;;;;1,0;1,0;;;;;2,0;;;;14,0;;;;;;;;1,0;;;;1,0;;;;3,0;;;3,0;;;;;8,0;1,0;;;;;;;;;;4,0;;;;3,0;;;;;;;;2,0;;;5,0;;;;5,0;;;11,0;;1,0;;;;;;;1,0;;2,0;;;;;;;;;;;;;;;;;;2,0;;;;;;;;;;;;;;8,0;;;;;1,0;;;;;;;;;;;;;;;;;7,0;;;;1,0;;;3,0;;;;;;;;;;;;;;;;;;;;;;;6,0;;;;;;;;2,0;;;;;;;;9,0;1,0;;;;;;;;;;;;;;;;;;1,0;;;;;;;;;;;;;;;1,0;;;;;;;;;;;;;;;1,0;1,0;;;1,0;;;;;;;;;2,0;;;;4,0;;;;;;;5,0;;;6,0;;;;2,0;;;;3,0;;;;3,0;1,0;;;;;;;;1,0;;;;;;;3,0;;;;;;;;;2,0;;;2,0;1,0;;;;;;;;;;;;;;;;;;;;;;;;1,0;;;;;;;;1,0;;;;;;;;;;;;;;;;;;;4,0;;;;1,0;;;;;;;;;;2,0;;;;;;2,0;;;3,0;;;;;;;;;2,0;;;;;;;;;;;2,0;;;;;;;;7,0;;;;;;;;;;;;;;;;;;;;;;;;;;;;;;;;;;2,0;;;;;;;;;;10,0;;;;;;;;;;;;;;;;2,0;;;;;;;;;;;;;;;;1,0;;;;;;;;;;;;;;;;;;;;;;;;;;;2,0;;;;;;;;;;;2,0;;;;;;;;;;;;;;;;;;;;;;1,0;1,0;1,0;;;;;;;;;;;;;;;;;;;;;;;;;;;;;;;;;;;;;;2,0;;;;;;;;;;;;;;;1,0;;;;;;;;;;;;;;;;;;;;1,0;;1,0;;;;;;;;;;;;;;;;;;;;;;;;;;;;;;;;;;;;;;;;5,0;;1,0;;;;;;;;;;;;;;;;;;;;;;;;;;;;;;;3,0;;;;3,0;;;;;;;;;;;;;;;;;;;;;;;;;;;;;;;;;;;;;;;;;;;;;;;1,0;;;1,0;;;;;;;;;;4,0;;;;;;;;;;;;;;;;;;;;;;;;;;;;;;;;;;;;;;8,0;;6,0;;;;;;;;;;;;;;;;;;;;;;;;;;;1,0;;;;;;;;;;;;;;;;;;;;2,0;;;;;;;;;;;;;8,0;;;;;;;;;;;;;;;;;;;;;;;3,0;;;;
transistor;;;;;13,0;;;12,0;;;;;;;4,0;;;1,0;;;;13,0;;;1,0;;;1,0;;16,0;34,0;4,0;89,0;2,0;7,0;;9,0;10,0;;;;;7,0;29,0;;;;;;;22,0;11,0;;11,0;;37,0;138,0;;7,0;1,0;;;4,0;;;;;;;27,0;4,0;1,0;9,0;2,0;;;7,0;2,0;1,0;5,0;;4,0;;1,0;;3,0;94,0;;;18,0;13,0;14,0;;141,0;;;;4,0;1,0;42,0;37,0;11,0;;242,0;;;78,0;26,0;;;1,0;12,0;1,0;;;;4,0;;;;;;;70,0;;1,0;7,0;1,0;;19,0;;;1,0;;;3,0;13,0;;120,0;;;;;1,0;4,0;;51,0;1,0;1,0;;;;;1,0;7,0;;1,0;;;53,0;1,0;;4,0;;;30,0;5,0;9,0;69,0;;;9,0;1,0;;;;;59,0;;;;;;;;;;106,0;;23,0;;;;17,0;;;;;;;31,0;;;17,0;;;;;6,0;;;;3,0;9,0;;3,0;;;;;;;;;4,0;;;;;;;;;3,0;1,0;;;24,0;2,0;;;;;1,0;;;28,0;8,0;;;13,0;;5,0;299,0;12,0;;;;;;;13,0;1,0;;;;3,0;;;;;8,0;11,0;;;;;;;;;;;;;;;;3,0;19,0;;;3,0;;;;32,0;;;;;;5,0;;;;;1,0;;;7,0;11,0;;;;;;;;;;14,0;;;;106,0;;;33,0;;;2,0;;;;23,0;;1,0;;;2,0;3,0;;2,0;;;;8,0;;;1,0;;;5,0;;;;;;;;;;4,0;;;;;21,0;;;2,0;;;;27,0;;;;6,0;1,0;33,0;;;9,0;;;1,0;;;;;;;;;1,0;;25,0;;;;;;;;;;;7,0;;;30,0;;;;;;45,0;;2,0;;;;;;;46,0;;;1,0;;;;;;1,0;;;;;;;1,0;2,0;;35,0;;;33,0;;;48,0;1,0;;;;;;;;;;;;5,0;;;;;;3,0;;;;;;;;;1,0;;;;;;;7,0;;14,0;;32,0;;29,0;2,0;;;120,0;;7,0;;4,0;;;;;;;;;;;;;;4,0;;;;;;;;;;;;;;;;;;;;;;;;;;;;;;;;;;;;;1,0;;;;1,0;;;;118,0;25,0;;;;;2,0;;;;;;;;;;;;;;;;;1,0;;14,0;;;;;;;;;7,0;41,0;;;;2,0;;4,0;;;;;;2,0;;;;;1,0;;;;;;;;175,0;;2,0;5,0;13,0;;;;5,0;;;8,0;;;;;;;;;;;;;;;;3,0;;;;34,0;;;;;;;6,0;;;;;;;11,0;;;;;;;;6,0;4,0;;;;5,0;;108,0;168,0;;;;37,0;71,0;;;50,0;2,0;6,0;;;;61,0;293,0;;;3,0;;4,0;47,0;;;1,0;46,0;;;;9,0;;;;;;;;;;;;1,0;;;;;;;;;;;;12,0;1,0;;;;;;;;;;;;3,0;;;;;;;;;;7,0;13,0;;;;;2,0;3,0;4,0;;;;;;10,0;;;;;;;;;;;;;;;;;;;;;;;;;;;;;;;3,0;;;;;;;;;;;;;3,0;;3,0;;;;;4,0;;;;;;8,0;;;;;;;;;;;;;;1,0;;;;100,0;;;;;;;;;;;;29,0;;25,0;;;;;;;;;;1,0;;;;;;;4,0;;;;;;;;7,0;;;;;;;;1,0;;;;;;;;;;;;;;;;;;;;;;;;;;;;;;;2,0;10,0;;;;;;;;;;;;;;;;;;1,0;;;;;;;;1,0;;;;;1,0;4,0;;;3,0;;;;;;;;;;;;;;;;;;;;;;;;;;;;;;;;;;;;;;;
transition;;;;;1,0;;;4,0;;7,0;;;;4,0;1,0;2,0;;;4,0;4,0;8,0;6,0;5,0;5,0;5,0;;;35,0;;21,0;10,0;12,0;4,0;;;;;;;13,0;;;;5,0;;;;1,0;;;1,0;2,0;;1,0;;50,0;9,0;5,0;1,0;3,0;;;9,0;;1,0;;;;3,0;1,0;3,0;1,0;2,0;;;;;18,0;3,0;1,0;;2,0;10,0;;;;9,0;;;2,0;2,0;;;4,0;1,0;3,0;;;;;6,0;7,0;;3,0;;;;18,0;;;;;1,0;;;;;;;;;;1,0;1,0;;;4,0;4,0;;;;;;2,0;;;;;;;;;;6,0;;;3,0;19,0;;;;;;;;;;2,0;;;;;;;;;2,0;;;;2,0;2,0;;;8,0;2,0;;1,0;;2,0;;;;;;1,0;1,0;8,0;;2,0;;;;;;;;;;;;;;3,0;;;;;;;;;;;;9,0;;1,0;;;;4,0;;;1,0;;;;;;;;;;;24,0;;;9,0;;;;;;;;2,0;;;;;;;1,0;2,0;;;13,0;;;4,0;3,0;1,0;;1,0;;3,0;;;;;;;;;;;;;1,0;;;;;;8,0;;7,0;1,0;;;;;;;;;2,0;;;;;9,0;3,0;;;;;;;1,0;10,0;2,0;;;;;;;;;;;;;8,0;;;;;9,0;;;;;;;;;;;;;;;1,0;;;;3,0;1,0;;;;;;1,0;;;;;;;;10,0;10,0;;;;1,0;;;;1,0;;;;;;;9,0;1,0;;;;;;;1,0;;;2,0;;;2,0;4,0;1,0;3,0;8,0;;;;;;8,0;;;8,0;2,0;;;3,0;;;;2,0;;;2,0;;;;;;6,0;;;;;4,0;2,0;;;;;;;;;;;2,0;;;;;;;;;;;3,0;3,0;;;;;;;;;;;;;;;5,0;;;12,0;;4,0;;;;;;;;;;;;;11,0;;;5,0;;5,0;1,0;;13,0;14,0;;;1,0;;;;;;;;;;;;;;;;;1,0;;;;;;;;;;;;;;;;;;;;;;;;;;;;;;;;1,0;;;;;;;;;;;;1,0;;2,0;;1,0;;;;;;;;;;;;;;;;;;;1,0;1,0;;;;;;3,0;1,0;;;;1,0;2,0;;;1,0;;;;;;;;;2,0;;;;;;;;;;;;;;;1,0;;;;;;;;;;;;;;;;;;;;;;;;;;;1,0;;;;;;;;;;;;1,0;;4,0;;;;;;;;;;;;;;;;;;;;;;;;;;;;;5,0;;;;;4,0;;;;;;;;;;;10,0;3,0;;;;;;;;;;1,0;;;;;;;;1,0;;;;4,0;1,0;4,0;;1,0;;;;;;;;1,0;;;1,0;2,0;;;;;;;;;;10,0;;;2,0;;;;;;;;;;;;1,0;;;;1,0;;1,0;;;;;;;;;1,0;;;;;;4,0;;;;;;;3,0;;;;2,0;;;;;;;;9,0;3,0;;;;;;;;;;;3,0;;;;;;;;1,0;;;;;;;;;;1,0;;;;;;;;;;;;;;1,0;;;;;;;;;;;;;;;;;;;;;;;;;;;;;;;;;;;;2,0;;;;;2,0;4,0;;;;;;;;;;;;;;;;;1,0;;;;;;;;;;;;;;;;;;;;;;;;;;;;4,0;;;;;;;;;;;;;;;;;;;;;;;;;;;;;;;;;;;;;;;;;;;;;;;;;;;;;;;;
transmitter;;;;;25,0;;;14,0;1,0;7,0;;1,0;;;;;1,0;2,0;2,0;3,0;;12,0;1,0;;;;;63,0;;7,0;2,0;5,0;28,0;;17,0;;6,0;;;12,0;4,0;;;4,0;;;;4,0;1,0;14,0;2,0;4,0;1,0;;;73,0;38,0;;;2,0;;;13,0;;;2,0;1,0;;;9,0;5,0;;1,0;;;;;;20,0;6,0;;2,0;10,0;;;;;;3,0;5,0;26,0;;;91,0;3,0;;;;1,0;;;44,0;;1,0;3,0;2,0;;43,0;2,0;;18,0;2,0;4,0;3,0;;;;1,0;;;;;2,0;3,0;;;14,0;;;6,0;;;;;;3,0;2,0;;;5,0;;;4,0;;;1,0;;4,0;;;;;;;;;;12,0;;;;;1,0;1,0;;;3,0;6,0;;;1,0;;9,0;3,0;;;;8,0;;;;1,0;;;;;;6,0;;9,0;;;6,0;30,0;;3,0;;;;;;;;1,0;;;;;1,0;2,0;;5,0;;;;2,0;125,0;;1,0;;;3,0;;;;1,0;1,0;;;;;;;;;1,0;;;13,0;;1,0;;2,0;1,0;4,0;;;;;;;;;14,0;;;;;2,0;;;;;;;;;;;;;;;;;11,0;;;;2,0;;;2,0;;;3,0;;4,0;4,0;1,0;1,0;;;;;;;;;;;;3,0;;;;;1,0;;;4,0;9,0;;;;;3,0;;;;;3,0;;;;22,0;;;1,0;;;;;;;;;;;;;7,0;;;;;;;;3,0;;9,0;2,0;;;;;;;;;;;;;1,0;1,0;;2,0;;;1,0;;;3,0;;1,0;;;;;2,0;;1,0;;;3,0;;;7,0;;2,0;;;40,0;;;1,0;;;4,0;;5,0;;;;;;;4,0;;2,0;;;1,0;;;;1,0;30,0;17,0;;;2,0;;;;4,0;;;;;;;;;;2,0;6,0;4,0;;;;2,0;;2,0;;4,0;;;;;;3,0;;1,0;6,0;;3,0;1,0;;;;;2,0;4,0;;2,0;1,0;;;3,0;;;2,0;;;19,0;;;;;;;;;;;;1,0;;4,0;;5,0;20,0;;;;;;;;;;37,0;;;;1,0;;;;;5,0;10,0;;;;;;1,0;;;;;;;;;;;;;;;;2,0;2,0;;;;4,0;;;;;;;;;;;;;5,0;;;4,0;;13,0;;;;;;;;;;;;4,0;;4,0;;;;;;5,0;;;;;;1,0;;;;;43,0;;;3,0;;;;;;;;;4,0;;;;;;;;;;;;2,0;3,0;49,0;;;;;;;;11,0;;;;18,0;1,0;;;;1,0;;;27,0;;;;;;;;;;;;;;;;;;;;;;;;1,0;;;;;;;;;;;;;;;;;;;;3,0;;;;6,0;;;;;;;;2,0;;;;;;1,0;;1,0;;2,0;;;;2,0;;;;;;;;;;;1,0;;;;;;;;;;;;;1,0;;;;;;;;;;;;;;;;;;;;;;;;;;3,0;;;;;;;1,0;;;;;;;;2,0;;;;6,0;;;;;;;;4,0;;;;;;;2,0;;;;6,0;;;;;;;;;;;;;;1,0;;;;;;;1,0;;;;;;;;;;;;;;;;;;;;;;;40,0;3,0;;;;;1,0;;;;;;;;;;;;6,0;;;;;;;;;;;;6,0;2,0;;;4,0;;;;;;;;;;;;;;;;;;;4,0;;;;;8,0;;;;7,0;;;;;;;;;;;;;;;;;;;1,0;;;;;23,0;;1,0;;2,0;;;;;;;;;;;;;;;;1,0;;;;;;;;;;;;;;;;;;;;;;;;;;;;;;;;;;;;;;;;;;;;;;1,0;;;;;;;;;
transparent;;;;;13,0;;2,0;52,0;;13,0;;1,0;4,0;;15,0;1,0;;;13,0;2,0;;1,0;1,0;1,0;3,0;;1,0;;1,0;;1,0;;72,0;;26,0;;;16,0;;42,0;;1,0;1,0;120,0;;;;;1,0;;3,0;1,0;;2,0;8,0;80,0;106,0;;1,0;106,0;6,0;;51,0;;;3,0;;2,0;;;54,0;2,0;1,0;2,0;16,0;;;9,0;43,0;3,0;1,0;1,0;1,0;1,0;6,0;6,0;29,0;;;5,0;47,0;;;5,0;2,0;8,0;;2,0;1,0;169,0;136,0;16,0;;;;;;24,0;;4,0;7,0;52,0;30,0;9,0;11,0;1,0;1,0;;5,0;21,0;5,0;;;9,0;17,0;3,0;19,0;19,0;;20,0;164,0;;9,0;;3,0;1,0;55,0;;53,0;4,0;;2,0;6,0;28,0;46,0;;142,0;10,0;;21,0;;8,0;11,0;1,0;4,0;13,0;14,0;87,0;3,0;38,0;3,0;;21,0;1,0;;128,0;;103,0;;97,0;118,0;3,0;63,0;20,0;;18,0;30,0;2,0;2,0;7,0;50,0;2,0;16,0;2,0;;4,0;89,0;46,0;1,0;121,0;14,0;;8,0;16,0;3,0;7,0;29,0;;;5,0;4,0;13,0;;62,0;2,0;1,0;;;30,0;19,0;7,0;2,0;1,0;22,0;;9,0;7,0;;;9,0;29,0;3,0;;11,0;29,0;7,0;133,0;2,0;;;;;1,0;19,0;1,0;12,0;;5,0;49,0;;12,0;9,0;6,0;32,0;;2,0;;32,0;3,0;;;7,0;2,0;14,0;6,0;6,0;2,0;12,0;;;;;7,0;;;;6,0;;;3,0;;32,0;1,0;1,0;1,0;3,0;2,0;;1,0;7,0;;;3,0;;2,0;;2,0;10,0;;23,0;1,0;;;1,0;;3,0;7,0;1,0;;;1,0;;13,0;22,0;23,0;;;10,0;13,0;2,0;;7,0;;;;;;;;28,0;;5,0;;;;13,0;1,0;;4,0;;7,0;;;;;;;;;;;1,0;;;;;;2,0;7,0;;6,0;;;;;;;;3,0;;;;1,0;;;;;;2,0;;;2,0;;;11,0;;;;;3,0;2,0;3,0;;;;;;;;29,0;;4,0;;2,0;9,0;;;;;;3,0;;;;;;;2,0;;;12,0;14,0;4,0;8,0;;;2,0;;;3,0;3,0;;;;;1,0;;;;1,0;;;;;;;;;;;;;;;;;1,0;1,0;;;;;3,0;;;;;;;;;;;;;1,0;;1,0;;;;;;;5,0;;4,0;;;;;;;;;;4,0;1,0;;2,0;2,0;4,0;1,0;1,0;7,0;19,0;;1,0;;;;;;;18,0;3,0;;2,0;11,0;;7,0;;;;;6,0;;;;;;1,0;;7,0;;1,0;8,0;;;;;;11,0;;;;;;;;;;;9,0;9,0;;;;;;;;1,0;;;9,0;4,0;;;6,0;7,0;;;;;;3,0;;;;;;;;3,0;;1,0;;;;1,0;;2,0;;;2,0;;;;;;26,0;;2,0;6,0;;;;1,0;;;;1,0;4,0;2,0;;;2,0;;;;7,0;;;;;1,0;;2,0;;;2,0;;4,0;;;;;1,0;;;7,0;1,0;;3,0;;6,0;3,0;;;;;1,0;4,0;2,0;;;;;;;134,0;;;2,0;;;;;;;;;;7,0;4,0;;2,0;3,0;2,0;2,0;;;6,0;;;16,0;;;;;;;;52,0;;;1,0;;;;6,0;1,0;;;;5,0;2,0;3,0;;;;;3,0;;6,0;;;;;;;;3,0;;;;;;17,0;15,0;;2,0;;;;;;3,0;;;;;4,0;;;;;;;;3,0;;;;;2,0;;;;;;;1,0;3,0;3,0;1,0;;;13,0;;;1,0;1,0;;2,0;1,0;;;;;;2,0;;;;;1,0;;;;3,0;;;;;;;;;;;;;2,0;;;4,0;;;;;;1,0;;;1,0;2,0;8,0;;;1,0;;2,0;;;3,0;;;;;;;;;;;;1,0;7,0;5,0;2,0;;;27,0;;4,0;;;;;;10,0;;;;2,0;;;2,0;;;;;;;2,0;;2,0;;;;;2,0;;;1,0;9,0;;;3,0;;1,0;;;;4,0;;;;2,0;;;;;1,0;;3,0;56,0;;;;;;;;;;;;;;;;3,0;;2,0;;;;8,0;;;;;;;;;7,0;;;2,0;;;;;;;;;;;;;;;;;1,0;;;;7,0;;;;5,0;;;;;22,0;15,0;;;;2,0;;2,0;1,0;;;;;;1,0;;;;;;;;;;;;;;;;;;;;;;;;;17,0;;;;;;;;
tube;;;;;30,0;;13,0;5,0;;1,0;17,0;2,0;;;;2,0;;;;;;5,0;;2,0;;;;;1,0;;;;28,0;;8,0;;3,0;12,0;;3,0;3,0;;22,0;13,0;;;1,0;;1,0;;;1,0;;2,0;;17,0;30,0;;4,0;170,0;4,0;1,0;22,0;;;;1,0;14,0;;;2,0;;2,0;7,0;2,0;4,0;;4,0;59,0;6,0;;1,0;;;;2,0;4,0;;;;11,0;;;4,0;;8,0;;1,0;2,0;1,0;53,0;11,0;;;;2,0;2,0;41,0;5,0;2,0;8,0;3,0;9,0;29,0;53,0;1,0;;;3,0;8,0;;;;4,0;;5,0;3,0;2,0;;7,0;9,0;4,0;2,0;;5,0;2,0;6,0;;4,0;27,0;2,0;;5,0;2,0;6,0;1,0;12,0;;;3,0;;1,0;3,0;;6,0;;1,0;11,0;;3,0;;;50,0;7,0;;;;70,0;;9,0;15,0;;14,0;46,0;21,0;12,0;58,0;;;;3,0;1,0;2,0;;11,0;;;10,0;;15,0;;;;1,0;;2,0;;;3,0;12,0;;1,0;3,0;8,0;;;;;8,0;47,0;;5,0;2,0;;2,0;2,0;7,0;9,0;;;11,0;;5,0;;10,0;;11,0;;;1,0;1,0;;10,0;4,0;3,0;;;4,0;2,0;;;3,0;2,0;;4,0;5,0;12,0;3,0;3,0;;;1,0;;27,0;;1,0;4,0;7,0;;5,0;1,0;1,0;2,0;;6,0;1,0;17,0;1,0;4,0;;10,0;9,0;;2,0;1,0;;;;;3,0;;;;;;1,0;4,0;2,0;;2,0;;;;1,0;;2,0;;3,0;;1,0;;;7,0;2,0;;5,0;11,0;;2,0;;;;;;2,0;;;;4,0;;;7,0;;;;1,0;19,0;4,0;1,0;;;1,0;2,0;;;;3,0;;;;3,0;1,0;9,0;;;;;4,0;;;1,0;;;;;;;;;;;;;3,0;;;;;2,0;;;;;2,0;;;4,0;;;4,0;;;;;;;;;;1,0;;1,0;;;;;;;;;;;;;;;;;;;1,0;;;;;;;;8,0;;;;;;2,0;;;;;;;;;;;6,0;;;;;;;;;;;1,0;;;;;;1,0;17,0;;;;;;;;;;;;2,0;5,0;;;;;;;;;;3,0;;;;;;;;;6,0;2,0;;;;;;;;4,0;5,0;;3,0;;;;;;;4,0;1,0;;16,0;;;;;;;2,0;2,0;2,0;;;;1,0;22,0;;;;;;2,0;;;;;;;;;;;;;;;;19,0;4,0;;;;;;1,0;;;;;;2,0;9,0;2,0;3,0;1,0;;;;3,0;;17,0;;;;;;;;1,0;;5,0;;;;;;2,0;;;;1,0;;;;6,0;4,0;;2,0;;;;;1,0;;3,0;;;16,0;;;;16,0;;1,0;;1,0;4,0;;;;;;;;;;;;;;;;1,0;;;3,0;10,0;2,0;3,0;;3,0;;2,0;;;;2,0;;;;;;;;;;;;11,0;7,0;;;;1,0;2,0;;;;17,0;;;;;;2,0;;;;3,0;;;3,0;;;;;;;;;2,0;;;;30,0;5,0;;;;;;;;;1,0;;1,0;;;2,0;;;;1,0;;;;1,0;;;;;;4,0;;;;;;;;;5,0;;;;;;;;;;;;;;1,0;;3,0;;;;;;;;;;;;1,0;;;;;;;;;3,0;;;;;;;;;;9,0;;;;;;;;;;;;;;;;;;;;;;1,0;;;;;;;;;;;;;;;;;;;1,0;;1,0;;3,0;;;;;;;;6,0;;1,0;;;2,0;2,0;;;;;;1,0;;6,0;;;;;;;;;;;;;;2,0;;4,0;;;;;;;;;;;1,0;;;;;4,0;2,0;;;;;1,0;;;1,0;2,0;;;;;;;;;;;;5,0;;;1,0;;1,0;;;;;;;;;;;;;;;;;;;;;;;;;2,0;;;;;;;;;;;;;;;;;;;;;;;;1,0;;2,0;;;;;;;;;;;;;;;;;;;;;;;;;;;;;;;;;;;;;;;;;;;;;;;
viewpoint;;;;;18,0;;;;28,0;5,0;2,0;;1,0;;;;;;;1,0;5,0;7,0;2,0;;4,0;;;7,0;;;;4,0;8,0;;;;;1,0;;8,0;7,0;;;4,0;;;;;;;;10,0;;;;60,0;2,0;3,0;;1,0;4,0;;6,0;;1,0;;2,0;;1,0;;2,0;;3,0;;;;;4,0;12,0;;;3,0;;;;;9,0;;4,0;5,0;4,0;;1,0;;;14,0;;;;;1,0;6,0;;;;2,0;;7,0;;;;2,0;1,0;;;;;;;;;;5,0;;;;1,0;;;;;;;;1,0;;;;;;;;;;;;;127,0;;;;;;;;;;;1,0;4,0;;;;;;;;14,0;;;;;1,0;;;;;4,0;;;2,0;;;;2,0;;;13,0;;4,0;;;;;;1,0;;;4,0;;;;2,0;3,0;;;;;2,0;;;;;;;5,0;2,0;;;;;;;;;;;;;;;;;;1,0;9,0;;;4,0;;;;60,0;;;;;;;;;;;;;;;1,0;1,0;;;;;;;;;;;;;2,0;;;;;;;;2,0;;;;1,0;;1,0;4,0;53,0;1,0;;;;;;;;;2,0;;;;;;;1,0;;;;;;2,0;1,0;;;;;;;;;;1,0;;;;;;;;8,0;1,0;;;;;;;;;;;;;;;;;;;3,0;3,0;;;;;;1,0;;;;2,0;;;;2,0;;;;;14,0;;;;;;1,0;;;;;1,0;;;;;;;;;2,0;;1,0;;;;;;2,0;;;1,0;;;;42,0;;33,0;;3,0;;;;;;;11,0;;;1,0;;3,0;;;;;;;;;14,0;1,0;6,0;;;;;;;;;;;;;;;5,0;;;;;;3,0;;;;;;2,0;;;;;;;;;;17,0;;;1,0;;3,0;;;;;;;;;;;;;5,0;;;3,0;;;;;8,0;19,0;;;;;;;;;;;;;;;;;;;;2,0;;;;;;;;;;;1,0;;;;;;;;;;;;;;;;;;;;;;;;2,0;;;;;;2,0;;;;2,0;;;;;;4,0;;;;;;;;;;;;;;;;;;;;;;;;;;;;;;;;;;;;;;;;;;;;;;;;;;2,0;;;;;;;;;;;;;;;;;;;;;;;;;;;;;;;;;;;;;;;;;;;2,0;1,0;;;;;2,0;;;;;;;;;;;;;;;;;;;1,0;;;;;;;;;;;;;;;;;;;;;;;;;3,0;;;;;;;;;;;;2,0;;;;;;;;;1,0;;;;;;;;;;;;;;;;;;4,0;;;;;;;4,0;1,0;;;;;;;;;;;;;;;;;;;1,0;;;;;;;;3,0;;1,0;;;;;;3,0;;22,0;;;;;;;7,0;;;;7,0;;8,0;1,0;;;;9,0;;4,0;;;;;;;;;2,0;;;;;;;;;;;3,0;;;;;;;;;;;;;;;;;;;;;;;;;;;;;;;;;;;;;;;;;;;;;;;;;;;;;;;;;;;;;;;;;;;;;;;;;;1,0;;2,0;;;;;;;;;;;;;;;;;;;;;;;;;;;4,0;;;;;12,0;;;;;;;;;;;;;;;;;;;;;;;;;;;;;;;;;;;;;;;;;;;;;;;;47,0;;;;;;;;;;
vision;;;;;25,0;;2,0;11,0;;14,0;;2,0;;;;;;;1,0;26,0;;6,0;3,0;1,0;;;;;3,0;4,0;4,0;3,0;69,0;1,0;3,0;;6,0;;;42,0;;;;35,0;;;;;1,0;;5,0;2,0;;2,0;;75,0;26,0;;;9,0;;;24,0;;;;;;;3,0;28,0;1,0;9,0;8,0;;;;1,0;17,0;2,0;1,0;4,0;8,0;2,0;;;5,0;;;1,0;2,0;;1,0;8,0;;;;;1,0;;7,0;156,0;;;1,0;;;10,0;;;1,0;13,0;2,0;2,0;1,0;;;;1,0;;;;2,0;;;;11,0;;2,0;5,0;;1,0;;;;5,0;1,0;;;;;;;;;;;1,0;1,0;;;;1,0;;;;1,0;3,0;1,0;26,0;;;;;;;;15,0;;5,0;9,0;4,0;7,0;2,0;;;;4,0;;;;1,0;;;;3,0;4,0;3,0;;5,0;;;;15,0;;2,0;;;1,0;;1,0;;;;;;;;3,0;2,0;19,0;;;;;1,0;4,0;;;;;131,0;;;1,0;;;1,0;;;1,0;;1,0;;;1,0;;4,0;3,0;;;;;;;;;;;;;;;3,0;;;;;4,0;;;;;;2,0;2,0;2,0;;1,0;;;1,0;1,0;;;5,0;;;;2,0;1,0;;;4,0;;;7,0;11,0;2,0;;;3,0;;2,0;;;;9,0;;;1,0;;;;;;;2,0;6,0;;;1,0;;;1,0;;;;;;;1,0;;;;;;;;1,0;4,0;;1,0;;;;1,0;;;1,0;;;;;;;1,0;;;4,0;;;3,0;;;;;;;;1,0;;;;;1,0;;;;;;;;;1,0;3,0;;;;;;;;;;;;;;;;2,0;;1,0;;;;;;1,0;1,0;1,0;2,0;2,0;;;;;;;;;;;;1,0;1,0;;3,0;;2,0;;;;3,0;;;;4,0;3,0;1,0;;;;;;;;;;;;;;;;;;;4,0;;3,0;14,0;;;;;;;;;;;;;5,0;2,0;;1,0;;1,0;4,0;;;;;9,0;;2,0;;;;;;;;5,0;1,0;;4,0;;1,0;;1,0;13,0;8,0;15,0;;3,0;;;;;1,0;;;;;;6,0;;;;;1,0;1,0;;;;;;;;;;;3,0;;;;;;;;;;;;;;;;;;2,0;;;6,0;;1,0;;;;1,0;;;7,0;;1,0;;1,0;;;;;;5,0;;;;;1,0;;;;;;4,0;;;;1,0;;;;;;;;;;;;;;1,0;;2,0;;;;;;;5,0;;;;6,0;;;;;;;;1,0;1,0;2,0;;;;;1,0;;;;4,0;;;2,0;;;1,0;38,0;;6,0;;;;;1,0;;;;;;1,0;;;;;;;4,0;;;;2,0;;2,0;;;;;;;;;;;;;;;;;;;;;4,0;1,0;3,0;20,0;;;;;;;;;;1,0;;;;;;;;;;;;;;;12,0;;;;;;;;2,0;;;;;;;;;;;;;2,0;;3,0;;;1,0;1,0;;2,0;;;;1,0;;;;;;;;;;1,0;;;;;;;;;;3,0;;;;;;;;;;;;;2,0;;4,0;;;;1,0;;7,0;;1,0;;;1,0;;;;1,0;;;;;;;;;;;;;;;;;;;;;;;;;;;;;;;;;;;;;;;;;;;;;;;1,0;;;;;;;;;;1,0;;1,0;1,0;;;;1,0;;2,0;;;;;;;;;;;;;;;;;;;;;;;;;;;;;;;;;;;;;;;;;;;;;;;;;2,0;2,0;;;;2,0;;;;;;3,0;;;;;;;;;1,0;;;;;;;;;;;;;;;11,0;;;1,0;5,0;;;;;;;;;;;;;;;;;;;;;;1,0;;;;;;;;;;;;1,0;;;;;2,0;;;;;;;;;;;;;;
voice;;;;;10,0;;1,0;3,0;;8,0;;;;;1,0;;;;3,0;;7,0;33,0;;;;;;5,0;;32,0;9,0;6,0;15,0;;7,0;;1,0;66,0;2,0;;;;12,0;1,0;;;;;;1,0;;25,0;;1,0;;28,0;6,0;;;5,0;10,0;;13,0;;;20,0;7,0;;;3,0;1,0;;;;;;1,0;;2,0;;;7,0;4,0;2,0;;;;;;2,0;23,0;1,0;;43,0;;;;;;;1,0;10,0;;;2,0;;;24,0;;;3,0;;;3,0;;;;;;;;;;;;2,0;14,0;;;5,0;;;;1,0;;17,0;1,0;;;;1,0;;4,0;7,0;;1,0;3,0;;;;;;;;7,0;2,0;;4,0;;7,0;;;;;;;2,0;1,0;;;5,0;;13,0;2,0;3,0;;;16,0;;;1,0;;;;;;;8,0;;4,0;;;;33,0;;;;;1,0;;;;;;4,0;1,0;6,0;;;2,0;;;;;;7,0;18,0;;;;5,0;;1,0;;;;;;;;;;36,0;1,0;3,0;;;;;;2,0;;;;;5,0;;;;52,0;;;;3,0;;1,0;;;;;;3,0;;;;;;;;;;;;;;;;;;2,0;;;;;;;1,0;9,0;1,0;1,0;;;;;;;;5,0;;;13,0;;5,0;;;;;2,0;;;;;;;;;;;;;;1,0;;;;4,0;;;;;25,0;;;;;;;;;;1,0;5,0;;1,0;;;;;;5,0;;16,0;;1,0;;;;;;;;;;;;;;;;1,0;;;;;2,0;;4,0;;;;;;;3,0;;;1,0;;;3,0;;1,0;;;;;;3,0;;;1,0;;1,0;;;;;;;4,0;;17,0;;5,0;2,0;;;;6,0;;3,0;;8,0;;2,0;7,0;3,0;;1,0;;;;1,0;;;;;;5,0;;1,0;;;;;8,0;;1,0;;11,0;;2,0;1,0;;;;1,0;;;;;;;;12,0;;;;;;;21,0;;;;;;;10,0;10,0;;;;1,0;;;;;;;3,0;1,0;1,0;1,0;5,0;3,0;1,0;;;;;;1,0;;;;;10,0;;;;;;2,0;21,0;1,0;;;;;;;;;;;;;;;;;;;;4,0;;;;;;;;5,0;;;;;;;;;;;;;3,0;;;;;;;;;;;;;;;1,0;;;;;;;;;;;6,0;;;9,0;;;;;1,0;;;;;;;;1,0;;;;;;;;;;;;;;;;2,0;;2,0;;;;1,0;;;;;;;;4,0;;;;;;;;;;;;;;;;;;;;;;2,0;;;;1,0;;;;;;;;;;;;;;;;;;;;;;;;;;;;;;;;;;;;;;;;;;;;;;;;;;;;;1,0;;4,0;;;;;;;;;;;;;;;;;1,0;;;;1,0;;3,0;;;;;;2,0;;;2,0;;;;;;;;;;1,0;;;;;;;;;1,0;;;2,0;;;;;;;2,0;;;;;;;;;;;;;18,0;;;;;;;;;;2,0;;1,0;;;;1,0;;;;;;;;;;;;;;;;;;;;;;1,0;;;;;;;;;;;;;;;;;;1,0;1,0;;;1,0;;;;;;;;;;;;;;;1,0;;;1,0;;;;;2,0;;1,0;;;;1,0;;;;;;;;;;;;;;;;;;;;;;;;;;;;;;;;;;;;;;;;;;;;;;;;;;;;;;;;;;3,0;;;;;;;;;;;;;;;;8,0;;;;;;;;;;;;;;;;;;;;;;;;;;;;;;;;;;;;;;;;;;1,0;;;;;;;;;;;
volume;;;;;10,0;;;8,0;1,0;10,0;;;;;;;;;;4,0;;24,0;;1,0;18,0;;;30,0;;1,0;1,0;19,0;17,0;1,0;25,0;6,0;;;;2,0;16,0;;1,0;20,0;;;;;4,0;;9,0;29,0;;;;52,0;5,0;;;38,0;;;22,0;;8,0;;;;2,0;11,0;12,0;;;;;;7,0;9,0;9,0;1,0;;4,0;1,0;;;;24,0;;4,0;10,0;13,0;;;23,0;2,0;35,0;;;3,0;1,0;4,0;16,0;;;1,0;;;12,0;1,0;;;1,0;2,0;1,0;;1,0;;;;4,0;;;9,0;1,0;;;2,0;;;;6,0;;1,0;1,0;;1,0;16,0;;;;;;5,0;1,0;1,0;;1,0;1,0;6,0;;;;;2,0;;;;4,0;;25,0;;32,0;1,0;6,0;1,0;1,0;15,0;8,0;1,0;1,0;3,0;;4,0;;;4,0;;1,0;2,0;;;1,0;1,0;;;;1,0;8,0;;19,0;;;1,0;3,0;;;1,0;;;2,0;;10,0;;;;;;;4,0;6,0;;;;;;10,0;3,0;;;;;1,0;;;3,0;;;;;;;;;2,0;6,0;3,0;8,0;3,0;4,0;;2,0;;;;1,0;;3,0;;;;;;;;;;3,0;9,0;2,0;;;;;;;;1,0;;;;;;;;1,0;2,0;;;;2,0;;;;;;;1,0;8,0;3,0;;;;;1,0;;;;;;;;;1,0;;1,0;;;;2,0;;1,0;1,0;;;;;;;;3,0;;;;;;;;;;;;;;;;;;;;;;1,0;;;;5,0;;;1,0;12,0;;;1,0;;;16,0;;;;;;;;1,0;1,0;;;;;6,0;;;;1,0;3,0;1,0;1,0;;;1,0;;;;1,0;;;1,0;;;3,0;;;;;;;8,0;26,0;1,0;2,0;;;;;2,0;;1,0;13,0;3,0;;;2,0;;;;;;;;;4,0;;;3,0;;4,0;;;9,0;1,0;;1,0;2,0;;1,0;;1,0;;;;;;;;;;;2,0;;;;2,0;10,0;7,0;;;;;4,0;;;;;1,0;;;;;;;;7,0;;;;;;;;1,0;6,0;5,0;;;;;;;;;;9,0;;4,0;13,0;16,0;;;;;1,0;;;;10,0;;;;;;;;;12,0;4,0;;;;;;;2,0;;;;;1,0;;;;;;;1,0;;;;;;;;;;;3,0;1,0;;1,0;6,0;1,0;;1,0;;;;;;;;1,0;1,0;;;;4,0;2,0;;;;;;;;;;;;;;;;;;;;;;;;;;;;1,0;;;;;;1,0;;;3,0;;2,0;;;;;;;;1,0;;;;;;;;;;;;;;;;;;;;;;;;;;1,0;;;;;;;;;;2,0;11,0;1,0;;;;;;;;;;;1,0;;;;;;;;;;;5,0;;;3,0;;;;;;;;;2,0;;;;;;;;5,0;;;;;;;;;;2,0;;;;;;3,0;5,0;;;;;1,0;;;;;;;;;;2,0;;;;;;;;;;;;;;;;;;;;;;;;;;;;;;;6,0;;;1,0;;;;;;2,0;;;1,0;;;;;;;;;;;;1,0;;;;;;;;1,0;;;;;;;;;;1,0;;;1,0;;;;;;1,0;;;;;1,0;;;;;;;1,0;;;;;;;;;16,0;;;;2,0;;;;1,0;;2,0;;;;;1,0;;;;;;;;;;;;;;;;;;;;1,0;;;;;;3,0;;1,0;;;;1,0;;;;;;;;;;;;;;;;;;;;6,0;;;;;;17,0;;;1,0;;;;;;;;;;;;;;;;;;;;;;;;;;;;;;;;;;;;2,0;;;;;;;;;;1,0;1,0;;;;;;;;;;;;;;;;;;;;;;;;;;;;;;;;;;;;;;;;;;;;;;;;;
wafer;;;;;32,0;;;1,0;;10,0;;;;;;;;;3,0;;;2,0;;;;;;6,0;;61,0;7,0;3,0;11,0;;2,0;;;6,0;;;;;2,0;8,0;;;;;1,0;;1,0;8,0;;1,0;;67,0;25,0;;;52,0;;;37,0;;;;;;;;22,0;;;;1,0;;;;17,0;;;;;;;;22,0;;;;36,0;;;6,0;;;;2,0;4,0;16,0;46,0;1,0;;;;;3,0;7,0;;;2,0;1,0;19,0;5,0;3,0;;;;;;3,0;;;;;;3,0;;;2,0;10,0;5,0;;;;2,0;29,0;;;;;;;1,0;2,0;;42,0;;;12,0;;6,0;;;;3,0;2,0;2,0;;;;;1,0;;;6,0;22,0;23,0;;2,0;1,0;;34,0;8,0;4,0;1,0;1,0;6,0;2,0;;;;;;;1,0;8,0;17,0;;15,0;4,0;;1,0;11,0;;;1,0;;;5,0;3,0;2,0;2,0;9,0;;;37,0;;5,0;2,0;;;;1,0;;;11,0;16,0;;;4,0;;;;3,0;;;;;;15,0;;;2,0;1,0;;;2,0;6,0;;1,0;;2,0;4,0;;;;12,0;;;;;1,0;1,0;;;;2,0;;1,0;5,0;4,0;;;;;3,0;;;3,0;;;;;1,0;3,0;;;1,0;1,0;;;;;6,0;;;;;4,0;4,0;;;;;4,0;1,0;6,0;1,0;;;;;;;;;;;2,0;;6,0;;;;;;;;;;;;;;1,0;8,0;;2,0;;;;;;;;;;;;1,0;1,0;;3,0;;;;1,0;;;;;;1,0;;;;;;;;;4,0;;;;;;2,0;;;;;;;;;;;;;;;7,0;4,0;;;;;7,0;;;;;1,0;;;;;;;;;;;;;;;;14,0;;;2,0;;;;;;2,0;;;;1,0;;;;6,0;;;;;;;;;;;;;;;;;;;1,0;;;;;;7,0;;;;7,0;;;;;;;1,0;;;;;;;;1,0;;;;;;;;3,0;;;;;;;;;;;;;;;;;;;;;;;;;2,0;;;;;;4,0;;;;;7,0;;1,0;;;;;4,0;;;;;;;2,0;;;3,0;1,0;;;;;;;;10,0;;;;;;;;;;;;;;;;;;;1,0;;;;;;5,0;;;;;;;;;;;;;;;;1,0;;;;;;;;;;;;;;;;;;;;;;;;;;;;;;;;;;;;;;;;;2,0;;;;;;;;;;;3,0;;;1,0;;;;1,0;;;;;95,0;;;;6,0;3,0;;;;;1,0;;;;;;;;;4,0;;;;;;;;;;;;;;;;;;;;;;1,0;;;;;;;;;;;;;;;;;;1,0;;;;11,0;;;;;;;;;;;;;;;;;;;;;;;;1,0;;;;;;;;;;;;;;4,0;;;;;;;;;;;1,0;1,0;;;;;;2,0;;;;;5,0;;1,0;;;;;;;;;;;;;;;;;;;;;1,0;;;;;;;;;;;;;;;;;2,0;;;;;;;;;;;;4,0;;;;;;2,0;;;;;;;;;;;;;;3,0;;;2,0;;;;;;;;;;;;;;;;;;;;;;1,0;;;3,0;;;;;;;;;;;;;;;14,0;;12,0;;;;;;;;;;;;;;;;;;;;;;;;;;;;;;;;;;14,0;;;;;;;;;;;;;3,0;;;;;;;;;;;;;;;;;;1,0;;;;;;;1,0;;;;1,0;;;;;;;;;;;;;;;;;;;;;;;;;;;;;;;;1,0;;;;
wall;;;;;9,0;;22,0;94,0;1,0;10,0;1,0;;;;3,0;;;;23,0;;2,0;5,0;;;;;5,0;;;;;3,0;39,0;;10,0;;5,0;28,0;;5,0;9,0;;1,0;12,0;;;5,0;;11,0;;;;;7,0;1,0;15,0;107,0;;2,0;145,0;4,0;;6,0;;;3,0;10,0;3,0;;1,0;38,0;1,0;;45,0;19,0;;;6,0;58,0;;6,0;;1,0;1,0;;;19,0;;4,0;3,0;12,0;;2,0;10,0;1,0;28,0;;4,0;1,0;11,0;162,0;4,0;;8,0;;;2,0;32,0;;2,0;4,0;14,0;4,0;21,0;23,0;;;;12,0;36,0;;3,0;;5,0;;;29,0;37,0;;2,0;42,0;3,0;;46,0;3,0;3,0;36,0;2,0;21,0;1,0;;1,0;54,0;38,0;19,0;;149,0;35,0;;1,0;;31,0;34,0;3,0;4,0;20,0;20,0;111,0;22,0;14,0;;5,0;160,0;35,0;;7,0;;25,0;;7,0;48,0;57,0;156,0;45,0;2,0;92,0;98,0;1,0;;;14,0;11,0;1,0;;3,0;10,0;30,0;60,0;;372,0;;8,0;;73,0;8,0;1,0;3,0;2,0;2,0;16,0;;15,0;10,0;256,0;16,0;;;1,0;7,0;25,0;;;;10,0;;;5,0;29,0;;10,0;83,0;11,0;;;;;35,0;;;8,0;;;4,0;14,0;2,0;23,0;18,0;;16,0;1,0;111,0;;12,0;106,0;2,0;8,0;18,0;2,0;21,0;9,0;9,0;;4,0;54,0;12,0;1,0;149,0;163,0;;18,0;3,0;10,0;4,0;4,0;31,0;5,0;86,0;7,0;6,0;11,0;2,0;5,0;;;15,0;2,0;;;3,0;21,0;4,0;6,0;;5,0;2,0;1,0;12,0;9,0;2,0;42,0;1,0;1,0;;;;10,0;;;5,0;1,0;1,0;;4,0;15,0;12,0;5,0;;2,0;35,0;33,0;;6,0;15,0;10,0;7,0;1,0;;;6,0;8,0;5,0;5,0;4,0;7,0;;9,0;8,0;7,0;1,0;;3,0;2,0;;;;;;1,0;;;8,0;3,0;;;;;;;22,0;;14,0;;;;;;;;;;;;2,0;1,0;;;;;;;;22,0;;;;4,0;;;;7,0;;;;;;;;;;;;;;;15,0;;4,0;;;;3,0;;1,0;;;;3,0;;;;4,0;5,0;;1,0;1,0;;2,0;;;;1,0;;;3,0;;;;;;;;;;;1,0;;;;;6,0;;;;;2,0;;1,0;1,0;;;;;;;1,0;;;;;;;;;;;1,0;68,0;;;;7,0;;1,0;;1,0;2,0;3,0;;;;;;;;;4,0;;;;;;1,0;;;;;2,0;;3,0;;2,0;;;;8,0;15,0;;;;29,0;27,0;;;1,0;7,0;5,0;6,0;;;;;7,0;;6,0;;;;;;1,0;;;1,0;;;;1,0;;;;;;;8,0;17,0;;;;;;;5,0;3,0;;1,0;5,0;;2,0;;;7,0;;;;4,0;1,0;9,0;;9,0;;;;;;40,0;;6,0;;;;;;3,0;;;13,0;51,0;;;;;2,0;;;;;1,0;4,0;3,0;;1,0;;;;;;;2,0;;1,0;3,0;4,0;;;;;;1,0;5,0;;;2,0;;10,0;;2,0;;;;2,0;;2,0;8,0;2,0;1,0;;;4,0;;36,0;;;15,0;;;;;;1,0;7,0;;15,0;2,0;;20,0;13,0;5,0;4,0;;;;;;;1,0;4,0;;7,0;6,0;4,0;;;;3,0;8,0;1,0;3,0;;;;;;1,0;;;;;1,0;;;;;1,0;;;;6,0;5,0;;;1,0;;;;;10,0;;;;;;2,0;;;;;4,0;;;25,0;;;;;;2,0;;;;;;;;2,0;;;1,0;;;20,0;;;;;;;2,0;;;;;;;;;;;;;;;;;;;2,0;1,0;1,0;;;;1,0;2,0;;;2,0;;;;;;;;;;1,0;;;;;;;;1,0;2,0;;;20,0;;4,0;;;;2,0;;;5,0;;3,0;;2,0;1,0;;;10,0;;;;2,0;;;;;;;1,0;1,0;;;;;2,0;;;1,0;;;15,0;3,0;4,0;;;32,0;;;;2,0;;;5,0;;;;;;;;;2,0;;3,0;;;;;;;;;1,0;;5,0;2,0;;3,0;5,0;;;4,0;;;1,0;5,0;;5,0;3,0;;;;;;;;;;;;;;;;4,0;;1,0;;;;;;;;;1,0;;;;;;;;;;;;;1,0;;;;1,0;;;;;;;;;;;;;;;;;;3,0;;;;;;7,0;;2,0;;;7,0;1,0;;;;;1,0;;;;;;;;;;;2,0;;;;;;;;2,0;;;1,0;;;;;;;;;;;;;
water;;;;;16,0;;;2,0;;1,0;;;;;;;;;;;2,0;;;;;;;;;2,0;;;3,0;;18,0;;3,0;;;;;;;3,0;;;2,0;;;;1,0;;2,0;;;9,0;2,0;;;8,0;;;8,0;;;;1,0;;;3,0;4,0;;;;;;;;2,0;;13,0;;;5,0;;;4,0;1,0;;;;;;;;;;4,0;3,0;;5,0;3,0;;1,0;;;;;;;;;;5,0;3,0;;;;;4,0;;;;;;;1,0;;;;5,0;;;2,0;;;;;;;;;1,0;1,0;;;;2,0;;;;;;1,0;;1,0;1,0;8,0;;;;;;5,0;6,0;14,0;2,0;4,0;;1,0;4,0;;4,0;;;;3,0;;;;;;;;;;;;;2,0;;;;;;;;;;;;1,0;1,0;;;;;;;6,0;;;;;;;;3,0;;5,0;2,0;8,0;1,0;;;;1,0;;;;;;;;;;;;;;1,0;;;;;25,0;3,0;;;;;;;1,0;;;1,0;;;;;2,0;;;;;;;;;;;;;;;;;;;;;;1,0;;;;1,0;;;1,0;;;;;;;;;;;;;;;;;;;;;2,0;;;;;;;;16,0;;2,0;;;;2,0;;;6,0;;;;;;;;;;;;;;;;;;;;4,0;;3,0;;;;;;;;;;;;;4,0;;;;;;;;;;;;;;;;1,0;;;;;1,0;;;;;;;;;;;;;;;;;;;;;;;;;;;2,0;;;;;;;;1,0;;;;;;;;;;;;;;;;;;;;;;;;1,0;;;;;;;7,0;;;;;;;;;;;;;;;3,0;;;;;;1,0;;;;;;;;;;;;;;;;;;;;;6,0;;;2,0;;;;;;;;;;;;;;;4,0;14,0;;;;;;;;;;;;;;;;;;1,0;;;;;;;;;;;;;;;;;;;;;;;;;;;;;;;;;;;;;;;;;;;;;;;;;;;;;;;;;;;;;;;;;;;;;1,0;;;;3,0;;;;;;;;;;;;;;2,0;;;;;;;;;;;;;;;1,0;;;;;1,0;1,0;;;;;;;;;;;;;;2,0;;;;;;;;;;5,0;;;;1,0;;;;;;;;;;;;;3,0;;;;;;;;;;;;;;1,0;;;;;;;;;;;3,0;;;;;;;;;;;;;;;;18,0;;;;;;;;;;;;;;1,0;;;;;;;;;;;;;;;2,0;;;;;;;;;;;;;;;;;;;;;;;;;;;1,0;;1,0;;;;;;;;;;;;;;;;;;;;2,0;;;;;;;;;;;;;;;;3,0;;;;;;;;;7,0;;;;;2,0;;;;5,0;2,0;;;1,0;;;;;;;;;;;1,0;;;;;;;;;;;;;;;;;;;;;;;;;;;;;;;;;;;;;;;;;;;;;;;;;;;;;;;;;;;;;;;;;;;;;;;;;;;;;;;;;;;;;;;;;;;;;;;;;;;;;;;;;;;;;;;;;;;;;;;;;;;;;;;;;;;;;;;;;;;;;;;;;;;;;;;;;
wheel;;;;;13,0;;8,0;15,0;2,0;5,0;4,0;;;;33,0;;;;;1,0;;6,0;;2,0;;;;1,0;;;;1,0;3,0;;;;1,0;3,0;;5,0;10,0;;32,0;1,0;;;2,0;;;1,0;;;;10,0;;15,0;33,0;;2,0;4,0;1,0;;14,0;;3,0;15,0;;;;;;;4,0;3,0;5,0;;;1,0;11,0;;;6,0;3,0;;;;;12,0;;18,0;6,0;;;2,0;;;;;;;16,0;15,0;;;;1,0;;29,0;;;8,0;1,0;;9,0;10,0;;;;;3,0;;;;;;;4,0;;;40,0;;;;3,0;;2,0;;;;;;;;1,0;79,0;7,0;1,0;15,0;;;2,0;6,0;;;;;;6,0;1,0;;;;3,0;6,0;;;;1,0;;;1,0;3,0;3,0;60,0;3,0;;7,0;3,0;;;;;;;12,0;4,0;3,0;126,0;;6,0;;;1,0;10,0;;;;;31,0;3,0;;;1,0;4,0;;;;;4,0;21,0;;;;;9,0;;4,0;;;2,0;;28,0;;;;;;;;2,0;18,0;;;3,0;4,0;41,0;;;;;;;4,0;;4,0;5,0;;;;;;;;11,0;1,0;;;8,0;1,0;;;3,0;11,0;;13,0;;2,0;2,0;;;;24,0;1,0;;;1,0;;3,0;;3,0;1,0;;6,0;10,0;;3,0;1,0;6,0;1,0;5,0;;;;;;;;;;;;2,0;1,0;;;;4,0;;;;;13,0;;;3,0;;14,0;;1,0;;;;6,0;;;4,0;;1,0;1,0;1,0;1,0;8,0;;1,0;;;;;;2,0;;;;;;;;;;;5,0;;;1,0;;;;;;;;;;;1,0;;;;1,0;;;2,0;;1,0;;2,0;;;;;;;;;;;;1,0;;1,0;5,0;1,0;2,0;;;6,0;;2,0;;;28,0;;;;;3,0;2,0;;;2,0;1,0;1,0;;;;;;1,0;1,0;1,0;2,0;;;2,0;;;;;;;1,0;;;;;;;;;;1,0;;;;38,0;1,0;;1,0;;;;;;;;;;;;;;;;;;;;;4,0;;;1,0;12,0;;;;1,0;;;;;;;;;28,0;1,0;;;3,0;;;1,0;;4,0;6,0;;;;;;;;;;;;;;;;;;;4,0;;;;;;;14,0;;;;;;;;;;;;2,0;;;2,0;14,0;;8,0;;;;15,0;;;1,0;3,0;;;;1,0;;;;;4,0;;;;;;;;2,0;;;;;;;;;;;;1,0;;;;;;2,0;;6,0;;5,0;;;;;;324,0;;;;;;10,0;;;;;;3,0;2,0;2,0;;3,0;;;;;;;;;;;;;23,0;;;;;2,0;;;;;;1,0;;4,0;;;;36,0;;;;;1,0;18,0;;;;;;;1,0;;;;;;;1,0;;;;;4,0;;;;;;;;;;;;1,0;;;;;;;;;;;;;;;;;;;;;;6,0;;;;;;;;;;;;;;;;4,0;;;;;;1,0;;;4,0;;;;;;;;1,0;;;;2,0;;;;;;;;;10,0;;;;;;;1,0;;1,0;;;;;;;1,0;;;;;;;;;;;;;;;;1,0;;;;;;;;;;10,0;;;;;;;;;;;;;;;;;;;;;;;12,0;;;;;;;;;1,0;;4,0;;;;;;;;;;;1,0;1,0;1,0;;;1,0;;;;;;1,0;;;;;;;;14,0;;4,0;;;;;;;1,0;;2,0;;;;;;;;;;;;;2,0;;;;;;;;;4,0;2,0;13,0;;;;;;;;;;;;;;;;;4,0;2,0;;;;9,0;;;;;;;;;;;;;;;;;;;;;;;;;;;;;;;;;;;;1,0;;;;;;;;;;;;;;;;;;;;;;1,0;;;;;;;;27,0;;1,0;;;;;;;;;;;;;;;;;;;;;;;;;
wireless;;;;;31,0;;2,0;28,0;;35,0;;;;;;1,0;;1,0;5,0;6,0;;68,0;;;;;;111,0;;14,0;7,0;16,0;248,0;1,0;48,0;;;1,0;;22,0;;;;21,0;1,0;;;;;14,0;9,0;8,0;;3,0;;95,0;51,0;;;5,0;;;84,0;;;;2,0;;3,0;24,0;2,0;1,0;12,0;11,0;;1,0;;2,0;8,0;65,0;;27,0;6,0;;;;1,0;;;5,0;15,0;;;189,0;;;;6,0;21,0;;;171,0;;10,0;1,0;4,0;8,0;147,0;2,0;;8,0;4,0;;2,0;5,0;3,0;;;2,0;44,0;;;3,0;24,0;;;54,0;5,0;;21,0;;;7,0;;;2,0;17,0;;;1,0;1,0;;18,0;;1,0;;2,0;8,0;;3,0;;;;1,0;;;;8,0;1,0;4,0;;;4,0;;;;2,0;2,0;1,0;1,0;3,0;;30,0;9,0;1,0;3,0;1,0;4,0;;;4,0;;;;;;;30,0;;6,0;;;;121,0;;;;;;;;;;;;2,0;;4,0;3,0;18,0;;;;;1,0;9,0;82,0;;;6,0;;10,0;;;;2,0;;;;;2,0;;;1,0;4,0;;;;12,0;1,0;3,0;;;;11,0;2,0;17,0;;;;2,0;3,0;;32,0;;2,0;;1,0;4,0;;;5,0;;;;;2,0;;;;;1,0;;;;68,0;;;2,0;2,0;2,0;;;2,0;;1,0;;4,0;24,0;;;;;;;;;7,0;;;39,0;;11,0;;;;15,0;23,0;;;;1,0;;;;;;;;;1,0;;;;;3,0;;2,0;11,0;;6,0;;;;;1,0;2,0;;1,0;;;7,0;;1,0;;1,0;;2,0;;8,0;;8,0;4,0;;;;;;1,0;1,0;;1,0;;;8,0;;5,0;;5,0;1,0;;;;;2,0;1,0;4,0;;;;;;;;;;2,0;3,0;;7,0;;3,0;;1,0;54,0;10,0;;1,0;3,0;;4,0;;4,0;;;;1,0;2,0;;2,0;;4,0;;;51,0;1,0;;;5,0;;14,0;;21,0;58,0;52,0;8,0;1,0;;2,0;3,0;;;2,0;;;7,0;2,0;1,0;20,0;30,0;9,0;;;11,0;5,0;34,0;2,0;;1,0;5,0;;3,0;;41,0;;;5,0;;9,0;6,0;;;6,0;;13,0;30,0;1,0;;;;;17,0;;;10,0;1,0;;15,0;;;;;2,0;9,0;;;1,0;3,0;;1,0;;10,0;;;108,0;3,0;;;;;2,0;3,0;;1,0;;;;;9,0;;;;3,0;8,0;334,0;52,0;12,0;;;;9,0;3,0;;;;;9,0;4,0;;2,0;5,0;;;;2,0;;1,0;1,0;14,0;6,0;;2,0;;3,0;;;32,0;;;;;1,0;2,0;;162,0;;7,0;2,0;;4,0;1,0;;6,0;;1,0;;;;;1,0;;29,0;15,0;28,0;;;;;;24,0;;6,0;10,0;;;48,0;;1,0;;;;;;;1,0;;;;4,0;;;;;;;4,0;;1,0;;;;;;;3,0;;52,0;;;1,0;;;1,0;8,0;3,0;;;;52,0;;;21,0;1,0;;1,0;;;;;;;;;;;1,0;;;;;;;;;2,0;;;;;;;;9,0;;;;;8,0;;;;;1,0;;;;;;;5,0;;;;;;;;3,0;1,0;;;2,0;1,0;;;;;;;;2,0;;9,0;;;;;3,0;;9,0;;;;;;;;3,0;;4,0;4,0;;1,0;;;;;;;;2,0;4,0;8,0;;1,0;;;;1,0;;;;;2,0;2,0;;;;;;;;;;;;;;;;;5,0;;;3,0;;;;;;;2,0;;;;8,0;;;;1,0;;;;;;;15,0;;;;2,0;;;;66,0;;;;;;;;;;;;1,0;;;;;1,0;;1,0;;3,0;;;;;1,0;1,0;;2,0;;;;;;;;3,0;;;;;;;52,0;;;;;43,0;1,0;1,0;;;;;;;;;;;86,0;;;;;1,0;;;;;;;;2,0;;;;;;;;;;;;;;1,0;;;;;;19,0;;19,0;;;;;8,0;;2,0;;;;;;;;;;;;;;;1,0;;;;;;;;;;;8,0;;2,0;;2,0;;;1,0;;;;2,0;;;;;;;2,0;;;;;;;;;;;;;;;;;;;;;;1,0;;;;;;;;;;;;;;;;;;;;;;;1,0;;;2,0;;;;7,0;;;;;
write;;;;;13,0;;;3,0;;7,0;;;;;;;;;;;3,0;10,0;;;;;;127,0;;2,0;;31,0;52,0;;10,0;;4,0;;;10,0;;;1,0;24,0;;;;;;;;4,0;;9,0;;180,0;13,0;;;;;1,0;17,0;1,0;;;2,0;;;4,0;7,0;6,0;;;;;;1,0;17,0;1,0;;10,0;2,0;3,0;1,0;;;3,0;2,0;18,0;;;;56,0;2,0;3,0;;26,0;9,0;;;1,0;;;;;1,0;130,0;;;;;;;9,0;;;2,0;;1,0;;;;22,0;;;16,0;;;;;11,0;;;1,0;;;;;;;;;;;;3,0;19,0;;;;;;;;;;8,0;;2,0;;;;;;;;;;;;;;;;;;4,0;;;;;;1,0;;;;2,0;;1,0;;;;2,0;;;;;;1,0;;;;2,0;;;;;;4,0;;20,0;;4,0;;4,0;3,0;;;;;;;;;;;;;;;;;;;2,0;;;13,0;;;;;;;;;;;;;3,0;;;2,0;;;;2,0;;;;;;;;;;;;;1,0;;;;;;;;;;;;;;7,0;;8,0;;;;;;;;;;2,0;;;;;1,0;;;;;1,0;;;3,0;1,0;;;;;;;;;;;;;;;;;;;2,0;;;;;;;;;;;;;;;15,0;1,0;;;;;2,0;;;3,0;;;;;;;;;;;4,0;;;;;;;;3,0;36,0;62,0;;;;1,0;7,0;4,0;;28,0;;;;;;53,0;1,0;2,0;;;1,0;25,0;2,0;1,0;;;;;;;;;;2,0;;;;;;;;;;;1,0;;19,0;3,0;;;2,0;;1,0;31,0;2,0;;22,0;;;;5,0;;;;;;;;4,0;;;4,0;1,0;3,0;;;;;13,0;1,0;;2,0;;;;;;1,0;;;;1,0;;;;;;;;;;;1,0;;1,0;;;;;2,0;;;4,0;;;;;;;;1,0;2,0;;;;;2,0;2,0;;;;;;;;;;;1,0;;;;;;;5,0;;;;2,0;1,0;;;;;;;;;;5,0;;;1,0;;;;;1,0;;;;;;5,0;;;3,0;;;;;;;6,0;6,0;14,0;;1,0;;;;2,0;;;;;1,0;4,0;;;;;;;;;1,0;5,0;1,0;1,0;;;1,0;;;;;;;1,0;;;;;;;;;;;;;;;;;;;;;;;;;;;;;;;;8,0;;1,0;;;;;;;;;;;;;4,0;;;;;;;;;3,0;;;;;;;;;;4,0;;;;;;;;;;;;;;;;;;;;2,0;4,0;1,0;;2,0;2,0;;;;;;1,0;;;;;;3,0;;;;;;;;;;;2,0;11,0;;;;1,0;1,0;;7,0;;;;;;;;;;;2,0;;;;;;;;;;;;;;;;;;;;;;;;;;;;;;;;2,0;;3,0;;2,0;;;;;6,0;;;;;;;4,0;;;;;2,0;;;;;;;2,0;;;;;;3,0;;;;;;;;;;;;2,0;;;;;;;;;;;;;;;;2,0;1,0;5,0;;;;;;;1,0;1,0;;;;;;;;5,0;;;;;;;;;;;;;1,0;;;;;;;;;;;;;;;;;;;;;;;;;;;;;;;;;;;;;;;;;;;1,0;1,0;;;;;;;;;;;;;;;;;;;;;;;;;3,0;;;;2,0;;;;;1,0;;;;;;;;;;;;;;;;;;;;;;;;;;;;;;;;;;;;;;;;;;;;;;;;;;;;;;;;;;;;;;;;;;;;;
yoke;;;;;5,0;;5,0;27,0;;;3,0;;2,0;;;;;;;;;;;;1,0;;;;;;;;6,0;;;;;4,0;;;;;;;;;;2,0;;;;5,0;;;;6,0;10,0;;4,0;11,0;;;1,0;;;6,0;;;;1,0;;;;;2,0;;;2,0;3,0;2,0;;;;;;;;;;;3,0;;;;;2,0;;;;;23,0;;;;;;;11,0;;;;8,0;;9,0;7,0;;;;;2,0;;;1,0;10,0;;;10,0;2,0;;4,0;1,0;2,0;;1,0;;;1,0;;;;;;;11,0;;6,0;22,0;3,0;;;;;3,0;;;18,0;1,0;;;;;;11,0;4,0;;;;;;2,0;13,0;;7,0;13,0;;7,0;10,0;;;;;2,0;2,0;;;;8,0;7,0;;41,0;;2,0;;4,0;2,0;;;;9,0;4,0;;5,0;1,0;13,0;;;4,0;5,0;2,0;6,0;;;;2,0;1,0;;;;;;5,0;;;;10,0;;;;;;;2,0;5,0;;;;6,0;2,0;;;2,0;;2,0;2,0;2,0;;;;2,0;56,0;;;1,0;2,0;1,0;;4,0;5,0;;;;13,0;;2,0;;;13,0;;;2,0;;;;;1,0;;;;4,0;;;61,0;;;;;1,0;;;2,0;;;;;6,0;2,0;;;;2,0;;;1,0;;;3,0;1,0;1,0;2,0;2,0;;;;;;;2,0;9,0;;;3,0;;;;;;;5,0;1,0;;;;;;;;;;;;;;;;;;;;;;;;;;;;;;;2,0;;;;;;;;;;;;;;;;;;;;2,0;;;;;;;;;;;;;;;6,0;;;;;;;;;;;;;;1,0;;;;1,0;;;;;;;1,0;1,0;;;;;;;;;;;;;;;;;;;;;;;;;;;;;;;;20,0;;;;;;;;;;;;;1,0;;;;;;;;;;;;;;;;;;;;5,0;;;;;;;;;;;;;;;;;;;;;;2,0;;;;;;;;;;;;;;;;;;;1,0;;;;;;;;;;;;;;;;;2,0;;;;;;;;;;;;;;;;;;;;;;;;;2,0;;;;;;;;;;;;;;;;;;;;;;;;;2,0;;;1,0;;;2,0;;;;;;;;;;;;3,0;1,0;;;;;;;;;;;;2,0;;;;;;;4,0;;;;;;4,0;;;;;;;;;;;;;;;;;7,0;;;;;;;;;;;;1,0;;;;;;;;;;;;;;;;;;;;;;;;;2,0;;;;2,0;;;;;;;;;;;;;;;;;;;;;;;;;;;;;;;;;;;;;;;;;;;;;;;;;;;;;;;;;;;;;;;;;;;;;;;;;;;;;;;;;;;;;;;;;;;;;;;;;;;2,0;;;;;;;;;;;;;;;;;;;;;;;;;;;;;;;;;;;;;;;4,0;;;;;;;;;6,0;;;;;3,0;;;;;;;;;;;;;;6,0;;1,0;;;;1,0;;;;;;;;;;;;;;;;;2,0;;;;;;;;;;;;;;;;;;;;;;;;;;;;;;;;;;;;;;;;;;;;;6,0;;;;;;;;;;;;;;;;;;;;;;;;;;3,0;;;;;;;;;;;;;;;;;;;;;;;;;;;;;;;;;;;;;;;;;;;;
zone;;;;;15,0;;;13,0;4,0;4,0;1,0;1,0;1,0;;;;;;6,0;1,0;;12,0;;;;;;14,0;2,0;10,0;88,0;4,0;21,0;13,0;2,0;;1,0;6,0;;5,0;3,0;;;11,0;;;;;;7,0;4,0;3,0;;2,0;;55,0;24,0;;;6,0;;;16,0;;2,0;;2,0;;;1,0;2,0;;;;;;;27,0;29,0;4,0;1,0;;1,0;;2,0;;2,0;;;18,0;13,0;;;12,0;3,0;1,0;;;;;2,0;10,0;;;1,0;;;27,0;4,0;;;3,0;;;4,0;1,0;;;;;;1,0;5,0;;;;7,0;2,0;;;3,0;;;;;21,0;4,0;;;;3,0;4,0;;5,0;2,0;;10,0;5,0;;;;;;7,0;;;;;;116,0;;;2,0;;;;;5,0;;;4,0;;1,0;2,0;4,0;;;2,0;;;;;2,0;;;;1,0;83,0;;;;;2,0;14,0;;3,0;;;3,0;;;;;6,0;;14,0;2,0;2,0;4,0;7,0;;;1,0;;;26,0;;;;;1,0;11,0;;;;;6,0;;6,0;;;;;14,0;36,0;23,0;3,0;2,0;10,0;;2,0;1,0;2,0;;;1,0;;2,0;;;;;;;5,0;1,0;;9,0;3,0;;6,0;;;;;;4,0;;;2,0;1,0;16,0;;;;;;;1,0;4,0;;;;;;8,0;2,0;5,0;5,0;3,0;;;11,0;;;;;1,0;;;1,0;;2,0;5,0;;;;1,0;;;4,0;24,0;;;;;;;;;;6,0;;1,0;;;1,0;1,0;1,0;;6,0;2,0;;;;;;;;1,0;2,0;32,0;;;;;1,0;2,0;;;3,0;;;;;;2,0;;1,0;;;1,0;;;;19,0;;;;;;;;;;1,0;13,0;;;;4,0;1,0;;;5,0;24,0;;2,0;1,0;;;2,0;;2,0;;;;9,0;2,0;;1,0;;;;;;1,0;;;3,0;2,0;;;4,0;3,0;;1,0;;;;3,0;;;;;;;;;;;;;;;;;;;;;;;;;3,0;;5,0;11,0;8,0;;;4,0;2,0;;;;;1,0;;;6,0;2,0;;;10,0;;1,0;;;;1,0;;;;;;;;2,0;;;;5,0;;;2,0;5,0;;3,0;;;4,0;;8,0;2,0;;1,0;;;;;;;;;;2,0;;6,0;1,0;;;;8,0;;;;;;;8,0;1,0;;;;;;;;;;;;;;;;;;;3,0;;;1,0;1,0;;;;;1,0;;;;3,0;;;;;;;;;1,0;5,0;;;;;;;;;;;;;;;;;;2,0;;;55,0;;;;;1,0;;;;;;;;;;;;;;;;;;;;;;;;;;;;;;;;;;;;;;;;;;;;1,0;;;;;;;;;;;;;;;;;2,0;;;;;;;;1,0;3,0;;;;;1,0;;;;;;;;;11,0;;2,0;;;;1,0;;4,0;10,0;;;;;;;;;2,0;;;;;15,0;;;;;1,0;;;;;;;1,0;;;2,0;3,0;3,0;;;1,0;;;;;;;2,0;;;;;;;;;;;;1,0;;;1,0;;;;;4,0;;;;;;1,0;;;6,0;;;;2,0;3,0;;;;;6,0;;;;;;7,0;1,0;;;;;;;;;;;;;;;;;;;;;;;;5,0;;;;;;;;;;2,0;;;;;;;;;;;;;;;;;;;;;;;;3,0;3,0;;;;;;;;;;;;;6,0;;;;;;;;;;27,0;2,0;;;10,0;;;;;3,0;;6,0;;;;;;;;;;;;;;;;;;;;;;;;;;;;;;;;;;;;;;;;;;;;;;;;;;;;;;;;;;;;;;;;;;;;;;;;;;;;;;;;;;;1,0;1,0;;;;;;;;;;;;;;;;;;;;;;;;;;;;;1,0;;;;;;;;;;;;;;;;;;10,0;;;;;
exit;;;;;;3,0;14,0;3,0;;2,0;1,0;;;;;;;;;6,0;;2,0;;;;;1,0;;;1,0;2,0;3,0;4,0;;6,0;;1,0;9,0;;;1,0;;;;;;;;;;1,0;;;;;6,0;7,0;;;13,0;;;6,0;;;;4,0;;;8,0;42,0;;4,0;;;2,0;;2,0;12,0;1,0;1,0;;4,0;;;;3,0;;;;2,0;;;;;;;;1,0;;53,0;11,0;;;;;;1,0;;;2,0;4,0;;2,0;;;;;;17,0;;3,0;;;;;5,0;1,0;;;;2,0;;;;;3,0;;;;;;2,0;5,0;;1,0;4,0;;;;;;;;2,0;;;11,0;;16,0;6,0;1,0;;;;1,0;;33,0;;2,0;4,0;2,0;4,0;10,0;;4,0;;2,0;;;;;11,0;;;15,0;2,0;1,0;;9,0;;;2,0;2,0;;10,0;1,0;;;;;9,0;;19,0;;;;;;2,0;5,0;;;;;17,0;;1,0;1,0;;;;;1,0;2,0;;2,0;;;;;;;4,0;;3,0;3,0;;16,0;;3,0;;;;12,0;;1,0;;;;;;;;;;;8,0;;;;;1,0;;;;;;;;;2,0;;;5,0;;;;;;;;;;1,0;;;6,0;;;;;;;;;;2,0;4,0;;;;;4,0;;;;;;;;;;;;1,0;;;1,0;2,0;;;;;;;1,0;;;;;;;1,0;;;;;;;;;;;1,0;;;1,0;5,0;1,0;;;;;;3,0;;;;1,0;;;;1,0;;3,0;;;2,0;;;;;;1,0;;;;;;;;;2,0;;;;;;2,0;;3,0;;;;;;;;;1,0;;;;;;;;;;;7,0;;;;;;;4,0;;1,0;;;2,0;6,0;2,0;;;;;;;;;;;;;;;;;;1,0;;;;;;;;;4,0;1,0;;;;;;;;;;2,0;;;;;;;;7,0;;;;1,0;15,0;;;;;;;;;;;;;;;;;;;3,0;;;;;;;;;2,0;;;;26,0;;6,0;;;;;;;;;;;2,0;;;;;;;;17,0;;;;4,0;;;;;;;;;;;8,0;;;;;;;15,0;;;;;;;;;;;2,0;;1,0;;1,0;;;;;;;;;;15,0;;;;;;;;;;;;;;;;;;;;;;;;;;1,0;4,0;;;;;;;;;1,0;;;;;;;;;;;1,0;;;;;;;;;;;;;5,0;;;;;;3,0;2,0;;;;;;;;;;;;1,0;;;;;2,0;;;;1,0;2,0;;;;;;;;1,0;;;4,0;;;;;;;;;;;2,0;;;;;;;;;;1,0;;;;;;;;1,0;;;;;;1,0;;;;;;;;;;;;4,0;;;;;;;;;;;;;;;;;;;;;;;1,0;;;;;;;;;;;;1,0;;;2,0;;;;;;;;;2,0;;;;;;;4,0;;;;;;;;;;;;;;;;;;;;2,0;;;;;;;;;2,0;;;;;;;;;;;;;;;;;;;2,0;;;;2,0;;;;;;;;;4,0;1,0;;;;;;;;;;;;;1,0;;;;;;;;;;;;14,0;;;;;;;;;;;;;;;2,0;;;;;;;;;;;;;;;;;;;;;;;;;;;;;;;3,0;;;;;1,0;13,0;;;;;;;;;;;;;;;;;;;;;;;;;;;;;;;;;19,0;;;;;;;;;;;;;;2,0;;;;;;;;;;;;2,0;;;;;;;;;;1,0;;;;;;;;;;4,0;;;;
fluid;;;;;;4,0;;;;;;;;;;;;;;;;6,0;;;;;;;;;;;;;;;;;;;;;;8,0;;;;;;;;;;;;2,0;5,0;;;42,0;;;4,0;;;;1,0;;;;;;;;;;;;;;;;;4,0;;;;;;;1,0;;;;;4,0;;4,0;7,0;;3,0;3,0;;;;;;;;;;7,0;;1,0;;;;;1,0;;;;6,0;1,0;;;7,0;;;;;;;;;;;;6,0;;;;;;;;7,0;;;;;;;4,0;;;4,0;4,0;;;;2,0;;;;;;1,0;;;;;10,0;;3,0;3,0;;;11,0;;;;4,0;;;1,0;;3,0;;7,0;;;;3,0;;;1,0;;1,0;;;8,0;;;;;;;2,0;;;;;;;;;;;;;;;;;;1,0;3,0;;;;;1,0;;2,0;;;2,0;;;;;;;;;10,0;;;;;;;;;;3,0;2,0;;;;;;;;;;;;;;;;;;10,0;;;;;;;;1,0;;;;;;;;;;2,0;;;;;;1,0;;;;;;;;;;2,0;;5,0;;;;;;;1,0;3,0;;;;;;;;;6,0;;1,0;;;;;;;;;;;;;;;5,0;;1,0;;8,0;;3,0;;;;3,0;;;;;;;;2,0;;;;;;;;;;1,0;;;;;;1,0;;;;;;;;;;;;;;;;;;;;;;;;;;;;;;3,0;;;;;;;;;;;;;;;;;;;;;;;;;;;;;;;;;;;;;;;;;;;5,0;;;;;;;;;;;;;;6,0;;;;;;;;;3,0;1,0;;;;;;;;;;;;;;;;1,0;1,0;;1,0;;;16,0;;;;;;1,0;;;;;;;2,0;;;24,0;;;;;;;;1,0;;;;;;;;;;;2,0;;;;;;;;;;;;;1,0;;;;;;;;;;;;;;;;3,0;;;;;;;;;;;;;;3,0;;;;;;;;;;;;;;;;;;;;;;;;;;;;;;;;;;;;;;;;;;;;;;;;;;;;;;;;;5,0;;;;;;;;;2,0;22,0;;;;;;;;;;;;;;;;;;;;;;;;;;;;;;;;;;;;;;;;;;;;;;;;;;;;;;;;;;;;;;;;;;;;;;;;;;1,0;;;1,0;;;;;;1,0;;2,0;;;;;;;;;;;;;;;1,0;;;;;;;;;;;;;;;;;;;1,0;;;;;;;;;;;1,0;;;;;1,0;;;;;;;;;;;;;;;;;;;;;;;;;;;;;;;;;;;;;1,0;;;;;;;;;;;;;;;;;;;;3,0;;;;;;;;;;;;;;;;;;;;;;;;;;;;;;;;;;;;;;;;;;;;;;;;;;;;;;;;;;;;;1,0;;;;;;;;;;;;;;;;;;;;;;;;;;;;;7,0;;;;;;;;;;;;;;;;;;;;;;7,0;;1,0;;;;;;;;;1,0;;;;;;;;;;;;;;;;;;;;;;;;;;;;2,0;;;;;;;;;2,0;;;;
refract;;;;;;2,0;2,0;3,0;;;;;;;;;;;;;;;;;;;;;;;;;1,0;;;;;1,0;;;2,0;;;24,0;;;;;2,0;;3,0;2,0;;256,0;;33,0;3,0;;;291,0;;2,0;1,0;;;;2,0;6,0;;;155,0;12,0;17,0;;;;;;2,0;223,0;;;;;;10,0;4,0;;;;1,0;;;1,0;1,0;1,0;;;;1,0;12,0;67,0;;;;;;1,0;;;2,0;16,0;4,0;;;;;;;;;;;;;;6,0;;;2,0;;;;;;;11,0;;;;;;;;1,0;;1,0;;;;;;;;;;;;;1,0;9,0;;;;;6,0;;42,0;;4,0;7,0;;;3,0;;;;;;;;1,0;5,0;;;21,0;;6,0;;11,0;;;;5,0;;11,0;;;;;;2,0;;12,0;;;;;;;;;;;;6,0;;7,0;1,0;;;;;;;;8,0;;;;;;;1,0;;5,0;;;3,0;;2,0;;;;;;;;;;;;;;;;;;;;;;;;;;;;;;;1,0;;;;2,0;;;;2,0;;;;;;;10,0;6,0;;;;;;;;;;;;;;;;1,0;;;;;;;;;;;;;;;;;;;;;;;;;;;;2,0;;;;;;;;;;;;;;;;;;;;;;;;;;;;;;;;;;;;;;;;;;;;;;;;1,0;;;;;;;;4,0;;;;;;;;;;;;;;;;;;;;8,0;;;;;;;;;;;1,0;;;;;;;;;;1,0;;2,0;;;;;;;;;;;;;;;;;1,0;;;;;;;;;;;;;;;;;;;13,0;;;;;;;;;;;;;;;;;;;;;;;;;;;;;;;;;;;;;;9,0;;;;;;;;;;;;;;;;;;;;;;;;;;;;;;;;;;;;;;;;;;;;;;;;;;;;;;;;;;;;;;;;;;;;;;;;;;;;;;8,0;;;;;;;;;;;;;;;;;;;;;2,0;;;;1,0;;;;;;;;;;;;;;;;3,0;;;;;;;;;;;;;6,0;;;;;;1,0;;4,0;;;;;;;3,0;;;;;;;;;;;;4,0;;;;;;;;;;8,0;;;;;;;;;;;;;;;;;;;;;;;;;;;;;;1,0;;;;;;;;;;;;;;;;;;;;;;;;;;;;;;;;;;;;;;;;;;;;;;;;;;;;;;;;;;;;;;;;;;;;;;1,0;;;;;;;;;;;;;;;;;;;;;;;;;;;;;;;;;;;;;;;;;;;;;;;;;;;;;;;2,0;;;;;;;;;;;;;;;1,0;;;;;;;;;;;;;;;;;;;;;11,0;;;;;;;;;;;;;;;;;;;;;;;;;;;;;;;;;;;4,0;;;;;;;;;;;;;;;;;1,0;;;;;;;;;;;;;;;;;;;;;;;;;;;;;;;;;;;;;;;;;;;;;;;;;2,0;;;;;;;;;;;;;;;;;;;;1,0;;;;;;9,0;;;;1,0;;;;
adaptor;;;;;;;5,0;;;;2,0;;;;;;;;;;;4,0;;;;;;;;1,0;3,0;1,0;4,0;;;;;;;;;;3,0;;;;;1,0;;;;;;;1,0;18,0;9,0;;;12,0;1,0;1,0;1,0;;1,0;;4,0;2,0;;2,0;;;;;;;;1,0;4,0;;;;;1,0;;;4,0;;;;;;;3,0;3,0;;;;;;3,0;1,0;;;;;;1,0;;;;;;;6,0;;;;;3,0;;;;2,0;1,0;;9,0;;;;;;;;;;;;;2,0;;;;;;;5,0;1,0;;;;;;;3,0;;1,0;15,0;18,0;;;;1,0;2,0;;;1,0;4,0;;;;2,0;1,0;;3,0;;1,0;;;;;;1,0;;;;;1,0;;;;;;1,0;;;;;1,0;;;1,0;;;;;;;;3,0;;;;;;3,0;1,0;;;;;;;;;14,0;;;;;;;;;;;;;18,0;;;;;1,0;;;;;1,0;;;;;5,0;;;;;;;;;;;6,0;;;;;;;;;;;1,0;;;;;;1,0;;;;;;;;;1,0;;;;1,0;;;;;;;;1,0;1,0;16,0;3,0;;11,0;;;;;;;;;;;;;;;;;;;;;;;;;;;;;;;;;;2,0;;;;;;;;1,0;;;;;;;;;;;;;;;;;;;;;;;;1,0;;1,0;;;;;;;;;;;;;;;;;1,0;;;1,0;;;;;;;;;;;;;;;;;;;;;;;;;;;;;;;;;;1,0;1,0;;;;;;;;;7,0;;;1,0;;;;;;;;;;;;;4,0;;;;;;;;;;;;;;;;;;;;;2,0;;;;;;;;;2,0;;1,0;1,0;1,0;;1,0;;;5,0;;;;;;;;;;;;;2,0;;;;;;;;4,0;2,0;;;;1,0;;;;;;1,0;1,0;;;;;;;;;;;;;;;;;1,0;;;;;;;;;;;;;;;;;;;;;;1,0;;;;;;;;;;;;2,0;;;;;;;1,0;;;;;;;;;;;;;;;;;;3,0;;;;;;;;;;;;;;;;;;;;;;;;;1,0;;;;;;;;2,0;;;;;;;;;;;;2,0;;;2,0;;;;;;;;;;;;;;;;3,0;;;;;;;;;;;;;;;;;;;;;;;;;;;;;;;;;;;;;;;;;;;;;;;;;;;;;;;;;;;;;;;1,0;;;;;;;;;;3,0;;;;;;;;;;;;;;;;;1,0;;;;;;;;;;;;;;1,0;;1,0;;17,0;;;;;;;;;;;;;;;;;;;;;;;;;;;;;;;;;;;;;;;;;;;;;;;;;;;;;1,0;;;2,0;;1,0;;;;;;;;;;;;;;;;;;;;;;;;;;;;;;;;;;;;;;;;;;;;;;;;;;;;;;;;;;;;;;;;;;;;;;;;;;;;;;;;;;;1,0;;;;;;;;;;;;;;;1,0;;;;;;;1,0;2,0;1,0;;;;;;;;;;;;;;;;;;;;;;;;;;;;;;;;;;;;;;;;;;;;;;;;;;;;;;;;;;;
apart;;;;;;;26,0;3,0;;12,0;3,0;;;;;;;;;;;;;;;;;;3,0;;;1,0;9,0;3,0;;;;29,0;;;23,0;;2,0;12,0;;;;;;;;;;;;25,0;5,0;;1,0;29,0;;;7,0;;;2,0;;;;;7,0;;;;1,0;3,0;;11,0;22,0;1,0;;2,0;;;2,0;;2,0;;;1,0;5,0;3,0;;1,0;2,0;162,0;;2,0;;;30,0;8,0;;;;2,0;;14,0;;;;2,0;8,0;1,0;1,0;;;;2,0;1,0;;3,0;;3,0;;;3,0;;;3,0;2,0;1,0;;;3,0;4,0;15,0;;;;;;3,0;2,0;3,0;;16,0;10,0;;;;;3,0;1,0;;1,0;7,0;7,0;;2,0;;;;;;;;9,0;;;9,0;8,0;13,0;9,0;1,0;2,0;2,0;4,0;;;2,0;6,0;1,0;;;;3,0;16,0;1,0;33,0;;;;3,0;;;;1,0;5,0;1,0;2,0;3,0;;6,0;1,0;;;;2,0;6,0;;3,0;;;;4,0;;;;3,0;12,0;2,0;;;8,0;2,0;;;;;;;;2,0;;5,0;3,0;;11,0;;5,0;;1,0;;;;6,0;2,0;;;1,0;;;1,0;;;;1,0;;2,0;;;11,0;2,0;;;3,0;;;;;1,0;3,0;;;3,0;;;3,0;3,0;;2,0;;;;;;11,0;1,0;1,0;;;;4,0;;;;;;;;;12,0;;3,0;;5,0;;;2,0;5,0;12,0;;;;;1,0;;;;;7,0;;;1,0;3,0;2,0;;;;1,0;;;2,0;;;;;;;;2,0;;;;;;1,0;;;;2,0;;;;;;;1,0;;;;;;;;;;;;;;;1,0;;;;;;13,0;2,0;;;;;;;;;;;;2,0;;1,0;;1,0;2,0;;1,0;;;;;;;;;;;2,0;2,0;;4,0;;1,0;;;;1,0;9,0;;;;1,0;;;;;;;;;;;;;;;;;;;;;;;;;1,0;;;2,0;;;;;;;;;;;;2,0;;1,0;;;;;;;;;;1,0;;;2,0;1,0;;;;;;;;;;;;;;;1,0;;;;;;;;;16,0;1,0;;2,0;;;;;;;;1,0;;;;;;;;;;;;;3,0;;;;1,0;;;;;;;;;;;1,0;3,0;;3,0;;;;;;;;2,0;;;;;;18,0;;;;;;1,0;;;;;;;;;;3,0;;;;4,0;;1,0;;;2,0;;;;5,0;;;;;;;;;;;;;;;;;;7,0;;1,0;;;1,0;;;;1,0;;;;;1,0;;2,0;;;;;;1,0;;;;;;;;;2,0;6,0;;;;10,0;;;;;;12,0;;;;;;5,0;1,0;;;;;;;;;;;;;;;;;;4,0;;1,0;;;;;;;;;;;;;;;;;;;;2,0;2,0;;;6,0;;;;;;;;;;1,0;;;;4,0;;2,0;;;;;;;;;;;;;;;;;;;;;;;;;;1,0;;;;6,0;;;;;;1,0;;;4,0;;;;;;;;;;;;;;;;;;;;1,0;;3,0;;;;;;;;;;;;;;;;;1,0;;;;;;;;;1,0;;;;;1,0;;;;;;;;;;;;;;2,0;;;;;;;;1,0;5,0;;;;;;;2,0;;;;2,0;;1,0;2,0;1,0;;;;;;;;;;1,0;;;;1,0;;3,0;;;;;;;;;;;;;;4,0;;;3,0;;;;;;;;;;;;;;;;;;;2,0;;;;;1,0;;;;;;;;;;;;1,0;;;;;;;;;;;;;;;;;;;8,0;;;;1,0;;;;;;;;;;;;;;;;;;;;;;1,0;;;;;;;;;;;;;;;;;;;;;;;;;;;;;;;;;;;;;;;
brake;;;;;;;1,0;;;;;;;;;;;;;;1,0;3,0;;;;;;;;;;1,0;5,0;;;;2,0;1,0;;;;;4,0;;;;;;;;;1,0;;;;;4,0;;;;;;2,0;;;;3,0;;;;;4,0;;;;;;;2,0;;2,0;;;2,0;;;;;;1,0;;;;8,0;;;;;;;;24,0;;;;;;;;;;;;3,0;4,0;4,0;;;;;;;;;;;;;;;;;;4,0;;;;;;;;;;;;1,0;;4,0;;;;;;;;;;3,0;;;;;;;;;;5,0;;;6,0;;38,0;1,0;3,0;;;7,0;;;;;;;;;;;;4,0;;;;;;;;;1,0;;;;;;;;;;;;;;;;1,0;;;;;;16,0;;;;;;;;;;;;12,0;;;;;6,0;;;;;;;;;;;;;;;;1,0;;;;1,0;;;;;;;3,0;;;;;;;;;;;;;3,0;;;6,0;;23,0;13,0;;;3,0;;1,0;1,0;;;;;;;;;;;;;4,0;;;;;;;;;2,0;;;;;;;;1,0;;;;3,0;;;;;;;;;4,0;;;;;;;;;;;;;;;;;;;;;;;;;;;;;;;;;;;;;;;;;;;;;;;;;;;2,0;1,0;;;;;;;2,0;;;;;;2,0;;;14,0;;;;;;;;;3,0;;1,0;;;;;;;;;;;;;;;;;;;;;;;;;;;;;;;;;;;;;;;;;;;;;;;;;;;;;;;;;;;;;;;;;;;;;;;;;;1,0;;;;;;;;;;;;;;;;;;;;;;;;;;;;;18,0;;;;;;;;;;;;;;;;;;;;;;2,0;;;;;;;;;;;1,0;;;;;;;;;1,0;;1,0;;;6,0;;;;;2,0;;;;1,0;;;;;;;2,0;;1,0;;;;1,0;;;;;;;;;;;;;;;;;;;;;;;;;;;;;;;;;;;;;;2,0;;;;;;;;;;;1,0;;;;;;;;;;;;;;;;;;;17,0;;;;;4,0;;;;;;;;;2,0;;;1,0;;;;;;;;;11,0;;;;;;;;;;;;;;4,0;;;;;;;;;;;;;;;;;;;;;;;;;;10,0;;;;;;;;;;;;;;;;;;;;;;;;;;;;;;;;;;;;;;;;;;;;;;;;;;;;2,0;;;;;;;;;;;;;;;;;;;;;;;;;;;;;;;;;;;;;;;;;;;;;;3,0;;;1,0;;;;;;;;;;;;;;;11,0;;;;;;1,0;;;3,0;;;;;;;;;2,0;;;;;;;;;;;;;;;;;;2,0;;;;;;;;;;;;;;;;;;;;;;;;;;;;;;;;;;;2,0;;;;;;;;;;;;;;;;;;;;;;;;;;;;;;;;;;;;;;;;;;;;;;;;;;;;;;;;;;;;;;;;;;;;;;;;;;;;;;;;;;;;;;;;;;;;;;;
chassis;;;;;;;5,0;;;1,0;1,0;;;3,0;;;;;;1,0;;1,0;;;1,0;;;;;;;;6,0;;1,0;;4,0;3,0;;6,0;;;2,0;;;;;;;;;;;8,0;;12,0;4,0;;1,0;19,0;;;1,0;;;4,0;;;;;8,0;;1,0;;;;;;4,0;;;;4,0;;;;;;;;9,0;1,0;;3,0;;6,0;;;;;7,0;16,0;;;;;;19,0;;;5,0;;;2,0;7,0;;;;3,0;30,0;;;;;;;8,0;;;24,0;2,0;;;;;;4,0;;;;;;1,0;;3,0;;9,0;10,0;;;;;;14,0;;3,0;3,0;12,0;11,0;22,0;1,0;;;;;2,0;;6,0;;2,0;16,0;;109,0;44,0;;13,0;;;1,0;;4,0;1,0;;;;18,0;;9,0;;8,0;;;;8,0;;;;;;2,0;;2,0;;2,0;;;;5,0;5,0;19,0;;;4,0;;;;;;;;7,0;;;;36,0;;;;;;1,0;;;2,0;;;;;6,0;;3,0;;;5,0;;;13,0;7,0;;;;;5,0;8,0;;;;2,0;;;;2,0;;;1,0;1,0;3,0;;;;;;;;;;;;;3,0;;;;;;;;2,0;;5,0;2,0;;;;;;;;;;;;;4,0;17,0;;;;;;;;;;4,0;;1,0;;1,0;1,0;1,0;6,0;1,0;;;6,0;;;3,0;;;;;;;;;;;;6,0;1,0;;;1,0;;;3,0;;;;;;;;;;;;;;;;2,0;;;;;;;;;;;;;;;;2,0;;;;;;;;;;;;;;;2,0;;;;;;3,0;;;;;;;2,0;;;;;;;;;3,0;;;;2,0;;;2,0;;;;;;;;;;;;;;;;;;;;;;;;;;;;;;;;;;;;;;;;;;;;;;;;;;;;;8,0;;;;;;;;;;;;;;;;;1,0;;;;;;;;;;;2,0;1,0;;;;9,0;;;;;10,0;;;;;;;;;;;;4,0;;;9,0;;;5,0;;;;1,0;;;;;;;;;;;;;;;3,0;10,0;;;;;;;;;;;;;3,0;4,0;;;;;;;;;;;;;;;;;;;;;;;;;;;;;;;;;;;;;;;;;;;;;;;;;;;2,0;15,0;;;2,0;;;;;;;1,0;2,0;;1,0;;;1,0;;;;3,0;;;;;;;;;1,0;;;;;;2,0;;;;;;;;1,0;;;;;;;;;;;;;;;;;;;;;;;;;;;;;;;;;;;;;;;;;;;;;;;;;;;;3,0;;;;;;4,0;;;;;;;;;;;;;;;;;;;;;;;;;;;;;;;;;;;;;;;;;;;;;;;;;;;;;;;;;;1,0;;;;;;;;;;;;;;;;;;;;8,0;;;;;;;;;;;;;;;;;;;;;;;;;;;;;;;;;1,0;;;;;;;;;;;;4,0;;;;;;;10,0;;;;;;;;;;;;;;;;;;;;;;18,0;;;;;;;;;;;;;;;;;;;;;;;;;;;;;;;;;;;;;;;;;;;;;;;;;;;;;;;;;;;;;;;;;;;;;;;;;;;;;;;;;;;;;;;;;;;;;;;;;;;;;;;;;;;;;;;;2,0;;;;;;;;;;;;;;;;
cure;;;;;;;1,0;;;;;;;;1,0;;;;;;;;;;;;;;;;;;;;;;;1,0;;;;;;;;;;;;;;;;1,0;;;4,0;;;15,0;;;3,0;;;;;;;;4,0;;;;;;;;;;;;;;;;;;;;1,0;;;;;;;;;3,0;4,0;;;;;;;;;;;;;1,0;3,0;;;;;1,0;;;;;;;;;;;;;1,0;;;;;;;1,0;;;;;;;8,0;;;;;4,0;;4,0;;6,0;;;;;;;2,0;;;2,0;;4,0;;;;;5,0;1,0;;;;;;;;;;;;;2,0;;;;;;4,0;;;;;;;;;;;;;;;;1,0;;;;;;;;1,0;;;;;;;;;;;;;;;;;;;;;3,0;9,0;;2,0;;;;;;;;;;;;;;;;;;;;;;;;;;;;;;;;;;3,0;;;;;;;;;;1,0;;;;;;;;;;;;;;;;;;;;;;;;;2,0;;;;;;;;;1,0;;;;;;;;2,0;;;;;;;;;;;;;;;;;;;;;;;;;;;;;;;;;;;;;;;;;;;;;;;;;;;;;;;;;;;;;;;;;;;;;;;;;;;;;;;;;;;;;;;;;;;;;;;;;3,0;;;;;;;;;;;;;;;;;;;;;;;;;;;;;;;;;;;;;;;;;;;;;;;;1,0;;;;;;;;;;;;;;;;;;;;;;;;;;;;;;;;;;;;;;;2,0;;;;;;;;;;;;1,0;;;;;;;;;;;;;;;;;;;;;;;;;;;;;;;;;;;;;;;;;;;;;;;;;;;;;;;;;;;;;;;3,0;;;;;;17,0;;;;;;;;;;;;;;;;;;;;;;;;;;;;;;;;;;;;;;;;;;;3,0;;2,0;;;;;;2,0;;;;;;;;;;;;;;;;;;;;;;;1,0;;;;;;;;;;;;;;;;;;;;;;;;;;;;;;;;;;;;;;;;;;;;;;;;;;;;;;;2,0;;;;;;;;;;;;;;;;;;;;;;;;;;;;;;;;;;;;;;;;;;;;;;;;;;;;;;;;;;;;;;;;;;;;;;;;;;;;;;;;;;;4,0;;;;;;;;;;;;;;;;;;;1,0;;;;;;;;;;;;;;;;;;;;;;;;;;;;;;;;;;;;;;;;;;;;;;;;;;;;;;;;;;;;;;;;;;;;;;;;;14,0;;;;;;;;;;;;;;;;;;;;;;;;;;;;;;;;;;;;;;;;;;;;;;;;;;;;;;;;;13,0;;;;;;;;;;;;;;;;;;;;;;;;;;;;;;;;;;;;;;;;;;;;;;;
differential;;;;;;;3,0;11,0;10,0;;;1,0;;;;2,0;;;;;3,0;9,0;;;;;;24,0;;10,0;1,0;7,0;6,0;8,0;7,0;;;3,0;;;;;10,0;;4,0;;;;;;2,0;;;;;16,0;7,0;;;;;;2,0;9,0;;3,0;3,0;;;4,0;;;;;;;;;11,0;;;4,0;;;;;27,0;;;;;1,0;;71,0;;;;;1,0;;2,0;14,0;;;;;;5,0;;;;;;;;;;;;;;;1,0;2,0;;;5,0;;;;;;;;;14,0;;;;;1,0;;;;;;;3,0;;;;;;;;;;;;8,0;;;;;;;1,0;;;;10,0;2,0;;;;;;4,0;;;;;;;;;;1,0;;51,0;;;;5,0;;;;;1,0;;;;;;;;;;;;;;;;3,0;6,0;1,0;;;;;;;;;;;;;;;;;1,0;3,0;;;;5,0;;;;;;1,0;;;;2,0;;;10,0;;5,0;;;;8,0;;;;;;;;;;;;;1,0;;;;;;;;;;;;;3,0;;4,0;;4,0;1,0;;;1,0;;1,0;;;;;;;;;;;;;;2,0;;;4,0;4,0;;;2,0;;;;;;;16,0;;;;4,0;;;;4,0;;;2,0;;;;1,0;;;;;4,0;;2,0;;;;;;42,0;;;6,0;;1,0;;;1,0;;;9,0;;;;;;;;;;;;;;;1,0;;1,0;;2,0;1,0;;;;;;;;;;;;;;;;;;4,0;;;;2,0;;2,0;;;;;;;;;;;;3,0;;5,0;;;;;;1,0;;;2,0;;;;;;;;;8,0;;;;;;;;;;;;;1,0;;1,0;;;;;;;;;;1,0;2,0;3,0;;;;;;;;2,0;;;;;;;;;;;;;;10,0;1,0;;;;;1,0;;;3,0;;;;;;;;;;1,0;;;;;;;;;;1,0;;;;;;;;21,0;;;;2,0;;;;;;;;1,0;3,0;;;;;;;;1,0;;;;;;;;;;;;;;;;;15,0;;;;;;2,0;;;;;;;;;;;;;7,0;;;;1,0;;2,0;;;;;1,0;;;;;;;;;;;;;;;;;;;;;;;;;;1,0;;;;1,0;;;;;;;;;;;;;5,0;;;;;1,0;;;;;;;;;;;;4,0;;;;;;;;;;;;;;;;;;;;;;;;2,0;;;;;;13,0;;;;;4,0;;1,0;16,0;;;;;;;;4,0;;;;;;;;1,0;;;;;2,0;1,0;2,0;;;;;12,0;;;;;;;;;;;;;;1,0;;2,0;;;;;;;;12,0;;;12,0;;;;;1,0;;;;;;;;;;2,0;;;;;;2,0;;;1,0;;;2,0;;;;;2,0;;1,0;2,0;;;;;;;;;;;;;;;;3,0;;;;;;;;;;;;;;;;;;;;;;;;;;;;;;;;;;;;;;;;;;;;4,0;;;;;;;;;;;9,0;5,0;;;;;;;;2,0;;;;;;;;;;2,0;;;;;;;;;;;;;;;;;;;;;;;;;;;;;;;;3,0;;;;;;;;;;;;;;;;;;;;;;;;;;;;;;;;;;;;;;;;;;;;;;;;;;;;;;;;;;;;;;;;;;;;;;;;;;;;;;;;;;;;;;;;;;;;;;;;;;;
drain;;;;;;;2,0;;;5,0;;;;;;;;;;;;10,0;;;;;;;;;1,0;;11,0;;;;;7,0;;;;;;4,0;;;;;;;3,0;1,0;;1,0;1,0;5,0;10,0;;;;;;;;;;;;6,0;2,0;;;;;;;4,0;;2,0;;;;;;;;144,0;;;4,0;;;;5,0;;;;;;8,0;5,0;;;21,0;;;8,0;13,0;;;;2,0;1,0;;;;9,0;;;;;;;1,0;;2,0;;4,0;;;;;;;;;12,0;;12,0;;;;;;;;20,0;;;;;;;;3,0;;5,0;;;2,0;;;;;;6,0;;;3,0;;;;;;;;;;;;;;;;;;;4,0;;2,0;;;;;;;;;;;7,0;2,0;;12,0;;;2,0;;27,0;;;;;;;2,0;;2,0;;;;;;;2,0;;;;;;;;;3,0;4,0;;;5,0;;;2,0;;2,0;1,0;;;3,0;;;;3,0;;3,0;52,0;;;;;;;1,0;2,0;;;;;;;;;;;6,0;;;;;;;;;;;;;;;;;7,0;;;2,0;;;;4,0;;;;;;;;;;;;;;;;;;1,0;;;;;;;2,0;;;;58,0;;;8,0;;;;;;;;;;;;1,0;;;;;1,0;;;;;;;;;;;;;;;;;;1,0;;;;;;;;4,0;;2,0;;2,0;;;;;3,0;2,0;;;1,0;;;;;;;;;;;;2,0;;;;;;;;;;;;;;3,0;;6,0;;;;;;;;;;;;;;;3,0;;;1,0;;;;;;;;;8,0;;;;1,0;;;6,0;;;;;;10,0;;;;;;;;;;;;;;;;;;;;;;;;;;;;9,0;;;;;;;1,0;;1,0;;12,0;;;;;;38,0;;;;;;;;;;;;;;;;;;;;;;;;;;;;;;;;;;;;;;;;;;;;;;;;;;;;;;;;;;;;;;;9,0;6,0;;;;;;;;;;;;;;;;;;;;;;;;3,0;;;;;;;;;2,0;13,0;;;;;;;;;;;;;;;;;;;;;;;;;25,0;;;;;;;;1,0;;;1,0;;;;;;;;;;;;;;;;;;;;4,0;;;;;;;;;;2,0;;;;;;;;;;;;;5,0;;;;;;5,0;13,0;;;;6,0;5,0;;;5,0;6,0;;;;;4,0;54,0;9,0;;;;;12,0;;2,0;;;;;;;;;;;;100,0;;;;4,0;;;;;;;;1,0;;;;;;;;;;;;;;;;;;;2,0;;;;;;;;;;;3,0;;;;;;;;;;;;;;;;;;;;;;;;;;;;;;;;;;;;4,0;;;;;;;;;;;;;;;;;;;;;1,0;;;;;;;1,0;;;;;;1,0;;;;6,0;;;;;;;;;;7,0;;;;;;;;;;;;;;;;1,0;;;;;;;;;;;;;;;;;;;;;;;;;;;;;;;;;;;;;;;;;;;;;;;;;;;;;;;;;;;;;;;;;;;;;;;;;;;;;;;;;;;;;;;;;;;;4,0;;;;;;;2,0;;;;;;;;;;;;;;;;;;;;;;;;;;;;;;;;;;;;;;;;;;
incline;;;;;;;17,0;2,0;1,0;;;;;;1,0;;;;;;;;2,0;;;;;;5,0;7,0;;;5,0;;3,0;;;23,0;;;;;;1,0;;;;;3,0;;;;;;3,0;6,0;10,0;;8,0;6,0;;;;;;;2,0;;;;15,0;;1,0;;2,0;;;2,0;9,0;;;;;;;;29,0;;;;3,0;;;;1,0;;;1,0;;;91,0;1,0;;;;;;;;;;;6,0;3,0;3,0;;;;;9,0;;1,0;;;;;;8,0;;;;;;2,0;;;6,0;;;;;;;13,0;1,0;;9,0;2,0;;;;3,0;;;;;;;;36,0;5,0;;1,0;;;;;18,0;;;10,0;4,0;11,0;1,0;1,0;1,0;;;;1,0;;;2,0;;;22,0;;25,0;;5,0;;2,0;;3,0;;7,0;;;1,0;;;1,0;;19,0;;;;;;1,0;;1,0;;;1,0;;1,0;;1,0;;2,0;2,0;;;7,0;;3,0;;;;;;;2,0;1,0;30,0;2,0;;1,0;;1,0;;1,0;2,0;;;;;1,0;;;;1,0;;;1,0;;;;;;2,0;;;2,0;;;;1,0;;;;;;;;;;;1,0;1,0;;;1,0;;;3,0;;;4,0;;5,0;;;;5,0;;;;;;;5,0;;;;;;1,0;3,0;2,0;;1,0;;;;;;2,0;;;;;2,0;;;1,0;;;;;;;;;;;;;;;;;;;;;1,0;;1,0;;;;;;;;;;;;;;;;;5,0;;;;;;;;;;;;;3,0;;;;;;;;;;;;;;;2,0;;;;;;;;;;;;;;;;;;;;;;2,0;;;;;;;;;;;;;;;;;;;;;;;;;;;;2,0;;;;;;;;;;;;;;;;;;;;;;;;;;;;;;;;;;;;;;;;;4,0;;;;;;;;;;2,0;;;;;;;;;;1,0;;;;;1,0;;;;;;;;;;;;;;;;;;;;;;;;;;;;;;;;;;;;;;;;;;;;;;;;;;;;;;;;17,0;;;;;;;;4,0;;;;;;;;3,0;;;;;;;;;;;;;;;;;;;;;;;;;;;;;;;;;;;;;;;;;3,0;;;;;;;;6,0;;;;;;;6,0;;;;;1,0;;;;;;;;;;;3,0;;2,0;;;;;;;;3,0;;;;;3,0;3,0;;;;6,0;;;;;;;;;;;;;;;;;;;;;;;2,0;;;;;;;;;;;;;;;;4,0;;;;;;;;;;;;;;;;;;;;4,0;;;;;;1,0;;1,0;;;;;;;;;;;;;;;;;;2,0;;;;;;;;;;;;;;;;;;2,0;;;;;;;;;;;1,0;;;;;;;;;;;;;;;;;;;;1,0;;;;;;;;;;;;;;;;;;;1,0;;2,0;;2,0;;;;;;;;;;;;;;;;;;;;;;;;;;;;;;;8,0;;;;;;;1,0;;;;;;;;;;;;;;;;;;1,0;;;;;;;;;;;;;;1,0;;;;;;;;;;;;;;;;;;;;;;;;;;;;;;;;;;;;;;;;;;;;;;;;;;;;;;;4,0;;;;;;;;;;;;;;;;;;;;;;;;;;;;;;;;;;;;;;;;;;;
middle;;;;;;;7,0;3,0;;;11,0;;;;;;;;2,0;;8,0;;;;;;15,0;;;;;;6,0;1,0;2,0;;;20,0;;;3,0;;1,0;6,0;;;1,0;10,0;;23,0;;1,0;;16,0;;28,0;9,0;;10,0;29,0;1,0;1,0;7,0;;;;;;;;4,0;;4,0;4,0;2,0;;;9,0;16,0;;;;;1,0;;;1,0;;;;;1,0;2,0;10,0;;;;;;35,0;19,0;3,0;4,0;;;;1,0;49,0;;;;4,0;;;1,0;;;;2,0;4,0;;;;1,0;;;;1,0;;9,0;5,0;;;24,0;1,0;;7,0;;;;1,0;;1,0;1,0;;;11,0;4,0;;;;;2,0;;;;10,0;1,0;4,0;1,0;;;11,0;;;8,0;20,0;4,0;;;3,0;2,0;7,0;2,0;3,0;2,0;11,0;2,0;;;;;10,0;;11,0;1,0;18,0;3,0;;48,0;;1,0;;;;;;;3,0;;;1,0;;3,0;1,0;;2,0;;1,0;36,0;;;1,0;;;;;2,0;;;28,0;4,0;;;;;;;;;;;;3,0;2,0;1,0;1,0;4,0;6,0;;6,0;1,0;7,0;4,0;;;2,0;;1,0;2,0;3,0;;;2,0;;;;12,0;;;;2,0;1,0;;;;13,0;;1,0;;;3,0;;;2,0;1,0;;;2,0;;12,0;4,0;;6,0;;;2,0;2,0;2,0;;;;;;1,0;;2,0;3,0;1,0;;;;1,0;2,0;2,0;;;15,0;3,0;13,0;3,0;;1,0;;;;6,0;;;;2,0;;9,0;;;;14,0;2,0;;;6,0;;4,0;;;;;;;;;;;2,0;;;;;;;2,0;;;;;;;;;;6,0;;;;;;;;1,0;;;;;2,0;;;;;;4,0;6,0;;;;7,0;;;;;;1,0;;8,0;;2,0;;;1,0;;;;;1,0;;;;;4,0;4,0;;1,0;1,0;1,0;;;;;;;;;;;;;;;2,0;;;;;;;;;;;;;;;;;;;2,0;;;;;;;;;;;;;;;;;;;;2,0;;;;1,0;;;;;;1,0;;;;;;;;;2,0;2,0;;;;;;;;;;1,0;22,0;;;;;;;5,0;;;1,0;;;;;;;;2,0;;;;;;;;;;;;;;;;;;;;;;;;;;;;2,0;;;;;;;1,0;;1,0;;;;;;;;8,0;;;;;;8,0;;;1,0;;;;;5,0;;;;;;;;6,0;;;;;;;;1,0;4,0;;;;11,0;;;5,0;2,0;;;;2,0;;;;;;;;;;;;;;;;;;;;;;;;;1,0;;;1,0;;;;;;;1,0;;;;2,0;;;;;1,0;;;;1,0;;;1,0;;;;;;3,0;;;;1,0;1,0;;1,0;;;;;;3,0;1,0;;;;4,0;;;;5,0;;;;;;;;;1,0;;;;;6,0;1,0;;;;;;;;;;;;;;1,0;;1,0;;;1,0;4,0;;;;;;;;1,0;;;;;;1,0;;;;;;;;;;;;;;;;3,0;;;;;;;;;;;2,0;;;;;;;;;;;2,0;;;;;;;;;;;;;;2,0;;;;;;;;;;;;;;;;;;;;;;;;;;;;;;;;;;;;;;;;;;;;;;;;;2,0;;;;;;;;;;;;;;;;;2,0;;;;;;;;;;;;;;;;;;;;;;;;;;1,0;;;;;;;;;3,0;;;;;;;;;;;;;;;;;;;;;;;;;;;;;;;;;;;;;;;;;;;;;;;;;;;;;;;;;;;;;;;;;;1,0;;;;;;;1,0;;;;;;;;;;;;;;;;;1,0;;;;1,0;;;;;;;;;;;;;;;;;4,0;;;;
orient;;;;;;;28,0;19,0;;21,0;1,0;;3,0;;4,0;;;;1,0;5,0;;9,0;;;;;;9,0;10,0;4,0;6,0;1,0;16,0;3,0;;1,0;1,0;37,0;;4,0;;;2,0;11,0;;;;;;;;5,0;;1,0;1,0;64,0;21,0;;11,0;24,0;;;15,0;;3,0;1,0;;;;;22,0;;4,0;4,0;;;;12,0;36,0;;;2,0;1,0;1,0;;;6,0;1,0;1,0;2,0;4,0;1,0;;;;3,0;2,0;;1,0;2,0;16,0;16,0;;;;;;2,0;;;2,0;1,0;4,0;8,0;;;;1,0;;11,0;;;;;;;11,0;;;;2,0;;6,0;;2,0;1,0;4,0;6,0;4,0;;;1,0;;19,0;19,0;;1,0;5,0;;;2,0;1,0;1,0;;1,0;7,0;;7,0;;1,0;3,0;;;1,0;1,0;3,0;;11,0;;;10,0;14,0;9,0;9,0;7,0;;1,0;;;;;;13,0;;1,0;9,0;10,0;9,0;;18,0;;4,0;4,0;6,0;1,0;2,0;;;5,0;2,0;;2,0;;15,0;;;;;;5,0;;1,0;;;;2,0;;;;1,0;;6,0;;;;;4,0;;;;1,0;;8,0;2,0;1,0;13,0;;4,0;7,0;;1,0;1,0;;;;;;1,0;6,0;2,0;1,0;;;;;;1,0;6,0;2,0;6,0;;;5,0;7,0;;;7,0;;;;;9,0;;;;;;;;13,0;2,0;;;;;4,0;;23,0;1,0;2,0;;1,0;;1,0;;19,0;;;4,0;;5,0;;6,0;6,0;13,0;;5,0;3,0;2,0;1,0;6,0;1,0;;;;;1,0;;;;;;1,0;;2,0;2,0;;;;;5,0;;;;;;;;;5,0;;1,0;;;;;;;;;2,0;;;;;;;;;;;;;;3,0;;;;;;;1,0;;;;;2,0;;;16,0;;1,0;;;;;;;;2,0;;3,0;;1,0;;;;;;;;;;;;;11,0;;;;;2,0;1,0;;;;3,0;;4,0;;6,0;;;1,0;1,0;4,0;;;;;10,0;;;;;;;;;;;;;;;4,0;;;;;;;3,0;;;;;;4,0;;;;;1,0;;;;1,0;;;;1,0;7,0;;;;;;1,0;;;1,0;;;;2,0;24,0;;;4,0;;;;;9,0;13,0;;;;;;;;;;3,0;;;;;2,0;;;8,0;2,0;;;1,0;;;;14,0;;;;;;;1,0;;;;;;;;;;;;;;;1,0;1,0;;3,0;;;12,0;3,0;;;;;;1,0;;1,0;4,0;;;;;;;13,0;;;;;;;;2,0;;12,0;;;;;;1,0;;;;;;;;;;;;4,0;;;;;3,0;;;;;1,0;;;;;;;;;;;;1,0;;;;;;;1,0;;;;;;;;;;;;;14,0;;;;;;;;1,0;1,0;;;;;2,0;;;;;;;1,0;1,0;;17,0;;;2,0;2,0;1,0;;;;2,0;;;;;1,0;;;;;;;;;;;;;;;;;;;;;;;3,0;1,0;;2,0;;;;;;;;;;;2,0;;1,0;;3,0;;;;;6,0;;;;;;;;;;;;;;;;;;;;;;;;;;3,0;1,0;;;;;;1,0;;;;;2,0;2,0;;;;;;;;;;;;;2,0;;;2,0;;;1,0;;;3,0;;;;12,0;;;;;;1,0;;;;5,0;;;;2,0;1,0;;;;;;;4,0;1,0;2,0;;;2,0;1,0;;;;;;;;;;;;;;;;;4,0;7,0;;;;;1,0;;1,0;;;;;;;1,0;;;;;;;;;3,0;;;;3,0;;;;;;2,0;3,0;;1,0;;;;;;;2,0;;;;1,0;;;;1,0;;;;;;;4,0;;;;;;;;;;;;;;;;;;;;;;;;;;1,0;;;2,0;;;;;;;;;;;;;;;;;;;;;1,0;;;;;;;;;;1,0;;;;8,0;;;3,0;;;;;;;;;;;;;;2,0;;1,0;1,0;;;;3,0;;;;;;3,0;;1,0;;;;;;;;;;;;;;
pane;;;;;;;4,0;2,0;;2,0;;;;;;;;;;;;;;;;;;9,0;;1,0;14,0;;10,0;;;;;5,0;;12,0;;;;52,0;;;;;;;;;;;;22,0;9,0;;;25,0;;;2,0;;;6,0;;;;4,0;9,0;;;;;;;13,0;;;;;;;;;28,0;;;2,0;3,0;;;;;24,0;;;;;;7,0;;;;;;;;1,0;;4,0;;;;;;;;13,0;1,0;;;;;;1,0;;;5,0;3,0;;;;;;;;;;;;;1,0;;;4,0;;;12,0;;;3,0;1,0;;;;;;;7,0;;;7,0;;;;7,0;;3,0;;;;;;;;;;;;;;;;1,0;;;;22,0;2,0;;1,0;1,0;;;11,0;;;;;;;23,0;;;;;16,0;2,0;;;;;3,0;;1,0;7,0;;;;23,0;;;;;3,0;2,0;;;;;;;;4,0;;;;;;;;;;;;;;;;;;25,0;;;;;;;9,0;;;;;;;;;;;8,0;;;;5,0;;;;2,0;;;;;;;;1,0;;6,0;;;;;;4,0;;;;;;;;1,0;;;;;;;;;;;;;;;;;;;;;5,0;;;;;;3,0;;;;;;;;;;;;;;;;;;;;;;;;;;;;;;;;;;;;2,0;;;;;;;;;;;;;2,0;;;;;;;;;;;;4,0;;;;;;;;;2,0;;;;;;1,0;;;;;;;;;;;;5,0;;;;;;;;;;;;;;;;;;;;;;;2,0;;;;;;;;1,0;;;;;;;;;;;;;4,0;;;;;;;;;;;;;;;;;;;;;;;;1,0;1,0;1,0;;;;;;17,0;17,0;;;;;;;;;;;;;;;;;;;;;;;;;;;;;;;;;;;;;;4,0;;;;;;;;;;;;;;;;;;;;;;;;;;;;;;;;;4,0;;;;;;;;;;;;;;;;;;;;;;;;;;;;;;;;;;;;;;;;;;;;;1,0;5,0;;;;;;;;;;;20,0;;;;;;;;;;;;;;;;;;;;;;;;;;;;;;;1,0;;;;;;;;;;;;;;;1,0;;;;;;;;;;;;;;;;;;;;;;;;;;;;;;;;;;;;;;;;;;;;;;;;;;;;;;;;;;;;;;;;;;;;;;;;;;;;;;;;;;;;;;;;;;50,0;;;;;;;;;;;;;;;;;;;;;;;;;;;;;;;;;;;;;;;;;;;;;;;1,0;;;;;2,0;;7,0;;;;;;;;;;;;;;;;8,0;;2,0;;;;;;;;;;;;;;;;;;;;;;;;;1,0;;;;;;;;;;;17,0;;;;;;;;;;;;;;;;;;;;;;;;;;;;;;;;;;;;;;;;;;;;;;;;16,0;;;;;;;;;;;;;;;;;;;;;;;;;;;;;;;;;;;;;;;;;;;1,0;;;;;;;;;;;;;;;;;;;;;;;;;;;;;;;;;;;;;;;;;
protective;;;;;;;2,0;4,0;;1,0;;;;;;;;;6,0;;;1,0;;;;;;;;;;;26,0;;7,0;;;1,0;;;2,0;;;21,0;;;;;;;;;;;;5,0;10,0;;;13,0;;;12,0;;;2,0;;;;3,0;2,0;;;;1,0;3,0;;;24,0;;2,0;;;;;;1,0;;;;2,0;;;2,0;2,0;2,0;;;;5,0;16,0;2,0;;;;1,0;;5,0;;4,0;;4,0;;20,0;1,0;;;;1,0;;;;;1,0;2,0;;5,0;1,0;;1,0;60,0;;;;;;8,0;;2,0;;;;;;2,0;;22,0;4,0;;4,0;;;2,0;1,0;;1,0;4,0;6,0;;1,0;;;;1,0;;18,0;;9,0;;9,0;24,0;;7,0;;7,0;3,0;4,0;;;2,0;1,0;;4,0;1,0;1,0;;8,0;3,0;;11,0;;2,0;1,0;10,0;;8,0;1,0;;;;3,0;7,0;2,0;5,0;1,0;;;1,0;1,0;1,0;;2,0;;;;1,0;1,0;14,0;;;4,0;2,0;;1,0;;;2,0;;;;;;;1,0;1,0;;1,0;;5,0;;4,0;;;1,0;;3,0;3,0;;;;;;;5,0;;;5,0;4,0;;;;;;;3,0;;4,0;;1,0;1,0;;1,0;;;;;;;1,0;2,0;;1,0;;2,0;3,0;;1,0;;6,0;3,0;1,0;;;2,0;;;;3,0;;;;;;;2,0;;;;;2,0;;1,0;;;1,0;;2,0;;;2,0;;;;;;;4,0;;;;;;;;;;;;;;;;;;;;;;;1,0;6,0;;;;;;;;;;;;;;;1,0;;;;;;;;;2,0;;;;;2,0;;;;;;;;;;2,0;;;;;2,0;;;;;;;;2,0;;;;;;;1,0;;1,0;;;;;;;;;;;;;2,0;;1,0;1,0;;;;;;;;;;;;;;;;;1,0;;1,0;;;;;;;2,0;;;;;;;;;;;;;4,0;;;;;;;;;;;;;;;;;;;;1,0;;;;;2,0;;;;14,0;;;;;;;;;3,0;;;;1,0;;1,0;;;;;;;;;;;;;;;;;;1,0;;;;4,0;;;;;;1,0;;;;;;;;;;;;;;;;;;1,0;;;;;;;;;;;;;;;;;;;;;;;;;;;;;;;;;;;1,0;;;;;1,0;;1,0;;;;;;4,0;;;;;;1,0;;;;;;;2,0;;;;;;;;;;;;;;3,0;;;;;;;;;;;3,0;;;;;;1,0;;;51,0;;;;;;;;;;;;;;4,0;;4,0;;;;;1,0;2,0;;;4,0;;;;;;;;;;;2,0;;;;;;;;;;;;;;;;;;;;;;;;;;;;;;;;;;;;;;;;;;;;;;;;;;;;;;;;;;;;;;;;;;;;;1,0;;;;;;;;;;;;;;;;;;;;;;1,0;;;;;;;;;;;;;;;;;;;3,0;;;;;;;;;;;;;;;;;;;;;;;;;;;;14,0;;;;;;;;;;;;;;;;;3,0;;;;;;;;;;;;;;2,0;;;;1,0;;;;;;;1,0;;2,0;1,0;;;;;;;;;;;;;;1,0;3,0;;;1,0;;;;;;;;;;;;;;;;;;;;;;;;;;;;;;;;;;;;;;;;;;;;;;1,0;;;;;;;;;;;;;;;;6,0;;;;;;;;;;;;;;;;1,0;;;;;;;;;;;;;;;;;;;;;;;;;;;;;;;;;
proximal;;;;;;;8,0;19,0;;;;;;;;;;;2,0;;;3,0;;;;;;7,0;;1,0;;;1,0;;2,0;;1,0;5,0;;;8,0;;;9,0;;;;8,0;;;;;;;;;16,0;;5,0;3,0;;;;;;;1,0;3,0;2,0;;2,0;;;;;;;;14,0;1,0;;;;;;;6,0;2,0;;1,0;3,0;;;;;;;;;;1,0;11,0;;;;;;7,0;;;;;;2,0;19,0;;;;;3,0;;;2,0;;;;6,0;9,0;;21,0;4,0;;;;;4,0;9,0;;;1,0;;;;14,0;;1,0;2,0;6,0;;;;1,0;2,0;;;;;16,0;;1,0;;;;;;;;3,0;;;37,0;;18,0;15,0;2,0;5,0;1,0;;;;;;;;2,0;;11,0;3,0;;48,0;;;;;;;;1,0;;4,0;;;2,0;4,0;6,0;;;;2,0;6,0;;;2,0;;;;;;;3,0;;;;;4,0;;;;;;;;1,0;6,0;;4,0;5,0;2,0;3,0;;;5,0;;1,0;9,0;1,0;;;;;;1,0;;12,0;;;;7,0;;;;;1,0;;2,0;;11,0;;;;;;;;1,0;6,0;;;;5,0;1,0;1,0;;;;;;;;;;;;;1,0;1,0;;;;;;4,0;4,0;;;;;;9,0;;;8,0;;;3,0;;1,0;;;;;;2,0;1,0;;6,0;;;;;1,0;;2,0;;;;;;;;;;;;;;;;1,0;2,0;3,0;;;;;;;;;;;;1,0;;;;;;;1,0;;1,0;;;;;;;;1,0;;;;;;;;;;;;;;;1,0;;;;;;;;;;;;;;;;;;;;;;;;;6,0;1,0;;;;;;;;;;;;;;;;;;;;2,0;;;;;;;;;;;;;1,0;;;;;;;;;;;;1,0;4,0;7,0;;;;1,0;;;1,0;;;;;;;;;;;;;;;;;;;;5,0;1,0;;;4,0;;1,0;;;;;1,0;;1,0;;;1,0;;;;;1,0;2,0;;;;6,0;90,0;;;;;7,0;13,0;;;;;;;;;6,0;2,0;;;;;;;;;9,0;;;2,0;;;;;;;;;3,0;;;;;;;;4,0;;3,0;;1,0;;;;;;1,0;;;1,0;;;;;;;;;;;1,0;;2,0;;;;;;;1,0;;;;;10,0;;;;;;;;1,0;;2,0;;2,0;;1,0;;;12,0;;1,0;;;;3,0;;;;1,0;;1,0;;7,0;18,0;;13,0;;;;;;;;;;;;;;;1,0;1,0;;3,0;;;;;;;;1,0;;;;;;;;;2,0;;;;;;;;;;;;;;;;;;;;;;;;;;;;;;;;;;;;;;;;;;;;;;;;;;;;;;;;;;;;;;;;;;;;;;;;;;;;;;4,0;;;;;;;;;;;;;;;;;;;;1,0;;;;5,0;;;;;;;;;1,0;;;;;;;;;;;;;;;;;;;2,0;;;1,0;;;4,0;;;;;;;;;;;;;;;;;;;1,0;;;;;5,0;;;;;;;;;;;;5,0;;;;;;;;;;;;;;;;;;;;;;;;;;;;;5,0;;;;;;;;;;3,0;;;;2,0;;;;;;;;;;;;;8,0;;3,0;1,0;;;;;;;;1,0;;;;;;;;;;;;;;;;;;;;;;;;;;;1,0;;;;;;;;;;2,0;;;;;;;;;;;;;;;;;;;;;;;;;;1,0;;;;;;;;;;;;;;;;;;;;;;;;
slid;;;;;;;2,0;1,0;;2,0;;;;;;;;;;;;;;;;;;;;;;;12,0;;3,0;;;9,0;;8,0;;;3,0;;;;;;1,0;;;;;9,0;;5,0;1,0;;;16,0;1,0;;1,0;;;2,0;;;;;2,0;;4,0;;;;;;11,0;;;;;;;;1,0;;;;;1,0;;;;;;;;;1,0;;;;;;;3,0;;;3,0;;;;1,0;;;;;1,0;;;;;;;1,0;8,0;;1,0;11,0;;;;;;;;;;;;;1,0;;;4,0;2,0;;;;;1,0;;2,0;2,0;1,0;8,0;;8,0;;;;;;;;2,0;;;;;1,0;4,0;;;2,0;;;;;;;;;;2,0;2,0;;1,0;;1,0;;;;;;;;;;3,0;;8,0;;;;;;;;;;;;1,0;;;;;;3,0;;;;;2,0;;;;;;2,0;;;;;;;;;;;;;;;;1,0;;;;;3,0;;;;;;;;1,0;;;4,0;1,0;;;;;;;;;;2,0;;;;;;;;12,0;2,0;1,0;1,0;;2,0;7,0;;;;;;;;;;;;;;;;;;1,0;2,0;;;;;;;;3,0;;;;;;3,0;4,0;;;;1,0;;;2,0;;;;;;;;;;;;;;;;;;;;1,0;;;;;;;;;;;;;;;;;;;;;;;;;;;;;1,0;;;;;;;;;;;;;;;5,0;3,0;;;;;;;;;;;;5,0;;;;3,0;;;;;;;;;2,0;;;;3,0;;;;;;;;;;;;;;;;1,0;;;;;;;;;;;;;;;;;;;;;;;;;;4,0;;;;;;;;;;;;;;;;;;;2,0;;;;;;1,0;;;2,0;;4,0;;;;;;;;4,0;;;7,0;;;;;;;;;;;;;;;;;;;2,0;;;;;;2,0;3,0;;;;;;;;;;;;;2,0;;;;;;;;;;1,0;;;;;;;;;;3,0;;;;;;;;;;3,0;;;;;;2,0;;;;;;;;;;;;;;;;;;;;;;;;;;3,0;;;;;;;;;;;;;;;;;;;;;;;;;;;;;;;;;;;;;;;1,0;;;;;;;;;;;;;;;;;;;;;;;;;;;;;;;;;;;;;;;;;;;;;;;;;;3,0;;;;;;;;;;;;;;;;;;;;;;;;;;;;;;;;;;;;;;;;;;;;;;;;;;;;;;;;;;;;;;;;;;;;;;;;;;;;;;;;;;;;;;;;;;;;;;;;;;;;;;;;;;1,0;;;;;;;;;;;;;;;;;;;;;;;;;;;;;;;;;;;;;;;;;;;;;;;;;;;;;;;;;;;;;;;;;;;;;;;10,0;;;;;;;;;;1,0;;;;1,0;;;;;;;;;;;;;;;;;;;;;;;;;;;;;;;;;;;;;;;;;;;;;;;;;;;;;;;;;;;;;;;;2,0;1,0;;;;;;;;;;;;;;;;;;;;;;;;;;;;;;;;;;;;;;;;;;;;;;
slope;;;;;;;1,0;2,0;;2,0;;6,0;;1,0;;;;;1,0;;;;;;6,0;1,0;2,0;4,0;;4,0;;;8,0;;;;;3,0;;4,0;2,0;;;1,0;;;;;;;1,0;;;;;3,0;2,0;;;36,0;1,0;;2,0;;2,0;;;;;;2,0;1,0;;1,0;;;;;7,0;;;2,0;;;;;1,0;1,0;4,0;;;;;6,0;;7,0;;;;;12,0;2,0;;;;;;3,0;;;;15,0;;;;;;;;;;;3,0;;;;2,0;2,0;;;;;;6,0;21,0;;4,0;;;;;;;1,0;;;;2,0;;1,0;2,0;10,0;;;2,0;1,0;;2,0;;1,0;;;;2,0;;;;;;;4,0;;14,0;;1,0;;5,0;1,0;;5,0;;;;;;;;2,0;;129,0;;25,0;;;;;;;6,0;;;12,0;;11,0;2,0;;;;;1,0;;9,0;;;;;;;;;9,0;2,0;;;;;;;;8,0;;;;20,0;;2,0;;2,0;5,0;;12,0;;;;;;2,0;;;;;;;6,0;;;;2,0;;;;;;4,0;;;;;;;;;;;;;;;;;;;;;;;2,0;;;1,0;;;;;;;;;;;;;;;;;5,0;;;;10,0;;;;;;;;;;;;;21,0;;;;;;;;;;;;;;;;;1,0;;;;;;;;;1,0;;;;;;;;;;;;;;;;;;4,0;;;;;;;;;;;;;;;;;;;4,0;;;;;;1,0;;;;;2,0;2,0;;;;;;1,0;;;;;;;;;;;;;;;;;;;;5,0;;;6,0;;;;;;;;;;;;;;;;;;;5,0;;;;;;;;;;;;;;;;;;;;;;;;;;;;;;;;;;;;;;;2,0;;;;;;;;6,0;;;;10,0;;;;;;;;;;;;;;;;;;;;;;;;;;;;;;;;;;;;;;;;;;;;;;;;;;;;;1,0;;;;;;;;;;1,0;;;;;;2,0;;;;;;;;;;;;;;;;;;;;;;;;;;;;;;;;;;;;;;;;;;;;;;;4,0;;;;;;;;;;;;;;;;;;;;;;;;;;;2,0;;;;1,0;;;;;;;;;;2,0;;;;;2,0;;;;;;;;;;;;;;;;;;;;;1,0;;4,0;;;;;;;;;;;;;;;;;;;;;;;;;;;;;;;;;;;;;;;;;;;;;;;2,0;;;;;;;;;;;1,0;;;;;;;;;;;;;;;;;;;4,0;;;;;;;;;;;;;;;;;;3,0;;;;;;;2,0;;;;;;;;;;;;;;;;;;;;;;;;;;;;;;;;;;;;;;;;;;;;;;;;;;;;;;;;;;;;;;;;;;;;;;;;;;;;;;;;;;;;;;;;;;;;13,0;;4,0;;;;;;;;;;;;;;;;;;;;;;;;;2,0;;;;;;;;;;;;;;;;;;2,0;;;;;;;;;;;;;;;;;;;;;;;;;;;;;;;;;;;;;;;;;;;;;;;;;;;;;;;;3,0;;;;;;;;;;;;;;;;;;;;;;
spacer;;;;;;;10,0;5,0;;1,0;;;;;1,0;;;;;;;;2,0;;;;1,0;;;3,0;;;10,0;;2,0;;4,0;2,0;;;2,0;;;16,0;;;;;;;;;;8,0;;21,0;28,0;;4,0;207,0;;;18,0;;;;;;;;11,0;;;;2,0;;;;9,0;;;;;;;;;;4,0;;18,0;;;3,0;;15,0;;;;78,0;23,0;1,0;;1,0;;;1,0;1,0;;;7,0;8,0;;14,0;4,0;;;;1,0;5,0;2,0;;;4,0;;;1,0;18,0;;5,0;10,0;;;;5,0;29,0;29,0;;;;;;;3,0;13,0;;10,0;11,0;;2,0;1,0;8,0;5,0;1,0;5,0;15,0;7,0;20,0;;;;;11,0;1,0;;12,0;2,0;5,0;;7,0;15,0;;18,0;25,0;;;2,0;;;;;;;;;6,0;10,0;21,0;;19,0;4,0;13,0;;7,0;;;;;4,0;18,0;;1,0;;4,0;;;;;1,0;23,0;;3,0;1,0;;;;1,0;1,0;1,0;19,0;8,0;;;;8,0;;1,0;;;1,0;;1,0;1,0;3,0;4,0;;8,0;1,0;5,0;;19,0;;12,0;3,0;;;;;;;;;;;;;;11,0;;3,0;;;2,0;;2,0;;8,0;;;;2,0;1,0;;1,0;10,0;;;;;1,0;;;;;2,0;;;;;5,0;8,0;;2,0;;;;;;3,0;5,0;;;7,0;2,0;;8,0;3,0;;;1,0;;1,0;;;2,0;;;;4,0;5,0;;;;;;1,0;;11,0;;;;;;;;;;;;;2,0;;;;;;;1,0;1,0;;;;;;;;;;;;;;1,0;;;;;;5,0;;;;;;;;2,0;;;;;;;;;;;;;;;;;;10,0;;;;;;;;;;;;;;;;19,0;;;;;;;;;;;;;;;;;;;;;;;;;;;;;;;;;;;;;3,0;;;;;;;2,0;;;;;;;;;2,0;;;;;;;;;;;;;1,0;;;;;;;;;1,0;;;;;;;;1,0;;;;;;;;;;;3,0;;;;;;;;;;;;;;;;3,0;;;;;1,0;;;;;;;2,0;;;;;;;;;;;3,0;8,0;;;;;;;;1,0;;;;;;;;;;;;;;;;;;;;;;4,0;;4,0;;;;;;;;;2,0;7,0;;;;;16,0;;;;;;;6,0;1,0;;;;;;;;;;;;;;;;;;1,0;;;;;;10,0;;;;;;;;;;;1,0;;2,0;;1,0;;;;1,0;;;;;;4,0;;;1,0;;1,0;11,0;;1,0;;;;;;;;;;;;;;;;;5,0;1,0;;8,0;;;;;;;;;;;;;;;;;;;;;4,0;;;;;;;;;;2,0;;;;;;;;;;;;;;;14,0;;;;;;;;;;1,0;;;;;;;;;;;;;;1,0;;;;;;;;;;;;1,0;;;;;;;;;;;;;;;;;;;2,0;;;;;;;;;;;;;;;;;3,0;;;;;;;;;1,0;;;;;;;;;;;;;;;;;;;;;;;;;;;;;;;;;;;;;;;5,0;;;1,0;;;;;;;;;;;;;;;;3,0;;;;;;;;;2,0;;;;;;;;5,0;;;;;;;1,0;;6,0;;;;;;;;1,0;2,0;;;;;;;;;;;;;;;;;;;;;;;;;;;;;;;;;;;;;;;;;;;;;;;;;;;;2,0;;5,0;;;;;;;;1,0;;;;;;;;;;;;;;;;;;;;;;;;;;;;;;;;;;;;;;;;;
stabilizer;;;;;;;2,0;24,0;;;;;;;;;1,0;;6,0;;;2,0;;;;;;;;1,0;;;8,0;;;;1,0;12,0;;5,0;;;2,0;;;;;;2,0;;;;;;;98,0;12,0;;1,0;14,0;;;3,0;;;;;;;1,0;90,0;;2,0;13,0;;;;;2,0;;;;;;;;;1,0;;;8,0;1,0;;;;;;;;10,0;1,0;2,0;;;;;;4,0;;;2,0;;;28,0;2,0;;;;3,0;;1,0;;;3,0;;;10,0;;;9,0;;;;;;;1,0;;1,0;;;;;;;2,0;3,0;19,0;;1,0;;2,0;;;;;;1,0;;;;;;;;;1,0;2,0;;;10,0;1,0;;3,0;;;;;;;;1,0;;;;;2,0;;;3,0;;;;3,0;;;;;;;;;;;;;;;13,0;12,0;;;;;;;;;;;;;;;1,0;;;;;;;;;;3,0;;;5,0;;;;7,0;;3,0;;;;;;4,0;;;;2,0;;;;;;2,0;;3,0;;5,0;7,0;;7,0;3,0;;;;;;;;;;;;;1,0;13,0;;;;1,0;3,0;;;;;;;;11,0;2,0;;;1,0;;3,0;;;;;;;;2,0;5,0;;;1,0;;9,0;;;;;;;2,0;41,0;7,0;;;;;;;5,0;;;;;;;;;;;;2,0;;;;;;;2,0;;;;;;;;;;;;;;;;;;;;;;;;;;;;;;;;;2,0;;;;;;;;1,0;1,0;;;;;;;;;;;;;;;;;;;;;;;;;;;;;;;;;;;;;;;8,0;;;2,0;;;;;;;;;;;;;;;;1,0;;;1,0;;;;;;;;;;;;;;9,0;;;;;;;;;;;;;;;;;;;;;;;;;;;;;;;1,0;;;;;;;2,0;12,0;;;;;;;;;;4,0;;;;;;;;;;;;;;;;;;;;;;3,0;1,0;;;;;5,0;1,0;;;;;;;;;;;;;;2,0;1,0;1,0;;;;;2,0;4,0;;;;;;;;;;;;;;;;;;;;;;;;;;;;;;;;;;;;;;;;;5,0;;;27,0;3,0;;;;;;;;;;;;;;;;3,0;;;;8,0;6,0;1,0;;4,0;;;;;;;;;;;;;;;;;;;;;1,0;;;;;;;;;;;;;;;;;;;;;2,0;;;;;;;;;;;;;;1,0;;;;;;;;;;;;;;;;;;;;1,0;;;;;;;;;;;;;1,0;;;;;;;;;;;;;;;;;;;;;;;;;;;6,0;;;;;;;;3,0;;;;;;;;;;;;;1,0;;;;;;;;;;;3,0;;;;;;;;;;;;;;;;;;;;;;;;;;;;;;;6,0;;;;;;;;;;;;;;;;;;;;;;;;;;;;3,0;;;;;;;;;;;1,0;;;;;;;8,0;1,0;;6,0;;;;;;;;;;1,0;2,0;;;;;;;;;;;;;;;;;;;;;;;;;;;;;;;;;;;;;;;;;;;;2,0;;;;;;;;;;;;;;;;;;;;;;;;;;;;;;;;2,0;;2,0;;;;;;;;;;;;;;;;;;;;;;;;;;;;;;;;;;;;;;;;;;;;;;;
stack;;;;;;;7,0;;;5,0;;;;;;;;;10,0;;;;;;;;;1,0;;;;;3,0;;2,0;;;15,0;;;;;4,0;14,0;;;;;;;1,0;1,0;;6,0;;21,0;16,0;;;112,0;;;3,0;;;;;1,0;;;4,0;3,0;;1,0;;;;;5,0;;;;1,0;;;;6,0;;6,0;1,0;7,0;;;;;;;;;24,0;4,0;4,0;;;;;2,0;5,0;;;;3,0;4,0;11,0;;;;;;4,0;1,0;;;;;;2,0;2,0;;;2,0;;;;;;9,0;;1,0;;;;1,0;7,0;2,0;;12,0;5,0;;1,0;;;;;2,0;1,0;;3,0;;1,0;;;1,0;1,0;;26,0;;2,0;;3,0;9,0;;18,0;9,0;;;;;3,0;;;;;;;2,0;4,0;16,0;;4,0;;;;;;;5,0;;;3,0;6,0;;4,0;1,0;;;2,0;;1,0;2,0;;2,0;;;;;;3,0;;;2,0;;;;;;;;;;;;2,0;4,0;;;3,0;;1,0;;;1,0;1,0;;;4,0;;5,0;;;;;1,0;6,0;;;;2,0;;2,0;;4,0;;;;;3,0;;;3,0;4,0;5,0;;;;;;;;21,0;;;;5,0;;;;;;;1,0;;;;;1,0;;;2,0;;;;2,0;;;;;1,0;1,0;;;3,0;;;;;;;2,0;;;;;;;2,0;6,0;;;;;;;;;;;;;;;;;;;;;;;;;;;;;;;;;;;;;;;1,0;;;2,0;;;;;;24,0;;;;;;;;;;;;;;;;;;;;;;;;;;;;;;;;;;;;2,0;;;;;;;;1,0;;;;;;;;;3,0;;;;;;;;;;;;;;;;;;;;;;;;;;;;;;;;;;;;;;;;;;;;;;;;;30,0;;;;;1,0;;;;;;;;;;;;;;3,0;;;;;;1,0;;;1,0;;;1,0;;;;;;4,0;;;;;;;;;;2,0;;;;;;;;;;;;;;;1,0;;;4,0;;2,0;2,0;;;;;;;8,0;;;;1,0;;;;;6,0;;4,0;;;;;;;;;;;;;;1,0;;;;;;;;;;;;;;;;;;;;;;2,0;;;;;;;;;;;;;;;;;;;;;;;;;;;;;;;;;1,0;;;;;;;;;;;;1,0;;;;;;;;22,0;;;;;;;;;;;6,0;;;;;;;;;;;1,0;;;12,0;;;;;;;;;;1,0;;;;;;;;;;;2,0;;;;;;;;;;;;;;;;2,0;;;;;;;2,0;;;;;;;;;;;;;;;;;;;;;;;;;;;;;;2,0;;;;;;;;;1,0;;;;;;;;;;;;;;;;;;;;;;;;;;;;;;;;;;;;;;;;;;;;;;;;;;;;;;;;;;;;;;;4,0;;;;;;;;;1,0;;;;;;;;;;;;;;;;;;;;;;;;;;;1,0;;16,0;;;2,0;;;;;;;;2,0;;;;;;;;;;;;;;;;;;;;;;;;;1,0;;;;;;;;;;;;;;;;;;;;;;;;;;;;;1,0;;;;;;;;;;;;;;;;;;;;;;;;;1,0;;;7,0;;;;1,0;1,0;;;;;;;;;;;;;;;;;;;;;;;;;;;;;;;;;;;;;;;;;
train;;;;;;;1,0;;1,0;1,0;2,0;;2,0;;;;;;;;;;2,0;;;;;3,0;;1,0;3,0;10,0;18,0;;;;;10,0;;1,0;;;58,0;1,0;;;;;;;3,0;;;;;7,0;32,0;;;;;;9,0;;2,0;23,0;;;;4,0;6,0;;;;;;;;;2,0;1,0;;1,0;1,0;;;;;;;1,0;;;1,0;;;;;2,0;;;7,0;;;;;;1,0;;;;;3,0;;;;;;2,0;1,0;;;;;;;;;2,0;24,0;;;;;;;;;;;;;;3,0;;3,0;;;;;;;5,0;;;2,0;;1,0;;2,0;;;;;3,0;;;13,0;;;;6,0;5,0;10,0;1,0;;;;;;;;;;;;3,0;1,0;;;;;;;;4,0;;;;;;;;1,0;;;1,0;;;6,0;;;;;27,0;4,0;8,0;;;;;2,0;;1,0;;;;;;;;;1,0;;2,0;2,0;;;3,0;;;;;;;;;;;;;;;10,0;;;;1,0;;;;4,0;;;;;;;;;;;;;1,0;1,0;;;;;1,0;;1,0;13,0;;7,0;;1,0;;1,0;;;;5,0;;1,0;;2,0;;;;;;;;;;1,0;;;1,0;8,0;;;;;;;3,0;;;2,0;10,0;;;3,0;;;;;1,0;;;;;;;;;;;4,0;;;;;;;;6,0;;;;;;;;;;;;;;9,0;;;;;;;;;;;1,0;;2,0;;;1,0;;;;;11,0;;;;;;;9,0;;;12,0;;;;2,0;;;1,0;;;3,0;;;;;;3,0;;;;;;1,0;;2,0;2,0;;;;;8,0;;;;;;;;;;;;;;1,0;;1,0;;;;;1,0;;;;;;;6,0;;;;;;1,0;;;;;;;;2,0;;1,0;;;;7,0;;1,0;;;;;;1,0;;;;;;;;;;;1,0;;;5,0;4,0;;;;;;;;;;;;;;;;;;;;;;;;;3,0;;;;;;;;;;;;;1,0;;;;;;3,0;;;;1,0;;;;3,0;;;;;;1,0;;;;;;;;;;;;3,0;1,0;;;;;;;;;;1,0;;;4,0;;;1,0;;;;;;;;;;;;;13,0;;;;;;;;;;;;;;;;;;;;;;;;;;;;;;;;;;;;;;;1,0;;;2,0;;;;;;;;;;;;;;;;;4,0;;;;;;;;;;;;;1,0;;;;;;;;;;;;3,0;;;;;;;;;;;;;;;;;;;;;;;;;;;;;;;;;;;;;;1,0;;;;;;;;;;;;;;;1,0;;;;;;;;;;;;;4,0;;;;;;;;;;;;;;;;;;;;;;;;;;;;;;4,0;;;;1,0;;;;4,0;;;;;;;;;;;;;;;;;;;;;;;;;;;;;;;;;;;;;;;;;;;;;1,0;1,0;;;;;;;;;;;;;;;;;;;;64,0;;;;;;;1,0;;;1,0;;;;2,0;;;;;;;;;;;;;;;;;;;;;;;;;;;;;;;;;;;;;;;;;;;;;;;;;;;;;;;;;;;;;;1,0;;;;;;;;;;;;;;;;;;;;;;;;;;;;1,0;;;;;;;;;;;;;;;;;;;;;;;4,0;;;;;;;;;;;;;;;;;;;;;4,0;;
fixture;;;;;;;;12,0;;;1,0;;;;;;;;9,0;5,0;;1,0;1,0;;;;;;;1,0;;;2,0;;12,0;;;;;;1,0;;;;;;;;;;;4,0;;;;;4,0;;;22,0;;;6,0;;4,0;;;;;;;;;;2,0;1,0;;;12,0;;;;;;;;;;;;1,0;;;;;4,0;;;;;21,0;1,0;;;;;;13,0;;;;;;20,0;9,0;;;;5,0;6,0;;;;;;;3,0;;;;3,0;;;;;7,0;1,0;;;;;;;;;2,0;4,0;4,0;;;;;;;;2,0;15,0;5,0;;1,0;;;;;;;;1,0;;;1,0;;12,0;13,0;;;;;;;;;;1,0;2,0;;1,0;1,0;;5,0;;;;;;;;;;1,0;;4,0;;5,0;;;;;1,0;6,0;;;;;;;1,0;;;;1,0;;;;1,0;;;;;;;;1,0;4,0;;;6,0;2,0;;;;;;4,0;;3,0;;;;;;2,0;;8,0;;;;10,0;;;;;;;;1,0;;;1,0;;;;;3,0;;;;;;1,0;1,0;;7,0;;;;1,0;;;;;;;;;1,0;;;;;;;;;;2,0;;;;3,0;;2,0;;;3,0;;;;2,0;1,0;;;;;;;;2,0;;;;;;;;;;;;;;;;;;;;1,0;1,0;;;;2,0;;;;;;;;;;;;;;;;;;;;;1,0;;;;;;;;;;;;;;;;;1,0;;2,0;;;;;;;;;;;;;;;;;1,0;;1,0;;;;;;;;6,0;;;;;;;;;;1,0;;;;;;;;;;;;;;;;;;;;;;;;;;;;;;;;;;;;1,0;;;;;;;;;;;;;;;;;;;;;;;;;;;;;1,0;;;;;;;;;;;1,0;;;;;;;;;;3,0;;;;;4,0;;;;;;;;1,0;;2,0;;;;;;3,0;;;;;;;;;;;1,0;;;;;;2,0;;;;;;;;;;;;;;;;;;1,0;;;;;8,0;;3,0;;;;;;;;;;;;;;;;11,0;;1,0;;;;;;;;1,0;;;;;;;;;;;;;;1,0;;;;;;;;;;;;;11,0;;;3,0;;5,0;;;;;;;;;;;5,0;;;;;;;;;;;;;;;;;;1,0;;;;;;;;;;;;;;;;;;;6,0;;;;;;;6,0;;;;;;;;;;;;;;;;;;1,0;;;;3,0;;;;;;;;;;;;;;;;;;;;;;;;;;;;;;;1,0;;;;;;;;;;;;;;;;;;;;;;;;;;;;;;;;;;;;;;;;;;;;;;;;;;;;;;;;;;;;;;;;;;;;;;;;;;;;;;;;;;;;;;;;;;;1,0;;;;;;;;;;;;;;1,0;;;;;;;;;;;;;;;;;;;;2,0;;;;;;;;;;;;;;;2,0;;;;;;;;;;1,0;;2,0;;;;;;;;1,0;;;;;;;;;;;;;;;;;;;;;;;;;;;;;;;;;;;;;;;;;;;;;;;;;;;;;;;;;;;;;;;;;;;;;;;;;;;;;;;;;;;;;;;;;;;;;;;
integration;;;;;;;;15,0;3,0;11,0;;1,0;;;;3,0;4,0;;2,0;;;30,0;;4,0;8,0;;;30,0;4,0;5,0;4,0;28,0;9,0;;25,0;;;2,0;;;3,0;;2,0;6,0;;;;;1,0;;2,0;6,0;;;;51,0;19,0;;6,0;;;;33,0;;;1,0;;;1,0;7,0;1,0;;;;;;;;;2,0;;8,0;12,0;3,0;;;5,0;;4,0;2,0;46,0;7,0;;18,0;;;;;7,0;2,0;1,0;5,0;;;;;;;;;;;31,0;2,0;;;;;;1,0;;;;12,0;;2,0;9,0;;;;;;1,0;;;2,0;4,0;;;;;;;;;;;2,0;;;;;;;2,0;;;9,0;4,0;26,0;3,0;;;;4,0;;;44,0;;;1,0;;;;;;;19,0;;;;4,0;;;;5,0;;10,0;;3,0;;;4,0;10,0;;;;;;;;;;;;;;;1,0;;;;;;;320,0;1,0;;;;;1,0;;;;41,0;;;;;;;;2,0;;;;5,0;1,0;;;;2,0;;;;16,0;1,0;;;2,0;;;;;;;1,0;;;;;;;;;;;;;;;;;;;;;;;;;;;;2,0;;16,0;;;;;;5,0;;;;;;;;;10,0;;;;;7,0;;;5,0;;;;;;;;;;;;;;;3,0;;;4,0;;;7,0;;;;6,0;;;3,0;4,0;;5,0;;6,0;2,0;;;6,0;;1,0;2,0;;36,0;4,0;;;;;;;1,0;;;3,0;;1,0;;1,0;34,0;;4,0;;;4,0;;4,0;;;;4,0;20,0;;;;3,0;3,0;;;;2,0;;7,0;;;1,0;1,0;;;;;;;;;;10,0;;;;;;3,0;;;;15,0;;;2,0;;2,0;;;;7,0;;;2,0;1,0;8,0;4,0;;;;;;1,0;;;;;;;3,0;;2,0;;;;1,0;;1,0;1,0;;;;;;;;;;;;;;;1,0;;;;5,0;;;;;;;;;4,0;;;;;;;;;4,0;;2,0;8,0;;;;;10,0;;;;;;;;;1,0;;;;;;;;;;;;;;;;;;;;1,0;;;;;2,0;;;;5,0;;;;;;4,0;1,0;;;;;;;;;;;;;;;;1,0;1,0;15,0;3,0;;;;;;;;;;;;;;;;;;;;1,0;1,0;;;1,0;;;;;;;;;6,0;11,0;;;;;;;2,0;;;;;;;;;;;;;;;;;2,0;;;;1,0;;;;;;;;;;;;;;;;;;;;;;;;;;;2,0;;;;;;;;;;;;;;;;8,0;;;;;;;;;;;1,0;;;;;4,0;;;5,0;;;;;;;;;;;2,0;4,0;5,0;;63,0;4,0;;;21,0;;;;;;;;;5,0;;;3,0;;;;;;;;3,0;;;;;;;4,0;;;;;;;;;12,0;;;4,0;;;2,0;29,0;;;;;;;;;;4,0;2,0;;;38,0;;5,0;;1,0;;;;2,0;1,0;;;;;1,0;1,0;1,0;;1,0;;;2,0;;;;;;4,0;;;;;;;;;;2,0;;;;;;;;;;;;;;;;;;;;;;;2,0;;;5,0;;;;2,0;;;1,0;;;;;1,0;;;;;;;;;;;;;;;;;;;;;;2,0;;;;;;;;;;;;;;;;;;;;;;;;;;;;;;;;;;;;;;;;;;;;;;;;;;;;;;;;;;;;;;6,0;;;;;;;;;;;;;;;;;;;;;;;;;;;;;;;;;;;;;;;;;;;;;;;;;;;;;;;;;;;;;;;;32,0;;;;;;;;2,0;;;;;;;
park;;;;;;;;1,0;;;;;;;;;;;;;;;;;;;;;;5,0;1,0;;;;;;;;;1,0;1,0;;;;;;;;;;;;;;;;2,0;;;;;;;;;;;;;;;;;;;;;2,0;6,0;;;;;;;;;;;;;;;;;9,0;;;;;;4,0;;;;;;;;;;;;;;;;;;;;;;;;;;;;;;;;;;;;;;;;;;;;;;;;;;;1,0;;;;;;;;;;;;;;;;;;;;;;;;;;;;;;;;;;;;;;;;;;;;;;;;;;;;;;;;;;;;;;;;;;;;;11,0;;;;;;;;;;;;;;;;;2,0;;;;;;;;;;;;;;;;;;;;;;;;;;;;;;;;;;;;;;;;;;;;;;;;;;;;;;;;;;;;;;;;;;;;;;;;;;;;;;;;;;;;;;;;;;;;;;;;;;;;;;;;;;;;;;;;;;;;;;;;;;;;;;;2,0;1,0;;;;;;;;;;;;;;1,0;;;;;;;;;;;;;;;;;;;;;;;;;;;;;;;;;;;;;;;;;;;;;;;;;;;;;;;;;;;;;;;;;;;;;;;;;;;;;;;;;;;;;1,0;;;;;;1,0;;;;;;;;;;;;;;;1,0;;;;;;;;;;;;;;;;;;;;;;;;;;;;;;;;;;;;;;;;;;;;;;;;;;;;;;;;;;;;;;;;;;;;;;;;;;;;;;;;;;;;;;;;;;;;;2,0;;;;;;;;;;;;;;;;;;;;;;;;;;;;;;;;;;;;;;;;;;;;;;;;;;;;;;;;;;;;;;;;;;;;;;;;;;;;;;;;;;;;;;;;;;;;;;;;;;;;;;;;;1,0;;;;;;;;;;;;;;;;;;;4,0;;;;;;;;;;;;;;;;;;;;;;;;;;;1,0;;;;;;;;;;;;;;;;;;;;;;;;;;;;;;;;;;;;;;;;;;;;;;;;;;;;;;;;;;;;;;;;;;;;;;;;;;;;;;;;;;;;;;;;;;;;;;;;;;;;;;;;;;;;;;;;;;;;;;;;;;;;;;;4,0;;;;;;;;;;;;;;;;;;;;;;;;;;;;;;;;;;;;;;;;;;;;;;;;;;;;;;;;;;;;;;;;;;;;;;;;;;;;;;;;;;;;;;;;;;;;;;;;;;2,0;;;;;;;;;;;;;;;;;;;;;;;;;;;;;;;;;;;;;;;;;;;;
ramp;;;;;;;;3,0;;1,0;;;;;;;;;1,0;;;2,0;;;;;;;;;;;1,0;;;;;;;;;;;;;;;;31,0;3,0;;6,0;4,0;;;7,0;87,0;;2,0;89,0;;;7,0;;;;;;;;;;;;;;;1,0;6,0;;;;;;;;;;;;5,0;;;46,0;;;;;;;56,0;;;;;;;49,0;15,0;;;;;5,0;;;;;;;11,0;;;15,0;;;7,0;9,0;;1,0;;;;5,0;;;36,0;;;;;;25,0;;4,0;2,0;10,0;;;;;;;;;;;60,0;;;;4,0;;;;;14,0;;;;;;51,0;;;;3,0;11,0;2,0;;;;1,0;;;;;;;6,0;;2,0;;12,0;;;;;;;;;;;1,0;;;;27,0;;;;;;;7,0;;;;;;;;;15,0;;;;;;;;;3,0;;;;;;;26,0;;;8,0;;;4,0;;;;;;;;;;24,0;20,0;;;;;;;47,0;;1,0;;;;;;;;;8,0;;;;7,0;2,0;;;31,0;;;2,0;;1,0;;;;;;;;;;;;;;;;3,0;;;;;8,0;;;;;9,0;;;;;;;;;;;;;;;;;;;;;;;;;;;1,0;;;;;;;;2,0;;;2,0;;;4,0;;;;;;;;;;;;;;;;;;;;;;;;;3,0;;;;;;;;;;;4,0;;;;;;;;;;;;;;;;;;5,0;;;;;;;;;;1,0;;;;;;;;;;;;;;;;;3,0;;;;;;;;;;1,0;;;;;;;;;;;;;;;;;;;;;;2,0;;;;;;;;;;;;;;;;;;;;;5,0;;;;;;;;4,0;2,0;;;;;;;;;;;;;;;;;;;;;;;1,0;;;;;;;;;;;;;;;;;;;;;;;;;;;;;;;;;;;;4,0;;;4,0;;;;;;;;;;;;;;7,0;;2,0;;;;;;;;;;;;;;;;;;;;;;;;;;;;;;;;;;22,0;;2,0;;;;;;;;;;;;;;;;;;;;;;;;;;;;;;;;;;;;;;;;;;;;;;;;;;;;;;;;;;;;;;1,0;;;;;;;;;;;;;;4,0;;;;;;;;;;;;;;;;;;;;;;;;;;;;;;;;;;;;;;;;;;;;9,0;;;;;;;;;;;;;;;;;;;;;;;;;;3,0;;;;;;8,0;;;1,0;;;;;;;;;;;;;;;;;;;;;;;;;;;;;;;;;;;;1,0;;;;;;;;;;;;;;;;;5,0;;3,0;;4,0;;;;;;;;;;;;;;;1,0;;;;;;;;;;;;;;;;;;;;;;2,0;;;;;;;;;;;;;;;;;;;;;;;;;;;1,0;;;;;;;;;;;;;;;10,0;;;;;;;;;;;;;;;;;;;;;;;;;;;;;;;;;;;;;;;;;;;;;;;;;;;;;;;;;;;;;;;;;;;;;;;;;;3,0;;;;;;;;;;;;;;;;;;;;;;
receptacle;;;;;;;;4,0;;;;;;;;;;;4,0;;;6,0;;;;;;3,0;;;;;23,0;;;;2,0;2,0;;;;;;;;;;;;;;;;;;2,0;5,0;;;2,0;;;1,0;;;;;;;;4,0;;;;;;;;2,0;;;;;2,0;;;;;;;;;;3,0;;;;;;;48,0;3,0;;;;;;4,0;;;2,0;;;;11,0;;;;;5,0;;;;;;;7,0;1,0;;3,0;15,0;;;;;;1,0;20,0;;;;;;;;;7,0;;;;;;4,0;;;3,0;;3,0;;4,0;;;1,0;;;;;;;;12,0;;;6,0;;7,0;;;;;;;;;;;7,0;;;4,0;;;;9,0;;;;;;;;;;7,0;;;;;;;;;;;;;1,0;;;;;;;;1,0;;;;;;;;2,0;2,0;;;;;;;;;3,0;25,0;;2,0;;;;;;;;25,0;;;;3,0;;;;;;;6,0;;;;;;;21,0;;;2,0;;;;;4,0;;;5,0;15,0;;3,0;;;;4,0;;6,0;;;;;;;;;1,0;;;4,0;;;;;17,0;3,0;;;;;;;1,0;;;;;;;;;;;;;;;;;;;;;;;;;;;;;;;;;;1,0;;;;;;;;;;;;;;;;;;;;;;;;;;;;;3,0;;;;;;;;;;;;;;;;;;;;;4,0;;;;;;;;;;;;;;;;;;;;;;;;;;;;;;;;;;;10,0;;;;;;;;;8,0;;;;;;;;;;;1,0;;;;;;;;;;;;;;;;;;;;;;;;;;;;;;1,0;;;;;;;;;19,0;;;;;;;;;;5,0;;;;;;;;;;;;4,0;;;;;;;;;;1,0;;;;;;10,0;;;;;;;;;;;3,0;;;;;;;;;;;;;;;1,0;;;;;;;;;;1,0;;;;;;;;;;;;;;;;;3,0;;;;;;;;;;;;;;;;;;;;;;;;;;;;;;;1,0;;;;;;;2,0;;;;;;;;;;;;;;;;;;;;;;;;;;;;;;1,0;;3,0;;;;;;;;;;;;;;;;;;;;;;;;;;;;;;;;;;;;;;;;;;;;;;;;;;;;;;;;;;;;;;;;;;;;;;;;;;;;;;;;;;;;;;;;;;;;;;;;;;;;;;;;;;;;;;;;;;;;;2,0;;;;;;;;;;;;;;;;;;;;;;;;;;;;;;;;;;;;;;;;;;;;;;;;;;;;;;;;;;;;;;;;;;;;;;;;;;;;;;2,0;;;;;;;;;;;;;;;;;;;;;;;;;;;;;;;;;;;;;;;;;;;;;;;;;;;1,0;;;;;;;;;;;;;;;;;;;;;;;;;;;;;;;;;;;;;;;;;;;;;;;;;;;;;;;;;;;;;;;;;;;;;;;;;;4,0;;;;;;;;;;;;;;;;;;;;;;;;
slave;;;;;;;;27,0;;;;;;;;;;;2,0;;;10,0;;;;;;11,0;;;;5,0;4,0;;;;1,0;1,0;;1,0;;;1,0;;;;;;;;;15,0;;;4,0;7,0;20,0;;;;;;17,0;;;;6,0;;;;;;;;;;;5,0;18,0;;;1,0;8,0;;;;6,0;;;1,0;;;;21,0;4,0;;;;;;;20,0;;;;;;22,0;;;3,0;;;;;;;;;;;;;;;;;;;4,0;;;;5,0;;;1,0;;;;;;;;;;;;;;;;;;;;;;;10,0;;;;;;;1,0;;;;;;2,0;;12,0;;;1,0;;;;;;;;;;4,0;;;;;;3,0;;;;;;;;;;;;;;;;17,0;;;;;3,0;;6,0;;;;;;;;;;;;;;;;17,0;;;;;1,0;;;;;;;;;;;;;;;;;;;;;;;;;;;;;;;;;;;;;;;;;;2,0;;;1,0;36,0;;2,0;1,0;17,0;4,0;;;;;4,0;;;;1,0;;;;;;;;;;;;;;;;;;;;;;;;18,0;4,0;;;;;;;;;;4,0;;;;;;1,0;;;21,0;;;;;;;;;2,0;;;;;;1,0;;;;6,0;;;;7,0;;;4,0;;13,0;;;;;2,0;;;;;;9,0;;;;;;;;;;1,0;4,0;;;;1,0;;;;;15,0;;;;;;;4,0;;;;;;;;;;;5,0;;;;;;33,0;;;;;;;;;;;;1,0;;;;;;;1,0;;8,0;;;1,0;;;;14,0;;;;;;;;;;;;;3,0;5,0;;13,0;;;;4,0;;;;;;;;;;;2,0;;;;;;;;;;;4,0;15,0;;;;;;;;;;;;;;;;;;;;;;;;;;;;;;;;;;;;;;;;;1,0;;;;;;;;;;;;;;;;;;;;;;;;;;;;;;9,0;;;;;;;;;;;;;;;;;;;;;;;;;;;;;;;;;;;;;;;;;;5,0;;;;2,0;;;;;;;;;;;;1,0;;;;2,0;;;;;1,0;;;;;;;;;;;;;;;;;;;;;;;;;;;;;;;;;;;;;;;;;;1,0;;;;;;;;;7,0;;;;;;;;;;;;;;;;;;;;;;;;;;;;;;;;;;;;;;;;;;;;;;;;4,0;;;;;;;;;;46,0;;;;;1,0;;;;;;;;1,0;3,0;4,0;;;;;21,0;1,0;1,0;;;;;;;;;;;;;;2,0;;;;;;;;;;;;;;;;2,0;;;;;;;;;6,0;;;;;;;;;;21,0;;2,0;;;;2,0;;;;;;;;;;;;;;1,0;;;;;;;;;;;;;;2,0;;;;;1,0;;;;;;;;;;;;;;;;;;;2,0;;;4,0;;;;;;;;;2,0;;;;;;;;;;;;;;;;;;;;;;;;;;;;;;;;;;;;;;;;;;;;;;;;;;;;;;;;;;;;;;;;;;;;;;;2,0;;;;;;;;;;;;;;;;;;2,0;;;;;;;;;;;;;;;;;;;;;;;;;;;
solder;;;;;;;;5,0;;;;1,0;;;;;;;2,0;;;;;;;;;;2,0;;;;3,0;;4,0;;;;;;1,0;;;2,0;;;1,0;;;;;;;2,0;6,0;12,0;3,0;;;1,0;;;25,0;;;;;;;1,0;2,0;;;;;;;6,0;2,0;1,0;;2,0;;2,0;;;2,0;;;6,0;11,0;;;;;1,0;;;;23,0;10,0;;;;;;;7,0;;;;1,0;;2,0;3,0;;;;7,0;;8,0;;;12,0;1,0;;4,0;3,0;;2,0;2,0;;;;;2,0;7,0;;;;;;4,0;1,0;;;40,0;1,0;;;;1,0;2,0;4,0;;;6,0;6,0;;1,0;;;;1,0;;10,0;;;;5,0;3,0;;22,0;5,0;;2,0;2,0;;7,0;;;;;;;;3,0;29,0;;38,0;;;;;;;;;;1,0;2,0;;2,0;1,0;;;;;;;1,0;;;;;;;;;;14,0;;;;;;5,0;;;;;;;3,0;;;;3,0;5,0;1,0;;;3,0;9,0;;;;6,0;;2,0;;;5,0;14,0;;;;4,0;;;;;8,0;;2,0;;3,0;;;;5,0;;3,0;;1,0;;1,0;;;4,0;;;;;10,0;;;;;1,0;;;;2,0;;;;;;;;;;;;;;;;3,0;1,0;2,0;;;;;;;;9,0;;4,0;;;;1,0;;1,0;;;;;;;;;;;;;;;;;;;;;;;;;;;;;;;;;;;;;;;;;;;;;;;;;;;;;;;;;;;;;;;;;;;;;;;;;;;;;;;;;;;3,0;;;;;;8,0;;;3,0;;;;;;;;;;;;;;;;;;;;;;;;2,0;;;;;;;;;;1,0;;;;;;;;;;;;;;;;;;1,0;;;;;3,0;;;;;;;;;;1,0;;;;;1,0;4,0;;;;;;;;2,0;;;;;;;;;;;;;;;5,0;4,0;;;;;;;;;;;;4,0;;2,0;;1,0;;;;;;;;;;;;;;;1,0;;;1,0;;4,0;;;4,0;;;;;;;;;;;;;;;;;;;5,0;;;;;;;;;1,0;;6,0;;;;;;3,0;;1,0;;;;;;;;;;;;;;;;;;1,0;;;;;;;;;;;;;;;;;;;;5,0;;;;23,0;2,0;;;;;;;32,0;;;;;;;;4,0;;;;;8,0;;2,0;;;;;;;;;;1,0;;;;;;;;;;;;;;;;;;;;;;;;2,0;;;;;;;;;;;;;;;;;7,0;;;;;;;;;;;;;;;;;;;;;;;1,0;;;;;;;;;;;;;;;;;;;;;1,0;;;;;;;;;;;;2,0;;;;;;;;;;;;3,0;;;;;;;;;;;;;;;;;;;;;;;;;;14,0;;;;;;;;;;;;;;;;;;;;;;;3,0;;;;;2,0;2,0;;;;;;;;;;;;;;;;;;;;;;;;;;;;;;;1,0;;;;;;;2,0;;;;;2,0;1,0;;;;;;;;;;;;;;;;;;;;;;;;;;;;;;;;;;;;;;;;;;;;;;;;;;;;;;;;;;;;;2,0;;;;;1,0;;;;;;;;1,0;;;;;1,0;;;;;;;;;;;;;;;;;;;;;;;;;;;;;;;;;;;;;;;;;;;;
transceiver;;;;;;;;2,0;;8,0;;;;;;;;;;1,0;;2,0;;;;;;9,0;;2,0;;;20,0;;2,0;;;;;2,0;;;;7,0;;;;;;25,0;;;;3,0;;2,0;10,0;;;;;;14,0;;;;7,0;;;1,0;27,0;;;;;;;;2,0;2,0;;;6,0;;;;;;;3,0;1,0;;;16,0;;;;;;;;15,0;;;;;;1,0;;;3,0;4,0;;;;;;;;10,0;;;;;;;16,0;1,0;;6,0;;;;;;1,0;;;;;;;2,0;;;;;;;;;;;;;;;1,0;;;;;;;;;;10,0;9,0;;;;6,0;;2,0;2,0;;;;;;;;;1,0;;;;;1,0;;;;23,0;;;;;;;;;;;;;;;;;;;;;;1,0;31,0;;;;;1,0;;;;;;;;;;;1,0;;;1,0;;;4,0;;;;;;2,0;;;;;;;;;5,0;;;;;;;;;;;;;;;;;;;;;;6,0;;;;;2,0;;;2,0;;;1,0;9,0;4,0;;;;;;;;;;;;2,0;;2,0;3,0;;;;1,0;;;;;;;;;;;;;;;;;;1,0;;;;;4,0;;;;;;;;;;;;;;;;;2,0;;;;;4,0;;;;;;;;1,0;;;;;;;;1,0;;;;;;;3,0;;;;;;;;2,0;;;;;;;;1,0;;1,0;;;;;;;;;1,0;;;;3,0;;;;;1,0;;1,0;;;;;6,0;;;1,0;;2,0;7,0;;;;;6,0;;;3,0;;;;1,0;;2,0;9,0;;;;3,0;3,0;6,0;;;;;;;;9,0;;;;;3,0;;;;;;2,0;;;;;;;;;;;;;4,0;;;3,0;;;;;;;;;2,0;;4,0;;;4,0;4,0;;;;;;;;;;;;;;;;;;14,0;5,0;1,0;5,0;;;;;;;;;;;;;1,0;;;;;;;;;;;;;;;;1,0;1,0;;;;;;;;6,0;;1,0;;;;;;;;;;6,0;;;1,0;;2,0;1,0;;;;;;;;;;1,0;;;1,0;;;;;19,0;;;;;2,0;;;6,0;;;;;;;;;;;;;;;;;;1,0;;;;;;;2,0;;;;;3,0;;;;;;;;;;;;;;;;;;;;;;;;;;;;;4,0;;4,0;1,0;;;;;;;1,0;;;;;;;;;;;;;;;;;;;;;;;;;;;;;;;;;;;;;;;;;;;;1,0;;;;;;;;;;;;;;;;;;;;;;;;;;;1,0;;;;;;;;;;;;;;;;;;;;;;;;;;;;;;;;;;;;;;;;;;;;;;;;;;;;10,0;;;;4,0;;;;;;;;;;;;;;;;;;;;;;;;;;;;;2,0;;;;;;;;;;;;;;;1,0;;;;;;;;;;;;;;;;;;;;;;;;;;;;;;;;;;;;;;;;;;;;;;;;;;;;;3,0;;;;;;;;;2,0;;;;;;;;;;;;;;;;;4,0;;;;;;;;;;;;;;;;;;;;;;;;;;;;;;;;;;;;;;;;;;;;;;;;;;;;;;;1,0;;;;;;;;;;;;;;;;;;;;;;;;;;;
version;;;;;;;;1,0;7,0;4,0;;;;4,0;7,0;3,0;;;10,0;;;1,0;;;;;;10,0;;;;;3,0;;;;;2,0;;4,0;1,0;;;;;;;;;;;;;;;61,0;3,0;;;;;;8,0;;;;;;;;;2,0;;;;;;;3,0;;;;1,0;4,0;;;2,0;;1,0;1,0;1,0;;;1,0;1,0;;;;4,0;;2,0;1,0;;;;;3,0;2,0;;;;;3,0;;;;;;;2,0;;;;;;;2,0;;2,0;;;2,0;;;;;;;;;;;;;;;5,0;1,0;;;;;;;;;;;;;;3,0;;;;;3,0;5,0;1,0;;;;1,0;;;;;5,0;;;;;;;;;;;;1,0;;;;1,0;;;;;;;;;;;;;;;;;;;7,0;;;;2,0;;;;;;;;;;;;;;;;;;;1,0;;;3,0;;;;;;;;;;;;;;;;;;;;;;;;1,0;;;;;;;;;;;;;;;;;;;;;;;;;2,0;1,0;;;;;;;;;8,0;;;1,0;;;2,0;;;;;;;;;;;;;;;;;;2,0;;;;;;;;2,0;;;;;;;;;;;;;;1,0;;;;1,0;;;;;;;;;4,0;;;;;;;;20,0;;;7,0;1,0;;;;;;;1,0;;;;;;;3,0;8,0;;;;;;;;;;;;;;;;;;;;;;;;;;;;;;;;;;;2,0;;;;;;;;1,0;;4,0;;;;;;;;;;;;;1,0;;;;;;;;;;;;;;;;;;;;;;;;;;;;;1,0;;;;;1,0;;;;;1,0;;;;;;;;;;;;;;;1,0;;;;;;;;3,0;;;;;;;;;;;;;;;;;;;;;;;1,0;;7,0;;;;;;2,0;;;;;;;;;;;;;;;;;6,0;;4,0;;;1,0;;;;1,0;;;;;;;;;;;;;;;;;;;;6,0;;;;;;;1,0;;2,0;;;;;;;;;;;;;;;;;;;;;;;;;;;;;;;;;;;;;;;;;;;;;;;;;;;;;;;;;;;;;1,0;;;;;;;;;;;;;;;;;;;;;;;;4,0;;;;;;;;;;;;;;;;;;;;;;;4,0;;2,0;;1,0;;;2,0;;;;;6,0;;;;;;;;;;;;;;;;;;;;;;;1,0;;;;;;;;;;;;;;;3,0;;;;;;;;;;;;;;;;;;;;;;;;;;;;4,0;;3,0;;;;;;;;;1,0;;;;;;;;;;;;;;;;;;1,0;;;;;;;;;;;;;;;;;1,0;;;;;;;;;;;;;;;;;;;;;;;;;;;;;;;;;;;;;;;;;;;;;;;;;;;;;;;;;;;;;;;;;;;;;;;;;1,0;;;;;;;;;;;;;;;;;;;;;;;;;;;1,0;;;;;;;;;;;;;;;;;;;;;;;;;;;;;;;;;;;;;;;;;;;;;;;;;;;;;;;;;;;;;;;;;;;;;;;;;;;;;;
warp;;;;;;;;6,0;2,0;7,0;;;2,0;1,0;2,0;;1,0;;;;;;2,0;1,0;;;;1,0;;;;6,0;1,0;;21,0;;;;;4,0;2,0;3,0;;;;;;;;;2,0;;;;2,0;30,0;2,0;;1,0;1,0;;;15,0;;3,0;;;;1,0;;;;;;;;;3,0;;;;;4,0;;;;3,0;;;1,0;1,0;;;;1,0;;;2,0;3,0;;;5,0;;;;;;1,0;;;1,0;;;;;;;;1,0;;;;;1,0;;;;;;;;3,0;;;;;;;;;;;;;;;;11,0;;;;;;;1,0;;;1,0;;;;;;;;;;;;;;;1,0;;;;;;;;;;;;;;;;;1,0;;;;;;;;;9,0;;;;;;;;;;;;1,0;;;;;;;;;;;;;;;;;;;;;;;;;5,0;;1,0;;;;;;;;;;;;;;;;;;;;;;;;;1,0;;;;;;;;;;;;;2,0;;;;;;;;;;;1,0;;1,0;;;;;1,0;;;;;1,0;;;;;;1,0;;;;;;2,0;1,0;;;;;;;;;;;;;;1,0;;;;;2,0;;;;;;;;;;;;;;;;;;;2,0;;;1,0;;;;;;;;;;;;;;;;;;;;;6,0;;1,0;;;;;;;;;;;;5,0;;;;;;;;;;4,0;;;;;;;;;;;;;1,0;;;4,0;;;2,0;;;;;;;;;;;;;4,0;;4,0;;1,0;;;;5,0;;;;;;;;;;;;;;;;;;;;;;;;;;;;;;;;;;;;;;;;;;;;;;;;;;;;;;;;;;2,0;;;;;;;;;;;;;;;;;;;2,0;;;;;;;;;;;;;;;;;;;;;;;;;;;;;;;;;;;;;;;;;;;;;3,0;4,0;;;;;;5,0;;;;;;;;;;;;;;;;;;;;;;;;;;;;;;;;;;;;;;;;;;;;;;;;;;;;;;;;;;;;;;;;;;;;;;;;;;;;;;;;;;;;;;;;;;;;;;;;;;;5,0;;;;;;;;;;;;;;;;;;;4,0;;;;;;;;;;;;;;;;;;;;;;;;;4,0;;;;;;;;;;;;;;;;;;;;;;;;;;;;4,0;;;;;;;;;;;;;;;;;;;2,0;;2,0;;;;;1,0;;;1,0;;;;;;;;;;;;;;;1,0;;;;;;;;;;;;;;;;;;;;;;;;;;;5,0;;;;;;;;;;;;;;;;;;;;;;;;;;;;;;;;;;;;;;;;;;;;;;;;;;;;;;;;;;;;;;2,0;;;;;;;;;;;;;;;;;;;;;;2,0;;;;;;;;;;;;;;;;;;;;;;;;;;;;;;;;;;;;;;;;;;;;;;;;;;;4,0;;;;;;;;;;;;;;;;;;;;;;;;;;;;;;;;;;;;;;;;;;;;;;;;;;;;;;;;
foreground;;;;;;;;;2,0;;1,0;;;;2,0;;;;9,0;;;3,0;3,0;;;;;;;1,0;3,0;6,0;1,0;;3,0;;;8,0;;3,0;2,0;;;;;;;;;;2,0;2,0;;1,0;;46,0;7,0;;;1,0;;;18,0;;;;2,0;;;;1,0;2,0;;;;;;3,0;;;;;5,0;;;;22,0;;;11,0;4,0;;;;;;;1,0;;;3,0;2,0;;;2,0;;;1,0;;;;1,0;2,0;;;;;;;;;;;;;;4,0;;;;;1,0;;;;;;;;;;;1,0;3,0;;;;4,0;;;;;;;;;;;;;;1,0;;;;;;;;;;;;;1,0;;;1,0;;;;;;;;11,0;;;;3,0;;;;;1,0;;;;;;;;;;;;;;;;;;;;;;;;;;1,0;;;;;;;;;;;;;;;;;;2,0;;1,0;;;;;;;;;;;;;;;;;;;;;;1,0;;;;;;;;;3,0;;;3,0;;;;;2,0;;;;;;16,0;;4,0;;;;;3,0;;;;;;;;;;;;4,0;;;;;;1,0;6,0;;;;;;;;;;;;;;;;;;;3,0;;;;;;;;;;;;;;;;;;;4,0;;;;;;;;;;;2,0;;;;3,0;;;;;;;;;;;;1,0;;;;;;;;;;;;;7,0;;;;;;8,0;;1,0;;;2,0;;;;;;;;;;;;;1,0;;4,0;;;;;2,0;1,0;;1,0;;;;;;6,0;1,0;;;;;;;;;;;;;;1,0;;;;;;;;;;;;;;;;;;;;;;;;;;;7,0;;;;;;;;;;;;3,0;;;1,0;;;;;;;;6,0;3,0;;;;;;;;;;;;;;;;;;;;;;;;;;;;;;;1,0;;;;;;;;;1,0;;;;;;;;;;;;;;;2,0;;;;;;;;;;46,0;;;3,0;;;;;;;;;;;;;;;;;;1,0;3,0;1,0;;;;;;;;;;;;;;;1,0;;;;;;;;;;;;;;;;;;;;;;;;;6,0;;;;;;;;;;;;;;;;;;2,0;;;;;;;;;3,0;;;;;;;;;;;;;;;2,0;;;;;;;;;2,0;;;;;;;;;;;;;;;;;;;;;;;1,0;;;;;;;5,0;;;;;7,0;;;;3,0;4,0;;;;;;;;;;;;;1,0;;;;;;;;;;;;;1,0;;;2,0;;;;;;;;;;;3,0;;;;;;;;;;;;;;;;;;;;;2,0;;;;;;;;2,0;;;;;;;;;;;;;;;2,0;;;;;;;;;;1,0;;6,0;;;;;3,0;;;;;;;18,0;;;;;;;;;;1,0;;;;;;;;;3,0;1,0;;;;;;;;;;;;;;1,0;;;;;;;;;;;;;;;;;;;;;;;;;;;;;;;;;;;;1,0;;;;;;;;;;;1,0;;;;;;;;;;;;;;;;;;;;;;;;;;;;;;;;;;;;;;;;;;;;;;;;;;;;;;;;;;;;;;;;;;;;;;;;;;;;;;;;;;;;;;;;;;;;;;;;
overlay;;;;;;;;;;1,0;;;;;12,0;4,0;;;;1,0;;;1,0;;;;;14,0;;1,0;2,0;1,0;9,0;;3,0;;;;;13,0;2,0;;;;;;;;2,0;;1,0;;;;;51,0;11,0;;;;;;8,0;;;;;;;1,0;;;;;;;;;5,0;;;;;;;;;;1,0;8,0;;2,0;;;;;;;5,0;;;9,0;;1,0;;;1,0;3,0;;;1,0;;1,0;;4,0;;;;;;;;;;;;5,0;;;;;5,0;;;;;;;;;;;;;1,0;;1,0;;;;;;;;;;;;;2,0;;;;;;;1,0;1,0;;5,0;;;;1,0;;;;2,0;;;;;;;;;;13,0;;8,0;;;;1,0;;;;;;;;;;1,0;;;;1,0;5,0;;;;;;;;;;;;;;;;1,0;;2,0;;;;;;;1,0;;10,0;;;4,0;;;;;;;;1,0;;;;;;;;;;;;;;;;1,0;;;;;;;;;;;;;1,0;;;;;1,0;;;;;3,0;;;1,0;;;;;;;;;4,0;;;;;6,0;;;;;;;;4,0;2,0;;;;;;;;;;;;;;1,0;;;;;1,0;;;;;;;;1,0;;;;;;;;;;6,0;2,0;1,0;;;;;;;;;;;;;;;;;;;;;;;;;1,0;;;;;;;;;;;4,0;;;;;;;;;;;;;;;;;;;;;2,0;;;2,0;;;;;;;;;;;;;2,0;;;;;;4,0;1,0;;;;;;;;;;;3,0;;;;1,0;;;;;;1,0;2,0;;;;;;;;;;;;;;;;;;;;;;;;;;;;;;;;;;3,0;1,0;;;;;;;42,0;1,0;;;;;;;;;1,0;;;;;;;;;1,0;;;;1,0;;;;1,0;;;;;;1,0;;;;;;1,0;;;;4,0;;;;;;;;;;1,0;;;;;;;;;;;;;8,0;;;;1,0;;1,0;;;;;;;;;;;;;;;3,0;;;;;;;;;;;;;;;;;;;;;1,0;;;1,0;;;;;;;;;;;;;;;;;;;;;;;1,0;;;;;;;;;;;;;;;;;;;;;;;;;;;;;;;;;;;;;2,0;;;;;;;;;;2,0;;;;;;;;;10,0;;;;;;;;;;;;;;;;;;;1,0;;;;;;;;;;;;;;;;;;;;;;;;;;;;;;;;;;;;;;;;;;;;;;;;;;;;;;;;;;;4,0;2,0;;;;;;;;;;;;1,0;;;;;;;1,0;;;;;;;;;6,0;;;1,0;;;;;;;;;;;2,0;;;2,0;;1,0;;;1,0;;;;;;;;;;;;;;;;1,0;;;;;;;;;;;;1,0;;;;;;;;;;;;;1,0;;1,0;;;;;;;;;1,0;;;;;;;;;;;1,0;;;;;;;;;;;;;;;;;;;;;;;;;;;;;;;2,0;;;1,0;;;;;;;;;;;1,0;;;;;;;;;;;;;;;;;;;;;;;;;;;;;;;;;;1,0;2,0;;;;;;;;;;;;;;;;8,0;2,0;;;;;;;;;;;;;;;;;;;;;;;;;;
aerial;;;;;;;;;;;;;;;;1,0;;;;;;1,0;;;;;;;;;;3,0;;;;;;;;;;;;;;;;;1,0;;;;;;;11,0;;;;;;;1,0;;;;;;;;;;;;;;;;;;;;;;;;;;;;7,0;;;2,0;;3,0;5,0;;;;;;;;;;;;2,0;;2,0;;2,0;;;;;;;;;;;;;;;;;;;3,0;;;;;;;;;;;;;;;2,0;;;;;;;;;;;;;;;;;;;;;3,0;;;;;;;;;;;;;;;;;;;;1,0;;;;;;4,0;;;;;;;;;;;;;;;;;;;;;;;;;;;;2,0;;;;;;;;;;;;;1,0;;;;;;;;;;;;;;;;;;;;;;;;;;;;;;;;;;;;;;;;;;;;;;;;;;;;;;;;;;;;;;;;;;;;;;;;;;;;;;;;;;;;;;;;;;;;;;;;;;;;;;;;;;;;;;;;;;;;;;;;;;;;;;;;;;;;;;;;;;;;;;;;;;;;;;;;;;;;;;;;;;;;;;;;;;;;;;;;;;;;;;;;;;;;;;;;;;;;;;;;;;;;;;;;;;;;;;;;;;;;;;;;;;;;;;;2,0;;;;;;;;;;;;;;;;;;;;;;;;;;;;;;;;;;;;;;;;;;;;;;;;;;;;;;;;;;;;;;;;;;;;;;;;;;;;;;;;;;;;;;;;;;;;;;;;;;;;;;;;;;;;;;;;;;;;;;;;;;;;;;;;;;;;;;;;;;;;;;;;;;;;;;;;;;;;;;;;;;;;;;;;;;;;;;;;;;;;;;;;;;;;;;;;;;;;;;;;;;;;;;;;;;;;;;;;;1,0;;;;;;;;;;;;;;;;;;;;;;;;;;;;;;;;;;;;;;;;;;;;;;;;;;;;;;;;1,0;;;;;;;;;;;;;;;;;;;;;;;;;;;;;;;;;;;;;;;;;;;;;;;;;;;;;;;;;;;;;;;;;;;;;;;;;;;;;;;;;;;;;;;;;;;;;;;;;;;;;;;;;;;;;;;;;;;;;;;;;;;;;;;;;;;;;;;;;;;;;;;;;;;;;;;;;;;;;;;;;;;;;;;;;;;;;;;;;;;;;;;;;;;;;;;;;;;;;;;;;;;;;;;;;;;;;;;;;;;;;;;;;;;;;;;;;;;;;;;;;;;;;;;;;;;;;;;;;;;;;
radar;;;;;;;;;;;;;;;;;;;;;;;4,0;;;;;9,0;;;;1,0;3,0;;;20,0;;;;5,0;;;;;;;;;;;;4,0;;;;11,0;9,0;;;;;;3,0;;;;;;;;;;;;;;;8,0;;;;8,0;1,0;16,0;;;4,0;;;;7,0;;;;;;;;;;;8,0;;;;;;;;;1,0;1,0;;2,0;;;;;;;;;;;;;;;;;;;;;1,0;;;;;;;;;;;;;2,0;;;;1,0;;;;;1,0;;;;;;;;;;;;;;;;12,0;1,0;;;;;;;;;;;;;;;;;;;;;;;;;;;;;;1,0;;;;1,0;;3,0;;;;;;;;;;;;10,0;;;;;;;;;;;;;;4,0;;;;;;;;;;;;;;;;;;;;;;;;;;;;;;;;;;;;;;;;;;;;;;;;;;;;9,0;2,0;;;;;;;;;;;;;;;;;;;12,0;;;;;;;;;;;;;;;;;;1,0;;;;;;;;;;;;;;;;1,0;;;;;;;;;;;;;;;;;;;;;;;;;;;;4,0;;;;;;;;;;;;;;;;;;;;;;;;;;;;;;;9,0;4,0;;;;;;;;;;;;;;;;;;;24,0;;;;;;;;;;;;;;;;;;;;;;;;;;;;;;;;1,0;;;;;;;;;;;;;;;;;;;;;;;;;;;;;;;;2,0;;;;;;;;;;;;;;;;;;;;;;;;;;;;;;;;;;;;;;;;;;;;1,0;;;;;;;;;;;;;;;;;;;;;;;;;;;;;;;;;;;;;;;;;;;;;;;;;;;;;;;;;;;;;;;;;;;;;;1,0;;;;;;;;;;;;;;;;;;;;;;;;;;;;;;;;;;;;;;;;;;;;;;;;;;1,0;2,0;;;;;;;;;;;;;;;;;;;;;;;;;;;;;;;;;;;;;;;;;;;;;;;;;;;;;;6,0;;;;;;4,0;;;;;;;;;;2,0;;;;;;;;;;;;;;;;;;;;;;;;;;;;;;;;;;;;;;;;;;;;;;;;;;;;;;;;;;;;;;;;;;;;;;;;;;;;;;;;;;;;;;;;;;;;;;;;;;;;;;;;;;;;;;;;;;;;;;;;10,0;;;;;;;;;;;;;;2,0;;;;;;;;;;;;;;;;;;;;;;;;;;;;;;;;;;;;4,0;;;;;;;;;;;;;;;;;;;;;;;;;;;;;;;;;;;;;;;1,0;;1,0;;;;;;;;;;;;;;;;;;;;;;;;;;;;;;;;;;;;;;;;;;;;;;;;;;;;;;;;;;;;;;;;;;;;;
dental;;;;;;;;;;;;;;;;;;;;;;;;;;;;4,0;;;;;1,0;;1,0;;;1,0;;;;;;;;;;;;;;;;;;3,0;3,0;;;;;;6,0;;3,0;;;;;;;;;;;4,0;;;;;;;;;;;;;;;;;;;;;;;;;1,0;4,0;;;;;;;;;;;;1,0;;;;;;;;;;;;;;;1,0;;;;;;;;;;;;;;;;;;;;;;;;;;;;;;;3,0;;;;;;;;;;;;;;;;;;;;;;;;;;;;;;;;;;;;;;;;;;;;;;;;;1,0;;;;;;;;4,0;;;;;;;;;;;;;;;;;;;;;;1,0;;;;;;;;;;;;;;;;2,0;;;;;;;;;;;;;;;;;;;;;;;;;;;;;;;;;2,0;;;;;;;;;;;;;;;;;;;;3,0;;;;;;;;;;;;;;;;;;;;;;;;;;;;;;;;;;;;;;;;;;;;;;;;;;;;;;;;;;;;;;;;;;;;;;;1,0;;;;;;;;;;;1,0;;;;;;;;;;;;;;;;;;;;;;;;;;;1,0;;;;;;;;;;;;;;;;;;;;;;;;;;;;;;;;;;;;;;;;;;;;;;;;;;;;;;;;;;;;;;;;;;;;;;;;;3,0;;;;;1,0;;;;;;;;;;;;;;;2,0;;;;;;;;;;;;;;;;;;;;;;;;;2,0;;;;;;;;;;;;;;;;;;;;;;;;;;;;;;;;;2,0;;;;;;;;;;;;;;;1,0;;;;;;;;;;;;;;;;;;;;;;;;;;;;;;;;;;;;;;;;;;;;;;;;;;;;;;;;;;;;;;;;;;;;;;;;;;;;;;;;;;;;;;;;;;;;;;;;;;;;;;;;;;;;;;;;;;;;;;;;;;;;;;;;;;;;;;;;;;;;;;;;;;;;;;;;;;;;;;;;;;;;;;;;;;;;;;;;;;;;;;;;;;;;;;;;;;;;;;;;;;;;;;;;;;;;;;;;;;;;;;;;;;;;;;;;;;;;;;;;;;;;;;;;;;;;;;;;;;;;;;;;;;;;;;;;;;;;;;;;;;;;;;;;;;;;2,0;;;;;;;;;;;;;;;;;;;;;;;;;;;;;;;;;;;;;;;3,0;;;;;;;;;;;;;;;;;;;;;;;;;;;;;;;;;;;;;;;;;;;;;;;;;;;;;;;;;;;;;;;;;;;;;;;;;;;;;;;;;;;;;;
impurity;;;;;;;;;;;;;;;;;;;;;;;;;;;;;;;;2,0;17,0;1,0;;;;;;;2,0;;;5,0;;;;;;;;;;;1,0;;2,0;;;;;;;;;;;;;;;1,0;;;;;;;;;;;;;;;81,0;;;;;;;;;;;;3,0;7,0;8,0;;;2,0;;;65,0;5,0;;;;;;;;;9,0;;;;;;;;;;;;;;;;;;;;1,0;;1,0;;;;;1,0;;;26,0;;;2,0;;;;;;;;;;9,0;;2,0;;;;43,0;;;;8,0;;;;;;;;;;;;;;;;;;1,0;;16,0;;;;;;;;;;;23,0;;;3,0;;;;;1,0;;;1,0;;;;;;2,0;;;1,0;;;;;;;;;;;;;2,0;;;;;1,0;;;;;;;;;;;;;;29,0;;;;;;;;;;1,0;;;;;;;;;;;;;;;;;;;;;;;;;;;3,0;;;;;;;1,0;;;;;;;;;;;;;;;;;;;;;;;;;;;;;3,0;;;;;;;;;;;;;;;;;;;;;;;;;3,0;;;;;;;;;;;;;;;;;;;;;;;;;;;;;;;;;;;;;;;;;;;;;;;;;;;;;;;;;;;;;;1,0;;;;;;;;;;;;;;;;;;;;;;;;;;;;;;;;;;6,0;;;;;;;;;;;;;;;;;2,0;;;;;;;;;;;;;;;;;;;;;;;;;;;;;;;;;;;;;;;;;;;;;;;;;;;;;;;;;;;;;;;;;;;;;;;;;;;;;;;;;;;;;;;;;;;;;;;;;5,0;3,0;;;;;;;;;;;;;;;;;;;;;;;;;;;;;;;;;;4,0;;;;;;;;;;;;;;;;;;;;;;;;;;;;;;;;;;;;;;;;;;;;;;;;;;;;;;;;4,0;;;;;;;;;;;;;;;;;;;;;;;;;;;;;;;;;;;30,0;;;17,0;;;;;;6,0;6,0;;;;;;;;;;1,0;;;;;;;;;;4,0;;;;;;1,0;;;;;;;;;;;;;;;;;;;;;;;;;;;;;;;;;;;;;;;;;;;;;;;;;;;;;;;;;;;;;;;;;;;;;;;;;;;;;;;;;;;;;;;;;;;;;;;;;;;;1,0;;;;;;;;;;;;;;;;;;;;1,0;;;;2,0;;;;;;;;;;;;;;;;;;;;;;;;;;;;;;;;;;;;;;;12,0;;1,0;;;;;;;;;;;;;;;;;;;;;;;;;;;;;;;;;;;;;;;;;;;;;;;;;;;;;;;;;;;;6,0;;;1,0;;;;;;;;;;;;;;;;;;;;;;;;;;;4,0;;;;;;;;;;;;;;;;;;;;;;
terahertz;;;;;;;;;;;;;;;;;;;;;;;;;;;;;;;;;1,0;;;;;;;;;;;;;;;;;;;;;;;1,0;;;;;;;;;;;;;;;;;;;;;;;;;;;;;;;;;;;;;;;;;;;;;;;;;;;;;;;;;;;;;;;;;;;;;;;3,0;;;;;;;;;;;;;;;;;3,0;;;;;;;;;;;;;;;;1,0;;;;;;;;;;;;;;;;;;;;;;;;;;;;;;;;;4,0;3,0;;;;;;;;;;;;;;;;;;;1,0;;;;;;;;;;;1,0;;;;;;;;;;;;;;;;;;;;;;;;;;;;;;;;;;;;;;;;;;;;;;;;;;;;;;;;;;;;;;;;;;;;;;;;;;;;;;;;;;;;1,0;;;;;;;;;;;;;;;;;;;;;;;;;;;;;;;;;;;;;;;;;;;;;;;;;;;;;;;;;;;;;;;;;;;;;;;;;;;;;;;;;;;;;;;;;;;;;;;;;;;;;;;;;;;;;;;;;;;;;;;;;;;;;;;;;;;;;;;;;;;;1,0;;;;;;;;;;;;;;;;;;;;;;;;;;;;;;;;;;;;;;;;;;;;;;;;;;;;;;;;;;;;;;;;;;;;;;;;;;;;;;;;;;;;;;;;;;;;;;;;;;;;;;;;;;;;;;;;;;;;;;;;;;;;;;;;;;;;;;;;;;;;;;;;;;;;;;;;;;;;;;;;;;;;;;;;;;;;;;;;;;;;;;;;;;;;;;;;;;;;;;;;;;;;;;;;;;;;;;;;;;;;;;;;;;;;;;;;;;;;;;;;;;;;;;;;;;;;;;;;;;;;;;;;;;;;;;;;;;;;;;;;;;;;;;;;;;;;;;;;;;;;;;;;;;;;;;;;;;;;;;;;;;;;;3,0;;;;;;;;;;;;;;;;;;;;;;;;;;;;;;;;;;;;;;;;;;;;;;;;;;;;;;;;;;;;;;;;;;;;;;;;;;;;;;;;;;;;;;;;;;;;;;;;;;;;;;;;;;;;;;;;;;;;;;;;;;;;;;;;;;;;;;;;;;;;;;;;;;;;;;;;;;;;;;;;;;;;;;;;;;;;;;;;;;;;;;;;;;;;;;;;;;;;;;;;;;;;;;;;;;;;;;;;;;;;;;;;;;;
trailer;;;;;;;;;;;;;;;;;;;;;;;;;;;;;;;;;;;;;;;;;;;;4,0;;;;;;;;;;;;;;;;;;;3,0;;;;;;;;;;;;;;;;;;;;;;;;;;;;;;;;;;;;;;;;;;;;;;;;;;;;;;;;;;;;;;;;;;;;;;;;;;2,0;;;;;;1,0;;;;;;;;;;;;;;;;;;;;;;;;;2,0;;;;;;2,0;;;;;;;;;;;;;;;;7,0;;;;;;;;;;;;;;1,0;;;;;;1,0;;;;;;;;;;;;;;2,0;;;;;;;;;;;;;;;;;;;;1,0;;;6,0;;;;;;;;;3,0;;;;;;;;;;;;;;;;;;;;;;;;;;;;;;;;;;;;;1,0;;;;;;;;;;;;;;;;;1,0;;;;;;;;;;;;;;;;;;;;;;;;;;;;;;;;;;;;;;;;;;;;;;;;;;;;;;;;;;;;;;;;;;;;;;;;;;;;;;;;;;;;;;;;;;;;;;;;;;;;;;;;;;;;;;;;;;;;;;;;;;;;;;;;;;;;;;;;;;;;;;;;;;;;;;;;;;;;;;;;;;;3,0;;;;;;;;;;;;;;;;;;;;;;;;;;;;;;;;;;;;;;;;;;;;;;;;;;;;;;;;;;;;;;;;;;;;;;;;6,0;;;;;;;;;;;;;;;;;;;;;;;;;;;;;;;;;;;;;;;;;;;;;;;;;;;;;8,0;;;;;;;;;;;;;;;;;;;;;;;;;;;;;;;;;;1,0;;;;;;;;;;;;;;;;;;;;;;;;;;;;;;;;;;;;;;;;;;;;;;;;;;;;;;;;;;;;;;;;;;;;;;;;;;;;;;;;;;;;;;;;;;;;;;;;;;;;;;;;;;;;2,0;;;;;;;;;;;;;;;;;;;;;;;;;;;;;;;;;;;;;;;;;;;;;;;;;;;;;;;;;;;;;;;;;;;;;;;;;;;;;;;;;;;;;;;;;;;;;;;;;;;;;;;;;;;;;;;;;;;;;2,0;;;;;;;;;;;;;;;;;;;;;;;;;;;;;;;;;;;;;;;;;;;;;;;;;;;;;;;;;;;;;;;;;;;;;;;;;;;;;;;;;;;;;;;;;;;;;;;;;;;;;;;;;;;;;;;;;;;;;;;;;;;;;;;;;;;;;;;;;;;;;;;
wearable;;;;;;;;;;;;;;;;;;;;;;;;;;;;;;;;;;;;;;;;;;;;;;;;;;;;;;;;;;;;8,0;;;2,0;;;;;;;;;;;;;;;;;;;;;;;;;;;;;;;;;;;;;;;;;;;;;;;;;;;;1,0;;;;;;;;;;;;;;;;;;;;;;;;;;;;;;;;;2,0;;;;;;;;;;;;;;;;;;;;;;;;;;;;;;;;;;;;;;;;;;;;;;;;;;;;;;;;;;;;;;;;1,0;;;;;;;;;;;;;;;;;;;;;;;;;;;;;;;;;;;;;;;;;;;;1,0;;;;;;;;;;;;;;;;;;;;;;;;;;;;;;;;;;;;;;;;;;;;;;;;;;;;;;;;;;;;;;;;;;;;;;;;;;;1,0;;;;;;;;;;;;;;;;;1,0;;;;;;;;;;;;;;;;;;;;;;;;;;;;;;;;;;;;;;;;;;;;;;;;;;;;;;;;;;;;;;;;;;;;;;;;;;;;;;;;;;;;;;;;;;;;;;;;;;;;;;;;;;;;;;;;;;;;;;;;;;;;;;;;;;;;;;;;;;;;;;;;;;;;;;;;;;;;;;;;;;;;;;;;;;;;;;;;;;;;;;;;;;;;;;;;;;;;;;;;;;;;;;;;;;;;;;;;;;;;;;;;;;;;;;;;;;;;;;;;;;;;;;;;;;;;;;;;;;;;;;;;;;;;;;;;;;;;;;1,0;;;;;;;;;;;;;;;;;;;;;;1,0;;;;;;;;;;;;;;;;;;;;;;;;;;;;;;;;;;;;;;;;;;;;;;;;;;;;;;;;;;;;;;;;;;;;;;;;;;;;;;;;;;;;;;;;;;;;;;;;;;;;;;;;;;;;;;;;;;;;;;;;;;;;;;;;;;;;;;;;;;;;;;;;;;;;;;;;;;;;;;;;;;;;;;;;;;;;;;;;;;;;;;;;;;;;;;;;;;;;;;;;;;;;;;;;;;;;;;;;;;;;;;;;;;;;;;;;;;;;;;;;;;;;;;;;;;;;;;;;;;;;;;;;;;;;;;;;;;;;;;;;;;;;;;;;;;1,0;;;;;;;;;;;;;;;;;;;;;;;;;;;;;;;;;;;;;;;;;;;;;;;;;;;;;;;;;;;;;;
