;aberration;accessory;achieve;activation;analyze;angle;aperture;apparatus;area;arrange;array;aspheric;associate;association;axis;base;beam;blur;brightness;calibrate;calibration;capture;changing;channel;characterize;coefficient;color;combination;compact;compensate;computer;condition;configure;contrast;control;controller;correct;correction;create;curvature;data;decrease;define;depth;detect;detection;determine;device;digital;display;dispose;distance;distortion;divide;drive;edge;element;error;estimate;executable;extend;external;field;file;filter;focal;focus;form;frame;front;function;fundus;generate;generation;geometric;group;identify;illuminate;illumination;image;imager;imaging;implement;include;increase;instruction;interchangeable;judge;lateral;length;lens;list;logic;material;measurement;medium;memory;metadata;method;mobile;model;modify;module;object;objective;operable;optical;order;output;parameter;pass;perform;peripheral;pick;plural;plurality;portion;position;power;predetermine;prevent;prism;process;processing;processor;program;property;quantity;radiation;range;reception;reference;relative;remove;represent;resolution;respective;response;sample;satisfy;scene;security;send;sensor;setting;shade;shell;side;signal;size;specific;stack;storage;store;subject;supply;system;telephoto;tilt;transfer;transitory;transmit;unit;variation;vary;vehicular;video;view;visible;wavelength;zoom;absorb;adhesive;adjacent;amount;apply;assembly;barrel;barrier;blue;board;body;bond;cavity;charge;circuit;coat;component;compose;compound;compress;compression;concave;connect;constitute;contact;content;contour;core;cover;cylindrical;design;difference;direction;displacement;elastic;electric;energy;exposure;face;film;flat;force;gate;glass;green;groove;heat;height;hole;house;incident;inner;insertion;instrument;interior;layer;lever;light;manufacturing;member;metal;mirror;mount;movable;move;movement;open;opposite;outer;overlap;panel;partially;path;phase;photodiode;photoelectric;physical;pixel;plane;plate;polarization;post;press;pressure;pulse;receive;reflect;reflector;refractive;resilient;resin;secure;select;semiconductor;shake;shape;shield;shutter;silicon;slide;source;space;spacer;spectrum;spring;start;structure;substrate;surface;switch;synchronization;terminal;thickness;thin;time;total;touch;train;transparent;vehicle;vertical;vibration;wafer;wall;water;weight;windshield;wire;abut;actuator;allow;attach;axial;ball;bearing;bias;block;bottom;boundary;capsule;case;chip;circumferential;close;combine;compartment;connector;convex;couple;cylinder;detachable;diameter;distal;driving;electronics;engage;engagement;enlarge;enter;extension;fasten;flange;fluid;fold;frequency;ground;guide;hold;holder;hollow;incline;insert;integrate;limit;link;lock;motor;parallel;pattern;periphery;perpendicular;photography;pickup;piezoelectric;pivot;platform;point;portable;primary;profile;project;protective;protrude;protrusion;proximal;ramp;rear;recess;reflection;relationship;release;removably;responsive;restrict;rigid;ring;rotatable;rotate;rotation;screw;seat;segment;shaft;sheet;shift;sidewall;sleeve;slope;support;surround;target;test;thereon;thread;transmission;wheel;width;window;zone;acceleration;accelerometer;access;adapt;aerial;aircraft;amplitude;angular;basis;calculate;change;code;compare;composite;compute;constant;construct;continuous;continuously;correlate;correlation;desire;detector;determination;duration;dynamic;exceed;feature;histogram;indicative;inertial;input;level;linear;location;magnitude;match;measure;mode;modulation;monitor;motion;moving;navigation;network;operate;operation;operator;orientation;period;photographic;pitch;posture;preset;rate;record;remote;render;roll;search;sense;sensitive;sound;speed;stabilize;stabilizer;status;steer;threshold;track;trajectory;travel;trigger;update;user;utilize;vector;velocity;voltage;work;adjust;align;analysis;center;coordinate;count;crop;derive;describe;dimensional;discharge;environment;event;execute;factor;forward;handheld;indicator;interface;mark;mechanism;microphone;phone;photograph;picture;predict;projection;radar;read;retrieve;scale;screen;sight;smart;stream;timer;tool;transceiver;viewfinder;accept;acquisition;activate;adapter;adjustment;aspect;attribute;audio;cable;character;circuitry;client;comparison;configuration;connection;decision;fastener;indicate;individual;initiate;interval;live;magnet;manipulate;minimum;preview;produce;ratio;request;retract;selection;serial;strap;thermal;visual;address;arrangement;assist;battery;bracket;button;card;carry;cell;characteristic;circular;command;communicate;communication;communications;compensation;convert;database;direct;door;embed;enable;enclose;enclosure;engine;entry;evaluate;exterior;facial;feed;flash;gain;gaming;gesture;handle;host;identification;identifier;initialization;inside;install;installation;internet;item;left;load;locate;management;media;message;modulate;multiple;occur;opening;packet;participant;permit;person;piece;plug;port;priority;probe;product;protocol;readable;readout;realtime;receptacle;recognition;recognize;recorder;region;register;removable;require;reset;roller;rule;separate;server;service;share;slot;software;station;subsequent;subsystem;surveillance;synchronize;text;transition;translation;tube;virtual;voice;wave;wireless;write;accommodate;adjustable;attachment;auto;become;casing;chassis;clamp;clock;cluster;consist;conversion;corner;crystal;degree;detachably;diaphragm;driver;elongate;emission;enhance;equip;exit;eyepiece;fitting;flexible;foot;grip;hand;head;hinge;hook;horizontal;instruct;intermediate;latch;liquid;loop;marker;middle;modular;notification;orient;planar;potential;print;rail;rearview;rearward;receiver;registration;rotatably;rotational;series;shoot;slid;socket;stand;strobe;symbol;upper;wearable;adaptor;antenna;articulate;blade;bobbin;capacitor;carrier;chamber;cleaning;clip;coil;conductive;converter;cross;curve;dark;decode;dimension;document;emit;encoder;endoscope;expose;finger;held;indication;insulate;lamp;manner;mate;mold;operative;orthogonal;package;park;passage;patient;scanner;seal;solder;stage;trace;tripod;type;accumulate;accumulation;amplifier;amplify;analog;assign;automatic;candidate;column;conductivity;destination;diffusion;electrode;evaluation;extract;float;flow;integration;intersect;matrix;maximum;node;photo;photodetector;photosensor;reach;repeat;scan;score;sensitivity;sequence;shot;transformation;transistor;turn;viewpoint;drain;impurity;synthesize;alignment;autofocus;average;balance;band;calculation;composition;correspondence;equipment;friction;luminance;machine;magnification;noise;omega;quality;radius;reduction;representative;reverse;separation;similarity;stereoscopic;tone;variable;algorithm;delay;differential;discrete;execution;extraction;gamma;illuminator;intensity;intersection;observation;partial;projector;proximate;rotary;rotor;selector;splitter;technique;vision;volume;action;activity;actuate;complete;conditional;counter;criterion;edit;encode;estimation;feedback;game;hardware;human;interest;iris;manual;neighboring;partition;player;polarize;representation;selectable;site;stitch;straight;version;ambient;auxiliary;brake;emitter;gear;icon;lead;master;mechanical;moveable;opaque;peak;radio;remain;reproduction;slave;spatial;speaker;spot;stabilization;subset;actuation;conductor;diode;photosensitive;sharpness;signature;temperature;transmitter;collect;context;maintain;presence;transform;linkage;permanent;pole;sequential;annular;circle;finder;fixture;join;laser;observe;offset;optics;positional;relation;robot;rolling;stationary;table;yoke;buffer;carriage;comparator;decide;denote;distribution;expression;format;gaze;generator;gimbal;gradient;joint;landmark;overlay;pane;refract;retractable;split;stereo;suspension;template;terahertz;addition;apart;freedom;mask;pupil;rectangular;reflective;shoulder;square;standard;cement;microlens;cycle;interpolation;perimeter;spectral;designate;parallax;successive;television;cure;perspective;chain;defect;disparity;dome;equation;foreground;interpolate;panoramic;tooth;deviation;graphic;pose;principal;superimpose;trailer;grid;road;judgment;alert;traffic;classify;warp;printer;half;lane;patch;dental;container;thumbnail;sign
accessory;12,0;;2,0;;;16,0;1,0;31,0;11,0;6,0;5,0;;;;3,0;21,0;;;;;;3,0;;3,0;;;;2,0;2,0;;;;68,0;;73,0;4,0;30,0;1,0;;;57,0;;13,0;2,0;18,0;6,0;7,0;78,0;;13,0;105,0;1,0;;;4,0;;19,0;;;;3,0;9,0;1,0;;2,0;1,0;;12,0;2,0;18,0;3,0;;2,0;;;2,0;7,0;;;60,0;2,0;3,0;;126,0;;11,0;45,0;;19,0;19,0;128,0;;;1,0;;3,0;11,0;;20,0;;;;1,0;;;1,0;11,0;28,0;37,0;1,0;2,0;3,0;;;1,0;31,0;60,0;32,0;55,0;41,0;3,0;;5,0;12,0;3,0;;;;;7,0;6,0;4,0;13,0;;1,0;;1,0;;;;;;12,0;45,0;1,0;;;55,0;82,0;;1,0;1,0;15,0;13,0;;34,0;113,0;;;5,0;2,0;23,0;47,0;;2,0;1,0;13,0;12,0;;;2,0;1,0;3,0;4,0;;1,0;44,0;3,0;;;1,0;290,0;;;3,0;3,0;;6,0;;;;;;45,0;;204,0;;;;15,0;19,0;1,0;;69,0;;6,0;2,0;;;18,0;;;2,0;;;;3,0;;;8,0;28,0;;8,0;26,0;;35,0;1,0;3,0;14,0;;42,0;;29,0;583,0;4,0;2,0;2,0;11,0;4,0;4,0;7,0;11,0;8,0;;24,0;;;;;2,0;11,0;;;;;;54,0;2,0;5,0;;;;4,0;9,0;;2,0;5,0;;;;2,0;15,0;;;;2,0;9,0;47,0;;47,0;15,0;4,0;77,0;;;8,0;;;;2,0;26,0;6,0;;;;;;31,0;4,0;;;17,0;53,0;13,0;4,0;;;6,0;4,0;;;9,0;;36,0;1,0;2,0;1,0;29,0;;48,0;;7,0;;3,0;3,0;16,0;48,0;;;1,0;;1,0;;;1,0;;10,0;;5,0;26,0;;1,0;103,0;3,0;;;28,0;;2,0;;2,0;2,0;;2,0;;4,0;;175,0;14,0;;1,0;3,0;;;;;;8,0;2,0;;;6,0;4,0;;48,0;;12,0;1,0;11,0;13,0;1,0;1,0;;1,0;;3,0;;;;3,0;1,0;;;1,0;5,0;2,0;6,0;3,0;1,0;;;;;;;;;7,0;2,0;;3,0;1,0;;;;;;;1,0;;;;1,0;;7,0;;;;;4,0;;24,0;15,0;2,0;;;;;10,0;;1,0;;;;;23,0;18,0;;6,0;2,0;4,0;;;;;8,0;;;;;;;;;;;11,0;;;;;;1,0;;;;;;3,0;;1,0;2,0;;9,0;;;;;;;;;;1,0;;3,0;12,0;;6,0;;6,0;;;2,0;;;;;;;;;;;;;;;38,0;;;2,0;2,0;;;;;;;2,0;;;2,0;10,0;;6,0;15,0;5,0;;;;;1,0;;2,0;;;10,0;;;;2,0;;;;;;8,0;2,0;5,0;;;1,0;;4,0;42,0;19,0;23,0;;;;;5,0;2,0;;4,0;;;;;;;;;;;;;;2,0;20,0;;;3,0;1,0;;;1,0;8,0;1,0;20,0;;11,0;;;;;1,0;;;;;;;1,0;;;;;;;;2,0;1,0;;;;3,0;2,0;1,0;;;;2,0;;7,0;6,0;1,0;1,0;;;;;;;1,0;;;;;;3,0;;2,0;2,0;43,0;1,0;6,0;2,0;1,0;27,0;7,0;5,0;2,0;3,0;1,0;1,0;34,0;45,0;6,0;8,0;5,0;4,0;1,0;17,0;2,0;3,0;5,0;1,0;1,0;2,0;2,0;7,0;1,0;1,0;3,0;5,0;74,0;5,0;1,0;1,0;1,0;3,0;1,0;9,0;4,0;3,0;6,0;1,0;1,0;33,0;1,0;9,0;3,0;6,0;2,0;1,0;1,0;1,0;3,0;1,0;4,0;2,0;2,0;45,0;;;;;;;;;;;;;;;;;;;;;;;;;;;;;;;;;;;;;;;;;;;;;;;;;;;;;;;;;;;;;;;;;;;;;;;;;;;;;;;;;;;;;;;;;;;;;;;;;;;;;;;;;;;;;;;;;;;;;;;;;;;;;;;;;;;;;;;;;;;;;;;;;;;;;;;;;;;;;;;;;;;;;;;;;;;;;;;;;;;;;;;;;;;;;;;;;;;;;;;;;;;;;;;;;;;;;;;;;;;;;;;;;;;;;;;;;;;;;;;;;;;;;;;;;;;;;;;;;;;;;;;;;;;;;;;;;;;;;;;;;;;;;
achieve;1,0;2,0;;;;4,0;2,0;;;;1,0;;;;12,0;5,0;;;7,0;;11,0;2,0;2,0;1,0;;;9,0;1,0;1,0;;4,0;65,0;1,0;1,0;1,0;1,0;3,0;3,0;1,0;;6,0;;3,0;;2,0;;9,0;15,0;4,0;1,0;;1,0;;1,0;2,0;;4,0;1,0;1,0;;;;;;6,0;;14,0;1,0;;1,0;8,0;2,0;1,0;;6,0;;1,0;2,0;5,0;62,0;;2,0;1,0;10,0;58,0;3,0;;;;;51,0;;;;;;;;23,0;;8,0;1,0;9,0;6,0;1,0;;15,0;16,0;2,0;1,0;2,0;2,0;;;1,0;;10,0;24,0;3,0;13,0;;;1,0;2,0;;;;10,0;2,0;3,0;;5,0;17,0;1,0;;4,0;;;;58,0;1,0;;;14,0;1,0;;;10,0;10,0;3,0;9,0;1,0;5,0;4,0;16,0;;12,0;;3,0;2,0;;;40,0;;35,0;6,0;6,0;3,0;1,0;1,0;11,0;;;;;;1,0;1,0;;;1,0;7,0;;;;1,0;;3,0;7,0;;;2,0;;;1,0;3,0;;;;;;;2,0;12,0;2,0;;;3,0;17,0;1,0;;;3,0;;;;;;2,0;;2,0;;;;1,0;;;2,0;17,0;2,0;;;;2,0;1,0;9,0;4,0;4,0;2,0;2,0;;;;1,0;;;;;7,0;;;;;;;;12,0;3,0;1,0;;;;;8,0;;;2,0;1,0;13,0;;;2,0;1,0;;1,0;;;;;;;;;;;32,0;;;;;;;;;;1,0;;;;;;;;;;2,0;;;;1,0;;;;;2,0;;;;;;;;;;1,0;;1,0;;2,0;;;;;;;4,0;2,0;;;;;;;;;;8,0;;;6,0;;;;5,0;;;;2,0;1,0;;1,0;;;;;;;;;1,0;;;;;;;;;8,0;5,0;2,0;;;;1,0;;;;;;;11,0;;;;;;;2,0;;;;5,0;;;;;;;2,0;62,0;7,0;;;;;;;1,0;;;4,0;1,0;1,0;;;;;;;;3,0;13,0;1,0;2,0;;1,0;3,0;3,0;4,0;1,0;2,0;2,0;;;;4,0;1,0;6,0;;;;;;;1,0;4,0;;;;;1,0;;11,0;;;;;;;;;;;2,0;2,0;;;1,0;;4,0;;;;4,0;;;;;1,0;;;;4,0;;;;;;;1,0;;;2,0;;;;;1,0;;1,0;;6,0;;;;;;;;;;;1,0;;;1,0;;;;;;1,0;;;;1,0;;;;;;3,0;;;;1,0;;;;;;;;;;1,0;;;;;;1,0;;;;;1,0;;2,0;;;;;;;;;;;;;;;4,0;1,0;;;;;;2,0;;;;1,0;;;1,0;1,0;3,0;;;;;2,0;;;;;;;1,0;;;;;;;;;;;;;;;;;;1,0;;;;7,0;;;;1,0;;;;;;;;2,0;;;;;;;;;;;;;;1,0;;;;4,0;;;2,0;;;;;;;;;;;;;;2,0;2,0;;;;;;;;;;;;;;;;;;;;;;;;;;;;;;;;;;;;1,0;;;;;;;;;;;2,0;;;;;11,0;;5,0;;;;;;;;;;;;;;;;;;;;;;;;;;;;;;;;;;;;;1,0;;;;;;2,0;8,0;;;1,0;;6,0;6,0;;5,0;1,0;;8,0;;;;;;;11,0;2,0;2,0;2,0;2,0;5,0;1,0;2,0;1,0;1,0;1,0;2,0;99,0;5,0;6,0;2,0;2,0;3,0;1,0;1,0;2,0;2,0;1,0;1,0;38,0;;;;;;;;;;;;;;;;;;;;;;;;;;;;;;;;;;;;;;;;;;;;;;;;;;;;;;;;;;;;;;;;;;;;;;;;;;;;;;;;;;;;;;;;;;;;;;;;;;;;;;;;;;;;;;;;;;;;;;;;;;;;;;;;;;;;;;;;;;;;;;;;;;;;;;;;;;;;;;;;;;;;;;;;;;;;;;;;;
activation;2,0;;;;2,0;;1,0;4,0;6,0;2,0;;;17,0;;1,0;2,0;15,0;1,0;;;;12,0;;;;;;2,0;;;;;16,0;;51,0;21,0;;;;;9,0;;11,0;;25,0;;11,0;75,0;9,0;36,0;8,0;;;;8,0;21,0;117,0;8,0;;;2,0;1,0;;3,0;;;;2,0;7,0;;2,0;;1,0;;;;;4,0;3,0;37,0;;;;5,0;4,0;3,0;18,0;;;;18,0;;;;;;5,0;;17,0;2,0;;;5,0;5,0;;3,0;2,0;;;1,0;;9,0;;;;9,0;2,0;18,0;4,0;2,0;;;5,0;20,0;1,0;;;;;;;;;;;;1,0;43,0;;;2,0;8,0;17,0;23,0;2,0;;;1,0;85,0;;;;2,0;1,0;;1,0;34,0;;;;;9,0;33,0;;;;3,0;4,0;;;2,0;;;;1,0;;5,0;;;;;3,0;;;;;;2,0;;;;;;;;3,0;;;;;;;;2,0;;;4,0;1,0;4,0;;;;;;;;;;;;1,0;;;;;;5,0;;15,0;;6,0;;1,0;1,0;;;2,0;2,0;1,0;;;;;;;;;;6,0;1,0;1,0;5,0;1,0;;;1,0;25,0;;;;;;;1,0;1,0;;;;24,0;;;11,0;;;;;4,0;;;;13,0;1,0;;;;14,0;;;;;12,0;;;;;;;;;;10,0;;;;;;;;;;;1,0;2,0;;5,0;;;;;9,0;2,0;;;;1,0;;2,0;;;;;;;;;2,0;;;;16,0;;;;1,0;;;1,0;9,0;;2,0;;;;4,0;;;4,0;1,0;;;;1,0;2,0;;;;;2,0;;;;5,0;;;;;;;;;;;;;;;;;;;;2,0;;;;;;;;;;;;6,0;;;;;;;2,0;5,0;;;1,0;;;2,0;;;;;;2,0;2,0;;2,0;;;6,0;;26,0;2,0;;1,0;;;;5,0;;3,0;;2,0;;;13,0;16,0;;1,0;8,0;1,0;;;2,0;;7,0;8,0;;;;;;;;;;;;3,0;;;;15,0;;48,0;1,0;;;3,0;;;;;8,0;;;;;;;;;;;;;;6,0;31,0;;6,0;;;;;;16,0;;;;;6,0;;;;1,0;;;;;2,0;31,0;;;;;;;;2,0;;1,0;;3,0;;;;6,0;1,0;;;;;;;;;7,0;;9,0;;;;2,0;;1,0;;;;6,0;;;;;;5,0;;15,0;;;1,0;;1,0;1,0;;3,0;;;;;;;;;14,0;;;;;;1,0;;;;;;;;;;1,0;;;2,0;;;8,0;;;;;;2,0;;;;;;;;;;;1,0;1,0;;12,0;;;;;;;;;;;;;3,0;;;;;;;;;;2,0;;;;;;3,0;;;;;;;3,0;;;;;;;;;;;;;;;;;;1,0;;;;;;;4,0;;;;;;;;;;;;;;;1,0;7,0;;;;;;;4,0;;;1,0;;;;;;;;;;;;;;;;;;;;1,0;5,0;;;;;;3,0;;;;;;1,0;;;;;;;;;;;;;;;;;;;2,0;;;;;;;2,0;;;;;;;;;;;;;11,0;;;;1,0;;;;;;;;;;1,0;;;;;;;;;;;;;;;;;1,0;3,0;;;;;1,0;;;;;;;;;4,0;;;2,0;1,0;;;;;;;;;;3,0;3,0;3,0;;;;;;;;;;;;;;;1,0;;;;;;;;;1,0;;2,0;3,0;1,0;;;;1,0;;;;3,0;;2,0;4,0;;;;1,0;;4,0;2,0;1,0;1,0;2,0;6,0;1,0;1,0;;;;;;;;;;;;;;;;;;;;;;;;;;;;;;;;;;;;;;;;;;;;;;;;;;;;;;;;;;;;;;;;;;;;;;;;;;;;;;;;;;;;;;;;;;;;;;;;;;;;
analyze;1,0;;;2,0;;;;7,0;25,0;7,0;3,0;;13,0;;;53,0;1,0;6,0;2,0;1,0;;79,0;;;;4,0;22,0;3,0;;;18,0;4,0;31,0;;26,0;15,0;8,0;;3,0;;120,0;1,0;4,0;5,0;50,0;7,0;95,0;44,0;45,0;1,0;;35,0;;3,0;2,0;10,0;3,0;;3,0;3,0;;1,0;3,0;2,0;9,0;5,0;;5,0;42,0;3,0;4,0;1,0;23,0;;;7,0;28,0;3,0;5,0;509,0;6,0;11,0;1,0;71,0;2,0;18,0;;11,0;;;2,0;;;;;11,0;3,0;4,0;121,0;2,0;3,0;2,0;32,0;113,0;;6,0;8,0;1,0;22,0;11,0;1,0;11,0;;;;36,0;37,0;10,0;2,0;3,0;;;6,0;24,0;46,0;5,0;3,0;;7,0;1,0;2,0;36,0;3,0;;4,0;7,0;6,0;9,0;2,0;;47,0;4,0;;24,0;9,0;;;;23,0;3,0;5,0;;2,0;7,0;15,0;;41,0;;;;3,0;1,0;61,0;;;;69,0;19,0;;2,0;;;;1,0;1,0;4,0;1,0;1,0;;1,0;3,0;1,0;;;2,0;1,0;;12,0;;2,0;;;;3,0;;;22,0;;;;;2,0;9,0;4,0;;;;1,0;1,0;12,0;;;;;;;;;;;5,0;4,0;;;;;;;21,0;;;;;;;;1,0;;;;;;1,0;1,0;1,0;;;4,0;27,0;;2,0;;;;;;16,0;;;;;;;;;7,0;1,0;;2,0;;;4,0;2,0;;1,0;;2,0;1,0;;6,0;;;1,0;;;13,0;;1,0;;;20,0;;;;;;;;;;1,0;1,0;;;;;;1,0;;;;;1,0;;;;;;;6,0;;;;;2,0;;;;;;;;;;;2,0;;1,0;;;;;;5,0;3,0;;1,0;;;3,0;13,0;3,0;1,0;;;;1,0;23,0;;;;6,0;;;;;;;;4,0;12,0;;;;;;;;;;;;14,0;;;;;;;;;13,0;;2,0;;;;;;;;3,0;;3,0;1,0;;;;2,0;10,0;13,0;3,0;2,0;2,0;8,0;;;;4,0;;;;2,0;3,0;1,0;;;16,0;3,0;1,0;;19,0;7,0;;16,0;;12,0;2,0;2,0;;2,0;24,0;6,0;1,0;14,0;2,0;6,0;;5,0;;;;;;2,0;15,0;;;;;1,0;;;1,0;;;;;4,0;12,0;;;3,0;;66,0;;2,0;1,0;;;2,0;;24,0;3,0;6,0;2,0;;2,0;;2,0;;1,0;9,0;8,0;;;;5,0;1,0;;;;;2,0;;4,0;3,0;;;6,0;;2,0;;;24,0;5,0;;;;9,0;1,0;;;;;12,0;4,0;;3,0;16,0;;;;;2,0;;1,0;9,0;;4,0;6,0;;;1,0;;1,0;;5,0;;2,0;1,0;;1,0;11,0;;;;;;;;;;9,0;;4,0;;3,0;1,0;;;1,0;5,0;;;;;;3,0;;3,0;;4,0;7,0;13,0;;28,0;18,0;;;7,0;3,0;;;;;;5,0;3,0;;6,0;;9,0;11,0;;1,0;;;2,0;2,0;;5,0;;;;;;1,0;;;;3,0;;11,0;5,0;;27,0;;;;;;2,0;;4,0;2,0;;;3,0;;;;1,0;1,0;8,0;;;;4,0;;1,0;;;2,0;;;;;;;;;;;;12,0;3,0;5,0;;;3,0;;1,0;;;;;;;;;;;;;;;;;;;1,0;;;1,0;;;12,0;;;;;;5,0;;;2,0;;;;;;;3,0;;;;;;;;;;;;;;;;;5,0;;;2,0;;;;7,0;;;3,0;;;1,0;;;;;;1,0;;6,0;;;;2,0;;;;;;;;;;1,0;1,0;;;1,0;;;22,0;3,0;;;;;;;1,0;16,0;;;;2,0;;;6,0;34,0;7,0;1,0;;;;;;1,0;;2,0;2,0;;;;5,0;;;;3,0;1,0;;;;6,0;;;;;;;;;;1,0;;;;;;2,0;;1,0;;;;1,0;;;;;;3,0;;;4,0;61,0;;;;;;;;;;3,0;;4,0;21,0;3,0;;1,0;;3,0;;8,0;;;1,0;;3,0;1,0;;;;;;;;;;;1,0;;;;;1,0;;;;6,0;;;;;7,0;3,0;;;;7,0;;2,0;;;;;;;;;;;;1,0;1,0;;;;;;;;;;;1,0;;;1,0;;;;1,0;;;;;;;;;;4,0;;;;2,0;;;;2,0;2,0;;;;1,0;;;;;;2,0;;;2,0;1,0;;;;;2,0;;;;;;;;;8,0;;;;;;;1,0;2,0;2,0;;;;;;;;;
angle;2,0;16,0;4,0;;;;13,0;69,0;133,0;28,0;18,0;;15,0;;268,0;230,0;30,0;3,0;;5,0;53,0;74,0;53,0;6,0;4,0;;7,0;5,0;11,0;10,0;12,0;24,0;90,0;6,0;102,0;30,0;5,0;17,0;3,0;2,0;27,0;6,0;118,0;22,0;156,0;36,0;189,0;192,0;20,0;75,0;32,0;168,0;11,0;14,0;13,0;24,0;31,0;8,0;68,0;;39,0;;154,0;;15,0;59,0;27,0;167,0;19,0;31,0;23,0;4,0;36,0;2,0;5,0;42,0;48,0;21,0;11,0;547,0;7,0;102,0;2,0;138,0;17,0;11,0;3,0;;;40,0;367,0;;;1,0;17,0;9,0;7,0;;210,0;23,0;3,0;;117,0;139,0;2,0;38,0;216,0;2,0;28,0;40,0;14,0;21,0;4,0;;1,0;113,0;98,0;267,0;;101,0;7,0;28,0;37,0;46,0;45,0;12,0;;1,0;2,0;89,0;;86,0;195,0;;51,0;3,0;27,0;23,0;22,0;16,0;24,0;;4,0;102,0;39,0;9,0;;79,0;62,0;33,0;12,0;;11,0;19,0;19,0;;134,0;65,0;381,0;;11,0;6,0;194,0;8,0;7,0;2,0;35,0;736,0;3,0;5,0;147,0;9,0;1,0;19,0;10,0;14,0;40,0;19,0;1,0;;6,0;25,0;;;;9,0;;19,0;;;;;2,0;51,0;;67,0;;2,0;;16,0;2,0;6,0;22,0;215,0;21,0;6,0;2,0;6,0;5,0;61,0;4,0;6,0;4,0;2,0;;4,0;12,0;;29,0;19,0;39,0;62,0;10,0;;;60,0;;2,0;140,0;;61,0;;44,0;83,0;21,0;21,0;27,0;23,0;4,0;18,0;18,0;9,0;1,0;42,0;12,0;;;2,0;23,0;99,0;15,0;7,0;1,0;2,0;5,0;;45,0;24,0;1,0;1,0;;;14,0;63,0;2,0;;34,0;;2,0;;3,0;33,0;22,0;;;13,0;;11,0;6,0;176,0;9,0;;6,0;5,0;;27,0;8,0;10,0;;1,0;146,0;74,0;9,0;;20,0;1,0;6,0;12,0;3,0;;21,0;9,0;11,0;8,0;;7,0;11,0;7,0;7,0;3,0;;4,0;2,0;11,0;8,0;7,0;9,0;21,0;5,0;17,0;4,0;;6,0;7,0;30,0;;3,0;1,0;;11,0;;17,0;7,0;2,0;3,0;;7,0;21,0;2,0;6,0;;52,0;8,0;16,0;338,0;2,0;4,0;53,0;17,0;17,0;;15,0;;4,0;2,0;29,0;10,0;165,0;8,0;1,0;2,0;4,0;1,0;;5,0;;;1,0;1,0;1,0;5,0;;;1,0;;1,0;5,0;13,0;178,0;290,0;2,0;2,0;7,0;24,0;1,0;8,0;6,0;11,0;;27,0;1,0;70,0;1,0;5,0;1,0;;13,0;10,0;7,0;5,0;16,0;2,0;;3,0;1,0;1,0;4,0;27,0;13,0;168,0;107,0;2,0;21,0;;83,0;1,0;;1,0;;;2,0;27,0;44,0;7,0;;1,0;13,0;12,0;;4,0;;29,0;13,0;6,0;49,0;20,0;3,0;89,0;18,0;;17,0;17,0;26,0;;2,0;6,0;13,0;4,0;54,0;;5,0;146,0;7,0;25,0;16,0;25,0;;3,0;173,0;25,0;29,0;;;6,0;1,0;;2,0;115,0;34,0;3,0;;3,0;;3,0;24,0;4,0;43,0;5,0;11,0;;168,0;11,0;4,0;83,0;72,0;;3,0;3,0;9,0;21,0;;6,0;5,0;6,0;10,0;6,0;4,0;9,0;7,0;1,0;82,0;;2,0;63,0;2,0;6,0;21,0;2,0;1,0;;7,0;4,0;33,0;;1,0;;26,0;;4,0;;13,0;;4,0;41,0;2,0;20,0;4,0;14,0;3,0;;1,0;1,0;3,0;5,0;;10,0;19,0;21,0;;2,0;1,0;8,0;2,0;7,0;;14,0;17,0;1,0;;3,0;;;10,0;3,0;1,0;6,0;;;9,0;6,0;;1,0;4,0;3,0;2,0;4,0;;12,0;;1,0;10,0;;8,0;2,0;;2,0;6,0;1,0;;;6,0;2,0;;;24,0;;;;14,0;;5,0;;;5,0;;8,0;;;52,0;1,0;23,0;;;;5,0;5,0;1,0;4,0;;;1,0;1,0;1,0;;11,0;;;2,0;;5,0;;6,0;2,0;;5,0;;17,0;1,0;;;;;1,0;10,0;1,0;1,0;2,0;2,0;1,0;;;1,0;4,0;;1,0;;;;22,0;;3,0;;;1,0;39,0;2,0;;2,0;;;3,0;;1,0;10,0;2,0;5,0;;568,0;;;2,0;1,0;;1,0;;4,0;;8,0;;8,0;;5,0;49,0;23,0;;112,0;;2,0;6,0;;;9,0;1,0;;;35,0;6,0;;1,0;2,0;;22,0;1,0;;4,0;64,0;;54,0;;;2,0;;;19,0;1,0;1,0;2,0;;;;;;;;6,0;3,0;;;19,0;13,0;3,0;3,0;5,0;16,0;3,0;9,0;13,0;;;1,0;5,0;;2,0;;3,0;;;9,0;;16,0;;;;1,0;;2,0;6,0;1,0;5,0;3,0;7,0;;;;3,0;4,0;1,0;13,0;;;;2,0;11,0;9,0;;;;13,0;;123,0;3,0;2,0;;;11,0;4,0;17,0;10,0;;4,0;6,0;7,0;;18,0;2,0;;;2,0;18,0;;9,0;1,0;;25,0;1,0;7,0;;4,0;;1,0;21,0;;250,0;23,0;4,0;;1,0;2,0;2,0;;5,0;;17,0;3,0;2,0;;;;2,0;9,0;;2,0;9,0;4,0;;;1,0;5,0;;;4,0;6,0;2,0;4,0;2,0;;1,0;;;;24,0;;;1,0;3,0;;2,0;4,0;7,0;8,0;1,0;;;3,0;20,0;;2,0;29,0;;25,0;;3,0;5,0;5,0;1,0;;;;;2,0;;;16,0;;5,0;;;8,0;;;1,0;3,0;;;2,0;2,0;;;;5,0;16,0;;18,0;;;1,0;;3,0;1,0;2,0;1,0;2,0;1,0;2,0;11,0;3,0;16,0;;;5,0;2,0;6,0;;3,0;;1,0;;;25,0;7,0;32,0;;;5,0;4,0;;4,0;;12,0;;3,0;22,0;3,0;;18,0;;;;;1,0;;4,0;;1,0;12,0;;15,0;1,0;;1,0;;;1,0;;17,0;2,0;;;;6,0;;;;3,0;5,0;;;15,0;1,0;15,0;;9,0;27,0;1,0;5,0;1,0;;;3,0;;1,0;1,0;2,0;226,0;1,0;;;;;
aperture;2,0;1,0;2,0;1,0;;13,0;;25,0;22,0;120,0;39,0;4,0;2,0;;72,0;82,0;11,0;11,0;8,0;;6,0;84,0;36,0;11,0;2,0;1,0;21,0;;2,0;4,0;1,0;19,0;78,0;1,0;85,0;70,0;3,0;2,0;2,0;;15,0;;133,0;6,0;25,0;2,0;43,0;93,0;16,0;24,0;74,0;15,0;1,0;10,0;31,0;19,0;35,0;3,0;;;50,0;5,0;17,0;;53,0;77,0;30,0;64,0;9,0;52,0;6,0;3,0;12,0;;;122,0;;16,0;29,0;227,0;;107,0;;151,0;8,0;7,0;31,0;;1,0;48,0;645,0;;;6,0;2,0;;16,0;;79,0;2,0;1,0;4,0;79,0;90,0;2,0;25,0;204,0;9,0;22,0;19,0;55,0;13,0;9,0;;7,0;100,0;149,0;88,0;28,0;46,0;;;;9,0;4,0;11,0;;3,0;10,0;47,0;;40,0;118,0;1,0;1,0;;15,0;13,0;;2,0;15,0;2,0;;70,0;31,0;2,0;1,0;135,0;21,0;37,0;2,0;5,0;12,0;24,0;11,0;;127,0;2,0;7,0;1,0;;18,0;393,0;2,0;20,0;;5,0;64,0;1,0;1,0;45,0;9,0;;64,0;40,0;5,0;53,0;30,0;2,0;;8,0;40,0;5,0;12,0;;13,0;6,0;15,0;1,0;2,0;;;4,0;19,0;;14,0;;;;58,0;24,0;2,0;3,0;40,0;;10,0;2,0;;110,0;39,0;18,0;1,0;;;13,0;2,0;7,0;;5,0;16,0;50,0;5,0;10,0;1,0;;6,0;31,0;3,0;183,0;3,0;103,0;5,0;25,0;105,0;4,0;94,0;11,0;56,0;16,0;3,0;38,0;7,0;21,0;56,0;;;;;3,0;23,0;84,0;1,0;1,0;;;;90,0;12,0;3,0;10,0;;;27,0;13,0;;;19,0;5,0;98,0;;16,0;18,0;8,0;3,0;;;31,0;57,0;15,0;92,0;18,0;;3,0;4,0;;101,0;;1,0;5,0;18,0;21,0;6,0;;;26,0;;;32,0;2,0;5,0;4,0;13,0;13,0;8,0;;8,0;15,0;9,0;28,0;;;3,0;1,0;;27,0;;;9,0;2,0;20,0;;;28,0;3,0;31,0;6,0;25,0;2,0;;13,0;4,0;2,0;2,0;2,0;1,0;;6,0;14,0;3,0;5,0;6,0;8,0;9,0;3,0;21,0;;17,0;7,0;11,0;5,0;5,0;4,0;;2,0;2,0;3,0;;11,0;8,0;4,0;1,0;2,0;5,0;4,0;13,0;2,0;;10,0;15,0;5,0;1,0;3,0;8,0;;13,0;;4,0;1,0;11,0;10,0;1,0;;5,0;13,0;;6,0;21,0;18,0;;23,0;23,0;19,0;1,0;2,0;59,0;2,0;;6,0;26,0;;;;;9,0;;;;;12,0;10,0;38,0;38,0;1,0;;18,0;3,0;3,0;;11,0;;;4,0;30,0;5,0;1,0;;;7,0;;;;1,0;7,0;7,0;11,0;;1,0;2,0;38,0;;8,0;2,0;11,0;;;19,0;116,0;;2,0;10,0;23,0;;;14,0;;2,0;;;;;3,0;;;70,0;;;1,0;;2,0;2,0;;1,0;1,0;;9,0;;;;;;57,0;71,0;;26,0;;;;2,0;1,0;4,0;;1,0;;2,0;3,0;2,0;3,0;2,0;5,0;;10,0;;;19,0;;;2,0;;3,0;;;;2,0;;;;;;;;6,0;2,0;22,0;25,0;;;;;;;;;3,0;1,0;;18,0;11,0;1,0;;21,0;;1,0;;15,0;;9,0;1,0;1,0;;5,0;;13,0;;1,0;;9,0;;;2,0;10,0;;6,0;2,0;8,0;11,0;;8,0;4,0;;;2,0;;6,0;;1,0;2,0;3,0;11,0;;;;3,0;;;20,0;9,0;;;;1,0;;;5,0;;;;;;10,0;;23,0;;;2,0;;6,0;2,0;4,0;;;11,0;;;;4,0;9,0;2,0;1,0;;;;;;15,0;15,0;;7,0;1,0;1,0;1,0;;;;11,0;;;;4,0;;;7,0;;2,0;4,0;;;;1,0;;;;;;;13,0;23,0;1,0;7,0;3,0;;5,0;;;17,0;;1,0;1,0;2,0;;487,0;;4,0;3,0;;3,0;10,0;;;2,0;;8,0;2,0;9,0;;;3,0;;6,0;;6,0;;1,0;3,0;;;2,0;8,0;;5,0;2,0;;;6,0;;;;4,0;1,0;24,0;1,0;;;;1,0;;2,0;;;66,0;;;3,0;4,0;;2,0;1,0;3,0;;;;13,0;;4,0;;3,0;;4,0;5,0;;;;;;;3,0;2,0;;;;;4,0;;;1,0;;;;1,0;4,0;2,0;2,0;;;;4,0;1,0;;;;;;1,0;1,0;3,0;;3,0;;4,0;;18,0;;;;4,0;;;4,0;;17,0;;;;;;1,0;;;;14,0;6,0;;2,0;10,0;;;2,0;;1,0;;;1,0;1,0;;;;;;;;;;;18,0;;;2,0;;;;1,0;2,0;3,0;;;1,0;;5,0;10,0;;;1,0;;1,0;;;;;4,0;;;;;;;;;2,0;;1,0;5,0;;;;;;1,0;1,0;;;;;;3,0;;1,0;;;;;4,0;3,0;15,0;;;4,0;;;3,0;;3,0;;14,0;1,0;;1,0;;;;;3,0;3,0;;;;;;;;;3,0;6,0;;;;;;11,0;1,0;;5,0;;;10,0;2,0;1,0;;;;;;;1,0;;3,0;7,0;;;2,0;;;;;;2,0;;;;;1,0;4,0;;28,0;6,0;7,0;2,0;2,0;;;1,0;17,0;;1,0;1,0;5,0;4,0;;;;;;;;;;;;;;;3,0;;1,0;;;;;;;;;;;;;;;1,0;;;
apparatus;8,0;31,0;;4,0;7,0;69,0;25,0;;118,0;51,0;38,0;7,0;65,0;7,0;102,0;201,0;17,0;22,0;4,0;47,0;102,0;323,0;19,0;7,0;2,0;17,0;109,0;14,0;8,0;4,0;62,0;18,0;564,0;5,0;809,0;176,0;46,0;197,0;6,0;2,0;338,0;5,0;22,0;57,0;195,0;136,0;197,0;442,0;150,0;589,0;80,0;152,0;15,0;9,0;153,0;78,0;147,0;13,0;54,0;11,0;19,0;163,0;37,0;12,0;82,0;21,0;189,0;107,0;167,0;47,0;62,0;25,0;154,0;13,0;1,0;49,0;51,0;21,0;116,0;2587,0;26,0;942,0;10,0;807,0;12,0;110,0;228,0;9,0;2,0;42,0;999,0;2,0;7,0;37,0;21,0;58,0;115,0;8,0;554,0;49,0;16,0;7,0;275,0;246,0;3,0;50,0;384,0;21,0;153,0;94,0;9,0;168,0;9,0;13,0;4,0;282,0;194,0;339,0;58,0;107,0;12,0;3,0;62,0;894,0;296,0;77,0;7,0;2,0;39,0;53,0;14,0;89,0;23,0;11,0;8,0;30,0;32,0;73,0;34,0;11,0;26,0;3,0;28,0;318,0;79,0;10,0;;121,0;324,0;19,0;20,0;13,0;136,0;104,0;107,0;114,0;517,0;;55,0;9,0;13,0;112,0;905,0;4,0;11,0;;343,0;97,0;20,0;21,0;179,0;5,0;8,0;28,0;65,0;33,0;51,0;53,0;6,0;7,0;36,0;168,0;4,0;5,0;26,0;154,0;8,0;80,0;9,0;4,0;24,0;7,0;12,0;190,0;5,0;17,0;29,0;5,0;18,0;43,0;7,0;5,0;29,0;155,0;4,0;15,0;6,0;6,0;88,0;67,0;54,0;4,0;7,0;2,0;10,0;4,0;25,0;2,0;2,0;45,0;142,0;2,0;8,0;6,0;2,0;3,0;40,0;10,0;466,0;32,0;218,0;20,0;67,0;275,0;26,0;33,0;77,0;20,0;16,0;10,0;12,0;53,0;6,0;37,0;30,0;9,0;21,0;4,0;191,0;31,0;79,0;1,0;6,0;3,0;2,0;6,0;168,0;21,0;14,0;2,0;3,0;5,0;12,0;94,0;37,0;62,0;70,0;14,0;56,0;5,0;18,0;128,0;49,0;3,0;14,0;9,0;37,0;59,0;54,0;172,0;46,0;10,0;31,0;5,0;11,0;194,0;5,0;30,0;11,0;35,0;90,0;14,0;17,0;1,0;35,0;4,0;22,0;2,0;34,0;1,0;34,0;26,0;78,0;3,0;11,0;8,0;12,0;42,0;19,0;5,0;140,0;48,0;42,0;;13,0;38,0;3,0;23,0;8,0;97,0;;13,0;10,0;4,0;360,0;;18,0;10,0;6,0;9,0;9,0;3,0;4,0;2,0;;48,0;9,0;46,0;36,0;46,0;;2,0;5,0;34,0;30,0;8,0;26,0;36,0;7,0;40,0;4,0;21,0;7,0;421,0;7,0;18,0;49,0;71,0;38,0;57,0;5,0;9,0;11,0;6,0;10,0;7,0;;29,0;11,0;7,0;3,0;32,0;22,0;8,0;13,0;2,0;24,0;9,0;52,0;28,0;17,0;5,0;18,0;15,0;8,0;7,0;8,0;14,0;3,0;215,0;7,0;78,0;20,0;3,0;3,0;45,0;12,0;5,0;14,0;2,0;1,0;1,0;82,0;25,0;;9,0;6,0;10,0;8,0;46,0;71,0;114,0;9,0;1,0;64,0;3,0;5,0;6,0;8,0;4,0;;7,0;82,0;33,0;3,0;9,0;6,0;51,0;8,0;2,0;5,0;163,0;46,0;9,0;80,0;2,0;32,0;56,0;131,0;;60,0;103,0;63,0;5,0;42,0;34,0;155,0;19,0;31,0;20,0;80,0;5,0;8,0;13,0;30,0;132,0;24,0;5,0;3,0;;61,0;2,0;3,0;16,0;18,0;6,0;26,0;2,0;59,0;122,0;11,0;1,0;10,0;10,0;141,0;5,0;35,0;25,0;13,0;3,0;100,0;11,0;15,0;23,0;33,0;1,0;6,0;6,0;25,0;15,0;13,0;14,0;6,0;76,0;9,0;13,0;9,0;15,0;57,0;9,0;63,0;12,0;40,0;183,0;54,0;11,0;22,0;;58,0;4,0;9,0;52,0;16,0;6,0;16,0;1,0;;2,0;4,0;2,0;67,0;19,0;9,0;35,0;7,0;4,0;36,0;4,0;24,0;29,0;62,0;16,0;15,0;12,0;6,0;6,0;33,0;5,0;6,0;10,0;5,0;45,0;4,0;11,0;5,0;23,0;9,0;19,0;;33,0;5,0;1,0;1,0;32,0;20,0;12,0;18,0;16,0;14,0;24,0;4,0;6,0;20,0;17,0;5,0;52,0;37,0;82,0;6,0;13,0;33,0;7,0;10,0;1,0;7,0;22,0;1,0;15,0;24,0;6,0;23,0;2,0;4,0;1,0;108,0;15,0;12,0;4,0;12,0;9,0;27,0;61,0;;15,0;27,0;3,0;10,0;20,0;6,0;1,0;56,0;13,0;26,0;10,0;2,0;50,0;9,0;1,0;;13,0;6,0;18,0;17,0;8,0;41,0;;;2,0;3,0;4,0;5,0;1,0;2,0;25,0;30,0;15,0;91,0;24,0;10,0;14,0;16,0;1,0;3,0;12,0;19,0;;3,0;12,0;11,0;9,0;;6,0;36,0;4,0;3,0;12,0;33,0;6,0;29,0;5,0;31,0;41,0;5,0;8,0;8,0;30,0;13,0;13,0;7,0;14,0;36,0;8,0;;1,0;61,0;5,0;30,0;36,0;20,0;136,0;25,0;11,0;26,0;12,0;14,0;1,0;;;12,0;;16,0;5,0;38,0;20,0;;12,0;13,0;5,0;9,0;34,0;2,0;12,0;;;6,0;3,0;12,0;4,0;49,0;3,0;1,0;;8,0;1,0;27,0;5,0;2,0;76,0;16,0;13,0;1,0;1,0;1,0;12,0;20,0;2,0;1,0;21,0;4,0;;2,0;12,0;3,0;13,0;17,0;34,0;17,0;4,0;3,0;11,0;5,0;23,0;27,0;34,0;107,0;19,0;2,0;5,0;9,0;5,0;4,0;2,0;4,0;5,0;3,0;18,0;2,0;1,0;4,0;6,0;;6,0;8,0;13,0;2,0;8,0;;3,0;29,0;3,0;8,0;9,0;;14,0;2,0;44,0;2,0;18,0;1,0;10,0;13,0;28,0;33,0;34,0;15,0;2,0;8,0;4,0;17,0;14,0;3,0;3,0;5,0;7,0;2,0;1,0;41,0;;2,0;10,0;2,0;1,0;46,0;23,0;6,0;1,0;;10,0;28,0;42,0;6,0;19,0;7,0;13,0;1,0;1,0;2,0;4,0;37,0;2,0;5,0;19,0;;10,0;3,0;12,0;2,0;2,0;10,0;1,0;30,0;2,0;7,0;4,0;10,0;3,0;1,0;13,0;6,0;25,0;1,0;32,0;8,0;10,0;3,0;15,0;1,0;7,0;;6,0;8,0;3,0;15,0;2,0;23,0;1,0;2,0;11,0;;3,0;1,0;14,0;12,0;36,0;2,0;20,0;1,0;6,0;14,0;31,0;16,0;2,0;7,0;7,0;2,0;15,0;1,0;2,0;1,0;7,0;1,0;15,0;20,0;15,0;3,0;2,0;6,0;5,0;1,0;3,0;;18,0;;36,0;3,0;18,0;2,0;10,0;21,0;2,0;10,0;4,0;;;13,0;;2,0;3,0;34,0;10,0;3,0;1,0;12,0;;6,0;4,0;;17,0;3,0;1,0;1,0;1,0;;1,0;10,0;;10,0;2,0;12,0;8,0;10,0;8,0;11,0;27,0;39,0;20,0;2,0;3,0;5,0;7,0;7,0;;15,0;;11,0;90,0;6,0;7,0;1,0;3,0;;5,0;;10,0;61,0;9,0;2,0;;3,0;1,0;;11,0;16,0;12,0;19,0;4,0;2,0;4,0;1,0;2,0;1,0;8,0;1,0;1,0;1,0;3,0;;12,0;2,0;1,0;;11,0;7,0;;11,0;3,0;1,0;14,0;1,0;4,0;3,0;16,0;2,0;5,0;4,0;5,0;1,0;5,0;3,0;;3,0;;;2,0;2,0;;;3,0;5,0;
area;2,0;11,0;;6,0;25,0;133,0;22,0;118,0;;94,0;31,0;;85,0;3,0;62,0;341,0;20,0;3,0;67,0;3,0;24,0;244,0;30,0;55,0;21,0;16,0;199,0;6,0;;2,0;26,0;11,0;156,0;7,0;350,0;30,0;11,0;95,0;20,0;7,0;251,0;13,0;126,0;15,0;561,0;264,0;414,0;375,0;102,0;395,0;117,0;43,0;17,0;124,0;17,0;69,0;105,0;;40,0;;33,0;14,0;255,0;2,0;58,0;26,0;322,0;206,0;125,0;55,0;40,0;12,0;91,0;4,0;29,0;9,0;140,0;65,0;88,0;2206,0;45,0;315,0;;443,0;32,0;51,0;2,0;21,0;7,0;9,0;100,0;;;13,0;20,0;25,0;61,0;2,0;230,0;8,0;36,0;16,0;55,0;411,0;4,0;14,0;154,0;10,0;77,0;22,0;50,0;79,0;41,0;21,0;4,0;437,0;273,0;254,0;7,0;232,0;;3,0;56,0;100,0;48,0;13,0;3,0;3,0;40,0;97,0;1,0;58,0;69,0;8,0;56,0;19,0;59,0;29,0;83,0;5,0;128,0;;;237,0;179,0;3,0;;137,0;99,0;127,0;37,0;6,0;51,0;66,0;134,0;20,0;181,0;1,0;15,0;62,0;28,0;31,0;353,0;12,0;16,0;;69,0;375,0;19,0;4,0;36,0;;11,0;46,0;52,0;20,0;10,0;24,0;5,0;1,0;10,0;31,0;3,0;3,0;72,0;36,0;3,0;95,0;;2,0;;3,0;4,0;44,0;2,0;201,0;18,0;35,0;;107,0;4,0;3,0;30,0;125,0;;6,0;22,0;10,0;62,0;293,0;18,0;14,0;;23,0;;;6,0;8,0;18,0;22,0;47,0;22,0;20,0;1,0;2,0;12,0;54,0;3,0;284,0;1,0;37,0;1,0;18,0;39,0;2,0;43,0;56,0;35,0;15,0;42,0;85,0;11,0;15,0;15,0;3,0;29,0;53,0;9,0;323,0;57,0;21,0;1,0;1,0;;2,0;1,0;97,0;30,0;;1,0;;1,0;4,0;179,0;29,0;5,0;90,0;5,0;10,0;21,0;4,0;53,0;38,0;1,0;;2,0;12,0;25,0;129,0;259,0;4,0;;206,0;32,0;4,0;101,0;62,0;46,0;1,0;36,0;220,0;21,0;5,0;1,0;10,0;2,0;14,0;16,0;9,0;;2,0;26,0;30,0;;1,0;;;85,0;11,0;27,0;;30,0;14,0;1,0;34,0;9,0;2,0;177,0;5,0;15,0;;;39,0;1,0;25,0;3,0;4,0;;52,0;5,0;7,0;9,0;;;;5,0;4,0;125,0;9,0;7,0;2,0;3,0;41,0;2,0;19,0;;3,0;11,0;26,0;74,0;28,0;5,0;;30,0;;;2,0;133,0;12,0;9,0;1,0;28,0;2,0;2,0;7,0;1,0;;21,0;23,0;6,0;60,0;;;2,0;23,0;4,0;9,0;5,0;14,0;24,0;8,0;2,0;21,0;;1,0;2,0;7,0;;;33,0;201,0;213,0;;2,0;4,0;9,0;;70,0;31,0;19,0;;;13,0;3,0;9,0;8,0;;;11,0;116,0;131,0;77,0;49,0;20,0;10,0;7,0;2,0;23,0;7,0;3,0;3,0;51,0;113,0;34,0;;9,0;14,0;162,0;6,0;6,0;;129,0;34,0;11,0;85,0;4,0;56,0;26,0;33,0;;128,0;138,0;80,0;4,0;36,0;26,0;38,0;5,0;8,0;2,0;47,0;11,0;;13,0;3,0;48,0;1,0;6,0;;25,0;59,0;14,0;1,0;2,0;;1,0;;;50,0;74,0;7,0;9,0;4,0;104,0;75,0;4,0;36,0;7,0;20,0;2,0;53,0;29,0;3,0;90,0;79,0;18,0;17,0;13,0;3,0;37,0;;1,0;8,0;14,0;1,0;10,0;6,0;13,0;12,0;3,0;10,0;;2,0;127,0;23,0;;6,0;1,0;36,0;;11,0;116,0;;;5,0;;;;1,0;;5,0;13,0;8,0;36,0;6,0;;2,0;10,0;51,0;8,0;;3,0;20,0;36,0;;6,0;63,0;17,0;1,0;;;4,0;;9,0;71,0;7,0;36,0;8,0;1,0;40,0;;2,0;62,0;46,0;;15,0;1,0;1,0;4,0;6,0;3,0;2,0;14,0;63,0;3,0;7,0;7,0;6,0;;2,0;15,0;3,0;12,0;;;4,0;12,0;12,0;3,0;35,0;11,0;11,0;2,0;1,0;40,0;3,0;;3,0;2,0;1,0;15,0;2,0;;39,0;6,0;2,0;1,0;12,0;28,0;1,0;93,0;3,0;7,0;1,0;4,0;20,0;12,0;6,0;3,0;;11,0;23,0;2,0;;4,0;2,0;2,0;2,0;;11,0;31,0;1,0;;68,0;34,0;;148,0;7,0;;4,0;10,0;2,0;;11,0;1,0;1,0;;1,0;2,0;1,0;3,0;3,0;160,0;1,0;21,0;;2,0;2,0;24,0;;4,0;8,0;13,0;2,0;3,0;1,0;5,0;11,0;;11,0;4,0;2,0;14,0;;76,0;53,0;10,0;43,0;;17,0;24,0;3,0;4,0;4,0;;4,0;;3,0;5,0;2,0;9,0;8,0;19,0;;;12,0;5,0;8,0;;6,0;2,0;8,0;;;;7,0;82,0;1,0;41,0;;;4,0;;4,0;;2,0;2,0;43,0;1,0;1,0;;;1,0;51,0;;1,0;;;6,0;;;;;1,0;29,0;3,0;13,0;8,0;17,0;22,0;28,0;10,0;13,0;;35,0;;1,0;49,0;15,0;4,0;9,0;20,0;12,0;12,0;;1,0;;4,0;1,0;34,0;4,0;17,0;1,0;5,0;;;14,0;4,0;9,0;5,0;2,0;;;;19,0;5,0;11,0;1,0;3,0;;14,0;34,0;44,0;116,0;12,0;;1,0;12,0;24,0;13,0;16,0;6,0;;2,0;9,0;3,0;41,0;;3,0;14,0;18,0;7,0;16,0;;3,0;1,0;4,0;;;3,0;20,0;;1,0;38,0;4,0;22,0;;;84,0;9,0;34,0;10,0;;6,0;11,0;1,0;22,0;1,0;;23,0;2,0;32,0;14,0;5,0;;3,0;;1,0;14,0;;8,0;33,0;15,0;26,0;83,0;5,0;2,0;;;4,0;;1,0;;2,0;2,0;2,0;;3,0;4,0;;3,0;54,0;10,0;2,0;;77,0;;3,0;92,0;;;14,0;7,0;25,0;12,0;22,0;4,0;3,0;1,0;5,0;;1,0;4,0;;1,0;;12,0;3,0;;1,0;3,0;8,0;;;6,0;2,0;;18,0;;;1,0;8,0;1,0;1,0;11,0;14,0;;8,0;43,0;;6,0;;12,0;4,0;34,0;;;;;4,0;5,0;4,0;5,0;3,0;2,0;15,0;8,0;3,0;12,0;9,0;;1,0;4,0;48,0;1,0;41,0;;;4,0;7,0;9,0;6,0;1,0;3,0;1,0;;7,0;;;;4,0;;;4,0;5,0;;9,0;;5,0;;;90,0;8,0;51,0;2,0;;7,0;;;10,0;1,0;;2,0;1,0;72,0;1,0;5,0;;;4,0;;1,0;2,0;;3,0;12,0;5,0;20,0;4,0;;7,0;;;16,0;;15,0;9,0;7,0;5,0;;6,0;6,0;;1,0;3,0;;;;3,0;
arrange;1,0;6,0;;2,0;7,0;28,0;120,0;51,0;94,0;;179,0;10,0;15,0;9,0;169,0;110,0;48,0;;3,0;;25,0;64,0;1,0;36,0;4,0;3,0;172,0;32,0;;2,0;4,0;6,0;185,0;;105,0;23,0;2,0;22,0;1,0;;69,0;1,0;26,0;17,0;109,0;28,0;24,0;185,0;42,0;60,0;19,0;19,0;;18,0;49,0;21,0;246,0;3,0;2,0;1,0;30,0;10,0;33,0;2,0;122,0;17,0;53,0;145,0;44,0;61,0;11,0;18,0;121,0;1,0;7,0;101,0;5,0;15,0;45,0;520,0;4,0;77,0;;212,0;1,0;4,0;14,0;;14,0;20,0;653,0;;3,0;21,0;12,0;5,0;16,0;;56,0;6,0;5,0;;135,0;247,0;18,0;5,0;296,0;70,0;69,0;9,0;31,0;66,0;38,0;;48,0;514,0;224,0;191,0;70,0;28,0;1,0;6,0;17,0;78,0;39,0;3,0;2,0;4,0;21,0;16,0;;41,0;185,0;6,0;9,0;3,0;66,0;3,0;7,0;4,0;8,0;;10,0;178,0;11,0;;;469,0;160,0;12,0;11,0;5,0;26,0;19,0;15,0;13,0;193,0;2,0;15,0;63,0;1,0;15,0;788,0;;6,0;1,0;21,0;24,0;4,0;4,0;10,0;2,0;5,0;66,0;5,0;4,0;49,0;97,0;19,0;14,0;55,0;71,0;6,0;31,0;7,0;148,0;1,0;61,0;5,0;1,0;2,0;2,0;;36,0;2,0;577,0;1,0;;21,0;45,0;17,0;;8,0;292,0;1,0;26,0;10,0;1,0;23,0;82,0;60,0;;3,0;25,0;21,0;13,0;9,0;4,0;11,0;73,0;102,0;8,0;26,0;2,0;;7,0;79,0;3,0;545,0;2,0;227,0;7,0;57,0;80,0;53,0;65,0;22,0;36,0;167,0;24,0;6,0;11,0;1,0;54,0;5,0;17,0;121,0;;777,0;51,0;64,0;18,0;11,0;;1,0;1,0;158,0;24,0;4,0;17,0;9,0;1,0;12,0;19,0;97,0;10,0;52,0;36,0;41,0;;13,0;168,0;34,0;24,0;6,0;30,0;;40,0;65,0;223,0;9,0;;16,0;14,0;5,0;22,0;18,0;3,0;;7,0;37,0;71,0;31,0;4,0;26,0;2,0;9,0;8,0;64,0;1,0;32,0;15,0;3,0;7,0;5,0;3,0;12,0;49,0;21,0;6,0;;13,0;10,0;22,0;56,0;5,0;4,0;15,0;8,0;19,0;2,0;1,0;7,0;16,0;42,0;;10,0;;2,0;9,0;2,0;6,0;4,0;;1,0;1,0;1,0;30,0;54,0;32,0;3,0;;2,0;3,0;3,0;25,0;10,0;30,0;75,0;100,0;23,0;27,0;;33,0;15,0;19,0;9,0;12,0;1,0;8,0;;17,0;7,0;4,0;24,0;8,0;;13,0;20,0;6,0;3,0;3,0;8,0;;;3,0;34,0;12,0;33,0;27,0;6,0;5,0;2,0;23,0;5,0;14,0;15,0;1,0;;60,0;4,0;17,0;5,0;18,0;6,0;17,0;14,0;;13,0;2,0;;;1,0;1,0;2,0;1,0;;5,0;1,0;4,0;6,0;4,0;3,0;;4,0;2,0;45,0;1,0;6,0;;;2,0;47,0;2,0;;;;1,0;10,0;;;27,0;9,0;2,0;21,0;;3,0;56,0;10,0;1,0;22,0;28,0;14,0;5,0;1,0;7,0;12,0;4,0;10,0;15,0;3,0;;;;1,0;23,0;5,0;1,0;;1,0;33,0;5,0;;;;8,0;;5,0;;12,0;;1,0;;;19,0;;1,0;;5,0;6,0;14,0;18,0;2,0;41,0;5,0;4,0;2,0;3,0;1,0;28,0;;2,0;20,0;1,0;;1,0;10,0;7,0;4,0;1,0;14,0;11,0;1,0;5,0;3,0;;7,0;;24,0;1,0;12,0;10,0;1,0;;3,0;1,0;3,0;;5,0;;;2,0;9,0;22,0;;1,0;1,0;3,0;5,0;2,0;;3,0;10,0;15,0;2,0;3,0;3,0;5,0;4,0;16,0;;104,0;;;;11,0;4,0;1,0;;14,0;;4,0;7,0;1,0;6,0;91,0;;;7,0;2,0;1,0;5,0;38,0;26,0;3,0;;6,0;57,0;2,0;4,0;25,0;2,0;22,0;2,0;4,0;6,0;1,0;1,0;10,0;1,0;1,0;;;7,0;6,0;5,0;;;10,0;;1,0;;;33,0;;2,0;;;5,0;;16,0;3,0;4,0;;2,0;27,0;3,0;3,0;1,0;;;;4,0;;;;;1,0;2,0;;6,0;2,0;23,0;;1,0;3,0;271,0;;;2,0;8,0;3,0;;18,0;3,0;;5,0;14,0;;2,0;2,0;10,0;4,0;;;;1,0;6,0;21,0;1,0;43,0;3,0;10,0;;5,0;3,0;3,0;;1,0;;4,0;7,0;1,0;;119,0;7,0;5,0;13,0;;101,0;11,0;10,0;7,0;;5,0;1,0;;;9,0;;12,0;7,0;27,0;3,0;;67,0;;16,0;18,0;7,0;2,0;10,0;;2,0;;12,0;10,0;5,0;9,0;8,0;;;10,0;1,0;4,0;1,0;2,0;;;6,0;;;;30,0;;7,0;14,0;6,0;35,0;7,0;1,0;20,0;11,0;1,0;;60,0;25,0;28,0;9,0;2,0;;;1,0;1,0;44,0;5,0;1,0;3,0;;1,0;1,0;43,0;;19,0;2,0;3,0;1,0;12,0;;;5,0;;2,0;5,0;4,0;17,0;1,0;;37,0;5,0;;9,0;8,0;2,0;2,0;;4,0;101,0;21,0;1,0;9,0;68,0;11,0;10,0;7,0;3,0;;3,0;186,0;2,0;13,0;6,0;6,0;;1,0;;8,0;;19,0;24,0;;;46,0;3,0;2,0;;3,0;1,0;15,0;;;;2,0;1,0;;8,0;;8,0;;;5,0;9,0;;1,0;1,0;2,0;;4,0;2,0;;10,0;;13,0;;2,0;5,0;1,0;;;;19,0;14,0;;4,0;;4,0;6,0;22,0;2,0;;11,0;;4,0;1,0;1,0;;17,0;;;16,0;;;2,0;8,0;;11,0;;2,0;2,0;8,0;1,0;7,0;9,0;7,0;9,0;;;;;21,0;;1,0;31,0;;4,0;4,0;;;2,0;7,0;6,0;3,0;;;3,0;;;2,0;3,0;;1,0;34,0;5,0;2,0;2,0;1,0;2,0;;8,0;13,0;1,0;;;4,0;4,0;;12,0;12,0;1,0;4,0;9,0;3,0;9,0;2,0;7,0;1,0;6,0;9,0;2,0;6,0;1,0;6,0;22,0;10,0;13,0;6,0;2,0;45,0;;;1,0;;;;8,0;;;9,0;;;4,0;;;14,0;2,0;5,0;;43,0;1,0;10,0;;11,0;6,0;5,0;2,0;;6,0;;3,0;20,0;;6,0;2,0;19,0;;;;;;;6,0;;;;;;;5,0;5,0;;1,0;5,0;;;;11,0;1,0;;1,0;;1,0;;;1,0;;;3,0;;;1,0
array;1,0;5,0;1,0;;3,0;18,0;39,0;38,0;31,0;179,0;;;27,0;;34,0;61,0;8,0;4,0;;6,0;7,0;104,0;;24,0;14,0;9,0;217,0;9,0;1,0;7,0;2,0;18,0;132,0;;36,0;18,0;2,0;7,0;4,0;2,0;112,0;1,0;11,0;23,0;66,0;12,0;48,0;202,0;37,0;17,0;86,0;35,0;;17,0;6,0;6,0;296,0;7,0;3,0;;15,0;3,0;44,0;;236,0;145,0;18,0;147,0;51,0;27,0;30,0;;44,0;3,0;4,0;13,0;3,0;11,0;18,0;840,0;86,0;322,0;7,0;362,0;4,0;7,0;;;1,0;24,0;485,0;;;11,0;21,0;3,0;6,0;;168,0;;;;77,0;33,0;35,0;7,0;360,0;20,0;52,0;26,0;17,0;49,0;8,0;5,0;14,0;453,0;79,0;143,0;38,0;13,0;;2,0;8,0;25,0;39,0;;;;11,0;40,0;;41,0;27,0;;27,0;47,0;33,0;7,0;11,0;;19,0;;4,0;676,0;10,0;;;36,0;150,0;3,0;2,0;69,0;10,0;10,0;8,0;9,0;215,0;;;58,0;5,0;23,0;154,0;;;;21,0;27,0;9,0;14,0;8,0;5,0;2,0;23,0;3,0;12,0;61,0;;;6,0;10,0;2,0;8,0;33,0;6,0;108,0;2,0;32,0;12,0;4,0;;;1,0;49,0;31,0;23,0;;;1,0;45,0;5,0;3,0;16,0;84,0;27,0;;16,0;2,0;11,0;;2,0;1,0;;32,0;3,0;6,0;;3,0;;6,0;16,0;27,0;2,0;;;;22,0;;269,0;12,0;2,0;5,0;4,0;38,0;3,0;4,0;7,0;6,0;14,0;;5,0;3,0;3,0;5,0;4,0;12,0;74,0;;1366,0;170,0;1,0;4,0;;;;27,0;87,0;29,0;31,0;3,0;;1,0;1,0;28,0;23,0;;16,0;4,0;61,0;;;35,0;10,0;12,0;2,0;;4,0;26,0;82,0;121,0;5,0;;51,0;1,0;;71,0;1,0;;;3,0;3,0;13,0;;35,0;3,0;;8,0;;;;20,0;9,0;8,0;;18,0;;;23,0;4,0;6,0;5,0;;42,0;;8,0;20,0;;1,0;1,0;59,0;2,0;;7,0;;10,0;2,0;;;;;;;;;;8,0;26,0;10,0;2,0;7,0;;2,0;;38,0;2,0;1,0;2,0;7,0;26,0;25,0;3,0;10,0;2,0;2,0;;;1,0;10,0;6,0;10,0;;16,0;;;2,0;1,0;;5,0;2,0;5,0;;;;1,0;;17,0;;2,0;5,0;23,0;;;3,0;;;16,0;;;;2,0;1,0;24,0;;5,0;;4,0;3,0;11,0;20,0;;;;5,0;31,0;2,0;;;1,0;4,0;19,0;3,0;3,0;13,0;29,0;12,0;2,0;4,0;;1,0;1,0;;7,0;214,0;3,0;;15,0;;9,0;;4,0;5,0;15,0;16,0;77,0;22,0;;5,0;5,0;4,0;2,0;;6,0;16,0;;3,0;16,0;15,0;;23,0;12,0;;15,0;;1,0;4,0;12,0;;2,0;;;47,0;3,0;1,0;;;;;;5,0;2,0;;;1,0;;3,0;8,0;;;11,0;;5,0;28,0;;24,0;20,0;1,0;;;11,0;89,0;;2,0;;7,0;13,0;;2,0;;3,0;;7,0;42,0;1,0;;5,0;1,0;;1,0;31,0;2,0;7,0;10,0;;5,0;1,0;;;;6,0;;1,0;;1,0;;1,0;1,0;11,0;;;20,0;;1,0;3,0;1,0;;;6,0;12,0;;1,0;;6,0;;;;40,0;;;;9,0;;;7,0;8,0;7,0;31,0;;;;1,0;2,0;;68,0;14,0;8,0;;;1,0;;;28,0;;7,0;;1,0;2,0;4,0;1,0;3,0;;3,0;;1,0;1,0;7,0;3,0;;;;;;;;1,0;;;;;4,0;;37,0;2,0;;;3,0;18,0;;13,0;3,0;;;;;14,0;;;2,0;;;1,0;41,0;;;;;;27,0;8,0;;;9,0;;;33,0;;;19,0;4,0;1,0;;2,0;12,0;;4,0;;;;1,0;3,0;;;4,0;;;3,0;;4,0;3,0;;;;6,0;;5,0;45,0;4,0;4,0;7,0;;14,0;;;3,0;;;;3,0;2,0;;;;;;;;9,0;;3,0;2,0;3,0;;;2,0;;;1,0;7,0;5,0;8,0;;1,0;;3,0;1,0;;;6,0;;;;;1,0;;11,0;;4,0;;;25,0;;;6,0;;;;6,0;3,0;7,0;;2,0;2,0;;20,0;;21,0;;;9,0;;1,0;;;6,0;1,0;;9,0;;10,0;4,0;;;;;2,0;;7,0;2,0;;8,0;5,0;3,0;;1,0;10,0;;3,0;;89,0;2,0;;3,0;42,0;;5,0;6,0;;2,0;2,0;66,0;8,0;1,0;31,0;40,0;87,0;10,0;;25,0;;16,0;6,0;;3,0;7,0;;;1,0;;;15,0;;;;10,0;;1,0;10,0;;;2,0;;2,0;1,0;;1,0;3,0;;4,0;;2,0;;1,0;;3,0;3,0;;6,0;8,0;;;1,0;3,0;122,0;;;2,0;;27,0;2,0;;;;9,0;2,0;;;;9,0;;;4,0;;;;;;;3,0;;;;;7,0;5,0;;5,0;4,0;14,0;3,0;12,0;4,0;;11,0;;;;;;;;1,0;;3,0;13,0;1,0;2,0;;;5,0;;1,0;;24,0;4,0;1,0;11,0;41,0;1,0;;26,0;;19,0;;2,0;;10,0;;;;2,0;;1,0;;;1,0;13,0;2,0;8,0;2,0;;1,0;;;;;;6,0;;6,0;;;;2,0;3,0;;1,0;;;;;;;1,0;;;10,0;;;;3,0;2,0;;6,0;2,0;5,0;3,0;;2,0;3,0;;97,0;;2,0;1,0;34,0;4,0;7,0;;;1,0;1,0;;5,0;1,0;;;;1,0;;;;5,0;;;;;6,0;;;;;;;;;;;;;;
aspheric;1,0;;;;;;4,0;7,0;;10,0;;;;;11,0;;2,0;;;;;;;1,0;;2,0;;2,0;;;;3,0;;;;;1,0;;;1,0;1,0;2,0;3,0;;;;;;;;8,0;2,0;6,0;;;;41,0;;;;;;;;1,0;1,0;;23,0;;;1,0;;;;;22,0;;;;17,0;;4,0;;80,0;;;;;;1,0;287,0;;;;;;;;4,0;;;;2,0;14,0;1,0;;28,0;2,0;;;1,0;;;;;2,0;;1,0;8,0;;;;;;;;;;;;;;3,0;;6,0;;2,0;;;5,0;;;;;;;;14,0;;1,0;;;;;;;10,0;;;;;;52,0;;2,0;;;1,0;;;76,0;;;;12,0;;3,0;;;;;;;;;;1,0;;3,0;;;2,0;1,0;;1,0;;;;;;;;;;;;;;;5,0;;;;;1,0;;;;8,0;;;;;;;;;;2,0;;;;27,0;;;;;;;;;;;;;;;;;1,0;1,0;;;;;;1,0;7,0;;7,0;;3,0;;2,0;;;1,0;;;;;;;;;;;2,0;;149,0;;;;;;;;;;;;;;;;;;;;;;;;;;;;;;;;;;;6,0;;;;17,0;;;;1,0;;;;;;;;;;;;;;;;;;;;;;;;;;;;1,0;;;;;;;5,0;;;;;;;;;;;;;3,0;;;;;;;;;;;;;;;;;;;;;;;;;;;;;;;;;;;;;;;;;;;;;4,0;;;;;;;;;;;;;;;;;;;;;;;;;;;;;;1,0;;;;;;;;;;;;;;;;;;;;;;;;;;;;;;;;;;;;;;;;;;;2,0;;;;;;;;;;;;;;;;;;;;;;;;;;;;;;;;;;;;;;;;;;;;;;;;;;;2,0;;;;;;1,0;;;;;;;;;;;;;;;;;;;;;;;;;1,0;;;;;;;;;;;;;;;;;;;;;;;;;;;;;;1,0;;;;;;;;;;;;;;;;;;;;;;;;;;;;;;;;;;;;;;;;3,0;1,0;;;;;;;2,0;;;;;;;;;;;;;;;1,0;;;;;;2,0;;;;;;;;;;;;;;;;;;;;;;;;;;;;;;;;;;;;;;;;;;;;;;;;;;;;;;;;;;;;;;;;;;;;;;;;;;;;;;;;;;;;;;;;;5,0;;;;;;;;;;;;;;;;;;;;;;;;;;;;;;;;;;;;;;;;;;;;;;;;;;;;;;10,0;;;;;;;;;;2,0;;;;;;;;;;;;;;;;;;;;;;;;;;;;;;;;;;;;;1,0;;;;;;;;;;;;;;;;;;;;;;;;;;;;;;;;;;;;;;;;;;;;;;;;;;;;;;;;;;;;;;;;;;;;;;;;;;;;;;;;;;;;;;;;;;;;;;;;;;;2,0;;;;;;;;;;;;;;;;3,0;;;;;;;;;;;;;;;;;;;;;;;;;
associate;6,0;;;17,0;13,0;15,0;2,0;65,0;85,0;15,0;27,0;;;13,0;56,0;196,0;3,0;5,0;4,0;;13,0;185,0;6,0;13,0;1,0;;52,0;2,0;;2,0;41,0;14,0;77,0;3,0;76,0;19,0;9,0;30,0;17,0;1,0;366,0;2,0;11,0;57,0;92,0;3,0;136,0;362,0;105,0;80,0;5,0;48,0;10,0;1,0;9,0;36,0;50,0;6,0;17,0;1,0;10,0;6,0;72,0;41,0;15,0;20,0;50,0;10,0;157,0;22,0;45,0;2,0;70,0;;2,0;59,0;93,0;15,0;26,0;924,0;19,0;65,0;3,0;113,0;5,0;48,0;1,0;;;23,0;135,0;2,0;6,0;7,0;37,0;14,0;43,0;22,0;249,0;73,0;52,0;10,0;40,0;342,0;7,0;10,0;54,0;9,0;46,0;93,0;11,0;25,0;;1,0;;215,0;93,0;146,0;16,0;35,0;;2,0;13,0;54,0;89,0;18,0;24,0;;2,0;17,0;1,0;56,0;17,0;5,0;13,0;21,0;56,0;53,0;17,0;3,0;83,0;3,0;7,0;137,0;52,0;1,0;;21,0;116,0;7,0;28,0;6,0;19,0;101,0;9,0;2,0;168,0;;15,0;27,0;6,0;25,0;68,0;2,0;;;104,0;74,0;13,0;22,0;20,0;;3,0;3,0;23,0;4,0;33,0;4,0;2,0;;7,0;9,0;;;;56,0;;21,0;;;;;;9,0;;5,0;58,0;9,0;;3,0;;2,0;22,0;19,0;7,0;;1,0;5,0;36,0;23,0;;;5,0;15,0;;;2,0;1,0;5,0;16,0;13,0;2,0;7,0;2,0;1,0;5,0;9,0;1,0;153,0;;20,0;4,0;24,0;18,0;9,0;7,0;44,0;19,0;2,0;6,0;6,0;8,0;2,0;16,0;24,0;4,0;2,0;56,0;192,0;18,0;15,0;;3,0;1,0;;4,0;69,0;2,0;6,0;;;;;119,0;2,0;;6,0;4,0;5,0;2,0;1,0;40,0;23,0;;;;32,0;10,0;11,0;62,0;4,0;24,0;8,0;2,0;;102,0;4,0;12,0;1,0;3,0;34,0;4,0;1,0;;6,0;;25,0;;;;8,0;3,0;3,0;;;3,0;;20,0;;1,0;4,0;1,0;;1,0;7,0;3,0;5,0;9,0;;3,0;;;;;3,0;3,0;1,0;1,0;;4,0;1,0;;;4,0;;5,0;1,0;2,0;20,0;5,0;3,0;;3,0;2,0;13,0;4,0;6,0;7,0;4,0;11,0;;;1,0;1,0;3,0;3,0;3,0;173,0;15,0;8,0;5,0;9,0;;;3,0;;;2,0;4,0;6,0;3,0;4,0;;4,0;2,0;2,0;6,0;1,0;2,0;6,0;4,0;;3,0;1,0;1,0;4,0;;;1,0;7,0;3,0;56,0;1,0;3,0;;11,0;20,0;8,0;8,0;13,0;;5,0;53,0;7,0;;;4,0;;7,0;26,0;17,0;23,0;24,0;6,0;44,0;2,0;9,0;1,0;;;1,0;4,0;18,0;5,0;3,0;5,0;9,0;131,0;15,0;4,0;2,0;48,0;15,0;3,0;139,0;;58,0;24,0;33,0;6,0;9,0;68,0;10,0;3,0;40,0;19,0;29,0;;31,0;2,0;14,0;1,0;;37,0;11,0;31,0;7,0;2,0;;2,0;10,0;2,0;7,0;2,0;2,0;;12,0;;10,0;78,0;;3,0;34,0;33,0;156,0;4,0;49,0;4,0;1,0;3,0;30,0;5,0;10,0;29,0;40,0;8,0;1,0;14,0;1,0;38,0;1,0;21,0;89,0;5,0;2,0;;3,0;6,0;54,0;2,0;6,0;4,0;23,0;5,0;21,0;7,0;16,0;6,0;14,0;11,0;6,0;11,0;3,0;4,0;13,0;2,0;10,0;3,0;10,0;4,0;4,0;49,0;12,0;3,0;1,0;26,0;39,0;6,0;17,0;33,0;10,0;4,0;23,0;3,0;2,0;4,0;29,0;74,0;;62,0;;5,0;;1,0;3,0;6,0;3,0;12,0;2,0;17,0;3,0;2,0;7,0;46,0;3,0;10,0;4,0;2,0;4,0;6,0;10,0;1,0;7,0;58,0;;38,0;4,0;47,0;6,0;16,0;6,0;20,0;9,0;;1,0;8,0;;5,0;11,0;2,0;10,0;;2,0;3,0;11,0;4,0;14,0;2,0;10,0;2,0;48,0;52,0;;1,0;4,0;5,0;4,0;41,0;17,0;1,0;12,0;;21,0;12,0;;8,0;5,0;2,0;;18,0;1,0;18,0;;12,0;6,0;11,0;3,0;23,0;2,0;4,0;;1,0;2,0;1,0;11,0;6,0;68,0;9,0;1,0;;5,0;2,0;12,0;24,0;21,0;19,0;28,0;;2,0;1,0;1,0;2,0;;;30,0;;17,0;5,0;26,0;18,0;1,0;43,0;1,0;;;;9,0;1,0;;;;;2,0;4,0;9,0;2,0;;1,0;;;5,0;;1,0;2,0;2,0;;;;;;;3,0;51,0;2,0;;6,0;;18,0;2,0;;;13,0;;;3,0;;2,0;;9,0;;22,0;;9,0;1,0;;;1,0;3,0;1,0;1,0;;1,0;2,0;2,0;;;;;;;;2,0;;3,0;10,0;5,0;2,0;2,0;1,0;19,0;4,0;;;1,0;5,0;2,0;2,0;1,0;1,0;;9,0;;;5,0;;;1,0;2,0;;3,0;1,0;5,0;1,0;;;1,0;2,0;;37,0;;;4,0;;2,0;3,0;1,0;;10,0;;11,0;21,0;4,0;16,0;11,0;17,0;10,0;2,0;4,0;23,0;8,0;10,0;11,0;;1,0;;;9,0;13,0;2,0;8,0;1,0;;13,0;;3,0;;;;1,0;4,0;17,0;1,0;4,0;;2,0;18,0;8,0;;3,0;11,0;11,0;12,0;;;;1,0;1,0;;3,0;;1,0;6,0;10,0;26,0;17,0;;17,0;3,0;2,0;1,0;28,0;11,0;5,0;;;4,0;;;;2,0;1,0;1,0;5,0;3,0;38,0;3,0;;;;7,0;;4,0;2,0;1,0;6,0;13,0;;6,0;20,0;2,0;1,0;;;4,0;;2,0;6,0;2,0;;;1,0;42,0;;;;3,0;7,0;4,0;;1,0;2,0;4,0;4,0;6,0;7,0;;;2,0;9,0;;;5,0;2,0;1,0;;;5,0;28,0;17,0;10,0;1,0;24,0;;2,0;1,0;;2,0;;;;;2,0;5,0;;1,0;14,0;1,0;6,0;;6,0;;;4,0;7,0;;26,0;;18,0;;;;1,0;1,0;4,0;;1,0;2,0;2,0;2,0;19,0;1,0;;;;51,0;;16,0;;;1,0;;;;2,0;6,0;;;5,0;;1,0;1,0;;1,0;;9,0;7,0;;9,0;;3,0;;;16,0;;5,0;;;1,0;;;2,0;48,0;;;4,0;6,0;4,0;;2,0;;1,0;5,0;;;;;;;6,0;
association;1,0;;;;;;;7,0;3,0;9,0;;;13,0;;;18,0;;;3,0;;3,0;30,0;13,0;;;;2,0;;;;1,0;;14,0;1,0;6,0;6,0;;5,0;17,0;;23,0;;7,0;;13,0;1,0;23,0;20,0;16,0;9,0;6,0;2,0;;;9,0;;3,0;1,0;1,0;;;1,0;1,0;2,0;1,0;2,0;;;5,0;;25,0;;19,0;;;3,0;2,0;;;86,0;7,0;13,0;;4,0;2,0;8,0;;;;;6,0;2,0;;;;6,0;5,0;;12,0;4,0;;;6,0;16,0;;1,0;;;1,0;8,0;;3,0;;;;20,0;2,0;23,0;;4,0;;;37,0;7,0;3,0;;;;;;;11,0;8,0;;2,0;4,0;1,0;5,0;2,0;;17,0;;;3,0;4,0;;;2,0;;3,0;4,0;;3,0;43,0;;;7,0;;;;1,0;;20,0;;;;1,0;;;;6,0;;;;2,0;;;1,0;;;;;;;;3,0;;;;;;;;;;;;;;;;;4,0;;8,0;;;;;;;;;;;;;;2,0;;;2,0;;;;;;;2,0;;3,0;;4,0;14,0;;9,0;11,0;;;;;;;;1,0;;;4,0;10,0;;;2,0;;;;;;;;;;;;;;;;;4,0;;;1,0;;;;;;1,0;;15,0;1,0;;;;;2,0;;;;;5,0;2,0;;;;;;;;;;;;;;;2,0;2,0;;;;;;;;;;;;;;;;2,0;;;;;;;;;;;;;;;;;;;;;1,0;;;;;1,0;;;;;;;;3,0;2,0;;;;;;;2,0;;;;;;;;;;;;;9,0;;;;;;;;;;8,0;1,0;;4,0;;;;;;;;;;;1,0;;;;;;;;3,0;;2,0;;1,0;;;;;;;;13,0;;1,0;;;6,0;;;;2,0;;;1,0;;5,0;;2,0;;;;;;3,0;1,0;3,0;;1,0;;;;;;;6,0;;;;2,0;9,0;;;;;;;;;;;;;;23,0;;8,0;;6,0;;18,0;;;;2,0;3,0;;;1,0;1,0;;;;4,0;1,0;;;;2,0;2,0;1,0;;;;;;;;;;;1,0;;;1,0;;;;;;1,0;3,0;;;;6,0;1,0;;;;;;;;;;1,0;1,0;;;1,0;7,0;;;;1,0;;;;3,0;;;;1,0;;2,0;;;;;1,0;;2,0;;;;;1,0;;;;3,0;;;1,0;;;;;;;;;;;;;;;;7,0;9,0;;;;;;1,0;1,0;;;;;2,0;;;;;;;;8,0;;;;;;1,0;;;;;;;3,0;;2,0;1,0;;;;;;;;3,0;2,0;;;;;;;;1,0;;;;3,0;;;3,0;;;;;;;;;6,0;;;;;;;;;;;;;;;;;;;;;;6,0;;;;;;5,0;;;;;;;;;;;9,0;;;;;;;;3,0;;;;;;;;;;;;;;;;;;1,0;;;;;;;;;;;;;;;;;;;;;4,0;;;;;;;;;;;;;;;;;;;;;5,0;;;;;;3,0;;;;;;;;;;;;;;;;;;;;;;;;;;;;;;;;;;;;;1,0;;;;;;;;;;1,0;;;;1,0;;;1,0;3,0;;;;;;;;;;;;;;1,0;;;;;;;11,0;;;;;2,0;3,0;;;;;;;;1,0;2,0;;;;;;;;;6,0;;;3,0;;;;;;;;;;;;;;;;;;;;1,0;;;;;6,0;;;1,0;;;;;;;;;;;;;;;1,0;;;;;;;;15,0;;;;;;;;;;2,0;;;;;;;2,0;;;;;;;;;;;;;;;;1,0;;;;;;;;;;;;2,0;;;;;;;;2,0;;;;;;;;;;1,0;;;;;;;;;
axis;2,0;3,0;12,0;1,0;;268,0;72,0;102,0;62,0;169,0;34,0;11,0;56,0;;;149,0;58,0;59,0;3,0;3,0;10,0;56,0;6,0;3,0;4,0;;23,0;8,0;;33,0;6,0;63,0;178,0;3,0;84,0;47,0;24,0;14,0;2,0;33,0;25,0;;127,0;18,0;24,0;15,0;101,0;226,0;64,0;36,0;118,0;157,0;2,0;4,0;127,0;18,0;112,0;31,0;14,0;1,0;193,0;2,0;30,0;;31,0;40,0;128,0;101,0;64,0;33,0;14,0;9,0;34,0;;;95,0;5,0;18,0;22,0;484,0;14,0;182,0;3,0;155,0;7,0;3,0;11,0;;12,0;31,0;1709,0;;;4,0;13,0;8,0;11,0;;114,0;16,0;5,0;1,0;303,0;73,0;7,0;25,0;3784,0;26,0;23,0;8,0;77,0;42,0;8,0;;;83,0;342,0;383,0;24,0;39,0;8,0;5,0;4,0;4,0;12,0;4,0;6,0;;8,0;24,0;;41,0;295,0;7,0;36,0;;58,0;40,0;4,0;61,0;8,0;;4,0;208,0;10,0;;;152,0;10,0;13,0;6,0;4,0;13,0;7,0;11,0;;481,0;2,0;204,0;3,0;6,0;9,0;677,0;15,0;26,0;;36,0;103,0;1,0;3,0;147,0;;;21,0;17,0;16,0;201,0;217,0;5,0;;15,0;116,0;2,0;12,0;;10,0;1,0;16,0;1,0;;1,0;8,0;10,0;58,0;1,0;33,0;;1,0;2,0;30,0;48,0;1,0;9,0;1359,0;29,0;20,0;13,0;14,0;4,0;73,0;2,0;20,0;21,0;1,0;;;47,0;3,0;19,0;59,0;157,0;37,0;31,0;;16,0;6,0;6,0;12,0;232,0;1,0;325,0;2,0;73,0;150,0;187,0;573,0;136,0;53,0;33,0;43,0;7,0;20,0;7,0;41,0;5,0;;9,0;19,0;24,0;318,0;71,0;3,0;10,0;3,0;1,0;;111,0;29,0;6,0;22,0;12,0;1,0;6,0;33,0;;18,0;38,0;11,0;19,0;;35,0;26,0;92,0;1,0;2,0;32,0;1,0;69,0;14,0;190,0;1,0;;3,0;22,0;3,0;129,0;5,0;;;;73,0;133,0;32,0;2,0;22,0;;13,0;9,0;19,0;5,0;61,0;27,0;39,0;17,0;12,0;1,0;4,0;7,0;18,0;8,0;;13,0;6,0;2,0;28,0;3,0;1,0;32,0;19,0;53,0;22,0;;11,0;31,0;147,0;1,0;38,0;16,0;;20,0;36,0;;13,0;5,0;;6,0;13,0;179,0;17,0;43,0;13,0;22,0;15,0;1,0;22,0;24,0;14,0;97,0;480,0;11,0;12,0;794,0;2,0;31,0;35,0;158,0;39,0;120,0;10,0;11,0;14,0;29,0;4,0;9,0;20,0;11,0;;29,0;12,0;24,0;;2,0;1,0;1,0;25,0;11,0;71,0;131,0;343,0;509,0;27,0;3,0;8,0;166,0;;56,0;2,0;40,0;1,0;163,0;46,0;32,0;2,0;2,0;4,0;11,0;15,0;10,0;14,0;3,0;1,0;2,0;;18,0;5,0;2,0;12,0;20,0;1,0;32,0;55,0;4,0;;;3,0;1,0;7,0;1,0;1,0;;;2,0;25,0;2,0;1,0;;;1,0;;1,0;3,0;16,0;4,0;112,0;37,0;;16,0;42,0;7,0;;8,0;74,0;108,0;4,0;;14,0;14,0;1,0;35,0;1,0;15,0;18,0;;6,0;1,0;7,0;3,0;16,0;93,0;3,0;27,0;3,0;2,0;7,0;12,0;8,0;;5,0;5,0;14,0;5,0;12,0;3,0;1,0;29,0;3,0;9,0;2,0;10,0;;39,0;161,0;2,0;136,0;98,0;;;;8,0;14,0;;2,0;;7,0;2,0;31,0;2,0;3,0;21,0;;77,0;1,0;1,0;133,0;1,0;;39,0;8,0;4,0;;32,0;6,0;57,0;;;;22,0;;2,0;;6,0;;30,0;4,0;1,0;4,0;;9,0;;;;;1,0;11,0;;2,0;5,0;50,0;1,0;132,0;;61,0;18,0;7,0;;11,0;7,0;;30,0;;;;3,0;;3,0;13,0;;;38,0;9,0;;;;4,0;7,0;1,0;;8,0;;2,0;1,0;;26,0;2,0;;4,0;4,0;;;1,0;8,0;2,0;;;15,0;6,0;;;19,0;;;;;10,0;4,0;2,0;;;26,0;1,0;98,0;;20,0;;;2,0;5,0;1,0;;;5,0;4,0;10,0;;3,0;;4,0;3,0;;;;1,0;9,0;1,0;1,0;;16,0;;4,0;;;16,0;;2,0;1,0;;13,0;5,0;;;;13,0;4,0;;;10,0;7,0;16,0;22,0;6,0;5,0;7,0;;1,0;25,0;7,0;2,0;3,0;1,0;;8,0;;12,0;;11,0;1,0;;82,0;;17,0;21,0;21,0;1,0;1,0;;7,0;3,0;5,0;1,0;14,0;2,0;5,0;28,0;13,0;;143,0;;2,0;5,0;1,0;13,0;5,0;7,0;;;40,0;5,0;;26,0;;;;5,0;;27,0;110,0;;15,0;12,0;2,0;5,0;;;15,0;;27,0;1,0;4,0;3,0;3,0;;11,0;2,0;;;62,0;;3,0;34,0;11,0;;;14,0;;10,0;30,0;22,0;5,0;6,0;10,0;13,0;;4,0;22,0;1,0;2,0;2,0;122,0;2,0;;5,0;2,0;11,0;;;19,0;;2,0;7,0;;;20,0;6,0;;1,0;4,0;3,0;1,0;;;6,0;2,0;;3,0;;8,0;;84,0;7,0;57,0;;1,0;1,0;;8,0;1,0;7,0;4,0;;23,0;1,0;1,0;;13,0;1,0;;;;23,0;2,0;3,0;20,0;;1,0;;1,0;;30,0;1,0;10,0;34,0;;5,0;;2,0;;;;7,0;;1,0;;38,0;;;2,0;;;1,0;;6,0;2,0;6,0;;3,0;1,0;10,0;19,0;4,0;;7,0;;3,0;;15,0;;4,0;;2,0;;;;;;11,0;;;;4,0;;8,0;;;;2,0;;;;;18,0;;;2,0;10,0;1,0;13,0;2,0;2,0;;9,0;35,0;;;;2,0;;;;1,0;;6,0;;1,0;;1,0;2,0;;;;8,0;4,0;;15,0;;;4,0;3,0;23,0;;9,0;20,0;;;6,0;41,0;;71,0;13,0;1,0;4,0;1,0;18,0;32,0;3,0;12,0;1,0;9,0;;;2,0;;;;;1,0;7,0;;6,0;;6,0;1,0;50,0;19,0;2,0;4,0;5,0;;;2,0;20,0;2,0;8,0;1,0;3,0;1,0;6,0;3,0;;;;8,0;;;6,0;3,0;6,0;;;;9,0;2,0;;1,0;4,0;;;;5,0;;6,0;;;15,0;3,0;1,0;2,0;;;;1,0;;;2,0;1,0;2,0;1,0;;;;
base;12,0;21,0;5,0;2,0;53,0;230,0;82,0;201,0;341,0;110,0;61,0;;196,0;18,0;149,0;;23,0;38,0;69,0;14,0;140,0;320,0;19,0;33,0;5,0;23,0;228,0;28,0;;9,0;40,0;66,0;223,0;65,0;474,0;64,0;74,0;175,0;59,0;15,0;1158,0;5,0;128,0;134,0;499,0;300,0;925,0;648,0;154,0;416,0;149,0;508,0;30,0;6,0;246,0;159,0;143,0;21,0;165,0;1,0;168,0;31,0;159,0;25,0;100,0;112,0;365,0;150,0;510,0;78,0;99,0;25,0;572,0;17,0;16,0;71,0;177,0;19,0;49,0;3280,0;35,0;183,0;1,0;428,0;6,0;144,0;28,0;9,0;23,0;122,0;686,0;14,0;6,0;20,0;78,0;34,0;37,0;20,0;438,0;169,0;151,0;53,0;258,0;682,0;1,0;35,0;182,0;29,0;398,0;333,0;31,0;190,0;26,0;15,0;12,0;536,0;825,0;947,0;44,0;229,0;2,0;4,0;68,0;176,0;109,0;17,0;26,0;36,0;19,0;107,0;2,0;182,0;204,0;22,0;42,0;71,0;97,0;46,0;73,0;29,0;161,0;8,0;22,0;306,0;136,0;5,0;;312,0;846,0;100,0;59,0;3,0;38,0;165,0;247,0;41,0;377,0;1,0;91,0;33,0;32,0;64,0;745,0;48,0;11,0;;357,0;226,0;25,0;23,0;110,0;1,0;33,0;41,0;277,0;36,0;134,0;42,0;;7,0;125,0;202,0;2,0;21,0;57,0;79,0;2,0;209,0;8,0;2,0;23,0;20,0;12,0;187,0;7,0;53,0;49,0;28,0;;55,0;12,0;8,0;183,0;327,0;114,0;54,0;8,0;26,0;113,0;151,0;22,0;14,0;16,0;21,0;1,0;8,0;20,0;1,0;40,0;103,0;194,0;7,0;34,0;19,0;9,0;29,0;159,0;14,0;437,0;1,0;757,0;2,0;4,0;382,0;77,0;92,0;194,0;99,0;35,0;29,0;21,0;16,0;25,0;68,0;48,0;;14,0;31,0;421,0;128,0;499,0;8,0;42,0;;;9,0;422,0;23,0;;1,0;2,0;35,0;77,0;299,0;5,0;26,0;74,0;6,0;71,0;;30,0;103,0;82,0;17,0;12,0;55,0;52,0;105,0;47,0;416,0;23,0;34,0;42,0;15,0;4,0;353,0;26,0;10,0;6,0;20,0;209,0;69,0;9,0;;58,0;4,0;31,0;2,0;18,0;12,0;63,0;18,0;164,0;1,0;5,0;12,0;1,0;46,0;112,0;25,0;16,0;46,0;11,0;2,0;17,0;18,0;3,0;33,0;2,0;154,0;11,0;9,0;21,0;17,0;161,0;4,0;52,0;9,0;9,0;2,0;19,0;34,0;44,0;1,0;1,0;95,0;41,0;78,0;24,0;82,0;23,0;3,0;33,0;34,0;13,0;16,0;23,0;41,0;23,0;112,0;6,0;31,0;33,0;35,0;42,0;34,0;34,0;337,0;14,0;14,0;42,0;47,0;;48,0;33,0;3,0;3,0;31,0;28,0;15,0;88,0;2,0;17,0;;9,0;14,0;67,0;24,0;106,0;125,0;18,0;16,0;25,0;70,0;9,0;31,0;30,0;39,0;25,0;285,0;28,0;233,0;33,0;17,0;38,0;20,0;41,0;26,0;60,0;10,0;17,0;1,0;19,0;29,0;3,0;16,0;8,0;22,0;15,0;427,0;181,0;49,0;47,0;41,0;97,0;16,0;19,0;3,0;1,0;3,0;14,0;20,0;51,0;125,0;4,0;12,0;5,0;278,0;13,0;8,0;30,0;272,0;153,0;20,0;368,0;16,0;45,0;125,0;190,0;22,0;59,0;429,0;136,0;23,0;61,0;49,0;187,0;7,0;108,0;34,0;124,0;8,0;31,0;49,0;113,0;70,0;13,0;24,0;4,0;40,0;48,0;4,0;16,0;92,0;9,0;5,0;19,0;34,0;92,0;142,0;18,0;8,0;28,0;70,0;346,0;3,0;157,0;32,0;58,0;20,0;224,0;26,0;70,0;61,0;197,0;35,0;9,0;21,0;4,0;24,0;10,0;57,0;71,0;28,0;74,0;21,0;18,0;17,0;41,0;9,0;78,0;11,0;5,0;96,0;31,0;51,0;27,0;7,0;63,0;15,0;28,0;22,0;16,0;1,0;50,0;4,0;5,0;2,0;2,0;15,0;27,0;7,0;68,0;110,0;15,0;62,0;71,0;16,0;10,0;8,0;13,0;158,0;44,0;35,0;28,0;8,0;57,0;31,0;;26,0;9,0;41,0;11,0;17,0;17,0;49,0;46,0;37,0;1,0;103,0;9,0;;18,0;97,0;19,0;12,0;4,0;22,0;17,0;19,0;;24,0;22,0;139,0;9,0;121,0;15,0;63,0;15,0;18,0;40,0;14,0;9,0;3,0;15,0;6,0;7,0;5,0;32,0;7,0;48,0;69,0;17,0;26,0;86,0;48,0;13,0;52,0;13,0;8,0;52,0;18,0;1,0;19,0;15,0;8,0;4,0;20,0;49,0;11,0;26,0;3,0;18,0;33,0;2,0;31,0;13,0;;3,0;14,0;3,0;40,0;16,0;4,0;;20,0;5,0;3,0;11,0;3,0;;11,0;7,0;48,0;47,0;2,0;222,0;22,0;6,0;26,0;15,0;4,0;65,0;15,0;22,0;14,0;45,0;23,0;3,0;58,0;11,0;13,0;20,0;10,0;13,0;15,0;18,0;4,0;63,0;14,0;24,0;59,0;3,0;7,0;8,0;31,0;22,0;9,0;6,0;11,0;66,0;52,0;6,0;7,0;50,0;15,0;6,0;35,0;15,0;37,0;23,0;28,0;65,0;11,0;3,0;7,0;1,0;24,0;4,0;4,0;9,0;6,0;66,0;34,0;22,0;28,0;8,0;42,0;8,0;9,0;8,0;64,0;6,0;1,0;4,0;7,0;14,0;26,0;30,0;7,0;;8,0;21,0;26,0;13,0;15,0;4,0;30,0;7,0;16,0;10,0;4,0;7,0;129,0;1,0;12,0;2,0;11,0;22,0;20,0;8,0;28,0;6,0;1,0;23,0;54,0;2,0;5,0;10,0;30,0;7,0;24,0;35,0;2,0;34,0;3,0;6,0;23,0;;7,0;26,0;8,0;4,0;11,0;31,0;14,0;1,0;8,0;6,0;10,0;2,0;2,0;1,0;3,0;10,0;13,0;1,0;10,0;49,0;50,0;1,0;3,0;12,0;23,0;23,0;29,0;28,0;16,0;;22,0;1,0;8,0;126,0;71,0;;6,0;16,0;1,0;61,0;39,0;18,0;17,0;;7,0;2,0;7,0;31,0;14,0;13,0;65,0;32,0;34,0;7,0;14,0;22,0;;;7,0;14,0;33,0;53,0;27,0;13,0;39,0;6,0;42,0;;2,0;96,0;21,0;21,0;20,0;;65,0;4,0;;9,0;3,0;8,0;32,0;11,0;14,0;17,0;19,0;36,0;12,0;2,0;7,0;1,0;7,0;11,0;115,0;30,0;14,0;62,0;12,0;9,0;29,0;;7,0;;7,0;20,0;11,0;15,0;37,0;2,0;;;18,0;29,0;21,0;12,0;12,0;18,0;29,0;3,0;11,0;44,0;8,0;9,0;24,0;3,0;27,0;;50,0;2,0;3,0;7,0;6,0;21,0;49,0;24,0;4,0;1,0;15,0;;4,0;;2,0;28,0;3,0;4,0;6,0;7,0;10,0;;30,0;8,0;3,0;7,0;28,0;1,0;;6,0;1,0;16,0;15,0;53,0;9,0;10,0;29,0;13,0;11,0;42,0;;13,0;34,0;3,0;3,0;1,0;2,0;6,0;7,0;15,0;16,0;44,0;1,0;76,0;34,0;12,0;;78,0;57,0;8,0;10,0;3,0;9,0;14,0;6,0;19,0;6,0;3,0;21,0;12,0;1,0;12,0;9,0;;4,0;4,0;2,0;1,0;4,0;31,0;9,0;36,0;26,0;2,0;13,0;;16,0;10,0;39,0;11,0;7,0;;4,0;;;16,0;16,0;11,0;11,0;13,0;34,0;7,0;11,0;;15,0;1,0;7,0;19,0;3,0;6,0;20,0;26,0;23,0;2,0;15,0;17,0;59,0;5,0;2,0;5,0;7,0;16,0;13,0;15,0;7,0;6,0;14,0;2,0;6,0;6,0;4,0;;;12,0;2,0
beam;2,0;;;15,0;1,0;30,0;11,0;17,0;20,0;48,0;8,0;2,0;3,0;;58,0;23,0;;;;;1,0;19,0;4,0;1,0;;;10,0;11,0;;;3,0;9,0;66,0;8,0;15,0;17,0;3,0;;4,0;;;2,0;25,0;3,0;24,0;7,0;9,0;51,0;;2,0;29,0;12,0;1,0;3,0;5,0;;54,0;;;;2,0;3,0;15,0;;18,0;3,0;33,0;48,0;29,0;19,0;3,0;23,0;48,0;;;2,0;;102,0;46,0;191,0;3,0;30,0;;70,0;1,0;1,0;;;;1,0;90,0;;;2,0;7,0;;1,0;;52,0;;;;4,0;94,0;14,0;13,0;79,0;3,0;54,0;1,0;60,0;2,0;;;;72,0;61,0;40,0;4,0;;16,0;33,0;4,0;12,0;10,0;1,0;;11,0;10,0;24,0;;76,0;16,0;2,0;9,0;1,0;3,0;4,0;11,0;4,0;4,0;;4,0;86,0;;;;32,0;14,0;3,0;2,0;4,0;;4,0;;;104,0;2,0;12,0;;1,0;39,0;35,0;;6,0;2,0;8,0;10,0;19,0;51,0;8,0;1,0;;16,0;3,0;;6,0;11,0;;;;9,0;;;3,0;1,0;;9,0;;;;;8,0;71,0;;21,0;;;;2,0;;3,0;3,0;38,0;;;;11,0;;15,0;;7,0;;2,0;1,0;1,0;;;4,0;22,0;11,0;46,0;13,0;;7,0;4,0;;;616,0;;14,0;;37,0;93,0;2,0;7,0;15,0;22,0;;12,0;4,0;;27,0;97,0;1,0;;;;8,0;72,0;7,0;18,0;;;;10,0;105,0;167,0;4,0;1,0;;;;17,0;;;18,0;;21,0;;;119,0;18,0;1,0;37,0;1,0;;27,0;1,0;127,0;3,0;;;2,0;1,0;27,0;3,0;2,0;;;3,0;2,0;;;10,0;3,0;;3,0;9,0;;;13,0;3,0;1,0;;1,0;;17,0;4,0;;;;;;;19,0;;4,0;;5,0;;;2,0;7,0;1,0;4,0;;7,0;;;4,0;;;;;24,0;;28,0;12,0;;3,0;4,0;1,0;8,0;2,0;11,0;;12,0;32,0;43,0;;29,0;;;;4,0;13,0;29,0;;2,0;41,0;46,0;;;;4,0;;;1,0;20,0;1,0;;;;4,0;1,0;2,0;4,0;11,0;1,0;;;1,0;;;22,0;;;1,0;47,0;1,0;87,0;4,0;13,0;;4,0;;6,0;4,0;3,0;;;;8,0;;;2,0;5,0;1,0;7,0;3,0;;;1,0;;2,0;1,0;;;;;2,0;41,0;1,0;;;;;;;;28,0;1,0;1,0;2,0;1,0;1,0;22,0;8,0;2,0;33,0;2,0;1,0;;;7,0;10,0;;3,0;2,0;;;;;;11,0;18,0;;;;4,0;2,0;;;;;;20,0;1,0;3,0;;5,0;;;3,0;;;;;;23,0;8,0;2,0;15,0;;;;;;12,0;;1,0;;;;1,0;;;14,0;;4,0;;;12,0;;;;23,0;2,0;;;;;;;;;1,0;;;5,0;1,0;7,0;1,0;;;;;;1,0;;;4,0;8,0;;1,0;;1,0;2,0;;;;;1,0;;20,0;8,0;1,0;;;;;7,0;;;;5,0;;37,0;;;;;;;;;5,0;;;12,0;;57,0;;;1,0;;;1,0;;1,0;;;2,0;;;;;;;;;;;;;;;;;12,0;;;;23,0;2,0;;2,0;;;;;;;;;;;;;;;;;3,0;;40,0;;4,0;;;;1,0;36,0;;;;;;;;;1,0;;;7,0;;;1,0;;2,0;;;;1,0;;;;;;;;1,0;1,0;;1,0;1,0;16,0;;7,0;;;19,0;2,0;;28,0;;;;;;;;;;5,0;;;;;;;;;;7,0;19,0;;;;;;10,0;;7,0;;;;;;;;;;;6,0;3,0;;;;;;;;;;1,0;5,0;5,0;1,0;;;2,0;;36,0;;;1,0;18,0;;;;2,0;1,0;;;;2,0;;;;21,0;4,0;3,0;;;;;3,0;;;;;;;;;1,0;;;;;1,0;;;;;6,0;;;;;3,0;;8,0;;13,0;;;;;;;20,0;;;;;6,0;7,0;;;;;;;;7,0;;;;;;;;;;;19,0;;4,0;;;;1,0;;5,0;;;;;23,0;2,0;9,0;;48,0;8,0;1,0;;;307,0;;;1,0;;;;1,0;;;;;;;1,0;;;;2,0;;1,0;;;;14,0;;2,0;;;;1,0;;;;9,0;;;;;1,0;1,0;9,0;;;;;;7,0;;;;4,0;;;3,0;;;;2,0;1,0;7,0;;;;;;;;;;;;;;70,0;;3,0;3,0;;;;;1,0;;;;;;;;4,0;;;;7,0;;;;;;27,0;6,0;;95,0;;;;;2,0;7,0;1,0;2,0;16,0;;17,0;;;2,0;;1,0;;;;7,0;;;;;1,0;;11,0;;;;;;;1,0;;;;;;;;;;;;1,0;;;;1,0;1,0;;5,0;;;1,0
blur;3,0;;;1,0;6,0;3,0;11,0;22,0;3,0;;4,0;;5,0;;59,0;38,0;;;;9,0;11,0;25,0;1,0;4,0;1,0;1,0;4,0;;;70,0;;5,0;29,0;;10,0;5,0;52,0;101,0;3,0;;14,0;3,0;2,0;27,0;2,0;3,0;43,0;27,0;8,0;;;22,0;;;10,0;9,0;4,0;5,0;1,0;;2,0;;4,0;1,0;7,0;11,0;23,0;2,0;53,0;;5,0;;15,0;;;4,0;;1,0;2,0;426,0;5,0;4,0;;33,0;5,0;2,0;3,0;;;10,0;168,0;;;;4,0;;8,0;;31,0;;10,0;;8,0;18,0;;1,0;55,0;12,0;4,0;30,0;;12,0;;;;31,0;39,0;26,0;5,0;11,0;;;10,0;12,0;11,0;1,0;;22,0;;22,0;;11,0;3,0;9,0;11,0;;2,0;15,0;;4,0;24,0;;;12,0;3,0;;;6,0;3,0;;2,0;;;25,0;3,0;;71,0;;2,0;;2,0;;153,0;;4,0;;;;1,0;;26,0;;;1,0;48,0;14,0;;1,0;;;;14,0;;;;;;9,0;;;;;;;;2,0;;;;;;;12,0;6,0;8,0;;;;7,0;21,0;;;;;;;;;;1,0;5,0;;;;;;;;1,0;;24,0;;;1,0;3,0;6,0;6,0;;;;1,0;;;;;;;1,0;83,0;5,0;;;;;;;1,0;;;;;;;4,0;;10,0;;;1,0;;;;;;;;2,0;;;;3,0;;;;;65,0;;;;;2,0;;22,0;;;;;;;;;6,0;;2,0;;;;1,0;;;;;;;;3,0;;;;;;;;;6,0;;;;;;;;;;;4,0;1,0;3,0;5,0;;;;;;;;;;1,0;;;1,0;;;;;;16,0;1,0;;;;;;;;;;;;;;;3,0;;;;;1,0;;;;;1,0;;2,0;;;9,0;5,0;3,0;3,0;;;;;;;3,0;;;;2,0;2,0;;;;;9,0;49,0;5,0;4,0;3,0;;6,0;;;;;4,0;;;9,0;;;;;;;;;1,0;3,0;;;;14,0;2,0;11,0;;;32,0;10,0;;;1,0;4,0;2,0;;;5,0;;;;;2,0;;;;;2,0;;;;;1,0;;;1,0;;;;;3,0;;;18,0;6,0;;;;2,0;1,0;6,0;;;;28,0;;;;;;;;;1,0;;;;;;;2,0;21,0;;;;;;;;;;;;;;;;1,0;;;;;;;;2,0;;;;;;;;1,0;3,0;;1,0;;6,0;;;2,0;13,0;;;;;;;;;;;;;;1,0;3,0;2,0;;1,0;;;;;;69,0;2,0;;;;;2,0;;;;;;;;;;;;;;;;;;2,0;;;;;;;4,0;;;;;;14,0;;;;;;;;;;;;;1,0;;;;;;;1,0;;;;;;;;;;;;1,0;;;;;;;;;;1,0;1,0;;;;;;;4,0;;;;;;;;;;;;;1,0;;;;;;;;1,0;;;;2,0;;;;;;;;;;;;;;;;;1,0;;;;;;;7,0;;8,0;;;;;;2,0;;;;;;;;;;;;2,0;;;;1,0;;;;;;;;;;1,0;;;;1,0;;;;;;;;;;;;1,0;2,0;;;;;;;;;;3,0;;;;;;7,0;2,0;;;;;4,0;54,0;;1,0;;;;;1,0;;;;;;;;;;;;3,0;1,0;;;;4,0;;;;;;1,0;12,0;;;1,0;24,0;;;;;;1,0;;;2,0;;;;;;;;;;;;;1,0;;;5,0;;;;;;;;;;;;;2,0;;;;;;;;;3,0;;;;;;;;1,0;;;;;;;;;;;;;;;;;;1,0;;;;3,0;;;;;;;;;;;;;;;4,0;;;;;;;;;;9,0;;;;;;10,0;;2,0;;;;;;;;;;;;;;;;;;;;;;;;;;;;;;;;;2,0;;;;;;;;;;;;;;;;1,0;2,0;;;;;2,0;;;;;;;;;;;;;;;;;;;;
brightness;6,0;;7,0;;2,0;;8,0;4,0;67,0;3,0;;;4,0;3,0;3,0;69,0;;;;1,0;5,0;39,0;7,0;;3,0;4,0;44,0;;;3,0;;16,0;45,0;20,0;70,0;3,0;18,0;6,0;3,0;;83,0;7,0;4,0;1,0;77,0;29,0;103,0;34,0;6,0;21,0;;20,0;;3,0;;29,0;11,0;2,0;;;;3,0;;;10,0;;12,0;5,0;65,0;;18,0;2,0;24,0;1,0;;22,0;19,0;6,0;2,0;387,0;1,0;5,0;1,0;55,0;10,0;13,0;7,0;11,0;;;28,0;;;;5,0;4,0;3,0;;46,0;3,0;;1,0;68,0;24,0;;9,0;12,0;;16,0;19,0;;4,0;8,0;6,0;2,0;43,0;10,0;23,0;;30,0;;1,0;18,0;14,0;20,0;1,0;2,0;2,0;;30,0;;40,0;4,0;5,0;7,0;3,0;;7,0;;4,0;28,0;;;16,0;16,0;2,0;;2,0;143,0;2,0;10,0;;11,0;26,0;126,0;1,0;7,0;;;8,0;2,0;3,0;160,0;20,0;2,0;;19,0;5,0;;;;;;17,0;23,0;;;;;;;1,0;;;;10,0;;18,0;;;;;;;1,0;;3,0;;3,0;;;2,0;57,0;6,0;;;4,0;10,0;53,0;11,0;;;;;1,0;;;;6,0;;;;;;;;;;126,0;;;;;2,0;;;1,0;;;;1,0;;;;4,0;;;;101,0;;1,0;;;;;;8,0;3,0;;;;;;7,0;;;3,0;;6,0;;1,0;10,0;;;;;;1,0;;1,0;9,0;;;;;57,0;;;;;9,0;1,0;1,0;;;;5,0;;;;;9,0;;;;;;5,0;;;;1,0;;;;;;;;;;;;;2,0;;;;;;;;;;;1,0;;;;;;;;6,0;1,0;;;;4,0;20,0;;;;6,0;;;;8,0;4,0;;1,0;1,0;;;;2,0;;;;4,0;;;;7,0;;;;;;;;;;;;;;;;;17,0;39,0;;;;4,0;;;;3,0;1,0;;;4,0;;;4,0;;12,0;64,0;88,0;;21,0;;22,0;7,0;6,0;1,0;;2,0;;1,0;11,0;33,0;;9,0;6,0;7,0;5,0;2,0;;7,0;59,0;;2,0;;4,0;48,0;31,0;;7,0;2,0;3,0;;;;9,0;;;2,0;12,0;;;14,0;9,0;6,0;;;;;4,0;;;2,0;;;4,0;;94,0;;;;4,0;;1,0;1,0;2,0;;;;62,0;;1,0;;1,0;;;3,0;;;;4,0;23,0;8,0;12,0;2,0;;4,0;1,0;2,0;;;;7,0;20,0;5,0;8,0;;20,0;1,0;3,0;3,0;;;;;;;;;39,0;2,0;;17,0;;;;;;;;20,0;;2,0;;;17,0;6,0;;1,0;4,0;;;24,0;;2,0;28,0;2,0;;;;;3,0;3,0;2,0;9,0;3,0;;;;;;;15,0;;;;3,0;;1,0;2,0;;;;;;;;;;1,0;;4,0;;45,0;9,0;;;;;;;;;;;;;;;;;4,0;;;4,0;;;;;;1,0;2,0;;;;;;;1,0;;;;24,0;15,0;;23,0;;;;;;;;;;;;;;1,0;;1,0;;1,0;1,0;;;2,0;;;;;;1,0;;7,0;10,0;;;;;;;;;;3,0;;2,0;3,0;;16,0;3,0;;;;;;;;;;;;5,0;;2,0;;;;;;;;;;;;;;;;;;;;6,0;;;;;;1,0;;;;;;;;;;;;;;;;4,0;7,0;16,0;;2,0;27,0;;;;;;;;;;;;;;;;;;;;;;;;;;;;1,0;1,0;;1,0;;;;;;;3,0;9,0;;;1,0;;;33,0;;;;;;;;;20,0;;1,0;;;3,0;;;;;;24,0;56,0;1,0;;31,0;;4,0;;;;2,0;;;;;;;;1,0;;1,0;;;;;1,0;;;;11,0;1,0;;11,0;3,0;;5,0;;;;;;;;;;;;;;;;;;1,0;;;;;1,0;;2,0;;9,0;;;;;;;;;;23,0;;;;;;;;;;;2,0;;;;;2,0;;;;;;;2,0;;;;;;;;;;;;;;1,0;;;;;;;1,0;;;;1,0;;;;12,0;;;;;;;27,0;2,0;;;;;11,0;;;;;;;;;;1,0;;3,0;;;1,0;3,0;;;;;2,0;;;2,0;;;2,0;4,0;;1,0;;;;;;1,0;;;;4,0;;;1,0;;;;;;;;;;;1,0;;;;;;;;;
calibrate;1,0;;;;1,0;5,0;;47,0;3,0;;6,0;;;;3,0;14,0;;9,0;1,0;;80,0;26,0;;;4,0;4,0;25,0;3,0;;;10,0;;26,0;;28,0;;2,0;8,0;;;29,0;;1,0;2,0;8,0;2,0;5,0;41,0;;78,0;2,0;6,0;;;4,0;;3,0;4,0;7,0;;;1,0;8,0;1,0;3,0;2,0;6,0;3,0;12,0;;7,0;;4,0;;;;3,0;;2,0;111,0;;16,0;;32,0;;3,0;;;;2,0;18,0;;;1,0;12,0;4,0;2,0;;185,0;2,0;12,0;;32,0;20,0;;6,0;1,0;6,0;8,0;38,0;;13,0;;;;19,0;4,0;11,0;;3,0;1,0;;9,0;5,0;8,0;5,0;;;;2,0;;23,0;9,0;2,0;;;1,0;19,0;;;5,0;;;3,0;5,0;3,0;;;19,0;;;;2,0;6,0;;;116,0;;1,0;;1,0;10,0;21,0;;;12,0;35,0;9,0;1,0;;;;;2,0;2,0;;2,0;;;1,0;26,0;;;;;;;;;;;;;1,0;;;;;;;;2,0;2,0;5,0;5,0;;;5,0;;;;;;;;;;;6,0;;;;;;;;;;21,0;;;;;2,0;1,0;5,0;1,0;;;;;;;;6,0;;;;5,0;3,0;;;;1,0;;1,0;9,0;;;;;1,0;;9,0;;;;;;;;12,0;1,0;;;;2,0;;;2,0;1,0;;;1,0;;5,0;;7,0;1,0;;14,0;2,0;;;;;;;;;3,0;1,0;;;;;;;;;;;1,0;;;;;;;9,0;;;;;;;1,0;;;;;;1,0;1,0;;2,0;;1,0;;;;;;;2,0;;1,0;;;10,0;;2,0;;;;;2,0;15,0;;;;5,0;;;;;;;;;;;;;;;4,0;;;15,0;;;;;;;;;3,0;;;10,0;2,0;;;1,0;;;;;;;;1,0;1,0;;;;;2,0;;;1,0;;4,0;3,0;5,0;;;;;;;;;;1,0;3,0;;2,0;1,0;10,0;;5,0;6,0;;12,0;5,0;;;9,0;;;2,0;10,0;13,0;8,0;;5,0;;;;2,0;1,0;;3,0;1,0;1,0;1,0;;;;;;;;;;4,0;1,0;;1,0;;;4,0;;7,0;;2,0;;2,0;;1,0;2,0;27,0;;;;4,0;4,0;;;;6,0;;1,0;;;1,0;;;;;;4,0;;;;;;1,0;1,0;;;1,0;1,0;;;;1,0;2,0;1,0;;5,0;;4,0;;;;1,0;;;;;2,0;;;;;;;;;1,0;;2,0;5,0;;;;;;12,0;;;1,0;;;;1,0;;2,0;;8,0;;;;;;4,0;3,0;4,0;1,0;;;;;;1,0;;;;;;;;;;;;;;;;3,0;3,0;;;2,0;;;;1,0;;;;;;;;;1,0;;;;;;;;;;;;;;;;;;;;;;1,0;2,0;;;;;;1,0;1,0;2,0;1,0;;;12,0;;2,0;;;;;;;;;;;;;;;;;;;;;;3,0;;;;1,0;;;;1,0;;;;;;;;;;;;;4,0;;;;;;1,0;;;;;;;;;;;;;;;;;;;;;;;;;;;;;;;;1,0;;;1,0;;;;4,0;;;;;;;1,0;;;;;;;;;;;;;;;1,0;;;;;;;4,0;;;;;;;;2,0;;1,0;;;19,0;3,0;;4,0;;;;4,0;;;;2,0;;1,0;2,0;1,0;;;;;1,0;8,0;2,0;9,0;;3,0;;;;;;;3,0;1,0;;;;;;;;;1,0;;;1,0;;;;2,0;;;;2,0;;;;9,0;;;;;;2,0;4,0;;;;;;;;;;;3,0;5,0;;;;2,0;;;;;1,0;;;1,0;;;;;1,0;;;;;;;;;;1,0;;;;;;1,0;;;1,0;;;;4,0;;;;1,0;;;;;;2,0;;;;;;;;2,0;;;;3,0;;;;;;1,0;2,0;;;;6,0;;;;;;;;;;;6,0;;;;;;18,0;;7,0;;;;;;;;;;;;;;;;;;;;;;;1,0;;;;;9,0;;;;1,0;;;;;;;;;;;;;;;;;;;;;
calibration;9,0;;11,0;;;53,0;6,0;102,0;24,0;25,0;7,0;;13,0;3,0;10,0;140,0;1,0;11,0;5,0;80,0;;84,0;5,0;;7,0;8,0;72,0;22,0;;1,0;10,0;7,0;111,0;10,0;97,0;9,0;17,0;18,0;1,0;1,0;155,0;2,0;6,0;12,0;83,0;12,0;149,0;168,0;5,0;94,0;19,0;71,0;16,0;;3,0;13,0;75,0;11,0;47,0;2,0;15,0;5,0;14,0;;7,0;6,0;55,0;19,0;38,0;;21,0;;62,0;5,0;17,0;31,0;20,0;10,0;1,0;542,0;4,0;45,0;2,0;175,0;;12,0;;;1,0;5,0;56,0;;;4,0;33,0;9,0;7,0;;273,0;2,0;8,0;7,0;83,0;151,0;1,0;;9,0;;18,0;278,0;9,0;83,0;;1,0;3,0;199,0;50,0;204,0;;53,0;3,0;;38,0;17,0;29,0;23,0;3,0;;1,0;30,0;2,0;63,0;41,0;2,0;8,0;;35,0;31,0;2,0;;11,0;;;31,0;54,0;;;34,0;18,0;4,0;1,0;;8,0;58,0;3,0;4,0;257,0;;10,0;1,0;7,0;10,0;87,0;1,0;;11,0;27,0;60,0;;2,0;2,0;;;5,0;15,0;22,0;21,0;;;;8,0;7,0;;;9,0;;;3,0;;;;;;1,0;;1,0;;3,0;1,0;6,0;;1,0;13,0;23,0;20,0;;;2,0;1,0;8,0;;;;;;;;;;;;3,0;;;2,0;;;;19,0;1,0;1,0;;;42,0;5,0;11,0;9,0;;;;4,0;;;1,0;10,0;;;19,0;6,0;37,0;;;1,0;;;;40,0;2,0;42,0;;;;2,0;29,0;;;7,0;;;;;35,0;23,0;;;;1,0;6,0;;88,0;12,0;4,0;1,0;16,0;;26,0;;12,0;1,0;2,0;67,0;10,0;;;9,0;;;;;;3,0;10,0;1,0;;;;2,0;;;1,0;;1,0;;2,0;1,0;1,0;;;;17,0;;;;;1,0;;5,0;3,0;;;;;;;;4,0;;;;;;;1,0;;1,0;1,0;1,0;2,0;18,0;205,0;;;3,0;;;10,0;13,0;340,0;;;1,0;42,0;;;;;;3,0;;1,0;13,0;;;1,0;;8,0;6,0;;7,0;21,0;1,0;;;;35,0;42,0;;;;9,0;2,0;163,0;21,0;24,0;2,0;;;1,0;;;1,0;3,0;;11,0;;;;2,0;7,0;113,0;17,0;6,0;2,0;;19,0;;19,0;1,0;;1,0;;;2,0;7,0;;8,0;1,0;54,0;8,0;5,0;;21,0;11,0;2,0;41,0;;9,0;22,0;15,0;;5,0;2,0;4,0;;7,0;2,0;19,0;;7,0;1,0;2,0;4,0;3,0;2,0;1,0;15,0;4,0;;14,0;;4,0;;;8,0;;1,0;;;2,0;8,0;3,0;5,0;;29,0;20,0;;8,0;;;;32,0;3,0;;11,0;133,0;;;16,0;5,0;5,0;;5,0;2,0;13,0;14,0;;1,0;;12,0;6,0;5,0;;;42,0;;;17,0;1,0;;10,0;18,0;8,0;;;;;5,0;;;1,0;2,0;;;30,0;1,0;;;;;3,0;;;3,0;;1,0;;11,0;7,0;1,0;4,0;;;4,0;13,0;;9,0;25,0;3,0;;;;;14,0;4,0;;7,0;;;;;;;;4,0;2,0;1,0;;3,0;;4,0;4,0;1,0;4,0;;1,0;3,0;3,0;;;;4,0;2,0;;;;3,0;;;;2,0;7,0;;;2,0;2,0;1,0;;;2,0;;9,0;1,0;7,0;;;5,0;;;;;;11,0;1,0;;;;;2,0;;;1,0;4,0;3,0;5,0;;;87,0;5,0;;1,0;1,0;;;9,0;;;2,0;;2,0;;6,0;7,0;2,0;;;;1,0;;1,0;;;;;1,0;;;10,0;4,0;;;;;;2,0;;19,0;;2,0;;;3,0;;;;;;;;;9,0;;;;;;11,0;2,0;;;;;99,0;;;;2,0;11,0;;;;;;;11,0;2,0;6,0;;;;1,0;;;1,0;4,0;3,0;;;;;;;;;;;;;1,0;;21,0;1,0;;4,0;;4,0;;43,0;3,0;;;1,0;;;;;;;10,0;;;;;1,0;;;1,0;;;4,0;;;;;;;12,0;;;;;;;1,0;22,0;;;2,0;7,0;29,0;;26,0;;;;1,0;5,0;2,0;;5,0;9,0;;19,0;11,0;11,0;1,0;;;;5,0;4,0;5,0;44,0;5,0;4,0;;17,0;1,0;;;3,0;10,0;5,0;;;;4,0;5,0;;;4,0;17,0;4,0;4,0;;;1,0;5,0;5,0;;2,0;;5,0;27,0;;6,0;6,0;;;;;;20,0;6,0;;;;1,0;6,0;;;;;;1,0;11,0;;;;2,0;;;6,0;;;;8,0;;;;6,0;;2,0;2,0;;;;;;;;;4,0;1,0;;3,0;;;14,0;;2,0;2,0;10,0;3,0;;;;;;10,0;2,0;6,0;;3,0;;12,0;;;;;;;;8,0;;1,0;2,0;2,0;;4,0;6,0;;;;35,0;;;;5,0;;;14,0;;1,0;1,0;1,0;;;;;;;;;;58,0;;26,0;;;15,0;;;;;;;;2,0;;;2,0;;;1,0;;;2,0;;;;;;1,0;;1,0;;1,0;;;7,0;4,0;3,0;1,0;52,0;;18,0;15,0;;;;;;;;;;;;;
capture;6,0;3,0;2,0;12,0;79,0;74,0;84,0;323,0;244,0;64,0;104,0;;185,0;30,0;56,0;320,0;19,0;25,0;39,0;26,0;84,0;;11,0;20,0;2,0;6,0;124,0;25,0;1,0;6,0;58,0;33,0;638,0;38,0;399,0;109,0;23,0;12,0;38,0;;1078,0;24,0;15,0;115,0;207,0;56,0;402,0;1962,0;777,0;570,0;40,0;129,0;15,0;12,0;26,0;48,0;347,0;9,0;54,0;17,0;27,0;17,0;173,0;58,0;104,0;45,0;110,0;103,0;791,0;23,0;61,0;71,0;309,0;7,0;2,0;34,0;116,0;35,0;72,0;11661,0;117,0;501,0;21,0;658,0;66,0;143,0;5,0;;3,0;56,0;524,0;2,0;7,0;8,0;28,0;56,0;102,0;15,0;1037,0;116,0;25,0;48,0;380,0;644,0;7,0;73,0;255,0;54,0;201,0;158,0;14,0;164,0;5,0;1,0;5,0;578,0;376,0;368,0;23,0;127,0;8,0;;154,0;306,0;203,0;42,0;2,0;15,0;19,0;104,0;8,0;110,0;60,0;8,0;82,0;120,0;83,0;141,0;30,0;3,0;702,0;1,0;47,0;808,0;160,0;7,0;;58,0;382,0;47,0;40,0;3,0;83,0;314,0;330,0;4,0;784,0;;17,0;56,0;28,0;179,0;998,0;5,0;6,0;2,0;927,0;345,0;74,0;15,0;33,0;;4,0;31,0;70,0;20,0;52,0;22,0;;4,0;32,0;69,0;8,0;2,0;4,0;80,0;;98,0;17,0;;21,0;27,0;;34,0;4,0;26,0;82,0;2,0;;10,0;2,0;2,0;19,0;138,0;3,0;9,0;;33,0;145,0;109,0;4,0;51,0;1,0;;4,0;5,0;;;3,0;6,0;97,0;16,0;1,0;3,0;3,0;2,0;1,0;;400,0;11,0;51,0;3,0;11,0;92,0;27,0;29,0;106,0;24,0;13,0;4,0;32,0;16,0;15,0;42,0;24,0;;16,0;70,0;300,0;60,0;18,0;1,0;;6,0;;4,0;408,0;20,0;;4,0;;1,0;3,0;168,0;;14,0;19,0;9,0;42,0;;1,0;91,0;41,0;;10,0;3,0;72,0;11,0;47,0;296,0;54,0;11,0;26,0;6,0;;386,0;10,0;14,0;;2,0;167,0;9,0;4,0;2,0;3,0;1,0;12,0;2,0;4,0;;4,0;19,0;19,0;5,0;21,0;4,0;;61,0;27,0;5,0;19,0;16,0;6,0;;22,0;59,0;;10,0;;68,0;9,0;5,0;3,0;;35,0;5,0;2,0;;29,0;11,0;;;2,0;1,0;;15,0;23,0;20,0;14,0;7,0;1,0;;3,0;14,0;16,0;4,0;10,0;7,0;11,0;99,0;;2,0;15,0;43,0;2,0;5,0;26,0;91,0;55,0;3,0;25,0;49,0;;5,0;9,0;1,0;;6,0;12,0;5,0;1,0;9,0;4,0;43,0;18,0;2,0;;5,0;45,0;37,0;;1,0;27,0;1,0;15,0;38,0;;2,0;;41,0;12,0;222,0;51,0;9,0;2,0;41,0;3,0;3,0;11,0;14,0;4,0;9,0;20,0;72,0;11,0;;;6,0;18,0;82,0;111,0;43,0;73,0;10,0;110,0;2,0;10,0;28,0;36,0;7,0;;10,0;30,0;41,0;11,0;8,0;29,0;88,0;9,0;14,0;2,0;159,0;86,0;4,0;187,0;;43,0;53,0;359,0;2,0;120,0;325,0;176,0;1,0;43,0;48,0;173,0;6,0;47,0;49,0;80,0;2,0;;20,0;106,0;161,0;10,0;22,0;;18,0;24,0;6,0;14,0;14,0;22,0;;27,0;6,0;49,0;59,0;14,0;8,0;78,0;10,0;290,0;7,0;29,0;2,0;;;119,0;29,0;56,0;33,0;42,0;2,0;15,0;29,0;19,0;64,0;2,0;72,0;25,0;34,0;8,0;17,0;22,0;29,0;55,0;27,0;32,0;33,0;35,0;113,0;208,0;1,0;9,0;7,0;45,0;11,0;30,0;56,0;1,0;9,0;54,0;26,0;5,0;2,0;11,0;2,0;23,0;73,0;11,0;34,0;15,0;15,0;90,0;2,0;7,0;23,0;14,0;17,0;66,0;11,0;1,0;9,0;58,0;22,0;55,0;27,0;54,0;10,0;94,0;4,0;38,0;61,0;18,0;36,0;;35,0;1,0;;83,0;95,0;3,0;17,0;6,0;11,0;1,0;63,0;14,0;3,0;11,0;40,0;6,0;59,0;6,0;37,0;18,0;4,0;32,0;7,0;34,0;;14,0;49,0;3,0;6,0;6,0;7,0;12,0;5,0;8,0;36,0;78,0;14,0;;28,0;1,0;11,0;9,0;19,0;;22,0;8,0;;6,0;12,0;32,0;;29,0;3,0;82,0;23,0;;131,0;21,0;;;10,0;4,0;13,0;20,0;;3,0;6,0;3,0;10,0;;7,0;4,0;28,0;2,0;21,0;34,0;25,0;145,0;9,0;4,0;6,0;3,0;;3,0;45,0;33,0;6,0;13,0;2,0;2,0;4,0;42,0;21,0;40,0;15,0;10,0;8,0;;;51,0;6,0;;41,0;4,0;2,0;23,0;2,0;1,0;5,0;10,0;;;10,0;1,0;5,0;8,0;14,0;;12,0;1,0;22,0;23,0;5,0;3,0;25,0;3,0;;;;21,0;2,0;;8,0;60,0;2,0;;6,0;28,0;13,0;20,0;1,0;3,0;26,0;;;4,0;27,0;3,0;12,0;17,0;4,0;;4,0;10,0;7,0;;;74,0;15,0;1,0;;1,0;4,0;2,0;1,0;4,0;;3,0;;;;;4,0;2,0;2,0;21,0;2,0;;2,0;1,0;3,0;20,0;25,0;22,0;17,0;13,0;1,0;19,0;11,0;4,0;9,0;18,0;;2,0;5,0;1,0;;6,0;;;4,0;;4,0;4,0;1,0;11,0;20,0;3,0;;18,0;2,0;2,0;;2,0;8,0;10,0;43,0;20,0;4,0;;14,0;2,0;;68,0;58,0;;3,0;;1,0;3,0;20,0;6,0;41,0;;33,0;6,0;15,0;48,0;5,0;18,0;248,0;46,0;2,0;;13,0;21,0;;;;11,0;13,0;25,0;21,0;6,0;1,0;23,0;4,0;1,0;2,0;31,0;11,0;18,0;16,0;;39,0;1,0;4,0;21,0;3,0;;4,0;47,0;13,0;15,0;7,0;19,0;;13,0;7,0;;1,0;5,0;39,0;1,0;3,0;15,0;21,0;28,0;;;6,0;8,0;8,0;7,0;32,0;17,0;6,0;13,0;11,0;2,0;;4,0;8,0;34,0;2,0;4,0;34,0;17,0;10,0;28,0;2,0;1,0;4,0;1,0;12,0;6,0;57,0;2,0;4,0;15,0;;5,0;15,0;4,0;;3,0;;2,0;2,0;1,0;1,0;1,0;6,0;;3,0;1,0;17,0;5,0;19,0;8,0;;9,0;55,0;17,0;;2,0;9,0;7,0;9,0;25,0;8,0;2,0;6,0;4,0;2,0;50,0;;1,0;;13,0;;;6,0;9,0;;9,0;2,0;45,0;5,0;;6,0;10,0;;;22,0;;48,0;;;;;5,0;1,0;16,0;11,0;14,0;;;1,0;33,0;7,0;4,0;21,0;;8,0;10,0;2,0;14,0;;2,0;6,0;1,0;14,0;6,0;20,0;5,0;;;8,0;;6,0;21,0;2,0;8,0;9,0;26,0;18,0;36,0;5,0;;4,0;;2,0;8,0;1,0;;2,0;;25,0;6,0;1,0;13,0;45,0;;2,0;2,0;5,0;1,0;2,0;7,0;;1,0;1,0;12,0;1,0;6,0;;;;5,0;
changing;2,0;;2,0;;;53,0;36,0;19,0;30,0;1,0;;;6,0;13,0;6,0;19,0;4,0;1,0;7,0;;5,0;11,0;;;;3,0;30,0;1,0;;10,0;;35,0;37,0;4,0;80,0;3,0;3,0;7,0;2,0;;27,0;3,0;12,0;10,0;20,0;2,0;6,0;61,0;9,0;55,0;;55,0;2,0;;39,0;3,0;15,0;;;1,0;;1,0;4,0;1,0;1,0;14,0;54,0;;22,0;;11,0;;11,0;;;8,0;;;14,0;142,0;6,0;21,0;;48,0;3,0;21,0;9,0;6,0;;10,0;112,0;;;;;3,0;5,0;;83,0;5,0;1,0;;6,0;15,0;;4,0;46,0;6,0;22,0;36,0;1,0;46,0;1,0;3,0;1,0;35,0;32,0;72,0;29,0;29,0;2,0;1,0;76,0;19,0;14,0;7,0;13,0;;;6,0;;18,0;7,0;;2,0;21,0;;14,0;;2,0;5,0;;1,0;32,0;23,0;;;11,0;64,0;62,0;;1,0;10,0;6,0;9,0;2,0;28,0;;16,0;10,0;;;145,0;1,0;6,0;;7,0;19,0;2,0;;93,0;;;3,0;53,0;4,0;;;;;;29,0;;;;2,0;;2,0;;;;5,0;;11,0;;4,0;4,0;1,0;;2,0;;;2,0;30,0;;;;;7,0;2,0;1,0;1,0;;;;;;1,0;1,0;1,0;2,0;;;;;;1,0;;57,0;;25,0;;;1,0;1,0;2,0;6,0;2,0;;1,0;1,0;1,0;;2,0;2,0;;;4,0;19,0;3,0;1,0;1,0;;1,0;1,0;2,0;22,0;;;;;;;33,0;;;25,0;;19,0;;;6,0;14,0;;4,0;;6,0;;;6,0;12,0;;5,0;;;52,0;1,0;1,0;;;5,0;10,0;1,0;;;;2,0;;;;1,0;;;;;;;;;;;;;;1,0;;;;;;;;1,0;;14,0;;;6,0;2,0;;;;;;;13,0;;2,0;1,0;;;;1,0;1,0;26,0;4,0;3,0;;22,0;18,0;;3,0;1,0;6,0;;1,0;1,0;20,0;;;;1,0;;1,0;;;4,0;;;;4,0;1,0;;;;;;;3,0;8,0;;;;1,0;;2,0;;;20,0;4,0;;22,0;;;;2,0;;;2,0;;;;;2,0;;;;;1,0;;70,0;3,0;13,0;1,0;3,0;2,0;;2,0;2,0;;;;8,0;4,0;;1,0;5,0;3,0;;;;26,0;10,0;2,0;7,0;;2,0;;58,0;1,0;1,0;4,0;5,0;2,0;3,0;28,0;31,0;5,0;17,0;3,0;3,0;5,0;;15,0;11,0;1,0;16,0;3,0;;;1,0;;1,0;7,0;;;;3,0;13,0;10,0;;;;;22,0;;;1,0;5,0;;20,0;;;5,0;1,0;;;;2,0;;;2,0;4,0;17,0;14,0;;;13,0;12,0;2,0;8,0;;;12,0;;;3,0;;6,0;3,0;;10,0;;4,0;;;;;;;;2,0;1,0;18,0;3,0;1,0;1,0;6,0;;;;2,0;11,0;;;;5,0;;;20,0;;;1,0;;5,0;;10,0;1,0;;9,0;;;3,0;2,0;16,0;;;;;1,0;;2,0;1,0;1,0;;2,0;1,0;15,0;;1,0;;2,0;;;;;;;1,0;;;;;;6,0;;;1,0;;1,0;;;;;;;;1,0;;;2,0;;6,0;;;;8,0;;;9,0;;2,0;1,0;;4,0;;;;6,0;3,0;1,0;;;;;;7,0;2,0;;7,0;1,0;;1,0;;;;;;;2,0;;;;;;;;;25,0;3,0;;;;;5,0;;1,0;;;;;3,0;4,0;;9,0;1,0;;3,0;1,0;19,0;2,0;;13,0;;;;;;;;1,0;;1,0;1,0;;2,0;;;;;;4,0;3,0;;1,0;2,0;;2,0;2,0;;;;;;;;1,0;5,0;;;;;;;;;;;;;6,0;;4,0;;;;;;1,0;11,0;;;1,0;;9,0;2,0;7,0;3,0;;;;1,0;;7,0;;;;;;;1,0;;;;;1,0;;;2,0;7,0;;2,0;;5,0;;;2,0;11,0;2,0;;;3,0;;3,0;;2,0;;;3,0;;;4,0;;;;9,0;;;3,0;7,0;;1,0;;;2,0;;1,0;;;1,0;;1,0;;4,0;5,0;;1,0;2,0;15,0;1,0;26,0;3,0;;3,0;;1,0;;;;;2,0;4,0;;3,0;5,0;;;;;;;5,0;;;6,0;1,0;;;;;;;;5,0;;;;;;;;4,0;;;1,0;1,0;;;;;8,0;;;;1,0;1,0;1,0;;;;;;3,0;1,0;;1,0;2,0;;;1,0;;;6,0;;;;;7,0;;;;2,0;12,0;;2,0;;;;10,0;;;;1,0;;;;;;;;;;3,0;;;;2,0;;1,0;;;;;2,0;;2,0;;4,0;12,0;;1,0;;;8,0;1,0;;6,0;;2,0;;;3,0;;;;;;;3,0;;1,0;2,0;;;;;;;;;5,0;;;;27,0;1,0;;;;6,0;;;;;;;;3,0;;;;1,0;;;;;2,0;;;;1,0;;;;;;;;1,0;
channel;1,0;3,0;1,0;;;6,0;11,0;7,0;55,0;36,0;24,0;1,0;13,0;;3,0;33,0;1,0;4,0;;;;20,0;;;;6,0;84,0;2,0;;;28,0;;90,0;;71,0;6,0;4,0;;;;84,0;;38,0;7,0;5,0;1,0;8,0;59,0;10,0;17,0;33,0;6,0;;3,0;2,0;1,0;32,0;;;1,0;81,0;4,0;21,0;;43,0;3,0;7,0;76,0;10,0;29,0;4,0;2,0;15,0;;;3,0;1,0;;3,0;149,0;17,0;12,0;2,0;78,0;;4,0;;;3,0;16,0;62,0;3,0;;5,0;5,0;3,0;3,0;;66,0;13,0;;;70,0;7,0;;1,0;163,0;;12,0;7,0;1,0;8,0;3,0;;;107,0;106,0;14,0;2,0;1,0;1,0;;;14,0;42,0;15,0;;;;;2,0;;4,0;4,0;;;33,0;70,0;;;;3,0;;20,0;12,0;2,0;;56,0;31,0;4,0;2,0;13,0;4,0;4,0;1,0;4,0;34,0;;;214,0;3,0;57,0;24,0;;;;13,0;7,0;2,0;;1,0;;;20,0;;3,0;20,0;3,0;3,0;8,0;2,0;8,0;;11,0;100,0;13,0;6,0;28,0;;;1,0;;;56,0;;2,0;5,0;;;9,0;1,0;;3,0;23,0;;;63,0;;;13,0;;2,0;3,0;33,0;1,0;11,0;2,0;2,0;;1,0;41,0;2,0;8,0;18,0;;11,0;4,0;;21,0;1,0;14,0;2,0;;25,0;8,0;3,0;;54,0;5,0;12,0;4,0;32,0;11,0;9,0;2,0;2,0;2,0;;55,0;10,0;8,0;1,0;1,0;;;;68,0;;;;;;5,0;7,0;6,0;;2,0;;;;21,0;5,0;13,0;;;;;5,0;14,0;62,0;3,0;7,0;5,0;;;11,0;8,0;8,0;4,0;;3,0;41,0;2,0;;15,0;13,0;1,0;;14,0;;;7,0;6,0;18,0;;;3,0;2,0;2,0;2,0;3,0;;;1,0;2,0;4,0;2,0;7,0;;32,0;8,0;;2,0;21,0;3,0;2,0;9,0;1,0;;;;3,0;3,0;90,0;;15,0;;6,0;;6,0;5,0;;1,0;8,0;1,0;1,0;1,0;1,0;10,0;;1,0;6,0;;4,0;;8,0;;1,0;;;;5,0;1,0;1,0;9,0;24,0;;;32,0;;4,0;1,0;1,0;;;;;2,0;;1,0;1,0;2,0;;1,0;;6,0;10,0;8,0;1,0;14,0;3,0;3,0;;;2,0;28,0;5,0;21,0;;;;;3,0;10,0;4,0;;1,0;;;6,0;1,0;;1,0;1,0;10,0;1,0;2,0;1,0;;;;;17,0;;;1,0;2,0;2,0;;1,0;;3,0;3,0;1,0;1,0;;2,0;1,0;1,0;2,0;2,0;;13,0;;2,0;15,0;4,0;;;3,0;;;;;4,0;1,0;5,0;2,0;;11,0;5,0;;;;;;;;12,0;12,0;;1,0;;2,0;3,0;4,0;4,0;;2,0;86,0;2,0;7,0;;1,0;;;;;;;7,0;;;;1,0;;;1,0;8,0;;1,0;;;;;;;;29,0;;;14,0;;;3,0;;8,0;1,0;;;;;6,0;1,0;;;3,0;3,0;;;;;;20,0;;1,0;10,0;;1,0;;;;;1,0;;5,0;;72,0;;;3,0;;2,0;;11,0;5,0;;1,0;1,0;;20,0;4,0;3,0;4,0;1,0;;8,0;83,0;2,0;;;;2,0;;;4,0;;;;;1,0;2,0;;;3,0;4,0;;;;;;;;1,0;;;;;47,0;;19,0;;4,0;91,0;;12,0;;3,0;2,0;;;;2,0;;5,0;;;;;3,0;28,0;;;;;;99,0;1,0;;;4,0;;;21,0;4,0;14,0;2,0;2,0;;7,0;1,0;;2,0;;;1,0;2,0;5,0;;;;65,0;;;4,0;4,0;;;;;;12,0;;1,0;3,0;1,0;;1,0;;;;2,0;1,0;;2,0;10,0;;;1,0;;;;;1,0;;19,0;;7,0;;;;;;;;1,0;2,0;1,0;;8,0;;;2,0;;2,0;1,0;1,0;;1,0;8,0;2,0;;;36,0;;;;;8,0;11,0;;8,0;;7,0;;;3,0;5,0;3,0;6,0;;;;;2,0;;38,0;;;;;12,0;;3,0;7,0;;;;;;25,0;;;2,0;;;;;9,0;34,0;;4,0;9,0;;6,0;;;2,0;5,0;1,0;12,0;47,0;3,0;;10,0;12,0;8,0;1,0;;1,0;;4,0;;1,0;;;2,0;;6,0;;;;93,0;3,0;;2,0;9,0;;17,0;;1,0;;8,0;;;;1,0;;1,0;;;;;;;2,0;;;;;34,0;;;;;;;;;;1,0;1,0;;2,0;;2,0;1,0;;;;;;;;;;;1,0;;;;;;;;;;;;;1,0;2,0;;;;;;;;2,0;;;1,0;;;;;;1,0;2,0;;3,0;;5,0;3,0;;5,0;;1,0;;;;;;;;;;;4,0;;;1,0;;;;;;;1,0;;;;;1,0;;4,0;12,0;;;;;;1,0;;;;;;;;;;;1,0;;1,0;;;;;;;1,0;1,0;;;;;2,0;;;;;;;;;;;;1,0;2,0;18,0;;;;1,0;;;;;1,0;;;;;;1,0;;;;;;1,0;;;;;6,0;;;;1,0;;;;;;
characterize;2,0;;;;;4,0;2,0;2,0;21,0;4,0;14,0;;1,0;;4,0;5,0;;1,0;3,0;4,0;7,0;2,0;;;;;4,0;;;;;1,0;2,0;;62,0;1,0;;1,0;;;35,0;;;;6,0;;23,0;83,0;2,0;29,0;1,0;;;;1,0;3,0;5,0;;3,0;;8,0;;5,0;;5,0;3,0;10,0;11,0;12,0;3,0;5,0;;3,0;;;1,0;6,0;4,0;5,0;51,0;3,0;30,0;;32,0;;;3,0;;;2,0;16,0;;;1,0;4,0;1,0;7,0;;53,0;3,0;;;23,0;18,0;;;5,0;2,0;4,0;3,0;;1,0;;;;9,0;13,0;13,0;;;;;1,0;3,0;3,0;16,0;2,0;;;3,0;;;;1,0;2,0;3,0;8,0;;;;6,0;;;7,0;3,0;;;4,0;6,0;;2,0;;2,0;8,0;;;37,0;;9,0;1,0;;1,0;15,0;;3,0;;2,0;2,0;;;10,0;;3,0;;;1,0;11,0;1,0;;;;1,0;;4,0;;1,0;;19,0;;2,0;;;;5,0;;;1,0;;;6,0;1,0;3,0;2,0;17,0;;1,0;;;3,0;;1,0;;;;1,0;;1,0;;;1,0;1,0;;;;;;;;13,0;;3,0;;;6,0;;;4,0;;1,0;2,0;;9,0;;1,0;;6,0;;;17,0;1,0;;;;;;;;;;;;10,0;;4,0;;;2,0;;;;6,0;2,0;;;;16,0;;7,0;;26,0;1,0;;;;;5,0;;1,0;1,0;;5,0;;;;;;;;1,0;;11,0;4,0;2,0;;;;;2,0;1,0;1,0;;;1,0;;;;;;;2,0;;;6,0;;5,0;;;;1,0;;10,0;;;;;12,0;3,0;13,0;;3,0;;;4,0;;;;5,0;1,0;;;1,0;;;;;1,0;;14,0;;;4,0;1,0;;;;;;;2,0;;1,0;;;;;;;;;;1,0;3,0;1,0;;2,0;;;;1,0;2,0;;5,0;2,0;;;7,0;;1,0;;3,0;;;;15,0;;;;;;5,0;3,0;16,0;1,0;;;1,0;;1,0;;;;;1,0;;1,0;;1,0;20,0;;6,0;;1,0;1,0;13,0;3,0;2,0;;;;;;1,0;2,0;;;5,0;;;9,0;;;1,0;;1,0;;3,0;;;;;1,0;;;;;;;;7,0;2,0;;;1,0;;1,0;;2,0;;;;8,0;;;;30,0;;;1,0;;;;;;;;;;1,0;1,0;;1,0;;;;;;;;1,0;;1,0;1,0;;;;;1,0;;;;5,0;;;4,0;;;;1,0;;;;;;;;2,0;;;;;;;;;;;;;;2,0;;;33,0;;2,0;10,0;;;2,0;;;;4,0;14,0;2,0;2,0;;;;;;;;;;;1,0;;;;3,0;;;1,0;5,0;9,0;;;;;;;;;;;;3,0;;;1,0;;;1,0;;;;;;;;1,0;1,0;;;;;14,0;;;;;;;;;10,0;1,0;;;1,0;;;1,0;;;2,0;7,0;;;;;;;3,0;;1,0;;;;;;2,0;;1,0;;;2,0;;;2,0;;;5,0;;1,0;;5,0;;2,0;2,0;;2,0;;;;;;;;1,0;;;;1,0;;;;;;;;1,0;;;;;;;1,0;;;;;;;;1,0;;;;;;;;;;;;;;3,0;;;;3,0;;;;;;;;;3,0;;;1,0;1,0;;;;;2,0;;11,0;;;12,0;;;;;;;;;;;;;;;3,0;;;;6,0;5,0;;;;4,0;4,0;;;;;;1,0;;;;;;;;;;4,0;2,0;10,0;;;;;;;;;;;;1,0;14,0;;2,0;;;;1,0;;;;;;;;;;;;;;;;;;;;;13,0;;;;;;;;;;;;;;;1,0;1,0;;;;;;;;;;3,0;2,0;1,0;;;;;;1,0;;;;;;5,0;;;;5,0;;;;;;;;;;;;;;;;;;;;;;;6,0;;;;;;;;;;;;;;;;;;;1,0;;1,0;;;1,0;;3,0;;;;;;1,0;4,0;;;;;;;;;;;;;;1,0;;;4,0;1,0;;4,0;;;;;;;;;;;;;;;1,0;;;;;;;;;;;;;;;;;;;;;;;;;;;;;;;;;
coefficient;3,0;;;;4,0;;1,0;17,0;16,0;3,0;9,0;2,0;;;;23,0;;1,0;4,0;4,0;8,0;6,0;3,0;6,0;;;73,0;;;;1,0;6,0;19,0;;1,0;;72,0;101,0;;;13,0;7,0;1,0;2,0;6,0;;52,0;17,0;25,0;3,0;;5,0;25,0;1,0;;24,0;3,0;4,0;9,0;;;;1,0;;9,0;2,0;2,0;3,0;12,0;;8,0;;6,0;;;52,0;10,0;;1,0;68,0;;10,0;;24,0;1,0;;1,0;2,0;;2,0;10,0;;;8,0;2,0;5,0;1,0;;34,0;;3,0;4,0;10,0;4,0;;2,0;5,0;2,0;75,0;6,0;;3,0;;;;20,0;6,0;28,0;;21,0;;;6,0;10,0;3,0;;;;;4,0;;2,0;2,0;;11,0;;16,0;;2,0;3,0;;;;7,0;19,0;;;1,0;15,0;;;;14,0;13,0;5,0;;6,0;;;;1,0;;41,0;;;;4,0;1,0;;2,0;2,0;;;;5,0;1,0;2,0;;3,0;;;3,0;;;;2,0;;18,0;;;9,0;1,0;;;;4,0;;1,0;;;;;25,0;9,0;1,0;2,0;;;13,0;13,0;1,0;;;;;;;;4,0;;;;;;;;3,0;;2,0;;5,0;;;;;;1,0;;;;1,0;2,0;;;;5,0;;2,0;17,0;;;;;;;;3,0;;;1,0;;;;38,0;;;;;;;;;6,0;;;;1,0;;1,0;11,0;;;;;;20,0;;1,0;;;2,0;2,0;;1,0;;2,0;24,0;;;;2,0;;;;;;;11,0;;;;;;;2,0;2,0;;;;;;;;;1,0;;;;;;;;1,0;;;12,0;;;2,0;;;;2,0;1,0;;;;;;;;;;7,0;3,0;;;1,0;;1,0;2,0;;;;;;;;;;4,0;;;;;;;;;;;;6,0;;;8,0;;;;;;2,0;1,0;;;6,0;;2,0;;;;;;;;;;;13,0;68,0;10,0;6,0;10,0;;1,0;4,0;;3,0;;3,0;18,0;;2,0;6,0;;2,0;;4,0;2,0;;;15,0;11,0;5,0;2,0;;4,0;1,0;;;;2,0;1,0;;;;6,0;;;;2,0;;;5,0;;;;;;;;;;2,0;;;;;3,0;1,0;;;;9,0;;;1,0;;1,0;;27,0;;2,0;;4,0;17,0;;;2,0;;;;;2,0;;;;;;;1,0;;;;;;4,0;;2,0;2,0;;;;;;;4,0;;;;2,0;;1,0;12,0;;;;;;;;;;1,0;;;6,0;;;2,0;;;;1,0;;5,0;4,0;;;;;;10,0;;;;;;;;;;;1,0;;;;;;;10,0;;;;;;;;;;;;;;1,0;35,0;;;;;;;;;;2,0;;;2,0;;2,0;;;;;;1,0;;;;;;;;;;;;;1,0;;;;;;;7,0;2,0;;;;;;;;;;;;;;;;;;2,0;;;;;;;;;;;11,0;2,0;;;;;;;36,0;;;6,0;;;2,0;;;;;;;;;;;;;;;2,0;;6,0;;;;4,0;;;;;;;;;;;;4,0;;;;5,0;;;;;;;;;;;;;;;;;;;;;;1,0;4,0;;;;2,0;;;;;1,0;;;;;;;;;;;;;;;;;;;1,0;;;11,0;;27,0;;;;;;;14,0;;;11,0;;;;;11,0;14,0;;;;;;;;;9,0;;;12,0;;;;;14,0;;;1,0;4,0;8,0;92,0;9,0;;1,0;;29,0;2,0;;1,0;;;;;;;;;11,0;;;1,0;;;1,0;9,0;;2,0;;;4,0;;;2,0;;;;;;;;;;;;;;;;;;;1,0;;;;;;;;;1,0;;;;;;;;1,0;;;;;;;;;;;;2,0;;;;;4,0;;1,0;;;;;;;;;11,0;;;;;1,0;8,0;;;;;;;;;;;;;;;1,0;;;;7,0;;;;;;6,0;;1,0;2,0;;;;;;;;;;;;;;2,0;;7,0;;;;;;;;4,0;3,0;;;;;;;2,0;;;;;;;;;;9,0;;;;;;;;;1,0;;;3,0;2,0;;;;;;;;;;;;
color;6,0;;9,0;;22,0;7,0;21,0;109,0;199,0;172,0;217,0;;52,0;2,0;23,0;228,0;10,0;4,0;44,0;25,0;72,0;124,0;30,0;84,0;4,0;73,0;;49,0;;4,0;34,0;20,0;132,0;15,0;80,0;18,0;107,0;270,0;25,0;;401,0;;32,0;49,0;128,0;50,0;322,0;261,0;123,0;202,0;39,0;40,0;3,0;42,0;12,0;77,0;409,0;8,0;53,0;4,0;8,0;;13,0;;1271,0;3,0;19,0;135,0;210,0;9,0;27,0;5,0;166,0;27,0;4,0;85,0;59,0;16,0;114,0;1722,0;10,0;163,0;5,0;368,0;17,0;47,0;;32,0;;8,0;53,0;;4,0;19,0;4,0;21,0;29,0;2,0;369,0;5,0;14,0;5,0;96,0;135,0;3,0;15,0;78,0;8,0;161,0;209,0;22,0;204,0;11,0;11,0;12,0;467,0;229,0;88,0;4,0;98,0;4,0;;55,0;137,0;64,0;20,0;4,0;4,0;8,0;127,0;;135,0;12,0;11,0;116,0;39,0;89,0;108,0;22,0;2,0;35,0;10,0;;298,0;111,0;18,0;;10,0;526,0;13,0;34,0;1,0;29,0;42,0;61,0;3,0;231,0;;3,0;4,0;23,0;46,0;444,0;12,0;6,0;;89,0;15,0;27,0;115,0;2,0;4,0;3,0;52,0;36,0;37,0;2,0;;4,0;130,0;;3,0;;;18,0;109,0;;457,0;38,0;5,0;9,0;2,0;;40,0;;4,0;6,0;4,0;19,0;14,0;;;225,0;96,0;7,0;2,0;;2,0;39,0;51,0;17,0;;;164,0;8,0;109,0;;2,0;6,0;2,0;13,0;14,0;1,0;1,0;6,0;2,0;74,0;;726,0;1,0;12,0;;2,0;6,0;;1,0;3,0;61,0;2,0;5,0;17,0;15,0;1,0;7,0;4,0;22,0;40,0;;1771,0;7,0;;2,0;;;;;56,0;9,0;;1,0;;8,0;;126,0;14,0;;16,0;;2,0;;1,0;137,0;349,0;;21,0;;4,0;24,0;12,0;39,0;48,0;;1,0;;4,0;85,0;3,0;1,0;;23,0;12,0;8,0;;;4,0;;24,0;;3,0;;2,0;14,0;;;;;1,0;38,0;;25,0;;65,0;14,0;;18,0;32,0;;;1,0;23,0;;1,0;;1,0;10,0;;;;;7,0;;;;2,0;;20,0;;6,0;3,0;;;2,0;10,0;9,0;1,0;;2,0;;3,0;146,0;20,0;8,0;11,0;19,0;;;3,0;177,0;3,0;60,0;3,0;40,0;1,0;;;;;1,0;3,0;6,0;3,0;;;6,0;;;29,0;;3,0;17,0;;;2,0;;;64,0;;2,0;2,0;2,0;7,0;167,0;135,0;2,0;;19,0;5,0;7,0;8,0;2,0;;;6,0;13,0;;1,0;;;36,0;128,0;78,0;38,0;31,0;1,0;23,0;10,0;10,0;7,0;7,0;5,0;3,0;2,0;27,0;;;49,0;1,0;19,0;19,0;22,0;2,0;158,0;93,0;48,0;49,0;2,0;56,0;58,0;76,0;2,0;50,0;14,0;16,0;;;8,0;28,0;;6,0;7,0;6,0;2,0;;12,0;23,0;26,0;3,0;19,0;;13,0;6,0;25,0;2,0;1,0;;;;;32,0;15,0;1,0;7,0;;7,0;22,0;6,0;30,0;2,0;1,0;1,0;76,0;5,0;17,0;9,0;61,0;2,0;4,0;11,0;;9,0;;1,0;;30,0;31,0;2,0;1,0;53,0;11,0;15,0;;;;65,0;36,0;;;;98,0;5,0;21,0;7,0;;;;;;;25,0;2,0;6,0;3,0;2,0;65,0;;2,0;5,0;1,0;12,0;1,0;;2,0;22,0;1,0;1,0;;36,0;3,0;3,0;5,0;;;12,0;14,0;6,0;59,0;75,0;;;20,0;8,0;;17,0;1,0;1,0;94,0;2,0;;;;;5,0;47,0;44,0;;1,0;3,0;4,0;;24,0;77,0;13,0;4,0;;1,0;4,0;;;;24,0;6,0;6,0;;3,0;46,0;74,0;;;;;7,0;21,0;;2,0;;;;7,0;3,0;1,0;38,0;1,0;4,0;1,0;;34,0;1,0;;;;;4,0;1,0;;;1,0;;;;12,0;17,0;4,0;;2,0;5,0;;125,0;10,0;;2,0;;;;56,0;;;6,0;;1,0;2,0;15,0;1,0;8,0;5,0;1,0;11,0;15,0;;6,0;1,0;2,0;1,0;2,0;;6,0;;6,0;1,0;;;;1,0;2,0;4,0;123,0;27,0;1,0;6,0;;;4,0;;97,0;3,0;1,0;5,0;;;;;;2,0;;;;73,0;8,0;7,0;;18,0;;4,0;;;;;1,0;;18,0;;;;;2,0;;;;19,0;;;;;;4,0;;;;;;;1,0;;;;3,0;;;6,0;2,0;21,0;72,0;10,0;21,0;2,0;69,0;2,0;1,0;2,0;2,0;;1,0;9,0;12,0;4,0;;;3,0;5,0;3,0;3,0;;;1,0;4,0;;;3,0;;70,0;22,0;;4,0;;2,0;25,0;;3,0;80,0;;;1,0;4,0;51,0;53,0;;;18,0;;44,0;70,0;;1,0;6,0;2,0;4,0;37,0;21,0;;74,0;24,0;5,0;16,0;5,0;;10,0;;;20,0;3,0;2,0;45,0;81,0;81,0;35,0;2,0;11,0;6,0;;72,0;6,0;8,0;50,0;;6,0;;15,0;15,0;3,0;69,0;14,0;9,0;28,0;8,0;29,0;;9,0;6,0;;6,0;7,0;;74,0;;16,0;5,0;;4,0;;;;3,0;1,0;11,0;;;;;2,0;;2,0;;;9,0;3,0;2,0;;1,0;20,0;41,0;8,0;;64,0;5,0;;9,0;78,0;1,0;;;1,0;10,0;30,0;24,0;;;;3,0;1,0;1,0;;;6,0;54,0;;8,0;8,0;1,0;10,0;;;;;;;12,0;12,0;;;412,0;;16,0;;4,0;1,0;53,0;;;;8,0;;2,0;2,0;;;;;7,0;;;9,0;;;3,0;27,0;;6,0;;3,0;5,0;;51,0;1,0;29,0;;4,0;;15,0;;4,0;4,0;;;;2,0;9,0;;6,0;;27,0;1,0;;66,0;;;4,0;;9,0;12,0;;23,0;;58,0;;78,0;7,0;;6,0;1,0;;6,0;;;7,0;1,0;4,0;4,0;12,0;;3,0;8,0;5,0;2,0;;11,0;;;2,0;261,0;1,0;2,0;5,0;;5,0;5,0;;37,0;;;;
combination;16,0;2,0;1,0;2,0;3,0;5,0;;14,0;6,0;32,0;9,0;2,0;2,0;;8,0;28,0;11,0;;;3,0;22,0;25,0;1,0;2,0;;;49,0;;1,0;;5,0;1,0;24,0;;17,0;1,0;;3,0;8,0;;24,0;;8,0;1,0;20,0;7,0;27,0;81,0;30,0;34,0;2,0;7,0;1,0;;1,0;2,0;5,0;1,0;3,0;2,0;3,0;3,0;1,0;;34,0;27,0;6,0;18,0;11,0;5,0;9,0;10,0;6,0;;4,0;26,0;12,0;;2,0;152,0;6,0;41,0;;33,0;;10,0;;;;30,0;100,0;;7,0;7,0;4,0;13,0;2,0;;65,0;12,0;24,0;1,0;17,0;19,0;6,0;3,0;24,0;5,0;21,0;14,0;2,0;4,0;;;4,0;49,0;10,0;23,0;9,0;9,0;;2,0;6,0;14,0;8,0;10,0;;;;2,0;;3,0;3,0;;3,0;;3,0;5,0;1,0;;4,0;5,0;1,0;34,0;24,0;;;22,0;9,0;6,0;9,0;6,0;14,0;3,0;9,0;;57,0;2,0;2,0;3,0;9,0;7,0;35,0;3,0;1,0;;18,0;11,0;8,0;5,0;8,0;;;;3,0;6,0;4,0;;;21,0;1,0;6,0;2,0;1,0;2,0;6,0;2,0;11,0;;1,0;;3,0;;16,0;;;5,0;;;;;;1,0;12,0;;5,0;;2,0;5,0;6,0;;;;3,0;2,0;17,0;7,0;;;;4,0;;1,0;;12,0;;2,0;;56,0;1,0;24,0;5,0;4,0;15,0;;2,0;9,0;13,0;;2,0;7,0;;;2,0;2,0;;;3,0;173,0;4,0;6,0;;;;;;7,0;1,0;;2,0;;;1,0;37,0;;;4,0;;6,0;;;6,0;1,0;;;2,0;;1,0;3,0;5,0;;3,0;;;1,0;14,0;5,0;;;;3,0;4,0;;;;;2,0;;2,0;;1,0;6,0;3,0;1,0;;;;3,0;;;2,0;;16,0;1,0;2,0;14,0;;3,0;;1,0;1,0;;2,0;;2,0;1,0;;4,0;;2,0;3,0;;;;;1,0;;;4,0;1,0;;;1,0;6,0;;3,0;26,0;1,0;2,0;4,0;;2,0;2,0;1,0;2,0;;;11,0;2,0;2,0;5,0;1,0;;;1,0;;;2,0;;;;;;;;;1,0;2,0;;3,0;2,0;;7,0;3,0;;3,0;;;;;;4,0;2,0;;6,0;6,0;1,0;;3,0;;;;;4,0;;;;;2,0;14,0;5,0;;;;2,0;;1,0;;;1,0;;7,0;5,0;;7,0;;;5,0;;4,0;;14,0;3,0;7,0;9,0;;1,0;3,0;9,0;;;33,0;1,0;;1,0;1,0;6,0;;;1,0;9,0;;;9,0;12,0;17,0;2,0;1,0;1,0;1,0;2,0;;;9,0;;;3,0;8,0;19,0;3,0;;;5,0;;13,0;1,0;14,0;;2,0;1,0;;12,0;6,0;;1,0;;;2,0;1,0;1,0;;2,0;12,0;1,0;4,0;;2,0;3,0;1,0;;3,0;;3,0;;5,0;;6,0;;;;1,0;14,0;;4,0;;;;;5,0;;;4,0;1,0;4,0;;4,0;4,0;1,0;;11,0;;;;5,0;;2,0;4,0;;;;;1,0;;3,0;3,0;13,0;3,0;1,0;;3,0;;5,0;;10,0;2,0;3,0;;;1,0;;1,0;3,0;;11,0;;1,0;;5,0;1,0;1,0;;5,0;;3,0;1,0;1,0;;3,0;2,0;;;;;2,0;6,0;7,0;;2,0;1,0;4,0;1,0;;;;;;4,0;;;;5,0;2,0;3,0;3,0;2,0;9,0;;2,0;;;;1,0;5,0;;1,0;;;3,0;1,0;4,0;3,0;;;2,0;;;11,0;1,0;3,0;;;;4,0;5,0;1,0;;;;4,0;;;;2,0;;;;5,0;;;3,0;;11,0;1,0;;2,0;;;;;;6,0;2,0;;1,0;2,0;;;1,0;;;2,0;;2,0;;;;1,0;;5,0;1,0;1,0;1,0;1,0;;;19,0;2,0;1,0;2,0;;;2,0;;;;2,0;;;2,0;;;;;;;;;2,0;;;3,0;;;;2,0;16,0;;2,0;;;1,0;2,0;;;;10,0;;1,0;4,0;1,0;1,0;;;4,0;12,0;;1,0;;13,0;;1,0;;3,0;;;4,0;;;;;;;;3,0;;;;;1,0;;;;;2,0;;;28,0;;;;;;;1,0;;;;;2,0;2,0;1,0;1,0;;;;;;1,0;1,0;;;7,0;;;;;;;1,0;;3,0;;9,0;;1,0;1,0;4,0;;;2,0;;;;4,0;1,0;;1,0;;;;;;5,0;6,0;;;3,0;;;;18,0;3,0;;4,0;7,0;1,0;;;;;;1,0;1,0;;1,0;6,0;;;;;;;;;2,0;;4,0;3,0;;1,0;;;;;;6,0;26,0;;;;6,0;;;;;;;;;;3,0;;;;;;;;1,0;;;3,0;;;12,0;;;;1,0;;;2,0;;;;;;;;;1,0;;;2,0;;;3,0;;;;;;2,0;3,0;;2,0;;;1,0;;1,0;;;;;;1,0;3,0;;;;;;1,0;1,0;;2,0;;;1,0;;1,0;1,0;;1,0;;;;;;3,0;2,0;;;3,0;;;7,0;;11,0;3,0;;1,0;;;;;;;;4,0;;;;;1,0;1,0;;;;;;;;2,0;;;;;
compact;1,0;2,0;1,0;;;11,0;2,0;8,0;;;1,0;;;;;;;;;;;1,0;;;;;;1,0;;;4,0;;10,0;;;;;;;;;;6,0;;;;9,0;7,0;12,0;;4,0;;;;1,0;1,0;5,0;;;;;1,0;1,0;;;;2,0;12,0;3,0;3,0;1,0;;3,0;;1,0;;;;2,0;17,0;;2,0;1,0;20,0;;;2,0;;;7,0;47,0;;;1,0;;;;;15,0;1,0;1,0;;251,0;3,0;1,0;;85,0;;;2,0;;2,0;;;;1,0;2,0;1,0;;;;;;;;7,0;;;;7,0;;;3,0;;;;;;;;2,0;;;17,0;;;;10,0;;2,0;;;;27,0;;;32,0;;;3,0;1,0;;16,0;;;;12,0;5,0;;;13,0;6,0;;1,0;;;;1,0;;;;3,0;1,0;4,0;;4,0;3,0;10,0;1,0;1,0;;;1,0;4,0;1,0;2,0;;;;;;3,0;;3,0;4,0;;;;;;;;;;2,0;;2,0;;4,0;2,0;24,0;;;1,0;;5,0;1,0;;13,0;;;;;2,0;3,0;1,0;;7,0;;5,0;2,0;1,0;;11,0;;;;;;;7,0;;;;;;4,0;;;;4,0;;3,0;1,0;;;1,0;7,0;;;;3,0;1,0;6,0;;2,0;;4,0;;1,0;;;1,0;4,0;3,0;;;;6,0;;;1,0;;;8,0;;;;5,0;;7,0;;;;;;;;;1,0;;;;;;;;;;20,0;;;4,0;;;;;;;;5,0;;;;11,0;;;;1,0;;;;2,0;4,0;;;;;;;;;;;;;;;1,0;;;;;;;;;;;;;;;;;2,0;6,0;;;;;;8,0;;;;;;;1,0;;1,0;2,0;;;;;;;;;;;2,0;;;;;;;;4,0;9,0;;4,0;;;;;;;;;;;;;1,0;;;;;;1,0;;;7,0;;;;;;;;;;;;1,0;;;;;;;;1,0;;;;1,0;;;;;;;;;;;;;;;;;;;;1,0;3,0;;;;;;;;;;;;;;;;;1,0;;;;;;;;;1,0;;;;;;;2,0;;;;;;;;;2,0;;;;2,0;;;19,0;;;;;;;;;;;1,0;;;;;;3,0;;;1,0;;;;;;;1,0;1,0;;6,0;;;;;;1,0;;;;1,0;9,0;;;;1,0;4,0;1,0;;;;;;;6,0;;;;;;;;;;;;1,0;;;;;;;;;;;;;;2,0;;1,0;;;;;;;;;2,0;4,0;;;;2,0;;;;;;;;5,0;;1,0;;;;;2,0;;;;;;2,0;;;;;;;;;2,0;;;;;;;;;;;5,0;;;;;;;;;;1,0;4,0;;;;;;;;;;;;;;1,0;1,0;;1,0;;;4,0;;;;;;;1,0;;;;;1,0;;;;;;;;;;;;;;;;7,0;2,0;2,0;;;;1,0;;;;;1,0;;;;1,0;;;;1,0;;;3,0;;;;;;;;1,0;;;;;;;;;;;;;;;3,0;;3,0;;1,0;2,0;;;;;;;;;;;;;;;;;;;;;;;6,0;2,0;;;;2,0;;;;;;;;;1,0;;;;;;;;;1,0;;;;;;;;1,0;;;;;;;;;;;;;4,0;;;;;;;;;;;;;;1,0;;;;;;;;;;;;;1,0;;;;;;;;;;;;;;;;;1,0;;;;;;;;;;50,0;;;;;;;;;;1,0;;;;;;;;;;1,0;;2,0;;;;;;;;1,0;;;;;;;1,0;;;;;;;;;;;;;;;1,0;;;;;;1,0;;1,0;;;;;;;;;;;;;;;;;;;;;;;;;;;;;;;;;;;4,0;1,0;;;;;;
compensate;9,0;;;;;10,0;4,0;4,0;2,0;2,0;7,0;;2,0;;33,0;9,0;;70,0;3,0;;1,0;6,0;10,0;;;;4,0;;;;;10,0;35,0;1,0;20,0;5,0;3,0;4,0;;2,0;11,0;;3,0;4,0;25,0;1,0;9,0;12,0;1,0;5,0;;15,0;3,0;;3,0;;9,0;13,0;5,0;;;1,0;8,0;;20,0;6,0;10,0;1,0;34,0;;5,0;;2,0;;2,0;;4,0;;;211,0;;9,0;;4,0;;;2,0;;1,0;2,0;90,0;;;1,0;4,0;;2,0;;16,0;2,0;1,0;;18,0;5,0;2,0;2,0;50,0;10,0;9,0;18,0;1,0;5,0;;;;3,0;13,0;25,0;4,0;;;;13,0;10,0;12,0;;;1,0;;5,0;;2,0;6,0;;5,0;2,0;;10,0;;;2,0;;;24,0;;1,0;;1,0;54,0;1,0;;;;1,0;;;39,0;;14,0;;;;77,0;19,0;;;12,0;5,0;;;18,0;;;2,0;4,0;1,0;2,0;;;;1,0;;;;;9,0;;1,0;;;;1,0;;;;;;;;;;;3,0;13,0;13,0;;;;1,0;;;;4,0;;;;;;;;;;;;;;;;15,0;;2,0;;;;4,0;20,0;20,0;;;1,0;;;;6,0;1,0;;;;5,0;2,0;;;;;;;1,0;;;;;;;11,0;;15,0;7,0;;;;;1,0;;;2,0;3,0;;1,0;;1,0;;;;;;14,0;;1,0;;;1,0;2,0;42,0;;;;3,0;;;;2,0;;;;;;1,0;1,0;;;;;;;;9,0;;;;;;;;;5,0;;;;;;;;6,0;;;;;;;;;;;;;2,0;;;;1,0;;1,0;;1,0;;2,0;;1,0;;1,0;;4,0;;;;;;;;1,0;;;;;;;;;3,0;4,0;;;;;;21,0;;;;1,0;1,0;3,0;1,0;;1,0;1,0;;;;;1,0;;;2,0;1,0;1,0;;2,0;;17,0;11,0;1,0;;;2,0;1,0;;;;;;;10,0;1,0;;;;2,0;;;2,0;1,0;7,0;;5,0;;;4,0;1,0;;;57,0;3,0;;;4,0;7,0;;14,0;1,0;;1,0;;;1,0;1,0;;;1,0;;2,0;;;;4,0;1,0;;;;;3,0;;;;1,0;2,0;8,0;12,0;;;5,0;;;3,0;;;;;;;;;;;;;1,0;;;;1,0;;5,0;3,0;;;;;2,0;;2,0;1,0;;;;;;;;;;;;4,0;;;;1,0;6,0;;;3,0;;;;;4,0;;;1,0;;;;;;;4,0;;;;;;;;;;;;;;;;5,0;6,0;;3,0;;;;23,0;1,0;;;;;1,0;;;;;;;;;10,0;9,0;;;3,0;;;;;1,0;;;;;1,0;;1,0;;;;;;2,0;;;1,0;;;2,0;;;;;;;;;1,0;;;2,0;;4,0;4,0;;;;;;;;;;;;;;;;;2,0;;;2,0;;;;;;;;;1,0;;;;;;;;1,0;;;;;3,0;;;;;;;;;;;;3,0;4,0;;;1,0;;4,0;;;;1,0;;;;;;;;;;2,0;;;;;;;;;1,0;;;;;;;;;;;;;;;1,0;;1,0;;2,0;1,0;;;;;;;;;;1,0;;;2,0;1,0;;;2,0;;;;2,0;;;;;;;;;;;1,0;;;;;2,0;;;;;;;;;;;;4,0;;;;;;;10,0;;5,0;;;;;;;;;;;;;2,0;1,0;;;;;;2,0;;4,0;2,0;;;;;;;;;;;;2,0;2,0;1,0;;;1,0;;;8,0;2,0;;;;;;;;;3,0;;;1,0;;;;;;;;;;;;;;;;;2,0;;;;;;;;;;;;;;;;1,0;;;;;;;;2,0;;;;2,0;2,0;;;;;;;;4,0;;;;;;1,0;;;;;;;;;;;;11,0;5,0;1,0;;;;;;;;;;;;1,0;;;;1,0;;;;;;;;;;1,0;;;;;;;;;;;;;;;;;4,0;;6,0;;;;;;;;1,0;;;;;;3,0;;2,0;;;;;;;;;;;;1,0;;;;;;;;
computer;3,0;;4,0;;18,0;12,0;1,0;62,0;26,0;4,0;2,0;;41,0;1,0;6,0;40,0;3,0;;;10,0;10,0;58,0;;28,0;;1,0;34,0;5,0;4,0;;;3,0;104,0;;113,0;13,0;9,0;22,0;9,0;5,0;118,0;;5,0;14,0;35,0;5,0;106,0;254,0;114,0;113,0;;20,0;7,0;1,0;1,0;1,0;19,0;3,0;6,0;111,0;;53,0;11,0;54,0;14,0;6,0;4,0;12,0;48,0;3,0;38,0;;54,0;2,0;;12,0;42,0;;5,0;537,0;1,0;31,0;80,0;95,0;;256,0;;1,0;;2,0;6,0;;21,0;14,0;3,0;610,0;127,0;5,0;269,0;16,0;12,0;4,0;42,0;68,0;1,0;9,0;13,0;5,0;45,0;23,0;;160,0;2,0;;;95,0;17,0;44,0;19,0;19,0;;;86,0;98,0;227,0;749,0;;;;7,0;;15,0;8,0;1,0;9,0;3,0;2,0;26,0;7,0;1,0;36,0;;9,0;25,0;7,0;2,0;;2,0;46,0;9,0;7,0;;298,0;194,0;17,0;5,0;423,0;;19,0;31,0;418,0;29,0;41,0;;4,0;;57,0;35,0;;2,0;9,0;;;;4,0;28,0;10,0;;;;27,0;9,0;;;4,0;14,0;;11,0;1,0;;1,0;1,0;;37,0;1,0;;12,0;1,0;;2,0;;2,0;2,0;12,0;1,0;;;1,0;2,0;9,0;1,0;;;;;;;;;;23,0;;;;1,0;;5,0;1,0;21,0;;2,0;;2,0;5,0;1,0;5,0;8,0;;1,0;;2,0;17,0;;1,0;;;;11,0;29,0;3,0;1,0;;4,0;1,0;;2,0;132,0;;;;;;1,0;68,0;;;1,0;;;;1,0;95,0;13,0;;1,0;;1,0;9,0;5,0;16,0;10,0;;;1,0;;24,0;;6,0;;;9,0;3,0;;;;;3,0;;;;1,0;20,0;2,0;;;2,0;;4,0;;1,0;;;5,0;;;9,0;;;;49,0;;;;;1,0;;;;;2,0;;4,0;;;;2,0;;;1,0;;;;;5,0;4,0;3,0;3,0;1,0;1,0;7,0;1,0;;3,0;2,0;;;3,0;53,0;50,0;2,0;;2,0;;1,0;;1,0;;2,0;1,0;;1,0;;1,0;7,0;;1,0;;1,0;3,0;22,0;;;1,0;;1,0;3,0;;;4,0;12,0;1,0;30,0;4,0;46,0;;9,0;;;2,0;;2,0;;23,0;29,0;7,0;;1,0;1,0;2,0;17,0;16,0;234,0;17,0;2,0;25,0;;1,0;1,0;;1,0;2,0;4,0;10,0;2,0;2,0;4,0;;29,0;1,0;4,0;1,0;44,0;9,0;2,0;38,0;;16,0;6,0;27,0;;12,0;44,0;16,0;2,0;168,0;30,0;43,0;;17,0;9,0;2,0;;;5,0;11,0;59,0;93,0;8,0;;;7,0;;;2,0;;;6,0;;6,0;41,0;4,0;;1,0;9,0;80,0;3,0;6,0;7,0;;;12,0;;2,0;4,0;50,0;5,0;;2,0;1,0;7,0;;5,0;14,0;221,0;8,0;5,0;37,0;1,0;50,0;1,0;1,0;7,0;18,0;36,0;5,0;1,0;;;6,0;5,0;2,0;24,0;2,0;7,0;10,0;1,0;3,0;1,0;;;5,0;6,0;2,0;1,0;1,0;1,0;7,0;10,0;4,0;2,0;2,0;;8,0;20,0;2,0;16,0;6,0;7,0;20,0;3,0;4,0;;4,0;3,0;;7,0;2,0;11,0;;4,0;1,0;;;7,0;15,0;;;2,0;;1,0;3,0;16,0;2,0;5,0;;31,0;11,0;43,0;6,0;1,0;35,0;16,0;13,0;;4,0;25,0;;;4,0;1,0;3,0;;12,0;18,0;10,0;8,0;7,0;5,0;2,0;43,0;9,0;5,0;;;10,0;8,0;28,0;2,0;3,0;23,0;2,0;3,0;60,0;12,0;1,0;5,0;1,0;;1,0;;3,0;22,0;;1,0;4,0;;;263,0;6,0;615,0;;2,0;;10,0;11,0;;20,0;2,0;1,0;;1,0;;;8,0;92,0;2,0;6,0;;26,0;;;7,0;5,0;;10,0;;3,0;;30,0;6,0;1,0;10,0;2,0;;;;;;;2,0;;;;5,0;3,0;2,0;;3,0;;;1,0;;1,0;;11,0;;;1,0;;1,0;;1,0;16,0;;;3,0;10,0;;;;;;;;;1,0;5,0;;;;;;4,0;1,0;;;4,0;6,0;5,0;;;;3,0;21,0;;;1,0;1,0;;;;;;;;;;1,0;;4,0;;13,0;2,0;6,0;1,0;1,0;;;1,0;;5,0;;;;;;2,0;;;;;3,0;2,0;;;;;;5,0;;;;;;5,0;2,0;;1,0;;27,0;;;3,0;16,0;;;;1,0;2,0;4,0;;30,0;;;;2,0;1,0;;;12,0;6,0;3,0;;2,0;3,0;;;1,0;;;2,0;;2,0;;1,0;;10,0;;;3,0;4,0;;;3,0;1,0;1,0;;;;1,0;3,0;2,0;;17,0;1,0;;1,0;8,0;;;;;1,0;;2,0;;1,0;1,0;;;;2,0;14,0;1,0;4,0;1,0;;;;;4,0;;30,0;5,0;3,0;15,0;5,0;5,0;5,0;;1,0;1,0;;6,0;;6,0;;;1,0;;;;;;2,0;;;;;;1,0;;;;;;;4,0;3,0;;;1,0;;;;;;2,0;1,0;4,0;4,0;4,0;1,0;;4,0;;;1,0;2,0;;;4,0;;;4,0;2,0;2,0;2,0;;;;;1,0;;;2,0;;;4,0;;2,0;;7,0;1,0;;1,0;;;;1,0;;;;;5,0;;2,0;;2,0;;;;;1,0;;;2,0;;;;1,0;5,0;;;6,0;;;2,0;;5,0;;;1,0;;3,0;1,0;1,0;6,0;6,0;;7,0;17,0;;;;1,0;;;4,0;;2,0;;3,0;;;;;;2,0;
condition;5,0;;65,0;;4,0;24,0;19,0;18,0;11,0;6,0;18,0;3,0;14,0;;63,0;66,0;9,0;5,0;16,0;;7,0;33,0;35,0;;1,0;6,0;20,0;1,0;;10,0;3,0;;44,0;1,0;36,0;12,0;11,0;2,0;7,0;14,0;37,0;3,0;6,0;5,0;73,0;16,0;103,0;94,0;32,0;92,0;9,0;32,0;11,0;6,0;243,0;1,0;74,0;1,0;5,0;;3,0;2,0;11,0;2,0;21,0;372,0;299,0;3,0;24,0;1,0;2,0;;11,0;;;47,0;2,0;;20,0;228,0;2,0;119,0;;81,0;5,0;8,0;23,0;14,0;35,0;270,0;856,0;;6,0;6,0;4,0;6,0;3,0;2,0;73,0;4,0;7,0;3,0;28,0;90,0;;11,0;191,0;1,0;31,0;34,0;3,0;8,0;;1,0;5,0;64,0;14,0;34,0;99,0;81,0;1,0;;7,0;12,0;20,0;2,0;2,0;10,0;;20,0;13,0;12,0;4,0;3,0;33,0;;3,0;28,0;;1018,0;52,0;1,0;5,0;34,0;47,0;;;37,0;36,0;2,0;23,0;;15,0;38,0;8,0;5,0;580,0;15,0;3,0;;3,0;49,0;250,0;;16,0;3,0;6,0;49,0;;1,0;219,0;;;6,0;54,0;9,0;;3,0;;;;21,0;;;;16,0;;70,0;4,0;1,0;1,0;;;1,0;3,0;1,0;1,0;;;;2,0;;3,0;22,0;;;2,0;;139,0;15,0;;;9,0;1,0;;3,0;;;4,0;2,0;1,0;12,0;5,0;;4,0;;;;128,0;;44,0;;1,0;5,0;;65,0;34,0;17,0;6,0;;;;;5,0;7,0;;;;55,0;2,0;9,0;;;;;2,0;33,0;;;85,0;;;;27,0;;7,0;;5,0;17,0;;2,0;4,0;12,0;;;;25,0;2,0;;10,0;4,0;1,0;1,0;26,0;;138,0;7,0;;2,0;1,0;23,0;1,0;7,0;;;3,0;;;;1,0;;1,0;4,0;47,0;;;;2,0;;3,0;1,0;1,0;;;5,0;;;;;1,0;;;2,0;;21,0;;;;;;;;;;1,0;28,0;;;1,0;2,0;;;;1,0;92,0;;22,0;;;4,0;2,0;14,0;92,0;3,0;;2,0;8,0;4,0;3,0;;;4,0;;;;;;1,0;;1,0;5,0;2,0;;1,0;1,0;;2,0;;;1,0;;;;6,0;;3,0;;;3,0;;;61,0;9,0;2,0;;52,0;;8,0;3,0;;;;;8,0;;;;;20,0;6,0;85,0;2,0;10,0;109,0;;1,0;1,0;;1,0;1,0;;;13,0;9,0;2,0;;5,0;22,0;;3,0;;22,0;8,0;1,0;3,0;;1,0;15,0;40,0;;13,0;11,0;16,0;1,0;20,0;13,0;25,0;;;31,0;51,0;;1,0;4,0;;8,0;;;;3,0;5,0;;5,0;6,0;;;6,0;;22,0;9,0;;;2,0;40,0;12,0;;1,0;;3,0;3,0;69,0;;3,0;18,0;;6,0;;;12,0;;;3,0;1,0;3,0;5,0;4,0;4,0;2,0;1,0;1,0;;;;23,0;6,0;;2,0;;2,0;5,0;;2,0;;2,0;9,0;;;2,0;1,0;3,0;1,0;;1,0;13,0;2,0;5,0;;;2,0;6,0;29,0;;;;;;10,0;28,0;2,0;27,0;5,0;;1,0;2,0;;1,0;1,0;;4,0;5,0;;;1,0;20,0;;1,0;;;;2,0;;2,0;1,0;3,0;;5,0;;4,0;;7,0;18,0;3,0;;;;5,0;;;1,0;;1,0;1,0;;;20,0;;;;1,0;;;6,0;1,0;1,0;1,0;;;;1,0;5,0;4,0;;10,0;1,0;1,0;1,0;8,0;;2,0;;;2,0;2,0;;;;;;;3,0;3,0;;;4,0;2,0;1,0;19,0;;2,0;1,0;;;;;1,0;;;1,0;;;5,0;;1,0;;;3,0;;;1,0;;;;;3,0;;6,0;;2,0;;;;6,0;1,0;7,0;4,0;;3,0;7,0;2,0;14,0;10,0;;5,0;2,0;;;;;;;;8,0;1,0;2,0;1,0;2,0;;1,0;;3,0;;;2,0;;;;1,0;;;;;1,0;1,0;;;;1,0;100,0;;;;2,0;;;;;;;;;;;;1,0;;7,0;;;;;1,0;;;;2,0;;4,0;3,0;;10,0;5,0;;;10,0;;;3,0;;;;;11,0;;2,0;;;;;1,0;;;;;;;2,0;2,0;1,0;;;;;14,0;;;;;;;24,0;1,0;1,0;;;;3,0;;;7,0;6,0;27,0;;;3,0;1,0;;;;;1,0;24,0;;;3,0;;4,0;3,0;;2,0;;101,0;4,0;222,0;10,0;52,0;;;6,0;;5,0;1,0;4,0;27,0;;;;;;;;;5,0;;;;1,0;;;;2,0;;2,0;2,0;;;3,0;;1,0;;;;;;;;3,0;;2,0;35,0;3,0;3,0;;;19,0;;;;;;;;25,0;;;;;;;;;;;3,0;;;;;;;;;9,0;;;;;;;5,0;;4,0;;7,0;;;;;;;;;1,0;;;1,0;1,0;1,0;2,0;;;;;1,0;9,0;;1,0;;;26,0;21,0;1,0;3,0;;;;;;;8,0;1,0;;;;;2,0;;;;;;;;;;;;15,0;;6,0;;17,0;;1,0;;1,0;;3,0;;;;;;4,0;;;2,0;;;;2,0;1,0;;;4,0;;;17,0;3,0;2,0;2,0;4,0;;;5,0;;;;;;
configure;7,0;68,0;1,0;16,0;31,0;90,0;78,0;564,0;156,0;185,0;132,0;;77,0;14,0;178,0;223,0;66,0;29,0;45,0;26,0;111,0;638,0;37,0;90,0;2,0;19,0;132,0;24,0;10,0;35,0;104,0;44,0;;19,0;1454,0;615,0;108,0;186,0;27,0;4,0;757,0;6,0;43,0;71,0;616,0;224,0;546,0;1395,0;228,0;791,0;89,0;222,0;44,0;19,0;343,0;53,0;439,0;18,0;95,0;22,0;33,0;69,0;111,0;23,0;207,0;75,0;351,0;230,0;258,0;80,0;76,0;66,0;753,0;76,0;7,0;133,0;129,0;86,0;91,0;3302,0;31,0;393,0;26,0;589,0;15,0;290,0;64,0;17,0;5,0;68,0;1062,0;18,0;67,0;17,0;32,0;52,0;204,0;10,0;156,0;66,0;53,0;19,0;742,0;357,0;20,0;6,0;642,0;7,0;575,0;114,0;59,0;419,0;11,0;25,0;33,0;545,0;419,0;425,0;170,0;129,0;29,0;14,0;216,0;658,0;1106,0;58,0;16,0;20,0;22,0;78,0;7,0;141,0;59,0;13,0;15,0;66,0;49,0;73,0;47,0;11,0;73,0;11,0;107,0;657,0;109,0;5,0;2,0;143,0;1305,0;49,0;27,0;10,0;142,0;433,0;262,0;139,0;1176,0;2,0;56,0;138,0;3,0;252,0;2914,0;13,0;21,0;1,0;454,0;153,0;44,0;36,0;108,0;11,0;4,0;19,0;124,0;99,0;164,0;105,0;37,0;15,0;54,0;299,0;10,0;18,0;134,0;488,0;3,0;169,0;6,0;2,0;55,0;23,0;2,0;213,0;1,0;53,0;35,0;2,0;4,0;98,0;4,0;;85,0;153,0;36,0;31,0;54,0;26,0;80,0;69,0;16,0;21,0;98,0;22,0;32,0;15,0;9,0;16,0;2,0;39,0;320,0;54,0;14,0;44,0;6,0;34,0;21,0;29,0;1112,0;;406,0;5,0;102,0;374,0;116,0;236,0;106,0;104,0;8,0;42,0;10,0;26,0;17,0;63,0;19,0;18,0;100,0;33,0;504,0;57,0;72,0;16,0;11,0;22,0;30,0;12,0;1065,0;99,0;28,0;2,0;22,0;;37,0;222,0;4,0;25,0;25,0;29,0;77,0;;47,0;316,0;39,0;2,0;7,0;88,0;54,0;96,0;58,0;246,0;157,0;29,0;69,0;9,0;4,0;283,0;4,0;44,0;11,0;15,0;113,0;46,0;27,0;7,0;47,0;9,0;18,0;13,0;39,0;16,0;113,0;112,0;97,0;8,0;20,0;10,0;51,0;78,0;25,0;11,0;;34,0;21,0;6,0;32,0;58,0;28,0;136,0;1,0;250,0;36,0;17,0;10,0;15,0;294,0;25,0;74,0;21,0;11,0;13,0;14,0;28,0;25,0;32,0;15,0;69,0;18,0;116,0;135,0;51,0;3,0;1,0;48,0;67,0;24,0;10,0;56,0;47,0;44,0;76,0;2,0;4,0;19,0;76,0;32,0;30,0;16,0;232,0;31,0;33,0;11,0;82,0;18,0;3,0;24,0;9,0;27,0;27,0;36,0;19,0;18,0;14,0;9,0;15,0;2,0;7,0;31,0;16,0;133,0;75,0;26,0;3,0;30,0;24,0;10,0;34,0;14,0;6,0;15,0;160,0;7,0;122,0;37,0;8,0;36,0;63,0;7,0;10,0;22,0;22,0;8,0;5,0;67,0;11,0;1,0;10,0;27,0;13,0;31,0;377,0;180,0;122,0;123,0;17,0;83,0;4,0;6,0;3,0;2,0;10,0;7,0;9,0;233,0;82,0;6,0;9,0;;108,0;2,0;14,0;3,0;311,0;77,0;31,0;127,0;2,0;29,0;147,0;155,0;13,0;88,0;171,0;101,0;8,0;55,0;203,0;265,0;15,0;46,0;21,0;55,0;3,0;14,0;12,0;26,0;133,0;66,0;24,0;4,0;9,0;97,0;14,0;18,0;28,0;12,0;7,0;14,0;9,0;42,0;104,0;1,0;1,0;35,0;61,0;268,0;7,0;53,0;15,0;137,0;22,0;226,0;41,0;51,0;21,0;36,0;92,0;7,0;16,0;5,0;11,0;4,0;17,0;19,0;157,0;13,0;14,0;14,0;18,0;213,0;17,0;143,0;12,0;14,0;90,0;88,0;27,0;25,0;5,0;186,0;17,0;27,0;102,0;13,0;48,0;30,0;9,0;29,0;29,0;16,0;15,0;96,0;35,0;14,0;69,0;12,0;26,0;58,0;18,0;4,0;142,0;3,0;64,0;58,0;75,0;26,0;29,0;37,0;28,0;24,0;17,0;5,0;26,0;8,0;5,0;22,0;76,0;6,0;53,0;38,0;72,0;18,0;20,0;25,0;31,0;14,0;33,0;1,0;37,0;17,0;26,0;18,0;34,0;16,0;16,0;7,0;58,0;71,0;168,0;30,0;31,0;249,0;7,0;57,0;14,0;27,0;55,0;14,0;27,0;37,0;7,0;22,0;;;21,0;108,0;28,0;2,0;13,0;10,0;12,0;78,0;12,0;9,0;50,0;22,0;22,0;9,0;8,0;33,0;19,0;44,0;5,0;25,0;24,0;5,0;40,0;7,0;17,0;1,0;6,0;14,0;13,0;24,0;18,0;42,0;2,0;2,0;20,0;17,0;15,0;51,0;7,0;13,0;37,0;44,0;17,0;103,0;48,0;12,0;9,0;57,0;1,0;6,0;33,0;42,0;12,0;9,0;14,0;17,0;50,0;3,0;57,0;19,0;18,0;4,0;15,0;5,0;15,0;26,0;38,0;72,0;182,0;8,0;24,0;15,0;91,0;12,0;1,0;7,0;5,0;15,0;36,0;10,0;;162,0;21,0;7,0;26,0;18,0;73,0;102,0;6,0;51,0;13,0;;15,0;1,0;22,0;8,0;1,0;1,0;5,0;54,0;11,0;2,0;33,0;21,0;24,0;44,0;8,0;7,0;9,0;6,0;4,0;14,0;7,0;14,0;15,0;60,0;8,0;20,0;;39,0;23,0;11,0;4,0;8,0;25,0;13,0;30,0;5,0;6,0;2,0;46,0;6,0;32,0;53,0;6,0;32,0;14,0;11,0;1,0;7,0;20,0;16,0;54,0;22,0;58,0;3,0;22,0;5,0;38,0;15,0;3,0;115,0;29,0;6,0;13,0;1,0;12,0;26,0;2,0;4,0;14,0;22,0;2,0;5,0;5,0;10,0;5,0;27,0;2,0;5,0;16,0;1,0;33,0;1,0;7,0;11,0;35,0;7,0;11,0;6,0;50,0;15,0;6,0;2,0;37,0;2,0;1,0;12,0;25,0;52,0;91,0;12,0;19,0;10,0;4,0;39,0;18,0;26,0;14,0;4,0;32,0;;18,0;33,0;5,0;33,0;45,0;6,0;14,0;39,0;36,0;1,0;;;28,0;56,0;6,0;21,0;42,0;16,0;69,0;3,0;7,0;14,0;17,0;68,0;7,0;29,0;21,0;;12,0;1,0;7,0;11,0;2,0;4,0;2,0;26,0;6,0;6,0;6,0;121,0;10,0;15,0;7,0;16,0;4,0;49,0;21,0;21,0;14,0;5,0;17,0;11,0;25,0;2,0;31,0;16,0;6,0;1,0;15,0;30,0;1,0;8,0;2,0;;72,0;4,0;5,0;46,0;21,0;14,0;16,0;15,0;9,0;13,0;;13,0;1,0;;12,0;4,0;20,0;3,0;9,0;12,0;4,0;;13,0;30,0;3,0;8,0;15,0;1,0;12,0;7,0;5,0;23,0;1,0;2,0;54,0;6,0;8,0;7,0;4,0;3,0;1,0;13,0;29,0;13,0;3,0;6,0;3,0;8,0;;23,0;43,0;50,0;10,0;27,0;7,0;48,0;7,0;9,0;14,0;3,0;6,0;;5,0;14,0;8,0;23,0;7,0;35,0;12,0;7,0;4,0;34,0;;8,0;21,0;6,0;19,0;1,0;121,0;41,0;;2,0;6,0;17,0;10,0;55,0;10,0;7,0;17,0;;17,0;3,0;19,0;46,0;23,0;11,0;;9,0;55,0;10,0;6,0;2,0;35,0;8,0;8,0;21,0;21,0;5,0;6,0;;5,0;9,0;5,0;4,0;16,0;3,0;24,0;4,0;8,0;1,0;6,0;2,0;2,0;11,0;1,0;3,0;17,0;2,0;14,0;3,0;11,0;12,0;16,0;3,0;31,0;2,0;4,0;2,0;12,0;4,0;2,0;8,0;6,0;6,0;2,0;2,0;4,0;2,0;;15,0;
contrast;1,0;;1,0;;;6,0;1,0;5,0;7,0;;;;3,0;1,0;3,0;65,0;8,0;;20,0;;10,0;38,0;4,0;;;;15,0;;;1,0;;1,0;19,0;;12,0;1,0;;8,0;;;23,0;2,0;5,0;;77,0;67,0;28,0;4,0;2,0;10,0;;11,0;;;6,0;27,0;3,0;;;;;;1,0;;7,0;10,0;51,0;;11,0;;6,0;10,0;17,0;;;5,0;2,0;;1,0;210,0;;16,0;;11,0;23,0;3,0;2,0;;;19,0;76,0;;;;;;;;33,0;;;;7,0;16,0;;4,0;15,0;;4,0;19,0;5,0;28,0;;2,0;;57,0;9,0;25,0;;13,0;;;8,0;33,0;13,0;;1,0;;;21,0;;19,0;;1,0;5,0;1,0;2,0;3,0;3,0;;14,0;1,0;;4,0;8,0;1,0;;1,0;9,0;3,0;6,0;;1,0;1,0;14,0;;17,0;;;4,0;1,0;;52,0;2,0;;;1,0;;;1,0;;;;3,0;10,0;6,0;;;;;;1,0;;;;3,0;;4,0;;;;;;;;;2,0;;;;;;17,0;3,0;;;;;4,0;;;;;;;;;;;;;;;;;;;;29,0;;;;;;;5,0;;;;;;;;;;;;;34,0;;;;;;;;1,0;;;;;;;22,0;;;;;3,0;;;1,0;;;3,0;;7,0;;;;3,0;;;;;12,0;16,0;;;;1,0;;;;;;;;;;1,0;;;;;;;2,0;;6,0;;8,0;;;;;;;;;;;;;1,0;;;;;;;;;;;2,0;;;;;;;;2,0;;;;1,0;;15,0;;;;23,0;;;;16,0;;2,0;;;;;;;;;;;;;;;;;;;1,0;;;;;;;;;;;;;13,0;1,0;;;;;8,0;16,0;;;;;2,0;;;;;4,0;55,0;20,0;;5,0;;;;;;;;;;3,0;46,0;;8,0;;8,0;5,0;3,0;;1,0;13,0;;;1,0;;7,0;6,0;3,0;4,0;;5,0;;;4,0;9,0;;;2,0;;;;5,0;26,0;7,0;;;;;;;;3,0;;;;;24,0;;;;1,0;;;;;;;;13,0;;;;1,0;;2,0;;;;;;;9,0;;;;;1,0;;;;;34,0;2,0;;1,0;;1,0;2,0;;4,0;;;;;;;;;;;;3,0;;;;;;;;1,0;2,0;;;;;2,0;1,0;;;;8,0;3,0;;1,0;35,0;;;2,0;;;3,0;1,0;;;21,0;;;;;;;3,0;;;;;;1,0;2,0;;;;;7,0;;;;;1,0;;;;;1,0;;;;;;;;;;;;;;;;;;;;2,0;;;;;;;;;;;;;;1,0;;;;;;3,0;19,0;;;;;;;;;;;;;1,0;;;;;1,0;9,0;;;;;;;;;;;;;;;;;;;;1,0;;3,0;;;;;2,0;8,0;;;;;;;;;;;;;;;;;;1,0;;;;;;;;;;;;1,0;;;;;;;;;;3,0;;;;;;;;;;;;;;;1,0;1,0;;;;;;;;;;;;;;;;;;;;;;;;;;4,0;;;3,0;8,0;;;;;;1,0;;;;;;;31,0;;;;3,0;;;11,0;;;;;;4,0;;2,0;2,0;;;;;;;;;4,0;;5,0;6,0;4,0;2,0;1,0;;;;;12,0;1,0;;6,0;;;;;;;;;;9,0;;;;;;;;;;11,0;;;;;;;;;;;1,0;;;;;;;;;;;;;;;1,0;;;;;;;;;;;;;;;;;;;;;1,0;;;;9,0;;;;;7,0;;;;;;;;;2,0;;;;;;;;;;;;;;;;;;;;;;;;;;;1,0;;;;;2,0;;2,0;;;;;;5,0;;;;;;;;;;;;;;;;5,0;;;;;;;;9,0;;;;5,0;;;;;;;5,0;;;;;;;;2,0;;;;;;;;;;;;;;;;;;;;
control;1,0;73,0;1,0;51,0;26,0;102,0;85,0;809,0;350,0;105,0;36,0;;76,0;6,0;84,0;474,0;15,0;10,0;70,0;28,0;97,0;399,0;80,0;71,0;62,0;1,0;80,0;17,0;;20,0;113,0;36,0;1454,0;12,0;;811,0;72,0;140,0;37,0;;743,0;13,0;28,0;52,0;297,0;121,0;473,0;2107,0;278,0;1392,0;35,0;133,0;1,0;13,0;653,0;9,0;340,0;32,0;21,0;6,0;6,0;75,0;28,0;46,0;92,0;59,0;678,0;86,0;119,0;5,0;187,0;21,0;560,0;26,0;;46,0;62,0;40,0;106,0;1809,0;56,0;474,0;38,0;744,0;39,0;251,0;197,0;7,0;;47,0;972,0;8,0;42,0;6,0;49,0;107,0;151,0;16,0;1165,0;128,0;13,0;19,0;920,0;166,0;1,0;203,0;203,0;39,0;577,0;286,0;13,0;803,0;5,0;7,0;19,0;413,0;543,0;514,0;395,0;227,0;28,0;;124,0;364,0;256,0;136,0;14,0;57,0;7,0;84,0;29,0;79,0;41,0;14,0;18,0;27,0;49,0;248,0;67,0;13,0;68,0;7,0;126,0;302,0;162,0;3,0;3,0;39,0;2284,0;66,0;51,0;2,0;193,0;216,0;124,0;269,0;1207,0;;149,0;241,0;22,0;342,0;4060,0;26,0;22,0;4,0;354,0;155,0;7,0;11,0;258,0;2,0;1,0;4,0;209,0;58,0;62,0;23,0;24,0;;51,0;562,0;1,0;1,0;184,0;711,0;;96,0;4,0;;2,0;1,0;6,0;308,0;9,0;25,0;42,0;1,0;3,0;9,0;7,0;15,0;45,0;153,0;17,0;2,0;54,0;14,0;422,0;49,0;65,0;;41,0;89,0;8,0;;1,0;1,0;1,0;25,0;86,0;6,0;7,0;15,0;1,0;5,0;19,0;21,0;827,0;1,0;186,0;;94,0;97,0;38,0;132,0;165,0;83,0;16,0;4,0;7,0;146,0;6,0;75,0;74,0;1,0;6,0;7,0;378,0;12,0;14,0;8,0;2,0;4,0;23,0;75,0;595,0;20,0;4,0;4,0;2,0;;4,0;339,0;10,0;25,0;57,0;4,0;243,0;;11,0;241,0;29,0;1,0;2,0;17,0;113,0;8,0;32,0;110,0;326,0;31,0;233,0;7,0;;395,0;5,0;40,0;;4,0;163,0;29,0;79,0;1,0;24,0;10,0;11,0;;31,0;34,0;163,0;77,0;39,0;1,0;6,0;4,0;34,0;68,0;4,0;8,0;40,0;78,0;4,0;;26,0;2,0;4,0;31,0;1,0;118,0;3,0;5,0;5,0;9,0;347,0;22,0;12,0;7,0;10,0;22,0;4,0;5,0;9,0;8,0;2,0;72,0;8,0;27,0;59,0;2,0;;2,0;23,0;66,0;42,0;32,0;38,0;156,0;13,0;43,0;;5,0;19,0;97,0;21,0;6,0;32,0;92,0;35,0;6,0;8,0;21,0;;2,0;3,0;;;13,0;5,0;9,0;12,0;41,0;;20,0;4,0;;6,0;7,0;79,0;63,0;3,0;;10,0;16,0;;38,0;;;;40,0;9,0;247,0;14,0;18,0;;194,0;3,0;5,0;6,0;1,0;7,0;;43,0;123,0;10,0;4,0;26,0;5,0;68,0;144,0;270,0;66,0;22,0;11,0;58,0;5,0;6,0;5,0;23,0;4,0;;28,0;46,0;68,0;12,0;12,0;20,0;49,0;;18,0;2,0;672,0;88,0;13,0;79,0;5,0;11,0;42,0;487,0;33,0;92,0;120,0;113,0;1,0;120,0;146,0;823,0;48,0;18,0;100,0;38,0;3,0;;69,0;68,0;277,0;578,0;25,0;2,0;12,0;43,0;4,0;29,0;75,0;6,0;6,0;49,0;20,0;63,0;83,0;4,0;6,0;53,0;22,0;502,0;16,0;4,0;10,0;147,0;7,0;253,0;15,0;15,0;108,0;28,0;16,0;3,0;8,0;4,0;6,0;52,0;14,0;41,0;207,0;10,0;7,0;17,0;24,0;217,0;10,0;247,0;5,0;24,0;187,0;31,0;47,0;15,0;;102,0;13,0;19,0;94,0;16,0;11,0;54,0;5,0;6,0;10,0;7,0;4,0;54,0;74,0;114,0;119,0;24,0;12,0;22,0;53,0;14,0;98,0;20,0;23,0;36,0;40,0;9,0;2,0;117,0;6,0;45,0;29,0;86,0;23,0;18,0;7,0;14,0;15,0;16,0;70,0;5,0;216,0;31,0;;14,0;22,0;44,0;41,0;7,0;14,0;1,0;49,0;17,0;60,0;10,0;35,0;;285,0;66,0;278,0;25,0;10,0;41,0;;24,0;1,0;17,0;52,0;;3,0;17,0;9,0;11,0;2,0;;14,0;119,0;127,0;;33,0;14,0;41,0;14,0;52,0;10,0;7,0;20,0;4,0;13,0;3,0;7,0;10,0;45,0;22,0;8,0;58,0;3,0;28,0;14,0;;26,0;22,0;16,0;7,0;10,0;3,0;19,0;2,0;;22,0;24,0;8,0;37,0;8,0;2,0;38,0;18,0;11,0;148,0;27,0;8,0;12,0;99,0;;5,0;22,0;73,0;1,0;7,0;1,0;6,0;26,0;6,0;22,0;28,0;19,0;3,0;11,0;4,0;3,0;58,0;20,0;12,0;148,0;9,0;9,0;27,0;7,0;43,0;15,0;6,0;10,0;5,0;58,0;2,0;7,0;87,0;2,0;14,0;41,0;;178,0;172,0;8,0;249,0;;10,0;2,0;2,0;;4,0;;5,0;10,0;93,0;;5,0;15,0;24,0;13,0;25,0;8,0;11,0;1,0;4,0;1,0;4,0;9,0;1,0;55,0;12,0;1,0;7,0;;68,0;3,0;1,0;6,0;13,0;118,0;26,0;2,0;1,0;9,0;6,0;15,0;1,0;11,0;1,0;4,0;20,0;;37,0;3,0;4,0;;10,0;34,0;2,0;25,0;2,0;12,0;7,0;7,0;6,0;12,0;77,0;2,0;13,0;2,0;4,0;9,0;68,0;4,0;23,0;24,0;;;9,0;3,0;3,0;5,0;7,0;;;2,0;;12,0;10,0;5,0;18,0;21,0;67,0;4,0;17,0;31,0;27,0;64,0;9,0;37,0;;9,0;1,0;30,0;82,0;38,0;6,0;16,0;27,0;1,0;15,0;41,0;21,0;24,0;13,0;15,0;3,0;7,0;23,0;;23,0;28,0;23,0;3,0;89,0;80,0;;2,0;1,0;5,0;11,0;111,0;8,0;41,0;5,0;55,0;3,0;9,0;29,0;15,0;29,0;27,0;12,0;8,0;;17,0;;27,0;1,0;9,0;1,0;4,0;44,0;;26,0;11,0;68,0;12,0;2,0;8,0;6,0;3,0;11,0;49,0;;7,0;14,0;35,0;4,0;65,0;4,0;12,0;;1,0;8,0;5,0;42,0;1,0;29,0;19,0;;37,0;3,0;8,0;26,0;8,0;33,0;10,0;9,0;1,0;11,0;15,0;16,0;2,0;;6,0;1,0;19,0;20,0;2,0;6,0;1,0;;3,0;15,0;46,0;3,0;4,0;17,0;;22,0;34,0;2,0;1,0;;20,0;25,0;32,0;3,0;4,0;4,0;4,0;11,0;5,0;74,0;1,0;17,0;;3,0;3,0;27,0;23,0;1,0;;37,0;;6,0;1,0;;10,0;4,0;;2,0;;18,0;;4,0;2,0;14,0;;11,0;13,0;14,0;9,0;3,0;20,0;1,0;12,0;;44,0;7,0;;6,0;9,0;20,0;;32,0;4,0;;2,0;1,0;7,0;;;;2,0;42,0;;;;6,0;;;4,0;1,0;;2,0;1,0;2,0;2,0;;;25,0;3,0;;;23,0;2,0;;51,0;;9,0;2,0;;12,0;2,0;4,0;2,0;;4,0;;14,0;17,0;4,0;1,0;15,0;33,0;;3,0;1,0;2,0;22,0;;;3,0;5,0;7,0;;;;4,0;
controller;4,0;4,0;1,0;21,0;15,0;30,0;70,0;176,0;30,0;23,0;18,0;;19,0;6,0;47,0;64,0;17,0;5,0;3,0;;9,0;109,0;3,0;6,0;1,0;;18,0;1,0;;5,0;13,0;12,0;615,0;1,0;811,0;;10,0;31,0;13,0;;142,0;7,0;4,0;18,0;102,0;17,0;159,0;293,0;35,0;271,0;4,0;63,0;2,0;;198,0;3,0;36,0;2,0;5,0;1,0;6,0;21,0;12,0;6,0;3,0;11,0;169,0;5,0;58,0;3,0;23,0;;94,0;1,0;;13,0;7,0;6,0;6,0;578,0;10,0;85,0;4,0;154,0;17,0;52,0;91,0;3,0;1,0;15,0;586,0;11,0;;;3,0;8,0;67,0;14,0;52,0;23,0;11,0;8,0;85,0;45,0;;141,0;92,0;15,0;198,0;34,0;6,0;134,0;15,0;2,0;2,0;55,0;35,0;212,0;41,0;67,0;5,0;1,0;27,0;26,0;59,0;14,0;1,0;2,0;5,0;27,0;4,0;86,0;6,0;;2,0;9,0;9,0;39,0;8,0;2,0;21,0;20,0;83,0;105,0;39,0;;1,0;14,0;279,0;8,0;10,0;;37,0;68,0;49,0;43,0;319,0;;20,0;11,0;;91,0;398,0;3,0;2,0;11,0;55,0;27,0;5,0;;71,0;;;2,0;25,0;21,0;20,0;2,0;6,0;2,0;22,0;334,0;;1,0;9,0;20,0;;13,0;;;5,0;6,0;;102,0;;3,0;12,0;2,0;;;;1,0;2,0;65,0;8,0;;10,0;2,0;114,0;15,0;;;1,0;2,0;2,0;;;5,0;2,0;5,0;40,0;1,0;;;;;;;140,0;;38,0;2,0;14,0;48,0;21,0;51,0;39,0;7,0;1,0;5,0;5,0;5,0;2,0;14,0;10,0;;2,0;;27,0;2,0;4,0;;;12,0;;18,0;211,0;10,0;2,0;;1,0;;2,0;71,0;;16,0;4,0;1,0;31,0;;1,0;41,0;13,0;;;6,0;46,0;1,0;24,0;24,0;43,0;9,0;35,0;;;96,0;;8,0;;1,0;64,0;3,0;5,0;;1,0;1,0;;;9,0;;40,0;12,0;6,0;1,0;1,0;;;;;;6,0;12,0;3,0;;11,0;5,0;;28,0;;111,0;;1,0;1,0;;116,0;4,0;1,0;;5,0;8,0;;1,0;;;;71,0;24,0;13,0;5,0;;;;8,0;9,0;4,0;12,0;1,0;68,0;3,0;6,0;;;3,0;16,0;;2,0;22,0;37,0;24,0;;2,0;3,0;;;;;;7,0;1,0;1,0;1,0;3,0;;10,0;7,0;;;2,0;18,0;6,0;4,0;1,0;;8,0;;14,0;;;;27,0;;18,0;18,0;1,0;;19,0;;7,0;1,0;13,0;;;7,0;33,0;7,0;4,0;7,0;6,0;10,0;54,0;32,0;6,0;6,0;4,0;16,0;;2,0;1,0;7,0;2,0;;1,0;58,0;25,0;;;1,0;5,0;;4,0;;61,0;26,0;4,0;39,0;7,0;14,0;17,0;118,0;1,0;17,0;58,0;38,0;;10,0;58,0;180,0;3,0;4,0;23,0;8,0;1,0;;8,0;13,0;21,0;53,0;25,0;9,0;3,0;19,0;6,0;8,0;41,0;3,0;4,0;6,0;13,0;26,0;38,0;1,0;3,0;23,0;2,0;66,0;2,0;1,0;1,0;4,0;;77,0;14,0;6,0;6,0;11,0;;3,0;2,0;3,0;1,0;11,0;;6,0;18,0;3,0;1,0;27,0;15,0;48,0;;60,0;1,0;16,0;23,0;20,0;1,0;7,0;3,0;13,0;4,0;;21,0;;3,0;6,0;5,0;6,0;5,0;2,0;7,0;12,0;35,0;;6,0;1,0;;3,0;4,0;;5,0;3,0;2,0;20,0;6,0;2,0;;18,0;7,0;10,0;1,0;8,0;2,0;11,0;1,0;8,0;7,0;6,0;14,0;10,0;34,0;1,0;;4,0;2,0;2,0;;3,0;5,0;2,0;19,0;;13,0;3,0;4,0;;32,0;17,0;144,0;6,0;1,0;13,0;;5,0;;32,0;17,0;;1,0;;1,0;8,0;;;2,0;70,0;18,0;2,0;;4,0;6,0;1,0;9,0;7,0;2,0;4,0;;4,0;;11,0;1,0;8,0;5,0;13,0;7,0;;3,0;2,0;;;3,0;2,0;;19,0;5,0;1,0;;;12,0;2,0;;6,0;1,0;;1,0;13,0;2,0;23,0;10,0;;4,0;5,0;;;26,0;7,0;;2,0;2,0;4,0;3,0;;3,0;4,0;17,0;;;;;1,0;2,0;2,0;115,0;4,0;;1,0;;8,0;;;;;2,0;;;3,0;;4,0;1,0;1,0;47,0;52,0;5,0;3,0;;5,0;;;3,0;;;;36,0;20,0;;;1,0;15,0;1,0;;1,0;2,0;;2,0;;3,0;1,0;;;1,0;;;1,0;6,0;;;;3,0;24,0;27,0;;;7,0;;2,0;;2,0;7,0;;1,0;;;;;;3,0;7,0;;1,0;;;17,0;1,0;;;13,0;1,0;8,0;12,0;5,0;2,0;8,0;2,0;10,0;2,0;;;;;;6,0;;;;;;2,0;4,0;;3,0;1,0;1,0;1,0;;;3,0;2,0;3,0;1,0;;4,0;;3,0;34,0;14,0;;;6,0;;2,0;7,0;2,0;2,0;4,0;;3,0;3,0;1,0;;1,0;11,0;2,0;1,0;1,0;3,0;;;;1,0;;16,0;3,0;7,0;7,0;4,0;;;;;7,0;5,0;6,0;4,0;;3,0;;3,0;3,0;3,0;3,0;;1,0;;5,0;9,0;7,0;1,0;5,0;3,0;4,0;;9,0;5,0;;;;20,0;2,0;3,0;2,0;1,0;;;;1,0;11,0;6,0;4,0;11,0;;4,0;;2,0;7,0;9,0;4,0;9,0;1,0;1,0;1,0;;10,0;;;11,0;6,0;;1,0;4,0;;;;2,0;35,0;1,0;5,0;1,0;1,0;2,0;;2,0;;;;23,0;;;;;;5,0;7,0;2,0;7,0;;1,0;;;;29,0;6,0;1,0;1,0;9,0;2,0;;1,0;;4,0;;;;;;;21,0;;;2,0;;;21,0;;;;;6,0;;;50,0;;;;7,0;1,0;17,0;;;;1,0;5,0;;;;;3,0;;;;;5,0;;4,0;;2,0;;;;2,0;;;22,0;;4,0;;4,0;6,0;;12,0;;;1,0;1,0;;2,0;1,0;4,0;;9,0;;;14,0;3,0;;2,0;1,0;2,0;3,0;;8,0;;;;;;;;;;;
correct;24,0;30,0;3,0;;8,0;5,0;3,0;46,0;11,0;2,0;2,0;1,0;9,0;;24,0;74,0;3,0;52,0;18,0;2,0;17,0;23,0;3,0;4,0;;72,0;107,0;;;3,0;9,0;11,0;108,0;;72,0;10,0;;257,0;14,0;17,0;109,0;5,0;2,0;29,0;27,0;5,0;49,0;65,0;53,0;75,0;1,0;47,0;231,0;;6,0;33,0;15,0;71,0;57,0;;3,0;;5,0;;11,0;6,0;63,0;10,0;44,0;;26,0;2,0;66,0;4,0;8,0;24,0;;2,0;1,0;785,0;13,0;27,0;;29,0;2,0;4,0;2,0;1,0;;7,0;95,0;;;;2,0;3,0;6,0;;114,0;1,0;14,0;3,0;34,0;27,0;1,0;14,0;82,0;19,0;56,0;45,0;8,0;56,0;6,0;1,0;;6,0;32,0;106,0;14,0;9,0;1,0;;16,0;50,0;26,0;11,0;4,0;12,0;1,0;15,0;;47,0;8,0;2,0;7,0;9,0;7,0;;12,0;;21,0;;1,0;21,0;34,0;19,0;;10,0;108,0;16,0;7,0;2,0;14,0;29,0;12,0;;52,0;1,0;23,0;;5,0;;218,0;7,0;3,0;;25,0;19,0;8,0;;8,0;;;7,0;30,0;43,0;;1,0;;;;51,0;;;2,0;22,0;;15,0;;;3,0;;;;;2,0;;;;;;;27,0;26,0;40,0;2,0;;;12,0;2,0;;;;;;;;;4,0;;2,0;;;1,0;;;;;24,0;;9,0;;;61,0;1,0;6,0;11,0;;;;1,0;;;10,0;72,0;;;;86,0;6,0;;;1,0;;;;12,0;10,0;;;;;;24,0;;46,0;4,0;1,0;;;;;2,0;;;;1,0;;;6,0;1,0;1,0;2,0;;;25,0;;1,0;;;6,0;9,0;10,0;;;;1,0;;2,0;;1,0;11,0;1,0;;2,0;;;5,0;;;;;;;4,0;15,0;;;;;3,0;;;;3,0;;2,0;;;;;;;;;17,0;;7,0;14,0;1,0;;;26,0;2,0;1,0;1,0;;;3,0;30,0;;;1,0;3,0;;;1,0;34,0;1,0;;;3,0;;;;;3,0;5,0;;;;;;;;;;;3,0;8,0;;;3,0;;;8,0;;;1,0;1,0;1,0;16,0;4,0;;;;;;1,0;;1,0;2,0;;;6,0;2,0;;2,0;14,0;31,0;5,0;20,0;3,0;;;3,0;;;;1,0;;2,0;5,0;1,0;;;;3,0;;;;20,0;25,0;6,0;25,0;;7,0;11,0;19,0;;1,0;20,0;12,0;;;5,0;44,0;;33,0;11,0;2,0;1,0;;8,0;;20,0;;3,0;7,0;;;;;2,0;2,0;3,0;2,0;2,0;3,0;10,0;1,0;;;3,0;12,0;1,0;24,0;2,0;11,0;;17,0;8,0;1,0;11,0;2,0;2,0;4,0;;2,0;;;1,0;;19,0;2,0;12,0;;;2,0;1,0;;;;11,0;;10,0;1,0;;13,0;;4,0;1,0;;;3,0;;;;;5,0;6,0;;2,0;16,0;1,0;;;;;2,0;;;;;;;2,0;4,0;;;;3,0;;;4,0;10,0;3,0;;;13,0;;;10,0;1,0;;;;;;2,0;;6,0;;10,0;;2,0;3,0;;;7,0;4,0;;2,0;;;2,0;;;2,0;;;;;3,0;13,0;9,0;;;;;1,0;;;;;;;;4,0;;;;;;;8,0;;;;;2,0;4,0;22,0;;;;;;;1,0;;1,0;;;1,0;;10,0;5,0;;;1,0;;2,0;1,0;;;;;1,0;;2,0;;;;;;1,0;;3,0;;;;;;;;3,0;1,0;;;;14,0;2,0;;12,0;;;7,0;;;2,0;;9,0;;;9,0;;;;;;;;;;;;;;;;8,0;10,0;2,0;;;1,0;;2,0;;;;;2,0;;1,0;;5,0;1,0;;;;;;;;;;;;;;;;;4,0;;1,0;2,0;8,0;7,0;5,0;3,0;1,0;5,0;;;;;5,0;;;;5,0;;;;;;;;1,0;;;;;2,0;;;3,0;;;;;3,0;1,0;;6,0;;;;;;14,0;;;;;7,0;7,0;;;;;;16,0;1,0;;4,0;3,0;1,0;11,0;;3,0;;;;2,0;12,0;;2,0;6,0;2,0;14,0;;5,0;;6,0;1,0;;2,0;18,0;;4,0;;2,0;1,0;;;;;8,0;1,0;2,0;4,0;2,0;;;;2,0;;;;;1,0;;;;;;;;;;1,0;;;;;3,0;;;;6,0;;;;;5,0;;1,0;;;;;36,0;;;3,0;;1,0;2,0;;;;;;1,0;;;;;;;;;1,0;1,0;;1,0;2,0;;;;;;3,0;;12,0;;;;3,0;;17,0;;;;;;;;3,0;;;2,0;25,0;;11,0;3,0;;;;3,0;;1,0;;;1,0;;1,0;6,0;;;;;3,0;;;;;;;;6,0;;;;4,0;;;;9,0;2,0;;;;;;;;2,0;;;4,0;21,0;;;;13,0;;9,0;10,0;;;4,0;1,0;6,0;2,0;5,0;5,0;13,0;;2,0;4,0;;6,0;;;;;7,0;;;;3,0;;;;
correction;8,0;1,0;3,0;;;17,0;2,0;197,0;95,0;22,0;7,0;;30,0;5,0;14,0;175,0;;101,0;6,0;8,0;18,0;12,0;7,0;;1,0;101,0;270,0;3,0;;4,0;22,0;2,0;186,0;8,0;140,0;31,0;257,0;;;1,0;219,0;4,0;2,0;2,0;54,0;44,0;146,0;140,0;47,0;32,0;7,0;66,0;226,0;5,0;32,0;34,0;42,0;28,0;10,0;;1,0;2,0;2,0;;7,0;9,0;34,0;23,0;15,0;;13,0;2,0;115,0;;15,0;14,0;8,0;;1,0;647,0;;98,0;1,0;153,0;5,0;53,0;20,0;4,0;;6,0;173,0;;;;2,0;9,0;37,0;2,0;169,0;;19,0;3,0;116,0;66,0;;15,0;84,0;5,0;80,0;157,0;2,0;293,0;;17,0;2,0;47,0;53,0;155,0;6,0;28,0;3,0;;48,0;141,0;49,0;10,0;;23,0;;22,0;;22,0;6,0;;16,0;9,0;;8,0;25,0;1,0;5,0;;;19,0;29,0;90,0;;5,0;180,0;10,0;6,0;;33,0;83,0;40,0;20,0;119,0;;8,0;6,0;11,0;8,0;473,0;2,0;;;42,0;10,0;;;53,0;;;2,0;146,0;46,0;2,0;4,0;;;2,0;43,0;;;;159,0;;11,0;3,0;1,0;1,0;1,0;;5,0;6,0;4,0;1,0;1,0;2,0;;;;39,0;51,0;31,0;1,0;;;26,0;6,0;;1,0;;2,0;;;;;2,0;1,0;12,0;1,0;1,0;;;;1,0;;16,0;1,0;65,0;;5,0;20,0;27,0;21,0;25,0;;1,0;;;;;3,0;23,0;;;1,0;81,0;16,0;6,0;;;4,0;;;14,0;3,0;;1,0;;;;129,0;;95,0;2,0;;;;;;2,0;;;;2,0;;6,0;1,0;11,0;1,0;3,0;;;43,0;;1,0;;;3,0;52,0;38,0;;;2,0;11,0;;3,0;;5,0;1,0;;;;1,0;39,0;8,0;;;;7,0;;;6,0;2,0;;;;1,0;;;;;7,0;;;;;;;;1,0;;1,0;25,0;7,0;;47,0;9,0;;;3,0;1,0;3,0;5,0;5,0;4,0;2,0;8,0;;10,0;;8,0;;;5,0;21,0;1,0;;2,0;2,0;;;;;;1,0;;;;;;;;;;;10,0;2,0;;;1,0;1,0;;7,0;;;11,0;22,0;;69,0;1,0;1,0;;1,0;;10,0;;;2,0;;2,0;;1,0;;44,0;32,0;55,0;122,0;57,0;2,0;1,0;1,0;15,0;1,0;;;;;;;9,0;24,0;;16,0;1,0;3,0;6,0;1,0;;12,0;50,0;11,0;15,0;;7,0;9,0;45,0;;5,0;38,0;39,0;2,0;;3,0;60,0;1,0;13,0;21,0;;3,0;;2,0;5,0;12,0;;;4,0;2,0;2,0;;3,0;2,0;;;5,0;1,0;15,0;8,0;;;;4,0;15,0;2,0;59,0;40,0;42,0;1,0;29,0;11,0;9,0;15,0;23,0;8,0;3,0;2,0;1,0;1,0;;4,0;;28,0;59,0;6,0;;;;9,0;9,0;;;14,0;1,0;;8,0;;13,0;;13,0;3,0;;;2,0;;1,0;;3,0;;41,0;;;19,0;7,0;;;1,0;;1,0;;2,0;1,0;2,0;4,0;;10,0;2,0;1,0;;;39,0;;;;14,0;11,0;;;46,0;;;2,0;3,0;4,0;;;;;;;41,0;;24,0;;;1,0;;;9,0;15,0;;5,0;;;12,0;;1,0;;7,0;;;;;12,0;47,0;;;;;15,0;;;;2,0;;;;2,0;1,0;;;;;;52,0;1,0;;;;;;6,0;;;;;;6,0;5,0;3,0;2,0;;1,0;;;11,0;3,0;;2,0;5,0;;1,0;1,0;1,0;;;;2,0;;2,0;;1,0;;1,0;4,0;;;3,0;1,0;2,0;;2,0;;3,0;;7,0;;;;17,0;10,0;;;18,0;;;11,0;;;4,0;;;2,0;;26,0;;;3,0;;;7,0;4,0;9,0;;39,0;;;3,0;;2,0;2,0;;;;;1,0;4,0;1,0;;;;1,0;2,0;;2,0;;8,0;;;;;;4,0;;1,0;;;;;2,0;;;;;34,0;;6,0;1,0;17,0;28,0;3,0;;2,0;3,0;;;3,0;;23,0;;1,0;;2,0;;;;;;;;;;;1,0;2,0;1,0;;;1,0;1,0;;;8,0;4,0;5,0;;2,0;;;;;;9,0;;4,0;;1,0;15,0;15,0;;;;;4,0;;4,0;8,0;13,0;1,0;5,0;;11,0;4,0;;;;2,0;11,0;;24,0;27,0;;42,0;1,0;9,0;;;19,0;;7,0;17,0;;;3,0;10,0;;;3,0;;2,0;83,0;;17,0;10,0;2,0;;2,0;4,0;40,0;;2,0;;;;;;1,0;;6,0;;1,0;;;3,0;;;29,0;;7,0;;;9,0;5,0;1,0;;;4,0;2,0;;;;2,0;;;3,0;4,0;;4,0;16,0;7,0;2,0;;;;;1,0;;;;;;;;1,0;;;1,0;;4,0;1,0;;;;1,0;;;;7,0;5,0;;;2,0;;1,0;;4,0;;;;;;;3,0;;4,0;41,0;;1,0;2,0;;;;67,0;2,0;3,0;;5,0;3,0;;2,0;9,0;5,0;;;;3,0;3,0;;;;;;;7,0;2,0;3,0;;6,0;;1,0;2,0;26,0;;;1,0;1,0;3,0;;;2,0;17,0;;;;18,0;;;;3,0;;81,0;2,0;;4,0;;8,0;;;3,0;;23,0;;4,0;;;;2,0;;;2,0;;;;;1,0;;;;
create;3,0;;1,0;;3,0;3,0;2,0;6,0;20,0;1,0;4,0;;17,0;17,0;2,0;59,0;4,0;3,0;3,0;;1,0;38,0;2,0;;;;25,0;8,0;;;9,0;7,0;27,0;;37,0;13,0;14,0;;;;136,0;;3,0;10,0;12,0;15,0;11,0;51,0;30,0;48,0;1,0;3,0;;3,0;2,0;2,0;5,0;;11,0;;;1,0;10,0;79,0;17,0;5,0;;7,0;56,0;;12,0;3,0;9,0;;;5,0;8,0;4,0;2,0;540,0;7,0;13,0;;51,0;;34,0;1,0;;;;23,0;2,0;2,0;1,0;1,0;22,0;11,0;3,0;79,0;4,0;21,0;5,0;5,0;81,0;5,0;3,0;10,0;1,0;9,0;8,0;1,0;16,0;;;;74,0;42,0;30,0;;4,0;1,0;;8,0;32,0;35,0;5,0;1,0;;;9,0;;2,0;7,0;;4,0;14,0;;5,0;14,0;;29,0;;;14,0;6,0;;;2,0;16,0;4,0;3,0;;15,0;23,0;8,0;;32,0;;5,0;;3,0;6,0;67,0;;2,0;;66,0;16,0;;;4,0;;;2,0;;2,0;2,0;;;;4,0;2,0;;3,0;4,0;8,0;;5,0;;;;;2,0;11,0;;3,0;20,0;;;;;6,0;15,0;10,0;1,0;;2,0;6,0;6,0;;3,0;;5,0;;;;1,0;;3,0;3,0;1,0;;;;;;1,0;;41,0;1,0;1,0;2,0;4,0;;;1,0;5,0;;;;;;;4,0;;;;1,0;8,0;5,0;5,0;;;;7,0;2,0;13,0;4,0;;2,0;;;;7,0;;;3,0;;;2,0;;11,0;6,0;;;2,0;;;;10,0;1,0;2,0;15,0;;;20,0;1,0;7,0;;;10,0;;;;;;5,0;;3,0;;2,0;4,0;2,0;;;2,0;;;1,0;3,0;;2,0;;;2,0;37,0;;;;2,0;;;;;;;;;1,0;;;;;1,0;2,0;1,0;;2,0;;1,0;;;;21,0;4,0;2,0;;2,0;2,0;4,0;;;3,0;2,0;1,0;;1,0;16,0;5,0;1,0;;6,0;;;;;;;;6,0;;;;;3,0;;;;1,0;;;;6,0;;;;;;;2,0;;11,0;1,0;;1,0;;;;9,0;;;;;8,0;;;;;;5,0;5,0;12,0;;10,0;3,0;4,0;1,0;1,0;;;;;3,0;;1,0;;2,0;18,0;6,0;1,0;1,0;4,0;;;6,0;;2,0;;13,0;;1,0;17,0;12,0;;4,0;;2,0;;4,0;;11,0;;;2,0;6,0;29,0;5,0;5,0;;1,0;11,0;9,0;3,0;1,0;;;;;2,0;4,0;;1,0;;8,0;19,0;1,0;4,0;;;1,0;8,0;1,0;;3,0;4,0;;4,0;;2,0;13,0;;11,0;8,0;3,0;1,0;;;1,0;4,0;;2,0;;;27,0;9,0;;4,0;;3,0;;;8,0;;;2,0;;;;;1,0;;;;;;;1,0;1,0;;1,0;;2,0;;7,0;;;5,0;3,0;;1,0;1,0;1,0;;1,0;4,0;;;5,0;;5,0;2,0;2,0;3,0;3,0;;3,0;;;;;6,0;;;1,0;;;2,0;22,0;;;2,0;6,0;;;;;;1,0;2,0;;;;;7,0;;;;;;1,0;4,0;;;;;;;4,0;2,0;;;2,0;15,0;2,0;;7,0;;;36,0;;;2,0;5,0;2,0;;;2,0;;;;;1,0;;;3,0;2,0;21,0;3,0;;1,0;;;2,0;;4,0;;;;4,0;;;;;4,0;6,0;2,0;1,0;;25,0;;1,0;1,0;;;;;;1,0;;;;1,0;;;;;;4,0;;;;;;2,0;;;;;;;;6,0;;;;;;;;;;;6,0;;;;;1,0;7,0;;;1,0;8,0;1,0;;;1,0;5,0;;;;;;4,0;;;;;;;;2,0;6,0;4,0;18,0;6,0;;1,0;;3,0;;;1,0;19,0;1,0;;;;;;2,0;3,0;;;;1,0;;;1,0;;;;;;;;3,0;3,0;6,0;;3,0;;;;;5,0;;;;;;;5,0;12,0;;4,0;;;5,0;1,0;;3,0;;;;1,0;19,0;;;1,0;15,0;8,0;;4,0;8,0;;;;;;13,0;;;;;;;;7,0;3,0;2,0;1,0;;;;1,0;3,0;;;;;2,0;;;;1,0;;;;;;1,0;;;4,0;2,0;;;;;;1,0;;2,0;;2,0;;;;;;3,0;1,0;;;5,0;;1,0;7,0;3,0;;;;14,0;;14,0;;;2,0;4,0;13,0;;1,0;;1,0;;;;;2,0;;;;;4,0;;;;;;1,0;1,0;;;;;;1,0;3,0;;5,0;6,0;7,0;;;;;;;;;2,0;;;;;3,0;;;;;;4,0;;;5,0;;;2,0;;3,0;;1,0;;1,0;;2,0;;1,0;;;4,0;;;;;9,0;;;;2,0;30,0;;;;;;;;;;1,0;;;;;;;;;;2,0;9,0;;;35,0;;15,0;;;10,0;;;4,0;;1,0;;;;;1,0;6,0;;;;;1,0;;4,0;
curvature;5,0;;;;;2,0;;2,0;7,0;;2,0;1,0;1,0;;33,0;15,0;;;;;1,0;;;;;;;;;2,0;5,0;14,0;4,0;;;;17,0;1,0;;;;;3,0;;1,0;;27,0;2,0;30,0;;;1,0;;;1,0;8,0;35,0;;25,0;;;1,0;26,0;;;;;9,0;;1,0;3,0;;;;;;;;;140,0;3,0;5,0;;12,0;;;;;1,0;;166,0;;;;;;;;24,0;1,0;1,0;;;75,0;;;8,0;;;;;;;;;5,0;1,0;6,0;;2,0;;;;1,0;4,0;;;;;2,0;;3,0;;;14,0;;5,0;;;45,0;;;1,0;2,0;1,0;;;170,0;;2,0;;6,0;;;;;14,0;;1,0;2,0;;;71,0;;6,0;;;;;;9,0;1,0;;;;;1,0;;;;;7,0;;;;;;;;;;5,0;2,0;;;;;1,0;;2,0;;;;;;;;;;2,0;;13,0;;;;;1,0;;;3,0;1,0;1,0;;;;;;;1,0;;6,0;;;2,0;;;1,0;;;3,0;;1,0;;;;;;;1,0;;2,0;1,0;;;;;;6,0;;;;;;1,0;;;3,0;;;;1,0;;;;;;;2,0;;241,0;;;;;;;;;;1,0;23,0;;1,0;;1,0;;;;;;;1,0;;;;1,0;;;;2,0;;1,0;;;6,0;;;;10,0;;1,0;;;;;;;;;;;;;;;;;1,0;;;;;;2,0;;;;;;;2,0;1,0;;1,0;;;;2,0;;;1,0;3,0;;;;;;1,0;;1,0;;;;;;;;2,0;1,0;1,0;;;2,0;;;;;;;5,0;;;;;;;6,0;;1,0;;;;;;;;;;;5,0;3,0;;3,0;;;;;;;;;9,0;;;;;;;;;;;;2,0;1,0;6,0;;;;2,0;8,0;;;;;;;;;;;;;;;;;12,0;;;;;;1,0;;;;;;17,0;7,0;;;;6,0;;;;;;;;;7,0;;;;;1,0;2,0;;;;;;23,0;;;8,0;;;;;7,0;;;;;;;;;;;;;;;;;;;;;;;;;;;;;1,0;;;;16,0;;;;;;;1,0;;;;;;;;1,0;;;;;;;;;;1,0;1,0;8,0;3,0;;;;;;1,0;;2,0;;;;;2,0;;;1,0;;;;;;;;;;;;;;;;;;;;;;;;;;;;;;;;;;;;;;;;;;;;;;3,0;;;;;;;;;;;;;;;;;;;;;1,0;;;;;;6,0;;6,0;;;;1,0;1,0;;;;;;;2,0;;;;;;;;;;;1,0;;;;;;;1,0;;;;1,0;;;;;;;;;;;;;;;;;;;;;;;;;;2,0;;11,0;;;;1,0;;;;;;;;6,0;;;;;;;;;;;15,0;;;1,0;;;;;;;1,0;;;;;;;;;;;;;;;;;;;;;;;;;;;;;;;;;;;;;;;;;;;;;;;;;;6,0;;;;;;;;;;;;12,0;;271,0;;7,0;;;;;;1,0;;;;;;;;;;;;3,0;;;;;;;;;;;;;;1,0;;;;;;;;;;;;;;;;;;;;;;;;;;;;;;;;;;;;;;;;;;;;;;;;2,0;;;;;;;;;;;;;;;;;;;;;;;;;;;;;;;;;2,0;;6,0;;;;;4,0;;4,0;;;;;;;;;;;;;;;;;;;;7,0;2,0;;;;;;;;;;;;;;5,0;2,0;;;3,0;;3,0;;;;;;;;;;;;;;;;;;;;
data;59,0;57,0;6,0;9,0;120,0;27,0;15,0;338,0;251,0;69,0;112,0;1,0;366,0;23,0;25,0;1158,0;;14,0;83,0;29,0;155,0;1078,0;27,0;84,0;35,0;13,0;401,0;24,0;;11,0;118,0;37,0;757,0;23,0;743,0;142,0;109,0;219,0;136,0;;;7,0;62,0;189,0;253,0;137,0;751,0;1523,0;626,0;969,0;40,0;142,0;22,0;43,0;18,0;51,0;264,0;40,0;159,0;45,0;16,0;133,0;108,0;243,0;81,0;40,0;81,0;145,0;482,0;5,0;83,0;17,0;1426,0;45,0;3,0;199,0;164,0;11,0;34,0;11277,0;51,0;467,0;30,0;1181,0;44,0;262,0;118,0;22,0;;32,0;287,0;19,0;11,0;7,0;241,0;254,0;656,0;26,0;917,0;57,0;57,0;80,0;269,0;426,0;5,0;137,0;195,0;94,0;1259,0;230,0;28,0;354,0;21,0;21,0;32,0;821,0;402,0;549,0;107,0;283,0;14,0;;481,0;1281,0;385,0;97,0;13,0;29,0;46,0;114,0;42,0;209,0;54,0;16,0;382,0;271,0;110,0;220,0;80,0;17,0;200,0;6,0;175,0;924,0;153,0;14,0;;114,0;1065,0;86,0;41,0;11,0;615,0;1172,0;283,0;56,0;909,0;;16,0;668,0;58,0;523,0;1502,0;8,0;6,0;5,0;1347,0;184,0;84,0;52,0;48,0;;;56,0;111,0;58,0;24,0;;;24,0;27,0;185,0;;1,0;20,0;198,0;;174,0;;;325,0;109,0;;164,0;10,0;92,0;53,0;7,0;3,0;5,0;;41,0;143,0;37,0;25,0;;3,0;9,0;116,0;61,0;;3,0;3,0;13,0;;16,0;;3,0;4,0;2,0;22,0;4,0;6,0;2,0;5,0;3,0;17,0;;336,0;1,0;5,0;;10,0;10,0;4,0;3,0;81,0;17,0;1,0;9,0;24,0;39,0;16,0;89,0;58,0;;10,0;52,0;1252,0;58,0;5,0;1,0;2,0;3,0;;10,0;1200,0;10,0;;7,0;;;3,0;396,0;3,0;7,0;14,0;;28,0;;;78,0;106,0;;10,0;6,0;59,0;76,0;11,0;48,0;72,0;149,0;145,0;1,0;51,0;416,0;9,0;23,0;7,0;5,0;199,0;11,0;10,0;;7,0;2,0;21,0;2,0;15,0;;4,0;39,0;26,0;;1,0;;1,0;167,0;1,0;4,0;19,0;7,0;12,0;;12,0;156,0;1,0;156,0;1,0;89,0;;;3,0;5,0;35,0;3,0;7,0;;18,0;7,0;;;;8,0;;41,0;11,0;2,0;39,0;;;;23,0;76,0;21,0;41,0;5,0;3,0;63,0;52,0;;3,0;13,0;175,0;;;6,0;499,0;24,0;33,0;6,0;15,0;2,0;;;;;8,0;;1,0;36,0;7,0;;37,0;4,0;;2,0;;26,0;6,0;;;146,0;;6,0;20,0;1,0;;2,0;4,0;16,0;148,0;17,0;10,0;;270,0;15,0;5,0;24,0;16,0;53,0;20,0;96,0;51,0;1,0;7,0;51,0;9,0;123,0;170,0;120,0;345,0;170,0;12,0;103,0;14,0;5,0;32,0;36,0;59,0;13,0;11,0;38,0;83,0;16,0;30,0;15,0;160,0;9,0;173,0;21,0;588,0;148,0;54,0;277,0;;43,0;76,0;171,0;;99,0;284,0;137,0;25,0;202,0;59,0;210,0;8,0;117,0;49,0;33,0;5,0;;4,0;236,0;728,0;53,0;34,0;10,0;31,0;59,0;;49,0;10,0;2,0;1,0;7,0;2,0;81,0;59,0;10,0;;23,0;66,0;324,0;35,0;36,0;28,0;65,0;3,0;180,0;25,0;70,0;36,0;79,0;12,0;6,0;70,0;58,0;40,0;3,0;49,0;152,0;84,0;17,0;12,0;45,0;38,0;270,0;10,0;19,0;19,0;20,0;60,0;105,0;8,0;6,0;66,0;184,0;36,0;35,0;78,0;10,0;3,0;333,0;6,0;2,0;16,0;6,0;166,0;111,0;18,0;30,0;63,0;19,0;40,0;189,0;11,0;18,0;161,0;42,0;71,0;114,0;68,0;7,0;;203,0;83,0;15,0;29,0;35,0;;27,0;18,0;51,0;224,0;37,0;100,0;;45,0;83,0;;84,0;240,0;74,0;21,0;4,0;5,0;;18,0;47,0;29,0;73,0;119,0;44,0;116,0;61,0;284,0;46,0;3,0;203,0;49,0;32,0;2,0;28,0;35,0;1,0;2,0;8,0;3,0;26,0;;10,0;61,0;122,0;46,0;25,0;39,0;5,0;20,0;103,0;31,0;1,0;3,0;;;5,0;83,0;44,0;11,0;33,0;30,0;97,0;7,0;14,0;77,0;10,0;;122,0;15,0;17,0;20,0;104,0;;36,0;26,0;;19,0;101,0;23,0;43,0;40,0;2,0;35,0;43,0;11,0;175,0;69,0;8,0;19,0;2,0;;8,0;36,0;121,0;14,0;39,0;3,0;15,0;5,0;25,0;10,0;46,0;18,0;57,0;20,0;2,0;;55,0;14,0;1,0;186,0;50,0;;1,0;3,0;5,0;2,0;1,0;;10,0;53,0;19,0;20,0;137,0;;3,0;12,0;1,0;6,0;3,0;;39,0;33,0;5,0;2,0;1,0;14,0;;39,0;;10,0;96,0;1,0;;39,0;23,0;32,0;48,0;;2,0;59,0;;;13,0;3,0;12,0;20,0;73,0;;2,0;;34,0;14,0;;3,0;27,0;73,0;;5,0;;2,0;14,0;23,0;;13,0;6,0;1,0;;;1,0;4,0;;;63,0;1,0;;44,0;;2,0;19,0;136,0;8,0;12,0;9,0;13,0;49,0;6,0;;11,0;19,0;;;34,0;3,0;;5,0;;2,0;2,0;;1,0;4,0;;;21,0;2,0;1,0;105,0;16,0;2,0;;7,0;19,0;44,0;2,0;27,0;75,0;;59,0;;;127,0;172,0;;8,0;34,0;1,0;6,0;38,0;35,0;5,0;1,0;;16,0;27,0;47,0;3,0;18,0;94,0;23,0;23,0;;12,0;4,0;;;7,0;10,0;6,0;50,0;18,0;16,0;26,0;;26,0;21,0;;125,0;25,0;;76,0;;51,0;2,0;22,0;61,0;2,0;1,0;3,0;39,0;38,0;4,0;27,0;137,0;23,0;5,0;6,0;45,0;1,0;2,0;94,0;7,0;14,0;14,0;3,0;8,0;;;21,0;;8,0;7,0;19,0;33,0;8,0;4,0;30,0;;19,0;21,0;20,0;283,0;9,0;15,0;22,0;16,0;8,0;19,0;4,0;4,0;9,0;1,0;27,0;2,0;80,0;5,0;38,0;13,0;;37,0;16,0;9,0;3,0;;;1,0;3,0;4,0;;1,0;;1,0;14,0;27,0;21,0;4,0;50,0;6,0;;7,0;30,0;2,0;;;2,0;4,0;8,0;180,0;46,0;79,0;5,0;5,0;23,0;99,0;;;2,0;4,0;;;;1,0;;13,0;1,0;17,0;1,0;85,0;12,0;3,0;;;99,0;;224,0;;5,0;1,0;2,0;18,0;4,0;180,0;;10,0;;1,0;7,0;34,0;13,0;4,0;;;2,0;5,0;;18,0;;6,0;1,0;;10,0;4,0;3,0;;;4,0;7,0;1,0;;12,0;17,0;;8,0;38,0;3,0;24,0;2,0;;16,0;;;74,0;1,0;1,0;2,0;6,0;22,0;1,0;2,0;10,0;25,0;;42,0;33,0;18,0;;69,0;3,0;34,0;16,0;1,0;17,0;;3,0;4,0;6,0;;40,0;2,0
decrease;2,0;;;;1,0;6,0;;5,0;13,0;1,0;1,0;2,0;2,0;;;5,0;2,0;3,0;7,0;;2,0;24,0;3,0;;;7,0;;;;;;3,0;6,0;2,0;13,0;7,0;5,0;4,0;;;7,0;;1,0;8,0;5,0;4,0;16,0;9,0;3,0;5,0;;20,0;4,0;;2,0;6,0;2,0;;1,0;;;1,0;1,0;;3,0;4,0;47,0;6,0;9,0;1,0;9,0;;1,0;;;23,0;;;7,0;50,0;2,0;2,0;;5,0;77,0;1,0;;;;8,0;153,0;;;1,0;;;;;13,0;;;;3,0;3,0;;;11,0;6,0;25,0;5,0;;4,0;;;;;17,0;27,0;9,0;13,0;;;;5,0;3,0;;;;;15,0;;17,0;1,0;1,0;;4,0;4,0;6,0;1,0;3,0;;;;5,0;6,0;;;20,0;7,0;5,0;;;;;2,0;;6,0;;;9,0;;;211,0;;2,0;;2,0;5,0;1,0;;8,0;;;2,0;12,0;2,0;;;1,0;;;;;;;3,0;;4,0;;;;3,0;;2,0;1,0;1,0;;;;;;;11,0;18,0;2,0;;;;9,0;;;;3,0;1,0;;;1,0;;4,0;;;4,0;;;;10,0;;;14,0;;8,0;;;;;5,0;;3,0;;10,0;;;;;4,0;;;;7,0;1,0;;;;;1,0;;1,0;;;1,0;;;;4,0;;1,0;4,0;;2,0;;;;3,0;;;1,0;;;1,0;6,0;;;;6,0;1,0;13,0;4,0;4,0;;;;2,0;;1,0;1,0;;9,0;;;;1,0;;;;3,0;2,0;1,0;1,0;;;;11,0;;;4,0;1,0;;;;;;;4,0;;2,0;;1,0;;3,0;;;;;;;9,0;;;;;;;;4,0;7,0;;;;;;;;;;;;;6,0;;2,0;;;;;;;2,0;1,0;;;2,0;;;;;;10,0;;;1,0;;;;;;;;;2,0;;;;;;;;;10,0;;;;;;;;;1,0;;;1,0;8,0;;1,0;4,0;;6,0;;;;;;;;;1,0;;3,0;;;;;1,0;14,0;;1,0;;;2,0;5,0;4,0;;6,0;4,0;;;;4,0;;;2,0;3,0;;;;17,0;2,0;;;;;1,0;;;10,0;;;;;10,0;;;;;1,0;3,0;;;;11,0;;9,0;;;2,0;;1,0;;;;;;;;;;;2,0;;2,0;;1,0;;;;;1,0;1,0;;;;1,0;;;;;;;;2,0;;2,0;;;2,0;;;;1,0;;;;1,0;;;;;;;;81,0;1,0;;14,0;;9,0;2,0;3,0;;;;;;;;;1,0;;1,0;;;;;;3,0;;;;;;;;;1,0;;;2,0;;;;;;;;;;5,0;;;;;;;;;;;;;1,0;;1,0;;;;;1,0;2,0;;;;;;;;;1,0;;;;;;;;1,0;;;5,0;3,0;;2,0;;;;2,0;;;;;1,0;;;;;;;;;;1,0;;;;;1,0;1,0;;;2,0;;;;;;;;;;1,0;;1,0;1,0;;3,0;2,0;;;;;;;;;;4,0;1,0;1,0;2,0;;1,0;;;;;;;;;;;;;;;;;2,0;1,0;1,0;;1,0;;;;4,0;;;;;2,0;;;;;;;;1,0;;;1,0;;;;;1,0;;;;1,0;;5,0;6,0;;;;2,0;;;;;;;;;;;2,0;;;;;;;;2,0;5,0;;;;;;;;1,0;;4,0;;;;6,0;;;;;6,0;1,0;;;12,0;;;;;;2,0;;;;;;3,0;;;;;;;3,0;10,0;;20,0;;;2,0;;1,0;;;;;2,0;6,0;;;1,0;;;;;;;3,0;;;3,0;4,0;;;;;;;;;;;;;;2,0;;;;;2,0;;;;;;;1,0;;;;;;;;;;1,0;;;;;;;;;;;1,0;;;;;;;;2,0;;;;1,0;;8,0;;6,0;;;;;;;;;;;;;;;;;;1,0;;2,0;;;;;;;;;1,0;;;;;;;;;;2,0;;;;;;;1,0;;;;;;;;;;;;;;;;1,0;2,0;;;2,0;;;;;;;;;;;;;;;;;;;2,0;;;;;;;;;;;;;;;;
define;3,0;13,0;3,0;11,0;4,0;118,0;133,0;22,0;126,0;26,0;11,0;3,0;11,0;7,0;127,0;128,0;25,0;2,0;4,0;1,0;6,0;15,0;12,0;38,0;;1,0;32,0;8,0;6,0;3,0;5,0;6,0;43,0;5,0;28,0;4,0;2,0;2,0;3,0;3,0;62,0;1,0;;30,0;27,0;11,0;67,0;194,0;40,0;39,0;21,0;78,0;1,0;2,0;16,0;36,0;35,0;3,0;26,0;;73,0;31,0;70,0;;35,0;15,0;32,0;49,0;148,0;32,0;34,0;1,0;23,0;1,0;9,0;51,0;18,0;5,0;21,0;311,0;3,0;64,0;;195,0;4,0;12,0;1,0;;2,0;15,0;385,0;;;16,0;10,0;7,0;8,0;;193,0;5,0;6,0;8,0;319,0;79,0;21,0;6,0;129,0;12,0;15,0;37,0;39,0;19,0;11,0;;3,0;214,0;252,0;225,0;;37,0;2,0;;16,0;26,0;40,0;10,0;2,0;2,0;12,0;58,0;3,0;81,0;27,0;;17,0;;16,0;18,0;15,0;12,0;45,0;1,0;;138,0;20,0;1,0;13,0;151,0;27,0;15,0;11,0;2,0;;5,0;2,0;3,0;250,0;1,0;12,0;3,0;2,0;3,0;100,0;5,0;1,0;;25,0;95,0;4,0;8,0;13,0;3,0;21,0;15,0;10,0;18,0;64,0;98,0;;;67,0;54,0;3,0;111,0;8,0;56,0;;26,0;3,0;;;23,0;10,0;41,0;;23,0;1,0;1,0;1,0;60,0;24,0;5,0;14,0;38,0;9,0;18,0;;1,0;20,0;59,0;14,0;1,0;5,0;16,0;12,0;;69,0;4,0;38,0;323,0;191,0;24,0;127,0;;;55,0;23,0;;105,0;;231,0;12,0;17,0;67,0;33,0;9,0;13,0;123,0;39,0;65,0;22,0;15,0;6,0;59,0;3,0;3,0;3,0;4,0;47,0;176,0;141,0;10,0;11,0;2,0;1,0;9,0;348,0;1,0;8,0;7,0;;;22,0;42,0;4,0;4,0;38,0;31,0;4,0;;31,0;48,0;146,0;4,0;2,0;11,0;1,0;67,0;70,0;451,0;6,0;;3,0;2,0;;37,0;5,0;6,0;6,0;35,0;33,0;14,0;16,0;1,0;158,0;;10,0;4,0;6,0;;24,0;12,0;15,0;5,0;2,0;11,0;3,0;27,0;95,0;68,0;;11,0;10,0;5,0;11,0;12,0;8,0;20,0;5,0;10,0;8,0;3,0;22,0;14,0;15,0;;18,0;2,0;;5,0;12,0;7,0;18,0;1,0;3,0;5,0;12,0;33,0;8,0;36,0;6,0;;12,0;8,0;36,0;2,0;2,0;11,0;29,0;10,0;13,0;20,0;;7,0;6,0;14,0;26,0;206,0;4,0;3,0;7,0;3,0;7,0;25,0;44,0;9,0;;8,0;130,0;1,0;25,0;;1,0;;5,0;3,0;17,0;6,0;2,0;46,0;7,0;1,0;10,0;26,0;3,0;2,0;150,0;13,0;12,0;121,0;12,0;45,0;;12,0;27,0;2,0;4,0;24,0;22,0;17,0;;;7,0;11,0;1,0;;;3,0;8,0;6,0;2,0;14,0;7,0;16,0;8,0;2,0;2,0;2,0;2,0;;5,0;4,0;25,0;2,0;1,0;3,0;;40,0;4,0;3,0;;38,0;31,0;7,0;44,0;3,0;2,0;11,0;16,0;2,0;5,0;26,0;16,0;;8,0;7,0;16,0;17,0;28,0;3,0;;;3,0;3,0;5,0;11,0;6,0;6,0;3,0;6,0;2,0;6,0;;;;8,0;;4,0;25,0;19,0;;2,0;;8,0;33,0;2,0;28,0;;;17,0;17,0;23,0;;59,0;292,0;;7,0;1,0;1,0;20,0;;8,0;5,0;2,0;16,0;;9,0;;20,0;;4,0;;;17,0;;;22,0;3,0;2,0;;7,0;3,0;6,0;;1,0;;12,0;1,0;1,0;;7,0;1,0;8,0;14,0;3,0;13,0;;;;17,0;;;2,0;13,0;;;;;6,0;4,0;;19,0;1,0;1,0;;5,0;17,0;;;6,0;1,0;4,0;3,0;2,0;;17,0;1,0;3,0;13,0;;8,0;3,0;8,0;14,0;26,0;1,0;22,0;13,0;;2,0;10,0;4,0;5,0;;1,0;14,0;10,0;27,0;3,0;8,0;2,0;8,0;;5,0;13,0;;1,0;1,0;11,0;;5,0;;;9,0;1,0;;;2,0;5,0;5,0;31,0;;15,0;;1,0;20,0;1,0;11,0;;;4,0;6,0;2,0;1,0;9,0;;;1,0;;1,0;3,0;;14,0;4,0;1,0;;128,0;2,0;;8,0;;;3,0;10,0;6,0;8,0;3,0;66,0;;;1,0;3,0;2,0;2,0;;;29,0;4,0;40,0;1,0;8,0;4,0;1,0;11,0;2,0;13,0;2,0;;24,0;1,0;20,0;;;6,0;2,0;26,0;1,0;11,0;1,0;;6,0;22,0;2,0;;;2,0;1,0;;13,0;;1,0;;9,0;3,0;1,0;25,0;2,0;4,0;7,0;3,0;;21,0;3,0;;;11,0;16,0;12,0;24,0;3,0;5,0;2,0;8,0;2,0;2,0;3,0;;7,0;;17,0;;;1,0;61,0;;5,0;1,0;;5,0;;;15,0;138,0;1,0;13,0;10,0;4,0;;8,0;44,0;2,0;1,0;24,0;;2,0;;2,0;5,0;1,0;2,0;;2,0;;1,0;2,0;1,0;1,0;9,0;1,0;23,0;18,0;;12,0;6,0;1,0;3,0;2,0;;1,0;2,0;;;3,0;;1,0;;;;;2,0;;95,0;2,0;;;2,0;;12,0;30,0;17,0;3,0;;;4,0;1,0;;29,0;2,0;2,0;19,0;4,0;33,0;;2,0;;;;1,0;12,0;1,0;3,0;1,0;12,0;;2,0;;;9,0;;1,0;13,0;6,0;;5,0;3,0;;6,0;;1,0;10,0;;;9,0;3,0;;8,0;2,0;;;;;3,0;13,0;1,0;6,0;1,0;;14,0;;;4,0;;3,0;24,0;9,0;2,0;2,0;1,0;;1,0;12,0;;;;;1,0;;;25,0;;;2,0;64,0;1,0;1,0;3,0;1,0;8,0;1,0;4,0;;;1,0;;;2,0;1,0;;;4,0;12,0;11,0;6,0;;;;;5,0;;;;5,0;;3,0;4,0;2,0;5,0;;17,0;2,0;;;;5,0;3,0;1,0;1,0;4,0;1,0;16,0;9,0;3,0;3,0;;7,0;;3,0;;4,0;;9,0;;15,0;9,0;2,0;1,0;;;10,0;;1,0;;;6,0;4,0;;3,0;2,0;6,0;;;;;;4,0;;1,0;;1,0;8,0;;9,0;;9,0;5,0;;;;5,0;8,0;1,0;;9,0;7,0;;;1,0;;;2,0;;;2,0;;7,0;1,0;;6,0;;2,0;1,0;10,0;18,0;;;;13,0;13,0;5,0;;;3,0;;19,0;;;9,0;;;
depth;1,0;2,0;;;5,0;22,0;6,0;57,0;15,0;17,0;23,0;;57,0;;18,0;134,0;3,0;27,0;1,0;2,0;12,0;115,0;10,0;7,0;;2,0;49,0;1,0;;4,0;14,0;5,0;71,0;;52,0;18,0;29,0;2,0;10,0;;189,0;8,0;30,0;;40,0;6,0;157,0;36,0;11,0;20,0;;85,0;2,0;3,0;;32,0;17,0;14,0;79,0;1,0;36,0;;193,0;2,0;25,0;19,0;92,0;24,0;168,0;5,0;7,0;1,0;128,0;8,0;1,0;10,0;8,0;7,0;21,0;757,0;1,0;19,0;3,0;94,0;11,0;11,0;;;1,0;22,0;40,0;;17,0;;42,0;8,0;5,0;;250,0;127,0;66,0;8,0;53,0;138,0;4,0;5,0;40,0;5,0;37,0;179,0;1,0;21,0;;;;83,0;73,0;92,0;1,0;23,0;;;36,0;54,0;34,0;17,0;;;2,0;65,0;1,0;35,0;57,0;1,0;18,0;16,0;24,0;12,0;45,0;;104,0;;3,0;71,0;24,0;1,0;;5,0;10,0;6,0;2,0;6,0;7,0;6,0;36,0;;107,0;;;1,0;9,0;1,0;51,0;;7,0;;33,0;47,0;3,0;2,0;2,0;;4,0;11,0;11,0;42,0;27,0;;3,0;;2,0;8,0;;1,0;;13,0;;18,0;;3,0;;2,0;2,0;15,0;1,0;2,0;5,0;5,0;;2,0;2,0;9,0;19,0;15,0;1,0;1,0;;1,0;2,0;33,0;1,0;;;;;;24,0;;20,0;2,0;8,0;;4,0;1,0;;;7,0;;63,0;1,0;9,0;;;2,0;;11,0;6,0;3,0;1,0;3,0;7,0;2,0;4,0;2,0;6,0;;5,0;16,0;111,0;14,0;1,0;;5,0;;2,0;6,0;82,0;3,0;;;;;3,0;23,0;3,0;;16,0;;;;;32,0;23,0;;;;6,0;12,0;13,0;47,0;;;;15,0;1,0;50,0;1,0;;;;;2,0;;2,0;;2,0;3,0;;;;6,0;;2,0;2,0;;;1,0;21,0;;;;4,0;;;3,0;16,0;;;1,0;3,0;;;;;;;;7,0;1,0;;;;2,0;;;1,0;;1,0;7,0;1,0;;;;8,0;5,0;;;4,0;3,0;;;2,0;;1,0;3,0;;;143,0;;4,0;;10,0;;;;;;1,0;16,0;;2,0;;;3,0;;;;;;1,0;;;13,0;;;4,0;2,0;;5,0;30,0;;22,0;;1,0;1,0;;;22,0;9,0;;1,0;;1,0;1,0;;;;2,0;2,0;32,0;39,0;8,0;10,0;1,0;78,0;2,0;7,0;;2,0;;4,0;3,0;1,0;5,0;;4,0;3,0;50,0;15,0;1,0;1,0;29,0;9,0;11,0;25,0;10,0;3,0;42,0;11,0;1,0;1,0;58,0;23,0;1,0;1,0;15,0;8,0;7,0;19,0;3,0;1,0;11,0;;;4,0;4,0;7,0;14,0;;1,0;10,0;;;2,0;;;;;27,0;37,0;;;;49,0;9,0;7,0;28,0;;1,0;5,0;11,0;11,0;;4,0;74,0;;2,0;6,0;9,0;13,0;1,0;28,0;7,0;8,0;3,0;;2,0;3,0;21,0;1,0;6,0;;;4,0;44,0;9,0;12,0;;1,0;;1,0;1,0;8,0;;;;;;;;;4,0;1,0;1,0;;;;;;;;14,0;2,0;;6,0;;10,0;;;;1,0;;;2,0;;22,0;8,0;;;;2,0;;5,0;10,0;;1,0;1,0;;;;1,0;;;5,0;;2,0;2,0;2,0;;;14,0;;5,0;;1,0;7,0;;1,0;2,0;3,0;4,0;;3,0;;1,0;;;19,0;;;;;;1,0;;;;;;;6,0;;2,0;12,0;;7,0;;;;5,0;;4,0;;;;;;;;1,0;;8,0;;2,0;2,0;;59,0;;;;1,0;;;7,0;;;2,0;;1,0;;1,0;6,0;;1,0;;;4,0;2,0;81,0;;;;;;2,0;1,0;7,0;;;;;;4,0;;5,0;;;1,0;;3,0;;;;2,0;;;;;;4,0;;3,0;20,0;;;4,0;6,0;1,0;;;2,0;7,0;;;;;1,0;2,0;;;;;1,0;15,0;;;14,0;6,0;;;;;;;;;;;;;;;;;1,0;1,0;;;;11,0;;2,0;14,0;;19,0;4,0;1,0;;;;12,0;;;;;;2,0;3,0;;;;;;;;11,0;;;14,0;3,0;;2,0;;;4,0;3,0;;;1,0;2,0;1,0;2,0;1,0;67,0;;3,0;16,0;3,0;4,0;28,0;1,0;;;;4,0;7,0;19,0;;;11,0;;5,0;1,0;;5,0;2,0;2,0;;7,0;3,0;9,0;1,0;2,0;2,0;;1,0;;;;1,0;20,0;1,0;;;3,0;;3,0;;;;12,0;;;3,0;;7,0;;;2,0;;3,0;23,0;8,0;;2,0;2,0;1,0;;;;;10,0;;8,0;1,0;;;;;;;;1,0;25,0;;4,0;;20,0;7,0;4,0;;5,0;1,0;5,0;;4,0;;;5,0;;2,0;1,0;;;;;;;;;;5,0;;;3,0;;;2,0;;;;;;;5,0;;;;5,0;1,0;3,0;;8,0;;13,0;;;;;;;;;;7,0;6,0;2,0;;;4,0;;;;;;2,0;;;;3,0;8,0;;;1,0;1,0;;;1,0;;;;;;;9,0;;;;;;;;;1,0;;;;;;11,0;;6,0;;2,0;;1,0;7,0;;;1,0;;;19,0;;2,0;11,0;1,0;;;13,0;;35,0;;;;2,0;;;;;;6,0;;2,0;;10,0;;;;
detect;2,0;18,0;2,0;25,0;50,0;156,0;25,0;195,0;561,0;109,0;66,0;;92,0;13,0;24,0;499,0;24,0;2,0;77,0;8,0;83,0;207,0;20,0;5,0;6,0;6,0;128,0;20,0;;25,0;35,0;73,0;616,0;77,0;297,0;102,0;27,0;54,0;12,0;1,0;253,0;5,0;27,0;40,0;;933,0;289,0;482,0;96,0;164,0;47,0;161,0;17,0;6,0;18,0;222,0;107,0;61,0;10,0;4,0;11,0;17,0;88,0;2,0;35,0;52,0;418,0;15,0;217,0;20,0;44,0;18,0;86,0;1,0;3,0;52,0;19,0;10,0;59,0;1893,0;9,0;118,0;9,0;430,0;5,0;68,0;99,0;4,0;3,0;24,0;469,0;3,0;8,0;1,0;22,0;70,0;26,0;9,0;603,0;32,0;37,0;8,0;194,0;972,0;;85,0;120,0;35,0;133,0;53,0;17,0;129,0;6,0;15,0;3,0;333,0;265,0;1057,0;35,0;179,0;14,0;;53,0;148,0;128,0;35,0;3,0;38,0;105,0;57,0;1,0;64,0;48,0;5,0;44,0;15,0;44,0;293,0;62,0;11,0;183,0;7,0;9,0;445,0;48,0;1,0;;37,0;631,0;38,0;85,0;;65,0;68,0;315,0;3,0;300,0;;20,0;11,0;6,0;28,0;1047,0;48,0;5,0;2,0;221,0;145,0;27,0;22,0;55,0;1,0;;6,0;194,0;39,0;20,0;19,0;6,0;5,0;11,0;417,0;;2,0;44,0;65,0;;70,0;;;1,0;17,0;;32,0;;81,0;4,0;5,0;;11,0;1,0;4,0;56,0;201,0;23,0;2,0;39,0;59,0;57,0;470,0;1,0;3,0;10,0;5,0;;31,0;;1,0;13,0;2,0;11,0;13,0;;;2,0;;;;481,0;1,0;84,0;;13,0;66,0;34,0;41,0;172,0;14,0;2,0;12,0;2,0;19,0;2,0;4,0;28,0;;19,0;9,0;252,0;51,0;5,0;9,0;;10,0;6,0;36,0;80,0;69,0;;1,0;3,0;;9,0;98,0;1,0;138,0;34,0;;90,0;;15,0;65,0;20,0;;8,0;;79,0;18,0;4,0;132,0;35,0;13,0;36,0;12,0;;154,0;1,0;75,0;;4,0;212,0;28,0;126,0;;3,0;10,0;11,0;11,0;5,0;;13,0;4,0;8,0;6,0;1,0;;;16,0;5,0;8,0;2,0;30,0;4,0;;11,0;9,0;;12,0;;13,0;;1,0;;2,0;62,0;;1,0;1,0;1,0;16,0;6,0;;;;;22,0;5,0;1,0;11,0;;;13,0;7,0;13,0;17,0;2,0;4,0;81,0;27,0;108,0;2,0;1,0;4,0;22,0;2,0;;12,0;195,0;17,0;8,0;;28,0;;3,0;;;3,0;16,0;;6,0;7,0;25,0;;8,0;1,0;;;;21,0;69,0;5,0;;10,0;;;47,0;1,0;;4,0;9,0;16,0;211,0;8,0;3,0;;9,0;8,0;2,0;14,0;30,0;5,0;6,0;10,0;46,0;5,0;13,0;3,0;52,0;35,0;36,0;276,0;21,0;49,0;;39,0;;4,0;6,0;5,0;6,0;10,0;4,0;722,0;28,0;2,0;3,0;32,0;109,0;2,0;30,0;;161,0;103,0;28,0;132,0;30,0;10,0;50,0;95,0;;42,0;437,0;164,0;4,0;12,0;36,0;163,0;8,0;41,0;23,0;63,0;3,0;11,0;79,0;35,0;30,0;10,0;;;8,0;28,0;5,0;24,0;64,0;6,0;;6,0;6,0;59,0;158,0;4,0;;45,0;15,0;154,0;4,0;66,0;90,0;39,0;11,0;75,0;7,0;10,0;17,0;45,0;;5,0;4,0;5,0;18,0;;33,0;131,0;37,0;12,0;6,0;3,0;8,0;27,0;17,0;23,0;7,0;9,0;106,0;12,0;3,0;14,0;5,0;9,0;1,0;4,0;33,0;2,0;13,0;19,0;25,0;;2,0;13,0;;7,0;9,0;10,0;42,0;14,0;5,0;45,0;15,0;15,0;35,0;1,0;21,0;6,0;33,0;5,0;;47,0;12,0;10,0;13,0;6,0;26,0;3,0;10,0;38,0;11,0;33,0;5,0;8,0;38,0;6,0;;31,0;20,0;16,0;6,0;23,0;14,0;3,0;25,0;;7,0;26,0;38,0;;31,0;1,0;42,0;;31,0;28,0;7,0;17,0;4,0;2,0;9,0;;;5,0;8,0;11,0;;10,0;15,0;24,0;7,0;1,0;106,0;;5,0;11,0;7,0;7,0;4,0;3,0;;2,0;2,0;17,0;2,0;13,0;1,0;13,0;16,0;14,0;14,0;11,0;;8,0;13,0;;34,0;4,0;2,0;16,0;;1,0;5,0;1,0;2,0;1,0;1,0;;40,0;23,0;1,0;235,0;9,0;;1,0;1,0;;7,0;18,0;8,0;;;;7,0;;12,0;1,0;13,0;3,0;21,0;10,0;1,0;1,0;26,0;2,0;164,0;10,0;1,0;1,0;1,0;7,0;6,0;4,0;;;2,0;2,0;;2,0;24,0;21,0;1,0;24,0;;14,0;43,0;1,0;7,0;1,0;2,0;;;;;;2,0;10,0;88,0;;;29,0;;13,0;3,0;;11,0;19,0;;;4,0;2,0;33,0;23,0;;;1,0;8,0;5,0;3,0;;12,0;6,0;33,0;62,0;;;;;2,0;;;13,0;;1,0;;;4,0;;2,0;;9,0;7,0;2,0;2,0;10,0;2,0;8,0;3,0;6,0;71,0;9,0;;4,0;17,0;7,0;8,0;;15,0;6,0;;;6,0;4,0;;20,0;2,0;1,0;;2,0;;9,0;6,0;;51,0;18,0;21,0;4,0;2,0;10,0;4,0;1,0;4,0;2,0;;4,0;;8,0;26,0;29,0;1,0;1,0;;3,0;4,0;21,0;12,0;18,0;4,0;4,0;4,0;12,0;12,0;1,0;4,0;16,0;13,0;;16,0;27,0;1,0;;;1,0;9,0;31,0;8,0;15,0;3,0;14,0;2,0;10,0;5,0;;77,0;10,0;2,0;16,0;;10,0;;9,0;12,0;13,0;13,0;;;6,0;11,0;7,0;50,0;;;;2,0;24,0;2,0;49,0;31,0;4,0;27,0;;6,0;7,0;;11,0;2,0;6,0;2,0;;23,0;64,0;;;;7,0;5,0;2,0;8,0;3,0;1,0;6,0;2,0;22,0;92,0;;5,0;;;2,0;14,0;7,0;1,0;2,0;;22,0;;30,0;7,0;10,0;5,0;;7,0;;4,0;1,0;14,0;5,0;10,0;6,0;4,0;;;2,0;1,0;10,0;3,0;;99,0;;3,0;;7,0;11,0;65,0;6,0;1,0;2,0;8,0;47,0;10,0;;1,0;2,0;73,0;;1,0;;1,0;;3,0;7,0;9,0;4,0;14,0;4,0;8,0;;6,0;1,0;1,0;11,0;1,0;;3,0;;11,0;2,0;;23,0;7,0;;15,0;;16,0;9,0;7,0;;2,0;4,0;21,0;;;152,0;4,0;;;8,0;17,0;2,0;2,0;;;1,0;;;6,0;1,0;;7,0;28,0;4,0;6,0;12,0;;;;4,0;7,0;;2,0;25,0;;2,0;1,0;2,0;26,0;6,0;;8,0;;2,0;20,0;9,0;2,0;10,0;13,0;;;10,0;16,0;;2,0;;;1,0
detection;1,0;6,0;;;7,0;36,0;2,0;136,0;264,0;28,0;12,0;;3,0;1,0;15,0;300,0;7,0;3,0;29,0;2,0;12,0;56,0;2,0;1,0;;;50,0;7,0;;1,0;5,0;16,0;224,0;67,0;121,0;17,0;5,0;44,0;15,0;;137,0;4,0;11,0;6,0;933,0;;109,0;347,0;59,0;69,0;20,0;38,0;2,0;12,0;23,0;119,0;116,0;6,0;24,0;;6,0;5,0;17,0;1,0;39,0;67,0;567,0;16,0;35,0;10,0;22,0;32,0;78,0;1,0;5,0;12,0;35,0;12,0;12,0;557,0;7,0;78,0;37,0;154,0;9,0;59,0;20,0;2,0;;1,0;194,0;1,0;;4,0;11,0;10,0;18,0;3,0;192,0;7,0;7,0;;106,0;246,0;1,0;22,0;84,0;8,0;115,0;15,0;9,0;189,0;;6,0;2,0;136,0;124,0;470,0;11,0;66,0;;;55,0;119,0;28,0;10,0;;2,0;18,0;148,0;1,0;44,0;11,0;;7,0;1,0;22,0;90,0;26,0;6,0;55,0;;2,0;88,0;70,0;;;12,0;311,0;41,0;16,0;;20,0;24,0;103,0;26,0;291,0;;8,0;;9,0;17,0;901,0;16,0;;;48,0;17,0;9,0;4,0;7,0;;;14,0;65,0;22,0;1,0;8,0;2,0;1,0;;89,0;;;10,0;40,0;2,0;34,0;3,0;;;18,0;;16,0;3,0;33,0;;3,0;2,0;;;7,0;87,0;87,0;8,0;;8,0;;19,0;287,0;4,0;;2,0;1,0;;2,0;1,0;;7,0;;13,0;5,0;1,0;1,0;3,0;;9,0;;132,0;;23,0;1,0;6,0;21,0;5,0;20,0;79,0;1,0;1,0;;6,0;8,0;2,0;4,0;84,0;5,0;15,0;3,0;214,0;49,0;8,0;;;1,0;;4,0;49,0;13,0;10,0;;3,0;;;31,0;3,0;35,0;7,0;;22,0;;2,0;18,0;15,0;;;2,0;33,0;12,0;9,0;12,0;14,0;26,0;24,0;2,0;;83,0;4,0;6,0;;2,0;78,0;1,0;107,0;;;8,0;10,0;1,0;;;9,0;6,0;;9,0;2,0;;;10,0;;4,0;7,0;15,0;3,0;;8,0;4,0;;5,0;1,0;11,0;;1,0;3,0;2,0;34,0;;;3,0;1,0;1,0;;;;;;21,0;;6,0;6,0;1,0;;4,0;;7,0;4,0;;3,0;13,0;7,0;19,0;;;11,0;13,0;;;2,0;92,0;2,0;5,0;2,0;4,0;;;;;;;;5,0;;5,0;;11,0;;;2,0;;19,0;18,0;6,0;;11,0;;;20,0;;;;8,0;;70,0;3,0;;;13,0;;2,0;70,0;35,0;3,0;;;27,0;;2,0;1,0;2,0;37,0;50,0;118,0;4,0;8,0;;3,0;1,0;2,0;1,0;1,0;;10,0;1,0;80,0;28,0;1,0;1,0;1,0;35,0;32,0;;;26,0;39,0;3,0;24,0;;4,0;22,0;47,0;;11,0;172,0;56,0;3,0;9,0;12,0;90,0;;2,0;19,0;31,0;;;7,0;21,0;12,0;4,0;;;2,0;5,0;1,0;4,0;7,0;2,0;;2,0;1,0;26,0;32,0;;1,0;11,0;37,0;23,0;2,0;27,0;1,0;9,0;;19,0;4,0;12,0;26,0;3,0;1,0;;1,0;2,0;7,0;;7,0;57,0;34,0;2,0;12,0;;4,0;5,0;4,0;25,0;;;44,0;5,0;;2,0;3,0;4,0;4,0;5,0;6,0;;1,0;2,0;11,0;;23,0;4,0;;13,0;2,0;;16,0;1,0;;18,0;5,0;10,0;5,0;;5,0;3,0;12,0;;;33,0;3,0;2,0;5,0;2,0;13,0;;;6,0;8,0;10,0;;;3,0;1,0;;27,0;3,0;;16,0;8,0;1,0;;11,0;;16,0;12,0;25,0;1,0;7,0;2,0;17,0;1,0;25,0;12,0;3,0;2,0;;;9,0;;;;;8,0;3,0;7,0;1,0;20,0;;;23,0;;1,0;4,0;;1,0;8,0;3,0;;;2,0;28,0;4,0;15,0;;3,0;1,0;;;4,0;;5,0;1,0;2,0;2,0;;1,0;5,0;;;1,0;1,0;1,0;3,0;1,0;;24,0;2,0;;100,0;7,0;;7,0;3,0;;;1,0;3,0;2,0;3,0;;7,0;;5,0;1,0;7,0;2,0;7,0;5,0;;1,0;19,0;5,0;47,0;6,0;;;1,0;;3,0;1,0;;;2,0;4,0;2,0;1,0;5,0;23,0;;10,0;;4,0;9,0;;22,0;5,0;;4,0;;;;;1,0;6,0;9,0;;;9,0;4,0;3,0;;;;;;;;;10,0;17,0;2,0;;;11,0;2,0;;;5,0;;11,0;;;;;6,0;5,0;1,0;;;;1,0;;;;;;;4,0;2,0;5,0;5,0;8,0;2,0;1,0;3,0;9,0;16,0;;1,0;2,0;;5,0;1,0;1,0;;6,0;1,0;;;1,0;4,0;1,0;;;;;;1,0;;1,0;33,0;18,0;4,0;;2,0;4,0;;21,0;6,0;4,0;1,0;1,0;;31,0;38,0;6,0;;;;;2,0;3,0;1,0;3,0;;;3,0;9,0;5,0;;6,0;31,0;2,0;1,0;15,0;10,0;;1,0;2,0;2,0;3,0;14,0;14,0;1,0;4,0;26,0;;15,0;;;7,0;2,0;;8,0;;2,0;5,0;4,0;;6,0;6,0;7,0;1,0;15,0;2,0;20,0;14,0;;;2,0;5,0;4,0;3,0;2,0;2,0;1,0;2,0;;;1,0;;3,0;;1,0;3,0;5,0;8,0;1,0;2,0;6,0;;1,0;14,0;;1,0;5,0;1,0;;1,0;6,0;5,0;;3,0;;;1,0;1,0;;6,0;;;1,0;;;1,0;1,0;;;1,0;;;;;;3,0;1,0;1,0;2,0;;7,0;;3,0;;;10,0;;;;2,0;;12,0;1,0;;;6,0;7,0;7,0;;;3,0;8,0;;4,0;;3,0;;3,0;2,0;4,0;2,0;2,0;2,0;2,0;;2,0;;;4,0;;;11,0;;;3,0;;;2,0;;3,0;;;;1,0;;;4,0;7,0;;1,0;46,0;3,0;;;6,0;19,0;;;;;;;;;;;;;2,0;;2,0;;2,0;;1,0;;;;3,0;;;;;1,0;8,0;;8,0;;1,0;7,0;2,0;22,0;4,0;5,0;;;;14,0;;2,0;;;6,0
determine;32,0;7,0;9,0;11,0;95,0;189,0;43,0;197,0;414,0;24,0;48,0;;136,0;23,0;101,0;925,0;9,0;43,0;103,0;5,0;149,0;402,0;6,0;8,0;23,0;52,0;322,0;27,0;9,0;9,0;106,0;103,0;546,0;28,0;473,0;159,0;49,0;146,0;11,0;27,0;751,0;16,0;67,0;157,0;289,0;109,0;;716,0;248,0;291,0;3,0;508,0;40,0;15,0;54,0;196,0;67,0;74,0;173,0;19,0;12,0;17,0;141,0;17,0;55,0;92,0;446,0;35,0;395,0;2,0;150,0;6,0;113,0;6,0;16,0;65,0;87,0;12,0;82,0;2772,0;28,0;145,0;19,0;410,0;25,0;117,0;30,0;11,0;3,0;86,0;279,0;1,0;16,0;11,0;73,0;93,0;52,0;12,0;1152,0;91,0;113,0;9,0;258,0;943,0;8,0;89,0;138,0;116,0;185,0;466,0;19,0;274,0;;6,0;6,0;431,0;249,0;1032,0;23,0;208,0;;;102,0;256,0;385,0;67,0;39,0;24,0;33,0;216,0;9,0;310,0;168,0;6,0;66,0;36,0;156,0;164,0;56,0;15,0;266,0;25,0;43,0;302,0;143,0;8,0;;24,0;320,0;125,0;32,0;4,0;92,0;142,0;175,0;15,0;521,0;1,0;65,0;22,0;16,0;34,0;1039,0;53,0;2,0;1,0;288,0;282,0;3,0;59,0;61,0;;;37,0;206,0;67,0;12,0;4,0;;2,0;1,0;64,0;;;5,0;85,0;;49,0;2,0;2,0;2,0;11,0;;40,0;;8,0;24,0;17,0;;6,0;4,0;25,0;215,0;258,0;120,0;;2,0;17,0;168,0;124,0;3,0;20,0;5,0;14,0;10,0;1,0;1,0;1,0;29,0;5,0;7,0;13,0;6,0;3,0;7,0;1,0;1,0;;319,0;2,0;6,0;;8,0;21,0;8,0;38,0;124,0;17,0;1,0;4,0;28,0;3,0;7,0;58,0;37,0;;1,0;39,0;506,0;83,0;5,0;7,0;3,0;2,0;;24,0;145,0;14,0;;2,0;;;;154,0;;25,0;43,0;1,0;32,0;;13,0;90,0;92,0;;6,0;;73,0;51,0;12,0;67,0;36,0;2,0;19,0;7,0;4,0;430,0;17,0;26,0;2,0;1,0;187,0;10,0;31,0;;6,0;1,0;44,0;1,0;2,0;;16,0;12,0;9,0;1,0;20,0;4,0;18,0;43,0;1,0;55,0;6,0;48,0;;;17,0;11,0;1,0;;4,0;19,0;;;2,0;;45,0;4,0;2,0;1,0;8,0;8,0;2,0;;1,0;1,0;;161,0;26,0;2,0;11,0;1,0;;;10,0;120,0;6,0;4,0;14,0;11,0;6,0;87,0;1,0;9,0;20,0;6,0;;2,0;2,0;575,0;30,0;24,0;20,0;33,0;;1,0;;;;8,0;1,0;16,0;47,0;3,0;;75,0;4,0;3,0;2,0;;18,0;133,0;;;36,0;;5,0;30,0;;;39,0;8,0;15,0;365,0;56,0;2,0;;40,0;5,0;49,0;97,0;17,0;16,0;32,0;15,0;32,0;;5,0;46,0;37,0;63,0;133,0;274,0;119,0;97,0;30,0;90,0;1,0;3,0;13,0;14,0;1,0;14,0;55,0;87,0;390,0;8,0;30,0;52,0;301,0;24,0;17,0;12,0;272,0;160,0;19,0;531,0;22,0;198,0;121,0;194,0;19,0;28,0;274,0;121,0;6,0;30,0;55,0;112,0;12,0;239,0;49,0;44,0;32,0;18,0;31,0;170,0;113,0;10,0;25,0;19,0;31,0;58,0;1,0;11,0;50,0;;1,0;25,0;3,0;227,0;96,0;58,0;22,0;37,0;135,0;298,0;5,0;206,0;64,0;49,0;;100,0;25,0;56,0;131,0;308,0;22,0;7,0;15,0;6,0;45,0;1,0;68,0;63,0;45,0;79,0;10,0;1,0;31,0;43,0;32,0;17,0;4,0;14,0;55,0;86,0;23,0;42,0;5,0;24,0;3,0;49,0;39,0;12,0;5,0;20,0;4,0;5,0;;5,0;19,0;16,0;23,0;3,0;147,0;13,0;65,0;32,0;2,0;28,0;49,0;16,0;66,0;31,0;20,0;5,0;;47,0;45,0;5,0;23,0;1,0;;4,0;20,0;8,0;30,0;51,0;24,0;;43,0;;;25,0;94,0;36,0;26,0;4,0;5,0;;6,0;6,0;5,0;9,0;91,0;;77,0;2,0;38,0;21,0;29,0;23,0;40,0;26,0;3,0;10,0;13,0;;;8,0;10,0;21,0;3,0;22,0;21,0;91,0;39,0;50,0;16,0;2,0;7,0;47,0;12,0;34,0;6,0;5,0;2,0;3,0;44,0;27,0;;51,0;16,0;29,0;14,0;4,0;62,0;62,0;2,0;4,0;19,0;12,0;33,0;2,0;3,0;3,0;21,0;2,0;12,0;;12,0;10,0;11,0;;62,0;26,0;;405,0;14,0;;15,0;4,0;;19,0;38,0;24,0;6,0;6,0;22,0;7,0;7,0;24,0;24,0;22,0;;33,0;14,0;47,0;;89,0;31,0;1,0;57,0;1,0;2,0;6,0;1,0;21,0;5,0;;;1,0;44,0;17,0;2,0;24,0;13,0;;78,0;;5,0;19,0;;14,0;7,0;;4,0;;2,0;;7,0;;8,0;48,0;9,0;;18,0;2,0;24,0;2,0;2,0;7,0;34,0;;;3,0;;1,0;10,0;13,0;;;;11,0;22,0;;6,0;31,0;59,0;4,0;;2,0;3,0;27,0;14,0;;;1,0;;;;1,0;3,0;;22,0;13,0;1,0;1,0;1,0;6,0;13,0;;24,0;30,0;8,0;24,0;;3,0;8,0;11,0;7,0;18,0;1,0;;1,0;1,0;;1,0;3,0;5,0;15,0;3,0;2,0;;;;3,0;2,0;;49,0;17,0;9,0;1,0;2,0;7,0;9,0;11,0;50,0;11,0;;31,0;;;63,0;60,0;1,0;6,0;7,0;7,0;93,0;89,0;69,0;31,0;;5,0;14,0;25,0;27,0;35,0;43,0;117,0;34,0;103,0;9,0;8,0;10,0;;;;21,0;16,0;67,0;17,0;16,0;60,0;6,0;94,0;4,0;;63,0;26,0;95,0;22,0;;48,0;12,0;10,0;9,0;4,0;1,0;38,0;22,0;11,0;20,0;36,0;28,0;7,0;5,0;11,0;6,0;8,0;6,0;112,0;20,0;14,0;55,0;3,0;7,0;;;2,0;;17,0;1,0;5,0;63,0;12,0;2,0;15,0;;5,0;32,0;3,0;8,0;31,0;6,0;3,0;6,0;10,0;84,0;10,0;5,0;41,0;11,0;14,0;;25,0;4,0;8,0;;16,0;14,0;62,0;6,0;6,0;;1,0;7,0;;4,0;1,0;4,0;2,0;11,0;9,0;14,0;13,0;5,0;51,0;9,0;14,0;6,0;36,0;2,0;;2,0;3,0;32,0;25,0;95,0;7,0;9,0;19,0;2,0;59,0;12,0;;;;4,0;;5,0;2,0;2,0;;11,0;16,0;61,0;;17,0;16,0;16,0;;13,0;26,0;;14,0;;37,0;3,0;;22,0;9,0;2,0;22,0;;;32,0;;;6,0;7,0;1,0;;;41,0;;17,0;;4,0;2,0;1,0;13,0;5,0;10,0;2,0;;2,0;8,0;;3,0;13,0;37,0;1,0;11,0;11,0;45,0;8,0;5,0;;10,0;;89,0;56,0;;39,0;15,0;8,0;7,0;;48,0;2,0;165,0;10,0;2,0;20,0;20,0;5,0;9,0;13,0;14,0;;21,0;1,0;9,0;9,0;4,0;;;;2,0
device;7,0;78,0;15,0;75,0;44,0;192,0;93,0;442,0;375,0;185,0;202,0;;362,0;20,0;226,0;648,0;51,0;27,0;34,0;41,0;168,0;1962,0;61,0;59,0;83,0;17,0;261,0;81,0;7,0;12,0;254,0;94,0;1395,0;4,0;2107,0;293,0;65,0;140,0;51,0;2,0;1523,0;9,0;194,0;36,0;482,0;347,0;716,0;;632,0;2604,0;195,0;236,0;30,0;21,0;301,0;183,0;451,0;20,0;147,0;39,0;64,0;467,0;96,0;137,0;209,0;69,0;211,0;375,0;318,0;114,0;219,0;36,0;471,0;104,0;2,0;146,0;221,0;62,0;205,0;6246,0;109,0;3811,0;92,0;2164,0;20,0;376,0;51,0;37,0;16,0;72,0;1240,0;23,0;24,0;80,0;59,0;205,0;346,0;13,0;1676,0;1663,0;37,0;41,0;743,0;489,0;24,0;148,0;1125,0;58,0;987,0;161,0;84,0;443,0;21,0;100,0;54,0;1048,0;530,0;959,0;313,0;151,0;35,0;25,0;126,0;1015,0;616,0;195,0;13,0;16,0;30,0;163,0;8,0;174,0;182,0;15,0;142,0;61,0;89,0;239,0;29,0;24,0;205,0;44,0;135,0;929,0;199,0;7,0;1,0;174,0;1189,0;72,0;35,0;23,0;1014,0;441,0;247,0;89,0;1515,0;6,0;77,0;242,0;94,0;390,0;1369,0;7,0;15,0;9,0;617,0;319,0;33,0;43,0;253,0;5,0;22,0;28,0;114,0;47,0;182,0;81,0;27,0;5,0;101,0;419,0;20,0;39,0;145,0;387,0;7,0;165,0;14,0;18,0;48,0;26,0;5,0;561,0;8,0;118,0;144,0;5,0;23,0;112,0;23,0;25,0;40,0;362,0;15,0;29,0;48,0;10,0;145,0;236,0;121,0;25,0;75,0;37,0;19,0;5,0;23,0;28,0;35,0;90,0;500,0;32,0;22,0;20,0;7,0;19,0;153,0;17,0;1316,0;85,0;364,0;37,0;138,0;597,0;106,0;147,0;132,0;193,0;40,0;69,0;46,0;50,0;14,0;92,0;68,0;27,0;186,0;70,0;847,0;67,0;139,0;19,0;11,0;11,0;23,0;60,0;1134,0;65,0;26,0;25,0;3,0;19,0;133,0;431,0;165,0;26,0;83,0;17,0;180,0;22,0;40,0;378,0;97,0;18,0;2,0;88,0;47,0;126,0;281,0;552,0;243,0;65,0;145,0;27,0;37,0;342,0;12,0;75,0;6,0;44,0;273,0;28,0;117,0;10,0;60,0;9,0;20,0;;59,0;9,0;79,0;116,0;193,0;5,0;21,0;15,0;68,0;92,0;60,0;24,0;1,0;132,0;94,0;4,0;52,0;51,0;9,0;219,0;4,0;515,0;11,0;34,0;22,0;22,0;471,0;37,0;35,0;21,0;11,0;30,0;23,0;50,0;15,0;5,0;6,0;69,0;12,0;88,0;111,0;69,0;31,0;3,0;44,0;117,0;76,0;44,0;129,0;108,0;39,0;121,0;6,0;30,0;62,0;719,0;31,0;93,0;87,0;221,0;1128,0;8,0;36,0;82,0;62,0;24,0;12,0;4,0;4,0;51,0;37,0;66,0;25,0;33,0;20,0;53,0;19,0;6,0;51,0;31,0;115,0;127,0;78,0;9,0;25,0;46,0;11,0;26,0;10,0;19,0;6,0;356,0;40,0;259,0;112,0;43,0;27,0;103,0;9,0;39,0;40,0;13,0;14,0;34,0;294,0;135,0;;4,0;14,0;18,0;18,0;131,0;243,0;145,0;75,0;11,0;1127,0;22,0;13,0;14,0;6,0;11,0;2,0;16,0;117,0;120,0;18,0;19,0;8,0;109,0;1,0;34,0;27,0;722,0;141,0;34,0;389,0;21,0;70,0;247,0;302,0;7,0;304,0;275,0;133,0;97,0;354,0;378,0;335,0;42,0;273,0;80,0;124,0;7,0;1,0;33,0;59,0;419,0;691,0;22,0;3,0;64,0;344,0;24,0;61,0;41,0;24,0;21,0;36,0;6,0;66,0;236,0;24,0;15,0;72,0;46,0;827,0;37,0;99,0;15,0;93,0;56,0;217,0;53,0;37,0;65,0;87,0;19,0;3,0;10,0;94,0;65,0;27,0;76,0;53,0;243,0;18,0;21,0;583,0;69,0;374,0;29,0;175,0;31,0;110,0;206,0;152,0;9,0;140,0;36,0;161,0;18,0;21,0;322,0;26,0;203,0;97,0;22,0;22,0;35,0;65,0;16,0;72,0;64,0;57,0;126,0;19,0;27,0;112,0;40,0;28,0;56,0;198,0;14,0;109,0;220,0;39,0;9,0;133,0;40,0;67,0;16,0;70,0;33,0;13,0;15,0;16,0;80,0;31,0;197,0;4,0;172,0;60,0;50,0;40,0;62,0;74,0;143,0;12,0;24,0;29,0;41,0;37,0;67,0;46,0;84,0;23,0;215,0;145,0;892,0;202,0;48,0;97,0;24,0;143,0;12,0;21,0;131,0;18,0;37,0;29,0;6,0;9,0;17,0;17,0;27,0;554,0;28,0;94,0;59,0;77,0;114,0;130,0;55,0;3,0;50,0;60,0;1,0;87,0;31,0;16,0;18,0;186,0;31,0;123,0;64,0;1,0;62,0;20,0;4,0;16,0;5,0;16,0;41,0;38,0;18,0;69,0;10,0;8,0;50,0;50,0;50,0;46,0;16,0;15,0;49,0;46,0;30,0;356,0;153,0;42,0;6,0;39,0;4,0;5,0;101,0;107,0;23,0;32,0;36,0;28,0;32,0;1,0;39,0;38,0;63,0;27,0;19,0;31,0;29,0;121,0;37,0;152,0;872,0;17,0;13,0;79,0;78,0;26,0;13,0;40,0;35,0;60,0;19,0;6,0;41,0;215,0;16,0;34,0;41,0;29,0;70,0;40,0;35,0;54,0;13,0;34,0;13,0;9,0;10,0;53,0;6,0;8,0;38,0;104,0;21,0;5,0;44,0;102,0;53,0;19,0;55,0;3,0;38,0;;2,0;29,0;25,0;27,0;52,0;69,0;2,0;1,0;19,0;78,0;66,0;29,0;10,0;23,0;170,0;2,0;23,0;19,0;7,0;14,0;52,0;17,0;73,0;45,0;1,0;51,0;7,0;9,0;47,0;11,0;33,0;48,0;40,0;46,0;37,0;10,0;22,0;9,0;40,0;48,0;7,0;262,0;16,0;42,0;35,0;11,0;32,0;37,0;72,0;11,0;46,0;3,0;7,0;16,0;14,0;46,0;3,0;3,0;7,0;15,0;18,0;17,0;15,0;5,0;20,0;114,0;28,0;8,0;16,0;16,0;13,0;54,0;43,0;18,0;48,0;20,0;54,0;23,0;114,0;71,0;26,0;24,0;6,0;10,0;5,0;41,0;9,0;27,0;31,0;6,0;11,0;20,0;13,0;111,0;8,0;18,0;87,0;33,0;7,0;106,0;39,0;1,0;9,0;20,0;3,0;56,0;40,0;16,0;17,0;27,0;40,0;8,0;2,0;33,0;12,0;21,0;25,0;69,0;91,0;;25,0;2,0;54,0;11,0;6,0;9,0;5,0;37,0;2,0;12,0;20,0;39,0;2,0;27,0;31,0;23,0;18,0;5,0;46,0;3,0;44,0;5,0;121,0;19,0;20,0;13,0;7,0;6,0;15,0;9,0;7,0;78,0;3,0;86,0;13,0;;24,0;6,0;9,0;43,0;24,0;27,0;30,0;26,0;27,0;13,0;3,0;17,0;9,0;16,0;15,0;4,0;96,0;25,0;8,0;4,0;8,0;3,0;18,0;93,0;3,0;21,0;49,0;17,0;6,0;19,0;27,0;9,0;11,0;4,0;246,0;19,0;29,0;3,0;13,0;12,0;4,0;12,0;15,0;24,0;2,0;28,0;5,0;;2,0;17,0;41,0;23,0;17,0;21,0;3,0;13,0;25,0;8,0;6,0;3,0;11,0;12,0;14,0;7,0;8,0;47,0;2,0;47,0;12,0;;23,0;1,0;2,0;15,0;33,0;12,0;44,0;5,0;21,0;82,0;1,0;7,0;3,0;35,0;22,0;19,0;2,0;3,0;16,0;;6,0;10,0;17,0;11,0;2,0;26,0;1,0;3,0;144,0;7,0;1,0;4,0;20,0;1,0;41,0;14,0;13,0;1,0;9,0;2,0;9,0;14,0;25,0;1,0;10,0;17,0;6,0;20,0;35,0;4,0;31,0;1,0;5,0;6,0;;4,0;1,0;3,0;106,0;7,0;6,0;5,0;32,0;;19,0;;16,0;7,0;6,0;11,0;9,0;;;14,0;;3,0;9,0;5,0;2,0;12,0;2,0
digital;24,0;;4,0;9,0;45,0;20,0;16,0;150,0;102,0;42,0;37,0;;105,0;16,0;64,0;154,0;;8,0;6,0;;5,0;777,0;9,0;10,0;2,0;25,0;123,0;30,0;12,0;1,0;114,0;32,0;228,0;2,0;278,0;35,0;53,0;47,0;30,0;30,0;626,0;3,0;40,0;11,0;96,0;59,0;248,0;632,0;;230,0;19,0;44,0;7,0;5,0;12,0;53,0;47,0;3,0;9,0;22,0;12,0;35,0;59,0;145,0;78,0;20,0;74,0;83,0;159,0;17,0;68,0;3,0;199,0;6,0;1,0;29,0;111,0;14,0;17,0;3627,0;4,0;335,0;12,0;483,0;11,0;82,0;7,0;7,0;;14,0;210,0;;16,0;2,0;21,0;50,0;234,0;8,0;492,0;45,0;24,0;32,0;202,0;120,0;7,0;51,0;219,0;14,0;246,0;40,0;20,0;146,0;14,0;;5,0;285,0;231,0;166,0;70,0;68,0;6,0;;107,0;266,0;291,0;46,0;;2,0;3,0;42,0;;80,0;11,0;5,0;24,0;30,0;26,0;33,0;58,0;3,0;178,0;2,0;23,0;331,0;65,0;;;12,0;866,0;23,0;12,0;1,0;131,0;429,0;49,0;29,0;742,0;;11,0;81,0;38,0;101,0;258,0;;;1,0;707,0;135,0;1,0;6,0;71,0;11,0;;14,0;20,0;24,0;41,0;3,0;;6,0;10,0;55,0;;3,0;25,0;134,0;;74,0;;;68,0;29,0;1,0;74,0;;7,0;204,0;4,0;4,0;10,0;1,0;7,0;18,0;62,0;6,0;;2,0;4,0;48,0;60,0;3,0;6,0;3,0;;5,0;6,0;;9,0;5,0;5,0;84,0;10,0;3,0;5,0;3,0;;2,0;;113,0;2,0;50,0;3,0;37,0;94,0;31,0;7,0;27,0;18,0;9,0;5,0;27,0;9,0;1,0;24,0;5,0;;;4,0;222,0;35,0;11,0;1,0;;3,0;;11,0;262,0;;;;;2,0;13,0;228,0;4,0;18,0;7,0;3,0;68,0;2,0;2,0;30,0;20,0;;2,0;2,0;11,0;17,0;5,0;75,0;34,0;11,0;10,0;4,0;9,0;156,0;7,0;33,0;;1,0;20,0;6,0;11,0;;2,0;12,0;2,0;;5,0;;21,0;13,0;57,0;1,0;2,0;;5,0;15,0;5,0;1,0;3,0;13,0;27,0;;12,0;55,0;9,0;27,0;4,0;95,0;;5,0;2,0;1,0;18,0;12,0;2,0;3,0;4,0;2,0;;1,0;1,0;2,0;;9,0;2,0;7,0;22,0;5,0;;;6,0;66,0;8,0;;;6,0;10,0;24,0;1,0;;43,0;10,0;;4,0;1,0;60,0;43,0;8,0;6,0;4,0;3,0;;2,0;;2,0;3,0;4,0;6,0;8,0;12,0;;6,0;;;8,0;3,0;17,0;11,0;4,0;;5,0;;8,0;21,0;;1,0;2,0;40,0;6,0;76,0;37,0;11,0;4,0;52,0;3,0;5,0;9,0;;10,0;49,0;18,0;21,0;15,0;;4,0;3,0;10,0;43,0;9,0;67,0;43,0;55,0;30,0;3,0;7,0;12,0;8,0;3,0;2,0;9,0;21,0;25,0;7,0;9,0;6,0;30,0;;11,0;1,0;169,0;44,0;1,0;78,0;2,0;20,0;23,0;127,0;1,0;24,0;93,0;61,0;2,0;96,0;65,0;113,0;1,0;53,0;40,0;66,0;5,0;;8,0;69,0;139,0;43,0;17,0;11,0;2,0;31,0;27,0;6,0;18,0;2,0;6,0;11,0;;27,0;8,0;2,0;1,0;36,0;9,0;185,0;7,0;11,0;4,0;32,0;;94,0;6,0;25,0;14,0;19,0;8,0;7,0;7,0;22,0;6,0;;9,0;8,0;18,0;11,0;16,0;59,0;6,0;107,0;9,0;38,0;11,0;75,0;136,0;71,0;;17,0;;41,0;6,0;15,0;33,0;;46,0;65,0;13,0;;4,0;21,0;;15,0;6,0;34,0;24,0;11,0;1,0;41,0;3,0;3,0;19,0;;13,0;36,0;25,0;9,0;;33,0;5,0;13,0;11,0;44,0;;2,0;4,0;20,0;30,0;20,0;8,0;;26,0;7,0;;3,0;;8,0;5,0;1,0;48,0;2,0;33,0;22,0;6,0;10,0;20,0;;21,0;9,0;67,0;24,0;3,0;141,0;22,0;8,0;;17,0;22,0;2,0;8,0;2,0;3,0;4,0;1,0;14,0;5,0;43,0;35,0;13,0;;3,0;18,0;39,0;;1,0;6,0;13,0;11,0;14,0;2,0;19,0;2,0;21,0;12,0;38,0;33,0;2,0;15,0;7,0;;3,0;;4,0;36,0;6,0;3,0;13,0;2,0;;15,0;34,0;7,0;7,0;11,0;1,0;6,0;5,0;34,0;68,0;10,0;20,0;6,0;15,0;;1,0;24,0;10,0;23,0;43,0;3,0;47,0;5,0;14,0;35,0;20,0;2,0;3,0;2,0;;;8,0;3,0;2,0;116,0;2,0;;11,0;17,0;19,0;7,0;2,0;1,0;12,0;9,0;;3,0;92,0;2,0;3,0;14,0;3,0;2,0;2,0;;6,0;4,0;19,0;4,0;;2,0;1,0;;3,0;;14,0;3,0;;16,0;;7,0;22,0;6,0;2,0;3,0;;10,0;;3,0;;4,0;67,0;;2,0;;6,0;3,0;;1,0;19,0;48,0;5,0;4,0;3,0;;1,0;5,0;2,0;7,0;22,0;1,0;2,0;;2,0;4,0;;;6,0;3,0;6,0;58,0;1,0;7,0;1,0;18,0;5,0;75,0;5,0;3,0;1,0;1,0;1,0;10,0;23,0;;;8,0;2,0;1,0;1,0;1,0;;12,0;1,0;1,0;16,0;11,0;;7,0;2,0;4,0;14,0;1,0;2,0;16,0;2,0;224,0;2,0;14,0;1,0;10,0;;30,0;;;39,0;41,0;;2,0;3,0;;7,0;11,0;6,0;54,0;;;7,0;1,0;23,0;;9,0;241,0;26,0;;6,0;18,0;2,0;;;7,0;;22,0;15,0;5,0;3,0;13,0;5,0;4,0;3,0;;1,0;8,0;15,0;30,0;;30,0;;4,0;2,0;;;5,0;29,0;9,0;9,0;14,0;7,0;;5,0;4,0;3,0;1,0;;12,0;;8,0;4,0;5,0;3,0;;;2,0;2,0;10,0;;1,0;10,0;;;8,0;;7,0;15,0;12,0;35,0;4,0;1,0;2,0;;2,0;14,0;3,0;7,0;2,0;;9,0;;87,0;5,0;1,0;1,0;;8,0;10,0;6,0;;;;11,0;1,0;3,0;;3,0;;1,0;6,0;4,0;5,0;;8,0;4,0;;11,0;81,0;;;7,0;1,0;18,0;3,0;10,0;9,0;2,0;75,0;6,0;;18,0;;;;1,0;1,0;;7,0;1,0;;23,0;;12,0;1,0;1,0;;;;2,0;23,0;;51,0;2,0;26,0;6,0;;1,0;;23,0;9,0;12,0;;2,0;;7,0;1,0;;;;;2,0;4,0;4,0;;10,0;;;;4,0;2,0;2,0;;;15,0;;;6,0;;2,0;12,0;21,0;1,0;25,0;9,0;;2,0;3,0;5,0;;;;4,0;;20,0;11,0;6,0;;;;2,0;;2,0;;;;6,0;;2,0;3,0;;;;;;22,0;10,0
display;2,0;13,0;1,0;36,0;1,0;75,0;24,0;589,0;395,0;60,0;17,0;;80,0;9,0;36,0;416,0;2,0;;21,0;78,0;94,0;570,0;55,0;17,0;29,0;3,0;202,0;34,0;;5,0;113,0;92,0;791,0;10,0;1392,0;271,0;75,0;32,0;48,0;;969,0;5,0;39,0;20,0;164,0;69,0;291,0;2604,0;230,0;;88,0;103,0;12,0;8,0;5,0;57,0;337,0;27,0;34,0;11,0;18,0;57,0;184,0;27,0;15,0;19,0;63,0;194,0;270,0;65,0;101,0;22,0;304,0;12,0;5,0;37,0;31,0;21,0;54,0;6257,0;14,0;180,0;28,0;677,0;19,0;187,0;9,0;1,0;;34,0;98,0;21,0;13,0;31,0;62,0;109,0;102,0;;873,0;125,0;28,0;37,0;255,0;390,0;;103,0;81,0;68,0;438,0;113,0;26,0;204,0;4,0;22,0;7,0;426,0;825,0;592,0;59,0;176,0;18,0;4,0;102,0;303,0;283,0;54,0;3,0;1,0;2,0;89,0;;57,0;94,0;5,0;86,0;113,0;43,0;226,0;8,0;2,0;156,0;39,0;22,0;227,0;148,0;11,0;;172,0;441,0;166,0;24,0;9,0;93,0;232,0;213,0;19,0;700,0;;55,0;39,0;50,0;73,0;1860,0;5,0;6,0;20,0;643,0;601,0;58,0;10,0;111,0;;;34,0;11,0;26,0;44,0;2,0;;1,0;5,0;169,0;;1,0;6,0;39,0;;139,0;4,0;3,0;12,0;10,0;;134,0;7,0;23,0;184,0;3,0;2,0;33,0;5,0;3,0;15,0;192,0;15,0;;4,0;4,0;25,0;145,0;12,0;23,0;9,0;;84,0;4,0;1,0;11,0;2,0;10,0;104,0;8,0;1,0;2,0;6,0;19,0;32,0;;385,0;;40,0;;177,0;86,0;27,0;60,0;30,0;11,0;8,0;20,0;54,0;331,0;10,0;34,0;28,0;;3,0;24,0;106,0;43,0;16,0;21,0;1,0;10,0;2,0;;307,0;22,0;;22,0;;;8,0;260,0;;;13,0;2,0;30,0;2,0;17,0;58,0;73,0;;;;36,0;22,0;23,0;188,0;186,0;;59,0;;9,0;161,0;10,0;203,0;;39,0;284,0;16,0;13,0;;9,0;16,0;3,0;2,0;1,0;;3,0;61,0;27,0;;26,0;7,0;1,0;12,0;16,0;52,0;;14,0;1,0;;18,0;47,0;6,0;6,0;;143,0;;2,0;;23,0;13,0;5,0;2,0;;93,0;8,0;;4,0;;;;7,0;17,0;72,0;6,0;4,0;;4,0;9,0;53,0;13,0;3,0;1,0;10,0;24,0;108,0;20,0;13,0;28,0;27,0;;3,0;13,0;137,0;132,0;13,0;;29,0;;4,0;1,0;11,0;;63,0;1,0;11,0;4,0;12,0;2,0;15,0;21,0;1,0;1,0;12,0;39,0;25,0;;1,0;22,0;8,0;3,0;20,0;6,0;3,0;;49,0;24,0;103,0;167,0;9,0;;23,0;11,0;10,0;31,0;7,0;1,0;2,0;19,0;49,0;1,0;2,0;1,0;5,0;34,0;64,0;167,0;39,0;23,0;46,0;103,0;1,0;3,0;4,0;9,0;11,0;;15,0;44,0;41,0;11,0;26,0;4,0;26,0;3,0;38,0;5,0;276,0;35,0;1,0;153,0;2,0;14,0;93,0;484,0;;367,0;36,0;190,0;54,0;24,0;168,0;241,0;30,0;102,0;28,0;38,0;5,0;3,0;45,0;41,0;189,0;152,0;50,0;7,0;20,0;33,0;44,0;9,0;10,0;;;60,0;12,0;27,0;51,0;14,0;10,0;17,0;52,0;667,0;3,0;7,0;7,0;2,0;2,0;87,0;10,0;5,0;43,0;77,0;;13,0;17,0;8,0;33,0;2,0;22,0;24,0;45,0;9,0;4,0;57,0;179,0;292,0;118,0;7,0;7,0;21,0;170,0;133,0;12,0;36,0;1,0;51,0;1,0;52,0;1287,0;32,0;22,0;44,0;3,0;15,0;8,0;136,0;10,0;6,0;8,0;22,0;67,0;14,0;16,0;23,0;11,0;55,0;32,0;16,0;16,0;20,0;23,0;13,0;;146,0;10,0;4,0;4,0;95,0;;8,0;2,0;200,0;51,0;28,0;47,0;;98,0;2,0;;74,0;65,0;6,0;19,0;5,0;25,0;7,0;55,0;13,0;11,0;3,0;25,0;;31,0;39,0;66,0;26,0;;102,0;10,0;33,0;1,0;28,0;32,0;9,0;;10,0;8,0;8,0;13,0;12,0;24,0;44,0;4,0;27,0;23,0;10,0;14,0;6,0;40,0;1,0;11,0;8,0;;9,0;92,0;17,0;;48,0;10,0;33,0;63,0;;12,0;9,0;5,0;;2,0;20,0;40,0;2,0;14,0;2,0;4,0;1,0;26,0;2,0;11,0;2,0;46,0;;24,0;32,0;12,0;277,0;26,0;14,0;1,0;2,0;1,0;1,0;39,0;16,0;6,0;7,0;9,0;18,0;7,0;12,0;54,0;17,0;4,0;23,0;22,0;7,0;5,0;194,0;6,0;;43,0;9,0;4,0;12,0;2,0;;11,0;4,0;6,0;;5,0;1,0;5,0;2,0;6,0;141,0;44,0;2,0;4,0;50,0;;9,0;17,0;9,0;1,0;9,0;;8,0;2,0;;15,0;51,0;6,0;1,0;25,0;82,0;14,0;;136,0;1,0;18,0;1,0;2,0;15,0;28,0;8,0;10,0;25,0;2,0;41,0;5,0;20,0;34,0;5,0;4,0;9,0;53,0;;;35,0;1,0;21,0;33,0;32,0;1,0;2,0;;3,0;;8,0;;;1,0;53,0;1,0;4,0;3,0;;4,0;;32,0;29,0;28,0;141,0;6,0;9,0;9,0;3,0;4,0;62,0;1,0;9,0;41,0;;3,0;14,0;4,0;;11,0;1,0;5,0;;2,0;;;6,0;;26,0;;;1,0;;3,0;7,0;5,0;16,0;;;11,0;;34,0;1,0;21,0;2,0;2,0;1,0;8,0;5,0;5,0;;49,0;1,0;;4,0;3,0;37,0;14,0;9,0;84,0;37,0;;8,0;37,0;54,0;;;5,0;24,0;6,0;4,0;3,0;;3,0;15,0;5,0;28,0;;14,0;12,0;22,0;4,0;;20,0;2,0;1,0;34,0;15,0;5,0;;79,0;1,0;;4,0;6,0;;1,0;2,0;3,0;;3,0;26,0;2,0;3,0;32,0;40,0;31,0;1,0;;16,0;;3,0;17,0;8,0;19,0;7,0;2,0;11,0;;8,0;4,0;28,0;7,0;;22,0;49,0;6,0;6,0;35,0;6,0;13,0;;1,0;14,0;1,0;76,0;30,0;;6,0;1,0;13,0;7,0;79,0;13,0;4,0;;102,0;;2,0;;14,0;11,0;1,0;6,0;39,0;42,0;1,0;5,0;8,0;;3,0;8,0;2,0;3,0;14,0;;1,0;;39,0;8,0;5,0;3,0;21,0;2,0;9,0;4,0;;;10,0;;4,0;19,0;;;17,0;18,0;;;6,0;5,0;6,0;;;10,0;;10,0;;;2,0;;6,0;2,0;11,0;15,0;9,0;;;10,0;4,0;51,0;34,0;4,0;;6,0;21,0;;24,0;;12,0;;;3,0;2,0;28,0;10,0;;2,0;3,0;;1,0;2,0;;24,0;3,0;18,0;5,0;15,0;44,0;;63,0;;1,0;12,0;;;19,0;;37,0;6,0;5,0;78,0;7,0;2,0;55,0;25,0;4,0;20,0;6,0;21,0;57,0;1,0;;5,0;6,0;;;1,0;5,0;75,0;4,0
dispose;1,0;105,0;;8,0;;32,0;74,0;80,0;117,0;19,0;86,0;8,0;5,0;6,0;118,0;149,0;29,0;;;2,0;19,0;40,0;;33,0;1,0;;39,0;2,0;4,0;;;9,0;89,0;;35,0;4,0;1,0;7,0;1,0;;40,0;;21,0;;47,0;20,0;3,0;195,0;19,0;88,0;;24,0;;;66,0;25,0;314,0;;1,0;;40,0;32,0;23,0;;108,0;14,0;20,0;56,0;66,0;136,0;5,0;3,0;18,0;2,0;;91,0;;10,0;21,0;352,0;37,0;184,0;;228,0;;1,0;3,0;;11,0;4,0;694,0;;6,0;46,0;;6,0;7,0;;49,0;24,0;1,0;3,0;223,0;87,0;4,0;10,0;221,0;25,0;24,0;;21,0;5,0;21,0;;1,0;282,0;489,0;189,0;26,0;9,0;2,0;17,0;;17,0;13,0;1,0;;;2,0;12,0;;19,0;36,0;3,0;1,0;2,0;41,0;2,0;;1,0;1,0;1,0;2,0;260,0;1,0;2,0;4,0;505,0;109,0;8,0;1,0;11,0;8,0;2,0;23,0;6,0;135,0;;3,0;27,0;;11,0;308,0;;;1,0;27,0;23,0;2,0;1,0;12,0;34,0;20,0;93,0;1,0;7,0;98,0;123,0;8,0;2,0;79,0;242,0;4,0;35,0;15,0;101,0;;52,0;4,0;2,0;1,0;;28,0;71,0;4,0;41,0;;;10,0;96,0;45,0;;;151,0;2,0;31,0;19,0;5,0;3,0;133,0;134,0;9,0;9,0;34,0;14,0;3,0;22,0;21,0;5,0;92,0;371,0;9,0;67,0;7,0;;48,0;85,0;4,0;231,0;;404,0;31,0;87,0;240,0;38,0;23,0;14,0;68,0;73,0;84,0;28,0;70,0;48,0;75,0;7,0;27,0;38,0;6,0;183,0;74,0;124,0;4,0;14,0;1,0;1,0;;67,0;13,0;20,0;11,0;9,0;13,0;16,0;13,0;42,0;1,0;39,0;30,0;50,0;1,0;17,0;69,0;100,0;33,0;;47,0;1,0;55,0;192,0;435,0;21,0;;114,0;13,0;7,0;10,0;3,0;19,0;14,0;65,0;69,0;31,0;9,0;6,0;48,0;;3,0;7,0;48,0;3,0;57,0;14,0;18,0;14,0;13,0;2,0;6,0;10,0;55,0;21,0;1,0;25,0;44,0;69,0;57,0;2,0;2,0;71,0;2,0;47,0;3,0;2,0;1,0;33,0;35,0;6,0;12,0;16,0;;2,0;15,0;10,0;20,0;1,0;3,0;;23,0;65,0;15,0;96,0;11,0;3,0;27,0;6,0;4,0;3,0;45,0;4,0;51,0;19,0;34,0;12,0;3,0;14,0;52,0;15,0;5,0;46,0;16,0;29,0;10,0;5,0;30,0;26,0;14,0;10,0;;48,0;34,0;22,0;4,0;;2,0;1,0;51,0;10,0;51,0;16,0;17,0;14,0;27,0;3,0;11,0;45,0;15,0;18,0;9,0;15,0;1,0;107,0;35,0;10,0;7,0;27,0;19,0;4,0;11,0;11,0;30,0;1,0;;6,0;;3,0;;;;;;2,0;6,0;;3,0;;3,0;9,0;;3,0;;;;1,0;42,0;4,0;;1,0;;2,0;;;;40,0;13,0;2,0;21,0;;1,0;3,0;;;6,0;5,0;16,0;;;24,0;21,0;;18,0;3,0;19,0;5,0;;;;13,0;3,0;;;;4,0;1,0;1,0;1,0;1,0;;;5,0;1,0;3,0;;1,0;;;18,0;;;;;6,0;21,0;24,0;;49,0;;9,0;;;1,0;1,0;1,0;15,0;;1,0;;8,0;1,0;1,0;19,0;;28,0;2,0;1,0;11,0;2,0;;5,0;2,0;76,0;;;6,0;;1,0;;1,0;1,0;;23,0;;6,0;;19,0;16,0;;;2,0;19,0;;55,0;;1,0;3,0;35,0;;10,0;;2,0;;23,0;;89,0;;;;1,0;;;;4,0;;14,0;16,0;2,0;1,0;33,0;;14,0;19,0;9,0;;8,0;13,0;2,0;5,0;;1,0;14,0;1,0;;14,0;;5,0;;8,0;;11,0;17,0;1,0;1,0;;18,0;;10,0;5,0;;;;15,0;;1,0;;;81,0;;3,0;;4,0;8,0;2,0;6,0;;5,0;;;9,0;;10,0;;;2,0;3,0;27,0;5,0;18,0;;;2,0;;;12,0;;9,0;;;;99,0;2,0;3,0;;13,0;8,0;;2,0;;;3,0;10,0;;;;4,0;6,0;;;;2,0;22,0;5,0;;;10,0;;9,0;7,0;8,0;2,0;1,0;31,0;15,0;6,0;2,0;1,0;5,0;31,0;14,0;3,0;10,0;1,0;11,0;12,0;6,0;4,0;;4,0;31,0;4,0;3,0;12,0;10,0;15,0;5,0;19,0;11,0;6,0;29,0;;16,0;25,0;7,0;4,0;6,0;11,0;;;8,0;6,0;2,0;21,0;10,0;32,0;3,0;10,0;;16,0;6,0;;1,0;;9,0;5,0;;;83,0;;4,0;9,0;2,0;18,0;21,0;41,0;22,0;6,0;1,0;4,0;90,0;41,0;15,0;;2,0;;1,0;1,0;11,0;11,0;;1,0;7,0;2,0;2,0;;59,0;3,0;3,0;16,0;17,0;4,0;2,0;21,0;;7,0;;;15,0;5,0;8,0;1,0;2,0;13,0;;;20,0;;5,0;;1,0;;72,0;5,0;;16,0;45,0;;;13,0;2,0;2,0;2,0;22,0;;2,0;2,0;10,0;;2,0;;1,0;;;2,0;;;47,0;4,0;;6,0;;;7,0;4,0;;25,0;5,0;;1,0;2,0;;2,0;2,0;1,0;;;;;1,0;;;2,0;;;;;4,0;;47,0;;3,0;;;1,0;3,0;;5,0;5,0;;13,0;16,0;1,0;11,0;;6,0;;1,0;4,0;6,0;;1,0;;;16,0;;;;;1,0;;;;2,0;;;;5,0;;7,0;;1,0;3,0;;3,0;;;;3,0;3,0;13,0;;25,0;;3,0;9,0;19,0;;;4,0;;;3,0;;;;;;2,0;2,0;3,0;;;;5,0;5,0;;1,0;;;5,0;19,0;24,0;;15,0;2,0;1,0;3,0;;3,0;1,0;6,0;3,0;;9,0;2,0;1,0;4,0;3,0;31,0;6,0;4,0;48,0;;;;1,0;;;6,0;23,0;;11,0;;;5,0;1,0;5,0;4,0;5,0;;;;;24,0;1,0;13,0;3,0;4,0;13,0;1,0;;2,0;;1,0;1,0;;12,0;2,0;;;;;;;2,0;;;3,0;;;;1,0;;;1,0;;2,0;3,0;1,0;;;;;;;;;;;;1,0;2,0;;
distance;2,0;1,0;1,0;;35,0;168,0;15,0;152,0;43,0;19,0;35,0;2,0;48,0;2,0;157,0;508,0;12,0;22,0;20,0;6,0;71,0;129,0;55,0;6,0;;5,0;40,0;7,0;;15,0;20,0;32,0;222,0;11,0;133,0;63,0;47,0;66,0;3,0;1,0;142,0;20,0;78,0;85,0;161,0;38,0;508,0;236,0;44,0;103,0;24,0;;1,0;33,0;9,0;60,0;84,0;39,0;124,0;2,0;16,0;5,0;84,0;;18,0;423,0;651,0;22,0;34,0;47,0;53,0;4,0;86,0;19,0;11,0;23,0;7,0;22,0;10,0;863,0;27,0;238,0;5,0;155,0;50,0;17,0;17,0;20,0;30,0;188,0;958,0;1,0;;38,0;66,0;14,0;27,0;7,0;337,0;39,0;20,0;2,0;173,0;1092,0;25,0;35,0;205,0;6,0;45,0;105,0;14,0;38,0;9,0;1,0;1,0;94,0;200,0;434,0;13,0;286,0;2,0;;36,0;29,0;63,0;15,0;6,0;6,0;4,0;135,0;;180,0;58,0;3,0;71,0;22,0;55,0;23,0;60,0;20,0;113,0;1,0;4,0;176,0;103,0;5,0;;191,0;74,0;41,0;23,0;1,0;48,0;47,0;243,0;;332,0;40,0;10,0;7,0;17,0;8,0;433,0;1,0;43,0;;22,0;67,0;2,0;;59,0;3,0;4,0;31,0;62,0;12,0;42,0;10,0;7,0;1,0;9,0;21,0;;;33,0;22,0;;28,0;;5,0;;8,0;;13,0;2,0;42,0;2,0;3,0;;11,0;1,0;;44,0;137,0;37,0;;13,0;10,0;20,0;43,0;5,0;3,0;2,0;6,0;;1,0;;;10,0;17,0;18,0;15,0;6,0;1,0;2,0;5,0;11,0;;145,0;;44,0;3,0;16,0;35,0;25,0;45,0;49,0;122,0;6,0;8,0;16,0;2,0;;8,0;11,0;6,0;10,0;10,0;325,0;112,0;9,0;2,0;9,0;;;4,0;93,0;19,0;2,0;6,0;;1,0;3,0;83,0;13,0;10,0;14,0;4,0;6,0;;8,0;69,0;111,0;2,0;1,0;8,0;5,0;9,0;13,0;268,0;9,0;;11,0;14,0;;101,0;3,0;;1,0;2,0;96,0;55,0;5,0;;5,0;4,0;18,0;;1,0;1,0;9,0;9,0;6,0;47,0;8,0;;;14,0;27,0;7,0;;9,0;3,0;1,0;93,0;16,0;;1,0;7,0;11,0;1,0;;7,0;15,0;36,0;3,0;5,0;24,0;10,0;3,0;8,0;1,0;49,0;;1,0;18,0;15,0;15,0;7,0;7,0;2,0;5,0;1,0;17,0;42,0;2,0;3,0;29,0;14,0;33,0;6,0;11,0;;40,0;1,0;20,0;;228,0;7,0;5,0;10,0;11,0;;6,0;10,0;1,0;;11,0;10,0;6,0;22,0;;;4,0;3,0;1,0;12,0;1,0;8,0;50,0;3,0;;11,0;8,0;13,0;22,0;4,0;3,0;2,0;30,0;;216,0;12,0;1,0;5,0;12,0;5,0;30,0;10,0;4,0;;3,0;;18,0;;5,0;;8,0;25,0;483,0;103,0;19,0;22,0;1,0;65,0;15,0;1,0;;;;1,0;19,0;41,0;27,0;3,0;;36,0;32,0;;29,0;;26,0;7,0;13,0;162,0;6,0;42,0;292,0;45,0;2,0;9,0;43,0;93,0;4,0;7,0;19,0;35,0;18,0;18,0;8,0;14,0;;8,0;50,0;18,0;27,0;7,0;2,0;;7,0;52,0;1,0;5,0;19,0;;2,0;;6,0;152,0;16,0;2,0;32,0;4,0;5,0;41,0;5,0;21,0;29,0;2,0;12,0;206,0;3,0;6,0;116,0;76,0;3,0;5,0;6,0;6,0;13,0;2,0;14,0;3,0;12,0;19,0;14,0;15,0;25,0;20,0;3,0;112,0;1,0;;61,0;4,0;21,0;7,0;;3,0;3,0;17,0;28,0;28,0;6,0;;;4,0;;;;20,0;4,0;6,0;34,0;3,0;2,0;3,0;1,0;;7,0;;7,0;;6,0;;;85,0;3,0;1,0;19,0;;7,0;;53,0;;5,0;35,0;;3,0;11,0;;;15,0;17,0;;6,0;2,0;;8,0;1,0;;4,0;12,0;11,0;1,0;11,0;1,0;2,0;;11,0;26,0;1,0;1,0;;;4,0;2,0;6,0;1,0;;11,0;;;10,0;14,0;46,0;1,0;1,0;;9,0;4,0;;;7,0;1,0;4,0;;;102,0;;29,0;;9,0;2,0;;11,0;4,0;3,0;;;7,0;;1,0;;;2,0;2,0;2,0;;;6,0;4,0;3,0;13,0;3,0;;86,0;46,0;;6,0;2,0;;;27,0;;;;1,0;2,0;3,0;1,0;22,0;1,0;;;;10,0;6,0;42,0;5,0;;1,0;;3,0;18,0;4,0;3,0;2,0;2,0;;;;2,0;1,0;13,0;7,0;3,0;4,0;1,0;9,0;6,0;5,0;7,0;;;51,0;;;2,0;2,0;;6,0;11,0;;1,0;59,0;;4,0;1,0;3,0;;19,0;6,0;;1,0;;;;2,0;3,0;;2,0;2,0;2,0;;2,0;5,0;55,0;23,0;;1,0;;;7,0;;;2,0;1,0;;1,0;;3,0;;;5,0;6,0;1,0;3,0;5,0;9,0;;;8,0;4,0;7,0;1,0;7,0;;1,0;6,0;;7,0;1,0;5,0;;;;2,0;3,0;8,0;;6,0;3,0;;;4,0;;;3,0;2,0;4,0;;;;5,0;7,0;1,0;;1,0;;4,0;3,0;18,0;31,0;;;;3,0;15,0;65,0;7,0;4,0;;18,0;14,0;5,0;26,0;1,0;;3,0;;4,0;2,0;19,0;4,0;;;;2,0;8,0;33,0;4,0;;82,0;;3,0;5,0;;3,0;2,0;51,0;12,0;;9,0;11,0;;17,0;;35,0;1,0;47,0;;22,0;17,0;4,0;1,0;2,0;;3,0;;1,0;24,0;17,0;1,0;4,0;7,0;2,0;2,0;;;;4,0;2,0;2,0;5,0;1,0;3,0;4,0;2,0;3,0;4,0;;;47,0;2,0;1,0;;;16,0;19,0;;25,0;;5,0;1,0;20,0;2,0;;;6,0;1,0;1,0;7,0;;2,0;;2,0;1,0;;5,0;8,0;1,0;23,0;;1,0;;;25,0;4,0;2,0;;2,0;;;1,0;2,0;2,0;;2,0;4,0;5,0;3,0;14,0;;;2,0;1,0;;;2,0;;4,0;;;47,0;5,0;65,0;3,0;3,0;11,0;;1,0;1,0;16,0;2,0;;1,0;;7,0;28,0;1,0;13,0;;9,0;4,0;3,0;;2,0;14,0;;;2,0;;;42,0;;1,0;;9,0;24,0;;6,0;61,0;1,0;;1,0;23,0;1,0;;49,0;11,0;;5,0;;9,0;27,0;7,0;;;3,0;;4,0;23,0;;10,0;65,0;;;;11,0;;6,0;5,0;7,0;4,0;3,0;5,0;;4,0;8,0;3,0;;;5,0;;;1,0;;;1,0
distortion;32,0;;;;;11,0;1,0;15,0;17,0;;;6,0;10,0;;2,0;30,0;1,0;;;;16,0;15,0;2,0;;;25,0;3,0;1,0;;3,0;7,0;11,0;44,0;;1,0;2,0;231,0;226,0;;;22,0;4,0;1,0;2,0;17,0;2,0;40,0;30,0;7,0;12,0;;1,0;;6,0;;2,0;6,0;5,0;13,0;;;;9,0;;2,0;38,0;;4,0;9,0;;10,0;;22,0;3,0;47,0;5,0;6,0;1,0;7,0;303,0;;12,0;;28,0;;1,0;9,0;;7,0;6,0;89,0;;;;;6,0;;;70,0;;12,0;7,0;5,0;26,0;1,0;1,0;64,0;1,0;6,0;38,0;;29,0;;1,0;;;8,0;11,0;5,0;2,0;2,0;;18,0;25,0;16,0;6,0;3,0;15,0;;7,0;;;3,0;7,0;1,0;;2,0;7,0;;8,0;;;;9,0;;10,0;;3,0;7,0;8,0;;;1,0;8,0;9,0;2,0;33,0;;4,0;;2,0;;46,0;;;;2,0;13,0;3,0;;22,0;;;1,0;42,0;17,0;2,0;2,0;;;;;;;;;;27,0;;;;;;;;;;1,0;;4,0;;;2,0;7,0;;;;;;2,0;;3,0;;;;;;;22,0;;;4,0;;;;;;;3,0;;;;;;;;12,0;;;;1,0;3,0;;;;;;2,0;3,0;30,0;;;;;;;6,0;3,0;;;;;;6,0;;;15,0;;1,0;;;;3,0;;;;4,0;1,0;;13,0;;;;;;1,0;;4,0;;3,0;6,0;9,0;;;;;;;;;;1,0;;;;;;3,0;;;;;;;2,0;;;;;;;;;;1,0;;;;;;;;;;;;;;18,0;;;;;1,0;8,0;;;;1,0;27,0;;;;1,0;;;;7,0;;2,0;;;;;;;;6,0;;2,0;;;;1,0;;;;;;7,0;;;;;;1,0;;;;;;2,0;;;;2,0;;;;;;;;;5,0;;;1,0;18,0;17,0;27,0;;;;1,0;;;;;1,0;3,0;;;;;;;19,0;;2,0;;10,0;;;2,0;;3,0;5,0;24,0;;;11,0;;;;;18,0;;2,0;;2,0;;;;1,0;2,0;;;;;;;;;;;3,0;;;;;;;;;;3,0;;;1,0;1,0;;3,0;9,0;2,0;;3,0;2,0;;;;;;12,0;16,0;3,0;;;;;;;4,0;8,0;;;17,0;;;;1,0;6,0;;;;;;;;;6,0;;;;3,0;;;;4,0;;;1,0;;;2,0;;;;;;;;;;2,0;14,0;7,0;;;8,0;;;;2,0;1,0;1,0;;;;;;1,0;2,0;2,0;;2,0;;;;1,0;;;3,0;;1,0;;;;;;;;;;;1,0;;;;;5,0;;;;;;;;3,0;;5,0;;;;;;;;;;;2,0;3,0;;;;;;;1,0;;2,0;;1,0;1,0;;12,0;3,0;;2,0;;;;7,0;1,0;;;;;;3,0;1,0;;;;;1,0;;;;;;;;;;;;;;;1,0;;;1,0;;;3,0;;;;1,0;;2,0;;;;;;;;;;;;7,0;;2,0;;;;;3,0;;;;;;;;;;;4,0;;;1,0;;;;;;;;;;;;;;;;;;;;;;;6,0;;;2,0;;;;;;;14,0;;;;;;;;;;;;;;;;;;;;;;;;;2,0;;;;;;;;;1,0;;;;;4,0;17,0;;;;;;2,0;;;;2,0;5,0;10,0;;;4,0;;;;;;2,0;;;8,0;;1,0;;;;;3,0;3,0;;1,0;;2,0;;;;;;;;3,0;;;;;;;;2,0;;;1,0;;;;;;;;;1,0;;;;;;;;;;;2,0;;;;;;;2,0;;;;;;;;10,0;;;;;;;;;;;;;;;;;;5,0;;;;;;;;;;;;;;;;;1,0;;;;;;;;;;;2,0;;;;8,0;;1,0;;2,0;;;;;;;;7,0;;;;;2,0;;;;;;;;1,0;;;;;;;;;;;;;;;;;;;;3,0;;;;;12,0;;2,0;;;;;;1,0;;1,0;;2,0;1,0;3,0;;2,0;;;;;;2,0;;;;;;;;
divide;2,0;;1,0;;3,0;14,0;10,0;9,0;124,0;18,0;17,0;;1,0;;4,0;6,0;3,0;;3,0;;;12,0;;3,0;;1,0;42,0;;;;1,0;6,0;19,0;;13,0;;;5,0;3,0;;43,0;;2,0;3,0;6,0;12,0;15,0;21,0;5,0;8,0;;33,0;6,0;;1,0;2,0;45,0;;2,0;;4,0;;5,0;;10,0;15,0;27,0;30,0;41,0;4,0;;;6,0;2,0;7,0;11,0;1,0;;;210,0;;15,0;;59,0;1,0;;1,0;;;17,0;26,0;;;;;;;;39,0;2,0;7,0;;11,0;19,0;;;8,0;;5,0;2,0;;12,0;;;49,0;146,0;29,0;12,0;;13,0;2,0;2,0;1,0;12,0;3,0;2,0;;;;15,0;;10,0;5,0;;8,0;1,0;54,0;;8,0;;7,0;;12,0;15,0;8,0;;;1,0;127,0;16,0;;;1,0;3,0;5,0;8,0;16,0;;1,0;22,0;1,0;2,0;66,0;2,0;;;12,0;20,0;;8,0;3,0;;;11,0;3,0;6,0;3,0;;;;;;;;8,0;3,0;;46,0;;;;;;1,0;2,0;1,0;;;;3,0;;;9,0;36,0;2,0;;;;20,0;16,0;;1,0;;4,0;;;3,0;1,0;2,0;7,0;;5,0;;;;;2,0;;56,0;;6,0;;;;4,0;2,0;3,0;1,0;1,0;;8,0;1,0;;2,0;;2,0;13,0;;347,0;10,0;;;;;;;20,0;2,0;;;;;;15,0;4,0;;1,0;2,0;;;;9,0;13,0;4,0;;4,0;;2,0;;9,0;;;2,0;;;36,0;9,0;1,0;;1,0;6,0;2,0;;9,0;1,0;;;;1,0;;2,0;3,0;3,0;;2,0;;;44,0;1,0;;;1,0;;;1,0;;1,0;1,0;;;;;;2,0;2,0;;;2,0;;10,0;3,0;;;;;2,0;;1,0;;;;;;;4,0;;1,0;1,0;12,0;6,0;12,0;1,0;;6,0;2,0;;;14,0;;7,0;;2,0;;;;2,0;;1,0;;;;;;;;;;;1,0;;;;13,0;;;;;;;;;15,0;1,0;;;;;11,0;;;;;;;;;;3,0;7,0;21,0;6,0;2,0;8,0;;;;;;;;;;5,0;3,0;;3,0;6,0;4,0;6,0;;;13,0;6,0;;6,0;10,0;10,0;4,0;6,0;;;3,0;;;;;;1,0;;24,0;7,0;;;3,0;1,0;2,0;;;;4,0;2,0;;;;;;;5,0;6,0;3,0;;2,0;;;;;3,0;5,0;9,0;;23,0;;4,0;2,0;4,0;1,0;1,0;;;1,0;;;;1,0;1,0;;;;3,0;2,0;;;;11,0;2,0;;;;18,0;;2,0;13,0;;;;;;;;;;;;1,0;;;1,0;;;;;3,0;;;;;3,0;14,0;;1,0;;;;4,0;5,0;;9,0;;;4,0;;;;;;6,0;;;;;;1,0;75,0;13,0;;;;;;;;;;;;;;;;;;1,0;;;;9,0;;;1,0;;;;;1,0;;;;;6,0;;;;4,0;;;2,0;;;;;;3,0;3,0;;;;;2,0;;;13,0;;;1,0;;;47,0;8,0;;;1,0;;4,0;2,0;;1,0;11,0;;;;;;3,0;;4,0;;;2,0;;;2,0;;;;3,0;;1,0;2,0;;2,0;;3,0;2,0;;33,0;;;2,0;;;1,0;;;;;;;;;;1,0;;3,0;;;3,0;;;;;;;;;;;;5,0;4,0;;;;;;;;;;;;;;;1,0;;;;;2,0;;;;5,0;;2,0;2,0;;;;;;;;;4,0;1,0;;;;;;2,0;;2,0;;1,0;;2,0;;;;;;;;;2,0;;;1,0;2,0;;12,0;;;;;11,0;;;10,0;1,0;;8,0;22,0;1,0;;1,0;;9,0;;;;3,0;;;3,0;;16,0;4,0;3,0;;2,0;;;1,0;;;1,0;;8,0;;21,0;2,0;;10,0;;;13,0;;1,0;8,0;;;;2,0;22,0;;6,0;;1,0;;;;;;;;;;;5,0;;;;;;;;;;;;;1,0;;;;;;1,0;;1,0;;;;;3,0;;;;;1,0;;;;;;;3,0;;;1,0;;;;;;;;;;;;6,0;;;;;;;;;;2,0;;;;1,0;;1,0;;;;3,0;;;;;;;;;;4,0;;;;;;;;;;;;;;;;7,0;;;;;;;;;;1,0;;;;1,0;2,0;8,0;;3,0;;;;8,0;;;;6,0;;;6,0;;;;3,0;7,0;;5,0;;;3,0;;;;;2,0;;;;;;;;;2,0;;4,0;;1,0;;;1,0;;;2,0;;;;;;
drive;1,0;4,0;2,0;8,0;2,0;13,0;31,0;153,0;17,0;49,0;6,0;;9,0;9,0;127,0;246,0;5,0;10,0;;4,0;3,0;26,0;39,0;2,0;1,0;;12,0;1,0;1,0;3,0;1,0;243,0;343,0;6,0;653,0;198,0;6,0;32,0;2,0;1,0;18,0;2,0;16,0;;18,0;23,0;54,0;301,0;12,0;5,0;66,0;9,0;;1,0;;1,0;251,0;4,0;2,0;;17,0;7,0;15,0;;7,0;3,0;384,0;52,0;83,0;16,0;16,0;11,0;195,0;;;53,0;1,0;;3,0;199,0;4,0;67,0;1,0;275,0;14,0;126,0;103,0;4,0;1,0;13,0;1019,0;;2,0;1,0;1,0;11,0;8,0;;58,0;12,0;1,0;;84,0;65,0;1,0;86,0;185,0;7,0;110,0;3,0;4,0;87,0;;;7,0;111,0;321,0;346,0;56,0;118,0;5,0;3,0;12,0;38,0;6,0;;;9,0;1,0;39,0;23,0;33,0;40,0;4,0;19,0;;8,0;25,0;2,0;26,0;1,0;;33,0;37,0;21,0;;;32,0;437,0;4,0;29,0;1,0;34,0;30,0;18,0;78,0;153,0;;101,0;172,0;;89,0;1386,0;;12,0;;4,0;3,0;;1,0;73,0;;;3,0;173,0;35,0;106,0;66,0;14,0;;8,0;138,0;;1,0;167,0;148,0;;9,0;3,0;;;;3,0;80,0;7,0;94,0;;2,0;1,0;36,0;4,0;5,0;9,0;330,0;21,0;22,0;48,0;;27,0;113,0;4,0;;355,0;4,0;1,0;;14,0;3,0;1,0;7,0;68,0;;7,0;5,0;24,0;3,0;6,0;44,0;78,0;1,0;612,0;3,0;129,0;50,0;113,0;170,0;99,0;45,0;23,0;22,0;5,0;1,0;1,0;18,0;79,0;;1,0;;324,0;36,0;118,0;;;;7,0;48,0;95,0;1,0;;;2,0;;6,0;44,0;;3,0;19,0;5,0;221,0;;37,0;54,0;7,0;1,0;;49,0;26,0;4,0;4,0;88,0;8,0;6,0;22,0;;5,0;115,0;;3,0;40,0;;31,0;13,0;144,0;;4,0;;2,0;;33,0;18,0;161,0;15,0;83,0;;4,0;2,0;18,0;13,0;7,0;17,0;;43,0;2,0;7,0;32,0;;;1,0;;45,0;10,0;5,0;4,0;1,0;550,0;;48,0;12,0;;2,0;1,0;2,0;4,0;;;112,0;16,0;40,0;43,0;57,0;7,0;1,0;5,0;9,0;14,0;25,0;6,0;353,0;31,0;3,0;10,0;44,0;17,0;67,0;64,0;50,0;19,0;7,0;1,0;1,0;7,0;8,0;7,0;4,0;;;;20,0;1,0;;10,0;23,0;2,0;;;;12,0;2,0;129,0;32,0;29,0;2,0;3,0;169,0;;14,0;6,0;1,0;;53,0;2,0;180,0;;3,0;7,0;104,0;21,0;6,0;3,0;;2,0;;3,0;18,0;;;8,0;1,0;36,0;122,0;74,0;5,0;;;2,0;14,0;;8,0;10,0;;;13,0;13,0;5,0;1,0;;2,0;;;2,0;;28,0;43,0;36,0;3,0;;;7,0;80,0;4,0;1,0;25,0;73,0;;;47,0;133,0;1,0;5,0;28,0;2,0;;4,0;;3,0;26,0;;;;;11,0;;45,0;95,0;15,0;15,0;7,0;6,0;5,0;12,0;1,0;;1,0;34,0;4,0;;;3,0;99,0;;32,0;5,0;;33,0;7,0;60,0;;;1,0;;9,0;;;22,0;;18,0;;;4,0;;163,0;;;12,0;8,0;2,0;;;292,0;;;1,0;;;2,0;;2,0;;7,0;;15,0;10,0;2,0;4,0;;;5,0;16,0;;8,0;;1,0;1,0;10,0;4,0;1,0;28,0;1,0;1,0;18,0;;218,0;;5,0;;14,0;10,0;5,0;1,0;18,0;;;;;11,0;5,0;1,0;;;1,0;;30,0;1,0;2,0;10,0;38,0;;8,0;;40,0;10,0;;3,0;;6,0;6,0;1,0;4,0;3,0;4,0;;2,0;;11,0;3,0;3,0;;;11,0;;;;50,0;5,0;7,0;;;;14,0;5,0;18,0;;1,0;;;8,0;16,0;;;;;;4,0;;;;8,0;;;;4,0;;;;;;33,0;2,0;;4,0;42,0;2,0;;;;;5,0;1,0;14,0;;;5,0;;6,0;;11,0;10,0;13,0;;7,0;31,0;;;1,0;5,0;2,0;2,0;;1,0;22,0;;10,0;;3,0;8,0;9,0;5,0;4,0;14,0;108,0;123,0;;24,0;;2,0;;3,0;18,0;4,0;2,0;;;14,0;1,0;16,0;13,0;1,0;5,0;;6,0;;;13,0;;;10,0;1,0;3,0;2,0;3,0;;;1,0;;7,0;44,0;8,0;2,0;31,0;2,0;4,0;;;8,0;;;;1,0;130,0;5,0;;6,0;;3,0;;242,0;6,0;4,0;;;;;;;;1,0;3,0;3,0;;15,0;1,0;;;12,0;;5,0;5,0;5,0;;2,0;;;1,0;1,0;;24,0;1,0;2,0;26,0;7,0;;3,0;;11,0;;5,0;;1,0;;;1,0;84,0;6,0;;;6,0;;5,0;16,0;4,0;15,0;1,0;;;;2,0;9,0;;2,0;;;;8,0;66,0;;1,0;;;3,0;5,0;10,0;1,0;3,0;57,0;;;;13,0;;4,0;6,0;2,0;;;;6,0;;27,0;;;;;1,0;;13,0;5,0;;1,0;;;;9,0;;4,0;5,0;3,0;;27,0;11,0;;;;3,0;;29,0;;8,0;12,0;;6,0;;;;2,0;2,0;;19,0;;;6,0;1,0;;2,0;;;;;;1,0;16,0;;;;35,0;2,0;62,0;;15,0;;6,0;10,0;;;;;;4,0;2,0;;;;1,0;2,0;;3,0;;;;;;;;7,0;;;2,0;10,0;1,0;1,0;;;;;1,0;12,0;;2,0;;2,0;1,0;19,0;38,0;11,0;6,0;36,0;;5,0;;3,0;;;;;;10,0;1,0;;;;1,0;;;4,0;2,0;;2,0;;;;;;;3,0;2,0;;;;;;;24,0;;;;3,0;1,0;1,0;2,0;;;3,0;;2,0;;1,0;;;;3,0;;;1,0;;;;;;2,0;;;;1,0;;3,0;;;;;;
edge;1,0;;;21,0;10,0;24,0;19,0;78,0;69,0;21,0;6,0;;36,0;;18,0;159,0;;9,0;29,0;;13,0;48,0;3,0;1,0;3,0;24,0;77,0;2,0;1,0;;1,0;1,0;53,0;27,0;9,0;3,0;33,0;34,0;2,0;8,0;51,0;6,0;36,0;32,0;222,0;119,0;196,0;183,0;53,0;57,0;25,0;60,0;2,0;2,0;1,0;;25,0;1,0;18,0;;124,0;4,0;7,0;;94,0;3,0;35,0;146,0;39,0;55,0;12,0;2,0;37,0;;1,0;6,0;75,0;8,0;17,0;554,0;1,0;39,0;;138,0;8,0;2,0;1,0;5,0;18,0;29,0;75,0;2,0;2,0;103,0;11,0;5,0;4,0;;142,0;;50,0;7,0;50,0;58,0;;34,0;14,0;1,0;37,0;5,0;6,0;87,0;76,0;1,0;1,0;199,0;258,0;100,0;1,0;5,0;;2,0;39,0;75,0;25,0;1,0;;;;6,0;;95,0;9,0;2,0;40,0;4,0;38,0;34,0;8,0;3,0;2,0;1,0;5,0;34,0;1,0;2,0;;141,0;95,0;13,0;;1,0;1,0;11,0;25,0;;37,0;;2,0;2,0;9,0;3,0;195,0;;;1,0;29,0;20,0;2,0;2,0;;;10,0;42,0;19,0;39,0;20,0;20,0;2,0;;23,0;49,0;4,0;11,0;;16,0;1,0;77,0;;;;1,0;28,0;43,0;2,0;23,0;4,0;17,0;12,0;29,0;15,0;1,0;62,0;68,0;;;;6,0;;33,0;11,0;8,0;1,0;2,0;1,0;;11,0;2,0;3,0;25,0;59,0;1,0;40,0;;;2,0;23,0;;22,0;;89,0;2,0;2,0;44,0;1,0;10,0;1,0;228,0;47,0;89,0;13,0;37,0;6,0;5,0;;;;10,0;151,0;9,0;45,0;;1,0;5,0;2,0;1,0;33,0;1,0;3,0;;;;12,0;31,0;;;19,0;2,0;7,0;;9,0;4,0;24,0;13,0;;2,0;2,0;37,0;27,0;129,0;5,0;;4,0;20,0;9,0;10,0;;2,0;;;15,0;61,0;;1,0;49,0;;7,0;3,0;1,0;1,0;3,0;5,0;19,0;16,0;;3,0;;10,0;48,0;16,0;;134,0;1,0;13,0;12,0;13,0;;13,0;4,0;22,0;;5,0;1,0;18,0;7,0;;28,0;5,0;;5,0;1,0;15,0;13,0;;6,0;4,0;4,0;11,0;;8,0;1,0;5,0;14,0;7,0;;;;2,0;16,0;22,0;3,0;24,0;;3,0;4,0;8,0;6,0;70,0;11,0;2,0;4,0;15,0;4,0;21,0;13,0;13,0;;42,0;26,0;9,0;;;;1,0;;3,0;28,0;10,0;4,0;6,0;1,0;;17,0;8,0;5,0;9,0;56,0;;6,0;22,0;12,0;23,0;1,0;1,0;11,0;2,0;5,0;6,0;26,0;3,0;;;;10,0;;;;9,0;6,0;51,0;6,0;1,0;27,0;1,0;33,0;;1,0;3,0;;9,0;;6,0;9,0;9,0;;;1,0;36,0;38,0;;;45,0;38,0;12,0;61,0;;16,0;22,0;;1,0;;16,0;10,0;;4,0;1,0;10,0;10,0;14,0;;15,0;;;5,0;2,0;1,0;;;2,0;8,0;;;;;;;3,0;;21,0;10,0;;;;2,0;2,0;;9,0;;2,0;;35,0;24,0;21,0;26,0;3,0;10,0;;15,0;;55,0;;4,0;;3,0;;1,0;;5,0;3,0;13,0;12,0;1,0;2,0;8,0;25,0;1,0;24,0;;2,0;;10,0;3,0;;2,0;;;8,0;;;4,0;;1,0;;3,0;;;1,0;2,0;12,0;;;2,0;15,0;6,0;;2,0;4,0;;14,0;6,0;;1,0;;16,0;3,0;6,0;5,0;19,0;;9,0;;4,0;3,0;9,0;3,0;3,0;;;4,0;4,0;;;;14,0;12,0;;;12,0;;1,0;;;3,0;10,0;1,0;4,0;2,0;1,0;2,0;5,0;13,0;;;1,0;7,0;9,0;;5,0;;;;;;12,0;;;;;9,0;;48,0;6,0;12,0;2,0;;;3,0;5,0;;;;2,0;;;;;;3,0;2,0;1,0;;;1,0;;4,0;;92,0;24,0;;;;;;11,0;2,0;;2,0;15,0;;;5,0;1,0;;;;8,0;;4,0;3,0;;;;;;;2,0;11,0;1,0;;;15,0;3,0;;11,0;;9,0;;4,0;;2,0;3,0;10,0;;10,0;;4,0;;1,0;4,0;4,0;1,0;;5,0;11,0;;39,0;;3,0;4,0;;;8,0;7,0;;;19,0;2,0;22,0;14,0;;;1,0;;70,0;4,0;1,0;;;2,0;5,0;;;;26,0;;;;;2,0;;;5,0;3,0;;;3,0;;;22,0;34,0;7,0;;8,0;13,0;4,0;;;5,0;;1,0;;3,0;1,0;9,0;2,0;;;4,0;3,0;1,0;;;;3,0;;1,0;;;1,0;2,0;4,0;;;3,0;2,0;4,0;42,0;;1,0;;;13,0;4,0;155,0;;;;13,0;;38,0;;;;;9,0;5,0;2,0;2,0;;3,0;;8,0;2,0;;;;;;9,0;;32,0;2,0;29,0;1,0;;14,0;;2,0;17,0;5,0;;;;3,0;3,0;;1,0;;;1,0;;2,0;;13,0;;18,0;;;32,0;6,0;;31,0;7,0;;9,0;1,0;5,0;4,0;;;;;;2,0;;;;1,0;;;;;;2,0;;;;;2,0;;;6,0;;;;22,0;;;4,0;36,0;;6,0;;;;;;;2,0;;;;;;;;;2,0;;2,0;;;;;;;36,0;;;;3,0;;;;7,0;6,0;;;;5,0;;;5,0;4,0;1,0;;1,0;;;5,0;;;5,0;19,0;;1,0;1,0;1,0;2,0;;6,0;;;;;;33,0;;4,0;;;6,0;;;21,0;;;;;7,0;;10,0;4,0;1,0;;1,0;;9,0;;;;4,0;10,0;;;;6,0;;;;;;1,0;;;5,0;1,0;;2,0;4,0;11,0;;;;;;2,0;;4,0;3,0;;;;;22,0;;;;;
element;4,0;19,0;4,0;117,0;3,0;31,0;35,0;147,0;105,0;246,0;296,0;41,0;50,0;3,0;112,0;143,0;54,0;4,0;11,0;3,0;75,0;347,0;15,0;32,0;5,0;3,0;409,0;5,0;5,0;9,0;19,0;74,0;439,0;3,0;340,0;36,0;15,0;42,0;5,0;35,0;264,0;2,0;35,0;17,0;107,0;116,0;67,0;451,0;47,0;337,0;314,0;84,0;6,0;45,0;251,0;25,0;;3,0;5,0;5,0;51,0;15,0;76,0;4,0;110,0;171,0;105,0;251,0;94,0;66,0;24,0;19,0;217,0;1,0;4,0;191,0;11,0;25,0;90,0;1842,0;63,0;966,0;;1047,0;10,0;5,0;5,0;;;164,0;4159,0;;20,0;50,0;10,0;10,0;43,0;;179,0;55,0;4,0;12,0;176,0;495,0;21,0;43,0;2081,0;182,0;209,0;2,0;44,0;66,0;12,0;43,0;25,0;664,0;350,0;531,0;850,0;67,0;3,0;20,0;22,0;135,0;52,0;5,0;1,0;10,0;36,0;44,0;;75,0;91,0;13,0;36,0;6,0;59,0;27,0;8,0;70,0;31,0;7,0;;286,0;98,0;3,0;32,0;932,0;432,0;34,0;13,0;34,0;18,0;44,0;92,0;70,0;636,0;;11,0;105,0;10,0;42,0;1250,0;4,0;10,0;3,0;47,0;165,0;4,0;4,0;213,0;5,0;19,0;96,0;50,0;25,0;248,0;92,0;;28,0;69,0;128,0;19,0;7,0;51,0;254,0;;56,0;479,0;10,0;3,0;2,0;29,0;210,0;80,0;53,0;2,0;45,0;15,0;109,0;4,0;25,0;84,0;223,0;11,0;73,0;21,0;15,0;30,0;121,0;40,0;8,0;27,0;20,0;26,0;14,0;7,0;49,0;16,0;19,0;270,0;30,0;24,0;3,0;;158,0;72,0;34,0;651,0;6,0;280,0;21,0;288,0;313,0;55,0;79,0;75,0;88,0;68,0;31,0;9,0;22,0;18,0;66,0;93,0;16,0;506,0;6,0;460,0;66,0;42,0;17,0;;2,0;9,0;10,0;317,0;150,0;11,0;180,0;4,0;29,0;82,0;86,0;86,0;2,0;61,0;26,0;43,0;2,0;25,0;49,0;88,0;46,0;2,0;40,0;7,0;62,0;119,0;628,0;84,0;5,0;29,0;44,0;;54,0;12,0;14,0;2,0;30,0;53,0;11,0;56,0;38,0;44,0;;5,0;13,0;27,0;8,0;64,0;23,0;228,0;30,0;111,0;56,0;8,0;48,0;20,0;4,0;1,0;27,0;31,0;4,0;115,0;28,0;9,0;40,0;54,0;87,0;;26,0;5,0;42,0;135,0;3,0;38,0;8,0;;3,0;18,0;129,0;13,0;12,0;2,0;14,0;27,0;122,0;76,0;67,0;10,0;6,0;13,0;16,0;46,0;12,0;31,0;25,0;32,0;34,0;6,0;38,0;8,0;506,0;331,0;273,0;12,0;37,0;2,0;7,0;13,0;24,0;130,0;23,0;12,0;35,0;4,0;40,0;9,0;44,0;2,0;16,0;;5,0;;30,0;14,0;9,0;47,0;18,0;18,0;4,0;3,0;17,0;84,0;31,0;8,0;1,0;1,0;148,0;45,0;63,0;5,0;22,0;3,0;10,0;6,0;12,0;9,0;5,0;4,0;2,0;18,0;39,0;3,0;;11,0;8,0;3,0;15,0;64,0;17,0;11,0;25,0;30,0;6,0;21,0;9,0;4,0;3,0;1,0;4,0;43,0;2,0;2,0;;10,0;17,0;12,0;1,0;;104,0;41,0;8,0;47,0;;7,0;10,0;41,0;3,0;9,0;41,0;56,0;;;53,0;61,0;3,0;24,0;27,0;37,0;19,0;;5,0;9,0;38,0;4,0;14,0;;1,0;98,0;6,0;;8,0;1,0;9,0;20,0;;7,0;1,0;5,0;;2,0;5,0;90,0;4,0;11,0;;65,0;;149,0;34,0;2,0;59,0;10,0;7,0;;1,0;2,0;36,0;2,0;;2,0;9,0;4,0;3,0;6,0;;58,0;21,0;44,0;;2,0;24,0;100,0;3,0;2,0;1,0;68,0;5,0;5,0;11,0;8,0;13,0;4,0;;;6,0;4,0;;10,0;35,0;4,0;34,0;4,0;1,0;2,0;6,0;2,0;19,0;;4,0;38,0;37,0;;4,0;12,0;38,0;1,0;26,0;1,0;8,0;3,0;16,0;;30,0;38,0;;;44,0;2,0;1,0;15,0;8,0;4,0;70,0;5,0;1,0;15,0;10,0;4,0;9,0;27,0;31,0;10,0;18,0;11,0;33,0;;9,0;154,0;3,0;28,0;1,0;7,0;14,0;6,0;7,0;;8,0;4,0;7,0;;3,0;13,0;6,0;;8,0;12,0;1,0;8,0;2,0;;23,0;4,0;;;10,0;40,0;12,0;64,0;1,0;4,0;;5,0;18,0;7,0;6,0;;;6,0;1,0;22,0;4,0;;;;;;5,0;;;6,0;;1,0;;166,0;2,0;4,0;7,0;98,0;5,0;5,0;65,0;2,0;;31,0;28,0;1,0;;7,0;22,0;3,0;5,0;6,0;1,0;1,0;10,0;9,0;1,0;15,0;9,0;4,0;43,0;14,0;277,0;1,0;4,0;2,0;2,0;22,0;7,0;13,0;90,0;544,0;18,0;8,0;8,0;10,0;11,0;26,0;15,0;6,0;5,0;7,0;8,0;3,0;;16,0;15,0;31,0;;2,0;9,0;5,0;16,0;;25,0;32,0;10,0;;;1,0;;;8,0;;5,0;9,0;8,0;181,0;12,0;30,0;7,0;6,0;31,0;3,0;2,0;7,0;110,0;5,0;;1,0;34,0;;;2,0;5,0;;;43,0;32,0;;4,0;2,0;2,0;18,0;6,0;6,0;8,0;;1,0;10,0;;98,0;8,0;19,0;5,0;10,0;11,0;16,0;12,0;;10,0;14,0;20,0;4,0;19,0;13,0;;2,0;6,0;4,0;23,0;8,0;4,0;1,0;2,0;76,0;13,0;8,0;23,0;11,0;2,0;6,0;2,0;6,0;9,0;7,0;;23,0;60,0;1,0;31,0;20,0;6,0;;7,0;32,0;21,0;70,0;4,0;1,0;15,0;;5,0;41,0;;46,0;8,0;;12,0;57,0;80,0;;7,0;3,0;2,0;18,0;4,0;22,0;;18,0;2,0;;3,0;2,0;;19,0;44,0;11,0;16,0;119,0;3,0;74,0;15,0;3,0;3,0;34,0;;16,0;;17,0;;242,0;;1,0;;20,0;3,0;2,0;15,0;9,0;;5,0;1,0;14,0;4,0;7,0;17,0;9,0;;2,0;3,0;;;54,0;2,0;7,0;11,0;3,0;;6,0;;2,0;;;1,0;24,0;;;29,0;3,0;;14,0;3,0;6,0;3,0;;2,0;;9,0;49,0;;2,0;12,0;;;;1,0;11,0;4,0;2,0;17,0;17,0;;;2,0;;1,0;6,0;9,0;28,0;35,0;39,0;19,0;;;17,0;12,0;2,0;;12,0;6,0;3,0;;5,0;1,0;;9,0;;;;21,0;26,0;;2,0;26,0;;4,0;;45,0;1,0;2,0;;;5,0;2,0;;6,0;2,0;12,0;2,0;;;;;10,0;2,0;170,0;2,0;31,0;;11,0;2,0;2,0;11,0;;6,0;16,0;;13,0;3,0;42,0;35,0;5,0;2,0;7,0;244,0;26,0;6,0;26,0;12,0;10,0;3,0;3,0;2,0;;10,0;;;;;;;2,0;6,0;;1,0;;138,0;;;;9,0;2,0;1,0;;;;2,0;;;64,0;;;;;;34,0
error;4,0;;1,0;8,0;;8,0;3,0;13,0;;3,0;7,0;;6,0;1,0;31,0;21,0;;5,0;2,0;4,0;11,0;9,0;;;;4,0;8,0;1,0;;13,0;3,0;1,0;18,0;;32,0;2,0;71,0;28,0;;;40,0;;3,0;14,0;61,0;6,0;74,0;20,0;3,0;27,0;;39,0;5,0;;4,0;1,0;3,0;;32,0;;;;;;6,0;28,0;13,0;12,0;9,0;;27,0;;27,0;;2,0;;11,0;2,0;2,0;112,0;;13,0;;16,0;;2,0;19,0;;;3,0;54,0;;2,0;;18,0;1,0;11,0;;77,0;1,0;16,0;5,0;13,0;7,0;5,0;6,0;43,0;2,0;8,0;11,0;;5,0;;1,0;;10,0;9,0;5,0;1,0;3,0;;;12,0;2,0;15,0;2,0;;;;6,0;;6,0;1,0;1,0;16,0;;7,0;10,0;;;8,0;;3,0;19,0;;;;;18,0;3,0;;;3,0;28,0;3,0;;39,0;;7,0;3,0;2,0;1,0;42,0;;5,0;;6,0;7,0;;;5,0;;;;;10,0;9,0;;;;;11,0;;;;;;7,0;;;;;;1,0;;;;1,0;;;;;25,0;16,0;45,0;;;;;;;;;;;;;;;;;;;;;;;;6,0;1,0;;;;4,0;;1,0;;;;;;;1,0;5,0;;;;3,0;20,0;1,0;1,0;;;;;;17,0;1,0;;;;;;2,0;;;2,0;;1,0;;;1,0;2,0;;2,0;;;2,0;;3,0;1,0;;1,0;;;7,0;;2,0;;;;8,0;;;;;2,0;;;;5,0;1,0;3,0;1,0;;;5,0;2,0;1,0;;;3,0;;;;11,0;;;;2,0;;;;;2,0;;;;;;;;28,0;;;5,0;4,0;;;;;;;;1,0;1,0;;2,0;;11,0;;;;;;;4,0;48,0;1,0;;;4,0;;;;;;;;;;;;;;;;1,0;;19,0;;;;;;3,0;;;;1,0;;3,0;4,0;;;;;3,0;1,0;;;2,0;;2,0;1,0;;;1,0;;35,0;11,0;36,0;12,0;2,0;11,0;;;;;;;1,0;24,0;3,0;;1,0;13,0;6,0;;1,0;1,0;;;5,0;53,0;;5,0;23,0;;;1,0;5,0;;;;2,0;4,0;1,0;1,0;;1,0;;;2,0;5,0;;1,0;;2,0;1,0;;;;2,0;;;;;21,0;4,0;;;;9,0;2,0;2,0;24,0;;;;7,0;5,0;1,0;4,0;13,0;;;;2,0;1,0;;1,0;;;;1,0;2,0;1,0;1,0;;1,0;;;2,0;;4,0;6,0;1,0;;;6,0;2,0;;;2,0;;;;;;;;;1,0;;;;;;;;3,0;;;;;14,0;2,0;;;;;2,0;8,0;;7,0;5,0;;;;;;;;;;;;;1,0;;;;3,0;;;;25,0;;4,0;7,0;1,0;;;;;;;1,0;;;;;;;;;;27,0;;;;;;;;;;;;;;;45,0;;3,0;9,0;;;;;;2,0;;;;;1,0;4,0;2,0;;1,0;;;;;1,0;3,0;;;;;;4,0;;;;;2,0;;;;;;;3,0;9,0;;;;;;;1,0;;;;;;;;;;2,0;;5,0;;1,0;;;;;;;;;;;;;;2,0;2,0;;;;;;;;10,0;;;;6,0;;;;;;;;;1,0;;3,0;;3,0;;;;;;;;;;;;;;;;;;;;;1,0;;1,0;5,0;;;;1,0;;;;;;;;;;;;;;;;;;;;;;;5,0;3,0;;1,0;;;1,0;;1,0;1,0;;3,0;;;3,0;;;;;;21,0;;;;;;;;;;3,0;2,0;;;;;;;;;24,0;1,0;1,0;;1,0;1,0;;3,0;;;;;;2,0;;1,0;;;;;;;;;;5,0;;1,0;;;;;;3,0;1,0;;1,0;;;;;;;1,0;;;1,0;1,0;;;;;5,0;;9,0;13,0;5,0;1,0;;;4,0;;1,0;;;;;3,0;;;1,0;1,0;1,0;;;;;;;;;;2,0;;;;;2,0;;;;;1,0;;;;;;;;2,0;2,0;;;;;;;;;;;;;;;;;15,0;;24,0;;;;;2,0;;;;;;;;2,0;;3,0;;;;;;;;;;;1,0;;;;1,0;;;;;;;;1,0;;;;;;;;;19,0;;;;;;;;;5,0;;1,0;;;7,0;4,0;20,0;;;;;;2,0;;;1,0;1,0;;;;;;;;
estimate;14,0;;1,0;;3,0;68,0;;54,0;40,0;2,0;3,0;;17,0;1,0;14,0;165,0;;1,0;;7,0;47,0;54,0;;;3,0;9,0;53,0;3,0;;5,0;6,0;5,0;95,0;;21,0;5,0;57,0;10,0;11,0;25,0;159,0;1,0;26,0;79,0;10,0;24,0;173,0;147,0;9,0;34,0;1,0;124,0;13,0;2,0;2,0;18,0;5,0;32,0;;1,0;;4,0;20,0;;18,0;7,0;50,0;24,0;67,0;;55,0;;75,0;7,0;6,0;17,0;16,0;;6,0;359,0;2,0;15,0;7,0;73,0;5,0;15,0;;;1,0;3,0;28,0;;1,0;;21,0;11,0;8,0;1,0;232,0;29,0;79,0;;47,0;141,0;1,0;10,0;16,0;3,0;10,0;141,0;1,0;14,0;;;;64,0;30,0;278,0;1,0;43,0;;;11,0;38,0;42,0;8,0;;;1,0;34,0;;76,0;26,0;7,0;13,0;18,0;14,0;12,0;7,0;;16,0;;5,0;62,0;7,0;;;8,0;110,0;21,0;1,0;;7,0;12,0;51,0;;87,0;;9,0;4,0;7,0;;213,0;2,0;2,0;;15,0;26,0;;;;2,0;;7,0;47,0;24,0;;;;1,0;1,0;1,0;;;2,0;;;29,0;2,0;1,0;;5,0;;4,0;;1,0;6,0;3,0;;;;1,0;21,0;26,0;13,0;;;;16,0;5,0;;1,0;;;;;;;4,0;;;;;;;;;;29,0;;1,0;;2,0;6,0;;1,0;25,0;;;;1,0;;2,0;6,0;1,0;;;15,0;100,0;46,0;;2,0;;;;4,0;22,0;17,0;3,0;;;;;13,0;;;2,0;;1,0;;;24,0;20,0;;;;;18,0;;28,0;4,0;;;;;40,0;1,0;;;;76,0;3,0;13,0;;;;6,0;;;;;1,0;2,0;;;;1,0;16,0;3,0;3,0;;11,0;;;4,0;22,0;;;;3,0;;;;;;;;;;;;;;;;31,0;32,0;8,0;2,0;;;;1,0;13,0;;;;2,0;5,0;6,0;6,0;8,0;;;;;26,0;57,0;9,0;2,0;2,0;11,0;;;;;;;;2,0;3,0;;;3,0;3,0;;;;;34,0;;;23,0;;1,0;2,0;;;;;2,0;28,0;1,0;3,0;;3,0;5,0;;10,0;4,0;9,0;9,0;;1,0;;;;4,0;21,0;69,0;38,0;2,0;7,0;;21,0;;;;;;3,0;;1,0;12,0;1,0;2,0;;44,0;5,0;;8,0;55,0;18,0;2,0;81,0;1,0;22,0;24,0;8,0;;9,0;227,0;8,0;2,0;1,0;1,0;7,0;;78,0;10,0;4,0;19,0;60,0;7,0;7,0;11,0;11,0;4,0;23,0;;;;;2,0;;;;4,0;9,0;41,0;75,0;56,0;;44,0;24,0;2,0;40,0;11,0;6,0;;2,0;3,0;;11,0;22,0;3,0;;24,0;5,0;26,0;3,0;2,0;;21,0;2,0;22,0;;;;3,0;;2,0;;7,0;;;9,0;;2,0;;6,0;1,0;5,0;;;;;;;;;1,0;;1,0;1,0;3,0;2,0;;;2,0;;2,0;3,0;;;;3,0;1,0;;;;;;5,0;;2,0;12,0;4,0;;;;;1,0;;;;;;;2,0;;4,0;;16,0;1,0;;;5,0;;2,0;2,0;8,0;1,0;;1,0;;;;1,0;;3,0;;;1,0;1,0;6,0;5,0;;1,0;;3,0;;;;1,0;;;;;;7,0;;4,0;;12,0;1,0;;;;;1,0;8,0;;;;4,0;;7,0;;;;;;4,0;5,0;;38,0;5,0;;1,0;;;3,0;;;;;;1,0;;9,0;;;;;;15,0;;1,0;;;;1,0;;;;17,0;;;;;;5,0;;;8,0;;6,0;;;4,0;;;2,0;1,0;;;1,0;;;;;6,0;;;24,0;;;;;;4,0;;;;;3,0;1,0;;;;3,0;2,0;5,0;;;;9,0;;;;;;;;;;;;;;;;1,0;3,0;;;;;1,0;;;;3,0;;;;1,0;;;;;1,0;1,0;;;1,0;;;45,0;;;1,0;;;;36,0;;;;;2,0;;5,0;1,0;;1,0;;;;;4,0;2,0;12,0;;6,0;1,0;7,0;91,0;11,0;10,0;;;;1,0;2,0;7,0;4,0;17,0;14,0;2,0;39,0;;;;;;9,0;23,0;2,0;26,0;1,0;1,0;24,0;;2,0;;5,0;;4,0;1,0;57,0;;1,0;2,0;;;;;5,0;;;5,0;7,0;1,0;4,0;1,0;;;;;19,0;24,0;2,0;;;;;;;;1,0;;7,0;;;;;;1,0;3,0;;1,0;45,0;;;;1,0;10,0;;;;1,0;;;7,0;;4,0;;;;;;;;;;1,0;;;2,0;1,0;2,0;;2,0;;;6,0;;;;;;;;;4,0;;17,0;;;7,0;;6,0;27,0;;;;;;;;;;;;9,0;;25,0;4,0;3,0;;;1,0;;4,0;;1,0;;2,0;2,0;1,0;;4,0;;;4,0;;14,0;2,0;;1,0;;;1,0;;3,0;;;;;3,0;;;;;2,0;;;;1,0;1,0;;;1,0;;3,0;;;4,0;;15,0;15,0;;;9,0;2,0;1,0;;14,0;;70,0;2,0;;;3,0;;;;2,0;;5,0;;3,0;3,0;2,0;;;;
executable;1,0;;;;3,0;;;11,0;;1,0;;;1,0;;1,0;1,0;;;;;2,0;17,0;1,0;1,0;;;4,0;2,0;;;111,0;;22,0;;6,0;1,0;;;;;45,0;;;1,0;4,0;;19,0;39,0;22,0;11,0;;2,0;;;;;5,0;;1,0;;;;;17,0;2,0;;2,0;1,0;;;2,0;;13,0;;;1,0;1,0;;1,0;54,0;;4,0;5,0;30,0;;259,0;;;;;3,0;;13,0;;;73,0;17,0;;20,0;;;1,0;7,0;1,0;;2,0;;;11,0;11,0;;43,0;;;;7,0;;5,0;2,0;;;;6,0;23,0;190,0;113,0;;;;;;;;;;;;4,0;;;5,0;;;1,0;3,0;5,0;;;2,0;1,0;;;21,0;50,0;;;15,0;;;;3,0;8,0;14,0;;;;2,0;;;;;;;;;;;;;;;2,0;;;;1,0;;;;;;;;1,0;;;1,0;;;;;;;1,0;4,0;;;;;;;5,0;;;;;;;;;;;;;;;;;;;;;;;;;;;;;;;;;;;;;;2,0;;;;;;;17,0;;;;;;;7,0;;;;;;;;2,0;;;;;2,0;2,0;;;8,0;;;;;8,0;;;;;;;;;;;;;;;;;;;;2,0;;;;;;;;;;1,0;;;;5,0;;;;;;;;;;;;;;;;1,0;3,0;;12,0;;;;;1,0;;;;1,0;;1,0;;;;;;;;3,0;1,0;;;;;;;;;;;;;;;1,0;;;;;1,0;;;;;;;1,0;;;;;;;;19,0;;6,0;;;;;;;1,0;;;;;;4,0;10,0;1,0;27,0;;;19,0;;;;;;;;;;;;;;;;;7,0;;;;;;2,0;;;4,0;;;;9,0;4,0;9,0;;2,0;;;;;;;3,0;5,0;1,0;;;;;;;;;;;;3,0;;;;3,0;8,0;;;1,0;;;3,0;1,0;5,0;;;;2,0;;;1,0;;1,0;;46,0;1,0;;5,0;;1,0;;;;9,0;;;;;;1,0;3,0;1,0;;1,0;9,0;;;;1,0;;;;;;1,0;;;;;;;1,0;;9,0;2,0;;;;;4,0;3,0;;;;;;;;1,0;;;;;;1,0;3,0;;;;;;;2,0;;;;7,0;;;;;2,0;;;;;3,0;;;;;;;;;3,0;;;;;1,0;;;;;;;;;;1,0;;;5,0;3,0;;6,0;;;;;;1,0;;;;;;2,0;3,0;16,0;;;;;1,0;;;;;;;;;7,0;4,0;6,0;;;31,0;;;16,0;;;1,0;;;;4,0;;;3,0;1,0;;;;;;;;;;;;2,0;;;;;;;;;2,0;;;;3,0;;;;;;;;;2,0;1,0;;;;1,0;;;;;;;;;;;;1,0;;;;;;;;;;;;;;;;;;;;;;;;;;;;;;;;;;;;;;;;;;;2,0;;;;;;;;;;;;;;;;;;;;1,0;;;;;;;2,0;;;;;3,0;;;;;;;5,0;;;;3,0;;;;;;;;;1,0;;1,0;;;;;;;;;21,0;;;;1,0;;;;;;;;;;;2,0;;;7,0;;;;;;;;;;;;;;;;;;;;;;;;;6,0;;;;1,0;;;;;;;;;;;;;;;;;;;;1,0;;;;;;;;;;;1,0;1,0;;;2,0;;;;;;;;;;;;;;;;;;;;;;;1,0;;;;;;;;;;;;;;;;;;5,0;;;;;;;;;;;;;;;;;;;;;;;;;1,0;;;;;;;;;;;;;;;;;;;;;;;1,0;;;;;1,0;;;;;;;;;;;;;;
extend;1,0;3,0;;2,0;;39,0;50,0;19,0;33,0;30,0;15,0;;10,0;;193,0;168,0;2,0;2,0;;;15,0;27,0;;81,0;8,0;;8,0;3,0;;;;3,0;33,0;;6,0;6,0;3,0;1,0;;;16,0;;73,0;36,0;11,0;6,0;12,0;64,0;12,0;18,0;40,0;16,0;;4,0;17,0;124,0;51,0;;;;;5,0;28,0;2,0;26,0;;27,0;93,0;69,0;91,0;5,0;;2,0;;;12,0;;4,0;4,0;116,0;21,0;51,0;;200,0;3,0;;;;17,0;139,0;216,0;;;8,0;;1,0;2,0;;27,0;5,0;1,0;;66,0;7,0;1,0;1,0;134,0;1,0;14,0;;25,0;2,0;68,0;;;176,0;571,0;135,0;11,0;15,0;2,0;1,0;4,0;5,0;4,0;;;1,0;4,0;59,0;1,0;7,0;12,0;3,0;15,0;;40,0;;;;11,0;4,0;;35,0;;1,0;6,0;205,0;9,0;9,0;;7,0;2,0;5,0;3,0;10,0;75,0;;3,0;27,0;1,0;1,0;85,0;;28,0;1,0;10,0;15,0;;2,0;6,0;1,0;2,0;22,0;10,0;6,0;83,0;73,0;3,0;;42,0;87,0;1,0;27,0;2,0;35,0;;5,0;;4,0;3,0;1,0;4,0;94,0;;20,0;1,0;;1,0;46,0;45,0;6,0;5,0;512,0;2,0;13,0;;;6,0;64,0;39,0;21,0;5,0;5,0;4,0;;56,0;7,0;11,0;133,0;180,0;2,0;63,0;4,0;2,0;30,0;50,0;21,0;49,0;;255,0;6,0;7,0;135,0;32,0;14,0;5,0;168,0;44,0;118,0;19,0;41,0;19,0;23,0;2,0;2,0;4,0;;31,0;97,0;255,0;;39,0;;5,0;;59,0;5,0;;;6,0;;28,0;9,0;25,0;1,0;36,0;20,0;4,0;3,0;14,0;8,0;57,0;11,0;4,0;42,0;5,0;24,0;29,0;406,0;1,0;;42,0;22,0;;13,0;;3,0;1,0;13,0;17,0;29,0;9,0;;189,0;;2,0;2,0;68,0;10,0;28,0;9,0;30,0;17,0;10,0;2,0;2,0;16,0;142,0;14,0;;23,0;15,0;160,0;6,0;3,0;6,0;57,0;9,0;39,0;16,0;;8,0;69,0;14,0;;58,0;14,0;;;52,0;6,0;59,0;19,0;1,0;2,0;16,0;130,0;21,0;22,0;8,0;10,0;13,0;2,0;1,0;17,0;16,0;3,0;92,0;27,0;26,0;103,0;;5,0;7,0;13,0;16,0;55,0;6,0;5,0;;10,0;4,0;19,0;106,0;31,0;4,0;45,0;54,0;3,0;;3,0;8,0;;1,0;1,0;52,0;13,0;8,0;22,0;28,0;8,0;17,0;110,0;4,0;4,0;65,0;15,0;6,0;142,0;8,0;10,0;;11,0;58,0;1,0;12,0;21,0;7,0;3,0;;;;10,0;;;;1,0;;;1,0;12,0;2,0;;;1,0;;4,0;1,0;;;2,0;1,0;2,0;1,0;7,0;;12,0;;;;;1,0;20,0;7,0;;2,0;2,0;17,0;;1,0;2,0;9,0;;1,0;4,0;2,0;;3,0;11,0;2,0;3,0;;;2,0;4,0;;;3,0;;1,0;1,0;;;3,0;8,0;;1,0;1,0;3,0;;7,0;1,0;;30,0;;6,0;;3,0;39,0;9,0;6,0;;42,0;2,0;;1,0;;;10,0;;;1,0;1,0;;10,0;1,0;;16,0;;14,0;4,0;;3,0;;;9,0;;;;1,0;3,0;3,0;;;2,0;5,0;;3,0;;;1,0;44,0;9,0;1,0;;;25,0;1,0;1,0;;;4,0;16,0;;24,0;;4,0;;5,0;;9,0;6,0;;3,0;;;;56,0;1,0;;6,0;4,0;;;6,0;;2,0;39,0;3,0;;6,0;;;22,0;;3,0;3,0;;;;;;9,0;;;;10,0;;;;18,0;;2,0;18,0;;;;27,0;;;;;18,0;;1,0;;;4,0;1,0;19,0;;;;;4,0;;1,0;;;2,0;5,0;37,0;;14,0;;;;;;2,0;;1,0;;;5,0;76,0;2,0;;3,0;;1,0;;1,0;;;;45,0;1,0;1,0;;1,0;2,0;;;;6,0;38,0;7,0;;;1,0;;4,0;4,0;5,0;;;9,0;;20,0;;;2,0;;7,0;;22,0;;2,0;4,0;33,0;;2,0;;16,0;3,0;7,0;17,0;7,0;16,0;3,0;18,0;2,0;1,0;34,0;;1,0;13,0;;1,0;12,0;5,0;2,0;;1,0;15,0;3,0;20,0;19,0;;6,0;8,0;;3,0;11,0;1,0;;2,0;7,0;;;;61,0;;6,0;;6,0;15,0;;1,0;2,0;12,0;;3,0;21,0;29,0;2,0;5,0;10,0;2,0;8,0;8,0;1,0;8,0;;;4,0;4,0;;;11,0;;6,0;5,0;1,0;3,0;13,0;;;23,0;;;;2,0;;2,0;3,0;;;;;4,0;1,0;;;2,0;11,0;;;1,0;34,0;;;1,0;;;9,0;4,0;;;;;7,0;1,0;;;;1,0;;;;11,0;5,0;;3,0;;;4,0;2,0;;1,0;1,0;;1,0;;;2,0;;;1,0;;;;3,0;;;;;;;;;;;;;;;1,0;1,0;;1,0;;1,0;4,0;1,0;7,0;4,0;;;6,0;;2,0;;;8,0;;;5,0;;;;;;3,0;;4,0;1,0;;;4,0;21,0;;;6,0;;7,0;;11,0;;;;;1,0;4,0;3,0;15,0;;3,0;13,0;4,0;;;4,0;;;;;;;;;10,0;;;;;;;3,0;;1,0;;;10,0;1,0;42,0;;10,0;3,0;;;3,0;;1,0;6,0;;;1,0;2,0;;3,0;7,0;4,0;;;;;;;;;;;3,0;;25,0;;;1,0;;13,0;;;7,0;1,0;;;6,0;;2,0;;4,0;;20,0;3,0;3,0;;7,0;1,0;;31,0;;;;;;;;;;;1,0;;;;1,0;5,0;;1,0;;;;;;4,0;3,0;;;;;;2,0;1,0;;;1,0;;
external;3,0;9,0;;1,0;1,0;;5,0;163,0;14,0;10,0;3,0;;6,0;1,0;2,0;31,0;3,0;;3,0;1,0;5,0;17,0;1,0;4,0;;;;3,0;1,0;1,0;53,0;2,0;69,0;;75,0;21,0;;2,0;1,0;1,0;133,0;1,0;31,0;;17,0;5,0;17,0;467,0;35,0;57,0;32,0;5,0;;;7,0;4,0;15,0;;4,0;;5,0;;;18,0;6,0;;;57,0;21,0;12,0;7,0;5,0;22,0;1,0;;4,0;12,0;3,0;18,0;288,0;5,0;29,0;;72,0;3,0;5,0;;;2,0;;51,0;2,0;12,0;7,0;2,0;3,0;30,0;4,0;45,0;5,0;;;98,0;38,0;2,0;5,0;28,0;6,0;18,0;49,0;3,0;30,0;4,0;;1,0;36,0;61,0;38,0;56,0;5,0;;;3,0;31,0;3,0;4,0;;;3,0;;1,0;12,0;5,0;2,0;11,0;;5,0;49,0;5,0;;8,0;10,0;2,0;38,0;8,0;;;42,0;105,0;2,0;3,0;;25,0;19,0;7,0;11,0;95,0;;2,0;11,0;;58,0;208,0;;2,0;4,0;76,0;23,0;;;2,0;4,0;2,0;;3,0;17,0;22,0;18,0;;;11,0;29,0;2,0;1,0;15,0;25,0;;14,0;;;4,0;2,0;;125,0;;9,0;1,0;2,0;3,0;4,0;17,0;;;20,0;;8,0;;2,0;2,0;14,0;1,0;1,0;33,0;;;;;;1,0;9,0;87,0;;6,0;1,0;2,0;6,0;1,0;1,0;145,0;;11,0;10,0;2,0;50,0;2,0;1,0;8,0;24,0;1,0;11,0;5,0;5,0;2,0;13,0;3,0;;;8,0;2,0;;9,0;;;;;;58,0;;;;5,0;1,0;;15,0;1,0;;7,0;10,0;11,0;;1,0;167,0;6,0;;;10,0;3,0;18,0;15,0;85,0;14,0;26,0;52,0;4,0;3,0;20,0;;2,0;;;45,0;1,0;8,0;1,0;22,0;8,0;1,0;1,0;8,0;;11,0;12,0;22,0;;;1,0;;1,0;3,0;;4,0;7,0;5,0;4,0;1,0;;2,0;67,0;;23,0;5,0;5,0;15,0;;10,0;3,0;8,0;2,0;;3,0;;;;3,0;3,0;6,0;2,0;20,0;4,0;16,0;2,0;;8,0;2,0;;;6,0;8,0;4,0;;4,0;1,0;3,0;4,0;2,0;;3,0;4,0;11,0;;1,0;;3,0;5,0;15,0;;;8,0;2,0;4,0;;;6,0;3,0;2,0;;22,0;;;1,0;4,0;2,0;;;;7,0;1,0;;;28,0;2,0;19,0;1,0;10,0;81,0;17,0;;;3,0;2,0;;;50,0;8,0;;;1,0;4,0;4,0;15,0;1,0;5,0;;;1,0;2,0;;;;;;;11,0;4,0;;;2,0;4,0;;1,0;;28,0;4,0;;29,0;;;2,0;13,0;;12,0;3,0;2,0;;10,0;10,0;36,0;1,0;3,0;11,0;;1,0;;;3,0;20,0;16,0;1,0;;;;;;11,0;;;2,0;;;3,0;;4,0;25,0;;9,0;;;;13,0;2,0;1,0;4,0;1,0;2,0;5,0;2,0;;1,0;;1,0;7,0;31,0;4,0;3,0;;3,0;1,0;;32,0;3,0;2,0;1,0;1,0;11,0;4,0;;7,0;;;1,0;;2,0;;;2,0;;;6,0;;;19,0;6,0;9,0;2,0;;11,0;6,0;6,0;;3,0;;1,0;5,0;75,0;;;11,0;;1,0;;5,0;3,0;7,0;;;6,0;;8,0;3,0;1,0;9,0;;1,0;;;2,0;;10,0;7,0;2,0;2,0;;;2,0;;4,0;13,0;80,0;2,0;;3,0;11,0;7,0;;4,0;4,0;6,0;37,0;;;;2,0;;;72,0;;;;;1,0;9,0;14,0;;3,0;7,0;;6,0;;;;9,0;2,0;2,0;6,0;;;1,0;7,0;8,0;;3,0;;9,0;;22,0;3,0;;;;1,0;;;5,0;;;16,0;15,0;1,0;6,0;;;;;3,0;3,0;2,0;2,0;;2,0;3,0;;1,0;1,0;4,0;;;5,0;;;;;26,0;2,0;;;13,0;8,0;;19,0;11,0;;;;3,0;2,0;;;;;;1,0;3,0;7,0;;;;;;;;;;;;;1,0;;;;2,0;2,0;40,0;;;4,0;;;;1,0;1,0;22,0;;2,0;;;;;;;;3,0;6,0;;5,0;;2,0;3,0;;;;;4,0;1,0;5,0;;3,0;8,0;;2,0;1,0;4,0;;4,0;6,0;8,0;1,0;;15,0;;;1,0;1,0;;;5,0;;;;1,0;;5,0;;;4,0;1,0;;;;3,0;;;;;2,0;;;;;;14,0;;29,0;5,0;;;;;;8,0;4,0;;;;1,0;1,0;1,0;5,0;;;5,0;;2,0;;3,0;;;;2,0;1,0;;;;;;1,0;1,0;68,0;;;3,0;;;;5,0;1,0;;;;;;;;;3,0;;;;1,0;;;;;;;2,0;;;;;;;;;;4,0;2,0;;;;;;;;;2,0;;;1,0;;;;;;;;;3,0;;;;;5,0;85,0;;;1,0;;;;2,0;3,0;1,0;;1,0;;1,0;1,0;;;;;;;;;;;1,0;3,0;;6,0;;1,0;;;;2,0;;2,0;2,0;;;3,0;;1,0;;;;;12,0;;;;1,0;;;;;23,0;;;;;;;;;1,0;;;;;;1,0;;3,0;;;1,0;;;4,0;;;;;;1,0;;;;;;2,0;3,0;;;;;6,0;;;;;;;;;2,0;1,0;;6,0;;;;2,0;;;;;;;3,0;;;;;;;
field;5,0;1,0;;;3,0;154,0;17,0;37,0;255,0;33,0;44,0;;72,0;1,0;30,0;159,0;15,0;4,0;;8,0;14,0;173,0;4,0;21,0;5,0;1,0;13,0;1,0;1,0;8,0;11,0;11,0;111,0;1,0;28,0;12,0;5,0;2,0;10,0;26,0;108,0;1,0;70,0;193,0;88,0;17,0;141,0;96,0;59,0;184,0;23,0;84,0;9,0;5,0;15,0;7,0;76,0;;20,0;;28,0;;;2,0;1,0;25,0;26,0;30,0;52,0;36,0;13,0;9,0;114,0;11,0;3,0;21,0;42,0;55,0;78,0;622,0;13,0;185,0;6,0;151,0;15,0;9,0;2,0;;;17,0;254,0;;1,0;4,0;12,0;5,0;2,0;;220,0;4,0;3,0;6,0;81,0;372,0;4,0;12,0;101,0;12,0;38,0;3,0;10,0;21,0;;17,0;3,0;164,0;160,0;196,0;14,0;33,0;;2,0;5,0;31,0;42,0;11,0;8,0;;9,0;35,0;;115,0;34,0;4,0;34,0;24,0;74,0;13,0;6,0;2,0;96,0;1,0;1,0;177,0;40,0;1,0;;77,0;52,0;8,0;4,0;6,0;5,0;19,0;32,0;2,0;188,0;2,0;6,0;19,0;3,0;9,0;58,0;;13,0;4,0;128,0;2529,0;13,0;;36,0;;;34,0;3,0;35,0;49,0;5,0;;;6,0;9,0;;1,0;12,0;30,0;2,0;34,0;2,0;;1,0;6,0;;12,0;;1,0;2,0;;3,0;52,0;3,0;3,0;11,0;91,0;6,0;;36,0;4,0;18,0;42,0;3,0;9,0;3,0;33,0;1,0;;;;7,0;6,0;31,0;2,0;5,0;2,0;1,0;5,0;8,0;;251,0;;14,0;1,0;36,0;19,0;22,0;34,0;28,0;13,0;13,0;2,0;103,0;4,0;39,0;15,0;4,0;;2,0;7,0;63,0;37,0;1,0;;;;;4,0;59,0;31,0;10,0;1,0;1,0;;1,0;69,0;;3,0;9,0;1,0;2,0;;;34,0;27,0;;1,0;;;5,0;4,0;68,0;20,0;;10,0;;1,0;67,0;;6,0;;6,0;128,0;9,0;1,0;;5,0;1,0;;9,0;5,0;;4,0;1,0;10,0;2,0;4,0;;;12,0;36,0;7,0;4,0;4,0;2,0;;16,0;30,0;;;1,0;6,0;;;1,0;;14,0;;1,0;;6,0;4,0;;2,0;;;3,0;15,0;15,0;8,0;10,0;1,0;;;1,0;6,0;18,0;;;4,0;5,0;10,0;1,0;3,0;2,0;2,0;;;2,0;72,0;3,0;1,0;3,0;2,0;;3,0;6,0;;;15,0;1,0;6,0;9,0;;;10,0;2,0;1,0;1,0;1,0;5,0;9,0;;;1,0;;;37,0;1,0;;1,0;9,0;1,0;34,0;8,0;;2,0;6,0;;9,0;27,0;1,0;;;;5,0;2,0;2,0;11,0;9,0;;19,0;42,0;176,0;12,0;7,0;17,0;;1,0;1,0;3,0;6,0;;4,0;43,0;6,0;1,0;24,0;2,0;10,0;;1,0;;24,0;23,0;7,0;56,0;16,0;20,0;7,0;33,0;4,0;19,0;50,0;23,0;;14,0;14,0;10,0;6,0;25,0;14,0;20,0;;;3,0;6,0;11,0;1,0;9,0;;1,0;63,0;;31,0;;;;;;15,0;83,0;4,0;2,0;9,0;1,0;34,0;;12,0;;11,0;7,0;107,0;7,0;2,0;41,0;18,0;4,0;3,0;3,0;5,0;27,0;3,0;9,0;5,0;;;24,0;;;18,0;;30,0;7,0;;15,0;23,0;3,0;5,0;12,0;5,0;2,0;;3,0;5,0;1,0;2,0;3,0;2,0;;14,0;;1,0;2,0;2,0;7,0;;;3,0;;;1,0;;;14,0;;;;10,0;8,0;1,0;3,0;;72,0;;2,0;;7,0;13,0;9,0;;7,0;1,0;;8,0;51,0;;31,0;;;;;;1,0;6,0;15,0;;2,0;6,0;3,0;1,0;;;;40,0;12,0;;;1,0;13,0;2,0;;2,0;19,0;;;12,0;;;5,0;;;4,0;;;8,0;1,0;;;5,0;43,0;4,0;21,0;1,0;;;8,0;22,0;1,0;3,0;;;1,0;9,0;4,0;3,0;;2,0;;8,0;;1,0;4,0;4,0;;;4,0;;105,0;;;1,0;;;3,0;13,0;;;24,0;;2,0;1,0;2,0;;17,0;6,0;;2,0;;1,0;43,0;;;2,0;;2,0;4,0;;2,0;2,0;;;;;;1,0;7,0;9,0;2,0;101,0;;14,0;12,0;;6,0;13,0;5,0;;;;;;2,0;5,0;34,0;1,0;;13,0;;5,0;;4,0;;17,0;2,0;;;23,0;7,0;6,0;;;28,0;57,0;4,0;1,0;1,0;;4,0;36,0;;;;8,0;;7,0;1,0;;2,0;;11,0;;;;;;;24,0;5,0;2,0;;1,0;;;5,0;;10,0;;25,0;3,0;;4,0;2,0;;;;;;2,0;20,0;3,0;;1,0;;1,0;;;;;;12,0;12,0;7,0;16,0;;;3,0;;1,0;;;;;20,0;5,0;;;2,0;;12,0;;20,0;8,0;4,0;9,0;;2,0;;21,0;;11,0;15,0;8,0;;96,0;4,0;;;;;16,0;1,0;3,0;1,0;10,0;2,0;;5,0;1,0;;1,0;2,0;5,0;1,0;;5,0;;1,0;5,0;7,0;;;33,0;;1,0;;;;;;;;8,0;16,0;;20,0;9,0;21,0;13,0;;;;;;11,0;6,0;1,0;2,0;1,0;1,0;;;;;;;;;;10,0;15,0;1,0;;;6,0;2,0;;12,0;2,0;;;;;;;;1,0;;;;1,0;2,0;18,0;;;2,0;14,0;;;8,0;;2,0;;1,0;;;8,0;;1,0;6,0;3,0;1,0;10,0;;23,0;2,0;1,0;;7,0;4,0;4,0;;1,0;;7,0;;9,0;9,0;1,0;3,0;;;4,0;;12,0;;2,0;;1,0;;;;29,0;;;;117,0;;2,0;12,0;;;;3,0;;;2,0;;;;;;;9,0;;8,0;9,0;;;1,0;;4,0;1,0;1,0;14,0;;5,0;;;2,0;;3,0;;;15,0;;;1,0;;29,0;;5,0;;1,0;;2,0;1,0;9,0;;;2,0;1,0;;;1,0;1,0;3,0;2,0;;;7,0;
file;10,0;;;3,0;2,0;;;12,0;2,0;2,0;;;41,0;2,0;;25,0;;1,0;;1,0;;58,0;1,0;;;;;;;;54,0;2,0;23,0;;46,0;6,0;;;79,0;;243,0;;;2,0;2,0;1,0;17,0;137,0;145,0;27,0;;;;;;;4,0;;;17,0;2,0;18,0;2,0;;16,0;;;2,0;48,0;;1,0;;60,0;1,0;;8,0;11,0;;2,0;740,0;;4,0;1,0;55,0;;9,0;;;;;2,0;2,0;1,0;6,0;;56,0;49,0;36,0;81,0;9,0;2,0;14,0;9,0;10,0;;;2,0;7,0;22,0;8,0;2,0;5,0;;1,0;1,0;61,0;1,0;10,0;;17,0;1,0;;31,0;41,0;25,0;4,0;5,0;;;;;5,0;;;5,0;3,0;6,0;8,0;7,0;;9,0;;6,0;1,0;17,0;;;;15,0;13,0;12,0;;39,0;103,0;1,0;;35,0;;;45,0;1,0;36,0;38,0;;;;136,0;5,0;;;1,0;;;2,0;4,0;3,0;;;;;;;;;;1,0;;;;;53,0;;;6,0;2,0;;14,0;;;;;;3,0;;;;;;;1,0;;;;;;;;;;;;;;;;2,0;;;1,0;;7,0;;8,0;3,0;;1,0;2,0;9,0;;;1,0;;;3,0;;;;;2,0;;;;1,0;;;;38,0;;;;;;;18,0;;;3,0;;9,0;;1,0;6,0;;;;;1,0;1,0;1,0;12,0;2,0;5,0;1,0;;;12,0;;;;;;;;;;;;;1,0;;;1,0;4,0;;;;;;;;;1,0;;;7,0;11,0;;1,0;;;;;;;;;;;;;;;;;;;;;;;;;3,0;59,0;;5,0;;;;;;;8,0;;;;;9,0;4,0;;;;;;;;;;;;;5,0;1,0;1,0;;;;;;;;;;;;1,0;;;;2,0;;8,0;;2,0;;4,0;;;;;;;6,0;;;;;;;;1,0;1,0;4,0;;7,0;;;4,0;4,0;;;4,0;;;;;;;;;;2,0;;;13,0;;2,0;7,0;12,0;;3,0;7,0;33,0;;45,0;;7,0;1,0;2,0;;4,0;;;;13,0;126,0;18,0;2,0;;;;;8,0;1,0;;;;;;;;;2,0;6,0;15,0;2,0;;;;;;;1,0;;;;;1,0;2,0;;;;2,0;4,0;;14,0;1,0;;10,0;;2,0;;;6,0;8,0;;1,0;;2,0;4,0;;4,0;;1,0;10,0;;;;;3,0;;;3,0;2,0;1,0;6,0;18,0;;12,0;;;2,0;24,0;3,0;;;1,0;54,0;4,0;;;;1,0;;;22,0;1,0;4,0;;7,0;;2,0;;16,0;5,0;8,0;;;;;6,0;;;;5,0;9,0;10,0;9,0;4,0;;4,0;13,0;;;;8,0;3,0;3,0;;2,0;;;;;2,0;;;;7,0;;3,0;;;;2,0;;2,0;3,0;;;;3,0;53,0;2,0;;;3,0;;1,0;;;;;1,0;2,0;;;;14,0;2,0;;2,0;;;;;17,0;;2,0;;;;2,0;16,0;3,0;4,0;3,0;;9,0;;;1,0;;2,0;16,0;;;;;;;3,0;5,0;;;;2,0;;;;;;;;3,0;;;;;;;;;;;;;;;;1,0;;;;;;5,0;;;;;;;;2,0;;1,0;;1,0;;;;;;;;;;;;;;1,0;;;;;;;;;;;;43,0;;;;;;;3,0;;;;1,0;;;;;4,0;;;;;;;;2,0;;;;;;;1,0;;;36,0;;;;;;31,0;1,0;21,0;;;18,0;;;;4,0;;;;;;;;22,0;;;4,0;1,0;;;;6,0;;;;;;;;;;;;;;;;;;;;1,0;;;;;;;;;;;;;;4,0;;;;1,0;;;;;;;;;;;;3,0;;;;;;;;;;;;;3,0;2,0;;1,0;1,0;;;;;;7,0;;;;1,0;;;;;1,0;;;;;1,0;;;;;;;;;;;;;;;;;;;;1,0;;;;1,0;;;;;;;;;;;;;;;;;;;;;;;;;20,0;;;;;;;37,0;;1,0;;;1,0;;3,0;;;;;;;2,0;;;;;;;;;;;;;;;;;;4,0;;;;;;;;;;;;;9,0;;;;;;1,0;;;;;;;;;;;;;;;11,0;
filter;6,0;2,0;6,0;;9,0;15,0;53,0;82,0;58,0;122,0;236,0;1,0;15,0;1,0;31,0;100,0;18,0;7,0;10,0;3,0;7,0;104,0;1,0;43,0;5,0;9,0;1271,0;34,0;;20,0;14,0;21,0;207,0;7,0;92,0;3,0;11,0;7,0;17,0;;81,0;3,0;35,0;25,0;35,0;39,0;55,0;209,0;78,0;15,0;108,0;18,0;2,0;10,0;7,0;94,0;110,0;6,0;18,0;2,0;26,0;6,0;1,0;16,0;;8,0;11,0;126,0;149,0;40,0;10,0;21,0;81,0;2,0;7,0;54,0;14,0;2,0;8,0;688,0;13,0;98,0;4,0;488,0;17,0;6,0;1,0;;1,0;13,0;259,0;1,0;5,0;10,0;3,0;4,0;15,0;;220,0;10,0;10,0;26,0;129,0;88,0;3,0;19,0;569,0;9,0;98,0;45,0;205,0;120,0;4,0;14,0;;434,0;93,0;157,0;7,0;29,0;5,0;;35,0;80,0;40,0;3,0;16,0;3,0;21,0;54,0;1,0;7,0;10,0;31,0;20,0;21,0;33,0;128,0;25,0;5,0;17,0;;3,0;190,0;23,0;;;69,0;217,0;18,0;20,0;6,0;15,0;16,0;5,0;5,0;162,0;;1,0;1,0;3,0;78,0;310,0;;6,0;;59,0;16,0;58,0;142,0;2,0;37,0;7,0;13,0;21,0;99,0;5,0;6,0;33,0;106,0;9,0;4,0;6,0;9,0;7,0;74,0;14,0;142,0;1,0;13,0;7,0;1,0;;42,0;;5,0;4,0;;14,0;35,0;8,0;4,0;32,0;74,0;6,0;;;3,0;34,0;40,0;44,0;3,0;2,0;;43,0;82,0;9,0;3,0;2,0;16,0;30,0;40,0;30,0;3,0;6,0;2,0;95,0;;544,0;1,0;38,0;6,0;6,0;53,0;14,0;23,0;19,0;32,0;5,0;7,0;9,0;3,0;4,0;118,0;10,0;16,0;20,0;3,0;703,0;9,0;32,0;34,0;;;;;94,0;9,0;8,0;1,0;;18,0;9,0;67,0;14,0;;20,0;14,0;12,0;;;29,0;13,0;10,0;7,0;2,0;1,0;23,0;52,0;74,0;77,0;;12,0;2,0;7,0;14,0;12,0;2,0;;52,0;4,0;44,0;8,0;;17,0;;7,0;;2,0;;12,0;30,0;14,0;16,0;;;;39,0;10,0;9,0;;3,0;6,0;;7,0;47,0;;2,0;2,0;42,0;;;;;6,0;;11,0;;;8,0;1,0;;;;;54,0;4,0;9,0;12,0;63,0;;;54,0;13,0;3,0;3,0;13,0;;6,0;95,0;5,0;8,0;;12,0;1,0;20,0;;26,0;10,0;127,0;;10,0;15,0;10,0;3,0;;;7,0;12,0;6,0;1,0;;4,0;3,0;;;18,0;5,0;9,0;22,0;1,0;10,0;30,0;8,0;5,0;8,0;;2,0;4,0;45,0;;22,0;6,0;2,0;1,0;49,0;13,0;12,0;9,0;;11,0;2,0;1,0;12,0;1,0;;7,0;6,0;1,0;17,0;;5,0;1,0;1,0;16,0;;1,0;;;;;3,0;26,0;5,0;;5,0;1,0;8,0;2,0;1,0;2,0;37,0;18,0;12,0;35,0;;16,0;26,0;21,0;1,0;;46,0;27,0;1,0;1,0;5,0;80,0;;6,0;5,0;1,0;2,0;;;1,0;9,0;;5,0;1,0;;8,0;;2,0;;;;;;25,0;3,0;1,0;8,0;;6,0;12,0;6,0;9,0;;7,0;;6,0;23,0;8,0;32,0;1,0;;;7,0;4,0;10,0;4,0;;3,0;11,0;7,0;3,0;2,0;2,0;5,0;2,0;9,0;;1,0;32,0;19,0;;2,0;;20,0;;18,0;12,0;;;5,0;;;1,0;;;3,0;4,0;6,0;4,0;;6,0;1,0;3,0;13,0;1,0;;4,0;12,0;;;;2,0;5,0;;1,0;;8,0;;12,0;;22,0;;11,0;2,0;9,0;1,0;;2,0;4,0;1,0;45,0;;;33,0;;;3,0;2,0;76,0;;1,0;4,0;2,0;1,0;4,0;20,0;3,0;4,0;;2,0;18,0;;5,0;2,0;;34,0;2,0;;6,0;25,0;5,0;;3,0;5,0;;;;2,0;5,0;5,0;;;2,0;14,0;;38,0;2,0;19,0;;;14,0;2,0;;;;;;;;1,0;;;2,0;;4,0;7,0;1,0;;1,0;3,0;;68,0;8,0;36,0;1,0;2,0;;;29,0;1,0;;;2,0;8,0;;12,0;2,0;10,0;;;5,0;6,0;2,0;6,0;1,0;5,0;1,0;;;2,0;16,0;2,0;1,0;;;;;;19,0;17,0;5,0;2,0;3,0;1,0;7,0;49,0;8,0;22,0;16,0;1,0;8,0;;;2,0;;;1,0;;;;27,0;;8,0;;2,0;;1,0;1,0;2,0;;2,0;;;2,0;;;;;2,0;;4,0;10,0;;5,0;;;;;16,0;;5,0;;;18,0;;;;;;;;;4,0;2,0;;;2,0;6,0;4,0;16,0;1,0;;1,0;;12,0;;16,0;;2,0;;;1,0;7,0;4,0;;6,0;;;8,0;;3,0;2,0;;29,0;5,0;;;;1,0;7,0;;8,0;19,0;;;;2,0;;12,0;;;1,0;2,0;35,0;13,0;;4,0;5,0;9,0;12,0;23,0;;1,0;16,0;20,0;6,0;;4,0;;;;;2,0;3,0;1,0;8,0;6,0;103,0;10,0;1,0;5,0;5,0;;6,0;1,0;;167,0;;13,0;;8,0;;;16,0;;;;3,0;10,0;;;;;1,0;;1,0;24,0;;10,0;2,0;2,0;3,0;;;;8,0;5,0;1,0;2,0;;;;1,0;;2,0;4,0;3,0;;3,0;1,0;;1,0;;4,0;3,0;2,0;8,0;9,0;;105,0;69,0;;;;1,0;;5,0;;;;2,0;;;;2,0;2,0;9,0;66,0;;13,0;;;44,0;1,0;;6,0;100,0;;;1,0;4,0;20,0;;3,0;1,0;3,0;;22,0;;24,0;;;10,0;;3,0;;;4,0;;2,0;;5,0;1,0;;2,0;;;;;1,0;11,0;;;;1,0;6,0;1,0;;2,0;2,0;;3,0;;2,0;;;1,0;2,0;4,0;;;2,0;;3,0;1,0;;10,0;5,0;8,0;7,0;2,0;1,0;2,0;;29,0;1,0;6,0;4,0;304,0;;;;;1,0;3,0;;;;3,0;2,0;1,0;2,0;;4,0;6,0;1,0;1,0;2,0;;;1,0;3,0;;2,0;1,0;4,0;;;5,0;;;;;;
focal;1,0;1,0;;;5,0;59,0;77,0;21,0;26,0;17,0;145,0;1,0;20,0;2,0;40,0;112,0;3,0;11,0;;2,0;6,0;45,0;14,0;3,0;3,0;2,0;3,0;27,0;;6,0;6,0;372,0;75,0;10,0;59,0;11,0;6,0;9,0;5,0;;40,0;4,0;15,0;19,0;52,0;67,0;92,0;69,0;20,0;19,0;14,0;423,0;38,0;15,0;3,0;3,0;171,0;28,0;7,0;;;;25,0;;8,0;;163,0;50,0;25,0;30,0;20,0;;16,0;;;127,0;13,0;2,0;2,0;393,0;31,0;116,0;;90,0;1,0;7,0;23,0;;;3000,0;1933,0;;;2,0;3,0;7,0;14,0;6,0;115,0;6,0;2,0;;76,0;84,0;30,0;1,0;192,0;2,0;10,0;62,0;26,0;15,0;2,0;;6,0;148,0;21,0;221,0;30,0;71,0;;3,0;11,0;10,0;14,0;9,0;;;8,0;57,0;1,0;37,0;12,0;;72,0;20,0;4,0;4,0;7,0;340,0;36,0;;2,0;99,0;63,0;2,0;3,0;87,0;19,0;16,0;4,0;52,0;4,0;15,0;16,0;1,0;1530,0;367,0;17,0;2,0;2,0;3,0;839,0;;35,0;;12,0;30,0;4,0;10,0;218,0;;1,0;3,0;12,0;7,0;47,0;7,0;;;2,0;14,0;;;;4,0;;71,0;;;;1,0;;6,0;4,0;1,0;;2,0;;12,0;;1,0;35,0;16,0;;;3,0;1,0;19,0;2,0;10,0;;1,0;;;;;1,0;25,0;;9,0;2,0;;;1,0;1,0;;8,0;57,0;1,0;27,0;;2,0;20,0;;4,0;6,0;3,0;1,0;;3,0;;;3,0;7,0;;;2,0;74,0;403,0;13,0;;1,0;1,0;;;42,0;2,0;;2,0;;;;59,0;;;10,0;;93,0;;2,0;6,0;2,0;;;;4,0;5,0;1,0;121,0;;;3,0;8,0;;72,0;23,0;;4,0;2,0;2,0;33,0;;;;;;;1,0;;2,0;16,0;1,0;2,0;1,0;;;;;;;4,0;3,0;;8,0;3,0;;2,0;4,0;6,0;1,0;;5,0;;1,0;;3,0;1,0;2,0;;;4,0;42,0;;;;;;;2,0;;;;7,0;579,0;1,0;8,0;;2,0;;2,0;;2,0;2,0;;3,0;;250,0;1,0;16,0;;14,0;;;2,0;;;10,0;;;7,0;1,0;;2,0;;;9,0;3,0;1,0;3,0;;;;2,0;;3,0;;;;12,0;;52,0;;3,0;3,0;4,0;;4,0;2,0;;4,0;;;13,0;5,0;;;5,0;15,0;84,0;67,0;2,0;4,0;242,0;9,0;6,0;;;;1,0;;4,0;49,0;3,0;;5,0;2,0;21,0;;;;12,0;16,0;;61,0;;10,0;17,0;11,0;10,0;5,0;16,0;7,0;;;5,0;17,0;8,0;3,0;;49,0;;;4,0;12,0;22,0;;;;;3,0;;;14,0;;;;;12,0;13,0;;;;;9,0;2,0;;;;4,0;114,0;3,0;6,0;8,0;1,0;;9,0;;8,0;2,0;;2,0;;3,0;9,0;1,0;;3,0;6,0;;35,0;;;37,0;3,0;;;1,0;;;;2,0;2,0;;;;4,0;;;;;1,0;2,0;46,0;11,0;;;;;6,0;;3,0;2,0;;;1,0;37,0;1,0;;5,0;;1,0;;13,0;;1,0;21,0;2,0;;4,0;;;8,0;1,0;;;;;;1,0;;3,0;;13,0;;;2,0;;1,0;54,0;1,0;2,0;;;;1,0;;3,0;;;;;;;1,0;16,0;;;;;1,0;;;;2,0;;;;31,0;;17,0;;;;14,0;4,0;;;;;;;;;;;;3,0;;;;;;;;;71,0;;;;;;;10,0;3,0;;;;;;6,0;;;;;;;;31,0;;;1,0;;;13,0;4,0;5,0;1,0;;;;;;;2,0;;2,0;163,0;;7,0;2,0;4,0;;;;1,0;;;;;;;3,0;;;12,0;;4,0;;4,0;;;2,0;;;;;;10,0;;;1,0;3,0;;;;;4,0;;;;;;1,0;;4,0;;;9,0;;;2,0;2,0;;;;;;;9,0;;;11,0;1,0;;;;7,0;;;;;;4,0;;;;;5,0;;;;1,0;2,0;;;;1,0;;1,0;;;;;;1,0;3,0;11,0;2,0;;;;3,0;11,0;;4,0;4,0;10,0;2,0;50,0;;;1,0;15,0;1,0;;1,0;;;2,0;;;;;;;;;15,0;1,0;12,0;;4,0;;;1,0;;;;;20,0;;114,0;1,0;;;2,0;4,0;6,0;;40,0;;29,0;4,0;;;4,0;;1,0;;;6,0;8,0;2,0;18,0;;1,0;;1,0;;;;1,0;2,0;1,0;;1,0;;20,0;;;;;1,0;;;;;10,0;;2,0;;;;;;4,0;;;;;;3,0;;;;;;;;;2,0;;;3,0;;;1,0;;;2,0;1,0;;;;;2,0;;;;2,0;;3,0;;2,0;;1,0;;1,0;;1,0;1,0;1,0;1,0;;;4,0;4,0;;8,0;;;2,0;8,0;;;;;1,0;56,0;3,0;35,0;;6,0;;;;;2,0;;;2,0;;;13,0;;;;2,0;1,0;;;4,0;1,0;;;14,0;1,0;15,0;57,0;;;;6,0;6,0;6,0;2,0;;;;;2,0;46,0;4,0;6,0;;2,0;;;9,0;;;19,0;;;;;;;;1,0;2,0;;;;;;;;
focus;4,0;;14,0;;;27,0;30,0;189,0;322,0;53,0;18,0;;50,0;;128,0;365,0;33,0;23,0;12,0;6,0;55,0;110,0;54,0;7,0;10,0;2,0;19,0;6,0;2,0;10,0;4,0;299,0;351,0;51,0;678,0;169,0;63,0;34,0;;;81,0;47,0;32,0;92,0;418,0;567,0;446,0;211,0;74,0;63,0;20,0;651,0;;27,0;384,0;35,0;105,0;13,0;50,0;2,0;27,0;;26,0;;11,0;163,0;;44,0;20,0;6,0;62,0;70,0;168,0;;4,0;102,0;24,0;7,0;18,0;807,0;14,0;173,0;7,0;225,0;40,0;47,0;66,0;2,0;27,0;106,0;2382,0;;;4,0;29,0;12,0;26,0;;311,0;2,0;8,0;12,0;191,0;237,0;8,0;117,0;334,0;13,0;117,0;90,0;22,0;209,0;;;;223,0;177,0;1011,0;28,0;111,0;11,0;2,0;61,0;45,0;56,0;9,0;;6,0;16,0;168,0;1,0;62,0;33,0;3,0;36,0;3,0;16,0;18,0;8,0;32,0;91,0;;9,0;134,0;158,0;;;22,0;254,0;30,0;18,0;2,0;32,0;58,0;183,0;24,0;338,0;40,0;7,0;2,0;11,0;27,0;637,0;36,0;12,0;2,0;17,0;41,0;47,0;1,0;131,0;;1,0;9,0;88,0;19,0;38,0;37,0;;;1,0;63,0;;;13,0;49,0;2,0;29,0;1,0;;;2,0;1,0;8,0;4,0;10,0;;2,0;;4,0;1,0;4,0;44,0;157,0;4,0;1,0;3,0;5,0;59,0;52,0;1,0;1,0;4,0;;;;1,0;;6,0;15,0;17,0;7,0;28,0;;;1,0;1,0;;216,0;1,0;64,0;3,0;17,0;24,0;9,0;188,0;109,0;4,0;2,0;5,0;20,0;;10,0;37,0;24,0;5,0;6,0;1,0;254,0;105,0;3,0;4,0;;12,0;;2,0;76,0;11,0;;1,0;;;5,0;145,0;3,0;4,0;7,0;2,0;8,0;;3,0;17,0;6,0;;2,0;3,0;40,0;11,0;8,0;69,0;26,0;5,0;4,0;2,0;;149,0;3,0;24,0;;3,0;2,0;1,0;;1,0;;9,0;1,0;;5,0;;45,0;22,0;;;;;5,0;6,0;6,0;18,0;;24,0;1,0;;27,0;10,0;;1,0;;29,0;;;3,0;;178,0;;3,0;2,0;1,0;3,0;1,0;1,0;;2,0;;19,0;;18,0;35,0;6,0;;1,0;2,0;14,0;101,0;23,0;10,0;83,0;9,0;7,0;;2,0;1,0;34,0;1,0;2,0;;144,0;3,0;1,0;;26,0;;5,0;2,0;;;1,0;;2,0;8,0;1,0;;8,0;3,0;;36,0;3,0;15,0;1,0;3,0;;;;1,0;9,0;3,0;2,0;1,0;12,0;5,0;192,0;19,0;2,0;5,0;10,0;1,0;32,0;16,0;;;;3,0;10,0;1,0;;8,0;4,0;36,0;132,0;117,0;4,0;22,0;20,0;3,0;3,0;5,0;4,0;1,0;1,0;;17,0;109,0;45,0;;;6,0;14,0;;7,0;;45,0;17,0;5,0;97,0;2,0;4,0;22,0;150,0;;6,0;4,0;75,0;1,0;;34,0;198,0;27,0;;22,0;28,0;5,0;;41,0;8,0;16,0;;12,0;;54,0;13,0;4,0;;40,0;;;11,0;1,0;32,0;28,0;;;5,0;10,0;54,0;1,0;2,0;;;;463,0;6,0;1,0;22,0;3,0;;3,0;1,0;3,0;2,0;;4,0;8,0;39,0;7,0;22,0;;8,0;11,0;;88,0;;4,0;110,0;11,0;43,0;46,0;;3,0;14,0;;33,0;;;2,0;4,0;;;;1,0;10,0;7,0;1,0;193,0;;;1,0;;9,0;4,0;1,0;2,0;;;3,0;2,0;113,0;;12,0;16,0;;10,0;5,0;4,0;12,0;22,0;17,0;4,0;;21,0;;;2,0;1,0;;;5,0;;1,0;6,0;5,0;3,0;3,0;9,0;;15,0;;13,0;;1,0;4,0;;1,0;;3,0;7,0;;;17,0;;18,0;;;;4,0;1,0;;;2,0;;;;4,0;1,0;15,0;;;;30,0;;23,0;;;;11,0;7,0;4,0;;;;8,0;;1,0;;;;;2,0;;1,0;;;;8,0;1,0;;192,0;8,0;4,0;9,0;6,0;;;9,0;2,0;;;5,0;1,0;5,0;13,0;22,0;;9,0;;;;1,0;24,0;;;1,0;;;14,0;;212,0;16,0;;;;1,0;;4,0;3,0;;3,0;25,0;7,0;8,0;88,0;;;;3,0;;3,0;;;;;;3,0;;;1,0;1,0;;8,0;5,0;;1,0;4,0;;1,0;;1,0;;;;;;;;;1,0;3,0;24,0;3,0;1,0;2,0;;;8,0;;;;;;;;1,0;;1,0;;7,0;1,0;4,0;;60,0;;;;1,0;2,0;;;4,0;4,0;5,0;7,0;;;8,0;;;;;;;;2,0;1,0;4,0;;13,0;;;17,0;4,0;8,0;;;;2,0;71,0;2,0;4,0;;;;23,0;114,0;15,0;;;1,0;5,0;;56,0;;1,0;11,0;10,0;1,0;16,0;38,0;7,0;8,0;2,0;;;;7,0;;;1,0;;8,0;71,0;4,0;14,0;4,0;16,0;1,0;2,0;;10,0;6,0;2,0;45,0;4,0;1,0;32,0;4,0;2,0;;;5,0;;27,0;;22,0;3,0;5,0;;;3,0;1,0;;;;;1,0;4,0;4,0;2,0;3,0;;21,0;1,0;8,0;2,0;;4,0;1,0;10,0;11,0;3,0;2,0;1,0;1,0;;14,0;1,0;;;3,0;20,0;1,0;28,0;;;;8,0;3,0;;1,0;;2,0;;;3,0;;1,0;7,0;;7,0;;5,0;3,0;;52,0;;8,0;;;4,0;;1,0;;5,0;2,0;;;2,0;42,0;;2,0;;9,0;;12,0;;;;1,0;;1,0;;2,0;;;;;4,0;1,0;6,0;4,0;1,0;;;;14,0;;3,0;;;9,0;3,0;;3,0;;6,0;7,0;;;;;;;;;21,0;11,0;4,0;;;;4,0;;;29,0;;;;;1,0;;4,0;4,0;2,0;;3,0;3,0;4,0;;;;1,0;;;11,0;;;9,0;1,0;;;4,0;;;;;;1,0;3,0;;;;3,0;;;12,0;;;1,0;;;
form;12,0;12,0;1,0;2,0;5,0;167,0;64,0;107,0;206,0;145,0;147,0;23,0;10,0;;101,0;150,0;48,0;2,0;5,0;3,0;19,0;103,0;;76,0;11,0;3,0;135,0;18,0;12,0;1,0;12,0;3,0;230,0;;86,0;5,0;10,0;23,0;7,0;9,0;145,0;6,0;49,0;24,0;15,0;16,0;35,0;375,0;83,0;194,0;56,0;22,0;4,0;30,0;52,0;146,0;251,0;12,0;24,0;1,0;93,0;57,0;30,0;2,0;126,0;50,0;44,0;;156,0;108,0;66,0;27,0;35,0;;3,0;80,0;2,0;19,0;28,0;2481,0;12,0;291,0;2,0;413,0;7,0;10,0;18,0;;18,0;30,0;1544,0;1,0;1,0;252,0;14,0;21,0;24,0;;350,0;16,0;5,0;15,0;438,0;417,0;36,0;2,0;1064,0;20,0;101,0;10,0;48,0;47,0;73,0;13,0;26,0;541,0;897,0;200,0;37,0;55,0;18,0;21,0;42,0;45,0;39,0;;;3,0;22,0;38,0;5,0;24,0;7,0;12,0;28,0;19,0;78,0;8,0;3,0;8,0;70,0;;;401,0;9,0;12,0;6,0;418,0;204,0;29,0;1,0;36,0;5,0;29,0;286,0;11,0;744,0;;21,0;98,0;4,0;38,0;526,0;;1,0;;80,0;48,0;40,0;6,0;427,0;14,0;38,0;55,0;28,0;8,0;92,0;118,0;19,0;3,0;63,0;213,0;88,0;65,0;47,0;169,0;26,0;92,0;1,0;10,0;8,0;5,0;43,0;151,0;6,0;173,0;11,0;13,0;31,0;147,0;30,0;3,0;40,0;124,0;;30,0;18,0;3,0;22,0;145,0;321,0;27,0;27,0;47,0;41,0;8,0;229,0;43,0;5,0;343,0;334,0;37,0;134,0;9,0;9,0;88,0;623,0;12,0;410,0;41,0;285,0;86,0;33,0;163,0;15,0;9,0;12,0;262,0;64,0;129,0;43,0;31,0;14,0;35,0;19,0;38,0;79,0;10,0;443,0;113,0;188,0;1,0;29,0;13,0;2,0;17,0;268,0;59,0;14,0;27,0;11,0;109,0;8,0;27,0;228,0;4,0;187,0;105,0;26,0;73,0;49,0;51,0;123,0;74,0;3,0;51,0;1,0;162,0;619,0;1113,0;12,0;1,0;96,0;28,0;18,0;46,0;9,0;22,0;;118,0;9,0;28,0;2,0;69,0;142,0;4,0;8,0;2,0;110,0;8,0;71,0;20,0;23,0;10,0;37,0;13,0;11,0;90,0;141,0;27,0;5,0;84,0;90,0;24,0;19,0;84,0;6,0;62,0;29,0;83,0;21,0;9,0;17,0;31,0;46,0;4,0;57,0;42,0;;5,0;17,0;28,0;43,0;9,0;;6,0;15,0;129,0;22,0;126,0;42,0;19,0;53,0;41,0;11,0;10,0;24,0;10,0;20,0;123,0;40,0;27,0;;55,0;16,0;24,0;11,0;112,0;19,0;14,0;10,0;30,0;35,0;35,0;108,0;8,0;5,0;73,0;125,0;30,0;9,0;;;4,0;3,0;11,0;70,0;3,0;30,0;19,0;35,0;9,0;35,0;28,0;10,0;6,0;38,0;7,0;10,0;120,0;41,0;43,0;7,0;55,0;68,0;20,0;2,0;15,0;40,0;11,0;2,0;;2,0;36,0;4,0;;5,0;4,0;11,0;15,0;26,0;26,0;11,0;41,0;6,0;6,0;8,0;14,0;17,0;;;3,0;28,0;3,0;;2,0;4,0;18,0;5,0;2,0;;26,0;12,0;22,0;21,0;;3,0;11,0;11,0;15,0;18,0;2,0;25,0;1,0;4,0;12,0;10,0;3,0;1,0;;27,0;3,0;;12,0;1,0;26,0;;1,0;;;23,0;3,0;2,0;;6,0;2,0;;;15,0;10,0;6,0;5,0;2,0;7,0;25,0;6,0;10,0;2,0;29,0;5,0;35,0;26,0;1,0;44,0;12,0;3,0;1,0;;4,0;23,0;5,0;9,0;3,0;3,0;20,0;1,0;4,0;4,0;22,0;2,0;48,0;2,0;5,0;58,0;6,0;;57,0;1,0;35,0;1,0;5,0;19,0;;;6,0;1,0;1,0;2,0;1,0;1,0;10,0;;3,0;22,0;;7,0;4,0;25,0;3,0;17,0;4,0;4,0;24,0;71,0;;6,0;4,0;20,0;;13,0;;49,0;;1,0;;2,0;7,0;;3,0;5,0;;11,0;20,0;;3,0;25,0;1,0;16,0;27,0;6,0;6,0;7,0;54,0;13,0;32,0;3,0;5,0;13,0;;1,0;211,0;;4,0;;5,0;2,0;16,0;6,0;4,0;3,0;3,0;4,0;;6,0;7,0;;;4,0;4,0;;10,0;;1,0;27,0;10,0;;;3,0;30,0;3,0;20,0;2,0;4,0;8,0;;23,0;6,0;29,0;6,0;;;4,0;44,0;10,0;13,0;;5,0;2,0;8,0;5,0;27,0;;16,0;1,0;3,0;;285,0;11,0;2,0;2,0;2,0;3,0;;28,0;;;12,0;42,0;1,0;;1,0;2,0;1,0;;10,0;1,0;10,0;21,0;12,0;8,0;9,0;;;15,0;3,0;24,0;1,0;4,0;15,0;9,0;8,0;4,0;7,0;15,0;93,0;33,0;20,0;17,0;;31,0;8,0;24,0;12,0;4,0;;11,0;;9,0;30,0;7,0;7,0;2,0;12,0;14,0;4,0;29,0;;34,0;19,0;63,0;19,0;3,0;5,0;2,0;3,0;1,0;13,0;3,0;27,0;1,0;;;6,0;1,0;2,0;1,0;13,0;15,0;5,0;32,0;1,0;;6,0;117,0;;3,0;6,0;5,0;45,0;14,0;13,0;17,0;18,0;;3,0;59,0;184,0;22,0;11,0;47,0;15,0;2,0;6,0;9,0;12,0;4,0;7,0;30,0;6,0;7,0;1,0;110,0;;10,0;2,0;64,0;5,0;1,0;31,0;;5,0;;1,0;41,0;43,0;7,0;6,0;2,0;93,0;3,0;2,0;3,0;;2,0;;;3,0;34,0;22,0;;25,0;316,0;4,0;13,0;18,0;5,0;2,0;8,0;97,0;6,0;21,0;2,0;5,0;;12,0;2,0;30,0;;2,0;63,0;10,0;8,0;78,0;4,0;1,0;15,0;27,0;4,0;22,0;6,0;2,0;;9,0;4,0;8,0;19,0;;6,0;7,0;14,0;4,0;;;;4,0;2,0;7,0;1,0;11,0;5,0;37,0;1,0;9,0;1,0;18,0;10,0;4,0;1,0;4,0;1,0;4,0;40,0;10,0;9,0;10,0;1,0;8,0;5,0;1,0;;1,0;;;4,0;9,0;;5,0;6,0;6,0;4,0;;;5,0;;3,0;4,0;;;3,0;1,0;;1,0;8,0;;3,0;8,0;;1,0;3,0;20,0;;;22,0;2,0;2,0;8,0;1,0;4,0;;15,0;8,0;24,0;1,0;;8,0;;;8,0;2,0;2,0;1,0;3,0;;3,0;1,0;16,0;4,0;;8,0;;7,0;2,0;1,0;;3,0;;7,0;13,0;;25,0;5,0;2,0;3,0;14,0;;2,0;7,0;22,0;;2,0;1,0;2,0;3,0;3,0;16,0;15,0;;1,0;1,0;1,0;2,0;;6,0;;7,0;;2,0;17,0;4,0;;3,0;1,0;7,0;9,0;3,0;1,0;;;;8,0;;53,0;8,0;8,0;15,0;5,0;12,0;6,0;9,0;14,0;2,0;;7,0;8,0;;1,0;4,0;;4,0;2,0;5,0;;;11,0;7,0;1,0;;16,0;17,0;3,0;21,0;;6,0;7,0;1,0;3,0;2,0;;4,0;;7,0;2,0;;1,0;;;1,0;1,0;;1,0
frame;11,0;2,0;;7,0;42,0;19,0;9,0;167,0;125,0;44,0;51,0;;157,0;5,0;64,0;510,0;29,0;53,0;65,0;12,0;38,0;791,0;22,0;10,0;12,0;12,0;210,0;11,0;3,0;34,0;48,0;24,0;258,0;11,0;119,0;58,0;44,0;15,0;56,0;;482,0;9,0;148,0;168,0;217,0;35,0;395,0;318,0;159,0;270,0;66,0;34,0;9,0;41,0;83,0;39,0;94,0;9,0;67,0;;69,0;21,0;52,0;48,0;149,0;25,0;20,0;156,0;;45,0;47,0;;366,0;20,0;;42,0;127,0;2,0;32,0;2528,0;11,0;93,0;3,0;479,0;32,0;33,0;8,0;6,0;2,0;22,0;426,0;3,0;8,0;6,0;10,0;30,0;134,0;10,0;494,0;30,0;66,0;46,0;167,0;313,0;;16,0;72,0;23,0;113,0;147,0;21,0;92,0;8,0;3,0;17,0;681,0;292,0;346,0;20,0;153,0;4,0;14,0;56,0;128,0;122,0;30,0;;2,0;16,0;85,0;2,0;346,0;132,0;12,0;110,0;114,0;106,0;57,0;34,0;9,0;140,0;7,0;16,0;245,0;87,0;;9,0;129,0;168,0;81,0;26,0;9,0;33,0;187,0;59,0;4,0;193,0;;52,0;47,0;46,0;61,0;222,0;4,0;7,0;;1287,0;163,0;18,0;5,0;35,0;;17,0;74,0;134,0;71,0;87,0;31,0;12,0;;29,0;73,0;;19,0;;62,0;;11,0;10,0;;58,0;21,0;1,0;123,0;3,0;11,0;30,0;1,0;4,0;57,0;10,0;4,0;135,0;107,0;31,0;13,0;1,0;8,0;109,0;89,0;6,0;;28,0;17,0;5,0;;17,0;30,0;7,0;113,0;85,0;1,0;91,0;33,0;;2,0;6,0;11,0;83,0;;148,0;46,0;48,0;242,0;95,0;48,0;96,0;42,0;28,0;66,0;90,0;19,0;2,0;18,0;35,0;;6,0;7,0;246,0;34,0;58,0;2,0;24,0;4,0;;38,0;303,0;7,0;15,0;;7,0;5,0;34,0;327,0;9,0;7,0;75,0;6,0;94,0;1,0;11,0;62,0;44,0;8,0;;20,0;83,0;18,0;22,0;142,0;16,0;26,0;5,0;2,0;2,0;284,0;14,0;6,0;;;27,0;39,0;7,0;;34,0;;11,0;;13,0;11,0;48,0;13,0;102,0;3,0;3,0;13,0;14,0;62,0;50,0;4,0;33,0;20,0;24,0;1,0;16,0;84,0;;15,0;;54,0;26,0;2,0;;8,0;51,0;6,0;22,0;4,0;4,0;2,0;11,0;10,0;;;;10,0;9,0;66,0;53,0;80,0;3,0;;48,0;24,0;19,0;20,0;16,0;32,0;64,0;35,0;15,0;6,0;2,0;6,0;12,0;15,0;25,0;116,0;29,0;23,0;15,0;29,0;12,0;6,0;10,0;;;11,0;14,0;10,0;9,0;;2,0;17,0;4,0;47,0;17,0;2,0;22,0;26,0;3,0;4,0;17,0;26,0;4,0;74,0;34,0;6,0;;326,0;31,0;103,0;1,0;6,0;5,0;23,0;2,0;9,0;38,0;1,0;;;17,0;20,0;1,0;;;6,0;25,0;113,0;91,0;43,0;80,0;21,0;58,0;5,0;16,0;18,0;13,0;4,0;21,0;2,0;26,0;50,0;7,0;7,0;39,0;181,0;51,0;4,0;34,0;269,0;50,0;8,0;58,0;9,0;39,0;38,0;140,0;10,0;24,0;493,0;71,0;1,0;3,0;36,0;43,0;8,0;5,0;107,0;4,0;1,0;;16,0;701,0;132,0;10,0;10,0;29,0;34,0;13,0;2,0;1,0;18,0;17,0;4,0;8,0;;83,0;52,0;10,0;2,0;14,0;36,0;60,0;3,0;130,0;9,0;6,0;2,0;71,0;45,0;49,0;55,0;85,0;3,0;45,0;35,0;4,0;41,0;;10,0;17,0;22,0;15,0;7,0;10,0;2,0;35,0;3,0;28,0;2,0;;39,0;93,0;12,0;37,0;;88,0;1,0;18,0;36,0;8,0;;77,0;1,0;;2,0;32,0;5,0;8,0;8,0;4,0;17,0;13,0;14,0;4,0;2,0;2,0;3,0;4,0;25,0;31,0;17,0;17,0;;34,0;12,0;4,0;50,0;11,0;23,0;;14,0;6,0;60,0;28,0;26,0;3,0;73,0;3,0;;18,0;13,0;21,0;7,0;;3,0;13,0;4,0;;15,0;;20,0;7,0;15,0;5,0;19,0;;4,0;116,0;;20,0;9,0;16,0;11,0;9,0;1,0;13,0;;51,0;2,0;;36,0;2,0;33,0;;23,0;10,0;9,0;8,0;;;11,0;14,0;;;5,0;22,0;;67,0;;73,0;22,0;12,0;53,0;32,0;2,0;18,0;1,0;8,0;1,0;2,0;;;;;8,0;;10,0;;18,0;1,0;6,0;4,0;4,0;155,0;30,0;3,0;7,0;2,0;2,0;;23,0;2,0;;1,0;5,0;3,0;1,0;19,0;11,0;4,0;9,0;9,0;38,0;5,0;1,0;38,0;3,0;;15,0;2,0;6,0;26,0;4,0;19,0;5,0;;10,0;1,0;1,0;1,0;3,0;27,0;26,0;;8,0;;4,0;16,0;6,0;5,0;;1,0;;;9,0;7,0;4,0;;3,0;42,0;8,0;;36,0;;142,0;4,0;;5,0;32,0;8,0;1,0;;8,0;11,0;;11,0;22,0;;;10,0;14,0;9,0;;29,0;4,0;2,0;8,0;;;1,0;50,0;;2,0;;;3,0;2,0;;7,0;2,0;;9,0;16,0;11,0;6,0;6,0;3,0;46,0;143,0;4,0;16,0;1,0;4,0;;53,0;1,0;15,0;11,0;4,0;;5,0;;12,0;;12,0;;13,0;;;1,0;1,0;4,0;11,0;3,0;;36,0;45,0;4,0;;;;13,0;13,0;10,0;2,0;2,0;4,0;;1,0;21,0;107,0;;31,0;5,0;2,0;23,0;26,0;1,0;16,0;;4,0;;15,0;5,0;3,0;5,0;377,0;20,0;51,0;;2,0;30,0;;;1,0;19,0;3,0;38,0;14,0;3,0;8,0;3,0;1,0;3,0;3,0;29,0;6,0;6,0;10,0;;14,0;;4,0;11,0;1,0;;3,0;39,0;4,0;12,0;5,0;35,0;;1,0;2,0;3,0;;;27,0;3,0;;7,0;57,0;;;;8,0;22,0;14,0;3,0;3,0;6,0;;2,0;16,0;;;8,0;3,0;65,0;8,0;4,0;2,0;7,0;4,0;17,0;;1,0;31,0;2,0;;14,0;10,0;;;5,0;;;6,0;5,0;;;4,0;;;;;136,0;;1,0;;37,0;4,0;2,0;12,0;;;17,0;36,0;2,0;;;;4,0;2,0;5,0;3,0;17,0;1,0;2,0;2,0;70,0;;9,0;67,0;49,0;3,0;2,0;1,0;5,0;2,0;2,0;7,0;48,0;2,0;4,0;8,0;;;119,0;3,0;3,0;103,0;1,0;1,0;2,0;13,0;12,0;;11,0;;27,0;;6,0;2,0;;22,0;;;48,0;;33,0;18,0;9,0;;5,0;9,0;;10,0;5,0;44,0;;4,0;5,0;10,0;;;5,0;2,0;;2,0;31,0;;75,0;;;31,0;;;23,0;;1,0;20,0;42,0;8,0;;2,0;11,0;8,0;4,0;5,0;;;9,0;;;;6,0;10,0;;8,0;;2,0;;2,0;;
front;1,0;18,0;1,0;;3,0;31,0;52,0;47,0;55,0;61,0;27,0;;22,0;;33,0;78,0;19,0;;;;;23,0;;29,0;3,0;;9,0;5,0;3,0;;3,0;1,0;80,0;;5,0;3,0;;;;1,0;5,0;1,0;32,0;5,0;20,0;10,0;2,0;114,0;17,0;65,0;136,0;47,0;;4,0;16,0;55,0;66,0;;;;91,0;12,0;36,0;;40,0;30,0;6,0;108,0;45,0;;5,0;22,0;4,0;;;77,0;;8,0;20,0;173,0;18,0;45,0;1,0;168,0;6,0;;;;17,0;22,0;514,0;;;19,0;;;3,0;;28,0;18,0;;;60,0;24,0;39,0;7,0;123,0;2,0;8,0;1,0;18,0;3,0;4,0;;;58,0;334,0;139,0;15,0;4,0;5,0;25,0;;5,0;1,0;;1,0;;1,0;15,0;;4,0;22,0;11,0;3,0;1,0;37,0;1,0;;;22,0;11,0;;81,0;1,0;;19,0;432,0;1,0;6,0;1,0;;2,0;2,0;1,0;2,0;83,0;;3,0;;1,0;5,0;59,0;;2,0;;30,0;60,0;11,0;3,0;4,0;;9,0;30,0;5,0;2,0;150,0;79,0;2,0;;38,0;172,0;8,0;16,0;4,0;41,0;10,0;23,0;4,0;;;;3,0;89,0;1,0;54,0;;;5,0;206,0;16,0;;;59,0;;;;4,0;6,0;267,0;26,0;3,0;3,0;2,0;3,0;;7,0;11,0;8,0;29,0;407,0;5,0;18,0;3,0;2,0;9,0;6,0;8,0;122,0;5,0;169,0;1,0;12,0;145,0;8,0;20,0;27,0;91,0;29,0;31,0;14,0;120,0;10,0;8,0;1,0;;2,0;;30,0;43,0;173,0;;1,0;1,0;;;27,0;9,0;1,0;1,0;;;17,0;7,0;5,0;;37,0;22,0;35,0;4,0;12,0;6,0;38,0;33,0;;15,0;;28,0;97,0;576,0;9,0;;6,0;2,0;1,0;11,0;2,0;13,0;;22,0;171,0;20,0;;5,0;150,0;9,0;2,0;6,0;17,0;3,0;5,0;11,0;79,0;;3,0;1,0;6,0;7,0;76,0;;;77,0;11,0;;15,0;3,0;3,0;82,0;15,0;46,0;6,0;1,0;15,0;12,0;;5,0;29,0;11,0;1,0;2,0;2,0;8,0;4,0;26,0;2,0;;;10,0;9,0;21,0;2,0;6,0;8,0;5,0;2,0;4,0;15,0;23,0;17,0;12,0;3,0;10,0;;10,0;1,0;17,0;15,0;8,0;3,0;;;23,0;2,0;23,0;27,0;5,0;;355,0;6,0;8,0;1,0;;2,0;;4,0;1,0;49,0;4,0;24,0;13,0;7,0;8,0;55,0;2,0;;2,0;19,0;;;78,0;13,0;3,0;;5,0;34,0;14,0;8,0;5,0;42,0;;;;1,0;12,0;;1,0;;4,0;;;6,0;1,0;;2,0;2,0;;6,0;4,0;1,0;;;2,0;5,0;1,0;;;;;;1,0;;9,0;1,0;;13,0;;;3,0;3,0;;17,0;6,0;4,0;3,0;;7,0;;;8,0;;2,0;3,0;2,0;;;8,0;;;13,0;;4,0;;2,0;;;;;;1,0;9,0;;4,0;;;14,0;1,0;;;;10,0;15,0;17,0;;24,0;;;;;;3,0;4,0;2,0;;;;19,0;;1,0;13,0;2,0;15,0;11,0;;10,0;;;2,0;1,0;2,0;1,0;;24,0;;;1,0;;15,0;;3,0;;;;15,0;4,0;1,0;;;8,0;;5,0;;;1,0;6,0;;9,0;1,0;22,0;;4,0;;1,0;;;3,0;5,0;;;3,0;;;5,0;2,0;3,0;;;;1,0;22,0;2,0;;6,0;7,0;;21,0;;;8,0;;;8,0;;14,0;6,0;6,0;;5,0;3,0;;;;7,0;;;3,0;;;;2,0;;;;;12,0;12,0;;;;78,0;;99,0;;;2,0;;3,0;;5,0;;;1,0;4,0;4,0;2,0;1,0;;;;;;;;3,0;;1,0;11,0;27,0;;7,0;;6,0;14,0;;7,0;;;1,0;9,0;;;;;7,0;;;;;23,0;1,0;1,0;4,0;;;4,0;4,0;10,0;;2,0;16,0;22,0;5,0;;;;;19,0;2,0;14,0;;4,0;10,0;15,0;;4,0;;;;4,0;11,0;1,0;2,0;;10,0;2,0;;2,0;;9,0;2,0;9,0;2,0;;7,0;;;10,0;11,0;;8,0;9,0;;3,0;;;8,0;8,0;;1,0;5,0;2,0;3,0;;;13,0;4,0;6,0;4,0;;2,0;;1,0;7,0;2,0;9,0;;4,0;11,0;2,0;4,0;11,0;;;4,0;1,0;9,0;1,0;24,0;26,0;;6,0;1,0;5,0;1,0;2,0;41,0;6,0;;2,0;1,0;;3,0;;;10,0;4,0;;;;3,0;;;;2,0;2,0;1,0;;;3,0;;;;3,0;2,0;2,0;;1,0;;;1,0;1,0;;;;5,0;;;;;;;;;4,0;1,0;;;;;4,0;;4,0;;;;;;;2,0;;;;;;;;;;;2,0;;;;5,0;;;;37,0;;;;73,0;;;1,0;;13,0;1,0;4,0;;;5,0;;10,0;;;;2,0;;;1,0;;;;;;;;;4,0;;;;;;4,0;;;;;2,0;;7,0;;;11,0;1,0;;;1,0;1,0;4,0;2,0;;;3,0;2,0;;;;;1,0;;3,0;1,0;3,0;;;;;9,0;;;2,0;;;;;;1,0;14,0;3,0;;;13,0;2,0;;2,0;2,0;;;;4,0;5,0;;;;;;;5,0;3,0;;;;6,0;;;6,0;;;7,0;1,0;;;2,0;3,0;;;;10,0;;8,0;1,0;2,0;;2,0;1,0;2,0;;11,0;;;4,0;;;;;;;;;;;;;3,0;;1,0;14,0;;;;;;2,0;;4,0;;;;4,0;;;12,0;;;;;;
function;2,0;3,0;8,0;2,0;4,0;23,0;6,0;62,0;40,0;11,0;30,0;1,0;45,0;25,0;14,0;99,0;3,0;5,0;18,0;7,0;21,0;61,0;11,0;4,0;5,0;8,0;27,0;9,0;1,0;5,0;38,0;2,0;76,0;6,0;187,0;23,0;26,0;13,0;12,0;3,0;83,0;9,0;34,0;7,0;44,0;22,0;150,0;219,0;68,0;101,0;5,0;53,0;10,0;;16,0;12,0;24,0;27,0;55,0;2,0;5,0;7,0;13,0;1,0;10,0;20,0;62,0;66,0;47,0;5,0;;1,0;55,0;1,0;19,0;7,0;8,0;4,0;14,0;488,0;6,0;97,0;18,0;193,0;11,0;15,0;3,0;1,0;;9,0;134,0;14,0;15,0;3,0;9,0;10,0;9,0;1,0;209,0;27,0;11,0;2,0;117,0;145,0;27,0;22,0;81,0;8,0;68,0;54,0;;165,0;7,0;2,0;3,0;98,0;33,0;111,0;11,0;80,0;3,0;;13,0;108,0;44,0;16,0;2,0;3,0;5,0;40,0;2,0;45,0;6,0;1,0;26,0;16,0;14,0;69,0;18,0;3,0;26,0;2,0;10,0;36,0;50,0;1,0;;19,0;122,0;10,0;52,0;3,0;9,0;25,0;6,0;6,0;125,0;;14,0;159,0;5,0;17,0;169,0;4,0;18,0;1,0;34,0;27,0;;35,0;92,0;;1,0;1,0;11,0;28,0;4,0;2,0;2,0;;3,0;50,0;1,0;;49,0;30,0;1,0;51,0;;;2,0;3,0;;8,0;1,0;4,0;4,0;;;7,0;;2,0;37,0;30,0;7,0;;11,0;15,0;39,0;26,0;12,0;;2,0;5,0;;;;2,0;1,0;11,0;21,0;11,0;;1,0;1,0;;12,0;;106,0;2,0;30,0;1,0;15,0;11,0;5,0;6,0;6,0;4,0;2,0;;1,0;5,0;;10,0;7,0;;24,0;;101,0;2,0;7,0;;;2,0;;4,0;64,0;10,0;;;;;;68,0;8,0;9,0;11,0;3,0;49,0;;2,0;22,0;19,0;1,0;2,0;1,0;28,0;8,0;2,0;54,0;21,0;6,0;40,0;1,0;;63,0;;22,0;1,0;1,0;25,0;2,0;4,0;;2,0;;62,0;;3,0;;2,0;12,0;1,0;;;1,0;4,0;19,0;2,0;4,0;2,0;6,0;5,0;;2,0;15,0;;11,0;1,0;15,0;;;6,0;;12,0;3,0;;;4,0;;;;2,0;;;11,0;8,0;6,0;11,0;5,0;2,0;;5,0;8,0;6,0;;12,0;3,0;1,0;9,0;;1,0;3,0;4,0;;;5,0;89,0;17,0;13,0;;12,0;;2,0;;;2,0;;;26,0;4,0;3,0;;7,0;4,0;;;1,0;5,0;4,0;;;;2,0;1,0;12,0;;;;17,0;;17,0;17,0;1,0;;22,0;;9,0;7,0;11,0;10,0;2,0;6,0;15,0;;;3,0;;11,0;107,0;38,0;11,0;18,0;2,0;27,0;9,0;5,0;14,0;2,0;4,0;9,0;15,0;16,0;12,0;;5,0;8,0;18,0;8,0;25,0;;49,0;9,0;32,0;27,0;7,0;28,0;17,0;28,0;113,0;4,0;44,0;14,0;;15,0;42,0;89,0;;5,0;8,0;9,0;1,0;3,0;37,0;3,0;39,0;8,0;9,0;;;18,0;5,0;;6,0;1,0;;14,0;4,0;31,0;102,0;20,0;1,0;5,0;17,0;157,0;5,0;13,0;3,0;16,0;4,0;47,0;;4,0;30,0;17,0;3,0;1,0;3,0;6,0;5,0;6,0;4,0;6,0;71,0;11,0;1,0;13,0;3,0;30,0;;1,0;1,0;34,0;17,0;1,0;6,0;2,0;;30,0;;9,0;46,0;2,0;12,0;3,0;13,0;6,0;;2,0;;8,0;58,0;2,0;38,0;;3,0;4,0;;9,0;3,0;;3,0;9,0;4,0;1,0;;17,0;3,0;3,0;2,0;12,0;3,0;1,0;10,0;9,0;10,0;14,0;19,0;;12,0;;;6,0;4,0;1,0;4,0;2,0;;;13,0;;15,0;8,0;6,0;;41,0;3,0;18,0;8,0;3,0;21,0;;1,0;1,0;;30,0;1,0;;1,0;;13,0;3,0;4,0;1,0;10,0;5,0;;2,0;3,0;3,0;2,0;;1,0;;;1,0;3,0;3,0;1,0;2,0;1,0;;;2,0;9,0;23,0;1,0;1,0;;1,0;;2,0;;3,0;2,0;12,0;1,0;;2,0;3,0;4,0;;;9,0;6,0;2,0;33,0;11,0;1,0;;37,0;;;2,0;23,0;6,0;6,0;15,0;2,0;;;4,0;2,0;16,0;4,0;1,0;5,0;;6,0;33,0;1,0;7,0;4,0;;;;12,0;;2,0;;2,0;1,0;2,0;2,0;52,0;4,0;;17,0;;1,0;14,0;;2,0;1,0;3,0;;;;;;;5,0;12,0;;;3,0;;1,0;;11,0;8,0;;;1,0;5,0;;;;10,0;;;;;9,0;;1,0;3,0;18,0;;;;;2,0;2,0;;;;;12,0;;;;1,0;;1,0;;17,0;2,0;1,0;13,0;;;2,0;9,0;4,0;;;8,0;1,0;3,0;3,0;6,0;;17,0;;;3,0;;;2,0;;;;;1,0;1,0;2,0;;5,0;9,0;32,0;;;7,0;15,0;14,0;;3,0;;;;6,0;8,0;14,0;2,0;;1,0;3,0;19,0;41,0;12,0;6,0;3,0;4,0;;3,0;10,0;3,0;60,0;9,0;2,0;29,0;43,0;19,0;;;;;3,0;20,0;20,0;4,0;9,0;18,0;;6,0;;;;1,0;9,0;15,0;;6,0;;2,0;6,0;;;2,0;3,0;;25,0;8,0;24,0;5,0;3,0;47,0;;1,0;;17,0;2,0;2,0;2,0;1,0;;5,0;;;;2,0;1,0;;2,0;;;2,0;;28,0;3,0;17,0;;3,0;3,0;3,0;6,0;1,0;3,0;20,0;;;1,0;1,0;;1,0;;;;;;4,0;1,0;;;2,0;25,0;;6,0;;;;10,0;8,0;1,0;;3,0;21,0;;;12,0;;14,0;4,0;;;11,0;;4,0;2,0;3,0;1,0;1,0;1,0;19,0;;;;;;;;;;4,0;1,0;2,0;;;1,0;;;;1,0;;1,0;;;;5,0;6,0;;;7,0;;;;;;14,0;5,0;;2,0;;2,0;;;;14,0;;;;;;;;;3,0;;;2,0;2,0;;15,0;3,0;2,0;7,0;;;3,0;;1,0;3,0;1,0;10,0;;13,0;;;9,0;1,0;14,0;;;;;;;3,0;;1,0;23,0;;13,0;1,0;;;;;
fundus;2,0;;2,0;;1,0;4,0;3,0;25,0;12,0;18,0;;;2,0;;9,0;25,0;23,0;;2,0;;;71,0;;2,0;;;5,0;10,0;;;;;66,0;10,0;21,0;;2,0;2,0;3,0;;17,0;;1,0;1,0;18,0;32,0;6,0;36,0;3,0;22,0;3,0;4,0;;;11,0;2,0;19,0;;;;;5,0;9,0;;21,0;;70,0;27,0;;22,0;1,0;;9,0;4,0;;;7,0;62,0;88,0;323,0;;43,0;;42,0;5,0;;;;;;62,0;;;2,0;2,0;;;;24,0;;;;21,0;5,0;84,0;1,0;96,0;1,0;11,0;;;26,0;2,0;3,0;;13,0;56,0;53,0;9,0;11,0;1,0;;;21,0;;;6,0;1,0;;25,0;;;3,0;;1,0;;;1,0;;;;;;18,0;1,0;;;3,0;5,0;6,0;10,0;;2,0;6,0;101,0;3,0;72,0;1,0;1,0;4,0;;1,0;160,0;;2,0;;;5,0;38,0;10,0;;2,0;;;15,0;1,0;;;4,0;9,0;;10,0;;;;;;1,0;6,0;;;;;6,0;;1,0;3,0;;;2,0;2,0;;8,0;17,0;;;;;3,0;1,0;1,0;;;;;3,0;;;;2,0;24,0;;;;;;;;234,0;;3,0;;7,0;;;2,0;4,0;;;1,0;2,0;;;41,0;2,0;;;;;8,0;4,0;;;2,0;;;15,0;62,0;;2,0;;;;3,0;;;5,0;;;;;50,0;;;2,0;;6,0;3,0;;4,0;10,0;;;1,0;;;;;;1,0;;2,0;;;;;1,0;;;;;2,0;;;;;;3,0;;;;3,0;;5,0;;;;;1,0;2,0;;3,0;4,0;;19,0;;;;;;;1,0;;;;;;;;;3,0;;1,0;2,0;2,0;3,0;1,0;;;16,0;;;7,0;3,0;;;;11,0;7,0;;;15,0;;;;;;8,0;;41,0;4,0;1,0;;;;;8,0;;;;;;;;;3,0;;;;;;21,0;;;;16,0;;;;;;;;;;;;;;5,0;3,0;;2,0;;;;;;;;;;1,0;3,0;1,0;;;;;;;1,0;2,0;2,0;6,0;;;;47,0;;4,0;;15,0;;;;2,0;;2,0;1,0;14,0;4,0;;;;19,0;6,0;;;;2,0;;;;;;;;;;;;1,0;;;;;;;;4,0;;;1,0;;;;;1,0;;;;;;1,0;;8,0;;6,0;;2,0;;;104,0;;;9,0;;;;1,0;9,0;1,0;;;;;;;;12,0;2,0;2,0;6,0;;;;;;;;;1,0;12,0;;;;;;;;;;;;3,0;;;;3,0;;;;;;;;;;;2,0;2,0;;2,0;1,0;;;4,0;;;;2,0;4,0;;;5,0;;;;;;;;;19,0;2,0;;;2,0;;;;;;;;;;7,0;;6,0;;;;;1,0;;;;;;;;;;;;;;;;;;5,0;;;14,0;;1,0;;;;;;;;2,0;;;;;;;;;;;14,0;;;;;;2,0;;;1,0;;;;;;;1,0;;;;2,0;1,0;12,0;2,0;7,0;2,0;9,0;;;;;;;;4,0;;;;1,0;;;;;;;;;;6,0;;;;;;;;;;;;1,0;;;;;;;;;;;;;;;;;;;;1,0;1,0;2,0;1,0;;;;25,0;;;2,0;;;;;;;;;1,0;;;;;5,0;;;;;;;2,0;;;;;;;1,0;;;;;;;5,0;;;2,0;1,0;3,0;;2,0;;;;;;;1,0;;3,0;;;;;3,0;;;;;3,0;1,0;;;2,0;;;;;;1,0;;;;;;;;;;1,0;;;2,0;;;;;;;;;;4,0;;38,0;;;;;;;14,0;;;;;;10,0;1,0;;;;;;;;;;1,0;;1,0;5,0;;;;4,0;;;;;;;;;;1,0;;;;;;;1,0;3,0;;;;4,0;;;5,0;;1,0;;;;;;;;;;;;;;;;;;;;;;;;18,0;1,0;9,0;;3,0;;;;;;;;;;;;;;;;;;;;;;1,0;;3,0;;;;;;;;13,0;5,0;;;;;;;;;;;2,0;;;;;;;;;;;;;;;;;;;;;;1,0;;;;;;;;;;;;;;
generate;13,0;2,0;1,0;1,0;23,0;36,0;12,0;154,0;91,0;121,0;44,0;;70,0;19,0;34,0;572,0;48,0;15,0;24,0;4,0;62,0;309,0;11,0;15,0;3,0;6,0;166,0;6,0;3,0;2,0;54,0;11,0;753,0;17,0;560,0;94,0;66,0;115,0;9,0;;1426,0;1,0;23,0;128,0;86,0;78,0;113,0;471,0;199,0;304,0;18,0;86,0;22,0;6,0;195,0;37,0;217,0;27,0;75,0;13,0;2,0;22,0;114,0;60,0;81,0;16,0;168,0;35,0;366,0;4,0;55,0;9,0;;234,0;12,0;23,0;33,0;12,0;46,0;4126,0;31,0;299,0;17,0;395,0;6,0;159,0;45,0;;;9,0;195,0;10,0;6,0;3,0;90,0;32,0;40,0;15,0;515,0;44,0;92,0;16,0;125,0;347,0;4,0;108,0;232,0;60,0;466,0;130,0;11,0;144,0;13,0;6,0;5,0;407,0;185,0;159,0;150,0;119,0;5,0;;150,0;303,0;217,0;21,0;3,0;8,0;59,0;94,0;2,0;318,0;40,0;21,0;70,0;87,0;48,0;149,0;85,0;2,0;163,0;27,0;35,0;394,0;47,0;11,0;;17,0;1973,0;12,0;28,0;8,0;40,0;161,0;148,0;69,0;335,0;;22,0;64,0;16,0;78,0;901,0;5,0;11,0;;361,0;117,0;30,0;52,0;57,0;4,0;4,0;9,0;71,0;38,0;14,0;13,0;6,0;11,0;7,0;129,0;;1,0;233,0;245,0;1,0;111,0;6,0;3,0;36,0;8,0;;31,0;;4,0;28,0;13,0;5,0;6,0;1,0;4,0;59,0;111,0;29,0;11,0;32,0;13,0;70,0;55,0;11,0;13,0;220,0;48,0;;13,0;2,0;51,0;6,0;1,0;25,0;31,0;3,0;;1,0;1,0;17,0;2,0;503,0;;101,0;7,0;5,0;14,0;7,0;14,0;36,0;9,0;4,0;1,0;22,0;16,0;3,0;27,0;23,0;51,0;99,0;17,0;407,0;27,0;5,0;3,0;;;3,0;133,0;127,0;30,0;;;;;3,0;105,0;10,0;11,0;24,0;3,0;34,0;2,0;5,0;234,0;35,0;2,0;11,0;14,0;40,0;13,0;12,0;101,0;37,0;27,0;24,0;;1,0;201,0;9,0;15,0;3,0;1,0;81,0;5,0;46,0;;;9,0;14,0;;4,0;;35,0;7,0;7,0;;;;22,0;25,0;2,0;7,0;;9,0;3,0;4,0;5,0;110,0;;3,0;;42,0;;;;7,0;175,0;2,0;;;16,0;;2,0;2,0;2,0;;;48,0;10,0;24,0;14,0;4,0;;;4,0;21,0;5,0;11,0;3,0;28,0;14,0;40,0;;6,0;3,0;128,0;9,0;2,0;7,0;122,0;12,0;3,0;4,0;22,0;4,0;;;;14,0;5,0;;1,0;2,0;10,0;;18,0;3,0;;3,0;2,0;25,0;18,0;;;14,0;1,0;1,0;31,0;;;8,0;13,0;15,0;54,0;40,0;4,0;;21,0;3,0;7,0;24,0;4,0;2,0;6,0;22,0;42,0;;;17,0;7,0;58,0;63,0;126,0;167,0;24,0;42,0;37,0;7,0;;10,0;10,0;4,0;4,0;13,0;39,0;18,0;3,0;35,0;2,0;101,0;28,0;56,0;5,0;111,0;119,0;11,0;62,0;1,0;17,0;16,0;72,0;14,0;55,0;156,0;49,0;22,0;50,0;43,0;101,0;5,0;45,0;32,0;11,0;2,0;;8,0;27,0;57,0;10,0;58,0;;2,0;51,0;5,0;17,0;17,0;3,0;;3,0;17,0;72,0;33,0;18,0;25,0;18,0;31,0;106,0;3,0;112,0;1,0;301,0;;80,0;16,0;39,0;18,0;21,0;45,0;12,0;7,0;9,0;44,0;20,0;43,0;27,0;24,0;22,0;12,0;15,0;22,0;24,0;6,0;9,0;12,0;5,0;63,0;38,0;59,0;21,0;3,0;61,0;6,0;37,0;20,0;;1,0;71,0;1,0;3,0;2,0;4,0;;15,0;16,0;11,0;41,0;;8,0;66,0;1,0;13,0;16,0;5,0;63,0;8,0;7,0;;;67,0;10,0;6,0;2,0;14,0;64,0;4,0;1,0;17,0;10,0;8,0;24,0;;14,0;5,0;;13,0;23,0;38,0;21,0;6,0;2,0;;14,0;1,0;9,0;18,0;50,0;;71,0;1,0;16,0;2,0;10,0;66,0;2,0;19,0;;16,0;7,0;5,0;1,0;17,0;3,0;6,0;1,0;;14,0;74,0;49,0;19,0;1,0;1,0;7,0;24,0;2,0;3,0;3,0;1,0;2,0;1,0;9,0;20,0;13,0;18,0;1,0;23,0;47,0;15,0;29,0;6,0;1,0;5,0;7,0;10,0;18,0;14,0;;2,0;4,0;1,0;9,0;5,0;4,0;6,0;11,0;;10,0;8,0;;101,0;11,0;;29,0;10,0;;2,0;36,0;25,0;14,0;11,0;1,0;4,0;4,0;12,0;25,0;18,0;43,0;27,0;7,0;4,0;;171,0;5,0;124,0;19,0;1,0;1,0;2,0;;14,0;2,0;;;30,0;94,0;4,0;;126,0;;2,0;14,0;;3,0;12,0;1,0;6,0;7,0;2,0;9,0;3,0;5,0;;;;;19,0;;;6,0;14,0;39,0;8,0;1,0;2,0;2,0;;;16,0;2,0;3,0;19,0;5,0;;;;7,0;12,0;5,0;3,0;7,0;18,0;1,0;;;1,0;1,0;6,0;;1,0;42,0;;2,0;1,0;1,0;16,0;;1,0;36,0;32,0;4,0;30,0;;18,0;14,0;45,0;2,0;1,0;32,0;4,0;15,0;7,0;;2,0;21,0;;1,0;2,0;;;2,0;9,0;2,0;;6,0;10,0;2,0;;;9,0;10,0;;8,0;55,0;21,0;4,0;14,0;38,0;6,0;3,0;6,0;19,0;;4,0;3,0;12,0;45,0;34,0;7,0;17,0;2,0;3,0;44,0;5,0;10,0;13,0;10,0;3,0;1,0;9,0;11,0;13,0;31,0;66,0;15,0;14,0;40,0;7,0;21,0;;;39,0;30,0;27,0;16,0;4,0;26,0;2,0;12,0;7,0;5,0;3,0;51,0;18,0;14,0;49,0;;18,0;;8,0;25,0;;2,0;8,0;38,0;10,0;8,0;20,0;21,0;8,0;2,0;5,0;10,0;;;38,0;5,0;16,0;4,0;25,0;;2,0;7,0;4,0;;24,0;1,0;8,0;6,0;18,0;14,0;5,0;;20,0;;1,0;15,0;18,0;17,0;;2,0;;35,0;;1,0;8,0;1,0;;;77,0;4,0;;4,0;;4,0;2,0;4,0;;2,0;;2,0;1,0;;;;;;;3,0;10,0;4,0;23,0;8,0;3,0;1,0;24,0;17,0;;5,0;1,0;11,0;6,0;13,0;3,0;1,0;;4,0;3,0;65,0;;17,0;1,0;5,0;2,0;2,0;3,0;;3,0;31,0;15,0;20,0;4,0;13,0;8,0;;2,0;8,0;28,0;;2,0;4,0;15,0;1,0;;11,0;10,0;22,0;10,0;132,0;;3,0;2,0;2,0;16,0;3,0;3,0;;1,0;32,0;;12,0;122,0;14,0;;;26,0;1,0;7,0;;;1,0;14,0;;;14,0;9,0;;1,0;6,0;7,0;6,0;3,0;2,0;11,0;;2,0;20,0;1,0;3,0;3,0;9,0;36,0;6,0;5,0;4,0;31,0;;55,0;;14,0;6,0;28,0;7,0;;4,0;8,0;;2,0;6,0;;;;9,0;
generation;1,0;;;;;2,0;;13,0;4,0;1,0;3,0;;;;;17,0;;;1,0;;5,0;7,0;;;;;27,0;;;;2,0;;76,0;;26,0;1,0;4,0;;;;45,0;;1,0;8,0;1,0;1,0;6,0;104,0;6,0;12,0;2,0;19,0;3,0;2,0;;;1,0;;7,0;;;1,0;11,0;1,0;2,0;;;;20,0;;1,0;4,0;234,0;;;6,0;;;;214,0;3,0;17,0;6,0;31,0;1,0;17,0;2,0;3,0;;;9,0;;1,0;;2,0;;2,0;;23,0;;;;8,0;14,0;;14,0;66,0;4,0;4,0;1,0;;4,0;7,0;;;9,0;19,0;8,0;;2,0;4,0;;6,0;9,0;6,0;2,0;;;;1,0;1,0;64,0;2,0;;;22,0;;14,0;;;3,0;;;5,0;3,0;1,0;;2,0;103,0;1,0;3,0;1,0;6,0;3,0;2,0;15,0;26,0;;1,0;3,0;1,0;;285,0;;;;14,0;12,0;;;;;;1,0;1,0;3,0;;;;;;5,0;;;16,0;36,0;;2,0;;;4,0;28,0;;1,0;;;;;;;;;3,0;;;;;;1,0;;;;;10,0;;;;1,0;;;;;;;;;;;25,0;;;;;1,0;;1,0;;2,0;;;;;;;5,0;;;;33,0;;;;;;;69,0;12,0;8,0;;;;;;1,0;;;;;3,0;2,0;;23,0;1,0;;;;27,0;;;5,0;;17,0;3,0;;;43,0;;;;;19,0;2,0;;;;2,0;;;;;;4,0;;;;;;;;2,0;;;;;;;;;;3,0;;;;;5,0;;;;;;;;;;;5,0;1,0;5,0;1,0;1,0;;;;2,0;;;;;;18,0;;;;;;;;5,0;;;;6,0;;;;;17,0;;;;;2,0;;;;;;;;1,0;;;;;;3,0;;;;;1,0;3,0;2,0;;;8,0;;;;;;;;1,0;;;;;1,0;6,0;13,0;3,0;;1,0;1,0;1,0;;1,0;1,0;;;;;3,0;;1,0;;4,0;;;;3,0;1,0;;;;1,0;;6,0;;2,0;;1,0;;;;5,0;2,0;1,0;9,0;3,0;;;;;5,0;;;;1,0;;;;1,0;;;;;;6,0;;;;3,0;;;;;21,0;;6,0;;;;1,0;;;;1,0;;1,0;;;2,0;;;;;;;4,0;;;2,0;9,0;;10,0;;2,0;;;;;;3,0;;;;;;2,0;;;;;;1,0;;;1,0;;;;1,0;;;;;;;;;;;;;;;;;;;;;15,0;1,0;2,0;;;2,0;;;;18,0;;2,0;;1,0;;;;;;;4,0;3,0;;;;;;;;;;;;;;;;;;;5,0;;;;;10,0;;;1,0;;;;3,0;;;;;;;;;;;2,0;;;;;;;;;2,0;1,0;;;;;;2,0;;;;;;;3,0;2,0;1,0;;;2,0;;;3,0;;33,0;;1,0;;;;;;;;;29,0;;;4,0;;;1,0;;;;;;;;;;;;;;;;;;4,0;15,0;4,0;;;;;;;;;;3,0;;;;;;;;;;;;;;;;;;;;;;;;;;;1,0;;;8,0;;;2,0;;;;13,0;;1,0;;;;;;;4,0;;;;;;;2,0;;;;;1,0;;;;;;2,0;8,0;;2,0;4,0;;;;;;;19,0;1,0;;6,0;;;10,0;;1,0;;;;;5,0;;;;;1,0;;;;3,0;;;;11,0;;3,0;;1,0;2,0;1,0;;;;3,0;;;;;;;;;;8,0;;1,0;;1,0;;3,0;;;;1,0;;;;;;;;;;;;;;;;;;;7,0;;;;;;;;;1,0;;;;;;;;;;;;;;;;;;;;;;;1,0;;;;;2,0;;;;;;;;;;;;;;;;;;;;;;;;;;;;;;;;;;;;;;;1,0;;;;;;;1,0;;;;4,0;;2,0;2,0;;;;;;;;;;39,0;1,0;;;10,0;;;;;;6,0;;;1,0;;;;;;;1,0;;;;;;;;;;2,0;;3,0;1,0;;;;;;1,0;12,0;;;;;;;;;;;1,0;
geometric;4,0;;6,0;;;5,0;;1,0;29,0;7,0;4,0;;2,0;;;16,0;;;;;17,0;2,0;;;;;4,0;4,0;1,0;2,0;;;7,0;;;;8,0;15,0;;;3,0;;9,0;1,0;3,0;5,0;16,0;2,0;1,0;5,0;;11,0;47,0;7,0;;1,0;4,0;2,0;6,0;;;;3,0;;7,0;;4,0;3,0;;;19,0;;12,0;;;3,0;;;;66,0;;;;22,0;;;;;7,0;2,0;6,0;;;2,0;1,0;;;;19,0;;49,0;;2,0;15,0;;;5,0;1,0;2,0;61,0;;19,0;;;;5,0;3,0;16,0;;1,0;;;3,0;2,0;4,0;;;3,0;;2,0;;3,0;4,0;2,0;11,0;1,0;2,0;4,0;;;5,0;;;4,0;2,0;;;;;10,0;2,0;;1,0;6,0;;;17,0;;3,0;;;;6,0;;1,0;;2,0;12,0;;;1,0;;;1,0;2,0;5,0;;;;;;3,0;;;;1,0;;;;;;;;;;;3,0;;;;;1,0;2,0;1,0;;;;;;;;3,0;;;;;;;;;;;;1,0;;;;;3,0;;;;2,0;;;;;;;;2,0;;;3,0;;;;14,0;9,0;;1,0;;;;;;;;;;;;;;;;25,0;;;;;;32,0;;;;;1,0;1,0;6,0;;;;;;3,0;;10,0;;;5,0;;;;;;;;;;;1,0;;;2,0;;;;;;;;;;;;;;;;;;;;;;;;;;3,0;;;;;;2,0;;1,0;;;;1,0;;;;9,0;;;24,0;;;;;;;;9,0;;;;4,0;;;;;;;;;6,0;;;;;;;;;;;;;;;2,0;;;;;2,0;2,0;;;6,0;;;;6,0;;;;;;;;;;1,0;16,0;;1,0;2,0;;;;;;;;;;;;;;;11,0;;;;8,0;;;9,0;;10,0;2,0;;;3,0;;;;1,0;;3,0;;;;;1,0;;;1,0;;;3,0;;;;;;;;;;;;;;;;3,0;3,0;;;;;;1,0;3,0;;3,0;1,0;;;;;;;;;;1,0;;;;1,0;;;2,0;;;1,0;;4,0;;;;8,0;20,0;;;;;;;;;2,0;;;;;;;;;;;;1,0;;;;;;;5,0;;;;;;4,0;;;;;;;1,0;2,0;;1,0;;;;;;;;5,0;;;;;;1,0;;;;;;;;;;;;;;;;1,0;1,0;;;;1,0;;;6,0;;;;;4,0;;;;;;;18,0;;;;;;;1,0;;;;;;;;;;;;3,0;;3,0;;;;;;;;;;;;;;;;1,0;;;;;;6,0;;;;;;;;;;;;;;;;;;;;;;;;;;;;;;;;;;2,0;;;;;;;;;1,0;;;;;8,0;;;;;2,0;;1,0;;;;;;;;;2,0;;;;1,0;;;;;1,0;;;;;;;3,0;;;;8,0;;;;;;;;5,0;;;;;;;;;;;;;;;;;;;;;;;;;;;;;;;;;;;;;4,0;;;;;;;;3,0;;;;;;38,0;;;;;;;;;2,0;;2,0;;;1,0;;;;;1,0;;;;;;1,0;;;;;;;;2,0;;;;;;;;;;;3,0;;;;;;;;;;;1,0;2,0;;;1,0;;;;;;;1,0;3,0;;;;1,0;;;4,0;;;;;;;;;;;;;;;;1,0;;;;;;3,0;1,0;;;;;;;;;;6,0;;;;1,0;;37,0;;;;;;3,0;;;;;;;;;3,0;;;;;;;;;;;;;;1,0;;;;;;;;;;;;;;;;;;;;;;;;;;;;;5,0;;;;;;;;;;;;;;;;;1,0;;;;;;2,0;;;;;;;;;;;;;;
group;1,0;2,0;;;7,0;42,0;122,0;49,0;9,0;101,0;13,0;22,0;59,0;3,0;95,0;71,0;2,0;4,0;22,0;;31,0;34,0;8,0;3,0;1,0;52,0;85,0;26,0;;;12,0;47,0;133,0;5,0;46,0;13,0;24,0;14,0;5,0;;199,0;23,0;51,0;10,0;52,0;12,0;65,0;146,0;29,0;37,0;91,0;23,0;5,0;11,0;53,0;6,0;191,0;;17,0;1,0;12,0;4,0;21,0;8,0;54,0;127,0;102,0;80,0;42,0;77,0;7,0;;23,0;6,0;3,0;;29,0;;3,0;513,0;12,0;92,0;4,0;450,0;29,0;12,0;1,0;;;121,0;2400,0;;;33,0;9,0;14,0;19,0;9,0;72,0;6,0;2,0;3,0;66,0;289,0;;2,0;225,0;93,0;53,0;47,0;15,0;44,0;;;11,0;350,0;56,0;155,0;345,0;21,0;1,0;1,0;31,0;23,0;7,0;9,0;;26,0;4,0;24,0;3,0;12,0;19,0;3,0;31,0;3,0;13,0;16,0;6,0;32,0;12,0;1,0;;166,0;27,0;;;270,0;117,0;12,0;31,0;;13,0;71,0;11,0;4,0;179,0;4,0;4,0;44,0;14,0;17,0;132,0;6,0;22,0;;33,0;28,0;8,0;1,0;118,0;1,0;1,0;27,0;24,0;14,0;45,0;37,0;16,0;10,0;3,0;12,0;10,0;2,0;2,0;29,0;;18,0;7,0;17,0;7,0;13,0;2,0;22,0;6,0;15,0;25,0;;;6,0;2,0;1,0;8,0;50,0;4,0;26,0;;7,0;42,0;21,0;2,0;;13,0;;3,0;6,0;11,0;1,0;;6,0;21,0;8,0;4,0;;;;13,0;;106,0;;96,0;40,0;3,0;21,0;31,0;144,0;27,0;9,0;1,0;5,0;6,0;4,0;;7,0;4,0;1,0;52,0;1,0;549,0;26,0;9,0;1,0;;1,0;;11,0;47,0;5,0;;180,0;;5,0;;442,0;1,0;;13,0;17,0;17,0;5,0;;27,0;28,0;;;9,0;3,0;42,0;7,0;121,0;32,0;11,0;6,0;9,0;;57,0;7,0;1,0;;7,0;9,0;13,0;;7,0;21,0;;1,0;;71,0;;33,0;5,0;7,0;;3,0;1,0;2,0;31,0;2,0;;2,0;17,0;;1,0;17,0;7,0;;2,0;3,0;6,0;41,0;;;;42,0;;5,0;;;1,0;4,0;3,0;1,0;;;5,0;;3,0;;2,0;4,0;;4,0;1,0;;19,0;;6,0;31,0;27,0;4,0;4,0;;5,0;18,0;1,0;;104,0;4,0;1,0;6,0;4,0;;2,0;7,0;;1,0;68,0;;19,0;11,0;;;5,0;;;23,0;;12,0;8,0;4,0;;41,0;2,0;1,0;17,0;;;;23,0;;14,0;3,0;;;1,0;2,0;;;3,0;;;2,0;1,0;;;1,0;;10,0;21,0;12,0;31,0;10,0;21,0;8,0;3,0;1,0;;1,0;;1,0;1,0;42,0;1,0;4,0;2,0;;101,0;1,0;1,0;;14,0;10,0;6,0;41,0;2,0;63,0;13,0;48,0;1,0;;63,0;12,0;;14,0;25,0;25,0;2,0;1,0;21,0;16,0;1,0;;2,0;;20,0;14,0;3,0;1,0;;25,0;6,0;;6,0;;;;;9,0;41,0;1,0;2,0;1,0;;23,0;1,0;53,0;11,0;7,0;;49,0;5,0;1,0;6,0;6,0;2,0;1,0;4,0;2,0;1,0;;2,0;6,0;2,0;;;;17,0;17,0;4,0;15,0;;2,0;55,0;46,0;1,0;;;19,0;;1,0;7,0;;3,0;4,0;;;;;;2,0;;;64,0;;4,0;14,0;2,0;2,0;4,0;1,0;1,0;20,0;3,0;4,0;5,0;22,0;1,0;;59,0;;18,0;;2,0;14,0;7,0;16,0;4,0;46,0;7,0;;;4,0;1,0;2,0;6,0;;4,0;;3,0;;3,0;53,0;46,0;1,0;1,0;;8,0;2,0;14,0;13,0;;2,0;;;1,0;5,0;1,0;;7,0;;;6,0;2,0;33,0;2,0;;11,0;2,0;;2,0;;;2,0;;;;1,0;8,0;1,0;39,0;;65,0;4,0;5,0;19,0;2,0;1,0;20,0;1,0;1,0;14,0;4,0;;;;;2,0;;15,0;10,0;;;4,0;12,0;;25,0;54,0;;2,0;16,0;;3,0;14,0;1,0;;36,0;4,0;;;2,0;;1,0;11,0;1,0;;2,0;;;3,0;;1,0;;2,0;;;6,0;1,0;;;;;5,0;354,0;47,0;13,0;3,0;10,0;;25,0;1,0;;;;1,0;;;;1,0;2,0;;;7,0;;2,0;14,0;;8,0;2,0;9,0;;2,0;;;;1,0;3,0;;2,0;;;;4,0;3,0;3,0;;8,0;;;3,0;;;1,0;3,0;;;;1,0;39,0;;1,0;;;;120,0;29,0;;27,0;2,0;4,0;;3,0;1,0;2,0;2,0;2,0;;2,0;;3,0;3,0;;3,0;6,0;;;;12,0;3,0;;;;2,0;3,0;3,0;1,0;;;31,0;2,0;18,0;;2,0;6,0;38,0;1,0;8,0;26,0;2,0;;5,0;2,0;3,0;12,0;9,0;2,0;1,0;17,0;18,0;14,0;;;1,0;;;3,0;4,0;;;17,0;;13,0;;;;1,0;1,0;;2,0;;8,0;;;1,0;;;;;4,0;13,0;8,0;;;10,0;;2,0;;;7,0;;;1,0;13,0;5,0;;2,0;2,0;;2,0;;;1,0;7,0;2,0;4,0;1,0;;1,0;4,0;;;6,0;;;1,0;;;4,0;6,0;6,0;;;;7,0;1,0;;1,0;7,0;4,0;9,0;2,0;3,0;3,0;;15,0;1,0;6,0;;;1,0;;;;;2,0;;;;1,0;7,0;1,0;1,0;;2,0;1,0;;;2,0;1,0;;;2,0;;28,0;1,0;;;1,0;2,0;6,0;1,0;;;11,0;16,0;13,0;4,0;;5,0;;1,0;;;;7,0;;3,0;;12,0;7,0;2,0;;2,0;9,0;;3,0;;;1,0;8,0;;9,0;4,0;;2,0;;;9,0;;;11,0;2,0;66,0;;;;;;2,0;6,0;4,0;;;1,0;1,0;;2,0;10,0;29,0;4,0;;3,0;2,0;6,0;2,0;2,0;20,0;;;4,0;;;;;1,0;;4,0;;;7,0;1,0;39,0;3,0;;;;1,0;;;4,0;23,0;;;;1,0;;;;;4,0
identify;1,0;7,0;1,0;;28,0;48,0;;51,0;140,0;5,0;3,0;;93,0;2,0;5,0;177,0;;;19,0;3,0;20,0;116,0;;1,0;6,0;10,0;59,0;12,0;;4,0;42,0;2,0;129,0;2,0;62,0;7,0;;8,0;8,0;;164,0;;18,0;8,0;19,0;35,0;87,0;221,0;111,0;31,0;;7,0;6,0;1,0;1,0;75,0;11,0;11,0;16,0;1,0;;12,0;42,0;11,0;14,0;13,0;24,0;2,0;127,0;;8,0;7,0;33,0;;;29,0;;5,0;12,0;908,0;10,0;8,0;6,0;142,0;;47,0;5,0;;;2,0;23,0;1,0;10,0;1,0;;12,0;22,0;5,0;206,0;15,0;17,0;7,0;38,0;313,0;2,0;14,0;30,0;3,0;25,0;18,0;;20,0;;;;200,0;82,0;125,0;3,0;25,0;3,0;;32,0;48,0;54,0;27,0;17,0;2,0;2,0;18,0;;43,0;15,0;1,0;5,0;6,0;39,0;16,0;1,0;4,0;81,0;3,0;2,0;30,0;18,0;;;;65,0;34,0;40,0;;27,0;47,0;27,0;4,0;107,0;;3,0;1,0;4,0;17,0;84,0;1,0;2,0;;123,0;82,0;3,0;;13,0;;;;5,0;9,0;6,0;;;;;13,0;;;;7,0;;9,0;;;1,0;;;8,0;;7,0;70,0;;;;;;22,0;12,0;4,0;;;;6,0;40,0;4,0;3,0;;9,0;;;;;2,0;18,0;;;;;2,0;3,0;;;46,0;4,0;3,0;;;;;9,0;14,0;1,0;;;6,0;12,0;;7,0;1,0;;;9,0;74,0;9,0;;1,0;;;;;69,0;1,0;2,0;;;;;52,0;;2,0;4,0;;;;;52,0;29,0;;;;9,0;5,0;;15,0;2,0;3,0;12,0;;;48,0;;4,0;;;36,0;8,0;;;;10,0;6,0;;;;1,0;1,0;;;;;;8,0;;1,0;;;;;6,0;8,0;;1,0;;5,0;;;;;2,0;;;;3,0;3,0;;5,0;;;;8,0;7,0;;5,0;;;;;6,0;2,0;;;4,0;6,0;21,0;1,0;;1,0;2,0;;;8,0;178,0;2,0;1,0;2,0;2,0;;;;;;3,0;;4,0;3,0;;;8,0;1,0;;;;3,0;5,0;;;32,0;;;;;;;3,0;;236,0;8,0;2,0;;3,0;;;17,0;12,0;25,0;8,0;46,0;1,0;1,0;3,0;;;4,0;7,0;22,0;28,0;18,0;2,0;23,0;;;;;8,0;;3,0;2,0;1,0;6,0;2,0;;179,0;4,0;1,0;1,0;96,0;9,0;5,0;160,0;2,0;66,0;18,0;30,0;;3,0;62,0;19,0;4,0;21,0;7,0;20,0;;24,0;1,0;8,0;11,0;;1,0;7,0;41,0;6,0;6,0;25,0;1,0;1,0;;;1,0;;;;;18,0;45,0;;;3,0;;69,0;6,0;35,0;1,0;;4,0;7,0;2,0;21,0;6,0;31,0;1,0;3,0;5,0;;4,0;1,0;3,0;60,0;27,0;;3,0;1,0;4,0;10,0;5,0;2,0;;;19,0;2,0;;8,0;;;1,0;;6,0;13,0;4,0;44,0;;3,0;;;;2,0;;;11,0;3,0;20,0;2,0;;19,0;7,0;14,0;1,0;4,0;1,0;2,0;11,0;11,0;20,0;3,0;14,0;;;;3,0;;5,0;2,0;25,0;;12,0;7,0;;2,0;34,0;;10,0;3,0;;;;8,0;;2,0;44,0;;38,0;13,0;36,0;2,0;3,0;1,0;9,0;1,0;;;;1,0;;;;;;12,0;;8,0;8,0;3,0;1,0;;;92,0;40,0;;;5,0;;;22,0;;1,0;24,0;3,0;55,0;16,0;;15,0;8,0;;4,0;7,0;;82,0;;;;4,0;;14,0;1,0;2,0;;3,0;4,0;31,0;26,0;;71,0;11,0;;7,0;;;1,0;;15,0;1,0;9,0;;4,0;;2,0;2,0;12,0;2,0;15,0;;;;18,0;;;18,0;1,0;;;;3,0;;;;;4,0;5,0;4,0;2,0;18,0;;;;;2,0;;;;;;;;;;;1,0;11,0;;;10,0;;14,0;;;1,0;17,0;;;;1,0;;6,0;;;;;6,0;7,0;;;12,0;;;;2,0;;;1,0;;;;;;;;;;6,0;15,0;;;;;1,0;6,0;7,0;2,0;4,0;2,0;3,0;4,0;2,0;2,0;2,0;3,0;;2,0;2,0;;;;;;5,0;;;3,0;;;;;;17,0;;;;;;13,0;3,0;37,0;2,0;;9,0;;;12,0;34,0;;;;3,0;5,0;60,0;6,0;;;;;2,0;8,0;3,0;1,0;29,0;2,0;10,0;;;1,0;;;;;1,0;1,0;7,0;;;2,0;2,0;1,0;;1,0;7,0;10,0;;;7,0;;;3,0;;;;;18,0;1,0;8,0;;;;;10,0;4,0;;3,0;7,0;;4,0;3,0;;;;8,0;;4,0;3,0;;4,0;6,0;1,0;;;;7,0;;6,0;1,0;;;;;34,0;4,0;2,0;9,0;;;3,0;7,0;2,0;1,0;;;2,0;1,0;;;;;;;5,0;;;;10,0;9,0;;2,0;;3,0;2,0;1,0;;50,0;;;;;;3,0;;3,0;2,0;4,0;2,0;22,0;27,0;;;;;;2,0;;;;;2,0;2,0;;1,0;;5,0;;1,0;22,0;;15,0;;2,0;;;15,0;;;;;;1,0;;7,0;4,0;;;;;2,0;;2,0;;;;;2,0;;11,0;;;2,0;;;;8,0;;5,0;2,0;2,0;;10,0;;;14,0;;6,0;;;;;;1,0;;;12,0;20,0;2,0;;2,0;5,0;2,0;1,0;;4,0;7,0;;;1,0;;;;;;
illuminate;3,0;;2,0;4,0;3,0;21,0;16,0;21,0;65,0;15,0;11,0;;15,0;;18,0;19,0;102,0;1,0;6,0;;10,0;35,0;;;4,0;;16,0;;;;;;86,0;;40,0;6,0;2,0;;4,0;;11,0;;5,0;7,0;10,0;12,0;12,0;62,0;14,0;21,0;10,0;22,0;1,0;;;8,0;25,0;2,0;;;4,0;3,0;55,0;;2,0;2,0;7,0;19,0;2,0;8,0;4,0;62,0;12,0;;;;5,0;;193,0;159,0;1,0;41,0;;43,0;;1,0;;;;1,0;26,0;;;5,0;3,0;4,0;2,0;;60,0;;;2,0;10,0;113,0;1,0;19,0;95,0;2,0;11,0;;1,0;11,0;;;;39,0;49,0;17,0;4,0;5,0;;1,0;4,0;3,0;3,0;3,0;;3,0;19,0;6,0;;30,0;6,0;;4,0;;4,0;17,0;1,0;;104,0;;;30,0;1,0;1,0;;44,0;8,0;2,0;1,0;;3,0;;151,0;;123,0;;7,0;;1,0;7,0;96,0;;8,0;;5,0;55,0;30,0;13,0;1,0;;;1,0;10,0;2,0;3,0;;;2,0;;3,0;1,0;1,0;;;;13,0;;;;;;1,0;;1,0;;;;1,0;;;;9,0;;;;;6,0;16,0;;;;;;;;2,0;8,0;3,0;4,0;;;;;2,0;16,0;;555,0;2,0;2,0;;19,0;;;3,0;;;1,0;5,0;2,0;3,0;10,0;13,0;4,0;;;1,0;9,0;9,0;3,0;;;;1,0;11,0;20,0;34,0;1,0;1,0;;;;5,0;;;2,0;;1,0;;;167,0;1,0;;1,0;;1,0;5,0;23,0;39,0;2,0;1,0;;2,0;;20,0;3,0;;6,0;1,0;8,0;;;;22,0;1,0;;;;;1,0;1,0;2,0;;;;1,0;;;;6,0;1,0;;;4,0;;;;1,0;8,0;;;;;1,0;;;;;4,0;;;;;;3,0;;8,0;1,0;;;4,0;2,0;2,0;1,0;;;3,0;6,0;10,0;;3,0;3,0;;;1,0;;16,0;2,0;;;26,0;;;;;;;3,0;6,0;1,0;;;;;;2,0;;2,0;;;;;;;1,0;;;;2,0;4,0;33,0;14,0;2,0;;1,0;;8,0;;5,0;;;;2,0;;;2,0;3,0;;5,0;1,0;4,0;1,0;1,0;;;2,0;2,0;9,0;;;1,0;5,0;;;;;3,0;;;;3,0;6,0;4,0;6,0;;;10,0;20,0;;4,0;5,0;4,0;;;3,0;6,0;;1,0;5,0;20,0;;2,0;;2,0;5,0;1,0;;;;3,0;1,0;;2,0;;;;;1,0;1,0;;2,0;;;11,0;;;;;2,0;;2,0;1,0;8,0;;;;;2,0;2,0;;19,0;;3,0;;1,0;2,0;3,0;4,0;;1,0;;;36,0;7,0;;1,0;;3,0;;;6,0;;;;;;;;;1,0;10,0;1,0;;;;;;;;;;;;;;3,0;1,0;;;;;;;;2,0;1,0;;;;;;;3,0;;4,0;;4,0;;;7,0;4,0;1,0;1,0;;1,0;;2,0;;3,0;6,0;;17,0;;;1,0;4,0;;;1,0;1,0;;;1,0;62,0;;;1,0;1,0;;;;;1,0;1,0;;;;3,0;;3,0;;3,0;;19,0;7,0;1,0;;;;;1,0;;;;;;;;;;;;;;;29,0;;;;1,0;;;;;;;1,0;;;;;5,0;;5,0;;;;;;;2,0;;;1,0;;;;2,0;;3,0;;5,0;;;;;;;2,0;4,0;6,0;34,0;4,0;;;;;2,0;;;2,0;;;;;;;;;;;;;;2,0;;;3,0;;;;1,0;;;;5,0;2,0;;;;3,0;;3,0;;;;;;;;;;;;;5,0;;;;5,0;;;21,0;87,0;;3,0;2,0;;;;;8,0;1,0;;;;;7,0;;;15,0;;;;;;;2,0;;;;;;;;;;;;;;1,0;;;;;;;2,0;;3,0;;10,0;1,0;2,0;21,0;;;1,0;;;3,0;3,0;;;;;;2,0;;;;;;;1,0;;;1,0;2,0;;;;;;;;;;;;1,0;6,0;;;6,0;;;;46,0;23,0;;5,0;1,0;2,0;;;;;;;;4,0;;;;;;;;;2,0;13,0;;;;2,0;8,0;;;;;;1,0;;;6,0;;;;14,0;;;9,0;;;;;;;23,0;;;;;;5,0;;3,0;;1,0;1,0;;19,0;;;;8,0;1,0;;;1,0;;;;;;;;;;3,0;;15,0;2,0;;2,0;;;;;;;;;;;;;5,0;;;;;;;;;;;3,0;;2,0;;;;;;;;26,0;2,0;;4,0;;;;;;;;1,0;;;;;;;;;;;;;;;;1,0;;;;;;;;;;;;;;;;;;2,0;;;1,0
illumination;1,0;;5,0;3,0;5,0;11,0;29,0;116,0;88,0;45,0;18,0;;26,0;;22,0;49,0;46,0;2,0;2,0;2,0;1,0;72,0;14,0;3,0;5,0;1,0;114,0;2,0;2,0;;5,0;20,0;91,0;1,0;106,0;6,0;1,0;1,0;2,0;;34,0;7,0;21,0;21,0;59,0;12,0;82,0;205,0;17,0;54,0;21,0;10,0;7,0;;3,0;17,0;90,0;2,0;6,0;1,0;4,0;18,0;78,0;2,0;8,0;2,0;18,0;28,0;32,0;20,0;14,0;88,0;46,0;;;3,0;12,0;193,0;;304,0;2,0;78,0;2,0;142,0;28,0;10,0;;;1,0;3,0;48,0;;;2,0;1,0;3,0;5,0;;97,0;5,0;;11,0;37,0;83,0;9,0;37,0;236,0;1,0;47,0;6,0;10,0;17,0;6,0;1,0;;114,0;58,0;20,0;76,0;15,0;2,0;2,0;;6,0;14,0;2,0;;5,0;13,0;17,0;;45,0;8,0;12,0;4,0;1,0;65,0;18,0;;;46,0;3,0;;122,0;20,0;1,0;;33,0;40,0;4,0;8,0;;4,0;7,0;71,0;5,0;387,0;;2,0;1,0;3,0;17,0;193,0;1,0;7,0;;15,0;17,0;19,0;31,0;4,0;;;7,0;26,0;7,0;56,0;;4,0;6,0;7,0;11,0;;1,0;;9,0;;123,0;19,0;;;;;6,0;5,0;1,0;;;1,0;21,0;;1,0;10,0;28,0;;;;;22,0;13,0;3,0;1,0;;1,0;2,0;1,0;;3,0;;;48,0;3,0;;2,0;;2,0;;;604,0;;12,0;;11,0;11,0;2,0;;4,0;7,0;2,0;6,0;7,0;;3,0;55,0;7,0;;3,0;3,0;28,0;28,0;2,0;;;;;18,0;43,0;59,0;3,0;;;;7,0;33,0;15,0;;27,0;;3,0;;;408,0;;;4,0;;9,0;11,0;3,0;33,0;5,0;;1,0;1,0;;42,0;8,0;3,0;;2,0;7,0;1,0;;;4,0;3,0;19,0;;;;2,0;13,0;3,0;6,0;;;;6,0;;3,0;5,0;22,0;2,0;;7,0;2,0;1,0;5,0;;8,0;;4,0;5,0;;7,0;14,0;;;1,0;;;1,0;;;;6,0;;9,0;;;;3,0;7,0;13,0;3,0;;;;6,0;163,0;2,0;;47,0;7,0;;;1,0;2,0;8,0;;10,0;34,0;;1,0;;;;1,0;3,0;21,0;;;1,0;4,0;;;3,0;;1,0;4,0;;;1,0;;;1,0;2,0;;;;1,0;69,0;10,0;1,0;1,0;12,0;2,0;4,0;9,0;1,0;;;;11,0;;;4,0;2,0;1,0;1,0;70,0;17,0;4,0;;7,0;6,0;4,0;5,0;4,0;2,0;;6,0;13,0;5,0;1,0;;1,0;7,0;;3,0;;8,0;44,0;6,0;9,0;;2,0;9,0;7,0;2,0;1,0;6,0;7,0;;;14,0;12,0;2,0;1,0;9,0;15,0;;;;4,0;13,0;2,0;;;;11,0;;;1,0;2,0;;;;10,0;22,0;;3,0;1,0;;3,0;4,0;;;;5,0;6,0;2,0;1,0;2,0;;1,0;1,0;;;38,0;1,0;24,0;1,0;3,0;11,0;;2,0;1,0;1,0;2,0;8,0;;3,0;97,0;1,0;;11,0;;6,0;;10,0;4,0;;;;1,0;;;;3,0;53,0;11,0;;6,0;;;;1,0;;;;;5,0;2,0;;;4,0;2,0;5,0;3,0;1,0;;;2,0;;26,0;58,0;;1,0;5,0;1,0;;1,0;1,0;;5,0;4,0;8,0;;2,0;11,0;5,0;1,0;10,0;;3,0;;8,0;;1,0;;2,0;34,0;;;;2,0;;;;1,0;3,0;;1,0;91,0;1,0;;1,0;;;;;;;;;;;;;6,0;1,0;1,0;;44,0;3,0;;;;;;;;1,0;2,0;1,0;7,0;;;2,0;;;;;;;33,0;;5,0;4,0;;;;11,0;;;;4,0;2,0;;7,0;32,0;1,0;6,0;1,0;;;;3,0;;1,0;;;;5,0;;1,0;;;;6,0;;1,0;1,0;3,0;;;4,0;;5,0;7,0;4,0;38,0;4,0;;6,0;;;;;;1,0;5,0;;;2,0;2,0;;;1,0;;1,0;;;;2,0;5,0;1,0;2,0;;;3,0;;;;1,0;;;;;;10,0;;;;1,0;;;;;1,0;;7,0;;;;;2,0;10,0;1,0;;1,0;18,0;;120,0;;4,0;4,0;;;;;1,0;5,0;;;;4,0;1,0;;;3,0;6,0;2,0;;;;;23,0;;;;;;;1,0;;;;;;4,0;;1,0;;1,0;;;2,0;6,0;;;;2,0;4,0;1,0;23,0;;1,0;21,0;1,0;;;6,0;2,0;;;;3,0;9,0;1,0;7,0;9,0;;;;;;;;2,0;;;;;;2,0;;2,0;;4,0;;4,0;;3,0;;;;;;17,0;42,0;1,0;27,0;2,0;10,0;3,0;;;;6,0;;7,0;1,0;;;;1,0;;1,0;;;4,0;1,0;1,0;;;;;;4,0;;;1,0;;;1,0;3,0;1,0;;;42,0;;;5,0;;;;;;1,0;2,0;4,0;;;;;96,0;;2,0;;;;;8,0;;;;6,0;2,0;3,0;;3,0;;2,0;;;;4,0;;;1,0;;;13,0;;;6,0;1,0;;;;;;;;;;;2,0;3,0;;;;1,0;;;;;;;;;7,0;;;;;;;1,0;16,0;5,0;4,0;6,0;;;1,0;;;;1,0;1,0;2,0;;;;;;;;3,0;;;;;;;2,0;;;;;2,0;;1,0;2,0;;;1,0;;1,0;;4,0;;;1,0;;;1,0
image;89,0;60,0;62,0;37,0;509,0;547,0;227,0;2587,0;2206,0;520,0;840,0;17,0;924,0;86,0;484,0;3280,0;191,0;426,0;387,0;111,0;542,0;11661,0;142,0;149,0;51,0;68,0;1722,0;152,0;17,0;211,0;537,0;228,0;3302,0;210,0;1809,0;578,0;785,0;647,0;540,0;140,0;11277,0;50,0;311,0;757,0;1893,0;557,0;2772,0;6246,0;3627,0;6257,0;352,0;863,0;303,0;210,0;199,0;554,0;1842,0;112,0;359,0;54,0;116,0;288,0;622,0;740,0;688,0;393,0;807,0;2481,0;2528,0;173,0;488,0;323,0;4126,0;214,0;66,0;513,0;908,0;159,0;304,0;;363,0;2255,0;79,0;3827,0;184,0;473,0;87,0;32,0;50,0;263,0;5156,0;21,0;36,0;104,0;163,0;434,0;917,0;58,0;4794,0;249,0;281,0;303,0;2323,0;5047,0;78,0;356,0;3684,0;721,0;2815,0;761,0;195,0;1707,0;78,0;362,0;80,0;4147,0;2718,0;2597,0;239,0;856,0;46,0;24,0;1249,0;5267,0;1959,0;307,0;32,0;104,0;91,0;610,0;30,0;1214,0;553,0;105,0;765,0;1156,0;601,0;518,0;344,0;85,0;1710,0;20,0;195,0;10386,0;501,0;87,0;8,0;2292,0;4778,0;769,0;256,0;66,0;931,0;2470,0;2249,0;106,0;3823,0;169,0;110,0;469,0;244,0;800,0;5678,0;59,0;67,0;21,0;1510,0;1479,0;349,0;97,0;1079,0;7,0;34,0;251,0;460,0;367,0;272,0;151,0;24,0;90,0;287,0;382,0;41,0;39,0;173,0;672,0;1,0;704,0;150,0;46,0;365,0;164,0;37,0;350,0;33,0;95,0;358,0;44,0;16,0;196,0;50,0;34,0;429,0;845,0;223,0;17,0;644,0;79,0;665,0;804,0;33,0;67,0;8,0;56,0;70,0;107,0;9,0;59,0;255,0;91,0;415,0;140,0;19,0;15,0;43,0;25,0;142,0;;2095,0;65,0;271,0;28,0;149,0;478,0;147,0;325,0;408,0;125,0;99,0;32,0;398,0;121,0;83,0;270,0;113,0;26,0;90,0;122,0;3667,0;795,0;130,0;44,0;15,0;9,0;5,0;32,0;3095,0;253,0;28,0;26,0;6,0;16,0;21,0;1492,0;128,0;84,0;124,0;32,0;226,0;19,0;39,0;569,0;333,0;20,0;38,0;14,0;218,0;181,0;403,0;1888,0;186,0;61,0;113,0;52,0;55,0;1574,0;135,0;188,0;74,0;63,0;773,0;153,0;161,0;69,0;52,0;31,0;185,0;17,0;37,0;14,0;148,0;158,0;138,0;79,0;43,0;5,0;14,0;500,0;105,0;93,0;49,0;99,0;336,0;2,0;162,0;857,0;8,0;58,0;43,0;351,0;8,0;22,0;13,0;14,0;255,0;21,0;22,0;2,0;218,0;65,0;2,0;3,0;1,0;8,0;5,0;167,0;79,0;191,0;81,0;118,0;14,0;8,0;134,0;223,0;350,0;31,0;42,0;50,0;223,0;491,0;12,0;79,0;57,0;2782,0;25,0;12,0;133,0;1388,0;205,0;161,0;22,0;481,0;41,0;15,0;12,0;4,0;3,0;134,0;98,0;98,0;76,0;43,0;3,0;135,0;20,0;8,0;23,0;17,0;204,0;115,0;8,0;9,0;217,0;16,0;89,0;341,0;7,0;5,0;3,0;184,0;131,0;1174,0;425,0;60,0;11,0;209,0;9,0;107,0;193,0;48,0;19,0;15,0;156,0;220,0;14,0;19,0;42,0;45,0;234,0;811,0;555,0;411,0;611,0;295,0;403,0;32,0;94,0;96,0;112,0;80,0;40,0;73,0;515,0;228,0;37,0;169,0;77,0;1262,0;103,0;98,0;4,0;1550,0;457,0;182,0;750,0;6,0;498,0;280,0;1053,0;39,0;483,0;814,0;1035,0;26,0;303,0;164,0;842,0;35,0;271,0;179,0;660,0;44,0;12,0;78,0;300,0;2017,0;121,0;236,0;35,0;155,0;671,0;111,0;25,0;105,0;141,0;199,0;33,0;42,0;346,0;309,0;58,0;22,0;113,0;178,0;1070,0;68,0;309,0;36,0;46,0;18,0;831,0;394,0;260,0;411,0;475,0;58,0;228,0;192,0;54,0;427,0;22,0;212,0;99,0;256,0;167,0;85,0;64,0;114,0;383,0;96,0;103,0;16,0;63,0;1048,0;333,0;60,0;213,0;15,0;442,0;91,0;297,0;642,0;30,0;44,0;413,0;35,0;22,0;12,0;161,0;12,0;410,0;107,0;17,0;338,0;54,0;101,0;129,0;20,0;130,0;128,0;44,0;192,0;104,0;88,0;11,0;20,0;360,0;322,0;77,0;134,0;358,0;37,0;115,0;43,0;370,0;778,0;166,0;154,0;22,0;252,0;21,0;;389,0;598,0;55,0;73,0;29,0;23,0;6,0;61,0;63,0;142,0;85,0;309,0;23,0;177,0;51,0;215,0;26,0;112,0;1498,0;134,0;164,0;2,0;81,0;150,0;17,0;24,0;31,0;11,0;124,0;8,0;144,0;54,0;378,0;113,0;15,0;88,0;14,0;59,0;108,0;92,0;6,0;87,0;31,0;18,0;34,0;120,0;315,0;5,0;353,0;24,0;123,0;91,0;58,0;445,0;83,0;6,0;17,0;11,0;31,0;411,0;196,0;16,0;14,0;31,0;9,0;98,0;17,0;59,0;97,0;108,0;6,0;239,0;212,0;66,0;1671,0;270,0;22,0;40,0;47,0;2,0;31,0;354,0;141,0;58,0;121,0;6,0;100,0;17,0;209,0;91,0;92,0;48,0;82,0;16,0;42,0;9,0;414,0;29,0;7,0;151,0;87,0;36,0;46,0;15,0;50,0;32,0;18,0;12,0;18,0;28,0;22,0;58,0;236,0;73,0;23,0;152,0;26,0;97,0;151,0;8,0;25,0;153,0;21,0;13,0;16,0;23,0;32,0;48,0;2,0;28,0;180,0;4,0;;202,0;53,0;174,0;1,0;20,0;5,0;190,0;24,0;5,0;20,0;78,0;34,0;36,0;293,0;7,0;13,0;10,0;58,0;147,0;1,0;30,0;279,0;499,0;3,0;5,0;2,0;5,0;18,0;111,0;33,0;22,0;6,0;;4,0;3,0;9,0;37,0;8,0;7,0;297,0;25,0;66,0;103,0;20,0;83,0;106,0;147,0;98,0;105,0;83,0;54,0;55,0;108,0;14,0;28,0;83,0;12,0;3,0;85,0;1,0;5,0;49,0;26,0;86,0;142,0;5,0;46,0;8,0;11,0;20,0;48,0;35,0;;196,0;67,0;97,0;11,0;7,0;107,0;98,0;58,0;179,0;120,0;;64,0;10,0;49,0;417,0;779,0;10,0;52,0;19,0;40,0;159,0;233,0;42,0;56,0;15,0;30,0;59,0;95,0;294,0;39,0;48,0;898,0;268,0;141,0;63,0;72,0;85,0;3,0;2,0;200,0;180,0;77,0;205,0;65,0;94,0;112,0;87,0;100,0;94,0;4,0;374,0;81,0;201,0;327,0;38,0;553,0;99,0;42,0;208,0;14,0;44,0;99,0;467,0;75,0;79,0;180,0;70,0;55,0;33,0;19,0;56,0;18,0;18,0;250,0;47,0;52,0;471,0;181,0;42,0;3,0;;78,0;33,0;74,0;45,0;29,0;38,0;6,0;15,0;57,0;6,0;39,0;62,0;177,0;146,0;54,0;11,0;150,0;29,0;49,0;322,0;29,0;14,0;71,0;26,0;65,0;119,0;194,0;58,0;60,0;96,0;38,0;92,0;47,0;48,0;;21,0;;27,0;1,0;10,0;9,0;52,0;30,0;20,0;4,0;54,0;109,0;10,0;115,0;35,0;12,0;190,0;443,0;14,0;;15,0;50,0;91,0;38,0;129,0;41,0;159,0;53,0;58,0;34,0;440,0;2,0;6,0;23,0;69,0;1,0;2,0;31,0;22,0;19,0;38,0;74,0;152,0;41,0;37,0;59,0;35,0;1,0;64,0;104,0;2,0;310,0;;11,0;17,0;35,0;79,0;5,0;265,0;33,0;49,0;;96,0;11,0;16,0;76,0;10,0;21,0;7,0;50,0;389,0;6,0;155,0;9,0;47,0;11,0;3,0;155,0;27,0;154,0;22,0;;9,0;91,0;29,0;16,0;61,0;57,0;23,0;42,0;148,0;160,0;160,0;38,0;4,0;70,0;;30,0;137,0;3,0;25,0;124,0;28,0;393,0;56,0;54,0;53,0;268,0;47,0;244,0;29,0;25,0;44,0;15,0;20,0;7,0;61,0;65,0;38,0;31,0;23,0;52,0;6,0;;97,0;3,0
imager;1,0;2,0;;;6,0;7,0;;26,0;45,0;4,0;86,0;;19,0;7,0;14,0;35,0;3,0;5,0;1,0;;4,0;117,0;6,0;17,0;3,0;;10,0;6,0;;;1,0;2,0;31,0;;56,0;10,0;13,0;;7,0;3,0;51,0;2,0;3,0;1,0;9,0;7,0;28,0;109,0;4,0;14,0;37,0;27,0;;;4,0;1,0;63,0;;2,0;;21,0;5,0;13,0;;13,0;31,0;14,0;12,0;11,0;18,0;6,0;;31,0;3,0;;12,0;10,0;1,0;2,0;363,0;;142,0;2,0;115,0;;21,0;;;;23,0;218,0;;;;1,0;;5,0;;60,0;11,0;1,0;1,0;22,0;43,0;19,0;10,0;55,0;8,0;82,0;8,0;6,0;8,0;;6,0;;116,0;26,0;56,0;4,0;19,0;;1,0;26,0;13,0;43,0;3,0;3,0;;5,0;4,0;;10,0;17,0;;2,0;15,0;23,0;7,0;2,0;;35,0;;4,0;59,0;23,0;;;12,0;44,0;11,0;8,0;11,0;7,0;8,0;7,0;2,0;133,0;;8,0;;1,0;8,0;25,0;;1,0;3,0;42,0;16,0;23,0;2,0;10,0;;8,0;6,0;;8,0;31,0;15,0;;;33,0;1,0;4,0;6,0;3,0;48,0;;9,0;;;;;;8,0;4,0;3,0;;;;11,0;;1,0;;35,0;;;;8,0;57,0;10,0;12,0;2,0;;2,0;;;;;;1,0;23,0;4,0;2,0;;;;6,0;;46,0;3,0;16,0;;;33,0;;5,0;1,0;10,0;;1,0;;;1,0;17,0;;;6,0;;67,0;38,0;;;;;;;52,0;2,0;;;;;1,0;18,0;1,0;;3,0;5,0;;1,0;;13,0;9,0;1,0;2,0;;5,0;3,0;10,0;97,0;;;2,0;;;22,0;;2,0;;4,0;7,0;;1,0;;2,0;2,0;1,0;;6,0;;;3,0;3,0;1,0;;;;6,0;;1,0;;2,0;6,0;;;11,0;;;1,0;5,0;;;;6,0;;3,0;;;3,0;;;4,0;;;;3,0;1,0;3,0;10,0;15,0;;;;2,0;;;;;14,0;;;1,0;;2,0;;;;10,0;1,0;2,0;;2,0;;;;1,0;;;;;;;;2,0;;4,0;5,0;;18,0;3,0;1,0;;6,0;2,0;;1,0;;;;3,0;24,0;16,0;;;;2,0;;;3,0;;;;;1,0;;;;;4,0;6,0;11,0;1,0;3,0;;1,0;;;;;;;1,0;25,0;3,0;;;;2,0;;;;9,0;22,0;;;;;;;;1,0;22,0;69,0;1,0;2,0;2,0;16,0;;;3,0;3,0;;;1,0;;5,0;;;;;9,0;1,0;;7,0;;;;;;2,0;;;1,0;1,0;;1,0;1,0;;12,0;;18,0;;1,0;10,0;22,0;;;1,0;7,0;;;4,0;1,0;23,0;2,0;2,0;;1,0;2,0;;7,0;;1,0;;1,0;4,0;;;;;;;;;4,0;;;2,0;;;1,0;;;;;1,0;;;;7,0;;1,0;;;;;2,0;;;;;;1,0;;;9,0;;;;;;;1,0;2,0;;3,0;;2,0;;1,0;10,0;;3,0;18,0;;;;13,0;;2,0;3,0;;3,0;3,0;1,0;4,0;2,0;;;;;2,0;;;;;;;1,0;;;1,0;;1,0;;7,0;;;;;3,0;;;;1,0;5,0;;;5,0;;;1,0;;;;;;;;1,0;;;;;;1,0;123,0;7,0;;;;;;6,0;;;8,0;;2,0;;2,0;;;2,0;;1,0;;3,0;1,0;;;2,0;;2,0;1,0;1,0;28,0;1,0;3,0;1,0;;1,0;;1,0;10,0;1,0;;2,0;;;;;;2,0;1,0;;;;5,0;;;;3,0;;;;;;;2,0;;;;;;1,0;;6,0;2,0;;;;1,0;;;;;;;;1,0;;;1,0;;;;;;;;1,0;2,0;;;;;;3,0;1,0;;;8,0;7,0;;1,0;17,0;;;;;;;2,0;;;;;;;;;;;;;;;14,0;2,0;5,0;;;;;1,0;;2,0;4,0;;2,0;8,0;;;2,0;10,0;;1,0;;3,0;;;;;;;3,0;;1,0;2,0;;14,0;;;;;3,0;;6,0;;;;1,0;;;;;;2,0;;;3,0;;;;;1,0;;2,0;;2,0;;4,0;;;;;;;;;2,0;;;9,0;;;9,0;;4,0;;;1,0;2,0;;;;;;;;;;;;;;1,0;;;;;;;1,0;;;6,0;;;;;;;;;;;;;;4,0;;;7,0;;;;;;;;;;;;;;2,0;2,0;2,0;;;1,0;;;;;;;;;;;;;5,0;;;2,0;;;6,0;;;;;;;;;;;;1,0;;;;;3,0;;;;;;;2,0;;;;;;1,0;4,0;;;;;;1,0;5,0;;;12,0;5,0;1,0;;;8,0;;;;;;;;;2,0;;;;;;1,0;;;;;;;;;;;;;;;;
imaging;13,0;3,0;2,0;;11,0;102,0;107,0;942,0;315,0;77,0;322,0;4,0;65,0;13,0;182,0;183,0;30,0;4,0;5,0;16,0;45,0;501,0;21,0;12,0;30,0;10,0;163,0;41,0;2,0;9,0;31,0;119,0;393,0;16,0;474,0;85,0;27,0;98,0;13,0;5,0;467,0;2,0;64,0;19,0;118,0;78,0;145,0;3811,0;335,0;180,0;184,0;238,0;12,0;15,0;67,0;39,0;966,0;13,0;15,0;4,0;51,0;29,0;185,0;4,0;98,0;116,0;173,0;291,0;93,0;45,0;97,0;43,0;299,0;17,0;;92,0;8,0;41,0;78,0;2255,0;142,0;;6,0;906,0;18,0;67,0;73,0;;1,0;57,0;1535,0;;3,0;40,0;23,0;40,0;28,0;5,0;538,0;14,0;4,0;7,0;349,0;328,0;28,0;103,0;1029,0;46,0;325,0;82,0;29,0;168,0;34,0;15,0;27,0;472,0;233,0;376,0;67,0;95,0;5,0;21,0;65,0;331,0;161,0;29,0;6,0;6,0;22,0;99,0;;141,0;51,0;8,0;27,0;42,0;28,0;49,0;12,0;73,0;153,0;8,0;16,0;842,0;44,0;4,0;;175,0;719,0;41,0;11,0;18,0;94,0;66,0;311,0;29,0;1602,0;13,0;37,0;74,0;7,0;22,0;1789,0;1,0;12,0;1,0;147,0;141,0;36,0;46,0;280,0;13,0;6,0;21,0;48,0;29,0;105,0;50,0;2,0;4,0;59,0;340,0;13,0;13,0;70,0;193,0;4,0;66,0;3,0;8,0;3,0;24,0;21,0;100,0;5,0;25,0;3,0;1,0;1,0;62,0;13,0;13,0;11,0;205,0;23,0;3,0;16,0;10,0;99,0;112,0;67,0;7,0;2,0;32,0;4,0;9,0;8,0;11,0;8,0;10,0;154,0;66,0;7,0;9,0;29,0;7,0;91,0;1,0;518,0;56,0;166,0;25,0;58,0;182,0;23,0;52,0;25,0;29,0;36,0;19,0;26,0;27,0;9,0;129,0;18,0;26,0;47,0;16,0;736,0;105,0;39,0;18,0;;1,0;1,0;7,0;204,0;58,0;19,0;19,0;;8,0;10,0;200,0;112,0;31,0;20,0;8,0;62,0;11,0;4,0;92,0;39,0;;4,0;4,0;67,0;25,0;158,0;658,0;41,0;3,0;37,0;13,0;4,0;211,0;9,0;28,0;1,0;9,0;70,0;33,0;13,0;1,0;35,0;;8,0;2,0;23,0;4,0;43,0;20,0;57,0;9,0;3,0;;37,0;31,0;9,0;5,0;2,0;42,0;65,0;;32,0;29,0;;34,0;7,0;68,0;1,0;5,0;8,0;9,0;109,0;3,0;3,0;7,0;5,0;18,0;1,0;1,0;2,0;;8,0;45,0;7,0;40,0;44,0;21,0;3,0;8,0;12,0;47,0;87,0;9,0;18,0;2,0;38,0;12,0;3,0;39,0;24,0;33,0;2,0;9,0;9,0;49,0;35,0;14,0;6,0;15,0;23,0;12,0;4,0;;4,0;55,0;28,0;29,0;9,0;6,0;6,0;5,0;3,0;;2,0;5,0;19,0;14,0;2,0;;2,0;1,0;1,0;13,0;;;6,0;69,0;27,0;93,0;28,0;10,0;;27,0;2,0;16,0;64,0;35,0;11,0;;23,0;27,0;3,0;1,0;3,0;12,0;29,0;34,0;55,0;45,0;1,0;;3,0;9,0;3,0;25,0;19,0;10,0;;10,0;114,0;10,0;;14,0;1,0;11,0;2,0;17,0;;53,0;47,0;19,0;23,0;11,0;;45,0;186,0;;19,0;79,0;89,0;;27,0;55,0;188,0;1,0;28,0;58,0;71,0;;;60,0;22,0;52,0;3,0;2,0;4,0;7,0;30,0;22,0;2,0;7,0;1,0;;1,0;;29,0;25,0;4,0;6,0;7,0;1,0;45,0;17,0;2,0;11,0;46,0;;108,0;70,0;;59,0;36,0;20,0;;5,0;15,0;17,0;2,0;16,0;3,0;53,0;22,0;15,0;14,0;2,0;42,0;1,0;43,0;2,0;12,0;91,0;30,0;3,0;4,0;14,0;108,0;14,0;3,0;27,0;3,0;;2,0;1,0;5,0;;7,0;;26,0;4,0;17,0;36,0;5,0;9,0;20,0;11,0;2,0;29,0;;4,0;13,0;33,0;6,0;;34,0;5,0;1,0;14,0;4,0;5,0;1,0;2,0;3,0;94,0;4,0;16,0;2,0;38,0;1,0;;265,0;111,0;8,0;18,0;18,0;1,0;2,0;10,0;3,0;12,0;15,0;71,0;4,0;88,0;16,0;34,0;2,0;;92,0;1,0;38,0;;3,0;8,0;7,0;6,0;16,0;2,0;3,0;8,0;;10,0;33,0;12,0;;2,0;22,0;7,0;20,0;10,0;;8,0;16,0;;9,0;3,0;5,0;5,0;67,0;26,0;4,0;5,0;1,0;16,0;2,0;;7,0;;4,0;2,0;13,0;1,0;1,0;;;5,0;4,0;2,0;66,0;11,0;;5,0;3,0;1,0;166,0;11,0;16,0;;40,0;1,0;;27,0;23,0;;10,0;1,0;3,0;1,0;2,0;94,0;16,0;25,0;;9,0;30,0;1,0;44,0;2,0;22,0;5,0;;25,0;2,0;1,0;;12,0;1,0;1,0;25,0;17,0;;5,0;79,0;5,0;5,0;16,0;9,0;34,0;26,0;1,0;12,0;2,0;9,0;3,0;;2,0;2,0;;2,0;11,0;14,0;3,0;;18,0;3,0;6,0;18,0;2,0;1,0;13,0;1,0;;5,0;13,0;4,0;26,0;21,0;;;8,0;3,0;2,0;;3,0;5,0;58,0;;28,0;9,0;3,0;1,0;20,0;13,0;16,0;8,0;1,0;;;49,0;4,0;9,0;;33,0;4,0;28,0;18,0;8,0;11,0;8,0;8,0;6,0;44,0;27,0;;13,0;43,0;;18,0;;51,0;;23,0;;2,0;;28,0;7,0;;;5,0;2,0;24,0;3,0;14,0;;;33,0;1,0;18,0;14,0;11,0;3,0;3,0;4,0;17,0;66,0;13,0;11,0;32,0;48,0;11,0;25,0;28,0;5,0;6,0;12,0;6,0;11,0;12,0;;4,0;4,0;13,0;4,0;27,0;;68,0;12,0;15,0;5,0;100,0;9,0;2,0;11,0;4,0;3,0;2,0;7,0;6,0;4,0;41,0;16,0;5,0;1,0;3,0;;27,0;1,0;66,0;21,0;;10,0;2,0;5,0;8,0;5,0;4,0;;40,0;;19,0;2,0;13,0;1,0;1,0;2,0;5,0;7,0;10,0;13,0;3,0;10,0;5,0;3,0;1,0;12,0;6,0;22,0;1,0;7,0;24,0;7,0;4,0;;13,0;1,0;42,0;15,0;1,0;8,0;;1,0;;;4,0;4,0;17,0;1,0;1,0;;8,0;;3,0;2,0;29,0;5,0;2,0;4,0;2,0;4,0;;;1,0;;;3,0;6,0;3,0;2,0;6,0;;6,0;4,0;1,0;1,0;22,0;;1,0;4,0;18,0;;3,0;3,0;3,0;2,0;;27,0;3,0;19,0;5,0;4,0;;;;1,0;;;;;;4,0;1,0;2,0;1,0;18,0;35,0;4,0;7,0;;;6,0;3,0;;4,0;5,0;21,0;6,0;6,0;2,0;10,0;;;4,0;;;4,0;;6,0;;6,0;;3,0;32,0;;;4,0;6,0;;10,0;14,0;9,0;10,0;3,0;;1,0;6,0;2,0;6,0;15,0;1,0;;21,0;3,0;10,0;23,0;3,0;2,0;1,0;;4,0;14,0;1,0;3,0;;1,0;2,0;4,0;33,0;1,0;2,0;;;;;9,0;2,0;3,0;;1,0;;1,0;2,0;;;2,0;;2,0;
implement;1,0;;1,0;;1,0;2,0;;10,0;;;7,0;;3,0;;3,0;1,0;;;1,0;;2,0;21,0;;2,0;;;5,0;;1,0;;80,0;;26,0;;38,0;4,0;;1,0;;;30,0;;;3,0;9,0;37,0;19,0;92,0;12,0;28,0;;5,0;;;1,0;;;;7,0;5,0;;;6,0;1,0;4,0;;7,0;2,0;3,0;1,0;18,0;;17,0;6,0;;4,0;6,0;;2,0;79,0;2,0;6,0;;53,0;1,0;125,0;1,0;1,0;;;28,0;1,0;;;;12,0;6,0;;169,0;2,0;3,0;3,0;34,0;17,0;1,0;;10,0;;9,0;3,0;5,0;11,0;;1,0;;16,0;8,0;16,0;16,0;4,0;1,0;;6,0;45,0;53,0;67,0;2,0;;;1,0;;19,0;1,0;;;;;1,0;;;6,0;;1,0;15,0;2,0;7,0;;1,0;25,0;2,0;;6,0;;22,0;5,0;;49,0;1,0;3,0;2,0;1,0;;15,0;1,0;;;6,0;16,0;;;2,0;;;1,0;3,0;3,0;1,0;;;;;37,0;;;;;4,0;1,0;;;;2,0;;;;;1,0;1,0;;;;2,0;;1,0;;;2,0;;8,0;;;9,0;;4,0;2,0;;2,0;;;1,0;;;;;;;2,0;;4,0;;;;;2,0;;2,0;;;;;;;1,0;;;;;3,0;11,0;3,0;;;;;;;14,0;;;;;;;4,0;;;;;;1,0;;2,0;4,0;;;;;3,0;;2,0;1,0;;;;7,0;3,0;;1,0;;;1,0;;;1,0;;;1,0;;;;;1,0;;;;;;;;2,0;;;4,0;;;3,0;;;;2,0;;;;;;;;;;;;;;;;;3,0;;;;;;;1,0;;;;4,0;9,0;4,0;;;;;;;;9,0;3,0;;1,0;;1,0;;;;;1,0;;;;2,0;;;1,0;;;;1,0;2,0;;;8,0;;;3,0;;;;1,0;;1,0;;1,0;;1,0;;;1,0;;;;;14,0;;;;;1,0;8,0;;9,0;;1,0;35,0;;;;;;;;6,0;;1,0;;;5,0;;;;5,0;7,0;2,0;8,0;;;3,0;;;3,0;2,0;;;4,0;5,0;5,0;;2,0;;1,0;;;40,0;;1,0;12,0;3,0;;;;;;1,0;;;;;;11,0;;;1,0;2,0;12,0;;1,0;4,0;;;6,0;1,0;;1,0;1,0;1,0;3,0;;3,0;1,0;;1,0;7,0;20,0;;;1,0;;6,0;;;;2,0;;6,0;;1,0;;;;;1,0;;3,0;1,0;;1,0;;;;;6,0;2,0;2,0;;1,0;;;1,0;4,0;1,0;;2,0;;;;;5,0;;;1,0;2,0;;;3,0;1,0;1,0;;;1,0;;;;1,0;;3,0;3,0;;;2,0;1,0;1,0;;;;3,0;;7,0;1,0;;2,0;2,0;;;1,0;7,0;;;6,0;;;2,0;1,0;;7,0;;;1,0;;3,0;2,0;;;1,0;;;3,0;;;;;;;1,0;;1,0;;;1,0;1,0;;;;1,0;;;;2,0;7,0;2,0;;2,0;;3,0;3,0;;5,0;1,0;;;;;;6,0;;1,0;;;6,0;;;;;;2,0;;2,0;;3,0;;;7,0;;;;;;;;;;;;;1,0;1,0;;;;;;;1,0;;;;;;1,0;;;1,0;;;;;;;;;;;;;;;;;;;;;1,0;1,0;;;2,0;;;;;;;;1,0;;;;;;;;;;;;;1,0;;;1,0;3,0;;;;;;;;;2,0;;;1,0;;;;;;;;;;;;;;;3,0;;;;;;;;;;;;;;;2,0;;;;;1,0;1,0;;;;;;;2,0;;;12,0;;1,0;;1,0;1,0;;;;3,0;6,0;1,0;;;;;1,0;;;;3,0;;3,0;;1,0;;2,0;;1,0;;;1,0;;;2,0;42,0;;;;1,0;;;2,0;2,0;;;;1,0;1,0;;;;8,0;2,0;;4,0;;;;;;;;;5,0;;;6,0;;;;;;;;;2,0;;;;;;;;;;;;;;;;;1,0;2,0;2,0;1,0;;;;;;1,0;5,0;;;;;;;;;;;;;;;;8,0;;;;;;;;1,0;;3,0;;;;;1,0;;4,0;;;;;;;;;;;4,0;;;1,0;;;;;;;;;;;;2,0;;;;;;1,0;;;;;;;;;;;;;;;;;;1,0;;;;;2,0;3,0;;;;;2,0;;;;1,0;;;;;;;;;
include;14,0;126,0;10,0;5,0;71,0;138,0;151,0;807,0;443,0;212,0;362,0;80,0;113,0;4,0;155,0;428,0;70,0;33,0;55,0;32,0;175,0;658,0;48,0;78,0;32,0;24,0;368,0;33,0;20,0;4,0;95,0;81,0;589,0;11,0;744,0;154,0;29,0;153,0;51,0;12,0;1181,0;5,0;195,0;94,0;430,0;154,0;410,0;2164,0;483,0;677,0;228,0;155,0;28,0;59,0;275,0;138,0;1047,0;16,0;73,0;30,0;200,0;72,0;151,0;55,0;488,0;90,0;225,0;413,0;479,0;168,0;193,0;42,0;395,0;31,0;22,0;450,0;142,0;43,0;142,0;3827,0;115,0;906,0;53,0;;15,0;271,0;186,0;6,0;18,0;57,0;3450,0;42,0;36,0;93,0;39,0;153,0;163,0;12,0;1320,0;112,0;62,0;52,0;1162,0;631,0;46,0;96,0;931,0;68,0;360,0;296,0;42,0;174,0;54,0;13,0;101,0;1898,0;1111,0;506,0;357,0;174,0;9,0;35,0;98,0;539,0;270,0;81,0;15,0;9,0;43,0;181,0;18,0;184,0;53,0;20,0;63,0;64,0;124,0;79,0;51,0;19,0;170,0;12,0;39,0;989,0;193,0;25,0;12,0;456,0;971,0;93,0;42,0;47,0;154,0;189,0;161,0;99,0;1930,0;6,0;107,0;193,0;21,0;109,0;2451,0;5,0;16,0;9,0;503,0;253,0;51,0;81,0;384,0;22,0;25,0;60,0;94,0;62,0;563,0;269,0;30,0;32,0;138,0;818,0;14,0;41,0;62,0;697,0;6,0;253,0;19,0;5,0;39,0;20,0;42,0;242,0;9,0;231,0;90,0;2,0;35,0;157,0;65,0;10,0;54,0;158,0;23,0;51,0;31,0;16,0;106,0;273,0;99,0;38,0;29,0;49,0;40,0;23,0;43,0;26,0;24,0;140,0;609,0;16,0;118,0;19,0;11,0;50,0;184,0;17,0;733,0;34,0;616,0;36,0;184,0;595,0;145,0;44,0;78,0;190,0;37,0;119,0;22,0;87,0;23,0;96,0;71,0;67,0;277,0;34,0;1738,0;145,0;256,0;14,0;26,0;5,0;13,0;43,0;589,0;77,0;26,0;57,0;16,0;25,0;46,0;207,0;130,0;29,0;171,0;42,0;134,0;15,0;39,0;299,0;102,0;40,0;6,0;138,0;31,0;184,0;356,0;745,0;100,0;52,0;250,0;13,0;8,0;170,0;17,0;58,0;26,0;42,0;221,0;52,0;51,0;27,0;177,0;2,0;20,0;11,0;61,0;23,0;189,0;40,0;154,0;17,0;59,0;22,0;78,0;117,0;113,0;20,0;21,0;72,0;75,0;20,0;15,0;57,0;16,0;161,0;27,0;204,0;20,0;29,0;10,0;44,0;238,0;18,0;65,0;39,0;12,0;8,0;41,0;30,0;34,0;14,0;14,0;68,0;53,0;137,0;92,0;178,0;26,0;18,0;51,0;79,0;63,0;62,0;106,0;155,0;70,0;247,0;22,0;19,0;22,0;189,0;43,0;92,0;62,0;214,0;63,0;42,0;11,0;46,0;17,0;48,0;86,0;19,0;5,0;99,0;96,0;29,0;11,0;18,0;10,0;3,0;33,0;9,0;87,0;37,0;51,0;60,0;43,0;18,0;50,0;55,0;34,0;45,0;56,0;28,0;4,0;311,0;35,0;206,0;77,0;26,0;85,0;73,0;27,0;28,0;72,0;12,0;7,0;23,0;70,0;40,0;10,0;8,0;5,0;17,0;9,0;128,0;112,0;198,0;90,0;53,0;65,0;5,0;28,0;15,0;4,0;8,0;5,0;14,0;140,0;56,0;17,0;20,0;5,0;178,0;14,0;23,0;33,0;275,0;120,0;53,0;128,0;5,0;38,0;62,0;253,0;13,0;154,0;218,0;137,0;14,0;106,0;128,0;226,0;6,0;75,0;72,0;95,0;15,0;1,0;65,0;59,0;162,0;84,0;23,0;32,0;15,0;88,0;28,0;9,0;37,0;20,0;34,0;53,0;12,0;38,0;123,0;17,0;;29,0;40,0;272,0;13,0;57,0;14,0;64,0;8,0;179,0;39,0;35,0;65,0;36,0;13,0;10,0;11,0;36,0;52,0;15,0;39,0;98,0;61,0;13,0;6,0;34,0;16,0;206,0;17,0;235,0;28,0;52,0;128,0;139,0;8,0;56,0;1,0;194,0;15,0;21,0;146,0;13,0;25,0;47,0;39,0;16,0;14,0;47,0;20,0;30,0;23,0;83,0;128,0;17,0;50,0;71,0;56,0;64,0;69,0;10,0;24,0;101,0;75,0;25,0;24,0;56,0;22,0;13,0;15,0;9,0;106,0;5,0;19,0;27,0;49,0;26,0;30,0;9,0;81,0;28,0;49,0;20,0;64,0;58,0;107,0;6,0;53,0;57,0;45,0;21,0;35,0;96,0;112,0;14,0;78,0;32,0;179,0;14,0;21,0;80,0;26,0;40,0;15,0;36,0;45,0;9,0;52,0;33,0;11,0;30,0;14,0;22,0;35,0;150,0;26,0;24,0;30,0;37,0;10,0;51,0;45,0;2,0;30,0;27,0;14,0;22,0;64,0;88,0;16,0;75,0;6,0;81,0;73,0;5,0;109,0;13,0;27,0;50,0;42,0;4,0;59,0;55,0;14,0;42,0;;;62,0;16,0;14,0;83,0;7,0;7,0;48,0;39,0;11,0;491,0;51,0;22,0;9,0;67,0;16,0;35,0;51,0;53,0;21,0;41,0;29,0;26,0;24,0;31,0;66,0;37,0;21,0;35,0;16,0;33,0;25,0;55,0;40,0;22,0;114,0;23,0;19,0;38,0;79,0;17,0;;43,0;13,0;56,0;59,0;24,0;14,0;283,0;11,0;33,0;40,0;31,0;80,0;67,0;39,0;30,0;11,0;12,0;3,0;8,0;27,0;84,0;23,0;20,0;14,0;116,0;16,0;15,0;76,0;21,0;57,0;43,0;62,0;30,0;67,0;6,0;3,0;13,0;13,0;45,0;14,0;140,0;14,0;55,0;5,0;32,0;15,0;17,0;10,0;35,0;28,0;17,0;63,0;6,0;2,0;10,0;107,0;5,0;51,0;12,0;5,0;60,0;25,0;19,0;66,0;15,0;28,0;143,0;96,0;83,0;143,0;14,0;50,0;13,0;23,0;21,0;20,0;60,0;13,0;19,0;45,0;26,0;6,0;25,0;34,0;9,0;32,0;17,0;34,0;5,0;14,0;48,0;25,0;9,0;2,0;8,0;21,0;16,0;49,0;7,0;12,0;148,0;37,0;6,0;65,0;26,0;40,0;20,0;6,0;10,0;94,0;26,0;48,0;13,0;98,0;25,0;67,0;26,0;;3,0;7,0;73,0;31,0;66,0;12,0;19,0;7,0;;9,0;37,0;4,0;16,0;125,0;17,0;21,0;261,0;22,0;9,0;8,0;8,0;21,0;47,0;11,0;30,0;16,0;41,0;18,0;9,0;7,0;41,0;17,0;55,0;25,0;31,0;75,0;;27,0;33,0;4,0;43,0;3,0;20,0;5,0;35,0;16,0;38,0;24,0;209,0;29,0;19,0;5,0;6,0;7,0;12,0;27,0;12,0;17,0;21,0;42,0;4,0;23,0;3,0;27,0;21,0;12,0;14,0;9,0;54,0;62,0;19,0;8,0;;71,0;30,0;8,0;33,0;21,0;31,0;11,0;10,0;22,0;48,0;8,0;15,0;3,0;5,0;7,0;13,0;47,0;37,0;15,0;;10,0;15,0;14,0;33,0;20,0;15,0;26,0;13,0;28,0;5,0;15,0;16,0;27,0;3,0;28,0;1,0;16,0;3,0;28,0;14,0;3,0;16,0;69,0;28,0;10,0;31,0;9,0;9,0;8,0;36,0;19,0;13,0;4,0;15,0;2,0;23,0;13,0;8,0;14,0;48,0;12,0;3,0;4,0;20,0;7,0;27,0;4,0;17,0;30,0;5,0;9,0;17,0;8,0;38,0;45,0;25,0;25,0;3,0;147,0;17,0;4,0;15,0;15,0;20,0;6,0;21,0;2,0;6,0;46,0;16,0;28,0;3,0;15,0;16,0;11,0;32,0;7,0;22,0;1,0;11,0;10,0;4,0;43,0;6,0;28,0;19,0;15,0;4,0;18,0;25,0;18,0;3,0;19,0;22,0;29,0;11,0;10,0;18,0;;2,0;3,0;6,0;27,0;23,0;11,0;1,0;13,0;;35,0;12,0;19,0;27,0;11,0;5,0;16,0;9,0;12,0;12,0;1,0;9,0;6,0;7,0;;16,0;9,0;10,0;2,0;6,0;12,0;11,0;
increase;7,0;;58,0;4,0;2,0;17,0;8,0;12,0;32,0;1,0;4,0;;5,0;2,0;7,0;6,0;1,0;5,0;10,0;;;66,0;3,0;;;1,0;17,0;;;;;5,0;15,0;23,0;39,0;17,0;2,0;5,0;;;44,0;77,0;4,0;11,0;5,0;9,0;25,0;20,0;11,0;19,0;;50,0;;1,0;14,0;8,0;10,0;;5,0;;3,0;3,0;15,0;;17,0;1,0;40,0;7,0;32,0;6,0;11,0;5,0;6,0;1,0;;29,0;;;28,0;184,0;;18,0;1,0;15,0;;6,0;;;5,0;13,0;115,0;;;;5,0;;1,0;;45,0;2,0;;;11,0;20,0;;;22,0;5,0;10,0;7,0;2,0;2,0;;;;2,0;22,0;16,0;12,0;13,0;2,0;;1,0;15,0;16,0;;1,0;6,0;;21,0;2,0;17,0;3,0;1,0;;21,0;5,0;17,0;3,0;;5,0;;;20,0;2,0;;1,0;30,0;29,0;18,0;4,0;1,0;;;6,0;10,0;37,0;1,0;6,0;17,0;1,0;;164,0;2,0;2,0;;11,0;8,0;;1,0;33,0;;1,0;2,0;21,0;1,0;3,0;7,0;;;;;2,0;;;4,0;;1,0;;;3,0;1,0;;10,0;2,0;4,0;;;;;;2,0;19,0;57,0;2,0;;;2,0;40,0;3,0;;;7,0;5,0;;;1,0;2,0;2,0;3,0;3,0;3,0;12,0;;;12,0;3,0;;37,0;3,0;4,0;;4,0;3,0;;5,0;6,0;5,0;1,0;2,0;1,0;;;2,0;;;;;23,0;5,0;5,0;5,0;;;4,0;;7,0;;;1,0;;;;7,0;2,0;1,0;2,0;;7,0;;2,0;1,0;6,0;;;2,0;;3,0;2,0;14,0;1,0;;1,0;2,0;1,0;32,0;3,0;;;;;6,0;;;;;8,0;;2,0;;3,0;2,0;5,0;;3,0;;3,0;4,0;1,0;;;6,0;1,0;;3,0;6,0;;;;;;;16,0;;3,0;;;;;;3,0;;1,0;;;14,0;;2,0;2,0;5,0;;;;;8,0;;7,0;;1,0;8,0;;1,0;;7,0;2,0;;;14,0;;;5,0;2,0;;;2,0;;4,0;3,0;;;2,0;;;;2,0;;10,0;1,0;;1,0;;1,0;1,0;;;;;;;1,0;;6,0;;;;3,0;;16,0;;1,0;;;;;;;5,0;1,0;2,0;5,0;74,0;1,0;7,0;;;9,0;1,0;;10,0;;1,0;;;1,0;2,0;3,0;1,0;6,0;2,0;4,0;;7,0;37,0;1,0;8,0;2,0;;4,0;6,0;2,0;;4,0;17,0;;;3,0;9,0;;1,0;16,0;13,0;1,0;;;48,0;2,0;;;;2,0;2,0;;;24,0;;;;;22,0;;;;;;4,0;;;1,0;18,0;;21,0;1,0;1,0;9,0;;4,0;1,0;;2,0;2,0;;;;;12,0;2,0;2,0;;;;;;;7,0;1,0;;;;;;2,0;1,0;;;;;;;;;;;2,0;4,0;;1,0;1,0;1,0;;;;;3,0;;;;9,0;;;24,0;;;52,0;1,0;;;10,0;;;1,0;;;;;;2,0;;1,0;;;;2,0;6,0;2,0;;;;;;1,0;;;2,0;;;1,0;;;;;6,0;;;;9,0;15,0;;;;;;;;;;;;;3,0;1,0;2,0;;;;;;1,0;;;;;1,0;;;;;;;1,0;;;;;;;;10,0;1,0;;12,0;2,0;;;;;;;;2,0;;4,0;;;;;;;;9,0;1,0;;;;;3,0;;1,0;3,0;;;;;;;;;4,0;7,0;;2,0;13,0;;2,0;2,0;;1,0;;1,0;;;;1,0;;4,0;;7,0;14,0;;;;;1,0;;;;;;;;;;;1,0;;;;;1,0;;;;;;7,0;;;1,0;;;;;;;;;1,0;3,0;1,0;2,0;1,0;3,0;;;;6,0;;2,0;2,0;6,0;;7,0;6,0;;;;3,0;;;;2,0;;;;;;;1,0;;2,0;;1,0;;;;2,0;;;1,0;;;;;4,0;1,0;;1,0;;;;4,0;3,0;;;2,0;;3,0;;;28,0;3,0;1,0;;1,0;;3,0;1,0;1,0;5,0;;;3,0;;;;;;;2,0;17,0;;75,0;7,0;;8,0;2,0;;;;2,0;;4,0;12,0;6,0;;1,0;;;;;1,0;;12,0;1,0;2,0;6,0;;;;;;;2,0;;;;;;;;2,0;;;;;3,0;;;;1,0;;;;;;;2,0;;;;3,0;;2,0;1,0;;;;;;;;;;3,0;;;;;1,0;;;5,0;;;;;1,0;6,0;;10,0;;;;;;;;;;;;;;;;;;6,0;;;;;;;;;;;;;;;;;;;;3,0;2,0;;;;6,0;;;;;;;;;;;1,0;;;;;;;5,0;1,0;1,0;;;1,0;;2,0;1,0;;;;;2,0;1,0;;1,0;;;;;;;;;;;;;;;1,0;;;;;;;;;
instruction;2,0;11,0;3,0;3,0;18,0;11,0;7,0;110,0;51,0;4,0;7,0;;48,0;8,0;3,0;144,0;1,0;2,0;13,0;3,0;12,0;143,0;21,0;4,0;;;47,0;10,0;;;256,0;8,0;290,0;3,0;251,0;52,0;4,0;53,0;34,0;;262,0;1,0;12,0;11,0;68,0;59,0;117,0;376,0;82,0;187,0;1,0;17,0;1,0;;126,0;2,0;5,0;2,0;15,0;259,0;;5,0;9,0;9,0;6,0;7,0;47,0;10,0;33,0;;15,0;;159,0;17,0;;12,0;47,0;1,0;10,0;473,0;21,0;67,0;125,0;271,0;6,0;;5,0;9,0;;5,0;63,0;3,0;16,0;;;499,0;202,0;3,0;109,0;17,0;12,0;2,0;15,0;62,0;;20,0;10,0;4,0;95,0;43,0;1,0;162,0;1,0;;3,0;98,0;43,0;68,0;46,0;56,0;1,0;;31,0;159,0;693,0;370,0;;;;13,0;7,0;16,0;6,0;;13,0;14,0;4,0;143,0;13,0;23,0;50,0;3,0;45,0;32,0;42,0;3,0;;;203,0;6,0;15,0;;270,0;373,0;8,0;;197,0;;40,0;28,0;52,0;79,0;244,0;;1,0;;67,0;16,0;1,0;;40,0;;;;38,0;14,0;4,0;;2,0;2,0;1,0;56,0;;;;4,0;;6,0;1,0;;;1,0;;7,0;;;6,0;1,0;;;;;;16,0;4,0;;;;43,0;6,0;;11,0;;6,0;;;;1,0;;;;;;3,0;2,0;;2,0;;180,0;;4,0;;8,0;4,0;2,0;17,0;7,0;6,0;;1,0;;1,0;1,0;4,0;;;;6,0;9,0;3,0;;;;2,0;;;365,0;2,0;;;;;;83,0;;;;;1,0;;;21,0;1,0;;;;242,0;2,0;6,0;5,0;22,0;4,0;9,0;;;133,0;;10,0;;;19,0;2,0;1,0;2,0;;4,0;2,0;;;;2,0;5,0;1,0;;;10,0;;6,0;;1,0;;;;;3,0;8,0;;;;15,0;;;;;14,0;;;;1,0;3,0;;;;;;13,0;4,0;4,0;28,0;;;;5,0;7,0;8,0;4,0;3,0;12,0;5,0;8,0;;;3,0;25,0;;;1,0;30,0;6,0;;;3,0;;;;;;1,0;;;1,0;16,0;;8,0;;;;;15,0;9,0;;;3,0;;9,0;13,0;;;;5,0;1,0;28,0;2,0;93,0;;23,0;;;;1,0;1,0;2,0;15,0;7,0;;;2,0;1,0;14,0;32,0;89,0;31,0;30,0;2,0;108,0;;1,0;;3,0;1,0;;2,0;5,0;11,0;4,0;1,0;1,0;4,0;;3,0;;122,0;17,0;2,0;21,0;;3,0;2,0;27,0;;10,0;7,0;25,0;11,0;10,0;28,0;90,0;4,0;21,0;7,0;;;;21,0;10,0;103,0;43,0;25,0;;13,0;3,0;;1,0;9,0;;5,0;6,0;;12,0;15,0;;4,0;1,0;4,0;165,0;;13,0;2,0;2,0;;71,0;3,0;3,0;3,0;17,0;;5,0;2,0;;5,0;;10,0;61,0;497,0;;;3,0;13,0;26,0;;7,0;;2,0;55,0;4,0;;22,0;;2,0;8,0;4,0;38,0;;6,0;4,0;12,0;2,0;2,0;;77,0;7,0;28,0;2,0;27,0;6,0;23,0;3,0;1,0;2,0;2,0;7,0;8,0;2,0;3,0;;2,0;32,0;28,0;20,0;9,0;2,0;;10,0;;2,0;8,0;2,0;9,0;;32,0;;;4,0;25,0;10,0;1,0;2,0;;;36,0;9,0;10,0;;1,0;;16,0;11,0;29,0;3,0;;16,0;1,0;16,0;;1,0;16,0;;;;;2,0;1,0;;2,0;18,0;1,0;3,0;10,0;;2,0;13,0;9,0;;;2,0;;3,0;4,0;3,0;6,0;7,0;2,0;50,0;8,0;;4,0;11,0;;;9,0;;5,0;3,0;1,0;2,0;3,0;;18,0;9,0;102,0;;4,0;;;1,0;2,0;11,0;2,0;;;6,0;;;7,0;9,0;6,0;6,0;;4,0;2,0;;17,0;;1,0;2,0;1,0;3,0;;33,0;8,0;24,0;31,0;3,0;;;4,0;3,0;;;;;;;;4,0;;;;;7,0;;;120,0;2,0;;3,0;;2,0;;2,0;;1,0;3,0;;;;75,0;19,0;;;2,0;1,0;;;;;15,0;;4,0;;;;16,0;1,0;;;2,0;6,0;;;;;1,0;1,0;;;;;;;;;;;7,0;;;;2,0;;;1,0;;;16,0;1,0;;;;;20,0;;5,0;;;;4,0;;;1,0;;;;;;;;;5,0;2,0;;;;;7,0;10,0;4,0;;;11,0;;;14,0;1,0;;2,0;;;6,0;1,0;12,0;2,0;;;;1,0;3,0;5,0;;20,0;2,0;6,0;;7,0;5,0;;;;1,0;1,0;3,0;9,0;2,0;9,0;;;;;1,0;51,0;5,0;;;2,0;1,0;;;;;;1,0;;3,0;6,0;16,0;;5,0;36,0;;;1,0;4,0;;;1,0;2,0;;15,0;;;;1,0;;;9,0;13,0;1,0;1,0;1,0;;;2,0;37,0;1,0;3,0;1,0;7,0;5,0;6,0;;2,0;;;;;10,0;1,0;19,0;;;;;;;1,0;;3,0;;;;3,0;;;24,0;;2,0;;;1,0;1,0;;3,0;7,0;;;;;;1,0;3,0;;;;2,0;2,0;;;;12,0;;;;;1,0;1,0;;;;1,0;;1,0;;;2,0;;2,0;;;;;;;9,0;;;;;2,0;;2,0;;;;;2,0;;10,0;;;;;;;;;;2,0;;;;5,0;;;;4,0;1,0;1,0;;;;;;;;;1,0;;;;1,0;1,0;5,0;;3,0;;2,0;;17,0;;1,0;1,0;3,0;;;;;;;3,0;
interchangeable;5,0;45,0;;18,0;;3,0;31,0;228,0;2,0;14,0;;;1,0;;11,0;28,0;;3,0;7,0;;;5,0;9,0;;3,0;1,0;;;2,0;2,0;;23,0;64,0;2,0;197,0;91,0;2,0;20,0;1,0;;118,0;;1,0;;99,0;20,0;30,0;51,0;7,0;9,0;3,0;17,0;9,0;1,0;103,0;1,0;5,0;19,0;;;;;2,0;;1,0;23,0;66,0;18,0;8,0;;3,0;;45,0;2,0;;1,0;5,0;;;87,0;;73,0;1,0;186,0;;5,0;;;;20,0;2507,0;;;;;3,0;10,0;;30,0;;;;2,0;7,0;1,0;41,0;152,0;6,0;43,0;3,0;3,0;35,0;2,0;1,0;1,0;37,0;19,0;62,0;35,0;47,0;3,0;;13,0;4,0;;;3,0;3,0;;21,0;8,0;15,0;;22,0;;;1,0;21,0;1,0;8,0;;;46,0;42,0;37,0;;;10,0;231,0;3,0;6,0;;26,0;27,0;22,0;39,0;283,0;;5,0;1,0;1,0;56,0;437,0;2,0;2,0;;2,0;4,0;;;67,0;;;;9,0;;7,0;5,0;;;1,0;631,0;;;;2,0;;14,0;;;;;2,0;57,0;1,0;123,0;;;;;;;1,0;10,0;;2,0;;;7,0;1,0;;;;;;;;;4,0;;2,0;7,0;3,0;;;;;2,0;5,0;;42,0;4,0;;269,0;17,0;1,0;2,0;2,0;2,0;1,0;1,0;;;23,0;;;2,0;;;4,0;4,0;;;;;;74,0;;;;;;;1,0;;1,0;;;3,0;;1,0;1,0;;;;3,0;11,0;16,0;;5,0;4,0;31,0;27,0;;;40,0;;1,0;;;1,0;;;;;;;;1,0;;;2,0;110,0;;;;3,0;3,0;;;;3,0;;;1,0;6,0;1,0;;;;;8,0;2,0;;82,0;;2,0;2,0;;;;1,0;1,0;;;23,0;20,0;1,0;21,0;;;1,0;4,0;;27,0;;3,0;5,0;;1,0;;;;13,0;;;;12,0;;;3,0;4,0;;;3,0;;;5,0;;;;;18,0;;;;4,0;5,0;;;;;;;;3,0;;;;15,0;;2,0;;;;49,0;;;;;;;;;;;2,0;;10,0;7,0;4,0;;;;;1,0;;;;;;1,0;68,0;4,0;;;1,0;7,0;;;;32,0;6,0;3,0;;;;1,0;37,0;;;;25,0;;;26,0;75,0;;;7,0;17,0;;;2,0;;3,0;;;;;1,0;;14,0;20,0;;;7,0;;;1,0;;;2,0;2,0;11,0;;;;19,0;;13,0;1,0;;3,0;;;;1,0;;;;;;3,0;;1,0;;3,0;4,0;;6,0;;;2,0;;1,0;;;;;;;;;;;;;1,0;;3,0;;47,0;6,0;;;1,0;;;;;;1,0;6,0;;;42,0;;;3,0;3,0;;;2,0;;5,0;;10,0;;7,0;;;2,0;3,0;;10,0;;2,0;;2,0;;;;50,0;5,0;66,0;4,0;90,0;;1,0;;;;;;4,0;;;;;;;;3,0;;;;;3,0;;12,0;;1,0;;;;;;;;;;;5,0;;5,0;;1,0;;;;;;;;;;;;;;;;2,0;6,0;1,0;;;4,0;2,0;1,0;;;1,0;;;;;;;1,0;;;16,0;;1,0;;;;;;5,0;;;1,0;1,0;;;;;;72,0;;;2,0;;;;71,0;90,0;3,0;;;2,0;4,0;1,0;;4,0;;;;;;;;;1,0;28,0;;;;;;;;;1,0;6,0;;;;4,0;;;;;;;;;1,0;;;1,0;;;;;3,0;;1,0;;;;;;1,0;;;;;;;;;;;;;;;;;5,0;3,0;;;;;;;2,0;;;;;;1,0;28,0;;;;;;2,0;;;;;;;;1,0;2,0;;1,0;;;;8,0;;;;;1,0;;;;;;;;;;;;;;;13,0;;;2,0;1,0;;;;;;;9,0;6,0;;;;;;;;;;;;;;;4,0;;;;;1,0;;1,0;;;;;;2,0;;;;;;;1,0;7,0;;;;;;;;;;;2,0;;;;;;;;;;;;;1,0;;;;;;;;1,0;;;;;;;;1,0;;;;;1,0;;;;;;;;;;;;;;;;;;;;;;;;1,0;;;;;;;1,0;;1,0;;;5,0;;;;;;1,0;;;;;;;;;;;;;;;;;;1,0;;;;;;;;42,0;2,0;;;;;;;;;;;;;;;;;;;;1,0;;;;;;;;;;;;;;;;;;
judge;8,0;;;;11,0;;;9,0;21,0;;;;;;;9,0;;;11,0;;;;6,0;;;2,0;32,0;;;;1,0;14,0;17,0;;7,0;3,0;1,0;4,0;;;22,0;;;;4,0;2,0;11,0;37,0;7,0;1,0;;20,0;;;4,0;5,0;;;;;;;;;;;2,0;;6,0;;1,0;;;3,0;;;;;;32,0;;;1,0;6,0;;9,0;;;;;2,0;;;;;;1,0;;3,0;;;;34,0;60,0;;7,0;;;2,0;6,0;;16,0;;;2,0;;16,0;18,0;;5,0;;;1,0;1,0;;;;;;1,0;;1,0;;;2,0;2,0;;1,0;;4,0;7,0;;;4,0;2,0;;;;5,0;;;;1,0;11,0;10,0;;;;16,0;21,0;1,0;;56,0;;;;6,0;;;;;;;;;;;;;;;1,0;;;;;;3,0;;;;;;;;2,0;;;;1,0;;;1,0;12,0;;;;;;9,0;;;;;;;;;;;;;;;;;;;1,0;;;;;;;3,0;13,0;;;;;;;2,0;;;;;10,0;;;;;;;;10,0;;;;;;;3,0;;;;;6,0;;;;;;;;3,0;;;;;;;;;3,0;;;;;25,0;;1,0;;;;;;;;;;1,0;;;;;;;;;;;;;;;;;;;;;;3,0;;;;;;;;;;;;;;;;;;;;3,0;;;;;3,0;;;;;;;;;;;;;;;;;;;;;;;;;;;;;;;;;7,0;;;2,0;;;;;1,0;;4,0;;;;;;;;;;;;;;;;1,0;4,0;2,0;;4,0;;;;;;;;;;2,0;1,0;;;;21,0;;1,0;;;;;;;;;1,0;;;;;;2,0;;13,0;;1,0;;8,0;;;;10,0;;;;;;;;;5,0;;;;;4,0;3,0;;;;;;;;;;;;;4,0;3,0;;1,0;;;;;;;;;;;;;;;;;;4,0;12,0;;;;1,0;;;;;28,0;;1,0;;;;;;;;;;;;;;;;;;;1,0;;;;;;;;;;;;;;;;;;;;;;;;;;;;;3,0;;;;8,0;;;;;;;;;;;;;;;;;1,0;;;;;;1,0;;;10,0;;;;;;;;;;;;;;;;;;;1,0;;;;;;8,0;1,0;;;;;1,0;;4,0;;;;;;;;;;;;;;;;;;;;;;;;;;;;;;1,0;;;;;;;;;;;;;;4,0;;;;;;;;;;;;;;;;;;;;;;;;;;;;;;;;;;;;;15,0;;;;;;;;;;;;;;;;;;;;;;;;;;;;;;;;;;;;;;;;;;;;;;;;1,0;;;2,0;;;;;;;;;;;;;;1,0;4,0;;;1,0;;;;23,0;;;;3,0;;;;4,0;;2,0;;;1,0;;;;;;2,0;5,0;;;;;3,0;;;;;;;;;;;;;;1,0;;;;;;;;1,0;3,0;;;;;;;;;;;;;;;;2,0;;;;;;1,0;;;;;;;6,0;;;;4,0;;;;;;;;;;;;;;1,0;;;;;;;;;;;;;;;;;;;;;;;;;;;;;;;;;;;;;;;;;;;;;;;;;;;;;;;;;;;;;1,0;;;;;;;;;;;;;;;;13,0;;;;;;;;;;;;;;1,0;;;;;;;;;;;;;;;;;;;;;55,0;;;;;;;;;;;;
lateral;10,0;19,0;;;;;1,0;2,0;7,0;14,0;1,0;;;;12,0;23,0;;;;;1,0;3,0;;3,0;;;;;;1,0;;35,0;5,0;;;1,0;;;;1,0;;;2,0;1,0;3,0;;3,0;16,0;;;11,0;30,0;7,0;;1,0;18,0;;;1,0;;17,0;2,0;;;1,0;;27,0;18,0;2,0;17,0;;;;;7,0;;;;1,0;50,0;;1,0;;18,0;5,0;;;;;;109,0;;;6,0;;;1,0;;3,0;2,0;9,0;;20,0;6,0;;;21,0;;1,0;1,0;2,0;1,0;;;;6,0;31,0;13,0;11,0;1,0;2,0;;;;;;;;;;;1,0;12,0;;3,0;;3,0;;;24,0;4,0;;;39,0;;;;103,0;1,0;1,0;;;;;;;3,0;7,0;1,0;1,0;;;86,0;;1,0;;;3,0;;1,0;;;1,0;1,0;;3,0;4,0;22,0;4,0;;;33,0;4,0;1,0;;2,0;1,0;1,0;;;;;;5,0;;8,0;;;;4,0;;;;34,0;1,0;1,0;;;;53,0;;;;;;;3,0;;2,0;5,0;18,0;1,0;26,0;1,0;;;;;4,0;;12,0;;1,0;30,0;6,0;3,0;16,0;13,0;12,0;21,0;1,0;;1,0;1,0;;;;;1,0;5,0;20,0;;7,0;;;;5,0;1,0;5,0;;;;4,0;1,0;;1,0;21,0;15,0;;;;;10,0;2,0;;24,0;;7,0;4,0;95,0;;;2,0;1,0;1,0;;;;;;43,0;2,0;3,0;;21,0;;4,0;;;;3,0;3,0;26,0;;;;2,0;7,0;7,0;2,0;;9,0;;;;;;2,0;;;;;;2,0;;;8,0;1,0;;;;;;;;;1,0;5,0;3,0;16,0;;3,0;;;9,0;;;;3,0;;1,0;5,0;;;;1,0;2,0;2,0;3,0;;;6,0;1,0;5,0;1,0;2,0;;5,0;1,0;;2,0;;;3,0;;;4,0;;1,0;1,0;1,0;1,0;;2,0;;;;;;11,0;3,0;;;;4,0;;1,0;1,0;3,0;2,0;1,0;;;;;;;;;2,0;1,0;;2,0;;4,0;;;;;;;1,0;;;;;;1,0;;;;1,0;5,0;;3,0;;;;;;2,0;7,0;1,0;;;;1,0;;19,0;;;;;;1,0;;;;;;;;;5,0;;2,0;;2,0;;;1,0;;;;1,0;;;1,0;;;;2,0;;5,0;1,0;;;1,0;;2,0;;;;;;5,0;;;;;1,0;;;2,0;;;;;;;;;;;;;;;;;;1,0;;;;;;;;;;;;;;2,0;;;;;;6,0;;2,0;;;;;;;;;;;;;;;7,0;;2,0;5,0;;;;;2,0;;;;;;;;;2,0;2,0;;;2,0;;;;;;;;;12,0;13,0;;;;;4,0;;;;12,0;;16,0;;;;;2,0;;1,0;;;1,0;;;;;;;4,0;;;;;1,0;;;;1,0;;;;;;;;;;;1,0;;;;;;;;;2,0;;;;;;;;1,0;21,0;2,0;1,0;;5,0;1,0;;;1,0;;1,0;;4,0;;;;1,0;;;;;;1,0;;;4,0;;5,0;;;3,0;;2,0;3,0;;;;3,0;;;11,0;;;1,0;3,0;;15,0;;;2,0;2,0;;;;;;;;13,0;15,0;;;;;4,0;;;;;;1,0;1,0;;;;;;1,0;;1,0;;;6,0;;2,0;;;;2,0;;;;;;;1,0;;;;1,0;2,0;;;1,0;;;;;;;;;;;;;;;;;1,0;;2,0;;2,0;;;;;2,0;;;;;;;;;;;;;;;;;;;;;;2,0;;;;92,0;;13,0;;1,0;;;;;;;;;;;;;;;;;;1,0;;;;;;;;;;;;;;;;;;;;;;;;;;;;;;;;;;;;;;;;;;;;;;;4,0;2,0;1,0;;;;;;;;;;;;;;;1,0;;;;;;;;;;1,0;;;;;;2,0;1,0;;;18,0;;;;;;;;4,0;;2,0;;;6,0;;;;;;;;;;;;;;;;;;;;5,0;;;;;;;;;;;;;;;;;;;;;;;;;;;;;;;;1,0;;;;;5,0;;;;;;;;;2,0;;;;
length;1,0;19,0;;;;40,0;48,0;42,0;9,0;20,0;24,0;1,0;23,0;;31,0;122,0;1,0;10,0;;2,0;5,0;56,0;10,0;16,0;2,0;2,0;8,0;30,0;7,0;2,0;2,0;270,0;68,0;19,0;47,0;15,0;7,0;6,0;;;32,0;8,0;15,0;22,0;24,0;1,0;86,0;72,0;14,0;34,0;4,0;188,0;6,0;17,0;13,0;29,0;164,0;3,0;3,0;;139,0;;17,0;;13,0;3000,0;106,0;30,0;22,0;22,0;9,0;;9,0;;2,0;121,0;2,0;1,0;3,0;263,0;23,0;57,0;;57,0;13,0;5,0;20,0;;;;1721,0;;;;16,0;9,0;18,0;;90,0;4,0;2,0;;92,0;111,0;10,0;1,0;194,0;4,0;14,0;57,0;7,0;12,0;;3,0;;79,0;110,0;91,0;25,0;156,0;1,0;3,0;4,0;23,0;15,0;2,0;;2,0;2,0;50,0;3,0;18,0;21,0;;67,0;18,0;22,0;2,0;11,0;255,0;38,0;;2,0;59,0;29,0;3,0;;125,0;17,0;18,0;1,0;10,0;2,0;11,0;11,0;8,0;1181,0;825,0;25,0;13,0;5,0;1,0;869,0;1,0;70,0;;31,0;39,0;3,0;26,0;256,0;;1,0;;29,0;3,0;33,0;2,0;;;8,0;14,0;;;;9,0;;28,0;;;1,0;1,0;;16,0;3,0;4,0;;;1,0;12,0;1,0;6,0;64,0;230,0;;4,0;2,0;;24,0;10,0;;2,0;3,0;7,0;6,0;;10,0;3,0;41,0;11,0;9,0;3,0;53,0;1,0;1,0;19,0;26,0;3,0;45,0;;27,0;16,0;26,0;38,0;7,0;14,0;18,0;73,0;1,0;68,0;2,0;;;22,0;4,0;;2,0;3,0;48,0;18,0;24,0;;;1,0;;4,0;13,0;1,0;2,0;2,0;;;8,0;52,0;;1,0;13,0;3,0;3,0;;11,0;6,0;12,0;;;3,0;1,0;35,0;1,0;77,0;2,0;;9,0;4,0;;158,0;45,0;;;;6,0;49,0;1,0;;3,0;;4,0;;22,0;;31,0;9,0;20,0;9,0;1,0;2,0;2,0;2,0;10,0;;;11,0;7,0;92,0;5,0;6,0;1,0;5,0;;15,0;2,0;3,0;11,0;4,0;4,0;;5,0;1,0;;;48,0;;10,0;6,0;2,0;3,0;;3,0;2,0;3,0;;3,0;;7,0;580,0;15,0;4,0;4,0;15,0;9,0;2,0;8,0;;1,0;1,0;13,0;5,0;45,0;7,0;26,0;;3,0;;1,0;16,0;7,0;1,0;10,0;4,0;;7,0;2,0;4,0;1,0;;9,0;102,0;1,0;;;3,0;1,0;27,0;5,0;;4,0;;2,0;;38,0;1,0;26,0;1,0;;5,0;6,0;;78,0;1,0;2,0;;5,0;;6,0;6,0;;;2,0;2,0;58,0;49,0;;19,0;277,0;5,0;9,0;2,0;2,0;15,0;1,0;;2,0;10,0;10,0;;1,0;;1,0;;2,0;;13,0;9,0;4,0;19,0;6,0;12,0;20,0;14,0;1,0;3,0;3,0;4,0;;;11,0;6,0;7,0;9,0;20,0;41,0;2,0;;2,0;21,0;20,0;;;2,0;1,0;4,0;;;7,0;1,0;2,0;;;17,0;19,0;2,0;;;4,0;10,0;;3,0;1,0;7,0;1,0;83,0;3,0;8,0;10,0;7,0;;8,0;;1,0;5,0;;;;2,0;11,0;;4,0;1,0;2,0;3,0;37,0;;;25,0;2,0;;5,0;;5,0;1,0;7,0;;;;;1,0;3,0;;;;;1,0;25,0;10,0;16,0;4,0;;5,0;4,0;1,0;;2,0;2,0;22,0;;6,0;34,0;2,0;;19,0;;1,0;;31,0;;3,0;29,0;;3,0;2,0;;29,0;;1,0;;8,0;;;;;;2,0;1,0;13,0;3,0;;3,0;1,0;;12,0;3,0;2,0;2,0;;;3,0;;5,0;;4,0;1,0;2,0;;;;2,0;;;4,0;;;;;;3,0;1,0;;;30,0;;13,0;;3,0;1,0;;12,0;1,0;2,0;;;;4,0;3,0;;;1,0;1,0;2,0;;1,0;;;;;1,0;;17,0;2,0;;4,0;;;1,0;14,0;1,0;;1,0;1,0;;2,0;6,0;9,0;;;;;;11,0;2,0;;3,0;4,0;;6,0;57,0;4,0;6,0;1,0;;3,0;1,0;;;;3,0;2,0;1,0;15,0;;7,0;1,0;15,0;1,0;;;;;1,0;4,0;6,0;2,0;2,0;13,0;;;23,0;1,0;5,0;;7,0;1,0;;2,0;;;7,0;1,0;;9,0;3,0;;1,0;;;2,0;;;1,0;1,0;1,0;2,0;;;9,0;;3,0;;;8,0;;;;2,0;;;9,0;;2,0;1,0;3,0;;1,0;26,0;1,0;2,0;;1,0;4,0;12,0;2,0;;;;;;;;;;;;;;;;;;2,0;;;1,0;;;;2,0;1,0;20,0;;;;4,0;1,0;5,0;12,0;4,0;;;;;30,0;;;;11,0;;;;;;;;;17,0;1,0;;;;;;2,0;28,0;1,0;2,0;;1,0;3,0;;;;;14,0;;197,0;;9,0;;;;;;8,0;;40,0;2,0;;;4,0;;;;;1,0;10,0;;19,0;;3,0;5,0;;;2,0;;2,0;16,0;5,0;1,0;;1,0;;;;;4,0;1,0;;;;8,0;;2,0;;;;;;;;;;5,0;;;3,0;3,0;;;;4,0;;;;;;;7,0;;;1,0;;;4,0;8,0;1,0;;1,0;;2,0;;;;;;2,0;;2,0;6,0;;2,0;;;2,0;;1,0;1,0;;;5,0;2,0;;2,0;;;2,0;4,0;3,0;;;1,0;1,0;49,0;4,0;16,0;;;;;;3,0;2,0;;1,0;;;;2,0;;5,0;;1,0;6,0;;3,0;3,0;9,0;;5,0;10,0;;13,0;27,0;52,0;;1,0;;49,0;1,0;;;;1,0;;;24,0;3,0;9,0;2,0;;;;;;;10,0;;4,0;;;;;;1,0;;;16,0;;;1,0;;4,0;2,0
lens;31,0;128,0;51,0;18,0;2,0;367,0;645,0;999,0;100,0;653,0;485,0;287,0;135,0;6,0;1709,0;686,0;90,0;168,0;28,0;18,0;56,0;524,0;112,0;62,0;16,0;10,0;53,0;100,0;47,0;90,0;6,0;856,0;1062,0;76,0;972,0;586,0;95,0;173,0;23,0;166,0;287,0;153,0;385,0;40,0;469,0;194,0;279,0;1240,0;210,0;98,0;694,0;958,0;89,0;26,0;1019,0;75,0;4159,0;54,0;28,0;3,0;216,0;51,0;254,0;2,0;259,0;1933,0;2382,0;1544,0;426,0;514,0;134,0;62,0;195,0;9,0;6,0;2400,0;23,0;26,0;48,0;5156,0;218,0;1535,0;28,0;3450,0;115,0;63,0;2507,0;2,0;109,0;1721,0;;1,0;4,0;258,0;9,0;38,0;79,0;;805,0;34,0;22,0;13,0;2756,0;1781,0;334,0;197,0;6730,0;584,0;169,0;70,0;266,0;247,0;93,0;22,0;40,0;1420,0;1710,0;2791,0;2146,0;275,0;48,0;52,0;78,0;104,0;81,0;27,0;45,0;8,0;16,0;212,0;49,0;144,0;463,0;61,0;119,0;33,0;216,0;74,0;23,0;868,0;143,0;1,0;75,0;1446,0;136,0;66,0;42,0;2634,0;1102,0;109,0;43,0;212,0;96,0;162,0;191,0;93,0;5124,0;373,0;154,0;47,0;10,0;179,0;12109,0;16,0;228,0;16,0;86,0;307,0;49,0;7,0;4739,0;5,0;103,0;193,0;257,0;74,0;1566,0;2774,0;28,0;1,0;197,0;1423,0;94,0;58,0;3,0;211,0;29,0;257,0;872,0;17,0;15,0;4,0;87,0;306,0;175,0;286,0;1,0;;37,0;466,0;166,0;32,0;36,0;987,0;52,0;31,0;200,0;13,0;58,0;311,0;50,0;37,0;99,0;1,0;68,0;5,0;96,0;22,0;49,0;284,0;932,0;172,0;279,0;22,0;18,0;46,0;48,0;4,0;1273,0;98,0;841,0;59,0;108,0;1466,0;448,0;1315,0;421,0;400,0;150,0;245,0;19,0;46,0;54,0;340,0;18,0;;17,0;12,0;86,0;335,0;270,0;9,0;14,0;12,0;15,0;1,0;1221,0;193,0;15,0;748,0;10,0;42,0;62,0;78,0;6,0;43,0;283,0;83,0;171,0;6,0;34,0;128,0;325,0;197,0;1,0;165,0;60,0;247,0;388,0;2395,0;79,0;37,0;135,0;170,0;6,0;498,0;50,0;21,0;26,0;121,0;63,0;45,0;83,0;132,0;122,0;13,0;17,0;3,0;74,0;38,0;507,0;142,0;506,0;143,0;54,0;27,0;61,0;91,0;145,0;19,0;2,0;122,0;107,0;58,0;285,0;56,0;5,0;28,0;211,0;448,0;87,0;84,0;171,0;35,0;790,0;2,0;179,0;38,0;1,0;78,0;11,0;3,0;88,0;37,0;8,0;60,0;29,0;245,0;396,0;1239,0;53,0;12,0;120,0;73,0;1005,0;32,0;43,0;82,0;169,0;78,0;82,0;143,0;5,0;333,0;77,0;23,0;15,0;276,0;44,0;45,0;33,0;88,0;32,0;104,0;144,0;8,0;7,0;345,0;61,0;57,0;23,0;19,0;41,0;6,0;16,0;4,0;130,0;57,0;197,0;103,0;58,0;55,0;8,0;50,0;36,0;64,0;56,0;17,0;1,0;630,0;118,0;142,0;27,0;45,0;133,0;215,0;3,0;41,0;60,0;4,0;;;7,0;77,0;13,0;1,0;8,0;12,0;47,0;74,0;253,0;29,0;14,0;302,0;9,0;28,0;44,0;5,0;12,0;4,0;1,0;19,0;181,0;24,0;1,0;1,0;14,0;19,0;;6,0;;75,0;54,0;76,0;131,0;15,0;12,0;46,0;139,0;15,0;22,0;35,0;622,0;;6,0;81,0;374,0;8,0;34,0;35,0;256,0;21,0;3,0;37,0;20,0;51,0;9,0;10,0;5,0;11,0;95,0;11,0;18,0;114,0;42,0;10,0;23,0;;22,0;18,0;4,0;22,0;8,0;9,0;38,0;9,0;3,0;2,0;43,0;16,0;430,0;284,0;2,0;261,0;19,0;3,0;9,0;6,0;9,0;14,0;2,0;14,0;;21,0;14,0;48,0;12,0;8,0;42,0;2,0;348,0;10,0;13,0;370,0;16,0;34,0;62,0;7,0;7,0;10,0;2,0;22,0;4,0;1,0;5,0;9,0;33,0;;12,0;9,0;52,0;6,0;134,0;111,0;3,0;1,0;2,0;15,0;;8,0;;10,0;55,0;28,0;1,0;6,0;212,0;80,0;3,0;708,0;9,0;114,0;6,0;15,0;2,0;45,0;54,0;39,0;77,0;18,0;1,0;1,0;9,0;20,0;1,0;85,0;4,0;4,0;25,0;4,0;;28,0;16,0;187,0;50,0;76,0;52,0;190,0;4,0;106,0;205,0;1,0;149,0;2,0;27,0;44,0;31,0;47,0;3,0;4,0;8,0;35,0;;10,0;151,0;37,0;;;7,0;;30,0;;13,0;50,0;91,0;18,0;2,0;;119,0;2,0;346,0;1,0;6,0;4,0;5,0;49,0;4,0;18,0;;;23,0;1,0;50,0;6,0;45,0;;12,0;6,0;1,0;3,0;3,0;3,0;13,0;38,0;38,0;7,0;162,0;8,0;28,0;16,0;5,0;11,0;;116,0;1,0;;34,0;18,0;2,0;3,0;172,0;20,0;17,0;26,0;2,0;1,0;1,0;54,0;38,0;35,0;16,0;11,0;5,0;104,0;81,0;56,0;40,0;10,0;49,0;27,0;12,0;63,0;;209,0;72,0;11,0;54,0;72,0;111,0;418,0;180,0;12,0;5,0;9,0;24,0;26,0;3,0;7,0;27,0;6,0;4,0;7,0;20,0;8,0;3,0;31,0;3,0;121,0;1,0;207,0;2,0;1,0;9,0;2,0;1,0;19,0;22,0;10,0;94,0;3,0;1,0;7,0;10,0;1,0;28,0;6,0;17,0;72,0;4,0;24,0;4,0;10,0;4,0;111,0;;49,0;2,0;16,0;27,0;25,0;5,0;172,0;195,0;33,0;2,0;228,0;38,0;12,0;13,0;45,0;1,0;2,0;18,0;6,0;37,0;7,0;26,0;111,0;1,0;77,0;6,0;21,0;3,0;44,0;51,0;130,0;11,0;20,0;49,0;;2,0;4,0;1,0;35,0;12,0;51,0;2,0;2,0;58,0;8,0;5,0;;;3,0;11,0;21,0;;3,0;;;3,0;143,0;60,0;25,0;;16,0;;16,0;4,0;161,0;;24,0;4,0;23,0;19,0;7,0;35,0;;3,0;23,0;3,0;7,0;;23,0;;;;2,0;85,0;92,0;36,0;11,0;27,0;13,0;5,0;13,0;;6,0;19,0;11,0;331,0;16,0;248,0;10,0;171,0;10,0;11,0;3,0;22,0;;8,0;;165,0;4,0;13,0;6,0;24,0;1,0;;1,0;;6,0;11,0;10,0;43,0;17,0;21,0;15,0;;9,0;31,0;2,0;23,0;7,0;12,0;;21,0;21,0;81,0;;;;1,0;18,0;;;6,0;3,0;3,0;45,0;13,0;;71,0;;13,0;1,0;6,0;1,0;9,0;6,0;;6,0;27,0;;2,0;10,0;;15,0;7,0;16,0;53,0;9,0;31,0;;12,0;;;3,0;;;12,0;1,0;6,0;;8,0;10,0;16,0;;29,0;12,0;49,0;;24,0;;;22,0;8,0;10,0;2,0;35,0;3,0;2,0;11,0;27,0;43,0;3,0;36,0;17,0;3,0;29,0;2,0;8,0;25,0;32,0;33,0;4,0;19,0;;37,0;59,0;3,0;88,0;;8,0;13,0;;2,0;2,0;;;;174,0;154,0;7,0;18,0;11,0;2,0;;3,0;32,0;6,0;38,0;39,0;15,0;24,0;3,0;6,0;4,0;458,0;12,0;66,0;8,0;11,0;46,0;11,0;31,0;;2,0;32,0;5,0;;3,0;11,0;46,0;33,0;4,0;;5,0;;3,0;;4,0;32,0;10,0;;1,0;3,0;;;;2,0;4,0;;167,0;;1,0;2,0;2,0;;33,0
list;1,0;;;;;;;2,0;;;;;2,0;2,0;;14,0;;;;;;2,0;;3,0;;;;;;;;;18,0;;8,0;11,0;;;2,0;;19,0;;;;3,0;1,0;1,0;23,0;;21,0;;1,0;;;;2,0;;;;;;2,0;;2,0;1,0;;;1,0;3,0;;14,0;;10,0;;;;1,0;;;21,0;;;1,0;42,0;;3,0;;;;;1,0;;1,0;;;;;11,0;9,0;13,0;4,0;;;11,0;;;;3,0;2,0;;;1,0;;;;13,0;2,0;1,0;;10,0;;;;6,0;2,0;;;;;;;;;4,0;;;;;;;8,0;;3,0;;1,0;;;;;;;;1,0;15,0;11,0;;25,0;;;;;6,0;;;;;10,0;1,0;;;;;;;;;;;;;1,0;4,0;;;;1,0;;1,0;;;;;;;;5,0;2,0;;;;;;;;;;;2,0;;;;;;;;;;;;;;;;;;;;;1,0;;;;;;1,0;;;;;;;;;;;;;;4,0;;;;1,0;;;;9,0;;;;;;;23,0;;;2,0;;;;;2,0;;;;;;;;;;;;;;6,0;;;;;4,0;;;;;;;;;;;1,0;;;;;;;;;;;;;;;;;;;;;;;;;;;;;;;;;;1,0;;;;;;;;;;3,0;;;;;;;;;;;;1,0;;;;;;;;;;;;;;;;;;;;;;;;;;;;;;;;;;;;;;;;;1,0;;;;;1,0;;;;;;;;;;;;;;;;;;;;;;;;1,0;;;;1,0;;;;;;;5,0;;2,0;;1,0;;2,0;;11,0;4,0;;;;;;2,0;;5,0;;;;5,0;;;;;;;;;2,0;;;;1,0;3,0;24,0;;;;;;;;;;3,0;;;3,0;5,0;1,0;;1,0;3,0;;;;;2,0;3,0;;;;;;;;;;;;;4,0;;;;;;;;;;;;1,0;;;2,0;;;;1,0;1,0;1,0;;;;;2,0;;;;;;;;1,0;;;;8,0;;;;;;;;;;;;;;;;1,0;1,0;14,0;;;;3,0;;;;7,0;;;8,0;;;;;;2,0;;;;;;6,0;;;;;;;69,0;;;;1,0;2,0;;;8,0;;;;;;;;;;;;24,0;;;;;;;;;8,0;;;;;;;;5,0;;;;;;;;1,0;;;;;;;;;14,0;;;;;;;;;;;;4,0;;;;2,0;;;;;;;;;;;;;;;;;;1,0;;;;;;;;;;;;2,0;;;;;;1,0;;;;;;;;;;;;;;;;;;;;;3,0;;;;;;;2,0;;;;;;;;;;;;;;;;;;;;;;;;;;;1,0;;;;;;2,0;;;;;;;;;3,0;;;;;;;1,0;;;;;;;;;2,0;;;;;;;;;;;;;;;;;;;;;;;;1,0;;;;;;;;;;2,0;;;;3,0;;;;2,0;;;;2,0;;;;;;2,0;1,0;;1,0;;;;;;3,0;;;;;;;;;;;;;;;;1,0;;;;;;;;;;;;;;;;;;;;;;;;;;;;;;;;;;;;1,0;;;;;;;;;;;;;;;;;;;;;;;;;;8,0;;;;;;;;;;;;;;;;;;;;;;2,0;;;;1,0;;;;;;;;;;;;;12,0;;;;;;;;;;;;;;;;;;;;;;;;;;;;;;;1,0;
logic;2,0;;;;;;;7,0;;3,0;;;6,0;;;6,0;;;;;;7,0;;;;;4,0;7,0;;;21,0;6,0;67,0;;42,0;;;;2,0;;11,0;;;17,0;8,0;;16,0;24,0;16,0;13,0;6,0;;;;2,0;2,0;20,0;2,0;1,0;13,0;;12,0;1,0;1,0;5,0;;;1,0;8,0;;15,0;;6,0;1,0;;;10,0;;;36,0;;3,0;;36,0;;16,0;;;;;4,0;1,0;;;;9,0;5,0;1,0;7,0;;;2,0;6,0;4,0;;15,0;4,0;;59,0;3,0;;10,0;;;1,0;15,0;10,0;14,0;4,0;;;;3,0;23,0;19,0;5,0;;;;;;3,0;;;;;;2,0;;;1,0;;1,0;4,0;1,0;;;1,0;50,0;;1,0;1,0;5,0;6,0;2,0;3,0;26,0;;;3,0;4,0;2,0;18,0;;;;18,0;4,0;;;1,0;;;;;4,0;2,0;;;;;;;;1,0;66,0;;2,0;;;;;;2,0;;;;;;;;;;;;;;2,0;2,0;1,0;;;;19,0;;;;;;;;;;;;;;;9,0;1,0;;;;1,0;;;;;;;;;;;3,0;;;1,0;12,0;;;;;;;;30,0;;;;;;;3,0;;;;;1,0;;;4,0;2,0;;;;;;1,0;;4,0;1,0;;;;;;6,0;;;2,0;;;;;;;;;;;;;;;1,0;;32,0;;;;;8,0;;1,0;2,0;;;;8,0;;;;;3,0;;;;;;;;;;;;;;14,0;;;;;;;;;;;1,0;;;;2,0;;;;2,0;1,0;;;2,0;;;;;4,0;;;;1,0;;;5,0;;;;;;;;;;;;;;;;1,0;;4,0;;1,0;;;;;;;;;;5,0;;;1,0;1,0;;7,0;;3,0;5,0;;1,0;;;;;;;;;;;;;;;;;43,0;9,0;;1,0;;;;2,0;;;;;;10,0;11,0;8,0;;;1,0;4,0;;;;1,0;5,0;;;;;2,0;;4,0;;;;;;4,0;;;;;1,0;9,0;;;;5,0;;;;2,0;;;8,0;;;;;;;;45,0;;;;1,0;4,0;4,0;;;;;;;;;2,0;;3,0;12,0;;;;;;;;;;4,0;;;;1,0;1,0;;;2,0;;5,0;;1,0;;;;;4,0;;;;;;;;;;;3,0;;;;;3,0;;;;;1,0;;;;;;35,0;;5,0;;;;6,0;;;;4,0;;;;;;;;;;;;1,0;;;5,0;;;;1,0;;;2,0;;;;;9,0;4,0;;1,0;1,0;;;;1,0;2,0;;;;2,0;;5,0;;9,0;12,0;;;6,0;2,0;;1,0;;;;;;;;1,0;;;;5,0;;1,0;14,0;1,0;;;;;;3,0;;;;;;;;;;;;;2,0;;;;;;;;;;;;1,0;;;;;;;;;;;;;2,0;;5,0;;;;;;;;;;;;;;;;;;;;;;;;;;;;;;;;;;;;;;;5,0;;;;1,0;;;;;;;;;2,0;;;;;;2,0;;;;;;;;;1,0;;;;;;1,0;;;;;;;;;;;;;;;;;;;;;;;;1,0;;;;2,0;;;;1,0;;;;;;;;;;;;;4,0;;;;;;;;;;;;;;;;;;2,0;;;;;;;;;;;;;;;;;1,0;;;;;;;4,0;10,0;;;13,0;;1,0;;;1,0;2,0;;;;;;;;;;;;;;;;;;;;;;;;2,0;;;;;;;;;;;;;;;;;;;;12,0;;;;;;;;;;;;;;;;;;;;;4,0;;;;6,0;;;;;3,0;1,0;;;;;;;;;;;;;;;;;;2,0;;;;;;2,0;;;1,0;;;;1,0;;;;;;;;;;;;;;;;;;;;;;;;;;;;;;;;;;;
material;1,0;1,0;;;;1,0;6,0;37,0;13,0;21,0;11,0;;7,0;;4,0;20,0;2,0;;;1,0;4,0;8,0;;5,0;1,0;8,0;19,0;7,0;1,0;1,0;14,0;6,0;17,0;;6,0;;;;1,0;;7,0;1,0;16,0;;1,0;4,0;11,0;80,0;2,0;31,0;46,0;38,0;;;1,0;103,0;50,0;;;;8,0;7,0;4,0;6,0;10,0;2,0;4,0;252,0;6,0;19,0;3,0;2,0;3,0;;2,0;33,0;1,0;5,0;2,0;104,0;;40,0;;93,0;;;;;6,0;;258,0;;;;;3,0;4,0;;85,0;4,0;;4,0;84,0;16,0;2,0;1,0;88,0;9,0;4,0;4,0;8,0;2,0;4,0;;;43,0;87,0;18,0;2,0;1,0;2,0;15,0;2,0;2,0;1,0;1,0;11,0;;8,0;;;;3,0;7,0;15,0;;1,0;;;11,0;;;4,0;17,0;1,0;;5,0;86,0;;2,0;;13,0;1,0;4,0;7,0;4,0;56,0;;;7,0;;14,0;46,0;;;;3,0;2,0;6,0;53,0;3,0;26,0;31,0;3,0;3,0;12,0;19,0;6,0;4,0;22,0;10,0;13,0;15,0;15,0;;11,0;33,0;17,0;9,0;4,0;;7,0;3,0;21,0;;15,0;;1,0;8,0;55,0;;1,0;7,0;6,0;;40,0;3,0;1,0;2,0;28,0;66,0;3,0;4,0;2,0;11,0;1,0;2,0;25,0;2,0;20,0;67,0;5,0;10,0;1,0;4,0;20,0;197,0;;182,0;14,0;52,0;41,0;5,0;36,0;1,0;1,0;;171,0;11,0;6,0;5,0;2,0;12,0;10,0;;4,0;10,0;;8,0;4,0;28,0;15,0;2,0;3,0;2,0;;19,0;8,0;1,0;115,0;3,0;35,0;;34,0;77,0;;27,0;36,0;4,0;16,0;5,0;11,0;13,0;11,0;4,0;4,0;;17,0;55,0;141,0;;;5,0;30,0;7,0;4,0;1,0;4,0;1,0;83,0;1,0;2,0;2,0;14,0;14,0;3,0;25,0;;10,0;;5,0;1,0;13,0;;;;1,0;35,0;8,0;;;12,0;1,0;1,0;5,0;1,0;4,0;3,0;1,0;8,0;4,0;2,0;;10,0;2,0;;8,0;;;3,0;;7,0;1,0;4,0;3,0;;9,0;3,0;6,0;12,0;5,0;;20,0;;;1,0;;;;17,0;1,0;6,0;;3,0;14,0;;4,0;6,0;3,0;2,0;10,0;1,0;8,0;8,0;5,0;4,0;;5,0;2,0;;3,0;;3,0;;;16,0;6,0;2,0;;;;;;2,0;18,0;;1,0;;;7,0;22,0;3,0;;6,0;;3,0;;4,0;7,0;;;;;;4,0;;3,0;;1,0;;2,0;;5,0;2,0;;10,0;8,0;3,0;4,0;;;1,0;5,0;;;;;;;;;16,0;4,0;1,0;5,0;;1,0;;;;1,0;;11,0;;;3,0;2,0;;;1,0;1,0;;;;;;;;;;2,0;6,0;1,0;;;;;;;2,0;;1,0;;1,0;4,0;2,0;;;1,0;1,0;3,0;12,0;3,0;2,0;;;11,0;;3,0;;;;2,0;;;;;;;;1,0;1,0;;3,0;;;;;2,0;;;4,0;;;;;8,0;;;1,0;;2,0;;1,0;;;2,0;1,0;;1,0;;;;6,0;;5,0;;3,0;;;;13,0;1,0;2,0;;7,0;7,0;2,0;;;;9,0;15,0;5,0;;3,0;;;6,0;;;4,0;6,0;5,0;3,0;;;1,0;;;1,0;;;;8,0;9,0;;4,0;;1,0;;3,0;;1,0;5,0;;;;6,0;;;;;5,0;;4,0;;;;1,0;14,0;;1,0;;;2,0;;9,0;;;;;7,0;2,0;1,0;;;;;;;;3,0;;;;36,0;;;;;;;1,0;2,0;;1,0;3,0;;;1,0;;2,0;;;;;1,0;;;8,0;;;2,0;1,0;5,0;;1,0;14,0;;2,0;;;30,0;50,0;2,0;29,0;1,0;1,0;;;7,0;9,0;;;;;;41,0;1,0;1,0;1,0;6,0;2,0;21,0;;;3,0;;19,0;22,0;2,0;1,0;;;;3,0;;5,0;;;;;;;;;1,0;;;1,0;;1,0;8,0;;3,0;4,0;;4,0;;;26,0;3,0;2,0;4,0;;141,0;4,0;17,0;1,0;5,0;;13,0;1,0;4,0;;2,0;;;2,0;;21,0;;;1,0;39,0;;;4,0;;;;;44,0;1,0;;1,0;;9,0;2,0;;;;;;1,0;;;1,0;;;37,0;;;1,0;7,0;;;1,0;4,0;;;7,0;;2,0;;1,0;;;;;;;3,0;;;10,0;;1,0;;5,0;;4,0;;1,0;;2,0;8,0;;;;;;;2,0;;;;;;;;1,0;;;;;;;;;;;;3,0;;;;2,0;;;1,0;;;;;;;;;;;;;;;;;;;;;;1,0;;;2,0;2,0;;;;;;;;;;;;1,0;;28,0;;;;;;;2,0;;;;;2,0;;2,0;;;3,0;;;;;1,0;;;1,0;5,0;;1,0;;2,0;;;1,0;2,0;;;;;;;;;5,0;5,0;;;;6,0;;;;;2,0;;3,0;;;;;;;;;;1,0;1,0;;1,0;1,0;27,0;;;15,0;;;;1,0;1,0;;;2,0;;;;;;7,0;;;;;;;;;;;;;;;;;;;;;;;;;6,0;;;;;;
measurement;1,0;;;;;17,0;2,0;21,0;20,0;12,0;21,0;;37,0;;13,0;78,0;7,0;4,0;5,0;12,0;33,0;28,0;;5,0;4,0;2,0;4,0;4,0;;4,0;3,0;4,0;32,0;;49,0;3,0;2,0;2,0;1,0;;241,0;;10,0;42,0;22,0;11,0;73,0;59,0;21,0;62,0;;66,0;;;1,0;11,0;10,0;18,0;21,0;;;2,0;12,0;;3,0;3,0;29,0;14,0;10,0;;9,0;2,0;90,0;2,0;1,0;9,0;;3,0;1,0;163,0;1,0;23,0;;39,0;5,0;;;;;16,0;9,0;;;;;7,0;5,0;2,0;110,0;8,0;19,0;;54,0;67,0;2,0;4,0;13,0;8,0;39,0;40,0;2,0;54,0;;1,0;;70,0;23,0;73,0;7,0;22,0;;;22,0;8,0;37,0;1,0;;;5,0;47,0;;50,0;14,0;1,0;9,0;4,0;5,0;43,0;3,0;;9,0;;5,0;59,0;4,0;;;;35,0;4,0;4,0;1,0;1,0;2,0;11,0;;102,0;;3,0;2,0;2,0;3,0;120,0;;4,0;;28,0;9,0;3,0;21,0;1,0;;;;3,0;8,0;6,0;2,0;;1,0;;5,0;;1,0;1,0;;;4,0;;;;5,0;;5,0;;;3,0;2,0;;1,0;;;21,0;8,0;4,0;;2,0;18,0;;;;;14,0;;;;1,0;;3,0;2,0;5,0;;;;2,0;;;;153,0;;2,0;;2,0;7,0;;13,0;8,0;;;;12,0;;3,0;9,0;16,0;;3,0;3,0;14,0;;1,0;1,0;;;;2,0;42,0;7,0;;6,0;;;;1,0;;;3,0;;;;;6,0;3,0;;1,0;;;23,0;;9,0;;1,0;5,0;8,0;;57,0;1,0;;;;36,0;1,0;;;;;2,0;;;;2,0;9,0;1,0;;;;;;;;;1,0;;;3,0;5,0;;;;23,0;;;;;;;;;;;;;;;;4,0;1,0;3,0;2,0;2,0;;;;1,0;;1,0;;2,0;1,0;27,0;;1,0;;6,0;;;;77,0;1,0;;1,0;9,0;;;;;;;;4,0;;;;7,0;;;;;2,0;1,0;;;3,0;;;;;;;;;83,0;10,0;;;2,0;7,0;4,0;;;1,0;23,0;;7,0;;;2,0;5,0;11,0;20,0;20,0;;20,0;;9,0;;;2,0;1,0;;1,0;2,0;5,0;1,0;15,0;3,0;6,0;23,0;;86,0;43,0;2,0;1,0;6,0;32,0;2,0;;99,0;15,0;7,0;3,0;31,0;6,0;2,0;;16,0;3,0;2,0;35,0;4,0;;;;;1,0;2,0;4,0;1,0;;;;;;9,0;;;;2,0;6,0;8,0;3,0;;5,0;5,0;4,0;4,0;5,0;2,0;7,0;;4,0;2,0;;;23,0;1,0;;3,0;;2,0;;9,0;;2,0;4,0;;9,0;1,0;3,0;2,0;6,0;;1,0;;4,0;;2,0;3,0;3,0;1,0;20,0;3,0;;;10,0;;;;;;4,0;;;12,0;1,0;4,0;;;;1,0;;;1,0;;;;4,0;5,0;;4,0;;;;6,0;;7,0;;;;;;;9,0;6,0;;;;;;;;1,0;;7,0;;;3,0;5,0;;1,0;4,0;1,0;1,0;;;;;;;;3,0;;;;25,0;;;;;;;;;2,0;;;;;6,0;;;1,0;2,0;4,0;1,0;16,0;;;3,0;;;2,0;;;;;;;;;;6,0;;2,0;;;22,0;;;;8,0;;;1,0;7,0;;;;;;1,0;1,0;;;;;;;;;6,0;2,0;4,0;;;;6,0;8,0;;;;2,0;2,0;;2,0;;;15,0;;;;;;;;;;;;;;1,0;5,0;;;1,0;;;;;;2,0;;;;;3,0;;;;;;9,0;1,0;;;;3,0;;;;1,0;;;;;;;;;1,0;;;;;5,0;;;;;3,0;;2,0;;30,0;;;;;;2,0;;;1,0;;;;6,0;;;;2,0;8,0;;;4,0;;;;;2,0;;4,0;;;;;;;;;;4,0;2,0;;;1,0;2,0;29,0;;8,0;5,0;6,0;6,0;;6,0;11,0;;4,0;25,0;;12,0;;;;;;2,0;11,0;15,0;8,0;38,0;;;;;1,0;;;;14,0;;;10,0;;;6,0;;1,0;;;;1,0;2,0;1,0;;4,0;;;;;18,0;;10,0;;2,0;;;;;1,0;3,0;20,0;2,0;;;;4,0;;;6,0;;;2,0;6,0;;;;;;;1,0;;;3,0;1,0;;;;;;13,0;1,0;;;;;;;;;;;;;;;8,0;;;;;;;;;1,0;;19,0;;7,0;1,0;;;17,0;;;;;;;;;;29,0;;1,0;;;5,0;;;;1,0;;4,0;;;;;;;;;;;;;4,0;;;;;6,0;10,0;;11,0;4,0;;;;;;;;;;3,0;;;;;1,0;4,0;;;;;;1,0;;;;;;;;;1,0;;1,0;32,0;;10,0;;;;;2,0;;;;;4,0;;;2,0;;;
medium;2,0;3,0;;;11,0;9,0;;58,0;25,0;5,0;3,0;;14,0;6,0;8,0;34,0;;;4,0;4,0;9,0;56,0;3,0;3,0;1,0;5,0;21,0;13,0;;;610,0;6,0;52,0;;107,0;8,0;3,0;9,0;22,0;;254,0;;7,0;8,0;70,0;10,0;93,0;205,0;50,0;109,0;6,0;14,0;6,0;;11,0;5,0;10,0;1,0;11,0;73,0;1,0;3,0;5,0;56,0;4,0;7,0;12,0;21,0;30,0;;10,0;;32,0;;;14,0;12,0;4,0;3,0;434,0;;40,0;12,0;153,0;;499,0;3,0;;;9,0;38,0;;9,0;3,0;7,0;;83,0;;100,0;10,0;7,0;2,0;16,0;38,0;;3,0;11,0;20,0;44,0;34,0;4,0;56,0;1,0;;;49,0;59,0;21,0;28,0;10,0;;;10,0;215,0;107,0;276,0;5,0;;;33,0;;2,0;3,0;;13,0;10,0;9,0;35,0;3,0;;21,0;1,0;2,0;23,0;10,0;6,0;;2,0;47,0;4,0;4,0;;954,0;409,0;6,0;15,0;44,0;;2,0;8,0;916,0;2,0;148,0;;1,0;;49,0;14,0;6,0;6,0;1,0;2,0;;2,0;7,0;2,0;1,0;;;1,0;;11,0;;2,0;3,0;11,0;;8,0;;;2,0;;;11,0;;1,0;2,0;;1,0;;;;3,0;16,0;4,0;1,0;;;12,0;6,0;;4,0;;;1,0;;;1,0;6,0;1,0;3,0;;;38,0;;;3,0;;44,0;;11,0;;;10,0;;4,0;7,0;;2,0;;;;;6,0;;;;3,0;27,0;4,0;1,0;;;1,0;1,0;2,0;59,0;;;23,0;;;;29,0;;;8,0;;2,0;;;6,0;7,0;;;;2,0;9,0;;30,0;27,0;1,0;11,0;13,0;;29,0;1,0;5,0;;1,0;8,0;1,0;;;;1,0;2,0;;;;;4,0;12,0;;;8,0;;1,0;;;;;;;;3,0;;1,0;;39,0;;14,0;;;4,0;;;;;5,0;;;;;;2,0;3,0;3,0;8,0;;;;42,0;4,0;36,0;;;2,0;14,0;7,0;13,0;;6,0;4,0;;;;22,0;3,0;;;;;1,0;;;;;;;1,0;;;;;;;;;2,0;;;4,0;;;1,0;;;;;;17,0;;78,0;;14,0;;;2,0;;;;12,0;1,0;;1,0;;;;18,0;17,0;76,0;13,0;2,0;14,0;;1,0;2,0;;;;2,0;56,0;8,0;2,0;21,0;3,0;21,0;;5,0;;19,0;13,0;2,0;16,0;;3,0;9,0;34,0;;6,0;12,0;12,0;2,0;9,0;3,0;35,0;;5,0;4,0;7,0;;;;3,0;748,0;6,0;3,0;13,0;8,0;4,0;;1,0;;;;;;5,0;9,0;1,0;6,0;;7,0;37,0;;11,0;2,0;9,0;;11,0;2,0;1,0;2,0;2,0;2,0;1,0;3,0;5,0;1,0;;1,0;16,0;123,0;2,0;1,0;;4,0;8,0;2,0;8,0;2,0;1,0;5,0;7,0;;5,0;;23,0;2,0;6,0;12,0;;;17,0;;;;;17,0;4,0;6,0;4,0;3,0;1,0;6,0;9,0;;2,0;;8,0;6,0;11,0;2,0;;;12,0;14,0;3,0;;7,0;;;3,0;8,0;5,0;1,0;19,0;;6,0;1,0;;;3,0;;3,0;;;;;4,0;4,0;;4,0;4,0;3,0;1,0;3,0;3,0;;;4,0;6,0;;;4,0;;;5,0;;2,0;;;2,0;3,0;1,0;7,0;3,0;;;5,0;3,0;55,0;2,0;1,0;;1,0;7,0;2,0;7,0;2,0;7,0;9,0;7,0;1,0;5,0;;;;1,0;1,0;2,0;1,0;;34,0;;;9,0;;526,0;;;;2,0;14,0;6,0;14,0;5,0;;4,0;;;;5,0;6,0;2,0;;3,0;12,0;;;;2,0;;3,0;;4,0;;18,0;;1,0;3,0;10,0;1,0;;13,0;1,0;4,0;;;;;1,0;2,0;1,0;;;1,0;1,0;12,0;;;1,0;;;;;;;;;;4,0;;;3,0;10,0;1,0;;41,0;;2,0;;;;1,0;;3,0;95,0;;;;3,0;4,0;;;5,0;8,0;;;;;;;;;;;;;;;8,0;;40,0;;;1,0;;4,0;;1,0;;;5,0;1,0;;;;;17,0;;1,0;;;;;2,0;;;2,0;;;8,0;;;2,0;;5,0;6,0;;;;;5,0;4,0;6,0;;;;;;12,0;1,0;;;;;3,0;6,0;;;;;;1,0;;;;17,0;4,0;;;;1,0;;;1,0;;;1,0;1,0;;1,0;3,0;2,0;1,0;;;101,0;3,0;3,0;;2,0;;2,0;;;;2,0;;;2,0;2,0;;;;14,0;1,0;;1,0;;;;;;;;;6,0;;1,0;;;3,0;6,0;;4,0;;;;3,0;42,0;4,0;;1,0;52,0;2,0;1,0;;;;2,0;2,0;;;1,0;2,0;;;1,0;;;;1,0;;3,0;;2,0;;;1,0;;;8,0;1,0;1,0;2,0;;1,0;2,0;5,0;1,0;;;;1,0;;;2,0;;;3,0;;2,0;;;;1,0;;;;;;;;5,0;;;;;;;6,0;;9,0;;;;8,0;;;3,0;;;;;;2,0;1,0;2,0;;;;3,0;;;;;;;2,0;;;3,0;;;1,0;;2,0;;1,0;;;1,0;1,0;;;;;;;1,0;;2,0;1,0;;1,0;;;2,0;1,0;4,0;;;;;;2,0;;1,0;;1,0;;;;;19,0;;
memory;12,0;11,0;;5,0;3,0;7,0;16,0;115,0;61,0;16,0;6,0;;43,0;5,0;11,0;37,0;1,0;8,0;3,0;2,0;7,0;102,0;5,0;3,0;7,0;1,0;29,0;2,0;;2,0;127,0;3,0;204,0;;151,0;67,0;6,0;37,0;11,0;;656,0;;8,0;5,0;26,0;18,0;52,0;346,0;234,0;102,0;7,0;27,0;;;8,0;4,0;43,0;11,0;8,0;17,0;2,0;30,0;2,0;49,0;15,0;14,0;26,0;24,0;134,0;3,0;9,0;;40,0;2,0;;19,0;22,0;2,0;5,0;917,0;5,0;28,0;6,0;163,0;1,0;202,0;10,0;1,0;1,0;18,0;79,0;;5,0;4,0;5,0;83,0;;;127,0;13,0;6,0;8,0;165,0;36,0;3,0;10,0;33,0;18,0;85,0;35,0;2,0;34,0;;;12,0;78,0;55,0;40,0;7,0;47,0;3,0;;41,0;192,0;351,0;143,0;;;2,0;10,0;2,0;21,0;2,0;1,0;15,0;20,0;11,0;25,0;28,0;;22,0;3,0;11,0;80,0;22,0;1,0;;24,0;155,0;27,0;2,0;11,0;199,0;1110,0;9,0;2,0;286,0;;4,0;24,0;67,0;33,0;307,0;;;1,0;105,0;14,0;4,0;;2,0;;;;27,0;8,0;19,0;4,0;;;56,0;24,0;;;3,0;40,0;;22,0;4,0;;57,0;4,0;;92,0;1,0;;15,0;;;3,0;;;6,0;29,0;11,0;;;;;9,0;;7,0;9,0;2,0;;;;;;2,0;20,0;;1,0;;2,0;;5,0;;31,0;;4,0;;;17,0;;4,0;4,0;4,0;;;3,0;;;10,0;;;;28,0;38,0;4,0;;2,0;;;;2,0;70,0;3,0;;;;;6,0;47,0;5,0;20,0;38,0;;6,0;;;15,0;53,0;2,0;1,0;7,0;2,0;7,0;9,0;6,0;10,0;2,0;11,0;;5,0;48,0;1,0;14,0;;;9,0;;;;;;1,0;;28,0;;7,0;12,0;3,0;;1,0;5,0;;15,0;;;24,0;2,0;109,0;;4,0;;;13,0;;119,0;;1,0;1,0;3,0;7,0;6,0;;;1,0;;;2,0;4,0;;;7,0;;15,0;24,0;2,0;;;17,0;3,0;12,0;;1,0;2,0;9,0;3,0;;1,0;1,0;12,0;1,0;;1,0;15,0;12,0;2,0;;3,0;1,0;1,0;;;;3,0;;;;;2,0;5,0;11,0;;;;;6,0;;;2,0;;;;;;;12,0;5,0;4,0;;9,0;;7,0;;1,0;1,0;;;6,0;40,0;28,0;1,0;;;;7,0;12,0;7,0;54,0;8,0;8,0;19,0;3,0;;5,0;6,0;1,0;;;6,0;8,0;2,0;;2,0;3,0;;1,0;4,0;66,0;5,0;13,0;46,0;1,0;3,0;6,0;40,0;;6,0;11,0;16,0;8,0;28,0;14,0;32,0;;3,0;16,0;6,0;1,0;3,0;19,0;26,0;167,0;6,0;2,0;;2,0;7,0;2,0;3,0;8,0;;;5,0;4,0;2,0;12,0;3,0;;7,0;7,0;43,0;4,0;9,0;;3,0;;11,0;16,0;4,0;1,0;3,0;15,0;;12,0;3,0;10,0;3,0;7,0;10,0;71,0;3,0;3,0;16,0;3,0;60,0;2,0;9,0;8,0;7,0;16,0;56,0;1,0;3,0;;69,0;16,0;;16,0;;;11,0;1,0;2,0;5,0;;6,0;7,0;9,0;;3,0;;4,0;6,0;;5,0;7,0;7,0;9,0;10,0;5,0;7,0;;8,0;8,0;;3,0;9,0;;;;1,0;8,0;5,0;9,0;;5,0;1,0;;8,0;2,0;22,0;2,0;;2,0;1,0;1,0;151,0;2,0;38,0;10,0;3,0;31,0;8,0;44,0;12,0;2,0;19,0;7,0;3,0;1,0;;13,0;;2,0;2,0;1,0;4,0;3,0;1,0;1,0;42,0;2,0;1,0;;;3,0;4,0;6,0;;17,0;2,0;1,0;5,0;;3,0;10,0;3,0;1,0;7,0;6,0;;6,0;1,0;;4,0;1,0;6,0;3,0;5,0;1,0;8,0;1,0;;4,0;;21,0;1,0;1,0;7,0;1,0;;18,0;5,0;9,0;31,0;5,0;8,0;;;11,0;6,0;1,0;5,0;7,0;16,0;2,0;4,0;5,0;8,0;1,0;1,0;;;;27,0;3,0;;18,0;53,0;;;1,0;1,0;5,0;;1,0;;3,0;;4,0;6,0;3,0;;;2,0;1,0;9,0;;;;;1,0;;;;;;;6,0;;;1,0;2,0;9,0;2,0;;1,0;3,0;;;;2,0;;;6,0;;;;4,0;3,0;;;2,0;10,0;;6,0;;;1,0;;;;;;;;62,0;;;;2,0;1,0;;13,0;3,0;;;5,0;;2,0;5,0;7,0;18,0;2,0;;2,0;6,0;;1,0;2,0;;;4,0;;;7,0;;;;;2,0;1,0;1,0;;2,0;5,0;3,0;;8,0;1,0;1,0;2,0;;3,0;;3,0;;;21,0;4,0;;;2,0;;7,0;2,0;;10,0;1,0;;6,0;3,0;8,0;1,0;6,0;16,0;;1,0;1,0;;;;;1,0;3,0;2,0;1,0;2,0;;;;1,0;5,0;;2,0;2,0;;20,0;;;;1,0;2,0;4,0;1,0;;6,0;4,0;;;5,0;1,0;1,0;8,0;1,0;;;1,0;;;;;;;;3,0;;1,0;;;3,0;;;3,0;;13,0;;16,0;5,0;1,0;1,0;1,0;5,0;;5,0;;;;;1,0;;3,0;;1,0;1,0;;1,0;2,0;2,0;;2,0;;;;;;;;1,0;;2,0;;;;1,0;;;4,0;1,0;;5,0;;;3,0;3,0;1,0;5,0;7,0;1,0;;14,0;;1,0;;2,0;;;;;;;;3,0;2,0;3,0;1,0;;;;35,0;;199,0;;6,0;;;1,0;;15,0;;;;1,0;1,0;;;;;;;4,0;;4,0;;1,0;2,0;;8,0;;6,0;;;;2,0;;;;1,0;;;6,0;;2,0;1,0;;;;;;;;;1,0;5,0;;3,0;;3,0;;;;;2,0;1,0;;2,0;;;3,0;;;;;;1,0;
metadata;1,0;;;;4,0;;;8,0;2,0;;;;22,0;;;20,0;;;;;;15,0;;;;;2,0;;;;5,0;2,0;10,0;;16,0;14,0;;2,0;3,0;;26,0;;;;9,0;3,0;12,0;13,0;8,0;;;7,0;;;;;;;1,0;;;4,0;;36,0;;6,0;;;10,0;;1,0;;15,0;;;9,0;5,0;;;58,0;;5,0;;12,0;;3,0;;;;;;11,0;1,0;;2,0;;;;23,0;;2,0;;5,0;30,0;;;;;1,0;6,0;1,0;3,0;;;;5,0;;;;10,0;;;6,0;4,0;;3,0;;;;;;;;2,0;;;;;;;;1,0;;2,0;8,0;;;;2,0;;;;24,0;36,0;17,0;;21,0;;;;1,0;8,0;5,0;3,0;;;33,0;;1,0;;;;;;;1,0;;;;;;;;;;1,0;;;;;;1,0;;1,0;;;14,0;;;;;;;;;;;;;;;;;;;;;;1,0;;;;;;;;1,0;;1,0;;;;;;;;1,0;;;;;;;;;;;;2,0;;1,0;;1,0;;;2,0;20,0;;;;;;;6,0;;;;;;;;9,0;;;;;1,0;;;;;;;;;13,0;;1,0;;;1,0;;;;;;;;;;;;;;;;;1,0;;;;;;;;;;;;;;;;;;;;;;;;;;;;;;;;;;;;;;1,0;;;;;;;;;;;;;;;;1,0;;;;;;;;;;;;;;;;;;;;;;;;;;;;;;;;;;;;;;;;;6,0;;;;4,0;;;4,0;2,0;11,0;;;2,0;;;;;;;;;;;;;;;;;2,0;2,0;;3,0;;4,0;;1,0;;8,0;1,0;1,0;;;;6,0;;1,0;;2,0;;;;;3,0;;;;1,0;;;2,0;;;;;;;4,0;;;1,0;1,0;2,0;;;;;;;;;;3,0;;;1,0;5,0;3,0;;;3,0;;;;1,0;;1,0;;;;;;7,0;;2,0;;;2,0;;;;2,0;13,0;;;;;;;;;;;22,0;;;;;;;;;;;4,0;;;;;;;;;;;;;;4,0;;;;;;;;;;;;;6,0;;;;;;;1,0;2,0;;;5,0;;;;5,0;;;;;1,0;4,0;;;;;3,0;3,0;;;;;;;;;;2,0;1,0;18,0;;;;;;;;;1,0;6,0;;;;;;;1,0;;1,0;;;10,0;;;;;;;;5,0;;;;1,0;;;;;;;6,0;;;5,0;;;;;;2,0;;;;2,0;;;;;;;5,0;;;;;;;;;;;;;;;;;;;;;;;;;;;;;;;;;;;;;;;;;;;;;;;;;;;;;;;;;;;;;19,0;;;;;;;;;;;;;;;;3,0;;;;;;;;;;;;;;;;;;2,0;;;;;;8,0;;;;;;;;;5,0;;;;;;;1,0;2,0;;;;;;;;3,0;3,0;;;;;;;;;;;;;;;;;;;;;;;;;;;;;;;;2,0;;;;;;;;;;;;;;;;;;;;;;3,0;;;;;;;;1,0;;;;;;4,0;;;;;;;;;;;;;;;;;;;;2,0;;;;;;;;;;;;;;;;;;1,0;5,0;;;;;;2,0;1,0;;;;;;;;;;;;;;;;;;;;;1,0;;;;;;;;;;;;;;;;;;;;;;;;;;;;;;;;;;;;;;;;;;;;;;;3,0;;;;;;;;;;;2,0;;;;;3,0;;;;;;;;;;4,0;
method;26,0;20,0;23,0;17,0;121,0;210,0;79,0;554,0;230,0;56,0;168,0;4,0;249,0;12,0;114,0;438,0;52,0;31,0;46,0;185,0;273,0;1037,0;83,0;66,0;53,0;34,0;369,0;65,0;15,0;16,0;269,0;73,0;156,0;33,0;1165,0;52,0;114,0;169,0;79,0;24,0;917,0;13,0;193,0;250,0;603,0;192,0;1152,0;1676,0;492,0;873,0;49,0;337,0;70,0;39,0;58,0;142,0;179,0;77,0;232,0;20,0;27,0;45,0;220,0;81,0;220,0;115,0;311,0;350,0;494,0;28,0;209,0;24,0;515,0;23,0;19,0;72,0;206,0;60,0;97,0;4794,0;60,0;538,0;169,0;1320,0;45,0;109,0;30,0;3,0;3,0;90,0;805,0;9,0;7,0;85,0;110,0;100,0;127,0;23,0;;225,0;147,0;71,0;693,0;757,0;12,0;8,0;327,0;42,0;316,0;394,0;45,0;601,0;2,0;9,0;13,0;611,0;410,0;650,0;106,0;276,0;15,0;14,0;133,0;659,0;238,0;118,0;29,0;7,0;30,0;207,0;3,0;270,0;110,0;62,0;111,0;120,0;114,0;120,0;77,0;13,0;284,0;31,0;64,0;620,0;265,0;38,0;;78,0;563,0;151,0;53,0;24,0;105,0;316,0;177,0;41,0;1192,0;;81,0;80,0;29,0;211,0;374,0;16,0;51,0;26,0;741,0;409,0;51,0;50,0;117,0;5,0;47,0;56,0;82,0;149,0;130,0;47,0;12,0;24,0;26,0;169,0;40,0;16,0;36,0;106,0;15,0;114,0;3,0;6,0;54,0;33,0;4,0;107,0;4,0;28,0;92,0;7,0;19,0;30,0;16,0;24,0;139,0;177,0;46,0;4,0;14,0;48,0;162,0;123,0;110,0;34,0;10,0;21,0;36,0;21,0;5,0;14,0;36,0;46,0;108,0;14,0;12,0;11,0;29,0;9,0;128,0;7,0;601,0;430,0;103,0;19,0;39,0;146,0;19,0;53,0;142,0;49,0;7,0;31,0;47,0;40,0;17,0;95,0;74,0;9,0;14,0;49,0;453,0;132,0;56,0;13,0;8,0;18,0;7,0;27,0;694,0;21,0;3,0;4,0;1,0;20,0;22,0;384,0;63,0;16,0;65,0;12,0;84,0;36,0;12,0;187,0;98,0;23,0;25,0;9,0;36,0;62,0;147,0;243,0;80,0;25,0;64,0;19,0;8,0;347,0;15,0;60,0;14,0;52,0;352,0;55,0;55,0;35,0;23,0;6,0;55,0;8,0;22,0;;89,0;31,0;61,0;1,0;25,0;15,0;4,0;50,0;26,0;26,0;42,0;30,0;42,0;;22,0;73,0;5,0;33,0;3,0;79,0;1,0;2,0;5,0;8,0;274,0;3,0;20,0;4,0;8,0;13,0;5,0;9,0;4,0;5,0;;83,0;42,0;33,0;24,0;38,0;2,0;1,0;32,0;112,0;31,0;24,0;48,0;59,0;36,0;151,0;5,0;26,0;32,0;74,0;7,0;10,0;46,0;358,0;94,0;14,0;33,0;58,0;15,0;7,0;10,0;1,0;4,0;23,0;24,0;11,0;34,0;20,0;5,0;27,0;11,0;4,0;76,0;3,0;55,0;50,0;1,0;4,0;71,0;7,0;2,0;38,0;7,0;5,0;8,0;72,0;22,0;204,0;100,0;12,0;3,0;47,0;8,0;25,0;56,0;27,0;27,0;43,0;45,0;21,0;21,0;23,0;12,0;24,0;52,0;220,0;148,0;146,0;105,0;50,0;176,0;22,0;29,0;28,0;25,0;13,0;14,0;40,0;85,0;99,0;26,0;40,0;30,0;203,0;26,0;15,0;30,0;360,0;160,0;60,0;283,0;13,0;97,0;185,0;299,0;20,0;162,0;337,0;187,0;23,0;145,0;370,0;265,0;33,0;180,0;65,0;71,0;27,0;4,0;62,0;117,0;321,0;108,0;72,0;19,0;31,0;71,0;11,0;9,0;70,0;13,0;7,0;24,0;22,0;217,0;261,0;37,0;11,0;71,0;82,0;466,0;37,0;107,0;34,0;52,0;2,0;310,0;54,0;54,0;102,0;151,0;39,0;26,0;51,0;83,0;80,0;5,0;86,0;98,0;178,0;46,0;30,0;43,0;40,0;136,0;16,0;36,0;18,0;51,0;224,0;147,0;30,0;48,0;7,0;83,0;23,0;54,0;133,0;19,0;20,0;88,0;23,0;47,0;13,0;32,0;4,0;35,0;41,0;34,0;89,0;26,0;38,0;96,0;12,0;53,0;7,0;18,0;48,0;76,0;39,0;7,0;13,0;77,0;38,0;42,0;55,0;32,0;18,0;19,0;31,0;49,0;169,0;43,0;60,0;1,0;91,0;19,0;4,0;70,0;133,0;41,0;34,0;27,0;18,0;2,0;25,0;17,0;49,0;23,0;131,0;16,0;109,0;35,0;102,0;27,0;52,0;62,0;37,0;49,0;5,0;21,0;61,0;4,0;7,0;20,0;14,0;38,0;10,0;29,0;19,0;145,0;35,0;39,0;76,0;10,0;36,0;30,0;30,0;2,0;18,0;26,0;38,0;12,0;51,0;33,0;12,0;80,0;14,0;72,0;40,0;15,0;103,0;34,0;1,0;20,0;17,0;3,0;65,0;14,0;12,0;10,0;8,0;2,0;53,0;36,0;22,0;5,0;41,0;8,0;65,0;66,0;5,0;355,0;59,0;6,0;14,0;32,0;1,0;16,0;56,0;58,0;26,0;25,0;12,0;25,0;11,0;21,0;14,0;50,0;26,0;45,0;42,0;19,0;7,0;159,0;35,0;2,0;130,0;6,0;4,0;4,0;2,0;40,0;5,0;5,0;;3,0;24,0;22,0;17,0;88,0;36,0;7,0;90,0;3,0;13,0;45,0;11,0;10,0;17,0;9,0;4,0;;13,0;39,0;3,0;9,0;12,0;65,0;6,0;;75,0;28,0;36,0;14,0;16,0;7,0;56,0;4,0;7,0;17,0;14,0;27,0;6,0;36,0;3,0;7,0;9,0;29,0;41,0;2,0;9,0;14,0;79,0;7,0;3,0;6,0;4,0;13,0;17,0;1,0;6,0;3,0;4,0;9,0;;4,0;18,0;7,0;61,0;26,0;33,0;19,0;13,0;18,0;34,0;38,0;44,0;42,0;29,0;53,0;10,0;46,0;31,0;9,0;4,0;59,0;5,0;6,0;18,0;2,0;48,0;5,0;10,0;23,0;49,0;3,0;7,0;7,0;17,0;18,0;24,0;12,0;;45,0;15,0;17,0;4,0;8,0;24,0;47,0;54,0;21,0;14,0;4,0;33,0;2,0;31,0;30,0;126,0;2,0;11,0;11,0;9,0;67,0;39,0;31,0;39,0;8,0;14,0;9,0;43,0;70,0;34,0;40,0;199,0;20,0;45,0;14,0;27,0;13,0;;3,0;9,0;42,0;58,0;54,0;56,0;26,0;23,0;8,0;34,0;22,0;10,0;53,0;24,0;29,0;68,0;;70,0;3,0;11,0;14,0;5,0;4,0;17,0;96,0;15,0;47,0;78,0;44,0;2,0;13,0;19,0;4,0;20,0;7,0;108,0;15,0;3,0;31,0;38,0;5,0;3,0;;9,0;6,0;30,0;13,0;16,0;36,0;33,0;10,0;31,0;1,0;12,0;52,0;24,0;45,0;69,0;24,0;27,0;10,0;42,0;72,0;16,0;11,0;8,0;3,0;11,0;21,0;62,0;11,0;12,0;12,0;15,0;12,0;54,0;10,0;6,0;14,0;1,0;17,0;1,0;5,0;10,0;3,0;22,0;8,0;34,0;17,0;22,0;;46,0;7,0;5,0;42,0;69,0;12,0;5,0;21,0;1,0;22,0;32,0;80,0;15,0;11,0;29,0;25,0;23,0;45,0;1,0;5,0;1,0;25,0;1,0;7,0;7,0;5,0;1,0;28,0;9,0;73,0;16,0;13,0;26,0;26,0;4,0;16,0;51,0;1,0;41,0;2,0;18,0;5,0;6,0;21,0;5,0;38,0;10,0;;4,0;20,0;9,0;22,0;10,0;10,0;6,0;2,0;9,0;64,0;;21,0;;6,0;4,0;11,0;38,0;5,0;13,0;10,0;;23,0;27,0;;20,0;12,0;22,0;10,0;13,0;21,0;10,0;14,0;25,0;17,0;34,0;;24,0;27,0;4,0;22,0;20,0;19,0;29,0;6,0;32,0;14,0;111,0;4,0;13,0;36,0;14,0;21,0;3,0;23,0;37,0;30,0;10,0;5,0;6,0;16,0;10,0;10,0;2,0;20,0;11,0
mobile;1,0;;;2,0;2,0;23,0;2,0;49,0;8,0;6,0;;;73,0;4,0;16,0;169,0;;;3,0;2,0;2,0;116,0;5,0;13,0;3,0;;5,0;12,0;1,0;2,0;16,0;4,0;66,0;;128,0;23,0;1,0;;4,0;1,0;57,0;;5,0;127,0;32,0;7,0;91,0;1663,0;45,0;125,0;24,0;39,0;;2,0;12,0;;55,0;1,0;29,0;;5,0;5,0;4,0;9,0;10,0;6,0;2,0;16,0;30,0;18,0;27,0;;44,0;;;6,0;15,0;;5,0;249,0;11,0;14,0;2,0;112,0;2,0;17,0;;;2,0;4,0;34,0;13,0;;4,0;8,0;10,0;13,0;;225,0;;12,0;2,0;86,0;42,0;1,0;26,0;13,0;6,0;23,0;22,0;2,0;18,0;;1,0;;23,0;24,0;132,0;12,0;9,0;;;10,0;46,0;57,0;11,0;1,0;;;5,0;5,0;24,0;25,0;3,0;8,0;;6,0;21,0;6,0;;22,0;;9,0;62,0;5,0;;1,0;18,0;35,0;5,0;2,0;;12,0;13,0;1,0;1,0;122,0;;2,0;3,0;14,0;61,0;95,0;;1,0;;55,0;22,0;;;13,0;;;;;3,0;5,0;10,0;3,0;1,0;1,0;39,0;2,0;;;8,0;1,0;7,0;;;;;1,0;35,0;;18,0;15,0;1,0;;11,0;;;1,0;29,0;9,0;3,0;;;7,0;29,0;;1,0;2,0;;;;2,0;;12,0;13,0;34,0;;2,0;8,0;;1,0;1,0;;28,0;;14,0;1,0;14,0;27,0;3,0;7,0;11,0;12,0;1,0;3,0;;1,0;2,0;3,0;2,0;;;1,0;1,0;2,0;47,0;;;1,0;;;115,0;;;;3,0;;13,0;23,0;;7,0;;1,0;7,0;;1,0;13,0;1,0;1,0;;8,0;4,0;4,0;1,0;24,0;7,0;1,0;220,0;;;16,0;;1,0;;1,0;50,0;5,0;;;6,0;;;;2,0;;10,0;13,0;17,0;;;1,0;1,0;;5,0;;;67,0;;;21,0;3,0;;10,0;;24,0;;1,0;;;15,0;2,0;2,0;;;4,0;;8,0;;;;13,0;2,0;11,0;17,0;41,0;26,0;;1,0;14,0;1,0;11,0;29,0;13,0;4,0;2,0;;3,0;;;;21,0;64,0;29,0;15,0;;;1,0;2,0;;22,0;;;15,0;1,0;;;2,0;1,0;2,0;;;2,0;1,0;6,0;34,0;2,0;;;;;2,0;;;;24,0;21,0;17,0;;9,0;;9,0;22,0;6,0;;;;14,0;14,0;;;;;1,0;;12,0;7,0;17,0;12,0;;59,0;;;1,0;1,0;2,0;;1,0;2,0;5,0;;2,0;;5,0;1,0;2,0;3,0;24,0;15,0;2,0;126,0;1,0;4,0;3,0;10,0;;11,0;22,0;23,0;38,0;25,0;21,0;27,0;1,0;55,0;1,0;;;;1,0;4,0;29,0;54,0;;1,0;4,0;3,0;1,0;16,0;3,0;;;1,0;5,0;4,0;34,0;;4,0;2,0;11,0;130,0;1,0;74,0;3,0;;;12,0;;;3,0;4,0;;;3,0;7,0;2,0;;52,0;5,0;16,0;;2,0;23,0;6,0;46,0;;4,0;;204,0;5,0;13,0;6,0;;;9,0;2,0;16,0;15,0;1,0;14,0;11,0;1,0;7,0;4,0;7,0;4,0;2,0;11,0;5,0;1,0;;;16,0;;10,0;4,0;3,0;2,0;8,0;12,0;8,0;2,0;19,0;3,0;2,0;;;;;1,0;3,0;3,0;1,0;27,0;;20,0;;;;28,0;4,0;2,0;;1,0;16,0;6,0;4,0;4,0;;1,0;;14,0;5,0;215,0;16,0;4,0;;3,0;6,0;1,0;;27,0;1,0;5,0;1,0;2,0;1,0;3,0;1,0;;11,0;3,0;3,0;;1,0;2,0;10,0;7,0;;;4,0;4,0;11,0;11,0;1,0;;26,0;1,0;6,0;7,0;;;2,0;;;;1,0;1,0;1,0;9,0;1,0;;;;;4,0;;11,0;;4,0;15,0;;6,0;1,0;2,0;2,0;6,0;;;4,0;16,0;3,0;5,0;;12,0;1,0;;;4,0;1,0;7,0;1,0;;1,0;13,0;7,0;;61,0;;;;5,0;2,0;1,0;;17,0;6,0;5,0;;1,0;;;;2,0;;;2,0;2,0;1,0;1,0;17,0;;;2,0;;3,0;;1,0;6,0;1,0;;1,0;3,0;;;2,0;1,0;3,0;1,0;;;1,0;1,0;;2,0;;;1,0;28,0;2,0;;;;6,0;;1,0;16,0;;2,0;7,0;2,0;;;;;;;2,0;;1,0;;;1,0;;;1,0;;1,0;1,0;;1,0;;2,0;4,0;;2,0;12,0;;1,0;;;;;;;;;;;;3,0;;;;1,0;;;;;;2,0;3,0;;10,0;;4,0;;;;5,0;;;;1,0;9,0;;;;;;1,0;1,0;2,0;;9,0;5,0;7,0;6,0;1,0;3,0;;;;;;7,0;;1,0;1,0;1,0;5,0;;2,0;;;30,0;2,0;;;1,0;;;;;;;25,0;;1,0;2,0;;;;;;;;6,0;;;;;3,0;;1,0;;;1,0;1,0;;16,0;1,0;4,0;;;;;;1,0;4,0;2,0;6,0;1,0;;;;;1,0;;2,0;;8,0;;;;;;3,0;3,0;1,0;;;2,0;;;4,0;;;;5,0;2,0;;;;4,0;;1,0;;3,0;;1,0;;;;;6,0;;;;;2,0;;;1,0;1,0;;7,0;;1,0;;;;;3,0;;16,0;24,0;;2,0;;1,0;;;;;;8,0;;;;;;;;;3,0;;;;;1,0;4,0;;;2,0;;;;;;;;;;;;;;;;;;;2,0;;1,0;;;;;;1,0;;3,0;;2,0;1,0;16,0;;;;;;;;;;;;;;;;;;
model;33,0;;8,0;;3,0;3,0;1,0;16,0;36,0;5,0;;;52,0;;5,0;151,0;;10,0;;12,0;8,0;25,0;1,0;;;3,0;14,0;24,0;1,0;1,0;12,0;7,0;53,0;;13,0;11,0;14,0;19,0;21,0;1,0;57,0;;6,0;66,0;37,0;7,0;113,0;37,0;24,0;28,0;1,0;20,0;12,0;7,0;1,0;50,0;4,0;16,0;79,0;;1,0;;3,0;2,0;10,0;2,0;8,0;5,0;66,0;;11,0;;92,0;;49,0;2,0;17,0;;;281,0;1,0;4,0;3,0;62,0;;12,0;;;9,0;2,0;22,0;4,0;;;19,0;7,0;6,0;2,0;147,0;12,0;;41,0;42,0;120,0;1,0;;1,0;3,0;31,0;106,0;3,0;17,0;;;;41,0;7,0;82,0;;26,0;;;5,0;8,0;21,0;28,0;1,0;;;5,0;;111,0;1,0;1,0;30,0;10,0;10,0;21,0;7,0;;46,0;;;12,0;8,0;;;1,0;1,0;11,0;4,0;;7,0;50,0;26,0;;82,0;;5,0;;9,0;;47,0;3,0;;1,0;6,0;12,0;;;5,0;;1,0;;3,0;40,0;;;2,0;;;3,0;;;;;;6,0;;;;3,0;;3,0;;;11,0;;;;;2,0;1,0;1,0;2,0;;;;;5,0;;;;1,0;;;;;1,0;;7,0;;;11,0;;;;;9,0;;;;;6,0;;8,0;6,0;;;;5,0;;;3,0;1,0;;;2,0;77,0;16,0;;;;;;;17,0;;;;;;;11,0;;;4,0;;1,0;;;2,0;60,0;;;;1,0;1,0;;15,0;;;4,0;;;21,0;;11,0;5,0;;48,0;3,0;;;;;3,0;;;;1,0;;;;;;;;;2,0;;3,0;1,0;;1,0;1,0;;;;1,0;;;;;;;;;;;;;;7,0;;6,0;4,0;;10,0;1,0;;;7,0;;;2,0;14,0;;1,0;3,0;;2,0;;;;;4,0;77,0;;1,0;2,0;7,0;;;;;;;;;;;;2,0;;;;;12,0;7,0;;;5,0;7,0;;3,0;;;3,0;21,0;13,0;4,0;3,0;;;;;1,0;;1,0;;;1,0;2,0;2,0;;;;2,0;22,0;7,0;;36,0;1,0;26,0;3,0;12,0;;;;;6,0;2,0;2,0;;;4,0;40,0;6,0;1,0;;37,0;11,0;5,0;18,0;;16,0;13,0;;;9,0;45,0;14,0;;1,0;3,0;2,0;;18,0;;16,0;;;14,0;;5,0;3,0;14,0;;;3,0;;;1,0;;;;1,0;25,0;13,0;;;;33,0;38,0;4,0;25,0;;1,0;;5,0;6,0;10,0;12,0;12,0;;1,0;3,0;4,0;82,0;;69,0;7,0;;;1,0;;;24,0;2,0;6,0;;3,0;3,0;;8,0;14,0;;;3,0;9,0;3,0;;1,0;;;4,0;;;;;;;1,0;;4,0;;;;;;10,0;4,0;;;;1,0;3,0;;1,0;;;9,0;;;4,0;2,0;3,0;;;5,0;;;10,0;;;;;;;1,0;;;;;3,0;1,0;;;;18,0;19,0;;;;3,0;;1,0;5,0;;8,0;;;2,0;1,0;1,0;4,0;;3,0;;16,0;;2,0;;;;;16,0;12,0;;9,0;;8,0;;;1,0;;;;;;8,0;2,0;;;;1,0;1,0;;2,0;;3,0;;10,0;10,0;;14,0;9,0;;;;;;1,0;;;;;;;4,0;3,0;6,0;;;1,0;5,0;;106,0;;;;4,0;;;;;;;;;;6,0;;1,0;;;3,0;;;;;;;;;;1,0;;;;;58,0;;;4,0;;;;;3,0;;;;;3,0;1,0;;1,0;;;;;23,0;;;;12,0;;;;;;;;;;;;;;;;;1,0;;;;;1,0;;;2,0;;;;;;11,0;;2,0;;;2,0;;;2,0;;;;;;2,0;;;;;;3,0;4,0;;;;;1,0;;;;;;;;9,0;8,0;;;;;20,0;1,0;;;;;;1,0;;1,0;;14,0;;1,0;;1,0;4,0;;;2,0;4,0;;6,0;;;2,0;;;;;9,0;6,0;;4,0;;;1,0;;;;;11,0;;;;1,0;;;;;;;;4,0;4,0;1,0;1,0;;;;;;;;16,0;4,0;;;7,0;2,0;;;;7,0;;3,0;;;;5,0;8,0;;;4,0;1,0;;;;;6,0;;;;;;;;;2,0;;;;;1,0;;;;;1,0;2,0;4,0;;;;;;;;;;;;;;6,0;;39,0;;;;;;;;;;3,0;3,0;6,0;;13,0;1,0;17,0;1,0;;3,0;;;;;;;14,0;1,0;2,0;1,0;6,0;;;1,0;;1,0;;;;;18,0;;1,0;;;;;2,0;;;;;;;;;;1,0;;;;;;22,0;;2,0;;1,0;;;;17,0;3,0;;;3,0;2,0;6,0;;6,0;;;1,0;;;;3,0;;;;9,0;1,0;1,0;;;
modify;1,0;;1,0;;2,0;;4,0;7,0;16,0;;;;10,0;;1,0;53,0;;;1,0;;7,0;48,0;;;;4,0;5,0;1,0;;;4,0;3,0;19,0;;19,0;8,0;3,0;3,0;5,0;;80,0;;8,0;8,0;8,0;;9,0;41,0;32,0;37,0;3,0;2,0;7,0;;;7,0;12,0;5,0;;1,0;;;6,0;14,0;26,0;;12,0;15,0;46,0;;2,0;;16,0;;;3,0;7,0;2,0;11,0;303,0;1,0;7,0;3,0;52,0;;2,0;;;;;13,0;;2,0;4,0;;2,0;8,0;;71,0;2,0;41,0;;8,0;14,0;2,0;9,0;6,0;23,0;14,0;39,0;1,0;13,0;;;;20,0;9,0;6,0;3,0;1,0;;;18,0;24,0;21,0;6,0;;;4,0;;;55,0;10,0;8,0;4,0;4,0;5,0;9,0;;;9,0;;3,0;36,0;5,0;;;2,0;21,0;1,0;1,0;;4,0;40,0;;;48,0;;;;8,0;5,0;9,0;;;;11,0;16,0;1,0;1,0;;;;1,0;2,0;6,0;2,0;;;;;4,0;;;;;;2,0;;;1,0;5,0;;4,0;;;16,0;;;2,0;;;3,0;;;;;;4,0;;;;;;;;;;;;3,0;;;;;;;;19,0;;3,0;;1,0;1,0;;1,0;;2,0;;;;;;4,0;1,0;;;;6,0;;;2,0;;;;;13,0;3,0;;;;2,0;;6,0;;;3,0;;1,0;;;16,0;;;2,0;;;;;;;;;;;8,0;;;;;;;;;;;4,0;;;;;2,0;;;;;;1,0;;;;;;;;1,0;;2,0;;;;;;;;;;;;;1,0;;;;;1,0;;3,0;;;;;1,0;;76,0;;6,0;;;20,0;;;;;4,0;;;27,0;;;;;;;;;;;;;2,0;;;;;2,0;2,0;;4,0;2,0;6,0;;;;;;;;;2,0;;;;;;;;26,0;;;;;;7,0;;;;;2,0;5,0;11,0;3,0;;;;;;;1,0;;;2,0;4,0;;2,0;;;6,0;;2,0;;19,0;;;2,0;;9,0;5,0;2,0;;;11,0;;;;;26,0;;3,0;;3,0;;;1,0;;19,0;;5,0;1,0;;;;;;;;1,0;;;;;;;4,0;23,0;;27,0;;4,0;;3,0;;4,0;4,0;6,0;;1,0;;;15,0;;5,0;1,0;2,0;;3,0;11,0;2,0;3,0;;3,0;;;23,0;4,0;;;;;2,0;1,0;2,0;;;2,0;;1,0;;;;;;;;;;1,0;;;1,0;;3,0;7,0;;1,0;;1,0;;;;;;;;2,0;18,0;;;;;;;1,0;12,0;;4,0;;;;;;1,0;;7,0;;13,0;;4,0;1,0;;3,0;;4,0;;;10,0;;;;;21,0;;1,0;5,0;5,0;4,0;6,0;3,0;3,0;;1,0;;;14,0;;;1,0;;;;6,0;;5,0;;;;1,0;;;;;12,0;;;;;;6,0;1,0;2,0;;;;;1,0;;87,0;;;;;;;;8,0;;4,0;;1,0;;1,0;1,0;;;;;;1,0;11,0;;;;;1,0;;;1,0;;;;;;;;1,0;;;10,0;;;;;;3,0;;;;;;;;1,0;;;;3,0;;;;;4,0;;;;;;;;3,0;;;;1,0;;;;;;;;;;;;;;;;;;;;;;2,0;;;;5,0;3,0;;1,0;;;;;4,0;;;;;;;2,0;;;;;;;;;;;;;3,0;;;;;;;1,0;3,0;;;;;1,0;;;;1,0;;;;;3,0;;1,0;;1,0;;;;5,0;;;15,0;;;;;;;;;;1,0;1,0;;4,0;2,0;;;1,0;;;;1,0;3,0;;4,0;;;2,0;;;;2,0;3,0;;3,0;;;;;;;;;;;;;;;;;;1,0;;1,0;7,0;;;;;;;6,0;3,0;;;;;;1,0;;;;;;;8,0;2,0;;;;16,0;;;;;;;;;;;;;1,0;;;;;;;1,0;;1,0;;;;;;;;;2,0;;;1,0;;;;;;;;;;;;;;;;;;;;;;;;;;;1,0;;;1,0;;;;;;2,0;;;2,0;;;6,0;;;;;7,0;;;;;;;;;;;;;;;;;;13,0;;;;;;;;;;;;;;;;2,0;;;;;;;;;;6,0;;;;
module;2,0;1,0;9,0;5,0;32,0;117,0;79,0;275,0;55,0;135,0;77,0;2,0;40,0;6,0;303,0;258,0;4,0;8,0;68,0;32,0;83,0;380,0;6,0;70,0;23,0;10,0;96,0;17,0;251,0;18,0;42,0;28,0;742,0;7,0;920,0;85,0;34,0;116,0;5,0;;269,0;3,0;319,0;53,0;194,0;106,0;258,0;743,0;202,0;255,0;223,0;173,0;5,0;11,0;84,0;50,0;176,0;13,0;47,0;7,0;66,0;98,0;81,0;9,0;129,0;76,0;191,0;438,0;167,0;60,0;117,0;21,0;125,0;8,0;2,0;66,0;38,0;10,0;37,0;2323,0;22,0;349,0;34,0;1162,0;11,0;15,0;2,0;34,0;20,0;92,0;2756,0;;6,0;84,0;54,0;16,0;165,0;5,0;693,0;86,0;42,0;8,0;;260,0;4,0;69,0;660,0;9,0;102,0;128,0;41,0;100,0;27,0;32,0;6,0;353,0;452,0;401,0;113,0;78,0;20,0;16,0;49,0;304,0;136,0;72,0;3,0;5,0;9,0;82,0;5,0;88,0;55,0;14,0;3,0;21,0;61,0;40,0;10,0;34,0;40,0;;25,0;1101,0;31,0;14,0;30,0;220,0;348,0;33,0;14,0;24,0;36,0;119,0;47,0;47,0;476,0;1,0;50,0;55,0;8,0;109,0;677,0;7,0;;;200,0;96,0;53,0;3,0;69,0;9,0;121,0;33,0;9,0;62,0;229,0;424,0;;4,0;259,0;293,0;55,0;48,0;20,0;391,0;34,0;135,0;8,0;15,0;15,0;32,0;5,0;382,0;8,0;126,0;12,0;7,0;12,0;136,0;37,0;3,0;24,0;128,0;36,0;90,0;10,0;3,0;49,0;91,0;53,0;16,0;34,0;10,0;69,0;11,0;100,0;41,0;47,0;151,0;530,0;12,0;68,0;7,0;;19,0;71,0;;442,0;192,0;364,0;69,0;71,0;221,0;154,0;82,0;74,0;157,0;60,0;91,0;25,0;23,0;16,0;36,0;;4,0;;8,0;58,0;51,0;144,0;8,0;19,0;8,0;23,0;3,0;517,0;24,0;8,0;26,0;20,0;56,0;34,0;102,0;109,0;50,0;125,0;189,0;134,0;6,0;29,0;110,0;118,0;72,0;11,0;158,0;9,0;122,0;363,0;478,0;91,0;20,0;105,0;37,0;2,0;66,0;21,0;49,0;15,0;51,0;102,0;25,0;6,0;56,0;81,0;4,0;4,0;16,0;113,0;5,0;229,0;30,0;88,0;;44,0;29,0;14,0;39,0;85,0;14,0;35,0;71,0;62,0;1,0;25,0;32,0;1,0;81,0;12,0;315,0;16,0;47,0;25,0;17,0;255,0;20,0;50,0;8,0;2,0;19,0;20,0;25,0;21,0;4,0;21,0;6,0;33,0;117,0;31,0;365,0;13,0;3,0;38,0;62,0;13,0;22,0;41,0;56,0;48,0;43,0;12,0;32,0;;62,0;116,0;13,0;9,0;72,0;67,0;2,0;12,0;17,0;30,0;61,0;107,0;;3,0;36,0;58,0;4,0;8,0;12,0;;13,0;1,0;14,0;59,0;16,0;74,0;63,0;20,0;1,0;37,0;66,0;14,0;21,0;33,0;26,0;1,0;171,0;29,0;42,0;119,0;19,0;44,0;63,0;;12,0;34,0;3,0;7,0;;9,0;40,0;;;9,0;8,0;8,0;225,0;38,0;4,0;40,0;8,0;33,0;3,0;6,0;5,0;6,0;5,0;7,0;7,0;40,0;31,0;;14,0;;59,0;;3,0;;251,0;54,0;17,0;26,0;4,0;26,0;36,0;93,0;6,0;137,0;100,0;99,0;9,0;28,0;45,0;105,0;12,0;23,0;14,0;3,0;6,0;;19,0;18,0;91,0;44,0;17,0;;3,0;134,0;2,0;21,0;15,0;7,0;30,0;54,0;4,0;40,0;48,0;;5,0;46,0;26,0;124,0;8,0;15,0;5,0;53,0;4,0;121,0;77,0;124,0;31,0;24,0;8,0;2,0;9,0;94,0;17,0;3,0;22,0;19,0;66,0;7,0;4,0;12,0;4,0;208,0;1,0;73,0;13,0;18,0;99,0;53,0;2,0;22,0;18,0;27,0;7,0;23,0;61,0;9,0;13,0;14,0;9,0;;27,0;6,0;8,0;10,0;35,0;2,0;61,0;6,0;24,0;40,0;28,0;;34,0;20,0;20,0;84,0;111,0;4,0;2,0;13,0;13,0;5,0;6,0;1,0;85,0;2,0;8,0;5,0;29,0;26,0;29,0;;21,0;17,0;;4,0;3,0;;11,0;2,0;63,0;36,0;16,0;22,0;20,0;18,0;39,0;17,0;10,0;24,0;256,0;13,0;18,0;29,0;6,0;40,0;7,0;17,0;29,0;21,0;16,0;4,0;;4,0;28,0;10,0;1,0;69,0;9,0;;3,0;13,0;15,0;17,0;;8,0;25,0;26,0;2,0;;;4,0;10,0;65,0;34,0;4,0;27,0;7,0;14,0;3,0;16,0;;1,0;4,0;3,0;28,0;12,0;5,0;2,0;2,0;7,0;4,0;4,0;3,0;9,0;5,0;12,0;28,0;;23,0;3,0;6,0;6,0;2,0;10,0;;51,0;10,0;1,0;27,0;32,0;8,0;22,0;3,0;3,0;3,0;7,0;4,0;12,0;;7,0;9,0;81,0;6,0;144,0;2,0;38,0;8,0;14,0;96,0;9,0;16,0;6,0;13,0;7,0;;15,0;73,0;40,0;33,0;49,0;13,0;1,0;72,0;;9,0;7,0;17,0;2,0;;31,0;93,0;4,0;3,0;4,0;53,0;36,0;4,0;25,0;13,0;8,0;3,0;58,0;;;16,0;17,0;1,0;13,0;13,0;;144,0;;23,0;3,0;18,0;14,0;8,0;3,0;3,0;43,0;2,0;43,0;1,0;;2,0;83,0;;;1,0;;18,0;15,0;5,0;43,0;10,0;12,0;2,0;174,0;126,0;2,0;20,0;18,0;2,0;3,0;11,0;;91,0;9,0;10,0;27,0;2,0;7,0;4,0;22,0;10,0;11,0;22,0;24,0;7,0;;36,0;1,0;2,0;4,0;;57,0;38,0;3,0;17,0;;24,0;;;2,0;4,0;8,0;11,0;3,0;;3,0;;2,0;;45,0;82,0;42,0;;5,0;1,0;4,0;15,0;20,0;12,0;15,0;;;5,0;8,0;13,0;;1,0;9,0;2,0;27,0;4,0;19,0;4,0;;2,0;;34,0;52,0;8,0;36,0;5,0;32,0;22,0;10,0;14,0;21,0;5,0;2,0;11,0;13,0;;38,0;3,0;3,0;7,0;10,0;7,0;;23,0;;12,0;6,0;5,0;3,0;7,0;10,0;;1,0;6,0;4,0;;4,0;;34,0;3,0;35,0;;;;3,0;20,0;7,0;9,0;;7,0;3,0;13,0;1,0;;4,0;21,0;13,0;3,0;11,0;1,0;;7,0;5,0;8,0;3,0;;8,0;1,0;5,0;1,0;2,0;1,0;3,0;;14,0;7,0;54,0;7,0;2,0;8,0;15,0;8,0;35,0;22,0;9,0;;10,0;5,0;;2,0;3,0;;;47,0;5,0;3,0;15,0;8,0;1,0;2,0;4,0;15,0;14,0;1,0;4,0;14,0;3,0;15,0;2,0;12,0;39,0;1,0;20,0;3,0;;26,0;6,0;5,0;1,0;25,0;2,0;6,0;6,0;6,0;10,0;16,0;18,0;34,0;29,0;;5,0;1,0;;;15,0;8,0;;9,0;;4,0;2,0;;6,0;;2,0;;;33,0;7,0;1,0;;1,0;25,0;;15,0;;15,0;12,0;1,0;5,0;1,0;;;;4,0;8,0;2,0;2,0;4,0;;1,0;4,0;;2,0;7,0;2,0;2,0;;;;17,0;3,0;8,0;15,0;8,0;;1,0;5,0;8,0;5,0;3,0;10,0;14,0;;1,0;32,0;15,0;8,0;8,0;;8,0;2,0;1,0
object;6,0;;6,0;5,0;113,0;139,0;90,0;246,0;411,0;247,0;33,0;14,0;342,0;16,0;73,0;682,0;94,0;18,0;24,0;20,0;151,0;644,0;15,0;7,0;18,0;4,0;135,0;19,0;3,0;5,0;68,0;90,0;357,0;16,0;166,0;45,0;27,0;66,0;81,0;75,0;426,0;3,0;79,0;138,0;972,0;246,0;943,0;489,0;120,0;390,0;87,0;1092,0;26,0;19,0;65,0;58,0;495,0;7,0;141,0;1,0;7,0;38,0;372,0;10,0;88,0;84,0;237,0;417,0;313,0;24,0;145,0;5,0;347,0;14,0;15,0;289,0;313,0;113,0;83,0;5047,0;43,0;328,0;17,0;631,0;20,0;62,0;7,0;60,0;6,0;111,0;1781,0;11,0;4,0;16,0;67,0;38,0;36,0;30,0;757,0;42,0;120,0;14,0;260,0;;18,0;39,0;704,0;618,0;217,0;82,0;57,0;139,0;2,0;48,0;20,0;467,0;410,0;864,0;75,0;238,0;4,0;3,0;100,0;174,0;139,0;62,0;41,0;3,0;27,0;136,0;;351,0;271,0;10,0;193,0;17,0;83,0;79,0;22,0;46,0;402,0;2,0;18,0;467,0;61,0;1,0;;2269,0;317,0;123,0;146,0;7,0;46,0;99,0;14,0;2,0;782,0;28,0;40,0;14,0;43,0;113,0;863,0;4,0;8,0;;237,0;447,0;44,0;5,0;107,0;2,0;1,0;42,0;53,0;14,0;12,0;19,0;;;15,0;49,0;1,0;1,0;3,0;49,0;3,0;50,0;11,0;4,0;3,0;8,0;20,0;22,0;9,0;28,0;48,0;8,0;1,0;30,0;5,0;;73,0;231,0;64,0;3,0;160,0;17,0;36,0;192,0;3,0;4,0;5,0;13,0;;;20,0;;49,0;;37,0;66,0;;;3,0;5,0;3,0;;723,0;;35,0;;37,0;39,0;70,0;123,0;179,0;16,0;4,0;;44,0;7,0;21,0;96,0;16,0;;6,0;207,0;290,0;135,0;16,0;7,0;1,0;;;14,0;231,0;236,0;2,0;29,0;;;9,0;213,0;;12,0;57,0;12,0;2,0;;4,0;97,0;138,0;;12,0;;33,0;44,0;2,0;694,0;8,0;;99,0;17,0;;216,0;11,0;46,0;9,0;9,0;169,0;22,0;;;6,0;49,0;20,0;;6,0;5,0;27,0;21,0;12,0;20,0;;;4,0;39,0;16,0;28,0;;37,0;2,0;;171,0;32,0;;;129,0;35,0;6,0;;4,0;1,0;80,0;;4,0;;4,0;46,0;3,0;;2,0;;;1,0;46,0;20,0;16,0;16,0;1,0;6,0;8,0;1,0;69,0;17,0;;5,0;43,0;94,0;5,0;4,0;;62,0;;4,0;6,0;300,0;10,0;16,0;2,0;100,0;6,0;16,0;;;;15,0;1,0;32,0;47,0;6,0;2,0;14,0;1,0;2,0;;4,0;29,0;29,0;14,0;;36,0;11,0;;68,0;;;;27,0;24,0;380,0;17,0;5,0;8,0;14,0;6,0;25,0;36,0;15,0;1,0;6,0;25,0;29,0;10,0;;1,0;12,0;18,0;223,0;105,0;10,0;77,0;11,0;91,0;10,0;16,0;11,0;11,0;4,0;4,0;16,0;93,0;66,0;12,0;26,0;18,0;313,0;27,0;23,0;4,0;97,0;19,0;26,0;288,0;2,0;131,0;217,0;72,0;;132,0;189,0;483,0;;25,0;31,0;56,0;24,0;71,0;25,0;87,0;6,0;5,0;12,0;41,0;156,0;18,0;49,0;1,0;54,0;94,0;;16,0;84,0;11,0;1,0;7,0;4,0;65,0;595,0;46,0;26,0;15,0;49,0;150,0;13,0;49,0;33,0;4,0;20,0;82,0;64,0;69,0;90,0;120,0;20,0;10,0;23,0;18,0;41,0;3,0;101,0;52,0;29,0;12,0;10,0;21,0;19,0;75,0;11,0;17,0;;4,0;253,0;19,0;36,0;38,0;19,0;14,0;8,0;2,0;42,0;;79,0;14,0;;9,0;;15,0;5,0;34,0;4,0;27,0;33,0;4,0;59,0;10,0;;29,0;10,0;1,0;29,0;15,0;8,0;14,0;5,0;121,0;10,0;5,0;60,0;2,0;2,0;16,0;23,0;8,0;58,0;27,0;13,0;;37,0;13,0;;41,0;69,0;;26,0;;2,0;1,0;7,0;1,0;5,0;7,0;73,0;;19,0;4,0;16,0;3,0;2,0;289,0;52,0;76,0;;3,0;25,0;2,0;6,0;19,0;10,0;4,0;4,0;4,0;4,0;11,0;3,0;6,0;36,0;3,0;5,0;113,0;36,0;1,0;27,0;5,0;6,0;;26,0;22,0;5,0;172,0;;4,0;8,0;17,0;175,0;31,0;;2,0;8,0;20,0;36,0;30,0;2,0;;25,0;;21,0;;13,0;1,0;10,0;2,0;115,0;86,0;7,0;385,0;20,0;1,0;2,0;6,0;;10,0;32,0;9,0;8,0;23,0;1,0;4,0;2,0;29,0;18,0;45,0;1,0;3,0;16,0;2,0;1,0;225,0;18,0;22,0;18,0;23,0;4,0;1,0;;8,0;23,0;2,0;;;;43,0;12,0;10,0;1,0;2,0;37,0;;46,0;13,0;16,0;1,0;17,0;1,0;1,0;;1,0;3,0;5,0;18,0;26,0;3,0;;;24,0;3,0;10,0;;2,0;;41,0;1,0;;10,0;18,0;16,0;3,0;1,0;4,0;4,0;6,0;6,0;1,0;2,0;6,0;11,0;97,0;2,0;;;;2,0;13,0;;;28,0;;5,0;2,0;;;;;10,0;1,0;;2,0;28,0;5,0;10,0;;48,0;9,0;10,0;;;2,0;4,0;12,0;17,0;;4,0;20,0;;;;4,0;1,0;1,0;2,0;2,0;;4,0;;5,0;10,0;;77,0;3,0;;;;5,0;23,0;16,0;107,0;3,0;;;;;51,0;175,0;;;1,0;28,0;9,0;46,0;84,0;31,0;7,0;;9,0;2,0;57,0;10,0;;86,0;37,0;7,0;;26,0;7,0;1,0;;5,0;9,0;8,0;15,0;11,0;12,0;21,0;1,0;43,0;;;78,0;15,0;52,0;49,0;23,0;4,0;80,0;;14,0;;9,0;55,0;25,0;;25,0;16,0;;2,0;3,0;2,0;25,0;2,0;;92,0;6,0;3,0;50,0;18,0;25,0;;2,0;6,0;11,0;22,0;6,0;30,0;61,0;3,0;;2,0;5,0;;8,0;;;29,0;6,0;2,0;7,0;21,0;250,0;2,0;;3,0;1,0;19,0;15,0;83,0;4,0;15,0;1,0;9,0;2,0;25,0;30,0;;3,0;;1,0;;;;;8,0;14,0;;20,0;20,0;;32,0;3,0;4,0;1,0;12,0;2,0;;3,0;7,0;1,0;111,0;64,0;10,0;10,0;16,0;35,0;48,0;15,0;;1,0;;;;;10,0;2,0;3,0;9,0;25,0;8,0;12,0;4,0;16,0;2,0;2,0;61,0;14,0;;;;;18,0;21,0;9,0;1,0;;26,0;6,0;;;2,0;6,0;1,0;2,0;7,0;;3,0;57,0;;7,0;44,0;6,0;1,0;;6,0;3,0;12,0;;;1,0;1,0;25,0;;9,0;;;6,0;42,0;12,0;8,0;2,0;;28,0;;1,0;28,0;;3,0;134,0;5,0;3,0;1,0;4,0;4,0;39,0;1,0;75,0;;9,0;2,0;;12,0;4,0;28,0;;;;2,0;;9,0;;2,0;5,0
objective;3,0;;1,0;;;2,0;2,0;3,0;4,0;18,0;35,0;1,0;7,0;;7,0;1,0;14,0;;;;1,0;7,0;;;;;3,0;6,0;1,0;2,0;1,0;;20,0;;1,0;;1,0;;5,0;;5,0;;21,0;4,0;;1,0;8,0;24,0;7,0;;4,0;25,0;1,0;;1,0;;21,0;5,0;1,0;;1,0;2,0;4,0;;3,0;30,0;8,0;36,0;;39,0;27,0;84,0;4,0;;;;2,0;1,0;9,0;78,0;19,0;28,0;1,0;46,0;;;1,0;;;10,0;334,0;;;2,0;2,0;;3,0;;12,0;1,0;1,0;2,0;4,0;18,0;;;99,0;3,0;4,0;7,0;7,0;2,0;;;;19,0;1,0;25,0;2,0;2,0;;;2,0;;;;;1,0;8,0;;;;6,0;2,0;;;;;5,0;;26,0;;;31,0;1,0;;;21,0;3,0;;1,0;;;3,0;5,0;;91,0;1,0;11,0;;;2,0;44,0;;;;;1,0;3,0;3,0;8,0;;;2,0;3,0;;11,0;;;;3,0;54,0;;;;2,0;;13,0;;;;;;14,0;;9,0;;;;4,0;;8,0;;3,0;;;;;;4,0;;2,0;;;1,0;;;;;8,0;29,0;2,0;;;;3,0;1,0;;62,0;;;;3,0;23,0;;;1,0;1,0;3,0;2,0;;;;6,0;;;;;13,0;50,0;;;;;;;25,0;5,0;;;;;4,0;1,0;1,0;;;;9,0;;;11,0;8,0;;;;;12,0;;17,0;;;1,0;;1,0;;;;;;1,0;;;;;;4,0;;;;;2,0;;;;;;1,0;;;;;1,0;;1,0;;1,0;;6,0;12,0;;;2,0;;1,0;;;;;;;9,0;10,0;;;;;2,0;5,0;;;;;;;;1,0;;;;;1,0;;1,0;;;;4,0;;;1,0;6,0;;2,0;;;;4,0;1,0;6,0;;1,0;;;;;4,0;;2,0;;1,0;;;;1,0;;;1,0;;;1,0;;;;4,0;;;;1,0;;;;;;1,0;;;;;;4,0;;;;2,0;4,0;1,0;;;;;;1,0;;;;;4,0;;;;2,0;;1,0;1,0;;;6,0;;;6,0;;1,0;;;;2,0;;;;4,0;;;;;11,0;;;;;;2,0;;;;;;;;;;;2,0;;1,0;;3,0;;;;5,0;9,0;;;;;;;;;;;;;;;;;2,0;;1,0;;;5,0;;;1,0;;2,0;;;;4,0;;5,0;;;;1,0;;3,0;;;;1,0;;;;4,0;;;;;14,0;;;;;;;;;;;;8,0;;;;;;;;;;1,0;;;;;;;;6,0;;;;;;2,0;;;6,0;;;1,0;;20,0;;2,0;;1,0;;;;;;;3,0;;;;;;;;;;;;8,0;;;;;1,0;;;;;;;;;;;5,0;;;;;;4,0;;;;8,0;;1,0;;;;;5,0;;;;;;;;;;;;;;6,0;4,0;;;;;;1,0;;;;;;;;;3,0;;;;;3,0;11,0;;;;4,0;;1,0;4,0;;;;;;1,0;;;2,0;;;;;;;;;;1,0;;;;;;;;;;;;;;;;;;;;;;;;;;27,0;;;;;;;;11,0;;;;;;;;;;;;;;;1,0;;;;;;2,0;;;;;;;;;;;;;1,0;;;;;;;;;1,0;;;;;;;;;;5,0;28,0;;;1,0;;;1,0;;;;;4,0;;;;2,0;;;;3,0;;;;;;;3,0;10,0;;;;;;;1,0;;;;;;3,0;;;;;;;;;;;;;1,0;;;;6,0;;1,0;;;;;;;;;;;;;;;;;2,0;;;;4,0;2,0;;;;;;;;;;;;;;;;;;;;;;;;;;;;;;;;;;;;6,0;;;;;;;;;;;;;;;;;18,0;;;;;;;;;;;;;;;;;;;;;;;;23,0;;;;;;;;;;8,0;6,0;;;;;2,0;;9,0;;;;;;;;;;;;;;;;;;;;;;2,0;;;;;;;;;1,0;;;;;;7,0;;;
operable;6,0;1,0;;3,0;6,0;38,0;25,0;50,0;14,0;5,0;7,0;;10,0;1,0;25,0;35,0;13,0;1,0;9,0;6,0;;73,0;4,0;1,0;;2,0;15,0;3,0;;2,0;9,0;11,0;6,0;4,0;203,0;141,0;14,0;15,0;3,0;;137,0;;6,0;5,0;85,0;22,0;89,0;148,0;51,0;103,0;10,0;35,0;1,0;;86,0;34,0;43,0;6,0;10,0;2,0;1,0;5,0;12,0;;19,0;1,0;117,0;2,0;16,0;7,0;22,0;1,0;108,0;14,0;;2,0;14,0;19,0;37,0;356,0;10,0;103,0;;96,0;;20,0;41,0;7,0;;1,0;197,0;;15,0;1,0;4,0;3,0;10,0;;8,0;26,0;;9,0;69,0;39,0;;;82,0;1,0;40,0;8,0;7,0;37,0;;5,0;7,0;39,0;43,0;61,0;23,0;14,0;1,0;;41,0;55,0;165,0;8,0;4,0;3,0;19,0;22,0;;39,0;8,0;;;7,0;3,0;8,0;5,0;;15,0;5,0;24,0;43,0;11,0;;;4,0;131,0;3,0;9,0;;33,0;54,0;51,0;9,0;160,0;;3,0;11,0;;77,0;464,0;2,0;4,0;;43,0;31,0;3,0;3,0;48,0;;;3,0;14,0;5,0;11,0;;4,0;2,0;1,0;80,0;;;35,0;15,0;;22,0;1,0;;9,0;;;26,0;;3,0;4,0;;1,0;6,0;;;6,0;19,0;9,0;;;4,0;7,0;11,0;;;4,0;19,0;1,0;1,0;;3,0;2,0;3,0;14,0;2,0;;;;;7,0;;196,0;;38,0;;10,0;6,0;4,0;20,0;8,0;5,0;;;;3,0;1,0;11,0;1,0;;3,0;2,0;17,0;3,0;8,0;4,0;4,0;7,0;;15,0;148,0;7,0;2,0;1,0;;;2,0;27,0;;;3,0;;10,0;;2,0;73,0;1,0;;2,0;;3,0;4,0;;4,0;26,0;2,0;23,0;;;19,0;3,0;7,0;;10,0;40,0;2,0;;;;2,0;;;;;13,0;13,0;5,0;;;;;1,0;;;;2,0;4,0;;6,0;11,0;;15,0;;19,0;;;;;24,0;;3,0;1,0;4,0;;;;1,0;;;8,0;;8,0;3,0;8,0;;;1,0;;4,0;6,0;3,0;;3,0;5,0;;1,0;;14,0;7,0;4,0;2,0;19,0;2,0;;1,0;3,0;;;;;;1,0;;2,0;1,0;4,0;;;4,0;;5,0;;4,0;4,0;;;2,0;;1,0;3,0;;;;3,0;;7,0;2,0;1,0;;27,0;;6,0;;;1,0;4,0;7,0;;;;;;1,0;42,0;30,0;2,0;10,0;;23,0;;2,0;;3,0;;;;34,0;5,0;;;2,0;5,0;1,0;3,0;;28,0;7,0;3,0;18,0;;;17,0;69,0;;16,0;10,0;8,0;;5,0;13,0;52,0;;12,0;3,0;;1,0;;2,0;;13,0;8,0;;3,0;2,0;3,0;4,0;22,0;33,0;;;;15,0;8,0;10,0;3,0;2,0;3,0;8,0;56,0;;9,0;;7,0;1,0;48,0;2,0;3,0;7,0;6,0;7,0;;;1,0;11,0;;2,0;3,0;50,0;1,0;1,0;3,0;1,0;30,0;;23,0;2,0;27,0;6,0;7,0;;4,0;;13,0;4,0;;10,0;;19,0;4,0;5,0;1,0;7,0;;;12,0;12,0;7,0;1,0;;;11,0;;;8,0;1,0;5,0;4,0;5,0;;1,0;14,0;;6,0;1,0;3,0;2,0;2,0;1,0;;14,0;1,0;3,0;;18,0;;;5,0;13,0;;2,0;2,0;1,0;;2,0;2,0;;2,0;;2,0;;22,0;23,0;16,0;;27,0;;9,0;;2,0;6,0;;;2,0;;5,0;;4,0;5,0;25,0;;;5,0;3,0;;7,0;2,0;;6,0;7,0;;7,0;1,0;;;11,0;19,0;13,0;;1,0;3,0;;;;;1,0;;;2,0;2,0;;;;14,0;;2,0;;;3,0;7,0;;21,0;;;;2,0;;;9,0;12,0;6,0;3,0;1,0;17,0;;1,0;3,0;1,0;5,0;;;;;6,0;16,0;5,0;18,0;;;;3,0;;1,0;;;6,0;1,0;;;3,0;;2,0;3,0;;37,0;39,0;;;;5,0;;;;;6,0;;;10,0;;;2,0;2,0;2,0;2,0;1,0;;3,0;;;1,0;;;;6,0;;;3,0;7,0;;;;4,0;7,0;3,0;;;;;;;;;;;;;2,0;;;;5,0;;;1,0;5,0;;2,0;6,0;;43,0;;;4,0;;;2,0;;;;;;;;;;;;2,0;;1,0;1,0;;1,0;4,0;14,0;20,0;;6,0;;2,0;;;;;;1,0;4,0;18,0;8,0;1,0;;1,0;;;3,0;;;;;;;13,0;;;6,0;;;2,0;3,0;2,0;;;;;6,0;1,0;;;6,0;;;;;;;6,0;4,0;;1,0;;;5,0;;8,0;;;;;1,0;2,0;;1,0;8,0;2,0;;;10,0;;1,0;;;;;;3,0;;;13,0;2,0;3,0;;2,0;;;5,0;;;3,0;;5,0;;12,0;;6,0;;1,0;1,0;;;;4,0;;;;;;9,0;;;;;4,0;2,0;;;;;;5,0;5,0;21,0;;;2,0;;;2,0;;;5,0;;;;1,0;20,0;7,0;;1,0;2,0;3,0;;2,0;;;2,0;;;2,0;;1,0;;5,0;2,0;13,0;;;;;;;5,0;4,0;3,0;;;1,0;1,0;;13,0;4,0;;8,0;;;8,0;;;;5,0;;;;;;;;;9,0;;1,0;;;5,0;;;;;;;;5,0;4,0;;;;;;;;;;;;;;;;;;4,0;;1,0;;;;;;;;;3,0;;;;
optical;106,0;11,0;15,0;2,0;8,0;216,0;204,0;384,0;154,0;296,0;360,0;28,0;54,0;;3784,0;182,0;79,0;55,0;12,0;1,0;9,0;255,0;46,0;163,0;5,0;5,0;78,0;24,0;85,0;50,0;13,0;191,0;642,0;15,0;203,0;92,0;82,0;84,0;10,0;8,0;195,0;11,0;129,0;40,0;120,0;84,0;138,0;1125,0;219,0;81,0;221,0;205,0;64,0;8,0;185,0;14,0;2081,0;43,0;16,0;;134,0;28,0;101,0;2,0;569,0;192,0;334,0;1064,0;72,0;123,0;81,0;96,0;232,0;66,0;5,0;225,0;30,0;95,0;236,0;3684,0;55,0;1029,0;10,0;931,0;22,0;10,0;152,0;;21,0;194,0;6730,0;;4,0;88,0;13,0;11,0;33,0;;327,0;13,0;1,0;6,0;660,0;704,0;99,0;82,0;;61,0;258,0;11,0;124,0;113,0;14,0;4,0;10,0;276,0;617,0;636,0;1864,0;77,0;10,0;61,0;21,0;55,0;44,0;8,0;102,0;9,0;121,0;81,0;45,0;69,0;158,0;38,0;43,0;25,0;64,0;53,0;34,0;160,0;80,0;1,0;26,0;996,0;37,0;3,0;3,0;349,0;469,0;23,0;16,0;32,0;87,0;84,0;430,0;15,0;3855,0;8,0;67,0;7,0;4,0;117,0;3585,0;13,0;38,0;;53,0;152,0;31,0;51,0;705,0;23,0;7,0;37,0;49,0;38,0;417,0;273,0;57,0;;31,0;215,0;11,0;22,0;24,0;50,0;6,0;248,0;78,0;6,0;17,0;34,0;28,0;65,0;11,0;56,0;;;25,0;66,0;28,0;11,0;33,0;1238,0;36,0;15,0;260,0;9,0;51,0;86,0;40,0;39,0;12,0;1,0;14,0;;50,0;5,0;35,0;34,0;361,0;137,0;58,0;2,0;28,0;33,0;101,0;1,0;901,0;39,0;451,0;41,0;162,0;204,0;205,0;756,0;119,0;67,0;42,0;73,0;34,0;19,0;24,0;1260,0;24,0;8,0;98,0;4,0;190,0;313,0;88,0;3,0;6,0;6,0;1,0;238,0;477,0;146,0;7,0;88,0;5,0;14,0;15,0;29,0;18,0;36,0;52,0;49,0;41,0;3,0;19,0;206,0;101,0;46,0;31,0;14,0;6,0;73,0;125,0;600,0;62,0;8,0;24,0;104,0;9,0;187,0;47,0;56,0;79,0;47,0;36,0;52,0;70,0;43,0;58,0;;15,0;10,0;20,0;2,0;88,0;56,0;62,0;92,0;4,0;2,0;3,0;31,0;35,0;10,0;;74,0;21,0;15,0;50,0;28,0;;9,0;57,0;135,0;12,0;;31,0;37,0;157,0;2,0;29,0;9,0;2,0;72,0;5,0;3,0;7,0;11,0;13,0;27,0;3,0;272,0;76,0;82,0;4,0;18,0;105,0;24,0;69,0;15,0;6,0;9,0;250,0;41,0;8,0;462,0;12,0;309,0;10,0;17,0;6,0;89,0;13,0;19,0;11,0;52,0;2,0;22,0;24,0;36,0;5,0;32,0;13,0;145,0;8,0;;3,0;12,0;18,0;1,0;79,0;43,0;114,0;52,0;5,0;;13,0;20,0;5,0;86,0;7,0;2,0;6,0;126,0;63,0;71,0;32,0;8,0;3,0;129,0;2,0;11,0;79,0;4,0;4,0;;1,0;45,0;7,0;;16,0;14,0;38,0;29,0;91,0;42,0;13,0;15,0;19,0;2,0;15,0;2,0;3,0;1,0;;5,0;163,0;3,0;1,0;1,0;5,0;16,0;;9,0;5,0;100,0;44,0;19,0;49,0;8,0;11,0;51,0;30,0;;12,0;38,0;153,0;;3,0;26,0;81,0;2,0;32,0;4,0;189,0;6,0;;7,0;9,0;41,0;7,0;9,0;1,0;;86,0;4,0;;18,0;22,0;115,0;;1,0;;17,0;1,0;17,0;1,0;;16,0;8,0;2,0;15,0;14,0;3,0;181,0;133,0;;178,0;105,0;1,0;;;9,0;15,0;1,0;16,0;1,0;6,0;3,0;29,0;10,0;5,0;18,0;5,0;71,0;1,0;1,0;494,0;18,0;2,0;80,0;13,0;20,0;;3,0;72,0;13,0;2,0;2,0;2,0;5,0;;53,0;7,0;43,0;5,0;64,0;33,0;11,0;2,0;4,0;5,0;19,0;5,0;4,0;1,0;;27,0;;;58,0;31,0;;142,0;;45,0;;10,0;1,0;35,0;21,0;6,0;62,0;5,0;;;11,0;16,0;1,0;73,0;;2,0;16,0;;1,0;4,0;5,0;345,0;14,0;21,0;4,0;43,0;;58,0;563,0;2,0;105,0;;1,0;11,0;11,0;33,0;1,0;5,0;2,0;6,0;;;87,0;24,0;;;;1,0;6,0;;;11,0;14,0;7,0;2,0;;41,0;;165,0;;6,0;3,0;24,0;38,0;17,0;1,0;2,0;;15,0;1,0;15,0;;16,0;;2,0;2,0;;1,0;11,0;2,0;;22,0;1,0;;230,0;3,0;27,0;6,0;1,0;8,0;;43,0;;;58,0;2,0;4,0;1,0;34,0;86,0;18,0;3,0;1,0;5,0;1,0;21,0;6,0;5,0;12,0;4,0;;21,0;22,0;5,0;5,0;9,0;;;5,0;;;28,0;55,0;6,0;8,0;39,0;;145,0;19,0;6,0;4,0;6,0;8,0;42,0;11,0;5,0;16,0;;;;19,0;7,0;;31,0;1,0;11,0;;45,0;1,0;4,0;6,0;;;34,0;6,0;1,0;27,0;1,0;;;51,0;2,0;1,0;16,0;1,0;24,0;18,0;5,0;;2,0;;16,0;;45,0;17,0;2,0;14,0;;;10,0;10,0;4,0;2,0;40,0;29,0;72,0;24,0;24,0;8,0;7,0;15,0;3,0;102,0;4,0;46,0;20,0;5,0;17,0;3,0;6,0;4,0;21,0;4,0;11,0;7,0;109,0;16,0;2,0;2,0;1,0;4,0;9,0;;33,0;8,0;;30,0;1,0;1,0;;16,0;1,0;22,0;3,0;;12,0;;;;23,0;5,0;5,0;3,0;20,0;2,0;26,0;11,0;92,0;1,0;6,0;10,0;20,0;9,0;3,0;16,0;;12,0;9,0;5,0;3,0;2,0;4,0;15,0;;;;44,0;31,0;4,0;4,0;35,0;20,0;;;;23,0;3,0;3,0;127,0;1,0;5,0;10,0;1,0;;10,0;2,0;;;68,0;;54,0;6,0;1,0;8,0;3,0;;4,0;1,0;12,0;10,0;8,0;122,0;11,0;18,0;6,0;27,0;5,0;4,0;27,0;3,0;4,0;8,0;;;12,0;5,0;17,0;;;;7,0;1,0;;;;2,0;5,0;28,0;12,0;;4,0;;29,0;7,0;1,0;;;34,0;;17,0;7,0;;41,0;;;16,0;;6,0;6,0;9,0;;1,0;6,0;;1,0;10,0;;1,0;44,0;1,0;4,0;4,0;11,0;12,0;2,0;;3,0;32,0;35,0;1,0;11,0;1,0;4,0;2,0;3,0;5,0;1,0;18,0;22,0;18,0;1,0;1,0;110,0;8,0;40,0;34,0;10,0;14,0;5,0;6,0;27,0;2,0;13,0;;13,0;;;13,0;;14,0;2,0;;6,0;;;15,0;2,0;1,0;5,0;57,0;13,0;80,0;7,0;5,0;;5,0;4,0;2,0;2,0;7,0;46,0;9,0;21,0;2,0;7,0;6,0;35,0;26,0;12,0;;9,0;59,0;;2,0;;5,0;1,0;6,0;;;2,0;2,0;;;;3,0;;5,0;1,0;2,0;8,0;2,0;;3,0;;;1,0;;;5,0;;5,0;1,0;;1,0;;;46,0
order;16,0;28,0;16,0;;1,0;2,0;9,0;21,0;10,0;70,0;20,0;2,0;9,0;;26,0;29,0;3,0;12,0;;6,0;;54,0;6,0;;2,0;2,0;8,0;5,0;;10,0;5,0;1,0;7,0;;39,0;15,0;19,0;5,0;1,0;;94,0;6,0;12,0;5,0;35,0;8,0;116,0;58,0;14,0;68,0;25,0;6,0;1,0;;7,0;1,0;182,0;2,0;3,0;;1,0;6,0;12,0;7,0;9,0;2,0;13,0;20,0;23,0;2,0;8,0;1,0;60,0;4,0;1,0;93,0;3,0;2,0;1,0;721,0;8,0;46,0;;68,0;5,0;4,0;6,0;;;4,0;584,0;3,0;;9,0;8,0;20,0;18,0;;42,0;6,0;3,0;23,0;9,0;618,0;3,0;1,0;61,0;;39,0;5,0;8,0;24,0;1,0;;;82,0;24,0;40,0;54,0;27,0;6,0;;5,0;23,0;3,0;7,0;;;4,0;4,0;;12,0;5,0;8,0;19,0;5,0;5,0;2,0;4,0;4,0;20,0;7,0;35,0;23,0;7,0;;;631,0;65,0;19,0;1,0;15,0;8,0;19,0;18,0;5,0;275,0;;7,0;18,0;15,0;10,0;164,0;;6,0;4,0;16,0;20,0;;;178,0;;;6,0;2,0;10,0;1,0;4,0;;;2,0;10,0;;;3,0;12,0;;2,0;92,0;4,0;5,0;1,0;;13,0;1,0;2,0;15,0;;;2,0;4,0;1,0;9,0;38,0;;;5,0;;10,0;5,0;;1,0;9,0;;10,0;;;4,0;;3,0;2,0;;4,0;;;;23,0;;29,0;;19,0;3,0;4,0;19,0;3,0;21,0;10,0;13,0;2,0;;9,0;;;8,0;3,0;;;4,0;57,0;3,0;;;;;;4,0;29,0;1,0;;21,0;;;3,0;17,0;;1,0;1,0;8,0;6,0;;;2,0;9,0;2,0;;2,0;9,0;2,0;5,0;14,0;5,0;1,0;11,0;;2,0;19,0;1,0;1,0;;2,0;9,0;3,0;14,0;;2,0;5,0;6,0;;2,0;5,0;2,0;2,0;3,0;;2,0;5,0;;2,0;7,0;;;2,0;1,0;6,0;1,0;7,0;6,0;6,0;;7,0;;;;;12,0;;12,0;;2,0;1,0;;1,0;;;;2,0;8,0;5,0;4,0;1,0;;;7,0;2,0;1,0;2,0;7,0;13,0;1,0;12,0;;7,0;;1,0;;;;9,0;2,0;1,0;;;3,0;;;;;4,0;;5,0;1,0;9,0;;6,0;1,0;;2,0;;14,0;2,0;1,0;;2,0;1,0;3,0;6,0;;;1,0;6,0;3,0;8,0;1,0;1,0;7,0;1,0;1,0;10,0;1,0;1,0;;;7,0;8,0;;;1,0;;1,0;6,0;14,0;16,0;4,0;8,0;2,0;3,0;;5,0;;1,0;;3,0;4,0;;6,0;;1,0;17,0;3,0;;;15,0;20,0;4,0;6,0;3,0;3,0;11,0;20,0;2,0;7,0;5,0;15,0;;14,0;4,0;10,0;6,0;7,0;6,0;7,0;;;8,0;3,0;20,0;3,0;4,0;;5,0;4,0;;;6,0;2,0;;;;3,0;8,0;6,0;;3,0;1,0;23,0;1,0;1,0;;2,0;;20,0;;;15,0;4,0;10,0;3,0;5,0;3,0;;8,0;1,0;6,0;12,0;;1,0;;6,0;3,0;;3,0;;;10,0;;;2,0;;5,0;;;1,0;3,0;;5,0;;;;;2,0;1,0;2,0;6,0;4,0;;1,0;2,0;1,0;3,0;;;3,0;6,0;2,0;;;11,0;;;7,0;13,0;1,0;;2,0;7,0;6,0;9,0;4,0;;7,0;2,0;;4,0;6,0;2,0;2,0;3,0;2,0;1,0;1,0;;10,0;3,0;12,0;1,0;4,0;;5,0;;2,0;3,0;2,0;;;3,0;8,0;;;1,0;;3,0;;;;1,0;;9,0;;2,0;1,0;;1,0;1,0;;1,0;;;1,0;7,0;3,0;1,0;;34,0;1,0;1,0;1,0;3,0;;;;;1,0;2,0;;;12,0;;2,0;;7,0;7,0;;;7,0;8,0;;20,0;6,0;;;;;2,0;5,0;4,0;23,0;;;1,0;1,0;8,0;;1,0;3,0;1,0;2,0;3,0;2,0;11,0;;1,0;;11,0;2,0;1,0;;;9,0;;3,0;1,0;7,0;2,0;9,0;1,0;;;6,0;1,0;8,0;3,0;;;;1,0;;;;1,0;;;;2,0;;2,0;;2,0;;1,0;;1,0;2,0;;;;;;;6,0;;;1,0;1,0;1,0;;;7,0;6,0;1,0;;;;5,0;3,0;;;;1,0;6,0;;;;2,0;;74,0;9,0;1,0;;;;9,0;2,0;1,0;;1,0;2,0;;1,0;10,0;1,0;1,0;;;6,0;;;;;3,0;1,0;1,0;1,0;;2,0;;1,0;2,0;1,0;12,0;;;;;;60,0;;;;;;;3,0;6,0;6,0;;;;;3,0;;1,0;;1,0;;;;7,0;1,0;;43,0;6,0;1,0;;1,0;4,0;;1,0;;3,0;;1,0;6,0;;1,0;;;1,0;2,0;2,0;1,0;9,0;1,0;;;;;;17,0;;;6,0;;5,0;1,0;;;;;;;;5,0;1,0;;;3,0;;;;;;1,0;;;11,0;5,0;2,0;1,0;;2,0;5,0;1,0;;;1,0;;;;7,0;6,0;;1,0;;;;8,0;1,0;;;;;;1,0;;;;;;;1,0;;;3,0;;;16,0;;;;;;2,0;;;;;;6,0;10,0;;;;1,0;1,0;2,0;;;;7,0;;;;;;;1,0;7,0;;;;;3,0;;3,0;;1,0;;5,0;;;;3,0;8,0;;13,0;;4,0;;;1,0;8,0;;;;1,0;;;;1,0;;;;;;;;;;6,0;;2,0;1,0;;5,0;;;1,0;2,0;;;;;;;3,0;;;;;1,0;;9,0;;1,0;;;;;;;;;1,0;;;;;;10,0;
output;5,0;37,0;2,0;;22,0;28,0;22,0;153,0;77,0;69,0;52,0;;46,0;1,0;23,0;398,0;54,0;4,0;16,0;8,0;18,0;201,0;22,0;12,0;4,0;75,0;161,0;21,0;;9,0;45,0;31,0;575,0;4,0;577,0;198,0;56,0;80,0;9,0;;1259,0;25,0;15,0;37,0;133,0;115,0;185,0;987,0;246,0;438,0;24,0;45,0;6,0;5,0;110,0;37,0;209,0;8,0;10,0;11,0;14,0;18,0;38,0;22,0;98,0;10,0;117,0;101,0;113,0;8,0;68,0;11,0;466,0;4,0;2,0;53,0;25,0;11,0;47,0;2815,0;82,0;325,0;9,0;360,0;10,0;95,0;43,0;2,0;1,0;14,0;169,0;2,0;59,0;4,0;39,0;44,0;85,0;1,0;316,0;23,0;31,0;14,0;102,0;217,0;4,0;40,0;258,0;39,0;;78,0;16,0;85,0;2,0;10,0;15,0;332,0;146,0;217,0;92,0;102,0;13,0;3,0;198,0;313,0;166,0;37,0;13,0;3,0;1,0;57,0;;214,0;7,0;;73,0;84,0;100,0;173,0;45,0;3,0;95,0;7,0;28,0;498,0;60,0;1,0;;182,0;3335,0;37,0;28,0;3,0;56,0;110,0;62,0;52,0;271,0;;6,0;148,0;9,0;94,0;1192,0;10,0;3,0;;518,0;75,0;22,0;29,0;15,0;;;15,0;129,0;16,0;8,0;2,0;4,0;;4,0;118,0;;;90,0;342,0;;82,0;2,0;;50,0;14,0;;391,0;6,0;138,0;104,0;;12,0;1,0;3,0;10,0;195,0;126,0;14,0;2,0;51,0;30,0;51,0;47,0;;14,0;8,0;28,0;;;;;;6,0;29,0;29,0;;;1,0;3,0;2,0;;397,0;;49,0;2,0;17,0;18,0;2,0;10,0;28,0;11,0;5,0;;7,0;4,0;7,0;36,0;83,0;1,0;105,0;10,0;916,0;22,0;4,0;26,0;;;35,0;77,0;263,0;25,0;;14,0;;;13,0;456,0;2,0;4,0;6,0;6,0;23,0;;;198,0;26,0;;22,0;;83,0;7,0;31,0;82,0;164,0;105,0;265,0;;12,0;290,0;35,0;2,0;2,0;9,0;41,0;18,0;37,0;;;;20,0;;8,0;1,0;12,0;27,0;9,0;3,0;;;19,0;57,0;2,0;5,0;;12,0;3,0;;2,0;71,0;;87,0;;55,0;4,0;;;6,0;109,0;;7,0;;;2,0;;;;2,0;;46,0;8,0;3,0;95,0;;;11,0;6,0;37,0;10,0;26,0;8,0;23,0;92,0;19,0;;;6,0;50,0;2,0;1,0;10,0;121,0;14,0;16,0;3,0;2,0;1,0;;;5,0;3,0;8,0;;5,0;6,0;2,0;1,0;24,0;3,0;;2,0;;23,0;11,0;;;13,0;8,0;20,0;24,0;;;6,0;14,0;4,0;61,0;38,0;4,0;;53,0;;;7,0;8,0;58,0;34,0;9,0;76,0;;;33,0;38,0;47,0;172,0;78,0;73,0;34,0;16,0;38,0;20,0;7,0;15,0;3,0;3,0;4,0;3,0;43,0;47,0;;6,0;9,0;3,0;3,0;67,0;8,0;367,0;428,0;10,0;19,0;1,0;22,0;30,0;121,0;40,0;36,0;88,0;46,0;7,0;26,0;26,0;159,0;3,0;8,0;111,0;18,0;2,0;;8,0;57,0;114,0;38,0;87,0;4,0;12,0;37,0;5,0;33,0;5,0;5,0;;15,0;;47,0;35,0;;3,0;26,0;30,0;115,0;8,0;6,0;27,0;416,0;8,0;80,0;28,0;12,0;23,0;42,0;174,0;2,0;12,0;;31,0;15,0;18,0;35,0;20,0;24,0;2,0;31,0;13,0;114,0;;4,0;6,0;54,0;58,0;114,0;5,0;12,0;7,0;180,0;1,0;18,0;58,0;;47,0;75,0;9,0;;;7,0;;17,0;18,0;21,0;19,0;;5,0;82,0;8,0;9,0;21,0;1,0;81,0;3,0;57,0;8,0;;80,0;18,0;10,0;11,0;2,0;1,0;1,0;38,0;19,0;97,0;10,0;11,0;10,0;103,0;25,0;;16,0;21,0;112,0;21,0;1,0;;;6,0;2,0;15,0;36,0;12,0;3,0;34,0;5,0;153,0;;9,0;97,0;;26,0;;13,0;12,0;;;2,0;1,0;15,0;5,0;;18,0;44,0;60,0;1,0;3,0;2,0;2,0;5,0;1,0;4,0;;2,0;;;4,0;9,0;40,0;23,0;7,0;8,0;21,0;19,0;24,0;2,0;;46,0;2,0;10,0;9,0;6,0;;80,0;3,0;1,0;6,0;;1,0;32,0;3,0;2,0;17,0;7,0;3,0;86,0;17,0;;17,0;105,0;;4,0;16,0;6,0;3,0;46,0;;29,0;6,0;2,0;3,0;17,0;22,0;25,0;42,0;;;47,0;15,0;;369,0;3,0;;4,0;4,0;3,0;2,0;3,0;;12,0;200,0;;;190,0;;1,0;50,0;;3,0;18,0;1,0;37,0;7,0;;;;6,0;2,0;;;1,0;32,0;;;22,0;5,0;23,0;113,0;1,0;3,0;;2,0;;16,0;1,0;1,0;70,0;6,0;;2,0;;38,0;6,0;;12,0;9,0;31,0;;;;3,0;;2,0;;8,0;;;6,0;;27,0;1,0;;;4,0;5,0;1,0;79,0;2,0;7,0;2,0;25,0;;5,0;17,0;8,0;;2,0;;15,0;22,0;;1,0;3,0;;;;2,0;;13,0;;3,0;3,0;1,0;;42,0;3,0;;21,0;34,0;16,0;119,0;38,0;86,0;12,0;17,0;2,0;43,0;10,0;10,0;6,0;22,0;26,0;12,0;12,0;10,0;10,0;4,0;12,0;53,0;356,0;5,0;18,0;14,0;2,0;3,0;64,0;;10,0;65,0;;3,0;184,0;37,0;4,0;;;51,0;35,0;1,0;21,0;4,0;95,0;24,0;3,0;5,0;1,0;;41,0;3,0;10,0;19,0;;14,0;;19,0;11,0;23,0;2,0;;15,0;1,0;7,0;1,0;151,0;24,0;2,0;2,0;3,0;1,0;;33,0;;5,0;2,0;1,0;;4,0;30,0;25,0;9,0;11,0;7,0;;5,0;1,0;1,0;6,0;;135,0;2,0;49,0;9,0;1,0;17,0;2,0;3,0;9,0;10,0;;5,0;;;2,0;8,0;7,0;9,0;9,0;;;4,0;8,0;12,0;;;25,0;;2,0;;;1,0;;;27,0;2,0;6,0;;4,0;15,0;;;9,0;;1,0;8,0;1,0;;;9,0;46,0;1,0;;20,0;;42,0;;1,0;1,0;8,0;;;;;;47,0;3,0;12,0;1,0;14,0;7,0;1,0;;2,0;18,0;;33,0;;279,0;;;1,0;2,0;28,0;;10,0;;1,0;1,0;31,0;2,0;;;;2,0;10,0;;5,0;;21,0;;;8,0;4,0;1,0;;;;8,0;;1,0;27,0;1,0;;11,0;11,0;6,0;6,0;95,0;;1,0;;15,0;5,0;;1,0;8,0;10,0;3,0;;;1,0;5,0;;2,0;;;;22,0;6,0;;2,0;;6,0;3,0;;;;;3,0;
parameter;1,0;1,0;1,0;1,0;11,0;40,0;19,0;94,0;22,0;9,0;26,0;;93,0;8,0;8,0;333,0;1,0;30,0;19,0;38,0;278,0;158,0;36,0;7,0;3,0;6,0;209,0;14,0;2,0;18,0;23,0;34,0;114,0;19,0;286,0;34,0;45,0;157,0;8,0;;230,0;5,0;37,0;179,0;53,0;15,0;466,0;161,0;40,0;113,0;;105,0;38,0;2,0;3,0;5,0;2,0;11,0;141,0;11,0;;49,0;3,0;8,0;45,0;62,0;90,0;10,0;147,0;1,0;54,0;;130,0;1,0;61,0;47,0;18,0;;6,0;761,0;8,0;82,0;3,0;296,0;7,0;43,0;3,0;6,0;1,0;57,0;70,0;;3,0;4,0;40,0;34,0;35,0;6,0;394,0;22,0;106,0;39,0;128,0;82,0;7,0;8,0;11,0;5,0;78,0;;5,0;64,0;;;;176,0;19,0;70,0;;91,0;;;43,0;202,0;42,0;22,0;4,0;1,0;2,0;42,0;;41,0;33,0;;122,0;10,0;54,0;83,0;10,0;1,0;44,0;;22,0;72,0;215,0;16,0;;3,0;100,0;24,0;24,0;;55,0;144,0;11,0;4,0;165,0;1,0;28,0;1,0;13,0;19,0;218,0;3,0;2,0;;216,0;55,0;1,0;1,0;42,0;;;2,0;17,0;63,0;1,0;;;3,0;9,0;1,0;;;;7,0;;31,0;;;4,0;3,0;;2,0;2,0;;3,0;;;;;9,0;85,0;30,0;10,0;;4,0;5,0;175,0;19,0;;;;;;;;;13,0;;;;;11,0;;;;;16,0;;;;1,0;13,0;4,0;1,0;33,0;6,0;;;6,0;;;1,0;5,0;;;8,0;39,0;10,0;;;1,0;;;3,0;73,0;3,0;;;;;;118,0;;7,0;9,0;;16,0;;;18,0;19,0;;;;1,0;9,0;;6,0;4,0;;;;;103,0;5,0;3,0;3,0;;30,0;18,0;;;;;2,0;;;;2,0;7,0;;;;;1,0;8,0;;1,0;;3,0;3,0;;4,0;31,0;;;;7,0;;;;;;;;;;;;;;2,0;;1,0;8,0;;3,0;;;;14,0;4,0;14,0;;107,0;;;21,0;;;;4,0;;;;102,0;;22,0;;1,0;;;;;;;;;13,0;;;1,0;17,0;2,0;;;;72,0;;;5,0;;;3,0;;;;;;27,0;23,0;1,0;;4,0;2,0;10,0;4,0;2,0;4,0;2,0;;16,0;5,0;5,0;4,0;3,0;21,0;235,0;76,0;8,0;21,0;17,0;32,0;2,0;2,0;;;;3,0;10,0;5,0;20,0;13,0;9,0;;29,0;7,0;16,0;;59,0;7,0;2,0;21,0;;28,0;15,0;61,0;;32,0;80,0;7,0;;15,0;70,0;24,0;5,0;14,0;16,0;53,0;12,0;3,0;99,0;30,0;23,0;5,0;14,0;2,0;5,0;;;1,0;14,0;1,0;;3,0;2,0;82,0;35,0;2,0;;4,0;88,0;59,0;2,0;17,0;1,0;2,0;4,0;240,0;9,0;7,0;16,0;36,0;;29,0;21,0;4,0;14,0;;32,0;21,0;5,0;17,0;1,0;4,0;13,0;27,0;8,0;6,0;;;15,0;97,0;23,0;27,0;3,0;31,0;22,0;27,0;6,0;;1,0;18,0;;;;4,0;7,0;18,0;8,0;;238,0;21,0;5,0;8,0;;1,0;33,0;12,0;23,0;15,0;2,0;1,0;;122,0;70,0;2,0;1,0;;;1,0;8,0;6,0;10,0;23,0;11,0;;9,0;;;3,0;55,0;4,0;3,0;;;;;;5,0;;30,0;;8,0;1,0;7,0;;180,0;14,0;5,0;2,0;;27,0;25,0;;;;2,0;13,0;2,0;;;88,0;22,0;;2,0;;;7,0;2,0;;2,0;4,0;6,0;;9,0;4,0;;1,0;1,0;4,0;26,0;;47,0;4,0;;;;;;6,0;;;1,0;;9,0;;7,0;;10,0;;3,0;6,0;;33,0;16,0;;23,0;;;;9,0;;6,0;;;6,0;;8,0;3,0;1,0;3,0;;;39,0;;24,0;;2,0;11,0;;;11,0;;12,0;1,0;;;;1,0;;10,0;5,0;;;2,0;;5,0;3,0;;24,0;;;;;;;;;;6,0;;;29,0;;1,0;;;2,0;2,0;;;1,0;;1,0;;;;;;;20,0;;;;34,0;;;;;;4,0;2,0;;;;;;;2,0;;;1,0;;;;1,0;2,0;;9,0;3,0;1,0;;19,0;14,0;1,0;;;18,0;;;2,0;;;;;;1,0;1,0;;;;;1,0;;;;;;;;;11,0;98,0;5,0;;;;;;3,0;68,0;;8,0;4,0;;61,0;7,0;8,0;9,0;;;1,0;3,0;4,0;;7,0;8,0;1,0;35,0;;;;;;5,0;12,0;6,0;16,0;27,0;;10,0;1,0;;;;9,0;1,0;13,0;22,0;;39,0;;2,0;5,0;;15,0;2,0;39,0;;17,0;59,0;;;;9,0;2,0;2,0;;4,0;4,0;1,0;11,0;7,0;;;;;;1,0;8,0;;;;;;;;8,0;;17,0;10,0;3,0;1,0;2,0;;;;2,0;1,0;2,0;;;4,0;7,0;;;;;6,0;1,0;;;;;;;;;;;;2,0;;;1,0;;;25,0;59,0;;;;;3,0;1,0;54,0;2,0;1,0;;1,0;7,0;310,0;;;;;;;;;;2,0;2,0;44,0;;1,0;13,0;;;2,0;7,0;;1,0;;;28,0;6,0;3,0;8,0;1,0;18,0;2,0;;2,0;;;1,0;2,0;;;;59,0;;;;1,0;;;;;;1,0;;1,0;11,0;;;1,0;5,0;;6,0;4,0;2,0;;;;6,0;;;5,0;;10,0;;;;;2,0;13,0;14,0;47,0;;;3,0;;;1,0;;2,0;14,0;;;;;;;;
pass;2,0;2,0;2,0;;1,0;14,0;55,0;9,0;50,0;31,0;17,0;1,0;11,0;;77,0;31,0;60,0;;;;9,0;14,0;1,0;1,0;;;22,0;2,0;;1,0;;3,0;59,0;5,0;13,0;6,0;8,0;2,0;1,0;;28,0;;39,0;1,0;17,0;9,0;19,0;84,0;20,0;26,0;21,0;14,0;;;4,0;6,0;44,0;;1,0;;25,0;3,0;10,0;2,0;205,0;26,0;22,0;48,0;21,0;18,0;;;11,0;;;15,0;;1,0;10,0;195,0;6,0;29,0;5,0;42,0;2,0;1,0;3,0;;2,0;7,0;266,0;;;8,0;2,0;4,0;2,0;1,0;45,0;2,0;3,0;1,0;41,0;57,0;7,0;7,0;124,0;8,0;16,0;5,0;;2,0;4,0;;;39,0;84,0;80,0;8,0;23,0;3,0;4,0;1,0;10,0;6,0;;;9,0;26,0;6,0;;12,0;3,0;;4,0;1,0;31,0;5,0;3,0;;16,0;;;67,0;15,0;;2,0;25,0;24,0;;4,0;;3,0;9,0;21,0;4,0;56,0;;8,0;;2,0;7,0;113,0;;2,0;;3,0;12,0;37,0;15,0;5,0;2,0;3,0;1,0;21,0;3,0;15,0;20,0;3,0;4,0;15,0;10,0;;25,0;4,0;23,0;17,0;29,0;;;;1,0;;16,0;2,0;11,0;16,0;;;16,0;;;2,0;27,0;;;9,0;7,0;5,0;15,0;;1,0;7,0;1,0;8,0;6,0;23,0;5,0;5,0;130,0;66,0;29,0;7,0;;1,0;1,0;12,0;1,0;543,0;;41,0;2,0;19,0;38,0;15,0;;12,0;86,0;11,0;10,0;6,0;;11,0;33,0;1,0;;13,0;;19,0;13,0;28,0;30,0;4,0;;;;123,0;41,0;13,0;;;;7,0;3,0;2,0;;4,0;12,0;32,0;;;25,0;5,0;2,0;9,0;10,0;2,0;4,0;17,0;90,0;6,0;;3,0;;;18,0;;9,0;;8,0;54,0;7,0;;;5,0;6,0;;5,0;36,0;;7,0;69,0;10,0;5,0;19,0;;1,0;20,0;24,0;;;7,0;3,0;2,0;4,0;1,0;1,0;6,0;4,0;10,0;4,0;;5,0;1,0;11,0;;8,0;1,0;1,0;21,0;3,0;;4,0;;;21,0;9,0;26,0;;6,0;3,0;;8,0;3,0;9,0;;3,0;;7,0;6,0;1,0;9,0;;10,0;;21,0;;66,0;2,0;3,0;1,0;9,0;1,0;2,0;3,0;1,0;1,0;1,0;3,0;4,0;1,0;3,0;;;;1,0;6,0;3,0;16,0;11,0;46,0;2,0;5,0;17,0;1,0;;;5,0;4,0;13,0;3,0;15,0;6,0;;13,0;;;1,0;13,0;1,0;1,0;;;5,0;;;;5,0;;4,0;2,0;1,0;1,0;;4,0;;2,0;;;;;;9,0;;;1,0;;5,0;;;;6,0;4,0;10,0;6,0;;4,0;6,0;12,0;;5,0;1,0;18,0;6,0;4,0;;;;3,0;6,0;13,0;;;;4,0;6,0;1,0;;;;3,0;;;;;;;2,0;21,0;6,0;7,0;1,0;2,0;3,0;8,0;;;1,0;3,0;1,0;16,0;13,0;1,0;66,0;6,0;;4,0;;;8,0;;;;;;1,0;;1,0;5,0;;7,0;;3,0;11,0;1,0;;1,0;9,0;;;3,0;19,0;1,0;3,0;3,0;;;;;;1,0;;3,0;4,0;;;3,0;1,0;;2,0;5,0;1,0;;3,0;;10,0;1,0;;;1,0;;7,0;1,0;;;2,0;1,0;1,0;;;;20,0;;1,0;;3,0;;;10,0;3,0;;;1,0;;2,0;;;;;;19,0;;9,0;;;3,0;;4,0;;11,0;;3,0;;;9,0;;;3,0;2,0;4,0;;;;2,0;;;;;5,0;;6,0;;4,0;;;;3,0;6,0;;;6,0;4,0;2,0;;4,0;;;;;;;2,0;;;2,0;;51,0;;;1,0;;;;6,0;;;;10,0;;;;;;;;;;1,0;2,0;1,0;8,0;2,0;;;4,0;2,0;1,0;;1,0;;8,0;;;1,0;5,0;1,0;2,0;2,0;;4,0;5,0;9,0;;;;5,0;;1,0;3,0;;;;8,0;8,0;;5,0;;;1,0;2,0;;;;;;;4,0;6,0;9,0;;;;2,0;3,0;;1,0;;5,0;;5,0;;;;16,0;;4,0;;1,0;4,0;;5,0;;;;;16,0;10,0;3,0;;2,0;;;;2,0;28,0;;6,0;4,0;;;3,0;2,0;;2,0;1,0;;;1,0;;;12,0;;;1,0;;1,0;7,0;;;;1,0;;;;;;3,0;;;;1,0;8,0;1,0;8,0;;6,0;2,0;;2,0;;;;;9,0;9,0;;1,0;;;;2,0;;2,0;16,0;;;;;1,0;3,0;;;56,0;2,0;;;;;;;2,0;15,0;;;;;1,0;;2,0;2,0;;;;;4,0;;;1,0;;;;2,0;7,0;;4,0;;;1,0;;;13,0;1,0;1,0;;2,0;;;;;;;;1,0;;;1,0;;5,0;;2,0;;;;;6,0;3,0;1,0;;;21,0;;8,0;;;1,0;1,0;;22,0;2,0;1,0;;1,0;;;;;;1,0;;;;5,0;;1,0;13,0;;1,0;18,0;;;5,0;;3,0;;;;2,0;7,0;;1,0;;;;4,0;;;1,0;8,0;;;23,0;2,0;;;1,0;1,0;;;;;;;;;;3,0;;10,0;;;;6,0;3,0;11,0;;1,0;;;1,0;;1,0;3,0;17,0;1,0;5,0;;1,0;1,0;;15,0;;;;29,0;1,0;6,0;4,0;;2,0;;;;;6,0;;;;5,0;;2,0;;1,0;;;;1,0;;;;;;;;;;;;;;
perform;4,0;3,0;2,0;9,0;11,0;21,0;13,0;168,0;79,0;66,0;49,0;;25,0;3,0;42,0;190,0;2,0;12,0;4,0;13,0;83,0;164,0;46,0;8,0;1,0;3,0;204,0;4,0;2,0;5,0;160,0;8,0;419,0;28,0;803,0;134,0;56,0;293,0;16,0;;354,0;4,0;19,0;21,0;129,0;189,0;274,0;443,0;146,0;204,0;5,0;38,0;29,0;12,0;87,0;87,0;66,0;5,0;14,0;43,0;2,0;30,0;21,0;5,0;120,0;15,0;209,0;47,0;92,0;3,0;165,0;26,0;144,0;4,0;19,0;44,0;20,0;11,0;17,0;1707,0;8,0;168,0;11,0;174,0;2,0;162,0;35,0;16,0;1,0;12,0;247,0;1,0;10,0;2,0;54,0;56,0;34,0;3,0;601,0;18,0;17,0;13,0;100,0;139,0;2,0;37,0;113,0;24,0;85,0;64,0;2,0;;;1,0;13,0;272,0;118,0;153,0;26,0;117,0;4,0;;327,0;921,0;354,0;87,0;3,0;7,0;3,0;42,0;5,0;62,0;11,0;9,0;10,0;31,0;34,0;78,0;104,0;4,0;49,0;;8,0;69,0;54,0;13,0;;13,0;578,0;24,0;16,0;;23,0;127,0;33,0;25,0;256,0;;57,0;53,0;19,0;31,0;806,0;12,0;7,0;;128,0;41,0;15,0;5,0;160,0;1,0;1,0;18,0;49,0;20,0;9,0;5,0;4,0;;1,0;78,0;9,0;1,0;123,0;108,0;2,0;31,0;4,0;;8,0;71,0;;24,0;;2,0;14,0;1,0;27,0;3,0;3,0;4,0;28,0;41,0;3,0;;93,0;4,0;150,0;38,0;13,0;3,0;3,0;8,0;;1,0;;;;4,0;12,0;13,0;;2,0;3,0;;5,0;1,0;173,0;1,0;25,0;4,0;19,0;21,0;5,0;35,0;73,0;4,0;1,0;4,0;16,0;;;4,0;32,0;1,0;124,0;7,0;484,0;8,0;2,0;4,0;;5,0;;52,0;149,0;;;;;10,0;;101,0;1,0;20,0;4,0;2,0;69,0;2,0;16,0;26,0;19,0;;;4,0;32,0;12,0;9,0;28,0;65,0;26,0;21,0;;9,0;232,0;;11,0;4,0;;18,0;28,0;16,0;1,0;2,0;1,0;10,0;;1,0;;10,0;20,0;;;1,0;;2,0;31,0;;8,0;6,0;10,0;2,0;;4,0;56,0;;15,0;1,0;3,0;;1,0;;;92,0;;;;22,0;5,0;;;;2,0;;28,0;;5,0;29,0;4,0;;;6,0;17,0;7,0;;11,0;3,0;13,0;25,0;;1,0;43,0;39,0;2,0;2,0;2,0;48,0;18,0;15,0;1,0;7,0;;;;;3,0;;;1,0;2,0;2,0;;4,0;5,0;;1,0;;13,0;17,0;2,0;;9,0;;2,0;27,0;2,0;;21,0;5,0;;47,0;16,0;10,0;1,0;13,0;;9,0;8,0;;;;35,0;16,0;;;15,0;9,0;29,0;41,0;99,0;88,0;30,0;1,0;67,0;12,0;3,0;11,0;26,0;11,0;2,0;4,0;10,0;131,0;;17,0;3,0;19,0;7,0;5,0;;110,0;58,0;19,0;12,0;;28,0;15,0;204,0;4,0;42,0;59,0;65,0;1,0;11,0;45,0;970,0;6,0;5,0;64,0;25,0;1,0;1,0;4,0;30,0;70,0;21,0;18,0;2,0;27,0;18,0;;4,0;32,0;4,0;;;2,0;28,0;28,0;2,0;2,0;9,0;12,0;154,0;;7,0;6,0;36,0;20,0;47,0;12,0;85,0;47,0;39,0;70,0;22,0;1,0;3,0;6,0;8,0;14,0;9,0;158,0;26,0;;14,0;1,0;14,0;1,0;25,0;5,0;5,0;111,0;23,0;11,0;15,0;;226,0;5,0;49,0;9,0;;7,0;10,0;6,0;1,0;3,0;10,0;;9,0;15,0;5,0;135,0;;;17,0;6,0;14,0;10,0;6,0;37,0;8,0;5,0;12,0;;8,0;4,0;;22,0;5,0;1,0;2,0;10,0;11,0;20,0;3,0;13,0;;35,0;7,0;;1,0;9,0;2,0;16,0;1,0;;5,0;12,0;2,0;7,0;6,0;16,0;2,0;30,0;4,0;143,0;7,0;51,0;90,0;3,0;10,0;;8,0;15,0;;;3,0;7,0;29,0;1,0;8,0;1,0;57,0;29,0;2,0;33,0;3,0;;6,0;1,0;18,0;4,0;1,0;2,0;3,0;13,0;4,0;5,0;3,0;3,0;12,0;2,0;2,0;37,0;;;4,0;;1,0;7,0;2,0;5,0;1,0;1,0;1,0;14,0;12,0;8,0;53,0;5,0;2,0;83,0;23,0;1,0;64,0;14,0;1,0;8,0;60,0;;3,0;7,0;20,0;3,0;3,0;4,0;20,0;1,0;11,0;4,0;6,0;11,0;23,0;3,0;1,0;;43,0;9,0;4,0;27,0;4,0;2,0;;;10,0;5,0;;;13,0;12,0;9,0;1,0;284,0;6,0;1,0;2,0;3,0;18,0;38,0;;88,0;4,0;;1,0;;2,0;;;10,0;1,0;5,0;;;31,0;15,0;8,0;10,0;1,0;4,0;4,0;;;2,0;;4,0;9,0;13,0;;;;5,0;12,0;;1,0;3,0;131,0;;;;;1,0;6,0;;;;;6,0;;35,0;4,0;;29,0;4,0;2,0;;5,0;1,0;12,0;7,0;20,0;4,0;4,0;34,0;1,0;2,0;;1,0;20,0;2,0;;;6,0;;4,0;4,0;;;7,0;;3,0;;;1,0;12,0;4,0;;10,0;11,0;11,0;6,0;2,0;16,0;7,0;16,0;7,0;59,0;;1,0;2,0;;30,0;29,0;2,0;2,0;;;33,0;19,0;9,0;6,0;;;;16,0;51,0;3,0;9,0;35,0;17,0;24,0;22,0;8,0;5,0;;;8,0;22,0;53,0;13,0;36,0;11,0;62,0;7,0;7,0;17,0;;15,0;11,0;29,0;49,0;;15,0;;20,0;;;5,0;1,0;4,0;31,0;2,0;27,0;14,0;1,0;6,0;8,0;17,0;4,0;2,0;3,0;2,0;23,0;12,0;5,0;;;;1,0;;11,0;4,0;;106,0;;2,0;12,0;;19,0;3,0;4,0;12,0;27,0;4,0;25,0;9,0;4,0;10,0;10,0;1,0;3,0;;3,0;;9,0;1,0;;5,0;;;5,0;5,0;;4,0;;4,0;2,0;5,0;1,0;;;;1,0;1,0;28,0;2,0;3,0;2,0;4,0;27,0;7,0;5,0;1,0;;23,0;2,0;1,0;25,0;8,0;3,0;1,0;10,0;;35,0;;1,0;;3,0;;;3,0;;;;2,0;30,0;2,0;4,0;3,0;5,0;14,0;;27,0;;5,0;;6,0;1,0;;11,0;2,0;9,0;2,0;;;1,0;3,0;2,0;11,0;;;1,0;5,0;21,0;4,0;3,0;4,0;41,0;;;11,0;4,0;11,0;1,0;;;1,0;;;17,0;65,0;;2,0;14,0;2,0;;;;15,0;1,0;40,0;3,0;;3,0;6,0;3,0;7,0;;2,0;3,0;10,0;;1,0;;2,0;1,0;21,0;;3,0;1,0;2,0;;3,0;5,0;1,0;2,0;;9,0;1,0
peripheral;6,0;;;;;4,0;9,0;9,0;41,0;38,0;8,0;;;;8,0;26,0;;;8,0;;;5,0;1,0;3,0;;;11,0;;;;2,0;;11,0;;5,0;15,0;6,0;;;;21,0;;11,0;;6,0;;;21,0;14,0;4,0;21,0;9,0;;;;76,0;12,0;;;;68,0;4,0;;;4,0;2,0;;73,0;8,0;4,0;7,0;2,0;13,0;7,0;;;;;6,0;78,0;;34,0;;54,0;;1,0;2,0;;;;93,0;;;4,0;;1,0;;;2,0;;;;27,0;2,0;;;14,0;1,0;2,0;;4,0;;;6,0;;54,0;200,0;28,0;3,0;4,0;;2,0;;4,0;8,0;;;;1,0;4,0;2,0;4,0;;;;;7,0;;;;1,0;;;31,0;;47,0;1,0;91,0;26,0;;2,0;1,0;8,0;9,0;2,0;;8,0;;;5,0;;10,0;50,0;;;1,0;6,0;7,0;;;;;5,0;14,0;1,0;;8,0;56,0;;;6,0;29,0;6,0;;;77,0;2,0;16,0;;;;;;13,0;;19,0;;;;18,0;8,0;;4,0;15,0;;3,0;;;;40,0;15,0;1,0;;23,0;7,0;;6,0;;34,0;12,0;11,0;4,0;56,0;;;;6,0;;12,0;;26,0;5,0;4,0;17,0;;3,0;;32,0;2,0;125,0;;14,0;4,0;;;;5,0;;77,0;2,0;37,0;;2,0;;;;7,0;4,0;;1,0;;2,0;3,0;3,0;2,0;;22,0;3,0;;;2,0;;15,0;18,0;;;;2,0;5,0;124,0;1,0;;2,0;11,0;1,0;;;2,0;;13,0;;;;;173,0;;1,0;;14,0;2,0;;11,0;9,0;;;;;3,0;4,0;;;3,0;3,0;2,0;2,0;12,0;;11,0;2,0;14,0;;1,0;8,0;1,0;1,0;3,0;12,0;2,0;;4,0;;;5,0;;;3,0;1,0;3,0;19,0;37,0;5,0;1,0;;1,0;4,0;;1,0;;13,0;4,0;16,0;;;3,0;;3,0;;3,0;2,0;;;19,0;;6,0;11,0;;;3,0;2,0;2,0;;;;;;1,0;17,0;1,0;;6,0;3,0;1,0;4,0;15,0;;;18,0;4,0;;3,0;16,0;3,0;;6,0;25,0;7,0;8,0;2,0;2,0;;;;;2,0;;;;;;4,0;1,0;;;;1,0;;1,0;1,0;;;;;;;;;;1,0;;;;;13,0;;1,0;;;;;;;;1,0;;;1,0;4,0;;;;;;;;;;;;;;;;;;;;1,0;;1,0;;;1,0;;;;;;;;;1,0;;;9,0;;;;;1,0;;;;;3,0;;;2,0;;12,0;;;;;;;;2,0;;;;;;;;;;;;1,0;;;;6,0;1,0;1,0;;;;;;;;1,0;1,0;;;;;;;;3,0;1,0;;;;;;;;5,0;1,0;;;;;;;2,0;1,0;;3,0;;19,0;21,0;;1,0;1,0;;;;;;;;;;3,0;;;3,0;;;;;;;;;2,0;;;;6,0;1,0;1,0;;1,0;;;8,0;;;;2,0;2,0;;6,0;;;;;2,0;2,0;1,0;;;;;;;;;;;;121,0;;;;;;;;;;;3,0;;;;;;;;1,0;;;;;;1,0;;;;2,0;;;;;;;;;3,0;;;;;;;;;;;;;;;;3,0;;;;;;;;;;;;;;;;;;;;;3,0;;;;;;1,0;;;;;;12,0;;;;;;;;;;;;11,0;1,0;4,0;;2,0;;;;;;;;1,0;;;;21,0;;;1,0;;;;2,0;;;;;6,0;;;;;1,0;;1,0;;;;;;;2,0;;;9,0;24,0;;;;;;;;;;;;;;;;;;;1,0;;49,0;;;;7,0;;;;1,0;;;;;;;2,0;2,0;1,0;;;;;;;;;;;;;;;;;;;1,0;;;;;;;;;;;;;;;;;;;;;;;;;;;;;;;;;;1,0;;;;;;;;;;;;;;;;;;;;;;;;;;;;;;;;;;3,0;;;1,0;2,0;;;;;;;;;3,0;;;;;;;;;;;;;;;;;;;;;;;;;;;;;;;;;;;;2,0;;;1,0;;;3,0;;6,0;;4,0;;;;;;2,0;;;;;;;;;;;;;;;;;1,0;;;;;;;;;3,0;;;;;;;;;;;;
pick;6,0;;;;;;;13,0;21,0;;5,0;;1,0;;;15,0;;;6,0;;1,0;1,0;3,0;;;;11,0;;;;;1,0;25,0;2,0;7,0;2,0;1,0;17,0;;;21,0;;;;15,0;6,0;6,0;100,0;;22,0;;1,0;1,0;;;1,0;43,0;1,0;;;;;17,0;1,0;14,0;;;13,0;3,0;;2,0;3,0;6,0;;;;;;1,0;362,0;6,0;15,0;1,0;13,0;;;1,0;;;3,0;22,0;;;;1,0;;;;9,0;1,0;;;32,0;48,0;;5,0;4,0;;10,0;;;1,0;6,0;;;18,0;13,0;38,0;;2,0;;;6,0;8,0;4,0;;;;;4,0;;6,0;;;;;;;;;;;1,0;18,0;2,0;;;2,0;27,0;;;;4,0;9,0;30,0;2,0;3,0;;;;;2,0;50,0;;;;3,0;3,0;;;5,0;;2,0;;1,0;;;;;;;6,0;5,0;;;5,0;;6,0;;;;;;9,0;;;;;;1,0;2,0;3,0;;1,0;;;;;1,0;5,0;;;;;;2,0;;;;;;;;;;;;;11,0;;1,0;;;11,0;;5,0;3,0;;;1,0;;;;;;;;;20,0;1,0;;;;;;;7,0;;;;;2,0;;5,0;1,0;1,0;;;;;;5,0;;;;;;3,0;14,0;2,0;5,0;3,0;5,0;;;1,0;;;;4,0;2,0;;;;;1,0;;;3,0;;;;5,0;;;;;;;;;;;;;;;4,0;;;;;;;4,0;;;;;;;;;;;3,0;;1,0;;;;;;6,0;;;;;;;1,0;;;38,0;;;;3,0;;;;;;;;;;;;;;1,0;;;;;;;1,0;;;;;;;4,0;;;;1,0;3,0;;5,0;;;;;;;;;;;3,0;;;;;;;6,0;;1,0;;;;;;12,0;;;;;;;;;;;;;2,0;;;15,0;;;2,0;4,0;;23,0;;;;;3,0;6,0;;;;;;;;;3,0;;;;;;;69,0;;;;;;;22,0;;;1,0;4,0;6,0;;;;;;;1,0;;1,0;2,0;;;;;;;;;;;;;;2,0;8,0;;6,0;;7,0;;;;;;4,0;;24,0;;;;;;;;;;;;1,0;;;2,0;;;9,0;;;;1,0;;;7,0;;;;;;;;;3,0;;;;1,0;1,0;;;;;2,0;;;;1,0;;2,0;;;;;;2,0;;;2,0;;;;;;;;;;2,0;;;;3,0;;;;;;;;;;2,0;;;;;;4,0;;;2,0;;;;;;;;;;2,0;2,0;;;;;;;;2,0;;5,0;;10,0;;;;2,0;;;;;;;;;2,0;;;2,0;;;;;;;;;;3,0;;;;1,0;;;;;;;2,0;;;;8,0;;;;;;;;;;;;;;1,0;9,0;;;;;;;;;;;;;;;;;;;;;;1,0;;;1,0;;;;1,0;;;;;;;;;;;;;;;;;;;;;;;3,0;;;;;;;;2,0;;;;;;;;;;;1,0;;;;;;;;;;;;4,0;;;;;;3,0;4,0;;;;;;;1,0;;;;;;;;;;;4,0;;;;;;;;8,0;;;;;;;;;;1,0;;;2,0;;;;;;;;;;;;;;;;;;;;;;;6,0;;;;;;;;;;;;;;;;;;;;;;;;;;;;;;;;;;;;;4,0;;;;;;;;;;;;;;;;;;;;;;;;1,0;;;;;;;;;;;;;;;;;;;;;24,0;;;;2,0;;;;;3,0;;;;;;;1,0;;;;;;;;;;;;2,0;;;;;;;;;;;;;;;;;;;;;;;;;;;;;;1,0;;;;;;;;;9,0;;;;;;1,0;;;;;;;;;;
plural;1,0;1,0;1,0;;;1,0;7,0;4,0;4,0;48,0;14,0;;;;;12,0;;;2,0;;3,0;5,0;1,0;;;;12,0;4,0;;;;5,0;33,0;;19,0;2,0;;2,0;;;32,0;;3,0;;3,0;2,0;6,0;54,0;5,0;7,0;1,0;1,0;;49,0;7,0;1,0;25,0;;;;;1,0;3,0;1,0;;6,0;;26,0;17,0;;3,0;;5,0;;;11,0;;;;80,0;;27,0;;101,0;;3,0;1,0;2,0;;;40,0;;1,0;;;;12,0;;13,0;;;;6,0;20,0;;7,0;10,0;;15,0;;;13,0;;;;12,0;11,0;14,0;;5,0;;;1,0;10,0;1,0;;;;;;1,0;45,0;6,0;;4,0;1,0;18,0;;3,0;1,0;;;1,0;2,0;1,0;;;4,0;75,0;;;;1,0;46,0;2,0;6,0;32,0;;;20,0;;;130,0;3,0;;;7,0;;4,0;;11,0;;;2,0;29,0;;;;;;;;;;2,0;23,0;2,0;;2,0;;;;;17,0;2,0;1,0;;;;2,0;;;;13,0;7,0;;2,0;;17,0;;5,0;;;;;;;;;;;;2,0;;;;7,0;;9,0;;8,0;2,0;;9,0;;;;1,0;;1,0;6,0;2,0;;;1,0;;32,0;;201,0;;1,0;;;;;;21,0;;;2,0;;;;21,0;6,0;16,0;;;;;;5,0;;;;;2,0;;3,0;5,0;5,0;2,0;1,0;;;38,0;;;1,0;;;;;2,0;;;;;;;4,0;1,0;;;;;;7,0;1,0;;;;3,0;2,0;;;;1,0;;1,0;;;;;4,0;;;;;;2,0;;;1,0;;;;;1,0;;;;;;;;5,0;;9,0;8,0;;;;2,0;;;1,0;10,0;;;;1,0;;1,0;2,0;;7,0;;;;1,0;;;;;;1,0;;1,0;;;1,0;4,0;;;1,0;;;;;;2,0;;1,0;1,0;4,0;;1,0;;;;;;;;;;;3,0;5,0;2,0;4,0;6,0;;1,0;;;;3,0;1,0;;;1,0;;;;;21,0;;1,0;;14,0;4,0;;;;;;3,0;;1,0;1,0;;;2,0;;;;3,0;8,0;;;;;1,0;;;;;;;;;;;;;;;;;;;;1,0;;6,0;;20,0;;;;;;;15,0;;1,0;;;;;;;;;;;;;10,0;;;;11,0;;;;21,0;2,0;;2,0;;;;;;;;;;;;1,0;;;;;1,0;;;4,0;;8,0;;;;14,0;;;;;;;;4,0;;;;;;;;;5,0;2,0;;;;2,0;;7,0;17,0;1,0;1,0;;;;;;6,0;;;;;;;;;;;;1,0;;1,0;;;;;;2,0;;;;;;;;6,0;;;;;;;;;1,0;;;;;23,0;;;;;;;;6,0;;;1,0;;;5,0;1,0;;;3,0;;;;;;5,0;;;;;2,0;;;;;;;1,0;;3,0;;;;;1,0;;1,0;;;;7,0;;;23,0;;;;;;;;;;;;;;;;;;3,0;;;;;;32,0;;;;;;;;;3,0;;;;;;2,0;;;2,0;1,0;;;;;;1,0;;;;;;;27,0;;;;;;2,0;9,0;;;;2,0;;;;;;3,0;;;;;;;;;;;;;;;;;;;;;;2,0;;;2,0;6,0;9,0;;;40,0;;;8,0;;;;8,0;;;;5,0;;1,0;;;;;;;;1,0;6,0;1,0;;2,0;;;;;;;;2,0;;;;1,0;;;;;;;1,0;;;;;;;;;;;;2,0;3,0;;;;;;;;;;;;;;2,0;;;;;;;;;;;6,0;1,0;;;;2,0;;;1,0;;;;;;;;2,0;;;;;;;;;;;;;;;;;;;;;;;;;;;;;;;;;;;;;;;1,0;;;2,0;;;;;;;;;8,0;;;2,0;;;;;;;;44,0;;;;;;;;;;;;;;;;;;;;;;;;;;;;;;;;;;;;;7,0;3,0;5,0;;;;;;;;;;;;;;1,0;;;4,0;;;;;;;1,0;;;;;;;;8,0;
plurality;2,0;31,0;;9,0;36,0;113,0;100,0;282,0;437,0;514,0;453,0;2,0;215,0;20,0;83,0;536,0;72,0;31,0;43,0;19,0;199,0;578,0;35,0;107,0;9,0;20,0;467,0;49,0;1,0;3,0;95,0;64,0;545,0;57,0;413,0;55,0;6,0;47,0;74,0;5,0;821,0;;214,0;83,0;333,0;136,0;431,0;1048,0;285,0;426,0;282,0;94,0;;146,0;111,0;199,0;664,0;10,0;64,0;7,0;176,0;36,0;164,0;61,0;434,0;148,0;223,0;541,0;681,0;58,0;98,0;13,0;407,0;9,0;5,0;350,0;200,0;39,0;114,0;4147,0;116,0;472,0;16,0;1898,0;2,0;98,0;37,0;;6,0;79,0;1420,0;13,0;15,0;43,0;70,0;49,0;78,0;5,0;611,0;23,0;41,0;20,0;353,0;467,0;19,0;39,0;276,0;82,0;332,0;176,0;39,0;272,0;54,0;18,0;12,0;;706,0;655,0;66,0;183,0;5,0;30,0;76,0;263,0;194,0;70,0;4,0;15,0;30,0;84,0;1,0;238,0;119,0;3,0;84,0;48,0;316,0;65,0;70,0;11,0;190,0;2,0;9,0;811,0;128,0;3,0;6,0;191,0;646,0;106,0;68,0;49,0;132,0;217,0;107,0;51,0;640,0;;43,0;305,0;35,0;90,0;1118,0;19,0;14,0;;400,0;202,0;7,0;39,0;119,0;3,0;13,0;165,0;55,0;37,0;174,0;115,0;12,0;27,0;86,0;140,0;17,0;26,0;59,0;444,0;3,0;242,0;102,0;1,0;41,0;7,0;13,0;313,0;10,0;102,0;29,0;1,0;7,0;69,0;23,0;3,0;105,0;237,0;6,0;29,0;49,0;22,0;148,0;99,0;57,0;36,0;7,0;35,0;24,0;14,0;70,0;18,0;8,0;241,0;163,0;23,0;50,0;10,0;1,0;5,0;132,0;;625,0;6,0;392,0;20,0;23,0;226,0;15,0;55,0;85,0;89,0;24,0;48,0;80,0;19,0;12,0;41,0;50,0;59,0;272,0;31,0;2526,0;173,0;99,0;39,0;21,0;3,0;7,0;28,0;431,0;20,0;32,0;3,0;7,0;2,0;23,0;569,0;77,0;5,0;54,0;33,0;25,0;;16,0;236,0;156,0;48,0;13,0;40,0;9,0;90,0;205,0;530,0;120,0;18,0;155,0;11,0;;218,0;33,0;27,0;23,0;36,0;120,0;44,0;24,0;43,0;63,0;;43,0;;109,0;4,0;27,0;27,0;110,0;4,0;54,0;52,0;12,0;132,0;72,0;7,0;17,0;60,0;103,0;5,0;29,0;117,0;33,0;121,0;19,0;126,0;36,0;11,0;13,0;10,0;56,0;2,0;70,0;23,0;2,0;7,0;3,0;14,0;17,0;15,0;;85,0;39,0;48,0;81,0;41,0;8,0;4,0;49,0;82,0;10,0;10,0;22,0;15,0;64,0;188,0;23,0;11,0;18,0;95,0;40,0;8,0;15,0;350,0;14,0;124,0;1,0;75,0;22,0;35,0;139,0;6,0;2,0;54,0;56,0;11,0;17,0;4,0;3,0;11,0;8,0;6,0;40,0;10,0;33,0;30,0;15,0;1,0;82,0;21,0;30,0;21,0;36,0;1,0;6,0;139,0;31,0;231,0;23,0;40,0;37,0;28,0;65,0;15,0;82,0;28,0;12,0;1,0;59,0;39,0;3,0;1,0;8,0;3,0;17,0;167,0;67,0;91,0;68,0;15,0;55,0;4,0;13,0;14,0;15,0;16,0;6,0;24,0;132,0;50,0;10,0;10,0;13,0;177,0;30,0;8,0;2,0;174,0;70,0;40,0;211,0;7,0;58,0;22,0;256,0;4,0;56,0;134,0;87,0;1,0;115,0;140,0;188,0;15,0;45,0;64,0;73,0;9,0;3,0;95,0;26,0;55,0;12,0;51,0;1,0;10,0;119,0;26,0;1,0;30,0;3,0;8,0;5,0;13,0;48,0;170,0;12,0;2,0;10,0;29,0;194,0;8,0;66,0;3,0;88,0;3,0;114,0;103,0;13,0;61,0;120,0;58,0;45,0;9,0;19,0;56,0;;40,0;35,0;58,0;23,0;3,0;1,0;14,0;94,0;29,0;31,0;11,0;3,0;164,0;62,0;;78,0;1,0;167,0;22,0;20,0;99,0;7,0;7,0;68,0;;6,0;7,0;3,0;10,0;29,0;16,0;16,0;110,0;16,0;20,0;36,0;6,0;13,0;10,0;23,0;20,0;18,0;73,0;6,0;22,0;56,0;161,0;1,0;34,0;23,0;66,0;2,0;32,0;14,0;68,0;43,0;38,0;13,0;80,0;9,0;11,0;6,0;26,0;9,0;67,0;1,0;4,0;27,0;;29,0;15,0;106,0;156,0;36,0;33,0;11,0;40,0;13,0;13,0;58,0;21,0;24,0;;23,0;21,0;13,0;5,0;7,0;14,0;39,0;5,0;11,0;13,0;87,0;29,0;;10,0;16,0;9,0;20,0;7,0;6,0;1,0;4,0;5,0;5,0;56,0;8,0;23,0;73,0;7,0;59,0;8,0;;35,0;21,0;86,0;46,0;27,0;3,0;34,0;103,0;2,0;4,0;9,0;;8,0;1,0;6,0;37,0;9,0;19,0;22,0;22,0;;566,0;51,0;16,0;9,0;43,0;11,0;1,0;244,0;22,0;1,0;57,0;35,0;7,0;3,0;30,0;6,0;41,0;16,0;9,0;5,0;9,0;32,0;48,0;2,0;6,0;22,0;12,0;19,0;10,0;11,0;25,0;7,0;4,0;15,0;11,0;50,0;17,0;15,0;234,0;29,0;6,0;21,0;9,0;6,0;18,0;18,0;21,0;11,0;13,0;1,0;;16,0;13,0;43,0;2,0;5,0;77,0;2,0;;41,0;7,0;130,0;57,0;16,0;;83,0;;2,0;2,0;18,0;43,0;31,0;49,0;10,0;1,0;3,0;43,0;4,0;8,0;4,0;13,0;98,0;4,0;14,0;2,0;;3,0;34,0;;6,0;12,0;15,0;57,0;1,0;14,0;33,0;16,0;1,0;107,0;62,0;91,0;52,0;4,0;50,0;25,0;22,0;7,0;15,0;130,0;10,0;6,0;7,0;7,0;9,0;7,0;16,0;7,0;12,0;3,0;8,0;3,0;6,0;5,0;15,0;11,0;;4,0;13,0;41,0;35,0;20,0;3,0;112,0;24,0;5,0;41,0;4,0;19,0;50,0;4,0;83,0;170,0;5,0;18,0;52,0;206,0;45,0;74,0;49,0;17,0;6,0;17,0;118,0;47,0;143,0;42,0;44,0;30,0;1,0;11,0;15,0;26,0;16,0;63,0;42,0;31,0;222,0;15,0;36,0;4,0;1,0;18,0;18,0;3,0;71,0;13,0;12,0;13,0;2,0;25,0;7,0;8,0;43,0;17,0;27,0;8,0;;27,0;;5,0;101,0;2,0;4,0;7,0;18,0;17,0;21,0;28,0;217,0;4,0;49,0;6,0;2,0;2,0;37,0;132,0;4,0;20,0;44,0;35,0;7,0;3,0;;19,0;;13,0;20,0;7,0;23,0;;2,0;4,0;;100,0;5,0;;60,0;1,0;3,0;2,0;2,0;5,0;58,0;11,0;;16,0;17,0;5,0;2,0;54,0;43,0;2,0;13,0;27,0;4,0;9,0;8,0;2,0;16,0;22,0;26,0;4,0;4,0;1,0;5,0;19,0;15,0;6,0;13,0;8,0;;18,0;;2,0;6,0;82,0;14,0;3,0;29,0;2,0;11,0;2,0;15,0;18,0;21,0;14,0;5,0;6,0;46,0;;28,0;25,0;13,0;20,0;8,0;;5,0;12,0;14,0;19,0;21,0;14,0;9,0;11,0;12,0;5,0;19,0;52,0;;14,0;;167,0;33,0;;20,0;1,0;15,0;5,0;16,0;2,0;2,0;24,0;20,0;5,0;10,0;3,0;7,0;20,0;10,0;16,0;16,0;;20,0;10,0;;38,0;10,0;14,0;5,0;;6,0;;;71,0;3,0;3,0;4,0;95,0;42,0;5,0;14,0;1,0;;10,0;1,0;11,0;11,0;;;19,0;15,0;17,0;16,0;5,0;6,0;79,0;;6,0;4,0;14,0;11,0;12,0;3,0;10,0;17,0;;6,0;2,0;1,0;6,0;7,0;4,0;84,0;
portion;6,0;60,0;10,0;2,0;37,0;98,0;149,0;194,0;273,0;224,0;79,0;;93,0;2,0;342,0;825,0;61,0;39,0;10,0;4,0;50,0;376,0;32,0;106,0;13,0;6,0;229,0;10,0;2,0;13,0;17,0;14,0;419,0;9,0;543,0;35,0;32,0;53,0;42,0;1,0;402,0;17,0;252,0;73,0;265,0;124,0;249,0;530,0;231,0;825,0;489,0;200,0;8,0;29,0;321,0;258,0;350,0;9,0;30,0;;571,0;61,0;160,0;1,0;93,0;21,0;177,0;897,0;292,0;334,0;33,0;56,0;185,0;19,0;3,0;56,0;82,0;49,0;58,0;2718,0;26,0;233,0;8,0;1111,0;22,0;43,0;19,0;16,0;31,0;110,0;1710,0;2,0;10,0;87,0;23,0;59,0;55,0;;410,0;24,0;7,0;9,0;452,0;410,0;1,0;43,0;617,0;24,0;146,0;19,0;84,0;118,0;200,0;13,0;11,0;706,0;;787,0;73,0;166,0;35,0;11,0;29,0;131,0;40,0;18,0;;22,0;68,0;47,0;;74,0;183,0;38,0;48,0;6,0;187,0;36,0;29,0;3,0;259,0;11,0;28,0;411,0;53,0;2,0;6,0;758,0;285,0;108,0;28,0;10,0;80,0;135,0;97,0;50,0;407,0;;62,0;83,0;19,0;128,0;548,0;9,0;8,0;5,0;98,0;286,0;22,0;26,0;111,0;47,0;73,0;152,0;59,0;75,0;309,0;242,0;25,0;5,0;127,0;635,0;33,0;56,0;56,0;209,0;18,0;102,0;26,0;2,0;19,0;16,0;210,0;717,0;14,0;476,0;33,0;3,0;46,0;342,0;235,0;5,0;66,0;430,0;2,0;165,0;46,0;1,0;83,0;400,0;85,0;116,0;133,0;50,0;23,0;20,0;139,0;19,0;33,0;244,0;794,0;52,0;329,0;15,0;1,0;64,0;246,0;24,0;716,0;12,0;775,0;33,0;109,0;642,0;258,0;161,0;122,0;445,0;127,0;417,0;133,0;63,0;67,0;126,0;2,0;37,0;141,0;4,0;419,0;111,0;357,0;5,0;36,0;28,0;63,0;35,0;785,0;85,0;17,0;12,0;31,0;20,0;131,0;190,0;69,0;37,0;298,0;153,0;44,0;10,0;183,0;86,0;133,0;68,0;33,0;209,0;32,0;193,0;310,0;1065,0;22,0;;262,0;182,0;104,0;106,0;;64,0;23,0;98,0;132,0;67,0;12,0;11,0;274,0;16,0;2,0;73,0;138,0;54,0;109,0;71,0;279,0;9,0;36,0;20,0;38,0;85,0;304,0;42,0;4,0;196,0;32,0;46,0;119,0;102,0;9,0;240,0;49,0;309,0;23,0;31,0;107,0;210,0;456,0;5,0;362,0;190,0;17,0;20,0;115,0;66,0;134,0;4,0;5,0;5,0;129,0;256,0;128,0;143,0;74,0;47,0;98,0;29,0;25,0;26,0;121,0;39,0;124,0;91,0;61,0;55,0;2,0;54,0;57,0;46,0;18,0;83,0;57,0;38,0;4,0;97,0;16,0;281,0;126,0;82,0;24,0;207,0;200,0;11,0;10,0;20,0;18,0;9,0;27,0;36,0;161,0;54,0;213,0;71,0;26,0;40,0;19,0;124,0;10,0;55,0;58,0;36,0;38,0;584,0;185,0;120,0;30,0;20,0;148,0;7,0;34,0;76,0;58,0;6,0;1,0;3,0;16,0;55,0;;3,0;;8,0;14,0;107,0;78,0;8,0;39,0;14,0;26,0;1,0;14,0;15,0;6,0;5,0;1,0;15,0;54,0;3,0;8,0;8,0;18,0;105,0;7,0;3,0;;154,0;23,0;39,0;73,0;1,0;39,0;25,0;113,0;10,0;64,0;43,0;125,0;;29,0;84,0;108,0;1,0;46,0;21,0;40,0;7,0;3,0;1,0;10,0;26,0;7,0;25,0;23,0;18,0;24,0;1,0;4,0;3,0;16,0;22,0;;3,0;12,0;37,0;7,0;5,0;9,0;10,0;173,0;7,0;3,0;1,0;70,0;33,0;98,0;110,0;11,0;138,0;42,0;2,0;40,0;5,0;8,0;30,0;2,0;29,0;5,0;2,0;5,0;15,0;4,0;7,0;66,0;10,0;117,0;;3,0;48,0;14,0;1,0;37,0;1,0;104,0;2,0;10,0;63,0;1,0;6,0;32,0;;17,0;4,0;59,0;25,0;29,0;9,0;44,0;11,0;33,0;;24,0;50,0;41,0;14,0;2,0;8,0;15,0;83,0;3,0;28,0;21,0;39,0;3,0;22,0;42,0;109,0;1,0;5,0;89,0;56,0;35,0;3,0;10,0;16,0;1,0;176,0;2,0;55,0;2,0;15,0;5,0;18,0;73,0;38,0;4,0;43,0;16,0;18,0;82,0;18,0;16,0;15,0;5,0;19,0;48,0;6,0;51,0;24,0;17,0;26,0;21,0;30,0;;;9,0;33,0;11,0;1,0;99,0;4,0;;20,0;97,0;;15,0;2,0;;62,0;19,0;8,0;;16,0;109,0;21,0;215,0;;11,0;2,0;7,0;16,0;6,0;15,0;4,0;;9,0;18,0;32,0;51,0;1,0;;7,0;17,0;1,0;3,0;23,0;22,0;16,0;17,0;17,0;6,0;324,0;35,0;24,0;3,0;31,0;2,0;;313,0;4,0;4,0;26,0;78,0;;1,0;7,0;2,0;17,0;;3,0;7,0;1,0;72,0;16,0;6,0;7,0;13,0;1,0;42,0;27,0;46,0;10,0;6,0;28,0;17,0;69,0;4,0;;17,0;158,0;66,0;10,0;18,0;24,0;82,0;11,0;61,0;2,0;;15,0;10,0;4,0;29,0;110,0;5,0;49,0;15,0;48,0;62,0;37,0;68,0;5,0;51,0;24,0;24,0;24,0;7,0;19,0;;;13,0;21,0;13,0;71,0;8,0;9,0;12,0;13,0;16,0;45,0;20,0;6,0;7,0;35,0;83,0;18,0;1,0;55,0;344,0;;9,0;4,0;8,0;150,0;25,0;2,0;32,0;7,0;16,0;10,0;182,0;78,0;5,0;31,0;68,0;33,0;3,0;16,0;22,0;51,0;;57,0;82,0;37,0;22,0;8,0;164,0;5,0;31,0;122,0;44,0;4,0;12,0;32,0;3,0;5,0;1,0;;41,0;22,0;28,0;18,0;2,0;11,0;15,0;1,0;1,0;45,0;9,0;8,0;2,0;8,0;16,0;5,0;2,0;75,0;129,0;22,0;90,0;69,0;16,0;;15,0;15,0;7,0;15,0;12,0;1,0;35,0;7,0;;33,0;11,0;5,0;80,0;4,0;14,0;43,0;14,0;6,0;6,0;6,0;1,0;37,0;42,0;12,0;11,0;30,0;21,0;7,0;9,0;16,0;40,0;44,0;3,0;39,0;1,0;;2,0;4,0;;43,0;4,0;17,0;;28,0;3,0;3,0;;1,0;9,0;5,0;;26,0;;;22,0;10,0;6,0;12,0;34,0;13,0;15,0;25,0;1,0;10,0;6,0;2,0;7,0;7,0;;1,0;;;11,0;;3,0;20,0;;2,0;;2,0;32,0;16,0;4,0;4,0;18,0;7,0;;;13,0;2,0;4,0;1,0;13,0;3,0;6,0;16,0;2,0;1,0;16,0;;13,0;;22,0;48,0;49,0;10,0;1,0;17,0;;;8,0;2,0;6,0;1,0;84,0;2,0;4,0;;5,0;11,0;1,0;4,0;1,0;25,0;;20,0;2,0;48,0;;20,0;13,0;;42,0;3,0;;24,0;34,0;27,0;3,0;30,0;1,0;7,0;3,0;;13,0;81,0;36,0;20,0;18,0;;19,0;5,0;;2,0;1,0;3,0;;10,0;;;15,0;;13,0;1,0;12,0;3,0;2,0;;9,0;2,0;1,0;6,0;29,0;2,0;16,0;4,0;48,0;17,0;25,0;19,0;1,0;;8,0;2,0;;51,0;14,0;11,0;7,0;1,0;;5,0;11,0;;4,0;1,0;11,0;;12,0;;14,0;10,0;;2,0;1,0;6,0;36,0;13,0;1,0;8,0;6,0;2,0;;3,0;2,0;1,0;10,0;;;;;;
position;7,0;32,0;24,0;18,0;10,0;267,0;88,0;339,0;254,0;191,0;143,0;1,0;146,0;23,0;383,0;947,0;40,0;26,0;23,0;11,0;204,0;368,0;72,0;14,0;13,0;28,0;88,0;23,0;1,0;25,0;44,0;34,0;425,0;25,0;514,0;212,0;106,0;155,0;30,0;6,0;549,0;27,0;225,0;92,0;1057,0;470,0;1032,0;959,0;166,0;592,0;189,0;434,0;11,0;12,0;346,0;100,0;531,0;5,0;278,0;5,0;135,0;38,0;196,0;10,0;157,0;221,0;1011,0;200,0;346,0;139,0;111,0;53,0;159,0;8,0;16,0;155,0;125,0;17,0;20,0;2597,0;56,0;376,0;16,0;506,0;16,0;68,0;62,0;18,0;13,0;91,0;2791,0;1,0;14,0;18,0;73,0;21,0;40,0;;650,0;132,0;82,0;6,0;401,0;864,0;25,0;61,0;636,0;40,0;217,0;70,0;80,0;153,0;28,0;38,0;14,0;655,0;787,0;;31,0;606,0;16,0;20,0;52,0;109,0;125,0;34,0;13,0;6,0;17,0;201,0;31,0;499,0;522,0;8,0;94,0;18,0;153,0;83,0;27,0;11,0;91,0;4,0;18,0;717,0;106,0;29,0;3,0;487,0;488,0;101,0;91,0;2,0;82,0;204,0;223,0;8,0;783,0;69,0;120,0;19,0;27,0;135,0;1661,0;10,0;23,0;;208,0;418,0;37,0;9,0;369,0;11,0;16,0;156,0;93,0;24,0;226,0;136,0;12,0;4,0;142,0;283,0;13,0;33,0;43,0;93,0;1,0;85,0;9,0;3,0;1,0;2,0;7,0;136,0;12,0;266,0;2,0;5,0;2,0;218,0;35,0;34,0;83,0;450,0;54,0;42,0;17,0;12,0;29,0;252,0;13,0;36,0;40,0;4,0;22,0;10,0;53,0;8,0;105,0;225,0;329,0;29,0;81,0;9,0;5,0;29,0;68,0;17,0;504,0;6,0;714,0;4,0;314,0;447,0;292,0;483,0;237,0;452,0;111,0;84,0;34,0;91,0;27,0;152,0;55,0;9,0;13,0;63,0;394,0;215,0;308,0;2,0;90,0;23,0;16,0;2,0;367,0;27,0;29,0;8,0;30,0;2,0;77,0;183,0;32,0;6,0;77,0;35,0;143,0;2,0;141,0;184,0;186,0;8,0;1,0;66,0;86,0;109,0;128,0;574,0;34,0;7,0;24,0;2,0;1,0;227,0;13,0;55,0;5,0;13,0;372,0;99,0;149,0;8,0;83,0;2,0;16,0;;34,0;22,0;161,0;52,0;124,0;17,0;48,0;25,0;63,0;79,0;74,0;37,0;1,0;82,0;7,0;33,0;479,0;30,0;9,0;88,0;13,0;115,0;35,0;4,0;8,0;67,0;156,0;4,0;72,0;19,0;35,0;18,0;28,0;23,0;19,0;18,0;32,0;34,0;43,0;114,0;86,0;95,0;8,0;15,0;52,0;39,0;148,0;27,0;136,0;187,0;61,0;68,0;21,0;57,0;10,0;92,0;12,0;97,0;130,0;454,0;53,0;20,0;1,0;87,0;35,0;48,0;68,0;25,0;5,0;79,0;65,0;30,0;77,0;62,0;11,0;25,0;20,0;10,0;52,0;62,0;152,0;135,0;66,0;20,0;18,0;83,0;18,0;140,0;7,0;9,0;16,0;262,0;23,0;697,0;95,0;19,0;17,0;118,0;29,0;19,0;62,0;7,0;6,0;15,0;15,0;86,0;2,0;23,0;12,0;64,0;74,0;391,0;336,0;44,0;49,0;16,0;98,0;15,0;2,0;5,0;8,0;11,0;5,0;67,0;329,0;131,0;2,0;7,0;12,0;165,0;;30,0;27,0;155,0;36,0;41,0;178,0;2,0;35,0;119,0;96,0;;83,0;153,0;370,0;15,0;17,0;113,0;150,0;20,0;324,0;23,0;127,0;4,0;17,0;128,0;45,0;77,0;24,0;15,0;7,0;26,0;105,0;5,0;7,0;40,0;9,0;6,0;7,0;11,0;50,0;230,0;29,0;29,0;15,0;41,0;279,0;8,0;135,0;37,0;7,0;9,0;308,0;44,0;8,0;245,0;227,0;5,0;16,0;26,0;18,0;81,0;4,0;55,0;42,0;22,0;7,0;20,0;16,0;52,0;64,0;30,0;222,0;;3,0;244,0;55,0;31,0;35,0;2,0;25,0;12,0;16,0;161,0;32,0;2,0;7,0;6,0;14,0;21,0;54,0;;32,0;18,0;5,0;108,0;2,0;24,0;7,0;5,0;9,0;5,0;1,0;18,0;22,0;18,0;11,0;16,0;256,0;21,0;;29,0;;85,0;6,0;16,0;3,0;17,0;21,0;39,0;200,0;8,0;;32,0;28,0;18,0;11,0;48,0;3,0;14,0;74,0;39,0;;8,0;14,0;34,0;26,0;28,0;19,0;67,0;29,0;121,0;19,0;17,0;30,0;74,0;3,0;24,0;8,0;38,0;4,0;4,0;6,0;13,0;;6,0;15,0;38,0;35,0;;15,0;6,0;18,0;16,0;1,0;38,0;33,0;5,0;;20,0;51,0;4,0;187,0;2,0;2,0;8,0;;68,0;15,0;45,0;;1,0;22,0;28,0;50,0;2,0;16,0;1,0;24,0;15,0;;3,0;2,0;9,0;28,0;30,0;11,0;3,0;246,0;21,0;1,0;13,0;16,0;11,0;4,0;20,0;23,0;2,0;1,0;18,0;5,0;2,0;7,0;11,0;37,0;5,0;2,0;32,0;15,0;20,0;266,0;18,0;;23,0;;25,0;43,0;47,0;25,0;13,0;22,0;31,0;21,0;4,0;5,0;13,0;35,0;20,0;12,0;41,0;1,0;76,0;45,0;5,0;4,0;4,0;1,0;8,0;12,0;20,0;24,0;46,0;15,0;33,0;187,0;48,0;9,0;82,0;20,0;37,0;30,0;11,0;5,0;98,0;17,0;;1,0;33,0;27,0;6,0;21,0;8,0;7,0;4,0;59,0;13,0;15,0;22,0;47,0;35,0;134,0;20,0;21,0;;4,0;91,0;;8,0;14,0;3,0;79,0;9,0;1,0;17,0;13,0;2,0;40,0;99,0;31,0;6,0;5,0;16,0;;1,0;5,0;6,0;50,0;15,0;41,0;34,0;20,0;51,0;4,0;5,0;5,0;28,0;7,0;11,0;44,0;10,0;13,0;1,0;3,0;6,0;6,0;11,0;3,0;28,0;13,0;3,0;36,0;5,0;1,0;1,0;;8,0;11,0;35,0;16,0;35,0;1,0;;13,0;50,0;64,0;72,0;13,0;10,0;1,0;19,0;7,0;109,0;22,0;6,0;6,0;23,0;68,0;16,0;58,0;9,0;;36,0;9,0;16,0;2,0;32,0;55,0;2,0;5,0;7,0;53,0;33,0;15,0;25,0;22,0;50,0;2,0;28,0;51,0;6,0;8,0;16,0;43,0;15,0;;5,0;11,0;35,0;15,0;13,0;9,0;2,0;12,0;;13,0;5,0;2,0;4,0;48,0;1,0;6,0;12,0;16,0;9,0;12,0;8,0;9,0;5,0;24,0;30,0;4,0;8,0;4,0;5,0;4,0;18,0;7,0;1,0;111,0;9,0;10,0;4,0;;;;31,0;5,0;49,0;1,0;8,0;46,0;15,0;5,0;13,0;2,0;35,0;1,0;18,0;9,0;62,0;;51,0;3,0;3,0;8,0;38,0;21,0;10,0;4,0;20,0;;7,0;66,0;6,0;29,0;9,0;13,0;27,0;;45,0;;7,0;20,0;23,0;7,0;3,0;14,0;9,0;20,0;;14,0;30,0;10,0;1,0;54,0;5,0;23,0;2,0;17,0;40,0;1,0;4,0;11,0;28,0;10,0;1,0;20,0;2,0;50,0;3,0;24,0;63,0;24,0;4,0;65,0;16,0;7,0;1,0;7,0;;9,0;;13,0;8,0;;14,0;27,0;;;25,0;23,0;6,0;;66,0;28,0;;13,0;4,0;7,0;;5,0;33,0;7,0;38,0;16,0;17,0;40,0;18,0;11,0;;;7,0;12,0;4,0;9,0;4,0;22,0;3,0;12,0;;2,0;8,0;;3,0;4,0;15,0;25,0;9,0;5,0;12,0;13,0;17,0;20,0;42,0;;25,0;36,0;8,0;3,0;15,0;2,0;8,0;3,0;;1,0;17,0;14,0;;;1,0;15,0;1,0
power;5,0;55,0;3,0;4,0;2,0;;28,0;58,0;7,0;70,0;38,0;8,0;16,0;;24,0;44,0;4,0;5,0;;;;23,0;29,0;2,0;;;4,0;9,0;;4,0;19,0;99,0;170,0;;395,0;41,0;14,0;6,0;;;107,0;9,0;;1,0;35,0;11,0;23,0;313,0;70,0;59,0;26,0;13,0;5,0;;56,0;1,0;850,0;1,0;1,0;2,0;11,0;56,0;14,0;;7,0;30,0;28,0;37,0;20,0;15,0;11,0;9,0;150,0;;;345,0;3,0;4,0;76,0;239,0;4,0;67,0;16,0;357,0;12,0;46,0;35,0;;11,0;25,0;2146,0;;4,0;2,0;7,0;28,0;7,0;;106,0;12,0;;3,0;113,0;75,0;2,0;23,0;1864,0;54,0;92,0;;8,0;26,0;3,0;;;66,0;73,0;31,0;;53,0;2,0;3,0;7,0;26,0;22,0;;10,0;;;4,0;;14,0;6,0;6,0;5,0;2,0;16,0;100,0;;80,0;7,0;6,0;8,0;61,0;71,0;;;161,0;416,0;1,0;;1,0;40,0;11,0;3,0;908,0;469,0;1,0;1,0;23,0;2,0;100,0;2334,0;8,0;5,0;;73,0;20,0;;4,0;242,0;;1,0;4,0;38,0;57,0;28,0;1,0;;;18,0;111,0;1,0;5,0;31,0;117,0;;37,0;120,0;;2,0;1,0;5,0;170,0;4,0;48,0;;;1,0;2,0;;;1,0;29,0;;;97,0;13,0;43,0;26,0;;;6,0;101,0;2,0;;1,0;1,0;1,0;1,0;40,0;;2,0;;;1,0;5,0;;136,0;2,0;35,0;;4,0;32,0;2,0;68,0;5,0;10,0;4,0;5,0;1,0;9,0;;4,0;7,0;;4,0;;70,0;8,0;17,0;;;;3,0;31,0;117,0;2,0;;331,0;;;5,0;7,0;;;9,0;3,0;21,0;;;420,0;5,0;;;5,0;14,0;12,0;12,0;97,0;107,0;;149,0;3,0;6,0;72,0;21,0;;;;20,0;3,0;;;4,0;2,0;1,0;;48,0;;30,0;13,0;15,0;;1,0;;1,0;14,0;6,0;;14,0;14,0;7,0;;14,0;1,0;12,0;34,0;70,0;44,0;1,0;23,0;1,0;;21,0;34,0;1,0;1,0;;6,0;;;;;;13,0;31,0;;45,0;2,0;;;;16,0;86,0;9,0;;43,0;4,0;21,0;;;1,0;12,0;11,0;1,0;1,0;19,0;14,0;6,0;1,0;;2,0;3,0;;;;17,0;4,0;6,0;6,0;1,0;1,0;1,0;2,0;1,0;5,0;;6,0;1,0;;;6,0;7,0;2,0;6,0;;;;10,0;1,0;7,0;2,0;5,0;;27,0;2,0;11,0;;;;;;14,0;;;;;2,0;34,0;195,0;1,0;8,0;12,0;4,0;17,0;;;2,0;;;;27,0;8,0;13,0;1,0;;2,0;;10,0;;55,0;197,0;4,0;3,0;;;4,0;148,0;4,0;11,0;13,0;9,0;2,0;;51,0;65,0;;;12,0;;;;32,0;5,0;26,0;114,0;;1,0;;17,0;1,0;7,0;2,0;;;32,0;;8,0;2,0;;;;;26,0;2,0;;;147,0;;45,0;;;4,0;;;;2,0;1,0;2,0;2,0;;10,0;6,0;2,0;4,0;1,0;1,0;46,0;;21,0;4,0;10,0;5,0;3,0;;1,0;;3,0;3,0;;5,0;;2,0;1,0;1,0;;6,0;;;1,0;5,0;36,0;80,0;;;7,0;24,0;;21,0;6,0;;9,0;34,0;;;25,0;2,0;18,0;25,0;;;1,0;;2,0;4,0;8,0;14,0;;1,0;12,0;;13,0;2,0;;3,0;7,0;141,0;;1,0;1,0;23,0;15,0;;;6,0;27,0;68,0;3,0;4,0;15,0;2,0;4,0;;5,0;13,0;2,0;8,0;3,0;;;1,0;;63,0;64,0;;;10,0;2,0;2,0;1,0;;;1,0;;1,0;10,0;1,0;;7,0;33,0;17,0;;7,0;14,0;;;;;;5,0;;;12,0;33,0;;;;6,0;;;2,0;2,0;;4,0;13,0;1,0;;3,0;3,0;11,0;;;1,0;;;4,0;;3,0;3,0;35,0;4,0;18,0;1,0;;5,0;;1,0;;;1,0;63,0;;1,0;1,0;;4,0;;3,0;5,0;;;;20,0;8,0;3,0;2,0;2,0;;38,0;31,0;;21,0;2,0;;2,0;;;3,0;;;;4,0;;;5,0;;2,0;2,0;11,0;1,0;;3,0;3,0;;;1,0;39,0;2,0;7,0;;;6,0;;;;5,0;3,0;;;1,0;2,0;;;;7,0;1,0;;2,0;;17,0;1,0;7,0;8,0;2,0;53,0;10,0;33,0;;;;;2,0;;9,0;;15,0;3,0;;2,0;;;16,0;1,0;;;;;2,0;;;1,0;1,0;6,0;2,0;;;;1,0;;;13,0;;;1,0;1,0;;2,0;;;2,0;16,0;;1,0;1,0;1,0;;;;8,0;36,0;;;;1,0;1,0;;;;6,0;;;21,0;45,0;;1,0;;;;;8,0;;;;;;1,0;1,0;;3,0;11,0;8,0;14,0;3,0;;2,0;;3,0;;;;;17,0;;19,0;;;1,0;;;1,0;11,0;;;1,0;;;5,0;;;;1,0;1,0;2,0;;;1,0;2,0;1,0;4,0;;;;;;;6,0;;;;4,0;;;3,0;;;1,0;;;;;1,0;4,0;;;3,0;;3,0;;3,0;;;;21,0;8,0;;;;;;3,0;;11,0;7,0;6,0;;;;5,0;21,0;;;19,0;;;;;3,0;;;;;1,0;2,0;12,0;1,0;;;;;;;2,0;1,0;4,0;3,0;;2,0;;;2,0;2,0;;;;;;4,0;;;;11,0;3,0;;;3,0;;;;;;;;;3,0;;2,0;5,0;29,0;;3,0;;;;2,0;;;4,0;;;;;;;;;;;;;;;;2,0;3,0;4,0;;;;;1,0;;6,0;;;;;4,0;;50,0
predetermine;1,0;41,0;13,0;2,0;3,0;101,0;46,0;107,0;232,0;28,0;13,0;;35,0;4,0;39,0;229,0;;11,0;30,0;3,0;53,0;127,0;29,0;1,0;;21,0;98,0;9,0;;;19,0;81,0;129,0;13,0;227,0;67,0;9,0;28,0;4,0;2,0;283,0;13,0;37,0;23,0;179,0;66,0;208,0;151,0;68,0;176,0;9,0;286,0;2,0;13,0;118,0;5,0;67,0;3,0;43,0;;15,0;5,0;33,0;17,0;29,0;71,0;111,0;55,0;153,0;4,0;80,0;11,0;119,0;2,0;1,0;21,0;25,0;5,0;15,0;856,0;19,0;95,0;4,0;174,0;13,0;56,0;47,0;5,0;1,0;156,0;275,0;10,0;;1,0;22,0;10,0;47,0;10,0;276,0;9,0;26,0;1,0;78,0;238,0;2,0;14,0;77,0;27,0;102,0;91,0;23,0;117,0;4,0;2,0;5,0;183,0;166,0;606,0;53,0;;3,0;;46,0;183,0;25,0;25,0;14,0;44,0;5,0;194,0;13,0;130,0;63,0;;58,0;15,0;39,0;58,0;25,0;74,0;65,0;1,0;24,0;82,0;95,0;;;24,0;318,0;70,0;3,0;;44,0;84,0;74,0;73,0;159,0;1,0;27,0;46,0;16,0;44,0;349,0;25,0;5,0;1,0;114,0;44,0;6,0;48,0;50,0;1,0;;8,0;201,0;30,0;6,0;5,0;;5,0;9,0;82,0;;3,0;9,0;25,0;;32,0;;;15,0;14,0;1,0;26,0;3,0;13,0;;;4,0;8,0;3,0;;113,0;214,0;11,0;7,0;15,0;8,0;101,0;38,0;8,0;1,0;23,0;5,0;1,0;11,0;5,0;1,0;39,0;22,0;11,0;8,0;2,0;1,0;1,0;;3,0;;163,0;1,0;70,0;3,0;5,0;55,0;27,0;73,0;54,0;4,0;3,0;3,0;14,0;13,0;;52,0;23,0;;;11,0;269,0;25,0;16,0;2,0;;8,0;4,0;21,0;106,0;1,0;1,0;;;2,0;1,0;121,0;2,0;11,0;30,0;2,0;26,0;1,0;2,0;26,0;58,0;;3,0;7,0;59,0;20,0;10,0;49,0;20,0;1,0;24,0;4,0;;889,0;3,0;15,0;;6,0;70,0;11,0;20,0;;1,0;2,0;7,0;;3,0;;11,0;14,0;6,0;2,0;1,0;;10,0;30,0;2,0;3,0;;29,0;;19,0;16,0;6,0;;3,0;2,0;6,0;3,0;7,0;5,0;;42,0;;16,0;3,0;6,0;2,0;;;2,0;;;96,0;5,0;3,0;28,0;3,0;;6,0;15,0;27,0;14,0;;4,0;17,0;19,0;63,0;5,0;5,0;17,0;57,0;7,0;;2,0;116,0;4,0;;4,0;18,0;1,0;;7,0;;12,0;3,0;1,0;2,0;32,0;9,0;;2,0;2,0;;9,0;5,0;25,0;35,0;1,0;;20,0;3,0;13,0;34,0;;1,0;1,0;16,0;6,0;89,0;11,0;4,0;2,0;38,0;7,0;38,0;3,0;2,0;6,0;9,0;;3,0;;3,0;23,0;57,0;15,0;73,0;73,0;54,0;61,0;6,0;18,0;5,0;3,0;3,0;20,0;8,0;2,0;7,0;35,0;26,0;29,0;;94,0;52,0;3,0;2,0;;75,0;174,0;4,0;44,0;4,0;34,0;90,0;127,0;6,0;15,0;76,0;65,0;1,0;14,0;47,0;149,0;12,0;34,0;285,0;6,0;31,0;2,0;10,0;88,0;38,0;;3,0;9,0;20,0;12,0;;6,0;68,0;;;1,0;11,0;412,0;19,0;2,0;5,0;13,0;12,0;54,0;1,0;32,0;30,0;157,0;;53,0;5,0;12,0;18,0;16,0;6,0;5,0;;;16,0;7,0;8,0;18,0;11,0;32,0;17,0;;6,0;6,0;30,0;10,0;;;62,0;40,0;10,0;13,0;;42,0;2,0;7,0;22,0;;;5,0;12,0;2,0;;;;49,0;6,0;6,0;53,0;1,0;5,0;3,0;;20,0;1,0;;29,0;12,0;3,0;9,0;;83,0;9,0;2,0;120,0;4,0;17,0;2,0;32,0;6,0;10,0;33,0;10,0;;39,0;9,0;;9,0;4,0;6,0;5,0;;3,0;;16,0;2,0;5,0;11,0;23,0;10,0;46,0;2,0;37,0;2,0;;34,0;7,0;13,0;;;11,0;;;1,0;;1,0;2,0;11,0;3,0;7,0;10,0;;1,0;1,0;;4,0;21,0;1,0;2,0;3,0;;2,0;;5,0;16,0;38,0;1,0;5,0;8,0;;10,0;16,0;7,0;;;1,0;12,0;20,0;;;5,0;;4,0;9,0;1,0;2,0;;2,0;16,0;19,0;;105,0;16,0;;11,0;38,0;;24,0;7,0;6,0;1,0;2,0;2,0;;4,0;16,0;2,0;7,0;;3,0;4,0;1,0;;15,0;1,0;7,0;10,0;3,0;2,0;6,0;2,0;9,0;34,0;;;6,0;17,0;2,0;;19,0;3,0;;30,0;;11,0;13,0;;5,0;;;;;;;;;1,0;7,0;;2,0;8,0;;7,0;;6,0;;16,0;;;2,0;7,0;;39,0;2,0;;;;4,0;2,0;1,0;11,0;19,0;29,0;6,0;;3,0;;3,0;21,0;;;1,0;;8,0;;12,0;4,0;1,0;2,0;;12,0;1,0;6,0;2,0;9,0;3,0;;8,0;7,0;3,0;1,0;1,0;5,0;1,0;10,0;1,0;1,0;;6,0;;;1,0;8,0;;;6,0;1,0;;;1,0;9,0;3,0;;15,0;10,0;13,0;11,0;4,0;27,0;15,0;3,0;10,0;16,0;2,0;7,0;5,0;31,0;20,0;30,0;4,0;9,0;1,0;14,0;3,0;86,0;15,0;17,0;;1,0;13,0;6,0;17,0;10,0;23,0;28,0;3,0;2,0;22,0;4,0;6,0;2,0;1,0;2,0;13,0;6,0;45,0;6,0;11,0;28,0;2,0;10,0;2,0;2,0;54,0;1,0;18,0;11,0;;26,0;3,0;3,0;8,0;5,0;1,0;29,0;5,0;2,0;1,0;12,0;64,0;1,0;18,0;17,0;13,0;1,0;2,0;31,0;4,0;2,0;15,0;;1,0;8,0;;;2,0;;;4,0;13,0;3,0;6,0;10,0;;26,0;60,0;;8,0;4,0;;1,0;;2,0;20,0;;2,0;2,0;1,0;;;1,0;;;;2,0;;12,0;8,0;11,0;4,0;2,0;;1,0;;;4,0;2,0;10,0;;7,0;5,0;;3,0;3,0;3,0;1,0;8,0;5,0;1,0;;;2,0;2,0;62,0;2,0;;10,0;12,0;20,0;48,0;;;2,0;2,0;;5,0;;;;4,0;1,0;22,0;;14,0;7,0;2,0;;3,0;13,0;;28,0;;16,0;7,0;2,0;8,0;9,0;13,0;9,0;4,0;;1,0;2,0;;;;10,0;;;2,0;;1,0;;5,0;23,0;;4,0;1,0;1,0;;;6,0;;;;37,0;;;1,0;4,0;4,0;7,0;;;;;;25,0;1,0;;10,0;2,0;;2,0;31,0;3,0;3,0;;8,0;;2,0;;1,0;9,0;9,0;2,0;;;2,0;1,0;;;;;1,0
prevent;1,0;3,0;;;;7,0;;12,0;;1,0;;;;;8,0;2,0;16,0;;;1,0;3,0;8,0;2,0;1,0;;;4,0;;;;;1,0;29,0;;28,0;5,0;1,0;3,0;1,0;;14,0;;2,0;;14,0;;;35,0;6,0;18,0;2,0;2,0;2,0;2,0;5,0;;3,0;;;;2,0;;;1,0;5,0;;11,0;18,0;4,0;5,0;3,0;1,0;5,0;4,0;;1,0;3,0;;2,0;46,0;;5,0;1,0;9,0;2,0;1,0;3,0;;2,0;1,0;48,0;;;2,0;;;3,0;;15,0;;;;20,0;4,0;;1,0;10,0;6,0;13,0;;3,0;4,0;;;;5,0;35,0;16,0;2,0;3,0;;;;;1,0;2,0;;;2,0;;2,0;6,0;6,0;3,0;;;;2,0;;;;2,0;2,0;3,0;;1,0;;10,0;7,0;3,0;;;2,0;;2,0;;3,0;;4,0;6,0;;4,0;27,0;;;;2,0;7,0;;;3,0;;1,0;1,0;;;7,0;14,0;1,0;;1,0;8,0;;1,0;7,0;11,0;1,0;4,0;;;1,0;;1,0;4,0;;12,0;;;;10,0;1,0;;;13,0;;;;;5,0;3,0;2,0;;6,0;1,0;1,0;;5,0;;;11,0;20,0;;1,0;4,0;;1,0;1,0;1,0;33,0;;29,0;;10,0;16,0;19,0;2,0;37,0;4,0;3,0;3,0;;16,0;;3,0;;;;;3,0;;29,0;;;1,0;1,0;;10,0;1,0;1,0;;;3,0;4,0;2,0;;1,0;2,0;5,0;7,0;4,0;26,0;;1,0;6,0;;5,0;;16,0;2,0;17,0;8,0;;;;;3,0;;;;8,0;2,0;2,0;1,0;;5,0;6,0;3,0;1,0;7,0;3,0;9,0;1,0;2,0;;7,0;5,0;3,0;12,0;3,0;;;2,0;;3,0;5,0;;;3,0;4,0;5,0;;;4,0;2,0;5,0;1,0;9,0;5,0;;9,0;1,0;7,0;2,0;1,0;;;;13,0;;6,0;;1,0;2,0;1,0;1,0;;17,0;1,0;;1,0;;3,0;2,0;1,0;1,0;4,0;;5,0;;1,0;;;7,0;1,0;5,0;1,0;;7,0;1,0;3,0;;;2,0;;;;12,0;;9,0;18,0;6,0;;;1,0;;2,0;;1,0;;22,0;1,0;;;;;;;;;;;;3,0;;;;;;;;3,0;1,0;;;3,0;;;;;;;;;;2,0;;;5,0;;;;2,0;3,0;5,0;4,0;;;;4,0;;2,0;3,0;39,0;;;1,0;10,0;;;;;2,0;;;;2,0;;;4,0;;;;;;;;;1,0;;1,0;;2,0;1,0;;14,0;1,0;;;;;2,0;;;4,0;;4,0;;;;;;1,0;;3,0;;;3,0;;;;1,0;;;3,0;2,0;;;;;;;1,0;;1,0;;1,0;1,0;;;;1,0;;2,0;3,0;;;;4,0;;1,0;;;2,0;3,0;;;;;;;;1,0;;;;1,0;;;;;;2,0;;2,0;;;;;5,0;2,0;;1,0;;1,0;1,0;10,0;;8,0;;8,0;;;9,0;;2,0;1,0;1,0;2,0;;4,0;;1,0;2,0;;7,0;;;;1,0;;4,0;;;1,0;;;;1,0;1,0;;1,0;;1,0;;;;2,0;;;;2,0;1,0;;;;;;;;;;;;3,0;;;1,0;1,0;2,0;;1,0;;;5,0;1,0;;;;2,0;;;;;;;;;3,0;5,0;1,0;;1,0;;;;2,0;;;4,0;1,0;;;;;4,0;;2,0;;;14,0;1,0;;1,0;;;2,0;;;;;1,0;4,0;3,0;;;;;;3,0;1,0;;;;;;;;5,0;;;;;;;;;;;;;;;;3,0;;;;;15,0;8,0;;1,0;2,0;;1,0;1,0;;;1,0;1,0;5,0;;3,0;;1,0;;;5,0;1,0;;;;;1,0;;3,0;1,0;;1,0;;2,0;;;8,0;;;1,0;7,0;;6,0;;;;;;;;;;;5,0;;;;5,0;2,0;2,0;;;;;8,0;;6,0;13,0;;;;;;;;1,0;;;;;;;;;;;;;;;5,0;;;;;;2,0;;2,0;;;12,0;;1,0;;;;1,0;;;;;;;;;;3,0;;;;;;;;1,0;;;;4,0;;;3,0;;;;;;;;;;2,0;;;2,0;;;;;;;;;;;2,0;;;;;;1,0;;15,0;;;;;;;;;;;;;;;;;1,0;;;;;;4,0;;1,0;1,0;;;;;;;;;;;;;;2,0;;;;2,0;;;;;;;;;;;;;;;;;;;;2,0;;;1,0;2,0;;;1,0;;;;;;;;;;;;;;;;;1,0;;3,0;;;;;;;2,0;1,0;;1,0;2,0;;;;4,0;;;;;1,0;;;;;;;;
prism;2,0;;;;;28,0;;3,0;3,0;6,0;2,0;;2,0;;5,0;4,0;33,0;;1,0;;;;1,0;;;;;2,0;;;;;14,0;;;1,0;;;;;;;;;;;;25,0;;4,0;17,0;;;2,0;3,0;2,0;20,0;;;;1,0;;2,0;;;3,0;2,0;21,0;14,0;25,0;;;;;;1,0;;1,0;2,0;24,0;1,0;21,0;;35,0;;;;;;3,0;52,0;;;15,0;;;;;14,0;;;;16,0;3,0;;;61,0;;3,0;;4,0;;2,0;;;30,0;11,0;20,0;3,0;;;;;;;;4,0;;2,0;;;;;;;;1,0;;;;;;;15,0;;;;13,0;2,0;;;;1,0;;1,0;;23,0;;;;3,0;;36,0;2,0;1,0;;;2,0;;2,0;8,0;;;21,0;;;13,0;;;;1,0;7,0;;;;4,0;4,0;9,0;;;;;;2,0;;;;;;5,0;;;;11,0;;;;;;32,0;2,0;;;;1,0;;;;;;1,0;19,0;;;;;;;80,0;;23,0;;6,0;4,0;10,0;5,0;3,0;;1,0;1,0;;;;15,0;;;1,0;;;1,0;4,0;2,0;2,0;;;;4,0;16,0;;12,0;;;1,0;;;;13,0;;5,0;;;2,0;20,0;;;;;;2,0;219,0;1,0;;;;;;16,0;;;;2,0;;;;;;;;;;;1,0;1,0;;;;;2,0;3,0;;;4,0;;;;3,0;;;1,0;3,0;;;;1,0;1,0;;;;;;;;;;;;1,0;14,0;3,0;5,0;;9,0;;1,0;;;;11,0;20,0;;;8,0;;;;;;;;;;7,0;;;;;;1,0;;67,0;;;;;;;;1,0;4,0;1,0;;4,0;;1,0;;;;;;;;;;4,0;;1,0;;;6,0;;;;;;;;;;;;1,0;;;;;;;;;;;;;;;;;1,0;;;;;;;1,0;;;;;;;;;;;;;;;;1,0;;;;;;;;;;;;;;;;;;;;;3,0;;;;1,0;;;;;;;;1,0;;;;;;5,0;;1,0;;;;;;;8,0;;;;;;;;4,0;;;;;;3,0;;;;;;;;;;;;;;;;;;;;;;;;;;;;;;;;;2,0;;;;;;;;;;34,0;;;;;;;;;;;;2,0;;;2,0;;1,0;;;;;;;3,0;;;;;2,0;;;;;;;;;4,0;1,0;;;;;;3,0;;;;;1,0;;;;;1,0;;;;;;;;;;;;;1,0;;;3,0;;;;;;;;;;;;;;;;;;;;;3,0;;1,0;;;;;;;;;1,0;1,0;;;;;1,0;;1,0;25,0;;;;;;;;9,0;;;1,0;;;;1,0;;;;;;;1,0;;;1,0;;;;;;;;;;;;;;;;;;;;;5,0;;;;;;;;;;;;1,0;;;11,0;3,0;;;;;7,0;;1,0;;;;;;;1,0;;;;3,0;2,0;;;;;;;;;;;;;;;;;;;;;;;;;;;;;;;;;;2,0;;;;3,0;;;;;;;;;;;;;;;;;;;;;;;;;;;;;;;;1,0;;1,0;;10,0;;;;;;1,0;;;;;;;3,0;;;;;28,0;;;;;;;;;;;;;;;;;;;1,0;;;;;6,0;;;;;;;;;;;;;;;;;;;;1,0;;;;1,0;;;;;;;;;;3,0;;;;;;;;;;;;;;;2,0;;;;1,0;;;;;;;;;;;;2,0;;;;;;;;;;;;3,0;;7,0;;;;;1,0;18,0;;1,0;;6,0;4,0;;;;;;;;;;;;;;;;;;;;;;;;;3,0;;;;;;;;;;;;;;;;;;;;
process;5,0;5,0;1,0;5,0;6,0;37,0;;62,0;56,0;17,0;8,0;;13,0;37,0;4,0;68,0;4,0;10,0;18,0;9,0;38,0;154,0;76,0;;1,0;6,0;55,0;6,0;;13,0;86,0;7,0;216,0;8,0;124,0;27,0;16,0;48,0;8,0;;481,0;;16,0;36,0;53,0;55,0;102,0;126,0;107,0;102,0;;36,0;18,0;1,0;12,0;39,0;22,0;12,0;11,0;6,0;4,0;3,0;5,0;31,0;35,0;11,0;61,0;42,0;56,0;;13,0;;150,0;6,0;3,0;31,0;32,0;4,0;;1249,0;26,0;65,0;6,0;98,0;1,0;31,0;13,0;1,0;;4,0;78,0;;3,0;2,0;22,0;10,0;41,0;6,0;133,0;10,0;5,0;18,0;49,0;100,0;2,0;41,0;21,0;5,0;198,0;43,0;1,0;327,0;;6,0;1,0;76,0;29,0;52,0;7,0;46,0;;;;395,0;203,0;13,0;;;2,0;9,0;;36,0;6,0;2,0;4,0;10,0;8,0;16,0;31,0;3,0;27,0;1,0;5,0;91,0;21,0;;;5,0;585,0;6,0;22,0;;30,0;72,0;30,0;7,0;126,0;;9,0;6,0;2,0;37,0;198,0;;7,0;;80,0;29,0;6,0;2,0;15,0;8,0;18,0;3,0;32,0;20,0;3,0;1,0;1,0;;5,0;10,0;6,0;;3,0;89,0;1,0;43,0;2,0;;2,0;12,0;;8,0;;;12,0;6,0;36,0;2,0;;2,0;13,0;9,0;4,0;;8,0;1,0;66,0;18,0;29,0;3,0;;2,0;2,0;7,0;;1,0;;1,0;6,0;;;1,0;;;8,0;;50,0;19,0;5,0;4,0;1,0;4,0;;25,0;8,0;1,0;;1,0;1,0;;2,0;1,0;16,0;;6,0;5,0;162,0;2,0;1,0;6,0;;;;1,0;112,0;3,0;;;;17,0;;50,0;;5,0;15,0;5,0;;;2,0;9,0;1,0;5,0;3,0;;18,0;7,0;5,0;22,0;13,0;2,0;1,0;3,0;;56,0;;6,0;4,0;3,0;24,0;3,0;;4,0;1,0;;12,0;;2,0;;7,0;5,0;;;;;;10,0;1,0;;2,0;2,0;5,0;;2,0;17,0;;1,0;3,0;13,0;;;;;19,0;;;;22,0;;;;;;;20,0;;3,0;29,0;2,0;;;1,0;8,0;27,0;1,0;;1,0;44,0;14,0;;;2,0;4,0;;;;45,0;3,0;2,0;;4,0;;;;;1,0;1,0;;;1,0;;;;17,0;;;;2,0;13,0;;;4,0;;2,0;1,0;;;;4,0;3,0;13,0;1,0;;5,0;6,0;1,0;9,0;;1,0;3,0;;1,0;31,0;2,0;3,0;16,0;2,0;8,0;26,0;32,0;7,0;22,0;5,0;10,0;1,0;4,0;10,0;1,0;;2,0;;8,0;22,0;;2,0;3,0;15,0;;2,0;2,0;63,0;17,0;1,0;14,0;;11,0;19,0;54,0;2,0;27,0;26,0;10,0;;8,0;16,0;23,0;6,0;12,0;37,0;;;;2,0;14,0;49,0;1,0;13,0;;14,0;13,0;;3,0;4,0;;;9,0;1,0;19,0;11,0;3,0;;6,0;29,0;21,0;;9,0;4,0;21,0;4,0;45,0;2,0;9,0;3,0;26,0;6,0;3,0;14,0;2,0;2,0;;4,0;10,0;99,0;10,0;;6,0;1,0;19,0;1,0;11,0;6,0;2,0;9,0;11,0;1,0;1,0;1,0;45,0;2,0;22,0;5,0;3,0;6,0;14,0;6,0;1,0;;;6,0;4,0;5,0;9,0;11,0;5,0;;28,0;;7,0;10,0;31,0;40,0;10,0;5,0;4,0;;7,0;1,0;11,0;11,0;4,0;;;4,0;4,0;34,0;5,0;3,0;;7,0;1,0;;8,0;5,0;10,0;4,0;;;;10,0;;6,0;4,0;1,0;;;1,0;19,0;2,0;18,0;37,0;2,0;7,0;;11,0;4,0;;1,0;;;4,0;;3,0;10,0;12,0;1,0;;7,0;2,0;1,0;6,0;5,0;17,0;4,0;;1,0;;6,0;3,0;5,0;;;2,0;7,0;2,0;20,0;3,0;;;;;7,0;;;;1,0;;2,0;3,0;1,0;13,0;;;15,0;4,0;1,0;7,0;9,0;;6,0;2,0;;;5,0;25,0;11,0;3,0;;14,0;4,0;13,0;1,0;5,0;9,0;8,0;3,0;;;1,0;2,0;;1,0;5,0;;;;9,0;;;;;10,0;3,0;2,0;68,0;3,0;;1,0;;2,0;2,0;;;3,0;5,0;1,0;;;;;;;;;;2,0;9,0;22,0;;;13,0;2,0;;;1,0;;1,0;1,0;;;;;1,0;15,0;;1,0;4,0;20,0;;;;;2,0;2,0;;;1,0;;;;;;;2,0;1,0;;2,0;7,0;;7,0;;6,0;2,0;3,0;2,0;;3,0;2,0;4,0;9,0;;1,0;;10,0;;8,0;1,0;3,0;3,0;;;;1,0;;3,0;9,0;1,0;;5,0;;;;;14,0;2,0;16,0;1,0;28,0;;2,0;;;24,0;26,0;;6,0;;;5,0;5,0;;;1,0;;4,0;20,0;9,0;1,0;2,0;9,0;6,0;11,0;1,0;2,0;;;;1,0;10,0;5,0;4,0;;3,0;10,0;8,0;2,0;;;37,0;9,0;6,0;40,0;;1,0;;;2,0;1,0;;;1,0;8,0;7,0;10,0;2,0;3,0;;2,0;19,0;6,0;2,0;6,0;;2,0;10,0;;;;;2,0;;1,0;;;4,0;1,0;;27,0;;1,0;;;11,0;7,0;2,0;;4,0;1,0;2,0;;;;;;;13,0;;;;;11,0;;;;4,0;;;1,0;;1,0;2,0;;;4,0;3,0;18,0;;2,0;;;1,0;5,0;1,0;1,0;;13,0;;1,0;1,0;2,0;9,0;;;;5,0;;;;;;1,0;4,0;;;3,0;;3,0;;;2,0;;;1,0;;;35,0;;35,0;4,0;;;4,0;19,0;;7,0;;;1,0;4,0;1,0;;;;;;;;;19,0;;;2,0;;17,0;2,0;;;1,0;;;;26,0;;;;;6,0;;130,0;;;;;;;;1,0;20,0;;1,0;5,0;5,0;;3,0;;;;;;;1,0;;;;;;;;2,0;1,0
processing;12,0;12,0;2,0;20,0;24,0;46,0;9,0;894,0;100,0;78,0;25,0;;54,0;7,0;4,0;176,0;12,0;12,0;14,0;5,0;17,0;306,0;19,0;14,0;3,0;10,0;137,0;14,0;;10,0;98,0;12,0;658,0;33,0;364,0;26,0;50,0;141,0;32,0;1,0;1281,0;5,0;26,0;54,0;148,0;119,0;256,0;1015,0;266,0;303,0;17,0;29,0;25,0;12,0;38,0;75,0;135,0;2,0;38,0;23,0;5,0;31,0;31,0;41,0;80,0;10,0;45,0;45,0;128,0;5,0;108,0;21,0;303,0;9,0;2,0;23,0;48,0;3,0;6,0;5267,0;13,0;331,0;45,0;539,0;15,0;159,0;4,0;1,0;;23,0;104,0;6,0;23,0;2,0;8,0;215,0;192,0;4,0;659,0;46,0;8,0;24,0;304,0;174,0;;55,0;55,0;23,0;313,0;202,0;10,0;921,0;4,0;8,0;10,0;263,0;131,0;109,0;26,0;183,0;;;395,0;;217,0;210,0;8,0;11,0;4,0;70,0;17,0;58,0;14,0;18,0;9,0;62,0;40,0;18,0;51,0;3,0;47,0;5,0;5,0;227,0;72,0;27,0;;39,0;1532,0;27,0;24,0;;102,0;279,0;111,0;30,0;776,0;;5,0;18,0;13,0;67,0;1996,0;9,0;4,0;;264,0;44,0;17,0;6,0;66,0;;;13,0;40,0;39,0;15,0;;1,0;;25,0;20,0;;;40,0;503,0;;178,0;1,0;;21,0;21,0;;164,0;;2,0;6,0;3,0;10,0;4,0;;12,0;34,0;41,0;5,0;;10,0;3,0;52,0;99,0;5,0;;;2,0;4,0;;;5,0;2,0;1,0;23,0;3,0;;14,0;1,0;;1,0;;93,0;2,0;18,0;;3,0;16,0;3,0;20,0;7,0;5,0;3,0;1,0;16,0;6,0;3,0;20,0;15,0;8,0;7,0;11,0;270,0;9,0;8,0;8,0;3,0;;;7,0;200,0;;;;;;;177,0;24,0;7,0;39,0;1,0;7,0;1,0;2,0;51,0;17,0;;2,0;;41,0;10,0;31,0;53,0;32,0;39,0;18,0;2,0;15,0;175,0;6,0;14,0;;;72,0;12,0;3,0;4,0;4,0;;17,0;3,0;2,0;;14,0;11,0;4,0;;;1,0;;136,0;1,0;4,0;9,0;5,0;121,0;;5,0;75,0;;6,0;;63,0;;;;1,0;23,0;9,0;;;1,0;5,0;1,0;;1,0;;;29,0;2,0;;16,0;;;;8,0;42,0;2,0;1,0;8,0;10,0;85,0;20,0;;2,0;33,0;81,0;;;1,0;55,0;18,0;9,0;7,0;14,0;1,0;;;;1,0;2,0;;2,0;18,0;5,0;8,0;7,0;5,0;;;;5,0;11,0;;;18,0;;;3,0;;;;16,0;;130,0;;9,0;;45,0;1,0;2,0;21,0;;10,0;2,0;22,0;40,0;;4,0;4,0;12,0;22,0;104,0;82,0;60,0;20,0;9,0;39,0;;11,0;5,0;;26,0;2,0;2,0;24,0;55,0;;;3,0;30,0;15,0;17,0;2,0;158,0;52,0;4,0;18,0;14,0;42,0;12,0;249,0;1,0;27,0;106,0;56,0;7,0;42,0;47,0;182,0;15,0;15,0;45,0;15,0;2,0;;1,0;31,0;202,0;9,0;40,0;1,0;9,0;30,0;1,0;12,0;11,0;;;11,0;;54,0;45,0;4,0;;11,0;46,0;181,0;9,0;47,0;1,0;11,0;9,0;64,0;1,0;9,0;27,0;21,0;2,0;;7,0;;12,0;;6,0;12,0;305,0;5,0;4,0;12,0;1,0;58,0;3,0;11,0;12,0;5,0;58,0;39,0;11,0;15,0;8,0;98,0;11,0;15,0;36,0;3,0;6,0;28,0;9,0;;2,0;;8,0;13,0;17,0;8,0;102,0;8,0;2,0;33,0;;5,0;125,0;7,0;16,0;46,0;9,0;5,0;5,0;27,0;5,0;3,0;17,0;8,0;;;6,0;;44,0;17,0;20,0;;33,0;3,0;;16,0;13,0;11,0;13,0;2,0;1,0;;10,0;9,0;75,0;12,0;35,0;1,0;22,0;4,0;39,0;5,0;45,0;47,0;3,0;14,0;;;13,0;;;6,0;;9,0;;8,0;5,0;74,0;12,0;;9,0;1,0;3,0;15,0;1,0;135,0;3,0;3,0;3,0;1,0;34,0;3,0;9,0;3,0;;8,0;11,0;2,0;106,0;8,0;;7,0;1,0;4,0;22,0;10,0;1,0;;8,0;;11,0;4,0;22,0;19,0;6,0;2,0;41,0;14,0;;80,0;36,0;1,0;39,0;8,0;;;14,0;49,0;23,0;9,0;2,0;33,0;2,0;11,0;22,0;6,0;4,0;7,0;7,0;2,0;2,0;20,0;9,0;;28,0;12,0;1,0;4,0;4,0;2,0;3,0;2,0;;17,0;5,0;;;100,0;15,0;9,0;4,0;;;2,0;;19,0;6,0;;;;1,0;;;;7,0;12,0;;;7,0;11,0;24,0;8,0;6,0;;7,0;1,0;1,0;;2,0;;;4,0;;1,0;;10,0;3,0;;4,0;34,0;75,0;;;1,0;;8,0;;;3,0;;1,0;;;5,0;1,0;4,0;26,0;12,0;2,0;;5,0;1,0;19,0;4,0;16,0;1,0;20,0;17,0;3,0;3,0;9,0;;13,0;4,0;;;10,0;;2,0;12,0;1,0;;3,0;;12,0;;;2,0;26,0;;;15,0;;21,0;6,0;2,0;20,0;14,0;2,0;4,0;111,0;;5,0;;9,0;46,0;49,0;;3,0;3,0;3,0;8,0;10,0;5,0;2,0;2,0;;2,0;17,0;8,0;3,0;10,0;42,0;7,0;3,0;;15,0;3,0;;;21,0;12,0;2,0;15,0;13,0;12,0;21,0;6,0;6,0;65,0;;29,0;17,0;13,0;101,0;;4,0;;46,0;4,0;;3,0;2,0;13,0;8,0;14,0;21,0;20,0;9,0;3,0;33,0;11,0;4,0;2,0;18,0;1,0;1,0;10,0;9,0;;2,0;;20,0;;49,0;9,0;5,0;6,0;;1,0;28,0;;8,0;6,0;;13,0;9,0;1,0;2,0;15,0;13,0;12,0;;2,0;2,0;1,0;;;22,0;35,0;;4,0;;1,0;2,0;3,0;3,0;;;5,0;;3,0;;;;6,0;;1,0;27,0;2,0;8,0;;;9,0;8,0;;;2,0;;;1,0;14,0;17,0;1,0;1,0;5,0;;15,0;;;;1,0;;;2,0;1,0;1,0;3,0;4,0;8,0;1,0;11,0;1,0;;;9,0;2,0;;32,0;;11,0;3,0;;5,0;1,0;11,0;1,0;;;2,0;5,0;;1,0;;;;;10,0;;36,0;2,0;10,0;;;11,0;;1,0;9,0;;1,0;9,0;;;;52,0;;;8,0;10,0;5,0;;;1,0;;22,0;4,0;;;;1,0;7,0;;2,0;35,0;17,0;;10,0;;1,0;;3,0;;;4,0;1,0;4,0;;1,0;;;;;1,0
processor;3,0;3,0;;1,0;46,0;45,0;4,0;296,0;48,0;39,0;39,0;;89,0;3,0;12,0;109,0;10,0;11,0;20,0;8,0;29,0;203,0;14,0;42,0;3,0;3,0;64,0;8,0;;12,0;227,0;20,0;1106,0;13,0;256,0;59,0;26,0;49,0;35,0;4,0;385,0;3,0;40,0;34,0;128,0;28,0;385,0;616,0;291,0;283,0;13,0;63,0;16,0;3,0;6,0;25,0;52,0;15,0;42,0;190,0;4,0;3,0;42,0;25,0;40,0;14,0;56,0;39,0;122,0;1,0;44,0;;217,0;6,0;4,0;7,0;54,0;3,0;14,0;1959,0;43,0;161,0;53,0;270,0;16,0;693,0;;;;15,0;81,0;2,0;19,0;1,0;37,0;107,0;351,0;;238,0;57,0;21,0;21,0;136,0;139,0;;165,0;44,0;3,0;166,0;42,0;6,0;354,0;8,0;4,0;1,0;194,0;40,0;125,0;22,0;25,0;1,0;;203,0;217,0;;274,0;2,0;2,0;6,0;21,0;;32,0;27,0;6,0;22,0;40,0;9,0;59,0;18,0;;46,0;2,0;36,0;308,0;28,0;3,0;2,0;7,0;510,0;37,0;5,0;;118,0;236,0;23,0;5,0;563,0;;19,0;17,0;30,0;50,0;182,0;5,0;7,0;1,0;249,0;57,0;5,0;2,0;65,0;;;4,0;8,0;28,0;45,0;;;8,0;30,0;21,0;2,0;24,0;;67,0;;40,0;1,0;;13,0;8,0;;158,0;1,0;7,0;16,0;;3,0;5,0;1,0;1,0;12,0;34,0;20,0;1,0;1,0;6,0;25,0;30,0;2,0;6,0;;17,0;;;;;;;33,0;4,0;4,0;5,0;;;4,0;;90,0;;5,0;;7,0;15,0;3,0;8,0;10,0;7,0;2,0;1,0;6,0;4,0;1,0;6,0;12,0;1,0;4,0;10,0;119,0;20,0;5,0;4,0;4,0;1,0;;19,0;343,0;3,0;2,0;;;;;109,0;2,0;;7,0;;22,0;;2,0;36,0;17,0;;4,0;;5,0;20,0;25,0;44,0;30,0;2,0;3,0;2,0;;72,0;5,0;21,0;1,0;;76,0;5,0;;2,0;;4,0;10,0;;3,0;;10,0;13,0;4,0;;2,0;14,0;;21,0;;6,0;1,0;3,0;15,0;;5,0;42,0;2,0;18,0;2,0;371,0;;;1,0;;14,0;1,0;;;4,0;1,0;;;8,0;;;16,0;10,0;3,0;;2,0;;;1,0;19,0;3,0;4,0;;7,0;13,0;23,0;;4,0;;10,0;3,0;4,0;7,0;54,0;11,0;5,0;3,0;3,0;;1,0;;;;2,0;;8,0;4,0;;;16,0;2,0;;;;22,0;17,0;;;21,0;7,0;;17,0;;;4,0;9,0;8,0;33,0;3,0;28,0;1,0;9,0;4,0;9,0;2,0;;17,0;18,0;35,0;46,0;;7,0;2,0;5,0;5,0;95,0;33,0;102,0;25,0;13,0;111,0;;8,0;;2,0;1,0;2,0;8,0;33,0;10,0;5,0;4,0;3,0;33,0;3,0;3,0;18,0;130,0;12,0;11,0;71,0;1,0;3,0;24,0;34,0;3,0;17,0;63,0;15,0;5,0;36,0;37,0;150,0;2,0;41,0;12,0;6,0;3,0;;4,0;18,0;33,0;14,0;36,0;4,0;14,0;17,0;7,0;19,0;2,0;1,0;2,0;2,0;23,0;35,0;46,0;8,0;2,0;11,0;28,0;110,0;2,0;20,0;10,0;;;47,0;11,0;10,0;15,0;36,0;;18,0;10,0;5,0;11,0;1,0;19,0;50,0;627,0;8,0;7,0;20,0;6,0;114,0;5,0;8,0;12,0;30,0;12,0;74,0;;8,0;;32,0;12,0;9,0;34,0;;8,0;25,0;1,0;10,0;13,0;6,0;;6,0;15,0;;31,0;2,0;14,0;35,0;;2,0;16,0;3,0;2,0;18,0;34,0;;;14,0;4,0;13,0;2,0;7,0;;3,0;4,0;4,0;20,0;6,0;16,0;;24,0;6,0;;10,0;28,0;2,0;4,0;;4,0;;4,0;11,0;17,0;2,0;17,0;1,0;57,0;44,0;79,0;20,0;9,0;20,0;17,0;30,0;1,0;9,0;43,0;5,0;;6,0;;6,0;2,0;5,0;3,0;38,0;7,0;8,0;38,0;3,0;3,0;8,0;1,0;1,0;3,0;3,0;;2,0;;5,0;1,0;32,0;25,0;30,0;6,0;6,0;28,0;4,0;1,0;1,0;1,0;;4,0;;;9,0;;;9,0;4,0;77,0;2,0;3,0;;28,0;21,0;1,0;59,0;25,0;2,0;;6,0;;4,0;14,0;24,0;7,0;5,0;;53,0;4,0;19,0;12,0;5,0;7,0;4,0;19,0;2,0;1,0;16,0;4,0;;31,0;4,0;;2,0;;19,0;;;;;1,0;2,0;;4,0;2,0;4,0;7,0;;;36,0;;;15,0;4,0;;;13,0;;;;3,0;21,0;;;6,0;31,0;13,0;;4,0;;5,0;;;1,0;3,0;2,0;1,0;6,0;;;;15,0;5,0;;;5,0;7,0;;1,0;;;;2,0;;1,0;17,0;;;;;6,0;;;2,0;5,0;;3,0;;4,0;10,0;18,0;5,0;21,0;4,0;9,0;3,0;4,0;;8,0;8,0;;2,0;3,0;;;5,0;6,0;;7,0;;4,0;4,0;;;1,0;;;6,0;1,0;;;;3,0;3,0;5,0;;4,0;;15,0;;;1,0;20,0;;37,0;2,0;1,0;3,0;3,0;;10,0;;;1,0;10,0;7,0;2,0;1,0;29,0;4,0;4,0;2,0;6,0;1,0;;;4,0;6,0;11,0;11,0;20,0;8,0;4,0;3,0;1,0;3,0;;11,0;10,0;8,0;15,0;;2,0;1,0;5,0;3,0;1,0;9,0;;6,0;10,0;9,0;6,0;4,0;;4,0;36,0;11,0;;2,0;15,0;3,0;8,0;1,0;;2,0;;;4,0;;;25,0;2,0;15,0;5,0;2,0;2,0;;1,0;5,0;16,0;23,0;4,0;7,0;5,0;17,0;2,0;18,0;2,0;4,0;2,0;;2,0;6,0;23,0;;6,0;10,0;;;3,0;2,0;;2,0;;1,0;;3,0;4,0;3,0;;2,0;1,0;6,0;1,0;;5,0;9,0;;7,0;17,0;5,0;;;1,0;4,0;1,0;6,0;10,0;7,0;8,0;3,0;;11,0;;;;8,0;;1,0;3,0;1,0;;4,0;2,0;15,0;5,0;2,0;1,0;;;;9,0;;15,0;;;2,0;;1,0;1,0;12,0;3,0;;;;;1,0;21,0;;;;;1,0;;13,0;;1,0;1,0;;14,0;1,0;11,0;5,0;;2,0;4,0;;1,0;6,0;2,0;;5,0;2,0;13,0;10,0;20,0;;5,0;;;5,0;;1,0;2,0;1,0;11,0;4,0;1,0;13,0;10,0;2,0;8,0;;1,0;5,0;;3,0;;8,0;4,0;2,0;;4,0;;;;1,0;
program;1,0;;;;5,0;12,0;11,0;77,0;13,0;3,0;;;18,0;;4,0;17,0;1,0;1,0;1,0;5,0;23,0;42,0;7,0;15,0;16,0;;20,0;10,0;7,0;;749,0;2,0;58,0;;136,0;14,0;11,0;10,0;5,0;;97,0;;10,0;17,0;35,0;10,0;67,0;195,0;46,0;54,0;1,0;15,0;6,0;2,0;;1,0;5,0;2,0;8,0;113,0;;4,0;11,0;4,0;3,0;9,0;9,0;;30,0;;16,0;;21,0;2,0;;9,0;27,0;3,0;2,0;307,0;3,0;29,0;67,0;81,0;;370,0;;;;2,0;27,0;;5,0;1,0;1,0;276,0;143,0;3,0;118,0;11,0;28,0;6,0;72,0;62,0;;8,0;8,0;7,0;37,0;22,0;;87,0;;;;70,0;18,0;34,0;;25,0;2,0;;13,0;210,0;274,0;;;;;13,0;;6,0;1,0;;7,0;2,0;1,0;17,0;;;50,0;;1,0;31,0;9,0;;;4,0;26,0;3,0;8,0;;142,0;333,0;33,0;;158,0;;11,0;11,0;112,0;6,0;51,0;1,0;2,0;;63,0;32,0;;1,0;8,0;;;;5,0;18,0;10,0;1,0;;;4,0;7,0;;;;9,0;;4,0;;;1,0;;;16,0;;;15,0;;1,0;1,0;;1,0;1,0;6,0;1,0;;;1,0;14,0;11,0;2,0;2,0;;;;;;;1,0;;2,0;;;;;;2,0;;20,0;;;;1,0;8,0;;2,0;;;;;4,0;7,0;1,0;7,0;;;;9,0;42,0;5,0;;;;;;4,0;84,0;4,0;;;;;;40,0;;;2,0;;1,0;;;18,0;5,0;;1,0;;2,0;4,0;;12,0;1,0;2,0;1,0;2,0;;12,0;;1,0;;;5,0;2,0;;;;;2,0;;;;4,0;5,0;;;;2,0;;13,0;;;;;4,0;;1,0;4,0;;;;3,0;;;;;1,0;;;;1,0;;;;2,0;;;8,0;2,0;2,0;2,0;;;;1,0;2,0;;1,0;;;1,0;8,0;;;;1,0;;;;28,0;6,0;;;;;;;;;1,0;;;5,0;;;8,0;;;;;2,0;7,0;;;9,0;;;2,0;;;;25,0;2,0;8,0;1,0;53,0;;4,0;1,0;;;;;;3,0;11,0;;;;;9,0;22,0;25,0;267,0;7,0;1,0;42,0;;1,0;;;1,0;2,0;2,0;11,0;5,0;;3,0;;6,0;;5,0;3,0;23,0;2,0;12,0;10,0;;10,0;11,0;15,0;;3,0;13,0;;3,0;8,0;17,0;30,0;;12,0;2,0;1,0;;;1,0;6,0;71,0;33,0;22,0;;;5,0;;;10,0;;;;;9,0;21,0;5,0;;3,0;1,0;33,0;1,0;4,0;2,0;;;15,0;2,0;7,0;2,0;2,0;;1,0;1,0;;;1,0;10,0;17,0;217,0;2,0;2,0;;5,0;70,0;;1,0;2,0;6,0;5,0;3,0;;;;9,0;2,0;2,0;11,0;3,0;11,0;2,0;;;;;;5,0;1,0;20,0;2,0;1,0;2,0;6,0;;1,0;5,0;5,0;1,0;1,0;3,0;2,0;;4,0;;2,0;4,0;;;;1,0;;8,0;3,0;6,0;;6,0;1,0;;1,0;1,0;;5,0;1,0;;;5,0;8,0;12,0;1,0;17,0;;28,0;9,0;11,0;;6,0;5,0;;11,0;;4,0;23,0;;;;;;;1,0;7,0;8,0;1,0;;;6,0;;1,0;1,0;;;2,0;;5,0;2,0;1,0;4,0;3,0;;6,0;4,0;;17,0;;;;2,0;3,0;10,0;;12,0;2,0;1,0;;276,0;;128,0;;;;3,0;5,0;;7,0;;;3,0;2,0;;;6,0;2,0;4,0;;;14,0;;;2,0;1,0;;;2,0;2,0;;25,0;2,0;;8,0;4,0;;;;;;;;;;;1,0;;1,0;;3,0;;1,0;3,0;;;;8,0;;;1,0;;2,0;;;5,0;;;;12,0;;;;;;;;1,0;2,0;4,0;;;;;;;1,0;;;6,0;11,0;;;;;1,0;1,0;;;;;;;;;;;1,0;;;1,0;2,0;;;9,0;1,0;1,0;;1,0;1,0;;;;2,0;;;;;;;3,0;;;;;3,0;;;;;;3,0;2,0;;;;;7,0;2,0;;;;1,0;;;3,0;12,0;;;;;13,0;1,0;11,0;14,0;;;;4,0;1,0;;13,0;10,0;1,0;12,0;;;;;;1,0;;3,0;8,0;1,0;;3,0;1,0;1,0;5,0;;;2,0;2,0;4,0;;;;3,0;;;;1,0;2,0;2,0;1,0;11,0;3,0;;;10,0;;;;;1,0;;;;;;;;;3,0;;;1,0;3,0;;;;;;29,0;18,0;4,0;;;;5,0;2,0;;;;;2,0;;;;;;;;1,0;;;;;1,0;;;5,0;;;;;1,0;;;6,0;;;1,0;6,0;1,0;;;;;5,0;4,0;;;;;;1,0;;;1,0;4,0;;1,0;1,0;;;;;1,0;;5,0;;3,0;;;;;1,0;;;4,0;;3,0;;;2,0;;;;;;2,0;;;;;2,0;;1,0;;;;;1,0;;;;;2,0;;;;3,0;;;;8,0;;;44,0;;;;;;;1,0;;;1,0;2,0;;1,0;7,0;;;;2,0;;;2,0;;6,0;1,0;5,0;;;;;;3,0;
property;4,0;;;;3,0;;;7,0;3,0;2,0;;;24,0;;6,0;26,0;;;2,0;;3,0;2,0;13,0;;2,0;;4,0;;;;;2,0;16,0;1,0;14,0;1,0;4,0;;1,0;;13,0;;2,0;;3,0;;39,0;13,0;;3,0;;6,0;3,0;;;;1,0;;;;;;8,0;5,0;16,0;;;;;1,0;2,0;6,0;3,0;;;;17,0;;;32,0;3,0;6,0;2,0;15,0;1,0;;3,0;;;;45,0;;;11,0;;5,0;;;29,0;1,0;1,0;;3,0;41,0;;4,0;102,0;;13,0;4,0;;3,0;;;;4,0;;13,0;10,0;14,0;;4,0;;8,0;2,0;;;;;2,0;;8,0;;2,0;6,0;;1,0;2,0;;2,0;1,0;;2,0;2,0;;;;1,0;28,0;2,0;7,0;;2,0;9,0;;;10,0;;8,0;1,0;4,0;3,0;31,0;11,0;1,0;;7,0;5,0;4,0;4,0;8,0;1,0;;;4,0;1,0;18,0;;;;1,0;10,0;;;3,0;1,0;3,0;;1,0;;;;;;;2,0;2,0;;;3,0;;;2,0;1,0;;;1,0;;;2,0;4,0;;;;1,0;;;1,0;;;2,0;;;;;;4,0;;16,0;1,0;2,0;;;;1,0;;2,0;;3,0;2,0;;;;;2,0;;;16,0;4,0;;;;;;;15,0;4,0;;;6,0;;;;;;;17,0;;;;1,0;1,0;1,0;;;;;;;2,0;;;5,0;;;6,0;;1,0;;4,0;;;1,0;;;;;;;;2,0;;;;;;;;;;;;;;;;;;;;;;;;14,0;;;;;;;;;6,0;;3,0;1,0;;1,0;;;;;;;;;;;1,0;;;;30,0;;;;7,0;;;;1,0;;;;;;;;10,0;1,0;;;2,0;;;1,0;;;;;;;;;;;;;;;;6,0;;;4,0;;;;;;;;;;;;;;2,0;8,0;;2,0;;14,0;;;;;;;;;;;2,0;;2,0;4,0;;;1,0;;;5,0;;1,0;12,0;;;1,0;;1,0;;;1,0;3,0;;;;;;;;;3,0;;1,0;;;;;32,0;6,0;;;;;1,0;4,0;;;;;1,0;2,0;;1,0;1,0;;10,0;;;;1,0;;;;2,0;;;1,0;;;;;;;;;1,0;;;1,0;1,0;;;;;;;;;1,0;;;;;;;;;;2,0;;;;;;;;;;;;;8,0;;;;;;;;;;;;;;;2,0;;2,0;;;;;;;;;;;;;;;;;;;1,0;;;;;;;;;;;;;;;;;;2,0;;;;;;;;1,0;10,0;;;3,0;;1,0;;;;;;;;;;;;;;;;;;;;;;21,0;;;;;;;;;;;;;;;;2,0;;;10,0;;;;;;;;;1,0;1,0;;;;1,0;;;;;2,0;2,0;1,0;2,0;;;;;;;;;;;;;;;;;;;;;;9,0;;1,0;;;;;;;;;;;;;;;;;;;;5,0;;;;;;;;;;;;;;;8,0;;;1,0;;;;;;;;2,0;;;;4,0;;2,0;;;;;;;;;;;;;;;1,0;;;;;;2,0;;4,0;;;;;2,0;;;;;;;;;;;;1,0;;1,0;;;;2,0;;;;;;;;;1,0;;;1,0;;1,0;;;2,0;;;;;8,0;;3,0;;;;;;;;;;;2,0;;;;;;;;;;;;;;;;;;;;;;1,0;;;;7,0;1,0;;;;;;;;;;;;;;3,0;;;;;;;;;;;;;1,0;1,0;;;;;1,0;;;;;;;;;;;;;;3,0;;1,0;;;;1,0;;;;;;;;;;;;;;;;;;;1,0;;;;;5,0;;;;;;;;;;;;;;;;2,0;;;;;1,0;;;;;;;;;;;;;;2,0;;;;;;;;;;;;;;;;1,0;;;;;;;;;;;;;;;;;;;;
quantity;1,0;;10,0;;;1,0;3,0;2,0;3,0;4,0;;;;;;36,0;11,0;22,0;2,0;;;15,0;;;;;4,0;;;1,0;;10,0;20,0;;57,0;2,0;12,0;23,0;;;29,0;;2,0;;38,0;2,0;24,0;16,0;2,0;1,0;;6,0;15,0;;9,0;;10,0;;;;1,0;;;;3,0;;6,0;3,0;2,0;;3,0;1,0;8,0;;3,0;26,0;2,0;3,0;5,0;104,0;;6,0;;9,0;6,0;;3,0;;;2,0;8,0;;;;;;;;7,0;;;;5,0;3,0;1,0;3,0;9,0;;3,0;1,0;9,0;7,0;;;;15,0;22,0;6,0;;44,0;;;;11,0;2,0;;;;;17,0;;4,0;9,0;;;;14,0;;4,0;;4,0;;;1,0;;;;;18,0;;;;8,0;13,0;7,0;8,0;11,0;;;;;;92,0;3,0;1,0;;;1,0;1,0;;;;;;;;;;;;;1,0;;;3,0;;;4,0;;;;;;;;;;;;;;;4,0;5,0;;;10,0;;14,0;;;;;;;;;;;7,0;;14,0;;;;;;;173,0;;;;;;;;1,0;;;;;;6,0;1,0;2,0;;;3,0;18,0;2,0;;;;;;;3,0;8,0;;;;;;11,0;;;;;5,0;;;3,0;23,0;;;;4,0;;;;;;;;;10,0;3,0;;;;2,0;;;;;;;;;;;;3,0;;3,0;;;2,0;;;;1,0;;;12,0;;;;;;;;;;1,0;;;;;;;;;;;3,0;;;;;;;;8,0;7,0;;;;;;;;;;;;;;2,0;;;;;;;;;;;;1,0;;;1,0;;;;;;1,0;;;;;2,0;;;;;;;;;;;;;;;;;;;1,0;;;;;5,0;104,0;9,0;;3,0;;;;;;1,0;1,0;;;12,0;;;;1,0;26,0;;1,0;;1,0;;;1,0;;2,0;8,0;4,0;;;22,0;4,0;;;1,0;18,0;6,0;;2,0;7,0;;;;;6,0;;;;;;;;5,0;;;;;4,0;;1,0;;;;;3,0;2,0;4,0;;;16,0;;;;2,0;;;;;;;;;2,0;2,0;;;;;;;;;5,0;;;;;5,0;;1,0;;;;;;;;;;;;;;;;;;;;;5,0;;;;;23,0;3,0;;2,0;;;;2,0;;;;;;;;;;2,0;;;;;;;;;;90,0;;1,0;;;;;4,0;;;;;;;;;;2,0;;;;67,0;;;;;;;;;;;;;1,0;;;;;1,0;1,0;;;;;;;;;;;;;;;;;1,0;;;4,0;2,0;;;;;;;;;2,0;;;;;;;;;;;;;;;;;;;;;;;;8,0;;;;;;;10,0;;;1,0;;6,0;;;10,0;;;;;;;;;;;;;;;;;;;;;;;;3,0;2,0;;;;;;;;;;3,0;;;;;;;;;;;;;;;1,0;;;;;;;;;;;10,0;37,0;;;;;;;;;;;;;;;;;;;;;;;;2,0;2,0;3,0;;;;;;;;;;;;1,0;3,0;;;2,0;;1,0;1,0;;;;;;;;;11,0;;;1,0;;3,0;;;;;;;5,0;4,0;;17,0;;9,0;;;;;;;;;;;;;;;;;15,0;1,0;;;;;1,0;;;;;1,0;;;;;;;;;;;;;;;;;;;;;;;;;;;;;;;;;;;;;;2,0;;;;;;;;;;;;;;;;;;;;;;;2,0;;;;3,0;;;;;3,0;3,0;;;;;;;;;;;;;;3,0;;;;;;;;;;;;;;;;;;2,0;;;;;;;1,0;1,0;;2,0;;2,0;;;1,0;;;;;;;;;;;;;;;;;;;;;;;;;;;;;;;;;;;;;;;13,0;;;;;;;;;
radiation;1,0;;2,0;;7,0;2,0;10,0;39,0;40,0;21,0;11,0;;2,0;;8,0;19,0;10,0;;;;1,0;19,0;;;;;8,0;;;;;;22,0;;7,0;5,0;1,0;;;;46,0;;12,0;2,0;105,0;18,0;33,0;30,0;3,0;2,0;2,0;4,0;;;1,0;;36,0;;1,0;;4,0;3,0;9,0;;21,0;8,0;16,0;22,0;16,0;1,0;5,0;;59,0;;;4,0;2,0;19,0;13,0;91,0;5,0;22,0;;43,0;;;;;;2,0;16,0;;;8,0;5,0;;2,0;;30,0;;;4,0;9,0;27,0;8,0;19,0;121,0;4,0;1,0;2,0;26,0;3,0;1,0;;;30,0;68,0;17,0;;5,0;2,0;2,0;2,0;4,0;6,0;;;;;57,0;;17,0;2,0;;3,0;1,0;15,0;14,0;12,0;;68,0;;1,0;68,0;;1,0;;2,0;36,0;1,0;;;;5,0;;;33,0;;;1,0;1,0;17,0;69,0;;;;;19,0;21,0;56,0;;2,0;1,0;1,0;3,0;;4,0;;2,0;;;13,0;;9,0;6,0;;;18,0;;;;;;2,0;;3,0;;;1,0;1,0;;1,0;3,0;16,0;3,0;;;65,0;;2,0;;;;;;;;5,0;;1,0;50,0;26,0;;;1,0;3,0;5,0;;59,0;;;;8,0;5,0;1,0;2,0;1,0;10,0;;;;1,0;3,0;4,0;3,0;;;1,0;23,0;16,0;;;;;;23,0;103,0;51,0;;;;;;6,0;;;;57,0;1,0;;;120,0;3,0;;14,0;;;10,0;8,0;25,0;4,0;1,0;4,0;3,0;;3,0;;;;3,0;6,0;;;;5,0;;;;;;;3,0;;;;;;5,0;;;;;;;;;;;1,0;17,0;;;;;;;;;;11,0;2,0;;;;;13,0;;4,0;5,0;;;1,0;;;3,0;;;;;;;;;1,0;;3,0;;2,0;2,0;;2,0;3,0;;;;;;;;10,0;1,0;;;1,0;;1,0;2,0;1,0;;1,0;;;;2,0;2,0;4,0;;;;2,0;;5,0;;2,0;;;;;15,0;2,0;;;;15,0;;;;;;3,0;1,0;1,0;6,0;;;;1,0;;4,0;1,0;;1,0;78,0;1,0;;;;;;7,0;;3,0;27,0;;9,0;;1,0;8,0;1,0;3,0;1,0;;3,0;;;6,0;;;1,0;;;;;;8,0;7,0;2,0;;;;8,0;5,0;;;;;;;1,0;1,0;;;;;;1,0;;;;;;;;1,0;;2,0;;1,0;;1,0;1,0;3,0;;;;;3,0;;;;;;;2,0;;;;1,0;1,0;;2,0;;;;9,0;;;;;;;2,0;;;;;;;;;;;;;;;2,0;2,0;;;;;;1,0;;7,0;1,0;;;;;;50,0;;;6,0;;;;;;;;1,0;;;;4,0;1,0;;43,0;;15,0;;;1,0;4,0;21,0;1,0;1,0;;;;;17,0;1,0;;;;;;;;;;;;;;;1,0;;1,0;;15,0;;;;;;;;;;;1,0;;;;;;;;;;;33,0;;;;;;;;;;;;;;1,0;;6,0;2,0;;;;3,0;;;6,0;;;1,0;2,0;;;;3,0;;;;;;13,0;;12,0;1,0;;;;;4,0;2,0;;11,0;;;;;;;;;;;;;;;;5,0;1,0;;;4,0;1,0;;;;;;;;;1,0;;;;;;;;;;;;;;;;7,0;;;;;;1,0;;31,0;;;1,0;;89,0;;26,0;17,0;;;1,0;;1,0;2,0;;;;;2,0;;1,0;;;;;;;;2,0;;;;;1,0;;;;;;;;4,0;2,0;;;;;;2,0;1,0;;1,0;1,0;4,0;;3,0;1,0;;3,0;;;;;;;;;;1,0;;4,0;;20,0;;;;;;;;;;;;;;6,0;;;;;;1,0;;;;;;;81,0;;18,0;4,0;;8,0;;;;;;;;;;;;;;;;;;;;;;2,0;2,0;3,0;;;;1,0;;;;;;;;;20,0;;;1,0;;;;;;;;;;2,0;;;1,0;;;;7,0;;;12,0;;;1,0;13,0;2,0;6,0;;;;;;;;;;;;;;6,0;;2,0;1,0;;9,0;;;1,0;;;;2,0;;;;2,0;;;;;;;;;;8,0;3,0;;10,0;;;;;1,0;;;3,0;;;1,0;;;;;;5,0;;;54,0;;3,0;;;;;;;;2,0;;;;2,0;;;;;;;;;;;;;;;;;;;3,0;;;
range;1,0;7,0;3,0;;1,0;89,0;47,0;53,0;97,0;16,0;40,0;;17,0;;24,0;107,0;24,0;22,0;30,0;2,0;30,0;104,0;6,0;;3,0;4,0;127,0;2,0;7,0;5,0;7,0;20,0;78,0;21,0;84,0;27,0;15,0;22,0;9,0;2,0;114,0;15,0;58,0;65,0;57,0;148,0;216,0;163,0;42,0;89,0;12,0;135,0;7,0;15,0;39,0;6,0;44,0;6,0;34,0;;59,0;;35,0;;54,0;57,0;168,0;38,0;85,0;15,0;40,0;25,0;94,0;1,0;2,0;24,0;18,0;6,0;17,0;610,0;4,0;99,0;1,0;181,0;21,0;13,0;21,0;1,0;;50,0;212,0;;;;47,0;33,0;10,0;;207,0;5,0;5,0;;82,0;136,0;;22,0;81,0;4,0;57,0;42,0;6,0;42,0;4,0;4,0;;84,0;47,0;201,0;4,0;194,0;;;9,0;70,0;21,0;13,0;2,0;17,0;57,0;;4,0;30,0;24,0;2,0;19,0;20,0;8,0;25,0;4,0;7,0;57,0;1,0;2,0;116,0;143,0;2,0;;2,0;139,0;67,0;51,0;;25,0;31,0;46,0;;135,0;;11,0;8,0;13,0;22,0;341,0;4,0;5,0;1,0;16,0;73,0;64,0;192,0;76,0;2,0;1,0;7,0;69,0;9,0;22,0;3,0;;4,0;2,0;25,0;;1,0;1,0;8,0;;52,0;;;4,0;2,0;3,0;8,0;;3,0;;2,0;;12,0;2,0;1,0;2,0;64,0;12,0;;6,0;20,0;13,0;29,0;4,0;2,0;2,0;13,0;;6,0;;;25,0;;5,0;;1,0;;;;9,0;2,0;193,0;;46,0;2,0;7,0;21,0;48,0;17,0;149,0;2,0;;7,0;12,0;4,0;2,0;15,0;6,0;1,0;10,0;1,0;112,0;37,0;9,0;;;2,0;2,0;22,0;21,0;25,0;2,0;1,0;;;;69,0;;;4,0;10,0;6,0;;;25,0;20,0;;8,0;;17,0;12,0;2,0;35,0;12,0;6,0;2,0;14,0;;87,0;4,0;10,0;10,0;5,0;26,0;4,0;46,0;;3,0;4,0;2,0;;;;9,0;22,0;3,0;;3,0;;2,0;9,0;1,0;9,0;;8,0;;20,0;28,0;19,0;;3,0;3,0;5,0;5,0;1,0;3,0;1,0;13,0;2,0;5,0;;10,0;;1,0;;;;;154,0;;3,0;3,0;;3,0;;;17,0;49,0;;;2,0;;9,0;;3,0;6,0;9,0;;1,0;;34,0;3,0;;;17,0;;8,0;;;14,0;1,0;;;10,0;;;8,0;22,0;;;1,0;26,0;22,0;;;1,0;4,0;1,0;5,0;;;5,0;6,0;;84,0;7,0;;;4,0;1,0;29,0;1,0;3,0;2,0;2,0;;20,0;3,0;;;58,0;11,0;65,0;105,0;70,0;13,0;6,0;8,0;7,0;;9,0;9,0;1,0;;;20,0;26,0;5,0;212,0;14,0;10,0;4,0;2,0;3,0;33,0;19,0;11,0;15,0;22,0;2,0;24,0;38,0;4,0;12,0;37,0;46,0;1,0;;18,0;39,0;2,0;;11,0;43,0;1,0;;10,0;17,0;25,0;;6,0;8,0;102,0;9,0;2,0;2,0;43,0;;4,0;;3,0;25,0;9,0;9,0;1,0;1,0;8,0;28,0;2,0;10,0;6,0;21,0;34,0;69,0;5,0;4,0;72,0;38,0;1,0;1,0;15,0;;2,0;;;7,0;17,0;14,0;;13,0;19,0;2,0;11,0;10,0;;;20,0;2,0;2,0;3,0;4,0;1,0;1,0;15,0;10,0;2,0;;7,0;;;;2,0;;3,0;;5,0;15,0;;2,0;28,0;;26,0;;;6,0;2,0;1,0;8,0;1,0;44,0;4,0;;9,0;;1,0;;9,0;;10,0;24,0;3,0;2,0;17,0;;;7,0;7,0;;4,0;;;4,0;4,0;3,0;1,0;7,0;9,0;;12,0;2,0;11,0;;51,0;12,0;;10,0;;2,0;4,0;;;;;;;;;33,0;2,0;;3,0;2,0;;;;;;1,0;;;;1,0;1,0;30,0;;;;2,0;11,0;1,0;;;;24,0;7,0;5,0;;;;3,0;;;2,0;1,0;;;3,0;6,0;;47,0;;;5,0;2,0;;;12,0;;;;1,0;;;6,0;3,0;;;1,0;;3,0;2,0;15,0;;4,0;14,0;;;14,0;;;1,0;2,0;;2,0;4,0;;3,0;44,0;8,0;;186,0;;1,0;8,0;;4,0;1,0;1,0;;;1,0;1,0;;;;7,0;;;6,0;1,0;;1,0;1,0;;;;;;2,0;;3,0;7,0;;;;14,0;7,0;2,0;5,0;;25,0;;;;;;11,0;;1,0;;2,0;;;;;;;6,0;;;11,0;;8,0;1,0;;4,0;;16,0;;6,0;;3,0;1,0;3,0;4,0;;3,0;;;;;;;;2,0;6,0;;;;;;5,0;;;;1,0;8,0;1,0;2,0;9,0;;;;;;4,0;;;;1,0;1,0;;40,0;;;3,0;5,0;;1,0;33,0;1,0;33,0;9,0;3,0;;2,0;;7,0;;;4,0;2,0;25,0;15,0;4,0;15,0;1,0;6,0;7,0;;11,0;13,0;14,0;49,0;19,0;;3,0;8,0;;7,0;3,0;;;12,0;8,0;23,0;;11,0;;;;;2,0;;19,0;;3,0;;2,0;3,0;;;;4,0;1,0;6,0;5,0;;;;;;;;;;;;;;24,0;12,0;21,0;1,0;;;;;2,0;8,0;;;;;5,0;1,0;;1,0;;1,0;;;;1,0;;2,0;8,0;1,0;;;8,0;;7,0;;5,0;4,0;;;;5,0;;58,0;1,0;3,0;;1,0;1,0;3,0;;;;;;;15,0;;;12,0;2,0;6,0;;1,0;;;;1,0;15,0;1,0;1,0;;;2,0;;15,0;1,0;;2,0;;;2,0;1,0;6,0;1,0;4,0;;;2,0;1,0;;;4,0;4,0;;;;;4,0;;;;;;4,0;2,0;32,0;;95,0;;;;;;;;;29,0;;4,0;6,0;4,0;10,0;2,0;2,0;;15,0;;7,0;;;;11,0;2,0;2,0;;;;;;;3,0;;;
reception;1,0;6,0;;;2,0;;;14,0;1,0;;;;1,0;;;2,0;;;;;2,0;8,0;;2,0;;;;;;;;13,0;7,0;;29,0;4,0;;;;;42,0;;3,0;1,0;1,0;1,0;9,0;8,0;;;;;;;23,0;;;;;;1,0;1,0;;;1,0;1,0;1,0;5,0;2,0;;2,0;;2,0;1,0;;3,0;;;;30,0;;;;18,0;2,0;7,0;8,0;;;3,0;49,0;;;;;;2,0;;3,0;5,0;;;5,0;;;;45,0;;;;;5,0;2,0;;1,0;1,0;;31,0;;13,0;2,0;;;17,0;;;;;;4,0;;;2,0;1,0;;6,0;;6,0;2,0;;;;1,0;5,0;1,0;;;;94,0;;2,0;;;4,0;;1,0;6,0;;;1,0;;2,0;172,0;;;;;;;;;;;4,0;;1,0;;;;;;21,0;;;;2,0;1,0;;;;;;;4,0;;1,0;;;;1,0;;;4,0;;;;4,0;;2,0;;;;;;;;10,0;;1,0;;;2,0;;;;;;1,0;20,0;;7,0;;;4,0;;;2,0;1,0;;;;1,0;;10,0;;;;;4,0;;;;;;;;135,0;;;;;;;;;;2,0;;;;;;1,0;;;;2,0;;;5,0;;;5,0;;;3,0;;;;;;;;;;;;;;;;;;;;;;;;;;;;;;;;6,0;;;;;;;1,0;;;;;;;;;;;11,0;;;;;;;;;;;;;;;;;;1,0;;;;1,0;;;;;;;;;;;;;;;;;;;;;;;;3,0;;;;1,0;;;;;;;;;;14,0;;1,0;;;;;1,0;;;;;;;;1,0;4,0;4,0;;;;;;;;;;;;;;;;;;;5,0;2,0;;2,0;;;;;1,0;;;;;;4,0;6,0;6,0;;6,0;;;;;;2,0;;;;6,0;;;;;;;1,0;;;;;;1,0;8,0;12,0;;;;12,0;;;;;;;;;;;;;;;;;;;;;;;;;2,0;12,0;;;;5,0;;;;;;;;;;;;;;;;;;;;;;;2,0;;;1,0;;14,0;;;;;;;;;11,0;;4,0;;;;;;;;;;;;;;;;37,0;;22,0;;18,0;;;;;;;;12,0;;;;;;;;;;;;;;;3,0;;2,0;1,0;;;;;;;1,0;;;2,0;;;;;30,0;;;;;;;;;;;;;;;;;;;;;13,0;;;;1,0;;;;;1,0;;;;;;;;;1,0;;;;48,0;;4,0;2,0;;;;;;;10,0;;;;;;;;;;1,0;;;;;;;;;;;;;;;;4,0;;;;;;;;;;;;;;;3,0;;;;;;;;;;;3,0;;;;;;;;;;;;;;;;;;;;;;;;;;;;;;;;;;;;;;;;;;;;;5,0;;;;;;;;;;;;;;2,0;;;;;;;;;;;;;;;;28,0;;;;;1,0;;;;;;1,0;;;;4,0;;;;;;;;;;;;;;;;;;;1,0;;1,0;;;;;;;2,0;;;;;;;;;;;;;;;;2,0;;;;;;;;;;;;;;;;;;;;;;;;;2,0;;;;;;;;;;;;;;;;;;;;;;;;;;;;;;;;;;;;;;;2,0;;;;;;6,0;;;;;;;;;;;1,0;;;;2,0;;;;;;;;;;;;;;1,0;;;;;;;;;3,0;;;;;16,0;;;;;;;;;;;;;;;;;;;;;;;;;;;;;;;;;;;;;;;
reference;1,0;4,0;5,0;;36,0;86,0;40,0;89,0;58,0;41,0;41,0;;56,0;11,0;41,0;182,0;76,0;11,0;40,0;23,0;63,0;110,0;18,0;;;2,0;135,0;3,0;;2,0;15,0;12,0;141,0;19,0;79,0;86,0;47,0;22,0;2,0;3,0;209,0;17,0;81,0;35,0;64,0;44,0;310,0;174,0;80,0;57,0;19,0;180,0;;10,0;33,0;95,0;75,0;6,0;76,0;;7,0;12,0;115,0;5,0;7,0;37,0;62,0;24,0;346,0;4,0;45,0;;318,0;64,0;3,0;12,0;43,0;30,0;45,0;1214,0;10,0;141,0;19,0;184,0;17,0;16,0;15,0;1,0;1,0;18,0;144,0;;3,0;;50,0;2,0;21,0;;270,0;24,0;111,0;55,0;88,0;351,0;;39,0;69,0;12,0;214,0;41,0;12,0;62,0;4,0;6,0;45,0;238,0;74,0;499,0;14,0;130,0;6,0;;36,0;58,0;32,0;6,0;8,0;4,0;17,0;30,0;;;58,0;2,0;24,0;28,0;50,0;15,0;27,0;4,0;63,0;;25,0;36,0;36,0;7,0;1,0;69,0;1125,0;49,0;32,0;;30,0;100,0;52,0;67,0;254,0;;29,0;10,0;25,0;39,0;204,0;11,0;9,0;;77,0;48,0;1,0;54,0;9,0;;;9,0;120,0;18,0;3,0;7,0;;;3,0;43,0;;;17,0;95,0;;34,0;;;;;;87,0;;9,0;;1,0;;9,0;;;86,0;119,0;30,0;;11,0;;24,0;8,0;1,0;1,0;1,0;23,0;2,0;;;;14,0;;11,0;12,0;;;4,0;;1,0;;156,0;1,0;13,0;3,0;;16,0;4,0;36,0;20,0;2,0;6,0;;7,0;2,0;2,0;31,0;57,0;;;6,0;155,0;155,0;10,0;1,0;4,0;;4,0;5,0;70,0;13,0;;;;;;55,0;;;10,0;;7,0;;;163,0;19,0;;27,0;;24,0;2,0;3,0;65,0;110,0;22,0;102,0;;;257,0;4,0;10,0;;;32,0;42,0;21,0;;;;8,0;;;;8,0;14,0;;4,0;2,0;;11,0;42,0;4,0;12,0;;10,0;;2,0;20,0;6,0;1,0;1,0;;4,0;;;2,0;2,0;27,0;;;;6,0;2,0;;;1,0;;;64,0;23,0;10,0;4,0;13,0;;;;1,0;41,0;;3,0;;19,0;135,0;;43,0;1,0;39,0;;;8,0;451,0;4,0;23,0;7,0;12,0;;5,0;;;131,0;;3,0;7,0;10,0;;;6,0;1,0;;2,0;;27,0;24,0;;;14,0;2,0;3,0;34,0;;;41,0;5,0;3,0;100,0;33,0;;1,0;7,0;;6,0;45,0;2,0;;2,0;;20,0;;1,0;3,0;2,0;42,0;50,0;40,0;82,0;208,0;8,0;42,0;7,0;1,0;4,0;4,0;4,0;5,0;3,0;14,0;25,0;6,0;3,0;7,0;115,0;9,0;24,0;1,0;165,0;108,0;;65,0;;52,0;51,0;32,0;;18,0;52,0;31,0;1,0;2,0;12,0;64,0;2,0;55,0;16,0;;2,0;8,0;22,0;17,0;43,0;3,0;;;17,0;26,0;;;;5,0;1,0;;1,0;17,0;20,0;8,0;10,0;6,0;16,0;36,0;3,0;86,0;1,0;521,0;5,0;74,0;65,0;8,0;19,0;190,0;59,0;;2,0;2,0;46,0;1,0;10,0;1,0;11,0;16,0;4,0;4,0;7,0;5,0;38,0;7,0;;4,0;19,0;99,0;6,0;8,0;;39,0;2,0;32,0;4,0;3,0;1,0;7,0;;;;;1,0;5,0;9,0;9,0;22,0;;8,0;;;;2,0;;95,0;3,0;3,0;30,0;;34,0;18,0;14,0;7,0;13,0;17,0;9,0;12,0;2,0;30,0;64,0;;4,0;5,0;2,0;;11,0;10,0;9,0;11,0;1,0;;2,0;;;8,0;2,0;15,0;1,0;;1,0;27,0;;3,0;27,0;12,0;4,0;;;2,0;;;2,0;;21,0;;;7,0;17,0;10,0;1,0;;2,0;1,0;3,0;3,0;;;2,0;;;;9,0;13,0;21,0;1,0;13,0;20,0;5,0;2,0;12,0;;;;;1,0;1,0;;;;1,0;3,0;2,0;;14,0;;;2,0;6,0;;157,0;5,0;;7,0;7,0;;10,0;;3,0;1,0;1,0;5,0;1,0;1,0;18,0;;11,0;9,0;;3,0;5,0;;91,0;;67,0;3,0;3,0;6,0;1,0;;43,0;13,0;;;20,0;77,0;;;15,0;;;11,0;;;2,0;;2,0;;;;3,0;7,0;;1,0;;;15,0;19,0;;75,0;2,0;4,0;4,0;3,0;1,0;64,0;;;;1,0;;157,0;8,0;12,0;;;3,0;1,0;;3,0;18,0;12,0;;;1,0;;;3,0;;;7,0;;;;18,0;;;;63,0;2,0;;21,0;7,0;32,0;8,0;10,0;14,0;2,0;3,0;;;;9,0;;2,0;;;6,0;1,0;;;12,0;;;;;2,0;1,0;;3,0;;;1,0;13,0;5,0;11,0;3,0;59,0;51,0;2,0;;12,0;;;;8,0;;54,0;;15,0;8,0;2,0;26,0;33,0;90,0;1,0;1,0;57,0;22,0;;17,0;;41,0;10,0;;6,0;34,0;10,0;3,0;4,0;;;3,0;2,0;16,0;3,0;21,0;3,0;1,0;1,0;2,0;;50,0;7,0;10,0;;;4,0;;;4,0;13,0;;10,0;;;7,0;;109,0;13,0;;5,0;15,0;1,0;65,0;19,0;;1,0;8,0;;;;;1,0;9,0;2,0;;;21,0;;;4,0;;17,0;;;20,0;;22,0;1,0;;1,0;20,0;3,0;;;3,0;;;25,0;9,0;1,0;;14,0;1,0;4,0;9,0;;;;;1,0;4,0;1,0;;;;1,0;;1,0;2,0;4,0;;2,0;;;;;6,0;;6,0;1,0;41,0;2,0;2,0;;3,0;1,0;16,0;;;;;;2,0;;1,0;;4,0;2,0;76,0;;5,0;3,0;3,0;;10,0;8,0;;7,0;;85,0;;5,0;5,0;;3,0;;74,0;;5,0;;;3,0;;;3,0;4,0;2,0;;20,0;;3,0;3,0;;1,0;;9,0;2,0;;1,0;14,0;;;60,0;;;4,0;9,0;3,0;8,0;;;13,0;;1,0;;;4,0;2,0;12,0;;;9,0;;67,0;;3,0;;7,0;;27,0;;;;;;2,0;;3,0;;;;
relative;2,0;13,0;17,0;;3,0;195,0;118,0;23,0;69,0;185,0;27,0;3,0;17,0;8,0;295,0;204,0;16,0;3,0;4,0;9,0;41,0;60,0;7,0;4,0;;2,0;12,0;3,0;3,0;6,0;8,0;4,0;59,0;;41,0;6,0;8,0;6,0;7,0;;54,0;1,0;27,0;57,0;48,0;11,0;168,0;182,0;11,0;94,0;36,0;58,0;3,0;5,0;40,0;9,0;91,0;1,0;26,0;;12,0;5,0;34,0;;10,0;12,0;33,0;7,0;132,0;22,0;6,0;3,0;40,0;2,0;4,0;19,0;15,0;6,0;8,0;553,0;17,0;51,0;1,0;53,0;3,0;6,0;;;12,0;21,0;463,0;;;3,0;14,0;3,0;2,0;;110,0;25,0;1,0;10,0;55,0;271,0;6,0;8,0;158,0;5,0;7,0;33,0;3,0;11,0;;;6,0;119,0;183,0;522,0;6,0;63,0;6,0;;6,0;14,0;27,0;1,0;;9,0;2,0;24,0;2,0;58,0;;;10,0;2,0;40,0;28,0;2,0;4,0;19,0;;1,0;164,0;2,0;3,0;;253,0;45,0;17,0;5,0;1,0;1,0;17,0;8,0;1,0;171,0;;64,0;1,0;9,0;;269,0;;21,0;;34,0;62,0;1,0;2,0;17,0;;1,0;32,0;43,0;8,0;105,0;76,0;2,0;;9,0;141,0;;1,0;;13,0;;29,0;1,0;;;;;20,0;1,0;23,0;6,0;;;18,0;6,0;;45,0;355,0;72,0;34,0;6,0;14,0;8,0;18,0;;5,0;14,0;;2,0;;7,0;;23,0;5,0;97,0;;22,0;5,0;3,0;4,0;1,0;;53,0;;360,0;;4,0;77,0;111,0;124,0;361,0;3,0;11,0;13,0;3,0;31,0;;16,0;26,0;;1,0;22,0;39,0;61,0;43,0;;;4,0;14,0;5,0;22,0;6,0;1,0;5,0;;;9,0;23,0;4,0;2,0;17,0;5,0;6,0;;41,0;26,0;20,0;2,0;;2,0;;38,0;9,0;131,0;;2,0;15,0;4,0;;67,0;;6,0;;2,0;78,0;21,0;20,0;;13,0;3,0;14,0;2,0;3,0;2,0;43,0;18,0;8,0;7,0;10,0;16,0;4,0;11,0;12,0;1,0;;13,0;;17,0;11,0;2,0;3,0;13,0;4,0;31,0;;;2,0;5,0;39,0;;9,0;;1,0;1,0;6,0;5,0;2,0;1,0;1,0;10,0;8,0;25,0;26,0;47,0;;3,0;;5,0;6,0;8,0;22,0;4,0;23,0;5,0;;19,0;1,0;22,0;11,0;30,0;48,0;127,0;41,0;3,0;5,0;2,0;3,0;1,0;3,0;;2,0;6,0;;1,0;34,0;1,0;;2,0;;6,0;13,0;61,0;99,0;98,0;10,0;2,0;;31,0;8,0;43,0;1,0;6,0;2,0;94,0;13,0;60,0;3,0;4,0;4,0;4,0;2,0;49,0;5,0;;;;;1,0;1,0;;5,0;8,0;2,0;51,0;59,0;3,0;11,0;2,0;36,0;19,0;;1,0;;;1,0;7,0;48,0;1,0;;;1,0;49,0;3,0;1,0;3,0;18,0;8,0;10,0;114,0;;3,0;14,0;1,0;1,0;14,0;109,0;111,0;;1,0;8,0;10,0;3,0;144,0;3,0;8,0;4,0;4,0;4,0;;5,0;2,0;2,0;6,0;;3,0;2,0;4,0;8,0;3,0;8,0;;6,0;16,0;15,0;5,0;1,0;1,0;7,0;53,0;3,0;45,0;12,0;;;49,0;21,0;2,0;37,0;69,0;;1,0;;2,0;5,0;;17,0;6,0;5,0;3,0;12,0;1,0;3,0;8,0;1,0;12,0;;1,0;8,0;6,0;8,0;10,0;5,0;3,0;;5,0;15,0;6,0;2,0;;;1,0;;3,0;;;;12,0;24,0;2,0;1,0;9,0;;1,0;1,0;;1,0;7,0;;;2,0;8,0;7,0;;25,0;;22,0;2,0;3,0;4,0;8,0;11,0;1,0;1,0;3,0;;;4,0;13,0;;12,0;;4,0;13,0;;;5,0;13,0;1,0;;3,0;;1,0;5,0;;;;6,0;4,0;1,0;9,0;;4,0;1,0;1,0;;1,0;;;13,0;;35,0;8,0;29,0;2,0;;;;1,0;1,0;;;2,0;6,0;6,0;28,0;1,0;3,0;;;2,0;;8,0;2,0;2,0;4,0;3,0;11,0;;;7,0;8,0;;1,0;3,0;;1,0;9,0;;1,0;;10,0;1,0;1,0;;;1,0;;2,0;;;;7,0;;2,0;5,0;;4,0;2,0;;2,0;17,0;13,0;7,0;2,0;17,0;4,0;1,0;;25,0;2,0;;3,0;;4,0;17,0;13,0;;;13,0;;;49,0;;70,0;6,0;5,0;1,0;2,0;;;2,0;7,0;2,0;14,0;7,0;6,0;29,0;2,0;;33,0;;2,0;2,0;;;52,0;6,0;;;16,0;5,0;1,0;2,0;1,0;;;4,0;1,0;2,0;12,0;4,0;9,0;;7,0;12,0;1,0;;22,0;;9,0;5,0;;18,0;;;11,0;1,0;;;7,0;;1,0;1,0;11,0;;;11,0;;1,0;;24,0;;2,0;4,0;1,0;1,0;5,0;7,0;3,0;2,0;1,0;22,0;14,0;2,0;;;;1,0;;17,0;;1,0;1,0;;;;;;1,0;4,0;;7,0;;;;;4,0;2,0;;3,0;1,0;;4,0;15,0;2,0;1,0;3,0;;1,0;1,0;1,0;2,0;3,0;5,0;2,0;13,0;;2,0;2,0;;;;14,0;3,0;7,0;6,0;;2,0;1,0;1,0;1,0;1,0;6,0;3,0;9,0;;;5,0;;;;2,0;;;9,0;;3,0;;1,0;;9,0;;;;10,0;8,0;9,0;2,0;13,0;9,0;1,0;;;;;;2,0;2,0;;;1,0;;;4,0;;;;2,0;1,0;9,0;;1,0;13,0;;1,0;13,0;;6,0;2,0;3,0;;9,0;;2,0;;;2,0;;5,0;8,0;;1,0;;4,0;21,0;10,0;;;7,0;;;7,0;;3,0;;;1,0;;2,0;;;;6,0;1,0;1,0;;4,0;1,0;7,0;1,0;2,0;4,0;;;;1,0;3,0;;3,0;5,0;9,0;;22,0;1,0;;;44,0;8,0;;2,0;15,0;3,0;;;6,0;;;1,0;3,0;;;2,0;;6,0;;16,0;;;9,0;4,0;;;;;1,0;17,0;1,0;;;30,0;3,0;;;3,0;;;1,0;2,0;5,0;1,0;;;1,0;5,0;;;;;;;;3,0;;3,0;2,0;38,0;;1,0;;;3,0;;;1,0;;;;;1,0;2,0;;;;
remove;2,0;;1,0;;;;1,0;11,0;8,0;6,0;;;5,0;;7,0;22,0;2,0;9,0;5,0;2,0;2,0;8,0;;4,0;1,0;;11,0;;;;1,0;3,0;13,0;1,0;14,0;;2,0;;;;16,0;1,0;;1,0;5,0;;6,0;15,0;5,0;5,0;3,0;3,0;7,0;;4,0;2,0;13,0;1,0;7,0;;3,0;2,0;4,0;;31,0;;3,0;12,0;12,0;11,0;1,0;;21,0;;2,0;3,0;1,0;;12,0;105,0;;8,0;;20,0;1,0;;22,0;;;;61,0;4,0;;7,0;1,0;;1,0;2,0;62,0;3,0;1,0;8,0;14,0;10,0;2,0;;38,0;8,0;;;;9,0;;;;3,0;38,0;8,0;6,0;;3,0;;2,0;18,0;6,0;;2,0;;;2,0;1,0;2,0;;;1,0;3,0;3,0;8,0;;;;1,0;;28,0;1,0;1,0;1,0;9,0;23,0;4,0;;;5,0;3,0;;2,0;16,0;;1,0;;;3,0;43,0;;;;11,0;5,0;1,0;1,0;1,0;;4,0;2,0;2,0;10,0;7,0;9,0;;;1,0;18,0;1,0;2,0;9,0;3,0;3,0;22,0;;;;2,0;;4,0;;;;;;2,0;;1,0;;1,0;;;;2,0;;1,0;19,0;;;;;3,0;;;;9,0;17,0;;;2,0;1,0;;16,0;;24,0;5,0;17,0;4,0;3,0;18,0;;1,0;2,0;10,0;2,0;1,0;2,0;3,0;3,0;24,0;;;2,0;;25,0;5,0;8,0;6,0;2,0;;;;;2,0;;;;;;2,0;9,0;1,0;1,0;6,0;;;;2,0;;;;;10,0;2,0;17,0;15,0;1,0;;1,0;;6,0;;;;;5,0;;2,0;1,0;6,0;6,0;;2,0;;3,0;;5,0;15,0;13,0;;2,0;;;1,0;3,0;;;7,0;3,0;;2,0;7,0;2,0;6,0;;2,0;1,0;;;2,0;10,0;;1,0;1,0;;;;5,0;;;;;;1,0;;;;;20,0;;;;;4,0;;9,0;;;;;;;2,0;9,0;;;;;8,0;1,0;;;;8,0;;9,0;;2,0;;;;;;;6,0;;;;15,0;;1,0;4,0;1,0;1,0;;7,0;2,0;2,0;;;1,0;;;;;1,0;;1,0;1,0;2,0;;;;;1,0;1,0;1,0;1,0;;1,0;;;;2,0;;;;;1,0;;;2,0;;21,0;;;;5,0;1,0;2,0;1,0;;2,0;4,0;6,0;;2,0;5,0;3,0;;;2,0;6,0;;6,0;;;;;1,0;;2,0;;;;;;2,0;;1,0;;;;2,0;2,0;5,0;3,0;;;1,0;2,0;1,0;;;6,0;;;;;;2,0;;6,0;;;1,0;;;;;;;;;;1,0;2,0;;1,0;5,0;9,0;;;;;1,0;;;;;;;10,0;;;;;1,0;3,0;;;;;;;;;;3,0;5,0;;1,0;1,0;4,0;;;2,0;;;;;3,0;;;;;;1,0;;;;;;5,0;1,0;;;2,0;1,0;1,0;;;;6,0;;;;;;5,0;;2,0;;;;;;;;;;;;;1,0;;;;;2,0;5,0;;;;;3,0;1,0;;3,0;;;;1,0;;2,0;;;;;;4,0;;;;;;1,0;;;;;;10,0;5,0;3,0;;2,0;;;;;;2,0;;;1,0;;;2,0;;;;;;6,0;2,0;;;;;1,0;;;;1,0;4,0;;;1,0;;2,0;;;3,0;;2,0;;2,0;;;;;;3,0;;1,0;2,0;1,0;4,0;;;;;3,0;;;;;;;;;;;;;3,0;;;;;;;1,0;;6,0;2,0;;;1,0;;3,0;;;;;;1,0;;18,0;1,0;5,0;1,0;;;;4,0;;;3,0;;;;3,0;;4,0;;1,0;;;;1,0;;;;;;;;10,0;;;;;1,0;;;3,0;;;;;;2,0;;;;;;5,0;;2,0;;;1,0;;;;;;1,0;1,0;;;;1,0;2,0;;;;;;1,0;;3,0;;5,0;;;;;4,0;;;;1,0;;28,0;;;;1,0;;;;;;1,0;;;;2,0;;;1,0;;;5,0;;5,0;;;;;;;;1,0;;;2,0;;;;;;;;;;;;1,0;;;;;2,0;;;1,0;3,0;;;;;;;;6,0;4,0;;;;;3,0;;;;;2,0;;;1,0;;;;2,0;;;;;;;4,0;;4,0;;;;;;;;;;;;;2,0;1,0;2,0;12,0;;;;;;;;;;;;;;;;;;;;;;;;;;;1,0;1,0;;;;;;;6,0;;;3,0;;;;;;;;1,0;;;;;;1,0;1,0;;7,0;;1,0;;;;;;;;;;;;;;;;;;1,0;;;;;;;;
represent;1,0;1,0;;;4,0;51,0;1,0;8,0;56,0;9,0;27,0;6,0;13,0;2,0;36,0;42,0;9,0;11,0;7,0;;8,0;82,0;2,0;;2,0;11,0;116,0;3,0;;5,0;9,0;33,0;15,0;5,0;18,0;2,0;7,0;16,0;4,0;14,0;382,0;;17,0;18,0;44,0;7,0;66,0;142,0;24,0;86,0;1,0;71,0;1,0;8,0;19,0;40,0;36,0;16,0;13,0;;15,0;11,0;34,0;5,0;20,0;72,0;36,0;28,0;110,0;3,0;26,0;1,0;70,0;;11,0;31,0;5,0;4,0;4,0;765,0;2,0;27,0;;63,0;;13,0;;2,0;3,0;67,0;119,0;;;15,0;9,0;13,0;15,0;;111,0;8,0;30,0;4,0;3,0;193,0;;;43,0;19,0;73,0;122,0;4,0;10,0;;;4,0;84,0;48,0;94,0;5,0;58,0;;;4,0;9,0;22,0;7,0;6,0;;3,0;19,0;;24,0;10,0;1,0;;13,0;29,0;3,0;26,0;47,0;115,0;;;35,0;2,0;;;14,0;69,0;25,0;11,0;3,0;5,0;35,0;70,0;8,0;54,0;2,0;12,0;;6,0;7,0;78,0;10,0;3,0;;65,0;54,0;3,0;47,0;11,0;;;37,0;10,0;;2,0;2,0;;4,0;;7,0;2,0;;;5,0;;34,0;;10,0;8,0;;;;2,0;;40,0;1,0;;3,0;1,0;;22,0;61,0;12,0;;;1,0;21,0;24,0;4,0;6,0;2,0;;;5,0;;;7,0;;;15,0;;;1,0;;;;143,0;;8,0;;;1,0;1,0;6,0;15,0;2,0;;6,0;;1,0;2,0;15,0;2,0;;;6,0;174,0;15,0;;1,0;;;;;77,0;8,0;;11,0;;;;37,0;2,0;5,0;5,0;;;;;6,0;11,0;;2,0;;2,0;27,0;;55,0;10,0;;2,0;6,0;1,0;34,0;4,0;7,0;;;27,0;15,0;5,0;;4,0;2,0;8,0;;;;;1,0;;;;;;11,0;;13,0;;;;13,0;;3,0;;2,0;;;;;8,0;4,0;2,0;;;;1,0;;;;;15,0;;15,0;1,0;3,0;;;;;;8,0;1,0;;6,0;3,0;;20,0;;;;;;;;78,0;8,0;8,0;;10,0;;;;;;;;;16,0;;;;1,0;;4,0;;;30,0;;;4,0;;;;;;3,0;4,0;5,0;44,0;5,0;1,0;;2,0;;16,0;12,0;;3,0;1,0;3,0;3,0;;12,0;11,0;9,0;;29,0;15,0;7,0;9,0;;16,0;;;;2,0;;1,0;1,0;1,0;;2,0;;;66,0;6,0;;;61,0;23,0;6,0;73,0;2,0;10,0;11,0;17,0;;11,0;113,0;9,0;;11,0;2,0;7,0;1,0;16,0;9,0;22,0;4,0;;4,0;;7,0;;1,0;1,0;1,0;9,0;;;15,0;1,0;;6,0;;7,0;16,0;13,0;;3,0;3,0;36,0;;81,0;13,0;1,0;;2,0;1,0;;19,0;59,0;;;15,0;1,0;9,0;;10,0;7,0;4,0;5,0;5,0;;27,0;9,0;6,0;2,0;3,0;;15,0;6,0;;8,0;5,0;3,0;;9,0;8,0;;;10,0;10,0;4,0;;;2,0;;;;2,0;15,0;1,0;9,0;;;1,0;;1,0;2,0;;1,0;;2,0;4,0;;6,0;;;;8,0;3,0;11,0;34,0;;;1,0;;;5,0;1,0;;1,0;;;;1,0;5,0;;1,0;13,0;6,0;5,0;;2,0;;4,0;16,0;3,0;;;;2,0;;;;;4,0;1,0;;;1,0;;;7,0;;;;1,0;;1,0;;;;8,0;3,0;;3,0;;1,0;3,0;;6,0;3,0;;;;1,0;18,0;;;2,0;;;7,0;;6,0;1,0;;;2,0;2,0;;49,0;31,0;5,0;;1,0;;;2,0;1,0;;;;;;;;8,0;1,0;1,0;7,0;1,0;;29,0;1,0;;1,0;;;;6,0;;;;;;;;3,0;;;;24,0;;;;;2,0;2,0;;1,0;;;;9,0;;2,0;4,0;;;19,0;2,0;;;;;15,0;1,0;;;;8,0;10,0;4,0;;;;;;;5,0;2,0;15,0;;;;;4,0;;;;;;;;;;;;;4,0;;1,0;;4,0;;;;;1,0;;1,0;;2,0;;3,0;;;1,0;;;;4,0;;2,0;;1,0;;;;;2,0;;6,0;1,0;;;;4,0;;;4,0;38,0;;;;7,0;9,0;2,0;;;2,0;;34,0;33,0;2,0;9,0;;;2,0;;6,0;1,0;8,0;21,0;7,0;2,0;;;4,0;;;;22,0;1,0;12,0;3,0;15,0;;;;5,0;;9,0;;7,0;8,0;3,0;6,0;20,0;;5,0;;;1,0;4,0;2,0;13,0;1,0;;4,0;;1,0;1,0;1,0;;16,0;19,0;2,0;3,0;4,0;;;;;;;;;;1,0;;;;;2,0;;8,0;1,0;1,0;;2,0;13,0;7,0;;;3,0;1,0;;1,0;3,0;4,0;4,0;;3,0;;4,0;3,0;;;;12,0;;;;;;;;3,0;;;4,0;;;;4,0;;;;;2,0;21,0;17,0;;1,0;;;1,0;6,0;;;;;;1,0;;;;;;3,0;1,0;3,0;6,0;2,0;;;;;2,0;;;3,0;4,0;4,0;13,0;1,0;2,0;;;4,0;;2,0;1,0;;4,0;;;4,0;;5,0;;;;;3,0;;1,0;;;;;;;6,0;;2,0;10,0;3,0;2,0;2,0;;;3,0;;;5,0;;24,0;5,0;;;;1,0;1,0;25,0;18,0;4,0;;1,0;;;;;;;;9,0;1,0;;;;;
resolution;2,0;;4,0;;7,0;3,0;;30,0;19,0;3,0;47,0;;21,0;4,0;;71,0;1,0;;3,0;;;120,0;21,0;;3,0;;39,0;;;2,0;3,0;;66,0;1,0;27,0;9,0;9,0;9,0;14,0;;271,0;4,0;;16,0;15,0;1,0;36,0;61,0;30,0;113,0;2,0;22,0;;1,0;;4,0;6,0;;18,0;;;;24,0;3,0;21,0;20,0;3,0;19,0;114,0;1,0;16,0;;87,0;22,0;1,0;3,0;6,0;;1,0;1156,0;15,0;42,0;;64,0;21,0;14,0;;2,0;;18,0;33,0;;;;4,0;10,0;20,0;;120,0;;10,0;4,0;21,0;17,0;;7,0;25,0;5,0;84,0;10,0;1,0;31,0;;;1,0;48,0;6,0;18,0;2,0;15,0;;;10,0;62,0;40,0;2,0;;;1,0;20,0;6,0;28,0;2,0;3,0;13,0;;3,0;18,0;19,0;2,0;10,0;;3,0;116,0;25,0;3,0;;;43,0;75,0;1,0;5,0;24,0;45,0;22,0;1,0;70,0;;;4,0;2,0;6,0;94,0;;2,0;;81,0;23,0;;13,0;32,0;;;;10,0;1,0;6,0;;;1,0;;3,0;;;2,0;5,0;;6,0;;;13,0;;;2,0;;;10,0;;;;;2,0;1,0;5,0;;;;2,0;21,0;4,0;;2,0;;1,0;;1,0;;;;;;4,0;;;;;;;10,0;;;;;1,0;;;1,0;;;;3,0;;2,0;5,0;11,0;;;4,0;116,0;10,0;;1,0;;;;;45,0;1,0;;;;;;46,0;;;;;3,0;;;;3,0;;;;2,0;;;8,0;;2,0;8,0;;2,0;41,0;4,0;1,0;;;1,0;;;;;;4,0;;;;;;;;;;;3,0;;;1,0;4,0;4,0;;;4,0;;6,0;;5,0;;;;;;2,0;;;11,0;;3,0;;;;;6,0;;;;;;;;7,0;7,0;;;;4,0;3,0;;;;2,0;;;;3,0;7,0;9,0;2,0;3,0;;;;;;;;;;;;;;;;;;;;;3,0;;;1,0;;;;1,0;;6,0;6,0;;;;;1,0;5,0;;;;5,0;7,0;;;;5,0;1,0;6,0;53,0;;4,0;1,0;5,0;4,0;1,0;;;;;2,0;22,0;;;20,0;13,0;12,0;2,0;;;11,0;19,0;6,0;4,0;1,0;3,0;2,0;69,0;1,0;2,0;33,0;1,0;;2,0;8,0;17,0;;1,0;2,0;2,0;1,0;;2,0;46,0;9,0;3,0;1,0;;;1,0;;;2,0;;;;;;1,0;;;;1,0;9,0;3,0;29,0;;;;14,0;;1,0;2,0;6,0;6,0;20,0;1,0;1,0;2,0;;1,0;;1,0;18,0;1,0;2,0;;3,0;;;;;1,0;51,0;;;;3,0;4,0;7,0;33,0;;;27,0;;1,0;;33,0;;2,0;5,0;;13,0;1,0;4,0;3,0;;;2,0;;1,0;6,0;2,0;;;3,0;7,0;;;1,0;;;6,0;10,0;8,0;3,0;3,0;;1,0;;;3,0;5,0;2,0;4,0;2,0;;;;;29,0;1,0;6,0;;7,0;2,0;3,0;;;6,0;1,0;;;8,0;11,0;;;;;;;;;2,0;;1,0;21,0;;;26,0;3,0;;;;;;;1,0;;;;1,0;;1,0;7,0;1,0;;;;;1,0;5,0;;;;;;;;1,0;1,0;;;;1,0;12,0;;;9,0;;;;;3,0;;1,0;;;3,0;;;1,0;;;1,0;;;5,0;;;1,0;;;1,0;;;7,0;;;;13,0;;1,0;42,0;;1,0;4,0;;;;;;;;;;;;;;;;;;39,0;;32,0;7,0;;;;;3,0;;;1,0;;63,0;;;;1,0;;;;1,0;1,0;;;;;;;;17,0;3,0;;;;;5,0;;;16,0;;;;;;;;;;;;;;;1,0;1,0;;;;;;;;;;;1,0;;;;;1,0;;;;;;;;;;;;;8,0;;;1,0;4,0;;;2,0;;8,0;20,0;;;;;;2,0;8,0;;8,0;6,0;3,0;1,0;;;2,0;;;9,0;5,0;1,0;1,0;8,0;4,0;;;;4,0;;4,0;;6,0;;;13,0;;;3,0;;1,0;3,0;2,0;1,0;3,0;;;;3,0;;;;;13,0;;7,0;5,0;1,0;;;;;;1,0;;;3,0;;;;;;3,0;;;;;;;1,0;9,0;1,0;;;4,0;;1,0;2,0;;;;1,0;15,0;;2,0;;;;;;;;;;;;1,0;3,0;;108,0;;;1,0;32,0;;;;;;;1,0;;12,0;;6,0;;;;;;;;;;;;;;;;;;;;;;;5,0;;;;;;;28,0;;1,0;;;;;;;;;;2,0;;;;2,0;;;4,0;;;;;;7,0;;;14,0;;;16,0;3,0;;3,0;8,0;;;;;;;;;7,0;;;;;;;;;;;;;;;;;2,0;1,0;;;;1,0;
respective;2,0;1,0;;1,0;6,0;27,0;15,0;32,0;59,0;66,0;33,0;2,0;56,0;1,0;58,0;97,0;3,0;2,0;;1,0;35,0;83,0;;33,0;8,0;16,0;89,0;3,0;;;2,0;3,0;49,0;2,0;49,0;9,0;7,0;;;5,0;110,0;4,0;16,0;24,0;44,0;22,0;156,0;89,0;26,0;43,0;41,0;55,0;2,0;54,0;8,0;38,0;59,0;7,0;14,0;;40,0;5,0;74,0;6,0;33,0;4,0;16,0;78,0;106,0;37,0;14,0;;48,0;;2,0;13,0;39,0;4,0;65,0;601,0;23,0;28,0;;124,0;5,0;4,0;1,0;;3,0;22,0;216,0;;;1,0;5,0;9,0;11,0;;114,0;6,0;10,0;5,0;61,0;83,0;;3,0;64,0;5,0;100,0;54,0;31,0;34,0;7,0;;18,0;316,0;187,0;153,0;16,0;39,0;;1,0;8,0;40,0;9,0;1,0;1,0;14,0;15,0;8,0;;50,0;40,0;3,0;29,0;3,0;;18,0;28,0;3,0;32,0;;3,0;72,0;16,0;1,0;;43,0;137,0;30,0;;1,0;13,0;37,0;;9,0;56,0;;5,0;51,0;6,0;12,0;164,0;17,0;40,0;;67,0;89,0;3,0;7,0;34,0;;3,0;19,0;28,0;23,0;15,0;10,0;;3,0;13,0;12,0;8,0;;17,0;64,0;1,0;24,0;;1,0;1,0;;3,0;56,0;6,0;13,0;16,0;;1,0;15,0;2,0;;28,0;60,0;7,0;17,0;10,0;;7,0;46,0;;7,0;;11,0;3,0;9,0;26,0;;3,0;28,0;10,0;7,0;20,0;2,0;1,0;;9,0;;118,0;;57,0;1,0;;26,0;6,0;12,0;11,0;8,0;11,0;7,0;19,0;;3,0;5,0;7,0;19,0;28,0;;414,0;23,0;14,0;10,0;8,0;4,0;1,0;3,0;92,0;;1,0;3,0;;2,0;7,0;55,0;4,0;3,0;12,0;1,0;3,0;;11,0;14,0;17,0;5,0;;5,0;1,0;3,0;18,0;102,0;26,0;1,0;17,0;3,0;;67,0;1,0;1,0;5,0;1,0;10,0;6,0;2,0;13,0;17,0;;33,0;;25,0;4,0;19,0;4,0;7,0;3,0;7,0;12,0;3,0;19,0;6,0;;4,0;1,0;12,0;1,0;4,0;9,0;4,0;13,0;2,0;27,0;5,0;;3,0;4,0;12,0;;26,0;;12,0;1,0;1,0;6,0;4,0;;;5,0;10,0;21,0;7,0;9,0;;;7,0;25,0;5,0;1,0;16,0;2,0;17,0;24,0;2,0;4,0;;1,0;;21,0;1,0;163,0;;4,0;;9,0;4,0;3,0;8,0;2,0;;1,0;12,0;;8,0;;;;;5,0;9,0;3,0;8,0;14,0;6,0;;23,0;7,0;4,0;14,0;11,0;3,0;2,0;49,0;;24,0;19,0;3,0;4,0;7,0;12,0;3,0;3,0;;3,0;10,0;1,0;2,0;5,0;;2,0;;15,0;34,0;7,0;21,0;8,0;;11,0;;;3,0;;2,0;9,0;7,0;10,0;5,0;5,0;;1,0;93,0;;11,0;;18,0;45,0;13,0;33,0;5,0;24,0;7,0;7,0;3,0;11,0;18,0;5,0;;5,0;3,0;8,0;2,0;14,0;7,0;4,0;;;34,0;1,0;16,0;12,0;4,0;2,0;6,0;9,0;2,0;;4,0;1,0;;3,0;;18,0;13,0;1,0;;2,0;41,0;10,0;;80,0;2,0;18,0;;18,0;18,0;7,0;16,0;46,0;31,0;2,0;1,0;4,0;11,0;5,0;2,0;2,0;3,0;4,0;;1,0;1,0;8,0;5,0;15,0;;1,0;5,0;3,0;;22,0;4,0;29,0;3,0;7,0;;;1,0;12,0;;;;2,0;;1,0;5,0;1,0;19,0;;9,0;;;7,0;1,0;1,0;11,0;1,0;9,0;1,0;3,0;12,0;16,0;2,0;30,0;12,0;31,0;;;;3,0;7,0;2,0;;2,0;;;;;6,0;10,0;;4,0;1,0;;;4,0;21,0;6,0;2,0;1,0;4,0;5,0;;1,0;14,0;2,0;2,0;;;3,0;1,0;1,0;;1,0;5,0;6,0;;1,0;8,0;9,0;;;4,0;;5,0;5,0;;;;;;7,0;31,0;;26,0;;4,0;8,0;10,0;15,0;4,0;7,0;2,0;13,0;;;2,0;;5,0;3,0;;2,0;;;5,0;;5,0;5,0;1,0;;153,0;2,0;;;;7,0;5,0;25,0;2,0;;10,0;21,0;;;11,0;1,0;5,0;5,0;2,0;5,0;1,0;1,0;14,0;1,0;;3,0;;3,0;3,0;;3,0;;1,0;;4,0;4,0;6,0;;27,0;14,0;1,0;17,0;;3,0;1,0;4,0;6,0;;;1,0;;;4,0;4,0;3,0;;19,0;;;22,0;;8,0;26,0;2,0;7,0;14,0;8,0;;;4,0;;3,0;15,0;3,0;1,0;1,0;24,0;4,0;3,0;2,0;2,0;1,0;;1,0;3,0;;4,0;8,0;;;1,0;3,0;2,0;;7,0;1,0;3,0;2,0;3,0;23,0;13,0;;3,0;7,0;;3,0;19,0;;5,0;5,0;;2,0;;2,0;9,0;;9,0;1,0;4,0;1,0;1,0;7,0;1,0;;;;;3,0;8,0;3,0;2,0;;10,0;10,0;5,0;3,0;7,0;11,0;9,0;;;27,0;;5,0;7,0;26,0;2,0;23,0;5,0;1,0;4,0;18,0;49,0;;10,0;7,0;2,0;6,0;1,0;2,0;16,0;;9,0;20,0;5,0;66,0;12,0;1,0;1,0;;;;18,0;1,0;8,0;;35,0;1,0;;11,0;;;1,0;;15,0;10,0;;2,0;1,0;3,0;10,0;4,0;4,0;;4,0;;9,0;11,0;9,0;2,0;4,0;3,0;;;;5,0;13,0;9,0;8,0;1,0;;;2,0;;1,0;;;;1,0;;;1,0;1,0;13,0;;;6,0;6,0;1,0;;;;17,0;;;25,0;2,0;;1,0;1,0;4,0;;;8,0;28,0;;;4,0;;;1,0;;;;;1,0;3,0;3,0;2,0;;;12,0;1,0;;;8,0;;1,0;1,0;2,0;10,0;1,0;1,0;4,0;4,0;1,0;;1,0;16,0;;5,0;2,0;2,0;2,0;;;1,0;;1,0;;11,0;2,0;4,0;4,0;12,0;2,0;7,0;2,0;2,0;1,0;8,0;35,0;1,0;;2,0;1,0;1,0;;3,0;;1,0;3,0;1,0;;;;;1,0;1,0;4,0;3,0;;6,0;3,0;4,0;2,0;;2,0;;6,0;2,0;;;17,0;2,0;;14,0;13,0;1,0;2,0;2,0;;;1,0;;;12,0;;1,0;4,0;;;1,0;;;4,0;1,0;;;6,0;;;;2,0;1,0;;;4,0;;;;2,0;14,0;3,0
response;6,0;;;43,0;9,0;23,0;13,0;73,0;29,0;3,0;7,0;;53,0;5,0;40,0;46,0;4,0;15,0;7,0;19,0;31,0;141,0;14,0;70,0;;;108,0;5,0;;10,0;26,0;28,0;73,0;3,0;248,0;39,0;;8,0;5,0;;220,0;6,0;18,0;12,0;293,0;90,0;164,0;239,0;33,0;226,0;2,0;23,0;7,0;;25,0;34,0;27,0;10,0;12,0;4,0;;49,0;13,0;8,0;128,0;4,0;18,0;8,0;57,0;1,0;69,0;1,0;149,0;14,0;4,0;16,0;16,0;17,0;18,0;518,0;7,0;49,0;1,0;79,0;17,0;143,0;21,0;1,0;;2,0;74,0;;2,0;;43,0;35,0;25,0;;120,0;21,0;21,0;9,0;40,0;79,0;;8,0;53,0;2,0;173,0;83,0;5,0;78,0;;;;65,0;36,0;83,0;100,0;58,0;2,0;;16,0;18,0;59,0;17,0;2,0;;14,0;25,0;6,0;15,0;28,0;8,0;3,0;18,0;18,0;;3,0;1,0;53,0;;22,0;132,0;65,0;;;;514,0;14,0;;;23,0;30,0;14,0;3,0;151,0;;13,0;18,0;7,0;90,0;101,0;;4,0;;72,0;30,0;4,0;13,0;25,0;;;;11,0;21,0;6,0;1,0;3,0;;4,0;148,0;;;24,0;29,0;2,0;10,0;;;;1,0;;16,0;;;8,0;;;4,0;;;3,0;69,0;25,0;;4,0;8,0;45,0;5,0;2,0;6,0;11,0;2,0;;;;;;8,0;1,0;13,0;;;;;8,0;6,0;83,0;1,0;24,0;;5,0;6,0;5,0;25,0;41,0;1,0;;;;5,0;1,0;6,0;12,0;;;12,0;44,0;5,0;3,0;7,0;;2,0;1,0;32,0;270,0;4,0;;;;;;98,0;3,0;9,0;5,0;;51,0;;8,0;18,0;;;3,0;2,0;74,0;3,0;;13,0;21,0;19,0;5,0;;;81,0;;35,0;12,0;6,0;23,0;19,0;7,0;;;;;;1,0;;9,0;3,0;;;;;3,0;5,0;1,0;3,0;;;;;2,0;9,0;;5,0;;1,0;2,0;1,0;2,0;;14,0;;;1,0;4,0;6,0;;;;;;40,0;;3,0;9,0;1,0;;2,0;;2,0;7,0;1,0;19,0;8,0;;29,0;;3,0;;;;;;39,0;10,0;20,0;;8,0;;;;;;;;3,0;4,0;4,0;;2,0;4,0;;;4,0;18,0;18,0;;;4,0;;1,0;1,0;;;;11,0;;47,0;54,0;4,0;;24,0;;1,0;11,0;17,0;34,0;12,0;37,0;33,0;;;;5,0;2,0;22,0;105,0;21,0;6,0;;41,0;;;;1,0;24,0;4,0;9,0;20,0;70,0;;4,0;9,0;25,0;;21,0;2,0;146,0;41,0;12,0;20,0;;28,0;38,0;114,0;1,0;17,0;15,0;38,0;;15,0;26,0;164,0;11,0;7,0;8,0;8,0;;;50,0;14,0;54,0;33,0;3,0;;2,0;16,0;;4,0;5,0;2,0;;13,0;10,0;16,0;8,0;;;49,0;12,0;227,0;;4,0;12,0;23,0;;44,0;;7,0;9,0;18,0;10,0;;4,0;1,0;19,0;;1,0;75,0;34,0;7,0;2,0;11,0;16,0;47,0;1,0;25,0;;5,0;14,0;20,0;1,0;3,0;;23,0;2,0;2,0;39,0;;4,0;7,0;35,0;2,0;2,0;;3,0;;50,0;1,0;17,0;2,0;;7,0;4,0;;21,0;21,0;4,0;9,0;;8,0;2,0;30,0;21,0;15,0;9,0;2,0;16,0;4,0;2,0;18,0;21,0;11,0;80,0;;79,0;3,0;;;22,0;8,0;;;;;21,0;3,0;1,0;5,0;4,0;;88,0;3,0;30,0;5,0;8,0;4,0;5,0;1,0;;;4,0;;1,0;1,0;4,0;;;3,0;1,0;22,0;8,0;;9,0;;2,0;28,0;14,0;8,0;;;3,0;;13,0;9,0;;;1,0;8,0;118,0;;1,0;10,0;;;;2,0;2,0;;;;;;1,0;1,0;;;2,0;;3,0;9,0;4,0;30,0;;1,0;;16,0;;;4,0;23,0;3,0;6,0;;2,0;5,0;5,0;3,0;8,0;3,0;11,0;16,0;;1,0;24,0;8,0;;35,0;2,0;;1,0;2,0;;1,0;;;;13,0;1,0;;7,0;;;2,0;;3,0;20,0;;13,0;;;1,0;;1,0;;6,0;;;2,0;6,0;;5,0;5,0;3,0;12,0;;3,0;8,0;;;13,0;;30,0;11,0;1,0;;1,0;1,0;4,0;5,0;;3,0;3,0;3,0;10,0;;;;5,0;5,0;;;;;;1,0;;;;;6,0;7,0;;;2,0;31,0;1,0;1,0;;;10,0;;3,0;2,0;2,0;4,0;10,0;;;3,0;;;1,0;1,0;2,0;3,0;1,0;;;1,0;;7,0;2,0;;6,0;4,0;16,0;1,0;;2,0;;2,0;9,0;2,0;;;6,0;7,0;5,0;4,0;6,0;6,0;;;;3,0;7,0;6,0;;;3,0;1,0;6,0;;2,0;18,0;;;1,0;3,0;;;;;5,0;2,0;;3,0;1,0;4,0;1,0;;;;;;5,0;6,0;;3,0;;1,0;1,0;1,0;;3,0;2,0;;;2,0;55,0;;;18,0;1,0;;2,0;11,0;;;14,0;;1,0;;;;;;2,0;;18,0;19,0;9,0;2,0;;3,0;7,0;9,0;9,0;7,0;5,0;3,0;2,0;;12,0;;2,0;;;9,0;;1,0;;;;;;1,0;1,0;5,0;2,0;;10,0;;;4,0;4,0;17,0;2,0;17,0;1,0;1,0;1,0;18,0;;;1,0;51,0;17,0;1,0;;3,0;;;4,0;3,0;2,0;4,0;3,0;4,0;1,0;;;;1,0;;;1,0;;;6,0;;;2,0;3,0;1,0;2,0;;;;;15,0;;;;;;;1,0;3,0;3,0;;;;;;1,0;;;;;;3,0;;;;1,0;4,0;;;;;;;;;1,0;;;163,0;6,0;;2,0;5,0;;4,0;;;;;;;;2,0;;4,0;8,0;4,0;3,0;;;;;2,0;10,0;;1,0;;1,0;;;;;;3,0;
sample;2,0;;;;2,0;22,0;;34,0;83,0;7,0;11,0;;17,0;2,0;4,0;73,0;11,0;;;;2,0;30,0;;;;2,0;22,0;1,0;;;7,0;;47,0;3,0;67,0;8,0;12,0;25,0;14,0;;80,0;1,0;15,0;45,0;62,0;26,0;56,0;29,0;58,0;8,0;;60,0;;8,0;2,0;8,0;8,0;;7,0;;;5,0;6,0;7,0;25,0;7,0;8,0;3,0;34,0;;18,0;;85,0;;;6,0;1,0;1,0;;344,0;2,0;12,0;;51,0;3,0;13,0;1,0;;;11,0;23,0;;;;3,0;3,0;28,0;;77,0;6,0;7,0;;10,0;22,0;5,0;5,0;34,0;4,0;45,0;10,0;3,0;104,0;;;3,0;70,0;29,0;27,0;;25,0;;;31,0;51,0;18,0;;;4,0;12,0;4,0;2,0;27,0;2,0;;26,0;19,0;28,0;3,0;;;48,0;;;15,0;21,0;;;1,0;142,0;20,0;;;12,0;33,0;13,0;22,0;30,0;;5,0;6,0;8,0;6,0;117,0;;7,0;;43,0;11,0;1,0;;;;;5,0;23,0;4,0;;;;2,0;;;;;;26,0;;15,0;;;51,0;2,0;;18,0;;;;;;15,0;;;9,0;2,0;2,0;;;;7,0;6,0;;;;5,0;;6,0;;;;4,0;;2,0;;;;;;;27,0;;;1,0;;2,0;;;;;;;3,0;;7,0;5,0;11,0;;1,0;;130,0;14,0;;;;;;3,0;19,0;7,0;;;;;;35,0;3,0;2,0;1,0;;4,0;;;11,0;3,0;;1,0;;;2,0;1,0;33,0;26,0;;10,0;;6,0;91,0;5,0;;;;13,0;6,0;;;1,0;;18,0;;;;;;;;;;41,0;4,0;;1,0;2,0;;25,0;;4,0;6,0;;;;;;;;;13,0;;;;4,0;;;;;;;26,0;;;26,0;;;;;6,0;;;;;1,0;1,0;;;;;;;;67,0;;42,0;;;;;;;;;;1,0;;;;5,0;;1,0;;;4,0;2,0;;;;;;2,0;;;11,0;;;38,0;;3,0;;3,0;;;;1,0;1,0;;;14,0;;;6,0;4,0;8,0;21,0;5,0;1,0;14,0;;4,0;;;1,0;;19,0;9,0;4,0;19,0;;;;11,0;13,0;2,0;;1,0;59,0;9,0;;95,0;;10,0;;23,0;;1,0;22,0;;;;;38,0;12,0;;62,0;;;;;40,0;3,0;;2,0;;7,0;;3,0;2,0;2,0;;;;;6,0;8,0;;;;22,0;3,0;1,0;38,0;4,0;127,0;;4,0;5,0;1,0;6,0;15,0;11,0;;5,0;;10,0;;3,0;;1,0;18,0;;;;;1,0;;;;8,0;5,0;;12,0;6,0;19,0;;18,0;;;;6,0;;;;;;;;;16,0;;;3,0;;;18,0;;;1,0;;;;3,0;4,0;;6,0;;;;1,0;17,0;;1,0;;;4,0;1,0;;;1,0;;;;;;;;15,0;;5,0;;1,0;;1,0;;;3,0;;1,0;;;2,0;;;2,0;;20,0;;;;;3,0;;17,0;;;;3,0;3,0;;;;;;;4,0;;;;;;2,0;2,0;;;;;2,0;;;1,0;;;;;;10,0;1,0;;4,0;;;7,0;;;;7,0;;;4,0;;1,0;;;;;65,0;;;;;;1,0;;;;;;;;;;;3,0;;;;4,0;;;1,0;;;3,0;;;2,0;;;;;;;2,0;;;;;;;;25,0;4,0;1,0;3,0;2,0;;;;;;;;;;;;;1,0;1,0;;;;;;;;;1,0;;;;;;;;5,0;;;;2,0;;;7,0;;3,0;;8,0;3,0;1,0;2,0;11,0;;3,0;;3,0;2,0;;;3,0;;;;;;;;;;;;;;;;;;13,0;;14,0;1,0;;;1,0;;;;;11,0;6,0;;;2,0;6,0;;11,0;5,0;7,0;;3,0;4,0;8,0;;;;;;;6,0;8,0;;;;;8,0;;22,0;;1,0;12,0;;;;;26,0;;2,0;21,0;;4,0;;;11,0;;;6,0;;2,0;;3,0;;4,0;;10,0;;;;12,0;3,0;;;;;;;;;1,0;;;;;;7,0;;2,0;5,0;;4,0;;1,0;;;;1,0;;;2,0;;;;2,0;;;;;;;;;;;;;;;;;;;15,0;;;11,0;;;1,0;18,0;;;;;;;;9,0;2,0;;1,0;;;;;;;;;;;;15,0;;9,0;3,0;;;;;4,0;1,0;;1,0;;7,0;;;17,0;;3,0;;;;;;;;;;;;;;1,0;;;;;2,0;;;;;12,0;3,0;;2,0;;;;2,0;4,0;2,0;;;;;;;3,0;;4,0;;;;;3,0;;29,0;;;;;;;;;4,0;;;6,0;2,0;2,0;;1,0;1,0;
satisfy;4,0;;58,0;;;16,0;2,0;11,0;5,0;4,0;;5,0;3,0;;61,0;29,0;4,0;4,0;4,0;;;3,0;2,0;;;3,0;2,0;;;;1,0;1018,0;11,0;;13,0;2,0;;1,0;;45,0;17,0;3,0;12,0;;11,0;6,0;15,0;24,0;3,0;2,0;1,0;20,0;8,0;;26,0;3,0;70,0;;;;;;2,0;;5,0;340,0;32,0;8,0;9,0;;3,0;;2,0;;;32,0;4,0;;;85,0;;73,0;;19,0;;23,0;8,0;4,0;24,0;255,0;868,0;;;11,0;;;;;13,0;;;;34,0;46,0;;;160,0;4,0;3,0;1,0;;4,0;;;1,0;11,0;3,0;11,0;80,0;74,0;;;3,0;3,0;;;2,0;;;7,0;;4,0;4,0;;47,0;2,0;3,0;1,0;;;;;2,0;20,0;4,0;;;65,0;10,0;2,0;12,0;;;5,0;3,0;;578,0;14,0;;2,0;1,0;3,0;59,0;3,0;6,0;;5,0;5,0;;;335,0;;;2,0;32,0;;;5,0;;;1,0;;;;;;;18,0;1,0;2,0;2,0;4,0;;;5,0;;3,0;;;;;;1,0;6,0;;;;;2,0;10,0;2,0;;;;;;;;4,0;;;4,0;1,0;;;;;;4,0;;1,0;;;;;9,0;18,0;;;;;;;;;;;2,0;4,0;;;;;;;;4,0;1,0;;101,0;;;;12,0;;2,0;5,0;;;1,0;;;8,0;1,0;;;;;1,0;27,0;;;;38,0;;66,0;4,0;;;;7,0;;;;;;;;;;;;;49,0;;;;1,0;;3,0;;2,0;;;2,0;1,0;;;4,0;;;;5,0;;12,0;;;;;;;;;;;2,0;;;;1,0;;1,0;;;45,0;;6,0;;;4,0;;;;3,0;;;;3,0;;;;;;;;;;;;;29,0;;;2,0;;;;;;;;;;;;2,0;;;;1,0;;2,0;;;;;;1,0;;;;;;1,0;;;;;;;43,0;;3,0;103,0;1,0;4,0;1,0;;;;;1,0;2,0;6,0;;;;10,0;;;;2,0;;;;;1,0;;9,0;;;;7,0;;7,0;;5,0;;;3,0;;4,0;1,0;;1,0;1,0;;1,0;;;2,0;;;;;;;1,0;26,0;3,0;;;1,0;1,0;3,0;;;1,0;;;9,0;;;13,0;1,0;;;;;;;;2,0;5,0;;;;2,0;;;1,0;;;1,0;;;9,0;;;;;;;2,0;2,0;;;;;;;;;1,0;;;;;;;;;;;;;16,0;;;30,0;;;;10,0;3,0;;4,0;4,0;;1,0;;;;;;1,0;;;;;;;;1,0;;;;;;;;;;;;;;;;;;;;;;;;;;;;;;;;;;;;;;;;;;;;;;;;1,0;3,0;;;10,0;;;;;;;;3,0;;1,0;2,0;;;2,0;;;;;;;;;;;1,0;;;;;;;;;;6,0;;;1,0;;6,0;;;;;;;3,0;2,0;;3,0;;1,0;;;;;;;;;;;;;;;;;;;;;;;;;;;;;;;;;;;;;;;;;;;;;;;;;;;;;;;;2,0;;;;;;;;;;;;;;;;;4,0;;;8,0;;;;;;;;;;;;;;;;;;;;;;;3,0;;;;;;12,0;;;;;;;24,0;2,0;;;;;6,0;2,0;;2,0;4,0;;;;;;;;;;1,0;24,0;;;;;;;;;;30,0;;229,0;3,0;57,0;;;4,0;;;1,0;;4,0;;3,0;;;;;;;1,0;;;;;;;;;;;;;;;;;129,0;;31,0;;;;;;;;;;;;;;;;1,0;;;;;;;;;;;;;;;;;;;;;;;;;;;;;;;;;;;;;1,0;;;;;;;;;;;;;2,0;;5,0;;;;;;;2,0;;;;32,0;;115,0;;;;;;;;;;;;;1,0;;;;;;;;;;;;17,0;;9,0;1,0;;;;;;;;;;;;;;;15,0;;;;;;;;;4,0;;;;;6,0;;;;;5,0;;;;;;
scene;4,0;;1,0;2,0;47,0;24,0;15,0;26,0;128,0;8,0;19,0;;83,0;17,0;8,0;161,0;4,0;24,0;28,0;5,0;11,0;702,0;5,0;;6,0;;35,0;4,0;2,0;2,0;36,0;52,0;73,0;14,0;68,0;21,0;21,0;5,0;29,0;;200,0;;45,0;104,0;183,0;55,0;266,0;205,0;178,0;156,0;1,0;113,0;;7,0;1,0;2,0;31,0;8,0;16,0;5,0;11,0;8,0;96,0;9,0;17,0;36,0;91,0;70,0;140,0;22,0;26,0;;163,0;3,0;5,0;12,0;81,0;104,0;46,0;1710,0;35,0;153,0;6,0;170,0;5,0;50,0;;7,0;4,0;38,0;143,0;8,0;1,0;;9,0;21,0;22,0;;284,0;22,0;46,0;9,0;40,0;402,0;26,0;15,0;80,0;20,0;95,0;44,0;16,0;49,0;1,0;;;190,0;259,0;91,0;7,0;65,0;;;27,0;47,0;46,0;50,0;1,0;4,0;68,0;57,0;;63,0;19,0;;115,0;10,0;32,0;53,0;48,0;;;;8,0;145,0;41,0;16,0;;13,0;56,0;4,0;25,0;3,0;28,0;19,0;53,0;;146,0;;;7,0;31,0;7,0;45,0;7,0;15,0;;136,0;268,0;23,0;;36,0;;;5,0;10,0;11,0;6,0;;;;;;;;1,0;8,0;;17,0;5,0;;2,0;3,0;1,0;1,0;;6,0;6,0;;;5,0;;;14,0;30,0;2,0;;;19,0;76,0;8,0;1,0;15,0;;;;;;;7,0;;9,0;16,0;;;;1,0;;;227,0;;;;5,0;;4,0;3,0;26,0;3,0;1,0;;10,0;;9,0;25,0;12,0;;;20,0;170,0;76,0;;;2,0;;;32,0;106,0;60,0;3,0;;;;;56,0;2,0;;3,0;;6,0;;;48,0;13,0;;2,0;;2,0;9,0;;103,0;10,0;1,0;;;;59,0;7,0;5,0;6,0;;36,0;3,0;;;;;1,0;1,0;;;;5,0;;;5,0;;;2,0;6,0;3,0;;;1,0;;3,0;34,0;;;;3,0;;;3,0;;;3,0;;;;11,0;3,0;;;;;2,0;20,0;33,0;4,0;2,0;;;4,0;7,0;5,0;5,0;;1,0;2,0;4,0;;;19,0;;;;;158,0;17,0;2,0;;40,0;2,0;;;;;;;3,0;2,0;;;29,0;;;;;4,0;7,0;;;9,0;;;23,0;;;;6,0;20,0;241,0;26,0;3,0;;;1,0;29,0;2,0;1,0;;;4,0;10,0;2,0;;;10,0;3,0;42,0;267,0;4,0;8,0;11,0;18,0;2,0;1,0;2,0;2,0;;;12,0;27,0;41,0;12,0;18,0;8,0;80,0;5,0;18,0;;63,0;38,0;2,0;86,0;1,0;43,0;6,0;102,0;19,0;70,0;103,0;43,0;;17,0;20,0;16,0;7,0;15,0;3,0;60,0;2,0;;7,0;7,0;106,0;;63,0;;24,0;49,0;1,0;;4,0;;1,0;;1,0;9,0;16,0;3,0;8,0;;5,0;87,0;2,0;23,0;4,0;;;6,0;2,0;20,0;29,0;19,0;3,0;1,0;3,0;12,0;27,0;;23,0;30,0;12,0;7,0;11,0;16,0;9,0;17,0;;6,0;;;76,0;29,0;4,0;5,0;;1,0;1,0;18,0;15,0;3,0;;10,0;2,0;3,0;;6,0;;11,0;5,0;;6,0;;2,0;8,0;;;8,0;;2,0;3,0;4,0;16,0;;22,0;3,0;9,0;6,0;7,0;;;1,0;17,0;67,0;9,0;4,0;;9,0;;;41,0;27,0;;5,0;;;;2,0;;4,0;;13,0;;5,0;6,0;8,0;2,0;1,0;4,0;3,0;8,0;;;6,0;;;;4,0;15,0;7,0;1,0;2,0;37,0;1,0;;;;1,0;14,0;;;2,0;;1,0;;7,0;7,0;;42,0;;9,0;27,0;11,0;12,0;4,0;;;2,0;4,0;27,0;;;2,0;;;;4,0;14,0;2,0;9,0;;23,0;13,0;1,0;128,0;7,0;;1,0;;;;151,0;1,0;;1,0;;;;25,0;16,0;10,0;;20,0;2,0;2,0;;125,0;;;7,0;;;2,0;;6,0;;;;;;;2,0;1,0;;;6,0;;;;;;1,0;;;;;;;;2,0;3,0;;;2,0;5,0;;;;;34,0;;;16,0;3,0;2,0;;;;;;;13,0;;;13,0;101,0;;;1,0;;5,0;;;;;2,0;;;;;;;3,0;;;4,0;2,0;6,0;8,0;;;;8,0;8,0;;11,0;;;4,0;;3,0;1,0;;;1,0;;;;;;;;;3,0;;;12,0;;;;;;;4,0;2,0;;;;1,0;;22,0;44,0;;;2,0;;7,0;8,0;;20,0;3,0;16,0;1,0;11,0;36,0;1,0;1,0;29,0;18,0;3,0;;2,0;7,0;;;;3,0;8,0;13,0;8,0;;1,0;8,0;3,0;;;14,0;2,0;16,0;12,0;;21,0;9,0;;22,0;;5,0;2,0;17,0;3,0;3,0;7,0;7,0;;;1,0;2,0;;5,0;8,0;14,0;10,0;2,0;9,0;;;;1,0;6,0;6,0;;2,0;8,0;4,0;;3,0;;;6,0;;10,0;;3,0;2,0;;3,0;63,0;3,0;1,0;3,0;1,0;;;12,0;;6,0;5,0;;2,0;6,0;1,0;;1,0;;23,0;;;;;;5,0;;;5,0;;18,0;;5,0;;22,0;;;;;4,0;1,0;22,0;;13,0;41,0;3,0;3,0;13,0;;;;2,0;;;1,0;;;5,0;18,0;1,0;6,0;1,0;1,0;;;2,0;2,0;;1,0;;;;;;;;1,0;1,0;;;;;;;8,0;;4,0;2,0;;6,0;;;;;3,0;;2,0;5,0;;;2,0;;16,0;12,0;;;2,0;6,0;5,0;;;;6,0;;;22,0;;;17,0;;7,0;;;2,0;31,0;1,0;12,0;;9,0;;1,0;;;1,0;;;2,0;;;;;;
security;5,0;;;8,0;4,0;;2,0;3,0;;;;;3,0;;;8,0;;;;;;1,0;;3,0;;;10,0;5,0;;;;1,0;11,0;1,0;7,0;20,0;;;;;6,0;;1,0;;7,0;;25,0;44,0;2,0;39,0;1,0;1,0;;;;1,0;7,0;;;;4,0;10,0;1,0;;;;;;7,0;11,0;2,0;;27,0;;;1,0;3,0;;3,0;20,0;;8,0;;12,0;;3,0;;;;;1,0;;;;;1,0;3,0;1,0;31,0;;;;;2,0;;5,0;1,0;7,0;7,0;;;;;;;2,0;11,0;4,0;6,0;1,0;2,0;;1,0;5,0;2,0;;;;;1,0;;;;1,0;;;;;;;;;6,0;11,0;;;;;3,0;;;;7,0;3,0;;1,0;162,0;;2,0;;2,0;3,0;4,0;;;;22,0;4,0;1,0;;2,0;;;;;3,0;35,0;;;;1,0;;;;1,0;;;2,0;;;;;;2,0;;2,0;4,0;;;2,0;;;;1,0;;;;1,0;;1,0;;;;;;;6,0;;;2,0;15,0;;;;;;;;4,0;;;;;40,0;;;;3,0;;4,0;;;;;;;;;;;16,0;;;2,0;;;4,0;;;;;;8,0;1,0;;;;;;;1,0;;1,0;;;;;15,0;;;7,0;;;;;1,0;;;;2,0;3,0;;;;;1,0;;;1,0;;2,0;1,0;2,0;;;;;2,0;3,0;2,0;;;1,0;;;;;1,0;;1,0;;;;;2,0;;;1,0;1,0;;;6,0;;;;2,0;;3,0;;1,0;;5,0;2,0;;;;4,0;;;;;;;;;;;;;;;;;;1,0;;;;1,0;;;;;;3,0;;;;;;1,0;1,0;;;;;;;;3,0;;;;1,0;;;;;3,0;;;;4,0;1,0;;;;;;10,0;;4,0;3,0;;;;;1,0;;;;;4,0;;;;;2,0;;;;1,0;11,0;;;;;;1,0;;1,0;2,0;1,0;;5,0;1,0;7,0;;3,0;;;;;1,0;;1,0;2,0;1,0;;;;;;;;;3,0;;5,0;3,0;;;1,0;;16,0;;;;1,0;;;;;;4,0;;;;;;3,0;;1,0;;;;;3,0;1,0;;4,0;;3,0;;;;;;;;;1,0;;2,0;;;;;;;1,0;2,0;7,0;;;;;;;;;5,0;5,0;15,0;;3,0;1,0;;;;;;;;;;;11,0;;;;;5,0;1,0;;6,0;;3,0;5,0;;;;;;;5,0;6,0;11,0;3,0;;;1,0;1,0;3,0;;1,0;;19,0;;2,0;1,0;;;;;;3,0;;;;2,0;;;;;2,0;;2,0;;;2,0;;;;;1,0;;;;;;;3,0;;2,0;;;;1,0;1,0;;;;;;1,0;2,0;;;;;;15,0;;1,0;;;;;;;;11,0;;;;;;50,0;;;22,0;;;;;;;1,0;;;;;;;;;;;;;;;2,0;;;;;1,0;;1,0;;;;;;;;;;;;;;1,0;;;;;;;;;1,0;;;;;;;12,0;;;;;;;;;;;;;;;;;;;1,0;;;;;2,0;;;1,0;;;2,0;;;;;;;;;;5,0;;;;;;2,0;;15,0;;;;;6,0;;;;;;;;;16,0;;;;;;;;;;;;;;;;;;;;;1,0;;;;;;;;;;;;;1,0;;;;;;;2,0;;;;;;;;;;;;;;;;;;;;;;;2,0;;;;;;;;1,0;;;;;;;;;;;;;;;;;;;;;;;;;;;;;;;;;;;;;;;2,0;;;;;;;;;;;2,0;;2,0;;1,0;;;;;;;;;;;;;;8,0;;;;;;;;;;;;;;;;;;;;;;;;;;;;;;;;;;;;;;;;;;;;;1,0;;;;;;;;;;;;;;;;22,0;;;;;;;;;;;;1,0;;;2,0;;2,0;;;;;;;;;
send;22,0;12,0;;17,0;;4,0;;28,0;;10,0;4,0;;7,0;;4,0;22,0;4,0;;;;;47,0;1,0;;;;;1,0;;;9,0;5,0;107,0;;126,0;83,0;1,0;;;1,0;175,0;;;3,0;9,0;2,0;43,0;135,0;23,0;22,0;2,0;4,0;;12,0;33,0;5,0;;3,0;5,0;;;2,0;1,0;6,0;3,0;2,0;9,0;;16,0;;10,0;;35,0;;;;2,0;;;195,0;4,0;16,0;1,0;39,0;;45,0;46,0;;;2,0;75,0;3,0;1,0;4,0;5,0;2,0;11,0;;64,0;9,0;;3,0;25,0;18,0;;24,0;26,0;35,0;28,0;22,0;;8,0;;1,0;1,0;9,0;28,0;18,0;8,0;24,0;2,0;;5,0;5,0;36,0;1,0;2,0;;1,0;2,0;1,0;25,0;1,0;;;3,0;3,0;22,0;;2,0;8,0;6,0;;12,0;19,0;1,0;;;229,0;6,0;;;7,0;15,0;2,0;2,0;45,0;;4,0;4,0;;8,0;153,0;;;;55,0;9,0;;;8,0;;;;2,0;;;;;;4,0;44,0;;;;10,0;;8,0;;;;;;10,0;;3,0;16,0;;;;;;3,0;1,0;;;2,0;;8,0;;;;;;;;;;;;1,0;;;;;;;;34,0;;3,0;;;5,0;;2,0;5,0;;;;;1,0;;;1,0;;;3,0;12,0;;;;;1,0;;7,0;47,0;;2,0;;;;3,0;20,0;;;;;1,0;;;3,0;2,0;;;;3,0;2,0;1,0;;22,0;1,0;;;;39,0;;;;;6,0;;;;;;;;3,0;;;;;;;;;;;;4,0;1,0;;;1,0;;;2,0;;7,0;;;;;31,0;;;;;;;2,0;;;;11,0;2,0;2,0;;;;;;;;4,0;1,0;3,0;;11,0;;;;28,0;;;;15,0;23,0;;2,0;;;;;;;3,0;;;;;;6,0;;;;;;;;;;;;1,0;;;;2,0;;3,0;3,0;;;22,0;;;;;;;16,0;6,0;;;;;1,0;2,0;7,0;4,0;3,0;;9,0;;;;;4,0;;5,0;8,0;6,0;2,0;;2,0;2,0;;2,0;;11,0;16,0;;2,0;;2,0;2,0;10,0;;4,0;6,0;2,0;;18,0;5,0;3,0;;3,0;6,0;1,0;;;;;12,0;18,0;;;3,0;;;8,0;11,0;;;5,0;1,0;2,0;3,0;;;5,0;7,0;38,0;1,0;;;1,0;2,0;10,0;;;;;;4,0;;;;;2,0;4,0;4,0;;;2,0;;16,0;;13,0;3,0;2,0;5,0;7,0;;1,0;;3,0;;;5,0;;2,0;12,0;;2,0;2,0;1,0;;3,0;4,0;2,0;2,0;;4,0;6,0;;;6,0;4,0;;1,0;5,0;;7,0;15,0;2,0;1,0;5,0;;;;;;1,0;3,0;38,0;;3,0;5,0;;1,0;3,0;2,0;;;;;;;;;;;49,0;;68,0;11,0;;;5,0;2,0;;1,0;6,0;;;2,0;;;;;;18,0;1,0;9,0;8,0;;1,0;3,0;3,0;1,0;;4,0;2,0;2,0;1,0;;;;;7,0;26,0;;2,0;;;4,0;;;;;1,0;;;;;4,0;;4,0;5,0;;6,0;;;5,0;1,0;1,0;5,0;1,0;;;2,0;20,0;1,0;2,0;;3,0;4,0;1,0;;1,0;22,0;;;1,0;;6,0;;;38,0;;;;1,0;;;;;;;;;;;;3,0;;13,0;;;;;;;;;;;;;5,0;;;4,0;2,0;8,0;;;;1,0;;;9,0;;;;;;;;1,0;1,0;;;;;;;;;;;;1,0;;;;;;;;;;;;;;;;1,0;;4,0;;;;;;;7,0;;;;;;;;;;;;;;;;;;;;;;16,0;1,0;3,0;;;;;2,0;;;1,0;;;;;;;;8,0;;;;;3,0;1,0;1,0;;3,0;;;;7,0;;;;;;1,0;;;2,0;;;;;;;1,0;1,0;;;;;;4,0;;;;;;;1,0;1,0;;;;;;;;;;;1,0;;7,0;;;;3,0;;;7,0;;;6,0;;;;;5,0;;1,0;;;1,0;;;;1,0;;;;3,0;;9,0;;;;;;;3,0;;;;;;;;;26,0;;1,0;;;;;;4,0;;;;;;1,0;1,0;4,0;;;;;;;;;;;;;;;3,0;;;;2,0;;;;3,0;;;;;;;;;;;;;2,0;;7,0;;1,0;;;;;;;;;;;;;;;;;;3,0;;;32,0;;2,0;;;;;5,0;;;;;;;;1,0;;;1,0;1,0;;;;;;;;;;;;;;;;;;;2,0;
sensor;10,0;45,0;14,0;23,0;24,0;102,0;70,0;318,0;237,0;178,0;676,0;;137,0;3,0;208,0;306,0;86,0;12,0;16,0;3,0;31,0;808,0;32,0;20,0;7,0;7,0;298,0;34,0;17,0;24,0;25,0;34,0;657,0;4,0;302,0;105,0;21,0;19,0;14,0;2,0;924,0;5,0;138,0;71,0;445,0;88,0;302,0;929,0;331,0;227,0;260,0;176,0;9,0;15,0;37,0;34,0;286,0;19,0;62,0;1,0;35,0;38,0;177,0;1,0;190,0;99,0;134,0;401,0;245,0;81,0;36,0;18,0;394,0;5,0;4,0;166,0;30,0;30,0;122,0;10386,0;59,0;842,0;15,0;989,0;20,0;32,0;42,0;4,0;39,0;59,0;1446,0;;4,0;17,0;59,0;23,0;80,0;2,0;620,0;62,0;12,0;36,0;1101,0;467,0;31,0;43,0;996,0;23,0;498,0;72,0;67,0;69,0;31,0;18,0;2,0;811,0;411,0;717,0;61,0;82,0;3,0;15,0;91,0;227,0;308,0;31,0;2,0;1,0;68,0;116,0;5,0;36,0;164,0;28,0;35,0;116,0;72,0;132,0;15,0;20,0;145,0;11,0;12,0;;42,0;9,0;6,0;175,0;716,0;70,0;22,0;48,0;71,0;87,0;116,0;21,0;763,0;2,0;74,0;50,0;22,0;74,0;768,0;10,0;12,0;1,0;186,0;199,0;60,0;35,0;47,0;2,0;44,0;69,0;44,0;40,0;240,0;97,0;3,0;7,0;335,0;140,0;39,0;57,0;51,0;345,0;5,0;132,0;33,0;17,0;3,0;4,0;5,0;292,0;9,0;75,0;1,0;;;233,0;20,0;2,0;53,0;191,0;31,0;3,0;16,0;13,0;201,0;141,0;41,0;22,0;12,0;24,0;53,0;17,0;5,0;48,0;44,0;42,0;283,0;51,0;45,0;;2,0;35,0;43,0;;985,0;42,0;162,0;48,0;74,0;386,0;57,0;76,0;85,0;93,0;63,0;33,0;31,0;28,0;30,0;85,0;57,0;14,0;14,0;40,0;849,0;109,0;97,0;17,0;3,0;4,0;18,0;12,0;834,0;60,0;7,0;3,0;;5,0;27,0;91,0;107,0;31,0;29,0;23,0;88,0;18,0;16,0;147,0;88,0;22,0;7,0;9,0;19,0;96,0;319,0;590,0;78,0;6,0;29,0;40,0;1,0;242,0;39,0;45,0;28,0;48,0;166,0;17,0;30,0;67,0;17,0;2,0;1,0;13,0;30,0;1,0;97,0;21,0;86,0;4,0;11,0;2,0;12,0;78,0;75,0;6,0;26,0;53,0;282,0;2,0;45,0;67,0;;21,0;5,0;307,0;7,0;2,0;20,0;8,0;107,0;11,0;16,0;;1,0;24,0;11,0;5,0;2,0;;8,0;25,0;2,0;21,0;19,0;123,0;3,0;11,0;10,0;72,0;14,0;7,0;9,0;46,0;83,0;50,0;5,0;19,0;4,0;44,0;18,0;13,0;27,0;41,0;87,0;5,0;8,0;48,0;35,0;6,0;2,0;2,0;;29,0;84,0;24,0;10,0;4,0;4,0;4,0;;5,0;16,0;12,0;37,0;70,0;2,0;3,0;53,0;11,0;10,0;44,0;25,0;5,0;;153,0;56,0;85,0;20,0;34,0;6,0;22,0;19,0;53,0;53,0;28,0;38,0;41,0;;75,0;10,0;3,0;8,0;43,0;50,0;56,0;81,0;29,0;26,0;;46,0;6,0;12,0;13,0;6,0;2,0;1,0;8,0;49,0;11,0;4,0;37,0;3,0;20,0;2,0;40,0;96,0;161,0;60,0;148,0;74,0;;10,0;91,0;137,0;4,0;60,0;316,0;120,0;1,0;37,0;73,0;115,0;3,0;186,0;42,0;27,0;25,0;3,0;6,0;39,0;91,0;6,0;1,0;10,0;15,0;276,0;38,0;2,0;33,0;9,0;14,0;21,0;19,0;15,0;47,0;13,0;15,0;37,0;12,0;86,0;8,0;14,0;34,0;49,0;4,0;80,0;157,0;8,0;69,0;58,0;8,0;14,0;19,0;27,0;47,0;16,0;56,0;15,0;24,0;31,0;13,0;13,0;4,0;129,0;;46,0;20,0;20,0;54,0;46,0;1,0;3,0;38,0;82,0;5,0;17,0;26,0;21,0;3,0;29,0;13,0;3,0;2,0;22,0;;32,0;40,0;1,0;15,0;6,0;;34,0;15,0;;46,0;;3,0;26,0;28,0;1,0;1,0;50,0;90,0;6,0;17,0;;37,0;2,0;2,0;23,0;62,0;36,0;8,0;;23,0;;;20,0;40,0;3,0;47,0;22,0;11,0;21,0;12,0;5,0;37,0;77,0;33,0;3,0;38,0;4,0;45,0;6,0;16,0;259,0;;64,0;14,0;8,0;33,0;20,0;19,0;3,0;3,0;14,0;8,0;2,0;12,0;86,0;57,0;34,0;102,0;5,0;11,0;5,0;;2,0;24,0;26,0;3,0;;10,0;36,0;3,0;102,0;;2,0;2,0;7,0;55,0;7,0;3,0;6,0;;14,0;10,0;13,0;2,0;3,0;;6,0;9,0;;7,0;40,0;6,0;7,0;6,0;3,0;2,0;339,0;33,0;;9,0;34,0;;;60,0;;4,0;26,0;3,0;15,0;3,0;20,0;9,0;11,0;22,0;2,0;;4,0;10,0;16,0;6,0;3,0;37,0;4,0;32,0;8,0;18,0;12,0;2,0;1,0;4,0;;14,0;28,0;18,0;27,0;9,0;20,0;20,0;3,0;11,0;46,0;4,0;3,0;10,0;9,0;8,0;;7,0;20,0;3,0;1,0;3,0;37,0;2,0;;46,0;13,0;17,0;;18,0;5,0;14,0;8,0;4,0;2,0;33,0;17,0;10,0;69,0;;20,0;10,0;16,0;2,0;8,0;26,0;4,0;12,0;;1,0;5,0;5,0;;78,0;12,0;;3,0;2,0;5,0;3,0;1,0;43,0;11,0;1,0;;25,0;65,0;20,0;3,0;66,0;18,0;6,0;14,0;2,0;36,0;3,0;12,0;123,0;;9,0;9,0;34,0;5,0;36,0;;4,0;5,0;11,0;87,0;1,0;2,0;8,0;1,0;12,0;8,0;20,0;10,0;3,0;81,0;21,0;9,0;9,0;;36,0;36,0;4,0;;50,0;1,0;;15,0;67,0;17,0;26,0;18,0;2,0;4,0;5,0;42,0;47,0;101,0;112,0;5,0;9,0;48,0;5,0;37,0;1,0;11,0;48,0;1,0;7,0;35,0;13,0;9,0;1,0;3,0;;48,0;9,0;4,0;5,0;3,0;2,0;2,0;4,0;8,0;;40,0;8,0;10,0;6,0;;11,0;;6,0;2,0;1,0;3,0;;16,0;17,0;18,0;13,0;6,0;1,0;16,0;;3,0;;8,0;47,0;1,0;7,0;22,0;22,0;15,0;3,0;2,0;11,0;19,0;5,0;41,0;;8,0;5,0;10,0;8,0;;12,0;3,0;4,0;15,0;11,0;11,0;4,0;5,0;;21,0;2,0;;5,0;6,0;1,0;5,0;5,0;6,0;13,0;9,0;1,0;2,0;34,0;5,0;16,0;4,0;2,0;1,0;3,0;9,0;10,0;33,0;7,0;;1,0;9,0;;3,0;25,0;;;10,0;20,0;7,0;6,0;3,0;11,0;;;64,0;24,0;15,0;2,0;28,0;5,0;6,0;3,0;6,0;14,0;2,0;1,0;;2,0;18,0;4,0;18,0;13,0;27,0;30,0;11,0;11,0;2,0;2,0;22,0;10,0;1,0;9,0;2,0;3,0;;2,0;1,0;;8,0;2,0;11,0;2,0;;3,0;;2,0;2,0;3,0;;24,0;17,0;;2,0;1,0;3,0;9,0;;23,0;3,0;7,0;20,0;2,0;3,0;1,0;;1,0;11,0;4,0;13,0;25,0;4,0;2,0;15,0;;9,0;2,0;1,0;1,0;6,0;1,0;2,0;20,0;3,0;4,0;1,0;;3,0;34,0;21,0;5,0;1,0;2,0;;3,0;9,0;;12,0;3,0;5,0;;;;1,0;;;
setting;1,0;1,0;1,0;2,0;9,0;39,0;31,0;79,0;179,0;11,0;10,0;;52,0;4,0;10,0;136,0;;3,0;16,0;5,0;54,0;160,0;23,0;12,0;3,0;19,0;111,0;24,0;;;7,0;47,0;109,0;8,0;162,0;39,0;34,0;29,0;6,0;1,0;153,0;6,0;20,0;24,0;48,0;70,0;143,0;199,0;65,0;148,0;1,0;103,0;;8,0;21,0;1,0;98,0;;7,0;3,0;;8,0;40,0;17,0;23,0;63,0;158,0;9,0;87,0;1,0;50,0;1,0;47,0;3,0;2,0;27,0;18,0;1,0;20,0;501,0;23,0;44,0;2,0;193,0;2,0;42,0;37,0;2,0;;29,0;136,0;1,0;1,0;1,0;4,0;10,0;22,0;8,0;265,0;5,0;8,0;5,0;31,0;61,0;1,0;11,0;37,0;7,0;60,0;215,0;15,0;54,0;;2,0;1,0;128,0;53,0;106,0;71,0;95,0;;;21,0;72,0;28,0;9,0;;;;143,0;1,0;36,0;2,0;1,0;2,0;25,0;16,0;65,0;21,0;4,0;41,0;;19,0;42,0;;;;5,0;66,0;26,0;8,0;;41,0;35,0;19,0;20,0;123,0;;16,0;22,0;3,0;25,0;570,0;3,0;2,0;;46,0;36,0;;;80,0;;;5,0;27,0;15,0;6,0;1,0;;;1,0;57,0;;1,0;10,0;6,0;;18,0;;;2,0;18,0;;10,0;;3,0;1,0;;;;;1,0;10,0;51,0;;;;1,0;233,0;9,0;1,0;;3,0;4,0;;;;;;1,0;;;2,0;;3,0;;2,0;;77,0;1,0;22,0;;10,0;1,0;;5,0;35,0;1,0;5,0;2,0;6,0;4,0;;3,0;6,0;;2,0;1,0;59,0;8,0;1,0;;;;;4,0;88,0;5,0;;;;;4,0;118,0;;7,0;;;54,0;;;9,0;7,0;;;3,0;19,0;1,0;2,0;18,0;15,0;6,0;6,0;1,0;;95,0;;2,0;;;19,0;8,0;4,0;;1,0;;38,0;;;;1,0;5,0;2,0;;;;1,0;19,0;1,0;1,0;;2,0;;;3,0;;;;;4,0;;3,0;;;27,0;1,0;;1,0;2,0;;;;;;;5,0;;;9,0;1,0;;;8,0;6,0;14,0;;3,0;11,0;5,0;9,0;;;14,0;20,0;;2,0;2,0;55,0;2,0;;2,0;1,0;;;;;;3,0;;5,0;2,0;2,0;;2,0;7,0;;2,0;;3,0;14,0;;;1,0;;;25,0;;;6,0;2,0;2,0;48,0;2,0;;;8,0;;13,0;8,0;;1,0;;6,0;8,0;1,0;1,0;;1,0;8,0;27,0;121,0;31,0;18,0;1,0;7,0;;;1,0;2,0;;;12,0;6,0;18,0;;4,0;;14,0;;18,0;;40,0;53,0;7,0;12,0;3,0;15,0;5,0;162,0;;13,0;44,0;4,0;1,0;20,0;56,0;89,0;8,0;4,0;15,0;27,0;19,0;;39,0;23,0;27,0;26,0;;;29,0;4,0;;3,0;27,0;;;7,0;;41,0;13,0;;;4,0;15,0;100,0;;8,0;;4,0;1,0;125,0;5,0;3,0;34,0;21,0;2,0;1,0;1,0;;2,0;2,0;3,0;8,0;15,0;11,0;1,0;3,0;5,0;24,0;2,0;11,0;1,0;1,0;44,0;37,0;3,0;1,0;;2,0;11,0;1,0;69,0;1,0;2,0;5,0;20,0;4,0;7,0;;1,0;;8,0;5,0;63,0;3,0;5,0;22,0;;1,0;9,0;6,0;1,0;19,0;15,0;1,0;;30,0;1,0;;5,0;19,0;;1,0;8,0;12,0;1,0;32,0;15,0;;6,0;;;8,0;2,0;5,0;8,0;;1,0;4,0;8,0;;3,0;;6,0;;2,0;8,0;6,0;;6,0;2,0;;;;;8,0;;;1,0;;7,0;;;;26,0;80,0;;;1,0;;1,0;1,0;3,0;;2,0;;4,0;39,0;25,0;4,0;1,0;3,0;1,0;2,0;;7,0;2,0;;;;7,0;;6,0;;2,0;5,0;1,0;;6,0;2,0;6,0;1,0;;20,0;5,0;;80,0;12,0;;12,0;26,0;;3,0;1,0;5,0;2,0;2,0;;1,0;;10,0;2,0;9,0;2,0;;2,0;;;15,0;;;13,0;;1,0;3,0;;5,0;5,0;;;4,0;2,0;;3,0;2,0;;1,0;3,0;;22,0;7,0;1,0;34,0;;;;1,0;;;1,0;;4,0;1,0;;;2,0;;10,0;13,0;;4,0;5,0;;;1,0;2,0;2,0;11,0;9,0;;;;;2,0;;;2,0;16,0;4,0;;2,0;;;10,0;;;;;4,0;;;;;;4,0;;;;;1,0;;8,0;5,0;2,0;3,0;1,0;;3,0;1,0;4,0;4,0;;;;;;1,0;;;;;;;1,0;;8,0;;;7,0;1,0;;;;6,0;5,0;4,0;12,0;2,0;;17,0;;3,0;3,0;5,0;;;11,0;2,0;12,0;14,0;1,0;1,0;;;2,0;2,0;4,0;;39,0;11,0;3,0;7,0;8,0;4,0;;1,0;;9,0;3,0;3,0;3,0;23,0;7,0;6,0;;7,0;;;1,0;;22,0;18,0;;11,0;;9,0;2,0;;;;11,0;;18,0;7,0;80,0;;;2,0;4,0;;;29,0;14,0;;5,0;1,0;;;;5,0;;;3,0;;;;1,0;8,0;;1,0;4,0;1,0;1,0;;10,0;;1,0;;16,0;9,0;1,0;;;;;;8,0;1,0;;;;12,0;2,0;1,0;;;2,0;;11,0;;;;;4,0;3,0;6,0;;1,0;;;7,0;13,0;1,0;;;;;;37,0;6,0;;8,0;2,0;;10,0;;;;1,0;;;;;;1,0;;8,0;;3,0;4,0;;;;9,0;;;;;1,0;;3,0;8,0;6,0;9,0;;;1,0;;;2,0;;;;;9,0;;;;1,0;8,0;;9,0;;;;;;1,0;;;6,0;6,0;;2,0;22,0;;2,0;;;;;2,0;29,0;;;6,0;;16,0;;9,0;6,0;35,0;22,0;;;;2,0;;2,0;;;;2,0;;;;;;2,0;
shade;2,0;;;;;9,0;2,0;10,0;3,0;;;;1,0;;;5,0;;;2,0;3,0;;7,0;;2,0;;;18,0;;;1,0;2,0;;5,0;1,0;3,0;;19,0;90,0;;;14,0;;1,0;1,0;1,0;;8,0;7,0;;11,0;2,0;5,0;10,0;;;2,0;3,0;;;5,0;1,0;;1,0;;;2,0;;12,0;;;1,0;;11,0;1,0;;;;1,0;1,0;87,0;;4,0;7,0;25,0;;3,0;;;;3,0;66,0;;;;;6,0;1,0;;38,0;;;;14,0;1,0;;;3,0;;1,0;16,0;;13,0;47,0;;;3,0;2,0;29,0;;;1,0;;;27,0;3,0;;;;1,0;2,0;;7,0;3,0;1,0;;3,0;1,0;;;;16,0;;1,0;9,0;;;;9,0;4,0;;3,0;;4,0;15,0;26,0;;6,0;;;;;8,0;59,0;;;;;;;;;;;;5,0;;17,0;;;;;5,0;;;;;;;;;;;;;;;;;;;;;2,0;4,0;;;;;8,0;;;;;;;;;;29,0;;;;;;;;2,0;;5,0;;15,0;;;4,0;;1,0;1,0;2,0;;;;;;;;;1,0;;6,0;2,0;2,0;;2,0;;;;5,0;;;;;;;;;1,0;5,0;;;;;;;;;;;7,0;1,0;1,0;;;;;;;;;;;4,0;;;;;;;;2,0;;;;8,0;;1,0;;;5,0;;1,0;;1,0;;;2,0;2,0;;;;;;;;2,0;4,0;;;;;1,0;;;;;;;;;;;;;;;;;;;2,0;1,0;;;;2,0;;;;22,0;;;;;;;;2,0;;;;;;;;;;;;;;1,0;;2,0;;;;;;;;;1,0;;;3,0;;4,0;;;;;;;1,0;1,0;;;;;4,0;20,0;6,0;;;;;;;;;;;8,0;;;;;;;;1,0;;;;;2,0;;5,0;;;;;;;;;;;;;;;;;;6,0;;2,0;;;;1,0;;;;;;;;;;;;;;;;1,0;;;;2,0;;;3,0;1,0;;;;;4,0;;;;9,0;;;;;;;4,0;;;;3,0;;;;1,0;;;;;;;;;;;;;;;4,0;;;;;;;;;;;;;;2,0;;;;;;;;;;;1,0;;;;;;;;;;;;;6,0;;13,0;;;;;;2,0;;;;;;;;;;;;;;;2,0;5,0;;;;;;;;;;;;;;;;;;;;;;;;;;;1,0;;;;;;;;;;;;;;1,0;;;;;;;;;;;;;;;;;;;;;;;;;;;2,0;;1,0;;;;;;;;;1,0;;;;;;;11,0;;2,0;;;;;;;;;;;;;;;;;;;;;;1,0;;;;;;;;;3,0;;;;;1,0;;;;;;;;;;;;;;;;;;;;;;;;;1,0;;;;;;;;;;;;;;;;;;;;;;;;;;;;;;;;;1,0;;;;;;3,0;;;;;;;3,0;;;;;;;;;;;;;;;;;1,0;2,0;;;1,0;;;;;;;9,0;;;6,0;;3,0;;;;;;;;;;;;;;;;;;;;;;;;;;;;1,0;;;;;;;;;3,0;;;;1,0;;;1,0;;;;;;;;;;;4,0;;;;;;;;;;;;;;;;;;;;;;;3,0;;;;;;;5,0;;;;;;;;;;;;;;;2,0;;;;;;1,0;;;;;;;;;;;;;;;;;;;;;;;;;;;;;;;;;;;;;;;;;1,0;2,0;;;;;;;;;;;;;;;;;9,0;;1,0;;;;;;;;;;;;;;;1,0;;;;
shell;1,0;;;;;;1,0;;;;;;;;;;;;;;;;;;;;;;;;;;2,0;;3,0;1,0;;;;;;;13,0;;;;;1,0;;;4,0;;;;;;32,0;;;;6,0;;;;;3,0;;6,0;9,0;19,0;;;;;;;;;;8,0;;;;12,0;1,0;;;;;;42,0;;;5,0;;;;;;1,0;;;30,0;;;;3,0;;;;2,0;;1,0;;;6,0;6,0;3,0;;;;;;;2,0;;;;;;;1,0;;1,0;;;;;;;;;;6,0;;;;;2,0;;;;2,0;;;;3,0;;;;;;8,0;;;;6,0;;;;;;;;;;5,0;2,0;;;1,0;8,0;;1,0;;1,0;;1,0;;;;;;6,0;;;;;5,0;;;1,0;;;;12,0;;;;;;;;;;3,0;;;;8,0;6,0;;6,0;;;;;;;1,0;20,0;5,0;;10,0;12,0;5,0;;;;37,0;;;;;;;;;;;3,0;;5,0;;;;25,0;;;;;;;1,0;;;1,0;;;;;;5,0;;;1,0;;;5,0;12,0;1,0;;;;;;;;;;1,0;;;;3,0;;;;2,0;;;;12,0;;;;;;;;;1,0;;;;;;;;;;;;3,0;13,0;;6,0;;;;;1,0;;;;;;;;;;;;;;;;16,0;;;;;;;;;;;;;;;;1,0;1,0;4,0;;15,0;3,0;;;;1,0;;;3,0;;;;;;;;;;;4,0;;;;1,0;;;;;;;;;;;;;1,0;;;;;;;;;;;;;;;;;;;;;;;;;;;;;;;;;;;;;;;;;;;;;;;;;;;;;;;;;;;;;1,0;;;;;;;;;;;;;;;;;;;;;;;;;;;;;;;;;;1,0;;;;;;;;;;;;;;;;;;;;;;;;;;;;;;;;;;;;;;;;;;;1,0;;;;;;;;;;;;;;25,0;;;;;;;;;1,0;;;;;;;;;;;;;;;;;;;;;;;;;;;;;;3,0;;1,0;;;;;;2,0;;;;;;;;;;;;;;;;;;;;;;;;;;;;;;;4,0;;;;2,0;;;;;;;;;;;;1,0;;;;2,0;;1,0;;;;;;;;;;;;;3,0;;;;;;;;;;;;;;2,0;;;;;;;1,0;;;;;;;;;1,0;;;;;;1,0;;;;;;;;;5,0;;;;;2,0;;;;1,0;;;13,0;1,0;;;2,0;;;;;;;;;;;;;1,0;;;;;;;;;;;;;;;;;;;;;;;;;;;;;;;;;;;;;;;;;;;;;;;;;;;;;;;;;;;;;;;;;;;3,0;;;;;;;;;;;;;;;;;;;;;;;;;;;;;;;;;1,0;;;;;;;;;;;;;;;1,0;;;;;;;;;;;;;;;;;;;;;;;1,0;;;;;;;;;;;;;;;;;;;;;;2,0;;;;;;;;;;;;;;;;;;;;;;;;;;;;;;;;;;;;;;;;;;;;;;;;;;;;;;;;;;;;;;;;;;;;;;;;;;;;;;;;;;;;;;;;;;;;;;;;;
side;1,0;55,0;10,0;1,0;;79,0;135,0;121,0;137,0;469,0;36,0;14,0;21,0;2,0;152,0;312,0;32,0;6,0;2,0;;34,0;58,0;11,0;56,0;4,0;1,0;10,0;22,0;10,0;1,0;2,0;37,0;143,0;1,0;39,0;14,0;10,0;5,0;2,0;170,0;114,0;20,0;151,0;5,0;37,0;12,0;24,0;174,0;12,0;172,0;505,0;191,0;3,0;1,0;32,0;141,0;932,0;;8,0;;205,0;42,0;77,0;;69,0;87,0;22,0;418,0;129,0;432,0;19,0;3,0;17,0;2,0;;270,0;;44,0;33,0;2292,0;12,0;175,0;1,0;456,0;30,0;;10,0;;103,0;125,0;2634,0;;1,0;86,0;;2,0;24,0;;78,0;18,0;1,0;2,0;220,0;2269,0;21,0;4,0;349,0;631,0;182,0;3,0;25,0;13,0;91,0;2,0;4,0;191,0;758,0;487,0;161,0;24,0;10,0;13,0;5,0;39,0;7,0;4,0;1,0;;2,0;2,0;;69,0;253,0;9,0;14,0;;43,0;;1,0;65,0;13,0;;;175,0;5,0;9,0;;;53,0;14,0;7,0;10,0;7,0;32,0;48,0;3,0;347,0;16,0;15,0;64,0;3,0;21,0;1157,0;;2,0;;21,0;114,0;20,0;10,0;108,0;11,0;25,0;138,0;19,0;15,0;114,0;105,0;8,0;1,0;116,0;405,0;14,0;16,0;;89,0;3,0;65,0;24,0;5,0;1,0;5,0;63,0;241,0;9,0;259,0;;4,0;4,0;136,0;63,0;;3,0;253,0;2,0;61,0;3,0;2,0;10,0;649,0;50,0;49,0;14,0;39,0;12,0;;105,0;13,0;17,0;129,0;356,0;61,0;258,0;10,0;27,0;160,0;188,0;6,0;304,0;9,0;513,0;22,0;99,0;333,0;36,0;83,0;30,0;348,0;625,0;194,0;18,0;208,0;12,0;66,0;1,0;9,0;35,0;;90,0;91,0;292,0;;23,0;10,0;;;109,0;41,0;8,0;67,0;17,0;33,0;10,0;9,0;78,0;1,0;86,0;47,0;31,0;3,0;37,0;58,0;98,0;23,0;;26,0;2,0;61,0;310,0;1991,0;40,0;2,0;82,0;25,0;7,0;24,0;7,0;3,0;5,0;30,0;128,0;25,0;4,0;2,0;655,0;16,0;5,0;4,0;42,0;16,0;29,0;21,0;164,0;74,0;4,0;7,0;5,0;99,0;315,0;45,0;;132,0;14,0;62,0;156,0;6,0;6,0;61,0;153,0;88,0;10,0;8,0;15,0;29,0;45,0;1,0;38,0;10,0;;9,0;7,0;19,0;43,0;42,0;13,0;;10,0;57,0;37,0;97,0;1,0;7,0;15,0;6,0;47,0;12,0;29,0;12,0;111,0;13,0;25,0;44,0;22,0;48,0;7,0;24,0;14,0;66,0;11,0;1,0;6,0;41,0;14,0;90,0;70,0;7,0;1,0;232,0;64,0;8,0;2,0;3,0;5,0;;2,0;6,0;37,0;17,0;17,0;31,0;5,0;20,0;9,0;29,0;62,0;10,0;51,0;2,0;3,0;148,0;25,0;3,0;7,0;4,0;43,0;40,0;14,0;29,0;41,0;4,0;;;4,0;11,0;3,0;;;;1,0;30,0;14,0;;5,0;5,0;4,0;18,0;;1,0;9,0;8,0;;;2,0;1,0;;;;17,0;;;;139,0;47,0;13,0;5,0;;8,0;5,0;4,0;;9,0;6,0;19,0;;;2,0;17,0;3,0;22,0;;41,0;;;;;3,0;5,0;;;;9,0;;1,0;5,0;1,0;4,0;1,0;1,0;;17,0;;;9,0;;28,0;;2,0;1,0;8,0;5,0;7,0;23,0;3,0;41,0;22,0;4,0;7,0;;3,0;2,0;1,0;3,0;;21,0;;13,0;2,0;2,0;29,0;2,0;15,0;7,0;;15,0;3,0;;7,0;1,0;10,0;;;79,0;;;;;2,0;;10,0;;9,0;1,0;42,0;5,0;;;3,0;3,0;;13,0;1,0;8,0;25,0;26,0;;18,0;4,0;14,0;2,0;57,0;;111,0;;;;14,0;;;4,0;2,0;;12,0;1,0;1,0;111,0;3,0;;7,0;32,0;28,0;4,0;22,0;13,0;8,0;29,0;5,0;6,0;1,0;;3,0;1,0;;29,0;16,0;;16,0;20,0;13,0;;;;129,0;;7,0;19,0;;;;7,0;1,0;2,0;;;18,0;20,0;1,0;;;336,0;8,0;257,0;;2,0;;;1,0;;18,0;;;5,0;4,0;51,0;2,0;2,0;;;1,0;;2,0;5,0;6,0;11,0;2,0;;;116,0;;3,0;;2,0;51,0;;15,0;;12,0;18,0;59,0;;1,0;8,0;;6,0;;;9,0;;68,0;5,0;3,0;4,0;;15,0;7,0;2,0;47,0;3,0;;6,0;22,0;10,0;1,0;6,0;35,0;46,0;18,0;13,0;16,0;11,0;81,0;4,0;16,0;14,0;;15,0;23,0;;;22,0;30,0;10,0;8,0;19,0;12,0;4,0;27,0;;10,0;44,0;7,0;;2,0;18,0;3,0;;12,0;17,0;5,0;16,0;13,0;4,0;4,0;;;19,0;5,0;4,0;2,0;11,0;18,0;;;;211,0;13,0;5,0;;1,0;19,0;10,0;5,0;3,0;4,0;12,0;4,0;66,0;44,0;7,0;23,0;26,0;3,0;;9,0;35,0;37,0;;36,0;16,0;11,0;15,0;3,0;23,0;3,0;7,0;6,0;3,0;;;23,0;2,0;3,0;;;19,0;16,0;2,0;5,0;5,0;12,0;;6,0;17,0;1,0;;;;;6,0;;;33,0;74,0;5,0;;28,0;7,0;;6,0;1,0;13,0;2,0;;4,0;;5,0;;4,0;;;14,0;1,0;;36,0;;;8,0;;;1,0;2,0;8,0;1,0;5,0;2,0;8,0;;2,0;6,0;;;11,0;;8,0;;167,0;6,0;;17,0;2,0;;;;25,0;3,0;10,0;4,0;35,0;;;1,0;108,0;;9,0;;6,0;18,0;7,0;14,0;6,0;2,0;;;2,0;2,0;;;;;10,0;15,0;;;;;2,0;9,0;;;2,0;;;;2,0;6,0;;;1,0;2,0;;5,0;1,0;;1,0;5,0;5,0;2,0;1,0;4,0;;2,0;38,0;7,0;;;5,0;2,0;;;1,0;;1,0;2,0;;5,0;10,0;;;;;;1,0;;2,0;;;1,0;7,0;8,0;;13,0;4,0;;6,0;27,0;2,0;;8,0;;;7,0;1,0;16,0;7,0;19,0;33,0;6,0;;2,0;;14,0;;5,0;3,0;;4,0;;;26,0;;2,0;5,0;6,0;;8,0;;11,0;;;;17,0;;3,0;1,0;38,0;10,0;3,0;4,0;2,0;52,0;6,0;;1,0;7,0;;3,0;;;;;1,0;;;;1,0;19,0;;;;2,0;;;;;;;;2,0;;;;;;;3,0;;;;;;6,0
signal;3,0;82,0;10,0;85,0;23,0;62,0;21,0;324,0;99,0;160,0;150,0;;116,0;;10,0;846,0;14,0;3,0;143,0;19,0;18,0;382,0;64,0;31,0;6,0;15,0;526,0;9,0;;54,0;46,0;36,0;1305,0;9,0;2284,0;279,0;108,0;180,0;16,0;;1065,0;7,0;27,0;10,0;631,0;311,0;320,0;1189,0;866,0;441,0;109,0;74,0;7,0;127,0;437,0;95,0;432,0;18,0;110,0;2,0;9,0;105,0;52,0;15,0;217,0;19,0;254,0;204,0;168,0;1,0;122,0;5,0;1973,0;103,0;;117,0;65,0;8,0;40,0;4778,0;44,0;719,0;25,0;971,0;29,0;203,0;231,0;5,0;1,0;17,0;1102,0;;50,0;;35,0;47,0;155,0;2,0;563,0;35,0;1,0;21,0;348,0;317,0;3,0;131,0;469,0;65,0;3335,0;100,0;24,0;578,0;26,0;27,0;75,0;646,0;285,0;488,0;416,0;318,0;7,0;2,0;585,0;1532,0;510,0;26,0;28,0;18,0;36,0;139,0;94,0;1125,0;45,0;23,0;69,0;43,0;137,0;514,0;142,0;10,0;56,0;3,0;229,0;716,0;66,0;4,0;2,0;53,0;;26,0;23,0;3,0;125,0;448,0;207,0;313,0;892,0;;27,0;550,0;16,0;784,0;2189,0;58,0;21,0;4,0;1067,0;73,0;8,0;36,0;307,0;;;91,0;221,0;120,0;28,0;19,0;8,0;32,0;31,0;714,0;4,0;4,0;687,0;893,0;;319,0;3,0;4,0;25,0;8,0;;373,0;;423,0;2,0;52,0;6,0;8,0;;;188,0;182,0;53,0;5,0;704,0;;330,0;46,0;16,0;;5,0;58,0;4,0;60,0;3,0;7,0;8,0;20,0;40,0;76,0;1,0;1,0;3,0;4,0;29,0;;618,0;;44,0;5,0;22,0;18,0;10,0;66,0;55,0;12,0;21,0;;39,0;32,0;;99,0;224,0;94,0;197,0;7,0;2782,0;12,0;4,0;3,0;;9,0;5,0;171,0;1401,0;36,0;;1,0;;;1,0;329,0;44,0;18,0;126,0;8,0;142,0;;;253,0;21,0;1,0;6,0;;236,0;10,0;45,0;64,0;345,0;409,0;371,0;1,0;29,0;786,0;11,0;53,0;12,0;4,0;99,0;182,0;77,0;;2,0;6,0;16,0;1,0;76,0;2,0;40,0;59,0;3,0;1,0;;;32,0;95,0;1,0;2,0;;62,0;91,0;;39,0;76,0;6,0;206,0;;110,0;;4,0;;;323,0;10,0;2,0;;;10,0;;;7,0;;1,0;287,0;18,0;9,0;129,0;10,0;;2,0;4,0;77,0;13,0;9,0;11,0;45,0;7,0;71,0;3,0;;9,0;158,0;9,0;4,0;18,0;80,0;23,0;23,0;;7,0;1,0;;;;229,0;1,0;1,0;8,0;16,0;13,0;;60,0;6,0;2,0;2,0;1,0;31,0;13,0;;;21,0;3,0;9,0;100,0;;;124,0;15,0;2,0;167,0;19,0;8,0;;307,0;5,0;20,0;10,0;12,0;64,0;31,0;5,0;68,0;;22,0;38,0;33,0;128,0;97,0;237,0;50,0;245,0;1,0;31,0;23,0;7,0;17,0;12,0;16,0;9,0;7,0;87,0;74,0;10,0;14,0;16,0;6,0;5,0;88,0;;1041,0;807,0;22,0;37,0;20,0;94,0;52,0;285,0;45,0;104,0;160,0;61,0;1,0;48,0;100,0;393,0;11,0;8,0;269,0;22,0;1,0;;50,0;27,0;235,0;200,0;3,0;2,0;7,0;137,0;9,0;33,0;39,0;18,0;9,0;55,0;27,0;96,0;20,0;;1,0;100,0;29,0;132,0;8,0;10,0;24,0;640,0;8,0;238,0;25,0;5,0;30,0;4,0;183,0;2,0;28,0;;7,0;133,0;5,0;47,0;36,0;24,0;11,0;12,0;4,0;139,0;;30,0;27,0;7,0;139,0;202,0;1,0;3,0;14,0;1424,0;2,0;37,0;39,0;;1,0;35,0;13,0;1,0;9,0;5,0;;20,0;34,0;58,0;167,0;;6,0;214,0;45,0;6,0;45,0;11,0;64,0;7,0;58,0;5,0;;245,0;14,0;18,0;49,0;9,0;3,0;;67,0;15,0;182,0;72,0;39,0;;153,0;66,0;;10,0;3,0;148,0;33,0;32,0;4,0;;25,0;10,0;85,0;101,0;37,0;2,0;154,0;58,0;263,0;22,0;59,0;760,0;4,0;21,0;;18,0;123,0;;10,0;3,0;1,0;15,0;2,0;;12,0;165,0;194,0;1,0;8,0;5,0;29,0;14,0;1,0;12,0;5,0;5,0;6,0;;13,0;3,0;53,0;17,0;3,0;20,0;7,0;32,0;27,0;24,0;1,0;5,0;2,0;4,0;7,0;;7,0;17,0;3,0;4,0;7,0;22,0;10,0;342,0;1,0;;13,0;22,0;4,0;190,0;29,0;2,0;14,0;256,0;;;30,0;10,0;4,0;25,0;;5,0;13,0;45,0;1,0;5,0;160,0;1,0;18,0;1,0;1,0;1,0;12,0;90,0;178,0;27,0;8,0;4,0;1,0;13,0;18,0;5,0;2,0;85,0;1001,0;1,0;5,0;396,0;18,0;7,0;15,0;2,0;3,0;95,0;;57,0;4,0;1,0;5,0;;;11,0;;;1,0;9,0;;;82,0;18,0;42,0;112,0;5,0;4,0;2,0;3,0;;5,0;2,0;4,0;146,0;19,0;;;2,0;117,0;;;5,0;13,0;28,0;;1,0;5,0;6,0;;7,0;;2,0;11,0;1,0;;;96,0;33,0;;1,0;81,0;17,0;6,0;127,0;;3,0;16,0;90,0;1,0;;37,0;12,0;1,0;9,0;2,0;22,0;16,0;18,0;83,0;9,0;;1,0;2,0;5,0;;8,0;1,0;;3,0;2,0;2,0;19,0;;;106,0;272,0;36,0;72,0;144,0;587,0;11,0;4,0;6,0;305,0;4,0;7,0;54,0;67,0;37,0;68,0;61,0;11,0;8,0;6,0;64,0;101,0;144,0;7,0;30,0;16,0;24,0;13,0;26,0;;52,0;29,0;8,0;4,0;188,0;105,0;;7,0;1,0;30,0;6,0;74,0;62,0;58,0;73,0;20,0;1,0;12,0;10,0;;182,0;8,0;9,0;100,0;;28,0;;14,0;87,0;51,0;2,0;;4,0;2,0;43,0;25,0;275,0;33,0;1,0;3,0;33,0;8,0;2,0;76,0;;16,0;4,0;14,0;;4,0;;18,0;;1,0;2,0;4,0;5,0;9,0;27,0;25,0;;141,0;7,0;14,0;62,0;21,0;54,0;3,0;29,0;3,0;11,0;8,0;2,0;3,0;9,0;1,0;3,0;14,0;5,0;5,0;;;2,0;6,0;6,0;6,0;12,0;1,0;3,0;3,0;11,0;4,0;2,0;1,0;23,0;109,0;4,0;3,0;5,0;4,0;4,0;16,0;10,0;13,0;10,0;9,0;3,0;3,0;;1,0;17,0;67,0;14,0;;15,0;4,0;13,0;;;;12,0;;;18,0;1,0;5,0;13,0;;55,0;7,0;1,0;4,0;6,0;1,0;8,0;24,0;;17,0;;261,0;4,0;3,0;14,0;;74,0;8,0;140,0;;35,0;4,0;;;;;;2,0;2,0;;4,0;;145,0;;;81,0;1,0;4,0;1,0;;;18,0;;2,0;105,0;23,0;4,0;20,0;37,0;7,0;9,0;34,0;;;;9,0;10,0;;6,0;;6,0;2,0;;5,0;7,0;24,0;;8,0;12,0;7,0;;17,0;12,0;47,0;1,0;;;;1,0;;;;;2,0
size;1,0;;3,0;;3,0;33,0;37,0;19,0;127,0;12,0;3,0;1,0;7,0;3,0;13,0;100,0;3,0;;2,0;;4,0;47,0;62,0;4,0;;;13,0;6,0;2,0;1,0;9,0;2,0;49,0;3,0;66,0;8,0;16,0;10,0;4,0;2,0;86,0;5,0;15,0;6,0;38,0;41,0;125,0;72,0;23,0;166,0;8,0;41,0;8,0;16,0;4,0;13,0;34,0;3,0;21,0;1,0;9,0;2,0;8,0;13,0;18,0;16,0;30,0;29,0;81,0;6,0;10,0;6,0;12,0;1,0;10,0;12,0;34,0;2,0;4,0;769,0;11,0;41,0;2,0;93,0;18,0;6,0;3,0;;1,0;18,0;109,0;;;2,0;4,0;4,0;27,0;;151,0;5,0;11,0;1,0;33,0;123,0;;3,0;23,0;19,0;37,0;24,0;;24,0;;;;106,0;108,0;101,0;1,0;70,0;3,0;;6,0;27,0;37,0;3,0;2,0;;1,0;67,0;;49,0;17,0;4,0;25,0;75,0;30,0;14,0;20,0;2,0;4,0;;6,0;70,0;26,0;;;14,0;26,0;;14,0;1,0;4,0;16,0;84,0;3,0;59,0;;5,0;3,0;7,0;2,0;98,0;3,0;23,0;;17,0;15,0;1,0;8,0;57,0;;;4,0;8,0;5,0;5,0;6,0;;;6,0;13,0;;3,0;;3,0;;3,0;;;3,0;4,0;1,0;2,0;1,0;;5,0;2,0;;8,0;;2,0;12,0;26,0;3,0;;;;5,0;72,0;;2,0;3,0;;4,0;3,0;;1,0;1,0;14,0;13,0;;;2,0;1,0;8,0;2,0;;21,0;1,0;24,0;5,0;;11,0;2,0;4,0;8,0;19,0;1,0;6,0;18,0;4,0;3,0;;;;;6,0;155,0;6,0;11,0;;;;;1,0;27,0;2,0;;;;;6,0;22,0;1,0;;92,0;5,0;3,0;4,0;;5,0;22,0;;;1,0;;3,0;4,0;21,0;2,0;;3,0;10,0;;29,0;6,0;1,0;1,0;;6,0;22,0;;;5,0;;2,0;1,0;;;4,0;7,0;9,0;;2,0;;1,0;26,0;3,0;28,0;;7,0;26,0;;7,0;5,0;7,0;4,0;1,0;1,0;;;9,0;9,0;2,0;;26,0;10,0;27,0;;2,0;;3,0;;;6,0;;4,0;11,0;4,0;4,0;;19,0;;24,0;3,0;2,0;;1,0;14,0;1,0;2,0;;10,0;3,0;;1,0;28,0;4,0;17,0;6,0;9,0;;;3,0;;;1,0;4,0;1,0;3,0;;;1,0;;;;;1,0;12,0;14,0;;3,0;;;;5,0;;;6,0;7,0;34,0;1,0;;9,0;1,0;;3,0;63,0;17,0;;;2,0;2,0;;;;;5,0;44,0;63,0;3,0;20,0;1,0;10,0;;;1,0;;2,0;3,0;16,0;11,0;4,0;2,0;;9,0;69,0;;1,0;;21,0;18,0;;38,0;;11,0;27,0;28,0;;7,0;16,0;26,0;;;;10,0;;19,0;16,0;37,0;2,0;;16,0;2,0;10,0;;3,0;;5,0;5,0;;;15,0;1,0;;;;56,0;4,0;;;1,0;4,0;45,0;3,0;3,0;;2,0;1,0;63,0;3,0;;11,0;8,0;3,0;22,0;5,0;1,0;6,0;;1,0;;5,0;17,0;;1,0;25,0;18,0;2,0;2,0;;1,0;16,0;118,0;;7,0;;7,0;1,0;41,0;50,0;;1,0;;;1,0;;5,0;;;;;10,0;9,0;10,0;;1,0;63,0;;12,0;;4,0;;;1,0;15,0;3,0;;13,0;;3,0;;26,0;9,0;4,0;27,0;1,0;;3,0;;10,0;5,0;;;9,0;2,0;3,0;2,0;1,0;3,0;1,0;13,0;2,0;;2,0;;2,0;;;;3,0;;2,0;;;;3,0;;;3,0;;;;1,0;2,0;;1,0;;;;;;2,0;1,0;;;2,0;;1,0;1,0;;5,0;1,0;;2,0;;4,0;;;1,0;7,0;;1,0;;3,0;1,0;1,0;;5,0;;;;9,0;8,0;;104,0;;1,0;2,0;;;;;2,0;;;;4,0;;11,0;;2,0;;;;;;7,0;1,0;;2,0;1,0;11,0;7,0;3,0;1,0;6,0;;1,0;;;3,0;4,0;;;;6,0;;9,0;3,0;1,0;;;;;;3,0;6,0;;1,0;;11,0;1,0;;15,0;1,0;10,0;1,0;;2,0;4,0;;;2,0;4,0;;1,0;61,0;;;;;;1,0;5,0;3,0;15,0;;2,0;1,0;;;1,0;;1,0;;;;1,0;;;;;11,0;3,0;;;5,0;;;3,0;13,0;5,0;3,0;;5,0;;3,0;1,0;8,0;;;1,0;1,0;;;;4,0;10,0;6,0;;;;;;13,0;1,0;6,0;;;;;;3,0;3,0;8,0;;;5,0;;1,0;8,0;15,0;;2,0;;1,0;12,0;51,0;;;;15,0;1,0;1,0;;;1,0;;4,0;;;2,0;;1,0;;;;;6,0;1,0;;1,0;3,0;2,0;;;2,0;;24,0;4,0;;7,0;2,0;10,0;;;;2,0;6,0;;9,0;1,0;1,0;;;;5,0;;;7,0;;;59,0;;;;;2,0;;;;2,0;;;;1,0;;;1,0;;8,0;22,0;;;;10,0;5,0;;;3,0;;;;6,0;;;;;;;4,0;;;;2,0;2,0;;;;;;;1,0;;;1,0;;;;;;;2,0;2,0;;;9,0;;5,0;;;;;;;4,0;;;;;;;;;2,0;;;13,0;;;;;;26,0;;;;1,0;;;4,0;;;;1,0;;;4,0;;;;;;;3,0;;1,0;;;4,0;;5,0;;11,0;1,0;4,0;1,0;7,0;;;;2,0;5,0;;1,0;;;;;;;;;6,0;11,0;;;4,0;;6,0;;4,0;;1,0;;;;1,0;7,0;;1,0;1,0;;;;;22,0;
specific;2,0;1,0;9,0;;5,0;12,0;2,0;20,0;37,0;11,0;2,0;;28,0;4,0;6,0;59,0;2,0;2,0;10,0;;1,0;40,0;;2,0;2,0;;34,0;9,0;;;7,0;23,0;27,0;6,0;51,0;10,0;7,0;6,0;3,0;;41,0;;11,0;2,0;85,0;16,0;32,0;35,0;12,0;24,0;1,0;23,0;;;29,0;;13,0;;1,0;;;3,0;4,0;12,0;20,0;4,0;18,0;1,0;26,0;1,0;52,0;10,0;28,0;3,0;2,0;31,0;40,0;1,0;8,0;256,0;8,0;11,0;;42,0;4,0;15,0;6,0;;;1,0;43,0;;1,0;;4,0;4,0;2,0;;53,0;2,0;4,0;1,0;14,0;146,0;1,0;9,0;16,0;1,0;28,0;24,0;4,0;16,0;2,0;;;68,0;28,0;91,0;;3,0;;;22,0;24,0;5,0;8,0;7,0;;;51,0;2,0;32,0;5,0;;11,0;1,0;;;;12,0;25,0;;;22,0;8,0;3,0;;7,0;23,0;14,0;;3,0;5,0;9,0;9,0;;13,0;;;2,0;5,0;4,0;84,0;2,0;4,0;;6,0;26,0;;13,0;16,0;;;5,0;5,0;11,0;1,0;;;;;3,0;;;1,0;15,0;;36,0;;;;1,0;;;;;;;;;;;2,0;33,0;6,0;;;3,0;8,0;3,0;;;2,0;;;;1,0;;;1,0;13,0;;;;;;;;38,0;;3,0;;1,0;4,0;;22,0;19,0;3,0;;;5,0;4,0;;2,0;;;;;63,0;8,0;;;1,0;;;;19,0;2,0;;;;;;34,0;;1,0;25,0;;1,0;;;8,0;6,0;1,0;1,0;;6,0;1,0;;28,0;4,0;;1,0;;;16,0;4,0;6,0;;;6,0;;;;;;2,0;;;;;6,0;;;;;1,0;3,0;;;;6,0;;;;1,0;;;;;;;;1,0;15,0;1,0;;;;;;;;;;17,0;1,0;1,0;;;;;1,0;7,0;1,0;;2,0;;1,0;33,0;;2,0;2,0;5,0;;;;34,0;3,0;;;6,0;;;;;;;;;;;;;4,0;;;;;;;;2,0;;;;2,0;;;1,0;;10,0;5,0;;;2,0;;3,0;9,0;;;;1,0;;;;;3,0;;8,0;26,0;1,0;;;2,0;6,0;;;;2,0;5,0;1,0;13,0;;1,0;;3,0;19,0;;1,0;;20,0;5,0;2,0;57,0;;1,0;5,0;33,0;;5,0;10,0;15,0;;;13,0;20,0;;;1,0;3,0;;2,0;5,0;2,0;8,0;3,0;3,0;;17,0;3,0;;5,0;;;;2,0;;1,0;11,0;;;2,0;1,0;62,0;1,0;2,0;;1,0;;18,0;;;4,0;20,0;;;;1,0;2,0;;;63,0;4,0;1,0;;;;6,0;2,0;1,0;;;11,0;5,0;1,0;;;4,0;;1,0;13,0;;;;;;;1,0;;;;;4,0;;;3,0;;1,0;;;;1,0;;6,0;;17,0;5,0;;15,0;3,0;;;;;4,0;;;;1,0;;;;4,0;4,0;8,0;;;;1,0;;;;7,0;;2,0;;7,0;;;;1,0;;;;5,0;;1,0;;;4,0;;;;;;;7,0;1,0;;8,0;2,0;1,0;;;1,0;;10,0;;;1,0;;2,0;;;1,0;4,0;;1,0;;6,0;15,0;1,0;3,0;;;;;;;;1,0;;;12,0;;70,0;9,0;;4,0;;;1,0;;2,0;;;;;;;;2,0;1,0;;;1,0;;3,0;;;3,0;2,0;;;;;;;;;;1,0;2,0;3,0;;;;;;;;1,0;;;;;;;;3,0;;4,0;;;5,0;1,0;3,0;1,0;;;1,0;;;;;;;1,0;;;;;;;;1,0;;1,0;;;;;;;;;4,0;;;;1,0;;;;8,0;;;;;;;;;1,0;;2,0;;;;3,0;;;;;;;1,0;;4,0;2,0;;;;;;4,0;;42,0;1,0;;;;;4,0;;2,0;;;;;;;31,0;;;;1,0;2,0;1,0;;3,0;;3,0;;2,0;1,0;1,0;;7,0;;2,0;;;;;;;;;2,0;;10,0;2,0;;1,0;;;18,0;3,0;;17,0;;;;;2,0;;2,0;2,0;4,0;;1,0;3,0;;;;1,0;;;;2,0;1,0;;6,0;;;;;;;2,0;;;4,0;;;1,0;;;2,0;;2,0;;;;1,0;4,0;4,0;;;;;;;5,0;;;;;;;;;;;3,0;;;;;2,0;;;;15,0;;1,0;;8,0;;;;;;;;;1,0;;1,0;2,0;;26,0;2,0;;;;;;;;;;;;;;;20,0;;;;;;;;;14,0;;;1,0;2,0;2,0;;;2,0;;;;;;;;5,0;;2,0;;;2,0;;;4,0;;;;;;;6,0;;1,0;;12,0;29,0;;;3,0;;;;;11,0;;;;;;;;;1,0;;1,0;;;;3,0;;;;;;;;;;;;
stack;2,0;1,0;1,0;;;;5,0;13,0;6,0;5,0;69,0;;6,0;;4,0;3,0;4,0;;;;;3,0;1,0;13,0;;;1,0;6,0;;;;;10,0;;2,0;;2,0;;;6,0;11,0;;2,0;6,0;;;4,0;23,0;1,0;9,0;11,0;1,0;;;1,0;1,0;34,0;;;;7,0;;6,0;;6,0;52,0;2,0;36,0;9,0;;3,0;;8,0;1,0;;;;;;66,0;11,0;18,0;6,0;47,0;1,0;;;;;10,0;212,0;;1,0;13,0;1,0;;11,0;;24,0;;;;24,0;7,0;;;32,0;15,0;3,0;;;;1,0;;;49,0;10,0;2,0;1,0;;;;;;;;;;;;;;1,0;;3,0;5,0;1,0;;;;3,0;;;48,0;;;;10,0;3,0;1,0;3,0;;;3,0;;1,0;12,0;;;1,0;;;23,0;;2,0;;1,0;1,0;;;1,0;;3,0;4,0;;4,0;13,0;3,0;;1,0;2,0;8,0;11,0;;;3,0;2,0;1,0;;17,0;2,0;;1,0;14,0;;1,0;;;1,0;2,0;;;;9,0;;;;;;1,0;17,0;;;;;1,0;;;2,0;1,0;3,0;;1,0;;;;51,0;;14,0;1,0;1,0;14,0;2,0;6,0;;;;;;1,0;;;2,0;2,0;2,0;;;;10,0;12,0;2,0;;;;;;1,0;;;4,0;;;9,0;1,0;17,0;;2,0;3,0;1,0;1,0;;;6,0;12,0;;;;13,0;50,0;29,0;5,0;;;2,0;;4,0;;;3,0;5,0;;;1,0;18,0;1,0;;;;4,0;;1,0;;5,0;1,0;4,0;;;4,0;2,0;;;;29,0;;;;;;;24,0;1,0;;1,0;3,0;3,0;;1,0;;;;;;;;;;;;5,0;3,0;;3,0;;1,0;;;;;2,0;;;3,0;;1,0;2,0;;;4,0;;;1,0;2,0;6,0;;53,0;2,0;;;54,0;;;;;;;;1,0;;3,0;2,0;;;1,0;;5,0;;6,0;;;6,0;;;;;3,0;;;3,0;;1,0;;;1,0;5,0;;;;;;12,0;;;;8,0;;;;;;;;;8,0;;;3,0;;;;;;;2,0;4,0;;1,0;;;;;;;2,0;;;;;3,0;;;1,0;;;;;;;;;;3,0;;;;1,0;;;;;;;;;;;2,0;;;;;3,0;2,0;;;;;;;1,0;;;;;;;;;1,0;1,0;;1,0;;;1,0;;;;;;;;;;;;;;;;;;;;;;;;;;2,0;;;2,0;2,0;;;;;;;;;1,0;;;;;;;;;;3,0;1,0;;3,0;;;;;;;;;1,0;;;;;;;;;;;1,0;4,0;;;;;;;;;;;;;;;;;;;;6,0;;;;12,0;1,0;;;;1,0;;;;;;;6,0;;;;;;10,0;;1,0;2,0;;;;;11,0;;;;;;;12,0;;;;1,0;;;;;;;;1,0;;5,0;7,0;;;;;2,0;;;;;;;;;;;2,0;;;;;;;;;;;;;;1,0;;;;;;;;;;;2,0;;;;1,0;;;1,0;;3,0;;;;;;;;;;;;;;;5,0;;;;;;;1,0;;;;;;5,0;;1,0;;;;1,0;;1,0;;;4,0;;;;7,0;;;;1,0;;;;;3,0;;2,0;1,0;2,0;;1,0;;2,0;;;;;;;;;1,0;;;;11,0;1,0;;;3,0;;;;;;;1,0;;;;;;;5,0;;;2,0;;;;1,0;;3,0;;;;5,0;;;;;1,0;;;;;;;2,0;;;4,0;;;;;;;;;;;;;;;;;;;1,0;;;;;1,0;;;;;;;;;;;;;;;;;;;;;;;1,0;;;;;;;;;1,0;;;;;;1,0;;1,0;;;;;;;;;1,0;;;;;;;;1,0;3,0;;;;;;;;;;;;;;1,0;;;;19,0;;;;;;;;;;;;;;;;;;;;;;;;;;;;;;;1,0;;;;;;;;2,0;;;8,0;;;;8,0;;;;;;;;;;;;;;;;;;;;;;;;;;;;3,0;;;;;;;;
storage;2,0;15,0;5,0;2,0;2,0;11,0;12,0;136,0;51,0;26,0;10,0;;19,0;3,0;13,0;38,0;;;11,0;2,0;8,0;83,0;10,0;4,0;2,0;14,0;29,0;14,0;;;298,0;15,0;142,0;1,0;193,0;37,0;14,0;33,0;15,0;;615,0;;;7,0;65,0;20,0;92,0;1014,0;131,0;93,0;8,0;48,0;1,0;1,0;34,0;1,0;18,0;3,0;7,0;21,0;2,0;25,0;5,0;39,0;15,0;4,0;32,0;5,0;33,0;2,0;9,0;2,0;40,0;6,0;1,0;13,0;27,0;3,0;4,0;931,0;7,0;94,0;;154,0;;270,0;26,0;1,0;;2,0;96,0;1,0;5,0;1,0;1,0;954,0;199,0;24,0;105,0;12,0;7,0;4,0;36,0;46,0;;33,0;87,0;8,0;56,0;55,0;3,0;23,0;8,0;4,0;1,0;132,0;80,0;82,0;40,0;44,0;2,0;1,0;30,0;102,0;118,0;142,0;2,0;8,0;;25,0;;30,0;1,0;5,0;5,0;24,0;13,0;23,0;12,0;;28,0;7,0;7,0;71,0;41,0;4,0;2,0;7,0;125,0;4,0;5,0;;;1115,0;40,0;10,0;190,0;;3,0;55,0;486,0;33,0;650,0;2,0;1,0;;151,0;14,0;;;7,0;;;3,0;7,0;4,0;1,0;1,0;;;14,0;48,0;;;34,0;131,0;;10,0;;;17,0;2,0;;34,0;3,0;3,0;15,0;;1,0;5,0;1,0;12,0;12,0;8,0;6,0;;1,0;8,0;12,0;19,0;2,0;5,0;;1,0;;;;;2,0;6,0;24,0;1,0;;33,0;2,0;;23,0;;15,0;;3,0;;;6,0;1,0;3,0;1,0;1,0;2,0;;;1,0;;;;4,0;7,0;4,0;70,0;1,0;1,0;;;2,0;2,0;;96,0;;;;;;24,0;52,0;6,0;;2,0;;7,0;;;20,0;14,0;;;;9,0;15,0;;12,0;10,0;1,0;10,0;1,0;9,0;56,0;2,0;2,0;;;6,0;1,0;;;;4,0;;;1,0;;;8,0;13,0;;;3,0;;;;;11,0;1,0;1,0;;1,0;17,0;2,0;11,0;;51,0;;;;;7,0;;;1,0;;;;;;1,0;;24,0;;2,0;42,0;18,0;;;30,0;1,0;43,0;2,0;2,0;3,0;10,0;6,0;;;4,0;10,0;;;8,0;10,0;10,0;;;1,0;4,0;;;;;1,0;;;4,0;1,0;;2,0;;;;;2,0;1,0;;;7,0;;1,0;2,0;;;;2,0;1,0;33,0;3,0;15,0;1,0;20,0;;2,0;1,0;2,0;1,0;;22,0;12,0;;;2,0;;5,0;31,0;10,0;26,0;25,0;;14,0;4,0;;15,0;1,0;1,0;;2,0;28,0;14,0;3,0;;;26,0;;5,0;;49,0;4,0;1,0;69,0;1,0;;2,0;43,0;;9,0;19,0;11,0;1,0;59,0;43,0;134,0;;8,0;9,0;11,0;;;42,0;5,0;112,0;17,0;8,0;;10,0;7,0;;2,0;20,0;1,0;;;;9,0;3,0;1,0;;;5,0;33,0;4,0;7,0;1,0;61,0;;16,0;1,0;2,0;1,0;7,0;13,0;1,0;1,0;5,0;18,0;20,0;3,0;14,0;44,0;2,0;4,0;2,0;5,0;54,0;5,0;;2,0;21,0;15,0;34,0;1,0;2,0;;24,0;16,0;1,0;16,0;;1,0;27,0;1,0;;;;11,0;2,0;10,0;4,0;11,0;;9,0;16,0;;3,0;2,0;11,0;5,0;5,0;24,0;;;17,0;7,0;4,0;3,0;5,0;;1,0;;5,0;3,0;1,0;26,0;;15,0;4,0;;3,0;20,0;27,0;3,0;;3,0;1,0;8,0;9,0;1,0;2,0;76,0;4,0;11,0;2,0;17,0;8,0;14,0;4,0;6,0;9,0;3,0;;4,0;1,0;8,0;6,0;1,0;2,0;;1,0;1,0;22,0;3,0;1,0;2,0;;5,0;24,0;2,0;;1,0;2,0;;6,0;5,0;;1,0;18,0;14,0;93,0;8,0;;2,0;2,0;;;;5,0;2,0;6,0;;15,0;;;5,0;10,0;201,0;22,0;1,0;;4,0;1,0;7,0;31,0;47,0;33,0;1,0;2,0;;6,0;1,0;14,0;4,0;3,0;;22,0;1,0;2,0;6,0;22,0;3,0;3,0;;16,0;;7,0;;1,0;20,0;16,0;;1,0;13,0;;2,0;;1,0;;4,0;;;9,0;2,0;;1,0;;;;;3,0;;1,0;2,0;;;;;;;6,0;;;7,0;2,0;1,0;;;2,0;;;;1,0;2,0;;;12,0;;;;;3,0;;;8,0;27,0;;;;;1,0;4,0;;;;;;;4,0;;;;5,0;;;1,0;;;6,0;5,0;3,0;;2,0;1,0;13,0;;;5,0;4,0;;;5,0;;;1,0;;;1,0;;3,0;;;;;;;45,0;9,0;2,0;2,0;;;7,0;2,0;3,0;1,0;3,0;8,0;3,0;1,0;28,0;7,0;4,0;;;1,0;4,0;10,0;4,0;7,0;;1,0;4,0;1,0;1,0;;4,0;14,0;14,0;5,0;;1,0;1,0;1,0;2,0;;;;3,0;2,0;1,0;4,0;;4,0;1,0;;;7,0;2,0;3,0;;4,0;1,0;;;;2,0;;5,0;2,0;3,0;2,0;5,0;2,0;;1,0;1,0;1,0;;;;;1,0;3,0;;1,0;;;;;;;2,0;;1,0;4,0;;;1,0;1,0;12,0;4,0;2,0;5,0;51,0;2,0;1,0;;;2,0;3,0;4,0;;4,0;1,0;;;;;2,0;2,0;;;;2,0;;1,0;;;;;;;3,0;1,0;3,0;2,0;1,0;2,0;3,0;2,0;;;;;;4,0;1,0;2,0;3,0;5,0;;26,0;;;;;;2,0;2,0;;;1,0;;7,0;;;;2,0;;;8,0;;33,0;;10,0;1,0;;2,0;2,0;20,0;;;;;1,0;2,0;;;;1,0;;2,0;;1,0;;;;;1,0;2,0;3,0;;;;3,0;;3,0;12,0;;;6,0;9,0;;3,0;;;;;;1,0;;2,0;1,0;;1,0;;;;1,0;;;;2,0;;2,0;1,0;;;;14,0;;;12,0;;5,0;3,0;
store;18,0;13,0;4,0;1,0;7,0;19,0;24,0;104,0;66,0;19,0;10,0;;101,0;43,0;7,0;165,0;4,0;25,0;26,0;6,0;58,0;314,0;6,0;4,0;8,0;13,0;42,0;3,0;27,0;1,0;194,0;38,0;433,0;1,0;216,0;68,0;29,0;83,0;23,0;;1172,0;;5,0;6,0;68,0;24,0;142,0;441,0;429,0;232,0;2,0;47,0;8,0;3,0;30,0;11,0;44,0;28,0;12,0;50,0;5,0;19,0;19,0;103,0;16,0;15,0;58,0;29,0;187,0;2,0;25,0;6,0;161,0;3,0;6,0;71,0;47,0;;7,0;2470,0;8,0;66,0;22,0;189,0;;373,0;27,0;11,0;;11,0;162,0;15,0;6,0;4,0;2,0;409,0;1110,0;36,0;316,0;13,0;50,0;40,0;119,0;99,0;3,0;54,0;84,0;19,0;110,0;144,0;9,0;127,0;9,0;9,0;46,0;217,0;135,0;204,0;11,0;84,0;;;72,0;279,0;236,0;333,0;9,0;13,0;5,0;31,0;4,0;100,0;17,0;3,0;35,0;45,0;37,0;30,0;33,0;5,0;19,0;3,0;15,0;87,0;35,0;15,0;;32,0;448,0;16,0;9,0;3,0;1115,0;;33,0;22,0;202,0;;5,0;42,0;93,0;78,0;777,0;4,0;3,0;;232,0;20,0;8,0;;21,0;;;1,0;45,0;14,0;10,0;;1,0;;9,0;34,0;;1,0;86,0;68,0;;50,0;4,0;;89,0;8,0;;19,0;1,0;4,0;59,0;1,0;;1,0;;19,0;32,0;26,0;2,0;;17,0;7,0;28,0;30,0;1,0;6,0;3,0;;;1,0;;;7,0;6,0;13,0;8,0;;;4,0;1,0;6,0;;90,0;;5,0;;6,0;19,0;1,0;8,0;14,0;5,0;;1,0;2,0;3,0;2,0;7,0;4,0;13,0;8,0;8,0;203,0;2,0;;;;2,0;2,0;5,0;178,0;4,0;;;;;1,0;84,0;6,0;24,0;1,0;5,0;30,0;;;70,0;10,0;;21,0;4,0;9,0;15,0;1,0;10,0;7,0;2,0;13,0;;8,0;139,0;3,0;5,0;;2,0;31,0;10,0;;;1,0;27,0;2,0;;;;4,0;16,0;4,0;;;;;8,0;;2,0;5,0;1,0;5,0;;;21,0;;3,0;4,0;33,0;3,0;;1,0;1,0;22,0;2,0;;;3,0;1,0;;;4,0;;;58,0;;19,0;9,0;3,0;;;7,0;16,0;7,0;7,0;1,0;5,0;24,0;10,0;;;1,0;12,0;;;3,0;58,0;17,0;4,0;7,0;7,0;1,0;;;;;;1,0;1,0;14,0;2,0;;2,0;5,0;;;;2,0;4,0;;;4,0;;8,0;8,0;;;2,0;9,0;3,0;52,0;13,0;95,0;;16,0;1,0;5,0;9,0;2,0;11,0;5,0;40,0;22,0;1,0;;4,0;;5,0;51,0;9,0;89,0;69,0;19,0;32,0;5,0;2,0;1,0;5,0;13,0;10,0;9,0;6,0;13,0;6,0;9,0;2,0;88,0;2,0;8,0;;93,0;11,0;6,0;97,0;1,0;57,0;14,0;58,0;;4,0;32,0;43,0;8,0;61,0;13,0;86,0;2,0;49,0;21,0;24,0;2,0;;44,0;14,0;110,0;5,0;;3,0;16,0;17,0;1,0;7,0;37,0;1,0;;3,0;5,0;23,0;22,0;;;10,0;22,0;138,0;6,0;11,0;;113,0;1,0;32,0;;3,0;8,0;24,0;48,0;;3,0;1,0;8,0;13,0;15,0;10,0;179,0;6,0;;8,0;6,0;27,0;4,0;4,0;5,0;17,0;64,0;63,0;1,0;1,0;;42,0;22,0;20,0;11,0;3,0;;21,0;3,0;9,0;;;2,0;2,0;11,0;7,0;13,0;;20,0;24,0;3,0;33,0;3,0;11,0;51,0;32,0;11,0;;;43,0;7,0;5,0;3,0;5,0;;3,0;18,0;2,0;20,0;11,0;21,0;;18,0;1,0;;8,0;45,0;51,0;13,0;5,0;6,0;;6,0;18,0;7,0;13,0;140,0;5,0;39,0;18,0;18,0;19,0;20,0;96,0;107,0;9,0;;1,0;8,0;;;5,0;2,0;6,0;1,0;12,0;1,0;17,0;12,0;;;2,0;5,0;28,0;11,0;;13,0;5,0;4,0;2,0;11,0;8,0;;12,0;6,0;61,0;4,0;2,0;18,0;6,0;;;4,0;9,0;26,0;27,0;2,0;;;;18,0;;106,0;;2,0;1,0;6,0;9,0;4,0;44,0;101,0;13,0;7,0;7,0;;12,0;11,0;24,0;11,0;3,0;;18,0;6,0;11,0;1,0;26,0;5,0;33,0;;15,0;;11,0;1,0;2,0;27,0;6,0;2,0;;;1,0;3,0;2,0;1,0;2,0;11,0;2,0;2,0;11,0;5,0;;4,0;2,0;5,0;5,0;;5,0;1,0;;20,0;;;;2,0;2,0;2,0;7,0;;;3,0;9,0;9,0;42,0;;;9,0;;;;;;;11,0;;;;6,0;3,0;;2,0;4,0;24,0;;;;1,0;1,0;;;1,0;1,0;;;;8,0;3,0;;1,0;26,0;;1,0;13,0;;10,0;6,0;8,0;;3,0;1,0;5,0;13,0;;;3,0;12,0;;;12,0;;;3,0;;;5,0;2,0;3,0;1,0;;;2,0;;;18,0;5,0;8,0;2,0;;18,0;13,0;3,0;19,0;7,0;;2,0;12,0;;6,0;33,0;15,0;;1,0;;8,0;29,0;9,0;23,0;;;3,0;1,0;5,0;;9,0;44,0;8,0;5,0;5,0;1,0;2,0;;;5,0;2,0;4,0;5,0;3,0;1,0;7,0;;5,0;5,0;;4,0;17,0;6,0;26,0;;18,0;;;3,0;;;2,0;12,0;1,0;4,0;8,0;9,0;1,0;3,0;31,0;2,0;2,0;;33,0;;;10,0;1,0;;;;3,0;;;1,0;;1,0;6,0;3,0;1,0;;7,0;1,0;33,0;31,0;9,0;;3,0;1,0;4,0;14,0;3,0;;12,0;1,0;;;12,0;1,0;3,0;1,0;1,0;21,0;11,0;8,0;;2,0;;3,0;;1,0;;;;1,0;4,0;1,0;1,0;1,0;2,0;5,0;3,0;;32,0;2,0;;4,0;;1,0;33,0;18,0;2,0;6,0;5,0;1,0;;30,0;;1,0;;;;;;;;1,0;;11,0;;10,0;1,0;12,0;;;80,0;;142,0;;52,0;;;8,0;;17,0;2,0;3,0;;5,0;;13,0;3,0;1,0;;4,0;;1,0;;2,0;;;;1,0;3,0;4,0;2,0;;;;2,0;;;3,0;1,0;;8,0;10,0;;1,0;6,0;;;;;1,0;;1,0;2,0;4,0;7,0;;7,0;18,0;;;;12,0;2,0;11,0;1,0;2,0;6,0;11,0;;5,0;;;;;;9,0;
subject;2,0;;16,0;;15,0;19,0;11,0;107,0;134,0;15,0;8,0;;9,0;;11,0;247,0;;3,0;126,0;;3,0;330,0;9,0;1,0;;5,0;61,0;9,0;;;17,0;8,0;262,0;14,0;124,0;49,0;12,0;40,0;8,0;;283,0;2,0;2,0;36,0;315,0;103,0;175,0;247,0;49,0;213,0;23,0;243,0;9,0;5,0;18,0;25,0;92,0;3,0;51,0;;3,0;7,0;32,0;1,0;5,0;16,0;183,0;286,0;59,0;1,0;6,0;101,0;148,0;2,0;;11,0;27,0;151,0;71,0;2249,0;7,0;311,0;5,0;161,0;6,0;8,0;22,0;10,0;;11,0;191,0;11,0;2,0;7,0;11,0;6,0;9,0;17,0;177,0;1,0;26,0;;47,0;14,0;5,0;51,0;430,0;18,0;62,0;11,0;21,0;33,0;2,0;30,0;2,0;107,0;97,0;223,0;3,0;74,0;2,0;1,0;30,0;111,0;23,0;33,0;;7,0;;46,0;;52,0;8,0;;70,0;22,0;;14,0;13,0;3,0;53,0;;2,0;116,0;19,0;26,0;;48,0;207,0;84,0;9,0;;40,0;33,0;;;251,0;;4,0;1,0;8,0;14,0;439,0;1,0;11,0;;65,0;84,0;34,0;1,0;20,0;;;15,0;68,0;3,0;10,0;;;;;75,0;4,0;;1,0;5,0;;8,0;;;;1,0;4,0;11,0;;3,0;2,0;6,0;5,0;;2,0;;21,0;40,0;4,0;2,0;7,0;;56,0;93,0;3,0;;;;;1,0;;1,0;;;12,0;21,0;;1,0;;;4,0;;461,0;;10,0;;23,0;34,0;15,0;31,0;61,0;8,0;8,0;1,0;8,0;;3,0;34,0;6,0;1,0;27,0;;105,0;24,0;1,0;;;1,0;;6,0;61,0;45,0;;;;;;52,0;;5,0;32,0;;23,0;;;3,0;14,0;;1,0;;3,0;1,0;7,0;35,0;2,0;;1,0;;1,0;93,0;;;7,0;;10,0;;16,0;;1,0;;2,0;;4,0;;;23,0;3,0;;3,0;;;4,0;;1,0;;40,0;;;22,0;21,0;;;12,0;5,0;;;5,0;;18,0;2,0;;;12,0;10,0;;;;;;4,0;2,0;59,0;11,0;;;;3,0;3,0;;;;4,0;;;;2,0;9,0;55,0;;1,0;3,0;14,0;6,0;;11,0;35,0;2,0;;;;;7,0;;3,0;3,0;;;3,0;7,0;;;;2,0;;1,0;;1,0;3,0;;12,0;;;8,0;4,0;4,0;94,0;20,0;3,0;;1,0;;1,0;1,0;2,0;;;1,0;12,0;3,0;;2,0;;24,0;82,0;51,0;6,0;14,0;3,0;13,0;;8,0;15,0;14,0;;;10,0;48,0;65,0;;;2,0;49,0;1,0;;1,0;57,0;25,0;;51,0;8,0;18,0;39,0;41,0;4,0;19,0;91,0;77,0;;2,0;4,0;75,0;2,0;6,0;12,0;244,0;;;;21,0;32,0;5,0;;;2,0;15,0;;2,0;34,0;;;6,0;;11,0;137,0;34,0;;9,0;4,0;34,0;1,0;11,0;2,0;3,0;2,0;70,0;2,0;2,0;4,0;12,0;;;1,0;3,0;7,0;;3,0;15,0;29,0;3,0;;1,0;6,0;;1,0;5,0;;1,0;167,0;18,0;17,0;22,0;;63,0;5,0;13,0;15,0;12,0;;14,0;4,0;;;34,0;;42,0;;;18,0;1,0;1,0;3,0;;4,0;1,0;;2,0;;;2,0;;42,0;;3,0;4,0;21,0;;;2,0;6,0;19,0;3,0;;;11,0;;;10,0;1,0;;5,0;7,0;;;2,0;1,0;14,0;;18,0;;;1,0;7,0;;;101,0;;8,0;;;6,0;;1,0;1,0;4,0;3,0;;12,0;18,0;46,0;4,0;;9,0;;;10,0;;;3,0;;;;;17,0;2,0;16,0;;1,0;2,0;;7,0;;;;3,0;3,0;2,0;17,0;;;;;16,0;;;2,0;;;27,0;16,0;;166,0;4,0;;;;;;8,0;;;;;;;30,0;1,0;;;;4,0;;;22,0;1,0;;;2,0;;3,0;;2,0;5,0;1,0;;2,0;;;4,0;25,0;;;3,0;;18,0;22,0;4,0;32,0;1,0;3,0;;1,0;;;3,0;;1,0;50,0;1,0;;;2,0;1,0;;;;2,0;;;1,0;1,0;2,0;3,0;13,0;;;;;10,0;;;7,0;39,0;;;;;4,0;;1,0;;;1,0;3,0;;16,0;2,0;3,0;;;1,0;;;1,0;;5,0;;;;33,0;;;4,0;;3,0;3,0;;1,0;3,0;;2,0;1,0;;;4,0;;1,0;;;;;;;13,0;;;;;;11,0;4,0;24,0;2,0;;1,0;;1,0;56,0;23,0;;;;2,0;8,0;18,0;;;;;;6,0;12,0;1,0;17,0;1,0;11,0;1,0;;8,0;;;;3,0;12,0;11,0;;11,0;2,0;32,0;3,0;2,0;1,0;;38,0;;2,0;8,0;;10,0;;;1,0;;;2,0;2,0;1,0;4,0;3,0;3,0;;;1,0;16,0;;1,0;16,0;;12,0;2,0;5,0;;;;14,0;;;1,0;2,0;7,0;9,0;;2,0;;1,0;26,0;;;14,0;2,0;;;113,0;10,0;4,0;1,0;;;;;1,0;;30,0;1,0;;1,0;;2,0;;1,0;;1,0;;2,0;;;;1,0;;1,0;3,0;;;;2,0;2,0;;1,0;;;;1,0;;23,0;;30,0;;4,0;5,0;1,0;;;;2,0;;1,0;5,0;;11,0;1,0;22,0;2,0;1,0;3,0;3,0;;;;;;5,0;;8,0;14,0;;2,0;1,0;;;;;;;;5,0;;;;4,0;3,0;;1,0;;5,0;;;5,0;11,0;;;;;;;;;7,0;;2,0;;5,0;1,0;3,0;;;;;6,0;;;7,0;;2,0;;1,0;;24,0;4,0;11,0;;;;;3,0;;1,0;;;14,0;;;1,0;;;
supply;2,0;34,0;;1,0;;;;114,0;20,0;13,0;9,0;;2,0;;;41,0;;;1,0;;4,0;4,0;2,0;4,0;;;3,0;;;;5,0;5,0;139,0;;269,0;43,0;;20,0;;;56,0;;3,0;;3,0;26,0;15,0;89,0;29,0;19,0;6,0;;2,0;8,0;78,0;;70,0;;;;10,0;11,0;2,0;;5,0;1,0;24,0;11,0;4,0;2,0;6,0;3,0;69,0;15,0;;4,0;4,0;;5,0;106,0;2,0;29,0;;99,0;10,0;;39,0;;;8,0;93,0;;3,0;4,0;;15,0;2,0;;41,0;1,0;;;47,0;2,0;;9,0;15,0;5,0;52,0;4,0;4,0;25,0;;2,0;6,0;51,0;50,0;8,0;908,0;73,0;;;7,0;30,0;5,0;;;8,0;;;1,0;67,0;1,0;2,0;8,0;1,0;9,0;3,0;22,0;;;1,0;2,0;21,0;20,0;;;3,0;313,0;3,0;;1,0;10,0;22,0;;;147,0;;;38,0;1,0;6,0;187,0;;;;13,0;;;;;;;2,0;3,0;;4,0;2,0;;;12,0;68,0;;;21,0;82,0;;7,0;;;;;;138,0;;64,0;;;3,0;1,0;;;9,0;13,0;1,0;;60,0;7,0;;16,0;3,0;;3,0;36,0;;1,0;;3,0;2,0;1,0;14,0;3,0;;;;;8,0;;45,0;;9,0;;;11,0;4,0;7,0;1,0;14,0;;2,0;;2,0;;;10,0;;6,0;;114,0;1,0;7,0;;;;;51,0;25,0;1,0;;;;;1,0;22,0;7,0;;;1,0;15,0;2,0;1,0;73,0;;;;8,0;6,0;2,0;13,0;1,0;53,0;;117,0;;;31,0;;6,0;;;11,0;13,0;2,0;;;43,0;;;70,0;;16,0;1,0;4,0;;;;36,0;9,0;;;;16,0;;;6,0;;;29,0;;13,0;;2,0;;;79,0;;1,0;;;;;;;5,0;;8,0;34,0;1,0;73,0;2,0;2,0;;1,0;10,0;;7,0;;15,0;5,0;9,0;;;;14,0;13,0;;;11,0;5,0;9,0;;;1,0;3,0;;;18,0;;;3,0;;;;;;;3,0;;1,0;;;;;2,0;;;;;9,0;3,0;;5,0;;1,0;;2,0;;3,0;;;;;;8,0;;;1,0;;6,0;8,0;8,0;3,0;14,0;;;13,0;;;9,0;;;;3,0;2,0;3,0;;;;;;;50,0;11,0;2,0;;;;1,0;59,0;;2,0;;1,0;2,0;;27,0;39,0;1,0;3,0;16,0;;;;6,0;1,0;4,0;1,0;;8,0;;3,0;;1,0;2,0;;2,0;23,0;;;;;;;1,0;12,0;2,0;6,0;;494,0;;18,0;;;;;4,0;;;;1,0;4,0;2,0;;;;1,0;;;5,0;;12,0;1,0;1,0;1,0;16,0;2,0;;;11,0;;;;;2,0;;;;1,0;6,0;;7,0;;32,0;18,0;;;;15,0;;3,0;;;3,0;11,0;;;8,0;;;5,0;2,0;3,0;;;;;1,0;9,0;;20,0;12,0;;3,0;;2,0;2,0;;29,0;;;;1,0;10,0;;;;1,0;13,0;2,0;;9,0;;;;6,0;9,0;2,0;;1,0;;;;;14,0;2,0;34,0;;;;;2,0;;;;;;2,0;;;7,0;;2,0;25,0;;4,0;;;;;;3,0;;;6,0;12,0;;;;2,0;;3,0;;;;;;10,0;2,0;2,0;;50,0;2,0;;3,0;2,0;;1,0;2,0;;;1,0;3,0;2,0;;;1,0;;7,0;;1,0;11,0;6,0;;1,0;;1,0;;;1,0;5,0;45,0;69,0;;2,0;32,0;2,0;;;;5,0;33,0;2,0;15,0;;;;;;;;;6,0;11,0;;;3,0;;4,0;7,0;1,0;;2,0;;;;;;45,0;35,0;1,0;;;5,0;;;;5,0;;;;;;;;;1,0;;;;;22,0;5,0;2,0;;1,0;35,0;7,0;18,0;;;;2,0;;;4,0;;5,0;2,0;;4,0;1,0;;6,0;;;;;;;;9,0;;;1,0;;11,0;;;3,0;;;10,0;1,0;20,0;;;;17,0;4,0;;2,0;32,0;;2,0;5,0;8,0;1,0;;;;29,0;;;;1,0;;;;;;;;89,0;12,0;;1,0;;;;;;;2,0;;;;;;;;;4,0;;;;3,0;;1,0;;;;;5,0;;64,0;30,0;;;;;;;;;;;;2,0;;;;;;;;;;1,0;;7,0;;;;;;;;;;;3,0;;;;;;;;;;;;13,0;;;;;;;;;;;1,0;;;;;;;3,0;;;1,0;4,0;;;;3,0;6,0;;;5,0;;;;;;;;;;3,0;1,0;;;;2,0;;;;;;4,0;;;;12,0;;;;;;;1,0;;4,0;;;;;;;;1,0;3,0;;;1,0;;;2,0;;;;;;;;;3,0;;;;2,0;;;1,0;;;;;;;;;;;;;;;;7,0;;1,0;;;;;;;1,0;2,0;;;;2,0;;
system;37,0;113,0;12,0;34,0;41,0;134,0;127,0;517,0;181,0;193,0;215,0;10,0;168,0;7,0;481,0;377,0;104,0;71,0;7,0;116,0;257,0;784,0;28,0;34,0;37,0;6,0;231,0;57,0;32,0;39,0;423,0;580,0;1176,0;17,0;1207,0;319,0;52,0;119,0;32,0;14,0;909,0;6,0;250,0;107,0;300,0;291,0;521,0;1515,0;742,0;700,0;135,0;332,0;33,0;16,0;153,0;37,0;636,0;39,0;87,0;15,0;75,0;95,0;188,0;35,0;162,0;1530,0;338,0;744,0;193,0;83,0;125,0;72,0;335,0;26,0;17,0;179,0;107,0;123,0;387,0;3823,0;133,0;1602,0;49,0;1930,0;37,0;197,0;283,0;;3,0;1181,0;5124,0;25,0;26,0;56,0;102,0;44,0;286,0;21,0;1192,0;122,0;82,0;48,0;476,0;782,0;91,0;160,0;3855,0;275,0;271,0;165,0;56,0;256,0;8,0;3,0;32,0;640,0;407,0;783,0;469,0;159,0;3,0;23,0;126,0;776,0;563,0;158,0;10,0;11,0;33,0;135,0;6,0;254,0;171,0;16,0;54,0;70,0;56,0;151,0;30,0;578,0;146,0;162,0;45,0;763,0;123,0;6,0;3,0;347,0;892,0;59,0;13,0;12,0;190,0;202,0;251,0;147,0;;486,0;33,0;62,0;23,0;182,0;1528,0;7,0;48,0;77,0;788,0;338,0;61,0;45,0;2804,0;7,0;10,0;39,0;138,0;66,0;180,0;53,0;10,0;10,0;67,0;435,0;4,0;3,0;22,0;222,0;;242,0;107,0;9,0;35,0;30,0;6,0;237,0;34,0;214,0;80,0;2,0;6,0;92,0;18,0;26,0;32,0;218,0;16,0;8,0;177,0;17,0;83,0;78,0;17,0;16,0;11,0;24,0;21,0;4,0;5,0;20,0;27,0;4,0;327,0;78,0;13,0;16,0;21,0;386,0;11,0;3,0;1089,0;6,0;199,0;7,0;452,0;616,0;79,0;148,0;154,0;69,0;29,0;40,0;23,0;25,0;10,0;211,0;29,0;;50,0;63,0;344,0;135,0;55,0;69,0;6,0;3,0;11,0;36,0;456,0;76,0;22,0;44,0;4,0;;36,0;201,0;14,0;20,0;60,0;3,0;114,0;1,0;10,0;297,0;80,0;5,0;11,0;17,0;15,0;166,0;72,0;361,0;141,0;30,0;44,0;11,0;11,0;253,0;2,0;67,0;13,0;26,0;638,0;27,0;55,0;3,0;39,0;6,0;14,0;26,0;9,0;3,0;171,0;39,0;128,0;14,0;30,0;22,0;3,0;73,0;20,0;9,0;33,0;35,0;96,0;2,0;69,0;21,0;5,0;49,0;8,0;223,0;11,0;39,0;22,0;22,0;130,0;34,0;42,0;20,0;5,0;20,0;23,0;33,0;8,0;14,0;5,0;47,0;27,0;100,0;70,0;36,0;;;21,0;151,0;1275,0;24,0;32,0;54,0;56,0;78,0;1,0;51,0;52,0;278,0;4,0;41,0;132,0;245,0;86,0;88,0;28,0;50,0;27,0;9,0;6,0;11,0;2,0;59,0;4,0;49,0;24,0;13,0;10,0;33,0;3,0;8,0;16,0;6,0;86,0;86,0;30,0;9,0;22,0;23,0;13,0;30,0;2,0;4,0;;283,0;44,0;239,0;44,0;16,0;15,0;78,0;19,0;24,0;50,0;14,0;45,0;52,0;43,0;97,0;103,0;27,0;4,0;32,0;19,0;119,0;99,0;67,0;39,0;72,0;158,0;11,0;34,0;8,0;5,0;8,0;8,0;16,0;127,0;41,0;8,0;18,0;7,0;113,0;9,0;12,0;111,0;187,0;90,0;62,0;140,0;5,0;38,0;123,0;315,0;14,0;182,0;221,0;97,0;38,0;174,0;294,0;228,0;24,0;96,0;45,0;214,0;10,0;2,0;39,0;58,0;172,0;181,0;74,0;7,0;11,0;78,0;43,0;24,0;42,0;72,0;15,0;14,0;66,0;102,0;165,0;17,0;22,0;50,0;26,0;394,0;41,0;40,0;47,0;61,0;16,0;156,0;64,0;49,0;103,0;1032,0;13,0;17,0;18,0;58,0;97,0;2,0;66,0;70,0;93,0;19,0;27,0;71,0;32,0;197,0;17,0;116,0;34,0;43,0;367,0;53,0;6,0;87,0;6,0;60,0;6,0;20,0;101,0;10,0;18,0;66,0;19,0;21,0;22,0;18,0;20,0;78,0;47,0;136,0;134,0;23,0;14,0;35,0;60,0;5,0;101,0;48,0;15,0;87,0;107,0;9,0;92,0;66,0;33,0;11,0;23,0;17,0;19,0;8,0;16,0;6,0;72,0;24,0;48,0;15,0;58,0;8,0;56,0;60,0;65,0;19,0;75,0;34,0;29,0;124,0;36,0;19,0;27,0;42,0;50,0;7,0;73,0;45,0;390,0;53,0;41,0;211,0;22,0;57,0;15,0;29,0;60,0;14,0;21,0;53,0;13,0;14,0;14,0;20,0;77,0;83,0;8,0;30,0;43,0;92,0;62,0;34,0;12,0;4,0;20,0;37,0;17,0;31,0;18,0;48,0;9,0;119,0;71,0;42,0;38,0;7,0;123,0;17,0;1,0;7,0;6,0;2,0;52,0;17,0;20,0;15,0;6,0;1,0;43,0;29,0;11,0;23,0;21,0;19,0;53,0;19,0;8,0;117,0;17,0;30,0;9,0;10,0;5,0;11,0;34,0;91,0;20,0;39,0;7,0;57,0;22,0;13,0;59,0;217,0;21,0;9,0;6,0;27,0;24,0;138,0;12,0;10,0;268,0;7,0;13,0;41,0;53,0;20,0;4,0;7,0;5,0;26,0;9,0;21,0;29,0;35,0;11,0;16,0;60,0;30,0;64,0;127,0;37,0;28,0;27,0;45,0;18,0;10,0;24,0;14,0;5,0;9,0;12,0;73,0;61,0;6,0;51,0;13,0;30,0;7,0;26,0;15,0;46,0;4,0;17,0;10,0;21,0;26,0;15,0;25,0;15,0;400,0;7,0;66,0;14,0;3,0;6,0;8,0;33,0;6,0;10,0;22,0;3,0;10,0;40,0;1,0;19,0;18,0;9,0;3,0;;9,0;26,0;7,0;28,0;13,0;10,0;7,0;44,0;11,0;13,0;1,0;22,0;33,0;22,0;70,0;10,0;108,0;10,0;20,0;9,0;20,0;1,0;12,0;32,0;7,0;1,0;14,0;25,0;15,0;37,0;1,0;9,0;22,0;10,0;4,0;12,0;17,0;4,0;50,0;6,0;7,0;5,0;2,0;20,0;7,0;40,0;2,0;29,0;2,0;20,0;8,0;8,0;40,0;43,0;5,0;6,0;7,0;21,0;51,0;30,0;22,0;16,0;7,0;9,0;8,0;10,0;118,0;5,0;10,0;82,0;9,0;77,0;5,0;13,0;11,0;;;11,0;24,0;67,0;28,0;116,0;24,0;20,0;10,0;9,0;39,0;1,0;11,0;41,0;68,0;6,0;229,0;25,0;8,0;8,0;11,0;5,0;4,0;2,0;117,0;5,0;51,0;21,0;41,0;7,0;6,0;6,0;16,0;9,0;28,0;35,0;14,0;70,0;14,0;64,0;13,0;19,0;2,0;13,0;26,0;15,0;227,0;7,0;20,0;13,0;48,0;9,0;26,0;9,0;12,0;3,0;39,0;12,0;20,0;23,0;37,0;16,0;51,0;20,0;6,0;6,0;1,0;9,0;9,0;21,0;6,0;11,0;9,0;6,0;3,0;21,0;17,0;89,0;12,0;9,0;1,0;20,0;6,0;18,0;16,0;6,0;7,0;38,0;19,0;;6,0;32,0;6,0;9,0;50,0;20,0;29,0;2,0;35,0;13,0;5,0;7,0;18,0;52,0;47,0;4,0;23,0;4,0;33,0;3,0;4,0;47,0;6,0;2,0;2,0;14,0;12,0;;107,0;13,0;22,0;27,0;7,0;12,0;45,0;20,0;12,0;14,0;1,0;34,0;17,0;12,0;2,0;15,0;17,0;31,0;19,0;8,0;6,0;17,0;;10,0;3,0;6,0;20,0;4,0;1,0;18,0;59,0;6,0;14,0;;12,0;2,0;4,0;23,0;46,0;20,0;12,0;7,0;17,0;6,0;2,0;3,0;7,0;3,0;11,0;27,0;4,0;2,0;3,0;40,0;;12,0;5,0;4,0;18,0;9,0;42,0;9,0;2,0;12,0;4,0;13,0;6,0;58,0;3,0;3,0;47,0;9,0;15,0;6,0;18,0;18,0;8,0;;11,0;6,0;6,0;2,0;3,0;2,0;6,0;6,0
telephoto;1,0;;;;;65,0;2,0;;1,0;2,0;;;;;2,0;1,0;2,0;;;;;;;;;;;2,0;;;;15,0;2,0;;;;1,0;;;;;;1,0;;;;1,0;6,0;;;;40,0;;;;;;;;;;;2,0;;;367,0;40,0;;;;;1,0;;;;4,0;;;;169,0;;13,0;1,0;6,0;1,0;;;;7,0;825,0;373,0;;;;;;;;;;;;1,0;28,0;1,0;;8,0;;;1,0;;;;;;;;69,0;1,0;1,0;;;;;;;;;;;;;;;2,0;;;;;14,0;;;;2,0;;;;16,0;;;;;;;;;486,0;;;;;;185,0;;2,0;;1,0;41,0;;;367,0;;;;26,0;;;;;;;;;;;;;;;;;;;;;;;;;;;;;7,0;1,0;;;;;;;;;;;;;;7,0;;2,0;;;;;;;;2,0;;;;23,0;1,0;2,0;9,0;36,0;;;;;;;;;;;;;;;;;;;;;1,0;;;;;;;;1,0;2,0;;;;;;;;;;;;;6,0;;;;5,0;;81,0;;;;;;;;;;;;;;;;1,0;9,0;8,0;;;;;;;;;4,0;;3,0;2,0;;;1,0;;;;;;2,0;;;;;;;;;;;;;;;;;;;;1137,0;;;;;;;;;;;;;;;;;;;;;;;;;;;;;;;;;;;;1,0;;;;;;;;;;;;;;1,0;;;;;;;;;2,0;;;;;;;;;;;;;;;;;;;;;;;;;;;;;;;;;;;4,0;;;;;;;;;;;;;;;;;;;;;;1,0;;;1,0;;;;;;;;;;;;;1,0;;;;;;;5,0;;;;;;;;;;;;;;;;;;;;;;;;;;;;;;;;;;;;;;;2,0;;;;;;;;;;;;;;;48,0;;19,0;;;;5,0;;1,0;5,0;;;;;;;;;;;;;;;;;;;;;;;;5,0;;;;;1,0;;;;;;;;;;;;;;;;;;;;;;;;;1,0;;;;;;;;;;;;;;;;;;;;;;;;1,0;;;;;;;;;;;;;;;;;;;;;;;;;;;;;3,0;;;;;;;;;;1,0;;;;7,0;;2,0;;;;1,0;;;;;;;1,0;;;;;;;1,0;;;;;1,0;;;;;;;;;;;;;;;1,0;;;;;;;;;;;;;;;;;;;;;;;;;;;;;;;;;;;;;;;;;;;;;;;;;;;;;;;;;;;;;;;;;;;;;;;;27,0;;;;;;;;;;;1,0;;;;;;;;;2,0;;;;;;;;;;;51,0;;12,0;;;;;1,0;;;2,0;;;;;;;;;;;;;;;;;;;;;;;;;;;;;;;;;;;;;;;;;;;;;;;;;;;;;;;;;;;;;;;;;;;;;;1,0;;;;;;;;;;;;;;;;;;;;;;;;;;;;;1,0;;;;;;;;;;10,0;;;;;;;;;;;;;;;;;;;;;;;;;;;3,0;;;;;;;;;;;;;;;;;;;;;;;;;;;;;;;;;;;;;18,0;;;;;;
tilt;4,0;;3,0;;;381,0;7,0;55,0;15,0;15,0;;;15,0;;204,0;91,0;12,0;2,0;;1,0;10,0;17,0;16,0;;9,0;;3,0;2,0;;14,0;19,0;3,0;56,0;;149,0;20,0;23,0;8,0;5,0;1,0;16,0;;12,0;;20,0;8,0;65,0;77,0;11,0;55,0;3,0;10,0;4,0;1,0;101,0;2,0;11,0;7,0;9,0;;3,0;2,0;6,0;;1,0;17,0;7,0;21,0;52,0;3,0;14,0;1,0;22,0;1,0;3,0;4,0;3,0;7,0;2,0;110,0;8,0;37,0;3,0;107,0;6,0;40,0;5,0;16,0;1,0;25,0;154,0;;;;3,0;2,0;4,0;;81,0;2,0;5,0;;50,0;40,0;11,0;3,0;67,0;7,0;6,0;28,0;8,0;57,0;;;;43,0;62,0;120,0;1,0;27,0;4,0;;9,0;5,0;19,0;11,0;8,0;;;11,0;;29,0;64,0;1,0;12,0;;5,0;13,0;5,0;;;2,0;4,0;74,0;16,0;;;15,0;27,0;5,0;;;3,0;5,0;4,0;;33,0;;;;2,0;7,0;153,0;21,0;3,0;;20,0;14,0;;;138,0;;2,0;1,0;6,0;5,0;35,0;6,0;;;6,0;12,0;;;;8,0;;10,0;;;;;2,0;12,0;;4,0;6,0;;;14,0;;1,0;9,0;192,0;8,0;3,0;;;;26,0;;;3,0;;;;2,0;;7,0;3,0;20,0;;7,0;;;;;2,0;5,0;;25,0;;3,0;57,0;17,0;26,0;57,0;1,0;4,0;;2,0;5,0;;1,0;;;;4,0;25,0;55,0;13,0;;;;;;14,0;6,0;8,0;;;;;16,0;2,0;2,0;3,0;1,0;;;4,0;5,0;2,0;;;;3,0;6,0;4,0;11,0;;;1,0;1,0;;6,0;;1,0;13,0;;4,0;16,0;3,0;;14,0;;2,0;;1,0;1,0;4,0;13,0;65,0;;;1,0;2,0;1,0;9,0;3,0;;5,0;;;8,0;6,0;;1,0;1,0;32,0;1,0;;2,0;2,0;96,0;;3,0;5,0;;1,0;7,0;;;;2,0;;;3,0;6,0;1,0;3,0;13,0;1,0;3,0;1,0;2,0;;70,0;31,0;2,0;;22,0;1,0;14,0;;19,0;24,0;31,0;3,0;;;6,0;1,0;;3,0;;;1,0;;2,0;;;;;;;1,0;12,0;64,0;65,0;1,0;;;35,0;;15,0;;;;74,0;;42,0;5,0;;3,0;;;;1,0;;1,0;1,0;;6,0;2,0;;1,0;;;23,0;32,0;8,0;13,0;;12,0;1,0;;;;2,0;;4,0;26,0;1,0;;2,0;;;;3,0;;27,0;2,0;;9,0;;1,0;4,0;33,0;;18,0;46,0;47,0;;1,0;3,0;14,0;2,0;35,0;4,0;;4,0;;6,0;2,0;2,0;6,0;;32,0;;2,0;;;5,0;;1,0;;1,0;28,0;13,0;2,0;;;;13,0;;10,0;4,0;;;89,0;3,0;;10,0;77,0;;1,0;;2,0;3,0;;1,0;2,0;1,0;21,0;4,0;2,0;1,0;6,0;29,0;84,0;;;14,0;;;4,0;2,0;;;1,0;;10,0;;2,0;;;;;;;3,0;;14,0;6,0;3,0;;4,0;;;;2,0;1,0;;;;19,0;;;;;55,0;1,0;4,0;;1,0;2,0;1,0;4,0;4,0;;;;1,0;;10,0;1,0;;4,0;;;4,0;;3,0;2,0;9,0;;11,0;;;7,0;;1,0;2,0;1,0;1,0;;12,0;;;;;;20,0;;4,0;;;;;;;;2,0;;1,0;;;20,0;1,0;6,0;1,0;1,0;10,0;;1,0;2,0;;;1,0;3,0;;;1,0;;;;1,0;;1,0;;;;;;;9,0;2,0;;;;;;;1,0;;;5,0;;;1,0;;2,0;;;;1,0;6,0;32,0;;;;;3,0;16,0;;3,0;1,0;;64,0;;;;4,0;;3,0;;36,0;;;1,0;;;1,0;;;;;;;;;38,0;;;18,0;1,0;2,0;6,0;;3,0;;;;;3,0;;;;2,0;;;7,0;;12,0;2,0;;;7,0;;;;;12,0;;2,0;2,0;;;12,0;;1,0;;1,0;;39,0;;;1,0;1,0;;;1,0;;1,0;6,0;;1,0;;1,0;;;;6,0;;;;6,0;;;;;;;;21,0;;;;;;6,0;1,0;2,0;;4,0;;4,0;;;;;24,0;;;;1,0;6,0;4,0;12,0;3,0;;;;2,0;7,0;20,0;;;;2,0;;;7,0;14,0;;;;2,0;1,0;6,0;2,0;;;;;;;;;6,0;;;1,0;1,0;1,0;1,0;2,0;;;;;1,0;;;;;;1,0;;;;;;1,0;;;6,0;;;;;;;2,0;;2,0;;;;;;2,0;4,0;9,0;;;;1,0;;;;;;;;4,0;1,0;;8,0;;1,0;2,0;;2,0;3,0;;;;1,0;1,0;;;;2,0;;;;;;2,0;;1,0;;;;7,0;;;;;;;;1,0;4,0;;;;;1,0;;;;;2,0;11,0;4,0;;4,0;;19,0;4,0;17,0;35,0;;;1,0;;;;;;;1,0;;;;;;;;;;;;;;;1,0;2,0;3,0;;;;;1,0;;;;;;;;8,0;;1,0;;;4,0;;;;6,0;;;;1,0;;5,0;;;1,0;;;1,0;;;;;1,0;;;2,0;;;;;;
transfer;1,0;5,0;2,0;;;;1,0;9,0;62,0;63,0;58,0;;27,0;;3,0;33,0;;;8,0;;1,0;56,0;10,0;214,0;1,0;;4,0;3,0;3,0;;31,0;;138,0;4,0;241,0;11,0;;6,0;;2,0;668,0;9,0;3,0;1,0;11,0;;22,0;242,0;81,0;39,0;27,0;7,0;;22,0;172,0;2,0;105,0;3,0;4,0;;27,0;11,0;19,0;45,0;1,0;2,0;2,0;98,0;47,0;;159,0;4,0;64,0;3,0;;44,0;1,0;;1,0;469,0;;74,0;2,0;193,0;17,0;28,0;1,0;21,0;1,0;13,0;47,0;;3,0;7,0;2,0;8,0;24,0;;80,0;3,0;;;55,0;14,0;;11,0;7,0;18,0;148,0;1,0;;53,0;5,0;;20,0;305,0;83,0;19,0;23,0;46,0;6,0;;6,0;18,0;17,0;11,0;1,0;;1,0;8,0;1,0;10,0;1,0;;;4,0;51,0;18,0;6,0;2,0;7,0;;4,0;50,0;22,0;;;64,0;550,0;3,0;2,0;1,0;55,0;42,0;1,0;38,0;62,0;;;;;16,0;766,0;;2,0;;27,0;5,0;;24,0;;;;13,0;16,0;40,0;7,0;3,0;13,0;;6,0;2,0;;;370,0;93,0;;17,0;2,0;;7,0;;;173,0;;9,0;33,0;;;15,0;;;1,0;143,0;;;70,0;3,0;;1,0;19,0;;11,0;205,0;;;;32,0;6,0;12,0;3,0;5,0;1,0;;;;29,0;;42,0;;19,0;;;8,0;;4,0;7,0;10,0;10,0;;3,0;10,0;1,0;2,0;73,0;53,0;129,0;;145,0;;2,0;;1,0;1,0;;111,0;63,0;1,0;;;;;;31,0;20,0;;13,0;3,0;2,0;;;4,0;3,0;;;1,0;2,0;1,0;32,0;43,0;30,0;;7,0;2,0;;52,0;1,0;3,0;;1,0;;221,0;;;12,0;;1,0;1,0;25,0;;7,0;4,0;;;;;1,0;2,0;4,0;;;3,0;;3,0;3,0;6,0;;19,0;5,0;9,0;;;;;54,0;;1,0;;;4,0;;;;2,0;;13,0;;12,0;15,0;4,0;2,0;;;2,0;3,0;2,0;;1,0;20,0;3,0;3,0;2,0;;6,0;6,0;;7,0;7,0;;1,0;;1,0;;1,0;;;;;;;;1,0;;1,0;6,0;;13,0;;4,0;7,0;;;;6,0;3,0;4,0;;;7,0;3,0;4,0;;7,0;;;12,0;;30,0;;;;;3,0;17,0;;;4,0;;11,0;5,0;16,0;3,0;4,0;;2,0;;;1,0;10,0;;;;3,0;17,0;6,0;1,0;2,0;1,0;;8,0;;50,0;58,0;10,0;24,0;;12,0;3,0;14,0;65,0;2,0;2,0;6,0;;33,0;10,0;25,0;;;150,0;;;;;116,0;41,0;2,0;3,0;;;15,0;1,0;;8,0;;;4,0;;5,0;;;;1,0;;28,0;2,0;;;58,0;3,0;8,0;;;12,0;;23,0;;;;;24,0;;;9,0;;;;;9,0;;1,0;;19,0;13,0;17,0;2,0;2,0;;121,0;9,0;;2,0;;44,0;6,0;;;;1,0;;;2,0;1,0;1,0;;1,0;6,0;1,0;;2,0;;2,0;10,0;12,0;;;24,0;2,0;31,0;15,0;21,0;3,0;;4,0;;5,0;8,0;44,0;;14,0;19,0;;2,0;2,0;4,0;10,0;;2,0;;2,0;1,0;14,0;8,0;3,0;;61,0;8,0;86,0;9,0;;6,0;;4,0;;3,0;5,0;;;;;1,0;;;2,0;5,0;;;;2,0;9,0;3,0;;;2,0;;;8,0;;;;6,0;2,0;2,0;;;4,0;3,0;;82,0;1,0;2,0;;1,0;1,0;6,0;;;;86,0;;27,0;;;;;2,0;110,0;44,0;;;41,0;;;20,0;9,0;2,0;14,0;;1,0;4,0;12,0;;1,0;2,0;2,0;16,0;;;1,0;;2,0;52,0;5,0;;;;;2,0;2,0;;;43,0;;;98,0;7,0;;1,0;;;;1,0;;;;;;;;;;;15,0;;;283,0;1,0;23,0;12,0;;;;1,0;;;;;18,0;4,0;;;;1,0;;;8,0;1,0;;;1,0;;;;3,0;;;;;;;15,0;41,0;;2,0;6,0;;16,0;28,0;;;;1,0;;;1,0;2,0;2,0;;;;;4,0;1,0;3,0;;4,0;1,0;8,0;2,0;;;;;;;57,0;;;16,0;88,0;4,0;11,0;15,0;2,0;;1,0;13,0;32,0;10,0;22,0;63,0;542,0;;;58,0;1,0;;1,0;8,0;5,0;67,0;4,0;8,0;;;11,0;5,0;1,0;1,0;8,0;;;374,0;108,0;;2,0;1,0;2,0;;1,0;8,0;;;;;;1,0;;;;;7,0;;;;3,0;5,0;;;2,0;;;1,0;;15,0;;;;;;;3,0;;;2,0;;;;;;;1,0;;;5,0;;;7,0;;1,0;;3,0;1,0;;7,0;2,0;;;;;;12,0;;;;3,0;;;;2,0;;;;;;39,0;;;;;;;;1,0;;;;3,0;;;;;;;;;14,0;1,0;;2,0;2,0;;1,0;;2,0;5,0;3,0;;;;;;;;;;;5,0;;;;;;;;8,0;;;2,0;;;;13,0;;7,0;2,0;;;;;;;;;;;;;11,0;1,0;;;;;;;;;;;;2,0;;;6,0;;1,0;;;;1,0;;;;;;2,0;;1,0;;;;;;;;;52,0;;;;;4,0;;;;;;;
transitory;2,0;2,0;;;3,0;11,0;;13,0;28,0;1,0;5,0;;6,0;1,0;6,0;32,0;1,0;2,0;2,0;1,0;7,0;28,0;;3,0;;1,0;23,0;9,0;1,0;;418,0;3,0;3,0;1,0;22,0;;5,0;11,0;3,0;;58,0;;2,0;9,0;6,0;9,0;16,0;94,0;38,0;50,0;;17,0;2,0;1,0;;9,0;10,0;2,0;7,0;3,0;1,0;;3,0;1,0;3,0;2,0;11,0;4,0;46,0;1,0;5,0;;16,0;1,0;;14,0;4,0;1,0;3,0;244,0;1,0;7,0;1,0;21,0;1,0;52,0;1,0;1,0;;5,0;10,0;;4,0;;2,0;916,0;67,0;1,0;29,0;14,0;9,0;8,0;8,0;43,0;;;4,0;15,0;9,0;13,0;2,0;19,0;;;;35,0;19,0;27,0;2,0;16,0;;3,0;2,0;13,0;30,0;112,0;4,0;;1,0;13,0;;25,0;9,0;;6,0;2,0;6,0;7,0;8,0;1,0;31,0;2,0;;22,0;3,0;;;3,0;16,0;7,0;5,0;;486,0;93,0;8,0;1,0;23,0;;2,0;;;1,0;11,0;1,0;;;40,0;17,0;4,0;1,0;12,0;;;1,0;8,0;2,0;1,0;;;;;1,0;;;;;;8,0;;;;1,0;;1,0;1,0;;11,0;;;1,0;;;8,0;14,0;12,0;;;;9,0;9,0;1,0;3,0;;;;1,0;;;1,0;;;;;;1,0;;3,0;;9,0;1,0;;1,0;1,0;6,0;1,0;2,0;6,0;;1,0;;3,0;;;2,0;1,0;;;3,0;18,0;7,0;;;;;;;11,0;;;;;;1,0;24,0;;1,0;1,0;;2,0;;;8,0;8,0;;;;3,0;2,0;1,0;9,0;1,0;;2,0;;;35,0;;;;;3,0;2,0;1,0;;;;2,0;;;;;;;;;1,0;;1,0;;3,0;;;;;1,0;;;2,0;;5,0;;;;;;;;;;1,0;;;;1,0;;;1,0;;7,0;;;;1,0;1,0;1,0;;;;3,0;2,0;1,0;1,0;3,0;3,0;;1,0;;29,0;4,0;1,0;3,0;3,0;;1,0;;;;;;;1,0;;;1,0;;;;;1,0;6,0;;;1,0;;;1,0;;;;;;18,0;1,0;2,0;;1,0;;;5,0;;;;1,0;1,0;;;;;;6,0;6,0;13,0;2,0;9,0;6,0;1,0;1,0;;1,0;;;;;3,0;6,0;2,0;;12,0;;;;23,0;9,0;;17,0;1,0;5,0;;13,0;;4,0;12,0;8,0;;9,0;1,0;15,0;;12,0;9,0;2,0;;;9,0;7,0;58,0;1,0;4,0;;;;;;4,0;;;1,0;;15,0;7,0;;2,0;;6,0;33,0;3,0;15,0;8,0;;;2,0;3,0;2,0;3,0;8,0;1,0;;;2,0;2,0;;4,0;3,0;9,0;10,0;;;1,0;4,0;;2,0;1,0;3,0;6,0;7,0;;6,0;;1,0;;4,0;4,0;1,0;2,0;8,0;1,0;;;;;;;;3,0;3,0;8,0;4,0;;1,0;1,0;6,0;3,0;5,0;;1,0;;3,0;1,0;;2,0;;;;4,0;5,0;8,0;1,0;4,0;;4,0;;;4,0;5,0;;;;;;;1,0;5,0;1,0;3,0;;12,0;;9,0;1,0;2,0;;1,0;1,0;;1,0;;;;1,0;;;;;3,0;4,0;;11,0;7,0;;1,0;;;;;1,0;;1,0;7,0;1,0;;3,0;1,0;129,0;;;;1,0;;1,0;1,0;;2,0;;1,0;;3,0;;58,0;1,0;420,0;;1,0;;4,0;3,0;;10,0;1,0;;;;;;2,0;5,0;5,0;1,0;;;;3,0;;1,0;1,0;5,0;1,0;6,0;1,0;18,0;;1,0;3,0;;;;;;;;;;;5,0;1,0;1,0;;;1,0;;;;;1,0;1,0;1,0;;;;;;;2,0;2,0;;;3,0;;1,0;;;;2,0;;;;;;2,0;2,0;;;;;2,0;;;;2,0;;;;;2,0;;;;;;;;;;;;35,0;;;;;4,0;;2,0;;1,0;;;;;;1,0;1,0;;;2,0;;;;2,0;;;;;1,0;;;;1,0;;8,0;;1,0;;;;3,0;;;3,0;;1,0;;;1,0;3,0;;;1,0;2,0;5,0;2,0;3,0;;;1,0;1,0;1,0;2,0;1,0;;12,0;2,0;2,0;;3,0;3,0;;;;1,0;1,0;2,0;;;1,0;2,0;1,0;;;1,0;93,0;2,0;1,0;;3,0;1,0;;1,0;;;;1,0;2,0;1,0;6,0;;;;2,0;;;1,0;;1,0;;3,0;3,0;;;;1,0;;1,0;;;6,0;1,0;;;;;4,0;2,0;14,0;4,0;1,0;1,0;;;1,0;;;;;1,0;;6,0;;2,0;;;;;;;;;1,0;;;;1,0;;;;5,0;;;;;;1,0;5,0;;;2,0;;1,0;2,0;2,0;;;3,0;2,0;1,0;3,0;;;;;;;2,0;;;1,0;;2,0;;;2,0;;;;1,0;;2,0;;;;;1,0;;;;;;1,0;;;;1,0;;;;;;3,0;;;;;1,0;;1,0;;;1,0;;;5,0;;1,0;;1,0;;1,0;1,0;;;2,0;;;;;3,0;3,0;;;;;3,0;3,0;;;;2,0;;;2,0;;;;;1,0;;;;;2,0;
transmit;3,0;23,0;;9,0;1,0;6,0;18,0;112,0;31,0;15,0;23,0;;25,0;;9,0;64,0;39,0;;3,0;10,0;10,0;179,0;;57,0;1,0;;46,0;7,0;;;29,0;49,0;252,0;;342,0;91,0;;8,0;6,0;;523,0;;3,0;1,0;28,0;17,0;34,0;390,0;101,0;73,0;11,0;8,0;;2,0;89,0;3,0;42,0;1,0;;8,0;1,0;58,0;9,0;36,0;78,0;3,0;27,0;38,0;61,0;5,0;17,0;1,0;78,0;;;17,0;17,0;7,0;17,0;800,0;8,0;22,0;;109,0;;79,0;56,0;;;1,0;179,0;6,0;2,0;14,0;3,0;2,0;33,0;8,0;211,0;61,0;;5,0;109,0;113,0;2,0;77,0;117,0;10,0;94,0;19,0;7,0;31,0;10,0;2,0;;90,0;128,0;135,0;100,0;44,0;4,0;;37,0;67,0;50,0;6,0;3,0;;17,0;22,0;2,0;39,0;;3,0;7,0;6,0;12,0;90,0;6,0;3,0;7,0;3,0;8,0;74,0;25,0;8,0;;21,0;784,0;2,0;4,0;;33,0;78,0;14,0;6,0;182,0;;7,0;16,0;1,0;;462,0;;;1,0;237,0;40,0;27,0;65,0;21,0;14,0;2,0;1,0;11,0;2,0;6,0;2,0;16,0;5,0;7,0;136,0;2,0;;9,0;51,0;;19,0;8,0;;14,0;5,0;;34,0;;13,0;22,0;;;6,0;;3,0;7,0;15,0;;;24,0;9,0;23,0;7,0;2,0;;117,0;1,0;4,0;9,0;;5,0;3,0;12,0;12,0;24,0;1,0;;;1,0;12,0;;433,0;;75,0;;16,0;13,0;8,0;1,0;18,0;25,0;;6,0;6,0;1,0;9,0;32,0;14,0;6,0;9,0;23,0;46,0;7,0;3,0;20,0;1,0;1,0;4,0;18,0;224,0;52,0;1,0;;;;;48,0;1,0;1,0;4,0;3,0;3,0;;2,0;32,0;3,0;;19,0;;11,0;8,0;8,0;23,0;36,0;31,0;6,0;;;91,0;3,0;10,0;2,0;3,0;33,0;3,0;1,0;;;;;1,0;12,0;;12,0;4,0;4,0;;1,0;;;26,0;;1,0;5,0;3,0;11,0;;3,0;1,0;;8,0;;23,0;2,0;;;;188,0;1,0;3,0;;;;;;;;;49,0;4,0;6,0;6,0;;;2,0;;8,0;5,0;11,0;4,0;20,0;;16,0;;;2,0;2,0;8,0;;6,0;13,0;11,0;5,0;;7,0;1,0;;;;;2,0;;;;;;4,0;6,0;;2,0;1,0;5,0;2,0;1,0;;2,0;6,0;2,0;1,0;;;;2,0;;25,0;15,0;5,0;;286,0;;;2,0;3,0;2,0;1,0;4,0;26,0;;2,0;;2,0;4,0;9,0;68,0;26,0;5,0;;18,0;2,0;;;1,0;;;7,0;15,0;4,0;;2,0;4,0;4,0;3,0;6,0;2,0;46,0;68,0;;56,0;;;11,0;77,0;2,0;27,0;15,0;10,0;7,0;78,0;7,0;22,0;;1,0;17,0;14,0;;;2,0;12,0;22,0;101,0;1,0;;;17,0;1,0;11,0;12,0;;1,0;45,0;4,0;;11,0;6,0;3,0;13,0;10,0;65,0;2,0;;2,0;20,0;2,0;19,0;2,0;1,0;;12,0;1,0;;3,0;2,0;4,0;8,0;4,0;12,0;2,0;;4,0;8,0;2,0;54,0;3,0;9,0;7,0;16,0;47,0;27,0;;;7,0;12,0;;2,0;13,0;1,0;8,0;49,0;9,0;;42,0;8,0;;11,0;6,0;8,0;19,0;1,0;1,0;23,0;19,0;;10,0;23,0;1,0;17,0;17,0;3,0;;30,0;16,0;22,0;8,0;21,0;;3,0;;;9,0;1,0;69,0;;17,0;9,0;;2,0;6,0;13,0;6,0;1,0;6,0;;6,0;6,0;1,0;4,0;65,0;;98,0;11,0;162,0;23,0;1,0;34,0;4,0;4,0;;;2,0;2,0;1,0;;;;1,0;;3,0;33,0;3,0;;2,0;5,0;10,0;30,0;26,0;13,0;7,0;;1,0;13,0;4,0;;5,0;9,0;5,0;29,0;83,0;5,0;4,0;1,0;21,0;30,0;2,0;8,0;6,0;3,0;3,0;8,0;7,0;3,0;6,0;12,0;;;10,0;;5,0;4,0;;39,0;6,0;;6,0;6,0;;1,0;12,0;36,0;2,0;4,0;;2,0;14,0;1,0;2,0;8,0;1,0;2,0;1,0;;;1,0;6,0;9,0;151,0;;;;;10,0;;;;;8,0;;1,0;9,0;;1,0;3,0;;3,0;15,0;1,0;5,0;1,0;;4,0;;1,0;;;;1,0;7,0;;;4,0;;9,0;3,0;2,0;;5,0;;;17,0;1,0;;;2,0;1,0;;;29,0;1,0;;5,0;;1,0;1,0;;3,0;1,0;1,0;9,0;;1,0;24,0;;;;;3,0;;;7,0;;3,0;;;;;1,0;1,0;4,0;27,0;1,0;17,0;;;3,0;6,0;;;1,0;;;2,0;2,0;2,0;1,0;;;;;;1,0;;;17,0;;;;4,0;21,0;1,0;;;14,0;;22,0;;2,0;2,0;7,0;;2,0;;;;2,0;14,0;1,0;4,0;;;4,0;;;1,0;2,0;;;;2,0;;;;;3,0;2,0;1,0;2,0;23,0;2,0;3,0;;12,0;1,0;;;;1,0;;1,0;;1,0;2,0;;1,0;;;;;;27,0;2,0;4,0;;;;;1,0;;1,0;;1,0;;15,0;;;6,0;;;;;;1,0;13,0;;;;;19,0;2,0;3,0;;6,0;5,0;1,0;4,0;;3,0;3,0;;1,0;1,0;4,0;;1,0;;3,0;3,0;;9,0;1,0;13,0;;1,0;7,0;1,0;;;;66,0;1,0;1,0;1,0;5,0;1,0;2,0;;;;2,0;;1,0;;2,0;1,0;97,0;5,0;;5,0;;2,0;;;;;4,0;;6,0;2,0;;3,0;1,0;1,0;;;;2,0;;;;;7,0;;6,0;;;2,0;;5,0;;9,0;;;2,0;;2,0;13,0;;;8,0;3,0;;;;2,0;;;1,0;4,0;1,0;;;;1,0;;;4,0;;;;5,0;;;3,0;;;;;;1,0;;;;;;;5,0;;;;;2,0;1,0;;4,0;2,0;;;;2,0;1,0;2,0;;;;1,0
unit;2,0;47,0;40,0;33,0;61,0;194,0;393,0;905,0;353,0;788,0;154,0;52,0;68,0;20,0;677,0;745,0;35,0;153,0;160,0;21,0;87,0;998,0;145,0;24,0;15,0;41,0;444,0;35,0;16,0;77,0;41,0;250,0;2914,0;52,0;4060,0;398,0;218,0;473,0;67,0;71,0;1502,0;211,0;100,0;51,0;1047,0;901,0;1039,0;1369,0;258,0;1860,0;308,0;433,0;46,0;66,0;1386,0;195,0;1250,0;42,0;213,0;14,0;85,0;208,0;58,0;38,0;310,0;839,0;637,0;526,0;222,0;59,0;169,0;160,0;901,0;285,0;6,0;132,0;84,0;96,0;193,0;5678,0;25,0;1789,0;15,0;2451,0;164,0;244,0;437,0;56,0;86,0;869,0;12109,0;;18,0;46,0;120,0;148,0;307,0;5,0;374,0;95,0;47,0;9,0;677,0;863,0;44,0;464,0;3585,0;164,0;1192,0;218,0;113,0;806,0;50,0;50,0;130,0;1118,0;548,0;1661,0;2334,0;349,0;27,0;36,0;198,0;1996,0;182,0;51,0;31,0;92,0;69,0;341,0;172,0;204,0;269,0;43,0;78,0;94,0;164,0;101,0;117,0;59,0;45,0;4,0;153,0;768,0;570,0;59,0;8,0;1157,0;2189,0;98,0;84,0;23,0;650,0;777,0;439,0;187,0;1528,0;185,0;153,0;766,0;11,0;462,0;;29,0;176,0;;333,0;229,0;41,0;21,0;811,0;11,0;1,0;129,0;610,0;56,0;102,0;145,0;42,0;12,0;92,0;1011,0;19,0;51,0;350,0;240,0;12,0;162,0;357,0;1,0;53,0;155,0;28,0;766,0;101,0;239,0;38,0;1,0;67,0;128,0;9,0;29,0;114,0;761,0;42,0;127,0;86,0;36,0;273,0;221,0;42,0;8,0;123,0;50,0;11,0;15,0;47,0;40,0;39,0;81,0;293,0;43,0;51,0;20,0;36,0;8,0;11,0;15,0;1700,0;23,0;381,0;13,0;356,0;519,0;362,0;938,0;323,0;148,0;56,0;84,0;27,0;46,0;5,0;244,0;133,0;11,0;439,0;14,0;1501,0;70,0;86,0;;6,0;7,0;7,0;273,0;1183,0;90,0;4,0;71,0;2,0;10,0;20,0;477,0;52,0;33,0;110,0;65,0;214,0;1,0;105,0;153,0;127,0;69,0;5,0;51,0;229,0;62,0;126,0;550,0;325,0;87,0;157,0;101,0;12,0;736,0;26,0;16,0;;16,0;166,0;182,0;315,0;11,0;94,0;;62,0;;88,0;15,0;164,0;85,0;149,0;109,0;9,0;3,0;81,0;137,0;68,0;5,0;5,0;104,0;40,0;19,0;100,0;80,0;1,0;80,0;10,0;209,0;3,0;43,0;16,0;5,0;1373,0;13,0;43,0;28,0;17,0;17,0;19,0;23,0;7,0;1,0;15,0;187,0;38,0;203,0;220,0;91,0;5,0;34,0;118,0;219,0;364,0;47,0;95,0;103,0;113,0;73,0;16,0;122,0;77,0;422,0;59,0;45,0;20,0;191,0;80,0;18,0;8,0;65,0;72,0;46,0;91,0;;19,0;133,0;120,0;65,0;27,0;15,0;10,0;6,0;13,0;10,0;31,0;9,0;219,0;175,0;12,0;;12,0;19,0;16,0;155,0;9,0;13,0;6,0;320,0;26,0;361,0;28,0;22,0;42,0;523,0;13,0;45,0;31,0;;10,0;5,0;34,0;137,0;3,0;2,0;41,0;14,0;67,0;881,0;570,0;144,0;93,0;100,0;123,0;18,0;22,0;51,0;15,0;2,0;5,0;23,0;97,0;460,0;6,0;13,0;11,0;190,0;7,0;6,0;30,0;603,0;144,0;14,0;75,0;8,0;84,0;269,0;367,0;14,0;82,0;195,0;378,0;11,0;90,0;181,0;742,0;32,0;39,0;196,0;184,0;6,0;43,0;25,0;72,0;471,0;91,0;15,0;6,0;26,0;165,0;13,0;60,0;176,0;14,0;4,0;27,0;6,0;135,0;136,0;9,0;4,0;11,0;175,0;171,0;10,0;121,0;19,0;129,0;8,0;308,0;61,0;39,0;245,0;73,0;22,0;3,0;11,0;4,0;15,0;59,0;22,0;14,0;191,0;29,0;12,0;32,0;32,0;114,0;18,0;88,0;29,0;29,0;440,0;86,0;56,0;88,0;;523,0;11,0;31,0;83,0;18,0;23,0;17,0;12,0;11,0;9,0;13,0;68,0;296,0;110,0;52,0;269,0;8,0;65,0;38,0;61,0;8,0;46,0;16,0;72,0;29,0;216,0;29,0;7,0;146,0;125,0;8,0;384,0;22,0;86,0;5,0;30,0;25,0;69,0;72,0;75,0;51,0;215,0;27,0;;25,0;57,0;49,0;65,0;7,0;51,0;8,0;45,0;8,0;71,0;96,0;274,0;8,0;168,0;71,0;819,0;16,0;292,0;284,0;2,0;64,0;11,0;9,0;45,0;4,0;3,0;7,0;5,0;35,0;2,0;4,0;19,0;430,0;97,0;;;14,0;15,0;119,0;34,0;81,0;44,0;97,0;14,0;12,0;10,0;54,0;38,0;160,0;13,0;12,0;10,0;2,0;111,0;23,0;6,0;127,0;5,0;28,0;5,0;39,0;4,0;19,0;20,0;;;45,0;7,0;92,0;13,0;27,0;119,0;75,0;7,0;278,0;75,0;16,0;29,0;87,0;2,0;11,0;95,0;22,0;4,0;8,0;13,0;25,0;2,0;203,0;1,0;44,0;34,0;7,0;16,0;7,0;38,0;6,0;78,0;145,0;149,0;57,0;40,0;24,0;26,0;48,0;13,0;59,0;20,0;85,0;130,0;21,0;68,0;550,0;12,0;10,0;60,0;56,0;338,0;56,0;8,0;397,0;2,0;18,0;29,0;4,0;8,0;19,0;4,0;4,0;62,0;138,0;14,0;11,0;179,0;55,0;44,0;45,0;35,0;;7,0;7,0;7,0;19,0;17,0;3,0;31,0;43,0;2,0;83,0;1,0;35,0;20,0;55,0;15,0;31,0;145,0;4,0;14,0;6,0;18,0;2,0;77,0;10,0;19,0;8,0;1,0;21,0;11,0;65,0;96,0;12,0;;25,0;64,0;20,0;53,0;8,0;16,0;6,0;32,0;3,0;3,0;241,0;2,0;15,0;39,0;2,0;88,0;37,0;1,0;3,0;42,0;;28,0;18,0;8,0;1,0;7,0;2,0;2,0;3,0;21,0;5,0;86,0;7,0;2,0;65,0;126,0;132,0;7,0;153,0;64,0;38,0;16,0;52,0;190,0;4,0;19,0;14,0;70,0;181,0;178,0;16,0;8,0;26,0;6,0;106,0;58,0;34,0;49,0;1,0;;18,0;45,0;115,0;3,0;105,0;23,0;18,0;5,0;120,0;29,0;9,0;6,0;2,0;32,0;50,0;25,0;58,0;60,0;23,0;559,0;11,0;34,0;39,0;4,0;128,0;11,0;333,0;73,0;98,0;16,0;72,0;29,0;9,0;5,0;65,0;27,0;5,0;4,0;69,0;11,0;313,0;24,0;12,0;43,0;83,0;4,0;;28,0;19,0;47,0;36,0;12,0;;38,0;;13,0;4,0;1,0;4,0;1,0;23,0;;11,0;66,0;;14,0;5,0;12,0;18,0;62,0;7,0;3,0;16,0;7,0;6,0;13,0;22,0;6,0;5,0;;10,0;13,0;1,0;10,0;10,0;18,0;1,0;28,0;14,0;8,0;1,0;14,0;10,0;2,0;19,0;26,0;9,0;4,0;2,0;89,0;12,0;50,0;;8,0;;5,0;5,0;4,0;10,0;1,0;8,0;1,0;3,0;;103,0;16,0;18,0;;26,0;5,0;28,0;2,0;1,0;20,0;3,0;;1,0;4,0;;8,0;7,0;26,0;21,0;12,0;9,0;17,0;25,0;14,0;52,0;49,0;17,0;66,0;;68,0;45,0;5,0;4,0;15,0;10,0;20,0;22,0;;;11,0;3,0;4,0;1,0;;7,0;96,0;24,0;12,0;19,0;76,0;21,0;27,0;;24,0;37,0;9,0;4,0;9,0;1,0;15,0;32,0;5,0;47,0;52,0;;48,0;29,0;9,0;7,0;;2,0;1,0;;90,0;15,0;17,0;9,0;5,0;12,0;9,0;;25,0;47,0;10,0;2,0;49,0;19,0;7,0;1,0;119,0;1,0;;13,0;1,0;3,0;101,0;1,0;1,0;;;9,0;12,0
variation;2,0;;;;;8,0;2,0;4,0;12,0;;;;2,0;;15,0;48,0;;;20,0;;1,0;5,0;1,0;;;;12,0;3,0;;19,0;;;13,0;2,0;26,0;3,0;7,0;2,0;;;8,0;;5,0;;48,0;16,0;53,0;7,0;;5,0;;1,0;;2,0;;;4,0;;2,0;;;;;;;;36,0;;4,0;;4,0;;5,0;;;6,0;1,0;;1,0;59,0;;1,0;1,0;5,0;2,0;;2,0;;;1,0;16,0;;;;;;;3,0;16,0;;3,0;;7,0;4,0;;2,0;13,0;;10,0;3,0;;12,0;;;3,0;19,0;9,0;10,0;8,0;25,0;;2,0;;9,0;5,0;1,0;11,0;3,0;;4,0;;11,0;;;10,0;;17,0;;;3,0;7,0;;;10,0;3,0;;;;58,0;3,0;2,0;;2,0;4,0;1,0;;7,0;;21,0;;1,0;;29,0;;1,0;;27,0;34,0;;;2,0;;;;10,0;3,0;;;;;;7,0;;;;2,0;;2,0;;;1,0;;;4,0;;;33,0;1,0;;;;;1,0;10,0;2,0;7,0;;;;;;;;;;;1,0;;8,0;;;;;;;;;;31,0;;2,0;;;2,0;;1,0;;;;8,0;;;;;;;;;3,0;1,0;;1,0;;;;13,0;;;;;;;;16,0;;;1,0;;4,0;;;;;;;;;;;17,0;;;;7,0;;35,0;;;;;;3,0;1,0;;8,0;;10,0;;;;3,0;1,0;1,0;;;;;7,0;;;2,0;5,0;;;1,0;;;;;;;;;;2,0;;;;;2,0;;;;;;7,0;1,0;6,0;;;;;;5,0;1,0;;;;;;;;;2,0;;;;6,0;;;;1,0;;;;;;;;;;;;;;;;;1,0;2,0;;;;;;;;;;1,0;;2,0;;;;8,0;;;;;;;;;;1,0;7,0;;;11,0;10,0;;2,0;;9,0;;;;1,0;;;;;7,0;;;2,0;10,0;;;;5,0;34,0;;1,0;1,0;;4,0;;1,0;1,0;1,0;1,0;;;;;;;1,0;;1,0;8,0;;;;;;;6,0;;;;1,0;;;;;15,0;7,0;;;;;2,0;;;;13,0;;14,0;;;1,0;;;;;3,0;;;4,0;;;9,0;;;;;;;;;;45,0;;;;;;;;;;;;;;;;;2,0;;3,0;;;;12,0;;;;;;;;;12,0;1,0;;6,0;;;;;;1,0;10,0;;;;;;;;;;;;;;;8,0;;3,0;;;;;;4,0;;;;;;1,0;;;;;1,0;;;;12,0;3,0;;;;;;;;4,0;;;;;;1,0;;;;;;;;;;;;;;;;;;;;;1,0;;;6,0;;;53,0;3,0;;;;;;;;;;;;;;;;;;1,0;;;1,0;;;;;1,0;1,0;;;6,0;;1,0;;;;;2,0;;;5,0;;;8,0;;;;;;;;;1,0;;;;;;;;;;;;1,0;;;;;;;;;;;;;;;;;;;;;;;;;;;;;;;;;;;;;;;;;;;1,0;;;;;;;;;;;;;;;;;;;;;;;;;;;;1,0;;;;;;;;;;;;;;;;;;79,0;;;;;;;;4,0;;;;;;;;;;;;1,0;;;;;;;;6,0;;40,0;;;;1,0;;;;1,0;;;;;;;1,0;;;;;;5,0;;;;1,0;;;;;;;;;1,0;;;;;;4,0;;;;;;;;;;;;;;;;;;;;;;;;;;;;;;;;;;;;;;;;;;;;;;;;;;;;;;7,0;;;;;;;;;;;1,0;;;;;;;;1,0;;;;;;;;;;;;;;;;;;1,0;;;;;;;;;;;;;;;;;;;2,0;;;9,0;;;5,0;;;;;1,0;;;3,0;;;;;;;;;;;;;;;;;;;2,0;;;;;;
vary;3,0;2,0;35,0;;;7,0;20,0;11,0;16,0;6,0;;2,0;;;26,0;11,0;6,0;4,0;2,0;;;6,0;6,0;;3,0;;6,0;1,0;;;4,0;16,0;21,0;;22,0;2,0;3,0;;2,0;6,0;6,0;2,0;1,0;7,0;5,0;;2,0;15,0;;6,0;;43,0;;;12,0;;10,0;5,0;2,0;;28,0;2,0;13,0;;6,0;35,0;12,0;1,0;7,0;2,0;18,0;2,0;11,0;;1,0;22,0;2,0;8,0;7,0;67,0;1,0;12,0;;16,0;2,0;1,0;2,0;;1,0;70,0;228,0;;;;4,0;1,0;;;51,0;1,0;;;;8,0;;4,0;38,0;6,0;3,0;2,0;2,0;7,0;;;;14,0;8,0;23,0;5,0;5,0;;1,0;7,0;4,0;7,0;2,0;1,0;1,0;;5,0;;9,0;21,0;;3,0;2,0;40,0;4,0;7,0;6,0;15,0;;;12,0;2,0;;;2,0;21,0;23,0;4,0;2,0;1,0;3,0;11,0;;48,0;2,0;3,0;2,0;;;176,0;1,0;;;11,0;6,0;;1,0;41,0;;;8,0;25,0;14,0;1,0;3,0;;;;14,0;1,0;;;4,0;;8,0;;;;;;1,0;;4,0;;4,0;;;;1,0;1,0;61,0;5,0;3,0;1,0;2,0;8,0;2,0;;;;;;;;;9,0;;3,0;9,0;2,0;;;2,0;;;61,0;;19,0;1,0;1,0;3,0;4,0;7,0;22,0;1,0;;5,0;1,0;;;8,0;7,0;6,0;;;17,0;5,0;2,0;3,0;1,0;;1,0;2,0;2,0;;2,0;1,0;;;1,0;9,0;2,0;;12,0;;;;1,0;7,0;19,0;;;;2,0;1,0;;13,0;1,0;1,0;;3,0;;85,0;;;;;9,0;;2,0;;;;3,0;;;;3,0;;;;;;;;;;;;;33,0;;;;;;1,0;;;3,0;;1,0;;;;4,0;;;;;;;6,0;1,0;;;;;;;;4,0;;;1,0;;3,0;;;;5,0;1,0;1,0;1,0;3,0;;2,0;6,0;;;;;;5,0;;;2,0;1,0;;;;;;2,0;1,0;2,0;3,0;;;;;;;;;2,0;;;6,0;1,0;;;;2,0;5,0;1,0;;;;;;;1,0;2,0;2,0;1,0;;21,0;;;;;3,0;;;7,0;;;;6,0;2,0;1,0;2,0;;6,0;;;;3,0;8,0;1,0;10,0;;;;8,0;2,0;1,0;4,0;3,0;;2,0;5,0;10,0;;6,0;9,0;5,0;3,0;;5,0;1,0;13,0;;;3,0;;2,0;;1,0;3,0;;;2,0;;11,0;2,0;;;;;;;;1,0;26,0;;3,0;;;;1,0;1,0;;;;2,0;2,0;1,0;;;;;;3,0;;;3,0;1,0;;2,0;1,0;;1,0;;;;;2,0;;;1,0;;;;;;1,0;;;5,0;;;;;;;;10,0;5,0;;;;2,0;27,0;;51,0;;1,0;;3,0;;3,0;1,0;;;;;2,0;;;;;;;1,0;;;;;3,0;;2,0;;;;4,0;;;;;;;;;;;;;;;2,0;7,0;;;;;;;;;;;;1,0;1,0;;1,0;;;;;1,0;;;;;;;;;;;;;;;;;;;;;5,0;;;;3,0;;;;;;;2,0;;;8,0;;;;;;;2,0;8,0;;;;;7,0;2,0;1,0;;1,0;;;8,0;;;;;;1,0;3,0;;20,0;;;1,0;;2,0;;;;;;;1,0;1,0;;;;;;1,0;5,0;;;;;;;;1,0;;;;1,0;;;;1,0;;;;;;;;;;;;1,0;;;;5,0;;;;4,0;;;;8,0;;;1,0;;10,0;;;;;;3,0;;;2,0;;;;;;;;;;;;;2,0;;;;;1,0;;4,0;1,0;;;;;;7,0;1,0;;;;1,0;;;;9,0;;;;;;;;;;2,0;;;;;1,0;;;;;;1,0;;;;;;;;1,0;;55,0;;1,0;1,0;5,0;;;;;1,0;;;47,0;2,0;2,0;;;;5,0;;;14,0;1,0;;;1,0;;;;;;;1,0;2,0;;;;;;4,0;;;;;;;;1,0;;;;;;1,0;;;;;;;;1,0;;;1,0;;;;;;;;;;2,0;3,0;;4,0;;;;;;;;;1,0;;6,0;1,0;;;1,0;;;;;;2,0;;1,0;;1,0;;5,0;;3,0;4,0;;;3,0;;;;;;;;;;;;;;;;;1,0;;;;3,0;;;;;;;;;;;;9,0;;;;;;;;;;;1,0;;;;;2,0;;1,0;4,0;;;;;1,0;;;;;;;;;;;1,0;;;;;;;;;;;
vehicular;1,0;1,0;6,0;;;2,0;;;;1,0;;;;;;;2,0;;;12,0;11,0;2,0;;;;;;;;;;3,0;1,0;;4,0;11,0;;;;;5,0;;;;2,0;;1,0;9,0;1,0;20,0;1,0;;;;;1,0;3,0;;;;1,0;4,0;4,0;;;;2,0;;;;1,0;;;;;;;;;21,0;3,0;1,0;;9,0;;;;;;;16,0;;;;;;1,0;;26,0;;1,0;;;;;;;4,0;;;;;1,0;;;;5,0;;;1,0;;;;;1,0;;;;;1,0;;;;;;;;;;;;;;1,0;;;;;4,0;;;;;;;;77,0;;;;;1,0;;;;;5,0;10,0;;;;;14,0;;;1,0;5,0;;;;4,0;2,0;;;;2,0;;;;;;;;;;;;;;2,0;;;;;;;;;;;;;;;;;;1,0;;;2,0;;;;;3,0;;;4,0;1,0;;;4,0;3,0;;;;1,0;;;;;;;;;;;;;;;;;;;1,0;;;;;;2,0;;;;5,0;;;;;2,0;;;;;;;2,0;;;;;;;3,0;;;;;14,0;;;;;;;1,0;;;;;1,0;;;;;;;;;;;;;;;;;;;;;;1,0;;;;;;;;;;;;;;;;1,0;;;;2,0;;;;;1,0;;;;;;;;;;;;1,0;;;;;;15,0;;;;;;;;;;;;;;;;;;;;;;;;;;;;;;;;;;;;;;;;;;;;;;;;;;;;;;;;;;;;;;;;1,0;;;;;;;2,0;;1,0;;2,0;2,0;;1,0;;;;3,0;;;;;;1,0;;;;;;;;2,0;;;;;;;1,0;;;;;;;;;;;2,0;1,0;;;;;;;;;;;;;;;;1,0;;;;;;;;;;;;;;;;;;;;;;;;;;4,0;;;1,0;;1,0;;;;;;;;;;;;;;1,0;;1,0;;;;;1,0;;;;;;;;;;;;;;;1,0;3,0;;;;;;4,0;;;;;;;;;;;;1,0;;;;;;;;;2,0;1,0;;;;;;;;;;;;;;;;;;;;;;;;;;;;;;;12,0;1,0;;;;;;;;;;;;;;1,0;;;;;1,0;;;;;;;;;;1,0;;;;;;;;;;;;1,0;;;;;;1,0;6,0;;;;;;;;;;;;;;;;;;;;;;;;;;3,0;;;;;;;;;;;;;;;;;;;;;;;;;;;;;;;;;;;;;;;;;;;;;;;;;;;;;;;;;;;;;;;;;;;;;;;;;;;;;;;;;;;;;;;;;;;;;;;;;;;;;;;;;;;;;;;;;;;;;1,0;;;;;2,0;;;;;;;;;2,0;;;;;;;;;;;;;;;;;;;;;;;;;;;;;;;;;;1,0;;;;;;;;;;;;;;;;;;;;;;;;;;;;;;;;;1,0;;;;;;;;;;;;;;;;;;;;;;;;;;;;;;;;;;;;;;;;;1,0;;;;;;;;;;;;;;;;;;;;;;;;;;;;;4,0;;;;;;;;;;;;;;;;3,0;;;;;;;;;;;;;;;
video;1,0;13,0;6,0;3,0;69,0;35,0;5,0;343,0;69,0;21,0;21,0;;104,0;1,0;36,0;357,0;8,0;;19,0;35,0;27,0;927,0;7,0;13,0;2,0;4,0;89,0;18,0;12,0;12,0;57,0;6,0;454,0;1,0;354,0;55,0;25,0;42,0;66,0;;1347,0;2,0;25,0;33,0;221,0;48,0;288,0;617,0;707,0;643,0;27,0;22,0;2,0;12,0;4,0;29,0;47,0;6,0;15,0;2,0;10,0;76,0;128,0;136,0;59,0;12,0;17,0;80,0;1287,0;30,0;34,0;;361,0;14,0;2,0;33,0;123,0;5,0;15,0;1510,0;42,0;147,0;6,0;503,0;11,0;67,0;2,0;6,0;;31,0;86,0;10,0;18,0;3,0;28,0;49,0;105,0;33,0;741,0;55,0;6,0;11,0;200,0;237,0;;43,0;53,0;16,0;518,0;216,0;3,0;128,0;6,0;3,0;7,0;400,0;98,0;208,0;73,0;114,0;2,0;;80,0;264,0;249,0;63,0;7,0;;;16,0;;77,0;34,0;11,0;65,0;81,0;67,0;72,0;43,0;5,0;136,0;22,0;55,0;186,0;46,0;;6,0;21,0;1067,0;17,0;6,0;1,0;151,0;232,0;65,0;13,0;788,0;1,0;20,0;27,0;40,0;237,0;333,0;27,0;11,0;5,0;;271,0;15,0;1,0;55,0;;;11,0;61,0;14,0;7,0;;2,0;3,0;4,0;122,0;;;4,0;81,0;;63,0;1,0;;86,0;93,0;;130,0;;3,0;178,0;2,0;2,0;11,0;1,0;18,0;73,0;45,0;2,0;;3,0;4,0;42,0;32,0;47,0;;4,0;2,0;2,0;3,0;2,0;;1,0;3,0;106,0;2,0;1,0;17,0;;5,0;12,0;;134,0;;11,0;;41,0;102,0;;13,0;92,0;11,0;4,0;11,0;18,0;8,0;5,0;25,0;6,0;;;26,0;103,0;14,0;1,0;;4,0;;;3,0;553,0;1,0;6,0;;;;11,0;256,0;1,0;5,0;4,0;8,0;8,0;;8,0;175,0;21,0;;3,0;;22,0;11,0;;31,0;61,0;54,0;19,0;;2,0;214,0;;1,0;;4,0;103,0;6,0;1,0;;4,0;;;1,0;11,0;1,0;7,0;43,0;59,0;;1,0;;;21,0;19,0;8,0;4,0;11,0;2,0;;16,0;33,0;29,0;74,0;;86,0;;2,0;2,0;5,0;2,0;;1,0;;;5,0;;1,0;;1,0;1,0;15,0;13,0;3,0;7,0;24,0;;;28,0;29,0;5,0;34,0;5,0;1,0;3,0;26,0;1,0;;6,0;5,0;;3,0;14,0;118,0;26,0;45,0;1,0;10,0;;;;2,0;;11,0;1,0;19,0;5,0;;1,0;23,0;2,0;7,0;8,0;2,0;5,0;4,0;;9,0;106,0;8,0;;23,0;;;;14,0;8,0;51,0;34,0;7,0;6,0;70,0;;1,0;6,0;1,0;;3,0;30,0;34,0;11,0;3,0;4,0;;39,0;40,0;53,0;81,0;58,0;44,0;67,0;3,0;6,0;10,0;15,0;5,0;3,0;12,0;28,0;16,0;17,0;7,0;15,0;33,0;46,0;14,0;1,0;311,0;83,0;;117,0;1,0;23,0;11,0;69,0;9,0;116,0;176,0;87,0;;129,0;60,0;78,0;20,0;20,0;23,0;99,0;;;1,0;144,0;640,0;78,0;43,0;;20,0;14,0;;18,0;13,0;7,0;1,0;6,0;5,0;30,0;66,0;3,0;4,0;3,0;12,0;111,0;9,0;18,0;1,0;17,0;;126,0;27,0;30,0;9,0;39,0;2,0;37,0;14,0;6,0;10,0;3,0;37,0;106,0;21,0;1,0;11,0;40,0;1,0;82,0;12,0;28,0;13,0;15,0;15,0;70,0;5,0;2,0;;8,0;2,0;5,0;68,0;6,0;3,0;549,0;1,0;1,0;19,0;11,0;2,0;17,0;6,0;18,0;20,0;20,0;45,0;131,0;29,0;5,0;32,0;20,0;19,0;90,0;16,0;3,0;;19,0;5,0;29,0;33,0;59,0;;2,0;6,0;6,0;86,0;36,0;47,0;;38,0;6,0;;2,0;22,0;28,0;12,0;1,0;42,0;1,0;13,0;;24,0;2,0;60,0;39,0;75,0;11,0;81,0;5,0;9,0;73,0;17,0;32,0;;38,0;25,0;11,0;1,0;9,0;4,0;;1,0;32,0;294,0;12,0;28,0;9,0;31,0;6,0;10,0;15,0;4,0;;9,0;7,0;4,0;36,0;13,0;46,0;;65,0;19,0;29,0;18,0;3,0;43,0;9,0;;28,0;25,0;4,0;17,0;11,0;16,0;37,0;11,0;2,0;18,0;9,0;14,0;;22,0;;32,0;;220,0;99,0;7,0;21,0;12,0;;;9,0;21,0;85,0;3,0;6,0;;6,0;21,0;6,0;13,0;192,0;31,0;8,0;14,0;;;40,0;6,0;;93,0;;6,0;1,0;5,0;4,0;1,0;1,0;2,0;2,0;5,0;;6,0;31,0;41,0;2,0;21,0;6,0;1,0;25,0;1,0;2,0;34,0;9,0;;;;7,0;;;;76,0;;2,0;13,0;2,0;66,0;;3,0;4,0;14,0;;;2,0;6,0;6,0;8,0;;11,0;;3,0;24,0;4,0;;;7,0;25,0;;;6,0;;;25,0;3,0;7,0;;5,0;2,0;;;;;;179,0;2,0;;6,0;2,0;8,0;5,0;49,0;1,0;14,0;18,0;36,0;56,0;;;;11,0;;3,0;13,0;1,0;;4,0;11,0;;3,0;;;2,0;4,0;;;1,0;8,0;20,0;11,0;;;11,0;67,0;9,0;2,0;1,0;;;17,0;;;12,0;57,0;;3,0;;1,0;7,0;7,0;1,0;40,0;;;6,0;10,0;8,0;6,0;2,0;516,0;18,0;6,0;;1,0;10,0;;;82,0;5,0;;11,0;24,0;30,0;6,0;7,0;5,0;7,0;;9,0;9,0;1,0;15,0;;91,0;;;37,0;7,0;2,0;;5,0;;3,0;7,0;50,0;;2,0;1,0;;3,0;1,0;2,0;;8,0;;26,0;17,0;4,0;;6,0;6,0;11,0;12,0;3,0;5,0;8,0;14,0;1,0;;;6,0;19,0;221,0;5,0;8,0;20,0;16,0;11,0;27,0;;;22,0;4,0;16,0;;16,0;2,0;52,0;12,0;1,0;3,0;;5,0;;;2,0;18,0;1,0;6,0;;;;;14,0;1,0;12,0;;22,0;;18,0;63,0;20,0;2,0;2,0;2,0;;;9,0;17,0;13,0;25,0;;6,0;4,0;21,0;;;;14,0;;;10,0;3,0;1,0;10,0;1,0;34,0;3,0;;;12,0;;10,0;6,0;;127,0;2,0;;2,0;;9,0;;19,0;;9,0;;;1,0;;12,0;16,0;2,0;;;1,0;1,0;25,0;;5,0;4,0;1,0;1,0;;1,0;;1,0;;39,0;;;;3,0;49,0;;12,0;;24,0;21,0;;9,0;;;;;9,0;;2,0;9,0;1,0;2,0;26,0;22,0;9,0;28,0;10,0;;2,0;2,0;11,0;7,0;2,0;;;1,0;;;;;;1,0
view;1,0;12,0;3,0;4,0;19,0;736,0;64,0;97,0;375,0;24,0;27,0;1,0;74,0;;103,0;226,0;10,0;;5,0;9,0;60,0;345,0;19,0;7,0;2,0;1,0;15,0;11,0;5,0;5,0;35,0;49,0;153,0;;155,0;27,0;19,0;10,0;16,0;;184,0;5,0;95,0;47,0;145,0;17,0;282,0;319,0;135,0;601,0;23,0;67,0;13,0;20,0;3,0;20,0;165,0;7,0;26,0;;15,0;23,0;2529,0;5,0;16,0;30,0;41,0;48,0;163,0;60,0;27,0;5,0;117,0;12,0;12,0;28,0;82,0;55,0;17,0;1479,0;16,0;141,0;16,0;253,0;8,0;16,0;4,0;;3,0;39,0;307,0;1,0;4,0;2,0;9,0;14,0;14,0;;409,0;22,0;12,0;16,0;96,0;447,0;1,0;31,0;152,0;20,0;75,0;55,0;12,0;41,0;7,0;3,0;;202,0;286,0;418,0;20,0;44,0;7,0;2,0;29,0;44,0;57,0;32,0;5,0;1,0;19,0;73,0;;48,0;62,0;5,0;54,0;23,0;89,0;30,0;11,0;5,0;268,0;4,0;9,0;199,0;36,0;;;114,0;73,0;15,0;26,0;1,0;14,0;20,0;84,0;;338,0;41,0;14,0;5,0;17,0;40,0;229,0;34,0;6,0;10,0;271,0;;21,0;4,0;45,0;9,0;1,0;32,0;11,0;5,0;82,0;2,0;;;;55,0;1,0;1,0;3,0;6,0;1,0;21,0;5,0;6,0;1,0;;3,0;13,0;;3,0;53,0;;1,0;119,0;20,0;1,0;9,0;330,0;5,0;1,0;;13,0;3,0;51,0;;;3,0;5,0;9,0;;3,0;;6,0;15,0;58,0;2,0;14,0;2,0;2,0;10,0;11,0;;196,0;;72,0;;150,0;88,0;22,0;31,0;21,0;53,0;3,0;8,0;152,0;9,0;73,0;24,0;2,0;;4,0;8,0;64,0;55,0;4,0;;;1,0;2,0;1,0;117,0;96,0;9,0;2,0;;;4,0;134,0;9,0;2,0;22,0;3,0;6,0;;5,0;57,0;65,0;;3,0;4,0;15,0;37,0;12,0;106,0;22,0;;4,0;1,0;1,0;98,0;;13,0;;12,0;319,0;28,0;1,0;;22,0;;15,0;61,0;6,0;;5,0;38,0;12,0;16,0;;5,0;14,0;16,0;15,0;15,0;4,0;6,0;;;27,0;42,0;4,0;2,0;2,0;13,0;;3,0;;1,0;13,0;3,0;1,0;;7,0;4,0;5,0;1,0;;;3,0;1,0;17,0;68,0;3,0;3,0;1,0;1,0;3,0;2,0;212,0;2,0;;4,0;31,0;17,0;3,0;39,0;1,0;6,0;;3,0;15,0;262,0;16,0;20,0;6,0;13,0;2,0;2,0;6,0;;;125,0;2,0;2,0;7,0;2,0;;10,0;48,0;1,0;6,0;7,0;28,0;20,0;1,0;1,0;16,0;11,0;;20,0;1,0;1,0;1,0;17,0;42,0;61,0;7,0;3,0;;4,0;;23,0;37,0;1,0;1,0;;2,0;25,0;1,0;3,0;;3,0;5,0;37,0;53,0;9,0;17,0;26,0;46,0;;2,0;11,0;7,0;11,0;1,0;6,0;32,0;14,0;2,0;;1,0;19,0;;7,0;;48,0;29,0;6,0;116,0;;42,0;24,0;176,0;3,0;78,0;51,0;53,0;22,0;33,0;60,0;21,0;24,0;47,0;4,0;;;;7,0;14,0;37,0;32,0;29,0;;;37,0;2,0;1,0;3,0;4,0;6,0;;10,0;34,0;103,0;11,0;4,0;12,0;4,0;179,0;3,0;8,0;7,0;;3,0;163,0;31,0;3,0;49,0;69,0;1,0;4,0;9,0;3,0;30,0;4,0;73,0;50,0;1,0;9,0;28,0;15,0;2,0;34,0;;12,0;4,0;2,0;56,0;13,0;;6,0;13,0;1,0;2,0;7,0;97,0;42,0;3,0;18,0;3,0;9,0;3,0;49,0;2,0;4,0;4,0;5,0;26,0;6,0;1,0;19,0;1,0;2,0;3,0;15,0;4,0;20,0;10,0;1,0;;24,0;21,0;1,0;;206,0;2,0;6,0;5,0;4,0;28,0;27,0;20,0;23,0;15,0;1,0;;12,0;29,0;;7,0;1,0;;;16,0;1,0;1,0;1,0;35,0;6,0;10,0;6,0;4,0;1,0;;12,0;;117,0;9,0;1,0;23,0;9,0;4,0;;;3,0;23,0;4,0;8,0;7,0;;2,0;4,0;3,0;1,0;1,0;;;6,0;3,0;;3,0;4,0;54,0;;36,0;2,0;3,0;;12,0;48,0;5,0;7,0;;2,0;10,0;9,0;4,0;4,0;4,0;2,0;1,0;7,0;1,0;2,0;;51,0;2,0;4,0;4,0;1,0;175,0;;;2,0;;;2,0;7,0;2,0;;25,0;;4,0;2,0;1,0;4,0;28,0;;4,0;18,0;1,0;1,0;139,0;1,0;1,0;6,0;1,0;3,0;47,0;3,0;;1,0;;;;5,0;12,0;6,0;11,0;8,0;2,0;400,0;;;65,0;9,0;;10,0;37,0;2,0;3,0;;;;;9,0;28,0;3,0;;18,0;;23,0;;2,0;2,0;29,0;2,0;;;30,0;19,0;8,0;2,0;1,0;32,0;56,0;25,0;1,0;1,0;5,0;8,0;37,0;;;;;;24,0;2,0;3,0;2,0;;;;7,0;11,0;2,0;1,0;7,0;2,0;5,0;;15,0;2,0;;3,0;3,0;1,0;3,0;2,0;38,0;3,0;1,0;1,0;5,0;;3,0;1,0;;;5,0;6,0;1,0;13,0;;2,0;;2,0;;2,0;;;5,0;;;;;1,0;7,0;2,0;16,0;;;1,0;;;;10,0;;;;13,0;2,0;127,0;21,0;24,0;7,0;;1,0;9,0;10,0;9,0;8,0;22,0;43,0;4,0;;19,0;23,0;;;6,0;17,0;10,0;4,0;;;;1,0;6,0;5,0;;5,0;;14,0;;226,0;14,0;;1,0;9,0;7,0;4,0;;99,0;6,0;29,0;;;;2,0;;;;2,0;21,0;2,0;27,0;4,0;16,0;11,0;6,0;;;2,0;;30,0;20,0;4,0;5,0;3,0;1,0;;;6,0;2,0;;5,0;;4,0;;18,0;37,0;;1,0;;12,0;5,0;11,0;16,0;;;1,0;1,0;;1,0;3,0;8,0;4,0;;8,0;;1,0;;;4,0;;;28,0;;;3,0;7,0;4,0;2,0;6,0;4,0;;2,0;2,0;3,0;13,0;12,0;1,0;10,0;;13,0;24,0;58,0;;1,0;5,0;6,0;5,0;2,0;43,0;3,0;2,0;8,0;21,0;7,0;;2,0;;6,0;;7,0;4,0;1,0;1,0;1,0;;;;;;;;;;;;4,0;26,0;12,0;4,0;;5,0;7,0;;;1,0;;;;7,0;;14,0;9,0;;1,0;1,0;;;2,0;7,0;11,0;1,0;17,0;13,0;3,0;;;78,0;;;23,0;;4,0;4,0;1,0;55,0;;;6,0;1,0;16,0;1,0;2,0;8,0;6,0;;9,0;51,0;;;2,0;320,0;1,0;;;;27,0;1,0
visible;1,0;;1,0;;;3,0;1,0;20,0;19,0;4,0;9,0;;13,0;;1,0;25,0;19,0;1,0;;1,0;;74,0;2,0;2,0;;;27,0;8,0;;;;;44,0;;7,0;5,0;8,0;;;;84,0;1,0;4,0;3,0;27,0;9,0;3,0;33,0;1,0;58,0;2,0;2,0;3,0;;;2,0;4,0;;;;;;13,0;;58,0;4,0;47,0;40,0;18,0;11,0;;38,0;30,0;;;8,0;3,0;30,0;19,0;349,0;23,0;36,0;;51,0;;1,0;;;;3,0;49,0;;;6,0;3,0;6,0;4,0;1,0;51,0;;;1,0;53,0;44,0;3,0;3,0;31,0;;22,0;1,0;37,0;15,0;;;4,0;7,0;22,0;37,0;;6,0;;;6,0;17,0;5,0;;4,0;1,0;21,0;64,0;;1,0;1,0;1,0;3,0;;3,0;4,0;1,0;;23,0;1,0;;60,0;;;;20,0;8,0;1,0;;;;8,0;34,0;;61,0;;;;4,0;27,0;41,0;;;;15,0;21,0;;94,0;3,0;11,0;;5,0;8,0;3,0;1,0;;;26,0;;1,0;;;7,0;1,0;12,0;6,0;;;;;;;;;2,0;5,0;;13,0;;2,0;1,0;2,0;;;;15,0;;;1,0;;;;;10,0;;;;;10,0;2,0;;;2,0;1,0;1,0;;950,0;1,0;1,0;;13,0;7,0;;3,0;;7,0;;;2,0;11,0;2,0;19,0;;;1,0;;11,0;11,0;;;;;;9,0;34,0;29,0;;;;;;5,0;;;;;1,0;;;78,0;14,0;;64,0;;;4,0;3,0;16,0;6,0;1,0;;;;6,0;1,0;5,0;;4,0;9,0;;;;;;;;1,0;;;3,0;2,0;;;;;8,0;;;;11,0;;;6,0;7,0;3,0;;;6,0;;3,0;;;;2,0;;;;;;;;;2,0;;;1,0;;;;;2,0;5,0;1,0;;;;1,0;7,0;;;;;;;;6,0;;;;10,0;;;;;;1,0;;2,0;;;;;1,0;;1,0;;;;;;12,0;;;;;;;;;22,0;;;;5,0;;;;;;;2,0;16,0;;;;;;2,0;2,0;1,0;3,0;;1,0;;;4,0;;;;;9,0;;;;;5,0;;6,0;;3,0;7,0;;13,0;;;3,0;15,0;;1,0;1,0;2,0;;;1,0;4,0;2,0;;2,0;1,0;;;;;13,0;;;;;5,0;5,0;;1,0;;;;;7,0;;;;;;6,0;2,0;;;;2,0;;;;;2,0;;;2,0;3,0;17,0;;3,0;3,0;;4,0;;;3,0;2,0;1,0;1,0;;;17,0;12,0;;1,0;;1,0;;2,0;9,0;;;2,0;;;;1,0;;1,0;;;;;3,0;;;;;;;;;;6,0;6,0;;;;;;;;;10,0;3,0;;;2,0;;;;2,0;;;;1,0;;;;;8,0;15,0;;;;2,0;1,0;1,0;6,0;1,0;7,0;;;;1,0;;;;;;;;7,0;1,0;;;;;;;;1,0;;;;;;;1,0;;;;2,0;1,0;;;;;;;;;;;;;;;;;;;;;70,0;1,0;;;;;;12,0;;;2,0;;;;;1,0;;1,0;;;;;4,0;;2,0;;;;;;;11,0;2,0;;1,0;;;5,0;11,0;;11,0;;;;2,0;;;;;4,0;;;;;;;;;;;;;;5,0;;8,0;;;;2,0;1,0;;;;1,0;;4,0;;;;1,0;;;;;;;4,0;;;;;;;;;;;;;;;;;;;;;52,0;;;;;;;;;10,0;;;;;;;;;;;;;;;;;;;;;;;;2,0;;;;1,0;;7,0;;;;2,0;;;;;;;;;;;16,0;6,0;1,0;;;10,0;;;;;;;;;39,0;;1,0;;;;8,0;;;1,0;;1,0;;;;;;;;;;;;;;;;8,0;3,0;7,0;;9,0;6,0;3,0;1,0;;;;9,0;;1,0;1,0;;;;;;;;;1,0;;;;;3,0;1,0;;;;;;1,0;5,0;;;;1,0;;11,0;;;;;;;;;;2,0;;;2,0;;;;;;;;;;1,0;;;;;;4,0;1,0;;;;;;;;;;;;;6,0;15,0;;;;2,0;;;;;;;;;;;;;;;;;;;;;;;;9,0;1,0;;1,0;;;2,0;;;;;;;;;;;2,0;;1,0;21,0;;;;;;;;;;3,0;;1,0;;5,0;4,0;;1,0;;;3,0;1,0;;;;;;;;;;;;;;;
wavelength;2,0;;1,0;;2,0;5,0;1,0;21,0;4,0;4,0;14,0;;22,0;;3,0;23,0;51,0;;;;2,0;15,0;;;;2,0;115,0;5,0;;;2,0;1,0;36,0;1,0;11,0;;;;;;52,0;;8,0;2,0;22,0;4,0;59,0;43,0;6,0;10,0;1,0;;;8,0;1,0;2,0;4,0;;;;2,0;;;;142,0;10,0;1,0;6,0;5,0;3,0;35,0;10,0;52,0;;;1,0;;13,0;31,0;97,0;2,0;46,0;;81,0;1,0;;;;1,0;26,0;7,0;;;53,0;21,0;6,0;;;50,0;;;1,0;3,0;5,0;3,0;3,0;51,0;;29,0;1,0;15,0;5,0;;;;39,0;26,0;9,0;4,0;48,0;;2,0;2,0;6,0;2,0;1,0;4,0;;56,0;192,0;;54,0;2,0;1,0;47,0;13,0;7,0;13,0;;;;;;35,0;;;;10,0;36,0;8,0;13,0;;;;1,0;;45,0;;;24,0;1,0;65,0;21,0;;1,0;;1,0;4,0;94,0;;;5,0;;;12,0;;4,0;;3,0;57,0;;;;1,0;6,0;1,0;;4,0;2,0;5,0;;;;;1,0;;2,0;;1,0;2,0;;3,0;17,0;14,0;;;3,0;14,0;14,0;2,0;12,0;;;4,0;;28,0;;;2,0;;3,0;34,0;1,0;;;;4,0;;543,0;;7,0;2,0;;1,0;;;1,0;1,0;;;22,0;;4,0;14,0;3,0;6,0;2,0;5,0;66,0;8,0;;3,0;;;1,0;4,0;23,0;33,0;1,0;1,0;;;;27,0;1,0;;;2,0;2,0;1,0;;39,0;;1,0;69,0;;;21,0;4,0;36,0;;8,0;;2,0;;9,0;3,0;2,0;;20,0;3,0;;2,0;;;;;;;;;6,0;;;;;;10,0;;;;2,0;2,0;;;5,0;;;;;;;2,0;;1,0;;;;;;;;;;;1,0;;;;1,0;;;4,0;1,0;9,0;;;2,0;;5,0;;3,0;;1,0;;;;56,0;1,0;;1,0;7,0;;;;;;;;4,0;3,0;;;;1,0;;2,0;;;;;;;;;8,0;;;;;;12,0;;9,0;;18,0;;9,0;;;;;;5,0;3,0;;1,0;;;5,0;;;4,0;;;4,0;2,0;;;1,0;;;27,0;1,0;1,0;;;1,0;;13,0;;;3,0;;5,0;;;28,0;6,0;1,0;2,0;;;;;4,0;9,0;;;;1,0;;;8,0;;;;;;;11,0;7,0;;1,0;;;;;;;;1,0;1,0;;2,0;;;;;;1,0;;3,0;9,0;;;;;;4,0;;;1,0;;;;6,0;;;;;;;7,0;;;;4,0;;;;;;;;;;;;;10,0;;6,0;;;;;;;;;1,0;;;;;;;;2,0;;;;12,0;;7,0;3,0;;1,0;12,0;;;13,0;;;3,0;;;;;;;13,0;8,0;;;;3,0;;;28,0;;2,0;;;4,0;;;;;4,0;;;2,0;6,0;2,0;;;;;;;;;;;;;;;;;4,0;;3,0;4,0;;;;;;1,0;;;;;;;;;;;;;;;59,0;4,0;;1,0;;;;16,0;;;;;;;;;;;;;;;;;8,0;;;;;;;12,0;;;;;;;51,0;;;2,0;;1,0;;;11,0;;;7,0;;;;;;;;;;;;;;;;2,0;2,0;;;4,0;;;;;;;1,0;;;;;;;;;;;;;;;;;;;;;;;;;;;;2,0;;5,0;;60,0;;3,0;1,0;;;;;;;;;;;;;3,0;;;;;;;;3,0;;;;;;;;;;;;;;;;;;;;;19,0;;;;6,0;6,0;;3,0;;29,0;;;;;;;;;;;;1,0;;180,0;;3,0;;;;;4,0;2,0;2,0;;;;;2,0;;1,0;;;;;1,0;;;7,0;;1,0;;2,0;41,0;;5,0;;;;;;;1,0;;5,0;;;;;;;;;;;;;;;3,0;1,0;;;;;;2,0;;;;;;;2,0;1,0;;5,0;;;;;;;;10,0;;;;;11,0;;;;4,0;;;1,0;;;;;2,0;;;;1,0;;;;;;;;;;;8,0;;;;;8,0;;;;;;;;;;;;;;;;;;;;;;;;12,0;;;;;;;;;;;5,0;;;;;10,0;2,0;;;21,0;;;;;;;;;;1,0;;;;;;8,0;;;;;;;;;;;;;;4,0;;;;;;
zoom;3,0;2,0;11,0;2,0;;147,0;45,0;179,0;36,0;10,0;8,0;76,0;20,0;6,0;147,0;110,0;8,0;26,0;;;2,0;33,0;93,0;1,0;10,0;2,0;2,0;8,0;13,0;18,0;9,0;219,0;108,0;;258,0;71,0;8,0;53,0;4,0;9,0;48,0;8,0;13,0;2,0;55,0;7,0;61,0;253,0;71,0;111,0;12,0;59,0;22,0;3,0;73,0;;213,0;5,0;;;6,0;2,0;36,0;1,0;2,0;218,0;131,0;427,0;35,0;4,0;92,0;;57,0;;1,0;118,0;13,0;1,0;4,0;1079,0;10,0;280,0;2,0;384,0;33,0;40,0;67,0;;;256,0;4739,0;;1,0;3,0;1,0;1,0;2,0;;117,0;13,0;5,0;;69,0;107,0;8,0;48,0;705,0;178,0;15,0;42,0;5,0;160,0;;5,0;11,0;119,0;111,0;369,0;242,0;50,0;3,0;8,0;15,0;66,0;65,0;8,0;8,0;;;76,0;;9,0;17,0;1,0;11,0;32,0;34,0;25,0;;335,0;36,0;2,0;8,0;47,0;80,0;;;108,0;307,0;57,0;16,0;1,0;7,0;21,0;20,0;;2804,0;367,0;138,0;;12,0;21,0;811,0;2,0;41,0;;55,0;45,0;3,0;;;;;8,0;32,0;12,0;9,0;13,0;;;1,0;42,0;;3,0;;5,0;;12,0;70,0;2,0;2,0;;;4,0;13,0;4,0;;;;2,0;2,0;;40,0;71,0;8,0;1,0;326,0;;3,0;35,0;2,0;1,0;;;;;3,0;;15,0;2,0;16,0;9,0;;;;;;3,0;22,0;;28,0;;5,0;11,0;3,0;203,0;31,0;8,0;;3,0;2,0;3,0;;5,0;;;2,0;;30,0;12,0;;;;;;;53,0;5,0;;30,0;;1,0;;41,0;;;2,0;;7,0;;7,0;3,0;8,0;;6,0;1,0;1,0;12,0;4,0;140,0;2,0;;10,0;8,0;4,0;167,0;2,0;11,0;;5,0;12,0;16,0;20,0;;;;2,0;;;;7,0;12,0;1,0;2,0;;;;;1,0;3,0;;4,0;1,0;;8,0;4,0;;;4,0;5,0;;;;;83,0;;2,0;;26,0;;;2,0;;;;10,0;;7,0;1,0;3,0;;;1,0;1,0;626,0;18,0;;36,0;5,0;;;33,0;;7,0;;1,0;;24,0;3,0;2,0;;7,0;;;;;;7,0;;2,0;5,0;;;8,0;;;11,0;;13,0;23,0;;;1,0;;1,0;8,0;;;;5,0;;44,0;;2,0;;1,0;;3,0;17,0;;1,0;;;8,0;;;;;6,0;23,0;104,0;3,0;2,0;1,0;8,0;7,0;;;7,0;2,0;;7,0;25,0;10,0;;;;8,0;;4,0;;65,0;69,0;1,0;10,0;3,0;4,0;4,0;20,0;;13,0;7,0;41,0;;1,0;21,0;211,0;6,0;16,0;13,0;23,0;4,0;;5,0;15,0;6,0;7,0;2,0;;;3,0;;6,0;28,0;;;;15,0;2,0;8,0;1,0;;2,0;7,0;38,0;;12,0;;;;112,0;4,0;;46,0;38,0;;15,0;2,0;1,0;3,0;;2,0;3,0;;78,0;;1,0;36,0;4,0;2,0;68,0;1,0;;10,0;9,0;2,0;;;1,0;2,0;13,0;4,0;;;;;2,0;;6,0;3,0;1,0;8,0;3,0;35,0;;3,0;6,0;1,0;10,0;;;1,0;6,0;5,0;;;65,0;;3,0;52,0;;2,0;2,0;6,0;;8,0;65,0;1,0;1,0;4,0;;;;;;;;;;9,0;;5,0;;4,0;;20,0;2,0;2,0;1,0;4,0;75,0;;3,0;;2,0;8,0;1,0;;;;;;;17,0;1,0;;;;;;1,0;;;;5,0;;;1,0;15,0;;13,0;1,0;;2,0;;6,0;1,0;;;2,0;1,0;8,0;;;;;;;1,0;1,0;;;;6,0;6,0;;7,0;;;2,0;;;;;1,0;;2,0;;;;19,0;;11,0;;1,0;1,0;;;29,0;;;1,0;;2,0;3,0;;9,0;3,0;;5,0;1,0;2,0;;13,0;10,0;1,0;;30,0;;31,0;35,0;1,0;;;;2,0;3,0;;1,0;;;;6,0;;;3,0;3,0;6,0;;7,0;;2,0;4,0;;2,0;;;;6,0;;;;;;1,0;;2,0;6,0;;;;;;;;;;2,0;;;;;;;2,0;2,0;;;2,0;2,0;;;;2,0;1,0;1,0;7,0;;1,0;;3,0;;;5,0;;;3,0;;;;;;;;1,0;1,0;5,0;6,0;1,0;2,0;;;;2,0;2,0;;;4,0;;;;;;13,0;;;;4,0;;33,0;;;;;3,0;;2,0;;;;3,0;7,0;;1,0;4,0;;;;;10,0;;6,0;2,0;;6,0;;;;5,0;;160,0;16,0;6,0;2,0;5,0;3,0;;;;;1,0;;27,0;;3,0;;12,0;;2,0;;;;;1,0;;;3,0;;;1,0;4,0;;;2,0;5,0;11,0;3,0;1,0;2,0;;;;2,0;1,0;1,0;9,0;;;11,0;5,0;5,0;;1,0;6,0;;;2,0;1,0;;;;1,0;3,0;;;;3,0;;;5,0;2,0;;;;3,0;;;1,0;2,0;;6,0;3,0;;;;;;;;;1,0;1,0;2,0;;4,0;;;;;;;;;2,0;1,0;;15,0;2,0;;7,0;;;1,0;19,0;;;;;5,0;18,0;;;;;4,0;;;;;6,0;;1,0;3,0;;7,0;;;;1,0;1,0;;2,0;;3,0;;;3,0;1,0;8,0;;;;;;;1,0;;;;;;;15,0;;;1,0;;3,0;;2,0;;13,0;1,0;3,0;;1,0;;;;;;14,0;;2,0;;;;;;20,0
aberration;;12,0;1,0;2,0;1,0;2,0;2,0;8,0;2,0;1,0;1,0;1,0;6,0;1,0;2,0;12,0;2,0;3,0;6,0;1,0;9,0;6,0;2,0;1,0;2,0;3,0;6,0;16,0;1,0;9,0;3,0;5,0;7,0;1,0;1,0;4,0;24,0;8,0;3,0;5,0;59,0;2,0;3,0;1,0;2,0;1,0;32,0;7,0;24,0;2,0;1,0;2,0;32,0;2,0;1,0;1,0;4,0;4,0;14,0;1,0;1,0;3,0;5,0;10,0;6,0;1,0;4,0;12,0;11,0;1,0;2,0;2,0;13,0;1,0;4,0;1,0;1,0;3,0;1,0;89,0;1,0;13,0;1,0;14,0;7,0;2,0;5,0;8,0;10,0;1,0;31,0;1,0;2,0;1,0;1,0;2,0;12,0;1,0;26,0;1,0;33,0;1,0;2,0;6,0;3,0;6,0;106,0;16,0;5,0;1,0;2,0;4,0;6,0;6,0;1,0;2,0;6,0;7,0;5,0;1,0;1,0;2,0;5,0;12,0;3,0;1,0;4,0;1,0;1,0;1,0;1,0;1,0;2,0;2,0;1,0;2,0;2,0;6,0;2,0;4,0;4,0;5,0;22,0;10,0;1,0;2,0;1,0;1,0;3,0;1,0;2,0;2,0;2,0;18,0;2,0;2,0;37,0;1,0;4,0;1,0;2,0;3,0;2,0;2,0;3,0;1,0;1,0;1,0;1,0;2,0;3,0;;;;;;;;;;;;;;;;;;;;;;;;;;;;;;;;;;;;;;;;;;;;;;;;;;;;;;;;;;;;;;;;;;;;;;;;;;;;;;;;;;;;;;;;;;;;;;;;;;;;;;;;;;;;;;;;;;;;;;;;;;;;;;;;;;;;;;;;;;;;;;;;;;;;;;;;;;;;;;;;;;;;;;;;;;;;;;;;;;;;;;;;;;;;;;;;;;;;;;;;;;;;;;;;;;;;;;;;;;;;;;;;;;;;;;;;;;;;;;;;;;;;;;;;;;;;;;;;;;;;;;;;;;;;;;;;;;;;;;;;;;;;;;;;;;;;;;;;;;;;;;;;;;;;;;;;;;;;;;;;;;;;;;;;;;;;;;;;;;;;;;;;;;;;;;;;;;;;;;;;;;;;;;;;;;;;;;;;;;;;;;;;;;;;;;;;;;;;;;;;;;;;;;;;;;;;;;;;;;;;;;;;;;;;;;;;;;;;;;;;;;;;;;;;;;;;;;;;;;;;;;;;;;;;;;;;;;;;;;;;;;;;;;;;;;;;;;;;;;;;;;;;;;;;;;;;;;;;;;;;;;;;;;;;;;;;;;;;;;;;;;;;;;;;;;;;;;;;;;;;;;;;;;;;;;;;;;;;;;;;;;;;;;;;;;;;;;;;;;;;;;;;;;;;;;;;;;;;;;;;;;;;;;;;;;;;;;;;;;;;;;;;;;;;;;;;;;;;;;;;;;;;;;;;;;;;;;;;;;;;;;;;;;;;;;;;;;;;;;;;;;;;;;;;;;;;;;;;;;;;;;;;;;;;;;;;;;;;;;;;;;;;;;;;;;;;;;;;;;;;;;;;;;;;;;;;;;;;;;;;;;;;;;;;;;;;;;;;;;;;;;;;;;;;;;;;;;;;;;;;;;;;;;;;;
absorb;;1,0;;;;9,0;9,0;5,0;;2,0;5,0;;;;;1,0;1,0;;;;;;;;;;4,0;;6,0;;;;11,0;;2,0;;;;;1,0;;;3,0;;1,0;;;5,0;11,0;;34,0;3,0;;;;;5,0;;2,0;;1,0;4,0;;;37,0;;;14,0;;;;2,0;4,0;;;1,0;;;;7,0;;13,0;;22,0;;;;;;;5,0;;;26,0;;2,0;;;5,0;;;;9,0;2,0;;;23,0;;;;2,0;1,0;;;;3,0;47,0;11,0;;1,0;;;8,0;;;;1,0;;2,0;2,0;;;;;;;;;;;;;;2,0;;;;11,0;;;;;;;;;7,0;;;;;14,0;11,0;;;;;9,0;11,0;5,0;;;1,0;1,0;7,0;3,0;8,0;1,0;4,0;4,0;1,0;7,0;2,0;1,0;1,0;2,0;1,0;6,0;2,0;5,0;4,0;3,0;1,0;2,0;1,0;1,0;2,0;1,0;8,0;6,0;1,0;1,0;2,0;6,0;3,0;2,0;1,0;2,0;25,0;4,0;23,0;3,0;2,0;3,0;3,0;2,0;5,0;7,0;2,0;6,0;14,0;1,0;11,0;1,0;3,0;4,0;103,0;2,0;165,0;4,0;51,0;3,0;20,0;3,0;20,0;10,0;4,0;9,0;1,0;4,0;2,0;1,0;11,0;4,0;1,0;3,0;3,0;3,0;1,0;1,0;17,0;3,0;1,0;2,0;2,0;1,0;2,0;2,0;11,0;3,0;9,0;2,0;4,0;1,0;5,0;2,0;9,0;2,0;6,0;1,0;1,0;1,0;1,0;4,0;1,0;1,0;2,0;15,0;23,0;32,0;1,0;2,0;3,0;3,0;12,0;2,0;2,0;1,0;1,0;2,0;29,0;13,0;15,0;4,0;1,0;2,0;3,0;45,0;17,0;;;;;;;;;;;;;;;;;;;;;;;;;;;;;;;;;;;;;;;;;;;;;;;;;;;;;;;;;;;;;;;;;;;;;;;;;;;;;;;;;;;;;;;;;;;;;;;;;;;;;;;;;;;;;;;;;;;;;;;;;;;;;;;;;;;;;;;;;;;;;;;;;;;;;;;;;;;;;;;;;;;;;;;;;;;;;;;;;;;;;;;;;;;;;;;;;;;;;;;;;;;;;;;;;;;;;;;;;;;;;;;;;;;;;;;;;;;;;;;;;;;;;;;;;;;;;;;;;;;;;;;;;;;;;;;;;;;;;;;;;;;;;;;;;;;;;;;;;;;;;;;;;;;;;;;;;;;;;;;;;;;;;;;;;;;;;;;;;;;;;;;;;;;;;;;;;;;;;;;;;;;;;;;;;;;;;;;;;;;;;;;;;;;;;;;;;;;;;;;;;;;;;;;;;;;;;;;;;;;;;;;;;;;;;;;;;;;;;;;;;;;;;;;;;;;;;;;;;;;;;;;;;;;;;;;;;;;;;;;;;;;;;;;;;;;;;;;;;;;;;;;;;;;;;;;;;;;;;;;;;;;;;;;;;;;;;;;;;;;;;;;;;;;;;;;;;;;;;;;;;;;;;;;;;;;;;;;;;;;;;;;;;;;;;;;;;;;;;;;;;;;;;;;;;;;;;;;;;;;;;;;;;;;;;;;;;;;;;;;;;;;;;;;;;;;;;;;;;;;;;;;;;;;;;;;;;;;;;;;;;;;;;;;;;;;;;;;;;;;;;
accommodate;;2,0;;;2,0;1,0;;8,0;2,0;;;;;;1,0;7,0;;;;;1,0;2,0;;;;;;;;;;3,0;24,0;;9,0;;;;;6,0;;1,0;11,0;;1,0;;2,0;13,0;;4,0;9,0;3,0;;;1,0;;43,0;1,0;;;4,0;;2,0;;;;;15,0;6,0;4,0;;2,0;1,0;;;2,0;;;;36,0;2,0;25,0;;19,0;;;;;;6,0;104,0;;;2,0;;1,0;;;4,0;;;1,0;38,0;4,0;;;21,0;2,0;;;;2,0;;;;19,0;42,0;25,0;1,0;2,0;;;;1,0;;;;;1,0;;4,0;6,0;;;;;3,0;;;1,0;;;;32,0;1,0;2,0;2,0;7,0;8,0;11,0;;2,0;;2,0;;1,0;13,0;3,0;3,0;;;;40,0;1,0;7,0;;6,0;3,0;;;2,0;;1,0;;;;21,0;24,0;;;7,0;13,0;2,0;4,0;12,0;12,0;;2,0;;;1,0;;;7,0;;;;;;9,0;1,0;;1,0;2,0;;1,0;;2,0;1,0;1,0;2,0;;;;1,0;;16,0;6,0;4,0;21,0;57,0;;10,0;;;12,0;3,0;;6,0;;34,0;;6,0;34,0;7,0;3,0;7,0;15,0;;1,0;;;;;;;;;;;8,0;;;;;;25,0;3,0;;;;;1,0;;1,0;;9,0;4,0;5,0;;;3,0;48,0;;;7,0;;9,0;21,0;24,0;;;;1,0;;2,0;;;;;5,0;1,0;;;9,0;2,0;;;5,0;;4,0;2,0;7,0;;;1,0;1,0;7,0;7,0;;;13,0;3,0;;3,0;;14,0;12,0;;5,0;21,0;;1,0;2,0;4,0;;6,0;;;;;;;2,0;2,0;;;5,0;2,0;22,0;8,0;;1,0;1,0;;1,0;;;;;;;;6,0;2,0;;;;4,0;;4,0;;4,0;3,0;1,0;;;3,0;10,0;;;;;;;3,0;5,0;6,0;1,0;3,0;;4,0;;7,0;1,0;;;3,0;;39,0;;;4,0;2,0;2,0;5,0;7,0;4,0;4,0;;;;;7,0;;;;;;;;;;;;;1,0;;;;;;;;;;;;;;;4,0;;;;;;;;;1,0;;6,0;;;;1,0;;9,0;;6,0;;;;;2,0;;;;;1,0;;;;;2,0;;;;7,0;;;;;2,0;;;;1,0;1,0;2,0;2,0;;;;;;;1,0;;;;;;;;;;;;1,0;;;4,0;;;2,0;;;;;1,0;;;;;;;1,0;;;;4,0;8,0;;;;;;;;;;3,0;;;;1,0;;;;1,0;;;;;;;;;;;;;;7,0;;11,0;5,0;;;;14,0;1,0;;;2,0;1,0;;;;;;;;;;;;;;;;;;;;;4,0;;;;;4,0;;;;;2,0;;1,0;;;;;;;;;;;;;;;;;;;;;;2,0;;;;;;;1,0;;;;;;;;1,0;;;;;;;;2,0;2,0;3,0;;;;1,0;;;1,0;;1,0;;6,0;2,0;2,0;;;;;2,0;;;;1,0;;;;;;;;;6,0;6,0;;;5,0;3,0;2,0;2,0;;;;2,0;;2,0;1,0;;;;;;3,0;;4,0;;;;;;;;;3,0;;;;6,0;;1,0;2,0;8,0;4,0;1,0;17,0;5,0;5,0;1,0;1,0;5,0;1,0;3,0;2,0;1,0;2,0;3,0;3,0;1,0;1,0;1,0;1,0;3,0;2,0;2,0;2,0;2,0;1,0;1,0;3,0;10,0;2,0;1,0;3,0;2,0;1,0;1,0;1,0;4,0;2,0;1,0;1,0;2,0;3,0;;;;;;;;;;;;;;;;;;;;;;;;;;;;;;;;;;;;;;;;;;;;;;;;;;;;;;;;;;;;;;;;;;;;;;;;;;;;;;;;;;;;;;;;;;;;;;;;;;;;;;;;;;;;;;;;;;;;;;;;;;;;;;;;;;;;;;;;;;;;;;;;;;;;;;;;;;;;;;;;;;;;;;;;;;;;;;;;;;;;;;;;;;;;;;;;;;;;;;;;;;;;;;;;;;;;;;;;;;;;;;;;;;;;;;;;;;;;;;;;;
activate;;2,0;;31,0;;;2,0;19,0;13,0;2,0;;;49,0;3,0;;7,0;1,0;;2,0;1,0;;73,0;2,0;;;;3,0;4,0;;;6,0;;35,0;;74,0;35,0;;;;;18,0;;1,0;4,0;9,0;2,0;23,0;64,0;6,0;8,0;;4,0;;;10,0;1,0;35,0;;1,0;;1,0;6,0;2,0;;4,0;1,0;7,0;;8,0;;58,0;2,0;16,0;;;;;10,0;11,0;107,0;;4,0;6,0;23,0;;28,0;;;1,0;1,0;6,0;;4,0;2,0;;6,0;9,0;;41,0;11,0;;;35,0;4,0;;12,0;5,0;2,0;18,0;8,0;;15,0;;;;16,0;9,0;18,0;5,0;6,0;;;5,0;17,0;15,0;1,0;;;2,0;;;9,0;;1,0;;5,0;5,0;50,0;;;5,0;2,0;4,0;40,0;8,0;;;1,0;34,0;;;;10,0;11,0;;;47,0;;3,0;2,0;;6,0;110,0;2,0;;;6,0;4,0;;;8,0;;;1,0;1,0;;5,0;;;;;1,0;;;;5,0;;6,0;;;;;;3,0;1,0;;1,0;;;;;1,0;4,0;6,0;;;1,0;;18,0;5,0;1,0;;;;;;;;;;4,0;;;;;;;;70,0;;1,0;;3,0;7,0;;3,0;11,0;1,0;;;;1,0;;5,0;1,0;;;2,0;13,0;;;;;2,0;;;40,0;;;;;;;5,0;;2,0;;;22,0;;16,0;42,0;1,0;;;;25,0;;;;16,0;;8,0;;;15,0;;3,0;2,0;;7,0;;;;;1,0;;;;;2,0;;1,0;;;;;2,0;1,0;;3,0;3,0;3,0;;12,0;;6,0;;;4,0;;;;;;4,0;3,0;;;1,0;;;;;;2,0;;;;;;;2,0;2,0;;;7,0;9,0;;2,0;;;;;;1,0;5,0;2,0;10,0;;;1,0;;1,0;;;;;;;;12,0;;;;;;;3,0;;;;;;;;;;;9,0;4,0;2,0;2,0;;;;5,0;;;13,0;;;;2,0;;;;;1,0;;3,0;7,0;1,0;;9,0;;;;;;;1,0;6,0;8,0;;;1,0;7,0;;;;31,0;7,0;;4,0;;3,0;2,0;45,0;;;6,0;8,0;;1,0;5,0;30,0;1,0;;1,0;3,0;;;6,0;6,0;10,0;13,0;;;1,0;15,0;2,0;6,0;;;;4,0;;1,0;10,0;;;19,0;;72,0;;;;6,0;;3,0;;;3,0;;4,0;1,0;;;3,0;8,0;;28,0;6,0;;;3,0;24,0;19,0;;12,0;4,0;62,0;3,0;15,0;;9,0;;1,0;;;4,0;;4,0;;;;1,0;;2,0;2,0;;;;1,0;2,0;2,0;;4,0;29,0;;3,0;;3,0;;;4,0;24,0;2,0;5,0;5,0;2,0;;;;;;3,0;;7,0;;;;2,0;;;;1,0;;33,0;;1,0;18,0;;;48,0;;2,0;4,0;;2,0;1,0;;;;4,0;;3,0;1,0;;;4,0;;;11,0;;;3,0;3,0;;23,0;;;;1,0;;;;1,0;;;;4,0;1,0;;2,0;;;;;;;;2,0;;;;;1,0;;;;2,0;3,0;;;1,0;1,0;;1,0;1,0;;;1,0;;;;;;;;;2,0;1,0;;4,0;;;1,0;44,0;;9,0;;;;1,0;3,0;6,0;;;;;2,0;;;;2,0;;;;2,0;1,0;;;2,0;;2,0;;;;6,0;;;;;;;3,0;;1,0;1,0;1,0;;;;1,0;;;;;1,0;1,0;3,0;;;;;4,0;3,0;;;;;;;;;;;;;;;4,0;;;;;;;2,0;;;;11,0;;2,0;1,0;;;2,0;;;3,0;;;;;;;;;;;;;;2,0;;;;;;;;1,0;;4,0;;;;;4,0;;;;;;3,0;;2,0;;;;;;2,0;;;6,0;1,0;5,0;2,0;1,0;;;;;1,0;7,0;;1,0;;;;;;;;;;;;;;;;2,0;;;;;2,0;2,0;;;;;;;15,0;;;;;;;;;;;;4,0;;2,0;4,0;1,0;;1,0;4,0;1,0;;;;;;2,0;;;;;;;;;1,0;3,0;;;;;2,0;6,0;4,0;2,0;2,0;12,0;2,0;2,0;1,0;1,0;1,0;1,0;2,0;2,0;4,0;2,0;1,0;16,0;1,0;1,0;4,0;;;;;;;;;;;;;;;;;;;;;;;;;;;;;;;;;;;;;;;;;;;;;;;;;;;;;;;;;;;;;;;;;;;;;;;;;;;;;;;;;;;;;;;;;;;;;;;;;;;;;;;;;;;;
adapter;;2,0;;;;4,0;22,0;9,0;8,0;9,0;1,0;;12,0;;30,0;68,0;7,0;;;;;11,0;1,0;6,0;;1,0;2,0;1,0;;;2,0;1,0;14,0;;114,0;;2,0;;;;30,0;;8,0;1,0;10,0;;3,0;57,0;34,0;22,0;19,0;6,0;;;2,0;;4,0;;;;44,0;9,0;2,0;3,0;6,0;2,0;1,0;3,0;4,0;15,0;2,0;2,0;11,0;;;;;1,0;;17,0;;17,0;2,0;83,0;2,0;2,0;47,0;;;25,0;134,0;;;;;4,0;;;34,0;5,0;;;2,0;27,0;;7,0;64,0;6,0;21,0;;3,0;5,0;6,0;;;16,0;44,0;5,0;36,0;6,0;2,0;;9,0;8,0;;20,0;;;;5,0;;9,0;12,0;3,0;;;1,0;1,0;;;;7,0;2,0;1,0;5,0;;;42,0;58,0;;;;4,0;7,0;;32,0;136,0;2,0;;1,0;;8,0;52,0;;;;18,0;5,0;;6,0;3,0;;;5,0;;;31,0;1,0;;;2,0;74,0;;1,0;;19,0;;;;;;1,0;;48,0;;16,0;;;;3,0;4,0;;4,0;6,0;;;;;;7,0;;;3,0;;;;7,0;;;14,0;18,0;;3,0;;;4,0;;;30,0;;33,0;;3,0;237,0;1,0;2,0;2,0;23,0;1,0;;;1,0;;20,0;1,0;;;;1,0;2,0;205,0;;;1,0;;;28,0;1,0;;;;;23,0;11,0;;;2,0;;3,0;;2,0;2,0;1,0;;;2,0;4,0;;;51,0;20,0;10,0;109,0;;;12,0;;;;;;;;;8,0;;1,0;;1,0;;;16,0;62,0;;;;2,0;;12,0;;;;4,0;;;1,0;;83,0;;7,0;1,0;;3,0;4,0;9,0;;10,0;13,0;;;8,0;4,0;39,0;;;;8,0;16,0;3,0;7,0;9,0;;5,0;;;;5,0;;8,0;;4,0;1,0;;1,0;;;12,0;24,0;1,0;;;;;1,0;5,0;2,0;;1,0;4,0;;3,0;8,0;6,0;;;1,0;65,0;3,0;7,0;16,0;3,0;10,0;10,0;4,0;;7,0;1,0;15,0;;25,0;1,0;;;;20,0;25,0;;;;;;;;6,0;;;;5,0;2,0;;1,0;2,0;;;;;;;;;;3,0;;;;;;8,0;;1,0;;22,0;1,0;4,0;;;;4,0;5,0;;1,0;;2,0;;90,0;8,0;9,0;1,0;16,0;2,0;9,0;;;;;3,0;7,0;;;;1,0;;;6,0;;;3,0;23,0;1,0;5,0;;;;;;1,0;;;20,0;;10,0;9,0;;19,0;;;;;;;;;;4,0;;1,0;;;54,0;;5,0;;7,0;3,0;2,0;;1,0;;1,0;;;;;5,0;;1,0;;;4,0;1,0;;;;;;;1,0;18,0;;;;;1,0;50,0;;8,0;3,0;;;;;;;;;1,0;1,0;7,0;1,0;;12,0;;;;28,0;18,0;;;;;;1,0;;2,0;;;7,0;19,0;2,0;;3,0;;16,0;;;5,0;;1,0;;;;;;6,0;12,0;;;;25,0;;;;7,0;1,0;9,0;2,0;4,0;;1,0;1,0;1,0;;;;;1,0;;3,0;;;1,0;2,0;;;6,0;;;;5,0;;;;;;;;;;;;;;;7,0;;;;15,0;;;;;;;;;;7,0;;;;22,0;;4,0;7,0;9,0;;;8,0;3,0;7,0;10,0;;;2,0;2,0;;5,0;12,0;9,0;1,0;1,0;;;;1,0;2,0;13,0;;;3,0;;;5,0;;;;153,0;;;;;;2,0;;1,0;27,0;2,0;;;;;7,0;;4,0;;2,0;;;;2,0;;;;;5,0;;6,0;;;;19,0;;;;;;10,0;2,0;;;5,0;;;1,0;;;3,0;;1,0;;;2,0;;;;;;;;10,0;;;;;2,0;;;;;;;;;;;;;;;1,0;;;;;;;;;;;;1,0;;;;;;;;;;;5,0;;;;;3,0;4,0;;;4,0;;;;11,0;;;;;;;;;;;;4,0;;;;;;1,0;2,0;;;;;;;;12,0;;;;;;;5,0;1,0;;;;;;3,0;;1,0;;;8,0;;;;;;;;;;;;;;;;;;;;;;;1,0;;1,0;;4,0;;;;;;;;;;;;;;1,0;;;;;;;;;3,0;;;;;;;;;;1,0;;;;;;3,0;;;1,0;;;;;;;;;;;2,0;;;;;5,0;;;;;;;;;;;1,0;4,0;1,0;1,0;2,0;3,0;1,0;2,0;2,0;1,0;;;;;;;;;;;;;;;;;;;;;;;;;;;;;;;;;;;;;;;;;;
adhesive;;3,0;;;;1,0;;8,0;11,0;5,0;2,0;;3,0;;;33,0;;;;;;4,0;;;3,0;;3,0;;;;;;4,0;;1,0;;;;;;;;21,0;4,0;;;;22,0;;;20,0;4,0;;;;10,0;19,0;;;;2,0;2,0;;;7,0;1,0;1,0;38,0;17,0;9,0;1,0;;4,0;;;1,0;;;;34,0;8,0;6,0;;25,0;1,0;;;;1,0;1,0;103,0;;;31,0;;;;;47,0;;1,0;;121,0;1,0;;;7,0;;;;3,0;1,0;5,0;2,0;;13,0;73,0;16,0;1,0;;1,0;;18,0;;;;;;1,0;1,0;;;1,0;4,0;;;3,0;;;;;;;44,0;;;;25,0;;;;3,0;;;;;10,0;;2,0;;;2,0;1,0;;;14,0;;1,0;;;;1,0;;1,0;;54,0;28,0;28,0;;;19,0;6,0;43,0;3,0;;21,0;13,0;6,0;1,0;;1,0;;4,0;15,0;;25,0;;;;20,0;1,0;;;9,0;;;;;15,0;35,0;6,0;2,0;;3,0;6,0;;15,0;5,0;;25,0;32,0;;9,0;1,0;;4,0;55,0;;17,0;1,0;25,0;6,0;1,0;18,0;;1,0;2,0;11,0;1,0;10,0;;2,0;4,0;;;;;;4,0;1,0;18,0;;;;;;20,0;;;1,0;3,0;8,0;7,0;;6,0;;1,0;5,0;;4,0;;;16,0;1,0;;;;13,0;72,0;93,0;;;1,0;6,0;1,0;4,0;1,0;;;6,0;11,0;3,0;;2,0;6,0;;;2,0;10,0;5,0;9,0;7,0;35,0;;3,0;;;8,0;20,0;1,0;;3,0;3,0;1,0;;;;;;3,0;;;2,0;1,0;2,0;;10,0;;;;;;;;;;;1,0;9,0;48,0;6,0;;5,0;2,0;;;;1,0;1,0;5,0;1,0;;;2,0;1,0;;;1,0;;;;;4,0;2,0;2,0;;;6,0;38,0;;;3,0;;;;;7,0;;;;;;;;4,0;;;;4,0;20,0;5,0;;;;1,0;;;;10,0;1,0;;;;1,0;;;;;;;;;;;;;;1,0;;;;;2,0;;;;;;;;;;28,0;;;;;;;;;;1,0;;;;;;;;;;;;;;;;2,0;;1,0;;;;;;;;;;;;;;2,0;;;;;;3,0;9,0;;1,0;;;;;;;;;;;;;;;2,0;;1,0;;;;;;;;;;;;;;;;4,0;;;2,0;;;;;;;;;;;;;;1,0;;2,0;;;;;;7,0;;1,0;;;;;;;;;1,0;;;;;;2,0;;;;;;3,0;;2,0;;2,0;;;;;;1,0;;;2,0;;;;;;;;;;;;;;;;3,0;;4,0;;;;;1,0;;;;;;1,0;;;;;;2,0;;;;;;;;;;;;;;2,0;;1,0;;;;;;;;;1,0;;;;;;;;;;4,0;;1,0;;;;1,0;;11,0;;;;;;;;1,0;;;;1,0;;;;4,0;;1,0;;;;;6,0;3,0;;;;;2,0;2,0;;2,0;;;3,0;;;;;;1,0;;5,0;;1,0;;;;;;;;;;;;;12,0;;;;;1,0;3,0;;9,0;;;2,0;11,0;54,0;;;;;;;;;;;5,0;;2,0;;7,0;;;;3,0;;;12,0;;;;;12,0;2,0;3,0;;;;;;;;;;;;1,0;;;;2,0;;;;2,0;;;1,0;;;;;;;;;;;;;;;;;;;;;;;;2,0;;;;;;;;;;;;;;;;;;;;;;;;1,0;;;;;;;;1,0;;2,0;;;;;;;;;;;;;;;;;;;;;;;;;;1,0;;;;;;;;;;;;;;;;;;;;;;;;;;;;;;;;;2,0;;;2,0;;;;3,0;;;;;;;1,0;;;1,0;10,0;;;;;;;;;4,0;;;;;;;;;;;;1,0;;;12,0;;;;;;;;;;;;3,0;;;;;;;;;;;;;3,0;;;;;;153,0;1,0;;;;;;;;;;;;;;;;;;;;;;;;;;;;;;
adjacent;;4,0;;;1,0;19,0;64,0;28,0;46,0;66,0;23,0;;3,0;;21,0;41,0;16,0;1,0;17,0;2,0;5,0;31,0;3,0;20,0;;;52,0;;1,0;2,0;;6,0;19,0;3,0;4,0;2,0;7,0;2,0;2,0;;56,0;2,0;15,0;11,0;6,0;14,0;37,0;28,0;14,0;34,0;93,0;31,0;1,0;11,0;3,0;42,0;96,0;;7,0;;22,0;;34,0;2,0;13,0;3,0;9,0;55,0;74,0;30,0;1,0;;9,0;1,0;1,0;27,0;;1,0;7,0;251,0;6,0;21,0;1,0;60,0;2,0;;;;1,0;;193,0;;;3,0;;2,0;;;56,0;;;1,0;33,0;42,0;2,0;3,0;37,0;6,0;15,0;2,0;1,0;18,0;14,0;;2,0;165,0;152,0;156,0;4,0;8,0;1,0;21,0;3,0;13,0;4,0;;;;1,0;7,0;4,0;9,0;32,0;2,0;37,0;;19,0;;5,0;2,0;5,0;;;69,0;5,0;;;138,0;91,0;4,0;5,0;4,0;3,0;1,0;15,0;2,0;39,0;;1,0;13,0;1,0;1,0;129,0;;8,0;;11,0;32,0;5,0;;8,0;1,0;1,0;;3,0;;15,0;3,0;5,0;3,0;15,0;44,0;;7,0;1,0;22,0;;17,0;1,0;;;2,0;2,0;50,0;2,0;17,0;;;2,0;47,0;1,0;;44,0;73,0;;;;;3,0;14,0;14,0;5,0;;6,0;21,0;3,0;9,0;3,0;2,0;43,0;23,0;13,0;17,0;;;7,0;38,0;;58,0;;63,0;4,0;4,0;32,0;9,0;3,0;6,0;26,0;24,0;19,0;33,0;15,0;;7,0;7,0;5,0;7,0;;441,0;27,0;19,0;2,0;4,0;;;;4,0;1,0;1,0;2,0;2,0;;1,0;21,0;1,0;;2,0;3,0;10,0;;4,0;15,0;54,0;4,0;;11,0;;11,0;38,0;179,0;6,0;;37,0;1,0;;24,0;4,0;7,0;;16,0;90,0;21,0;8,0;1,0;36,0;5,0;5,0;;12,0;2,0;;16,0;11,0;1,0;1,0;22,0;;10,0;18,0;2,0;;4,0;;7,0;1,0;11,0;1,0;1,0;6,0;12,0;;;6,0;8,0;47,0;;7,0;5,0;;1,0;2,0;6,0;6,0;;3,0;;7,0;8,0;2,0;10,0;2,0;5,0;4,0;1,0;;10,0;3,0;7,0;15,0;5,0;5,0;3,0;;;5,0;8,0;2,0;19,0;2,0;;;1,0;;5,0;19,0;3,0;3,0;35,0;11,0;2,0;1,0;;;;15,0;;5,0;1,0;2,0;1,0;5,0;2,0;24,0;2,0;4,0;7,0;18,0;1,0;2,0;32,0;5,0;40,0;;1,0;3,0;3,0;4,0;2,0;22,0;2,0;;;9,0;;3,0;;;1,0;;18,0;14,0;3,0;5,0;4,0;5,0;;1,0;;;1,0;11,0;;13,0;4,0;;2,0;6,0;18,0;;1,0;;1,0;10,0;;15,0;;9,0;4,0;2,0;;6,0;4,0;4,0;;;1,0;11,0;9,0;1,0;2,0;6,0;;;10,0;;;;;;1,0;2,0;;1,0;;;;;;5,0;;;3,0;;1,0;5,0;;4,0;1,0;;3,0;5,0;7,0;;7,0;;;;1,0;;;1,0;7,0;;3,0;;;3,0;4,0;6,0;4,0;5,0;1,0;;3,0;6,0;;2,0;;37,0;;;6,0;;;;;5,0;;1,0;2,0;3,0;1,0;5,0;7,0;2,0;;;2,0;;;;;1,0;3,0;;4,0;1,0;2,0;;11,0;;30,0;;11,0;;;4,0;;;10,0;;6,0;;;16,0;3,0;;;1,0;2,0;;20,0;39,0;;7,0;;1,0;1,0;;2,0;4,0;;4,0;4,0;;1,0;2,0;3,0;;;;1,0;;;8,0;;;;;2,0;;;;8,0;1,0;4,0;;3,0;43,0;;25,0;;;;;10,0;;8,0;;;1,0;15,0;5,0;;1,0;;;3,0;;;;;1,0;;2,0;;75,0;3,0;;;7,0;2,0;2,0;14,0;;;11,0;10,0;;;7,0;;1,0;1,0;1,0;3,0;;28,0;1,0;;1,0;;;;;;;2,0;7,0;1,0;;1,0;;;6,0;10,0;;6,0;;50,0;3,0;4,0;1,0;2,0;;2,0;;2,0;4,0;1,0;2,0;;1,0;4,0;;11,0;;7,0;6,0;4,0;;6,0;2,0;;;4,0;2,0;6,0;3,0;;;3,0;11,0;;;;;;;4,0;1,0;;;44,0;;;;;4,0;;2,0;;;4,0;4,0;13,0;5,0;4,0;4,0;1,0;2,0;;;;1,0;;;;4,0;3,0;;2,0;;2,0;;3,0;3,0;;;4,0;;;3,0;;;1,0;;;;;6,0;3,0;1,0;;1,0;;1,0;94,0;;;1,0;22,0;;2,0;2,0;2,0;;3,0;4,0;18,0;6,0;;7,0;;;1,0;;;11,0;1,0;;;16,0;2,0;;;3,0;6,0;1,0;2,0;14,0;;2,0;;3,0;1,0;;1,0;6,0;;;;;;;;1,0;;2,0;;;;4,0;;;1,0;;;;;3,0;7,0;33,0;1,0;1,0;6,0;;1,0;;;4,0;;;3,0;;9,0;;;;4,0;;;;1,0;2,0;;;;4,0;;1,0;2,0;4,0;;;;;;1,0;;;;;;8,0;1,0;;;;;;9,0;1,0;;;;;;;;;5,0;;3,0;3,0;;1,0;;;1,0;;;7,0;4,0;5,0;;1,0;14,0;;2,0;;;;2,0;2,0;;2,0;1,0;3,0;;;8,0;2,0;;;;;4,0;1,0;;;;;;12,0;;;;;4,0;;;1,0;;4,0;;;;;10,0;;2,0;;3,0;1,0;9,0;;;;1,0;;2,0;3,0;;2,0;;2,0;;;;3,0;4,0;2,0;1,0;1,0;1,0;1,0;3,0;4,0;;;;;;;;;;;;;;;;;;;;;
adjust;;1,0;4,0;;2,0;168,0;57,0;100,0;53,0;14,0;5,0;;30,0;18,0;39,0;224,0;23,0;;62,0;2,0;32,0;119,0;20,0;2,0;8,0;27,0;76,0;;1,0;5,0;12,0;69,0;226,0;13,0;253,0;77,0;17,0;29,0;8,0;;180,0;9,0;17,0;11,0;75,0;19,0;100,0;217,0;94,0;87,0;21,0;206,0;1,0;23,0;32,0;35,0;149,0;7,0;2,0;3,0;9,0;1,0;107,0;;6,0;114,0;463,0;35,0;71,0;15,0;47,0;4,0;80,0;6,0;1,0;49,0;7,0;;6,0;831,0;18,0;108,0;6,0;179,0;21,0;71,0;13,0;;;83,0;430,0;;;3,0;4,0;11,0;11,0;;310,0;12,0;5,0;3,0;121,0;82,0;5,0;48,0;181,0;20,0;80,0;240,0;16,0;47,0;1,0;;;114,0;98,0;308,0;45,0;53,0;2,0;;45,0;64,0;47,0;15,0;10,0;16,0;;69,0;;74,0;49,0;;2,0;14,0;18,0;44,0;4,0;9,0;6,0;;10,0;80,0;125,0;2,0;;7,0;238,0;63,0;18,0;3,0;16,0;32,0;70,0;18,0;156,0;;89,0;8,0;2,0;19,0;308,0;14,0;3,0;;126,0;163,0;;1,0;112,0;;3,0;5,0;170,0;25,0;49,0;11,0;;;16,0;25,0;;;3,0;47,0;;84,0;1,0;;2,0;8,0;1,0;58,0;5,0;15,0;3,0;4,0;11,0;8,0;3,0;3,0;30,0;116,0;1,0;2,0;1,0;5,0;141,0;11,0;;7,0;15,0;3,0;;1,0;11,0;;8,0;57,0;42,0;2,0;2,0;;;;2,0;3,0;173,0;4,0;80,0;;12,0;55,0;15,0;20,0;23,0;1,0;8,0;3,0;6,0;109,0;3,0;27,0;44,0;;2,0;7,0;29,0;21,0;24,0;1,0;25,0;1,0;11,0;9,0;47,0;;2,0;1,0;2,0;;6,0;82,0;;4,0;28,0;;26,0;;8,0;25,0;11,0;;;20,0;6,0;16,0;7,0;61,0;9,0;8,0;15,0;2,0;;154,0;;8,0;;2,0;32,0;21,0;5,0;;;5,0;29,0;1,0;1,0;;24,0;17,0;24,0;3,0;;2,0;;12,0;3,0;8,0;;8,0;;;3,0;;;36,0;1,0;20,0;2,0;;5,0;;27,0;;22,0;4,0;;;12,0;17,0;;;5,0;25,0;1,0;11,0;5,0;15,0;3,0;3,0;1,0;2,0;15,0;3,0;7,0;33,0;7,0;15,0;3,0;14,0;12,0;15,0;2,0;31,0;14,0;86,0;8,0;;3,0;8,0;;9,0;13,0;4,0;1,0;;2,0;;7,0;3,0;;1,0;1,0;1,0;9,0;4,0;21,0;17,0;29,0;;;25,0;;6,0;;5,0;;27,0;9,0;31,0;11,0;2,0;4,0;8,0;4,0;10,0;22,0;4,0;;3,0;;9,0;;;19,0;7,0;14,0;29,0;28,0;7,0;13,0;;15,0;2,0;;2,0;6,0;;1,0;8,0;25,0;10,0;8,0;1,0;13,0;22,0;;2,0;;63,0;100,0;4,0;30,0;2,0;3,0;21,0;49,0;;11,0;38,0;27,0;1,0;11,0;23,0;75,0;15,0;24,0;10,0;34,0;2,0;3,0;7,0;46,0;28,0;19,0;1,0;1,0;4,0;8,0;4,0;9,0;22,0;2,0;1,0;;3,0;54,0;1,0;1,0;2,0;5,0;14,0;61,0;1,0;6,0;1,0;35,0;2,0;;9,0;;7,0;31,0;12,0;9,0;;1,0;;;5,0;1,0;25,0;27,0;1,0;2,0;11,0;17,0;;86,0;;;47,0;9,0;4,0;15,0;;5,0;;11,0;23,0;18,0;;7,0;2,0;2,0;;2,0;1,0;;3,0;10,0;214,0;4,0;;9,0;5,0;8,0;2,0;;8,0;19,0;6,0;;22,0;15,0;;2,0;18,0;7,0;1,0;15,0;1,0;3,0;3,0;40,0;3,0;;18,0;5,0;4,0;6,0;6,0;;16,0;;;10,0;7,0;;2,0;;21,0;1,0;30,0;3,0;8,0;;3,0;15,0;;4,0;;1,0;5,0;3,0;1,0;2,0;;5,0;;;;77,0;54,0;;;5,0;2,0;;1,0;;2,0;7,0;;;;10,0;7,0;3,0;;6,0;1,0;3,0;2,0;6,0;;;;;;1,0;;;;;;;3,0;;6,0;;7,0;;2,0;19,0;5,0;;6,0;4,0;6,0;1,0;2,0;4,0;;;6,0;1,0;;12,0;;8,0;;;;1,0;3,0;24,0;;3,0;4,0;;2,0;36,0;6,0;11,0;;;1,0;6,0;8,0;;;3,0;1,0;8,0;5,0;;40,0;18,0;19,0;;;;;;2,0;1,0;1,0;1,0;;32,0;2,0;;7,0;16,0;4,0;;4,0;3,0;15,0;1,0;;;1,0;;;13,0;6,0;9,0;35,0;8,0;3,0;;1,0;5,0;32,0;4,0;9,0;1,0;;;6,0;;;;1,0;4,0;;;1,0;8,0;1,0;4,0;;;2,0;1,0;;8,0;2,0;1,0;2,0;18,0;;2,0;3,0;2,0;;1,0;;6,0;8,0;3,0;;7,0;;2,0;;;;;1,0;;8,0;6,0;;4,0;5,0;;;;4,0;1,0;18,0;;;;;;4,0;1,0;5,0;;6,0;20,0;;1,0;14,0;5,0;;;1,0;;12,0;6,0;;32,0;7,0;1,0;5,0;;5,0;5,0;;;4,0;15,0;13,0;17,0;29,0;6,0;6,0;2,0;;1,0;11,0;16,0;19,0;42,0;9,0;;12,0;;5,0;1,0;;1,0;1,0;3,0;6,0;16,0;9,0;139,0;;;9,0;6,0;;;41,0;;5,0;12,0;31,0;;;;5,0;;4,0;4,0;4,0;5,0;;10,0;2,0;;;1,0;;4,0;2,0;14,0;;2,0;;3,0;10,0;15,0;;;;;9,0;1,0;;1,0;;6,0;21,0;7,0;;;1,0;2,0;;;3,0;2,0;2,0;6,0;5,0;6,0;;2,0;7,0;;;4,0;;1,0;1,0;2,0;1,0;1,0;;29,0;8,0;1,0;;8,0;;3,0;;;3,0;;;;1,0;;;;;37,0;;3,0;;;;5,0;7,0;;6,0;;;1,0;;2,0;2,0;3,0;;2,0;;;12,0;;3,0;;12,0;;;9,0;;;;8,0;;;;6,0;3,0;8,0;;2,0;1,0;;;18,0;8,0;;;18,0;15,0;;7,0;1,0;1,0;;1,0;;;2,0;1,0;4,0;;1,0;9,0;2,0;4,0;1,0;4,0;2,0;;;;;;;;;;;;;;;
adjustable;;2,0;;;;39,0;13,0;8,0;3,0;5,0;3,0;;;;25,0;8,0;1,0;;1,0;;;23,0;5,0;4,0;1,0;;6,0;2,0;;;;;15,0;;27,0;1,0;;3,0;;;1,0;1,0;2,0;2,0;1,0;1,0;6,0;79,0;11,0;12,0;7,0;18,0;;3,0;5,0;;14,0;;;;4,0;;4,0;;2,0;13,0;14,0;3,0;26,0;4,0;;;2,0;;;;;1,0;5,0;46,0;1,0;2,0;;38,0;3,0;;1,0;;1,0;57,0;81,0;;;1,0;;;;;4,0;;;;8,0;1,0;1,0;;22,0;1,0;4,0;11,0;4,0;;;;;10,0;27,0;43,0;1,0;6,0;;;;4,0;2,0;;1,0;;2,0;14,0;2,0;1,0;25,0;1,0;;1,0;3,0;1,0;;;2,0;;;8,0;3,0;;;2,0;4,0;7,0;;;1,0;;3,0;;41,0;;16,0;;;;24,0;1,0;2,0;;1,0;47,0;;;3,0;;;;;3,0;33,0;8,0;;;;20,0;1,0;1,0;;5,0;;7,0;;;1,0;2,0;;47,0;;6,0;;;;1,0;;;;25,0;;;;;1,0;4,0;;;2,0;;;;;;9,0;;22,0;;3,0;;;4,0;;;21,0;;30,0;;39,0;67,0;2,0;2,0;1,0;32,0;1,0;4,0;;;;2,0;;;;;4,0;4,0;25,0;;8,0;;5,0;;17,0;;5,0;;;;;1,0;;;4,0;2,0;8,0;;22,0;5,0;7,0;;4,0;6,0;1,0;2,0;;11,0;;;5,0;1,0;;3,0;;;;;51,0;14,0;;;14,0;;4,0;;;;4,0;11,0;20,0;1,0;6,0;2,0;;1,0;;;;6,0;;;3,0;;1,0;22,0;;15,0;;2,0;2,0;5,0;7,0;;5,0;;;;9,0;;;;13,0;;2,0;2,0;1,0;10,0;3,0;;2,0;5,0;;7,0;26,0;6,0;11,0;1,0;;5,0;;;;11,0;13,0;6,0;6,0;;;;;;;3,0;;5,0;1,0;;6,0;;8,0;11,0;;4,0;8,0;6,0;3,0;1,0;1,0;;;20,0;1,0;;;2,0;4,0;110,0;;2,0;1,0;1,0;4,0;1,0;;7,0;1,0;;;;;3,0;;;;3,0;2,0;;4,0;;;;2,0;;;1,0;3,0;1,0;;;6,0;1,0;1,0;;;;;;;;2,0;1,0;11,0;;1,0;2,0;1,0;;;;;;;2,0;5,0;1,0;7,0;;1,0;;;;2,0;;1,0;;;;3,0;;;4,0;;5,0;;;;6,0;;2,0;1,0;;18,0;;;;;2,0;36,0;4,0;;5,0;;;1,0;;1,0;;;1,0;;;3,0;1,0;;3,0;;;22,0;;;4,0;;;1,0;;1,0;;3,0;;;;;;;;5,0;;;;7,0;17,0;;;1,0;4,0;;;;;5,0;1,0;;1,0;;;2,0;;;2,0;;3,0;;4,0;;;;;;66,0;;;;;;2,0;9,0;1,0;;3,0;;2,0;;1,0;;4,0;2,0;;;;;3,0;;;;2,0;4,0;;2,0;;;1,0;2,0;2,0;;;4,0;1,0;;;;;6,0;;;;9,0;2,0;;;;;;6,0;2,0;1,0;;1,0;2,0;;3,0;;;;12,0;;;;;;;;;;20,0;;1,0;2,0;5,0;1,0;;;;;;7,0;;1,0;;;;;;;;1,0;1,0;;;3,0;;1,0;;6,0;;;;;15,0;;;;;;;4,0;;36,0;19,0;1,0;;;16,0;;;;5,0;;1,0;1,0;32,0;;2,0;4,0;;;;1,0;2,0;;;;;;;;;1,0;18,0;;3,0;;2,0;4,0;;3,0;1,0;1,0;4,0;;;3,0;;1,0;;1,0;;;;1,0;;;;;;;;2,0;;;10,0;4,0;3,0;;;;;1,0;1,0;;1,0;1,0;;;2,0;;2,0;;;;;;;4,0;;1,0;;;;;;;;;;;;;;;;;;;1,0;;;11,0;;;;;;;;;;;;;;3,0;;;;;;2,0;;7,0;;;;;9,0;4,0;;;3,0;;;1,0;;;;1,0;;;2,0;;10,0;4,0;;;;;;;;;;;;;;;;;;;;;1,0;;5,0;;;;;;;1,0;;;;;;8,0;5,0;;;;;;1,0;;;1,0;;;;2,0;;1,0;;;;;3,0;;;2,0;;;;;;;;;;;1,0;;;;1,0;;;;;;;1,0;;4,0;;;;;;;;1,0;;1,0;;4,0;;;3,0;;;;6,0;;;;;;;;;;;7,0;;;1,0;8,0;;;;;;;;3,0;;;;;;4,0;;;;;;;;;;;;;1,0;;;;;;;1,0;;;1,0;;;;;;;1,0;2,0;;;;;;;;;;;;;
align;;2,0;;;;11,0;71,0;11,0;29,0;18,0;28,0;;5,0;;161,0;26,0;8,0;2,0;;;3,0;29,0;;7,0;;;5,0;12,0;3,0;;;;41,0;;15,0;14,0;8,0;11,0;1,0;;25,0;;23,0;11,0;7,0;4,0;25,0;53,0;6,0;10,0;24,0;3,0;;;5,0;24,0;34,0;5,0;3,0;1,0;6,0;4,0;7,0;;23,0;3,0;6,0;26,0;45,0;17,0;;;16,0;;3,0;5,0;2,0;2,0;2,0;394,0;;70,0;1,0;39,0;1,0;3,0;1,0;;2,0;3,0;284,0;;;12,0;2,0;2,0;16,0;;54,0;;6,0;;77,0;64,0;9,0;2,0;133,0;;28,0;9,0;13,0;12,0;;1,0;;103,0;110,0;44,0;;5,0;;;2,0;1,0;11,0;2,0;;;;5,0;;65,0;21,0;;1,0;;18,0;;5,0;;2,0;;;157,0;5,0;;;23,0;25,0;3,0;;2,0;1,0;;2,0;;64,0;;3,0;;3,0;2,0;61,0;;;2,0;27,0;31,0;;;4,0;;9,0;7,0;7,0;1,0;57,0;20,0;;;15,0;29,0;;8,0;;23,0;;25,0;2,0;;;;;12,0;;78,0;2,0;;1,0;16,0;16,0;;3,0;77,0;15,0;;;;;8,0;;;;3,0;6,0;;5,0;;1,0;109,0;50,0;4,0;6,0;6,0;;1,0;9,0;2,0;43,0;;30,0;5,0;18,0;47,0;8,0;4,0;;113,0;;11,0;4,0;18,0;2,0;7,0;;2,0;;8,0;34,0;24,0;13,0;3,0;5,0;1,0;;;26,0;;;;;;18,0;2,0;;;7,0;1,0;13,0;;;;6,0;9,0;1,0;;;34,0;26,0;82,0;;;4,0;;;4,0;;1,0;6,0;8,0;5,0;12,0;;3,0;6,0;;;1,0;7,0;;3,0;16,0;8,0;2,0;1,0;9,0;;16,0;16,0;10,0;;2,0;5,0;;3,0;;2,0;26,0;1,0;20,0;;;4,0;7,0;2,0;;1,0;;;;5,0;2,0;5,0;1,0;;;;19,0;27,0;3,0;1,0;;15,0;;;;1,0;3,0;21,0;6,0;13,0;11,0;;3,0;;11,0;2,0;21,0;4,0;;1,0;2,0;;;12,0;;;11,0;6,0;;;;;;;1,0;18,0;8,0;10,0;10,0;1,0;;5,0;14,0;;6,0;5,0;3,0;;38,0;3,0;11,0;4,0;2,0;;1,0;;4,0;31,0;1,0;;3,0;;17,0;;;;;;4,0;;;1,0;;;;;;;;;3,0;4,0;5,0;;;;4,0;;;;2,0;11,0;7,0;1,0;;1,0;5,0;;;11,0;3,0;7,0;;;;3,0;;15,0;;;;;;;1,0;;;1,0;;7,0;6,0;;;;;;5,0;3,0;5,0;;;3,0;;15,0;;;;10,0;1,0;9,0;;;27,0;5,0;;;;;;;;;;8,0;7,0;;;;2,0;5,0;1,0;;4,0;3,0;;4,0;;1,0;;;6,0;13,0;;2,0;;7,0;;;;;;9,0;2,0;;;1,0;2,0;1,0;;;;1,0;7,0;;8,0;1,0;3,0;;;1,0;18,0;;;;2,0;;;;;;;;34,0;;3,0;1,0;5,0;13,0;6,0;3,0;;1,0;1,0;16,0;;;6,0;;;3,0;;;1,0;;6,0;;7,0;3,0;;;;;4,0;10,0;;;;8,0;;;;;2,0;;;;;5,0;;10,0;;11,0;;;8,0;4,0;9,0;;;;;5,0;;2,0;;;;;1,0;1,0;10,0;3,0;1,0;;;22,0;13,0;1,0;;;2,0;;3,0;;;1,0;8,0;;1,0;2,0;14,0;2,0;1,0;;;;7,0;5,0;1,0;;;;2,0;4,0;7,0;1,0;2,0;;1,0;1,0;;;1,0;2,0;;;;;;;2,0;;;;1,0;;5,0;11,0;4,0;;2,0;5,0;;;9,0;;3,0;1,0;2,0;;7,0;;;;4,0;13,0;;8,0;;4,0;;2,0;2,0;3,0;10,0;;2,0;;5,0;;;;3,0;;5,0;;;;;;4,0;;;3,0;10,0;2,0;;;14,0;;;2,0;2,0;3,0;;4,0;7,0;;1,0;4,0;;1,0;6,0;8,0;14,0;2,0;;1,0;;2,0;;5,0;1,0;;11,0;;;;1,0;;;;;2,0;;;6,0;;;;;;;;3,0;;2,0;4,0;1,0;2,0;1,0;2,0;;;1,0;10,0;;;;;5,0;1,0;;;;;;21,0;3,0;3,0;;;;;;1,0;;2,0;3,0;2,0;;;1,0;;;;;;;;;;;;;3,0;;;;3,0;2,0;2,0;1,0;;;;;;;;;1,0;;;;1,0;2,0;;;;;;;;;;;6,0;6,0;;;;;;5,0;;1,0;;10,0;;;;4,0;2,0;;;;;5,0;;2,0;;;2,0;;;5,0;;;;4,0;;;2,0;;;;;;;;3,0;;17,0;1,0;1,0;8,0;;1,0;2,0;;3,0;;9,0;;4,0;2,0;;2,0;;;;1,0;;;;;;;4,0;;6,0;;2,0;;;;;1,0;;8,0;2,0;;3,0;;;;;2,0;;3,0;2,0;3,0;1,0;;2,0;;;8,0;;;1,0;;;3,0;;1,0;3,0;3,0;;;;1,0;;;;1,0;1,0;;;4,0;2,0;;1,0;;4,0;;;4,0;;1,0;;;;;;;;
allow;;17,0;;;1,0;9,0;13,0;26,0;26,0;15,0;9,0;;3,0;;27,0;18,0;13,0;6,0;9,0;1,0;10,0;19,0;;7,0;4,0;;14,0;6,0;;;20,0;1,0;112,0;;77,0;12,0;11,0;1,0;4,0;1,0;39,0;;12,0;;4,0;6,0;12,0;116,0;13,0;61,0;14,0;9,0;1,0;3,0;15,0;5,0;23,0;1,0;1,0;;9,0;12,0;1,0;1,0;30,0;16,0;22,0;20,0;13,0;11,0;12,0;2,0;7,0;4,0;1,0;5,0;1,0;1,0;13,0;158,0;3,0;20,0;1,0;40,0;2,0;5,0;2,0;;3,0;9,0;142,0;1,0;;1,0;9,0;4,0;12,0;;31,0;13,0;;2,0;30,0;21,0;2,0;13,0;56,0;2,0;27,0;7,0;69,0;20,0;11,0;;1,0;27,0;71,0;52,0;13,0;14,0;1,0;1,0;5,0;11,0;13,0;5,0;;;3,0;22,0;;14,0;18,0;15,0;1,0;;4,0;3,0;;;5,0;1,0;;21,0;5,0;;;21,0;59,0;7,0;6,0;;8,0;16,0;23,0;1,0;39,0;1,0;13,0;4,0;;4,0;85,0;1,0;;;43,0;38,0;3,0;6,0;12,0;;7,0;16,0;16,0;3,0;17,0;19,0;;4,0;7,0;50,0;;1,0;19,0;9,0;;10,0;;;5,0;;;23,0;;9,0;3,0;1,0;;4,0;;2,0;3,0;17,0;8,0;;4,0;2,0;10,0;7,0;1,0;;1,0;4,0;6,0;1,0;4,0;;3,0;28,0;38,0;39,0;3,0;4,0;;5,0;4,0;11,0;189,0;;51,0;;7,0;72,0;14,0;41,0;32,0;39,0;2,0;7,0;3,0;3,0;4,0;22,0;4,0;;2,0;2,0;14,0;11,0;20,0;7,0;6,0;1,0;4,0;;16,0;6,0;2,0;;;1,0;5,0;40,0;1,0;4,0;13,0;;5,0;;21,0;11,0;11,0;;;8,0;3,0;11,0;6,0;30,0;12,0;;5,0;3,0;;28,0;;2,0;;2,0;9,0;19,0;;;3,0;1,0;;;8,0;10,0;11,0;;28,0;9,0;4,0;7,0;1,0;12,0;1,0;3,0;;5,0;2,0;3,0;9,0;4,0;1,0;13,0;;16,0;3,0;1,0;9,0;;9,0;4,0;10,0;2,0;;17,0;4,0;1,0;;1,0;1,0;1,0;2,0;6,0;5,0;10,0;;1,0;14,0;2,0;;6,0;10,0;8,0;7,0;1,0;;1,0;3,0;6,0;;33,0;8,0;16,0;4,0;2,0;;1,0;;4,0;4,0;;1,0;6,0;2,0;;2,0;8,0;;;2,0;7,0;4,0;4,0;23,0;11,0;5,0;2,0;9,0;13,0;3,0;5,0;2,0;4,0;;25,0;;14,0;2,0;3,0;7,0;16,0;16,0;4,0;;3,0;;;23,0;7,0;;;;13,0;1,0;;12,0;5,0;3,0;;3,0;1,0;2,0;4,0;2,0;;;2,0;1,0;;2,0;1,0;;17,0;;;;17,0;14,0;3,0;14,0;1,0;;6,0;12,0;;12,0;6,0;11,0;;4,0;18,0;14,0;11,0;26,0;8,0;4,0;;;2,0;;22,0;5,0;;2,0;1,0;2,0;;1,0;;3,0;;;9,0;;8,0;;5,0;4,0;2,0;182,0;2,0;;1,0;3,0;1,0;17,0;16,0;1,0;6,0;9,0;;;;;;2,0;2,0;1,0;7,0;;;3,0;3,0;26,0;;20,0;;11,0;10,0;8,0;;2,0;;11,0;;;26,0;;8,0;2,0;;3,0;;1,0;1,0;5,0;;16,0;26,0;;1,0;2,0;;5,0;;1,0;5,0;3,0;6,0;1,0;7,0;1,0;3,0;;4,0;;;8,0;;2,0;;;2,0;6,0;13,0;;4,0;2,0;1,0;;6,0;1,0;8,0;3,0;3,0;;1,0;;;1,0;1,0;12,0;12,0;1,0;2,0;2,0;;7,0;8,0;1,0;;2,0;5,0;2,0;2,0;1,0;3,0;1,0;;21,0;1,0;;;14,0;;3,0;2,0;;2,0;6,0;;;;3,0;4,0;6,0;2,0;1,0;;;11,0;3,0;4,0;;;1,0;5,0;2,0;2,0;;;1,0;;;;10,0;2,0;;1,0;1,0;;11,0;;3,0;;;5,0;;4,0;3,0;3,0;2,0;6,0;;1,0;;2,0;3,0;1,0;;4,0;2,0;9,0;5,0;1,0;;7,0;2,0;2,0;11,0;8,0;;;9,0;1,0;2,0;2,0;;;5,0;1,0;;6,0;;3,0;3,0;3,0;;1,0;;;;5,0;2,0;1,0;13,0;2,0;4,0;5,0;;9,0;2,0;1,0;4,0;;1,0;5,0;;;4,0;;3,0;;2,0;1,0;;;1,0;1,0;3,0;6,0;1,0;3,0;7,0;4,0;;;;4,0;;3,0;1,0;;5,0;;1,0;2,0;2,0;2,0;1,0;;1,0;2,0;;5,0;;;2,0;;1,0;1,0;2,0;1,0;;10,0;;;;21,0;1,0;;;;;8,0;18,0;2,0;;1,0;;1,0;2,0;1,0;8,0;;;;;;;4,0;;1,0;4,0;;;2,0;1,0;;;22,0;1,0;1,0;2,0;9,0;3,0;;;3,0;18,0;1,0;6,0;;;;;1,0;;3,0;;;;;17,0;4,0;2,0;2,0;;3,0;3,0;;8,0;;;;;;;;;;;;4,0;;4,0;;4,0;2,0;1,0;;1,0;;;;;;;2,0;;1,0;3,0;;;2,0;1,0;4,0;3,0;2,0;;;;1,0;;;2,0;;;;;;1,0;;;1,0;4,0;;;;12,0;;1,0;1,0;;1,0;1,0;7,0;;8,0;;1,0;;1,0;;6,0;;11,0;;3,0;2,0;;;;;;3,0;5,0;;;;;;;2,0;1,0;;;;3,0;;1,0;;;;4,0;;1,0;1,0;;;12,0;1,0;;;;2,0;;;;5,0;1,0;;;1,0;;;;1,0;2,0;1,0;;;5,0;2,0;1,0;;3,0;2,0;;;;;;;1,0;;1,0;;;;;;1,0;;;5,0;;6,0;5,0;;;;;;;1,0;;;;;;;;2,0;;;;;;;;;;;;;;;;;;;;;
angular;;7,0;;;;27,0;;10,0;;5,0;1,0;;;;20,0;22,0;5,0;;;;2,0;6,0;;;;;;;;2,0;1,0;;13,0;;5,0;6,0;2,0;32,0;;;9,0;;3,0;2,0;52,0;2,0;37,0;18,0;3,0;5,0;;8,0;1,0;3,0;1,0;9,0;8,0;1,0;4,0;;1,0;4,0;9,0;;6,0;5,0;4,0;4,0;6,0;4,0;;;7,0;;;;;3,0;2,0;45,0;;12,0;;17,0;1,0;1,0;;;;2,0;12,0;;1,0;;5,0;;;;24,0;1,0;;;8,0;12,0;;;14,0;;38,0;3,0;5,0;9,0;;;;3,0;8,0;64,0;;57,0;;;2,0;12,0;5,0;;;;;58,0;;2,0;8,0;;9,0;5,0;;5,0;4,0;;10,0;;;43,0;1,0;;;;33,0;;3,0;;;;;;32,0;;;;;2,0;14,0;;2,0;;;3,0;;;;;;1,0;1,0;5,0;2,0;;;;;6,0;;;;13,0;;;;;;;;2,0;;;;;;;;4,0;2,0;31,0;15,0;;;;;8,0;;;;;;;;;;4,0;1,0;;1,0;;;;;1,0;21,0;;1,0;;10,0;5,0;;9,0;4,0;;;1,0;;2,0;;;;;;;4,0;14,0;8,0;;;;;;16,0;1,0;;;;;2,0;1,0;;24,0;5,0;;2,0;;8,0;6,0;12,0;;;;;1,0;1,0;2,0;;;;;;5,0;;;;;8,0;4,0;3,0;;;;1,0;5,0;;;2,0;13,0;3,0;;;;1,0;;;;;;;2,0;;5,0;;;;2,0;;;2,0;;7,0;;;2,0;;;;;;;;;;;;1,0;;1,0;;16,0;3,0;;1,0;7,0;2,0;3,0;2,0;;;;;9,0;8,0;2,0;;13,0;1,0;;;;2,0;;;;;8,0;6,0;;;;4,0;;;;28,0;26,0;;;;;;;;;;7,0;;7,0;;;1,0;;6,0;;3,0;1,0;53,0;2,0;;2,0;;;5,0;;;16,0;19,0;;7,0;6,0;3,0;2,0;;;;;;3,0;13,0;3,0;;;;3,0;;9,0;18,0;3,0;1,0;3,0;;3,0;1,0;49,0;;;7,0;33,0;5,0;1,0;;;;1,0;22,0;;;8,0;;;14,0;19,0;1,0;3,0;6,0;;7,0;;;7,0;;2,0;;7,0;10,0;1,0;;2,0;;;;;13,0;253,0;;;7,0;;;5,0;;;;8,0;;7,0;;4,0;;;1,0;;;;;;3,0;;;;;;;;;;1,0;;2,0;;;;;;;;;;5,0;9,0;;;;;;;;;2,0;14,0;;;10,0;;;8,0;;;;2,0;;19,0;4,0;;;;;;2,0;;;1,0;;;7,0;;;;;;1,0;4,0;;1,0;;1,0;1,0;;;;;1,0;;;;;;;;;2,0;3,0;;;;;;;;;;;;;;;;;;;1,0;;;;;;;;;;;;1,0;;;;;;;;;;;;;;;;;;;;;1,0;;;;;;1,0;;;8,0;;;;2,0;;;;3,0;;;;;;;;;;;;;117,0;;;;2,0;1,0;;;;;;;4,0;;;1,0;;;1,0;;;;;;;;;;1,0;;;;;;;;1,0;2,0;7,0;;;;;;;;;;;;;;;;;;;1,0;;;;;1,0;;;3,0;;3,0;1,0;;1,0;;;;;;1,0;;;;1,0;;;;;;;;;;;;;;;;;;;4,0;;;;;;;1,0;;;3,0;;10,0;;;;;;;;2,0;;;13,0;;;;;;;;;;;1,0;;;;;;;;;;1,0;;;;;2,0;4,0;;4,0;;;;;;;;;;2,0;;;;;;;;;1,0;;;;;1,0;;;;;;;;;;;4,0;;;;;;;;;;;;;;;;;;;;;;;;;;2,0;;;;;;;;6,0;;2,0;;;;;;;;;;;;;1,0;;7,0;;;11,0;;;;;;;3,0;;;;;;;;;;1,0;;;;;;;;;;;6,0;;6,0;;;;;;;;;;;1,0;2,0;11,0;;;;;;2,0;;;;;;;;;;;;;;;;;;;;;;1,0;37,0;;33,0;;;;;;;;;;;;;;;;;;
apply;;1,0;;;4,0;14,0;5,0;33,0;20,0;4,0;12,0;;4,0;;16,0;36,0;;14,0;;;22,0;20,0;4,0;3,0;1,0;1,0;37,0;6,0;;1,0;28,0;9,0;99,0;6,0;58,0;21,0;43,0;46,0;2,0;;58,0;2,0;18,0;42,0;39,0;22,0;67,0;47,0;24,0;26,0;7,0;12,0;17,0;6,0;35,0;39,0;25,0;10,0;24,0;;6,0;17,0;35,0;3,0;99,0;7,0;19,0;8,0;71,0;2,0;28,0;1,0;38,0;3,0;5,0;14,0;9,0;2,0;7,0;367,0;8,0;29,0;3,0;62,0;1,0;14,0;;;3,0;3,0;74,0;;4,0;12,0;8,0;2,0;8,0;1,0;149,0;3,0;40,0;6,0;62,0;14,0;;5,0;38,0;10,0;16,0;63,0;3,0;20,0;;;;37,0;75,0;24,0;57,0;30,0;;;20,0;39,0;28,0;18,0;1,0;;;9,0;1,0;18,0;8,0;10,0;;1,0;23,0;21,0;4,0;;11,0;3,0;;40,0;15,0;;;15,0;120,0;5,0;11,0;4,0;4,0;14,0;3,0;;66,0;;5,0;40,0;2,0;2,0;56,0;3,0;14,0;1,0;14,0;5,0;3,0;;12,0;3,0;54,0;;12,0;;18,0;16,0;3,0;;4,0;20,0;1,0;;9,0;20,0;2,0;22,0;;;2,0;14,0;;7,0;5,0;9,0;1,0;;;6,0;;1,0;9,0;60,0;3,0;24,0;59,0;1,0;12,0;30,0;10,0;1,0;103,0;20,0;;;3,0;1,0;;9,0;17,0;;4,0;3,0;;1,0;26,0;2,0;45,0;;75,0;4,0;21,0;4,0;23,0;12,0;8,0;5,0;6,0;5,0;;;;12,0;11,0;;;3,0;77,0;9,0;18,0;9,0;;5,0;55,0;14,0;17,0;5,0;3,0;;5,0;10,0;1,0;33,0;4,0;10,0;14,0;2,0;;;6,0;12,0;10,0;;2,0;23,0;;3,0;21,0;20,0;8,0;6,0;13,0;1,0;6,0;23,0;2,0;;2,0;7,0;11,0;21,0;20,0;;3,0;;33,0;;21,0;;28,0;3,0;;;;;10,0;8,0;5,0;1,0;;3,0;1,0;;5,0;16,0;;;;2,0;2,0;;2,0;;20,0;;4,0;;;1,0;4,0;;;1,0;;4,0;;5,0;5,0;9,0;2,0;;3,0;3,0;6,0;;7,0;12,0;8,0;12,0;;;1,0;9,0;22,0;2,0;2,0;26,0;1,0;2,0;;1,0;5,0;;3,0;;4,0;7,0;8,0;;4,0;1,0;;1,0;2,0;;;4,0;12,0;26,0;;;11,0;;1,0;;;;;4,0;8,0;6,0;4,0;2,0;;2,0;6,0;;20,0;1,0;;3,0;;2,0;;;;5,0;;25,0;13,0;13,0;7,0;5,0;11,0;2,0;5,0;;;1,0;2,0;;16,0;;;6,0;2,0;13,0;;;5,0;23,0;23,0;21,0;5,0;;2,0;18,0;15,0;5,0;4,0;22,0;15,0;;1,0;3,0;25,0;18,0;7,0;16,0;8,0;6,0;4,0;;2,0;7,0;;10,0;;2,0;3,0;2,0;1,0;1,0;;;3,0;6,0;15,0;3,0;11,0;2,0;2,0;9,0;11,0;;40,0;;135,0;1,0;25,0;1,0;1,0;6,0;19,0;;3,0;18,0;1,0;3,0;;;;10,0;8,0;6,0;2,0;1,0;;5,0;13,0;1,0;;4,0;5,0;;3,0;;9,0;;17,0;8,0;;;1,0;;;;;;;;;56,0;;;1,0;;1,0;1,0;;3,0;;6,0;5,0;;4,0;;;1,0;;10,0;1,0;2,0;;7,0;4,0;;;13,0;1,0;;1,0;8,0;4,0;;;;;;1,0;;3,0;3,0;;7,0;1,0;5,0;2,0;26,0;2,0;2,0;;;;5,0;;;14,0;;5,0;6,0;1,0;;12,0;13,0;3,0;;4,0;;1,0;;10,0;;;;;1,0;;4,0;;2,0;2,0;;;;;;;;2,0;1,0;1,0;;;;;;;1,0;7,0;2,0;2,0;4,0;;;50,0;1,0;;;17,0;;18,0;9,0;;;;;2,0;;3,0;5,0;2,0;;;;5,0;3,0;4,0;2,0;2,0;1,0;;;3,0;1,0;12,0;2,0;;;2,0;10,0;;;1,0;1,0;;2,0;;2,0;7,0;;;1,0;1,0;;1,0;3,0;;4,0;;1,0;2,0;;;16,0;;10,0;;;2,0;7,0;;;;1,0;;25,0;6,0;;;2,0;;2,0;;2,0;;5,0;;;;;1,0;8,0;;;;;2,0;;1,0;1,0;;;4,0;36,0;22,0;2,0;;9,0;;;;5,0;;;;;1,0;;;4,0;1,0;;;4,0;;1,0;4,0;;;;;5,0;;3,0;;;3,0;2,0;;1,0;;5,0;;4,0;1,0;4,0;;;;69,0;9,0;12,0;4,0;1,0;;2,0;29,0;13,0;3,0;;;1,0;;5,0;3,0;8,0;1,0;15,0;1,0;44,0;13,0;7,0;;;;2,0;;;4,0;9,0;;4,0;8,0;;;16,0;11,0;1,0;8,0;16,0;;6,0;;5,0;;4,0;;;2,0;1,0;6,0;79,0;6,0;8,0;2,0;1,0;;4,0;;7,0;;1,0;1,0;1,0;2,0;1,0;;;;30,0;4,0;1,0;2,0;5,0;2,0;;;6,0;5,0;5,0;;3,0;1,0;;;;2,0;;;4,0;;;;2,0;;;;1,0;;2,0;;27,0;;;;;;4,0;2,0;1,0;;;9,0;;2,0;17,0;;;;2,0;3,0;;;1,0;;;3,0;1,0;;1,0;7,0;;30,0;;;;1,0;3,0;1,0;;;2,0;1,0;3,0;29,0;;2,0;;;6,0;;1,0;4,0;1,0;;8,0;;;;;;1,0;11,0;;3,0;;;6,0;;;;;1,0;3,0;;;;;2,0;18,0;;;;;5,0;;;;;;4,0;3,0;;;;;2,0;4,0;;2,0;3,0;;7,0;;;4,0;;;;18,0;;1,0;3,0;;;;;;;4,0;;;;;;;;
assembly;;44,0;1,0;5,0;1,0;40,0;53,0;51,0;10,0;49,0;61,0;3,0;33,0;;201,0;134,0;6,0;;;2,0;21,0;52,0;;20,0;11,0;2,0;2,0;4,0;;2,0;10,0;;164,0;;62,0;20,0;;2,0;2,0;1,0;24,0;;64,0;27,0;20,0;1,0;12,0;182,0;41,0;44,0;98,0;42,0;2,0;3,0;106,0;20,0;248,0;9,0;;;83,0;22,0;49,0;;5,0;47,0;38,0;92,0;87,0;150,0;4,0;;14,0;;;45,0;6,0;3,0;56,0;272,0;31,0;105,0;1,0;563,0;3,0;4,0;7,0;;4,0;33,0;1566,0;;2,0;19,0;6,0;1,0;19,0;;130,0;5,0;;2,0;229,0;12,0;11,0;11,0;417,0;1,0;8,0;1,0;15,0;9,0;8,0;;;174,0;309,0;226,0;28,0;6,0;7,0;13,0;3,0;15,0;45,0;10,0;18,0;;4,0;22,0;;3,0;105,0;7,0;2,0;6,0;15,0;6,0;;;6,0;35,0;;240,0;6,0;17,0;5,0;114,0;28,0;5,0;1,0;13,0;1,0;10,0;10,0;4,0;180,0;;35,0;7,0;1,0;6,0;102,0;;1,0;5,0;7,0;82,0;1,0;4,0;9,0;8,0;28,0;15,0;;18,0;;230,0;;;58,0;92,0;2,0;19,0;;105,0;3,0;59,0;;6,0;1,0;1,0;2,0;123,0;;33,0;;1,0;43,0;161,0;44,0;3,0;;96,0;;13,0;18,0;9,0;;61,0;;8,0;22,0;;4,0;;16,0;16,0;2,0;70,0;378,0;5,0;29,0;;2,0;287,0;11,0;9,0;131,0;8,0;233,0;14,0;292,0;658,0;73,0;81,0;56,0;80,0;21,0;39,0;6,0;36,0;25,0;18,0;;;;;24,0;26,0;101,0;;14,0;2,0;3,0;;156,0;7,0;3,0;1,0;23,0;;32,0;21,0;3,0;1,0;30,0;13,0;6,0;1,0;16,0;13,0;32,0;10,0;;51,0;;103,0;44,0;179,0;11,0;1,0;1,0;4,0;;2,0;4,0;3,0;2,0;5,0;142,0;9,0;9,0;23,0;38,0;;7,0;40,0;16,0;1,0;84,0;17,0;228,0;10,0;42,0;19,0;16,0;12,0;30,0;;2,0;19,0;20,0;9,0;20,0;5,0;;51,0;1,0;118,0;1,0;;16,0;19,0;95,0;7,0;52,0;8,0;;5,0;10,0;31,0;24,0;6,0;4,0;10,0;8,0;77,0;28,0;70,0;13,0;8,0;21,0;25,0;10,0;19,0;66,0;90,0;13,0;10,0;5,0;17,0;;;2,0;61,0;104,0;19,0;32,0;6,0;4,0;13,0;25,0;17,0;18,0;3,0;2,0;24,0;29,0;;;17,0;18,0;;4,0;9,0;31,0;51,0;73,0;19,0;14,0;1,0;;27,0;6,0;;9,0;10,0;2,0;258,0;11,0;19,0;9,0;19,0;47,0;9,0;150,0;5,0;49,0;;;;;36,0;8,0;;;2,0;;6,0;3,0;7,0;;;6,0;;11,0;2,0;;;;3,0;38,0;2,0;;;;12,0;1,0;;;20,0;28,0;1,0;1,0;;2,0;6,0;8,0;;21,0;6,0;71,0;;;21,0;8,0;5,0;17,0;1,0;;3,0;;2,0;;4,0;12,0;;15,0;;8,0;1,0;1,0;2,0;1,0;18,0;;2,0;;13,0;;2,0;2,0;;12,0;1,0;5,0;;5,0;18,0;49,0;57,0;;23,0;1,0;;1,0;;5,0;5,0;;1,0;;;;5,0;6,0;2,0;15,0;1,0;66,0;5,0;;8,0;;1,0;13,0;;;1,0;1,0;1,0;1,0;;;;16,0;;15,0;;3,0;5,0;31,0;30,0;2,0;;3,0;31,0;;5,0;;;6,0;20,0;;5,0;8,0;5,0;3,0;;;45,0;3,0;;;5,0;;;21,0;;;16,0;1,0;4,0;;32,0;2,0;25,0;39,0;50,0;;14,0;8,0;8,0;7,0;4,0;7,0;39,0;;;4,0;;14,0;7,0;12,0;10,0;6,0;27,0;;;;3,0;;;21,0;1,0;;;62,0;;;;;13,0;16,0;18,0;;;18,0;;24,0;;30,0;;;6,0;2,0;3,0;;;5,0;1,0;37,0;1,0;6,0;;5,0;;1,0;;;2,0;3,0;;;;6,0;;22,0;8,0;;10,0;;13,0;;11,0;4,0;3,0;1,0;1,0;;3,0;3,0;;;1,0;1,0;55,0;;;;6,0;;21,0;33,0;178,0;2,0;;6,0;37,0;7,0;;4,0;4,0;;9,0;1,0;39,0;5,0;;19,0;24,0;;;2,0;6,0;10,0;4,0;26,0;1,0;8,0;6,0;34,0;15,0;17,0;7,0;11,0;5,0;;7,0;6,0;6,0;9,0;3,0;;7,0;5,0;;49,0;2,0;236,0;5,0;20,0;;18,0;16,0;1,0;6,0;2,0;12,0;6,0;;8,0;36,0;;;;3,0;2,0;8,0;;3,0;2,0;15,0;22,0;31,0;2,0;;7,0;15,0;;;;6,0;6,0;1,0;18,0;4,0;1,0;23,0;;2,0;5,0;1,0;2,0;10,0;3,0;6,0;35,0;;11,0;2,0;2,0;14,0;3,0;40,0;;13,0;1,0;;;;;;;1,0;;;;;;;;;;1,0;1,0;;1,0;;;21,0;;;2,0;;23,0;2,0;;7,0;;1,0;;3,0;;;;;20,0;10,0;;11,0;1,0;;;1,0;1,0;17,0;;9,0;3,0;;;7,0;2,0;1,0;;;5,0;;3,0;;6,0;;;;4,0;;1,0;;14,0;2,0;2,0;;1,0;;5,0;8,0;;;2,0;1,0;54,0;15,0;1,0;;7,0;;;2,0;;;;;6,0;;;;1,0;3,0;;;;;;;2,0;1,0;;;;;;3,0;1,0;19,0;;3,0;;10,0;50,0;4,0;;2,0;5,0;;;;;;;8,0;8,0;3,0;1,0;1,0;;;10,0;;;;5,0;5,0;;3,0;1,0;18,0;;8,0;;;6,0;6,0;12,0;5,0;1,0;14,0;1,0;1,0;;3,0;18,0;;14,0;2,0;30,0;;;;;;;;;16,0;;3,0;1,0;;;1,0;2,0;;;13,0;;;;3,0;2,0;;;5,0;5,0;82,0;2,0;1,0;;;;;5,0;;;;;;6,0;;;;;22,0;;;;;3,0;;;1,0;;;76,0;;;;;;;;1,0;;;;;;;
attach;;53,0;;;;11,0;13,0;78,0;30,0;3,0;8,0;;3,0;;39,0;164,0;3,0;;;;1,0;19,0;;6,0;2,0;;;3,0;;;2,0;4,0;97,0;;39,0;6,0;1,0;;2,0;;26,0;;15,0;2,0;8,0;;9,0;193,0;57,0;27,0;18,0;6,0;;3,0;83,0;19,0;228,0;3,0;2,0;;30,0;22,0;10,0;4,0;14,0;1,0;;23,0;102,0;79,0;1,0;;7,0;;;7,0;;2,0;3,0;138,0;3,0;57,0;;154,0;5,0;1,0;110,0;1,0;26,0;20,0;506,0;;;13,0;1,0;12,0;3,0;;61,0;17,0;;;88,0;12,0;;5,0;62,0;3,0;9,0;;10,0;;9,0;5,0;;110,0;279,0;124,0;15,0;6,0;2,0;1,0;;4,0;4,0;;;3,0;;3,0;;;8,0;13,0;;;7,0;;;;;2,0;;86,0;2,0;8,0;12,0;164,0;3,0;9,0;;5,0;13,0;4,0;3,0;4,0;128,0;9,0;65,0;;;4,0;149,0;1,0;;1,0;59,0;12,0;2,0;;1,0;;35,0;11,0;;;228,0;78,0;;;54,0;257,0;2,0;15,0;;48,0;;47,0;;9,0;;;1,0;44,0;;9,0;;1,0;;104,0;6,0;7,0;1,0;47,0;;10,0;3,0;;;27,0;9,0;7,0;4,0;1,0;24,0;;3,0;6,0;5,0;24,0;253,0;;45,0;;2,0;111,0;8,0;13,0;43,0;1,0;277,0;15,0;167,0;307,0;77,0;10,0;9,0;30,0;27,0;106,0;;28,0;2,0;8,0;1,0;;;;3,0;16,0;259,0;;25,0;;1,0;;42,0;1,0;3,0;1,0;5,0;1,0;16,0;1,0;1,0;1,0;8,0;18,0;16,0;;12,0;10,0;14,0;14,0;;56,0;;101,0;93,0;237,0;18,0;;30,0;3,0;;7,0;;;3,0;25,0;112,0;26,0;;4,0;35,0;;12,0;36,0;11,0;2,0;42,0;28,0;;;5,0;10,0;8,0;21,0;67,0;;1,0;19,0;10,0;;9,0;;1,0;78,0;1,0;16,0;12,0;26,0;;24,0;15,0;4,0;13,0;15,0;;;8,0;16,0;14,0;;2,0;4,0;5,0;17,0;20,0;92,0;6,0;;3,0;8,0;1,0;8,0;10,0;33,0;5,0;7,0;9,0;8,0;;20,0;5,0;47,0;43,0;11,0;20,0;11,0;;7,0;16,0;;2,0;6,0;4,0;47,0;26,0;16,0;5,0;10,0;31,0;;;10,0;34,0;6,0;17,0;3,0;32,0;16,0;18,0;44,0;10,0;2,0;23,0;15,0;;162,0;5,0;8,0;2,0;5,0;21,0;3,0;19,0;8,0;9,0;;;3,0;1,0;36,0;;2,0;;3,0;5,0;3,0;1,0;2,0;;;4,0;3,0;;3,0;;;;1,0;1,0;;;;;7,0;;;1,0;6,0;21,0;5,0;15,0;;;2,0;;;12,0;1,0;16,0;;1,0;2,0;8,0;;1,0;3,0;9,0;;1,0;;;4,0;13,0;;13,0;1,0;;;;;18,0;13,0;;7,0;;5,0;;1,0;;;5,0;1,0;;;1,0;;24,0;8,0;1,0;35,0;;;;;4,0;;;;;;;4,0;7,0;;6,0;;18,0;8,0;10,0;11,0;;;;;;;1,0;3,0;;6,0;2,0;;12,0;;1,0;;;1,0;62,0;8,0;;;;16,0;;5,0;2,0;;3,0;7,0;;25,0;;;;;;69,0;3,0;;;;;;;;2,0;51,0;;2,0;;2,0;1,0;2,0;75,0;6,0;;;;2,0;3,0;;6,0;3,0;;;;1,0;3,0;1,0;;3,0;5,0;27,0;;1,0;;16,0;;4,0;5,0;;;;63,0;;1,0;1,0;;15,0;6,0;13,0;;10,0;23,0;;7,0;;2,0;;;1,0;;1,0;;;;1,0;4,0;14,0;10,0;;2,0;;;;;;1,0;;;2,0;1,0;;6,0;1,0;;12,0;;3,0;;4,0;;14,0;;1,0;;;;3,0;;1,0;;31,0;;;;;;7,0;20,0;241,0;;1,0;11,0;139,0;20,0;;12,0;2,0;;7,0;;1,0;86,0;13,0;;23,0;3,0;;1,0;;11,0;13,0;13,0;21,0;25,0;3,0;58,0;29,0;16,0;20,0;;42,0;5,0;;15,0;2,0;5,0;;;;5,0;5,0;35,0;11,0;139,0;;9,0;;27,0;10,0;1,0;1,0;6,0;10,0;;4,0;;50,0;;3,0;;10,0;22,0;4,0;;18,0;;5,0;15,0;82,0;7,0;3,0;4,0;;;;1,0;;;;3,0;2,0;;2,0;;4,0;2,0;4,0;;4,0;2,0;;1,0;;2,0;;;4,0;2,0;35,0;;7,0;2,0;;;;;;;;;9,0;;;;;;;;2,0;;3,0;;;;;;;;;;;;;2,0;;;2,0;1,0;;;;2,0;8,0;;21,0;;;;;16,0;9,0;;;1,0;;;;;1,0;;;;;;;3,0;;;;2,0;;1,0;;;;;7,0;;9,0;12,0;6,0;3,0;;;;1,0;;;;;;;3,0;;;;;;;;1,0;;;;;;;;;;;;;;;;6,0;4,0;22,0;;7,0;4,0;3,0;18,0;;;;1,0;;5,0;;;2,0;9,0;;2,0;;;;;;;1,0;;;2,0;1,0;;8,0;3,0;43,0;;2,0;;;3,0;;3,0;;3,0;1,0;10,0;;1,0;;25,0;;23,0;2,0;9,0;;;;;;;;2,0;29,0;;23,0;;;;;3,0;;;3,0;;;;12,0;;;;;;11,0;;2,0;;1,0;;;1,0;2,0;;;;;1,0;;;1,0;;1,0;;;;7,0;3,0;;;;2,0;;;;;1,0;;;;;;;;;;;;2,0
attachment;;43,0;;3,0;;2,0;23,0;30,0;1,0;3,0;;;;;7,0;31,0;;;;;;2,0;;4,0;;;;;;;;6,0;91,0;;7,0;;;;;6,0;3,0;;13,0;1,0;7,0;;1,0;78,0;17,0;2,0;8,0;4,0;;;2,0;2,0;277,0;;;;5,0;13,0;;;16,0;4,0;;24,0;4,0;10,0;;;;;;;;;;15,0;1,0;1,0;;79,0;;4,0;1,0;;21,0;4,0;56,0;;;5,0;;13,0;1,0;;2,0;5,0;;;14,0;;;3,0;5,0;;4,0;;2,0;;2,0;;1,0;11,0;46,0;47,0;;2,0;2,0;;;4,0;;;1,0;;;;;;2,0;;6,0;;;2,0;;6,0;;;1,0;18,0;;1,0;1,0;47,0;1,0;3,0;;;13,0;;;1,0;53,0;;;;;;26,0;;1,0;1,0;5,0;3,0;;;;;11,0;;;1,0;178,0;13,0;;;3,0;25,0;;;;2,0;;8,0;;;1,0;;;25,0;;1,0;;;;67,0;;1,0;;11,0;;4,0;;;;22,0;;8,0;;;7,0;;;;1,0;13,0;75,0;;;1,0;;98,0;;6,0;6,0;;69,0;4,0;201,0;74,0;9,0;2,0;1,0;12,0;5,0;6,0;;7,0;;;;;;4,0;;24,0;17,0;;6,0;;2,0;;4,0;;;;;4,0;19,0;4,0;;;6,0;;3,0;;;2,0;5,0;15,0;;;;49,0;20,0;132,0;2,0;;3,0;;;;;;;;17,0;1,0;;;9,0;;;9,0;;;2,0;8,0;241,0;2,0;9,0;2,0;;5,0;17,0;;;;;7,0;;;;7,0;;15,0;9,0;28,0;2,0;1,0;;;23,0;6,0;;;;1,0;;;;;;4,0;1,0;34,0;10,0;;6,0;;1,0;;2,0;2,0;2,0;;;5,0;;4,0;;13,0;4,0;40,0;1,0;;1,0;5,0;;2,0;1,0;;;3,0;3,0;;2,0;4,0;10,0;;;;71,0;3,0;3,0;8,0;8,0;1,0;2,0;14,0;;1,0;;1,0;;27,0;8,0;;;1,0;13,0;2,0;6,0;;4,0;;;;;22,0;;;;;;1,0;;;;;;1,0;4,0;;;;;;4,0;;;;;1,0;;;;;1,0;1,0;2,0;;;;2,0;;3,0;;;;;;;;;;;;;;;5,0;;;;;;;;;7,0;7,0;3,0;;;6,0;;1,0;;;3,0;;6,0;;;;6,0;7,0;;3,0;;;;;;4,0;;2,0;;;;4,0;3,0;;6,0;;30,0;;1,0;1,0;;;2,0;;;;;1,0;2,0;;1,0;;7,0;;5,0;;;1,0;9,0;4,0;;;;1,0;;1,0;;;1,0;1,0;;9,0;;10,0;;;;2,0;;;;;;;;;1,0;10,0;;;1,0;;;;29,0;1,0;;1,0;;;1,0;;2,0;4,0;;;;;;;2,0;4,0;1,0;;;;;;;;4,0;;;;8,0;;;;;;;6,0;;;;;;;;;;;;;;;;;3,0;2,0;;;;;;;;;6,0;;;;;;10,0;1,0;;;;;;;;11,0;;;;;;;;;;5,0;;;;;;;6,0;;;;2,0;23,0;10,0;;10,0;1,0;;3,0;;3,0;3,0;;;12,0;;1,0;;;8,0;15,0;;10,0;;1,0;4,0;3,0;1,0;;;3,0;4,0;;;;1,0;;;;;;;;111,0;;;;3,0;3,0;;;;8,0;;1,0;;;4,0;1,0;;;;;;;;;6,0;5,0;;3,0;3,0;;;;;;;;;;;1,0;;1,0;;;;;;;1,0;;;;;;;1,0;;3,0;;;;;;;;;;1,0;;;;;;;;;;;;;5,0;;;;;;;;;;;1,0;;;1,0;;;;;;;;;;;;13,0;;;;;;;;6,0;;;;;;;;;;;2,0;;;;;;;;;;;8,0;;;;;;1,0;;;;;;;;;;;;;;;;;;;;;;;;;;;;;;;;;;;;;11,0;;;;;;;;;;;2,0;;;;;;;;;;;;2,0;;;4,0;;2,0;;;;;;2,0;1,0;;;;;2,0;;;;;;;;;;;;;;;;;;5,0;;;;;;;;;;;;1,0;;;;3,0;;;;2,0;;;;;;;;;;;;;;;;;;;;;;;;;;;;;;;;;;;;;;;;;;6,0
auto;;1,0;;;;;1,0;13,0;5,0;3,0;4,0;;9,0;;2,0;22,0;;4,0;7,0;;10,0;1,0;1,0;;;11,0;6,0;;2,0;1,0;;;12,0;;43,0;8,0;3,0;7,0;;;5,0;;2,0;7,0;6,0;3,0;21,0;26,0;19,0;;2,0;3,0;;1,0;2,0;11,0;1,0;;17,0;;;8,0;2,0;2,0;2,0;5,0;212,0;1,0;19,0;;12,0;1,0;14,0;;;6,0;3,0;;1,0;50,0;28,0;;;17,0;1,0;3,0;;1,0;2,0;6,0;40,0;;;;6,0;1,0;1,0;2,0;40,0;2,0;;1,0;96,0;8,0;;;5,0;;3,0;12,0;1,0;10,0;;1,0;;25,0;10,0;25,0;4,0;9,0;;;9,0;2,0;19,0;;;;;;;43,0;;;;;3,0;;;;6,0;;;12,0;5,0;;;3,0;13,0;1,0;;;;1,0;2,0;;20,0;;3,0;;;10,0;48,0;;;;4,0;;;;9,0;;;;;12,0;2,0;3,0;;;1,0;1,0;;;;17,0;;4,0;;;;;;4,0;;;;;;1,0;;1,0;1,0;4,0;;3,0;;;70,0;;;;;9,0;;;;;;2,0;6,0;;2,0;;;;;;4,0;;1,0;;;5,0;;3,0;5,0;;1,0;1,0;2,0;;;;;;;;7,0;;;;;;;;14,0;;;;;;;6,0;;;;3,0;1,0;;;6,0;1,0;;;;6,0;;1,0;3,0;7,0;1,0;2,0;;;6,0;;;;;;1,0;;;;;;;;;31,0;;;;;;;7,0;2,0;;;;;;;;;2,0;;3,0;;;;;4,0;;;;;;;;;;;2,0;;;;;;;;;2,0;;1,0;1,0;;;;;1,0;;;;;1,0;5,0;;;;;;;;;;;;;;;;;;1,0;;1,0;;;;;;;4,0;;;;1,0;;1,0;;;;;;;3,0;;;;;;;;;;2,0;23,0;1,0;3,0;;;;;;4,0;;;;;;4,0;;;;;;;;1,0;33,0;;1,0;;;2,0;67,0;;;2,0;3,0;;;;9,0;;;;3,0;;;;;5,0;;;;28,0;;;;;;1,0;23,0;;20,0;4,0;;;1,0;7,0;;1,0;1,0;;;;11,0;1,0;;;;;;;1,0;6,0;;;2,0;5,0;3,0;;;;;;;;;2,0;5,0;;;;;;;;;;;;;3,0;;;;3,0;;64,0;;;;;5,0;;;;;4,0;;;2,0;;;;;;;;3,0;;;;;4,0;;;;;;6,0;;;;;;1,0;;1,0;;;;;;1,0;;;;;;1,0;;;;;;;;;23,0;8,0;;;;;2,0;;;1,0;3,0;;;;;;;;;;;;;;;;;;;;2,0;;;;;;;1,0;;;1,0;;3,0;;;;;;;;;;1,0;;;;;;1,0;6,0;;;;;;;;6,0;;1,0;;;;;;;;1,0;;4,0;;;;;;;;;;;;;;;;;;;;;;1,0;;;;;;;;;;;;;1,0;;;;;;;;;;;;;;;1,0;;;;;;2,0;;;;;;2,0;;;;29,0;;;;;;;;;;;;;;1,0;;;;;;;;;;;;2,0;;;1,0;;;;;;;;;;;;;2,0;1,0;;;1,0;3,0;;;;;;;;;;;;;;;;;2,0;;;;;;;;78,0;1,0;6,0;;;;;;;;;;;;;;;;;;;;4,0;;;;1,0;;;;;;;;;;;;;;;1,0;;2,0;;;;;;;;;2,0;;;;;;;2,0;;;;;;;;;;;;;;;1,0;;;;;;;;1,0;1,0;;;5,0;;;2,0;;1,0;;;;;;1,0;;;;;;;;1,0;;;;;;;;;;;;;;;;;4,0;;1,0;;;;;;;;;;;;;;;;;;;;;;;;;;;;;;;;;;;;;;;;;;;;;;;;;;;;;;;;;;;;;;7,0;;;;;;;;;;;;
axial;;13,0;;;;8,0;8,0;3,0;;7,0;;;;;17,0;1,0;1,0;2,0;;;;5,0;;18,0;;;;1,0;;;;47,0;8,0;;1,0;1,0;;;;;;;5,0;2,0;6,0;9,0;1,0;5,0;1,0;;14,0;47,0;;;;16,0;30,0;1,0;;;17,0;;2,0;;16,0;2,0;;10,0;3,0;;;;;;;;;;6,0;79,0;1,0;9,0;;17,0;;;;;;9,0;143,0;;;;;;;;1,0;;;;;20,0;;;92,0;;3,0;;5,0;;;;;4,0;9,0;17,0;;2,0;;;;;;;;;;;;4,0;7,0;;;;3,0;;;49,0;;;;4,0;;;;74,0;1,0;;;1,0;;;;;14,0;8,0;;;;;109,0;;;;;16,0;;;2,0;;;1,0;16,0;;10,0;;;;1,0;2,0;;;;;;;;;;;;;;3,0;;;;;11,0;;;127,0;;4,0;;;;1,0;1,0;;7,0;;;;3,0;;4,0;9,0;3,0;;4,0;;;;;;10,0;;21,0;;;6,0;5,0;1,0;17,0;;2,0;4,0;;;;35,0;;;;;;6,0;1,0;;4,0;;;;8,0;1,0;;;;;;2,0;;;1,0;;;;;6,0;2,0;;;;;1,0;;24,0;;;;60,0;;5,0;16,0;;;;;1,0;;;1,0;;;;1,0;4,0;;9,0;;;;7,0;1,0;;1,0;;;2,0;;2,0;2,0;;;;;;2,0;;;;;;5,0;;;;;1,0;;;;1,0;;2,0;1,0;1,0;;;1,0;;9,0;;;;15,0;;;9,0;;;;;;;;;;8,0;;;;;;4,0;1,0;;;;;;1,0;;3,0;1,0;;9,0;20,0;;;24,0;;2,0;;1,0;;1,0;;4,0;;1,0;2,0;;;;;;;;;2,0;;;;;1,0;7,0;;;;;;1,0;;;;;;;2,0;;;;;;;3,0;;25,0;;1,0;1,0;;;3,0;;;;1,0;3,0;;;;;;2,0;;1,0;;;;;;;;;;;;;;;;;;;;;;;;;;;;;;3,0;2,0;;3,0;2,0;;;;;;;;;;;;;;;;5,0;;;;;;1,0;;;;;;;;;;;;;;;;;5,0;;;;;;;;;;2,0;;;;;;39,0;;36,0;;;;;;;;;;;;;;;;;3,0;;;;;;1,0;;;;;;1,0;;;;;;;;;;;;;;;;;;4,0;;;;;;;;;;2,0;;3,0;;;;;;;2,0;;;;;;;;;;;;;;;4,0;;;;;;;;;2,0;;;;;;;;;2,0;;;;;;;4,0;;;;;;;1,0;2,0;;;;;6,0;;;;;;;2,0;;1,0;;7,0;;;;;;;;;;;2,0;2,0;;;;1,0;;;;;;;;8,0;;;1,0;;;;1,0;;;;8,0;;1,0;;;;;1,0;;;;;;11,0;;;;;;2,0;2,0;;;;;;6,0;;;;1,0;;;;;;;;;;;;;;1,0;;;;;;;;;;;;;;;;;;;;;;;;;;;1,0;;;;1,0;;;;;;;;;;;;;;;;;11,0;;;;;;;;;2,0;;;;;9,0;;;;;;;;2,0;;2,0;;;;;;;;;;;;;;;1,0;;;1,0;;;;;;;;;;;;;;;;;;;1,0;;;;;;;;;;;;;;;2,0;5,0;;;;;;;;;;;;;;;;;;;;;;;;;;;;;;;1,0;2,0;;1,0;;;;2,0;;;;;;2,0;;;;;;;;;;;;;;;6,0;;;2,0;;;;;;1,0;;;;;;;;;;;;;;;;;;;;;;;;;;;;;;;;;;;8,0;;;;1,0;;;;;;;;;;;4,0;;;;;;
ball;;4,0;;;;;;11,0;1,0;5,0;18,0;;;;12,0;5,0;;;;;;21,0;;;;;;;;;;;20,0;;6,0;1,0;2,0;;;;1,0;3,0;2,0;;1,0;2,0;20,0;21,0;2,0;26,0;13,0;8,0;;2,0;4,0;;111,0;;;;10,0;;4,0;;;1,0;;37,0;3,0;3,0;;;;;2,0;3,0;;;;43,0;;3,0;;59,0;3,0;;;;;1,0;54,0;;;;;;1,0;;25,0;;;;44,0;;;;4,0;2,0;;;19,0;1,0;;;;54,0;36,0;48,0;1,0;1,0;7,0;;;;2,0;;;3,0;;3,0;;2,0;10,0;2,0;;;7,0;;;;5,0;;;11,0;;1,0;;4,0;;2,0;;4,0;;;3,0;;30,0;;;;;1,0;9,0;;;;1,0;;;;;;3,0;1,0;;;42,0;21,0;;;4,0;2,0;3,0;7,0;15,0;2,0;;11,0;;;1,0;;1,0;28,0;;13,0;;;5,0;5,0;4,0;;4,0;7,0;;;4,0;;;15,0;1,0;;2,0;;4,0;;5,0;;15,0;3,0;46,0;;5,0;;;;;;5,0;1,0;42,0;23,0;14,0;24,0;1,0;4,0;9,0;6,0;;1,0;;2,0;;;;;;5,0;;2,0;13,0;;;;;;52,0;;;;;4,0;2,0;2,0;2,0;;6,0;;1,0;;1,0;;8,0;1,0;;7,0;;1,0;6,0;36,0;;;3,0;1,0;;;;;;1,0;10,0;2,0;;;;;;1,0;1,0;14,0;;4,0;5,0;;;84,0;7,0;1,0;9,0;;;3,0;9,0;;;;;43,0;;5,0;;;4,0;3,0;7,0;;11,0;;;;;;;2,0;;;5,0;23,0;3,0;6,0;;;;1,0;;2,0;10,0;4,0;;;2,0;;;;;173,0;;14,0;3,0;;;;;1,0;;;;14,0;2,0;;2,0;;8,0;;;;;10,0;6,0;12,0;11,0;1,0;4,0;12,0;;;;4,0;;20,0;4,0;1,0;;;19,0;3,0;;;;2,0;;;;;;;;;5,0;7,0;;;;;;;2,0;;;;;;;;;;;2,0;;;;;;4,0;2,0;;;;;;;;2,0;;;;1,0;;;;;1,0;;;;;;;3,0;;;;;1,0;;1,0;;;;;5,0;;;;4,0;;;1,0;;;;1,0;;1,0;;;;;;;;;4,0;;;;;;5,0;;13,0;;;2,0;;;;1,0;;;;;;;;;;;;4,0;;;;2,0;;;;6,0;;;;;2,0;4,0;;4,0;;8,0;1,0;;;6,0;;;;;;;;;;16,0;;;2,0;1,0;;;6,0;;;3,0;;1,0;4,0;;;2,0;;8,0;1,0;;1,0;;1,0;1,0;;14,0;;;;;;;;;7,0;;;;;;;;;;;1,0;;;15,0;;;;;;;4,0;;;2,0;;;;;;;;;;;;;;;;;;2,0;;;;;;;;1,0;5,0;;;;;2,0;;;;;2,0;62,0;;;1,0;1,0;;6,0;9,0;;;;;3,0;;;;;;1,0;5,0;;;1,0;;;;9,0;;;;;4,0;1,0;;8,0;;;2,0;;;;5,0;;;;;;;;;1,0;;;;;;6,0;;;;;185,0;2,0;;;3,0;;;;;;;;2,0;;;;1,0;2,0;;;;;;;;;;;4,0;;6,0;;3,0;;1,0;;;;;3,0;;;;;;75,0;1,0;1,0;;1,0;;;;;;;;;;;;;;;;;;;3,0;2,0;;;;;;1,0;;;;;2,0;1,0;;;;;;;;;1,0;;;;;;;2,0;2,0;;;;;;;2,0;;;;;;;;;;;;;;;;;;;;;;;2,0;;;;;;;;;;;;;3,0;;;;;2,0;;;;;;;;5,0;;;;;;;;;;;;1,0;;;;1,0;;3,0;;;;;;;;;;;;2,0;;;;;;;;;;;;;;;;;;;;1,0;;;;;;1,0;;6,0;;;;;;;;;;;;;;;;127,0;;;;;;;;;;;;5,0;;;;;;2,0;;;;;;;;;;;;;;2,0;;;;;;;;1,0;1,0;;;;;;;7,0;;;;;;;;1,0;;;;;;
barrel;;3,0;1,0;;1,0;19,0;30,0;53,0;24,0;97,0;;;4,0;1,0;217,0;42,0;11,0;1,0;;;;22,0;;3,0;1,0;;;;1,0;;;3,0;105,0;;23,0;2,0;1,0;4,0;;;;;98,0;;19,0;8,0;4,0;81,0;3,0;2,0;123,0;10,0;2,0;;66,0;20,0;92,0;;;;73,0;18,0;5,0;;6,0;7,0;37,0;118,0;31,0;79,0;2,0;;13,0;;;37,0;;;;151,0;15,0;50,0;;269,0;7,0;;5,0;;22,0;2,0;2774,0;;;6,0;2,0;;4,0;;47,0;10,0;;;424,0;19,0;;;273,0;4,0;2,0;;20,0;5,0;56,0;;;115,0;242,0;136,0;1,0;5,0;14,0;;1,0;;;1,0;;;;3,0;;7,0;76,0;9,0;2,0;;10,0;1,0;;5,0;;;;97,0;1,0;;2,0;105,0;19,0;6,0;;3,0;1,0;;;2,0;53,0;;6,0;3,0;;2,0;145,0;;3,0;;;2,0;;;13,0;1,0;28,0;3,0;1,0;16,0;230,0;;12,0;;54,0;101,0;14,0;64,0;;36,0;4,0;17,0;1,0;;1,0;2,0;;96,0;2,0;48,0;;;;62,0;50,0;1,0;1,0;76,0;2,0;33,0;4,0;;;67,0;3,0;6,0;76,0;;1,0;;59,0;3,0;8,0;56,0;219,0;;123,0;;;7,0;1,0;1,0;40,0;5,0;239,0;1,0;;127,0;365,0;151,0;26,0;58,0;66,0;123,0;4,0;;13,0;1,0;;;;3,0;;26,0;40,0;;20,0;1,0;12,0;;404,0;1,0;;1,0;19,0;;5,0;;;5,0;24,0;11,0;20,0;2,0;5,0;;59,0;3,0;;79,0;;23,0;25,0;284,0;4,0;;26,0;6,0;;;;3,0;1,0;3,0;;10,0;46,0;;96,0;;27,0;;8,0;4,0;244,0;19,0;78,0;;21,0;18,0;6,0;12,0;59,0;;;68,0;5,0;24,0;6,0;2,0;;3,0;1,0;87,0;27,0;1,0;26,0;18,0;103,0;;80,0;7,0;;17,0;4,0;3,0;24,0;;;;;105,0;58,0;186,0;22,0;5,0;33,0;10,0;3,0;2,0;20,0;35,0;13,0;1,0;29,0;24,0;1,0;21,0;58,0;7,0;;18,0;18,0;;;5,0;;28,0;61,0;;17,0;69,0;23,0;1,0;;;;;;;49,0;13,0;75,0;20,0;28,0;26,0;2,0;17,0;9,0;14,0;47,0;3,0;;98,0;23,0;2,0;;13,0;46,0;3,0;;;;;;;;6,0;;;;;;;4,0;;;;;5,0;2,0;;;;;2,0;14,0;;;;1,0;4,0;;;;;;18,0;7,0;;;;2,0;;1,0;6,0;37,0;;;5,0;22,0;;5,0;1,0;5,0;1,0;;;;;;;;;8,0;;;;;;;;;;;;;;;;;;1,0;;11,0;20,0;;8,0;;;;;3,0;;;;;;;1,0;;3,0;15,0;;19,0;;;8,0;1,0;;7,0;;;;;;1,0;;;;5,0;;;;;;1,0;11,0;1,0;;;1,0;;1,0;;;;3,0;;;1,0;;4,0;;;42,0;;;;1,0;1,0;;1,0;;;;;;;;;;2,0;;1,0;5,0;;1,0;26,0;;2,0;;;5,0;5,0;;;;9,0;1,0;7,0;5,0;;2,0;;14,0;;;1,0;1,0;;;6,0;;;;1,0;15,0;5,0;4,0;;;2,0;1,0;27,0;;;;;2,0;;1,0;;;2,0;;8,0;1,0;;;;;;;;;;;;;6,0;;;;;15,0;;4,0;;;;6,0;;1,0;;;;;;;;10,0;;16,0;11,0;;1,0;24,0;8,0;13,0;3,0;;8,0;1,0;11,0;;;;;8,0;5,0;;5,0;2,0;4,0;2,0;;;1,0;2,0;;;20,0;7,0;;;;2,0;;;;;;4,0;;1,0;;;;3,0;;;16,0;1,0;;3,0;;;24,0;16,0;4,0;1,0;2,0;1,0;;;;32,0;8,0;;;;14,0;7,0;;31,0;11,0;;;62,0;6,0;;6,0;4,0;;;;;2,0;;;12,0;;6,0;;6,0;;14,0;;6,0;;2,0;3,0;;;;;13,0;;4,0;;;;;;;;;;;;;;;;4,0;;;;;;1,0;;7,0;;;;;1,0;;;;;;;;;6,0;;;;;;7,0;;1,0;;1,0;;;;59,0;;;;;;2,0;2,0;2,0;;;2,0;;;;;;;;3,0;;;;;;;;1,0;;;;;;;;;;;;2,0;;1,0;2,0;;;;;;;1,0;;;;11,0;;;;;;;;;2,0;;;;;;;;;;2,0;3,0;;;;;;;1,0;;;;;3,0;;;;;;7,0;;1,0;;7,0;;;;1,0;;;16,0;;;3,0;2,0;;;3,0;;;;;10,0;7,0;;10,0;2,0;;;;;;;;;1,0;1,0;2,0;;;;;9,0;6,0;;;;;;;6,0;;;3,0;2,0;;;;;;;;;4,0;;;;;;3,0;;;;;;;;;;;;;;;;;;;;;;;;;;;;;;;
basis;;2,0;;;2,0;13,0;12,0;8,0;11,0;1,0;4,0;;7,0;;1,0;15,0;1,0;9,0;12,0;;7,0;18,0;1,0;;;13,0;36,0;2,0;;;2,0;20,0;31,0;4,0;68,0;10,0;14,0;55,0;;;123,0;;8,0;2,0;35,0;37,0;63,0;18,0;10,0;34,0;;25,0;18,0;7,0;36,0;6,0;3,0;;21,0;4,0;;4,0;;;1,0;15,0;36,0;11,0;25,0;;11,0;;58,0;1,0;1,0;10,0;4,0;;1,0;234,0;4,0;29,0;1,0;9,0;2,0;14,0;10,0;1,0;;2,0;47,0;;;1,0;11,0;;7,0;;52,0;;2,0;2,0;8,0;18,0;;1,0;38,0;1,0;47,0;21,0;;29,0;;;3,0;17,0;14,0;74,0;2,0;15,0;;;8,0;22,0;5,0;9,0;;5,0;;11,0;;42,0;2,0;1,0;;1,0;15,0;2,0;8,0;;3,0;;1,0;50,0;8,0;4,0;;1,0;128,0;5,0;;;5,0;5,0;24,0;6,0;19,0;;;11,0;;4,0;67,0;;1,0;;39,0;5,0;;;6,0;;;;35,0;;;;;;;9,0;;;12,0;3,0;;19,0;;;;;;;;;;;;;;;21,0;12,0;1,0;;3,0;;20,0;30,0;;;1,0;2,0;;;;1,0;1,0;;3,0;;;;;1,0;;;37,0;;1,0;1,0;;10,0;;2,0;19,0;2,0;;;1,0;;;;13,0;4,0;;5,0;91,0;3,0;3,0;4,0;;;;;8,0;;;;;;;18,0;;4,0;;;8,0;1,0;;11,0;1,0;;2,0;;3,0;4,0;8,0;2,0;8,0;13,0;;;;34,0;1,0;;1,0;;17,0;;;;;;12,0;;;;2,0;1,0;5,0;1,0;5,0;;;4,0;;;;;;;;8,0;;;;;;;;;2,0;;;;;;;;2,0;;;9,0;;1,0;3,0;2,0;;;1,0;;;;1,0;6,0;;2,0;;;16,0;11,0;;1,0;;11,0;;;;;;;;;;;;1,0;6,0;;;3,0;;;1,0;;;1,0;;;;;;2,0;;;;1,0;;25,0;1,0;;;8,0;1,0;;1,0;;1,0;;;;;;;;;50,0;12,0;1,0;20,0;2,0;20,0;;1,0;;;;;;25,0;9,0;;;;9,0;;;1,0;9,0;11,0;;9,0;4,0;1,0;14,0;3,0;;1,0;6,0;3,0;;;3,0;21,0;;14,0;8,0;3,0;;;;5,0;11,0;1,0;;;3,0;;2,0;;8,0;;;;;3,0;3,0;9,0;;;10,0;7,0;;29,0;;2,0;;14,0;;;4,0;13,0;1,0;1,0;;19,0;4,0;;5,0;;4,0;;;;2,0;4,0;;9,0;;;11,0;4,0;;;;13,0;;1,0;1,0;1,0;;1,0;;;;;;3,0;1,0;2,0;2,0;;4,0;;;;;;19,0;;3,0;3,0;;8,0;2,0;;;;;;2,0;1,0;13,0;8,0;4,0;;2,0;;;3,0;2,0;2,0;2,0;;2,0;;;;3,0;;4,0;;8,0;;11,0;2,0;;3,0;3,0;;;;;;;1,0;;2,0;;3,0;;3,0;3,0;;;1,0;;8,0;;;;;;;;;;;;;;;;;;;;;1,0;3,0;;;1,0;;4,0;;;;;;2,0;4,0;;14,0;6,0;;1,0;;;;2,0;;;;;;;7,0;;;;1,0;1,0;;;3,0;;;6,0;;;2,0;;2,0;;;;;25,0;;;3,0;;;5,0;;1,0;6,0;;6,0;;;;;;;;;1,0;;;;1,0;;2,0;;;1,0;2,0;;;;;;;;;;;;;;2,0;;1,0;;;;;;;1,0;;;;;;;;;;10,0;;;;;1,0;10,0;2,0;;;8,0;;;;;2,0;;;3,0;;;;;1,0;;;;;;;;2,0;1,0;;7,0;;;3,0;;;;;;10,0;;2,0;;;22,0;10,0;;2,0;4,0;;4,0;10,0;;2,0;;;;1,0;;;19,0;1,0;2,0;4,0;;;;;;;7,0;;6,0;3,0;;3,0;;1,0;;;12,0;2,0;8,0;;;1,0;;;;2,0;;;2,0;;1,0;;4,0;3,0;2,0;;;;1,0;14,0;;;4,0;;;;;3,0;;;;3,0;1,0;;1,0;;;3,0;3,0;;2,0;1,0;;;;;;;3,0;3,0;9,0;6,0;1,0;1,0;;;;;;3,0;8,0;;;2,0;;;;;;;;1,0;;;;;;;;;1,0;;1,0;;;;22,0;;6,0;;;1,0;5,0;;;;2,0;;;;;;;;;;18,0;1,0;;;;1,0;;;;;1,0;;;;1,0;;;;;;;;;;;;3,0;;;;1,0;;;;1,0;;;;1,0;;;;;;;3,0;;2,0;;;;;;6,0;7,0;;;;6,0;;;4,0;;12,0;;;;;;2,0;;;1,0;;;;;;;;;
battery;;8,0;;;;;;16,0;1,0;;;;2,0;;;22,0;;;;;;11,0;;1,0;;;;;1,0;;2,0;;37,0;;14,0;5,0;;;;;5,0;1,0;3,0;;14,0;1,0;5,0;24,0;48,0;25,0;14,0;;;;;;1,0;;;;2,0;10,0;;;;;;16,0;3,0;1,0;;;2,0;;;4,0;;4,0;8,0;23,0;2,0;1,0;;53,0;1,0;;2,0;;;;4,0;;;;;;2,0;;18,0;1,0;;;63,0;2,0;;1,0;2,0;2,0;;;;;;;;4,0;18,0;14,0;141,0;3,0;;;;1,0;4,0;;;;;;;;4,0;5,0;;;4,0;;;;;3,0;;11,0;1,0;;;7,0;4,0;3,0;;;3,0;6,0;;29,0;29,0;;;2,0;;6,0;51,0;;;;42,0;;1,0;;;;;;3,0;;25,0;;;;1,0;20,0;;7,0;78,0;23,0;;3,0;;;;;;29,0;;;;;;8,0;;;;1,0;;;1,0;22,0;;2,0;;;;;;;;3,0;;;78,0;;4,0;3,0;;1,0;;;19,0;;1,0;1,0;;15,0;;;;11,0;1,0;12,0;;8,0;;;;;;1,0;;;1,0;;;;;;24,0;;;;;;4,0;2,0;;;;;;;;52,0;1,0;;;;;;;11,0;3,0;;;;;3,0;;;;;2,0;;;;21,0;;1,0;;;;;8,0;2,0;;;;;4,0;5,0;;22,0;11,0;3,0;;7,0;1,0;110,0;6,0;;11,0;;4,0;;10,0;;4,0;7,0;;;;;;;;;;;;;2,0;1,0;;1,0;1,0;;;;;6,0;;;;;2,0;;;;;3,0;1,0;;;;1,0;;4,0;;6,0;2,0;;;13,0;1,0;;;;;;;;;;;;;;;;;11,0;;;;1,0;1,0;16,0;;;;;;;2,0;3,0;;;;;2,0;;;;;;;5,0;;2,0;;;;;6,0;2,0;4,0;;5,0;;;;;1,0;8,0;;1,0;;;2,0;7,0;1,0;1,0;1,0;;;;;;;6,0;;;;;;9,0;1,0;;;;;;;;;;;18,0;;2,0;1,0;;;9,0;;1,0;;;;14,0;;;5,0;;;;;;;1,0;;;;;;8,0;;2,0;1,0;4,0;;2,0;1,0;8,0;;2,0;;;;;;;;;3,0;;;;4,0;1,0;;;1,0;;;;;4,0;3,0;;2,0;;;;4,0;;;1,0;;;;2,0;;;;;;;;;;;;1,0;1,0;;;;;;1,0;1,0;;16,0;1,0;;;;14,0;;;;;;7,0;;2,0;7,0;7,0;;;;2,0;;;1,0;;;;6,0;;;;;2,0;;;1,0;;;1,0;52,0;1,0;2,0;;1,0;4,0;;7,0;;;1,0;;6,0;;5,0;;;;;;;;;;;26,0;1,0;;2,0;;;;;6,0;;;;;;5,0;;;2,0;;;1,0;;;;;;16,0;;11,0;2,0;;;4,0;1,0;1,0;;;;4,0;;;;2,0;;;;1,0;;;;;;;;2,0;;;;;;;;;;;;;;;;;2,0;;;1,0;;;;;;;;;;;1,0;;;;;5,0;;4,0;;;3,0;;21,0;;;3,0;2,0;1,0;;;;;1,0;;5,0;;2,0;;;1,0;;;;;;;;;;;;;;;;;;;7,0;;;;;;;;;;;;;;;;;;;;;;;;;2,0;;;;;;;;;;;;;;;;;;;;;;;;;;;;;;;;;;;;;;;;;;;;;;;1,0;;;;;2,0;;;;;;1,0;2,0;;;;;;;;;;;;;;;;;;;;;;;;;;;;;1,0;2,0;;;;;;;;2,0;;;1,0;3,0;;;;;;;;;;5,0;;;;3,0;1,0;3,0;;4,0;10,0;;;;;;;;;;;;;;;;;;;;;;;;;;;;;;;5,0;;;4,0;;;;;;;;;;;1,0;;;;;;;;;3,0;;;;;;;;;;;;;;;;;;;;;;;;;;;;;;;;;;;;;;;;1,0;;
become;;6,0;;;;2,0;7,0;13,0;11,0;;3,0;;1,0;;3,0;9,0;;;10,0;;4,0;5,0;;;2,0;2,0;1,0;;;;;2,0;1,0;;15,0;;1,0;;1,0;;2,0;2,0;;;4,0;1,0;5,0;13,0;7,0;11,0;1,0;2,0;;2,0;;1,0;4,0;;;;;;2,0;;1,0;1,0;16,0;4,0;5,0;2,0;;;2,0;;;1,0;;;;32,0;1,0;12,0;;;3,0;;;;1,0;1,0;10,0;;;1,0;8,0;4,0;5,0;;5,0;1,0;;;9,0;23,0;;1,0;9,0;9,0;2,0;1,0;;5,0;;;1,0;7,0;6,0;13,0;;34,0;;;;3,0;;;;8,0;;1,0;;13,0;3,0;;;7,0;;1,0;3,0;;;;;2,0;5,0;;;;18,0;6,0;;;2,0;3,0;5,0;;4,0;;1,0;2,0;;;13,0;6,0;1,0;;1,0;1,0;11,0;12,0;3,0;;;2,0;15,0;2,0;;;;;;7,0;;;7,0;;;2,0;;1,0;2,0;;;7,0;;8,0;;;;;;;2,0;27,0;;;7,0;;7,0;8,0;;1,0;;;;;1,0;;;;1,0;;1,0;;;;1,0;;40,0;;5,0;;;17,0;;;2,0;9,0;;1,0;5,0;;;;1,0;;2,0;;8,0;1,0;;;;;;2,0;1,0;;1,0;;;;;4,0;3,0;;1,0;;;;;;1,0;;;;;;6,0;11,0;;;1,0;2,0;2,0;3,0;;;;3,0;2,0;;;;;;;;;;1,0;;1,0;;;;;;1,0;;;7,0;;;11,0;;;1,0;1,0;;;;;;2,0;;6,0;1,0;;1,0;;;;;;1,0;;;1,0;2,0;;;;;;1,0;;;5,0;6,0;;;;;;;;6,0;;;2,0;;;1,0;2,0;;;;;;;;;;;;3,0;;1,0;1,0;;;10,0;;;;;;;;;12,0;;;;1,0;;7,0;1,0;;;;;;;;;;;12,0;;;;;;;;1,0;1,0;;1,0;;1,0;1,0;;;;;;;;;18,0;;;;;1,0;5,0;4,0;;;1,0;;1,0;;2,0;3,0;;;;1,0;;;2,0;;;;;;1,0;;1,0;;;;;;5,0;;;;;;1,0;;1,0;;14,0;;;2,0;;1,0;2,0;;;;;1,0;;;;;;;;;;;;;4,0;4,0;;;;;;;;;;2,0;;;;;1,0;;;6,0;;3,0;;;;;;;;;;1,0;;;6,0;;;;2,0;;;10,0;;;;;;4,0;;;1,0;;;;1,0;4,0;;;;;4,0;;;;;2,0;1,0;;3,0;;;;;1,0;;;;;;;;;;12,0;;;;;1,0;;;;;;;;;;;;;;;;;;;;;;;;1,0;1,0;;;1,0;;;;;;;;2,0;;;;5,0;;;;;;;;;;;;;;;2,0;;;;;;2,0;;;;;;;;;;;;;5,0;;;1,0;;;;;10,0;;;;;;;;2,0;;;7,0;;5,0;;;;;;;2,0;;;;;15,0;;;;;;;;;;3,0;;;;;;;;;;;2,0;;6,0;;1,0;;1,0;;1,0;;1,0;;4,0;;;2,0;1,0;;;;;;;;;2,0;;2,0;;;;;;;;;;;1,0;;1,0;;;;;3,0;;4,0;;4,0;;;;18,0;4,0;;;;;;;11,0;2,0;;;;;;;;;;2,0;;;12,0;;;1,0;;;;1,0;;4,0;;;;;;;;3,0;3,0;;;;;;;;;;;;;;1,0;;;;;;2,0;;2,0;2,0;;;1,0;;;;;;;1,0;;;;;;;;;;;;;1,0;;3,0;;;;;;1,0;;;;;;1,0;1,0;2,0;;;;;;;;;;2,0;;;;2,0;;;;;;;;;;;;;;;;;;;;1,0;;;2,0;;;;;1,0;;;;;;;3,0;;;2,0;;;2,0;;;;1,0;;;;;;;;;;;;8,0;;;;;;;;;;;;;;;;;;;;;;;;1,0;;;;;;;;;;;1,0;;;4,0;1,0;;;2,0;;;;;;;1,0;;;;;;
block;;6,0;;;1,0;7,0;9,0;42,0;85,0;49,0;23,0;;20,0;2,0;7,0;46,0;17,0;1,0;5,0;;;61,0;;2,0;2,0;11,0;38,0;3,0;;1,0;4,0;2,0;78,0;2,0;68,0;;5,0;8,0;;;167,0;1,0;27,0;21,0;16,0;10,0;43,0;92,0;15,0;12,0;10,0;14,0;3,0;44,0;13,0;10,0;48,0;2,0;16,0;;16,0;1,0;12,0;;39,0;;6,0;90,0;62,0;7,0;19,0;3,0;25,0;;;31,0;8,0;;6,0;500,0;6,0;31,0;;117,0;4,0;6,0;3,0;;7,0;2,0;91,0;;32,0;35,0;;1,0;15,0;1,0;50,0;;;1,0;39,0;39,0;1,0;1,0;31,0;2,0;57,0;8,0;20,0;31,0;3,0;;7,0;132,0;85,0;79,0;14,0;30,0;12,0;2,0;10,0;136,0;21,0;13,0;;2,0;5,0;9,0;;42,0;11,0;1,0;11,0;3,0;19,0;5,0;4,0;1,0;2,0;2,0;;78,0;19,0;5,0;;99,0;95,0;26,0;3,0;4,0;;8,0;4,0;9,0;73,0;;1,0;2,0;1,0;26,0;137,0;7,0;;;21,0;16,0;8,0;10,0;;;8,0;10,0;3,0;8,0;12,0;12,0;;;33,0;11,0;1,0;6,0;20,0;77,0;4,0;25,0;;1,0;4,0;3,0;;42,0;10,0;9,0;8,0;;;17,0;1,0;;19,0;37,0;;3,0;2,0;2,0;9,0;10,0;8,0;1,0;9,0;;;2,0;45,0;4,0;;37,0;27,0;22,0;15,0;1,0;;2,0;37,0;1,0;284,0;;60,0;5,0;6,0;95,0;16,0;17,0;4,0;26,0;10,0;4,0;5,0;10,0;6,0;22,0;;;3,0;;236,0;4,0;15,0;;8,0;;9,0;;63,0;;;2,0;;;3,0;57,0;2,0;;13,0;14,0;29,0;1,0;84,0;36,0;10,0;2,0;3,0;4,0;16,0;17,0;30,0;70,0;15,0;;33,0;;;32,0;1,0;2,0;1,0;3,0;1,0;4,0;;;11,0;3,0;19,0;;3,0;6,0;27,0;12,0;21,0;;1,0;2,0;;;14,0;;;9,0;6,0;4,0;14,0;9,0;;6,0;3,0;4,0;8,0;;;6,0;12,0;;;;;10,0;;14,0;;;;2,0;2,0;27,0;4,0;2,0;3,0;4,0;6,0;1,0;3,0;5,0;19,0;2,0;6,0;13,0;1,0;6,0;1,0;1,0;;6,0;;16,0;5,0;;;7,0;6,0;17,0;21,0;4,0;9,0;6,0;4,0;7,0;;1,0;;;2,0;;1,0;6,0;9,0;7,0;7,0;;5,0;3,0;1,0;1,0;5,0;3,0;;100,0;;12,0;;10,0;;5,0;;11,0;2,0;10,0;3,0;;1,0;9,0;;;;;4,0;31,0;3,0;13,0;19,0;2,0;15,0;1,0;1,0;;;1,0;;5,0;7,0;16,0;;;3,0;73,0;2,0;;;30,0;12,0;1,0;11,0;3,0;18,0;8,0;22,0;;;61,0;6,0;;4,0;4,0;43,0;1,0;3,0;12,0;8,0;2,0;;;1,0;;;3,0;;7,0;3,0;;;;1,0;2,0;;;14,0;2,0;;3,0;;1,0;9,0;;27,0;;7,0;;12,0;16,0;5,0;3,0;3,0;;;;10,0;3,0;2,0;;;57,0;;4,0;;;8,0;;3,0;;;2,0;22,0;1,0;9,0;;9,0;;3,0;9,0;1,0;;12,0;;2,0;;14,0;;4,0;2,0;;4,0;;7,0;;5,0;;;4,0;32,0;11,0;7,0;12,0;;9,0;1,0;;3,0;;11,0;;6,0;;14,0;3,0;6,0;1,0;43,0;;;;1,0;;2,0;;4,0;5,0;2,0;;9,0;2,0;9,0;;21,0;;3,0;;1,0;5,0;;4,0;;;8,0;4,0;1,0;;;;;;;2,0;3,0;;;;;;;;3,0;;;;;1,0;;46,0;;;;;8,0;;;;;;;7,0;;3,0;;;1,0;;;;;;5,0;7,0;;12,0;2,0;;3,0;8,0;;2,0;4,0;2,0;;;7,0;1,0;1,0;5,0;;4,0;1,0;18,0;;;2,0;2,0;3,0;;;;7,0;1,0;5,0;7,0;;;;2,0;;;3,0;1,0;6,0;;;;15,0;;2,0;1,0;;;;;1,0;2,0;1,0;;3,0;;5,0;;3,0;;1,0;1,0;;;;;;;;1,0;4,0;1,0;;;;2,0;;2,0;;7,0;;;4,0;;;;3,0;;1,0;;;14,0;2,0;;3,0;2,0;;;9,0;7,0;;;1,0;;3,0;;;9,0;1,0;;;1,0;;2,0;;;3,0;;;1,0;;;;10,0;;;;1,0;;;;;5,0;;1,0;;2,0;9,0;1,0;4,0;2,0;;;;4,0;;25,0;;3,0;;;12,0;25,0;;;;;3,0;;;;5,0;;1,0;6,0;;;;;;;9,0;;20,0;;4,0;4,0;;;;;19,0;;;13,0;;;;24,0;17,0;;4,0;;;24,0;2,0;4,0;1,0;8,0;10,0;1,0;22,0;;;;;;1,0;;;;4,0;;;3,0;;;1,0;;5,0;;;2,0;2,0;;34,0;8,0;;;1,0;4,0;11,0;;;;;;3,0;;;;;;;8,0;;;;3,0;;8,0;5,0;2,0;;;;;6,0;;9,0;2,0;;1,0;1,0;;;;1,0;;;;;9,0;3,0;;2,0;;12,0;;;2,0;;1,0;;;;1,0;;;;;13,0;4,0;;;4,0;7,0;4,0;;1,0;;;;5,0;;1,0;;11,0;;;;;;;;;;;;;;;;;5,0;1,0;;;;;;;;;2,0;;3,0;;;7,0;;;;;;;3,0;;4,0;;;7,0;;;;;;;1,0;;;;;5,0;;;;;;;;;
board;;1,0;1,0;;3,0;6,0;8,0;36,0;10,0;55,0;10,0;;7,0;;15,0;125,0;;;;26,0;8,0;32,0;;2,0;;;;1,0;;1,0;27,0;;54,0;;51,0;22,0;;2,0;4,0;;27,0;;67,0;2,0;11,0;;1,0;101,0;10,0;5,0;79,0;9,0;;;8,0;23,0;69,0;;1,0;;42,0;11,0;6,0;;9,0;2,0;1,0;63,0;29,0;38,0;3,0;;7,0;;;3,0;;;7,0;287,0;33,0;59,0;;138,0;;1,0;1,0;;;8,0;197,0;1,0;;10,0;;;56,0;;26,0;1,0;;;259,0;15,0;3,0;1,0;31,0;2,0;4,0;9,0;15,0;1,0;6,0;;;86,0;127,0;142,0;18,0;9,0;1,0;1,0;5,0;25,0;30,0;4,0;1,0;;;2,0;;3,0;9,0;1,0;;;13,0;4,0;;1,0;;1,0;4,0;335,0;1,0;;1,0;116,0;31,0;6,0;;2,0;14,0;9,0;;12,0;67,0;;6,0;6,0;;7,0;92,0;;;4,0;4,0;;;;1,0;1,0;19,0;15,0;2,0;4,0;58,0;54,0;;;;25,0;6,0;10,0;;1393,0;;34,0;2,0;;1,0;;1,0;205,0;;24,0;;;3,0;37,0;2,0;10,0;;15,0;4,0;31,0;;;;38,0;;1,0;5,0;;4,0;;14,0;14,0;4,0;69,0;75,0;7,0;12,0;;;3,0;21,0;;33,0;2,0;74,0;18,0;;339,0;4,0;8,0;2,0;64,0;32,0;17,0;2,0;11,0;1,0;;;;;1,0;11,0;13,0;68,0;;5,0;2,0;;;61,0;7,0;;;;6,0;20,0;4,0;3,0;;9,0;28,0;5,0;;5,0;6,0;28,0;12,0;;5,0;;10,0;32,0;203,0;5,0;;35,0;1,0;;5,0;;9,0;;3,0;32,0;4,0;1,0;;13,0;;4,0;2,0;99,0;8,0;5,0;7,0;54,0;1,0;4,0;2,0;4,0;33,0;34,0;2,0;16,0;16,0;20,0;;;1,0;;37,0;2,0;40,0;2,0;;4,0;4,0;19,0;1,0;5,0;;;;4,0;;;;8,0;;42,0;3,0;12,0;78,0;10,0;;10,0;12,0;7,0;;;8,0;12,0;19,0;6,0;4,0;;13,0;7,0;2,0;;2,0;7,0;;;1,0;7,0;2,0;4,0;;;11,0;2,0;;5,0;;;;;40,0;;42,0;19,0;2,0;8,0;4,0;3,0;9,0;4,0;;8,0;1,0;;89,0;5,0;;;4,0;;5,0;;2,0;7,0;;;;;4,0;1,0;;;;;;;;6,0;;;1,0;;;;;;;3,0;;;;;1,0;;;;11,0;6,0;;1,0;;;;1,0;;3,0;3,0;7,0;;3,0;1,0;3,0;;4,0;;;;6,0;;;;;;;;5,0;;1,0;;;4,0;;;2,0;13,0;;;;1,0;2,0;1,0;;;;;16,0;15,0;;12,0;10,0;;;;7,0;;;;;1,0;;;;1,0;7,0;;16,0;5,0;2,0;;6,0;1,0;;;3,0;;;;;;;;2,0;;7,0;;1,0;;2,0;8,0;1,0;;1,0;13,0;;11,0;;;2,0;22,0;;7,0;;5,0;;;;2,0;2,0;;;3,0;;;;;;;2,0;;;;;1,0;1,0;5,0;1,0;;1,0;1,0;3,0;;3,0;1,0;3,0;;4,0;4,0;2,0;;4,0;;7,0;6,0;;;;2,0;;2,0;1,0;;;;;3,0;;;;6,0;5,0;;;;;;25,0;;;;;3,0;;1,0;;;3,0;;1,0;;1,0;;2,0;;;;;;;;;;;1,0;;1,0;;;;8,0;;;5,0;4,0;;;;;;;;;;;;;;6,0;12,0;7,0;;3,0;1,0;;2,0;;16,0;;;4,0;;1,0;2,0;;;;;1,0;;;2,0;1,0;;4,0;239,0;1,0;;;5,0;;2,0;8,0;;1,0;4,0;2,0;;;;;;4,0;2,0;;563,0;;;;1,0;;1,0;;1,0;;;19,0;;2,0;;34,0;;;;;;;12,0;4,0;7,0;1,0;;22,0;14,0;;;;;;1,0;;6,0;;4,0;3,0;;11,0;;3,0;;2,0;4,0;4,0;;;7,0;;;;;2,0;12,0;;;;2,0;;;;;2,0;;2,0;;;;;;5,0;;;;;;;;4,0;;;3,0;;2,0;;;;;;;1,0;;1,0;2,0;;;;3,0;;;;2,0;;;;1,0;1,0;;;;;;;;;;11,0;1,0;;;;;;;;10,0;;;;1,0;;;;;;;;1,0;;;;;;;2,0;;;;;1,0;;;;;;;;;;1,0;;;;;;;10,0;6,0;;;;1,0;;;;;7,0;;;5,0;1,0;;;;;;;;;1,0;4,0;;5,0;3,0;;;;;3,0;7,0;;1,0;;;;;3,0;;3,0;;;9,0;;;;;1,0;;4,0;;;5,0;;;;;;;;;;;;5,0;;;;;;;;;;;;;;3,0;1,0;;1,0;;14,0;1,0;;;4,0;;;;;;;;;1,0;;;;;;;;;;;;;;1,0;;;;;;;;;;;;;;;;;2,0;;
body;;290,0;7,0;3,0;1,0;25,0;40,0;168,0;31,0;71,0;2,0;;9,0;;116,0;202,0;9,0;14,0;1,0;;7,0;69,0;29,0;8,0;1,0;3,0;3,0;6,0;3,0;;9,0;21,0;299,0;1,0;562,0;334,0;51,0;43,0;2,0;7,0;185,0;;54,0;8,0;417,0;89,0;64,0;419,0;55,0;169,0;242,0;21,0;;;138,0;49,0;128,0;11,0;1,0;2,0;87,0;29,0;9,0;;4,0;14,0;63,0;213,0;73,0;172,0;50,0;10,0;129,0;5,0;3,0;12,0;13,0;3,0;11,0;382,0;1,0;340,0;37,0;818,0;;56,0;631,0;1,0;33,0;14,0;1423,0;4,0;;13,0;5,0;11,0;24,0;;169,0;39,0;3,0;4,0;293,0;49,0;54,0;80,0;215,0;10,0;118,0;1,0;10,0;78,0;29,0;6,0;;140,0;635,0;283,0;111,0;82,0;8,0;7,0;10,0;20,0;21,0;7,0;10,0;1,0;13,0;25,0;21,0;43,0;141,0;18,0;7,0;3,0;12,0;148,0;;;;;44,0;140,0;57,0;5,0;8,0;405,0;714,0;13,0;3,0;8,0;48,0;34,0;75,0;68,0;435,0;;12,0;2,0;1,0;136,0;1011,0;7,0;14,0;2,0;122,0;55,0;1,0;;42,0;7,0;6,0;44,0;10,0;20,0;92,0;101,0;1,0;;25,0;;8,0;60,0;;23,0;;46,0;7,0;;2,0;2,0;21,0;279,0;10,0;352,0;;;10,0;145,0;64,0;;1,0;144,0;1,0;132,0;11,0;3,0;20,0;71,0;;10,0;16,0;18,0;1,0;;27,0;12,0;8,0;84,0;183,0;10,0;64,0;20,0;3,0;13,0;5,0;4,0;93,0;1,0;375,0;9,0;34,0;1170,0;84,0;46,0;47,0;109,0;52,0;73,0;9,0;22,0;20,0;67,0;29,0;;1,0;2,0;16,0;30,0;98,0;;3,0;8,0;14,0;8,0;267,0;7,0;4,0;1,0;;20,0;27,0;20,0;;14,0;60,0;66,0;56,0;;19,0;34,0;46,0;1,0;2,0;42,0;27,0;39,0;12,0;352,0;48,0;47,0;114,0;17,0;11,0;65,0;;18,0;2,0;11,0;53,0;5,0;54,0;3,0;147,0;34,0;11,0;1,0;20,0;15,0;65,0;50,0;257,0;2,0;2,0;7,0;26,0;11,0;75,0;6,0;4,0;31,0;3,0;11,0;28,0;9,0;8,0;140,0;7,0;136,0;5,0;40,0;5,0;13,0;78,0;1,0;87,0;20,0;9,0;14,0;9,0;23,0;24,0;3,0;1,0;24,0;21,0;54,0;50,0;69,0;71,0;1,0;107,0;13,0;4,0;13,0;71,0;47,0;36,0;20,0;22,0;27,0;6,0;44,0;88,0;33,0;;178,0;28,0;;5,0;33,0;5,0;52,0;64,0;2,0;;123,0;36,0;3,0;4,0;5,0;14,0;;31,0;5,0;39,0;32,0;76,0;34,0;11,0;16,0;1,0;67,0;1,0;5,0;5,0;3,0;;175,0;24,0;61,0;7,0;3,0;70,0;148,0;1,0;6,0;6,0;;;;3,0;16,0;;;2,0;6,0;9,0;13,0;20,0;7,0;;2,0;4,0;5,0;9,0;5,0;;1,0;;1,0;58,0;12,0;9,0;;2,0;15,0;;;;89,0;20,0;4,0;23,0;2,0;2,0;5,0;67,0;;23,0;34,0;198,0;;2,0;49,0;154,0;5,0;52,0;12,0;25,0;;8,0;19,0;3,0;16,0;19,0;;;;4,0;;20,0;25,0;6,0;11,0;3,0;8,0;2,0;17,0;;3,0;2,0;8,0;109,0;;3,0;;37,0;;25,0;29,0;;27,0;;1,0;2,0;1,0;2,0;4,0;;8,0;;4,0;;18,0;7,0;3,0;54,0;;48,0;1,0;13,0;21,0;15,0;3,0;1,0;;2,0;;1,0;9,0;;;;2,0;21,0;3,0;35,0;;28,0;1,0;74,0;23,0;;3,0;5,0;3,0;;;;;6,0;20,0;5,0;8,0;46,0;6,0;;4,0;8,0;38,0;3,0;3,0;6,0;13,0;;38,0;15,0;4,0;;2,0;4,0;4,0;;6,0;33,0;20,0;7,0;17,0;;19,0;2,0;56,0;51,0;79,0;41,0;171,0;1,0;7,0;19,0;;19,0;7,0;16,0;13,0;16,0;23,0;;4,0;;23,0;6,0;2,0;30,0;;;1,0;13,0;;15,0;;4,0;52,0;38,0;;1,0;2,0;24,0;;77,0;;;3,0;;3,0;4,0;4,0;;;4,0;1,0;19,0;6,0;5,0;;2,0;11,0;;;;;15,0;25,0;2,0;11,0;11,0;1,0;6,0;1,0;;9,0;;18,0;;;;14,0;;1,0;2,0;1,0;2,0;21,0;2,0;;;19,0;47,0;2,0;17,0;13,0;1,0;13,0;20,0;25,0;1,0;7,0;4,0;12,0;14,0;64,0;;5,0;19,0;7,0;1,0;15,0;156,0;33,0;14,0;46,0;2,0;3,0;21,0;2,0;;9,0;7,0;24,0;8,0;11,0;20,0;29,0;10,0;5,0;1,0;41,0;4,0;1,0;1,0;9,0;32,0;7,0;2,0;3,0;8,0;4,0;;10,0;;4,0;10,0;1,0;19,0;9,0;2,0;21,0;2,0;2,0;5,0;8,0;;65,0;3,0;16,0;;1,0;;14,0;22,0;45,0;5,0;12,0;2,0;69,0;11,0;3,0;3,0;15,0;;;4,0;1,0;17,0;2,0;15,0;38,0;2,0;9,0;;1,0;1,0;18,0;;10,0;;;10,0;;4,0;2,0;;5,0;;2,0;1,0;6,0;17,0;1,0;;;;;;2,0;;;1,0;;1,0;9,0;2,0;;;4,0;;1,0;7,0;2,0;;;;;2,0;1,0;6,0;;;5,0;;;;20,0;;;;3,0;1,0;37,0;4,0;1,0;3,0;14,0;1,0;1,0;14,0;7,0;;6,0;6,0;3,0;;;9,0;;;2,0;;;2,0;;2,0;;6,0;;;;1,0;;;;;;13,0;2,0;4,0;8,0;;9,0;;;1,0;4,0;1,0;;;2,0;;;;;;1,0;;;13,0;31,0;;3,0;1,0;;;4,0;2,0;8,0;;;;3,0;;4,0;5,0;;2,0;11,0;;4,0;1,0;3,0;6,0;;;;9,0;;1,0;1,0;;;2,0;;80,0;1,0;1,0;;;2,0;;1,0;2,0;;8,0;3,0;2,0;8,0;1,0;15,0;27,0;9,0;;;4,0;20,0;2,0;5,0;6,0;3,0;;11,0;1,0;;4,0;12,0;11,0;;17,0;;7,0;;;1,0;6,0;;;3,0;;7,0;;;;3,0;6,0;;4,0;8,0;1,0;;1,0;3,0;1,0;;2,0;7,0;3,0;13,0;5,0;1,0;;1,0;54,0;;2,0;7,0;;;;;2,0;;;1,0;;14,0;2,0;;;;6,0;;;6,0;;9,0;;;4,0;;1,0;;;;;7,0;;;;;;
bottom;;4,0;;;;7,0;28,0;19,0;11,0;21,0;4,0;;;;18,0;112,0;4,0;;;;;27,0;;2,0;1,0;;;;;;;;25,0;;4,0;;;;1,0;;1,0;;95,0;;5,0;;1,0;60,0;5,0;16,0;55,0;27,0;;1,0;7,0;48,0;20,0;1,0;3,0;;142,0;3,0;36,0;;10,0;;6,0;141,0;50,0;76,0;2,0;;2,0;;;2,0;;;;105,0;;9,0;;113,0;1,0;;;;7,0;10,0;145,0;;;8,0;;;;;26,0;5,0;;;85,0;16,0;;;35,0;7,0;2,0;;24,0;;4,0;;1,0;72,0;304,0;74,0;6,0;2,0;3,0;3,0;1,0;1,0;;;;;;1,0;;4,0;12,0;3,0;;;6,0;1,0;;;6,0;3,0;;75,0;1,0;;;315,0;1,0;3,0;;2,0;;;;;20,0;;9,0;4,0;;;68,0;;;;19,0;15,0;;;1,0;;20,0;18,0;1,0;5,0;30,0;59,0;6,0;;34,0;75,0;14,0;56,0;;41,0;1,0;35,0;4,0;;;;28,0;83,0;4,0;55,0;;;5,0;44,0;9,0;;;28,0;;16,0;2,0;;;115,0;16,0;12,0;10,0;2,0;8,0;;58,0;4,0;9,0;58,0;165,0;;70,0;4,0;;;30,0;;15,0;5,0;178,0;13,0;6,0;100,0;17,0;5,0;;81,0;46,0;51,0;2,0;18,0;2,0;2,0;;3,0;1,0;;9,0;32,0;296,0;;12,0;;;;93,0;;1,0;;2,0;;39,0;;8,0;;29,0;35,0;1,0;;9,0;;56,0;6,0;;25,0;1,0;31,0;56,0;1008,0;9,0;;5,0;2,0;;;;2,0;;2,0;;8,0;3,0;1,0;316,0;;;;8,0;1,0;10,0;1,0;67,0;1,0;9,0;5,0;1,0;14,0;;;;40,0;7,0;;15,0;9,0;;18,0;;31,0;10,0;;2,0;16,0;5,0;1,0;7,0;20,0;;2,0;2,0;3,0;9,0;3,0;4,0;;6,0;48,0;5,0;55,0;20,0;9,0;10,0;6,0;1,0;2,0;9,0;6,0;50,0;1,0;6,0;18,0;;3,0;4,0;6,0;6,0;9,0;3,0;1,0;1,0;5,0;;24,0;49,0;1,0;3,0;27,0;53,0;;;;2,0;;;3,0;10,0;2,0;12,0;1,0;2,0;;;3,0;4,0;;84,0;7,0;6,0;63,0;4,0;;;5,0;6,0;1,0;1,0;15,0;2,0;1,0;;;;11,0;;;1,0;;;;;20,0;;;3,0;1,0;1,0;;6,0;;;;2,0;1,0;;;;4,0;;;;;;3,0;11,0;;1,0;;;;;1,0;16,0;;;1,0;;;6,0;;;;;;;;;;;;;;;;;2,0;;;8,0;;;;;;2,0;;1,0;;;;3,0;16,0;;13,0;;4,0;2,0;;3,0;;;;;;;2,0;;;10,0;1,0;2,0;1,0;;;;;4,0;;;;;2,0;;;;;;;2,0;;;1,0;12,0;;;;;1,0;;12,0;;;2,0;9,0;;;1,0;;;1,0;;5,0;;2,0;2,0;;;;;;;;;;;;;5,0;22,0;;;3,0;3,0;;29,0;;3,0;4,0;;1,0;1,0;;1,0;24,0;;;2,0;7,0;;;;;;;3,0;;;;;;;;;3,0;3,0;;;;49,0;;31,0;;;;;;;3,0;;;;;2,0;;;;;;;;;;;;;;28,0;;;4,0;;;;1,0;;;1,0;13,0;;;;;2,0;;;1,0;;13,0;;7,0;;;;7,0;;17,0;2,0;1,0;3,0;;3,0;;;5,0;1,0;5,0;2,0;;;8,0;1,0;;;;;;;5,0;12,0;10,0;2,0;3,0;1,0;7,0;4,0;13,0;;;8,0;2,0;;1,0;4,0;;;1,0;2,0;;3,0;;;;12,0;;3,0;1,0;1,0;;;12,0;5,0;;2,0;60,0;;1,0;;;6,0;1,0;1,0;7,0;5,0;;5,0;13,0;29,0;;;14,0;;;2,0;1,0;;;;18,0;;;;12,0;;2,0;3,0;10,0;1,0;;;;;;;5,0;7,0;;;1,0;;;12,0;;;;;;;3,0;;;;11,0;;;;;;2,0;;1,0;;;;;3,0;1,0;;;;1,0;;;;;;;;;3,0;;1,0;;;;;;1,0;2,0;;;;;;;;;;;;;;;;;;;8,0;;;;;1,0;;;1,0;1,0;1,0;;;;;;;;;;2,0;;;2,0;;;;;;;;;;;;;36,0;;;;;;;3,0;;;;;1,0;;;2,0;;;2,0;;3,0;;;;;;;;;;;;;;;;;;;;1,0;;;;4,0;2,0;;;;;5,0;5,0;;;;;;;;;;5,0;;;1,0;;;;;;;;2,0;;;4,0;;;;;;;;2,0;;;;17,0;;;;3,0;4,0;6,0;1,0;;;1,0;;;1,0;;;;;;1,0;1,0;;;;;;;;1,0;2,0;;;;;;;;;;;;;;;9,0;;;;2,0;;
bracket;;2,0;;;;9,0;2,0;14,0;4,0;7,0;;;4,0;;38,0;17,0;37,0;;;;;1,0;;1,0;2,0;;;1,0;1,0;;;;17,0;;1,0;2,0;;;;;;;13,0;;3,0;;;29,0;2,0;7,0;19,0;8,0;;;;4,0;15,0;;;;39,0;7,0;;;33,0;;1,0;27,0;13,0;22,0;;;;;;;;;;6,0;;2,0;;57,0;;;;;7,0;;25,0;;;6,0;;;1,0;;2,0;16,0;;;36,0;1,0;;;16,0;1,0;;;10,0;5,0;2,0;;;27,0;73,0;74,0;;;5,0;;;;;;;;;4,0;;2,0;13,0;1,0;;;1,0;;;;;5,0;;21,0;4,0;;;32,0;;2,0;;;1,0;;;;124,0;;4,0;;;;8,0;;1,0;;1,0;;;;;;2,0;1,0;;;39,0;2,0;;;1,0;7,0;1,0;;;;1,0;26,0;;;;;;56,0;;4,0;;;;8,0;2,0;5,0;;13,0;;15,0;;1,0;11,0;4,0;;1,0;7,0;;;;8,0;;;41,0;72,0;;2,0;;;1,0;;2,0;1,0;;36,0;22,0;;275,0;3,0;7,0;7,0;15,0;3,0;7,0;;8,0;;;;;;;;18,0;23,0;;17,0;1,0;5,0;;20,0;;4,0;;5,0;;27,0;7,0;;;37,0;1,0;;;3,0;1,0;8,0;;;9,0;;34,0;4,0;34,0;;;15,0;;;;;10,0;;5,0;26,0;9,0;;;7,0;;;4,0;1,0;;5,0;3,0;75,0;3,0;6,0;;6,0;5,0;22,0;;;36,0;;;;;;20,0;;53,0;;;;20,0;4,0;2,0;9,0;;;;11,0;22,0;4,0;;;;;13,0;4,0;7,0;4,0;3,0;6,0;3,0;8,0;;1,0;2,0;19,0;;;25,0;;;;5,0;1,0;1,0;6,0;;;6,0;;2,0;3,0;7,0;;11,0;8,0;1,0;;7,0;7,0;;2,0;3,0;;;20,0;16,0;16,0;3,0;1,0;28,0;;;;;;156,0;5,0;4,0;;;3,0;;10,0;;3,0;;;;1,0;18,0;1,0;;;7,0;;;;;;;4,0;;;;;;;;;;1,0;;;6,0;;;;;;2,0;;;;;;;2,0;5,0;2,0;;;;2,0;;2,0;;;;;;;;;;;;;;;1,0;4,0;9,0;;;;;;;;;;;;;;;10,0;13,0;;1,0;;;;;;;2,0;;;;;3,0;3,0;;6,0;;11,0;;;;;;;;;;;17,0;9,0;;;;;;;;;;;3,0;;;;;;;;;5,0;8,0;;7,0;;;;;;2,0;;;;;;;17,0;;;6,0;;;;;;;;;;1,0;;;;;1,0;;;;;;;1,0;;1,0;;;;;;1,0;;;2,0;;;;74,0;;;;;2,0;4,0;7,0;;1,0;2,0;;6,0;;;;;;;5,0;;;4,0;1,0;2,0;;;;;;;;;;2,0;;;;;;;;;4,0;;2,0;;;;7,0;;;;;;;;;1,0;2,0;;;;;;5,0;9,0;29,0;;;5,0;;16,0;;;1,0;;1,0;;9,0;;;2,0;3,0;;;;;;;;8,0;6,0;;;66,0;4,0;10,0;;;8,0;;;;5,0;;;6,0;6,0;;;3,0;;;1,0;;15,0;1,0;3,0;;;6,0;;;;28,0;2,0;;;3,0;;;;7,0;6,0;;;;2,0;;;;;;;;;;;;;10,0;;;;;;;;;;;4,0;;;3,0;;;1,0;;1,0;;;;;;;;;;;;;;;;;;;;;;;;;;;;;;;;;;;;;;;;5,0;;;4,0;1,0;;;;;;;;;;;;;;;;;;;;;;;;;;;;;;;;;;36,0;;;;;;;;;;;;;;;;;;;;;;;1,0;;;;;;;;;;2,0;;;;;;1,0;;;;;;;;;;;;5,0;;;1,0;;;;;;;;;;;;1,0;;;;;4,0;;1,0;;;3,0;3,0;;;;;;;;;;;;;;;;;;;;;;1,0;;5,0;;;;;;;;;;;;1,0;;;;;;;3,0;;;;;;;;;;;;;;;;8,0;3,0;;;;;4,0;;;;;;;;;;;;;;;;;;;;;
button;;5,0;;6,0;;6,0;10,0;24,0;6,0;2,0;1,0;;6,0;;9,0;19,0;;1,0;;1,0;;63,0;1,0;;;;;;;;1,0;2,0;26,0;;49,0;19,0;2,0;;;;18,0;;;;25,0;11,0;6,0;41,0;33,0;55,0;9,0;1,0;;;1,0;4,0;10,0;1,0;2,0;;3,0;2,0;;;;1,0;6,0;6,0;4,0;2,0;13,0;;14,0;2,0;;3,0;;;2,0;61,0;1,0;10,0;2,0;45,0;;36,0;2,0;;;;4,0;;1,0;;;;1,0;;25,0;6,0;;;16,0;7,0;;2,0;;1,0;6,0;;3,0;12,0;1,0;1,0;2,0;;38,0;39,0;1,0;16,0;2,0;;10,0;10,0;4,0;5,0;;;;4,0;;;;;1,0;;;21,0;;;2,0;;;12,0;8,0;;;28,0;25,0;1,0;1,0;;8,0;6,0;2,0;;36,0;;;2,0;;6,0;45,0;;;;13,0;16,0;;;9,0;;;2,0;1,0;;50,0;;;;5,0;17,0;;;;1,0;;2,0;;;2,0;;;10,0;;13,0;;;;1,0;1,0;;;11,0;;;1,0;;4,0;7,0;;;;;;;;;;;36,0;2,0;3,0;;;17,0;;1,0;9,0;;28,0;2,0;105,0;103,0;;2,0;9,0;3,0;4,0;23,0;;13,0;1,0;;;;;4,0;1,0;;6,0;;;66,0;;;13,0;;;;;;7,0;22,0;;;;;215,0;;5,0;2,0;2,0;;;;5,0;9,0;;15,0;14,0;;2,0;;;9,0;;37,0;;;8,0;;;;;;;8,0;3,0;;13,0;3,0;6,0;;;;2,0;2,0;;;;8,0;;;;1,0;1,0;1,0;;18,0;;3,0;;;;;1,0;;;;4,0;1,0;;;;;;;6,0;3,0;;1,0;;;6,0;1,0;10,0;;;15,0;;2,0;;;;4,0;;3,0;7,0;2,0;;;;5,0;;3,0;;1,0;;;;88,0;;3,0;;;;;1,0;;;;;9,0;;;1,0;;;8,0;1,0;1,0;;3,0;;;;;1,0;;;;2,0;2,0;;;;;;2,0;2,0;;;;;;;;1,0;;;1,0;;;2,0;;;4,0;;;;38,0;3,0;;;;;;30,0;;4,0;;5,0;1,0;2,0;21,0;69,0;;;3,0;;;;2,0;1,0;10,0;2,0;;;;;4,0;5,0;;;;3,0;;1,0;;;;27,0;;68,0;2,0;;;;;7,0;6,0;;1,0;;1,0;4,0;;1,0;;;;;2,0;;2,0;1,0;;23,0;2,0;1,0;1,0;6,0;1,0;5,0;;3,0;;;;;17,0;;;;;;;;;;33,0;;3,0;;;;2,0;;1,0;;;;1,0;;;1,0;;5,0;;;;3,0;;6,0;3,0;;;;4,0;;;;4,0;;;;1,0;;;;;;;7,0;6,0;3,0;;;;7,0;;;;;7,0;;;;;;7,0;;;4,0;;;4,0;7,0;4,0;;2,0;1,0;1,0;7,0;;;;11,0;;14,0;;;;;;2,0;;;2,0;1,0;3,0;;;;;;;;;;;;;;9,0;1,0;2,0;2,0;;1,0;;;;;;;5,0;;;;;;;;;;;3,0;;;1,0;;;1,0;1,0;;;4,0;;2,0;;;5,0;;;;1,0;;1,0;;2,0;;;;;;;2,0;;;4,0;13,0;;4,0;1,0;14,0;;7,0;;;;;;;;;;;;13,0;;3,0;;;;1,0;9,0;;;;;2,0;5,0;;;;;;;;;;;;;;;;;;;;;3,0;;17,0;8,0;4,0;2,0;;;;;;4,0;;;;;;;;;;1,0;;;1,0;;;;;;;;;;;2,0;;;;;;;;;;;;3,0;;;1,0;;;;;5,0;5,0;;;2,0;;;;;;3,0;;;;;;;;;;;;;;;;;;;;;;;13,0;;;;2,0;;;;;;;;;;;;;5,0;;;;;;;10,0;1,0;;;;;;;1,0;;3,0;;;;4,0;;;;;;;;;;;;;;1,0;;1,0;;;;;;;;2,0;;;;1,0;;;;14,0;;;;;;;1,0;;4,0;7,0;;1,0;2,0;;;;11,0;;;;;;;1,0;;;;;;;;;;;;;;;;;;;;;;;;;;;;;;;;;;;;;;;;;;;;3,0;;;;1,0;;2,0;;;;;;;;;;;;;;2,0;;;;;;;;;;;;;1,0;;;;;4,0;
case;;9,0;;1,0;;4,0;3,0;48,0;30,0;13,0;;;1,0;;13,0;46,0;;;1,0;;1,0;16,0;;;;;65,0;;;;;1,0;34,0;8,0;78,0;12,0;;7,0;2,0;1,0;7,0;11,0;11,0;4,0;30,0;15,0;48,0;132,0;13,0;14,0;25,0;9,0;;1,0;43,0;134,0;27,0;3,0;11,0;;23,0;7,0;4,0;1,0;3,0;4,0;24,0;84,0;20,0;77,0;6,0;3,0;9,0;;;17,0;;1,0;22,0;99,0;2,0;42,0;;72,0;6,0;;3,0;;9,0;11,0;122,0;;;12,0;1,0;;2,0;;30,0;67,0;3,0;;71,0;37,0;;2,0;74,0;2,0;12,0;3,0;7,0;10,0;3,0;;;60,0;196,0;82,0;14,0;29,0;2,0;4,0;2,0;5,0;3,0;;;1,0;;8,0;;10,0;13,0;7,0;;4,0;1,0;;;2,0;;;1,0;53,0;2,0;1,0;1,0;132,0;62,0;7,0;6,0;;1,0;1,0;40,0;16,0;35,0;;5,0;3,0;;3,0;104,0;5,0;;;11,0;6,0;11,0;2,0;4,0;;3,0;4,0;13,0;3,0;19,0;68,0;;;16,0;31,0;2,0;1,0;15,0;17,0;;17,0;1,0;;4,0;22,0;;41,0;2,0;27,0;;6,0;2,0;61,0;24,0;3,0;12,0;37,0;;7,0;;;18,0;60,0;;5,0;4,0;;1,0;;12,0;7,0;;47,0;108,0;8,0;43,0;9,0;;53,0;21,0;;53,0;;111,0;4,0;13,0;77,0;3,0;22,0;7,0;189,0;11,0;38,0;4,0;17,0;;25,0;15,0;;;;10,0;18,0;15,0;;2,0;6,0;6,0;1,0;18,0;1,0;1,0;1,0;1,0;8,0;15,0;18,0;;;26,0;59,0;51,0;;12,0;;13,0;;;9,0;2,0;4,0;23,0;170,0;5,0;;16,0;32,0;1,0;28,0;;8,0;;2,0;18,0;;6,0;;23,0;;1,0;9,0;1,0;2,0;15,0;5,0;19,0;2,0;3,0;3,0;5,0;9,0;40,0;;;;;3,0;62,0;3,0;;23,0;;33,0;1,0;;3,0;8,0;20,0;;18,0;13,0;;4,0;1,0;15,0;1,0;;;6,0;;6,0;22,0;6,0;41,0;2,0;19,0;10,0;6,0;;14,0;5,0;3,0;6,0;;21,0;;9,0;;3,0;;5,0;12,0;;1,0;5,0;18,0;11,0;11,0;;4,0;57,0;5,0;2,0;7,0;2,0;;;3,0;10,0;16,0;6,0;20,0;16,0;;16,0;;19,0;3,0;;2,0;6,0;13,0;37,0;;28,0;;;4,0;12,0;;11,0;8,0;1,0;;;12,0;6,0;;;;;;9,0;15,0;5,0;4,0;;;;;2,0;;;;;4,0;5,0;;;;7,0;;;1,0;1,0;6,0;2,0;7,0;;;;33,0;;3,0;9,0;5,0;;;5,0;15,0;1,0;13,0;1,0;;;;4,0;46,0;4,0;1,0;;;;3,0;;;;;1,0;2,0;;12,0;1,0;;;6,0;2,0;3,0;;;;;1,0;8,0;2,0;1,0;3,0;;;1,0;;;2,0;1,0;;2,0;1,0;1,0;4,0;2,0;1,0;;;11,0;;3,0;28,0;11,0;;3,0;;1,0;6,0;3,0;11,0;;;;;;;;;2,0;3,0;;2,0;1,0;;6,0;8,0;;;3,0;;23,0;9,0;1,0;1,0;15,0;;;14,0;2,0;7,0;;;;;3,0;2,0;;3,0;;;1,0;;2,0;2,0;;11,0;36,0;8,0;;34,0;;2,0;1,0;4,0;;4,0;;1,0;;1,0;1,0;18,0;2,0;;14,0;1,0;;;1,0;2,0;;;36,0;1,0;;;2,0;;;9,0;;49,0;10,0;;2,0;2,0;10,0;;4,0;;;1,0;;1,0;;1,0;;;;1,0;;4,0;2,0;;5,0;;;;;;;;;;12,0;;13,0;1,0;;1,0;;1,0;1,0;1,0;;8,0;;;;2,0;3,0;;1,0;;;;;;2,0;;;13,0;6,0;;;7,0;;;3,0;;;;25,0;14,0;;5,0;1,0;8,0;1,0;1,0;5,0;;;;;;4,0;;1,0;;7,0;4,0;1,0;7,0;;;4,0;;;;;;;;;;3,0;;;;;2,0;3,0;;;30,0;4,0;1,0;;3,0;;64,0;;1,0;5,0;;10,0;;2,0;;;;1,0;3,0;;;1,0;3,0;22,0;2,0;;2,0;8,0;;;13,0;;3,0;;1,0;;;;;;2,0;;5,0;;;;2,0;;;;;;;;;;4,0;1,0;;;;;;;;21,0;1,0;;;;;;2,0;;1,0;;;1,0;;;;2,0;;;;;2,0;;;1,0;;2,0;;;2,0;;5,0;;;;;;;4,0;1,0;;1,0;;;;;;;;;1,0;;;;;;;;;;;5,0;1,0;;1,0;;;;;;;;1,0;;3,0;2,0;1,0;;;;;;;;;;;;;;1,0;;;;;;;;;;;;;5,0;;1,0;;4,0;2,0;;1,0;;3,0;2,0;;;;;2,0;;3,0;;;;;;4,0;;;;2,0;1,0;;;;;;;;;6,0;2,0;;16,0;1,0;;8,0;;1,0;1,0;2,0;1,0;1,0;;;;2,0;;;;1,0;;2,0;;4,0;;;;;;1,0;13,0;1,0;;;;;2,0;;5,0;;16,0;;;7,0;;1,0;;;;2,0;;;;3,0;;;;;2,0;;;;1,0;;;;;;;;;;;;1,0;6,0;;;;;;;;;;;
casing;;2,0;;;;;3,0;7,0;;1,0;;;;;1,0;6,0;;;;;;10,0;;;;;;;;;;;7,0;;6,0;;;;;;1,0;;24,0;;;;;40,0;2,0;4,0;31,0;2,0;;;1,0;;2,0;;;;9,0;19,0;;;;;;15,0;;16,0;2,0;;;;;;;2,0;;18,0;3,0;1,0;;43,0;;;;;;;49,0;;;14,0;;;;;5,0;;;;16,0;2,0;;;;;3,0;;1,0;;;;;4,0;28,0;22,0;3,0;;4,0;1,0;;2,0;;;;;3,0;2,0;;;;1,0;;;1,0;;;;;1,0;;1,0;;;;6,0;5,0;;;;;2,0;1,0;1,0;7,0;;;2,0;;;59,0;;;;1,0;;2,0;;;;;7,0;;;6,0;8,0;;;2,0;4,0;;3,0;1,0;1,0;;;;;;;;11,0;;;;;;24,0;3,0;;2,0;5,0;;5,0;;;;10,0;;4,0;4,0;;;;5,0;3,0;;11,0;19,0;;9,0;;;23,0;;1,0;;;18,0;;;21,0;4,0;1,0;1,0;23,0;2,0;9,0;;9,0;1,0;6,0;;;;;;4,0;;;1,0;;;;10,0;;;;;;;;;;3,0;1,0;;1,0;;;6,0;;;5,0;;9,0;2,0;31,0;;;3,0;;;;;;;;4,0;;;;13,0;;;;1,0;;;9,0;11,0;;;4,0;;;3,0;;;;;;5,0;;4,0;;;21,0;;;1,0;4,0;4,0;;4,0;;2,0;;;7,0;;;;;2,0;4,0;;;1,0;;1,0;2,0;2,0;;;;;;;;;4,0;;;;2,0;7,0;;;2,0;5,0;4,0;;;;16,0;6,0;;;;;;;3,0;3,0;15,0;12,0;2,0;2,0;;;4,0;1,0;;;;;30,0;6,0;;;4,0;;;;5,0;3,0;;;;;1,0;;;;;;;;;;;;;;;;;;;9,0;;;;;2,0;;;;;;;3,0;;;;;;5,0;;;;;;2,0;;;;;;;;;1,0;;;1,0;;1,0;2,0;;;;;;;;4,0;;;;;2,0;;;;;3,0;;;;4,0;;;;;;;;;;;;;2,0;;;;9,0;;;;;;1,0;;;5,0;;;;;;;;;;;;;8,0;;;;;4,0;;;;;;2,0;;;;;;;;1,0;;;;;;;;;;;;3,0;;;;1,0;5,0;4,0;;;4,0;;;;2,0;4,0;;;;;;;1,0;;7,0;1,0;;;;27,0;;2,0;;;;;;;;;;45,0;19,0;;;;1,0;;17,0;;3,0;;;;;;;;;;2,0;;1,0;;;;;;;2,0;;1,0;;;;;4,0;;;2,0;;;;;;23,0;;;;;;;;;;;;;;;;6,0;;2,0;;;;12,0;;;;;;;;;;;;;;;1,0;;;2,0;;;1,0;;;4,0;;1,0;;;;;;6,0;;;;;;;3,0;;13,0;;;;5,0;;;4,0;;;;;;10,0;;;1,0;;;;;15,0;2,0;;;1,0;;;;;;;;1,0;;;;3,0;;;;;;;;2,0;;;;;;;;4,0;;;;;;;;;;;;;;;;;;;;;;13,0;;;;;;;;;;;;;;;;;;;;;;;;;;;;;;;;4,0;;;3,0;;;;;;;;;;;;;;;;;;;;;;;;;;;;;;;;;;;;;;;;;;;;;;;;;;;;;;;;;;;;;;;;;;;;;;;3,0;;;;;;;;;1,0;;;;;;;;;;;;1,0;;;1,0;;;;7,0;1,0;;;;;;;;;;;;1,0;;;;;;;;;;;;;;;;;;;;;;;;;;;;;;;;;;;;;;;;;;;;;;;;;;;;;;;;;;;;;;;;;;;;;;;;;1,0;;;;
cell;;1,0;1,0;;;4,0;2,0;20,0;14,0;38,0;68,0;;7,0;2,0;;22,0;;;;;;11,0;1,0;3,0;4,0;;47,0;;;5,0;2,0;1,0;16,0;;10,0;3,0;;;;1,0;73,0;;8,0;;26,0;12,0;9,0;46,0;10,0;3,0;13,0;12,0;2,0;75,0;1,0;;27,0;;;;;;6,0;;2,0;;3,0;54,0;;7,0;8,0;;18,0;;;53,0;2,0;1,0;1,0;85,0;3,0;15,0;;96,0;6,0;;;;;1,0;16,0;;;6,0;;;38,0;;23,0;;;;18,0;7,0;;2,0;5,0;3,0;36,0;;1,0;6,0;;;17,0;106,0;16,0;14,0;15,0;11,0;;;4,0;12,0;2,0;1,0;;;;7,0;;2,0;13,0;1,0;1,0;1,0;21,0;5,0;;;;;;77,0;;;;13,0;101,0;13,0;;;2,0;13,0;;10,0;42,0;;;8,0;1,0;4,0;96,0;;;;2,0;1,0;8,0;13,0;;;;39,0;;3,0;8,0;;;13,0;1,0;2,0;;2,0;20,0;32,0;;12,0;3,0;;2,0;;;47,0;4,0;1,0;;1,0;;4,0;;;;41,0;;;1,0;16,0;1,0;9,0;3,0;;;6,0;;69,0;;;;;5,0;3,0;;;;1,0;13,0;;49,0;;;;;3,0;;4,0;7,0;12,0;;3,0;;28,0;;;;3,0;90,0;;402,0;4,0;2,0;;;;;2,0;10,0;;;4,0;;;1,0;2,0;1,0;;5,0;3,0;;;;24,0;7,0;;;;;4,0;20,0;6,0;4,0;;;;;10,0;;;;2,0;4,0;4,0;;;4,0;;;;;;;;;;;;;2,0;3,0;;;;1,0;;5,0;5,0;15,0;6,0;;4,0;;;;;6,0;;2,0;;;3,0;;;;8,0;;5,0;;;1,0;;;;4,0;6,0;1,0;8,0;;;2,0;;;;;8,0;;4,0;;8,0;4,0;2,0;;;;;;;;3,0;3,0;;;;;;;4,0;2,0;;;;;;;;;21,0;;;;1,0;2,0;6,0;;;2,0;;;8,0;;;;;1,0;2,0;;;;;;4,0;1,0;1,0;;;1,0;4,0;5,0;;1,0;;;;11,0;;;1,0;;10,0;;;6,0;7,0;;;9,0;;;4,0;9,0;1,0;1,0;;;;2,0;;2,0;;;;;9,0;;;;3,0;1,0;;;;1,0;;;;;;;;3,0;;;3,0;;;2,0;;1,0;;9,0;1,0;;1,0;;5,0;1,0;;;;;6,0;;;;;;1,0;;;2,0;;;;133,0;;6,0;;;6,0;17,0;;;2,0;;;1,0;;;3,0;;;;18,0;;;;;;;;;;;;4,0;;;6,0;;;;;;;;2,0;6,0;4,0;;;4,0;;7,0;;;;6,0;;16,0;;;;12,0;;26,0;;;4,0;4,0;;;10,0;;;;;5,0;;;;;1,0;2,0;;;;2,0;;;;;;2,0;;6,0;;;2,0;;2,0;;8,0;;1,0;2,0;;1,0;;;;;;;;;6,0;;;3,0;;;4,0;;4,0;;1,0;;19,0;24,0;;;2,0;;;11,0;;;25,0;;;1,0;;;1,0;;1,0;;;;;1,0;;8,0;8,0;14,0;;;;4,0;4,0;;;;12,0;;81,0;;4,0;;2,0;;;5,0;;;;;;;;1,0;;;;5,0;;;;;;21,0;;;;;;3,0;1,0;;;;;;3,0;;;;;;;;;;;1,0;;2,0;;;;;4,0;;;;;;10,0;;;;;2,0;1,0;;;;;;;;;;;2,0;1,0;;;;4,0;;;;;;;;;;;3,0;2,0;1,0;8,0;3,0;6,0;;;7,0;;;2,0;10,0;;13,0;2,0;;;;5,0;7,0;;1,0;;;;;;;18,0;1,0;;;37,0;2,0;;10,0;;;;;1,0;;;;;;;;;;;;;;;;;2,0;16,0;;;;2,0;;;7,0;;;;2,0;;27,0;;20,0;;;;;;;;;;;;;;;;;;;8,0;1,0;;;;;;;;3,0;5,0;;;;;;;1,0;;;;;;;;;;;;;;1,0;;;;5,0;;;;7,0;;;;3,0;;;23,0;2,0;1,0;;;;;;;;;;;;;;1,0;;;;;2,0;2,0;;;;;;;2,0;;2,0;;;;;3,0;;;;;;;;;;;;;;;;;;;;;;;;;;;;;2,0;5,0;;;;;;4,0;;;;1,0;;;;;;;;;;;54,0;;;;;;;;4,0;;;;;;
center;;9,0;;8,0;3,0;83,0;26,0;23,0;90,0;41,0;24,0;;29,0;;136,0;61,0;15,0;6,0;;2,0;11,0;33,0;5,0;1,0;;;9,0;;;3,0;4,0;18,0;21,0;;108,0;6,0;11,0;15,0;3,0;7,0;36,0;2,0;59,0;4,0;17,0;26,0;131,0;65,0;14,0;43,0;49,0;116,0;9,0;2,0;33,0;26,0;59,0;4,0;11,0;;42,0;2,0;41,0;;32,0;8,0;22,0;44,0;55,0;24,0;30,0;1,0;18,0;;3,0;6,0;6,0;8,0;2,0;411,0;10,0;59,0;1,0;65,0;9,0;3,0;3,0;3,0;5,0;10,0;261,0;;;2,0;;2,0;1,0;;102,0;3,0;12,0;4,0;31,0;90,0;;7,0;178,0;15,0;23,0;16,0;66,0;47,0;9,0;1,0;;61,0;138,0;245,0;4,0;18,0;4,0;1,0;3,0;27,0;15,0;2,0;;;1,0;72,0;;19,0;37,0;;19,0;2,0;16,0;9,0;6,0;13,0;29,0;;;69,0;34,0;3,0;;41,0;30,0;11,0;4,0;;1,0;8,0;4,0;;103,0;5,0;10,0;12,0;3,0;;245,0;1,0;;;9,0;49,0;;9,0;46,0;;1,0;7,0;16,0;6,0;23,0;8,0;6,0;;12,0;27,0;;14,0;;7,0;;8,0;;;2,0;1,0;2,0;27,0;2,0;18,0;;3,0;2,0;14,0;6,0;1,0;1,0;116,0;2,0;9,0;;3,0;4,0;65,0;;3,0;3,0;2,0;3,0;;6,0;;30,0;60,0;11,0;5,0;12,0;9,0;8,0;55,0;2,0;2,0;73,0;;44,0;4,0;20,0;183,0;13,0;14,0;21,0;35,0;16,0;17,0;17,0;14,0;2,0;12,0;;1,0;6,0;2,0;131,0;46,0;40,0;;41,0;5,0;;;36,0;5,0;4,0;;;;25,0;16,0;;;14,0;2,0;15,0;;3,0;15,0;25,0;;;17,0;17,0;;3,0;47,0;8,0;;90,0;35,0;;4,0;3,0;1,0;1,0;;23,0;34,0;34,0;;14,0;;3,0;;7,0;;3,0;6,0;35,0;3,0;1,0;2,0;18,0;3,0;13,0;4,0;;3,0;1,0;19,0;15,0;7,0;1,0;70,0;22,0;18,0;3,0;;17,0;6,0;21,0;;12,0;1,0;3,0;6,0;;1,0;1,0;;;2,0;3,0;12,0;3,0;9,0;3,0;9,0;5,0;;7,0;6,0;9,0;1,0;12,0;5,0;11,0;35,0;13,0;;4,0;3,0;18,0;278,0;4,0;36,0;;2,0;;7,0;25,0;2,0;;6,0;2,0;1,0;12,0;1,0;;;;;6,0;6,0;40,0;47,0;1,0;3,0;9,0;26,0;;14,0;4,0;1,0;;13,0;6,0;48,0;5,0;1,0;7,0;;7,0;4,0;35,0;4,0;;1,0;;3,0;1,0;;;5,0;4,0;52,0;14,0;15,0;;;2,0;;;;2,0;;;5,0;1,0;11,0;;;;9,0;2,0;;1,0;17,0;;6,0;31,0;2,0;17,0;14,0;42,0;6,0;2,0;13,0;28,0;;1,0;;33,0;5,0;7,0;1,0;7,0;11,0;;8,0;5,0;1,0;;2,0;2,0;;3,0;;;;;1,0;;2,0;10,0;4,0;1,0;;;;11,0;2,0;25,0;;3,0;;7,0;27,0;;;139,0;7,0;4,0;4,0;;4,0;;;2,0;;1,0;1,0;;20,0;3,0;6,0;20,0;;;27,0;13,0;2,0;15,0;;1,0;;4,0;9,0;5,0;4,0;;;2,0;;3,0;;1,0;3,0;19,0;22,0;1,0;1,0;;5,0;;;;1,0;1,0;3,0;;;5,0;;;6,0;15,0;20,0;;3,0;;2,0;3,0;2,0;;1,0;;;;;;5,0;;;1,0;1,0;3,0;3,0;5,0;;20,0;7,0;5,0;5,0;;49,0;1,0;;4,0;;5,0;6,0;1,0;;;;;3,0;;8,0;15,0;17,0;;;13,0;;;;;2,0;1,0;;;;19,0;1,0;57,0;;;1,0;1,0;18,0;;6,0;;;9,0;;;;2,0;;;;;5,0;;;;;;;79,0;;;11,0;1,0;4,0;;4,0;3,0;16,0;1,0;11,0;;5,0;7,0;;6,0;;;;;11,0;27,0;;;;;;5,0;3,0;;1,0;4,0;4,0;3,0;;6,0;;1,0;10,0;;5,0;;4,0;1,0;2,0;;;;1,0;1,0;2,0;3,0;;3,0;4,0;14,0;3,0;4,0;13,0;;20,0;;;;3,0;;;;2,0;2,0;6,0;1,0;3,0;;2,0;;2,0;1,0;9,0;5,0;3,0;;2,0;;;;5,0;;1,0;;2,0;8,0;1,0;;;1,0;1,0;;18,0;;4,0;6,0;2,0;;;;;8,0;;;5,0;;6,0;2,0;;4,0;5,0;3,0;;;1,0;;4,0;;;;;;;;;;;;;;;1,0;;;2,0;;;1,0;;1,0;4,0;1,0;;;17,0;4,0;13,0;6,0;1,0;;;1,0;2,0;;;;3,0;;;;1,0;17,0;;2,0;;;5,0;6,0;62,0;4,0;9,0;;;;;6,0;2,0;2,0;4,0;;;11,0;2,0;2,0;;;1,0;12,0;;3,0;;;2,0;2,0;;;;;1,0;3,0;;25,0;;;3,0;;4,0;;1,0;2,0;1,0;;;;4,0;;;2,0;;;1,0;5,0;;1,0;1,0;31,0;;;5,0;;;1,0;31,0;;;;22,0;3,0;;1,0;;1,0;;2,0;;;;2,0;;;;11,0;;;1,0;;7,0;;1,0;;;;3,0;2,0;;8,0;;1,0;;7,0;;3,0;1,0;2,0;53,0;2,0;9,0;82,0;;;;;;20,0;2,0;12,0;10,0;1,0;4,0;2,0;1,0;4,0;;;;;8,0;1,0;2,0;5,0;2,0;3,0;8,0;4,0;7,0;;3,0;1,0;14,0;;;;;;;;10,0;;;5,0;11,0;;;3,0;1,0;1,0;4,0;;1,0;1,0;;3,0;;;;1,0;15,0;;;14,0;8,0;6,0;;3,0;6,0;12,0;8,0;;;1,0;8,0;;10,0;;;2,0;;;3,0;;1,0;7,0;;1,0;;;
change;;3,0;62,0;2,0;13,0;107,0;38,0;71,0;131,0;6,0;3,0;;17,0;3,0;55,0;181,0;3,0;5,0;88,0;;17,0;111,0;70,0;1,0;3,0;10,0;78,0;5,0;;11,0;16,0;85,0;180,0;20,0;270,0;32,0;5,0;57,0;5,0;3,0;120,0;8,0;2,0;39,0;276,0;118,0;274,0;243,0;9,0;167,0;6,0;103,0;27,0;6,0;74,0;6,0;64,0;11,0;38,0;1,0;1,0;1,0;42,0;1,0;;67,0;117,0;26,0;91,0;6,0;38,0;3,0;126,0;13,0;;12,0;22,0;1,0;70,0;555,0;11,0;55,0;;112,0;74,0;89,0;4,0;2,0;1,0;49,0;253,0;;;2,0;20,0;17,0;7,0;2,0;148,0;7,0;7,0;11,0;38,0;105,0;4,0;30,0;91,0;14,0;78,0;76,0;2,0;99,0;1,0;6,0;2,0;67,0;78,0;336,0;195,0;73,0;3,0;1,0;32,0;82,0;33,0;25,0;8,0;9,0;1,0;105,0;1,0;40,0;59,0;1,0;15,0;53,0;7,0;105,0;5,0;43,0;267,0;;7,0;81,0;121,0;6,0;;14,0;237,0;63,0;26,0;;10,0;9,0;51,0;8,0;99,0;;32,0;16,0;6,0;68,0;570,0;10,0;21,0;;53,0;53,0;2,0;;104,0;;;14,0;374,0;13,0;3,0;4,0;;;;20,0;;;5,0;26,0;1,0;26,0;1,0;;4,0;2,0;;1,0;1,0;12,0;2,0;1,0;6,0;5,0;4,0;;23,0;130,0;9,0;;7,0;8,0;95,0;12,0;1,0;2,0;22,0;15,0;1,0;;2,0;4,0;6,0;2,0;13,0;5,0;1,0;2,0;2,0;;3,0;;165,0;2,0;56,0;;5,0;7,0;18,0;21,0;44,0;2,0;5,0;1,0;3,0;1,0;1,0;12,0;49,0;;;3,0;102,0;20,0;;12,0;;;2,0;26,0;41,0;6,0;;5,0;;;;39,0;2,0;;12,0;1,0;35,0;;1,0;25,0;21,0;;;;24,0;;2,0;27,0;20,0;8,0;13,0;3,0;;126,0;2,0;4,0;;;30,0;5,0;12,0;;;;2,0;;;;14,0;12,0;1,0;;;;;3,0;;4,0;3,0;15,0;;;17,0;2,0;;8,0;;1,0;;;3,0;;35,0;;;1,0;5,0;1,0;;;;2,0;;33,0;5,0;3,0;;1,0;;;3,0;11,0;5,0;1,0;2,0;10,0;12,0;23,0;1,0;1,0;4,0;18,0;;6,0;4,0;82,0;10,0;2,0;3,0;1,0;;1,0;;;3,0;4,0;;;3,0;;;22,0;4,0;;5,0;;3,0;42,0;1,0;;;;;14,0;;;12,0;5,0;;32,0;5,0;;;25,0;3,0;14,0;;1,0;17,0;3,0;6,0;17,0;;1,0;5,0;19,0;12,0;101,0;;45,0;26,0;;24,0;16,0;1,0;11,0;12,0;2,0;1,0;4,0;28,0;24,0;1,0;3,0;19,0;21,0;6,0;6,0;;60,0;93,0;2,0;21,0;20,0;1,0;26,0;217,0;;33,0;64,0;37,0;1,0;9,0;22,0;112,0;8,0;64,0;55,0;18,0;35,0;;18,0;137,0;71,0;44,0;1,0;;4,0;34,0;;7,0;30,0;1,0;1,0;17,0;2,0;38,0;25,0;3,0;2,0;11,0;8,0;91,0;2,0;25,0;10,0;33,0;3,0;28,0;;4,0;14,0;20,0;1,0;5,0;;2,0;;;11,0;19,0;20,0;14,0;2,0;;6,0;32,0;4,0;16,0;;;37,0;18,0;8,0;3,0;;24,0;1,0;19,0;36,0;12,0;5,0;;;;;6,0;5,0;6,0;3,0;1,0;15,0;2,0;5,0;2,0;;;;;26,0;16,0;4,0;18,0;;49,0;9,0;11,0;11,0;;7,0;3,0;2,0;6,0;8,0;21,0;7,0;;13,0;;;11,0;9,0;21,0;2,0;3,0;;;2,0;;4,0;1,0;5,0;;15,0;9,0;35,0;2,0;8,0;6,0;;1,0;;;7,0;1,0;1,0;;4,0;17,0;;2,0;;2,0;33,0;1,0;3,0;1,0;5,0;2,0;;11,0;;;2,0;;2,0;1,0;;2,0;;6,0;16,0;2,0;1,0;60,0;;;19,0;8,0;8,0;2,0;;13,0;1,0;;1,0;2,0;;4,0;;1,0;13,0;3,0;;51,0;1,0;;6,0;41,0;1,0;2,0;;;;2,0;;;;5,0;;;;;14,0;1,0;;34,0;;;6,0;4,0;;4,0;;1,0;;;1,0;7,0;16,0;4,0;5,0;15,0;;4,0;3,0;;38,0;8,0;;15,0;;;;;;;2,0;1,0;1,0;12,0;4,0;;4,0;13,0;;3,0;8,0;1,0;1,0;;;4,0;;;12,0;;2,0;;;1,0;9,0;;5,0;4,0;18,0;;;;;;2,0;;;;1,0;;;5,0;;11,0;;1,0;5,0;1,0;3,0;20,0;11,0;3,0;3,0;3,0;;9,0;1,0;;5,0;2,0;;7,0;2,0;2,0;2,0;;;;;;1,0;;;;;;5,0;3,0;;2,0;4,0;7,0;2,0;;3,0;3,0;17,0;;3,0;;4,0;2,0;5,0;8,0;15,0;;2,0;2,0;;9,0;8,0;3,0;12,0;;4,0;1,0;4,0;10,0;;60,0;7,0;2,0;5,0;;2,0;10,0;;2,0;;3,0;4,0;6,0;18,0;3,0;11,0;4,0;4,0;4,0;6,0;22,0;2,0;158,0;3,0;;15,0;3,0;2,0;;3,0;2,0;;;16,0;3,0;5,0;20,0;1,0;;;13,0;;;9,0;1,0;14,0;9,0;;1,0;1,0;;8,0;;5,0;2,0;8,0;1,0;11,0;4,0;;;11,0;;6,0;3,0;;3,0;2,0;3,0;3,0;4,0;;;;;4,0;6,0;5,0;;;;8,0;;9,0;8,0;;;;5,0;;;1,0;1,0;;12,0;;1,0;14,0;;4,0;;;2,0;3,0;1,0;;1,0;;6,0;;79,0;3,0;1,0;;4,0;3,0;2,0;;;2,0;;;;;;;;4,0;10,0;;4,0;10,0;;;5,0;6,0;;;;15,0;1,0;;3,0;5,0;2,0;9,0;;1,0;14,0;1,0;;8,0;;12,0;4,0;;5,0;;;;5,0;1,0;;2,0;2,0;;;;;;;;12,0;2,0;;2,0;11,0;;2,0;2,0;;2,0;1,0;2,0;;;;3,0;5,0;3,0;;6,0;11,0;16,0;;4,0;;;;8,0;;;;1,0;;;1,0;;;;4,0;
charge;;3,0;;;2,0;;;26,0;72,0;7,0;6,0;;;;;57,0;3,0;;;;9,0;4,0;;100,0;;;18,0;2,0;;;4,0;;134,0;;184,0;9,0;2,0;;4,0;;20,0;;8,0;;44,0;10,0;5,0;145,0;25,0;6,0;15,0;33,0;;8,0;167,0;;51,0;;2,0;;2,0;15,0;12,0;;7,0;;13,0;47,0;;4,0;49,0;;233,0;16,0;;2,0;;;;173,0;3,0;70,0;;62,0;;;;;;;3,0;;1,0;;1,0;3,0;3,0;;36,0;;;;20,0;3,0;;35,0;24,0;3,0;90,0;;4,0;123,0;;;2,0;59,0;56,0;43,0;31,0;9,0;7,0;;3,0;40,0;;;3,0;3,0;6,0;1,0;;17,0;;9,0;;2,0;17,0;24,0;;;1,0;1,0;;51,0;10,0;;;;687,0;;1,0;;34,0;86,0;1,0;21,0;22,0;;;370,0;;9,0;350,0;;;;4,0;3,0;7,0;6,0;;1,0;;1,0;67,0;9,0;;;9,0;9,0;;;;;;105,0;;;;;;;;27,0;;105,0;;;2,0;1,0;;1,0;20,0;74,0;;;216,0;1,0;10,0;76,0;36,0;;98,0;27,0;;7,0;;;;3,0;12,0;55,0;;;;;38,0;9,0;175,0;;176,0;1,0;7,0;;;25,0;2,0;4,0;6,0;;;3,0;1,0;8,0;23,0;112,0;226,0;;204,0;2,0;4,0;;;;;4,0;78,0;2,0;;1,0;;;;4,0;26,0;;3,0;12,0;24,0;;;29,0;;;1,0;3,0;19,0;1,0;48,0;35,0;23,0;3,0;6,0;2,0;6,0;87,0;1,0;1,0;;1,0;;33,0;;;;;;;7,0;;;19,0;;;15,0;;6,0;20,0;;;;15,0;2,0;;6,0;22,0;3,0;4,0;;87,0;;;;;16,0;4,0;4,0;;;10,0;;;;4,0;;5,0;;5,0;41,0;;;;2,0;8,0;;;;2,0;2,0;;;13,0;;8,0;;;;;;6,0;;;;;;;;2,0;5,0;1,0;;2,0;;2,0;;;;;14,0;1,0;;;;5,0;;29,0;;;;;4,0;2,0;;1,0;;5,0;;;1,0;;;;;1,0;;;1,0;;12,0;13,0;5,0;;;;;1,0;;;;;;;4,0;2,0;3,0;1,0;1,0;;;1,0;;15,0;29,0;;5,0;1,0;;10,0;9,0;9,0;;;10,0;;;4,0;75,0;;;42,0;;;;;39,0;;;;;;17,0;7,0;;4,0;;;;;12,0;;;;1,0;;;;;;62,0;;3,0;;;;;;;;;;110,0;;;13,0;;;2,0;;11,0;;2,0;;;1,0;;;;;112,0;;;;;;;;2,0;;;;1,0;;;1,0;;;;1,0;;3,0;;;8,0;2,0;;;;2,0;;2,0;;3,0;;;;5,0;3,0;;;5,0;;;;;;;;78,0;;;;1,0;20,0;1,0;;;;8,0;;;102,0;;;;;4,0;;;;;;;;;9,0;1,0;;;;;;;;;1,0;;;;;;2,0;;1,0;;;;3,0;;7,0;;;;;;5,0;;;;;;67,0;;;;;;143,0;21,0;;1,0;41,0;;;;;;;;;;;;1,0;;;9,0;;;;;1,0;1,0;;12,0;;;;7,0;1,0;;1,0;;;;179,0;;4,0;;;1,0;;;2,0;;;;;;;;;;;;9,0;41,0;;3,0;;3,0;;;;;;;;20,0;;;;;;;;2,0;;12,0;;;;;;;;;;;8,0;;80,0;10,0;;;;11,0;12,0;30,0;;;1,0;;;;4,0;;;3,0;;;;18,0;;3,0;;;;;;;;;;;;24,0;;;32,0;256,0;146,0;1,0;21,0;;;;;9,0;16,0;;27,0;44,0;;;40,0;3,0;4,0;;9,0;1,0;32,0;;5,0;9,0;;;4,0;;5,0;;1,0;;106,0;42,0;;7,0;1,0;;;;;;;;;;3,0;;;2,0;;7,0;;;;4,0;1,0;;16,0;;;;;;2,0;;;;;8,0;;3,0;;;;;;;;;1,0;;;;3,0;;;15,0;;2,0;;;;;;;;;;;;;;;;;;;;;;;;1,0;;;;;;;;3,0;;1,0;11,0;;;;;;;;;;1,0;;;;1,0;;7,0;;2,0;2,0;;;;;;;;1,0;;;;;;;;;;;;;;;;1,0;;;;;;;;;;;;;;;;;;;;;3,0;;;;;;;;;;;;;;;;1,0;;;;;;;;;;;;;;;;;;;;;;;;;;;;;;;;;;;
chassis;;1,0;;;;;;14,0;11,0;;;;;;;11,0;;;;;;;;;;;;;;;2,0;;5,0;;10,0;;;;;1,0;;;1,0;;;;;35,0;1,0;6,0;15,0;;;2,0;22,0;;2,0;;;;;11,0;;;;;;9,0;10,0;22,0;;;;;;;;;;12,0;1,0;1,0;;13,0;;;;;5,0;3,0;27,0;;;;;;1,0;;;17,0;;;6,0;;;;;3,0;;;;;;;;15,0;17,0;31,0;5,0;;1,0;1,0;;;;;1,0;;;;;;4,0;4,0;;;;;;;;;;4,0;;;;22,0;2,0;1,0;;;1,0;1,0;;5,0;5,0;;64,0;;;;20,0;1,0;;;2,0;;;;5,0;;;1,0;;;37,0;1,0;;;;12,0;;2,0;;2,0;2,0;2,0;;;2,0;;;8,0;;;;;;;1,0;;;16,0;;4,0;8,0;;;2,0;;;;;;;;1,0;;12,0;24,0;;10,0;;;;;1,0;1,0;;17,0;;;8,0;5,0;3,0;;3,0;1,0;60,0;;16,0;;;;;;;;;30,0;;1,0;;;;7,0;;;;1,0;;;;;;1,0;4,0;;;;;2,0;;;9,0;;12,0;2,0;79,0;;;;;;2,0;;;;;6,0;1,0;;;15,0;;;;;;3,0;1,0;139,0;;;;2,0;;;;;;;;4,0;;;;6,0;1,0;3,0;;;;;;;8,0;;;;;;;;;;;3,0;1,0;;;;1,0;;6,0;5,0;27,0;1,0;;;;;;;3,0;2,0;2,0;7,0;;4,0;;;1,0;;;;9,0;2,0;;;1,0;;;;;6,0;1,0;2,0;;3,0;;;7,0;;;;;;33,0;;;;;;;15,0;4,0;;;;;;1,0;;;;;;;1,0;;;;;;;;;;;;;;;;;;;;;;;;6,0;;;;1,0;;;;1,0;;;;;;;;;;8,0;;;;;;4,0;;;;;;;;;8,0;;;;;;;1,0;;;;;;1,0;1,0;;4,0;;;;;;;2,0;;;;;2,0;;;;;;;;;2,0;;7,0;;;;;;;;;;;;;;;;3,0;;;;;;;;;;;;;1,0;;;;;;;;;;;;;;;;3,0;;;;;;1,0;;;1,0;;;;;;;;;;3,0;;;;;;;3,0;;;;;;;;;;;4,0;;;;;9,0;;;;;6,0;;1,0;;4,0;;;;;;;;;;8,0;;;;;;;;;;2,0;;;;2,0;;;1,0;;;;1,0;;;;1,0;;;;;1,0;;;;;2,0;;;;;;2,0;;23,0;;;12,0;;;;;;;6,0;;;;;;;;;;;;4,0;2,0;1,0;;;1,0;1,0;7,0;4,0;;;;;;;3,0;;;;;;7,0;;;;;;11,0;;;;;;;;;4,0;;;;;;;;2,0;;;;;7,0;;;2,0;;;;;;;;3,0;;;;;;;;;;;;;;;;;;;;;;;;;;;;;;8,0;;;;;;;;;;;;;;;;;;;;;;;;;;;;;;;;;;;;;;;1,0;;;;5,0;;;;6,0;;;;;;;;;;;;;;;;;;;;;;;;;;;;;;;;;;;;;;;;;;;;;;;;1,0;;;;;;;;;;;;;;;;;;3,0;1,0;;;;;;;;;;;1,0;;;;;;;;;;;;;1,0;;;;;;;;;;;1,0;;;1,0;;;;;;;;;;;;;;;;;;;;;;;;;;9,0;;;;;;;;2,0;;;2,0;;;;;;;;;;;;;;;;;;;;;;;;;;;;;;;;;;;;;;;;;1,0;;12,0
circuit;;3,0;1,0;;1,0;9,0;13,0;154,0;36,0;148,0;108,0;;56,0;3,0;10,0;79,0;1,0;;10,0;;;80,0;2,0;13,0;1,0;2,0;109,0;6,0;4,0;9,0;14,0;16,0;488,0;3,0;711,0;20,0;22,0;159,0;8,0;;198,0;3,0;56,0;13,0;65,0;40,0;85,0;387,0;134,0;39,0;101,0;22,0;;3,0;148,0;16,0;254,0;;;1,0;35,0;25,0;30,0;1,0;74,0;4,0;49,0;169,0;62,0;41,0;30,0;;245,0;36,0;1,0;29,0;7,0;;9,0;672,0;48,0;193,0;;697,0;4,0;4,0;2,0;;2,0;9,0;211,0;1,0;66,0;11,0;;11,0;40,0;1,0;106,0;8,0;;;391,0;49,0;2,0;15,0;50,0;12,0;342,0;7,0;23,0;108,0;77,0;5,0;23,0;444,0;209,0;93,0;117,0;25,0;11,0;4,0;89,0;503,0;67,0;9,0;1,0;;;8,0;2,0;95,0;13,0;3,0;5,0;5,0;64,0;29,0;26,0;;8,0;;10,0;345,0;6,0;;1,0;89,0;893,0;3,0;15,0;3,0;131,0;68,0;5,0;82,0;222,0;;8,0;93,0;;51,0;240,0;2,0;4,0;2,0;81,0;6,0;1,0;1,0;5,0;2,0;21,0;22,0;6,0;20,0;105,0;36,0;;;1393,0;23,0;7,0;19,0;105,0;;;74,0;;;9,0;9,0;;390,0;5,0;62,0;;2,0;5,0;21,0;;3,0;17,0;40,0;11,0;10,0;20,0;3,0;18,0;36,0;13,0;2,0;;43,0;10,0;;7,0;20,0;16,0;30,0;112,0;10,0;9,0;;;4,0;59,0;;74,0;6,0;60,0;10,0;38,0;288,0;8,0;8,0;7,0;68,0;15,0;15,0;5,0;16,0;9,0;24,0;94,0;;34,0;11,0;732,0;11,0;27,0;;4,0;;;31,0;124,0;8,0;;;1,0;5,0;10,0;135,0;41,0;;23,0;17,0;7,0;;4,0;104,0;23,0;6,0;;5,0;6,0;18,0;383,0;229,0;132,0;74,0;82,0;4,0;1,0;152,0;;6,0;11,0;2,0;7,0;53,0;25,0;;4,0;;;;48,0;1,0;16,0;9,0;48,0;;2,0;4,0;67,0;77,0;41,0;;1,0;17,0;70,0;;9,0;7,0;1,0;26,0;;158,0;2,0;;1,0;7,0;41,0;1,0;10,0;;3,0;6,0;11,0;1,0;3,0;;17,0;29,0;58,0;6,0;88,0;48,0;8,0;;7,0;285,0;3,0;;13,0;35,0;9,0;56,0;4,0;1,0;;70,0;16,0;1,0;;6,0;9,0;1,0;;3,0;11,0;3,0;1,0;;;6,0;11,0;;12,0;;;3,0;;21,0;1,0;;9,0;1,0;2,0;2,0;11,0;10,0;6,0;10,0;9,0;;2,0;41,0;8,0;3,0;6,0;20,0;;14,0;;7,0;6,0;;;;2,0;23,0;1,0;;1,0;13,0;3,0;22,0;26,0;18,0;21,0;2,0;2,0;6,0;;;1,0;10,0;3,0;;16,0;45,0;;;4,0;12,0;2,0;;3,0;127,0;40,0;9,0;7,0;5,0;2,0;8,0;42,0;21,0;11,0;51,0;16,0;;19,0;20,0;132,0;;5,0;17,0;1,0;;;;11,0;8,0;1,0;1,0;;1,0;303,0;5,0;1,0;1,0;1,0;4,0;15,0;;15,0;3,0;1,0;;59,0;12,0;32,0;7,0;6,0;7,0;143,0;1,0;47,0;23,0;2,0;7,0;;82,0;1,0;1,0;4,0;6,0;49,0;;2,0;51,0;5,0;5,0;2,0;6,0;48,0;;12,0;4,0;2,0;6,0;20,0;;1,0;1,0;182,0;1,0;10,0;2,0;;;4,0;7,0;2,0;10,0;2,0;;1,0;5,0;19,0;46,0;1,0;;3,0;19,0;;25,0;5,0;25,0;27,0;38,0;38,0;5,0;4,0;4,0;8,0;3,0;;9,0;;2,0;;10,0;15,0;;;109,0;11,0;;2,0;1,0;42,0;5,0;;23,0;;1,0;2,0;20,0;32,0;3,0;;9,0;15,0;24,0;35,0;12,0;84,0;4,0;3,0;;3,0;9,0;8,0;6,0;26,0;1,0;4,0;3,0;;;4,0;16,0;;;;5,0;;;5,0;7,0;17,0;;;;;14,0;26,0;11,0;;;1,0;4,0;3,0;3,0;6,0;;1,0;;9,0;3,0;9,0;;4,0;;3,0;1,0;199,0;;2,0;2,0;2,0;;139,0;14,0;;1,0;32,0;;;14,0;;4,0;34,0;;13,0;4,0;7,0;;3,0;3,0;;4,0;4,0;;;3,0;4,0;14,0;2,0;12,0;5,0;2,0;17,0;;1,0;2,0;29,0;69,0;;1,0;164,0;13,0;;15,0;;;35,0;;;;5,0;4,0;;;444,0;;;;5,0;;;49,0;1,0;6,0;136,0;3,0;9,0;;2,0;;;;2,0;38,0;679,0;;;;9,0;;1,0;;5,0;2,0;;13,0;;;;15,0;;;2,0;;3,0;;14,0;37,0;1,0;;;20,0;23,0;47,0;2,0;;;8,0;4,0;;5,0;7,0;5,0;6,0;;13,0;2,0;7,0;4,0;5,0;5,0;11,0;6,0;1,0;11,0;;;;;10,0;10,0;20,0;2,0;;20,0;15,0;3,0;66,0;30,0;24,0;;14,0;1,0;98,0;3,0;;10,0;17,0;2,0;6,0;11,0;3,0;19,0;;35,0;5,0;75,0;4,0;3,0;;3,0;;25,0;3,0;1,0;4,0;;4,0;164,0;39,0;;3,0;;3,0;3,0;3,0;20,0;7,0;2,0;15,0;;4,0;;4,0;7,0;;1,0;14,0;;3,0;;20,0;;2,0;2,0;;;19,0;14,0;7,0;174,0;5,0;49,0;5,0;3,0;5,0;1,0;6,0;;;2,0;10,0;;9,0;;4,0;;4,0;;;5,0;1,0;1,0;9,0;;80,0;;;18,0;5,0;;;;;7,0;;1,0;1,0;;;;8,0;4,0;5,0;1,0;;1,0;4,0;1,0;2,0;4,0;;;2,0;;3,0;6,0;2,0;1,0;17,0;4,0;;;1,0;;;1,0;1,0;;10,0;;;;;1,0;5,0;;;5,0;1,0;11,0;;;7,0;;;;;16,0;;4,0;;8,0;;;2,0;;;15,0;;;4,0;;50,0;;;;;5,0;;14,0;;;3,0;;;;;;;;;;;9,0;5,0;;15,0;;1,0;;;;2,0;;;8,0;;;;10,0;;1,0;9,0;3,0;;;25,0;1,0;;;;1,0;1,0;;1,0;;;;;1,0;;;;;;;;1,0;;;;;2,0;;
circuitry;;2,0;;2,0;16,0;;;29,0;8,0;2,0;20,0;;33,0;;;8,0;1,0;;;1,0;3,0;23,0;;;;;1,0;11,0;;;2,0;6,0;142,0;;98,0;5,0;2,0;1,0;1,0;;161,0;;17,0;;35,0;5,0;49,0;56,0;19,0;32,0;55,0;7,0;;;8,0;;19,0;;2,0;;1,0;3,0;1,0;;1,0;6,0;4,0;17,0;3,0;5,0;3,0;;16,0;1,0;;4,0;7,0;;;128,0;7,0;29,0;4,0;69,0;;2,0;;;;1,0;8,0;;2,0;1,0;1,0;;7,0;;7,0;4,0;;1,0;34,0;10,0;;8,0;5,0;;21,0;33,0;2,0;10,0;;9,0;;10,0;14,0;5,0;21,0;1,0;1,0;;10,0;125,0;16,0;5,0;;;;;;2,0;1,0;;1,0;2,0;1,0;21,0;18,0;;8,0;;6,0;46,0;9,0;;;13,0;45,0;;;2,0;2,0;3,0;1,0;3,0;101,0;;;2,0;1,0;10,0;46,0;;;1,0;32,0;3,0;;;;;;;1,0;1,0;5,0;1,0;;;11,0;;1,0;1,0;3,0;25,0;;13,0;;;3,0;6,0;;44,0;;6,0;;;;;;;3,0;4,0;;;;;2,0;2,0;;;;;9,0;;;;;;55,0;;;;;32,0;;;17,0;1,0;2,0;2,0;32,0;;;;1,0;;;1,0;3,0;;4,0;3,0;;;;;24,0;8,0;;;;;;;64,0;2,0;;;;;1,0;5,0;4,0;;;;14,0;1,0;1,0;5,0;;;2,0;;7,0;;22,0;17,0;3,0;2,0;;;;29,0;;2,0;1,0;1,0;2,0;;;3,0;;;;2,0;3,0;;;;5,0;;;;;;12,0;;;;2,0;;;8,0;;17,0;;42,0;;;;;4,0;;;;;;;;;;;3,0;;;;;;;;10,0;;;;;3,0;5,0;;;;1,0;;3,0;4,0;5,0;1,0;;;;;;;;;;;;;;4,0;1,0;;;;;;;;;1,0;;;4,0;;;;1,0;;2,0;;;;2,0;;;;;;;;10,0;;;;;;13,0;;;19,0;;;;1,0;;;;;;4,0;7,0;;;;3,0;;;;25,0;;;1,0;;;2,0;5,0;1,0;;3,0;2,0;2,0;2,0;16,0;8,0;3,0;1,0;2,0;;;;;7,0;7,0;6,0;;;1,0;2,0;;;;;;;;;1,0;;;1,0;1,0;5,0;;;;;;2,0;;;;;;;;;;;2,0;42,0;;;1,0;;12,0;56,0;;2,0;1,0;2,0;1,0;;;;2,0;5,0;2,0;;2,0;;;2,0;;;1,0;;66,0;2,0;29,0;;4,0;;29,0;10,0;5,0;;;;7,0;;7,0;;;4,0;39,0;1,0;8,0;;;;;;6,0;;;;5,0;;;2,0;30,0;1,0;2,0;;2,0;;1,0;;1,0;;1,0;;3,0;5,0;27,0;9,0;;3,0;;2,0;;;2,0;;;;;5,0;;;;2,0;;;12,0;;;6,0;2,0;;1,0;;1,0;;1,0;;1,0;2,0;;;;;2,0;;;;;;;;;6,0;2,0;;;;;51,0;;;13,0;2,0;;5,0;;;;1,0;;;;;;18,0;;2,0;1,0;;;1,0;;;;1,0;;;;;15,0;5,0;;;1,0;;;;;;1,0;;;14,0;;;2,0;;;;;;;;;;;1,0;;;;12,0;;;;;;;;;;;;;;1,0;1,0;2,0;;67,0;;;;;;;;;2,0;;;;;1,0;;;3,0;;;;;;;;;7,0;40,0;;;;6,0;;;;;;2,0;;;1,0;;;;;;8,0;;;;;;;;;;;;9,0;1,0;1,0;;;;1,0;;;2,0;;;;;4,0;1,0;1,0;;;;;1,0;1,0;;;;;;;;;3,0;;;;;;;;;1,0;2,0;;;;1,0;;;;;;;;;;;;;;;;;2,0;;;;;;;;1,0;;;;;;;;;;;;;;4,0;1,0;;;;;;;;;9,0;;;1,0;;;;;1,0;;;;;;1,0;2,0;;;;;;1,0;;;;18,0;1,0;;;;;1,0;;4,0;1,0;;2,0;;;7,0;2,0;;;;;;;;;;;4,0;;;;;;;;;;;;;;;;;;;;;;7,0;;;1,0;;;;;;2,0;;;4,0;;1,0;;;;;7,0;;;;;;;;;;;;;;;;;;;;1,0;4,0;;;;;;;4,0;;;;;1,0;;2,0;;;;;;;1,0;;2,0;;;;;;;;;;;
circular;;4,0;;;;2,0;11,0;5,0;3,0;3,0;8,0;;;;7,0;9,0;;;;;2,0;6,0;;1,0;2,0;;;;;;;;7,0;;;;;;;3,0;44,0;;26,0;;;1,0;;23,0;;;5,0;1,0;;;10,0;12,0;10,0;;1,0;;22,0;;;5,0;;;;32,0;7,0;21,0;;1,0;;;;1,0;;;;23,0;;4,0;;14,0;;;5,0;;;3,0;50,0;;;3,0;;4,0;3,0;;16,0;;;;17,0;;;2,0;14,0;1,0;3,0;;2,0;2,0;21,0;;1,0;36,0;82,0;26,0;;10,0;1,0;;;1,0;1,0;;;;;;;1,0;;;6,0;;2,0;;;;;;;3,0;;;1,0;29,0;2,0;;;1,0;4,0;5,0;;;7,0;;2,0;;;;8,0;;;;39,0;6,0;;;;;3,0;7,0;;;7,0;26,0;;;3,0;51,0;;1,0;;;;11,0;;;;;1,0;;;18,0;;6,0;;16,0;9,0;;1,0;25,0;;;2,0;;;5,0;;2,0;;;1,0;;15,0;;;17,0;4,0;;26,0;2,0;1,0;1,0;10,0;;7,0;1,0;24,0;1,0;4,0;22,0;;12,0;4,0;42,0;1,0;30,0;1,0;;4,0;2,0;1,0;;;;7,0;2,0;27,0;2,0;2,0;;1,0;;6,0;;;;;;;1,0;;;42,0;1,0;;;1,0;;20,0;;;;;6,0;;48,0;;;1,0;1,0;;1,0;2,0;;2,0;3,0;;4,0;;;56,0;;3,0;2,0;1,0;;1,0;1,0;3,0;1,0;4,0;6,0;3,0;;29,0;3,0;;1,0;;9,0;1,0;;;11,0;;;1,0;;18,0;4,0;;;11,0;;;;4,0;;2,0;;;;;8,0;7,0;1,0;3,0;;4,0;;;;;4,0;1,0;5,0;17,0;1,0;;;1,0;;;9,0;5,0;;1,0;6,0;;7,0;76,0;;;3,0;2,0;;2,0;;;;;6,0;25,0;8,0;3,0;4,0;;3,0;12,0;6,0;;5,0;2,0;2,0;3,0;9,0;6,0;2,0;;2,0;;;5,0;3,0;6,0;1,0;;;4,0;1,0;;;;1,0;;4,0;;;;;;4,0;;3,0;2,0;;;;1,0;;;;;2,0;;;;2,0;1,0;6,0;;;;;;;;11,0;1,0;;;1,0;;;4,0;5,0;;;;1,0;2,0;37,0;;1,0;9,0;;1,0;;;;;2,0;;;;4,0;;;;;4,0;;;2,0;;;1,0;16,0;;20,0;1,0;;;;2,0;;;;;;;10,0;2,0;;;;5,0;;;;;;;;;;;;;;3,0;;;;;;;;;3,0;;;;;;;;;2,0;;;1,0;;;;4,0;;4,0;;;;;1,0;;;1,0;;1,0;2,0;;;3,0;;;;7,0;;;;;;;;;;;4,0;;;;;;;2,0;;;;;;;3,0;;;;;;;;;10,0;;;;;5,0;;1,0;;;;;2,0;;11,0;;;;1,0;2,0;;1,0;;;;;;;;;;;;3,0;;1,0;;;;;4,0;;;;3,0;;;;;1,0;;;;;4,0;;;;;;;;1,0;;;;;1,0;;;1,0;;2,0;;5,0;;;;1,0;;;;;;1,0;2,0;;;;;;;5,0;;;;;2,0;;;;;;;;;1,0;;;1,0;;1,0;1,0;;;;;;;;5,0;;1,0;;;;;;;;;4,0;3,0;;;6,0;3,0;;;;;;;;;;3,0;;;;;2,0;;;4,0;;;;;;1,0;;;;1,0;;;;;;;;;;;1,0;;;26,0;;2,0;;;;;;;;;;;1,0;;;;;;;;;;;;;;4,0;;;;;;;;;;;;1,0;;;;5,0;;;;;;;;1,0;;;;;;;;;;;;;;;1,0;;;;;;;;;;;;;;;;;;;;;1,0;;;;4,0;;;;;;;;;;1,0;;;10,0;;;;;;1,0;;;;;;;;12,0;;;;;;;;;;;;;1,0;;;;;1,0;;8,0;1,0;;2,0;1,0;;;;;;;;;;;;20,0;;;;;;;;;;;;;;;;;;;;2,0;;;;2,0;;2,0;;10,0;;1,0;4,0;;;;1,0;;7,0;;4,0;;;;;;;;;;;;;1,0;;;;;;;;1,0;;;;;;;;2,0;;;;;;
circumferential;;36,0;;;;11,0;;;1,0;22,0;;;1,0;;2,0;2,0;;;;;2,0;;;1,0;;;;1,0;;;;;6,0;;;;;;;;;;5,0;;;;;4,0;;;69,0;1,0;;;7,0;13,0;4,0;;;;160,0;4,0;;;;;;24,0;1,0;;;5,0;4,0;;;1,0;;;;2,0;;;;20,0;;;;;;92,0;58,0;;;1,0;;;;;;;;;1,0;;;;15,0;6,0;;;2,0;;2,0;;2,0;5,0;46,0;33,0;;19,0;3,0;;;;;;;;;20,0;;2,0;17,0;;13,0;;1,0;;;;;;;2,0;;;;62,0;;;;;;;;;2,0;;;3,0;;;19,0;;33,0;;;;;;;;1,0;7,0;;;9,0;24,0;;;;11,0;;6,0;;;1,0;;;;;;;12,0;;4,0;;;;9,0;58,0;;;375,0;;1,0;;;;46,0;;;4,0;;;;7,0;;;17,0;2,0;3,0;71,0;;;1,0;2,0;;6,0;;77,0;;;24,0;;;2,0;16,0;11,0;100,0;;;6,0;16,0;2,0;;;;;;1,0;;;;;;10,0;;;;;;6,0;;4,0;;8,0;1,0;1,0;;;;8,0;2,0;;4,0;;12,0;20,0;231,0;;;2,0;;5,0;;;;;4,0;;;1,0;;42,0;;1,0;;1,0;1,0;7,0;3,0;;2,0;;1,0;;4,0;;1,0;;3,0;;;10,0;;;;;8,0;4,0;;2,0;2,0;10,0;;4,0;;;;5,0;;;;;;;9,0;1,0;9,0;;11,0;3,0;;;;9,0;;3,0;;6,0;4,0;;;4,0;;;3,0;;;;46,0;1,0;2,0;8,0;2,0;;;11,0;;11,0;1,0;;;;;13,0;3,0;29,0;;4,0;;;2,0;;;;1,0;1,0;19,0;9,0;;;;1,0;3,0;;;;;;;;;;;;2,0;;;;;;;;4,0;;1,0;;;;;;;;;;;;;;;;1,0;;;;2,0;;;;;4,0;;;;;;2,0;;;4,0;;;;;;;;;;;;;2,0;;;;;;;;;;;;;;;;;;;19,0;;;;;;;;;;;;;;;;;;;;3,0;;;;;;;;;;;;;1,0;;;;;;;;;;;2,0;;;;;;1,0;;;;;;51,0;;31,0;;;;;;;;;;;;;;1,0;;;;;;;;;9,0;;;;;;;;4,0;;;;;;;;;;;;;;;;2,0;;;;;1,0;3,0;;;;;;4,0;;;;;;;2,0;;;1,0;;4,0;;;;;;;;;;1,0;;;;8,0;;;;;;;1,0;;;;3,0;;;;;;;;;;2,0;;;;;;;;7,0;;;;;;;;;;1,0;;12,0;;;;;;;9,0;;;1,0;;;;;;2,0;;;;;;;;;;;;;;;;;;;;;2,0;;;;;;;;;8,0;;;;;;2,0;;;;;;45,0;;;;1,0;;;1,0;;;;;1,0;;;;;;;;;;2,0;;;1,0;;;;;;;4,0;;;;;;;;;;;;;;;;3,0;;;;;;;;;;;;;;;;;;;;2,0;;;;;;;;;;;;;;;;1,0;;;;;3,0;;;;1,0;;;;;;;2,0;;;;;;;6,0;;;;;3,0;4,0;;;;;;;;;;;;;;;;;;;;;;;;;;;;;;;;;;;;;;;;;;;;;;;;;;;;;;;;;;;;;;;;;;;;3,0;20,0;;;8,0;;;;;;;1,0;11,0;;;2,0;;;17,0;;;;;;;;;;;;;;;;;;;;;;;;1,0;4,0;;;;;;;1,0;;;;;;;;;;;;;;;;;;;;;;;;;;;;;;;;;;;;;;;;;;;
clamp;;27,0;1,0;;;3,0;5,0;36,0;4,0;4,0;;;;6,0;8,0;66,0;;;;;;;;;2,0;;;6,0;;;;;15,0;;5,0;;;17,0;;1,0;10,0;;20,0;;2,0;2,0;1,0;60,0;12,0;;6,0;;;;;15,0;22,0;;;;20,0;;;;;;;8,0;1,0;5,0;2,0;;30,0;;;;;3,0;6,0;18,0;;25,0;;56,0;;;;;1,0;1,0;12,0;;;2,0;;;;;3,0;6,0;;;13,0;;;6,0;5,0;1,0;12,0;;8,0;13,0;;;;11,0;69,0;21,0;;6,0;;;;17,0;;;;;;2,0;;20,0;17,0;;;;4,0;;;;;;;;4,0;;;10,0;85,0;;;;;2,0;2,0;45,0;26,0;;;;;;85,0;;8,0;;2,0;;1,0;;1,0;;;;;2,0;7,0;11,0;;;16,0;14,0;;;1,0;29,0;;4,0;;;3,0;;;21,0;;6,0;;;;10,0;2,0;3,0;6,0;9,0;;6,0;2,0;;;2,0;1,0;3,0;1,0;2,0;;;;;;2,0;6,0;;2,0;;;1,0;;7,0;2,0;;191,0;;;57,0;21,0;4,0;2,0;5,0;8,0;10,0;;;;;;;;;15,0;20,0;33,0;;;1,0;1,0;;6,0;;2,0;;1,0;;20,0;31,0;;;2,0;2,0;4,0;;4,0;;4,0;;;7,0;;7,0;4,0;100,0;1,0;;3,0;;;1,0;;;;;;5,0;;;7,0;;5,0;;;;;2,0;20,0;6,0;3,0;;43,0;2,0;3,0;;;3,0;;;;;;26,0;;8,0;;1,0;8,0;7,0;;;11,0;12,0;;;;1,0;2,0;;1,0;;;6,0;8,0;3,0;1,0;;2,0;1,0;;;9,0;;10,0;;;4,0;;;;2,0;6,0;2,0;1,0;;;2,0;;5,0;4,0;2,0;2,0;11,0;5,0;;8,0;19,0;;;;5,0;18,0;15,0;3,0;38,0;42,0;4,0;6,0;24,0;;;4,0;3,0;6,0;40,0;2,0;1,0;;;6,0;;3,0;;;;;;;2,0;;;;;;3,0;7,0;;4,0;;;;;;;;;;;;;;;;;;;;14,0;;4,0;;;2,0;;;;;;;;;3,0;;4,0;2,0;1,0;;;;;;;;;;;;;;;;;;;;;;;;;;;;130,0;;6,0;1,0;;3,0;;1,0;;;;;;;;;;;1,0;;1,0;;20,0;;2,0;;;4,0;;;;;;;;2,0;;;;;;;;;7,0;3,0;;;;3,0;;;;1,0;;;;7,0;;;;;;;;;;;1,0;;;1,0;;;;;;;;;16,0;2,0;;2,0;;;1,0;;;;2,0;;;;;;;1,0;;3,0;;;;3,0;;;1,0;;;;;;;;;;;;;;1,0;;3,0;;;;;;2,0;;;;2,0;;;;;;1,0;;;;3,0;;2,0;;;;6,0;4,0;;;;;;3,0;;;;6,0;;;;;;;;;;;;;;2,0;;2,0;15,0;10,0;;;;;;;;;12,0;;;3,0;6,0;;;1,0;;;;;;;4,0;;1,0;;1,0;;2,0;9,0;;;6,0;;;2,0;3,0;;;;;;5,0;18,0;;;;;6,0;;;1,0;;3,0;2,0;;;29,0;;;;;;;3,0;;4,0;;5,0;;;2,0;;;;;1,0;;;;;;;2,0;;;;;;;2,0;;;;;;;;1,0;20,0;;2,0;1,0;;;;;;;;;;;;;;;;1,0;;;;;;1,0;;;;;;;;;;;;;3,0;;;;;;;;10,0;;;;;;6,0;;;;;;;;;;;;;;;;;;;2,0;;;;;;;;;;;2,0;;;;;;;2,0;;1,0;;;;;;;;;;;3,0;;;;;;;;;;;;;;;;8,0;;;;;;18,0;2,0;;;;;;;;;;;;;;;;;;;;;;5,0;;;;;4,0;;;;;2,0;;;;;;;;;;;;;;;;;;;;;;;2,0;;6,0;;;;;;;;;;;;4,0;;;;;1,0;;;1,0;;;;;;;;;;;;;;;;;;;;27,0;1,0;;;;;;;;;;;;;;;;;;;;;
clock;;7,0;;;;;;8,0;2,0;7,0;6,0;;;;;52,0;;;;;;10,0;3,0;12,0;;;1,0;2,0;;;;6,0;36,0;;58,0;2,0;14,0;10,0;1,0;;53,0;;;;2,0;4,0;44,0;19,0;9,0;5,0;2,0;;1,0;3,0;10,0;3,0;7,0;;;;;;;;;;1,0;4,0;1,0;;1,0;;94,0;29,0;;;4,0;;;28,0;1,0;17,0;;59,0;;;72,0;;;;63,0;;2,0;;2,0;;3,0;;24,0;5,0;;;7,0;;;1,0;;7,0;200,0;1,0;;12,0;;;7,0;50,0;4,0;4,0;;17,0;;;10,0;5,0;1,0;;;;;4,0;10,0;77,0;13,0;;;13,0;4,0;13,0;4,0;;;;;14,0;2,0;;;1,0;1001,0;;;;4,0;11,0;;69,0;9,0;;;43,0;;8,0;130,0;;;;5,0;5,0;;;2,0;;;1,0;8,0;10,0;;;;;;64,0;;;;69,0;;5,0;;;;;;6,0;;134,0;;;;;;;26,0;16,0;;;;;1,0;;;;;1,0;;;;;;;;;;;;;;;9,0;;;;;2,0;;;;3,0;;;;;;;138,0;;;1,0;22,0;;;;;;;19,0;39,0;;;;;;;34,0;;;;;;;;30,0;;;;8,0;1,0;;;;16,0;93,0;55,0;;4,0;45,0;;;8,0;;;7,0;;;;;;;;;;2,0;;;;;;;;;;;4,0;;;;;49,0;;;;;;;10,0;;3,0;;;;;;;;;300,0;;;3,0;;;;;4,0;;;;;3,0;;;;;1,0;;;;8,0;;;;;;;;;;3,0;;;1,0;;;;;;;;;;;;;;;15,0;;;;;;;;;;11,0;;;;;;;;;;;;;25,0;4,0;16,0;8,0;5,0;;1,0;1,0;;;;;;1,0;;;2,0;;;;;2,0;;165,0;17,0;;;;21,0;;6,0;3,0;;;1,0;;;23,0;14,0;;;62,0;;;;;27,0;;;;;2,0;1,0;;1,0;;;;;;;;;;7,0;;;;;;22,0;;8,0;;;;;79,0;;;;;;;1,0;;1,0;;;;1,0;;;2,0;;;4,0;;;;12,0;;;;;;1,0;1,0;;;;;;;10,0;9,0;;;;;;1,0;;9,0;;1,0;1,0;;1,0;;;;;;;;;3,0;3,0;5,0;;7,0;27,0;;3,0;;;;;;;;;2,0;;;;6,0;;1,0;;;34,0;;;;;3,0;;;2,0;;;;;;;;;;;;;;;;;;;;;;;;;;;;;;;;;;2,0;;;;;;;;2,0;4,0;;;;;;12,0;;;1,0;;;;;;;;1,0;;;;;38,0;;1,0;;;;;;16,0;1,0;;;;1,0;;;;;;;;70,0;;;;;;;;;;;;;;;;;;;;;5,0;;24,0;59,0;;6,0;;;;;;;7,0;;;;;3,0;;;;;;;;;;;2,0;;;;;;;;;;;;;;30,0;;;;5,0;;;;;;;;4,0;;;;;;;;;;;;;;;;19,0;;;7,0;;;;;;;;;10,0;;;;;1,0;;;;;;2,0;;;;;;;;;;3,0;4,0;;;;;;;;;;;;;;;;;;;;;;;;1,0;;;;;;;;;;;89,0;;;;;;;;;;3,0;;;;;7,0;;;;;;;;1,0;;51,0;;;;;28,0;;;;;;;;;;;;3,0;;;;;;;;;;;;1,0;;;;;;;;;;;;;;;;;;;;;3,0;;;;;;;;;;;;;;;;;;;;2,0;;;;;;;;14,0;;;;;2,0;;6,0;;;;;;;;;;;;;;6,0;;;2,0;;;;;;3,0;;;50,0;1,0;;;;;;;;;;;;;;;;;;;;;;;;;;;;;;;;10,0;;;;;;
close;;1,0;2,0;5,0;;8,0;27,0;13,0;34,0;56,0;8,0;6,0;7,0;;28,0;17,0;;;;;1,0;22,0;1,0;2,0;;2,0;18,0;2,0;;;;5,0;32,0;;26,0;11,0;4,0;6,0;2,0;6,0;12,0;4,0;11,0;3,0;11,0;8,0;17,0;52,0;12,0;18,0;57,0;93,0;2,0;1,0;32,0;12,0;115,0;;4,0;;6,0;1,0;16,0;7,0;7,0;8,0;27,0;19,0;16,0;15,0;2,0;;5,0;;;17,0;6,0;4,0;7,0;162,0;;32,0;;15,0;3,0;3,0;1,0;;;5,0;285,0;;1,0;5,0;3,0;;4,0;;22,0;21,0;1,0;;25,0;171,0;1,0;6,0;50,0;1,0;2,0;4,0;4,0;4,0;2,0;;;29,0;119,0;479,0;14,0;16,0;5,0;;2,0;5,0;5,0;1,0;;12,0;;28,0;;20,0;11,0;2,0;;;4,0;2,0;4,0;2,0;3,0;;1,0;45,0;3,0;2,0;;156,0;39,0;7,0;;;1,0;;22,0;6,0;69,0;3,0;8,0;3,0;1,0;3,0;100,0;1,0;;;16,0;27,0;6,0;;8,0;;;1,0;22,0;5,0;20,0;6,0;21,0;;;28,0;;1,0;6,0;9,0;;9,0;;;1,0;;;9,0;1,0;52,0;;;;70,0;2,0;2,0;3,0;48,0;;;4,0;;13,0;12,0;3,0;1,0;1,0;1,0;5,0;;3,0;1,0;;9,0;65,0;2,0;19,0;;;29,0;4,0;5,0;66,0;1,0;97,0;1,0;15,0;18,0;29,0;57,0;11,0;335,0;2,0;13,0;4,0;3,0;3,0;13,0;;;;1,0;46,0;9,0;22,0;;4,0;1,0;1,0;;9,0;;;5,0;1,0;;16,0;22,0;2,0;5,0;13,0;7,0;171,0;;15,0;24,0;31,0;;;11,0;2,0;15,0;23,0;104,0;28,0;;;12,0;4,0;22,0;;;4,0;1,0;22,0;3,0;3,0;;12,0;5,0;;1,0;;6,0;4,0;9,0;9,0;2,0;;;1,0;14,0;15,0;;;62,0;;10,0;;;7,0;1,0;;12,0;6,0;;5,0;5,0;36,0;1,0;3,0;2,0;2,0;1,0;;9,0;1,0;7,0;5,0;;;19,0;8,0;3,0;5,0;8,0;;3,0;3,0;;2,0;9,0;8,0;1,0;5,0;3,0;;5,0;;8,0;1,0;28,0;1,0;6,0;2,0;;18,0;1,0;2,0;1,0;;11,0;1,0;2,0;;1,0;;;9,0;2,0;11,0;;6,0;15,0;1,0;1,0;3,0;1,0;3,0;;;;;9,0;2,0;20,0;1,0;1,0;1,0;2,0;;6,0;14,0;1,0;;;1,0;18,0;1,0;;1,0;;;13,0;17,0;7,0;5,0;;2,0;;;;4,0;;;;;7,0;2,0;;;;;2,0;;13,0;3,0;;14,0;;5,0;2,0;31,0;;4,0;3,0;22,0;;;28,0;12,0;;7,0;2,0;9,0;2,0;;4,0;;12,0;1,0;1,0;;;9,0;;;1,0;;;;;7,0;7,0;;;;;13,0;;;;2,0;;3,0;3,0;;15,0;6,0;;3,0;;;2,0;1,0;;3,0;3,0;3,0;1,0;;;2,0;;10,0;1,0;2,0;4,0;7,0;;11,0;;3,0;;;12,0;;;2,0;;2,0;;2,0;;1,0;12,0;;2,0;2,0;;;1,0;;;;;16,0;8,0;;;13,0;1,0;;3,0;1,0;2,0;;1,0;;1,0;1,0;1,0;;1,0;;2,0;1,0;;;3,0;;7,0;;;;9,0;5,0;25,0;1,0;;1,0;18,0;;1,0;1,0;;1,0;64,0;1,0;2,0;7,0;7,0;;4,0;;1,0;4,0;;5,0;;;;8,0;;;1,0;;14,0;;2,0;2,0;;2,0;;71,0;;;;;2,0;;7,0;;;;;3,0;;2,0;;2,0;6,0;2,0;;;;2,0;1,0;1,0;;22,0;2,0;1,0;;6,0;;;6,0;;;;;;;5,0;;1,0;;;4,0;;4,0;13,0;;;;;3,0;3,0;;;11,0;5,0;4,0;;;;;4,0;1,0;4,0;5,0;;6,0;6,0;1,0;;;1,0;;;1,0;;;;2,0;4,0;14,0;10,0;;2,0;7,0;2,0;2,0;7,0;4,0;;;;1,0;1,0;;1,0;;;1,0;2,0;;;1,0;2,0;16,0;2,0;;1,0;;;4,0;;;;1,0;116,0;;1,0;;5,0;2,0;;3,0;2,0;2,0;;5,0;;;1,0;;;1,0;;8,0;5,0;2,0;;;1,0;3,0;1,0;;;;7,0;3,0;;;;10,0;;;;;2,0;;1,0;;;;;;;2,0;;;;2,0;;;;3,0;;;4,0;7,0;;;;;2,0;;1,0;;;9,0;;4,0;;1,0;1,0;;;;;;9,0;;;1,0;;;;2,0;;;2,0;;;1,0;4,0;;1,0;;1,0;;2,0;;;;1,0;;;;;;;2,0;4,0;;;;4,0;1,0;4,0;;;;;;5,0;;5,0;1,0;;;;;2,0;3,0;;1,0;;;1,0;2,0;;;;;;;;;;5,0;1,0;6,0;1,0;;;;;;;6,0;3,0;;;;2,0;2,0;;;;;;;;;;;;;2,0;;;;6,0;5,0;;3,0;;;;1,0;1,0;;1,0;1,0;;;1,0;;;6,0;;;;;;;;;;;;;;;;;;;;;;;;2,0;;;;;1,0;1,0;;;3,0;1,0;;4,0;;;;;;;;;2,0;;;8,0;;;;;;1,0;;22,0;;;;;;;;;;;;;;2,0;;;;;;;;;;
cluster;;5,0;;3,0;;1,0;;;14,0;1,0;;;2,0;;12,0;6,0;1,0;;;;;1,0;4,0;;;;2,0;;;;;1,0;10,0;;2,0;;2,0;;;;19,0;;;4,0;;2,0;17,0;6,0;;1,0;1,0;2,0;;2,0;;;13,0;;5,0;;;;;;;;;7,0;1,0;;2,0;;4,0;;;5,0;5,0;5,0;1,0;22,0;;;;24,0;;;;;;;;;;;2,0;1,0;;;22,0;;6,0;;;43,0;;;;2,0;;;;9,0;;;;17,0;;5,0;;2,0;;;3,0;;2,0;;;;;;;;;1,0;;;6,0;1,0;;3,0;;;;28,0;;;;6,0;1,0;3,0;1,0;;;2,0;;;21,0;;;;5,0;;21,0;;;;;12,0;;;;;;;;;4,0;;;;;;;;;;;;;;;;;;;;;;;13,0;;;3,0;2,0;;;;;;;;;;;;;;;;;2,0;;;;3,0;6,0;;;29,0;;;;3,0;1,0;;;;4,0;;;;;4,0;;;;;;56,0;;;;;;;;1,0;;;;;;;4,0;;;3,0;;;;;32,0;;;;;;;;4,0;;1,0;;;;1,0;;;;;4,0;5,0;;;;;;4,0;;;;;12,0;;;;;;;;;;;;;;;;;;;5,0;;;;;;;;;;;;;;;;;;;;;;;;;;;;;;;;;;;;14,0;;;;;;;;;;;;;;;;;;;;;9,0;1,0;;;;;;;;;;10,0;;4,0;;;;;;;;;;;;;4,0;1,0;;;;1,0;4,0;;;;;;;;;;;;;6,0;;15,0;;9,0;;;;;;1,0;;;1,0;2,0;;;;9,0;;;;5,0;1,0;;6,0;;;;;;;;;;;;;;;;;;;;2,0;6,0;;;;2,0;;;10,0;;;;;;;6,0;;;;1,0;1,0;2,0;;;;;;;;;;;2,0;;;;2,0;;;;;;;;;;;;;;;;1,0;2,0;;;;;;;;;;;4,0;;;;;24,0;;;;;;2,0;;;;;;;;;;1,0;;;;;;;;1,0;12,0;;;;;;;;;;;;;;;;;;;;;;;;;;;;3,0;;;;;;;;;;;;1,0;;;;;15,0;;;;;;;;;;;;;;;;;;;2,0;;;;;;;;;;;;;;;;1,0;;;;;;;;;;;;;10,0;;;;;;;;;;11,0;;;;;2,0;;;;;;;;;;;;13,0;;;3,0;;;;;;;;;;;;;;;;;;;;;;;;;;;;;;;;;;;;;;;;;;;;;;;;7,0;1,0;;;;;;;;;;;;;;;;;;;;;;;;2,0;;;;;;;;;;;;;;;13,0;;;;;2,0;2,0;6,0;;;;;1,0;;;;1,0;;;;;;;;;;;;;;;;;;;;1,0;;;;;;;;;;;;;;8,0;;;;;5,0;;;7,0;;;;;;;;;;;;;;;;;;;;;;;;;;;2,0;;;;;;;2,0;;;;;;;;;;;;;;;;;;;;;;;;;;;;;;;;;6,0;;;;;1,0;;;;;;;;;;;;;;;;;;;;4,0;;;;;;;3,0;;;;;;;;;;;;;;1,0;;;;;;;;;;;;;;;;;;;;3,0;;;;;;;;;;;13,0;;;;;;;;;;;;;;;1,0;;;;;;;;;
code;;1,0;7,0;5,0;3,0;2,0;38,0;114,0;77,0;4,0;3,0;;23,0;;4,0;49,0;;4,0;;;6,0;43,0;3,0;;16,0;6,0;38,0;;4,0;1,0;234,0;2,0;122,0;;66,0;6,0;20,0;2,0;12,0;;345,0;;14,0;8,0;21,0;4,0;119,0;145,0;67,0;39,0;;19,0;;2,0;5,0;1,0;17,0;36,0;2,0;27,0;12,0;5,0;176,0;1,0;5,0;2,0;4,0;26,0;43,0;1,0;11,0;;167,0;3,0;1,0;31,0;28,0;4,0;17,0;411,0;1,0;45,0;9,0;198,0;1,0;31,0;;;;;29,0;;3,0;;;76,0;54,0;11,0;146,0;17,0;;3,0;4,0;10,0;;2,0;42,0;16,0;73,0;8,0;1,0;88,0;;;4,0;91,0;8,0;44,0;1,0;54,0;1,0;;7,0;60,0;102,0;267,0;;;1,0;70,0;4,0;82,0;3,0;1,0;7,0;;21,0;21,0;1,0;;4,0;4,0;4,0;29,0;31,0;;;;50,0;3,0;1,0;;26,0;89,0;6,0;3,0;67,0;;8,0;3,0;13,0;26,0;144,0;;;;81,0;9,0;1,0;;3,0;;;3,0;21,0;13,0;7,0;;;4,0;;7,0;;;;18,0;;7,0;;;10,0;5,0;;5,0;;1,0;1,0;;;;1,0;1,0;26,0;12,0;5,0;;;;;13,0;;;;1,0;;;;;1,0;1,0;8,0;;;;;;6,0;;38,0;2,0;;;2,0;1,0;2,0;6,0;;;14,0;;4,0;;1,0;11,0;10,0;;;7,0;178,0;7,0;;;;;;21,0;69,0;2,0;;;;;;34,0;;2,0;7,0;;;;;11,0;2,0;;;;44,0;7,0;16,0;4,0;16,0;6,0;;1,0;;29,0;;;8,0;;3,0;;1,0;;;;1,0;;;;11,0;5,0;2,0;;;2,0;;13,0;20,0;;;5,0;;;7,0;;;;;2,0;;;;;7,0;;;;;1,0;;;;;;28,0;;;4,0;;;;9,0;3,0;;3,0;;;1,0;73,0;;;;1,0;;;16,0;15,0;3,0;1,0;1,0;;;;;;;;;;;1,0;;;;;;;;15,0;;;52,0;;;2,0;;;;1,0;;27,0;6,0;17,0;;4,0;;9,0;6,0;1,0;5,0;;4,0;21,0;;;;;1,0;22,0;45,0;;14,0;;6,0;;;;;;;;2,0;12,0;2,0;4,0;;4,0;;1,0;2,0;28,0;3,0;;12,0;;13,0;2,0;4,0;5,0;;17,0;11,0;;2,0;5,0;14,0;1,0;4,0;;;;;;3,0;15,0;13,0;4,0;;10,0;1,0;;1,0;;;;;;20,0;7,0;;;2,0;2,0;20,0;1,0;1,0;1,0;6,0;1,0;7,0;;;15,0;27,0;33,0;;3,0;;40,0;;2,0;;68,0;;1,0;6,0;;4,0;2,0;1,0;;;;106,0;13,0;1,0;;20,0;21,0;1,0;2,0;1,0;1,0;5,0;;2,0;11,0;;;1,0;7,0;2,0;1,0;;1,0;9,0;;2,0;;4,0;15,0;2,0;4,0;;;20,0;7,0;2,0;1,0;16,0;;;6,0;;3,0;7,0;3,0;;3,0;5,0;;5,0;3,0;7,0;3,0;;;;;2,0;5,0;1,0;5,0;;6,0;1,0;2,0;;3,0;45,0;;1,0;;51,0;19,0;;;15,0;;1,0;1,0;;4,0;9,0;;;;2,0;3,0;4,0;;;;;;;15,0;;11,0;16,0;;16,0;;;2,0;;;2,0;;1,0;;30,0;;;;;24,0;;85,0;;;;4,0;2,0;;1,0;3,0;;8,0;;;;6,0;21,0;2,0;;;20,0;3,0;;2,0;;;8,0;4,0;47,0;;1,0;;1,0;4,0;1,0;;;;3,0;;;;;8,0;;2,0;29,0;3,0;;;;;2,0;6,0;;;;;;;;;;;23,0;;;1,0;;1,0;26,0;;;1,0;;;;;;;28,0;;;;35,0;1,0;;;4,0;;;;;;15,0;;;;;;;;;;;;1,0;;;4,0;;;;104,0;;;10,0;1,0;;;;;1,0;;;1,0;;;;1,0;;;;;2,0;;;;;;1,0;5,0;;;;2,0;11,0;;3,0;5,0;;;;;2,0;17,0;;;;;10,0;15,0;;;;;;10,0;5,0;;;15,0;;1,0;;2,0;1,0;;;1,0;;;8,0;;1,0;2,0;1,0;;;;11,0;;1,0;;;9,0;;;5,0;;;;;1,0;;1,0;9,0;7,0;;6,0;;2,0;;;;;8,0;;;;;;;2,0;;;10,0;;;;;21,0;2,0;;25,0;;;;1,0;;;;1,0;2,0;;;;2,0;;;;;4,0;;1,0;;1,0;;;1,0;;;;1,0;;3,0;;;;;;;;8,0;;;;;;4,0;1,0;;;;;;1,0;;;;5,0;;1,0;;;;;;;3,0;19,0;;;1,0;;14,0;;3,0;;;;;;2,0;12,0;;4,0;;;;;1,0;;;;;;;;;1,0;;;;;1,0;;;;6,0;;;1,0;;;;2,0;;5,0;6,0;;;;;;;6,0;;;;;;;4,0;;;;;;;;;4,0;;;;;;;;;1,0
combine;;2,0;;;;7,0;;38,0;9,0;5,0;20,0;;3,0;;3,0;18,0;19,0;3,0;;;1,0;59,0;;4,0;;2,0;32,0;14,0;;9,0;9,0;;58,0;;2,0;5,0;15,0;2,0;37,0;;156,0;1,0;12,0;16,0;9,0;4,0;11,0;51,0;55,0;47,0;2,0;16,0;;;;13,0;28,0;11,0;22,0;1,0;3,0;;30,0;11,0;47,0;3,0;10,0;84,0;84,0;3,0;15,0;;110,0;;;7,0;8,0;;2,0;857,0;11,0;29,0;3,0;57,0;6,0;8,0;6,0;;;6,0;56,0;;2,0;1,0;5,0;3,0;;;73,0;3,0;1,0;1,0;32,0;32,0;;11,0;28,0;7,0;71,0;31,0;1,0;56,0;12,0;;;117,0;102,0;30,0;1,0;6,0;;3,0;17,0;75,0;42,0;4,0;;;;19,0;;6,0;2,0;7,0;3,0;4,0;9,0;9,0;6,0;1,0;34,0;;;67,0;;2,0;;6,0;76,0;5,0;1,0;;17,0;21,0;21,0;;21,0;2,0;6,0;6,0;;1,0;80,0;;;;33,0;42,0;7,0;5,0;4,0;;;11,0;3,0;16,0;5,0;2,0;;;1,0;9,0;;;22,0;7,0;;6,0;1,0;;;2,0;;5,0;;5,0;3,0;;;4,0;;;17,0;19,0;;;1,0;;15,0;10,0;4,0;30,0;5,0;;;;;;1,0;5,0;11,0;;;1,0;;;5,0;;59,0;;32,0;;;3,0;;1,0;2,0;3,0;1,0;7,0;20,0;;2,0;4,0;10,0;5,0;;2,0;78,0;;5,0;;;;;;11,0;9,0;;1,0;;1,0;1,0;23,0;;4,0;6,0;;4,0;;2,0;9,0;4,0;;9,0;1,0;1,0;9,0;1,0;33,0;;;1,0;2,0;;16,0;6,0;7,0;1,0;1,0;5,0;3,0;;;;;10,0;;;1,0;;4,0;;;;;;9,0;9,0;2,0;;3,0;4,0;;;;;;;4,0;;;;;3,0;1,0;;;;4,0;1,0;;;;;;;7,0;;11,0;;1,0;;6,0;1,0;4,0;;2,0;4,0;11,0;;;;1,0;;;;11,0;1,0;6,0;;;;;;;;1,0;;4,0;;;;;;;;;3,0;4,0;2,0;;5,0;1,0;;12,0;;;;9,0;1,0;4,0;5,0;;;1,0;;;;3,0;6,0;;;;;;10,0;5,0;8,0;14,0;2,0;;6,0;15,0;7,0;;3,0;1,0;2,0;;1,0;;1,0;1,0;3,0;5,0;;2,0;;4,0;;6,0;4,0;6,0;12,0;;6,0;8,0;21,0;;4,0;26,0;6,0;;1,0;;1,0;;2,0;2,0;10,0;;;;;7,0;1,0;10,0;;2,0;3,0;;2,0;2,0;;;;;6,0;1,0;8,0;1,0;;4,0;;1,0;1,0;9,0;3,0;1,0;;;4,0;7,0;;2,0;8,0;6,0;4,0;6,0;;;4,0;1,0;;;;2,0;1,0;1,0;3,0;1,0;;1,0;;;4,0;;6,0;;2,0;25,0;;;8,0;;;;1,0;;;;1,0;5,0;;1,0;15,0;;16,0;8,0;;2,0;1,0;;1,0;;1,0;8,0;;2,0;;2,0;1,0;2,0;;32,0;3,0;;;;;;1,0;1,0;3,0;1,0;;1,0;;1,0;;2,0;5,0;5,0;;3,0;;5,0;;;7,0;;9,0;;3,0;2,0;;1,0;;8,0;1,0;2,0;;12,0;18,0;4,0;;3,0;;;;;1,0;;;;;;32,0;;1,0;;1,0;;1,0;8,0;3,0;;;;;1,0;4,0;;;;;2,0;;;2,0;;;6,0;1,0;;31,0;7,0;1,0;;;;;53,0;;1,0;1,0;;2,0;;1,0;;;5,0;6,0;;;;1,0;1,0;;;;;;;;;;;;;;;4,0;4,0;;13,0;;;2,0;;;;;15,0;;1,0;1,0;1,0;;;4,0;1,0;;16,0;;5,0;;;;1,0;3,0;;;;1,0;3,0;1,0;;;;;2,0;6,0;1,0;7,0;12,0;6,0;4,0;;;;1,0;;;;;;;2,0;;;;;;4,0;;;3,0;4,0;;;1,0;3,0;;;;;;5,0;;;7,0;;;;;1,0;6,0;;;;1,0;;;;;;4,0;;;1,0;;1,0;;4,0;4,0;;;;;5,0;6,0;;2,0;;;14,0;1,0;;2,0;1,0;2,0;;7,0;1,0;4,0;2,0;2,0;2,0;10,0;;;;;;;1,0;1,0;3,0;;1,0;1,0;;;;;5,0;;1,0;11,0;;;1,0;;3,0;;;;9,0;;3,0;2,0;2,0;12,0;1,0;;;;;8,0;;;7,0;;;;;;;1,0;;;;;;2,0;;1,0;1,0;;;1,0;3,0;;;;;1,0;;;;;;6,0;;4,0;1,0;;;1,0;;;;;;;;;;;1,0;;2,0;;;;;;1,0;25,0;;;;;;1,0;1,0;1,0;;;;;2,0;;;;;;;;;;;;2,0;;22,0;;;;;14,0;2,0;;;;3,0;;;;;;;;;;;8,0;;;;1,0;;1,0;;;1,0;2,0;1,0;13,0;;;;;;;;2,0;;;;2,0;2,0;;;;;1,0;;;3,0;;;19,0;;14,0;14,0;;1,0;32,0;;;;1,0;;;;;1,0;;;;;;;;;
command;;42,0;;5,0;4,0;4,0;;52,0;7,0;;;;38,0;;1,0;121,0;;;;;1,0;59,0;2,0;;2,0;;1,0;1,0;;3,0;31,0;5,0;58,0;;285,0;32,0;2,0;;;;116,0;;1,0;2,0;31,0;7,0;77,0;215,0;21,0;31,0;;11,0;2,0;;38,0;;18,0;;;7,0;;4,0;2,0;9,0;1,0;;15,0;3,0;15,0;;41,0;;71,0;2,0;;1,0;38,0;1,0;3,0;177,0;;88,0;3,0;78,0;;16,0;66,0;;;;76,0;1,0;35,0;;;3,0;31,0;;109,0;14,0;3,0;13,0;10,0;19,0;;;21,0;4,0;34,0;8,0;;30,0;;;;33,0;18,0;28,0;6,0;46,0;10,0;;;22,0;57,0;28,0;;1,0;;12,0;22,0;;3,0;;5,0;7,0;1,0;88,0;1,0;;5,0;5,0;49,0;38,0;2,0;;;5,0;154,0;2,0;2,0;;11,0;39,0;;;73,0;;9,0;61,0;12,0;98,0;168,0;;2,0;1,0;75,0;10,0;;;20,0;;;;1,0;7,0;4,0;;;;;79,0;;;;9,0;;4,0;;;;1,0;;7,0;;;14,0;;1,0;;;;2,0;8,0;;;;;1,0;;;;;;;;;;2,0;;;;;1,0;;;;;11,0;;8,0;;9,0;6,0;;4,0;21,0;;;;;;;4,0;;;;;;;;;;;;2,0;276,0;;;;;;;17,0;;;;;21,0;;;4,0;4,0;;;;28,0;;;;33,0;8,0;6,0;;;27,0;;11,0;;;8,0;1,0;16,0;;;;4,0;;;;2,0;1,0;;;;;;21,0;;;;4,0;;;;3,0;3,0;2,0;;2,0;;;;;30,0;;;;;8,0;;;;;;18,0;;;;;;;;2,0;8,0;2,0;;6,0;;2,0;;;11,0;;;;4,0;10,0;23,0;1,0;;;;;;;;;;;;;;6,0;8,0;;1,0;;4,0;6,0;;;8,0;;;4,0;;;;27,0;;8,0;;;;32,0;;;;;;;22,0;24,0;1,0;1,0;;4,0;8,0;10,0;15,0;6,0;44,0;;9,0;;;;1,0;;;2,0;;1,0;4,0;4,0;4,0;;;5,0;;56,0;;2,0;14,0;;3,0;4,0;40,0;;;4,0;1,0;3,0;15,0;14,0;23,0;43,0;16,0;14,0;50,0;;;3,0;;68,0;27,0;2,0;;;3,0;2,0;11,0;5,0;;2,0;12,0;14,0;;5,0;;;17,0;8,0;166,0;4,0;;6,0;;;30,0;;4,0;7,0;8,0;;;;;;;;1,0;63,0;6,0;;13,0;6,0;42,0;;5,0;11,0;9,0;4,0;13,0;3,0;4,0;;5,0;5,0;;3,0;2,0;6,0;2,0;;;4,0;;;6,0;48,0;;17,0;4,0;21,0;24,0;;;3,0;1,0;;8,0;1,0;1,0;;24,0;6,0;6,0;7,0;;;2,0;;;8,0;1,0;37,0;;29,0;9,0;;;;;;;;;6,0;;1,0;;;;;7,0;41,0;4,0;17,0;15,0;;5,0;;;4,0;;;20,0;5,0;;;;;22,0;;;9,0;2,0;10,0;;;;;2,0;;;;;;;2,0;31,0;11,0;;5,0;1,0;;2,0;;11,0;;;;2,0;;;;3,0;1,0;;1,0;;8,0;19,0;;3,0;12,0;;11,0;;;;9,0;2,0;2,0;;;3,0;4,0;10,0;2,0;;15,0;2,0;6,0;35,0;;12,0;109,0;;29,0;;;1,0;;;;;;;6,0;;2,0;;;;;;18,0;;;4,0;;;;;;;;;;1,0;;;;14,0;;;;;;;;3,0;2,0;1,0;;;;;;3,0;2,0;;;4,0;4,0;;;;;2,0;4,0;;;;;;;;;;;1,0;;;;;;;2,0;;;5,0;;;;;1,0;;;;1,0;;;;;;;;;;;;;;;2,0;;;;;1,0;;;;;;3,0;;;;;;;;;;1,0;4,0;7,0;;;;1,0;3,0;1,0;1,0;18,0;;;;;;;;;;;;1,0;;;;;;;1,0;6,0;;;;1,0;;1,0;4,0;;1,0;;1,0;;1,0;1,0;;4,0;;1,0;1,0;;;;;;;7,0;;;;2,0;;2,0;2,0;;17,0;;1,0;7,0;;;;59,0;3,0;;1,0;1,0;;2,0;3,0;4,0;1,0;;1,0;;;;;;;;;1,0;;2,0;;;1,0;;;1,0;;;;5,0;;6,0;;;2,0;;;;1,0;;;;;3,0;;;2,0;;4,0;;2,0;;;;;;;;;;2,0;;;;4,0;;;;;43,0;;1,0;;;1,0;;;;2,0;4,0;8,0;;;;3,0;;;;;;;;3,0;;;;;;;;;;;;;;5,0;;;2,0;;;;12,0;;;;;;;;;;1,0;;4,0;;;;;;;;;;;2,0;;;;;;;;1,0;
communicate;;19,0;;;;;8,0;37,0;7,0;6,0;;;4,0;;;15,0;;;;;;6,0;1,0;8,0;;;3,0;;1,0;;11,0;;71,0;;66,0;17,0;3,0;1,0;2,0;;61,0;;22,0;2,0;1,0;2,0;2,0;145,0;9,0;39,0;1,0;1,0;;;;;11,0;;;;3,0;13,0;6,0;10,0;4,0;2,0;;5,0;5,0;;3,0;;1,0;;;;13,0;;;51,0;;16,0;;32,0;;11,0;4,0;;2,0;3,0;52,0;1,0;;;3,0;1,0;8,0;;35,0;5,0;1,0;;24,0;4,0;;22,0;4,0;;5,0;1,0;;4,0;1,0;;;11,0;16,0;19,0;27,0;2,0;;;1,0;4,0;44,0;9,0;;;;2,0;;1,0;;;;2,0;4,0;3,0;;;6,0;6,0;;4,0;8,0;;;6,0;58,0;;;;2,0;18,0;1,0;1,0;45,0;;;8,0;;11,0;71,0;;;3,0;11,0;6,0;;;2,0;;2,0;1,0;2,0;1,0;7,0;2,0;;1,0;3,0;41,0;;18,0;;15,0;;4,0;;;1,0;;;10,0;;10,0;8,0;;;1,0;;;;1,0;;;;2,0;7,0;2,0;;;;;;;19,0;2,0;;59,0;7,0;2,0;5,0;7,0;;;;;22,0;;3,0;;7,0;12,0;2,0;;1,0;8,0;5,0;4,0;;1,0;;1,0;;;;;;;;;;;12,0;;70,0;;;;;;;;;;3,0;;2,0;;2,0;4,0;19,0;;;1,0;;1,0;;20,0;5,0;8,0;6,0;;;3,0;1,0;;;4,0;6,0;;;;1,0;;;;7,0;;;12,0;6,0;;;;;;3,0;2,0;;;;;1,0;;;7,0;;2,0;2,0;;;2,0;;;;;;;;;;;;4,0;;3,0;;1,0;1,0;;;;;3,0;;;;6,0;;1,0;;2,0;4,0;;;10,0;7,0;;;6,0;;;1,0;1,0;;;31,0;;;;;1,0;1,0;;;;;;;;4,0;4,0;;;4,0;;;;5,0;7,0;3,0;;;3,0;;;3,0;2,0;;;6,0;9,0;;;;;;;9,0;1,0;;;5,0;;;;;;;;2,0;;;;;;;;;5,0;17,0;1,0;1,0;;1,0;1,0;;;;2,0;1,0;;28,0;7,0;2,0;;4,0;2,0;;;;;;1,0;19,0;;;;;;;3,0;;;;;;2,0;1,0;;1,0;;10,0;;;;;1,0;3,0;;;5,0;;;6,0;;2,0;;2,0;;;1,0;;;;1,0;55,0;;1,0;2,0;13,0;3,0;;;;;;;;4,0;;8,0;3,0;;5,0;11,0;;;1,0;;7,0;5,0;;;2,0;2,0;1,0;5,0;4,0;;5,0;7,0;;;2,0;;;;;;;;;;2,0;6,0;;2,0;4,0;;;3,0;3,0;;;;1,0;3,0;3,0;1,0;4,0;1,0;;7,0;;125,0;18,0;;;4,0;1,0;;;14,0;2,0;1,0;;;;2,0;;;4,0;;;;1,0;3,0;3,0;;;3,0;;;4,0;;4,0;;;;2,0;5,0;;2,0;;;;;;10,0;2,0;5,0;2,0;;;;16,0;2,0;;;1,0;2,0;2,0;;9,0;5,0;;;;;;;30,0;7,0;2,0;4,0;1,0;;;;;;11,0;;;;1,0;1,0;8,0;62,0;;2,0;;2,0;;;2,0;;;;;;;2,0;;;;;2,0;1,0;3,0;;;;;;;;;;2,0;;;;;13,0;;;;;;;;;;1,0;2,0;;;;4,0;1,0;;;;;;1,0;;;;4,0;;2,0;1,0;;;;;;14,0;;;;;;1,0;;;1,0;;;15,0;;4,0;;;2,0;;;;;;;;;;;;;;;;;;;2,0;;;;;1,0;;;;;;6,0;;;;1,0;;;;1,0;;;4,0;;;;;;;;;;;;;;;;;;;1,0;;;;;;;2,0;;;4,0;;;;1,0;;;;;1,0;;5,0;;;1,0;;;;;;;;;;;;1,0;;2,0;;;;;;;2,0;;;;;;;;2,0;;;;3,0;;;;;;;;;1,0;;;;;;;;;;;;;2,0;;;;;12,0;;;;;2,0;;;;6,0;;;;;;;4,0;2,0;;;2,0;;;;;;2,0;;;;1,0;;;;;;;;;;;;2,0;;;;;;;1,0;;;;;;;4,0;;;;;1,0;;;;;;;;;;;;;;;;;;;;;;;;;;;;;;;;;;;;3,0;;;;;;;;;;;;3,0;;;;1,0;4,0;;
communication;;23,0;1,0;15,0;3,0;12,0;4,0;82,0;6,0;57,0;1,0;;47,0;1,0;8,0;63,0;5,0;;3,0;;3,0;37,0;15,0;83,0;;;4,0;5,0;;;43,0;4,0;168,0;;278,0;144,0;;;22,0;;284,0;;13,0;2,0;42,0;17,0;38,0;892,0;67,0;66,0;14,0;2,0;;;8,0;12,0;33,0;25,0;5,0;;3,0;80,0;3,0;9,0;2,0;;13,0;13,0;19,0;8,0;18,0;4,0;16,0;1,0;;8,0;36,0;2,0;8,0;215,0;13,0;34,0;7,0;179,0;;29,0;90,0;8,0;;1,0;190,0;14,0;5,0;1,0;5,0;3,0;44,0;;102,0;215,0;;4,0;256,0;16,0;;23,0;43,0;5,0;153,0;7,0;;143,0;1,0;2,0;;40,0;15,0;67,0;68,0;37,0;8,0;2,0;19,0;39,0;79,0;11,0;;;4,0;11,0;18,0;27,0;1,0;6,0;2,0;3,0;5,0;30,0;1,0;;8,0;11,0;68,0;45,0;6,0;;;1,0;263,0;2,0;7,0;;17,0;18,0;7,0;13,0;390,0;;11,0;86,0;9,0;162,0;819,0;;;;81,0;4,0;2,0;3,0;2,0;;;1,0;4,0;5,0;39,0;;;;1,0;171,0;;12,0;8,0;24,0;;68,0;;;3,0;;;83,0;;141,0;15,0;;;1,0;4,0;1,0;;9,0;;1,0;3,0;3,0;4,0;12,0;;;;;;;2,0;;;13,0;53,0;2,0;8,0;;;26,0;3,0;;72,0;;24,0;;9,0;28,0;5,0;1,0;5,0;21,0;9,0;2,0;3,0;18,0;3,0;24,0;;;;2,0;2,0;1,0;4,0;;;;;1,0;294,0;;;;;;5,0;31,0;1,0;;;4,0;3,0;;2,0;29,0;21,0;;;;44,0;;1,0;11,0;17,0;34,0;62,0;;;71,0;3,0;12,0;1,0;1,0;25,0;12,0;2,0;;11,0;;;;4,0;;9,0;12,0;3,0;;2,0;1,0;;3,0;4,0;;4,0;4,0;1,0;;18,0;5,0;;45,0;;43,0;2,0;6,0;1,0;2,0;;5,0;5,0;;;;;4,0;;20,0;;48,0;;2,0;4,0;1,0;;;1,0;15,0;;49,0;;6,0;6,0;1,0;;1,0;10,0;12,0;;1,0;3,0;27,0;49,0;7,0;1,0;;;;;;;4,0;4,0;;;;;6,0;2,0;;;;1,0;1,0;;;2,0;11,0;;9,0;;;;14,0;2,0;7,0;;1,0;;35,0;;;2,0;1,0;;;20,0;18,0;1,0;;;1,0;11,0;4,0;35,0;2,0;;;35,0;;1,0;;;;;1,0;16,0;3,0;5,0;;;4,0;;10,0;1,0;51,0;31,0;;65,0;;;1,0;44,0;;14,0;;3,0;2,0;100,0;22,0;53,0;2,0;1,0;29,0;;;;;88,0;36,0;64,0;;;2,0;10,0;;;6,0;;;6,0;2,0;1,0;1,0;;;9,0;;67,0;1,0;;;6,0;6,0;8,0;6,0;3,0;5,0;6,0;3,0;;;;;;7,0;16,0;26,0;;9,0;14,0;;164,0;;8,0;;31,0;6,0;7,0;;;1,0;6,0;2,0;;12,0;1,0;38,0;7,0;3,0;4,0;20,0;;;19,0;2,0;19,0;10,0;;;6,0;10,0;2,0;27,0;6,0;;14,0;51,0;;5,0;33,0;2,0;7,0;1,0;5,0;;;;;1,0;;20,0;6,0;15,0;33,0;;6,0;;13,0;7,0;;14,0;;;12,0;17,0;4,0;1,0;;41,0;125,0;;27,0;;4,0;6,0;18,0;9,0;1,0;59,0;;18,0;1,0;;1,0;20,0;;1,0;35,0;;;;3,0;5,0;5,0;11,0;;;3,0;;14,0;;;2,0;10,0;5,0;5,0;15,0;1,0;3,0;14,0;;91,0;;9,0;6,0;;1,0;55,0;4,0;3,0;1,0;146,0;4,0;1,0;1,0;;2,0;1,0;;12,0;6,0;1,0;;3,0;;;2,0;43,0;5,0;10,0;2,0;15,0;18,0;7,0;1,0;5,0;16,0;5,0;;;1,0;1,0;10,0;71,0;722,0;;1,0;4,0;4,0;;2,0;4,0;;;1,0;;1,0;24,0;;;1,0;2,0;;5,0;8,0;23,0;;1,0;11,0;;;;;;;24,0;1,0;;;;6,0;4,0;1,0;;;;2,0;4,0;;;;3,0;;8,0;;17,0;;;;;6,0;;1,0;1,0;;;3,0;1,0;;;;;;;;9,0;;1,0;1,0;;20,0;;;;;;3,0;19,0;;1,0;;;2,0;12,0;;2,0;5,0;;;10,0;;;;;;;2,0;;;;;3,0;;;;;9,0;;;;;;14,0;1,0;;10,0;;1,0;;;;;;5,0;;;2,0;;;;;;8,0;;;;;;;;;;1,0;;1,0;;2,0;;;8,0;;;1,0;;;;;;;2,0;;;;;;;;5,0;;1,0;1,0;;;;;;;;;;;;3,0;;;4,0;;;1,0;1,0;9,0;;1,0;;1,0;1,0;;15,0;;3,0;1,0;1,0;2,0;4,0;2,0;;;1,0;;1,0;3,0;;;;;2,0;27,0;;3,0;;;1,0;28,0;;;;296,0;1,0;;;;;;1,0;2,0;1,0;;;;;;1,0;11,0;;1,0;;;;;;;;;;1,0;;;1,0;;;2,0;;;3,0;;5,0;;8,0;3,0;2,0;2,0;;;;;3,0;;;;;2,0;;;;;;;1,0;;1,0;;;;;;1,0;;;;;5,0;;;12,0;;;;8,0;;;;;;;;;;;;;;;;;2,0;;;;;;9,0;;;;;3,0;10,0;;;;;2,0;
compartment;;1,0;;;;9,0;;3,0;2,0;4,0;;;5,0;;1,0;3,0;;;;;;;;2,0;;;;;;;;;28,0;;4,0;;;;;;1,0;;8,0;;;;1,0;9,0;9,0;6,0;2,0;;;1,0;;;9,0;;;;6,0;2,0;;;;;;6,0;;3,0;;;;;;;;;1,0;8,0;;;;16,0;;;1,0;;;1,0;5,0;;;4,0;;;;;5,0;;;;1,0;;1,0;;;6,0;;;1,0;;;;;33,0;9,0;9,0;12,0;;;;;;2,0;;;;;;;1,0;3,0;2,0;;;4,0;;;;;;;;;;;6,0;6,0;7,0;;;2,0;;;;5,0;;;;;;1,0;;;;29,0;4,0;3,0;;;;;1,0;;;;;;;;8,0;;5,0;3,0;1,0;;4,0;;;;;;21,0;;;;;;10,0;;;;4,0;;;;;;;;;;2,0;;;;;;;48,0;;5,0;1,0;;11,0;;;1,0;;6,0;;4,0;6,0;1,0;6,0;6,0;9,0;1,0;6,0;;5,0;;;;;;;;;1,0;;;;;;2,0;;;;;;1,0;3,0;;;4,0;;;;;2,0;7,0;;;;;4,0;;1,0;2,0;;;;;;;;;1,0;19,0;;;;9,0;;;;2,0;2,0;;1,0;1,0;;;;9,0;;;;;;;;7,0;;;;;3,0;;1,0;;;;2,0;;;;;;;;1,0;;;;;13,0;2,0;;;;;;2,0;1,0;;;;;;;;;;;1,0;1,0;;;;;;;;;8,0;;;1,0;3,0;;;;;;;;;1,0;2,0;;;;;1,0;;;4,0;;;;;;;;1,0;;;;;3,0;6,0;;;;;;;;;;;;;;;1,0;;;6,0;2,0;;;;;;;;;1,0;;;2,0;;;1,0;;;2,0;;;;;1,0;;;3,0;;;;;;1,0;;3,0;;;;;;1,0;;;;;;;;;;;;3,0;;;;;;;2,0;;1,0;;;;;;;;;;;2,0;;;;;;6,0;1,0;;;;;;;;;;4,0;;;;;;;;;;6,0;;;;;;;;;;;7,0;;;;;;;;;;;;;;;;;;;;;;;;1,0;110,0;;1,0;;;15,0;;;3,0;;;;;;;1,0;9,0;;;2,0;;;;;1,0;;;;;;;;;;;;5,0;1,0;;;1,0;1,0;2,0;32,0;;1,0;;;;;7,0;;;;;;;1,0;;;;;;;;;;;23,0;;;1,0;;;;;10,0;;;;;;;6,0;;3,0;;;;;;;;;;;14,0;1,0;;;;4,0;;;;;;;;;;;;;1,0;;;;;;;;;;;;;;;;;;;;;;;;1,0;1,0;;;;4,0;6,0;3,0;;;;;;;1,0;;;;;;;;;;;;;;;;;;;;;;;;;;;;;;;;;;;;;;;;;;;;1,0;;;;;;;;;;;;;;2,0;;;;;;;;;;1,0;;;;;;;;;;;;;;;;;;;;;;;;;;;;;;;;1,0;;;;;;;;;;;;;;;;;;;;;;;;;;;;;;;;;;4,0;;;;;;;;;;;;;;;;;;;2,0;;;;;;;;;;;;;;;;;;;;;;;;;;;;;;;;;;;;;;;;;;;;;;;;2,0;;;;;;;;;;;;;;;;;;;;;;;;;;;;;;;;;;;;;;;;;;;;;;;;;;;;;;;;;;;;;;;;;;;;;;;;;;8,0;;;;;;;;;;;;;;;
component;;6,0;3,0;2,0;12,0;19,0;15,0;80,0;95,0;61,0;32,0;;21,0;;16,0;209,0;9,0;9,0;18,0;;3,0;98,0;2,0;28,0;19,0;18,0;457,0;11,0;10,0;1,0;11,0;70,0;169,0;4,0;96,0;13,0;15,0;11,0;5,0;;174,0;4,0;26,0;18,0;70,0;34,0;49,0;165,0;74,0;139,0;52,0;28,0;27,0;46,0;9,0;77,0;56,0;7,0;29,0;;5,0;14,0;34,0;;142,0;71,0;29,0;92,0;11,0;23,0;51,0;1,0;111,0;2,0;;18,0;9,0;13,0;123,0;704,0;9,0;66,0;1,0;253,0;1,0;6,0;14,0;3,0;1,0;28,0;257,0;1,0;2,0;17,0;4,0;8,0;22,0;;114,0;7,0;6,0;2,0;135,0;50,0;13,0;22,0;248,0;2,0;82,0;31,0;29,0;31,0;16,0;6,0;;242,0;102,0;85,0;37,0;32,0;4,0;9,0;43,0;178,0;40,0;4,0;;4,0;18,0;52,0;;34,0;29,0;22,0;34,0;6,0;24,0;10,0;15,0;18,0;17,0;2,0;8,0;132,0;18,0;;1,0;65,0;319,0;3,0;36,0;1,0;10,0;50,0;8,0;7,0;242,0;;10,0;17,0;8,0;19,0;162,0;2,0;8,0;;63,0;21,0;6,0;4,0;12,0;6,0;6,0;17,0;21,0;22,0;59,0;17,0;;26,0;34,0;46,0;2,0;24,0;;74,0;3,0;;;1,0;19,0;;3,0;133,0;9,0;13,0;8,0;75,0;3,0;42,0;19,0;1,0;14,0;132,0;25,0;9,0;4,0;28,0;27,0;25,0;3,0;;11,0;1,0;10,0;32,0;4,0;11,0;6,0;;180,0;3,0;13,0;19,0;1,0;13,0;12,0;;307,0;17,0;18,0;27,0;6,0;273,0;5,0;25,0;18,0;38,0;26,0;5,0;5,0;26,0;10,0;21,0;6,0;;11,0;1,0;235,0;47,0;12,0;52,0;5,0;1,0;11,0;;120,0;17,0;6,0;6,0;14,0;7,0;31,0;50,0;1,0;;16,0;32,0;3,0;;3,0;15,0;29,0;;1,0;50,0;;69,0;40,0;147,0;20,0;1,0;3,0;;;24,0;3,0;2,0;;11,0;17,0;64,0;57,0;1,0;16,0;;18,0;7,0;16,0;5,0;26,0;10,0;47,0;;11,0;1,0;12,0;25,0;35,0;4,0;;17,0;5,0;;9,0;6,0;4,0;23,0;7,0;103,0;4,0;1,0;5,0;47,0;18,0;13,0;7,0;3,0;16,0;;5,0;53,0;2,0;82,0;5,0;242,0;9,0;28,0;19,0;10,0;;6,0;11,0;12,0;1,0;5,0;11,0;10,0;15,0;19,0;;21,0;25,0;;;7,0;8,0;26,0;6,0;78,0;1,0;7,0;;6,0;5,0;25,0;6,0;10,0;9,0;1,0;1,0;;6,0;1,0;2,0;12,0;10,0;9,0;22,0;27,0;3,0;1,0;6,0;9,0;7,0;1,0;1,0;;8,0;131,0;3,0;21,0;6,0;3,0;10,0;30,0;2,0;3,0;12,0;;2,0;;2,0;57,0;3,0;;;;19,0;101,0;26,0;7,0;13,0;4,0;19,0;2,0;2,0;1,0;2,0;;;;62,0;12,0;;3,0;2,0;6,0;7,0;;1,0;29,0;66,0;41,0;7,0;2,0;12,0;4,0;19,0;3,0;13,0;101,0;13,0;8,0;30,0;17,0;8,0;;12,0;4,0;1,0;4,0;11,0;4,0;23,0;14,0;1,0;20,0;;1,0;15,0;;;4,0;;2,0;3,0;;19,0;;;7,0;33,0;;17,0;5,0;62,0;2,0;3,0;3,0;84,0;25,0;13,0;8,0;14,0;;;3,0;7,0;2,0;3,0;14,0;2,0;9,0;9,0;2,0;2,0;1,0;23,0;;32,0;;6,0;5,0;12,0;;;19,0;13,0;5,0;5,0;3,0;2,0;;2,0;2,0;3,0;;6,0;5,0;9,0;6,0;;28,0;12,0;;25,0;16,0;;13,0;;1,0;14,0;27,0;;3,0;11,0;10,0;;;;1,0;;8,0;;3,0;36,0;6,0;;11,0;5,0;25,0;4,0;40,0;;10,0;;3,0;26,0;2,0;5,0;17,0;12,0;21,0;11,0;4,0;4,0;68,0;13,0;;43,0;;17,0;;7,0;13,0;18,0;;4,0;;;7,0;;;3,0;23,0;;;6,0;3,0;;1,0;;12,0;12,0;1,0;1,0;;2,0;1,0;33,0;2,0;4,0;5,0;18,0;7,0;7,0;4,0;;;;;5,0;2,0;6,0;;;3,0;;2,0;3,0;;;17,0;15,0;1,0;28,0;;13,0;5,0;7,0;;4,0;49,0;2,0;1,0;7,0;5,0;9,0;;4,0;5,0;1,0;4,0;1,0;5,0;2,0;;17,0;;1,0;83,0;;2,0;7,0;8,0;4,0;2,0;;2,0;4,0;5,0;;12,0;31,0;;4,0;7,0;1,0;;;4,0;1,0;8,0;2,0;5,0;;1,0;14,0;1,0;1,0;2,0;16,0;;1,0;68,0;;1,0;;5,0;;;;1,0;;7,0;;;12,0;;;2,0;11,0;;3,0;12,0;2,0;8,0;2,0;13,0;6,0;;;51,0;;6,0;;;;;4,0;69,0;2,0;5,0;;13,0;20,0;1,0;;29,0;16,0;;;;6,0;4,0;6,0;;1,0;10,0;1,0;7,0;;3,0;4,0;11,0;1,0;20,0;22,0;;;1,0;7,0;3,0;4,0;1,0;2,0;;1,0;;;;;12,0;3,0;;;2,0;;;;4,0;3,0;179,0;;1,0;1,0;;2,0;2,0;;1,0;;1,0;1,0;;;;16,0;1,0;5,0;;;2,0;;;;7,0;2,0;;17,0;49,0;58,0;15,0;4,0;23,0;33,0;1,0;140,0;5,0;1,0;250,0;;1,0;;4,0;43,0;;41,0;18,0;7,0;;10,0;2,0;1,0;12,0;10,0;;17,0;;6,0;8,0;;1,0;7,0;14,0;13,0;2,0;;;5,0;1,0;1,0;;;1,0;13,0;;;;;;1,0;1,0;2,0;2,0;;1,0;;1,0;2,0;;6,0;;84,0;10,0;7,0;;;;;2,0;1,0;;;17,0;;4,0;2,0;3,0;;;;;10,0;;2,0;8,0;;;3,0;;;8,0;1,0;2,0;1,0;1,0;;9,0;5,0;;8,0;;9,0;;;18,0;2,0;1,0;;;10,0;2,0;2,0;;10,0;;;5,0;;1,0;;5,0;;2,0;;;;;6,0;26,0;2,0;1,0;8,0;20,0;;7,0;;;;;3,0;4,0;1,0;;11,0;;7,0;2,0;1,0;;;;3,0;2,0;1,0;4,0;5,0;;3,0;10,0;3,0;20,0;7,0;;;;;3,0;;3,0;2,0;1,0;4,0;;;1,0;;7,0;;;1,0;12,0;;1,0;1,0;3,0;3,0;;2,0;3,0;;;;;;2,0;;
configuration;;2,0;1,0;;;3,0;3,0;15,0;20,0;10,0;3,0;;23,0;;1,0;44,0;4,0;;;;3,0;66,0;11,0;;;;22,0;;;;8,0;;58,0;2,0;36,0;20,0;;1,0;;1,0;114,0;;2,0;2,0;6,0;3,0;31,0;109,0;36,0;20,0;3,0;;;;1,0;15,0;38,0;;3,0;9,0;4,0;5,0;14,0;24,0;12,0;2,0;;24,0;31,0;1,0;9,0;1,0;8,0;;1,0;20,0;4,0;;5,0;104,0;;13,0;2,0;101,0;3,0;2,0;1,0;;;2,0;55,0;1,0;;;1,0;11,0;10,0;;76,0;8,0;4,0;7,0;84,0;15,0;;4,0;;6,0;3,0;15,0;;8,0;1,0;;;18,0;15,0;22,0;9,0;12,0;2,0;;10,0;46,0;18,0;1,0;;;;2,0;;3,0;7,0;3,0;2,0;6,0;1,0;9,0;1,0;;3,0;5,0;1,0;26,0;19,0;;;25,0;7,0;4,0;1,0;2,0;5,0;32,0;;3,0;87,0;;1,0;10,0;5,0;17,0;29,0;;5,0;;90,0;20,0;;;6,0;;;1,0;2,0;;6,0;;;1,0;2,0;6,0;;;8,0;27,0;;14,0;;;;;;6,0;1,0;;;1,0;;13,0;;;1,0;6,0;;;1,0;;3,0;5,0;;2,0;;2,0;;1,0;3,0;;1,0;12,0;24,0;;;;;;10,0;;27,0;;13,0;1,0;;17,0;4,0;9,0;;21,0;;1,0;;1,0;;16,0;;;;1,0;17,0;;1,0;;4,0;;;;49,0;5,0;;;;7,0;;12,0;;;3,0;;1,0;;3,0;14,0;7,0;;;1,0;5,0;1,0;1,0;12,0;2,0;;2,0;;;4,0;;;;;7,0;3,0;;;1,0;1,0;1,0;;;;2,0;3,0;3,0;;2,0;1,0;;11,0;2,0;;;23,0;;;16,0;1,0;7,0;1,0;3,0;8,0;;1,0;;;4,0;;1,0;;;;;;;;5,0;5,0;;3,0;1,0;2,0;;;;;;;1,0;;;13,0;;2,0;;2,0;;1,0;;2,0;;;1,0;2,0;;;;;;;3,0;4,0;;;;6,0;2,0;;1,0;;;2,0;;;2,0;1,0;;6,0;;;;14,0;2,0;;;3,0;;2,0;3,0;1,0;2,0;;;;2,0;22,0;;;;2,0;;1,0;16,0;2,0;;6,0;;;;;;;;16,0;;1,0;;16,0;;;;;;14,0;;1,0;3,0;;1,0;;21,0;;2,0;19,0;1,0;;50,0;;10,0;;4,0;1,0;;3,0;3,0;;1,0;3,0;3,0;16,0;;5,0;;;;;;;2,0;;;;;;;16,0;36,0;;;;;1,0;19,0;1,0;14,0;1,0;;;1,0;;8,0;;;10,0;;6,0;;2,0;;;12,0;3,0;10,0;;;;3,0;;1,0;;22,0;22,0;;;;;32,0;;;6,0;;2,0;;;1,0;18,0;5,0;;4,0;1,0;;;38,0;;;8,0;3,0;;5,0;3,0;1,0;;1,0;1,0;;1,0;;;4,0;20,0;1,0;18,0;;;;;9,0;3,0;;;5,0;;2,0;21,0;;;2,0;8,0;5,0;14,0;;;3,0;;;;;4,0;17,0;14,0;;;;;;;2,0;;;1,0;;6,0;;4,0;;;;;9,0;;3,0;1,0;2,0;;;;;5,0;1,0;;;;1,0;;3,0;;1,0;;;23,0;17,0;6,0;13,0;;1,0;;;;16,0;14,0;;;2,0;1,0;;3,0;11,0;8,0;8,0;1,0;;;2,0;;14,0;;1,0;1,0;1,0;;10,0;;;16,0;;;5,0;1,0;;;;;;;4,0;1,0;;;;;;;;;;1,0;;;;;;;;2,0;;;;5,0;;4,0;2,0;1,0;;;;4,0;;1,0;1,0;2,0;;1,0;;;;2,0;1,0;;;;;;;;;11,0;;;1,0;;1,0;;;;;;;;;;1,0;;;;1,0;;;6,0;;;;;;;;;;;2,0;;7,0;;;;;;;2,0;;;24,0;;6,0;4,0;;;4,0;1,0;;2,0;;1,0;;10,0;2,0;;2,0;;;;23,0;;2,0;1,0;;;;5,0;5,0;;;;;;1,0;;;;;;1,0;2,0;;;4,0;;;;;;;;;;;;;;;;;;;;;;4,0;2,0;;;;2,0;4,0;;;;;;;;;;1,0;;;3,0;6,0;;7,0;1,0;;;;;6,0;;2,0;;4,0;;;;;;;;;;3,0;;;;;;;;;1,0;;;1,0;1,0;;;;;1,0;;1,0;8,0;;;;5,0;;;;;;;;;;;5,0;;;;;;;;;;;4,0;2,0;;2,0;;;1,0;;;;1,0;;1,0;;;;;1,0;;;;;;;;;2,0;;;;;;;;;;;;5,0;;1,0;;;;1,0;;3,0;;;;4,0;1,0;;;;2,0;;;;;1,0;;;;;1,0;;;;;;12,0;;;;;;;;;;;;;;;
connect;;45,0;;;3,0;51,0;19,0;190,0;44,0;36,0;49,0;;9,0;;58,0;187,0;71,0;;;1,0;1,0;34,0;11,0;56,0;5,0;;40,0;16,0;4,0;;37,0;1,0;213,0;;308,0;102,0;;5,0;11,0;;164,0;2,0;41,0;15,0;32,0;16,0;40,0;561,0;74,0;134,0;71,0;13,0;;1,0;80,0;43,0;210,0;1,0;4,0;1,0;94,0;125,0;12,0;6,0;42,0;6,0;8,0;151,0;123,0;89,0;8,0;6,0;31,0;1,0;;22,0;8,0;1,0;6,0;350,0;8,0;100,0;;242,0;10,0;7,0;57,0;;5,0;16,0;306,0;;2,0;21,0;5,0;11,0;92,0;1,0;107,0;35,0;3,0;4,0;382,0;22,0;14,0;26,0;65,0;13,0;391,0;2,0;16,0;24,0;13,0;9,0;17,0;313,0;717,0;136,0;170,0;26,0;4,0;2,0;8,0;164,0;158,0;16,0;;;2,0;8,0;4,0;87,0;20,0;4,0;;2,0;56,0;16,0;18,0;;1,0;2,0;10,0;292,0;10,0;;6,0;241,0;373,0;2,0;;14,0;34,0;19,0;11,0;138,0;237,0;;12,0;173,0;1,0;34,0;766,0;4,0;1,0;;130,0;13,0;;;4,0;2,0;15,0;50,0;2,0;7,0;123,0;96,0;1,0;;205,0;279,0;43,0;24,0;27,0;390,0;5,0;133,0;2,0;1,0;5,0;3,0;3,0;;3,0;180,0;3,0;2,0;1,0;32,0;18,0;6,0;5,0;83,0;1,0;99,0;26,0;3,0;2,0;53,0;29,0;15,0;19,0;118,0;12,0;;32,0;16,0;2,0;97,0;239,0;10,0;54,0;3,0;;39,0;74,0;24,0;101,0;;663,0;23,0;28,0;227,0;65,0;10,0;18,0;50,0;36,0;58,0;;70,0;4,0;27,0;3,0;27,0;21,0;;171,0;11,0;265,0;;18,0;1,0;1,0;11,0;131,0;1,0;1,0;;21,0;2,0;27,0;33,0;42,0;2,0;28,0;31,0;45,0;;43,0;212,0;14,0;7,0;;145,0;4,0;57,0;174,0;358,0;227,0;7,0;442,0;15,0;1,0;32,0;2,0;7,0;2,0;14,0;38,0;60,0;7,0;5,0;115,0;;11,0;;294,0;12,0;89,0;23,0;44,0;;28,0;10,0;18,0;42,0;83,0;8,0;;41,0;64,0;12,0;9,0;5,0;21,0;300,0;7,0;59,0;10,0;7,0;4,0;51,0;90,0;9,0;29,0;2,0;;2,0;26,0;32,0;12,0;12,0;7,0;3,0;120,0;41,0;33,0;53,0;29,0;4,0;9,0;5,0;10,0;68,0;35,0;69,0;64,0;75,0;19,0;4,0;2,0;12,0;27,0;78,0;54,0;133,0;21,0;45,0;3,0;11,0;18,0;17,0;53,0;17,0;3,0;28,0;24,0;;2,0;5,0;40,0;3,0;;32,0;41,0;45,0;27,0;20,0;48,0;6,0;20,0;92,0;8,0;7,0;65,0;42,0;;262,0;14,0;6,0;5,0;9,0;38,0;46,0;14,0;5,0;20,0;3,0;3,0;;12,0;40,0;1,0;;;2,0;;1,0;1,0;5,0;4,0;;8,0;5,0;5,0;;;4,0;;4,0;32,0;4,0;;;;17,0;;2,0;7,0;247,0;28,0;17,0;12,0;1,0;7,0;2,0;29,0;3,0;21,0;12,0;33,0;;131,0;31,0;19,0;;5,0;1,0;8,0;;;7,0;3,0;12,0;24,0;;3,0;4,0;21,0;5,0;6,0;;10,0;3,0;3,0;11,0;9,0;28,0;;1,0;21,0;;30,0;1,0;;2,0;88,0;;58,0;12,0;10,0;27,0;13,0;;;;2,0;2,0;12,0;2,0;1,0;2,0;5,0;13,0;7,0;1,0;103,0;5,0;109,0;13,0;7,0;1,0;4,0;1,0;6,0;;47,0;;;11,0;3,0;10,0;3,0;7,0;4,0;8,0;9,0;1,0;2,0;3,0;48,0;14,0;2,0;;7,0;197,0;1,0;44,0;21,0;6,0;6,0;191,0;;28,0;2,0;18,0;13,0;;;22,0;;2,0;1,0;3,0;;;2,0;24,0;25,0;69,0;8,0;;7,0;17,0;2,0;29,0;56,0;10,0;3,0;13,0;47,0;3,0;;7,0;10,0;83,0;15,0;1,0;11,0;1,0;10,0;3,0;10,0;13,0;4,0;14,0;2,0;;;4,0;;7,0;30,0;3,0;;3,0;40,0;11,0;6,0;10,0;3,0;18,0;16,0;3,0;17,0;1,0;12,0;26,0;54,0;3,0;3,0;5,0;9,0;10,0;1,0;1,0;2,0;;10,0;2,0;58,0;24,0;63,0;1,0;5,0;1,0;2,0;;4,0;1,0;17,0;1,0;1,0;51,0;61,0;7,0;14,0;4,0;33,0;14,0;3,0;11,0;10,0;1,0;15,0;26,0;4,0;12,0;2,0;9,0;27,0;1,0;1,0;4,0;4,0;23,0;6,0;7,0;1,0;46,0;6,0;7,0;47,0;25,0;4,0;7,0;11,0;8,0;21,0;6,0;;;32,0;14,0;4,0;17,0;53,0;6,0;54,0;26,0;2,0;;;1,0;3,0;38,0;85,0;6,0;24,0;4,0;44,0;63,0;9,0;39,0;;18,0;17,0;4,0;;;7,0;5,0;2,0;2,0;3,0;47,0;44,0;3,0;4,0;1,0;29,0;;110,0;12,0;42,0;4,0;10,0;23,0;6,0;4,0;;79,0;;20,0;4,0;17,0;21,0;;74,0;30,0;3,0;5,0;32,0;101,0;164,0;20,0;1,0;12,0;;;3,0;4,0;13,0;3,0;27,0;8,0;26,0;9,0;;13,0;6,0;5,0;1,0;3,0;1,0;6,0;3,0;;;7,0;;6,0;19,0;15,0;6,0;10,0;19,0;3,0;9,0;46,0;35,0;3,0;;10,0;1,0;55,0;14,0;10,0;46,0;226,0;10,0;1,0;45,0;13,0;;3,0;7,0;6,0;133,0;1,0;2,0;3,0;;;6,0;;;7,0;;2,0;295,0;7,0;;35,0;3,0;;2,0;5,0;1,0;96,0;3,0;3,0;1,0;2,0;7,0;17,0;;1,0;;;;;;1,0;;;9,0;2,0;1,0;;19,0;1,0;14,0;17,0;;;4,0;;;;13,0;;;5,0;;16,0;8,0;4,0;3,0;;2,0;3,0;4,0;;21,0;;;24,0;;1,0;4,0;;14,0;;;3,0;;;;5,0;;;;1,0;1,0;10,0;;43,0;;;11,0;6,0;2,0;14,0;5,0;41,0;5,0;4,0;31,0;;3,0;2,0;9,0;1,0;2,0;2,0;;;9,0;6,0;3,0;35,0;27,0;;;;1,0;13,0;1,0;1,0;5,0;;;43,0;3,0;72,0;;9,0;;2,0;7,0;7,0;4,0;;1,0;1,0;;2,0;1,0;1,0;21,0;10,0;32,0;41,0;7,0;29,0;;;;;;;3,0;12,0;;69,0;;1,0;;;1,0;;;24,0;;2,0;2,0;5,0;1,0;6,0;1,0;9,0;;19,0;2,0;2,0;;;;;2,0;1,0;;;;4,0;;;16,0;;;;;;;3,0;3,0;;13,0;;;;3,0;1,0;;;;;;;5,0;1,0;;;;1,0;;
connection;;10,0;;3,0;;5,0;1,0;12,0;36,0;15,0;1,0;;3,0;;11,0;35,0;8,0;;2,0;;;11,0;;20,0;;1,0;1,0;5,0;;;20,0;;75,0;;40,0;6,0;;2,0;7,0;;68,0;;13,0;;33,0;12,0;20,0;220,0;25,0;23,0;35,0;6,0;;;10,0;6,0;37,0;;;2,0;16,0;75,0;;3,0;;;;71,0;17,0;6,0;4,0;12,0;7,0;1,0;;3,0;1,0;;2,0;88,0;;33,0;;75,0;;3,0;6,0;;;22,0;28,0;;1,0;6,0;;2,0;5,0;;39,0;12,0;;;111,0;8,0;14,0;5,0;27,0;2,0;57,0;2,0;3,0;5,0;1,0;1,0;8,0;73,0;83,0;18,0;34,0;3,0;3,0;;5,0;9,0;34,0;3,0;;;;1,0;;3,0;;5,0;;2,0;9,0;;;;4,0;15,0;5,0;28,0;15,0;;;26,0;58,0;;;2,0;24,0;11,0;;11,0;107,0;;;12,0;;17,0;216,0;;;;16,0;10,0;;;5,0;;1,0;3,0;2,0;6,0;20,0;3,0;;;22,0;20,0;18,0;7,0;2,0;38,0;;27,0;;;;1,0;;191,0;;37,0;2,0;;;11,0;2,0;;2,0;16,0;;23,0;6,0;;4,0;3,0;1,0;2,0;1,0;1,0;2,0;;2,0;1,0;;17,0;30,0;;5,0;2,0;8,0;1,0;2,0;3,0;2,0;1,0;87,0;8,0;7,0;54,0;2,0;4,0;5,0;18,0;3,0;6,0;;9,0;1,0;11,0;;;1,0;8,0;9,0;6,0;20,0;;1,0;;;;30,0;;3,0;;3,0;;7,0;56,0;8,0;;5,0;4,0;9,0;;;9,0;5,0;;;32,0;4,0;23,0;46,0;73,0;47,0;5,0;101,0;2,0;;13,0;;4,0;;;12,0;2,0;1,0;;2,0;;;;74,0;;20,0;6,0;7,0;2,0;4,0;;1,0;7,0;9,0;;;9,0;8,0;1,0;8,0;;;63,0;;27,0;5,0;2,0;;1,0;8,0;5,0;13,0;1,0;;;2,0;23,0;1,0;14,0;18,0;63,0;36,0;8,0;;4,0;4,0;1,0;2,0;2,0;;4,0;3,0;2,0;9,0;7,0;;9,0;;9,0;;3,0;2,0;75,0;6,0;25,0;4,0;13,0;;8,0;15,0;;;13,0;4,0;;3,0;9,0;3,0;1,0;1,0;14,0;29,0;6,0;21,0;4,0;9,0;;;5,0;4,0;;;5,0;;23,0;5,0;;1,0;;18,0;12,0;;2,0;;3,0;;;7,0;11,0;;;;14,0;3,0;2,0;4,0;4,0;;;2,0;1,0;;;;1,0;;;;;;;;8,0;;;;11,0;3,0;;6,0;;3,0;1,0;11,0;;12,0;1,0;1,0;1,0;45,0;14,0;30,0;;3,0;;1,0;;;1,0;1,0;12,0;8,0;;;4,0;1,0;;;;;;7,0;;1,0;5,0;2,0;;1,0;;12,0;2,0;;;11,0;;6,0;7,0;;3,0;;;4,0;;1,0;;;;;;;4,0;1,0;1,0;49,0;;30,0;;18,0;3,0;;;;;4,0;4,0;1,0;6,0;;27,0;1,0;;6,0;4,0;;4,0;;3,0;50,0;1,0;;;2,0;42,0;7,0;7,0;4,0;;8,0;;;3,0;1,0;3,0;26,0;;;7,0;;;1,0;2,0;;1,0;;6,0;18,0;;7,0;13,0;5,0;1,0;;4,0;8,0;1,0;;22,0;4,0;;;1,0;7,0;51,0;2,0;;;4,0;22,0;;;6,0;2,0;2,0;;1,0;1,0;2,0;1,0;;26,0;2,0;;;6,0;4,0;9,0;;;1,0;;;32,0;;;2,0;14,0;5,0;4,0;;;;2,0;2,0;1,0;;2,0;;1,0;3,0;3,0;1,0;;4,0;25,0;;1,0;;;;2,0;;10,0;;;;3,0;9,0;;;8,0;;16,0;1,0;6,0;2,0;;;4,0;3,0;1,0;;3,0;9,0;1,0;1,0;;234,0;;3,0;1,0;1,0;4,0;1,0;2,0;;;1,0;;1,0;1,0;;;15,0;;;4,0;;3,0;2,0;1,0;;;6,0;1,0;;4,0;;7,0;11,0;4,0;2,0;;10,0;;;;;;1,0;;3,0;2,0;6,0;5,0;;1,0;;;;2,0;2,0;;;;4,0;1,0;;;19,0;;7,0;;;4,0;;5,0;6,0;;;4,0;9,0;16,0;2,0;;3,0;;;1,0;;2,0;;2,0;14,0;;;2,0;;;1,0;1,0;4,0;9,0;;2,0;;2,0;;;3,0;8,0;;1,0;2,0;6,0;;;1,0;;;;1,0;;1,0;3,0;11,0;;24,0;5,0;;;7,0;;1,0;;;19,0;;;;2,0;;;;;;2,0;;13,0;4,0;;;;;1,0;;;1,0;;;;;1,0;;;6,0;;2,0;;;;;;;7,0;;3,0;;;;2,0;2,0;;;;;;;1,0;4,0;;;;4,0;;;2,0;;4,0;;1,0;;;;;8,0;;;;;1,0;;;;;;11,0;2,0;;;;;;12,0;;;;;;;;;;;;1,0;2,0;2,0;;50,0;;;;;;;;23,0;;10,0;4,0;;;;;;;;2,0;;;5,0;;2,0;;4,0;;;3,0;3,0;;;1,0;1,0;1,0;1,0;;;15,0;;13,0;5,0;1,0;;1,0;;;;;;;2,0;;3,0;;12,0;;;;;;2,0;;;;;;;;;;;;4,0;;;;;;;2,0;;;9,0;;;;;;;;1,0;;;;;16,0;;;;;;;;;;;;4,0;;;;;;2,0;
connector;;29,0;;;;21,0;9,0;23,0;177,0;15,0;1,0;;9,0;;32,0;33,0;4,0;;;;;10,0;;7,0;;;;3,0;;;;;136,0;;31,0;28,0;;;;;156,0;;20,0;;12,0;5,0;;219,0;27,0;6,0;71,0;1,0;;1,0;1,0;13,0;40,0;;;;57,0;67,0;;1,0;2,0;2,0;1,0;62,0;15,0;82,0;11,0;;3,0;;;2,0;1,0;;5,0;58,0;;34,0;;161,0;;;;;2,0;5,0;28,0;;;3,0;;1,0;13,0;;33,0;10,0;;2,0;81,0;;;15,0;9,0;6,0;87,0;;6,0;15,0;11,0;4,0;1,0;121,0;240,0;88,0;34,0;3,0;3,0;;1,0;6,0;18,0;;;;;3,0;6,0;1,0;13,0;6,0;2,0;6,0;13,0;5,0;;;;1,0;2,0;21,0;;;;61,0;206,0;4,0;;;11,0;3,0;;29,0;49,0;;1,0;19,0;2,0;8,0;80,0;;;;74,0;2,0;;;;;;1,0;;;51,0;3,0;;;37,0;140,0;2,0;;4,0;26,0;;23,0;;;7,0;3,0;;300,0;;196,0;;;;17,0;9,0;2,0;;59,0;;5,0;2,0;;;18,0;;3,0;4,0;;;;22,0;;3,0;59,0;109,0;;1,0;27,0;8,0;4,0;12,0;9,0;1,0;;55,0;18,0;1,0;184,0;21,0;10,0;3,0;33,0;5,0;17,0;;31,0;;;;;;2,0;;;80,0;;;4,0;;;118,0;;;;3,0;;26,0;3,0;1,0;;40,0;9,0;;;6,0;1,0;5,0;;1,0;9,0;;41,0;3,0;46,0;12,0;31,0;625,0;;;5,0;;5,0;;;29,0;;;;39,0;;;;10,0;3,0;3,0;13,0;78,0;;43,0;;6,0;6,0;18,0;;;23,0;4,0;;1,0;;;;;97,0;;;;8,0;2,0;11,0;33,0;7,0;;3,0;;9,0;5,0;;;1,0;16,0;11,0;45,0;;;;14,0;3,0;2,0;7,0;10,0;;8,0;;4,0;2,0;;15,0;;11,0;18,0;20,0;5,0;;1,0;4,0;;12,0;10,0;4,0;;91,0;17,0;;21,0;14,0;4,0;;1,0;;8,0;16,0;2,0;7,0;8,0;5,0;18,0;1,0;1,0;;;27,0;1,0;40,0;4,0;;7,0;5,0;30,0;25,0;;2,0;;;;;;17,0;;;;;;1,0;8,0;;;;1,0;;;;;;;;;;;;;;;;;100,0;;;;;5,0;;8,0;;6,0;;4,0;;20,0;7,0;4,0;;4,0;;;1,0;;;;1,0;4,0;;;;;;;;;3,0;2,0;;;2,0;;;24,0;;3,0;;;;41,0;;36,0;26,0;;70,0;;;;;8,0;;;;;1,0;;;5,0;;35,0;;38,0;2,0;5,0;;2,0;;;;;;;5,0;;;;2,0;2,0;6,0;2,0;2,0;2,0;;83,0;;;;7,0;24,0;;17,0;;;1,0;63,0;;8,0;;71,0;2,0;3,0;;3,0;;;;1,0;;;;;9,0;54,0;1,0;;3,0;1,0;1,0;6,0;20,0;1,0;3,0;10,0;6,0;;11,0;2,0;7,0;45,0;21,0;;;;;;7,0;11,0;1,0;;;8,0;;1,0;;;9,0;;;;10,0;;4,0;;;4,0;;;;1,0;2,0;;10,0;;;;;1,0;;3,0;;;13,0;4,0;2,0;22,0;25,0;;;;15,0;;;;5,0;;;;4,0;;5,0;;;;;14,0;;;;42,0;;1,0;;;;;;;;;;;;17,0;;12,0;22,0;7,0;2,0;1,0;;;26,0;49,0;;;;5,0;;9,0;17,0;;2,0;10,0;;;;;;1,0;14,0;1,0;4,0;;11,0;5,0;3,0;;;40,0;;;1,0;;3,0;1,0;;;;1,0;3,0;17,0;;;1,0;;5,0;1,0;1,0;;;70,0;;;;7,0;;17,0;;;;;;;3,0;;3,0;2,0;8,0;;6,0;;;;5,0;;;;;23,0;;5,0;;1,0;;1,0;29,0;14,0;;;;;1,0;;;2,0;1,0;;;3,0;4,0;;;;;4,0;;11,0;;2,0;;;;1,0;;1,0;;;;;;;;;;;;;16,0;;;6,0;;;;;;;;;8,0;4,0;;;;;;;9,0;1,0;;;;;;;;;;7,0;3,0;;;;;;;;;;;;;;;4,0;;;;;;;;;7,0;;;;1,0;;;;;;;;;;17,0;;;1,0;;;;;;;;;;2,0;;;2,0;;;;;;;;;;;;4,0;;;1,0;;;4,0;;;6,0;;;;;;;2,0;;1,0;;;;;;;;2,0;;4,0;1,0;;;;;21,0;4,0;;;2,0;;;;;;;;;;;;;;;1,0;;;;;;;;;;;5,0;4,0;;;;;;6,0;;2,0;;;;;;;;;;;;;;;;;;;;;2,0;;;;;;;;;;;;;;1,0;20,0;;;;;;
consist;;2,0;;;;10,0;17,0;1,0;;;5,0;1,0;4,0;;;7,0;1,0;;;;2,0;5,0;;1,0;5,0;;4,0;1,0;;;5,0;7,0;;;7,0;;;;;;20,0;;6,0;;2,0;1,0;2,0;41,0;3,0;5,0;5,0;1,0;;;3,0;11,0;90,0;2,0;;;2,0;3,0;1,0;;19,0;;4,0;15,0;3,0;;2,0;1,0;;;;354,0;4,0;;1,0;58,0;1,0;5,0;;14,0;;;;;1,0;;209,0;4,0;;30,0;;2,0;4,0;5,0;17,0;1,0;;;15,0;12,0;3,0;;28,0;9,0;;10,0;1,0;1,0;;2,0;;15,0;17,0;13,0;20,0;;;;2,0;;;1,0;;;;3,0;;;;;3,0;1,0;;;;2,0;2,0;;;18,0;3,0;;;35,0;5,0;4,0;2,0;;;2,0;4,0;2,0;29,0;1,0;4,0;;1,0;1,0;68,0;;;;6,0;6,0;5,0;;13,0;;1,0;;;;4,0;;;2,0;4,0;5,0;2,0;1,0;;1,0;;12,0;;3,0;;3,0;10,0;;;2,0;;;;;;;;;;2,0;;9,0;6,0;3,0;2,0;;;;6,0;1,0;;;;;2,0;;2,0;;2,0;;2,0;;28,0;;14,0;3,0;;17,0;1,0;1,0;1,0;;;;;;;;;;;;9,0;;9,0;;;;;;3,0;1,0;;3,0;;5,0;;275,0;3,0;;8,0;;;4,0;;14,0;2,0;;;4,0;;6,0;1,0;18,0;1,0;;4,0;2,0;;4,0;;;;;7,0;1,0;;2,0;;;;;;;6,0;;2,0;;;;;3,0;5,0;;2,0;;;;;;;;2,0;;;2,0;;1,0;;;;;;;2,0;;2,0;;;2,0;;;;1,0;;;;;;;;6,0;;2,0;;;;;;;1,0;2,0;;;5,0;;;1,0;1,0;;;;18,0;;;;;;;;;1,0;;4,0;6,0;;;3,0;;1,0;;1,0;2,0;3,0;;8,0;;;8,0;;4,0;;6,0;;;;;;;;;;;;5,0;2,0;;;;;;;;;1,0;;1,0;1,0;;1,0;;13,0;;;;;3,0;1,0;4,0;;4,0;1,0;1,0;;;4,0;5,0;;1,0;2,0;4,0;1,0;1,0;2,0;;;;;;9,0;;;;1,0;6,0;;;7,0;;;;;;1,0;1,0;;;1,0;1,0;;5,0;;;;;1,0;;;;;;;6,0;1,0;;;2,0;;;;;;;3,0;7,0;1,0;1,0;1,0;1,0;;;;1,0;;;5,0;;3,0;1,0;;;;;;1,0;;;1,0;;4,0;;2,0;;;;;1,0;1,0;;6,0;;1,0;;;;5,0;;;;;3,0;2,0;;;1,0;;2,0;;4,0;1,0;;4,0;1,0;5,0;3,0;1,0;;5,0;1,0;2,0;;1,0;1,0;2,0;;;2,0;;;;;;;;;;3,0;;9,0;3,0;;1,0;;;4,0;;;2,0;;;;1,0;;;;;5,0;3,0;;3,0;2,0;;;;;;9,0;;;;;;;;;1,0;;;;;11,0;;;;;;;;;;;3,0;;;5,0;;;;2,0;;1,0;2,0;;3,0;;;;;;1,0;4,0;;;;;;;;;;1,0;;;;;;;;;;;;1,0;1,0;;1,0;1,0;;4,0;1,0;;;2,0;1,0;;;;;;;;;1,0;;;;;;;;;;;;;;;8,0;;1,0;;2,0;;;1,0;;;;;3,0;;;2,0;4,0;;;;2,0;1,0;4,0;2,0;;1,0;;3,0;6,0;;;;;;;5,0;;;;;;;1,0;;;2,0;;;;;2,0;;1,0;;5,0;1,0;;;2,0;;;;;;;;;6,0;;;;;;;;;4,0;;;;;;;;;1,0;;1,0;;1,0;1,0;;1,0;1,0;;3,0;;;1,0;;;;;1,0;;;;;;;4,0;;;;;;;;;;;2,0;1,0;;4,0;5,0;;;7,0;1,0;;1,0;;;;;;2,0;;;1,0;;;;7,0;;;;;;;;;;;;;;;1,0;;;;;;;3,0;;1,0;;2,0;;;;;1,0;;1,0;2,0;1,0;;1,0;;;;1,0;1,0;;;;;;;2,0;;;;2,0;;;;2,0;;;2,0;;;;;2,0;1,0;;;1,0;;;;;;;;;;;;;;;;;;;;;;;;;;;;2,0;;2,0;1,0;9,0;1,0;;3,0;;;;;;;;;;;;;;;;;;;;;;;;;1,0;;;4,0;;;;8,0;2,0;;;;;2,0
contact;;204,0;3,0;3,0;;67,0;14,0;17,0;201,0;577,0;23,0;;5,0;;33,0;53,0;21,0;2,0;;;1,0;26,0;4,0;2,0;;4,0;4,0;;2,0;;;1,0;53,0;;25,0;3,0;2,0;4,0;3,0;;92,0;1,0;23,0;2,0;81,0;33,0;8,0;118,0;7,0;23,0;41,0;42,0;;1,0;94,0;23,0;53,0;;1,0;;20,0;9,0;1,0;;5,0;1,0;10,0;173,0;11,0;54,0;4,0;1,0;4,0;;;15,0;7,0;1,0;1,0;95,0;3,0;25,0;;231,0;4,0;;123,0;2,0;8,0;4,0;286,0;5,0;;15,0;;1,0;;;28,0;18,0;;;126,0;28,0;9,0;3,0;56,0;2,0;138,0;;11,0;2,0;19,0;;1,0;102,0;476,0;266,0;48,0;13,0;12,0;;;2,0;7,0;;2,0;;3,0;3,0;1,0;9,0;23,0;;;;13,0;;;;6,0;2,0;3,0;75,0;3,0;;;259,0;423,0;;;1,0;3,0;4,0;3,0;64,0;214,0;;4,0;9,0;;13,0;239,0;;4,0;;3,0;3,0;;;4,0;1,0;25,0;17,0;;9,0;33,0;48,0;14,0;;24,0;352,0;25,0;13,0;105,0;62,0;4,0;13,0;;;2,0;1,0;1,0;180,0;;;;2,0;13,0;33,0;6,0;4,0;5,0;43,0;;38,0;47,0;;;124,0;37,0;18,0;48,0;3,0;6,0;;15,0;13,0;;26,0;61,0;;32,0;4,0;1,0;71,0;90,0;5,0;16,0;1,0;418,0;17,0;123,0;63,0;43,0;44,0;27,0;17,0;242,0;25,0;9,0;18,0;9,0;12,0;13,0;;9,0;10,0;22,0;47,0;38,0;;5,0;14,0;45,0;;55,0;3,0;;;;10,0;14,0;9,0;52,0;;32,0;16,0;9,0;1,0;28,0;53,0;14,0;6,0;;47,0;2,0;33,0;82,0;466,0;5,0;54,0;207,0;6,0;;8,0;15,0;13,0;2,0;10,0;33,0;1,0;4,0;1,0;17,0;;;13,0;27,0;8,0;41,0;9,0;9,0;3,0;13,0;8,0;19,0;9,0;55,0;;;27,0;18,0;4,0;52,0;5,0;;196,0;5,0;25,0;6,0;6,0;;9,0;29,0;;34,0;18,0;1,0;;3,0;3,0;5,0;3,0;8,0;;56,0;39,0;112,0;35,0;2,0;2,0;6,0;6,0;10,0;7,0;7,0;2,0;6,0;9,0;7,0;9,0;;14,0;31,0;1,0;;354,0;9,0;;;20,0;4,0;23,0;41,0;1,0;3,0;23,0;16,0;;;3,0;;;14,0;;62,0;6,0;18,0;38,0;8,0;;28,0;27,0;14,0;1,0;13,0;2,0;1,0;50,0;5,0;7,0;4,0;;5,0;7,0;;3,0;6,0;;;;;6,0;;;;;;2,0;12,0;1,0;;;1,0;4,0;;3,0;1,0;;;1,0;12,0;;;;;;;;;152,0;8,0;9,0;16,0;;;;7,0;;;2,0;17,0;;;13,0;87,0;;;;1,0;;;;;;2,0;;;;;4,0;;;;1,0;;2,0;;;;2,0;;;10,0;;;;117,0;1,0;15,0;78,0;;18,0;1,0;;;;3,0;3,0;1,0;;;2,0;;3,0;;;9,0;;11,0;;1,0;1,0;;;9,0;;;1,0;;3,0;;;;;2,0;;;;4,0;;16,0;1,0;1,0;;;8,0;;6,0;;;;37,0;;3,0;;;;;;13,0;;;;;;;2,0;;;1,0;4,0;;1,0;235,0;;;4,0;13,0;;6,0;1,0;;18,0;;10,0;141,0;1,0;2,0;2,0;;32,0;;3,0;13,0;2,0;2,0;;1,0;;3,0;;;1,0;;;4,0;1,0;1,0;2,0;2,0;;5,0;2,0;3,0;;;20,0;;15,0;;;2,0;;3,0;1,0;;;1,0;2,0;6,0;2,0;35,0;;;4,0;;;;1,0;;;;;;110,0;;2,0;;3,0;18,0;;5,0;1,0;;1,0;4,0;;1,0;;;1,0;;2,0;;2,0;2,0;1,0;;4,0;1,0;;;6,0;1,0;;8,0;;;6,0;134,0;;2,0;15,0;4,0;2,0;;10,0;11,0;;2,0;1,0;;;;2,0;;33,0;4,0;;4,0;;1,0;2,0;;;1,0;;18,0;;;;;;1,0;8,0;;25,0;;;2,0;8,0;;;5,0;;1,0;12,0;11,0;1,0;;;28,0;;21,0;;;16,0;3,0;;14,0;;;;;69,0;;3,0;7,0;;1,0;4,0;;;;;4,0;29,0;15,0;;33,0;;;16,0;2,0;5,0;;3,0;;;;;11,0;12,0;3,0;13,0;;16,0;2,0;29,0;;1,0;;;;;1,0;11,0;1,0;11,0;41,0;;;11,0;2,0;;;;;;;;;;;;;;2,0;;;9,0;1,0;;6,0;3,0;;;1,0;12,0;;;;;;;21,0;;;;;;;;;;2,0;1,0;;;;;;;;5,0;;;15,0;;;;;;;3,0;;;;;;;;;;;;;;;;;;;;;1,0;;;10,0;;1,0;;;1,0;;2,0;;5,0;;;1,0;19,0;;;1,0;;;;2,0;;;;3,0;;;;;;1,0;;3,0;4,0;;;;;;1,0;;;16,0;;;2,0;;2,0;;1,0;;;2,0;4,0;1,0;;1,0;;;;;;1,0;;2,0;;;;;3,0;;;;;4,0;;;3,0;;1,0;;;;;1,0;;;;;1,0;;2,0;;;2,0;;2,0;;;;;;10,0;;;;;;1,0;;3,0;;;;;;;;;;;;2,0;;;1,0;;;;;;;1,0;2,0;;;;;;
continuously;;1,0;1,0;;4,0;;11,0;8,0;7,0;6,0;1,0;;;;1,0;1,0;;;;;;36,0;2,0;;;;7,0;;;;;1,0;2,0;;23,0;7,0;;;;;36,0;;2,0;2,0;5,0;1,0;14,0;6,0;8,0;9,0;;;;;10,0;;4,0;;;;1,0;;3,0;4,0;;;1,0;17,0;13,0;1,0;2,0;;10,0;1,0;;1,0;;9,0;4,0;112,0;;19,0;;4,0;10,0;3,0;;;;15,0;12,0;;;4,0;1,0;;6,0;;25,0;1,0;;1,0;6,0;11,0;;3,0;3,0;;3,0;;;26,0;;12,0;3,0;15,0;6,0;8,0;2,0;20,0;;;1,0;;2,0;;;1,0;4,0;9,0;;4,0;;;2,0;;;1,0;;;2,0;;;6,0;2,0;;;9,0;12,0;;;;1,0;5,0;14,0;9,0;5,0;;;10,0;1,0;1,0;15,0;1,0;7,0;;15,0;7,0;;;7,0;;;;3,0;;;;;;;;;;;1,0;;2,0;;;3,0;;;;1,0;1,0;;8,0;;10,0;;;1,0;9,0;;;;;5,0;;5,0;;;2,0;;;2,0;;;1,0;1,0;;;;;1,0;;;29,0;;;;2,0;;;4,0;2,0;2,0;;1,0;3,0;;;;;;2,0;;;1,0;;;;;;;2,0;;4,0;;;;;;;1,0;;;11,0;;;3,0;2,0;;;;1,0;1,0;;2,0;3,0;;;;;56,0;;;;;3,0;1,0;;;8,0;;;;;;1,0;2,0;;;;;3,0;;6,0;;;;;;4,0;2,0;1,0;;;;;;;;;;;;1,0;;;;;;;;;;;;1,0;1,0;;1,0;;;;3,0;;2,0;2,0;;1,0;1,0;;;2,0;1,0;;;;;;;;;;1,0;;;;1,0;;;;;3,0;;2,0;;;;;;;3,0;;;1,0;1,0;;3,0;;;;;;;;;1,0;2,0;;1,0;;;;;;5,0;12,0;;;;2,0;1,0;3,0;1,0;;;;1,0;;;;;;3,0;;;;12,0;9,0;2,0;1,0;;;1,0;5,0;;;5,0;8,0;;;1,0;8,0;;1,0;7,0;;1,0;;4,0;10,0;;2,0;;;;;;;4,0;;;;1,0;2,0;7,0;;;;13,0;;;1,0;;1,0;;6,0;;1,0;2,0;12,0;;;;;;;;2,0;1,0;6,0;;;2,0;;;1,0;;;6,0;1,0;;;;1,0;;;3,0;1,0;;1,0;;;;7,0;;;;;;;;;1,0;;;;;;;;;2,0;;;3,0;4,0;;2,0;3,0;;;2,0;;;;;;;;;;;;;1,0;;1,0;1,0;;2,0;1,0;;;;;;;;;;;;;;;;;;;;2,0;;;;;;;;;;;;;2,0;;;;;;;;;;1,0;;;1,0;1,0;;;;;;;;;2,0;;;;;3,0;;;;;;;;;;;;;;1,0;;2,0;;;;;;;;;1,0;;;3,0;;;1,0;;;;;;;;;;4,0;;4,0;;;5,0;;;;;;;;;;;;;1,0;;;;;;;;;;;;;1,0;;;;;;;;;3,0;;;;;;;;;;;1,0;;;;;;;;;;1,0;1,0;;;;;13,0;;;3,0;;;;3,0;;;;;;;;1,0;;;;;;;;;;1,0;;;;;;2,0;;;;;2,0;;1,0;;2,0;;;;;;;;;;;2,0;2,0;;;3,0;7,0;;;;;;;;;;;;;;;;;;;;7,0;;;;;1,0;;;;;;;13,0;;;;;;;;;;;;;;;2,0;;;;1,0;;;;;1,0;;;;;;1,0;;;;;1,0;1,0;;;;;;2,0;5,0;;;;;;;;;;;;;;;;;;;1,0;;;;;;;;;;;;;;11,0;;;;;;;;;;;;;1,0;;;;;;;;;;;;;;;;;;;;;2,0;;;;;;;;;3,0;;;;;;;;;2,0;;;;;;;1,0;;;;;;1,0;;;;;;;;;;;;2,0;;2,0;3,0;1,0;;;;;;;1,0;1,0;;;1,0;;;;;;1,0;;;
conversion;;3,0;4,0;;;2,0;;61,0;76,0;119,0;45,0;;9,0;;11,0;50,0;;;;;;8,0;9,0;3,0;;36,0;123,0;2,0;;1,0;3,0;4,0;162,0;;87,0;3,0;12,0;18,0;;;137,0;;2,0;5,0;24,0;5,0;24,0;215,0;92,0;2,0;31,0;13,0;1,0;33,0;8,0;;544,0;;;2,0;;2,0;7,0;3,0;17,0;2,0;3,0;93,0;27,0;;52,0;;126,0;4,0;;47,0;2,0;;3,0;236,0;10,0;79,0;1,0;283,0;;4,0;2,0;;;3,0;72,0;;;50,0;2,0;1,0;6,0;;88,0;;1,0;1,0;73,0;10,0;;3,0;55,0;1,0;190,0;5,0;5,0;284,0;3,0;;23,0;234,0;158,0;35,0;8,0;19,0;4,0;1,0;68,0;100,0;4,0;;2,0;10,0;13,0;44,0;;15,0;13,0;2,0;;42,0;27,0;7,0;1,0;;1,0;;;27,0;2,0;1,0;;46,0;396,0;;3,0;2,0;9,0;11,0;25,0;32,0;35,0;;;98,0;1,0;9,0;550,0;2,0;;;31,0;11,0;11,0;51,0;10,0;;;6,0;16,0;1,0;;;16,0;28,0;;19,0;1,0;;179,0;164,0;;31,0;;;4,0;4,0;;32,0;1,0;15,0;;;;17,0;1,0;;14,0;27,0;;6,0;17,0;17,0;5,0;10,0;26,0;;;10,0;;2,0;;;1,0;;;28,0;10,0;;;;49,0;;108,0;6,0;12,0;8,0;;;;;10,0;10,0;12,0;4,0;6,0;1,0;;10,0;10,0;12,0;1298,0;1,0;474,0;3,0;;2,0;;;;16,0;55,0;;;3,0;;4,0;;18,0;47,0;2,0;19,0;11,0;3,0;2,0;;2,0;21,0;;;;3,0;;28,0;51,0;4,0;3,0;3,0;7,0;;36,0;2,0;2,0;3,0;2,0;;13,0;11,0;;1,0;;;;11,0;;13,0;5,0;;;;;5,0;1,0;1,0;4,0;;25,0;3,0;;4,0;4,0;;;4,0;9,0;;;;;39,0;;2,0;;2,0;2,0;;;;;;14,0;;3,0;13,0;;;;;14,0;;;;2,0;8,0;2,0;2,0;;;20,0;;;;12,0;1,0;1,0;;9,0;;;;;8,0;3,0;;;4,0;;;;;;;;4,0;1,0;;;;;;7,0;;;27,0;3,0;7,0;2,0;;8,0;;11,0;;1,0;;;;;;1,0;;;3,0;;3,0;11,0;15,0;29,0;10,0;;;1,0;;3,0;;;;2,0;1,0;4,0;;;;1,0;;;;29,0;13,0;;;;3,0;;31,0;;;6,0;2,0;;;10,0;14,0;;;49,0;9,0;1,0;;3,0;70,0;3,0;;1,0;;;11,0;;;2,0;;;;;11,0;1,0;;;3,0;1,0;2,0;;1,0;;41,0;;3,0;2,0;;1,0;26,0;20,0;;2,0;3,0;5,0;5,0;;;27,0;3,0;;;;24,0;;1,0;;;10,0;;;;;110,0;;3,0;2,0;;;2,0;;;;;;1,0;;2,0;10,0;1,0;;2,0;;;14,0;;3,0;;1,0;;;5,0;1,0;4,0;10,0;;;;2,0;;5,0;5,0;2,0;;17,0;;;;;1,0;;;;;;;26,0;81,0;37,0;;;;24,0;1,0;;182,0;;;;;24,0;;;;9,0;;;;;;12,0;;;;;1,0;;;;;;;;;;1,0;;;;;3,0;4,0;11,0;;;;;5,0;1,0;;;;;;1,0;37,0;;;;;;156,0;10,0;;;37,0;;;;;;15,0;;;;1,0;;;1,0;2,0;11,0;;;;;11,0;;3,0;;;;;5,0;;;12,0;70,0;;;;5,0;;;;;10,0;;;;;1,0;;;;;;;1,0;;;21,0;;;27,0;;;;;;;;1,0;17,0;;;;;1,0;;;5,0;3,0;4,0;;;;;;2,0;;;;;;;8,0;59,0;;;;;1,0;15,0;1,0;31,0;2,0;1,0;;;5,0;;;1,0;;4,0;;1,0;;1,0;;;;4,0;;;;;;;;9,0;;;29,0;68,0;22,0;20,0;29,0;53,0;;;;36,0;8,0;;30,0;24,0;3,0;1,0;32,0;9,0;;;69,0;2,0;39,0;;3,0;;2,0;;26,0;;41,0;;1,0;;79,0;2,0;2,0;3,0;6,0;3,0;1,0;;3,0;1,0;1,0;2,0;;;;;4,0;;1,0;2,0;;;;;;1,0;;;;9,0;2,0;;6,0;4,0;;;;1,0;;2,0;1,0;2,0;;;;;;4,0;;1,0;;;;;;;;24,0;;;1,0;;1,0;;;;;;;;;;4,0;4,0;;;;1,0;;;;;;;;;;;;;;;;;;;;2,0;;;;;8,0;1,0;;;3,0;;;;1,0;;1,0;;;;;;;;;15,0;;;6,0;;2,0;;;;;;;2,0;;7,0;;4,0;;;9,0;;;;11,0;;;;;;;;;;;;6,0;2,0;;17,0;3,0;4,0;;;;;;3,0;1,0;4,0;;5,0;;2,0;;;;;;;;;;;6,0;9,0;;;;;;;;;;1,0;;;;;;;;;;;;
corner;;1,0;;;12,0;5,0;1,0;5,0;53,0;7,0;4,0;;2,0;;1,0;15,0;1,0;;;;19,0;14,0;1,0;1,0;1,0;;27,0;;;;2,0;;21,0;1,0;2,0;;;;;;;;26,0;;21,0;23,0;13,0;16,0;2,0;6,0;14,0;7,0;;;9,0;9,0;18,0;5,0;8,0;;7,0;;9,0;;5,0;;;33,0;26,0;19,0;4,0;;;;;13,0;18,0;;;73,0;1,0;5,0;1,0;11,0;;;;;1,0;2,0;11,0;;;2,0;;;3,0;;36,0;;;;40,0;1,0;;;6,0;;;;1,0;6,0;;;;29,0;66,0;20,0;3,0;3,0;;;3,0;15,0;2,0;1,0;2,0;;;8,0;;;;;;;14,0;;;3,0;;;;9,0;;;;18,0;18,0;;;;2,0;5,0;;2,0;11,0;;3,0;7,0;;;12,0;;;;41,0;8,0;;;1,0;;;10,0;;1,0;9,0;8,0;;;1,0;7,0;;2,0;;13,0;;;1,0;;;;1,0;14,0;;4,0;;;;10,0;1,0;;1,0;;;;1,0;;;11,0;;;1,0;5,0;;;6,0;;;13,0;11,0;2,0;15,0;;;6,0;1,0;;8,0;;22,0;;;17,0;;;;9,0;10,0;6,0;2,0;1,0;2,0;7,0;1,0;;5,0;;1,0;9,0;9,0;;4,0;;;;15,0;;;;;1,0;9,0;10,0;1,0;;17,0;2,0;;;;4,0;6,0;;;1,0;;1,0;6,0;47,0;;;;;;;;2,0;;;6,0;;;;5,0;;;;4,0;;11,0;1,0;7,0;;;;;6,0;5,0;;;14,0;1,0;1,0;1,0;4,0;;5,0;1,0;1,0;;;;;3,0;;;;;;;;;;;;3,0;7,0;1,0;7,0;;;1,0;;3,0;1,0;;7,0;2,0;14,0;4,0;1,0;;;;;2,0;34,0;;;;1,0;;2,0;5,0;;;4,0;9,0;;;;3,0;;;;1,0;;1,0;2,0;;;2,0;;;;1,0;;;5,0;3,0;;4,0;2,0;;;1,0;1,0;;;;;;2,0;;;;;;24,0;;3,0;;;3,0;3,0;;;;4,0;8,0;;2,0;1,0;;;;10,0;;;;8,0;;3,0;59,0;;;;;2,0;;2,0;2,0;;;;;;;;8,0;;;;;;;;;2,0;;;;;;;;2,0;;5,0;;;;;;;;;;;1,0;;;10,0;30,0;;2,0;3,0;;1,0;;1,0;;;;4,0;;;;;;;;;;;1,0;;;;;9,0;;;;;;;4,0;;;;2,0;;;;;;;;;;;;;;2,0;;;;;9,0;;1,0;2,0;;;;;;;;1,0;;;;;;1,0;;;;;;2,0;;2,0;;;;;;;;1,0;2,0;;;;;;;;34,0;;;;;;;2,0;;;6,0;;;;;54,0;;31,0;;;;;1,0;;;;;;;;;2,0;;;1,0;;;;;1,0;3,0;;;13,0;;;;;3,0;;2,0;;;;1,0;1,0;;;;;;;;1,0;6,0;3,0;2,0;;;;2,0;;3,0;;;;6,0;;;11,0;;5,0;;1,0;;;;;;1,0;;;;;;;;;;;;;;;;;1,0;;3,0;;;;;5,0;30,0;;;;2,0;;4,0;;;;;;;;;2,0;50,0;;;1,0;;;;;;;;;2,0;;;2,0;1,0;;;1,0;;2,0;;;1,0;;;;;1,0;2,0;;;;;4,0;3,0;;;;;3,0;;;;;;;;;;;2,0;;;;;;;;;;;;3,0;1,0;;;;;;;2,0;;;;;1,0;3,0;1,0;;;;;;;;;;;;;3,0;;;;;;;;;;;;;;;1,0;;;1,0;;;;;;;;;3,0;;;1,0;1,0;;;;;1,0;;;;;;;;;;;;;;;;;1,0;;;2,0;;;;;;;1,0;5,0;;;;;;;;1,0;;1,0;2,0;;;;;;;;;;1,0;;;;1,0;;;;;;;;;;1,0;;;;;;;;;4,0;;;6,0;;;3,0;;1,0;2,0;2,0;3,0;;;;;;2,0;;;;;;;4,0;;;;;;;;;;;;;;27,0;;14,0;;;5,0;;;;;;;;;;;;;;;;;;;;;;;;;;;;;11,0;;;;;;;;;;;;;;
couple;;48,0;;9,0;6,0;17,0;20,0;97,0;15,0;19,0;59,0;;3,0;;53,0;154,0;5,0;;;9,0;17,0;68,0;;32,0;2,0;;23,0;1,0;20,0;;49,0;1,0;250,0;;118,0;111,0;;1,0;2,0;;89,0;;10,0;3,0;13,0;11,0;19,0;515,0;95,0;143,0;47,0;11,0;;;45,0;22,0;87,0;2,0;3,0;5,0;39,0;23,0;6,0;;42,0;6,0;29,0;83,0;54,0;46,0;15,0;2,0;42,0;3,0;;6,0;5,0;8,0;8,0;351,0;5,0;68,0;2,0;204,0;;15,0;;;;15,0;448,0;;8,0;8,0;23,0;39,0;119,0;;79,0;24,0;1,0;;315,0;35,0;12,0;19,0;135,0;7,0;55,0;7,0;10,0;3,0;14,0;;1,0;126,0;309,0;115,0;44,0;6,0;5,0;3,0;13,0;63,0;371,0;3,0;;;17,0;5,0;;4,0;31,0;2,0;;5,0;27,0;1,0;;;3,0;1,0;7,0;307,0;4,0;;;88,0;110,0;1,0;;24,0;51,0;33,0;5,0;13,0;223,0;;32,0;9,0;5,0;23,0;209,0;;1,0;;86,0;13,0;6,0;;5,0;;3,0;12,0;;2,0;118,0;87,0;8,0;;40,0;136,0;1,0;14,0;87,0;158,0;2,0;103,0;2,0;;5,0;2,0;2,0;59,0;;25,0;;;3,0;89,0;16,0;2,0;1,0;38,0;;22,0;2,0;6,0;10,0;18,0;;10,0;12,0;11,0;24,0;;36,0;7,0;6,0;61,0;311,0;;21,0;13,0;;20,0;19,0;18,0;132,0;;171,0;13,0;27,0;192,0;45,0;34,0;17,0;51,0;6,0;25,0;1,0;54,0;3,0;41,0;;;;12,0;33,0;10,0;62,0;1,0;11,0;3,0;;3,0;107,0;2,0;2,0;;13,0;;19,0;32,0;8,0;;43,0;13,0;14,0;1,0;13,0;59,0;19,0;9,0;;47,0;1,0;139,0;92,0;120,0;39,0;;25,0;1,0;6,0;3,0;;4,0;26,0;3,0;22,0;4,0;1,0;9,0;25,0;;6,0;2,0;18,0;1,0;92,0;16,0;16,0;;5,0;14,0;12,0;4,0;31,0;;2,0;33,0;6,0;8,0;12,0;4,0;3,0;97,0;;;2,0;8,0;5,0;17,0;44,0;19,0;19,0;11,0;2,0;;18,0;42,0;14,0;2,0;5,0;4,0;4,0;62,0;16,0;91,0;8,0;2,0;33,0;15,0;6,0;62,0;27,0;62,0;5,0;1,0;4,0;;;;9,0;33,0;14,0;19,0;10,0;5,0;;6,0;24,0;24,0;23,0;8,0;3,0;33,0;21,0;1,0;1,0;8,0;24,0;2,0;1,0;16,0;70,0;11,0;49,0;21,0;19,0;2,0;24,0;65,0;10,0;;9,0;;6,0;133,0;9,0;17,0;4,0;11,0;35,0;25,0;6,0;1,0;7,0;;4,0;6,0;1,0;22,0;4,0;3,0;;2,0;;;1,0;2,0;1,0;;36,0;;;;;;;1,0;53,0;1,0;1,0;2,0;;7,0;;;3,0;69,0;2,0;30,0;8,0;1,0;6,0;;6,0;2,0;10,0;49,0;44,0;;43,0;16,0;10,0;1,0;10,0;7,0;1,0;;;2,0;3,0;7,0;36,0;;1,0;;11,0;2,0;1,0;;2,0;8,0;1,0;6,0;6,0;10,0;;;7,0;6,0;42,0;2,0;1,0;;2,0;2,0;20,0;20,0;6,0;18,0;;;;;;;;4,0;9,0;6,0;;;2,0;12,0;105,0;;153,0;15,0;4,0;;5,0;;28,0;;25,0;3,0;;27,0;6,0;4,0;5,0;;10,0;17,0;3,0;;5,0;4,0;7,0;;2,0;;14,0;22,0;;42,0;3,0;2,0;8,0;27,0;;7,0;;;1,0;;1,0;33,0;;4,0;3,0;3,0;5,0;;;5,0;9,0;2,0;7,0;4,0;2,0;11,0;;11,0;53,0;18,0;8,0;17,0;4,0;6,0;;2,0;2,0;43,0;20,0;;2,0;3,0;1,0;15,0;6,0;10,0;9,0;21,0;15,0;;;4,0;;1,0;30,0;18,0;;1,0;27,0;10,0;3,0;;;15,0;15,0;2,0;3,0;;5,0;;37,0;6,0;32,0;;;10,0;1,0;;;1,0;5,0;1,0;77,0;1,0;48,0;;;;7,0;6,0;26,0;1,0;6,0;4,0;1,0;;5,0;3,0;23,0;1,0;1,0;;;3,0;18,0;1,0;5,0;20,0;1,0;2,0;;28,0;3,0;;;1,0;2,0;8,0;14,0;5,0;;22,0;;5,0;15,0;15,0;3,0;;21,0;1,0;8,0;;;;9,0;1,0;5,0;3,0;37,0;;12,0;42,0;1,0;;1,0;;9,0;4,0;41,0;1,0;3,0;6,0;43,0;35,0;2,0;4,0;;4,0;3,0;1,0;2,0;3,0;;;;;3,0;;43,0;1,0;;;9,0;;89,0;11,0;2,0;4,0;10,0;3,0;17,0;1,0;;41,0;;11,0;17,0;23,0;16,0;23,0;14,0;12,0;;;2,0;29,0;13,0;1,0;6,0;1,0;3,0;;1,0;;9,0;3,0;46,0;6,0;;2,0;2,0;4,0;3,0;9,0;5,0;4,0;1,0;;4,0;;;1,0;;1,0;1,0;12,0;4,0;12,0;9,0;;;5,0;2,0;;;;;8,0;;4,0;;4,0;;3,0;;;1,0;;;4,0;4,0;11,0;;;;;10,0;;;16,0;2,0;;5,0;1,0;;;;;7,0;2,0;;10,0;6,0;1,0;;;3,0;;;2,0;;;;;;;;;1,0;;17,0;;5,0;1,0;4,0;1,0;1,0;;;7,0;4,0;;;;;5,0;12,0;17,0;;;2,0;2,0;5,0;2,0;;;13,0;;;3,0;;;4,0;4,0;11,0;3,0;5,0;2,0;1,0;;1,0;;;;1,0;1,0;;1,0;;;;;1,0;4,0;2,0;34,0;;7,0;2,0;3,0;5,0;3,0;;22,0;2,0;;;4,0;2,0;;1,0;3,0;1,0;;10,0;;;;;12,0;;;1,0;;4,0;;1,0;5,0;;11,0;1,0;;14,0;1,0;21,0;;3,0;3,0;;4,0;4,0;;3,0;;5,0;2,0;10,0;7,0;;;;;1,0;1,0;4,0;1,0;1,0;1,0;;2,0;8,0;;9,0;;6,0;;;;;9,0;;;;8,0;;;;2,0;;;4,0;;9,0;;;;;;;;;;;11,0;;1,0;1,0;;;2,0;2,0;2,0;;;;;;;2,0;;;;2,0;;;;;;;
cover;;15,0;;;;16,0;58,0;43,0;107,0;45,0;45,0;;3,0;;30,0;55,0;2,0;;;;6,0;10,0;2,0;9,0;6,0;;14,0;;;;2,0;;98,0;;9,0;;;;;2,0;5,0;;60,0;2,0;11,0;;6,0;112,0;10,0;33,0;96,0;11,0;4,0;3,0;36,0;29,0;109,0;;;;46,0;4,0;52,0;;35,0;12,0;4,0;147,0;57,0;206,0;7,0;2,0;6,0;;;6,0;;1,0;21,0;196,0;11,0;62,0;;157,0;;;;1,0;4,0;12,0;466,0;;;55,0;1,0;;3,0;;30,0;11,0;;2,0;136,0;30,0;4,0;6,0;66,0;2,0;1,0;;16,0;3,0;18,0;1,0;2,0;69,0;342,0;218,0;2,0;8,0;10,0;5,0;2,0;4,0;5,0;1,0;3,0;;1,0;12,0;1,0;9,0;18,0;2,0;3,0;;15,0;4,0;15,0;;5,0;2,0;;233,0;;;;136,0;8,0;8,0;;2,0;5,0;1,0;;1,0;92,0;;14,0;15,0;1,0;6,0;128,0;;;2,0;11,0;119,0;13,0;2,0;2,0;6,0;20,0;47,0;6,0;6,0;161,0;62,0;11,0;2,0;37,0;145,0;12,0;5,0;1,0;21,0;13,0;42,0;4,0;7,0;5,0;;15,0;32,0;4,0;33,0;;2,0;4,0;;16,0;1,0;;90,0;;17,0;2,0;;7,0;85,0;90,0;9,0;2,0;6,0;99,0;;22,0;19,0;6,0;114,0;297,0;2,0;141,0;4,0;;39,0;87,0;2,0;90,0;;291,0;83,0;61,0;134,0;92,0;42,0;17,0;150,0;10,0;174,0;17,0;20,0;27,0;7,0;2,0;25,0;26,0;9,0;38,0;41,0;98,0;1,0;7,0;1,0;6,0;;61,0;2,0;11,0;1,0;5,0;8,0;42,0;6,0;29,0;;47,0;103,0;54,0;9,0;40,0;;40,0;13,0;1,0;6,0;;62,0;57,0;318,0;;;13,0;12,0;;8,0;8,0;14,0;;96,0;28,0;19,0;;18,0;52,0;1,0;1,0;17,0;29,0;11,0;12,0;4,0;104,0;;5,0;8,0;5,0;17,0;44,0;;;61,0;24,0;9,0;70,0;4,0;10,0;17,0;6,0;89,0;;87,0;14,0;18,0;9,0;7,0;32,0;12,0;;;5,0;11,0;8,0;8,0;4,0;;6,0;35,0;26,0;26,0;3,0;10,0;22,0;7,0;9,0;2,0;19,0;34,0;12,0;16,0;11,0;3,0;;24,0;1,0;2,0;;10,0;4,0;5,0;2,0;17,0;131,0;35,0;32,0;4,0;;68,0;41,0;1,0;7,0;;13,0;;6,0;5,0;39,0;22,0;27,0;13,0;6,0;1,0;1,0;12,0;5,0;3,0;33,0;2,0;2,0;45,0;31,0;17,0;2,0;5,0;29,0;5,0;4,0;6,0;76,0;1,0;;;3,0;7,0;2,0;3,0;;;;;5,0;;;;1,0;1,0;3,0;5,0;10,0;1,0;;;6,0;;;;;;;;;1,0;2,0;4,0;9,0;;;;;;5,0;3,0;8,0;;;5,0;13,0;4,0;2,0;;7,0;;1,0;;4,0;6,0;;;;;5,0;1,0;1,0;2,0;;2,0;;;;4,0;;4,0;;;4,0;;;;;1,0;8,0;16,0;;14,0;;;;;1,0;;9,0;;;;;;1,0;;11,0;;37,0;;;4,0;4,0;1,0;13,0;;;;;12,0;;2,0;;;1,0;;;;;;3,0;2,0;;;;8,0;;;;;13,0;11,0;;17,0;3,0;7,0;;2,0;;24,0;;3,0;;;;;1,0;;;4,0;2,0;;;15,0;;8,0;8,0;1,0;3,0;1,0;4,0;7,0;16,0;;1,0;1,0;;;4,0;;5,0;6,0;;8,0;22,0;18,0;;;;30,0;;;35,0;;;;;;;;;24,0;7,0;;;;4,0;;22,0;;;;;3,0;1,0;6,0;;;4,0;;13,0;19,0;;;4,0;9,0;;;2,0;;2,0;3,0;3,0;12,0;56,0;;23,0;4,0;;;;16,0;;14,0;;13,0;;;;3,0;11,0;;;1,0;;7,0;4,0;8,0;;;;9,0;1,0;67,0;1,0;;24,0;;10,0;;13,0;;17,0;10,0;;3,0;10,0;13,0;12,0;9,0;2,0;;2,0;;;1,0;22,0;;7,0;4,0;7,0;;;8,0;;11,0;;;;;;2,0;;5,0;5,0;;8,0;1,0;50,0;;;;6,0;1,0;;4,0;6,0;6,0;;;2,0;85,0;;;2,0;;16,0;4,0;;1,0;10,0;;;9,0;15,0;17,0;6,0;11,0;4,0;;2,0;1,0;2,0;1,0;1,0;43,0;;12,0;;32,0;7,0;13,0;15,0;17,0;2,0;;8,0;;;;;32,0;2,0;4,0;2,0;;3,0;1,0;;;;;1,0;;1,0;;;;5,0;22,0;;1,0;3,0;13,0;2,0;3,0;;9,0;3,0;9,0;;;1,0;;2,0;;;;;;7,0;3,0;4,0;;4,0;;;;;;1,0;;;;2,0;;;;;1,0;;;3,0;;1,0;;;;;;;;;;;;;;7,0;;;1,0;3,0;2,0;;8,0;2,0;;;;3,0;1,0;;;;;;2,0;;;;;;;;;1,0;;;;2,0;;1,0;;;2,0;;;;;;;;4,0;;4,0;;2,0;1,0;7,0;;;5,0;;;1,0;;;;;;16,0;;2,0;;;1,0;1,0;;;;3,0;;;;1,0;;7,0;;;;4,0;3,0;2,0;1,0;5,0;1,0;2,0;;3,0;;20,0;13,0;;;;;;;;2,0;;;;;;;;;;;;1,0;;2,0;;;;;8,0;;8,0;3,0;1,0;2,0;;;;;;8,0;;;;;;;;2,0;;;103,0;;;;2,0;;;;;;4,0;;5,0;2,0;;;;;;;9,0;;;;;;
crystal;;1,0;;;3,0;;1,0;30,0;10,0;5,0;4,0;;;;;6,0;1,0;;;;;;;;;;1,0;;;;;3,0;7,0;;14,0;4,0;;;;;3,0;;1,0;;1,0;;;34,0;3,0;141,0;3,0;3,0;;;5,0;;8,0;;;;;;2,0;;2,0;2,0;3,0;20,0;;2,0;;;2,0;;;3,0;;;;23,0;;5,0;;33,0;4,0;;;;;1,0;54,0;;;29,0;;;;;7,0;;;;33,0;2,0;;2,0;8,0;;1,0;;2,0;1,0;;;;6,0;10,0;12,0;2,0;;2,0;1,0;;9,0;4,0;;1,0;;12,0;;;;;;;1,0;1,0;;;;;;;20,0;1,0;;;13,0;7,0;;;;;;;;16,0;;;;;1,0;10,0;;1,0;;2,0;2,0;11,0;;;;;;4,0;;1,0;5,0;;;2,0;1,0;;2,0;4,0;;;4,0;1,0;;;;;4,0;1,0;2,0;;;;;;;;1,0;;;;;5,0;10,0;2,0;;;;14,0;;1,0;;;7,0;9,0;;;;;;36,0;;34,0;;6,0;;;2,0;;;;2,0;1,0;;;46,0;;5,0;2,0;;;;3,0;;3,0;;;;;;24,0;1,0;;16,0;;35,0;;;;;;;4,0;4,0;;3,0;1,0;;;;;;28,0;5,0;1,0;;;;2,0;2,0;;;;8,0;;;;;2,0;2,0;;;3,0;;2,0;;;;1,0;;;;2,0;1,0;;;;;4,0;;;;;5,0;;;;;4,0;;;;;;;;;;;;2,0;4,0;;4,0;;;;1,0;;;;;;;;;;;;;;;;1,0;;;;;;;;;2,0;;;;;;;1,0;;;;;;;4,0;;;;;;;;;;;;;1,0;;3,0;;;;;;;;;;;;;4,0;;1,0;;;;;;;;;1,0;1,0;;;;;;;;;;;;;;;;;;13,0;;6,0;;;;;;;;;;;;3,0;2,0;;;;;;;;1,0;;;;;;;;;;;;1,0;;;;;8,0;;;;;;;;;;;;2,0;;;;;;;;;;1,0;;;;;2,0;;;;8,0;;;;;;;;;2,0;2,0;;;;;;;;;;;;;;;;1,0;;;;;;;;11,0;;;;;;;;;;3,0;;;;;;;4,0;;;;;;;;1,0;;1,0;;;;1,0;;;;;1,0;;;2,0;2,0;;;;;;;;1,0;;;;;;2,0;1,0;;2,0;;;;;;;;;;;;;;;;;;;;;;;2,0;6,0;;;;;;;2,0;;;;;;;;1,0;;;;;;;;;;;;;;;;;;;;;;1,0;;1,0;;5,0;;;4,0;;;;;;;;;;;;;;;;;;;322,0;;;;;;;;1,0;;;;;;;;;;;;;;;;;;;;;;;;;;;;;2,0;;;;;;;;4,0;1,0;;3,0;;4,0;;;;;;8,0;;;;;;;;4,0;3,0;;;;;;;;;;;;;;;;3,0;5,0;;;;;;;;;;1,0;;;;;;;;;;;;;;;;;4,0;;;;;;35,0;;;;;;;;;;;;;;;;;;1,0;;;;;;;12,0;;;;;;;;;;;1,0;;;2,0;;;;;;;;;;;;;;;;;;;;;1,0;;;;;;;;;;;;;;;;;;;;;;;;;;;;;;1,0;;;;;;2,0;;;;;;;;;;;2,0;;;2,0;;;;;;;;;;;;;;;;;;;;;;;;1,0;;;;;2,0;;;;;;;;;;;1,0;;;1,0;;;;;;;;;;;;;;;;;;;;;;;;;;;;;;;;;;;;;;;;;;
cylindrical;;19,0;;;;2,0;24,0;7,0;4,0;17,0;5,0;;;;48,0;12,0;;;;;;2,0;;1,0;1,0;;;;;;;2,0;4,0;;7,0;;;;;;;;24,0;2,0;1,0;;4,0;23,0;1,0;5,0;45,0;1,0;;;4,0;15,0;4,0;;;;45,0;17,0;3,0;;8,0;;1,0;30,0;10,0;16,0;;2,0;1,0;;;2,0;;;;50,0;;13,0;;65,0;;;;;;1,0;166,0;;;;;;;;16,0;;;;37,0;5,0;;;28,0;4,0;3,0;;;3,0;8,0;2,0;;23,0;235,0;35,0;;3,0;1,0;;;;1,0;;;;;2,0;;;6,0;;1,0;;2,0;;;;;;;20,0;;;;63,0;;;;;1,0;;2,0;;18,0;;;;;;9,0;;;;1,0;20,0;;;2,0;1,0;1,0;1,0;;;44,0;50,0;;;2,0;64,0;;16,0;;;;19,0;3,0;;;;1,0;18,0;;6,0;;;1,0;16,0;;;;34,0;;;;;;22,0;;5,0;;;;;20,0;;3,0;29,0;33,0;;55,0;;;4,0;;;3,0;;118,0;;;44,0;1,0;;;26,0;3,0;62,0;2,0;;8,0;10,0;;;;;18,0;4,0;17,0;;1,0;10,0;;;41,0;;2,0;;2,0;;8,0;;;;38,0;8,0;;;3,0;4,0;8,0;;;1,0;;19,0;5,0;204,0;;;;;;;;;;4,0;;3,0;;;58,0;;;;1,0;1,0;10,0;;6,0;11,0;4,0;3,0;;1,0;9,0;;;24,0;;58,0;2,0;;;9,0;3,0;16,0;9,0;;37,0;24,0;1,0;;21,0;;2,0;;;;8,0;4,0;;;;4,0;3,0;19,0;42,0;2,0;11,0;;;;4,0;1,0;3,0;;4,0;6,0;;;2,0;3,0;3,0;;1,0;;1,0;6,0;;12,0;18,0;1,0;;14,0;12,0;;;;1,0;;;4,0;11,0;8,0;17,0;1,0;;1,0;1,0;9,0;;2,0;1,0;27,0;;17,0;;;;;31,0;1,0;;2,0;4,0;;;;;5,0;;;;;;;4,0;1,0;;;;;;;;;;;;;;;2,0;;;;;;;1,0;;;;;;;4,0;;3,0;;;;;;1,0;;;;;;;2,0;;;;;;;;;;2,0;;;;;;;;;5,0;;;;;;3,0;16,0;;6,0;55,0;;;;1,0;;;;;;;;;;;;1,0;;;;;;1,0;;;;;;;;;;9,0;;;;;;4,0;1,0;;;;1,0;;;;;;2,0;;;;;;17,0;;4,0;;;;;;;;;;;;;;;;;2,0;1,0;;;;;9,0;;;4,0;;;1,0;;;;1,0;8,0;1,0;8,0;;;;;;;;;;;;;;;;9,0;;6,0;;;;;5,0;;;;;;;1,0;;;;;;;;;;;;;;12,0;2,0;;;;;;;;;6,0;;;;;1,0;15,0;;;;;1,0;;;;;2,0;;1,0;;;;1,0;;;;;3,0;1,0;2,0;;;;1,0;1,0;;8,0;;2,0;5,0;2,0;;;;;2,0;7,0;2,0;1,0;13,0;;5,0;;;;;;;;;;;;;5,0;3,0;;4,0;;;2,0;1,0;;3,0;1,0;;;;1,0;;;;14,0;;4,0;;;2,0;;1,0;2,0;14,0;;;6,0;;;;6,0;;;2,0;;;;7,0;3,0;;1,0;;2,0;;;2,0;8,0;;;;;;;;;1,0;;;;;;;;;;;;;;;;;;;;;;;;;1,0;;;;;;;7,0;;;;;;1,0;;;;;;3,0;;;;;;;1,0;;7,0;;;;;;;3,0;;;;;;2,0;;;;;;3,0;;;;2,0;;;1,0;6,0;;;;7,0;;;;;;;;;;;;;;;;;;;;;;;;;;;;;;;5,0;;;;;;2,0;;;;;;;;;;;;;;;;;;;1,0;;;;;;2,0;;;;22,0;;1,0;4,0;;3,0;;;;;;;;2,0;;;;;;5,0;;;;;;;;;;;;;;1,0;;;;;;;;;;;;;;;;4,0;;2,0;2,0;;;;;7,0;;;;;;;;;;;;;;;;2,0;1,0;;;;;;;;1,0;;;;;;;;;;;;;
degree;;34,0;2,0;;5,0;568,0;2,0;36,0;43,0;13,0;7,0;;1,0;;82,0;35,0;16,0;;3,0;;2,0;12,0;3,0;1,0;5,0;6,0;6,0;1,0;5,0;;3,0;7,0;26,0;3,0;41,0;1,0;7,0;11,0;4,0;2,0;12,0;1,0;11,0;1,0;24,0;10,0;78,0;41,0;14,0;44,0;10,0;4,0;3,0;2,0;4,0;4,0;8,0;1,0;6,0;;22,0;;101,0;;3,0;163,0;25,0;17,0;8,0;14,0;17,0;2,0;14,0;1,0;;10,0;;;4,0;152,0;2,0;16,0;;40,0;7,0;;;;4,0;15,0;72,0;2,0;;1,0;15,0;1,0;;;90,0;2,0;3,0;10,0;49,0;37,0;;3,0;39,0;6,0;50,0;2,0;2,0;2,0;;8,0;;21,0;18,0;41,0;2,0;30,0;;25,0;1,0;4,0;7,0;3,0;2,0;1,0;1,0;186,0;;11,0;49,0;3,0;24,0;4,0;17,0;2,0;3,0;1,0;6,0;;3,0;20,0;3,0;;;16,0;15,0;6,0;;;1,0;4,0;3,0;;60,0;7,0;36,0;1,0;1,0;3,0;60,0;5,0;3,0;1,0;21,0;400,0;;2,0;30,0;;1,0;6,0;19,0;2,0;39,0;;2,0;;;15,0;2,0;;;15,0;;7,0;;;1,0;4,0;;17,0;;;;;2,0;3,0;8,0;5,0;15,0;92,0;;;;1,0;;30,0;5,0;1,0;1,0;;2,0;;2,0;7,0;;2,0;21,0;18,0;;;2,0;;10,0;;55,0;4,0;20,0;;5,0;27,0;2,0;5,0;40,0;9,0;2,0;7,0;20,0;7,0;4,0;10,0;20,0;;1,0;;24,0;35,0;15,0;5,0;1,0;;;;4,0;15,0;3,0;;;;1,0;8,0;;1,0;15,0;2,0;9,0;;5,0;41,0;4,0;4,0;;3,0;2,0;4,0;;40,0;7,0;;;3,0;;1,0;1,0;1,0;;;12,0;18,0;3,0;;4,0;;9,0;8,0;;;;6,0;1,0;2,0;5,0;;7,0;;;;;5,0;;12,0;5,0;13,0;;9,0;2,0;3,0;;1,0;2,0;3,0;25,0;;4,0;1,0;2,0;1,0;;;4,0;;6,0;;;10,0;;6,0;;9,0;;1,0;281,0;;3,0;2,0;6,0;1,0;3,0;12,0;;4,0;;11,0;2,0;13,0;11,0;17,0;;;2,0;;10,0;2,0;;;;4,0;19,0;;;;2,0;1,0;5,0;8,0;97,0;59,0;;;1,0;6,0;;;;1,0;5,0;15,0;3,0;11,0;2,0;;;2,0;;1,0;;;;;;5,0;;;;117,0;5,0;35,0;3,0;;10,0;4,0;2,0;;;2,0;4,0;;6,0;8,0;10,0;6,0;;;4,0;16,0;;1,0;;11,0;1,0;4,0;3,0;;12,0;8,0;13,0;40,0;2,0;25,0;4,0;;;3,0;4,0;3,0;23,0;;1,0;2,0;;4,0;8,0;1,0;;;12,0;2,0;2,0;;3,0;2,0;2,0;1,0;1,0;1,0;14,0;2,0;;;;;7,0;;6,0;;3,0;;5,0;;;5,0;1,0;;;;;;;2,0;4,0;3,0;;2,0;;;;;11,0;;2,0;;1,0;1,0;6,0;;;;;3,0;2,0;;;1,0;;;4,0;;6,0;;5,0;;;;;;2,0;2,0;;1,0;;15,0;;;23,0;;;13,0;;8,0;2,0;3,0;;1,0;1,0;;;;;;5,0;1,0;;6,0;;2,0;9,0;1,0;;5,0;;5,0;5,0;;;1,0;;2,0;;;1,0;;;4,0;;;;;2,0;2,0;;;3,0;;;;;;;;;1,0;;1,0;;;5,0;7,0;9,0;;1,0;;;;;;;;2,0;3,0;;6,0;;8,0;;1,0;;1,0;;;1,0;29,0;;;7,0;2,0;;;;;;;;;3,0;;2,0;;;2,0;3,0;;;4,0;;;;;1,0;;;;4,0;3,0;;1,0;;;3,0;;;;;;5,0;;1,0;;4,0;;4,0;3,0;1,0;;3,0;2,0;;2,0;;;3,0;5,0;;15,0;;1,0;;5,0;;;1,0;;;23,0;4,0;3,0;;2,0;3,0;;1,0;;1,0;14,0;;9,0;1,0;;;;;1,0;;;;3,0;8,0;;;;;;;4,0;;;9,0;2,0;;;5,0;;;;12,0;;1,0;;;;;2,0;;;;;;;;;14,0;;;11,0;;1,0;1,0;;;;;;;;;;;;;1,0;22,0;1,0;;;;10,0;;98,0;5,0;2,0;;;5,0;;2,0;6,0;3,0;1,0;7,0;;;;;;;;7,0;;1,0;14,0;1,0;4,0;;;;9,0;10,0;;;2,0;93,0;14,0;2,0;;;;2,0;13,0;;;;;6,0;;;;;3,0;;;;1,0;3,0;;;;;;14,0;;;;;;;1,0;;;;;;;;;;;3,0;1,0;1,0;6,0;;;6,0;6,0;1,0;;;6,0;;6,0;;;;;;;;1,0;2,0;;;;6,0;;;1,0;;;;1,0;;;;;;;45,0;;1,0;;2,0;2,0;;3,0;;11,0;;;3,0;;1,0;2,0;10,0;3,0;3,0;;;;1,0;;1,0;;;;;;2,0;;;;;;;12,0;;8,0;;;;;;;;;;;;5,0;79,0;;2,0;;2,0;;;1,0;;;;2,0;;;;;;;;;;;3,0;;4,0;;;8,0;;1,0;;1,0;1,0;;;;;;;1,0;;;;269,0;;;2,0;;;
design;;1,0;;;2,0;6,0;2,0;5,0;3,0;;3,0;;2,0;;1,0;8,0;3,0;;2,0;2,0;1,0;2,0;;;3,0;;;;3,0;;2,0;;;;15,0;1,0;;;6,0;;41,0;;5,0;9,0;4,0;7,0;25,0;25,0;7,0;3,0;;;;;5,0;1,0;25,0;;1,0;;6,0;;3,0;;4,0;1,0;4,0;3,0;4,0;;2,0;;4,0;;1,0;1,0;;;1,0;34,0;1,0;13,0;2,0;10,0;2,0;;;;;6,0;32,0;;;1,0;;;;;24,0;;2,0;;3,0;;8,0;;11,0;1,0;10,0;9,0;;4,0;;3,0;;3,0;5,0;34,0;;;;;2,0;12,0;1,0;1,0;;;1,0;1,0;;;;1,0;;2,0;;;;;;;;2,0;1,0;;1,0;;;2,0;;;12,0;19,0;;;26,0;;1,0;;;3,0;29,0;;1,0;;18,0;1,0;2,0;3,0;;1,0;;;6,0;1,0;3,0;1,0;;;10,0;;;;1,0;3,0;;1,0;;;;;1,0;6,0;;4,0;1,0;;1,0;1,0;;;;7,0;6,0;;;3,0;;;;;;;;;;;1,0;1,0;2,0;;;;2,0;1,0;;;18,0;1,0;;1,0;14,0;24,0;1,0;1,0;7,0;2,0;;1,0;;;;1,0;;;;;10,0;3,0;1,0;;;;;;7,0;;5,0;;;;1,0;1,0;;;3,0;;1,0;;;;1,0;;;1,0;;;;7,0;1,0;;1,0;1,0;;;;;;;6,0;;;;1,0;;;;;;5,0;2,0;7,0;;;;;;;;;3,0;;;2,0;;;2,0;;2,0;;;1,0;;;1,0;2,0;1,0;;;3,0;2,0;;;1,0;1,0;;3,0;1,0;2,0;;2,0;;;;;5,0;2,0;;1,0;;2,0;;;1,0;3,0;;21,0;;3,0;1,0;2,0;1,0;;;;;1,0;3,0;7,0;2,0;;;;;2,0;;;11,0;6,0;1,0;;1,0;;1,0;2,0;;;;1,0;;;;;;1,0;;;;;;;;;;2,0;;4,0;;4,0;;1,0;1,0;;;;1,0;3,0;;;;;2,0;;;1,0;;5,0;;;;1,0;2,0;;1,0;;;1,0;;;;;;;;6,0;1,0;;;;1,0;;24,0;;;;2,0;5,0;;;;1,0;;;;;;;;4,0;;;;;5,0;1,0;;;;10,0;3,0;;;1,0;5,0;;;2,0;4,0;;;;;;;;;;2,0;;7,0;;;;;;;;4,0;;;;1,0;;3,0;;;;;;;1,0;;6,0;;;;;;;;;;;;4,0;;;;;;3,0;;;;;1,0;;;;;1,0;2,0;;;4,0;;;5,0;;;2,0;;;;;;1,0;1,0;2,0;;;2,0;;;;;3,0;;;;;;;;;;;4,0;;;;;1,0;;;;;;;3,0;;;;;;;;;;;5,0;5,0;1,0;;;;;;;1,0;;;2,0;;;5,0;;;;;;;;;;1,0;;;;;;;;;;2,0;;7,0;1,0;;;;;;1,0;1,0;;;;3,0;;;;;;;5,0;;;;;;;;;;;1,0;2,0;2,0;2,0;;;;;;1,0;;;;1,0;;;;;1,0;;;;;;2,0;;;;;;;1,0;1,0;;;;;;1,0;;2,0;;;;;;;2,0;;;1,0;;;;;1,0;1,0;;;;3,0;2,0;;;;3,0;2,0;;;3,0;;;;;;;1,0;;;1,0;;;;;;;;;;;;;;;3,0;1,0;;;;;;;;;;1,0;;;;;1,0;;;;;;;;;;1,0;1,0;1,0;;3,0;;;;2,0;;;;;;;;;;;;;;;;;2,0;;;;;;;;;;;2,0;;;;;;;;1,0;;;;6,0;;;;;;;;;;;;;;;;;;;;;;;1,0;;;1,0;;;1,0;;;;3,0;;;3,0;;;;;2,0;;;;;;;;;;;;;;1,0;;3,0;;1,0;;;;;;;;;;;;1,0;;;;;;;;;;;;;;;;;;;;;;;;;;;;2,0;;;;;;1,0;;;;;;;;3,0;;;;6,0;1,0;;;;;;;;;;;;;;;;;9,0;4,0;;;;;;;;;;;;;;1,0;;;
detachable;;7,0;;;;;;13,0;;1,0;;;;;;9,0;;;;;;5,0;;;;;1,0;;;;;;17,0;;5,0;1,0;;;;;;;3,0;;1,0;1,0;;34,0;5,0;2,0;2,0;;;;5,0;5,0;26,0;;;;;5,0;;;;;;9,0;2,0;1,0;;3,0;;;;;;;4,0;22,0;;5,0;;29,0;;;8,0;;;3,0;84,0;;;2,0;;14,0;1,0;;2,0;1,0;;;47,0;;;;;;;;;1,0;1,0;;;11,0;31,0;4,0;23,0;7,0;;;;;;;;;;1,0;;;;;;;;1,0;;;;;;2,0;3,0;;;8,0;4,0;;;;;;;2,0;39,0;;;;;;43,0;;;;2,0;3,0;3,0;;;;;;;;;1,0;;;;40,0;;;;;;1,0;;;;;;7,0;;6,0;;;;87,0;;;;;;;;;;;;4,0;;;;;;;;6,0;27,0;;;;;17,0;;;5,0;;11,0;;10,0;33,0;4,0;;;2,0;;;;2,0;1,0;;;;;;;1,0;1,0;;;;;;3,0;;;;;;4,0;;1,0;;1,0;;;;;5,0;;;;7,0;;19,0;;7,0;;;;;;1,0;;1,0;;;8,0;;;;;;;10,0;4,0;4,0;;1,0;26,0;;;;;;;;;;;;;;1,0;;;8,0;;;;;2,0;;1,0;;;1,0;1,0;6,0;;;;;3,0;;;3,0;;;3,0;1,0;;;2,0;;1,0;16,0;;;;3,0;;1,0;;;17,0;1,0;;;;;;;;1,0;3,0;;;;;;;;;;1,0;;;1,0;1,0;;;;;;;1,0;;;;;;1,0;;;;;;;;1,0;;;;;;1,0;;;;1,0;;;;;;;;1,0;;;;;;;;;;;;;;;;;3,0;;7,0;;;;;;4,0;;;;4,0;;;;;13,0;;;;;;1,0;;;;;;;;;;;;;;;;;;;;;;;;;;;;;;;;;;;;;12,0;;3,0;;;2,0;;;1,0;;;;;3,0;;;;;;;;;;;;;;;;1,0;;;;;1,0;2,0;;2,0;;;;;;;;;;;;;;;;2,0;;;;;;4,0;;3,0;;1,0;;;;;;6,0;;;;;;;;;;;;;;;;;;;;;4,0;;;;;2,0;;;;;;;1,0;;;;;;;;;;1,0;;;;;;;;;;;;;;;;;;1,0;1,0;;;;;;10,0;;3,0;;;;;1,0;;;;;;;;;4,0;;;2,0;28,0;;;;;1,0;;5,0;2,0;;;;1,0;4,0;;2,0;;;;;;;;;;;;7,0;;7,0;;;;;;2,0;;;;;;;;;1,0;19,0;;;;;;;;;;;;;;;;;1,0;;;;;;;;;;;;;;;;;;;7,0;;;;;;;18,0;;4,0;;;2,0;;;;;2,0;2,0;;;1,0;3,0;;;;;;;;;;;;;;;;;;;;;;;;;;;;;;;;;;;;;;;;;;;;1,0;;;;2,0;;;;;;;;;;;;;;;;;;;;;;;;;;;;;;;;;;;;;;;;;;;;;;;;;;;;;;;;;;;;;;;;;;;;;;;3,0;;;;;;;;;;;;;;;;;;;;;;;;;;;;;;;;;;;;;;;;;;;;;;;;;;;;;;;;;;;;;;;;;;;;;;;;;;;;;;;;;;;;;;;;;;;;;;;;;;;;;;;;;;;;;;;;;;;;;;;;;;
detachably;;45,0;;;;;;20,0;;;;;;;;15,0;;;;;;1,0;1,0;;;;;;;;;2,0;18,0;;;1,0;;;;;1,0;;1,0;;;;;29,0;3,0;2,0;1,0;1,0;;;14,0;;10,0;;;;;;;;1,0;;7,0;;;;;1,0;;;;;;;;26,0;;9,0;;31,0;;;71,0;;;;111,0;;;1,0;;1,0;2,0;;3,0;;;;13,0;;3,0;;;1,0;;;;3,0;;;;9,0;24,0;1,0;;;;;;;;;;;;;;;;;;;;;;;;;;3,0;;;3,0;11,0;2,0;;;;;2,0;;;30,0;;;;;;56,0;;;;6,0;;;;;;;;;;5,0;5,0;;;;156,0;;;;;;1,0;;;;;;53,0;;10,0;;;1,0;10,0;;;;7,0;;;;;;;1,0;;;;;;2,0;;;1,0;22,0;;1,0;;;;;;1,0;;28,0;;2,0;119,0;;;;1,0;;11,0;;;;;;;;;;;;;;;;;4,0;;;;;;4,0;;;;1,0;;2,0;;9,0;;;;;3,0;;28,0;;8,0;;;;;;;;;;;;;;;3,0;;;;;;;;86,0;;;;;;;;;1,0;;;;;;17,0;;37,0;;4,0;;;1,0;;32,0;;;;;38,0;;;;1,0;;1,0;2,0;;;;;;;1,0;;;;;;;;24,0;;;;11,0;;;;;;;;;;;6,0;;;;;;;;;3,0;;3,0;;;1,0;;;;;;;;;1,0;;;1,0;4,0;;;;;;;;8,0;;;;;;;;;;;;;;;;;;;;;;;;1,0;;;;1,0;;;;;4,0;;;;2,0;;;;6,0;;;;1,0;;3,0;;;;;;;;;;;;;;;;;;;;;;;;;;;;;;;;;;;;;;;;;;;;;;;;12,0;;2,0;;2,0;2,0;;;;;;;;3,0;;;;;;;1,0;;;;12,0;;;;;;;;;;;;;;;;;;;;;;;;;;;;;2,0;;;;;;;;;;7,0;2,0;;;;;2,0;;;;;;8,0;;;1,0;1,0;;;;2,0;;;;;;;1,0;;1,0;;;;6,0;;;;;;;;1,0;;;;;;;;;;;;;;;;;;;;2,0;;;;;;5,0;;;;;2,0;;;;6,0;;;;;;;;;;;;;;;;;;3,0;;;;;6,0;;;;;;;1,0;;12,0;;4,0;;;3,0;;3,0;1,0;;;2,0;2,0;;4,0;;;;1,0;;;;;;;;;;;2,0;4,0;;;;;;;;;;;;;;;;;;;;;;;2,0;;;;;;;;;;;;;;6,0;;;;;;;;;4,0;;;;;;;;;;;;;;;;;;;;;;;;;;;;;;;;;;;;;;;;;;;;;;;;;;;;;;;;;;;;;;;;;;;;;;;;;;;;;;;;;;;;;;;;;;;;;;;;;;;;;;;;;;;;;;;;;;;;;;;1,0;1,0;;;;;;;2,0;;;;;;;;;;;;;;;;;;;;;;;;;;;;;;;;;;;;;;;;;;;;;;;;;;;;;;;;;;;;1,0;;;;;;;;;;;;;;;;;;;;;;;;;;;;3,0;;;;;;;;;;;;;;;;;;;;;;;;;;;;;;;;;;;;;;;
detector;;1,0;1,0;;2,0;44,0;30,0;82,0;113,0;47,0;214,0;;18,0;13,0;25,0;51,0;41,0;9,0;11,0;;2,0;30,0;8,0;17,0;1,0;2,0;27,0;5,0;;10,0;10,0;13,0;233,0;3,0;46,0;58,0;5,0;9,0;3,0;;38,0;;25,0;1,0;722,0;80,0;87,0;117,0;21,0;44,0;42,0;41,0;;5,0;13,0;9,0;43,0;24,0;1,0;;1,0;11,0;43,0;;26,0;49,0;109,0;28,0;26,0;5,0;16,0;1,0;39,0;;;42,0;2,0;5,0;13,0;515,0;25,0;114,0;6,0;140,0;;5,0;68,0;2,0;;10,0;181,0;;;5,0;5,0;56,0;6,0;;85,0;2,0;2,0;4,0;40,0;93,0;1,0;34,0;163,0;4,0;43,0;5,0;9,0;10,0;;;1,0;132,0;54,0;329,0;27,0;35,0;;;8,0;24,0;33,0;11,0;;12,0;78,0;20,0;;14,0;48,0;1,0;1,0;22,0;10,0;20,0;19,0;2,0;27,0;4,0;8,0;49,0;6,0;;;2,0;87,0;11,0;13,0;8,0;28,0;6,0;48,0;3,0;127,0;;26,0;3,0;;15,0;97,0;;6,0;;28,0;32,0;9,0;27,0;25,0;;2,0;13,0;18,0;16,0;38,0;14,0;;;3,0;58,0;;12,0;4,0;16,0;;62,0;1,0;1,0;;;;32,0;;12,0;;1,0;4,0;6,0;;2,0;6,0;43,0;12,0;2,0;6,0;21,0;16,0;131,0;2,0;18,0;1,0;7,0;;;1,0;2,0;;3,0;66,0;5,0;;8,0;1,0;3,0;18,0;;152,0;1,0;18,0;1,0;4,0;56,0;3,0;19,0;30,0;9,0;2,0;1,0;9,0;20,0;7,0;18,0;11,0;4,0;4,0;2,0;89,0;37,0;2,0;8,0;;;4,0;36,0;94,0;59,0;9,0;1,0;1,0;;2,0;27,0;;54,0;12,0;8,0;8,0;;7,0;78,0;5,0;;10,0;;20,0;7,0;30,0;80,0;11,0;;4,0;4,0;;40,0;4,0;3,0;;;5,0;;11,0;3,0;;;;;2,0;;10,0;1,0;1,0;2,0;;;2,0;7,0;2,0;;;4,0;7,0;;;1,0;2,0;;;53,0;4,0;;1,0;;26,0;10,0;;;;;3,0;;;;;7,0;;2,0;6,0;;;5,0;;11,0;;3,0;;17,0;7,0;4,0;;2,0;;;2,0;;;47,0;1,0;3,0;2,0;1,0;;;1,0;1,0;;1,0;;6,0;1,0;1,0;;;;2,0;17,0;2,0;18,0;7,0;8,0;;6,0;;;1,0;;;;9,0;2,0;38,0;4,0;;;8,0;;;8,0;2,0;1,0;;;25,0;2,0;;;13,0;25,0;17,0;28,0;2,0;6,0;;1,0;2,0;5,0;;;3,0;2,0;;;1,0;;6,0;4,0;39,0;;1,0;5,0;12,0;7,0;3,0;58,0;9,0;1,0;17,0;8,0;1,0;5,0;219,0;35,0;;2,0;10,0;27,0;1,0;3,0;1,0;1,0;1,0;2,0;;5,0;18,0;7,0;1,0;;;17,0;24,0;;8,0;1,0;;2,0;3,0;15,0;17,0;1,0;;22,0;2,0;1,0;1,0;20,0;11,0;4,0;;25,0;4,0;;1,0;2,0;16,0;;;1,0;44,0;;1,0;41,0;4,0;2,0;;6,0;4,0;3,0;20,0;18,0;1,0;;7,0;3,0;1,0;1,0;1,0;12,0;1,0;;2,0;;;1,0;1,0;;;;;4,0;6,0;;7,0;2,0;;;;;4,0;;;;;1,0;;24,0;3,0;3,0;;;5,0;;2,0;;6,0;3,0;;;10,0;1,0;;33,0;23,0;;8,0;;6,0;;;11,0;;11,0;1,0;1,0;;2,0;16,0;1,0;;8,0;1,0;13,0;;3,0;1,0;2,0;5,0;1,0;;5,0;;;;5,0;2,0;;2,0;8,0;;;;;8,0;;6,0;;;7,0;;4,0;2,0;;13,0;2,0;5,0;;;;;2,0;4,0;2,0;;8,0;;;;;;4,0;;;2,0;1,0;1,0;20,0;13,0;;;;;1,0;5,0;;;5,0;;1,0;;2,0;12,0;3,0;3,0;;;;2,0;;;;5,0;;;6,0;4,0;;1,0;9,0;;;;;1,0;1,0;2,0;1,0;10,0;;1,0;3,0;;2,0;;;;;1,0;;;;1,0;8,0;;;1,0;3,0;2,0;;3,0;;12,0;;;;8,0;23,0;;;;;;9,0;;;3,0;1,0;2,0;19,0;;;;;;;;;;;;;11,0;;;;2,0;1,0;9,0;;5,0;1,0;3,0;3,0;;18,0;4,0;;9,0;;;5,0;1,0;;1,0;1,0;;;2,0;7,0;;;3,0;;2,0;;;3,0;;5,0;;1,0;;;7,0;2,0;;;;;;;14,0;1,0;13,0;;;;;1,0;8,0;;34,0;;1,0;7,0;;1,0;;12,0;5,0;;3,0;;2,0;;;;;8,0;4,0;;1,0;7,0;4,0;;;;;10,0;1,0;8,0;;;3,0;;;3,0;1,0;6,0;;;4,0;4,0;;;8,0;2,0;;;11,0;1,0;4,0;;;7,0;;1,0;4,0;;15,0;;;1,0;6,0;;7,0;;;;;2,0;;;;;;;;;;;;;;13,0;;1,0;3,0;;2,0;;2,0;;;34,0;;;7,0;4,0;2,0;;3,0;;;2,0;;;1,0;;;;;3,0;;;;;;39,0;3,0;17,0;;1,0;2,0;;;;1,0;;;;1,0;1,0;;35,0;;1,0;13,0;4,0;2,0;;2,0;1,0;;1,0;;;;;;;;3,0;;;;;;;;;3,0;1,0;;3,0;;;;;;;;1,0;4,0;1,0;;1,0;;;;;;1,0;6,0;3,0;8,0;;;;;;3,0;6,0;1,0;;11,0;;6,0;;;;;;1,0;;2,0;;;1,0;;8,0;;;;;;;;;
diaphragm;;6,0;;;;;487,0;136,0;17,0;101,0;14,0;2,0;;;17,0;37,0;7,0;1,0;2,0;;;22,0;19,0;;2,0;;;;;3,0;;14,0;73,0;;178,0;47,0;;;;;6,0;1,0;;3,0;14,0;4,0;5,0;70,0;2,0;4,0;11,0;9,0;;;108,0;2,0;11,0;;;;2,0;;14,0;;7,0;7,0;8,0;31,0;4,0;4,0;1,0;12,0;3,0;;;25,0;;2,0;5,0;97,0;;34,0;;80,0;2,0;7,0;90,0;;;7,0;418,0;;;;;12,0;1,0;;13,0;;;;1,0;46,0;11,0;37,0;145,0;8,0;3,0;5,0;4,0;18,0;;;;6,0;82,0;76,0;38,0;11,0;14,0;;2,0;;;1,0;;6,0;;1,0;;;70,0;2,0;;;3,0;3,0;;;;;13,0;11,0;22,0;;;81,0;3,0;9,0;;;;5,0;18,0;5,0;64,0;2,0;;;;3,0;338,0;;20,0;;1,0;;;1,0;31,0;;;50,0;32,0;2,0;;2,0;;;;33,0;;;1,0;;;;1,0;;;;;6,0;;11,0;;;;13,0;2,0;;;37,0;;;1,0;;51,0;;;;7,0;;;;;1,0;;3,0;1,0;;1,0;;;;;;58,0;;24,0;2,0;4,0;24,0;7,0;117,0;6,0;30,0;2,0;;;;;16,0;;;;;1,0;11,0;6,0;;;;;1,0;16,0;1,0;;;2,0;;;2,0;;;7,0;;44,0;;8,0;3,0;5,0;;;19,0;26,0;;;18,0;9,0;;;1,0;;44,0;;;;;;;1,0;;;;;;;;2,0;3,0;13,0;1,0;;1,0;6,0;15,0;8,0;;;8,0;;;6,0;;;;;;;;30,0;;168,0;;26,0;;;1,0;;1,0;;;;;;1,0;2,0;;;;17,0;1,0;11,0;;;33,0;2,0;7,0;;1,0;;4,0;;1,0;;1,0;;;;10,0;;;;;;9,0;;;;;;;8,0;;17,0;5,0;11,0;1,0;4,0;;;3,0;10,0;;;;;7,0;4,0;;;;;;;;;;;;;;;;;;1,0;2,0;38,0;;1,0;;;7,0;;;4,0;;;;1,0;2,0;;;2,0;;;;;;3,0;3,0;;4,0;;2,0;28,0;;;1,0;54,0;;;21,0;22,0;;;13,0;47,0;;;;;3,0;;;;;3,0;;2,0;44,0;;;;;5,0;;;;;;;2,0;;;;;40,0;;;4,0;1,0;;;;;;;;;2,0;;;;;;;50,0;;;7,0;;9,0;;;;;;;;;;;;;;;2,0;;9,0;;;;;;;;;1,0;;;;;3,0;;;20,0;;5,0;;7,0;;;;;2,0;;;;2,0;;;6,0;;;;1,0;;1,0;;;;18,0;;;;;1,0;;;;;1,0;;;;;;;;;;;;;;;;;8,0;;;;;;;;12,0;;;;;;;1,0;;;;;3,0;;;;;;;;;;;;;;7,0;;;;;;;1,0;;;;;;;1,0;;;;;;;;;;;;;1,0;36,0;;;;;;;;;;;;;;12,0;;8,0;;;;3,0;3,0;;;;;;;;;;;;4,0;;10,0;;;3,0;;;1,0;;;;;;4,0;;;3,0;;;;21,0;;;;;;;;;;164,0;;;;4,0;;;;;;1,0;;;;;;;;;;;;;;;;;;;3,0;;;;;;4,0;;;;;;;;;;;;;;;;;;;;;;;;5,0;;6,0;;;;;1,0;;;;;;;;;;;;;;;;14,0;;;1,0;;;;;;;;;;;1,0;;;;;;;;4,0;;;;;;;;;;;;;;;;1,0;;;;;4,0;;;;2,0;;;;;;;;;;;;6,0;;;;;;;;;;;;;;;;;;1,0;;;;;;;2,0;;;;;;;;;2,0;;1,0;;;;;;;;;;;1,0;;;;;;;;;3,0;;;;;;;1,0;;1,0;;;;;;;;;;;;;;;;;;;1,0;4,0;;;;1,0;;;3,0;1,0;1,0;;;;;1,0;;1,0;;;;;2,0;;;;;;;;;;;;;;;;;;;;;;;;;;;;1,0;;;1,0;4,0;;
direct;;5,0;;1,0;5,0;8,0;6,0;10,0;12,0;22,0;7,0;;9,0;;26,0;9,0;57,0;;;1,0;4,0;34,0;;2,0;;;4,0;;;;13,0;;57,0;;24,0;5,0;2,0;5,0;;2,0;32,0;1,0;5,0;5,0;17,0;2,0;26,0;143,0;8,0;33,0;5,0;1,0;3,0;;3,0;3,0;28,0;;1,0;;;7,0;40,0;;4,0;;1,0;4,0;20,0;14,0;1,0;4,0;19,0;;;2,0;1,0;17,0;34,0;164,0;3,0;38,0;;40,0;2,0;16,0;;;;2,0;149,0;;;;1,0;6,0;3,0;;49,0;6,0;;4,0;40,0;76,0;6,0;9,0;105,0;;26,0;2,0;9,0;10,0;;;;24,0;51,0;30,0;4,0;13,0;9,0;1,0;7,0;14,0;30,0;11,0;1,0;;15,0;10,0;;4,0;6,0;;;;2,0;1,0;1,0;;8,0;1,0;2,0;64,0;;;;29,0;21,0;;;;9,0;9,0;8,0;;57,0;;1,0;4,0;1,0;4,0;64,0;;;4,0;32,0;117,0;7,0;2,0;3,0;;;4,0;15,0;;14,0;;;;2,0;19,0;;;;3,0;;17,0;;2,0;;;;10,0;;32,0;7,0;;;5,0;;2,0;;38,0;;;;2,0;4,0;12,0;3,0;;2,0;1,0;4,0;;;;;;21,0;8,0;9,0;;2,0;11,0;1,0;;304,0;1,0;2,0;2,0;7,0;15,0;3,0;2,0;8,0;4,0;5,0;;3,0;3,0;1,0;36,0;;;;7,0;8,0;9,0;;;;;;2,0;33,0;35,0;4,0;;;;;6,0;3,0;;1,0;4,0;1,0;;;97,0;7,0;2,0;;;5,0;3,0;1,0;52,0;15,0;5,0;;2,0;;9,0;;1,0;;5,0;29,0;3,0;;;6,0;4,0;;;;;1,0;7,0;3,0;;1,0;;;4,0;1,0;1,0;;1,0;2,0;4,0;1,0;9,0;1,0;;6,0;1,0;;;4,0;12,0;;;4,0;6,0;;;;2,0;;;4,0;7,0;1,0;2,0;;3,0;;1,0;;4,0;;4,0;6,0;4,0;3,0;2,0;4,0;1,0;9,0;8,0;;5,0;;2,0;4,0;5,0;;8,0;;;;6,0;;3,0;;6,0;1,0;;;;;;5,0;2,0;1,0;;;;8,0;7,0;;;;1,0;;8,0;2,0;21,0;;5,0;;1,0;1,0;;12,0;;;;2,0;9,0;;;;;;2,0;1,0;1,0;;;7,0;5,0;1,0;;;;;4,0;13,0;;;;;;;;;9,0;3,0;1,0;23,0;;2,0;8,0;8,0;;9,0;1,0;2,0;;;6,0;9,0;6,0;22,0;1,0;2,0;;;1,0;;3,0;3,0;;;;13,0;;2,0;;;;;2,0;;1,0;1,0;2,0;;;8,0;;2,0;;13,0;1,0;4,0;;2,0;4,0;8,0;2,0;;;;;;13,0;2,0;6,0;;;1,0;;17,0;;3,0;3,0;2,0;8,0;;;12,0;;1,0;1,0;;6,0;;;5,0;;;;7,0;;;;16,0;;2,0;;18,0;2,0;;2,0;;;;22,0;;;;4,0;10,0;;1,0;;;;;3,0;;5,0;;3,0;;;;19,0;;4,0;;;;;1,0;;;11,0;;5,0;1,0;18,0;3,0;;9,0;;;;;4,0;;4,0;;;;2,0;;7,0;52,0;2,0;;;;1,0;;;;;1,0;;55,0;1,0;;;;1,0;;;1,0;1,0;;4,0;6,0;1,0;;;8,0;;3,0;;1,0;;;;;;;;;;16,0;;;;1,0;1,0;;2,0;1,0;;1,0;;1,0;3,0;;1,0;1,0;;1,0;;;;1,0;1,0;;2,0;;;;;;;;;;;;2,0;;;1,0;1,0;;;2,0;1,0;;1,0;;;1,0;;;;;2,0;7,0;;;;;;;;;2,0;;;;2,0;4,0;;3,0;;1,0;5,0;1,0;;;;;3,0;;;;;;3,0;;3,0;;;1,0;;;1,0;;;;;;;3,0;;;1,0;2,0;;14,0;;2,0;1,0;;2,0;;;;3,0;;1,0;;;;;;5,0;;;;1,0;;;5,0;;;;;1,0;5,0;;;;;;1,0;;;1,0;1,0;1,0;;3,0;;;;2,0;;;;1,0;;;;2,0;8,0;1,0;;;;;;;;2,0;;;;;;;;;;1,0;;;;;;;;;;;1,0;3,0;;;;;;;;1,0;;;;;;4,0;3,0;;;2,0;16,0;;;1,0;1,0;;1,0;;;1,0;;;;;3,0;;;2,0;3,0;;;;;;4,0;;;9,0;;;;5,0;;;5,0;;;;;;;;;;1,0;;;1,0;8,0;1,0;;4,0;;;4,0;;2,0;;;;9,0;;2,0;;;;;2,0;;;;;;;17,0;;;10,0;1,0;;;;1,0;;;;3,0;3,0;;;;;3,0;;;;;;;1,0;1,0;;;4,0;;;1,0;;;;;;1,0;;4,0;;1,0;;;;;;;3,0;;;;;;;;;;;;1,0;;;;;;;;;5,0;;;;;;;1,0;2,0;;;;;;;
direction;;69,0;12,0;2,0;4,0;215,0;40,0;155,0;125,0;292,0;84,0;;19,0;;1359,0;327,0;38,0;6,0;6,0;5,0;23,0;138,0;30,0;23,0;17,0;9,0;96,0;12,0;3,0;13,0;12,0;22,0;153,0;3,0;153,0;65,0;26,0;51,0;10,0;;37,0;18,0;38,0;15,0;201,0;87,0;258,0;362,0;62,0;192,0;151,0;137,0;7,0;36,0;330,0;68,0;223,0;16,0;26,0;1,0;512,0;20,0;91,0;;74,0;16,0;157,0;124,0;107,0;59,0;30,0;17,0;111,0;;1,0;50,0;12,0;9,0;28,0;845,0;35,0;205,0;1,0;158,0;57,0;16,0;10,0;12,0;34,0;230,0;987,0;;;6,0;8,0;16,0;29,0;;177,0;29,0;1,0;;128,0;231,0;3,0;19,0;1238,0;38,0;126,0;30,0;27,0;41,0;15,0;1,0;13,0;237,0;430,0;450,0;29,0;214,0;13,0;11,0;9,0;41,0;34,0;6,0;1,0;5,0;16,0;64,0;;119,0;355,0;1,0;61,0;5,0;60,0;69,0;2,0;6,0;30,0;1,0;1,0;191,0;51,0;4,0;;253,0;182,0;26,0;33,0;9,0;8,0;26,0;40,0;13,0;218,0;7,0;192,0;143,0;14,0;15,0;761,0;10,0;61,0;;45,0;330,0;2,0;14,0;71,0;6,0;9,0;73,0;139,0;60,0;96,0;76,0;19,0;5,0;15,0;144,0;3,0;7,0;74,0;40,0;;132,0;12,0;13,0;3,0;1,0;4,0;83,0;2,0;43,0;;;4,0;90,0;34,0;7,0;47,0;;48,0;31,0;30,0;13,0;5,0;218,0;21,0;2,0;121,0;2,0;5,0;2,0;30,0;6,0;13,0;63,0;80,0;52,0;68,0;25,0;7,0;49,0;68,0;10,0;339,0;3,0;473,0;6,0;41,0;104,0;173,0;620,0;379,0;88,0;351,0;76,0;30,0;9,0;15,0;43,0;11,0;;20,0;11,0;446,0;194,0;142,0;11,0;6,0;11,0;14,0;7,0;148,0;19,0;10,0;1,0;9,0;;3,0;41,0;17,0;41,0;50,0;16,0;37,0;;113,0;58,0;86,0;4,0;;83,0;10,0;26,0;56,0;334,0;13,0;;39,0;49,0;8,0;94,0;20,0;17,0;1,0;2,0;92,0;405,0;27,0;5,0;28,0;4,0;21,0;2,0;39,0;3,0;57,0;17,0;47,0;127,0;7,0;5,0;67,0;37,0;28,0;20,0;;37,0;4,0;375,0;48,0;19,0;4,0;59,0;14,0;38,0;10,0;;10,0;5,0;166,0;;22,0;19,0;8,0;8,0;53,0;12,0;4,0;1,0;1,0;6,0;9,0;174,0;24,0;155,0;1,0;71,0;6,0;12,0;52,0;13,0;35,0;59,0;265,0;21,0;17,0;692,0;2,0;76,0;100,0;14,0;12,0;123,0;17,0;8,0;8,0;20,0;1,0;51,0;47,0;;;34,0;13,0;21,0;21,0;6,0;1,0;2,0;63,0;1,0;41,0;31,0;276,0;155,0;16,0;2,0;23,0;98,0;1,0;104,0;19,0;;16,0;176,0;4,0;35,0;16,0;4,0;6,0;10,0;44,0;129,0;32,0;1,0;109,0;79,0;;42,0;4,0;7,0;;31,0;12,0;107,0;130,0;12,0;13,0;4,0;6,0;32,0;3,0;17,0;9,0;1,0;;16,0;43,0;16,0;;5,0;6,0;31,0;;25,0;;77,0;44,0;44,0;27,0;31,0;21,0;30,0;38,0;1,0;5,0;119,0;313,0;8,0;4,0;15,0;51,0;5,0;47,0;9,0;2,0;35,0;;11,0;12,0;32,0;1,0;8,0;10,0;11,0;25,0;50,0;2,0;54,0;6,0;16,0;6,0;16,0;13,0;17,0;6,0;44,0;;5,0;88,0;;79,0;37,0;29,0;11,0;116,0;77,0;;116,0;42,0;4,0;4,0;1,0;4,0;61,0;;3,0;3,0;4,0;13,0;58,0;5,0;10,0;20,0;6,0;27,0;1,0;;101,0;11,0;17,0;5,0;1,0;21,0;3,0;10,0;25,0;58,0;;;;3,0;;14,0;4,0;2,0;6,0;6,0;52,0;6,0;2,0;9,0;10,0;;4,0;;3,0;6,0;16,0;1,0;2,0;66,0;;2,0;145,0;5,0;63,0;;7,0;;1,0;7,0;3,0;3,0;23,0;1,0;2,0;17,0;8,0;1,0;26,0;1,0;1,0;13,0;11,0;;6,0;41,0;;25,0;8,0;1,0;9,0;1,0;1,0;7,0;;38,0;;;8,0;;6,0;;1,0;4,0;43,0;;20,0;4,0;7,0;;24,0;13,0;1,0;;;;6,0;4,0;3,0;;6,0;66,0;1,0;32,0;;10,0;1,0;;7,0;7,0;15,0;;;;12,0;12,0;1,0;1,0;2,0;2,0;2,0;;1,0;3,0;;8,0;8,0;3,0;1,0;55,0;17,0;1,0;2,0;6,0;1,0;40,0;19,0;1,0;;10,0;10,0;2,0;4,0;;;13,0;;;2,0;11,0;7,0;34,0;1,0;3,0;6,0;;2,0;25,0;11,0;4,0;27,0;5,0;16,0;9,0;16,0;2,0;;27,0;;1,0;92,0;7,0;37,0;20,0;16,0;9,0;;;7,0;1,0;9,0;2,0;2,0;10,0;4,0;15,0;57,0;3,0;367,0;7,0;1,0;3,0;1,0;;6,0;;;;79,0;9,0;10,0;9,0;6,0;;8,0;18,0;;3,0;73,0;4,0;143,0;29,0;5,0;1,0;;;40,0;4,0;5,0;12,0;;58,0;4,0;14,0;26,0;;4,0;;96,0;24,0;5,0;34,0;10,0;;1,0;37,0;;28,0;1,0;16,0;12,0;3,0;9,0;10,0;6,0;;27,0;;;2,0;279,0;4,0;13,0;2,0;;2,0;1,0;2,0;20,0;;5,0;6,0;1,0;;2,0;;;3,0;6,0;;126,0;3,0;;2,0;69,0;25,0;6,0;2,0;10,0;1,0;50,0;30,0;15,0;13,0;2,0;5,0;;9,0;3,0;76,0;;3,0;20,0;8,0;;9,0;14,0;23,0;2,0;1,0;2,0;117,0;9,0;5,0;8,0;4,0;2,0;;3,0;;7,0;15,0;7,0;19,0;;;;8,0;3,0;4,0;49,0;6,0;12,0;;;25,0;1,0;;9,0;5,0;;;1,0;;3,0;4,0;16,0;11,0;3,0;;16,0;2,0;;2,0;;;;2,0;;1,0;;;7,0;7,0;;;11,0;7,0;;;1,0;5,0;1,0;3,0;6,0;6,0;;14,0;4,0;10,0;;;30,0;;1,0;4,0;4,0;;14,0;6,0;1,0;;7,0;11,0;4,0;;;3,0;;;2,0;;;7,0;20,0;4,0;;12,0;;;;8,0;2,0;2,0;;7,0;4,0;26,0;1,0;13,0;21,0;;4,0;33,0;;2,0;21,0;11,0;13,0;22,0;;3,0;7,0;;30,0;36,0;67,0;15,0;2,0;4,0;8,0;12,0;2,0;3,0;;;69,0;8,0;1,0;9,0;3,0;6,0;1,0;;10,0;7,0;;5,0;11,0;;1,0;6,0;25,0;3,0;4,0;7,0;6,0;2,0;5,0;9,0;;;8,0;2,0;1,0;;5,0;23,0;17,0;4,0;;;;;;33,0;19,0;2,0;;1,0;6,0;;15,0;5,0;;3,0;8,0;;4,0;7,0;1,0;1,0;;;7,0;;;9,0;;;;;
distal;;3,0;;;;7,0;3,0;4,0;1,0;16,0;;;;2,0;31,0;17,0;7,0;;;;;;;21,0;;;1,0;;;;;;15,0;;9,0;;;;;;5,0;;14,0;;2,0;2,0;;22,0;1,0;23,0;33,0;15,0;;2,0;1,0;18,0;42,0;;;;69,0;;;;;;;31,0;8,0;12,0;;;7,0;;;;;;;14,0;6,0;9,0;;44,0;;;;;2,0;4,0;35,0;;;10,0;;;3,0;;8,0;;;;17,0;1,0;;;37,0;;6,0;;1,0;;1,0;;;10,0;210,0;67,0;;;2,0;1,0;;1,0;;;;;;1,0;;2,0;5,0;2,0;4,0;;4,0;;;;;;;8,0;;2,0;3,0;29,0;;9,0;1,0;3,0;;1,0;;;22,0;;2,0;;;;5,0;;;;5,0;1,0;;;;;1,0;8,0;;;19,0;18,0;;;4,0;13,0;;7,0;;7,0;;47,0;;;;;5,0;51,0;;9,0;;;7,0;18,0;24,0;;;5,0;;17,0;;;;53,0;;2,0;7,0;;;;3,0;;2,0;9,0;30,0;;22,0;6,0;7,0;1,0;3,0;14,0;24,0;;55,0;;4,0;46,0;16,0;;4,0;60,0;1,0;37,0;;12,0;6,0;2,0;;;;;;;7,0;2,0;18,0;4,0;;;7,0;3,0;;;4,0;2,0;5,0;2,0;;;14,0;1,0;;;1,0;5,0;5,0;;;3,0;;20,0;2,0;94,0;;;;;;;;;7,0;14,0;;;;;18,0;;;;11,0;6,0;1,0;;24,0;;3,0;;3,0;6,0;16,0;;;8,0;1,0;2,0;5,0;;;8,0;3,0;17,0;2,0;;7,0;;;2,0;3,0;10,0;;;37,0;9,0;;21,0;1,0;;;6,0;4,0;10,0;3,0;;9,0;;;7,0;8,0;2,0;12,0;;;4,0;;;;1,0;2,0;4,0;;;;;4,0;7,0;3,0;140,0;;1,0;8,0;;;;;;;2,0;4,0;8,0;;1,0;3,0;;;28,0;;;5,0;;;30,0;;1,0;;;2,0;;1,0;2,0;2,0;;;;;6,0;;;;;;;;;;;;;6,0;;;;;;;;;;2,0;;;;;;;1,0;2,0;;;;;;;;7,0;;;;;;;;;;;;;;1,0;;;;;;;;;2,0;;;;;;;;;1,0;;;;;7,0;;7,0;;6,0;2,0;;;;;;;;;;;1,0;;;1,0;1,0;1,0;;;;2,0;;6,0;;;;;;;;;;1,0;1,0;;;;;4,0;;;;;17,0;;;;1,0;;1,0;;;;;;;;1,0;;;;;;;;;;5,0;;;;11,0;;10,0;20,0;;;2,0;;;4,0;;2,0;2,0;;;;;12,0;;2,0;;1,0;;;;1,0;;;;;;;;18,0;;1,0;;;3,0;1,0;;;;;;12,0;;;;;;;;;;1,0;;4,0;1,0;;;5,0;;;;;;1,0;;;;9,0;;;;;;;2,0;;2,0;;;;;;;;;;4,0;;17,0;1,0;;;;;2,0;5,0;1,0;;;4,0;;7,0;;;1,0;;;;3,0;;;;3,0;;;;8,0;;4,0;17,0;4,0;1,0;1,0;11,0;;2,0;;;;2,0;;;;;;;1,0;9,0;;;;;;3,0;;1,0;;8,0;;;2,0;;;;13,0;;2,0;;8,0;16,0;;;;;;;9,0;;;4,0;5,0;;;;;;;30,0;3,0;17,0;;8,0;;;;;2,0;1,0;9,0;1,0;;9,0;1,0;;1,0;;;;;;;;;;;;;;1,0;;;;;;;;2,0;;;;;;;;;;;;;;;;;;;;;;;1,0;;;;;;;;5,0;;;;2,0;;;;;;;;1,0;;11,0;;;;;;2,0;;;;3,0;;2,0;;6,0;;9,0;;;;;;;2,0;;;;;;;;;;;;;;;;2,0;;;;;2,0;;;;;;;5,0;6,0;;;;;;;;;;;;2,0;;;1,0;;;;;1,0;;;;;;;;;;;;;5,0;;18,0;;;;;;1,0;3,0;;3,0;;;;;;;;;;;;;;;;;;;;;14,0;;;;;1,0;1,0;;;;;;;;;;1,0;;2,0;;;;;;;;;;;;;2,0;;;;;2,0;;;;;;;;;;;;;;;;;;;;;;;;;;
door;;2,0;;1,0;;2,0;;1,0;;2,0;;;;;2,0;3,0;;;;;;;;;;;;3,0;;;;;14,0;;1,0;;;;;;2,0;;;;4,0;;3,0;12,0;;1,0;;;;;;10,0;1,0;;;;9,0;;12,0;;;;;;9,0;6,0;1,0;;;;;;;;;2,0;3,0;;;15,0;;;;;;;2,0;;;;;;1,0;;5,0;1,0;;;7,0;;;;;;;;;;;;;;24,0;74,0;;;;;;;1,0;;;;;;;;4,0;5,0;;;;;;;;3,0;;14,0;;;;16,0;;2,0;;;3,0;;;;15,0;;2,0;;;;11,0;;;;;9,0;;;;;;4,0;;;7,0;;;;;7,0;;4,0;;;;;;;;;;3,0;;;;;4,0;6,0;;;;;2,0;;;;;26,0;;;;;;;;;;2,0;57,0;;27,0;;;6,0;;;;;;;;14,0;7,0;;;56,0;1,0;29,0;;5,0;;;;;;;;4,0;1,0;;;;;;2,0;;;;;;18,0;1,0;;;;;;;2,0;;1,0;;;;;37,0;;7,0;2,0;;;;;;;;;;17,0;4,0;;;13,0;;1,0;;4,0;;;8,0;1,0;;;;2,0;;24,0;;;18,0;;;64,0;;9,0;;;15,0;;;;;;;1,0;;;;2,0;15,0;;;;;;;;;;;2,0;3,0;5,0;;7,0;1,0;8,0;;;;;;;2,0;;;;;;;;;;;;38,0;;;;;;;;;;;5,0;10,0;;1,0;;;;;;;;;;;;;;;;16,0;7,0;;;;7,0;;;2,0;;;;;;;2,0;;;;;;;;;;;;;;;;;;;;;;;;;;;;;;;;;13,0;;;2,0;;;;;;;2,0;;;;;;;;1,0;;;1,0;;;;;;;;2,0;;;;;;;1,0;;;;;;;;;;;;;;;;;3,0;;4,0;1,0;;;;;;;;;;2,0;;;;;;;;;;;;;;;;;;;;;;;;;3,0;;;;;2,0;;;;;;;14,0;;;;;;;2,0;;7,0;1,0;;;;;;;;;9,0;3,0;;;;;;;;11,0;1,0;1,0;;;5,0;;;;;;;;;2,0;;;7,0;1,0;;;;;;10,0;;;;;;;7,0;;;;;2,0;;;;;;;;;;1,0;;;;;;12,0;;;;;1,0;;;;;;;;;4,0;;;;;;;;;;;;3,0;;;;;;;;;;;;;;8,0;;;;;;;;;;;;;;;5,0;;;;;13,0;;;;;;;;;;;;5,0;;;;;;;;;;;;;;;;;;;;;;;;;;;;;;;;;;;;;4,0;;;;;;;;;;;;6,0;;;;6,0;;;;;;;;;;;;;;;;;;;;;;;;;;;;;;2,0;;;;;;;;;;;;;;;;;;;;;;;;;;;;;;;;;;;;;;;;;;;;;;;;;;;;;;;;;;;;;;;;;;;;;;;;;;;;;;;;;;;;;;;;;;;;;;;;;;;;;;;;;;;;;;;;;;;;;;;;;;;;;;;;;;;;;;;;;;;;;;;;;;;;;;;;;;;;;;;;;;;;;;;;;;;;;;;;;;;;;;;;;;;;;;;;;;;;;;;;;;;;;;;;;;;;;;;;
driver;;8,0;;;3,0;2,0;;25,0;24,0;11,0;;;5,0;;21,0;23,0;;;3,0;3,0;3,0;23,0;2,0;;2,0;2,0;4,0;2,0;;;1,0;10,0;102,0;;172,0;52,0;2,0;4,0;;;3,0;1,0;6,0;;43,0;9,0;19,0;40,0;2,0;50,0;12,0;6,0;;1,0;123,0;3,0;26,0;;4,0;;4,0;1,0;12,0;;49,0;2,0;88,0;8,0;16,0;10,0;14,0;2,0;12,0;;;1,0;2,0;4,0;7,0;151,0;;26,0;;67,0;13,0;;3,0;4,0;;1,0;180,0;;;;;;9,0;;45,0;2,0;;;72,0;13,0;;39,0;19,0;3,0;18,0;3,0;5,0;38,0;;;;18,0;11,0;45,0;31,0;13,0;1,0;;2,0;2,0;36,0;3,0;;;;8,0;;2,0;6,0;;;;1,0;20,0;2,0;;;;;46,0;7,0;;;4,0;95,0;3,0;;;;5,0;22,0;33,0;127,0;;1,0;;;15,0;56,0;8,0;;;25,0;65,0;2,0;;35,0;;;3,0;3,0;7,0;19,0;4,0;2,0;;;14,0;;;;35,0;;;;;;;;54,0;;;1,0;;;12,0;5,0;;1,0;20,0;11,0;;1,0;;22,0;22,0;;;3,0;;;;;;;4,0;8,0;2,0;1,0;;3,0;1,0;;;24,0;1,0;8,0;;24,0;7,0;1,0;23,0;3,0;7,0;3,0;;;3,0;2,0;1,0;4,0;;;;4,0;;1,0;;;;;;10,0;12,0;;;;;4,0;20,0;;;3,0;;20,0;;3,0;23,0;1,0;;;4,0;7,0;1,0;2,0;13,0;11,0;;11,0;;;14,0;;;;;193,0;2,0;5,0;;;;;1,0;16,0;;21,0;3,0;;;1,0;;;;1,0;;;1,0;9,0;;6,0;2,0;;2,0;;12,0;;2,0;;;60,0;;1,0;;;;;;;;;3,0;1,0;5,0;14,0;4,0;;;;5,0;;7,0;11,0;24,0;5,0;;;1,0;;10,0;3,0;11,0;;2,0;;;;;;;;;;7,0;;;;;;5,0;5,0;;;;18,0;5,0;1,0;2,0;;;;9,0;;;1,0;;;3,0;;;;3,0;1,0;;2,0;34,0;;;;1,0;;5,0;3,0;;6,0;8,0;8,0;2,0;1,0;;;1,0;;;;;;1,0;3,0;6,0;;;;1,0;1,0;2,0;;8,0;2,0;;2,0;;3,0;2,0;26,0;2,0;24,0;10,0;9,0;;;50,0;39,0;;;2,0;;;;;2,0;;1,0;;;;6,0;;;11,0;;1,0;15,0;13,0;2,0;4,0;3,0;;;;9,0;;;;6,0;1,0;18,0;;1,0;1,0;;;;;1,0;;;;5,0;7,0;;4,0;;4,0;7,0;;6,0;;2,0;;;;2,0;;;;;8,0;;;;;;;;;4,0;2,0;1,0;;;;;;;;;1,0;;4,0;;;12,0;9,0;;;;2,0;2,0;;;;;10,0;;50,0;1,0;;;10,0;;;7,0;;2,0;;;;;10,0;;;2,0;5,0;4,0;;1,0;;2,0;;2,0;6,0;;;2,0;;;1,0;1,0;;3,0;;;;4,0;3,0;4,0;;;3,0;6,0;;;;5,0;1,0;2,0;;8,0;2,0;;1,0;;;;;1,0;;;;5,0;;;;;4,0;;;;1,0;6,0;;3,0;;;1,0;2,0;;;;;;2,0;;16,0;;;;;1,0;;3,0;;;4,0;5,0;;;;;19,0;;;;;;;;2,0;;10,0;;4,0;4,0;;8,0;;2,0;;;49,0;2,0;;;;;;2,0;22,0;4,0;2,0;;5,0;1,0;;7,0;;;;;;;;2,0;;;;3,0;1,0;;;3,0;;2,0;;;;;;8,0;;;;;;;1,0;4,0;;;;13,0;;2,0;;;;;;2,0;;2,0;;1,0;;;;2,0;;1,0;;;;;1,0;13,0;;;;;;1,0;;;;;;;16,0;1,0;;5,0;;1,0;;;1,0;17,0;;5,0;;3,0;;;;;5,0;;;;;;1,0;;;;;;5,0;5,0;2,0;1,0;;;;10,0;3,0;;2,0;;;2,0;2,0;;;;;;;;;;;2,0;;;;;3,0;4,0;;4,0;;;;;;;;;;;;14,0;2,0;;;;7,0;;5,0;;1,0;;;;;;;;;;9,0;;1,0;;;;;;;;;3,0;;;;;;1,0;2,0;;;;;1,0;8,0;;1,0;;;;;;;1,0;1,0;;;1,0;1,0;;1,0;;;;1,0;;19,0;;;;;;;;;;;;4,0;;;3,0;;;;8,0;;2,0;;23,0;5,0;;;;1,0;;;;1,0;;1,0;2,0;;2,0;2,0;;;;1,0;;;;;;;;4,0;;1,0;;;;;;;;;;;;;2,0;;;;;;4,0;;;;;;;1,0;;;;2,0;;19,0;2,0;13,0;4,0;;;;;3,0;;;;;1,0
driving;;3,0;1,0;1,0;2,0;30,0;31,0;360,0;25,0;42,0;10,0;;3,0;;147,0;161,0;1,0;6,0;2,0;;1,0;35,0;14,0;3,0;5,0;1,0;10,0;2,0;;5,0;1,0;21,0;294,0;1,0;347,0;116,0;3,0;7,0;;;35,0;2,0;15,0;;62,0;34,0;45,0;471,0;18,0;13,0;35,0;36,0;1,0;2,0;550,0;7,0;135,0;2,0;;;14,0;10,0;14,0;;6,0;1,0;178,0;46,0;51,0;;12,0;19,0;175,0;5,0;;42,0;2,0;1,0;7,0;255,0;;109,0;;238,0;3,0;14,0;82,0;3,0;;4,0;790,0;;3,0;2,0;;4,0;7,0;;274,0;15,0;;;255,0;80,0;1,0;24,0;157,0;12,0;109,0;;11,0;92,0;1,0;4,0;4,0;56,0;456,0;156,0;21,0;42,0;5,0;1,0;19,0;23,0;14,0;1,0;14,0;1,0;;13,0;1,0;27,0;39,0;10,0;2,0;;12,0;14,0;13,0;12,0;;2,0;31,0;107,0;27,0;4,0;13,0;45,0;323,0;2,0;15,0;3,0;7,0;22,0;18,0;79,0;130,0;2,0;96,0;54,0;;188,0;1373,0;2,0;1,0;1,0;2,0;13,0;;1,0;83,0;;2,0;47,0;96,0;20,0;95,0;103,0;34,0;1,0;19,0;78,0;3,0;4,0;16,0;41,0;;18,0;1,0;;4,0;;5,0;90,0;;29,0;1,0;1,0;5,0;9,0;1,0;;5,0;166,0;2,0;22,0;21,0;;15,0;111,0;4,0;;349,0;1,0;;;30,0;2,0;1,0;5,0;44,0;;15,0;;;5,0;2,0;7,0;53,0;3,0;424,0;;3,0;36,0;87,0;156,0;52,0;42,0;25,0;18,0;17,0;1,0;5,0;37,0;51,0;1,0;2,0;2,0;224,0;9,0;37,0;;;;18,0;37,0;91,0;;;;2,0;3,0;1,0;21,0;;5,0;41,0;2,0;63,0;;16,0;32,0;4,0;;;45,0;37,0;16,0;12,0;63,0;16,0;10,0;10,0;5,0;5,0;93,0;;9,0;;1,0;84,0;30,0;101,0;;8,0;;1,0;;32,0;1,0;127,0;9,0;15,0;;7,0;2,0;3,0;12,0;5,0;2,0;;20,0;17,0;10,0;36,0;3,0;;2,0;1,0;44,0;8,0;2,0;;;;;35,0;1,0;;;3,0;1,0;1,0;;;19,0;3,0;35,0;16,0;59,0;5,0;21,0;30,0;15,0;;3,0;10,0;134,0;17,0;8,0;10,0;15,0;1,0;76,0;155,0;1,0;5,0;18,0;5,0;3,0;;2,0;;2,0;16,0;;;5,0;1,0;;4,0;7,0;;4,0;3,0;;44,0;;87,0;36,0;16,0;1,0;1,0;29,0;1,0;10,0;4,0;1,0;;66,0;11,0;24,0;1,0;1,0;8,0;5,0;3,0;9,0;1,0;;;;;1,0;;;7,0;7,0;2,0;47,0;35,0;7,0;2,0;;;6,0;;1,0;;;;2,0;26,0;4,0;;;1,0;;;1,0;;20,0;18,0;13,0;4,0;1,0;5,0;5,0;50,0;;5,0;5,0;67,0;;;81,0;108,0;1,0;1,0;47,0;;;;;6,0;7,0;;;2,0;1,0;;;8,0;116,0;7,0;7,0;2,0;;4,0;7,0;7,0;;2,0;;8,0;;4,0;7,0;67,0;3,0;27,0;2,0;;21,0;4,0;1,0;;;3,0;1,0;14,0;2,0;;14,0;;5,0;;;;;116,0;;1,0;12,0;;4,0;3,0;;88,0;1,0;;1,0;;;;1,0;4,0;;4,0;;2,0;;9,0;10,0;;;2,0;;;4,0;;2,0;4,0;8,0;;2,0;30,0;1,0;;1,0;;136,0;;2,0;;3,0;10,0;;;8,0;;;;;2,0;;22,0;;4,0;;;27,0;6,0;3,0;;30,0;;;;2,0;1,0;;;;;2,0;;1,0;3,0;3,0;;1,0;;;11,0;2,0;;;1,0;;1,0;;1,0;2,0;10,0;2,0;;;;39,0;40,0;1,0;;3,0;1,0;7,0;1,0;;;;;1,0;1,0;;;;;;;1,0;9,0;1,0;;;1,0;;18,0;2,0;;3,0;11,0;6,0;;3,0;;;13,0;3,0;1,0;;;;;1,0;;;2,0;;5,0;16,0;21,0;3,0;;4,0;7,0;;4,0;2,0;4,0;;;10,0;;;39,0;3,0;4,0;25,0;1,0;168,0;60,0;;;;;2,0;;;7,0;;;;2,0;6,0;13,0;13,0;2,0;3,0;;4,0;2,0;;;;;;;3,0;4,0;1,0;;;;1,0;3,0;16,0;2,0;8,0;3,0;8,0;;;;18,0;;;;;84,0;10,0;;3,0;1,0;1,0;;133,0;2,0;2,0;2,0;3,0;2,0;;;;7,0;6,0;;4,0;;5,0;;9,0;;;;2,0;;1,0;;13,0;;;;;1,0;13,0;;;4,0;2,0;4,0;7,0;3,0;4,0;;;;16,0;;;4,0;95,0;1,0;3,0;4,0;1,0;;;19,0;29,0;25,0;2,0;;;1,0;4,0;6,0;;;4,0;;;14,0;9,0;1,0;3,0;;1,0;;21,0;3,0;5,0;1,0;10,0;;;13,0;8,0;;6,0;;4,0;;;3,0;10,0;;32,0;;;;;10,0;;4,0;;;;;;;;;2,0;;2,0;;14,0;3,0;;;;1,0;2,0;9,0;;4,0;5,0;;1,0;1,0;;;;2,0;;;;;3,0;;;3,0;;;;;1,0;;5,0;;3,0;;2,0;2,0;132,0;;9,0;;;31,0;;;;;;;;;;2,0;;;;;;;;10,0;;4,0;;;;;6,0;11,0;;1,0;;;;2,0;9,0;;1,0;13,0;;;5,0;1,0;51,0;13,0;8,0;21,0;;;;17,0;;;;;;5,0;;;;;;;;9,0;1,0;1,0;8,0;;;1,0;4,0;;;;1,0;;;1,0;;;;15,0;;;;;1,0;;;;;6,0;;;;;;2,0;;;;;;;2,0;1,0;;1,0;;1,0;;;;;1,0;3,0;;;;;
duration;;7,0;;2,0;1,0;;1,0;3,0;;;;;3,0;1,0;1,0;4,0;;;;;;11,0;;;1,0;;;7,0;;;2,0;2,0;6,0;;12,0;;;;1,0;;16,0;1,0;1,0;;2,0;1,0;8,0;18,0;7,0;11,0;;3,0;;;1,0;;2,0;;1,0;;1,0;;1,0;;;;;;7,0;;;1,0;3,0;;;4,0;6,0;;1,0;37,0;;;1,0;17,0;2,0;4,0;;;;;1,0;;;;15,0;2,0;2,0;;26,0;;;2,0;;12,0;;;1,0;6,0;;13,0;;;;;;10,0;8,0;2,0;13,0;29,0;2,0;;;;5,0;;;;;5,0;;6,0;;;2,0;;5,0;;;;12,0;;2,0;4,0;;;;;10,0;2,0;1,0;;3,0;6,0;;3,0;8,0;;;6,0;6,0;;6,0;;1,0;;17,0;2,0;;1,0;;;;;;;;;;;;9,0;;;3,0;;;;;;;;;;;;6,0;;;;;;;;1,0;;;1,0;20,0;;;;;11,0;;;;;;;;;;;;;;;26,0;;;;;;2,0;3,0;;;;;27,0;6,0;;7,0;;;;;;;;1,0;;1,0;;14,0;11,0;2,0;;;;;1,0;8,0;;1,0;;;6,0;;;3,0;2,0;;1,0;;6,0;;;;1,0;;;;;135,0;;;;;1,0;;;;;;;;;;;2,0;;;;;;;;;;;;;2,0;3,0;;;;1,0;;;;;;;;;;;;;;;;4,0;;;2,0;;;;4,0;;;;;;;;;;;;;;;;;;;;;;;;;;;2,0;;;;;;;;;;;;;8,0;;;;;;;;;;;;;;;2,0;;;6,0;3,0;;;;;;;;6,0;1,0;2,0;;13,0;3,0;1,0;;;;;;;;;;1,0;1,0;;;;;2,0;5,0;;6,0;6,0;1,0;3,0;8,0;3,0;7,0;;;;;1,0;3,0;;1,0;17,0;;;;;7,0;;2,0;2,0;1,0;;;;;;;;;;;;;;1,0;;5,0;3,0;1,0;;;;8,0;;;;;;;2,0;;2,0;;;5,0;;;;;;;;;;;;;;;;4,0;;;;;;;;2,0;;;;;;;;;;;;;;;3,0;;;;;;;;6,0;;;;;;4,0;1,0;;;1,0;;;;;;;;4,0;1,0;2,0;;;;;;4,0;;5,0;;;1,0;;;;;3,0;;;;;1,0;;;;4,0;;;;;;;;;;;;;;;;;;5,0;;;;5,0;;;3,0;;;;;;;;;;5,0;;;;;;;;1,0;;;;;;2,0;;;;;;;10,0;;;;;;;;8,0;;;;;;1,0;;;;;;;2,0;;;;;;;;;;;2,0;;;;;;;;;;;;;;;;;;;;;;;;;;;;;;;;;;;;;;;;2,0;;;;;;;;;;;;26,0;;;;;;;;;;;;;;;;1,0;;;1,0;;;;;;;;;;;;;;;;;;;;;6,0;;;;;;;;1,0;;;;;;;4,0;;;;;;3,0;;;;10,0;;;;4,0;;;;;;;4,0;;;;;;;;;4,0;;;;;;;1,0;;;;;;9,0;;1,0;;;;;;;1,0;;;;;;;;3,0;;1,0;;;;;;;;3,0;;;;;;;;;;;;;1,0;;;;1,0;;;;;;;;;;;;;;;;;1,0;2,0;;;;;;;;;;;;;;1,0;;;;;;;;;;;;;;;;;;;;;;;;;;;1,0;;;;;;;1,0;;;;;;;;;;;;;;3,0;1,0;;;;;1,0;;;;;;;;;;;1,0;;;;;;1,0;;;;;;;;;;;;;;;;;;;;;;;;4,0;;;;;;
elastic;;6,0;;;;6,0;10,0;15,0;6,0;26,0;;;;;20,0;54,0;;;;;;9,0;;;1,0;2,0;2,0;5,0;;;;;31,0;;2,0;;2,0;1,0;;;;;18,0;1,0;2,0;;;29,0;;;31,0;;;;22,0;;73,0;;;;13,0;8,0;;;;;1,0;30,0;13,0;;;;11,0;;;26,0;;;;17,0;;3,0;;51,0;;;2,0;;1,0;4,0;31,0;;;40,0;;1,0;;;4,0;3,0;;;90,0;3,0;;;15,0;;2,0;;;;3,0;;;29,0;165,0;42,0;;7,0;;;;;1,0;;;;;;;;34,0;;;;17,0;;;;;;;3,0;;;12,0;61,0;5,0;;;;;;2,0;;8,0;;3,0;;;;127,0;7,0;3,0;;;1,0;;;1,0;2,0;;;2,0;24,0;13,0;33,0;5,0;;31,0;132,0;;19,0;;10,0;1,0;9,0;;;2,0;;;99,0;;38,0;;1,0;2,0;17,0;;;;31,0;2,0;;1,0;6,0;;8,0;2,0;;70,0;;;;6,0;;;41,0;12,0;;44,0;;;1,0;2,0;4,0;;;605,0;3,0;;23,0;38,0;30,0;23,0;17,0;15,0;31,0;3,0;;;;;;;;;3,0;33,0;;16,0;11,0;13,0;;38,0;;;;3,0;3,0;17,0;;;1,0;12,0;4,0;;;25,0;;19,0;14,0;;60,0;;7,0;5,0;18,0;;;3,0;4,0;;;;;;;1,0;2,0;40,0;;28,0;;;;21,0;11,0;25,0;;10,0;4,0;;;16,0;3,0;16,0;;;7,0;;1,0;;;;5,0;;22,0;;;2,0;17,0;22,0;;18,0;;;3,0;3,0;14,0;;;;;;28,0;1,0;39,0;2,0;1,0;10,0;2,0;2,0;1,0;26,0;15,0;1,0;;1,0;9,0;;1,0;15,0;;;3,0;3,0;;4,0;5,0;2,0;5,0;12,0;;;;6,0;;;4,0;;;2,0;6,0;9,0;4,0;7,0;;5,0;;1,0;5,0;9,0;1,0;4,0;;;55,0;12,0;;;3,0;1,0;;;4,0;;;;;;;;;;;;;;;;;;3,0;;;;;;;2,0;;;;;;;;;;;2,0;;;;;;;2,0;16,0;5,0;;;2,0;;;;;;;;;;;;;;;;;;;1,0;2,0;;;;;;;;;;;;;;;2,0;;;9,0;;;;;3,0;;;;;;;;;;3,0;;9,0;;;;;;1,0;;;;;;;;;;;;;;;;;3,0;;;;2,0;;;;;;23,0;;;;;;;;2,0;;;;1,0;1,0;;;;;3,0;;;;;;;15,0;;;1,0;;14,0;;;;1,0;;;;;;;;;;;;;;3,0;;;;;;;8,0;;;;;5,0;9,0;;;;;;10,0;;;;;;;;;;;;8,0;;;;;;;;;;;;;;;;;;1,0;6,0;;1,0;;;;6,0;;;;;;;;;;;;11,0;19,0;;;1,0;;4,0;3,0;;5,0;4,0;6,0;;;2,0;6,0;;;;;;;2,0;;;1,0;2,0;;;12,0;2,0;9,0;;;19,0;6,0;2,0;;;;1,0;;;5,0;;;;;4,0;4,0;5,0;;;;;1,0;;;;;3,0;;1,0;;16,0;;;;;4,0;14,0;;;1,0;;;14,0;2,0;;1,0;5,0;;;1,0;;;;;1,0;;6,0;;;;;;;;8,0;;;;;;;3,0;;;2,0;;6,0;;;;;;;;;;;;2,0;;;;4,0;;;;;;;;;;;;;;;;;;;;;;;;;;;17,0;;;;;5,0;;;;;;;;4,0;;;;;;;;;;;;;;;;;;;;;;;;;;;;;;;;;;;;;;;;;;1,0;;;;;;;;;;;;;;;;;;1,0;;;;3,0;11,0;;;;;;;;;;;;;;;;;;;;;;3,0;;;;;8,0;;9,0;1,0;;;6,0;;;;;;;;2,0;;6,0;;;;;;;;;;;;;;;;;;;;;;10,0;;;;5,0;;;;15,0;;1,0;;;;;;;;;;;;;;;;;;;;;;;;;;;;;;;;;;;;;;;;;;;;
electric;;2,0;;4,0;;2,0;2,0;6,0;22,0;10,0;16,0;;1,0;;13,0;8,0;;;4,0;;;;;63,0;;;;;;;;2,0;54,0;;54,0;10,0;;;2,0;;3,0;;;;39,0;8,0;2,0;48,0;2,0;4,0;19,0;13,0;;;48,0;;21,0;;;;;;36,0;;;3,0;3,0;18,0;1,0;;11,0;;32,0;;;;;;;644,0;;16,0;2,0;31,0;;;;;;2,0;200,0;;;3,0;2,0;;;;14,0;;;;10,0;160,0;;;260,0;5,0;51,0;4,0;9,0;93,0;;;2,0;49,0;46,0;17,0;97,0;15,0;;;8,0;10,0;1,0;;1,0;10,0;;6,0;4,0;11,0;6,0;;;;10,0;4,0;;;;;2,0;16,0;;;;3,0;704,0;;;;1,0;17,0;7,0;60,0;177,0;;;70,0;;24,0;86,0;;1,0;;3,0;;;3,0;326,0;1,0;;;13,0;59,0;18,0;4,0;6,0;;;11,0;;2,0;216,0;20,0;;4,0;;;4,0;;;26,0;;47,0;;;1,0;2,0;;;;30,0;;1,0;;2,0;14,0;3,0;;1,0;7,0;6,0;;;;;;;1,0;19,0;1,0;;1,0;;4,0;;77,0;;16,0;;2,0;15,0;5,0;1,0;3,0;7,0;1,0;4,0;;;3,0;;;;48,0;1,0;86,0;2,0;1,0;;1,0;1,0;4,0;;16,0;;;;;;2,0;4,0;;;2,0;;2,0;;;18,0;;;2,0;4,0;6,0;1,0;25,0;1,0;11,0;;12,0;;2,0;24,0;;1,0;;3,0;6,0;1,0;3,0;;2,0;;;;1,0;3,0;17,0;4,0;3,0;;4,0;;;2,0;2,0;;;;;;4,0;1,0;;2,0;;2,0;;;;;21,0;;1,0;;;6,0;;;;;;;;2,0;3,0;4,0;2,0;2,0;;;1,0;22,0;1,0;90,0;;13,0;;11,0;;4,0;2,0;1,0;;47,0;10,0;;;;;;;;2,0;2,0;1,0;;;;;;2,0;1,0;;;;;;;;11,0;;;;;;;;;;;;3,0;15,0;;4,0;;;;;1,0;;;;;3,0;;7,0;;3,0;;;;;;;;;1,0;6,0;1,0;;;1,0;1,0;;;;7,0;13,0;;;2,0;2,0;2,0;2,0;3,0;;;16,0;;;11,0;22,0;;;13,0;2,0;;;;1,0;4,0;1,0;;;;7,0;;;;;;;;;;;1,0;;;1,0;;;;7,0;2,0;1,0;;;;;1,0;;;;;32,0;;;7,0;;2,0;;;1,0;;42,0;;;3,0;;;;;20,0;;;3,0;;;;;;;;;;1,0;;1,0;;;;5,0;;;;1,0;1,0;6,0;2,0;;;;;3,0;;5,0;;;;9,0;;;;;;;;;;;;1,0;;1,0;;1,0;1,0;;2,0;;;3,0;;;148,0;;;;;1,0;;;;;2,0;;;2,0;;4,0;;;;;;;;2,0;;;;;;;2,0;;;;;1,0;;;;;1,0;;;36,0;;;;2,0;;;41,0;;2,0;;2,0;;10,0;1,0;;;26,0;;;3,0;;;;2,0;;;;;2,0;1,0;;2,0;;;;;;1,0;;;;;;7,0;;8,0;2,0;;;;17,0;1,0;;;;1,0;1,0;;;;;;;;;;;;;;;;;3,0;4,0;2,0;;;2,0;;;;;62,0;6,0;;;;1,0;;;;;4,0;;;;;;1,0;;;2,0;;2,0;;29,0;1,0;;;;39,0;7,0;2,0;;;;;;;11,0;;;;;;;;;;;1,0;;;;;;;;;;2,0;2,0;;;79,0;33,0;1,0;8,0;;1,0;;;;;;10,0;17,0;3,0;;7,0;15,0;2,0;;4,0;;8,0;;;8,0;;;1,0;;1,0;;;;25,0;6,0;;;;;;;;;;;;;;;;;;;;;;;;3,0;;;1,0;;2,0;;1,0;;;;;;;3,0;;;;;;2,0;1,0;;;;;;;;;2,0;;8,0;;;;;;;;;;;;;;;;;;;;;;;2,0;3,0;;;;;;2,0;;;;;8,0;1,0;;;;;;;;3,0;13,0;;;;;;;;;;;;;;;;;;;;;;;;;;;;2,0;;4,0;;;3,0;;;;;;;2,0;;;;;;;;;;;3,0;;;;;;;;1,0;;;;;;;;;;;;;;1,0;;;4,0;;;;1,0;;;1,0;;;;;;;;;;;;;;;;;;;;;;
electronics;;16,0;;;;;6,0;;3,0;;2,0;;3,0;;1,0;4,0;4,0;;;;;5,0;;2,0;;;;1,0;;;;;25,0;;22,0;4,0;;;;;3,0;;;;;;4,0;37,0;12,0;5,0;6,0;3,0;;;;;3,0;;;;;3,0;;;;;;4,0;6,0;5,0;3,0;;2,0;;;;;;14,0;21,0;3,0;3,0;;18,0;;;;;;;2,0;;;;;;6,0;;3,0;2,0;;;20,0;;;;2,0;;;;;;3,0;;;2,0;5,0;4,0;34,0;;1,0;;;9,0;1,0;;;;;2,0;;;;;;2,0;;;;;3,0;;;11,0;1,0;;;1,0;10,0;;1,0;;;2,0;2,0;;34,0;;;;;1,0;13,0;;;;;3,0;2,0;;;;;;;;7,0;;;;1,0;1,0;;1,0;4,0;1,0;;13,0;;;;;;9,0;;;;;;7,0;;1,0;;;;;;;1,0;;;;;;;;;;;1,0;7,0;;;;;1,0;;;4,0;;7,0;;;5,0;;;;1,0;;3,0;;2,0;;;;;;;2,0;2,0;3,0;;;;;;12,0;2,0;;;;;;4,0;;;;;;;;4,0;;;;;;1,0;;6,0;2,0;;;;;;;;;;;;;;;;;;;1,0;;4,0;4,0;;;;;;1,0;;;;;;1,0;1,0;2,0;11,0;;19,0;;;;2,0;;;1,0;;;;;;;13,0;;;2,0;1,0;;;;;;7,0;;;;1,0;1,0;;;;;;;;5,0;1,0;;;;;;;;3,0;;1,0;1,0;;;;2,0;;;;;;;;;;;;;;;;;5,0;;7,0;;3,0;;2,0;;;;;;;2,0;1,0;2,0;;;;;9,0;;;;;;4,0;;;;;;;10,0;;;;;;;;;;2,0;;1,0;;;;2,0;;;7,0;;;;;1,0;;3,0;;;;;;;3,0;;;;1,0;;;1,0;;;;;;;2,0;;;3,0;;5,0;1,0;;;2,0;;;;;;;;;;;;;;;2,0;;;28,0;;10,0;;;4,0;1,0;;;;;;;;;1,0;;;;;;;;;;4,0;;;;;;2,0;;;;;;5,0;;;;;;;;;;;;;;;;;1,0;;;;;;;4,0;2,0;;1,0;1,0;;;;;;5,0;1,0;;8,0;;;;9,0;;1,0;2,0;;;;2,0;;;2,0;;;;;;;;;;1,0;;;;;;4,0;;;;;;;3,0;;;;;;;;;;;;;;1,0;;;;;;;;;;;;4,0;;;;;1,0;;;;;;;;;;;;;1,0;;;;;;;;;;;;;;;;;;;;;;;;;;;;;;;2,0;;;2,0;;;;;;;;;;;;;;;;;;;;;;;;;;;;;;;;;;;;;;;;;;2,0;;;;;;;;;1,0;1,0;;;;;;;;;;;;;;;;1,0;;;;;;;;;;1,0;;;;;;;;;;;;;;;;;;;;;;;;;;;;;;;;;;;;;;;;;;;;;;;;;;;;;;;;;;;;1,0;;;;;;;;;;;;;;;;;;;;;;;;;;;;;;1,0;;;;;;;1,0;;;;;;;;;;;;;;8,0;;;;;;;;;1,0;;;1,0;;;;;;;;;2,0;;;;;1,0;;;;;;;;;;;;;;8,0;;;1,0;;;;;;;;;;;;;;;;;;;;;;;;;;;;;;;;;;;;;;;;;;;;;;;;;;;;;;;;;;;;;;;;;;;;;;;;;;;;;;;;;;
elongate;;5,0;;;;1,0;4,0;11,0;3,0;10,0;;;;;21,0;28,0;;;;;;5,0;;2,0;;;;;;;;;6,0;;8,0;5,0;;;;;;;22,0;;1,0;;;35,0;;;6,0;5,0;1,0;;;10,0;15,0;;;;33,0;3,0;;;8,0;4,0;;24,0;6,0;15,0;;7,0;1,0;;;;;6,0;4,0;8,0;;1,0;;39,0;;;;;1,0;15,0;12,0;;;7,0;;;;;11,0;2,0;;;;16,0;;;6,0;;1,0;;9,0;;;;;18,0;61,0;5,0;;;;;;;;;;;;;1,0;;5,0;2,0;;;4,0;;;;;;;4,0;1,0;11,0;;16,0;;1,0;;;;;4,0;2,0;37,0;;;1,0;;1,0;8,0;;;;1,0;9,0;;;1,0;;4,0;4,0;;;24,0;2,0;;;1,0;46,0;;1,0;;;;4,0;;2,0;;;1,0;26,0;;2,0;;;2,0;9,0;2,0;;;16,0;;2,0;;;;;;;;;1,0;;6,0;1,0;;51,0;24,0;;3,0;;;1,0;2,0;1,0;7,0;;159,0;4,0;1,0;46,0;3,0;;5,0;2,0;;;;26,0;3,0;8,0;;;;;;3,0;16,0;;2,0;1,0;;;16,0;;;;1,0;;9,0;4,0;1,0;;13,0;;;;4,0;2,0;14,0;;;;;25,0;;13,0;;;;3,0;;;1,0;;1,0;;;1,0;;;6,0;;2,0;;;;4,0;3,0;23,0;7,0;;4,0;1,0;2,0;;;;1,0;;;1,0;;1,0;10,0;1,0;42,0;1,0;;1,0;3,0;;;10,0;1,0;;;;15,0;;;;;;1,0;2,0;6,0;;1,0;5,0;;;1,0;3,0;6,0;3,0;;2,0;7,0;1,0;;6,0;2,0;;7,0;2,0;;1,0;;;13,0;5,0;2,0;;2,0;10,0;1,0;1,0;;4,0;;;2,0;3,0;4,0;3,0;;9,0;1,0;;17,0;;;;;;48,0;2,0;;;;6,0;;;;4,0;;;;;3,0;;;;2,0;;;;6,0;;;;;3,0;1,0;;;;;;;;;;;;;;;;1,0;;;;;;;1,0;;2,0;;;4,0;1,0;;7,0;;;;;;;1,0;;;1,0;;2,0;;;;;7,0;;;;;;;;;7,0;;;;;;19,0;2,0;;2,0;;;;;;;;;;;;5,0;1,0;;1,0;;2,0;;;;;;;;1,0;;;;;;;;6,0;;;;;1,0;1,0;;;;;3,0;;;;;;;;24,0;;1,0;;;;;1,0;;;;;;1,0;;;16,0;1,0;;;1,0;;1,0;3,0;2,0;;2,0;5,0;;1,0;;1,0;8,0;;;2,0;;1,0;;;;;3,0;;;;1,0;;;;;;;10,0;;;;;;1,0;4,0;;;;;3,0;;1,0;;;;;;;;;;1,0;;;;;;;;;;5,0;;;;;;;;;;;;;;;14,0;;;;;5,0;;;;;1,0;;;;8,0;;;1,0;12,0;;;;;1,0;;;;;;;;4,0;;2,0;;;;;;;;27,0;2,0;1,0;;;;2,0;1,0;;2,0;;;3,0;;1,0;;;9,0;11,0;;1,0;7,0;;;;;5,0;;3,0;;3,0;6,0;2,0;;;4,0;;;;1,0;4,0;;;1,0;;;;2,0;;;7,0;9,0;;;3,0;;1,0;;5,0;;;;;;;;2,0;;;;;;;;;7,0;;;;;;;;;;;;;;;;;;;;;;1,0;;;;;;5,0;;;;;;;;;;;;;;;;;1,0;;;;;;;;;;;;;;;;;;;;;;;;;;;;1,0;;;;;;;;;;;;;;;;;;;;;;;;;;;;;;;;;;;;;;;;;;;2,0;;;;;;;;;;;;;;;;;;;;;;;;;1,0;;;;;;;;;;;;;6,0;;;;;;3,0;;;;3,0;;;;1,0;;;;;4,0;;;;;;;;;;;4,0;;;;;;;;;;;;1,0;;;;1,0;;4,0;4,0;;;;;;1,0;;;;;;;;;;;1,0;;;;;;;;;;;;;;;;;;;;;;;;;;
emission;;4,0;;;1,0;;3,0;26,0;4,0;7,0;3,0;;1,0;;1,0;65,0;19,0;;16,0;;;3,0;13,0;1,0;2,0;;97,0;2,0;;;1,0;5,0;51,0;2,0;249,0;3,0;9,0;;;;39,0;3,0;2,0;;7,0;22,0;14,0;54,0;6,0;9,0;4,0;7,0;;;24,0;;6,0;;;;;7,0;6,0;;22,0;;;12,0;5,0;;2,0;2,0;6,0;;;;;34,0;38,0;25,0;;12,0;1,0;30,0;2,0;120,0;;;;1,0;5,0;;;9,0;;1,0;;;10,0;1,0;;;9,0;1,0;;;4,0;;37,0;24,0;;88,0;;;;21,0;2,0;4,0;21,0;5,0;1,0;;;19,0;;;;10,0;4,0;4,0;;2,0;1,0;;2,0;;6,0;13,0;;;;;;3,0;34,0;;;14,0;57,0;;1,0;;3,0;5,0;32,0;15,0;28,0;;;;1,0;5,0;397,0;;1,0;;2,0;;;11,0;;;;1,0;134,0;;;;;;;2,0;;;2,0;;;1,0;;6,0;;;;2,0;;1,0;;;;2,0;;;5,0;9,0;;;;2,0;2,0;4,0;;;;;;;3,0;14,0;;2,0;1,0;;1,0;2,0;;;12,0;;804,0;;8,0;;;;;;;;3,0;;1,0;;;;;;;;;;;;;;;4,0;3,0;1,0;;;;;;6,0;4,0;;6,0;;2,0;;;19,0;;;13,0;;146,0;1,0;;13,0;3,0;6,0;17,0;;;93,0;;;;;;;1,0;;;;3,0;;;;;;3,0;;;;;1,0;;;;5,0;1,0;;;;;;;1,0;;;;;;;;;;3,0;;;;;;6,0;;;;1,0;;1,0;;;;;;;;17,0;;;18,0;7,0;;;;6,0;;;14,0;6,0;;;;;;;;1,0;8,0;;;;;;;2,0;;;;;;;;;;;;;;3,0;;;;;;1,0;6,0;;;;;2,0;;;;1,0;6,0;53,0;15,0;;;;;;;;5,0;;;3,0;2,0;;2,0;;;;;;;15,0;22,0;;;;;2,0;7,0;;3,0;;1,0;;;7,0;126,0;;;12,0;12,0;;;;;;1,0;;;;2,0;;;;;;1,0;;;;;;2,0;;1,0;;;;1,0;;;;;;1,0;;;;;;;;;19,0;;;;;;;;;;22,0;2,0;;;;5,0;;;2,0;;;;;;;;;12,0;;;;;;;;;;;3,0;;3,0;;;38,0;;1,0;5,0;;;;;;1,0;3,0;1,0;;;;;;;10,0;;1,0;;;;;3,0;;3,0;;4,0;3,0;23,0;;;;;;;;;2,0;;;;;;;;97,0;;;;;;;;;;;;;;;;;;;;;1,0;;;2,0;;;;;;;;;;;;;;;;;;53,0;;;15,0;;;;;;;;;;;;;;4,0;;;;;;1,0;4,0;2,0;;;;;;10,0;;;;;;;;1,0;;4,0;;;;;;;;;;;;;;;;;;;;;;;;;;;;1,0;;;;;;;;;;;;;;;;1,0;;3,0;;;;;;;;;;;;;2,0;;;;;;;;120,0;;;;;;;;;;;;;1,0;;;;;;;;;;;;;;;;;2,0;;;;;;;;;1,0;;;;;1,0;;;;;;;1,0;;;7,0;3,0;2,0;;;3,0;;;;;;;;;2,0;18,0;;2,0;;;3,0;;;;;;;;1,0;;;;;;1,0;;54,0;;;4,0;4,0;;;26,0;;;;;;1,0;;;;;;;;;;;;;;;;;;;;;;;;;;;;;;;;;;;;;3,0;;;;;;;;;10,0;;;;;;5,0;;;;1,0;11,0;;;;81,0;;;;7,0;;;;;;;;;;;;4,0;;;;;;;;;;;;;;;;1,0;;;;;;;;;;;;;;;;;4,0;;;;;1,0;;;;;1,0;;;;;;3,0;;;;;;;;;;;;;;;;2,0;;;;;;;;;;;;;;;;;;;;
enable;;4,0;;3,0;;2,0;2,0;22,0;4,0;6,0;2,0;;8,0;;4,0;6,0;1,0;2,0;;;3,0;49,0;;4,0;;;4,0;1,0;1,0;1,0;25,0;5,0;55,0;7,0;52,0;17,0;2,0;12,0;;;35,0;2,0;14,0;7,0;9,0;9,0;13,0;131,0;22,0;32,0;;4,0;;;6,0;4,0;14,0;;;3,0;;4,0;;8,0;18,0;1,0;7,0;2,0;11,0;;30,0;5,0;7,0;3,0;;1,0;;1,0;;150,0;4,0;8,0;7,0;45,0;1,0;16,0;4,0;;2,0;3,0;44,0;7,0;4,0;9,0;;4,0;13,0;;61,0;27,0;3,0;10,0;29,0;25,0;1,0;6,0;11,0;8,0;12,0;25,0;3,0;15,0;;;;21,0;26,0;24,0;13,0;11,0;1,0;;4,0;13,0;43,0;23,0;;;1,0;4,0;12,0;2,0;9,0;2,0;2,0;11,0;3,0;4,0;2,0;;6,0;1,0;6,0;33,0;8,0;;;16,0;123,0;;5,0;1,0;4,0;8,0;6,0;9,0;60,0;1,0;1,0;5,0;;2,0;45,0;1,0;;;25,0;23,0;;4,0;8,0;;;1,0;;5,0;10,0;1,0;;;;13,0;;;4,0;9,0;;13,0;1,0;;2,0;3,0;;13,0;;13,0;4,0;;;8,0;8,0;;;8,0;;;1,0;1,0;5,0;2,0;;;2,0;3,0;1,0;;;;;1,0;12,0;1,0;;5,0;;4,0;;1,0;27,0;;10,0;;4,0;39,0;3,0;11,0;5,0;7,0;;;;;;11,0;;;;4,0;4,0;2,0;2,0;3,0;;5,0;;;41,0;;;;;;1,0;31,0;;;1,0;1,0;14,0;;4,0;5,0;2,0;;;;;6,0;;7,0;14,0;;15,0;;1,0;12,0;;7,0;;8,0;3,0;11,0;;;4,0;;;;;;2,0;;3,0;;1,0;;;8,0;;3,0;1,0;;;;2,0;2,0;;11,0;;10,0;;;;;2,0;;2,0;;3,0;4,0;1,0;3,0;;;;5,0;;4,0;1,0;7,0;1,0;;1,0;2,0;2,0;;12,0;1,0;;2,0;;;1,0;;;5,0;2,0;6,0;;;;1,0;2,0;;2,0;;;1,0;1,0;;;3,0;3,0;4,0;3,0;;;6,0;5,0;12,0;1,0;;2,0;;;1,0;5,0;2,0;;10,0;;2,0;;1,0;4,0;10,0;7,0;16,0;;7,0;;;21,0;3,0;;;;1,0;;1,0;7,0;19,0;;;15,0;1,0;;3,0;;;;;1,0;1,0;3,0;;3,0;3,0;;;;46,0;18,0;3,0;2,0;;1,0;;32,0;;10,0;14,0;7,0;1,0;8,0;8,0;33,0;15,0;2,0;2,0;;;;3,0;1,0;7,0;6,0;1,0;;;2,0;1,0;4,0;3,0;;;2,0;;5,0;2,0;;;13,0;;148,0;;1,0;;12,0;;5,0;6,0;5,0;6,0;12,0;7,0;2,0;;3,0;;;;2,0;26,0;;2,0;3,0;4,0;59,0;;11,0;1,0;20,0;14,0;15,0;;2,0;;;3,0;1,0;16,0;;;3,0;2,0;;;2,0;;;4,0;5,0;20,0;;;1,0;4,0;13,0;2,0;1,0;1,0;4,0;6,0;;5,0;1,0;1,0;;5,0;2,0;3,0;2,0;;5,0;2,0;1,0;7,0;5,0;22,0;3,0;;;2,0;1,0;2,0;;2,0;1,0;7,0;;;5,0;7,0;;4,0;14,0;59,0;2,0;3,0;;;4,0;;8,0;;;;;4,0;;;;;3,0;4,0;;12,0;5,0;3,0;;;;1,0;1,0;1,0;2,0;;2,0;1,0;1,0;;3,0;;;1,0;;1,0;;;;4,0;2,0;1,0;6,0;;;;1,0;11,0;2,0;1,0;;;4,0;;13,0;;;;;;;1,0;3,0;;4,0;3,0;12,0;;;1,0;2,0;3,0;10,0;1,0;;;4,0;;;22,0;2,0;;;4,0;1,0;1,0;;;1,0;3,0;;;24,0;2,0;;4,0;;1,0;6,0;;;;;;;;3,0;;;;2,0;;3,0;7,0;;2,0;;;3,0;;;3,0;2,0;;;;2,0;;1,0;;;2,0;;3,0;;4,0;;;;;;;;;;1,0;;;;;;;;1,0;;;;1,0;2,0;;1,0;3,0;6,0;;4,0;1,0;;;3,0;;2,0;3,0;;;;;;1,0;;;;;;;;1,0;1,0;;;;;4,0;;2,0;;;;;;;;1,0;;1,0;2,0;;;;;;1,0;1,0;1,0;;;;;2,0;1,0;2,0;;4,0;;;;5,0;8,0;12,0;;1,0;2,0;;;;6,0;;;;1,0;2,0;;;;;;;;;;;1,0;4,0;;;3,0;11,0;1,0;5,0;;5,0;;;;;;2,0;;;;1,0;4,0;;23,0;;1,0;;;1,0;4,0;3,0;1,0;;2,0;;3,0;;2,0;;3,0;;;;1,0;1,0;4,0;;1,0;;;;;;;;;;;3,0;1,0;1,0;;;;;;5,0;4,0;;3,0;;;1,0;;;;;;;;;;;11,0;;;;;;;2,0;1,0;1,0;;6,0;;;;;;;;4,0;;;;1,0;;;;;;;;;;1,0;;;;;;2,0;;;;;;;;;;3,0;1,0;;;2,0;;;;;;2,0;1,0;;;;;;;4,0;;;;;;10,0;;;;;;;1,0;;9,0;1,0;;;;;;;;;;;;
engage;;48,0;1,0;2,0;;3,0;25,0;18,0;4,0;10,0;;;1,0;;38,0;52,0;;;;1,0;5,0;2,0;;9,0;;;;;;;;;74,0;;12,0;1,0;2,0;;;;7,0;1,0;18,0;;1,0;;2,0;35,0;2,0;2,0;12,0;5,0;;;48,0;28,0;38,0;;;;58,0;8,0;1,0;;11,0;3,0;3,0;57,0;22,0;29,0;;;;;;5,0;;;;22,0;;3,0;;65,0;;;2,0;;8,0;5,0;179,0;;;8,0;;;;;20,0;2,0;;;50,0;4,0;;3,0;29,0;12,0;7,0;;8,0;;12,0;;;70,0;362,0;72,0;1,0;16,0;9,0;;;;;;;;;5,0;;;9,0;1,0;;;26,0;;;;;;;16,0;;;6,0;38,0;2,0;26,0;;1,0;;;;1,0;42,0;;3,0;1,0;;3,0;43,0;;;;1,0;1,0;;;2,0;;10,0;7,0;2,0;4,0;52,0;80,0;;;5,0;87,0;1,0;5,0;4,0;10,0;1,0;7,0;;;;;11,0;29,0;;34,0;;;;32,0;21,0;2,0;;22,0;;18,0;1,0;;7,0;61,0;8,0;3,0;6,0;;;;90,0;;6,0;104,0;51,0;;33,0;1,0;2,0;8,0;;2,0;2,0;;172,0;4,0;8,0;110,0;23,0;29,0;13,0;17,0;7,0;22,0;1,0;5,0;3,0;3,0;3,0;;;1,0;5,0;7,0;78,0;;1,0;;;;39,0;;3,0;;1,0;;10,0;16,0;;;39,0;4,0;12,0;;37,0;3,0;16,0;3,0;;20,0;;37,0;;119,0;3,0;;12,0;;12,0;3,0;;;1,0;2,0;1,0;4,0;;;38,0;;11,0;;3,0;4,0;20,0;10,0;13,0;5,0;11,0;4,0;16,0;;7,0;2,0;;18,0;1,0;4,0;3,0;;;33,0;10,0;19,0;11,0;1,0;3,0;3,0;35,0;1,0;;91,0;;2,0;8,0;3,0;6,0;;1,0;3,0;4,0;27,0;9,0;23,0;4,0;;13,0;;3,0;5,0;51,0;15,0;4,0;;6,0;6,0;;6,0;5,0;7,0;7,0;35,0;4,0;1,0;6,0;8,0;3,0;20,0;80,0;;;20,0;30,0;2,0;2,0;6,0;14,0;;2,0;;13,0;9,0;12,0;12,0;45,0;2,0;5,0;52,0;;1,0;7,0;8,0;3,0;34,0;4,0;8,0;;5,0;104,0;4,0;11,0;1,0;8,0;1,0;;;;44,0;1,0;;;;;;;;;;;;6,0;;;;;2,0;;;;;;11,0;;1,0;;;;8,0;;;;;14,0;;2,0;;11,0;;;5,0;7,0;;3,0;;2,0;;;;;5,0;;;3,0;;;;;;1,0;4,0;1,0;10,0;;16,0;;;;;6,0;;;;;;22,0;1,0;;12,0;;;;;1,0;;;;2,0;;;3,0;4,0;;10,0;;75,0;;;3,0;;;18,0;;;;;2,0;;;;3,0;19,0;;;;;3,0;10,0;10,0;1,0;;;3,0;;;;;1,0;13,0;;16,0;4,0;;;;;8,0;;;;;;;2,0;1,0;;41,0;;1,0;;1,0;;7,0;9,0;1,0;;5,0;2,0;;11,0;;;5,0;;;;;4,0;1,0;;2,0;;6,0;;;;;;;3,0;;;;15,0;;;;;4,0;1,0;16,0;;;6,0;;17,0;;1,0;;;;;4,0;;;;;3,0;1,0;;;4,0;;;;;;6,0;2,0;;1,0;1,0;;3,0;;;10,0;;;;;;41,0;;;;;;;;;4,0;10,0;;3,0;;;;6,0;5,0;23,0;;6,0;4,0;;11,0;3,0;;;2,0;;;4,0;32,0;26,0;1,0;10,0;;;1,0;;;11,0;9,0;6,0;2,0;;4,0;2,0;14,0;7,0;;;10,0;2,0;3,0;3,0;1,0;;;2,0;1,0;;6,0;12,0;;1,0;10,0;;13,0;5,0;4,0;;;17,0;2,0;;1,0;19,0;;6,0;;;40,0;;;5,0;3,0;3,0;20,0;4,0;;;5,0;8,0;;;4,0;;;;8,0;1,0;8,0;;;;4,0;;1,0;;2,0;;;2,0;2,0;;;10,0;;;1,0;11,0;1,0;;3,0;;;;;;;;;;;;;;;;;;;1,0;;;;;;;;;;;;;;2,0;;;;;2,0;3,0;1,0;2,0;;;;;;2,0;;;;;;;;;;3,0;;;6,0;;;;;;;;;;;;;;;;1,0;12,0;3,0;;;;3,0;;;1,0;;;;;;;;;;;;;;;1,0;;;;;;;4,0;1,0;;;;;5,0;;89,0;;4,0;;2,0;7,0;;;;2,0;;;;4,0;;;;;;;;;;3,0;;;;4,0;;;;;5,0;;6,0;;;;;;;1,0;;;;;;8,0;;;;;;;;;;;;;;;3,0;;;;;;;;;;;;;;;;;;2,0;1,0;;;;;;1,0;;;;;;;;2,0;;;2,0;;;;;26,0;;;;1,0;;;;;;;;;;;;;;;;;
enhance;;1,0;;;;1,0;;12,0;4,0;;;;2,0;;1,0;11,0;2,0;;3,0;;;25,0;;;;;3,0;;;;;2,0;13,0;8,0;;;;2,0;2,0;;33,0;2,0;;2,0;1,0;5,0;7,0;13,0;4,0;17,0;;;2,0;;;10,0;5,0;;2,0;2,0;2,0;;13,0;;16,0;;;4,0;;4,0;1,0;9,0;7,0;;;;;4,0;4,0;153,0;2,0;2,0;;11,0;2,0;2,0;2,0;;;;9,0;;1,0;;;;;;17,0;1,0;;3,0;7,0;17,0;4,0;;6,0;;7,0;;;4,0;;;;11,0;;4,0;2,0;;;;3,0;6,0;15,0;;;;2,0;1,0;;;2,0;;2,0;;;;;;1,0;2,0;;10,0;;2,0;;;4,0;;;;;1,0;1,0;;27,0;1,0;1,0;;1,0;1,0;2,0;;;1,0;34,0;10,0;;;;;1,0;2,0;;1,0;;;;;;3,0;;;;;;8,0;;;1,0;;;;;;1,0;3,0;;;;;10,0;;;;;;1,0;2,0;;;;;1,0;;;;;;2,0;;;;;;;;16,0;;;;12,0;;3,0;;3,0;;;;;;1,0;2,0;1,0;;;;3,0;;1,0;2,0;;;;;2,0;1,0;;;;;;3,0;;;;;;;;1,0;;;;;1,0;;;2,0;;;;;;2,0;;1,0;;;7,0;;;;;;;;;;;1,0;;;;;;;;;;;;;;;;;;;;;;;;;;;;;2,0;;;;;;;;;1,0;;1,0;;;;;;;;;;;1,0;;;;;;;1,0;;;;;1,0;;;1,0;;6,0;;;;;;;;;;;;6,0;;;;;;;;;;2,0;;;;6,0;;;1,0;;;;;;;;;;;;;;2,0;;;;;;;;;;;1,0;;;;5,0;;;1,0;1,0;1,0;;2,0;;;;12,0;;4,0;;4,0;2,0;;;1,0;4,0;5,0;;;;;;2,0;5,0;;;;;;;;1,0;;;;;;1,0;;;;;5,0;;;;;;;;1,0;;1,0;;;;;2,0;;;8,0;;;;;;1,0;;2,0;;;;4,0;;;;;;;;;;2,0;;;;6,0;;2,0;;;;1,0;5,0;;;;;;;1,0;2,0;;;;;;;1,0;;;;;14,0;;;;;;;;9,0;;1,0;;;;;;;;3,0;;;;;;;;1,0;1,0;;;;;;;;;;;;5,0;;;;;1,0;7,0;;;;;;;;;;;;;;3,0;1,0;;;;;;;;;;;;1,0;;;;1,0;;1,0;;;;;;1,0;;;;;;3,0;;;;;1,0;4,0;;;;;;;;;;;;;;1,0;;;;;;;;;;;;3,0;;;;;;;;;;;;;;;;;;;;;;;;9,0;;4,0;;2,0;;;;;;;;;;;;;;;;;;;;;;;;;;;;;;;;;2,0;;;;;;;;;;;;;;;4,0;;;;;;;;1,0;;;1,0;;;;;;;;;;;;;;;;;;;;;;;;;;;;;;;;;;1,0;4,0;;2,0;;;;;;;3,0;;;;;;;3,0;;;5,0;;;;;10,0;;;1,0;;;;;;;2,0;;;;;;2,0;;1,0;;;;;;;;;;;4,0;;;;;;;;;;;;;;;;;2,0;;;;;;3,0;;;;;;1,0;;;;;;;;;;;;;;3,0;;;;;;;;;;;3,0;;;;;;;;1,0;;;;;;;;;;;;;;;;;;;;;;;;;;;;;;;;;1,0;2,0;;;;;;;;;;;;;1,0;;;;;;;;;;;;;;;;;;;;1,0;;;;;;;;;3,0;;;;;;;;;1,0;;;;;;;;;;
enter;;1,0;;;;11,0;13,0;9,0;5,0;9,0;;;4,0;;20,0;2,0;;;;;;11,0;;;;;7,0;2,0;;;2,0;;13,0;;22,0;8,0;;;;;7,0;;5,0;;16,0;1,0;8,0;30,0;2,0;8,0;2,0;3,0;;10,0;2,0;5,0;3,0;;;;;3,0;4,0;;8,0;;3,0;5,0;2,0;2,0;;;;;;1,0;3,0;4,0;;65,0;;18,0;;8,0;;3,0;;;;;78,0;;;3,0;;5,0;;;13,0;4,0;;;19,0;46,0;;;72,0;1,0;2,0;;21,0;5,0;4,0;;;7,0;20,0;18,0;6,0;2,0;9,0;;;5,0;1,0;;;;11,0;;;2,0;1,0;;;;1,0;6,0;;;11,0;;;24,0;;1,0;;9,0;10,0;;;;;1,0;10,0;;20,0;;1,0;4,0;1,0;;17,0;2,0;;;5,0;4,0;;;;;;1,0;8,0;1,0;5,0;17,0;;1,0;;14,0;;4,0;10,0;6,0;;;;;;;;2,0;;;;;;;;;;8,0;;3,0;6,0;;;2,0;1,0;;;;2,0;1,0;2,0;;;7,0;28,0;4,0;;1,0;;;3,0;1,0;140,0;;15,0;;37,0;1,0;29,0;3,0;;16,0;;1,0;1,0;;3,0;34,0;;1,0;2,0;;8,0;;2,0;;;;;;4,0;3,0;;;;4,0;;3,0;3,0;1,0;1,0;;6,0;;;9,0;;2,0;;;3,0;8,0;14,0;21,0;;;4,0;;;1,0;7,0;3,0;;;18,0;4,0;;;3,0;2,0;;;;1,0;2,0;17,0;;;;;;10,0;2,0;2,0;10,0;4,0;;;1,0;4,0;;3,0;;;;1,0;;;;;2,0;;;;;;;;;3,0;;3,0;3,0;10,0;;;1,0;;;2,0;10,0;13,0;1,0;2,0;;2,0;;3,0;;;;;10,0;;;;1,0;1,0;1,0;;;2,0;;1,0;3,0;1,0;;;;;;;2,0;;;;;;;;;;;;;6,0;12,0;;;;;;;4,0;;;;;2,0;;;;;;1,0;1,0;;;;;;;;;;;;;;;2,0;1,0;;;;9,0;5,0;;;;1,0;2,0;75,0;;5,0;1,0;10,0;;;3,0;6,0;;;;21,0;;;1,0;;4,0;1,0;;;;5,0;;;;;;;;1,0;5,0;1,0;;3,0;;28,0;;1,0;;;;;;1,0;6,0;1,0;;;;;;;2,0;;;;;;1,0;7,0;;;;1,0;6,0;;;1,0;;1,0;;;7,0;;7,0;;2,0;;;;;;1,0;;1,0;1,0;;;6,0;1,0;;;;;;;;1,0;;;;;;;2,0;5,0;3,0;;2,0;15,0;1,0;;;;;2,0;;;;;;;;3,0;;;8,0;;;;;6,0;;;;;4,0;;;;;;;;;3,0;;;;2,0;1,0;1,0;2,0;;7,0;;6,0;;;;;1,0;;;;;;;;;;6,0;;;;;;;;;1,0;;;;3,0;;;9,0;;;;;;;;2,0;;;;;;;;;;1,0;;;1,0;;;;1,0;;;;;;1,0;;;;;;;2,0;;;1,0;;1,0;;;3,0;;;19,0;;;;;;1,0;;;;;;;;1,0;;1,0;;;;;;;2,0;;;;1,0;;;;2,0;2,0;;;;;;;;;;;1,0;;;;1,0;;;;2,0;;;4,0;;;;;1,0;;1,0;;;;;;;;;;;2,0;;3,0;2,0;1,0;;1,0;;2,0;;;;;;;;;;;4,0;;;;;;;;;;;;;;5,0;;4,0;;1,0;;;;;1,0;;;;;;;;;;;;;1,0;;1,0;;;;3,0;;;;;;;;;1,0;;4,0;;;3,0;;;;;;;;;;;2,0;;;;;;;;;;;;;;;;1,0;;;;;;;;1,0;;;;;;;2,0;;;;;;;2,0;;3,0;;;;;;;;;;;;;;;;2,0;;;;;;;;;;;;;;;;;;;;2,0;;;;;;;;;;;4,0;;;;;;;;;;2,0;;;;;;;;;;;6,0;2,0;;;;;;;;;;;;1,0;;;;;;;;;;;;;;;;;;;;;;;;;;;;;;;;;;2,0;;;;;8,0;;;;;;
equip;;17,0;;;;;3,0;14,0;;5,0;;;2,0;;;3,0;;;;1,0;;3,0;;2,0;;;1,0;;;;11,0;;;;10,0;5,0;;;;;5,0;;;;2,0;;;34,0;19,0;9,0;4,0;;;;2,0;;7,0;;1,0;;;;5,0;;1,0;;3,0;;1,0;;3,0;;2,0;;;1,0;;;;21,0;1,0;9,0;;12,0;;;4,0;;;;24,0;;;;;;;;9,0;17,0;;;17,0;1,0;;5,0;8,0;1,0;;;;;;;;13,0;15,0;1,0;;;;;5,0;;4,0;8,0;;;;1,0;;;;;;;;;;;;;;9,0;;;;15,0;1,0;;;;1,0;;3,0;;45,0;;;;1,0;;18,0;;2,0;6,0;9,0;37,0;;;;;;;2,0;1,0;2,0;1,0;;;2,0;21,0;;;;5,0;;2,0;1,0;;;;;;;;;;;2,0;;;;;;1,0;;;;1,0;;;;;;;1,0;1,0;;;;;9,0;;;49,0;;;4,0;;;;17,0;23,0;;1,0;;3,0;;1,0;;;;;;;;;;;;;;;;;1,0;;;;;;;;;1,0;;;;;1,0;;;;;1,0;;1,0;2,0;3,0;;;8,0;;;;;;;;161,0;;1,0;;1,0;;;19,0;1,0;;5,0;;1,0;;9,0;;;;;;;;;9,0;1,0;;;;;1,0;;;;;;;1,0;;;;;;;;;;;1,0;3,0;3,0;;;;;;;;2,0;1,0;;;;;3,0;;7,0;;;6,0;;;2,0;;;;;;10,0;;;;;;;;;;;;2,0;;;;;;;;;;2,0;;1,0;;;;;;;;;;;;;;;;;;;;;;;2,0;;;;;;;;;1,0;;2,0;;;;4,0;;1,0;1,0;;;;;;;;4,0;;5,0;;;31,0;;;;;5,0;;;;;;8,0;;;;;;;5,0;;;;;1,0;2,0;;;;;1,0;;;;;1,0;;;;;;;;;;;;;;;;;;;;;2,0;;5,0;6,0;2,0;;;;;;;1,0;;;;;;;;;;2,0;;1,0;;;;;;;;;;1,0;;;;;;;;4,0;;;;1,0;;;;;;;;;;;5,0;;;;;1,0;;2,0;;;;1,0;;;;;;;;;;;;;;1,0;;;;;2,0;;;;;;;;;;2,0;;;;;;;;;1,0;;;;;;;;;2,0;;;;1,0;;;;;;;;1,0;;;;;;;;;;;;;;;;2,0;;;;;3,0;;;;2,0;;;16,0;;;;1,0;;;;;;;;;1,0;3,0;3,0;49,0;;;;;;;;;;;;16,0;;;;;;;;;;;;;;;;;1,0;49,0;4,0;2,0;;;;;;;;3,0;;;;;;;;;;;;;;;4,0;1,0;1,0;;;;;;;;;1,0;;;;;;2,0;;;;;;;;;;;;;;;;;;;;;;;;;;;;;;;;;;3,0;;;1,0;;8,0;;;;;3,0;;;;;;;1,0;;;;;;;;;;;;;;;;;;;;;;;;2,0;;;;;;;;;;;;;;;;;;3,0;;;;;;;4,0;;;;;;;;;;;;;;;1,0;;;1,0;;;;;;;;;;;;;4,0;;;;;;;;;;;;;;;;;1,0;;;;1,0;;;;;2,0;;;;;;;;;;;;;;;;;;;;;;;;;;;;;;;;;;;;;;;;;;;;;;;1,0;;;;;;;;;;;;;;;;;;;;;;;;;;;;;;;;;;;;;;;;;;2,0;1,0;;;;;;;;;;
execute;;1,0;4,0;;8,0;6,0;2,0;76,0;14,0;1,0;7,0;;5,0;4,0;7,0;28,0;;;8,0;6,0;13,0;34,0;17,0;;;2,0;30,0;1,0;;;221,0;3,0;157,0;9,0;207,0;18,0;19,0;28,0;3,0;;84,0;;2,0;8,0;37,0;34,0;45,0;243,0;18,0;45,0;1,0;12,0;12,0;1,0;22,0;3,0;9,0;;21,0;46,0;1,0;3,0;;4,0;11,0;3,0;39,0;3,0;22,0;;71,0;;24,0;2,0;;2,0;27,0;3,0;3,0;256,0;23,0;53,0;20,0;61,0;;497,0;3,0;;;2,0;21,0;;45,0;;2,0;123,0;71,0;;178,0;16,0;;2,0;66,0;29,0;;50,0;6,0;12,0;20,0;5,0;;158,0;3,0;;;58,0;2,0;22,0;6,0;11,0;3,0;;99,0;305,0;627,0;217,0;;2,0;;17,0;;11,0;5,0;;4,0;1,0;3,0;34,0;1,0;5,0;12,0;;4,0;24,0;15,0;9,0;;21,0;36,0;5,0;4,0;;44,0;179,0;29,0;;93,0;;1,0;9,0;9,0;2,0;191,0;;;;21,0;1,0;;;;;;3,0;5,0;10,0;;;;;1,0;4,0;;;13,0;51,0;;9,0;1,0;;2,0;4,0;;2,0;;2,0;6,0;;;;;;;4,0;;;7,0;;28,0;7,0;;;;6,0;;;;;1,0;;3,0;1,0;;;1,0;;;;24,0;3,0;14,0;;;2,0;;;8,0;2,0;;;;;;;;;7,0;;34,0;10,0;;;;;;;48,0;;;;;;;33,0;;5,0;6,0;;28,0;;;2,0;2,0;;;;13,0;4,0;;1,0;13,0;1,0;1,0;;2,0;33,0;;;;;2,0;3,0;;;;;;;;;3,0;7,0;;;;8,0;;57,0;;1,0;;1,0;;;3,0;1,0;;1,0;;6,0;;;;;14,0;2,0;;;1,0;;;;;;;2,0;2,0;;1,0;;;;;;1,0;3,0;;4,0;16,0;4,0;;;11,0;13,0;;;;21,0;6,0;;;;;;;;;;;6,0;;2,0;;3,0;;;;;;6,0;;;8,0;;;;;;;3,0;;16,0;1,0;49,0;;4,0;;;;;;1,0;16,0;17,0;;;;;4,0;8,0;20,0;68,0;3,0;1,0;129,0;;;;1,0;1,0;;;4,0;27,0;;;2,0;4,0;3,0;3,0;;19,0;;1,0;7,0;;33,0;1,0;33,0;;2,0;17,0;5,0;3,0;10,0;12,0;199,0;6,0;;;2,0;;;1,0;4,0;27,0;1,0;7,0;1,0;5,0;4,0;;;;1,0;;11,0;;7,0;21,0;;;1,0;1,0;24,0;;4,0;;1,0;;25,0;;5,0;;3,0;2,0;;1,0;1,0;;13,0;5,0;14,0;;1,0;;3,0;;15,0;;3,0;;2,0;25,0;10,0;;6,0;;6,0;14,0;5,0;2,0;;6,0;8,0;6,0;;1,0;;1,0;;6,0;4,0;18,0;;6,0;;1,0;3,0;;1,0;;6,0;;3,0;;1,0;;2,0;1,0;;;;;2,0;6,0;;3,0;;24,0;;;3,0;2,0;5,0;1,0;;;;2,0;;2,0;;2,0;;63,0;1,0;26,0;4,0;3,0;1,0;2,0;6,0;;3,0;26,0;;;5,0;;2,0;;2,0;;20,0;5,0;1,0;1,0;1,0;1,0;;4,0;34,0;;1,0;1,0;6,0;;;3,0;3,0;;22,0;3,0;;4,0;3,0;;;1,0;;1,0;;1,0;;1,0;;10,0;6,0;27,0;4,0;;;8,0;;2,0;6,0;;;;24,0;;;1,0;16,0;;;;43,0;3,0;1,0;;;2,0;;;6,0;;4,0;;;9,0;1,0;;;;5,0;;;;;;;;27,0;;;3,0;;2,0;7,0;;19,0;;;;;1,0;;;;;3,0;;;1,0;6,0;;1,0;;;1,0;;;1,0;;14,0;;;;;;1,0;3,0;;1,0;6,0;10,0;;;;2,0;;8,0;;;;;;;;;;2,0;1,0;;;2,0;1,0;1,0;;5,0;;;6,0;3,0;;11,0;3,0;;1,0;;;;;;2,0;;;;;;;;;;;;5,0;;7,0;;;;;12,0;;;;1,0;;;6,0;3,0;;;;;6,0;1,0;3,0;;;;;1,0;;;;10,0;1,0;11,0;;;1,0;;;;;3,0;1,0;;;12,0;1,0;3,0;;;1,0;10,0;;3,0;;;1,0;10,0;1,0;;;;2,0;4,0;;5,0;5,0;5,0;2,0;19,0;1,0;;;5,0;;;;1,0;2,0;;;;;3,0;;;14,0;;;1,0;;;4,0;3,0;13,0;1,0;;1,0;17,0;;2,0;;;;;;1,0;;;;;;;;;;;;4,0;;;1,0;1,0;;;1,0;1,0;2,0;;1,0;1,0;;2,0;1,0;;;;;;;;;;;;;1,0;;;;1,0;;;;;;;;;;;;;;;10,0;;;;;;;;1,0;;;;;;;2,0;;;;;;;;13,0;;5,0;;;;;;;;2,0;;;;2,0;5,0;;;;;;;;;;;;;;;;;;;1,0;1,0;;;;;;;;;;;;;;;;;;
exit;;2,0;;;;4,0;10,0;1,0;4,0;1,0;;;;;7,0;7,0;28,0;;;;;;;10,0;;;5,0;;;;;;15,0;;2,0;;9,0;26,0;;;2,0;;2,0;;;4,0;4,0;13,0;4,0;1,0;31,0;51,0;;;;4,0;8,0;;;;16,0;;;;8,0;1,0;;11,0;;;;;9,0;;;;;;6,0;13,0;;3,0;;3,0;1,0;3,0;1,0;;;;26,0;;;;;;1,0;;4,0;;;;2,0;1,0;1,0;;42,0;;;;5,0;1,0;;;;1,0;10,0;8,0;2,0;;2,0;9,0;1,0;;;;;;11,0;;;;;;1,0;;1,0;1,0;;;;;;8,0;;;;23,0;5,0;;;;2,0;20,0;;;18,0;;;;;4,0;29,0;;;;;2,0;4,0;7,0;2,0;;;2,0;16,0;;6,0;2,0;;;1,0;2,0;;1,0;;4,0;;5,0;;;;;;1,0;;;;;;;;;1,0;7,0;;2,0;;;;40,0;;;;;;1,0;;;;2,0;21,0;5,0;;;;12,0;;2,0;94,0;;7,0;;;1,0;;;;29,0;;4,0;4,0;;;5,0;1,0;;;;;3,0;1,0;;;;;;11,0;6,0;;;;;;1,0;;;;;;;;10,0;4,0;;;;;2,0;;77,0;;;;;;;11,0;;;1,0;3,0;;;;3,0;;;;;;;;;;;;2,0;;;;2,0;;;;;15,0;;;1,0;;;;;8,0;2,0;;;;;19,0;;;;6,0;;;;12,0;;12,0;;1,0;1,0;;;;18,0;;3,0;;;2,0;;;;;1,0;1,0;;1,0;;;;;3,0;2,0;;;;11,0;;;;;;;;;;2,0;4,0;;;62,0;;1,0;2,0;;;;4,0;;1,0;1,0;;;;;1,0;;;;;;;;;;;;;;2,0;;3,0;;;;;;;;;;;;;;;;;;2,0;;1,0;;1,0;;7,0;;;;;;;;3,0;;;;12,0;;;;;;3,0;;;;;;;;;;;;;;;1,0;;;;;;;;8,0;;1,0;;1,0;;;;;;;;;;;;;;;3,0;;;;;;;;2,0;;;;;;;;;3,0;;;;;;;1,0;;;;;24,0;;;;;;;;;2,0;;;;;;;;;3,0;;;;;;;;;;5,0;;;;;;;;;;;;11,0;;;;;;;;;;;;;;10,0;;2,0;1,0;;;;;;;;;;;3,0;;;;;;;6,0;;;;;2,0;;;;;;;41,0;;;;;;;;;1,0;;;19,0;;;;;2,0;;;;1,0;;4,0;2,0;5,0;;;;;;;;;;2,0;;;;;;;;;;;;;;;1,0;;;;;3,0;2,0;;;;;;;;;;;;;;;;;;;;10,0;;;;;2,0;;;5,0;;;;;;;;;;;;;;;;;;;;;;;;;;;2,0;;;;;;;;;;;6,0;;;;;;;;;;;;;3,0;;;;1,0;;;;;;;;;;;;;;;;;;;;;;;;4,0;;;;;;;;;;;;;;;;;;;;;;;;;;;;;;;;;;;;;;;;;;;;;;;;;;;;;1,0;;;;4,0;;;;;;23,0;;;;;;;;;;;;;;;;;;;1,0;;;;;;;1,0;;;;;;;;;;;;;2,0;;;;;;;;;;;;;;;;;;;;;;;;;;;;;;;;;;;;;;;;;;;;;;;;;;1,0;;1,0;;;;;;;;;;;;3,0;;;;;;;;;76,0;;11,0;;;;;;;;;;;;;;;;;;;;;;;;;;;;;;;;;;;;;;;;;;;;;
eyepiece;;3,0;;;;;;;;;3,0;;;;3,0;1,0;;;;;;;;;;;;1,0;;;;;1,0;;2,0;;;;;;1,0;;1,0;;;;;9,0;;9,0;4,0;;;;3,0;;3,0;;;;3,0;;;;;;3,0;;;;;;3,0;;;;;;;16,0;;;;8,0;;;;;;;3,0;;;;;;;;;;;;;;4,0;;11,0;;;;;;;;;;4,0;12,0;;;;;;;;;;;;;;3,0;2,0;;;;;;;;;;;;1,0;;;;;;;;;;1,0;;10,0;;;;;;4,0;;;;;3,0;;;3,0;;;;;1,0;10,0;;;;;;;;;;;;;;;;;3,0;;2,0;;;;;2,0;;;1,0;;;;;;7,0;;;;;;;;;;;3,0;;;;;;;2,0;;;1,0;;;4,0;;;;;;1,0;;;;;;;;;;;1,0;;;;;;4,0;;;;;;8,0;;;;;;3,0;;;;;;;1,0;;;;;;;;;;;;;;;;;;;;;;;;;;;11,0;;;;;;;;;;;;;;;;;9,0;;;1,0;;;;;;;;;;;;;;;;;;;;2,0;;;;3,0;;3,0;;;2,0;;;;;;;;;;;;;;1,0;;;;;;1,0;4,0;;;;;3,0;;;;;;;;;;6,0;;;;;;;;;;;;;;;;;;;;;;;;;;;;;;;;;;;;;;;;;;;;;;;;;;;1,0;;;;;;;;1,0;;1,0;;;;;;;;;;;;;;;;;;;;;;;;;;;;;;;;;;;1,0;;;;;;;;;;;;;;;;;;;;;;;1,0;;;;;;;;;;;;12,0;;;2,0;2,0;1,0;;;;;;;;;;;;2,0;;;;;;;;;;;;;;;;;;;;;;;;;;;;;;;;;;;;;1,0;;;;;;;;;;;;;;;;2,0;;;;;;;;;;2,0;;;;;;;;;;;;;;;;;;;;;;;;11,0;;;;;;;;;;;;;;;;;;;;;;;;;;;;;;;;;8,0;;;;;;;;;;;;3,0;3,0;;;;;;;;;;;;;;;;;3,0;;1,0;;;;;;;;;;;;;;;;;;;;;;;;;;;;1,0;;;;;;;;;;;;;;;;;;;;;3,0;;;;;;;;;;;;;;;;;;;;;;;;;;;;;;;;;;;;;;;;;;;;;;5,0;;;;;;;;;;;;;;;;;;;;;;;;;;;;;;;;;;;;;;;;;;;;;;;;;;;4,0;;;;;;;;;;;;;;;;;;;;;;;;;;;;;;;;;;;;;;;;;;;;;;;;;;;;;;;;;;;;;;;;;;;;;;;;;;;;;;;;;;;;;;;;;;;;;;;;1,0;;;;;;;;;;;;;;;;;;;;;;;;;;;;;;;;;;;;;;;;;;;;;;;;;;;;;;;;;;;;;;;;;;;;;;
face;;18,0;1,0;;12,0;61,0;39,0;67,0;293,0;82,0;;5,0;23,0;;73,0;151,0;15,0;21,0;11,0;;8,0;109,0;2,0;13,0;;13,0;51,0;6,0;;;9,0;15,0;69,0;;49,0;15,0;2,0;6,0;;2,0;61,0;;59,0;33,0;470,0;287,0;124,0;236,0;60,0;145,0;133,0;43,0;2,0;16,0;113,0;33,0;121,0;;5,0;;64,0;14,0;42,0;1,0;40,0;2,0;52,0;145,0;89,0;267,0;26,0;1,0;55,0;;;21,0;40,0;16,0;13,0;804,0;10,0;112,0;;273,0;3,0;6,0;1,0;9,0;53,0;10,0;311,0;;1,0;28,0;;6,0;9,0;;123,0;29,0;5,0;;91,0;192,0;4,0;11,0;86,0;5,0;47,0;19,0;15,0;38,0;40,0;5,0;;99,0;400,0;252,0;26,0;38,0;3,0;32,0;18,0;99,0;30,0;11,0;2,0;;2,0;29,0;;8,0;18,0;1,0;24,0;4,0;46,0;5,0;6,0;10,0;8,0;1,0;;141,0;9,0;;;649,0;46,0;72,0;3,0;1,0;19,0;30,0;93,0;16,0;78,0;;26,0;1,0;9,0;7,0;221,0;;2,0;;32,0;51,0;;2,0;35,0;4,0;35,0;14,0;13,0;30,0;61,0;67,0;2,0;;38,0;71,0;20,0;17,0;76,0;36,0;;25,0;;2,0;;;28,0;53,0;1,0;124,0;4,0;7,0;10,0;85,0;22,0;;15,0;218,0;1,0;8,0;3,0;;27,0;;8,0;21,0;54,0;1,0;12,0;;32,0;2,0;6,0;41,0;153,0;31,0;86,0;3,0;;31,0;35,0;3,0;285,0;1,0;242,0;5,0;15,0;127,0;51,0;23,0;15,0;62,0;105,0;139,0;11,0;19,0;15,0;8,0;;;14,0;;26,0;51,0;75,0;;9,0;3,0;12,0;;151,0;29,0;7,0;1,0;7,0;2,0;3,0;28,0;73,0;3,0;76,0;19,0;15,0;;11,0;22,0;61,0;5,0;;4,0;2,0;41,0;148,0;607,0;7,0;;5,0;10,0;10,0;23,0;3,0;4,0;1,0;43,0;38,0;1,0;23,0;3,0;127,0;;12,0;27,0;22,0;4,0;37,0;7,0;27,0;1,0;15,0;5,0;3,0;10,0;115,0;72,0;;60,0;8,0;46,0;12,0;10,0;;18,0;82,0;18,0;4,0;;17,0;53,0;111,0;;61,0;21,0;3,0;2,0;1,0;16,0;8,0;10,0;2,0;;3,0;12,0;22,0;38,0;2,0;44,0;3,0;3,0;2,0;;9,0;6,0;103,0;3,0;12,0;50,0;;28,0;48,0;7,0;;56,0;19,0;;3,0;10,0;11,0;47,0;41,0;11,0;1,0;112,0;43,0;12,0;8,0;1,0;1,0;;;5,0;11,0;5,0;23,0;13,0;8,0;1,0;10,0;7,0;12,0;2,0;34,0;2,0;5,0;94,0;17,0;30,0;51,0;2,0;7,0;1,0;;11,0;37,0;3,0;;;;9,0;1,0;;;8,0;30,0;23,0;12,0;13,0;11,0;;5,0;5,0;1,0;1,0;;;;1,0;131,0;2,0;;;9,0;59,0;1,0;2,0;;60,0;10,0;5,0;31,0;;11,0;1,0;14,0;;20,0;95,0;38,0;;3,0;6,0;22,0;3,0;30,0;2,0;15,0;3,0;;;;14,0;3,0;;;17,0;2,0;3,0;;8,0;;6,0;2,0;;22,0;45,0;1,0;2,0;2,0;1,0;94,0;3,0;;;;7,0;11,0;8,0;1,0;65,0;19,0;9,0;4,0;;1,0;6,0;;7,0;;7,0;3,0;21,0;6,0;14,0;18,0;10,0;9,0;1,0;2,0;13,0;1,0;;13,0;;;;;23,0;;;2,0;;3,0;;5,0;1,0;2,0;5,0;7,0;6,0;;8,0;4,0;1,0;;2,0;;3,0;5,0;3,0;;1,0;55,0;9,0;;;5,0;174,0;;6,0;7,0;4,0;8,0;;;4,0;;;;1,0;;4,0;;2,0;4,0;7,0;;15,0;9,0;4,0;5,0;;2,0;12,0;1,0;;6,0;7,0;12,0;26,0;1,0;2,0;6,0;13,0;;;1,0;12,0;8,0;;4,0;5,0;;;;;8,0;;;8,0;8,0;9,0;;;67,0;;79,0;;5,0;3,0;;5,0;6,0;1,0;;14,0;1,0;97,0;5,0;;;;;1,0;;1,0;;2,0;2,0;70,0;51,0;1,0;148,0;2,0;5,0;;;;2,0;22,0;;;;2,0;;2,0;2,0;1,0;2,0;2,0;;;;7,0;2,0;5,0;9,0;;1,0;1,0;4,0;22,0;;8,0;10,0;2,0;2,0;;;3,0;10,0;11,0;10,0;30,0;;;22,0;;4,0;2,0;1,0;40,0;7,0;;11,0;2,0;;6,0;11,0;7,0;;5,0;;2,0;;20,0;1,0;;4,0;;;12,0;21,0;;21,0;;;6,0;2,0;12,0;;;19,0;11,0;5,0;7,0;;;;94,0;39,0;1,0;1,0;;14,0;9,0;25,0;16,0;1,0;1,0;;135,0;17,0;4,0;2,0;13,0;;;3,0;3,0;12,0;;3,0;41,0;;5,0;1,0;39,0;2,0;7,0;59,0;2,0;;43,0;3,0;;1,0;3,0;;6,0;7,0;2,0;;;15,0;;6,0;1,0;;;1,0;;23,0;1,0;2,0;;3,0;38,0;5,0;44,0;3,0;5,0;;6,0;;17,0;;2,0;7,0;;;1,0;6,0;3,0;;9,0;4,0;;3,0;;;;1,0;1,0;;1,0;;;;1,0;4,0;9,0;1,0;4,0;6,0;;6,0;;;;7,0;;5,0;1,0;;11,0;11,0;19,0;;8,0;;;1,0;;5,0;;;;;;13,0;;;1,0;4,0;;29,0;3,0;5,0;4,0;1,0;;;;;;;1,0;;;2,0;;;33,0;4,0;3,0;;2,0;;1,0;4,0;3,0;;;;5,0;;1,0;;;6,0;;2,0;3,0;;2,0;5,0;3,0;;;;;;;9,0;;;1,0;;;3,0;1,0;1,0;;;;25,0;;1,0;5,0;;;30,0;28,0;;14,0;2,0;;1,0;42,0;7,0;6,0;1,0;7,0;5,0;3,0;21,0;8,0;16,0;;42,0;1,0;;;;;4,0;;;;7,0;;;10,0;4,0;14,0;;;;;;1,0;1,0;;4,0;7,0;1,0;1,0;4,0;10,0;7,0;;2,0;;5,0;9,0;;;1,0;;1,0;3,0;;;;;;;;4,0;24,0;3,0;;1,0;;;;6,0;14,0;;;;;7,0;;;3,0;;;;;;;;;3,0
fasten;;1,0;;;;17,0;2,0;3,0;9,0;6,0;;;;;;34,0;;;;;;;;3,0;;;;;;;4,0;;28,0;;5,0;1,0;;;;;;;7,0;;;;;50,0;1,0;4,0;10,0;1,0;;;2,0;15,0;129,0;;;;6,0;;2,0;;;4,0;1,0;28,0;10,0;8,0;;1,0;2,0;;;3,0;5,0;;1,0;3,0;4,0;1,0;;30,0;;;1,0;;;;3,0;;;7,0;;;2,0;;9,0;8,0;;;25,0;;9,0;;3,0;1,0;;;;;;;;14,0;66,0;23,0;;;7,0;;;;;;;;;;;;5,0;5,0;;;6,0;;;;;6,0;2,0;5,0;;;1,0;19,0;;;;;;;;;33,0;;;;;;23,0;;;;1,0;1,0;;;2,0;;;6,0;;;31,0;3,0;;;;23,0;;;;1,0;;53,0;;;;;;32,0;;3,0;;;6,0;11,0;;2,0;;12,0;;14,0;;;1,0;16,0;;;9,0;;3,0;;5,0;;;31,0;75,0;;16,0;;;5,0;;;7,0;;79,0;3,0;9,0;69,0;5,0;;1,0;4,0;4,0;24,0;1,0;4,0;;;;;;;;7,0;34,0;;1,0;;;;15,0;;2,0;;1,0;;23,0;;;;3,0;1,0;14,0;;11,0;;9,0;;;17,0;;107,0;4,0;59,0;;;;;;;;;;;12,0;7,0;;;31,0;;1,0;;7,0;4,0;3,0;1,0;16,0;1,0;;3,0;;14,0;3,0;;;15,0;;;9,0;;;9,0;3,0;42,0;;6,0;;9,0;1,0;;3,0;;;;4,0;;6,0;;;;;4,0;10,0;7,0;;2,0;10,0;;;3,0;4,0;6,0;1,0;;;;;1,0;;2,0;2,0;;4,0;;;1,0;3,0;4,0;11,0;;;14,0;14,0;;;2,0;13,0;;;3,0;5,0;4,0;1,0;2,0;20,0;;;11,0;1,0;;5,0;6,0;;39,0;5,0;;;;9,0;;;;4,0;;;;;10,0;;;;;;;;;;;;;;;;;;;;;;;;1,0;;;;;;1,0;;;;;;;9,0;;2,0;;;1,0;;;1,0;;1,0;;;;;;;;2,0;;;;;;;;;;;;;;;;1,0;;;;;;17,0;2,0;;1,0;;;;;3,0;;;;;;;;;;1,0;;6,0;;;;;;;;;;;2,0;;;;;2,0;;4,0;;;;4,0;;;;;6,0;;;;;;23,0;;31,0;;;;;;8,0;1,0;;;;;;;;;25,0;;;;42,0;;;22,0;1,0;;9,0;;;;;;4,0;;;;;2,0;15,0;;3,0;2,0;4,0;;;;;;;4,0;;;;3,0;;;;;2,0;8,0;2,0;;;;;27,0;;;;;;;;;;6,0;;10,0;;;;;;;;;;4,0;;;;;;12,0;;;2,0;;2,0;;;;7,0;;;;;5,0;;;;;;;;;;;;;1,0;;;7,0;;1,0;;;;;;;;38,0;1,0;;15,0;;;;;;2,0;5,0;;1,0;1,0;1,0;4,0;4,0;6,0;;;4,0;;6,0;;2,0;1,0;;;4,0;;2,0;;9,0;;13,0;;1,0;1,0;;;;2,0;11,0;;;3,0;;;;;;;;10,0;;;;1,0;;;;;;;;;2,0;;;;;1,0;;;;4,0;;2,0;;;1,0;;;;;4,0;;;;4,0;;;;;;;;3,0;;;;;;;;;;1,0;;;;;;;;;;;;;;;;;;1,0;;;;;1,0;;;;;;;;;;;;;;;;;;;;;;;;;;;;;;;;;;;1,0;;;;;;;3,0;;;;;;;;;;;;;;;;;4,0;;;;;;;;;;;;;;;;;;;;;;14,0;;;;;;;;;;;;;;;;;;;;;;;3,0;;;;1,0;;;;;;;;1,0;;;;;;;;;;2,0;;;;;;;;;;;;;;;;;;;;;;;;;2,0;;;;;;5,0;;;;;;;;;;;;;;;;;;;;;;;;;;;;;;;;;;;;;;;;;;;;
fastener;;6,0;;;;10,0;18,0;6,0;6,0;3,0;;;4,0;;2,0;8,0;1,0;;;;;9,0;;1,0;2,0;;;2,0;;;16,0;;29,0;;2,0;;;;;;;;;;;;;9,0;;;10,0;;;;1,0;2,0;4,0;;;;24,0;;;;;1,0;2,0;6,0;;9,0;;;;;;5,0;11,0;;;20,0;;;;24,0;;2,0;;;2,0;6,0;6,0;;;5,0;;;;;13,0;2,0;;;2,0;5,0;;1,0;;;;;10,0;;;;;22,0;28,0;16,0;;;;;;5,0;;;;;;1,0;;;2,0;1,0;;;3,0;2,0;;;;3,0;7,0;1,0;;;;18,0;;1,0;;;;;;;92,0;;;;;;7,0;;;;;;6,0;;;;2,0;4,0;;;5,0;;;;7,0;8,0;;;;5,0;;3,0;;1,0;;;1,0;28,0;;3,0;;;;17,0;;4,0;;2,0;;;;;;1,0;;5,0;;;1,0;;1,0;;;35,0;21,0;;;;;;;;13,0;;16,0;;12,0;80,0;3,0;;;21,0;;1,0;;13,0;;;;;;;;1,0;12,0;;1,0;;;;19,0;;;;;;29,0;5,0;;;3,0;;;;;;2,0;;;1,0;;16,0;;36,0;;;;;;;;;;;;4,0;;;2,0;;;;;;;7,0;25,0;;4,0;;;;;;;1,0;;;;;;8,0;;7,0;2,0;2,0;;;2,0;;16,0;1,0;;;2,0;31,0;10,0;;1,0;;;;1,0;;;;7,0;;;;4,0;;1,0;;;;;;;5,0;;;;;;;;;;;1,0;;6,0;;;2,0;6,0;4,0;;;6,0;2,0;4,0;2,0;7,0;;;8,0;;;2,0;;;3,0;;;;;30,0;;1,0;;;;;;;7,0;;3,0;;;;;;;;;;;;;;;;;;;;;;1,0;;;;;;;;;2,0;;;;2,0;;;;;;2,0;;;;;;;;;;;;;;;;;;;1,0;;5,0;;;;;;;;;;;;;22,0;8,0;;;;;;;;;;;;;;;;;4,0;;8,0;;;1,0;;;;;;;;;;;;;41,0;;;3,0;;;8,0;;;;;;;;;;;3,0;;;;;;;;1,0;;;;;;;1,0;;;8,0;;;;7,0;;;7,0;;;;;;1,0;;;5,0;1,0;;;;;;;5,0;2,0;;1,0;;;;;;;;;;5,0;;;;;;16,0;38,0;;2,0;1,0;;7,0;;;;;;;2,0;;;;;1,0;;;;;;;;;;;;;;;;2,0;;;;;;;;;14,0;;;;;4,0;;;;;3,0;;;;1,0;;;1,0;9,0;;;;1,0;7,0;;;6,0;;;;;;;;24,0;;;;;2,0;2,0;2,0;8,0;;;7,0;;4,0;;;;4,0;1,0;4,0;;3,0;;;;;;2,0;;;;1,0;;;;;;;11,0;2,0;;;3,0;;2,0;;;;;;;;;3,0;;2,0;;1,0;;;;1,0;;;;;;;;;;1,0;;1,0;;;;;;;1,0;;1,0;;;;;1,0;;;;;;;;;;;;;;;;;;;;;;;;;;;;;;;;;;;4,0;;;;;;;;;;;;;;;;;;;;;;;;;;;;;;;;;;;;;;;;;;;;;;;;;2,0;;;;;;;;;;;;;;;;;;;;;;;;;;;;;;;;;;;;;2,0;;;;;;;;;;;;;;;;;;;;;;;;;;;;;;;;;1,0;;;;;;1,0;;;;;;;;1,0;;;;;;;;;;;;;;;;;;;;;;;1,0;;;;;1,0;;;;;;;;;;;;;;;;;;;;;;;;;;;;;;;;;;;;;;;;;;;;;
fitting;;5,0;;;;8,0;;;3,0;;2,0;;;;5,0;24,0;;1,0;;;;;;;;;;;1,0;;1,0;;22,0;;;3,0;;;;;14,0;;;;;;2,0;10,0;2,0;;3,0;;;;18,0;1,0;;;1,0;3,0;7,0;;;;;;;9,0;9,0;4,0;;;5,0;;;;;;;23,0;;2,0;;27,0;1,0;2,0;4,0;;1,0;1,0;7,0;;;;;;;;13,0;2,0;1,0;;31,0;1,0;;;5,0;;6,0;;1,0;2,0;;;;16,0;29,0;20,0;;;;;;1,0;13,0;1,0;;;;1,0;;7,0;7,0;3,0;;;;1,0;2,0;;;;;7,0;;;;;;3,0;;;;;;;24,0;;;;;1,0;8,0;;;;;;;;;;;2,0;;3,0;4,0;;;;4,0;9,0;2,0;1,0;;;;1,0;;;;1,0;;38,0;;;;;1,0;1,0;7,0;;;9,0;;;;;;;;;;;;;6,0;;4,0;24,0;2,0;;;;;;;;1,0;;16,0;;;7,0;3,0;1,0;;2,0;2,0;2,0;;;;;;;;1,0;2,0;2,0;21,0;;;;;;4,0;;;;;;;;;;7,0;;;;;;1,0;;;4,0;;;;2,0;;;1,0;;;;;;;;4,0;3,0;;;;;;;1,0;;1,0;5,0;13,0;;;1,0;;1,0;5,0;1,0;;;;1,0;1,0;1,0;;1,0;;4,0;;;;4,0;;;11,0;2,0;;;4,0;2,0;2,0;;;;;3,0;1,0;;;;;;;;5,0;9,0;2,0;;1,0;1,0;;;;1,0;1,0;2,0;;;;;;;4,0;;;;;;;;;;1,0;2,0;4,0;;9,0;1,0;2,0;;;6,0;;;;;;5,0;1,0;;;;8,0;2,0;;1,0;;;;;;6,0;;;;;;16,0;;;1,0;;;;;;;;;;1,0;;;;;2,0;;;;;2,0;1,0;;;1,0;8,0;;;;;;;;;;2,0;;;1,0;;;;;1,0;;;;;;;;;;;;21,0;;;;;;;;;;;;;2,0;5,0;3,0;2,0;7,0;;;;;2,0;;;;1,0;;;;;;;3,0;;;;10,0;;2,0;;;;;;;;;;;;;;;;13,0;;;24,0;;39,0;;;;;;6,0;;2,0;;29,0;;;;;;;;;;;;;1,0;;;;;;;;;;;;;;1,0;;;;;;;;;;2,0;;1,0;;;1,0;;;;;;;;;16,0;;;;;;;1,0;;;;;;;;;;;;;;;;;1,0;;;;;1,0;;;;;;;2,0;;3,0;;;;;2,0;;;;;;1,0;;;;;;;;;2,0;20,0;;;;;;;;15,0;;;2,0;4,0;;;;;;;;2,0;1,0;;;;;;;;;;;14,0;;;25,0;3,0;1,0;;;;;;1,0;;;;;;3,0;;;2,0;;;6,0;;3,0;;;;;;;;;7,0;;1,0;;;1,0;;;2,0;;;1,0;;;;;4,0;;;15,0;;;;17,0;;;;;;;;;;;;1,0;;;;1,0;;;;;;;;;;;;;;;;;;;;;;;;;;;;;;;;;;;;;;4,0;;;;;;;;;;;;;;;;5,0;;;;;;;;;;;;;;;;;;;;;;;;;;;;;;;;2,0;;;;;;;;;;;;;;;;;;;;;;;;1,0;;;;;;;8,0;;;;;;;;;;;;;;;;;;;;;;;;;;;;;;;;;;;;;;1,0;;1,0;;;;;1,0;;;;;;;;1,0;;;;;;;;;;;;;;;;;;;;;;1,0;;;;;;;;;;;1,0;6,0;;;;;;;;;;;;;;;;;;;;;;;;;;;;;;;;;;;;2,0;;;;;;;
flexible;;1,0;;;;;2,0;12,0;5,0;9,0;;;;;1,0;4,0;;;;1,0;;21,0;;1,0;;;;5,0;4,0;;;;8,0;;4,0;;;3,0;;1,0;;;13,0;;;;;53,0;1,0;8,0;12,0;2,0;;;4,0;4,0;16,0;;;;17,0;;;;2,0;;;30,0;7,0;11,0;;;;;;1,0;;2,0;;32,0;5,0;2,0;1,0;84,0;;;;;;4,0;27,0;;;41,0;;;;;39,0;;;;93,0;3,0;;;16,0;1,0;2,0;;3,0;;;;;13,0;110,0;24,0;3,0;;;1,0;;;;;;;;1,0;;;2,0;;;;4,0;;;;;1,0;;20,0;;;;22,0;11,0;6,0;;1,0;;;;;14,0;;;;;;19,0;;;;7,0;;;;1,0;;6,0;4,0;;;26,0;20,0;;;239,0;7,0;;9,0;;444,0;;14,0;;;1,0;;;85,0;;33,0;;;;22,0;2,0;1,0;;2,0;2,0;12,0;;;;11,0;31,0;2,0;;;;;;3,0;3,0;3,0;40,0;;1,0;;;;2,0;;5,0;;48,0;1,0;;60,0;1,0;3,0;;25,0;7,0;7,0;3,0;6,0;;1,0;;;;;;2,0;12,0;;;;;;10,0;;;;3,0;;4,0;1,0;;4,0;12,0;;;;2,0;5,0;8,0;4,0;;2,0;;12,0;179,0;81,0;;;8,0;3,0;1,0;;;3,0;1,0;5,0;;;;;3,0;;;;27,0;;10,0;2,0;13,0;;;1,0;;2,0;12,0;;;4,0;1,0;;;1,0;;14,0;;41,0;;;;17,0;7,0;;9,0;;;;34,0;5,0;3,0;;7,0;;2,0;2,0;1,0;6,0;5,0;;3,0;;1,0;;3,0;11,0;2,0;5,0;;5,0;;;15,0;2,0;;10,0;;;;;;2,0;12,0;2,0;;1,0;2,0;;;;4,0;;;23,0;7,0;4,0;;;3,0;;3,0;5,0;6,0;;;;;7,0;1,0;;;;3,0;;;3,0;9,0;;;;;2,0;1,0;;;;;;;;;;;;;;;;;;;;;;;1,0;;;;;;;;;1,0;;;;1,0;;2,0;;;2,0;;;;;;;;;;;1,0;;;;;;;;;1,0;;;;1,0;;;;;;;;;;;1,0;11,0;;3,0;;;;;1,0;;;;;;;;;;4,0;;;;;;1,0;;;;;;;1,0;;;;;;;;;1,0;;;2,0;;;;12,0;;1,0;;;;1,0;;2,0;;;;1,0;;1,0;2,0;;;1,0;;;2,0;;;12,0;1,0;;;;;;;2,0;;2,0;;;2,0;;;;;;;;;;1,0;3,0;;1,0;;;;;;;;;;;1,0;;;;;;1,0;;;;;;2,0;;;;;;;;;;;1,0;13,0;;;;;;;;;;;;;;1,0;;;;;;;2,0;;;;2,0;;;;;2,0;;;;;16,0;;;;;;6,0;5,0;;;;;2,0;4,0;;;1,0;;;;;;;;27,0;;;;;;;;;;;1,0;7,0;;2,0;;1,0;;;;;7,0;;;;2,0;;228,0;;;;;;;;;;;;1,0;;;1,0;;4,0;;;1,0;;;1,0;;;3,0;3,0;6,0;;2,0;3,0;;;;;;;12,0;;7,0;;;;;;2,0;2,0;;;;;;;;1,0;1,0;;3,0;;;;;;;;;;;;2,0;;;2,0;;;;;;;;;;;;;;;;;;;;;;;;;;;2,0;1,0;;;1,0;;;;;4,0;;;;;;;;;;;;;;;;;;;3,0;;;;;;;;;;;;;;;;;;;;;;;;;;;;;;;;;;;;;;;;;;;;;;;;;;;;;;5,0;;;;1,0;;;;;;1,0;;;;;;;;;2,0;;;1,0;;;;;2,0;;;;;2,0;;;;;;;;;;3,0;;;;;;;;;;;;;;;14,0;;;;;;;;;;;;4,0;;;;1,0;;;;;;;;;1,0;;;;;;;;;;;;;;;;;;;;;;;;;;;;;;;4,0;;;;;;
fold;;1,0;;;;3,0;1,0;;;1,0;;;;;;1,0;;;;;;;;;;;;;11,0;;;1,0;15,0;;2,0;;;1,0;2,0;;;;3,0;;;;;6,0;;;3,0;1,0;;;;6,0;2,0;;;;1,0;3,0;3,0;;;;;;;2,0;;;;;;;;;;5,0;;8,0;;14,0;;;;;;2,0;8,0;;;3,0;;;;;;;;;21,0;;;;13,0;;;;;;;;;;5,0;32,0;;;;;;;;;;;;;;;1,0;;;;;;;;;;;8,0;;;;13,0;1,0;;;;;;;;5,0;;2,0;;;;15,0;;;;1,0;3,0;2,0;;;;;3,0;;;4,0;;;;8,0;1,0;;1,0;;17,0;;5,0;;;;;;7,0;;8,0;;;;4,0;;1,0;;1,0;;;;;;2,0;1,0;;;;;;;;;;9,0;;;;;4,0;;;15,0;;;;8,0;;;1,0;;3,0;;1,0;2,0;5,0;;13,0;;;;;;;1,0;;3,0;;;;;9,0;;;;;;;;;4,0;;;;2,0;1,0;;;2,0;;;3,0;;19,0;2,0;;2,0;;;1,0;;;;2,0;2,0;;;;4,0;;;;;1,0;3,0;1,0;2,0;;;;;;4,0;;;;;;5,0;;;;;5,0;;;1,0;1,0;;;1,0;;;;4,0;;7,0;;;;4,0;;;;;;;;;;2,0;;1,0;;;2,0;;;;;2,0;;;;;2,0;;;;;9,0;1,0;;3,0;;;;;;;;;;;;;13,0;;;;;;;23,0;;;;;;;;;;;;;;;;;;;;;;;;;;;;;;;;;;;;;;2,0;;;;;;;;;;;;;;;;;;;;;6,0;;;;;;;;;;;;;;;;;;;;;;;;;;2,0;;;;;;5,0;;;;;;;;;;;;;;;;;;;;9,0;;;;;;;;;;;;;;;;;;;;;;;10,0;;;;;;;;;5,0;18,0;;1,0;;;;;;;;;;;;;;;;;;;;2,0;;;;;;;;;;;;;;;;;4,0;;;;6,0;;;;;;;;;;;;;;;;;1,0;;;;;;;;;;;;1,0;;;;;;;;;;;;;;;;;;;;;;;;;;;;;;;;;;;;;;;;2,0;;;;;;;;2,0;13,0;;;;;;1,0;;;;;;;6,0;;;;;;;;;;;7,0;;;;;1,0;3,0;;;;;;3,0;;2,0;;;2,0;2,0;;6,0;;;;;;;2,0;;;;1,0;;;;1,0;;;;;;;;2,0;;;;;;;;;;;;;;;;;;;;;;1,0;;1,0;14,0;;;;;;;;;;;1,0;;;;;;;;;;;;;;;;;;;;;;;;;;;;;;;;;;;;;;;;;;;;;;;;;3,0;;;;;;;;;;;;;;;;;;;;6,0;;;;2,0;;;;;;;;;;;;;;;;;;;;;;;;;;;;;;;;;;;;;;;3,0;;;;;;;;;;;;;;;;;;;;;;;2,0;;;;;;;;;;;;;;;;;;;;;;;;;5,0;;;;;;;;;;;;;;;;;;;;;;;;;;;;;;;;;;;;;;;;1,0;;;;;;;;;;;;;;;;;;;;;;;;;;;;;;;;;;;;;;;;;;
foot;;1,0;;;;8,0;;;2,0;;;;;;14,0;4,0;;;;;9,0;2,0;;;;;;1,0;;;1,0;;1,0;;;;;;;;39,0;;;4,0;;;7,0;6,0;;2,0;10,0;2,0;;;2,0;4,0;15,0;;;;7,0;;;;;;;7,0;4,0;1,0;;;;;;2,0;;;;48,0;;;;23,0;;2,0;;;;6,0;6,0;;;1,0;;;;;3,0;3,0;;;4,0;5,0;;6,0;;;;;;;;;;43,0;5,0;46,0;;;;;;;;2,0;;;;;;1,0;14,0;1,0;9,0;;4,0;6,0;;;;;;3,0;1,0;;;30,0;;;;;;2,0;3,0;;5,0;;;;;;4,0;1,0;;;;;;;;;3,0;1,0;;4,0;1,0;7,0;;;1,0;24,0;;;;;;1,0;;;;;3,0;6,0;;4,0;;1,0;;;1,0;2,0;;2,0;;2,0;;1,0;;2,0;;4,0;;;;;3,0;;1,0;3,0;20,0;;4,0;;;;;;;;8,0;7,0;6,0;21,0;6,0;4,0;;3,0;14,0;8,0;;2,0;;;;;;;;;4,0;;;;;;5,0;;;;1,0;;19,0;2,0;;;8,0;;;;;;3,0;;;;;;;10,0;;;1,0;1,0;;;;;;;3,0;2,0;;;5,0;;;;;;;1,0;21,0;;4,0;;;1,0;10,0;;;;;;;1,0;;1,0;;1,0;;;;4,0;;;6,0;;;;2,0;;3,0;;;;5,0;;1,0;5,0;;;7,0;5,0;;;6,0;;;;;1,0;;;;4,0;2,0;34,0;;;;1,0;3,0;;;;15,0;1,0;7,0;;3,0;;1,0;;;3,0;3,0;2,0;7,0;2,0;3,0;1,0;;;;;;1,0;;55,0;;6,0;;;1,0;;2,0;;;;;;;5,0;;;;4,0;;;2,0;;;;6,0;;;;;;;;;;;;;5,0;;;;;2,0;3,0;2,0;;3,0;1,0;;;;3,0;;;;;;;2,0;;;;;;;;;;;;;;;;3,0;9,0;;;;;3,0;1,0;;;9,0;;2,0;;;;1,0;4,0;4,0;;;;;;;;;;;;;;;;;;;;1,0;;;;;;;;;;;;;;;;;;;;;1,0;;2,0;;;10,0;;;;;;;8,0;;16,0;;;;;;;;1,0;4,0;;;;;5,0;;;;;;2,0;8,0;;;;1,0;3,0;;;;;;;;;;;;;;;;;;;;;;;;;;;;;;;;;;;;;2,0;;;;;1,0;;;;;;1,0;1,0;;;;;1,0;;;;;;;1,0;;3,0;;;;1,0;;;1,0;;;;6,0;;;;;;;;;;13,0;2,0;;;;;6,0;;10,0;;;;1,0;;;;1,0;;;;2,0;;;;2,0;;;;;;14,0;;;;;32,0;;;;;;;;;;1,0;;;;5,0;;;7,0;;;;;;1,0;;;;;1,0;;;2,0;;;;1,0;;;;3,0;;;2,0;;;;;;;;2,0;;;;;;;;;;;;;;;;;;;;;;;;;4,0;;;;;;;;;2,0;;;;;;;;;;;;;;;;;;;;;;;;;;;;;;;;;;;;;;;;;;;;1,0;;;;;;;;;;;;;;;;;;;;;;;;;;;;;;;;;;;;;;;;;;;;;;;5,0;;;;;;8,0;;;;;;;;;;;;;;;;3,0;;;;;;;;;;;2,0;;;;;;;;;;;;;;3,0;;;;;;;;1,0;2,0;;;;;;;;;;;;;1,0;;;;;;;;;;;;;;;;;;;2,0;;;;2,0;;;;;;2,0;1,0;;;;;;;;;;3,0;;;;;;;;;;;;;;;;;;;;;;;;;;;;;;;;;
force;;2,0;3,0;;;4,0;;7,0;;3,0;;;5,0;;21,0;16,0;;;;;;1,0;;3,0;;;;;;4,0;;9,0;98,0;;41,0;1,0;;;5,0;;3,0;3,0;5,0;;10,0;2,0;5,0;75,0;3,0;9,0;9,0;2,0;;;355,0;1,0;27,0;;;;5,0;33,0;3,0;;2,0;1,0;4,0;27,0;28,0;3,0;2,0;;220,0;;;13,0;;;;8,0;;2,0;;29,0;7,0;;;;;3,0;99,0;;;4,0;14,0;;9,0;;10,0;2,0;;;34,0;5,0;;4,0;12,0;9,0;8,0;;7,0;3,0;;;;7,0;133,0;40,0;6,0;23,0;6,0;;;;;;;;;2,0;;1,0;14,0;;2,0;;;11,0;;;;;;12,0;3,0;;;14,0;5,0;3,0;2,0;;;3,0;;3,0;11,0;;3,0;11,0;;117,0;123,0;;;;4,0;3,0;;;;2,0;;;3,0;103,0;22,0;76,0;12,0;;5,0;16,0;1,0;;98,0;;;11,0;1,0;;1,0;4,0;;19,0;;48,0;2,0;;2,0;2,0;;;3,0;121,0;11,0;70,0;7,0;;;54,0;6,0;;;;;;2,0;;;7,0;26,0;;2,0;;;;1,0;18,0;4,0;;232,0;;8,0;7,0;46,0;29,0;5,0;10,0;11,0;3,0;;;;2,0;20,0;;;;;4,0;10,0;;1,0;5,0;20,0;1,0;16,0;;;;30,0;;6,0;3,0;;1,0;4,0;1,0;40,0;;8,0;4,0;1,0;;;132,0;;2,0;2,0;25,0;5,0;;1,0;;1,0;3,0;;;;;10,0;11,0;8,0;;4,0;4,0;2,0;;1,0;1,0;55,0;1,0;4,0;7,0;2,0;7,0;49,0;9,0;10,0;4,0;;4,0;2,0;4,0;1,0;5,0;;4,0;1,0;12,0;;;;7,0;349,0;;6,0;;;;;9,0;;1,0;;;;8,0;4,0;15,0;2,0;1,0;12,0;1,0;;10,0;25,0;10,0;14,0;;;24,0;;2,0;23,0;12,0;1,0;5,0;6,0;1,0;;;4,0;11,0;4,0;1,0;2,0;3,0;;;;10,0;;1,0;2,0;;7,0;;74,0;13,0;3,0;1,0;2,0;31,0;2,0;3,0;;1,0;;20,0;;;;;;;5,0;4,0;2,0;;;13,0;;1,0;2,0;;;;1,0;2,0;22,0;;;;;7,0;;;;;;;1,0;;;;2,0;;;;1,0;;;3,0;4,0;;;8,0;2,0;;;5,0;34,0;;;5,0;5,0;;;12,0;;;;;;;;;;;;;;;2,0;1,0;3,0;2,0;4,0;2,0;;;1,0;;1,0;;5,0;;;;15,0;;;3,0;;;;;;;2,0;;;;;;;;6,0;2,0;14,0;;;;;;;;;;;1,0;;;1,0;;;;;;2,0;;3,0;3,0;;;;1,0;;;;;;1,0;;;;;;;;76,0;;;;9,0;;;1,0;;;;;;;;;;7,0;;;;;2,0;;;;;;1,0;;;2,0;;;2,0;;1,0;2,0;;;2,0;;;6,0;;;;5,0;;;;9,0;;;;;;;4,0;9,0;;;;;;1,0;;;;2,0;;;1,0;1,0;;;;;;;;1,0;;;;4,0;;;9,0;;;;;;;11,0;1,0;;1,0;;;;;;12,0;1,0;2,0;;3,0;6,0;;;;2,0;;;;4,0;;1,0;;;;;1,0;;1,0;;7,0;3,0;;;;;;;;;;;2,0;;;;1,0;;;2,0;;;;1,0;;;13,0;;4,0;2,0;1,0;2,0;1,0;4,0;;;29,0;;2,0;3,0;;2,0;;;3,0;;;;;47,0;3,0;2,0;;;;;47,0;1,0;;;1,0;;;;;;;;;1,0;;;;;;;;;1,0;;;;;;2,0;;2,0;;;;4,0;;1,0;4,0;;;;;;;;;11,0;;;;6,0;;1,0;;1,0;;;;;;2,0;;;;;;;2,0;1,0;;;;;1,0;3,0;;4,0;;;;;;30,0;;;;;;;;1,0;;4,0;;;;;3,0;;;;;;;;;;;;1,0;;;3,0;11,0;;;;;;15,0;;;;;;;;;;;;;;;;2,0;;1,0;;;;;;;;;1,0;1,0;3,0;;9,0;;1,0;;9,0;11,0;;;;;;;;;;;;;;;;;;4,0;;;;9,0;;;6,0;23,0;;;4,0;8,0;;;8,0;1,0;;2,0;;;4,0;2,0;8,0;3,0;2,0;14,0;;1,0;;;;;;;;10,0;;;;;;;;;;1,0;3,0;;;;;;;;;;;;;;;1,0;;;;;;;;2,0;;;;;;;;;;;;;;;;;;;;;;;;;;;;;2,0;;
forward;;3,0;;;;6,0;2,0;13,0;10,0;1,0;;;;;31,0;21,0;1,0;;2,0;1,0;;17,0;;;;;2,0;;;;5,0;4,0;14,0;;7,0;1,0;12,0;6,0;;23,0;12,0;;;;6,0;12,0;10,0;21,0;16,0;4,0;8,0;14,0;3,0;;18,0;1,0;3,0;1,0;22,0;;10,0;3,0;24,0;14,0;3,0;1,0;22,0;1,0;7,0;19,0;1,0;;12,0;;;;3,0;1,0;;85,0;2,0;15,0;;6,0;2,0;;1,0;;5,0;;48,0;;;;;1,0;3,0;;30,0;2,0;1,0;3,0;4,0;10,0;;1,0;29,0;1,0;2,0;1,0;1,0;;;;;3,0;15,0;20,0;4,0;17,0;;;;4,0;7,0;2,0;;;;;;4,0;12,0;;5,0;1,0;;2,0;;;11,0;;;13,0;1,0;;;13,0;11,0;;;;4,0;;;1,0;27,0;;4,0;;;4,0;12,0;;;;11,0;28,0;;;;;;;2,0;6,0;5,0;1,0;1,0;;;18,0;;4,0;;5,0;;2,0;;;;;;13,0;;3,0;3,0;;;;;;6,0;58,0;;;2,0;;3,0;21,0;;;;;;;;;;;25,0;;;;;;;;2,0;;5,0;;8,0;16,0;4,0;19,0;4,0;4,0;;;4,0;;;;;;;2,0;5,0;1,0;;;3,0;;1,0;;5,0;;;;;;;5,0;;;1,0;;;;;2,0;4,0;;;1,0;;3,0;;19,0;;;2,0;;;5,0;;;;1,0;79,0;1,0;1,0;;4,0;;;5,0;;;1,0;;4,0;;;;3,0;4,0;2,0;;;4,0;1,0;;1,0;;;;;;;;;1,0;5,0;;3,0;;;;;;;;;3,0;6,0;;;2,0;;;;2,0;1,0;1,0;;;;2,0;;;;2,0;;9,0;;6,0;;;;11,0;;;6,0;;;7,0;;;;;;3,0;;;;;9,0;3,0;;;1,0;;;;;;;5,0;;2,0;;;3,0;1,0;;1,0;2,0;;;1,0;;1,0;5,0;;;;;10,0;2,0;1,0;3,0;;3,0;;;;;;;3,0;;;;;;;;5,0;;11,0;;;10,0;;;;6,0;;8,0;23,0;6,0;;4,0;;;15,0;1,0;;1,0;;;;;13,0;4,0;;;;1,0;;1,0;1,0;;;2,0;;2,0;;;4,0;;;3,0;3,0;6,0;;;;1,0;7,0;;1,0;2,0;;;;;;;;1,0;;;;;;3,0;;3,0;;;5,0;;;;4,0;;;1,0;1,0;;2,0;;;;;;;;;1,0;;;1,0;;;4,0;1,0;;;2,0;4,0;;;1,0;;;;;;;1,0;;;;;;7,0;;;;;;3,0;;;3,0;2,0;;4,0;1,0;;10,0;;;9,0;2,0;1,0;;;;;;2,0;;;;;;;;7,0;;3,0;;;;12,0;;;;3,0;1,0;;;1,0;2,0;;15,0;;;1,0;;4,0;;6,0;;;;;4,0;;3,0;;;;;1,0;;;;;;5,0;6,0;;;;;;;;2,0;;;;2,0;;;;;1,0;10,0;;;;;;;;;;1,0;4,0;;;;2,0;;;;;;4,0;;2,0;;;4,0;5,0;;;;;;;;;;1,0;3,0;4,0;;5,0;;;;;1,0;1,0;;;5,0;2,0;;4,0;;;4,0;3,0;4,0;;;;;;;;;;;;3,0;;2,0;;;;;;;;;2,0;;;;;;;;;;;1,0;;;;1,0;;;1,0;;;;1,0;;2,0;;;;;;;;;;;;;;;;;;;;;;;;;;;;;;1,0;8,0;;;;;;;;;;2,0;;;1,0;;;;;1,0;;;;;2,0;;;;2,0;;;;;;;;;;6,0;;;;;;1,0;1,0;;;;;;2,0;;;;;;;;;;;;3,0;;;;;;;;;;;;;;;;4,0;;;;;;;;;;;;;;;1,0;;2,0;;;;;;4,0;;;;5,0;;;;;;;;;12,0;;;;;;;;;;;1,0;;;;;;;;;2,0;;1,0;;6,0;2,0;;;;;;;;;;;;;;;5,0;;;1,0;;;;;;;;;;;;;1,0;4,0;3,0;;;;;;;;1,0;;5,0;;;;;;;;;;;;;;;;;;;;;;;;1,0;;;;;;;;9,0;2,0;;;;2,0
grip;;2,0;;1,0;;;8,0;16,0;9,0;12,0;;;;;2,0;9,0;;;;;;;1,0;;1,0;;;1,0;;;;;1,0;;5,0;;;;;;;;1,0;;2,0;1,0;;8,0;3,0;;15,0;;;1,0;;1,0;31,0;;;;16,0;;2,0;1,0;;;;7,0;;2,0;;;;;;;;;;2,0;;2,0;;20,0;;;;;4,0;2,0;4,0;;;1,0;;;;;9,0;;;;3,0;18,0;;;;;;;;10,0;3,0;;;2,0;49,0;15,0;;;1,0;;;;;;;;;;;;7,0;2,0;;;3,0;;;;;1,0;;1,0;;;;10,0;;1,0;3,0;;;2,0;;;9,0;1,0;;;;;4,0;;;;;;;;;;;2,0;;;8,0;;1,0;;;8,0;;;;;;1,0;;;;;3,0;24,0;;;;1,0;;7,0;13,0;2,0;;10,0;;9,0;;;;;;;;;;;;;1,0;;4,0;;2,0;;;;;1,0;;;40,0;;;25,0;5,0;4,0;1,0;4,0;3,0;1,0;;;;;;;;;;3,0;7,0;;;8,0;;;1,0;;;;;;3,0;;;;3,0;;;;;;1,0;;;3,0;;;;8,0;;;;;;1,0;;;;;;2,0;;;3,0;;;;12,0;;4,0;13,0;25,0;;1,0;1,0;2,0;;2,0;;;1,0;;;;;;4,0;;3,0;;;;1,0;;;2,0;7,0;;;2,0;1,0;;;;;;;2,0;;;;;;2,0;;4,0;;1,0;;;4,0;;;;9,0;;;;;;1,0;;3,0;;1,0;;;8,0;;;;;;;;1,0;;4,0;3,0;2,0;;;4,0;;;1,0;;;1,0;;;;;;;5,0;4,0;;;;;;1,0;;;;;;;1,0;;;;;;;;;;;;;;;;;1,0;;;;;;;;;;;1,0;;;;1,0;;;;1,0;5,0;;;;;;;;2,0;;;;;;;;;1,0;8,0;;2,0;;12,0;;;;;16,0;;;;;12,0;1,0;;;3,0;;;;;;;;;;;;;;;;;3,0;;;;1,0;;;;;;;;;;;;14,0;;;;;6,0;3,0;;;;;1,0;;;;;;4,0;;;;;;;;;;;;;;;;;;1,0;;;;;;;6,0;;;;;;;;;;;;;;;;2,0;;;10,0;;;;;;2,0;;;;;39,0;;;;;5,0;;14,0;;;1,0;;8,0;;;;;;;;;;;;5,0;2,0;;;1,0;;;;;;;;;;2,0;;;;;;;;;;;2,0;;;;;;;;;;3,0;;;;;;;1,0;;;2,0;1,0;;1,0;;;;;;;;2,0;;;1,0;;;;;;;;;;17,0;;3,0;;;;;;;;;;;;;;;;;;;;;;;;2,0;4,0;5,0;;;;2,0;;;;;;;;1,0;;;;;;;;1,0;;;;;;;;;;9,0;;;;;;;;;;;;;;;;;;;;;;;;;;;;;;;;;;;;;;;;;;;;;;;;;;;;;;;;;;;;;;3,0;9,0;;;;;;;;;;;;;;;;;;;;;;;;;;;;;;;;;;;;;;;;;;;;;;;;;;;;;;;;;;1,0;;;;;;;;;1,0;;;;6,0;;;;;;;2,0;;;;1,0;;;;;;;;;;;;;;;;;;1,0;;;;;3,0;;;;;;1,0;;;;;;1,0;;;;;;;;;;;;;;;;2,0;;5,0;;;;;;;;;;;1,0;;;;;30,0;;;;;;;;;;;;;2,0;;;;;;;;;;;;4,0;;;;;;;;;;;;;;;;;;;;;
groove;;3,0;;;;12,0;7,0;25,0;6,0;9,0;;;2,0;;47,0;20,0;;;;;;;;2,0;1,0;;;7,0;2,0;;;;9,0;;1,0;;;;1,0;1,0;;1,0;69,0;24,0;;1,0;1,0;23,0;;1,0;22,0;;;3,0;14,0;11,0;7,0;;;;56,0;;;;9,0;;1,0;229,0;17,0;7,0;;;2,0;;;11,0;;;;9,0;;8,0;2,0;43,0;1,0;;;;3,0;10,0;96,0;;;2,0;1,0;;;;5,0;2,0;;;100,0;20,0;;;50,0;;;;23,0;;6,0;;;70,0;139,0;53,0;1,0;5,0;5,0;;;;;;;;;;10,0;;7,0;;;;26,0;;;;;6,0;;5,0;;;;105,0;3,0;;1,0;;;;;;5,0;;2,0;;;;47,0;1,0;;;2,0;3,0;;;3,0;5,0;15,0;9,0;;3,0;16,0;59,0;;;14,0;27,0;1,0;2,0;;7,0;3,0;4,0;;;;;7,0;32,0;1,0;15,0;;;;22,0;20,0;;;30,0;;6,0;;;;32,0;;2,0;2,0;;3,0;;;6,0;5,0;32,0;37,0;;51,0;27,0;;2,0;3,0;3,0;5,0;1,0;116,0;;;61,0;3,0;29,0;3,0;42,0;16,0;18,0;3,0;;13,0;1,0;;;;;1,0;4,0;9,0;;2,0;1,0;;;146,0;;5,0;;2,0;16,0;6,0;3,0;2,0;;46,0;26,0;3,0;;70,0;3,0;21,0;5,0;;;;17,0;8,0;160,0;1,0;;3,0;1,0;;;;1,0;;;;4,0;3,0;5,0;49,0;;10,0;;15,0;6,0;18,0;4,0;3,0;3,0;5,0;5,0;2,0;45,0;58,0;;;12,0;;7,0;3,0;;;22,0;1,0;36,0;1,0;;3,0;3,0;30,0;;90,0;21,0;;2,0;1,0;5,0;4,0;1,0;;;2,0;169,0;2,0;36,0;7,0;9,0;54,0;1,0;2,0;1,0;7,0;10,0;7,0;;14,0;12,0;;2,0;3,0;7,0;;;2,0;5,0;;29,0;4,0;24,0;67,0;1,0;;14,0;9,0;;;4,0;;;5,0;;16,0;;33,0;1,0;7,0;1,0;1,0;16,0;;;11,0;5,0;;39,0;10,0;;;3,0;12,0;;;16,0;;;;;;2,0;;;;;;;2,0;;2,0;;;;;;2,0;;;;1,0;;;;;6,0;;;;;;18,0;1,0;;;;;;;;9,0;;;1,0;1,0;;;;;2,0;;;;;;;;;;;;;;;;;;;;;;;;;;;;;11,0;5,0;;6,0;;;;;;;4,0;;;;;;;1,0;;;47,0;;1,0;5,0;;;15,0;;;;;1,0;;;;;;;2,0;;;;7,0;9,0;;;;;;;;;3,0;2,0;;1,0;;;;4,0;;8,0;;;;;;;;;;1,0;;;;;;;8,0;;;3,0;;;15,0;;19,0;2,0;;;;;;;;;;4,0;;;;;;;1,0;;;;;;;;;7,0;;;;;;;15,0;;;;;1,0;;1,0;;;1,0;;4,0;2,0;;;;;;;;;;;;;4,0;;;;;1,0;;;;;;4,0;;;;;;;;;3,0;;;;2,0;;;16,0;;;;1,0;5,0;;;;;;;6,0;1,0;2,0;2,0;;;6,0;3,0;;1,0;;;6,0;;3,0;;;;2,0;1,0;5,0;;;2,0;1,0;;;;;;;;;2,0;;;;1,0;;9,0;2,0;;;;1,0;;;;23,0;;;;;7,0;;1,0;;;1,0;1,0;3,0;;;9,0;2,0;;;4,0;;;;;7,0;;2,0;;;;2,0;;;;3,0;;;;;;3,0;1,0;;;;2,0;;;;;;;;;;;;;2,0;;;;2,0;;;;;;;;;7,0;;;;;1,0;;;;;;;;;1,0;1,0;;;;;;;;5,0;;;;;;;4,0;;;;;;;;;;;;1,0;;;;;;;1,0;;;;;;;;;3,0;;;;;;;;;;;;;;;;;;;1,0;;;;;;;;3,0;;;2,0;;;;;1,0;;2,0;10,0;;;;;;;;;;;;;;;;;;;;1,0;;1,0;;;;;3,0;;26,0;;;;;;;6,0;;;1,0;;2,0;;;1,0;;;;;;;;;;;;;;;;;;;;;;;;;2,0;;;;;;;2,0;;;;;;;;;;;;1,0;;;;;6,0;;;;;;;;;;;;;;;;;;;;;;;;;;
ground;;10,0;2,0;;;7,0;6,0;9,0;4,0;1,0;26,0;;1,0;;13,0;41,0;;1,0;;;;23,0;;;3,0;;;;;;;;18,0;;8,0;24,0;;7,0;;;11,0;;12,0;;5,0;;26,0;12,0;2,0;17,0;23,0;15,0;;;16,0;4,0;27,0;4,0;32,0;3,0;16,0;2,0;15,0;;4,0;;;15,0;9,0;;8,0;;10,0;1,0;2,0;;7,0;;;79,0;1,0;7,0;3,0;53,0;;4,0;20,0;;1,0;;29,0;;;9,0;1,0;3,0;;;42,0;2,0;4,0;;33,0;46,0;;;3,0;8,0;8,0;8,0;9,0;;1,0;;;39,0;129,0;43,0;31,0;5,0;;1,0;;2,0;10,0;2,0;1,0;;;;;23,0;8,0;;1,0;;10,0;;;;20,0;;2,0;2,0;;;;10,0;18,0;;1,0;;;;2,0;34,0;27,0;;;;1,0;4,0;38,0;1,0;1,0;;13,0;17,0;;;;;;7,0;;;8,0;;;;42,0;21,0;1,0;3,0;;58,0;3,0;9,0;;;;;;120,0;;56,0;;;;6,0;;;;9,0;1,0;;;;2,0;3,0;5,0;4,0;;1,0;;;2,0;2,0;5,0;4,0;21,0;;2,0;;;4,0;19,0;;;;8,0;10,0;;28,0;;4,0;;2,0;7,0;5,0;;;;;;;;3,0;12,0;104,0;23,0;;3,0;;2,0;;3,0;;;;;;18,0;2,0;;;8,0;20,0;3,0;;;26,0;4,0;;;9,0;;;9,0;120,0;1,0;;137,0;;;4,0;;3,0;;;44,0;8,0;1,0;;;;;;22,0;3,0;;2,0;5,0;;5,0;2,0;;2,0;6,0;;;;1,0;;;;;16,0;;4,0;;3,0;;;3,0;2,0;4,0;;;;;;;1,0;4,0;1,0;;;;5,0;;;;;;;2,0;;9,0;12,0;;5,0;;;;;4,0;39,0;1,0;2,0;;6,0;;3,0;;;3,0;;16,0;;;;;;;;1,0;1,0;1,0;;;;;;;;;;;6,0;3,0;;;2,0;;;8,0;5,0;;;;;;8,0;4,0;;;;;18,0;5,0;;;;;1,0;;;;;;;;;;;;29,0;;;;15,0;9,0;;14,0;;;;2,0;;2,0;39,0;2,0;;;;17,0;1,0;18,0;;1,0;2,0;;5,0;;2,0;;3,0;;;;;;;2,0;;;1,0;4,0;11,0;;;;;7,0;;;1,0;50,0;;1,0;;;3,0;24,0;;;;4,0;8,0;2,0;2,0;;2,0;;6,0;23,0;1,0;9,0;31,0;4,0;;;;2,0;;8,0;;;;;;;;;;;;;2,0;;;8,0;1,0;1,0;2,0;3,0;8,0;;;;;;36,0;;;3,0;8,0;;;;;1,0;;;;;;;;;4,0;4,0;;;1,0;;;;;;3,0;;;;;;;;;;;1,0;;1,0;;;;;1,0;;;;;;;;;;;;;;3,0;3,0;;;;;1,0;1,0;;;;6,0;1,0;;;;;2,0;;3,0;;;;;;;;1,0;;2,0;;1,0;;6,0;;1,0;;2,0;;;;;;;;;;;;1,0;;;3,0;;;8,0;;;;;;2,0;;;;2,0;;;;;;;3,0;2,0;;;;1,0;;;;;;;;2,0;5,0;;;;;;9,0;;7,0;;;;;;;;2,0;4,0;56,0;10,0;;;4,0;;;;;;;;1,0;7,0;;;26,0;;;2,0;;;;2,0;;;2,0;1,0;8,0;10,0;;;;;;1,0;;;;;6,0;;2,0;;;;;;;;;13,0;;;;;;3,0;;;;1,0;;;;4,0;;;;;19,0;;;;;;;;1,0;;2,0;10,0;1,0;;;;;;;;;;;;6,0;6,0;;;;;;;;2,0;1,0;;;;2,0;;;;;;;;;2,0;;;;;1,0;;;;;;;;;;;;;6,0;;;;;;;;;1,0;1,0;;;;;;;;3,0;;;3,0;;;;;;2,0;;1,0;1,0;;;2,0;;;1,0;;;;2,0;;;1,0;;1,0;;;;;;2,0;1,0;;;;;;;;;30,0;;;;;;;;;;;3,0;;;;;;1,0;;;1,0;;;;;;1,0;;1,0;;;;2,0;;;;3,0;;;;;;;;;;;;;;;;;;;;3,0;;6,0;;;;;;;;;;;;;;;2,0;;;2,0;;;;;;15,0;;;1,0;;;;;2,0;;12,0;2,0;;;;;;;;;;;;;
hand;;2,0;2,0;;;5,0;2,0;5,0;8,0;7,0;;;3,0;;5,0;6,0;;2,0;;;;8,0;;;;;2,0;1,0;;3,0;1,0;8,0;5,0;;10,0;36,0;;7,0;6,0;;10,0;;;3,0;10,0;6,0;8,0;38,0;;15,0;5,0;6,0;;;;;;2,0;;;3,0;;5,0;;1,0;;;2,0;3,0;;5,0;4,0;;;;;1,0;2,0;1,0;28,0;;11,0;1,0;14,0;1,0;1,0;;;;2,0;7,0;;;1,0;1,0;;;;12,0;1,0;;1,0;4,0;26,0;;;;;1,0;;;1,0;;1,0;;5,0;15,0;33,0;;1,0;4,0;;;7,0;3,0;;;;;;;;6,0;1,0;2,0;;;;;;2,0;;;3,0;4,0;;;8,0;1,0;;;;;2,0;1,0;6,0;12,0;;;;2,0;1,0;62,0;;1,0;;;9,0;;;;;;;3,0;1,0;6,0;;;;;11,0;;;;;;2,0;;;;;;4,0;;4,0;;;;4,0;;2,0;;4,0;;;;;;6,0;;;2,0;;2,0;;;;;;7,0;;;2,0;;;;1,0;7,0;;11,0;;3,0;11,0;;3,0;7,0;1,0;;1,0;;;;;;;;;4,0;;6,0;;;;;;1,0;4,0;;;;;;;;12,0;;;2,0;;1,0;1,0;3,0;;;;;1,0;;3,0;1,0;;11,0;;;4,0;;8,0;;;4,0;;7,0;;;;;;;;;2,0;3,0;;;;;3,0;3,0;;;;1,0;;2,0;;;;;6,0;;;;1,0;;;;;;1,0;;1,0;;;;1,0;;;6,0;;;;;1,0;;;2,0;2,0;;2,0;;1,0;;;;5,0;2,0;;6,0;;;;;;;;;;3,0;;1,0;2,0;;;;;1,0;;4,0;2,0;;;;5,0;;;;;;3,0;;2,0;;2,0;;;;3,0;;;;;;;;;;;1,0;;1,0;;;;;;2,0;;;;;2,0;1,0;;;1,0;;;;;;5,0;;;10,0;;;1,0;5,0;;3,0;6,0;3,0;;1,0;18,0;6,0;6,0;;1,0;;;;;;2,0;;;;2,0;1,0;7,0;;3,0;;2,0;;;6,0;4,0;;;1,0;;36,0;;;;;;;2,0;;4,0;6,0;;;;;5,0;;1,0;1,0;;3,0;1,0;3,0;;5,0;;2,0;;2,0;3,0;;;;;1,0;;;5,0;;;;;3,0;;;;;;;;;;;;;;;;2,0;;;;1,0;;;;;;;;;;;;2,0;;;;;3,0;1,0;;;;;4,0;;;;;;;;;;3,0;;;2,0;;;;;2,0;;;;;;;;1,0;;6,0;2,0;;1,0;;;2,0;1,0;;;;2,0;;;;;2,0;;4,0;1,0;;;1,0;;2,0;1,0;;;;;;;;;;;;;;3,0;;;;;;;1,0;;;;2,0;;;;;4,0;;;;;;;;;;;;1,0;1,0;;;;;;;;1,0;;;;;2,0;;2,0;;;;;;;;;;17,0;;;;;2,0;;;;;;;;;;;;2,0;;;;;;;;;;2,0;;;;;2,0;3,0;;;;;;;;;;;;;;;;3,0;;;3,0;1,0;;;;;18,0;72,0;;;;;;;;;;;;;;;;;4,0;;;;;;;;;1,0;;;;;;;;;;;;;;1,0;;;;;;;;;;;;;;;;;;;;;;;1,0;;;;;;;;;;;;;;3,0;;;1,0;;;2,0;;;;2,0;;;;;;;;2,0;;1,0;;;;;;;;;;;;;;;;;;;;;18,0;2,0;;3,0;;;22,0;;5,0;;;;;;;;;;;1,0;;;;;;;;1,0;;;;2,0;;;;;;;;;;;;;;;;;;;;;;;;;;;;1,0;3,0;1,0;;6,0;;;;;;;;;;;;;;;1,0;;1,0;;;;;;;;1,0;;;;;;;3,0;;;4,0;;;;;;;;;;;;;;;;;;;;;;;;;;1,0;;;;;;;;;;;;;;;;;;
handheld;;12,0;;;;4,0;3,0;9,0;6,0;10,0;2,0;;3,0;;2,0;18,0;;1,0;;;1,0;22,0;;;;;1,0;2,0;;1,0;37,0;4,0;14,0;;17,0;27,0;;;;;45,0;2,0;9,0;2,0;3,0;;1,0;583,0;59,0;57,0;1,0;15,0;;;;;6,0;2,0;;5,0;1,0;1,0;;1,0;2,0;;;4,0;10,0;;13,0;8,0;15,0;;;;1,0;2,0;2,0;64,0;;14,0;1,0;34,0;2,0;3,0;;;;4,0;12,0;;;;9,0;;16,0;1,0;43,0;23,0;;11,0;12,0;21,0;;3,0;10,0;;31,0;4,0;;14,0;2,0;;;1,0;4,0;16,0;1,0;;3,0;;6,0;12,0;20,0;;;;3,0;13,0;;4,0;1,0;;;2,0;1,0;11,0;;;16,0;;2,0;13,0;3,0;;;2,0;12,0;1,0;;;2,0;8,0;1,0;;71,0;;2,0;;;8,0;32,0;;;;40,0;15,0;;6,0;1,0;;;3,0;;2,0;6,0;;;;;7,0;;2,0;2,0;2,0;;2,0;;;;;;7,0;;;1,0;;;1,0;;;;5,0;;;;;;6,0;;;;;;;;;;1,0;12,0;;;;;;1,0;;17,0;;12,0;;;13,0;2,0;1,0;2,0;1,0;;4,0;5,0;;1,0;2,0;;;;2,0;2,0;1,0;;1,0;;1,0;;;25,0;;;;;;8,0;12,0;;;;;2,0;;1,0;6,0;1,0;;3,0;;;4,0;4,0;5,0;;;12,0;1,0;;1,0;;1,0;;;2,0;;;;;;;;;;;3,0;7,0;;;;;;;;;2,0;;;;;;5,0;;2,0;;;;;;28,0;4,0;1,0;;;;;;;;1,0;23,0;;2,0;;;;1,0;7,0;2,0;1,0;;2,0;;4,0;;;1,0;;;3,0;3,0;13,0;54,0;;1,0;;;;;;;;;;1,0;;;;;;;1,0;1,0;;;;;;;;;;;13,0;;1,0;;6,0;1,0;;;;;;;1,0;;10,0;7,0;;;;;;;6,0;;;9,0;;;;;;;;6,0;;;;;;;5,0;;23,0;;;5,0;;;7,0;4,0;;;15,0;7,0;;;21,0;7,0;;20,0;;1,0;;;;2,0;3,0;7,0;;;;8,0;;1,0;;3,0;;2,0;;;6,0;;;;;20,0;2,0;;;2,0;19,0;2,0;;;;;;1,0;;2,0;1,0;;;;3,0;2,0;;;2,0;9,0;;;1,0;15,0;;21,0;;;;;;;10,0;4,0;8,0;;;;8,0;;;;3,0;;;;;3,0;;;;;;;1,0;;;13,0;2,0;1,0;;;;;;;;;;3,0;;;4,0;2,0;1,0;;1,0;;2,0;3,0;1,0;;5,0;;;2,0;13,0;;14,0;10,0;2,0;;;1,0;;2,0;3,0;;;;1,0;;;;;18,0;;2,0;1,0;;1,0;;;;;;;;;;;;;2,0;;;1,0;1,0;;;;;1,0;;;;;;;;;;1,0;;;;;2,0;;;;;;;4,0;5,0;;;;;2,0;;4,0;;;;;;;16,0;;;14,0;;;;3,0;;;2,0;;1,0;;;;;;;;;;;1,0;;;;;;;;;;3,0;;;;;;;;1,0;;;;;;1,0;;;4,0;;;;;;;;;;1,0;4,0;;;;;;;8,0;;;;;;;;;;;;;;;5,0;;;1,0;;;;2,0;3,0;2,0;;1,0;3,0;1,0;;;;;;;;;;;;;3,0;1,0;;;;;;;;;;;;;;;;;;;;;;;;;;;;;;2,0;;;;;;;;;;;;;10,0;;;;;;;;;61,0;;;;;;3,0;;1,0;;1,0;;;;;;;1,0;;;;;;;;1,0;3,0;;;;;;;;9,0;;;2,0;;;1,0;;5,0;;2,0;4,0;;4,0;;;;;1,0;;;5,0;;;;;;1,0;;;;;;;;;;;;;;;;;;;;;;;5,0;;;;;;;;;;;;;;1,0;;;;1,0;;;;;;;3,0;;;;;;;;;;;;;2,0;;;;;;;;;;;;;;;;;1,0;;;;;;;;;;;;;;;;;;;;;;;;;;;;;;;;;;;3,0;;5,0;;;;;;;;;;12,0;;;
head;;7,0;2,0;;;49,0;9,0;38,0;19,0;27,0;;;51,0;6,0;28,0;66,0;;;;;;60,0;1,0;;;;;1,0;;4,0;16,0;1,0;54,0;;93,0;20,0;;4,0;;;96,0;;9,0;20,0;88,0;9,0;48,0;104,0;14,0;51,0;19,0;11,0;;3,0;14,0;5,0;2,0;2,0;6,0;;18,0;;34,0;;;3,0;3,0;12,0;42,0;10,0;12,0;;19,0;;2,0;7,0;11,0;;5,0;180,0;3,0;14,0;;116,0;;3,0;;;5,0;13,0;20,0;;;6,0;5,0;4,0;6,0;;65,0;6,0;58,0;;53,0;3,0;1,0;10,0;19,0;2,0;32,0;6,0;8,0;5,0;;9,0;3,0;77,0;48,0;187,0;4,0;7,0;3,0;1,0;;12,0;21,0;5,0;;;;7,0;;15,0;29,0;4,0;4,0;;19,0;2,0;;;3,0;;5,0;37,0;1,0;;2,0;19,0;9,0;11,0;4,0;;6,0;7,0;50,0;11,0;73,0;;38,0;15,0;2,0;7,0;138,0;;1,0;;76,0;28,0;;;6,0;;;1,0;1,0;2,0;34,0;;;;5,0;20,0;;1,0;;5,0;;16,0;;;4,0;4,0;4,0;44,0;;;;;;7,0;5,0;;;15,0;;;;1,0;;11,0;;2,0;;1,0;9,0;;;;14,0;10,0;48,0;;2,0;;;150,0;;2,0;21,0;;12,0;;154,0;79,0;5,0;18,0;28,0;9,0;8,0;5,0;;5,0;4,0;6,0;2,0;;;;;13,0;35,0;;;1,0;;;37,0;4,0;;;;;16,0;22,0;;;1,0;2,0;;;4,0;4,0;5,0;;;4,0;3,0;76,0;2,0;7,0;10,0;;2,0;1,0;;2,0;;;2,0;;21,0;2,0;;;4,0;1,0;5,0;;;;2,0;4,0;58,0;2,0;8,0;3,0;;;1,0;;;7,0;1,0;;4,0;4,0;;11,0;;43,0;;7,0;5,0;11,0;2,0;2,0;4,0;;;;9,0;1,0;;;;;;;5,0;3,0;1,0;2,0;4,0;;;2,0;3,0;28,0;9,0;;;3,0;;;;22,0;13,0;58,0;;2,0;4,0;18,0;;1,0;;2,0;;;;;;6,0;;5,0;;3,0;5,0;4,0;13,0;17,0;14,0;3,0;1,0;17,0;;;;12,0;1,0;54,0;;5,0;7,0;;19,0;23,0;;4,0;3,0;;;;;13,0;5,0;;;1,0;;5,0;12,0;23,0;9,0;;15,0;;6,0;;;;;2,0;8,0;2,0;;6,0;;7,0;;;;7,0;10,0;;27,0;;;22,0;1,0;;5,0;3,0;13,0;;4,0;11,0;4,0;1,0;70,0;;3,0;;;;15,0;2,0;3,0;2,0;8,0;;2,0;;2,0;1,0;3,0;;;;1,0;36,0;3,0;;2,0;1,0;71,0;;17,0;1,0;6,0;;32,0;5,0;1,0;14,0;6,0;;;;2,0;6,0;;3,0;;3,0;;3,0;;;;1,0;17,0;;;;3,0;7,0;3,0;;2,0;6,0;;;4,0;;1,0;;2,0;;;;;;;;2,0;;3,0;22,0;;12,0;;11,0;;7,0;;7,0;2,0;9,0;;;;;2,0;;;2,0;;;;1,0;9,0;11,0;1,0;;;;2,0;;;13,0;;;;;;1,0;2,0;24,0;;;;;7,0;;;2,0;1,0;;;;;;;4,0;2,0;;;;14,0;;2,0;1,0;;2,0;2,0;;;1,0;5,0;;19,0;;4,0;;;2,0;1,0;1,0;12,0;1,0;1,0;6,0;;;;6,0;29,0;;;1,0;;1,0;;;;;10,0;13,0;7,0;;;2,0;;7,0;;;4,0;2,0;;2,0;;;2,0;;;;5,0;;15,0;;;4,0;2,0;5,0;32,0;4,0;;;;1,0;1,0;;13,0;1,0;1,0;;;3,0;;;22,0;;;;16,0;;;25,0;1,0;32,0;;;;1,0;;2,0;;6,0;2,0;;;;;;;3,0;;;8,0;;172,0;20,0;2,0;;5,0;4,0;16,0;;;18,0;;;;8,0;;;;7,0;;;;;1,0;21,0;;1,0;;;5,0;;;;4,0;;3,0;;2,0;;;;;;6,0;3,0;;;7,0;;;;;;;3,0;;;;24,0;13,0;;;;;1,0;;;2,0;1,0;;;;;;8,0;;;;1,0;8,0;1,0;;;;;;2,0;;;;2,0;;6,0;;10,0;;;;;1,0;;;;;;;;;;;5,0;;;;;1,0;2,0;;;8,0;;;;;;10,0;4,0;;;;;;;;;;7,0;4,0;13,0;;;;2,0;;;2,0;2,0;;;;;;;2,0;1,0;;1,0;;;;;;;1,0;1,0;;;3,0;1,0;;2,0;;1,0;;;;11,0;;2,0;;;2,0;;;;;;;;;;;1,0;;;;;;;;;;;1,0;;;4,0;;;;1,0;;;;;2,0;;24,0;;;4,0;;;12,0;4,0;2,0;9,0;;;;;;;;;;2,0;;9,0;;;;;;;;;;;;2,0;;;;1,0;;5,0;;;;;;;;;;;12,0;1,0;;;;;;;;;;8,0;3,0;;;73,0;;;;;;;1,0;;1,0;;;;2,0;;;;;
hinge;;1,0;;;;23,0;;20,0;;3,0;;;2,0;;13,0;34,0;;;;;;2,0;1,0;1,0;;;;;;;;2,0;11,0;;;;;9,0;;;1,0;4,0;3,0;;;;9,0;21,0;3,0;6,0;11,0;;;;1,0;11,0;9,0;;;;2,0;;1,0;;;;;14,0;8,0;2,0;;;;;;;;;;4,0;;3,0;;16,0;4,0;;;;;;8,0;;;2,0;;;;;6,0;1,0;;;36,0;;;;7,0;;;;8,0;;;;;2,0;62,0;48,0;;;;;;;;;;;;;;19,0;2,0;;;;;6,0;;;;;;2,0;;;;12,0;;1,0;;;;;1,0;;61,0;;;;;;14,0;;;;;3,0;;;;;;4,0;;;15,0;2,0;;;;29,0;;1,0;;;;;;;;;;63,0;;1,0;;;1,0;;;;;57,0;;19,0;;;;7,0;1,0;1,0;;;;;2,0;;;5,0;37,0;;20,0;;;;;;;;71,0;2,0;;71,0;5,0;2,0;4,0;7,0;2,0;14,0;;3,0;;;;;;;;3,0;28,0;;;;;;;;;;;2,0;3,0;1,0;;5,0;1,0;;;;;;;;;11,0;;51,0;;2,0;;;;;1,0;;;;;;2,0;1,0;;;3,0;;;;;;4,0;5,0;29,0;2,0;;;;5,0;7,0;;;4,0;;2,0;14,0;1,0;;5,0;;35,0;;;;;6,0;;2,0;;;;;4,0;;;1,0;;;;;4,0;2,0;;1,0;29,0;;5,0;4,0;7,0;6,0;;;3,0;;;;23,0;;4,0;1,0;1,0;;;2,0;;;;;2,0;4,0;;;1,0;;;;3,0;;5,0;42,0;10,0;;;;5,0;;;;;;24,0;;4,0;3,0;;;2,0;;;;;;;;1,0;;;;;;;4,0;;;;;;2,0;;;;;;;;;;;1,0;;;;;;;3,0;;;;;;3,0;;;;;;;;1,0;;1,0;;;;;;;;;;7,0;;;;;;;;;;;;;;4,0;;;;;;2,0;;;3,0;;;;;;1,0;;;;;;4,0;;;3,0;;27,0;;;1,0;;;;;;;;;;;;;;;1,0;;;;5,0;;;;1,0;;;;;1,0;;11,0;;;;;;;;2,0;;;;;;;;;;7,0;;;;11,0;;;66,0;;;2,0;5,0;14,0;;;;1,0;;;;;;5,0;;;1,0;;;;;1,0;;;;;;;;;;;;;5,0;;;;3,0;;15,0;;;;;;;1,0;;;;;6,0;;;;;;;;;;1,0;;;;4,0;;;;;;;;;;;;;;;;;;;;;;;;;;;3,0;;3,0;;7,0;4,0;1,0;;;;;;;;5,0;4,0;;4,0;;;;;;;3,0;7,0;;3,0;;1,0;;;9,0;;;2,0;;3,0;;5,0;;;2,0;1,0;;;;;;;;10,0;;;;;1,0;;;;10,0;;;;;;;1,0;;;;;2,0;;;;1,0;;;;;;;;;;;;;;1,0;;1,0;;;;;;;;;;;;;;;;;;;;;;;;;;;;;;1,0;;;;;;;;;;;;;;;;;;;;;;;;;;;;;;;;33,0;;;;;;;;;;;;;;;;;;;;;;;;;;;;;;2,0;;;;;;;;;;;;;;;;;;;;2,0;;;;;;;;;;;;1,0;;;;;;;;;;;1,0;;;;;;;;;;;;;;;;;;;;;;;;;27,0;;;;;;;;3,0;;;;;;;;;;;;;;;;;;;;;;;;16,0;;;;;;;;;;;;;;;;3,0;;;;;;;;;;;;;;;;;;;;;;;;;;;;;;;;;;;;;;;1,0;;;;;;;
hold;;5,0;;;;2,0;3,0;36,0;9,0;54,0;2,0;;20,0;;17,0;24,0;12,0;5,0;;;;14,0;1,0;;;2,0;3,0;4,0;1,0;;1,0;1,0;135,0;;59,0;5,0;14,0;47,0;;;39,0;;8,0;7,0;11,0;6,0;11,0;111,0;22,0;6,0;15,0;7,0;18,0;;43,0;;76,0;;2,0;12,0;21,0;4,0;10,0;;12,0;;35,0;22,0;53,0;9,0;11,0;;14,0;1,0;1,0;;5,0;1,0;;81,0;10,0;44,0;;92,0;2,0;28,0;21,0;;3,0;2,0;396,0;;14,0;6,0;2,0;8,0;24,0;;24,0;17,0;10,0;;31,0;16,0;5,0;3,0;76,0;4,0;95,0;3,0;;29,0;19,0;;1,0;81,0;128,0;86,0;45,0;28,0;;3,0;29,0;16,0;;2,0;1,0;;5,0;3,0;;4,0;26,0;;;;7,0;9,0;26,0;;4,0;;;19,0;9,0;;;37,0;129,0;11,0;;5,0;42,0;9,0;11,0;73,0;70,0;;6,0;15,0;7,0;6,0;220,0;;;;7,0;3,0;;;1,0;;9,0;2,0;1,0;5,0;28,0;58,0;3,0;;12,0;50,0;;3,0;41,0;88,0;;19,0;1,0;;3,0;;;33,0;4,0;112,0;;;1,0;26,0;3,0;1,0;14,0;24,0;;1,0;3,0;;;22,0;;1,0;4,0;3,0;4,0;;2,0;;;12,0;70,0;7,0;17,0;;;;1,0;;6,0;;234,0;3,0;2,0;31,0;42,0;2,0;3,0;19,0;1,0;8,0;1,0;;8,0;;4,0;;7,0;;41,0;3,0;33,0;;;4,0;;2,0;22,0;1,0;;;11,0;;11,0;10,0;;;3,0;3,0;18,0;;2,0;3,0;7,0;2,0;;21,0;2,0;10,0;19,0;30,0;13,0;;56,0;;2,0;26,0;;8,0;9,0;1,0;12,0;4,0;;;5,0;;1,0;2,0;33,0;2,0;4,0;5,0;20,0;1,0;3,0;2,0;12,0;4,0;5,0;;;22,0;1,0;1,0;8,0;;13,0;45,0;;16,0;2,0;;;4,0;16,0;;9,0;1,0;;3,0;6,0;10,0;2,0;;;;;23,0;;78,0;;;5,0;4,0;1,0;3,0;9,0;14,0;13,0;1,0;1,0;6,0;;18,0;;;9,0;6,0;1,0;1,0;;12,0;10,0;1,0;2,0;1,0;;4,0;4,0;;;;2,0;;1,0;;19,0;;5,0;1,0;2,0;5,0;1,0;13,0;1,0;3,0;;;;19,0;5,0;4,0;;1,0;;3,0;1,0;;;1,0;;;1,0;15,0;;;1,0;;3,0;;;4,0;1,0;1,0;1,0;;;;;;;;6,0;7,0;2,0;2,0;;6,0;;;;14,0;3,0;;3,0;;14,0;;5,0;;5,0;1,0;17,0;;;3,0;20,0;2,0;2,0;44,0;10,0;;;;;;1,0;;6,0;;1,0;;1,0;;1,0;;;1,0;1,0;1,0;;;;;18,0;1,0;11,0;;70,0;;5,0;27,0;;3,0;;21,0;;;3,0;;10,0;;;1,0;;;2,0;;1,0;;16,0;;;6,0;1,0;;4,0;;26,0;;;;1,0;;3,0;;1,0;;2,0;1,0;;;3,0;1,0;;;;1,0;;;;;1,0;;;1,0;;;;;;17,0;;;;4,0;;1,0;5,0;11,0;;5,0;;2,0;4,0;5,0;;;4,0;6,0;;1,0;1,0;4,0;7,0;;;4,0;;;3,0;;;;;1,0;3,0;;;;;;;;1,0;13,0;;20,0;7,0;;65,0;;;3,0;;4,0;;;;1,0;1,0;;2,0;;;2,0;;;;;;8,0;4,0;2,0;2,0;;;;;;3,0;;;;;;15,0;5,0;;;11,0;;;1,0;;;2,0;6,0;6,0;;6,0;10,0;1,0;;;;;6,0;;;;;;2,0;1,0;1,0;;1,0;;3,0;8,0;3,0;;;13,0;1,0;;;2,0;2,0;14,0;2,0;;;3,0;;;1,0;1,0;1,0;2,0;6,0;5,0;;14,0;2,0;3,0;4,0;21,0;;1,0;;;;;;1,0;2,0;6,0;;;;7,0;1,0;;;;1,0;9,0;1,0;;;;1,0;;1,0;;;9,0;;10,0;19,0;7,0;2,0;3,0;21,0;11,0;6,0;;;;;1,0;2,0;1,0;;;;2,0;80,0;;;3,0;2,0;6,0;11,0;1,0;;;;;;;;1,0;1,0;;1,0;;8,0;2,0;9,0;8,0;2,0;;;;11,0;;;8,0;;;;8,0;2,0;;;5,0;;2,0;;;;3,0;;2,0;;;3,0;;;12,0;1,0;3,0;1,0;;;;;;;;2,0;;;;;5,0;;2,0;;;;;;;1,0;;;;;5,0;;2,0;1,0;;1,0;;;;;;;;;;;;5,0;10,0;;;;;;7,0;;;10,0;;;1,0;;1,0;;;;;;;;;2,0;;;;;;5,0;;;;2,0;;;;1,0;;;;;;;;;;;;;;;2,0;;;;;;;;4,0;;;;;;6,0;;;;;;5,0;;;;1,0;1,0;;;;1,0;1,0;3,0;;1,0;;9,0;;;;;;;;;;1,0;;;;6,0;;;;1,0;;;;2,0;;;;;;2,0;;;;;2,0;;;;;;;;9,0;;;;;;;;;;;;;;;;;;;2,0;;;;;;;2,0;;;;;
holder;;26,0;;16,0;;6,0;5,0;46,0;7,0;32,0;7,0;;5,0;;43,0;82,0;;;;;;7,0;;6,0;3,0;;;1,0;;;;2,0;51,0;;2,0;;1,0;9,0;1,0;;;;36,0;1,0;;1,0;1,0;69,0;5,0;4,0;96,0;7,0;;;57,0;8,0;67,0;;;;22,0;16,0;1,0;;63,0;2,0;6,0;126,0;80,0;21,0;5,0;;4,0;1,0;;2,0;;;;118,0;15,0;21,0;;178,0;5,0;;;;16,0;3,0;1239,0;;;12,0;2,0;;2,0;;38,0;41,0;1,0;;365,0;16,0;;8,0;82,0;1,0;;;6,0;4,0;37,0;;;41,0;143,0;95,0;2,0;3,0;6,0;5,0;2,0;;2,0;;;;;;;13,0;47,0;;;;9,0;1,0;;1,0;2,0;1,0;;123,0;1,0;;;97,0;10,0;4,0;;3,0;18,0;3,0;;2,0;36,0;;1,0;4,0;;;91,0;;;;24,0;3,0;;1,0;3,0;;48,0;10,0;1,0;9,0;70,0;186,0;;;78,0;69,0;14,0;2,0;;48,0;4,0;10,0;11,0;;5,0;;;53,0;3,0;35,0;;;1,0;26,0;19,0;2,0;;155,0;1,0;39,0;4,0;;;38,0;1,0;6,0;15,0;;9,0;6,0;36,0;4,0;9,0;67,0;84,0;3,0;94,0;3,0;;;4,0;8,0;18,0;13,0;246,0;35,0;2,0;112,0;28,0;33,0;61,0;59,0;27,0;47,0;;;2,0;6,0;;;;;;15,0;95,0;;16,0;5,0;4,0;;136,0;22,0;;;8,0;1,0;10,0;;;3,0;25,0;10,0;5,0;;7,0;1,0;36,0;16,0;;45,0;;17,0;81,0;269,0;1,0;;32,0;;4,0;1,0;1,0;3,0;60,0;12,0;4,0;7,0;;;57,0;;;;44,0;13,0;21,0;10,0;92,0;1,0;6,0;;1,0;2,0;55,0;;;6,0;6,0;9,0;3,0;11,0;2,0;;;91,0;3,0;3,0;26,0;10,0;59,0;;23,0;5,0;;10,0;10,0;7,0;;;;;5,0;105,0;78,0;;7,0;2,0;20,0;2,0;5,0;8,0;31,0;;5,0;6,0;6,0;5,0;;6,0;13,0;13,0;1,0;6,0;1,0;;;3,0;2,0;19,0;44,0;5,0;;21,0;12,0;;2,0;9,0;6,0;;24,0;4,0;50,0;9,0;14,0;6,0;18,0;1,0;;5,0;3,0;;5,0;4,0;;148,0;11,0;;4,0;17,0;24,0;3,0;;;2,0;1,0;;;;1,0;;;;1,0;2,0;;1,0;;;;;1,0;;;;;;3,0;;;;;;3,0;;;;1,0;2,0;;8,0;;;;;;;2,0;41,0;;;2,0;;;;;;;;;;;1,0;;;;2,0;;;;;2,0;;;;1,0;;;3,0;;12,0;;;;3,0;6,0;15,0;3,0;;9,0;;;;;2,0;;;;;;;2,0;;;;;7,0;;;;;;5,0;;;;;3,0;;;;;12,0;;;;;;7,0;9,0;;;;3,0;;;;;2,0;4,0;;;;;;;;28,0;;1,0;;;;;;;;3,0;;;;7,0;;2,0;7,0;3,0;2,0;4,0;;;1,0;;1,0;1,0;;;1,0;;3,0;;1,0;7,0;2,0;;;;;3,0;;1,0;;;;;;;;;;16,0;23,0;4,0;;;1,0;;13,0;;1,0;;;1,0;;;;;1,0;;4,0;1,0;;;;1,0;;;;;1,0;;;12,0;6,0;;13,0;;;;;6,0;;;;1,0;;;;;;;;;;7,0;;;;;;22,0;10,0;34,0;;2,0;;1,0;3,0;;;1,0;;7,0;4,0;6,0;;;4,0;6,0;1,0;1,0;3,0;12,0;;;6,0;5,0;;;3,0;4,0;5,0;4,0;;;;13,0;3,0;4,0;1,0;;;1,0;;;15,0;;;;;;6,0;2,0;;;2,0;22,0;3,0;;;42,0;;3,0;;1,0;1,0;9,0;2,0;1,0;;5,0;5,0;41,0;2,0;;3,0;;;;2,0;;9,0;;18,0;10,0;;16,0;;7,0;;7,0;;12,0;5,0;;1,0;;;;;;;2,0;;;2,0;;;;;;;;;;;;;8,0;;;;;;;;3,0;;;;;;;1,0;;;;;1,0;;1,0;;;;;;1,0;;;;;;;1,0;;;7,0;;;;;;;;;;;;;;;;;;;;;;;1,0;2,0;1,0;;5,0;4,0;;;;;2,0;;1,0;;;;;;;;;;;;;;;;;;;;;;;;;3,0;;;;;;1,0;;;;1,0;3,0;;;;1,0;;;;;;;;;;;2,0;;;;;;;2,0;;;1,0;5,0;4,0;;;;;6,0;6,0;;;;;1,0;3,0;;;16,0;;6,0;1,0;;;;;;;;;;;;10,0;;;;;;;;1,0;;;;11,0;;;;6,0;1,0;;1,0;;;;;;1,0;;;;;;4,0;;;;;4,0;;;;;;1,0;;;;;;;;;;;;;;;;;;;;
hole;;8,0;;;;19,0;16,0;45,0;22,0;73,0;6,0;;16,0;;59,0;103,0;22,0;1,0;;;;6,0;1,0;1,0;1,0;;2,0;;2,0;;;2,0;39,0;;25,0;5,0;;1,0;3,0;3,0;2,0;;323,0;2,0;2,0;;5,0;90,0;5,0;10,0;92,0;17,0;;7,0;7,0;25,0;19,0;;;;133,0;9,0;6,0;;16,0;;15,0;343,0;113,0;29,0;11,0;2,0;1,0;;;6,0;18,0;3,0;;91,0;1,0;10,0;1,0;140,0;3,0;;;;5,0;11,0;284,0;;;20,0;2,0;1,0;2,0;;46,0;13,0;;;151,0;;8,0;3,0;34,0;3,0;6,0;;130,0;4,0;12,0;;;241,0;244,0;225,0;1,0;22,0;11,0;;1,0;1,0;;;;7,0;1,0;;;;5,0;9,0;;;28,0;8,0;4,0;;;2,0;;42,0;1,0;;8,0;129,0;20,0;14,0;1,0;1,0;6,0;6,0;;1,0;4,0;;3,0;12,0;;12,0;81,0;;;;3,0;15,0;;;2,0;6,0;25,0;43,0;5,0;9,0;70,0;56,0;6,0;;69,0;84,0;10,0;11,0;3,0;30,0;1,0;;;;1,0;;6,0;97,0;4,0;26,0;;;;114,0;29,0;1,0;1,0;63,0;;41,0;;;;41,0;12,0;1,0;7,0;1,0;2,0;;32,0;16,0;2,0;;99,0;11,0;59,0;30,0;;11,0;46,0;15,0;120,0;6,0;193,0;12,0;4,0;242,0;53,0;11,0;18,0;79,0;58,0;42,0;4,0;42,0;11,0;3,0;1,0;;;1,0;10,0;4,0;111,0;;62,0;5,0;11,0;;475,0;2,0;;2,0;13,0;4,0;55,0;3,0;12,0;;47,0;49,0;6,0;2,0;20,0;4,0;77,0;26,0;;74,0;;32,0;77,0;287,0;2,0;;20,0;6,0;3,0;14,0;;;;31,0;;4,0;;3,0;58,0;;1,0;;65,0;2,0;23,0;28,0;24,0;9,0;3,0;11,0;2,0;37,0;58,0;13,0;;47,0;19,0;17,0;9,0;5,0;;59,0;;61,0;;6,0;51,0;9,0;5,0;1,0;104,0;63,0;;7,0;14,0;31,0;24,0;;;2,0;4,0;132,0;12,0;67,0;40,0;7,0;162,0;4,0;8,0;2,0;100,0;16,0;8,0;17,0;17,0;10,0;;5,0;10,0;35,0;3,0;5,0;22,0;1,0;4,0;16,0;4,0;31,0;75,0;;;13,0;56,0;;;8,0;3,0;;22,0;;38,0;7,0;36,0;18,0;104,0;4,0;12,0;113,0;6,0;;51,0;11,0;;89,0;32,0;;;11,0;83,0;13,0;;;24,0;1,0;;;18,0;13,0;;;;4,0;;9,0;2,0;1,0;;;;;;;1,0;;;2,0;3,0;;;;;2,0;;;;;;5,0;9,0;;3,0;3,0;;;2,0;;15,0;;;3,0;14,0;;3,0;;11,0;;;;;;;;;;3,0;2,0;4,0;;;9,0;;1,0;;;;;17,0;;1,0;;;;3,0;;57,0;109,0;;60,0;;;;;5,0;7,0;14,0;1,0;;;;;1,0;;6,0;;12,0;1,0;6,0;;2,0;;36,0;;;;2,0;5,0;;;;;4,0;;2,0;3,0;;;14,0;13,0;;;;;;;;;12,0;17,0;;35,0;;;;1,0;;31,0;;1,0;;;;;;;;7,0;1,0;;;;;;41,0;;;1,0;;2,0;17,0;;59,0;13,0;;;5,0;;;2,0;3,0;1,0;4,0;1,0;;;;3,0;;;11,0;;;;7,0;;;;;11,0;16,0;;2,0;;;;60,0;;;;;3,0;;5,0;;;;;29,0;2,0;;;;;;;;;3,0;;;;28,0;2,0;5,0;2,0;;;;9,0;;;;30,0;;6,0;;;5,0;;;;;9,0;2,0;6,0;;;1,0;21,0;;13,0;2,0;;11,0;12,0;2,0;;;;;13,0;7,0;2,0;1,0;3,0;4,0;51,0;2,0;;;2,0;;24,0;3,0;3,0;;;10,0;5,0;8,0;14,0;;6,0;1,0;3,0;;;;;;4,0;3,0;1,0;10,0;2,0;;;3,0;;18,0;;;;;9,0;;;;70,0;;;;;15,0;;;2,0;10,0;57,0;1,0;18,0;35,0;;3,0;14,0;3,0;;2,0;;;;1,0;42,0;;5,0;;10,0;;2,0;4,0;28,0;;1,0;5,0;;1,0;;;23,0;4,0;1,0;;2,0;5,0;5,0;11,0;;;3,0;;;;1,0;;;;36,0;;;;9,0;;4,0;;;;1,0;;;;;;;;;;;10,0;;;;;;7,0;;;;;6,0;;1,0;;4,0;;;8,0;;;;2,0;;;;7,0;;;;;;;;1,0;;;;;2,0;2,0;;;;;5,0;2,0;;;;;1,0;;;;1,0;;5,0;;;;;;;;;;;;;;;;;;;;4,0;;;1,0;;8,0;5,0;;;;;10,0;13,0;;;;;;11,0;;;1,0;;;1,0;;;;;;3,0;3,0;;2,0;;;1,0;2,0;41,0;;5,0;;;3,0;1,0;;;;1,0;;;;;8,0;;1,0;1,0;;;;;1,0;;;;4,0;;;8,0;;;;;;14,0;1,0;4,0;;;1,0;25,0;;11,0;7,0;16,0;;;;3,0;;;;;3,0;;;;;;;2,0;;;;6,0;;;;;1,0;;;;6,0;;;1,0;;;;;;;;;;;;;;
hook;;1,0;;;;;;;;;;;;;;22,0;;;;;;;;;1,0;;;;;;;1,0;2,0;;5,0;;;;;;;1,0;1,0;;;;;5,0;;1,0;6,0;1,0;;;16,0;;5,0;;;;1,0;;;;;;;4,0;;;;;;;;2,0;;;;;;;;15,0;;;;;;;3,0;;;21,0;;;;;;;;;4,0;;;;;2,0;;;;;;;;;37,0;9,0;;2,0;;;;;;;;;;;;;;;;;;;;;;;;;;;;4,0;;;;;;;;;6,0;;;;;;11,0;;;;2,0;;;;;;2,0;;;;17,0;;1,0;;2,0;10,0;;;9,0;;;1,0;;;;1,0;;9,0;;2,0;;;;;;;;3,0;;6,0;;;4,0;;;;;;;;1,0;;;8,0;8,0;;;;;4,0;;6,0;1,0;;85,0;;;11,0;;;;7,0;;7,0;;1,0;;;;;;;;;;;;;;;11,0;;;;;;2,0;;;;16,0;;2,0;;;;1,0;;;9,0;4,0;5,0;;8,0;;;;;;5,0;;;;;;8,0;;;6,0;;;;4,0;;;;16,0;;;;;;4,0;;;1,0;;;10,0;;;3,0;;2,0;;7,0;;2,0;13,0;;14,0;33,0;;;1,0;4,0;2,0;;3,0;;;;14,0;5,0;10,0;;8,0;;;;8,0;;;;;;;;;3,0;;;2,0;1,0;;1,0;;6,0;;;;;;;;13,0;3,0;;;;6,0;;;;;;;6,0;;;;;;3,0;;;;;;;;;;;;;;;;;;;;;;;;;;;;;;;;;;;;;;;;;;;;2,0;;;;;;;5,0;;7,0;;;22,0;8,0;;;;;;;;;;;;;;;;;;;;;;;1,0;;;;;1,0;;;;;;;;;4,0;;;;;;;;;;;;;;;1,0;;1,0;;;;;;22,0;;;;;;;;;;;;;;;;;;;;;;;;;;;4,0;;4,0;;;;;;14,0;;;;;;;;;;3,0;;;;2,0;;;4,0;4,0;;;;;;;;;;;;;;;;3,0;;;;;;;;;;;;;10,0;;;;;;;;;;;;2,0;;;;;;;;;;;;19,0;;;;;;;;;;;;;;;;;;;;;;;;;;;;;;;;;;;;;;;;;2,0;2,0;1,0;;;;7,0;2,0;;;4,0;;;;;;;2,0;2,0;;;;;;1,0;;;;;;;;;;3,0;4,0;;38,0;;1,0;;;;;;;;;;1,0;;2,0;;;;;1,0;;;;1,0;;;;;8,0;;;;;;3,0;;;;;;;;;;;;;;;2,0;;;;;;;7,0;;;;;;;;;;;;1,0;;;;;;;;;1,0;;;;;;;;;;;;;;;;;;;;;;;;;;;;;;;;;;;;;;;;;;;;;;;;;;2,0;;;;;;;;;;;;;;;;;;;;;;;;;;;;;;;;;;;;;;1,0;;2,0;;;;;;;;;;;;;;;;4,0;;;;;;;;;;;;;;;;;;;;;;;;;;;;;;;;;;;;;;;;;;;;;;;;;;;;;;;;;;;;;;;;;;;;;;;;;;;;;;;;;;;;;;;;;;;;;;;;;;;;;;;;;;;;;;;;;;;;;;;;;;;;;;
horizontal;;3,0;;;;112,0;3,0;12,0;12,0;67,0;9,0;;6,0;;143,0;28,0;5,0;;5,0;;11,0;6,0;2,0;19,0;;2,0;73,0;19,0;;1,0;3,0;2,0;33,0;;15,0;1,0;;39,0;;1,0;39,0;1,0;25,0;4,0;29,0;9,0;18,0;44,0;16,0;25,0;29,0;59,0;7,0;3,0;13,0;39,0;16,0;;24,0;;34,0;1,0;13,0;;27,0;12,0;1,0;29,0;36,0;2,0;3,0;1,0;6,0;4,0;;14,0;10,0;;2,0;202,0;;18,0;;76,0;7,0;;;;3,0;23,0;31,0;1,0;;;1,0;3,0;1,0;;75,0;1,0;4,0;3,0;25,0;24,0;2,0;2,0;31,0;;22,0;29,0;5,0;31,0;;;;41,0;68,0;82,0;5,0;8,0;;;2,0;7,0;6,0;;;;;6,0;;75,0;33,0;;19,0;39,0;22,0;5,0;25,0;;2,0;;4,0;46,0;2,0;;;27,0;82,0;15,0;5,0;;7,0;3,0;;3,0;51,0;;18,0;283,0;3,0;4,0;179,0;;;;13,0;18,0;;;3,0;;2,0;11,0;10,0;16,0;7,0;;2,0;9,0;8,0;5,0;;;41,0;49,0;3,0;68,0;2,0;;1,0;;;39,0;1,0;;;;;8,0;;;6,0;367,0;6,0;2,0;;;5,0;5,0;11,0;1,0;1,0;;;9,0;5,0;;10,0;14,0;11,0;2,0;1,0;;7,0;;;;8,0;;15,0;;1,0;31,0;1,0;22,0;6,0;3,0;2,0;4,0;3,0;12,0;;;6,0;;12,0;6,0;221,0;101,0;23,0;13,0;4,0;;3,0;2,0;11,0;2,0;;;;;1,0;19,0;;;6,0;9,0;5,0;;3,0;3,0;6,0;1,0;;7,0;;9,0;3,0;31,0;4,0;16,0;3,0;;5,0;20,0;19,0;6,0;;;16,0;336,0;5,0;;7,0;;7,0;;3,0;;4,0;9,0;20,0;;2,0;;;3,0;13,0;8,0;;7,0;5,0;;;16,0;;;;4,0;;;;;13,0;2,0;7,0;;1,0;;;6,0;;;;;9,0;5,0;2,0;4,0;;4,0;1,0;1,0;;;9,0;2,0;37,0;24,0;1,0;49,0;;;;8,0;5,0;55,0;3,0;5,0;;13,0;;1,0;1,0;;;8,0;1,0;2,0;;2,0;;;;;;7,0;16,0;36,0;1,0;;22,0;4,0;;43,0;;;2,0;33,0;;29,0;1,0;1,0;;;1,0;11,0;5,0;;;;;2,0;;2,0;;1,0;1,0;36,0;4,0;1,0;1,0;;4,0;;;;1,0;;;1,0;1,0;;;;2,0;10,0;6,0;1,0;;24,0;5,0;8,0;16,0;1,0;;16,0;11,0;;1,0;33,0;11,0;;;2,0;10,0;2,0;54,0;46,0;;4,0;6,0;3,0;2,0;8,0;;;12,0;9,0;1,0;;;5,0;1,0;2,0;;5,0;;2,0;;;1,0;1,0;20,0;;36,0;1,0;17,0;;7,0;9,0;6,0;13,0;13,0;17,0;19,0;3,0;1,0;8,0;2,0;1,0;;1,0;5,0;5,0;;;2,0;3,0;;;;3,0;16,0;;34,0;;17,0;;5,0;2,0;4,0;;;;2,0;;3,0;;;;;3,0;10,0;;;;1,0;;;8,0;5,0;2,0;;;3,0;3,0;;5,0;1,0;;;;;1,0;16,0;;;7,0;;2,0;;1,0;;5,0;;;10,0;1,0;;5,0;;;5,0;;;;;;12,0;;;;;7,0;;;;;7,0;;;;1,0;;;;4,0;2,0;;;1,0;3,0;3,0;;;;11,0;;8,0;;;;;1,0;;2,0;20,0;;2,0;;;;;;;;;1,0;8,0;;2,0;;3,0;1,0;10,0;13,0;;;3,0;;;;;;2,0;;;;;;;1,0;1,0;;3,0;5,0;;;;;;2,0;4,0;;1,0;5,0;1,0;4,0;9,0;5,0;3,0;1,0;21,0;;;15,0;;;;1,0;;;;;3,0;;2,0;;;2,0;2,0;9,0;;;;6,0;;;;1,0;1,0;2,0;;5,0;7,0;;;;;;;;;4,0;1,0;11,0;;;1,0;;;18,0;;;;;;;;2,0;;;;;3,0;;;1,0;;;15,0;;;;1,0;;;2,0;;;;1,0;;;2,0;4,0;;;;;;;2,0;10,0;;;10,0;2,0;;;;;;;;10,0;;;;64,0;11,0;3,0;1,0;4,0;;5,0;;9,0;;;;;;1,0;17,0;;2,0;;1,0;;2,0;;1,0;6,0;;;8,0;;6,0;;;;;;;1,0;2,0;2,0;;6,0;;3,0;;;5,0;;;;4,0;;;3,0;;;;;;2,0;;;;;;;;;;;3,0;;;;;;;;;;;;;;;;;;;;;;;;3,0;4,0;;;;4,0;;;;;1,0;3,0;;;;;;;4,0;;;;;1,0;;1,0;1,0;19,0;;;;;;;;3,0;;;1,0;;12,0;1,0;;;;4,0;;;;;1,0;;4,0;;3,0;3,0;;;;4,0;;;;;;2,0;;;;1,0;3,0;;;;2,0;;;1,0;;;;2,0;;;;1,0;;;;1,0;;1,0;2,0;;;;;;1,0;;;2,0;;;;9,0;;6,0;;4,0;;;;;;3,0;1,0;;;2,0;;;;2,0;;;;;;;1,0;;;;;
host;;2,0;;;;;1,0;9,0;1,0;;;;2,0;;;8,0;;;;;2,0;11,0;1,0;;;;;4,0;;;43,0;;12,0;;41,0;6,0;;;1,0;;20,0;;;;5,0;1,0;7,0;114,0;18,0;14,0;;9,0;;;;;1,0;;;1,0;;1,0;;;;;;;9,0;;3,0;;7,0;;;;;;;59,0;;7,0;3,0;10,0;;2,0;;;13,0;;;;;;;;3,0;3,0;36,0;2,0;;;15,0;5,0;;;1,0;1,0;2,0;;4,0;;2,0;;;9,0;;6,0;2,0;;;;1,0;3,0;3,0;;;;;;;1,0;2,0;;;;;2,0;;;1,0;;1,0;11,0;;;;1,0;29,0;;;;5,0;5,0;;;62,0;;;9,0;1,0;10,0;15,0;;;;10,0;1,0;;;;;;2,0;;;;;3,0;;3,0;;;;;5,0;;3,0;;;4,0;;;11,0;;1,0;;;;;;;;1,0;;;;;1,0;;;;;;;;;;;;;;;;;;;;1,0;1,0;;;1,0;2,0;;;;;;;;;;1,0;;;;1,0;;;;;4,0;;;;21,0;;;;;;;2,0;;;;;;;;;3,0;;;;1,0;;2,0;1,0;2,0;4,0;1,0;;;;;1,0;;;52,0;4,0;;1,0;;;;;;;;;;;;;;;;;;;;;;;;;;10,0;;;;;;;;1,0;;1,0;;;;;;;;;;;;;;2,0;;;;;1,0;;;;;;;;1,0;1,0;;;;;;;;;;1,0;;;;4,0;;6,0;;;;;;;;;1,0;;;;;;;;;;;;;;;;;;;;1,0;;;;;;;1,0;5,0;3,0;;1,0;41,0;;;;;;;;;;;7,0;;;;;;1,0;1,0;;3,0;;;;16,0;;;28,0;3,0;;11,0;14,0;13,0;1,0;;3,0;;;;;1,0;1,0;14,0;;;;;1,0;;2,0;;;;;;;;;;;6,0;;;;;;2,0;;;;;;;;;;;;;1,0;;12,0;1,0;;13,0;;;;;;11,0;1,0;;;;;4,0;1,0;;;4,0;;;;;;;;;;;1,0;;2,0;;;;;6,0;4,0;;;;;4,0;1,0;;;;;;;;2,0;;1,0;4,0;;;;;;;;;4,0;;;;;;10,0;3,0;5,0;;;1,0;;1,0;;;3,0;;;6,0;;4,0;;;1,0;;;;;;;;;;;1,0;1,0;10,0;;;;3,0;;1,0;;;;;;;;;;;;;;;;7,0;;;;;;;;;;;;;;;;1,0;1,0;10,0;;15,0;;1,0;;;;;;14,0;;;;;2,0;;;1,0;;;;;;;;;;;;;;;;3,0;;;1,0;;;;;;;;;;;;2,0;1,0;2,0;;;;;;;;;;;;;;;;;;;;;;;;;;;;;;;;;;;;;;;1,0;;;;;;;;;;;;;;2,0;;;;;;;;;;;;;;1,0;;;;;;;;;;2,0;;;;;;;;;;;;;;;;;;;;;1,0;;;;;;;;;;;;;;;;;;;;;;;;;;;;;;;;;;;;;;;;;;;;;;;;;;;;;;;;;;1,0;;;1,0;;;;;;;;;;;;;;;;;;;;;;;;;;;;;;;;;;;;;;;;;;;2,0;;;;;;;;;;;;;;1,0;;;;;;;;;;;;;;;;;;;;;;;;;;;;;1,0;;;;;;;;;;;;;;1,0;;;;;;;;;;;;;;;;;;2,0;;;;;;;;;;;;;;;;;;;;;;;;;;;;;;;8,0;;;3,0;
house;;28,0;2,0;1,0;5,0;39,0;50,0;142,0;47,0;102,0;16,0;;13,0;;157,0;194,0;11,0;5,0;;;;97,0;2,0;41,0;1,0;;13,0;4,0;24,0;;23,0;1,0;320,0;;86,0;40,0;2,0;12,0;1,0;1,0;22,0;;191,0;8,0;11,0;13,0;7,0;500,0;84,0;104,0;371,0;18,0;;;68,0;59,0;270,0;;;;180,0;87,0;31,0;;30,0;9,0;17,0;334,0;85,0;407,0;21,0;24,0;25,0;;;21,0;;4,0;48,0;415,0;23,0;154,0;;609,0;3,0;;2,0;;18,0;9,0;932,0;;;67,0;5,0;3,0;20,0;;108,0;34,0;7,0;3,0;530,0;37,0;29,0;14,0;361,0;2,0;29,0;;66,0;12,0;11,0;;;163,0;794,0;329,0;40,0;11,0;20,0;1,0;6,0;23,0;33,0;2,0;2,0;;50,0;5,0;;11,0;97,0;17,0;;;10,0;1,0;;;9,0;15,0;1,0;283,0;;;6,0;356,0;40,0;13,0;13,0;3,0;24,0;13,0;12,0;14,0;327,0;2,0;20,0;3,0;;12,0;293,0;;3,0;2,0;106,0;58,0;10,0;3,0;16,0;14,0;32,0;23,0;11,0;17,0;378,0;219,0;8,0;;75,0;183,0;23,0;68,0;12,0;112,0;21,0;180,0;1,0;;7,0;11,0;4,0;239,0;8,0;61,0;;3,0;20,0;297,0;33,0;2,0;;80,0;27,0;12,0;1,0;7,0;7,0;153,0;10,0;15,0;26,0;4,0;17,0;;37,0;31,0;9,0;99,0;;3,0;165,0;19,0;3,0;214,0;11,0;5,0;239,0;12,0;492,0;63,0;234,0;595,0;54,0;72,0;53,0;258,0;47,0;233,0;11,0;72,0;41,0;25,0;4,0;;;1,0;;28,0;127,0;1,0;16,0;13,0;9,0;;285,0;20,0;32,0;;8,0;;152,0;13,0;1,0;6,0;59,0;74,0;21,0;;35,0;126,0;94,0;1,0;;38,0;;172,0;159,0;497,0;15,0;;18,0;3,0;10,0;6,0;6,0;;11,0;29,0;89,0;13,0;6,0;4,0;301,0;12,0;;32,0;20,0;6,0;94,0;38,0;253,0;3,0;46,0;18,0;47,0;27,0;165,0;1,0;7,0;108,0;17,0;2,0;65,0;11,0;48,0;109,0;3,0;311,0;6,0;27,0;9,0;30,0;44,0;7,0;51,0;14,0;;28,0;9,0;75,0;18,0;2,0;9,0;;21,0;62,0;70,0;84,0;45,0;3,0;21,0;69,0;10,0;1,0;51,0;39,0;35,0;7,0;7,0;15,0;;34,0;9,0;59,0;9,0;12,0;65,0;8,0;4,0;21,0;60,0;46,0;24,0;17,0;8,0;186,0;51,0;3,0;3,0;3,0;31,0;;7,0;6,0;33,0;16,0;57,0;43,0;31,0;17,0;3,0;78,0;3,0;;31,0;23,0;2,0;258,0;29,0;2,0;1,0;24,0;42,0;15,0;3,0;7,0;76,0;;;1,0;6,0;65,0;11,0;1,0;;1,0;3,0;2,0;13,0;8,0;;1,0;;2,0;10,0;;1,0;;;2,0;66,0;;;;2,0;26,0;;;;13,0;2,0;2,0;19,0;;2,0;;6,0;;17,0;31,0;40,0;;6,0;18,0;15,0;;30,0;1,0;14,0;;;;2,0;14,0;5,0;;;;16,0;5,0;1,0;;3,0;21,0;;;2,0;6,0;6,0;4,0;2,0;;21,0;;;;3,0;4,0;42,0;50,0;;11,0;;;;;9,0;;1,0;8,0;;3,0;2,0;25,0;12,0;5,0;29,0;;102,0;19,0;9,0;5,0;4,0;;2,0;6,0;1,0;;;21,0;1,0;4,0;;;1,0;2,0;2,0;2,0;12,0;4,0;18,0;40,0;7,0;;8,0;19,0;;55,0;;;24,0;30,0;;21,0;3,0;2,0;;10,0;;58,0;2,0;;;2,0;5,0;3,0;21,0;2,0;;8,0;23,0;;1,0;11,0;3,0;78,0;72,0;36,0;;47,0;5,0;1,0;4,0;;7,0;53,0;4,0;2,0;9,0;;21,0;57,0;19,0;12,0;82,0;19,0;5,0;3,0;;62,0;;1,0;41,0;;;;12,0;;;;;137,0;69,0;1,0;;1,0;;1,0;197,0;;3,0;;;;1,0;9,0;;;23,0;2,0;35,0;1,0;41,0;;1,0;8,0;1,0;;;2,0;5,0;1,0;;48,0;39,0;;20,0;;;;;23,0;2,0;;1,0;40,0;;;;2,0;37,0;;1,0;;;35,0;1,0;4,0;1,0;12,0;;57,0;22,0;75,0;6,0;1,0;19,0;24,0;6,0;;2,0;2,0;;11,0;9,0;21,0;22,0;1,0;8,0;24,0;1,0;2,0;;21,0;3,0;2,0;40,0;20,0;4,0;7,0;48,0;37,0;8,0;11,0;;;14,0;9,0;2,0;1,0;;;1,0;15,0;9,0;;36,0;15,0;92,0;3,0;9,0;2,0;20,0;22,0;2,0;;;47,0;7,0;;;134,0;;8,0;7,0;;2,0;4,0;9,0;14,0;25,0;3,0;3,0;56,0;31,0;6,0;9,0;9,0;;;3,0;;12,0;;30,0;74,0;1,0;7,0;;1,0;10,0;10,0;91,0;28,0;2,0;;33,0;;4,0;;;106,0;5,0;22,0;12,0;3,0;2,0;;;;;;;4,0;;2,0;6,0;3,0;1,0;7,0;;;;4,0;;13,0;;1,0;;2,0;1,0;;5,0;1,0;;;;;;;;5,0;;;3,0;;29,0;1,0;;;;;;1,0;2,0;1,0;;7,0;;3,0;;;1,0;;1,0;;1,0;;3,0;;9,0;;1,0;;15,0;;;13,0;;1,0;7,0;1,0;;5,0;9,0;6,0;2,0;;8,0;;17,0;6,0;1,0;2,0;26,0;;;2,0;;;;;2,0;;;2,0;1,0;;1,0;;3,0;;;1,0;;;;;;11,0;;;8,0;15,0;;6,0;;1,0;1,0;27,0;;;4,0;;;;3,0;;;;1,0;5,0;;;;;2,0;24,0;4,0;;14,0;1,0;2,0;4,0;7,0;3,0;;6,0;;;7,0;20,0;3,0;;1,0;10,0;1,0;4,0;;;3,0;1,0;27,0;1,0;;;;;1,0;;3,0;;;5,0;1,0;1,0;;;;;27,0;;;;;;2,0;11,0;;4,0;1,0;6,0;8,0;;4,0;1,0;;;;;15,0;;5,0;;;;6,0;;2,0;;;26,0;;;;11,0;;;;;;;;;4,0;;;;;;2,0;3,0;;;;;;
identification;;20,0;;1,0;7,0;5,0;;27,0;15,0;1,0;;;48,0;7,0;;52,0;;;;;7,0;9,0;;;;;7,0;1,0;;;9,0;;78,0;;14,0;1,0;1,0;15,0;4,0;;103,0;;5,0;;11,0;4,0;47,0;130,0;39,0;6,0;1,0;4,0;5,0;;;;8,0;;3,0;;;9,0;4,0;3,0;;1,0;;10,0;8,0;;2,0;;24,0;;1,0;2,0;92,0;;;108,0;;20,0;2,0;51,0;;13,0;12,0;1,0;;;30,0;6,0;5,0;;;5,0;4,0;3,0;30,0;10,0;16,0;1,0;17,0;113,0;;7,0;6,0;;5,0;7,0;;6,0;;;2,0;20,0;15,0;18,0;1,0;4,0;4,0;;6,0;15,0;8,0;1,0;2,0;;;;3,0;3,0;;;;26,0;5,0;28,0;;;14,0;2,0;3,0;5,0;1,0;;;2,0;14,0;;8,0;;24,0;28,0;10,0;2,0;34,0;;;3,0;;30,0;119,0;;;;15,0;1,0;;;1,0;;;;;1,0;;;;;;15,0;;;;;;;;;;;;6,0;;2,0;2,0;;;;;;7,0;;;;;;1,0;8,0;;;;;;;;;;;;;;1,0;;;;;26,0;;;;;14,0;;;;;;;1,0;;1,0;;;;;20,0;1,0;;;;;;;;74,0;;;;;;;4,0;;;;;;;;30,0;;;;;21,0;;;8,0;6,0;;10,0;;;43,0;;;;;11,0;;;;1,0;;;;;;;3,0;1,0;;;;;;;;;;;;;;;4,0;;3,0;;;;1,0;1,0;;;;;1,0;;;;;;17,0;;;65,0;;;;;;;;;;;;;;;;;;;16,0;;;;;;;;;;;;;;;;;3,0;;4,0;;;;;;1,0;;;;;;;;;77,0;2,0;;;13,0;;;1,0;;;;13,0;1,0;;3,0;;;8,0;4,0;2,0;4,0;18,0;;;;;;;3,0;;;;1,0;;;;22,0;;;;8,0;;;9,0;;10,0;;1,0;;9,0;5,0;7,0;;22,0;;;3,0;;;;;;;1,0;1,0;6,0;;6,0;1,0;;;;;;;;;;12,0;;;;;7,0;;;;;;;;1,0;;1,0;;;5,0;1,0;;;;;;;;;2,0;3,0;;49,0;;;9,0;6,0;;;;2,0;;1,0;;;;1,0;;;;;;10,0;23,0;;;;15,0;1,0;;;6,0;;;;9,0;;;15,0;43,0;;27,0;;;;;;;;18,0;;2,0;1,0;;1,0;4,0;24,0;;;;;;2,0;;;2,0;;;3,0;5,0;1,0;;2,0;6,0;;2,0;;;2,0;;;;;3,0;6,0;;31,0;;;;;;;3,0;;;;1,0;2,0;41,0;;;4,0;;6,0;19,0;;3,0;1,0;;;;;5,0;;;2,0;;;27,0;;1,0;;2,0;;2,0;1,0;;1,0;;;;;;;;4,0;;10,0;;;;;3,0;11,0;2,0;;;;;1,0;;;6,0;;;;;2,0;1,0;;;;;3,0;4,0;1,0;2,0;;;1,0;;4,0;;;7,0;;;;;;;;1,0;2,0;;;;;16,0;;;;9,0;;;;;;;9,0;;;;1,0;2,0;;;;;;;;;;;;2,0;2,0;;;;;;;;6,0;;;;;;;;;35,0;;;;;;30,0;1,0;;;;;;2,0;;;;;2,0;;;;;3,0;;;;;;;;1,0;3,0;1,0;;;1,0;;;;2,0;;;1,0;;;;;;;;;;8,0;;;2,0;;2,0;;;;;;;1,0;;;;;;;;;;;;1,0;;;;;;;;;;;;;;;;;;;;;;;;;;;;;;;;;;;;;4,0;;;;;;3,0;;59,0;;;6,0;;2,0;;;57,0;;8,0;;;;;;;;;;;;;;;;;;16,0;;;;;1,0;;;;;;;;;;;;;;;;;;;;;;;;;;;;;;;;;;;8,0;;;;30,0;;;;;8,0;;;;;;1,0;;;;;;;;;;;;;;;;;;;;;;;;;;;;;10,0;;;;;;;;;;;;;;;;;;;;;;;;;;;;;;;2,0;
incline;;1,0;;;;52,0;8,0;2,0;3,0;;2,0;;;;22,0;3,0;4,0;;;;;;;;;;2,0;;;;;;1,0;;2,0;;;;;;;;;;13,0;4,0;;3,0;;4,0;3,0;5,0;;;1,0;5,0;6,0;;;;10,0;;;;;;1,0;19,0;;6,0;;;;;;;;4,0;3,0;8,0;;8,0;;18,0;;;1,0;;3,0;3,0;12,0;;;;;;;;1,0;;;;3,0;6,0;;;18,0;;11,0;;;;1,0;;;4,0;47,0;15,0;;6,0;1,0;9,0;;;;;;;1,0;;;;3,0;;;;;2,0;;1,0;;5,0;;11,0;;;;7,0;2,0;;;3,0;;;;;;;13,0;;;2,0;34,0;;;;;1,0;;;;;;5,0;1,0;;8,0;5,0;;;;1,0;;;;;;6,0;;;;;;4,0;;2,0;;;;10,0;2,0;2,0;;71,0;;1,0;2,0;;;44,0;;1,0;1,0;;;;9,0;;1,0;7,0;3,0;2,0;8,0;;2,0;;;7,0;20,0;;13,0;;4,0;11,0;9,0;5,0;1,0;4,0;15,0;3,0;;3,0;1,0;;;;;;;20,0;14,0;;2,0;5,0;3,0;;;3,0;;18,0;;;;;;;1,0;3,0;;;14,0;1,0;3,0;;;7,0;;1,0;10,0;130,0;1,0;;;1,0;;;;2,0;;;4,0;8,0;;;8,0;;;2,0;;2,0;;1,0;;;;;;4,0;9,0;;;2,0;;11,0;8,0;1,0;;;;2,0;5,0;;;;21,0;;;3,0;;;;2,0;3,0;;;;;9,0;;2,0;;;1,0;;;;16,0;;7,0;;4,0;2,0;;;;;;;;3,0;;1,0;;2,0;9,0;;;6,0;1,0;2,0;;;;;;;;;1,0;3,0;2,0;;;1,0;;;9,0;;1,0;16,0;;;;;2,0;1,0;2,0;;8,0;;;;;1,0;;;;1,0;;3,0;;;;;;;;;1,0;;;;5,0;;;;;1,0;;;;;;;;;;;;;1,0;;1,0;;;;;;1,0;;;1,0;;;;;;;;;2,0;;;4,0;;;;;;;;;;;;;;;;;3,0;;;9,0;2,0;;;;;4,0;;;;;;;;;;;1,0;;;;;;2,0;;;;;1,0;;;;;;;;;;;;1,0;;;;;;;;;;1,0;;;;;;;;;;1,0;;;;;;;;;;;;;;;3,0;1,0;;;;;;;;;;;;;1,0;;;;;;;;;;;;;;;;;;;;;;;;;;5,0;;;;4,0;;;;;;;;;;;;;;;;;;;;;;;;18,0;;;;;;;3,0;;;;2,0;;;;;;;;;;2,0;;;;;;;;;;;;;;;;;;;;9,0;;;;1,0;1,0;1,0;;1,0;;;;;;;2,0;;;4,0;;;;;;;;;;;;;;;;;;;;2,0;;;;;;;;1,0;;;;;;;;;;;;1,0;;;;1,0;;;;;;2,0;;;;;;;;1,0;;;;2,0;;;;;;;;;;1,0;1,0;;;;;;;;;;;;;;;;;;;;;1,0;;;;;;;;;;;;;;;;;;;;;;;;;;;;;;;;;;;;;;;;;;;;;;;;;;;;;;;;;;;;;2,0;;;;;;;;;;;;;;;;;;;;;;;;;;;;;;;;;;;;;;;;2,0;;;;;;;;;;;;;;;;;;;5,0;2,0;;;;;;;;;;;1,0;;;;;;;;1,0;;;;;;;;;;;;;;;;;;;;;;;;3,0;;;;;;2,0;;;;;4,0;;;;;;;;;;;;;;;;;;;3,0;;;;;3,0;;;;;;;;;;;;;;2,0;;;;;;;
indicate;;15,0;1,0;;1,0;19,0;11,0;33,0;63,0;3,0;6,0;;29,0;1,0;5,0;57,0;;1,0;17,0;;11,0;58,0;5,0;10,0;;6,0;36,0;4,0;;4,0;6,0;10,0;37,0;;117,0;18,0;2,0;10,0;5,0;16,0;203,0;;;10,0;47,0;33,0;47,0;133,0;33,0;146,0;;85,0;;3,0;28,0;4,0;12,0;14,0;3,0;;;11,0;10,0;1,0;2,0;37,0;113,0;4,0;34,0;1,0;17,0;;67,0;;;22,0;11,0;3,0;4,0;360,0;2,0;34,0;;56,0;9,0;32,0;42,0;;;34,0;212,0;;;;4,0;12,0;8,0;4,0;77,0;19,0;1,0;1,0;13,0;121,0;;14,0;58,0;11,0;80,0;122,0;1,0;8,0;;7,0;;56,0;21,0;256,0;25,0;83,0;;;7,0;27,0;14,0;4,0;8,0;23,0;2,0;44,0;14,0;34,0;8,0;1,0;2,0;3,0;12,0;30,0;3,0;16,0;22,0;1,0;15,0;50,0;30,0;;;4,0;245,0;15,0;17,0;;17,0;43,0;42,0;8,0;66,0;;19,0;24,0;3,0;30,0;146,0;12,0;2,0;;19,0;24,0;6,0;;65,0;;;1,0;94,0;4,0;8,0;1,0;;;;46,0;;;;4,0;;11,0;;;2,0;4,0;;2,0;6,0;;13,0;;;3,0;;;40,0;66,0;4,0;;;;17,0;55,0;;2,0;;;;;;;3,0;;3,0;;;4,0;;1,0;;;59,0;;14,0;;1,0;4,0;9,0;31,0;33,0;4,0;;;7,0;6,0;;4,0;10,0;;1,0;3,0;59,0;2,0;;;1,0;4,0;;1,0;112,0;2,0;;1,0;;;1,0;31,0;;;7,0;;8,0;;;13,0;6,0;;;;39,0;;;17,0;26,0;3,0;2,0;;;54,0;;10,0;;;29,0;1,0;;;;;5,0;;;;;1,0;;;;;;9,0;1,0;3,0;;15,0;;;13,0;1,0;;;;;;;1,0;;30,0;;4,0;;2,0;1,0;;;;6,0;;31,0;3,0;3,0;;;;;6,0;5,0;7,0;6,0;5,0;;;8,0;;;;12,0;;;;50,0;;8,0;16,0;3,0;;;;;1,0;;;10,0;29,0;1,0;;3,0;2,0;;;;4,0;15,0;;;;;;37,0;;;;2,0;1,0;55,0;4,0;2,0;;33,0;1,0;8,0;;4,0;;;9,0;;;;;10,0;8,0;60,0;49,0;20,0;8,0;3,0;4,0;;;;2,0;;2,0;21,0;24,0;8,0;;8,0;2,0;22,0;5,0;1,0;7,0;99,0;35,0;;59,0;1,0;23,0;22,0;67,0;;21,0;83,0;37,0;3,0;;6,0;79,0;4,0;39,0;9,0;38,0;3,0;;;15,0;19,0;14,0;;1,0;4,0;7,0;;18,0;34,0;;;67,0;2,0;34,0;10,0;3,0;;6,0;19,0;118,0;1,0;30,0;23,0;8,0;;15,0;1,0;;5,0;25,0;8,0;3,0;;;18,0;1,0;4,0;25,0;1,0;7,0;1,0;13,0;78,0;18,0;30,0;4,0;;10,0;38,0;30,0;3,0;3,0;;2,0;;9,0;24,0;5,0;;9,0;2,0;;;;2,0;;4,0;3,0;48,0;9,0;6,0;3,0;;4,0;4,0;2,0;10,0;5,0;1,0;;;;2,0;2,0;;9,0;;1,0;12,0;4,0;3,0;29,0;12,0;;48,0;1,0;;5,0;11,0;1,0;9,0;;1,0;;1,0;;1,0;6,0;39,0;;24,0;2,0;33,0;;4,0;1,0;;;3,0;;1,0;;;;;3,0;;10,0;;7,0;19,0;6,0;;4,0;;15,0;14,0;32,0;1,0;2,0;1,0;;2,0;1,0;;10,0;;9,0;46,0;;2,0;17,0;;2,0;2,0;3,0;5,0;7,0;;;;;7,0;10,0;;1,0;4,0;;7,0;8,0;;45,0;21,0;;3,0;;;2,0;2,0;3,0;1,0;8,0;1,0;;1,0;1,0;;;6,0;;6,0;2,0;;2,0;;;9,0;1,0;;;;2,0;6,0;;;;1,0;;;5,0;2,0;;23,0;;3,0;12,0;;38,0;;;2,0;;;;;;1,0;2,0;;;3,0;2,0;1,0;;;;5,0;;;19,0;;;1,0;9,0;;;;4,0;3,0;;4,0;;6,0;;;;2,0;1,0;3,0;;;;;1,0;;;;;;9,0;2,0;;;;4,0;1,0;1,0;2,0;;5,0;;;;4,0;;26,0;;;6,0;;;;;;13,0;3,0;;;;;;;1,0;17,0;;;;;7,0;9,0;12,0;8,0;;;6,0;;;16,0;8,0;;;;;23,0;15,0;1,0;;2,0;;6,0;1,0;12,0;1,0;5,0;22,0;1,0;9,0;;12,0;;;;;4,0;2,0;4,0;9,0;;5,0;5,0;9,0;;;13,0;;18,0;11,0;;6,0;12,0;;;2,0;;27,0;1,0;;5,0;;15,0;8,0;1,0;2,0;;;;3,0;;;5,0;;4,0;1,0;;;;;;;14,0;2,0;1,0;8,0;23,0;4,0;6,0;2,0;9,0;;7,0;2,0;;3,0;2,0;2,0;6,0;;;;;5,0;;1,0;;;;7,0;3,0;2,0;2,0;;12,0;;;1,0;;;1,0;3,0;4,0;3,0;;;15,0;8,0;;2,0;1,0;;;;4,0;4,0;4,0;;;;3,0;11,0;3,0;;;;;;;1,0;;;5,0;5,0;3,0;;17,0;2,0;;;;7,0;;;;1,0;;;4,0;24,0;4,0;12,0;6,0;;1,0;;;5,0;;;;;;;14,0;;1,0;;;;5,0;1,0;;;;;;3,0;35,0;;;1,0;2,0;;7,0;;;;;;15,0;;;9,0;;2,0;1,0;1,0;1,0;3,0;11,0;5,0;2,0;12,0;;1,0;1,0;3,0;;;1,0;2,0;;;;;1,0;
indicative;;4,0;;6,0;1,0;4,0;;2,0;6,0;;4,0;;4,0;;1,0;8,0;;;2,0;2,0;5,0;14,0;;1,0;6,0;;22,0;4,0;;;4,0;3,0;14,0;3,0;18,0;4,0;;1,0;1,0;;173,0;;3,0;1,0;30,0;;17,0;34,0;11,0;38,0;;29,0;2,0;;2,0;;1,0;1,0;;;;1,0;1,0;;1,0;;7,0;2,0;4,0;1,0;25,0;;56,0;;;1,0;1,0;;3,0;98,0;;17,0;;23,0;4,0;3,0;;1,0;;2,0;6,0;;;;86,0;5,0;1,0;;15,0;2,0;1,0;2,0;3,0;23,0;;3,0;9,0;;67,0;16,0;;5,0;;;1,0;8,0;3,0;30,0;10,0;2,0;;;2,0;17,0;3,0;5,0;;1,0;7,0;2,0;;24,0;1,0;;;;11,0;21,0;;;18,0;;2,0;40,0;18,0;1,0;;;88,0;1,0;1,0;;5,0;8,0;;;12,0;;3,0;8,0;;6,0;6,0;;;;14,0;7,0;6,0;13,0;4,0;;;1,0;12,0;;;;;3,0;;;;;1,0;;;;;;;;;2,0;;;;;;;;;15,0;25,0;4,0;;;8,0;;2,0;;;;;;;;;;;;;;;;;;;60,0;;;;;;;;9,0;;;;1,0;;;;;;;;7,0;1,0;;;;;;;50,0;;;;;;;14,0;;;1,0;;6,0;;;3,0;1,0;;6,0;;;;;1,0;1,0;;;;;15,0;;;;;26,0;1,0;1,0;;;;;;;;;;;3,0;;;;;;;;;;;2,0;4,0;;;;;;;;;1,0;;1,0;;;;;;;;;8,0;;;;;;;2,0;;;;;;;;;;;;;;1,0;4,0;5,0;;;;;;;;;1,0;;;;;;1,0;;;;;2,0;1,0;;;;;;1,0;;;;;;13,0;20,0;;;2,0;6,0;;;6,0;1,0;;;;;;;9,0;;5,0;6,0;1,0;2,0;;2,0;;;;;1,0;5,0;;1,0;1,0;;;;18,0;;;;23,0;3,0;5,0;21,0;3,0;8,0;4,0;15,0;1,0;;30,0;8,0;1,0;2,0;4,0;2,0;2,0;19,0;;;1,0;;6,0;7,0;;;2,0;1,0;;7,0;;;6,0;1,0;1,0;18,0;7,0;2,0;3,0;1,0;;4,0;2,0;33,0;1,0;;12,0;;;2,0;;;;;2,0;;3,0;;1,0;;10,0;2,0;3,0;;5,0;5,0;4,0;9,0;;;1,0;;1,0;;;;;;4,0;;;;;;;;;;2,0;;;1,0;;;2,0;27,0;;3,0;;;;;;;;1,0;;;;;;;;;9,0;;2,0;;6,0;;;;;;3,0;;;;;5,0;;;15,0;;5,0;;10,0;;;;;;;1,0;;;;;;;;3,0;;;4,0;;11,0;;;;;;;;;;3,0;;;;;;;1,0;2,0;;;;;;1,0;;2,0;;4,0;;;;;;;;;;;6,0;1,0;;1,0;;;1,0;;1,0;;;;2,0;;;;3,0;;1,0;;;;1,0;;;1,0;;;;;;;;;;2,0;;;;;;1,0;;;2,0;;;;4,0;;;;;;;;;;;1,0;3,0;1,0;;;;;;;5,0;;;;5,0;;;;2,0;;;8,0;1,0;;;;;;1,0;;;;;;;;;;;;2,0;;;;;;;;;;18,0;;;;;;;;;;;;;;;6,0;;;;;;;;;2,0;;;;;;;;;;;;;;2,0;3,0;;;;;;15,0;;4,0;;;;;;;;9,0;1,0;2,0;;;;;;;;;;;4,0;;;2,0;;;;1,0;1,0;;;4,0;;;;3,0;;1,0;;7,0;;;2,0;2,0;;1,0;;;;6,0;;;;;;;;;;;;3,0;2,0;2,0;;;;;;;2,0;;2,0;4,0;2,0;16,0;;;;;;;;;1,0;;;;;3,0;;5,0;1,0;1,0;2,0;;;;;;;;;;;2,0;;;;;;;;;;1,0;15,0;;;;;3,0;;;;;;;;;;;;;;;3,0;3,0;;;3,0;;;;;;;;;;;;;;;;;1,0;;;;;;;;;;;;;4,0;;;;;;;;;;1,0;;;1,0;;;;2,0;;;;;;2,0;;;;;;7,0;;;2,0;;1,0;;2,0;;;;;;;;;;;
individual;;5,0;;6,0;9,0;21,0;1,0;5,0;17,0;5,0;12,0;;74,0;1,0;50,0;31,0;1,0;3,0;6,0;;7,0;22,0;;;;;3,0;;;;7,0;28,0;28,0;2,0;6,0;7,0;4,0;2,0;3,0;;83,0;;;;12,0;3,0;45,0;40,0;5,0;10,0;2,0;3,0;;14,0;1,0;;38,0;2,0;1,0;;4,0;;8,0;54,0;5,0;1,0;;20,0;12,0;22,0;3,0;;10,0;;;1,0;20,0;1,0;2,0;322,0;;5,0;5,0;22,0;;28,0;;;;2,0;80,0;2,0;;3,0;5,0;14,0;8,0;;38,0;3,0;3,0;;13,0;10,0;;;31,0;;18,0;70,0;;4,0;;;14,0;161,0;39,0;21,0;2,0;9,0;;;1,0;5,0;4,0;;;3,0;2,0;4,0;;18,0;7,0;4,0;4,0;7,0;16,0;21,0;4,0;;3,0;;2,0;90,0;1,0;2,0;;14,0;14,0;3,0;5,0;;7,0;7,0;;;33,0;48,0;;2,0;1,0;16,0;125,0;1,0;27,0;;5,0;21,0;;;;;;2,0;1,0;;5,0;;;3,0;5,0;6,0;;;2,0;4,0;;10,0;1,0;;;;;18,0;2,0;;;;;7,0;;;8,0;;;;;1,0;22,0;9,0;;;;;;3,0;;;;;2,0;8,0;;;;7,0;;;39,0;1,0;9,0;;1,0;10,0;3,0;64,0;1,0;;;;3,0;;4,0;;;;;6,0;72,0;8,0;;;;;1,0;;4,0;1,0;2,0;;;;;4,0;1,0;;8,0;;;;;14,0;22,0;;;;2,0;2,0;7,0;5,0;26,0;1,0;;1,0;;13,0;;1,0;;;2,0;1,0;;1,0;;;4,0;;;;;3,0;;;8,0;;;1,0;;;;;2,0;;1,0;8,0;;71,0;;;;;;;1,0;;;;;;;;;;;7,0;8,0;;;;;;;2,0;48,0;;;;;2,0;;;1,0;;;;1,0;2,0;;1,0;;5,0;;;;;;26,0;;;4,0;;;;;;;;;16,0;;;2,0;4,0;;;;;;2,0;;;;3,0;2,0;;;;18,0;;;;;5,0;1,0;;;;2,0;19,0;9,0;7,0;9,0;4,0;6,0;1,0;2,0;;;;;1,0;3,0;;;;1,0;29,0;;;;2,0;;1,0;22,0;;;;10,0;;5,0;14,0;7,0;1,0;8,0;3,0;;;1,0;1,0;;;3,0;;;32,0;1,0;;;1,0;15,0;;;;;;;;10,0;33,0;2,0;;1,0;5,0;3,0;3,0;15,0;;;1,0;;3,0;2,0;;4,0;3,0;1,0;;1,0;1,0;;;16,0;;7,0;;2,0;6,0;;1,0;5,0;1,0;;3,0;6,0;;;;15,0;2,0;1,0;;;;;;;;;22,0;1,0;24,0;;3,0;;58,0;2,0;;11,0;39,0;;6,0;3,0;3,0;;;2,0;;;8,0;1,0;4,0;;;;8,0;2,0;;;9,0;;;;11,0;6,0;4,0;;;;;;2,0;;9,0;;6,0;;2,0;;4,0;3,0;;4,0;;;1,0;;;;;3,0;1,0;3,0;;5,0;1,0;;;;;43,0;7,0;;;;;;1,0;;;7,0;2,0;;;1,0;20,0;;;;;;1,0;8,0;;;;;;;;;;;2,0;6,0;;17,0;;;;;;;3,0;;;7,0;;;;;;4,0;;1,0;1,0;;1,0;;;;;;1,0;;10,0;;;;;;;24,0;1,0;1,0;;1,0;;;;9,0;1,0;;;;;;29,0;;16,0;;;9,0;;;3,0;;;2,0;2,0;;;;;;4,0;;;1,0;;6,0;;;;;;1,0;;;2,0;10,0;;;;;;;;;;;;;;;;;;1,0;;1,0;2,0;7,0;;1,0;1,0;;1,0;;5,0;;;;3,0;1,0;1,0;;;1,0;;;;;;;;;;;2,0;;;;;16,0;;2,0;2,0;;1,0;4,0;;3,0;1,0;;1,0;;2,0;36,0;;;1,0;1,0;4,0;;;;8,0;1,0;;1,0;1,0;;;;;;;;;4,0;;;;;4,0;4,0;;;;1,0;;;3,0;3,0;;;;1,0;4,0;;;;1,0;;;;;;;;1,0;1,0;;2,0;1,0;2,0;;;;;;;;1,0;;;;;15,0;;;;;;;;;;;;;;1,0;;;;5,0;2,0;;;;;;;;;;;;;;;;;;;3,0;;;;;;;;;1,0;;;;;;;3,0;;;;;;;;;;;1,0;;;2,0;;;;;;2,0;;;;;2,0;;;;;;;;;;;;;;;;;;2,0;;;;;;;;;4,0;;;;;;;;;;;1,0;;;;;;;;;;;1,0;;3,0;;;;;;;;;;;;;;;;;;;;
inner;;8,0;;;;10,0;10,0;8,0;20,0;26,0;2,0;;7,0;;31,0;34,0;13,0;;;;;1,0;;8,0;;;1,0;1,0;;;;5,0;14,0;;7,0;;;1,0;;;6,0;;127,0;4,0;;1,0;6,0;22,0;3,0;1,0;67,0;6,0;;;7,0;40,0;24,0;;;;63,0;6,0;5,0;;30,0;;28,0;134,0;91,0;18,0;;;3,0;;;4,0;;;;19,0;2,0;7,0;;118,0;12,0;;3,0;;26,0;53,0;279,0;;;10,0;;;1,0;;12,0;2,0;;;68,0;;;;58,0;4,0;;;7,0;;56,0;;2,0;50,0;329,0;81,0;2,0;2,0;1,0;;;;4,0;;;;;1,0;;;22,0;;;;20,0;;;1,0;;;;45,0;2,0;;6,0;258,0;1,0;;;1,0;;;;;13,0;;7,0;1,0;;1,0;51,0;;2,0;;1,0;14,0;;1,0;;11,0;9,0;17,0;;4,0;29,0;123,0;1,0;;12,0;64,0;3,0;50,0;;9,0;9,0;13,0;;1,0;4,0;;19,0;54,0;1,0;32,0;;8,0;;141,0;55,0;;6,0;68,0;;44,0;1,0;;1,0;86,0;19,0;4,0;2,0;3,0;1,0;;51,0;8,0;4,0;59,0;165,0;13,0;;2,0;;2,0;23,0;;34,0;;170,0;4,0;2,0;79,0;29,0;1,0;7,0;119,0;22,0;369,0;1,0;21,0;11,0;17,0;;;;6,0;4,0;7,0;155,0;;7,0;3,0;;;83,0;7,0;5,0;1,0;;;3,0;2,0;;;28,0;5,0;4,0;;3,0;13,0;96,0;2,0;;30,0;;33,0;11,0;886,0;;;;1,0;6,0;1,0;;3,0;3,0;9,0;14,0;1,0;7,0;;425,0;;2,0;17,0;9,0;9,0;11,0;3,0;45,0;4,0;5,0;12,0;1,0;15,0;70,0;1,0;1,0;43,0;;71,0;19,0;;5,0;1,0;1,0;21,0;2,0;;76,0;22,0;15,0;;33,0;13,0;;;;16,0;15,0;3,0;;;2,0;11,0;17,0;94,0;4,0;8,0;;1,0;6,0;7,0;10,0;3,0;14,0;8,0;31,0;3,0;;2,0;7,0;10,0;2,0;;3,0;5,0;;10,0;2,0;15,0;39,0;7,0;;12,0;39,0;4,0;1,0;2,0;;;2,0;3,0;112,0;4,0;8,0;9,0;14,0;3,0;;28,0;;;65,0;15,0;4,0;89,0;28,0;3,0;;3,0;59,0;;17,0;51,0;10,0;;;;3,0;6,0;2,0;;;1,0;;3,0;1,0;;1,0;;;4,0;4,0;2,0;;;;1,0;;;;;;2,0;;;;;;1,0;13,0;;;;;;;;4,0;;;;1,0;;;;;2,0;;;;;;;;;;;;;;3,0;;;1,0;5,0;;;;;;;1,0;;;1,0;2,0;6,0;;12,0;1,0;;;;4,0;;2,0;1,0;;;;;;;;;5,0;;;;;;5,0;;;;;3,0;;;;;2,0;;;;;;3,0;;;;;2,0;;;;;;5,0;;;;;;1,0;;34,0;;5,0;;;;;;;;1,0;3,0;;;;;4,0;2,0;3,0;3,0;1,0;;;26,0;;5,0;8,0;;;2,0;;9,0;27,0;6,0;;3,0;5,0;;4,0;;6,0;;;;;;;;;;;;9,0;;;;;15,0;;21,0;;;;;;;2,0;;;1,0;;4,0;;;;;8,0;;;;;3,0;;;;21,0;2,0;;;;7,0;;1,0;;;2,0;7,0;;;;;1,0;;;4,0;1,0;24,0;;1,0;;;;10,0;3,0;;2,0;1,0;9,0;10,0;2,0;;;2,0;10,0;15,0;;;1,0;1,0;1,0;3,0;1,0;;9,0;;;;1,0;4,0;2,0;;2,0;20,0;;1,0;;2,0;;;4,0;;4,0;;;;2,0;;;;;;1,0;;6,0;;5,0;;2,0;14,0;;;1,0;59,0;;;;;3,0;2,0;;2,0;62,0;;6,0;28,0;9,0;2,0;1,0;4,0;;;3,0;;3,0;;4,0;14,0;;;;15,0;;1,0;1,0;6,0;;;1,0;;;;1,0;2,0;1,0;;7,0;;1,0;;;;;;;;;;3,0;;;60,0;;;1,0;2,0;;3,0;;;;;;;;;;;;;;;2,0;1,0;;;;;;;;1,0;;;;;;1,0;;1,0;;;;;3,0;2,0;;;;;2,0;;;;;;1,0;;;;;;3,0;;;;;;;;;;2,0;2,0;;;7,0;;;;;;;;;;;;;;;;41,0;;;;;;;;;;;;;8,0;;;;1,0;3,0;1,0;;;2,0;;;;;;;;;;;;;;;;;;;;;;9,0;7,0;;15,0;;;3,0;5,0;;;;;;;;1,0;;4,0;38,0;1,0;;;;;;;;;;11,0;;1,0;;;26,0;1,0;;;;1,0;;;;5,0;1,0;;;;;;4,0;;;;;;14,0;;;;;;;;;;;14,0;;;;;2,0;;;;;1,0;;;;;;;;;;12,0;;;;;;
input;;24,0;3,0;26,0;19,0;29,0;1,0;163,0;129,0;27,0;15,0;;48,0;2,0;16,0;272,0;28,0;1,0;7,0;10,0;21,0;159,0;26,0;3,0;1,0;15,0;158,0;14,0;;1,0;44,0;22,0;311,0;1,0;672,0;61,0;20,0;12,0;4,0;;588,0;1,0;38,0;29,0;161,0;26,0;272,0;722,0;169,0;276,0;40,0;26,0;10,0;13,0;28,0;45,0;104,0;;55,0;7,0;;28,0;24,0;2,0;37,0;12,0;45,0;26,0;269,0;9,0;49,0;1,0;111,0;3,0;8,0;14,0;96,0;3,0;8,0;1550,0;9,0;53,0;5,0;275,0;7,0;122,0;32,0;;1,0;13,0;75,0;1,0;43,0;16,0;2,0;19,0;66,0;2,0;360,0;24,0;37,0;19,0;251,0;97,0;2,0;28,0;100,0;15,0;367,0;59,0;6,0;110,0;;2,0;14,0;174,0;154,0;155,0;55,0;75,0;2,0;;63,0;158,0;130,0;23,0;1,0;1,0;3,0;33,0;5,0;165,0;18,0;5,0;61,0;11,0;18,0;146,0;59,0;2,0;63,0;1,0;11,0;161,0;40,0;;;139,0;1041,0;21,0;20,0;;49,0;93,0;57,0;50,0;187,0;;27,0;50,0;23,0;46,0;603,0;5,0;3,0;1,0;311,0;48,0;3,0;;65,0;;;1,0;38,0;23,0;20,0;;;;11,0;89,0;;1,0;15,0;127,0;;29,0;4,0;;23,0;1,0;;247,0;3,0;152,0;23,0;2,0;;1,0;;1,0;7,0;77,0;2,0;;7,0;14,0;5,0;60,0;;2,0;;54,0;;1,0;;;1,0;;13,0;4,0;;;;;3,0;;110,0;;10,0;;12,0;19,0;;20,0;13,0;22,0;6,0;;1,0;16,0;1,0;66,0;17,0;;12,0;4,0;156,0;10,0;3,0;8,0;;3,0;;33,0;883,0;11,0;;;;;3,0;236,0;2,0;;51,0;;35,0;;63,0;27,0;4,0;;2,0;;59,0;3,0;2,0;107,0;92,0;57,0;293,0;;1,0;120,0;2,0;108,0;4,0;1,0;49,0;16,0;;;;;4,0;;3,0;;7,0;17,0;6,0;25,0;;;5,0;30,0;;1,0;;1,0;4,0;;13,0;6,0;1,0;100,0;4,0;69,0;;;;;20,0;;;;25,0;9,0;;;;1,0;;33,0;15,0;9,0;14,0;1,0;;;4,0;7,0;9,0;23,0;8,0;10,0;15,0;46,0;;;11,0;6,0;;;;134,0;23,0;;1,0;2,0;1,0;;;;26,0;4,0;;;9,0;7,0;;37,0;2,0;;;;11,0;12,0;;;16,0;;;19,0;;;14,0;10,0;;31,0;12,0;2,0;;15,0;10,0;7,0;33,0;6,0;1,0;2,0;9,0;18,0;;1,0;4,0;3,0;9,0;41,0;60,0;28,0;75,0;1,0;37,0;9,0;;10,0;12,0;13,0;;3,0;12,0;19,0;2,0;5,0;5,0;66,0;;23,0;24,0;;88,0;5,0;70,0;2,0;66,0;8,0;94,0;3,0;14,0;121,0;37,0;12,0;24,0;28,0;213,0;28,0;28,0;23,0;26,0;3,0;;35,0;12,0;43,0;63,0;12,0;;13,0;24,0;8,0;4,0;13,0;;;8,0;10,0;33,0;23,0;;4,0;49,0;11,0;1054,0;7,0;2,0;1,0;151,0;10,0;63,0;2,0;8,0;17,0;67,0;10,0;6,0;7,0;5,0;28,0;7,0;27,0;23,0;19,0;12,0;11,0;23,0;22,0;200,0;3,0;31,0;26,0;4,0;52,0;17,0;;7,0;;26,0;7,0;7,0;74,0;3,0;3,0;60,0;4,0;1,0;7,0;12,0;35,0;13,0;31,0;22,0;39,0;18,0;;180,0;;38,0;25,0;;11,0;14,0;11,0;10,0;;99,0;2,0;23,0;;7,0;;5,0;2,0;20,0;17,0;20,0;25,0;;129,0;5,0;;;14,0;108,0;2,0;1,0;1,0;;38,0;5,0;1,0;7,0;29,0;2,0;56,0;5,0;51,0;8,0;;66,0;1,0;9,0;;;46,0;;;6,0;6,0;;2,0;19,0;7,0;9,0;21,0;18,0;56,0;;1,0;8,0;2,0;1,0;;1,0;;;7,0;52,0;3,0;16,0;2,0;1,0;6,0;11,0;21,0;7,0;;;12,0;2,0;24,0;5,0;1,0;78,0;;;2,0;;2,0;7,0;13,0;;10,0;10,0;3,0;104,0;9,0;;5,0;37,0;;;20,0;2,0;2,0;4,0;1,0;3,0;3,0;3,0;;2,0;;22,0;23,0;9,0;;30,0;16,0;21,0;15,0;4,0;4,0;;;1,0;;;;;165,0;;;29,0;8,0;;11,0;1,0;;8,0;;15,0;1,0;1,0;;;;;;;5,0;7,0;;;24,0;12,0;19,0;26,0;;5,0;2,0;;;1,0;1,0;1,0;34,0;7,0;;1,0;;13,0;1,0;;8,0;14,0;1,0;1,0;;;;11,0;1,0;;3,0;;;;;37,0;3,0;1,0;;3,0;2,0;3,0;14,0;3,0;7,0;3,0;11,0;2,0;4,0;1,0;7,0;1,0;2,0;1,0;13,0;10,0;;;3,0;;;;8,0;;2,0;;;4,0;;;26,0;4,0;;42,0;3,0;;74,0;41,0;98,0;3,0;9,0;5,0;39,0;23,0;4,0;;1,0;6,0;25,0;4,0;;;;10,0;16,0;138,0;1,0;;2,0;1,0;8,0;22,0;2,0;7,0;76,0;3,0;13,0;90,0;9,0;;;;30,0;6,0;;5,0;7,0;8,0;5,0;2,0;1,0;23,0;;8,0;6,0;13,0;5,0;;5,0;;6,0;20,0;2,0;4,0;8,0;3,0;7,0;10,0;11,0;49,0;16,0;3,0;19,0;;;;4,0;;;4,0;8,0;3,0;2,0;1,0;2,0;10,0;3,0;;;20,0;;3,0;;4,0;38,0;;6,0;10,0;2,0;6,0;18,0;3,0;7,0;1,0;1,0;19,0;9,0;2,0;25,0;2,0;2,0;10,0;2,0;;;2,0;13,0;3,0;;;4,0;2,0;;1,0;2,0;;;;;3,0;4,0;1,0;4,0;7,0;;4,0;3,0;18,0;;13,0;1,0;4,0;1,0;8,0;16,0;4,0;2,0;24,0;;2,0;;;;1,0;;;2,0;;;;;18,0;;;2,0;4,0;;;32,0;;21,0;;98,0;;;4,0;1,0;;8,0;3,0;;40,0;;2,0;3,0;2,0;;;1,0;7,0;;5,0;;;1,0;;18,0;2,0;4,0;;;;;;;12,0;5,0;1,0;4,0;32,0;;1,0;3,0;;;2,0;;2,0;;;16,0;;3,0;;;5,0;5,0;1,0;3,0;34,0;;11,0;;;1,0;8,0;;1,0;14,0;;;1,0;;3,0;2,0
insert;;103,0;;;;8,0;9,0;5,0;41,0;2,0;;;3,0;;15,0;33,0;1,0;;;;1,0;3,0;1,0;1,0;4,0;2,0;10,0;1,0;2,0;;;;48,0;;23,0;8,0;26,0;3,0;;;23,0;;12,0;;7,0;;10,0;44,0;6,0;9,0;27,0;1,0;;;5,0;14,0;13,0;;1,0;;13,0;8,0;1,0;3,0;54,0;;2,0;53,0;48,0;8,0;5,0;1,0;4,0;;1,0;4,0;;2,0;7,0;134,0;;12,0;;51,0;;5,0;4,0;;;;120,0;;;20,0;;42,0;17,0;;32,0;1,0;7,0;1,0;38,0;8,0;;1,0;105,0;7,0;6,0;14,0;8,0;6,0;;;;49,0;98,0;52,0;;15,0;2,0;;1,0;8,0;1,0;1,0;;;;;;;;20,0;;;7,0;;;;4,0;2,0;;10,0;8,0;;;15,0;4,0;19,0;1,0;;30,0;7,0;3,0;1,0;21,0;;1,0;;1,0;;118,0;;;;28,0;3,0;2,0;4,0;1,0;;5,0;4,0;;3,0;21,0;33,0;18,0;1,0;10,0;107,0;;31,0;2,0;7,0;;11,0;;;5,0;;6,0;9,0;;6,0;;;;22,0;11,0;;;6,0;;10,0;;;2,0;3,0;;;12,0;;8,0;;54,0;2,0;;162,0;21,0;;;69,0;3,0;;11,0;;30,0;;69,0;3,0;16,0;220,0;5,0;3,0;;107,0;3,0;2,0;1,0;3,0;2,0;81,0;24,0;;;;;7,0;12,0;;1,0;1,0;;;27,0;;1,0;;2,0;7,0;9,0;25,0;2,0;1,0;2,0;2,0;2,0;;8,0;;4,0;3,0;;22,0;;15,0;14,0;16,0;;6,0;13,0;;3,0;7,0;;;;;1,0;1,0;5,0;;15,0;;;;21,0;8,0;6,0;14,0;3,0;1,0;;;;6,0;10,0;;;19,0;2,0;3,0;;;;14,0;2,0;33,0;4,0;3,0;;9,0;30,0;;13,0;54,0;5,0;1,0;7,0;10,0;1,0;6,0;;;;64,0;5,0;20,0;4,0;1,0;;2,0;8,0;;29,0;4,0;2,0;;3,0;1,0;;;2,0;6,0;;10,0;1,0;2,0;6,0;4,0;;24,0;79,0;3,0;1,0;20,0;38,0;1,0;;2,0;;;15,0;9,0;19,0;2,0;8,0;12,0;23,0;2,0;;31,0;;;1,0;9,0;;39,0;2,0;2,0;;5,0;3,0;;2,0;;3,0;;;;2,0;6,0;;;;;1,0;;3,0;9,0;;2,0;;;1,0;3,0;;;;;;;4,0;;;1,0;;2,0;;4,0;;;7,0;;;;5,0;;3,0;1,0;9,0;;;2,0;6,0;;1,0;1,0;13,0;;;;;3,0;;1,0;;;;;;1,0;;;;;;1,0;;;1,0;;15,0;;;;;1,0;1,0;15,0;3,0;5,0;;;1,0;;;6,0;;1,0;;;2,0;;1,0;2,0;6,0;1,0;1,0;;;10,0;;;11,0;;;;1,0;3,0;;;;;10,0;;5,0;;;2,0;5,0;1,0;;;;4,0;;;;;;2,0;2,0;7,0;6,0;;;2,0;2,0;6,0;1,0;;6,0;4,0;;;7,0;3,0;;5,0;;;;1,0;;1,0;6,0;;24,0;;4,0;;4,0;;;1,0;;;;;;2,0;;1,0;;4,0;;;;;8,0;3,0;9,0;;;;1,0;;;;;;1,0;;;;;;1,0;;;;;;;4,0;;;;;21,0;3,0;28,0;3,0;1,0;1,0;;;;;9,0;;;;2,0;;5,0;8,0;1,0;;;;;;;27,0;;;;4,0;;;;;;11,0;;2,0;;;;1,0;2,0;6,0;;;1,0;;2,0;;;;;1,0;;;;17,0;;5,0;;;;1,0;2,0;;3,0;7,0;;;4,0;1,0;8,0;1,0;;1,0;2,0;;3,0;4,0;;2,0;;;;;2,0;1,0;;;;;3,0;;2,0;2,0;;9,0;1,0;;1,0;5,0;;9,0;;;8,0;3,0;;3,0;;13,0;;11,0;2,0;;;1,0;;1,0;;;;1,0;23,0;;;2,0;;2,0;;;;25,0;;;2,0;;;1,0;;;;;;2,0;;;;;;;;;5,0;;;;;;;13,0;;;;;;;;;;;;;;;;6,0;1,0;;;;;;;1,0;;;;;;;1,0;;;2,0;;;11,0;;;1,0;;4,0;;;;;18,0;;;;;1,0;;;;;;;;3,0;;;;3,0;1,0;;;;;;;;6,0;;;2,0;;;8,0;;;;;;;;;;;;1,0;;;;;3,0;;;1,0;;;;;3,0;;1,0;;;;;;;;2,0;;;;;;;;;;;1,0;;;;;;;;1,0;5,0;;;2,0;;5,0;;;;1,0;;;2,0;;1,0;;;1,0;;;2,0;;;;;;;2,0;;;1,0;;;;;;7,0;;3,0;7,0;;;;;1,0;;;;;;;;1,0;;;;;1,0;;3,0;;;;;;;2,0;;3,0;;;;;;;;4,0;;;;;;;;;;;;;;;;
insertion;;26,0;;;;;1,0;6,0;1,0;2,0;;;2,0;;;19,0;;;;;;3,0;;18,0;;;1,0;;1,0;;;;44,0;;15,0;;1,0;;;;2,0;;;1,0;;1,0;3,0;20,0;5,0;2,0;7,0;1,0;;;5,0;;3,0;;;;4,0;1,0;2,0;;3,0;;;9,0;33,0;3,0;1,0;;;;1,0;;;;2,0;15,0;;9,0;;19,0;;3,0;;;1,0;1,0;22,0;;;1,0;;38,0;;;11,0;8,0;11,0;;7,0;;;;2,0;;;11,0;;2,0;;;;10,0;15,0;9,0;;1,0;4,0;;1,0;14,0;5,0;;;;;;;;5,0;2,0;;;2,0;;;;;;;;;;;10,0;1,0;2,0;;;33,0;;1,0;;16,0;;;;;;20,0;;;;17,0;2,0;;;;1,0;1,0;;;3,0;;;;;;20,0;1,0;5,0;;;;19,0;;;;;;3,0;;4,0;;;;4,0;;;;25,0;;;;;;3,0;;;;;;;27,0;5,0;;30,0;19,0;;2,0;;;;;;;;15,0;;;46,0;;6,0;1,0;27,0;6,0;1,0;;1,0;;;3,0;;;;;;14,0;;;;;;;;;;;;6,0;;;;5,0;;;;4,0;;;1,0;;;;14,0;4,0;11,0;;;2,0;;;1,0;;;;1,0;;4,0;;;5,0;;;;11,0;;;4,0;;;;;;1,0;4,0;;;9,0;;;;1,0;1,0;27,0;;13,0;;;;6,0;;;1,0;;;1,0;;;;3,0;;;;8,0;;3,0;4,0;;69,0;4,0;8,0;1,0;2,0;;;1,0;;;;3,0;;3,0;;6,0;;;;;;2,0;13,0;1,0;;6,0;;;1,0;;;;;;;;3,0;;1,0;;;;;;3,0;;3,0;9,0;;;;;;;;;6,0;;;;2,0;2,0;;;;;;2,0;2,0;;;;;;;;;;;;8,0;;;;;4,0;;;;;3,0;;1,0;;1,0;;;;;;10,0;;;;;;;;;;;;;;;;;3,0;;;;;;;;;;3,0;;;;;2,0;;;;;17,0;;6,0;1,0;9,0;;;;;;;;;;;;;;;3,0;;1,0;;;;;;1,0;;;;;;;;;;22,0;;5,0;;;;;;;;;;;;;;;2,0;;;4,0;;;3,0;;;;;;;;;;;;;;;;1,0;;3,0;;;;;;;2,0;1,0;7,0;;;;;;;;;5,0;;;;;;;;;;;;;8,0;;1,0;;;2,0;;;;;;;;;11,0;;;;;;;;2,0;;;;30,0;;;;;;;;;;;;;;;;;;;2,0;;2,0;;;;;;11,0;;;;4,0;;;1,0;;;;;;;1,0;;;;;;;;;;;;;;;;;2,0;;;;;;;;;2,0;;;;;1,0;;2,0;;;;;;;;;;;;;;;;;;;;;;;;;12,0;;;;;;;;;;2,0;;;;;;;;;;1,0;;;3,0;1,0;;;;;;;;1,0;;;;;;;;;1,0;;;;;;;;;;;2,0;;;;;;;;2,0;;;;;;1,0;;;;;;;;;;6,0;;;;;;;;;;;1,0;;;;;;;;;10,0;;;;;;;;;;;1,0;;;;1,0;;;;1,0;;;;;;;;;;;;;;;;;;;;;;;;;;;;;1,0;;;;;;;;;;;;;;;;;;;;;;;;;;;;;;1,0;;;;;;;;;;;;;;;;;2,0;;;;;;;;1,0;1,0;;;;;;;;;;;;;;;;;;;;;2,0;;;;;;;;;;;1,0;4,0;;;;;;;;;;;;;;;;;;;;;;;;;;;2,0;;;;;;;;;;;;;;;;;;;;;;;;;;
inside;;3,0;;;;5,0;;15,0;39,0;33,0;1,0;;1,0;;10,0;19,0;;2,0;;;2,0;22,0;;1,0;;;2,0;;;1,0;;1,0;50,0;;7,0;2,0;;;;;3,0;;9,0;1,0;4,0;8,0;6,0;50,0;6,0;11,0;81,0;7,0;;1,0;5,0;12,0;23,0;;;;18,0;3,0;8,0;;5,0;;1,0;27,0;11,0;12,0;;;3,0;;6,0;2,0;;1,0;;87,0;1,0;8,0;1,0;30,0;;;;10,0;;;50,0;;;5,0;2,0;2,0;17,0;;18,0;;;14,0;25,0;27,0;;6,0;11,0;;;2,0;2,0;4,0;6,0;;;1,0;62,0;38,0;1,0;2,0;1,0;4,0;4,0;3,0;3,0;;;;;;1,0;;1,0;2,0;1,0;;;;;;2,0;;;24,0;;;;18,0;5,0;2,0;;;1,0;13,0;3,0;;20,0;;2,0;2,0;;7,0;44,0;4,0;;2,0;9,0;6,0;1,0;;;;3,0;8,0;;;13,0;15,0;;;6,0;52,0;1,0;12,0;;7,0;3,0;12,0;;;;2,0;2,0;18,0;;5,0;;2,0;2,0;24,0;9,0;1,0;1,0;6,0;;5,0;2,0;;2,0;8,0;2,0;;;1,0;;3,0;7,0;2,0;4,0;11,0;137,0;;9,0;2,0;1,0;7,0;3,0;;38,0;;50,0;11,0;17,0;70,0;6,0;3,0;2,0;23,0;9,0;16,0;;;1,0;2,0;;;;;3,0;4,0;11,0;;;;1,0;;17,0;7,0;10,0;1,0;3,0;6,0;6,0;1,0;3,0;;14,0;11,0;3,0;;4,0;8,0;11,0;;;3,0;;4,0;12,0;119,0;2,0;;;1,0;;1,0;;;;3,0;48,0;;1,0;;29,0;1,0;2,0;16,0;6,0;;11,0;2,0;15,0;;;;1,0;3,0;3,0;3,0;10,0;49,0;;1,0;14,0;;5,0;4,0;;15,0;;2,0;1,0;3,0;2,0;;4,0;15,0;;7,0;3,0;2,0;;;1,0;;3,0;15,0;3,0;16,0;1,0;;;3,0;28,0;4,0;5,0;3,0;;2,0;;;;;1,0;2,0;2,0;1,0;10,0;4,0;;10,0;;7,0;16,0;;;;3,0;;;1,0;;;;;2,0;;7,0;3,0;6,0;3,0;5,0;4,0;;;3,0;;;16,0;;5,0;;1,0;8,0;4,0;;;7,0;;;;1,0;6,0;;;;;;;;;;;;;;;;;;;8,0;;;;1,0;3,0;;;;;;2,0;17,0;;;;4,0;;7,0;3,0;3,0;;;2,0;;2,0;;;4,0;;;;;1,0;1,0;5,0;3,0;;;;3,0;;;;1,0;;1,0;3,0;;;;;6,0;;;;;19,0;2,0;2,0;;2,0;;;;;;;;2,0;;;;3,0;;;1,0;;14,0;3,0;1,0;1,0;;1,0;2,0;;;1,0;;;;13,0;;;2,0;;1,0;;;;1,0;3,0;1,0;;1,0;3,0;;1,0;;;;1,0;;;1,0;;;1,0;;8,0;;;;;;;;;;;;;;;;2,0;2,0;1,0;;;6,0;;10,0;;3,0;;1,0;;2,0;;;7,0;;1,0;13,0;11,0;;;;;;;2,0;;;;1,0;;;;;;20,0;2,0;;;;;21,0;;;;;5,0;;;;;;;3,0;3,0;1,0;;;;;;;;1,0;;2,0;;36,0;;;;;5,0;;4,0;;;;10,0;;;;;;;;;;11,0;3,0;;;;;4,0;;;1,0;;45,0;9,0;;;;2,0;;6,0;1,0;1,0;;;3,0;;;;;;;;;;5,0;2,0;2,0;;;3,0;;1,0;6,0;2,0;;;;;;;;;2,0;;1,0;;2,0;;;;;5,0;;;;;;12,0;;;;;1,0;7,0;;;4,0;1,0;;14,0;6,0;1,0;1,0;11,0;1,0;;11,0;;2,0;;;1,0;;2,0;;3,0;;3,0;1,0;10,0;;;7,0;;;;;10,0;;;4,0;;2,0;;;;;;;;;;1,0;;;1,0;;2,0;1,0;;;;;;18,0;;;;;;;;;;1,0;;;;;1,0;;;;;;;;;1,0;3,0;;2,0;;3,0;;;;;1,0;;2,0;;;;;;3,0;;;;1,0;;;;;;;2,0;;;1,0;;;;;;;;;;;;;;;;;;;;;;3,0;;;;7,0;;;;;;;;;;;;;;;;;1,0;;;;;;;;;1,0;;;;;;;;;;4,0;;;;;;;;3,0;;;;1,0;2,0;1,0;1,0;;;;2,0;;;;;;;6,0;;;;;;;;;;;;;;3,0;;;;4,0;;1,0;;;;;;;;;;2,0;;;;;;;;8,0;;;1,0;;;;;;;;1,0;;;;;1,0;;2,0;;;;;;;;;;;;;;;;;;;
install;;1,0;;;;;;27,0;6,0;;;;4,0;;4,0;15,0;;;;3,0;2,0;8,0;;;;;;;;;10,0;1,0;22,0;;20,0;4,0;;2,0;;;;;1,0;;3,0;3,0;5,0;60,0;13,0;8,0;;1,0;;;7,0;;4,0;;1,0;;;7,0;1,0;2,0;5,0;2,0;15,0;10,0;14,0;12,0;;;1,0;5,0;;;5,0;1,0;;31,0;;16,0;;27,0;;2,0;;;4,0;3,0;91,0;;1,0;;;1,0;2,0;;26,0;4,0;;;26,0;5,0;;7,0;14,0;1,0;2,0;4,0;;1,0;1,0;2,0;;4,0;19,0;33,0;;3,0;;1,0;;3,0;3,0;2,0;;;;1,0;;2,0;1,0;5,0;;;;;;;;;4,0;26,0;2,0;;3,0;20,0;5,0;1,0;;;2,0;5,0;;;37,0;;;;1,0;;97,0;;;1,0;7,0;3,0;;;5,0;;;1,0;;;16,0;5,0;1,0;;5,0;38,0;;3,0;1,0;17,0;1,0;12,0;;;;6,0;;16,0;;2,0;2,0;;5,0;7,0;;;;4,0;;9,0;;;;8,0;;;;;6,0;;;;;16,0;69,0;;;;;1,0;;;18,0;;19,0;;10,0;24,0;9,0;6,0;;5,0;1,0;4,0;;8,0;;;;;;;;1,0;11,0;;;;2,0;11,0;4,0;1,0;;;;;;;;1,0;2,0;7,0;1,0;;;3,0;4,0;;;5,0;;5,0;2,0;12,0;1,0;;3,0;;;;;;;8,0;27,0;3,0;;;7,0;;1,0;1,0;2,0;;7,0;6,0;6,0;;;1,0;;;3,0;;;10,0;2,0;3,0;;;1,0;;;15,0;;;2,0;1,0;10,0;1,0;1,0;;;;;8,0;;;;;3,0;10,0;;23,0;;;1,0;;;6,0;;10,0;;;1,0;;;;2,0;;;1,0;6,0;;;;1,0;;;;;14,0;1,0;;;;3,0;;;;1,0;;5,0;1,0;;;;;1,0;;1,0;;;11,0;2,0;5,0;4,0;11,0;1,0;4,0;3,0;;11,0;;;;1,0;2,0;1,0;5,0;;;;;;;;;6,0;;;;;;;1,0;;;;;;;;;;1,0;2,0;1,0;4,0;;;2,0;;;3,0;1,0;3,0;;1,0;5,0;4,0;;1,0;;;;3,0;;;;2,0;;;;2,0;;1,0;;;;;;;1,0;;;;;10,0;;;;;;7,0;;1,0;1,0;;;;;;;;;;1,0;;1,0;;22,0;15,0;;6,0;;5,0;;2,0;;2,0;1,0;;;;7,0;;3,0;;;6,0;;;;;1,0;9,0;2,0;;;;;;;;;;;;16,0;2,0;;;;;13,0;;;;;;2,0;;;;;;;;4,0;;;4,0;7,0;;;;4,0;;2,0;;3,0;;;2,0;;1,0;1,0;;1,0;;6,0;3,0;;;3,0;;;7,0;2,0;;;1,0;1,0;;;;20,0;;3,0;3,0;;1,0;;1,0;;;;;4,0;;;;;;;1,0;;;;;;;;;;;1,0;;;;;;;3,0;;;2,0;1,0;;6,0;9,0;6,0;;;;3,0;1,0;;;;;;3,0;;1,0;;;6,0;;3,0;;19,0;;;;;;;;;;6,0;;6,0;1,0;;;;;;;1,0;;;1,0;2,0;5,0;;3,0;;;;;;;;;;;1,0;;1,0;;;;;;5,0;4,0;;5,0;3,0;;;;;16,0;;;3,0;;1,0;;;2,0;1,0;;1,0;8,0;1,0;;;;;;;;;;3,0;;1,0;;;;;5,0;;;5,0;;;1,0;2,0;;;2,0;;4,0;2,0;2,0;1,0;;;;11,0;;;2,0;;;;;;1,0;;;;2,0;;;;;;;;;;;1,0;;;;;;;1,0;;;;;;;;;;;;1,0;;;;1,0;;;;3,0;;;;;1,0;;;;;2,0;;;1,0;;;;1,0;;;;;2,0;;7,0;;;;;;;;;;;;3,0;;;;;2,0;;;;;;;;;;;;;1,0;;;;;;;;2,0;;3,0;;;;;;;;;;;;;;;;;;;;;;;;;1,0;;;;;2,0;;;;;5,0;;;;;1,0;;;;;;;1,0;;2,0;2,0;;;;;;;;;;;;1,0;;;2,0;;;;;;;1,0;;1,0;;;1,0;;;;;;;;;;;;;;;;;;;2,0;;;;;;;3,0;;;;;;;;;;;;;;1,0;;;;;
instruct;;5,0;;;;;;13,0;5,0;;;;;;;8,0;;;;;2,0;28,0;;;;;8,0;2,0;;;10,0;;21,0;;24,0;15,0;;;;;23,0;2,0;2,0;6,0;;4,0;2,0;102,0;;82,0;;;;;1,0;;;;;2,0;;;;5,0;;;1,0;;;;;;14,0;15,0;;;;;2,0;53,0;;3,0;;21,0;14,0;75,0;1,0;;;1,0;3,0;;2,0;;;10,0;2,0;;28,0;3,0;;;13,0;3,0;;2,0;1,0;2,0;5,0;;;15,0;;;;7,0;5,0;20,0;;;;;9,0;11,0;31,0;12,0;;;;1,0;;2,0;;;2,0;;;5,0;4,0;;5,0;;2,0;13,0;;;;;18,0;1,0;1,0;;2,0;9,0;2,0;;13,0;;1,0;1,0;;;55,0;;;;2,0;;;;3,0;;;;;;11,0;;1,0;;;1,0;;;;1,0;;;;;;;;;;;;;;;;;1,0;7,0;;;;;1,0;;;;;;;;;;2,0;;;;;1,0;;;;2,0;1,0;;;;;;1,0;5,0;;6,0;;;;;;3,0;;;;3,0;1,0;;;;;;;;9,0;;;;;;;17,0;;;;;1,0;;;;;;;;30,0;;;;9,0;;;;;21,0;;;;;11,0;;;;;;;;;;1,0;2,0;;;;;;;;;;;;;2,0;;;;;;;;;;2,0;;;;;;;;;;;;;2,0;3,0;;;;;;4,0;;;;;;;;;;;;;1,0;32,0;;;;;;;;;;;;;7,0;;;;;;;;;;;;;;2,0;;;;;;13,0;;3,0;;1,0;;2,0;;;;;;;;;;;;2,0;13,0;;2,0;;3,0;;;;;2,0;;;3,0;1,0;;;;;;3,0;;12,0;;;;;;;21,0;;25,0;;2,0;;;2,0;40,0;1,0;;14,0;;;;16,0;1,0;2,0;;;;18,0;;;;;;;;;1,0;;;;;;21,0;2,0;2,0;;;2,0;16,0;;;;;;;;;;;;;6,0;;;;;;;;;;6,0;1,0;;1,0;;1,0;;;1,0;;3,0;;1,0;;;;;;;;3,0;;;;1,0;;;6,0;;;;;;2,0;;1,0;;;;;;;;;3,0;;2,0;;;;;;;;;;14,0;;2,0;;;;14,0;;;1,0;;;;;;;;;;1,0;;;;;;11,0;;15,0;;;1,0;;2,0;;;;;;;;;;6,0;14,0;;;;;;;1,0;;2,0;;;2,0;;;;;2,0;6,0;;;1,0;;;;4,0;;;;;;;7,0;1,0;;;;;;2,0;;;;;;;;;;;2,0;;;;;;;;;;;;;;;;;;5,0;;;;;;;;;;;;;;;;;;;;;;;;;;;;;;;;;6,0;;;;8,0;;;;7,0;;;;;;;;;;;;;;;;;;;;1,0;;;6,0;;;2,0;;;;;;;;;;;;;1,0;;;;;;;;;;;;;;;;;;;;;;;;;;;;;;;;;;;;;;;;;;;1,0;1,0;;;;;;;;;;;;;;;;;;;;;;;;;;;;;4,0;;;;1,0;1,0;;;;;;;;;;;;;;;;1,0;;;;;;;;1,0;;;;2,0;;;;4,0;;;;;;;;;;;;;;;;2,0;;;;;;;;;11,0;;;;;;;;;;;;;;1,0;;;;;;;;;;;;;;;7,0;;1,0;;;;;;;;;2,0;;;;;;;;;;;;;;;;;;;;;;;;;;;;;;;;;;;1,0;;;;;;;;;;;;;;;;;;;1,0;1,0;;;;2,0;;;;;;;;;;;;;;;
integrate;;3,0;;1,0;5,0;16,0;3,0;34,0;2,0;3,0;38,0;;2,0;;1,0;34,0;8,0;;6,0;;;14,0;1,0;8,0;;1,0;9,0;6,0;4,0;;5,0;1,0;67,0;2,0;66,0;9,0;2,0;1,0;21,0;2,0;76,0;4,0;8,0;8,0;13,0;7,0;120,0;117,0;66,0;53,0;6,0;17,0;1,0;;9,0;7,0;16,0;;13,0;1,0;2,0;2,0;6,0;59,0;13,0;7,0;14,0;41,0;24,0;5,0;8,0;2,0;21,0;2,0;;1,0;6,0;2,0;13,0;223,0;2,0;47,0;1,0;79,0;;7,0;;;;7,0;73,0;;;;1,0;4,0;3,0;;112,0;14,0;;;62,0;1,0;;;24,0;2,0;37,0;4,0;3,0;17,0;1,0;6,0;;82,0;29,0;39,0;16,0;27,0;1,0;1,0;8,0;42,0;19,0;2,0;;8,0;;17,0;;1,0;5,0;;8,0;7,0;25,0;2,0;6,0;;7,0;;;72,0;6,0;;;6,0;77,0;;7,0;1,0;1,0;16,0;3,0;10,0;151,0;;3,0;2,0;1,0;8,0;219,0;5,0;;;29,0;2,0;5,0;1,0;1,0;;2,0;1,0;28,0;3,0;25,0;10,0;;;12,0;13,0;;;8,0;285,0;;12,0;;;;;;5,0;2,0;6,0;16,0;;1,0;7,0;;;;12,0;;2,0;;21,0;16,0;3,0;2,0;3,0;1,0;2,0;2,0;2,0;1,0;2,0;;4,0;69,0;4,0;1,0;4,0;;;3,0;;85,0;2,0;5,0;1,0;2,0;43,0;4,0;5,0;;;;2,0;;15,0;;4,0;3,0;1,0;3,0;;86,0;6,0;1,0;;;;;2,0;16,0;8,0;;;;7,0;6,0;16,0;5,0;1,0;;4,0;9,0;;1,0;16,0;2,0;;;3,0;2,0;5,0;72,0;38,0;6,0;3,0;6,0;;;36,0;;1,0;2,0;5,0;36,0;;1,0;2,0;4,0;;;1,0;3,0;1,0;4,0;2,0;8,0;;1,0;1,0;1,0;1,0;6,0;;1,0;10,0;69,0;;3,0;6,0;;3,0;;15,0;;1,0;;;15,0;7,0;;2,0;;;2,0;;;;;4,0;;6,0;4,0;2,0;;;2,0;;2,0;;3,0;11,0;7,0;8,0;2,0;;2,0;16,0;;;4,0;4,0;8,0;;1,0;1,0;1,0;6,0;;;;2,0;2,0;2,0;8,0;2,0;;1,0;;;2,0;;1,0;;;;;4,0;;7,0;;;;17,0;;15,0;6,0;1,0;;1,0;;;8,0;;13,0;36,0;1,0;7,0;2,0;1,0;3,0;16,0;;34,0;11,0;3,0;8,0;1,0;4,0;;;5,0;1,0;;;;11,0;34,0;;;1,0;7,0;;;2,0;7,0;22,0;7,0;4,0;;;1,0;10,0;;4,0;11,0;6,0;3,0;6,0;27,0;3,0;;;8,0;;;;8,0;3,0;31,0;6,0;7,0;;2,0;25,0;3,0;2,0;4,0;;;;3,0;51,0;2,0;;;;1,0;12,0;;2,0;16,0;2,0;1,0;2,0;;1,0;;;15,0;;2,0;;1,0;;;3,0;;;2,0;7,0;;13,0;;6,0;4,0;14,0;1,0;2,0;;1,0;;12,0;1,0;;12,0;;;;1,0;2,0;5,0;;4,0;;2,0;;8,0;;;;1,0;2,0;10,0;;4,0;;2,0;28,0;;5,0;2,0;;3,0;2,0;2,0;;;2,0;1,0;;;;1,0;;10,0;4,0;1,0;;6,0;;1,0;3,0;;6,0;;6,0;1,0;;2,0;;15,0;3,0;1,0;1,0;2,0;4,0;3,0;1,0;2,0;2,0;2,0;;2,0;;;;;3,0;27,0;;;2,0;2,0;;;1,0;3,0;;;6,0;;;;3,0;;;;;22,0;;;;;;;1,0;1,0;7,0;;;1,0;;;29,0;;;2,0;5,0;;22,0;17,0;3,0;;2,0;;;1,0;1,0;;6,0;3,0;;3,0;;;1,0;;3,0;;;;7,0;3,0;;6,0;;1,0;5,0;;;;2,0;1,0;1,0;4,0;;;14,0;;1,0;1,0;;1,0;5,0;;;;;;;;;5,0;;1,0;;29,0;;1,0;;;2,0;1,0;;;3,0;;;3,0;;;2,0;8,0;;;2,0;;;;5,0;;;2,0;2,0;;10,0;;;;2,0;;3,0;;1,0;6,0;2,0;;;2,0;;30,0;;;3,0;;;1,0;2,0;2,0;;;;;1,0;;;1,0;1,0;5,0;;;7,0;;;;;;;3,0;;;1,0;;2,0;;1,0;1,0;1,0;;;3,0;;;3,0;3,0;3,0;6,0;;;21,0;;;;;1,0;;;;1,0;;;;12,0;;;6,0;1,0;;1,0;;;;2,0;6,0;8,0;;47,0;;2,0;2,0;;71,0;5,0;;1,0;;1,0;;1,0;2,0;;;;;;7,0;1,0;8,0;;;;1,0;4,0;3,0;2,0;3,0;3,0;1,0;4,0;;;;;9,0;;;1,0;3,0;;;;;;;;1,0;4,0;;;2,0;2,0;;;;1,0;;;;;;2,0;2,0;;;;4,0;;;9,0;;1,0;;1,0;;1,0;;;;;;1,0;;;1,0;;;;;;;;;3,0;2,0;;;;1,0;;;;;;;;;;1,0;;1,0;;;;;1,0;;;;2,0;;12,0;;;;1,0;2,0;;;;3,0;;4,0;;;;;;9,0;;;;3,0;;;2,0;;;;;;11,0;;;6,0;;;2,0;3,0;;;;;;;;1,0;;;;;2,0;;;;;;;4,0;;1,0;;;;;;2,0;;;;;;;
interface;;6,0;;31,0;1,0;7,0;5,0;57,0;12,0;4,0;3,0;;54,0;2,0;21,0;41,0;14,0;;1,0;1,0;12,0;55,0;12,0;8,0;1,0;;11,0;1,0;1,0;;50,0;1,0;213,0;1,0;217,0;48,0;2,0;;4,0;8,0;270,0;2,0;20,0;21,0;27,0;5,0;43,0;374,0;107,0;292,0;19,0;20,0;;3,0;4,0;3,0;58,0;1,0;;1,0;16,0;32,0;18,0;10,0;5,0;6,0;11,0;22,0;35,0;13,0;30,0;6,0;24,0;;1,0;17,0;10,0;4,0;1,0;383,0;2,0;42,0;6,0;206,0;;26,0;4,0;;;2,0;42,0;3,0;4,0;;3,0;8,0;60,0;1,0;136,0;46,0;24,0;3,0;208,0;75,0;2,0;30,0;18,0;3,0;114,0;27,0;5,0;14,0;12,0;2,0;;94,0;66,0;64,0;46,0;6,0;;8,0;19,0;58,0;114,0;70,0;;;;2,0;;5,0;8,0;;9,0;3,0;8,0;47,0;;;17,0;1,0;16,0;129,0;24,0;;1,0;29,0;139,0;18,0;6,0;1,0;54,0;27,0;;5,0;197,0;;6,0;9,0;4,0;54,0;114,0;;;1,0;82,0;34,0;2,0;;4,0;;2,0;6,0;1,0;;15,0;15,0;;3,0;7,0;54,0;3,0;;11,0;48,0;1,0;23,0;;;5,0;;;103,0;;9,0;34,0;;1,0;11,0;;2,0;;20,0;;3,0;1,0;2,0;;18,0;7,0;1,0;6,0;;;2,0;;;;6,0;29,0;;;3,0;12,0;1,0;6,0;;34,0;;14,0;;1,0;64,0;1,0;;13,0;19,0;5,0;;;14,0;;19,0;;6,0;1,0;30,0;7,0;8,0;1,0;;;3,0;;;274,0;15,0;;2,0;;;16,0;60,0;;1,0;12,0;;15,0;;;14,0;7,0;;1,0;;6,0;11,0;1,0;43,0;16,0;7,0;5,0;;;19,0;;70,0;;7,0;17,0;1,0;;1,0;1,0;;;;14,0;;1,0;26,0;6,0;;5,0;;;8,0;10,0;;;;14,0;;2,0;1,0;;35,0;;105,0;;12,0;3,0;1,0;;10,0;10,0;6,0;;7,0;;1,0;;7,0;;1,0;9,0;7,0;1,0;;6,0;;6,0;13,0;5,0;2,0;8,0;;57,0;2,0;;;2,0;1,0;;;10,0;13,0;7,0;5,0;2,0;2,0;;3,0;7,0;;1,0;11,0;9,0;;1,0;;8,0;2,0;;1,0;;1,0;2,0;1,0;;;9,0;;1,0;;1,0;;;12,0;1,0;27,0;;;2,0;34,0;;;9,0;3,0;;1,0;12,0;20,0;;;;;4,0;2,0;32,0;4,0;1,0;3,0;35,0;;;;;;;3,0;3,0;3,0;;;;2,0;1,0;9,0;;200,0;4,0;;52,0;;2,0;;30,0;;4,0;3,0;2,0;1,0;154,0;23,0;25,0;28,0;18,0;1,0;1,0;;;39,0;12,0;12,0;23,0;6,0;;;4,0;54,0;7,0;2,0;;1,0;4,0;;11,0;4,0;;;12,0;3,0;1028,0;3,0;;;2,0;1,0;17,0;;3,0;3,0;6,0;;7,0;7,0;;;;8,0;4,0;15,0;;3,0;9,0;32,0;;;8,0;20,0;35,0;7,0;16,0;;;;17,0;5,0;7,0;129,0;;26,0;9,0;;2,0;1,0;11,0;1,0;5,0;19,0;54,0;;2,0;;11,0;14,0;5,0;56,0;9,0;;12,0;49,0;;4,0;18,0;;4,0;;5,0;;2,0;;7,0;11,0;2,0;11,0;;37,0;37,0;;;6,0;4,0;3,0;1,0;4,0;6,0;23,0;11,0;1,0;2,0;;;42,0;55,0;164,0;45,0;;25,0;4,0;17,0;3,0;;59,0;2,0;;8,0;5,0;3,0;6,0;;11,0;6,0;;;8,0;10,0;13,0;3,0;8,0;;1,0;15,0;;19,0;7,0;5,0;2,0;9,0;3,0;24,0;11,0;;18,0;1,0;;;;2,0;5,0;;10,0;3,0;1,0;;4,0;12,0;5,0;;2,0;9,0;3,0;2,0;;41,0;14,0;6,0;;;;2,0;2,0;5,0;5,0;7,0;13,0;7,0;;;3,0;22,0;;2,0;23,0;1,0;2,0;12,0;16,0;;123,0;1,0;;;6,0;;;;;1,0;1,0;;;24,0;;;;12,0;;7,0;1,0;;1,0;;3,0;;;4,0;;;5,0;;3,0;1,0;2,0;;1,0;;15,0;;7,0;1,0;7,0;1,0;2,0;;;5,0;;;;10,0;1,0;;;4,0;;5,0;3,0;;2,0;;2,0;;16,0;;;;;;;;;9,0;;;29,0;2,0;5,0;;3,0;4,0;;2,0;1,0;8,0;2,0;11,0;2,0;18,0;;;;13,0;;1,0;;3,0;;10,0;1,0;3,0;;;;;3,0;40,0;;6,0;;;5,0;1,0;;;1,0;;6,0;;5,0;2,0;2,0;;2,0;;;;1,0;1,0;28,0;;;;;2,0;;;6,0;;;;;;;;;9,0;2,0;;1,0;5,0;;2,0;;3,0;1,0;;4,0;;;;;;;4,0;;;;9,0;;1,0;1,0;2,0;;2,0;3,0;;;3,0;;;8,0;;;1,0;;;3,0;4,0;1,0;2,0;1,0;4,0;;4,0;;;;2,0;21,0;4,0;;12,0;;1,0;1,0;2,0;;5,0;;2,0;;1,0;7,0;3,0;2,0;;;;;15,0;;;;9,0;;2,0;2,0;3,0;;;1,0;1,0;;1,0;3,0;19,0;;;2,0;4,0;;;;1,0;;;3,0;2,0;2,0;4,0;1,0;1,0;;;;2,0;;;3,0;;;;;1,0;1,0;;;;;;4,0;;11,0;;1,0;;;4,0;;5,0;2,0;;;;;;4,0;2,0;;;2,0;3,0;;2,0;;1,0;1,0;;;;5,0;;;;5,0;;1,0;;;3,0;;14,0;;;7,0;;;;;;;;1,0;;12,0;;;4,0;;;;;;;;3,0;2,0;;;10,0;;1,0;;;;13,0;
interior;;35,0;;;;60,0;6,0;3,0;12,0;7,0;;;5,0;;6,0;29,0;4,0;;;;;2,0;;11,0;;;2,0;;5,0;;;;34,0;;5,0;;;;;;3,0;10,0;55,0;;;;1,0;19,0;;19,0;48,0;5,0;;;3,0;2,0;158,0;;;;30,0;6,0;5,0;2,0;2,0;1,0;1,0;88,0;2,0;9,0;;;1,0;;;;3,0;2,0;2,0;25,0;;7,0;;50,0;12,0;;;;;19,0;46,0;;;20,0;;;;;9,0;1,0;;;19,0;5,0;3,0;;33,0;;3,0;;1,0;;;;;5,0;64,0;29,0;1,0;;1,0;;;;;;;;3,0;;;;4,0;;;;;;;;1,0;;;35,0;;;;160,0;4,0;8,0;;;;1,0;;;386,0;;;;;1,0;8,0;;2,0;3,0;5,0;10,0;1,0;;;4,0;4,0;7,0;;1,0;287,0;7,0;3,0;;3,0;13,0;3,0;22,0;;4,0;4,0;13,0;;;2,0;7,0;;39,0;;71,0;;;;39,0;4,0;1,0;2,0;49,0;;1,0;;3,0;;31,0;;;;;2,0;;2,0;4,0;1,0;11,0;214,0;;2,0;;;;27,0;;9,0;;28,0;1,0;842,0;114,0;2,0;5,0;2,0;25,0;;11,0;4,0;1,0;;1,0;;;;;1,0;4,0;8,0;;2,0;;4,0;;40,0;;6,0;;3,0;2,0;6,0;;2,0;;6,0;18,0;;;1,0;2,0;78,0;;;4,0;;53,0;10,0;126,0;;;5,0;4,0;;;;;5,0;2,0;136,0;2,0;;;26,0;;;78,0;1,0;;2,0;5,0;111,0;;;2,0;;2,0;;;;53,0;1,0;1,0;29,0;;11,0;4,0;;20,0;;17,0;3,0;1,0;5,0;1,0;8,0;;2,0;;;5,0;;5,0;4,0;;4,0;3,0;;;7,0;;;;;;1,0;;6,0;;2,0;;;;;54,0;;65,0;;;;1,0;;3,0;;;;6,0;2,0;;;;2,0;;;3,0;4,0;1,0;;;;5,0;;21,0;;2,0;18,0;1,0;;10,0;13,0;1,0;;1,0;4,0;;;23,0;8,0;;;;2,0;6,0;;1,0;;;1,0;;;;;;;18,0;3,0;2,0;1,0;;;;3,0;;;;;;;;;;;;1,0;;;1,0;2,0;;10,0;;1,0;;;28,0;;;;;;;;;;4,0;;3,0;;;1,0;;;;;;1,0;;;3,0;;;;;4,0;;;;2,0;;;1,0;;55,0;;;;;;;;2,0;;;1,0;;;1,0;1,0;;1,0;;2,0;;;;;;;;;20,0;;;;;;;;;;;4,0;9,0;;1,0;1,0;13,0;;32,0;;;;1,0;;;1,0;7,0;;;;5,0;;;;;;;;;;2,0;1,0;;;1,0;;1,0;1,0;17,0;;1,0;1,0;;1,0;;;26,0;;;2,0;;11,0;6,0;1,0;4,0;6,0;25,0;;1,0;;91,0;;;;;;;1,0;;;;;7,0;1,0;;;;;;20,0;;2,0;;;;;;;;1,0;;;;10,0;;1,0;1,0;;;;;2,0;;;;41,0;2,0;1,0;;;;;5,0;;7,0;2,0;;;;;;;;;;;16,0;;;;;;12,0;4,0;98,0;;;23,0;;1,0;;6,0;;;6,0;;;;;1,0;1,0;;;49,0;12,0;;;;;;;150,0;;4,0;;;2,0;;3,0;4,0;;;3,0;;3,0;;;;;716,0;;;;2,0;;;;;33,0;1,0;;;;;2,0;;;;1,0;;12,0;6,0;;;;3,0;7,0;;;;;;;;;;7,0;;;;1,0;;1,0;;;4,0;;;;;1,0;;9,0;;;2,0;;;;;;;;3,0;;;;1,0;;;;;;;3,0;;5,0;;;;;;;;;7,0;;;1,0;;;;;;;;;1,0;;;;;;;;1,0;;;;;;;;1,0;;;;;;;;;;;;;;;;;;;;1,0;;;;;;;;2,0;26,0;;;;;;;;;;;;;;1,0;3,0;;;;;;;;;;;;;;;;;;;;;;;1,0;;;;;;;2,0;;;;;1,0;;;;;2,0;;;;;;;;;;;7,0;;;1,0;;4,0;;;1,0;;1,0;;;;;1,0;;4,0;;;;;;;;;;;33,0;;;1,0;;1,0;;;;;;;1,0;;;;;;;;;;;;;4,0;;;;;;;;2,0;;;;;;;;3,0;;;;;;3,0;;;;;;;;;;;;;;;
intermediate;;74,0;;4,0;;2,0;6,0;5,0;8,0;16,0;3,0;;18,0;;2,0;42,0;;;2,0;;;13,0;;7,0;;6,0;7,0;1,0;;4,0;;1,0;24,0;;13,0;1,0;;;;;32,0;;4,0;1,0;13,0;3,0;24,0;53,0;7,0;14,0;16,0;4,0;2,0;;5,0;3,0;25,0;;;1,0;1,0;;5,0;;8,0;4,0;;34,0;142,0;9,0;1,0;;39,0;4,0;;8,0;14,0;;;174,0;;6,0;;57,0;;19,0;28,0;;2,0;5,0;121,0;;;3,0;;1,0;9,0;;36,0;;;;8,0;10,0;;2,0;11,0;;23,0;1,0;;8,0;;;;130,0;51,0;37,0;2,0;7,0;;;22,0;24,0;13,0;;;;;;4,0;4,0;2,0;3,0;;32,0;8,0;3,0;1,0;;;;8,0;17,0;10,0;;;10,0;42,0;10,0;3,0;;1,0;9,0;1,0;4,0;30,0;1,0;2,0;23,0;1,0;9,0;44,0;;;;66,0;23,0;;;6,0;;2,0;7,0;;10,0;5,0;;;;1,0;41,0;4,0;2,0;3,0;6,0;;1,0;;;3,0;;2,0;18,0;;1,0;;4,0;;11,0;;1,0;;1,0;2,0;;3,0;;29,0;2,0;5,0;15,0;;1,0;;;;1,0;7,0;6,0;;;2,0;;;2,0;15,0;;41,0;;35,0;;;38,0;2,0;2,0;;20,0;6,0;4,0;3,0;;;3,0;;;;;11,0;36,0;41,0;;1,0;;;;16,0;;;;;;;2,0;3,0;;3,0;;8,0;;3,0;7,0;13,0;;;1,0;1,0;5,0;11,0;11,0;22,0;10,0;45,0;1,0;;7,0;;;;;3,0;5,0;;4,0;;;1,0;2,0;3,0;;;1,0;42,0;1,0;;;;1,0;;4,0;;;;;7,0;5,0;;40,0;1,0;4,0;;;1,0;;3,0;;;;2,0;;;;2,0;;;;7,0;2,0;4,0;;;;1,0;;1,0;;;;1,0;;;;;;;2,0;;24,0;;;;;2,0;1,0;;;;;;;1,0;2,0;;;9,0;1,0;;;2,0;;;;;2,0;;2,0;;;;5,0;1,0;30,0;;;;6,0;;;;;;;;;;;;;2,0;21,0;;1,0;2,0;;2,0;;1,0;1,0;;6,0;;;2,0;;;;;;;1,0;;19,0;2,0;6,0;1,0;;;1,0;10,0;;;8,0;1,0;;5,0;5,0;17,0;;7,0;;;;;;;19,0;7,0;9,0;;;;;;;;;;;2,0;;;;;;;;5,0;;7,0;;4,0;3,0;;20,0;;;12,0;3,0;1,0;6,0;;;;;;;;;1,0;;;;;;10,0;;58,0;;;;;2,0;4,0;;;;;3,0;;;;3,0;153,0;4,0;;;;1,0;;;;;4,0;10,0;;;1,0;;;2,0;;2,0;;;;10,0;1,0;;;1,0;1,0;;2,0;1,0;;1,0;;;;;;;;8,0;;;13,0;6,0;;;;;;;;2,0;2,0;;;;;;;;;;;;;2,0;16,0;;;1,0;;;;;;;1,0;;;;;5,0;;;;;;;2,0;;7,0;;;;;;;;;1,0;2,0;;16,0;;;3,0;;;;13,0;;;2,0;2,0;;;9,0;;1,0;;;;;;;;;3,0;;;;3,0;;;;;;24,0;;;;;;1,0;1,0;4,0;1,0;2,0;;;;;1,0;;1,0;;;;6,0;;3,0;6,0;;;;;;4,0;;;;;;11,0;4,0;;;;;;3,0;;;;;;;;4,0;3,0;;;;;12,0;;;;4,0;;;;11,0;;1,0;2,0;;;;12,0;;;;3,0;;;;;;1,0;1,0;13,0;;;;;;;;;;;;;;;;;;;;;;;1,0;;;11,0;;;;;;;1,0;2,0;18,0;;;;1,0;1,0;;;;4,0;;;2,0;5,0;6,0;;;;;;;;8,0;;;;;;;;1,0;;;;;;;;;;;;1,0;;;;;;;;;2,0;;;;;;3,0;;;;1,0;;;;;;6,0;;1,0;;;;;;;;;;;;;1,0;;;;;;;4,0;;;7,0;;7,0;;;;;;;;;7,0;;;;;;;;11,0;;;;;;;;3,0;;;1,0;;;4,0;1,0;10,0;;;;;;1,0;;;3,0;;1,0;1,0;;;7,0;21,0;;5,0;;;;;;;5,0;;;;;19,0;;40,0;;;;;;1,0;;;;;;;;;5,0;;;;;;;1,0;;;1,0;;;;;4,0;;;;;;;10,0;;;;44,0;38,0;;;;;;;;;;;;;;;;;3,0;
item;;1,0;;;5,0;;;20,0;12,0;;;;41,0;1,0;;20,0;;;;;;12,0;1,0;;3,0;;7,0;;;;2,0;;8,0;;3,0;;;;4,0;;83,0;;2,0;;2,0;2,0;44,0;31,0;2,0;92,0;4,0;;;;;;10,0;;;;;;5,0;3,0;2,0;;;3,0;5,0;;3,0;;9,0;;;1,0;22,0;;;120,0;;3,0;;64,0;;4,0;;;;;;69,0;2,0;;;7,0;;;51,0;11,0;16,0;;;26,0;;1,0;;1,0;4,0;9,0;;13,0;1,0;;;56,0;16,0;20,0;1,0;;1,0;;6,0;34,0;;2,0;;1,0;;;;;2,0;;8,0;;7,0;13,0;;;7,0;2,0;1,0;10,0;39,0;;;;13,0;2,0;10,0;;5,0;11,0;;;18,0;;;;7,0;4,0;10,0;;1,0;;13,0;4,0;;;1,0;;;3,0;1,0;1,0;;;;;;2,0;;;;;;;;;1,0;;;1,0;;;19,0;;;;;;;6,0;;;;;;;;;;;;;;;;;1,0;;;;;;;;;;;;;2,0;1,0;1,0;2,0;1,0;;;2,0;2,0;;3,0;;;;4,0;2,0;;;;;;;;34,0;;;;;;1,0;22,0;;;;;;;;;1,0;;;;;;;4,0;1,0;;1,0;;;4,0;3,0;1,0;;;1,0;;;;;;;;3,0;;;;10,0;;1,0;;;;;;;2,0;;;;;1,0;1,0;;;;;;;;;;;;;;;;;;;;;;;;;;;;;1,0;;;;;;;8,0;;;10,0;;3,0;;;;;;;;;;;;1,0;;;;;;;;1,0;;;;;;;;;2,0;;;1,0;3,0;;;;;;1,0;5,0;;;;2,0;1,0;;;;;;1,0;2,0;15,0;7,0;1,0;;;;;;;;1,0;;;;;;28,0;;3,0;;7,0;;;3,0;;6,0;;;;;;5,0;;4,0;6,0;;4,0;3,0;;1,0;;;;4,0;7,0;2,0;;;4,0;;;;;;2,0;2,0;;;28,0;;;;2,0;19,0;;;;;;;;3,0;;;;2,0;4,0;16,0;;;;4,0;;;1,0;;;7,0;;;;;8,0;12,0;;;;2,0;;;20,0;;;8,0;;;;;;;;;;;;;;2,0;1,0;;1,0;;;2,0;2,0;2,0;1,0;;;;;;;;33,0;;3,0;;10,0;;1,0;;44,0;4,0;1,0;;;1,0;;;;;;;;;;4,0;;;4,0;1,0;;;;;;1,0;;;;;;;;;1,0;5,0;;41,0;8,0;;;;;;;;;2,0;;7,0;;;7,0;;;;;;1,0;;;;5,0;;2,0;;2,0;;;;2,0;;;;;;;;;1,0;;1,0;;2,0;;;;;;1,0;;;;;;1,0;;;1,0;;;;;;;;;;;;1,0;;;;;;;;;;;;;;;;;;;1,0;;;;;;;;;;;;;;;15,0;8,0;;;1,0;;;1,0;;;;;;1,0;;;2,0;;;;;;;;;;;6,0;;;;;;;7,0;;;;;;;;;1,0;;;;;;;;1,0;;;;7,0;;;;;;16,0;;;;;;2,0;;;;;;;;17,0;2,0;;;;;;;;;;;;;10,0;;;;;;;;;;;;;;;;;;;;;;;3,0;;;;;;;;;;;;;;;;;;;;;;;;;1,0;;;;;;;;;;;6,0;2,0;;;;;;;;;1,0;;1,0;;;;;;3,0;;1,0;7,0;;;;;;;;;;1,0;;;;;;;;;;;;;;;;;;;;;;;;1,0;;3,0;3,0;;;;;7,0;;;;;;;;;;;;;;;;;;;;;;;;;;;;;;;;;;;;;;;;;;;;;;;;;;;;;;;;3,0;;;;;;;;;;;;;;;;;;;2,0;;;;;;;4,0;;;;;;;;3,0;
latch;;5,0;;;;6,0;;9,0;;18,0;2,0;;2,0;5,0;5,0;8,0;;;;;;20,0;;;;;;2,0;;;;;44,0;;25,0;;;3,0;;;48,0;1,0;7,0;;3,0;;2,0;19,0;22,0;;25,0;1,0;;;;4,0;32,0;;;;13,0;;;;;;8,0;19,0;4,0;2,0;;;8,0;;;2,0;;;;1,0;;18,0;;43,0;;;;;3,0;;1,0;;5,0;;;;2,0;;14,0;;;;3,0;;;2,0;;1,0;113,0;;1,0;10,0;;;32,0;57,0;24,0;30,0;2,0;;3,0;;;8,0;;;;;;1,0;;4,0;2,0;;;7,0;26,0;12,0;3,0;;;;;;13,0;;;44,0;112,0;1,0;1,0;;;42,0;;7,0;7,0;;6,0;12,0;;3,0;45,0;;1,0;;;;;;;;;6,0;1,0;;;;;;4,0;4,0;;1,0;;136,0;;;;;;;;17,0;3,0;;;;;;;;;3,0;;;4,0;;;;;1,0;2,0;3,0;;;2,0;;;1,0;14,0;;;2,0;;;;2,0;;;21,0;5,0;;6,0;;2,0;3,0;2,0;12,0;8,0;;;;;83,0;;2,0;1,0;16,0;;29,0;;1,0;;;21,0;33,0;;;;;;14,0;22,0;;;5,0;;2,0;;5,0;;8,0;;;;5,0;3,0;;4,0;22,0;1,0;;;1,0;54,0;;;13,0;;;;;;20,0;;;1,0;;;;4,0;5,0;;;;;1,0;8,0;;;4,0;;;2,0;;;;;3,0;;;;2,0;;;10,0;2,0;;;3,0;4,0;;;;6,0;;;21,0;;;;2,0;2,0;;;6,0;;1,0;;;2,0;;8,0;;5,0;;;8,0;1,0;;2,0;6,0;1,0;4,0;;;12,0;5,0;;;1,0;;;;;3,0;;1,0;2,0;;;;2,0;;6,0;4,0;2,0;2,0;8,0;1,0;;;10,0;2,0;;;;1,0;;;;;3,0;;;;;;5,0;3,0;26,0;1,0;;;;;;;3,0;;;;;;;;;;;;26,0;4,0;;;;;;;;5,0;;2,0;;;;24,0;;;1,0;;;;;;1,0;;;;;;;;;;;;;;;;;4,0;;;;;;;;;1,0;;;;84,0;;;1,0;;1,0;;;1,0;;;;;;;1,0;;;;;;;;;;;;;;;;;2,0;;;;;;7,0;;;;;;;;24,0;2,0;;;4,0;;2,0;;;;3,0;;;;;;;;6,0;;;;;;2,0;;;8,0;7,0;;4,0;;;;;;4,0;;;18,0;;;13,0;;;;;;;;;;;1,0;;;;;;;;;6,0;;;;;;;;;;;;;;;;;;;8,0;;;;;;;;2,0;;;;;;;;;;3,0;;;;;;;50,0;;;;;;;;14,0;;6,0;;;;;2,0;;;4,0;;;;;6,0;59,0;;2,0;27,0;;;;;;;;;;;;;;;;;;2,0;2,0;4,0;;;;;;;;;;;;;;;;;;;;;;3,0;;;;;;;1,0;;;;;;;;;;;;;;11,0;1,0;1,0;;13,0;;;;;;;;5,0;;;;3,0;;;4,0;;;;;;;;;;;;36,0;;;;;6,0;;;;25,0;;;;;;;;;;;2,0;;;;;;;;6,0;;;;;;;;;;;;;;3,0;;;;;;;;;;;;;;;;;;;;;;;;5,0;1,0;;;;;;;;;;;;;;4,0;;;;;;;;;;80,0;;;;;;;;;;;4,0;;;;;;;;;;;;;;;;;;;;;;;;4,0;;;;;;;;;;;;;;;1,0;;;2,0;;;;;;;;;;;;;;;;;;;;;;;;;71,0;;;;;;;;;;;;;;;;;;;;;;;;16,0;;;;;;;;;3,0;;;;;;;;;;5,0;;;;;;;;;;;;;;;;;;;;;;;;;;;;;
layer;;1,0;;5,0;;;31,0;40,0;54,0;79,0;22,0;;9,0;;6,0;159,0;;;;;;1,0;1,0;4,0;;3,0;74,0;2,0;1,0;;5,0;;21,0;;19,0;;;1,0;1,0;;17,0;;23,0;7,0;;9,0;1,0;153,0;2,0;32,0;85,0;11,0;;2,0;6,0;23,0;72,0;;;;50,0;1,0;8,0;;95,0;;1,0;623,0;6,0;6,0;12,0;;17,0;;;13,0;;16,0;;142,0;6,0;91,0;2,0;184,0;3,0;2,0;;;;26,0;48,0;;;197,0;;3,0;5,0;1,0;128,0;1,0;;;71,0;3,0;1,0;7,0;101,0;23,0;2,0;;12,0;5,0;6,0;;7,0;132,0;246,0;68,0;5,0;3,0;1,0;;8,0;1,0;4,0;2,0;4,0;;5,0;9,0;;1,0;1,0;16,0;;;9,0;8,0;;;;;;43,0;2,0;2,0;;188,0;29,0;2,0;;51,0;23,0;6,0;4,0;8,0;11,0;;;29,0;3,0;12,0;11,0;;;;12,0;11,0;1,0;4,0;;103,0;55,0;38,0;2,0;26,0;11,0;1,0;64,0;;21,0;5,0;252,0;4,0;38,0;59,0;43,0;12,0;2,0;121,0;;;17,0;74,0;2,0;90,0;10,0;;56,0;87,0;;;8,0;68,0;;2,0;4,0;12,0;6,0;35,0;166,0;;1,0;24,0;40,0;;3,0;23,0;5,0;46,0;11,0;;23,0;;2,0;27,0;;;190,0;39,0;24,0;116,0;2,0;24,0;;;;118,0;27,0;26,0;3,0;5,0;16,0;5,0;;23,0;64,0;6,0;106,0;6,0;45,0;14,0;;;;;22,0;12,0;12,0;30,0;;129,0;;22,0;333,0;1,0;27,0;48,0;14,0;49,0;;16,0;9,0;35,0;1,0;;;18,0;281,0;384,0;;;1,0;83,0;11,0;7,0;;7,0;;99,0;42,0;18,0;3,0;6,0;15,0;1,0;1,0;34,0;222,0;3,0;12,0;4,0;8,0;;;9,0;;37,0;30,0;22,0;;21,0;28,0;2,0;4,0;5,0;;12,0;;19,0;;;3,0;3,0;2,0;;;;;3,0;2,0;;;13,0;;2,0;19,0;1,0;1,0;4,0;;;11,0;3,0;3,0;;1,0;;8,0;87,0;1,0;8,0;;16,0;;;;2,0;7,0;2,0;2,0;;22,0;;;;;4,0;6,0;1,0;1,0;;;3,0;;;55,0;;;;;1,0;14,0;;2,0;;38,0;2,0;2,0;29,0;14,0;2,0;2,0;3,0;;1,0;;17,0;12,0;1,0;;;;1,0;;;;;;;3,0;6,0;;13,0;2,0;2,0;1,0;2,0;;;;;18,0;;;;;2,0;;;;3,0;5,0;;1,0;;2,0;;2,0;;;;2,0;;1,0;2,0;;;6,0;;;;;;;;;1,0;;;4,0;1,0;;;;;;;;;;;;3,0;8,0;;1,0;;11,0;1,0;2,0;9,0;;2,0;;;;;2,0;;1,0;;;;;;1,0;;6,0;;;;;5,0;;;;;2,0;;1,0;9,0;;;8,0;;;;;;;;;;;;;;;;;;10,0;2,0;;;;;;2,0;;;1,0;1,0;5,0;7,0;;;;3,0;;;3,0;;;2,0;;;;;;13,0;13,0;;10,0;;;3,0;;;;;1,0;;14,0;;2,0;;;;;80,0;;;1,0;8,0;;;;;;;;3,0;;;;;;;11,0;;;;;3,0;;21,0;;;;;;;;;;4,0;3,0;;14,0;;;;;;93,0;;;;3,0;;;9,0;;;1,0;2,0;;;;;;;4,0;;;;;;4,0;1,0;;3,0;;;;1,0;;;;;;2,0;49,0;1,0;36,0;10,0;;;;2,0;12,0;;;;;;2,0;;;;;;;;;15,0;;46,0;2,0;;;;;3,0;6,0;15,0;3,0;;;;;;;;4,0;;;5,0;;;;23,0;;;16,0;;2,0;;1,0;29,0;;;2,0;;314,0;4,0;;;;;;;2,0;;;29,0;;;;210,0;;1,0;;5,0;5,0;6,0;4,0;;;;;34,0;5,0;;;;168,0;4,0;22,0;;4,0;1,0;;;;3,0;18,0;;10,0;342,0;;;5,0;4,0;;2,0;;;3,0;;3,0;;11,0;;;;;9,0;;;29,0;;;3,0;49,0;;20,0;2,0;1,0;;;;12,0;;;1,0;;4,0;;1,0;;3,0;;;;7,0;15,0;;;;4,0;;;;2,0;;;1,0;;3,0;1,0;;;;;;;;;;5,0;1,0;;;;;;14,0;;1,0;;;;;;;;3,0;;5,0;;;1,0;;;1,0;;1,0;;;8,0;;3,0;;;1,0;;1,0;;70,0;;2,0;;;;;;;;;;;;5,0;;;4,0;;;;2,0;;;;;;;4,0;;;;13,0;2,0;;;;1,0;;;;;;;6,0;;;;;;;;;;;1,0;;;;;;;;;;;7,0;1,0;1,0;;81,0;;16,0;2,0;4,0;;2,0;;3,0;;;13,0;;;;;1,0;14,0;;;;;;;;;25,0;;;;;;;;2,0;;;;;;;;6,0;;;;;;
left;;8,0;1,0;;3,0;52,0;10,0;6,0;28,0;5,0;4,0;;17,0;1,0;26,0;49,0;;;;2,0;2,0;32,0;;47,0;;2,0;3,0;;;1,0;3,0;1,0;33,0;;7,0;11,0;4,0;2,0;2,0;;44,0;1,0;5,0;;17,0;28,0;27,0;16,0;19,0;17,0;8,0;102,0;3,0;6,0;14,0;9,0;40,0;;;;4,0;;43,0;;14,0;31,0;30,0;30,0;22,0;78,0;1,0;7,0;20,0;;4,0;8,0;;3,0;;315,0;;5,0;;88,0;3,0;3,0;;;12,0;30,0;119,0;;;;6,0;2,0;3,0;;33,0;1,0;12,0;;4,0;22,0;;;41,0;7,0;9,0;4,0;5,0;4,0;;;6,0;8,0;109,0;51,0;;5,0;1,0;;3,0;3,0;5,0;1,0;1,0;;;1,0;;9,0;6,0;;3,0;1,0;31,0;9,0;;;7,0;;;36,0;25,0;;;336,0;3,0;;;;;8,0;17,0;;48,0;;20,0;;1,0;;54,0;;1,0;;46,0;54,0;;;15,0;;;43,0;9,0;;18,0;2,0;;;;24,0;;4,0;;;;2,0;4,0;;;;;12,0;1,0;20,0;;;2,0;4,0;;;2,0;66,0;;;;;;67,0;;1,0;;;;1,0;;;;;;2,0;15,0;;;;;;19,0;;4,0;2,0;2,0;21,0;;12,0;8,0;5,0;8,0;19,0;6,0;;15,0;2,0;;;;;39,0;11,0;38,0;1,0;;;;;6,0;;;;;;;7,0;;3,0;8,0;;1,0;;23,0;6,0;5,0;;;;;7,0;;47,0;1,0;;;;;13,0;;;;;35,0;10,0;1,0;;41,0;;1,0;;;;3,0;3,0;23,0;2,0;;;;1,0;49,0;;;10,0;;;2,0;32,0;1,0;2,0;;5,0;;;;;;;6,0;;;;;;;4,0;;;;11,0;;1,0;;5,0;;;;;;22,0;3,0;1,0;;1,0;;1,0;;;2,0;16,0;3,0;;3,0;;;2,0;24,0;;;54,0;2,0;;;;;;2,0;;2,0;;16,0;1,0;1,0;;7,0;;;10,0;13,0;;;11,0;4,0;8,0;3,0;;;;2,0;1,0;10,0;;;;1,0;;;;;;;17,0;1,0;;6,0;;8,0;;;7,0;2,0;;;1,0;7,0;4,0;;;;3,0;;;;52,0;;1,0;;2,0;1,0;4,0;1,0;;2,0;;8,0;;;1,0;1,0;;2,0;;;;;4,0;;3,0;;;11,0;;4,0;;2,0;;;;;7,0;;19,0;1,0;;4,0;;7,0;2,0;;;;;10,0;5,0;4,0;19,0;32,0;1,0;3,0;;;1,0;;;;;;2,0;;;5,0;6,0;30,0;;;14,0;;;1,0;;;;1,0;3,0;3,0;;;;;;2,0;;;1,0;1,0;;;;1,0;3,0;4,0;;;;3,0;;;1,0;1,0;;;;;;;1,0;1,0;1,0;;;;9,0;;1,0;;2,0;;;;;2,0;11,0;;;2,0;;5,0;;4,0;;;;3,0;;;;2,0;2,0;;2,0;;;;1,0;;3,0;1,0;;;3,0;1,0;;;;;;1,0;;;;;;8,0;;;;;;;1,0;;;;4,0;1,0;;;;;;;;;;;;;;18,0;;;;;42,0;;3,0;;;;13,0;1,0;;;;;;;;;65,0;1,0;;;;;2,0;9,0;;;;1,0;6,0;1,0;;;;;54,0;;5,0;;;5,0;;;;;;2,0;;;;1,0;2,0;5,0;3,0;;11,0;;;;;;1,0;4,0;;;5,0;4,0;;;;;1,0;;;5,0;;5,0;4,0;2,0;3,0;;;;94,0;9,0;;;;;;;;;;;10,0;;;;1,0;;;;;;;8,0;6,0;2,0;;;;;;;;;6,0;2,0;;;;;;;;;;;;;;2,0;;;1,0;;34,0;;;;;;;;1,0;;;;8,0;;;;;;;;;;;1,0;;;2,0;;;;;4,0;;2,0;;3,0;;;6,0;;;1,0;;4,0;;;;;;;;;;38,0;;1,0;;1,0;;10,0;;;;11,0;;;;;;;;;;;1,0;9,0;;1,0;;;;;1,0;;;;;;;;;2,0;;;;;;6,0;;3,0;;;;;;;;;;;;;;;;;;;;;7,0;1,0;2,0;;;;;;;;3,0;;;;;;;1,0;;;;;;;;;2,0;;1,0;3,0;12,0;;2,0;;12,0;;1,0;2,0;;2,0;;;;;;;2,0;;;;5,0;;;;;;;11,0;3,0;;;;4,0;;;;7,0;;;;;;;;;;2,0;4,0;4,0;;;;;;;6,0;;;8,0;;10,0;16,0;;;;2,0;;;;;;;;;;;3,0;6,0;;;;;
level;;15,0;13,0;2,0;7,0;13,0;7,0;46,0;34,0;9,0;16,0;;15,0;;4,0;153,0;1,0;3,0;59,0;;11,0;86,0;10,0;3,0;1,0;11,0;93,0;3,0;;7,0;9,0;8,0;77,0;13,0;88,0;26,0;25,0;50,0;;;148,0;14,0;31,0;9,0;103,0;39,0;160,0;141,0;44,0;35,0;13,0;7,0;;6,0;43,0;38,0;41,0;;18,0;;1,0;4,0;23,0;;18,0;16,0;17,0;12,0;50,0;1,0;9,0;2,0;119,0;1,0;;10,0;9,0;6,0;44,0;457,0;22,0;47,0;7,0;120,0;37,0;17,0;6,0;;5,0;9,0;54,0;;9,0;4,0;1,0;13,0;5,0;2,0;160,0;15,0;11,0;;54,0;19,0;;7,0;44,0;20,0;428,0;7,0;4,0;58,0;13,0;;4,0;70,0;23,0;36,0;197,0;174,0;3,0;;17,0;52,0;12,0;2,0;;;27,0;19,0;2,0;108,0;8,0;1,0;23,0;19,0;45,0;41,0;9,0;;38,0;11,0;16,0;60,0;53,0;;;47,0;807,0;18,0;5,0;2,0;4,0;11,0;25,0;11,0;90,0;;2,0;58,0;9,0;68,0;144,0;34,0;8,0;;83,0;29,0;7,0;3,0;69,0;;28,0;10,0;32,0;23,0;28,0;;2,0;15,0;6,0;20,0;2,0;1,0;29,0;40,0;;66,0;;;2,0;9,0;;28,0;;8,0;4,0;;;2,0;;2,0;129,0;44,0;3,0;;13,0;52,0;145,0;10,0;;6,0;;5,0;;24,0;;4,0;6,0;;2,0;11,0;;3,0;1,0;;5,0;;231,0;;5,0;1,0;;6,0;2,0;10,0;7,0;1,0;5,0;1,0;8,0;1,0;;36,0;48,0;;2,0;;318,0;6,0;41,0;;;;;42,0;63,0;;;;;;7,0;30,0;16,0;16,0;7,0;5,0;2,0;;;38,0;13,0;;;1,0;12,0;7,0;16,0;24,0;69,0;2,0;24,0;1,0;;124,0;1,0;2,0;;8,0;1,0;7,0;2,0;77,0;6,0;;14,0;;;;;14,0;21,0;;;;;12,0;;3,0;6,0;6,0;8,0;;3,0;4,0;;;;2,0;;;;;18,0;2,0;;;;5,0;;;1,0;;;7,0;9,0;;3,0;2,0;;;;22,0;2,0;;1,0;24,0;;8,0;;;5,0;10,0;;15,0;14,0;31,0;4,0;2,0;3,0;;2,0;;;;19,0;;;;2,0;;;19,0;2,0;;;1,0;;5,0;1,0;;;1,0;;25,0;2,0;;16,0;10,0;;54,0;5,0;;1,0;27,0;;2,0;1,0;;1,0;;41,0;6,0;11,0;;1,0;1,0;11,0;112,0;93,0;3,0;38,0;;3,0;9,0;2,0;5,0;9,0;;;10,0;7,0;56,0;5,0;1,0;33,0;8,0;8,0;3,0;;88,0;;6,0;4,0;2,0;11,0;12,0;15,0;;7,0;52,0;10,0;2,0;2,0;15,0;26,0;1,0;4,0;41,0;2,0;;;30,0;33,0;2,0;15,0;;1,0;;29,0;1,0;20,0;12,0;3,0;;4,0;;123,0;6,0;;;3,0;22,0;23,0;3,0;2,0;15,0;252,0;;100,0;11,0;;;6,0;4,0;7,0;;4,0;;3,0;4,0;1,0;;16,0;;;2,0;4,0;2,0;;1,0;6,0;1,0;1,0;;2,0;;22,0;;19,0;6,0;;;28,0;;;1,0;10,0;;10,0;7,0;1,0;8,0;;;3,0;7,0;16,0;;;30,0;;3,0;1,0;;35,0;;6,0;3,0;;;24,0;19,0;3,0;;5,0;;;1,0;1,0;;4,0;;7,0;;;8,0;;3,0;;16,0;;4,0;1,0;;17,0;31,0;;2,0;20,0;;3,0;;;18,0;;1,0;;;8,0;;1,0;;9,0;17,0;;;;1,0;;6,0;2,0;;2,0;;;;;1,0;;;1,0;;1,0;7,0;14,0;;;;;;;;4,0;4,0;;;;1,0;1,0;;;5,0;5,0;;71,0;12,0;;2,0;69,0;;4,0;8,0;;3,0;2,0;;;;;1,0;2,0;2,0;;17,0;;1,0;19,0;;;7,0;;;2,0;1,0;33,0;18,0;;;14,0;17,0;;3,0;13,0;;;1,0;;3,0;2,0;;22,0;1,0;1,0;2,0;;2,0;;2,0;;;10,0;;;5,0;;2,0;4,0;;;;11,0;;;1,0;;55,0;;;;;;;;;;10,0;;;;;;13,0;;;;1,0;;;1,0;;;;;;5,0;4,0;;;28,0;6,0;;;7,0;;;;;3,0;15,0;;11,0;2,0;;1,0;;;19,0;;;3,0;;;;11,0;;;8,0;2,0;17,0;17,0;4,0;18,0;;4,0;2,0;16,0;4,0;;4,0;6,0;20,0;8,0;4,0;;;;2,0;16,0;21,0;4,0;1,0;;13,0;6,0;1,0;;58,0;7,0;;;15,0;18,0;;1,0;;16,0;33,0;;42,0;19,0;2,0;1,0;2,0;8,0;1,0;;112,0;;20,0;35,0;;43,0;;1,0;11,0;;;62,0;1,0;;9,0;1,0;21,0;1,0;2,0;;8,0;22,0;;50,0;;;1,0;;;;;9,0;;4,0;1,0;;4,0;7,0;;;;22,0;1,0;;6,0;;;;6,0;5,0;3,0;15,0;3,0;2,0;;;;;;;;;1,0;39,0;11,0;;;;;;1,0;;;;2,0;8,0;5,0;;2,0;2,0;;8,0;5,0;3,0;;8,0;;;4,0;1,0;29,0;;1,0;1,0;15,0;2,0;2,0;2,0;;;;;;;;;;;17,0;3,0;;6,0;;;;2,0;;2,0;;15,0;2,0;2,0;;;;;;3,0;;16,0;;;;;;;;;8,0;;6,0;3,0;;9,0;;;;;;8,0;;4,0;;13,0;;;1,0;;3,0;6,0;20,0;;;13,0;;;;;;11,0;;8,0;;;;;;;;;3,0;2,0;4,0;;;2,0;;;;;;
lever;;3,0;2,0;;;2,0;3,0;10,0;3,0;3,0;;;1,0;;12,0;14,0;;;;;;;;;;;;;;;1,0;;29,0;;21,0;;;;;;;;;;;;;17,0;;;4,0;;;;44,0;;34,0;;;;21,0;1,0;;;;8,0;;12,0;11,0;8,0;;;2,0;;;;;;;;;1,0;;17,0;;;2,0;;;3,0;4,0;;;;;;;;7,0;;;;;;;;1,0;;;;1,0;1,0;;;;;24,0;17,0;;;1,0;;;;;;;;;2,0;1,0;;;;;;;6,0;;;;;;;;;;6,0;;;;;;;;;3,0;;2,0;;;;15,0;;;;;;;;3,0;2,0;;;;2,0;9,0;1,0;;;;4,0;;;9,0;;;;;;;;;24,0;;5,0;;;;2,0;;;;10,0;;4,0;;;;3,0;8,0;;18,0;;;;3,0;;;15,0;5,0;;;;;;;;;;62,0;;7,0;19,0;2,0;10,0;12,0;14,0;1,0;4,0;;;;5,0;;;;;;7,0;18,0;;2,0;2,0;;;1,0;;;;1,0;;1,0;;;;;;16,0;1,0;11,0;;1,0;;;9,0;;;;10,0;1,0;2,0;;;;5,0;;;;;;1,0;1,0;;1,0;;;;;;;11,0;13,0;;;1,0;5,0;1,0;;;;;;;5,0;;;9,0;;18,0;2,0;;;14,0;7,0;;2,0;1,0;;1,0;12,0;;;;;;;5,0;;8,0;;7,0;;;;16,0;46,0;;7,0;;;2,0;;;;48,0;;5,0;1,0;;;;;10,0;;1,0;;;;;;21,0;2,0;;2,0;;3,0;1,0;23,0;9,0;5,0;;;5,0;;;;1,0;;8,0;;;;;;;;;;;;;;;;;;1,0;;;;;1,0;;;;;;;;;;;;;;;;;;;;;;;;;;;;;;13,0;;;14,0;5,0;;;;;;;;;;;;;;;;;;;1,0;;;;;;;31,0;;;;;;;;3,0;2,0;;2,0;;;;;;;;;;;;;;2,0;;;13,0;;;;;;2,0;;;;;;;;;;;;;;;;;;;;;;;;;;;3,0;;;;;;;;9,0;;;;1,0;;;3,0;;;;;;;;;;2,0;1,0;;;;;;;;;;;;;;;;1,0;;;;;;;;;;;;;;;;;;;;;;;;;6,0;;;;;;1,0;;;;;;7,0;;;;;;;;;;4,0;;;;4,0;;;;;;;2,0;;;;;;;1,0;;2,0;;;1,0;;;;;;;;;;6,0;;;1,0;1,0;7,0;;;;;;;;;;;1,0;;;;2,0;2,0;;;;1,0;1,0;2,0;;6,0;;2,0;;2,0;;;;;;;;;;;;;;;;1,0;6,0;;;4,0;;1,0;1,0;;4,0;;;;1,0;19,0;;;1,0;;;;3,0;;;2,0;;;;;;;;;;;6,0;;;;;;;;;;;;;;;;;;;;;;;4,0;;;;;;;;;;;;1,0;;;2,0;;;;;;;;;;;;;;;;2,0;;;;;;;;;;;;;;14,0;;;;;;;;;;;;;;;2,0;;;;;;;;;;;;;;;;;;;;;;2,0;;4,0;;;1,0;;;;;;;;;;;1,0;;;;;;;;;;;;;56,0;;;;;;;2,0;;;;;;;;;;;;4,0;;;;;;;;;;;;;4,0;3,0;;;;;;;;;;;1,0;;;;;;;15,0;;;;;;;;;;;;;;;;;;1,0;;;;;;;1,0;;;;;;;;;;;;;;;;;;;;;;;;;;;;;;;;;;;;;;;;;;;;;;;;;;
light;;14,0;17,0;15,0;21,0;140,0;183,0;466,0;284,0;545,0;269,0;2,0;153,0;2,0;232,0;437,0;616,0;1,0;126,0;21,0;19,0;400,0;57,0;21,0;13,0;2,0;726,0;56,0;13,0;15,0;21,0;128,0;1112,0;29,0;827,0;140,0;24,0;16,0;41,0;1,0;336,0;14,0;105,0;63,0;481,0;132,0;319,0;1316,0;113,0;385,0;231,0;145,0;3,0;56,0;78,0;22,0;651,0;6,0;29,0;;49,0;145,0;251,0;1,0;544,0;57,0;216,0;410,0;83,0;122,0;106,0;234,0;503,0;25,0;3,0;106,0;46,0;555,0;604,0;2095,0;46,0;518,0;4,0;733,0;37,0;180,0;5,0;1,0;4,0;45,0;1273,0;1,0;9,0;182,0;153,0;44,0;31,0;1,0;601,0;28,0;9,0;19,0;442,0;723,0;62,0;196,0;901,0;29,0;397,0;16,0;543,0;173,0;12,0;11,0;9,0;625,0;716,0;504,0;136,0;163,0;33,0;80,0;50,0;93,0;90,0;20,0;16,0;173,0;59,0;193,0;20,0;156,0;53,0;24,0;143,0;10,0;118,0;83,0;27,0;4,0;227,0;4,0;34,0;985,0;77,0;5,0;;304,0;618,0;21,0;38,0;14,0;15,0;90,0;461,0;45,0;1089,0;2,0;5,0;42,0;9,0;433,0;1700,0;31,0;61,0;4,0;134,0;196,0;950,0;543,0;22,0;165,0;17,0;58,0;497,0;45,0;131,0;40,0;13,0;198,0;33,0;93,0;18,0;17,0;175,0;74,0;37,0;307,0;7,0;3,0;1,0;2,0;7,0;101,0;4,0;16,0;1,0;5,0;3,0;90,0;3,0;18,0;46,0;339,0;17,0;;77,0;170,0;172,0;285,0;81,0;1,0;4,0;53,0;8,0;141,0;5,0;30,0;9,0;120,0;239,0;963,0;34,0;;8,0;9,0;190,0;;;6,0;268,0;35,0;186,0;134,0;28,0;54,0;23,0;222,0;34,0;16,0;35,0;63,0;54,0;411,0;38,0;20,0;124,0;12,0;532,0;174,0;70,0;132,0;2,0;1,0;5,0;189,0;1517,0;842,0;52,0;12,0;;67,0;10,0;178,0;78,0;;88,0;231,0;131,0;6,0;;3621,0;111,0;15,0;147,0;2,0;213,0;108,0;235,0;996,0;76,0;25,0;13,0;18,0;3,0;321,0;26,0;23,0;7,0;103,0;91,0;24,0;3,0;45,0;50,0;8,0;14,0;24,0;21,0;;20,0;189,0;43,0;10,0;5,0;;5,0;284,0;15,0;22,0;19,0;53,0;31,0;6,0;66,0;59,0;1,0;1,0;3,0;132,0;;5,0;13,0;24,0;53,0;4,0;2,0;;4,0;140,0;9,0;7,0;2,0;1,0;15,0;101,0;;422,0;6,0;18,0;7,0;20,0;30,0;85,0;26,0;8,0;3,0;11,0;73,0;181,0;10,0;82,0;26,0;90,0;;9,0;7,0;149,0;34,0;5,0;25,0;238,0;3,0;5,0;3,0;21,0;15,0;29,0;15,0;192,0;25,0;6,0;2,0;40,0;11,0;;51,0;;30,0;17,0;;7,0;15,0;4,0;10,0;28,0;8,0;5,0;;37,0;54,0;163,0;35,0;58,0;1,0;105,0;4,0;28,0;31,0;11,0;;1,0;9,0;104,0;2,0;;12,0;21,0;37,0;154,0;165,0;38,0;39,0;1,0;19,0;10,0;2,0;73,0;29,0;1,0;5,0;36,0;152,0;28,0;26,0;5,0;8,0;58,0;3,0;60,0;1,0;110,0;231,0;36,0;53,0;16,0;30,0;189,0;185,0;22,0;31,0;23,0;119,0;;;98,0;159,0;2,0;13,0;43,0;144,0;2,0;;3,0;30,0;56,0;115,0;3,0;;;240,0;122,0;3,0;27,0;;2,0;8,0;7,0;47,0;30,0;2,0;41,0;14,0;4,0;43,0;11,0;2,0;1,0;27,0;3,0;173,0;43,0;12,0;73,0;24,0;2,0;1,0;14,0;11,0;29,0;16,0;77,0;4,0;24,0;2,0;2,0;17,0;22,0;34,0;8,0;14,0;4,0;;221,0;36,0;;46,0;1,0;44,0;9,0;1,0;42,0;;;6,0;17,0;1,0;12,0;7,0;5,0;39,0;70,0;30,0;33,0;;3,0;7,0;6,0;;17,0;;15,0;27,0;2,0;17,0;13,0;59,0;39,0;9,0;28,0;11,0;14,0;2,0;25,0;2,0;139,0;55,0;1,0;15,0;49,0;6,0;;18,0;67,0;10,0;38,0;43,0;19,0;1,0;9,0;7,0;23,0;49,0;141,0;7,0;11,0;22,0;72,0;3,0;12,0;292,0;1,0;304,0;;21,0;27,0;9,0;1,0;18,0;5,0;15,0;8,0;1,0;14,0;559,0;6,0;;5,0;3,0;1,0;26,0;12,0;;38,0;18,0;1,0;2,0;;19,0;1,0;94,0;;5,0;;129,0;24,0;14,0;32,0;7,0;;10,0;3,0;15,0;1,0;10,0;;6,0;8,0;;1,0;4,0;2,0;1,0;6,0;5,0;;594,0;8,0;5,0;34,0;6,0;;1,0;95,0;;;15,0;2,0;2,0;;12,0;17,0;27,0;19,0;3,0;9,0;1,0;16,0;5,0;1,0;86,0;11,0;;6,0;21,0;6,0;4,0;40,0;;1,0;2,0;9,0;29,0;28,0;108,0;8,0;34,0;55,0;1,0;58,0;24,0;7,0;804,0;16,0;4,0;94,0;;1,0;5,0;;;7,0;21,0;;1,0;8,0;1,0;41,0;;39,0;;16,0;;;1,0;32,0;30,0;2,0;5,0;;5,0;;38,0;1,0;3,0;3,0;5,0;49,0;;;1,0;9,0;1,0;20,0;;10,0;88,0;3,0;6,0;;25,0;9,0;3,0;3,0;1,0;;56,0;40,0;6,0;14,0;11,0;;12,0;14,0;2024,0;;40,0;37,0;2,0;;9,0;9,0;49,0;20,0;1,0;12,0;6,0;15,0;31,0;;19,0;36,0;1,0;27,0;1,0;22,0;4,0;;14,0;49,0;13,0;1,0;6,0;12,0;2,0;9,0;;13,0;3,0;;5,0;82,0;6,0;29,0;2,0;19,0;2,0;3,0;19,0;38,0;5,0;50,0;31,0;51,0;71,0;14,0;32,0;;66,0;34,0;7,0;;11,0;64,0;1,0;;1,0;;26,0;38,0;25,0;20,0;113,0;29,0;4,0;4,0;4,0;;101,0;16,0;7,0;2,0;;1,0;1,0;;35,0;2,0;21,0;;12,0;2,0;13,0;21,0;78,0;2,0;1,0;6,0;15,0;13,0;19,0;521,0;3,0;73,0;7,0;55,0;13,0;33,0;;3,0;114,0;2,0;22,0;8,0;6,0;;;3,0;;3,0;1,0;;8,0;15,0;5,0;2,0;3,0;5,0;8,0;10,0;;5,0;3,0;1,0;236,0;7,0;3,0;14,0;;5,0;;373,0;200,0;;128,0;;;13,0;2,0;1,0;5,0;30,0;9,0;39,0;9,0;;;17,0;2,0;19,0;2,0;47,0;;;296,0;17,0;13,0;;188,0;32,0;126,0;;23,0;12,0;8,0;4,0;;11,0;;13,0;3,0;5,0;79,0;5,0;88,0;43,0;16,0;59,0;2,0;12,0;;;9,0;2,0;;2,0;4,0;7,0;54,0;;129,0;;;3,0;5,0;1,0;;19,0;;1,0;17,0;67,0;2,0;75,0;3,0;;;45,0;4,0;7,0;1,0;21,0;23,0;19,0;61,0;;6,0;;;31,0;4,0;;14,0;103,0;4,0;;4,0;1,0;14,0;1,0;;5,0;2,0;1,0;2,0;5,0;;;5,0;15,0;;;21,0;;2,0;1,0;;10,0;1,0;10,0;1,0;;2,0;5,0;6,0;2,0;8,0;;;4,0
linear;;2,0;1,0;;;6,0;7,0;9,0;11,0;2,0;77,0;;3,0;;112,0;20,0;1,0;;;5,0;2,0;4,0;2,0;1,0;13,0;5,0;48,0;7,0;1,0;;2,0;1,0;31,0;;13,0;4,0;6,0;11,0;;2,0;54,0;;7,0;11,0;28,0;3,0;19,0;34,0;1,0;1,0;2,0;13,0;;;36,0;12,0;8,0;5,0;2,0;;20,0;;7,0;;12,0;;5,0;22,0;8,0;;32,0;2,0;11,0;;;6,0;5,0;4,0;6,0;182,0;;19,0;2,0;53,0;1,0;2,0;3,0;;;4,0;76,0;;;1,0;6,0;2,0;13,0;;60,0;2,0;5,0;;17,0;26,0;1,0;3,0;19,0;4,0;10,0;2,0;10,0;19,0;;;;40,0;39,0;41,0;4,0;4,0;5,0;;1,0;4,0;11,0;12,0;;;;11,0;;;10,0;2,0;6,0;6,0;13,0;12,0;;;2,0;;;148,0;7,0;;;13,0;22,0;;2,0;4,0;1,0;6,0;;2,0;62,0;;;10,0;;;14,0;;1,0;;;6,0;;;1,0;;;;;21,0;1,0;18,0;;;;4,0;;;;9,0;;41,0;;;2,0;;1,0;17,0;;9,0;;2,0;1,0;4,0;1,0;;2,0;44,0;1,0;2,0;;3,0;6,0;5,0;2,0;;3,0;1,0;;;18,0;;1,0;5,0;2,0;4,0;1,0;;;;;;36,0;;10,0;2,0;2,0;39,0;10,0;35,0;29,0;3,0;8,0;1,0;;;;17,0;1,0;3,0;;;20,0;7,0;28,0;6,0;;1,0;2,0;4,0;10,0;2,0;;;;;2,0;24,0;;5,0;26,0;;22,0;;1,0;11,0;4,0;;;13,0;;25,0;1,0;18,0;2,0;;2,0;;;2,0;;3,0;;;3,0;11,0;10,0;;2,0;;7,0;;;;129,0;3,0;5,0;1,0;4,0;26,0;2,0;1,0;3,0;2,0;;2,0;;1,0;;6,0;;;;30,0;;;;1,0;13,0;;8,0;1,0;;;;1,0;;;;3,0;;80,0;;;2,0;;;7,0;1,0;4,0;1,0;66,0;11,0;1,0;5,0;4,0;;;10,0;6,0;8,0;27,0;;;;7,0;2,0;1,0;3,0;;;;4,0;;4,0;;;;2,0;;7,0;;;49,0;;;7,0;3,0;;2,0;;;3,0;23,0;3,0;4,0;;;3,0;;1,0;;;1,0;2,0;;;16,0;;;;3,0;;16,0;2,0;;;;10,0;;1,0;;2,0;;;3,0;3,0;;;1,0;;1,0;;5,0;;5,0;6,0;;;1,0;;;4,0;4,0;;114,0;14,0;;1,0;5,0;5,0;;11,0;1,0;;;;;6,0;2,0;;4,0;;;6,0;;;3,0;;;;;1,0;9,0;7,0;;1,0;;3,0;1,0;;7,0;;;4,0;7,0;3,0;6,0;20,0;;;;;4,0;;;;1,0;3,0;;;1,0;;;92,0;;;;;;9,0;;14,0;9,0;;;12,0;;1,0;;;;;;1,0;;4,0;1,0;;;;;;;;;1,0;;;;;1,0;;;;13,0;;;;1,0;3,0;;2,0;;;;2,0;;1,0;3,0;;;2,0;;7,0;3,0;;2,0;6,0;2,0;1,0;;;;3,0;;1,0;;2,0;3,0;;1,0;;;1,0;;;;;;;;;;;;;2,0;1,0;;;;1,0;;;;;;1,0;2,0;;;;;1,0;;;;;;;2,0;;;1,0;1,0;;;;;7,0;;;;;;;1,0;;;;;;;;;1,0;;;;;1,0;1,0;;;;10,0;;1,0;1,0;;;;;;;1,0;1,0;;3,0;;4,0;;3,0;;1,0;;;;;;1,0;;3,0;;;;;2,0;8,0;;6,0;;;2,0;;;;;4,0;1,0;;3,0;9,0;;;;;25,0;10,0;3,0;;3,0;;;;;3,0;;4,0;;;7,0;;;12,0;;;;16,0;;3,0;1,0;18,0;;;4,0;;5,0;1,0;;;1,0;5,0;;;;2,0;;;;6,0;11,0;;;;5,0;;;;;;;;;;;;;;;4,0;;;3,0;;;;3,0;;;;14,0;3,0;;;;;;;27,0;1,0;6,0;1,0;;16,0;6,0;;;;;;3,0;6,0;3,0;;2,0;;;3,0;2,0;4,0;1,0;;2,0;1,0;;;2,0;;1,0;;7,0;;;9,0;11,0;12,0;1,0;;3,0;;;;;1,0;15,0;;;;;3,0;;;1,0;2,0;;;2,0;;;;;;;;2,0;4,0;2,0;;;;;;;;;;7,0;;;;1,0;5,0;;;;;;28,0;;;;3,0;6,0;;;;;2,0;;;;;;;;;5,0;;2,0;;;;;;;;8,0;;;2,0;1,0;;2,0;;;;;;1,0;;;;;2,0;;16,0;;;7,0;;;1,0;;;2,0;;;1,0;;;;;;;;;;;;;;;;;;3,0;;;8,0;;;;;12,0;;;;1,0;;;;;;1,0;1,0;;18,0;;8,0;;;2,0;26,0;;;;;;1,0;;;;;;;;;;;;;
liquid;;1,0;;;;;6,0;34,0;6,0;7,0;3,0;;;;1,0;9,0;;;;;;1,0;;;;;18,0;;;;;3,0;8,0;;8,0;1,0;;;;1,0;;;3,0;;;;2,0;55,0;6,0;136,0;7,0;3,0;;;6,0;;10,0;;;;;2,0;4,0;;2,0;4,0;5,0;63,0;;9,0;11,0;;1,0;;;9,0;;;1,0;20,0;2,0;2,0;;62,0;;;;;;7,0;207,0;;;19,0;;41,0;;;16,0;2,0;;;58,0;2,0;;1,0;45,0;;1,0;;2,0;1,0;;;;16,0;24,0;11,0;11,0;6,0;1,0;1,0;;6,0;4,0;;9,0;;;1,0;;3,0;;;;;2,0;;2,0;;;;;18,0;;;1,0;7,0;5,0;;;2,0;;;;1,0;26,0;;;;;2,0;35,0;;5,0;;3,0;2,0;5,0;;7,0;;;4,0;8,0;;7,0;4,0;;;2,0;1,0;;4,0;3,0;3,0;;5,0;;;;;;4,0;1,0;18,0;;;;;;;;1,0;;1,0;2,0;;1,0;20,0;11,0;6,0;;;16,0;1,0;1,0;4,0;;3,0;9,0;;;;;3,0;46,0;;39,0;1,0;11,0;;;6,0;1,0;;1,0;3,0;1,0;1,0;1,0;46,0;;4,0;2,0;;;;;;3,0;1,0;;;;;12,0;1,0;;16,0;;37,0;2,0;4,0;;;7,0;;5,0;3,0;;1,0;13,0;;;;;1,0;36,0;12,0;1,0;;;;2,0;;;;;15,0;2,0;;;;;4,0;;;6,0;;6,0;;;;5,0;;;;2,0;1,0;;;;;2,0;;;;;1,0;;;;;4,0;;2,0;;;1,0;;;;;;;;2,0;;13,0;;;;1,0;;;;;1,0;;;;;;;;;;;;;;;;;;;2,0;2,0;;;;1,0;;;;;;;;;;4,0;;;1,0;;;;;;3,0;;;;1,0;;;1,0;;;;;;;;;;;6,0;8,0;;;;;;2,0;;;;;;3,0;;;;;;;;;;;;;;;1,0;;;13,0;;6,0;;;2,0;1,0;;;;;;;;3,0;2,0;;;;;;4,0;;;;;;;;;;;;;;;;;1,0;;4,0;2,0;5,0;;;;;;;;;;;;;;1,0;;15,0;;1,0;;1,0;;;;;;;;;8,0;;;;;;;;;1,0;1,0;;;;;;1,0;;;;;1,0;;;1,0;;2,0;;;;;;;;10,0;;;;;;;;;;4,0;;;;;;;21,0;;;;;1,0;;;;;;;;;;;1,0;1,0;;1,0;;;1,0;;;;;;;;;2,0;;;;;;2,0;3,0;;;;;;;;;;;;;;;;;;;;;;;;;4,0;3,0;;1,0;;;;;2,0;;;;;1,0;;;1,0;;;;;;;;;;;;2,0;1,0;;;;;;;;;1,0;;1,0;322,0;5,0;;10,0;7,0;;;;;;;;;;;;;;;;;;;;;;;;;;;1,0;;;;;;;;;;;;;;;;;;;;;;;;2,0;35,0;2,0;;;7,0;;;;;;;;2,0;1,0;;;;4,0;;10,0;;;;9,0;;;;;;;;10,0;1,0;2,0;;;1,0;;;;;;;;;;;;3,0;28,0;;;;;;;;1,0;;;;;;;;;;;;;;;;;;;4,0;;;;;;7,0;;;;;;;;;;;;;;;;;;1,0;;;;;;;;;;;;;;;;;;;;5,0;4,0;;;;;;;;;;;;;1,0;;;;;;;;;;;;;;;;;;;;;;;1,0;3,0;3,0;;;;;;;;;;;;;1,0;;;;2,0;;;;;;;;;;;;;;;;2,0;;;;;;;;;;;;;;;;;;;;;;;;1,0;;1,0;;;;;;;;;1,0;;;;;1,0;;;1,0;;;;;;;;;;;;;;;;;;;;;;;;;;;;;;;;;;;;;;;;15,0;;
load;;1,0;1,0;;;1,0;;1,0;1,0;;;;1,0;;1,0;11,0;;;;;;;;;;;1,0;;;;23,0;5,0;19,0;;10,0;1,0;;1,0;;;11,0;;5,0;;2,0;4,0;;18,0;2,0;;2,0;;;;5,0;;12,0;;;1,0;1,0;;4,0;;;;;3,0;;;2,0;;13,0;10,0;;1,0;1,0;;;5,0;;5,0;;16,0;1,0;6,0;;;;;2,0;;;1,0;;7,0;10,0;;12,0;;;;10,0;5,0;;;;3,0;40,0;;;5,0;;;;23,0;21,0;4,0;7,0;16,0;;;5,0;9,0;1,0;4,0;10,0;;;1,0;;13,0;6,0;3,0;;;;;4,0;;;;;3,0;4,0;;;8,0;53,0;1,0;;;1,0;;2,0;7,0;9,0;;1,0;;;5,0;38,0;1,0;;;;;;;;;;;3,0;4,0;;1,0;;;;;;;;14,0;;1,0;;;2,0;;;26,0;;;;;;;;;1,0;1,0;;;;;;;;;4,0;6,0;;;;;;;1,0;;;;1,0;;;;1,0;;5,0;;;2,0;3,0;5,0;1,0;;;;;;;4,0;;;;;6,0;;;;;1,0;;11,0;11,0;;;;1,0;;;;;;6,0;;;;;19,0;1,0;;;9,0;12,0;;;1,0;13,0;;;;;13,0;;;;;3,0;;;;2,0;2,0;;;;;1,0;4,0;;;;2,0;11,0;;;;;;;;;;2,0;;;;1,0;;;;39,0;;;;;;;;;;;12,0;1,0;;1,0;;;;;;;;;1,0;3,0;1,0;;;;;;;2,0;;1,0;;;;;;;;2,0;;;;;;;;;;13,0;;1,0;;;;;;;;;;;3,0;;;1,0;;;4,0;1,0;;;;;;1,0;3,0;;;;;;;;11,0;5,0;;;1,0;;;;;;;;;;4,0;;;;;;3,0;1,0;;1,0;;;;1,0;;1,0;;1,0;4,0;3,0;1,0;3,0;;;3,0;;;;;;9,0;;;;1,0;;;;;;;1,0;;;;;;;;;;;;15,0;;7,0;;2,0;1,0;;;;;;;;;;3,0;;;;;2,0;;;;;;1,0;;;;3,0;;;;;;;;;7,0;;;;;1,0;;;;;;3,0;1,0;;;1,0;2,0;;;;;;;;;;;;;;;;1,0;;;;;;5,0;;1,0;;;;2,0;;;;;;2,0;;;;;;;;1,0;;;1,0;;;;;;;;;;1,0;;;;;;;;;;;;;;;;;;;;;;;;;;;;;2,0;2,0;2,0;2,0;;;;;;;1,0;1,0;1,0;;;;;1,0;;1,0;;3,0;1,0;;;;;;3,0;;;;;;;;;2,0;;;;;;;;;;;;2,0;7,0;;;1,0;;;;;;;;;;;;;;;;;;;2,0;;;;;;;;;;;;;;;;;;;;;;;;;;;;1,0;1,0;;;;;;;;1,0;1,0;;1,0;;;;;;1,0;;;;;;;;2,0;;;;;;;;;;;;;;;1,0;;;;;;;;;;;1,0;;;;;;2,0;;;;;3,0;;;;;;;;;;;;41,0;;;4,0;;;;;;2,0;;1,0;;;3,0;;;;;;;1,0;;;;;;;2,0;;;;;2,0;;;;;;;;;;1,0;;;;;;;;;;;;;;;;;4,0;;;;;;;;;;;;;;;;;1,0;;;;;;;;;;;;;;;;;;;;;;;;;;;;;5,0;;;;;;;;;;;;;;;;;;1,0;;;;;;;;;;4,0;1,0;;;;;;;;;;;;;;;;;;;;;;;;;;;;;;;;;;;;;;;;;;;;;;;;;;;;;;;;;;;;;;;;;;;;;;;;
locate;;20,0;3,0;1,0;6,0;23,0;23,0;56,0;93,0;16,0;37,0;1,0;12,0;;98,0;26,0;12,0;4,0;;;9,0;29,0;2,0;19,0;1,0;2,0;38,0;5,0;;1,0;2,0;4,0;44,0;;45,0;8,0;;;;;33,0;1,0;31,0;6,0;13,0;15,0;51,0;186,0;21,0;48,0;6,0;29,0;5,0;;18,0;48,0;64,0;;7,0;;19,0;9,0;21,0;;38,0;17,0;23,0;20,0;67,0;99,0;1,0;6,0;18,0;;;39,0;24,0;3,0;6,0;353,0;3,0;67,0;;75,0;2,0;7,0;;;16,0;13,0;346,0;;;14,0;;2,0;3,0;2,0;80,0;26,0;9,0;6,0;65,0;172,0;8,0;11,0;165,0;1,0;23,0;1,0;6,0;3,0;8,0;4,0;;73,0;215,0;187,0;33,0;38,0;1,0;3,0;;3,0;32,0;3,0;;;1,0;30,0;1,0;21,0;28,0;1,0;3,0;;26,0;;;;42,0;2,0;;102,0;1,0;;;257,0;17,0;1,0;1,0;12,0;18,0;12,0;16,0;;119,0;1,0;6,0;6,0;3,0;9,0;160,0;;1,0;;65,0;36,0;1,0;;13,0;;1,0;25,0;1,0;;24,0;27,0;6,0;4,0;25,0;77,0;1,0;30,0;2,0;26,0;;33,0;;;3,0;3,0;;54,0;2,0;15,0;;;;22,0;5,0;3,0;6,0;32,0;;10,0;2,0;1,0;2,0;79,0;9,0;1,0;9,0;2,0;14,0;3,0;15,0;2,0;9,0;60,0;197,0;2,0;21,0;;4,0;20,0;11,0;6,0;94,0;;61,0;1,0;20,0;50,0;34,0;10,0;22,0;35,0;43,0;34,0;2,0;14,0;4,0;52,0;2,0;;13,0;7,0;142,0;84,0;21,0;;29,0;;5,0;;47,0;1,0;2,0;4,0;;6,0;3,0;26,0;28,0;;15,0;12,0;6,0;2,0;16,0;38,0;37,0;11,0;;14,0;;38,0;66,0;150,0;10,0;;20,0;11,0;1,0;8,0;3,0;5,0;;2,0;63,0;8,0;1,0;6,0;14,0;1,0;7,0;6,0;19,0;;20,0;6,0;7,0;3,0;15,0;;;46,0;31,0;8,0;;4,0;;4,0;71,0;1,0;32,0;10,0;2,0;37,0;2,0;1,0;;12,0;40,0;4,0;17,0;3,0;;1,0;2,0;27,0;3,0;;;1,0;1,0;22,0;1,0;13,0;4,0;;1,0;3,0;1,0;28,0;3,0;10,0;17,0;13,0;10,0;14,0;;9,0;;44,0;8,0;76,0;5,0;3,0;;4,0;1,0;5,0;5,0;7,0;;42,0;5,0;15,0;3,0;3,0;;;4,0;;11,0;11,0;21,0;12,0;6,0;8,0;2,0;7,0;1,0;;2,0;1,0;;25,0;11,0;80,0;9,0;;3,0;3,0;9,0;8,0;14,0;3,0;;;28,0;7,0;;;;;;3,0;2,0;16,0;1,0;;6,0;;;;;;;1,0;4,0;;;;5,0;14,0;;;;16,0;;;43,0;;10,0;2,0;2,0;;6,0;10,0;13,0;;1,0;2,0;6,0;2,0;8,0;3,0;8,0;2,0;;;;10,0;9,0;1,0;2,0;7,0;6,0;;5,0;4,0;;;;;7,0;9,0;4,0;;;;30,0;4,0;;;6,0;1,0;3,0;10,0;5,0;57,0;19,0;1,0;1,0;2,0;;5,0;2,0;17,0;2,0;3,0;;15,0;;9,0;9,0;;21,0;8,0;2,0;22,0;2,0;;17,0;2,0;1,0;5,0;;5,0;;;1,0;2,0;6,0;2,0;9,0;;1,0;;1,0;3,0;;1,0;13,0;5,0;1,0;2,0;2,0;;2,0;14,0;;7,0;10,0;7,0;;6,0;2,0;21,0;;4,0;3,0;2,0;;;2,0;6,0;;1,0;3,0;8,0;;3,0;;52,0;6,0;14,0;;1,0;8,0;4,0;1,0;;;10,0;1,0;1,0;5,0;3,0;;10,0;1,0;1,0;;7,0;6,0;;;24,0;1,0;;6,0;;6,0;10,0;14,0;3,0;4,0;9,0;;21,0;1,0;;;2,0;8,0;;;;6,0;2,0;;2,0;2,0;2,0;1,0;1,0;;;21,0;;8,0;;;2,0;;;;;1,0;5,0;7,0;36,0;88,0;1,0;1,0;;1,0;;;7,0;1,0;;9,0;3,0;;1,0;3,0;2,0;14,0;;5,0;5,0;9,0;;12,0;4,0;;12,0;;1,0;;;;;17,0;1,0;3,0;;;;1,0;31,0;1,0;9,0;;12,0;2,0;3,0;;;;;;;2,0;2,0;8,0;;19,0;15,0;2,0;8,0;;1,0;;3,0;;2,0;5,0;;;2,0;4,0;14,0;7,0;12,0;18,0;4,0;3,0;;;1,0;;1,0;2,0;3,0;;;;16,0;;;;16,0;3,0;;;1,0;7,0;2,0;1,0;9,0;;11,0;3,0;;;6,0;1,0;;1,0;2,0;;1,0;1,0;;;5,0;;4,0;1,0;1,0;;10,0;1,0;1,0;;;;10,0;;;;;10,0;;11,0;;;;;;;4,0;3,0;1,0;;6,0;;2,0;;;;1,0;;;;;4,0;1,0;2,0;;1,0;;;5,0;;;2,0;;10,0;;;;1,0;;;;4,0;;;3,0;;;2,0;2,0;2,0;;;;;;;;5,0;;;;5,0;2,0;;;1,0;;;1,0;2,0;3,0;2,0;1,0;1,0;;3,0;;;;6,0;1,0;1,0;2,0;;;1,0;;;;;;2,0;;;;;2,0;8,0;6,0;;10,0;;;1,0;3,0;;14,0;;2,0;;;1,0;4,0;1,0;;2,0;6,0;;;2,0;2,0;3,0;;4,0;;;;1,0;;1,0;1,0;1,0;3,0;;1,0;;;;7,0;1,0;;;;1,0;3,0;2,0;3,0;;2,0;12,0;4,0;1,0;2,0;2,0;1,0;6,0;1,0;;;6,0;3,0;7,0;13,0;5,0;;;;1,0;;;;;;3,0;;4,0;4,0;17,0;;;8,0;1,0;9,0;3,0;;;;;5,0;;1,0;6,0;12,0;;1,0;;;3,0;11,0;;;5,0;14,0;1,0;;;1,0;;;;3,0;4,0;7,0;3,0;2,0;;5,0;;;;;;;;1,0;2,0;;;9,0;;;2,0;;3,0;1,0;1,0;;;
lock;;28,0;8,0;1,0;1,0;4,0;17,0;26,0;3,0;10,0;2,0;;6,0;;14,0;23,0;;;;1,0;1,0;10,0;3,0;1,0;5,0;;2,0;26,0;;;3,0;22,0;56,0;;38,0;1,0;;5,0;;;5,0;;2,0;;4,0;3,0;14,0;129,0;;1,0;45,0;3,0;;1,0;6,0;;31,0;;;;16,0;6,0;;;13,0;8,0;10,0;24,0;16,0;15,0;12,0;1,0;3,0;;9,0;;;;;42,0;;18,0;;106,0;7,0;3,0;3,0;;;4,0;43,0;;;;;;1,0;;48,0;29,0;14,0;6,0;41,0;;1,0;3,0;6,0;7,0;8,0;107,0;3,0;11,0;1,0;;5,0;22,0;121,0;136,0;;4,0;17,0;;;8,0;;;;;;;;3,0;22,0;;6,0;;16,0;19,0;;6,0;;4,0;1,0;9,0;3,0;;;29,0;11,0;2,0;2,0;;2,0;1,0;;;32,0;;;;;4,0;95,0;;;;5,0;;;;;;;3,0;;7,0;66,0;20,0;;;;71,0;;2,0;;13,0;;11,0;;;;2,0;;35,0;2,0;7,0;;;;19,0;4,0;5,0;;35,0;;26,0;1,0;;6,0;9,0;;;25,0;;;;7,0;;;100,0;51,0;;10,0;2,0;;1,0;1,0;46,0;3,0;;270,0;1,0;;49,0;23,0;21,0;25,0;18,0;10,0;11,0;;;;4,0;11,0;;;;;9,0;28,0;;2,0;4,0;;;39,0;;;;;;9,0;2,0;;;4,0;5,0;9,0;;12,0;;3,0;;;21,0;2,0;30,0;4,0;27,0;6,0;4,0;;2,0;;2,0;;5,0;;;4,0;4,0;;;22,0;;;;3,0;2,0;4,0;10,0;10,0;;10,0;1,0;6,0;19,0;9,0;;;14,0;;9,0;2,0;;1,0;10,0;;27,0;10,0;2,0;1,0;8,0;10,0;;51,0;37,0;;10,0;2,0;4,0;;;2,0;1,0;2,0;6,0;9,0;31,0;3,0;16,0;29,0;3,0;;1,0;;2,0;1,0;4,0;9,0;4,0;;3,0;;15,0;17,0;11,0;3,0;6,0;;6,0;;6,0;40,0;;4,0;3,0;29,0;;;24,0;5,0;4,0;19,0;;32,0;2,0;43,0;18,0;52,0;;;20,0;;4,0;;11,0;;67,0;6,0;1,0;;;20,0;2,0;3,0;;;3,0;;;2,0;12,0;;;;1,0;1,0;;2,0;;8,0;;14,0;1,0;;;;;;11,0;;;;;;3,0;;;;8,0;1,0;1,0;6,0;;4,0;;9,0;;;;8,0;;;8,0;37,0;;9,0;;20,0;;;9,0;;12,0;;;;;1,0;;;;;1,0;;;18,0;1,0;;;;;30,0;2,0;;;10,0;2,0;7,0;1,0;;9,0;;;;;;;1,0;;;;;;;3,0;8,0;2,0;101,0;1,0;;5,0;;;18,0;;;;;5,0;;;4,0;;;;;;;7,0;5,0;6,0;;;;3,0;;;;;1,0;3,0;;4,0;5,0;;;;;1,0;;;2,0;;;3,0;;;;1,0;;;;3,0;;;1,0;10,0;;12,0;;;;;;;2,0;;;;6,0;7,0;;12,0;;;;;1,0;;;;1,0;;4,0;;13,0;;;;;5,0;;;;1,0;;;3,0;;14,0;;;;;;;;1,0;;16,0;;;;4,0;;;3,0;;;;;;;4,0;1,0;;;;;;6,0;;;;19,0;;;;;;;;;;29,0;;;;;;;26,0;2,0;1,0;;;5,0;9,0;;;;;;;3,0;;;11,0;3,0;;;;18,0;3,0;5,0;3,0;6,0;4,0;2,0;3,0;4,0;8,0;9,0;;;6,0;;17,0;;;;;;;;;1,0;;;7,0;2,0;3,0;4,0;;1,0;;9,0;9,0;;;17,0;;;;2,0;29,0;;;;;;2,0;1,0;;1,0;;1,0;;;;;;;;;;5,0;;;;;2,0;;;;;;2,0;;;;;1,0;;6,0;1,0;;;;;;;;;1,0;;;;;;;;;;1,0;;;;;;;;;;;;;;;;4,0;;;;;1,0;1,0;;;;;;;;1,0;;2,0;;;;;;;;;;;;;;17,0;31,0;;9,0;;;;;;4,0;;;;;;;;;;;;;;5,0;;;;;;;;;;;;;;;;;;;;;;;;;;;2,0;;;1,0;;;;5,0;;;;2,0;;;;;;;;;;;;;;;;;;8,0;;;;;1,0;4,0;1,0;;1,0;;;;;;;;11,0;;;;;;;;;;;;;;;;;1,0;5,0;;;;;2,0;;;5,0;;;1,0;4,0;;;;;;;;1,0;;;;;;;;;;;;;1,0;;;9,0;;;;;5,0;;;;;;;;;;;;;;;1,0;;;;1,0;;
loop;;1,0;;;;;;2,0;2,0;2,0;;;;;13,0;8,0;;;;;;3,0;;;;;;;;;;;7,0;;11,0;2,0;;2,0;;;2,0;;;2,0;11,0;;7,0;3,0;2,0;1,0;4,0;;;;;;;10,0;;;1,0;2,0;;;;;;19,0;5,0;2,0;8,0;;2,0;;;;1,0;;;5,0;;1,0;;30,0;;2,0;;;;1,0;2,0;;;22,0;;;1,0;;7,0;1,0;3,0;4,0;;;;;1,0;1,0;3,0;2,0;;4,0;;;;;24,0;5,0;1,0;;;;13,0;;;;;;;;;1,0;;;;;7,0;3,0;;;;;;5,0;4,0;;;;4,0;2,0;;;2,0;;;;15,0;;3,0;;;;;;;;4,0;2,0;;;;;3,0;;;2,0;6,0;;;;;1,0;3,0;;;9,0;;;;;;1,0;;;;;;;;;;;1,0;;;;;1,0;;1,0;;;;;;;;;;;2,0;;4,0;;;4,0;2,0;;;;1,0;;;6,0;2,0;1,0;;;;5,0;;1,0;10,0;;8,0;;;;;;5,0;;;;;;4,0;;;;;;1,0;1,0;;;3,0;;1,0;;10,0;1,0;;;;;;;;6,0;;;;;;1,0;;;;1,0;;;1,0;;;;;;;;1,0;1,0;15,0;;;;;;;;;;;;7,0;;;1,0;;2,0;;2,0;1,0;;2,0;;3,0;2,0;;;;6,0;;3,0;3,0;2,0;;;1,0;3,0;;;3,0;;;;17,0;11,0;;;;;;;;;4,0;;1,0;;;;;;;;;;;;2,0;;;;;;;;1,0;;;;;12,0;;;;;;5,0;1,0;;;;2,0;;3,0;;;;;;;;;;;;1,0;;1,0;;5,0;;;;;13,0;;;;;;;;;;;;;;5,0;;2,0;;;;3,0;;;;1,0;;;1,0;;;;;;;;;;;9,0;;;4,0;;;;;;;;;;;;;;;7,0;2,0;;4,0;;1,0;;3,0;;;;;;;;;;;;;;;1,0;;;;;;;;;;;;;;;;;;;;;;;;;;1,0;;1,0;;;;10,0;;;;;;;;4,0;;;;;;2,0;;;;;1,0;;;;;15,0;;;;;;;;;;4,0;;;2,0;;;;;;2,0;;;;;3,0;;;;;;;;;;1,0;;;;;;;;;;;;;;;;;1,0;;;5,0;;;;;;;3,0;;10,0;;;;;;;;;;;;3,0;;;;1,0;;;;;;;;;;1,0;;1,0;;;;;;;;;;;;2,0;;;;;;;6,0;;;;;;;;;;3,0;;;;10,0;;1,0;;;;;;3,0;38,0;;;;;;;;1,0;;;;2,0;;;;;;;;;;;;1,0;;;;;;;;1,0;;2,0;;;;;;3,0;2,0;;1,0;;;;;;;;2,0;;;;;;;;;;;;;;;;;;;;;;;1,0;;;2,0;;;;;;1,0;;;;;;;;3,0;;;4,0;;;2,0;;;;;;;;;;;;;;;;;1,0;;;;;;;;;;;;;;;;;;;1,0;;;;;1,0;;23,0;;;;;;;;;;;;;;;;;;;;;8,0;;;;;;;;;21,0;;;1,0;;;;;;;;;;;;;;;;;;1,0;;;;;;;;;;;;;;;1,0;;;;;;;;;;;;;;;;;;;;;;;;;;;;;;;;;;;;;;;;;;;;;;;;;;;;;;;;;;;;;;;;;;;;;;;;;;;;;;;;5,0;;;;;;;;;;;;1,0;;;;;;;;;;;;;;;;;
manipulate;;1,0;3,0;;;2,0;;4,0;;;;;;;18,0;11,0;;;;;4,0;94,0;1,0;;;;12,0;;;;4,0;1,0;8,0;8,0;18,0;11,0;;;;;27,0;14,0;1,0;;3,0;;4,0;13,0;2,0;8,0;;;;;;;3,0;2,0;;;6,0;7,0;;1,0;;;5,0;;;;1,0;;4,0;;;;;;;115,0;1,0;1,0;;5,0;52,0;10,0;;;;;6,0;;;1,0;;;;;19,0;;9,0;;2,0;16,0;;2,0;;;1,0;1,0;1,0;2,0;1,0;;;2,0;1,0;6,0;1,0;2,0;;;;;3,0;;;;;;;9,0;2,0;;;;;4,0;;;;;;2,0;1,0;;;;;;;1,0;1,0;3,0;;;8,0;;1,0;;;3,0;5,0;;;;2,0;6,0;;;2,0;;;;;1,0;3,0;;;;2,0;3,0;;;;;;;;;8,0;;;;;;;;;;;;;;;;;;6,0;;;;;;;;;;;;2,0;;;;;;1,0;;2,0;;12,0;;3,0;3,0;;3,0;5,0;;;;;;;;;;;;;2,0;;;;;;;5,0;;;;;;;5,0;;;;;3,0;;;;;;1,0;;;;;3,0;1,0;;;;;1,0;;;;;;;;;;;;;;;;8,0;3,0;;;2,0;;;;;;;;;;1,0;;;;;2,0;;;;;;;;;;;1,0;;4,0;;;1,0;2,0;;;;;1,0;;;;;;;;;;;;;;2,0;1,0;;;;1,0;;;;;;;1,0;;;;;;;;1,0;;;;;;6,0;2,0;;;;;;1,0;;3,0;;;;;;;;;;;;;;;;;;;3,0;;;;4,0;;;;2,0;;;;;;;;;1,0;;;;5,0;24,0;;2,0;;;;12,0;;;;;;1,0;1,0;9,0;;4,0;2,0;;;;;;9,0;2,0;;;;2,0;1,0;;1,0;;;;;1,0;;;;1,0;;25,0;;;;;;15,0;;;;;;;;1,0;;;;;;;;;;2,0;;;;;;1,0;;;;;;;;;;;;;;;3,0;;;;1,0;;;;;;;;;;;;;1,0;;;;4,0;;;;;2,0;;6,0;;;;;;;;;;;;3,0;;;;;;2,0;;;;;;;;;;2,0;;;;;;;;;;;;2,0;1,0;;;;;;;;;;;;;;3,0;;;;;;;;2,0;;2,0;;;;;;;;;;;;;;;;;;;;;;3,0;;;;1,0;;;;1,0;;;;;;19,0;;;2,0;;;;;;;;;;;;;;;;2,0;;;2,0;1,0;;;;;;;2,0;;;;2,0;;;;;;;;;;;;;;;;4,0;;;;;;;;1,0;;;;;;;;;;;;;;;1,0;;;2,0;;;;;;;;;;;;;;;;;;;1,0;;;;;;;;;;;;;;;;;;;;;;;;;;;;;;;;;;;;;;;;;;;;;;;;;;1,0;;;;;;;;;;;;;7,0;;;1,0;;;;;;;;;;;;4,0;;;;;;;;;;;;;;;;;;;;;1,0;;1,0;;;;;;;1,0;4,0;;;;;;;;;;;;;1,0;;;;;;;;;;;;;;;;;;;;;;;;;;;;;;;;;6,0;;1,0;;;;;1,0;;;;;;;;;;;;;;;7,0;;;;;;;;;;;;;1,0;;;;;;1,0;;;;;;;;;;;1,0;;;;;;;;;;;;;;;;;;;;;;;;;;;;;;;;;;;;;;;;;;;;;;;;;
marker;;1,0;;;1,0;9,0;1,0;12,0;8,0;10,0;;;13,0;;5,0;64,0;;;;4,0;99,0;26,0;4,0;;;4,0;4,0;2,0;;1,0;;;9,0;1,0;1,0;;8,0;2,0;;;59,0;;21,0;7,0;19,0;;34,0;38,0;3,0;18,0;6,0;19,0;;;;8,0;;;4,0;1,0;12,0;40,0;17,0;;1,0;;1,0;3,0;32,0;;;;2,0;;1,0;2,0;17,0;;1,0;190,0;;13,0;;67,0;1,0;1,0;;;;;1,0;;;2,0;2,0;2,0;3,0;;56,0;3,0;;;;41,0;;3,0;4,0;2,0;;2,0;;4,0;;;;83,0;7,0;98,0;;16,0;;;2,0;7,0;5,0;;1,0;;5,0;;;64,0;52,0;;15,0;;14,0;8,0;;;34,0;;1,0;14,0;5,0;;;2,0;2,0;4,0;1,0;;;9,0;2,0;2,0;46,0;;;;2,0;5,0;7,0;1,0;;;14,0;29,0;8,0;2,0;2,0;;;6,0;2,0;7,0;6,0;1,0;;;;9,0;;;;;;;;;2,0;;;;;;;;;;;1,0;15,0;6,0;2,0;;;;;;;;;;;;;;1,0;;1,0;;;;;;;;16,0;;;2,0;;;;7,0;10,0;;;2,0;;1,0;;;;;;36,0;8,0;35,0;;;4,0;;;;7,0;9,0;;;;;1,0;10,0;;;4,0;;;;;5,0;15,0;;;;6,0;;;18,0;1,0;;;;;3,0;;1,0;;;4,0;1,0;;;;;;1,0;;;;5,0;2,0;;;;;;1,0;;;;;;4,0;1,0;;;;3,0;;;1,0;;;;3,0;;;1,0;;;;;;11,0;;;;4,0;;;4,0;;;;;;3,0;18,0;;2,0;;;;;;22,0;;;;21,0;;;;;;;;;;;;;;;;;;;;;;;2,0;;;;;;2,0;42,0;;1,0;;;;2,0;1,0;;;;;1,0;;;;;2,0;17,0;1,0;1,0;1,0;4,0;8,0;8,0;8,0;;;;;;12,0;;;;;20,0;;;;2,0;;;141,0;;1,0;;10,0;1,0;1,0;1,0;11,0;;;1,0;;;16,0;;;;;;;;;3,0;;;1,0;;;;;;;;;17,0;;;;6,0;1,0;;1,0;;;;15,0;7,0;;3,0;7,0;;;1,0;;;;2,0;;1,0;;1,0;;;7,0;3,0;;;;;;;6,0;;;;;3,0;;;;;;;2,0;;;1,0;;5,0;;;;;;;;2,0;;;;;5,0;;;;;;;;;3,0;;;;2,0;;;;9,0;;;1,0;;;;;;;4,0;;;;;;;;;2,0;;2,0;;;;1,0;;;;;;;;;1,0;;;9,0;;;;;;;;1,0;;2,0;;;1,0;2,0;3,0;;;3,0;;;;;;;1,0;;;;;;;;;2,0;;7,0;;;;;;;3,0;4,0;;;;;;3,0;;;;3,0;2,0;;;1,0;;1,0;;;2,0;;;;;6,0;;2,0;;;;;3,0;;;;;;;;9,0;;;;;;;;;;;;1,0;;4,0;;;;;;;;1,0;2,0;1,0;;;;;;12,0;;5,0;4,0;;;;;;;;;;1,0;;;;;;;;;;;;1,0;2,0;;;1,0;;16,0;;10,0;;;;;;;;;;;;;18,0;;1,0;;;;;;;;;;;;;;2,0;4,0;;;;;;;;;;;1,0;;;87,0;;;;;;;;;;;8,0;;;;;;;;4,0;2,0;2,0;9,0;;2,0;;;;;;;;;;;;1,0;;;;9,0;;;;;;;;;;;;6,0;;21,0;1,0;;;;;;1,0;1,0;1,0;;;;;;;;;;;;;6,0;;;;;;;;;10,0;;;;2,0;;5,0;1,0;;2,0;;2,0;;;2,0;;;;;6,0;;;;;;;;;;;;;;;;;;;1,0;;;;;;;;1,0;1,0;;;;2,0;;;1,0;;;2,0;2,0;;1,0;;;;;9,0;;;;;;;;;;2,0;;;;2,0;;;;;;;;;3,0;2,0;;;;;;;;;;1,0;2,0;;;;2,0;;;;;;;;;;;2,0;1,0;;3,0;;2,0;8,0;;;;;;;;2,0;;;;;
mechanism;;6,0;1,0;6,0;;82,0;10,0;63,0;10,0;14,0;7,0;;6,0;1,0;77,0;78,0;4,0;;;;5,0;32,0;8,0;1,0;1,0;1,0;;3,0;;1,0;1,0;;143,0;;247,0;60,0;;9,0;2,0;;19,0;1,0;4,0;6,0;23,0;25,0;17,0;175,0;38,0;7,0;28,0;112,0;;;163,0;12,0;44,0;1,0;;;14,0;2,0;30,0;2,0;9,0;35,0;88,0;48,0;28,0;15,0;1,0;2,0;9,0;4,0;;15,0;2,0;1,0;8,0;103,0;7,0;43,0;;235,0;;7,0;6,0;;1,0;37,0;348,0;;;1,0;6,0;8,0;9,0;;36,0;4,0;6,0;3,0;73,0;17,0;1,0;23,0;71,0;3,0;4,0;6,0;7,0;25,0;;;10,0;31,0;117,0;222,0;21,0;10,0;1,0;;11,0;11,0;8,0;1,0;1,0;;;10,0;;7,0;12,0;2,0;2,0;;15,0;25,0;;1,0;6,0;4,0;13,0;46,0;11,0;4,0;;15,0;30,0;2,0;1,0;1,0;;4,0;5,0;12,0;116,0;;84,0;1,0;2,0;9,0;88,0;;3,0;;28,0;12,0;1,0;;68,0;;1,0;5,0;8,0;13,0;66,0;19,0;19,0;;16,0;48,0;;;2,0;12,0;;32,0;;;;;;109,0;2,0;11,0;1,0;1,0;3,0;37,0;1,0;7,0;3,0;27,0;1,0;9,0;42,0;2,0;8,0;9,0;6,0;;14,0;;4,0;;47,0;2,0;3,0;12,0;102,0;;5,0;1,0;;1,0;;13,0;14,0;;164,0;;104,0;158,0;82,0;54,0;48,0;47,0;3,0;8,0;;9,0;;6,0;1,0;;;2,0;2,0;14,0;27,0;;2,0;;8,0;;62,0;;;;;;4,0;8,0;;8,0;24,0;3,0;81,0;;28,0;11,0;2,0;1,0;;30,0;3,0;24,0;1,0;21,0;68,0;;4,0;2,0;;11,0;;2,0;2,0;;14,0;9,0;63,0;;14,0;;3,0;1,0;1,0;;14,0;20,0;18,0;5,0;13,0;8,0;54,0;3,0;2,0;1,0;2,0;11,0;;;10,0;3,0;6,0;38,0;;153,0;4,0;3,0;5,0;1,0;116,0;;75,0;7,0;2,0;;3,0;6,0;3,0;;9,0;7,0;4,0;47,0;16,0;7,0;2,0;1,0;1,0;6,0;9,0;31,0;101,0;63,0;4,0;3,0;;7,0;;8,0;10,0;48,0;19,0;18,0;10,0;41,0;2,0;1,0;1,0;3,0;18,0;3,0;;3,0;9,0;;2,0;33,0;8,0;9,0;;7,0;7,0;31,0;61,0;99,0;14,0;2,0;;45,0;1,0;54,0;;14,0;;84,0;2,0;14,0;;;12,0;15,0;5,0;5,0;2,0;;;1,0;9,0;36,0;;;;3,0;9,0;1,0;16,0;1,0;;;3,0;3,0;;;1,0;;;3,0;18,0;12,0;;2,0;;1,0;;;1,0;31,0;;92,0;1,0;;;2,0;7,0;;9,0;151,0;98,0;;3,0;15,0;26,0;1,0;3,0;2,0;1,0;1,0;;1,0;2,0;3,0;8,0;;18,0;;2,0;;;5,0;3,0;;;1,0;;5,0;;1,0;18,0;1,0;13,0;3,0;;;1,0;1,0;86,0;5,0;2,0;20,0;;;5,0;;2,0;;;;4,0;3,0;;3,0;;3,0;8,0;;;;;4,0;4,0;;4,0;;1,0;;;4,0;8,0;;;3,0;1,0;7,0;7,0;;1,0;12,0;5,0;64,0;3,0;;;4,0;;2,0;;;10,0;30,0;;8,0;4,0;5,0;;4,0;;12,0;;;;4,0;1,0;;5,0;4,0;;3,0;;1,0;1,0;6,0;;2,0;11,0;1,0;;10,0;;;5,0;5,0;1,0;8,0;;2,0;3,0;;3,0;4,0;3,0;11,0;5,0;6,0;;3,0;;3,0;;5,0;1,0;;1,0;14,0;4,0;;49,0;;7,0;14,0;6,0;;3,0;;30,0;;21,0;;4,0;1,0;;;2,0;;;;10,0;2,0;3,0;35,0;;;2,0;;3,0;1,0;;1,0;1,0;2,0;;;9,0;;1,0;2,0;8,0;3,0;;1,0;;;;9,0;;;;1,0;7,0;;;1,0;10,0;;2,0;6,0;;2,0;;1,0;22,0;30,0;;;9,0;;20,0;;2,0;7,0;1,0;;;11,0;2,0;50,0;6,0;2,0;;2,0;2,0;;;3,0;;;3,0;2,0;17,0;27,0;1,0;;;;1,0;1,0;;;;;;;5,0;2,0;33,0;2,0;;;3,0;2,0;22,0;4,0;1,0;30,0;3,0;1,0;8,0;1,0;;4,0;;5,0;;6,0;10,0;;;13,0;1,0;2,0;;12,0;;;2,0;4,0;;;1,0;2,0;4,0;;23,0;14,0;;1,0;;5,0;;5,0;6,0;;5,0;;;;;1,0;1,0;;;3,0;;1,0;6,0;;;;;6,0;2,0;10,0;;;;;;3,0;5,0;;;;;1,0;;1,0;;;2,0;;2,0;;12,0;;;3,0;;;;2,0;;;;;10,0;1,0;;25,0;1,0;;;;3,0;20,0;;1,0;2,0;;;;;38,0;;1,0;;;1,0;;1,0;;1,0;;2,0;;;;;;;;;2,0;3,0;20,0;;;;1,0;1,0;1,0;3,0;2,0;18,0;3,0;;2,0;;;;;5,0;;18,0;2,0;2,0;;3,0;;;;1,0;;;;;;;;2,0;61,0;;30,0;;9,0;3,0;5,0;7,0;;;;;;1,0;;;;14,0;;9,0;;;;;1,0;2,0;2,0;;;6,0;;;1,0;2,0;11,0;;;;;;2,0;3,0;;2,0;2,0;2,0;;;;;2,0;13,0;;;;3,0;4,0;;;;2,0;;16,0;;4,0;;1,0;;;11,0;;7,0;;;;;;4,0;3,0;2,0;3,0;;6,0;1,0;;;;;;;4,0;;1,0;;;;;;;1,0;;3,0;5,0;;20,0;1,0;;;;2,0;;2,0;;;4,0;;;;;3,0;1,0;;;;;;
media;;11,0;;;9,0;;;26,0;7,0;4,0;;;21,0;;20,0;18,0;;;4,0;1,0;7,0;82,0;6,0;4,0;;;4,0;3,0;;;60,0;10,0;25,0;;8,0;13,0;;;15,0;;97,0;;15,0;2,0;13,0;3,0;29,0;123,0;38,0;33,0;5,0;9,0;;4,0;1,0;12,0;4,0;;4,0;5,0;;2,0;;53,0;19,0;;;4,0;73,0;;;;23,0;1,0;;65,0;55,0;3,0;1,0;123,0;;4,0;;81,0;;50,0;;;;3,0;6,0;2,0;9,0;1,0;2,0;9,0;7,0;18,0;72,0;6,0;8,0;5,0;4,0;4,0;;13,0;6,0;34,0;8,0;4,0;4,0;12,0;;;;59,0;11,0;2,0;;5,0;1,0;;2,0;8,0;30,0;6,0;3,0;1,0;1,0;;;13,0;3,0;3,0;1,0;1,0;4,0;8,0;;;9,0;;7,0;2,0;1,0;;2,0;2,0;20,0;5,0;2,0;;93,0;61,0;1,0;25,0;42,0;;1,0;2,0;129,0;29,0;12,0;;;;29,0;3,0;;4,0;;;;;;2,0;30,0;;;;;;;5,0;1,0;;;4,0;;;;;;3,0;;;72,0;1,0;1,0;;;;4,0;10,0;;;;;4,0;5,0;1,0;;;;;;;;;;3,0;;;11,0;;2,0;;;5,0;;2,0;;11,0;2,0;;3,0;;;;;2,0;2,0;1,0;4,0;;;;2,0;;1,0;;;;;;;55,0;2,0;;3,0;;;3,0;13,0;5,0;;4,0;;;;;22,0;3,0;;;;2,0;1,0;1,0;10,0;2,0;1,0;;;;36,0;;;;;;;;;;;1,0;;;;;1,0;2,0;;;;;;;;;;1,0;;;1,0;1,0;;1,0;32,0;;;;;;;1,0;;;;;;;;;;;;2,0;1,0;3,0;4,0;;;;3,0;14,0;;9,0;2,0;1,0;;;;;;4,0;14,0;43,0;3,0;4,0;2,0;;2,0;;;;1,0;1,0;;;;;3,0;3,0;;;;1,0;1,0;;;;;6,0;;;;;;;6,0;;2,0;;;;;;;;;17,0;;;;;;;3,0;6,0;16,0;5,0;31,0;15,0;;;1,0;;;2,0;9,0;;2,0;5,0;2,0;1,0;3,0;;;;1,0;1,0;;9,0;;10,0;;;;6,0;4,0;3,0;;5,0;10,0;4,0;;1,0;;1,0;;;;;10,0;2,0;4,0;15,0;;2,0;2,0;;2,0;;;16,0;2,0;3,0;4,0;;;3,0;2,0;34,0;4,0;;;;;6,0;11,0;3,0;;;;1,0;3,0;1,0;;;1,0;5,0;22,0;;;2,0;2,0;24,0;;4,0;;5,0;;2,0;1,0;;6,0;1,0;7,0;;1,0;;3,0;14,0;1,0;;;5,0;;1,0;4,0;;;2,0;;21,0;3,0;1,0;;1,0;;;4,0;;;9,0;;1,0;;;;3,0;;7,0;3,0;1,0;18,0;;13,0;;;;42,0;3,0;;;2,0;;;3,0;2,0;1,0;4,0;;31,0;2,0;5,0;;;;;;;6,0;3,0;;;;;4,0;2,0;;81,0;16,0;42,0;;3,0;10,0;1,0;6,0;;;;;;3,0;7,0;;;6,0;2,0;;1,0;;;2,0;;;;;;;;;;;5,0;;36,0;;3,0;;4,0;;4,0;6,0;8,0;2,0;1,0;;13,0;5,0;6,0;8,0;2,0;1,0;9,0;8,0;;2,0;2,0;;3,0;3,0;4,0;;;1,0;;;1,0;;;;;;;3,0;4,0;;;1,0;5,0;;;2,0;1,0;1,0;;8,0;1,0;;;;6,0;;;;;;;4,0;;;;14,0;;;;1,0;;;;10,0;;;;186,0;;;;1,0;;2,0;;;;;;;;;3,0;;1,0;3,0;;;;;;;;254,0;;;;8,0;;;;1,0;;;;;;;;;;;1,0;;;;;;;;3,0;;;;;;;4,0;;;;;1,0;22,0;3,0;;;;3,0;;;;7,0;;;;;;1,0;;;;;;;;1,0;;30,0;;;;1,0;;;;;;;;;;;;;;;2,0;16,0;8,0;;;;;;;;;;;;2,0;;;;;7,0;;;;2,0;;;;1,0;;2,0;;;;2,0;;;2,0;;1,0;;;2,0;2,0;8,0;8,0;;;2,0;;;;;;;;7,0;;1,0;3,0;;;;6,0;;;;;;;;;;1,0;;;1,0;1,0;;;;;;;1,0;;;;;;;;1,0;;;1,0;;;;;;9,0;;;;;;27,0;;4,0;2,0;;;;;;;;8,0;;;;;;;4,0;;;;;1,0;;;;;;;;;;;6,0;;;;;;;;;1,0;;;;;;;;;;1,0;;1,0;;3,0;;;;;;;;;;1,0;;;;;;;;;;;4,0;;2,0;;;1,0;;
member;;42,0;;6,0;;61,0;103,0;218,0;37,0;227,0;2,0;;20,0;3,0;325,0;757,0;14,0;24,0;;;1,0;51,0;25,0;14,0;3,0;5,0;12,0;24,0;;2,0;2,0;44,0;406,0;;186,0;38,0;9,0;65,0;1,0;6,0;5,0;8,0;231,0;9,0;84,0;23,0;6,0;364,0;50,0;40,0;404,0;44,0;;6,0;612,0;89,0;280,0;;1,0;;255,0;11,0;14,0;7,0;38,0;27,0;64,0;285,0;148,0;169,0;30,0;3,0;101,0;;;96,0;3,0;2,0;12,0;271,0;16,0;166,0;;616,0;4,0;4,0;42,0;;12,0;27,0;841,0;;;52,0;2,0;11,0;4,0;;103,0;14,0;;3,0;364,0;35,0;;38,0;451,0;19,0;49,0;;41,0;25,0;26,0;1,0;8,0;392,0;775,0;714,0;35,0;70,0;29,0;23,0;5,0;18,0;5,0;;2,0;;;46,0;7,0;13,0;360,0;17,0;8,0;;57,0;24,0;;1,0;;;3,0;162,0;22,0;15,0;20,0;513,0;44,0;24,0;3,0;1,0;3,0;5,0;10,0;9,0;199,0;;25,0;19,0;;75,0;381,0;2,0;19,0;;11,0;72,0;1,0;7,0;28,0;51,0;25,0;63,0;20,0;75,0;233,0;239,0;58,0;9,0;74,0;375,0;27,0;31,0;176,0;60,0;36,0;18,0;7,0;;19,0;3,0;17,0;663,0;3,0;418,0;;;23,0;291,0;118,0;;;473,0;5,0;605,0;16,0;2,0;26,0;242,0;26,0;43,0;232,0;1,0;16,0;;116,0;49,0;18,0;193,0;492,0;20,0;170,0;15,0;;28,0;24,0;62,0;268,0;12,0;;67,0;223,0;452,0;551,0;251,0;281,0;173,0;127,0;158,0;38,0;22,0;15,0;52,0;2,0;2,0;38,0;;17,0;77,0;410,0;;57,0;57,0;37,0;;365,0;37,0;;8,0;137,0;24,0;136,0;49,0;45,0;11,0;127,0;75,0;69,0;5,0;150,0;27,0;120,0;15,0;;169,0;10,0;99,0;41,0;713,0;40,0;;33,0;83,0;39,0;29,0;;3,0;4,0;51,0;13,0;27,0;119,0;12,0;114,0;2,0;16,0;6,0;72,0;87,0;139,0;51,0;277,0;21,0;42,0;47,0;199,0;60,0;178,0;9,0;5,0;111,0;19,0;77,0;97,0;32,0;6,0;55,0;16,0;171,0;3,0;11,0;10,0;55,0;424,0;7,0;172,0;142,0;2,0;15,0;55,0;79,0;20,0;12,0;;14,0;8,0;291,0;234,0;246,0;9,0;13,0;69,0;5,0;20,0;74,0;270,0;64,0;85,0;6,0;21,0;51,0;;38,0;328,0;136,0;28,0;22,0;7,0;2,0;10,0;36,0;29,0;68,0;98,0;8,0;;136,0;47,0;144,0;22,0;54,0;33,0;2,0;141,0;5,0;68,0;114,0;288,0;255,0;82,0;11,0;2,0;191,0;48,0;17,0;462,0;27,0;;741,0;55,0;133,0;8,0;13,0;87,0;44,0;12,0;11,0;41,0;2,0;;;1,0;30,0;;4,0;;1,0;1,0;6,0;56,0;;1,0;1,0;;8,0;2,0;2,0;;;;1,0;18,0;;;;;;;;1,0;10,0;5,0;10,0;3,0;;2,0;5,0;16,0;;11,0;67,0;313,0;;19,0;126,0;408,0;;14,0;1,0;10,0;1,0;;2,0;3,0;5,0;3,0;;;;2,0;;;8,0;4,0;32,0;18,0;15,0;;16,0;;2,0;5,0;;36,0;;1,0;;40,0;;80,0;30,0;;44,0;;;;;14,0;1,0;2,0;;2,0;14,0;5,0;5,0;12,0;7,0;14,0;1,0;164,0;;1,0;55,0;;;31,0;;;;;5,0;;;;;6,0;;7,0;1,0;;1,0;33,0;40,0;5,0;;4,0;21,0;;2,0;;;13,0;87,0;;16,0;14,0;9,0;5,0;30,0;;151,0;12,0;2,0;;1,0;3,0;;15,0;11,0;;2,0;9,0;3,0;;8,0;;1,0;36,0;28,0;;18,0;;17,0;24,0;8,0;3,0;24,0;1,0;2,0;2,0;1,0;2,0;;10,0;10,0;1,0;6,0;;8,0;;12,0;;9,0;6,0;;;;62,0;;;2,0;16,0;50,0;19,0;10,0;;;4,0;5,0;61,0;;2,0;2,0;;2,0;;2,0;;;20,0;2,0;12,0;3,0;18,0;;5,0;;;2,0;;;1,0;;15,0;;15,0;6,0;7,0;2,0;2,0;11,0;;29,0;1,0;;;41,0;;;;;6,0;1,0;;2,0;42,0;3,0;;7,0;17,0;;1,0;34,0;30,0;69,0;1,0;5,0;18,0;17,0;191,0;;;14,0;12,0;22,0;6,0;20,0;28,0;24,0;8,0;159,0;8,0;;;7,0;1,0;16,0;48,0;8,0;40,0;11,0;12,0;71,0;85,0;15,0;;35,0;21,0;11,0;1,0;;8,0;1,0;2,0;11,0;21,0;2,0;8,0;4,0;3,0;;19,0;6,0;66,0;44,0;;3,0;17,0;36,0;17,0;1,0;;188,0;;;;1,0;154,0;26,0;7,0;16,0;94,0;2,0;4,0;139,0;126,0;27,0;38,0;36,0;;;6,0;;16,0;;;40,0;34,0;54,0;;10,0;;12,0;60,0;23,0;;28,0;17,0;;6,0;;;93,0;4,0;10,0;3,0;10,0;21,0;2,0;;;4,0;;3,0;1,0;;;6,0;;;20,0;4,0;;;6,0;1,0;4,0;;6,0;1,0;8,0;9,0;;9,0;;;;;1,0;;;;67,0;;;;;13,0;7,0;;7,0;5,0;2,0;;;2,0;204,0;;8,0;;;;;2,0;5,0;;3,0;2,0;;;;46,0;;;;17,0;6,0;;;;;13,0;1,0;2,0;;1,0;15,0;24,0;;1,0;;1,0;7,0;3,0;;20,0;6,0;;;1,0;;;;1,0;;;;;;2,0;5,0;202,0;;4,0;;;;;9,0;;3,0;1,0;69,0;2,0;4,0;;10,0;2,0;1,0;227,0;18,0;;;5,0;;;;;;;;2,0;9,0;;;;;2,0;3,0;2,0;;26,0;;;1,0;10,0;27,0;;20,0;;1,0;3,0;34,0;2,0;;;2,0;7,0;5,0;;7,0;210,0;2,0;16,0;7,0;10,0;;;;;;;;2,0;;;22,0;;;;;12,0;;;30,0;;;;19,0;;6,0;;30,0;26,0;12,0;3,0;2,0;;;1,0;;12,0;;1,0;;;;1,0;;;;;1,0;;;;27,0;4,0;;;;4,0;11,0;;;;;;;;;;4,0;;;;4,0;;
middle;;3,0;;;;1,0;3,0;;;;2,0;;;;7,0;6,0;;;;;;;3,0;;1,0;;;;1,0;;;2,0;6,0;;4,0;2,0;10,0;;6,0;;;;3,0;;;;;;;1,0;11,0;6,0;3,0;;13,0;7,0;1,0;;;;5,0;;2,0;;1,0;2,0;4,0;5,0;8,0;7,0;;;;;;;;;;24,0;;1,0;;6,0;;;;;3,0;2,0;9,0;;;1,0;;;;;4,0;1,0;;;16,0;1,0;;;6,0;;2,0;;;;;;;;19,0;17,0;3,0;;;1,0;;1,0;;;;;1,0;;;;6,0;;1,0;;8,0;;;;;;;8,0;;;;18,0;3,0;;;;;;;;4,0;1,0;;1,0;;;7,0;;;;;2,0;;2,0;4,0;;;2,0;;;9,0;;;;;32,0;;;;2,0;;;;;;;;7,0;;;;;;;;;;;;5,0;2,0;;;4,0;;;1,0;;;;;;1,0;;;;4,0;;;;;;;;8,0;;;6,0;;3,0;3,0;;;4,0;;1,0;;;;;;;2,0;1,0;7,0;;;;;;;;;2,0;;;;;;;1,0;;;;;;2,0;;;4,0;1,0;;1,0;5,0;;;;;;;2,0;;;;;2,0;;;2,0;;;;;;;;5,0;;;1,0;;;4,0;;;;;;;3,0;;3,0;;;;;;;;;1,0;;;;2,0;2,0;;;2,0;2,0;;2,0;;1,0;;;;3,0;;2,0;;12,0;3,0;;1,0;1,0;;;;;3,0;1,0;;;;;;;;;;2,0;4,0;;;;;;;;1,0;;2,0;5,0;;;19,0;1,0;;;;1,0;;5,0;;;;;;;7,0;;;;;;;;;;;;;;;;;;;;;;;;;;;2,0;;;;;;;;;11,0;;3,0;;;;;;1,0;;;;;;;;;;;;;;;;;;;;;1,0;;;;;;;2,0;;;;;;;;;;3,0;;1,0;;;;;;2,0;;;;;;;;;;;;1,0;;;;;;;;;;;;;2,0;;;;;;;;;;;;;;;;;;;;;;;;3,0;;;;;;12,0;;;;;;;;;;11,0;;;;;;;5,0;;;;;4,0;;;;;;;;;;;;;4,0;;;;;;;;;;;;;;;;;;;;;;4,0;;5,0;;;;;;;;;;;3,0;22,0;;;;;;;;;;1,0;;;;3,0;;;;;;;;;;;1,0;;;;;;;;;;;;;;;;1,0;;1,0;;2,0;;3,0;3,0;;;;;;;1,0;;3,0;;1,0;;;;;;;7,0;1,0;;;;5,0;1,0;1,0;;;;;1,0;;;;1,0;;1,0;;2,0;;;;;;1,0;;;;1,0;;;;;14,0;;;;;;;;;;;5,0;;1,0;;;1,0;1,0;;;;;;;;2,0;;;;;;;;;1,0;;;;;;;;;;;2,0;;;;;;;;;;;;;;;;;;;1,0;;;;;;;1,0;;1,0;;;;;;;;;;1,0;;;;;;;;;;;;;;1,0;;;;;4,0;;;;;1,0;1,0;;;;;;;;;;;;;;;;;;;;;;;;;;;;;;;;;;;;1,0;;;;;;;;;;;;;;;;;;2,0;;;;;1,0;;;;;;;;;;;;;;;;;;;;;;;;;;;;;;;;;;;;3,0;;;;;;;;;;;;;1,0;;;;;1,0;;;;;;;;;;;8,0;;;;;;;;;;;;;;;;;;;;;;;;;;;;;;;;;2,0;;;;;1,0;;;;;;;;;;;;;;;;
mirror;;29,0;;1,0;;44,0;25,0;67,0;18,0;57,0;4,0;27,0;24,0;4,0;73,0;4,0;37,0;;;;;11,0;;;;;2,0;4,0;;;2,0;1,0;102,0;;94,0;14,0;;5,0;4,0;;10,0;;17,0;;13,0;6,0;8,0;138,0;37,0;177,0;87,0;16,0;;;129,0;2,0;288,0;;2,0;;7,0;2,0;36,0;8,0;6,0;2,0;17,0;33,0;48,0;12,0;15,0;7,0;5,0;;2,0;3,0;;19,0;11,0;149,0;;58,0;;184,0;4,0;8,0;;;1,0;26,0;108,0;;;5,0;2,0;;;;39,0;14,0;;1,0;71,0;37,0;3,0;10,0;162,0;4,0;17,0;1,0;19,0;19,0;4,0;;;23,0;109,0;314,0;4,0;5,0;10,0;6,0;1,0;3,0;7,0;1,0;;;8,0;7,0;;;4,0;3,0;;;;5,0;;;5,0;;;74,0;10,0;;;99,0;22,0;;1,0;2,0;;6,0;23,0;;452,0;23,0;3,0;;1,0;16,0;356,0;;1,0;4,0;41,0;150,0;13,0;;5,0;20,0;1,0;4,0;2,0;21,0;292,0;;1,0;;;34,0;;6,0;7,0;38,0;1,0;6,0;;;1,0;;4,0;28,0;;123,0;1,0;;;61,0;;14,0;1,0;41,0;;;2,0;;3,0;15,0;;;8,0;2,0;32,0;;;;3,0;4,0;234,0;15,0;2,0;;;842,0;2,0;7,0;186,0;;223,0;1,0;;225,0;256,0;55,0;10,0;56,0;16,0;8,0;;14,0;23,0;77,0;13,0;;;2,0;1,0;17,0;17,0;3,0;3,0;20,0;;1,0;60,0;164,0;27,0;;;;3,0;11,0;;1,0;1,0;1,0;29,0;;1,0;27,0;8,0;;12,0;20,0;5,0;76,0;;57,0;9,0;9,0;1,0;6,0;2,0;13,0;1,0;5,0;;14,0;106,0;1,0;2,0;;5,0;;;41,0;;11,0;10,0;7,0;167,0;;14,0;;21,0;6,0;6,0;;;13,0;1,0;;15,0;;4,0;1,0;11,0;27,0;;10,0;1,0;4,0;3,0;;8,0;2,0;2,0;37,0;6,0;9,0;;;8,0;;;25,0;2,0;2,0;;4,0;16,0;2,0;3,0;;;11,0;12,0;10,0;;5,0;11,0;;;71,0;3,0;63,0;4,0;1,0;;13,0;;;;2,0;;26,0;1,0;64,0;2,0;7,0;;;;;2,0;25,0;184,0;96,0;1,0;13,0;;65,0;;4,0;1,0;;;60,0;;4,0;1,0;;4,0;7,0;;;5,0;;;;1,0;3,0;;;1,0;10,0;;6,0;5,0;2,0;;;;;;;2,0;;;;4,0;2,0;;;1,0;;;;;12,0;;2,0;14,0;;2,0;7,0;19,0;;45,0;3,0;21,0;;;3,0;21,0;3,0;9,0;2,0;34,0;;;;;3,0;3,0;;1,0;;4,0;;1,0;2,0;;;;2,0;2,0;2,0;;1,0;3,0;;8,0;1,0;;;8,0;1,0;12,0;18,0;;20,0;17,0;;;;;6,0;11,0;;2,0;;;8,0;;;1,0;;104,0;;7,0;37,0;6,0;;4,0;4,0;;;;2,0;;;2,0;;;;33,0;;;3,0;3,0;35,0;;;;;;32,0;;;;7,0;;12,0;1,0;1,0;;;;;3,0;1,0;;6,0;5,0;;84,0;;;;;3,0;;4,0;;;;105,0;;;;3,0;4,0;9,0;7,0;9,0;;;;;7,0;;2,0;4,0;1,0;;;;1,0;5,0;;;5,0;3,0;;;;1,0;;;;17,0;10,0;;;;2,0;;20,0;;11,0;;3,0;34,0;;;;;;1,0;1,0;;;;;1,0;;;;14,0;;;3,0;;18,0;1,0;4,0;;1,0;1,0;;;;2,0;4,0;;;;;4,0;6,0;;;7,0;;1,0;4,0;;;;;6,0;39,0;201,0;;;;;;;3,0;;;;;5,0;2,0;4,0;24,0;1,0;;12,0;17,0;;;;;6,0;;3,0;154,0;;;1,0;;;;;;;;10,0;;7,0;27,0;;;;863,0;17,0;;1,0;10,0;36,0;;;;6,0;1,0;;;2,0;;5,0;;;;;2,0;3,0;1,0;6,0;;2,0;;1,0;4,0;40,0;;;;;19,0;1,0;11,0;;;10,0;;;;;;;;3,0;1,0;;1,0;3,0;;3,0;;;;;6,0;;;21,0;;1,0;;1,0;;;6,0;;;;2,0;;;;;4,0;;;;;;;8,0;;15,0;;;;1,0;;7,0;5,0;;;;;;8,0;;;1,0;;;;1,0;;;;;;;1,0;1,0;;;;;;;1,0;;1,0;22,0;;;;;2,0;4,0;;7,0;;3,0;6,0;;28,0;;;18,0;;2,0;2,0;;;;1,0;;;1,0;;;;;;;1,0;;1,0;;;;;1,0;;3,0;;1,0;;1,0;;;115,0;5,0;4,0;;8,0;;3,0;6,0;2,0;;;;;;;;;;;;;;;;;;;2,0;;;5,0;;4,0;;2,0;;;;1,0;;2,0;7,0;1,0;3,0;3,0;;;;;1,0;;;;;;;;;;;;;;;32,0;;2,0;;;;11,0;;;3,0;;;4,0;;1,0;1,0;;57,0;;;1,0;;;;;;;;;;;;;;;;;;;;;;;;;6,0;;;;;2,0;;;;;;15,0;;;;;;
mode;;10,0;3,0;5,0;2,0;18,0;38,0;131,0;33,0;10,0;4,0;;33,0;2,0;7,0;190,0;8,0;11,0;31,0;;15,0;359,0;58,0;1,0;;;76,0;9,0;;1,0;27,0;40,0;155,0;6,0;487,0;118,0;19,0;45,0;13,0;;171,0;5,0;16,0;11,0;95,0;47,0;194,0;302,0;127,0;484,0;;45,0;24,0;6,0;80,0;;41,0;;8,0;;17,0;13,0;33,0;12,0;21,0;11,0;150,0;11,0;140,0;3,0;28,0;47,0;72,0;6,0;;48,0;30,0;20,0;7,0;1053,0;;186,0;;253,0;6,0;27,0;37,0;1,0;;14,0;139,0;5,0;2,0;;15,0;34,0;40,0;1,0;299,0;10,0;;2,0;93,0;72,0;;69,0;30,0;20,0;121,0;61,0;12,0;204,0;;4,0;3,0;256,0;113,0;96,0;148,0;127,0;4,0;;54,0;249,0;34,0;15,0;;4,0;1,0;38,0;;32,0;1,0;6,0;17,0;69,0;7,0;114,0;23,0;9,0;102,0;1,0;10,0;137,0;162,0;;;4,0;285,0;28,0;33,0;;43,0;58,0;41,0;59,0;315,0;4,0;33,0;14,0;13,0;77,0;367,0;;8,0;2,0;69,0;176,0;15,0;6,0;20,0;;;2,0;32,0;15,0;8,0;2,0;3,0;;1,0;67,0;;;9,0;42,0;;19,0;;;5,0;8,0;;29,0;;7,0;;;4,0;;;;6,0;38,0;2,0;;2,0;5,0;107,0;14,0;16,0;;2,0;5,0;;;;;;;6,0;;;;;2,0;2,0;;185,0;1,0;16,0;;19,0;3,0;15,0;30,0;33,0;7,0;;;;7,0;2,0;8,0;39,0;3,0;4,0;;96,0;5,0;;24,0;;26,0;;1,0;132,0;;;;;;;720,0;;2,0;1,0;;44,0;;7,0;44,0;5,0;;;;38,0;1,0;;9,0;458,0;9,0;51,0;1,0;37,0;90,0;1,0;27,0;4,0;;66,0;3,0;24,0;;2,0;8,0;2,0;;;;2,0;12,0;;;;;;22,0;;2,0;32,0;33,0;1,0;;31,0;21,0;;8,0;;6,0;;3,0;2,0;;50,0;2,0;14,0;;1,0;75,0;;;;;;23,0;2,0;4,0;5,0;;;;5,0;10,0;7,0;;9,0;1,0;6,0;8,0;;;130,0;35,0;2,0;2,0;;20,0;36,0;9,0;18,0;9,0;;;;;1,0;4,0;3,0;;3,0;9,0;;4,0;15,0;;;2,0;13,0;9,0;;1,0;;;;36,0;;;;31,0;;32,0;12,0;;;11,0;2,0;7,0;;25,0;1,0;;23,0;13,0;1,0;;1,0;;3,0;16,0;217,0;4,0;20,0;10,0;5,0;18,0;;38,0;5,0;3,0;;;8,0;25,0;8,0;6,0;10,0;9,0;;15,0;3,0;94,0;15,0;4,0;5,0;8,0;16,0;5,0;;;32,0;66,0;118,0;;40,0;409,0;917,0;4,0;4,0;60,0;39,0;;;69,0;24,0;130,0;4,0;;;1,0;48,0;;27,0;44,0;;;65,0;15,0;30,0;25,0;;2,0;18,0;6,0;184,0;;12,0;1,0;6,0;3,0;49,0;;1,0;42,0;;14,0;;9,0;7,0;2,0;3,0;1,0;28,0;33,0;12,0;6,0;4,0;5,0;30,0;;7,0;;55,0;293,0;96,0;2,0;34,0;;304,0;24,0;;36,0;;13,0;2,0;15,0;;18,0;33,0;11,0;4,0;45,0;5,0;59,0;1,0;;1,0;;13,0;5,0;6,0;22,0;21,0;11,0;35,0;;67,0;10,0;22,0;4,0;112,0;;12,0;;73,0;8,0;10,0;11,0;3,0;199,0;;;12,0;;13,0;;9,0;7,0;;30,0;;14,0;9,0;1,0;;40,0;;44,0;5,0;4,0;9,0;;8,0;;;32,0;2,0;;;3,0;;;3,0;;58,0;19,0;;12,0;3,0;16,0;1,0;3,0;10,0;4,0;;13,0;5,0;;1,0;1,0;2,0;3,0;;10,0;1,0;23,0;32,0;;1,0;55,0;5,0;;;;8,0;7,0;;;5,0;3,0;55,0;3,0;;15,0;1,0;8,0;60,0;46,0;;13,0;2,0;;3,0;10,0;2,0;;4,0;;9,0;2,0;;8,0;8,0;6,0;;26,0;2,0;;15,0;4,0;;49,0;;;1,0;2,0;67,0;5,0;;1,0;;6,0;;1,0;31,0;;;13,0;;28,0;26,0;;7,0;12,0;;7,0;1,0;;;;1,0;5,0;1,0;;;11,0;21,0;10,0;;;;10,0;;;;1,0;1,0;;32,0;;;8,0;;;;14,0;4,0;307,0;;;14,0;;;13,0;;5,0;;;;;2,0;;;;3,0;3,0;;1,0;;;;;;7,0;7,0;5,0;;;;5,0;5,0;;;6,0;;;;;;43,0;;;;1,0;;;;1,0;13,0;;;4,0;;;;26,0;2,0;6,0;;4,0;;1,0;4,0;6,0;6,0;1,0;3,0;;4,0;7,0;2,0;19,0;;2,0;3,0;4,0;34,0;17,0;15,0;14,0;56,0;1,0;;5,0;;;;3,0;1,0;40,0;18,0;4,0;;7,0;;1,0;1,0;;7,0;;10,0;1,0;;5,0;;;5,0;26,0;;2,0;12,0;;3,0;23,0;;;;11,0;6,0;8,0;4,0;11,0;;35,0;5,0;2,0;;1,0;;81,0;;4,0;19,0;;21,0;;;8,0;;28,0;;6,0;7,0;;;;1,0;1,0;6,0;;10,0;;;1,0;;;34,0;2,0;1,0;;2,0;12,0;;;;;35,0;;;;;;2,0;3,0;7,0;154,0;;4,0;42,0;;4,0;;4,0;;2,0;;;27,0;13,0;;;21,0;10,0;;;1,0;;;1,0;;;3,0;;4,0;1,0;10,0;6,0;;1,0;;1,0;2,0;8,0;;;1,0;;;2,0;1,0;;;3,0;1,0;;;;;;;;;;3,0;15,0;;;;1,0;;;2,0;1,0;;;;;4,0;;;1,0;;3,0;;7,0;;14,0;;;;;;;;;1,0;5,0;12,0;1,0;;1,0;;;2,0;4,0;1,0;22,0;;;;;;1,0;11,0;;1,0;5,0;;5,0;
modular;;1,0;;;;;;;;2,0;;;;;;1,0;;;;;;;;;;;;;1,0;;;;4,0;;1,0;;2,0;;;;;;;;;;;2,0;10,0;2,0;;;;;;;;;;;2,0;;;;2,0;;;2,0;1,0;;1,0;;;;;;;;;5,0;;;;3,0;;;;;;;2,0;;;;;;;;7,0;;;;17,0;;;;;;;;;;;;;2,0;;;3,0;;;;;1,0;;;;;;;;;;;;3,0;;;;;;;;4,0;;;;3,0;;;;1,0;;;;;17,0;;;;;;7,0;;;;;;;;;;;;;;3,0;;;;;7,0;;;;;;1,0;;;1,0;;;5,0;;;;;;2,0;;;;;;;;;;;;;;;1,0;;;;;;;;;;;3,0;;;;;1,0;;10,0;3,0;;;;1,0;1,0;;;;;;;;;;2,0;;1,0;;;;;;8,0;;;;;;;;;;;;;;;2,0;;;;;;2,0;;;;;;;;;;;;;;;;;;;;;;;;;;;;;;;;;;;;;;;;1,0;;;;;;;;;;;;;;1,0;;;;;;;;;;;2,0;;;;;;;2,0;;;;;;;;;1,0;;;;;;;;;;;;;;;;;;;;;;;;6,0;;;;;;;1,0;;;;;;;;;2,0;;;;;1,0;;;;;;;;;;;;;;;;;;;;;;;;;;;;;;;;;;;;;8,0;4,0;;;;;1,0;;;;;;;;1,0;1,0;;;;;;;;;;;;;;;;;;;4,0;;;;;;;;;;;;;;1,0;;;;;;;;;;7,0;;;;;;3,0;;;1,0;;;;;;3,0;;;;;1,0;;;;2,0;;;;;;;;;;4,0;1,0;;;;;;;;;;;;;;;;;;;;;;;;;;;;;;;;;;2,0;;;;;;;1,0;3,0;;;;;;;;;3,0;;;;1,0;;;;;;;;;;;;;;;;;;;;;;1,0;;;;;;;;;;;;;;;;;;2,0;;;;;;;;;;;;;;;;;;;;;;;;;;;;;;;;;;;;;;;;;;;;;4,0;;;;;;;;;;;;2,0;;;;;;;;;;;;;;;9,0;;;;;;;;;;;;;;;;;;;;;;;;;;;;;;;;;;;;;;;;;;;;;;;;;;;;;;;;;;;;;;;;;;;;;;;;;;;;;;;;;;;;;;;;;;;;;;;;;;;;;;;;;;;;;;;;;;;;;;;;;;1,0;;;;;;;;;;;;;;;;;;;;;;;;;;;;;;;;;;;;;;;;;;;;;;;;;;;;;;;1,0;;;;;;;;;;;;;;;;;;;;;;;;;;;;;;;;;;;;;;;;;;;;;;;;;;;;;;;;;;;;;;;;;;;;;;;;;;;;;;;;;;;;;;;;;;;;;;;;;;;;;;;;;;;;;;;;;;;3,0;;;;;;;
monitor;;1,0;1,0;3,0;2,0;17,0;8,0;60,0;128,0;22,0;;;9,0;;8,0;59,0;33,0;;7,0;9,0;5,0;120,0;1,0;2,0;;;50,0;;;;12,0;13,0;88,0;4,0;92,0;17,0;1,0;5,0;1,0;8,0;99,0;;5,0;1,0;42,0;11,0;28,0;304,0;24,0;367,0;6,0;9,0;;;1,0;;9,0;1,0;9,0;4,0;1,0;12,0;19,0;3,0;;5,0;6,0;18,0;24,0;17,0;4,0;4,0;55,0;2,0;3,0;;3,0;4,0;1,0;483,0;1,0;19,0;3,0;154,0;;10,0;;;2,0;3,0;22,0;2,0;;1,0;3,0;6,0;6,0;8,0;162,0;11,0;9,0;;137,0;132,0;6,0;16,0;12,0;7,0;36,0;32,0;5,0;42,0;;23,0;1,0;56,0;64,0;83,0;11,0;15,0;2,0;;27,0;27,0;17,0;3,0;1,0;;1,0;12,0;;18,0;14,0;2,0;11,0;2,0;11,0;17,0;1,0;;70,0;1,0;4,0;60,0;13,0;;;9,0;104,0;7,0;5,0;;9,0;4,0;19,0;2,0;182,0;;18,0;2,0;4,0;27,0;82,0;1,0;1,0;1,0;116,0;78,0;1,0;2,0;13,0;;;6,0;3,0;4,0;21,0;1,0;;;3,0;23,0;;4,0;;11,0;;13,0;;;;;;21,0;;;8,0;;;5,0;4,0;;4,0;5,0;2,0;2,0;;1,0;11,0;20,0;;1,0;;;16,0;;;;1,0;2,0;17,0;;;;2,0;10,0;;;31,0;;11,0;;45,0;27,0;3,0;2,0;8,0;2,0;1,0;;13,0;10,0;2,0;6,0;2,0;;;1,0;25,0;3,0;5,0;;;1,0;2,0;12,0;31,0;6,0;;;;;6,0;7,0;;;12,0;1,0;;;1,0;7,0;11,0;;;1,0;;4,0;3,0;14,0;11,0;;37,0;;;48,0;6,0;14,0;;4,0;146,0;1,0;;;1,0;5,0;;;1,0;;;12,0;12,0;;;;;;;;;3,0;;;4,0;4,0;2,0;6,0;;10,0;1,0;7,0;;;5,0;;2,0;;1,0;5,0;1,0;9,0;;;;3,0;2,0;2,0;5,0;;1,0;1,0;3,0;4,0;1,0;2,0;;1,0;1,0;8,0;;;;1,0;;;;2,0;1,0;2,0;;5,0;;;2,0;;;19,0;;4,0;6,0;;;17,0;7,0;3,0;;;11,0;3,0;;5,0;;1,0;;;;1,0;1,0;11,0;2,0;17,0;24,0;;;;2,0;1,0;;;2,0;;2,0;4,0;;1,0;;7,0;1,0;11,0;33,0;;9,0;;8,0;;;;;1,0;;4,0;5,0;5,0;7,0;1,0;2,0;;;;;14,0;7,0;;20,0;;3,0;15,0;32,0;;;42,0;6,0;1,0;11,0;10,0;24,0;12,0;5,0;8,0;11,0;;1,0;2,0;19,0;35,0;4,0;3,0;;;11,0;2,0;;3,0;;;22,0;;2,0;4,0;;;3,0;2,0;22,0;12,0;15,0;5,0;29,0;11,0;11,0;11,0;2,0;2,0;2,0;;3,0;;2,0;5,0;;7,0;23,0;2,0;1,0;8,0;;9,0;4,0;10,0;9,0;;1,0;4,0;1,0;;;;3,0;;2,0;96,0;;1,0;8,0;4,0;;;5,0;;3,0;;1,0;;;2,0;27,0;;;;3,0;6,0;2,0;12,0;;2,0;21,0;5,0;4,0;3,0;1,0;;;;;10,0;2,0;10,0;;6,0;;;4,0;1,0;;6,0;2,0;1,0;2,0;4,0;2,0;1,0;1,0;7,0;;;;14,0;;;13,0;1,0;9,0;;1,0;10,0;1,0;2,0;1,0;1,0;;5,0;2,0;;3,0;3,0;;1,0;;;9,0;;;7,0;3,0;13,0;;;2,0;1,0;6,0;;6,0;22,0;;11,0;;;;;1,0;16,0;4,0;1,0;1,0;;;4,0;;1,0;;3,0;;;;2,0;40,0;;3,0;;;;;10,0;7,0;;1,0;2,0;;16,0;3,0;2,0;13,0;;;2,0;1,0;;5,0;;1,0;21,0;;1,0;;3,0;;;5,0;;;;;;;;13,0;2,0;2,0;;24,0;1,0;3,0;4,0;4,0;;;;1,0;;;3,0;5,0;3,0;5,0;1,0;25,0;;5,0;13,0;;1,0;1,0;8,0;11,0;;;;1,0;1,0;26,0;20,0;1,0;;2,0;5,0;1,0;1,0;;;;;;3,0;;3,0;;;;;;;;2,0;;1,0;;;2,0;2,0;;;2,0;;2,0;;;3,0;;;2,0;;19,0;1,0;;;;;;2,0;;15,0;2,0;1,0;;;2,0;;3,0;;;;;3,0;9,0;3,0;;;;;;;;;;1,0;1,0;;;;;;;;;1,0;9,0;;;6,0;;;;11,0;;;;;;3,0;;1,0;;1,0;;;3,0;;2,0;9,0;;;;3,0;;;;1,0;;;;;;4,0;2,0;;;;;;;;;4,0;1,0;;;;;;;4,0;2,0;;3,0;18,0;;;;;1,0;;;;4,0;4,0;1,0;;8,0;;1,0;;;1,0;1,0;1,0;;;;;;4,0;2,0;1,0;8,0;;;;;3,0;;;2,0;1,0;1,0;1,0;;4,0;;;8,0;4,0;;1,0;;;;;17,0;2,0;;;;;1,0;;;;2,0;;;;;;7,0;;2,0;;6,0;;12,0;;2,0;1,0;;1,0;;2,0;3,0;;;;;;1,0;;;;;2,0;;1,0;;;9,0;;1,0;;;;;1,0;1,0;1,0;2,0;;;;;;;;;;5,0;;;3,0;;;;1,0;;;;;;5,0;3,0;;2,0;9,0;;3,0;2,0;;1,0;;10,0;9,0;;;;5,0;2,0;;7,0;;;
mount;;583,0;2,0;1,0;;83,0;105,0;275,0;39,0;80,0;38,0;;18,0;14,0;150,0;382,0;93,0;1,0;2,0;2,0;42,0;92,0;1,0;25,0;6,0;;6,0;15,0;2,0;;5,0;5,0;374,0;;97,0;48,0;61,0;20,0;;2,0;10,0;;67,0;2,0;66,0;21,0;21,0;597,0;94,0;86,0;240,0;35,0;;;50,0;44,0;313,0;4,0;6,0;;135,0;50,0;19,0;3,0;53,0;20,0;24,0;163,0;242,0;145,0;11,0;;14,0;1,0;;21,0;;;11,0;478,0;33,0;182,0;2,0;595,0;3,0;4,0;269,0;;30,0;38,0;1466,0;;1,0;36,0;7,0;10,0;17,0;;146,0;27,0;6,0;1,0;221,0;39,0;23,0;6,0;204,0;19,0;18,0;13,0;38,0;21,0;17,0;11,0;9,0;226,0;642,0;447,0;32,0;55,0;16,0;4,0;4,0;16,0;15,0;8,0;;;5,0;21,0;4,0;16,0;77,0;18,0;1,0;1,0;26,0;6,0;2,0;;;40,0;5,0;386,0;1,0;4,0;10,0;333,0;18,0;11,0;4,0;6,0;6,0;19,0;34,0;11,0;616,0;1,0;57,0;8,0;6,0;13,0;519,0;2,0;3,0;3,0;102,0;88,0;7,0;1,0;11,0;3,0;18,0;32,0;9,0;4,0;658,0;127,0;2,0;;339,0;1170,0;9,0;40,0;;288,0;3,0;273,0;2,0;7,0;4,0;2,0;6,0;227,0;;63,0;;1,0;5,0;134,0;44,0;24,0;;104,0;11,0;23,0;15,0;3,0;8,0;127,0;;15,0;7,0;2,0;9,0;;61,0;15,0;14,0;242,0;595,0;9,0;79,0;46,0;6,0;114,0;24,0;19,0;134,0;8,0;452,0;43,0;225,0;;97,0;15,0;27,0;106,0;51,0;65,0;10,0;122,0;14,0;59,0;56,0;;2,0;2,0;7,0;79,0;554,0;;19,0;1,0;3,0;;185,0;12,0;26,0;;4,0;1,0;211,0;41,0;10,0;8,0;50,0;26,0;47,0;;53,0;52,0;42,0;8,0;;31,0;15,0;288,0;173,0;746,0;9,0;;124,0;3,0;;21,0;2,0;23,0;5,0;31,0;403,0;56,0;12,0;1,0;64,0;1,0;5,0;74,0;37,0;6,0;50,0;72,0;307,0;6,0;24,0;11,0;16,0;95,0;100,0;;;77,0;27,0;24,0;18,0;3,0;6,0;184,0;2,0;192,0;9,0;33,0;22,0;46,0;36,0;5,0;110,0;13,0;;1,0;20,0;69,0;80,0;;;8,0;28,0;35,0;31,0;112,0;31,0;11,0;220,0;43,0;8,0;18,0;49,0;40,0;54,0;5,0;13,0;17,0;3,0;38,0;36,0;63,0;56,0;165,0;58,0;4,0;2,0;8,0;15,0;17,0;33,0;8,0;;63,0;40,0;1,0;8,0;15,0;60,0;3,0;33,0;35,0;93,0;49,0;73,0;61,0;61,0;36,0;2,0;94,0;9,0;2,0;50,0;28,0;;452,0;30,0;11,0;11,0;84,0;79,0;6,0;26,0;5,0;24,0;3,0;1,0;4,0;6,0;94,0;4,0;6,0;;5,0;10,0;6,0;7,0;1,0;1,0;1,0;4,0;1,0;20,0;3,0;;;;5,0;56,0;2,0;;;;39,0;;;2,0;19,0;6,0;39,0;21,0;;2,0;5,0;3,0;;27,0;43,0;31,0;2,0;8,0;45,0;19,0;5,0;57,0;8,0;20,0;7,0;14,0;;4,0;25,0;7,0;;1,0;2,0;6,0;1,0;7,0;;6,0;23,0;2,0;5,0;1,0;21,0;;8,0;7,0;;21,0;5,0;1,0;2,0;4,0;3,0;55,0;47,0;;183,0;2,0;;3,0;;12,0;2,0;2,0;1,0;;2,0;;16,0;13,0;1,0;64,0;;158,0;14,0;4,0;11,0;6,0;;15,0;;4,0;2,0;;30,0;7,0;8,0;;;6,0;2,0;18,0;7,0;1,0;7,0;237,0;74,0;1,0;;8,0;12,0;;;1,0;;17,0;54,0;;80,0;4,0;10,0;;12,0;9,0;85,0;3,0;;;;1,0;;7,0;;;42,0;25,0;3,0;;82,0;4,0;15,0;275,0;103,0;6,0;15,0;3,0;4,0;22,0;6,0;12,0;28,0;1,0;8,0;3,0;;15,0;14,0;12,0;39,0;26,0;88,0;3,0;;;27,0;;6,0;75,0;;;;25,0;2,0;14,0;;2,0;70,0;24,0;4,0;;2,0;21,0;2,0;50,0;;2,0;;;3,0;;36,0;;;8,0;14,0;24,0;18,0;1,0;;10,0;14,0;1,0;1,0;;;34,0;3,0;1,0;17,0;34,0;;28,0;2,0;;7,0;;14,0;;3,0;;44,0;;2,0;;17,0;10,0;;;;3,0;23,0;;;;5,0;;34,0;67,0;74,0;5,0;17,0;21,0;8,0;57,0;2,0;1,0;17,0;;17,0;2,0;27,0;119,0;24,0;7,0;46,0;;;23,0;1,0;4,0;7,0;60,0;21,0;25,0;11,0;79,0;71,0;11,0;31,0;;38,0;6,0;6,0;6,0;;6,0;3,0;;12,0;30,0;;102,0;54,0;56,0;6,0;20,0;;61,0;12,0;5,0;12,0;19,0;23,0;6,0;2,0;;120,0;;26,0;2,0;15,0;42,0;3,0;6,0;21,0;22,0;13,0;15,0;28,0;35,0;5,0;4,0;13,0;;;1,0;6,0;18,0;4,0;7,0;11,0;6,0;10,0;;9,0;8,0;36,0;18,0;1,0;9,0;7,0;12,0;;;;1,0;11,0;10,0;20,0;2,0;30,0;17,0;;;;;6,0;;6,0;;1,0;1,0;;;7,0;1,0;;;;;;;;;3,0;;;;;;;;2,0;;;2,0;9,0;;;;;24,0;2,0;;10,0;6,0;3,0;;13,0;16,0;18,0;;6,0;3,0;;;2,0;4,0;;;6,0;;;8,0;;1,0;;;;25,0;;;;;;;3,0;1,0;3,0;15,0;8,0;;;14,0;;9,0;;1,0;5,0;7,0;;;5,0;;;;;5,0;;2,0;;;;3,0;;3,0;;;1,0;4,0;;;;;;12,0;3,0;2,0;13,0;;1,0;;5,0;30,0;2,0;;;5,0;;4,0;16,0;2,0;2,0;4,0;;5,0;4,0;10,0;;;;3,0;2,0;4,0;;6,0;;;26,0;4,0;15,0;4,0;16,0;22,0;1,0;32,0;7,0;7,0;;11,0;7,0;14,0;8,0;13,0;1,0;26,0;30,0;13,0;;33,0;;23,0;1,0;6,0;;1,0;;7,0;3,0;;13,0;;;1,0;7,0;1,0;;7,0;;;;;16,0;1,0;1,0;;12,0;;5,0;2,0;11,0;;2,0;;;2,0;;;;;;;;3,0;;;9,0;;;;7,0;13,0;6,0;3,0;4,0;;;7,0;5,0;3,0;;;;;;3,0;;;1,0;;;;
movable;;4,0;1,0;;;21,0;4,0;26,0;2,0;53,0;3,0;;9,0;;187,0;77,0;2,0;3,0;;1,0;5,0;27,0;1,0;8,0;;;;;3,0;4,0;1,0;;116,0;;38,0;21,0;1,0;27,0;;;4,0;;33,0;;34,0;5,0;8,0;106,0;31,0;27,0;38,0;25,0;;4,0;113,0;1,0;55,0;;;;32,0;2,0;22,0;;14,0;;9,0;15,0;95,0;8,0;5,0;;7,0;;;31,0;;;2,0;147,0;;23,0;;145,0;;2,0;17,0;;6,0;7,0;448,0;1,0;;1,0;;;;;19,0;3,0;;;154,0;70,0;;4,0;205,0;3,0;2,0;4,0;15,0;5,0;;;;15,0;258,0;292,0;2,0;27,0;19,0;10,0;;3,0;3,0;;1,0;;1,0;48,0;;4,0;111,0;;1,0;;6,0;5,0;;;4,0;;;57,0;;;12,0;36,0;10,0;2,0;;;1,0;1,0;15,0;4,0;79,0;2,0;17,0;;1,0;8,0;362,0;;4,0;;;22,0;;;3,0;20,0;;9,0;9,0;23,0;73,0;365,0;11,0;;4,0;84,0;;44,0;;8,0;;5,0;;;;1,0;6,0;65,0;;43,0;;;;92,0;1,0;1,0;1,0;173,0;5,0;38,0;5,0;;1,0;51,0;2,0;2,0;46,0;1,0;;;3,0;;;53,0;54,0;6,0;29,0;;;2,0;;2,0;28,0;;551,0;;256,0;97,0;;135,0;40,0;29,0;38,0;57,0;3,0;;;31,0;2,0;;;;;48,0;60,0;;15,0;17,0;11,0;;217,0;5,0;;1,0;6,0;1,0;15,0;3,0;;5,0;12,0;;18,0;2,0;18,0;2,0;23,0;;;50,0;3,0;9,0;13,0;115,0;2,0;;18,0;;;11,0;;1,0;3,0;1,0;5,0;9,0;1,0;;15,0;;11,0;;12,0;2,0;75,0;14,0;77,0;5,0;1,0;8,0;15,0;16,0;17,0;5,0;;3,0;;;29,0;;1,0;21,0;1,0;45,0;12,0;4,0;;16,0;87,0;;23,0;4,0;;29,0;1,0;5,0;15,0;2,0;;;;65,0;42,0;28,0;4,0;9,0;5,0;4,0;16,0;24,0;23,0;28,0;4,0;;2,0;35,0;;7,0;21,0;21,0;16,0;5,0;7,0;;;9,0;2,0;5,0;18,0;14,0;;4,0;3,0;40,0;5,0;7,0;;;3,0;;11,0;15,0;41,0;57,0;21,0;1,0;1,0;42,0;1,0;;30,0;10,0;;179,0;5,0;5,0;;7,0;17,0;;1,0;;2,0;;;;;4,0;;;;;;7,0;18,0;2,0;;;1,0;;;;;;;7,0;3,0;;2,0;;;4,0;;;;;2,0;10,0;12,0;;;;15,0;;3,0;8,0;72,0;;1,0;1,0;7,0;2,0;4,0;;4,0;;;2,0;;4,0;6,0;;1,0;;2,0;;;4,0;22,0;7,0;1,0;4,0;;5,0;;1,0;;;4,0;;1,0;;5,0;8,0;15,0;8,0;;13,0;9,0;;;;2,0;3,0;;;;;;4,0;2,0;;1,0;;82,0;;;14,0;2,0;1,0;5,0;;;;1,0;7,0;4,0;;;;1,0;;25,0;;;;1,0;12,0;;;;6,0;;;;;4,0;2,0;;3,0;9,0;3,0;;1,0;8,0;113,0;;;;;2,0;;41,0;;;3,0;;;;13,0;;;3,0;;;1,0;;;;;2,0;5,0;1,0;1,0;2,0;;3,0;7,0;;3,0;1,0;2,0;1,0;;;;;1,0;2,0;;;;38,0;;;;;6,0;9,0;;;1,0;;3,0;34,0;;;;;7,0;;;;;9,0;;1,0;3,0;1,0;;;;;;;;;;;;12,0;;4,0;;1,0;15,0;;28,0;;;;12,0;;4,0;;;1,0;;;1,0;1,0;10,0;;13,0;;3,0;;7,0;2,0;9,0;;;4,0;5,0;21,0;;;1,0;;;;2,0;;7,0;1,0;3,0;;3,0;;;;3,0;1,0;6,0;5,0;;5,0;5,0;;1,0;1,0;2,0;;1,0;2,0;;;;;;;;2,0;1,0;;3,0;1,0;;6,0;18,0;;1,0;7,0;;4,0;;;14,0;;;;;98,0;;2,0;13,0;4,0;;;54,0;;1,0;2,0;1,0;;;3,0;;1,0;;;7,0;;12,0;;;2,0;14,0;;1,0;;25,0;;;;2,0;;1,0;;32,0;;;;;;;;;;;;2,0;;;;1,0;;;;;;11,0;1,0;1,0;;;;;1,0;;;;;;;3,0;;;;;;;;7,0;;10,0;;;;1,0;;26,0;;2,0;;;;;;;;3,0;;;;;;;;;;;;;;;;;11,0;;;4,0;;;;;;;2,0;;10,0;;1,0;6,0;;;;;;;;;;;;;;;;;;;;5,0;;;1,0;;;1,0;;1,0;;4,0;5,0;6,0;;;;;;;;;2,0;;;;;;;;;;;;4,0;;;;2,0;19,0;;10,0;;;3,0;2,0;;;1,0;2,0;2,0;2,0;2,0;5,0;29,0;22,0;10,0;;7,0;;;;;;;;1,0;;;2,0;;1,0;;;4,0;;2,0;2,0;;;;3,0;;5,0;;1,0;1,0;7,0;;;;;;;1,0;;1,0;;;;;;;;;;;;;;1,0;2,0;;;;12,0;;;4,0;;;;;;;;;;;;;
move;;2,0;9,0;;;21,0;94,0;33,0;43,0;65,0;4,0;;7,0;9,0;573,0;92,0;7,0;6,0;;5,0;11,0;29,0;2,0;3,0;;;1,0;2,0;1,0;20,0;5,0;65,0;236,0;5,0;132,0;51,0;6,0;21,0;1,0;;3,0;5,0;9,0;11,0;41,0;20,0;38,0;147,0;7,0;60,0;23,0;45,0;;2,0;170,0;10,0;79,0;1,0;1,0;;14,0;1,0;34,0;1,0;23,0;4,0;188,0;9,0;48,0;20,0;6,0;2,0;14,0;1,0;;144,0;9,0;3,0;;325,0;5,0;52,0;2,0;44,0;5,0;17,0;1,0;3,0;3,0;14,0;1315,0;;;1,0;13,0;4,0;4,0;;53,0;7,0;8,0;1,0;82,0;123,0;;20,0;756,0;21,0;10,0;1,0;;35,0;3,0;5,0;;55,0;161,0;483,0;68,0;73,0;2,0;5,0;25,0;20,0;8,0;2,0;;;2,0;17,0;;36,0;124,0;1,0;6,0;;12,0;25,0;;9,0;3,0;;2,0;76,0;5,0;1,0;5,0;83,0;66,0;4,0;22,0;;3,0;8,0;31,0;7,0;148,0;9,0;26,0;4,0;2,0;1,0;938,0;1,0;7,0;;13,0;31,0;3,0;;203,0;10,0;1,0;3,0;61,0;12,0;81,0;151,0;13,0;;8,0;46,0;;3,0;25,0;8,0;;25,0;;;2,0;;;10,0;8,0;44,0;12,0;;;42,0;;1,0;4,0;620,0;60,0;30,0;1,0;3,0;37,0;23,0;7,0;;29,0;;4,0;;29,0;1,0;1,0;11,0;72,0;1,0;1,0;6,0;1,0;5,0;;10,0;54,0;;251,0;;55,0;15,0;135,0;;144,0;42,0;23,0;15,0;10,0;5,0;1,0;18,0;12,0;;;2,0;11,0;59,0;59,0;;;19,0;7,0;;15,0;3,0;;1,0;4,0;;5,0;7,0;;4,0;6,0;;28,0;;47,0;24,0;26,0;3,0;;8,0;15,0;14,0;16,0;79,0;6,0;;11,0;6,0;1,0;40,0;;8,0;;;41,0;12,0;17,0;;15,0;;4,0;;4,0;2,0;162,0;41,0;10,0;1,0;4,0;3,0;32,0;17,0;5,0;1,0;7,0;22,0;;;57,0;1,0;6,0;10,0;5,0;34,0;8,0;;3,0;;156,0;;29,0;3,0;;3,0;3,0;;3,0;;1,0;2,0;4,0;72,0;2,0;33,0;;5,0;3,0;5,0;22,0;11,0;21,0;74,0;24,0;11,0;3,0;121,0;;24,0;24,0;18,0;12,0;35,0;8,0;;;27,0;14,0;4,0;19,0;;8,0;17,0;1,0;9,0;1,0;1,0;;1,0;3,0;3,0;13,0;10,0;56,0;39,0;25,0;;6,0;17,0;1,0;32,0;3,0;;3,0;80,0;3,0;54,0;2,0;;4,0;;1,0;5,0;2,0;2,0;;;;11,0;4,0;2,0;;9,0;2,0;24,0;21,0;6,0;2,0;3,0;1,0;;2,0;1,0;4,0;;;14,0;19,0;4,0;3,0;2,0;;3,0;;;;20,0;10,0;35,0;38,0;;;1,0;30,0;;2,0;24,0;103,0;;;26,0;48,0;10,0;13,0;;14,0;2,0;;16,0;2,0;3,0;7,0;;2,0;;;;;18,0;2,0;;;2,0;9,0;43,0;6,0;2,0;1,0;1,0;31,0;;11,0;9,0;5,0;1,0;20,0;4,0;;14,0;3,0;;2,0;;;;10,0;1,0;;;;19,0;1,0;3,0;;;54,0;;;38,0;4,0;2,0;15,0;;1,0;;5,0;9,0;1,0;;3,0;;1,0;;2,0;;1,0;3,0;2,0;20,0;;;;;4,0;;;1,0;9,0;4,0;;;31,0;64,0;;79,0;4,0;43,0;3,0;11,0;3,0;;;3,0;16,0;;;16,0;;1,0;;6,0;1,0;;7,0;2,0;;6,0;4,0;1,0;12,0;4,0;;1,0;;13,0;;;2,0;;2,0;11,0;;1,0;;;;3,0;3,0;1,0;5,0;1,0;;;11,0;;;14,0;;3,0;6,0;;;1,0;12,0;5,0;10,0;;3,0;1,0;;3,0;4,0;;;;1,0;1,0;4,0;;;;7,0;1,0;;;;2,0;;;;;10,0;11,0;;8,0;;2,0;;5,0;;;;4,0;;2,0;10,0;;2,0;1,0;;2,0;8,0;4,0;30,0;7,0;6,0;;;3,0;2,0;2,0;3,0;;1,0;3,0;4,0;;;1,0;;;;5,0;;117,0;23,0;;;;1,0;;;1,0;3,0;4,0;4,0;3,0;18,0;2,0;;22,0;5,0;2,0;2,0;;1,0;7,0;3,0;;;;;;1,0;8,0;;7,0;2,0;;;6,0;3,0;13,0;42,0;;2,0;1,0;;7,0;;;;1,0;46,0;5,0;;8,0;;5,0;;46,0;;;1,0;8,0;;;;;5,0;2,0;;6,0;10,0;4,0;2,0;;;20,0;;;6,0;9,0;4,0;;2,0;1,0;;1,0;;21,0;2,0;2,0;1,0;;;;;;;;;3,0;;;;;9,0;3,0;;5,0;;4,0;;21,0;;;;;4,0;;24,0;;;7,0;1,0;8,0;;8,0;5,0;;;;13,0;3,0;2,0;7,0;;;;3,0;;1,0;;4,0;15,0;;;;;2,0;;3,0;;;1,0;;6,0;;;;1,0;;;;;;;9,0;;;;6,0;;;;;;;4,0;;50,0;2,0;1,0;;;;;2,0;1,0;8,0;;4,0;13,0;;2,0;;;;;;;;1,0;16,0;;;5,0;19,0;1,0;20,0;3,0;15,0;;7,0;15,0;;4,0;;6,0;;;1,0;3,0;;1,0;;;;1,0;;;;4,0;;;;7,0;3,0;2,0;3,0;2,0;3,0;;1,0;;3,0;3,0;;;1,0;1,0;6,0;;;20,0;;7,0;20,0;15,0;;1,0;;1,0;;;;;11,0;4,0;2,0;;1,0;;5,0;;1,0;16,0;1,0;5,0;1,0;;;2,0;1,0;3,0;;1,0;;;6,0;1,0;;;;;;;;2,0;1,0;;;19,0;;;;;;3,0;3,0;;2,0;1,0;;;13,0;;1,0;;2,0;;;;;;;;;;;1,0;;;
movement;;2,0;4,0;2,0;1,0;27,0;11,0;77,0;56,0;22,0;7,0;;44,0;11,0;136,0;194,0;15,0;6,0;1,0;1,0;9,0;106,0;6,0;;4,0;1,0;3,0;9,0;;20,0;8,0;34,0;106,0;;165,0;39,0;11,0;25,0;5,0;1,0;81,0;;13,0;6,0;172,0;79,0;124,0;132,0;27,0;30,0;14,0;49,0;12,0;3,0;99,0;1,0;75,0;;25,0;;5,0;8,0;28,0;2,0;19,0;6,0;109,0;12,0;96,0;27,0;6,0;4,0;36,0;;;27,0;14,0;;4,0;408,0;1,0;25,0;;78,0;6,0;7,0;2,0;13,0;16,0;18,0;421,0;;;;8,0;7,0;4,0;1,0;142,0;11,0;6,0;;74,0;179,0;1,0;8,0;119,0;10,0;28,0;33,0;12,0;73,0;;3,0;;85,0;122,0;237,0;5,0;54,0;37,0;3,0;8,0;7,0;10,0;;2,0;1,0;1,0;149,0;2,0;20,0;361,0;2,0;15,0;1,0;11,0;41,0;;18,0;26,0;;5,0;85,0;35,0;1,0;;30,0;55,0;8,0;19,0;;1,0;14,0;61,0;1,0;154,0;36,0;57,0;7,0;6,0;18,0;323,0;;22,0;;92,0;21,0;;1,0;31,0;4,0;2,0;6,0;244,0;8,0;56,0;26,0;12,0;;2,0;47,0;;;2,0;7,0;;18,0;1,0;2,0;1,0;;;18,0;1,0;27,0;;;;17,0;;7,0;7,0;379,0;8,0;23,0;3,0;3,0;5,0;15,0;13,0;;5,0;1,0;;;3,0;;2,0;18,0;53,0;;7,0;1,0;2,0;2,0;;12,0;23,0;1,0;281,0;6,0;10,0;27,0;40,0;144,0;;8,0;7,0;1,0;2,0;2,0;;33,0;15,0;;;35,0;16,0;16,0;12,0;;1,0;;6,0;;47,0;9,0;;;;1,0;1,0;26,0;;4,0;9,0;;41,0;;33,0;10,0;11,0;;;3,0;68,0;33,0;;47,0;6,0;;4,0;;2,0;98,0;2,0;;2,0;;99,0;11,0;25,0;;3,0;2,0;10,0;;4,0;;34,0;32,0;9,0;17,0;9,0;7,0;9,0;4,0;;7,0;1,0;7,0;1,0;2,0;11,0;2,0;6,0;3,0;;17,0;;;;4,0;52,0;;13,0;;;;5,0;1,0;;;;4,0;;104,0;3,0;61,0;;1,0;;;105,0;;25,0;25,0;15,0;19,0;;65,0;1,0;7,0;5,0;22,0;21,0;29,0;9,0;2,0;2,0;5,0;6,0;3,0;2,0;;;7,0;;;3,0;3,0;;4,0;62,0;;9,0;;10,0;29,0;8,0;;37,0;12,0;3,0;4,0;;;3,0;75,0;;21,0;;2,0;1,0;9,0;29,0;38,0;9,0;1,0;7,0;1,0;1,0;7,0;8,0;4,0;;4,0;19,0;55,0;44,0;;15,0;;12,0;10,0;2,0;11,0;2,0;3,0;;19,0;30,0;12,0;;4,0;;12,0;;9,0;12,0;13,0;7,0;29,0;30,0;;1,0;17,0;33,0;;8,0;76,0;56,0;2,0;;7,0;22,0;8,0;14,0;8,0;4,0;10,0;3,0;7,0;7,0;20,0;12,0;2,0;1,0;;28,0;2,0;1,0;37,0;11,0;2,0;;11,0;22,0;48,0;37,0;;2,0;24,0;74,0;;18,0;5,0;3,0;;23,0;;1,0;21,0;21,0;9,0;3,0;2,0;9,0;2,0;3,0;1,0;9,0;8,0;1,0;4,0;2,0;4,0;13,0;1,0;48,0;;5,0;19,0;2,0;6,0;9,0;;2,0;;2,0;2,0;;;;;;;1,0;;2,0;11,0;2,0;13,0;2,0;;6,0;;3,0;1,0;;2,0;;5,0;;;33,0;1,0;5,0;4,0;1,0;8,0;5,0;1,0;2,0;3,0;6,0;;3,0;8,0;;1,0;1,0;2,0;;4,0;8,0;;7,0;9,0;5,0;12,0;7,0;37,0;4,0;21,0;1,0;5,0;;35,0;7,0;2,0;8,0;;1,0;5,0;;;;1,0;2,0;;4,0;1,0;1,0;;3,0;1,0;10,0;;;1,0;;2,0;;;;2,0;8,0;1,0;22,0;;;;;2,0;9,0;2,0;;3,0;31,0;10,0;10,0;;;;1,0;1,0;;2,0;;2,0;2,0;2,0;2,0;;3,0;;;3,0;;;;2,0;;;1,0;2,0;1,0;1,0;15,0;;;4,0;;;3,0;3,0;48,0;;3,0;;;7,0;1,0;1,0;5,0;2,0;1,0;;2,0;;;1,0;10,0;;;40,0;;6,0;3,0;5,0;;3,0;;;;;;;1,0;7,0;28,0;4,0;;6,0;;;3,0;1,0;;10,0;3,0;;2,0;;;;1,0;4,0;;;1,0;;;60,0;;;15,0;1,0;2,0;;;7,0;;;;8,0;17,0;3,0;2,0;12,0;1,0;2,0;;7,0;;;3,0;1,0;;;3,0;;5,0;2,0;3,0;;10,0;1,0;5,0;;;;;;1,0;19,0;;;1,0;4,0;;;;32,0;;3,0;2,0;5,0;2,0;;;;5,0;1,0;;;;;;;13,0;3,0;;5,0;;;1,0;13,0;;3,0;3,0;;7,0;7,0;6,0;;;28,0;12,0;2,0;;3,0;3,0;;;;12,0;5,0;9,0;3,0;1,0;;;;;4,0;11,0;13,0;19,0;7,0;4,0;;;4,0;;9,0;;1,0;2,0;1,0;;;;;;;;;;;;1,0;;;;;12,0;1,0;;;;5,0;6,0;1,0;19,0;2,0;;3,0;5,0;;;;3,0;6,0;;9,0;3,0;;4,0;7,0;;7,0;;4,0;;;1,0;1,0;;1,0;3,0;8,0;3,0;17,0;3,0;4,0;4,0;20,0;15,0;;3,0;;3,0;2,0;;5,0;;;7,0;;;;;;;2,0;;1,0;;;6,0;;6,0;3,0;2,0;;;;;;2,0;;;2,0;2,0;5,0;4,0;7,0;19,0;19,0;6,0;3,0;;19,0;5,0;2,0;;1,0;;2,0;;4,0;;12,0;;3,0;;;;;4,0;;8,0;;;;;1,0;26,0;;;;;1,0;;;;;1,0;;3,0;2,0;2,0;3,0;7,0;;;3,0;;;;;;;3,0;5,0;;3,0;1,0;;;1,0;4,0;;;6,0;1,0;5,0;3,0;;;;;;;;;
notification;;9,0;;;1,0;;;6,0;;;;;3,0;;;4,0;;;;;;4,0;1,0;;;;;;;;;;14,0;;4,0;3,0;;;;;13,0;;;;4,0;;3,0;29,0;;15,0;;1,0;;;;;;6,0;;;;4,0;;2,0;;;1,0;3,0;;;5,0;;16,0;;;;;;;20,0;;5,0;;13,0;;;;;;;1,0;;;;;;;;17,0;;;;1,0;10,0;;1,0;;;16,0;1,0;;2,0;;;;2,0;;1,0;;2,0;;;1,0;;1,0;1,0;;;;;;;;;;;;13,0;;;16,0;1,0;9,0;2,0;1,0;;;;5,0;2,0;;;1,0;;1,0;;10,0;;;;;17,0;19,0;;;;2,0;;;;2,0;;;;;;;;;;;2,0;;;;;;;;;;;;2,0;;;;;;;;;;;1,0;;;;2,0;;;;;;;;;;;;1,0;;;;;;;;1,0;;2,0;;;;;;2,0;;;;;;;;;;;;;;;;;;;;31,0;;;;;;;;;;;;;;;1,0;;;;;6,0;;;9,0;;;;;;6,0;;;;;5,0;;;;;;;;;;;4,0;;;;;;;;;;;;;;;;;;;;;;;;;;;;;;;;;;;;1,0;;;;;;;;8,0;;;;;;;;;;;;;11,0;;;;;;;;;;;;;;;2,0;;;;;;;;;;;;;;;;;;;;;;;;;;;;;;;;;;;;;4,0;;;;;;;;;;;;;1,0;;;1,0;;;5,0;;1,0;;;2,0;;4,0;1,0;;;11,0;;;;4,0;;19,0;4,0;;2,0;;;;;;;5,0;;;;;;2,0;;;;29,0;;3,0;;;;1,0;;12,0;;;;;;;;;;;;;;;;5,0;;2,0;1,0;;5,0;;1,0;1,0;;;;;;;;;;;;;;;;1,0;;;;;;;;;;;;;;;;;;;;;;19,0;;;;;;;;;2,0;2,0;7,0;;1,0;;;;;;;;;;;;;;;;3,0;;4,0;;;;;;;;2,0;;;;;;;;;2,0;;;;;;;1,0;;;;;;;;;;;10,0;28,0;;;4,0;;;;;;;;;;;;;;;;;2,0;;;;1,0;;;;;;4,0;;;;;;;;;;;;;;;;;;;;;;;;;;;;;;;;;;;;;;;;;;;;;;;;;;;;;;;;;;;1,0;;;;;;;;;;;1,0;;;3,0;;;;;;;;;;;;;;;;;;;;;;;;;;;;;;;;;;1,0;;;;;;;;;;;;;;;;;;1,0;;;;;;;;;;;19,0;;;;;;;;;;;;;;;;;;;;;;;;;;;;;;;;;;;;;;;;;;;;;;;;;;;;;;;;;;;;;;;1,0;;;;1,0;;;;;;;;2,0;;;1,0;;;;;;;;;;;;1,0;;;;;;;4,0;;;;;;;;;;;;;;;;;;;;;;;;;;;;;;;2,0;1,0;;;;;;;;;;;;;;;;;;;;;;;;;;;;;;;;;;;;6,0;;;;;2,0;;;;;;;;;;;;;;;;;;;;;;;;;;;;2,0;;;;;;;;;;;;;;;;;;;;;;;;;;;;;;;;
open;;11,0;4,0;2,0;;23,0;56,0;20,0;35,0;36,0;6,0;;19,0;;53,0;99,0;22,0;;;;;24,0;2,0;54,0;;;61,0;13,0;7,0;;;17,0;104,0;;83,0;7,0;;;;;17,0;3,0;123,0;3,0;14,0;1,0;17,0;193,0;18,0;11,0;68,0;122,0;;1,0;45,0;228,0;88,0;;;;168,0;24,0;13,0;9,0;32,0;3,0;4,0;262,0;42,0;91,0;4,0;;9,0;2,0;;9,0;1,0;;7,0;125,0;10,0;29,0;;190,0;5,0;6,0;2,0;;13,0;73,0;400,0;;;171,0;;;4,0;;49,0;12,0;;2,0;157,0;16,0;1,0;5,0;67,0;13,0;11,0;6,0;86,0;4,0;32,0;;1,0;89,0;445,0;452,0;10,0;4,0;4,0;;1,0;5,0;7,0;;;;10,0;2,0;1,0;2,0;3,0;10,0;2,0;;8,0;1,0;;;3,0;3,0;;93,0;1,0;2,0;;348,0;12,0;19,0;3,0;;1,0;5,0;8,0;14,0;69,0;;1,0;10,0;;25,0;148,0;;1,0;1,0;11,0;53,0;7,0;1,0;8,0;9,0;11,0;26,0;9,0;5,0;80,0;58,0;30,0;;64,0;109,0;3,0;39,0;4,0;68,0;3,0;38,0;4,0;;6,0;1,0;11,0;50,0;;17,0;9,0;1,0;2,0;150,0;26,0;2,0;4,0;88,0;;17,0;7,0;;56,0;62,0;20,0;2,0;10,0;16,0;9,0;;42,0;1,0;8,0;79,0;258,0;16,0;119,0;27,0;;25,0;118,0;14,0;222,0;;173,0;7,0;56,0;106,0;29,0;42,0;8,0;;79,0;75,0;9,0;19,0;24,0;51,0;1,0;;6,0;2,0;11,0;19,0;136,0;5,0;13,0;2,0;2,0;;141,0;25,0;10,0;;;3,0;24,0;17,0;27,0;;74,0;42,0;264,0;4,0;15,0;11,0;56,0;2,0;;16,0;30,0;68,0;100,0;279,0;36,0;6,0;14,0;2,0;3,0;59,0;;;;22,0;41,0;18,0;;;106,0;37,0;1,0;16,0;40,0;3,0;51,0;39,0;30,0;;6,0;4,0;1,0;26,0;81,0;4,0;;189,0;8,0;16,0;335,0;3,0;9,0;33,0;6,0;51,0;9,0;2,0;38,0;60,0;42,0;1,0;17,0;1,0;6,0;16,0;2,0;4,0;8,0;49,0;3,0;;2,0;25,0;19,0;59,0;9,0;4,0;107,0;;4,0;8,0;18,0;11,0;6,0;1,0;2,0;16,0;;18,0;2,0;16,0;4,0;8,0;13,0;;4,0;18,0;19,0;44,0;45,0;42,0;;58,0;53,0;;;2,0;1,0;;4,0;;87,0;3,0;17,0;12,0;;2,0;;21,0;14,0;1,0;36,0;22,0;6,0;59,0;22,0;;3,0;11,0;53,0;9,0;1,0;95,0;40,0;2,0;;;4,0;35,0;;;;;2,0;7,0;2,0;;2,0;;;5,0;1,0;4,0;2,0;;;1,0;9,0;;;;;7,0;;;;22,0;1,0;3,0;5,0;;;2,0;7,0;;2,0;2,0;47,0;;1,0;37,0;44,0;4,0;2,0;29,0;11,0;;;2,0;;5,0;1,0;;;;10,0;1,0;;8,0;;4,0;11,0;;;;;;3,0;;30,0;;;;;19,0;1,0;113,0;;35,0;;;;;21,0;1,0;10,0;4,0;;2,0;;4,0;1,0;;19,0;;47,0;1,0;3,0;14,0;4,0;;6,0;;;;;13,0;;;;;1,0;;1,0;;14,0;1,0;23,0;;;;;6,0;;;;;21,0;18,0;;21,0;4,0;;;8,0;;4,0;;23,0;;1,0;1,0;1,0;7,0;;;4,0;;;;5,0;;11,0;15,0;3,0;6,0;22,0;12,0;;42,0;;8,0;21,0;;;5,0;;4,0;56,0;5,0;7,0;14,0;18,0;;4,0;;35,0;3,0;;64,0;;;;5,0;;;1,0;;23,0;5,0;;;1,0;5,0;;35,0;;;;;3,0;1,0;59,0;;;4,0;1,0;10,0;7,0;10,0;;2,0;;;;;;13,0;;;;35,0;;8,0;33,0;1,0;;;2,0;;;;7,0;;;1,0;;;3,0;;3,0;;12,0;;1,0;2,0;1,0;;15,0;32,0;12,0;;9,0;23,0;3,0;5,0;3,0;4,0;;10,0;9,0;2,0;9,0;1,0;30,0;7,0;2,0;;;3,0;29,0;;2,0;25,0;3,0;4,0;1,0;9,0;7,0;7,0;3,0;6,0;20,0;2,0;3,0;;;;1,0;;9,0;6,0;1,0;16,0;;;;4,0;;3,0;2,0;;3,0;3,0;14,0;3,0;;1,0;52,0;;4,0;3,0;1,0;92,0;;;13,0;5,0;2,0;10,0;2,0;17,0;5,0;11,0;3,0;14,0;;11,0;3,0;9,0;;3,0;59,0;1,0;9,0;;23,0;;5,0;;7,0;;;6,0;1,0;11,0;;;21,0;7,0;;;;6,0;;;;;;1,0;;;;1,0;;2,0;5,0;;;1,0;16,0;;2,0;;;;1,0;;;4,0;;2,0;;;;;;;7,0;;;;;20,0;;1,0;;;;;2,0;;1,0;;;;;;;3,0;;;7,0;6,0;;;;1,0;;;;1,0;5,0;;1,0;1,0;3,0;4,0;;;;2,0;;;;;;;;;;20,0;;;;5,0;;1,0;;;;;2,0;;;;;;2,0;;;;;;;;2,0;3,0;;;;;;;2,0;4,0;22,0;;;3,0;;;;;;;;;1,0;;;;;;1,0;2,0;;20,0;;;2,0;;;;8,0;;;1,0;1,0;1,0;;3,0;7,0;;;;;;;2,0;1,0;;;;;;3,0;;;;;;6,0;;;2,0;;1,0;1,0;;1,0;;;;5,0;;26,0;3,0;3,0;1,0;1,0;8,0;1,0;;;;;14,0;;2,0;;1,0;;;;;;;;4,0;;;;;;;;;;;;1,0;;;6,0;;;1,0;4,0;;2,0;;;1,0;
opening;;1,0;;;;4,0;4,0;1,0;6,0;3,0;13,0;;2,0;;1,0;;2,0;;;;;;;3,0;;;;2,0;;;;;17,0;;;;;;;;;;11,0;;;;2,0;4,0;;5,0;10,0;3,0;;;;5,0;6,0;;;;1,0;7,0;3,0;;;;;29,0;2,0;5,0;1,0;;1,0;;;1,0;;;;6,0;;;;27,0;;;1,0;;1,0;2,0;18,0;;;9,0;;;;;1,0;;;;16,0;;;;1,0;;;;6,0;;6,0;;1,0;86,0;15,0;45,0;;7,0;;;;;1,0;;;;;;;;8,0;;;;7,0;;;;;;;3,0;;;;18,0;1,0;4,0;;;;;;;1,0;;;;;21,0;6,0;;;;;7,0;;;;;;8,0;;;3,0;1,0;;;1,0;4,0;;;;3,0;;4,0;;;;;;1,0;;;;;;6,0;1,0;;;15,0;;;;;;1,0;2,0;;;;;;1,0;11,0;;5,0;9,0;1,0;2,0;;;;21,0;;32,0;;2,0;1,0;;36,0;;;2,0;59,0;1,0;4,0;6,0;;;4,0;;;11,0;;7,0;;13,0;;2,0;;;;2,0;;;;1,0;;;12,0;1,0;;8,0;3,0;19,0;;;;5,0;;;;;4,0;6,0;11,0;;;1,0;1,0;;;;;;4,0;;;;;2,0;7,0;;;;;8,0;4,0;1,0;2,0;4,0;;;;3,0;;;1,0;;2,0;7,0;;7,0;3,0;;;;;2,0;;;3,0;4,0;1,0;;;;;2,0;3,0;;;;1,0;;;;;4,0;;;;;1,0;;;3,0;1,0;;;;;;;1,0;;;;;4,0;15,0;2,0;;;;;;;;;3,0;;3,0;;2,0;;2,0;;;;;1,0;5,0;;;12,0;11,0;;;;28,0;;1,0;;5,0;1,0;;;6,0;1,0;;;;;;;;;;;;;;;;;;;;;;;;3,0;;;;;;;;;;;;;;;;;;4,0;;;;;;;;;;;;;;;4,0;1,0;;;;;;;;;;;;;;;;;;;;9,0;;6,0;;;;;;;7,0;;;;;6,0;;;;;;;;;;;;;;;;1,0;;;;;;;;;;;3,0;1,0;;;;;;;;;;2,0;;2,0;;;;;;;;;;;;;;;;2,0;;;;3,0;;7,0;5,0;;;2,0;;;11,0;;;;;;;;4,0;7,0;;1,0;;;;;;1,0;;;;;;;;;;;;;;;;;1,0;;2,0;;;;;;;;;;;;5,0;;;;1,0;;;;;;;;;;1,0;;;;;;;1,0;;1,0;;6,0;;;;;;;;;;3,0;;1,0;;;;;1,0;;;;;;;;15,0;;11,0;;;;;1,0;;;;;;2,0;;;;;;;1,0;1,0;;2,0;;;;;;;;;;1,0;;;;;;;;;;;4,0;;;3,0;;;;3,0;;;;;17,0;;;;;1,0;;1,0;8,0;;;;;;;;;;;1,0;;;;;;1,0;1,0;;;;;;;;;1,0;;;;;;;;;;;;;;;;;1,0;11,0;;;1,0;;;;;;;;;;;;;;;;;;;;;;;;51,0;;;;;1,0;;;;;;;;;;;;;;5,0;;;;;;;;;;;;;;;;;;;1,0;;;;;;;;;;;;;1,0;;;;;;;;;;;;;;;;;;;;;;;;;;;;;;;;6,0;;;;;;3,0;;;;;;;;;;;;;;;;;;;;;;;;;;;;;;;;;;;;;;;;;;;3,0;;;;;;;;;;;;;;;;2,0;;;2,0;;8,0;;1,0;;;1,0;;;;;;;;;;;;;;;;;;;;;;;;;;;;;;;;;;;;;;;;;;;
operate;;23,0;;13,0;2,0;6,0;19,0;34,0;26,0;7,0;16,0;1,0;19,0;1,0;14,0;49,0;7,0;1,0;;13,0;2,0;48,0;28,0;15,0;5,0;;8,0;1,0;;4,0;30,0;13,0;203,0;4,0;146,0;58,0;5,0;3,0;;;59,0;;7,0;15,0;36,0;12,0;55,0;378,0;65,0;168,0;24,0;19,0;;;47,0;1,0;53,0;2,0;1,0;4,0;4,0;10,0;14,0;;5,0;5,0;34,0;12,0;36,0;7,0;42,0;;43,0;;;25,0;7,0;3,0;14,0;164,0;2,0;55,0;5,0;128,0;3,0;28,0;26,0;;;11,0;81,0;;11,0;3,0;16,0;3,0;14,0;;370,0;21,0;3,0;;45,0;31,0;;13,0;26,0;4,0;26,0;70,0;;45,0;1,0;3,0;;140,0;84,0;113,0;51,0;47,0;1,0;;16,0;47,0;37,0;17,0;1,0;1,0;6,0;18,0;4,0;12,0;8,0;2,0;2,0;8,0;3,0;26,0;;;20,0;1,0;5,0;73,0;56,0;;;2,0;100,0;;13,0;;43,0;13,0;4,0;27,0;294,0;;3,0;10,0;1,0;7,0;181,0;;5,0;1,0;60,0;60,0;1,0;4,0;21,0;;;1,0;1,0;3,0;21,0;5,0;;;1,0;49,0;;3,0;4,0;20,0;;17,0;;;1,0;2,0;;31,0;;13,0;9,0;;2,0;5,0;;6,0;17,0;15,0;4,0;2,0;11,0;1,0;39,0;6,0;8,0;;5,0;4,0;;;1,0;6,0;2,0;3,0;18,0;;;;1,0;28,0;2,0;14,0;98,0;;126,0;;3,0;45,0;1,0;26,0;7,0;37,0;2,0;6,0;;3,0;2,0;2,0;40,0;6,0;;2,0;23,0;;3,0;;;2,0;;6,0;52,0;;;;;;;82,0;;2,0;;1,0;33,0;;;25,0;3,0;;2,0;7,0;15,0;1,0;2,0;29,0;55,0;;32,0;1,0;;77,0;;1,0;;3,0;89,0;3,0;;;;;;1,0;;;11,0;18,0;2,0;;;1,0;10,0;4,0;1,0;4,0;10,0;5,0;1,0;;28,0;;1,0;7,0;;16,0;1,0;;;;81,0;;5,0;;;3,0;1,0;1,0;;;;35,0;;4,0;3,0;2,0;;;2,0;27,0;3,0;3,0;8,0;15,0;4,0;6,0;;3,0;2,0;7,0;;5,0;7,0;91,0;21,0;;2,0;7,0;12,0;7,0;1,0;1,0;;1,0;;;2,0;20,0;;;8,0;;14,0;;4,0;5,0;4,0;;;4,0;;8,0;;;;24,0;;10,0;4,0;2,0;2,0;7,0;;;3,0;5,0;1,0;;43,0;7,0;;;4,0;;3,0;;22,0;5,0;6,0;;5,0;3,0;2,0;3,0;1,0;4,0;;;10,0;4,0;1,0;4,0;2,0;;;4,0;;28,0;15,0;5,0;20,0;;1,0;32,0;409,0;3,0;10,0;28,0;14,0;;26,0;;151,0;5,0;12,0;12,0;4,0;1,0;;38,0;22,0;20,0;43,0;1,0;;4,0;12,0;;2,0;8,0;;1,0;1,0;1,0;1,0;3,0;;;5,0;1,0;97,0;2,0;4,0;;51,0;4,0;23,0;;;;1,0;2,0;5,0;;2,0;5,0;5,0;18,0;2,0;12,0;;;21,0;5,0;23,0;2,0;15,0;1,0;12,0;10,0;5,0;;2,0;;7,0;7,0;14,0;8,0;;24,0;2,0;6,0;3,0;5,0;;1,0;4,0;5,0;8,0;4,0;;;;3,0;;16,0;6,0;3,0;;14,0;3,0;;6,0;3,0;;2,0;3,0;11,0;1,0;;;25,0;3,0;7,0;;12,0;3,0;;4,0;2,0;3,0;14,0;;;;21,0;;6,0;;16,0;1,0;14,0;7,0;22,0;3,0;;3,0;;6,0;13,0;3,0;8,0;;;;;;2,0;1,0;4,0;10,0;1,0;8,0;6,0;8,0;14,0;;;3,0;2,0;5,0;;7,0;6,0;1,0;1,0;2,0;;10,0;;1,0;6,0;2,0;4,0;;;1,0;2,0;3,0;;7,0;;;1,0;4,0;2,0;14,0;3,0;;4,0;;1,0;14,0;;;14,0;;;;;8,0;5,0;1,0;1,0;31,0;43,0;;5,0;6,0;1,0;;1,0;1,0;;13,0;1,0;1,0;133,0;;;2,0;;;;;;;23,0;5,0;2,0;10,0;;;3,0;;21,0;50,0;4,0;7,0;;31,0;;;;2,0;;;18,0;11,0;;22,0;2,0;2,0;5,0;;2,0;;1,0;;;;;;2,0;4,0;;;10,0;4,0;;1,0;;;6,0;2,0;;1,0;;;7,0;4,0;1,0;;4,0;19,0;;1,0;;2,0;3,0;;5,0;;13,0;1,0;5,0;1,0;;;;9,0;;;2,0;1,0;2,0;3,0;;14,0;13,0;;;1,0;1,0;;;2,0;;;;;1,0;;1,0;1,0;;;;;;2,0;1,0;2,0;5,0;;;;;2,0;;;;;;3,0;;2,0;;;5,0;1,0;;2,0;;3,0;19,0;1,0;;9,0;7,0;;;;;;4,0;1,0;;3,0;;;;9,0;;;1,0;1,0;1,0;;1,0;;;;6,0;;;9,0;1,0;4,0;1,0;1,0;1,0;2,0;5,0;;;1,0;5,0;;2,0;;5,0;;;;3,0;;1,0;15,0;2,0;;;14,0;;;19,0;;4,0;;;;3,0;9,0;;3,0;1,0;4,0;;1,0;12,0;;;;2,0;;;;8,0;3,0;3,0;;1,0;8,0;4,0;;1,0;;;;8,0;3,0;3,0;;1,0;;;;;9,0;;7,0;;;;31,0;2,0;;2,0;7,0;1,0;;;1,0;;;;;;2,0;;;;3,0;2,0;;;;3,0;2,0;;;2,0;;9,0;;;;;;;;;;;;;;;;;2,0;;;;;;2,0;;;;;;;4,0;;;;;;2,0;2,0;;;;;;;1,0;4,0;;;;;;;1,0;1,0;;;;;1,0;2,0;;;1,0;;;3,0;;;;6,0;;;
operation;;18,0;4,0;16,0;6,0;13,0;116,0;155,0;38,0;12,0;15,0;;29,0;3,0;14,0;187,0;10,0;4,0;9,0;8,0;19,0;173,0;31,0;4,0;;6,0;28,0;6,0;;7,0;43,0;25,0;265,0;9,0;823,0;180,0;44,0;60,0;2,0;;210,0;4,0;16,0;8,0;163,0;90,0;112,0;335,0;113,0;241,0;21,0;35,0;18,0;;133,0;10,0;61,0;4,0;7,0;9,0;2,0;36,0;10,0;7,0;80,0;17,0;198,0;10,0;43,0;;89,0;2,0;101,0;5,0;3,0;25,0;20,0;6,0;12,0;842,0;16,0;188,0;5,0;226,0;9,0;90,0;75,0;13,0;1,0;6,0;374,0;11,0;8,0;2,0;3,0;35,0;32,0;6,0;265,0;27,0;2,0;26,0;105,0;56,0;2,0;52,0;81,0;10,0;159,0;24,0;;970,0;4,0;6,0;;188,0;108,0;150,0;65,0;149,0;10,0;;23,0;182,0;150,0;30,0;3,0;18,0;;39,0;6,0;64,0;10,0;6,0;7,0;17,0;8,0;164,0;38,0;5,0;16,0;7,0;3,0;115,0;89,0;;;17,0;393,0;10,0;20,0;;134,0;86,0;75,0;39,0;228,0;;14,0;25,0;15,0;22,0;742,0;;10,0;;78,0;21,0;4,0;9,0;211,0;;;11,0;43,0;25,0;8,0;22,0;;;3,0;154,0;;1,0;75,0;132,0;;8,0;;;6,0;10,0;;19,0;1,0;87,0;3,0;;2,0;13,0;;1,0;13,0;51,0;1,0;;22,0;1,0;80,0;22,0;1,0;2,0;5,0;8,0;4,0;;1,0;7,0;1,0;14,0;15,0;2,0;1,0;;;;;5,0;159,0;2,0;408,0;;21,0;19,0;7,0;48,0;22,0;44,0;2,0;18,0;11,0;12,0;6,0;4,0;8,0;;;;268,0;7,0;14,0;;;26,0;;9,0;210,0;3,0;;2,0;;;6,0;284,0;;16,0;4,0;1,0;204,0;;41,0;17,0;8,0;;;8,0;237,0;11,0;3,0;39,0;236,0;63,0;31,0;;12,0;255,0;;14,0;2,0;;33,0;4,0;7,0;;1,0;4,0;3,0;;;;21,0;14,0;8,0;;1,0;;6,0;43,0;;4,0;22,0;15,0;;;12,0;1,0;;4,0;7,0;10,0;;4,0;3,0;;108,0;1,0;7,0;2,0;5,0;6,0;;;2,0;;;12,0;17,0;27,0;20,0;;;;6,0;3,0;20,0;9,0;37,0;13,0;16,0;13,0;6,0;2,0;6,0;59,0;;3,0;7,0;61,0;9,0;9,0;6,0;8,0;;2,0;1,0;;;;3,0;3,0;5,0;70,0;;5,0;24,0;;92,0;7,0;43,0;60,0;4,0;3,0;3,0;3,0;;20,0;;;;2,0;3,0;20,0;4,0;3,0;15,0;7,0;1,0;1,0;2,0;;1,0;;36,0;11,0;;;;;21,0;55,0;112,0;14,0;23,0;2,0;30,0;14,0;;26,0;8,0;2,0;1,0;6,0;27,0;28,0;3,0;7,0;9,0;23,0;1,0;2,0;;213,0;26,0;5,0;8,0;;3,0;24,0;917,0;1,0;24,0;19,0;32,0;;14,0;151,0;;15,0;;44,0;18,0;2,0;;33,0;24,0;137,0;25,0;5,0;2,0;1,0;28,0;4,0;4,0;47,0;1,0;;3,0;;7,0;16,0;1,0;3,0;38,0;18,0;277,0;2,0;4,0;;108,0;1,0;75,0;3,0;6,0;33,0;17,0;96,0;8,0;4,0;2,0;2,0;62,0;6,0;3,0;199,0;2,0;;7,0;13,0;25,0;2,0;26,0;5,0;2,0;127,0;18,0;6,0;40,0;;208,0;11,0;9,0;18,0;1,0;5,0;3,0;7,0;2,0;;2,0;19,0;5,0;30,0;9,0;36,0;8,0;;16,0;3,0;5,0;8,0;3,0;27,0;10,0;30,0;1,0;2,0;79,0;;46,0;18,0;3,0;1,0;9,0;3,0;2,0;26,0;3,0;3,0;3,0;68,0;;;7,0;19,0;4,0;11,0;3,0;;2,0;69,0;;50,0;2,0;27,0;;23,0;2,0;53,0;4,0;34,0;13,0;;9,0;;1,0;33,0;;;1,0;2,0;9,0;1,0;2,0;;41,0;12,0;;5,0;2,0;13,0;;8,0;13,0;;4,0;4,0;4,0;;1,0;3,0;6,0;3,0;4,0;3,0;;2,0;8,0;;2,0;;24,0;3,0;32,0;;1,0;3,0;2,0;2,0;;4,0;61,0;7,0;;2,0;25,0;15,0;26,0;14,0;;11,0;50,0;;;;15,0;2,0;;10,0;1,0;1,0;31,0;;4,0;6,0;6,0;4,0;3,0;1,0;27,0;6,0;1,0;24,0;7,0;1,0;5,0;;9,0;2,0;2,0;;3,0;14,0;1,0;4,0;14,0;;;4,0;;22,0;39,0;1,0;126,0;1,0;;3,0;1,0;;;;1,0;6,0;4,0;;8,0;10,0;40,0;17,0;24,0;1,0;;;;1,0;19,0;;;10,0;4,0;;;;5,0;9,0;4,0;3,0;10,0;161,0;5,0;1,0;;12,0;3,0;4,0;;1,0;;;26,0;;1,0;2,0;1,0;25,0;7,0;3,0;;9,0;;;3,0;15,0;2,0;;10,0;;;15,0;1,0;11,0;3,0;;;2,0;2,0;1,0;1,0;;;;;;;3,0;2,0;3,0;7,0;;4,0;4,0;2,0;6,0;;6,0;2,0;6,0;6,0;8,0;;;;1,0;28,0;3,0;7,0;1,0;1,0;;2,0;8,0;2,0;1,0;;7,0;3,0;15,0;12,0;1,0;6,0;20,0;23,0;1,0;5,0;25,0;;1,0;;;2,0;70,0;1,0;1,0;;8,0;;1,0;9,0;;3,0;15,0;16,0;1,0;;9,0;;1,0;1,0;4,0;;2,0;8,0;13,0;1,0;19,0;7,0;4,0;11,0;15,0;8,0;4,0;;4,0;;;;10,0;;8,0;;22,0;;3,0;2,0;;2,0;;6,0;22,0;;38,0;;10,0;7,0;3,0;5,0;9,0;1,0;1,0;;1,0;51,0;3,0;;6,0;;10,0;8,0;;1,0;;;1,0;;6,0;2,0;16,0;2,0;;;4,0;;;1,0;3,0;13,0;28,0;;;;5,0;12,0;5,0;8,0;;3,0;;1,0;;17,0;4,0;;;17,0;2,0;4,0;;;;1,0;;;2,0;;;2,0;4,0;11,0;5,0;;1,0;3,0;19,0;2,0;4,0;;9,0;;35,0;;;;3,0;1,0;1,0;6,0;;;;;;;;1,0;;2,0;4,0;;;10,0;;;;;4,0;;;1,0;4,0;;;28,0;17,0;;2,0;11,0;1,0;2,0;;;;;2,0;;1,0;2,0;;2,0;4,0;;6,0;2,0;;;2,0;;1,0;1,0;7,0;;;2,0;;;;;;;;1,0;
opposite;;4,0;2,0;1,0;;4,0;16,0;16,0;15,0;167,0;14,0;;2,0;;33,0;35,0;;;;;;13,0;;5,0;1,0;;2,0;;;;1,0;6,0;8,0;;16,0;1,0;;1,0;;;1,0;;39,0;1,0;2,0;1,0;1,0;40,0;9,0;8,0;73,0;6,0;;1,0;23,0;47,0;68,0;;;;44,0;1,0;13,0;;5,0;1,0;2,0;64,0;28,0;29,0;2,0;;4,0;;;1,0;;1,0;2,0;99,0;;36,0;;37,0;1,0;;2,0;;12,0;1,0;150,0;;;11,0;;2,0;;;7,0;1,0;;;60,0;4,0;3,0;;42,0;2,0;5,0;;11,0;1,0;2,0;;;24,0;127,0;111,0;4,0;3,0;3,0;1,0;;3,0;2,0;;3,0;;;;;6,0;11,0;2,0;;;11,0;;;;1,0;;;63,0;5,0;;;625,0;21,0;1,0;;;2,0;;8,0;;29,0;;4,0;10,0;1,0;;56,0;;;;4,0;3,0;;;;1,0;1,0;24,0;4,0;6,0;21,0;66,0;;;32,0;52,0;8,0;9,0;6,0;15,0;;26,0;;;;;;36,0;;242,0;;;15,0;10,0;3,0;;3,0;351,0;5,0;15,0;1,0;;1,0;105,0;2,0;9,0;11,0;5,0;11,0;;16,0;3,0;;58,0;47,0;6,0;22,0;6,0;;;27,0;1,0;34,0;;127,0;1,0;16,0;51,0;38,0;23,0;7,0;79,0;;24,0;5,0;12,0;1,0;2,0;2,0;;4,0;;23,0;18,0;83,0;;20,0;2,0;1,0;;48,0;7,0;;;3,0;7,0;14,0;;12,0;;5,0;1,0;3,0;;30,0;5,0;28,0;4,0;;27,0;;14,0;85,0;507,0;1,0;;15,0;;1,0;;;6,0;;19,0;3,0;2,0;;;32,0;1,0;2,0;;5,0;1,0;27,0;2,0;27,0;2,0;;4,0;7,0;10,0;46,0;;3,0;11,0;3,0;11,0;2,0;1,0;1,0;5,0;1,0;6,0;3,0;;;1,0;25,0;;7,0;4,0;;;2,0;4,0;24,0;1,0;;;7,0;21,0;1,0;27,0;2,0;15,0;3,0;;2,0;;10,0;5,0;18,0;1,0;10,0;1,0;;5,0;26,0;11,0;2,0;37,0;2,0;1,0;;3,0;4,0;18,0;16,0;;1,0;14,0;18,0;2,0;;1,0;2,0;;4,0;5,0;6,0;4,0;22,0;12,0;1,0;7,0;3,0;13,0;5,0;1,0;59,0;9,0;20,0;54,0;3,0;1,0;2,0;3,0;11,0;5,0;;;15,0;;;;;6,0;;;;;;;5,0;14,0;;;;;;;;;;;2,0;;;;;4,0;;;;6,0;5,0;8,0;9,0;;1,0;;;;1,0;8,0;13,0;1,0;;2,0;2,0;3,0;2,0;3,0;;;;;;;1,0;;1,0;;;2,0;;;;1,0;;1,0;;3,0;;;;;9,0;;1,0;;11,0;;8,0;;;16,0;;;12,0;;1,0;4,0;;;;;;;;;5,0;;3,0;;;;10,0;;7,0;;;;;1,0;;;;;;;1,0;;2,0;;1,0;6,0;;;;;;;;;;3,0;;;;;1,0;;;71,0;;;;;;;;;;2,0;;;;24,0;;1,0;3,0;4,0;;;;;1,0;;5,0;9,0;;;;;5,0;1,0;;;;3,0;;;;2,0;;;1,0;;;;2,0;;;;;9,0;1,0;;;;8,0;;43,0;;;;;1,0;;1,0;;;;1,0;10,0;;;;;;;;;;;1,0;;;25,0;;2,0;;;;;3,0;;;;6,0;;;;;;;;5,0;;7,0;;2,0;3,0;;;;1,0;5,0;1,0;;2,0;1,0;8,0;;;;12,0;10,0;1,0;2,0;;2,0;3,0;;3,0;;;;;2,0;7,0;14,0;3,0;;8,0;2,0;;2,0;;6,0;12,0;1,0;;;;1,0;;2,0;1,0;2,0;12,0;2,0;;1,0;1,0;;2,0;1,0;;;6,0;3,0;;;;28,0;;;5,0;1,0;6,0;3,0;;7,0;3,0;2,0;2,0;37,0;12,0;;1,0;;;;;;8,0;;1,0;5,0;8,0;;;;;;8,0;1,0;;2,0;3,0;;1,0;;;15,0;3,0;2,0;;1,0;29,0;;;;;;;;;2,0;29,0;;3,0;29,0;;;1,0;1,0;;;;;;;;;;;;;;;;;6,0;1,0;;5,0;;;1,0;;;;;;1,0;;;15,0;;;;;;1,0;;;;2,0;;;;;;;;;1,0;;;;;;;;;3,0;3,0;3,0;2,0;;;;;;;;;;;;;;;;2,0;3,0;;;;;;;;3,0;;;1,0;;;3,0;;6,0;1,0;;;1,0;;;;4,0;4,0;;;;1,0;;1,0;;;;;1,0;;;2,0;;;;3,0;;;;2,0;;;6,0;3,0;32,0;;1,0;1,0;;4,0;;;;;1,0;;;;;4,0;6,0;2,0;1,0;;;2,0;;;;;;6,0;;;;;;;2,0;;;;3,0;;;3,0;6,0;;2,0;2,0;6,0;;2,0;;8,0;;;;;14,0;;6,0;;;;;;;;;7,0;;;;1,0;1,0;;;;;;;;;;;;;;;;;;;;;
orient;;4,0;;;;35,0;2,0;3,0;7,0;12,0;1,0;;;;40,0;7,0;7,0;;;;2,0;27,0;2,0;1,0;;;;2,0;1,0;;1,0;;7,0;;9,0;1,0;;;;;3,0;;11,0;;2,0;;;25,0;3,0;28,0;8,0;;;;10,0;19,0;8,0;;;;1,0;;23,0;;2,0;;;1,0;8,0;10,0;;6,0;2,0;;;1,0;1,0;2,0;2,0;78,0;1,0;13,0;;13,0;;;;;11,0;7,0;19,0;;;;;1,0;2,0;;14,0;1,0;3,0;;13,0;18,0;1,0;;34,0;;1,0;;;;;;;18,0;13,0;33,0;;7,0;;;;2,0;3,0;2,0;;;4,0;2,0;;1,0;16,0;;;;4,0;;;;3,0;;;33,0;2,0;1,0;;12,0;2,0;4,0;;;2,0;;1,0;;21,0;;3,0;;;1,0;17,0;;;;6,0;30,0;2,0;4,0;;;;4,0;;1,0;7,0;3,0;;;4,0;3,0;;;;;;7,0;;;;;;2,0;;1,0;1,0;;;5,0;5,0;;;79,0;4,0;;;;;12,0;;4,0;13,0;;;;;;1,0;4,0;15,0;3,0;;;;3,0;3,0;;32,0;;11,0;;7,0;12,0;;;;9,0;2,0;;2,0;;;1,0;;;;;4,0;34,0;3,0;;2,0;;;2,0;17,0;9,0;;;;;1,0;3,0;;;1,0;3,0;;;1,0;;;;;4,0;;3,0;2,0;28,0;;;;;6,0;1,0;;;;1,0;12,0;5,0;;;3,0;;;5,0;;;5,0;;;8,0;;4,0;;;1,0;3,0;;;;;1,0;;1,0;;;;;;;1,0;;;2,0;;;;1,0;;2,0;;2,0;;2,0;2,0;;1,0;;;;3,0;;;;2,0;16,0;2,0;;9,0;;;;2,0;5,0;4,0;1,0;1,0;4,0;4,0;;;2,0;;;3,0;;4,0;;;;;;1,0;10,0;2,0;2,0;3,0;;;3,0;;4,0;;;1,0;;22,0;;12,0;;1,0;3,0;1,0;1,0;9,0;2,0;;;;;1,0;;;;1,0;;;;;;;1,0;;;;;;;4,0;8,0;;;;;4,0;1,0;;;1,0;1,0;4,0;1,0;;;;1,0;;;;;;2,0;;;;13,0;;;;;;;;7,0;;;;;;;;;;;;;1,0;;;;1,0;10,0;4,0;;;;;1,0;4,0;;2,0;1,0;;1,0;;;2,0;;2,0;;;;2,0;1,0;;2,0;;;1,0;4,0;1,0;;;;;1,0;;;13,0;4,0;4,0;;;;;;;;1,0;1,0;;;;;;;;;;1,0;3,0;;;;4,0;;;;;;;;;;;2,0;;;;;;;3,0;2,0;;6,0;;;1,0;3,0;;;2,0;;;;;;;2,0;;;;;2,0;;;;;;;2,0;;;;;;;;;;;;;;5,0;;2,0;;;;;5,0;;1,0;1,0;;1,0;;1,0;;;;;;4,0;;;;;;;;3,0;;;;;;;;;;;1,0;;;;;6,0;;;;;;;;2,0;;;;;;;;;;;;;;;;;23,0;;1,0;;9,0;1,0;2,0;;2,0;;;;;;;3,0;2,0;;5,0;;;;;;1,0;;;;;5,0;;;;;2,0;;1,0;;2,0;;1,0;;;;;;1,0;1,0;;;;;;;2,0;;3,0;;6,0;;;2,0;;;;;1,0;3,0;;3,0;;;;;1,0;;11,0;;;2,0;3,0;1,0;;;;;;;;;;;;;;;;;;;3,0;;2,0;;1,0;;;;;;;;;;;;;;;;;;;;;;1,0;;;;;1,0;;;;;;;;3,0;1,0;;;;;;;;;;;;;4,0;;;;;;4,0;;;;;;;;;;5,0;;;;7,0;;;3,0;6,0;;;;;;;;;;;;;;;;;;;;1,0;;;;;;;;;;;2,0;;;;;;1,0;;;;;;2,0;;;;;;;2,0;;;;;;2,0;;;;5,0;;;;;;2,0;;2,0;;;1,0;;1,0;;5,0;;2,0;;1,0;;;1,0;;;;2,0;;;;;;1,0;1,0;;;;;;;;;;;;;;;;4,0;2,0;;;;;;;;;;;;;;;;;;;;;;;;;;;;;;;;;;;;;;;;;;;;;
orientation;;6,0;6,0;1,0;5,0;54,0;2,0;31,0;8,0;10,0;23,0;;31,0;1,0;35,0;108,0;3,0;;;5,0;7,0;47,0;17,0;;9,0;;6,0;;1,0;14,0;17,0;;46,0;;18,0;4,0;33,0;13,0;4,0;;117,0;;28,0;19,0;41,0;2,0;239,0;273,0;53,0;102,0;18,0;18,0;2,0;;5,0;14,0;24,0;1,0;78,0;2,0;3,0;3,0;25,0;2,0;6,0;3,0;;1,0;5,0;8,0;5,0;2,0;45,0;1,0;;1,0;24,0;1,0;1,0;271,0;;28,0;2,0;75,0;1,0;21,0;;1,0;19,0;9,0;34,0;;;;35,0;5,0;3,0;1,0;180,0;55,0;18,0;3,0;23,0;71,0;;12,0;32,0;7,0;8,0;14,0;3,0;5,0;;;3,0;45,0;46,0;324,0;;34,0;;;12,0;15,0;41,0;12,0;;;1,0;;;55,0;144,0;6,0;16,0;1,0;14,0;7,0;;;15,0;3,0;3,0;186,0;4,0;;;22,0;8,0;19,0;;;8,0;49,0;6,0;3,0;96,0;;35,0;;12,0;1,0;39,0;;6,0;;20,0;47,0;;;16,0;;;1,0;2,0;7,0;17,0;5,0;;;4,0;52,0;;3,0;;5,0;;12,0;;1,0;;;;5,0;;;;;;2,0;1,0;;6,0;47,0;;;;;;30,0;;;;;;;;;1,0;3,0;30,0;;;;2,0;;6,0;;13,0;;14,0;;9,0;57,0;4,0;13,0;14,0;2,0;2,0;;3,0;6,0;2,0;7,0;1,0;;;54,0;16,0;33,0;36,0;6,0;;;;;37,0;;;;;;4,0;36,0;;;7,0;;5,0;;;7,0;17,0;;;3,0;1,0;3,0;;15,0;13,0;;1,0;;;18,0;;;;;42,0;31,0;;;;;1,0;;;;4,0;26,0;1,0;2,0;;;;3,0;6,0;;;13,0;;2,0;7,0;2,0;3,0;4,0;;10,0;4,0;;;;1,0;3,0;3,0;;;;2,0;1,0;;;6,0;1,0;18,0;8,0;2,0;;;1,0;1,0;;;1,0;9,0;6,0;7,0;11,0;;6,0;;;;;7,0;38,0;35,0;;;8,0;;;1,0;;;3,0;;;1,0;2,0;;10,0;;;2,0;4,0;16,0;25,0;;;7,0;;;;2,0;5,0;;11,0;7,0;50,0;;3,0;;;4,0;5,0;3,0;;3,0;13,0;2,0;3,0;;;;22,0;14,0;27,0;64,0;4,0;9,0;21,0;51,0;1,0;1,0;;1,0;;;21,0;3,0;4,0;1,0;2,0;2,0;36,0;6,0;19,0;5,0;28,0;4,0;11,0;118,0;;6,0;29,0;4,0;;5,0;16,0;25,0;;;12,0;;2,0;;2,0;10,0;10,0;;5,0;1,0;40,0;3,0;2,0;25,0;;21,0;2,0;5,0;1,0;1,0;2,0;11,0;1,0;5,0;29,0;5,0;;1,0;5,0;56,0;4,0;5,0;5,0;4,0;;24,0;15,0;3,0;7,0;25,0;;;7,0;17,0;3,0;;33,0;;;;1,0;20,0;4,0;18,0;;3,0;;2,0;19,0;6,0;2,0;3,0;;;1,0;;29,0;3,0;;;3,0;1,0;;4,0;;;;16,0;4,0;;;6,0;;5,0;1,0;;3,0;4,0;3,0;;;39,0;1,0;;;;;4,0;;;4,0;;;;;;;13,0;7,0;;1,0;3,0;6,0;2,0;;;;;;4,0;16,0;4,0;1,0;;2,0;9,0;4,0;22,0;2,0;;2,0;;;3,0;;;1,0;;4,0;;;21,0;1,0;8,0;;;;;;1,0;;;3,0;2,0;;8,0;;1,0;;;1,0;1,0;;;;;;;;;;;2,0;;3,0;2,0;3,0;;;3,0;;11,0;;6,0;;1,0;;;;4,0;;;;;;3,0;1,0;5,0;;6,0;8,0;;4,0;61,0;;;2,0;;9,0;7,0;;;;;;4,0;;6,0;1,0;;;;23,0;1,0;;;7,0;;5,0;;;1,0;;;2,0;;;70,0;1,0;;54,0;;7,0;;;;16,0;;;;13,0;1,0;;6,0;1,0;3,0;;;;1,0;11,0;;2,0;;;1,0;;2,0;7,0;;;;1,0;;;7,0;1,0;;;;;;;3,0;3,0;;3,0;1,0;;;;2,0;;;12,0;;;;9,0;;;8,0;;;;2,0;;2,0;;;;;;;;;;;;1,0;;;2,0;;;;;;1,0;;;;;13,0;;;;;;2,0;;1,0;;;;;10,0;;1,0;9,0;;;2,0;3,0;;4,0;;;;;;;;;;;;;;;;4,0;;2,0;;2,0;;;;;;2,0;;;;;3,0;;;;3,0;;;;;;;;4,0;;;;;;;;;2,0;1,0;1,0;;2,0;;;;;11,0;1,0;;4,0;1,0;;;;1,0;;;2,0;;1,0;;1,0;;2,0;1,0;;;;;1,0;;3,0;1,0;;;;1,0;;;;;;;;1,0;2,0;;14,0;;4,0;1,0;;1,0;;;4,0;1,0;8,0;;7,0;;1,0;;1,0;10,0;1,0;1,0;1,0;1,0;;;3,0;;2,0;;;;1,0;;;2,0;1,0;2,0;;;;;;1,0;;;;;;;;;;2,0;;;2,0;;;;;;;;;;;;;4,0;;;;;;;2,0;5,0;;12,0;;30,0;;2,0;;3,0;;1,0;;1,0;3,0;;;;8,0;;;;;
outer;;4,0;2,0;;;18,0;3,0;10,0;42,0;24,0;;;6,0;;43,0;29,0;12,0;;;;;4,0;1,0;12,0;2,0;;5,0;2,0;5,0;1,0;;;42,0;;4,0;5,0;;;;3,0;9,0;10,0;65,0;3,0;12,0;;4,0;69,0;5,0;20,0;84,0;8,0;;;22,0;89,0;31,0;;;;118,0;11,0;2,0;;7,0;;5,0;129,0;66,0;31,0;;1,0;1,0;;;5,0;;5,0;6,0;32,0;1,0;19,0;;119,0;2,0;1,0;1,0;;21,0;68,0;245,0;;;6,0;;;;;31,0;3,0;;;91,0;;2,0;;73,0;;;;10,0;4,0;125,0;1,0;1,0;48,0;417,0;84,0;5,0;3,0;3,0;1,0;1,0;1,0;1,0;;2,0;;;7,0;;;13,0;1,0;6,0;;7,0;;;;;4,0;;33,0;2,0;;37,0;194,0;;6,0;;1,0;;1,0;1,0;2,0;40,0;;;;;6,0;84,0;8,0;5,0;;11,0;8,0;;;3,0;4,0;10,0;19,0;1,0;5,0;39,0;123,0;1,0;;17,0;73,0;4,0;10,0;;15,0;4,0;5,0;2,0;1,0;;3,0;;58,0;1,0;25,0;;10,0;;174,0;62,0;1,0;;76,0;;31,0;4,0;1,0;;139,0;7,0;18,0;3,0;;2,0;6,0;18,0;;5,0;42,0;233,0;3,0;369,0;1,0;2,0;11,0;26,0;4,0;16,0;1,0;158,0;25,0;8,0;65,0;57,0;15,0;1,0;75,0;24,0;;6,0;20,0;19,0;3,0;;;;;1,0;12,0;101,0;;5,0;4,0;4,0;;41,0;14,0;2,0;1,0;;;23,0;;7,0;;54,0;39,0;13,0;;4,0;4,0;32,0;6,0;;24,0;;39,0;38,0;823,0;;;8,0;6,0;4,0;;;;11,0;9,0;31,0;4,0;2,0;;361,0;;;;24,0;10,0;8,0;7,0;106,0;4,0;1,0;17,0;4,0;4,0;51,0;14,0;1,0;38,0;3,0;100,0;13,0;7,0;6,0;17,0;25,0;25,0;12,0;;125,0;37,0;18,0;3,0;22,0;12,0;;1,0;6,0;24,0;13,0;2,0;1,0;;5,0;5,0;8,0;47,0;9,0;3,0;2,0;2,0;1,0;6,0;11,0;19,0;14,0;3,0;88,0;8,0;;2,0;2,0;3,0;7,0;1,0;2,0;7,0;4,0;17,0;12,0;14,0;39,0;8,0;;27,0;24,0;3,0;;2,0;2,0;;;;125,0;4,0;10,0;12,0;14,0;;1,0;13,0;2,0;;44,0;17,0;3,0;165,0;25,0;1,0;;5,0;68,0;1,0;30,0;72,0;10,0;;;;3,0;23,0;;;;1,0;;2,0;1,0;;;;;15,0;5,0;;1,0;;;;1,0;;;;3,0;1,0;;;;;1,0;1,0;13,0;;3,0;;;;;;4,0;;1,0;6,0;18,0;;;;6,0;;8,0;;;2,0;1,0;;;;1,0;;;;1,0;5,0;;;;7,0;;;1,0;;;;;;;5,0;3,0;11,0;;17,0;5,0;;;;;;;;;;;;4,0;;;5,0;8,0;;;1,0;;;18,0;;;;1,0;3,0;;;;;7,0;;;;;;;2,0;1,0;;;6,0;;1,0;;;1,0;6,0;;1,0;;;;8,0;;31,0;;18,0;;1,0;;;;;;;;;2,0;3,0;;12,0;7,0;23,0;3,0;4,0;3,0;;30,0;;4,0;2,0;2,0;;;;;29,0;3,0;;1,0;6,0;;3,0;;4,0;;;2,0;;;;4,0;;;;;16,0;4,0;;;;19,0;;34,0;;;;;;;4,0;;;;;23,0;;1,0;;5,0;3,0;;;;;;;;;36,0;;;;1,0;6,0;;;;;;3,0;;;;;2,0;;;2,0;;34,0;;4,0;;1,0;;1,0;4,0;6,0;1,0;1,0;9,0;60,0;10,0;;;;4,0;6,0;;7,0;11,0;;;;;;1,0;4,0;1,0;2,0;7,0;8,0;1,0;1,0;5,0;14,0;7,0;4,0;;4,0;8,0;1,0;5,0;2,0;4,0;;;;8,0;;;5,0;5,0;3,0;1,0;;10,0;1,0;;;1,0;7,0;;;;37,0;;;;1,0;17,0;10,0;1,0;;6,0;2,0;6,0;86,0;8,0;;;4,0;2,0;;8,0;;;;2,0;4,0;;1,0;;8,0;1,0;3,0;1,0;8,0;;1,0;1,0;;;;;3,0;;1,0;2,0;;1,0;;;;;;;;;;;;;10,0;;;;6,0;;6,0;;17,0;;;;;4,0;;3,0;;;;;;;4,0;;;;;1,0;1,0;;12,0;;;;;2,0;3,0;;5,0;;;;;2,0;;;;1,0;;;;;;;;1,0;;;;;;3,0;;3,0;1,0;;;;;3,0;;3,0;;;;4,0;;;1,0;;;;;;;;;;;;;11,0;;;8,0;;;;;;;3,0;;;7,0;;3,0;;2,0;11,0;2,0;;;;;;1,0;;;;;;2,0;;;;;;;2,0;;1,0;;;;8,0;15,0;;7,0;;;;5,0;;;;;;;;;;;46,0;1,0;;;;;;;;;;24,0;;1,0;;;32,0;;;;;9,0;;;;8,0;;;4,0;;;5,0;3,0;;;;;;51,0;;;;;;;;;;;15,0;;;;3,0;3,0;;;;;10,0;;;;;;;;;;;;;;;;6,0
overlap;;7,0;;;;18,0;38,0;12,0;85,0;6,0;5,0;;6,0;;7,0;21,0;4,0;1,0;1,0;;4,0;32,0;1,0;4,0;;1,0;17,0;7,0;2,0;;2,0;;10,0;;7,0;5,0;1,0;;;;24,0;;22,0;7,0;2,0;6,0;28,0;46,0;27,0;54,0;28,0;16,0;1,0;8,0;5,0;13,0;9,0;;1,0;;19,0;5,0;103,0;1,0;9,0;3,0;20,0;43,0;90,0;14,0;1,0;2,0;22,0;;2,0;6,0;6,0;2,0;7,0;398,0;;26,0;;22,0;1,0;;1,0;;1,0;2,0;19,0;;;5,0;12,0;;3,0;;47,0;;5,0;;25,0;44,0;;;34,0;9,0;7,0;6,0;6,0;16,0;;;6,0;80,0;133,0;34,0;1,0;14,0;;;1,0;16,0;6,0;4,0;;;;12,0;;7,0;3,0;2,0;;3,0;19,0;;3,0;;10,0;;;31,0;6,0;;;18,0;39,0;18,0;5,0;;;2,0;8,0;;23,0;;2,0;3,0;3,0;6,0;27,0;;1,0;;18,0;152,0;2,0;22,0;2,0;2,0;;33,0;30,0;;6,0;4,0;11,0;;2,0;9,0;;3,0;;5,0;;5,0;;;;2,0;;;;9,0;4,0;3,0;3,0;17,0;2,0;;3,0;30,0;5,0;3,0;;3,0;11,0;11,0;9,0;2,0;;17,0;2,0;;3,0;;;4,0;11,0;;1,0;;;4,0;3,0;;35,0;;38,0;1,0;;10,0;3,0;10,0;2,0;9,0;5,0;6,0;;;99,0;12,0;3,0;3,0;1,0;1,0;52,0;19,0;2,0;;;;;2,0;15,0;3,0;3,0;;;;7,0;15,0;12,0;;7,0;6,0;7,0;;8,0;6,0;12,0;;1,0;2,0;4,0;3,0;6,0;20,0;;;3,0;;;56,0;;3,0;5,0;1,0;1,0;;;;1,0;;;2,0;7,0;;3,0;3,0;;;;;;5,0;2,0;4,0;2,0;4,0;5,0;;4,0;20,0;;;3,0;1,0;;;;;17,0;;1,0;;;1,0;2,0;1,0;5,0;;2,0;6,0;;14,0;1,0;;;;1,0;;1,0;;;;13,0;22,0;;2,0;;3,0;;1,0;;6,0;;;;12,0;1,0;;2,0;;;;;1,0;;;;;25,0;;;;3,0;4,0;;;8,0;;;9,0;;;;1,0;5,0;3,0;;;;5,0;;4,0;2,0;;;;1,0;3,0;1,0;;;;1,0;;3,0;4,0;3,0;3,0;1,0;;;;3,0;1,0;;2,0;9,0;3,0;27,0;;;6,0;3,0;1,0;;1,0;8,0;;6,0;;;1,0;;;13,0;16,0;4,0;;;;11,0;;3,0;49,0;4,0;;;;2,0;5,0;;7,0;;8,0;5,0;;;;;;;1,0;15,0;2,0;;;;;3,0;;2,0;;;4,0;6,0;4,0;;17,0;3,0;;9,0;;;2,0;16,0;;;;;4,0;5,0;1,0;;1,0;;;;6,0;;;4,0;;8,0;2,0;;2,0;;;;;;;9,0;;2,0;;;16,0;;;;;4,0;3,0;;;;;;;7,0;3,0;;8,0;1,0;1,0;;1,0;3,0;4,0;4,0;2,0;;3,0;;;;;;2,0;;;;;;3,0;;;1,0;;;3,0;;;5,0;;3,0;;;;;;;2,0;6,0;;;;;;;1,0;1,0;;1,0;1,0;;;;;;2,0;6,0;;2,0;;2,0;;;7,0;4,0;6,0;;;;;;;;;;;;;1,0;4,0;;;;;149,0;3,0;;;4,0;;;5,0;;;3,0;;;;3,0;;;;;;;5,0;1,0;;;3,0;;;;;2,0;5,0;;;;;;;6,0;2,0;;20,0;;;;;1,0;;;4,0;;;3,0;;;;;;;3,0;;3,0;;1,0;;;;;;2,0;3,0;12,0;2,0;;;;;5,0;;2,0;;;;;;;;5,0;;;;;32,0;;10,0;;;;3,0;7,0;;1,0;;;;2,0;2,0;;2,0;1,0;8,0;;;;;;;3,0;1,0;1,0;;;;3,0;;;;;;;;;1,0;;;1,0;;;;1,0;;;;;;17,0;;;;;;4,0;;5,0;;;2,0;2,0;;4,0;1,0;5,0;;8,0;;1,0;3,0;;;;2,0;;3,0;;7,0;;17,0;4,0;;3,0;;;;;7,0;;;;1,0;;;;;1,0;;;;2,0;;;;;;;;;;;18,0;8,0;;1,0;;;;;;;;;;;;;2,0;;;1,0;;8,0;;;19,0;3,0;;8,0;;;;;;1,0;1,0;;;;5,0;;;4,0;;;;1,0;;1,0;;1,0;;;;8,0;;;;2,0;;;;;;;1,0;;;;;;11,0;10,0;;;2,0;;;;;;9,0;2,0;5,0;1,0;;;1,0;;;;1,0;;;;;;;;4,0;;;;1,0;;;1,0;;;;;;;1,0;;4,0;;;1,0;8,0;;;;;2,0;;2,0;;;9,0;;;;3,0;;;;;;;;;3,0;;;;;;1,0;;;;;;;;;;;;4,0;;;1,0;;1,0;
panel;;11,0;;;;9,0;7,0;53,0;11,0;11,0;3,0;;8,0;;20,0;16,0;;;;;;16,0;1,0;32,0;9,0;2,0;15,0;;1,0;;17,0;;26,0;;146,0;5,0;;;;1,0;39,0;;15,0;2,0;19,0;8,0;3,0;50,0;9,0;331,0;70,0;2,0;3,0;1,0;1,0;37,0;22,0;;;;41,0;5,0;4,0;;3,0;;;31,0;19,0;120,0;5,0;;16,0;;;4,0;12,0;3,0;;121,0;;27,0;;87,0;;1,0;;;;;46,0;;;2,0;;;;;40,0;1,0;;;23,0;7,0;;3,0;19,0;;4,0;;;;14,0;;2,0;19,0;63,0;91,0;9,0;13,0;16,0;;;6,0;4,0;7,0;;;1,0;4,0;1,0;2,0;31,0;3,0;1,0;;;5,0;;;;;1,0;28,0;4,0;;;208,0;32,0;4,0;4,0;;1,0;3,0;;2,0;25,0;;5,0;10,0;;1,0;46,0;;;;8,0;9,0;11,0;;3,0;1,0;2,0;15,0;;;36,0;;;;11,0;22,0;;;3,0;16,0;;26,0;;;;;;70,0;;18,0;;2,0;3,0;20,0;;;2,0;9,0;;;;6,0;;19,0;4,0;37,0;;;;;;1,0;1,0;42,0;72,0;4,0;21,0;1,0;7,0;1,0;5,0;;63,0;;22,0;2,0;14,0;122,0;;5,0;2,0;19,0;12,0;20,0;;;;;;;;3,0;8,0;3,0;16,0;;3,0;;;;41,0;;;;;;4,0;;;;1,0;;6,0;;9,0;20,0;9,0;;;3,0;1,0;1,0;4,0;77,0;10,0;;;;;1,0;;185,0;;10,0;21,0;1,0;;;2,0;;;;5,0;;1,0;3,0;28,0;;2,0;;4,0;10,0;18,0;4,0;;17,0;;;3,0;;5,0;31,0;;54,0;;2,0;;12,0;1,0;2,0;5,0;;;;;4,0;11,0;;5,0;2,0;;1,0;;;;3,0;3,0;15,0;;;;;2,0;;11,0;9,0;;6,0;;4,0;6,0;2,0;20,0;;;1,0;1,0;7,0;;4,0;;38,0;1,0;;3,0;2,0;;;;3,0;;3,0;22,0;40,0;;2,0;2,0;10,0;;1,0;;;;41,0;5,0;;1,0;2,0;10,0;4,0;;;12,0;;;;;5,0;;1,0;;2,0;;2,0;1,0;;;;;;;1,0;;;;;20,0;2,0;6,0;;;10,0;;;;16,0;1,0;;24,0;;;1,0;7,0;;10,0;4,0;5,0;;;3,0;12,0;;6,0;;;;2,0;;;9,0;;;;;3,0;;;;;;;;;2,0;;;;1,0;24,0;;;;;1,0;109,0;18,0;1,0;14,0;2,0;;;;;1,0;;;1,0;;;;;;14,0;6,0;9,0;;;;4,0;;;;2,0;;;36,0;;;;;;;11,0;;;1,0;1,0;3,0;1,0;;;;1,0;;;;1,0;9,0;;13,0;6,0;;;;;5,0;;;3,0;3,0;;7,0;;2,0;2,0;6,0;;3,0;;2,0;;8,0;8,0;13,0;4,0;3,0;28,0;;;;1,0;18,0;;;6,0;;3,0;5,0;;;2,0;3,0;;5,0;;7,0;;;5,0;;;;2,0;;;30,0;;;8,0;2,0;;2,0;;;14,0;;2,0;3,0;;;;;;;;;1,0;;2,0;;;;;;;1,0;2,0;;1,0;;2,0;;30,0;;;;;4,0;;;;3,0;;;;8,0;13,0;;;;;5,0;;;;3,0;;;;7,0;;;9,0;16,0;;;;;1,0;1,0;46,0;7,0;;;3,0;26,0;;;;;;;6,0;2,0;;;5,0;3,0;1,0;12,0;;;;46,0;1,0;1,0;1,0;;;;7,0;;3,0;;;;1,0;;15,0;;;;2,0;;;;;10,0;;;;;;;;2,0;;;22,0;;;;;;;;;;4,0;;;2,0;2,0;5,0;;;;1,0;1,0;3,0;;;;;;;;2,0;;;;1,0;1,0;;;;;;3,0;8,0;;;;;;7,0;;;;;;;;3,0;;1,0;;;;1,0;;;;;1,0;;;6,0;;;;;;3,0;;;;;;;1,0;;;16,0;;;;;;;;;;;;;;;;;;1,0;;;;;;;;;5,0;;;;;;;2,0;;;1,0;3,0;;;;;1,0;;;1,0;;;;;;;1,0;;1,0;;;;;;;;;;;;2,0;;;4,0;;26,0;;;1,0;;;;;;;;;;3,0;;;;;;3,0;;2,0;;;;;;;;;;;;;;;;;;;;2,0;;;;;;;;;;;;;;;;;1,0;;;;;;;;;;2,0;;;;;;;;;;;;;6,0;;;;;;;;;1,0;;;;;;;;;;;;;;;;;;;1,0;;1,0;4,0;;;;1,0;;
parallel;;2,0;;;;17,0;11,0;7,0;26,0;75,0;26,0;;4,0;;480,0;23,0;32,0;1,0;4,0;;18,0;11,0;22,0;10,0;;;3,0;2,0;;;1,0;;44,0;;13,0;3,0;3,0;2,0;2,0;;63,0;;29,0;3,0;27,0;7,0;6,0;39,0;10,0;24,0;51,0;14,0;1,0;12,0;31,0;16,0;32,0;;5,0;;92,0;4,0;5,0;;6,0;2,0;9,0;20,0;64,0;17,0;1,0;;14,0;;;31,0;6,0;6,0;6,0;223,0;14,0;38,0;9,0;70,0;1,0;5,0;;;3,0;15,0;169,0;;;;1,0;14,0;9,0;;36,0;4,0;1,0;;48,0;43,0;;3,0;250,0;1,0;92,0;;7,0;13,0;13,0;;9,0;64,0;124,0;61,0;4,0;19,0;;20,0;44,0;85,0;13,0;1,0;;;;;;19,0;23,0;;;4,0;17,0;;1,0;;2,0;;;83,0;5,0;2,0;;111,0;7,0;1,0;1,0;2,0;10,0;24,0;;5,0;56,0;;31,0;20,0;3,0;;113,0;;;;3,0;31,0;1,0;;5,0;;1,0;15,0;3,0;8,0;13,0;13,0;;;12,0;36,0;7,0;1,0;2,0;9,0;;15,0;1,0;2,0;;1,0;;64,0;4,0;6,0;;3,0;4,0;12,0;3,0;;1,0;265,0;4,0;1,0;;;5,0;103,0;3,0;10,0;14,0;5,0;11,0;;7,0;;10,0;8,0;35,0;1,0;14,0;;4,0;6,0;8,0;7,0;73,0;;85,0;1,0;12,0;54,0;4,0;24,0;15,0;6,0;18,0;14,0;13,0;2,0;;30,0;;;1,0;;27,0;207,0;63,0;;4,0;2,0;1,0;4,0;44,0;14,0;;;9,0;;1,0;3,0;3,0;1,0;6,0;4,0;5,0;;7,0;15,0;35,0;;;25,0;3,0;11,0;26,0;256,0;3,0;2,0;9,0;5,0;;2,0;;1,0;;2,0;11,0;21,0;1,0;1,0;82,0;;;7,0;13,0;13,0;9,0;7,0;5,0;15,0;;3,0;1,0;6,0;50,0;8,0;;3,0;3,0;3,0;8,0;4,0;;8,0;1,0;5,0;3,0;1,0;7,0;12,0;17,0;1,0;4,0;;1,0;1,0;10,0;1,0;;;1,0;;9,0;54,0;13,0;5,0;4,0;7,0;2,0;7,0;1,0;9,0;1,0;7,0;;11,0;;25,0;;11,0;19,0;12,0;7,0;25,0;6,0;4,0;5,0;3,0;2,0;5,0;4,0;3,0;2,0;7,0;10,0;6,0;1,0;;;;;7,0;4,0;7,0;16,0;29,0;8,0;4,0;3,0;24,0;4,0;6,0;40,0;5,0;2,0;43,0;;6,0;;;1,0;5,0;2,0;4,0;20,0;1,0;;;3,0;4,0;1,0;;;2,0;;3,0;12,0;1,0;;2,0;13,0;;3,0;2,0;;;;;7,0;6,0;;;;27,0;;;;15,0;;11,0;2,0;;7,0;4,0;6,0;;1,0;13,0;14,0;;;4,0;16,0;4,0;7,0;1,0;;;;;4,0;30,0;;12,0;1,0;;7,0;;;;2,0;1,0;;1,0;;17,0;;4,0;;;4,0;1,0;3,0;;;;7,0;21,0;;12,0;20,0;;;;;8,0;;;;16,0;1,0;;;;57,0;;4,0;;2,0;8,0;2,0;;4,0;1,0;8,0;;;6,0;11,0;2,0;;;4,0;;14,0;;2,0;;8,0;6,0;;;;;;3,0;;;;9,0;;1,0;;;;;;5,0;;3,0;;;;;5,0;;2,0;;;;;5,0;1,0;6,0;19,0;;;1,0;2,0;;1,0;;;6,0;;;;;3,0;8,0;;;1,0;6,0;1,0;2,0;1,0;;;2,0;;;;;;1,0;;1,0;1,0;;;2,0;;;3,0;3,0;17,0;;9,0;;;3,0;;;;;1,0;1,0;5,0;;;;;;;;8,0;2,0;;;2,0;;6,0;13,0;1,0;;2,0;1,0;;3,0;;;;10,0;1,0;;;1,0;;6,0;;1,0;1,0;3,0;1,0;;;;4,0;;11,0;2,0;;5,0;;1,0;10,0;3,0;;;8,0;2,0;;6,0;;2,0;5,0;3,0;;;1,0;3,0;3,0;2,0;2,0;;1,0;;9,0;6,0;;37,0;;1,0;1,0;1,0;;3,0;3,0;;;16,0;23,0;2,0;8,0;16,0;1,0;;;;;16,0;1,0;;3,0;2,0;;;;30,0;;;4,0;;5,0;2,0;12,0;4,0;3,0;;15,0;7,0;;3,0;1,0;7,0;;;8,0;;2,0;;;;4,0;3,0;;;;9,0;4,0;;;18,0;2,0;20,0;;;;;;5,0;;;2,0;3,0;;4,0;2,0;;;;;7,0;;;2,0;9,0;4,0;6,0;2,0;;;5,0;3,0;2,0;;;2,0;1,0;;;4,0;;;;;;3,0;;1,0;;;;10,0;;;5,0;6,0;3,0;;;;7,0;;2,0;3,0;4,0;;1,0;1,0;;;;;;3,0;;1,0;;4,0;;1,0;1,0;4,0;;3,0;4,0;6,0;4,0;1,0;2,0;1,0;1,0;1,0;;4,0;12,0;;;4,0;;;;;;;;;;;;1,0;;;;;;10,0;;;;;;;10,0;;;1,0;2,0;;5,0;2,0;5,0;;2,0;4,0;1,0;;;;;;;;;;;2,0;;;;;;;1,0;;;2,0;;;1,0;;7,0;1,0;;2,0;;1,0;13,0;;;10,0;;;;;;2,0;2,0;;6,0;2,0;16,0;;;4,0;;2,0;;1,0;1,0;;2,0;;;;8,0;;2,0;2,0;3,0;;;;21,0;;;;10,0;;5,0;;;;;;;1,0;;;;;;;11,0;;;;3,0;;;;1,0;1,0;2,0;;;10,0;;;;7,0;;;;;1,0;;;;;;1,0;;
partially;;8,0;;;1,0;1,0;21,0;6,0;15,0;1,0;3,0;;2,0;;7,0;25,0;27,0;;;;;15,0;;11,0;;;1,0;;;;;;17,0;;6,0;2,0;;;;;16,0;;6,0;4,0;2,0;2,0;7,0;14,0;1,0;10,0;48,0;;;;1,0;6,0;18,0;1,0;2,0;;19,0;2,0;39,0;;4,0;;10,0;14,0;2,0;10,0;;;3,0;;;;;10,0;3,0;83,0;1,0;9,0;1,0;23,0;;1,0;;;1,0;;54,0;;;12,0;3,0;;;;17,0;2,0;;;16,0;21,0;;1,0;24,0;;7,0;;11,0;;4,0;;;12,0;67,0;27,0;;;;;2,0;3,0;1,0;1,0;;6,0;3,0;2,0;;2,0;;3,0;2,0;2,0;3,0;1,0;7,0;;9,0;;;30,0;;;;12,0;;3,0;;2,0;;2,0;3,0;;10,0;;;1,0;;9,0;5,0;;;;5,0;73,0;2,0;4,0;;11,0;4,0;;;;25,0;13,0;8,0;;1,0;20,0;;8,0;1,0;9,0;;10,0;1,0;;1,0;1,0;2,0;4,0;2,0;9,0;1,0;;1,0;27,0;8,0;;1,0;15,0;;;3,0;;1,0;15,0;4,0;;;15,0;;;13,0;;;11,0;41,0;;11,0;;;;16,0;;54,0;;15,0;2,0;23,0;14,0;;1,0;;24,0;1,0;19,0;99,0;;;5,0;;;1,0;;13,0;;;;1,0;;;;18,0;30,0;3,0;;1,0;;1,0;;10,0;;6,0;6,0;5,0;8,0;;5,0;4,0;;4,0;1,0;;15,0;6,0;60,0;4,0;;4,0;;4,0;1,0;;2,0;8,0;8,0;25,0;;;;3,0;;1,0;23,0;;;16,0;4,0;2,0;;;;13,0;6,0;2,0;1,0;;;1,0;6,0;3,0;2,0;;;;3,0;;1,0;;6,0;5,0;;3,0;;2,0;3,0;3,0;;10,0;;;;;17,0;8,0;2,0;1,0;1,0;2,0;;;;;;;2,0;2,0;4,0;;;;1,0;;12,0;;5,0;;4,0;;12,0;2,0;1,0;;5,0;;1,0;;;;;1,0;;7,0;1,0;;6,0;1,0;;1,0;22,0;;;;2,0;;2,0;10,0;2,0;;;;4,0;;;1,0;2,0;;;1,0;;;;;;;;1,0;1,0;;;2,0;;;;;;;1,0;7,0;;;;;3,0;;;;1,0;;;4,0;;7,0;5,0;2,0;;2,0;2,0;;;;2,0;6,0;;2,0;15,0;1,0;1,0;;;;1,0;;;1,0;;1,0;;;;;2,0;;;1,0;2,0;;;;;;;;;;;3,0;2,0;;2,0;;;;;;;5,0;2,0;;;;;1,0;;;;;;;;;;3,0;;1,0;;;1,0;;;;;;;5,0;;2,0;;;10,0;;;;10,0;;4,0;;;;1,0;;;;4,0;;;;4,0;;;;2,0;;;;;;;;;;;;;;1,0;;;;;4,0;;;3,0;;;;;1,0;;6,0;;10,0;2,0;;;2,0;1,0;;;2,0;;;;3,0;;1,0;;;1,0;;;;;15,0;;4,0;;1,0;;;;;;;;;;;;21,0;;;;;1,0;;;;;1,0;;38,0;;1,0;;;;;;;;;5,0;;;;;1,0;;;;;1,0;3,0;;;4,0;;;;;;;1,0;;;;4,0;;;2,0;;4,0;;;2,0;3,0;;1,0;;;;;;;;;4,0;;;;;;;;10,0;;;;;;1,0;10,0;1,0;;4,0;;1,0;;;;;;;;;;;4,0;;;;;2,0;;;1,0;;;;;2,0;2,0;;;;;;;2,0;;2,0;20,0;8,0;1,0;1,0;7,0;3,0;;9,0;;;;;6,0;;1,0;;4,0;;2,0;1,0;;5,0;;;;;;;;;;;;;1,0;;;;1,0;;;1,0;2,0;;;2,0;1,0;;;;;;;;1,0;5,0;1,0;;;2,0;;;7,0;1,0;;;;;;;;;1,0;;;;;;;;;;;5,0;;;;1,0;;;;;;;3,0;;;1,0;;;;4,0;;5,0;;;1,0;;;1,0;;;;;;;;;;1,0;1,0;10,0;;;;;;1,0;;;;;;;1,0;;2,0;;2,0;;;;;;4,0;;1,0;2,0;;;;;;;;;;;;;;1,0;;;;1,0;;2,0;13,0;;;;;;;2,0;;;;3,0;3,0;;;;;;;4,0;2,0;;;;;;;3,0;;;;;;;5,0;8,0;;;2,0;;;;;;1,0;;2,0;;;8,0;;;;;1,0;;;8,0;1,0;;;;;4,0;;;;;3,0;;;;1,0;;;;;;1,0;;;;;;;;;;;;;1,0;;;
period;;2,0;;8,0;;;10,0;20,0;2,0;15,0;12,0;;2,0;;1,0;34,0;2,0;;2,0;;1,0;49,0;3,0;3,0;;;7,0;1,0;;1,0;9,0;31,0;21,0;2,0;100,0;23,0;11,0;21,0;;;49,0;2,0;3,0;3,0;23,0;19,0;49,0;80,0;40,0;28,0;3,0;8,0;;24,0;28,0;;27,0;;10,0;;11,0;11,0;14,0;;5,0;;22,0;;107,0;;8,0;1,0;32,0;9,0;;21,0;1,0;5,0;9,0;179,0;3,0;58,0;;72,0;16,0;7,0;7,0;;;20,0;35,0;;1,0;1,0;4,0;4,0;16,0;;65,0;1,0;;;14,0;25,0;;3,0;4,0;6,0;111,0;16,0;6,0;64,0;;;8,0;64,0;21,0;23,0;12,0;285,0;;;37,0;45,0;12,0;2,0;;2,0;;11,0;6,0;16,0;3,0;;9,0;2,0;7,0;8,0;62,0;3,0;3,0;;6,0;42,0;15,0;;;;269,0;16,0;1,0;;9,0;21,0;12,0;16,0;45,0;;4,0;150,0;9,0;17,0;196,0;1,0;9,0;3,0;23,0;4,0;2,0;;13,0;;;2,0;21,0;16,0;1,0;1,0;;;;12,0;;;42,0;17,0;;4,0;;;6,0;3,0;;1,0;3,0;;16,0;;;;;;4,0;9,0;;;13,0;;150,0;2,0;;;12,0;8,0;;;;;;;1,0;2,0;;;;;;;43,0;;1,0;;2,0;8,0;;;8,0;29,0;3,0;;49,0;;15,0;10,0;25,0;;16,0;;141,0;;1,0;;;;;58,0;18,0;2,0;;;;;;19,0;;;1,0;;43,0;;;1,0;;;;;42,0;;;3,0;20,0;11,0;;;;976,0;11,0;2,0;;2,0;11,0;5,0;8,0;;2,0;;1,0;;;;8,0;8,0;3,0;;;;5,0;12,0;;;6,0;1,0;;;2,0;2,0;;;;7,0;;;;;47,0;;;;1,0;;;;;;;14,0;;;44,0;;;;1,0;8,0;4,0;;;4,0;1,0;4,0;;;1,0;20,0;;;;14,0;;;;1,0;;;;;6,0;;;3,0;;2,0;;3,0;2,0;;;;14,0;;;;;15,0;;3,0;;;1,0;;1,0;7,0;3,0;;1,0;7,0;;2,0;;;4,0;;;4,0;;;;;8,0;36,0;55,0;;15,0;12,0;4,0;19,0;;5,0;7,0;;;;1,0;19,0;17,0;;;3,0;;;;23,0;41,0;1,0;6,0;3,0;;6,0;60,0;;8,0;10,0;3,0;5,0;1,0;12,0;44,0;;2,0;;2,0;;;5,0;21,0;29,0;;1,0;;1,0;4,0;2,0;7,0;2,0;;;2,0;1,0;20,0;;;;5,0;1,0;12,0;;12,0;;47,0;2,0;10,0;;1,0;1,0;1,0;20,0;;1,0;;;41,0;2,0;34,0;;;;;;1,0;;2,0;;;16,0;;10,0;;;140,0;;;2,0;;;25,0;13,0;;;1,0;;4,0;1,0;2,0;6,0;;;2,0;;;2,0;;3,0;1,0;;14,0;;9,0;1,0;1,0;22,0;1,0;;2,0;4,0;;6,0;3,0;10,0;;7,0;;;2,0;1,0;2,0;9,0;;;;3,0;1,0;14,0;;1,0;5,0;14,0;2,0;29,0;1,0;;2,0;;1,0;;;2,0;;;;;;;4,0;;6,0;4,0;;3,0;;3,0;;;4,0;;;;;;;3,0;3,0;;;2,0;;29,0;67,0;;12,0;;;;;;;;;;;;13,0;;;;;3,0;20,0;2,0;;45,0;23,0;;;;1,0;;;6,0;;;3,0;;;1,0;;27,0;;;;3,0;1,0;1,0;;;;;;;;;2,0;62,0;;2,0;49,0;;;;;13,0;2,0;;12,0;;;;;;;;;1,0;;;;46,0;14,0;;1,0;;;;;;2,0;;;6,0;1,0;;;;2,0;;;16,0;;4,0;;;7,0;;;1,0;;;;;;;2,0;3,0;;13,0;;3,0;;;;;4,0;;;;9,0;;;10,0;;7,0;1,0;;;1,0;;;;;;2,0;1,0;;1,0;;;7,0;;;4,0;25,0;15,0;;1,0;22,0;;2,0;;5,0;;;;1,0;4,0;;;4,0;3,0;;5,0;3,0;;2,0;;2,0;4,0;1,0;12,0;;;10,0;;1,0;2,0;10,0;;;;2,0;;1,0;53,0;;1,0;18,0;;;;;1,0;;;;;3,0;;;1,0;2,0;;;;;1,0;;33,0;;4,0;4,0;;;;2,0;;2,0;4,0;;;;;2,0;;;;;2,0;2,0;;2,0;;7,0;;;1,0;;;;;;;;;;1,0;;;;;1,0;;;1,0;;;2,0;;;;;;;;4,0;;1,0;;;;;;;;3,0;;;4,0;;;;6,0;1,0;;;9,0;1,0;;;;;3,0;;;;;;;;;;;;;;;6,0;;4,0;;;3,0;;2,0;;;2,0;2,0;;;;;;;;;;;;;;4,0;;;;;;;;;;;;17,0;;;1,0;10,0;;1,0;2,0;;;;;2,0;;;;;;;2,0;;;;;;;;;;3,0;;;;6,0;;;;;;
periphery;;2,0;;;13,0;;5,0;4,0;28,0;23,0;3,0;1,0;;;12,0;6,0;;;;;;;;1,0;1,0;;20,0;;;;1,0;2,0;2,0;;;;;;;2,0;;;13,0;;2,0;;1,0;6,0;1,0;20,0;34,0;6,0;;12,0;10,0;3,0;6,0;;6,0;;26,0;4,0;1,0;;5,0;2,0;;40,0;15,0;3,0;;;;;;4,0;1,0;;2,0;12,0;;3,0;;22,0;;;;;1,0;2,0;82,0;;;1,0;;13,0;;;5,0;;;;12,0;5,0;;;8,0;;;;1,0;;16,0;1,0;;23,0;61,0;21,0;;5,0;;;;;;;;;;;;;;;;;2,0;;;;;;;5,0;;;;25,0;3,0;1,0;;;;;;;1,0;;;3,0;1,0;;16,0;;;;1,0;3,0;;;;;1,0;5,0;;;5,0;29,0;1,0;;6,0;22,0;;3,0;;4,0;;;2,0;;;;;19,0;;7,0;;;2,0;11,0;4,0;;4,0;17,0;;1,0;;;;12,0;;;;5,0;4,0;;14,0;;;17,0;7,0;1,0;31,0;;;2,0;1,0;;10,0;;21,0;;;13,0;2,0;3,0;;2,0;10,0;88,0;;11,0;2,0;1,0;;;3,0;;25,0;;8,0;;6,0;;;;3,0;;1,0;4,0;;;;;12,0;;12,0;2,0;;;;2,0;2,0;;;6,0;;9,0;17,0;29,0;1,0;;;3,0;1,0;;;8,0;;;1,0;6,0;;;12,0;;;4,0;8,0;2,0;2,0;;9,0;;2,0;;;1,0;6,0;;;;;6,0;5,0;;;4,0;10,0;4,0;6,0;;1,0;;10,0;;6,0;2,0;;;;;9,0;;;;;3,0;1,0;6,0;1,0;4,0;3,0;2,0;1,0;1,0;9,0;;;3,0;;;;1,0;2,0;;;17,0;;;;;;3,0;10,0;;;8,0;9,0;;;;;;;;18,0;2,0;2,0;1,0;;2,0;;7,0;;3,0;11,0;;;12,0;5,0;9,0;;;1,0;2,0;;;3,0;;;;;1,0;;;;2,0;;;1,0;;6,0;;;;;;2,0;;;;;;;;1,0;1,0;;;;;;5,0;5,0;;;2,0;;;;;3,0;;;;6,0;;;;12,0;;;;;;;;;;;;;;;;;;2,0;;;;;;;;;;1,0;;3,0;13,0;;11,0;;;;;;;;;;;;;;1,0;;;;;;1,0;;;8,0;;;;;;;;;1,0;;;;;;;4,0;;;;;;;;;;;;;;;;;2,0;;17,0;;;;2,0;;;;;;;;;;;;;;;;;;;17,0;;;;;;;;4,0;;;;;;;;;2,0;;;;;;;;;;;;;1,0;;;;;;10,0;;1,0;;;;;3,0;;;;;1,0;1,0;;;;;;;2,0;;;;;;12,0;;;;;;;;;;;;;;;;;;;;;;;;;;;;;;;;;;;;;;2,0;4,0;;3,0;;;;2,0;;;;;;1,0;;;;;;;;1,0;;;;;;;1,0;;;;;1,0;;2,0;;3,0;3,0;;4,0;;;;;1,0;;;;12,0;;;;;;9,0;;;;;;20,0;;1,0;;3,0;;;;;;;;;;;;1,0;;;2,0;;;2,0;;;4,0;;;3,0;;;;;;;;;;;;;;;;;3,0;1,0;;;4,0;;;2,0;;;;;;;;;;;;;;;;;;;1,0;;;;;;;;;;;;4,0;;;;;;;;;;;;;;;;;;;;;;;2,0;;;;;;6,0;;;;;;;;;;;;;;;;;;;;;;;;;;;;;;;;;;;;;;;;;;;;1,0;;;;;;;;;;;;;;;;;;;;;2,0;;;;;;;3,0;1,0;;1,0;;;;;;;;;;;;7,0;;;;;;6,0;;;;2,0;;;;;;;;;;;;;;;1,0;;;1,0;;;2,0;;;;;;;;;;;;;;;;3,0;;;;;;3,0;2,0;;;;;;;;;;;;;;;;;;;;;
perpendicular;;2,0;;;3,0;15,0;4,0;21,0;5,0;27,0;10,0;;;;794,0;31,0;29,0;1,0;;2,0;;2,0;3,0;6,0;;;8,0;2,0;;1,0;;14,0;4,0;;5,0;;;10,0;;1,0;3,0;;20,0;2,0;1,0;;9,0;30,0;;13,0;12,0;11,0;;1,0;44,0;24,0;38,0;;8,0;;103,0;1,0;3,0;;8,0;;2,0;27,0;6,0;10,0;1,0;;6,0;;;4,0;;3,0;;79,0;1,0;39,0;;19,0;1,0;;;;5,0;8,0;143,0;;;6,0;1,0;;1,0;;26,0;3,0;2,0;;32,0;4,0;1,0;1,0;462,0;7,0;;;9,0;1,0;;;;11,0;55,0;57,0;;5,0;3,0;8,0;;2,0;4,0;;;;;3,0;;43,0;19,0;;;;4,0;3,0;;;;;;19,0;;;;44,0;;2,0;2,0;3,0;;;2,0;;51,0;;22,0;2,0;1,0;;122,0;;;;;39,0;;3,0;33,0;;;3,0;44,0;;17,0;24,0;;1,0;4,0;27,0;;3,0;13,0;1,0;;21,0;;;;;;4,0;;9,0;;;;3,0;6,0;2,0;;692,0;3,0;9,0;11,0;;;50,0;;3,0;24,0;1,0;;;12,0;;6,0;10,0;15,0;10,0;3,0;;;;8,0;2,0;82,0;;51,0;2,0;5,0;17,0;35,0;121,0;65,0;16,0;1,0;8,0;2,0;9,0;4,0;25,0;;;;1,0;3,0;246,0;33,0;;2,0;;;;46,0;7,0;2,0;;5,0;;1,0;;1,0;4,0;2,0;5,0;2,0;;13,0;1,0;4,0;;;8,0;;8,0;18,0;115,0;;;1,0;;;56,0;;1,0;;;1,0;19,0;;;15,0;;1,0;2,0;7,0;4,0;6,0;1,0;8,0;9,0;;;3,0;6,0;18,0;3,0;;21,0;1,0;4,0;3,0;;;2,0;2,0;;;;2,0;4,0;15,0;;6,0;4,0;;2,0;22,0;;8,0;1,0;2,0;;5,0;19,0;6,0;5,0;4,0;2,0;1,0;;;;4,0;1,0;25,0;2,0;;;2,0;13,0;6,0;10,0;4,0;38,0;;1,0;5,0;8,0;;8,0;7,0;2,0;;3,0;8,0;;;;1,0;;2,0;10,0;3,0;5,0;20,0;22,0;3,0;1,0;10,0;33,0;;1,0;2,0;2,0;;41,0;;;2,0;2,0;4,0;;6,0;15,0;4,0;;;3,0;;;;;;;;;1,0;;2,0;2,0;1,0;;2,0;;;;;;2,0;;;;;6,0;;;;;;4,0;7,0;;;1,0;;;;7,0;24,0;;;3,0;2,0;;6,0;;1,0;;;;;;;;1,0;;6,0;;;;5,0;;;;;;;4,0;;;2,0;;22,0;1,0;;;14,0;11,0;;35,0;15,0;;;;4,0;1,0;;;;;2,0;;;;;;7,0;;;8,0;;;29,0;;;;;3,0;14,0;;;;1,0;;7,0;;;;1,0;1,0;1,0;;;4,0;;;;;2,0;9,0;;;;;;4,0;;9,0;;;;;;;1,0;;;;;2,0;;2,0;;;25,0;2,0;1,0;3,0;;2,0;1,0;;1,0;1,0;;;;;1,0;;3,0;;;;;;15,0;;;;;2,0;;;6,0;;;;;;;1,0;;;1,0;;14,0;;;;;4,0;;1,0;;;;;4,0;;;;2,0;;;;;;;;;;8,0;;;;;3,0;;;;;;7,0;;;;2,0;;;;;7,0;5,0;7,0;3,0;;;;;5,0;5,0;;;;;4,0;;;;;1,0;;12,0;;1,0;1,0;7,0;;;;2,0;2,0;1,0;5,0;1,0;4,0;1,0;3,0;3,0;;49,0;;;2,0;;;2,0;1,0;;;9,0;5,0;;;;;;;;1,0;2,0;1,0;;;;2,0;;;17,0;;;1,0;;;3,0;3,0;1,0;;;;10,0;;;5,0;;;;;;;;1,0;;;;;;;1,0;;;;3,0;;;;;;;2,0;3,0;3,0;;;;;;;;;;;;;2,0;;12,0;;;;;;;;2,0;;;;;;;1,0;;;;;;1,0;;;;;;24,0;;;8,0;;2,0;;1,0;;14,0;;3,0;1,0;;;;;;;;;;;;;;;;;;;;3,0;;2,0;;;1,0;;4,0;1,0;;2,0;;;;3,0;;4,0;;;;;;;;;;;;;;;;;;;;;;;17,0;;;1,0;;1,0;6,0;;;;1,0;4,0;;;;;;;;;;;;5,0;;2,0;2,0;;;;;;;;;;1,0;1,0;8,0;;;2,0;;;;4,0;1,0;1,0;2,0;;2,0;;4,0;1,0;5,0;7,0;;;;;;1,0;;3,0;;;1,0;;2,0;;;;4,0;4,0;;;;;;;1,0;;;;1,0;8,0;1,0;;;;;;;;;;;;;;2,0;;;;;;;;1,0;;;;;;;;;2,0;;;;;;;;1,0;;;;;
phase;;24,0;;;1,0;12,0;;30,0;3,0;5,0;4,0;;24,0;1,0;5,0;48,0;1,0;;4,0;6,0;10,0;24,0;2,0;2,0;;;4,0;2,0;;1,0;;7,0;19,0;;74,0;10,0;72,0;23,0;;;58,0;4,0;3,0;6,0;28,0;84,0;37,0;68,0;5,0;28,0;7,0;11,0;;;79,0;;93,0;;1,0;;2,0;3,0;4,0;;10,0;7,0;24,0;19,0;35,0;1,0;7,0;2,0;23,0;5,0;;4,0;1,0;4,0;7,0;113,0;;18,0;;71,0;;;;;;4,0;18,0;;3,0;;16,0;;;;74,0;2,0;1,0;1,0;;16,0;;1,0;24,0;3,0;83,0;5,0;1,0;32,0;;;1,0;50,0;2,0;55,0;7,0;23,0;;;16,0;15,0;12,0;;2,0;2,0;3,0;6,0;;57,0;26,0;;2,0;11,0;7,0;12,0;11,0;;12,0;;1,0;57,0;6,0;;;1,0;224,0;;;2,0;;4,0;6,0;10,0;29,0;;;73,0;1,0;14,0;133,0;;7,0;;6,0;2,0;;3,0;;1,0;;7,0;52,0;11,0;;;;;;29,0;;;23,0;94,0;;6,0;1,0;;;;;3,0;;13,0;;;;2,0;;;178,0;11,0;2,0;;;;6,0;;;;20,0;6,0;;;;;;1,0;4,0;2,0;;3,0;;;;;38,0;;2,0;;13,0;56,0;2,0;12,0;15,0;1,0;2,0;;3,0;;;5,0;;;4,0;;56,0;;28,0;15,0;;;;79,0;20,0;2,0;;;;;;18,0;;;;;16,0;;;4,0;19,0;;1,0;;;;;1,0;28,0;67,0;;;;65,0;;;10,0;;;;10,0;;;;;;;;2,0;4,0;1,0;;;;;;;;;15,0;4,0;2,0;;10,0;;;;;;;;;51,0;;3,0;;;;;;;;;8,0;;;4,0;;;;24,0;3,0;;1,0;11,0;3,0;;28,0;;;;5,0;;;;11,0;2,0;3,0;;2,0;;;;;;;;1,0;1,0;;;;2,0;;;;111,0;4,0;;;;37,0;;62,0;;;1,0;;;6,0;;;;18,0;;;;;3,0;;;1,0;;;29,0;;13,0;12,0;49,0;10,0;11,0;;4,0;1,0;;27,0;;;7,0;;11,0;2,0;;;1,0;;;;;17,0;48,0;1,0;3,0;1,0;5,0;11,0;39,0;4,0;2,0;6,0;9,0;;1,0;40,0;8,0;1,0;1,0;25,0;6,0;;;;20,0;5,0;;4,0;;;6,0;2,0;;6,0;;;;;;1,0;;;2,0;;;1,0;;;20,0;;44,0;;7,0;;3,0;10,0;;;;;;2,0;;;9,0;;;;;;1,0;;;1,0;;;21,0;1,0;43,0;;5,0;;;;;;;;;;9,0;1,0;1,0;6,0;;;;;;;;11,0;;;;;10,0;;;5,0;;;;;;;;;;2,0;4,0;;8,0;;;1,0;;;;;;13,0;;1,0;1,0;;;;;3,0;33,0;2,0;;;;;;;;;;;;;;;;;;;;;;;;3,0;;;;;2,0;;;;7,0;11,0;;;;;;;4,0;;;;;;;;;4,0;;;;;1,0;;;;5,0;;;;;;;;;;;;1,0;17,0;;6,0;;;;;1,0;;;;;;;1,0;;;;138,0;;;10,0;1,0;2,0;20,0;;;4,0;;;1,0;;1,0;;;;;;;2,0;;;6,0;;;83,0;2,0;8,0;;;;;;;2,0;;;;;;;;120,0;2,0;1,0;;;;;;;;;1,0;;16,0;;;;;;;3,0;;1,0;;;;8,0;1,0;;6,0;1,0;;;;;;1,0;;1,0;;;;6,0;;;;;2,0;;;;;;11,0;2,0;;;;3,0;;;;;;;;8,0;;;;;2,0;;;;1,0;;2,0;1,0;;3,0;29,0;;;5,0;;;;;;;;1,0;;;;;3,0;11,0;;;;;;3,0;;;;;;;;;;;;;;8,0;90,0;;;1,0;;;;11,0;;;5,0;5,0;;1,0;;4,0;;1,0;;2,0;;;;;;14,0;1,0;;;;32,0;;;;;;;;;;5,0;;;;;;;;;;;;;8,0;;;;;;;;;;3,0;;;;;5,0;;;;;;;;;;;;;;;;;;;;;;1,0;;7,0;;3,0;4,0;;;;;;;;1,0;;;4,0;;3,0;;;;5,0;;;;;;;1,0;;;;;;;;;1,0;;;;;;;;13,0;;;1,0;;;3,0;2,0;;;;;1,0;;;;12,0;;;;;;;;;;;;;;;;;10,0;;;;;;
photograph;;2,0;2,0;;2,0;63,0;19,0;183,0;127,0;5,0;;;5,0;;133,0;96,0;12,0;2,0;7,0;;42,0;113,0;12,0;;;;65,0;;;3,0;36,0;23,0;90,0;34,0;187,0;23,0;11,0;14,0;27,0;7,0;60,0;;17,0;4,0;106,0;44,0;55,0;206,0;136,0;170,0;11,0;61,0;8,0;11,0;12,0;8,0;24,0;2,0;7,0;;3,0;11,0;15,0;6,0;32,0;37,0;110,0;58,0;39,0;10,0;17,0;104,0;63,0;2,0;;55,0;19,0;36,0;97,0;1048,0;;91,0;;128,0;7,0;55,0;2,0;4,0;2,0;25,0;370,0;;;3,0;;5,0;16,0;;224,0;5,0;3,0;23,0;99,0;253,0;5,0;6,0;494,0;10,0;58,0;15,0;11,0;111,0;;7,0;;164,0;48,0;244,0;5,0;62,0;3,0;;9,0;58,0;12,0;5,0;1,0;5,0;2,0;20,0;2,0;19,0;8,0;5,0;15,0;1,0;5,0;14,0;8,0;1,0;76,0;;5,0;54,0;44,0;;;15,0;139,0;16,0;11,0;1,0;15,0;64,0;167,0;1,0;367,0;;14,0;13,0;6,0;47,0;440,0;;2,0;;15,0;56,0;17,0;7,0;10,0;;;3,0;26,0;4,0;8,0;8,0;7,0;3,0;;21,0;;;1,0;6,0;;5,0;9,0;;1,0;;2,0;1,0;6,0;1,0;3,0;1,0;1,0;4,0;;;5,0;101,0;;;3,0;;14,0;13,0;1,0;7,0;;;;;5,0;1,0;;;5,0;27,0;;;;;5,0;;221,0;;55,0;;37,0;11,0;14,0;38,0;19,0;14,0;;1,0;6,0;;;78,0;1,0;;;;27,0;21,0;10,0;;;8,0;;2,0;62,0;28,0;;;;;2,0;87,0;;7,0;7,0;;26,0;;1,0;44,0;4,0;;3,0;;30,0;4,0;;35,0;33,0;;6,0;;;133,0;;1,0;;4,0;22,0;2,0;2,0;;;6,0;;;;;3,0;10,0;11,0;;2,0;;;2,0;;;;28,0;4,0;3,0;4,0;1,0;;;1,0;;20,0;2,0;;;12,0;;3,0;;1,0;6,0;;;;;;;;23,0;6,0;;;;10,0;1,0;2,0;3,0;5,0;4,0;8,0;29,0;1,0;8,0;3,0;16,0;;;3,0;51,0;3,0;1,0;;17,0;;1,0;;;;14,0;;12,0;1,0;3,0;3,0;;;;2,0;;32,0;17,0;;;13,0;;24,0;1,0;;;;6,0;4,0;60,0;33,0;4,0;;3,0;;;1,0;;;1,0;;2,0;13,0;;;;11,0;20,0;37,0;;24,0;1,0;3,0;2,0;2,0;38,0;6,0;;;3,0;7,0;2,0;;;;40,0;;1,0;;52,0;1,0;;59,0;;2,0;5,0;293,0;;4,0;8,0;77,0;;15,0;10,0;127,0;1,0;19,0;16,0;52,0;;3,0;4,0;11,0;28,0;10,0;;;3,0;4,0;;;12,0;;2,0;;;1,0;34,0;7,0;8,0;;;41,0;;10,0;;;1,0;47,0;4,0;1,0;27,0;5,0;;1,0;;;9,0;;;5,0;25,0;3,0;5,0;;;7,0;5,0;4,0;;;;37,0;2,0;13,0;;2,0;;2,0;14,0;;;1,0;2,0;2,0;;3,0;4,0;5,0;3,0;3,0;8,0;;;3,0;;18,0;1,0;;4,0;;3,0;2,0;1,0;38,0;3,0;11,0;9,0;15,0;;;;19,0;1,0;4,0;4,0;32,0;23,0;1,0;;;6,0;;;4,0;;;1,0;2,0;2,0;;19,0;;4,0;3,0;6,0;;4,0;9,0;6,0;8,0;;;14,0;;;;;;;13,0;;12,0;2,0;;;3,0;;9,0;6,0;9,0;1,0;;3,0;2,0;8,0;14,0;;22,0;;;6,0;;3,0;1,0;;;;1,0;4,0;;;;1,0;;4,0;;;;2,0;;6,0;5,0;;45,0;;;1,0;;;;3,0;12,0;3,0;7,0;;4,0;;2,0;2,0;3,0;;6,0;11,0;;1,0;15,0;;2,0;5,0;4,0;4,0;4,0;1,0;2,0;4,0;;;;;;1,0;10,0;;;;2,0;7,0;;;22,0;;6,0;;;;;;;3,0;;1,0;;3,0;6,0;;;;;;;;;1,0;;;19,0;;;4,0;;;;1,0;20,0;6,0;;;;2,0;3,0;2,0;;3,0;;;1,0;;;;;1,0;;;;;1,0;1,0;;;;6,0;21,0;;;3,0;;;3,0;;6,0;3,0;;;;11,0;;9,0;;7,0;;;;;;1,0;2,0;3,0;3,0;;;;2,0;4,0;2,0;;;8,0;;;1,0;31,0;;1,0;;;;2,0;;9,0;;;12,0;6,0;2,0;;2,0;;2,0;;;2,0;;;;8,0;;6,0;2,0;2,0;7,0;1,0;;10,0;3,0;;4,0;1,0;2,0;;;2,0;;;;1,0;;;14,0;;1,0;4,0;;;;;3,0;;;9,0;;81,0;;8,0;;6,0;;;;;;;;1,0;;12,0;;;1,0;5,0;1,0;;;;;;;;;;;;;;1,0;4,0;;;15,0;10,0;3,0;;;;1,0;2,0;1,0;;;;;;1,0;12,0;;;;;1,0;;;;;;;;;;1,0;;;;;;1,0;4,0;2,0;;2,0;2,0;;;;9,0;;;;;;;4,0;1,0;;;;;2,0;3,0;1,0;;2,0;8,0;;;;;;;;1,0;7,0;7,0;9,0;;;;;1,0;;;4,0;;;;;;;;;;;5,0;3,0;;;4,0;;;;;1,0;2,0;;2,0;3,0;2,0;;;1,0;3,0;;;;;;3,0;;;3,0;;4,0;;2,0;;;;1,0;
photographic;;4,0;;1,0;;5,0;23,0;80,0;47,0;3,0;;;14,0;;15,0;124,0;;5,0;12,0;;2,0;80,0;3,0;;;2,0;6,0;9,0;;;2,0;51,0;55,0;;38,0;8,0;2,0;;11,0;;33,0;3,0;;1,0;63,0;31,0;44,0;124,0;66,0;38,0;19,0;14,0;2,0;7,0;2,0;15,0;37,0;1,0;4,0;;2,0;;20,0;4,0;1,0;49,0;28,0;27,0;4,0;2,0;9,0;14,0;11,0;3,0;;16,0;8,0;20,0;15,0;660,0;3,0;71,0;1,0;95,0;13,0;;17,0;8,0;;41,0;256,0;;4,0;1,0;;7,0;6,0;2,0;71,0;;16,0;3,0;3,0;87,0;4,0;;189,0;7,0;18,0;53,0;13,0;25,0;;;;73,0;40,0;127,0;;6,0;;1,0;;15,0;6,0;1,0;;7,0;;43,0;;;8,0;;22,0;2,0;4,0;8,0;;;60,0;;1,0;27,0;27,0;;;41,0;22,0;37,0;3,0;1,0;11,0;24,0;244,0;;214,0;;;;2,0;14,0;184,0;;5,0;;99,0;;1,0;1,0;23,0;;;6,0;16,0;8,0;;5,0;2,0;;;25,0;;;;1,0;;1,0;;;1,0;;;8,0;;1,0;;;;7,0;;1,0;15,0;2,0;;;2,0;;54,0;15,0;45,0;;;;;;;;4,0;11,0;14,0;2,0;;;3,0;;;;144,0;;10,0;;34,0;20,0;4,0;14,0;4,0;11,0;;6,0;4,0;;1,0;46,0;6,0;;6,0;;20,0;3,0;;;;;3,0;;71,0;22,0;5,0;;;;;8,0;;2,0;9,0;;6,0;;1,0;5,0;9,0;;;;10,0;9,0;;7,0;;;;;;27,0;;6,0;;;3,0;;34,0;;14,0;;;;;;;4,0;9,0;1,0;;;;8,0;;;;;3,0;;9,0;10,0;;;;1,0;;4,0;4,0;;;;2,0;1,0;5,0;21,0;;1,0;;;;1,0;1,0;15,0;10,0;;;;13,0;;2,0;;20,0;;;;12,0;1,0;53,0;14,0;;;;25,0;2,0;;;8,0;9,0;;;;;1,0;;4,0;;2,0;1,0;;3,0;;5,0;;2,0;1,0;5,0;;;;;;;;;5,0;;4,0;;;;5,0;;1,0;;;4,0;;1,0;6,0;;;;;3,0;18,0;18,0;;2,0;;3,0;2,0;;6,0;;2,0;;;1,0;36,0;;;;9,0;;;2,0;26,0;2,0;;20,0;5,0;;1,0;39,0;;11,0;7,0;16,0;;2,0;4,0;18,0;49,0;10,0;2,0;;3,0;;;3,0;8,0;10,0;;;;;;2,0;5,0;;;;;13,0;3,0;;5,0;;1,0;55,0;;;;;;34,0;;;7,0;;;4,0;;1,0;104,0;;1,0;;2,0;;1,0;1,0;1,0;1,0;9,0;1,0;;;52,0;3,0;2,0;14,0;;10,0;;2,0;3,0;;;;1,0;;;14,0;;1,0;3,0;9,0;10,0;;3,0;;1,0;;;;;;1,0;;;38,0;;1,0;;;1,0;;;;3,0;1,0;;12,0;3,0;;;1,0;;;;;;;;;4,0;;3,0;;50,0;;;;15,0;4,0;;2,0;;13,0;;;;;;1,0;;1,0;;8,0;3,0;;;;;;2,0;;4,0;;;1,0;1,0;;;8,0;;1,0;;;21,0;;;;;2,0;6,0;6,0;;;;;14,0;;1,0;;;;2,0;1,0;;37,0;;;19,0;;;;;;6,0;;;;;;;;1,0;;;;1,0;;;;;;6,0;1,0;;3,0;;;;1,0;;;;9,0;8,0;;1,0;3,0;47,0;;;12,0;;5,0;12,0;;1,0;;;;;3,0;1,0;;;;;;;;;;;;;;;;;;;;;;1,0;;8,0;;4,0;;;;3,0;;1,0;;;;;;;;;1,0;1,0;;;;;;;;;2,0;;1,0;4,0;;4,0;;;;;;;;5,0;;;;;;;;;4,0;1,0;1,0;;;;;;;1,0;7,0;;;1,0;;;8,0;9,0;;;;1,0;;;;;;;1,0;;;;11,0;;1,0;;;3,0;;;;2,0;;8,0;;;;1,0;;4,0;6,0;;;1,0;30,0;;;;;;;;;;;;8,0;3,0;;;;;3,0;;4,0;2,0;11,0;18,0;;1,0;;;;;;;;1,0;;;;7,0;;;;;;;;;;;;1,0;;;;;;4,0;;2,0;;;;;4,0;;;1,0;9,0;;;;;;2,0;;;5,0;;1,0;;;5,0;;1,0;;;;;;7,0;;4,0;;;1,0;;;;;;;;;;;;;;;;;;;;;;;;;4,0;;2,0;;3,0;;;;;9,0;;;;1,0;;;;;;;1,0;;;;12,0;4,0;;;;;;;1,0;;;;4,0;;;;;;;;;;;;2,0;;;;;;2,0;3,0;;;;1,0;;;;;;6,0;;;;;2,0;
pickup;;2,0;5,0;4,0;;4,0;2,0;421,0;30,0;33,0;2,0;;1,0;;31,0;35,0;;;6,0;;;43,0;6,0;4,0;;7,0;19,0;1,0;;1,0;2,0;3,0;76,0;23,0;97,0;16,0;3,0;8,0;2,0;1,0;175,0;;7,0;1,0;22,0;13,0;6,0;719,0;10,0;27,0;14,0;40,0;1,0;6,0;67,0;3,0;506,0;;;;5,0;4,0;2,0;;12,0;2,0;34,0;55,0;6,0;10,0;4,0;3,0;128,0;;;5,0;2,0;;7,0;2782,0;2,0;33,0;;189,0;7,0;25,0;13,0;;;1,0;333,0;;2,0;3,0;6,0;4,0;12,0;;74,0;;;;62,0;62,0;1,0;14,0;309,0;1,0;50,0;4,0;10,0;39,0;3,0;38,0;2,0;95,0;54,0;92,0;12,0;57,0;1,0;;4,0;81,0;10,0;1,0;30,0;;1,0;9,0;1,0;39,0;22,0;;;2,0;1,0;;;3,0;;;28,0;44,0;20,0;2,0;;48,0;158,0;10,0;5,0;1,0;10,0;12,0;55,0;14,0;278,0;;14,0;6,0;3,0;2,0;422,0;2,0;5,0;;5,0;6,0;;1,0;7,0;;2,0;;27,0;9,0;;21,0;1,0;;13,0;44,0;1,0;;8,0;70,0;;;2,0;;1,0;;4,0;12,0;;14,0;;;6,0;24,0;;;5,0;76,0;;1,0;4,0;;33,0;28,0;16,0;;2,0;6,0;;;2,0;3,0;2,0;5,0;34,0;11,0;2,0;3,0;;;16,0;;90,0;26,0;38,0;7,0;;38,0;7,0;24,0;7,0;18,0;5,0;2,0;3,0;6,0;;43,0;5,0;2,0;15,0;;195,0;36,0;4,0;;;;;1,0;29,0;;1,0;1,0;;10,0;1,0;10,0;9,0;10,0;6,0;;12,0;4,0;;20,0;3,0;4,0;2,0;1,0;19,0;7,0;64,0;72,0;4,0;9,0;4,0;2,0;;82,0;;4,0;;10,0;12,0;6,0;10,0;2,0;13,0;3,0;;;7,0;13,0;12,0;6,0;20,0;;;;6,0;1,0;3,0;;;9,0;23,0;;5,0;1,0;;15,0;;;;3,0;2,0;;76,0;;6,0;2,0;1,0;3,0;;1,0;;;;;;21,0;18,0;6,0;;;;16,0;;;3,0;;11,0;2,0;1,0;13,0;;;;;2,0;6,0;;;;;5,0;8,0;1,0;;;25,0;32,0;;1,0;2,0;;;;;;;14,0;;4,0;;;;2,0;13,0;;;;12,0;1,0;5,0;8,0;5,0;;6,0;;;;;2,0;;;6,0;;2,0;;;11,0;6,0;18,0;1,0;;;;4,0;1,0;8,0;1,0;;;;;4,0;;;2,0;;;;;6,0;10,0;;;;;2,0;35,0;;1,0;5,0;13,0;;;7,0;59,0;;;20,0;14,0;4,0;;;2,0;11,0;;;;;1,0;1,0;51,0;13,0;;;;;1,0;4,0;;;;;;1,0;1,0;;5,0;;15,0;3,0;;;6,0;9,0;4,0;;;2,0;1,0;;;13,0;;2,0;;;1,0;;8,0;;;16,0;2,0;3,0;14,0;;13,0;;4,0;4,0;;;;;;;5,0;3,0;18,0;;1,0;11,0;;;;;;1,0;;4,0;2,0;9,0;3,0;;12,0;;;1,0;;;;3,0;;5,0;5,0;;;;;;;;2,0;18,0;;2,0;;;;16,0;8,0;4,0;;;2,0;12,0;;;36,0;;8,0;;;;;;;;;;;4,0;10,0;3,0;;;;;;;;;;;1,0;8,0;1,0;;9,0;;;;;2,0;;;;;;;;;;;;;;;1,0;;1,0;;;1,0;35,0;3,0;;1,0;6,0;;;;;;1,0;;;;;;;;;;;;1,0;1,0;;;1,0;6,0;;4,0;;;4,0;;;1,0;;;20,0;;;4,0;24,0;4,0;10,0;;7,0;;3,0;;;;;;;;;;;;;;8,0;;;;;;;;;5,0;;;;;;;;;4,0;;;;;1,0;;1,0;;;;;;;5,0;5,0;;;;2,0;5,0;4,0;;;;;;;2,0;;;1,0;;4,0;1,0;3,0;2,0;5,0;;4,0;;1,0;10,0;;;;;;;4,0;;1,0;11,0;9,0;;2,0;2,0;;;2,0;2,0;3,0;;;2,0;8,0;5,0;;1,0;;1,0;;5,0;2,0;;;;;7,0;3,0;2,0;;2,0;;4,0;;14,0;1,0;;1,0;;3,0;;1,0;2,0;3,0;2,0;18,0;;;;;;;10,0;3,0;;2,0;;;;;1,0;;;;;;13,0;;;1,0;1,0;;;1,0;;;;;;;1,0;;;;;;;;;;;21,0;;;;;;;;1,0;;;;;;;;;;;;;;;18,0;;;;;;;;;;1,0;;;;;;;;;;;;4,0;;;;1,0;;;;;;;;;;;;;;;;;;1,0;;;;5,0;;;1,0;;1,0;;9,0;3,0;;1,0;2,0;;;4,0;;;;;;;;;;;1,0;;;1,0;;;;2,0;7,0;1,0;;;;;3,0;;;;2,0;;;;;1,0;;;;;;2,0;;;;;1,0;;5,0;;;;;;;;2,0;;1,0;;;;;;;;
pivot;;4,0;;;;29,0;3,0;18,0;;19,0;;;3,0;;158,0;34,0;4,0;;;;10,0;5,0;1,0;8,0;1,0;;;;;2,0;;2,0;30,0;;6,0;2,0;;;;;;;14,0;;;;2,0;93,0;4,0;3,0;15,0;20,0;;;50,0;8,0;273,0;;;;13,0;;;;20,0;3,0;2,0;24,0;15,0;17,0;;;2,0;;;1,0;;1,0;;12,0;;9,0;;92,0;;;;;1,0;13,0;23,0;;;;;;;;10,0;21,0;;;13,0;4,0;;4,0;17,0;;1,0;;21,0;2,0;3,0;;;8,0;46,0;97,0;1,0;;4,0;;;;4,0;;;;3,0;1,0;;;30,0;;;;21,0;;;;;;;13,0;2,0;;;24,0;4,0;;;;;;1,0;;41,0;;19,0;;1,0;;45,0;;1,0;;3,0;3,0;;;1,0;;;8,0;;2,0;61,0;7,0;;;2,0;33,0;;1,0;;1,0;;7,0;;;;3,0;;78,0;;1,0;;1,0;;2,0;3,0;3,0;;14,0;;;1,0;;;7,0;;;12,0;;;;7,0;1,0;1,0;35,0;59,0;;10,0;3,0;;54,0;;48,0;9,0;;136,0;;71,0;63,0;21,0;18,0;22,0;16,0;11,0;3,0;1,0;4,0;1,0;5,0;;;;;;10,0;46,0;;3,0;1,0;;;25,0;1,0;;;;;9,0;6,0;;;10,0;2,0;19,0;;16,0;1,0;14,0;;;3,0;;14,0;;16,0;;;;;;;1,0;;;;15,0;13,0;1,0;;7,0;;11,0;3,0;9,0;2,0;12,0;33,0;47,0;;173,0;2,0;3,0;6,0;6,0;;;3,0;;;8,0;;;11,0;;33,0;;1,0;;1,0;1,0;;7,0;3,0;;;2,0;2,0;;;;;;15,0;;13,0;;;6,0;;4,0;9,0;15,0;15,0;12,0;1,0;;10,0;1,0;;4,0;;7,0;66,0;2,0;6,0;;;5,0;5,0;1,0;;;9,0;18,0;9,0;;6,0;2,0;;;13,0;4,0;11,0;44,0;42,0;5,0;10,0;4,0;43,0;;16,0;9,0;11,0;;118,0;3,0;10,0;1,0;3,0;10,0;;9,0;;;;;;;10,0;;;;9,0;1,0;;6,0;;;;2,0;;2,0;;;;;2,0;;;;;;;;;;;15,0;6,0;4,0;;3,0;;2,0;;;2,0;18,0;2,0;;5,0;3,0;;;;;;;;1,0;;2,0;;;;;;;;5,0;1,0;;2,0;;3,0;;;1,0;;10,0;;;6,0;1,0;;31,0;11,0;;3,0;;;;;;1,0;;;;;;9,0;3,0;;;;48,0;;;;;;;;;;;2,0;;;;;;;;;;1,0;;2,0;;;;2,0;;3,0;;;1,0;3,0;;5,0;;;1,0;;;6,0;;;;;;;2,0;;;1,0;3,0;;;4,0;;;5,0;4,0;;2,0;4,0;;;;;1,0;;;;;5,0;2,0;;5,0;;6,0;;;;;;2,0;2,0;;;;13,0;;;;;2,0;;;;;;;44,0;;;;;10,0;;;;;;;3,0;;;;;;;;;;2,0;;;;1,0;;;;;2,0;;;;;;1,0;;;;8,0;1,0;;;;;3,0;12,0;;;2,0;1,0;;11,0;13,0;;;;3,0;2,0;;;;;;;11,0;;1,0;11,0;2,0;;;7,0;;;1,0;2,0;4,0;9,0;5,0;22,0;23,0;3,0;8,0;;2,0;5,0;;;;;;;2,0;;;1,0;;54,0;22,0;6,0;;21,0;12,0;;;1,0;160,0;7,0;;;3,0;;;;1,0;11,0;2,0;;2,0;2,0;;;;;;;3,0;;;3,0;;2,0;1,0;10,0;;;;6,0;;;14,0;;;;2,0;;;;;;;;;;;;;;;;;;1,0;;5,0;;;;;;;;;;;;;;;;;;;;;;;;;;2,0;;;;;;;;3,0;;;;;2,0;;;;;;;;;;;;;;;;8,0;;;;;;;;;;;;;;1,0;6,0;;;;;;;6,0;2,0;1,0;;;;;;;;;;;;;;;;;;;;;;;;;;;2,0;;;;20,0;;1,0;3,0;;4,0;;3,0;;;1,0;;;;;;;;;;;;;;;;;;;1,0;;;;;;;;;;3,0;;;5,0;;;2,0;;6,0;;6,0;;;;;;;;;1,0;;162,0;;;;2,0;;;1,0;;;;;8,0;4,0;;;4,0;;9,0;;;;;;;3,0;;;7,0;;;;;;;;;;;;;;;;;;;;;;;;;;;1,0;2,0;;;;;;
planar;;3,0;;;;6,0;8,0;12,0;82,0;10,0;7,0;;2,0;;5,0;14,0;19,0;;;;11,0;3,0;;2,0;;;1,0;;;;5,0;1,0;14,0;;1,0;;1,0;1,0;;;12,0;;16,0;1,0;33,0;10,0;1,0;27,0;;8,0;6,0;;;;1,0;2,0;;;3,0;;15,0;;7,0;1,0;;;1,0;13,0;11,0;11,0;;;3,0;;8,0;3,0;;;5,0;34,0;;4,0;;45,0;;15,0;1,0;;;1,0;22,0;;;3,0;3,0;;;;27,0;1,0;1,0;;13,0;16,0;;;6,0;;1,0;1,0;4,0;4,0;;;;43,0;21,0;27,0;1,0;;;;1,0;;2,0;4,0;;3,0;1,0;;;;5,0;;8,0;1,0;;30,0;;;2,0;;;17,0;2,0;;;17,0;4,0;;;1,0;;;2,0;;26,0;;;;;;3,0;;;;6,0;19,0;1,0;;;;1,0;2,0;;;5,0;;;;2,0;8,0;;4,0;;2,0;;;;2,0;;;1,0;3,0;;8,0;;;;5,0;3,0;1,0;;9,0;;;;;;21,0;;;;;26,0;;;;;3,0;9,0;;2,0;;;;6,0;;30,0;;21,0;;27,0;30,0;;;;6,0;1,0;8,0;3,0;7,0;1,0;1,0;;;;;;23,0;17,0;;;;;1,0;;6,0;1,0;2,0;;;2,0;2,0;;;1,0;1,0;;;1,0;4,0;3,0;;;;;9,0;9,0;209,0;;;;1,0;;;;1,0;;17,0;;8,0;;;6,0;;;;;;1,0;3,0;5,0;;;;;1,0;2,0;3,0;;;;;1,0;1,0;1,0;;;3,0;;;1,0;9,0;;;1,0;1,0;;;1,0;4,0;2,0;1,0;2,0;;4,0;1,0;1,0;;;;;;;;;;23,0;14,0;;5,0;;;;;;12,0;1,0;;;3,0;;;1,0;2,0;;6,0;1,0;;6,0;;;;;;24,0;;;2,0;;;;;1,0;;2,0;;2,0;1,0;;10,0;2,0;1,0;2,0;;;1,0;1,0;;;;;2,0;;;;;;3,0;;;;;37,0;;;2,0;;;;;23,0;;;;;2,0;;;;1,0;;1,0;;;4,0;;1,0;;;;1,0;;;;;;1,0;;;;;1,0;;;;;;1,0;;;;;;;;;;;1,0;;;;;;;;;;;13,0;;2,0;10,0;;1,0;;1,0;;;1,0;;14,0;;;;;;2,0;5,0;;1,0;;;;2,0;;;;;6,0;1,0;;;;;;;;;;27,0;;;;;;;1,0;;;1,0;2,0;;;;;;;;4,0;;;;;;;;;;;;1,0;;3,0;;2,0;6,0;;;1,0;1,0;;;1,0;;;;;;;4,0;;;;;;;3,0;;8,0;;;;;;;;;;;;;1,0;;;;4,0;;4,0;;;;;1,0;;;;;;;;;;;;;;;;;;;;;17,0;;;;;;;1,0;;;;;;;;;3,0;;;;2,0;;;;;;;;;;;;;;;;;;1,0;5,0;;4,0;;;;11,0;;;;;;3,0;2,0;5,0;;;;1,0;;7,0;;;;;2,0;2,0;1,0;;;5,0;;;2,0;;;;;;;;;2,0;10,0;;;;;2,0;;;2,0;;;;;;;;;7,0;;;;6,0;;;;;2,0;;;;;;;;;1,0;;1,0;;1,0;;;;;;;;3,0;1,0;;;;;;;;;;;;;;;1,0;;1,0;;;;3,0;;1,0;;;;;;;;;1,0;;2,0;;;;;;;;1,0;;;;;;;1,0;;;;;;;;;;;;;;;;;;;;;3,0;;;;;;;;;1,0;;2,0;;;;;1,0;;;1,0;;;;;;;1,0;2,0;;;;;4,0;;;;;;;;;;;;;;;;;;;;;;;2,0;;;;;;1,0;;;;;;;3,0;;;;;;;;;;6,0;2,0;;;;;;;;;1,0;1,0;;1,0;;;;;;;1,0;;;;;;;;4,0;;;;;;;;;;;;3,0;;2,0;;;2,0;;;2,0;1,0;14,0;;6,0;;;;;;;;;;;;;;;;;;;;;;;;;;;;;10,0;1,0;;;;;1,0;;;;1,0;;;;
plane;;2,0;;1,0;;99,0;23,0;31,0;57,0;51,0;170,0;1,0;18,0;;318,0;128,0;72,0;5,0;;3,0;37,0;60,0;3,0;10,0;1,0;;7,0;4,0;;2,0;3,0;2,0;57,0;;12,0;2,0;6,0;16,0;5,0;;58,0;1,0;176,0;14,0;51,0;49,0;83,0;67,0;35,0;43,0;74,0;112,0;30,0;10,0;36,0;9,0;66,0;1,0;46,0;2,0;97,0;;37,0;;9,0;403,0;105,0;113,0;34,0;43,0;2,0;8,0;27,0;;;26,0;9,0;9,0;28,0;795,0;38,0;105,0;3,0;145,0;5,0;3,0;4,0;;5,0;18,0;335,0;;;4,0;;4,0;4,0;;132,0;2,0;16,0;;51,0;135,0;50,0;3,0;313,0;3,0;22,0;10,0;13,0;8,0;2,0;1,0;;173,0;111,0;215,0;8,0;25,0;;1,0;2,0;9,0;20,0;5,0;;2,0;16,0;37,0;;155,0;61,0;5,0;15,0;10,0;23,0;5,0;14,0;;76,0;;;109,0;8,0;2,0;;91,0;12,0;6,0;8,0;12,0;1,0;2,0;24,0;1,0;135,0;;55,0;;7,0;7,0;70,0;1,0;5,0;;14,0;55,0;11,0;8,0;12,0;1,0;1,0;27,0;12,0;9,0;26,0;26,0;6,0;;13,0;30,0;1,0;;2,0;11,0;;47,0;;;;;;11,0;1,0;47,0;;2,0;;41,0;4,0;3,0;6,0;194,0;3,0;3,0;2,0;3,0;6,0;51,0;13,0;10,0;4,0;;4,0;;4,0;1,0;22,0;4,0;28,0;5,0;7,0;;3,0;4,0;6,0;7,0;174,0;1,0;77,0;3,0;17,0;79,0;48,0;59,0;16,0;19,0;18,0;12,0;19,0;3,0;;20,0;;1,0;2,0;;90,0;;26,0;18,0;5,0;2,0;;;50,0;10,0;2,0;8,0;;;;28,0;;1,0;14,0;1,0;92,0;;6,0;30,0;31,0;3,0;;6,0;2,0;23,0;43,0;177,0;1,0;;4,0;1,0;;16,0;2,0;9,0;3,0;1,0;20,0;40,0;5,0;4,0;6,0;;;;5,0;3,0;8,0;11,0;16,0;6,0;2,0;;1,0;4,0;32,0;17,0;;18,0;;;9,0;;;;11,0;10,0;;1,0;1,0;;9,0;2,0;7,0;;;;;7,0;5,0;;;;104,0;7,0;3,0;15,0;1,0;20,0;7,0;6,0;6,0;1,0;9,0;11,0;207,0;14,0;;246,0;;36,0;1,0;10,0;7,0;189,0;8,0;;;74,0;1,0;2,0;6,0;;;5,0;1,0;2,0;1,0;1,0;;;;21,0;8,0;11,0;35,0;60,0;1,0;1,0;13,0;17,0;;15,0;10,0;4,0;9,0;71,0;;64,0;;2,0;;2,0;4,0;1,0;6,0;1,0;14,0;6,0;2,0;13,0;12,0;;;14,0;3,0;40,0;20,0;7,0;3,0;;3,0;;3,0;2,0;1,0;;1,0;;37,0;11,0;;;;18,0;;1,0;;10,0;6,0;7,0;48,0;2,0;;13,0;5,0;;3,0;37,0;35,0;;;;7,0;;33,0;;3,0;2,0;;6,0;3,0;3,0;;10,0;;8,0;9,0;5,0;1,0;;4,0;;;;5,0;18,0;3,0;6,0;;;10,0;2,0;47,0;2,0;;;21,0;24,0;;46,0;125,0;;;3,0;14,0;55,0;;4,0;3,0;10,0;2,0;1,0;1,0;3,0;8,0;6,0;14,0;;;21,0;3,0;2,0;82,0;5,0;6,0;2,0;;7,0;2,0;;;;1,0;;;;2,0;;2,0;2,0;4,0;;1,0;;;8,0;;;;6,0;;1,0;2,0;8,0;;9,0;;13,0;2,0;;;15,0;2,0;;5,0;;;;8,0;;;11,0;;;18,0;;;6,0;4,0;1,0;2,0;;;1,0;1,0;;8,0;2,0;9,0;4,0;;2,0;;9,0;;;12,0;2,0;;;1,0;5,0;;;;;;;;4,0;1,0;;;;11,0;;84,0;3,0;1,0;;12,0;17,0;;;;;;;1,0;;;;;4,0;2,0;;;;3,0;2,0;;;54,0;;;;;;;25,0;;;1,0;;;;3,0;3,0;3,0;;;1,0;;6,0;59,0;;3,0;1,0;2,0;;4,0;24,0;;1,0;4,0;;20,0;;;;3,0;9,0;;35,0;;11,0;;3,0;;;;3,0;;2,0;2,0;;3,0;;13,0;3,0;;101,0;;36,0;;;;35,0;1,0;;;34,0;23,0;;8,0;;;;4,0;;5,0;9,0;;5,0;;;7,0;;;10,0;;;5,0;;11,0;;;3,0;1,0;;5,0;13,0;1,0;;11,0;6,0;;;15,0;;3,0;;13,0;;;2,0;;;;7,0;3,0;;;68,0;5,0;;;;;;1,0;9,0;5,0;;;;;;;;2,0;;20,0;5,0;2,0;1,0;;5,0;;49,0;;;4,0;52,0;27,0;2,0;1,0;1,0;5,0;1,0;;1,0;22,0;;;2,0;2,0;6,0;;;8,0;;;;8,0;;;;2,0;5,0;2,0;2,0;;2,0;;;8,0;;;1,0;4,0;;;;3,0;2,0;3,0;;;8,0;;1,0;9,0;;1,0;;;;70,0;;3,0;5,0;1,0;;;;;4,0;;6,0;;;2,0;;;;;;;1,0;;;;;3,0;5,0;;1,0;;;11,0;;;;1,0;16,0;;;;;;3,0;;;;2,0;16,0;;;;2,0;;;;;;1,0;11,0;2,0;;3,0;2,0;;;;;1,0;;2,0;;3,0;;1,0;2,0;;;1,0;1,0;1,0;1,0;4,0;;26,0;2,0;;1,0;;;8,0;1,0;2,0;;;;;1,0;3,0;;;;;1,0;;3,0;;;;4,0;3,0;;;;1,0;;;1,0;;16,0;10,0;6,0;5,0;4,0;;1,0;;25,0;;;4,0;6,0;6,0;4,0;2,0;;;14,0;;1,0;2,0;2,0;31,0;6,0;;1,0;;2,0;2,0;1,0;9,0;3,0;;11,0;30,0;;;;;;;;;1,0;2,0;;;1,0
plate;;11,0;;1,0;2,0;15,0;84,0;79,0;21,0;64,0;1,0;1,0;15,0;;71,0;499,0;7,0;;1,0;;;18,0;1,0;8,0;;;;6,0;7,0;;1,0;9,0;72,0;;14,0;4,0;;6,0;5,0;2,0;5,0;;141,0;1,0;5,0;8,0;5,0;139,0;11,0;16,0;124,0;9,0;;;118,0;45,0;42,0;1,0;;;255,0;9,0;1,0;;32,0;13,0;3,0;188,0;58,0;173,0;7,0;4,0;5,0;;1,0;9,0;;3,0;2,0;130,0;;39,0;;256,0;5,0;;4,0;;20,0;24,0;270,0;;;28,0;1,0;1,0;;1,0;56,0;47,0;;;144,0;16,0;;8,0;88,0;;4,0;;28,0;2,0;37,0;;1,0;99,0;357,0;308,0;17,0;16,0;29,0;4,0;1,0;8,0;5,0;;;;;9,0;;10,0;43,0;8,0;;;14,0;3,0;;;;16,0;;97,0;1,0;2,0;3,0;292,0;4,0;11,0;;2,0;1,0;;1,0;7,0;55,0;;13,0;2,0;;3,0;86,0;;2,0;;1,0;4,0;;;;17,0;18,0;19,0;3,0;18,0;101,0;40,0;;;68,0;98,0;12,0;12,0;4,0;27,0;5,0;12,0;3,0;1,0;4,0;1,0;1,0;265,0;;38,0;;3,0;9,0;98,0;17,0;1,0;4,0;142,0;1,0;33,0;1,0;1,0;12,0;75,0;14,0;49,0;10,0;;33,0;;9,0;36,0;5,0;111,0;127,0;;155,0;14,0;;8,0;45,0;18,0;70,0;1,0;410,0;65,0;17,0;554,0;60,0;59,0;12,0;136,0;83,0;101,0;2,0;16,0;;6,0;28,0;;;3,0;;26,0;;5,0;33,0;8,0;7,0;;100,0;5,0;6,0;;56,0;12,0;81,0;5,0;4,0;1,0;80,0;26,0;80,0;2,0;118,0;15,0;57,0;26,0;;144,0;;10,0;45,0;447,0;2,0;;10,0;22,0;82,0;3,0;2,0;2,0;;159,0;43,0;38,0;15,0;5,0;58,0;1,0;2,0;6,0;29,0;5,0;27,0;20,0;259,0;1,0;13,0;4,0;14,0;15,0;296,0;;;15,0;16,0;1,0;22,0;5,0;1,0;80,0;3,0;62,0;12,0;1,0;11,0;7,0;37,0;3,0;78,0;36,0;;2,0;11,0;34,0;20,0;3,0;1,0;;23,0;47,0;33,0;95,0;6,0;14,0;12,0;1,0;1,0;18,0;28,0;24,0;63,0;6,0;8,0;33,0;;4,0;35,0;46,0;50,0;11,0;14,0;;9,0;6,0;6,0;50,0;71,0;3,0;2,0;62,0;39,0;10,0;;13,0;25,0;3,0;3,0;;20,0;18,0;32,0;43,0;17,0;14,0;;10,0;6,0;;85,0;16,0;5,0;355,0;25,0;1,0;;9,0;53,0;2,0;4,0;7,0;9,0;1,0;;;1,0;25,0;;1,0;;8,0;3,0;1,0;;;4,0;;;;2,0;;;;;;2,0;;;;3,0;2,0;;;;3,0;41,0;28,0;4,0;;2,0;;;;5,0;7,0;28,0;;;3,0;14,0;;36,0;1,0;;;;;;2,0;;;5,0;;1,0;;;;5,0;3,0;;;;1,0;;1,0;11,0;;5,0;;;;;3,0;24,0;13,0;;40,0;;;;;8,0;1,0;4,0;;2,0;;1,0;;;;1,0;;27,0;;;10,0;1,0;;6,0;5,0;;;;2,0;2,0;;3,0;;;;1,0;2,0;;;205,0;10,0;;;;5,0;;;;;1,0;20,0;;12,0;;;;4,0;;26,0;;3,0;;3,0;;;4,0;;;24,0;5,0;;;9,0;;1,0;23,0;6,0;;12,0;2,0;;27,0;;;4,0;;;;1,0;;1,0;3,0;2,0;7,0;;;;;;;;;;;;6,0;;;;;11,0;11,0;;;;38,0;;21,0;;;;1,0;3,0;;13,0;;;8,0;6,0;10,0;1,0;3,0;;;;;;;;13,0;24,0;14,0;1,0;15,0;;8,0;;;3,0;;18,0;3,0;;;37,0;1,0;;;;;;;1,0;21,0;8,0;2,0;4,0;5,0;;2,0;8,0;25,0;17,0;;;;30,0;33,0;;;9,0;;9,0;3,0;15,0;;6,0;1,0;16,0;;1,0;;1,0;1,0;21,0;12,0;4,0;7,0;6,0;35,0;28,0;;23,0;;41,0;29,0;3,0;5,0;;7,0;1,0;;3,0;17,0;;55,0;9,0;1,0;1,0;5,0;8,0;27,0;;7,0;;3,0;14,0;;;;145,0;;7,0;;6,0;54,0;;;8,0;34,0;;14,0;13,0;50,0;;2,0;5,0;;;3,0;;5,0;;2,0;2,0;;4,0;;;3,0;;8,0;4,0;;4,0;3,0;;5,0;;;17,0;3,0;14,0;;15,0;3,0;;;;;;;6,0;;3,0;1,0;;;38,0;;3,0;;;;2,0;;;;;;;;;;;;;;;;23,0;;;;;4,0;;2,0;6,0;;;;;9,0;10,0;;1,0;;;;;4,0;;;;10,0;;;;;;6,0;;1,0;;;;;;;;;;;7,0;;;1,0;;7,0;;;;;;;1,0;;;;;;;;;;1,0;;;49,0;;8,0;;;;;2,0;;;25,0;1,0;;1,0;;4,0;2,0;12,0;21,0;1,0;;;;;;;;;2,0;;18,0;;;;;;;;;;3,0;;1,0;;6,0;19,0;;1,0;;1,0;;6,0;;;1,0;;;;;;14,0;;6,0;;;;;;;;;;1,0;;;36,0;;;;;;;3,0;;;;;20,0;;1,0;1,0;15,0;3,0;7,0;;;;;;;;;;;;;2,0;;4,0;;;;;;;1,0;2,0;;;;3,0;;;;;;;;;;;;;;;;;
point;;175,0;2,0;1,0;23,0;165,0;11,0;71,0;133,0;12,0;10,0;5,0;173,0;3,0;120,0;337,0;29,0;16,0;8,0;15,0;340,0;91,0;20,0;1,0;14,0;1,0;177,0;11,0;;1,0;53,0;4,0;232,0;16,0;92,0;37,0;34,0;21,0;16,0;2,0;499,0;6,0;206,0;143,0;195,0;92,0;575,0;221,0;60,0;137,0;46,0;228,0;7,0;14,0;7,0;70,0;37,0;48,0;57,0;3,0;55,0;4,0;72,0;9,0;26,0;250,0;144,0;112,0;116,0;8,0;89,0;11,0;122,0;5,0;9,0;104,0;178,0;16,0;2,0;1388,0;10,0;49,0;9,0;214,0;14,0;30,0;12,0;;2,0;45,0;276,0;1,0;2,0;6,0;77,0;22,0;15,0;;358,0;29,0;77,0;27,0;72,0;300,0;4,0;19,0;89,0;9,0;121,0;102,0;66,0;48,0;3,0;3,0;10,0;350,0;83,0;454,0;19,0;116,0;5,0;;45,0;55,0;54,0;28,0;7,0;;2,0;34,0;1,0;451,0;127,0;9,0;78,0;3,0;163,0;39,0;67,0;3,0;158,0;;15,0;41,0;55,0;22,0;;66,0;80,0;28,0;34,0;4,0;10,0;58,0;14,0;11,0;245,0;;31,0;7,0;29,0;13,0;191,0;6,0;3,0;;118,0;262,0;6,0;56,0;24,0;;1,0;19,0;24,0;26,0;19,0;18,0;2,0;;2,0;178,0;;;;6,0;;26,0;;;6,0;6,0;6,0;133,0;5,0;354,0;17,0;1,0;;10,0;;21,0;19,0;123,0;28,0;3,0;47,0;7,0;59,0;56,0;1,0;22,0;5,0;1,0;2,0;;;1,0;30,0;5,0;12,0;;;6,0;9,0;65,0;2,0;5,0;149,0;1,0;22,0;;63,0;165,0;5,0;35,0;29,0;8,0;37,0;1,0;6,0;2,0;12,0;38,0;11,0;;;7,0;97,0;189,0;11,0;;1,0;1,0;;6,0;77,0;8,0;3,0;6,0;;;2,0;234,0;;9,0;26,0;3,0;17,0;;;58,0;91,0;;;1,0;62,0;15,0;2,0;122,0;24,0;34,0;77,0;;;416,0;;23,0;1,0;1,0;93,0;72,0;;;1,0;;13,0;;11,0;1,0;18,0;16,0;11,0;;14,0;4,0;2,0;16,0;9,0;47,0;;5,0;;3,0;28,0;11,0;1,0;20,0;;19,0;;;6,0;4,0;18,0;1,0;35,0;8,0;4,0;;2,0;;;;;1,0;39,0;10,0;6,0;6,0;;;10,0;4,0;30,0;7,0;11,0;7,0;25,0;43,0;17,0;38,0;3,0;6,0;;66,0;1,0;;17,0;29,0;2,0;71,0;1,0;2,0;;;;;1,0;4,0;38,0;2,0;1,0;;;5,0;4,0;14,0;46,0;67,0;4,0;4,0;59,0;25,0;4,0;23,0;;;;36,0;5,0;254,0;74,0;;10,0;4,0;1,0;6,0;68,0;32,0;;3,0;64,0;10,0;;;6,0;2,0;11,0;174,0;82,0;15,0;32,0;;64,0;2,0;3,0;10,0;1,0;13,0;17,0;65,0;47,0;19,0;;7,0;1,0;529,0;1,0;4,0;10,0;134,0;31,0;27,0;248,0;1,0;326,0;85,0;20,0;;2,0;51,0;37,0;1,0;3,0;91,0;61,0;1,0;38,0;14,0;25,0;8,0;7,0;30,0;12,0;44,0;9,0;38,0;7,0;7,0;4,0;;;7,0;3,0;7,0;;9,0;26,0;98,0;25,0;3,0;6,0;50,0;63,0;4,0;148,0;4,0;47,0;9,0;86,0;21,0;4,0;278,0;480,0;23,0;;21,0;3,0;90,0;9,0;14,0;8,0;21,0;21,0;6,0;13,0;24,0;13,0;15,0;18,0;1,0;;51,0;19,0;27,0;23,0;;3,0;19,0;33,0;28,0;30,0;14,0;15,0;6,0;11,0;;1,0;;4,0;2,0;24,0;27,0;3,0;;;4,0;8,0;5,0;3,0;33,0;2,0;75,0;5,0;;50,0;2,0;4,0;18,0;;4,0;1,0;5,0;17,0;4,0;14,0;10,0;;21,0;;3,0;15,0;11,0;;6,0;6,0;;1,0;3,0;;28,0;8,0;31,0;9,0;10,0;10,0;27,0;;4,0;25,0;12,0;2,0;;1,0;6,0;5,0;3,0;;5,0;7,0;;;36,0;4,0;1,0;1,0;11,0;;1,0;16,0;;;1,0;1,0;1,0;2,0;;16,0;;76,0;;14,0;;;16,0;11,0;;;;1,0;13,0;3,0;;4,0;5,0;1,0;8,0;4,0;13,0;;6,0;;4,0;30,0;;137,0;2,0;2,0;1,0;1,0;;;10,0;3,0;;1,0;5,0;2,0;5,0;;10,0;2,0;1,0;;3,0;42,0;;86,0;;;55,0;3,0;;6,0;40,0;1,0;6,0;2,0;2,0;2,0;8,0;14,0;2,0;12,0;34,0;;13,0;11,0;1,0;2,0;7,0;6,0;;;1,0;;2,0;10,0;34,0;;;58,0;4,0;;55,0;1,0;24,0;;;;22,0;1,0;;;4,0;12,0;2,0;3,0;;;1,0;1,0;7,0;4,0;1,0;4,0;32,0;;2,0;;;3,0;55,0;1,0;23,0;1,0;;12,0;1,0;1,0;6,0;;1,0;;4,0;;8,0;28,0;24,0;;;4,0;1,0;6,0;;3,0;1,0;2,0;4,0;7,0;;;7,0;;;;8,0;2,0;3,0;;3,0;10,0;1,0;;2,0;;;7,0;4,0;;2,0;2,0;;24,0;;18,0;13,0;3,0;7,0;;;11,0;158,0;1,0;;;76,0;50,0;16,0;5,0;8,0;1,0;;8,0;14,0;5,0;5,0;41,0;33,0;2,0;16,0;6,0;2,0;3,0;;;;7,0;3,0;18,0;27,0;6,0;6,0;2,0;29,0;;;17,0;6,0;2,0;3,0;;2,0;8,0;;7,0;2,0;1,0;9,0;20,0;;10,0;2,0;;;15,0;;;;1,0;15,0;193,0;10,0;1,0;8,0;3,0;2,0;;10,0;;16,0;7,0;8,0;1,0;;;3,0;;1,0;3,0;;;6,0;2,0;2,0;1,0;;105,0;2,0;3,0;61,0;;;;4,0;10,0;;;29,0;4,0;3,0;4,0;;;;;1,0;;4,0;1,0;5,0;;;16,0;;;9,0;;4,0;;25,0;;4,0;2,0;;;;49,0;;5,0;;12,0;20,0;15,0;;;;1,0;;2,0;;2,0;4,0;13,0;2,0;52,0;5,0;44,0;28,0;30,0;;2,0;19,0;2,0;;;38,0;3,0;7,0;28,0;;10,0;40,0;1,0;9,0;5,0;3,0;;4,0;;;;;16,0;;4,0;;;17,0;;6,0;2,0;;8,0;1,0;13,0;3,0;;1,0;;3,0;1,0;3,0;30,0;45,0;22,0;;;16,0;;2,0;;4,0;28,0;;;6,0;;5,0;21,0;35,0;102,0;8,0;15,0;45,0;7,0;;3,0;;;1,0;;6,0;;7,0;;;;
port;;1,0;;;;11,0;4,0;41,0;4,0;;;;6,0;;3,0;;;;;;;3,0;4,0;5,0;;;;1,0;;;4,0;;42,0;;19,0;1,0;;;;;36,0;;9,0;;16,0;5,0;3,0;69,0;13,0;2,0;18,0;;;;;;;;;;14,0;22,0;;2,0;1,0;;;13,0;;1,0;2,0;;2,0;;;;;;2,0;14,0;;1,0;;42,0;;2,0;;;;;45,0;;;1,0;;34,0;8,0;;10,0;1,0;;;5,0;;;2,0;16,0;;80,0;;4,0;1,0;1,0;2,0;;4,0;1,0;16,0;33,0;;;;;;9,0;2,0;;;;;;;;4,0;2,0;;5,0;;1,0;;2,0;2,0;;3,0;2,0;;;2,0;17,0;;;;15,0;;;12,0;15,0;;;6,0;;8,0;19,0;;;;37,0;4,0;;;;;;1,0;1,0;;6,0;;;;1,0;5,0;;2,0;5,0;9,0;;6,0;;;;;;63,0;;;2,0;;;;;;;1,0;;;;;1,0;;;;1,0;1,0;1,0;;;;;;41,0;;;30,0;1,0;10,0;;;10,0;;18,0;;;1,0;1,0;;;10,0;;1,0;;2,0;21,0;6,0;;;;;;;3,0;;1,0;;1,0;;30,0;;1,0;;;3,0;;20,0;;;;;1,0;;;10,0;;;;;;;6,0;4,0;9,0;3,0;13,0;;;;;3,0;;;;;;;2,0;;;;3,0;;4,0;;10,0;;;;;3,0;;;;2,0;;;2,0;;1,0;25,0;;48,0;7,0;;1,0;;;;;;;;;;6,0;10,0;;;;10,0;2,0;;1,0;;28,0;7,0;6,0;32,0;;;;;;;;;;;;4,0;;;;;;6,0;;2,0;;1,0;;;;;;1,0;;;14,0;1,0;2,0;;;;;31,0;;;6,0;;;3,0;;;;;;;;;1,0;;;;11,0;2,0;;;;;;;13,0;;;;;1,0;;;;;;;8,0;;;;;;;;;78,0;4,0;;;;;;8,0;;1,0;;;;5,0;7,0;1,0;;;;;;;;1,0;;3,0;;;;;;;;;;;;11,0;;;;;;8,0;;;;11,0;;;2,0;;2,0;;;;;;;7,0;;;;;3,0;;;3,0;;;;7,0;;;;;;;;;1,0;;;1,0;;2,0;1,0;;;;;6,0;;;;1,0;20,0;;6,0;;6,0;1,0;3,0;;;;;3,0;;;;;;;1,0;;2,0;1,0;;26,0;;;;73,0;;;5,0;;;;;6,0;;1,0;2,0;2,0;55,0;6,0;;1,0;;3,0;;;6,0;;;;;;10,0;;;2,0;;;;2,0;;2,0;;;1,0;;;3,0;;;;8,0;;;4,0;3,0;;;;6,0;;1,0;;1,0;3,0;;;;;2,0;;;;3,0;;;20,0;;;;;;;;1,0;2,0;;;;;;;;1,0;;;;;;;;;3,0;;;;;2,0;1,0;1,0;;;;;;;2,0;;;;;5,0;;;;2,0;41,0;;;;;;;;;;;2,0;7,0;;;10,0;;;;;;;1,0;;;;;;;;;;;;;;;;10,0;;;;;;;3,0;;1,0;;;;;1,0;;;;1,0;;;;;;;;;;;;;2,0;;;2,0;;;;;;;;;;;;;;;;9,0;;;;;;6,0;;;;;;9,0;;;;;;;;;;;;;;;;;;;;;;;3,0;;;;;;;;;;;;;;;1,0;;;;;;;;;;;;;;;;;;;;8,0;;;;;;;;;;;;;;;;;;;;;;;;;;;;;;;;;;;;;;;;;1,0;;;;;;;;;;;;;;;;;;;;;;;;;;1,0;;;;;;;;;;;;;;;;;;;;;;;5,0;;6,0;;9,0;;;;;1,0;;;;;;;;;;;;;;;;;;;;;;;;;1,0;;;;;;;;;;7,0;;;1,0;;;;;;;;;;;;;;;;;;;;;;;;;;;;;
portable;;14,0;1,0;;;8,0;8,0;38,0;12,0;1,0;6,0;;15,0;2,0;10,0;14,0;;1,0;4,0;;;55,0;;;;;3,0;2,0;1,0;;50,0;3,0;31,0;;35,0;24,0;1,0;1,0;5,0;;24,0;;4,0;;17,0;2,0;30,0;1128,0;43,0;132,0;16,0;7,0;;;1,0;11,0;2,0;1,0;9,0;1,0;6,0;11,0;3,0;4,0;10,0;1,0;3,0;19,0;29,0;3,0;17,0;7,0;12,0;;;4,0;2,0;2,0;8,0;205,0;1,0;35,0;3,0;63,0;;6,0;;;3,0;7,0;44,0;;1,0;3,0;1,0;3,0;12,0;;94,0;15,0;;;67,0;10,0;;2,0;13,0;2,0;14,0;;2,0;18,0;2,0;;;14,0;57,0;53,0;14,0;4,0;;;3,0;18,0;11,0;6,0;;2,0;2,0;3,0;;4,0;41,0;;8,0;7,0;;10,0;;;17,0;;23,0;87,0;2,0;;;11,0;23,0;4,0;3,0;;10,0;17,0;6,0;5,0;86,0;;3,0;;4,0;11,0;80,0;;;;26,0;16,0;;1,0;3,0;;;2,0;1,0;1,0;32,0;18,0;;;7,0;28,0;;4,0;;9,0;;6,0;;;1,0;2,0;2,0;21,0;;9,0;11,0;;;4,0;1,0;;;17,0;;3,0;10,0;1,0;;19,0;;1,0;6,0;;;1,0;2,0;4,0;1,0;22,0;65,0;5,0;3,0;;;;7,0;1,0;34,0;1,0;7,0;;4,0;58,0;7,0;8,0;9,0;13,0;2,0;2,0;;20,0;;2,0;2,0;;;8,0;3,0;8,0;14,0;;8,0;2,0;;;41,0;2,0;;;;;20,0;6,0;;;4,0;;4,0;;14,0;2,0;14,0;2,0;;7,0;;2,0;;41,0;5,0;;149,0;;;6,0;;5,0;;3,0;5,0;;;;12,0;1,0;4,0;;;2,0;2,0;4,0;20,0;;3,0;4,0;3,0;5,0;3,0;2,0;;12,0;1,0;;1,0;1,0;1,0;5,0;;10,0;2,0;17,0;5,0;;5,0;;4,0;1,0;;10,0;;4,0;1,0;;;5,0;1,0;2,0;1,0;1,0;1,0;;1,0;8,0;1,0;3,0;3,0;2,0;6,0;14,0;;;;;2,0;2,0;1,0;17,0;;1,0;5,0;3,0;8,0;13,0;;;;6,0;1,0;;;;6,0;6,0;;;8,0;8,0;9,0;16,0;1,0;1,0;;9,0;3,0;3,0;;2,0;;32,0;;10,0;;1,0;;2,0;2,0;3,0;7,0;4,0;;2,0;;3,0;;;;;;3,0;10,0;3,0;;;112,0;;;3,0;;;;1,0;1,0;;;;;2,0;;5,0;1,0;23,0;4,0;;10,0;;;1,0;36,0;;1,0;2,0;;;7,0;21,0;9,0;1,0;35,0;;2,0;;;2,0;2,0;5,0;1,0;3,0;;36,0;1,0;;;1,0;3,0;;9,0;;1,0;1,0;;;;;56,0;;;;;;8,0;4,0;2,0;4,0;1,0;;1,0;2,0;24,0;;;7,0;;6,0;2,0;;54,0;;7,0;;10,0;2,0;25,0;3,0;2,0;;1,0;;2,0;;;9,0;;;3,0;;;1,0;1,0;;4,0;10,0;1,0;;1,0;;;2,0;8,0;1,0;2,0;;;6,0;;;;;;;;9,0;;;3,0;;;;13,0;5,0;;;3,0;;2,0;;2,0;3,0;6,0;7,0;;;4,0;;5,0;23,0;7,0;49,0;20,0;;2,0;;4,0;;1,0;;1,0;1,0;;1,0;;2,0;;;8,0;;77,0;;4,0;;;2,0;;10,0;6,0;;2,0;3,0;3,0;1,0;5,0;;43,0;;;;;1,0;;;;;;;;;;1,0;2,0;6,0;;;;1,0;3,0;;6,0;3,0;2,0;;;;;7,0;8,0;3,0;;16,0;;;2,0;27,0;1,0;;3,0;7,0;;;;4,0;;19,0;;4,0;6,0;1,0;5,0;;7,0;7,0;1,0;;;;1,0;;;11,0;;;;2,0;;;6,0;;;;;;;6,0;;1,0;2,0;3,0;32,0;;8,0;;1,0;;;1,0;11,0;1,0;1,0;;6,0;;;1,0;1,0;;2,0;;2,0;7,0;5,0;8,0;;;;5,0;;7,0;;;;;;;1,0;;;;1,0;1,0;;2,0;;5,0;1,0;2,0;1,0;;;5,0;1,0;9,0;1,0;;4,0;3,0;;;4,0;1,0;;;;2,0;9,0;2,0;;;;3,0;2,0;;;;;;;1,0;1,0;;;2,0;;;;4,0;;;;;;2,0;;;;3,0;;;;1,0;;6,0;;;;2,0;;;;;;;;1,0;;;;;;3,0;;;;;;;;;1,0;;;;4,0;;1,0;2,0;1,0;;;2,0;;;;;;;;5,0;;5,0;;;;1,0;2,0;;3,0;1,0;;;;;;;2,0;6,0;;1,0;2,0;;;;1,0;;;5,0;;;2,0;;1,0;;;1,0;1,0;;;4,0;1,0;1,0;;;2,0;;;1,0;1,0;;;;2,0;;;2,0;1,0;;2,0;;;;;1,0;1,0;;5,0;;;;;2,0;;1,0;;2,0;;;;;1,0;2,0;;;;;;;;2,0;;;;;;;;;;;;;;;;;;;;1,0;;;;;;;;1,0;;1,0;;;;;;;;;1,0;;;;;4,0;;2,0;;;;;;2,0;;;7,0;6,0;;;;;;;;;;;;;;;2,0;;;
potential;;6,0;;;12,0;;;4,0;1,0;5,0;5,0;;;;;26,0;;;;1,0;;12,0;2,0;1,0;;;;;;;;;15,0;;55,0;;;4,0;1,0;;20,0;;12,0;2,0;23,0;17,0;10,0;52,0;4,0;10,0;2,0;;;5,0;3,0;22,0;5,0;;1,0;;3,0;;6,0;;;;;3,0;;;;;19,0;3,0;;;6,0;;1,0;36,0;6,0;26,0;;14,0;;;6,0;;;;10,0;2,0;;;;3,0;;;6,0;;;;;3,0;;;1,0;;70,0;;6,0;9,0;;;3,0;31,0;13,0;6,0;39,0;39,0;5,0;;1,0;;1,0;;;2,0;;3,0;;157,0;1,0;;10,0;;3,0;11,0;;;;;;10,0;11,0;;;5,0;146,0;1,0;;;;;3,0;45,0;15,0;;;18,0;2,0;;31,0;;1,0;;8,0;8,0;;;;;;6,0;8,0;25,0;;;59,0;;;4,0;;;20,0;38,0;;;;;;;;47,0;;;;;;;;;;10,0;3,0;4,0;62,0;;;;2,0;2,0;4,0;68,0;;;;;10,0;1,0;;;;;;;15,0;;2,0;;2,0;;;;;;;1,0;2,0;;12,0;;10,0;1,0;2,0;;18,0;;66,0;;;;;;;6,0;4,0;;;;;;;4,0;5,0;;;;;2,0;2,0;38,0;;;;;;;4,0;7,0;43,0;;92,0;;;11,0;;;;;3,0;6,0;;;;;;;7,0;;;;5,0;;;;6,0;4,0;;;;;;;;3,0;;1,0;;;;;;;3,0;;;;;;;;;;;;56,0;1,0;2,0;;;;;;;;;;2,0;8,0;1,0;;;5,0;;;;2,0;;;;;;;;;6,0;;;;;2,0;;;;;;;;;;;21,0;;;2,0;;;2,0;;4,0;3,0;;;;;;;6,0;;;;;;;;1,0;;;;12,0;;26,0;;;6,0;;;;;;;;2,0;;;;9,0;;;;34,0;55,0;;32,0;;6,0;2,0;;6,0;;;;;;2,0;10,0;1,0;;6,0;;;;;;;;;;;9,0;;;;;;;;1,0;2,0;;;;;4,0;;;;59,0;;;;;6,0;6,0;;;4,0;;;5,0;;;;;4,0;;;;;2,0;;;;;;;;47,0;;;;;;1,0;;;;;;;;2,0;;;;7,0;;;1,0;;1,0;2,0;6,0;2,0;;1,0;;;;;;;;;;;;;2,0;;;;2,0;;;;;;;;;;;;;1,0;;;;;;;;;;;;;;;;;;;9,0;;;2,0;;;2,0;;;;;;15,0;;;14,0;;;;;;;;;;;;;;1,0;;;;;;12,0;;;;2,0;;29,0;8,0;;;64,0;;;2,0;;;;2,0;;;;;;;;2,0;;;;;8,0;;;;;;;15,0;;;;7,0;;;17,0;30,0;1,0;3,0;;;2,0;;;;;;;;;;;2,0;;;;;;11,0;;1,0;;1,0;;;;;;;;;;;;;;;2,0;;;;;;;;;;;;;;7,0;3,0;;;;;2,0;6,0;;;;;;;;;;;;;;3,0;;;;;;;;;;;;;;2,0;;;9,0;7,0;10,0;4,0;19,0;33,0;;1,0;;25,0;9,0;;27,0;71,0;4,0;1,0;33,0;8,0;;;;;78,0;;5,0;8,0;;;;4,0;;;;;73,0;7,0;;6,0;1,0;;;;;1,0;1,0;;;;;;;;;;;;;;;;;;;;4,0;;;2,0;;;;;;;;;;;;;;1,0;;;;;;;;;;2,0;;;;;;;;;2,0;;;;;;;;;;;;;;3,0;;;;;;;;;;;;;;;;;;;;;;4,0;;;;;;;;;1,0;2,0;;;;;;;;;;;;2,0;;;;;;2,0;;;;;14,0;;;1,0;;;;;;1,0;;;;;;;;;;;;;2,0;;;1,0;;;;;;;;;;;;;;;;;;;;;;;;;;;;;;;;;;;6,0;;;1,0;;;;;;;;;
preview;;2,0;;;;;;5,0;71,0;;;;3,0;;;17,0;;2,0;;;;38,0;5,0;;;;6,0;3,0;;;;;22,0;;14,0;8,0;4,0;;4,0;;51,0;9,0;;;38,0;6,0;8,0;16,0;20,0;200,0;;;2,0;5,0;;3,0;;;;;3,0;;;;;;12,0;;6,0;3,0;9,0;;17,0;;;14,0;;;;370,0;;3,0;3,0;27,0;;2,0;;;;;2,0;;;;;8,0;1,0;;49,0;3,0;;2,0;5,0;8,0;;;1,0;7,0;19,0;6,0;;11,0;;;;14,0;89,0;3,0;2,0;6,0;;;4,0;;4,0;;;;;;;2,0;4,0;;3,0;10,0;;18,0;17,0;3,0;17,0;;;23,0;12,0;;;;15,0;9,0;;;5,0;2,0;6,0;;6,0;;;;5,0;;25,0;;;;6,0;4,0;;;;;;;5,0;;;;;;;6,0;;;;;;;;;;;;1,0;;;9,0;;;;;;;;;;;;;7,0;;;;;;;;;;;;;;;;;5,0;;2,0;;;;;;;3,0;2,0;;;;3,0;3,0;;;;;;;;;;;;3,0;;;18,0;2,0;;;;;;13,0;;;;;7,0;;;;;;;;6,0;;;;10,0;;4,0;;;10,0;;17,0;;;;;;;;;;;;;;2,0;;;;;;;2,0;;;;;;;;;;;3,0;;;;;;;;;6,0;5,0;;;;;;;;;;;;;6,0;2,0;;;2,0;;;;;;;;;;;17,0;3,0;;;;;;;;;;;;;3,0;;;;;;;;;;;;;;;;;;1,0;;;;;;;;;2,0;;;;;;;;;;1,0;;6,0;;7,0;7,0;4,0;;;;;;;;;;;;;21,0;;;;20,0;3,0;;1,0;;2,0;1,0;73,0;;;1,0;1,0;;;;2,0;1,0;;;;;;1,0;;4,0;5,0;;;;;;2,0;;;;2,0;;;5,0;;;;2,0;30,0;;;;;;3,0;;;;;;2,0;;;;;;4,0;2,0;;;;5,0;7,0;;;;2,0;19,0;13,0;;;;;;12,0;55,0;;;7,0;;;;19,0;1,0;;;;3,0;6,0;;;;15,0;;;1,0;;1,0;;;4,0;;;;3,0;;;;;;8,0;5,0;;3,0;;;;2,0;;;;;;6,0;;;2,0;;;;;;;;1,0;;;;;5,0;;;;;;;1,0;;;;;18,0;;;;;;;;;;;1,0;;3,0;;7,0;;;;6,0;;;;;;;;;;;;;4,0;;2,0;;11,0;;;1,0;;;;;;;12,0;;;;;;;;;;;;;;;;;;2,0;;;;;3,0;;;;;;;;;2,0;;;;;;;;;;;;;;;;;;;;;;;;;;;;;;;;;;;;;;;;;5,0;;;;;;3,0;;;;;;;;;;;;4,0;;;;;;2,0;;;;;;;;8,0;;;;;;;;;;;;;;1,0;;;;;;1,0;;;;;;1,0;;;;;;;;;2,0;;;;;;;;;;;;2,0;;;;5,0;;;;;;;;;;;4,0;;;;;;;;6,0;3,0;;;;;;;;;;;15,0;;;;;;;10,0;;;;;;;;;;;;;;;;;2,0;;;2,0;;;;12,0;;;;;;;;;;;;;;;2,0;;;;;1,0;2,0;;;;;;;;;;;;;;;;;;;;2,0;;;;;;;;;;4,0;;;;;;5,0;;;;;;;;;;;;;;;;;;;;;;;;;;;;;;;;17,0;;;;;;;;;;;;;;;;;;;;;;;;7,0;;;;;;;;;;;12,0;;;;;;;;6,0;;;;;;;;;;;;;;;;
print;;1,0;;;;1,0;5,0;49,0;41,0;9,0;8,0;;9,0;;26,0;30,0;;1,0;;;;17,0;2,0;;;;18,0;2,0;4,0;;;;60,0;;12,0;1,0;2,0;1,0;7,0;;73,0;;24,0;;;2,0;13,0;69,0;67,0;25,0;21,0;2,0;;4,0;2,0;14,0;9,0;;;;20,0;1,0;;1,0;2,0;10,0;;27,0;11,0;8,0;10,0;;5,0;;;2,0;;3,0;2,0;293,0;2,0;21,0;;140,0;;4,0;;;1,0;9,0;94,0;;;5,0;;95,0;6,0;;36,0;2,0;1,0;3,0;144,0;1,0;;6,0;27,0;6,0;6,0;;9,0;13,0;;;;49,0;71,0;21,0;2,0;2,0;;;;4,0;6,0;;;;;7,0;;8,0;2,0;;4,0;63,0;15,0;1,0;;;;;;69,0;9,0;;1,0;16,0;19,0;61,0;1,0;3,0;12,0;11,0;13,0;35,0;25,0;;;4,0;2,0;2,0;43,0;;;;;2,0;;;6,0;;5,0;3,0;;6,0;49,0;16,0;;;563,0;;2,0;5,0;;679,0;;12,0;;;1,0;;;44,0;;25,0;3,0;;1,0;8,0;4,0;;;9,0;;4,0;6,0;;;21,0;5,0;;2,0;;;;2,0;8,0;5,0;10,0;36,0;;;;1,0;;3,0;;5,0;3,0;8,0;6,0;;102,0;2,0;1,0;1,0;16,0;12,0;;2,0;3,0;1,0;3,0;;;;15,0;2,0;8,0;55,0;;;;1,0;;26,0;;;;2,0;1,0;8,0;14,0;;;4,0;;3,0;;4,0;2,0;8,0;7,0;;2,0;;9,0;35,0;72,0;2,0;;6,0;3,0;;20,0;;9,0;8,0;1,0;2,0;1,0;;;2,0;;;;32,0;;7,0;2,0;35,0;1,0;1,0;3,0;2,0;1,0;3,0;;1,0;3,0;5,0;;1,0;1,0;;3,0;;43,0;1,0;;;;4,0;;6,0;;8,0;2,0;6,0;2,0;1,0;;6,0;;10,0;5,0;6,0;15,0;1,0;;2,0;2,0;;;;8,0;8,0;38,0;;;;;4,0;1,0;;3,0;6,0;;;;1,0;1,0;;;;4,0;1,0;1,0;;;;;;14,0;;;2,0;;1,0;2,0;3,0;11,0;12,0;;6,0;;;8,0;2,0;1,0;12,0;7,0;;1,0;;3,0;4,0;;;;;2,0;1,0;;;;;5,0;;28,0;1,0;;;;;;1,0;;;;;;;;;;;5,0;;7,0;;3,0;7,0;;1,0;;32,0;;1,0;;11,0;;;4,0;4,0;;6,0;1,0;;1,0;;;;8,0;;;69,0;;14,0;5,0;;;;1,0;;;;;;;;;5,0;;;;;1,0;13,0;8,0;;1,0;;;1,0;;1,0;;;;;;5,0;;4,0;;5,0;4,0;33,0;2,0;;19,0;7,0;;10,0;;7,0;;;17,0;;;;;;;;;;;;;;;4,0;6,0;;2,0;;1,0;;5,0;;2,0;9,0;1,0;;;;1,0;4,0;;;9,0;;;;2,0;;;;2,0;8,0;1,0;;;;;23,0;6,0;;;;;2,0;3,0;2,0;;;;3,0;;;2,0;;;;;4,0;3,0;;2,0;;;;;;;9,0;1,0;;2,0;1,0;;;8,0;;;7,0;;186,0;1,0;;;;;;;;6,0;11,0;;;;;3,0;1,0;;1,0;2,0;;;;6,0;3,0;11,0;7,0;;;10,0;;2,0;;4,0;1,0;9,0;;;;;;;1,0;3,0;;;;12,0;2,0;;;3,0;;;1,0;;3,0;7,0;5,0;;;1,0;;;;;2,0;;;1,0;;;;5,0;;;228,0;;;;8,0;;;;;4,0;;;;;2,0;;;;2,0;;;;;;;2,0;2,0;;;;;5,0;;;;5,0;;;;;;;;30,0;;;;3,0;6,0;;3,0;;;6,0;;1,0;;;;1,0;;;;;;;;4,0;;;2,0;;;;;2,0;5,0;;2,0;;;;;;;;;;;;;5,0;;3,0;;;;;;;;15,0;;4,0;;;;;8,0;2,0;;;;;;;;;;;2,0;;;;2,0;;2,0;;;;;1,0;10,0;;;;;;;;1,0;;;;;;;;9,0;;;;;;;;;;;1,0;;7,0;;1,0;;;3,0;;;;;2,0;;;9,0;;;;;;;;;;;;;;;;;;7,0;;;;;;;3,0;;;3,0;;;;;;;;;;;;;;;;;;;;2,0;;1,0;;13,0;;;1,0;;;;;;;;;;;;1,0;;;;;;;;;;;;;7,0;;;;;1,0;;;;;;;;;;;;7,0;;;;1,0;;;;;;;;;;;;;;2,0;;;;;;;;;4,0;;;;;;;5,0;;;;;;;;;20,0;;;12,0;;2,0;;
profile;;1,0;1,0;;;2,0;1,0;5,0;1,0;;;;5,0;;14,0;42,0;41,0;;1,0;;1,0;25,0;;;4,0;2,0;3,0;5,0;;;;;11,0;;8,0;2,0;;2,0;;1,0;6,0;;7,0;;;2,0;20,0;36,0;6,0;;10,0;10,0;;;7,0;4,0;13,0;;2,0;;;1,0;3,0;;;;;10,0;15,0;;;;4,0;;;6,0;2,0;;10,0;22,0;;6,0;1,0;11,0;5,0;;3,0;;;;33,0;;;10,0;1,0;;;;33,0;;2,0;;12,0;2,0;1,0;1,0;11,0;;3,0;;1,0;1,0;;;;1,0;4,0;1,0;1,0;4,0;;;;7,0;3,0;;;;2,0;;;7,0;5,0;;;2,0;;;;;;;2,0;8,0;2,0;;;6,0;;6,0;;1,0;;7,0;11,0;;28,0;;;;3,0;;8,0;;6,0;;1,0;6,0;;1,0;;;;;11,0;;4,0;;;;;5,0;;;;;;1,0;;;1,0;;3,0;3,0;;;;;;2,0;1,0;1,0;;8,0;;4,0;;16,0;;3,0;;7,0;;;;;;;15,0;4,0;4,0;;;;;;2,0;;25,0;1,0;10,0;;;2,0;;;2,0;4,0;;4,0;;;;5,0;;;;;2,0;;9,0;;;;;;2,0;;;4,0;;;;25,0;;;11,0;1,0;1,0;;1,0;1,0;;;;;;6,0;3,0;23,0;4,0;;;;3,0;;1,0;;;;2,0;1,0;4,0;;;;;;;1,0;4,0;;;;;;;;1,0;;1,0;1,0;2,0;;2,0;;;1,0;;;;;;;;;6,0;8,0;2,0;;3,0;;;;;;;3,0;;;;;6,0;1,0;;;;3,0;5,0;1,0;;5,0;;;;;3,0;2,0;5,0;;;1,0;;1,0;;2,0;;;;;;;;;2,0;;4,0;;;;;;;;;;;;;5,0;;4,0;;;;;;;2,0;1,0;1,0;;2,0;;3,0;;3,0;1,0;;1,0;3,0;1,0;4,0;;1,0;;;3,0;;;;3,0;2,0;;;;1,0;4,0;;;;1,0;3,0;;1,0;;4,0;2,0;18,0;;;30,0;3,0;;2,0;2,0;6,0;;;;;;;;;4,0;1,0;;;;2,0;;;;;;2,0;;;3,0;;2,0;1,0;1,0;23,0;;;;;;3,0;1,0;1,0;;;;;;;;;;;;1,0;;1,0;;2,0;;2,0;;;;3,0;;;;;;2,0;;;;3,0;;;;;;;;;;;;;;;;3,0;;1,0;4,0;2,0;;16,0;;;;;;;1,0;;7,0;;;;;;;;1,0;2,0;;;;;;2,0;;;;1,0;;;1,0;;;;5,0;;;;;;2,0;;;1,0;;;1,0;9,0;;;;;;;;;;;;;;3,0;;;;4,0;;;2,0;;;;;;;;;;;;;;;;;1,0;;3,0;;15,0;;;;;;;;;;;;;1,0;;;;;2,0;;;;;;;;1,0;4,0;;1,0;;2,0;;4,0;;;;5,0;;;;;;;;1,0;14,0;;;;;;;;;;4,0;;;;;;;;;;;;;4,0;;;;;;;;;;;;;;;;;;;;;;;9,0;;;2,0;;;;;2,0;;11,0;1,0;;;1,0;;6,0;;;;5,0;;;;;;;17,0;;;1,0;;;;2,0;;;1,0;;;;;;;;;;;;;;;;;1,0;;;;;;;6,0;;;;;3,0;;4,0;2,0;;;;;;3,0;;;1,0;;1,0;;;;1,0;;;2,0;;1,0;3,0;;2,0;1,0;;;;;;;;;;;;;;;;;;;;14,0;;;;;;;;;;;4,0;;;;;;;;;;;;;;;;;;;;;;;;;;3,0;;;;;;;;;;;;;;13,0;;1,0;;;12,0;;;;8,0;;;;;;;12,0;;;;;;;;;;;;;;;;9,0;;1,0;;;;;;;;;;;;;;1,0;;;;;;3,0;;;;;1,0;;;2,0;;;;1,0;;;;;;;;;;;;;;;;;;;;;4,0;;;;;;;;;;;;;;;;;5,0;;;;;;;;;;;;;
project;;3,0;;1,0;6,0;4,0;2,0;9,0;28,0;17,0;16,0;;9,0;;29,0;47,0;46,0;;1,0;5,0;42,0;49,0;1,0;5,0;1,0;;40,0;1,0;;4,0;2,0;4,0;82,0;;21,0;3,0;3,0;2,0;6,0;3,0;15,0;;3,0;10,0;28,0;4,0;33,0;82,0;4,0;29,0;5,0;11,0;;2,0;8,0;15,0;24,0;4,0;11,0;;10,0;;2,0;;10,0;14,0;26,0;30,0;29,0;23,0;12,0;15,0;22,0;6,0;4,0;4,0;2,0;26,0;34,0;481,0;2,0;15,0;;46,0;2,0;3,0;4,0;;6,0;3,0;88,0;;2,0;1,0;9,0;;3,0;1,0;58,0;1,0;7,0;;17,0;100,0;6,0;3,0;52,0;;2,0;1,0;9,0;7,0;19,0;;1,0;75,0;97,0;87,0;;18,0;;7,0;4,0;14,0;3,0;;1,0;;3,0;17,0;;12,0;2,0;;10,0;3,0;9,0;8,0;;;40,0;;;48,0;1,0;;;41,0;7,0;9,0;6,0;2,0;1,0;7,0;35,0;;50,0;;6,0;1,0;3,0;7,0;65,0;1,0;;1,0;10,0;13,0;10,0;7,0;7,0;;;1,0;1,0;1,0;13,0;5,0;2,0;;1,0;33,0;;1,0;;3,0;;7,0;;;;;;11,0;;20,0;;;;17,0;6,0;2,0;;20,0;;5,0;;;3,0;10,0;;6,0;;;2,0;;29,0;2,0;10,0;16,0;21,0;;10,0;;;1,0;;;238,0;;36,0;4,0;13,0;8,0;9,0;27,0;5,0;18,0;3,0;17,0;12,0;1,0;4,0;5,0;2,0;;;1,0;38,0;74,0;6,0;;;2,0;;4,0;16,0;9,0;;;3,0;1,0;;6,0;;;8,0;3,0;3,0;;3,0;38,0;13,0;;;1,0;;17,0;7,0;155,0;;4,0;14,0;;1,0;9,0;;1,0;;2,0;23,0;3,0;;;33,0;1,0;;2,0;4,0;3,0;3,0;1,0;7,0;8,0;;;6,0;7,0;5,0;28,0;;5,0;;46,0;;;;4,0;;6,0;;;3,0;;2,0;;8,0;1,0;1,0;;;1,0;6,0;;2,0;5,0;6,0;21,0;12,0;3,0;1,0;1,0;4,0;1,0;6,0;;6,0;8,0;3,0;107,0;;8,0;;;;;;71,0;3,0;;1,0;;;4,0;19,0;;;31,0;30,0;;1,0;;1,0;1,0;;;5,0;;9,0;2,0;;;1,0;8,0;3,0;5,0;;1,0;2,0;14,0;;25,0;10,0;10,0;1,0;;;;40,0;;;;;5,0;;;;;;17,0;1,0;;;;;;4,0;1,0;;;2,0;;1,0;;;1,0;;33,0;;;;2,0;;7,0;11,0;;3,0;2,0;9,0;;5,0;5,0;3,0;;9,0;7,0;8,0;;8,0;1,0;8,0;;2,0;;1,0;;2,0;;;1,0;1,0;;;;;;;;3,0;1,0;7,0;;;;13,0;;47,0;;1,0;1,0;8,0;2,0;;2,0;43,0;;;;;7,0;;14,0;;;2,0;11,0;;;2,0;4,0;1,0;;;17,0;;2,0;72,0;6,0;;;4,0;14,0;;;;;;;;;;1,0;;;;;;;;;1,0;;2,0;13,0;;;3,0;5,0;4,0;6,0;;1,0;1,0;;;1,0;;1,0;5,0;;;;;;;1,0;;;6,0;;;;;5,0;6,0;;6,0;;;;15,0;3,0;8,0;;;1,0;;;;;7,0;6,0;;;11,0;;;;;;;;;10,0;;;;;;;4,0;3,0;2,0;;;1,0;;;;;;;1,0;;;;;5,0;;;;;1,0;;3,0;;24,0;3,0;;1,0;;;;20,0;;;;;;;1,0;;;1,0;;;;;26,0;;;;;;;5,0;;;2,0;;2,0;;;;9,0;1,0;;;;10,0;;;6,0;;2,0;;;;;1,0;1,0;;18,0;;1,0;13,0;;;2,0;;;21,0;;;;4,0;3,0;;;;;7,0;;;;;8,0;;;;;;1,0;3,0;;;;;;;;;;;3,0;1,0;;1,0;;2,0;;;;1,0;1,0;;;1,0;;;8,0;;;13,0;;;;4,0;;;;16,0;;;;;;;;;;;;;;;;;;;;;;5,0;;;;;7,0;2,0;;;4,0;35,0;;1,0;5,0;;;4,0;1,0;;;;;;;;2,0;3,0;;;;;;;;;2,0;;;;;1,0;3,0;;2,0;;2,0;;1,0;;1,0;;2,0;;;;;;2,0;4,0;6,0;;;139,0;;2,0;;;4,0;;;;1,0;;20,0;;;;;;1,0;5,0;;;;;;1,0;;;;;2,0;9,0;;;;;;;;;2,0;;;;;;;1,0;;;;;;3,0;;;;2,0;;;;2,0;;;;;;;1,0;;2,0;;;;;1,0;7,0;;;2,0;15,0;;1,0;;12,0;;;;;;;2,0;;;;;1,0;;;;;;;;;1,0;;1,0;;4,0;5,0;1,0;11,0;;2,0;;;13,0;;1,0;;;;1,0;;9,0;;;3,0;;;;2,0;;;;;;;;;15,0;;1,0;9,0;;;1,0;;2,0;;8,0;4,0;;;;;;;;;;;;;
rail;;1,0;;;;2,0;2,0;3,0;;8,0;;;;9,0;;7,0;;;;;;4,0;;8,0;1,0;;;;;;;;8,0;;1,0;;;;;;;;3,0;;;;;2,0;;2,0;10,0;3,0;;;3,0;;8,0;;;;19,0;1,0;;;;;;1,0;22,0;9,0;;;;;;;;;;7,0;;;;14,0;;;;;3,0;3,0;3,0;;;;;;;;3,0;;;;;4,0;;;1,0;;;;;;;;;10,0;8,0;8,0;7,0;;;;;;;;;;;;;12,0;1,0;;;;3,0;;;;;;;;;;;13,0;;;;;;;;1,0;15,0;;2,0;;;1,0;2,0;;;;11,0;1,0;;;;;;;;;2,0;1,0;;;;10,0;;;;;;;;;;;1,0;3,0;;;;1,0;;1,0;;;;6,0;;5,0;;;;;;;1,0;;;;;;;2,0;15,0;;;;;;;;;;4,0;2,0;;54,0;1,0;8,0;4,0;;2,0;5,0;;;;;;;;;;;9,0;;;;;;25,0;;;;;;7,0;;;;;;;;10,0;3,0;2,0;;;;;;;15,0;;;;;;;;;;;7,0;;;;;;;2,0;1,0;;;1,0;11,0;;;4,0;;;;;;;;;;;;17,0;;1,0;;1,0;;;1,0;;12,0;;;;;;;;;;;5,0;;;;;1,0;8,0;;;1,0;;16,0;;2,0;;;;;;;;;;;;;1,0;;;;2,0;7,0;;;;;;;;;;;;3,0;;;4,0;;;;;;44,0;;;;;2,0;;6,0;2,0;;;;;;;;;;;;;2,0;;;;2,0;;;;;;;;;;;;;;;;;;;9,0;;;2,0;;;;1,0;;;;;;;;1,0;;;;;;;2,0;;;;;;;;;;4,0;;;;3,0;;;;;;;;;;;6,0;;;3,0;;;;;;;;;;;;;;;;;2,0;1,0;;;;;;;;;;;;;;;;;;;;;;;;;;;;;;;1,0;;;;;;;;;5,0;;;;;;;;;;;;;;;;1,0;3,0;;;;;;1,0;;;;;;;;;;;;;;;;;6,0;;5,0;;;;;;;;;;;;;;;;;12,0;;;;;;;;;;1,0;;;;;;;;;;;;;;;12,0;;;;;;2,0;;1,0;;;;3,0;;;;;;;;;4,0;;;;;;;;1,0;;;;;;18,0;;;;;;;2,0;4,0;;;7,0;;;1,0;;;2,0;;7,0;;;;;;;;;;;;;;;;;;;;;;;;;;;;;;;;;;;1,0;;;;;;;5,0;;;;3,0;;;;;;;;;;;;;;;;;;;2,0;;;;;;;;;1,0;;;;;;;;;;;;;;;;;;;;;;;;;;;;;;;;;;;;;;;;;;;;;;;;2,0;;;;;;;;;;;;;;;;;;;;;;;;;;;;;;;;;;;;;;;;;;;;;;;;;;;;;;;;;;;;;;;;;;;;;;;;;;;;;;;2,0;;;;;;;;;;;;;;;;;;;1,0;;;;;;;;;;;;;;;;;;;;;;1,0;;;;;2,0;;;;;;;;;;;;;;;;;;1,0;;;;;3,0;;;;;;;;1,0;;;;;;;;;;;;;;;;;;;;;;;;;;;;;;;;;;;;;;;;;;
rear;;8,0;;2,0;;1,0;10,0;29,0;21,0;13,0;5,0;;2,0;;29,0;31,0;;;;;3,0;6,0;;;;;1,0;2,0;;;2,0;1,0;27,0;;13,0;7,0;5,0;1,0;;1,0;8,0;1,0;8,0;1,0;16,0;;8,0;51,0;3,0;63,0;48,0;11,0;6,0;1,0;20,0;42,0;40,0;;;;45,0;8,0;15,0;;7,0;10,0;1,0;73,0;11,0;355,0;;8,0;5,0;;;68,0;3,0;;1,0;134,0;;55,0;1,0;99,0;3,0;1,0;5,0;;5,0;10,0;345,0;;;5,0;;;3,0;;23,0;15,0;;;36,0;15,0;4,0;1,0;32,0;4,0;8,0;;1,0;;3,0;;;54,0;207,0;79,0;17,0;3,0;7,0;1,0;1,0;2,0;2,0;1,0;;;;1,0;;;6,0;8,0;;;1,0;;;;;;3,0;29,0;3,0;;15,0;232,0;1,0;1,0;;;1,0;;7,0;;59,0;;1,0;;;2,0;133,0;;;15,0;11,0;125,0;1,0;;7,0;;6,0;35,0;5,0;7,0;24,0;69,0;;;11,0;123,0;2,0;4,0;2,0;6,0;9,0;10,0;1,0;;5,0;;;28,0;4,0;23,0;;1,0;3,0;68,0;14,0;1,0;;34,0;;;2,0;;;112,0;2,0;4,0;3,0;1,0;2,0;;14,0;7,0;5,0;13,0;186,0;;12,0;6,0;;6,0;4,0;;29,0;1,0;136,0;2,0;26,0;63,0;4,0;17,0;7,0;58,0;14,0;27,0;;38,0;5,0;4,0;;;;;;5,0;62,0;;1,0;;;;7,0;6,0;;1,0;;2,0;6,0;1,0;;;23,0;8,0;9,0;5,0;5,0;7,0;32,0;1,0;;8,0;5,0;16,0;46,0;285,0;3,0;;13,0;1,0;1,0;5,0;;1,0;;2,0;161,0;24,0;1,0;;148,0;2,0;;1,0;6,0;8,0;1,0;6,0;47,0;4,0;14,0;3,0;3,0;6,0;27,0;2,0;;57,0;;;11,0;1,0;8,0;91,0;10,0;33,0;;1,0;10,0;1,0;5,0;1,0;20,0;11,0;1,0;2,0;3,0;14,0;12,0;1,0;1,0;;;17,0;4,0;21,0;1,0;6,0;20,0;2,0;2,0;;3,0;22,0;7,0;;8,0;3,0;;25,0;;9,0;4,0;;6,0;;;31,0;2,0;9,0;20,0;;;;14,0;3,0;;;;1,0;;6,0;19,0;;4,0;5,0;3,0;11,0;1,0;10,0;33,0;5,0;2,0;;;21,0;;10,0;4,0;3,0;35,0;;3,0;2,0;25,0;;;;;;;;;;;1,0;4,0;;;2,0;2,0;;3,0;;1,0;;;2,0;1,0;;;;;1,0;;1,0;;4,0;;;3,0;;;;4,0;;19,0;1,0;2,0;;;1,0;;;3,0;;1,0;;;;;;1,0;;;;2,0;;2,0;;;;;1,0;;1,0;;;;;;;;;;6,0;;11,0;;6,0;13,0;;;;;;;;;;;7,0;;;11,0;;3,0;1,0;;14,0;;;7,0;;;1,0;;15,0;;;;;;;;;;;1,0;4,0;;;;8,0;;;;;;13,0;;;;26,0;;2,0;;4,0;;;;1,0;1,0;;;;;;1,0;1,0;;;;6,0;11,0;1,0;3,0;3,0;3,0;4,0;3,0;;;4,0;;;;;3,0;38,0;2,0;1,0;1,0;3,0;;;;3,0;;;2,0;;;;3,0;1,0;;;;;14,0;;;;54,0;;42,0;;1,0;;;;2,0;;;;1,0;;1,0;2,0;1,0;;;;;;;;;1,0;2,0;12,0;4,0;;5,0;;;15,0;;;;;1,0;1,0;;;;;1,0;;;;;21,0;3,0;;;;;3,0;5,0;3,0;;;16,0;9,0;11,0;3,0;;;3,0;4,0;;;;9,0;7,0;2,0;;1,0;10,0;;;;1,0;1,0;;;;2,0;;8,0;;;12,0;2,0;;;2,0;;;3,0;6,0;;4,0;2,0;;8,0;;;;2,0;;;1,0;2,0;;;;18,0;;4,0;;;;;1,0;7,0;2,0;;4,0;10,0;3,0;;;3,0;;;;;;;;1,0;;9,0;11,0;10,0;12,0;;19,0;9,0;;2,0;;2,0;6,0;;;10,0;9,0;;;;;;2,0;;;;;1,0;;;;;;4,0;;2,0;;;;;;;;;;;1,0;;;;;;;;;5,0;;;;;4,0;;;;;;;;4,0;;1,0;;;;;;;;;1,0;2,0;;1,0;;3,0;;;;;;;;;;4,0;;;6,0;;6,0;;;1,0;;;;;;;;;;;;;;;;;;2,0;;1,0;;;;;;;;;;;;;2,0;;;3,0;;1,0;1,0;6,0;;;;2,0;;;;;;;;;;;;;;;;;;;;1,0;;;;;7,0;;;1,0;14,0;;;;;13,0;;;2,0;;;2,0;;;;;;;;;;;;;;;;;;;;;;;;;3,0;;;;;1,0;;;;;;;;1,0;;;;;;;;;;;;;;;;;;1,0;;;;3,0;;3,0;;;;;;2,0;1,0;1,0;;;;;
rearview;;33,0;;;;;;1,0;;;1,0;;22,0;;;;;;;;;;;;;;;;;;;;20,0;;7,0;;;;;;2,0;;5,0;;1,0;;;1,0;2,0;41,0;32,0;;;;;;181,0;;;;;22,0;28,0;;;;;;;;;;;;;;;;;13,0;;;;55,0;;;;;;;1,0;;;;;;;;7,0;;;;23,0;4,0;;;;;2,0;;;;;;;1,0;9,0;7,0;;;;;;1,0;;;;;;;;;;3,0;;;1,0;1,0;;;;;;20,0;;;;4,0;;;;;;;;;400,0;;;;;;83,0;;;3,0;;32,0;1,0;;;;1,0;;;;236,0;;;;;;;;;;;;;;;;;4,0;;;;;;50,0;;;;;;;;;;;;;2,0;1,0;;;;;;;92,0;;;;;716,0;;;5,0;;3,0;1,0;863,0;56,0;;;;;;5,0;;;4,0;;;;;;;;1,0;;;;;;;;;;3,0;;;;;;;;;;;;3,0;;2,0;;;43,0;;;;;;;;;;;;;131,0;;;;;7,0;;35,0;;;;;139,0;;;1,0;;;;;;;;;;;4,0;;;;;19,0;;;;;;;;;;9,0;;;;;;;;;;;;;;;;2,0;1,0;;;;;;;54,0;;;;;;;;;;;;;;;;;;;;;;;;;;;;;;;;;;1,0;;;;;;;3,0;;;;;;;;;;;;;;;;;;;;;;;;;;;;;1,0;;;;;;1,0;;;2,0;;;;;;26,0;;;;;;;5,0;3,0;;;;;;;;;;;;;;;;;;;5,0;;;3,0;;;;1,0;;;;;;9,0;4,0;;;;;;;;;7,0;;;;;4,0;;1,0;;;;;;;;;;;;;;3,0;;;1,0;;;;;;;1,0;;10,0;;;;;;67,0;;;;1,0;;;;6,0;;;;;;;;;;;;;;;;1,0;;;;;;13,0;;;;;;;;8,0;;;;;1,0;5,0;;1,0;;;;;;4,0;;;;;;;;;;;;1,0;;;;;;;18,0;;;;;;;;;;;;;;;;;;;;;;;;;;;;4,0;;;;;4,0;;6,0;4,0;;;;;;;;;;;;;;;;;4,0;18,0;111,0;;;13,0;;;;;;;;;3,0;;;;;;;49,0;;;;;;;;172,0;;;;;;;;;;;9,0;;;;;;;;;;;;;;;;;;;;;;;;;;;;;;;;;;;;;;;;;;;;;;;;;;;;;;;;;;;;;;;;;;;;;;;;;;;;;;;;;;;;;;;;;;;;;;;;;;;;;;;;;;;;;;;;;;;;;;;;;;;;;;;;;;;;;;;;;;;;;;;;;;;;;;;;;;;;;;;;;;;1,0;;;;;;;;;;;;;1,0;;;;;;;;;;;;;;;;;;;;;;;;;;;;;;;;;;;;;;;2,0;;;;;;;;;;;;;;;;;;;;;;;;;;;;;31,0;;;;;;;;;;;1,0;;;;;;;;;;;;;;;;;;;;;;;;;;;;;2,0;;;;;;;;;;;;;;;;;;;;;;
rearward;;1,0;;;;22,0;;;4,0;;;;;;;8,0;;;;;;4,0;;;;;;;;2,0;;1,0;;;;1,0;;;1,0;;;;2,0;;8,0;11,0;;19,0;;5,0;3,0;2,0;;;;1,0;12,0;;3,0;;6,0;;57,0;;;1,0;;;;3,0;;;;;2,0;;;;3,0;10,0;;8,0;;5,0;;;4,0;;15,0;1,0;7,0;;;;;;;;9,0;1,0;;;3,0;6,0;;3,0;;1,0;;;;;3,0;;;3,0;12,0;4,0;;;;;;;;;;;;;;;;;;;1,0;1,0;;;;;;10,0;;;;4,0;2,0;;;;;;;;7,0;;;;;;1,0;;1,0;;3,0;56,0;;;;;;3,0;;2,0;5,0;3,0;;;;4,0;;;;;;2,0;;;;;;1,0;;2,0;;;;;2,0;;;8,0;;;;;;6,0;;;1,0;;;;;;;;3,0;;;;;;;;;;;;17,0;6,0;3,0;7,0;;;1,0;3,0;;;;;;;;;;;1,0;;;;;;;;;;;;1,0;;;;;;;;;3,0;;;;;;2,0;;3,0;;;;;;;;;;;91,0;;;;3,0;;;;;;;;;;;;;;;;;;;;1,0;;6,0;;;;;;;;;;1,0;;;;2,0;;;;;;4,0;;;;;;;;;;;;;;3,0;;;;;22,0;;1,0;1,0;;;7,0;;1,0;;;1,0;8,0;;;4,0;;;1,0;;;4,0;;;;;2,0;;;;;;;;4,0;;1,0;;;;5,0;;2,0;;;;;;;;;;;;;;;;;;;;;;;;2,0;;;;;;;;;;;;;;;;;8,0;;20,0;;;;;10,0;;;;;;;;;2,0;2,0;;;;;;;;;;;;7,0;;;;;;;;;;;;;35,0;;;2,0;;;;;;;;2,0;1,0;;;3,0;;;;;;;;4,0;;;;1,0;;;;;;;;;;;;;;1,0;;;;;;;;;;;;;;;;;;;;;;;;1,0;;;;;;;;;;;;;;;;;;;;;;;;;;;5,0;;;;;;;;;3,0;;;;;;;;;;;;;;;;1,0;1,0;;4,0;;;;;;;;;;1,0;;;;;;;;;;;;;;;;2,0;;;;;;;;;;;;;;;;;;;;;;;;;;;;;;;;;;;;;;;2,0;;;;4,0;3,0;;;;4,0;;;;;;;;20,0;;;;;;;;;;;;;2,0;;;;;;;;;1,0;;;;;;;;;;;;;;;;;;;;;;;;;;;;;;;;;;;;;;;;;;;1,0;;;;;;;;;;;;;;;;;;;;;;;;;;;;;;;;;;;;;;;;;;;;;;;;;;;;;;;;;;;;;;;;;;;;;;;;;;;;;;;;;;;;;;;;;;;;;;;;;;;;;;;;;;;;;;;;;;;;;;;;;;;;;;;;;;;;;;;;;;;;;;;;;;;;;;;;;;;;;;1,0;;;;;;;;;2,0;;15,0;;11,0;;;;;;;;;;;;;;;;;;;11,0;;;;;;;;;;;;;;;;;;;;;;;;;;;;;;;;;;;;;;;;;1,0;;;;;;;;;;;1,0;;;;;;;;;;
receive;;54,0;12,0;25,0;16,0;45,0;90,0;168,0;97,0;158,0;87,0;1,0;69,0;;111,0;422,0;105,0;1,0;8,0;9,0;40,0;408,0;22,0;68,0;;3,0;56,0;7,0;4,0;1,0;132,0;33,0;1065,0;1,0;595,0;211,0;12,0;14,0;13,0;;1200,0;1,0;348,0;82,0;80,0;49,0;145,0;1134,0;262,0;307,0;67,0;93,0;6,0;20,0;95,0;33,0;317,0;17,0;22,0;17,0;59,0;58,0;59,0;38,0;94,0;42,0;76,0;268,0;303,0;27,0;64,0;15,0;127,0;12,0;;47,0;69,0;20,0;43,0;3095,0;52,0;204,0;14,0;589,0;7,0;365,0;74,0;10,0;5,0;13,0;1221,0;9,0;30,0;19,0;42,0;59,0;70,0;20,0;694,0;115,0;17,0;13,0;517,0;231,0;25,0;148,0;477,0;29,0;263,0;73,0;123,0;149,0;7,0;7,0;21,0;431,0;785,0;367,0;117,0;106,0;10,0;4,0;112,0;200,0;343,0;84,0;4,0;3,0;103,0;21,0;135,0;70,0;22,0;;77,0;45,0;92,0;270,0;19,0;4,0;106,0;4,0;47,0;834,0;88,0;5,0;25,0;109,0;1401,0;27,0;19,0;1,0;96,0;178,0;61,0;25,0;456,0;;14,0;63,0;11,0;224,0;1183,0;;2,0;1,0;553,0;117,0;34,0;23,0;53,0;2,0;20,0;4,0;50,0;17,0;156,0;404,0;1,0;1,0;61,0;267,0;1,0;323,0;78,0;124,0;;120,0;2,0;;8,0;15,0;;131,0;;55,0;91,0;1,0;3,0;61,0;41,0;7,0;7,0;148,0;3,0;38,0;16,0;42,0;30,0;151,0;14,0;3,0;16,0;23,0;4,0;1,0;146,0;8,0;7,0;475,0;285,0;47,0;83,0;;2,0;40,0;22,0;1,0;1517,0;1,0;365,0;13,0;60,0;185,0;217,0;15,0;47,0;141,0;48,0;41,0;15,0;41,0;18,0;35,0;20,0;3,0;68,0;44,0;166,0;50,0;100,0;3,0;65,0;4,0;16,0;13,0;;145,0;14,0;;11,0;;35,0;120,0;4,0;3,0;62,0;10,0;27,0;;53,0;98,0;376,0;2,0;18,0;19,0;40,0;109,0;67,0;525,0;42,0;39,0;27,0;;21,0;167,0;1,0;82,0;12,0;10,0;91,0;13,0;1,0;11,0;42,0;2,0;3,0;15,0;22,0;18,0;69,0;16,0;42,0;8,0;52,0;24,0;8,0;63,0;93,0;5,0;11,0;18,0;10,0;10,0;9,0;11,0;2,0;118,0;1,0;107,0;10,0;3,0;28,0;7,0;91,0;12,0;39,0;10,0;;4,0;1,0;15,0;11,0;9,0;;61,0;3,0;94,0;22,0;136,0;34,0;;27,0;16,0;6,0;30,0;39,0;32,0;44,0;14,0;3,0;46,0;4,0;29,0;46,0;25,0;8,0;77,0;41,0;6,0;2,0;16,0;9,0;22,0;52,0;10,0;2,0;7,0;260,0;34,0;4,0;10,0;18,0;51,0;5,0;1,0;18,0;7,0;21,0;13,0;19,0;7,0;10,0;62,0;5,0;9,0;63,0;43,0;7,0;170,0;16,0;114,0;7,0;8,0;53,0;59,0;4,0;12,0;21,0;13,0;15,0;9,0;65,0;132,0;;13,0;;16,0;8,0;16,0;41,0;69,0;52,0;7,0;80,0;1,0;12,0;2,0;2,0;;;20,0;94,0;23,0;11,0;10,0;6,0;54,0;1,0;50,0;10,0;883,0;63,0;10,0;115,0;1,0;32,0;28,0;132,0;4,0;31,0;63,0;56,0;17,0;106,0;52,0;210,0;37,0;37,0;18,0;71,0;1,0;;11,0;28,0;72,0;153,0;3,0;2,0;10,0;57,0;14,0;33,0;39,0;5,0;12,0;44,0;25,0;27,0;23,0;4,0;7,0;48,0;35,0;623,0;11,0;2,0;24,0;58,0;1,0;47,0;26,0;8,0;36,0;17,0;17,0;5,0;10,0;12,0;19,0;;21,0;61,0;48,0;3,0;5,0;25,0;5,0;274,0;1,0;62,0;47,0;26,0;62,0;39,0;;23,0;22,0;14,0;7,0;8,0;49,0;;30,0;89,0;5,0;4,0;57,0;9,0;;13,0;40,0;28,0;23,0;2,0;18,0;84,0;30,0;7,0;64,0;31,0;14,0;49,0;30,0;4,0;19,0;112,0;4,0;6,0;7,0;14,0;53,0;5,0;3,0;18,0;16,0;7,0;210,0;1,0;194,0;50,0;77,0;21,0;49,0;9,0;16,0;1,0;24,0;20,0;13,0;19,0;16,0;10,0;89,0;6,0;276,0;70,0;294,0;37,0;5,0;91,0;7,0;33,0;2,0;7,0;41,0;5,0;15,0;13,0;4,0;8,0;8,0;10,0;33,0;54,0;4,0;5,0;13,0;5,0;21,0;74,0;22,0;2,0;17,0;4,0;2,0;11,0;34,0;6,0;11,0;47,0;5,0;55,0;89,0;22,0;34,0;5,0;2,0;44,0;6,0;;4,0;12,0;10,0;30,0;;1,0;8,0;15,0;15,0;6,0;5,0;25,0;25,0;6,0;5,0;108,0;23,0;10,0;5,0;5,0;21,0;8,0;51,0;127,0;35,0;8,0;47,0;9,0;23,0;9,0;10,0;7,0;38,0;5,0;15,0;7,0;12,0;44,0;70,0;11,0;177,0;2,0;25,0;17,0;4,0;14,0;1,0;10,0;7,0;6,0;39,0;1,0;3,0;55,0;15,0;24,0;4,0;4,0;16,0;10,0;16,0;3,0;2,0;1,0;11,0;4,0;4,0;10,0;5,0;1,0;1,0;37,0;;11,0;11,0;9,0;16,0;33,0;12,0;4,0;7,0;;8,0;31,0;17,0;;4,0;26,0;25,0;;;148,0;5,0;24,0;2,0;11,0;9,0;;50,0;9,0;;;91,0;;7,0;7,0;;2,0;3,0;20,0;17,0;27,0;2,0;26,0;51,0;15,0;43,0;2,0;13,0;;28,0;3,0;6,0;34,0;11,0;33,0;11,0;1,0;3,0;63,0;;;5,0;4,0;1,0;3,0;1,0;11,0;7,0;11,0;20,0;4,0;16,0;2,0;18,0;4,0;1,0;31,0;14,0;11,0;8,0;2,0;43,0;2,0;2,0;6,0;6,0;2,0;21,0;1,0;18,0;4,0;27,0;1,0;5,0;2,0;2,0;2,0;8,0;12,0;3,0;18,0;32,0;;8,0;10,0;;4,0;50,0;12,0;6,0;29,0;5,0;;;;10,0;15,0;9,0;4,0;10,0;13,0;2,0;1,0;1,0;16,0;2,0;15,0;5,0;1,0;12,0;;5,0;;3,0;9,0;4,0;3,0;1,0;13,0;3,0;3,0;;16,0;14,0;8,0;8,0;;15,0;3,0;39,0;;4,0;2,0;7,0;;10,0;4,0;5,0;26,0;2,0;6,0;4,0;19,0;4,0;6,0;8,0;;9,0;2,0;24,0;30,0;7,0;13,0;8,0;5,0;;13,0;;14,0;6,0;;12,0;13,0;21,0;5,0;17,0;;;3,0;24,0;6,0;1,0;9,0;2,0;11,0;;11,0;2,0;71,0;1,0;;59,0;3,0;3,0;2,0;1,0;4,0;3,0;3,0;9,0;4,0;2,0;1,0;5,0;2,0;2,0;15,0;18,0;8,0;8,0;8,0;;11,0;;5,0;6,0;8,0;8,0;1,0;1,0;8,0;;9,0;4,0;11,0;24,0;2,0;6,0;3,0;;42,0;6,0;1,0;28,0;1,0;20,0;3,0;;;;23,0;7,0;17,0;;;10,0;2,0;2,0;1,0;10,0;;12,0;12,0;;18,0;;;10,0;3,0;6,0;3,0;17,0;2,0;2,0;10,0;3,0;1,0;5,0;32,0;2,0;;15,0;5,0;;4,0;42,0;;20,0;3,0;;1,0;4,0;;2,0;;12,0;;1,0;4,0;13,0;;1,0;1,0;1,0;3,0;;13,0;7,0;;;4,0;;;2,0;;16,0;13,0;
receiver;;9,0;;1,0;;1,0;6,0;8,0;;10,0;3,0;;9,0;;5,0;21,0;10,0;;;;;10,0;;2,0;;;;;;;4,0;1,0;39,0;;68,0;6,0;;1,0;8,0;;34,0;;8,0;1,0;5,0;2,0;11,0;78,0;6,0;20,0;10,0;2,0;;;1,0;;30,0;;2,0;;8,0;2,0;4,0;;;3,0;;6,0;10,0;;;;7,0;;;4,0;6,0;1,0;;58,0;1,0;3,0;1,0;32,0;1,0;16,0;;;;;10,0;;;;9,0;3,0;4,0;;29,0;28,0;;1,0;18,0;6,0;;7,0;51,0;1,0;38,0;;2,0;5,0;;;;43,0;13,0;59,0;6,0;4,0;;;1,0;10,0;15,0;;;;;14,0;3,0;3,0;4,0;;;1,0;24,0;4,0;1,0;;;;1,0;16,0;;;;;117,0;;;;;6,0;;5,0;66,0;;7,0;1,0;;29,0;35,0;;;;24,0;25,0;4,0;1,0;;;;11,0;;;20,0;;;;1,0;10,0;4,0;;;9,0;;11,0;;;1,0;;;29,0;;8,0;;1,0;;;1,0;2,0;;18,0;;;1,0;4,0;;2,0;;;4,0;;;;1,0;;;3,0;9,0;3,0;1,0;;;;;;38,0;;19,0;;;20,0;1,0;2,0;1,0;4,0;1,0;1,0;;1,0;1,0;;;;;;;4,0;5,0;;;;;;148,0;1,0;;;;;4,0;38,0;;;2,0;;1,0;;1,0;;4,0;;;3,0;;6,0;3,0;10,0;;1,0;;5,0;;14,0;;1,0;;;28,0;2,0;;;4,0;3,0;;;;;1,0;1,0;9,0;1,0;;;;2,0;12,0;;;;;;2,0;;3,0;1,0;;9,0;;;;3,0;;;10,0;;;1,0;;13,0;;;;4,0;;2,0;7,0;;;;;2,0;4,0;6,0;7,0;;;1,0;3,0;;;;;6,0;8,0;1,0;1,0;;;;;1,0;;;;;2,0;2,0;;3,0;3,0;2,0;;;;4,0;1,0;1,0;1,0;;;;;;;2,0;;2,0;;;;;24,0;3,0;4,0;1,0;1,0;;;;;3,0;;4,0;;;;;1,0;35,0;4,0;;4,0;;;1,0;;;;;9,0;2,0;;;;;;2,0;;13,0;;;16,0;;1,0;1,0;;;1,0;6,0;6,0;3,0;10,0;4,0;5,0;1,0;;2,0;;;;;3,0;;73,0;;;;;8,0;;5,0;;1,0;;2,0;;1,0;;;1,0;2,0;37,0;;;;;2,0;8,0;2,0;;;;;;;1,0;6,0;;1,0;;1,0;;4,0;;;10,0;;3,0;4,0;2,0;;6,0;;1,0;2,0;2,0;1,0;;3,0;;;1,0;;;13,0;7,0;;;3,0;7,0;1,0;;;4,0;2,0;;;;;;;;1,0;4,0;;;;;;;;;4,0;;1,0;;2,0;6,0;6,0;;2,0;21,0;1,0;;;1,0;3,0;;1,0;3,0;;1,0;3,0;4,0;17,0;4,0;;;3,0;1,0;;;;;;;;;;;6,0;9,0;;;;14,0;;1,0;;;2,0;;;2,0;;;;3,0;1,0;1,0;2,0;2,0;;;;2,0;;2,0;;;1,0;;;;;;6,0;1,0;;;;2,0;1,0;2,0;;;1,0;;;;1,0;3,0;;;3,0;;;;;3,0;;;;;;;;;24,0;;;3,0;;;;;;;3,0;;;1,0;;;1,0;;;1,0;;;;2,0;;;6,0;;;;;2,0;;1,0;;;;;;;;;;;;;;;;;;;;1,0;1,0;;;;;4,0;;;2,0;;;6,0;;;;;;;;2,0;;10,0;;;;;2,0;;;1,0;;7,0;;;2,0;;1,0;;1,0;;;;;;;;;;;;;;17,0;1,0;;;;;;1,0;;;;;;;5,0;1,0;;;;;1,0;;8,0;;;1,0;;;;;;;1,0;6,0;;;1,0;;;;;3,0;;;;4,0;;;;;2,0;;;;;;;;;;;;;;;11,0;;;;;;1,0;;;2,0;;;;;;;;;;;1,0;;;;4,0;;;;;;;1,0;;;;;;;1,0;;2,0;;;;;;;;;;;;15,0;;1,0;;;2,0;;;;10,0;;;;;;;;3,0;1,0;;;;;;;49,0;1,0;;1,0;;;;;3,0;;;;;;;;;;1,0;;;;;;;;;;;;;;;;;;;;;;;;;;;;;;;;3,0;;1,0;;;;;;1,0;;;;;;;;;;10,0;;;;;;;;;;;;;;;;;;;;;1,0;6,0;;;;;;1,0;;;;
receptacle;;2,0;;;;2,0;;2,0;;23,0;;;2,0;;9,0;7,0;;;;;3,0;2,0;;;;;;;4,0;;;;13,0;;2,0;;;;;;2,0;;14,0;;;;;15,0;1,0;;9,0;3,0;;;;1,0;6,0;;;;1,0;5,0;;;;;;16,0;1,0;3,0;;;;;;;4,0;;;6,0;;;;7,0;;;;;1,0;;13,0;;;3,0;;;7,0;;8,0;;;;5,0;2,0;4,0;;;;2,0;;;2,0;;2,0;;19,0;16,0;28,0;2,0;2,0;;;;2,0;;;;;;;;;9,0;;;;5,0;;;;;;;7,0;;;;11,0;;;;;;1,0;;;19,0;;;;;;27,0;;;;;2,0;;;;;;1,0;;2,0;3,0;;;;;15,0;;;;2,0;;;;;;;;17,0;;;;;;2,0;2,0;;;8,0;;;2,0;;;2,0;;;1,0;;;;;;;3,0;5,0;;3,0;;;2,0;;4,0;1,0;1,0;1,0;;;34,0;;;2,0;13,0;;;;2,0;;;;;;;;3,0;13,0;;;;;;25,0;;;;5,0;2,0;4,0;;;;;;;;;;;4,0;;;;1,0;1,0;23,0;;;1,0;;;;;;;;;2,0;;;;;;;;;;;1,0;4,0;;;;;;;;;1,0;1,0;2,0;;;5,0;;6,0;;;;1,0;;;6,0;1,0;;;;4,0;2,0;;;;2,0;;;1,0;;;9,0;;;;;;;;;;;1,0;;2,0;;;;;1,0;1,0;;;;;;;;;1,0;;1,0;;;;;;;3,0;;1,0;;1,0;;;;;;;;16,0;;;1,0;;3,0;;;;;;1,0;3,0;;;;;;;1,0;;;;;;;;;;;;;2,0;;;;;;;;;;;1,0;;;;;;;;2,0;;;;;;;;;;;;;;;;;;;;;;;;;;;1,0;;;;;3,0;;;;;;;3,0;;;;;;;;;;;;;;;;;9,0;;1,0;;;;;;;;;;;;;;;;;;;;;2,0;;;;;;1,0;;;;;1,0;;;;;;;;;;;;;;;;;;;3,0;;;;5,0;;;2,0;;4,0;;4,0;;;;1,0;;;;;;;1,0;;;;;;;;;;;1,0;;;;3,0;;;;;1,0;;;;;;;1,0;;;;;;1,0;;;;;;2,0;2,0;3,0;;;;;;;;;;;;;;3,0;;;;;;;;;;;1,0;;;;;;;;;;;;;;2,0;;6,0;;;;2,0;2,0;;;;;1,0;;1,0;2,0;;;5,0;;;;;11,0;;;;;;;1,0;;2,0;;;;;;;1,0;;;;;;;;;;;;;;;;;1,0;2,0;;;;;;;;;;;;;;;;;;;;;;1,0;;;;12,0;2,0;;;;;;;;;;;6,0;;;;;;;;;1,0;;;;;;;;;;;;;;;;1,0;;;;1,0;;;;;;;;;;;;;;;;;;;;;10,0;;;;;;;;;;;;;;;;;;;;;;6,0;;;;;;;;;;;;;;;;;;;;;;;;;;;;;;;;;;;;;2,0;;;;;;;;;;;;;;;;;;;;;;;;;;;;;;1,0;;;;;;;;;;;;;;;3,0;;;;;;;;;;4,0;1,0;;;;1,0;;;;;;;;;;;;;;;;;;;;;;;;;;;;;;;;;;;;;;;;;;;;;;;;;;;2,0;;2,0;;;;;;;;;;;;;;;;;;;;;;;;;;;;;
recess;;2,0;;;;1,0;15,0;11,0;23,0;20,0;2,0;;4,0;;12,0;28,0;1,0;;;;;12,0;;32,0;2,0;;3,0;;;;1,0;;36,0;;5,0;1,0;;;;;;;130,0;16,0;;;1,0;37,0;4,0;1,0;34,0;10,0;;;1,0;26,0;9,0;;;;54,0;2,0;1,0;;12,0;;;125,0;14,0;6,0;;;;;;;;3,0;3,0;98,0;;28,0;;96,0;;;;;1,0;4,0;61,0;;;2,0;;;;;24,0;1,0;;;58,0;1,0;1,0;;13,0;;;;3,0;;2,0;;;56,0;200,0;65,0;4,0;1,0;1,0;;;;;;;;;;;3,0;;;;;12,0;;;;;1,0;;84,0;;;3,0;64,0;1,0;4,0;;54,0;;1,0;;;4,0;;;;;;120,0;;;;1,0;2,0;;;;;38,0;11,0;;8,0;29,0;23,0;;;2,0;36,0;3,0;15,0;5,0;11,0;5,0;9,0;;;;;1,0;24,0;;16,0;;3,0;1,0;41,0;12,0;3,0;;13,0;;6,0;1,0;2,0;;43,0;;;;3,0;;;9,0;;4,0;56,0;51,0;1,0;39,0;;;2,0;6,0;;15,0;;47,0;1,0;1,0;40,0;3,0;1,0;;53,0;18,0;24,0;;1,0;;;;;;;;1,0;39,0;;5,0;13,0;;;260,0;;2,0;;;1,0;13,0;;5,0;;14,0;1,0;1,0;;4,0;2,0;22,0;;;2,0;;9,0;41,0;228,0;1,0;;2,0;10,0;;;;;;19,0;5,0;1,0;;2,0;45,0;;;;9,0;2,0;6,0;2,0;26,0;1,0;2,0;11,0;;4,0;53,0;;;5,0;2,0;11,0;1,0;;;17,0;1,0;21,0;1,0;3,0;3,0;8,0;1,0;1,0;30,0;2,0;;;;14,0;1,0;;;;16,0;10,0;4,0;12,0;;1,0;38,0;2,0;;1,0;29,0;11,0;10,0;;9,0;8,0;;32,0;2,0;18,0;11,0;1,0;1,0;3,0;;30,0;;26,0;62,0;6,0;;14,0;;;;2,0;;;;5,0;8,0;2,0;6,0;1,0;2,0;2,0;1,0;3,0;2,0;;33,0;;1,0;57,0;13,0;;;7,0;1,0;;1,0;16,0;2,0;;;;;7,0;;;;;;;;;;;;;;2,0;;;;;;;;;2,0;;;;;;;4,0;2,0;;5,0;;3,0;;;;22,0;;;;3,0;;;;;;;;;;;;;;;;;;;4,0;;;;2,0;;;;;3,0;;;;2,0;1,0;2,0;6,0;;2,0;;;;;5,0;;;;;;;;;;9,0;;9,0;;;;;;11,0;;;;;;;;;;2,0;;;2,0;;;4,0;2,0;;;;8,0;;;;;3,0;4,0;;6,0;;;;;;4,0;1,0;;;;;;1,0;2,0;;;;;;;;2,0;8,0;;;;3,0;;2,0;;31,0;4,0;;;3,0;;;;;1,0;;8,0;;;;1,0;;;;;;;1,0;;;;;3,0;1,0;10,0;;;2,0;;5,0;;1,0;;;;;;;;;;2,0;;;;;;;;;;;;;;13,0;;;10,0;1,0;6,0;;2,0;;;;21,0;;;;;5,0;;;;1,0;;;5,0;;;;10,0;1,0;3,0;;;6,0;2,0;5,0;;;18,0;;9,0;2,0;;6,0;;;10,0;;;;;;;2,0;7,0;8,0;3,0;;4,0;;1,0;;;5,0;2,0;;;4,0;;;;1,0;;1,0;7,0;;;2,0;;1,0;;;;;10,0;;;1,0;64,0;;;;;;;;;1,0;;;16,0;33,0;;;23,0;;;1,0;;1,0;;2,0;12,0;1,0;3,0;;;;;;3,0;;;6,0;;1,0;;;;3,0;;;;;;;;;;;;;;;;;1,0;;;;;;;;;;;1,0;;;;;;;;;;20,0;1,0;;;;;11,0;;;;;;;;;;;;;;;;;;;;;;4,0;;;;;;;;;;;;;;;;;;;;;;1,0;;;;;;;;;;;;;;;;;;;;3,0;;;;;;;;;;;6,0;;2,0;;;;1,0;;;;;;;;;;;;;;2,0;;;;;;;;;;;;;4,0;3,0;;3,0;;;;;;;;;;;;;;;;;;;;;;;;;;;;;;;;;;;;;;;;;;;;1,0;3,0;;;;;;;;5,0;;;;;;;;;;;1,0;;;;;;;;;;;4,0;;;;;;;;;60,0;;;;;;
recognition;;1,0;;1,0;11,0;;15,0;25,0;68,0;;;;1,0;;1,0;48,0;;;24,0;;5,0;21,0;;;;;2,0;2,0;;;10,0;4,0;37,0;;38,0;1,0;;1,0;;;35,0;1,0;4,0;2,0;40,0;24,0;62,0;49,0;6,0;24,0;;13,0;1,0;1,0;;;;;4,0;;;;;;1,0;;8,0;1,0;6,0;;9,0;5,0;10,0;;;4,0;31,0;;;239,0;;5,0;3,0;48,0;;;2,0;;;;38,0;;6,0;;2,0;2,0;1,0;;65,0;4,0;10,0;;12,0;115,0;;3,0;22,0;7,0;17,0;3,0;;83,0;;;1,0;22,0;17,0;30,0;;16,0;3,0;1,0;15,0;41,0;28,0;3,0;;4,0;;3,0;;2,0;;;2,0;;5,0;3,0;4,0;3,0;23,0;;6,0;6,0;20,0;;;2,0;13,0;9,0;;;4,0;6,0;27,0;;53,0;;;;4,0;5,0;119,0;6,0;;;32,0;4,0;;;6,0;;;;;4,0;;;;;;25,0;;;;2,0;;17,0;;;;;;1,0;;;10,0;;;3,0;;2,0;3,0;8,0;;;;;4,0;70,0;;;;;;;;;;;1,0;1,0;;;;;;;6,0;;;;;3,0;;;2,0;;1,0;;;;;;;;;;1,0;2,0;24,0;;;;;;25,0;;;;;;;40,0;;;4,0;;1,0;;;;;;;;2,0;1,0;;3,0;;;;;;46,0;;3,0;;;20,0;;;;;;1,0;;;;;1,0;;;;;;5,0;;;;;;;1,0;6,0;;;;4,0;;;;;;;2,0;;4,0;3,0;;;;;;9,0;;;;;;;;2,0;;;;;;39,0;;;;;;;3,0;4,0;1,0;1,0;;;;;1,0;;;1,0;;1,0;1,0;;;6,0;;;;;;;;;1,0;;;;;;;;;12,0;;;;;;;;;;;1,0;6,0;;;;;2,0;5,0;13,0;4,0;15,0;;4,0;;;;;1,0;;;2,0;2,0;;2,0;2,0;40,0;;;;10,0;5,0;;6,0;;3,0;4,0;15,0;;;6,0;7,0;;;4,0;2,0;;;;2,0;;;;3,0;4,0;1,0;;;2,0;;4,0;1,0;6,0;;;;;21,0;15,0;;;5,0;;21,0;3,0;;;;;7,0;1,0;3,0;;1,0;;6,0;2,0;;;;1,0;13,0;8,0;;;;;3,0;2,0;2,0;6,0;;6,0;1,0;5,0;;;;;;3,0;1,0;;3,0;1,0;4,0;;;;7,0;3,0;;;3,0;3,0;6,0;;87,0;13,0;;2,0;;;;;7,0;2,0;;6,0;3,0;;;;11,0;3,0;1,0;6,0;;2,0;;;1,0;6,0;;1,0;;;;;;4,0;;5,0;;8,0;2,0;2,0;;;2,0;2,0;;;2,0;;;;16,0;;2,0;;57,0;1,0;1,0;;3,0;15,0;;;2,0;1,0;1,0;;1,0;;2,0;2,0;;;5,0;;4,0;3,0;;1,0;;;2,0;2,0;;7,0;;1,0;;3,0;;;2,0;3,0;;;;;88,0;1,0;34,0;2,0;;1,0;;;7,0;2,0;4,0;1,0;;;22,0;;1,0;1,0;2,0;;16,0;2,0;2,0;;1,0;28,0;1,0;1,0;;;;;;;1,0;;;;;;;3,0;;29,0;;;1,0;;;1,0;;1,0;;;;;;;;;;;1,0;1,0;;;;;;;2,0;;;;;;;;;;;;;;;;1,0;;1,0;;;;;;;;;;;;;;;;;;;4,0;;2,0;;;;;;;1,0;;;1,0;;;;;2,0;;;;1,0;;;;;;;;;;;;23,0;7,0;14,0;;;;;;4,0;8,0;;;;;;10,0;;;;;;;4,0;;;3,0;;;;;;;;;;;2,0;;;2,0;;;;;;3,0;;2,0;;3,0;;;;;;3,0;;;;16,0;;;;;1,0;;;;;;4,0;;;;;;;7,0;;;;;;;;;3,0;;;;;;;2,0;4,0;13,0;;;;;;3,0;;3,0;;;;1,0;;;;;;;;;;;;;2,0;7,0;;1,0;1,0;1,0;;;;;;;;;;;;;;2,0;6,0;;;;;;;;;;1,0;1,0;;;;;5,0;;;;;;;;2,0;;;;;5,0;;;;;5,0;;;;;;;;1,0;;;;;;;;;;;;;;;;;;;;;;;3,0;;;;;;;;;;;;;;;;;1,0;;;5,0;;;;;;;;;;5,0
record;;8,0;1,0;7,0;15,0;25,0;2,0;132,0;48,0;23,0;12,0;;31,0;6,0;7,0;70,0;11,0;2,0;6,0;3,0;15,0;161,0;1,0;1,0;3,0;;26,0;17,0;;1,0;59,0;8,0;133,0;7,0;277,0;21,0;20,0;12,0;29,0;;728,0;2,0;11,0;4,0;30,0;12,0;113,0;419,0;139,0;189,0;13,0;27,0;2,0;2,0;26,0;1,0;38,0;;11,0;3,0;4,0;20,0;11,0;126,0;9,0;22,0;16,0;26,0;132,0;8,0;39,0;19,0;57,0;5,0;;20,0;41,0;5,0;13,0;2017,0;5,0;52,0;1,0;162,0;2,0;103,0;3,0;;;20,0;51,0;5,0;5,0;;2,0;748,0;167,0;3,0;321,0;29,0;5,0;19,0;91,0;156,0;11,0;13,0;41,0;20,0;114,0;23,0;6,0;70,0;;3,0;;55,0;26,0;77,0;26,0;38,0;2,0;;49,0;202,0;33,0;71,0;3,0;6,0;7,0;25,0;2,0;43,0;5,0;2,0;7,0;9,0;16,0;54,0;3,0;1,0;106,0;1,0;12,0;91,0;27,0;;;3,0;235,0;10,0;8,0;;112,0;110,0;32,0;4,0;172,0;;2,0;41,0;58,0;22,0;471,0;;13,0;1,0;640,0;37,0;13,0;;6,0;;;;16,0;7,0;4,0;;;1,0;;16,0;;;;8,0;;14,0;4,0;1,0;33,0;5,0;;12,0;;;3,0;;;6,0;2,0;;7,0;32,0;;;4,0;1,0;35,0;14,0;2,0;2,0;;;;3,0;;;2,0;;14,0;3,0;;;4,0;4,0;;;56,0;;5,0;;3,0;25,0;4,0;3,0;20,0;5,0;;2,0;5,0;9,0;1,0;13,0;5,0;;;4,0;80,0;3,0;2,0;2,0;3,0;;;1,0;72,0;4,0;7,0;;;;7,0;73,0;;;1,0;;9,0;;2,0;10,0;18,0;;;1,0;30,0;5,0;;38,0;28,0;13,0;6,0;1,0;;127,0;;5,0;3,0;1,0;59,0;1,0;5,0;;5,0;1,0;3,0;1,0;;;2,0;22,0;4,0;;;;;;;;;4,0;1,0;;12,0;7,0;;1,0;;7,0;;13,0;;;7,0;3,0;5,0;1,0;3,0;4,0;;;;;;4,0;2,0;7,0;;;;;3,0;31,0;15,0;9,0;12,0;5,0;30,0;11,0;;;16,0;11,0;;;6,0;44,0;5,0;1,0;4,0;;2,0;;;;;;;4,0;5,0;23,0;1,0;1,0;;;;;4,0;2,0;;;17,0;;6,0;;;1,0;;13,0;8,0;14,0;12,0;42,0;;7,0;1,0;14,0;4,0;;22,0;8,0;23,0;9,0;2,0;1,0;;19,0;11,0;9,0;71,0;15,0;10,0;3,0;3,0;2,0;5,0;21,0;;;;3,0;18,0;16,0;;5,0;;68,0;;;4,0;43,0;2,0;2,0;35,0;;5,0;23,0;130,0;5,0;35,0;54,0;52,0;;19,0;20,0;137,0;5,0;40,0;29,0;8,0;10,0;2,0;5,0;11,0;;17,0;2,0;18,0;;5,0;19,0;28,0;5,0;3,0;;6,0;;11,0;9,0;8,0;2,0;17,0;9,0;87,0;4,0;4,0;17,0;;;28,0;1,0;4,0;1,0;16,0;2,0;;1,0;3,0;4,0;1,0;20,0;55,0;27,0;3,0;13,0;3,0;2,0;12,0;;3,0;11,0;7,0;28,0;20,0;;1,0;;51,0;8,0;2,0;11,0;1,0;2,0;34,0;;;2,0;5,0;4,0;4,0;10,0;3,0;5,0;4,0;39,0;87,0;;2,0;7,0;1,0;7,0;3,0;12,0;2,0;;19,0;32,0;13,0;8,0;13,0;;9,0;9,0;4,0;26,0;8,0;5,0;3,0;9,0;;;14,0;139,0;3,0;12,0;1,0;1,0;;10,0;34,0;4,0;3,0;1,0;37,0;68,0;1,0;36,0;5,0;;3,0;6,0;3,0;2,0;1,0;7,0;3,0;6,0;;3,0;9,0;9,0;;1,0;3,0;4,0;;;1,0;1,0;1,0;7,0;57,0;1,0;;;;7,0;3,0;9,0;10,0;11,0;10,0;1,0;;9,0;3,0;;6,0;2,0;7,0;10,0;4,0;;;;1,0;2,0;;31,0;1,0;1,0;;4,0;5,0;71,0;56,0;;;5,0;1,0;;;4,0;28,0;2,0;2,0;3,0;4,0;5,0;11,0;1,0;15,0;3,0;1,0;1,0;2,0;1,0;13,0;20,0;;40,0;19,0;2,0;;5,0;5,0;;1,0;;;;;9,0;3,0;;2,0;1,0;;3,0;;1,0;;5,0;;;;1,0;;;2,0;2,0;2,0;;;8,0;2,0;19,0;1,0;2,0;9,0;;;1,0;;;;;8,0;2,0;;2,0;;5,0;;;11,0;40,0;;;1,0;;2,0;3,0;;1,0;1,0;;4,0;;;;;;87,0;;;4,0;;;5,0;;3,0;;12,0;;;;;;7,0;;;1,0;;3,0;2,0;;;;;10,0;1,0;;;15,0;;;1,0;;2,0;;;;7,0;;13,0;;;3,0;1,0;;13,0;19,0;;;;;5,0;9,0;3,0;9,0;2,0;;6,0;;5,0;;5,0;78,0;5,0;4,0;;8,0;;;;5,0;1,0;1,0;2,0;;2,0;2,0;1,0;9,0;2,0;3,0;1,0;1,0;2,0;6,0;;38,0;;3,0;14,0;;;1,0;;1,0;;;4,0;;;1,0;;;;19,0;1,0;1,0;11,0;;;;;8,0;;1,0;;2,0;14,0;3,0;3,0;4,0;;;3,0;1,0;16,0;;;2,0;;1,0;7,0;;2,0;;1,0;;;12,0;1,0;;;1,0;10,0;2,0;5,0;;11,0;;;;7,0;;6,0;;;;19,0;13,0;;;;1,0;;11,0;1,0;;;;;;2,0;;1,0;;2,0;2,0;10,0;;;;2,0;;1,0;;;;1,0;4,0;6,0;4,0;1,0;14,0;1,0;;2,0;15,0;;59,0;;;1,0;;8,0;;;;2,0;;;;;1,0;;;;;23,0;;9,0;;2,0;1,0;;;2,0;;1,0;;;2,0;;;17,0;1,0;;8,0;7,0;1,0;2,0;;;5,0;;;5,0;;;;;4,0;;4,0;;1,0;;1,0;;;1,0;;1,0;;4,0;;;1,0;1,0;;3,0;;7,0;
reflect;;2,0;3,0;;;24,0;12,0;21,0;30,0;24,0;29,0;7,0;2,0;;29,0;23,0;167,0;;3,0;;2,0;20,0;;;;;9,0;1,0;;;;;99,0;;20,0;10,0;10,0;3,0;4,0;6,0;10,0;;1,0;3,0;69,0;13,0;14,0;65,0;;22,0;13,0;19,0;3,0;2,0;1,0;1,0;150,0;1,0;17,0;;5,0;;31,0;;9,0;2,0;11,0;59,0;7,0;9,0;10,0;62,0;30,0;8,0;;5,0;1,0;34,0;59,0;253,0;2,0;58,0;;77,0;;2,0;;;1,0;1,0;193,0;;;8,0;7,0;;3,0;;21,0;;;3,0;24,0;236,0;5,0;7,0;146,0;1,0;25,0;3,0;41,0;;4,0;;;20,0;85,0;27,0;2,0;1,0;1,0;16,0;3,0;;3,0;4,0;;8,0;51,0;25,0;;13,0;6,0;2,0;8,0;1,0;;4,0;7,0;1,0;60,0;;;60,0;5,0;;;41,0;36,0;2,0;2,0;;;4,0;45,0;1,0;76,0;1,0;6,0;1,0;;52,0;90,0;;;;1,0;96,0;29,0;33,0;5,0;2,0;;1,0;2,0;5,0;7,0;1,0;;8,0;7,0;7,0;;;2,0;8,0;21,0;17,0;;;;2,0;5,0;1,0;1,0;3,0;;;;2,0;;;4,0;19,0;;;;5,0;6,0;29,0;8,0;1,0;;4,0;1,0;;;;3,0;2,0;20,0;45,0;7,0;;;;12,0;;842,0;;37,0;2,0;164,0;12,0;5,0;3,0;9,0;25,0;7,0;14,0;3,0;;30,0;50,0;2,0;;6,0;2,0;19,0;10,0;5,0;10,0;;;;95,0;145,0;;47,0;1,0;;;;6,0;;;1,0;1,0;12,0;;;31,0;4,0;;23,0;;;4,0;2,0;281,0;3,0;1,0;;5,0;;21,0;4,0;2,0;;4,0;18,0;;;;11,0;3,0;;;;;;6,0;1,0;1,0;;;2,0;;;2,0;;1,0;;;;9,0;;;4,0;2,0;;;5,0;3,0;;2,0;;;;3,0;;;;2,0;9,0;15,0;;11,0;1,0;22,0;;3,0;;8,0;;;;4,0;14,0;4,0;;7,0;;;;1,0;2,0;8,0;2,0;;;9,0;;;;;;6,0;;48,0;;;;1,0;;;2,0;;11,0;;;2,0;;;;5,0;;;;3,0;;43,0;;;;2,0;;;2,0;;1,0;;;11,0;;;4,0;1,0;;;6,0;2,0;2,0;;;;;;;;;3,0;59,0;1,0;2,0;;2,0;2,0;1,0;;1,0;11,0;;2,0;2,0;;;24,0;;1,0;6,0;6,0;2,0;2,0;;;3,0;;;2,0;22,0;;;;;4,0;4,0;;;;16,0;;;;1,0;;;;2,0;4,0;;7,0;;5,0;5,0;;3,0;1,0;3,0;1,0;;;;5,0;;;;;;4,0;;7,0;2,0;;;;;;15,0;;;;;28,0;2,0;;9,0;7,0;;;;5,0;;;;1,0;;;9,0;;;;1,0;;;;;;;2,0;;1,0;5,0;;;;2,0;1,0;;7,0;;;;;2,0;6,0;;;9,0;;;;4,0;;;;;;;;4,0;2,0;;22,0;;;;;;;7,0;;35,0;;;;;;;;2,0;1,0;;;1,0;11,0;;;;;;2,0;;7,0;1,0;;;;;;1,0;;2,0;;11,0;8,0;;;;;;;;;;;;;;;;;;;;;18,0;;;;;;;4,0;;;3,0;;;;3,0;3,0;5,0;;;;;3,0;9,0;;8,0;;;3,0;;;;;;;;;;1,0;;;1,0;15,0;;1,0;12,0;;1,0;1,0;;6,0;;;;;;4,0;4,0;;;2,0;;;;1,0;;9,0;;;;9,0;6,0;;;;;;1,0;6,0;1,0;;;;;;;;;1,0;;;27,0;;;;;;;2,0;3,0;;;;;9,0;;;2,0;;54,0;;6,0;;1,0;;1,0;;;;;;;;1,0;;;11,0;;;;;;;;2,0;4,0;;;;;;;;;;;3,0;2,0;1,0;;;;;;;3,0;;;;9,0;;2,0;;;;13,0;;;;3,0;;;;3,0;;;1,0;8,0;;;;;;;;;;;2,0;4,0;;1,0;;;;4,0;;;;4,0;;;;;;1,0;10,0;1,0;5,0;;2,0;5,0;;;2,0;20,0;;;1,0;;;;;;;1,0;;4,0;;;;1,0;4,0;;;;;;;31,0;;2,0;;;;;7,0;;1,0;9,0;;;;;;;;;;2,0;;;;;;;;;;1,0;3,0;;;4,0;;8,0;;;7,0;4,0;;;;;1,0;;;;;22,0;1,0;2,0;8,0;3,0;;;;;;;;;;;;;;;;;;;;;;20,0;8,0;;19,0;;;;12,0;;3,0;;2,0;4,0;;35,0;;;;;2,0;;;;3,0;;;;;;;;;;;;;;;;;;;;;;;1,0;;;;;;;7,0;;;;;;
reflector;;5,0;1,0;;;1,0;3,0;14,0;;4,0;31,0;;6,0;;6,0;;4,0;;;;42,0;;;;;;;;;;;;28,0;;4,0;2,0;;;;;;;8,0;;;10,0;;26,0;;;20,0;2,0;;;;3,0;11,0;;3,0;;;;10,0;;8,0;;;14,0;15,0;1,0;;;;;;;2,0;1,0;3,0;28,0;;19,0;;26,0;;;;;5,0;2,0;15,0;;;1,0;;;;;3,0;;;;8,0;2,0;;2,0;7,0;;;;13,0;;;;;32,0;17,0;29,0;;1,0;1,0;;;;2,0;;;;;2,0;;;1,0;;;;1,0;;;;3,0;;2,0;7,0;;;;8,0;;;;;;;;;22,0;;8,0;;;1,0;4,0;;2,0;;6,0;9,0;;1,0;;11,0;;1,0;;3,0;3,0;;;;;4,0;;;;;2,0;6,0;;;;;;1,0;;;;;;11,0;2,0;5,0;;10,0;;;;;;7,0;2,0;;;1,0;;;5,0;;;;32,0;4,0;5,0;;;6,0;12,0;;52,0;;;1,0;27,0;26,0;;;;10,0;;2,0;3,0;;3,0;1,0;;;;3,0;5,0;2,0;6,0;;1,0;;;;14,0;47,0;;1,0;;;1,0;11,0;;;4,0;;3,0;2,0;;6,0;2,0;;;;;4,0;8,0;13,0;;;;1,0;1,0;;2,0;5,0;;3,0;10,0;3,0;;;2,0;;;;1,0;;5,0;2,0;3,0;;;;;;1,0;;;1,0;1,0;;;;;;;2,0;;;;;;;3,0;;;;;2,0;;;;;;;;;;;1,0;;;;;;;;1,0;2,0;1,0;1,0;;;7,0;3,0;;;;;;;1,0;;;;2,0;14,0;;;;;;3,0;;1,0;17,0;;2,0;;;;;;;;;3,0;1,0;7,0;5,0;4,0;;;;;1,0;2,0;;;;;;;;;;;;;;;;;;8,0;4,0;;;6,0;9,0;;;;;;;;;;;;4,0;;;;;;;;;;;;;;;;5,0;;;;;7,0;;;;;;;;;;;;6,0;;1,0;;3,0;;;;;;1,0;;;2,0;;;4,0;;;;;;2,0;;;;;;;;;;;;;;;;;;;;;;6,0;;;;;;;;;1,0;;;1,0;;;;;;;;;;3,0;;;;2,0;;;;;;;;4,0;;;;;;;;;;;;;4,0;;;;;;;;;;;;;;4,0;;5,0;;5,0;;;;;;;;4,0;;;;;;;;;10,0;;;;;;;2,0;;;;1,0;;;;;;;;;;1,0;;;;;;;;;;1,0;;1,0;;1,0;;;;;;;;;9,0;;;;2,0;;;;;;;2,0;;;;;;5,0;;;1,0;;;2,0;;;;;;;3,0;;;;;;;;;;;;;;;;;;;;;;;;;;;;;1,0;;;;;;;;;;;;;;;;;2,0;;;;;;;;;;;1,0;;1,0;;;6,0;;;3,0;;2,0;1,0;;;;;;;;;;;;;1,0;;;;;;;;;;;;;;;;;;;;;;;2,0;;;;;;;;;;1,0;;;3,0;;3,0;;;;;;;;;;;;;;3,0;;;;;;;;;;;;;;;;;;;;;;;;;;;;;;;;;;;;1,0;;;;;;;1,0;;;2,0;;;;;;;;;;;;;;;;;;;;23,0;;;;;;;;1,0;;;;;;;2,0;;;;;;;;;;;2,0;;;;;;;;3,0;;;;;;;;;20,0;;;1,0;;;;;;;;;;;;;;;;;;;;;;;;;;;;;;;;;;;;;2,0;;;;3,0;6,0;;;;;;;;;;;;;;;;;;;;;;;;;;;;;;;11,0;1,0;;;;;;;;;;;;;
register;;3,0;;;;1,0;1,0;24,0;7,0;;8,0;;9,0;1,0;;22,0;;;;;5,0;9,0;2,0;1,0;1,0;2,0;10,0;1,0;;4,0;2,0;;48,0;;27,0;10,0;5,0;3,0;3,0;;69,0;3,0;2,0;;9,0;7,0;14,0;153,0;10,0;26,0;2,0;46,0;3,0;8,0;2,0;24,0;2,0;3,0;5,0;;2,0;1,0;;;8,0;;8,0;11,0;30,0;;11,0;;11,0;1,0;;54,0;11,0;;;270,0;7,0;11,0;1,0;51,0;1,0;2,0;;;;2,0;8,0;;;;;5,0;9,0;;59,0;1,0;9,0;;3,0;20,0;;;3,0;6,0;17,0;16,0;;14,0;;;1,0;51,0;35,0;21,0;;16,0;1,0;;9,0;36,0;25,0;;;;;;;5,0;1,0;5,0;31,0;;2,0;;;;7,0;;1,0;33,0;12,0;;;;29,0;;9,0;;47,0;101,0;4,0;2,0;17,0;;2,0;44,0;1,0;6,0;75,0;3,0;;;7,0;;1,0;4,0;;;;3,0;21,0;1,0;;;;;1,0;1,0;;;21,0;14,0;;;;;;;;7,0;;;44,0;;;;;;;17,0;2,0;;1,0;8,0;;2,0;;;;3,0;;;;;3,0;2,0;;;2,0;;;2,0;;;8,0;;6,0;;1,0;;;11,0;;;;;3,0;;;;;;4,0;4,0;24,0;;;;;;;13,0;23,0;;;;;;;12,0;;;;;2,0;;;2,0;1,0;;1,0;;4,0;2,0;2,0;5,0;4,0;3,0;1,0;;;32,0;10,0;;;;1,0;9,0;3,0;;;1,0;;;;;;;;;;;;2,0;;4,0;;;;;2,0;7,0;;;;3,0;;;;;2,0;;;;;;;;;;;6,0;;;5,0;;;;;17,0;;;1,0;;13,0;;;;;3,0;;;1,0;2,0;3,0;;;3,0;;1,0;;;;;;;;;;1,0;;;;;;;;;2,0;;;138,0;;;;;;3,0;;;;1,0;;;;;;;2,0;;;;4,0;;6,0;12,0;1,0;3,0;1,0;;;;;;;;;;13,0;2,0;1,0;;;31,0;;1,0;;9,0;12,0;;9,0;;4,0;5,0;46,0;;;3,0;1,0;;31,0;;14,0;;;2,0;;;;17,0;;;;;;1,0;6,0;;;;1,0;;;;2,0;3,0;;;;16,0;10,0;;1,0;1,0;;2,0;5,0;13,0;;;7,0;2,0;;;;3,0;;;;;;;;;14,0;;;;;;;8,0;;3,0;11,0;2,0;1,0;5,0;;;2,0;;;2,0;;;;1,0;;3,0;;4,0;;;;;;1,0;14,0;;;;21,0;;8,0;4,0;;;;;;;;1,0;;2,0;;;15,0;1,0;3,0;;;;;2,0;1,0;;24,0;5,0;;12,0;5,0;6,0;;21,0;5,0;12,0;;;;;;;;;;;9,0;;9,0;;;;;;;6,0;;;;;9,0;;;1,0;1,0;;8,0;2,0;;4,0;;;;;1,0;9,0;;;;;;1,0;;;6,0;2,0;;2,0;11,0;;11,0;;;;67,0;;;;;12,0;;1,0;;;37,0;1,0;;12,0;;;;;;6,0;;;;;;;;;;;4,0;12,0;;;10,0;;;2,0;;;;;;;;;;;;;;;13,0;;;13,0;4,0;;;;;;;;1,0;;;8,0;11,0;;;;;26,0;;;;;;;;;;;;;;;;;;;;;;;;;;;;;;;;;;;;1,0;;;;6,0;;;;2,0;;;;;;;;74,0;;;;1,0;4,0;2,0;6,0;;;;;13,0;;3,0;2,0;2,0;;1,0;4,0;;2,0;;;2,0;;;;;;;4,0;;;;;;13,0;2,0;;;;;;;2,0;;1,0;4,0;;;;;;;;;;;;;1,0;;;;;;;;;;;;;1,0;;;;;;6,0;;;;;;;;;;;;1,0;;18,0;;;1,0;;;;;;3,0;;;1,0;2,0;;;;;;1,0;;;;;;;;;;;;;;;;;;;;;;;;;;;;;;29,0;;;;3,0;;1,0;;;;;;;;;;;;;;;;2,0;;;1,0;;1,0;;;;;;;5,0;;;;;;9,0;;;;;;;;;;2,0;;;;;;;;;;;;;;;1,0;5,0;3,0;;;;;;;;;;;;19,0;;;;;;3,0;;;;;;;1,0;;;;;;;;;
registration;;3,0;;7,0;5,0;;;1,0;4,0;1,0;1,0;;1,0;;;26,0;;;;;11,0;7,0;;;;4,0;2,0;;;;1,0;;23,0;1,0;3,0;;2,0;2,0;1,0;;14,0;;2,0;15,0;3,0;;22,0;66,0;3,0;34,0;;2,0;4,0;;;70,0;7,0;1,0;5,0;1,0;;;1,0;;2,0;;;1,0;14,0;;9,0;;12,0;;1,0;3,0;7,0;;;147,0;;2,0;1,0;15,0;;1,0;;;;;1,0;1,0;;;1,0;4,0;3,0;;41,0;2,0;23,0;;14,0;1,0;;;2,0;1,0;6,0;20,0;3,0;12,0;;;2,0;4,0;16,0;13,0;;2,0;;;15,0;3,0;5,0;1,0;;;;7,0;;1,0;1,0;;;;4,0;5,0;1,0;;13,0;1,0;1,0;2,0;2,0;;;;;;;;3,0;3,0;10,0;;14,0;;;;2,0;1,0;20,0;;;;4,0;1,0;;;;;;;2,0;2,0;;;;;;1,0;;;;;;;;;;;;;;;;;;;;;;;4,0;;;;;12,0;;1,0;;;;;;;;;2,0;;;;;;;;1,0;;6,0;;1,0;;;;;;;;5,0;;;1,0;;;;5,0;5,0;;8,0;;;;;3,0;5,0;6,0;;;;;;19,0;;;1,0;;;;;1,0;;;;;;;;1,0;;;;;;4,0;;;;;11,0;;;;;;;;;;;1,0;;;;;;;;;;2,0;;;;2,0;;;;;;;;;1,0;;;;;;3,0;;;;;;;;1,0;;;;;;;;2,0;;;;;;;;;;;7,0;;;;;;;;;;;;;;;;;;;;;;1,0;;;;;;;;;;;;5,0;;1,0;;;;;;;;;;;;;;1,0;;7,0;9,0;1,0;;;13,0;;;;;;;;;;;;;22,0;;;;1,0;;;1,0;;1,0;;;;;9,0;1,0;;2,0;;9,0;;;;;;;7,0;;5,0;;1,0;;;;;;;;;2,0;;2,0;2,0;1,0;;;4,0;9,0;;3,0;;;;3,0;2,0;;2,0;2,0;;;1,0;;2,0;;;;3,0;;;;;1,0;;2,0;;;;;;2,0;;3,0;7,0;;;;;;;;;;;;;;3,0;;;;;;;;1,0;2,0;;;;3,0;;14,0;;;;;;;1,0;;15,0;;3,0;;;;;;;;;;;;4,0;;;;2,0;1,0;;;;1,0;;;;;2,0;;;1,0;;3,0;;;;;;;;;;2,0;1,0;;;;;;;;;;;;4,0;;2,0;;;;;;;;;;;;;;;;2,0;;;4,0;;6,0;26,0;;;;;4,0;2,0;2,0;2,0;;;;;;;;;;;;;1,0;;;;;;;;;;;;;;;;;4,0;;;;;;;;;;;;;;;;;;;;;6,0;;;;;12,0;;;1,0;1,0;;;2,0;;;;;;;;4,0;;;;;;;;;;;;;;;;;;;;;;2,0;;;;1,0;;;;;;;2,0;;;;;;;;;2,0;;;;;;;;;;;;;;;;;;;;;;;;1,0;4,0;;;;;;;4,0;1,0;;;;;4,0;;;1,0;;7,0;;;;;;;1,0;;;;;;;;;;;;2,0;;;;;;;;;2,0;;;;2,0;;;;;;;;;;;;5,0;;;;;;4,0;;;;;;4,0;;;;;;;;;;;1,0;;2,0;;;;;;;;;;;;;;;;;;;;;;;;;;;;;;;;;;;;;;;;;;1,0;;;;;;;;;;;;1,0;;;;;;;;;;;;;;;;;;;;;;;;;;;;;;;;;;;;;1,0;;;;;;;;;;;;;;1,0;;;;;;;;;;;;;;;1,0;7,0;;;;1,0;;;4,0;;;;;;;;;;;
release;;6,0;;5,0;;;3,0;32,0;;3,0;;;4,0;;2,0;2,0;;;;;;9,0;1,0;1,0;;;;;;;;2,0;14,0;;41,0;3,0;;;;;7,0;;;;25,0;5,0;3,0;33,0;12,0;12,0;;;;;23,0;;16,0;;;;3,0;;;5,0;;1,0;1,0;;;;3,0;1,0;10,0;2,0;;;;;;43,0;;6,0;2,0;18,0;;16,0;;;;2,0;19,0;;;;;;;;20,0;2,0;;;12,0;6,0;1,0;4,0;;9,0;2,0;;3,0;2,0;;1,0;;4,0;20,0;62,0;1,0;9,0;;;;5,0;;;;;;;;;1,0;2,0;;;;4,0;;;;;;4,0;2,0;;;3,0;13,0;;;;1,0;2,0;;;13,0;;;1,0;;;15,0;;;;;2,0;;;;;3,0;;2,0;1,0;17,0;;;;;5,0;;;2,0;;;;;;2,0;2,0;;5,0;;3,0;;;;;;;2,0;6,0;;4,0;;;2,0;1,0;;1,0;10,0;;;;4,0;11,0;;8,0;3,0;;2,0;;;;;21,0;6,0;;54,0;;7,0;15,0;7,0;1,0;3,0;2,0;1,0;2,0;;2,0;;2,0;;;;;2,0;1,0;13,0;;;2,0;1,0;;10,0;;;;;;1,0;5,0;;;3,0;;105,0;;10,0;3,0;4,0;;;16,0;4,0;1,0;1,0;8,0;12,0;2,0;1,0;;;10,0;;4,0;;;;1,0;1,0;;;;2,0;;;2,0;4,0;8,0;10,0;;;;9,0;1,0;;;;2,0;;1,0;1,0;;3,0;14,0;;8,0;;;2,0;;7,0;;6,0;5,0;;1,0;1,0;2,0;2,0;;;;;;;9,0;;;2,0;2,0;3,0;;24,0;;;;;;;2,0;;6,0;2,0;2,0;;;;;;1,0;1,0;;;;2,0;;;;;;2,0;;2,0;;4,0;3,0;6,0;;;;;1,0;;2,0;;5,0;;;;;;;;;;;;;;;;;;;;;;1,0;;;;;;4,0;1,0;;;;1,0;;;;;;;;;7,0;;;;;;;9,0;;;;5,0;;;20,0;70,0;;2,0;2,0;2,0;;;;;23,0;;;;;;;;;;;1,0;;1,0;;;;1,0;;1,0;2,0;;;;;3,0;;;1,0;;;;;;;;;;2,0;;;;;;;33,0;;;3,0;;;2,0;;;;2,0;5,0;;;;;;;;;;12,0;8,0;;;;;;;;;;;9,0;;2,0;1,0;;;;2,0;7,0;;;3,0;;;;3,0;;;;;;;;;13,0;7,0;88,0;;;;;;;;;;;;1,0;;;;3,0;2,0;;;;;;;;6,0;;;;23,0;4,0;;;;1,0;;;;;;;3,0;;;;;;2,0;;;2,0;;;4,0;;;;;;;;;;;;;;;;1,0;;3,0;;;3,0;;;;4,0;;;;;;;;1,0;;2,0;;;;;;;;4,0;;;;1,0;19,0;;;;;;;;;;;;;;;;1,0;;;;;2,0;6,0;1,0;13,0;2,0;7,0;2,0;1,0;;;;;;;;;2,0;;;;;3,0;;;;;6,0;;4,0;;2,0;3,0;3,0;;;;;8,0;;;;;;;;;;;;;;;;;;;;2,0;15,0;;;;;;;;;;;2,0;;;;;;;;;;;;;;;;;;;;;;1,0;;;;;1,0;;;;;;;;1,0;;;;;4,0;;;1,0;;;;;;;;;;;;;;4,0;;;;;;;;;;1,0;;;;;2,0;;;;;;;;;;;;10,0;;;;;;;;;;2,0;;7,0;;;;;;;;;;5,0;;;;;;;;;;;;;;;;;25,0;;;;;;;1,0;;;;1,0;;;;;;;;2,0;;;;;;;;;;2,0;;;;;;24,0;;;;;;;;;;;;;;;;4,0;;;;;;;;;;;;;;;;;;;;;;;;;4,0;;;;;;;;;;;;;;;;;3,0;;;;;;;;;;;;1,0;;;;;;;;;;;;;;;1,0;;;;;;
removable;;2,0;;;;;1,0;10,0;;;;;1,0;;4,0;6,0;4,0;;;;;4,0;;;;;;3,0;;;1,0;2,0;12,0;;8,0;;;;;;8,0;;;;;;;42,0;20,0;14,0;3,0;;;;;;4,0;;;;;6,0;;2,0;36,0;;4,0;2,0;3,0;7,0;1,0;1,0;;;;;;;5,0;22,0;;16,0;;22,0;;;4,0;;;;28,0;;;;;;31,0;;6,0;2,0;;;6,0;1,0;1,0;;27,0;;;;;1,0;;;;16,0;24,0;1,0;3,0;;2,0;;;1,0;2,0;;;;;;;;1,0;3,0;5,0;;;1,0;;;;;1,0;;;;;3,0;2,0;1,0;;;33,0;13,0;;2,0;30,0;;;;;;16,0;;;;21,0;;;;;;1,0;;;;22,0;;;;;6,0;;2,0;;;;13,0;;;2,0;1,0;1,0;14,0;;2,0;1,0;;;23,0;;;;1,0;;;;;;5,0;;;;;;;;;;5,0;20,0;;;;;1,0;;;5,0;;7,0;;4,0;28,0;4,0;;;8,0;2,0;;;30,0;1,0;8,0;;;;;;;8,0;;;;;;10,0;;1,0;;;;3,0;;5,0;;3,0;;9,0;;2,0;;1,0;;;1,0;;13,0;;13,0;;;;;;;;4,0;;1,0;;;;;6,0;1,0;;;;;;3,0;6,0;;2,0;;;;;;;13,0;;;1,0;1,0;1,0;5,0;;23,0;6,0;1,0;;;;;3,0;7,0;;;;12,0;;;;;1,0;2,0;;13,0;6,0;;5,0;3,0;;;;;1,0;;;;;;;;;2,0;2,0;1,0;;;1,0;;;;;5,0;;1,0;2,0;1,0;1,0;;;;1,0;3,0;1,0;;1,0;;5,0;1,0;;;;;;14,0;;;;4,0;2,0;;1,0;;2,0;;;;1,0;11,0;;;;;;;;;;;;;;;;;;;;2,0;;;;;;;;;;;;;;;;;3,0;;;;;;;;6,0;;;;;;;;1,0;;1,0;;5,0;4,0;;;;;;;;;;;;;2,0;;;;;;;1,0;;;;;;;;;;;1,0;;;;;;6,0;;1,0;1,0;;;;;;;;;;11,0;;;;;;;;;;;;;;;1,0;1,0;;;;;;;;2,0;;;;;;;;;;;;;;;;1,0;;;;3,0;;2,0;;2,0;23,0;;;;1,0;;;1,0;1,0;;;;;12,0;;;4,0;1,0;;;;1,0;;;7,0;;;;3,0;;;;;;;;;;;1,0;1,0;;2,0;;;;;;;;1,0;;;;;;;;;;;;3,0;;;19,0;;;;;;;;1,0;;7,0;;;;;;9,0;2,0;;;;;;;;;;;;1,0;10,0;;;4,0;;;;;;;;;;5,0;;;;;;;;;;;;;;7,0;;;;;;;1,0;;;;2,0;;;;;7,0;;4,0;;;;;;;;;;;;;;;7,0;;;4,0;;;;;12,0;1,0;;;;;;;;;;;;;;;5,0;;;;9,0;;;;;;;;;5,0;12,0;;;;;;;;;;;;;;;;;;;;;;;;;;;;;;;;;5,0;;;;;;;;;;;;;1,0;;;;;;;;;;;;;;;;;;;;;;;;;;;;;;;;;;;;;;;;;;;;;;;;;;;;;;;;;;;;;;;;;;;;;;;;;;;;;;;;;;;;;1,0;;;;;;;;;;;;;;;;;;;;;;;;;;;;;;;;;;2,0;;;;;;;;;;;;;;;;;;;;;;;;;1,0;;;;;;;;;;;1,0;1,0;;;;;;;;;;;;;;;;;;;;;;;;;;;;;;;;;;;;;;;;;;;;
removably;;4,0;;;;;8,0;22,0;;8,0;;;;;1,0;17,0;;;;;;4,0;;1,0;;;;;;;1,0;;9,0;;;;;;;;;;1,0;;;;;20,0;;2,0;2,0;;;;2,0;;;;;;8,0;6,0;;1,0;4,0;;;;2,0;2,0;;;;;;;;;1,0;3,0;;6,0;;10,0;;;18,0;;;4,0;41,0;;;3,0;;;2,0;;5,0;1,0;;;;2,0;;;3,0;;1,0;;;;;;;3,0;18,0;11,0;1,0;;2,0;;;8,0;;;;;;;;;;;;;;;;;;;;4,0;;;1,0;5,0;;;;;;;;;10,0;;;;;;10,0;;;;1,0;;;;;;;;;;18,0;;;;;14,0;;1,0;;;;6,0;;;;;;40,0;;;;;;13,0;1,0;;;1,0;;;;;;1,0;2,0;;;;;;;;;3,0;31,0;;;;;2,0;;2,0;2,0;;33,0;;;60,0;;;;1,0;2,0;2,0;;;;1,0;;;;;;;25,0;;;;;;18,0;;;;;;23,0;;;;7,0;;;;;;2,0;;;2,0;;11,0;;5,0;;;;;;;;;;1,0;;;;;2,0;;2,0;;;6,0;;;31,0;;8,0;;;;2,0;;;;;;;;;4,0;;24,0;;;1,0;;;2,0;14,0;;;;;13,0;;2,0;;;;;2,0;6,0;2,0;;;;;;5,0;;;;;1,0;;;;2,0;1,0;1,0;6,0;;;1,0;2,0;;;5,0;;;;;2,0;;;;;;7,0;2,0;1,0;;;1,0;;4,0;;;5,0;5,0;;15,0;5,0;;;;5,0;;;;;;;;;12,0;;;;;;;;;;;;;7,0;;;;;;;;;;;;;;;;;;;;;;;;;;;;;;;;;;1,0;;;;;1,0;;;;;;;;;;;;;;;;;;;2,0;;;;;;;;;;;;;;;;;;;;;;;;8,0;;8,0;;2,0;3,0;;;;;;;;2,0;;2,0;;;;;;;;;6,0;;;;;2,0;;4,0;;;;3,0;;6,0;;;;;;;;;;;;;;;;15,0;;;;;;1,0;7,0;;;3,0;;;;;;;;;;;;;;3,0;;;;;;2,0;;;;;;;;;;;;;3,0;2,0;;;;;;;;;;;;;;;;;;1,0;;;;;;;;;1,0;;;;;;1,0;;;;;;;;;2,0;;;;;;;;;;1,0;;;;;;;8,0;10,0;;;;;;;;;;3,0;;;;;;4,0;;;;;4,0;;4,0;1,0;;;;;3,0;;;;;1,0;;;;;;;;;;;;;3,0;;;;;;;3,0;;;;4,0;;;;;;;;1,0;;;8,0;;;1,0;;;;;;;;;;;3,0;;;;;;;;;;;;2,0;;;;;;;;1,0;;;;;;;;;;;;;;;;;;;;;;;;;;;;;;;;;;;;;;;;;2,0;;;;;;;;;;;;;;;;;;;;;;;;;;;;;;;1,0;;;;;;;;;;;;1,0;;;;;;;;;;;;;;;;;;;;;;;;;;;;;;1,0;;;1,0;;;;;;;;;;;;;;;;;;;;;;;;1,0;;;;;;;;;;;;;;;1,0;;;;;;;;;;;;;;;;;;;;;;;;;;;;;;;;;;;1,0;;;;;;2,0;;;;;1,0;;2,0;;;;;;;;;;;;;;;;;;;;;;;;;;;;;;;;;;;;;
request;;10,0;;7,0;5,0;1,0;1,0;19,0;8,0;1,0;;;12,0;;;37,0;1,0;;2,0;;3,0;36,0;1,0;72,0;;;;1,0;3,0;;11,0;;53,0;;70,0;14,0;;;5,0;;100,0;;;;5,0;;24,0;197,0;8,0;47,0;;;;;5,0;19,0;;;4,0;1,0;;8,0;9,0;4,0;11,0;2,0;4,0;;26,0;;19,0;;24,0;;;4,0;25,0;;;154,0;;16,0;;30,0;;9,0;10,0;;;;39,0;;;2,0;;19,0;9,0;;60,0;27,0;3,0;;29,0;13,0;;3,0;6,0;4,0;11,0;11,0;1,0;13,0;;;;38,0;3,0;39,0;14,0;10,0;;;3,0;20,0;16,0;6,0;;;;3,0;4,0;;1,0;;;3,0;2,0;80,0;;4,0;4,0;11,0;38,0;8,0;15,0;;;;39,0;1,0;;;26,0;21,0;;9,0;48,0;;1,0;44,0;4,0;69,0;75,0;;;;47,0;20,0;;;1,0;;;;2,0;;;;;;;38,0;;;;;;6,0;;;2,0;;;;;;6,0;;;;;;1,0;3,0;1,0;;;;;;;;;;;;;;;;3,0;;;;;;;;1,0;;;;;;;3,0;;1,0;;;2,0;7,0;;4,0;;;;;;;;;;;;;210,0;;;;;;;23,0;;;;;;;;10,0;;;;;12,0;;;;3,0;;10,0;;;47,0;;1,0;;;25,0;;;;;;;;;;;2,0;;;;;;6,0;;;;2,0;;;1,0;;;;;;;;;;;;;;;2,0;;;;;;6,0;;4,0;1,0;;;;;;;;3,0;1,0;;1,0;;;;;;;;10,0;;;;1,0;;;;;;;;;;;;10,0;2,0;;;;;;;;;;;;;;;2,0;;16,0;;2,0;;44,0;;;;2,0;;;22,0;1,0;;3,0;;;4,0;2,0;7,0;3,0;;;4,0;;;5,0;;;;1,0;;;;;6,0;;;2,0;;25,0;;;12,0;;5,0;;11,0;;10,0;2,0;5,0;;15,0;7,0;3,0;1,0;;10,0;;;;;2,0;5,0;10,0;2,0;;8,0;;;;;;;7,0;;1,0;8,0;;;3,0;1,0;112,0;2,0;2,0;1,0;1,0;;3,0;;;2,0;;;;;8,0;1,0;;;4,0;3,0;1,0;;;1,0;11,0;;;;2,0;4,0;6,0;;;;;5,0;;12,0;;10,0;6,0;;;;;8,0;6,0;3,0;7,0;4,0;;9,0;;;4,0;;65,0;;20,0;1,0;;;12,0;;9,0;4,0;2,0;;6,0;;5,0;;1,0;;;12,0;1,0;;;1,0;;;;;;;;;;4,0;;37,0;6,0;20,0;6,0;;;6,0;5,0;;;7,0;;;2,0;;;;;13,0;1,0;;4,0;5,0;2,0;2,0;18,0;1,0;;;2,0;;2,0;3,0;;;;;18,0;108,0;;4,0;3,0;;1,0;3,0;;;;;2,0;2,0;;;2,0;;;4,0;;6,0;1,0;;13,0;1,0;;4,0;;;;;22,0;13,0;1,0;1,0;1,0;10,0;6,0;;7,0;;;14,0;2,0;;9,0;3,0;;19,0;3,0;;;;;;;;;5,0;;2,0;2,0;;;;;;10,0;;1,0;;;;;;;;;;;;;;3,0;;;;;;;;7,0;;;;;;;;1,0;15,0;;;;1,0;;;;;;;;;;;;;;;;;;;;;;;;3,0;;;;2,0;;;;;;;;2,0;;;;;;;;;;;;;;;5,0;;;;;;5,0;;;;;1,0;;;;9,0;;;;;;;2,0;;;;;;4,0;;;4,0;1,0;;;;2,0;;;;;1,0;;;;;6,0;;;;;;;;;1,0;;;;1,0;;;;2,0;;;;;2,0;3,0;;;;;;;;1,0;;;;4,0;;;;;5,0;;10,0;1,0;;;;6,0;3,0;;;;;;3,0;;1,0;;;;;4,0;;;;;;;;;;;;;2,0;;;1,0;;5,0;1,0;;;;;;;;;;;;;6,0;;;;;;;;;;;;;;;;;;;;;;;;;;4,0;;3,0;;;;;;;4,0;;;;;;;7,0;;;;;;;1,0;;;;;;;;;;;;;;;;;;;;;2,0;;;;;;;;;;2,0;;;1,0;4,0;;;;;;;;;;;;;;;;;2,0;
require;;1,0;;;;;1,0;14,0;4,0;2,0;;;;;;26,0;;;;;1,0;6,0;7,0;;;;2,0;;;;;1,0;9,0;;12,0;4,0;;2,0;1,0;;19,0;2,0;8,0;;1,0;7,0;15,0;6,0;6,0;1,0;;6,0;2,0;;4,0;;7,0;;1,0;;3,0;;1,0;;1,0;;9,0;2,0;7,0;;;;29,0;;;2,0;7,0;;4,0;40,0;;;;9,0;12,0;;2,0;;;4,0;16,0;;;;;4,0;5,0;;14,0;2,0;;;6,0;2,0;;;6,0;;17,0;23,0;1,0;8,0;;;;9,0;3,0;13,0;3,0;11,0;;;6,0;39,0;;3,0;;;;5,0;13,0;7,0;;;;9,0;;;;2,0;1,0;;5,0;9,0;12,0;;;;14,0;2,0;4,0;;1,0;7,0;;;9,0;;;;;6,0;29,0;;;;12,0;2,0;;1,0;2,0;;;;11,0;;8,0;;;;1,0;1,0;;;1,0;1,0;;5,0;;;;2,0;;4,0;;;1,0;;1,0;4,0;;;3,0;2,0;1,0;;;;1,0;;;;9,0;;;;;4,0;;2,0;;;;;;;;;34,0;;2,0;;;2,0;;8,0;3,0;33,0;;;;;;;;;;;1,0;;;;1,0;;;2,0;5,0;;;;;;;4,0;;2,0;3,0;2,0;;;;2,0;2,0;;;;;;;4,0;7,0;;;;;108,0;;;;;10,0;1,0;1,0;;;28,0;;;;;;;1,0;;;;;3,0;4,0;;;1,0;2,0;;;;;;;1,0;;1,0;;;3,0;;;;;;;;;;;;;;;;;;8,0;;;;;1,0;;;;;;1,0;;;;1,0;;;;1,0;;18,0;;;;;10,0;;;;;;;;4,0;;4,0;;;;2,0;;;;;;;1,0;1,0;5,0;;;;3,0;1,0;;;;;;4,0;2,0;;;;;1,0;7,0;6,0;8,0;15,0;1,0;1,0;;2,0;1,0;;;;4,0;;5,0;;;;7,0;;1,0;;5,0;2,0;;;;;2,0;13,0;;;;3,0;1,0;;14,0;11,0;7,0;;45,0;19,0;;;;3,0;5,0;;;;1,0;;;;7,0;;;;;2,0;2,0;;;1,0;;11,0;;1,0;;1,0;;6,0;;1,0;11,0;;1,0;4,0;;;;;;3,0;;;;;;;;2,0;;;1,0;2,0;;;;;1,0;;;6,0;;1,0;;;1,0;;;7,0;1,0;;2,0;;;;;;;1,0;;;;2,0;;3,0;;2,0;2,0;;;;1,0;;1,0;;4,0;;1,0;;;;;;5,0;;;;;;;;4,0;;11,0;;;;1,0;;;;;;;;;;;;;;;1,0;3,0;;2,0;;;;;;;;3,0;;;;1,0;;;1,0;;;5,0;;;1,0;6,0;;;1,0;;;1,0;;1,0;;;;;;1,0;;;1,0;;;;2,0;;;;1,0;;;;;;4,0;;;2,0;;;;;;;;;;1,0;2,0;1,0;;;;1,0;;;;;;;;;;;1,0;;15,0;1,0;;;;;;;;;;;;;;3,0;;;;;;;;;;;;;;;1,0;;;3,0;1,0;;;;;;;;;;;;;;;;;8,0;;;;;;;1,0;3,0;;;12,0;;;;;;;;;;;;;;;;;;;;;;;2,0;2,0;;1,0;;;;;;;;;2,0;;;;2,0;1,0;;;;;;;;;;1,0;5,0;;;;5,0;;;;;;;;3,0;6,0;;1,0;1,0;;5,0;;;;;;;;;;;;;;;;;;;;;12,0;;;3,0;;;;2,0;;;;;;;;;;2,0;;;5,0;;;5,0;;;1,0;;3,0;;;;1,0;;;;2,0;;;;;;1,0;2,0;;;;;;;;;;;;;;;;;1,0;1,0;;1,0;;;2,0;;1,0;;;;;;;;;;;;;;;;;;;;;;;;2,0;;;;;;;2,0;;;;;3,0;;;;;;;;;1,0;;;;;;;;;;;;;;;;1,0;;;;;;;9,0;;;;;;;;;;;;;;;;;1,0;;;;;;;;;;;;;;;;;;;;;;
restrict;;48,0;;;;;13,0;13,0;23,0;;;;2,0;;25,0;9,0;4,0;;;;;18,0;;;;;;;;;;1,0;2,0;;4,0;7,0;;;3,0;;4,0;;5,0;;1,0;;4,0;19,0;;21,0;51,0;3,0;;;;;;;3,0;;1,0;2,0;2,0;;;;3,0;3,0;4,0;4,0;4,0;;3,0;;;;1,0;;;20,0;;3,0;1,0;33,0;2,0;;;;;;16,0;;;;;;11,0;;11,0;;;;1,0;1,0;;4,0;18,0;1,0;3,0;17,0;;5,0;;;;8,0;27,0;20,0;2,0;2,0;;;17,0;5,0;2,0;;;;;22,0;;1,0;;;1,0;;;4,0;;;;3,0;;;7,0;;;2,0;6,0;;4,0;;;5,0;7,0;;3,0;;;6,0;;6,0;13,0;;;;2,0;48,0;1,0;1,0;;;;15,0;;2,0;4,0;;1,0;;;31,0;;;;;;2,0;;;1,0;;;;;14,0;2,0;;;6,0;;;;63,0;4,0;2,0;2,0;;1,0;;;;2,0;;;;5,0;;;22,0;7,0;7,0;2,0;;;;;2,0;11,0;;141,0;;;33,0;3,0;3,0;62,0;4,0;4,0;;25,0;;1,0;2,0;2,0;;;;7,0;;3,0;;;;;;5,0;;;;;;;12,0;;;;;;;4,0;;;;;;;;;6,0;1,0;;;;2,0;2,0;;;;;10,0;;;;;;;;;1,0;;2,0;;1,0;;;1,0;2,0;;4,0;;3,0;;;9,0;;;1,0;;1,0;;;;;3,0;;2,0;1,0;;;;;1,0;;;5,0;;10,0;1,0;24,0;;;15,0;;;;19,0;;;1,0;;2,0;;;;;;;;;2,0;;;1,0;7,0;;;;;;;2,0;;;;;;;23,0;30,0;;;;1,0;;;;;;10,0;;;;3,0;;2,0;;1,0;;5,0;;;13,0;;;;;4,0;;;4,0;;;;;;;;;;;;;;;;;;;;;2,0;2,0;2,0;;;;;15,0;;7,0;;2,0;;;8,0;24,0;;;2,0;3,0;;;;4,0;;;;;1,0;;;;1,0;;;6,0;;;;;2,0;;;5,0;;;;;;1,0;;;;1,0;;;;;;;;;;;;;;;;;;1,0;;;;;;;;;;;;;;;;;;1,0;;;;;;;;;;12,0;;2,0;1,0;;;2,0;;;;7,0;3,0;;2,0;;;;2,0;1,0;1,0;;;;;;;;;2,0;;;;;;;8,0;1,0;2,0;;;;;;;;3,0;;;;;;2,0;;;;;;;;;3,0;;;;;;;;2,0;;4,0;;3,0;;;;;3,0;;;7,0;;1,0;;;1,0;;;;;;;;;2,0;;;;;;;;;;2,0;;;;;;;;;;;;4,0;;;;;6,0;;;;;;;;;;;;;;;;2,0;;8,0;5,0;;;;;;;1,0;;;;;;;;;;9,0;;;;;;;;;;;;;;;;;;3,0;;1,0;;1,0;;;;;;;;;2,0;2,0;;1,0;;;3,0;2,0;;;;;1,0;;;;;;;;;;;;;;;;;;;;;;;;;;;;;;;;;;;;;;;;;;;;;;;;1,0;1,0;;;;;;;;;5,0;;;;;;;;;;;;;;;;;1,0;;;;;;;;;;;;;;;;;;;;;;;;;;;;;;;;;;3,0;;;;;;;;;;;;;;1,0;;;;;;;;;;;;3,0;;;;;;1,0;;;;;;;;;;;;5,0;;;;;;;;;;;;;;;;;;;2,0;;;;2,0;3,0;;;;;;;;;;;;;;;;;;;;;;;;;;;;;;;;;;;;;;;;;;;;;;;;;;;;;;;;;;;;;;;;;;;;;;;;;;;;;;;;;;;;;;;;;;;;
ring;;12,0;;;;5,0;4,0;24,0;9,0;34,0;;;6,0;;71,0;67,0;2,0;;;4,0;6,0;;;;;;29,0;1,0;6,0;;;2,0;31,0;;6,0;;;;;;2,0;10,0;17,0;;;2,0;2,0;51,0;8,0;1,0;51,0;12,0;;;12,0;28,0;14,0;;;;52,0;22,0;1,0;;18,0;9,0;36,0;70,0;17,0;49,0;;8,0;3,0;;;23,0;;2,0;3,0;23,0;5,0;2,0;;87,0;10,0;;4,0;;4,0;102,0;130,0;;;6,0;;;;;76,0;2,0;;2,0;59,0;;4,0;5,0;79,0;2,0;2,0;;6,0;1,0;17,0;;1,0;40,0;161,0;52,0;5,0;9,0;12,0;;;;;;1,0;;2,0;;;2,0;13,0;;4,0;;9,0;;;;;;;16,0;2,0;;;37,0;2,0;;;1,0;;;;3,0;16,0;;1,0;13,0;;2,0;31,0;;2,0;;8,0;6,0;1,0;2,0;11,0;;7,0;5,0;4,0;;31,0;49,0;5,0;;;39,0;13,0;2,0;;1,0;;10,0;;3,0;7,0;;;41,0;;62,0;;1,0;;39,0;11,0;;;41,0;;9,0;;;;11,0;;8,0;7,0;;;;16,0;;8,0;38,0;33,0;;112,0;;;4,0;55,0;3,0;51,0;1,0;68,0;1,0;2,0;93,0;11,0;13,0;9,0;87,0;6,0;125,0;;;7,0;;;;;;1,0;8,0;20,0;;;4,0;;;18,0;2,0;;;6,0;;12,0;11,0;;;75,0;6,0;7,0;3,0;8,0;4,0;3,0;58,0;;30,0;;14,0;2,0;140,0;;;4,0;16,0;;1,0;;4,0;;4,0;;;7,0;1,0;8,0;;;;;3,0;14,0;4,0;34,0;3,0;;4,0;7,0;1,0;10,0;1,0;;16,0;5,0;13,0;11,0;;;8,0;22,0;70,0;8,0;;10,0;4,0;44,0;;13,0;12,0;;;14,0;5,0;8,0;;;3,0;1,0;23,0;19,0;50,0;19,0;;19,0;2,0;;9,0;32,0;6,0;4,0;1,0;18,0;3,0;;;;4,0;;4,0;8,0;2,0;4,0;5,0;1,0;7,0;19,0;;;19,0;8,0;3,0;1,0;2,0;7,0;;;;;22,0;79,0;21,0;25,0;17,0;4,0;3,0;4,0;6,0;20,0;10,0;;91,0;22,0;;;2,0;46,0;3,0;;99,0;5,0;1,0;;;;11,0;;;;;1,0;1,0;5,0;;;;;20,0;1,0;;3,0;;;;17,0;;;;;1,0;;;;;;7,0;7,0;;;;;;;6,0;2,0;;2,0;14,0;92,0;;2,0;;5,0;;;;;;;;;;;;1,0;;;;;;;;;2,0;;;11,0;1,0;;;;;9,0;18,0;;6,0;1,0;1,0;;;;1,0;;;;;;;;;;;7,0;;1,0;2,0;;;;;;;4,0;4,0;;;;;;;;;;;65,0;7,0;;;;;;;;;1,0;29,0;;6,0;;;;1,0;;13,0;1,0;19,0;;1,0;;;;;;5,0;;2,0;;;;;;;;9,0;2,0;;25,0;1,0;;;;4,0;;;5,0;;;;7,0;;;;;15,0;;;;;;;1,0;;4,0;;;2,0;1,0;;;;2,0;13,0;11,0;;;;;;8,0;3,0;;;4,0;;;;14,0;;1,0;;3,0;;;;;;;;;;1,0;4,0;;54,0;;5,0;;;1,0;5,0;;;;;3,0;;;;;6,0;;;11,0;2,0;;5,0;8,0;71,0;1,0;3,0;3,0;6,0;18,0;;;;;1,0;;5,0;;17,0;;3,0;;;;;;4,0;7,0;3,0;1,0;1,0;5,0;;6,0;;;;3,0;;;;1,0;;;10,0;24,0;;;;;4,0;;;10,0;2,0;;;;;;;;11,0;;3,0;;;3,0;;1,0;10,0;1,0;;;9,0;5,0;3,0;2,0;2,0;2,0;;;;;;;4,0;3,0;7,0;;;;;1,0;;;;6,0;;4,0;1,0;;30,0;;;;2,0;1,0;2,0;;;;;;;;;;;;;;;;;;;;;;;;;;;1,0;;;1,0;;;;;;;;;5,0;3,0;;;2,0;;;;;3,0;;;;;;;2,0;1,0;;;;;8,0;;;;;;;;;;2,0;;;;;;;1,0;;;1,0;;;;2,0;;1,0;3,0;;;;;;;;;;;;;48,0;1,0;;;;;;;;;;;;;;8,0;;;;3,0;;;;;2,0;;;;;;1,0;7,0;;1,0;;;;;;5,0;;;5,0;;;;6,0;1,0;;16,0;1,0;;35,0;3,0;3,0;;;2,0;;1,0;;;17,0;;;;6,0;;;;;;;;;1,0;;1,0;;;;;;;;;;;;3,0;;;1,0;4,0;;2,0;4,0;;;;;;6,0;;;;;;;;1,0;;;;;;;10,0;;;;;;6,0;;;;;;;;;;2,0;;;;;;
rotatable;;1,0;;;;13,0;1,0;9,0;5,0;12,0;2,0;;1,0;;131,0;24,0;4,0;;;;;5,0;;2,0;;;;2,0;;;1,0;;16,0;;7,0;2,0;;;;2,0;;;6,0;;;;;31,0;3,0;12,0;16,0;1,0;;;2,0;10,0;9,0;1,0;;;13,0;;1,0;;5,0;3,0;3,0;3,0;2,0;4,0;1,0;;2,0;;;;;;;17,0;;5,0;;37,0;1,0;;5,0;;;1,0;57,0;;;2,0;;;;;3,0;1,0;;;16,0;4,0;;;43,0;;;;3,0;;1,0;;;10,0;54,0;62,0;;5,0;;1,0;;;;;;;1,0;1,0;;;61,0;;;;3,0;4,0;;;;;;12,0;;;;17,0;1,0;;;;;;;;6,0;;12,0;;;1,0;9,0;;1,0;;2,0;7,0;;;;;;1,0;;4,0;51,0;13,0;2,0;;42,0;32,0;;;;;;9,0;;;;;;45,0;;6,0;;;18,0;22,0;8,0;;;31,0;;4,0;;;;5,0;;;;;;;;;;7,0;16,0;;4,0;;;1,0;;1,0;;;114,0;;25,0;49,0;15,0;10,0;;3,0;4,0;4,0;;3,0;1,0;1,0;;;;;;11,0;18,0;;;;;;7,0;;1,0;;;;13,0;;;;9,0;;;;1,0;1,0;;2,0;;;;11,0;10,0;20,0;;;;;;;;;;;;8,0;;;7,0;;;;;3,0;;4,0;6,0;1,0;10,0;9,0;;6,0;2,0;;;6,0;;3,0;;;;16,0;;11,0;;;2,0;8,0;;;9,0;1,0;;;6,0;4,0;1,0;;;;1,0;9,0;;9,0;;;2,0;;;13,0;2,0;14,0;7,0;;2,0;5,0;;;;11,0;3,0;14,0;8,0;;;;2,0;2,0;;8,0;;;2,0;;4,0;;2,0;;;6,0;22,0;;47,0;57,0;4,0;1,0;1,0;111,0;;1,0;3,0;11,0;;51,0;;1,0;;;4,0;;7,0;;1,0;;;;;1,0;;;;;;;;;;;6,0;;;;;;;;2,0;;;;;;;;;;1,0;;;;;;2,0;;;1,0;1,0;;;;7,0;;4,0;;;;;2,0;;;;;1,0;;;;;;;;;1,0;;;;;;;6,0;;;;;2,0;4,0;8,0;;6,0;;;;;;;;;;;;;1,0;;1,0;;31,0;;3,0;;;;;;;;;;;;;;;;7,0;;;;3,0;2,0;;;;1,0;;;;;;6,0;;2,0;;;;;;1,0;;;;;;;5,0;;;;;;;1,0;;;;;;;;;8,0;;;;;;;;2,0;;1,0;6,0;;2,0;;;;;;;;;;;6,0;;;;;;;;;;;;11,0;;;;;;;;;;;3,0;5,0;;1,0;;;;;;;;;;;;2,0;;3,0;;;9,0;;;;;;8,0;;;;;1,0;;;;;;;;;1,0;;6,0;6,0;3,0;;;15,0;1,0;15,0;;;1,0;;;;8,0;3,0;5,0;;4,0;2,0;;;;3,0;;4,0;2,0;;;4,0;5,0;;7,0;;;;;;;;;;2,0;;;;;;;4,0;;1,0;12,0;;;;4,0;;;;7,0;;;;7,0;4,0;;;53,0;;1,0;;;;;;3,0;;;;;1,0;;4,0;;;4,0;;;;10,0;;;;;3,0;;;;;;;;;4,0;;;;;;;;;;;;;;;;;;;;;;;;;;;;;;;;;;;;;;;;;;;;4,0;;;;;;3,0;;1,0;;;;;;;;;;;;;;1,0;;;2,0;;;;;;;;;;;5,0;10,0;;;;;;;;;;;;;;;;;;;;;;8,0;;;;;;;;;;;;;3,0;;7,0;;;;;3,0;2,0;;;;;;;;;1,0;;;2,0;;;;;;2,0;;;;;;;;6,0;;;1,0;;;;1,0;;;1,0;;1,0;;;4,0;8,0;;;2,0;;;;;;;;;;;5,0;;;;;;;;;;;;;;;;;4,0;1,0;;;;;;;;;;;;;;;;;;4,0;;;;;;;;;;;;;;;;;;;;;;;;;;
rotatably;;6,0;;;;4,0;;27,0;;4,0;;;;;27,0;13,0;7,0;;;;2,0;;;2,0;;;;;;;;;11,0;;1,0;;;;;;;;2,0;;;;;29,0;;5,0;16,0;;;;7,0;4,0;6,0;;;;3,0;;1,0;;;;;2,0;9,0;8,0;;;5,0;;;3,0;;;;1,0;;;;17,0;;;;;2,0;2,0;28,0;;;;;;;;2,0;;;;8,0;2,0;;;1,0;;;;;;;1,0;;8,0;45,0;15,0;;1,0;;;;;;;;;;2,0;;;2,0;;;;3,0;;;;;;;8,0;;3,0;1,0;19,0;;1,0;;;;;;;3,0;;12,0;;;;55,0;;;;;1,0;;;1,0;;;;;;18,0;24,0;5,0;;1,0;19,0;;2,0;;1,0;;3,0;;;;;;110,0;;;;;2,0;6,0;3,0;;;3,0;2,0;1,0;;;3,0;;3,0;3,0;;;;;9,0;;;18,0;20,0;;6,0;;;2,0;;1,0;3,0;;66,0;;10,0;61,0;6,0;;;3,0;2,0;10,0;;15,0;;;;;;;;5,0;27,0;;5,0;;;;24,0;1,0;;;;;3,0;;;;;;4,0;;6,0;;1,0;1,0;;;;;;17,0;;;;;;;;;;;;;;;1,0;;;;;;5,0;3,0;27,0;;6,0;4,0;;2,0;3,0;;;3,0;;2,0;;6,0;;5,0;;89,0;1,0;;;1,0;3,0;;13,0;1,0;;;1,0;1,0;;;;;;4,0;;6,0;1,0;;3,0;;;44,0;3,0;7,0;;;4,0;1,0;;;;21,0;1,0;4,0;2,0;24,0;;;3,0;;5,0;;;;1,0;;;;;;;7,0;10,0;1,0;23,0;20,0;;;;31,0;;;2,0;10,0;1,0;80,0;1,0;2,0;;1,0;3,0;4,0;7,0;;;;;;;;;;;2,0;;;;;;;;;1,0;;;;;;;;;;;;;;;;;25,0;;;;;;;2,0;25,0;5,0;;;1,0;4,0;;1,0;;;;;;;;;;;;;;;;;;;;;;;;;;;;;;;;;3,0;;1,0;;;;;;;;;;;;;;;;;22,0;;;;2,0;;;;;;;2,0;;;;;;;1,0;;2,0;;4,0;;;;;1,0;;;;;1,0;2,0;;;;;;;;2,0;;;;;;;;;;;;;;2,0;;;15,0;;;1,0;;;1,0;;;;;;;;;;2,0;;;;;;;3,0;;;1,0;;;;7,0;;;;;;5,0;3,0;;1,0;5,0;;;;2,0;;;;;;;;;8,0;3,0;;;;;;;;;;;;;;;;;;;8,0;;;;;;;;;;;;;;;;2,0;;;;;;;2,0;3,0;;;5,0;11,0;6,0;;;;;;;1,0;;3,0;;5,0;;;;;;3,0;;;;;5,0;10,0;2,0;;;3,0;;;;;1,0;;;;;;2,0;;;1,0;1,0;;;10,0;;;4,0;5,0;1,0;1,0;;3,0;;;;;6,0;;;;;;;3,0;;;;2,0;;;;;;;2,0;;;1,0;;;;;;;;;;;;;;;;3,0;;3,0;;;;;;;;;;;;;;;;;;;;;;;;;;;;;;;;;;;;;;;;;;;;24,0;;;;;;9,0;;;6,0;;;;;;;;;;;;;;;;;;;;;;;;;;8,0;12,0;;;;;;;;;;;;;;;;;;;;;;;;;;;;;;;;;;;;;;2,0;;;;;;;;;;;;;;;;;1,0;;;;;;;;;;;;;25,0;;2,0;;;;;;;;;;;;;;;;;24,0;;;;;;;;;;;3,0;;14,0;;;;;;;;;;;;;;;;;;;;;;;;;;;;;;;;;;;;;;;;3,0;3,0;;;;;;;;;;;;;;;;;;;;;
rotate;;11,0;8,0;;;178,0;11,0;52,0;14,0;33,0;5,0;;2,0;9,0;343,0;106,0;11,0;1,0;;;7,0;45,0;3,0;;;;3,0;;;3,0;3,0;;133,0;1,0;79,0;18,0;3,0;10,0;1,0;1,0;26,0;;2,0;;21,0;19,0;18,0;115,0;17,0;39,0;17,0;8,0;;1,0;129,0;4,0;47,0;;;1,0;8,0;;5,0;;9,0;1,0;15,0;30,0;22,0;24,0;5,0;;25,0;;;12,0;3,0;2,0;1,0;204,0;18,0;19,0;1,0;51,0;;15,0;;;1,0;;197,0;;;;2,0;;;;55,0;6,0;12,0;4,0;74,0;29,0;2,0;4,0;114,0;14,0;23,0;;16,0;13,0;;1,0;1,0;33,0;213,0;152,0;6,0;25,0;9,0;4,0;2,0;5,0;22,0;2,0;;;;26,0;;27,0;99,0;6,0;;;8,0;18,0;4,0;;4,0;;;37,0;3,0;;;17,0;31,0;1,0;;3,0;2,0;2,0;2,0;1,0;86,0;;64,0;4,0;1,0;5,0;219,0;1,0;2,0;;5,0;28,0;;;13,0;;;2,0;11,0;12,0;73,0;75,0;8,0;;19,0;76,0;;3,0;14,0;9,0;;22,0;;;;;;27,0;;18,0;;;8,0;27,0;17,0;11,0;1,0;276,0;;7,0;;;5,0;23,0;1,0;6,0;74,0;;;;33,0;;3,0;36,0;57,0;;8,0;3,0;12,0;;;23,0;30,0;;288,0;1,0;184,0;73,0;41,0;56,0;10,0;17,0;22,0;10,0;3,0;22,0;;8,0;111,0;;;3,0;15,0;35,0;32,0;9,0;;1,0;;;21,0;11,0;17,0;;1,0;;4,0;11,0;;;7,0;;13,0;;11,0;4,0;15,0;;;20,0;1,0;22,0;2,0;35,0;2,0;;;7,0;1,0;8,0;;3,0;1,0;1,0;1,0;18,0;1,0;;7,0;;4,0;;;3,0;95,0;23,0;17,0;;6,0;4,0;2,0;9,0;12,0;1,0;2,0;20,0;;29,0;6,0;3,0;;2,0;2,0;49,0;15,0;1,0;;;87,0;;12,0;10,0;1,0;2,0;4,0;1,0;3,0;;;;1,0;36,0;5,0;14,0;2,0;1,0;8,0;1,0;;19,0;43,0;135,0;16,0;2,0;2,0;20,0;3,0;14,0;7,0;44,0;34,0;46,0;9,0;;;9,0;;10,0;11,0;;3,0;4,0;6,0;3,0;;4,0;1,0;;23,0;13,0;79,0;47,0;;141,0;25,0;1,0;6,0;210,0;;9,0;;9,0;;84,0;2,0;13,0;1,0;3,0;19,0;4,0;15,0;1,0;8,0;4,0;;;;15,0;1,0;1,0;;28,0;;10,0;3,0;;;;6,0;2,0;2,0;;2,0;;;4,0;18,0;;;;;1,0;;2,0;;11,0;;;4,0;;1,0;1,0;13,0;;11,0;14,0;20,0;;;4,0;43,0;;16,0;14,0;2,0;1,0;;1,0;1,0;4,0;2,0;;1,0;;8,0;;;18,0;;5,0;;3,0;;5,0;1,0;2,0;2,0;;16,0;;4,0;2,0;5,0;16,0;21,0;10,0;;40,0;29,0;;3,0;;3,0;19,0;2,0;1,0;;;;9,0;1,0;;2,0;;61,0;;;32,0;3,0;;1,0;;;;2,0;6,0;6,0;;1,0;;4,0;;23,0;;;3,0;7,0;8,0;;;;2,0;;;;;;21,0;;4,0;4,0;;3,0;;;113,0;;;;13,0;;;14,0;;;;4,0;;;11,0;;;20,0;1,0;;5,0;;2,0;3,0;4,0;;1,0;;;1,0;;1,0;5,0;;5,0;;;;;2,0;;;;6,0;;;;11,0;;;;1,0;7,0;5,0;4,0;;1,0;16,0;1,0;21,0;;1,0;;;8,0;3,0;2,0;;;2,0;1,0;6,0;1,0;2,0;;1,0;;;;;13,0;;;8,0;;4,0;;1,0;4,0;;6,0;;2,0;;;81,0;12,0;1,0;1,0;;;6,0;;;14,0;;12,0;18,0;;;2,0;;1,0;3,0;3,0;1,0;1,0;12,0;2,0;3,0;;9,0;;4,0;1,0;;97,0;;11,0;18,0;3,0;;;;;;9,0;;7,0;4,0;4,0;13,0;42,0;;16,0;;2,0;1,0;;1,0;;2,0;;;2,0;;;2,0;;;;1,0;;23,0;147,0;;4,0;4,0;5,0;;;;16,0;;1,0;;5,0;19,0;;;15,0;;5,0;7,0;21,0;;;6,0;3,0;;;;4,0;2,0;1,0;11,0;4,0;7,0;7,0;1,0;;;4,0;;;;2,0;3,0;;;;;1,0;;4,0;;1,0;3,0;;;;;;;;;;;;;;;;;;;1,0;2,0;;;;;;;2,0;4,0;;;6,0;8,0;3,0;;4,0;;;;;3,0;3,0;;23,0;;;;;;1,0;;;2,0;;;;;1,0;;2,0;;;3,0;;;;;;;;;;;;;;;2,0;;69,0;10,0;4,0;1,0;;;;;;1,0;2,0;;5,0;;1,0;;;;;;;;;9,0;2,0;;;5,0;;;;;;2,0;;;22,0;1,0;30,0;2,0;24,0;;1,0;11,0;;;;;;;;;;;;2,0;;;;;;;;;;3,0;;1,0;17,0;1,0;22,0;;10,0;;;2,0;;3,0;;;;;4,0;4,0;20,0;15,0;;;;1,0;;;;;;;;4,0;3,0;;7,0;;;5,0;17,0;;;;;;;;3,0;;1,0;;4,0;5,0;;;1,0;;;;;2,0;1,0;;4,0;;;;3,0;1,0;1,0;;2,0;;;;2,0;;;;5,0;4,0;;;;;4,0;;;;;;6,0;;;;;10,0;
rotation;;13,0;5,0;;;290,0;10,0;28,0;24,0;27,0;23,0;;6,0;;509,0;125,0;1,0;;;15,0;21,0;37,0;8,0;1,0;;;17,0;3,0;;4,0;22,0;1,0;75,0;;63,0;6,0;8,0;2,0;;1,0;6,0;1,0;46,0;1,0;69,0;18,0;133,0;127,0;11,0;25,0;14,0;50,0;7,0;;32,0;6,0;18,0;19,0;34,0;;22,0;1,0;9,0;;22,0;3,0;1,0;19,0;26,0;13,0;4,0;;18,0;1,0;;8,0;5,0;;4,0;115,0;3,0;14,0;2,0;60,0;1,0;9,0;;;1,0;;103,0;;;;1,0;2,0;6,0;;50,0;34,0;7,0;2,0;63,0;29,0;;4,0;52,0;2,0;11,0;72,0;11,0;17,0;6,0;;;30,0;71,0;135,0;1,0;35,0;18,0;1,0;13,0;11,0;17,0;7,0;;1,0;1,0;22,0;;24,0;98,0;;30,0;;14,0;18,0;2,0;;7,0;;;70,0;14,0;1,0;;31,0;13,0;12,0;;2,0;1,0;4,0;;;86,0;;65,0;7,0;6,0;2,0;175,0;2,0;3,0;;4,0;20,0;;;23,0;;;1,0;28,0;26,0;19,0;20,0;5,0;;2,0;34,0;;;1,0;1,0;;27,0;;;;;1,0;20,0;;38,0;;1,0;;13,0;1,0;6,0;1,0;155,0;4,0;;;;7,0;13,0;;;13,0;;;;1,0;;;18,0;43,0;;9,0;;8,0;;;9,0;17,0;;255,0;;96,0;61,0;57,0;39,0;29,0;12,0;12,0;12,0;4,0;40,0;6,0;3,0;4,0;;;;1,0;60,0;43,0;5,0;;2,0;;;13,0;;;;1,0;;7,0;11,0;;1,0;8,0;;9,0;;11,0;2,0;14,0;;;10,0;5,0;9,0;13,0;31,0;8,0;2,0;4,0;;;15,0;;;;;24,0;17,0;;;;;10,0;;3,0;5,0;7,0;11,0;3,0;9,0;12,0;11,0;9,0;7,0;1,0;1,0;;16,0;3,0;;15,0;4,0;;7,0;;21,0;;;1,0;1,0;36,0;;12,0;3,0;;;2,0;2,0;;;;3,0;;31,0;1,0;6,0;;3,0;12,0;;16,0;8,0;18,0;18,0;29,0;10,0;1,0;22,0;;;3,0;42,0;28,0;67,0;16,0;18,0;;2,0;;9,0;3,0;;;5,0;1,0;;1,0;3,0;;4,0;30,0;;21,0;57,0;141,0;;40,0;;;76,0;2,0;5,0;1,0;19,0;3,0;54,0;;10,0;;;5,0;5,0;14,0;1,0;3,0;;;4,0;;10,0;3,0;2,0;;26,0;1,0;33,0;42,0;15,0;6,0;19,0;10,0;2,0;;;;;;2,0;7,0;;;;3,0;6,0;;1,0;11,0;12,0;5,0;49,0;22,0;;2,0;32,0;9,0;;3,0;59,0;9,0;3,0;;5,0;60,0;1,0;25,0;;1,0;13,0;6,0;3,0;21,0;2,0;2,0;5,0;9,0;;16,0;;;23,0;;;;2,0;;11,0;4,0;;;7,0;32,0;1,0;32,0;6,0;3,0;;17,0;10,0;;47,0;79,0;;;9,0;1,0;6,0;1,0;5,0;;6,0;;3,0;;;1,0;;99,0;;6,0;17,0;;;7,0;;1,0;;30,0;2,0;39,0;;;;;;1,0;;2,0;;16,0;47,0;;;;2,0;;;;;2,0;4,0;;2,0;15,0;16,0;;;;50,0;;5,0;;5,0;;;6,0;1,0;;;;;;12,0;;;16,0;;;;;2,0;4,0;6,0;;1,0;;1,0;22,0;;;10,0;;12,0;;3,0;;;;;;;3,0;;;;4,0;;;;;3,0;1,0;;;;1,0;;12,0;;1,0;4,0;;;;;;;20,0;;1,0;;;;4,0;1,0;;2,0;;1,0;3,0;;1,0;;4,0;;;;;2,0;;3,0;;1,0;9,0;4,0;;1,0;;1,0;3,0;;;;94,0;2,0;20,0;;;;3,0;3,0;1,0;8,0;;1,0;2,0;;38,0;;1,0;4,0;1,0;2,0;;59,0;3,0;1,0;5,0;;;;2,0;2,0;;1,0;;2,0;3,0;2,0;17,0;10,0;;36,0;;;2,0;;;;5,0;;;3,0;2,0;;;;;;1,0;1,0;20,0;19,0;3,0;14,0;3,0;1,0;;;;8,0;;;;5,0;8,0;;;2,0;;6,0;10,0;6,0;2,0;;1,0;2,0;;;1,0;5,0;;9,0;9,0;7,0;;;4,0;;3,0;5,0;;;;3,0;;;;;;;;;3,0;4,0;2,0;;;;;;;;;3,0;;;;;;10,0;;;;21,0;243,0;11,0;;1,0;;;;1,0;;;;24,0;2,0;24,0;;;1,0;;;;2,0;;1,0;2,0;;6,0;;14,0;;7,0;;;;;;;1,0;;;9,0;;;1,0;;;;;1,0;;;;;;;;;;1,0;6,0;13,0;;;;;1,0;;9,0;;;1,0;;;;;;23,0;1,0;;1,0;;;;3,0;;;;8,0;;;;;;;;2,0;4,0;;32,0;;15,0;;2,0;;;;;5,0;;;2,0;;;;;;;;;;;;;;;5,0;;4,0;2,0;;8,0;;;;;1,0;1,0;2,0;;18,0;;;6,0;4,0;9,0;;7,0;2,0;;2,0;;;4,0;;;;;;12,0;4,0;8,0;;;;1,0;;;2,0;1,0;;;;1,0;4,0;9,0;;;;;2,0;;;;;;;;;;;;;;;;;3,0;1,0;;1,0;5,0;;1,0;;13,0;;1,0;;2,0;;;;;;;;;;;;;;
rotational;;2,0;;;;64,0;;5,0;2,0;1,0;;;;;110,0;15,0;;7,0;;;6,0;;;1,0;;;;;1,0;;;;4,0;;6,0;;1,0;2,0;;;3,0;2,0;3,0;;12,0;5,0;6,0;10,0;1,0;4,0;6,0;2,0;;;44,0;1,0;31,0;3,0;;;11,0;;;;4,0;;1,0;1,0;;8,0;1,0;;3,0;;;;;;1,0;30,0;;3,0;;10,0;;;;;2,0;;6,0;;;;;;;;9,0;;;;3,0;6,0;;;16,0;;12,0;;1,0;1,0;;;;4,0;20,0;22,0;;11,0;;;1,0;4,0;;;;;1,0;5,0;;3,0;12,0;;5,0;;2,0;3,0;;;;;;26,0;;;;5,0;5,0;5,0;;;;2,0;;;6,0;;2,0;8,0;;5,0;15,0;;1,0;;;5,0;;;;;;;7,0;2,0;16,0;16,0;;;;9,0;;;2,0;;;12,0;;;;;;12,0;;5,0;;;;1,0;1,0;;;73,0;15,0;;;2,0;2,0;;;;29,0;;;;2,0;;;;22,0;;;;;;;6,0;3,0;;44,0;;36,0;12,0;18,0;6,0;60,0;2,0;1,0;1,0;2,0;;;6,0;120,0;;;;1,0;9,0;;6,0;;;;;2,0;;;;;;;2,0;;7,0;;;16,0;;;;3,0;;;2,0;;3,0;;5,0;2,0;;;;;2,0;;;1,0;1,0;2,0;2,0;;;;;1,0;;;;7,0;6,0;10,0;;;1,0;6,0;;1,0;;;;;;1,0;1,0;;1,0;;11,0;;;;;16,0;;5,0;1,0;;;7,0;1,0;;;2,0;;;9,0;;2,0;;2,0;;;7,0;22,0;4,0;11,0;16,0;;;2,0;2,0;;;12,0;;1,0;;2,0;;;;;;;;2,0;;;3,0;;;;3,0;;2,0;12,0;147,0;19,0;6,0;1,0;;61,0;;1,0;;1,0;;18,0;;;;;1,0;1,0;;;;;;;;;1,0;;;7,0;2,0;5,0;5,0;;;;;4,0;;;;;;1,0;3,0;;;;2,0;;;8,0;;8,0;;10,0;;;;;14,0;;5,0;14,0;3,0;;;;3,0;;11,0;16,0;1,0;1,0;;;8,0;;;;;;1,0;;;6,0;;1,0;;;;;;1,0;;;8,0;;1,0;;;;1,0;10,0;;9,0;5,0;;;2,0;;;;;;1,0;;;;;;;4,0;;;1,0;;;;;;;;;;;;;2,0;;;;6,0;;;4,0;3,0;;;1,0;;;;;;2,0;;;4,0;;;;;2,0;;;;2,0;3,0;;1,0;;;;;;;;;;1,0;;;1,0;;;1,0;;;;;;8,0;;;;;3,0;;2,0;;;;;;;3,0;;;;;;;;;;4,0;;;;;;1,0;;;;;1,0;2,0;;;;5,0;;5,0;;;;;;;;;;;;;;1,0;;;3,0;;1,0;;;;;1,0;;;;;;;;;1,0;;;;;;;;;4,0;3,0;;;;;;;;;5,0;;;14,0;;;3,0;;;;;;;;;1,0;;;4,0;;;4,0;;;;;;5,0;;;;2,0;;;;;;;1,0;;10,0;;;;;;;;;1,0;;;;;5,0;;;3,0;;;;2,0;;;5,0;2,0;;;;;;1,0;;;;;;;;;;;;3,0;;;;;;;;;;;;;;;;;;;;;;;;;;;;;;2,0;2,0;5,0;;;;;1,0;;;;;;1,0;;;6,0;;;;;;;;;;;;;;5,0;;2,0;;;;;;;;1,0;;;;;;;;;;;;;;;;;;;;4,0;11,0;;;;1,0;;;;;;;1,0;;;;;;;;;;;;;;;1,0;;;;;;;;;3,0;;16,0;;2,0;;1,0;;;;;;;;;;;;;;;;;;;;3,0;;;7,0;;2,0;;;;;;;;1,0;;;;3,0;;;1,0;1,0;;;1,0;;;;;;;;;;;;4,0;;10,0;;;;;;;;;;;;;4,0;;;;;;;2,0;;;;;;;1,0;;;;;;;;;;2,0;;;;1,0;;;;;;;;;;;;;;;;;;;;;
screw;;1,0;2,0;;;2,0;1,0;17,0;8,0;6,0;;;4,0;;27,0;18,0;;;;;1,0;;;1,0;1,0;;;2,0;;;;;26,0;;3,0;4,0;;;;;;;7,0;;5,0;6,0;;78,0;4,0;;27,0;3,0;;;29,0;1,0;18,0;;;;28,0;4,0;;;1,0;;3,0;35,0;3,0;7,0;;;;;;4,0;;;;8,0;1,0;2,0;;43,0;;;;;1,0;3,0;58,0;;;;;;;;1,0;2,0;;6,0;20,0;14,0;1,0;;5,0;1,0;;;46,0;2,0;3,0;;;15,0;26,0;66,0;;1,0;6,0;;;;;;;;;;;;10,0;;;;6,0;;;;;1,0;;2,0;;;;5,0;;14,0;;;;;1,0;;30,0;1,0;1,0;;;1,0;12,0;;;;;1,0;;;;;;5,0;;;14,0;28,0;;;8,0;11,0;;;;2,0;2,0;3,0;;;1,0;;;48,0;;8,0;;;;6,0;;1,0;;16,0;;5,0;;;;8,0;;1,0;3,0;;;;7,0;1,0;;104,0;31,0;;14,0;1,0;;;;5,0;;;82,0;8,0;1,0;61,0;21,0;25,0;8,0;;1,0;14,0;;;1,0;;;;;;;1,0;17,0;;8,0;;;;19,0;;2,0;;1,0;;5,0;4,0;;;4,0;2,0;1,0;;9,0;;4,0;1,0;;11,0;;5,0;9,0;42,0;4,0;;4,0;3,0;;2,0;;;;;;5,0;;;8,0;;;;4,0;2,0;;5,0;32,0;20,0;11,0;14,0;4,0;7,0;2,0;;;;;4,0;1,0;2,0;1,0;8,0;;19,0;6,0;;12,0;3,0;16,0;;45,0;19,0;;;3,0;20,0;;;;;;3,0;2,0;18,0;;2,0;23,0;;13,0;;52,0;48,0;8,0;;;3,0;;4,0;;5,0;1,0;4,0;1,0;12,0;;;;1,0;;;;3,0;2,0;;1,0;6,0;;;;3,0;25,0;4,0;25,0;40,0;;;;6,0;;1,0;3,0;9,0;;15,0;15,0;;;3,0;152,0;;1,0;7,0;1,0;;;;;2,0;;;;;;;1,0;;;;;;;;;;;;8,0;;;;;2,0;;;;;1,0;;;;;;;;;;7,0;;;4,0;4,0;;;;5,0;6,0;;;;;;;;;;;;;;;;;;2,0;;;;;2,0;1,0;;;;;29,0;1,0;;1,0;;;;;;;;;;;;;;;;;14,0;;;;;;;;;;;;;;;;;;12,0;;;;3,0;26,0;;;;;;;;;;9,0;;7,0;;;;;;;;;;;;;;;;16,0;;;;;;;16,0;;;11,0;;;;;;;;;;;;;2,0;1,0;;;;;;;;;2,0;;;;2,0;;;;;6,0;;;;;1,0;;6,0;;;;;;;2,0;;;;;12,0;;;;;;;;;;;;;;;;1,0;;;10,0;;9,0;;;;18,0;;;;;;;;;2,0;1,0;;;;;;;1,0;8,0;;;2,0;3,0;42,0;;;6,0;;;;;;4,0;1,0;9,0;;;;4,0;;2,0;3,0;3,0;2,0;;14,0;;;1,0;;;;;;;;;;;;;1,0;3,0;;;1,0;;;6,0;;1,0;10,0;10,0;7,0;;;7,0;;;;;4,0;9,0;;1,0;1,0;;5,0;2,0;4,0;;;;;;6,0;;;;;;;4,0;;;;8,0;10,0;;;;;;;;;3,0;;;;37,0;1,0;;;;;;;;;;;;;;;;;;;;;;;1,0;;;;;;;;4,0;;;;6,0;;;;;;;;;;;;;;12,0;;;;;;;;;;4,0;;;;;;;;;;;;;;;;;;;;1,0;;;;;;;;;1,0;;;1,0;;;;;;;;;;;;;;;;;;;;;;;11,0;;;5,0;;145,0;;;;;;;1,0;;;;;;;;1,0;;;;;;;;;;;;;;;3,0;;;;;;2,0;2,0;;;1,0;;;;;;;;;;;;;;;;;;;;3,0;;;;;1,0;;;;;;2,0;1,0;;;;1,0;;;;1,0;;;;;;;;;;;;;;;;1,0;;;;22,0;;;;;;;;;;;;;;;;;;;;;;
seat;;1,0;;;;2,0;;5,0;2,0;5,0;;;;;3,0;16,0;;;;;;1,0;;2,0;3,0;;;;;;;;3,0;;;1,0;;;;;;;1,0;;;;;9,0;;1,0;3,0;;;;2,0;;4,0;;;;8,0;2,0;;;10,0;;;9,0;4,0;8,0;;;;;;;;;;9,0;;;;18,0;1,0;;;;1,0;1,0;55,0;;;;;;;;4,0;;;;1,0;;;;;;;;2,0;;1,0;;1,0;1,0;40,0;20,0;;;;4,0;;;;;;;;;3,0;;2,0;;;;;;;;;1,0;;3,0;;2,0;;20,0;;;;;;;;;9,0;;;;;;;;;;9,0;1,0;;;;;;2,0;;;1,0;26,0;;;4,0;16,0;1,0;;;2,0;;1,0;;;3,0;;;6,0;;;;;;1,0;1,0;;;2,0;;;;;;1,0;;;1,0;;;;1,0;;2,0;4,0;17,0;;3,0;;;5,0;1,0;;7,0;;11,0;;13,0;36,0;1,0;;;2,0;7,0;;;2,0;;;;;;;;1,0;14,0;;;1,0;;;7,0;2,0;;;1,0;;2,0;;;;5,0;;;;9,0;;1,0;;;13,0;;;;48,0;;;;;;;;;;;14,0;1,0;;;1,0;;4,0;;;3,0;;2,0;16,0;;1,0;;3,0;;;;;16,0;;;1,0;;2,0;5,0;;2,0;4,0;1,0;6,0;;1,0;;2,0;7,0;;;;;1,0;1,0;;;;2,0;5,0;1,0;5,0;;2,0;;1,0;;;;4,0;;2,0;1,0;;;;10,0;3,0;4,0;1,0;;;;;1,0;6,0;;;11,0;2,0;;;;1,0;;;;17,0;1,0;1,0;;;;;3,0;;;;2,0;;9,0;;;1,0;11,0;;;2,0;2,0;;;;;;;;;;;;;;;;;;;1,0;;;;;;;;;;;2,0;;;;;;;6,0;;;;1,0;;5,0;;1,0;;;;3,0;3,0;;;;;;;;;;;;;;;;;;4,0;;;;;;;;;;;;;;;;;;3,0;;;;;;;;;;;;;;;;;2,0;;;;;;;;;;;1,0;;;;;;;;;;;10,0;1,0;;;;;;;;;;;;;;;;;;;;;;;;;;;;;;6,0;;;;;3,0;;;;;;3,0;;;;;;;;;1,0;;;1,0;;;;;9,0;;;;;;;;;;;;3,0;;2,0;;;;;8,0;;;;;;;;;;;;;;;;;;;;;;1,0;;;;4,0;;;;;;;;;;;1,0;;;;;;;;;;2,0;;;;;;4,0;;1,0;;;;;4,0;;;;;;;;;;2,0;1,0;;6,0;;;;;;1,0;;;3,0;;;;;;;;;;;;;;;;2,0;;;2,0;;;;1,0;;2,0;;1,0;;;;8,0;;;;;;;;21,0;;;;;;1,0;;;;;;;1,0;;;;;;;;;;1,0;;;;2,0;;;;;5,0;;;;;1,0;;;;;;;;;;;;;;;;2,0;1,0;;;;;;;;;;;;;;;;;;;;;;;;;;;;;;;;;;;;3,0;;;;;;;;;;;;;;;;;;;;;;;;;;;;;;;;;2,0;;;1,0;;;;;;;;;;;;;;;;;;;;;;;;3,0;;;;;;;;;1,0;;;;;;;;;;;;;;;;;;;;;;;;;;;;;1,0;;;2,0;;;;;;;2,0;;;;;;;;;;;;;;;;;;;;;;;;;;;;;;3,0;;;;;;;1,0;;;;;;;;;;;;;;;;;1,0;;;;;;;;;;;;;;;;;;;;;;;;;;
secure;;4,0;;;;14,0;27,0;12,0;4,0;12,0;1,0;;;;6,0;77,0;;;;;2,0;3,0;;5,0;;;;1,0;3,0;;1,0;;37,0;;4,0;2,0;;;;;3,0;;22,0;3,0;9,0;;;133,0;13,0;8,0;16,0;3,0;;;6,0;12,0;82,0;;;;28,0;;1,0;;9,0;;5,0;8,0;34,0;17,0;;;3,0;;;;;;7,0;21,0;1,0;10,0;;46,0;;;;;4,0;8,0;62,0;;;;;;6,0;;22,0;13,0;;;34,0;9,0;4,0;2,0;15,0;3,0;13,0;;7,0;;3,0;;;23,0;131,0;77,0;5,0;1,0;4,0;1,0;;;;;;;;;;;9,0;;;;7,0;;;;;8,0;3,0;27,0;4,0;;;10,0;1,0;6,0;;9,0;24,0;1,0;;1,0;36,0;;;;1,0;;20,0;;1,0;2,0;11,0;4,0;;;;4,0;7,0;1,0;1,0;1,0;32,0;5,0;;;20,0;27,0;;3,0;;10,0;;31,0;;;2,0;;;27,0;;14,0;1,0;;1,0;42,0;8,0;1,0;;3,0;;17,0;2,0;;;3,0;;4,0;6,0;;;;6,0;;1,0;55,0;152,0;;3,0;6,0;;6,0;;1,0;10,0;;136,0;2,0;3,0;211,0;15,0;5,0;1,0;24,0;14,0;23,0;7,0;4,0;1,0;1,0;;;;;;;81,0;;32,0;1,0;;;35,0;;1,0;;1,0;1,0;;2,0;;;6,0;3,0;11,0;;5,0;6,0;6,0;;;9,0;;33,0;24,0;112,0;4,0;;2,0;;;1,0;;;;12,0;12,0;5,0;18,0;12,0;21,0;;;;3,0;4,0;;5,0;16,0;;2,0;2,0;2,0;3,0;39,0;;;15,0;1,0;6,0;16,0;1,0;1,0;26,0;;19,0;;4,0;1,0;5,0;1,0;;10,0;2,0;;;3,0;23,0;26,0;;;22,0;18,0;8,0;11,0;10,0;2,0;;9,0;6,0;;;9,0;13,0;1,0;;;1,0;;1,0;;9,0;17,0;2,0;20,0;2,0;;;9,0;2,0;29,0;;;6,0;13,0;;1,0;1,0;23,0;;;;12,0;13,0;4,0;7,0;5,0;2,0;1,0;35,0;4,0;;15,0;13,0;;47,0;3,0;;2,0;1,0;5,0;;;1,0;20,0;;;;4,0;30,0;;;;2,0;;;;;;;2,0;;7,0;;;;;4,0;2,0;;1,0;;;8,0;;;;3,0;7,0;2,0;6,0;;;2,0;;;6,0;;2,0;;;;6,0;;4,0;;;;;;;7,0;2,0;;;;;;;1,0;;3,0;;;;;;;1,0;;5,0;2,0;;;;;6,0;18,0;;25,0;;;;;2,0;;;;;;1,0;;8,0;2,0;16,0;;4,0;1,0;;2,0;;;1,0;;;;;6,0;;3,0;;;;;;1,0;;;23,0;1,0;;;1,0;2,0;;1,0;;;;7,0;;29,0;1,0;;;;;3,0;;;;;;;;;3,0;14,0;;2,0;;18,0;1,0;4,0;27,0;7,0;7,0;3,0;1,0;;;;;5,0;2,0;;;;;18,0;4,0;1,0;1,0;6,0;;;;1,0;;;6,0;;;;5,0;;;;;6,0;;;;1,0;;;3,0;;3,0;;;1,0;;;;;;;10,0;4,0;;;;;;;;;4,0;;;;8,0;;3,0;;;;;;;;;37,0;;1,0;;;;;;;;;;;;32,0;;1,0;;19,0;;;;;20,0;;;;;9,0;;1,0;4,0;;4,0;9,0;;;;;8,0;;4,0;19,0;3,0;;16,0;3,0;2,0;1,0;;;14,0;2,0;1,0;1,0;;;;1,0;2,0;;8,0;7,0;;1,0;4,0;;3,0;;;;;11,0;1,0;;;11,0;;6,0;;;;;;;;;2,0;3,0;1,0;;;;1,0;;;;;;2,0;;;5,0;;;2,0;3,0;12,0;;4,0;;2,0;;;;1,0;11,0;1,0;6,0;;3,0;;;;;;;;;;;;;;;;;;;;;;;;;1,0;;;;2,0;;;;;;;1,0;;1,0;;;1,0;;;1,0;7,0;;;;;2,0;;;;;;;;;;;1,0;;4,0;;;;;;;;;;;;;6,0;;;;15,0;;;;;5,0;;;;;;;;;;;;;;;;6,0;;;;;;;;;;;1,0;;;;;;3,0;;;;5,0;3,0;2,0;;22,0;;;;;;;;;;;1,0;;;;;;;;2,0;;;;;1,0;;;;;9,0;2,0;1,0;;;7,0;;;;1,0;5,0;;;;;;;;;;;;;1,0;;1,0;;;;;1,0;;;;;;;1,0;;4,0;;7,0;;;;1,0;;;;;27,0;;;;;;;1,0;;;;1,0;;;;;4,0;;;;3,0;;;;;;;;;;;;;;;;1,0;
select;;9,0;8,0;1,0;;63,0;13,0;94,0;179,0;19,0;28,0;2,0;119,0;;33,0;299,0;17,0;4,0;7,0;9,0;29,0;168,0;33,0;7,0;4,0;38,0;126,0;37,0;1,0;11,0;68,0;27,0;222,0;22,0;339,0;71,0;24,0;129,0;7,0;1,0;396,0;4,0;42,0;23,0;98,0;31,0;154,0;431,0;228,0;260,0;13,0;83,0;6,0;15,0;44,0;31,0;86,0;2,0;13,0;7,0;9,0;15,0;69,0;18,0;67,0;59,0;145,0;27,0;327,0;7,0;68,0;3,0;105,0;1,0;;442,0;52,0;5,0;33,0;1492,0;18,0;200,0;4,0;207,0;7,0;83,0;1,0;3,0;1,0;52,0;78,0;23,0;3,0;34,0;1,0;29,0;47,0;6,0;384,0;23,0;11,0;6,0;102,0;213,0;1,0;27,0;29,0;17,0;456,0;118,0;3,0;101,0;3,0;5,0;21,0;569,0;190,0;183,0;7,0;121,0;2,0;;50,0;177,0;109,0;40,0;;11,0;6,0;69,0;;55,0;23,0;2,0;37,0;46,0;55,0;98,0;35,0;12,0;56,0;1,0;20,0;91,0;118,0;;1,0;9,0;329,0;22,0;34,0;1,0;52,0;84,0;52,0;22,0;201,0;;16,0;31,0;24,0;48,0;477,0;16,0;9,0;;256,0;134,0;5,0;27,0;41,0;1,0;;21,0;76,0;33,0;21,0;;4,0;2,0;4,0;20,0;2,0;;4,0;135,0;;50,0;5,0;3,0;5,0;11,0;;33,0;2,0;9,0;80,0;2,0;;6,0;;1,0;25,0;41,0;4,0;;4,0;14,0;59,0;28,0;8,0;;3,0;8,0;4,0;2,0;3,0;2,0;5,0;3,0;13,0;;2,0;;1,0;;22,0;;178,0;;49,0;6,0;11,0;41,0;3,0;7,0;26,0;17,0;;;15,0;;;8,0;18,0;1,0;;29,0;476,0;28,0;5,0;4,0;11,0;1,0;1,0;1,0;120,0;6,0;11,0;4,0;;2,0;2,0;;;17,0;25,0;;31,0;3,0;4,0;115,0;13,0;;15,0;5,0;19,0;10,0;4,0;17,0;48,0;1,0;9,0;2,0;12,0;119,0;16,0;15,0;1,0;6,0;25,0;14,0;;;;;3,0;;4,0;;2,0;40,0;1,0;2,0;2,0;2,0;22,0;57,0;;37,0;11,0;18,0;;;22,0;23,0;3,0;3,0;3,0;32,0;;;;2,0;21,0;4,0;16,0;;2,0;3,0;;;;2,0;;34,0;2,0;10,0;10,0;;;;25,0;16,0;3,0;18,0;2,0;;3,0;24,0;;;39,0;10,0;;6,0;16,0;234,0;6,0;2,0;25,0;6,0;;;16,0;;;1,0;;1,0;7,0;5,0;;13,0;12,0;;11,0;;11,0;11,0;4,0;;27,0;1,0;3,0;7,0;;;1,0;6,0;6,0;152,0;7,0;;1,0;19,0;3,0;14,0;20,0;5,0;4,0;;13,0;25,0;2,0;1,0;;1,0;18,0;39,0;39,0;34,0;18,0;23,0;30,0;7,0;2,0;10,0;;5,0;4,0;25,0;27,0;10,0;8,0;3,0;12,0;96,0;4,0;14,0;;236,0;30,0;24,0;106,0;3,0;17,0;15,0;720,0;;7,0;66,0;30,0;5,0;95,0;82,0;284,0;8,0;36,0;19,0;8,0;;;29,0;14,0;73,0;35,0;54,0;1,0;18,0;24,0;10,0;4,0;18,0;;;1,0;8,0;73,0;30,0;4,0;1,0;;5,0;517,0;7,0;48,0;9,0;40,0;4,0;82,0;2,0;9,0;16,0;66,0;6,0;3,0;;8,0;1,0;3,0;7,0;45,0;33,0;24,0;5,0;12,0;16,0;60,0;6,0;8,0;;19,0;87,0;48,0;1,0;9,0;4,0;66,0;4,0;4,0;63,0;;18,0;31,0;;3,0;1,0;19,0;9,0;4,0;5,0;11,0;23,0;5,0;4,0;28,0;;65,0;5,0;3,0;3,0;12,0;56,0;6,0;5,0;31,0;4,0;4,0;23,0;8,0;6,0;5,0;2,0;13,0;16,0;25,0;23,0;3,0;285,0;8,0;;7,0;7,0;72,0;6,0;6,0;2,0;7,0;22,0;;5,0;2,0;39,0;1,0;17,0;;31,0;16,0;22,0;15,0;10,0;6,0;1,0;1,0;31,0;;;5,0;;10,0;;10,0;21,0;9,0;25,0;;4,0;7,0;2,0;4,0;77,0;8,0;1,0;;;2,0;22,0;7,0;;26,0;2,0;13,0;14,0;;21,0;16,0;12,0;12,0;25,0;11,0;11,0;3,0;10,0;20,0;2,0;;9,0;4,0;10,0;28,0;1,0;;40,0;17,0;;115,0;12,0;;4,0;19,0;;1,0;9,0;10,0;19,0;11,0;;3,0;1,0;3,0;2,0;21,0;5,0;17,0;2,0;9,0;;23,0;1,0;;171,0;;;1,0;4,0;6,0;4,0;;;31,0;34,0;4,0;275,0;18,0;10,0;;8,0;;2,0;20,0;4,0;6,0;3,0;;1,0;;;1,0;2,0;;;22,0;1,0;;19,0;17,0;2,0;22,0;4,0;1,0;10,0;;;;3,0;2,0;4,0;14,0;;;;38,0;19,0;;2,0;13,0;81,0;;4,0;7,0;;5,0;1,0;1,0;;;1,0;1,0;;1,0;;1,0;;47,0;;2,0;7,0;4,0;17,0;2,0;2,0;1,0;34,0;14,0;4,0;;;1,0;6,0;13,0;;1,0;4,0;;1,0;6,0;1,0;;24,0;;;2,0;3,0;;3,0;;;22,0;1,0;;1,0;;5,0;6,0;2,0;89,0;47,0;;41,0;;10,0;24,0;10,0;;;;3,0;35,0;26,0;5,0;29,0;1,0;;6,0;8,0;33,0;15,0;8,0;51,0;13,0;8,0;46,0;6,0;5,0;2,0;;3,0;3,0;2,0;17,0;8,0;46,0;7,0;;6,0;9,0;;30,0;8,0;22,0;14,0;;23,0;;3,0;64,0;;8,0;7,0;1,0;13,0;3,0;88,0;18,0;;2,0;4,0;4,0;8,0;10,0;18,0;;1,0;;;2,0;;4,0;154,0;;13,0;1,0;5,0;5,0;;;;;3,0;19,0;4,0;12,0;17,0;11,0;1,0;3,0;9,0;18,0;;2,0;;1,0;;;20,0;18,0;3,0;1,0;;2,0;8,0;3,0;;3,0;;21,0;;3,0;1,0;;1,0;;2,0;8,0;20,0;;5,0;1,0;;4,0;64,0;;;3,0;;5,0;;32,0;1,0;2,0;17,0;3,0;3,0;4,0;;2,0;;6,0;;4,0;;;;7,0;1,0;2,0;;2,0;;4,0;6,0;5,0;8,0;;10,0;;3,0;;;13,0;;10,0;;1,0;;5,0;;12,0;4,0;7,0;;;2,0;29,0;;15,0;;2,0;3,0;3,0;2,0;;;;;6,0;6,0;;1,0;;67,0;4,0;10,0;11,0;5,0;14,0;19,0;;2,0;;15,0;;;9,0;;;1,0;1,0;8,0;1,0;8,0;;2,0;1,0;;5,0;3,0;1,0;20,0;6,0;5,0;1,0;;2,0;;;;25,0;2,0
separate;;2,0;;;;10,0;11,0;12,0;11,0;18,0;33,0;;24,0;;2,0;15,0;36,0;;;1,0;9,0;45,0;;21,0;1,0;;56,0;5,0;;;8,0;;33,0;;22,0;26,0;1,0;1,0;;;36,0;2,0;10,0;7,0;18,0;1,0;38,0;101,0;24,0;39,0;2,0;27,0;7,0;2,0;;11,0;65,0;4,0;;7,0;1,0;3,0;13,0;16,0;29,0;10,0;9,0;28,0;23,0;7,0;2,0;;36,0;2,0;;14,0;;;11,0;354,0;6,0;27,0;6,0;51,0;;7,0;1,0;;;14,0;116,0;;;1,0;1,0;5,0;11,0;;56,0;4,0;1,0;;51,0;32,0;5,0;9,0;43,0;5,0;16,0;9,0;6,0;7,0;;;;244,0;313,0;20,0;1,0;7,0;5,0;;5,0;14,0;14,0;6,0;;2,0;;12,0;1,0;;2,0;;2,0;;25,0;4,0;4,0;;151,0;;2,0;60,0;1,0;;4,0;15,0;30,0;;;12,0;1,0;11,0;8,0;3,0;34,0;;;20,0;2,0;12,0;95,0;;;;21,0;7,0;12,0;16,0;;;;14,0;;9,0;13,0;4,0;6,0;7,0;8,0;18,0;7,0;6,0;;14,0;2,0;49,0;6,0;;1,0;2,0;2,0;11,0;1,0;5,0;5,0;;2,0;16,0;;;;19,0;;1,0;3,0;;6,0;22,0;2,0;84,0;;7,0;3,0;12,0;;;;9,0;23,0;2,0;1,0;2,0;;5,0;9,0;2,0;95,0;5,0;29,0;3,0;;14,0;28,0;5,0;2,0;2,0;3,0;;5,0;4,0;;12,0;;;;4,0;36,0;25,0;18,0;9,0;;;;;51,0;4,0;;;;;;9,0;4,0;5,0;1,0;8,0;3,0;;2,0;5,0;25,0;14,0;;10,0;;6,0;33,0;40,0;3,0;;5,0;1,0;;30,0;;;;3,0;6,0;1,0;;5,0;18,0;;;1,0;2,0;;2,0;4,0;3,0;;;;1,0;4,0;1,0;;;1,0;7,0;1,0;6,0;53,0;10,0;14,0;;3,0;;;;2,0;3,0;4,0;;3,0;;;1,0;2,0;2,0;;;1,0;;1,0;1,0;6,0;;3,0;;1,0;1,0;;6,0;7,0;3,0;7,0;;;;;5,0;;;10,0;7,0;8,0;;20,0;3,0;;2,0;;;;2,0;;1,0;3,0;;;;5,0;5,0;;2,0;3,0;9,0;;9,0;1,0;3,0;8,0;;;;7,0;1,0;;8,0;;5,0;;;3,0;;;;;1,0;3,0;;;;;2,0;;;6,0;3,0;3,0;27,0;;5,0;;;;;;5,0;;2,0;;;4,0;;;;20,0;8,0;1,0;24,0;;;2,0;10,0;;10,0;5,0;13,0;;3,0;;;;;;;;;;;4,0;;3,0;;4,0;6,0;;;1,0;;;;4,0;4,0;5,0;;;4,0;;10,0;1,0;3,0;;;2,0;2,0;3,0;2,0;4,0;;;10,0;;;4,0;;3,0;2,0;1,0;1,0;;4,0;;2,0;2,0;1,0;;;3,0;;;;;2,0;;1,0;;;;9,0;1,0;3,0;2,0;;;;1,0;7,0;6,0;1,0;;6,0;1,0;9,0;;2,0;;3,0;;;;2,0;3,0;;15,0;;;;;12,0;28,0;;;;16,0;1,0;;4,0;1,0;;2,0;;6,0;2,0;;;1,0;11,0;;4,0;9,0;;2,0;;1,0;17,0;1,0;2,0;1,0;1,0;1,0;;;;3,0;;;;;14,0;;;7,0;3,0;;;;;4,0;2,0;2,0;;;3,0;;7,0;;6,0;;;7,0;;1,0;;;;;8,0;1,0;1,0;;;;;2,0;;;;2,0;;;65,0;;1,0;;;;;;13,0;2,0;2,0;1,0;;1,0;2,0;;1,0;2,0;1,0;;;4,0;;3,0;;3,0;;;;;;;;1,0;3,0;;;;;2,0;2,0;;2,0;1,0;;;;;;;;;2,0;1,0;;1,0;7,0;;;;;13,0;;2,0;;3,0;;;4,0;;1,0;2,0;2,0;1,0;4,0;;1,0;2,0;;;;;;;1,0;;2,0;1,0;;1,0;;;34,0;;;2,0;7,0;;4,0;21,0;1,0;;7,0;7,0;2,0;2,0;;;;4,0;;;;;;2,0;1,0;;2,0;2,0;;2,0;2,0;;;;;1,0;;;2,0;;6,0;3,0;2,0;;;1,0;;;;3,0;;;;9,0;;3,0;1,0;1,0;;;11,0;;;;3,0;47,0;;;2,0;;;10,0;;15,0;2,0;;;;;;1,0;1,0;;;;;;;;;;2,0;14,0;;;;;;4,0;3,0;57,0;;1,0;;;;5,0;;8,0;;;;;1,0;;;;2,0;;;;;5,0;1,0;;;;;;1,0;;;;1,0;9,0;;;;;;1,0;;1,0;;3,0;;7,0;;1,0;;;1,0;;;;;;;;2,0;;;;2,0;;1,0;1,0;;1,0;1,0;;;;87,0;;;;;;;1,0;6,0;;;1,0;;11,0;;;1,0;;;;;1,0;2,0;2,0;;1,0;4,0;;;;;1,0;;2,0;5,0;;;;;;;;;;;;;;;4,0;;;8,0;3,0;;;;;2,0;;;;;2,0;1,0;;;;16,0;;;;3,0;;;;;;;;;;;;14,0;;2,0;;;;;;;1,0;;;;;;1,0;;;;;;;2,0;;
series;;1,0;;;2,0;;4,0;2,0;2,0;2,0;6,0;;1,0;;;4,0;;;;;;74,0;1,0;1,0;;;;;;;4,0;1,0;8,0;;13,0;3,0;;;1,0;;27,0;1,0;;14,0;6,0;;31,0;23,0;19,0;9,0;;5,0;1,0;;8,0;;3,0;;;;1,0;;4,0;;10,0;;3,0;13,0;29,0;;3,0;;7,0;;;8,0;12,0;5,0;;279,0;;5,0;2,0;35,0;;2,0;;;;;17,0;;;;;5,0;2,0;;14,0;;;;3,0;11,0;;4,0;1,0;7,0;9,0;;;3,0;;;2,0;13,0;6,0;47,0;5,0;19,0;;;4,0;34,0;5,0;6,0;;;;;;18,0;4,0;;2,0;1,0;2,0;3,0;;;13,0;;;4,0;2,0;;;4,0;13,0;3,0;1,0;;8,0;4,0;7,0;5,0;8,0;;;1,0;;;31,0;;;;7,0;8,0;1,0;;2,0;;;;19,0;;1,0;4,0;;;1,0;2,0;;1,0;;5,0;;2,0;;;1,0;;;42,0;;;;;1,0;;;;;4,0;;;;;1,0;19,0;;;;10,0;;;;;;;2,0;;5,0;;;;4,0;;5,0;;;;;5,0;;3,0;;;;;;;;;2,0;;3,0;11,0;15,0;;7,0;;;;;1,0;11,0;;;;;;;13,0;;;;;8,0;;;4,0;3,0;;;;13,0;1,0;;6,0;4,0;;3,0;;;18,0;;;;;;1,0;;;;;;;3,0;;;1,0;1,0;8,0;;;2,0;7,0;1,0;;;;;;2,0;7,0;;1,0;;2,0;;;;8,0;2,0;;4,0;6,0;;2,0;;;;;;4,0;;2,0;;;;;2,0;5,0;;;;18,0;1,0;;;1,0;;4,0;;;1,0;4,0;2,0;;;8,0;;;;;2,0;;;;;;;;;;;;;3,0;;;;1,0;;2,0;;;;;1,0;8,0;1,0;1,0;;;3,0;;1,0;;;;;;;;;;;3,0;4,0;4,0;1,0;1,0;2,0;;;1,0;;7,0;;;1,0;;;;;1,0;;1,0;;14,0;;3,0;8,0;;;5,0;4,0;;1,0;4,0;7,0;1,0;;;10,0;;;;;;;;1,0;11,0;1,0;;;;;;;2,0;;;;;1,0;7,0;;;;8,0;2,0;1,0;;1,0;5,0;;5,0;;;5,0;4,0;1,0;;;;;;;1,0;6,0;3,0;;;;4,0;;1,0;;;20,0;;1,0;;;2,0;;3,0;2,0;;;;;;;;;;;2,0;15,0;;;;;;;;;;;;;;1,0;;1,0;;5,0;1,0;;5,0;3,0;;;;2,0;;;;;;;;;3,0;1,0;4,0;;;1,0;;4,0;;;;;;;;;;;;1,0;;;;1,0;;;2,0;;;1,0;2,0;;;;2,0;;;;;;5,0;;;;;;;;;4,0;;;1,0;;;;;;;;;1,0;;2,0;;;;;6,0;;;1,0;;;;;;;;;;;;;7,0;;;1,0;;;1,0;2,0;;2,0;2,0;;;;;;;;;;;;3,0;;;;;;;3,0;;;;;;;;;;;16,0;;;1,0;;;3,0;;;4,0;;;3,0;;;2,0;;;;;;4,0;;;;5,0;;;;;;;;;;;;;;;;;;6,0;;;;1,0;1,0;;;;2,0;;;;;;1,0;;;1,0;;;;;;;;;;;;;;;9,0;;;;;;;;;1,0;3,0;;;;;11,0;;;;;;;;;;;;8,0;;;1,0;8,0;29,0;;26,0;;4,0;;;;8,0;;;;;;1,0;;;;2,0;;;;;;;;4,0;;;;1,0;;1,0;;1,0;1,0;;;;;;;;;;;2,0;;;;;;;;;2,0;;2,0;;;;;1,0;;;;;;2,0;;;;;;;;;;;;;;;;1,0;6,0;;2,0;;;;;;;;;2,0;;;;1,0;;2,0;;;;1,0;;;;;;;;;;;;3,0;;1,0;;;;;;;;;;;;;;;4,0;;;1,0;;;;;;;;;;;;;8,0;;;1,0;;;;;;;;;1,0;;;;;;;;;;3,0;;16,0;25,0;;;;;;;;;;;2,0;9,0;;;8,0;;;;;;;;;;;;;;;;;;
service;;7,0;;;2,0;1,0;;;1,0;;;;19,0;3,0;;14,0;;;;;;6,0;;14,0;;;;;;;2,0;;12,0;;1,0;;;;;;14,0;;8,0;;;2,0;6,0;23,0;23,0;6,0;;;;1,0;;;;;;6,0;;2,0;;4,0;;;;;;;6,0;;14,0;;;;1,0;;;58,0;;;1,0;21,0;;6,0;;;;;;;;;;2,0;1,0;;26,0;3,0;;;1,0;8,0;;6,0;;23,0;3,0;6,0;;3,0;;;;1,0;4,0;2,0;;1,0;;;11,0;23,0;7,0;4,0;;;;;;1,0;;;;;;3,0;1,0;;;;1,0;4,0;2,0;;;12,0;4,0;;;;4,0;11,0;;;20,0;;;2,0;5,0;2,0;4,0;;;;3,0;;;;;;;;1,0;;11,0;;;;;;;;;4,0;;1,0;;;;;;1,0;;;4,0;;;14,0;;;;;;;;;;;2,0;;;;;;;;;;;;;2,0;;7,0;;;;;;;2,0;3,0;;;;;;;;;;;;;;8,0;;;;;;;;;35,0;;;;;;;19,0;;;;;;;;6,0;;;;;;;;;;;;;;;;1,0;;;;;;;2,0;;;;;;;3,0;4,0;;;;;;;;;1,0;;;;1,0;;;;1,0;;10,0;;2,0;;;;;;;;;;3,0;;;;;;;;;;;1,0;1,0;;;;;;;;;;;;;3,0;;;;;;;3,0;;;;;;;;2,0;;;;;;1,0;;;;;;;;;;;;1,0;;;;;;;;;;;2,0;1,0;;;;;;;;2,0;;;1,0;;;;;;;12,0;;;;;;;;;;2,0;3,0;;7,0;;;;;;;;;1,0;16,0;5,0;2,0;;;;6,0;;;;;2,0;3,0;1,0;;;;1,0;;;;;;;;;;;;9,0;37,0;2,0;;;;;;;;16,0;;;;4,0;3,0;;;;1,0;;;;;1,0;5,0;;;;;3,0;1,0;;;;;1,0;;;;;1,0;;1,0;;;;;;;;;;;;;;6,0;3,0;8,0;;;;1,0;;;;;;;1,0;;;;13,0;;13,0;;;;2,0;;;;;;;;;;;;2,0;7,0;5,0;8,0;;;4,0;;;;;;;;1,0;;;;1,0;;;;;;1,0;;7,0;;;;;29,0;;;;;15,0;2,0;10,0;;1,0;;1,0;;;;;;2,0;;;;22,0;;2,0;;1,0;;1,0;;;;12,0;7,0;;;;;2,0;27,0;;1,0;;1,0;14,0;;;;;;;;;20,0;;;18,0;;;;;;;;;;;;;;;;;;;;;;3,0;;1,0;;;;;;;;;;;1,0;;;;;;;;;;;;4,0;;6,0;;;2,0;;;;;;;;;;;;;;;;;;;;1,0;;;;;;3,0;;;;2,0;;1,0;7,0;;;;1,0;;;1,0;;;;;;;;;;;;;;;;;;;;;;;;;;1,0;;;;;;;;;;;;12,0;;;1,0;;;;;;;1,0;;;;;;;;;;;;;2,0;;;;;2,0;;;;2,0;;;;;;;;;;1,0;;;;;;;;;;;;;;;;;;1,0;;;6,0;5,0;;;;;;;1,0;;1,0;;;;;;;;;;;;1,0;;;;;;;;;;;;2,0;;;;;;;;;;;1,0;;;;;;;;;;;;;;;;;;;;;;;;;;;;;;;;;;;;1,0;;;;;1,0;;3,0;;;;;;;;;;;;;;1,0;;;;;;;;;;;;;;;;;;2,0;;;2,0;;;;;;;;;;;;;1,0;;;;;;;;;2,0;1,0;;2,0;;;;;;;
shaft;;1,0;;;;24,0;13,0;15,0;;23,0;;;1,0;;166,0;70,0;;1,0;;;;1,0;1,0;1,0;;;;3,0;;;;6,0;24,0;;16,0;8,0;;1,0;;;;;26,0;;;;;46,0;;8,0;45,0;8,0;;;169,0;8,0;17,0;;;;110,0;;;;8,0;2,0;;28,0;26,0;2,0;2,0;;1,0;;;2,0;;;;16,0;2,0;1,0;;55,0;;;;;2,0;5,0;50,0;;;2,0;;;;;7,0;;7,0;;66,0;11,0;;;20,0;1,0;8,0;;17,0;;15,0;;;21,0;124,0;83,0;7,0;3,0;1,0;1,0;;;7,0;;;;2,0;4,0;;2,0;31,0;;;;7,0;;;;;;;11,0;;;;29,0;3,0;;;;;;3,0;2,0;23,0;;35,0;6,0;;6,0;19,0;;;;8,0;11,0;;;;;;2,0;1,0;;27,0;17,0;7,0;;9,0;67,0;;;5,0;10,0;;9,0;;;;1,0;3,0;92,0;;27,0;;;;12,0;9,0;;;98,0;;5,0;11,0;;;7,0;;;31,0;;;;16,0;;4,0;113,0;78,0;;28,0;;5,0;21,0;;5,0;4,0;;191,0;4,0;65,0;94,0;42,0;17,0;12,0;21,0;13,0;13,0;;10,0;22,0;;37,0;;;;;17,0;10,0;;6,0;3,0;;;62,0;;;;1,0;2,0;35,0;1,0;;;6,0;;14,0;;32,0;10,0;18,0;;;12,0;;3,0;1,0;65,0;5,0;;9,0;;;1,0;;;5,0;;;1,0;7,0;;6,0;;;;1,0;13,0;11,0;13,0;44,0;24,0;12,0;20,0;26,0;3,0;3,0;;;19,0;;2,0;1,0;1,0;;1,0;;65,0;9,0;;;28,0;29,0;;52,0;35,0;;;6,0;11,0;7,0;;;;;62,0;13,0;5,0;20,0;1,0;31,0;4,0;;12,0;20,0;81,0;24,0;;7,0;33,0;;;23,0;43,0;8,0;25,0;9,0;;;8,0;;8,0;;6,0;;10,0;3,0;;;;4,0;;1,0;;3,0;111,0;210,0;76,0;6,0;3,0;;;1,0;1,0;10,0;6,0;;122,0;;;;4,0;54,0;8,0;3,0;;;;;;;1,0;;;;;;;;;;;;1,0;;;;;;;;;;;;;;;;;1,0;3,0;;;8,0;2,0;;;1,0;14,0;13,0;;;4,0;3,0;;;15,0;;;;;;;;;8,0;;;;;1,0;;;;;;1,0;;1,0;;;1,0;1,0;;;;;25,0;14,0;;26,0;;;;;;;;;;;;;;;;1,0;45,0;;;;;;7,0;;;;;2,0;;;;;1,0;1,0;;;;;4,0;3,0;;6,0;;23,0;;;;;1,0;5,0;;8,0;;4,0;;;;2,0;2,0;;;;;;;;;;;;;;;;28,0;9,0;;5,0;;;6,0;;4,0;11,0;;;;;7,0;;3,0;;;2,0;;;;10,0;;2,0;;;;;23,0;;;;;4,0;;;;;;;7,0;;;;;;;;;;;;19,0;4,0;31,0;;6,0;;;;;;1,0;;;;41,0;;1,0;;;2,0;;1,0;;;;24,0;;;;;;;;14,0;;4,0;;;;3,0;;7,0;20,0;14,0;;;4,0;7,0;24,0;;;3,0;;;;6,0;;3,0;;17,0;;;;62,0;;6,0;5,0;;4,0;5,0;17,0;5,0;6,0;4,0;;2,0;2,0;;12,0;;1,0;;;;;;11,0;4,0;;;;;31,0;61,0;1,0;2,0;12,0;1,0;2,0;;;11,0;;;;1,0;6,0;;;23,0;;;;2,0;1,0;;1,0;;;;;;;2,0;18,0;1,0;;5,0;;1,0;;4,0;;;;4,0;;;1,0;;;;;3,0;;3,0;;;;;;;;;;;;;;;;;;;;3,0;;;;;;;;;;;;;;;;5,0;;;;;;;;1,0;;;;;;4,0;;;;;;;3,0;;;1,0;;;;;8,0;;;;;;;;;;;;;;;70,0;8,0;;;;;;1,0;;29,0;;;;;;;;4,0;;;;;;;;;;;;;;;;;;1,0;29,0;;66,0;;6,0;;1,0;1,0;;;;;;;1,0;;;;;;;;;;;;3,0;;;;;;1,0;;10,0;;;;;;;;;;;;1,0;;;4,0;;1,0;;3,0;;;;;;;;;;;14,0;;;;;;;;;;;;4,0;;;;;;;;;;;;;;;;;;;;;;;;1,0;;;;;1,0;;;;;;;;;;;;;;1,0;;;;;;;
shake;;2,0;;;7,0;;;62,0;5,0;10,0;;;;;18,0;26,0;;10,0;;;;14,0;;;;;;;;15,0;;7,0;25,0;;25,0;16,0;46,0;95,0;;;7,0;1,0;4,0;;138,0;35,0;25,0;26,0;18,0;;1,0;10,0;;;3,0;;2,0;;;;1,0;;3,0;;;;4,0;4,0;7,0;;9,0;;11,0;;;;2,0;;;84,0;;31,0;;29,0;1,0;;1,0;;1,0;1,0;43,0;;;;;;20,0;;16,0;7,0;;;50,0;12,0;;;36,0;1,0;4,0;7,0;;20,0;;1,0;16,0;5,0;37,0;6,0;;11,0;1,0;;5,0;7,0;;;;;;;;;2,0;1,0;5,0;;3,0;9,0;2,0;2,0;;;;31,0;7,0;1,0;;1,0;18,0;;1,0;;;24,0;5,0;;20,0;1,0;2,0;;1,0;1,0;33,0;;;;5,0;2,0;;;;2,0;;;59,0;10,0;1,0;5,0;;;;14,0;;;;;;;;;;;;2,0;;;5,0;;;;;;;41,0;12,0;1,0;;;30,0;3,0;;;1,0;;;;;;;;6,0;;;;;;1,0;;;3,0;11,0;;1,0;8,0;5,0;4,0;4,0;;;;;;;;;;;;1,0;1,0;1,0;;;;;;3,0;;;;;;;17,0;;;;;3,0;;;;;;;2,0;17,0;;4,0;1,0;1,0;;;;;25,0;;;;;;;6,0;;;;;;4,0;;4,0;4,0;1,0;;;;;;;;;;;;5,0;4,0;;;;;;;;;5,0;;;;;1,0;;;;;;1,0;;;;3,0;;;1,0;1,0;;;;;1,0;;;4,0;;10,0;1,0;;;9,0;;;;;;;;;;;;;;;;;;;;;;1,0;;;1,0;;;;;;;6,0;;;;;;;;;;;1,0;;;;;;;24,0;4,0;18,0;;2,0;1,0;;;2,0;;1,0;1,0;;;;54,0;;1,0;;;;;;;;16,0;5,0;;4,0;;;2,0;;;5,0;10,0;;;2,0;16,0;;;;2,0;4,0;;1,0;5,0;;;;4,0;;1,0;;;3,0;9,0;1,0;;;15,0;;;;;;;;10,0;20,0;;;4,0;;;;1,0;;;;1,0;;;1,0;;5,0;;;;;1,0;;8,0;;8,0;7,0;;;;;3,0;;;;;;;;;;1,0;;;2,0;;;;;;;;;;;;;;;;;1,0;;;15,0;;;;2,0;;;;;;;;;;;;;;;;2,0;;3,0;;;;;;35,0;;;;;;;;1,0;;;;;;;;;;;;;;;;;1,0;;;;3,0;;;;;;;;7,0;;;;;;3,0;;;;;;;;;;;;;;;;;2,0;;;;5,0;1,0;;;;;;;;;;;;;;;;;;;;;;;;;;;;;;2,0;;;1,0;;;;;;;1,0;;;;4,0;;;12,0;;5,0;;;;;;;;;;;;;;;;;;;;;;7,0;;11,0;;;;;;3,0;;;;;;;;;;;;5,0;;;1,0;1,0;;;;;;;;3,0;;;3,0;1,0;;2,0;;;;;;;;;;;;1,0;;;;;;;;;;;;;;;;;;;;2,0;;1,0;1,0;;;;;;2,0;;4,0;;;4,0;;;;1,0;;;;;;;4,0;;;2,0;1,0;3,0;;;;;1,0;;;1,0;;;;;;;;;;10,0;;;;1,0;;;;;;;;;;;;1,0;;;;;1,0;;1,0;;;;;;;;;;;;;;;;;;;;;;;;;;;;;;;;;;;;;;;;;;;;1,0;;1,0;;;;;;;;;;1,0;1,0;;;;;;;;;;;;;4,0;;;;;;;8,0;;;;;;;;;;;1,0;;;;;;;;;;;1,0;;;2,0;;;;;;;;;;;;;;;;;;;;;;;;;;;;;;;2,0;;;;;;;;;;;;;;;;;;;;
shape;;5,0;2,0;;1,0;34,0;19,0;70,0;90,0;52,0;16,0;1,0;6,0;;38,0;74,0;18,0;;3,0;;7,0;19,0;25,0;2,0;2,0;;16,0;4,0;1,0;7,0;1,0;;25,0;;57,0;4,0;4,0;2,0;3,0;3,0;14,0;4,0;38,0;16,0;34,0;7,0;43,0;83,0;7,0;13,0;39,0;14,0;15,0;1,0;19,0;19,0;61,0;2,0;2,0;;36,0;7,0;9,0;3,0;20,0;10,0;7,0;187,0;75,0;37,0;11,0;5,0;24,0;;25,0;13,0;4,0;2,0;27,0;124,0;3,0;20,0;;171,0;2,0;;;;21,0;13,0;283,0;2,0;;27,0;3,0;8,0;38,0;;65,0;;4,0;3,0;125,0;57,0;;3,0;52,0;1,0;6,0;9,0;4,0;4,0;22,0;;;54,0;298,0;77,0;9,0;30,0;2,0;13,0;15,0;39,0;7,0;2,0;17,0;;;4,0;2,0;10,0;17,0;1,0;5,0;;12,0;5,0;1,0;5,0;3,0;;;29,0;;5,0;1,0;86,0;126,0;92,0;25,0;2,0;2,0;1,0;32,0;;60,0;2,0;3,0;13,0;1,0;4,0;110,0;1,0;12,0;5,0;4,0;22,0;;;2,0;9,0;1,0;2,0;5,0;14,0;30,0;24,0;;2,0;9,0;60,0;3,0;1,0;3,0;23,0;5,0;16,0;4,0;;;;26,0;28,0;;32,0;;11,0;;47,0;38,0;3,0;2,0;50,0;;12,0;2,0;1,0;5,0;76,0;;23,0;4,0;8,0;1,0;2,0;46,0;7,0;8,0;47,0;59,0;1,0;28,0;5,0;;6,0;27,0;;88,0;;127,0;6,0;1,0;50,0;12,0;6,0;9,0;74,0;5,0;54,0;7,0;1,0;6,0;5,0;;;7,0;23,0;32,0;14,0;80,0;;3,0;3,0;;23,0;62,0;1,0;4,0;10,0;1,0;;6,0;25,0;4,0;;;13,0;10,0;1,0;7,0;24,0;31,0;8,0;;34,0;1,0;36,0;12,0;186,0;;;11,0;10,0;13,0;10,0;;4,0;;6,0;33,0;9,0;7,0;2,0;26,0;;6,0;1,0;31,0;2,0;23,0;13,0;8,0;1,0;6,0;1,0;1,0;13,0;29,0;10,0;;26,0;1,0;8,0;13,0;6,0;4,0;40,0;67,0;43,0;9,0;1,0;5,0;14,0;41,0;;39,0;18,0;;1,0;5,0;3,0;11,0;;4,0;5,0;8,0;26,0;3,0;25,0;20,0;1,0;2,0;;5,0;3,0;4,0;2,0;6,0;40,0;12,0;2,0;;6,0;10,0;10,0;7,0;26,0;4,0;;11,0;8,0;4,0;11,0;37,0;2,0;4,0;23,0;14,0;1,0;1,0;3,0;7,0;;;4,0;75,0;9,0;7,0;8,0;4,0;5,0;1,0;6,0;2,0;3,0;4,0;2,0;19,0;27,0;12,0;13,0;5,0;;5,0;7,0;1,0;15,0;15,0;;;;7,0;5,0;;;;5,0;;10,0;12,0;7,0;14,0;;12,0;;2,0;1,0;;;;7,0;12,0;1,0;;;;9,0;2,0;1,0;;51,0;7,0;26,0;4,0;8,0;15,0;7,0;1,0;;12,0;4,0;6,0;;1,0;;4,0;2,0;7,0;1,0;9,0;;;;;1,0;;;;2,0;6,0;;;;;4,0;;;;9,0;5,0;;;1,0;9,0;;2,0;;2,0;;28,0;7,0;;14,0;2,0;;;;2,0;23,0;;;;6,0;3,0;1,0;;5,0;12,0;12,0;24,0;;2,0;7,0;1,0;;9,0;;24,0;;;23,0;;;;;3,0;;2,0;;;;2,0;6,0;;;;3,0;;;;1,0;3,0;5,0;;3,0;7,0;8,0;;;;26,0;;;;6,0;9,0;;;4,0;;9,0;2,0;2,0;5,0;1,0;;;37,0;;6,0;5,0;5,0;16,0;42,0;;3,0;;;;5,0;;1,0;;2,0;1,0;5,0;8,0;;16,0;;4,0;;;5,0;5,0;;;11,0;;;;;14,0;2,0;;;;8,0;6,0;15,0;;4,0;;1,0;3,0;2,0;8,0;;;4,0;1,0;4,0;2,0;;;1,0;1,0;;;3,0;;;4,0;5,0;;59,0;;3,0;3,0;1,0;;;1,0;;;1,0;42,0;;;1,0;3,0;;;;8,0;2,0;7,0;7,0;5,0;;;;9,0;4,0;6,0;;1,0;3,0;1,0;2,0;;3,0;8,0;19,0;17,0;;15,0;1,0;7,0;3,0;13,0;6,0;;;;;7,0;12,0;8,0;3,0;;1,0;1,0;16,0;6,0;;3,0;5,0;7,0;3,0;4,0;1,0;;;1,0;1,0;;4,0;;;;2,0;1,0;;;;2,0;;4,0;1,0;;;12,0;;3,0;;3,0;15,0;4,0;1,0;1,0;8,0;;;16,0;10,0;1,0;27,0;38,0;;;36,0;;6,0;;;1,0;2,0;2,0;;2,0;5,0;5,0;2,0;11,0;;1,0;4,0;;7,0;;;1,0;1,0;1,0;;;3,0;;;;;1,0;;2,0;18,0;;;;5,0;3,0;5,0;4,0;2,0;;;8,0;32,0;;;;;;3,0;1,0;2,0;2,0;1,0;3,0;;;;;1,0;1,0;;;4,0;;;;2,0;4,0;;;1,0;4,0;3,0;1,0;3,0;;;1,0;1,0;;;1,0;1,0;4,0;1,0;3,0;;1,0;1,0;;;18,0;1,0;;2,0;4,0;;;17,0;1,0;;;;;4,0;;;;;;1,0;;2,0;;10,0;;3,0;;;;;6,0;1,0;2,0;;;3,0;;;1,0;;;;5,0;;;1,0;;;1,0;;1,0;;2,0;;;7,0;;1,0;;;5,0;;;;;;;;;;;2,0;1,0;3,0;;;;8,0;;5,0;3,0;1,0;14,0;12,0;;4,0;8,0;8,0;;2,0;1,0;;3,0;;2,0;1,0;;19,0;;;;;;3,0;2,0;;;1,0;2,0;;;;10,0;;;;1,0;;;;;1,0;3,0;;5,0;2,0;56,0;13,0;1,0;29,0;;;;;;18,0;2,0;6,0;;;;;4,0;;;;5,0;2,0;;;;2,0;1,0;;;;1,0;;2,0;1,0;;1,0;3,0;5,0;;10,0;2,0;12,0;;1,0;7,0;;
share;;6,0;;;;2,0;;3,0;;5,0;19,0;;28,0;2,0;13,0;45,0;;;;;2,0;13,0;;2,0;2,0;;6,0;;1,0;;6,0;;9,0;;7,0;2,0;;;;;39,0;;3,0;2,0;;3,0;6,0;32,0;43,0;7,0;3,0;;;11,0;5,0;2,0;31,0;;;;;2,0;24,0;3,0;;;;12,0;1,0;1,0;6,0;2,0;11,0;;;36,0;9,0;;;121,0;8,0;10,0;;41,0;;6,0;;;;1,0;34,0;;;1,0;;;5,0;1,0;25,0;5,0;;4,0;27,0;23,0;;3,0;58,0;;46,0;;;3,0;;;5,0;57,0;26,0;1,0;4,0;2,0;;;3,0;9,0;5,0;;;;;;;1,0;;2,0;;1,0;10,0;6,0;;;1,0;;2,0;26,0;2,0;;;18,0;25,0;;;;3,0;3,0;;1,0;39,0;;;14,0;1,0;4,0;8,0;;;;6,0;25,0;2,0;;2,0;;;11,0;;;4,0;;;;5,0;;;7,0;;34,0;;7,0;;;;;;15,0;;1,0;8,0;;2,0;;1,0;1,0;4,0;10,0;;;;;;;;;11,0;;;;;;;;1,0;;2,0;;;2,0;1,0;;15,0;;;;4,0;;;;1,0;;;;3,0;;;7,0;;;18,0;1,0;162,0;1,0;;;;;;;8,0;3,0;;;;;;11,0;;;1,0;;;;;5,0;;;;;;8,0;6,0;1,0;14,0;;2,0;;;;;;;;12,0;;;2,0;;;;;3,0;;1,0;2,0;;;1,0;;;;1,0;;;;;;;1,0;;;;5,0;;;;;13,0;;;;;;;;;;;;;2,0;2,0;;;;;6,0;8,0;;;1,0;;;;;;1,0;;;;1,0;;;;;1,0;;;;;1,0;;;5,0;;;;;;1,0;;81,0;9,0;;;1,0;;;;2,0;;;1,0;;1,0;;;;2,0;;;1,0;;;;8,0;1,0;;;;;;2,0;2,0;;;;;;;;;;;1,0;5,0;;;;;8,0;;;;4,0;2,0;;2,0;2,0;;;4,0;;1,0;;;;20,0;1,0;;;;;;;;;;2,0;2,0;1,0;1,0;;6,0;;;;;;2,0;;;;;;;;16,0;;;;3,0;;;1,0;;1,0;1,0;8,0;;2,0;1,0;2,0;;1,0;;;1,0;;;;7,0;;;;;7,0;4,0;;;;9,0;;;2,0;;1,0;;;;;;;;;;1,0;;44,0;;;;18,0;3,0;;8,0;16,0;;;8,0;7,0;;;;64,0;;;;;;1,0;;8,0;;;;1,0;5,0;1,0;;;;;2,0;;25,0;3,0;;;2,0;10,0;2,0;;6,0;1,0;1,0;;;4,0;1,0;1,0;;3,0;;;;4,0;;;;2,0;;10,0;10,0;;;;6,0;;;2,0;;1,0;9,0;;1,0;;;2,0;1,0;;;1,0;2,0;;;;;5,0;;;1,0;;21,0;;;;;;12,0;;;;11,0;;;2,0;3,0;1,0;;;14,0;1,0;;;1,0;;;;;;4,0;;;5,0;;;;;1,0;;;;;;;;15,0;;;3,0;;;2,0;;;;;;;;;;;;4,0;;;2,0;;2,0;;;;;;;;;;;1,0;;4,0;;;;;1,0;;;;;;;;2,0;;;;;;;;;;;;16,0;;8,0;;;;;;;1,0;;;;;;;;;6,0;;;;;;;;;;;;;;;4,0;;;2,0;2,0;;;;;12,0;;40,0;30,0;;;1,0;31,0;;;;;;16,0;;1,0;;;1,0;;;;1,0;;;27,0;;;6,0;;;;2,0;;;;;;;;;;;1,0;;;;;;;;3,0;;;;;;;;1,0;;;;1,0;1,0;;2,0;;;;;;;;;;2,0;;;2,0;;;5,0;;;;;;;;;1,0;;;;;;;2,0;;;;;;;;;;4,0;;;;;;;;;2,0;;;;;;;;;;;;;;;;;1,0;;;;5,0;;;;2,0;;;;;;;;;;;;;9,0;;;;;;;;;;;;;;;;;;;;;;;;;;;;;;;;;;;;;;2,0;;;;4,0;;;;;;;;;;;;;;2,0;;;;;;;;;;;;;;;;;;;;;
shift;;3,0;;;;8,0;6,0;7,0;2,0;14,0;16,0;;4,0;;56,0;31,0;22,0;2,0;;;42,0;38,0;2,0;6,0;;8,0;64,0;3,0;;21,0;3,0;3,0;34,0;;38,0;14,0;8,0;7,0;;;20,0;;2,0;4,0;47,0;20,0;30,0;26,0;21,0;20,0;18,0;22,0;1,0;;14,0;9,0;31,0;3,0;2,0;1,0;4,0;7,0;37,0;1,0;8,0;3,0;9,0;6,0;74,0;2,0;12,0;3,0;31,0;3,0;2,0;17,0;;1,0;1,0;341,0;1,0;13,0;3,0;45,0;;13,0;3,0;2,0;;4,0;64,0;;;;;1,0;;;38,0;2,0;3,0;;21,0;68,0;;3,0;86,0;6,0;24,0;3,0;;27,0;;4,0;1,0;21,0;55,0;140,0;6,0;34,0;2,0;;1,0;3,0;17,0;2,0;;;4,0;5,0;1,0;34,0;43,0;4,0;;1,0;14,0;1,0;2,0;2,0;23,0;;1,0;44,0;25,0;;;10,0;100,0;;;;2,0;8,0;12,0;;30,0;;15,0;4,0;1,0;1,0;155,0;;;;23,0;20,0;;8,0;8,0;;;7,0;161,0;;;14,0;;;;5,0;;;29,0;10,0;;1,0;;1,0;;;;7,0;;1,0;;;1,0;3,0;2,0;2,0;3,0;104,0;5,0;1,0;;4,0;2,0;2,0;3,0;;3,0;1,0;;2,0;;;;;;11,0;;;;2,0;;;28,0;;17,0;;4,0;2,0;;32,0;4,0;1,0;1,0;;9,0;1,0;;15,0;62,0;;4,0;;120,0;15,0;;;;;;5,0;9,0;5,0;;;;;;7,0;;;3,0;;;;;2,0;5,0;;;;2,0;25,0;;25,0;;7,0;5,0;;;47,0;;;;;6,0;33,0;32,0;;2,0;;;;;1,0;;5,0;2,0;2,0;;1,0;;1,0;;;1,0;;2,0;;;12,0;;;1,0;;1,0;;1,0;;10,0;;1,0;5,0;;;14,0;;;;;7,0;;3,0;3,0;;2,0;;;7,0;2,0;2,0;4,0;2,0;6,0;42,0;3,0;1,0;1,0;13,0;;16,0;;23,0;3,0;10,0;;5,0;;;3,0;;;5,0;;3,0;2,0;1,0;;;;;6,0;1,0;9,0;5,0;1,0;;;1,0;;;;;;;1,0;7,0;7,0;2,0;1,0;2,0;3,0;4,0;2,0;1,0;;;;3,0;;;16,0;;2,0;29,0;14,0;2,0;;;9,0;;;2,0;3,0;;2,0;;1,0;1,0;;;2,0;7,0;;1,0;;19,0;25,0;2,0;15,0;1,0;2,0;15,0;36,0;1,0;;4,0;15,0;;1,0;8,0;20,0;1,0;;3,0;;;;;4,0;;;4,0;;;2,0;;;1,0;;4,0;;14,0;;;2,0;2,0;1,0;3,0;2,0;2,0;4,0;;10,0;;6,0;6,0;2,0;14,0;1,0;2,0;2,0;;3,0;8,0;;1,0;;;1,0;;;2,0;;2,0;54,0;;;1,0;;;4,0;;3,0;;1,0;;;;4,0;;;;;;1,0;;7,0;14,0;;;;;;4,0;;;6,0;;;;37,0;;;3,0;13,0;;;1,0;;4,0;;;;2,0;;;;;1,0;1,0;1,0;;;;;;21,0;7,0;5,0;4,0;;9,0;;2,0;15,0;;;;;1,0;;;;;;;;;3,0;1,0;;;6,0;;;;;;;;;;10,0;;;;;;4,0;2,0;;1,0;;;;1,0;;;;;;;;;3,0;;;;;;12,0;138,0;;;18,0;;;8,0;;;;;;;1,0;;;12,0;;;1,0;3,0;;;3,0;;;;;1,0;4,0;;;;;15,0;;1,0;7,0;;;;;;9,0;;;;;1,0;;;;;;;;;;43,0;2,0;2,0;6,0;1,0;;;;;;;;2,0;;;;;;;;1,0;2,0;32,0;;;;;;17,0;;;;;;;1,0;3,0;;;1,0;;;;;10,0;2,0;;;;;;;;;;1,0;;;2,0;;;;;;;;;;;;7,0;;;1,0;11,0;2,0;2,0;3,0;2,0;;;;22,0;;;;2,0;19,0;7,0;;1,0;;3,0;;1,0;;;;;;1,0;5,0;;;13,0;;2,0;1,0;;1,0;;;;9,0;;2,0;1,0;1,0;3,0;2,0;;;;;;2,0;;;;1,0;;1,0;;;;;;15,0;10,0;;;;;;;;2,0;;;;7,0;;;;;1,0;;;;;;;;;27,0;;;;;;;;;1,0;;;1,0;;;;1,0;;;;;6,0;;;;;2,0;;;;;;;7,0;;;;;7,0;;;1,0;8,0;;;;;;;3,0;;;;;;2,0;2,0;;;;;;;;;;;10,0;3,0;14,0;;;;;;;;;;;;;;;;1,0;;;;;4,0;;4,0;;;4,0;;;;2,0;;;1,0;1,0;;;;;;2,0;;;;;2,0;6,0;3,0;;;;;2,0;;2,0;;;8,0;;;3,0;;;;;10,0;;;;3,0;;;3,0;;;2,0;;;1,0;;;
shoot;;1,0;;;;54,0;1,0;76,0;43,0;;;;3,0;3,0;15,0;30,0;;8,0;6,0;;;15,0;5,0;;1,0;5,0;19,0;2,0;;;6,0;100,0;25,0;;118,0;24,0;5,0;8,0;5,0;;73,0;1,0;7,0;6,0;33,0;11,0;59,0;170,0;48,0;53,0;1,0;55,0;;;2,0;;2,0;3,0;9,0;;;;36,0;;;4,0;24,0;15,0;4,0;1,0;18,0;1,0;18,0;;;;;2,0;;499,0;;58,0;;28,0;1,0;6,0;;15,0;;1,0;72,0;;;1,0;3,0;8,0;10,0;;79,0;6,0;12,0;;43,0;97,0;;7,0;24,0;6,0;31,0;34,0;5,0;131,0;1,0;1,0;1,0;98,0;7,0;35,0;3,0;29,0;;;20,0;75,0;7,0;11,0;;3,0;;25,0;;12,0;9,0;1,0;15,0;1,0;1,0;3,0;;;101,0;;;12,0;16,0;;;2,0;28,0;15,0;;;27,0;24,0;39,0;;33,0;1,0;;;2,0;1,0;145,0;;;;25,0;37,0;;;6,0;;;;4,0;5,0;6,0;1,0;;;;21,0;;1,0;12,0;2,0;;8,0;1,0;;;1,0;;4,0;;1,0;;;3,0;4,0;;;15,0;143,0;;;4,0;;33,0;11,0;2,0;;2,0;;;;;;;;;3,0;;;;;;;49,0;;3,0;;;12,0;1,0;13,0;;3,0;;;;;;;1,0;;1,0;;3,0;5,0;;2,0;;2,0;;;9,0;;;;;;;81,0;;11,0;2,0;;;;;6,0;5,0;;;;11,0;2,0;;;20,0;;2,0;;;117,0;3,0;2,0;;;6,0;8,0;8,0;;;;1,0;;;;3,0;3,0;1,0;;;;1,0;;;;;30,0;;;16,0;12,0;;;;4,0;;;;;8,0;;;;2,0;2,0;;;;;;;;;1,0;;;;2,0;;13,0;;1,0;1,0;;2,0;;;4,0;;2,0;;;32,0;7,0;;;;;;;;;;;;;6,0;;3,0;1,0;;;;4,0;14,0;1,0;2,0;;2,0;;32,0;;;;2,0;1,0;18,0;16,0;;;1,0;;4,0;5,0;24,0;;;;;;;;;1,0;37,0;18,0;;7,0;;2,0;;;71,0;3,0;2,0;;1,0;2,0;24,0;;1,0;;24,0;;;;1,0;10,0;;2,0;;5,0;1,0;307,0;;1,0;5,0;53,0;;;6,0;161,0;1,0;2,0;4,0;8,0;;;;1,0;40,0;;;1,0;33,0;38,0;;;6,0;;;;;1,0;;;;4,0;3,0;4,0;2,0;8,0;;2,0;;32,0;2,0;;3,0;54,0;;;;;;18,0;3,0;2,0;10,0;;;;7,0;;;30,0;;;6,0;6,0;;;;2,0;;1,0;14,0;7,0;;;;;;2,0;;10,0;4,0;;8,0;;;;;;;;4,0;;;1,0;;6,0;;;4,0;2,0;;;3,0;;;;1,0;;1,0;;;;5,0;2,0;;;;;9,0;;8,0;;;;4,0;;6,0;;1,0;9,0;;3,0;;;4,0;;;;;5,0;;;;41,0;;;;;;;;;5,0;5,0;;;;4,0;;1,0;;;;;11,0;2,0;;;;;5,0;3,0;;;;;;;1,0;1,0;;;;;;;;;;;;;;;;;;;;;;;1,0;;;;;35,0;7,0;;;1,0;;3,0;;;3,0;4,0;;1,0;;;;4,0;;;9,0;;;2,0;;;;;;;;;;2,0;2,0;;;;11,0;8,0;;;;;;;;;1,0;2,0;;;;;;;;;;5,0;;;;;2,0;;;;;;2,0;;;12,0;;;;;;;;2,0;;13,0;;;1,0;41,0;;;;;;;;;;;;;;;;;;;;;1,0;;;11,0;;;;;;;4,0;;;;;;;32,0;;;;;;;5,0;;7,0;;;1,0;;;;30,0;;25,0;;;1,0;3,0;;;;2,0;3,0;1,0;;;1,0;;;;;;;2,0;;;;2,0;2,0;;;;;8,0;3,0;;;;;;;;;;4,0;;;;;;;;6,0;;3,0;;;4,0;;;7,0;;;;;;2,0;;;;;;;;;;;2,0;;;;;;;2,0;;;;;34,0;2,0;;;;;;;;11,0;;1,0;;2,0;;;;;;;;;14,0;;;;;;;;;;1,0;;;;;;;;;;;3,0;;;;13,0;;;;;2,0;4,0;;2,0;;;;;;;24,0;;;;;;;1,0;3,0;;1,0;;;6,0;;;;;;1,0;;;;;;;1,0;;14,0;;;;;;;;;2,0;;;;3,0;2,0;;;;;;1,0;7,0;;;;;;;;;;;;
slid;;1,0;;;;;24,0;16,0;1,0;;;;1,0;;12,0;7,0;;;;;;1,0;;1,0;;;;;;;5,0;;13,0;;26,0;27,0;1,0;;;;;;;;62,0;;4,0;2,0;5,0;;;23,0;;;31,0;2,0;7,0;;;;2,0;;;;5,0;;3,0;5,0;2,0;5,0;;;1,0;;;;;;;3,0;;;;17,0;;;;;;1,0;4,0;;;;;;;;7,0;;;;2,0;2,0;;3,0;18,0;1,0;;;;;;;;4,0;35,0;134,0;;6,0;;;;;;;;;;;;;;;;;;10,0;;;;;;;4,0;;;11,0;;;1,0;;;;;;6,0;;7,0;;;1,0;4,0;;;;;;;;;;;;;;2,0;2,0;;;;2,0;;;;;;2,0;;;;;3,0;10,0;;12,0;;;;6,0;;;6,0;29,0;;;;;;5,0;;;3,0;;;;;;;;;;2,0;;;;;4,0;;;17,0;;;19,0;7,0;42,0;15,0;3,0;6,0;1,0;;2,0;;;;;;;;;3,0;;;;12,0;;;;;;2,0;;;;;;;;3,0;;28,0;;;;;;;;;5,0;;;;;;14,0;;1,0;;;;19,0;4,0;;;;1,0;;;;3,0;7,0;6,0;1,0;;;10,0;;;;;4,0;;;2,0;6,0;;;;10,0;;;;;3,0;;;2,0;;;;;;;;;;18,0;9,0;2,0;;;;;;2,0;;47,0;3,0;6,0;;;;;;1,0;;;5,0;;;;;11,0;;;;1,0;;;;;;;;;;;4,0;3,0;10,0;;;12,0;;;;;;9,0;;;;6,0;1,0;;;;;;;;;;;;;;;1,0;;;2,0;;;;;;;;;;19,0;1,0;;;3,0;;;;;1,0;;3,0;;;;;;;;15,0;23,0;;;2,0;5,0;;;;;;;;;;;;;;;;;;;;;;4,0;3,0;;;1,0;2,0;16,0;;;;;;4,0;;;;;;;;;;;;;;;;1,0;;5,0;;3,0;;;;;;;;;;1,0;1,0;;;;;;;;;;3,0;;;;;;4,0;;;;;;;;;;;;;;7,0;;;;;;;;;;4,0;;;;;;;;;;;;;;;;;;;;;;;;;;2,0;3,0;;;;;;;;;1,0;2,0;;;;;;3,0;;;;2,0;;2,0;;;;;;;;;;;;;;;;2,0;;;;;;;;;;5,0;;;;;;;;;;;17,0;;;;;;;;;;;6,0;;;;;;1,0;;;;;;;;;;;;;1,0;;21,0;;3,0;;;;;;;;;4,0;;;;;;;;;;1,0;;1,0;;;;10,0;;;;;;;;4,0;;;;;;;;;;;;;;;;;1,0;;;;;;;;;;;;;;;;;1,0;1,0;;;;;;;;;;;;;;;;;;;1,0;2,0;;;;;;;;;;;;;;;;;;;;1,0;;;;;2,0;1,0;;;;;;;;;;;;;;;;1,0;;;;;;;;;;;;;;;;;;;;;;;;;;;;;;;;;;;;;;;;;;;;;;;;;;;;;;;;;;;;;;;;;;;;;;;;;;;;13,0;;;5,0;;;;;;;;;;;;1,0;;;;;;;;;;;;;;;;;;;;;;;;;;;;;;;;;;;;;;;;;;;;;;;;;;;;;;;;;;;;;;;;;;;;;;;;;;;;;;;;;;;;;;;;;;;;;;;;;;;;;3,0;;;;;;
slide;;2,0;;;;3,0;16,0;18,0;4,0;13,0;;;1,0;;35,0;30,0;;;1,0;;;1,0;;21,0;6,0;;1,0;;;;1,0;2,0;47,0;;11,0;1,0;;;;1,0;;;31,0;;15,0;2,0;13,0;40,0;2,0;17,0;17,0;8,0;;;37,0;9,0;25,0;;;;14,0;1,0;;1,0;;2,0;3,0;49,0;11,0;12,0;2,0;;5,0;;;;;;;39,0;;4,0;;39,0;2,0;;1,0;;;11,0;34,0;;;5,0;;;;;12,0;1,0;;;29,0;4,0;;2,0;19,0;;;;;16,0;2,0;;;16,0;183,0;141,0;;2,0;26,0;;2,0;2,0;2,0;;1,0;;;;;;41,0;;;;11,0;8,0;;;;1,0;;16,0;;;;37,0;;;;;;;;1,0;10,0;;4,0;;;2,0;105,0;;1,0;;8,0;5,0;;;7,0;1,0;;4,0;8,0;6,0;16,0;5,0;2,0;;5,0;19,0;;3,0;;4,0;;3,0;;;1,0;;15,0;43,0;;28,0;;;;40,0;3,0;;;113,0;;25,0;;;;11,0;;;8,0;;;;70,0;;3,0;20,0;35,0;;3,0;4,0;;1,0;;11,0;;;150,0;;1,0;53,0;18,0;47,0;33,0;15,0;30,0;4,0;8,0;9,0;;11,0;;;;;;6,0;118,0;;;1,0;;;53,0;;;;;4,0;5,0;4,0;;;7,0;;6,0;;;;8,0;;;15,0;;15,0;;45,0;1,0;;;;;;;3,0;;;5,0;2,0;1,0;;35,0;;;;2,0;5,0;5,0;21,0;12,0;;1,0;4,0;12,0;84,0;9,0;;;12,0;;;15,0;2,0;;6,0;;13,0;1,0;;2,0;1,0;16,0;;37,0;2,0;1,0;;;11,0;1,0;;2,0;;;83,0;2,0;7,0;;14,0;8,0;1,0;2,0;4,0;12,0;16,0;7,0;1,0;;13,0;;;2,0;16,0;1,0;;14,0;;1,0;3,0;12,0;8,0;18,0;;;5,0;4,0;2,0;7,0;10,0;;3,0;4,0;1,0;8,0;1,0;11,0;11,0;9,0;9,0;2,0;32,0;3,0;;5,0;9,0;3,0;64,0;;;;1,0;2,0;;2,0;4,0;2,0;8,0;;;;11,0;;;;8,0;;;1,0;;1,0;;2,0;;;;;;;;7,0;;;1,0;;;;;;63,0;;1,0;;;;;7,0;;1,0;13,0;30,0;;;;41,0;;;;1,0;;;;;2,0;;;;;4,0;;;;;1,0;6,0;;;26,0;;;9,0;;7,0;;;5,0;;;8,0;;;3,0;;;;;;;;;;;;;1,0;;;;28,0;;;1,0;;;;;;;3,0;6,0;;;;;;;;;;16,0;2,0;3,0;;;;;;1,0;;;3,0;;;;;;;;;;;;;;1,0;;5,0;;;48,0;2,0;;;3,0;;;3,0;5,0;;1,0;;;1,0;;2,0;2,0;;;;;;2,0;;4,0;;8,0;;;;;;;1,0;;;6,0;24,0;;;;;4,0;;;;;23,0;;16,0;;;;;;;;;;2,0;;4,0;2,0;;;8,0;;;;;;;;;;1,0;;2,0;;;;;2,0;;;;71,0;;;;;1,0;;2,0;;1,0;1,0;10,0;;2,0;;;;22,0;;;;;;4,0;;;;;;;5,0;9,0;8,0;3,0;4,0;;;1,0;;;;2,0;;;1,0;4,0;;;3,0;;3,0;5,0;;10,0;;;;;1,0;1,0;2,0;4,0;10,0;;;1,0;;6,0;;;;28,0;3,0;1,0;;;4,0;;;;;8,0;;;5,0;2,0;;;;;;;;;;;;2,0;;1,0;3,0;3,0;1,0;;;;3,0;;;;;;;;;;;;;;6,0;;2,0;;;;;;1,0;;;;;;;;;;;;;;;;;;;;;;;;1,0;;;;2,0;;;;;;;;;;;;;;2,0;;;;;;;;;;;;;;;;;;;;;;;;;;;;;;5,0;;;;;;;2,0;;3,0;;;;;;;;;16,0;;;4,0;;;;;;;;;;;1,0;;;;4,0;;6,0;4,0;3,0;;1,0;;4,0;;;;1,0;;;;;;;2,0;;;;;;;;;;1,0;;2,0;1,0;;;;1,0;;;;;;;;2,0;;;;1,0;2,0;;;;2,0;;;;;;;;;1,0;;10,0;;;;;;;;;;;;2,0;3,0;;;;;;;;;;;;;;;;;;;;;;;;;;;;5,0;;;;;;;;;;;;;;;;;;;2,0;;
slot;;1,0;;;;2,0;4,0;12,0;1,0;14,0;4,0;;;;5,0;23,0;;;;;;2,0;;2,0;7,0;;;;;;;1,0;14,0;;1,0;2,0;;;;;3,0;;66,0;;;;22,0;36,0;3,0;9,0;10,0;1,0;;;1,0;15,0;28,0;;;;45,0;;;;2,0;;5,0;42,0;5,0;9,0;15,0;;1,0;;;4,0;;1,0;4,0;6,0;;1,0;;29,0;;;;;1,0;1,0;18,0;;;3,0;;3,0;7,0;;12,0;;;;32,0;1,0;;1,0;2,0;;;;10,0;4,0;3,0;;;35,0;78,0;18,0;;2,0;;;;2,0;;;;;;1,0;;5,0;7,0;;;;21,0;;;;;;;3,0;;;2,0;59,0;;;;1,0;;;;2,0;7,0;;5,0;;;;13,0;;2,0;;;;;;;;1,0;10,0;;;3,0;6,0;;;4,0;14,0;;;;;;5,0;;;;;;26,0;;4,0;;;;13,0;15,0;;1,0;10,0;;6,0;2,0;;;2,0;;2,0;1,0;4,0;;;4,0;;4,0;30,0;40,0;;7,0;;;;2,0;;2,0;;41,0;;;44,0;12,0;4,0;2,0;7,0;6,0;3,0;;3,0;5,0;;;;;;;;37,0;;3,0;1,0;;;47,0;;9,0;;1,0;;37,0;;;;42,0;;;;71,0;1,0;8,0;;;7,0;;2,0;3,0;50,0;6,0;;;;;67,0;;;;1,0;;6,0;;;21,0;;;1,0;;;4,0;6,0;14,0;;5,0;7,0;2,0;7,0;13,0;;;8,0;;3,0;;;;42,0;;20,0;;3,0;;;3,0;;41,0;1,0;;;5,0;7,0;6,0;;;;;47,0;6,0;1,0;2,0;2,0;27,0;3,0;;;19,0;1,0;10,0;;;7,0;;;;1,0;2,0;5,0;16,0;;;;2,0;6,0;6,0;;4,0;1,0;21,0;;;4,0;2,0;;;;5,0;8,0;12,0;4,0;18,0;1,0;;24,0;4,0;;5,0;1,0;;20,0;1,0;;;;8,0;3,0;5,0;4,0;2,0;;;;2,0;12,0;;;;1,0;;;;;;;;1,0;;;;;;2,0;;;;;1,0;6,0;;;;1,0;;;;;;;;;2,0;2,0;;;7,0;1,0;10,0;;;6,0;;;;;;3,0;;;;;1,0;;;;5,0;;;1,0;;;;;1,0;;4,0;;;;;1,0;6,0;8,0;;11,0;;;;;;;;;;;;;;;13,0;;9,0;;;;;;2,0;;;;;;;4,0;3,0;;;;;;;;15,0;15,0;;;;2,0;;;;;1,0;1,0;;14,0;1,0;;;;;2,0;;;;;;1,0;4,0;;;12,0;2,0;;;5,0;;;7,0;5,0;35,0;;;;3,0;;4,0;2,0;;;;;;;3,0;3,0;1,0;3,0;;16,0;;1,0;;;;;;;13,0;;;;;10,0;9,0;;;;13,0;;3,0;;9,0;;;2,0;11,0;6,0;;;1,0;;1,0;2,0;;;4,0;;3,0;;;;;;;;11,0;1,0;;;;8,0;;1,0;;;;;;;;;;;;1,0;2,0;5,0;;1,0;;;;1,0;7,0;11,0;;;23,0;1,0;6,0;;;3,0;;1,0;;;6,0;;;14,0;;;;4,0;;1,0;2,0;6,0;2,0;2,0;2,0;;;;;2,0;50,0;;;;1,0;;;1,0;;2,0;9,0;3,0;;;3,0;;;;;;17,0;2,0;;;;8,0;;;;;;;;;;43,0;3,0;1,0;1,0;;2,0;12,0;;1,0;2,0;;;;;7,0;3,0;1,0;;;;2,0;;;;;;;;;;1,0;;;;1,0;;2,0;;;;;1,0;;;;;;;;;;;;;2,0;;;;;;;;;;;;;;;;2,0;;;;;;;;;;;;;;;;4,0;;;;;;;;;;;;;;;;;;;;;;;;;;;3,0;;;;;;;;;;;;;;;;;;;;;;;;;;;;;;;;;2,0;;;;;;;;;;;3,0;;;;;;;;;;;;;;;;;;;;;;;;;1,0;;;;7,0;;;;;;;;;;;;;;;;;;;;;;;;;;;;2,0;;;;;4,0;;1,0;;;;1,0;2,0;;;;2,0;4,0;;;;;;;;;;;;;;;;;;;;;;;;2,0;;2,0;;;;;;;;;;;;;;;;;;;
socket;;3,0;;;;;1,0;13,0;1,0;6,0;;;1,0;;2,0;16,0;;;;;1,0;;;8,0;;;;;;;;;30,0;;2,0;;;;;;5,0;1,0;17,0;;;;;23,0;4,0;;9,0;;;;2,0;5,0;110,0;;;;7,0;;;;;;1,0;32,0;8,0;2,0;;;;;;3,0;;;;5,0;;28,0;;63,0;;;;;;1,0;24,0;;;;;;6,0;;3,0;1,0;;;43,0;;;;5,0;;;;5,0;;;;;14,0;83,0;20,0;;;;;;;1,0;;;;;;;;7,0;6,0;;;1,0;;;;;;;1,0;;1,0;;18,0;1,0;2,0;;;;;;;10,0;;;1,0;;;14,0;;;;;;;;;;;4,0;;;12,0;1,0;;;19,0;2,0;;1,0;;13,0;;13,0;;;3,0;2,0;;23,0;;11,0;;5,0;;6,0;1,0;1,0;;5,0;;3,0;;;;7,0;3,0;;;1,0;;;1,0;;;9,0;47,0;;14,0;;;33,0;5,0;;;;36,0;7,0;6,0;23,0;;;1,0;14,0;3,0;7,0;;;;;;;;;;;14,0;;5,0;;;;50,0;;;;2,0;;11,0;4,0;;;4,0;3,0;;;3,0;;22,0;;;4,0;;14,0;1,0;36,0;;;6,0;;;1,0;;;;;12,0;2,0;;;12,0;;;1,0;;;2,0;4,0;10,0;;185,0;2,0;;4,0;12,0;;;1,0;;;;4,0;1,0;70,0;;3,0;;;;2,0;8,0;;17,0;1,0;;;;2,0;;;1,0;;1,0;;1,0;22,0;;;9,0;2,0;;;9,0;;2,0;;1,0;;;;;160,0;;2,0;8,0;5,0;;;;;6,0;3,0;2,0;2,0;10,0;;7,0;4,0;3,0;;1,0;;;4,0;5,0;1,0;10,0;1,0;;1,0;;;;15,0;;12,0;;;;3,0;23,0;;;;;;;;;1,0;;;;;;;;;;;;;;2,0;;;;;;;;;;;;;;;;;;;7,0;;;;;;1,0;;;;1,0;;;;4,0;;;;;;;;;;;;;;1,0;1,0;;;;;;;;;;;;;;;9,0;5,0;1,0;2,0;;;;;;;;;;;;;4,0;;3,0;;1,0;;1,0;;;;;;;;;;;;;;14,0;;;;;;;;;;;1,0;;2,0;;;;4,0;;11,0;;2,0;;;;;;;;;;;;;;15,0;;;;;;;6,0;;6,0;;;;;;1,0;1,0;;;;;;;;;;;;;;;;;5,0;;;;;;;;;;;;;;3,0;;3,0;;;;;;;3,0;;;;;;;;;;;;;;;1,0;;;;;;;;;;;;;;;2,0;;;;;;;;;;;;;;;;3,0;1,0;8,0;;;;;3,0;;;;;;;;;;;6,0;;;;;;;;;5,0;;18,0;1,0;1,0;;;;;;;;;;;;;;5,0;;;;;;5,0;;;;;;5,0;;;4,0;;;;;;;;;;;;;3,0;;;2,0;;;;;;;;4,0;;2,0;;;;;1,0;;;;;;;;;1,0;1,0;;;5,0;;;;;;;;;;1,0;;;;;;;;;;2,0;;;;;;;;;;;;;;;;;;;;;;;;1,0;1,0;;;;;;;;;;;;2,0;;;;;;;;;;;;;;;;;;;;;;;;;;;;;;;;;;;;;;;;;;;;;;;;;;;;;;;;;;1,0;;;;;;;;;;;;;;;;;;;;;;;;;;;;;;;;;2,0;;;;;1,0;;;;;;;7,0;;1,0;;1,0;;;;;;;;;;;;;;;;113,0;;;;;;;;;;;;;;;;3,0;;1,0;;;;;;;2,0;;;;;;;;;;;;;;;;;;;;;;;;;;;;;;;;;;;;;
software;;1,0;1,0;;3,0;1,0;;11,0;2,0;;1,0;;2,0;;;3,0;;1,0;;;2,0;2,0;;;;;1,0;4,0;;;26,0;;17,0;;6,0;4,0;1,0;2,0;4,0;;15,0;1,0;;1,0;7,0;7,0;7,0;28,0;47,0;18,0;;2,0;;;14,0;;1,0;2,0;1,0;31,0;1,0;2,0;2,0;9,0;8,0;;1,0;1,0;3,0;;2,0;;4,0;;;;4,0;;2,0;100,0;2,0;3,0;6,0;26,0;2,0;4,0;;;;;2,0;;5,0;;;12,0;16,0;;25,0;12,0;;1,0;8,0;4,0;;17,0;4,0;1,0;29,0;6,0;;20,0;;;;7,0;;5,0;3,0;;2,0;;14,0;33,0;53,0;14,0;;;;;1,0;1,0;;;;;;2,0;;;;;3,0;15,0;1,0;;;;5,0;4,0;;;22,0;18,0;;;57,0;;;1,0;;2,0;25,0;;;;6,0;4,0;;;;;;;10,0;2,0;1,0;;;;;;;;;13,0;;9,0;;;;;;4,0;;;4,0;;;;;;;2,0;1,0;;;;2,0;;;;;;;;;;;;;;;;1,0;;;;2,0;;;;;;;;1,0;;;;;;;;;;;;1,0;;1,0;;;;;;9,0;;;;;;;3,0;;;;;;;;;;;;;7,0;;;;;;1,0;;;5,0;;;;;;;;;;;;;;;;;;;;;;1,0;;;;;;;;2,0;;;;1,0;;;;;1,0;1,0;;;;;;;;;;;;;6,0;;;;;;;;;;1,0;4,0;;;;;;;3,0;2,0;;;;;;;;;;;;2,0;;;;1,0;;;;;1,0;;;;1,0;;;;;;;8,0;;4,0;;2,0;;;;;;;;;3,0;9,0;;;;;;11,0;;20,0;2,0;2,0;17,0;;;;;;;;1,0;;;;;4,0;;2,0;;3,0;;;2,0;;1,0;1,0;9,0;;;1,0;;4,0;6,0;31,0;1,0;;;;;;;;;4,0;;4,0;;1,0;;;;1,0;;;;;;;1,0;;9,0;5,0;11,0;2,0;1,0;;;;1,0;;3,0;;1,0;;;;1,0;1,0;;2,0;;43,0;;2,0;;;7,0;;;;18,0;4,0;;;;;;;;;1,0;16,0;3,0;;8,0;;;;;;;2,0;;;1,0;1,0;;2,0;;;;6,0;;;;;1,0;;1,0;;1,0;;;2,0;;1,0;;;;;;;;;;;;;;5,0;;1,0;;3,0;1,0;15,0;;;;4,0;1,0;;2,0;12,0;;;3,0;;;;10,0;;;;;;;15,0;;;;;6,0;11,0;;;1,0;3,0;;4,0;8,0;;;;;;8,0;;;;;1,0;;;;11,0;;11,0;;2,0;;22,0;1,0;;1,0;;;;;;;;9,0;1,0;14,0;;;;;;;;;;3,0;;2,0;;;14,0;;;;;;;;;;1,0;;;;1,0;;2,0;;;16,0;;;;;2,0;;;;;;;;;;;;;;1,0;;;;;;;;;;;;;;;;;;;;;;;;;;;;;;;;;;;;;;;;;;1,0;1,0;;;;3,0;;;3,0;;;;;;;2,0;;;;;;;;;;;;3,0;;;;;;;;;;;;;;;4,0;;;;;;;;1,0;;;;;1,0;;;;;;;;1,0;;;;;;;1,0;;5,0;;;;;;3,0;;;;;;;1,0;;;;;;;1,0;;;;3,0;2,0;;;;;;;;;;;;;;;;6,0;;;;;;;1,0;1,0;;;;32,0;;;;;;;;;;;;1,0;;2,0;1,0;;;;;1,0;;;;;;;;;;;1,0;;1,0;;;;;;;;;;;;;5,0;;;;;;;;;;;;;;;;;;;;;2,0;;;;;;;;;1,0;;;;;;;;;;;;;;2,0;;1,0;;;;;;;;;2,0;;;;;;;1,0;;;;;;;;;;;;;;;;3,0;;;;;;;;;;;;;;;;;;;
source;;15,0;2,0;11,0;4,0;33,0;18,0;128,0;53,0;168,0;35,0;;40,0;1,0;26,0;103,0;119,0;;10,0;12,0;35,0;91,0;6,0;5,0;2,0;;137,0;6,0;3,0;1,0;95,0;4,0;316,0;1,0;241,0;41,0;;;11,0;;78,0;;48,0;32,0;65,0;18,0;90,0;378,0;30,0;58,0;69,0;69,0;;9,0;54,0;4,0;49,0;1,0;24,0;2,0;8,0;167,0;34,0;6,0;29,0;6,0;17,0;51,0;62,0;6,0;22,0;50,0;234,0;23,0;;27,0;52,0;167,0;408,0;569,0;13,0;92,0;2,0;299,0;1,0;21,0;1,0;;;6,0;128,0;2,0;4,0;11,0;6,0;6,0;15,0;9,0;187,0;13,0;2,0;16,0;110,0;97,0;11,0;73,0;206,0;2,0;198,0;18,0;25,0;26,0;;5,0;5,0;236,0;86,0;184,0;420,0;26,0;;2,0;9,0;51,0;36,0;18,0;1,0;3,0;120,0;25,0;;163,0;26,0;2,0;6,0;;14,0;18,0;11,0;;48,0;;3,0;147,0;9,0;;;58,0;253,0;5,0;8,0;;20,0;70,0;3,0;73,0;297,0;;5,0;4,0;8,0;32,0;153,0;;7,0;2,0;175,0;57,0;78,0;39,0;3,0;1,0;;15,0;4,0;12,0;13,0;;1,0;8,0;6,0;34,0;;6,0;29,0;104,0;;15,0;13,0;;;5,0;4,0;212,0;4,0;53,0;10,0;;;;4,0;;13,0;58,0;12,0;;18,0;62,0;14,0;22,0;6,0;3,0;4,0;58,0;1,0;6,0;3,0;16,0;2,0;4,0;126,0;37,0;13,0;;1,0;2,0;16,0;;3621,0;3,0;27,0;8,0;27,0;52,0;2,0;24,0;10,0;11,0;5,0;4,0;6,0;20,0;5,0;65,0;4,0;1,0;;3,0;128,0;30,0;15,0;4,0;4,0;;7,0;58,0;98,0;31,0;6,0;2,0;;;6,0;115,0;14,0;;24,0;4,0;22,0;;;;10,0;;51,0;3,0;4,0;24,0;29,0;76,0;65,0;3,0;33,0;12,0;1,0;48,0;;3,0;;20,0;9,0;5,0;;;23,0;;;;14,0;;12,0;11,0;10,0;6,0;;5,0;16,0;36,0;;1,0;14,0;;5,0;;24,0;9,0;2,0;1,0;1,0;59,0;;5,0;3,0;5,0;32,0;4,0;3,0;;;9,0;;;;11,0;1,0;18,0;26,0;21,0;3,0;1,0;;1,0;;16,0;9,0;4,0;;6,0;15,0;19,0;2,0;1,0;5,0;20,0;;1,0;;58,0;2,0;19,0;1,0;38,0;;2,0;;2,0;12,0;7,0;2,0;28,0;2,0;3,0;;1,0;;1,0;4,0;1,0;4,0;2,0;;;8,0;10,0;3,0;2,0;1,0;;;10,0;7,0;50,0;25,0;1,0;;25,0;;3,0;3,0;;;;5,0;17,0;;;;6,0;11,0;23,0;25,0;11,0;14,0;;3,0;14,0;;18,0;3,0;2,0;;5,0;78,0;2,0;3,0;;;7,0;;3,0;;27,0;38,0;11,0;90,0;6,0;5,0;13,0;44,0;9,0;7,0;20,0;64,0;;66,0;25,0;17,0;1,0;7,0;1,0;5,0;;;4,0;15,0;10,0;33,0;3,0;;;23,0;1,0;24,0;1,0;;;1,0;;8,0;10,0;6,0;10,0;3,0;4,0;36,0;5,0;11,0;;143,0;3,0;25,0;;2,0;15,0;25,0;;3,0;1,0;;7,0;5,0;34,0;7,0;2,0;13,0;2,0;6,0;;14,0;6,0;11,0;3,0;1,0;44,0;7,0;1,0;21,0;;12,0;1,0;9,0;6,0;;1,0;19,0;;;2,0;;;64,0;42,0;2,0;11,0;9,0;;67,0;2,0;;5,0;;5,0;14,0;9,0;1,0;;13,0;14,0;;8,0;;2,0;;5,0;;47,0;58,0;10,0;;43,0;2,0;;8,0;4,0;26,0;16,0;2,0;52,0;1,0;2,0;1,0;6,0;24,0;31,0;;4,0;4,0;29,0;1,0;4,0;21,0;;97,0;;2,0;5,0;13,0;7,0;1,0;;2,0;1,0;4,0;4,0;146,0;2,0;;;2,0;;30,0;19,0;;8,0;3,0;;1,0;;6,0;19,0;38,0;;22,0;1,0;18,0;16,0;1,0;;;4,0;;15,0;1,0;1,0;10,0;2,0;1,0;2,0;;4,0;4,0;;;;3,0;1,0;92,0;2,0;;2,0;9,0;;;5,0;4,0;6,0;5,0;1,0;;2,0;4,0;8,0;2,0;6,0;;3,0;1,0;;12,0;;11,0;6,0;;3,0;5,0;2,0;6,0;;;;;30,0;32,0;14,0;2,0;4,0;3,0;41,0;;3,0;23,0;2,0;19,0;1,0;;10,0;;;5,0;;;1,0;4,0;;;3,0;;7,0;;1,0;1,0;5,0;;2,0;1,0;;4,0;38,0;2,0;3,0;;3,0;;1,0;;;4,0;6,0;;;1,0;5,0;1,0;2,0;;5,0;68,0;1,0;5,0;;2,0;4,0;12,0;;17,0;11,0;7,0;7,0;1,0;20,0;1,0;;3,0;8,0;378,0;2,0;51,0;1,0;;;9,0;1,0;6,0;4,0;1,0;1,0;;2,0;5,0;;2,0;1,0;10,0;2,0;;1,0;;;13,0;;;25,0;20,0;1,0;;1,0;;17,0;8,0;4,0;;18,0;1,0;8,0;;4,0;;;5,0;6,0;23,0;9,0;1,0;12,0;15,0;1,0;27,0;;2,0;18,0;2,0;7,0;196,0;38,0;1,0;67,0;;;;1,0;;41,0;1,0;;7,0;;;;8,0;1,0;2,0;3,0;;;1,0;2,0;5,0;1,0;1,0;2,0;1,0;;11,0;6,0;1,0;7,0;1,0;;4,0;;8,0;55,0;2,0;27,0;;7,0;6,0;;2,0;6,0;11,0;;;2,0;;;2,0;;;;3,0;;10,0;1,0;1,0;;;2,0;4,0;;;;;;22,0;1,0;1,0;4,0;1,0;2,0;;6,0;122,0;;7,0;;;;;4,0;4,0;3,0;;6,0;7,0;;;2,0;2,0;;;4,0;;1,0;32,0;3,0;;;74,0;9,0;4,0;;10,0;1,0;2,0;;1,0;;3,0;2,0;;1,0;6,0;2,0;50,0;;14,0;4,0;1,0;;;;1,0;;;5,0;8,0;3,0;7,0;;1,0;;;;3,0;1,0;;1,0;;;18,0;1,0;;3,0;;;;22,0;2,0;2,0;;6,0;3,0;14,0;1,0;;2,0;;;;;;;5,0;3,0;;;1,0;;;;;;;;;;1,0;2,0;4,0;6,0;;;;;;;9,0;;4,0;1,0;;5,0;1,0;;4,0;7,0;;;2,0
spring;;2,0;;;;13,0;;9,0;2,0;30,0;;;;;32,0;55,0;1,0;;;;;3,0;;;16,0;;;2,0;2,0;3,0;;;88,0;;17,0;6,0;;;2,0;;6,0;1,0;11,0;;;2,0;;88,0;2,0;;47,0;8,0;;4,0;49,0;2,0;40,0;;;;42,0;10,0;;;2,0;;3,0;51,0;20,0;15,0;1,0;;14,0;;;9,0;;;;14,0;;4,0;;138,0;2,0;;3,0;;24,0;3,0;165,0;;;4,0;;;7,0;;9,0;8,0;;;158,0;;;;14,0;2,0;;;10,0;4,0;;;;40,0;209,0;66,0;5,0;7,0;5,0;;;;;;;;;;;;2,0;;;;5,0;2,0;;;;;;9,0;3,0;;1,0;26,0;;1,0;;;;4,0;;8,0;17,0;;;1,0;;;51,0;;;;;4,0;;;1,0;1,0;;11,0;3,0;23,0;51,0;79,0;10,0;;5,0;42,0;2,0;3,0;3,0;5,0;3,0;50,0;6,0;;13,0;20,0;2,0;145,0;1,0;47,0;;;;6,0;1,0;1,0;1,0;83,0;;60,0;4,0;;2,0;4,0;1,0;16,0;132,0;;;;;;;74,0;38,0;;30,0;;;4,0;;9,0;2,0;;169,0;9,0;20,0;31,0;50,0;8,0;3,0;16,0;27,0;24,0;2,0;3,0;1,0;1,0;;;;;;6,0;144,0;;19,0;10,0;5,0;;19,0;;;;24,0;2,0;9,0;5,0;;2,0;34,0;12,0;5,0;;15,0;3,0;28,0;12,0;;;;19,0;7,0;65,0;1,0;;22,0;6,0;;;;;;;1,0;7,0;4,0;;6,0;;1,0;;123,0;3,0;36,0;8,0;56,0;;7,0;7,0;103,0;4,0;25,0;;1,0;9,0;;4,0;11,0;1,0;;9,0;;47,0;;7,0;5,0;3,0;45,0;;20,0;4,0;;;6,0;17,0;;;;;9,0;18,0;21,0;45,0;;7,0;22,0;3,0;7,0;21,0;21,0;10,0;25,0;;6,0;8,0;;1,0;16,0;3,0;;1,0;7,0;4,0;;1,0;;2,0;20,0;1,0;;8,0;2,0;;;16,0;2,0;;;1,0;30,0;;20,0;10,0;11,0;13,0;;12,0;8,0;;;4,0;;75,0;5,0;;;1,0;8,0;;3,0;12,0;;;;;;1,0;1,0;;;;;;;;;;;37,0;3,0;;;;;2,0;;;;;;2,0;;;;;1,0;13,0;2,0;;;;;;1,0;;7,0;;;7,0;8,0;;3,0;;;;;;;1,0;1,0;;;;;;;;;2,0;;;;;;;;;;;3,0;;;;20,0;;;17,0;;;;;3,0;;;;;;;1,0;;;;;30,0;;1,0;;;;;;4,0;;;1,0;;;;;;;;;;;2,0;1,0;;;1,0;7,0;;;;1,0;1,0;32,0;;1,0;;;;;;9,0;;;;2,0;;;;;;;;;;15,0;;;9,0;;;;;;;;1,0;;;;;;;;6,0;;4,0;6,0;;;;2,0;;;1,0;;;;;;;;;3,0;5,0;;;;;9,0;14,0;;;;;;;;;;;;7,0;3,0;;;2,0;;;;;;;;;;14,0;;1,0;;;;;10,0;;;;7,0;;2,0;;;;;;;;13,0;;1,0;;;;7,0;6,0;;;;5,0;9,0;7,0;8,0;;4,0;;1,0;;3,0;3,0;19,0;4,0;;;;1,0;;1,0;4,0;2,0;;3,0;;4,0;11,0;9,0;7,0;;1,0;;;;;4,0;;;4,0;;;2,0;;;;3,0;;;2,0;;;;4,0;;;;93,0;;;;;21,0;16,0;;9,0;;;3,0;49,0;5,0;;;7,0;;;1,0;;;;;1,0;3,0;2,0;;1,0;;1,0;1,0;4,0;;;1,0;;;;;;2,0;9,0;;;4,0;;;;;;;;;;;;;2,0;;;;1,0;;5,0;;2,0;;;;;;;;;;1,0;;;;;;;;;;;;1,0;1,0;;;;;;;;;;;;;3,0;;2,0;2,0;;2,0;;;;;;;;;;;;;;;;;;;;;;1,0;;2,0;;2,0;;;;;;;;;;;;;;;;;;;;;;;1,0;;;;2,0;;2,0;;;;;3,0;;;;;;;;;;2,0;;2,0;1,0;;;;;;;;;;;;;1,0;2,0;;;;;;;;;;;;5,0;;;6,0;;6,0;6,0;;;;;;;;;;;;1,0;;;;;;;;19,0;;;;16,0;3,0;2,0;;2,0;;8,0;;;;;;;1,0;;;;;;;;;;;;;;;10,0;2,0;;;;;;;;;;;;;;;;;;;1,0;;
stand;;1,0;;4,0;;2,0;;1,0;;;;;;;5,0;10,0;;;;;;1,0;;2,0;;;;3,0;1,0;1,0;;;5,0;;1,0;;;;;;;;;;;;2,0;19,0;3,0;35,0;5,0;1,0;;;4,0;;5,0;;;;;3,0;;;;;2,0;1,0;;3,0;;;;;;;2,0;;;2,0;1,0;9,0;;6,0;;;1,0;;;2,0;4,0;;;1,0;;;;;6,0;16,0;;;1,0;;;;;;;;;;;;;2,0;18,0;21,0;1,0;3,0;;;;1,0;;;;;;;;1,0;12,0;2,0;;;3,0;;;;1,0;12,0;;5,0;2,0;;;;5,0;1,0;;;;;;;22,0;;;;;3,0;6,0;;;;6,0;;;;;;;1,0;;;6,0;;;;;5,0;1,0;;;;;6,0;2,0;;;;;6,0;;1,0;;;;;;1,0;;1,0;;;;;;;;;2,0;;;;;;;;7,0;;;;;1,0;;1,0;1,0;;17,0;;1,0;6,0;4,0;2,0;2,0;3,0;;;;;;;;;;;;7,0;;;;;3,0;3,0;9,0;;;;;;1,0;7,0;;;1,0;;2,0;;1,0;1,0;;;;;;1,0;;6,0;;;4,0;1,0;;;;;2,0;;3,0;2,0;2,0;;;;;;;;7,0;;;;2,0;;3,0;;5,0;;;;;;1,0;;;;;17,0;;;;;;;2,0;5,0;;;;11,0;;;;;7,0;1,0;;3,0;2,0;;1,0;2,0;;;9,0;1,0;;;;2,0;;;;7,0;1,0;;;;;;;;;;;;;;;;;;;4,0;;;;;7,0;;;2,0;;;;2,0;;11,0;;;;;5,0;3,0;;;;;;;;;;;;;;;;;;;;;;;;;;;;;;;;1,0;;;;;;;3,0;;;;14,0;;;;;;3,0;1,0;;;1,0;7,0;;;;;;1,0;;;;;2,0;;;;;;;;;;;;;;4,0;;;;;;1,0;;;;;;;;;;;3,0;;;;;;;;;8,0;;;;;;;;;;;;;;;;;;;;;;2,0;1,0;;;;1,0;;;;;;1,0;;2,0;;10,0;;;;;;;;;;;;;;3,0;;;2,0;;3,0;1,0;;;;1,0;;;;;;1,0;5,0;;;;;;;;;;;;2,0;;;;;;;;7,0;;;;;;;;;1,0;;;;;;;;1,0;;;;;;;;;;;;;;;;;2,0;1,0;1,0;;1,0;;;;;;;1,0;;;;;;;;;;;;;;;;;;5,0;;;4,0;;;;;;2,0;;;;;;;;;;;2,0;;;3,0;;;;1,0;1,0;;;;;;1,0;;;;;;;;;;;;;;;;;4,0;;1,0;;;;;5,0;;;;3,0;;;;;2,0;;;;;;;;;;;;3,0;;;1,0;;;;1,0;;6,0;;;;;2,0;;;;;;1,0;;;;1,0;;;2,0;;;;;;;;;;;;;1,0;;;;;;;;;;;;;;;;9,0;;;;;;;;;;;;;;;;;;;;;;;;;;;;;;;;;;;;;;;;;;;;;1,0;;;;;;;2,0;;;;;;;;2,0;;;;;;;;;;;;;;;;;;;;;;;;;;;;;;;;;;1,0;;;;;;;;;1,0;;;;;;;;;;;1,0;;2,0;;;;;;;;;;;;;;1,0;;;;;;;;;;;;;;;;;;;;;;;;;;1,0;;;;;;;;;;;;;;;;;;;;;;;;;;;;;;;;;;;;;;;;;;;;;;;;;;;;;;;;;
start;;9,0;;4,0;2,0;;31,0;37,0;12,0;;4,0;;32,0;;1,0;52,0;;2,0;;2,0;1,0;72,0;6,0;;;1,0;4,0;;;;1,0;25,0;54,0;7,0;113,0;46,0;1,0;2,0;;;59,0;;1,0;6,0;79,0;33,0;73,0;47,0;11,0;36,0;1,0;5,0;4,0;;26,0;2,0;7,0;;;2,0;5,0;3,0;;1,0;1,0;4,0;40,0;1,0;83,0;;28,0;6,0;40,0;27,0;;3,0;9,0;1,0;9,0;218,0;5,0;67,0;;31,0;;242,0;11,0;3,0;;1,0;60,0;;;;;2,0;2,0;1,0;36,0;4,0;1,0;;9,0;33,0;;3,0;6,0;9,0;83,0;1,0;2,0;32,0;;;2,0;9,0;32,0;86,0;14,0;59,0;;;18,0;41,0;5,0;2,0;;4,0;;17,0;2,0;24,0;;10,0;2,0;2,0;1,0;74,0;;;2,0;;3,0;19,0;19,0;;;2,0;236,0;;6,0;;9,0;9,0;3,0;6,0;15,0;;3,0;2,0;3,0;11,0;229,0;;2,0;;22,0;15,0;;;1,0;2,0;;;21,0;;;;;;;27,0;;;19,0;6,0;;;;;;;;4,0;;2,0;1,0;;;;;;5,0;10,0;3,0;;6,0;1,0;127,0;2,0;;;;5,0;;;;2,0;3,0;;;;;;;;;;213,0;;10,0;;5,0;15,0;3,0;15,0;68,0;30,0;;;4,0;1,0;;14,0;;;2,0;;16,0;2,0;;;;2,0;;11,0;40,0;;;;;;;19,0;;17,0;1,0;;59,0;;;4,0;;;2,0;;;2,0;;5,0;6,0;12,0;9,0;;;323,0;;4,0;;;14,0;1,0;5,0;;;;;;;;2,0;3,0;;;;;;16,0;1,0;5,0;;2,0;;;2,0;1,0;;;;1,0;;;;;37,0;;;;;3,0;;;;;;2,0;;2,0;2,0;;;;;2,0;;2,0;2,0;;3,0;1,0;;;23,0;19,0;;;;62,0;;;;;;;;;22,0;5,0;;1,0;;4,0;;;;;;;1,0;5,0;;;2,0;;;2,0;;;;;;12,0;;;;15,0;;3,0;;;8,0;;;1,0;;;1,0;;3,0;22,0;24,0;44,0;;;;7,0;1,0;4,0;1,0;;;;20,0;9,0;6,0;;1,0;1,0;;;;59,0;12,0;;27,0;2,0;2,0;11,0;38,0;;;12,0;11,0;;;15,0;237,0;3,0;1,0;42,0;10,0;;;11,0;4,0;30,0;;3,0;;;;;;2,0;;1,0;;;4,0;5,0;4,0;;6,0;8,0;22,0;;;2,0;10,0;;6,0;;2,0;17,0;14,0;52,0;;;;2,0;;;15,0;13,0;;;;3,0;6,0;;3,0;;3,0;30,0;;;32,0;;9,0;;;4,0;;;;22,0;;;;2,0;16,0;25,0;4,0;32,0;;1,0;;;;7,0;;;5,0;4,0;;;39,0;2,0;1,0;36,0;;;;3,0;6,0;3,0;;12,0;;33,0;;;;;22,0;;;;;5,0;;2,0;;2,0;;28,0;;44,0;;3,0;;2,0;5,0;;;;;;;3,0;;;;4,0;37,0;;;7,0;;1,0;21,0;;14,0;;;;;;;12,0;;;2,0;;;;2,0;;10,0;;;;;;;;;;;1,0;6,0;;;2,0;1,0;;8,0;4,0;;;23,0;;;;;;;;7,0;;3,0;;1,0;3,0;1,0;5,0;;;1,0;1,0;12,0;;;;1,0;;6,0;;;;;1,0;;;3,0;;;2,0;;26,0;7,0;;146,0;1,0;;;;;;;;;3,0;;4,0;;30,0;1,0;5,0;;;6,0;1,0;;6,0;;;;;;;;;;;;13,0;11,0;;;;6,0;;1,0;;;;;6,0;;1,0;;;;16,0;;;;;1,0;6,0;1,0;;;7,0;;;10,0;;3,0;5,0;;;1,0;;;;;;;;;;;;3,0;;;;;17,0;;;;7,0;;;2,0;;2,0;;;2,0;7,0;;3,0;;;;3,0;;;;;2,0;;14,0;;;9,0;6,0;;2,0;3,0;;2,0;;;;7,0;;20,0;;;1,0;;;;2,0;3,0;;2,0;;;;1,0;1,0;4,0;2,0;;;;;;28,0;;;10,0;;;;;;;;3,0;;;;;;;;;;;3,0;1,0;;16,0;;1,0;;2,0;;;1,0;;3,0;;;;;;;;;;;;;;;;;;9,0;;;;;;;25,0;;4,0;;;;;;;;;;;;;;2,0;;;1,0;2,0;1,0;;;;;;;;;;;;;;16,0;3,0;;;;2,0;;;;11,0;1,0;;;;;;;;1,0;;4,0;;;;;;;;;;;;;;;;;;;;;;6,0;;;;5,0;;9,0;;;;;;;;3,0;;;;;;;;;;;;;2,0;;;;;;;;;;;2,0;
status;;11,0;;;;2,0;1,0;26,0;;;;;12,0;;;19,0;;;4,0;;;27,0;;;;;;3,0;;;6,0;6,0;14,0;;49,0;6,0;2,0;5,0;;;7,0;;;;6,0;2,0;25,0;36,0;11,0;60,0;;;3,0;;7,0;3,0;20,0;;;;;2,0;;;;;11,0;;8,0;;14,0;;3,0;;;;;;;33,0;;1,0;;53,0;;6,0;7,0;;;;23,0;;;;;;5,0;;24,0;1,0;;1,0;54,0;7,0;;;;;15,0;3,0;;;1,0;;;5,0;;7,0;32,0;1,0;;;9,0;11,0;2,0;;;;;;1,0;;;;6,0;;3,0;13,0;;;;3,0;5,0;21,0;7,0;;;1,0;55,0;;2,0;;;3,0;6,0;23,0;14,0;;;4,0;1,0;45,0;27,0;;2,0;;6,0;;;;;;;;;3,0;;;;;;3,0;;;;15,0;;3,0;;;;;;3,0;;;;;;;;;;6,0;;;;4,0;3,0;2,0;;;3,0;;;;;;;;;;;;;1,0;;;8,0;;18,0;;;2,0;1,0;;;11,0;;;;;;2,0;;;;;;;;;;1,0;;;44,0;;;;;;;1,0;;;;;8,0;;6,0;1,0;;;;;;;;;54,0;;;;;5,0;1,0;;;;13,0;1,0;1,0;;;;;;;;;;;;;;;;;;28,0;2,0;;;;;;2,0;;1,0;;;;;2,0;;1,0;;;;;;;;;;;;;;;;;;;2,0;;;;;;;;;;;;;9,0;;2,0;;;;;;;;;;;1,0;;;6,0;;;;;;;;;;;;;;;;;16,0;;;;17,0;1,0;;;4,0;1,0;;2,0;;;;;;;;17,0;;2,0;;;;;;;;;;2,0;;;;2,0;;;18,0;;8,0;4,0;;1,0;;;;65,0;;22,0;24,0;;;1,0;1,0;3,0;;11,0;2,0;;1,0;;;;6,0;18,0;1,0;1,0;;;;5,0;2,0;;;;2,0;9,0;;;;58,0;;21,0;;;;;2,0;;;;;;;;;1,0;;;;13,0;11,0;5,0;2,0;2,0;6,0;4,0;;;;21,0;;9,0;;;;;;;;;;;6,0;;;;;;4,0;3,0;;;;;;;;;;2,0;7,0;;;67,0;;2,0;;;;;;2,0;14,0;;7,0;;;;;;;;;;18,0;;3,0;;;;;;12,0;;6,0;;;;;;1,0;4,0;2,0;;;1,0;;6,0;;1,0;;49,0;;2,0;;;;;;63,0;1,0;;;;2,0;;1,0;;;16,0;;;3,0;3,0;;;;2,0;;;;;;;;;;;;;;;;;;;;2,0;;;;4,0;;2,0;;;5,0;;;;;;;;;;;;10,0;;;;3,0;23,0;;;;;;;;;;;1,0;;;15,0;;1,0;;;;;;;;;;;;;;;;;;;;;;29,0;;;;;;;;;2,0;;;;;;;;;;;;;;;;;;;;;;;;;;;;;;;;;;;;;1,0;;1,0;;;;;;;;;;;;;;;;;;;;;;;3,0;1,0;;;;;3,0;1,0;;;;;;;;;;;;;;;;;1,0;;;;;;;;;;;;6,0;;;;;;;;2,0;;;;6,0;;;;1,0;;;;;;;;;;;;;;;;;;;;;;;;;;;5,0;;;1,0;;;;;1,0;;;;;;;;;;;;;;;;;;;1,0;;;;;;;;;;;;;1,0;;;;21,0;;;;;;;;;;;1,0;;;;;;;;;;;;;;;;;;;;;;;;;;;;;;;;;;;2,0;;;;;;;;;;;;;;;;;;;;;;;;;;;;;;;;;;;;;;;;;;;;;;;;;3,0;;;;;;;;;;;;;;;;
strap;;2,0;;;;;13,0;1,0;2,0;4,0;;;2,0;;;;;;;;;;;;;;;5,0;;;;;20,0;;;;;;2,0;1,0;;;4,0;;;;;50,0;;;14,0;;;;;4,0;1,0;;;;6,0;;;2,0;;;;11,0;;5,0;;;;;;;;;;;;;;49,0;;;;;;29,0;1,0;;;9,0;;;;;4,0;;;;;;;;;;;;20,0;;1,0;;;11,0;176,0;32,0;;;2,0;;;;;;2,0;;;;;;;1,0;;;;;;;;;;;;;;12,0;;10,0;;;;;;;56,0;;;;;;;;2,0;;;;;;;;;6,0;;;16,0;;;;;2,0;;;;;;25,0;;;1,0;;;69,0;;1,0;;;;4,0;;1,0;;2,0;2,0;3,0;;;;;;1,0;;;;;1,0;;;7,0;8,0;;1,0;;;2,0;;;;;2,0;1,0;;42,0;3,0;16,0;1,0;4,0;2,0;;;6,0;;;;;;;;;24,0;;;;;;77,0;;;;;;14,0;;;;9,0;;;;48,0;;1,0;;;;;;;13,0;;;;1,0;2,0;;;;;;;1,0;;;;;;;;;;4,0;51,0;;16,0;;;;;;;;;;2,0;;;54,0;;2,0;;2,0;1,0;5,0;;;41,0;7,0;;;8,0;25,0;;;;;4,0;1,0;5,0;3,0;;;5,0;10,0;;;1,0;;;;;;;;;1,0;2,0;3,0;;1,0;;;;;;;;;;;4,0;;15,0;;;2,0;5,0;;;;16,0;;;;2,0;;2,0;;;1,0;1,0;;;1,0;26,0;;;3,0;;;;;;12,0;;;;;;;;;;;;;;1,0;;;;;;;;;;;;;;;;;3,0;;;;;;;;;;;;;;;;;;;;;;;;;;;;;;9,0;;;;;;;;;;31,0;;;;;2,0;4,0;;;;;;;;3,0;;;;;;;;4,0;;;;3,0;;;;5,0;;;;;;;;;;;;;;;2,0;;;;;;;;;;;;;;;;8,0;;;;;;;;;;;;;;;;;;;;1,0;5,0;;6,0;;;64,0;7,0;;1,0;;;;;;2,0;;;;;;4,0;14,0;;;;8,0;;;;;;;1,0;;;;;;;;;1,0;1,0;;1,0;;;;;;;2,0;;;;2,0;3,0;;;;;;;;;;3,0;;;;;;1,0;;;2,0;;;;;;12,0;;;;;;;;;;;;;;;;;66,0;10,0;;;;3,0;;;;;;;;;2,0;;;16,0;;;;;;;12,0;5,0;1,0;;11,0;7,0;3,0;2,0;;;;;15,0;;11,0;;;;;;;;;;6,0;;;;;;4,0;15,0;3,0;;;2,0;;2,0;;;;;;;;;3,0;;;;;1,0;;;2,0;;;;;;;;;;2,0;;;;;;;;;;;;;;;11,0;1,0;;;;;;;;;;;;;;;;;;;;;;;;;;;;;;;6,0;;;;;;;;;;;;;4,0;;;;;;;;;;;;;;;2,0;;;;;;;;;;;;;;;;;;;;;;;;;1,0;;;;;;;;;;;;;;;13,0;;;;;;;;;;;;;;;;;;;;;;;;;;;8,0;;;;;;2,0;;;;;;;;;;;;3,0;;;;;;;;;;;;;;;;;;;;;;;;;;;;;;;;;;;;;;;;;;;2,0;;;;;;;;;;32,0;;;;;;;;;;;;;;;;;;;;;;;;;;;;;;;;;;;;;;;;;;;;
strobe;;4,0;;;;;;1,0;;;1,0;;1,0;;;4,0;;;;;;4,0;;;;;;;;;;2,0;6,0;;9,0;7,0;;;;;2,0;;;;;;3,0;7,0;;1,0;;;;;;;;;;;;6,0;8,0;;;;;;;;;;1,0;;;;;3,0;10,0;5,0;;3,0;;2,0;;;;;;;10,0;;;;1,0;;;;4,0;;;;;;;;2,0;;3,0;;;;;1,0;;;1,0;;2,0;;;;;;;;5,0;;;;;;1,0;;;;;;;;;;;5,0;;;;;6,0;;;;;1,0;;;3,0;;;;;1,0;18,0;;;;;;;;;;;;2,0;;;;;;2,0;8,0;;;;;;;;;;;;4,0;1,0;;;;;;;;;;;1,0;;;;;;;;;;;;;;;;;;;;;;1,0;9,0;;1,0;;;2,0;;1,0;;;;;;;;;;;;;;;;;;;;;;;;;;;;;;;;;;;;5,0;;;;;6,0;;;;;;;;;2,0;;;;;;;;;;;1,0;;2,0;;;;4,0;;;;;;;;;3,0;;;;;;;;1,0;;;;;;;;;;;;;;;;;;1,0;;;;;;;;;;;;;;;;1,0;;;;;;;;;;;;;;;;;;2,0;;;;;;;;;;;;;;;;;;;;;;;;;;;;;;;;;;;;;;2,0;;;;;;;;;;;;;;;;;;;;;;;;;;;;1,0;;;;1,0;;;;;12,0;;;;;;;;;;;;;;;;;;;;;;;;;;;;;;;;;;;;;;;;;;;;;;;2,0;;;;;2,0;;1,0;;;2,0;;;;;6,0;;;;;;;;;;;;;;;;;;;;;;;;;;;;2,0;;;;;;;;;;;;;;;;;;;;;;;;;;;;;;;;;;;;;;;;;;;;;;;2,0;23,0;;;;;;;;;;;;;;;;;;;;;;;;;;;;;;;;;;;;;;;;;;;;;;;;;;;;;;;;;;;;;;;;;;;;;;;1,0;;;;;;;;;;;;;;;;;1,0;;;;;;;;;;;;;;7,0;;;;;;;;;;;;;;;;;;1,0;;;2,0;;;;;;;;;;;;;2,0;;1,0;;;;;;;;;;;;4,0;;;;;1,0;;;;3,0;;;;;;;;;;;;;;2,0;8,0;;;;;;;;;;;;;;;;;;;;;;;;;;;;;;;;;;;;;;;;;;;;;;;;;;;;;;;;;;;;;;;;;;;;;;;;2,0;;;;;;;;;;;;;;;;2,0;;;;;;;;;;;;;;;;;;;;;;;;;;;;;;;;;;;;;;;;;;;;;;;;;;;;;;;;;;;;;;;;;;;;4,0;;;;;;;;;;;;;;;;;;;;;;;;;;;;;;;;;;;;;;;;;;;;;;;;;;;;;;;;;;;;;;;;;;;;;;;;;;;;;;;;;;;;;
structure;;47,0;;;1,0;11,0;57,0;59,0;25,0;40,0;26,0;2,0;10,0;1,0;69,0;105,0;27,0;;1,0;;6,0;11,0;;5,0;7,0;;24,0;1,0;4,0;1,0;9,0;2,0;96,0;;8,0;1,0;;;;2,0;76,0;;67,0;12,0;18,0;12,0;51,0;126,0;17,0;22,0;55,0;9,0;1,0;2,0;4,0;37,0;62,0;2,0;18,0;2,0;24,0;18,0;5,0;1,0;23,0;5,0;11,0;162,0;18,0;28,0;8,0;3,0;13,0;;1,0;42,0;5,0;5,0;11,0;181,0;3,0;25,0;3,0;184,0;3,0;2,0;16,0;;7,0;35,0;247,0;;;17,0;23,0;9,0;7,0;;62,0;4,0;1,0;;122,0;44,0;12,0;4,0;73,0;2,0;7,0;9,0;4,0;12,0;2,0;3,0;;90,0;193,0;109,0;12,0;20,0;16,0;;7,0;10,0;20,0;4,0;;;10,0;12,0;;2,0;38,0;2,0;27,0;;3,0;3,0;2,0;;9,0;15,0;2,0;96,0;1,0;7,0;;61,0;10,0;3,0;1,0;13,0;15,0;15,0;1,0;2,0;166,0;;6,0;1,0;2,0;8,0;62,0;;1,0;;11,0;37,0;4,0;21,0;12,0;15,0;13,0;11,0;1,0;3,0;103,0;23,0;2,0;;10,0;39,0;13,0;8,0;1,0;18,0;3,0;69,0;;;;;7,0;57,0;3,0;33,0;6,0;2,0;1,0;62,0;19,0;;2,0;26,0;3,0;7,0;1,0;;;41,0;26,0;5,0;2,0;2,0;7,0;;17,0;10,0;6,0;32,0;172,0;;33,0;14,0;2,0;53,0;18,0;;108,0;2,0;99,0;109,0;76,0;288,0;9,0;14,0;33,0;68,0;14,0;39,0;3,0;1,0;15,0;13,0;;;1,0;4,0;111,0;23,0;10,0;;6,0;4,0;2,0;;109,0;4,0;4,0;1,0;2,0;2,0;33,0;10,0;5,0;;36,0;10,0;17,0;3,0;15,0;24,0;12,0;6,0;;19,0;2,0;;56,0;140,0;1,0;;4,0;4,0;;3,0;;1,0;;5,0;58,0;18,0;3,0;4,0;34,0;;6,0;28,0;23,0;9,0;36,0;11,0;101,0;1,0;1,0;16,0;26,0;17,0;31,0;2,0;;4,0;23,0;12,0;15,0;9,0;4,0;41,0;4,0;139,0;;19,0;8,0;20,0;16,0;1,0;37,0;8,0;;8,0;32,0;107,0;13,0;6,0;3,0;;;14,0;10,0;17,0;17,0;1,0;15,0;5,0;14,0;;30,0;23,0;11,0;6,0;9,0;8,0;;7,0;2,0;14,0;9,0;15,0;2,0;2,0;6,0;17,0;17,0;7,0;35,0;14,0;1,0;16,0;9,0;1,0;;1,0;11,0;;;11,0;14,0;11,0;22,0;9,0;5,0;;6,0;3,0;11,0;25,0;3,0;7,0;;386,0;16,0;49,0;6,0;4,0;9,0;;5,0;3,0;20,0;1,0;27,0;;1,0;37,0;1,0;7,0;;1,0;4,0;50,0;;7,0;;1,0;12,0;;3,0;;1,0;;1,0;1,0;7,0;1,0;;1,0;;14,0;;;;3,0;7,0;25,0;19,0;;5,0;16,0;1,0;;4,0;18,0;10,0;;4,0;1,0;11,0;2,0;3,0;;9,0;2,0;;;;5,0;;1,0;1,0;;4,0;;;;1,0;1,0;;2,0;;7,0;;;1,0;7,0;9,0;2,0;;;;3,0;16,0;34,0;;;17,0;;;;;21,0;5,0;3,0;;4,0;;3,0;4,0;;11,0;1,0;24,0;4,0;1,0;4,0;;;3,0;;6,0;;;5,0;11,0;;;;4,0;;;;5,0;;;7,0;2,0;4,0;;15,0;;;;1,0;1,0;23,0;;16,0;;2,0;;11,0;;2,0;;2,0;;9,0;;;1,0;1,0;;;17,0;3,0;;13,0;;;34,0;9,0;;2,0;4,0;3,0;6,0;;1,0;;;2,0;2,0;1,0;3,0;37,0;16,0;6,0;21,0;;3,0;;1,0;;;;17,0;;;3,0;10,0;;;3,0;;4,0;5,0;9,0;;;7,0;;38,0;;1,0;;;43,0;;4,0;;;8,0;1,0;6,0;7,0;;;;1,0;;1,0;2,0;1,0;1,0;1,0;5,0;;23,0;2,0;13,0;;2,0;1,0;;6,0;;;8,0;2,0;;;;3,0;2,0;;1,0;2,0;1,0;1,0;1,0;1,0;;2,0;1,0;9,0;2,0;49,0;;;9,0;12,0;7,0;;;6,0;;1,0;;4,0;28,0;;1,0;25,0;1,0;;1,0;2,0;;;12,0;;;1,0;76,0;51,0;5,0;9,0;;5,0;3,0;1,0;;;;2,0;;3,0;9,0;;9,0;;43,0;2,0;6,0;;;3,0;1,0;2,0;;14,0;1,0;;;33,0;;3,0;;3,0;;;;3,0;;;1,0;4,0;24,0;1,0;1,0;;;5,0;3,0;6,0;5,0;1,0;;1,0;2,0;;;7,0;;2,0;27,0;19,0;;;1,0;;;;4,0;14,0;1,0;;;2,0;22,0;4,0;;;;;;;;;5,0;;3,0;3,0;;;2,0;;;;;9,0;3,0;;3,0;3,0;;;5,0;;;6,0;1,0;2,0;14,0;;;1,0;1,0;;55,0;;;;1,0;;;;;21,0;;;;;;;2,0;;2,0;2,0;3,0;;;;2,0;1,0;1,0;2,0;;;;;;6,0;;;;9,0;;;;;;;;;;;7,0;;;;;;3,0;4,0;;;;;7,0;;2,0;;1,0;;;;;;;1,0;;;2,0;;4,0;5,0;;;;;;1,0;;;;;3,0;4,0;2,0;;3,0;;;3,0;6,0;;;;4,0;;;1,0;6,0;;17,0;;;10,0;;8,0;;;;6,0;8,0;;;2,0;;;;;7,0;1,0;;3,0;;;;;;;;;1,0;2,0;;7,0;;;;;;;4,0;1,0;;;9,0;7,0;;1,0;;1,0;;;;1,0;;;;16,0;8,0;;;;;;1,0;;;8,0;;;;;;;;1,0;;4,0;;6,0;;3,0;;;1,0;;;;;;2,0;;;1,0;;
support;;3,0;;;;27,0;23,0;215,0;33,0;60,0;2,0;;7,0;1,0;163,0;285,0;47,0;5,0;;;9,0;41,0;4,0;14,0;2,0;;2,0;;1,0;1,0;12,0;;160,0;;40,0;27,0;1,0;22,0;2,0;5,0;4,0;;121,0;30,0;9,0;8,0;8,0;356,0;40,0;49,0;107,0;30,0;;;53,0;22,0;148,0;1,0;;;142,0;28,0;9,0;2,0;45,0;12,0;12,0;120,0;326,0;78,0;17,0;;13,0;;;23,0;3,0;2,0;;184,0;3,0;69,0;1,0;311,0;1,0;5,0;15,0;;11,0;38,0;630,0;;1,0;7,0;;;12,0;;72,0;24,0;21,0;2,0;171,0;27,0;;3,0;126,0;6,0;14,0;;13,0;5,0;3,0;1,0;;139,0;584,0;262,0;10,0;16,0;22,0;;4,0;16,0;9,0;25,0;;;2,0;6,0;;5,0;94,0;7,0;4,0;1,0;49,0;11,0;;1,0;6,0;3,0;2,0;153,0;2,0;;;148,0;15,0;6,0;1,0;6,0;2,0;9,0;4,0;3,0;283,0;;74,0;3,0;;2,0;320,0;1,0;;;14,0;17,0;;;5,0;;20,0;32,0;1,0;4,0;258,0;98,0;2,0;;89,0;175,0;19,0;15,0;;41,0;2,0;131,0;;1,0;;1,0;1,0;262,0;3,0;50,0;1,0;5,0;;45,0;17,0;1,0;9,0;176,0;;55,0;;8,0;;94,0;10,0;12,0;20,0;1,0;4,0;;39,0;4,0;49,0;89,0;258,0;2,0;89,0;9,0;;10,0;29,0;8,0;37,0;4,0;741,0;30,0;60,0;452,0;179,0;80,0;75,0;59,0;54,0;165,0;1,0;41,0;2,0;9,0;;;;;11,0;71,0;355,0;;42,0;;2,0;;170,0;3,0;3,0;;12,0;7,0;47,0;6,0;29,0;6,0;27,0;17,0;21,0;3,0;64,0;10,0;29,0;17,0;;75,0;;386,0;236,0;525,0;8,0;;33,0;6,0;3,0;2,0;;3,0;2,0;33,0;53,0;54,0;11,0;;167,0;4,0;37,0;3,0;16,0;14,0;87,0;25,0;162,0;1,0;20,0;40,0;;100,0;63,0;6,0;;37,0;11,0;19,0;9,0;9,0;4,0;40,0;;133,0;14,0;1,0;7,0;30,0;66,0;5,0;34,0;17,0;1,0;;27,0;39,0;12,0;9,0;23,0;3,0;6,0;83,0;19,0;148,0;13,0;16,0;39,0;17,0;6,0;24,0;67,0;98,0;43,0;2,0;12,0;41,0;9,0;12,0;49,0;118,0;75,0;36,0;32,0;25,0;5,0;14,0;6,0;26,0;53,0;;1,0;21,0;57,0;;5,0;5,0;15,0;;10,0;4,0;91,0;51,0;84,0;54,0;15,0;9,0;4,0;122,0;3,0;;16,0;4,0;14,0;;22,0;5,0;4,0;39,0;25,0;1,0;40,0;15,0;8,0;;;;;58,0;;1,0;;7,0;1,0;;5,0;1,0;;;14,0;;4,0;;1,0;;;2,0;9,0;24,0;;;18,0;5,0;;;;10,0;10,0;23,0;4,0;;2,0;;31,0;;11,0;20,0;139,0;;2,0;24,0;2,0;3,0;11,0;;5,0;2,0;;;;13,0;1,0;;19,0;;5,0;4,0;;10,0;18,0;38,0;;7,0;3,0;20,0;;2,0;4,0;;30,0;13,0;21,0;;;;27,0;38,0;3,0;13,0;;;;;;12,0;7,0;3,0;4,0;3,0;1,0;5,0;13,0;1,0;12,0;;84,0;;12,0;6,0;6,0;;12,0;;2,0;;4,0;7,0;14,0;11,0;;2,0;;2,0;5,0;;;9,0;25,0;19,0;;;3,0;16,0;5,0;1,0;;;14,0;23,0;19,0;3,0;2,0;2,0;;1,0;;54,0;1,0;2,0;1,0;4,0;;2,0;2,0;6,0;;1,0;3,0;;;15,0;;11,0;156,0;8,0;;3,0;1,0;5,0;9,0;27,0;;14,0;8,0;;1,0;;8,0;;5,0;10,0;16,0;;3,0;;;;2,0;1,0;11,0;;;;117,0;;;;;16,0;11,0;3,0;1,0;;11,0;3,0;25,0;1,0;;;;2,0;;12,0;;;8,0;;15,0;1,0;3,0;;;;3,0;;;;;;10,0;;17,0;;14,0;1,0;;41,0;;7,0;1,0;;1,0;20,0;8,0;;;7,0;4,0;;;3,0;7,0;27,0;12,0;10,0;1,0;11,0;5,0;39,0;110,0;27,0;1,0;;30,0;33,0;40,0;;10,0;3,0;3,0;5,0;;15,0;;7,0;;48,0;;;2,0;;;5,0;7,0;55,0;1,0;3,0;54,0;24,0;3,0;33,0;;5,0;8,0;;5,0;;5,0;1,0;;22,0;1,0;;8,0;44,0;1,0;4,0;2,0;;80,0;18,0;;2,0;9,0;12,0;11,0;;;78,0;;4,0;;26,0;16,0;23,0;;15,0;7,0;1,0;;64,0;12,0;;1,0;16,0;;;1,0;;6,0;1,0;6,0;8,0;10,0;3,0;16,0;8,0;8,0;27,0;1,0;2,0;8,0;7,0;1,0;;4,0;;;5,0;9,0;16,0;;22,0;11,0;;;;;4,0;;;;1,0;;;;5,0;;1,0;;2,0;;3,0;1,0;4,0;;;;;;;2,0;;;;;;;10,0;;;;;11,0;2,0;;88,0;;;;;17,0;4,0;;20,0;2,0;;;1,0;2,0;;1,0;;;;3,0;;1,0;1,0;;;21,0;2,0;;;1,0;;;;;;37,0;3,0;;;32,0;;;10,0;12,0;;8,0;;;1,0;;16,0;;1,0;;;3,0;;;;2,0;;;;;;;;;;;;5,0;;1,0;15,0;;2,0;;14,0;31,0;;;;1,0;;3,0;;2,0;;11,0;;2,0;4,0;1,0;1,0;;;4,0;4,0;;;2,0;;;1,0;8,0;27,0;;5,0;;;10,0;3,0;3,0;;5,0;2,0;1,0;6,0;1,0;8,0;35,0;30,0;9,0;1,0;18,0;2,0;;2,0;;;;;4,0;20,0;;16,0;;;;;;;;5,0;;;;12,0;4,0;1,0;;4,0;3,0;67,0;;3,0;;;;;;;;;;;1,0;;;1,0;;8,0;;;;;;;;;;;;;;;;;;;;;;;;;;
surface;;47,0;;;6,0;176,0;92,0;172,0;259,0;223,0;121,0;149,0;62,0;15,0;190,0;416,0;127,0;;1,0;2,0;88,0;296,0;6,0;62,0;26,0;11,0;39,0;5,0;1,0;1,0;16,0;10,0;246,0;;110,0;24,0;6,0;1,0;10,0;241,0;48,0;6,0;451,0;47,0;132,0;12,0;67,0;552,0;75,0;188,0;435,0;268,0;13,0;9,0;88,0;129,0;628,0;3,0;28,0;;406,0;85,0;68,0;12,0;74,0;121,0;69,0;1113,0;142,0;576,0;54,0;4,0;101,0;5,0;6,0;121,0;15,0;39,0;33,0;1888,0;97,0;658,0;2,0;745,0;14,0;5,0;5,0;;95,0;77,0;2395,0;;;141,0;9,0;30,0;6,0;;243,0;24,0;15,0;;478,0;694,0;17,0;4,0;600,0;14,0;82,0;6,0;90,0;28,0;124,0;2,0;5,0;530,0;1065,0;574,0;97,0;49,0;17,0;219,0;22,0;53,0;44,0;12,0;2,0;;25,0;35,0;5,0;65,0;131,0;15,0;55,0;8,0;102,0;13,0;33,0;27,0;103,0;;;590,0;18,0;1,0;12,0;1991,0;64,0;21,0;28,0;29,0;12,0;10,0;35,0;1,0;361,0;6,0;11,0;43,0;9,0;23,0;550,0;17,0;13,0;;31,0;106,0;16,0;36,0;140,0;32,0;93,0;179,0;27,0;20,0;179,0;284,0;20,0;1,0;203,0;352,0;99,0;79,0;35,0;229,0;62,0;147,0;8,0;1,0;5,0;1,0;188,0;358,0;6,0;466,0;;8,0;24,0;318,0;204,0;7,0;17,0;334,0;1,0;18,0;1,0;11,0;37,0;607,0;118,0;187,0;25,0;49,0;46,0;;160,0;33,0;69,0;287,0;497,0;233,0;886,0;11,0;5,0;126,0;384,0;10,0;996,0;15,0;713,0;48,0;57,0;746,0;115,0;79,0;47,0;279,0;507,0;823,0;20,0;77,0;60,0;44,0;1,0;34,0;52,0;15,0;128,0;177,0;447,0;2,0;13,0;23,0;5,0;3,0;525,0;281,0;13,0;86,0;6,0;54,0;112,0;17,0;231,0;1,0;186,0;64,0;56,0;19,0;45,0;76,0;169,0;61,0;2,0;65,0;5,0;140,0;1047,0;;10,0;;61,0;47,0;55,0;49,0;29,0;98,0;18,0;195,0;208,0;82,0;67,0;30,0;318,0;51,0;5,0;116,0;100,0;99,0;59,0;30,0;237,0;24,0;36,0;38,0;18,0;70,0;1008,0;52,0;1,0;170,0;62,0;231,0;104,0;33,0;1,0;46,0;277,0;120,0;28,0;7,0;83,0;94,0;63,0;6,0;119,0;51,0;3,0;21,0;11,0;59,0;97,0;24,0;19,0;6,0;120,0;118,0;30,0;269,0;36,0;130,0;16,0;38,0;27,0;9,0;27,0;18,0;256,0;63,0;29,0;115,0;2,0;72,0;25,0;16,0;11,0;122,0;41,0;5,0;23,0;155,0;16,0;127,0;184,0;28,0;7,0;285,0;228,0;114,0;32,0;8,0;5,0;;6,0;2,0;140,0;20,0;35,0;31,0;42,0;48,0;3,0;65,0;24,0;25,0;123,0;25,0;55,0;525,0;84,0;77,0;7,0;37,0;83,0;38,0;14,0;26,0;48,0;5,0;;3,0;1,0;54,0;8,0;2,0;9,0;2,0;2,0;39,0;27,0;4,0;20,0;14,0;25,0;9,0;2,0;29,0;2,0;;2,0;1,0;80,0;7,0;;;2,0;90,0;3,0;1,0;;107,0;24,0;18,0;142,0;7,0;6,0;25,0;9,0;;14,0;64,0;62,0;;;29,0;39,0;5,0;15,0;3,0;7,0;11,0;8,0;;;38,0;3,0;6,0;2,0;4,0;95,0;37,0;1,0;6,0;;9,0;;1,0;2,0;20,0;3,0;7,0;5,0;1,0;17,0;3,0;3,0;4,0;7,0;57,0;61,0;82,0;1,0;47,0;28,0;;4,0;;17,0;34,0;;13,0;;1,0;2,0;19,0;5,0;3,0;43,0;5,0;21,0;9,0;2,0;35,0;1,0;2,0;73,0;1,0;4,0;;3,0;35,0;1,0;;4,0;4,0;17,0;;2,0;7,0;19,0;;51,0;13,0;14,0;;3,0;13,0;;17,0;;12,0;12,0;73,0;;36,0;17,0;5,0;5,0;53,0;;40,0;3,0;2,0;;35,0;10,0;;3,0;1,0;;13,0;17,0;2,0;;50,0;;11,0;34,0;15,0;25,0;44,0;6,0;9,0;48,0;;20,0;11,0;;4,0;19,0;;52,0;7,0;19,0;7,0;11,0;22,0;;13,0;1,0;131,0;;6,0;21,0;;;3,0;17,0;1,0;8,0;;;119,0;12,0;23,0;;4,0;47,0;1,0;150,0;;10,0;;4,0;20,0;25,0;11,0;;;8,0;1,0;16,0;3,0;4,0;;1,0;7,0;;3,0;10,0;1,0;23,0;3,0;3,0;1,0;332,0;5,0;13,0;4,0;5,0;8,0;;40,0;;;1,0;50,0;;3,0;7,0;;2,0;;;8,0;;20,0;20,0;7,0;18,0;;4,0;24,0;11,0;132,0;3,0;11,0;31,0;79,0;100,0;;4,0;18,0;51,0;47,0;5,0;40,0;8,0;18,0;13,0;13,0;13,0;2,0;3,0;77,0;;2,0;81,0;10,0;8,0;3,0;7,0;2,0;8,0;31,0;;11,0;4,0;12,0;6,0;18,0;5,0;;9,0;28,0;209,0;7,0;72,0;15,0;;3,0;10,0;1,0;17,0;5,0;6,0;;5,0;36,0;6,0;;1,0;705,0;;3,0;2,0;;7,0;17,0;1,0;66,0;64,0;9,0;9,0;52,0;216,0;7,0;17,0;113,0;6,0;5,0;8,0;12,0;87,0;1,0;15,0;136,0;6,0;7,0;24,0;56,0;3,0;23,0;73,0;51,0;;39,0;34,0;;;15,0;11,0;53,0;47,0;19,0;10,0;4,0;41,0;9,0;32,0;;4,0;;2,0;2,0;;5,0;5,0;1,0;8,0;191,0;2,0;21,0;4,0;6,0;;15,0;9,0;11,0;;;24,0;;4,0;;33,0;;1,0;;;1,0;23,0;11,0;1,0;7,0;14,0;;29,0;2,0;;2,0;2,0;2,0;9,0;11,0;1,0;24,0;2,0;3,0;2,0;;20,0;;106,0;;;4,0;2,0;;8,0;;17,0;;;3,0;19,0;;5,0;5,0;45,0;16,0;15,0;;79,0;45,0;29,0;4,0;4,0;;35,0;6,0;10,0;2,0;1,0;1,0;9,0;;1,0;;3,0;;4,0;1,0;;;1,0;1,0;9,0;5,0;6,0;;63,0;;6,0;1,0;3,0;1,0;;2,0;;8,0;4,0;1,0;9,0;7,0;;5,0;4,0;3,0;19,0;37,0;;;5,0;;1,0;7,0;1,0;1,0;2,0;6,0;1,0;38,0;;14,0;;;17,0;11,0;3,0;2,0;16,0;;6,0;2,0;1,0;5,0;;45,0;;;19,0;36,0;12,0;4,0;9,0;15,0;;9,0;1,0;2,0;9,0;20,0;35,0;2,0;4,0;2,0;1,0;10,0;10,0;12,0;2,0;;10,0;;;7,0;;;56,0;6,0;2,0;28,0;2,0;;7,0;6,0;5,0;58,0;;4,0;3,0;19,0;134,0;4,0;11,0;1,0;13,0;;;;50,0;3,0;7,0;;2,0;;3,0;7,0;;1,0;;7,0;3,0;;;31,0;18,0;7,0;1,0;1,0;;;1,0;3,0;70,0;;;;;;4,0;22,0;;7,0;3,0;7,0;;18,0
surround;;1,0;;;;1,0;23,0;7,0;201,0;4,0;1,0;;3,0;;46,0;28,0;1,0;3,0;17,0;;2,0;12,0;;3,0;;;7,0;;;1,0;1,0;;7,0;;9,0;;1,0;;;;16,0;;12,0;;16,0;;15,0;40,0;6,0;24,0;35,0;;;;2,0;12,0;45,0;;2,0;;8,0;2,0;1,0;;;;5,0;41,0;31,0;13,0;;;15,0;1,0;2,0;;;4,0;1,0;131,0;24,0;27,0;;35,0;;1,0;;1,0;3,0;1,0;118,0;;;22,0;;;5,0;;22,0;21,0;13,0;;29,0;24,0;1,0;;63,0;3,0;4,0;;3,0;;16,0;3,0;;31,0;185,0;23,0;1,0;6,0;1,0;;3,0;;8,0;2,0;;;;;;3,0;13,0;2,0;5,0;;;;;;20,0;;;56,0;2,0;1,0;1,0;25,0;2,0;7,0;;;1,0;3,0;4,0;;44,0;;;4,0;;;26,0;;;;8,0;42,0;;;;;5,0;5,0;;8,0;11,0;23,0;4,0;;5,0;24,0;3,0;15,0;4,0;8,0;2,0;3,0;;;1,0;3,0;6,0;14,0;;5,0;;4,0;;31,0;;;1,0;4,0;;12,0;;1,0;3,0;17,0;1,0;3,0;;2,0;;;10,0;5,0;2,0;32,0;29,0;;28,0;;;13,0;14,0;;54,0;;55,0;3,0;;30,0;5,0;3,0;;22,0;3,0;25,0;5,0;5,0;10,0;;;;7,0;1,0;62,0;;25,0;1,0;2,0;;;;16,0;;1,0;;;;3,0;6,0;21,0;;12,0;13,0;4,0;2,0;;7,0;8,0;15,0;;5,0;;16,0;31,0;84,0;;;13,0;1,0;;;;2,0;;23,0;20,0;3,0;1,0;1,0;9,0;;;;7,0;1,0;3,0;;5,0;;4,0;3,0;;;4,0;;;;8,0;9,0;2,0;1,0;;4,0;2,0;9,0;;;9,0;;11,0;;4,0;;;;2,0;5,0;6,0;;;;3,0;94,0;5,0;11,0;2,0;;2,0;;2,0;1,0;6,0;;;2,0;5,0;;;1,0;;3,0;2,0;5,0;;1,0;;;4,0;1,0;16,0;;;;13,0;;1,0;;5,0;;;1,0;22,0;;2,0;;15,0;;4,0;;;1,0;29,0;12,0;;22,0;;3,0;;;2,0;;1,0;4,0;11,0;11,0;;;;;;;;;;1,0;;;10,0;;;;;1,0;;;1,0;;2,0;;;;1,0;23,0;;;;;;3,0;30,0;;3,0;;;;2,0;2,0;6,0;;;;3,0;;7,0;1,0;;;;2,0;;8,0;3,0;;;;;14,0;;;;;;;5,0;6,0;;;;;;;;;;;9,0;3,0;;6,0;3,0;;;;2,0;;;51,0;;;;;;;1,0;;2,0;;;4,0;3,0;;5,0;;;;;8,0;2,0;;;;2,0;;3,0;;1,0;4,0;1,0;2,0;;;1,0;1,0;;;;2,0;2,0;5,0;;;1,0;;;;;11,0;;;;;;;;;;1,0;;12,0;;7,0;;;5,0;1,0;;;2,0;;6,0;;5,0;2,0;;;;;2,0;;;;5,0;2,0;;;;;;;7,0;6,0;;;;;;;;;2,0;;;1,0;4,0;;11,0;;;;;;;11,0;;;;1,0;1,0;;;;1,0;;;;;;;;;;111,0;;;1,0;;6,0;;1,0;4,0;;;1,0;;;5,0;;2,0;;2,0;;;3,0;2,0;;;;;;;8,0;;;6,0;;2,0;;;;7,0;3,0;;3,0;;4,0;;2,0;;;;4,0;;1,0;1,0;;;;;;;;;1,0;1,0;;1,0;2,0;;;;;;4,0;2,0;;;;;;1,0;;1,0;1,0;;;;;;3,0;;;1,0;;1,0;;;2,0;7,0;;;12,0;13,0;1,0;;8,0;8,0;;;;6,0;;;;;;;1,0;6,0;1,0;;3,0;1,0;;1,0;;2,0;1,0;;2,0;2,0;1,0;;4,0;4,0;;;;1,0;;;;;;;3,0;2,0;15,0;;7,0;2,0;;;;;;;;4,0;;;;;;;2,0;;;1,0;;;;;;;;;;;;;;;;;3,0;;;;;;;;;;;1,0;;;;;;;;;;;6,0;2,0;;;;1,0;;2,0;;;;;1,0;;;;;;;;;;;;;;;8,0;;;;5,0;;;3,0;;;;;;;;6,0;;;;;;;;4,0;6,0;;4,0;;;;;;;;;;;5,0;;;4,0;;3,0;;;1,0;;;5,0;;;5,0;;;2,0;1,0;2,0;;;;;;;;7,0;2,0;3,0;;;;;;;;;;;;;;2,0;;;;;;;;;;;;;;;4,0;;;2,0;;;;;;15,0;;;;;;;1,0;1,0;;;1,0;;;;10,0;;;7,0;;1,0;1,0;;;;;;;;;;;;;;;1,0;
switch;;15,0;;13,0;;9,0;18,0;46,0;4,0;9,0;5,0;;4,0;1,0;1,0;23,0;3,0;3,0;9,0;1,0;12,0;54,0;12,0;3,0;1,0;;48,0;;;;10,0;4,0;157,0;3,0;326,0;43,0;1,0;11,0;1,0;;72,0;;6,0;;35,0;14,0;36,0;243,0;34,0;186,0;21,0;9,0;;;8,0;5,0;84,0;1,0;4,0;8,0;1,0;14,0;20,0;2,0;77,0;;26,0;12,0;16,0;9,0;21,0;10,0;37,0;;;32,0;2,0;2,0;5,0;186,0;;41,0;1,0;100,0;1,0;22,0;4,0;;;2,0;79,0;;4,0;;;27,0;10,0;;80,0;7,0;;;91,0;8,0;;26,0;62,0;5,0;164,0;4,0;6,0;65,0;1,0;5,0;5,0;120,0;22,0;34,0;107,0;20,0;8,0;1,0;13,0;32,0;30,0;1,0;;;4,0;12,0;;110,0;;1,0;10,0;;26,0;21,0;26,0;;10,0;7,0;22,0;78,0;15,0;;1,0;40,0;345,0;2,0;4,0;5,0;10,0;7,0;2,0;53,0;141,0;;;30,0;1,0;36,0;325,0;;1,0;;61,0;22,0;6,0;;2,0;1,0;;6,0;4,0;8,0;11,0;4,0;;;5,0;48,0;;;23,0;132,0;;20,0;;2,0;1,0;;;227,0;5,0;5,0;2,0;;1,0;;;1,0;2,0;13,0;;;11,0;1,0;10,0;7,0;;;5,0;126,0;10,0;;1,0;;;2,0;15,0;;;;;;;1,0;76,0;;40,0;;9,0;9,0;2,0;6,0;6,0;36,0;1,0;;;10,0;4,0;16,0;28,0;;;6,0;74,0;1,0;2,0;22,0;;10,0;2,0;15,0;42,0;3,0;;;;;4,0;48,0;;1,0;;;17,0;;1,0;65,0;;;;1,0;6,0;1,0;;10,0;;9,0;53,0;;;44,0;;3,0;;15,0;5,0;5,0;;;3,0;3,0;6,0;;;1,0;3,0;12,0;18,0;;;;6,0;15,0;9,0;;3,0;5,0;2,0;;28,0;;2,0;12,0;;39,0;;;1,0;;16,0;2,0;3,0;1,0;1,0;;1,0;;;;2,0;21,0;1,0;2,0;13,0;1,0;;1,0;;6,0;;5,0;6,0;3,0;3,0;3,0;1,0;;;4,0;;;;24,0;5,0;;4,0;;;;4,0;;2,0;3,0;1,0;;;12,0;;5,0;1,0;;;;2,0;8,0;4,0;;4,0;5,0;2,0;;;;;8,0;;5,0;;2,0;;13,0;1,0;1,0;;;;;;7,0;;;1,0;;8,0;7,0;20,0;16,0;;6,0;2,0;10,0;;3,0;3,0;;;;11,0;7,0;1,0;;1,0;3,0;;1,0;5,0;92,0;69,0;2,0;8,0;1,0;;1,0;458,0;1,0;11,0;6,0;11,0;;13,0;55,0;236,0;;13,0;20,0;;;;2,0;2,0;28,0;4,0;;;;9,0;6,0;8,0;;;;54,0;7,0;47,0;3,0;;;50,0;;38,0;1,0;;;98,0;;9,0;;;8,0;4,0;11,0;1,0;2,0;1,0;1,0;2,0;;4,0;13,0;1,0;;;2,0;16,0;;68,0;7,0;;33,0;32,0;;;11,0;23,0;;;12,0;;4,0;4,0;4,0;;7,0;5,0;4,0;1,0;16,0;20,0;27,0;4,0;;7,0;14,0;;3,0;;15,0;2,0;47,0;;;26,0;26,0;10,0;2,0;6,0;2,0;1,0;6,0;10,0;11,0;;3,0;1,0;27,0;;;4,0;2,0;5,0;1,0;;3,0;;14,0;;2,0;4,0;7,0;;33,0;5,0;17,0;3,0;;9,0;;15,0;2,0;6,0;14,0;1,0;3,0;;;;1,0;;;16,0;6,0;;;1,0;2,0;6,0;3,0;9,0;2,0;1,0;1,0;5,0;1,0;1,0;13,0;10,0;;2,0;;2,0;8,0;4,0;;3,0;;7,0;;1,0;1,0;9,0;;;;15,0;;2,0;;;;;;22,0;4,0;;7,0;20,0;;;3,0;;;14,0;6,0;;1,0;6,0;;2,0;1,0;;1,0;7,0;5,0;;2,0;;8,0;;;;2,0;7,0;;;;1,0;16,0;;1,0;4,0;;1,0;7,0;;9,0;11,0;;3,0;;;;;;;;;1,0;10,0;;;4,0;9,0;22,0;22,0;1,0;;1,0;;;;;;43,0;2,0;;;;;;;2,0;4,0;20,0;;;;;;15,0;;;;;;;17,0;;;;1,0;2,0;10,0;19,0;;;;;;3,0;2,0;;;2,0;1,0;15,0;1,0;;;4,0;;;1,0;;;;4,0;;;;;4,0;;2,0;9,0;6,0;1,0;11,0;1,0;8,0;;2,0;;22,0;;;2,0;4,0;5,0;;3,0;;6,0;;;8,0;61,0;1,0;2,0;;;;1,0;;5,0;2,0;;;188,0;97,0;;9,0;;;;3,0;;10,0;9,0;10,0;;;;;;;;4,0;;;;2,0;;;;;5,0;;;;2,0;8,0;;1,0;2,0;;2,0;25,0;;4,0;;;;4,0;;10,0;;2,0;5,0;1,0;11,0;;12,0;3,0;;26,0;;;;;;;1,0;;;;8,0;2,0;;;;;2,0;5,0;;;;1,0;;;;;;3,0;;1,0;;13,0;;;2,0;36,0;;1,0;9,0;;;;10,0;;4,0;;;;;3,0;1,0;;3,0;4,0;;;;;;;;;;;14,0;;1,0;;;2,0;4,0;;;5,0;;9,0;;23,0;;;;;;;;;;;;;;2,0;;;;;;;6,0;;;;1,0;;1,0;;1,0;;;;51,0;;;34,0;;;;;;;;2,0;;;;;;;2,0;;;;;8,0;;;2,0;37,0;;;;;;;;;8,0;;;
symbol;;2,0;;;;;;1,0;1,0;;;;2,0;;;7,0;;;;;1,0;2,0;;;;;;;;;3,0;;2,0;;6,0;;;;;;14,0;;1,0;;;6,0;27,0;14,0;1,0;21,0;;;;;;;1,0;;;;;;;1,0;;;;6,0;1,0;;2,0;;1,0;;2,0;1,0;;;;18,0;;1,0;;10,0;;1,0;;;;;4,0;;;1,0;;;1,0;;13,0;2,0;;;2,0;2,0;;;;5,0;;;;1,0;;;;3,0;55,0;4,0;;3,0;;;2,0;8,0;;1,0;;;;;;;;;4,0;;4,0;5,0;1,0;;5,0;;;;;;;;;;;;1,0;1,0;4,0;;10,0;;;;2,0;1,0;2,0;;;;;;;;;;;;;1,0;8,0;;;;;;;;;;;;;;;;;;;;;;;2,0;;;;;;;;;5,0;;;;;;;;;;;;;;1,0;;;;;;1,0;;;;;;;;;1,0;;;;;;;;;;1,0;3,0;;;;;;;;;;;;;;;5,0;;;;;2,0;;;1,0;;;;;;;;1,0;;;;;;;3,0;;;;;;;;2,0;;;;;;;;;;;;;;2,0;;;;;;;;;;;;;;;;;;1,0;;;;;;;;;;;;;;;;1,0;10,0;;;;;;9,0;;;;;;;;3,0;;;;1,0;;;;;;;1,0;;;3,0;;;;;;;;;;;3,0;;;;;;;;;;;;;;;;;;;;;;;;;;;;;15,0;3,0;;;;;;;2,0;2,0;;;;2,0;;;;;1,0;;11,0;;;;;1,0;;;2,0;;;;;;;3,0;;2,0;;;;;;;2,0;;;;;;;;;;;;;3,0;;;;1,0;;2,0;;;;;;;;;;;;;;;;;;;;;;;;;;;;;3,0;;;1,0;;;;;1,0;;;;;;;;;1,0;;;;;;12,0;;5,0;;;;;;;;1,0;;;;;;;;3,0;;;;;;;;1,0;2,0;;;;;;2,0;;;;;;2,0;;;;;7,0;;;;1,0;;;;;;;;2,0;;;;;;;;;;;;;;;;;;;;;6,0;;;;;;;;;;;;;;1,0;;1,0;;;;1,0;5,0;;;;;;;;;2,0;;;;;;;;;;;8,0;;;;;;;;;;;;;;;;;;;;;2,0;;;;;;;;;;;;;;;;2,0;;;;;;4,0;;;;;;;;;;;;;;;;;;;;;;;;;;;;;;;;;;;;;;;;;;;;3,0;;;;;;;;;;;;;;;;;;;;;;;;;;;;;;;;;;;;;;;;;;1,0;;;;;;;;;;;;21,0;;3,0;;94,0;;7,0;;;;;;;;;;;;;;;;;;1,0;;;;;;;;;;;;;;;;;;;;;;;;;;;;;;;;;;;;;;;;;;;1,0;;;;;;;;;;;;;;;;;;;;;;;;;;;;;;;;2,0;;;;;;;;;;;;;;;;;;;;;;;;;;;;;;;;;;;;;;;;;;;;;;;;;;;;;;;;;;;;;;;;;;;;;;;;2,0;;;;;;;;;;;;;;;;;;;;;;;;;;;5,0;;;;;;;;;;;;;;;;2,0
synchronization;;4,0;;1,0;;;;10,0;;;;;24,0;;;34,0;;;;;4,0;11,0;;7,0;;;;3,0;;;;1,0;29,0;;31,0;9,0;1,0;1,0;2,0;;149,0;;;;13,0;26,0;2,0;65,0;11,0;;;;;;6,0;;5,0;;;;;26,0;;5,0;;;5,0;1,0;26,0;;6,0;;27,0;17,0;;11,0;3,0;1,0;;61,0;;3,0;;52,0;;4,0;31,0;;;;37,0;;1,0;;1,0;1,0;2,0;;25,0;1,0;;;20,0;;;2,0;8,0;1,0;105,0;;;26,0;;3,0;2,0;18,0;;7,0;;1,0;;;2,0;39,0;2,0;2,0;;;1,0;6,0;;22,0;2,0;;;2,0;1,0;19,0;;;1,0;;1,0;6,0;6,0;;;2,0;409,0;;;;1,0;2,0;;;30,0;;;;;31,0;87,0;;1,0;;54,0;;1,0;8,0;;2,0;;;4,0;6,0;1,0;;;;;47,0;;;3,0;74,0;;1,0;;;1,0;;;7,0;;54,0;10,0;;;;;;5,0;;;;;;;;;;;;;1,0;;;;;;;;;;;;2,0;25,0;;;;9,0;;;;;6,0;;;;;;;67,0;;;;1,0;;;;;;;18,0;39,0;1,0;;;;;;1,0;;;;;2,0;;;3,0;;;;;12,0;;;;9,0;;3,0;;;96,0;;1,0;;;;56,0;;;;;;;;;;;;;;;;;;;;;;;;;;31,0;;;;;;;10,0;;;;;;;;;;;4,0;;;;;;;6,0;3,0;;;4,0;;2,0;;;;32,0;9,0;;;;34,0;;;;4,0;;;;;;;;;;2,0;;;;;;;;2,0;;;;;;7,0;;;;;;1,0;;;;22,0;;;;;;;4,0;1,0;;;;;13,0;;8,0;6,0;11,0;;;1,0;;;;;;;;;;;1,0;;;;;57,0;2,0;;;;10,0;;9,0;;;;;;;;63,0;;;11,0;;;;;6,0;13,0;10,0;;;;;;2,0;3,0;3,0;;;;;;;;2,0;;14,0;;;;8,0;;8,0;;1,0;;1,0;3,0;;;;2,0;;;;1,0;;;;;7,0;;;;;;;;1,0;;8,0;;;7,0;;;;2,0;;2,0;;;;;10,0;5,0;;;22,0;;;2,0;;;;5,0;;;3,0;1,0;12,0;5,0;;;;;;;;;;3,0;1,0;;;;;;;;;;;1,0;;;;8,0;8,0;34,0;;;6,0;;5,0;;;;;;;;;;;3,0;18,0;;;;;4,0;;;;;;;3,0;;;;;;1,0;;;2,0;7,0;;14,0;;;;;;3,0;;;;;;;;;;;;;3,0;;;;;;;;;;;;;;;;31,0;;;;;;;;3,0;;;;;1,0;;;;;93,0;1,0;;3,0;;;;;;;;6,0;;;;;;;;;;;;;16,0;;10,0;1,0;;;;;;;;;;;;;;1,0;;;;;;;;;;;;;;;;;;;;;;1,0;;;3,0;;;;2,0;;1,0;3,0;;;;;;;;;;;;1,0;;;;;;;;;;;;;;3,0;;;;;;;1,0;;;;;;;;;;;;;3,0;;;;;;;;;3,0;;;;;;;;;5,0;;3,0;;;;;;;;;2,0;;4,0;;;;;;;;;;;;;9,0;;;3,0;;;;;;;;17,0;;;;;;;;;;;;2,0;;;;;4,0;;;;1,0;;;;;;;;;;;;;;;;;;;;;;6,0;;;;;2,0;3,0;;1,0;;;;;;;;;;;;;;;;1,0;;;;;;;;;;;;;;;;;;;;;;;;;4,0;;;;;;;5,0;;;;;;;;;;;;;;8,0;;;;;;;;;;;;3,0;;;;1,0;;;;;;;;;;;;;;;;;;;;;;;;;;;;;;;;;;2,0;
terminal;;77,0;;;1,0;6,0;3,0;31,0;206,0;16,0;51,0;;8,0;;3,0;42,0;;;;;1,0;26,0;5,0;5,0;;;1,0;;1,0;;;1,0;69,0;;233,0;35,0;2,0;3,0;15,0;;145,0;;3,0;;36,0;24,0;19,0;145,0;10,0;59,0;114,0;11,0;;2,0;22,0;4,0;29,0;1,0;;;42,0;52,0;10,0;1,0;12,0;3,0;4,0;96,0;5,0;6,0;40,0;;24,0;3,0;;6,0;12,0;;1,0;113,0;2,0;37,0;;250,0;1,0;9,0;27,0;;2,0;9,0;135,0;;;5,0;5,0;11,0;11,0;;64,0;220,0;4,0;;105,0;99,0;1,0;23,0;24,0;11,0;265,0;;3,0;21,0;2,0;5,0;1,0;155,0;262,0;24,0;149,0;24,0;;;1,0;18,0;3,0;1,0;5,0;;4,0;2,0;5,0;102,0;15,0;1,0;2,0;8,0;17,0;5,0;10,0;;;;;29,0;6,0;;;82,0;371,0;3,0;1,0;;10,0;13,0;1,0;117,0;44,0;;1,0;7,0;2,0;6,0;157,0;;;;19,0;4,0;;;10,0;3,0;1,0;37,0;;13,0;1,0;26,0;2,0;;35,0;114,0;6,0;;6,0;82,0;4,0;3,0;;;1,0;;3,0;442,0;;207,0;5,0;;;13,0;;1,0;6,0;39,0;;3,0;12,0;;1,0;5,0;2,0;1,0;1,0;5,0;;;3,0;3,0;;20,0;18,0;1,0;;2,0;;5,0;1,0;;13,0;;33,0;12,0;1,0;124,0;18,0;11,0;4,0;14,0;15,0;8,0;3,0;;4,0;;;;1,0;;13,0;4,0;10,0;;;8,0;;4,0;27,0;;;;4,0;2,0;2,0;9,0;7,0;;11,0;7,0;2,0;;;33,0;4,0;1,0;;22,0;9,0;4,0;26,0;61,0;53,0;3,0;;;4,0;42,0;;2,0;;;4,0;3,0;;;5,0;;;;43,0;8,0;51,0;5,0;30,0;;3,0;;2,0;33,0;5,0;;;16,0;2,0;2,0;;1,0;;625,0;;25,0;;;3,0;;10,0;;12,0;2,0;;4,0;30,0;;8,0;;2,0;15,0;137,0;4,0;56,0;32,0;;;13,0;6,0;;1,0;;3,0;9,0;20,0;;1,0;;4,0;;;;77,0;149,0;;;14,0;;23,0;;;4,0;13,0;2,0;;20,0;1,0;;;;;4,0;;;4,0;4,0;;1,0;9,0;;5,0;;;5,0;33,0;13,0;8,0;;4,0;1,0;15,0;2,0;13,0;;;1,0;;;3,0;;1,0;;;;8,0;13,0;;5,0;1,0;3,0;;1,0;1,0;;;;;4,0;2,0;;;;5,0;;;;293,0;24,0;2,0;12,0;;25,0;4,0;51,0;4,0;37,0;17,0;10,0;1,0;12,0;32,0;31,0;;1,0;;;;;2,0;2,0;6,0;6,0;;;2,0;;;;;;2,0;;;4,0;3,0;1,0;1,0;4,0;;10,0;;;;166,0;3,0;15,0;4,0;;90,0;2,0;;;;;;;;1,0;1,0;;2,0;12,0;2,0;5,0;;4,0;;20,0;6,0;6,0;3,0;1,0;;3,0;;;10,0;;1,0;;;;;;;5,0;8,0;109,0;8,0;;;6,0;2,0;;;3,0;3,0;2,0;101,0;;;2,0;;1,0;;;13,0;;3,0;4,0;2,0;;10,0;8,0;2,0;;;;7,0;3,0;3,0;;;15,0;2,0;;;;;1,0;6,0;6,0;62,0;2,0;;;;;;;15,0;;;;;;2,0;;12,0;35,0;6,0;;;;1,0;10,0;1,0;;;3,0;;;1,0;;;20,0;;;;14,0;4,0;;1,0;;;;;1,0;1,0;13,0;;3,0;2,0;;;;;1,0;;;;3,0;1,0;;;14,0;;;5,0;3,0;;2,0;;1,0;;;;37,0;;;7,0;;;;;;30,0;4,0;;5,0;3,0;2,0;1,0;3,0;;3,0;55,0;;4,0;3,0;;;;;;11,0;;17,0;;8,0;;;1,0;8,0;1,0;;11,0;2,0;;;3,0;;45,0;;;;;;;;;;92,0;6,0;;;;;;;;3,0;2,0;;6,0;4,0;;;4,0;;;;;;;22,0;10,0;;;;50,0;24,0;6,0;2,0;;;;2,0;3,0;;2,0;;18,0;;3,0;2,0;5,0;;;;9,0;;;1,0;;;;;;20,0;10,0;;2,0;15,0;;;35,0;10,0;;1,0;;1,0;;;;4,0;61,0;;6,0;4,0;2,0;;;;;60,0;;;1,0;;;;;6,0;3,0;;;73,0;4,0;;1,0;;;7,0;3,0;3,0;2,0;1,0;1,0;;;;;;;4,0;2,0;;;;;1,0;;1,0;;;;6,0;;;23,0;;;2,0;;;;1,0;;1,0;;;;;2,0;;;;;;2,0;;;;;;3,0;6,0;;6,0;;;;;;;;;;;;1,0;;;;;;1,0;;;;;;;;1,0;;;1,0;12,0;;;;;;;;3,0;1,0;8,0;;;;;1,0;1,0;;3,0;;;;1,0;1,0;;;11,0;;;2,0;;;;;11,0;;;;;1,0;5,0;11,0;;12,0;;;;;;;;;;;;;;;;;;;;;3,0;1,0;;;;;;;;;;;;;;;;;;;;;1,0;;;;;;;;;1,0;;;;14,0;;;;;;;;;;1,0;;;;;;
thereon;;1,0;;;2,0;5,0;2,0;3,0;2,0;18,0;5,0;;3,0;;2,0;17,0;13,0;;;;24,0;9,0;;;;;2,0;;;;46,0;2,0;8,0;;18,0;1,0;;1,0;;;10,0;;12,0;1,0;3,0;;2,0;43,0;11,0;9,0;27,0;1,0;;;3,0;1,0;22,0;;3,0;19,0;11,0;10,0;;2,0;2,0;3,0;2,0;55,0;6,0;5,0;1,0;;4,0;;;;2,0;2,0;1,0;60,0;;10,0;1,0;26,0;;93,0;;;;;45,0;;1,0;6,0;;78,0;9,0;;12,0;9,0;;;19,0;5,0;;1,0;8,0;1,0;4,0;1,0;;10,0;6,0;;1,0;40,0;20,0;19,0;5,0;4,0;;4,0;;9,0;28,0;53,0;;;2,0;;;;4,0;;1,0;;3,0;4,0;3,0;;3,0;1,0;;34,0;;3,0;;4,0;8,0;;;;15,0;95,0;3,0;1,0;16,0;;;;2,0;5,0;22,0;;;;7,0;3,0;;9,0;2,0;;;1,0;;2,0;19,0;13,0;;;4,0;3,0;4,0;;1,0;20,0;;3,0;;;;;;9,0;;;;;;5,0;;;;4,0;;3,0;;;;2,0;1,0;;;1,0;;;3,0;;;11,0;24,0;36,0;3,0;;;1,0;3,0;;58,0;1,0;13,0;2,0;;84,0;7,0;;2,0;11,0;3,0;5,0;;2,0;;;;;2,0;;13,0;2,0;9,0;;8,0;;;;8,0;;4,0;1,0;;;1,0;;5,0;;;;3,0;;1,0;1,0;4,0;6,0;;1,0;;4,0;27,0;37,0;2,0;;4,0;;;;;;;4,0;2,0;;1,0;;6,0;;3,0;;6,0;4,0;;3,0;5,0;1,0;;;;10,0;5,0;;;;8,0;;1,0;;;5,0;;11,0;;;;;1,0;3,0;5,0;;;;;;1,0;;;;2,0;15,0;1,0;17,0;3,0;;5,0;1,0;;1,0;;1,0;;11,0;;2,0;;5,0;;3,0;7,0;;1,0;1,0;;10,0;3,0;;11,0;;;3,0;7,0;;;;;;3,0;;2,0;;3,0;;3,0;11,0;;4,0;;2,0;1,0;2,0;2,0;39,0;;3,0;1,0;;16,0;;2,0;1,0;;1,0;;;1,0;2,0;;;;;;1,0;;17,0;;;10,0;;;1,0;;;;2,0;;;;;;1,0;;;;2,0;;;3,0;;;;;;;;;;;2,0;3,0;4,0;3,0;;;;;;;42,0;;;;;2,0;;;;3,0;;;;;2,0;;;;;3,0;;;;2,0;;2,0;2,0;;1,0;;;1,0;;;1,0;;;;49,0;;;6,0;;;3,0;;;;4,0;;;;;1,0;1,0;;1,0;;;;;1,0;13,0;;;;;;;;;;;;;;;3,0;;2,0;;2,0;3,0;;;;8,0;;;;1,0;1,0;2,0;1,0;1,0;;1,0;;;;1,0;;1,0;;3,0;1,0;3,0;;;2,0;;;1,0;;;4,0;;5,0;;1,0;1,0;4,0;;1,0;;;1,0;;;7,0;;;;;;;1,0;;1,0;11,0;;;;;;;;2,0;;;3,0;;;;;;;;;;;;2,0;;14,0;;;;;;2,0;1,0;;4,0;;;;;;;;;;2,0;;;;;;4,0;;;1,0;;;;2,0;;2,0;1,0;1,0;;;4,0;;;;;;8,0;2,0;;;;;;;;;;1,0;;;;;;2,0;;;;1,0;3,0;;10,0;;;1,0;;;;1,0;1,0;;7,0;;;;;1,0;1,0;;1,0;;6,0;3,0;;;;;;;;;;;;2,0;1,0;;;;6,0;1,0;;1,0;;1,0;;1,0;;;9,0;;;;;;;;;6,0;1,0;;;;;;;;;;;;;;;;;2,0;;;;;;;;3,0;;;;;;;;;;;;;;;;;;2,0;;;2,0;;;;;;;;;;3,0;;;;;;;3,0;;;;;;;;;;;1,0;;;;;;;9,0;;;;;;;;;;;;;1,0;;;;;;;;;2,0;;;4,0;;;;;;;;;;;;;;;;;;;;;;;1,0;;;;;;;;;1,0;;;;;;;;;;;;;;;;;;;;;;4,0;2,0;;;;;;;;;;;;3,0;1,0;;1,0;1,0;;;3,0;;;;;;;1,0;;;;;;;;;;3,0;1,0;;;;;;;;;;;2,0;;;;;;;;;;;;;;;;;;;;;;;;;;2,0;;;;;2,0;;;;;;;;;;;;;
thread;;5,0;;;;1,0;59,0;3,0;4,0;6,0;;;;;4,0;38,0;;;;;2,0;2,0;;2,0;;;;6,0;;1,0;;;36,0;;;;;;1,0;;;;27,0;1,0;;;;27,0;4,0;;19,0;5,0;;;7,0;11,0;3,0;;;;58,0;81,0;2,0;;1,0;3,0;5,0;68,0;5,0;34,0;;;;;6,0;;;;1,0;11,0;;;;85,0;;;;;4,0;5,0;133,0;;;;;;;;3,0;;;;44,0;8,0;4,0;;3,0;7,0;;;13,0;1,0;25,0;;1,0;37,0;148,0;17,0;;2,0;;;5,0;;1,0;;;;;;;1,0;4,0;1,0;;;4,0;;;;;;;6,0;;;;43,0;;9,0;;3,0;1,0;;;;15,0;1,0;3,0;;;;42,0;;;;6,0;;;;;;1,0;3,0;;;47,0;46,0;;;;70,0;;2,0;;;2,0;10,0;;1,0;3,0;6,0;1,0;38,0;;5,0;;;;29,0;31,0;;;6,0;;1,0;;2,0;;7,0;;4,0;;;;;12,0;;1,0;83,0;42,0;;59,0;;;4,0;;;1,0;;87,0;;4,0;79,0;17,0;4,0;1,0;53,0;11,0;68,0;;10,0;;;;;;;;;53,0;;9,0;;;;53,0;;;;3,0;;5,0;1,0;;;5,0;1,0;;1,0;2,0;;6,0;2,0;;8,0;;9,0;;83,0;;;1,0;3,0;;2,0;;;;;1,0;2,0;;;22,0;;2,0;;;3,0;14,0;7,0;21,0;2,0;19,0;1,0;;;6,0;;;4,0;;1,0;1,0;;;30,0;;35,0;4,0;;32,0;2,0;8,0;;104,0;19,0;;;7,0;9,0;2,0;;;;;4,0;;24,0;4,0;2,0;3,0;;1,0;;20,0;1,0;1,0;;1,0;4,0;;;;10,0;4,0;10,0;;3,0;;1,0;;2,0;15,0;;;35,0;1,0;;3,0;;5,0;;;;46,0;4,0;19,0;5,0;152,0;;;54,0;;1,0;;32,0;;25,0;2,0;;;16,0;;;5,0;;;;;;;5,0;;;;1,0;;;;;;;;;1,0;;;;;;;;;;2,0;4,0;;;;;1,0;3,0;;;1,0;;;;;;7,0;;;2,0;15,0;;;1,0;;13,0;;;;;;;;;;;;;;1,0;;3,0;;2,0;;;1,0;;;;;;;;4,0;;;7,0;;;;;;;;3,0;;;;3,0;1,0;;2,0;;12,0;;;;;;;;;;;;;;;;4,0;;5,0;;;;20,0;7,0;;;;4,0;;;;;;18,0;;30,0;;2,0;;;;1,0;;;;;;;;;;26,0;;;;2,0;;1,0;3,0;;;14,0;2,0;;;;;;;;;;;;;4,0;2,0;;;;;7,0;;;;;;;2,0;;;;;8,0;1,0;1,0;;;;;3,0;;;;;;9,0;28,0;;;;7,0;18,0;4,0;;;4,0;;;;;;1,0;;;7,0;;;2,0;;;;;5,0;;;;8,0;;;;;;;;;;7,0;;1,0;;;3,0;2,0;4,0;13,0;;;;;6,0;;;8,0;;;;;1,0;;;6,0;;;;;;8,0;3,0;1,0;;;19,0;;;;;;2,0;;2,0;;;;;3,0;2,0;;;2,0;;;24,0;;3,0;1,0;;;1,0;23,0;5,0;;;7,0;;;;;;13,0;;1,0;1,0;;;1,0;;2,0;;;;;3,0;;;;;1,0;;2,0;;;;2,0;27,0;2,0;;;;;;;;6,0;;;;21,0;1,0;;;;;;;;;;;;;;;;;;;;;1,0;;;;;;;;;;2,0;;;;;;;;;;2,0;;4,0;;;;;;;;;;;;;;;;;;;1,0;;2,0;;;;;6,0;;;;;;;;;3,0;1,0;;;;2,0;2,0;;;;;;;4,0;;;;;;;;;;;;;;;;;;;;;2,0;;11,0;;;5,0;;10,0;;;;;;;;;;;;;;;;;;;;;;;;;1,0;;;;;5,0;;3,0;;;;3,0;;;1,0;;;;;;;;;;;;;;;;;;2,0;;;2,0;;;;;;;;;;;;2,0;;;;;;5,0;;;;;;;10,0;;;;;;;;;;;;;;;5,0;4,0;;;;;;;;;;;;;;;;;;;;;
time;;8,0;32,0;14,0;13,0;27,0;101,0;194,0;101,0;22,0;71,0;;102,0;2,0;129,0;353,0;27,0;65,0;57,0;5,0;26,0;386,0;52,0;11,0;5,0;20,0;85,0;14,0;;14,0;24,0;138,0;283,0;12,0;395,0;96,0;25,0;43,0;20,0;;416,0;13,0;37,0;50,0;154,0;83,0;430,0;342,0;156,0;161,0;10,0;101,0;1,0;36,0;115,0;10,0;54,0;7,0;40,0;8,0;13,0;20,0;67,0;12,0;14,0;72,0;149,0;46,0;284,0;11,0;63,0;;201,0;43,0;3,0;57,0;48,0;20,0;42,0;1574,0;22,0;211,0;3,0;170,0;32,0;133,0;40,0;3,0;;158,0;498,0;6,0;;4,0;57,0;29,0;48,0;13,0;347,0;16,0;21,0;8,0;66,0;216,0;;19,0;187,0;19,0;290,0;103,0;18,0;232,0;;1,0;38,0;218,0;106,0;227,0;72,0;889,0;3,0;;56,0;175,0;72,0;12,0;6,0;10,0;3,0;87,0;3,0;257,0;67,0;;34,0;41,0;67,0;81,0;91,0;66,0;59,0;1,0;39,0;242,0;95,0;;;24,0;786,0;29,0;16,0;4,0;56,0;139,0;93,0;31,0;253,0;81,0;6,0;52,0;35,0;91,0;736,0;35,0;85,0;3,0;214,0;98,0;6,0;9,0;167,0;2,0;4,0;24,0;157,0;23,0;2,0;;1,0;;5,0;65,0;6,0;;87,0;152,0;1,0;24,0;;;6,0;6,0;;32,0;4,0;8,0;26,0;;;8,0;;;148,0;94,0;5,0;;24,0;6,0;891,0;23,0;6,0;6,0;3,0;16,0;;3,0;;3,0;;14,0;6,0;3,0;1,0;1,0;1,0;;7,0;5,0;321,0;1,0;29,0;1,0;13,0;21,0;11,0;40,0;98,0;59,0;;;56,0;1,0;1,0;33,0;65,0;;8,0;5,0;342,0;16,0;3,0;2,0;2,0;8,0;;104,0;167,0;21,0;;;;;1,0;119,0;;25,0;10,0;1,0;104,0;1,0;;48,0;32,0;;;;323,0;3,0;10,0;49,0;44,0;96,0;42,0;1,0;1,0;;28,0;22,0;1,0;9,0;100,0;6,0;3,0;;2,0;;14,0;;2,0;;6,0;28,0;7,0;5,0;;1,0;;32,0;;2,0;9,0;28,0;19,0;;22,0;16,0;;5,0;;3,0;1,0;1,0;2,0;;93,0;;3,0;;1,0;1,0;;;;;1,0;47,0;4,0;1,0;26,0;1,0;;;7,0;36,0;250,0;3,0;2,0;27,0;2,0;6,0;;56,0;32,0;82,0;;;2,0;416,0;6,0;4,0;;9,0;;;;;34,0;5,0;;3,0;29,0;10,0;;12,0;2,0;;1,0;;8,0;15,0;2,0;;11,0;1,0;2,0;47,0;;;7,0;2,0;;125,0;19,0;;2,0;97,0;;21,0;8,0;17,0;18,0;5,0;12,0;20,0;7,0;1,0;15,0;5,0;34,0;122,0;126,0;29,0;61,0;8,0;26,0;8,0;5,0;11,0;56,0;22,0;2,0;6,0;40,0;16,0;135,0;10,0;46,0;31,0;3,0;15,0;6,0;120,0;124,0;2,0;76,0;18,0;31,0;127,0;90,0;9,0;48,0;72,0;96,0;7,0;22,0;77,0;255,0;1,0;18,0;976,0;27,0;11,0;2,0;19,0;50,0;127,0;5,0;13,0;;7,0;45,0;;12,0;108,0;;2,0;5,0;7,0;73,0;23,0;14,0;15,0;75,0;47,0;66,0;;21,0;10,0;109,0;4,0;154,0;4,0;6,0;4,0;8,0;184,0;24,0;1,0;3,0;6,0;19,0;9,0;83,0;33,0;20,0;5,0;1,0;13,0;19,0;;11,0;2,0;4,0;133,0;33,0;49,0;7,0;;164,0;;25,0;28,0;8,0;9,0;20,0;49,0;1,0;;8,0;20,0;92,0;15,0;12,0;100,0;;9,0;20,0;;6,0;29,0;10,0;109,0;4,0;13,0;3,0;;54,0;13,0;11,0;375,0;15,0;7,0;1,0;25,0;10,0;22,0;31,0;47,0;6,0;25,0;3,0;;17,0;16,0;11,0;16,0;;3,0;;9,0;;17,0;10,0;11,0;1,0;27,0;3,0;71,0;3,0;53,0;30,0;2,0;9,0;;6,0;12,0;;;2,0;2,0;7,0;;2,0;10,0;81,0;36,0;;14,0;2,0;;43,0;;;1,0;;;1,0;4,0;13,0;13,0;8,0;4,0;36,0;15,0;16,0;56,0;95,0;;21,0;6,0;1,0;12,0;11,0;;;2,0;;4,0;11,0;13,0;19,0;3,0;;46,0;;10,0;62,0;32,0;;108,0;83,0;;2,0;30,0;16,0;;;67,0;5,0;2,0;90,0;;12,0;33,0;1,0;18,0;7,0;;18,0;4,0;3,0;19,0;8,0;2,0;3,0;;6,0;3,0;;2,0;1,0;45,0;1,0;4,0;36,0;;2,0;1,0;;44,0;14,0;;93,0;2,0;;;;;;;1,0;4,0;2,0;;5,0;20,0;21,0;7,0;54,0;;1,0;3,0;;;6,0;1,0;;11,0;20,0;;;;14,0;4,0;;2,0;18,0;117,0;14,0;1,0;;2,0;;4,0;1,0;;1,0;1,0;9,0;;2,0;1,0;;66,0;45,0;5,0;;30,0;;6,0;26,0;2,0;41,0;1,0;48,0;1,0;12,0;39,0;1,0;4,0;7,0;;2,0;14,0;;1,0;;;3,0;2,0;6,0;2,0;1,0;;;26,0;3,0;1,0;7,0;85,0;60,0;;2,0;8,0;21,0;15,0;;10,0;;3,0;3,0;;12,0;32,0;;7,0;103,0;2,0;43,0;65,0;12,0;2,0;;9,0;16,0;12,0;10,0;;35,0;61,0;7,0;11,0;8,0;14,0;;;;4,0;2,0;7,0;20,0;1,0;14,0;34,0;;6,0;20,0;2,0;28,0;9,0;39,0;9,0;19,0;4,0;9,0;5,0;9,0;12,0;10,0;14,0;4,0;;11,0;4,0;325,0;;12,0;8,0;;5,0;8,0;13,0;1,0;47,0;5,0;7,0;5,0;;;16,0;;2,0;1,0;;9,0;4,0;6,0;29,0;;62,0;13,0;;26,0;4,0;1,0;40,0;;4,0;9,0;;1,0;;14,0;8,0;;18,0;6,0;;;;7,0;5,0;2,0;13,0;;;;3,0;1,0;5,0;;2,0;3,0;15,0;11,0;3,0;;7,0;;5,0;1,0;9,0;3,0;;5,0;;4,0;1,0;53,0;8,0;2,0;1,0;17,0;2,0;8,0;;;;5,0;;3,0;;;;14,0;2,0;43,0;2,0;;1,0;8,0;;1,0;13,0;;25,0;;139,0;1,0;8,0;;;1,0;3,0;42,0;;;;;;;;;1,0;14,0;1,0;4,0;;10,0;2,0;;4,0;;5,0;;;1,0;2,0;;2,0;29,0;3,0;;7,0;8,0;5,0;12,0;;;1,0;;1,0;3,0;6,0;12,0;7,0;1,0;1,0;2,0;5,0;1,0;28,0;;2,0;;;;4,0;6,0;3,0;4,0;8,0;;9,0;;;;;;2,0
transition;;1,0;;;;;;12,0;;;;;;;10,0;15,0;7,0;;1,0;;;8,0;;1,0;;2,0;11,0;;;;;3,0;15,0;9,0;11,0;;;4,0;2,0;;20,0;;;;10,0;5,0;14,0;19,0;2,0;22,0;;;;;11,0;8,0;1,0;3,0;;;;;2,0;;5,0;;;1,0;38,0;;1,0;;7,0;2,0;;;;;;16,0;1,0;9,0;;16,0;;1,0;1,0;;;;1,0;;;;;;;;42,0;1,0;1,0;;12,0;16,0;;;5,0;2,0;42,0;;;3,0;1,0;;;5,0;7,0;32,0;5,0;4,0;;;3,0;7,0;19,0;2,0;10,0;;;;;3,0;2,0;;7,0;1,0;5,0;16,0;;;2,0;;;;2,0;;;9,0;18,0;;;1,0;;;4,0;1,0;6,0;;;16,0;1,0;1,0;16,0;1,0;;1,0;14,0;18,0;;;1,0;;;3,0;2,0;;1,0;;;;;;;;9,0;4,0;;5,0;;;;;;4,0;;;;;;1,0;;;;2,0;;;2,0;;;;;1,0;12,0;;2,0;;;;;;;;4,0;4,0;;;;1,0;9,0;;2,0;2,0;7,0;;1,0;2,0;;3,0;5,0;2,0;;;;1,0;6,0;;;;2,0;1,0;1,0;;;;;18,0;15,0;;;;;;;2,0;1,0;;8,0;;4,0;;;3,0;2,0;;;;5,0;2,0;;8,0;1,0;;7,0;;;18,0;;;;;;;;;;;;;;;;4,0;1,0;;;;;;1,0;1,0;;;;;4,0;;;;;1,0;;;3,0;4,0;;;;;;;;;;;2,0;;3,0;;;;;;;;;;;;1,0;9,0;;;;;;;;3,0;7,0;2,0;;;;;;;2,0;;;;;1,0;;5,0;;;;;14,0;;;;;14,0;;;1,0;;;3,0;;2,0;;;;;;;;;;;1,0;4,0;;;1,0;;1,0;1,0;14,0;4,0;;;3,0;;;;;;1,0;;;;;2,0;;;;;;23,0;17,0;;29,0;;;;26,0;;2,0;1,0;16,0;;;1,0;4,0;;8,0;27,0;;;;;5,0;1,0;;;;3,0;;;;;;;;;1,0;8,0;;;2,0;;25,0;;;9,0;;;;;3,0;;;18,0;;;;;3,0;;32,0;;;;;3,0;23,0;;1,0;;;11,0;3,0;;;;;;;;;;4,0;;;;;;;4,0;;;1,0;;3,0;;;;;;1,0;;;;6,0;1,0;2,0;;;;;;;5,0;9,0;14,0;;8,0;;;;1,0;;;;1,0;;;2,0;;;;;6,0;;;;;;;;;;1,0;1,0;1,0;;2,0;4,0;;;1,0;;;1,0;1,0;1,0;;;;;;;2,0;;;;3,0;5,0;;4,0;;;4,0;;;;;1,0;;;;;;;;;;5,0;;;2,0;;;27,0;;;;1,0;;;;;;;1,0;;;1,0;4,0;3,0;;;;;;3,0;1,0;;;;2,0;;;;2,0;;;;1,0;;;11,0;;;4,0;;;3,0;;;;;;;;;;;;;;;;;;14,0;;;2,0;;;;;;2,0;3,0;;;;;;;1,0;1,0;;;;;;;;;;;;;;;;;;;1,0;;;;2,0;1,0;;;;;;;;;1,0;;;;1,0;;;2,0;;;;;;;;;;;1,0;;;;;;;;2,0;;1,0;;;;;;;;;;;;;2,0;;;;;2,0;;;;15,0;1,0;;;4,0;;;;;;;;;;;;;;;;;6,0;;;;;;;;;;;;;;2,0;;;;;;;20,0;;;;;;;;;;;;;;;;2,0;;9,0;;;;;;;;;;;1,0;;;;;3,0;;;;;;;;;;;;;;;;;;;;;;2,0;;;1,0;;1,0;;;;;;2,0;;;;1,0;;;;;;;;;;;;;;;;1,0;;;;;;;;;4,0;2,0;;;;;;;;;;;7,0;;;;;;;;;;;;11,0;;;;;1,0;;;;;;;;;;;;;;;;;;;1,0;;;;;7,0;;;;;;;;;;;;;;;;;;;
transmission;;2,0;;;;;2,0;45,0;9,0;17,0;4,0;;11,0;;11,0;20,0;4,0;;4,0;1,0;;41,0;2,0;28,0;7,0;6,0;19,0;6,0;;1,0;9,0;52,0;63,0;;194,0;19,0;;1,0;;;270,0;;2,0;;9,0;13,0;40,0;103,0;52,0;23,0;4,0;12,0;2,0;;104,0;2,0;10,0;;3,0;6,0;1,0;17,0;6,0;4,0;49,0;4,0;10,0;20,0;23,0;14,0;22,0;16,0;21,0;8,0;;1,0;3,0;1,0;12,0;209,0;2,0;27,0;1,0;73,0;3,0;23,0;49,0;;;6,0;215,0;;;3,0;2,0;14,0;7,0;;47,0;9,0;;;63,0;14,0;;27,0;129,0;1,0;53,0;4,0;;13,0;7,0;;4,0;28,0;7,0;118,0;27,0;38,0;;1,0;6,0;45,0;9,0;4,0;4,0;;;4,0;14,0;7,0;4,0;;2,0;;7,0;24,0;3,0;;;;22,0;22,0;8,0;4,0;;40,0;307,0;1,0;2,0;;20,0;16,0;1,0;2,0;78,0;;;12,0;1,0;286,0;523,0;8,0;;;70,0;4,0;5,0;18,0;1,0;;;3,0;8,0;2,0;9,0;3,0;1,0;;5,0;148,0;;;5,0;14,0;;30,0;;;6,0;;2,0;46,0;;7,0;8,0;;1,0;5,0;1,0;1,0;7,0;10,0;4,0;;3,0;7,0;4,0;1,0;3,0;;;;3,0;;;9,0;;13,0;15,0;;;;;;1,0;;105,0;;44,0;;7,0;6,0;;;9,0;9,0;5,0;1,0;5,0;4,0;4,0;256,0;18,0;;1,0;4,0;50,0;2,0;2,0;2,0;;;;9,0;59,0;2,0;;;;;;19,0;;;7,0;;2,0;;;25,0;;4,0;;;15,0;;2,0;38,0;13,0;22,0;15,0;;;97,0;;1,0;1,0;5,0;17,0;;9,0;;3,0;;;;9,0;2,0;;16,0;3,0;;3,0;;2,0;5,0;1,0;;2,0;12,0;;3,0;2,0;1,0;;25,0;;25,0;;1,0;;;5,0;2,0;4,0;;;;;;;;;66,0;;;3,0;3,0;3,0;1,0;;1,0;11,0;3,0;2,0;10,0;5,0;2,0;2,0;;6,0;6,0;10,0;;3,0;4,0;2,0;3,0;;;;;2,0;;;;;12,0;;;;1,0;2,0;;3,0;;4,0;5,0;;;7,0;8,0;;2,0;;4,0;1,0;1,0;;4,0;2,0;;;;;;3,0;2,0;;;4,0;5,0;;;;;8,0;8,0;25,0;4,0;;;1,0;;;2,0;;;;;8,0;1,0;;;;;;2,0;;15,0;27,0;;5,0;;2,0;15,0;11,0;1,0;;3,0;;;61,0;7,0;7,0;;;7,0;5,0;;;1,0;67,0;7,0;16,0;;;;1,0;;;10,0;;;17,0;;12,0;;;;8,0;6,0;13,0;;;;;;8,0;1,0;;;;;;;;4,0;;;1,0;4,0;;1,0;;;34,0;;15,0;;1,0;3,0;4,0;;;;;;;1,0;;1,0;6,0;1,0;;5,0;;;15,0;;25,0;5,0;;4,0;4,0;9,0;;2,0;6,0;;2,0;12,0;3,0;;33,0;;25,0;5,0;2,0;;;;;5,0;3,0;44,0;;6,0;15,0;;6,0;;5,0;8,0;;16,0;;;5,0;2,0;;112,0;;32,0;3,0;35,0;3,0;;28,0;;1,0;;;10,0;;3,0;;;;;;1,0;10,0;;;;6,0;;13,0;9,0;18,0;4,0;4,0;;3,0;;;4,0;3,0;;;7,0;2,0;5,0;;;15,0;;12,0;;;;;34,0;;4,0;13,0;1,0;;1,0;;;;;8,0;1,0;;3,0;1,0;;;;3,0;;2,0;3,0;;1,0;;;2,0;1,0;1,0;;2,0;3,0;;1,0;1,0;82,0;;5,0;1,0;2,0;;1,0;;;;11,0;;;11,0;;1,0;2,0;4,0;;3,0;;;6,0;;;;2,0;;;;;23,0;2,0;;;1,0;6,0;;1,0;;;;;;1,0;;;1,0;;;5,0;3,0;;4,0;1,0;;1,0;;;3,0;;;;;;2,0;;;;;;;;;1,0;1,0;1,0;;3,0;3,0;2,0;;3,0;5,0;;2,0;;;5,0;;;;1,0;1,0;;;;1,0;;;;;;;;;1,0;28,0;;;;1,0;9,0;1,0;;;2,0;;9,0;;;1,0;3,0;;;;2,0;4,0;4,0;;;;;;1,0;;;;3,0;;;2,0;;;2,0;;;;;;;4,0;4,0;;1,0;14,0;;3,0;;;;;3,0;;1,0;2,0;2,0;4,0;;2,0;;;;50,0;;;;;;;;;;;;;7,0;;2,0;;;;;;;1,0;7,0;;;;;14,0;;;;;;;;2,0;;1,0;;;;;;;;;;;;;8,0;;;;1,0;3,0;3,0;5,0;9,0;;;1,0;;;;;;;;;;;;;13,0;;;;;1,0;;;;;;;;4,0;1,0;6,0;;;2,0;;;;;;;;2,0;;;;;;;14,0;;;;;;;;;;;2,0;;;;;2,0;;;3,0;;;;;;2,0;;;66,0;;;26,0;4,0;;;4,0;;;;;;1,0;;;1,0;;3,0;;2,0;;;1,0;;;;7,0;;;;;2,0;2,0;;;;;;
transparent;;2,0;;;;1,0;18,0;35,0;36,0;7,0;3,0;;3,0;;;20,0;;;;;2,0;2,0;;;;;23,0;;;;;1,0;15,0;;4,0;1,0;;;;1,0;5,0;;35,0;;4,0;2,0;1,0;44,0;1,0;39,0;65,0;2,0;3,0;1,0;;;30,0;;;;13,0;;6,0;;52,0;2,0;3,0;118,0;;22,0;1,0;1,0;1,0;;;7,0;;1,0;2,0;63,0;4,0;9,0;;42,0;;;;;;;121,0;;;83,0;;1,0;;;52,0;1,0;;;51,0;9,0;;10,0;47,0;2,0;9,0;;8,0;;13,0;4,0;;36,0;98,0;13,0;;6,0;8,0;;3,0;;;;4,0;;3,0;5,0;;;2,0;5,0;;;1,0;6,0;;;;2,0;;48,0;;;;30,0;4,0;;;5,0;;2,0;;;26,0;;;1,0;;3,0;16,0;;;;4,0;12,0;4,0;20,0;5,0;2,0;6,0;16,0;;7,0;5,0;3,0;14,0;1,0;3,0;11,0;7,0;7,0;1,0;2,0;8,0;11,0;2,0;17,0;;;;14,0;;10,0;;;2,0;96,0;4,0;;;2,0;;;3,0;1,0;;43,0;79,0;5,0;;;63,0;1,0;;5,0;;31,0;29,0;6,0;9,0;1,0;;2,0;99,0;;103,0;5,0;51,0;8,0;14,0;31,0;1,0;;;22,0;19,0;9,0;1,0;10,0;8,0;6,0;;;5,0;;51,0;1,0;159,0;;;;;;10,0;4,0;3,0;19,0;;2,0;12,0;6,0;12,0;;6,0;1,0;6,0;4,0;;20,0;11,0;17,0;;;;5,0;222,0;195,0;15,0;;;7,0;2,0;9,0;4,0;1,0;1,0;;;1,0;;26,0;10,0;1,0;;;1,0;5,0;1,0;2,0;25,0;;1,0;;1,0;3,0;2,0;9,0;;2,0;15,0;4,0;1,0;1,0;1,0;;5,0;3,0;;;6,0;14,0;1,0;;2,0;1,0;;;;;;2,0;2,0;;;9,0;1,0;12,0;;;;5,0;;;;;2,0;19,0;;;;10,0;;;;1,0;3,0;;;2,0;7,0;;;8,0;;2,0;19,0;;2,0;;1,0;;;;4,0;;1,0;;;;30,0;;11,0;;19,0;;;33,0;23,0;3,0;2,0;4,0;;5,0;;;121,0;;;;;;;;;;;1,0;;;;;;;;;;;;1,0;;;;;;1,0;;;;1,0;8,0;;;;;;;1,0;4,0;;1,0;;1,0;3,0;;1,0;;2,0;;;;;;1,0;;;;;5,0;2,0;;;;;;;;;;;;;;;;;4,0;;2,0;8,0;;;;;;;1,0;2,0;;2,0;;;;1,0;;;7,0;;;;;4,0;4,0;;4,0;;;;;4,0;;3,0;;;;;;;;;;;;;;;;1,0;;;;;;;;;;;;1,0;;;;;;;;;;;;;;1,0;;;5,0;;;;2,0;2,0;3,0;;4,0;1,0;;;;;5,0;;2,0;8,0;;12,0;;;;2,0;;;;;;;1,0;;;;;3,0;8,0;;;;;;2,0;;;;2,0;;;4,0;;;;;;;;;2,0;9,0;;;;;;;;;24,0;;1,0;;;1,0;;3,0;;;;1,0;;;;;1,0;;;;;;;;;;;;;;;3,0;;;;;;;2,0;;8,0;;;;;;;;;1,0;;;5,0;;;;;;;;;;;15,0;1,0;;;;;1,0;17,0;;1,0;;;;;;;1,0;;;;;;;;30,0;;5,0;;;;;;2,0;;1,0;;;57,0;;;4,0;5,0;;;1,0;4,0;;;3,0;;4,0;;4,0;1,0;;;3,0;3,0;7,0;10,0;;;2,0;;8,0;1,0;;1,0;;;;;;;;;;;;;;;113,0;;;;;;;;3,0;;;;;;;;;;;;1,0;;;;;;;1,0;;1,0;;18,0;;;;;;;;;;;;;;;;;;;;1,0;;;;;;;;11,0;;;;;;2,0;;;;3,0;;1,0;;;1,0;;;;;;;;;;;;;;;;;1,0;;;;;;;;;;6,0;;;;;;;;;52,0;;;;;;;;;;2,0;;1,0;1,0;;;;;;;;;;5,0;;;7,0;;;;;;;2,0;;;1,0;;;;;;;;;;;;;;;;;;;;;;;1,0;;;1,0;;;;;1,0;;;19,0;;;8,0;;;;;5,0;;;8,0;2,0;;;;;;;;;;1,0;;;;;;;;;;;;1,0;;;;;;;;;;;;;;
trigger;;1,0;;15,0;3,0;;1,0;10,0;4,0;;1,0;;34,0;;3,0;28,0;;;4,0;;;78,0;;;1,0;;;5,0;;;1,0;2,0;35,0;1,0;53,0;23,0;;;;;23,0;;;;45,0;11,0;37,0;72,0;36,0;17,0;;4,0;;;1,0;;2,0;;;;1,0;25,0;9,0;2,0;;;5,0;2,0;14,0;;5,0;1,0;18,0;;;1,0;3,0;;1,0;113,0;1,0;7,0;1,0;29,0;;1,0;2,0;;;;8,0;1,0;;;5,0;;7,0;1,0;71,0;2,0;;;46,0;15,0;2,0;3,0;1,0;3,0;26,0;4,0;2,0;9,0;;1,0;;10,0;9,0;15,0;;13,0;1,0;;6,0;11,0;11,0;3,0;;;;1,0;1,0;6,0;1,0;;3,0;;2,0;49,0;;1,0;;1,0;5,0;37,0;4,0;;;9,0;100,0;1,0;2,0;;;10,0;9,0;;50,0;;;1,0;;13,0;11,0;;;;3,0;12,0;;1,0;2,0;;;;3,0;2,0;2,0;;;;;2,0;;2,0;1,0;59,0;;33,0;;;;;;21,0;;;1,0;;;;;;1,0;;;;;3,0;15,0;2,0;;;1,0;;;;;;;17,0;2,0;;;;;;;31,0;14,0;;5,0;;3,0;7,0;;1,0;2,0;3,0;;1,0;;;;;2,0;;;;3,0;;11,0;;;7,0;;5,0;48,0;;;;;;1,0;;3,0;;;;27,0;;9,0;3,0;;;1,0;;6,0;1,0;;5,0;50,0;2,0;4,0;;;75,0;;;;;9,0;;2,0;;;;;;;;5,0;4,0;;;;;;;;;;6,0;;;;;;24,0;;7,0;;;;;2,0;3,0;;1,0;;3,0;;;;;;;;3,0;;3,0;;;1,0;;1,0;2,0;;;;;;;;;;1,0;;6,0;;;1,0;;;14,0;;;;;;;;1,0;;3,0;;;;;2,0;;;;4,0;;;1,0;;;;4,0;;2,0;;;1,0;8,0;;;1,0;;2,0;;6,0;;;1,0;;;;1,0;11,0;2,0;2,0;;2,0;;;;;5,0;2,0;1,0;22,0;4,0;1,0;1,0;1,0;3,0;;4,0;;49,0;3,0;1,0;4,0;;;;18,0;;3,0;25,0;5,0;1,0;7,0;5,0;38,0;;1,0;5,0;;;;;32,0;17,0;3,0;1,0;;;1,0;;;;;;58,0;;5,0;1,0;2,0;;;1,0;29,0;;4,0;4,0;1,0;;5,0;3,0;;;6,0;6,0;;;;;;2,0;98,0;1,0;;;;4,0;12,0;;18,0;;2,0;;4,0;;;3,0;;;;;1,0;2,0;2,0;6,0;;1,0;;;2,0;19,0;;;;;1,0;;;1,0;;;;1,0;;;6,0;1,0;4,0;6,0;;1,0;1,0;;;17,0;;3,0;;;;;;;6,0;;;9,0;;27,0;;3,0;;;;17,0;1,0;9,0;;;;;;;;13,0;;;;;;;2,0;;10,0;;;;1,0;;;;;;;;1,0;;4,0;;;2,0;3,0;;;1,0;6,0;;9,0;11,0;;1,0;;;;;;;;;;;;5,0;3,0;1,0;1,0;;;1,0;1,0;;;4,0;;;;1,0;9,0;2,0;;;;1,0;;2,0;;4,0;1,0;1,0;;2,0;;;1,0;;1,0;;;;;7,0;;;3,0;;;;;;;;2,0;;;;;;;;;1,0;2,0;;;1,0;;;4,0;;;;;;1,0;;;;;;;;1,0;;;;;4,0;1,0;;;;1,0;;;;;;;;;;;;;;;;2,0;;;;;;1,0;1,0;;;;;;;;2,0;;;;;;;;;4,0;1,0;;;;;;;;;;;;;;;;3,0;;;;;;2,0;2,0;;;2,0;;7,0;;;;;5,0;;6,0;7,0;;;;;;;;;;10,0;;;1,0;;;;;;;1,0;;;;;;;;;;;;;;;15,0;;;;;1,0;;1,0;;;;2,0;1,0;;;;;;;;12,0;6,0;;;;11,0;3,0;;1,0;;;;;;1,0;;;;;;;;;;;;;;;;;;;;5,0;2,0;;;;1,0;;;;;;;;;1,0;;;;;;;;;;;;;1,0;;;;;;;;;1,0;;;;;;;;;;;1,0;;8,0;;;;;1,0;1,0;;;;;;;;;;;;;;;;;;;1,0;;4,0;;;;;;2,0;;;;;;;;;;;;;;;;;;;;;;;;;;;;10,0;1,0;;;;;;;;;;
upper;;2,0;;1,0;3,0;19,0;1,0;12,0;51,0;30,0;11,0;;2,0;;15,0;129,0;;2,0;1,0;;4,0;1,0;;36,0;;;4,0;;;;21,0;;46,0;3,0;15,0;2,0;;4,0;4,0;;23,0;4,0;61,0;;2,0;5,0;14,0;52,0;5,0;33,0;83,0;7,0;;1,0;8,0;26,0;34,0;;;;61,0;5,0;7,0;;16,0;1,0;8,0;117,0;50,0;13,0;2,0;;6,0;;;3,0;1,0;3,0;;111,0;1,0;20,0;;107,0;7,0;1,0;1,0;;13,0;9,0;111,0;;;8,0;;;;;17,0;7,0;;;83,0;13,0;;;16,0;3,0;2,0;4,0;16,0;6,0;12,0;;1,0;34,0;344,0;91,0;;21,0;3,0;5,0;2,0;;2,0;1,0;;;;11,0;3,0;3,0;22,0;1,0;;;8,0;5,0;;;;;;78,0;10,0;;5,0;211,0;7,0;1,0;;5,0;4,0;;;;40,0;;12,0;3,0;;9,0;77,0;;;;25,0;24,0;4,0;;;;12,0;44,0;2,0;8,0;36,0;32,0;2,0;;34,0;65,0;3,0;21,0;;15,0;;51,0;7,0;;1,0;;4,0;79,0;;28,0;;;1,0;85,0;14,0;;2,0;40,0;;16,0;1,0;;3,0;94,0;21,0;21,0;3,0;13,0;2,0;;23,0;4,0;10,0;70,0;134,0;4,0;59,0;12,0;1,0;;23,0;4,0;20,0;;188,0;;2,0;120,0;14,0;7,0;7,0;52,0;28,0;37,0;5,0;10,0;4,0;;;;4,0;;57,0;10,0;145,0;;18,0;;;;91,0;1,0;2,0;1,0;8,0;21,0;11,0;1,0;12,0;3,0;12,0;30,0;;;4,0;2,0;22,0;8,0;;93,0;1,0;33,0;56,0;705,0;15,0;;4,0;5,0;1,0;4,0;;5,0;;30,0;13,0;26,0;1,0;1,0;92,0;;7,0;2,0;17,0;;15,0;4,0;50,0;1,0;3,0;;;3,0;60,0;6,0;;64,0;;8,0;4,0;1,0;;7,0;;41,0;6,0;;17,0;13,0;18,0;;19,0;1,0;5,0;;14,0;3,0;16,0;3,0;1,0;11,0;26,0;13,0;1,0;42,0;7,0;1,0;5,0;;72,0;6,0;17,0;9,0;30,0;4,0;12,0;17,0;;1,0;1,0;3,0;11,0;55,0;5,0;3,0;;3,0;1,0;18,0;10,0;9,0;;18,0;64,0;;;3,0;4,0;;;14,0;11,0;7,0;16,0;8,0;7,0;8,0;1,0;11,0;;17,0;11,0;2,0;3,0;78,0;3,0;2,0;;;7,0;;2,0;;12,0;;;;;3,0;;;;;;2,0;2,0;;1,0;;;3,0;;;;;;;;;;1,0;4,0;12,0;;;;1,0;13,0;3,0;1,0;2,0;58,0;;13,0;;3,0;5,0;7,0;;3,0;7,0;4,0;3,0;7,0;1,0;3,0;;1,0;1,0;7,0;3,0;;;;;2,0;2,0;;8,0;;6,0;;1,0;32,0;4,0;4,0;;;;3,0;;3,0;;;3,0;6,0;3,0;;5,0;13,0;2,0;;;;;;5,0;;8,0;;;;;2,0;1,0;4,0;3,0;;2,0;1,0;;3,0;;;;;4,0;;;;;;;3,0;;;;;2,0;;;;3,0;;;;1,0;11,0;19,0;;3,0;3,0;;;3,0;;52,0;;3,0;;1,0;1,0;;;;1,0;2,0;;;;;;;28,0;5,0;;2,0;1,0;1,0;5,0;4,0;4,0;3,0;;;;;3,0;;;;10,0;;;4,0;;3,0;;30,0;1,0;;;;4,0;;;;2,0;12,0;16,0;;;2,0;94,0;;16,0;;3,0;;;;;3,0;;;;;;1,0;10,0;;;;;;;;;;;;30,0;;;;;32,0;;1,0;;;2,0;8,0;;;1,0;;;;;;;33,0;3,0;7,0;;;;6,0;3,0;;1,0;;10,0;4,0;29,0;2,0;;8,0;2,0;50,0;;1,0;;;8,0;4,0;3,0;;;;;7,0;1,0;2,0;2,0;3,0;8,0;10,0;1,0;18,0;;3,0;1,0;;;;14,0;;;1,0;2,0;;5,0;;;;2,0;;3,0;1,0;;;;4,0;3,0;;;;;;;;3,0;21,0;;;1,0;1,0;;54,0;3,0;4,0;;6,0;;;1,0;1,0;1,0;;;11,0;1,0;;;47,0;2,0;;;3,0;;;3,0;;5,0;2,0;;2,0;4,0;2,0;;;1,0;;;;;;;;;;;;;23,0;10,0;;;3,0;;3,0;7,0;11,0;;;;;;;;;6,0;1,0;;;5,0;4,0;;;;;;;;;;;;;1,0;;3,0;;;;;;;;;1,0;;;1,0;;3,0;;;;;;1,0;2,0;;18,0;8,0;;;;;7,0;;;;1,0;;;1,0;;;;;4,0;;;;;;;;1,0;3,0;;;2,0;;;;;;;2,0;2,0;;;;;2,0;1,0;;;;;4,0;;;;;;;;;;;;;;;;;;4,0;;;;;;7,0;;3,0;6,0;;3,0;;;3,0;3,0;;;1,0;2,0;;1,0;1,0;2,0;23,0;6,0;17,0;;;;1,0;;;;;;;;;1,0;;;;;;;;2,0;;;;13,0;;1,0;;10,0;;13,0;;;;;;;14,0;;;;;;;2,0;;;4,0;;;;;20,0;15,0;;;;;1,0;;;;;;;;;;5,0;;;;;;
vehicle;;26,0;;12,0;20,0;146,0;21,0;90,0;220,0;37,0;3,0;;34,0;5,0;73,0;209,0;3,0;2,0;9,0;14,0;67,0;167,0;5,0;3,0;5,0;2,0;12,0;3,0;;1,0;9,0;23,0;113,0;1,0;163,0;64,0;6,0;3,0;10,0;23,0;199,0;;33,0;;212,0;78,0;187,0;273,0;20,0;284,0;69,0;96,0;6,0;6,0;31,0;15,0;53,0;;76,0;;17,0;45,0;128,0;;4,0;2,0;2,0;9,0;27,0;171,0;25,0;;81,0;19,0;5,0;9,0;36,0;8,0;7,0;773,0;7,0;70,0;1,0;221,0;;19,0;1,0;25,0;43,0;6,0;63,0;4,0;2,0;1,0;36,0;8,0;9,0;1,0;352,0;50,0;48,0;;102,0;169,0;1,0;40,0;36,0;9,0;41,0;30,0;54,0;18,0;;2,0;;120,0;132,0;372,0;20,0;70,0;2,0;2,0;24,0;72,0;76,0;5,0;;2,0;6,0;26,0;;32,0;78,0;;27,0;1,0;10,0;23,0;13,0;7,0;36,0;3,0;6,0;166,0;19,0;4,0;1,0;128,0;99,0;6,0;6,0;;6,0;31,0;10,0;11,0;638,0;;4,0;;3,0;33,0;166,0;;9,0;14,0;103,0;319,0;9,0;3,0;12,0;29,0;11,0;90,0;8,0;11,0;142,0;;4,0;2,0;32,0;53,0;;;;7,0;;17,0;5,0;;;;1,0;38,0;;33,0;2,0;;;28,0;;6,0;16,0;92,0;24,0;1,0;6,0;;14,0;38,0;1,0;4,0;10,0;;;1,0;;;14,0;;89,0;4,0;14,0;;6,0;136,0;42,0;;91,0;;13,0;;106,0;403,0;5,0;41,0;99,0;41,0;3,0;31,0;1,0;21,0;25,0;38,0;;;;;45,0;20,0;43,0;2,0;4,0;;;;91,0;18,0;10,0;;3,0;;12,0;25,0;;;33,0;2,0;;;5,0;9,0;55,0;;;1,0;14,0;58,0;;208,0;5,0;;4,0;;;100,0;8,0;;1,0;;;16,0;8,0;;6,0;25,0;8,0;268,0;5,0;4,0;3,0;9,0;112,0;;10,0;2,0;9,0;1,0;;12,0;;18,0;;;22,0;5,0;19,0;29,0;;22,0;2,0;8,0;;;84,0;;1,0;1,0;;18,0;3,0;12,0;;;2,0;12,0;44,0;16,0;12,0;4,0;;4,0;1,0;36,0;8,0;5,0;4,0;224,0;11,0;15,0;1,0;1,0;;12,0;;15,0;24,0;93,0;5,0;2,0;2,0;23,0;5,0;;;;5,0;161,0;5,0;;5,0;;;18,0;10,0;;;;1,0;24,0;;14,0;;;8,0;6,0;;;3,0;53,0;20,0;13,0;32,0;2,0;1,0;17,0;47,0;58,0;52,0;8,0;5,0;2,0;2,0;7,0;46,0;42,0;;8,0;17,0;51,0;30,0;3,0;29,0;3,0;23,0;;2,0;5,0;3,0;1,0;;48,0;5,0;11,0;1,0;;3,0;27,0;3,0;26,0;;49,0;1,0;3,0;129,0;;;29,0;66,0;;146,0;54,0;67,0;21,0;3,0;89,0;33,0;66,0;42,0;11,0;3,0;30,0;18,0;1,0;12,0;59,0;11,0;10,0;17,0;2,0;9,0;1,0;;125,0;;;13,0;119,0;35,0;53,0;41,0;65,0;9,0;16,0;46,0;4,0;4,0;19,0;;17,0;32,0;5,0;8,0;23,0;35,0;;7,0;1,0;4,0;5,0;4,0;82,0;22,0;2,0;2,0;79,0;2,0;11,0;17,0;8,0;14,0;;;22,0;7,0;42,0;3,0;10,0;8,0;4,0;4,0;47,0;2,0;;;;5,0;6,0;;;8,0;7,0;;15,0;2,0;;16,0;5,0;;2,0;;8,0;7,0;12,0;;;29,0;2,0;;7,0;;;;;;17,0;7,0;25,0;1,0;7,0;;;;6,0;;31,0;37,0;2,0;26,0;8,0;;12,0;4,0;1,0;;8,0;6,0;25,0;2,0;;2,0;15,0;29,0;17,0;;3,0;2,0;;5,0;9,0;5,0;65,0;;;;;;;17,0;52,0;11,0;;;48,0;27,0;3,0;;1,0;35,0;3,0;63,0;9,0;;8,0;;12,0;2,0;;;;4,0;4,0;1,0;17,0;;;;1,0;2,0;1,0;;8,0;;20,0;26,0;2,0;81,0;1,0;;10,0;;;2,0;6,0;15,0;;12,0;;;8,0;;1,0;18,0;;;;;;19,0;;2,0;2,0;;5,0;51,0;17,0;;2,0;4,0;6,0;;;4,0;7,0;;6,0;;12,0;;;193,0;;;7,0;161,0;3,0;;4,0;;3,0;;4,0;21,0;2,0;;16,0;11,0;3,0;;2,0;;4,0;;;5,0;12,0;;3,0;2,0;7,0;131,0;91,0;28,0;11,0;;2,0;;6,0;;12,0;3,0;;;13,0;;;;;;;;32,0;;15,0;5,0;;;4,0;1,0;4,0;2,0;1,0;10,0;;;2,0;;12,0;;2,0;8,0;;26,0;5,0;;1,0;;;;117,0;2,0;;;;;1,0;12,0;1,0;13,0;;;;;2,0;4,0;2,0;1,0;;;1,0;;;3,0;14,0;;10,0;2,0;;2,0;1,0;;11,0;;;4,0;3,0;17,0;;;14,0;;5,0;;1,0;15,0;;;9,0;19,0;;5,0;;3,0;5,0;1,0;;;;;;;;;1,0;;;3,0;62,0;;1,0;;;8,0;5,0;3,0;1,0;;;;;;3,0;;3,0;1,0;;26,0;1,0;;;;;53,0;;1,0;6,0;1,0;3,0;;;1,0;;;1,0;;;;1,0;20,0;;;1,0;1,0;;;17,0;;1,0;;6,0;;4,0;2,0;12,0;3,0;14,0;1,0;;;;1,0;;;9,0;1,0;;;2,0;1,0;14,0;2,0;;;4,0;;;;;4,0;6,0;3,0;;4,0;13,0;7,0;3,0;;;5,0;;;;;4,0;3,0;2,0;30,0;;59,0;4,0;3,0;10,0;1,0;1,0;;;;;;7,0;2,0;;;;;;;4,0;2,0;4,0;18,0;;;;2,0;1,0;;;3,0;4,0;;7,0;;;9,0;;;;;;3,0;;;;;;2,0;;;1,0;;;5,0;;1,0;;;2,0;;13,0;9,0;38,0;;10,0;119,0;;46,0;24,0;5,0;34,0;2,0;;;;40,0;4,0;;;;
vertical;;6,0;;;;74,0;6,0;14,0;21,0;71,0;13,0;;4,0;2,0;133,0;69,0;2,0;;1,0;2,0;10,0;9,0;10,0;41,0;;2,0;8,0;4,0;1,0;2,0;3,0;1,0;46,0;;29,0;3,0;9,0;52,0;;;11,0;2,0;14,0;2,0;28,0;1,0;10,0;28,0;6,0;16,0;31,0;55,0;9,0;2,0;13,0;61,0;11,0;8,0;3,0;;29,0;1,0;9,0;;44,0;33,0;1,0;28,0;39,0;20,0;2,0;2,0;5,0;2,0;;13,0;8,0;;1,0;153,0;;33,0;;52,0;6,0;2,0;;;2,0;49,0;45,0;;;2,0;1,0;1,0;;;55,0;5,0;3,0;;25,0;22,0;;2,0;52,0;3,0;18,0;18,0;7,0;28,0;;;;44,0;67,0;99,0;3,0;11,0;2,0;;3,0;12,0;5,0;2,0;;;;4,0;;42,0;21,0;2,0;15,0;;6,0;19,0;6,0;;3,0;;;17,0;8,0;;;25,0;182,0;22,0;;;1,0;10,0;;13,0;27,0;;16,0;221,0;2,0;3,0;182,0;3,0;;;6,0;28,0;;;16,0;13,0;3,0;21,0;18,0;21,0;9,0;10,0;1,0;2,0;4,0;5,0;;3,0;33,0;53,0;8,0;64,0;;;1,0;;;60,0;2,0;1,0;;4,0;;19,0;3,0;;14,0;405,0;6,0;2,0;1,0;;;1,0;7,0;;11,0;;;2,0;4,0;;5,0;4,0;13,0;1,0;1,0;4,0;3,0;2,0;18,0;1,0;24,0;;27,0;3,0;1,0;56,0;9,0;12,0;11,0;18,0;2,0;4,0;;1,0;;1,0;;;5,0;1,0;205,0;40,0;38,0;13,0;30,0;1,0;1,0;9,0;13,0;;3,0;;;;5,0;14,0;3,0;;9,0;4,0;1,0;;2,0;5,0;9,0;2,0;;7,0;1,0;18,0;3,0;82,0;5,0;56,0;3,0;;5,0;6,0;21,0;5,0;;1,0;16,0;;;;5,0;;1,0;;24,0;;8,0;19,0;26,0;1,0;2,0;;1,0;4,0;8,0;9,0;;;;;3,0;3,0;;;2,0;4,0;;;;;30,0;;4,0;1,0;4,0;4,0;6,0;7,0;;;;;8,0;3,0;4,0;7,0;;8,0;1,0;;;3,0;4,0;2,0;21,0;13,0;6,0;19,0;;6,0;;13,0;17,0;72,0;;3,0;1,0;3,0;;;;;7,0;24,0;1,0;1,0;;1,0;;1,0;;;;8,0;18,0;17,0;5,0;1,0;12,0;1,0;1,0;33,0;16,0;2,0;1,0;54,0;3,0;29,0;;;2,0;;;3,0;4,0;;;;;4,0;;;;4,0;;14,0;5,0;;;;6,0;3,0;;;1,0;;;5,0;;;;;;9,0;;1,0;3,0;16,0;7,0;11,0;18,0;;4,0;22,0;3,0;;1,0;37,0;4,0;;;3,0;4,0;1,0;31,0;5,0;;8,0;7,0;;;1,0;;;9,0;14,0;3,0;;;5,0;4,0;;1,0;1,0;6,0;15,0;;;;;20,0;;14,0;;2,0;1,0;21,0;12,0;2,0;34,0;18,0;1,0;10,0;;;9,0;;;3,0;3,0;4,0;1,0;;;1,0;1,0;9,0;;;2,0;4,0;;1,0;;13,0;;6,0;8,0;2,0;;;;1,0;;2,0;;;;;9,0;13,0;;;5,0;;;;;3,0;2,0;;4,0;1,0;1,0;;26,0;;;;;;2,0;15,0;;;5,0;;1,0;;3,0;;5,0;;;9,0;;2,0;9,0;4,0;6,0;4,0;1,0;;12,0;;;;;3,0;4,0;;11,0;;;;;;;;;;;;;11,0;4,0;;;;;3,0;;;;10,0;;8,0;;;2,0;;6,0;4,0;;2,0;;1,0;;2,0;;;;2,0;;;;9,0;;2,0;;1,0;;42,0;9,0;;1,0;4,0;;;1,0;;;;6,0;;;;;;19,0;;;5,0;20,0;1,0;;;;;1,0;14,0;1,0;1,0;;;1,0;5,0;7,0;5,0;1,0;13,0;;;18,0;;;2,0;1,0;;;;;;3,0;;2,0;2,0;;2,0;1,0;8,0;336,0;;5,0;;;;1,0;2,0;;;5,0;8,0;6,0;1,0;;;;2,0;;;2,0;1,0;8,0;19,0;2,0;2,0;;;26,0;;;1,0;;1,0;2,0;;3,0;;;;;3,0;;5,0;;;;14,0;;1,0;;1,0;1,0;;;;6,0;1,0;11,0;;;;3,0;1,0;1,0;;;;;;4,0;2,0;1,0;;1,0;;3,0;2,0;;;1,0;45,0;23,0;;;2,0;33,0;3,0;1,0;4,0;;;4,0;7,0;1,0;2,0;;;;;;12,0;;2,0;;1,0;1,0;5,0;2,0;1,0;;;;4,0;;9,0;1,0;;;;;;;2,0;;;;;;1,0;;;;2,0;;;;2,0;;4,0;;;;;;;12,0;1,0;;3,0;;;;;;;;;;;;;;;;;;;;;;;1,0;1,0;;;;;;1,0;1,0;;;;8,0;;;2,0;;;1,0;1,0;;;;12,0;;;;;;;;1,0;1,0;1,0;17,0;;;;;;;;1,0;1,0;;1,0;;20,0;1,0;;;;;;;4,0;3,0;1,0;;26,0;;12,0;2,0;;1,0;;1,0;;;;6,0;;;9,0;;1,0;;;;16,0;;2,0;;1,0;;;;3,0;;;;1,0;2,0;1,0;;2,0;2,0;;2,0;2,0;;;;;;;;6,0;;;;;;;9,0;;;;;;;;5,0;;;;1,0;;;3,0;1,0;2,0;;3,0;1,0;;;;1,0;;;;
viewfinder;;38,0;;;;4,0;;4,0;1,0;5,0;6,0;;10,0;;2,0;2,0;;;;;;11,0;;;;;25,0;5,0;;;;1,0;16,0;;7,0;2,0;;3,0;;;6,0;2,0;1,0;;13,0;4,0;5,0;65,0;21,0;136,0;23,0;;;;7,0;;4,0;;;;3,0;;14,0;;;;;1,0;32,0;3,0;2,0;;4,0;;;;;;;161,0;;7,0;;47,0;;;1,0;;;;12,0;;;;;;;;32,0;7,0;;;6,0;15,0;1,0;;53,0;;7,0;4,0;;10,0;1,0;;;3,0;59,0;54,0;;;;;;;6,0;;;;;2,0;;;3,0;;;33,0;2,0;;;;6,0;;1,0;22,0;;;;10,0;5,0;5,0;1,0;;;;34,0;6,0;18,0;;;1,0;;8,0;13,0;;;;11,0;49,0;1,0;;6,0;;;1,0;;;15,0;;;1,0;7,0;35,0;;1,0;;2,0;;6,0;;;;;;9,0;;;1,0;;2,0;;;;4,0;14,0;;;;;2,0;5,0;;2,0;;;;2,0;2,0;;3,0;2,0;2,0;5,0;;5,0;;;;;7,0;;7,0;;33,0;18,0;25,0;2,0;1,0;1,0;1,0;;9,0;11,0;5,0;;;;;;1,0;;1,0;;;;;;9,0;9,0;;;;;;19,0;;1,0;2,0;10,0;5,0;;;;5,0;;;;;;;2,0;5,0;;;;;8,0;;6,0;;;;2,0;;;1,0;;;;;;;1,0;1,0;;;;;14,0;2,0;;;;;;2,0;1,0;;2,0;;3,0;;;;;4,0;;;;;;;4,0;;;;;;3,0;2,0;;;;5,0;;;;;;14,0;;;7,0;1,0;5,0;;;;1,0;1,0;2,0;;;;2,0;;;;;;;;;;;;;;7,0;23,0;1,0;12,0;;;;;;2,0;;;5,0;3,0;1,0;;;5,0;;;4,0;;;;1,0;;1,0;;;;;;1,0;6,0;;5,0;;;2,0;;1,0;7,0;;;;;2,0;;;;;;;;12,0;10,0;;5,0;;2,0;1,0;33,0;;5,0;6,0;2,0;;;;2,0;2,0;4,0;1,0;14,0;;;;9,0;5,0;3,0;;;;;;;;1,0;;;;;;;;;3,0;19,0;2,0;;;;;2,0;;;3,0;;;5,0;6,0;;;;;2,0;;6,0;;;1,0;11,0;;7,0;;;3,0;2,0;;;;;;;25,0;;;2,0;;;;;2,0;;;4,0;8,0;21,0;;;;;;;;;;;;;;;;12,0;1,0;;;19,0;;20,0;;27,0;2,0;;;;;;;;1,0;;;;1,0;;;;;;;;;1,0;;7,0;;;2,0;;;;;;;;;2,0;9,0;;1,0;6,0;;;;;1,0;;;;;2,0;;9,0;;5,0;;;1,0;;;;;;;;6,0;;;;;;;;7,0;;;1,0;;7,0;;;;;;;;;;;;;;;1,0;;;6,0;;3,0;;;1,0;;;;1,0;5,0;5,0;;1,0;;;;;;;;4,0;;4,0;1,0;;;;;6,0;;;12,0;;;;;;;1,0;;3,0;;;;;;2,0;;1,0;;;;;;;;;7,0;;1,0;;;2,0;;;;;;3,0;;;;;;;2,0;;;;;;3,0;;;;;;3,0;;;;;;;1,0;3,0;;;;;;;;;;;;;;;;;;;;;;;;;;;;;;;;;1,0;;;;;;1,0;;;;;;9,0;;;;;;;;;;;;;;1,0;;;;;;;;;;;;;;;;;;;;;;;6,0;;;;;;;;;;;1,0;;;;;;;;;;;;;;;;;;;;;;;;;5,0;;;;;;;1,0;;;;;;;;;;;6,0;;;;;;;;;;;;;;;;;;;;;;22,0;;;;8,0;;;;;;;;;;;;;7,0;6,0;;;;;;;;;;;;;;;;;3,0;;;;;;5,0;;;;3,0;;;;;;;;;;;3,0;;;2,0;;;;;;;2,0;;;;;;;;;;;;;;;;;;;;;;;;;;;;;3,0;;;;;;
voltage;;3,0;1,0;3,0;;11,0;;13,0;20,0;5,0;11,0;;1,0;6,0;10,0;58,0;;;;2,0;;;5,0;2,0;;1,0;1,0;2,0;;;;3,0;137,0;;147,0;4,0;11,0;42,0;;;65,0;11,0;;1,0;39,0;9,0;49,0;93,0;32,0;2,0;;2,0;;9,0;99,0;2,0;65,0;;6,0;;3,0;13,0;11,0;;7,0;;;29,0;6,0;;16,0;;301,0;21,0;;7,0;;;;46,0;12,0;46,0;;64,0;18,0;2,0;19,0;;;7,0;43,0;;5,0;1,0;7,0;9,0;3,0;;52,0;;1,0;4,0;53,0;4,0;;7,0;14,0;2,0;416,0;2,0;3,0;36,0;;;20,0;88,0;70,0;7,0;147,0;157,0;;;21,0;11,0;;;1,0;;;21,0;12,0;521,0;;6,0;1,0;;18,0;23,0;127,0;;;1,0;1,0;49,0;4,0;;;8,0;640,0;2,0;1,0;;61,0;113,0;3,0;494,0;61,0;;;58,0;;20,0;129,0;13,0;26,0;;17,0;;;;;;;;10,0;135,0;5,0;1,0;7,0;;;37,0;;;62,0;143,0;;3,0;;;;;;88,0;;117,0;;;3,0;;;;37,0;29,0;2,0;;7,0;1,0;;;9,0;;;99,0;;;;;7,0;3,0;3,0;5,0;;;;2,0;11,0;;27,0;;40,0;2,0;8,0;4,0;5,0;5,0;3,0;;11,0;;;;;4,0;20,0;15,0;4,0;;126,0;;;2,0;;;43,0;5,0;58,0;3,0;;;;;;40,0;19,0;;2,0;2,0;4,0;4,0;;143,0;;;;;10,0;;21,0;7,0;98,0;8,0;166,0;4,0;;109,0;5,0;1,0;;4,0;;2,0;2,0;1,0;;;;;10,0;;8,0;3,0;1,0;;;;134,0;7,0;;;;;2,0;;2,0;3,0;;41,0;;2,0;;;;;67,0;2,0;;;;;;;;;;9,0;50,0;;70,0;3,0;;;;2,0;;;10,0;;;4,0;1,0;;;5,0;29,0;1,0;;47,0;;13,0;;1,0;;;;;83,0;;2,0;;;;;1,0;;;;;5,0;3,0;;;;;;10,0;;;31,0;;;5,0;1,0;2,0;;;;3,0;;;2,0;;;;;;29,0;;2,0;10,0;33,0;6,0;104,0;;;26,0;;;1,0;;;;4,0;15,0;;1,0;;;;;;151,0;252,0;;4,0;3,0;;13,0;6,0;;29,0;;2,0;;2,0;51,0;108,0;;4,0;47,0;;3,0;;;11,0;;;;;;33,0;;;1,0;;;;;43,0;1,0;;;1,0;1,0;2,0;;;;;;35,0;10,0;;3,0;;33,0;;;2,0;3,0;10,0;;;1,0;1,0;;2,0;;2,0;;1,0;1,0;;;;1,0;;;62,0;;;;;;;;;;;;2,0;6,0;20,0;6,0;;;;;;;;67,0;;11,0;;;8,0;;;;1,0;1,0;;78,0;;22,0;2,0;1,0;;;1,0;;;;;2,0;;14,0;;;;2,0;9,0;;;;;6,0;;;60,0;;13,0;;;12,0;;;;;;;;4,0;;11,0;;;;;;;1,0;;;;;;;15,0;6,0;1,0;;;;;;;;;1,0;;;5,0;11,0;;;;;;21,0;;;;;;8,0;;;1,0;49,0;;2,0;;;;3,0;;;;12,0;;;;;;;1,0;;;33,0;;;1,0;;;;14,0;;;130,0;22,0;;;41,0;;;3,0;;;6,0;;1,0;;;;;;;;;;6,0;;;17,0;;7,0;;1,0;1,0;;3,0;;;;;59,0;;;;;;;;;5,0;2,0;;;;;;;;;;;;;26,0;;;;;;12,0;51,0;10,0;;;;;;;;;1,0;;25,0;1,0;11,0;;;;;;;;;;;;;;6,0;;;14,0;2,0;1,0;49,0;13,0;172,0;;;;19,0;4,0;;10,0;82,0;;1,0;9,0;7,0;1,0;;1,0;95,0;88,0;;;3,0;15,0;;;;1,0;;;;163,0;33,0;;6,0;;;;;1,0;2,0;1,0;;;;;;;;;14,0;;;;1,0;;;;;;;7,0;;52,0;16,0;;;;;;5,0;;46,0;;;;;;;;;;2,0;;;;1,0;;33,0;;;;1,0;;;;;;;;;;;;;;;;;;;18,0;;;;;;;;2,0;;;;;;;;;;;;;2,0;5,0;;;;6,0;36,0;;;1,0;;;;1,0;;;;;;;;;7,0;50,0;;;2,0;;;1,0;3,0;;;;115,0;;;;;;3,0;9,0;;4,0;;;;;1,0;;;;;;;3,0;;;;;;;;3,0;6,0;;;;;;;;;;;;;;;;;;;;;;;;;;4,0;;;;13,0;;;;;;2,0;;;;;;
wearable;;45,0;;;;1,0;;20,0;;;;;;;;1,0;;;;;3,0;4,0;;;;;;2,0;;;;;6,0;;1,0;;;;;;;;;;;1,0;;17,0;2,0;32,0;;;;;;;;;;;;;1,0;;;;;;;4,0;;;;;;;;;;33,0;;13,0;1,0;5,0;;;;;15,0;;;;;;;;;;1,0;2,0;;;;;;;;;;2,0;;;;;;;;;;;;;;;;;;;;;;;;;;;;;;;;;;12,0;;;;13,0;;;;;;;1,0;;1,0;;;;;;10,0;;;;3,0;2,0;;;;;;;;;;8,0;;;;3,0;;;;;;;;;;;;;;;;;;;;;;4,0;;;;;;39,0;;;;;;;;;;;;;;;;;;;;;;;;;;;;;;;;;;;;;;;;;;;;;;;;;;;;;;1,0;;;;;;;;;;;;;;;;;;;;;;1,0;;;;;;;;;;;;;;;;;;;;;;;;;;;;;;;;;;;;;;;;;;;;;;;;;;;;;;;;;;;;;;;;;;;;;;;;1,0;;;;;;;;;;;;;;;;;;;;;;;;;;;;;;;;;;;;;;;;;;;;;;1,0;;;;;1,0;;;;;;;;;;;;;;;;;;;;;;;;;;;;;1,0;;;;;;;;4,0;;;;;;;;;;;1,0;;;;;;;;;;;;;3,0;;;;;13,0;;;;;;;;;;;;;;1,0;;;;;;;3,0;;;;;;;;;;;;;;;;;;;;;;;;;1,0;;;1,0;;;;;;1,0;;;;;;;;;;;;;;;;;;;;;;;;;;;;;2,0;;;;;;;;;1,0;;;;;;;;;;;;;;;;;;;;;;;;;;;;;;;9,0;;;;;;;;;;;;;1,0;;;;;;;;;;;;;;;4,0;;;;;;;;;;;;;;;;;;;;;;;;;;;;;4,0;;;;;;;;;;;;;;;;;;;;;;;;;;;;;;;;;;;;;;;;1,0;;;;1,0;;;;;;;;;;;;;;;;;;;;;;;;;;;;;;;;;;;;;;;;;;;;1,0;;;;;;;;;;;;;;;;;;;;;;1,0;;;;;;;;;;;;;;;;;;;;;;;;;;;;;;;;;;;;;;;;;;;;;;;;;;;;;;;;;;;;;;;;;;;;;;;;;;;;;;;;;;;;;;;;;;;;1,0;;;;;;;;;;;;;;;;;;;;;;;;;;;;;;;;;;;;;;;;;;;;;;;;;;;;;;;;;;;;;;;;;;;;;;;;;;;;4,0;;;;;;;;;;;;;;;;;;;;;;;;;;;;;;;;;;;;;;;;;;;;;;;;;;;;;;;;;;;;;;;;;;
wheel;;6,0;;;;13,0;;12,0;;14,0;3,0;;20,0;;15,0;41,0;;;;;;3,0;;5,0;;;5,0;1,0;;;;;7,0;;3,0;;;;;6,0;15,0;;4,0;;8,0;;5,0;9,0;3,0;11,0;11,0;5,0;;;21,0;5,0;6,0;;5,0;;12,0;;;;13,0;;1,0;2,0;2,0;8,0;;;3,0;;;2,0;;;2,0;9,0;;2,0;;27,0;;;;;1,0;;3,0;;;;7,0;;;;8,0;22,0;;;;6,0;;;2,0;1,0;;2,0;;;8,0;;;65,0;34,0;29,0;2,0;7,0;;;1,0;1,0;4,0;1,0;;;;1,0;;;2,0;;;;12,0;;;;1,0;;;19,0;;;;14,0;5,0;;;;;1,0;;;19,0;;;;;;13,0;;2,0;;;;;;;;;4,0;1,0;6,0;150,0;;;;;1,0;;;;;;2,0;;;;;2,0;14,0;;;;1,0;;4,0;;;;44,0;;;15,0;;;;;;5,0;;2,0;;;;;;3,0;;17,0;;;;;;4,0;;12,0;;;26,0;1,0;1,0;29,0;1,0;;30,0;;;;;;;;;;4,0;4,0;;;;;;4,0;;;;;;;3,0;;;1,0;;;;2,0;;18,0;;;3,0;;5,0;;14,0;1,0;;2,0;;;;;;;;47,0;;;;;;;;;2,0;6,0;16,0;19,0;;;;;;1,0;;;;;;;;;;;6,0;;;;1,0;3,0;;11,0;1,0;;;8,0;;;;;;8,0;5,0;1,0;;;2,0;2,0;;;21,0;3,0;18,0;2,0;;;6,0;;;;9,0;6,0;1,0;2,0;;;;2,0;3,0;3,0;1,0;;3,0;1,0;;;;;;;3,0;;7,0;15,0;14,0;1,0;2,0;1,0;3,0;;3,0;;;;40,0;1,0;;;2,0;5,0;;;3,0;;;;;;2,0;;;;6,0;1,0;2,0;3,0;;;;;;;;;;;1,0;;;;;;;;6,0;;10,0;;1,0;4,0;;;1,0;2,0;;2,0;2,0;;;;;1,0;;4,0;;;;;;;1,0;;;2,0;;5,0;;;3,0;;;1,0;67,0;;18,0;;3,0;;;;;;;;;4,0;;;7,0;1,0;;;;;;;;;;;;;4,0;;;5,0;;;;;;;;1,0;;;;;;;;;;;;;5,0;;1,0;;;;3,0;;;;;3,0;;;1,0;1,0;;;;;;;;;;;;;;;;;;;;2,0;;10,0;;;;;;5,0;;;;;;;;1,0;;;7,0;;2,0;;;;;;1,0;;;;;7,0;;;;;;3,0;;;;2,0;1,0;9,0;;;;;;;1,0;;;;;;;;;;;;;;;3,0;;;;;;1,0;1,0;;5,0;;;;;;5,0;;;;;;;;;;;;;;;;7,0;;6,0;;;;15,0;3,0;;;4,0;;1,0;;;;;1,0;;;;;;;;;2,0;5,0;;;;;1,0;;;;;3,0;;7,0;;;1,0;;;;6,0;3,0;;4,0;;7,0;;3,0;;;;;;;2,0;;;;49,0;;;;8,0;;1,0;1,0;;;;;;;;;;;7,0;;;;;;;;;;;;;;3,0;;;;;;;;;;;;;;;;;;1,0;;;;;;;;;;;;;;1,0;;;1,0;;;;;;;1,0;;4,0;;;;;;;;;1,0;;;;2,0;1,0;;;;;;;;8,0;;;;;;;;1,0;;;;;;;;;;;;;;;;4,0;;;;;;;;;;;;;;;;;;;;;5,0;;;;2,0;;;;;;;;;2,0;;18,0;;;2,0;1,0;6,0;;;;;;;;;;;;;;;;;;;;;;;;;;;;;;;;;;1,0;;3,0;;;2,0;;6,0;;;;1,0;4,0;;;;;;;;;2,0;;;;1,0;;;3,0;;;8,0;;;;2,0;;;;;;;;;;;;;;4,0;;;;;;;1,0;;;;;;;;2,0;;;;;;2,0;;1,0;;;;;;;;;;;;;
width;;3,0;;;;10,0;6,0;5,0;70,0;;11,0;;8,0;;10,0;26,0;6,0;;;;1,0;3,0;;21,0;1,0;2,0;7,0;;;;;8,0;10,0;8,0;5,0;7,0;;10,0;;;5,0;10,0;24,0;22,0;2,0;2,0;49,0;39,0;5,0;10,0;11,0;30,0;;11,0;6,0;6,0;12,0;3,0;;;21,0;;9,0;;12,0;4,0;32,0;15,0;9,0;5,0;9,0;;7,0;;;;;8,0;4,0;107,0;;16,0;;28,0;16,0;;;;1,0;78,0;41,0;;;4,0;4,0;;1,0;;25,0;6,0;1,0;26,0;12,0;25,0;;6,0;11,0;10,0;;10,0;1,0;9,0;2,0;;1,0;15,0;76,0;19,0;11,0;38,0;;;9,0;2,0;9,0;;;;;29,0;1,0;6,0;49,0;;16,0;1,0;3,0;1,0;;1,0;29,0;;;53,0;13,0;;;29,0;20,0;3,0;3,0;3,0;2,0;5,0;1,0;3,0;24,0;;;30,0;;;45,0;;5,0;;1,0;23,0;;9,0;3,0;;;2,0;2,0;;5,0;;;6,0;2,0;6,0;;2,0;;7,0;;3,0;;;;;;5,0;1,0;3,0;;;;6,0;2,0;;3,0;129,0;;4,0;;3,0;;11,0;7,0;1,0;4,0;20,0;;;16,0;;59,0;;7,0;;51,0;;;23,0;17,0;;28,0;;11,0;;;5,0;;5,0;38,0;95,0;;72,0;4,0;;;4,0;;;1,0;;32,0;1,0;7,0;;2,0;;;64,0;12,0;;;;;3,0;1,0;14,0;2,0;;15,0;1,0;2,0;7,0;4,0;3,0;20,0;1,0;7,0;12,0;3,0;3,0;11,0;26,0;1,0;;13,0;4,0;;21,0;;1,0;;;58,0;3,0;;;9,0;;;;4,0;1,0;2,0;4,0;8,0;;;;;11,0;15,0;2,0;;11,0;;;6,0;;1,0;2,0;;1,0;;;;2,0;9,0;;1,0;;3,0;;;;;;;1,0;5,0;2,0;;;;;;;13,0;;;1,0;4,0;12,0;;15,0;;;1,0;;;6,0;3,0;;;;;18,0;6,0;;1,0;2,0;16,0;;1,0;;;;1,0;4,0;99,0;;1,0;1,0;7,0;2,0;4,0;;;4,0;4,0;2,0;;15,0;4,0;14,0;1,0;1,0;;;3,0;;6,0;1,0;;;;8,0;;;13,0;;;7,0;14,0;9,0;6,0;;2,0;9,0;;1,0;;;;;;46,0;2,0;;4,0;;;;;7,0;2,0;;;;;5,0;7,0;6,0;1,0;;6,0;;;;1,0;;5,0;2,0;1,0;4,0;4,0;2,0;1,0;14,0;;;;;1,0;;;;;;;1,0;12,0;2,0;;3,0;;2,0;7,0;;;;3,0;;10,0;4,0;;4,0;;3,0;;;;;1,0;;;;12,0;1,0;;;;;5,0;;1,0;;4,0;;2,0;;;;;19,0;;;;;;;4,0;;1,0;;;20,0;;;;1,0;;;;;1,0;2,0;;;8,0;;;;;;;33,0;;;23,0;;;7,0;;3,0;;;;1,0;;;;;;;8,0;7,0;3,0;;;;;;;;;16,0;;16,0;;1,0;;;;;;;1,0;;;;8,0;;;;;;;;;1,0;1,0;;8,0;;;;6,0;;;;;;;;3,0;;;;;;;;;;;;;;29,0;;;;2,0;;;3,0;;;;4,0;;;;;1,0;;;;;1,0;5,0;;4,0;;1,0;4,0;7,0;;;7,0;5,0;4,0;;;;;1,0;1,0;3,0;1,0;;;;;1,0;;;;;1,0;3,0;;4,0;3,0;4,0;;;11,0;2,0;;;;;2,0;;;;9,0;1,0;;3,0;2,0;;2,0;1,0;;;;;4,0;;;;;;;;;;;;;;;;;;6,0;3,0;3,0;;1,0;;;57,0;;3,0;;;;11,0;3,0;;;;;;;;2,0;;18,0;;;;;;;;;2,0;;;2,0;;;;1,0;;;;;11,0;20,0;;;3,0;;;;;29,0;2,0;2,0;;;1,0;2,0;4,0;;9,0;1,0;;;12,0;;;1,0;;;6,0;2,0;6,0;;2,0;;;;1,0;;;;14,0;;;;1,0;;;;2,0;;;;1,0;;;;;;2,0;;;;;;2,0;;;;;;1,0;;;;;;;;;2,0;;;;;;;;11,0;4,0;;;;;;;;;;;;;;;;;;;;;;;;3,0;;;;;;;;;;;;;;;;;;;;1,0;;;;;;;;;;;2,0;;;3,0;;;;;;;;;;;;;4,0;;1,0;;;;;;;;;;;;;;;;3,0;;1,0;;1,0;;11,0;;2,0;2,0;;;;;;4,0;11,0;;;;;;;;4,0;14,0;1,0;;3,0;;9,0;;2,0;1,0;;;;4,0;;;;;;;;1,0;10,0;7,0;;;;;
window;;1,0;2,0;;;7,0;26,0;14,0;31,0;13,0;20,0;;8,0;;14,0;60,0;4,0;3,0;;;;11,0;2,0;;;;8,0;3,0;;;2,0;3,0;22,0;16,0;6,0;1,0;1,0;;9,0;1,0;24,0;;22,0;9,0;14,0;70,0;97,0;40,0;9,0;31,0;30,0;10,0;;;3,0;26,0;9,0;1,0;10,0;;7,0;3,0;27,0;;9,0;2,0;16,0;40,0;38,0;42,0;7,0;;24,0;;6,0;;17,0;;9,0;193,0;3,0;64,0;1,0;72,0;;;;;3,0;1,0;60,0;1,0;;7,0;;2,0;1,0;;56,0;;;;34,0;36,0;1,0;;79,0;1,0;7,0;4,0;13,0;8,0;2,0;;;82,0;58,0;62,0;;3,0;;6,0;;21,0;2,0;;;;15,0;1,0;;45,0;5,0;;12,0;5,0;3,0;11,0;;;2,0;3,0;;53,0;8,0;;;41,0;10,0;63,0;9,0;;1,0;9,0;1,0;;50,0;;1,0;;5,0;2,0;31,0;;1,0;;6,0;37,0;;;17,0;;10,0;22,0;4,0;20,0;49,0;;6,0;;7,0;6,0;2,0;9,0;1,0;6,0;1,0;12,0;;1,0;;;3,0;20,0;3,0;6,0;;;;76,0;4,0;;;32,0;4,0;;4,0;;;37,0;2,0;12,0;2,0;;40,0;;;5,0;;24,0;76,0;;10,0;6,0;;8,0;12,0;;31,0;;41,0;9,0;5,0;24,0;2,0;2,0;9,0;40,0;15,0;10,0;2,0;12,0;1,0;;;;;;104,0;6,0;9,0;1,0;;;;;21,0;2,0;1,0;;;1,0;20,0;20,0;;;15,0;1,0;4,0;1,0;2,0;3,0;4,0;2,0;;;;20,0;4,0;48,0;;;;2,0;1,0;8,0;10,0;5,0;;121,0;52,0;4,0;;;22,0;1,0;11,0;18,0;;2,0;;;9,0;;;;2,0;2,0;2,0;8,0;1,0;8,0;;;14,0;;;;;7,0;;;4,0;2,0;1,0;;8,0;;4,0;;;4,0;;;;;;13,0;;2,0;;8,0;3,0;8,0;;2,0;;2,0;20,0;;3,0;4,0;;;;;1,0;68,0;7,0;4,0;2,0;40,0;1,0;2,0;2,0;;;25,0;2,0;;7,0;;;1,0;;;5,0;1,0;8,0;3,0;1,0;;;;2,0;2,0;16,0;;;8,0;11,0;6,0;;;;3,0;;6,0;;2,0;;;9,0;1,0;;;;3,0;1,0;18,0;;6,0;6,0;;4,0;;1,0;;;;2,0;;8,0;;;;;123,0;30,0;;;33,0;1,0;;19,0;;9,0;;;;;5,0;7,0;;;3,0;2,0;;3,0;;;;;;;4,0;1,0;;;5,0;1,0;;;;;;;;7,0;1,0;;1,0;1,0;;6,0;;16,0;;;;22,0;31,0;3,0;35,0;4,0;;4,0;;;;3,0;12,0;1,0;;6,0;2,0;;;9,0;1,0;2,0;;;1,0;;1,0;1,0;4,0;;;;6,0;1,0;;1,0;;1,0;;;;2,0;;;1,0;;1,0;;;;;;7,0;2,0;;;;;18,0;;;;;;1,0;2,0;1,0;;;;;;;1,0;;1,0;3,0;;;3,0;1,0;;5,0;;1,0;6,0;;3,0;2,0;;7,0;;;12,0;7,0;;;1,0;4,0;1,0;1,0;13,0;4,0;;;6,0;;;;1,0;;1,0;;;7,0;11,0;;;5,0;10,0;;14,0;;;;;3,0;;5,0;;;3,0;3,0;;;1,0;;;11,0;;1,0;;1,0;;;;;73,0;;2,0;;;;;;;;1,0;2,0;;;2,0;;6,0;;;;;;;;;;;4,0;1,0;4,0;3,0;1,0;3,0;;;;;6,0;;;;;;;2,0;4,0;6,0;1,0;;1,0;;;9,0;;;;3,0;;;5,0;;;1,0;1,0;;1,0;;2,0;;2,0;1,0;6,0;4,0;;;;1,0;;;;1,0;5,0;;;;;;12,0;;;;;;;;;;;;;;;;4,0;21,0;;;;3,0;;1,0;1,0;;;;;;;1,0;;;5,0;2,0;;2,0;1,0;5,0;23,0;;;;;;1,0;;;;;13,0;;12,0;;;;;1,0;2,0;;;;1,0;3,0;3,0;8,0;;;;;;7,0;8,0;15,0;;2,0;;3,0;;;;;;;12,0;;13,0;;;2,0;;;;;;;9,0;1,0;;3,0;;;;;;9,0;1,0;;1,0;;;;3,0;;;;11,0;3,0;;1,0;;;3,0;2,0;;;;;1,0;;1,0;;;;;;;;;;;;;;9,0;;3,0;;;;;;;;;;1,0;;;;;;;1,0;;;;11,0;;;;;;;;;;;;;;;8,0;;1,0;;2,0;;1,0;1,0;2,0;;;1,0;1,0;4,0;;;;;;;;3,0;;5,0;;;;3,0;;;;;2,0;;2,0;;9,0;;;;;;;1,0;23,0;;;;;;1,0;;1,0;2,0;;3,0;;;1,0;;;;;;1,0;;5,0;;2,0;;;;;;;;26,0;1,0;;;6,0;;;3,0;;;;;;;1,0;;;;;3,0;;1,0;;;;;;
windshield;;31,0;;;;12,0;32,0;2,0;16,0;8,0;;;;;9,0;2,0;3,0;;;;;2,0;;;;;;;;;;;13,0;;;;;;;;2,0;;4,0;;11,0;1,0;1,0;;;2,0;7,0;;;;;3,0;13,0;;;;2,0;1,0;9,0;;;;;2,0;;6,0;;;;;;;;;;17,0;;2,0;;11,0;;;;;;;3,0;;;;;;;;8,0;;;;16,0;;;;10,0;;;;5,0;;;;;;73,0;;;;1,0;;;3,0;;;;;;;;;2,0;;;;;;;;1,0;;;13,0;;;;4,0;1,0;1,0;;;;;;;26,0;;;1,0;;1,0;;;;1,0;1,0;61,0;;;;45,0;2,0;;;;40,0;;;;2,0;1,0;;;;;;7,0;;;;;;;;13,0;;;;17,0;;;;2,0;;;;;;27,0;;;;;1,0;;;;;;32,0;;17,0;;;78,0;34,0;;24,0;;6,0;;41,0;74,0;;;;16,0;;;2,0;;23,0;;;;;;;;6,0;;;;;;15,0;;;;3,0;;;;;;1,0;2,0;;;;;4,0;;;;;28,0;;116,0;;;;;;;;;;;268,0;;;;3,0;;;;;;;;36,0;;1,0;1,0;8,0;;;;;9,0;;;1,0;;;;;2,0;;10,0;;;;;;;;;;;;;;;;;2,0;;;2,0;;1,0;;;;;7,0;;4,0;2,0;;;;3,0;;;;;;2,0;;;;;;1,0;;;;;;;;;;;;;;;;;;;;;;3,0;;;;;;;;;18,0;;;;;6,0;;;;5,0;;;;;;;;;;;;;;;;;;;;;;;;;;;;;;;;;;;;;;1,0;;1,0;;;;;;;;1,0;;;;;;;;;;;;;;;;;;;;;;;;;1,0;1,0;;;;;;;;;;;;;;5,0;;;;;1,0;;;;;;;7,0;;;;;;;;;;;;;;;;4,0;;;;;;2,0;;1,0;;;;;;;;;;;;;;;;;;;;;;;;;;;4,0;8,0;;;;;2,0;;;;;;;;;;;;;;;;4,0;;;;;;;;;;;;;16,0;1,0;;;;;;6,0;;;;;;;;;;;;;;;;;;;;;;;;;;1,0;;;;;;;1,0;;;;1,0;;;;;;;;;;;;;1,0;;;;;9,0;;;;;;;4,0;;;;;8,0;;;1,0;;;;19,0;;;;;;;;;;;;;2,0;1,0;;;1,0;;;;5,0;;;;2,0;35,0;;;;;;;;;1,0;;;;2,0;;;;;;;;;;;;;;;3,0;;;;;;1,0;;;;;;;;;;;;;;;;;;;;;;;;;;;;;;;;;;;;;;;;;;;;;;;;;;;;;;;;;;;;;;;;;;1,0;;;;;;;;;;;;;;;;1,0;;;;;;;1,0;;;;;;;;;;;;;;;;;;;2,0;;;;;;;;;;;;;;;;;;;;;;;;;;;;;;;;;;;;;;;;;;;;;;;;;;;;;;;;;;;;;;;;;;;;;;;;;;;;;;;;;;;;;;;;;;;;;;;;;;4,0;;;;;;;;;;;;;;;;;;;;;;;;;;;;;;;;;;;;;;;;;;;;;;;;;;;;;;;;;;;
wire;;4,0;;;;3,0;2,0;34,0;9,0;64,0;;;;;19,0;18,0;9,0;;;;;4,0;;14,0;1,0;;3,0;2,0;5,0;;;;39,0;;31,0;9,0;2,0;3,0;3,0;;15,0;;6,0;;5,0;;2,0;59,0;5,0;1,0;48,0;1,0;;1,0;33,0;1,0;27,0;;;;68,0;8,0;5,0;1,0;2,0;1,0;5,0;110,0;13,0;17,0;3,0;;4,0;;;71,0;;;;37,0;6,0;23,0;;61,0;2,0;;1,0;;;22,0;74,0;;;10,0;;;28,0;;22,0;2,0;;;113,0;6,0;;;20,0;2,0;8,0;;36,0;1,0;14,0;3,0;;109,0;138,0;34,0;48,0;3,0;7,0;;2,0;2,0;3,0;;;;;;;;3,0;3,0;;;25,0;1,0;;;;1,0;3,0;30,0;;2,0;2,0;42,0;76,0;;;4,0;1,0;;4,0;70,0;9,0;;1,0;25,0;;12,0;88,0;;;;11,0;6,0;1,0;;;17,0;10,0;12,0;7,0;21,0;16,0;8,0;;;99,0;20,0;77,0;9,0;7,0;48,0;2,0;16,0;2,0;;;;6,0;294,0;2,0;27,0;;;;29,0;1,0;;;39,0;4,0;21,0;1,0;;;22,0;29,0;;1,0;3,0;3,0;;15,0;1,0;;65,0;20,0;5,0;9,0;11,0;;1,0;222,0;;21,0;;72,0;17,0;;37,0;12,0;4,0;4,0;40,0;5,0;24,0;7,0;5,0;;;;;8,0;;59,0;5,0;29,0;;;;;;22,0;;1,0;;12,0;6,0;3,0;4,0;50,0;4,0;31,0;;15,0;;2,0;14,0;11,0;8,0;;123,0;;23,0;121,0;100,0;;;43,0;1,0;;2,0;;4,0;;1,0;5,0;24,0;3,0;;3,0;;;;;1,0;15,0;8,0;11,0;1,0;1,0;;5,0;3,0;8,0;2,0;4,0;1,0;13,0;1,0;;;2,0;10,0;;18,0;4,0;4,0;1,0;11,0;32,0;;3,0;;;;1,0;7,0;;;;4,0;22,0;3,0;33,0;44,0;;;21,0;3,0;;27,0;3,0;1,0;13,0;38,0;8,0;7,0;;7,0;;9,0;;11,0;;;;4,0;;4,0;;;;6,0;9,0;;;;;;;2,0;;;;3,0;4,0;;2,0;1,0;;;;;;16,0;7,0;;1,0;6,0;;9,0;;4,0;;;;;;1,0;;;;;;;;;;;;2,0;;;;;;;2,0;;;;1,0;;;;;3,0;;;6,0;;;;;;1,0;;5,0;;;;;;;;;;;;;;1,0;;;;1,0;;1,0;;;;;;;;;;;;4,0;;;;10,0;;1,0;7,0;;7,0;;;;;7,0;1,0;;;;;;;;;14,0;;1,0;;;;;;;;;;;;;;;;;6,0;;1,0;;;1,0;;;;;25,0;;3,0;;;;74,0;;;;;;;;2,0;;;;;;;;;;;;;;1,0;1,0;;1,0;3,0;;;;;1,0;;7,0;4,0;4,0;;;;;4,0;15,0;;;1,0;;;;;;2,0;;;;;;;;;;6,0;2,0;;1,0;3,0;;;19,0;1,0;;;;;4,0;;;;;;13,0;1,0;3,0;;;;;;1,0;;;;;;34,0;;;;;;;2,0;2,0;;3,0;;;;;11,0;2,0;;;;;14,0;;3,0;;17,0;;5,0;;;;;1,0;;;;;;11,0;4,0;3,0;;;;16,0;;;;1,0;;;1,0;27,0;;12,0;;;;4,0;3,0;;3,0;;6,0;;;;;;;;7,0;32,0;1,0;;;;;;;3,0;;;;;2,0;;17,0;;;;3,0;;1,0;14,0;3,0;1,0;;;53,0;59,0;2,0;;3,0;;;1,0;;;;4,0;9,0;2,0;;;48,0;1,0;;;;;2,0;5,0;;5,0;;;;11,0;;;;4,0;1,0;2,0;;;;;;;22,0;4,0;;2,0;63,0;;;2,0;;;5,0;5,0;5,0;;;4,0;;5,0;;;;;;;2,0;13,0;;;6,0;1,0;;;3,0;;;1,0;;;;;1,0;;;;;;;;1,0;;;;;;;;;;3,0;;;;;;;2,0;;;;;;;;;;;;;;;;;1,0;;;;;1,0;;;;;;1,0;;1,0;;;;;;;1,0;6,0;;;;;;;26,0;;;8,0;;;5,0;2,0;;;;;;;;;;;1,0;;;3,0;1,0;1,0;;;;;;;1,0;2,0;;;;7,0;3,0;;;2,0;;;;;1,0;;;;3,0;;2,0;;;;;;1,0;;;;3,0;;;;;6,0;;;75,0;;;;1,0;;;;;;;;;;;;;;;;;;;;;15,0;;;1,0;;;;;;;;;;;1,0;1,0;;;;;;;3,0;;;;;;;
wireless;;3,0;;;;;;41,0;8,0;3,0;4,0;;43,0;3,0;7,0;59,0;;;;;;41,0;;65,0;;;1,0;11,0;;;10,0;;182,0;;148,0;115,0;;;1,0;;186,0;;4,0;;10,0;6,0;57,0;872,0;116,0;43,0;10,0;1,0;;;;;9,0;;;3,0;1,0;26,0;2,0;3,0;1,0;1,0;1,0;;15,0;;7,0;;19,0;;;1,0;18,0;2,0;;151,0;2,0;5,0;7,0;114,0;;31,0;5,0;;;4,0;11,0;14,0;;;2,0;3,0;18,0;;130,0;61,0;;;144,0;18,0;;18,0;4,0;;369,0;11,0;2,0;27,0;1,0;;;22,0;13,0;23,0;63,0;10,0;1,0;;1,0;28,0;31,0;8,0;;;;14,0;48,0;3,0;4,0;;1,0;1,0;3,0;35,0;;;7,0;22,0;38,0;37,0;13,0;;;;178,0;2,0;3,0;;20,0;27,0;;6,0;268,0;;;52,0;3,0;151,0;149,0;;;;93,0;6,0;;;1,0;;;;;1,0;6,0;;2,0;;6,0;13,0;;;1,0;14,0;;83,0;;;2,0;;;46,0;;1,0;62,0;;1,0;;;;4,0;6,0;;;1,0;17,0;3,0;;;;;;;1,0;;;1,0;;12,0;;;;1,0;;1,0;;11,0;;;;;5,0;3,0;;;1,0;;1,0;3,0;3,0;4,0;2,0;;;;8,0;;1,0;;;;;;;177,0;;;;;;32,0;171,0;;;;;1,0;;;6,0;;;1,0;;;2,0;;;8,0;3,0;30,0;;;19,0;12,0;3,0;;;2,0;;;;;;;;17,0;;1,0;7,0;;;1,0;;;;;;23,0;;1,0;;;;;17,0;;22,0;;4,0;;;3,0;1,0;;;;1,0;;;;;;131,0;;;;;;;;6,0;5,0;68,0;;1,0;;;;;6,0;;;2,0;5,0;55,0;19,0;;;;;;;;;;;;;;;2,0;6,0;;2,0;1,0;2,0;;;;3,0;3,0;;;;;;11,0;;1,0;;2,0;;82,0;;;;;;;70,0;4,0;;;;;6,0;;6,0;4,0;4,0;;6,0;1,0;;;1,0;;;;5,0;12,0;;;2,0;1,0;;1,0;;15,0;7,0;;36,0;;;;49,0;7,0;21,0;8,0;;;211,0;133,0;24,0;;2,0;1,0;;;;;;40,0;47,0;1,0;;17,0;2,0;3,0;2,0;;;;10,0;;1,0;1,0;;;2,0;2,0;58,0;16,0;;;;;4,0;;1,0;;4,0;;;;1,0;;;7,0;8,0;9,0;;;14,0;4,0;123,0;;2,0;8,0;99,0;5,0;3,0;;;;;;;16,0;;117,0;6,0;;2,0;53,0;;;;9,0;22,0;;1,0;;11,0;9,0;;15,0;2,0;3,0;16,0;234,0;;1,0;9,0;;1,0;2,0;1,0;;2,0;1,0;2,0;5,0;;19,0;;34,0;7,0;;;1,0;;1,0;;16,0;;1,0;2,0;3,0;8,0;;;29,0;62,0;722,0;148,0;;;5,0;2,0;;;22,0;;;;;;5,0;;;20,0;;16,0;;4,0;2,0;6,0;9,0;;;1,0;;12,0;1,0;;;12,0;6,0;1,0;8,0;;3,0;4,0;;14,0;;1,0;;;;3,0;4,0;4,0;3,0;52,0;;;6,0;;1,0;;;;;;;;;;3,0;17,0;18,0;5,0;;14,0;72,0;4,0;;2,0;4,0;;;;;;4,0;1,0;;;1,0;3,0;;6,0;2,0;;;2,0;16,0;;;;;;;;;;8,0;2,0;;2,0;;;;;;;;4,0;;;;;3,0;;;;;;;;;;;;;;;24,0;;;;2,0;;;;5,0;;;;;2,0;3,0;;1,0;;;;;;2,0;;;;;;2,0;5,0;;1,0;5,0;;4,0;;;;11,0;;;3,0;;;;;1,0;;2,0;1,0;;;;;;;;;;;;;;1,0;;;;9,0;;;;;;;1,0;;;;1,0;1,0;;2,0;;;;;41,0;3,0;;;;;;;;;;;3,0;;;;4,0;;;;;12,0;;;;2,0;;2,0;;;;;;;;;5,0;;1,0;;;;;;;;;;;1,0;;;;3,0;4,0;;;;1,0;;;;;1,0;5,0;;;3,0;4,0;;;;;;;;;;;;;;;;1,0;;;;4,0;;;;;;;116,0;2,0;;;;4,0;;;;1,0;;;;;;;54,0;;;1,0;2,0;;;;;;;;;;;;;;;;;2,0;;;;;9,0;;;;;;;7,0;1,0;;;;;3,0;;;;;;;;;;;;;;;;;;;15,0;;;;;;;2,0;;;2,0;;;;;;;;;;;;;;;;;;3,0;;;2,0;;;;5,0;10,0;;;;;;
access;;;5,0;;;;;82,0;13,0;1,0;5,0;;53,0;1,0;;19,0;;2,0;;;;20,0;;3,0;;;6,0;;;;23,0;;67,0;;43,0;7,0;;2,0;;;96,0;;7,0;1,0;10,0;;15,0;294,0;18,0;19,0;;;;;3,0;;18,0;;;1,0;;50,0;;6,0;1,0;;3,0;2,0;17,0;1,0;6,0;;22,0;;;2,0;46,0;;;156,0;;23,0;;70,0;;15,0;;;;;7,0;;;;;12,0;40,0;6,0;45,0;14,0;1,0;;9,0;25,0;;7,0;1,0;7,0;9,0;;;35,0;;;;59,0;16,0;15,0;;;3,0;;1,0;22,0;35,0;3,0;;;;;1,0;;;1,0;3,0;5,0;1,0;37,0;;;4,0;4,0;16,0;;6,0;1,0;;4,0;5,0;2,0;1,0;1,0;22,0;40,0;1,0;;43,0;;;3,0;1,0;4,0;34,0;;;;30,0;2,0;2,0;;;;;9,0;1,0;;;;1,0;;;3,0;;3,0;;2,0;;2,0;;;4,0;;;12,0;;;19,0;;;3,0;;;;;;;;3,0;3,0;;;;;;;;;;;18,0;6,0;;3,0;2,0;2,0;2,0;;;9,0;;1,0;;1,0;6,0;;;1,0;4,0;;3,0;1,0;;1,0;;;;;1,0;28,0;2,0;1,0;;;;;4,0;65,0;;;;;;4,0;13,0;;;7,0;;6,0;;;5,0;4,0;;;;;1,0;;1,0;;4,0;;;5,0;12,0;;1,0;;;2,0;;;;;;;;;;;23,0;1,0;;;;;1,0;;;2,0;12,0;;;1,0;;3,0;;;1,0;;;;;;2,0;;;;;;;;;;;;;1,0;;;;2,0;1,0;;3,0;2,0;1,0;3,0;;;;;;;;1,0;64,0;;;2,0;;1,0;;;;;;;;;;;3,0;13,0;;;;;;;;2,0;;;;;;1,0;;;2,0;;1,0;;4,0;;;9,0;;3,0;;;1,0;;;4,0;;;;6,0;4,0;7,0;;;;;1,0;;1,0;;;;2,0;;;;13,0;;;;9,0;41,0;;31,0;;5,0;;23,0;;2,0;3,0;;3,0;26,0;43,0;36,0;2,0;2,0;;1,0;;;;;23,0;9,0;2,0;;;;1,0;;15,0;;;2,0;;;;;;6,0;;78,0;1,0;;;;;;;1,0;;;2,0;;;1,0;;;2,0;;16,0;;;;;12,0;;9,0;2,0;1,0;;7,0;;;;12,0;;;;;17,0;3,0;;1,0;3,0;;;8,0;;;;;10,0;2,0;;;;11,0;;2,0;7,0;;;9,0;;;;1,0;;;;;;;22,0;;2,0;1,0;;;14,0;10,0;12,0;1,0;2,0;1,0;2,0;1,0;1,0;1,0;10,0;4,0;22,0;6,0;20,0;1,0;1,0;1,0;6,0;2,0;7,0;1,0;21,0;1,0;2,0;1,0;4,0;2,0;1,0;1,0;4,0;9,0;2,0;22,0;2,0;4,0;1,0;13,0;31,0;2,0;1,0;1,0;2,0;18,0;2,0;1,0;1,0;28,0;11,0;17,0;10,0;4,0;5,0;4,0;6,0;3,0;1,0;4,0;7,0;2,0;1,0;11,0;1,0;1,0;1,0;2,0;1,0;1,0;1,0;1,0;1,0;1,0;1,0;19,0;2,0;1,0;4,0;10,0;2,0;1,0;1,0;25,0;2,0;8,0;2,0;3,0;5,0;1,0;3,0;2,0;2,0;2,0;1,0;2,0;3,0;4,0;2,0;1,0;70,0;3,0;;;;;;;;;;;;;;;;;;;;;;;;;;;;;;;;;;;;;;;;;;;;;;;;;;;;;;;;;;;;;;;;;;;;;;;;;;;;;;;;;;;;;;;;;;;;;;;;;;;;;;;;;;;;;;;;;;;;;;;;;;;;;;;;;;;;;;;;;;;;;;;;;;;;;;;;;;;;;;;;;;;;;;;;;;;;;;;;;;;;;;;;;;;;;;;;;;;;;;;;;;;;;;;;;;;;;;;;;;;;;;;;;;;;;;;;;;;;;;;;;;;;;;;;;;;;;;;;;;;;;;;;;;;;;;;;;;;;;;;;;;;;;;;;;;;;;;;;;;;;;;;;;;;;;;;;;;;;;;;;;;;;;;;;;;;;;;;;;;;;;;;;;;;
adjustment;;;1,0;;;41,0;25,0;35,0;36,0;22,0;;;3,0;;4,0;110,0;1,0;;17,0;5,0;30,0;34,0;18,0;1,0;4,0;12,0;65,0;4,0;2,0;4,0;1,0;13,0;69,0;3,0;119,0;6,0;16,0;19,0;;;63,0;2,0;14,0;1,0;42,0;16,0;147,0;126,0;24,0;67,0;16,0;34,0;;1,0;4,0;3,0;34,0;1,0;1,0;1,0;9,0;2,0;7,0;2,0;4,0;46,0;193,0;22,0;17,0;4,0;38,0;6,0;41,0;;;64,0;11,0;;6,0;338,0;;36,0;2,0;128,0;4,0;27,0;6,0;;;10,0;111,0;1,0;;1,0;12,0;3,0;3,0;;89,0;1,0;1,0;;61,0;33,0;;1,0;33,0;4,0;19,0;238,0;4,0;135,0;1,0;1,0;1,0;110,0;11,0;108,0;80,0;53,0;3,0;;11,0;102,0;31,0;2,0;2,0;;;15,0;;22,0;24,0;;2,0;13,0;19,0;17,0;16,0;1,0;6,0;;2,0;15,0;63,0;4,0;;5,0;167,0;10,0;4,0;;11,0;13,0;18,0;18,0;134,0;;14,0;1,0;3,0;19,0;269,0;3,0;5,0;;20,0;26,0;;;35,0;;;7,0;131,0;56,0;30,0;11,0;;;8,0;23,0;2,0;;1,0;46,0;;28,0;2,0;;;3,0;;14,0;15,0;1,0;1,0;3,0;1,0;2,0;1,0;6,0;8,0;52,0;16,0;3,0;1,0;;49,0;6,0;;;3,0;5,0;;;9,0;;14,0;13,0;40,0;;;;;9,0;;;33,0;1,0;40,0;;35,0;74,0;12,0;20,0;13,0;;6,0;2,0;16,0;3,0;10,0;5,0;6,0;;;;20,0;2,0;10,0;;2,0;;;3,0;23,0;;1,0;;;;1,0;23,0;3,0;;6,0;;;;3,0;11,0;4,0;1,0;;1,0;32,0;7,0;;13,0;27,0;5,0;8,0;;;100,0;;7,0;;;15,0;9,0;1,0;;;;13,0;4,0;;;6,0;26,0;8,0;5,0;2,0;;;4,0;;7,0;;2,0;;;2,0;5,0;;;;;;;1,0;;10,0;;10,0;;;1,0;2,0;;3,0;;10,0;4,0;1,0;2,0;1,0;9,0;;1,0;1,0;8,0;1,0;2,0;6,0;3,0;6,0;3,0;;1,0;7,0;11,0;;2,0;;27,0;;9,0;;;;;1,0;;2,0;4,0;2,0;;;;;12,0;;2,0;7,0;2,0;8,0;47,0;26,0;1,0;3,0;3,0;;14,0;;;;19,0;2,0;16,0;5,0;;7,0;5,0;1,0;20,0;1,0;;;;;9,0;;;5,0;9,0;2,0;109,0;15,0;1,0;2,0;;2,0;;8,0;2,0;;;;4,0;7,0;20,0;;30,0;;16,0;;;;39,0;8,0;1,0;18,0;;5,0;9,0;59,0;;;1,0;7,0;;2,0;4,0;36,0;6,0;4,0;6,0;10,0;3,0;2,0;7,0;;5,0;5,0;1,0;1,0;;;;;1,0;1,0;2,0;;3,0;29,0;;;;;28,0;26,0;4,0;11,0;9,0;6,0;3,0;214,0;2,0;;22,0;31,0;15,0;;;;5,0;;;1,0;18,0;11,0;;;1,0;;11,0;64,0;;;8,0;2,0;;9,0;;4,0;4,0;7,0;1,0;10,0;;;;;;8,0;2,0;4,0;;;;1,0;;1,0;1,0;;4,0;;6,0;18,0;1,0;1,0;;48,0;3,0;;;4,0;2,0;1,0;;3,0;;2,0;4,0;;3,0;2,0;;;3,0;;43,0;6,0;;3,0;3,0;;10,0;;6,0;3,0;17,0;5,0;10,0;;3,0;9,0;;;;;20,0;1,0;1,0;1,0;;2,0;;;1,0;17,0;23,0;;;9,0;;;;3,0;3,0;2,0;;;;;;3,0;;;;3,0;2,0;;1,0;;2,0;10,0;;4,0;;;;;;;;;;;;;2,0;6,0;3,0;;2,0;3,0;;;6,0;1,0;;1,0;15,0;2,0;;2,0;;;2,0;;;;;2,0;;;;;8,0;17,0;4,0;64,0;3,0;;;3,0;9,0;;1,0;10,0;;;;;;;;;;1,0;;1,0;;2,0;1,0;;;;;;3,0;3,0;4,0;7,0;;1,0;5,0;;;;;;;;;10,0;;1,0;3,0;;4,0;15,0;8,0;;;1,0;;;2,0;1,0;5,0;;;;;;10,0;;;1,0;4,0;;;3,0;8,0;1,0;;5,0;1,0;2,0;;2,0;;13,0;;;;;;2,0;;;2,0;2,0;;;;;1,0;;3,0;;;;;;3,0;;;;36,0;;;;1,0;;;2,0;4,0;;;5,0;;8,0;1,0;;1,0;;;;1,0;8,0;;;4,0;;;;6,0;9,0;;;;17,0;6,0;7,0;117,0;;10,0;;1,0;4,0;5,0;2,0;1,0;;1,0;;63,0;;;2,0;;;;;2,0;4,0;37,0;110,0;;;10,0;2,0;;;14,0;1,0;1,0;;1,0;;;;1,0;;;;;;;1,0;11,0;;6,0;;;;;14,0;;3,0;;;1,0;18,0;;;;;;;;;;;1,0;14,0;7,0;2,0;;1,0;;;;;;;9,0;2,0;;;;;;3,0;;7,0;;;;;;19,0;;;;6,0;3,0;1,0;1,0;;;1,0;3,0;2,0;;;;2,0;1,0;69,0;1,0;;;;;;5,0;;2,0;;4,0;2,0;;1,0;;2,0;;;;;1,0;;;;;;;1,0;;;;;;;1,0;;1,0;;;;1,0;;;1,0;;;;;53,0;;;;;;3,0;;;;;;;2,0;3,0;1,0;8,0;;6,0;;;;23,0;;;;;;;;;;;;
alignment;;;11,0;;;18,0;14,0;28,0;;15,0;15,0;;1,0;;23,0;14,0;6,0;3,0;;1,0;5,0;11,0;;17,0;;;3,0;1,0;;;;;56,0;;11,0;;12,0;11,0;;;10,0;;12,0;7,0;9,0;3,0;21,0;56,0;;24,0;7,0;2,0;;1,0;3,0;9,0;18,0;24,0;23,0;1,0;4,0;1,0;16,0;;3,0;15,0;8,0;22,0;19,0;4,0;3,0;3,0;30,0;11,0;;2,0;;;3,0;180,0;6,0;2,0;3,0;47,0;;1,0;;;;;85,0;;;1,0;11,0;;3,0;;42,0;;4,0;;34,0;9,0;2,0;;44,0;3,0;35,0;12,0;1,0;22,0;;8,0;;18,0;37,0;53,0;;13,0;;;10,0;12,0;6,0;;1,0;;1,0;2,0;;3,0;14,0;3,0;22,0;5,0;18,0;5,0;8,0;;3,0;;;48,0;3,0;2,0;;1,0;6,0;;;3,0;;2,0;12,0;;24,0;;2,0;;1,0;3,0;50,0;;;;5,0;17,0;;;;;;1,0;;;20,0;;;;3,0;1,0;;;;3,0;;2,0;;;;2,0;;2,0;;;;;;;3,0;1,0;9,0;117,0;;;;1,0;;;;7,0;1,0;;;;1,0;;1,0;7,0;29,0;;;;3,0;1,0;20,0;;26,0;1,0;13,0;4,0;;24,0;;13,0;12,0;20,0;1,0;1,0;3,0;;;2,0;;;1,0;4,0;47,0;8,0;4,0;;1,0;;;1,0;15,0;3,0;;;;1,0;1,0;3,0;;;4,0;3,0;;;;;1,0;;;;;55,0;3,0;29,0;;5,0;7,0;3,0;;2,0;;3,0;1,0;1,0;19,0;4,0;;;;;;;;;3,0;17,0;2,0;11,0;;;;9,0;3,0;;;2,0;;;;1,0;;8,0;;7,0;2,0;;6,0;1,0;;;2,0;3,0;;;1,0;1,0;2,0;;;1,0;;39,0;;;;;;;;2,0;1,0;2,0;10,0;4,0;;24,0;;;;;8,0;7,0;;2,0;1,0;2,0;;11,0;6,0;;;4,0;11,0;;;;;;;8,0;5,0;;3,0;2,0;;;;;2,0;9,0;3,0;1,0;;11,0;;10,0;5,0;;;;;6,0;12,0;;;;;1,0;;;;;7,0;18,0;3,0;;1,0;2,0;6,0;1,0;;;;1,0;2,0;;8,0;2,0;;1,0;2,0;44,0;;;2,0;6,0;33,0;3,0;;;7,0;3,0;1,0;;;9,0;3,0;;;;2,0;;3,0;;;;;1,0;;1,0;3,0;;;;1,0;1,0;;;2,0;;;1,0;9,0;3,0;2,0;;;3,0;14,0;;11,0;;;;15,0;21,0;;;3,0;;;;1,0;6,0;;;;;;1,0;;;9,0;1,0;10,0;;;;;;2,0;;3,0;;6,0;5,0;10,0;;;;;;;;;1,0;3,0;17,0;;;1,0;;;1,0;;;1,0;1,0;;;4,0;;;;;4,0;;1,0;;2,0;1,0;;;2,0;;;;2,0;;;5,0;;5,0;;;;;;4,0;;;;;;1,0;;;;;8,0;;1,0;6,0;;;;;2,0;;;;;1,0;;1,0;;;;;;;;4,0;;1,0;;;;;1,0;;51,0;;;;;5,0;;3,0;;;1,0;;1,0;;3,0;10,0;;1,0;;2,0;;;6,0;;;;1,0;;;;;;;4,0;;;;1,0;;2,0;1,0;1,0;;;;;;;;;;;;;;;1,0;1,0;;4,0;7,0;;;;1,0;;3,0;;;;;2,0;;;;1,0;;;8,0;;;;4,0;1,0;;;;;1,0;1,0;;2,0;;;;3,0;1,0;;;8,0;2,0;;;;;;;;;;;;;;4,0;;2,0;;;1,0;;1,0;;;;;1,0;;;4,0;;;4,0;12,0;;;;21,0;;;;5,0;;;2,0;;1,0;;;;;;;;;;;;6,0;;;;;;;;1,0;;1,0;;1,0;15,0;1,0;;1,0;;;;1,0;;;1,0;;;5,0;;;;;;;;;4,0;;;8,0;;;;;;1,0;1,0;;;2,0;;;4,0;;;;8,0;;;4,0;;10,0;;;;;;;;;;;5,0;3,0;;;1,0;;2,0;;;;;;;;;;;5,0;4,0;;;;;;1,0;2,0;;;;;;;;;;;;;;;;;;2,0;;;;1,0;;;2,0;;;;;;;2,0;;;;;;;;;2,0;;4,0;;;;;;;;;;4,0;;8,0;;4,0;4,0;;;;;;;;;;;;;;;;;;;1,0;3,0;;;;;;1,0;;;;;;2,0;1,0;4,0;;1,0;;1,0;;;;;;;;;;;;;;;;;;;;;;4,0;;;;;;;;;;;;;1,0;;;;;;;
assist;;;1,0;;;;;18,0;1,0;;;;4,0;;;4,0;5,0;;3,0;;;6,0;;;;;2,0;;;;;;1,0;21,0;7,0;3,0;;;;;4,0;;1,0;1,0;23,0;8,0;4,0;12,0;1,0;5,0;;2,0;;;1,0;;5,0;;;;;;;;;;5,0;1,0;;;2,0;;6,0;2,0;;;3,0;;4,0;29,0;;18,0;3,0;6,0;;2,0;;;;;4,0;;;;;;;;27,0;;;;2,0;;;2,0;;3,0;1,0;;;1,0;;;;1,0;5,0;3,0;7,0;;;;;2,0;;1,0;;;;;;1,0;;;;2,0;;;;;;;;22,0;;;;;32,0;2,0;;;;5,0;7,0;;34,0;;1,0;;;1,0;7,0;;;;1,0;1,0;;;;;;;6,0;;2,0;;;;;33,0;;1,0;;;;;;;;;;2,0;;;;;;;;;;1,0;;;;;;;1,0;;;;;;;;;;3,0;;;;;;;;43,0;;;;;4,0;;1,0;8,0;;;;;;;1,0;;;;;;;;;;;;;1,0;;;;;;1,0;6,0;;;;;;;;2,0;;;;;;;;;;;;;;;;;;;37,0;;;;2,0;1,0;;;1,0;;;1,0;1,0;;;;;;;;;;;;;;1,0;1,0;;;;;;;22,0;;;1,0;;;;;;;;;;3,0;;;;;;;;;;3,0;1,0;1,0;;;;;;;;6,0;2,0;;;;;;;;;;;;;;;;;;;;;;;;;;;1,0;;;;;;;;;;;2,0;;;;;;1,0;;;;;;;;3,0;;;;;;1,0;;;;;;;;;;;;;;;1,0;;;1,0;;2,0;;9,0;;2,0;1,0;;;3,0;;3,0;3,0;3,0;;;;;;;1,0;2,0;;;;;;;;;1,0;;4,0;;1,0;2,0;;;;12,0;1,0;;;;;;1,0;;;1,0;;;1,0;;;;;1,0;;;;;;1,0;;;;;4,0;;;2,0;;;;;3,0;;;;;;;;;;;;6,0;;;;;;;;;;;;;;;;;1,0;;;;;;;;;;;5,0;;;;;;;;;;;;;;;;;1,0;;;;;;;;;;;;;;;;;;1,0;;1,0;;;;;;;2,0;;;;;;;;;;;;;;;;2,0;;;;;;;;;;;;;;;;;;;;;1,0;;;;;;;;;2,0;;;;;;;;;;;;;;;;1,0;;;;;;;;;;;;;7,0;;1,0;;5,0;;;;;;;;2,0;;;;;;;;;1,0;;;;2,0;;;;;;;;;;;;;;;3,0;;;;;;;;;;;;;;;;;;;;;;;;15,0;;;;;;;;;;;;;;;5,0;;;;;;;;;;;;;;;;;;;;;;;;;;;;;;;;;;;;;;;;;;;;4,0;;;;;5,0;38,0;;;;;1,0;;;;6,0;;;;;;;;;2,0;;;;;;;;;;;;;;;;;;;;;;;;;;;;1,0;;;;;;;;;;;2,0;;;;;;;;;;;;;;;;;;;;;;;;;;;;;;;;;;;;;;;;;;;;;;4,0;;;;;;;;;;;;;;;;1,0;;;;1,0;;;;;;;;;;;;;;;;;2,0;;;;;;;;1,0;;;;;;;1,0;;;;;;;;;;;;;;;;;;;;;;;;;;1,0;1,0;;;1,0;;1,0;4,0;;;;;;;;;;;;
audio;;;1,0;;4,0;4,0;;36,0;2,0;1,0;11,0;;39,0;1,0;;71,0;;;;;;90,0;1,0;3,0;;;5,0;4,0;;;7,0;;58,0;;22,0;3,0;;;1,0;;189,0;;;;45,0;18,0;32,0;112,0;41,0;23,0;2,0;3,0;;1,0;5,0;1,0;2,0;;2,0;;;6,0;3,0;18,0;1,0;;1,0;4,0;4,0;;4,0;;66,0;1,0;;14,0;2,0;;;129,0;;20,0;;71,0;1,0;3,0;1,0;;;;2,0;2,0;1,0;2,0;;9,0;6,0;;96,0;16,0;;1,0;40,0;10,0;;11,0;4,0;2,0;82,0;8,0;3,0;17,0;;2,0;;36,0;24,0;7,0;7,0;3,0;;;28,0;33,0;35,0;6,0;;;;28,0;;;9,0;;9,0;3,0;;7,0;3,0;;8,0;;6,0;34,0;22,0;;;3,0;214,0;;3,0;;16,0;24,0;3,0;;35,0;;;6,0;4,0;23,0;38,0;;;;131,0;19,0;;;6,0;;;;;1,0;3,0;;;;1,0;5,0;;;;3,0;;25,0;;;;13,0;;7,0;;;47,0;;;;;;;9,0;;;;46,0;;4,0;;;;;1,0;;;;;;8,0;;;;;1,0;;;7,0;;4,0;;;8,0;;;6,0;;;;;;;;;;;;;1,0;;;;;;;84,0;;;;;;1,0;28,0;;;;;;;;67,0;1,0;;2,0;1,0;;;;3,0;7,0;22,0;6,0;;;20,0;3,0;;;;16,0;;1,0;;;;;;;;;2,0;;;;2,0;;;;;;6,0;;;;15,0;;7,0;;14,0;;;;;2,0;;;;;;;;;;;50,0;3,0;1,0;;;;;;;1,0;6,0;;7,0;;4,0;;;;;;;1,0;;;;;;;;;;;;;;;;;4,0;;;;;;;;;4,0;;;;;;;3,0;1,0;4,0;;;;4,0;;;;;;;2,0;1,0;;;9,0;;;;2,0;9,0;15,0;1,0;6,0;;;;;2,0;1,0;;;;;;;;;27,0;;180,0;3,0;;44,0;1,0;6,0;;1,0;;27,0;9,0;2,0;8,0;4,0;;16,0;11,0;6,0;2,0;;;;;3,0;87,0;;22,0;;;8,0;;21,0;2,0;;;;;5,0;10,0;;;1,0;1,0;35,0;1,0;;;;2,0;9,0;1,0;;;;;;3,0;1,0;;;26,0;2,0;;3,0;;3,0;5,0;11,0;;;78,0;2,0;3,0;1,0;;;;;3,0;2,0;;;2,0;36,0;;;3,0;;7,0;;2,0;1,0;1,0;;;;2,0;;10,0;3,0;;4,0;2,0;;;3,0;2,0;2,0;;2,0;;;;;9,0;14,0;;;4,0;1,0;;;20,0;;1,0;;4,0;;;;;;16,0;;24,0;2,0;6,0;1,0;;5,0;;18,0;;3,0;1,0;2,0;3,0;;;;1,0;11,0;1,0;1,0;;;;;;1,0;7,0;;1,0;;;8,0;;1,0;;13,0;;21,0;8,0;;2,0;;;1,0;4,0;;4,0;;1,0;1,0;;;;;;;;;6,0;11,0;2,0;1,0;;1,0;;;;;6,0;3,0;;;;1,0;1,0;;;;5,0;12,0;3,0;;;1,0;11,0;1,0;11,0;;;1,0;;;;;;;;;;2,0;;;;;;;;;;;;;;;;;;3,0;1,0;;;;;;;;;;;;;;7,0;4,0;;;;4,0;;;;;;;;;;12,0;;;1,0;;;;;;;;;24,0;;;;;;;6,0;;15,0;5,0;4,0;;;;;;;;;;3,0;;;;2,0;;;;;;;;;4,0;;;;;2,0;;;;;;;;;;1,0;;;;;;;;;;;;;;15,0;;18,0;;10,0;;;;;;;1,0;;;;1,0;1,0;;;;;;3,0;;12,0;;6,0;;1,0;3,0;;;1,0;;1,0;3,0;2,0;5,0;;;;;;;;;;;;4,0;;;;;;;1,0;;1,0;;;;;;9,0;19,0;;7,0;;;;;;;;;;;;;8,0;;;1,0;4,0;3,0;;5,0;;1,0;;;;;;1,0;;;;;1,0;19,0;;;;;;;;;;;;3,0;3,0;;;7,0;;;;;;;1,0;;;;;2,0;;;;;;;1,0;;;;;;;1,0;;;;;;;;;;;;;;;;;;8,0;;;1,0;;;;;;2,0;;;;;;;;;;;;;;;;;;;;;;;;;;;;;;;12,0;;;;;;;;;;;
autofocus;;;2,0;1,0;2,0;;6,0;42,0;3,0;;;;4,0;;2,0;33,0;7,0;1,0;24,0;8,0;4,0;13,0;1,0;;;1,0;2,0;;6,0;;;1,0;6,0;5,0;111,0;16,0;;;;;6,0;;1,0;3,0;31,0;14,0;16,0;40,0;22,0;6,0;4,0;8,0;;;5,0;;4,0;1,0;2,0;;2,0;;1,0;;1,0;1,0;71,0;6,0;3,0;;20,0;1,0;27,0;;;;1,0;2,0;9,0;77,0;;7,0;6,0;11,0;;1,0;13,0;2,0;;2,0;92,0;;;;15,0;;2,0;;58,0;7,0;;1,0;52,0;8,0;;6,0;31,0;;1,0;6,0;3,0;53,0;;;;3,0;42,0;33,0;;6,0;;;5,0;2,0;11,0;3,0;;;;25,0;1,0;2,0;3,0;;1,0;1,0;1,0;2,0;;1,0;8,0;;1,0;9,0;3,0;;;2,0;74,0;;;;;4,0;11,0;;67,0;2,0;1,0;1,0;1,0;2,0;25,0;;;;;10,0;;;10,0;;;2,0;1,0;;10,0;7,0;;;;37,0;;;;3,0;2,0;;;;;;;5,0;;1,0;;;;;;1,0;;9,0;;;;;12,0;1,0;;;3,0;;;;1,0;;;;1,0;;;;;;2,0;;38,0;;7,0;;8,0;2,0;7,0;3,0;5,0;;;1,0;;3,0;7,0;13,0;;;;;2,0;;;;;4,0;;;9,0;;;;;1,0;;2,0;;;;;3,0;;;1,0;;;;;7,0;;;2,0;3,0;;3,0;;;7,0;;;3,0;;;;;;;;2,0;;3,0;;23,0;4,0;8,0;;1,0;2,0;;;;1,0;;;29,0;;;1,0;;4,0;;2,0;;;2,0;;21,0;;3,0;;;;3,0;;;;;1,0;;;;1,0;;;;2,0;;;1,0;3,0;;;;;2,0;1,0;8,0;;;3,0;;;;3,0;;7,0;;;;;;;;;2,0;;;;3,0;;3,0;;;;2,0;;;;;;;2,0;;23,0;1,0;;2,0;;;2,0;;;;;;2,0;;;;;;11,0;4,0;;1,0;;;;;2,0;;;;;4,0;;;;;7,0;;;;;;6,0;2,0;;1,0;3,0;40,0;;3,0;2,0;12,0;;;4,0;70,0;4,0;;1,0;8,0;;;1,0;2,0;1,0;;;;;;;;2,0;1,0;;;;19,0;4,0;;;10,0;;5,0;;;;;;13,0;3,0;;5,0;1,0;;;1,0;;;;;12,0;3,0;;;;;2,0;4,0;1,0;;;6,0;1,0;1,0;;;;;;;;;;;;;1,0;;1,0;7,0;4,0;6,0;;;;;1,0;2,0;;15,0;2,0;;;;2,0;;;;3,0;7,0;;;;;;1,0;;5,0;;;;;;;38,0;;;3,0;;;;8,0;;;1,0;1,0;;3,0;;;2,0;;;12,0;;;;;;;;;9,0;;;;;;;;1,0;;;;1,0;;;;;;;;;;;;;;;;;;;;;;;;;;;;1,0;;2,0;;1,0;;;;;1,0;;;2,0;;;;;2,0;;3,0;;;;;;;;;;;2,0;;;;;;;;;;;;;;;;10,0;;;;;;;;1,0;;;;;;;;;;;;;4,0;;;;;;;;;;;;;;;;3,0;;;;;;;;;;;;;;1,0;;;;5,0;;;;;;;;;4,0;;;;;;2,0;;;1,0;;;;1,0;1,0;;;;;;;;;;1,0;;;;;;;3,0;;;;;;;11,0;;;;;;;1,0;;;;;1,0;2,0;;;;;;;;;;;;;;;2,0;2,0;;;;;;;;;3,0;;;;;;;;;;10,0;;1,0;;;;;;;;;;;;;;;;;1,0;;;2,0;;;;;1,0;;;;1,0;;1,0;4,0;;;;;;5,0;;;;;;;;;;;;;;;;;;;;3,0;;1,0;;;;;;;;2,0;;;;1,0;;10,0;;4,0;;;;2,0;;;;;;;;;;;;;;;1,0;;;;;;;;;;;;;;;;;;;;;;;;;;;;;;;;;;;;;;;;4,0;;;23,0;;;;1,0;;4,0;;;;;;3,0;;;;;;;;;;;1,0;;;;;;;;;;;;;;;;
average;;;2,0;;2,0;9,0;;6,0;20,0;;;;17,0;;3,0;53,0;;;56,0;2,0;5,0;25,0;;1,0;;4,0;45,0;3,0;2,0;;2,0;24,0;21,0;6,0;8,0;3,0;2,0;24,0;13,0;6,0;50,0;3,0;3,0;9,0;8,0;14,0;67,0;16,0;15,0;4,0;;33,0;2,0;8,0;10,0;32,0;22,0;1,0;26,0;1,0;;;3,0;;8,0;12,0;4,0;2,0;38,0;4,0;20,0;;16,0;3,0;2,0;8,0;1,0;;1,0;205,0;;6,0;1,0;30,0;3,0;3,0;;5,0;;28,0;36,0;;;5,0;8,0;1,0;1,0;;54,0;;6,0;1,0;8,0;15,0;;1,0;4,0;1,0;21,0;16,0;;13,0;1,0;;2,0;71,0;12,0;15,0;8,0;45,0;;;4,0;15,0;11,0;8,0;;5,0;4,0;15,0;;16,0;7,0;5,0;12,0;1,0;8,0;;22,0;24,0;13,0;;;4,0;3,0;;;8,0;62,0;6,0;2,0;;3,0;5,0;;;28,0;;6,0;8,0;2,0;1,0;58,0;1,0;1,0;;11,0;4,0;;1,0;;;;14,0;5,0;4,0;;;;1,0;;4,0;;;;20,0;;17,0;;2,0;;;;1,0;;12,0;;;;;;1,0;63,0;5,0;20,0;;;24,0;36,0;;;;;;5,0;4,0;;;7,0;;;1,0;;1,0;;;1,0;;25,0;;;;;;;2,0;9,0;1,0;;;7,0;;1,0;;;;;10,0;160,0;;2,0;;;;;4,0;4,0;;3,0;13,0;;;;17,0;;4,0;;2,0;6,0;;;;6,0;;1,0;;;;;;;3,0;3,0;2,0;;20,0;2,0;1,0;;1,0;5,0;9,0;3,0;;;;24,0;1,0;;;4,0;2,0;;;;;;20,0;1,0;;3,0;;;;9,0;3,0;;;;;;;4,0;;3,0;;1,0;;;;;;;;;5,0;2,0;;;;;;;6,0;2,0;;;;;2,0;;;;2,0;2,0;;;18,0;;2,0;;;;;;;;;;;;;;;;3,0;;;;1,0;;;2,0;;;2,0;1,0;;;;;1,0;3,0;;;;;6,0;13,0;;;;;3,0;;;;1,0;6,0;130,0;6,0;8,0;21,0;18,0;42,0;5,0;2,0;4,0;;;;1,0;;11,0;4,0;1,0;4,0;11,0;3,0;;1,0;5,0;42,0;3,0;12,0;;;11,0;18,0;10,0;;10,0;13,0;;;1,0;1,0;;4,0;53,0;;;;;7,0;2,0;;;;;2,0;;;24,0;;;;;34,0;4,0;;;;5,0;4,0;;32,0;3,0;1,0;;17,0;3,0;2,0;6,0;1,0;13,0;;1,0;;;;;;1,0;2,0;;;;;;;;;2,0;2,0;;2,0;;2,0;;;;;;24,0;;;;;;;;;7,0;;;;;;;;2,0;;;;;4,0;4,0;;;;;;14,0;4,0;9,0;2,0;;;1,0;;;2,0;1,0;;1,0;;;;;;7,0;1,0;;;;;;;;3,0;;;;;;;2,0;;;;;;;;4,0;;;;;;;;;;;;;2,0;;;1,0;;;1,0;5,0;;;;;;2,0;3,0;;;;;;;;;;;2,0;;;15,0;2,0;;1,0;19,0;;;;1,0;;;;;;;;;;;;;;;;;3,0;;;;;;1,0;;;;;;1,0;3,0;;;1,0;;14,0;3,0;;;;;;;;;;;;;;;6,0;;;3,0;;;2,0;;;;;;;;;;;;;;;;1,0;;;;;;;;;;;;;;;;;;3,0;;1,0;;10,0;6,0;2,0;8,0;;;;2,0;1,0;;;1,0;;;;;;;;;;;;;;;1,0;;;;;;;;2,0;8,0;;;6,0;;;;;7,0;5,0;;;1,0;;3,0;17,0;;;;6,0;;1,0;;;3,0;5,0;4,0;5,0;;;;;;1,0;4,0;2,0;;;;14,0;2,0;2,0;;;68,0;;;14,0;;1,0;1,0;;12,0;;;4,0;8,0;;1,0;1,0;;;;;2,0;;;19,0;1,0;;2,0;;;;;1,0;;1,0;;7,0;;;;;;4,0;2,0;;1,0;;;;;;;;;6,0;12,0;;;;;;;;;9,0;;;;;;;;;;;1,0;;2,0;;;1,0;;;;6,0;;;;;25,0;2,0;21,0;;9,0;;;;1,0;;;;;;;;;;;;50,0;;;;;;;2,0;;;;;;3,0;2,0;;;;1,0;;;;;;2,0;;;;;;1,0;;2,0;;;;;;;;3,0;5,0;;;1,0;;;;;;3,0;;;4,0;;7,0;2,0;;;;2,0;;;12,0;;;;;;;;;;2,0;;;4,0;3,0;2,0;;;;;
balance;;;2,0;;;1,0;2,0;19,0;;;;;1,0;;20,0;27,0;;;1,0;9,0;44,0;21,0;1,0;;;8,0;81,0;;;2,0;;;42,0;4,0;41,0;7,0;6,0;27,0;;;18,0;;1,0;1,0;15,0;1,0;17,0;17,0;5,0;3,0;25,0;4,0;;;1,0;2,0;;;1,0;;1,0;;1,0;;6,0;;14,0;;14,0;;4,0;;4,0;;;;7,0;;7,0;65,0;;4,0;;16,0;;9,0;;;;1,0;11,0;;;;38,0;1,0;2,0;;56,0;1,0;;;36,0;11,0;;;4,0;6,0;4,0;27,0;;36,0;;;;13,0;11,0;25,0;;6,0;;;;13,0;20,0;1,0;1,0;4,0;;4,0;;3,0;6,0;;3,0;8,0;;3,0;;;8,0;;;5,0;23,0;1,0;;1,0;58,0;1,0;;;2,0;3,0;11,0;;116,0;;2,0;;;2,0;60,0;;;;24,0;;;;6,0;;;;1,0;9,0;11,0;1,0;;;;1,0;;;;7,0;;49,0;;;;1,0;;96,0;;;;;;;;;1,0;8,0;;;;;27,0;;3,0;;4,0;17,0;;;;1,0;;;;;1,0;;;;;;20,0;;7,0;;;10,0;10,0;7,0;3,0;;;12,0;;;;;;;;;19,0;;6,0;;3,0;;1,0;;10,0;1,0;;;1,0;;1,0;8,0;;;;;3,0;1,0;;41,0;;;;1,0;20,0;;;2,0;10,0;;2,0;;;1,0;;1,0;2,0;;;1,0;;;;7,0;12,0;;;;;2,0;21,0;;;;;;;;;2,0;;;;;;;;10,0;;;;;5,0;;2,0;;;;1,0;;;;;;1,0;;;;2,0;;;8,0;1,0;;;13,0;5,0;;;8,0;1,0;3,0;;3,0;1,0;27,0;1,0;86,0;;;;1,0;;;;;;;;;;;;;;4,0;23,0;2,0;;;1,0;1,0;;1,0;;;;88,0;;8,0;2,0;;4,0;;;;;;;;;3,0;;;;;3,0;37,0;18,0;;7,0;;1,0;;;1,0;;;;;1,0;;;4,0;;;;;;7,0;19,0;;5,0;;4,0;1,0;4,0;;1,0;10,0;5,0;;;;1,0;;;;;;;;2,0;;;;1,0;;;1,0;1,0;5,0;1,0;7,0;6,0;1,0;19,0;;;;;;1,0;4,0;;;2,0;;29,0;;;62,0;;;;;;;;;;;13,0;;10,0;;1,0;;25,0;;;2,0;2,0;;;;;;11,0;;;;;4,0;;;;;;1,0;;117,0;;;;7,0;;;;;;1,0;;;9,0;;6,0;;;;;;;1,0;21,0;;;;;;;;;;;;4,0;;;;;;;1,0;;1,0;;1,0;3,0;;;;2,0;1,0;;;;;;;;;8,0;73,0;;;15,0;;;;;;;;;;;2,0;;;;;;1,0;;;;;;;;;;;;;;;;;;;;;;;;1,0;1,0;;;;1,0;;;;1,0;;8,0;;;;;;3,0;;;;;;;;7,0;;78,0;;;;10,0;;;;1,0;;;14,0;;;;;;;;;;;;;3,0;;;;;;;;;;;2,0;;;;;;1,0;;2,0;;;;;24,0;;;;1,0;1,0;;;;;;;;;;;;;;;;;;;;;7,0;;;;;;1,0;1,0;;1,0;;;;6,0;;;;;;;;;;;;;;1,0;;;;;;;;21,0;;;;;;;;1,0;;;13,0;;;;;;;;;;;;2,0;7,0;;;;;;;;2,0;;2,0;;;4,0;10,0;;;6,0;;;;;;;;;;;;;;2,0;1,0;;2,0;;;;;4,0;10,0;;;;;;;;;;;;;;;;;;;;3,0;;;3,0;;2,0;;;;;;1,0;;;;;;;;;;;;2,0;;;2,0;;;6,0;;;;;;;;5,0;4,0;;;;;;;;;1,0;;13,0;;;;4,0;;;;;247,0;;;;;;;;;1,0;;;;;;;;;;;;;;;;;;;65,0;;;;;;;;;;;;;;;;;;;;;;3,0;;;;;;4,0;;;;5,0;;;;;;;7,0;;;;;1,0;;;;;;;;18,0;;;;2,0;;1,0;;2,0;;;;
band;;;2,0;;;;10,0;7,0;1,0;2,0;10,0;;4,0;;;13,0;;;;;5,0;6,0;;8,0;;92,0;81,0;9,0;;1,0;2,0;;16,0;2,0;5,0;7,0;2,0;;;;16,0;;12,0;2,0;3,0;4,0;16,0;27,0;3,0;;5,0;;;21,0;3,0;29,0;18,0;1,0;1,0;;1,0;;10,0;;103,0;4,0;4,0;9,0;3,0;;9,0;2,0;26,0;1,0;2,0;;;;9,0;94,0;1,0;41,0;;41,0;;2,0;2,0;;;2,0;27,0;;;4,0;;;;;26,0;1,0;;4,0;5,0;12,0;3,0;;35,0;;95,0;;56,0;11,0;;;;12,0;30,0;22,0;;11,0;;;3,0;12,0;8,0;;;;20,0;15,0;;21,0;;;15,0;4,0;35,0;1,0;1,0;;;;2,0;3,0;7,0;;;5,0;73,0;;10,0;5,0;1,0;1,0;2,0;2,0;24,0;;;;;23,0;23,0;;;;30,0;;39,0;180,0;2,0;;2,0;2,0;4,0;;1,0;;;;2,0;3,0;;;;2,0;;58,0;2,0;;;;;3,0;;;;;2,0;1,0;;3,0;16,0;4,0;;17,0;;;;;;;;;;;;;;;;;;;;;;;113,0;;5,0;1,0;1,0;6,0;;;1,0;;;;17,0;;;5,0;3,0;1,0;;;14,0;2,0;;2,0;;;;;13,0;8,0;;;;;7,0;46,0;;;2,0;;;;;1,0;1,0;;4,0;1,0;;1,0;;2,0;9,0;;1,0;;;14,0;;1,0;;18,0;3,0;;;;;;3,0;;1,0;;1,0;;;;;;;4,0;;;1,0;;;;;1,0;;;;6,0;;1,0;;;1,0;;;;;1,0;1,0;;;;;174,0;;1,0;;;;;;;4,0;;;;6,0;3,0;;;;2,0;;;;6,0;;2,0;1,0;;;;;;;;;;;;;;;;2,0;;;;;;;;;1,0;;;;;;1,0;;3,0;;4,0;1,0;2,0;;;;;;3,0;;;2,0;;;19,0;3,0;1,0;6,0;;;1,0;;;;;;;7,0;1,0;;3,0;;2,0;;4,0;;8,0;2,0;2,0;7,0;;;;;;;;3,0;;1,0;3,0;;;;1,0;;;;;5,0;2,0;;;;;;;;;;;;;;;;4,0;1,0;;7,0;;;;1,0;;6,0;;4,0;4,0;;;;2,0;;;;;;;2,0;;;;5,0;;1,0;1,0;;7,0;;;;;;;;1,0;;;;;;;;;;;4,0;;;;1,0;;;;;;4,0;;;;;;;6,0;;2,0;;;;2,0;2,0;;;;;4,0;;1,0;;2,0;;;1,0;;;;;1,0;;;;;;;;;;;;2,0;;1,0;;;1,0;;;;;;;;;;;;;;;;;;3,0;;4,0;;;;;4,0;3,0;;;;;;;;;;;;;;;;;;;;7,0;1,0;;;;;;;;;;;;;;;1,0;;;;;;;;16,0;;;;;;1,0;4,0;;;;;;1,0;1,0;;;1,0;;;2,0;;2,0;;;;;;1,0;;9,0;1,0;;;;;;8,0;;;;9,0;;;;;;1,0;2,0;;;;4,0;;;;;;;1,0;;;;;;3,0;;;;;;;;;;1,0;;;;;3,0;;;;4,0;;;;;;;;;;;;;;;;;;;;;3,0;;1,0;4,0;;;;;;;;2,0;;;;;;;1,0;;;;;;1,0;;;;;;2,0;;;6,0;1,0;;;;;;;;;;;;4,0;;;;;;;;;;4,0;;;;5,0;2,0;;;;;;;;;;;;2,0;;;6,0;;2,0;;;;;;;;;;;;;;;;;;;;4,0;;;;;2,0;;;;;;;;;;;;;;;;;;;;;;;;;;;;;6,0;1,0;;;;;;;;;;;;2,0;;;;;;;;;;;;;;;;;;;;;;;;;;;;;;;;;;;;;;;;;;;;1,0;;;;2,0;;;;;7,0;;;;;;;;;;65,0;;;;;;;;;;;1,0;;;;;;;;;1,0;;;;;;2,0;;;;2,0;;;;;;
bearing;;;2,0;;;7,0;8,0;8,0;;3,0;;;3,0;;1,0;12,0;1,0;;;;;4,0;;;;;;;;;2,0;;10,0;;4,0;;;1,0;2,0;1,0;;2,0;11,0;;;;4,0;15,0;;7,0;2,0;;;;2,0;3,0;56,0;;;2,0;2,0;1,0;;;;;;13,0;13,0;1,0;1,0;;;;;1,0;;;;5,0;;;;22,0;;10,0;;;;2,0;27,0;;1,0;;;8,0;5,0;;15,0;1,0;;;29,0;;;;2,0;5,0;;;;;;;;52,0;20,0;25,0;;;5,0;;;1,0;14,0;2,0;;;;;;;16,0;;;;12,0;;;;;;;2,0;;;;7,0;;;;;3,0;;;;22,0;;1,0;;1,0;;3,0;;;;;5,0;;;;;;22,0;;;19,0;18,0;;;2,0;7,0;;5,0;;4,0;;1,0;;;1,0;;;10,0;;8,0;;;;8,0;3,0;;;5,0;4,0;;;;;5,0;;;7,0;;1,0;;5,0;;;11,0;18,0;;12,0;;1,0;2,0;9,0;1,0;;;47,0;2,0;;11,0;8,0;3,0;7,0;4,0;4,0;17,0;;;;;;;;;;;4,0;;;1,0;2,0;;24,0;;;;;;2,0;2,0;;;1,0;;1,0;;4,0;5,0;4,0;;;7,0;;16,0;2,0;38,0;;;;;1,0;1,0;;;;;2,0;;;;5,0;;;1,0;;5,0;5,0;7,0;10,0;7,0;84,0;;;2,0;5,0;;1,0;3,0;2,0;1,0;;;;;;14,0;1,0;;1,0;;2,0;;4,0;;;;;3,0;;12,0;;;2,0;17,0;2,0;;;;;1,0;2,0;;1,0;4,0;3,0;1,0;;;;;;2,0;6,0;4,0;4,0;;;;;;4,0;;;3,0;11,0;;;;;;;;4,0;9,0;4,0;11,0;14,0;;3,0;20,0;;1,0;;8,0;;40,0;3,0;10,0;;;1,0;;;;;;;;;;;;;;;;;2,0;;;;;;;;;;2,0;;;;;;;;;;;;26,0;6,0;;;;;;;;5,0;;;1,0;;;;;;;;;;;;;3,0;;1,0;;;;;5,0;;;;7,0;;;;;;;2,0;;;;2,0;9,0;;2,0;4,0;;;;;;;4,0;;8,0;;;;;;;8,0;;;;;;;;;;;;;;;;;;;4,0;;;;;;;2,0;;;;;;1,0;;;;;;;;;4,0;2,0;;;;;;;;;;;;;;;;;;;4,0;;;6,0;;;1,0;;;;;;;;;;;;;;;;;;;;;3,0;;;;;;1,0;;;;;2,0;;;;;;;;;;;1,0;;1,0;;;;;;;2,0;;;;;;;;;;;;23,0;;;;;;7,0;;;;;;;1,0;;;1,0;;;;;;1,0;2,0;2,0;;;4,0;;;;;;;;;;;1,0;;4,0;;;;;;1,0;1,0;;1,0;;3,0;;;;;;;;;;1,0;;;4,0;;;3,0;4,0;1,0;;;;4,0;1,0;;;;2,0;;;;;;;;;;;;9,0;;;;4,0;;;;;;;;;;;;4,0;;;;;;1,0;;;;2,0;1,0;;;;;;;;;;;;;;;;;;;1,0;;;;;;;;;;;;;;;;;;;;;;;;;;1,0;;;;;;2,0;;;;;;;;17,0;;;;;;;1,0;;;;;;;;;;;;;;;;;;;;;;;;;;1,0;;;;;;;;;;;;;;;;;;;;;;;;;;;;;;;;2,0;;;14,0;2,0;;;1,0;;;;;;;;;;;;;2,0;1,0;;;;;;;;;;;;;2,0;1,0;;2,0;;;;;1,0;;;;;1,0;;44,0;;;;;1,0;;;;;;;;;;;2,0;;;;;;;;;;;;6,0;;;;;;1,0;;1,0;;;;;;;;;;;;;;;;;;;;;1,0;;;;1,0;;;;;;;;;;;;;;;;;
blade;;;1,0;;;;66,0;4,0;6,0;35,0;25,0;;;;3,0;22,0;;;;;;;;8,0;;;;;;;;;32,0;;20,0;1,0;;;;;;2,0;5,0;;1,0;1,0;;51,0;2,0;3,0;18,0;;;2,0;130,0;2,0;;;;;15,0;;11,0;;18,0;9,0;;45,0;3,0;2,0;12,0;;2,0;;;39,0;;;;4,0;;;;60,0;;;3,0;;;8,0;27,0;;;4,0;;;;;9,0;;;;18,0;5,0;;;14,0;6,0;6,0;;4,0;6,0;;;;57,0;150,0;79,0;2,0;8,0;15,0;;;;;;;;;;;;18,0;;;;2,0;;;;;;;5,0;4,0;;2,0;19,0;;;;;;;3,0;;3,0;;;;;;21,0;;;;2,0;;;;;;1,0;4,0;1,0;2,0;2,0;14,0;137,0;;;;;;8,0;3,0;;;;;;;;21,0;;16,0;;;7,0;16,0;2,0;2,0;2,0;58,0;;4,0;2,0;;63,0;14,0;4,0;10,0;47,0;;1,0;;7,0;;;15,0;2,0;;3,0;;;;2,0;19,0;6,0;;154,0;;;42,0;98,0;46,0;17,0;92,0;6,0;17,0;32,0;;2,0;6,0;16,0;;;;;11,0;54,0;;;;;;2,0;;;;;;;1,0;;;15,0;3,0;328,0;;8,0;5,0;4,0;;;21,0;6,0;;1,0;7,0;;;;2,0;2,0;9,0;;;;;;1,0;;2,0;;;;;;;20,0;5,0;22,0;;;;1,0;14,0;6,0;1,0;;10,0;;;116,0;;;;2,0;16,0;4,0;;5,0;16,0;84,0;;40,0;2,0;;1,0;;;1,0;;;;;1,0;9,0;1,0;;;8,0;3,0;;3,0;29,0;11,0;5,0;;;;;;;11,0;;12,0;;5,0;9,0;;;20,0;6,0;14,0;;;;;;8,0;;;2,0;;3,0;4,0;19,0;8,0;4,0;;;6,0;7,0;;3,0;;;16,0;1,0;5,0;;;;;;;;;;;;2,0;;;;;;;;;;;;;;;1,0;;;4,0;;;;;;1,0;;;;;;7,0;;;3,0;5,0;;;;1,0;23,0;;;19,0;26,0;;;;;;;4,0;;4,0;;;1,0;;1,0;;;7,0;;;;;;;;;;;;;;;;;4,0;;;8,0;;;;;;;;;;;;;;;;;10,0;;;1,0;;;;;2,0;;;;;;;;;;;;;;;;;;;;;;;;1,0;4,0;;;1,0;;;;;21,0;;;;;;;14,0;;;;;;;46,0;;;;;;;;;;;;;;;;;1,0;;;;;;;;;;;;;;;;11,0;;;;;1,0;1,0;;;;;1,0;3,0;;;;;;;17,0;;;;;1,0;;;;;;;;;;;;;;3,0;;4,0;;;;;34,0;;;;;;;;;;;;;;;;;;1,0;;4,0;;;;2,0;;;;;;;;;;8,0;;164,0;;4,0;;;;;;1,0;1,0;;;;;;8,0;;;12,0;;;2,0;;;;;;;;;;;;;;6,0;5,0;;;;;2,0;;;3,0;;;;;;8,0;;;18,0;1,0;;35,0;;;6,0;;;;;;;;;;6,0;8,0;;2,0;;;;;;;;;;1,0;;;;;;;;;;;;;;;;;;;;;;;;;;;;;;;;;1,0;;;;;;;;;;;;;;;;;;;;;;;2,0;;;;;;;;;;;;;;;1,0;;;;;;;;;;;;;;;;19,0;;;;;;;;;;;;;;;;4,0;;;;3,0;4,0;;;;;;;;;;;;;1,0;2,0;;;;;;16,0;;;;;1,0;;;;;;;;;;;;;;;;;;;;;;11,0;1,0;;;;;3,0;;1,0;;;;;;;;23,0;;1,0;;;;;;;;;;10,0;;;;;;;;;;;;;;;;;;;13,0;;;;;;;;;;;;;;;;;;;;;;;;;;;;;;;;;;;;;;;;;;;;;;
boundary;;;1,0;;;3,0;;5,0;27,0;6,0;6,0;;1,0;;8,0;25,0;;;;;1,0;5,0;;2,0;1,0;;25,0;;1,0;;1,0;3,0;11,0;6,0;8,0;;;;3,0;2,0;4,0;;68,0;;8,0;4,0;55,0;24,0;1,0;52,0;21,0;7,0;;;17,0;16,0;4,0;;3,0;;14,0;;7,0;;9,0;;18,0;27,0;4,0;;4,0;;7,0;2,0;;;1,0;;3,0;93,0;1,0;5,0;2,0;20,0;;1,0;;;2,0;;19,0;;;;;;;;26,0;;2,0;;14,0;28,0;;;10,0;;5,0;1,0;;8,0;;;;7,0;42,0;37,0;;3,0;;;;4,0;6,0;;;;;9,0;;12,0;1,0;;13,0;;;3,0;1,0;3,0;3,0;2,0;;6,0;1,0;1,0;;45,0;2,0;28,0;;;;2,0;1,0;;9,0;;3,0;;3,0;1,0;5,0;;;;8,0;15,0;;;3,0;;1,0;2,0;3,0;1,0;;;;;2,0;6,0;;;;;;4,0;;;;;;8,0;2,0;;;7,0;;;;;;20,0;4,0;;;;;72,0;1,0;;4,0;;;;;;2,0;13,0;1,0;;1,0;;;;22,0;;22,0;;9,0;;;;5,0;1,0;7,0;4,0;;14,0;4,0;4,0;1,0;3,0;;;;;33,0;17,0;;;;;;;5,0;2,0;;;;;;37,0;5,0;;10,0;8,0;;6,0;;1,0;12,0;3,0;;;5,0;2,0;9,0;52,0;;;;2,0;1,0;2,0;;;;9,0;12,0;9,0;;;3,0;;;;2,0;3,0;10,0;3,0;;;;;;;;;;;3,0;1,0;;2,0;;;;;;;2,0;;2,0;;2,0;;;2,0;1,0;;;;;1,0;;;;;;;;;;;;;8,0;;;3,0;;;;;;47,0;2,0;;;28,0;;;;;;2,0;;;;;;;4,0;;1,0;;1,0;1,0;;;;;;;;;;6,0;;2,0;;;;;;2,0;8,0;4,0;;;;;;;;;;7,0;4,0;;3,0;8,0;5,0;;2,0;;;2,0;;2,0;;5,0;;;3,0;10,0;;;;1,0;3,0;2,0;7,0;;;;2,0;;;;2,0;;2,0;4,0;4,0;2,0;;;;;;;;;;;;1,0;6,0;;;;1,0;;;;3,0;3,0;1,0;2,0;;;;;;;;;8,0;10,0;;4,0;6,0;;4,0;;;;;7,0;4,0;1,0;4,0;;;57,0;;6,0;1,0;;;;;1,0;36,0;;6,0;;3,0;3,0;;6,0;2,0;;;;;;1,0;;;7,0;;;;;6,0;;;2,0;;;;;3,0;;1,0;;;12,0;;;;2,0;;;;;;;1,0;;;;;;;;;;;6,0;3,0;;2,0;;;;;;1,0;;;3,0;1,0;;;3,0;;3,0;2,0;;1,0;;;;;;;;;3,0;;;;;;;8,0;2,0;;;;;2,0;;;2,0;;6,0;;;;;;;;;;1,0;;;1,0;;92,0;4,0;;;;;;;;;;;;;1,0;4,0;2,0;;;1,0;1,0;;2,0;;;;;;;;;;;;;;;;4,0;;1,0;;;;;;;;;;;1,0;;;;;;;;8,0;;4,0;;1,0;;;;;;3,0;3,0;;;;;;;;;;;;;;;;;6,0;;;;;1,0;;;;;;;4,0;7,0;;;3,0;4,0;13,0;1,0;;2,0;;;1,0;;;;4,0;;;;;;1,0;3,0;1,0;;;;;;;;;14,0;2,0;;;;;;2,0;4,0;2,0;;;;;;4,0;;6,0;;7,0;;1,0;5,0;;;;1,0;;;;;2,0;1,0;;;;;;6,0;2,0;;1,0;;;;;;;;;1,0;;;;;;;;;;;;1,0;;;;;;;;;;;;2,0;;;;;;3,0;;;;;;;;;;;;;;;2,0;1,0;;;;7,0;;;;;;;4,0;;;;8,0;;;3,0;;;;;;;;;9,0;;;;;;5,0;;;;;;;;;;;1,0;;;;;5,0;;;;5,0;1,0;1,0;3,0;;;;;;;;;;;;;;;;;;;3,0;;;;1,0;;;7,0;;;;;;;;;;;;;2,0;;;;;;;;;;;;;;;1,0;;;;;;;;;;3,0;;;2,0;;;;;;;;;;;;;1,0;;;;1,0;;;;;
calculate;;;2,0;;10,0;168,0;10,0;46,0;116,0;4,0;19,0;;26,0;;32,0;427,0;7,0;49,0;64,0;2,0;113,0;82,0;;6,0;5,0;68,0;128,0;14,0;;17,0;17,0;6,0;377,0;55,0;144,0;54,0;31,0;122,0;5,0;5,0;170,0;1,0;6,0;32,0;36,0;50,0;133,0;131,0;43,0;64,0;2,0;483,0;17,0;21,0;122,0;51,0;15,0;35,0;69,0;10,0;;15,0;19,0;;17,0;84,0;132,0;15,0;113,0;;107,0;5,0;63,0;6,0;16,0;21,0;7,0;5,0;1,0;811,0;6,0;34,0;8,0;128,0;5,0;32,0;7,0;4,0;2,0;58,0;74,0;;7,0;;20,0;18,0;12,0;4,0;220,0;12,0;22,0;5,0;225,0;223,0;;42,0;29,0;6,0;172,0;235,0;4,0;41,0;4,0;;5,0;167,0;107,0;391,0;34,0;73,0;;;26,0;104,0;95,0;22,0;2,0;104,0;3,0;65,0;;50,0;51,0;1,0;29,0;6,0;34,0;22,0;21,0;;42,0;10,0;2,0;56,0;27,0;20,0;;30,0;97,0;44,0;8,0;12,0;31,0;51,0;82,0;8,0;119,0;;23,0;5,0;6,0;9,0;881,0;11,0;;;40,0;37,0;2,0;5,0;23,0;;;18,0;393,0;25,0;6,0;;;8,0;;13,0;;;13,0;22,0;;101,0;;;;9,0;;1,0;2,0;2,0;;5,0;;;;4,0;246,0;107,0;29,0;;;14,0;129,0;23,0;;19,0;2,0;1,0;;5,0;;;30,0;9,0;2,0;;3,0;2,0;14,0;;;;154,0;;6,0;;6,0;6,0;7,0;24,0;55,0;7,0;;2,0;;2,0;;19,0;12,0;;1,0;6,0;312,0;40,0;1,0;;;;2,0;;16,0;;;;;;;39,0;;18,0;10,0;;1,0;;;23,0;28,0;;;;22,0;50,0;2,0;39,0;7,0;;8,0;7,0;;122,0;11,0;;1,0;1,0;51,0;14,0;12,0;;;;54,0;;;;10,0;;3,0;7,0;7,0;;;31,0;;7,0;;9,0;;;13,0;14,0;;1,0;;;;1,0;1,0;;47,0;9,0;;;1,0;;;;1,0;;;29,0;18,0;3,0;;;;3,0;;34,0;4,0;;;2,0;3,0;39,0;;;;6,0;3,0;;2,0;174,0;3,0;1,0;1,0;17,0;;;;;;1,0;;2,0;9,0;;;2,0;;;1,0;;10,0;33,0;;;6,0;;14,0;29,0;1,0;;4,0;;1,0;98,0;17,0;1,0;;8,0;2,0;7,0;18,0;2,0;3,0;;;18,0;;16,0;2,0;16,0;50,0;;101,0;22,0;51,0;5,0;26,0;4,0;;2,0;5,0;2,0;5,0;10,0;17,0;29,0;6,0;11,0;6,0;79,0;10,0;5,0;;41,0;112,0;16,0;116,0;2,0;28,0;29,0;16,0;1,0;11,0;129,0;51,0;;5,0;;55,0;4,0;27,0;36,0;18,0;11,0;11,0;26,0;45,0;9,0;;3,0;3,0;8,0;6,0;;;42,0;;;;14,0;62,0;30,0;11,0;4,0;1,0;30,0;11,0;6,0;179,0;32,0;10,0;;29,0;4,0;15,0;52,0;165,0;3,0;2,0;2,0;4,0;11,0;;10,0;;8,0;31,0;10,0;;1,0;2,0;10,0;1,0;;4,0;20,0;23,0;4,0;3,0;2,0;20,0;1,0;14,0;19,0;11,0;1,0;24,0;2,0;6,0;;1,0;5,0;5,0;;;109,0;3,0;2,0;;;2,0;13,0;;34,0;1,0;2,0;4,0;;60,0;19,0;2,0;5,0;2,0;9,0;;16,0;;7,0;62,0;2,0;;6,0;2,0;;18,0;2,0;3,0;8,0;;;;2,0;2,0;3,0;4,0;55,0;4,0;10,0;;4,0;;22,0;12,0;5,0;2,0;;;1,0;;;;6,0;1,0;;;4,0;27,0;149,0;;;;1,0;4,0;;;;;3,0;;1,0;17,0;;3,0;;3,0;2,0;;;;;;;;7,0;;;;;;8,0;;1,0;;1,0;;5,0;1,0;;72,0;12,0;;7,0;3,0;;1,0;;5,0;;2,0;;11,0;;4,0;2,0;3,0;;1,0;1,0;7,0;1,0;17,0;;2,0;;;;;1,0;23,0;12,0;;;3,0;4,0;1,0;;11,0;24,0;;35,0;;2,0;8,0;;53,0;;;;;16,0;;;;;5,0;;;36,0;2,0;21,0;5,0;6,0;;17,0;;;;;3,0;;5,0;;;;;7,0;;5,0;3,0;37,0;1,0;;;2,0;;2,0;;;1,0;;;;;;;;;;;6,0;4,0;10,0;2,0;;10,0;2,0;25,0;3,0;2,0;;;9,0;2,0;;;8,0;;;;2,0;;;;2,0;;;;4,0;;;3,0;34,0;;5,0;;10,0;2,0;17,0;6,0;12,0;;;;1,0;159,0;23,0;;;10,0;1,0;53,0;89,0;2,0;;;9,0;;5,0;3,0;17,0;33,0;5,0;;33,0;;1,0;1,0;;;1,0;18,0;11,0;130,0;37,0;19,0;388,0;;14,0;4,0;;92,0;;12,0;31,0;;10,0;7,0;2,0;17,0;;7,0;25,0;4,0;7,0;7,0;9,0;18,0;48,0;;2,0;8,0;2,0;;39,0;12,0;24,0;13,0;3,0;;;;;;2,0;1,0;3,0;3,0;4,0;2,0;2,0;;1,0;1,0;;;41,0;5,0;;17,0;1,0;15,0;2,0;;6,0;;;;3,0;1,0;3,0;;1,0;1,0;31,0;2,0;4,0;;;;;;2,0;;;5,0;;7,0;1,0;;13,0;;4,0;;3,0;1,0;;;1,0;10,0;;20,0;3,0;3,0;;3,0;;73,0;;;;1,0;;;3,0;;;9,0;6,0;76,0;;4,0;9,0;3,0;;;15,0;;;;5,0;;1,0;3,0;9,0;;4,0;3,0;;33,0;;6,0;1,0;;;;1,0;8,0;;2,0;;2,0;;;34,0;3,0;1,0;;;3,0;10,0;;4,0;;17,0;;4,0;;52,0;1,0;;;;;;64,0;;27,0;4,0;4,0;;7,0;41,0;;25,0;2,0;2,0;4,0;4,0;5,0;;1,0;2,0;;;;4,0;6,0;5,0;;;;
calculation;;;5,0;;;25,0;;13,0;38,0;1,0;;;;;1,0;39,0;;4,0;31,0;3,0;4,0;1,0;4,0;;1,0;9,0;35,0;;;;;3,0;69,0;1,0;55,0;4,0;14,0;42,0;;;26,0;;;2,0;14,0;26,0;60,0;40,0;13,0;3,0;;82,0;8,0;2,0;57,0;1,0;2,0;1,0;24,0;;;;2,0;;10,0;;16,0;4,0;8,0;;18,0;;2,0;2,0;;1,0;;;;112,0;;16,0;;18,0;;9,0;1,0;;;;13,0;;;;;1,0;;;23,0;1,0;2,0;2,0;32,0;21,0;;6,0;20,0;1,0;24,0;10,0;2,0;62,0;;;;13,0;21,0;50,0;;28,0;;;10,0;21,0;4,0;3,0;1,0;17,0;;1,0;4,0;3,0;2,0;;;;1,0;4,0;12,0;;1,0;;;2,0;6,0;;;2,0;20,0;1,0;2,0;;4,0;7,0;32,0;;20,0;;;;1,0;2,0;559,0;;;;6,0;;;;;;;;86,0;4,0;;1,0;;;;14,0;;;;15,0;;15,0;;;;;;3,0;;;;;;;;;31,0;2,0;2,0;;;;89,0;1,0;1,0;;;;;;;;1,0;6,0;;5,0;;;12,0;;;;29,0;;2,0;;;3,0;;;;;;;4,0;;;;11,0;;;;10,0;5,0;;;;;;2,0;2,0;;;;;;;7,0;;2,0;4,0;;;;;;;;;;;;;2,0;10,0;;1,0;;;34,0;1,0;;;;5,0;;18,0;;;;18,0;;;;;3,0;;;;;;4,0;;;;5,0;;;1,0;1,0;;;;1,0;;;;;10,0;;;;;;;;;;;2,0;;;2,0;;;;;47,0;;;;1,0;3,0;3,0;;2,0;;18,0;;;3,0;6,0;;2,0;;;;;;;;;;;;;;;;;;;;6,0;;;;;;3,0;;;;;;16,0;;;;4,0;;;2,0;1,0;;;;15,0;;;;;3,0;388,0;11,0;2,0;3,0;;4,0;;;;;;4,0;;4,0;4,0;;;;8,0;1,0;;;5,0;1,0;;4,0;;3,0;5,0;7,0;;1,0;29,0;12,0;;;;8,0;2,0;;18,0;1,0;3,0;;;1,0;2,0;;4,0;;5,0;;;;25,0;;;;;25,0;3,0;;;;23,0;1,0;;10,0;;;;6,0;;;9,0;;1,0;;1,0;;;;3,0;;12,0;7,0;2,0;;;;;;;;1,0;1,0;;;;6,0;;;;;;1,0;;;;;;1,0;;;10,0;;4,0;1,0;;;1,0;;1,0;;;;;5,0;;;;;;;;;1,0;13,0;;;2,0;;;;;3,0;1,0;;;;;;2,0;;4,0;;;;2,0;;5,0;1,0;;;;;;;;;;;;;2,0;13,0;21,0;;;;;;;;;;;;;;1,0;;;;;;;;1,0;;;;;;;;1,0;;1,0;;;;1,0;;2,0;;;16,0;4,0;;5,0;;;;;;;;;5,0;;;;1,0;;;;;;2,0;;2,0;;;;;;6,0;;;;;;;1,0;2,0;;;4,0;;1,0;;;18,0;;;;;;;;;;;;;;;;;;;;;;;;;;;;;;;;;;;1,0;;;;;;;;;;;;;;;;;2,0;;;;;;;;;1,0;;;;;;;;;;2,0;;;;;;1,0;;;;;;1,0;;;;;;;;;;3,0;;8,0;;;;;12,0;6,0;;;;;2,0;;;;;;;3,0;2,0;;6,0;;;1,0;;;5,0;;;;8,0;;14,0;10,0;;;;;;;9,0;;;3,0;;1,0;;;9,0;;;14,0;;;4,0;2,0;;19,0;;;3,0;;;2,0;;1,0;2,0;;;;;;;2,0;;;;;;;;;1,0;;;6,0;1,0;;;2,0;;;;;;;;;;;;;;6,0;1,0;;;;;;;;;;;;1,0;;;;;;;;;;;;;;3,0;;;;;;4,0;;;;;;;;;;;;3,0;;;;;;;3,0;;;;;1,0;;;;;;;;;;;;;;;2,0;1,0;;;;;;;;1,0;;;;;;;;;5,0;;;;2,0;;;;;;;;;;;;;;;;1,0;;2,0;;;;2,0;;;;;;;;;;;;
compensation;;;2,0;;;1,0;;13,0;2,0;4,0;;;16,0;;2,0;18,0;;69,0;1,0;4,0;4,0;4,0;1,0;;;;24,0;1,0;;23,0;1,0;7,0;31,0;1,0;10,0;1,0;7,0;9,0;;;3,0;;2,0;;31,0;25,0;29,0;48,0;3,0;;;11,0;1,0;;40,0;1,0;9,0;4,0;2,0;;;;;;4,0;54,0;1,0;1,0;4,0;;3,0;;10,0;;1,0;14,0;3,0;3,0;1,0;112,0;2,0;;;21,0;1,0;;1,0;;;12,0;106,0;;;;1,0;;2,0;;52,0;4,0;;;18,0;2,0;2,0;;58,0;2,0;9,0;180,0;;51,0;;;;13,0;19,0;121,0;4,0;;8,0;;18,0;45,0;9,0;6,0;;;;51,0;;3,0;;;4,0;;1,0;8,0;;;1,0;;;16,0;6,0;2,0;;3,0;59,0;;;;14,0;20,0;;;41,0;;;;2,0;1,0;292,0;4,0;4,0;;9,0;;1,0;;4,0;;;2,0;4,0;26,0;;5,0;;;;7,0;;;;12,0;;;;;12,0;1,0;;1,0;;2,0;5,0;;;;;2,0;;1,0;10,0;;;5,0;5,0;;;;1,0;;;;;;;;2,0;2,0;;;;;;;12,0;;2,0;;;8,0;1,0;13,0;35,0;;;;;;;5,0;3,0;;;;7,0;;;;;;;11,0;5,0;;;;;;;22,0;;35,0;;;5,0;;;4,0;;;;;3,0;2,0;;4,0;;;;;;53,0;;;;;;;254,0;;;;10,0;;;;11,0;2,0;;;8,0;;;1,0;1,0;;;1,0;;;1,0;;;;;;;;2,0;;2,0;;;;1,0;;;;;;;;;;;;;;;1,0;18,0;;;;;;;;8,0;;;;;4,0;;;;;;;;;;;;;;;;;;;4,0;;;1,0;;;2,0;;;2,0;;;1,0;;;65,0;;;;;;;7,0;;;;1,0;;5,0;3,0;;1,0;;22,0;8,0;3,0;;;2,0;2,0;2,0;;;;;;;5,0;;1,0;;2,0;;;;;2,0;;3,0;2,0;;5,0;4,0;;;69,0;6,0;;;;34,0;17,0;2,0;;15,0;;;;4,0;;;1,0;;;;;;4,0;1,0;;;;;1,0;;;;;;;5,0;14,0;;;3,0;;2,0;49,0;3,0;;;1,0;1,0;;;1,0;;3,0;22,0;1,0;2,0;;;;2,0;;2,0;4,0;2,0;;;;2,0;;;;1,0;;;;;;;;;;;3,0;;;;;;;;1,0;;;;;4,0;4,0;5,0;;;;;1,0;;;;;;;;;;;;;;;;;;;;1,0;;17,0;;;;;;;;;9,0;3,0;;;1,0;;;;;;100,0;2,0;;;7,0;;;;;;;;;;;;1,0;;;;;;2,0;;;;2,0;;1,0;;;;;;;;;;;;;;1,0;21,0;;1,0;;;;1,0;;;;;;;3,0;;;;;;;;;;;;;;;;1,0;;;;;;;2,0;;;;2,0;;;;;;;;;;;;;;3,0;;;;;;;;;;;;;;;;;;;;;;;;;;1,0;;;;;;;;;;;;1,0;;;;;;1,0;;;;12,0;;;;;;;;;;3,0;;;;;;;;;;;;1,0;;;;;2,0;;;;;;;;2,0;1,0;;;;;;;;;;;;;2,0;51,0;;;;2,0;;;;;;;;;;;;;;;;3,0;;1,0;;5,0;;;;;17,0;;;;;1,0;;2,0;;;;;;;1,0;30,0;1,0;;;;;1,0;;10,0;;;;;;;;1,0;;;;;;;;;;;;;;;;;1,0;;;;;;;;;;;;;;;3,0;;;;;;3,0;;;;;;;1,0;;;1,0;;;3,0;54,0;;;;;;;;;1,0;;;;16,0;;;;;;;;;;;;;;;;;;;1,0;;;;;;;;;;;;1,0;;;;;;;;;;;;;1,0;;;;;;;;;;;;;1,0;;;2,0;;;;;;;2,0;;;1,0;;;;;;;;2,0;;;;;;;;;;;;;;;;;
compose;;;7,0;;;;1,0;9,0;;5,0;12,0;3,0;;;1,0;8,0;;;;;;17,0;;;;;38,0;;1,0;;1,0;4,0;6,0;;4,0;;;3,0;;;;;3,0;;;3,0;2,0;14,0;;4,0;4,0;;;;3,0;;479,0;;2,0;;;;2,0;;1,0;;1,0;1,0;10,0;4,0;;6,0;6,0;;;7,0;;;19,0;150,0;;3,0;;19,0;;1,0;;;;;872,0;;;9,0;;;4,0;;3,0;;;;8,0;11,0;;1,0;78,0;92,0;2,0;;;4,0;;;2,0;102,0;26,0;9,0;120,0;;;;2,0;1,0;1,0;;1,0;;;;;;1,0;;;;;;;1,0;5,0;;;33,0;;;;24,0;3,0;;;;;4,0;;;107,0;;;2,0;;8,0;357,0;;;;1,0;5,0;;2,0;70,0;2,0;1,0;1,0;;;;1,0;;;2,0;7,0;;;;;;;;;;;3,0;2,0;;;;;2,0;4,0;3,0;;1,0;12,0;;;;;1,0;;3,0;;1,0;1,0;;2,0;;;;;1,0;;;;;;2,0;;7,0;;7,0;;;2,0;;;1,0;4,0;;2,0;;;1,0;;1,0;3,0;;;52,0;;3,0;;;;;;2,0;;;;1,0;6,0;;5,0;5,0;;4,0;2,0;;3,0;;13,0;1,0;;;6,0;;;7,0;8,0;;;;;;;;;;2,0;5,0;;;;2,0;;;;2,0;;;;;;;;;;4,0;;;1,0;;;;1,0;;;;2,0;;;3,0;;1,0;;;;;;;;;;;;;;1,0;11,0;1,0;;;;2,0;;;;1,0;1,0;2,0;;1,0;2,0;;;;;;;;;;;;;;1,0;;;;;;;;;;;;;;;;;;;;;;;;1,0;;;;;;;;;;;;;;;;;;;1,0;;;4,0;1,0;;;1,0;;;;;1,0;;;;;;;;;4,0;;;1,0;;;;;;;;;;;;;;;;;;;;;4,0;;;;;;;;;;;;;;;;2,0;;;6,0;;;;;4,0;1,0;2,0;;;;;5,0;1,0;;1,0;;;;1,0;;;;;;;;;;9,0;;;;;3,0;;;7,0;;;1,0;;;;;;25,0;;;2,0;;;;;;;;;;;;;;1,0;;4,0;;18,0;;;;;;;;;;;;;;;;;;;;;3,0;;;;;;;;;;;;;1,0;1,0;;;;;;;;1,0;;;;;;;;;;;;;;4,0;;;;;;;3,0;;;;;;;2,0;;;;;;;;;;;;;;4,0;;;;;;;6,0;;;;;;;;;;;;;;;;;;;;;;;;;;;;;;;;1,0;1,0;;;1,0;;;;;1,0;;;;;;;;;;;2,0;;;;;;;;;;;;;;;;;;;;;;1,0;;;2,0;;;7,0;;;;;;;;1,0;;;;4,0;;;;1,0;;;;;;1,0;;;;;;4,0;;;;;;;;;;;;;;;2,0;;4,0;;;2,0;;;;;;3,0;4,0;;;4,0;5,0;;;;;;;;;10,0;;;;1,0;;;;1,0;8,0;;6,0;1,0;1,0;;;;;;;;2,0;;5,0;;;;;;1,0;;;;;;;;;;8,0;;;;;;;;;;;;;2,0;2,0;;;;;;;;;;;;;1,0;;;;;;;;;;;2,0;;;;;;;;;1,0;;;;;;;;;;;;;;;;;;;;;;;;;;4,0;;;;;;3,0;;;;;;;2,0;;;;;;;3,0;;;;;;;;;;;;;;;;;;;1,0;;;;;;;;;;;;1,0;2,0;;;4,0;;;1,0;;1,0;;;;;9,0;;;;;5,0;;;7,0;;;;;;;;;;;1,0;;;;;;;;;;;;;;;;;;;;;;
composition;;;1,0;;5,0;1,0;;1,0;4,0;;1,0;;2,0;;;6,0;;;;;;23,0;5,0;;14,0;;2,0;1,0;2,0;;1,0;;3,0;;3,0;;;1,0;;;;;2,0;;2,0;;6,0;8,0;5,0;15,0;1,0;;;;;;;;;;1,0;1,0;;;1,0;;1,0;8,0;3,0;;;;12,0;1,0;;;2,0;;;87,0;;5,0;;9,0;;;;;;1,0;5,0;;;1,0;;3,0;;;8,0;5,0;;;22,0;1,0;;;;;3,0;1,0;;7,0;;;1,0;2,0;7,0;2,0;;2,0;;;8,0;6,0;3,0;1,0;;;;6,0;;1,0;1,0;;;;;1,0;;;8,0;;;2,0;;;;8,0;1,0;3,0;;;;;3,0;;10,0;;;;2,0;3,0;11,0;;;;7,0;1,0;1,0;3,0;6,0;;;3,0;;8,0;;;;;;1,0;1,0;;;;;4,0;5,0;5,0;;;;1,0;2,0;;2,0;;;;;;5,0;;;;;;1,0;4,0;1,0;;;;;;;;;;;2,0;;;;;12,0;;4,0;;;;;;;;;;1,0;;;;;;;;;;;2,0;;;;;2,0;;1,0;;;;;45,0;;;2,0;1,0;;;;;;7,0;;;;;1,0;;1,0;9,0;;;;1,0;;;;;;;1,0;;;2,0;;;;;;;;3,0;;;;;;;;;;;;;;;;;;;;;2,0;;;;;;;1,0;;;;;;;;17,0;;;;;1,0;;3,0;;;;;2,0;;;;;;;;2,0;;;;;;;;;;;;;;;;;;;;;;;;;;;;2,0;;;;;;2,0;;;;;;;;;;;;;;;;;;;4,0;1,0;;1,0;5,0;;;;;;;;;;;;;;;;;2,0;2,0;;2,0;;;;;;;;1,0;;3,0;;;;;;;;;;;1,0;;2,0;;;;;;;;;;;;;;3,0;;2,0;6,0;;;;;;2,0;;;;;;5,0;;;1,0;;;;1,0;;;;2,0;2,0;;;;;;;;;;;;;5,0;;;1,0;;;;;;;;;;1,0;;;;;;;;;;;;5,0;;;;;;;;;;3,0;6,0;;4,0;;;;;;;1,0;;;;;;;12,0;;;;;;;2,0;;;;2,0;;;;;;1,0;1,0;;;;;;;;;;1,0;;1,0;;;;;;;;;;;;4,0;;;;;;2,0;;;;;;;;3,0;;;;;2,0;;;;;;;;;;;2,0;;;;;;;;;;;;;1,0;;;4,0;;;;;;;;;;;;;;;35,0;;;;;;;;;;;;;;;;;;;;;;;7,0;;2,0;;;;;;;2,0;;;;;;;;1,0;;;;;;;;;;;;;;;;;;;;;;;;;;;;;;;;;;2,0;;;1,0;;16,0;;;;;;;;;;;3,0;;;;;;;2,0;;;;;;;;;3,0;;;;;;;;;;;;;;;;;;1,0;;;;;;;;;;2,0;;;;;;;;;;;;;9,0;;;;;;;1,0;;;;;;;;;;;;;;;;;;;;;;;2,0;;;;;;;;;;;;;;;;;;;;;;;;;;;;;;;;;2,0;;;;;;;;;;;;;;;;;;;;;;;;;;;;;;;;;;1,0;;;;;;;;;;;;;;;7,0;;;;;;;;;;;;;;3,0;;;;;5,0;;;;3,0;;;;;;;;;;;;;;;;;;;;;;;1,0;;;;;;;;;2,0;;;;;1,0;;;;;;;;;;;;;;
compression;;;2,0;;;;;7,0;3,0;2,0;;2,0;;;8,0;20,0;;;;;;27,0;5,0;;;1,0;2,0;3,0;;1,0;1,0;;23,0;;1,0;6,0;;1,0;;5,0;109,0;3,0;23,0;2,0;17,0;18,0;11,0;26,0;29,0;10,0;;8,0;;;;1,0;2,0;;5,0;;1,0;2,0;6,0;;1,0;1,0;2,0;5,0;21,0;;3,0;;8,0;28,0;;13,0;;;;164,0;;24,0;2,0;20,0;1,0;1,0;;;;1,0;4,0;;;7,0;5,0;;4,0;1,0;33,0;;3,0;5,0;32,0;8,0;;;34,0;1,0;14,0;3,0;1,0;71,0;;;;7,0;16,0;2,0;1,0;14,0;;;12,0;21,0;8,0;;;;;2,0;;;;2,0;;;;1,0;2,0;4,0;3,0;;;4,0;18,0;;;5,0;8,0;4,0;1,0;;2,0;8,0;1,0;;30,0;;;;1,0;5,0;155,0;;;;93,0;;;;;3,0;;2,0;2,0;14,0;1,0;2,0;;;;2,0;2,0;;;9,0;;;;;78,0;;;3,0;;1,0;;1,0;;;;;;1,0;;;;;3,0;;4,0;;4,0;;;;;;;;11,0;;;;;7,0;;;2,0;;3,0;;;2,0;1,0;;;1,0;;3,0;2,0;;1,0;;;;;;70,0;;1,0;;;1,0;5,0;150,0;15,0;2,0;;;;;;11,0;;;;;;;;5,0;6,0;;;20,0;;;;1,0;;;;;;6,0;;;;;;;10,0;1,0;2,0;;4,0;;;;2,0;;;;;;1,0;3,0;;;6,0;22,0;13,0;;;2,0;;3,0;;2,0;;;;;;;;;;;;;;;;1,0;;;;;;;;;;;2,0;;1,0;;;;;;2,0;3,0;;6,0;2,0;;;;;;;;;;;4,0;;2,0;;;;;;;;;;;;1,0;;;;;;1,0;3,0;13,0;;;6,0;;;;;;;;;;;;;;;9,0;2,0;5,0;;;;;;;;;;;;3,0;;1,0;1,0;1,0;;;;1,0;9,0;;;;;;8,0;;;10,0;6,0;;1,0;2,0;10,0;;;3,0;;;;;170,0;5,0;;;;2,0;;;;;;;;;10,0;;;;;;2,0;4,0;5,0;11,0;;;8,0;;;1,0;;2,0;;4,0;2,0;2,0;;1,0;2,0;4,0;;;;;;;;;;;4,0;;;;1,0;;;6,0;;;5,0;;;;;;;;1,0;3,0;;4,0;13,0;1,0;;6,0;3,0;;;1,0;;;4,0;;;;;1,0;;3,0;;;16,0;;;5,0;;;1,0;1,0;;;;;;;;2,0;;;;1,0;;;1,0;1,0;;;;;;3,0;;;6,0;;;;;;;;;;1,0;;;;;2,0;6,0;;;;;;3,0;;;;;;4,0;;;;;;;;;;;;;;;;;;;;1,0;;1,0;2,0;;;;2,0;;;;;;;1,0;3,0;;;;;;;;;2,0;;;;2,0;;;;;;;;;3,0;4,0;;;4,0;;;;;;;;;;1,0;;;;;4,0;;1,0;;;;;;1,0;;;;;;;;;;;;;;;;;1,0;;2,0;;;;;;;;;;;;;;;1,0;;;;;;1,0;10,0;1,0;;6,0;10,0;;;;;;;;;;11,0;;;1,0;;;;;;;5,0;;;5,0;;;;22,0;;;;1,0;2,0;;;;;;;;;;;;;;;;;;1,0;;1,0;;3,0;;;;;;;;;2,0;;;1,0;;;;;;;4,0;;;1,0;;3,0;;1,0;;;;;;;1,0;9,0;;;2,0;2,0;;;;2,0;;;;;;;;2,0;;11,0;;;;;;2,0;;;7,0;;14,0;;;;;;1,0;;;;;;;;2,0;;;;;;;;;;;;;;;;;;5,0;1,0;;;;;2,0;1,0;;;;;;;3,0;;;;;;1,0;1,0;;;;;;;;;;;;;;;;;;;;5,0;;;;;;;3,0;;;;;;;;;;;;;;;2,0;1,0;1,0;;;;;;;;3,0;;;;;;;;;;;;;;;;2,0;;;;;;;;;;;;;;;6,0;;;;;;;;;;;
constitute;;;1,0;;;;;5,0;2,0;2,0;31,0;1,0;;;1,0;7,0;;;1,0;;;4,0;;;;;;;1,0;;1,0;3,0;1,0;;9,0;;;6,0;;;10,0;1,0;;1,0;;3,0;;8,0;;7,0;4,0;2,0;;2,0;7,0;2,0;80,0;;;;;;;2,0;;4,0;4,0;6,0;3,0;1,0;1,0;;;;;6,0;;;5,0;33,0;4,0;5,0;;9,0;2,0;;1,0;;;3,0;175,0;;;;;;1,0;;4,0;;;;8,0;9,0;;;11,0;1,0;6,0;2,0;2,0;;;;2,0;10,0;14,0;12,0;4,0;3,0;;;;;1,0;;;;;;;;1,0;;2,0;;6,0;;;5,0;;;;9,0;;;;9,0;;1,0;;;3,0;1,0;;;34,0;;;;1,0;;101,0;;;;;;;1,0;13,0;1,0;;2,0;6,0;5,0;;2,0;1,0;;;10,0;;;;5,0;;9,0;;2,0;;;;3,0;;;;;1,0;4,0;;;;2,0;12,0;;;;;1,0;;;;;;;1,0;;;4,0;8,0;;1,0;;;;2,0;;4,0;;3,0;2,0;;;;8,0;1,0;;;1,0;;;2,0;;;1,0;;;80,0;1,0;;2,0;;;;;;1,0;;11,0;;2,0;;2,0;7,0;;;1,0;;;;4,0;1,0;;;1,0;;3,0;2,0;6,0;5,0;;;1,0;;4,0;;;;;;2,0;2,0;;;;;;2,0;;3,0;;;;;;2,0;10,0;4,0;2,0;;2,0;2,0;;1,0;;;;;;1,0;;;;;;;;;;;;;;;2,0;;;4,0;3,0;;;;2,0;;;2,0;;4,0;1,0;;;9,0;;;;;5,0;;;;;1,0;;;;;4,0;;;;;;;;;;;;;;;;;;;;;;3,0;;;;;;;;1,0;3,0;;;;;;;;;;;2,0;1,0;;;;;;;;1,0;;;;;;;;;2,0;;;;3,0;;;;;;;;;;;;;8,0;;1,0;;;3,0;;;;;;;;;;;;;;;;;;;;;;;;;;;6,0;;;;5,0;;;2,0;;;;;;2,0;;;;;;;;;;;2,0;;;6,0;3,0;;;;;;;;;;;;;;;;;1,0;;15,0;;;;;;;;;1,0;;;;6,0;2,0;;;;2,0;;;;;2,0;;;;;;;;;1,0;;;;;;;4,0;;;;;;;;;;;;;;;;;;;;;;;;;;2,0;;;;;;;;;;1,0;;2,0;;;;;4,0;;;;;;;;;;;;;;;;;;;;;18,0;;;;3,0;;;1,0;;;;;;;2,0;;;;;;;1,0;;;;;;;;;;;;;;;;;1,0;;1,0;;;;;;;;;;;;;;;;;;;1,0;;;3,0;1,0;;;;;;;;;;;;;;;;;;;;;;1,0;;;;;;;;;;;;;;6,0;;1,0;;;;;;;;;;;;;;;;1,0;;;;;;;;;;;;;;;;;;4,0;;;5,0;;;5,0;;;;;;2,0;;1,0;;;;3,0;;2,0;;;;;;;;5,0;;;6,0;;;;;;;;;;;;2,0;1,0;;;6,0;;;;1,0;;1,0;;;;;1,0;;;;;;;;;;;;1,0;;;6,0;;;;;;;;;;;;1,0;;;;;;;;;;;;1,0;;;;;;;;;;;;;;;;;;;;;;;;;;;;;;;;;;;;;;;;;;1,0;;;;;;;;;;;;;;;;;;;2,0;;;;;4,0;;;;;;1,0;;;;;;2,0;;;;;;;;;1,0;3,0;;;;;;1,0;;;;;;7,0;1,0;;;;2,0;;;;;;;;;;;;;;;;;3,0;;;;;;;;;;;;;;;;;;;
coordinate;;;4,0;;6,0;72,0;;33,0;79,0;5,0;20,0;;40,0;2,0;98,0;197,0;;;1,0;27,0;133,0;42,0;1,0;;30,0;4,0;61,0;1,0;;;50,0;;36,0;1,0;28,0;11,0;2,0;23,0;4,0;;79,0;;292,0;74,0;45,0;3,0;308,0;87,0;19,0;77,0;;76,0;2,0;4,0;7,0;3,0;10,0;13,0;22,0;;2,0;5,0;18,0;;1,0;1,0;3,0;12,0;85,0;;17,0;;21,0;1,0;1,0;6,0;31,0;;;475,0;22,0;36,0;1,0;36,0;;17,0;;;1,0;7,0;19,0;3,0;;;23,0;2,0;3,0;3,0;151,0;4,0;12,0;6,0;24,0;120,0;;6,0;105,0;4,0;42,0;36,0;6,0;39,0;;2,0;;120,0;42,0;227,0;;16,0;;;26,0;21,0;36,0;2,0;1,0;2,0;;38,0;;190,0;69,0;2,0;59,0;6,0;46,0;18,0;15,0;1,0;19,0;4,0;;58,0;21,0;1,0;;22,0;4,0;8,0;20,0;;7,0;24,0;12,0;;1032,0;;77,0;;8,0;12,0;73,0;;1,0;;39,0;69,0;2,0;;38,0;;;;21,0;19,0;1,0;;;1,0;10,0;;;;;;;14,0;;;;;;13,0;;1,0;;1,0;;;55,0;5,0;23,0;42,0;39,0;;;4,0;3,0;19,0;;;;;3,0;2,0;;;16,0;;;;1,0;;11,0;;;;24,0;;;;17,0;2,0;9,0;3,0;21,0;;;5,0;3,0;2,0;;3,0;3,0;;;;117,0;125,0;;;2,0;;;1,0;17,0;;;;;;;66,0;;1,0;2,0;;;;;25,0;28,0;;2,0;;14,0;17,0;;28,0;4,0;1,0;2,0;;;8,0;4,0;4,0;;;35,0;18,0;;;;;;;;;;9,0;;2,0;;4,0;;3,0;;6,0;6,0;;;;6,0;;;;;;;;;2,0;4,0;;;;6,0;1,0;;;;;;6,0;24,0;;;;;2,0;;;;6,0;;1,0;20,0;13,0;;15,0;;6,0;;;;480,0;1,0;;;43,0;;;;;;13,0;;;19,0;;;;1,0;;1,0;;29,0;79,0;;;;;;1,0;;;3,0;;3,0;117,0;12,0;;;;1,0;;4,0;7,0;;2,0;;4,0;;;;;13,0;165,0;20,0;27,0;11,0;12,0;30,0;;;4,0;12,0;1,0;1,0;1,0;2,0;2,0;;3,0;4,0;71,0;3,0;;;67,0;6,0;20,0;94,0;4,0;17,0;95,0;;4,0;2,0;25,0;7,0;;;1,0;17,0;;25,0;1,0;;;;31,0;;16,0;3,0;3,0;;24,0;;;;1,0;;;;5,0;8,0;10,0;8,0;12,0;6,0;27,0;17,0;1,0;59,0;2,0;;1,0;31,0;5,0;;139,0;;;1,0;4,0;3,0;98,0;;10,0;1,0;3,0;1,0;2,0;;1,0;6,0;45,0;;;1,0;5,0;1,0;1,0;3,0;;;2,0;5,0;10,0;16,0;1,0;1,0;;11,0;;;2,0;2,0;;;31,0;;2,0;;;12,0;;;5,0;;;2,0;;25,0;4,0;;;;;;12,0;;;;;;;;;14,0;6,0;1,0;;1,0;;;;2,0;4,0;1,0;1,0;1,0;8,0;;6,0;;3,0;127,0;2,0;8,0;;;12,0;;;1,0;1,0;8,0;1,0;;16,0;1,0;31,0;;;;;1,0;;;;;3,0;;;32,0;;19,0;2,0;;;;;;;;;;4,0;1,0;;;;3,0;2,0;;2,0;;15,0;;1,0;;;56,0;7,0;;;3,0;;;;;;1,0;;1,0;2,0;;;6,0;;;;25,0;;21,0;;;4,0;;;;;;2,0;;;;;;;26,0;30,0;;1,0;;1,0;;;1,0;1,0;;;;7,0;;;;6,0;6,0;;;13,0;;;;;;7,0;;;;1,0;10,0;6,0;;;;;;2,0;;5,0;4,0;54,0;;;;;;13,0;;;1,0;;;;;;;;;;;2,0;6,0;;;;34,0;;1,0;;;;;;;;;5,0;;;;38,0;;;;;16,0;;;2,0;6,0;;1,0;;;;;1,0;;2,0;;;;;;;3,0;32,0;;;;6,0;45,0;2,0;2,0;;;;;;6,0;;;3,0;;95,0;;1,0;2,0;;;;3,0;1,0;1,0;;;;;2,0;1,0;;7,0;40,0;2,0;;;;;;4,0;;;;;;;3,0;;;;;;;;10,0;10,0;;3,0;10,0;;;;;;1,0;;2,0;2,0;;;1,0;;;;;1,0;6,0;;2,0;1,0;1,0;32,0;1,0;;;;;;7,0;;;;11,0;;;;;;;9,0;;;;;;5,0;;1,0;;;16,0;;1,0;;9,0;;;;;;;2,0;;3,0;;;1,0;80,0;;;;;;;;;;14,0;;3,0;;37,0;15,0;55,0;;2,0;21,0;;;;;1,0;2,0;4,0;;;11,0;;;1,0;;132,0;1,0;;;;;4,0;;4,0;;1,0;;;31,0;;52,0;;;;1,0;;;;18,0;;;2,0;2,0;;;;;;;;;25,0;;;2,0;;;;35,0;6,0;1,0;;2,0;2,0;;;;;;;;;4,0;;;;1,0
correspondence;;;2,0;;;7,0;2,0;1,0;22,0;8,0;10,0;;18,0;;1,0;42,0;;;4,0;;17,0;4,0;;;;1,0;11,0;1,0;;;;4,0;7,0;;9,0;;5,0;9,0;;;26,0;;;1,0;10,0;15,0;94,0;2,0;4,0;5,0;2,0;3,0;1,0;10,0;;14,0;3,0;3,0;2,0;;;1,0;5,0;;5,0;1,0;2,0;19,0;1,0;;6,0;;7,0;;1,0;;2,0;;;100,0;;1,0;1,0;7,0;;;;3,0;;3,0;13,0;;;;;2,0;1,0;;34,0;;;;10,0;43,0;;;;;5,0;;;7,0;;;;25,0;9,0;28,0;;10,0;;;2,0;6,0;1,0;1,0;;9,0;;7,0;;1,0;1,0;4,0;;;11,0;;;;3,0;;;4,0;7,0;;;;12,0;2,0;1,0;;4,0;5,0;2,0;;9,0;;;;1,0;;34,0;;;;5,0;6,0;;;;;;1,0;;;1,0;;;;;1,0;;2,0;;4,0;;23,0;;;;;;2,0;1,0;;;;;;1,0;;6,0;3,0;2,0;;;;10,0;9,0;;;;;;;;;2,0;1,0;1,0;;;;;;;;4,0;;;;;13,0;1,0;3,0;;2,0;;;3,0;;;;;;;;44,0;2,0;;;;;;;1,0;;;;;;;6,0;;3,0;;;;;;;6,0;;;;;;;11,0;;;;;;6,0;;;;;;;1,0;;;;;;;;;;;;;;;;;;;;;;;;;;;;;;;;;;;;;;;;;;;4,0;2,0;;;;;;;2,0;;;;;;;;1,0;;;;;;29,0;;;2,0;;;;;;;;;;7,0;;;;1,0;;;;;14,0;;;;;1,0;;;;;;;3,0;;;;1,0;;;;;;;;;;;;;1,0;14,0;4,0;;;;2,0;;;1,0;;;;;;6,0;;;;25,0;;2,0;;1,0;8,0;3,0;9,0;;5,0;;1,0;;;;;;;;1,0;;;;4,0;;;;;9,0;;;;2,0;3,0;;;4,0;;;;;8,0;20,0;;;;;3,0;;;;;;;;1,0;;2,0;;;;;5,0;;;;3,0;;;;;;2,0;;;;10,0;1,0;;;;2,0;;;;;;;;;;;;;;;1,0;;;;;;;;;;;;;9,0;4,0;;;;2,0;;;;;;;;2,0;;;;;;;;;;;1,0;;;5,0;;;;;;;2,0;;;;;;;;;;4,0;;;;12,0;1,0;1,0;;;;;2,0;;3,0;1,0;;;;6,0;;3,0;;;;;2,0;;;;;;5,0;;;;;;1,0;;;;1,0;;;;;5,0;;;;;;;;;;;;;;;;1,0;;;;;;5,0;6,0;;;;;;;;;;;;;;1,0;;3,0;;;;;2,0;;2,0;3,0;;;;;;;;;;;;;;;;;;;;;;;1,0;;;;;;;;;;;;;;;;;;;;;;;;;;;;;;;2,0;;;;;;;1,0;;;;;;;;;;;2,0;;3,0;;;;;;;2,0;;;;;;;1,0;;;5,0;1,0;;11,0;;;;;;7,0;;;;;8,0;;;7,0;;;;;;;1,0;5,0;;6,0;;;;;;;;;2,0;;;;;;;;2,0;;;1,0;;;;2,0;8,0;;;;;;;3,0;;2,0;;;;;;;;;;2,0;;;;;;;;;6,0;;;;;;;;;;;;;;;;;;;;;;;;;;;1,0;;;;;;;;;;;;;;;;;;;;1,0;;;;;;;;;;;;;1,0;;;;;;;;;;;;;;;5,0;;;;8,0;;;;5,0;3,0;;;;;;;;;;;;;;;1,0;3,0;;8,0;;;1,0;;;3,0;2,0;;;;;;1,0;;;;;;;;;;;;;;;;;;;;;;2,0;;;;;;;;;;3,0;;;;;;;;
curve;;;2,0;;;13,0;;11,0;22,0;2,0;2,0;;19,0;;11,0;30,0;1,0;1,0;4,0;1,0;21,0;3,0;11,0;6,0;;1,0;21,0;1,0;;2,0;4,0;;22,0;1,0;12,0;;8,0;17,0;3,0;6,0;2,0;1,0;44,0;11,0;10,0;8,0;13,0;22,0;7,0;4,0;2,0;9,0;6,0;;;34,0;8,0;;1,0;;10,0;1,0;1,0;;;9,0;60,0;47,0;3,0;11,0;13,0;2,0;18,0;;;4,0;1,0;;1,0;83,0;1,0;11,0;;50,0;1,0;;;;;3,0;45,0;;;1,0;;4,0;;;34,0;1,0;1,0;3,0;18,0;5,0;11,0;5,0;24,0;;7,0;2,0;2,0;12,0;2,0;;;50,0;68,0;16,0;;9,0;1,0;3,0;7,0;19,0;4,0;;1,0;;31,0;8,0;;32,0;11,0;;4,0;;7,0;31,0;3,0;;6,0;1,0;;66,0;1,0;;2,0;26,0;3,0;;;;;10,0;;;13,0;;1,0;;4,0;;16,0;;8,0;;8,0;2,0;;;2,0;;;1,0;;9,0;15,0;4,0;1,0;;;15,0;;3,0;;;;29,0;1,0;;;;5,0;12,0;;7,0;;;3,0;11,0;6,0;;1,0;10,0;5,0;5,0;;;1,0;13,0;1,0;14,0;1,0;;1,0;;2,0;3,0;2,0;14,0;9,0;1,0;4,0;;;;;;14,0;;36,0;;40,0;13,0;1,0;8,0;1,0;3,0;;4,0;;;;14,0;;;;;10,0;6,0;5,0;;1,0;2,0;;;13,0;9,0;6,0;;;1,0;;17,0;;1,0;38,0;;;;;20,0;6,0;;;7,0;1,0;;12,0;113,0;;;;;;6,0;;;2,0;4,0;4,0;;;;19,0;1,0;5,0;;3,0;;2,0;5,0;;;;;;1,0;14,0;3,0;;3,0;;1,0;5,0;3,0;;;2,0;1,0;2,0;;2,0;5,0;3,0;;8,0;2,0;;4,0;;;3,0;;;4,0;;11,0;;;4,0;1,0;1,0;;;1,0;1,0;;7,0;17,0;3,0;;;;2,0;3,0;9,0;24,0;2,0;;1,0;2,0;1,0;5,0;;3,0;;3,0;23,0;4,0;;;;;;;2,0;3,0;3,0;2,0;;;6,0;;;10,0;1,0;;4,0;16,0;8,0;10,0;;1,0;;3,0;;1,0;4,0;;;;;1,0;;;1,0;1,0;1,0;10,0;11,0;;1,0;;10,0;3,0;;;1,0;;;1,0;5,0;;;4,0;;2,0;;;;7,0;;18,0;7,0;;4,0;4,0;;;2,0;1,0;7,0;;;5,0;;;3,0;;;6,0;;1,0;;;1,0;1,0;1,0;;;;;4,0;;;;;;37,0;;;;10,0;2,0;1,0;;;;3,0;;14,0;3,0;2,0;;;;;2,0;9,0;;1,0;;1,0;;;;;5,0;;4,0;;;1,0;9,0;4,0;;;;;;;;;5,0;;;;;;;;;8,0;;4,0;;1,0;;;;1,0;;3,0;;;4,0;;;;;;;;;2,0;;;;;;1,0;2,0;;;1,0;;;;;;1,0;;35,0;3,0;;;;;12,0;;;;;;1,0;;7,0;;;;;;;17,0;1,0;;;;;;1,0;;11,0;;;;;1,0;1,0;;;;;;5,0;;;;;;;3,0;;;;;;1,0;2,0;;;;;1,0;;18,0;;;;;;;7,0;;3,0;;12,0;;;;;;;;2,0;;;;;;;;1,0;2,0;;29,0;;;2,0;;;;4,0;31,0;1,0;;2,0;;;;9,0;;;;;;4,0;3,0;;1,0;3,0;;1,0;;1,0;;2,0;1,0;;;2,0;1,0;;;;6,0;;;;;;;;2,0;2,0;1,0;;;2,0;;;;6,0;;;;;;;;;;;;;3,0;;2,0;;1,0;;2,0;;;;5,0;1,0;;2,0;2,0;;;1,0;;;;;2,0;;;;1,0;;;;;;1,0;;;;;;1,0;;;;;;;;;7,0;;;;;;1,0;;;;;;;;;;;;;2,0;1,0;;;;2,0;;;10,0;;;;;;1,0;;2,0;;;;;1,0;;;2,0;;;;;21,0;;;;;1,0;;1,0;6,0;;8,0;7,0;;1,0;1,0;;;;;;;2,0;;;;;1,0;;;;;;1,0;4,0;;;2,0;2,0;;;;;;;;;;;4,0;;;;;;;;;;;2,0;3,0;;;;;;4,0;;;;;;;;;;;;;2,0;;;;;;;2,0;;;;;;1,0;;;2,0;;;;;;;2,0;;1,0;4,0;;;;2,0;;;;;;2,0;;;1,0;;;;1,0;;1,0;;;;;;;;1,0;2,0;;2,0;;;;;;;;;;;;;;;;;6,0;1,0;;;1,0;2,0;;30,0;;;;;;1,0;;;;;;;;;;;;;
desire;;;4,0;;;27,0;4,0;7,0;51,0;2,0;7,0;;4,0;;2,0;20,0;2,0;;1,0;;;10,0;;;;;2,0;7,0;;;4,0;;9,0;;28,0;1,0;2,0;;;9,0;11,0;;4,0;3,0;4,0;1,0;55,0;16,0;9,0;15,0;1,0;19,0;;;13,0;6,0;4,0;1,0;;;2,0;;4,0;4,0;3,0;4,0;17,0;3,0;2,0;2,0;15,0;;13,0;;;1,0;3,0;1,0;6,0;73,0;1,0;10,0;;14,0;;2,0;1,0;;1,0;2,0;19,0;;;1,0;2,0;2,0;;;40,0;1,0;6,0;2,0;7,0;16,0;;;5,0;3,0;3,0;10,0;;4,0;;;;24,0;15,0;67,0;;7,0;;;;2,0;8,0;2,0;;;1,0;;;3,0;7,0;;1,0;2,0;7,0;9,0;4,0;1,0;12,0;;5,0;8,0;12,0;8,0;;;7,0;16,0;1,0;;2,0;9,0;10,0;;16,0;;4,0;;;7,0;23,0;;;;12,0;6,0;;;7,0;;;;6,0;;3,0;2,0;;;;1,0;;;;;;;;;;;;4,0;;1,0;;;;;;;;16,0;2,0;;1,0;;1,0;1,0;;;;;;;;;4,0;2,0;2,0;1,0;1,0;;;;;;36,0;2,0;1,0;;;5,0;7,0;14,0;19,0;1,0;;;2,0;;1,0;7,0;;;2,0;;16,0;;;;;;;;20,0;3,0;6,0;;;;4,0;25,0;;;7,0;;5,0;2,0;;5,0;7,0;1,0;;2,0;;1,0;1,0;1,0;;;;1,0;;6,0;;;;1,0;48,0;5,0;;2,0;2,0;;;;;;1,0;2,0;1,0;;;2,0;;5,0;;2,0;;;;;;;6,0;;;1,0;;1,0;;;2,0;;2,0;1,0;;;;;;;;;;;;3,0;;;;;;;11,0;9,0;;15,0;;;2,0;;;2,0;1,0;65,0;1,0;;3,0;;;;;;;2,0;;;1,0;;;3,0;;;;;4,0;2,0;;;;;;;1,0;;;2,0;;13,0;;2,0;;;1,0;;;2,0;1,0;;;2,0;;;;3,0;;10,0;4,0;;17,0;1,0;1,0;;1,0;1,0;1,0;;;;;1,0;;;;8,0;;;;3,0;10,0;3,0;21,0;;1,0;1,0;;;4,0;5,0;19,0;;4,0;;6,0;1,0;21,0;;;;;4,0;;3,0;4,0;1,0;;;;;4,0;3,0;1,0;1,0;;4,0;1,0;9,0;;;1,0;3,0;29,0;;1,0;4,0;;;8,0;3,0;1,0;5,0;1,0;;;;;;;1,0;1,0;;1,0;3,0;;2,0;3,0;;3,0;;2,0;3,0;4,0;4,0;;;1,0;;5,0;4,0;16,0;;4,0;;;;;;;1,0;3,0;4,0;4,0;;;1,0;;;;;16,0;;;;21,0;1,0;;;;;;;;3,0;3,0;1,0;2,0;17,0;;;2,0;;1,0;2,0;;;;1,0;;;;;;2,0;;1,0;;;1,0;4,0;4,0;;;;;;;;2,0;;;;2,0;1,0;;;4,0;;;;;;1,0;;;1,0;1,0;;1,0;;9,0;;;;;;;;1,0;;;;;;;15,0;;1,0;;;;;;1,0;16,0;;;4,0;3,0;;;;2,0;12,0;1,0;2,0;;;;1,0;1,0;;1,0;;;;8,0;;;;1,0;;;;;;;;;1,0;;;2,0;;1,0;8,0;;;1,0;;3,0;;;;;;;;;2,0;2,0;;;1,0;;;;;;;;;;4,0;;;;;;2,0;;;;1,0;;1,0;;;;;;;;;;2,0;4,0;;;;;;2,0;;;1,0;;1,0;;;;;4,0;;;;;2,0;4,0;;;;;;;;;;;;;;;;;1,0;;;;;;;1,0;;10,0;;;5,0;;1,0;1,0;2,0;;2,0;;1,0;;;;8,0;;;4,0;6,0;;;;3,0;;;;;;;;;;;1,0;;;;;;;;;;;;;1,0;;2,0;1,0;;;;2,0;;2,0;;1,0;;;;;;;2,0;;;;;;;;1,0;;;;1,0;;;;;;;1,0;;;;;;;;;;3,0;;;;;2,0;14,0;;;;;;;;;;;;;1,0;1,0;;;;;;;;;;;3,0;;;;;;;2,0;;;;7,0;;;;;;;;;;;;;2,0;1,0;;25,0;5,0;1,0;1,0;;1,0;;;;;;;14,0;;;4,0;;;;;;;;;;;2,0;;;;;;;;;;1,0;;1,0;5,0;;;;;;;2,0;;;;;1,0;;;;;;;;;;;;;;;3,0;;;;;;;;;;5,0;;;;;
determination;;;1,0;2,0;3,0;7,0;5,0;33,0;34,0;2,0;3,0;;5,0;;2,0;125,0;1,0;;33,0;;7,0;41,0;4,0;;;6,0;;;;1,0;2,0;9,0;82,0;46,0;68,0;25,0;1,0;24,0;;;83,0;;2,0;5,0;28,0;28,0;390,0;120,0;25,0;41,0;4,0;27,0;;3,0;5,0;9,0;2,0;3,0;12,0;;2,0;4,0;6,0;;5,0;3,0;45,0;3,0;50,0;1,0;12,0;3,0;18,0;3,0;;1,0;1,0;;5,0;228,0;3,0;10,0;;56,0;1,0;11,0;4,0;1,0;;10,0;24,0;;;;1,0;8,0;8,0;;99,0;5,0;2,0;;31,0;66,0;;5,0;3,0;;47,0;20,0;;131,0;;;;50,0;3,0;131,0;8,0;26,0;;;22,0;55,0;10,0;5,0;;;1,0;26,0;;25,0;1,0;;;;5,0;70,0;;6,0;41,0;;6,0;11,0;18,0;;;1,0;74,0;4,0;;;14,0;13,0;65,0;2,0;41,0;;1,0;17,0;3,0;4,0;460,0;7,0;2,0;;16,0;14,0;;1,0;10,0;;;4,0;28,0;;2,0;;;;;12,0;;;2,0;45,0;;12,0;;;2,0;3,0;;4,0;;;;;;;;;15,0;16,0;3,0;;1,0;;14,0;2,0;;;;;;;;;4,0;;;;;;;;;;28,0;;;;2,0;2,0;;4,0;12,0;;;;3,0;2,0;;1,0;2,0;;;4,0;51,0;11,0;;;;;;;23,0;1,0;;;;;;10,0;;;1,0;;1,0;;;2,0;;;;;9,0;1,0;;7,0;7,0;;2,0;;2,0;16,0;1,0;5,0;;;11,0;;;;;;;;;;2,0;;;;;;;16,0;1,0;5,0;1,0;5,0;;;7,0;1,0;;;;1,0;;;;;4,0;;;;;;;;;;;19,0;;;7,0;;;;;34,0;5,0;3,0;;;6,0;2,0;;;4,0;4,0;;;;19,0;;;;;;;;;;;;;5,0;;;32,0;;;;;;;;;3,0;;;1,0;;;2,0;24,0;;97,0;2,0;;;1,0;;46,0;;;2,0;;2,0;12,0;;;2,0;3,0;9,0;29,0;24,0;12,0;19,0;;2,0;2,0;;6,0;;;;1,0;1,0;;;;2,0;7,0;1,0;1,0;;19,0;56,0;;9,0;2,0;30,0;6,0;25,0;;5,0;17,0;11,0;1,0;5,0;4,0;28,0;2,0;4,0;19,0;36,0;;;3,0;;16,0;6,0;1,0;;1,0;13,0;;;12,0;;;;1,0;69,0;8,0;8,0;;4,0;44,0;8,0;;4,0;4,0;15,0;;10,0;5,0;21,0;11,0;2,0;13,0;;2,0;1,0;;;3,0;10,0;27,0;;;;10,0;3,0;;12,0;;1,0;2,0;7,0;;2,0;;8,0;;;2,0;;;;;2,0;5,0;2,0;8,0;2,0;8,0;;20,0;;1,0;;;1,0;7,0;1,0;22,0;1,0;;5,0;;8,0;;;1,0;;;;13,0;;;3,0;;;12,0;6,0;;1,0;;;2,0;;2,0;;;4,0;;;7,0;;1,0;;3,0;;5,0;;3,0;;;;1,0;;;;;;;;;1,0;1,0;;1,0;;;1,0;;;;;;;;4,0;;;;2,0;;1,0;5,0;5,0;;;;2,0;;;;;4,0;;1,0;;;1,0;10,0;2,0;2,0;1,0;;65,0;2,0;2,0;5,0;2,0;;6,0;;6,0;;;;;2,0;1,0;1,0;;;1,0;;;;4,0;11,0;;12,0;;;1,0;;4,0;1,0;;;;;6,0;1,0;4,0;1,0;;6,0;;2,0;6,0;;;1,0;1,0;;;;;;;;2,0;;;;1,0;;;;;;2,0;;1,0;;;2,0;;;;;2,0;;;;;24,0;1,0;;;;;;;;;;;;;;;;2,0;;;;1,0;;;2,0;;;;9,0;;2,0;;;;;;;;;;;;;;;;;;;;;1,0;;;;1,0;4,0;4,0;2,0;2,0;2,0;;1,0;;;20,0;1,0;;;11,0;;1,0;7,0;;;;;;1,0;;;4,0;1,0;;;;4,0;;;;;2,0;;11,0;;1,0;4,0;;6,0;;;11,0;;6,0;;;2,0;;4,0;;1,0;;6,0;;1,0;;;2,0;;;;2,0;;;4,0;;2,0;7,0;;;;;;;;2,0;;17,0;2,0;;3,0;;17,0;5,0;;4,0;1,0;;;;3,0;;;1,0;;;;;2,0;1,0;;;;;5,0;6,0;;1,0;;;;;;;;;;5,0;;;1,0;;;;;;;;;1,0;;;;;2,0;;;;;;;;;;;;;;;;;3,0;;;;;1,0;;1,0;;8,0;7,0;;;;;;;;;;;;;;;;4,0;;4,0;;2,0;;;;;;;;;;;;8,0;;;;12,0;;;1,0;;;;48,0;;;;;;;;3,0;;2,0;;;;;;;;;1,0;;;;4,0;;;;;
difference;;;2,0;;9,0;22,0;3,0;29,0;30,0;8,0;16,0;;22,0;4,0;9,0;183,0;3,0;12,0;57,0;2,0;13,0;19,0;2,0;3,0;2,0;25,0;225,0;1,0;;3,0;2,0;3,0;85,0;17,0;45,0;2,0;27,0;39,0;15,0;;143,0;11,0;14,0;19,0;56,0;87,0;215,0;40,0;18,0;15,0;;44,0;2,0;9,0;9,0;62,0;84,0;25,0;21,0;;5,0;;11,0;3,0;32,0;35,0;44,0;40,0;135,0;;37,0;8,0;59,0;3,0;2,0;8,0;22,0;;10,0;429,0;;11,0;;54,0;19,0;;1,0;1,0;;64,0;36,0;;;7,0;21,0;3,0;6,0;;139,0;1,0;1,0;3,0;24,0;73,0;;6,0;33,0;9,0;195,0;85,0;2,0;28,0;4,0;;;105,0;66,0;83,0;1,0;113,0;;;13,0;34,0;12,0;1,0;2,0;4,0;3,0;2,0;4,0;86,0;45,0;;22,0;1,0;28,0;3,0;9,0;1,0;14,0;;3,0;53,0;10,0;2,0;;3,0;188,0;12,0;2,0;;12,0;32,0;21,0;9,0;32,0;;9,0;1,0;8,0;7,0;114,0;1,0;1,0;;73,0;9,0;1,0;17,0;40,0;2,0;;44,0;58,0;9,0;;1,0;;;;1,0;;;20,0;17,0;;14,0;1,0;;;;;5,0;;5,0;;1,0;17,0;;;;;47,0;14,0;;;1,0;5,0;15,0;7,0;;3,0;;;;;;8,0;1,0;;3,0;6,0;;2,0;2,0;8,0;;46,0;;;;1,0;;1,0;4,0;7,0;4,0;3,0;;3,0;2,0;1,0;19,0;178,0;;6,0;1,0;338,0;6,0;4,0;;;;3,0;4,0;7,0;4,0;;27,0;;;;25,0;5,0;;2,0;2,0;14,0;;;13,0;18,0;;3,0;1,0;5,0;2,0;;17,0;2,0;5,0;6,0;15,0;8,0;148,0;8,0;;;;16,0;14,0;16,0;;;;1,0;;;;3,0;3,0;1,0;;4,0;;5,0;19,0;;;2,0;12,0;2,0;;3,0;17,0;;;;1,0;;;5,0;;5,0;;;;3,0;;;;3,0;;;45,0;;;14,0;;;;;;5,0;;;2,0;1,0;33,0;4,0;;1,0;5,0;1,0;;;19,0;;4,0;;;;;;;;;;6,0;3,0;2,0;;6,0;;;;;1,0;1,0;;;1,0;;;3,0;2,0;;;9,0;1,0;53,0;10,0;;;7,0;;3,0;;2,0;;;;;;;19,0;2,0;21,0;246,0;23,0;26,0;113,0;4,0;34,0;2,0;;;1,0;2,0;3,0;;6,0;15,0;;3,0;10,0;3,0;34,0;15,0;;7,0;129,0;2,0;32,0;20,0;14,0;31,0;6,0;2,0;4,0;120,0;11,0;;;17,0;13,0;2,0;6,0;4,0;15,0;3,0;8,0;37,0;5,0;7,0;;;1,0;;1,0;2,0;;2,0;1,0;;;;187,0;1,0;;1,0;1,0;4,0;2,0;3,0;44,0;;37,0;1,0;30,0;3,0;4,0;1,0;23,0;129,0;;6,0;;1,0;;;2,0;;3,0;6,0;;5,0;;7,0;3,0;;;5,0;15,0;16,0;1,0;;63,0;;2,0;;;;1,0;;2,0;;4,0;;6,0;4,0;4,0;8,0;;;;;2,0;3,0;;32,0;1,0;2,0;;;40,0;8,0;;4,0;1,0;;;31,0;;13,0;22,0;1,0;;3,0;;;1,0;8,0;3,0;;;;;;;4,0;;30,0;1,0;2,0;;;;;7,0;;;;;;;1,0;9,0;4,0;32,0;2,0;;;5,0;9,0;;1,0;;;7,0;;;1,0;;;;;2,0;1,0;6,0;;4,0;2,0;1,0;1,0;5,0;;;;;;6,0;;;;;3,0;;;1,0;;;3,0;1,0;2,0;26,0;;;3,0;4,0;;;;3,0;;4,0;1,0;;;9,0;;;;;;1,0;;3,0;;1,0;4,0;;1,0;;;1,0;2,0;2,0;;6,0;26,0;3,0;;14,0;1,0;;15,0;;;1,0;;5,0;10,0;;1,0;;;;;;;;;;6,0;1,0;;;;1,0;15,0;;;;;;;;;;;;;;;;15,0;6,0;;;;;2,0;;;;;2,0;;9,0;;6,0;;12,0;10,0;2,0;;;1,0;2,0;;1,0;;2,0;;1,0;;;7,0;;1,0;;;;;;;;;;;;3,0;;1,0;;;4,0;13,0;9,0;;;1,0;5,0;2,0;5,0;7,0;;;;1,0;6,0;34,0;;1,0;;;8,0;80,0;;5,0;1,0;5,0;1,0;13,0;8,0;;20,0;19,0;6,0;3,0;;1,0;4,0;;;1,0;9,0;;63,0;1,0;16,0;31,0;5,0;6,0;;;48,0;;5,0;25,0;;13,0;;;10,0;;;1,0;1,0;;;5,0;7,0;19,0;;;;2,0;;42,0;9,0;2,0;14,0;5,0;;;;;1,0;;;;;;;;;3,0;3,0;;1,0;2,0;;;;;16,0;;;6,0;4,0;;;15,0;;;;;;2,0;;;;;;;;;;;3,0;;3,0;;;5,0;;2,0;4,0;;;;;;12,0;;52,0;;;;4,0;9,0;57,0;;;;6,0;;;;;;;5,0;24,0;;9,0;2,0;;;;2,0;;;;1,0;;;6,0;4,0;;2,0;;1,0;25,0;;;;;2,0;;2,0;1,0;;2,0;;1,0;;;3,0;3,0;;;;9,0;2,0;;3,0;10,0;13,0;;1,0;;4,0;2,0;3,0;;;;6,0;4,0;;;5,0;;;;;;11,0;;;;;;;;;2,0;;;12,0;;4,0;;;;
dimensional;;;1,0;;2,0;21,0;4,0;15,0;37,0;28,0;89,0;;38,0;1,0;14,0;24,0;12,0;;;4,0;5,0;64,0;;;;;9,0;1,0;;;7,0;;11,0;;6,0;1,0;;1,0;13,0;2,0;40,0;;20,0;13,0;18,0;7,0;45,0;65,0;6,0;33,0;1,0;13,0;;1,0;;55,0;36,0;1,0;26,0;1,0;10,0;1,0;27,0;;10,0;2,0;2,0;23,0;41,0;3,0;5,0;;44,0;;;1,0;4,0;2,0;38,0;427,0;;17,0;1,0;52,0;2,0;5,0;;;2,0;5,0;14,0;1,0;;;2,0;1,0;10,0;3,0;80,0;2,0;82,0;15,0;17,0;41,0;;11,0;15,0;;31,0;14,0;8,0;6,0;;;;56,0;30,0;81,0;2,0;16,0;;5,0;2,0;12,0;11,0;;;;1,0;2,0;;46,0;5,0;1,0;9,0;2,0;11,0;19,0;10,0;;27,0;;;47,0;2,0;4,0;;2,0;7,0;6,0;2,0;;18,0;8,0;7,0;1,0;97,0;;3,0;;2,0;4,0;15,0;;2,0;;10,0;30,0;17,0;4,0;3,0;;;;;3,0;5,0;;;;;4,0;;;;6,0;;2,0;1,0;;;2,0;;2,0;2,0;3,0;;1,0;;;;;1,0;61,0;1,0;;;;;6,0;;17,0;;;1,0;;;;1,0;7,0;;1,0;;;;;;;29,0;;1,0;;6,0;2,0;3,0;;2,0;1,0;4,0;;2,0;1,0;;1,0;;4,0;;;71,0;55,0;1,0;;;;;5,0;19,0;4,0;2,0;;;1,0;;1,0;2,0;;23,0;;1,0;;;7,0;24,0;;;;2,0;21,0;1,0;34,0;1,0;2,0;;;;6,0;;1,0;;2,0;5,0;9,0;;;;;;;1,0;;;;;;;;;3,0;;;;2,0;;;2,0;6,0;;;;;;;;;1,0;;;;;;;;;2,0;;;8,0;;;;;4,0;6,0;1,0;1,0;3,0;;;8,0;32,0;;1,0;8,0;2,0;;1,0;9,0;90,0;;1,0;;7,0;;;;;;;;2,0;1,0;;;;;2,0;1,0;;19,0;6,0;;;3,0;;;8,0;;;;12,0;;10,0;;1,0;;4,0;;;;;;4,0;;2,0;1,0;2,0;;7,0;4,0;11,0;;40,0;1,0;3,0;8,0;;9,0;1,0;;1,0;;;44,0;;2,0;;;29,0;;1,0;;28,0;;4,0;27,0;;8,0;;2,0;;5,0;19,0;2,0;;;5,0;2,0;;3,0;;104,0;1,0;;;2,0;4,0;;8,0;;;13,0;2,0;;;;;;;12,0;28,0;7,0;;;3,0;27,0;;12,0;3,0;3,0;2,0;;;1,0;4,0;98,0;;;1,0;2,0;;;7,0;;;1,0;;1,0;;;4,0;;;;9,0;9,0;;4,0;;1,0;;2,0;14,0;;;1,0;;;1,0;;;2,0;3,0;;5,0;3,0;;;;;;;1,0;;;;;18,0;1,0;;;;2,0;;;;7,0;2,0;1,0;;;;;1,0;;;9,0;;;;;4,0;;6,0;3,0;;;;;;;5,0;;;;;;;1,0;3,0;17,0;;;;;;1,0;;;;;;1,0;;;;;;;1,0;;5,0;;;;25,0;2,0;1,0;;;;;;;;;;;;;;1,0;2,0;;;;;20,0;3,0;;;;;;4,0;;;2,0;;1,0;;2,0;2,0;1,0;;;;;1,0;5,0;;;;8,0;;;4,0;6,0;1,0;;;;;2,0;1,0;5,0;1,0;;;;;;;;2,0;;;;2,0;;;;5,0;6,0;1,0;;8,0;;6,0;;;;;;;;2,0;;;;;;;6,0;2,0;;;;;;;;;;;;;1,0;;;;;;;;;;1,0;;3,0;9,0;;23,0;16,0;;9,0;;;;;1,0;1,0;;;;;;;5,0;;;4,0;;1,0;;;;;;1,0;;;;;;;;;5,0;;;;;;3,0;;;;;14,0;;6,0;;1,0;10,0;2,0;3,0;11,0;;;18,0;;7,0;;3,0;2,0;;;;6,0;;;;;;1,0;5,0;;;;1,0;;2,0;;1,0;;1,0;;;;1,0;10,0;;;6,0;;;;;;;;2,0;;;;4,0;;;;;;1,0;;2,0;;;;;;;;;6,0;;;;;;3,0;;;;2,0;;;35,0;;2,0;;1,0;;1,0;2,0;;;;;;;;;3,0;2,0;;;;;17,0;;;;;;1,0;;;;;;2,0;2,0;;;;;;;;4,0;;;;;;2,0;;2,0;;;;;;4,0;;;;;;;;;;3,0;;;;8,0;;;;;;;;9,0;;;;1,0;5,0;;13,0;;1,0;;;;;;;;;;1,0;;;;;;5,0;;;;;;8,0;;1,0;;;3,0;2,0;;;;6,0;;;;;;;;;;;;;;
displacement;;;2,0;;;21,0;;4,0;;1,0;27,0;;7,0;8,0;29,0;114,0;;8,0;;5,0;20,0;3,0;;;;1,0;7,0;;4,0;13,0;1,0;;36,0;;17,0;8,0;40,0;31,0;1,0;;25,0;2,0;9,0;1,0;23,0;8,0;120,0;15,0;6,0;15,0;2,0;37,0;;2,0;21,0;;11,0;45,0;13,0;4,0;2,0;;6,0;;6,0;;4,0;;31,0;;7,0;;29,0;;;4,0;4,0;;;223,0;;23,0;;23,0;2,0;4,0;;;1,0;;52,0;;;;4,0;4,0;11,0;;46,0;9,0;2,0;;36,0;64,0;;9,0;36,0;;14,0;10,0;;3,0;;;7,0;6,0;2,0;54,0;;11,0;;;4,0;5,0;20,0;1,0;;;3,0;12,0;;30,0;72,0;;12,0;;7,0;25,0;2,0;;2,0;;;31,0;;;;2,0;53,0;3,0;6,0;;6,0;2,0;4,0;1,0;16,0;1,0;8,0;;12,0;;42,0;2,0;5,0;;2,0;5,0;;;8,0;3,0;;;50,0;3,0;;2,0;;;4,0;1,0;;;;11,0;;25,0;;;;;;1,0;12,0;;;;;;;6,0;14,0;48,0;;2,0;;;1,0;1,0;;1,0;11,0;;;;;;;;27,0;;;;;;;;17,0;;5,0;;;11,0;5,0;60,0;8,0;;5,0;;5,0;;;5,0;2,0;;;2,0;27,0;3,0;1,0;;;;;;3,0;;;;;;;4,0;;12,0;;;2,0;;;12,0;;;;;3,0;3,0;;1,0;;;;1,0;;5,0;;;;;24,0;6,0;17,0;;;;;;4,0;;29,0;8,0;;;;4,0;2,0;;;4,0;;;;;;;;;;;;;;;2,0;;;;;;6,0;;;;;;1,0;;;1,0;;;;;1,0;;;1,0;4,0;1,0;;3,0;1,0;;2,0;;;28,0;;3,0;;;;;1,0;;;;;;;;;;4,0;;;;;4,0;;;;;;5,0;;;;;;;1,0;;;4,0;;;4,0;;3,0;;;;;;;15,0;1,0;29,0;9,0;5,0;18,0;;7,0;;;;;;;2,0;12,0;3,0;1,0;;22,0;25,0;;4,0;;2,0;3,0;1,0;22,0;;;17,0;2,0;;2,0;6,0;27,0;1,0;;4,0;1,0;;;;;;6,0;;;;;;4,0;;1,0;;;2,0;;;;;55,0;10,0;;5,0;;6,0;2,0;;101,0;1,0;2,0;;1,0;15,0;1,0;2,0;39,0;;;6,0;5,0;1,0;;;;;45,0;;;;;;1,0;;;;;13,0;;;3,0;;;;;;;;;;;;20,0;;;16,0;;;;;;;;;;;;;4,0;;2,0;1,0;;1,0;;9,0;;6,0;;1,0;;;;2,0;;41,0;1,0;;;;;;;7,0;;2,0;;;;;;10,0;10,0;;;2,0;;;;;;8,0;;;;1,0;;;;;;;;;;;;;;;;;;1,0;;;;13,0;3,0;;;;;;;;;;2,0;;;;;;;;;;6,0;2,0;;1,0;;;7,0;;;;;;1,0;;7,0;6,0;;;;;10,0;;;;;;1,0;;;;;;;;;;;;;;;;;;11,0;;;;;;;;2,0;;;;;;;6,0;;2,0;;;;2,0;;;1,0;4,0;;3,0;;;;;;4,0;2,0;15,0;;;;;;;;;;;;;;;;;;;;1,0;;;;5,0;;;;;;;;;;;;;;3,0;;;;;;;;;;;;3,0;;;;;;;;;2,0;;34,0;;;;;1,0;;2,0;;;;;;17,0;;;;;;;;;;;;4,0;;;;;;;;;20,0;;;2,0;;2,0;;;;;;;;;;1,0;;;;;;;;2,0;;;;;;;;;;;13,0;;;6,0;4,0;;;;;;;;;3,0;;;;;;;2,0;;;;;;;;;;;;;;;2,0;;;;;;;;;;;2,0;;;;2,0;;;3,0;;3,0;;1,0;;;;;20,0;;2,0;;;;;;;;;;1,0;;;;1,0;;4,0;12,0;3,0;;2,0;4,0;;;;;;;;;;;;;;;4,0;;;;;;;;;;;2,0;;;;;;;;;;;;;;;;;;;;8,0;;;;;;;;;;;;;;3,0;5,0;1,0;;;;;;;;;;;;;;;;;;
emit;;;11,0;5,0;;3,0;3,0;107,0;35,0;44,0;21,0;;5,0;;10,0;34,0;36,0;;27,0;;4,0;13,0;9,0;2,0;3,0;2,0;69,0;12,0;;;1,0;2,0;115,0;;77,0;13,0;5,0;3,0;1,0;;9,0;1,0;2,0;19,0;71,0;16,0;24,0;262,0;5,0;141,0;11,0;7,0;;4,0;;4,0;98,0;;;;8,0;8,0;10,0;;16,0;;2,0;12,0;1,0;9,0;4,0;25,0;32,0;13,0;;2,0;2,0;87,0;120,0;83,0;;27,0;;60,0;6,0;16,0;;;1,0;2,0;37,0;;;4,0;30,0;5,0;5,0;;53,0;1,0;;;91,0;10,0;;43,0;102,0;1,0;17,0;;28,0;34,0;;3,0;;130,0;51,0;50,0;9,0;3,0;1,0;7,0;2,0;17,0;4,0;;;37,0;89,0;16,0;;3,0;1,0;;1,0;;5,0;10,0;2,0;;8,0;2,0;;36,0;3,0;1,0;;37,0;37,0;3,0;1,0;1,0;2,0;1,0;33,0;4,0;70,0;;1,0;1,0;;27,0;241,0;1,0;10,0;;18,0;3,0;52,0;60,0;1,0;;;1,0;89,0;;6,0;2,0;;55,0;6,0;17,0;;7,0;4,0;5,0;;6,0;;4,0;2,0;6,0;;13,0;;;;;1,0;2,0;;1,0;2,0;28,0;;;11,0;24,0;4,0;12,0;;;;;;14,0;;3,0;;;12,0;16,0;3,0;;;;2,0;;2024,0;;16,0;;19,0;18,0;1,0;5,0;5,0;9,0;8,0;;2,0;4,0;2,0;3,0;6,0;;2,0;4,0;2,0;3,0;5,0;3,0;;;;60,0;34,0;54,0;2,0;;;;;14,0;;;6,0;;4,0;;2,0;378,0;2,0;;11,0;;7,0;5,0;1,0;87,0;2,0;3,0;;1,0;;48,0;;3,0;;4,0;;1,0;;1,0;1,0;;1,0;1,0;;;1,0;1,0;;;;;;9,0;;2,0;;8,0;20,0;;;3,0;;;;9,0;;;2,0;;7,0;;;;;1,0;;2,0;;;;4,0;;8,0;1,0;9,0;1,0;;;2,0;13,0;;;;2,0;17,0;;;4,0;2,0;;2,0;1,0;6,0;1,0;;6,0;1,0;;;;;;;1,0;9,0;;;;;;;;1,0;2,0;;;1,0;2,0;;;;1,0;;;6,0;6,0;6,0;17,0;;;5,0;;3,0;3,0;;;;;12,0;;;;3,0;8,0;25,0;9,0;10,0;2,0;;1,0;1,0;;11,0;13,0;;;4,0;18,0;;;;;;;18,0;;1,0;7,0;5,0;8,0;;1,0;54,0;7,0;1,0;2,0;;2,0;;;9,0;10,0;;;9,0;2,0;;;;;12,0;20,0;1,0;;;9,0;2,0;2,0;7,0;;;;1,0;2,0;2,0;;;1,0;;2,0;;;;;;18,0;3,0;2,0;8,0;1,0;;;;;9,0;2,0;;;6,0;;;1,0;8,0;2,0;;4,0;;;21,0;;;3,0;4,0;;;;3,0;;;;2,0;;;;;2,0;11,0;1,0;2,0;;3,0;5,0;;;;;;;2,0;;;5,0;1,0;2,0;;;;;6,0;;1,0;7,0;;;;3,0;;1,0;3,0;10,0;8,0;15,0;5,0;;3,0;;;;4,0;;5,0;15,0;19,0;;;18,0;;14,0;;;6,0;;;2,0;;;;;;231,0;;;1,0;;;;;;2,0;;;;;;;1,0;;;1,0;9,0;3,0;1,0;;;;;;;1,0;;;;5,0;;;;;;;;;27,0;;;12,0;;;;;3,0;;1,0;;;;;19,0;9,0;;;;;3,0;;;89,0;5,0;;1,0;3,0;;;1,0;;;;;1,0;1,0;5,0;2,0;4,0;;;;;1,0;120,0;;;;;;;;;;3,0;;;;6,0;;;2,0;;16,0;;;;3,0;2,0;;;;;;1,0;;;;2,0;41,0;;;;4,0;;1,0;;4,0;38,0;;;;6,0;;;;;;;2,0;1,0;;;;;;;;5,0;;;;1,0;;4,0;3,0;;;;;10,0;;3,0;;;2,0;;3,0;;;;1,0;;;7,0;;;;;;;;1,0;1,0;1,0;1,0;;;;;1,0;7,0;;;;1,0;;;4,0;;6,0;9,0;1,0;;;4,0;;;;;;4,0;;;4,0;;;1,0;;;13,0;;;;;;;;2,0;;;;;;;;13,0;;1,0;;;2,0;25,0;46,0;;1,0;;2,0;;;;;;;1,0;1,0;;;;;;;;;5,0;1,0;3,0;;;;1,0;;;;;;;;;;;;;1,0;10,0;;49,0;;;1,0;;;;;2,0;25,0;2,0;;;19,0;1,0;;;3,0;;;276,0;;;;14,0;5,0;6,0;;2,0;;;;;;;2,0;;;;;31,0;;;;;;;;2,0;;;;;;;;7,0;;2,0;;;;;;;;2,0;1,0;;;;;;67,0;;;;;;;2,0;;;;;;;;;3,0;;;;;;;;;;;;;;1,0;;;;;;;;;;;1,0;;;;;;;;;;;1,0
endoscope;;;5,0;;;13,0;4,0;2,0;1,0;1,0;;;2,0;;22,0;6,0;;;;4,0;43,0;19,0;7,0;38,0;;;1,0;1,0;;;;4,0;6,0;;13,0;8,0;;;;;49,0;;2,0;1,0;;1,0;3,0;42,0;1,0;9,0;1,0;7,0;;;3,0;;19,0;;;;;;25,0;;;;;7,0;;24,0;;;15,0;1,0;;;4,0;3,0;4,0;55,0;17,0;13,0;;19,0;2,0;;;;;1,0;26,0;;;2,0;;;18,0;;46,0;2,0;;4,0;10,0;;;;46,0;;;14,0;6,0;2,0;;;;6,0;57,0;41,0;15,0;1,0;;1,0;3,0;3,0;3,0;1,0;;;26,0;6,0;;;24,0;;1,0;;;3,0;;;;;;12,0;;;;36,0;1,0;5,0;2,0;;13,0;13,0;;5,0;108,0;;;2,0;;17,0;15,0;;;;56,0;38,0;;3,0;7,0;;;;1,0;;18,0;;;;4,0;15,0;;15,0;;5,0;;6,0;;1,0;;;;27,0;;;;;2,0;1,0;7,0;;1,0;16,0;;;;14,0;;3,0;;;;;;;;;;1,0;30,0;1,0;4,0;3,0;;;;;40,0;14,0;;2,0;11,0;7,0;;;3,0;3,0;1,0;2,0;8,0;;2,0;;;;;;3,0;13,0;2,0;;;;;;33,0;6,0;;;;;2,0;;;;;;;;1,0;51,0;;;;;;;;15,0;;;;;;12,0;;;;;;1,0;;;15,0;;;;4,0;;;2,0;3,0;1,0;;;;;;;;;;;;;;;;46,0;1,0;7,0;2,0;30,0;;1,0;8,0;3,0;;1,0;;;;33,0;;;;1,0;;18,0;;;23,0;;6,0;;;2,0;;;;1,0;;;;10,0;;3,0;;;;;1,0;;;15,0;;;2,0;5,0;5,0;;;;;1,0;;4,0;11,0;9,0;;;1,0;18,0;;;;;2,0;6,0;;32,0;;9,0;;2,0;;;1,0;;;;;12,0;;;;;;2,0;;;;;1,0;;;;;;;;;;;;;1,0;;;;1,0;;;4,0;;;1,0;;;;;3,0;;;;;;2,0;;1,0;;;;;;;;;;1,0;;;;;;;;;;;1,0;;;3,0;;;;;3,0;2,0;4,0;;;;;;;1,0;;;1,0;;;4,0;1,0;;;8,0;;23,0;;2,0;;;;2,0;;;;;1,0;;;;;4,0;16,0;;;;2,0;;2,0;1,0;;;21,0;;;;;;2,0;;;;;;;;;;;;;1,0;;;;;;;;;;;2,0;;17,0;;;;4,0;;;4,0;1,0;;;;;2,0;;2,0;4,0;5,0;;;1,0;;;;;;;;;8,0;;;;;;3,0;;;;8,0;;;;;;;3,0;;;;;;;;;;;1,0;;;;;;12,0;;;;29,0;;;;;;;;;7,0;;;3,0;;1,0;;;;;;;9,0;1,0;;;4,0;;1,0;;;;;;;;;;2,0;;;;12,0;6,0;;;5,0;;;1,0;6,0;3,0;17,0;12,0;;;;2,0;;;1,0;;;;;;10,0;;;;3,0;;;;;;;7,0;;2,0;;;;;;;;;;;;;3,0;;;;;;14,0;;2,0;;;5,0;5,0;;;7,0;;5,0;;;;;1,0;;;;;;1,0;;;;;;;;;;;;;;;;;;;;;;;;;;;;;;;;;;;;;;;;;;;;;;;;;;;;;4,0;;2,0;1,0;;;;;;;2,0;3,0;;;;;;;;;;;117,0;;8,0;;;;11,0;;;;18,0;;;;;;;;;;;;;;;;1,0;;;;;;;;;;;;;;;;;;;5,0;;;;;;;;;2,0;;;;;2,0;;;;;;;;8,0;;;;;4,0;;7,0;;;;;3,0;;;2,0;;;;;;;2,0;;;10,0;;;;1,0;;;;;;;;;;;;;;;;;;;;;;;;;;;;2,0;;;;;;1,0;;2,0;;;;;;;;;;1,0;;;;;;;;;;;3,0;;;;;;;;;;;;;;;;;;;;;;;;;;
energy;;;3,0;1,0;1,0;6,0;;6,0;10,0;1,0;2,0;;5,0;;14,0;26,0;11,0;;10,0;5,0;2,0;33,0;;;;;2,0;2,0;;;1,0;;26,0;;14,0;2,0;;;6,0;;9,0;;1,0;1,0;59,0;;17,0;10,0;4,0;4,0;5,0;10,0;;;;6,0;15,0;;;;;2,0;4,0;;3,0;1,0;5,0;3,0;8,0;4,0;15,0;;13,0;;;7,0;;;;79,0;8,0;10,0;;16,0;2,0;;;;;;13,0;2,0;2,0;1,0;18,0;;;;48,0;;;;3,0;17,0;;4,0;9,0;;30,0;5,0;7,0;4,0;;;;22,0;1,0;12,0;13,0;8,0;;;1,0;3,0;6,0;1,0;;;65,0;20,0;;;14,0;2,0;1,0;2,0;;8,0;;;19,0;1,0;;13,0;1,0;;;2,0;;;3,0;;8,0;7,0;;7,0;17,0;;;3,0;;9,0;36,0;;2,0;;4,0;13,0;15,0;14,0;;2,0;;;73,0;1,0;9,0;;;;;3,0;;;1,0;3,0;;28,0;;;;;;3,0;;;;;;;;3,0;1,0;13,0;;6,0;2,0;;3,0;;;1,0;;;;;;2,0;;;7,0;1,0;;;;3,0;12,0;;170,0;;2,0;;;3,0;;3,0;3,0;;;1,0;3,0;6,0;;;;;;;1,0;3,0;1,0;;;;;;42,0;5,0;;;;;;14,0;;;1,0;3,0;;;;62,0;;;7,0;;1,0;;5,0;11,0;1,0;;;6,0;1,0;6,0;46,0;;;1,0;;;;;;;;;;;5,0;2,0;;;;;;2,0;;;1,0;;;;;;;;;6,0;;;;;;;;;;;1,0;;;;;24,0;;;;;;;;21,0;;;;3,0;;;;;;;;;;7,0;1,0;6,0;16,0;;;;;;;;2,0;;;;;;;;;;;;;;;;;4,0;;;;8,0;1,0;15,0;1,0;;2,0;7,0;;3,0;;2,0;;;3,0;3,0;;;;;;14,0;8,0;;;;;;3,0;;;;;;21,0;;1,0;3,0;7,0;;;8,0;;14,0;52,0;3,0;1,0;1,0;;37,0;5,0;;1,0;;;;;1,0;1,0;;;;;;;;1,0;1,0;;;;2,0;14,0;;;;;;4,0;;9,0;;;;3,0;;4,0;1,0;;;1,0;;5,0;;1,0;3,0;4,0;1,0;;;;;;3,0;;;7,0;;;;2,0;;2,0;4,0;;;2,0;;;;;;;;;;;;;7,0;;;;;;;;;46,0;;;;;;;;;;;1,0;;3,0;;;;;;2,0;8,0;;;2,0;;;29,0;2,0;;;;22,0;1,0;;;1,0;16,0;3,0;;;2,0;3,0;;5,0;17,0;;2,0;;;1,0;;;;;2,0;;;;24,0;;;;;;;;;;;;;;;;1,0;;;;;2,0;3,0;;;;;;;;;;;;;;;;;;2,0;;8,0;8,0;;;;;;;;;;;;;;;2,0;;;;;;;;;17,0;;2,0;;;;;;;;;;9,0;17,0;;;1,0;;;;;2,0;;;;;;;1,0;;;1,0;;;;;;;;1,0;;;;;;;;;;;;4,0;;;2,0;;;;;;;;;;;;;;;5,0;;;;;2,0;;;;;;;;;24,0;;14,0;;;;;;1,0;;;;;;;;;;1,0;1,0;;;;;;5,0;;;;1,0;3,0;;;;;;;;;;;;;;2,0;5,0;;1,0;;16,0;3,0;2,0;;;2,0;2,0;;;;;;;;;1,0;;24,0;;;;;;;;;;;;;;;;6,0;;;2,0;;;;1,0;;;;;;5,0;;14,0;;;;;;;;;1,0;;;2,0;;;;;;;;;;;1,0;;;;;;;;;;;3,0;;;;;;17,0;;;4,0;;;;;11,0;;;11,0;1,0;;;;13,0;;;;;;;;;;;2,0;7,0;9,0;;;;1,0;;;;;;;;;;;;;;;6,0;;;;14,0;;;;;;;;;;;;;;;;;;1,0;;1,0;;;;;;;;;;;;;;;;;;;;8,0;;;;;;;;;;1,0;;;;;;1,0;;;;;;1,0;;;;;;;;;;;;;;
enlarge;;;2,0;;;;;6,0;52,0;2,0;;;;;;9,0;;;;;;29,0;2,0;;1,0;;;;;;;;11,0;;10,0;5,0;;;1,0;;18,0;3,0;;1,0;1,0;1,0;8,0;11,0;4,0;93,0;;10,0;;;;;;;;;;;6,0;;;2,0;1,0;;4,0;1,0;4,0;;16,0;;;;3,0;;1,0;218,0;3,0;5,0;;12,0;;1,0;;;;;1,0;;;;;;1,0;;8,0;;;;2,0;4,0;;4,0;2,0;2,0;;;1,0;22,0;;;;2,0;17,0;35,0;;6,0;;;22,0;1,0;4,0;1,0;;;;10,0;;6,0;1,0;;1,0;11,0;12,0;4,0;4,0;;;1,0;;1,0;2,0;;;;;27,0;;;;3,0;12,0;;5,0;;;;;;17,0;;4,0;;;7,0;;;26,0;;;;;;;;;;;9,0;;;;3,0;;16,0;;;;;;;;1,0;;;;;2,0;;3,0;8,0;;;;;;3,0;;2,0;;;;;;;1,0;;;;;;;2,0;;;4,0;;2,0;2,0;2,0;;;;;6,0;;;;;2,0;;;;;;5,0;;;;;2,0;;;;;;;;;;2,0;;;;;;;1,0;;;;;;;;;3,0;1,0;;;;;1,0;;;;;;4,0;1,0;;;;;;;1,0;;;;;;;;;;;;;;;2,0;;;;;2,0;;;;;;;;8,0;;;;;;;;;;;;;;;5,0;;;;;;1,0;;;;;1,0;;;;4,0;;;2,0;1,0;;;;;;1,0;;;1,0;;;;;;;;1,0;;;;;;2,0;;;;;1,0;;7,0;;;;;;3,0;4,0;;;;;;;;;;;1,0;5,0;;;;;;;;1,0;;;;;;;;;7,0;;;;25,0;;;3,0;;7,0;;1,0;;1,0;1,0;2,0;;;;5,0;;;1,0;5,0;;;5,0;;3,0;;;;;;;;;;;;;2,0;;;;;;3,0;;;;;;;;;3,0;6,0;;;;;;;;;1,0;3,0;;;;;;2,0;;;1,0;;;;;;;;5,0;1,0;;;;;;;;;;;;;;;;4,0;;;1,0;;;;;2,0;;;;;;;;6,0;;1,0;;;;;;;;;;;;;;;;;;;;;;;1,0;1,0;;;;;3,0;;;;;;;;;;;;;;;;;;;;;;;;;;;;;;;;;;;;3,0;;;;;;;;;;;;4,0;2,0;;24,0;;;;;;;;;;;;;;;;4,0;;4,0;;;;;;;;;;;;;;2,0;;;;;;2,0;;;2,0;;;;;;;;;;;;;;;;;;1,0;;2,0;;;;;;;;;;;8,0;;;;;;;;;2,0;;;;;;5,0;;;;;;;;;;;;;;1,0;;;;;;;;;;;;;;;;;;;;;;;;;;;;;3,0;;;;;;;;;;;;;;;;;12,0;;;;;;3,0;;;;;;;3,0;;;;;;;;;;;;;;;;;;;;;;;;17,0;16,0;;;;;7,0;;;;;;;;;;;;;;;;;;1,0;1,0;;1,0;;1,0;;;;;;;;;;;;;;;;;;;9,0;4,0;;;;;;1,0;;;;;;;1,0;;;;;;;;;;;;;;;;;;2,0;;;;;;;;;;;;;;1,0;;;;;1,0;;;;;;;;;;;;;;;;;;;;;;;;;;;;;;;;1,0;;;;;;;;;;;;9,0;;;;;;;;;;;;;;;;;;;;1,0;;;;15,0;;;;;;1,0;;;;;;;;;;;;;;;;
equipment;;;1,0;;;;;2,0;;;;;8,0;;;;;;;;1,0;1,0;1,0;1,0;2,0;;6,0;4,0;;;10,0;3,0;14,0;;29,0;;;;;;21,0;;;;5,0;;4,0;33,0;3,0;28,0;;5,0;;;;;2,0;;;;;68,0;1,0;;5,0;;;;3,0;;;;5,0;;;;1,0;1,0;;94,0;;3,0;;41,0;;;;;2,0;;;;4,0;2,0;1,0;1,0;5,0;;22,0;2,0;;1,0;14,0;;;;;1,0;1,0;;;17,0;;;;7,0;16,0;51,0;1,0;2,0;;;;65,0;3,0;5,0;2,0;;;;;2,0;1,0;;5,0;4,0;;;;;;1,0;;8,0;;;;2,0;10,0;;;;1,0;5,0;1,0;;39,0;;;1,0;;12,0;39,0;;;;7,0;5,0;;;;;;;;;1,0;;1,0;;1,0;14,0;;;3,0;;;33,0;;;;;;7,0;;;;;;2,0;;2,0;;;;;;;1,0;1,0;;;;;;;;;3,0;;2,0;;;;1,0;1,0;;;4,0;2,0;2,0;;1,0;16,0;;;;;;2,0;;1,0;;;;1,0;;4,0;3,0;;9,0;;6,0;;;2,0;16,0;;;;;;;9,0;;;1,0;2,0;;;;;10,0;;;;;;;1,0;;;;;;20,0;;2,0;;;;;;;;;11,0;;;;;8,0;16,0;;2,0;;;;1,0;;;;;;;;;9,0;;3,0;3,0;2,0;2,0;5,0;13,0;;;;;;;;;;3,0;;;6,0;;1,0;2,0;;;2,0;;;;;;;;;;;;2,0;;;;4,0;;;1,0;;;;;4,0;;;;;;9,0;;;;;;;;;;;;;;;;17,0;;;8,0;;;14,0;2,0;1,0;;;;;;5,0;1,0;;;;;4,0;4,0;;;;;;;;;;;;;;;;;1,0;;;;23,0;1,0;2,0;;;;1,0;1,0;;3,0;;;;;9,0;9,0;3,0;;;6,0;;;;3,0;2,0;18,0;;;;;;;;;;;;;;;1,0;;;;8,0;;;;1,0;1,0;1,0;;;1,0;;;;;;;1,0;22,0;;;;;;3,0;;3,0;;;3,0;;;;;1,0;;;;;;1,0;;;;;;;;11,0;4,0;;;;;3,0;;;;;1,0;;;;4,0;;;;;7,0;;;;;;;1,0;;;;;4,0;;;;;;;;;2,0;;;2,0;8,0;1,0;;;1,0;;;;6,0;;;;;1,0;;;;1,0;;;;;;;;;;;;;;;3,0;;;;;;4,0;;;;;;;8,0;;;;1,0;5,0;;;;1,0;;;;;;;;;;;;;;;;;;;;;3,0;;;;1,0;;;;;;;;9,0;13,0;;;;1,0;;;;1,0;;;;;;;2,0;;;;;;;5,0;;;;;;;;;;;;;;;;;;3,0;;;;;;;;;;;;;;;;;;1,0;;3,0;;;;;;;;;;;;;;1,0;;;;;;;;;;;;;;;;;;;;;1,0;;;;;1,0;;;4,0;;;;;;;;;;;;;;;8,0;;;;;;;;;;;;;3,0;;;;;;;5,0;;;;;;;;6,0;;;;;;;;;;7,0;;;;;;;1,0;;;;;;1,0;;;;;;;;;;;;;;;;;;1,0;;;;;;8,0;;;;;;;1,0;;;;;;;;5,0;;;;;;;;;;;;;;;;;;;;;1,0;;;;;;;;;;1,0;;;;;;;;;;;;;;;;;;3,0;;;;;;;;;;;;;;1,0;;;;1,0;;1,0;;;;;;;;;;;;;;;;1,0;;;;;;;;;1,0;;;;;;;;;;;;;;;;;;;;;;;;;;;;;;;;1,0;;;;;;;;;;
exposure;;;17,0;4,0;1,0;5,0;110,0;88,0;62,0;23,0;11,0;;36,0;;4,0;113,0;;7,0;53,0;;1,0;145,0;7,0;;3,0;13,0;39,0;5,0;;1,0;2,0;139,0;80,0;4,0;422,0;114,0;12,0;26,0;6,0;;116,0;9,0;20,0;2,0;57,0;19,0;168,0;145,0;48,0;25,0;3,0;20,0;;20,0;27,0;;30,0;;16,0;;6,0;2,0;18,0;;34,0;19,0;59,0;22,0;109,0;6,0;39,0;3,0;70,0;1,0;;42,0;6,0;6,0;22,0;665,0;57,0;99,0;8,0;106,0;40,0;43,0;7,0;;;24,0;58,0;;2,0;2,0;;12,0;;;162,0;7,0;;4,0;49,0;36,0;;7,0;51,0;10,0;51,0;175,0;5,0;150,0;;1,0;17,0;148,0;83,0;29,0;43,0;101,0;5,0;;66,0;52,0;25,0;14,0;;14,0;;13,0;2,0;24,0;8,0;;21,0;21,0;7,0;45,0;7,0;2,0;76,0;;8,0;201,0;233,0;8,0;;10,0;330,0;5,0;8,0;;12,0;28,0;56,0;;83,0;;;;9,0;23,0;273,0;;8,0;;42,0;3,0;;14,0;3,0;25,0;15,0;3,0;199,0;12,0;;;;;;20,0;;;10,0;18,0;;27,0;1,0;;4,0;3,0;;2,0;;;;1,0;6,0;7,0;;;5,0;5,0;1,0;;14,0;3,0;;27,0;32,0;7,0;;;;;;4,0;;;7,0;5,0;1,0;;;;6,0;;172,0;;26,0;;3,0;8,0;1,0;37,0;5,0;56,0;1,0;;11,0;;1,0;;6,0;;6,0;;112,0;6,0;12,0;;;;;3,0;30,0;6,0;;;;12,0;;59,0;;30,0;5,0;;115,0;;;14,0;1,0;;1,0;2,0;127,0;;;37,0;10,0;;1,0;;;891,0;10,0;;3,0;;14,0;;;;6,0;;14,0;;;;;10,0;;;;;;9,0;;;;18,0;;;13,0;15,0;;;6,0;10,0;;;;;15,0;1,0;7,0;;;;;1,0;;;;;2,0;3,0;;;;;2,0;16,0;55,0;;6,0;3,0;5,0;6,0;;;3,0;33,0;;;;59,0;;;;3,0;;;;;;;;10,0;7,0;2,0;;2,0;1,0;;;;5,0;7,0;;;;;;2,0;;;;;3,0;53,0;1,0;;;4,0;;;;;1,0;;3,0;6,0;1,0;;;;20,0;129,0;95,0;;14,0;;43,0;11,0;6,0;2,0;5,0;7,0;3,0;1,0;16,0;14,0;20,0;10,0;8,0;1,0;;;;5,0;145,0;6,0;5,0;;3,0;17,0;107,0;;11,0;24,0;16,0;;;39,0;80,0;;;150,0;54,0;;;;41,0;35,0;6,0;;;4,0;6,0;6,0;;44,0;;;3,0;;28,0;;;;15,0;1,0;16,0;3,0;2,0;;;;141,0;;5,0;4,0;3,0;;;1,0;;;1,0;;2,0;28,0;11,0;3,0;;;;1,0;8,0;;5,0;14,0;5,0;4,0;;;21,0;5,0;2,0;1,0;;;1,0;1,0;;;2,0;;9,0;18,0;;49,0;;8,0;;;;2,0;;2,0;3,0;4,0;2,0;;17,0;22,0;5,0;23,0;;;6,0;7,0;;19,0;7,0;;;8,0;;;;;1,0;;;;11,0;4,0;;22,0;1,0;9,0;;1,0;7,0;4,0;;5,0;;;4,0;;;5,0;;;;;11,0;;;;83,0;52,0;;;;1,0;1,0;;;2,0;;;;;;;2,0;;4,0;;18,0;52,0;36,0;;;;;;;;1,0;2,0;;;1,0;2,0;4,0;;;4,0;3,0;1,0;39,0;;;1,0;26,0;;;6,0;;;;;2,0;;19,0;;;11,0;;;;;1,0;;;3,0;;1,0;1,0;;70,0;7,0;;;;1,0;;6,0;5,0;;5,0;;;51,0;22,0;;2,0;1,0;;;;;;;;;;;4,0;5,0;1,0;29,0;;1,0;;;;;2,0;;;;;;;;;;3,0;2,0;1,0;33,0;;;;;5,0;3,0;;;;;63,0;;;;;;;;;;;1,0;84,0;;;;4,0;;;40,0;;;;;1,0;4,0;;;;1,0;1,0;;;;;;;5,0;1,0;;;51,0;106,0;2,0;;;3,0;55,0;;13,0;;;10,0;;29,0;2,0;;1,0;18,0;;5,0;12,0;;1,0;;;4,0;;9,0;;46,0;42,0;43,0;2,0;1,0;6,0;;;;7,0;;12,0;36,0;27,0;;89,0;1,0;10,0;1,0;;68,0;3,0;;16,0;;5,0;;1,0;4,0;;;;;;5,0;2,0;6,0;;;;;;3,0;19,0;;2,0;6,0;1,0;3,0;;;;;1,0;;;9,0;;;20,0;;2,0;1,0;;;3,0;;;2,0;;;1,0;1,0;;17,0;;;11,0;;;;;;3,0;1,0;;;;;;;1,0;;;;6,0;2,0;;;;;2,0;2,0;3,0;;;1,0;17,0;1,0;;19,0;4,0;;1,0;1,0;;;;;;;;;1,0;;;;;50,0;;;1,0;;21,0;1,0;16,0;;;;;57,0;;1,0;6,0;;;2,0;;;;;;;;;1,0;;;4,0;;4,0;;;;;;;;;;;;2,0;3,0;;1,0;;;10,0;;16,0;;;;;;3,0;;16,0;;1,0;18,0;;;;;;;;;;1,0;;;;;;;;;;1,0
extract;;;1,0;;3,0;9,0;3,0;34,0;116,0;10,0;5,0;;11,0;3,0;3,0;71,0;;2,0;9,0;2,0;22,0;58,0;3,0;;4,0;11,0;53,0;1,0;3,0;;16,0;;91,0;;38,0;14,0;14,0;9,0;12,0;;172,0;1,0;;67,0;29,0;6,0;60,0;26,0;41,0;21,0;;31,0;1,0;8,0;;155,0;31,0;;12,0;2,0;;;;4,0;12,0;11,0;15,0;13,0;107,0;2,0;14,0;;34,0;1,0;;12,0;34,0;;1,0;779,0;;25,0;2,0;67,0;1,0;1,0;2,0;4,0;;12,0;25,0;3,0;;;2,0;1,0;4,0;5,0;126,0;5,0;8,0;1,0;42,0;175,0;;8,0;5,0;6,0;12,0;68,0;8,0;29,0;;;;74,0;90,0;72,0;1,0;30,0;;;26,0;49,0;20,0;12,0;;3,0;;;;54,0;2,0;5,0;2,0;4,0;23,0;4,0;6,0;;44,0;;;26,0;5,0;3,0;;;68,0;15,0;31,0;;7,0;33,0;23,0;2,0;43,0;;;;3,0;7,0;178,0;;;;57,0;10,0;7,0;;13,0;;;2,0;22,0;12,0;;;;2,0;;;;;;6,0;;179,0;;;;;;1,0;2,0;;;43,0;1,0;1,0;;1,0;34,0;6,0;2,0;;;;2,0;44,0;;;;;;1,0;;;;;;;;2,0;1,0;;;;29,0;;;;;;;3,0;3,0;;;;;;;1,0;;;;;117,0;49,0;3,0;;;;;;27,0;1,0;;;;;;10,0;;;4,0;;;;;8,0;;;;;7,0;;;21,0;;;6,0;;;32,0;;3,0;1,0;;14,0;1,0;4,0;;;;3,0;;;;;;;;;;1,0;25,0;;4,0;;1,0;;3,0;;6,0;;1,0;;3,0;;;;;3,0;;;;12,0;;;;;;;10,0;;5,0;;;;;13,0;6,0;;;;;6,0;17,0;;;;;;;;158,0;4,0;15,0;;5,0;;;;;;2,0;;;;;;8,0;;;;;;10,0;;;16,0;;;7,0;;;5,0;1,0;7,0;41,0;2,0;;;3,0;;;;;;;;10,0;1,0;5,0;;1,0;10,0;23,0;15,0;17,0;43,0;2,0;3,0;;;;;;2,0;2,0;13,0;1,0;;2,0;;360,0;1,0;3,0;;25,0;8,0;;22,0;;33,0;4,0;6,0;;;42,0;29,0;;9,0;;3,0;1,0;1,0;;9,0;;;7,0;5,0;19,0;1,0;;;5,0;;;;;;;;2,0;7,0;10,0;;;;10,0;19,0;1,0;22,0;;1,0;2,0;5,0;;4,0;4,0;32,0;;16,0;4,0;2,0;3,0;;5,0;29,0;3,0;;;;;2,0;9,0;;;;31,0;5,0;;;;1,0;1,0;;1,0;;;8,0;;;;1,0;;;;;4,0;3,0;6,0;1,0;1,0;34,0;1,0;3,0;10,0;;;;;8,0;1,0;;5,0;;;;5,0;2,0;7,0;22,0;9,0;;;;;8,0;42,0;;1,0;;;;;15,0;2,0;13,0;37,0;2,0;;1,0;;;;3,0;4,0;1,0;;;1,0;;;;;;;44,0;1,0;3,0;16,0;;2,0;2,0;;2,0;2,0;;2,0;;;;2,0;;;2,0;;7,0;3,0;;4,0;;;;;;3,0;;1,0;;1,0;;6,0;;;;1,0;1,0;8,0;25,0;;99,0;1,0;;2,0;;;5,0;3,0;9,0;;1,0;;4,0;;6,0;;8,0;;37,0;;3,0;;1,0;;;;2,0;;;;;;;;;;13,0;;1,0;;;1,0;;;5,0;;1,0;;;;;;;;;;8,0;;;3,0;;;;;;;;;;;1,0;1,0;;;;;;4,0;;;11,0;;;;;;1,0;;;;;;;;;;1,0;1,0;2,0;2,0;;;1,0;7,0;;10,0;;7,0;1,0;;;;;;;;;10,0;;;;;;;;;2,0;;;3,0;;;3,0;2,0;;;;6,0;;1,0;1,0;;;;;;;;;;6,0;;6,0;30,0;;2,0;;;;;9,0;3,0;;24,0;5,0;;;;2,0;;;;1,0;;5,0;1,0;1,0;6,0;;7,0;8,0;;44,0;;2,0;155,0;;;;1,0;4,0;1,0;;4,0;12,0;;;;;8,0;;2,0;126,0;2,0;;9,0;49,0;7,0;50,0;;;;;;;1,0;;;;;;1,0;;;;;21,0;2,0;;;1,0;12,0;41,0;;;5,0;;;;;;3,0;;2,0;;2,0;1,0;;;;;;;;;;;;5,0;1,0;;;4,0;2,0;1,0;12,0;;;;;1,0;;5,0;2,0;4,0;;2,0;3,0;1,0;;;;1,0;;;;;;;;;;;5,0;6,0;;;9,0;;3,0;;;1,0;2,0;1,0;;6,0;;;;;;2,0;;;;;1,0;5,0;;;;4,0;3,0;;7,0;;;;;;4,0;;;;1,0;;;;;1,0;;;;;;8,0;;5,0;20,0;1,0;1,0;;6,0;;42,0;11,0;3,0;;;;11,0;;;3,0;;;;;;;;;
flash;;;4,0;14,0;13,0;24,0;20,0;108,0;40,0;6,0;7,0;;11,0;;15,0;86,0;;;45,0;;;78,0;6,0;3,0;5,0;1,0;46,0;6,0;6,0;10,0;10,0;20,0;108,0;;119,0;70,0;13,0;12,0;;;122,0;;13,0;1,0;24,0;20,0;91,0;554,0;43,0;44,0;5,0;14,0;;;3,0;7,0;13,0;;1,0;3,0;18,0;72,0;12,0;2,0;25,0;1,0;4,0;7,0;2,0;3,0;10,0;19,0;74,0;;;33,0;8,0;62,0;91,0;378,0;;33,0;7,0;150,0;9,0;18,0;;1,0;;;151,0;2,0;;5,0;25,0;3,0;42,0;4,0;145,0;11,0;1,0;5,0;69,0;11,0;;25,0;87,0;1,0;44,0;88,0;9,0;57,0;;3,0;1,0;87,0;99,0;15,0;64,0;7,0;7,0;2,0;12,0;74,0;38,0;8,0;;67,0;17,0;33,0;;17,0;13,0;;1,0;2,0;8,0;22,0;;;37,0;;18,0;86,0;26,0;2,0;;19,0;165,0;1,0;;;22,0;17,0;46,0;2,0;83,0;;;5,0;4,0;33,0;430,0;12,0;2,0;1,0;12,0;7,0;7,0;6,0;1,0;;;8,0;70,0;12,0;21,0;1,0;;8,0;1,0;30,0;;1,0;9,0;4,0;;3,0;1,0;;3,0;;;30,0;;1,0;1,0;;;35,0;;;5,0;4,0;;;;24,0;83,0;4,0;5,0;;6,0;;2,0;;1,0;;;11,0;41,0;;;;;;1,0;;559,0;;6,0;;5,0;75,0;2,0;5,0;1,0;64,0;1,0;2,0;;5,0;2,0;;;;;;8,0;1,0;;;;;;35,0;54,0;1,0;4,0;3,0;;;6,0;9,0;1,0;;5,0;;15,0;;1,0;146,0;11,0;;31,0;1,0;37,0;17,0;2,0;21,0;16,0;18,0;35,0;2,0;8,0;81,0;;7,0;;;;;;;7,0;;;;;;3,0;21,0;5,0;;;;;2,0;3,0;1,0;1,0;36,0;1,0;;5,0;18,0;;9,0;;30,0;;;2,0;;11,0;2,0;3,0;;;3,0;;4,0;;;;;;5,0;1,0;;;;9,0;3,0;4,0;9,0;1,0;;;;;;18,0;10,0;;2,0;;4,0;8,0;;9,0;11,0;8,0;3,0;1,0;;;2,0;;2,0;;6,0;;3,0;;;;;6,0;3,0;2,0;;2,0;;;3,0;;;;11,0;7,0;2,0;;7,0;;10,0;;1,0;6,0;;;;9,0;;;;16,0;2,0;3,0;27,0;2,0;9,0;4,0;;3,0;;;8,0;;;;2,0;5,0;1,0;4,0;;3,0;9,0;;;;9,0;9,0;;;;7,0;8,0;58,0;;3,0;8,0;5,0;;;10,0;41,0;;;6,0;8,0;;;;;3,0;45,0;;;;9,0;;;3,0;;;49,0;;37,0;;;2,0;10,0;;13,0;1,0;;;;;77,0;10,0;4,0;15,0;1,0;;;;8,0;;2,0;2,0;27,0;20,0;;;18,0;;6,0;;1,0;3,0;;12,0;43,0;;;56,0;3,0;;;8,0;;;;1,0;;3,0;2,0;;6,0;11,0;12,0;17,0;;;1,0;;;2,0;;4,0;2,0;26,0;13,0;;7,0;5,0;15,0;3,0;3,0;;;;;18,0;9,0;1,0;;7,0;6,0;;;;;8,0;;1,0;2,0;4,0;16,0;7,0;;10,0;3,0;22,0;4,0;35,0;11,0;100,0;2,0;;52,0;;3,0;3,0;;;;;;;;2,0;;11,0;;;;;31,0;;;2,0;7,0;;1,0;;1,0;;6,0;;16,0;;;6,0;3,0;;2,0;;;;1,0;;2,0;;;23,0;1,0;3,0;;;1,0;1,0;;;21,0;9,0;7,0;1,0;;;;14,0;;;;;;;;;;10,0;2,0;;;11,0;;;2,0;20,0;7,0;;2,0;4,0;23,0;;;;1,0;;;9,0;;;2,0;3,0;;;3,0;;97,0;5,0;;1,0;;;;;;;2,0;;;1,0;11,0;;1,0;1,0;;;;3,0;2,0;2,0;;;;;;;9,0;;1,0;3,0;2,0;41,0;;5,0;;23,0;;1,0;;3,0;;;;;6,0;;;;;;;;;17,0;8,0;;4,0;;231,0;;;4,0;;1,0;;;18,0;;;;;;4,0;;;;;;;;;;;5,0;;;;;;5,0;;;;;;;2,0;3,0;;;;;;;;;;;;;2,0;;6,0;4,0;62,0;;;1,0;;;;;;9,0;;8,0;;13,0;;12,0;1,0;;4,0;;;1,0;;1,0;;1,0;2,0;1,0;3,0;;;;17,0;2,0;1,0;;1,0;;4,0;;;24,0;;;;1,0;;1,0;;;;1,0;;7,0;;;3,0;3,0;;;;;;;;;;;;;10,0;;;;;;;;;;;13,0;39,0;;1,0;;;;;;2,0;;5,0;33,0;1,0;;5,0;;1,0;;;4,0;;;13,0;;;;9,0;34,0;;;2,0;;;;;;;2,0;2,0;;;;76,0;2,0;4,0;;;;;;;3,0;;1,0;;;31,0;;5,0;;2,0;3,0;;;;;;;;;;;;;;;;1,0;;10,0;1,0;2,0;1,0;;;12,0;;;4,0;;;4,0;;;8,0;;;;;14,0;;;;1,0;;;;4,0;;;;;;;;;;;;;;;;2,0;;;;
frequency;;;4,0;2,0;2,0;;;48,0;5,0;1,0;8,0;;5,0;;6,0;95,0;24,0;4,0;1,0;2,0;4,0;15,0;13,0;15,0;12,0;12,0;20,0;1,0;;;2,0;28,0;69,0;2,0;72,0;71,0;17,0;25,0;1,0;;41,0;9,0;5,0;1,0;22,0;21,0;161,0;69,0;9,0;7,0;;18,0;;2,0;112,0;4,0;14,0;5,0;31,0;1,0;2,0;6,0;15,0;;54,0;;19,0;6,0;10,0;;11,0;;48,0;5,0;;5,0;8,0;3,0;6,0;167,0;3,0;45,0;;68,0;14,0;13,0;23,0;;;3,0;60,0;1,0;;;4,0;2,0;7,0;;83,0;13,0;6,0;1,0;6,0;1,0;;8,0;27,0;2,0;46,0;1,0;21,0;28,0;3,0;3,0;;85,0;5,0;34,0;13,0;96,0;;;20,0;29,0;16,0;8,0;3,0;3,0;13,0;154,0;11,0;64,0;10,0;;15,0;6,0;5,0;40,0;26,0;2,0;2,0;2,0;11,0;25,0;5,0;;;;287,0;6,0;17,0;;24,0;58,0;4,0;8,0;47,0;;;13,0;;49,0;187,0;7,0;6,0;;15,0;1,0;;1,0;10,0;;;;11,0;4,0;10,0;;;;;24,0;;;5,0;29,0;;242,0;;;1,0;1,0;;3,0;2,0;;11,0;;;;;1,0;45,0;6,0;;;;24,0;;;;;;;;2,0;;;1,0;2,0;;;;;;;2,0;;101,0;;14,0;;;8,0;;2,0;4,0;;;;6,0;2,0;;2,0;8,0;1,0;;1,0;24,0;;;;;;;7,0;61,0;15,0;;;;;22,0;34,0;;1,0;5,0;;3,0;;;18,0;4,0;;9,0;;2,0;;;6,0;21,0;4,0;15,0;;5,0;47,0;;3,0;;;12,0;;29,0;;;;4,0;;4,0;1,0;5,0;1,0;4,0;1,0;;;;2,0;;1,0;;6,0;;;;;;1,0;;4,0;;;;;19,0;;3,0;;;3,0;;;;;;;1,0;;;;;;;4,0;12,0;2,0;1,0;11,0;;17,0;;;;;;;;1,0;5,0;;;5,0;;;;;;;;3,0;7,0;;;;5,0;;3,0;;;3,0;;;6,0;;;7,0;;;;3,0;;18,0;;;;66,0;;1,0;;3,0;;;;1,0;;;41,0;;9,0;29,0;33,0;28,0;19,0;1,0;1,0;5,0;;1,0;;1,0;;;7,0;19,0;4,0;;4,0;3,0;6,0;8,0;1,0;33,0;7,0;3,0;19,0;5,0;60,0;69,0;23,0;16,0;3,0;31,0;9,0;;7,0;35,0;12,0;1,0;1,0;14,0;1,0;;;;19,0;4,0;1,0;;;5,0;;;6,0;6,0;;;;;21,0;5,0;;;;5,0;1,0;1,0;20,0;1,0;9,0;;25,0;;4,0;2,0;6,0;5,0;;3,0;;;15,0;7,0;3,0;2,0;6,0;3,0;1,0;;1,0;;7,0;2,0;8,0;;1,0;;2,0;;14,0;;9,0;;;13,0;3,0;;;45,0;;;2,0;2,0;;4,0;;;50,0;;;3,0;;7,0;5,0;63,0;;;31,0;7,0;2,0;16,0;1,0;;;2,0;;9,0;21,0;6,0;;5,0;7,0;;;;;;;;;;4,0;4,0;5,0;85,0;;18,0;4,0;48,0;;;22,0;;7,0;;1,0;5,0;;;;;;;;;;3,0;;;;;17,0;4,0;;;;;;;;12,0;1,0;1,0;;;5,0;3,0;7,0;;;3,0;2,0;;;;;;;;3,0;;2,0;2,0;;9,0;;;3,0;6,0;;;;;4,0;1,0;2,0;;;;;;;;3,0;9,0;;;2,0;;;4,0;7,0;131,0;;;;;2,0;1,0;;;;300,0;;2,0;14,0;;;;1,0;;3,0;;6,0;;;;;;;;;1,0;;;;;;;6,0;;2,0;11,0;2,0;;;;;;;;;;4,0;;;;4,0;;;;;;;11,0;;;14,0;;;;;;;;;5,0;;6,0;5,0;4,0;1,0;;;1,0;4,0;;;;;;;;3,0;1,0;;;;8,0;;;;;5,0;;;4,0;;1,0;;;;1,0;;;;;;;;;;2,0;6,0;10,0;;;;;2,0;5,0;;;1,0;4,0;;;1,0;;19,0;8,0;;;;2,0;;;;;1,0;1,0;5,0;;174,0;2,0;;4,0;;;4,0;;7,0;40,0;;;;5,0;;1,0;;4,0;;1,0;4,0;;;1,0;;4,0;2,0;;1,0;11,0;;;4,0;;;;;4,0;;;1,0;;;5,0;;3,0;;8,0;;;9,0;6,0;;;;1,0;;;;;;;;;3,0;6,0;;;;;;;1,0;3,0;;;;;;;;177,0;;;;109,0;;;;1,0;;;;;4,0;;;7,0;;;;1,0;10,0;;;;;;;2,0;4,0;;8,0;;4,0;;;4,0;;;;;;;;2,0;;4,0;20,0;1,0;;1,0;1,0;;5,0;;;1,0;;;;;;;;3,0;4,0;;;;;;;;;5,0;;;4,0;2,0;;4,0;3,0;2,0;;;;;;;;;2,0;;;;;;;;;;;1,0;;;;;1,0;;;6,0;;;1,0;;;
friction;;;1,0;;;4,0;1,0;4,0;;8,0;;;;;30,0;2,0;7,0;;;;;2,0;2,0;;;29,0;;;;;;;17,0;;15,0;;6,0;;;;;3,0;9,0;;;;;12,0;;;2,0;;;;13,0;2,0;;;5,0;;2,0;;;;;;10,0;6,0;3,0;2,0;;;3,0;;;;;;;4,0;;;;17,0;2,0;;;;;;6,0;;;8,0;;;;;10,0;;;;21,0;;;;23,0;2,0;;;;;2,0;;;8,0;40,0;6,0;1,0;2,0;5,0;;;;;;;;;11,0;;;1,0;;;;;;;;;;;;;;;6,0;;;;1,0;;;;;1,0;;;;;1,0;4,0;;;;;;;;;;;1,0;;16,0;17,0;59,0;;;1,0;7,0;;2,0;;4,0;2,0;1,0;;;1,0;;;17,0;;21,0;;;;;7,0;;;7,0;;5,0;;;;4,0;1,0;;30,0;;;;5,0;;;4,0;1,0;;1,0;;;;1,0;14,0;;;204,0;;;18,0;26,0;1,0;4,0;1,0;15,0;3,0;;;;2,0;;;;;;2,0;10,0;;;;3,0;;2,0;;;;3,0;;2,0;;;;4,0;;9,0;;2,0;;8,0;;;;;21,0;;24,0;;;;6,0;;2,0;;;;;;;11,0;;;;2,0;;1,0;;10,0;;9,0;2,0;2,0;17,0;;;2,0;;;;;;2,0;;;1,0;;;1,0;;;;8,0;;2,0;;;;1,0;;;;;;;;;;;;2,0;;;;1,0;;7,0;;;14,0;;;38,0;;;;3,0;1,0;1,0;;;1,0;;;;;;;;4,0;;;;;3,0;3,0;1,0;7,0;12,0;;;4,0;;;18,0;;;4,0;;;;;;;1,0;;;;;;;;;;;;;;6,0;;;;;;;;;;;;;;;;;;;;;;;4,0;;;;;;;;;3,0;;;;;;;;;;;;6,0;3,0;;;;;;;;;;3,0;;;;;;;;;;;;;;;11,0;;;;;;;;;;;;;;;2,0;;;1,0;;20,0;;;;;;;;;;;;;;;;;;;;;;;5,0;;;;;;;;;;;;;;;;;;1,0;;;;;;;;;;;;;;;;;;;;;;;;;;;;;;;;;2,0;;;;;;;;;;;;;;1,0;;;;;2,0;;2,0;;;;;;;;;;;;;;;1,0;;4,0;;;;;;;;;;;;;;;;;;;3,0;;;;;;;;;;;;;;;;;;;;;;;4,0;;;;4,0;;6,0;;;;;;;9,0;;;;;;;;;;;4,0;;;;;33,0;;1,0;;;;;;;;;;1,0;;;;;;;2,0;;9,0;5,0;;;;;;;;;;;;;2,0;;;;;;;1,0;;;;;;;2,0;;;;;;7,0;1,0;;;;;;;;;;;;;;;;;;1,0;;;;;;;;;;;;;;;;;;;;;;4,0;;;;;;;;;;;;;;;;;;;;;;;;;;;;;;;;;;;;;;;;;;;1,0;;;;;;;;;;;;;;;;;;;;;;;;;;;;;;;1,0;;;;;;;;;;;;;;;;;;;;22,0;;1,0;;;;;;;;;;;;;;;1,0;;1,0;;;;;;;;;;2,0;;;25,0;;2,0;;;;;;1,0;;;;;;;;;;;;;;;;;;;;;;;;12,0;;;;;;;;;;;;;;;;;;;;;;;;;;;;;;;;;3,0;;;;;;;;;;;;;;;;3,0;;;;;;;;;;;;;
gain;;;1,0;;;;9,0;15,0;3,0;5,0;3,0;;4,0;;6,0;48,0;;;9,0;;3,0;14,0;;4,0;9,0;35,0;74,0;7,0;;9,0;8,0;;28,0;1,0;127,0;18,0;9,0;47,0;;;46,0;5,0;;;7,0;;39,0;28,0;35,0;4,0;;46,0;1,0;9,0;3,0;9,0;6,0;;6,0;;;;;;5,0;16,0;1,0;;33,0;;5,0;2,0;49,0;;1,0;2,0;8,0;;1,0;113,0;;12,0;;26,0;15,0;1,0;;;;2,0;37,0;;;;;1,0;2,0;;35,0;3,0;1,0;4,0;9,0;3,0;;;24,0;;60,0;22,0;;29,0;;;;29,0;4,0;38,0;;10,0;;;1,0;12,0;7,0;1,0;;;1,0;2,0;;10,0;;;;;9,0;8,0;3,0;;1,0;;1,0;57,0;80,0;5,0;;;194,0;2,0;;;3,0;12,0;4,0;34,0;8,0;;4,0;;;3,0;97,0;3,0;7,0;;28,0;;1,0;2,0;;;;;17,0;13,0;1,0;1,0;;11,0;;;;;1,0;16,0;;23,0;;;;;;3,0;;;;;;;;;9,0;7,0;;;4,0;;52,0;5,0;;;;6,0;;11,0;;;;;;;;;;;8,0;;6,0;;;;3,0;;;1,0;;;;;;;;2,0;;;;;47,0;5,0;;;;;;;4,0;11,0;;1,0;;;;25,0;;;5,0;;16,0;;;2,0;;;;;;;;;6,0;;6,0;;16,0;36,0;;;;;;;1,0;;;;4,0;;;;3,0;1,0;;;;;4,0;3,0;;;;1,0;;;;4,0;;;;18,0;;;;;2,0;;;;;;;;;;;3,0;;;13,0;;;;;27,0;;1,0;;;;9,0;;2,0;1,0;3,0;;;;1,0;;6,0;;;;;;;;;;5,0;;;;;;;;;;;;;;;;1,0;;;;;6,0;4,0;;;;;;;;;;;2,0;;;;11,0;3,0;3,0;149,0;33,0;;;;1,0;4,0;;;2,0;6,0;6,0;1,0;2,0;1,0;;1,0;;1,0;;4,0;;21,0;17,0;;;;4,0;2,0;19,0;;3,0;7,0;2,0;;;1,0;12,0;;;4,0;3,0;;;;6,0;4,0;;;;;4,0;;;;;;;;6,0;;;;;6,0;;;;;11,0;;54,0;;;17,0;31,0;2,0;;;12,0;1,0;;;;5,0;5,0;3,0;;;;;;;;2,0;4,0;;;4,0;3,0;;;;;;;;;;9,0;;1,0;;;23,0;;;;;;;;;;2,0;;;19,0;1,0;;4,0;;;;;;2,0;3,0;;;2,0;;;2,0;2,0;;;;;;;;;2,0;1,0;;;;;;2,0;9,0;;2,0;;;4,0;;;;;;;;;11,0;;;;;;;;;;2,0;;;;;;;;42,0;;;3,0;;;;;;;;;;;;;;1,0;4,0;;;;1,0;;1,0;;;3,0;;;;;;;;;;;;;;;1,0;;;1,0;;;5,0;;;;2,0;;8,0;12,0;;;;;;3,0;12,0;;2,0;;;;;;;;;;;;;;;1,0;;;;;;;;;1,0;;;;;;;9,0;;;;;;;;;;;;;;;;;;;3,0;;;;1,0;;;;3,0;;;9,0;4,0;1,0;;;;;;;;;;1,0;;;3,0;2,0;;;;;;;;;;;;;;;;;2,0;32,0;7,0;87,0;1,0;12,0;;11,0;;;;;2,0;16,0;;4,0;15,0;;;;;;;;;1,0;;;10,0;;3,0;2,0;23,0;;;;;;;;4,0;73,0;;21,0;;1,0;;;4,0;;;8,0;;;;;;;;;1,0;;34,0;;11,0;11,0;;;;;;;;2,0;;;;;;;;;;;;;;6,0;;;;;;;10,0;;;;;3,0;;;;;;;;;;;;;;;;;;;;;;;2,0;;;;1,0;;;;;;;;;;;;2,0;2,0;;;4,0;;;;;;;;;;;;23,0;;23,0;;;;;;;5,0;;;;;;;;2,0;;;3,0;;;;;;;;;;;;;;;;;;;;;;;1,0;;;3,0;;;;2,0;;;;;;;6,0;;;3,0;;2,0;;;4,0;;;;;;;;14,0;;;;;;;;;;;;
height;;;2,0;;;29,0;5,0;2,0;18,0;11,0;;8,0;5,0;2,0;19,0;40,0;4,0;;6,0;6,0;;3,0;1,0;;;4,0;6,0;;4,0;;;4,0;2,0;;1,0;2,0;4,0;2,0;3,0;;4,0;4,0;38,0;20,0;13,0;7,0;29,0;35,0;5,0;2,0;5,0;10,0;22,0;2,0;1,0;3,0;16,0;;4,0;;11,0;1,0;7,0;;2,0;25,0;6,0;5,0;7,0;8,0;1,0;;6,0;;;;2,0;8,0;;255,0;;8,0;;24,0;2,0;;4,0;;2,0;41,0;49,0;;;2,0;3,0;6,0;;1,0;36,0;12,0;1,0;;47,0;49,0;;2,0;35,0;;;13,0;5,0;;34,0;;;8,0;33,0;105,0;1,0;39,0;;;;2,0;;1,0;;;;25,0;1,0;14,0;23,0;;7,0;;3,0;;;4,0;7,0;;;44,0;;29,0;;17,0;8,0;1,0;;2,0;2,0;7,0;;2,0;27,0;7,0;7,0;6,0;1,0;3,0;39,0;8,0;9,0;;1,0;6,0;;2,0;15,0;2,0;;2,0;3,0;;2,0;8,0;12,0;;4,0;8,0;;10,0;;16,0;;6,0;;;2,0;;;2,0;;;;;;6,0;3,0;1,0;8,0;13,0;;;;;;6,0;2,0;;;6,0;;;5,0;;;2,0;9,0;;4,0;;;1,0;5,0;;9,0;;18,0;4,0;3,0;14,0;;1,0;2,0;8,0;;5,0;;1,0;;4,0;;;2,0;18,0;6,0;22,0;5,0;;3,0;;;;7,0;3,0;;5,0;;2,0;1,0;5,0;2,0;;8,0;5,0;;;3,0;2,0;13,0;7,0;;;3,0;6,0;19,0;69,0;;;;21,0;;;5,0;1,0;2,0;;14,0;5,0;;1,0;7,0;;3,0;;;;8,0;3,0;5,0;4,0;15,0;;;;9,0;2,0;;;;;;1,0;;3,0;;6,0;1,0;;;2,0;1,0;;6,0;;1,0;;;;1,0;3,0;;1,0;5,0;;;9,0;;1,0;;;43,0;;;1,0;10,0;;;6,0;2,0;2,0;;1,0;;30,0;1,0;;15,0;10,0;;3,0;3,0;;;5,0;4,0;;1,0;;;;;3,0;8,0;;3,0;;;2,0;;4,0;;;;;;49,0;2,0;6,0;;;1,0;;;59,0;;;;;;2,0;;;;;1,0;30,0;6,0;1,0;7,0;;2,0;;;;;;2,0;4,0;;4,0;;1,0;15,0;7,0;;;;1,0;6,0;1,0;;;2,0;18,0;;;1,0;1,0;9,0;;;2,0;1,0;;1,0;;4,0;;;;;2,0;1,0;;;;;1,0;;2,0;1,0;3,0;;1,0;;1,0;1,0;1,0;;;13,0;;20,0;;7,0;;8,0;1,0;;30,0;16,0;;;;2,0;1,0;;;;1,0;;;;;;;3,0;;;;1,0;;;;;;;2,0;;;;;;;3,0;;2,0;;;14,0;;7,0;;;2,0;;;;1,0;;;;3,0;;1,0;;;;;1,0;;3,0;3,0;;;;;;;8,0;;2,0;;;;;;;;4,0;;2,0;;;1,0;;1,0;;;;;;;;;1,0;;;;;;;;;4,0;;;;;4,0;;3,0;;;;;9,0;;;;;18,0;;;;;;4,0;;;;;;;;;;;;;;;15,0;3,0;;;;;;;1,0;;;4,0;;2,0;;;;;;;3,0;;3,0;;1,0;1,0;;4,0;9,0;1,0;;;;;;;;;1,0;;;;;;;;;;;;;4,0;3,0;1,0;1,0;;14,0;;;10,0;2,0;7,0;;;;1,0;1,0;;;1,0;;10,0;5,0;;;;;;;;;;;;;;;10,0;;;;;;;;3,0;;2,0;;4,0;4,0;;1,0;2,0;;;20,0;;;;;;;;;2,0;2,0;2,0;;1,0;;2,0;;3,0;4,0;;;;3,0;1,0;;;2,0;;;;;;;;12,0;5,0;;;4,0;;1,0;;2,0;;;;2,0;94,0;2,0;;;;2,0;;1,0;;;;;;;;;;;;1,0;;7,0;;;1,0;;2,0;3,0;;;;2,0;1,0;24,0;;1,0;;2,0;;;;;;4,0;;;;;;;;;;1,0;;;1,0;;;2,0;;;;;1,0;;;;;;;4,0;;;;;;;9,0;;;;;;;;;1,0;;;;;;;;;;;;;;;;1,0;;1,0;;;2,0;;;1,0;;;;;;;;;;;;;;;;;;;;;;;1,0;;;;;;;2,0;;;;;;;;;10,0;;;;;;;;;;;;;;;1,0;;;;17,0;;;;2,0;11,0;;1,0;;;;4,0;;2,0;;;;;1,0;;2,0;;;;;1,0;;3,0;;;;2,0;;;;;;1,0;8,0;;;;;;;9,0;;;;;;
identifier;;;2,0;;3,0;;;61,0;2,0;;;;52,0;9,0;;18,0;;;;;;19,0;;;;;21,0;;;;5,0;6,0;12,0;;52,0;9,0;;;;;31,0;;;;7,0;;12,0;55,0;;40,0;;;;;;;2,0;;;;;14,0;;;;;;;;;;;2,0;;;;40,0;;;92,0;1,0;10,0;;45,0;;9,0;;;;;;;;;;3,0;6,0;;30,0;7,0;;;;36,0;;2,0;;1,0;1,0;2,0;;1,0;;;;7,0;2,0;16,0;;21,0;;;5,0;1,0;1,0;1,0;;;;;;3,0;;;1,0;3,0;5,0;14,0;3,0;;;;3,0;;1,0;;;;1,0;;2,0;;2,0;11,0;;;12,0;;;;;26,0;34,0;;;;4,0;;;;;;;;2,0;;;;;;;;;;;;;1,0;;;;;;10,0;;2,0;;;;;;;;;;;;;;;;;;;;;;;;;;;;;;;;;12,0;;2,0;;;;;14,0;1,0;1,0;;;1,0;30,0;;2,0;;;;36,0;;;;;;;;;22,0;2,0;;;;;;77,0;;;;;1,0;;;19,0;;;;;;3,0;;;3,0;;1,0;;;;;;;;;;;;;;;;;;;2,0;1,0;;;;;;;;;9,0;;;1,0;;;;;;;;;;;;;;;2,0;;;;;;4,0;;;;;;;;;;;;;1,0;;;;4,0;;;;;;2,0;;;;;;;;;;;;;;;1,0;;;;;;;;;;;;;;;;;;8,0;;1,0;;9,0;;;;4,0;;;31,0;;;;;;;;;;1,0;1,0;12,0;;;;;1,0;1,0;;;;;;;3,0;;;;2,0;6,0;;10,0;;19,0;;3,0;;;;2,0;;12,0;;8,0;;;;2,0;;;;;7,0;6,0;;;;3,0;;;;;;;;;5,0;;;;;23,0;;;;;;1,0;;;;;;;;1,0;1,0;;;2,0;4,0;;;;;8,0;2,0;;;3,0;6,0;;;;;;;;;;;;;;;;;7,0;;;;;;7,0;;;2,0;;1,0;4,0;;;;14,0;7,0;;;;;;;;2,0;;1,0;;2,0;1,0;;;2,0;2,0;;;;;2,0;;;2,0;;;;;11,0;;;;;;;;;;;;;;;;;;;15,0;;;;3,0;;;;;;;8,0;;;9,0;1,0;;26,0;;;6,0;;;;;;;;;;;1,0;;1,0;;;;1,0;;;;6,0;;;;;;;5,0;7,0;;;;;;;;;;;;;;;;9,0;1,0;;;;;;;;;;;;;;;;;;;;;;;;;;;;;;1,0;;;;2,0;;;;;;;;1,0;;;2,0;1,0;;;;;1,0;;;;;;;;;;;;;;;;;;;;;;;;;;1,0;;;;;;;;;;;5,0;;;5,0;;;;;;;;;;;;;;;;;;;;;;;;;;5,0;;;;2,0;;;;1,0;;;;;;;;;;;;;;;;;;;;;;;;;;;1,0;2,0;;;;;;;;;;;;;;;;;;;;;;;3,0;;;;;;;;;;;8,0;;;;;30,0;;;;;;;;;;;;;;;;;;;;;;;;;;;;;;;;1,0;;;;;;;4,0;1,0;;;;;;;;;;;;;;;1,0;;;;;;;;;;;2,0;;4,0;;;;;;;;16,0;;;;;5,0;;;;;;;;;;;;;;;;;;;;;;;;;;;;;;;;;;;;;;;;;;;;;;;;;;;;;;;;;;1,0;;3,0;;;;;;;1,0;;;;;;;
installation;;;1,0;;;8,0;;3,0;2,0;2,0;;;5,0;;2,0;8,0;;;;3,0;1,0;;;;;2,0;;;;;8,0;;22,0;;4,0;;;;;;;;;;;;2,0;1,0;11,0;;3,0;4,0;;;;;;;;;1,0;;;;;;;;;;1,0;;2,0;;;;;;;18,0;7,0;;;14,0;;;;;;1,0;18,0;;;4,0;;;1,0;;38,0;4,0;;;2,0;6,0;;;7,0;;;6,0;;2,0;1,0;;;5,0;8,0;5,0;1,0;;;;1,0;3,0;;;;;;;;;;;;;;3,0;;;1,0;2,0;2,0;3,0;;;;1,0;6,0;;1,0;;;4,0;;;17,0;;1,0;;;1,0;14,0;;;;4,0;;;;;;4,0;4,0;;;18,0;4,0;;;;;;;;;;1,0;;;;;;3,0;;3,0;;;;;6,0;;;3,0;;;;;;9,0;;;;;;;;;3,0;;1,0;;;;;;;;1,0;;10,0;;;4,0;;;;;;;;2,0;;2,0;3,0;;;;;;;;;2,0;;;2,0;;;;;;;;;;;;;;;;3,0;;;;;9,0;1,0;23,0;1,0;;;;;;;;;;3,0;;;;4,0;;;;;;;;13,0;;;;;;;;;;;;2,0;;;;;2,0;2,0;;;;2,0;;16,0;;;6,0;;2,0;;;;;;;4,0;4,0;;;;;1,0;;;;2,0;;;1,0;;;;;;1,0;;;;;;;;;;;10,0;;;;2,0;;;;;;4,0;;;2,0;;;;;;;;3,0;;;;;1,0;;;;;;;;2,0;1,0;;;;;;3,0;2,0;;1,0;;;;;;;;;;6,0;;;;;;;;;;;;3,0;;;;13,0;;13,0;;;;7,0;;4,0;;;;;;;;;;;;;;;;;;;;;;;;;;;;1,0;;;;;1,0;;;;;3,0;;;;;;;;;1,0;1,0;;;;;;;;;3,0;;;;;;;;;;;;;80,0;;;;1,0;;2,0;;1,0;;;;;1,0;;;;;;38,0;1,0;;1,0;;;;;;;;;;;;;;;;;;2,0;;7,0;;1,0;;;;;;;;;;;;;;1,0;1,0;;;1,0;1,0;;;;;;;;;;1,0;1,0;;;2,0;3,0;;;;;;;;;;;;;;;;;;;;;;;;1,0;;;;;;;;1,0;;;3,0;;;;2,0;2,0;;;;11,0;;;;9,0;;;2,0;;;;;;;;;;6,0;;;;;;;;;;;;1,0;;;;4,0;;;;3,0;;1,0;;;14,0;;;;;;;;;;;;;;;;;;;;;;;;3,0;;;;;;;;;;;;;;;;;;;;;;;;;;;;;3,0;;;;;;;;;;;;;;;;;;;;;;;;;;;;;;;;;;;;;;;1,0;;;;;1,0;;;;;;;;;;;;;;;;;;;;;;;;;;;;;;2,0;;;;;;;;;;;1,0;;;;;;;;;1,0;;;;;;;;;;;;;;;;;;;;;;;;;;;;;;;;;;;;;;;;;;;;;;;4,0;;;;;;;;;;;;;;;;;;;;;;;;;;;;2,0;;;;;;;;;;;2,0;;;;;;;;;1,0;;;;;;;;;;;;;;;4,0;;;;;;;5,0;;;;;;;;;;;;;;;;;;;;;;;;;;;;1,0;2,0;;;;;;3,0;;;;;2,0;;;;;;;;;;;;;;;
instrument;;;1,0;;;;;2,0;2,0;;;;1,0;;16,0;9,0;7,0;;;;2,0;3,0;;;;;6,0;12,0;;;1,0;4,0;6,0;;1,0;;;;;;5,0;;;;2,0;3,0;7,0;7,0;3,0;6,0;;2,0;;;24,0;;;;;;2,0;2,0;1,0;;6,0;1,0;;9,0;;2,0;1,0;;1,0;;;;2,0;;;43,0;;29,0;;11,0;;2,0;;;;1,0;18,0;;;4,0;2,0;;2,0;;29,0;;;;;3,0;;;28,0;;1,0;;1,0;3,0;;;;1,0;1,0;5,0;;1,0;;;;1,0;;;;;1,0;;;4,0;3,0;1,0;1,0;;1,0;;;;;;;2,0;3,0;;;27,0;3,0;1,0;;;2,0;4,0;;;21,0;;;;1,0;;36,0;;;;;2,0;2,0;;;3,0;;;;;2,0;;;;;3,0;;3,0;;;;1,0;;;;;;;;1,0;;;;;;2,0;2,0;7,0;;;1,0;;;;2,0;;;;;;;;;;3,0;;;;;;2,0;;8,0;2,0;;;;6,0;;1,0;2,0;;;2,0;;7,0;;5,0;;;;;;3,0;;;;;;;2,0;;;;;;;1,0;30,0;;;;;;;1,0;1,0;;;;;2,0;1,0;5,0;;;;;;1,0;;;;;6,0;3,0;24,0;;;;;;;;;;2,0;;;1,0;;;;;;;1,0;;;;;8,0;;;;;;7,0;;;2,0;;;;;;;;;;;;;;;2,0;3,0;;;;;;4,0;;;;;;;;;9,0;;;;;;;;;;;;;;;;;;2,0;;;12,0;8,0;;;;5,0;;;;1,0;;;;5,0;1,0;;;;;;;;;;2,0;2,0;;;;;;14,0;2,0;;1,0;;;;;;;;;;1,0;;;1,0;;;;;;;1,0;;5,0;;1,0;3,0;;;2,0;;2,0;;1,0;1,0;;;2,0;;3,0;;;;;4,0;1,0;;;;;;;;;;;3,0;;;;;;;;;;;;;;;;8,0;11,0;;;;1,0;;;;;1,0;;;;;12,0;1,0;;;;;3,0;;2,0;;;;2,0;3,0;;;;;1,0;;;;;;;;1,0;;;;;;;3,0;;8,0;;;;;;;;;;;;;;;;;;;;4,0;;;;;;;;;;;1,0;;;;;;;;2,0;;;;;;;;1,0;;;;;;;;;;;;;1,0;;;;;;1,0;4,0;;;;;;12,0;;;;;;;;1,0;;;;;1,0;;;;;;;;;;;;;;;;;;;1,0;1,0;;;;;;;;;1,0;;;1,0;;;;;;;;;;;3,0;2,0;;;;2,0;;;3,0;;;;;;;;;;;;;;;7,0;;;;;;;;;;;;;1,0;;;;;;;;;;;;;;;1,0;;12,0;;;;;;;;;;;;;;;;;;;;;;;;1,0;;;;;;;;;;;1,0;;;;;;;;;;;;;;;;;;;;;;;1,0;;;;;;;;;;;;;;;;;;;;;;;;;3,0;;;;;12,0;;;1,0;;;;;;;;;;;;;;;;;;;;;;;;;;;16,0;2,0;;;;;1,0;;;;;;;;;;;;;;;;;;;;;;;;;;;;;;;;;27,0;;;;;;;;;;;;;1,0;;1,0;;;;;;;;;;;;;1,0;;;;;;;;;;;;;;4,0;1,0;;;;7,0;;;;;;;;;;;;;;;;;;;;;;;;;;;;;;;;;1,0;;;;;1,0;1,0;;;;;;;;;;;;;;;;;;;;;;;;;;;;;;;;;;;;;;;;;
location;;;2,0;1,0;16,0;49,0;11,0;80,0;85,0;21,0;22,0;;139,0;1,0;37,0;368,0;2,0;;2,0;6,0;41,0;187,0;7,0;1,0;3,0;2,0;49,0;9,0;;5,0;38,0;3,0;127,0;;79,0;39,0;25,0;15,0;6,0;1,0;277,0;1,0;44,0;25,0;132,0;24,0;531,0;389,0;78,0;153,0;21,0;162,0;2,0;6,0;3,0;61,0;47,0;53,0;81,0;;7,0;29,0;56,0;13,0;35,0;61,0;97,0;21,0;58,0;13,0;27,0;6,0;62,0;;9,0;41,0;160,0;6,0;9,0;750,0;;23,0;8,0;128,0;8,0;21,0;;;3,0;19,0;131,0;;1,0;5,0;32,0;16,0;46,0;3,0;283,0;126,0;18,0;2,0;26,0;288,0;1,0;18,0;49,0;6,0;19,0;21,0;6,0;12,0;1,0;15,0;;211,0;73,0;178,0;3,0;44,0;4,0;1,0;14,0;18,0;71,0;10,0;5,0;1,0;9,0;15,0;2,0;65,0;114,0;1,0;73,0;4,0;33,0;20,0;95,0;;86,0;;2,0;74,0;12,0;2,0;;5,0;37,0;38,0;57,0;;69,0;97,0;51,0;;140,0;;9,0;24,0;17,0;56,0;75,0;1,0;10,0;;117,0;116,0;13,0;5,0;10,0;;;15,0;2,0;5,0;1,0;7,0;;2,0;1,0;23,0;;4,0;5,0;7,0;;7,0;1,0;;1,0;;;12,0;;16,0;8,0;;;9,0;;1,0;32,0;27,0;22,0;;;1,0;5,0;31,0;4,0;6,0;4,0;;2,0;1,0;1,0;;;9,0;19,0;;13,0;1,0;5,0;1,0;1,0;;53,0;;3,0;;14,0;21,0;12,0;38,0;30,0;5,0;9,0;13,0;6,0;24,0;4,0;18,0;3,0;;;54,0;121,0;48,0;4,0;2,0;;;;;115,0;2,0;4,0;;;;6,0;106,0;;;4,0;;;;;90,0;69,0;;4,0;2,0;27,0;19,0;9,0;142,0;8,0;;12,0;3,0;;76,0;7,0;54,0;2,0;;129,0;18,0;;;4,0;;6,0;;6,0;;2,0;14,0;15,0;1,0;2,0;6,0;;11,0;11,0;7,0;;7,0;;;14,0;12,0;2,0;;;8,0;1,0;;;2,0;4,0;1,0;;;3,0;;;;1,0;;;19,0;14,0;9,0;3,0;8,0;;;7,0;4,0;;;6,0;4,0;2,0;49,0;5,0;7,0;1,0;;;4,0;3,0;248,0;10,0;1,0;1,0;11,0;4,0;1,0;4,0;1,0;;3,0;2,0;8,0;12,0;;;2,0;;;7,0;;4,0;22,0;;6,0;6,0;;2,0;15,0;;2,0;4,0;4,0;30,0;88,0;14,0;3,0;;5,0;4,0;;19,0;;2,0;4,0;31,0;11,0;2,0;13,0;;;9,0;116,0;21,0;12,0;67,0;5,0;25,0;6,0;4,0;7,0;1,0;7,0;1,0;21,0;58,0;9,0;6,0;;1,0;114,0;5,0;21,0;8,0;70,0;4,0;;;;47,0;27,0;5,0;;20,0;24,0;17,0;28,0;21,0;20,0;8,0;11,0;118,0;6,0;20,0;;;37,0;;35,0;53,0;15,0;;3,0;21,0;12,0;5,0;13,0;;1,0;1,0;4,0;25,0;93,0;16,0;21,0;4,0;21,0;131,0;3,0;9,0;;4,0;;30,0;1,0;1,0;31,0;94,0;1,0;;6,0;;27,0;4,0;95,0;53,0;7,0;2,0;10,0;5,0;29,0;52,0;9,0;1,0;1,0;20,0;59,0;11,0;9,0;18,0;;4,0;3,0;3,0;34,0;2,0;;35,0;5,0;13,0;1,0;5,0;;;4,0;;18,0;1,0;12,0;44,0;;23,0;1,0;9,0;4,0;3,0;6,0;;;59,0;22,0;1,0;;4,0;6,0;2,0;;1,0;6,0;4,0;12,0;;5,0;;3,0;;60,0;;14,0;1,0;1,0;;;;3,0;9,0;14,0;;14,0;1,0;65,0;6,0;3,0;17,0;35,0;23,0;;4,0;2,0;2,0;4,0;6,0;;;3,0;;2,0;;;4,0;7,0;2,0;3,0;9,0;10,0;;17,0;4,0;3,0;4,0;3,0;;1,0;43,0;2,0;9,0;2,0;;10,0;9,0;;;12,0;;24,0;3,0;;;;;4,0;1,0;13,0;;;1,0;6,0;14,0;5,0;54,0;9,0;;;1,0;;3,0;24,0;11,0;7,0;2,0;;2,0;4,0;22,0;1,0;6,0;;6,0;29,0;7,0;1,0;87,0;2,0;;36,0;;;11,0;2,0;1,0;;3,0;6,0;4,0;;;4,0;;59,0;;3,0;;;2,0;;;2,0;;1,0;;;;2,0;;10,0;27,0;3,0;;16,0;;1,0;;;;141,0;3,0;;2,0;1,0;;32,0;7,0;;2,0;;16,0;1,0;;;8,0;2,0;;;3,0;;;1,0;;;;;;;;2,0;;2,0;4,0;2,0;4,0;;;7,0;;2,0;8,0;;8,0;;4,0;2,0;4,0;;23,0;;;8,0;1,0;;;4,0;;;;1,0;;;3,0;1,0;3,0;;20,0;;;;;;12,0;1,0;2,0;4,0;;17,0;;;;22,0;;2,0;;7,0;5,0;2,0;16,0;;3,0;20,0;1,0;4,0;2,0;4,0;;19,0;1,0;16,0;;3,0;6,0;2,0;;;;2,0;12,0;5,0;7,0;4,0;2,0;9,0;;;2,0;9,0;1,0;1,0;;6,0;;;4,0;;;1,0;4,0;;1,0;;1,0;;2,0;;;;;11,0;28,0;2,0;1,0;4,0;18,0;2,0;;1,0;;3,0;1,0;;9,0;4,0;;;;;8,0;;6,0;29,0;2,0;1,0;1,0;1,0;45,0;1,0;5,0;2,0;;1,0;;14,0;;14,0;1,0;1,0;;2,0;;;;1,0;2,0;;;2,0;;;4,0;2,0;8,0;;;14,0;;;;6,0;;;1,0;;1,0;;5,0;12,0;2,0;6,0;;41,0;19,0;;2,0;2,0;;;6,0;4,0;;;5,0;11,0;17,0;;8,0;11,0;4,0;;6,0;5,0;;;;;;;7,0;1,0;;17,0;;;1,0;2,0;9,0;2,0;;;3,0;;2,0;;14,0;;;4,0;;2,0;9,0;4,0;1,0;;13,0;;;;;;18,0;;8,0;5,0;15,0;;;4,0;1,0;;8,0;;5,0;5,0;;2,0;;4,0;8,0;22,0;;;6,0;8,0;2,0;;1,0;17,0;2,0;1,0;;;;;1,0;;;
luminance;;;1,0;;3,0;;;37,0;84,0;;2,0;;3,0;;1,0;96,0;;;;;;31,0;15,0;1,0;;2,0;72,0;;;2,0;;2,0;68,0;12,0;29,0;7,0;1,0;19,0;7,0;;125,0;10,0;;;77,0;7,0;63,0;21,0;1,0;14,0;2,0;3,0;;13,0;;17,0;19,0;;;;;;1,0;;6,0;;6,0;7,0;29,0;;;1,0;51,0;3,0;;4,0;1,0;;;374,0;2,0;27,0;;55,0;17,0;1,0;;;;;19,0;;;;;;2,0;;53,0;;9,0;;5,0;78,0;;;3,0;2,0;41,0;9,0;;15,0;2,0;1,0;;43,0;44,0;8,0;;54,0;;;37,0;29,0;11,0;;;;;13,0;;50,0;6,0;;9,0;4,0;1,0;;26,0;;14,0;;;40,0;1,0;9,0;;;182,0;2,0;18,0;;;4,0;38,0;;11,0;;;;1,0;;128,0;6,0;1,0;;9,0;5,0;8,0;;5,0;;;6,0;71,0;11,0;;;;;;;;;;7,0;;140,0;;;;4,0;;;6,0;;3,0;41,0;;;;;48,0;15,0;;;;;68,0;6,0;;;;;;4,0;;;;;;9,0;;;;;;;101,0;;;;;;;;11,0;;;;;;;1,0;;;;;153,0;;;;;;;;15,0;;;;;;;30,0;;;3,0;;2,0;;;8,0;5,0;;;;2,0;;;2,0;;;;;;28,0;;11,0;;;;2,0;;;;;12,0;;;;;;;;;;;19,0;;1,0;;;;;;5,0;;;;;;;;;;;;;;3,0;;;;;;4,0;;;5,0;;;;;71,0;;;;;;;4,0;;;;;;;17,0;;;3,0;2,0;;;;;;1,0;;;8,0;;;;;;;;;;;;;;;;;;2,0;;;23,0;;;;3,0;;;;;;;;4,0;;;;;12,0;92,0;22,0;11,0;19,0;;3,0;4,0;;1,0;;5,0;;;10,0;11,0;;2,0;10,0;4,0;3,0;;;8,0;112,0;1,0;2,0;;2,0;9,0;7,0;4,0;2,0;5,0;4,0;1,0;;;3,0;;;1,0;;6,0;;;7,0;1,0;;;;;;;;2,0;;;;;53,0;6,0;;;;;2,0;;1,0;;;;16,0;2,0;2,0;6,0;7,0;1,0;;4,0;;;;;1,0;1,0;;;;;;;;;;4,0;1,0;;;;2,0;1,0;18,0;8,0;;;;;;;;;6,0;;;2,0;;;;;;;;8,0;;;;;13,0;;;;;;;;6,0;12,0;9,0;;;4,0;;;;;;2,0;6,0;;;;;1,0;;4,0;;1,0;;;;17,0;24,0;;;;;;;;;;;;;;4,0;4,0;;;;;;;;;;;;;1,0;;2,0;;2,0;;9,0;;4,0;;;;;;;;;1,0;;;;;5,0;;;;;;37,0;;;;;;;;;;;;;;2,0;;;;;;;;;;;;;;;;;;;;;;;3,0;4,0;;;10,0;;;;;3,0;5,0;;;;;;;;;;;;2,0;;;;;;;;;;;;;;;;;;;;;2,0;;;;;;;3,0;;;;;;;;;;;2,0;;;3,0;;2,0;4,0;;;;13,0;;2,0;;;11,0;;;;;;;;;;;;;;;;1,0;;;;;;;;1,0;4,0;1,0;;;;;;;6,0;44,0;;;6,0;;6,0;4,0;;;;;;1,0;1,0;;1,0;;;;;2,0;;;;79,0;;;68,0;;;9,0;;2,0;;;;1,0;;2,0;;;;;26,0;;1,0;4,0;;1,0;3,0;3,0;;;;;11,0;;;4,0;;42,0;2,0;;;;;10,0;;;;;;;;;;;;;;;;;;;3,0;;;;;;;2,0;;;;;;34,0;;;;;;;;;;;;;;;;2,0;;;;;;;;;;;1,0;;;;;;2,0;;;;;;;1,0;;;;;;;;;;;;1,0;;;;;4,0;;20,0;2,0;;;2,0;;;;;;;;;;;;4,0;;1,0;;;9,0;;;;;;;;;;5,0;;;4,0;9,0;;;;;;;4,0;;1,0;;;;;;;;;2,0;;;;1,0;;;;;;;;;;;;
machine;;;2,0;;1,0;1,0;;2,0;9,0;;;;11,0;;10,0;21,0;;1,0;2,0;;3,0;11,0;1,0;;;;6,0;2,0;;;3,0;;7,0;1,0;27,0;5,0;;;3,0;;25,0;;1,0;1,0;10,0;2,0;26,0;25,0;8,0;12,0;1,0;2,0;;;4,0;5,0;44,0;;4,0;21,0;;3,0;2,0;1,0;1,0;;2,0;14,0;6,0;;1,0;;18,0;;;13,0;7,0;1,0;;81,0;;1,0;3,0;25,0;;51,0;;;;;11,0;;;;;101,0;2,0;;24,0;30,0;6,0;;2,0;15,0;3,0;;3,0;1,0;3,0;1,0;;11,0;1,0;;;17,0;3,0;16,0;3,0;1,0;;;9,0;17,0;10,0;2,0;;;;14,0;;7,0;3,0;1,0;;;;;;;2,0;;1,0;8,0;;;3,0;;8,0;;3,0;;7,0;17,0;;;41,0;;;;93,0;;11,0;;;;9,0;;;4,0;;;;;;1,0;9,0;;;1,0;;6,0;;;2,0;;;5,0;;;;;;1,0;;;5,0;;;;;;;7,0;;;;;3,0;;2,0;1,0;;;;;;;;;7,0;;1,0;10,0;;;4,0;;16,0;1,0;8,0;15,0;;6,0;2,0;4,0;13,0;;;5,0;;16,0;1,0;3,0;3,0;;;;1,0;;1,0;;;;;;5,0;;;;;;;8,0;2,0;;1,0;;;2,0;;1,0;1,0;2,0;;;3,0;;10,0;3,0;;2,0;;1,0;;9,0;;;22,0;;;;;1,0;;;23,0;;;;;;;;;;;;;;;;;1,0;;;1,0;;;2,0;;;;;6,0;;;;;;;;1,0;;;;;;;7,0;;;;5,0;;3,0;2,0;;2,0;5,0;;3,0;;;;;;6,0;;;;;;;;;;;;;;;;2,0;;;;1,0;;;;;2,0;;;;;;;20,0;3,0;2,0;;3,0;;;;;;2,0;;;;1,0;;;;;2,0;;2,0;;1,0;3,0;5,0;;;;;2,0;;;1,0;;4,0;1,0;;1,0;;1,0;;6,0;;;9,0;;2,0;38,0;;;9,0;1,0;3,0;2,0;8,0;1,0;15,0;;;;1,0;;;;1,0;1,0;1,0;;;;;;;;;;2,0;;6,0;3,0;;;1,0;;19,0;9,0;19,0;;;;19,0;3,0;;2,0;40,0;;;;;1,0;;3,0;1,0;10,0;;;;;4,0;;1,0;;1,0;1,0;1,0;;;;1,0;1,0;;1,0;;;1,0;;32,0;;;;2,0;;;1,0;;;3,0;;;;;;;6,0;;;;;4,0;;;;1,0;;3,0;1,0;;;;1,0;2,0;;;1,0;;;;;;;4,0;;;;;6,0;4,0;1,0;;;;4,0;1,0;;3,0;;5,0;;48,0;2,0;;;;;;;38,0;;;;;;;3,0;1,0;;1,0;3,0;;;2,0;2,0;16,0;;;1,0;;;;;;16,0;;;;;;;;109,0;;;;3,0;5,0;;10,0;;;;2,0;;2,0;2,0;6,0;2,0;;4,0;3,0;;1,0;;8,0;;;;;;2,0;;;12,0;;;;;;;;;;;1,0;;;;;;;;;;;;;;;;;;;;5,0;;;2,0;;;;;;;;;;;;;1,0;;;;;;;2,0;;;;;;;1,0;;;;;;;;;;;;29,0;1,0;;;;;;;7,0;2,0;;;3,0;;;;;4,0;;;;;;;;;;;2,0;;;;;;3,0;;;;;;2,0;1,0;;;;;;;;;;;1,0;;3,0;;;;;;;;1,0;;;7,0;;;;2,0;;;;;1,0;;;;;;;;;;1,0;;;1,0;;3,0;;1,0;;;2,0;;;;;13,0;;;;;;;;;;;1,0;;;;;1,0;;7,0;20,0;2,0;2,0;;;;;;1,0;4,0;1,0;;1,0;2,0;3,0;;;;;;;;;2,0;1,0;;;;;;;;;;;;;;3,0;;;;;;;4,0;1,0;;;;;;;;;;;;;;;;;;;;;;;;5,0;;;;1,0;;;;1,0;;;2,0;;;;;;;2,0;;;;;;;;;1,0;;;;;;;2,0;;;;;;;;;;;;;;;;;;;;;;;;;;;;;;;;;;;1,0;;;;;;;;;;;;;;;;;;
magnification;;;99,0;;;21,0;1,0;5,0;34,0;5,0;2,0;;11,0;1,0;34,0;21,0;;12,0;;3,0;10,0;18,0;26,0;;1,0;1,0;8,0;;;4,0;4,0;101,0;29,0;;12,0;6,0;2,0;7,0;2,0;;;20,0;13,0;20,0;2,0;;95,0;69,0;15,0;22,0;;51,0;3,0;1,0;6,0;;11,0;;1,0;;1,0;;5,0;;;20,0;45,0;4,0;6,0;;9,0;;14,0;;1,0;8,0;10,0;2,0;2,0;201,0;;66,0;;31,0;75,0;5,0;9,0;;92,0;14,0;331,0;;;;14,0;3,0;;;29,0;2,0;;1,0;11,0;52,0;10,0;6,0;127,0;9,0;10,0;13,0;2,0;29,0;;;;27,0;39,0;43,0;11,0;18,0;;;6,0;13,0;8,0;2,0;;;;49,0;;10,0;9,0;;7,0;6,0;15,0;5,0;2,0;30,0;16,0;;1,0;10,0;22,0;;;11,0;9,0;24,0;;;2,0;6,0;2,0;;68,0;51,0;6,0;;2,0;;333,0;40,0;55,0;;1,0;14,0;;2,0;160,0;;;;7,0;8,0;3,0;;;;;6,0;;;;1,0;;1,0;1,0;;;;;;;;;;;;;;5,0;19,0;;;;;;6,0;;11,0;;;;;;;2,0;8,0;;;;;;;;;7,0;;;;;3,0;;15,0;19,0;;;;7,0;;;4,0;;;;;5,0;8,0;;;;;;;1,0;;;;;;;22,0;;1,0;3,0;;;;;2,0;4,0;;;;;;;2,0;;;4,0;5,0;;39,0;;;;;;;;;;;;;;;2,0;;1,0;;;;;;;;;4,0;;;2,0;1,0;;;;;;;1,0;2,0;;;;2,0;17,0;;;;;;;7,0;;;2,0;;;;11,0;;7,0;;;;3,0;2,0;;1,0;;10,0;;;;2,0;;1,0;2,0;;;;;;;;;;1,0;;;;;;;;2,0;;;;;;;2,0;;;;2,0;;14,0;;;;;;14,0;9,0;;;;;;;;;1,0;8,0;12,0;158,0;1,0;;3,0;4,0;4,0;;;7,0;;;;8,0;6,0;;;;;;1,0;;13,0;20,0;2,0;1,0;3,0;8,0;9,0;10,0;;;;8,0;;;1,0;16,0;;;;30,0;;;;2,0;2,0;;3,0;;;;;5,0;;;;;;2,0;1,0;;;;;10,0;;;;;14,0;42,0;2,0;;2,0;2,0;;1,0;;;;;;;;46,0;;61,0;;;;2,0;;;2,0;1,0;;;;;;3,0;1,0;;;;;1,0;;;;;;;;;;;;;;;;;;;;18,0;1,0;;2,0;;;;11,0;;5,0;55,0;;;1,0;;;;2,0;;;;;;;;;;1,0;1,0;;;;;;2,0;;;;;1,0;;;;;5,0;;;;;;;;;;1,0;;;;;;;;4,0;;2,0;;8,0;2,0;;;;;;;;;;;;1,0;;4,0;;1,0;;;;;;;3,0;;;;2,0;;2,0;14,0;;;1,0;;;;;;;;3,0;6,0;;;4,0;;;;;;3,0;;;3,0;3,0;5,0;;;;;1,0;;;;;;;;;;;;;;;1,0;;;;;;;;1,0;;;;;1,0;;;;;;10,0;;;;;2,0;6,0;;;2,0;;;;;;;;;;;;;;;;;;;;;;;;;1,0;;;;;;;2,0;;;;3,0;;;;;;;;;;;;;2,0;;;;;;;;;;3,0;;;;;;;2,0;;;;;;17,0;;;;3,0;1,0;;;2,0;2,0;1,0;;;;;;;;;1,0;3,0;;;;;;;;;;;;;13,0;;;6,0;;;;;;;61,0;;;;;;;;;;;13,0;;;3,0;;;;;;;;;;;;;;;;;;;;;;1,0;;;;;;;;;;;;;;;;2,0;;1,0;;;;;;;;1,0;4,0;;3,0;;;3,0;;;;;;;;;;;;2,0;;2,0;;;;;;;;;;5,0;;1,0;;;;;;;1,0;;;;;;5,0;;;1,0;;;;;;;;;;;;3,0;;2,0;;1,0;;;;;12,0;;;;;;25,0;;;;;;;;;;1,0;;;;;;;;13,0;;;;;1,0;;;;;;;;;2,0;;2,0;;;;;;
manufacturing;;;2,0;;;;3,0;32,0;1,0;2,0;12,0;;;;1,0;1,0;;;;;1,0;11,0;;1,0;;;1,0;1,0;;;;;;;1,0;;;1,0;1,0;;1,0;;;1,0;1,0;;2,0;85,0;2,0;;;;;;1,0;;6,0;1,0;;;;;;;1,0;1,0;1,0;41,0;;5,0;2,0;;;;;;4,0;2,0;;65,0;3,0;56,0;;34,0;3,0;;;;;;98,0;;1,0;14,0;;;;;430,0;;;;192,0;;;;39,0;;;;;1,0;;;;6,0;12,0;6,0;2,0;1,0;;;19,0;2,0;;;1,0;;;;;1,0;;5,0;;;;1,0;;;;;;42,0;1,0;;1,0;9,0;;1,0;;1,0;;;;;6,0;;;;1,0;;23,0;;;1,0;;;1,0;;;4,0;1,0;;;;8,0;5,0;;;2,0;1,0;18,0;1,0;;6,0;;17,0;;;;;2,0;;;1,0;;;4,0;;;1,0;;3,0;;;;;;1,0;13,0;;;;;;1,0;3,0;;6,0;12,0;;;;2,0;;39,0;;6,0;;12,0;1,0;;8,0;;;1,0;;;1,0;;;;;;;4,0;;3,0;1,0;1,0;;;;;;1,0;;;;;11,0;;;43,0;3,0;;4,0;;4,0;;3,0;;8,0;;;;2,0;38,0;15,0;;;;;2,0;1,0;;;;5,0;;;11,0;7,0;2,0;;;;;;8,0;;1,0;;1,0;;;;5,0;;;;4,0;;1,0;;;;;;;;;;3,0;;;;;;;;;;;;;;;13,0;;;;2,0;;;;1,0;;7,0;;;;26,0;;;;1,0;1,0;;1,0;;;1,0;;1,0;;1,0;;;;;;;;;1,0;;;;;;;;;;;;;4,0;;;4,0;1,0;;;;;;;;;;;;;;;;;2,0;2,0;;;;;;;;;;2,0;1,0;;;;;1,0;;;;;;;;;;1,0;1,0;;;;;;;;2,0;;;;;;;;;;;;;;6,0;;;;;;;;;;;;;;;;;;;;4,0;;;;;;;;;;;2,0;;3,0;;;;;;;;;1,0;;;;;;;;2,0;;;;;;;;;;;;;1,0;;;;;;1,0;;;;1,0;;;;1,0;1,0;;;;;2,0;;;;;;;;;;;;;;;;;;;;;1,0;;;;;;;;1,0;;;;;;;;;;;;;;;;;1,0;;;;;;;;;;;;;;;;;;;;;;;1,0;;;;;;;;;;1,0;;;;5,0;;;;;;;5,0;;;;;;;1,0;;;;;;;;;;;;;;;;;;;;;;;;6,0;;;4,0;;;1,0;;;;;;;;;;;;;;;;;;;1,0;;;;;;;;;3,0;;;;;;;;;;;;;;;;;;;;;;;;;;;1,0;4,0;;;;;;;;;;14,0;4,0;;;;3,0;;;;3,0;;;5,0;;;;;2,0;;;;;;;;;;;;;;;;;;6,0;;;;;;;;;;;;;;;;;;;;;;;;;;;1,0;;;;;;;;2,0;;;1,0;;;;;;;;;;;;;;;;;;1,0;;;;;;;1,0;;;;;;;2,0;;;;;;;;;;;;;;;;;;1,0;;;;;;;;;;;;;;;;;;;;;;;;;;;;;;;;;;1,0;;;;;;;1,0;;;;;;;;;;;;2,0;2,0;;;;;;;;;;1,0;;;;;;;;;;;;;;;;;;;;;;;;;;;;;;;2,0;;;;;;;;;;;;;;1,0;;;3,0;;;;;;;;;;;;;;;;;;;;;;;;;;;;
match;;;1,0;;12,0;3,0;1,0;32,0;56,0;3,0;5,0;;58,0;5,0;16,0;45,0;1,0;14,0;4,0;12,0;9,0;43,0;2,0;2,0;;4,0;56,0;1,0;7,0;;16,0;1,0;29,0;;11,0;14,0;7,0;7,0;2,0;;43,0;;2,0;3,0;10,0;4,0;198,0;70,0;20,0;14,0;1,0;42,0;3,0;10,0;;16,0;7,0;5,0;22,0;;2,0;;20,0;2,0;16,0;10,0;4,0;3,0;39,0;;28,0;;17,0;1,0;10,0;63,0;66,0;;2,0;498,0;;;;38,0;;3,0;;;;12,0;12,0;;;1,0;;3,0;3,0;4,0;97,0;4,0;16,0;9,0;26,0;131,0;;;11,0;3,0;22,0;28,0;4,0;28,0;;;;58,0;39,0;35,0;;34,0;;;11,0;42,0;3,0;10,0;1,0;2,0;1,0;2,0;;52,0;3,0;2,0;10,0;3,0;24,0;28,0;10,0;1,0;43,0;;2,0;10,0;15,0;5,0;;8,0;94,0;11,0;1,0;;;57,0;18,0;;38,0;;1,0;12,0;5,0;;84,0;;;;23,0;42,0;;;4,0;;;9,0;2,0;2,0;2,0;;;;;2,0;;;;2,0;;12,0;;;;;;7,0;;;10,0;4,0;;;;;14,0;21,0;;;2,0;;3,0;11,0;;6,0;;;;;;;2,0;3,0;2,0;;;1,0;1,0;;2,0;;30,0;;2,0;;2,0;2,0;;;1,0;;1,0;3,0;;;7,0;4,0;5,0;;2,0;2,0;63,0;;2,0;;;;;;32,0;;;;;;;17,0;;;15,0;;;;;5,0;6,0;;1,0;;2,0;5,0;;6,0;;10,0;25,0;1,0;;31,0;1,0;;5,0;;;4,0;;;;;;;;;1,0;;;;;;;18,0;1,0;;;;2,0;;5,0;6,0;;5,0;;6,0;;;;;5,0;;;;7,0;1,0;;;;;;60,0;;9,0;14,0;;;;;;4,0;;4,0;1,0;7,0;56,0;;;13,0;;;3,0;2,0;326,0;;6,0;4,0;3,0;;;1,0;;;;5,0;;;;;10,0;;;;;1,0;2,0;;;;8,0;;2,0;;;12,0;2,0;3,0;19,0;8,0;;1,0;2,0;;;9,0;1,0;1,0;;5,0;3,0;;;;1,0;1,0;28,0;1,0;13,0;35,0;;11,0;9,0;;;;;;1,0;1,0;30,0;1,0;;4,0;205,0;9,0;8,0;;66,0;11,0;;47,0;2,0;;4,0;16,0;;3,0;11,0;3,0;;;1,0;3,0;;6,0;;;;;1,0;5,0;5,0;10,0;;;12,0;5,0;;;1,0;;;;5,0;7,0;52,0;5,0;8,0;;16,0;24,0;3,0;9,0;1,0;;1,0;3,0;1,0;2,0;17,0;17,0;;2,0;7,0;;8,0;;4,0;;33,0;11,0;;;;2,0;2,0;;;4,0;2,0;1,0;2,0;;;;;3,0;;2,0;;;;;;2,0;1,0;;3,0;;5,0;4,0;5,0;6,0;;;;6,0;1,0;1,0;3,0;3,0;2,0;23,0;;;4,0;9,0;;;4,0;2,0;12,0;8,0;5,0;;8,0;6,0;;;4,0;4,0;;2,0;;;;;8,0;;22,0;;3,0;1,0;;;;4,0;35,0;2,0;;;1,0;1,0;;1,0;;10,0;;;;7,0;4,0;;2,0;;;10,0;19,0;;;;;;6,0;1,0;;10,0;2,0;10,0;6,0;;3,0;9,0;;;2,0;;8,0;;;;2,0;;1,0;;;;;;3,0;2,0;;24,0;4,0;;;;;1,0;;11,0;;;;1,0;;1,0;;1,0;3,0;4,0;;;;11,0;3,0;;;;;1,0;;;;;;;21,0;1,0;4,0;3,0;;;12,0;4,0;;3,0;;;;;1,0;;1,0;1,0;3,0;;;;;;;;;;;;1,0;;;4,0;;4,0;6,0;1,0;2,0;;;1,0;1,0;;;;5,0;;7,0;;;1,0;58,0;;;;;3,0;;;;;;;3,0;;;;4,0;;;;1,0;1,0;1,0;;;3,0;10,0;3,0;;;;;;;;;13,0;;;;;;;6,0;;;;;;;11,0;3,0;;2,0;3,0;;2,0;;;10,0;33,0;;1,0;;6,0;18,0;1,0;;8,0;;;;2,0;;17,0;;16,0;;12,0;;1,0;;;;1,0;7,0;1,0;;4,0;;3,0;;5,0;;;2,0;2,0;8,0;2,0;;6,0;;;2,0;11,0;;5,0;1,0;1,0;;5,0;3,0;1,0;;;1,0;;;6,0;6,0;2,0;3,0;2,0;;1,0;;3,0;;;;;11,0;;;;;;10,0;;1,0;2,0;1,0;;;3,0;26,0;;;8,0;;;;16,0;;6,0;;;;4,0;2,0;;;1,0;2,0;;;;;;;;4,0;;;;;;;17,0;;;;;6,0;41,0;19,0;;2,0;14,0;1,0;;12,0;;;;;;;;2,0;;;;;;11,0;2,0;;;;5,0;;;;2,0;1,0;;;;;7,0;2,0;;;;;;;;;;6,0;;39,0;;;;;;;6,0;;;3,0;;;;;;4,0;1,0;7,0;;15,0;;;6,0;;;6,0;;;;;2,0;;9,0;;48,0;;;4,0;;;;;;;4,0;;;;;;;;
maximum;;;2,0;;;123,0;18,0;14,0;13,0;2,0;8,0;;8,0;;57,0;39,0;;54,0;33,0;3,0;;20,0;;1,0;1,0;14,0;70,0;2,0;;4,0;4,0;24,0;18,0;11,0;41,0;7,0;7,0;15,0;1,0;;38,0;6,0;17,0;28,0;21,0;3,0;89,0;9,0;11,0;5,0;;65,0;17,0;9,0;4,0;38,0;21,0;;11,0;;;4,0;20,0;;13,0;50,0;56,0;6,0;26,0;1,0;41,0;2,0;5,0;;;14,0;60,0;2,0;6,0;233,0;3,0;11,0;1,0;31,0;4,0;1,0;8,0;;2,0;30,0;161,0;;;4,0;;6,0;2,0;;39,0;;1,0;;20,0;46,0;;3,0;92,0;;53,0;7,0;;19,0;;1,0;;47,0;7,0;109,0;8,0;86,0;;;5,0;10,0;3,0;1,0;;1,0;1,0;40,0;;33,0;15,0;;33,0;20,0;;3,0;11,0;24,0;8,0;;;47,0;14,0;;;13,0;101,0;51,0;1,0;;10,0;29,0;18,0;;30,0;27,0;12,0;5,0;2,0;2,0;58,0;;9,0;;7,0;127,0;;19,0;33,0;;;18,0;21,0;13,0;;7,0;;;4,0;2,0;;;1,0;5,0;;2,0;;6,0;;;;6,0;3,0;;1,0;1,0;;9,0;1,0;;80,0;15,0;17,0;;;5,0;12,0;17,0;;;1,0;;;9,0;;;94,0;;1,0;;;1,0;;;;;38,0;;6,0;1,0;;;1,0;21,0;13,0;;;17,0;5,0;3,0;2,0;1,0;;;2,0;;112,0;2,0;;;;;;;8,0;;;10,0;;;;26,0;;;;;6,0;;;6,0;5,0;;;2,0;3,0;9,0;;11,0;8,0;;;6,0;1,0;65,0;2,0;;;3,0;1,0;1,0;;;;2,0;29,0;;5,0;;8,0;9,0;;;;;;25,0;1,0;1,0;1,0;2,0;;;7,0;1,0;;;3,0;4,0;1,0;;26,0;;29,0;;1,0;;3,0;;;;;;;5,0;1,0;1,0;;3,0;1,0;1,0;;;21,0;;;;2,0;;;2,0;1,0;2,0;;;4,0;16,0;2,0;;6,0;2,0;;2,0;;;;;;6,0;;;;;1,0;;;;;11,0;;;3,0;;;1,0;;;1,0;4,0;;24,0;;;1,0;4,0;;29,0;8,0;;;;;1,0;;;3,0;;10,0;89,0;8,0;15,0;11,0;;;4,0;;;;;3,0;;8,0;7,0;4,0;5,0;12,0;1,0;8,0;15,0;;16,0;16,0;3,0;2,0;;1,0;3,0;7,0;3,0;;28,0;31,0;;4,0;;8,0;;;3,0;;;;29,0;38,0;9,0;;;;4,0;1,0;4,0;2,0;59,0;;;;6,0;53,0;14,0;;3,0;2,0;6,0;3,0;1,0;7,0;;95,0;;14,0;1,0;;13,0;2,0;5,0;;;;;;;3,0;1,0;2,0;1,0;;;1,0;;1,0;;;2,0;3,0;;5,0;;7,0;1,0;2,0;7,0;;;1,0;;;;1,0;;;;;1,0;1,0;;;;7,0;1,0;;6,0;;;1,0;;15,0;;;3,0;4,0;;;131,0;;1,0;6,0;;;;;;2,0;;;1,0;;;;;;;7,0;9,0;;1,0;;;;51,0;2,0;2,0;;;;;;;;;;;;;;;1,0;3,0;1,0;;;;;;;;;;8,0;;;;1,0;;;6,0;3,0;;;;1,0;;;;;;3,0;3,0;;;;;;10,0;;;23,0;2,0;;;4,0;;;;;;;;;;4,0;;4,0;;;;;;;;;;;;11,0;;;11,0;;;;;2,0;;2,0;;;98,0;;6,0;;;;;1,0;;;;;;;1,0;1,0;;;9,0;;2,0;;1,0;;;;;;;1,0;;15,0;;;;8,0;;;5,0;;5,0;1,0;;;;;11,0;;;;;;;;;;;1,0;;;7,0;;1,0;1,0;;5,0;;7,0;;;;;;;;;;;;;;;;;;;;;;4,0;;10,0;11,0;1,0;;;20,0;2,0;;40,0;;4,0;1,0;;;14,0;30,0;;;;;4,0;;;;;5,0;36,0;5,0;;1,0;8,0;1,0;;4,0;;;;1,0;4,0;;1,0;1,0;17,0;;1,0;;;;;4,0;4,0;;17,0;2,0;125,0;1,0;;1,0;;1,0;1,0;34,0;1,0;;3,0;;3,0;;;;19,0;;;89,0;2,0;;3,0;;;;;;;;;;;;1,0;;;2,0;;;1,0;6,0;;;;;2,0;;1,0;;;;;;;;;;;1,0;;;2,0;;;;;;;;13,0;;2,0;;;1,0;;;;;;;;;10,0;3,0;14,0;;;;1,0;;;;;;;;;;;1,0;;;3,0;;;1,0;;;;2,0;1,0;;;;10,0;6,0;;;;;;;1,0;;;;;;;;4,0;4,0;;;;;;;;;;;;;;;3,0;12,0;;4,0;1,0;;;;;;;2,0;55,0;;1,0;;;;;2,0;;;21,0;;;;;;;;;;;111,0;;;;;;
measure;;;3,0;;2,0;89,0;2,0;56,0;26,0;56,0;5,0;;24,0;;42,0;125,0;22,0;2,0;48,0;5,0;22,0;53,0;;1,0;;1,0;58,0;3,0;;4,0;6,0;15,0;147,0;7,0;42,0;17,0;11,0;9,0;;;76,0;2,0;11,0;42,0;50,0;22,0;121,0;247,0;23,0;93,0;3,0;292,0;5,0;4,0;7,0;22,0;10,0;23,0;24,0;2,0;2,0;2,0;7,0;7,0;26,0;17,0;22,0;11,0;38,0;3,0;17,0;;16,0;;2,0;13,0;18,0;10,0;9,0;280,0;;45,0;3,0;62,0;4,0;2,0;1,0;;;20,0;46,0;;;;99,0;9,0;6,0;;185,0;3,0;13,0;5,0;36,0;217,0;6,0;17,0;51,0;11,0;30,0;15,0;6,0;15,0;;2,0;;22,0;25,0;119,0;4,0;90,0;;;19,0;12,0;24,0;11,0;12,0;8,0;8,0;24,0;;51,0;14,0;4,0;11,0;2,0;7,0;38,0;;;6,0;;2,0;91,0;5,0;;;5,0;52,0;27,0;5,0;;2,0;14,0;39,0;1,0;123,0;;4,0;3,0;;11,0;269,0;4,0;;;11,0;24,0;3,0;28,0;4,0;;;4,0;46,0;18,0;6,0;;;;;5,0;;;10,0;8,0;;4,0;;;;;;2,0;;;1,0;1,0;;;;1,0;31,0;30,0;17,0;;2,0;37,0;17,0;1,0;3,0;;8,0;;1,0;;;;18,0;3,0;;3,0;;;3,0;1,0;;;189,0;1,0;5,0;;7,0;5,0;;1,0;17,0;2,0;;;1,0;1,0;5,0;8,0;11,0;;;2,0;55,0;13,0;;;;;1,0;3,0;28,0;24,0;;;;;2,0;15,0;;;7,0;1,0;5,0;;;13,0;26,0;;;;11,0;16,0;3,0;25,0;1,0;;4,0;4,0;1,0;127,0;10,0;2,0;;;29,0;22,0;;;1,0;;9,0;;;;4,0;6,0;2,0;3,0;;;;8,0;;;6,0;;;2,0;2,0;8,0;1,0;;;;;;2,0;;5,0;;;;;2,0;;;1,0;;;69,0;;2,0;;;;;;1,0;3,0;;;5,0;4,0;9,0;2,0;1,0;;2,0;;;4,0;85,0;1,0;8,0;2,0;2,0;;;;;;;;;8,0;;;2,0;;;;;1,0;32,0;;;;2,0;;15,0;;;;;;55,0;19,0;;;15,0;1,0;5,0;;2,0;24,0;9,0;;9,0;;;70,0;49,0;14,0;29,0;26,0;2,0;15,0;;22,0;7,0;;;1,0;;2,0;1,0;17,0;6,0;3,0;3,0;17,0;25,0;1,0;4,0;29,0;8,0;12,0;;27,0;4,0;4,0;;5,0;2,0;15,0;89,0;8,0;3,0;1,0;32,0;24,0;;29,0;6,0;1,0;;10,0;;10,0;23,0;3,0;2,0;;;5,0;1,0;;18,0;;;;;17,0;12,0;3,0;8,0;;6,0;19,0;3,0;20,0;24,0;13,0;2,0;21,0;5,0;4,0;14,0;95,0;4,0;;;3,0;;2,0;1,0;1,0;1,0;4,0;;7,0;1,0;;1,0;2,0;;4,0;5,0;2,0;;;2,0;3,0;;3,0;14,0;4,0;;2,0;7,0;;;1,0;1,0;2,0;2,0;4,0;9,0;;11,0;;2,0;;2,0;;13,0;;1,0;;;22,0;;5,0;9,0;2,0;;;1,0;1,0;10,0;14,0;;;;;;14,0;12,0;;4,0;;2,0;;;;2,0;4,0;11,0;;4,0;1,0;1,0;;5,0;2,0;;8,0;;4,0;;;;;;10,0;;;2,0;8,0;2,0;;;;;;;;;2,0;;;;4,0;;2,0;;;2,0;;3,0;2,0;;;;;5,0;;;;2,0;6,0;4,0;;1,0;6,0;9,0;;4,0;;;40,0;5,0;;2,0;3,0;;;2,0;;;;;1,0;8,0;2,0;1,0;;;;;;1,0;6,0;3,0;19,0;;;;2,0;;2,0;1,0;;;2,0;;2,0;1,0;;;;8,0;;2,0;2,0;;2,0;;;;;8,0;;1,0;;1,0;22,0;;;16,0;;1,0;;1,0;3,0;;;;1,0;;;2,0;;;;;1,0;;;;5,0;1,0;;;;1,0;;;1,0;;3,0;;5,0;;1,0;;;;;4,0;;;;4,0;;;10,0;;54,0;7,0;1,0;;1,0;;;;;;;;;;;12,0;2,0;;9,0;;;;;;;1,0;5,0;;;1,0;;;6,0;2,0;;;;3,0;6,0;4,0;;;10,0;20,0;16,0;3,0;1,0;5,0;;5,0;;3,0;12,0;4,0;4,0;8,0;1,0;8,0;;1,0;;;;1,0;3,0;3,0;11,0;1,0;;5,0;;;1,0;;9,0;38,0;9,0;7,0;;12,0;;1,0;3,0;;;21,0;;;10,0;14,0;27,0;1,0;1,0;;;5,0;;21,0;2,0;3,0;2,0;6,0;;;;2,0;1,0;;2,0;8,0;2,0;;;;;8,0;;;;2,0;5,0;;;;1,0;;;;;;;10,0;;7,0;;;;10,0;1,0;3,0;;;;;1,0;3,0;;2,0;;;2,0;;;22,0;;;7,0;2,0;;;1,0;4,0;3,0;1,0;11,0;;1,0;;2,0;;16,0;;;;1,0;;;;;;26,0;5,0;10,0;1,0;2,0;3,0;;;1,0;;;1,0;;4,0;;;;4,0;;1,0;;2,0;;;;;;;;;3,0;;;12,0;;1,0;;1,0;;4,0;;;1,0;;;;2,0;;1,0;5,0;1,0;5,0;;;;1,0;;2,0;1,0;;;;;;;17,0;;15,0;;;;1,0;1,0;;1,0;;;;;;;9,0;3,0;;;1,0
modulation;;;4,0;;;;;;;1,0;2,0;;6,0;;;22,0;2,0;;;;;2,0;1,0;2,0;;;2,0;;;;;;13,0;3,0;33,0;1,0;;;;2,0;;4,0;2,0;1,0;;;19,0;7,0;1,0;;;2,0;;;4,0;1,0;3,0;;;;;;4,0;;1,0;10,0;;15,0;10,0;;113,0;;14,0;;;1,0;;;2,0;39,0;;;;13,0;2,0;;;;;1,0;15,0;;;;7,0;;;;20,0;;;;6,0;;;;;2,0;40,0;;;4,0;;;;4,0;10,0;;4,0;6,0;;;2,0;1,0;3,0;;;;3,0;4,0;1,0;;1,0;;;1,0;3,0;1,0;;;19,0;;;4,0;;;;;45,0;;;;;;4,0;;14,0;;;65,0;;2,0;14,0;1,0;2,0;;9,0;3,0;;1,0;;;;;;5,0;;;;;;;;;9,0;21,0;;3,0;;;;;;3,0;;;1,0;3,0;;;;;2,0;1,0;;;3,0;;;;;;;;;;;;;;;1,0;;;;;;;22,0;;;;;;;;;;;;;;;;4,0;;;;18,0;;;;;;;12,0;4,0;1,0;;;;;;;;;;;;;;9,0;;;2,0;;;;;;1,0;;4,0;;;9,0;;;;1,0;;;;;;;;;;;;;;;;;;;;;;;;;;;;;;2,0;;;;;;;;;;;;;;;;16,0;;;;;;;;;1,0;;;3,0;;2,0;;;;;;;;;;;;;;;;;;;;;;;;;;;;;;;;;;;;1,0;;;;;;;;;;1,0;;6,0;;;4,0;;;1,0;;;;;;1,0;;5,0;3,0;;;3,0;;2,0;;;;;1,0;;3,0;;;;;1,0;;3,0;;4,0;;1,0;;2,0;;;;;;;;3,0;1,0;;;;;;;;;5,0;;;;;1,0;;;1,0;;;;;15,0;;;;;;2,0;;;;;;;;;6,0;4,0;;;2,0;;;;;;;;;;;;;;;;;;;;;3,0;;;;;;;;;;;;;;;;;;;;;1,0;;;;;;;;;;1,0;;;;;;;;;;;;;;;;;;1,0;;;;;1,0;2,0;;;;;;;;;;;5,0;;;;;;1,0;;;;;;;;;;;;;;;;;;;;;;;;12,0;1,0;;;;;;;;;;;;;;;;;;;;;;;;;2,0;;;;;;;;;1,0;;1,0;;;;;;;;;;7,0;;;;;;4,0;;;;3,0;;;;2,0;;40,0;;;2,0;;;;;;;;;;;;;;;;;;;;;1,0;;;;;;6,0;;;;;;;;;;;;;;;2,0;;;;;;;;;;;;;5,0;14,0;;;;;9,0;;;1,0;;;;;;;;;2,0;;;;10,0;;;;;;;;;;;;;2,0;1,0;;;;;;;;;;;1,0;;;;;;7,0;3,0;2,0;;;3,0;;;;;;5,0;;;4,0;;;;;;;;10,0;;;;;;;;4,0;;;;;;;10,0;6,0;2,0;;;;;;;;;2,0;;;2,0;;4,0;;;;;;;;;;1,0;;;;;;;;;;;;;;;;;1,0;;;;;;;;;;;;;;;;1,0;;;;;;;;;8,0;;;;2,0;;;;;;;;;3,0;;2,0;;2,0;;;;;;;;;;;;;;2,0;;;;;;;;;;;;;;;;;;;;;;;;;;;;;;;;;;;;;2,0;;;1,0;;;;;;;;;1,0;;;;;1,0;;;;;;;;;;;;;;;;;;;;;;;;;;;;;;;
motion;;;2,0;;24,0;17,0;2,0;103,0;138,0;28,0;6,0;;68,0;;74,0;429,0;2,0;32,0;2,0;;2,0;325,0;4,0;;1,0;2,0;14,0;33,0;;57,0;44,0;11,0;171,0;;120,0;58,0;20,0;38,0;17,0;;284,0;6,0;26,0;58,0;437,0;172,0;274,0;275,0;93,0;36,0;5,0;43,0;11,0;3,0;25,0;16,0;41,0;5,0;227,0;;2,0;3,0;50,0;7,0;46,0;16,0;4,0;2,0;493,0;6,0;44,0;;156,0;;;63,0;62,0;5,0;6,0;814,0;22,0;79,0;2,0;218,0;4,0;7,0;;;7,0;3,0;35,0;;;;31,0;12,0;11,0;1,0;337,0;22,0;45,0;11,0;100,0;189,0;;10,0;38,0;5,0;88,0;80,0;1,0;59,0;;;1,0;134,0;43,0;153,0;13,0;76,0;3,0;;26,0;106,0;63,0;13,0;;22,0;;37,0;;52,0;109,0;5,0;113,0;33,0;18,0;15,0;22,0;;103,0;2,0;6,0;316,0;44,0;;;6,0;160,0;16,0;10,0;;19,0;32,0;91,0;;221,0;;46,0;2,0;12,0;15,0;195,0;1,0;4,0;;176,0;51,0;1,0;;7,0;;;4,0;144,0;22,0;6,0;6,0;3,0;;3,0;34,0;;2,0;;51,0;;101,0;;;5,0;10,0;;12,0;;2,0;2,0;;;3,0;;;120,0;119,0;6,0;16,0;;;24,0;95,0;2,0;;5,0;2,0;;;;;1,0;;31,0;;;;;;;;23,0;;67,0;;3,0;43,0;8,0;24,0;76,0;2,0;8,0;;16,0;4,0;2,0;77,0;6,0;;;6,0;54,0;37,0;7,0;;5,0;;8,0;;63,0;6,0;;;;;;66,0;;5,0;4,0;;7,0;;13,0;20,0;5,0;;;;12,0;18,0;;64,0;6,0;;17,0;2,0;;72,0;9,0;3,0;5,0;;54,0;37,0;6,0;;;4,0;1,0;;;;8,0;6,0;1,0;1,0;;;;61,0;1,0;;21,0;9,0;;;3,0;26,0;;;;49,0;;;2,0;;5,0;7,0;;;1,0;1,0;;;;;;31,0;39,0;17,0;1,0;2,0;1,0;;1,0;11,0;8,0;;;16,0;13,0;10,0;;7,0;13,0;5,0;9,0;2,0;8,0;51,0;2,0;36,0;30,0;5,0;;;1,0;;;1,0;;5,0;;;;23,0;;1,0;6,0;1,0;14,0;59,0;;;10,0;14,0;;4,0;;;;20,0;2,0;38,0;8,0;;;3,0;2,0;;5,0;2,0;35,0;25,0;3,0;6,0;;3,0;;33,0;6,0;129,0;64,0;17,0;41,0;2,0;70,0;2,0;2,0;5,0;5,0;3,0;1,0;5,0;219,0;17,0;;1,0;22,0;51,0;25,0;30,0;2,0;121,0;52,0;114,0;24,0;33,0;11,0;89,0;66,0;;42,0;;70,0;;2,0;28,0;19,0;5,0;16,0;10,0;7,0;5,0;;7,0;45,0;54,0;12,0;20,0;5,0;21,0;12,0;1,0;5,0;46,0;3,0;4,0;24,0;;163,0;80,0;1,0;;25,0;15,0;85,0;38,0;865,0;35,0;;1,0;38,0;3,0;13,0;13,0;25,0;19,0;1,0;52,0;6,0;19,0;;32,0;46,0;17,0;2,0;23,0;15,0;3,0;3,0;1,0;151,0;1,0;5,0;8,0;121,0;66,0;;;;;16,0;6,0;8,0;1,0;12,0;4,0;2,0;1,0;6,0;;2,0;6,0;;1,0;39,0;1,0;9,0;;;3,0;;18,0;19,0;1,0;4,0;;83,0;14,0;3,0;7,0;5,0;4,0;;20,0;1,0;18,0;19,0;2,0;2,0;7,0;;;12,0;6,0;;6,0;1,0;1,0;5,0;;;5,0;;44,0;11,0;4,0;2,0;;;69,0;11,0;;1,0;;1,0;14,0;;;1,0;1,0;37,0;;6,0;5,0;8,0;7,0;;4,0;16,0;28,0;5,0;;;3,0;1,0;;;;;;10,0;;4,0;;;10,0;30,0;;;3,0;2,0;2,0;;;;;2,0;3,0;;2,0;;11,0;;6,0;11,0;;71,0;3,0;;;7,0;;;5,0;1,0;;;2,0;1,0;;1,0;;1,0;7,0;;1,0;4,0;2,0;27,0;;9,0;8,0;2,0;;;;2,0;;;;;;9,0;4,0;6,0;2,0;;25,0;;1,0;10,0;;;;;;;;;3,0;;6,0;3,0;;;33,0;;8,0;;;1,0;1,0;;4,0;;;;;;;;;6,0;9,0;25,0;14,0;4,0;5,0;15,0;;;1,0;;5,0;;;;2,0;1,0;;;6,0;;;4,0;;;;;1,0;1,0;6,0;14,0;;;2,0;;11,0;12,0;;9,0;;;1,0;;;1,0;6,0;;;1,0;;2,0;;;5,0;2,0;;51,0;40,0;;;;1,0;;2,0;;;;2,0;;;27,0;42,0;;6,0;7,0;1,0;2,0;28,0;;6,0;;;5,0;2,0;7,0;9,0;1,0;58,0;1,0;6,0;;;;;;1,0;9,0;2,0;10,0;10,0;;29,0;;;;;5,0;1,0;;2,0;;4,0;;3,0;10,0;2,0;7,0;12,0;;;5,0;5,0;3,0;2,0;;;8,0;;;2,0;11,0;;;;;15,0;;8,0;;5,0;3,0;25,0;12,0;1,0;;1,0;;;22,0;;3,0;64,0;5,0;6,0;2,0;18,0;12,0;;2,0;9,0;1,0;5,0;;8,0;1,0;;;4,0;4,0;;;;3,0;;1,0;4,0;3,0;1,0;;;10,0;3,0;;1,0;3,0;3,0;;;11,0;4,0;;;2,0;;;;3,0;5,0;1,0;;;30,0;29,0;;1,0;1,0;3,0;;;;3,0;;;6,0;8,0;3,0;;1,0;1,0;1,0;13,0;3,0;12,0;15,0;;;;;27,0;15,0;1,0;1,0;2,0;55,0;;2,0;;;;;;;1,0;;9,0;;;;8,0;5,0;2,0;;;;1,0;9,0;;;1,0;2,0;;;16,0;2,0;11,0;2,0;;2,0;;1,0;;;6,0;7,0;2,0;3,0;;;1,0;22,0;3,0;1,0;;;1,0;1,0;;;;1,0;;;;21,0;;;;3,0
moving;;;2,0;2,0;6,0;26,0;11,0;63,0;80,0;14,0;16,0;;10,0;;108,0;136,0;1,0;10,0;3,0;;4,0;176,0;5,0;13,0;2,0;1,0;16,0;1,0;;3,0;16,0;16,0;101,0;5,0;113,0;38,0;12,0;39,0;12,0;;137,0;4,0;16,0;23,0;164,0;56,0;121,0;133,0;61,0;190,0;16,0;93,0;;;73,0;10,0;56,0;;8,0;;9,0;2,0;23,0;33,0;27,0;7,0;75,0;25,0;71,0;4,0;14,0;15,0;49,0;1,0;;12,0;19,0;4,0;7,0;1035,0;69,0;89,0;;137,0;17,0;25,0;25,0;;1,0;4,0;622,0;1,0;;11,0;6,0;12,0;16,0;1,0;187,0;23,0;14,0;;99,0;483,0;1,0;8,0;153,0;15,0;46,0;7,0;18,0;65,0;1,0;;;87,0;125,0;370,0;9,0;65,0;39,0;;10,0;56,0;15,0;;1,0;4,0;3,0;46,0;;31,0;111,0;3,0;9,0;1,0;5,0;38,0;;7,0;43,0;1,0;2,0;120,0;4,0;;;19,0;61,0;26,0;15,0;2,0;11,0;43,0;77,0;1,0;97,0;;47,0;6,0;8,0;10,0;378,0;1,0;3,0;2,0;87,0;53,0;2,0;;41,0;;1,0;4,0;57,0;15,0;71,0;37,0;;;7,0;198,0;;2,0;10,0;16,0;;13,0;;;4,0;6,0;;33,0;;17,0;5,0;1,0;;8,0;3,0;;11,0;313,0;27,0;5,0;16,0;;16,0;38,0;1,0;2,0;34,0;;;;9,0;2,0;9,0;15,0;40,0;2,0;4,0;10,0;2,0;1,0;2,0;13,0;119,0;;313,0;;21,0;31,0;72,0;103,0;56,0;47,0;13,0;4,0;4,0;5,0;;52,0;9,0;;;;36,0;35,0;28,0;1,0;;4,0;5,0;;56,0;2,0;;2,0;;;2,0;30,0;;10,0;6,0;2,0;17,0;;30,0;64,0;20,0;;;7,0;11,0;10,0;1,0;62,0;11,0;;10,0;;;96,0;;10,0;1,0;1,0;67,0;4,0;6,0;;;1,0;5,0;;5,0;;112,0;11,0;16,0;3,0;2,0;5,0;2,0;6,0;16,0;2,0;;5,0;;4,0;22,0;6,0;;4,0;;44,0;3,0;;4,0;7,0;67,0;;11,0;;2,0;10,0;3,0;2,0;;2,0;;9,0;2,0;41,0;17,0;41,0;;1,0;9,0;6,0;6,0;11,0;8,0;35,0;14,0;9,0;3,0;24,0;44,0;13,0;27,0;18,0;54,0;37,0;;5,0;3,0;3,0;4,0;6,0;2,0;;;2,0;22,0;1,0;13,0;5,0;;17,0;2,0;3,0;2,0;1,0;20,0;9,0;7,0;1,0;;13,0;;15,0;;3,0;;139,0;6,0;66,0;8,0;;7,0;;;6,0;7,0;1,0;2,0;;;10,0;3,0;4,0;;5,0;3,0;51,0;37,0;11,0;2,0;3,0;4,0;;;3,0;8,0;;;19,0;35,0;11,0;;1,0;3,0;14,0;3,0;8,0;;37,0;10,0;14,0;17,0;8,0;3,0;8,0;118,0;;6,0;70,0;;3,0;5,0;14,0;32,0;;25,0;3,0;16,0;1,0;;11,0;16,0;52,0;3,0;1,0;10,0;11,0;7,0;;2,0;62,0;11,0;2,0;;;15,0;47,0;16,0;2,0;5,0;;28,0;2,0;11,0;71,0;2,0;;27,0;7,0;1,0;28,0;7,0;;4,0;;1,0;2,0;3,0;6,0;6,0;5,0;;6,0;7,0;14,0;2,0;;98,0;;;77,0;164,0;3,0;8,0;;;;;19,0;1,0;;9,0;;6,0;;2,0;2,0;5,0;8,0;2,0;7,0;1,0;7,0;2,0;;3,0;2,0;;5,0;1,0;1,0;2,0;;37,0;7,0;2,0;4,0;6,0;49,0;;2,0;1,0;23,0;8,0;5,0;;1,0;;;1,0;2,0;;3,0;;;2,0;5,0;;2,0;;3,0;1,0;1,0;1,0;3,0;;6,0;9,0;2,0;2,0;;5,0;7,0;;;;;;;;2,0;5,0;2,0;6,0;3,0;2,0;3,0;7,0;2,0;5,0;3,0;3,0;;;5,0;8,0;1,0;13,0;;3,0;;;2,0;5,0;;;;2,0;5,0;;;;;2,0;5,0;;;1,0;4,0;2,0;7,0;;3,0;20,0;1,0;;3,0;1,0;;2,0;13,0;1,0;;;;;1,0;5,0;;4,0;3,0;;16,0;5,0;2,0;73,0;6,0;4,0;;3,0;6,0;;;3,0;1,0;;1,0;;1,0;;5,0;2,0;2,0;6,0;4,0;;54,0;9,0;2,0;1,0;4,0;5,0;;;;2,0;;1,0;3,0;13,0;;7,0;11,0;2,0;1,0;2,0;6,0;;11,0;;;;;1,0;;11,0;;;;6,0;1,0;5,0;3,0;7,0;53,0;23,0;1,0;;;;7,0;;;;5,0;23,0;8,0;;6,0;3,0;8,0;12,0;44,0;;1,0;;7,0;;;1,0;;2,0;3,0;3,0;;22,0;5,0;2,0;;;4,0;;;2,0;1,0;4,0;2,0;2,0;;;;;29,0;2,0;;5,0;6,0;;;;;;;1,0;1,0;;;;;26,0;29,0;;11,0;;2,0;2,0;31,0;;;1,0;;2,0;1,0;12,0;;1,0;23,0;3,0;;;12,0;3,0;;;2,0;3,0;12,0;13,0;5,0;3,0;12,0;1,0;;;3,0;4,0;3,0;8,0;2,0;;;;;2,0;5,0;2,0;1,0;6,0;;1,0;1,0;;1,0;;1,0;;;;2,0;1,0;1,0;9,0;;3,0;5,0;1,0;3,0;;3,0;;;4,0;;11,0;11,0;;2,0;;3,0;1,0;;;;1,0;1,0;8,0;;1,0;;1,0;5,0;1,0;1,0;;;;9,0;;;;6,0;;4,0;;2,0;;2,0;3,0;1,0;4,0;;6,0;7,0;;;;;1,0;3,0;;;;;;;;2,0;3,0;;4,0;;7,0;;3,0;3,0;;1,0;1,0;1,0;6,0;1,0;;;5,0;24,0;4,0;1,0;13,0;6,0;27,0;4,0;3,0;;7,0;;1,0;;;1,0;3,0;1,0;2,0;5,0;;;;;;;2,0;;5,0;;;;;3,0;1,0;;;;;;;2,0;;;1,0;;;1,0;3,0;4,0;;;2,0;6,0;;;;;;3,0;;;1,0;1,0;2,0;6,0;;7,0;;;;;1,0;2,0;;;;2,0;;;;;1,0;
multiple;;;2,0;;1,0;5,0;6,0;50,0;20,0;27,0;18,0;;8,0;;2,0;31,0;2,0;;4,0;;5,0;131,0;;12,0;;;34,0;9,0;;;5,0;1,0;40,0;2,0;28,0;3,0;8,0;52,0;7,0;;77,0;1,0;20,0;7,0;14,0;;62,0;62,0;15,0;12,0;9,0;11,0;;2,0;8,0;;18,0;3,0;1,0;6,0;4,0;;22,0;;14,0;4,0;7,0;23,0;53,0;3,0;23,0;1,0;29,0;;18,0;19,0;15,0;7,0;3,0;445,0;5,0;16,0;1,0;109,0;;4,0;5,0;;2,0;12,0;49,0;8,0;1,0;2,0;16,0;5,0;6,0;;103,0;;1,0;;14,0;175,0;1,0;3,0;38,0;1,0;24,0;47,0;;37,0;2,0;;;35,0;16,0;68,0;;10,0;;1,0;20,0;106,0;28,0;17,0;;;;11,0;;2,0;2,0;;6,0;7,0;15,0;1,0;2,0;;12,0;1,0;2,0;55,0;7,0;;;1,0;27,0;2,0;1,0;1,0;2,0;18,0;7,0;;123,0;;1,0;4,0;;4,0;111,0;;1,0;;43,0;48,0;1,0;4,0;6,0;;;10,0;1,0;;6,0;2,0;;;3,0;3,0;;1,0;;4,0;;7,0;3,0;;5,0;;;10,0;4,0;3,0;6,0;;1,0;3,0;;;1,0;7,0;13,0;;1,0;2,0;52,0;5,0;;;;3,0;1,0;;1,0;1,0;18,0;3,0;;;;;;;3,0;;24,0;;2,0;39,0;34,0;3,0;7,0;3,0;2,0;3,0;1,0;;7,0;;;1,0;11,0;;2,0;2,0;43,0;17,0;3,0;;;;;1,0;34,0;8,0;;;;;1,0;21,0;;;3,0;;;;;16,0;16,0;;;;;43,0;8,0;20,0;8,0;2,0;4,0;2,0;;56,0;;8,0;6,0;;12,0;6,0;;;1,0;;;;;;;11,0;1,0;;;;;8,0;;;43,0;1,0;8,0;;2,0;8,0;;1,0;;10,0;;;;;7,0;;;;;;;;;;1,0;3,0;1,0;;2,0;1,0;;;;22,0;2,0;12,0;;;3,0;12,0;;4,0;3,0;2,0;;10,0;4,0;16,0;;;2,0;1,0;;;;;;;;2,0;;;;;;;;;8,0;;;;6,0;;;2,0;;;1,0;2,0;;18,0;;3,0;;5,0;;;3,0;22,0;;;5,0;2,0;;;;;;;1,0;2,0;;5,0;12,0;;;3,0;;;;;5,0;5,0;;1,0;1,0;15,0;;2,0;;21,0;7,0;2,0;10,0;;3,0;3,0;23,0;1,0;11,0;10,0;2,0;;26,0;6,0;2,0;;1,0;29,0;21,0;3,0;;;15,0;9,0;;9,0;;1,0;4,0;;;4,0;;;3,0;1,0;2,0;41,0;;;1,0;4,0;34,0;1,0;13,0;;;6,0;2,0;8,0;7,0;18,0;;;;10,0;2,0;2,0;;4,0;20,0;4,0;;4,0;1,0;;18,0;;;1,0;;3,0;1,0;;1,0;;15,0;;1,0;5,0;;2,0;10,0;;;;1,0;;8,0;2,0;1,0;2,0;1,0;4,0;2,0;3,0;2,0;2,0;5,0;;5,0;;5,0;;2,0;20,0;1,0;11,0;1,0;4,0;;;;6,0;;4,0;1,0;1,0;;;;1,0;;6,0;;4,0;;;4,0;;1,0;4,0;2,0;5,0;2,0;3,0;;;;;1,0;;1,0;1,0;;1,0;7,0;7,0;;;;1,0;6,0;3,0;;3,0;2,0;;3,0;;;5,0;4,0;;;7,0;;;2,0;3,0;;;;;1,0;;;1,0;6,0;5,0;3,0;1,0;;2,0;;3,0;;;;1,0;;1,0;6,0;;39,0;4,0;;5,0;1,0;;8,0;7,0;2,0;1,0;2,0;2,0;;1,0;2,0;;17,0;2,0;2,0;4,0;;;12,0;4,0;;3,0;;;6,0;;;;;;;;;3,0;3,0;1,0;;;;;1,0;;1,0;1,0;1,0;;;;;1,0;;4,0;2,0;;;1,0;;5,0;;;5,0;3,0;;;;5,0;1,0;;;;;;;2,0;;1,0;;11,0;;;1,0;;;;;;;11,0;;;;;;1,0;;;;;1,0;5,0;1,0;;9,0;1,0;3,0;;3,0;7,0;;1,0;;;;1,0;1,0;3,0;1,0;;;;;;;;;1,0;1,0;;38,0;;2,0;;;;2,0;;;40,0;;;;;;4,0;;;2,0;;2,0;6,0;;;;5,0;1,0;3,0;3,0;;;9,0;9,0;;;;2,0;;;1,0;1,0;;5,0;1,0;4,0;;4,0;2,0;4,0;;;1,0;;;;7,0;;;;;;;3,0;3,0;3,0;3,0;;;4,0;;5,0;2,0;;8,0;;4,0;;8,0;;1,0;;;;10,0;1,0;;;;;11,0;;;;;;;1,0;;;;1,0;;;3,0;5,0;;;;1,0;2,0;2,0;;;;;;1,0;;;;;2,0;;;;;;;;2,0;2,0;;;;;;2,0;;;1,0;26,0;;12,0;;17,0;;;;;;;2,0;;4,0;;;;1,0;;;;;;;;2,0;;;;;;;1,0;;2,0;1,0;1,0;;;8,0;;;;;;;4,0;;25,0;;;;;1,0;;;1,0;;;;;4,0;17,0;;;5,0;6,0;;6,0;;;;;;;;;;;11,0;;;;;;;;;;;;1,0;;;;6,0;1,0;;;;;
node;;;8,0;;1,0;3,0;;3,0;16,0;13,0;1,0;;10,0;;;18,0;;;;;26,0;6,0;;;;;;1,0;;;;1,0;26,0;;21,0;2,0;;;;;35,0;;3,0;1,0;12,0;1,0;69,0;27,0;6,0;;2,0;7,0;;;15,0;;70,0;;10,0;;;;8,0;;;;;21,0;1,0;;12,0;;10,0;1,0;;;6,0;;;42,0;;12,0;;66,0;3,0;12,0;;23,0;;;;1,0;;;8,0;;;1,0;31,0;;;1,0;12,0;84,0;;;1,0;1,0;356,0;8,0;;9,0;;;1,0;143,0;15,0;22,0;36,0;15,0;;;;5,0;;11,0;;;;;;90,0;2,0;;2,0;;10,0;7,0;5,0;2,0;;;8,0;101,0;1,0;3,0;;2,0;144,0;;;;4,0;9,0;;29,0;22,0;;3,0;67,0;3,0;14,0;34,0;79,0;;;1,0;21,0;;;;;;6,0;2,0;3,0;;;;;;;;;32,0;75,0;;;;;;;;133,0;;;6,0;;;3,0;;;;13,0;;;8,0;;;;;;;24,0;;;;;2,0;;;4,0;;;;;3,0;;5,0;;1,0;;;;;;;;;;;;;11,0;1,0;2,0;31,0;3,0;60,0;1,0;;;;;;2,0;12,0;3,0;;;;;;5,0;;;;;;;;23,0;1,0;;;;;3,0;;;61,0;3,0;60,0;;;12,0;;;;;;2,0;28,0;;;;15,0;;;;;3,0;;;;;5,0;;;5,0;;;;;;;;;;4,0;;;;;25,0;;;;;5,0;;;;;;;;2,0;2,0;;;;;;1,0;;;;;;;;;;;;;5,0;;;;;;;;;;;;;;;;;;;;;;;;;1,0;;;;;;;;;31,0;;;;;;2,0;;;;;;;;;;;;2,0;3,0;;1,0;;1,0;;;;;;;;;;;2,0;5,0;1,0;;;;138,0;21,0;;16,0;2,0;;1,0;2,0;2,0;;;;;5,0;2,0;2,0;1,0;;;;;;;3,0;3,0;6,0;;;;8,0;;;;;;;;26,0;76,0;;;;8,0;3,0;;9,0;;88,0;;5,0;2,0;;6,0;2,0;;;;4,0;6,0;10,0;1,0;;3,0;;8,0;;;1,0;;;;;;;15,0;4,0;;29,0;3,0;;;;275,0;;;;;;;;2,0;;;;;;;;1,0;;6,0;2,0;19,0;;;1,0;;1,0;;;;;;;3,0;;2,0;;11,0;5,0;;;;;;;;;;;;;16,0;;4,0;4,0;5,0;;;11,0;;;;;;;;;;;;;;;;;;;;;;;18,0;;;3,0;;;3,0;;;;3,0;;;;;;;;;;;;1,0;;;;;6,0;;;;;;65,0;;;;89,0;;3,0;;;;16,0;;;;;;;;;2,0;;;;;;1,0;;;;5,0;;2,0;;;1,0;;6,0;6,0;39,0;;;5,0;;;5,0;;;;;;;;;;;;;;;;;18,0;;;;87,0;;;;;;78,0;;;;;;4,0;;;;;;;;;;;;;;;;;12,0;;;;;4,0;2,0;13,0;;;;;;;;;;;;;;;;;;;;;;;;;;;;8,0;;;;5,0;;32,0;12,0;1,0;16,0;;;;;;27,0;10,0;;;56,0;;;;1,0;;;;;;;;;;;;;;143,0;23,0;;;;;;;;;;;;;;;;;;;;;;3,0;;;;19,0;;;;;;11,0;;;;;;3,0;;;;;;;;;;;;;;;;;;;;;;;;;;;;;;2,0;;;;2,0;;;;;;;;;;;;;;;;;;;;;;4,0;;;;3,0;;;;;;;;;;;3,0;;;;;;;;;;;;;2,0;;;1,0;4,0;;;;1,0;;;;6,0;14,0;;;;;;;;;;;;;;;;;;;;;;;;;;;;2,0;;;;;;;;2,0;;;;;;;;;;;;;;;;;;;;;;;;1,0;;;;;;;;;;1,0;
noise;;;5,0;;;;1,0;19,0;10,0;9,0;1,0;;12,0;;;20,0;;;;1,0;5,0;16,0;3,0;;;;50,0;;;2,0;;4,0;21,0;6,0;8,0;4,0;18,0;17,0;1,0;;76,0;;6,0;1,0;16,0;8,0;22,0;91,0;30,0;4,0;;12,0;3,0;8,0;2,0;;16,0;2,0;57,0;;;;1,0;;167,0;;4,0;;10,0;;15,0;;49,0;;;;;;;327,0;3,0;21,0;3,0;75,0;7,0;;6,0;;;;16,0;;;;;3,0;20,0;;68,0;;4,0;3,0;13,0;49,0;;4,0;1,0;1,0;19,0;22,0;15,0;49,0;;2,0;1,0;8,0;1,0;15,0;8,0;11,0;;;40,0;101,0;15,0;4,0;8,0;;;19,0;;;;28,0;8,0;;10,0;6,0;21,0;;12,0;;;6,0;18,0;6,0;;;100,0;4,0;17,0;;3,0;26,0;8,0;4,0;6,0;;;7,0;1,0;1,0;73,0;;;;15,0;;1,0;2,0;16,0;;;;8,0;16,0;;;;;;3,0;;;7,0;14,0;;250,0;;;6,0;1,0;;;;;;;;1,0;;;25,0;;;;;;16,0;;;;;;;;;;1,0;;3,0;;;;;;1,0;;2,0;;;;;;;;7,0;;;;;;;5,0;;;;;177,0;;;;1,0;;;;12,0;;;;;;;14,0;1,0;;;;;;;3,0;5,0;;7,0;;2,0;;;;4,0;4,0;2,0;;;9,0;5,0;;;;;;;;;;4,0;;;;;;;;;;;13,0;;;;1,0;2,0;;;11,0;;;;;;;;;4,0;;;;16,0;;;;;;;40,0;;;;;;;;1,0;2,0;;;12,0;4,0;52,0;;;;3,0;;;;3,0;;;1,0;;1,0;;;;;;;;2,0;;;4,0;;;;;;;;3,0;1,0;;;;;;;;;6,0;;;;;;;1,0;;;;;1,0;;;6,0;;;31,0;3,0;;10,0;;10,0;;;;;;;;;;;4,0;10,0;;20,0;;;5,0;35,0;1,0;1,0;3,0;2,0;7,0;1,0;;;2,0;2,0;;;1,0;1,0;2,0;;;;;;;;6,0;;;;;;;3,0;2,0;;;;;38,0;1,0;;;;;1,0;;;;14,0;;9,0;;;4,0;;12,0;;2,0;;2,0;;1,0;2,0;3,0;4,0;;;;;;;;;;4,0;;7,0;;13,0;;1,0;;;;;;;;;;;;;1,0;;6,0;12,0;;;;;;;2,0;;;11,0;;;1,0;;;;;;9,0;42,0;;;1,0;;;4,0;;;;;;;;;;;3,0;;;;;;;;;;;;2,0;;;;;;;;;1,0;8,0;;;;;;;;;;;;;;;;;;;;;;;;;;;;;;;;;;;2,0;;;2,0;1,0;;;;;;19,0;;;;1,0;;;;;;5,0;;;;;;;;;;;;5,0;;;;;3,0;;;;;;1,0;2,0;;;2,0;;;;;;;;;;;;;;;;;;6,0;;;;;;;;;;;;;;;;;;;;;;;;;;;;;;;;;;;7,0;;;;;;;1,0;1,0;;4,0;;;;;;;;;;;;;1,0;;;;;;;;;;;;3,0;;;;;;1,0;9,0;;;1,0;;1,0;;;;;;155,0;;;;;2,0;2,0;;;;;;1,0;;;;;5,0;;;;;;;;;;14,0;;4,0;3,0;;1,0;7,0;;2,0;1,0;;;;;;138,0;;;;;;;12,0;1,0;;1,0;;;12,0;3,0;;;;13,0;5,0;;;;;;;7,0;1,0;;;1,0;;;;;1,0;;;17,0;;;;;14,0;;;6,0;;;;26,0;;;;;;4,0;;;;;;;;;;;;;;;;8,0;;;;1,0;;;;;2,0;;1,0;;;;2,0;;4,0;;;;;;;;;;;;9,0;;;;;;1,0;1,0;;1,0;;;;;;;;;2,0;;6,0;;;;;;;;;;;;;;;1,0;10,0;;;;;;;;;;;;;;;;;;;4,0;;;4,0;;;;;1,0;;;;2,0;;;;;;;1,0;;;;;;;;;
omega;;;6,0;;;250,0;;;;;;10,0;;;5,0;;;;;;;;;;;;;;;;;222,0;;;;;;;;12,0;;;;;;;;;;;;;;;;;119,0;;;;;;;;;114,0;1,0;;;;;;;;;;;;;38,0;;;;;;;;;13,0;197,0;248,0;;;;;;;;;;;;;23,0;;;5,0;;;;;;;;;;;;14,0;;;;;;;;;;;;;;;;3,0;;;;;229,0;;;;;;;;8,0;;;;;;;;;229,0;12,0;;;;;98,0;;1,0;;;226,0;;;6,0;;;;4,0;;;;;;;;;;;;;;;;;;;;1,0;;;;;;;;;;;;;;;;;;;;;;;;24,0;;;21,0;;;;;;;;;;;;;;;4,0;;;;;;;;;;;;;;;;;;;;;;;62,0;;;;;;;;;;;;;;;;;;;;20,0;;;;4,0;;19,0;;;;;;;;;;;;;;;;;;9,0;;;;;;;;;;;;;;;;;;;4,0;;;;;;;;;;;;;;;;;;;;;;163,0;;;;;;;;;;;;;;;;;;;;;;;;;;;;;;;;;;;;;;;;;;;;;;;;;;;;;;;;;;;;;;;;;;;;;33,0;;;;;;;;;;;;;;;;;;;;;;;;;;;;;;;;;;;;;;;;;;;;;;;;;;;;;;;;;;;;;;;;;;;;;;;;;;;;;;;;;;;;;;;;;;;;;;;;;;;;;;;;;;;;;;;;;;;;;;;;;;;;;;9,0;;;;3,0;;;;;;;;;;;;;;;;;;;;;;;;;;;;;;;;;;;;;;;;;;;;;;;;;;;;;;;;;;;;;;;;;;;;;;;;;;;;;;;;;;;;;;;;;;;;;;;;;;;;;;;;;;;;;;;;;;;;;;;;;;;;93,0;;;;;;;;;;;;;;;;;;;;;;;;;;;;;;;;;;;;;;;;;;;;;;;;;;;;;;;;;;;;;;;;;;;;;;;;;;;;;;;;;;;;;;;;;;;;;;;;;;;;;;;;;;;;;;;;125,0;;;;;;;;;;;;;;;;;;;;;;;;;;;;;;;13,0;;;;12,0;;;;;;;;;;;;;;;;;;;;;;;;;;;;;;;;;;;;;;;;;;;;;;;;;;;;;;;;;;;;;;;;;;;;;;;;;;;;;;;;;;;;;;;;;;;;;;;;;;;;;;;;;;;;;;;;;;;;;;;;;;;;;;;;;;;;;;;;;;;;;;;;;;;;;;;;;;;;;;;;3,0;;;;;;;;;;;;;;;;;;;323,0;;;;;;
operator;;;1,0;;;4,0;;19,0;5,0;4,0;;;;;1,0;7,0;;2,0;;;;6,0;5,0;;;;;;;;;;15,0;;48,0;3,0;;1,0;;;8,0;;17,0;7,0;8,0;;12,0;42,0;1,0;30,0;;18,0;;1,0;1,0;10,0;3,0;1,0;;;;1,0;6,0;1,0;;8,0;27,0;3,0;8,0;;;;5,0;2,0;;2,0;;;2,0;35,0;;1,0;;6,0;;4,0;;;;7,0;8,0;4,0;;;2,0;;;;33,0;1,0;;;12,0;24,0;;;2,0;6,0;3,0;5,0;;6,0;;;;15,0;1,0;20,0;;12,0;;;6,0;15,0;2,0;;;6,0;;2,0;6,0;2,0;3,0;;1,0;;2,0;11,0;12,0;;7,0;;;3,0;8,0;;;3,0;11,0;;;3,0;;2,0;2,0;1,0;24,0;;2,0;;;;32,0;;;;20,0;24,0;2,0;;6,0;;;9,0;;18,0;5,0;;4,0;;;5,0;;;;;;;;;;;;;;;;;;4,0;;;2,0;5,0;;;;;;3,0;;;;;;;;;;;;;;;;;;;2,0;;;;3,0;5,0;2,0;10,0;8,0;4,0;3,0;;;;;1,0;1,0;;;;3,0;;;;;;;;37,0;;;;;;;8,0;;;2,0;;;;;1,0;1,0;;;;3,0;2,0;;5,0;;;;;;1,0;;;;1,0;66,0;1,0;17,0;;;;;1,0;;;;11,0;;;;;;1,0;;2,0;;1,0;;;;;;;;1,0;;;;;1,0;;;;;;;;;;;1,0;1,0;;2,0;;;;;;;4,0;;;4,0;1,0;;;3,0;;;;;1,0;1,0;;;;;;;;;;;;1,0;;;5,0;;;;;;1,0;;3,0;;;;1,0;;;;3,0;;;1,0;4,0;;;;;;;1,0;;2,0;3,0;;;;1,0;;4,0;8,0;1,0;1,0;;3,0;;1,0;;;;5,0;1,0;1,0;2,0;;;4,0;;;2,0;;28,0;1,0;;11,0;;;;4,0;;12,0;5,0;;;;5,0;15,0;;2,0;;49,0;;;3,0;;5,0;7,0;;;;4,0;1,0;;1,0;4,0;2,0;;5,0;1,0;;4,0;;;;4,0;;;;;;15,0;;1,0;5,0;;1,0;1,0;;;;;;1,0;6,0;;15,0;;1,0;28,0;;1,0;;;1,0;1,0;;1,0;;;1,0;;9,0;;;;;1,0;;2,0;;;1,0;1,0;6,0;;;11,0;;4,0;3,0;;;;;;;4,0;;;;4,0;;;;1,0;;;1,0;;9,0;1,0;;;;;;3,0;;;;;;;;;43,0;;2,0;;17,0;;;6,0;;;15,0;;;;;;4,0;;;;;;;4,0;1,0;3,0;;;2,0;;;1,0;4,0;;;2,0;;;;;;1,0;;;;;;;;;;;;;;;;;;;;4,0;;;7,0;;;;;;;;;;;1,0;;;;2,0;;;;2,0;3,0;;;;;1,0;;;3,0;;;;;;1,0;;;;3,0;;;;;;4,0;;;;2,0;;;5,0;6,0;1,0;;;2,0;1,0;;;;;;;;4,0;;;1,0;;;5,0;;1,0;;;;;1,0;;;;;;3,0;;;;;;;;;;;;;;;1,0;;;;;7,0;;;;;1,0;7,0;1,0;;;3,0;;;;;;;;;;;;;;;;;;;;;1,0;;;;;;;;1,0;1,0;;2,0;;;1,0;;1,0;;;;1,0;;;;;1,0;3,0;;;1,0;;;;;;4,0;;;;2,0;;;3,0;;;;;2,0;;2,0;;;;;;;;;6,0;1,0;;9,0;;;;;;;;2,0;;;4,0;;;;;;;;9,0;1,0;;3,0;;;;;;;2,0;1,0;;;5,0;;;;;;;2,0;;;;;;;2,0;;;;;;;;;;;;;;;;;;;;;;;;;;;;;;3,0;;;;;;;;;;;;;;1,0;;;;;;;;;;;;;;;;;;2,0;;5,0;;;;;;;;3,0;;;;;;;1,0;;;;10,0;;;;;1,0;;;;;;1,0;;;;;;;;;;;1,0;;1,0;2,0;;;;;;;;1,0;;3,0;;;;;;;;;
path;;;1,0;;1,0;42,0;56,0;37,0;15,0;54,0;5,0;;16,0;;41,0;68,0;97,0;;;;1,0;42,0;2,0;9,0;1,0;;7,0;2,0;11,0;6,0;1,0;5,0;63,0;;75,0;14,0;10,0;3,0;4,0;;89,0;;59,0;2,0;4,0;4,0;58,0;92,0;24,0;34,0;75,0;8,0;;2,0;18,0;5,0;66,0;5,0;6,0;;23,0;13,0;15,0;3,0;118,0;3,0;37,0;35,0;18,0;8,0;10,0;41,0;27,0;;3,0;7,0;7,0;13,0;55,0;270,0;17,0;129,0;;96,0;2,0;4,0;23,0;2,0;1,0;22,0;340,0;;;10,0;9,0;6,0;10,0;;95,0;3,0;3,0;4,0;36,0;96,0;6,0;11,0;1260,0;8,0;36,0;1,0;33,0;4,0;;;;41,0;126,0;152,0;4,0;52,0;3,0;15,0;1,0;20,0;6,0;7,0;;1,0;4,0;15,0;10,0;31,0;16,0;24,0;15,0;5,0;5,0;6,0;5,0;;25,0;;;85,0;3,0;;;66,0;99,0;;2,0;2,0;;7,0;34,0;;211,0;;1,0;2,0;2,0;32,0;244,0;;8,0;;25,0;24,0;19,0;14,0;5,0;4,0;;7,0;2,0;12,0;18,0;1,0;3,0;2,0;;67,0;;5,0;8,0;24,0;;21,0;;;2,0;;1,0;27,0;;12,0;;;;7,0;10,0;1,0;19,0;43,0;5,0;;;;;8,0;4,0;;2,0;1,0;;;1,0;11,0;4,0;3,0;25,0;19,0;17,0;;5,0;1,0;5,0;5,0;411,0;;52,0;3,0;77,0;59,0;31,0;18,0;33,0;51,0;2,0;3,0;12,0;;5,0;;5,0;;7,0;3,0;32,0;20,0;6,0;5,0;;2,0;;1,0;35,0;50,0;1,0;6,0;;;1,0;8,0;1,0;;5,0;7,0;21,0;;11,0;65,0;7,0;;4,0;1,0;14,0;13,0;9,0;44,0;16,0;;;;;33,0;1,0;4,0;9,0;6,0;38,0;1,0;;;6,0;4,0;2,0;;;1,0;21,0;22,0;8,0;35,0;;;2,0;22,0;2,0;3,0;;25,0;;16,0;13,0;4,0;;;1,0;41,0;7,0;;3,0;2,0;37,0;;3,0;;;34,0;3,0;;;6,0;13,0;2,0;;23,0;;6,0;2,0;;81,0;4,0;4,0;6,0;4,0;2,0;30,0;1,0;1,0;25,0;2,0;43,0;;5,0;1,0;38,0;2,0;3,0;5,0;5,0;1,0;;;1,0;;4,0;;30,0;;2,0;1,0;3,0;2,0;;;1,0;8,0;3,0;;;3,0;;;15,0;;;;9,0;;16,0;;;;256,0;;4,0;;5,0;;3,0;;1,0;;;;;;19,0;12,0;11,0;;1,0;9,0;;4,0;;;;2,0;7,0;18,0;1,0;7,0;;;1,0;;;;66,0;36,0;17,0;18,0;;4,0;8,0;8,0;;6,0;77,0;52,0;2,0;3,0;2,0;4,0;1,0;7,0;10,0;46,0;1,0;;1,0;;13,0;;12,0;1,0;1,0;6,0;;;1,0;;;2,0;10,0;;9,0;2,0;35,0;;13,0;12,0;1,0;3,0;2,0;4,0;;27,0;7,0;6,0;12,0;3,0;;11,0;8,0;;1,0;10,0;32,0;3,0;;;;2,0;;19,0;;6,0;;;78,0;17,0;38,0;8,0;;27,0;;;9,0;3,0;11,0;7,0;;;;;;22,0;5,0;20,0;5,0;;;;;2,0;3,0;1,0;1,0;16,0;11,0;4,0;;4,0;;2,0;2,0;;12,0;;;;6,0;2,0;4,0;39,0;3,0;;;20,0;3,0;;9,0;1,0;;;;9,0;11,0;;21,0;2,0;4,0;1,0;24,0;;5,0;10,0;;36,0;;;11,0;5,0;;;;;2,0;;;;2,0;;;;1,0;;2,0;2,0;2,0;;2,0;;3,0;2,0;4,0;52,0;;4,0;;;1,0;;4,0;;;3,0;;;;6,0;;;1,0;;2,0;2,0;3,0;;;;;24,0;;8,0;;3,0;;;12,0;2,0;;7,0;;;;;;;;;1,0;2,0;;7,0;;;2,0;;;2,0;;;;6,0;;;;;;10,0;7,0;5,0;10,0;;16,0;1,0;8,0;;2,0;;5,0;;;1,0;;;;6,0;;;;3,0;3,0;;4,0;;;;;;1,0;1,0;1,0;3,0;;;;;1,0;;6,0;;;;;;;;;;4,0;;1,0;6,0;;;;;2,0;;1,0;6,0;6,0;;14,0;;;8,0;;3,0;;;7,0;;;2,0;;;2,0;;;4,0;6,0;1,0;;2,0;;;;;5,0;1,0;;14,0;4,0;;7,0;;2,0;;;;;5,0;;2,0;2,0;;1,0;;62,0;;9,0;1,0;1,0;11,0;;;1,0;1,0;;4,0;;;7,0;1,0;;7,0;3,0;;;;;2,0;13,0;;;5,0;;;;;2,0;1,0;3,0;4,0;5,0;;;;;4,0;;;;;;2,0;1,0;10,0;;;;;;;3,0;7,0;32,0;;6,0;2,0;;;;18,0;2,0;3,0;1,0;;;2,0;3,0;;;;;;;;1,0;;;;;2,0;;;;;8,0;;1,0;;6,0;;;4,0;6,0;5,0;;14,0;;;;2,0;;;;2,0;;;5,0;;;1,0;1,0;;;3,0;;;;4,0;2,0;6,0;;;;1,0;;;;1,0;;;;;1,0;8,0;5,0;1,0;17,0;3,0;6,0;;;8,0;;;3,0;;;1,0;;;;;;;;;1,0;;;;;;59,0;;;;;;;;1,0;5,0;;1,0;;;1,0;;;46,0;;;4,0;2,0;2,0;4,0;;;3,0;;;;;1,0;;;2,0;;2,0;5,0;12,0;1,0;;48,0;;1,0;;;;;1,0;;1,0;;;;;;
pattern;;;6,0;2,0;3,0;17,0;5,0;40,0;74,0;100,0;25,0;;11,0;1,0;11,0;112,0;43,0;;20,0;10,0;205,0;99,0;18,0;;;;146,0;4,0;;1,0;7,0;4,0;76,0;15,0;43,0;6,0;30,0;8,0;4,0;;52,0;;10,0;;108,0;19,0;87,0;121,0;24,0;108,0;19,0;33,0;27,0;6,0;3,0;22,0;34,0;11,0;6,0;1,0;27,0;;10,0;;95,0;;7,0;123,0;35,0;12,0;9,0;16,0;40,0;18,0;24,0;27,0;21,0;10,0;163,0;491,0;;12,0;4,0;247,0;8,0;8,0;1,0;3,0;;9,0;78,0;;1,0;17,0;27,0;7,0;3,0;;151,0;2,0;3,0;20,0;43,0;94,0;;5,0;41,0;12,0;19,0;21,0;6,0;25,0;4,0;;8,0;188,0;91,0;68,0;21,0;63,0;1,0;;14,0;20,0;23,0;8,0;1,0;;;9,0;;135,0;5,0;9,0;20,0;3,0;24,0;29,0;1,0;4,0;4,0;;11,0;50,0;9,0;1,0;;13,0;71,0;14,0;33,0;;6,0;10,0;;9,0;78,0;;2,0;3,0;2,0;16,0;73,0;;3,0;1,0;26,0;17,0;7,0;5,0;;;5,0;5,0;9,0;12,0;10,0;1,0;;2,0;19,0;20,0;2,0;;;56,0;;19,0;1,0;;;;;75,0;1,0;9,0;;;;16,0;;1,0;33,0;21,0;1,0;;13,0;;6,0;3,0;42,0;;;10,0;;;;;;17,0;7,0;;8,0;1,0;;;87,0;;181,0;7,0;6,0;3,0;10,0;5,0;;11,0;19,0;1,0;1,0;3,0;22,0;;2,0;1,0;28,0;2,0;1,0;6,0;78,0;14,0;6,0;2,0;;;;1,0;14,0;4,0;;;;1,0;;24,0;7,0;;40,0;3,0;2,0;;1,0;19,0;5,0;15,0;;;1,0;6,0;25,0;63,0;3,0;;20,0;;;6,0;6,0;18,0;;19,0;15,0;13,0;;1,0;;;;;38,0;5,0;2,0;1,0;7,0;;;1,0;4,0;13,0;1,0;;;6,0;4,0;;1,0;11,0;;;1,0;1,0;;16,0;;;8,0;;;;;2,0;;;;;;17,0;12,0;1,0;1,0;6,0;3,0;;;8,0;2,0;;4,0;15,0;11,0;;3,0;2,0;;2,0;;1,0;1,0;43,0;14,0;33,0;1,0;107,0;;1,0;;;;;;6,0;;;;4,0;1,0;;1,0;;2,0;10,0;;;12,0;;;42,0;;;;2,0;2,0;93,0;206,0;11,0;;2,0;;12,0;;;;;;4,0;1,0;;5,0;3,0;2,0;39,0;23,0;73,0;26,0;;3,0;2,0;4,0;1,0;2,0;;3,0;15,0;4,0;2,0;;;1,0;27,0;;;;46,0;8,0;1,0;49,0;1,0;56,0;9,0;8,0;2,0;8,0;10,0;9,0;;4,0;6,0;13,0;1,0;11,0;4,0;;;2,0;55,0;3,0;11,0;2,0;;;2,0;3,0;5,0;2,0;;;;;4,0;1,0;3,0;2,0;;;;38,0;2,0;4,0;;4,0;1,0;15,0;6,0;6,0;5,0;13,0;;;;2,0;32,0;1,0;8,0;1,0;4,0;4,0;2,0;4,0;2,0;2,0;3,0;3,0;4,0;;29,0;1,0;;13,0;;5,0;;14,0;21,0;;;;;2,0;1,0;;;4,0;2,0;;3,0;;;4,0;;;5,0;;4,0;13,0;7,0;;;8,0;2,0;;4,0;;;;2,0;;17,0;8,0;1,0;;;;;2,0;4,0;;17,0;1,0;;;15,0;5,0;6,0;;20,0;5,0;2,0;6,0;1,0;;;10,0;1,0;2,0;;11,0;2,0;;;;;12,0;;;1,0;;9,0;13,0;;;;;;1,0;2,0;;;;;1,0;1,0;13,0;;2,0;;32,0;12,0;1,0;;;;;;2,0;;;;2,0;;;2,0;;1,0;;39,0;11,0;;73,0;;;;;;;7,0;;;;;4,0;;14,0;9,0;;1,0;3,0;9,0;2,0;;4,0;2,0;2,0;;;;1,0;;;6,0;;;;;;2,0;2,0;14,0;;1,0;;7,0;;;17,0;;;;;;5,0;;;2,0;;;;24,0;;;;;;18,0;;2,0;;2,0;14,0;8,0;38,0;;;;1,0;;;;;2,0;6,0;;;;9,0;4,0;;;;;;;;1,0;;;;;43,0;3,0;1,0;17,0;11,0;40,0;11,0;1,0;17,0;;;7,0;;;3,0;4,0;;9,0;;3,0;;2,0;;;;;;;5,0;2,0;2,0;;7,0;4,0;2,0;1,0;;;1,0;1,0;;8,0;;;2,0;34,0;22,0;17,0;5,0;;;3,0;19,0;;;;;2,0;;19,0;27,0;;;49,0;7,0;6,0;8,0;2,0;;;1,0;;4,0;;2,0;;3,0;3,0;2,0;;;;;5,0;2,0;52,0;;2,0;;4,0;;5,0;;;;4,0;;3,0;;;3,0;;;;;12,0;6,0;;2,0;21,0;;;;;1,0;6,0;;1,0;3,0;;1,0;2,0;;;2,0;;17,0;;1,0;;1,0;;2,0;;;1,0;;;;34,0;1,0;;;8,0;;2,0;;;5,0;;;3,0;;;;;;1,0;2,0;;;120,0;1,0;1,0;;5,0;42,0;1,0;;2,0;6,0;;3,0;2,0;;3,0;;;2,0;;;;14,0;;;;;;15,0;1,0;12,0;;;6,0;1,0;;2,0;;;2,0;;;2,0;;52,0;4,0;;;17,0;;3,0;;;;;;;;14,0;;11,0;;;2,0;;4,0;;7,0;4,0;;8,0;8,0;;;;;5,0;1,0;;;;;;1,0;;1,0;2,0;;;;;;;2,0;6,0;;;10,0;;29,0;4,0;9,0;;1,0;1,0;;;7,0;;4,0;1,0;;;
photosensor;;;1,0;;;;4,0;7,0;2,0;;87,0;;1,0;;;7,0;;;;;;33,0;;1,0;;;2,0;;;;;;32,0;;15,0;;;;;;;;4,0;;4,0;;5,0;11,0;;;;18,0;;3,0;;;15,0;;;;7,0;1,0;;;9,0;15,0;10,0;;4,0;5,0;4,0;;3,0;;;;;10,0;2,0;30,0;;4,0;;7,0;2,0;;;;;11,0;23,0;;;;6,0;;;;14,0;;;;;;28,0;;20,0;;14,0;;9,0;;;;;30,0;35,0;23,0;;1,0;6,0;;;;;;1,0;;4,0;5,0;;57,0;;;;;6,0;;3,0;;16,0;;;9,0;;;;;16,0;15,0;3,0;;1,0;;;;9,0;;;;1,0;;;;;;;;;6,0;;;;;;1,0;;;;;;;;;9,0;;;1,0;;;;;;3,0;;;;;;;;1,0;5,0;;;;8,0;16,0;;;;5,0;;17,0;;;;;;;;3,0;;;;;;;51,0;;;;;;;;;;;;2,0;;1,0;1,0;1,0;;;1,0;79,0;1,0;;1,0;;;;;32,0;;;;;;;;;;;;;;;12,0;;;;;;3,0;;;;;1,0;;;9,0;;;;;;;;;;;;;;;;3,0;;;;;;;;;;;;;;2,0;;;;;;;1,0;;;;;;;;;;;;;4,0;;;;;;;;;3,0;;;;1,0;2,0;;;;;;;;;3,0;;;35,0;;;;;;;;;;;;2,0;;;;;;;;;;;;;;;;;;3,0;1,0;;;;;;;;;;;;;;;;;9,0;4,0;;;;;;;;;;;;1,0;;;;;;;;;2,0;;;20,0;;;5,0;2,0;3,0;;;;;;5,0;7,0;;;2,0;;;;;4,0;;;;;;;;;;;;;;;;;;;;;;;;3,0;;1,0;;;;;;;;;10,0;;;;;;;;;;;;2,0;;;;;;;;;;;;;;;;;;;;;;;;;;;;;;;;;;;;4,0;2,0;1,0;;;;;;;;;;;;;;;;;;2,0;;;;;;;;;;2,0;;2,0;1,0;;;2,0;;1,0;;;;;4,0;;;;;;;;;;;;;;;;;;;;1,0;;;;;5,0;;;;;;;;;;;;;;;4,0;;;;;;1,0;;;;1,0;;;47,0;;;;;;;;;;;;;;1,0;;;;2,0;;;;;;;;;;;;;;;;;;;;;;;;;;;;;;;;;;;;;;;;;;;;;;8,0;;;;;;;;;;;;;;;;;;;;;;;;;;;;;;6,0;;;;;9,0;;1,0;;;4,0;;;;;;;;;;;;;;;;;;;;;5,0;2,0;17,0;;;;;;;;;;;;;;;;8,0;;;5,0;;1,0;;;7,0;2,0;;;;;;;;4,0;;;;;;;6,0;;;;;;;;;;3,0;;;;;;;;;;;;;;;;;;;2,0;;1,0;;;;;2,0;;;;;;;;;;;;;;;;;;;;;;;;;;;;2,0;;;;;;;;;;;;;;;;;;;;;;;;;;;6,0;;;;;;;;;;;;;;;;;;;;;;;;;;;;;;;;;;;;;;;;;;;;;;3,0;;;;;;;;;;;;;;;;;;;;;;45,0;;;;;;;;;;;;;;;;;;;;;;;;;;;;;;;;;;;;;;;;
piece;;;1,0;2,0;;1,0;;17,0;2,0;4,0;;;;;10,0;16,0;;;2,0;;1,0;20,0;1,0;2,0;1,0;;1,0;5,0;1,0;2,0;;2,0;24,0;;10,0;19,0;22,0;6,0;5,0;;104,0;;2,0;;4,0;;2,0;38,0;6,0;2,0;27,0;1,0;3,0;3,0;4,0;;22,0;2,0;;;37,0;9,0;4,0;;;;1,0;44,0;2,0;4,0;;;14,0;;1,0;4,0;;;;196,0;;13,0;;55,0;;3,0;;1,0;;3,0;50,0;;;7,0;;1,0;5,0;6,0;14,0;1,0;2,0;;28,0;30,0;;;15,0;2,0;6,0;6,0;2,0;2,0;2,0;;23,0;103,0;32,0;50,0;;20,0;;;;10,0;;;;;;5,0;;1,0;11,0;;;5,0;2,0;;;3,0;;3,0;;13,0;6,0;1,0;;51,0;;;1,0;6,0;6,0;27,0;17,0;;17,0;;;1,0;;3,0;39,0;;;;11,0;4,0;;;;;2,0;5,0;7,0;1,0;37,0;8,0;;;1,0;19,0;3,0;5,0;;9,0;;5,0;2,0;;;;;58,0;;2,0;;;;13,0;;5,0;6,0;12,0;;8,0;;;;5,0;;;;;;;4,0;;;29,0;35,0;;4,0;;;;;7,0;15,0;1,0;12,0;5,0;1,0;24,0;1,0;4,0;10,0;10,0;10,0;23,0;;1,0;;;4,0;;;6,0;27,0;1,0;10,0;;2,0;1,0;;;12,0;;;;8,0;1,0;10,0;3,0;;3,0;4,0;4,0;2,0;;4,0;1,0;5,0;;;7,0;;6,0;41,0;16,0;1,0;;1,0;;;11,0;;;;;1,0;2,0;;;2,0;;;;13,0;;1,0;2,0;4,0;;;1,0;;7,0;2,0;;5,0;;11,0;4,0;3,0;4,0;;2,0;;77,0;;;;4,0;1,0;;3,0;49,0;;;15,0;10,0;12,0;;;;3,0;5,0;4,0;4,0;;;21,0;1,0;3,0;1,0;16,0;;5,0;2,0;1,0;4,0;;;;3,0;1,0;3,0;;;;1,0;1,0;9,0;3,0;3,0;1,0;1,0;2,0;;;4,0;;;1,0;;;5,0;6,0;1,0;12,0;;1,0;19,0;;;3,0;3,0;;15,0;1,0;10,0;;;18,0;;;3,0;;;;;2,0;2,0;;;;;3,0;;2,0;30,0;;;;;5,0;3,0;1,0;;;;2,0;;;;;20,0;;;;5,0;;;3,0;;;;;;4,0;;;;1,0;3,0;32,0;;;;6,0;;;8,0;;4,0;6,0;;;;17,0;;;;;5,0;;;;3,0;;;;;;;;;;3,0;1,0;5,0;;;1,0;;1,0;;;;;1,0;;;;4,0;;;;;3,0;;;;;;18,0;;6,0;;1,0;;;;;;;;;;;;;4,0;;;;;1,0;;;;3,0;1,0;;1,0;7,0;8,0;;;;3,0;2,0;1,0;;;;;;1,0;;3,0;;;;7,0;;6,0;2,0;;2,0;5,0;;3,0;2,0;;2,0;;;1,0;11,0;;8,0;2,0;;2,0;;1,0;;;1,0;;;;1,0;;;;1,0;;;;;3,0;1,0;;;;1,0;;21,0;;;;;3,0;;5,0;;;;;;;1,0;;;;;;;;2,0;;6,0;;3,0;;;1,0;;;;8,0;;;;1,0;;;;;;3,0;;;;;1,0;;;;2,0;;3,0;3,0;;;2,0;8,0;;2,0;;9,0;5,0;;;;;3,0;;1,0;;;;;;1,0;13,0;1,0;5,0;1,0;;6,0;19,0;;;2,0;8,0;;3,0;;22,0;;;1,0;;;11,0;;;;;;3,0;5,0;;3,0;;;;;;;;;;;1,0;;;4,0;1,0;;3,0;;5,0;;2,0;3,0;;;;;;;;2,0;;;;;;1,0;1,0;4,0;;2,0;1,0;;;;;1,0;4,0;1,0;2,0;;;;;;;;;;;;;;;6,0;;;;;;;;;;;;;;;;;;;1,0;;;1,0;;;;;5,0;;3,0;;;;;;8,0;4,0;;;;;;;;;;;;;;;;3,0;;;;;;;;;;;;;3,0;;;;;;;;;;;;;1,0;;;2,0;1,0;;;;3,0;;;;;1,0;;;;;;10,0;2,0;;;;;;1,0;;;;;;;;;5,0;;;;;;;;;;;;;;;;;;1,0;;;8,0;;3,0;;11,0;;;;11,0;;;;;;;;;;;;2,0;;;;;;;8,0;;;;;27,0;;;;;;;;;;;;3,0;;;;3,0;;1,0;;;;;;;2,0;;;;;;;;;;;;;;;;;3,0;;;3,0;;1,0;;;;;;;;;;;;;;;
pixel;;;7,0;6,0;27,0;23,0;3,0;191,0;323,0;777,0;1366,0;;192,0;10,0;24,0;421,0;8,0;83,0;101,0;5,0;6,0;300,0;19,0;55,0;17,0;17,0;1771,0;173,0;;5,0;29,0;55,0;504,0;34,0;378,0;27,0;86,0;81,0;8,0;1,0;1252,0;7,0;47,0;111,0;252,0;214,0;506,0;847,0;222,0;106,0;183,0;325,0;3,0;347,0;324,0;151,0;460,0;20,0;100,0;;31,0;2,0;63,0;2,0;703,0;74,0;254,0;443,0;246,0;30,0;101,0;;407,0;33,0;9,0;549,0;74,0;9,0;28,0;3667,0;67,0;736,0;11,0;1738,0;23,0;9,0;;10,0;1,0;48,0;86,0;4,0;12,0;8,0;14,0;27,0;38,0;2,0;453,0;1,0;77,0;6,0;58,0;290,0;13,0;17,0;190,0;57,0;916,0;39,0;19,0;484,0;77,0;20,0;201,0;2526,0;419,0;394,0;70,0;269,0;3,0;;162,0;270,0;119,0;42,0;4,0;18,0;23,0;112,0;4,0;155,0;39,0;25,0;174,0;116,0;414,0;44,0;130,0;4,0;170,0;;12,0;849,0;59,0;6,0;;90,0;2782,0;155,0;63,0;10,0;70,0;203,0;105,0;114,0;344,0;;25,0;145,0;18,0;46,0;1501,0;3,0;17,0;;103,0;64,0;11,0;66,0;30,0;1,0;4,0;441,0;119,0;77,0;24,0;;;95,0;11,0;16,0;10,0;2,0;204,0;732,0;;235,0;52,0;;31,0;70,0;;171,0;80,0;22,0;4,0;4,0;1,0;38,0;18,0;10,0;338,0;446,0;27,0;;86,0;1,0;112,0;26,0;13,0;12,0;;30,0;;138,0;1,0;1,0;6,0;10,0;;115,0;4,0;;;1,0;106,0;;532,0;3,0;17,0;2,0;1,0;7,0;;11,0;16,0;11,0;23,0;1,0;52,0;8,0;13,0;32,0;56,0;79,0;447,0;9,0;;90,0;;7,0;;;;7,0;166,0;19,0;5,0;4,0;;;;476,0;77,0;1,0;32,0;18,0;118,0;;;128,0;70,0;32,0;5,0;;16,0;111,0;80,0;128,0;74,0;1,0;13,0;22,0;65,0;342,0;98,0;12,0;4,0;51,0;45,0;205,0;;26,0;4,0;2,0;46,0;;59,0;1,0;5,0;14,0;3,0;;;;11,0;236,0;9,0;33,0;1,0;10,0;45,0;;46,0;78,0;;;;33,0;;;1,0;;224,0;2,0;5,0;;5,0;8,0;;;;;;24,0;12,0;9,0;41,0;;;;;86,0;6,0;;;;27,0;78,0;25,0;3,0;;195,0;;;;97,0;3,0;43,0;2,0;38,0;;4,0;;;20,0;;;1,0;33,0;2,0;;16,0;7,0;;1,0;;15,0;1,0;;;14,0;;3,0;120,0;;;3,0;11,0;62,0;466,0;6,0;13,0;;50,0;;32,0;104,0;11,0;;;28,0;30,0;;;17,0;4,0;91,0;312,0;102,0;178,0;195,0;7,0;92,0;5,0;4,0;2,0;;1,0;7,0;16,0;89,0;51,0;;24,0;16,0;51,0;30,0;7,0;2,0;156,0;318,0;20,0;121,0;;63,0;55,0;96,0;18,0;25,0;54,0;36,0;;;23,0;268,0;3,0;16,0;141,0;20,0;37,0;;5,0;47,0;80,0;;29,0;;10,0;126,0;40,0;;7,0;;;;;128,0;9,0;12,0;1,0;3,0;61,0;16,0;2,0;101,0;2,0;126,0;1,0;29,0;34,0;6,0;131,0;117,0;86,0;7,0;85,0;13,0;71,0;19,0;3,0;3,0;34,0;13,0;5,0;2,0;;7,0;38,0;2,0;;;27,0;38,0;2,0;8,0;2,0;1217,0;3,0;30,0;23,0;;;9,0;;;;1,0;;4,0;13,0;1,0;20,0;3,0;7,0;;;;24,0;;90,0;17,0;9,0;18,0;;59,0;72,0;;53,0;2,0;;;88,0;;36,0;49,0;;;91,0;;;7,0;5,0;66,0;149,0;;;;1,0;2,0;32,0;402,0;90,0;7,0;;;2,0;;7,0;240,0;1,0;8,0;;1,0;4,0;;;11,0;4,0;;;;;8,0;47,0;;21,0;1,0;;1,0;;;3,0;;;;2,0;39,0;6,0;142,0;5,0;;;17,0;43,0;20,0;7,0;1,0;;;3,0;27,0;17,0;;;;3,0;;3,0;325,0;24,0;;1,0;;;668,0;24,0;;1,0;164,0;;11,0;36,0;;;162,0;;1,0;;72,0;1,0;;3,0;;2,0;7,0;;36,0;;;;6,0;;4,0;;7,0;8,0;;;15,0;22,0;56,0;9,0;474,0;1,0;3,0;24,0;;1,0;4,0;;;3,0;;;;2,0;;;;4,0;;;;221,0;1,0;11,0;16,0;;;8,0;2,0;2,0;;4,0;;66,0;2,0;;;;;5,0;;1,0;15,0;3,0;;;;;3,0;57,0;;;;;;;9,0;12,0;;;13,0;;9,0;130,0;8,0;10,0;48,0;59,0;22,0;9,0;2,0;;3,0;51,0;2,0;19,0;;3,0;1,0;13,0;;;4,0;4,0;;14,0;;;;2,0;;1,0;1,0;;224,0;93,0;39,0;40,0;40,0;146,0;62,0;2,0;21,0;537,0;3,0;;66,0;84,0;19,0;117,0;71,0;8,0;25,0;11,0;351,0;112,0;60,0;5,0;17,0;79,0;20,0;39,0;46,0;;132,0;44,0;8,0;20,0;228,0;12,0;5,0;24,0;9,0;8,0;47,0;2,0;160,0;19,0;14,0;10,0;;44,0;3,0;;153,0;1,0;5,0;177,0;;19,0;34,0;33,0;5,0;5,0;16,0;7,0;6,0;40,0;25,0;8,0;;14,0;1,0;;10,0;3,0;;154,0;20,0;10,0;34,0;2,0;1,0;;;;;11,0;4,0;;;;;7,0;;41,0;;;21,0;5,0;1,0;;2,0;;184,0;;;217,0;20,0;;1,0;8,0;34,0;29,0;1,0;21,0;21,0;7,0;12,0;;1,0;;;4,0;;;1,0;7,0;53,0;;31,0;1,0;;14,0;;;;123,0;;;;6,0;;2,0;5,0;;12,0;;22,0;6,0;113,0;;;;10,0;;5,0;;;;2,0;4,0;135,0;3,0;9,0;8,0;;17,0;;9,0;;27,0;;59,0;9,0;3,0;34,0;3,0;6,0;;2,0;;17,0;;;2,0;;;;;62,0;;13,0;;72,0;2,0;;47,0;3,0;49,0;1,0;;8,0;15,0;;30,0;3,0;59,0;8,0;54,0;25,0;6,0;6,0;;;1,0;;52,0;35,0;;3,0;62,0;38,0;3,0;;12,0;2,0;;4,0;7,0;;1,0;;18,0;;;49,0;;2,0;18,0;;2,0;;;;
quality;;;2,0;;6,0;23,0;;10,0;6,0;1,0;1,0;;;;;65,0;;1,0;;;;39,0;3,0;;;;6,0;4,0;1,0;;3,0;10,0;12,0;;17,0;3,0;4,0;;;;51,0;2,0;5,0;;10,0;2,0;48,0;25,0;30,0;20,0;;9,0;1,0;;;3,0;3,0;1,0;1,0;1,0;;5,0;5,0;;13,0;1,0;32,0;;14,0;;6,0;;18,0;;;10,0;7,0;;;553,0;;10,0;1,0;27,0;8,0;2,0;;;;;10,0;1,0;;;10,0;2,0;;;70,0;1,0;;4,0;38,0;4,0;;1,0;10,0;;14,0;39,0;;15,0;;;;27,0;2,0;5,0;3,0;26,0;2,0;;1,0;4,0;2,0;;3,0;;;3,0;;4,0;5,0;;6,0;13,0;2,0;3,0;4,0;3,0;21,0;2,0;;11,0;11,0;3,0;;;28,0;7,0;;;4,0;18,0;10,0;;25,0;;1,0;;3,0;1,0;16,0;;1,0;;91,0;14,0;1,0;;2,0;;;;;6,0;7,0;2,0;;;;;;;;3,0;;1,0;;;1,0;3,0;;;;;13,0;;;;;;13,0;;;;;;5,0;;;2,0;;;;;;;;;;;;;;;3,0;;1,0;;;;1,0;2,0;;;;;1,0;;;;;;;;;;19,0;1,0;;;;;;;5,0;2,0;;;;;;23,0;;1,0;1,0;;;;;;;;;;;;;;;;;;;4,0;;;;;1,0;;;;;;;;;;1,0;;;;;;;;;;;1,0;1,0;;1,0;;;;;;;;;;;;;;;;;;;;;;;;;;;;1,0;1,0;1,0;;;;1,0;2,0;;;;2,0;;;1,0;2,0;;8,0;;1,0;;;;;;;;1,0;;;;;;;;;;;;;;;;;;;;1,0;;;;;;3,0;;;3,0;;;;;;;;;;1,0;10,0;15,0;9,0;19,0;;6,0;;3,0;;;;1,0;1,0;3,0;2,0;;;13,0;;;4,0;;5,0;43,0;;6,0;;6,0;12,0;5,0;;3,0;4,0;;;;1,0;9,0;2,0;;3,0;;;;1,0;12,0;38,0;;1,0;;5,0;;;3,0;;;;6,0;2,0;23,0;2,0;;;;;22,0;4,0;;;;;12,0;1,0;1,0;;;6,0;5,0;;1,0;1,0;;;;;65,0;;;1,0;;6,0;;;1,0;2,0;45,0;;2,0;;;;;8,0;;;20,0;;;;;;;;;63,0;4,0;14,0;6,0;;;;;4,0;;;;;6,0;3,0;1,0;;;;;;;2,0;4,0;1,0;;2,0;;;2,0;;;;;;;;;;;7,0;;1,0;1,0;;;1,0;;;;;;;;4,0;;;15,0;;1,0;;1,0;;;;;;;;;;3,0;;;;;1,0;;;;;;7,0;;;;;;;;;1,0;;;;;1,0;;;;3,0;;;5,0;;;;;;;;1,0;2,0;;;;1,0;8,0;;;;;;;;;;;2,0;;;1,0;;;;;;;1,0;;;;;;14,0;;;;;;10,0;;;;;;;;;;;;3,0;;;;;;;;;;;;;;;;;;;;;;;;;;;;;;;;;;;;1,0;;;;;;2,0;;1,0;;;;;;1,0;;2,0;;;1,0;;1,0;;;;;;2,0;;;;;2,0;;;;;1,0;;;;;7,0;;;2,0;;;;;;3,0;;;;;;;1,0;;63,0;;;;5,0;;2,0;;;2,0;1,0;;;;;;;2,0;;1,0;;;1,0;9,0;;;;;3,0;;;;;;1,0;;;;;1,0;;8,0;36,0;;;;;;;;;;;;;;;;1,0;;;;2,0;;;;1,0;;;37,0;;11,0;;4,0;;;;1,0;;;;;;;;3,0;;;;;;;;;;1,0;;;;;;;;1,0;3,0;;4,0;;;;12,0;;;;;7,0;;;;;;2,0;1,0;16,0;;;;4,0;;;;;;;;;;;;;;;;;;;;1,0;;1,0;;;;;;;;;;;;;;;;;;;;;;;;;;;1,0;;;;;;;;;;;;;;1,0;;;3,0;;;;;;;10,0;;;;;;;;;;;;;;;;;;
radius;;;2,0;;;4,0;;3,0;11,0;1,0;3,0;;;;2,0;4,0;;24,0;;;;1,0;;;;;;1,0;;;1,0;52,0;1,0;;;;;3,0;;271,0;2,0;;3,0;3,0;;5,0;12,0;2,0;;2,0;1,0;11,0;;;;3,0;74,0;;2,0;;3,0;1,0;;;;;4,0;4,0;;;;;;;;;;;;99,0;;2,0;;33,0;2,0;1,0;;;1,0;9,0;171,0;;;2,0;;;;;3,0;;1,0;;3,0;80,0;;;1,0;;;;;;;;;;4,0;11,0;;3,0;;;;;1,0;;;;;8,0;;;;;20,0;;1,0;;;57,0;9,0;;;;;;;167,0;;2,0;;2,0;1,0;;;;8,0;;1,0;;1,0;;72,0;1,0;5,0;;;;;;5,0;;;;;;2,0;2,0;;;;9,0;;;;;;;;;;;2,0;;1,0;;;2,0;;3,0;3,0;;;8,0;;;;;;7,0;;6,0;;;6,0;;4,0;;1,0;2,0;1,0;;3,0;;;1,0;;;1,0;;2,0;;1,0;4,0;;;;3,0;;2,0;1,0;;;;;;;;34,0;4,0;4,0;;;;;;;4,0;;14,0;;;;;;;1,0;;;;;1,0;1,0;;;;;2,0;;106,0;;;;5,0;;9,0;1,0;;;;;1,0;3,0;;;;1,0;;;;1,0;;;;2,0;1,0;;;;;;;;3,0;4,0;1,0;;;3,0;;;;2,0;;3,0;;;;;;;;;;;;2,0;1,0;;;;;;;;;;;1,0;;;;;;;;;8,0;;2,0;;3,0;;;4,0;;;;;;2,0;;;;;;2,0;;;1,0;;;;3,0;;1,0;;;;2,0;;;;;;;;1,0;;1,0;;;;;;;;;;7,0;3,0;;2,0;;;;;;;;;;;;;;;;;;;;;2,0;;6,0;;;;;;;;;;;;;;;;5,0;;3,0;;;;;;;;;;;;;;;;;;;;;;;;;;;;;;11,0;;;;;;;;;;1,0;;;;;;;;;;;;;;;;;;;;;;;;;;;;;;;;;;;;;;;;;;;12,0;3,0;;;;;;1,0;;;;;;;;;;;;;;;;;;;;2,0;5,0;;;;;;1,0;;;;;;;;;;1,0;;;;;;;;;;;;;1,0;;;;;;;;;;;;;;;;;;;;;;;;;;1,0;;;;;;;;;;;;;;;;;;;;;;;;;;;;1,0;1,0;;;;;;;6,0;;;;6,0;;;;;;;;2,0;;1,0;;;;;;;;;;;;;1,0;;;;;;;;;;;;;;;;;;;;;;;;;2,0;;2,0;;;;;;2,0;;;;;;;;;;;;;;;;;;;;;;;;;;;;;;;;;;;;;;;;;;;;;;;;;;;;;;;;;;;;;;3,0;;;;;;;;;;;;;;;;;;;;;;;1,0;;;;;;;;;;;;12,0;;;;;;;;;;;;;;;;;;;;;;3,0;;;;;;;;;;;;;;2,0;;;;;1,0;;;;;;;;3,0;;;;;;;;;;;;;;;;;;;;1,0;;;;;;;;2,0;;;;;;;;;;;;;;;;;;;;;2,0;;;1,0;;;4,0;;;;;;;5,0;;;;;;2,0;;4,0;;;;;;;;;;;;;;;;;;;;1,0;;;;1,0;;;5,0;;;;;;;;;;;;;;;2,0;2,0;;;;;;;1,0;;;;;;;;;;;;;;;;;;
ratio;;;1,0;;;17,0;1,0;9,0;36,0;4,0;;;3,0;;7,0;46,0;8,0;;28,0;5,0;25,0;18,0;10,0;;;4,0;75,0;3,0;;4,0;2,0;1,0;6,0;35,0;16,0;6,0;3,0;11,0;;;37,0;3,0;17,0;8,0;33,0;10,0;51,0;31,0;20,0;28,0;;35,0;7,0;9,0;10,0;5,0;38,0;5,0;12,0;;;;13,0;1,0;;21,0;17,0;7,0;28,0;;14,0;;8,0;;;16,0;2,0;1,0;58,0;166,0;;4,0;1,0;26,0;10,0;2,0;;;;29,0;54,0;;;7,0;;1,0;5,0;;43,0;1,0;2,0;;26,0;27,0;;1,0;21,0;9,0;10,0;23,0;1,0;3,0;;;;43,0;35,0;21,0;8,0;33,0;;;5,0;17,0;6,0;3,0;;;1,0;24,0;;64,0;11,0;;34,0;3,0;7,0;11,0;1,0;4,0;9,0;;3,0;36,0;32,0;;;;72,0;27,0;;;1,0;11,0;3,0;1,0;24,0;5,0;2,0;8,0;1,0;1,0;72,0;10,0;1,0;;36,0;27,0;3,0;3,0;65,0;;;4,0;20,0;4,0;;1,0;;1,0;;;2,0;;3,0;15,0;1,0;36,0;;;3,0;16,0;;;2,0;;;;;;;1,0;22,0;7,0;;1,0;;8,0;7,0;8,0;4,0;;;;;8,0;;1,0;3,0;;5,0;;;;;;;;55,0;;3,0;;5,0;1,0;2,0;;6,0;1,0;;;4,0;;;2,0;;;;1,0;49,0;2,0;;;;;;8,0;7,0;;;11,0;;2,0;;25,0;;;9,0;;5,0;;1,0;58,0;2,0;;3,0;;;;;10,0;;;;11,0;1,0;31,0;6,0;;1,0;;7,0;15,0;1,0;;3,0;;12,0;;;;4,0;;;;;;;3,0;;;1,0;3,0;;;1,0;3,0;;;;5,0;;;3,0;;10,0;;;;1,0;;6,0;;;;;21,0;;;;;;;;;7,0;;;;;8,0;;;;5,0;5,0;;;14,0;;;;;;;;;;1,0;;3,0;2,0;;;;;;;;;;;;1,0;;;;;;1,0;;;12,0;;1,0;;3,0;;23,0;;;;;;7,0;;;;4,0;8,0;62,0;21,0;7,0;9,0;;8,0;7,0;;1,0;2,0;;;3,0;3,0;3,0;1,0;1,0;5,0;1,0;11,0;;;20,0;5,0;3,0;4,0;5,0;8,0;14,0;10,0;;2,0;19,0;8,0;;;3,0;3,0;;;3,0;1,0;;;6,0;10,0;8,0;4,0;1,0;;;;;;4,0;;;;;11,0;;;;;;11,0;;4,0;2,0;2,0;;40,0;;;3,0;;;12,0;;1,0;2,0;;;;;23,0;;;;2,0;;1,0;;1,0;4,0;5,0;2,0;;;2,0;;13,0;16,0;;;;;;3,0;20,0;30,0;3,0;;1,0;2,0;193,0;10,0;14,0;;3,0;;6,0;12,0;4,0;;;;29,0;2,0;;;2,0;;;4,0;8,0;3,0;;1,0;;;;;1,0;;;;;;;;;;4,0;11,0;1,0;1,0;2,0;;;;;;;;;1,0;;;2,0;;2,0;;;;9,0;3,0;;4,0;;;;;;;;;;;;;;;1,0;;;;;;;;;;;;;;;2,0;;1,0;;;;1,0;4,0;1,0;32,0;;;;;;;;;;;;;;1,0;;;;;9,0;;;2,0;;;;;;;;;;;;1,0;3,0;;3,0;5,0;;;1,0;;;;;3,0;;;;;;;4,0;;;;;;16,0;;1,0;;;1,0;;;;2,0;;;;;;;;;;;3,0;;;;;;;;1,0;;;;;;;2,0;3,0;;;;;;1,0;;;;;4,0;;7,0;;1,0;;;;1,0;;4,0;6,0;;;;;;;;;;;;5,0;;;3,0;2,0;1,0;3,0;;;2,0;;;;;;;;2,0;22,0;3,0;3,0;;;9,0;6,0;;1,0;;;;4,0;;;3,0;;1,0;;;;;;;;1,0;;2,0;21,0;2,0;13,0;3,0;;;;9,0;;55,0;42,0;;4,0;;7,0;;;4,0;;;;8,0;;;3,0;;;14,0;;;25,0;;;18,0;;;;;2,0;;;;2,0;1,0;;;;;;1,0;;1,0;4,0;2,0;;;;1,0;;2,0;;;;;4,0;;;;;;;;4,0;;;;;;;;;1,0;;;;;1,0;;;;;;;;;1,0;;3,0;;;;3,0;5,0;3,0;;;;;;;;;;;;2,0;;;2,0;;;;1,0;;;;;;;;2,0;1,0;;;;;1,0;;;;;;;;;;;1,0;;;6,0;3,0;1,0;;;;4,0;;;2,0;2,0;;;2,0;;2,0;;;;;;;;;;;;;;;;2,0;;;;;;;1,0;2,0;;;;;;;;;
read;;;1,0;;;1,0;3,0;58,0;36,0;24,0;31,0;;14,0;;4,0;63,0;2,0;;20,0;;;45,0;6,0;29,0;1,0;2,0;98,0;;;2,0;6,0;2,0;186,0;1,0;102,0;13,0;13,0;13,0;3,0;;184,0;;2,0;1,0;9,0;4,0;24,0;161,0;41,0;51,0;76,0;3,0;;18,0;292,0;2,0;68,0;;2,0;1,0;;;5,0;2,0;20,0;;3,0;35,0;88,0;2,0;30,0;;61,0;2,0;;19,0;;3,0;6,0;442,0;;108,0;;194,0;;2,0;;1,0;;5,0;7,0;;2,0;2,0;3,0;23,0;69,0;;83,0;9,0;;;27,0;14,0;2,0;13,0;20,0;5,0;180,0;31,0;;226,0;;;21,0;167,0;104,0;25,0;3,0;42,0;;;45,0;98,0;32,0;9,0;;5,0;1,0;1,0;5,0;39,0;3,0;;3,0;3,0;29,0;23,0;19,0;;1,0;;3,0;82,0;2,0;1,0;;10,0;1424,0;7,0;4,0;;24,0;42,0;63,0;11,0;60,0;;;121,0;1,0;12,0;523,0;;;;8,0;1,0;1,0;;1,0;;;37,0;16,0;9,0;;;;;3,0;2,0;1,0;;112,0;182,0;;13,0;3,0;;17,0;1,0;;47,0;;;;;;;;4,0;63,0;21,0;3,0;;20,0;;21,0;;3,0;5,0;;8,0;;1,0;;1,0;;;1,0;4,0;;;;;2,0;;44,0;;;;;4,0;;1,0;2,0;;;;8,0;2,0;1,0;27,0;43,0;42,0;42,0;3,0;1217,0;6,0;;;;;;;14,0;;;;;;;66,0;26,0;3,0;24,0;;79,0;;;12,0;;;;4,0;9,0;6,0;30,0;4,0;23,0;8,0;3,0;1,0;51,0;164,0;;;;;8,0;13,0;;;;;4,0;;;;1,0;11,0;;;;;4,0;9,0;;6,0;;1,0;2,0;;3,0;6,0;;;;25,0;;;;;88,0;;;;;1,0;;;;;;14,0;;4,0;26,0;;;;;12,0;;5,0;;;8,0;5,0;;;;13,0;;;2,0;3,0;2,0;1,0;;;;;;;15,0;;;;1,0;;;;;2,0;;;;1,0;;;;;;3,0;;;9,0;2,0;;12,0;;1,0;;;1,0;;;;;3,0;12,0;2,0;;;2,0;;13,0;20,0;24,0;20,0;25,0;1,0;1,0;12,0;;4,0;1,0;6,0;;1,0;12,0;8,0;4,0;;1,0;1,0;;;;26,0;22,0;14,0;4,0;;;3,0;304,0;3,0;3,0;;;;;7,0;208,0;;;140,0;10,0;;;28,0;9,0;51,0;1,0;;;3,0;31,0;10,0;2,0;111,0;1,0;;;2,0;;;;;;2,0;3,0;;5,0;;62,0;;5,0;1,0;;1,0;;70,0;;3,0;;1,0;;2,0;16,0;6,0;;;;;17,0;1,0;1,0;;;2,0;34,0;;;;;;3,0;9,0;;;2,0;;1,0;;;;;1,0;1,0;4,0;;;;;3,0;5,0;4,0;1,0;22,0;4,0;1,0;;2,0;15,0;;5,0;1,0;;;1,0;;7,0;2,0;;;24,0;;;6,0;;59,0;7,0;;;;;5,0;59,0;17,0;4,0;;5,0;;6,0;;2,0;32,0;;1,0;;;;;;;;2,0;;;;3,0;3,0;;;;;2,0;;3,0;;;;;2,0;;3,0;1,0;;1,0;;;15,0;1,0;;7,0;;;;6,0;;;;;;;;100,0;;;;1,0;;18,0;11,0;;;77,0;;;2,0;2,0;;9,0;;;;24,0;;;;;;;;;;8,0;;16,0;;1,0;;;;;;;12,0;;1,0;110,0;;;;;;;1,0;5,0;;;;;;;;;1,0;2,0;;;17,0;1,0;;;;;;;;;1,0;;47,0;7,0;;;;2,0;3,0;;;2,0;2,0;;;;6,0;;;;;;;2,0;;3,0;12,0;;;4,0;1,0;;9,0;;;;38,0;;1,0;;;;4,0;;1,0;;;1,0;8,0;;;;;;1,0;;;2,0;;;1,0;;;12,0;19,0;;4,0;8,0;83,0;2,0;1,0;;100,0;;;1,0;16,0;10,0;1,0;2,0;2,0;2,0;3,0;37,0;7,0;29,0;;1,0;;;1,0;12,0;;7,0;14,0;;;52,0;16,0;;;;1,0;3,0;;2,0;;;6,0;;2,0;1,0;;2,0;1,0;;13,0;;;;;1,0;;;;2,0;1,0;;;;;;;;;;8,0;;4,0;2,0;;;;;;;1,0;;1,0;;;;2,0;;19,0;;;2,0;;;;;;;;;;;;;2,0;;;;;;;;;;;;;1,0;;;;;1,0;;;;;;;;;;;;;;;7,0;;2,0;;;;;;;;3,0;;;;;;;;2,0;1,0;;;;;;9,0;;9,0;;20,0;;9,0;;;;;;;;;;;;;;;;;;;63,0;;;;;;;;;;;;1,0;;;;10,0;;;;;;;;;;;;;;;;6,0;;;;;;;1,0;;;3,0;;;2,0;;;;;1,0;
reduction;;;3,0;;;;;12,0;1,0;2,0;;;1,0;;;;;;;;4,0;4,0;1,0;2,0;;;15,0;;;;1,0;;7,0;;27,0;3,0;2,0;10,0;1,0;;22,0;1,0;;;9,0;4,0;10,0;54,0;4,0;1,0;;;2,0;2,0;6,0;;15,0;;;;;;1,0;;8,0;;2,0;2,0;4,0;;2,0;;8,0;;;2,0;;;;42,0;;5,0;2,0;4,0;;;;;;;10,0;;;;;2,0;1,0;;11,0;;;;3,0;;;;;;19,0;2,0;;20,0;;;;5,0;;35,0;2,0;3,0;2,0;;;46,0;5,0;3,0;;;;;;;;1,0;;;3,0;1,0;;;;;;6,0;9,0;;;6,0;14,0;10,0;;;;;;3,0;8,0;;1,0;3,0;;1,0;29,0;;;;;1,0;;;3,0;;;;1,0;5,0;1,0;2,0;;;;;;;4,0;20,0;;4,0;;;;1,0;;1,0;;;;;;;;;;3,0;1,0;4,0;;;1,0;;;;1,0;;;;;;;;;;2,0;;;;;;;;5,0;;;;;2,0;4,0;;;;;;;;;;;;33,0;;;;1,0;;;;3,0;;;;;;;3,0;;;;;2,0;;;2,0;2,0;;;3,0;1,0;;1,0;;2,0;;;1,0;;5,0;;;;;;;54,0;;;;1,0;;1,0;;;;1,0;;;;2,0;24,0;;;;;1,0;;;;;;;;;;;;10,0;;;;;;;;;;;5,0;;;;;;;4,0;1,0;2,0;7,0;;2,0;;4,0;;;;;;;;;;;;;2,0;;;;;;;;;;;;;;1,0;;1,0;;;;;;;;;;;;;18,0;;;;1,0;8,0;;;;;;;;;;;2,0;;2,0;2,0;;;;;;;;1,0;;;2,0;;4,0;;3,0;;1,0;;;;6,0;1,0;;;1,0;;1,0;;10,0;;3,0;;;;;1,0;;;;;;;;2,0;3,0;;;;;;;;;;;;;5,0;1,0;;;;;1,0;;;4,0;1,0;;5,0;;;2,0;;;;1,0;;1,0;;;;10,0;3,0;;;;;;38,0;;;;;;;;;;2,0;;;;;;;;;;;;;;;;1,0;;;;;;;;9,0;;;;;1,0;;;;;;1,0;7,0;;;;;;1,0;;;;;;;;;;;;;1,0;;;;2,0;;;;;;;;;;;;;;1,0;1,0;;;;;;;;;;;;;;;;;1,0;;;;;;;;;;;;;;;;;;;;;;;;;;;;;;;;;;;;;;;1,0;;;;;;;;;;;2,0;;;;;;;;;;;;;;;;;;;;;;;;;;;;;;;2,0;;;;;;;;;;4,0;;;;;;;;;;;;;;;2,0;;;;;;;;;;;;;;;;;;;;;;;4,0;;;;;;;;;;;;;;;;;;;;;;;;;2,0;;2,0;2,0;;;;1,0;;;;;3,0;;;;;;1,0;;;;;1,0;1,0;3,0;;;;;;;;;;;;1,0;;;;;1,0;;;;;5,0;;;2,0;;;;1,0;6,0;138,0;;1,0;;;;;;;;;;;;1,0;;;1,0;1,0;;;;;;;;;;;;7,0;1,0;;;1,0;;;;;;;;;3,0;;;;7,0;;;;;;;2,0;;;;;;;;;;9,0;;;;;;;;;;;;;;;;;;;;;;;;;;;2,0;;2,0;;;;;;;;;;;;;;;;;;;;;;;;;;;;;;;;;;;;;;;;;;;;;;;;;;;;;;;;;;;;;;;;;;;7,0;;;;;;1,0;;;;;;;;;;;;;1,0;;;;;;;;;
reflection;;;1,0;;4,0;1,0;5,0;7,0;6,0;6,0;5,0;;6,0;;24,0;15,0;20,0;;4,0;;1,0;5,0;;;;;6,0;;;1,0;;1,0;19,0;;9,0;1,0;;;6,0;1,0;1,0;;1,0;;6,0;5,0;16,0;66,0;6,0;11,0;22,0;6,0;2,0;;;9,0;44,0;;2,0;;3,0;4,0;6,0;;6,0;;2,0;30,0;10,0;8,0;26,0;41,0;1,0;;;19,0;4,0;6,0;21,0;98,0;;29,0;;29,0;;;;;;;57,0;;;;4,0;;;;11,0;;;;4,0;32,0;6,0;2,0;145,0;5,0;5,0;;4,0;1,0;2,0;;;11,0;11,0;30,0;6,0;2,0;3,0;67,0;;2,0;8,0;;10,0;;10,0;;;7,0;1,0;9,0;;;;3,0;1,0;;3,0;;;24,0;5,0;;;8,0;8,0;1,0;;;;1,0;3,0;3,0;49,0;;2,0;;;;65,0;;2,0;;19,0;2,0;2,0;4,0;2,0;;;2,0;;;;1,0;;;;3,0;;;1,0;;12,0;1,0;;;;4,0;2,0;;;;;;;1,0;;7,0;6,0;21,0;;;;;10,0;12,0;25,0;;;4,0;;;;;;;3,0;20,0;4,0;;;;1,0;;192,0;;144,0;;64,0;1,0;40,0;9,0;;;2,0;3,0;1,0;;1,0;30,0;1,0;;1,0;;1,0;2,0;10,0;4,0;;;;8,0;34,0;48,0;14,0;7,0;;;;1,0;;;1,0;;6,0;;2,0;28,0;7,0;;3,0;;1,0;1,0;;114,0;;;;;;3,0;26,0;;;;;1,0;;;3,0;1,0;;;;2,0;;;16,0;;;;;7,0;;;;2,0;;;2,0;4,0;;;;1,0;;;;;;;2,0;;;1,0;;;;;3,0;3,0;;4,0;;;;2,0;1,0;2,0;;;;;6,0;6,0;;;;;;9,0;;4,0;;;;;;2,0;;;;3,0;;;;;;;;;3,0;;3,0;;;;4,0;;;3,0;;;;;;9,0;1,0;;;12,0;;;;;;;;2,0;;;1,0;8,0;1,0;2,0;;;10,0;;;;;2,0;;;;;6,0;;2,0;;;1,0;;;;;;;8,0;;;;;;4,0;5,0;1,0;;;;3,0;;;3,0;4,0;;;;;4,0;;;;;9,0;;;;;;;;6,0;4,0;;;;;;1,0;;;;;;;;1,0;;;;1,0;;2,0;;;;6,0;;;;;;;;;;12,0;;;5,0;;;;;;;;;;;;;;;;;;;;;;;;;;4,0;;;;10,0;;;;2,0;;;;;3,0;3,0;;;2,0;;;;2,0;;;;;1,0;;;;;2,0;;;;;;;;;6,0;;;;;;;6,0;6,0;;;;2,0;5,0;;;;;;;;;;;;;;;15,0;;;;4,0;2,0;1,0;;;;;;;;;;1,0;;;;;;;1,0;;;13,0;;1,0;;;;;;;;;;2,0;;;1,0;;;;;;;;;6,0;;;;;;;;;;;;;;;;;4,0;;;;1,0;1,0;6,0;;11,0;;;;;;;;;;2,0;;;;;;;;;;4,0;;;1,0;;;;2,0;;;;;;;;;;;;;;;;;;;;;;;;;1,0;2,0;4,0;;;3,0;;9,0;;5,0;;;;;;;1,0;;;;;1,0;;;;;;;;;;4,0;;;;4,0;;;;;;;;;;;;;11,0;;;;6,0;;;;;;;;;;;;;;;;;;;;;;;;;;;;;;;;;;1,0;;;;;;;;;;;12,0;;;;;;10,0;4,0;;;;;;;;;14,0;1,0;;;;;;;;;;;;;;;;1,0;;;;;;;14,0;2,0;1,0;;;;;;;;;;;;;;;;;;2,0;;;;;1,0;;;;;;;;;;;3,0;;3,0;2,0;;;;;;;;4,0;;;8,0;;;;;;;;2,0;;;;;;;;1,0;;;;;;;;;;;;;2,0;;;;;;;;2,0;2,0;;;;;2,0;;;;;;1,0;;;;;;2,0;;;;;;;;;;;;;;;;;2,0;;;;;;;;;;;;;
remote;;;4,0;8,0;;;;24,0;1,0;5,0;;;7,0;;3,0;13,0;18,0;;;1,0;4,0;10,0;16,0;5,0;;;3,0;2,0;1,0;;93,0;;66,0;;578,0;53,0;;;5,0;;53,0;;6,0;7,0;10,0;4,0;10,0;691,0;43,0;152,0;3,0;7,0;;;;;4,0;1,0;11,0;5,0;;16,0;1,0;18,0;;;;;10,0;;8,0;6,0;10,0;;;14,0;6,0;1,0;2,0;121,0;;3,0;12,0;84,0;;43,0;;;;;9,0;;;;4,0;6,0;6,0;;108,0;54,0;3,0;;44,0;18,0;;8,0;7,0;3,0;38,0;5,0;1,0;21,0;;;;12,0;7,0;24,0;114,0;;;;1,0;9,0;14,0;33,0;;;2,0;;;3,0;2,0;;;3,0;12,0;33,0;;;;2,0;18,0;6,0;26,0;2,0;;5,0;200,0;;3,0;;17,0;5,0;5,0;1,0;181,0;;6,0;2,0;1,0;101,0;91,0;;;;78,0;32,0;;;7,0;;;;6,0;;12,0;;11,0;;;19,0;;;;1,0;;1,0;;;;;;24,0;;2,0;23,0;;;;;2,0;;1,0;;;1,0;;6,0;3,0;;;;;43,0;;;;1,0;;5,0;;;;1,0;;;;115,0;;3,0;;3,0;7,0;6,0;7,0;12,0;1,0;1,0;1,0;;;;;;;;2,0;;;;;;1,0;3,0;;153,0;4,0;;;;;2,0;35,0;;;;;2,0;;;33,0;4,0;;;1,0;;;;3,0;4,0;10,0;6,0;;;5,0;;1,0;2,0;;11,0;;;;2,0;1,0;;;1,0;;1,0;5,0;13,0;;;;;;;;;1,0;;;1,0;1,0;3,0;4,0;;36,0;;;;1,0;;;;;;1,0;;;;;;1,0;;;1,0;1,0;;;;6,0;5,0;5,0;;4,0;;2,0;;;;;;2,0;2,0;9,0;1,0;;1,0;2,0;;;;;;1,0;;;5,0;;;8,0;;;;;2,0;2,0;;;1,0;;;;;;;1,0;3,0;26,0;5,0;;;16,0;;;1,0;1,0;3,0;;9,0;4,0;;;;1,0;1,0;;44,0;13,0;2,0;1,0;10,0;;;2,0;2,0;;;4,0;7,0;6,0;2,0;;;11,0;;;;63,0;15,0;;53,0;;10,0;3,0;4,0;;4,0;12,0;3,0;;26,0;43,0;25,0;7,0;3,0;;10,0;;;8,0;;17,0;;;1,0;;4,0;3,0;;2,0;;;18,0;;1,0;1,0;;;3,0;1,0;144,0;;;;;;19,0;;1,0;;3,0;;;;;;;3,0;1,0;1,0;;4,0;7,0;5,0;23,0;;8,0;4,0;1,0;10,0;7,0;;1,0;;1,0;;3,0;11,0;;;16,0;1,0;;11,0;3,0;;16,0;13,0;7,0;5,0;;;;3,0;;6,0;1,0;1,0;3,0;8,0;;;14,0;1,0;;;1,0;;2,0;;5,0;4,0;4,0;10,0;;5,0;3,0;;;;4,0;1,0;2,0;;;2,0;2,0;;1,0;2,0;;27,0;19,0;64,0;15,0;;11,0;2,0;3,0;;;6,0;;3,0;2,0;;;1,0;;5,0;45,0;;;;2,0;14,0;6,0;6,0;;1,0;2,0;;14,0;2,0;;;9,0;3,0;2,0;8,0;;;;;;1,0;3,0;2,0;6,0;;3,0;;;2,0;4,0;2,0;3,0;1,0;;1,0;2,0;;2,0;;1,0;;;;;;100,0;3,0;2,0;;;27,0;;7,0;2,0;15,0;;;4,0;1,0;10,0;;1,0;47,0;;;1,0;;;;;;;;;;;;;;;;1,0;;1,0;;8,0;3,0;;;1,0;;;;3,0;;;;;7,0;;;;;;;5,0;7,0;;;;;;;73,0;;;;1,0;;;;;;;;1,0;;2,0;;;;;;;1,0;4,0;;;;1,0;1,0;;1,0;;3,0;20,0;1,0;;;;;7,0;;4,0;;;;;3,0;;;;;;;;;;;5,0;;;;;;2,0;1,0;;;;;;;1,0;1,0;;;;;;;6,0;13,0;;;;1,0;;;;;;;;3,0;;1,0;;;3,0;;;;;;;;18,0;;;1,0;;;;;;;3,0;;;;;;;;12,0;;;;;;;;;1,0;;20,0;5,0;2,0;;;;;1,0;;2,0;1,0;4,0;;;;;4,0;2,0;;2,0;1,0;9,0;1,0;3,0;;;;;;;;;11,0;1,0;;;;;;;;;;4,0;;;;;19,0;2,0;;;;1,0;;;;;;;;;2,0;;34,0;4,0;;;1,0;;;;8,0;1,0;;;;;;6,0;;;;;;4,0;1,0;;2,0;;;;;;;;;1,0;;;;;;;3,0;;;1,0;;;;1,0;;;8,0;;;;;;;;;;;;;;;;;;42,0;;;;;;;;;;;;;;1,0;;;;;;;;;;;;;;;;;;
repeat;;;6,0;11,0;2,0;4,0;;1,0;3,0;;;;;;1,0;7,0;;;;4,0;5,0;15,0;9,0;;;;37,0;;;;2,0;3,0;18,0;4,0;7,0;3,0;16,0;;1,0;;27,0;1,0;;7,0;12,0;9,0;25,0;13,0;1,0;3,0;;5,0;2,0;;2,0;5,0;5,0;;2,0;5,0;;1,0;;1,0;23,0;;16,0;2,0;15,0;;3,0;;9,0;5,0;3,0;3,0;2,0;2,0;1,0;95,0;;4,0;;9,0;3,0;1,0;;;;;7,0;;1,0;;6,0;1,0;3,0;;43,0;1,0;1,0;;8,0;2,0;;;3,0;;3,0;3,0;;16,0;;;;11,0;;16,0;1,0;6,0;;;20,0;17,0;10,0;4,0;1,0;;3,0;1,0;;;1,0;1,0;;2,0;2,0;1,0;8,0;6,0;11,0;;3,0;5,0;2,0;;;;13,0;1,0;2,0;;1,0;1,0;6,0;;10,0;;7,0;11,0;1,0;4,0;45,0;;;;10,0;9,0;;;;;;1,0;1,0;5,0;;;;;;1,0;;;;;;;1,0;;;1,0;;;;;;;;;;;13,0;3,0;;;;2,0;;1,0;;;2,0;1,0;;;;;;;1,0;;;;;;;;14,0;;;;;;;;7,0;;;;4,0;1,0;;;3,0;;;;39,0;1,0;;;;;;1,0;8,0;;;;1,0;;;8,0;;;1,0;;;;;1,0;3,0;;;;;;1,0;;;;;;;12,0;;2,0;2,0;;3,0;;;;;;;;;;;1,0;;;;;;;1,0;;;;;;;7,0;;;;;;;;;4,0;;;;;;;;;;;;;;;;;;;1,0;;;;2,0;;19,0;;;;3,0;;;;14,0;;1,0;;1,0;;;;;;;;;;1,0;;;;;;;2,0;1,0;;;;;;1,0;;;;;;5,0;10,0;;;1,0;;2,0;7,0;2,0;;;;;2,0;;;;1,0;5,0;4,0;10,0;6,0;1,0;2,0;;;1,0;2,0;2,0;;6,0;;1,0;3,0;;2,0;2,0;;;;8,0;6,0;;4,0;;2,0;3,0;4,0;;1,0;2,0;1,0;;1,0;;15,0;;;1,0;;;;2,0;2,0;;1,0;6,0;;;1,0;;;1,0;;;;;15,0;2,0;;1,0;;3,0;2,0;;1,0;1,0;;;12,0;1,0;5,0;2,0;;;;2,0;;3,0;;;;1,0;;;;1,0;;2,0;;;;6,0;3,0;;2,0;;1,0;;;;;;2,0;;;;9,0;;5,0;;;1,0;;;;;;;;1,0;5,0;;;;1,0;;2,0;3,0;;;;;2,0;2,0;4,0;;;5,0;;;;;;15,0;;;;;;;;2,0;;1,0;;;;;;;1,0;;;;;;;;;;;;;1,0;;;;1,0;;;;;;;;;;;;;;;;3,0;4,0;;;;;;;;;;;;;1,0;;;;;2,0;;13,0;;;5,0;;;;;;;1,0;;;;;2,0;3,0;;1,0;2,0;;;;;;;2,0;;;;;;;;;;1,0;;;2,0;;;;;;;1,0;;;;;;;;;;2,0;;;1,0;;1,0;;;;;;;;;;;;;;;;;;;8,0;;1,0;;;;21,0;;;;;;;;;;;;2,0;;;;;;;;;;;;;;;;;;;1,0;;;;;;;;;;;;;;;;1,0;;;;;2,0;;2,0;1,0;;;;1,0;1,0;;;;;;;5,0;;2,0;;2,0;2,0;;2,0;;;21,0;;3,0;;;1,0;;;;1,0;2,0;1,0;;2,0;3,0;;;;;1,0;;;1,0;;5,0;;;;;2,0;;;;1,0;;2,0;5,0;2,0;2,0;;;;5,0;;;;;;;;;;;;;5,0;;1,0;4,0;;;8,0;;;2,0;;;;;;;;;1,0;;;;;;;;;2,0;;;2,0;;;;;;;;2,0;;2,0;1,0;;;;;;2,0;;;;;;;;;;;1,0;;1,0;;;;;;1,0;;1,0;;;;2,0;;;;;;;;;1,0;;;;;;;;;;;;;;;;;;;2,0;;;;;;;1,0;;;;;;;;;8,0;;3,0;1,0;;;4,0;;;1,0;;;;;;;;;;;;2,0;;;;;;;;;1,0;1,0;;;;;;;;
representative;;;1,0;1,0;;1,0;;2,0;22,0;;4,0;;1,0;;;9,0;;;;;5,0;21,0;;;;;15,0;1,0;;;;;11,0;;1,0;3,0;1,0;;3,0;7,0;61,0;;6,0;3,0;12,0;;9,0;11,0;2,0;34,0;;17,0;;22,0;;1,0;3,0;;;;;;5,0;;;2,0;;7,0;11,0;;6,0;;25,0;;1,0;;3,0;;2,0;208,0;1,0;8,0;;43,0;;;;;;;11,0;;;;6,0;;2,0;;14,0;;;2,0;7,0;14,0;;5,0;10,0;;11,0;5,0;1,0;;;;;101,0;43,0;15,0;;8,0;;;2,0;4,0;3,0;;;;6,0;7,0;;4,0;;;5,0;3,0;10,0;1,0;11,0;;22,0;;4,0;2,0;2,0;;;;87,0;;2,0;;;3,0;1,0;;11,0;;1,0;5,0;1,0;2,0;9,0;;;;37,0;9,0;;2,0;;;;1,0;5,0;;;;;;;;;;1,0;;;43,0;;;;;;;;;6,0;;;1,0;;;10,0;4,0;;;;6,0;4,0;5,0;;;;;;;;;2,0;;1,0;;;;;;;;35,0;;;;;;;;;;;;;;;4,0;;;;11,0;5,0;;;;;;;7,0;9,0;1,0;;;;;;64,0;;;;;;;;5,0;2,0;;4,0;;1,0;2,0;;;;;1,0;;;9,0;2,0;;;;3,0;;3,0;;;;;1,0;;;;;;;;;;17,0;;;;;;;1,0;3,0;;;;;;;;;;;;;7,0;;;;;;;;;;;;;;;2,0;;;;;;;;;;;;;;7,0;1,0;;;2,0;;;;;;;;;;;;;;;;;;;;;2,0;;;1,0;;;;1,0;;9,0;;;;2,0;;;;;;;;;;;;4,0;;17,0;;5,0;;;4,0;;;1,0;;;;1,0;3,0;;1,0;;;37,0;2,0;;;20,0;11,0;1,0;4,0;;2,0;3,0;5,0;6,0;;10,0;2,0;1,0;;;1,0;;4,0;1,0;;;;;;14,0;3,0;2,0;;;;;;;;;;;;3,0;;;;2,0;11,0;;1,0;4,0;;;1,0;;;2,0;4,0;;;3,0;;;;;;1,0;6,0;;3,0;4,0;4,0;;;;;;3,0;;;;1,0;;;44,0;;;;;;;;;;;;2,0;1,0;1,0;3,0;;2,0;;;;;;;;;;;;;;;;;6,0;;;;;1,0;;3,0;;;;;;;;;;;6,0;;4,0;;2,0;;;1,0;;;;;;;;1,0;;;;;;2,0;;;;;;;;;2,0;;;;;;;;;;;;;2,0;;1,0;;;6,0;;;;;;;;3,0;;3,0;;;2,0;;6,0;1,0;;;;;;4,0;;;;;1,0;;;1,0;;;;;;;2,0;;;;;;;;;;;;;;;1,0;;;;;;;;;1,0;1,0;;;;;;;;3,0;;;;5,0;;;;;;1,0;;;;;;;;;;;;;;;4,0;;;;;;;;;;;;;;;;;;89,0;;;3,0;;2,0;;;8,0;;2,0;1,0;;1,0;;;;;;;;;;6,0;;;;;;;;;;;5,0;;;;;;3,0;;;;;2,0;;;2,0;4,0;;;;;;;;;;;;;;;;3,0;;;;;;;;;4,0;;12,0;;2,0;9,0;;8,0;;;26,0;;;;;;;;;;;;;;;;8,0;;;;1,0;;;10,0;;;;;;;;;;;;;;;;;;;;;;2,0;;;6,0;1,0;1,0;;;;;;;;2,0;;;;;8,0;;;;;30,0;;;;;;;3,0;;;;;;;1,0;;;;;;4,0;;2,0;;4,0;;;;;;;;1,0;;;1,0;;;;;2,0;;;;;;;;;;;;;;;;;;;;;;2,0;;;;;;;;3,0;;;;;;;;;;;;;;;;4,0;2,0;8,0;;;;;;;;;;;;;;;;2,0;;;2,0;;;;;;;3,0;;;;;;;;;
reset;;;1,0;;;;;16,0;10,0;8,0;9,0;;5,0;;;15,0;;;;;1,0;3,0;1,0;4,0;1,0;;;;;;1,0;;57,0;;99,0;5,0;1,0;5,0;;;2,0;;;1,0;1,0;3,0;4,0;39,0;15,0;2,0;13,0;2,0;;1,0;42,0;;98,0;;;;;;;;2,0;;6,0;2,0;2,0;6,0;37,0;;10,0;;;16,0;;1,0;;47,0;;40,0;;67,0;2,0;6,0;1,0;;;;5,0;;;;8,0;;8,0;;32,0;6,0;;;2,0;6,0;;2,0;1,0;;105,0;;;60,0;;2,0;3,0;43,0;31,0;16,0;11,0;38,0;1,0;;2,0;8,0;6,0;2,0;;;;2,0;;7,0;;2,0;1,0;;;16,0;7,0;;;;1,0;34,0;26,0;;;2,0;256,0;;;;2,0;7,0;;50,0;10,0;;;41,0;;6,0;87,0;;3,0;;;;;;;;;7,0;9,0;17,0;;;;;;;;;41,0;32,0;;7,0;;;;;;33,0;3,0;3,0;;;;;;;4,0;6,0;;1,0;26,0;;26,0;;1,0;;;33,0;;;;;;;;5,0;;;;;3,0;;6,0;;2,0;;1,0;;1,0;;;1,0;;1,0;4,0;;;3,0;5,0;11,0;17,0;;164,0;;;;;;;17,0;5,0;;;;;;;19,0;9,0;;1,0;;26,0;;;9,0;;;;;23,0;2,0;5,0;5,0;20,0;;14,0;;;83,0;;;;;;4,0;1,0;;;;1,0;;;;;;;;;;3,0;8,0;;;;;;;6,0;;;;;1,0;;;;;11,0;;;;;;;;;;;;2,0;;11,0;;;;1,0;2,0;2,0;;;;2,0;;;;;6,0;;;;1,0;;1,0;;;;;;;7,0;;1,0;;1,0;3,0;;;;;;;;;;;;;;18,0;;;;;;6,0;4,0;;;1,0;;2,0;;;;;10,0;2,0;;;;;;3,0;41,0;;5,0;;1,0;2,0;;2,0;;;;3,0;;2,0;;2,0;;2,0;;;;37,0;69,0;;1,0;;;3,0;2,0;2,0;;7,0;1,0;;2,0;;50,0;;1,0;23,0;;;;;;1,0;;;;;3,0;;;;;;2,0;;7,0;2,0;;;1,0;4,0;4,0;1,0;;;49,0;;4,0;;;1,0;3,0;17,0;;;;;8,0;;;24,0;;;;2,0;;2,0;8,0;;9,0;;;;;;77,0;;;;;;;25,0;;;;;;1,0;;3,0;;;;;;1,0;;;2,0;3,0;1,0;;;;;20,0;;;;;;4,0;;;;16,0;;;;;31,0;;;;;1,0;;16,0;2,0;1,0;;;;3,0;;;2,0;;1,0;;;;;;;;;;;;;;;;;;;;2,0;;3,0;;;;;;1,0;;;;;1,0;2,0;;;;;;;1,0;;;;;;;5,0;;;;;;39,0;67,0;;2,0;;;;;;;11,0;;;;19,0;;;;;1,0;;;;;;;11,0;;5,0;;;5,0;;;;1,0;;;37,0;;;;;;2,0;;;;;;;;;1,0;;;;;;3,0;;;3,0;;1,0;;;;;;;64,0;;;;;;;;;;;;;;;;;;;;;;;11,0;6,0;;;;;;10,0;;;2,0;;;;;;;2,0;;1,0;;1,0;;;;;;;;;;;;;;54,0;;;;17,0;22,0;22,0;16,0;9,0;;;;9,0;;;42,0;16,0;;;68,0;;6,0;;1,0;4,0;89,0;3,0;;1,0;;;8,0;;;2,0;;;301,0;72,0;;14,0;;;;;19,0;1,0;;;;;;;;2,0;2,0;19,0;;;;;;;;;;;2,0;;1,0;;;4,0;;;;1,0;;;;;;;;;;;;;;;;;;16,0;;;;;;;;;;;;;;;;;;;;;;;;;;;;;;1,0;;;;;;;;;;;;;;;;;;;;;;;4,0;;;;;;;;;;;;;;1,0;;;;1,0;;;;;;;5,0;;;;;;;;;;;;;;;;;;;;;;;;;;;;;;;;;1,0;;;;8,0;;;;;;;;;;;;;;;;;;;2,0;;;;;;;;;;;;;;;;
reverse;;;1,0;3,0;;2,0;;2,0;1,0;4,0;;;;;;3,0;;;1,0;;;3,0;;;;;3,0;;;;;6,0;2,0;;9,0;3,0;;;;;2,0;;;;13,0;6,0;4,0;6,0;;15,0;2,0;;;;27,0;;3,0;;;;;;7,0;;;4,0;;1,0;1,0;;;;;;;;;;;14,0;;5,0;1,0;3,0;;;;;;;3,0;;;;;;4,0;;5,0;;;;10,0;;1,0;;2,0;17,0;23,0;;;;;;;2,0;4,0;13,0;3,0;5,0;;;1,0;;1,0;;;;;3,0;;13,0;2,0;;;;4,0;1,0;;4,0;;;;1,0;;;;17,0;51,0;;;4,0;;;;1,0;5,0;1,0;2,0;;;;5,0;;;1,0;7,0;7,0;;;;;;;1,0;4,0;;;;;11,0;2,0;;;;2,0;;;;4,0;;;;;;2,0;;;;;;;;49,0;;;3,0;;;1,0;2,0;;4,0;;;;;;;;;;;;;;7,0;;2,0;;3,0;;;6,0;3,0;3,0;9,0;7,0;2,0;;;;;;;;2,0;;5,0;;;;;;;1,0;4,0;;;;;;;;3,0;;1,0;;;;;1,0;;;;2,0;4,0;2,0;;4,0;;;;;;12,0;;;;;62,0;;;;;4,0;;;;;;;;;;;;;;;;;;;;;;7,0;;;;;;;32,0;;3,0;;;1,0;;;;;;1,0;;;1,0;;;;;;2,0;;;15,0;;5,0;;;;;;;;2,0;;;;;;;;;1,0;1,0;;;;1,0;;1,0;;;;;2,0;9,0;4,0;;;1,0;;;;;;;;;;;;2,0;;;;;;;;;;;;;2,0;;3,0;;2,0;;;1,0;;;;;;;1,0;1,0;;;;;;3,0;;2,0;;;;;11,0;;26,0;2,0;1,0;2,0;5,0;;;6,0;4,0;;;2,0;;;;;;;;;;;4,0;;;;;;1,0;;;;;1,0;;;;;;;;;;;;;;9,0;;;;;;;;;;6,0;;;;;1,0;;;1,0;;;3,0;;;;;;;;;;;;;;;2,0;;;;;;;;;;;;;;;2,0;;;;;5,0;;;;1,0;;1,0;;1,0;;2,0;;;;;2,0;;;;;;2,0;;;;;;;;;;;;;;;;;;;;;;1,0;;;;;;;;;;;;;;;;;;;;;;;5,0;;;;;;;;;;;;;;;;;;;5,0;;;;;;;3,0;1,0;;;;;;;;;;;;;;;;;;;;1,0;;;;;;;;;;1,0;;;;;;2,0;;;;2,0;;;;;;;;;;2,0;;;;;;1,0;;;;;;;;;;;;;;;1,0;;;;;;;;1,0;;;;;;;;1,0;;;;3,0;;1,0;;;;;;;;;;;;;;;2,0;;;;1,0;;;;;;;;;;;;3,0;;;;;;;;;;3,0;;;;;1,0;;;;;3,0;1,0;;;;;;;;;;;;;1,0;1,0;;1,0;;;;;;;;;;;;;;;;;;;;;;;;;;;;;;;;;;;;;;;;;2,0;;;;;;2,0;;;;;;;10,0;;;;;;;;;;;;;;;;;;;;;;;;;;13,0;;;;;;;;;;4,0;;;;;;;;;;;;;;;;;2,0;;;;;;;;;;;;;;;1,0;;;;;;;1,0;;;18,0;;;;;;;;;;;;;;;;;;;;;;;;;;;;;;;;;;;;;;;;;;;1,0;;;;;;;1,0;;;;;;;1,0;;;;;;;;;;;;;;;
scale;;;1,0;;;7,0;;9,0;11,0;12,0;7,0;;6,0;;32,0;28,0;;;3,0;1,0;18,0;30,0;;;1,0;;21,0;1,0;;2,0;2,0;;27,0;;19,0;;4,0;13,0;;;35,0;1,0;7,0;1,0;4,0;5,0;49,0;21,0;15,0;52,0;;17,0;1,0;2,0;;10,0;5,0;6,0;6,0;1,0;1,0;;;;18,0;;;5,0;18,0;;9,0;1,0;37,0;;8,0;1,0;;;10,0;297,0;;3,0;;21,0;2,0;4,0;;;;7,0;2,0;;3,0;;20,0;6,0;;;54,0;16,0;9,0;1,0;23,0;2,0;;;3,0;;18,0;27,0;3,0;49,0;;;;20,0;10,0;16,0;;7,0;;;22,0;15,0;9,0;2,0;;1,0;2,0;15,0;;32,0;5,0;;9,0;7,0;7,0;2,0;18,0;;18,0;;;17,0;1,0;;;;37,0;41,0;1,0;;1,0;20,0;13,0;;20,0;;1,0;;4,0;2,0;31,0;;;;5,0;7,0;2,0;;13,0;;;;;17,0;1,0;;;;;1,0;;;;10,0;;5,0;;;10,0;;;;;;1,0;;;;;;2,0;10,0;;;;;2,0;;;;;;1,0;;;;;2,0;;2,0;;;2,0;;1,0;;1,0;2,0;;;;;1,0;5,0;2,0;;;1,0;;;;;5,0;;;1,0;30,0;;;;;;;;8,0;;;;;;;4,0;;;;;;;3,0;9,0;;;;;;;;3,0;;;;;;25,0;;;;;4,0;6,0;;3,0;;;;;;;;;1,0;;;;1,0;3,0;;3,0;;3,0;9,0;;;2,0;;;;;;;;;;;;;;;;;;;;9,0;;;;;;;1,0;;2,0;;;2,0;;14,0;;;;4,0;;;5,0;33,0;;11,0;2,0;4,0;;;;;;;;;;2,0;;;;;4,0;;2,0;30,0;;;;;;1,0;;;;4,0;;1,0;6,0;;;;;;;;;1,0;;2,0;;;;1,0;1,0;14,0;19,0;1,0;1,0;1,0;7,0;;2,0;;;2,0;;5,0;;;;;;29,0;1,0;;;7,0;19,0;;3,0;;3,0;3,0;;;2,0;16,0;;;;14,0;9,0;;;;2,0;;;;2,0;2,0;3,0;;;;;;;1,0;;;;;;;;;;;15,0;;15,0;;;;11,0;;2,0;4,0;5,0;;18,0;14,0;1,0;2,0;;;;5,0;114,0;1,0;;3,0;7,0;1,0;;;;2,0;11,0;;;;3,0;;;1,0;;;1,0;;2,0;;;;;;;7,0;;;2,0;;;;;2,0;;1,0;;;9,0;1,0;;4,0;;;;;12,0;36,0;13,0;;;;;;17,0;;;;;;;;;;;;;;;;2,0;;8,0;1,0;;;1,0;1,0;2,0;;;;1,0;;;;;;;1,0;2,0;4,0;1,0;;;;;;;;1,0;;;;;;;1,0;;;;;;;1,0;;;;;;;;17,0;;;;;;4,0;1,0;;;;;;1,0;;;;;;;;;;;;;8,0;1,0;2,0;;;;;;3,0;;;;;;;;;;3,0;;;;;;;;;;;;;;;;;;;;;5,0;;;;;;;;;;;;;;;;;;;;;3,0;1,0;1,0;;;;;;;;;;;;;2,0;;;;;;;4,0;;2,0;4,0;2,0;1,0;;;;;;;44,0;;;;;;;;3,0;;;;;;;1,0;;;3,0;;;;;2,0;;;;11,0;;;;;1,0;;;;;;23,0;2,0;;;;;;;;;;8,0;2,0;16,0;;;;;;;6,0;;;11,0;;;;;;;18,0;;3,0;1,0;;;;2,0;;;;;;;;2,0;;;;;1,0;2,0;;4,0;4,0;;;2,0;;;;;;;2,0;;2,0;4,0;1,0;;;;1,0;;1,0;8,0;;;;5,0;4,0;;;;3,0;;;6,0;;;;;2,0;;3,0;;;;;;;1,0;;;;;;;;4,0;;;;;1,0;;;;;2,0;9,0;;;;;;18,0;;;;;;;;;;1,0;;15,0;;;7,0;;;;1,0;;1,0;;;;;;4,0;5,0;;2,0;;;;;;;;;1,0;4,0;;15,0;;3,0;;;1,0;;;;;;;;;;2,0;;;;;;;;;;;;;1,0;;2,0;;;;;4,0;1,0;3,0;;9,0;;;;;;;;;;4,0;;;;
scan;;;6,0;;;17,0;4,0;41,0;41,0;8,0;25,0;;9,0;;7,0;31,0;13,0;1,0;;;2,0;48,0;;2,0;;;21,0;;;10,0;1,0;;33,0;;23,0;1,0;1,0;4,0;19,0;;47,0;;29,0;19,0;12,0;5,0;27,0;111,0;23,0;37,0;1,0;26,0;;3,0;9,0;2,0;41,0;;7,0;;;5,0;21,0;;;1,0;38,0;30,0;5,0;;10,0;1,0;11,0;;;4,0;8,0;21,0;23,0;294,0;3,0;27,0;2,0;37,0;;3,0;;;;;35,0;;;1,0;11,0;;8,0;;70,0;2,0;;5,0;13,0;57,0;1,0;13,0;16,0;7,0;64,0;4,0;1,0;51,0;;;;15,0;33,0;58,0;;17,0;;3,0;9,0;8,0;7,0;1,0;;;1,0;33,0;;17,0;1,0;;6,0;8,0;16,0;6,0;;2,0;36,0;;1,0;37,0;4,0;;;4,0;26,0;;1,0;;1,0;5,0;12,0;;118,0;;20,0;5,0;2,0;;115,0;;;;8,0;10,0;;3,0;2,0;;;;8,0;3,0;23,0;;;;;6,0;;;4,0;25,0;;;;;;;;6,0;;;1,0;;;2,0;7,0;;8,0;76,0;;;1,0;;9,0;6,0;;;;;;;;;1,0;;;2,0;;;;7,0;;;32,0;;;;15,0;;;24,0;6,0;2,0;;3,0;1,0;;;4,0;29,0;;4,0;5,0;46,0;22,0;;;;;;;10,0;2,0;3,0;;;;2,0;33,0;;4,0;2,0;;14,0;;;27,0;3,0;;;;14,0;5,0;;33,0;1,0;;;1,0;;10,0;1,0;;2,0;;17,0;12,0;1,0;;;;;;;;;6,0;;;;;;;;;;;;;1,0;1,0;;16,0;;10,0;;;;;6,0;;;;3,0;;;;;;;1,0;;3,0;2,0;1,0;;;;;;2,0;;;4,0;27,0;;1,0;;2,0;;;;5,0;;1,0;4,0;5,0;;;;;;;;;;;;8,0;;;1,0;;4,0;;;;;;1,0;5,0;;;;2,0;;30,0;10,0;;;;;4,0;8,0;6,0;;;;5,0;2,0;;;2,0;;3,0;10,0;5,0;1,0;6,0;2,0;;6,0;25,0;2,0;2,0;;;1,0;;;;1,0;1,0;;;1,0;22,0;1,0;27,0;2,0;;;12,0;34,0;;9,0;7,0;12,0;;;2,0;12,0;;1,0;12,0;;;;;1,0;5,0;;;;;7,0;;;5,0;;;;5,0;5,0;3,0;;2,0;5,0;4,0;11,0;;5,0;10,0;;;6,0;10,0;11,0;;6,0;;2,0;;5,0;11,0;2,0;;4,0;;;;;9,0;2,0;1,0;12,0;;;2,0;7,0;1,0;;;12,0;;;17,0;10,0;;;;;;;;1,0;2,0;;8,0;6,0;;;;3,0;;;;5,0;;;;12,0;;;;;;;;;16,0;;4,0;;7,0;;;;;1,0;2,0;;;;;7,0;1,0;;;;3,0;;;;;8,0;;;;;;;5,0;;;1,0;;;;2,0;;;1,0;;;8,0;;;;1,0;;;10,0;;;1,0;;;;;3,0;;;;;2,0;1,0;;;;;10,0;1,0;;1,0;3,0;;;4,0;;1,0;17,0;4,0;5,0;;8,0;;;2,0;;;;;1,0;;;1,0;;3,0;1,0;;;;1,0;;;;;;;;;;;;;;;;26,0;;;2,0;;;1,0;;;;3,0;;;;;;;;;;;17,0;;;6,0;;;;1,0;;;;;;8,0;;;;;4,0;;;;;;;9,0;;;;;36,0;;;;;;1,0;;;;;;;;;;1,0;2,0;35,0;4,0;2,0;;1,0;;;;;;10,0;;;2,0;;;;;1,0;16,0;;;;;;;2,0;;;;;;7,0;;11,0;;;;;7,0;9,0;;;;;4,0;;;5,0;;;;2,0;;4,0;;46,0;;;;;;;;;;;;;;2,0;;;3,0;;1,0;1,0;;;;;;;;;;;;;;2,0;;;;;;;2,0;;;;;;;;;;;;;11,0;;;;1,0;;;7,0;;;;;5,0;;;10,0;67,0;;;;5,0;;4,0;;;;;2,0;;1,0;;;;;;;;;;;;;;;1,0;;;;;;;2,0;;;;;;3,0;;2,0;;5,0;;;;;;;;;;19,0;;1,0;1,0;;5,0;;;;;;8,0;2,0;;;;;;3,0;;;;3,0;;;;;;;2,0;;;;;;;;;3,0;;6,0;;;;;;4,0;;2,0;;;;;4,0;;;;4,0;;;1,0;;;;;;;;;;;;10,0;;;;;;1,0;;;6,0;7,0;;;
sensitive;;;1,0;;;;;2,0;14,0;5,0;3,0;;2,0;;3,0;4,0;2,0;;;;;6,0;;;;;25,0;;;;;;14,0;;4,0;6,0;;;9,0;;;;6,0;;5,0;1,0;1,0;24,0;27,0;44,0;1,0;1,0;;;;;6,0;;;;1,0;;;;;;4,0;3,0;2,0;;5,0;;5,0;;;6,0;;1,0;;111,0;1,0;22,0;;28,0;;;;;;;11,0;;;6,0;;;2,0;;11,0;1,0;;;2,0;;2,0;4,0;4,0;;5,0;;;;;;;26,0;1,0;5,0;1,0;;;;;1,0;7,0;;;;5,0;2,0;;;2,0;2,0;;;2,0;;3,0;;1,0;;;38,0;;;;;9,0;;;;;1,0;;;43,0;;;1,0;;1,0;13,0;;;;;2,0;5,0;7,0;;;;;1,0;2,0;1,0;;;;;;2,0;;7,0;5,0;;;;;;;;5,0;;4,0;2,0;1,0;;1,0;;1,0;2,0;50,0;;;;;6,0;3,0;;;;2,0;;;;;1,0;2,0;5,0;;;;;;1,0;;122,0;;;;;1,0;;;2,0;1,0;2,0;;;;;;2,0;;;;40,0;5,0;;;;;3,0;4,0;14,0;;;;;;;10,0;;;;;7,0;;;1,0;;;2,0;;;;6,0;37,0;6,0;;;;;;;128,0;;2,0;1,0;;;;;;17,0;;;;;;;;;;;;;;;;2,0;;;;;;;2,0;;1,0;;;;;;;;;;;;;;;;;;;;;;3,0;;5,0;;;;5,0;;;;1,0;;;;;;;;;;;;;;;;;;;;;;;;;;;;;;;;;;;;4,0;14,0;;;;;;;;;;36,0;40,0;1,0;1,0;;;;;2,0;;;;;;;;;2,0;;;;;24,0;;;2,0;;1,0;;;;8,0;1,0;;12,0;;;1,0;;;2,0;1,0;;;3,0;;4,0;1,0;2,0;2,0;;;;;;19,0;3,0;;;;5,0;;;;;;;2,0;;3,0;;;;1,0;47,0;1,0;;;;;4,0;6,0;;;;;1,0;;;2,0;;;;;2,0;;;;54,0;;;8,0;5,0;;6,0;;;;10,0;;;96,0;;11,0;;;;;;;1,0;2,0;;;1,0;;;;;;;;;;;;;;1,0;;;;1,0;3,0;;;;;;9,0;;;4,0;1,0;;1,0;;;;4,0;;;;;;2,0;;;;;3,0;;;;3,0;1,0;1,0;2,0;;;;;;;;;;;;1,0;;;;;;;1,0;;;;;;2,0;;;;;1,0;;;;;;;;;;;;;;;;4,0;;;83,0;;4,0;;;;;;;1,0;;;;;;;;;;;;;;6,0;;3,0;;;;;;;2,0;;;;;;;;;;;;;;;;;;;;;;;7,0;;;;;;;;4,0;;;1,0;;;;;;5,0;;;;8,0;;;;;;;;;;;2,0;;;;;;;;;;;;;3,0;;;;;;2,0;;2,0;;;;1,0;;2,0;;;2,0;;;;;;;;;;;;;2,0;;;1,0;;;;;2,0;;;;;;;;;;;;;;;4,0;;;;;;;;;2,0;12,0;4,0;;;;;;;;1,0;;;1,0;;;;;;;;;;;;;;;;;;;;;;2,0;;;;;;;;9,0;;;;;;;;;;;;;;;;;;;;1,0;;;;;;;;;;;;;;;;;;;;;;;5,0;;2,0;;;1,0;;4,0;;;;;;;;;;;;;;;;;;;3,0;;;;;;;4,0;;;;;;;;;;1,0;;;;;;;;2,0;;;;;;;;3,0;;;;;;1,0;;;;;;;;;;;;4,0;;;;;;;;;;;;3,0;;;;;;;;;;;;;;2,0;;;;;;;;;;;;;;;;;;;1,0;;;
sensitivity;;;5,0;;6,0;;17,0;2,0;3,0;19,0;16,0;;2,0;;;13,0;;;20,0;;5,0;18,0;3,0;6,0;;9,0;74,0;1,0;;5,0;;7,0;33,0;2,0;23,0;1,0;4,0;13,0;;;18,0;12,0;2,0;;4,0;6,0;43,0;18,0;9,0;9,0;;;;16,0;2,0;;46,0;3,0;17,0;;1,0;;11,0;;16,0;;8,0;2,0;5,0;;60,0;3,0;31,0;;;;1,0;;1,0;48,0;1,0;68,0;;16,0;28,0;;;4,0;;;3,0;;;;4,0;;6,0;;40,0;9,0;;;1,0;;;;12,0;;10,0;7,0;;9,0;;;1,0;16,0;5,0;;;23,0;;;2,0;10,0;1,0;13,0;;11,0;3,0;33,0;28,0;41,0;3,0;;8,0;8,0;9,0;2,0;;2,0;1,0;;;11,0;39,0;;;;52,0;1,0;;;4,0;9,0;17,0;;10,0;;;1,0;;1,0;105,0;4,0;;;2,0;8,0;16,0;29,0;;;;11,0;17,0;1,0;;;;7,0;;;;;5,0;1,0;;16,0;;;;;;;;;;;;;;1,0;20,0;3,0;;;1,0;2,0;46,0;;;;;;;16,0;;;;;;1,0;;;;;;;66,0;;;;;;;;;;;;;;;;;;39,0;;132,0;;;;;;;;4,0;;;;;;;8,0;1,0;;1,0;;4,0;;;2,0;;;;;;;1,0;1,0;5,0;;6,0;;;35,0;;;;;;2,0;;;;;1,0;;;;4,0;;;;;;;5,0;;;;2,0;;;;2,0;;;;;;;;;;;;;;;;;;;;19,0;;;;;;;;;24,0;;;;;;;;1,0;2,0;;;;41,0;;1,0;;;;;;;;;;;5,0;;;;5,0;;;;;;;;;;;;;;;;;3,0;;;;;;9,0;;;;;;1,0;;;;;19,0;33,0;60,0;;1,0;;;;;;;;;;12,0;4,0;;4,0;;;2,0;;;7,0;58,0;6,0;;;;4,0;15,0;;;1,0;1,0;;;3,0;6,0;;;;11,0;;;7,0;;5,0;;3,0;;10,0;;2,0;;10,0;;;;;7,0;1,0;;;6,0;1,0;;;;;1,0;;32,0;;;;;;;2,0;;;;;;;2,0;;2,0;;;;;;;2,0;3,0;;;;7,0;;;;;;;;;;;;;;;;;;;;;;;1,0;;;;;5,0;1,0;;1,0;;;;;;8,0;3,0;;;;;;10,0;;6,0;;;;;;;;18,0;56,0;;1,0;;;;;17,0;;;;;;;;;;;;;;6,0;10,0;;;;;;;;;;;;;;;;;;;;;1,0;;;;;;;;;;;;;;1,0;;;;;;29,0;;;;;;;;;;;;;;2,0;4,0;;;;;;;;;;41,0;;;;;;;;;;3,0;;;41,0;;;3,0;;;;;7,0;1,0;;;;;;;;;;;;2,0;;;;;;;;;;;1,0;;;;;;;;;;1,0;30,0;;;;;;6,0;;;;;;;4,0;;;;;;;;;;13,0;;;;6,0;;;;;;;;;;;;;;;;;;;;;;;;;2,0;3,0;;;1,0;2,0;2,0;;;;;;1,0;;;;;;;4,0;8,0;;14,0;;;;;;;;;3,0;;;;;;;;1,0;;3,0;2,0;6,0;6,0;;1,0;;;1,0;;2,0;;;;;;;;1,0;;;;4,0;;;;;;;;;19,0;;;;;;;;;;;;;;;;;;;;;;;;;;1,0;;;;;;;;;;;;;;7,0;;;;;;;;;;;22,0;;;1,0;;;;5,0;;;;;;;;;6,0;;;;;;;;;;4,0;;;;;;;;;;1,0;;;;;1,0;;;;;5,0;;9,0;;;;;;;;;;;;;;24,0;;;;6,0;;;1,0;;;;;;1,0;;;;9,0;;70,0;;;4,0;;;;;;;;;;;;;1,0;;;;;;;;;;;;;;1,0;;;;;;
separation;;;2,0;;;2,0;;10,0;;2,0;2,0;;3,0;;7,0;8,0;19,0;;;;;;;;;;69,0;;;;;;4,0;;1,0;3,0;;3,0;;;1,0;;1,0;;13,0;6,0;1,0;9,0;;5,0;;35,0;;6,0;;;34,0;;;;;;;;16,0;6,0;5,0;11,0;;2,0;;1,0;2,0;8,0;;7,0;;;2,0;44,0;2,0;4,0;;20,0;2,0;;;;;;22,0;;;;1,0;;1,0;;4,0;;;;7,0;9,0;;8,0;;;2,0;15,0;2,0;5,0;;;;4,0;17,0;9,0;;1,0;12,0;1,0;;3,0;9,0;;;;;;;;;;;1,0;4,0;;;;5,0;;;3,0;;;;2,0;2,0;;2,0;;2,0;;;;4,0;;;;;1,0;65,0;1,0;;;2,0;4,0;;1,0;;;;2,0;;;5,0;2,0;;;1,0;;;;16,0;2,0;;41,0;;;;;;9,0;;1,0;;;;;;;;6,0;;;;;;;;;;2,0;2,0;;;;;7,0;1,0;;;;;;15,0;;21,0;;2,0;;;;;;;6,0;;1,0;;;;;;1,0;;;16,0;3,0;10,0;4,0;;;;8,0;3,0;;;;;;1,0;8,0;;;1,0;;2,0;;;1,0;2,0;;;2,0;2,0;3,0;1,0;2,0;;;1,0;;;10,0;;;;;;2,0;;;;;;;;;1,0;4,0;;;;;;4,0;;;;;;1,0;1,0;;;3,0;;1,0;;;;1,0;;;;;;;;;;;;;;;;;;;;;;;;;;;;;;1,0;;;;1,0;;;;2,0;;1,0;;;;2,0;;;;;;;;;;;;;;;5,0;;;;;;;;;;;;;4,0;;2,0;;;;;;;;;1,0;4,0;;7,0;2,0;;;;;;;;;;;;6,0;;;;;;;;;4,0;;7,0;;;;;;;;7,0;2,0;;;;;;2,0;;;;;;;;;;;;;;;;;;;;;;;;;;;2,0;;;;;1,0;;;;;;;;;;;;;;;;1,0;;;;;;;;;;4,0;;;;;;;;;;;;;;;;4,0;;2,0;;;4,0;;;;;;7,0;;;;1,0;;;;;;;;;4,0;;;1,0;1,0;;;;;;;;;;;;16,0;1,0;;1,0;1,0;;;;3,0;;;;;;;;;;;;3,0;;3,0;;;;;;;;;;1,0;1,0;;;;;5,0;;;;;;;;;;;;;;;;;2,0;;;;;;;;;5,0;;;;;;;57,0;;;3,0;;;;;;;;;;;;;;;;;;;;;;;;;;;;;;;2,0;;;;;;;;;;;;;;;8,0;;;;;;;;;;;;;;;;1,0;;;;;;;;;;;;;;;;;;;;;;;;;;;;5,0;;;;;;;1,0;;;;1,0;;;;;;;;3,0;;;;;;;;1,0;;;;;;;;;;;;;;;;;;2,0;;;;;;;;1,0;;;;;;2,0;;;1,0;;;;;;;;;;;;;;;;;;1,0;;1,0;2,0;;;;;;;;;;;3,0;;;;;;;;;;;;;;;1,0;;;;;;1,0;;;;;;;;;;;;;;;;;;;;;;;;;;;;;;;;;;;;;;;;;;;;;;;;;;;;;;;;;;;;;;;2,0;;;;;;;;;;;;;;;;;;;;;;;;;;;18,0;;;;;;;;;;;;;;;;;1,0;2,0;;1,0;;;;;;;;;;;;6,0;;;4,0;;;;;;;;;;;;;;;;;;;;;;;;;;;;;;;;;
sequence;;;1,0;1,0;34,0;4,0;;10,0;14,0;24,0;6,0;;8,0;;23,0;65,0;;;;2,0;9,0;248,0;7,0;;4,0;;24,0;;;;12,0;6,0;45,0;;28,0;11,0;3,0;1,0;1,0;;94,0;;19,0;11,0;16,0;31,0;117,0;87,0;241,0;84,0;2,0;3,0;2,0;4,0;;3,0;8,0;2,0;14,0;3,0;;5,0;15,0;6,0;20,0;2,0;2,0;63,0;377,0;;9,0;;66,0;;;17,0;29,0;1,0;21,0;898,0;2,0;12,0;12,0;125,0;3,0;20,0;;;;;23,0;2,0;2,0;;25,0;17,0;16,0;3,0;199,0;5,0;14,0;15,0;9,0;86,0;1,0;6,0;9,0;43,0;65,0;8,0;;35,0;;;6,0;63,0;80,0;36,0;6,0;28,0;;;9,0;42,0;29,0;10,0;2,0;;;9,0;;10,0;5,0;1,0;21,0;6,0;20,0;18,0;;4,0;29,0;;3,0;48,0;11,0;;;14,0;29,0;;7,0;5,0;14,0;44,0;1,0;;82,0;;;8,0;12,0;2,0;23,0;;2,0;;516,0;22,0;6,0;;;;;1,0;;15,0;7,0;;;;;5,0;;;;4,0;;1,0;1,0;;2,0;3,0;;7,0;5,0;2,0;8,0;;;;;;19,0;20,0;;;;2,0;42,0;9,0;8,0;;;;4,0;;1,0;;;;;;;6,0;;1,0;9,0;;34,0;;1,0;;;2,0;;7,0;28,0;;;;8,0;;;7,0;5,0;;;7,0;44,0;2,0;;;5,0;;;2,0;50,0;;;;2,0;;;51,0;4,0;4,0;3,0;;7,0;;1,0;18,0;;;4,0;1,0;9,0;6,0;2,0;;2,0;3,0;3,0;;;61,0;5,0;1,0;;;14,0;;;;;;;;;;15,0;;;;2,0;;;;1,0;2,0;;;5,0;;9,0;2,0;;6,0;;16,0;;;;;4,0;;;;;1,0;;;;;;8,0;;;3,0;;;;6,0;12,0;1,0;9,0;;5,0;;49,0;;;;;;;3,0;33,0;6,0;1,0;;4,0;;;;;2,0;;;;;;;1,0;;;1,0;;6,0;24,0;4,0;;8,0;;;13,0;;;;;2,0;5,0;59,0;2,0;2,0;3,0;;1,0;2,0;4,0;;;;4,0;;;1,0;13,0;1,0;5,0;7,0;15,0;17,0;19,0;6,0;;4,0;6,0;3,0;1,0;2,0;3,0;5,0;1,0;10,0;;1,0;13,0;5,0;9,0;;76,0;7,0;1,0;19,0;;16,0;8,0;14,0;5,0;6,0;58,0;23,0;;2,0;19,0;20,0;1,0;;10,0;;;;;7,0;78,0;;1,0;;1,0;;12,0;;;1,0;;1,0;;4,0;26,0;1,0;;7,0;2,0;32,0;3,0;18,0;7,0;;;7,0;;7,0;3,0;3,0;;11,0;2,0;2,0;18,0;;7,0;11,0;10,0;;;;2,0;6,0;;3,0;;1,0;;32,0;;;;14,0;;8,0;3,0;;;5,0;2,0;;;;;4,0;6,0;;4,0;;4,0;18,0;;;3,0;2,0;3,0;;;;;22,0;;23,0;1,0;2,0;1,0;;3,0;5,0;22,0;;4,0;;10,0;3,0;6,0;6,0;4,0;;2,0;;;;5,0;;2,0;1,0;;;18,0;;8,0;1,0;;9,0;;2,0;;10,0;2,0;;;;;20,0;;58,0;;4,0;;;24,0;3,0;;2,0;;;;;;;;;;5,0;;30,0;2,0;5,0;9,0;1,0;;;;;9,0;;;;;;4,0;;9,0;;5,0;;3,0;6,0;;20,0;;;5,0;2,0;;1,0;10,0;;;1,0;;;;2,0;3,0;6,0;2,0;3,0;15,0;5,0;;3,0;;;3,0;2,0;;;;;;;;;4,0;1,0;4,0;;;;1,0;;;;;3,0;4,0;;;;;;;;;2,0;;;;;4,0;;;;;;;;;;;;;;;1,0;1,0;;;8,0;;;;;;94,0;1,0;;;;;;;;;;;24,0;;;;;;;2,0;7,0;;9,0;;;12,0;;;1,0;;;4,0;1,0;;;;10,0;;;;2,0;;;;;;7,0;11,0;;;;;30,0;;3,0;2,0;;;;2,0;;24,0;;1,0;;;27,0;1,0;;2,0;;;;21,0;46,0;4,0;;;2,0;6,0;;;;;;26,0;;;5,0;7,0;1,0;;;5,0;;;;7,0;1,0;;;;;;3,0;;;;1,0;2,0;7,0;8,0;5,0;;;3,0;;;;3,0;;;;1,0;;;;;;1,0;4,0;;4,0;;;3,0;2,0;;9,0;;;1,0;;1,0;1,0;3,0;2,0;;;;1,0;;;11,0;;;3,0;;;;;;;;;;;6,0;;;;3,0;;;;19,0;9,0;;4,0;7,0;1,0;;;;;;2,0;;;2,0;1,0;;14,0;;;;2,0;;;;;;;;;;;;;;;;;8,0;;;;;;;1,0;;1,0;;;;;;;;;;;;;;;;;1,0;;;2,0;;;;;;;;;;;;19,0;;;4,0;;;;;;1,0;;2,0;;;1,0;21,0;;;;;;;;;;;;;;;;;;
server;;;7,0;;4,0;1,0;;19,0;1,0;3,0;;;21,0;;1,0;22,0;;;;2,0;;33,0;;4,0;;;;1,0;5,0;;92,0;1,0;42,0;;73,0;7,0;;1,0;4,0;;121,0;;6,0;;8,0;3,0;24,0;107,0;10,0;16,0;;;1,0;;;2,0;2,0;;;4,0;;3,0;;3,0;1,0;3,0;2,0;;2,0;;23,0;;25,0;;;1,0;15,0;;;141,0;;23,0;;53,0;;9,0;;;;1,0;1,0;5,0;1,0;2,0;7,0;6,0;6,0;;58,0;16,0;;8,0;10,0;9,0;;12,0;;4,0;6,0;;;20,0;;;;22,0;4,0;23,0;;6,0;1,0;;25,0;49,0;24,0;2,0;;;;;;3,0;;;1,0;3,0;2,0;23,0;;;1,0;1,0;20,0;;5,0;;;;10,0;2,0;2,0;;14,0;24,0;;2,0;91,0;;1,0;9,0;5,0;36,0;22,0;;;;85,0;2,0;;;1,0;;;;;;;;;;;;;;;;;2,0;;;2,0;;;10,0;;1,0;6,0;;;;;;3,0;1,0;;;;;;;;;;;;;;;1,0;;2,0;;;;;;;;;;1,0;;;;;;;;;;;;;2,0;;;;;;;3,0;;1,0;;;;127,0;;;;;;;10,0;;1,0;;;;;;4,0;;;;;;;;;;;3,0;;;16,0;;;;;15,0;;;;;;;;2,0;;;3,0;;;;;;2,0;;;;1,0;;;;;;;;18,0;;;;;;;;;;2,0;;;;;;2,0;;;;;;;;1,0;;;;;;;;;;;;;4,0;3,0;8,0;;;;;;;;;;;;;;;8,0;2,0;;;;;;;;5,0;;;;;;;1,0;4,0;4,0;;;;3,0;;;;;;;25,0;4,0;;;;;;5,0;;21,0;3,0;;7,0;;1,0;;;;;2,0;;6,0;;;;;1,0;1,0;;2,0;;;11,0;;11,0;;2,0;;7,0;1,0;1,0;;106,0;8,0;15,0;;4,0;1,0;;;;1,0;;28,0;100,0;;;3,0;;;;2,0;;;4,0;;1,0;3,0;;;;9,0;40,0;;4,0;;;1,0;4,0;;4,0;3,0;;;;2,0;;;;6,0;4,0;16,0;;2,0;5,0;;5,0;;;;;12,0;2,0;;;;2,0;5,0;;2,0;;1,0;18,0;;;4,0;;;3,0;;;1,0;2,0;2,0;3,0;;;;27,0;;11,0;8,0;3,0;;3,0;;1,0;;;;3,0;;;;;22,0;;;;;;14,0;10,0;;;;;;3,0;;;1,0;;2,0;30,0;43,0;8,0;;3,0;22,0;1,0;;2,0;3,0;;;2,0;;;;;;;;18,0;;;1,0;4,0;5,0;;;1,0;2,0;5,0;1,0;;1,0;1,0;34,0;8,0;16,0;;2,0;;;;;;;;;2,0;;;;2,0;3,0;;2,0;;4,0;;;4,0;;;1,0;;;7,0;13,0;;27,0;3,0;;9,0;5,0;;5,0;3,0;1,0;12,0;;;;1,0;2,0;;17,0;;;;;;;;;;;;;;;;;;;;;;;;;;;;;;;;;;;7,0;;;;;4,0;;;;;;;;;;;3,0;2,0;;;;;;;;;;;;;1,0;;;;;;;;22,0;;;;;;;1,0;;1,0;3,0;;;;;;1,0;;;;;;1,0;;;;;;;;;;;;1,0;;;;;;;;;;;3,0;;;12,0;9,0;;;;;;;;2,0;;;;;;1,0;;;;;;;;;;;;;1,0;1,0;;;;;;;;6,0;;1,0;;1,0;;;;1,0;;;;;2,0;3,0;;;;3,0;;;;1,0;;;;3,0;;;;;;;;;;6,0;;;;;;7,0;;;;1,0;2,0;;1,0;;;;;;;12,0;;;;;7,0;;;;1,0;;;;;;;;;3,0;;;;;;;;;;;;;;8,0;;;1,0;;;;;;;;;;;;;;;;2,0;;;;;;;1,0;;1,0;;;2,0;;3,0;;2,0;;;;;;6,0;1,0;;;;;;;;;;;;;;;;;;;;;;1,0;;;;;;;;;;;;;;;;1,0;;;;;;;;;;;4,0;2,0;;;;;;;;;;
sheet;;;1,0;;;1,0;;8,0;1,0;5,0;;;1,0;;;9,0;;;;;35,0;15,0;;;2,0;;;;;;1,0;;10,0;;;;;;;;6,0;;3,0;;;;5,0;11,0;8,0;3,0;15,0;13,0;;;;5,0;84,0;;1,0;;4,0;;;;5,0;;1,0;10,0;4,0;;1,0;;1,0;;;1,0;;;;89,0;;1,0;;34,0;;9,0;;;;;36,0;;;18,0;;;;;2,0;;;;14,0;;1,0;1,0;5,0;3,0;20,0;;1,0;2,0;;;;30,0;10,0;18,0;2,0;13,0;;;2,0;;;;;2,0;2,0;1,0;;3,0;8,0;1,0;;;4,0;1,0;;;;;;10,0;;;;62,0;9,0;;;5,0;1,0;8,0;;;13,0;;;3,0;;2,0;16,0;;;;;;;;1,0;;4,0;4,0;7,0;1,0;6,0;9,0;2,0;;4,0;1,0;;1,0;;6,0;;7,0;;;3,0;;;8,0;;14,0;;;;5,0;;1,0;;1,0;;9,0;;;;12,0;2,0;3,0;2,0;;1,0;;;2,0;;6,0;3,0;;;;;;2,0;;10,0;;48,0;57,0;;9,0;1,0;1,0;3,0;14,0;5,0;2,0;;;;;;;;;3,0;;6,0;;;1,0;;;5,0;;;1,0;;1,0;4,0;3,0;;;2,0;3,0;1,0;;3,0;3,0;2,0;3,0;;8,0;;11,0;4,0;24,0;2,0;;;10,0;4,0;2,0;;3,0;;11,0;8,0;1,0;;;39,0;;1,0;;;3,0;2,0;3,0;10,0;;;;1,0;1,0;4,0;;;3,0;;;3,0;;;1,0;;10,0;;;;;1,0;;;11,0;2,0;;;1,0;;;;;;3,0;1,0;3,0;;;;;;;;4,0;4,0;;;;;2,0;5,0;;;4,0;3,0;;;3,0;;;4,0;;;33,0;2,0;;1,0;;;;;1,0;4,0;;;2,0;;;;1,0;;;;;;3,0;;;;;;;;;2,0;;;;;;;;;;;14,0;;;1,0;;;;;;;;;;;;;;;;;;;;;;2,0;;;;;;;;;;;;;;;;;;2,0;;;6,0;;;;;;;;;;;;;;;;;;;;;;;;;;;;;;;;;;;;;;;;;;;1,0;4,0;1,0;1,0;;24,0;;;;;;;;3,0;;;;;;;;;;;;;;;;1,0;;;;;;4,0;;;;;;;;;;;;;;;;;;2,0;3,0;;;1,0;;;;;;;;;;;;;;;;;;;;;;;;;;;;1,0;;;;;2,0;;;;;;1,0;;;;;;1,0;;6,0;;;;;;;;;;;;;;;;;;;;;;;;7,0;;;;;6,0;1,0;3,0;;;;4,0;;;;1,0;;;;;;;;;;;1,0;1,0;1,0;;;;1,0;;;;;;;;;;;10,0;;;;;;;;;6,0;;;;;;;;;;;;;2,0;;;;4,0;1,0;;12,0;;;;;;;;;;;;;;;;;;;;7,0;;;;;;;;11,0;;;;;;;2,0;;;;;;;;;;;;;;;1,0;;;;;1,0;3,0;;1,0;;;;;;;;;;4,0;;;;;;;;;;;;;;;;;;;;1,0;;;;;;;;;;;;2,0;;;;;;;1,0;;;;;;;;;;;;;;;;;;;;;;;;;;;;;;;;4,0;;;;;;2,0;;;;;;;;;;;;;;;;;;;1,0;;;;;;;;;;;;;;;;;1,0;;;;;;;;;;;;;;;;;;;;;;;1,0;;;;;;;;;;;;;;;;;;;;;;;;;;;;;;;;;;;;;;;;;;;;;;;2,0;;8,0;;7,0;6,0;;;;;;;;;1,0;4,0;;;;;;;1,0;;1,0;;;;;;15,0;;;;1,0;;;;;;;;;;;;;;;;
shield;;;1,0;;;;5,0;14,0;5,0;36,0;4,0;;4,0;;11,0;6,0;;;;;;9,0;;;;;;;7,0;;;5,0;29,0;;4,0;1,0;1,0;;;;;;31,0;;;;1,0;17,0;3,0;2,0;30,0;4,0;;2,0;5,0;2,0;26,0;;;;20,0;10,0;1,0;;14,0;;2,0;105,0;6,0;22,0;3,0;;3,0;;;17,0;;;;32,0;5,0;8,0;;42,0;;;;;15,0;3,0;83,0;;;36,0;;;;;12,0;1,0;;;189,0;12,0;;;49,0;8,0;6,0;;12,0;2,0;3,0;;;33,0;153,0;35,0;3,0;2,0;5,0;;5,0;1,0;;;;;57,0;10,0;;;5,0;6,0;;;1,0;;;;;;;23,0;;;;47,0;8,0;5,0;;3,0;;5,0;;1,0;3,0;;1,0;3,0;;3,0;65,0;;;;8,0;3,0;;2,0;;2,0;5,0;3,0;;2,0;13,0;11,0;3,0;;28,0;66,0;;19,0;12,0;17,0;15,0;32,0;2,0;1,0;;;;31,0;1,0;16,0;;;;103,0;8,0;;2,0;16,0;;4,0;;3,0;;19,0;25,0;2,0;1,0;4,0;;;26,0;20,0;5,0;49,0;74,0;15,0;5,0;;;18,0;48,0;;231,0;4,0;75,0;38,0;1,0;26,0;;;;42,0;1,0;39,0;6,0;;6,0;7,0;;;11,0;;18,0;1,0;26,0;;;1,0;;;10,0;1,0;;;;56,0;3,0;;3,0;;13,0;;13,0;;;4,0;25,0;21,0;;12,0;;10,0;18,0;64,0;;;7,0;4,0;;1,0;1,0;2,0;6,0;1,0;2,0;4,0;;;23,0;;;2,0;;6,0;7,0;;18,0;;;;;14,0;35,0;8,0;;59,0;5,0;1,0;7,0;;;9,0;;13,0;;;5,0;1,0;2,0;;4,0;;;;;1,0;;;;;20,0;;3,0;10,0;1,0;3,0;2,0;4,0;2,0;;5,0;;4,0;3,0;2,0;5,0;;;;2,0;;3,0;;;1,0;3,0;3,0;12,0;9,0;2,0;;8,0;1,0;;;;;;;1,0;6,0;;;;2,0;;;;3,0;;6,0;;;17,0;13,0;;;;1,0;;;1,0;1,0;;;;;;;;;;;;1,0;;4,0;;;;;;;;;;8,0;;;1,0;;1,0;;;;;5,0;;;;;1,0;;;1,0;;2,0;;;1,0;1,0;;;;;4,0;;;;;;;;;4,0;;;;;;;;;;;;;;;;;;2,0;2,0;;1,0;;2,0;;;;;1,0;;3,0;;;;;;;;;;3,0;;;;2,0;;4,0;5,0;;;;;;;;;;;10,0;;;;;;;;;5,0;;;;2,0;;4,0;;;;;;;;3,0;;;;;;;;;;;4,0;;;7,0;;;1,0;;;3,0;3,0;;1,0;;;4,0;;;;;4,0;;1,0;1,0;9,0;56,0;;;;2,0;;;;;;;;;;;;11,0;7,0;;;;;;12,0;;;;;;4,0;3,0;;;;;4,0;;;;;;;;;;;;;;5,0;;;2,0;;;;8,0;;;;;;;;;;;;;;2,0;;10,0;10,0;;;4,0;2,0;;3,0;;1,0;4,0;2,0;;;;11,0;2,0;;2,0;;;;;;;;;;;;;;;2,0;;;9,0;;;;;;;;;;3,0;1,0;;;;;;;;;;;;;3,0;;;;30,0;;;4,0;;3,0;2,0;;;;;;12,0;30,0;;;;;;1,0;;;;;8,0;;1,0;;10,0;;2,0;2,0;;;;3,0;;;;2,0;1,0;3,0;;;;;2,0;;;;;;;;8,0;;;;5,0;2,0;;;;;;;;;;;;;;;;;;;;;;;;;;3,0;;2,0;;;;;;2,0;;;;;;;;;;;;;;;;;;;;;;;2,0;;;;;;;;;;;;;;13,0;;;;;;;;;;;;;;;;;;;;;;;;;;;;2,0;;;;;;;;;;1,0;;;1,0;;;;;;;;;6,0;3,0;;;;6,0;;;;1,0;1,0;;;5,0;;;3,0;;;;2,0;;;;;;1,0;;;;;3,0;2,0;;;;;;;;;;;;;;;;;;;;;;;;4,0;;1,0;;;;;;;;;;;;;2,0;;2,0;;;;;;;;;;;;;;;;;;;;;;;;;;;;;;;;;
shutter;;;13,0;24,0;2,0;2,0;98,0;56,0;10,0;41,0;61,0;;5,0;4,0;19,0;71,0;21,0;1,0;6,0;;;42,0;19,0;;;;2,0;6,0;;;;17,0;77,0;3,0;243,0;31,0;;;;;28,0;2,0;4,0;;90,0;22,0;32,0;180,0;68,0;30,0;50,0;6,0;1,0;;221,0;7,0;43,0;1,0;1,0;;4,0;11,0;2,0;9,0;12,0;93,0;8,0;26,0;94,0;35,0;49,0;;34,0;3,0;;17,0;;1,0;3,0;226,0;;62,0;;134,0;7,0;1,0;3,0;6,0;;3,0;171,0;;1,0;4,0;;2,0;6,0;;84,0;7,0;1,0;1,0;134,0;2,0;9,0;10,0;41,0;6,0;23,0;16,0;32,0;69,0;;;;25,0;44,0;143,0;21,0;26,0;7,0;5,0;;7,0;22,0;1,0;;5,0;1,0;6,0;;7,0;6,0;;;3,0;3,0;51,0;4,0;;6,0;;1,0;88,0;54,0;;;31,0;142,0;3,0;1,0;1,0;7,0;30,0;23,0;15,0;114,0;;;2,0;2,0;3,0;214,0;4,0;;;8,0;6,0;1,0;2,0;7,0;6,0;;10,0;25,0;;6,0;20,0;;;5,0;56,0;;;24,0;7,0;1,0;3,0;;;7,0;;;45,0;;9,0;;2,0;6,0;54,0;;1,0;14,0;37,0;2,0;;2,0;;115,0;15,0;23,0;;40,0;4,0;11,0;;3,0;;;6,0;21,0;18,0;4,0;;;;14,0;16,0;131,0;;69,0;;29,0;47,0;18,0;28,0;41,0;264,0;3,0;13,0;7,0;6,0;5,0;21,0;16,0;;3,0;1,0;118,0;92,0;80,0;2,0;;37,0;;36,0;27,0;12,0;3,0;1,0;;;11,0;31,0;;3,0;10,0;13,0;;8,0;6,0;22,0;7,0;1,0;4,0;5,0;59,0;17,0;16,0;56,0;17,0;2,0;2,0;;2,0;104,0;;19,0;;6,0;;1,0;3,0;4,0;;;4,0;;15,0;;26,0;5,0;16,0;;1,0;1,0;5,0;29,0;1,0;;;51,0;;1,0;171,0;4,0;;;;14,0;;;5,0;;63,0;;12,0;;;6,0;;14,0;1,0;1,0;;3,0;3,0;7,0;18,0;5,0;;;2,0;9,0;3,0;;9,0;53,0;5,0;2,0;;2,0;;12,0;;19,0;;17,0;4,0;2,0;1,0;3,0;;3,0;5,0;;;9,0;1,0;6,0;;105,0;;;;;7,0;;13,0;9,0;1,0;;;14,0;1,0;;1,0;;;21,0;4,0;12,0;;3,0;;2,0;;2,0;4,0;;1,0;;6,0;17,0;2,0;;2,0;2,0;8,0;1,0;35,0;;;;18,0;4,0;;2,0;11,0;;;5,0;8,0;1,0;6,0;8,0;;6,0;;6,0;;35,0;2,0;22,0;;;;5,0;44,0;;;7,0;17,0;;;33,0;204,0;;5,0;43,0;6,0;;;2,0;1,0;9,0;2,0;;2,0;;4,0;7,0;;154,0;;;8,0;;1,0;;;;27,0;1,0;37,0;;;2,0;4,0;;26,0;13,0;;15,0;;;;;3,0;1,0;10,0;;;28,0;4,0;;2,0;1,0;15,0;2,0;81,0;;18,0;26,0;12,0;;3,0;;79,0;;;6,0;;;;;;;5,0;;4,0;22,0;3,0;;;;;;;14,0;;;1,0;9,0;;;8,0;;2,0;4,0;;42,0;3,0;1,0;7,0;4,0;5,0;;10,0;18,0;;;7,0;2,0;67,0;44,0;;;;215,0;;34,0;;4,0;;21,0;2,0;3,0;;5,0;1,0;1,0;1,0;;3,0;14,0;1,0;1,0;;;;;;;15,0;16,0;;15,0;3,0;;;1,0;;3,0;1,0;;;;1,0;;6,0;;;;;;3,0;19,0;;2,0;2,0;;2,0;;1,0;;;;;;17,0;;;1,0;2,0;;6,0;2,0;9,0;;26,0;;;3,0;;;;;;;4,0;;;9,0;;4,0;;;1,0;;;1,0;;5,0;8,0;3,0;1,0;;;;4,0;;;;3,0;;4,0;9,0;2,0;44,0;20,0;;2,0;;;;3,0;;;;;2,0;;;2,0;5,0;1,0;8,0;2,0;5,0;1,0;;;;;;;;3,0;;;;1,0;;4,0;16,0;8,0;;3,0;;2,0;;2,0;;;;;;328,0;;;5,0;4,0;;;19,0;;;1,0;;1,0;28,0;;;4,0;;;17,0;;7,0;;6,0;;5,0;;;3,0;;;;1,0;;;4,0;;1,0;;;7,0;5,0;;;;;;;;2,0;;;;18,0;;;;1,0;3,0;;;6,0;;1,0;;;3,0;;14,0;;4,0;7,0;17,0;;;17,0;;;;;;3,0;6,0;3,0;;;;;;9,0;2,0;;;;;;;2,0;;;2,0;;5,0;;4,0;;2,0;;;11,0;;;;5,0;;;10,0;;;3,0;3,0;;;;;;1,0;;15,0;3,0;;;1,0;;;;5,0;;;;;22,0;2,0;;;;2,0;;;;;;;;6,0;11,0;2,0;3,0;;;;46,0;;;;;;;;;;;;;13,0;2,0;;;;;3,0;;3,0;4,0;12,0;;;;8,0;1,0;20,0;;;;2,0;1,0;;;1,0;;;2,0;;41,0;;;3,0;;;;;;2,0;;;;;;;1,0;;;;;;3,0;1,0;;;;;;;;3,0;5,0;1,0;;;1,0;;;7,0;;;3,0;9,0;;6,0;;;;;;;;;;;1,0;1,0;1,0;;;;;;;;;;1,0;;;;27,0;;;;;;
sight;;;6,0;;;33,0;2,0;16,0;;1,0;;;3,0;;57,0;16,0;;;;;;1,0;;;;;;;;;2,0;;13,0;;16,0;;;;;;10,0;;6,0;8,0;2,0;;12,0;26,0;;32,0;;28,0;;;;;8,0;;5,0;1,0;3,0;;5,0;;;2,0;;;8,0;;2,0;1,0;;;;;13,0;;;30,0;;3,0;;13,0;;;;;;;4,0;;;;;;;;19,0;1,0;;;9,0;;4,0;;13,0;3,0;;;1,0;;;;;7,0;1,0;32,0;;;;3,0;3,0;3,0;;3,0;;;;2,0;;3,0;6,0;;;;;;;;3,0;;;21,0;1,0;;;;;;;;;3,0;12,0;;10,0;;10,0;;1,0;1,0;18,0;;;;6,0;42,0;;;;;;;;;1,0;1,0;;;;;;;;;;2,0;;;;;;3,0;;;;;;;;1,0;;58,0;;;;;;;;;;;;;;;;;1,0;;;;;;;;;;;;;7,0;4,0;1,0;;;;;;;;3,0;;;;;;2,0;2,0;;;;;;;;;;;;;;;;;;;;;;;;;;;11,0;;1,0;;;;;;8,0;1,0;;;;2,0;2,0;;;2,0;;;;;;;;;;;;;1,0;;;;;;;;;;;;6,0;;;;;;;;;1,0;;;;;;;;;5,0;1,0;;;;;;;4,0;;1,0;11,0;;;14,0;;;;;5,0;30,0;;;;;;;;;;;;;;;;;;;;;6,0;39,0;;;;;;;;;;14,0;2,0;62,0;;;;;;;1,0;;;1,0;;1,0;;4,0;;2,0;1,0;11,0;12,0;1,0;;;2,0;;;;1,0;;;16,0;;;;2,0;;1,0;;;;3,0;;12,0;2,0;;2,0;4,0;;;;8,0;1,0;;;;1,0;;3,0;;;;;;2,0;1,0;;;;;1,0;;;;;;;;;2,0;;;1,0;;3,0;;31,0;8,0;;;18,0;13,0;;5,0;16,0;;;;;;;;;;;;4,0;;;;8,0;;;;2,0;;2,0;;;;;2,0;;;;;;;;;;;;10,0;;;;;;;;;;;;;5,0;;;;;;;;;1,0;;;;;;;3,0;;;;;;9,0;;;;;;;2,0;;1,0;;1,0;5,0;;;;;;;;;;;;;;;;;4,0;;;;;;;;;;;3,0;;;;;;;;;;;;1,0;;;;;;;;;;;;;1,0;7,0;;;;;6,0;;;;;;;;;1,0;1,0;;;5,0;;;;;;1,0;;;;;;;2,0;;;;;;;;;;;;2,0;;;;;;;;;;;;;;;4,0;;;4,0;;4,0;;;;;;;;4,0;1,0;;;;;;;;;;;7,0;;;;;;;;;;;;;;;;;;;;;;;;;;;;;;;;;4,0;;;2,0;;;;;;;;;;;;;;;1,0;;;;;;;;1,0;;;;;;;;;;;2,0;;;;;;;;;10,0;;;;;;;;;;;;10,0;;;;;;;;;;;;;;;;;;;;;;;;;;;;;;;;;;1,0;;1,0;;;;;;;;;;;;;;;;;;;;;1,0;;11,0;;;;;;2,0;;;;;;;;;;;;;;1,0;;;;;;;6,0;;;;;;;;;;;;;;11,0;1,0;;;11,0;;;;;;;;;;;;4,0;1,0;;;;;;;;;;;;;;;;;;;;1,0;;;;;;;;;;;;;;;;;1,0;;;;;;;;;;;;;;;;;4,0;;;;;;;;;;10,0;4,0;;;;;;;;;;;;;;;;;;;
similarity;;;2,0;;;;;1,0;23,0;;;;;;;32,0;;;1,0;;4,0;4,0;;;;11,0;14,0;;;;1,0;5,0;2,0;;4,0;;;;;;3,0;;10,0;;;7,0;38,0;5,0;5,0;;;1,0;;;;1,0;;;5,0;;;;;;;;;5,0;3,0;;2,0;;8,0;;;;;;;99,0;;;;5,0;;;;1,0;;;;;;;;2,0;;;17,0;;11,0;;;55,0;;;;;;2,0;2,0;1,0;;;;7,0;;2,0;;29,0;;;;2,0;;1,0;;;;;;10,0;;;1,0;3,0;;3,0;6,0;;2,0;;;;;;;;;2,0;2,0;;;2,0;2,0;;2,0;;;2,0;;;27,0;;1,0;;;;;;;;;;1,0;;;;;;;;;;;;;18,0;;;;;;2,0;1,0;;;;;;;;1,0;12,0;;;;2,0;;11,0;;;;;;;;;;;;;;;;;;;;;;;;;;;1,0;;;;1,0;;;;;;;1,0;7,0;2,0;;;;;;;1,0;;;;;;;7,0;;;4,0;;;;;2,0;1,0;;;;;;;;;;;;;14,0;;;;;1,0;;;;;;13,0;;;;;;;;;;;;;;;;;;;;;;;;;;;;;;;;;4,0;;;;;;4,0;1,0;;;;;;;;;;;;;;;;;;;;;9,0;;;;;;;;;;;;;3,0;;;;;;;;;;;;;;;;;;;;;5,0;1,0;;;;;;9,0;;;;;2,0;;;;;;25,0;;;3,0;;9,0;;;;;;;;;6,0;;;;16,0;13,0;1,0;;8,0;62,0;;1,0;;5,0;21,0;2,0;;;12,0;1,0;;;;2,0;;;;;;;;;1,0;;1,0;;;;;;;;;;;20,0;6,0;;;;8,0;2,0;1,0;9,0;;;;1,0;;;1,0;;;;;;1,0;;;1,0;;37,0;;;;;;;;;;;1,0;;;;;;1,0;;11,0;;;;;;;;;;;;;1,0;;;;;;;;1,0;;27,0;4,0;;;10,0;;;;;;;;;;;;;;;;;;;;;3,0;;30,0;;;;;;;1,0;;;;;;;;;;;;;;;;;;;;;;;;;;;;;;;;;;;;;;;;;;;;;;;1,0;;;;;;3,0;;;6,0;;;;;;6,0;;;;;;;;;;;;;;;;;;;;;;;;;;;;;;;;;;;13,0;;;;;;;;;;;;;;1,0;;;;;;;;;;;;;;;;;;;;;;2,0;;;;;;;;;;;;;;;;;;;;;;;;;;;;;;;;;;;;;;;;2,0;;;;;;;;;;;;;;;;;;;;;;;58,0;;;;;;4,0;4,0;;;;;;34,0;19,0;;;;;;;;;;;1,0;;;;;;;;;4,0;;;14,0;;;;;4,0;;;;;;;;;;;;;1,0;;;;;;;;;;;;;;;;;;;;;;;;;;;;;;;;;;;;;1,0;;;4,0;;;;;;;;;;;;;;;;;;;;;;;;;;2,0;;;;;;;;;;3,0;;;;;;;;;;;;;;;;;;;;;;;;;;2,0;;;;;1,0;;3,0;;;;;;;;;;;;;;;;18,0;;;;;;;;;;2,0;;;;;;;;;;;;;;;;;;;;;;;;;1,0;;;;;;;;;;;;;3,0;;;;;
space;;;1,0;;2,0;22,0;8,0;49,0;38,0;34,0;10,0;;23,0;;92,0;82,0;18,0;;;1,0;23,0;41,0;14,0;13,0;;6,0;349,0;1,0;1,0;;13,0;12,0;39,0;;29,0;13,0;2,0;2,0;6,0;;106,0;3,0;146,0;23,0;20,0;15,0;92,0;97,0;20,0;73,0;100,0;111,0;3,0;13,0;7,0;24,0;88,0;2,0;20,0;;57,0;6,0;27,0;;13,0;2,0;6,0;123,0;44,0;38,0;19,0;;35,0;1,0;32,0;28,0;29,0;1,0;;333,0;9,0;39,0;4,0;102,0;6,0;1,0;;;10,0;12,0;325,0;;2,0;13,0;3,0;7,0;53,0;;98,0;1,0;60,0;;118,0;138,0;8,0;1,0;101,0;9,0;26,0;19,0;5,0;19,0;15,0;;;156,0;133,0;186,0;5,0;58,0;1,0;20,0;1,0;17,0;17,0;5,0;1,0;23,0;3,0;20,0;1,0;19,0;20,0;;11,0;3,0;17,0;;3,0;8,0;13,0;1,0;2,0;88,0;7,0;;5,0;98,0;21,0;22,0;6,0;6,0;14,0;10,0;14,0;;80,0;;2,0;3,0;8,0;3,0;127,0;;19,0;;21,0;65,0;14,0;;8,0;1,0;16,0;54,0;6,0;10,0;32,0;59,0;;;28,0;46,0;9,0;3,0;;23,0;1,0;29,0;1,0;;1,0;6,0;3,0;14,0;1,0;14,0;;;3,0;40,0;8,0;1,0;18,0;86,0;;19,0;;;1,0;61,0;1,0;;1,0;1,0;9,0;;21,0;12,0;13,0;77,0;94,0;5,0;96,0;;1,0;78,0;9,0;1,0;111,0;;120,0;1,0;8,0;42,0;23,0;26,0;11,0;56,0;28,0;32,0;12,0;9,0;4,0;7,0;19,0;;;72,0;70,0;31,0;57,0;;4,0;;6,0;;376,0;4,0;2,0;1,0;2,0;4,0;6,0;13,0;6,0;;31,0;25,0;7,0;2,0;8,0;10,0;;7,0;;28,0;;12,0;33,0;169,0;;;4,0;9,0;1,0;32,0;4,0;;4,0;11,0;55,0;9,0;6,0;1,0;39,0;;8,0;4,0;11,0;1,0;8,0;11,0;14,0;2,0;8,0;4,0;1,0;10,0;56,0;12,0;4,0;13,0;6,0;8,0;31,0;4,0;7,0;5,0;1,0;19,0;14,0;;3,0;5,0;4,0;;16,0;14,0;;;4,0;9,0;14,0;;;4,0;4,0;27,0;7,0;36,0;6,0;3,0;4,0;2,0;4,0;4,0;3,0;5,0;35,0;5,0;2,0;4,0;;3,0;10,0;14,0;;91,0;14,0;;;13,0;6,0;2,0;28,0;;1,0;32,0;22,0;7,0;4,0;4,0;2,0;4,0;;2,0;3,0;;15,0;14,0;4,0;1,0;7,0;18,0;2,0;5,0;17,0;1,0;;29,0;8,0;5,0;;4,0;6,0;;18,0;20,0;4,0;1,0;;;4,0;5,0;;;;12,0;1,0;28,0;21,0;2,0;4,0;2,0;15,0;;9,0;2,0;2,0;;;7,0;5,0;;2,0;;1,0;14,0;4,0;1,0;;4,0;13,0;4,0;69,0;;6,0;26,0;5,0;;11,0;5,0;20,0;;1,0;3,0;8,0;1,0;17,0;;9,0;11,0;;;1,0;18,0;4,0;11,0;;;14,0;;1,0;2,0;;3,0;;1,0;2,0;7,0;1,0;2,0;;5,0;31,0;;11,0;;;2,0;11,0;6,0;;25,0;28,0;;;;11,0;24,0;;3,0;2,0;2,0;;4,0;1,0;4,0;7,0;;2,0;;;4,0;3,0;;23,0;;;;;34,0;;;2,0;;;;5,0;;;1,0;1,0;4,0;;;1,0;;7,0;;;;7,0;5,0;;2,0;6,0;22,0;;11,0;;6,0;;1,0;;5,0;2,0;;;;1,0;1,0;1,0;6,0;;10,0;;1,0;8,0;2,0;2,0;;7,0;26,0;20,0;4,0;19,0;21,0;;;20,0;2,0;7,0;1,0;;2,0;21,0;2,0;;16,0;2,0;1,0;;;11,0;;4,0;5,0;1,0;3,0;;;;11,0;4,0;3,0;;1,0;5,0;1,0;37,0;;3,0;;;16,0;;5,0;;;;6,0;5,0;;;1,0;4,0;2,0;;4,0;1,0;1,0;;;3,0;;35,0;1,0;1,0;2,0;;1,0;;25,0;;;;8,0;;2,0;2,0;;3,0;;;2,0;;3,0;196,0;3,0;;;3,0;48,0;7,0;5,0;1,0;1,0;6,0;2,0;4,0;;;2,0;21,0;6,0;1,0;4,0;;5,0;1,0;14,0;;;;4,0;;1,0;8,0;3,0;1,0;3,0;5,0;;1,0;6,0;;13,0;8,0;13,0;;15,0;2,0;;;;3,0;;8,0;2,0;3,0;;4,0;;1,0;3,0;3,0;5,0;;22,0;;;;22,0;;;;;4,0;3,0;5,0;9,0;4,0;2,0;1,0;34,0;14,0;8,0;6,0;6,0;3,0;;12,0;;2,0;;;2,0;1,0;6,0;2,0;1,0;;3,0;;2,0;;2,0;4,0;134,0;8,0;;6,0;16,0;1,0;;;;;;;;;;3,0;;;3,0;1,0;;;3,0;;;;1,0;;1,0;13,0;5,0;1,0;;;;2,0;3,0;3,0;;;;6,0;2,0;;;9,0;;1,0;;1,0;;6,0;;1,0;;;6,0;10,0;8,0;5,0;1,0;4,0;5,0;;;1,0;2,0;2,0;;2,0;1,0;;1,0;3,0;;;;4,0;;;;;2,0;2,0;;2,0;19,0;2,0;;;;;2,0;;35,0;;;;;;;;;;1,0;;1,0;;;10,0;2,0;;6,0;3,0;4,0;;9,0;;;;2,0;;1,0;;3,0;2,0;;;;;;25,0;;1,0;;1,0;;;;;1,0;;4,0;;;1,0;;;2,0;;6,0;8,0;;3,0;3,0;17,0;;3,0;4,0;1,0;7,0;;;1,0;;9,0;3,0;9,0;;8,0;5,0;5,0;;12,0;11,0;1,0;8,0;2,0;;;;6,0;1,0;14,0;13,0;7,0;;;;;2,0;;;4,0;;1,0;;2,0;;;258,0;;;;6,0;2,0;;4,0;1,0;;1,0;;;4,0;1,0;;;;;;3,0;;;;3,0;1,0;5,0;;11,0;1,0;1,0;3,0;5,0;4,0;1,0;3,0;6,0;7,0;;;;8,0;;3,0;4,0;;1,0;;1,0;;
spectrum;;;1,0;;1,0;;;14,0;;6,0;2,0;;;;2,0;12,0;37,0;;;;;10,0;4,0;;;;21,0;;;2,0;1,0;;7,0;3,0;2,0;;;;;;10,0;;2,0;;8,0;;6,0;2,0;2,0;;;1,0;;;;;2,0;2,0;;;4,0;;1,0;;7,0;;2,0;3,0;;;2,0;2,0;11,0;;;;;1,0;4,0;38,0;2,0;4,0;;6,0;;;;;;;1,0;;;4,0;1,0;;1,0;;25,0;;;2,0;11,0;12,0;;2,0;31,0;;22,0;;9,0;;;;;13,0;33,0;1,0;;3,0;;;3,0;2,0;4,0;1,0;;;14,0;8,0;;27,0;;;2,0;;;3,0;1,0;;2,0;;;7,0;;;;;6,0;;1,0;;;21,0;1,0;;11,0;;;;;19,0;5,0;;;;3,0;3,0;64,0;69,0;6,0;1,0;;;1,0;2,0;;;;5,0;;2,0;;;1,0;;1,0;1,0;;;;;;;;;;;;1,0;;;3,0;;;;2,0;7,0;1,0;;;;;;;;;;;;;;;;;;1,0;;147,0;;;;12,0;;;;;;;;1,0;;4,0;4,0;1,0;2,0;;;5,0;;;1,0;;;;4,0;18,0;23,0;;;;;;15,0;;;;;4,0;;;51,0;;;;;2,0;;;2,0;;;;;;;2,0;;;;;;;;;2,0;5,0;;;;;;;;;;2,0;3,0;;;;;;;;9,0;;1,0;;;;;;;;;;;;;;;;;2,0;9,0;;;;;;;;;12,0;;;7,0;;;;;;2,0;;;;;;;;;;;;;;;;3,0;;;;;;;;;;;;;;;;;;;;;;9,0;;;;;;7,0;;;;;;2,0;;;;;2,0;;;;1,0;;;;;3,0;;;;;10,0;;1,0;;;;;6,0;;2,0;;;4,0;;1,0;;;2,0;;;;;;2,0;;;;;;;;;;;;;;;13,0;2,0;;;;;;;1,0;;;;1,0;;3,0;;2,0;;;;;1,0;;;2,0;;;;;;1,0;;1,0;;4,0;;3,0;;1,0;;;;;3,0;;;;;;2,0;;;;;2,0;;;;;;;;;;;;2,0;;;2,0;;;;;;;;;;;;;1,0;;;20,0;3,0;;;;;;12,0;2,0;;;;;;;;;;15,0;;;;;;;;;;;;;;;;;1,0;;;;31,0;;;;;;;;;;;;;;;;;;;;;;;;;;;;;;;;;;;;;;;;;;14,0;1,0;;;;;;;;;;;;;;;;;;;;;;;;1,0;;;4,0;;;;;;;;;;;;;;;;;;13,0;;;;;;;;;;;;;;;;;;;;;;;;;;;;2,0;;;;;;;;;;;;;;;;;;;;;;;;;;;;;;;;;;11,0;;;;;;;;1,0;;;;;1,0;;;;;;;;;;;;;;;;;;;;;;;;;;;;;;;;;;;;;2,0;;;;;4,0;;;;;;;;;;;1,0;;4,0;;;;;;;;;7,0;;;;;4,0;;;;;;;;;;;;;;;2,0;;;;;;;;;;;;;;1,0;;;;;;;;;;;;;;;;;;;;;1,0;;;1,0;;13,0;;;2,0;;;;;;;;1,0;2,0;;;;;;;;1,0;;;5,0;;;;14,0;;;;;;;;;;;;;;;;;1,0;;2,0;;;;;;;;;;;;;;;1,0;;;;;;;;;;;;;;;;;;;;;;;;;;;;;;;;;;;;;;;;;;;;;;;;;;;;;;;;;;;;;;;;3,0;;;
speed;;;11,0;;1,0;6,0;70,0;16,0;2,0;;;;2,0;;7,0;92,0;;;2,0;;8,0;14,0;7,0;;;2,0;1,0;9,0;;;2,0;6,0;28,0;3,0;75,0;41,0;2,0;2,0;1,0;1,0;10,0;10,0;;2,0;64,0;7,0;50,0;41,0;18,0;10,0;1,0;19,0;;;95,0;;8,0;2,0;2,0;;;11,0;;1,0;;14,0;40,0;;18,0;;6,0;;17,0;1,0;;6,0;1,0;2,0;1,0;105,0;7,0;7,0;1,0;37,0;24,0;9,0;20,0;5,0;5,0;7,0;114,0;;;;9,0;;8,0;;70,0;3,0;1,0;;15,0;84,0;;33,0;18,0;6,0;5,0;14,0;;32,0;;;;30,0;3,0;40,0;2,0;68,0;;;4,0;11,0;2,0;10,0;6,0;5,0;;43,0;;;8,0;1,0;15,0;2,0;4,0;5,0;2,0;;4,0;;11,0;33,0;27,0;;;5,0;39,0;15,0;;;20,0;37,0;34,0;2,0;42,0;1,0;5,0;8,0;4,0;12,0;176,0;1,0;3,0;2,0;13,0;3,0;1,0;1,0;28,0;;;;16,0;1,0;2,0;;;;;25,0;;;4,0;1,0;;4,0;;;3,0;;6,0;;;;;;;2,0;;;2,0;54,0;2,0;;;;44,0;8,0;1,0;;;1,0;;2,0;;;2,0;;;;;;;;;;27,0;;8,0;;2,0;;4,0;18,0;37,0;8,0;;;;;;1,0;6,0;;;;7,0;;;;;;1,0;1,0;39,0;;;;;;1,0;18,0;;3,0;;;154,0;;;1,0;2,0;;;;2,0;;12,0;6,0;;3,0;;;1,0;108,0;;;2,0;;125,0;5,0;5,0;;;4,0;1,0;;;;4,0;;;;1,0;;;;;;;;;;1,0;2,0;;;;;4,0;;;;116,0;;;;;;;;;;;6,0;;;;;;4,0;1,0;4,0;17,0;1,0;;41,0;;;;;;13,0;;;;7,0;1,0;;;;;;;;;;;;3,0;;;5,0;1,0;;;;18,0;23,0;;;;1,0;;1,0;;;;10,0;;30,0;2,0;;;10,0;3,0;;;2,0;9,0;2,0;15,0;4,0;;;;7,0;8,0;42,0;30,0;;5,0;;20,0;20,0;;2,0;4,0;;;3,0;8,0;12,0;;;2,0;5,0;;6,0;;13,0;12,0;3,0;13,0;;1,0;18,0;44,0;1,0;3,0;46,0;62,0;;;8,0;47,0;1,0;1,0;2,0;5,0;;;3,0;59,0;5,0;2,0;;;2,0;13,0;;10,0;;;;2,0;5,0;8,0;18,0;7,0;4,0;;2,0;11,0;2,0;4,0;;1,0;;22,0;;;;1,0;;;;;;1,0;;9,0;;8,0;1,0;;;2,0;;5,0;;;12,0;1,0;14,0;;;111,0;;1,0;7,0;;;;;;;;;2,0;;6,0;1,0;;2,0;2,0;;;;1,0;4,0;;;;;34,0;;2,0;4,0;;1,0;1,0;11,0;;;4,0;;;4,0;12,0;;;;;;;;1,0;;5,0;1,0;;;;5,0;3,0;6,0;;4,0;;;;1,0;;3,0;;;5,0;;;;;;3,0;;2,0;;;2,0;;;;;;;;;;;4,0;;2,0;1,0;2,0;4,0;;;;;;;;;;;1,0;1,0;;1,0;;1,0;;6,0;;;10,0;;;7,0;;;;1,0;2,0;;;;1,0;;4,0;;1,0;;;;1,0;;10,0;;;;;;4,0;;;;;;;;;7,0;2,0;;1,0;2,0;;44,0;11,0;;;1,0;5,0;;;;;;;3,0;1,0;;;5,0;;;;;;;;;;;;;;;;;5,0;;;6,0;2,0;6,0;;;;;;8,0;;;;;7,0;;1,0;;;;;;;;;4,0;;;;;7,0;;;1,0;;2,0;;;3,0;;;;;;;;;;;;;2,0;;;3,0;4,0;2,0;;;1,0;2,0;5,0;;;;;;;;;;6,0;2,0;;;59,0;;;;;12,0;1,0;5,0;;10,0;;6,0;;;;5,0;1,0;;;;2,0;24,0;5,0;;25,0;;4,0;;;2,0;;;2,0;;;;;;;;;;;2,0;2,0;1,0;1,0;;;;;;3,0;;;;;;8,0;4,0;4,0;;;1,0;;;;;;;;1,0;;;;;;1,0;;;;1,0;;;;;2,0;1,0;;;;;3,0;;1,0;;6,0;;;2,0;1,0;;;2,0;2,0;;1,0;;;;;;;;;;;;;3,0;;3,0;;1,0;;1,0;;;;;;;;;;3,0;;7,0;;;4,0;;;;1,0;;;;;22,0;;;;;;;1,0;;;;;;;;;7,0;;;;;;;3,0;;;;;;1,0;;;;;;;3,0;;2,0;;;1,0;;;;;3,0;;;;;4,0;1,0;;;;;;23,0;3,0;1,0;14,0;;;2,0;;;;;;;2,0
stereoscopic;;;1,0;;;5,0;;30,0;2,0;10,0;1,0;;1,0;1,0;1,0;11,0;4,0;1,0;;1,0;17,0;47,0;2,0;34,0;;;9,0;;;;3,0;1,0;26,0;;44,0;1,0;;2,0;;;39,0;2,0;;12,0;;1,0;22,0;37,0;29,0;79,0;;47,0;;1,0;;;16,0;;;;;;33,0;;;40,0;27,0;37,0;39,0;;3,0;;38,0;1,0;;;;;4,0;467,0;2,0;40,0;1,0;35,0;4,0;1,0;;;;8,0;8,0;;;;;;6,0;;96,0;25,0;;2,0;23,0;25,0;;;68,0;6,0;15,0;39,0;;4,0;;;;18,0;28,0;12,0;;5,0;1,0;1,0;1,0;13,0;6,0;2,0;;;;12,0;;;9,0;;4,0;2,0;4,0;2,0;;1,0;17,0;;;16,0;11,0;;;;4,0;6,0;4,0;;5,0;12,0;2,0;;117,0;2,0;;;1,0;;5,0;;;;5,0;99,0;;;1,0;;;;4,0;2,0;3,0;;;;;2,0;;;;;;7,0;8,0;;;;;1,0;;;;;;;2,0;;1,0;;;;1,0;;;11,0;;;;;7,0;;;;;;3,0;;2,0;1,0;;;;;12,0;;;;;8,0;;1,0;2,0;;;;;;5,0;;;;;;6,0;3,0;;;;;;;13,0;4,0;;;;;4,0;1,0;;;1,0;;5,0;;;1,0;;;;2,0;;;;8,0;5,0;;;;;4,0;;4,0;;;;;;;;;;;;;2,0;4,0;;2,0;;;;;;1,0;;;;;2,0;9,0;;;;17,0;;;;11,0;;;6,0;3,0;;;;;;;;;;6,0;;;;;18,0;;2,0;;;;3,0;;;;6,0;;;;;20,0;4,0;6,0;;1,0;;;;;;1,0;4,0;;3,0;;;;;;8,0;;3,0;1,0;;;;;;;;;2,0;3,0;1,0;23,0;;1,0;1,0;2,0;;;1,0;;;;;;;;;;2,0;4,0;;;;;10,0;;;;;;;2,0;;;;;;;;;;3,0;1,0;;4,0;;1,0;;12,0;;;;6,0;;;9,0;8,0;;2,0;;;;;;;;;10,0;;;1,0;;;;;;;;;1,0;;;;6,0;9,0;;;;;;3,0;;2,0;12,0;;;;1,0;1,0;10,0;;1,0;;2,0;;;1,0;;9,0;;1,0;;1,0;14,0;;;4,0;;2,0;;;18,0;;;16,0;;;;;;;;;;;;;;;2,0;;;;3,0;;;1,0;;;1,0;;;;1,0;15,0;1,0;;;;1,0;;;;1,0;;4,0;;;;;;1,0;;5,0;;1,0;5,0;;;;;;1,0;;;;;;;;;;;;;1,0;;;;;;;;;;;;;38,0;2,0;;;;;;3,0;;;;;;;;;;;;;;;;2,0;6,0;;;;6,0;;;;;;;1,0;;;;;;;;;;;;;;;1,0;;;;;;2,0;;;;;;;;;;;1,0;;;;;;;;;;;;;;;;;;;;4,0;;;;;;9,0;1,0;;;4,0;;;;;;;;;;;1,0;8,0;;;;;;1,0;;;;;;;;;;;;2,0;;;2,0;;;5,0;;;;1,0;117,0;;;1,0;;;;1,0;;;;;;;;;;;;;;;;;;;;;;2,0;;;;;;;;12,0;;;;;2,0;1,0;;;;;;;;;;1,0;1,0;;;;6,0;;;;8,0;10,0;8,0;2,0;;;1,0;;;;;;;;;1,0;;;;;3,0;;;;1,0;;;;;;;;;;;;;1,0;9,0;;;;;;4,0;4,0;1,0;;1,0;;;;;;4,0;1,0;1,0;;;;8,0;;1,0;;;;;;;;;;;;;;;;;;;2,0;;;;;;;;5,0;;;1,0;;;;;;2,0;;;;;;2,0;;;;;;;;;;;;;;;4,0;;4,0;;;;;;;;;;;;;;;;;;;;;;;;;16,0;;;;1,0;;;;2,0;;;;;;;;;;;;;;;;;1,0;;;14,0;;;7,0;;;;;;;10,0;;;;;;;;;;;1,0;;;;;;
target;;;11,0;2,0;13,0;70,0;19,0;78,0;213,0;17,0;24,0;;56,0;4,0;32,0;233,0;87,0;3,0;39,0;10,0;163,0;222,0;22,0;3,0;5,0;2,0;167,0;4,0;1,0;3,0;30,0;61,0;122,0;13,0;247,0;18,0;16,0;69,0;11,0;;148,0;;45,0;22,0;211,0;70,0;365,0;259,0;76,0;103,0;10,0;216,0;2,0;15,0;180,0;23,0;63,0;3,0;28,0;;10,0;19,0;34,0;8,0;22,0;52,0;192,0;43,0;103,0;3,0;17,0;21,0;54,0;3,0;2,0;14,0;236,0;33,0;69,0;1174,0;16,0;93,0;1,0;206,0;6,0;28,0;2,0;;;26,0;142,0;;4,0;3,0;83,0;17,0;4,0;;204,0;17,0;4,0;;42,0;380,0;;7,0;71,0;8,0;61,0;27,0;15,0;47,0;3,0;;2,0;231,0;120,0;697,0;7,0;89,0;;;13,0;130,0;33,0;8,0;;;5,0;84,0;;100,0;60,0;2,0;44,0;6,0;24,0;47,0;38,0;2,0;241,0;;3,0;85,0;48,0;;;3,0;167,0;34,0;10,0;;33,0;52,0;94,0;5,0;239,0;;42,0;;18,0;25,0;361,0;2,0;6,0;;51,0;61,0;22,0;12,0;44,0;;;40,0;23,0;6,0;19,0;2,0;;;;61,0;;2,0;2,0;3,0;;21,0;1,0;1,0;5,0;13,0;;6,0;;7,0;12,0;;;17,0;;;53,0;35,0;;;;15,0;53,0;30,0;;3,0;;4,0;;;;;6,0;;2,0;;3,0;;5,0;1,0;2,0;;163,0;;133,0;;4,0;11,0;5,0;54,0;21,0;;1,0;1,0;3,0;;2,0;16,0;6,0;;;18,0;466,0;64,0;1,0;1,0;;;;1,0;114,0;43,0;7,0;1,0;1,0;;;152,0;;;13,0;;12,0;;;50,0;5,0;;9,0;;12,0;49,0;;77,0;5,0;1,0;8,0;2,0;4,0;125,0;12,0;10,0;6,0;3,0;13,0;29,0;68,0;;;3,0;16,0;;;1,0;12,0;14,0;8,0;4,0;1,0;10,0;;12,0;;2,0;;28,0;;;20,0;4,0;;;;17,0;;;;1,0;24,0;7,0;8,0;1,0;7,0;6,0;;;3,0;;;18,0;;6,0;4,0;;;;2,0;15,0;;6,0;1,0;;6,0;93,0;9,0;;;5,0;1,0;10,0;11,0;254,0;10,0;6,0;4,0;25,0;;;2,0;;;10,0;;9,0;23,0;;;6,0;;3,0;;1,0;13,0;10,0;;;8,0;;;7,0;;;10,0;5,0;3,0;;60,0;3,0;;4,0;;14,0;6,0;3,0;;;2,0;11,0;1,0;22,0;3,0;7,0;25,0;98,0;32,0;27,0;28,0;7,0;18,0;;10,0;1,0;3,0;5,0;;13,0;38,0;97,0;;4,0;2,0;58,0;;13,0;;31,0;54,0;4,0;88,0;5,0;19,0;55,0;32,0;;17,0;38,0;66,0;;1,0;10,0;20,0;;50,0;7,0;4,0;2,0;;1,0;23,0;14,0;26,0;6,0;;23,0;7,0;;;30,0;;;16,0;1,0;14,0;146,0;5,0;6,0;2,0;31,0;71,0;1,0;40,0;39,0;5,0;;31,0;11,0;20,0;48,0;117,0;1,0;;5,0;7,0;10,0;1,0;13,0;22,0;16,0;1,0;2,0;1,0;1,0;27,0;20,0;14,0;;;60,0;43,0;4,0;51,0;6,0;12,0;17,0;1,0;13,0;62,0;1,0;6,0;6,0;;;1,0;;6,0;2,0;;16,0;5,0;30,0;4,0;2,0;1,0;2,0;;3,0;;;1,0;;55,0;;1,0;;;;3,0;21,0;;24,0;12,0;16,0;;24,0;9,0;;26,0;;4,0;7,0;;;4,0;1,0;;;6,0;15,0;2,0;8,0;7,0;7,0;9,0;65,0;15,0;;21,0;;2,0;2,0;;;6,0;;7,0;1,0;;4,0;2,0;4,0;;3,0;;;77,0;8,0;27,0;5,0;5,0;;3,0;3,0;8,0;;80,0;;6,0;10,0;5,0;18,0;9,0;;;;3,0;8,0;10,0;;;;1,0;1,0;;3,0;;1,0;16,0;12,0;26,0;;133,0;3,0;;5,0;6,0;;1,0;;4,0;1,0;1,0;;4,0;2,0;4,0;21,0;24,0;3,0;20,0;2,0;;;15,0;;;1,0;;;2,0;;1,0;12,0;;;1,0;;4,0;8,0;2,0;;;11,0;1,0;;3,0;;3,0;2,0;1,0;;;;;6,0;;2,0;5,0;4,0;;29,0;13,0;30,0;;3,0;;42,0;;;;12,0;10,0;3,0;1,0;;;1,0;;5,0;2,0;;8,0;18,0;;;;;;2,0;;;1,0;;5,0;;;;;11,0;5,0;;;;1,0;10,0;3,0;8,0;11,0;;6,0;1,0;32,0;6,0;;3,0;19,0;;;14,0;;;;3,0;;;;;;;;1,0;11,0;2,0;26,0;;30,0;;;;24,0;4,0;13,0;;;1,0;;;23,0;41,0;;;9,0;11,0;15,0;24,0;31,0;9,0;3,0;3,0;19,0;5,0;30,0;1,0;3,0;5,0;8,0;2,0;;19,0;4,0;;;;10,0;23,0;1,0;8,0;1,0;16,0;2,0;3,0;;;23,0;2,0;14,0;6,0;;;;18,0;9,0;;;5,0;23,0;;2,0;2,0;2,0;;7,0;1,0;;1,0;17,0;3,0;4,0;6,0;4,0;5,0;1,0;2,0;;;4,0;8,0;;7,0;1,0;;2,0;8,0;;;1,0;;1,0;5,0;;;1,0;24,0;57,0;;1,0;7,0;1,0;;7,0;8,0;2,0;;;4,0;;8,0;;;1,0;;15,0;6,0;;;5,0;4,0;2,0;2,0;9,0;4,0;;15,0;;2,0;;19,0;1,0;;;13,0;;;19,0;;1,0;7,0;10,0;4,0;18,0;;;10,0;;;;12,0;5,0;;36,0;5,0;4,0;9,0;23,0;8,0;2,0;;6,0;4,0;;1,0;;;5,0;4,0;;;2,0;;;;;;;;;;;18,0;6,0;;15,0;;7,0;;;15,0;;3,0;11,0;;1,0;;;;4,0;6,0;1,0;1,0;3,0;4,0;4,0;;;1,0;;40,0;46,0;;2,0;1,0;4,0;3,0;;23,0;;15,0;;2,0;;3,0;;9,0;;1,0;1,0;;;2,0;;;;;;
tone;;;1,0;;;;;2,0;32,0;;;;6,0;;;14,0;;;;;4,0;13,0;4,0;;;;28,0;;;;2,0;4,0;6,0;9,0;;;8,0;83,0;2,0;;38,0;6,0;;;6,0;15,0;11,0;2,0;9,0;1,0;;;;;;2,0;;;;;;;;;;;;1,0;4,0;;;2,0;10,0;;;1,0;18,0;;;75,0;;;;16,0;12,0;;;;;;;;;;;;4,0;;15,0;;;3,0;;;;;;;1,0;;;31,0;;;;17,0;3,0;;;2,0;;;8,0;8,0;10,0;2,0;;;;8,0;;;;1,0;2,0;1,0;;;2,0;;3,0;;;17,0;;;;;2,0;;;;2,0;1,0;1,0;;5,0;;;;2,0;;4,0;;;;;6,0;;;;;;;;1,0;;;;;;;;;;19,0;;;;;;;;;;;;;;;;;;;;;;;;19,0;;;;;;;;;;;;;;;;;;;2,0;;;;1,0;;;;1,0;;;;;;;;;;;;40,0;;;;;;;;3,0;;;;;;;13,0;;;3,0;;;;;;1,0;;;;;;;;;;;;;;;;;;;;1,0;;;;;;;;;;;;;;;24,0;;;;;;;;;;;;;;;;;;;;;;;;;;;;1,0;;3,0;;;;;;;;;;;;4,0;;;;;;;;;;2,0;;;;;;;;;;;;;;;;;;;;;;;;;;;;;;;;;;;;;;;;;;;;;;;;;;7,0;16,0;1,0;;;;;;1,0;;;;;4,0;1,0;;4,0;;4,0;;7,0;;7,0;;9,0;;;1,0;;;;;;;;;1,0;13,0;;;;;6,0;;;;1,0;;;;;;;;;;;;;;;;;;;3,0;;;;;;6,0;;2,0;;;;;;;;;;;4,0;;;;;;;;;;;;;;;1,0;;;;;;;;;;;;1,0;;;2,0;;1,0;1,0;;;;;;;;;;;;;;;;4,0;;;1,0;;2,0;;;;;;;;;;;;;;;;27,0;;;;;;;7,0;;3,0;;;;;;;3,0;;;3,0;;;;;;;;;;;;;;;;;;;;;;;3,0;;;;;;31,0;;;;;;;;;4,0;;;;;;16,0;;;;;;;;;;;;;;;;;;;;;;;;;;;;;;;;;;;;;;9,0;;;;;;;;;;;;;;;;;;;;;;;;;;;;1,0;;;;;;;;;;;;;;;3,0;;;;;;;;;;;;;;;;;;;;2,0;;21,0;1,0;;;;;;;;2,0;;;;;;;;;;;;;;;;;;;;;;;;;;;3,0;;;;;;;;;;;;;;;;;;;;;;;;2,0;;;;;;;;;;;;1,0;;;;;;;1,0;;;;;;;;;;;1,0;;;1,0;;;;;;;;;;;;;;;;;;;;;;;;;;;;;;;;;;;12,0;;3,0;;;;;;;3,0;;;;;;;;;;;;;;;;;;;;;;;;;;;;;;;;;;;;;;;;;;;;;;;;;;;;;;;;;;;;;;;;5,0;;4,0;;;;;;;;;;;;;;28,0;;;;;;;;;;;1,0;;;;;;;;;;;;;;;;;;;;;;;;;;;;;;;;;4,0;;;;;;;;;
transformation;;;8,0;;1,0;7,0;;1,0;7,0;;3,0;;;;1,0;34,0;;;;1,0;19,0;2,0;1,0;;10,0;12,0;16,0;7,0;;;3,0;;14,0;;3,0;1,0;11,0;;8,0;;23,0;;33,0;5,0;;1,0;103,0;7,0;;;;4,0;10,0;;;8,0;12,0;;39,0;;;2,0;;;;;;8,0;51,0;;29,0;;14,0;;38,0;13,0;10,0;;;141,0;14,0;5,0;1,0;21,0;;6,0;;;;;7,0;;;;12,0;;1,0;;45,0;6,0;1,0;;27,0;7,0;;;3,0;1,0;3,0;35,0;;24,0;;;;31,0;14,0;16,0;;2,0;;;11,0;3,0;4,0;12,0;;1,0;;;;6,0;13,0;;2,0;1,0;66,0;;;;3,0;;;7,0;7,0;;;;4,0;;2,0;;5,0;5,0;1,0;;77,0;;;;2,0;;5,0;;;;6,0;4,0;;;7,0;;;;2,0;44,0;1,0;;;;1,0;;;;;4,0;;;;;1,0;;;2,0;;;;;;;;;3,0;;4,0;;;;2,0;;;;;;;;;;;;;;;;;;;;;;;;;;3,0;8,0;2,0;;;;1,0;;1,0;;;;1,0;;20,0;6,0;;;;;;;6,0;;;;;;;8,0;;;;;;;;7,0;2,0;;;;;2,0;;1,0;;;;;;11,0;;;;1,0;5,0;1,0;;;;;;;2,0;;;1,0;;;;;;6,0;;;;;;;4,0;10,0;;;;;;;;;;;;;;;;;;;;;6,0;;;1,0;;;;;;;;;;6,0;;;;;;;;16,0;;;;;;;;;;;;;4,0;;;;;6,0;;;3,0;24,0;;;1,0;;;2,0;;;;;;2,0;;;;;1,0;;3,0;;;;;3,0;;;;;4,0;33,0;5,0;1,0;2,0;;32,0;;;;;3,0;;;3,0;;;3,0;;9,0;;2,0;10,0;13,0;;16,0;16,0;;12,0;8,0;1,0;;;6,0;;;;;1,0;;10,0;1,0;;;;;;4,0;;3,0;;3,0;;;;;;;;;;3,0;;;;25,0;;4,0;12,0;;;;5,0;5,0;;;95,0;;5,0;1,0;2,0;7,0;;;;11,0;4,0;;;;;;;;;;2,0;;7,0;;;;16,0;1,0;;;1,0;;1,0;;;;;5,0;;;;;10,0;;;;;;;;;;9,0;1,0;;;;;;;;10,0;;;;1,0;;;;9,0;3,0;;;;;;;2,0;;;;;;;;;;5,0;1,0;;;2,0;;;;;;;1,0;;;2,0;;;;;2,0;;;;;;;;;;;;;;;;1,0;;;;;;;;;;;3,0;;1,0;;;;;;;;;;;;;;15,0;;1,0;;;;;;;;;;;46,0;;1,0;;;;;;;1,0;;;;;;;;;;3,0;;;;;;;;2,0;;;;;;;;;6,0;;;;;;;;;8,0;;;;;;;;;;;;7,0;;;;;;;;;7,0;;;;;;;;;;;;;;;;4,0;;;;;;;;;;;;;;;;;;;;;;;;;;;;;;;5,0;;;;;;;;;;;;;;;;3,0;;;290,0;4,0;;;;;2,0;3,0;;21,0;;6,0;;;;;6,0;;;;5,0;;5,0;;;1,0;;6,0;;;;;;;;1,0;;;;;;1,0;;;;3,0;;;;;;;;;;;2,0;;;;;3,0;;7,0;1,0;;;;;2,0;;;1,0;;;8,0;1,0;;;;;;;;;;;;;;;1,0;24,0;;;;;;;;;;;1,0;;;2,0;2,0;;9,0;;;;;;;;;;;;3,0;;;;;18,0;;;;;;;;;;;;;;;2,0;10,0;;;;;;;;;6,0;;4,0;;;;;;;;;;;;;4,0;;2,0;;;;;;;;;;2,0;;;;;;;;4,0;11,0;;;;5,0;;;;;;;;;;1,0;;27,0;;;;;;;;;1,0;;;;;;;;;
translation;;;2,0;;;;;33,0;2,0;1,0;;;17,0;;7,0;18,0;;;;12,0;1,0;;;2,0;1,0;;15,0;5,0;;;3,0;;5,0;;4,0;;1,0;;1,0;;2,0;;29,0;4,0;1,0;;47,0;31,0;;7,0;2,0;10,0;1,0;;10,0;;1,0;9,0;15,0;;6,0;5,0;;;6,0;;;10,0;5,0;;5,0;;4,0;;;2,0;;;;42,0;;30,0;2,0;33,0;;3,0;;;2,0;;1,0;;;;;4,0;;5,0;19,0;;5,0;;;2,0;;;1,0;3,0;;39,0;;1,0;;;;9,0;1,0;15,0;;1,0;;;;2,0;2,0;2,0;;;;3,0;;5,0;17,0;;1,0;;1,0;;1,0;;2,0;;1,0;4,0;;;;;1,0;;1,0;;16,0;15,0;;;27,0;;1,0;;6,0;;7,0;;;;;1,0;;;;;;;1,0;5,0;1,0;;;;;;;;;4,0;;2,0;;;;;;4,0;;2,0;;2,0;;;;2,0;1,0;11,0;10,0;;;;;;;;1,0;;3,0;;3,0;;3,0;;;;1,0;;;;;;1,0;;42,0;;;3,0;1,0;8,0;3,0;;;;;;;2,0;;;;;7,0;;21,0;;;;;;7,0;;;;;;;9,0;;;2,0;;;;1,0;1,0;;;;;;1,0;;;7,0;;;;;7,0;;;2,0;;;5,0;;;;;;;;;1,0;2,0;;;;;;;;1,0;;;;;;;;;;2,0;;;;;2,0;;4,0;;;;;;;;;2,0;;;;;;;;;2,0;;;3,0;1,0;2,0;;7,0;;;;;;42,0;;;;;;;;;;;1,0;;;;;;4,0;;;;;94,0;2,0;;;;;1,0;;;;7,0;;;2,0;;;2,0;;;;;;;2,0;;;;;8,0;;7,0;1,0;47,0;;;;1,0;;;;;;;;;;;2,0;;;;8,0;9,0;;;7,0;;;;2,0;;1,0;4,0;5,0;;;1,0;3,0;;;;;;;;1,0;2,0;4,0;;;7,0;;;;1,0;;;;;2,0;1,0;1,0;;;;6,0;;52,0;;;;1,0;;;;25,0;;1,0;;1,0;;;;;6,0;5,0;;;;1,0;;10,0;;;;1,0;;;;;16,0;8,0;2,0;;;;;;;3,0;;;;;;;5,0;;;6,0;1,0;;;1,0;3,0;;;2,0;;;;;2,0;;;;;;2,0;;;;;1,0;;;;;;1,0;;;;;;;35,0;;;;;2,0;1,0;;;;;;;49,0;2,0;;;;;;;;;;14,0;;;;;;;;;;;9,0;;;;;;;;2,0;;;;;;;;;;;;;2,0;;2,0;2,0;;2,0;;;;;;;;;;;2,0;3,0;;;;;;;;;;;;;;;2,0;;;;;;;;;;1,0;;1,0;;;;;;;;;;;;2,0;;;;;5,0;;;3,0;;;;;;;;;;;2,0;;;4,0;;;;;;;;;;;;;;;;;;1,0;;;;;;;;;;;;;;;;;;;;;;;;;;;;;;;1,0;;;;;;;;;;1,0;;;;;;3,0;;;;;;;;;3,0;;;;;93,0;;;;;;;;;;;5,0;;46,0;;;;;;;2,0;;;3,0;;;;;1,0;;;;;;;;;;;;;;;;;;;;;;;1,0;;;;;;;;;;;;2,0;;;;;;;;;;2,0;;8,0;;;;;;;;;;;;1,0;;;;;;;;;;2,0;;;;;2,0;1,0;;;;;;1,0;;;;;;;;;;;;;;;;;1,0;;;;;;;;;;;;1,0;;;;1,0;;;6,0;;;;;;;;;;;;;;;;;;;;;;;;;;;;;;;;;;;;;;;;;;;;4,0;;;;;;;;;;;1,0;;;29,0;;;;2,0;;;;;;;;;;;;;;
user;;;2,0;48,0;66,0;24,0;9,0;141,0;75,0;19,0;3,0;;156,0;23,0;29,0;346,0;3,0;;1,0;4,0;20,0;290,0;22,0;3,0;1,0;;22,0;13,0;;1,0;80,0;12,0;268,0;;502,0;66,0;12,0;15,0;19,0;6,0;324,0;3,0;33,0;9,0;154,0;23,0;298,0;827,0;185,0;667,0;18,0;41,0;;;4,0;2,0;90,0;2,0;24,0;8,0;30,0;9,0;34,0;15,0;12,0;9,0;54,0;25,0;60,0;14,0;157,0;;106,0;;3,0;23,0;69,0;11,0;3,0;1070,0;;45,0;12,0;272,0;4,0;165,0;11,0;;1,0;10,0;38,0;24,0;9,0;4,0;4,0;37,0;43,0;2,0;466,0;130,0;38,0;23,0;124,0;150,0;1,0;56,0;16,0;23,0;115,0;59,0;8,0;154,0;;6,0;1,0;194,0;173,0;279,0;26,0;54,0;14,0;;21,0;181,0;110,0;33,0;1,0;;;28,0;12,0;36,0;53,0;2,0;36,0;9,0;10,0;227,0;3,0;3,0;87,0;16,0;38,0;86,0;100,0;;;28,0;132,0;45,0;62,0;;33,0;138,0;34,0;12,0;394,0;;13,0;28,0;33,0;65,0;171,0;2,0;;;111,0;179,0;6,0;2,0;38,0;;2,0;5,0;11,0;11,0;12,0;;1,0;4,0;2,0;109,0;;1,0;;32,0;;17,0;6,0;1,0;2,0;2,0;;30,0;;10,0;89,0;2,0;1,0;4,0;5,0;5,0;2,0;88,0;2,0;;1,0;4,0;16,0;94,0;2,0;1,0;1,0;;16,0;;;;13,0;1,0;21,0;;;2,0;;4,0;8,0;;43,0;;36,0;;8,0;21,0;4,0;31,0;74,0;30,0;9,0;;3,0;24,0;;12,0;;;;60,0;16,0;10,0;5,0;;;16,0;;;623,0;5,0;;;;;5,0;517,0;;;9,0;;37,0;;7,0;36,0;31,0;;3,0;;22,0;9,0;;17,0;38,0;14,0;10,0;;;66,0;2,0;74,0;1,0;;46,0;20,0;10,0;;4,0;;4,0;;4,0;;9,0;182,0;5,0;;4,0;;2,0;9,0;2,0;;;3,0;2,0;;13,0;;3,0;3,0;;42,0;;;;1,0;8,0;5,0;6,0;12,0;3,0;28,0;1,0;1,0;;3,0;2,0;1,0;7,0;13,0;18,0;12,0;;;15,0;12,0;8,0;6,0;30,0;3,0;4,0;38,0;;2,0;7,0;;;10,0;26,0;63,0;56,0;4,0;23,0;13,0;;1,0;;;;;3,0;;17,0;1,0;2,0;49,0;5,0;1,0;11,0;6,0;16,0;32,0;2,0;;1,0;1,0;;2,0;;;;30,0;;71,0;9,0;3,0;;13,0;;7,0;6,0;;1,0;5,0;78,0;32,0;5,0;1,0;;;7,0;11,0;91,0;20,0;13,0;3,0;91,0;;1,0;3,0;;1,0;8,0;29,0;1,0;8,0;5,0;5,0;5,0;53,0;;33,0;;1054,0;23,0;3,0;131,0;;24,0;19,0;184,0;2,0;22,0;85,0;28,0;11,0;68,0;97,0;277,0;4,0;56,0;12,0;55,0;;;38,0;6,0;87,0;144,0;35,0;3,0;13,0;19,0;47,0;12,0;11,0;6,0;3,0;21,0;3,0;11,0;51,0;;;29,0;40,0;;5,0;8,0;2,0;2,0;3,0;61,0;15,0;14,0;11,0;17,0;5,0;8,0;12,0;25,0;27,0;;32,0;15,0;24,0;4,0;3,0;20,0;47,0;1028,0;1,0;13,0;13,0;23,0;41,0;92,0;;;;3,0;13,0;15,0;181,0;3,0;16,0;13,0;7,0;3,0;;19,0;37,0;3,0;72,0;;26,0;24,0;4,0;35,0;1,0;59,0;5,0;50,0;6,0;36,0;12,0;8,0;;118,0;3,0;41,0;5,0;38,0;2,0;25,0;1,0;30,0;10,0;11,0;112,0;;200,0;1,0;31,0;13,0;38,0;11,0;;12,0;1,0;;68,0;4,0;17,0;2,0;12,0;4,0;166,0;10,0;67,0;22,0;;3,0;19,0;8,0;2,0;10,0;148,0;;8,0;6,0;19,0;18,0;6,0;9,0;3,0;13,0;;95,0;87,0;10,0;6,0;7,0;23,0;6,0;6,0;10,0;1,0;22,0;19,0;7,0;;30,0;5,0;34,0;101,0;;34,0;15,0;;3,0;;19,0;24,0;;7,0;8,0;5,0;;10,0;8,0;3,0;;8,0;3,0;21,0;40,0;;69,0;10,0;2,0;11,0;4,0;;3,0;10,0;40,0;37,0;16,0;4,0;11,0;1,0;5,0;9,0;9,0;1,0;6,0;25,0;6,0;2,0;53,0;52,0;;58,0;5,0;2,0;18,0;3,0;;1,0;2,0;1,0;;;;1,0;2,0;;;7,0;;;9,0;7,0;1,0;5,0;1,0;;;;;9,0;16,0;36,0;71,0;4,0;1,0;20,0;21,0;;;;2,0;1,0;;4,0;12,0;10,0;;4,0;5,0;;1,0;;37,0;9,0;;8,0;2,0;4,0;16,0;;4,0;;2,0;3,0;13,0;;;3,0;;;;;;;16,0;;;;;2,0;;2,0;7,0;8,0;2,0;4,0;3,0;5,0;29,0;14,0;63,0;;;10,0;;;1,0;;;1,0;;1,0;;;;2,0;1,0;1,0;19,0;2,0;;;;3,0;5,0;4,0;3,0;;;16,0;;1,0;4,0;19,0;;2,0;;;;3,0;3,0;148,0;;;17,0;2,0;11,0;2,0;;32,0;5,0;;;5,0;7,0;;;;14,0;5,0;4,0;1,0;7,0;1,0;6,0;3,0;;;2,0;19,0;10,0;1,0;;22,0;;1,0;11,0;;;2,0;9,0;3,0;4,0;11,0;1,0;;;3,0;2,0;;3,0;3,0;;3,0;4,0;4,0;11,0;;;9,0;;5,0;5,0;2,0;64,0;48,0;11,0;8,0;;4,0;11,0;20,0;3,0;1,0;20,0;6,0;3,0;29,0;15,0;;12,0;;;;;40,0;39,0;1,0;2,0;;2,0;1,0;;;;;23,0;;5,0;9,0;4,0;2,0;;4,0;11,0;1,0;;2,0;13,0;;3,0;11,0;82,0;;;;1,0;6,0;3,0;25,0;1,0;12,0;12,0;4,0;5,0;;;2,0;;;;3,0;;1,0;;22,0;;2,0;;17,0;1,0;;;2,0;;2,0;;;1,0;;1,0;1,0;;99,0;;;;2,0;1,0;7,0;2,0;;3,0;4,0;3,0;;10,0;;1,0;1,0;;;1,0;;1,0;26,0;;1,0;;;;;5,0;3,0;35,0;4,0;1,0;6,0;;8,0;;;1,0;;;3,0;;20,0;;;6,0;14,0;;4,0;;;;;16,0;3,0;;;;1,0;;;;;25,0;2,0
utilize;;;2,0;1,0;;4,0;;5,0;4,0;;8,0;;4,0;;3,0;3,0;;;1,0;;;7,0;;4,0;;;6,0;1,0;;2,0;3,0;;7,0;;16,0;2,0;1,0;2,0;1,0;;35,0;;2,0;7,0;4,0;2,0;5,0;37,0;7,0;3,0;;5,0;;;;;4,0;2,0;2,0;;;;;2,0;6,0;2,0;1,0;6,0;3,0;1,0;5,0;;3,0;;;1,0;6,0;;4,0;68,0;1,0;17,0;;13,0;;;;;;;9,0;;;2,0;4,0;;4,0;;37,0;1,0;4,0;;8,0;13,0;;;8,0;1,0;8,0;2,0;;;;;;8,0;7,0;8,0;2,0;1,0;1,0;1,0;;9,0;2,0;1,0;2,0;3,0;1,0;2,0;;3,0;3,0;1,0;;3,0;;;1,0;;2,0;;1,0;8,0;;;;;8,0;3,0;1,0;2,0;4,0;6,0;1,0;2,0;41,0;;;2,0;3,0;2,0;10,0;;;;9,0;3,0;2,0;;;;;;3,0;;1,0;;;;1,0;;;;;7,0;;5,0;;;;4,0;;1,0;;;;;;;;1,0;3,0;;;;;1,0;3,0;3,0;;;;;;;;;;;;;;;;;;;11,0;;;;1,0;5,0;;;;;;;;;;1,0;1,0;;;;2,0;2,0;;;;;;;11,0;;;;;;2,0;7,0;;;;;;;;5,0;;;;;;2,0;;3,0;1,0;;;;;;5,0;1,0;;;4,0;;;;;;;;;;;2,0;1,0;;;;;;;;;;;;;1,0;;;;2,0;;;;;;1,0;;;;;;;;;;1,0;;;1,0;;;;;;;;2,0;4,0;1,0;2,0;;;1,0;1,0;;;;4,0;;;;;;;;1,0;;;;1,0;4,0;2,0;;;;;1,0;;;1,0;1,0;;;1,0;;2,0;;;;13,0;;1,0;1,0;;;;;;;;3,0;;1,0;1,0;;;;;;6,0;2,0;1,0;;;2,0;;1,0;;;1,0;1,0;;1,0;;3,0;;;1,0;;1,0;;7,0;3,0;1,0;3,0;;3,0;3,0;;;12,0;38,0;2,0;;9,0;2,0;2,0;;4,0;;;;;;;4,0;;3,0;2,0;;4,0;1,0;1,0;2,0;;;;;2,0;2,0;;;;;5,0;;10,0;1,0;;;1,0;;1,0;2,0;1,0;;;;;;1,0;;5,0;;;3,0;2,0;;3,0;;3,0;1,0;1,0;;2,0;1,0;;1,0;;;;1,0;;;1,0;;;;2,0;;2,0;;1,0;4,0;;;1,0;2,0;;;;;;2,0;;;1,0;3,0;;;;;;;;;;2,0;;;;;;;;1,0;1,0;;;2,0;1,0;;;4,0;;4,0;;1,0;2,0;;3,0;2,0;;;;;;;;;;;2,0;;1,0;;;2,0;1,0;;;;;;;;;;2,0;;4,0;;4,0;2,0;;1,0;;;;;;1,0;;;;;;;;;;;;3,0;1,0;;5,0;;;;1,0;;;1,0;;2,0;;;2,0;;1,0;1,0;1,0;;;;;;;1,0;;16,0;;;;;1,0;;;;;;;;;;1,0;;;2,0;;;;;;;;;;;;;;;;;2,0;;;;;;;;;4,0;;;;;;;;;;;1,0;2,0;;;;;;;;;;;;;;1,0;;1,0;;1,0;;1,0;1,0;1,0;1,0;;;;;2,0;;;;;4,0;;;;;;;;;;;;;;;;;;2,0;;;;;;;;;;;3,0;;;;1,0;;;;;;1,0;;1,0;;;;;;;;3,0;;4,0;;;3,0;;;1,0;;;;4,0;;;;;8,0;;;9,0;;;;4,0;;;;;2,0;1,0;;;;5,0;;3,0;;;;;;;;;;3,0;;;;;;7,0;;;;;1,0;;;;;;;3,0;;;;;4,0;;;;;;;2,0;;;;;;1,0;;;;;;;;1,0;;;;1,0;;;;;;;;;;;;;;;;1,0;;;;;3,0;;;;;;4,0;;1,0;;2,0;;;;;;;;;;;1,0;;1,0;;;;;;;;;;;;;;;;6,0;2,0;;;;1,0;;;1,0;6,0;;;;;;;;;;;;2,0;;;;;;;;;;4,0;;;;;;1,0;;;;;;;;;;;;;;;;;;;
variable;;;38,0;1,0;;17,0;18,0;7,0;14,0;13,0;3,0;2,0;10,0;;38,0;17,0;;;;;4,0;15,0;;;;1,0;8,0;5,0;1,0;;;27,0;6,0;;26,0;5,0;1,0;;;1,0;4,0;;9,0;;11,0;2,0;20,0;12,0;9,0;;4,0;22,0;;;1,0;;17,0;;5,0;;;;1,0;;3,0;29,0;22,0;9,0;12,0;5,0;25,0;;8,0;1,0;;13,0;1,0;1,0;4,0;79,0;4,0;19,0;;38,0;6,0;3,0;;;;40,0;165,0;;;1,0;1,0;2,0;;2,0;47,0;1,0;;;12,0;25,0;;;54,0;5,0;7,0;17,0;;2,0;;;;21,0;3,0;13,0;17,0;1,0;;10,0;7,0;14,0;9,0;1,0;;15,0;1,0;23,0;1,0;7,0;3,0;;13,0;3,0;9,0;;;4,0;3,0;;;18,0;18,0;;;25,0;43,0;9,0;1,0;;3,0;4,0;4,0;5,0;51,0;;1,0;1,0;1,0;;69,0;;47,0;2,0;3,0;29,0;;;27,0;;;4,0;2,0;6,0;6,0;;;;;2,0;7,0;;;14,0;;10,0;;;;1,0;;19,0;;;1,0;;;;;;;25,0;;;2,0;;5,0;;;;3,0;;;;;;4,0;;9,0;3,0;;;;;4,0;2,0;13,0;;46,0;1,0;;1,0;;6,0;;1,0;;;;;;2,0;;;;;25,0;;;;1,0;;1,0;3,0;3,0;;;6,0;;;;3,0;;;;;4,0;;;11,0;3,0;;;;;2,0;3,0;17,0;;;6,0;59,0;;11,0;;2,0;;1,0;8,0;2,0;2,0;1,0;;;1,0;;;;3,0;4,0;3,0;2,0;;;;2,0;;;;1,0;;;;3,0;;;;5,0;;;2,0;;10,0;;;;;3,0;;;;;;4,0;;;5,0;;;;;7,0;5,0;5,0;;6,0;1,0;;;;;;;8,0;;10,0;1,0;2,0;;1,0;;;;;;3,0;;;6,0;2,0;;;;;;;;;;;;8,0;;15,0;;;4,0;1,0;;2,0;2,0;;2,0;;;1,0;1,0;2,0;;;;1,0;;;3,0;;1,0;7,0;3,0;;;;1,0;2,0;1,0;1,0;13,0;;;2,0;4,0;;9,0;;;1,0;2,0;;;10,0;9,0;11,0;1,0;;;10,0;3,0;;;5,0;1,0;;;4,0;1,0;6,0;;1,0;8,0;;;;9,0;;;;;;;;;2,0;;1,0;;;20,0;;;;;;4,0;;;;7,0;;16,0;;;3,0;;;;;3,0;;;;;;4,0;;;;1,0;;1,0;;1,0;1,0;1,0;;;;;;;;;1,0;;;;;6,0;;;2,0;;4,0;;;3,0;;;;;;;;;;5,0;;;;;;;3,0;;;8,0;;;2,0;;;;;;;;;;13,0;;1,0;2,0;3,0;1,0;1,0;;;;1,0;1,0;;;;;1,0;;;;;1,0;;;;17,0;34,0;;;;;;;;3,0;;;;;1,0;;5,0;;2,0;;;3,0;;;;2,0;;;;;;;;;;;;;;;;;8,0;;;;2,0;;;;2,0;;;;;;1,0;;;;;;;;6,0;;;;;;10,0;;;;;;;;;;2,0;;1,0;;;4,0;3,0;;1,0;;;;;;;;;2,0;;;;;;1,0;;1,0;1,0;;;1,0;;;;4,0;;;;;11,0;;;;1,0;;;;;;;3,0;;2,0;;;1,0;;2,0;;2,0;;2,0;;2,0;;;;;;1,0;;;;8,0;;;2,0;;;3,0;;;;;;;;;;;;;;2,0;;;;;21,0;1,0;;2,0;;;1,0;;;;2,0;;;;;;;;3,0;;;;;;1,0;;;4,0;7,0;;;11,0;;;;;;;1,0;1,0;;;4,0;;;;1,0;3,0;;61,0;12,0;;8,0;;;;;;;1,0;1,0;;;;1,0;3,0;;;;1,0;;2,0;;;;;;;;2,0;;;4,0;;;;;;;2,0;;1,0;3,0;1,0;;1,0;;6,0;;;;;;;;;;;;;;1,0;;1,0;;;;;;;;7,0;;;;;;;;;;;;;;11,0;;8,0;;;;;1,0;;;;;;1,0;;;1,0;;;;11,0;1,0;;;;;;;;;;;2,0;2,0;1,0;5,0;1,0;;;;;1,0;;;;;1,0;;;;;;;1,0;;;;;;;;;;;5,0;;;2,0;;;1,0;;1,0;;;;;2,0;2,0;;;;;;;16,0;;;;;;;;;3,0;;;;;;;;;
water;;;1,0;;;1,0;;4,0;2,0;2,0;;;;;;4,0;3,0;;;;;1,0;;13,0;;2,0;;;;;;3,0;9,0;;10,0;1,0;;2,0;;;2,0;;;2,0;10,0;8,0;1,0;9,0;12,0;16,0;;4,0;;;;;;;;;;8,0;1,0;;;;9,0;4,0;;9,0;;;9,0;2,0;;;10,0;1,0;3,0;31,0;2,0;;;2,0;;4,0;;;;;13,0;;;3,0;;1,0;;;6,0;;;;4,0;49,0;;2,0;;5,0;;;6,0;1,0;;1,0;;;16,0;2,0;2,0;2,0;6,0;;;;4,0;;;;;4,0;;;3,0;;2,0;;;;;;;1,0;;2,0;;;;16,0;6,0;;;;4,0;27,0;;43,0;6,0;;;;;;;;;;;;;;;2,0;;5,0;4,0;;;;;;;34,0;;1,0;;;;;;;;;;;;;;;;1,0;;;;4,0;;;;;;;;;4,0;7,0;;;;;;;12,0;;;;;;1,0;;8,0;;2,0;;;1,0;;;2,0;37,0;1,0;;;;;4,0;;;;;2,0;;1,0;;;;8,0;7,0;2,0;3,0;;7,0;;;;;;;;;;;;;;;2,0;;;;;51,0;3,0;;;;;;;;;1,0;25,0;;;;2,0;;2,0;;;;3,0;1,0;;;;;;3,0;;;;;;;5,0;;;;;;;;2,0;;;;;;;2,0;;;;;;;;;;;;;;;10,0;;;2,0;;;;;;3,0;;;;;1,0;;;1,0;;11,0;;;;2,0;;1,0;;;;1,0;;;;;;;;;;;;;;;;4,0;;3,0;;;;;;;1,0;;;;;;1,0;;;;;;;;;;;;;;;;;;;;;;1,0;1,0;;;;;;;;;;;8,0;;5,0;4,0;1,0;;;;4,0;;;;;;;;;1,0;1,0;;;;2,0;;;4,0;;;;3,0;;;;3,0;;;;;;;;;5,0;;;;;;;;;;7,0;3,0;;;;;;;;;;;;6,0;;;;;;;;;;;;;;;;;;1,0;;;;;;;;;;;1,0;;;;;;;;;;;;;;;;;;;;;2,0;;;1,0;;;;;2,0;;8,0;;;;;;;;;4,0;;;;;6,0;1,0;2,0;;;;;;;;;1,0;;;;;1,0;;;;;;2,0;1,0;;;;;;;7,0;;;;;;;;;;;;;;;;;;;5,0;1,0;1,0;28,0;;;;;;;;;;;;;;;;;;;;;;;;2,0;;;;;;;;;;;;;2,0;;;;;;;;;;;;;;;;1,0;;;;;;;4,0;;;;;;;;;;;7,0;;3,0;;;;;;;;;;;;;;;;;;;;;7,0;;;;;;1,0;2,0;;;;;;;;;;;;;;;;;;;;36,0;;;6,0;;;;;4,0;;;;;;;;;;;;1,0;;;;;19,0;;;;2,0;;;;;;;;;;;;;;;;5,0;;;;;;7,0;;;;;;;;;;;;;;;;4,0;;;;;;;;;;;;;;;;;;;1,0;;;;2,0;;;;;5,0;3,0;;;;;;;;;;;;;;;;;;;2,0;;;;;;;;;;;;;;;;;;;1,0;;;;;;;;;;;;;2,0;;2,0;;;;;;;;;;;;;;3,0;;;;2,0;;;;;;;;;;;;;;;;;;;;7,0;;;;;;;;;;;;;;;;;;;;;;;;;;9,0;;;;;;;;;;;;;;;;;1,0;;;;;;1,0;;;;;;;;;;;;;
acquisition;;;;2,0;1,0;13,0;6,0;67,0;5,0;;1,0;;4,0;1,0;6,0;27,0;5,0;1,0;39,0;2,0;2,0;23,0;;;5,0;2,0;6,0;;;;5,0;1,0;96,0;;54,0;12,0;6,0;41,0;;;111,0;2,0;7,0;;7,0;13,0;16,0;72,0;15,0;6,0;6,0;20,0;6,0;;15,0;;10,0;;;;;19,0;1,0;;3,0;;10,0;10,0;8,0;;8,0;12,0;15,0;2,0;2,0;2,0;2,0;1,0;53,0;410,0;1,0;26,0;;30,0;;7,0;3,0;;;;52,0;;;;4,0;4,0;7,0;;35,0;2,0;;;10,0;34,0;3,0;12,0;43,0;1,0;17,0;18,0;1,0;9,0;;;;29,0;29,0;32,0;1,0;49,0;1,0;;4,0;13,0;6,0;5,0;;;;3,0;;5,0;;;;2,0;1,0;;;;11,0;1,0;3,0;32,0;;;;9,0;20,0;;;;2,0;2,0;42,0;7,0;78,0;;;;;11,0;296,0;;1,0;;17,0;4,0;1,0;10,0;1,0;;;3,0;12,0;;3,0;;;;1,0;28,0;;;1,0;1,0;;9,0;25,0;;;;;2,0;;4,0;4,0;1,0;;;;;6,0;2,0;20,0;;;;9,0;2,0;;;2,0;;;;;1,0;2,0;;12,0;;;;;;;;39,0;;;;;1,0;;1,0;2,0;14,0;2,0;;2,0;;2,0;22,0;9,0;;;;4,0;2,0;;;;;;;13,0;;1,0;;;;;4,0;;;;;4,0;;;64,0;;;;;16,0;5,0;;19,0;1,0;;5,0;;;92,0;;;;;8,0;;;;;;1,0;;;;;5,0;;;;;;4,0;;1,0;;2,0;5,0;;1,0;;;2,0;;5,0;;;;;2,0;;;;;;;;;;;2,0;;2,0;;;;;;;;;;;2,0;4,0;;;1,0;18,0;;;;4,0;4,0;;;;;;;;;;;;1,0;;;1,0;1,0;;;;;2,0;;;2,0;;;1,0;;;;;1,0;6,0;;;;15,0;;1,0;2,0;2,0;;;8,0;4,0;;;;;3,0;5,0;6,0;1,0;1,0;1,0;;;;4,0;;1,0;;;4,0;2,0;;;;;1,0;;;13,0;10,0;1,0;;;;2,0;4,0;;3,0;2,0;5,0;;5,0;4,0;5,0;;;4,0;1,0;;;2,0;13,0;4,0;16,0;;;;;1,0;1,0;2,0;;;;;;;;;2,0;;3,0;2,0;14,0;;2,0;;;;;1,0;2,0;;;;;2,0;;23,0;;;;;;;5,0;;1,0;1,0;1,0;5,0;1,0;3,0;;;;;;1,0;;;5,0;;;1,0;;3,0;;2,0;;4,0;;;;;;2,0;1,0;;;;;;;1,0;2,0;2,0;;;;;;;3,0;6,0;;2,0;;;5,0;30,0;2,0;;;;;;9,0;;;;;6,0;1,0;19,0;4,0;;6,0;1,0;;;;;;;;;;;;;6,0;1,0;;;;;10,0;7,0;;;;1,0;1,0;;;;1,0;;1,0;2,0;1,0;8,0;2,0;;;;;;;;;;;;;1,0;;8,0;;7,0;;;10,0;;;7,0;;;1,0;;3,0;;;;;;3,0;;;;;;;1,0;;33,0;12,0;;;;;;;;;;;;1,0;1,0;1,0;;2,0;6,0;;2,0;4,0;;12,0;2,0;;;;;1,0;;;;;;;;;;;1,0;;;;;;;;;;;;;;;2,0;6,0;;10,0;;;;;1,0;;1,0;;;;;;;3,0;;;;;;;2,0;;;;;2,0;2,0;2,0;;;;4,0;;;;;;;;2,0;;;;;;;;;2,0;;;;;;;;2,0;2,0;;1,0;;;1,0;;2,0;;;;;;;;;;;;;5,0;1,0;;;4,0;11,0;;;4,0;;;;;;1,0;;;;1,0;;;;;6,0;2,0;;;;;;;;;;;;1,0;;1,0;25,0;1,0;1,0;1,0;1,0;1,0;3,0;1,0;2,0;15,0;2,0;1,0;3,0;4,0;3,0;2,0;3,0;1,0;2,0;6,0;;;;;;;;;;;;;;;;;;;;;;;;;;;;;;;;;;;;;;;;;;;;;;;;;;;;;;;;;;;;;;;;;;;;;;;;;;;;;;;;;;;;;;;;;;;;;;;;;;;;;;;;;;;;;;;;;;;;;;;;;;;;;;;;;;;;;;;;;;;;;;;;;;;;;;;;;;;;
activity;;;;3,0;61,0;;;1,0;2,0;;;;3,0;;;37,0;;;;;;6,0;;;;;;6,0;;;1,0;3,0;1,0;;1,0;6,0;;;2,0;;8,0;;2,0;;64,0;1,0;12,0;3,0;;7,0;;1,0;;;;;;1,0;;;;2,0;2,0;;;;1,0;;;;;;18,0;;;;6,0;;;6,0;;;;62,0;;13,0;;;;1,0;;;;;;6,0;;;33,0;1,0;;;;3,0;;;;5,0;1,0;;;;;;;;;1,0;;3,0;;;1,0;;5,0;3,0;;;;;;;;;1,0;;;19,0;;;4,0;;;5,0;;;;;9,0;;;;;6,0;9,0;;13,0;;;;1,0;;;;;;8,0;5,0;;;11,0;;;9,0;;5,0;;;;;2,0;;;;;1,0;;1,0;;;;;;;;;;;;;;;;;;;;;;;;;;;;;;;;;2,0;;;;;;;;;;;;;5,0;;;1,0;;;;;;;;;;;;;;;;;;;;4,0;;;;;;;;;;;;;;;;;;1,0;;;;;1,0;;;2,0;;;4,0;;;;1,0;6,0;;;;;5,0;;;;;;;;;;;;;;;;;;;;;;;;;;;;;;;1,0;;;;;;;;;5,0;;;;;;;;;1,0;;;11,0;;;;;;;;2,0;1,0;;1,0;;;;;;;;;;;;3,0;;;;;;;;;;;;;;;;;;;;;;;;;;;;;;;;;;4,0;;;;;4,0;11,0;;5,0;;;;;;;;;;7,0;2,0;;1,0;1,0;;;2,0;;;7,0;;4,0;;;;;;18,0;1,0;;;74,0;;;1,0;;2,0;;;;;;3,0;1,0;;;;4,0;;;;;;;;2,0;4,0;;;6,0;1,0;48,0;;;;;;;;1,0;;;;;;;;;;;;;;;;;;2,0;;;1,0;;;;;;9,0;4,0;;;;;5,0;;;;;;4,0;;;;;1,0;;;;;;;;;;2,0;;;;;;;;;2,0;;;;;;;;1,0;;;1,0;;;;;;;;;;;1,0;;;;1,0;;;;;;4,0;;;7,0;;;;;;62,0;;;;;;;;;;;6,0;;;;;;12,0;;;3,0;;;;;;;;;;;1,0;;;;;;;;;3,0;;;;;;6,0;;6,0;5,0;;;;;;;;;;;;;2,0;;;;;;;;;;;;;;;;;;;;;;;;;;;;;;;;;;2,0;;;;;;;;8,0;;;;;;1,0;;;;;;;;;;2,0;;;;;;;;;;;;;;;;;2,0;;;;;;;;;;;;;;;;;;;;;;;;;;;;2,0;;;;;;;;;;;;;1,0;;;;;;;;14,0;;;;;;;;;;;;;;;4,0;;;;;;;2,0;;;;;;;;;;;;;;;;;1,0;;;;1,0;;;;;;;;;;;;;;;;;;;;;;;;;;;;;9,0;;;;;6,0;;;1,0;;;;;4,0;1,0;;;;;;;;;;;;;;;12,0;;;;;;;;;;;;;;;;;;;;;;;;;;;1,0;1,0;1,0;2,0;2,0;;;;;;;;;;;;;;;;;;;;;;;;;;;;;;;;;;;;;;;;;;;;;;;;;;;;;;;;;;;;;;;;;;;;;;;;;;;;;;;;;;;;;;;;;;;;;;;
actuate;;;;3,0;;1,0;;2,0;;17,0;9,0;;;;4,0;2,0;;;;;1,0;13,0;;;1,0;;;;;;;;8,0;;29,0;4,0;;;;;4,0;;2,0;;;2,0;2,0;86,0;;2,0;1,0;3,0;;;8,0;;54,0;;;;8,0;;1,0;;;1,0;10,0;5,0;2,0;2,0;;10,0;14,0;;1,0;;1,0;;;15,0;;13,0;;19,0;;1,0;1,0;;;;21,0;;;;;;;;10,0;4,0;7,0;;7,0;;;2,0;12,0;2,0;1,0;;;2,0;;;;2,0;1,0;111,0;1,0;6,0;4,0;;;1,0;2,0;;1,0;;;;;;1,0;;;;;9,0;;;;;;10,0;1,0;;;;27,0;;;;1,0;3,0;;;48,0;;2,0;;;1,0;11,0;;;;14,0;3,0;;;3,0;;;;;2,0;7,0;2,0;;;;;;;;1,0;;13,0;;;2,0;;;21,0;1,0;;;;;;;6,0;;1,0;;;;;;;;;;;;;;;;;26,0;;7,0;;;;;4,0;;;20,0;;;7,0;10,0;50,0;19,0;20,0;;4,0;;1,0;1,0;2,0;;;;;;2,0;;;;;;;6,0;;2,0;;;;;;;1,0;1,0;;15,0;;3,0;2,0;;;;2,0;3,0;7,0;;9,0;12,0;;;;;6,0;;;;;1,0;;;;4,0;3,0;;;;;63,0;;;;;;3,0;5,0;2,0;;;3,0;;;5,0;;;1,0;;13,0;2,0;;;;4,0;;;;;;;;;;;;;2,0;7,0;;1,0;;6,0;;;;5,0;3,0;;1,0;;4,0;;;2,0;1,0;3,0;;;;;20,0;;;;;;;;;;7,0;;1,0;;;1,0;;1,0;;1,0;;;29,0;;;;;;8,0;;2,0;;;;1,0;;;;;;;;;;;;;1,0;2,0;4,0;;;;1,0;;;;1,0;;;;;;;;;;;;;3,0;;;;;;;;;;;11,0;;;14,0;6,0;;;;;;;;;3,0;4,0;;;;1,0;;;;;;;;;;;6,0;;;11,0;1,0;;2,0;;;10,0;1,0;;;;;;;;;;;;;1,0;;;;4,0;;18,0;;2,0;;9,0;;;;;;1,0;;;;;;;;;;;1,0;;1,0;;;;;;;;;7,0;;;;1,0;;6,0;2,0;;1,0;;;;1,0;;10,0;;;;;;4,0;;;;;;10,0;;;;;;1,0;;1,0;;;;;1,0;;;1,0;1,0;5,0;;;;1,0;;;3,0;;;;15,0;1,0;;;;;;;;2,0;;;1,0;;1,0;1,0;;;1,0;;;;;;;;;;7,0;;;1,0;;;;;;;5,0;;;;;;;;;;2,0;;;1,0;;;;1,0;;;;;;;2,0;1,0;;;5,0;;;;;;1,0;;;;;;;;;;1,0;;;;;;;;;;;;;;;;;;;;;;;;;;;;;;;;4,0;;;;;;;;2,0;2,0;;;;;;;;;;;;2,0;;;;;;;;;;;;;1,0;;8,0;;;;;4,0;;;;;;;;;;;;4,0;;;;;;;;;;2,0;;;;;;;1,0;;;;;;;1,0;;;;;;1,0;;;;;;;;1,0;;;;;;;;;;;;;;;;;;;;;;;;;;;1,0;;;;;;;;;;;5,0;;;3,0;;;;;;;;2,0;;1,0;;;;;;;;;;;;;;3,0;;;;;;;;;;;;;;;6,0;;3,0;;;;2,0;;;;;;;;;;;;;19,0;;;;;;;;1,0;;;;1,0;;;;;;;;;;;;;;;;;;;;;;;;;;;;;;;;;;;;;;;;;;;;;;;;;;;;;;;;;;;;;;;;;;;;;;;;;;;;;;;;;;;;;;;;;;;;;;;
actuation;;;;4,0;;;1,0;;1,0;5,0;4,0;;2,0;;1,0;1,0;;;;;3,0;17,0;12,0;;;;;;;;;;13,0;;74,0;7,0;;;;;2,0;;;;99,0;10,0;2,0;24,0;;2,0;;;;;2,0;;28,0;;;;;;;;;;2,0;;2,0;3,0;14,0;;17,0;;;;;1,0;;14,0;;;5,0;28,0;;7,0;1,0;;;1,0;6,0;;;;;1,0;1,0;;12,0;3,0;;1,0;3,0;2,0;;;4,0;;;;;5,0;;;;14,0;2,0;7,0;11,0;5,0;;;1,0;;5,0;1,0;;;;4,0;;;1,0;;;;;17,0;;;;;;7,0;1,0;;;;10,0;;;;2,0;2,0;1,0;;29,0;;1,0;;;;10,0;;;;2,0;4,0;;;;;;;;3,0;8,0;3,0;;;;80,0;;;;;;;;;;;;3,0;;3,0;;;;;;;;4,0;;;;;;;;;;;;;;;;;1,0;;;;;;;4,0;;;2,0;;;5,0;;;;;;;;;;;5,0;;;1,0;;2,0;18,0;;2,0;;;;4,0;;2,0;;;;;;;1,0;;;13,0;;2,0;;;;;2,0;;;;1,0;10,0;;3,0;;;3,0;;;;;;;;;;;;;;;4,0;;2,0;;;2,0;;;;;;3,0;;;;;;;;1,0;;;;1,0;;;;;;;;;;;2,0;;;;2,0;;;;;;4,0;;;;2,0;42,0;;5,0;;;;;1,0;;1,0;;;;;;;;;;;;;2,0;;;;;;;2,0;;1,0;;;;;;;;;2,0;;1,0;;;;;;;;;;;;;;;;;1,0;1,0;1,0;;;;;;;;;;;;3,0;;;;;;;;;18,0;;;;;;;4,0;;;;;;;9,0;8,0;;;;1,0;;;42,0;;1,0;;;;;6,0;;;;;3,0;;;;;;;1,0;;82,0;;;;;;1,0;;;;;;;;;;;;;;;;;;4,0;;9,0;;;;16,0;;;;;;1,0;;;;;;;;;;;;;7,0;;;;;;2,0;;;;;;;1,0;;;;;1,0;;;2,0;3,0;;;;4,0;;;1,0;;;1,0;;;;14,0;;;;;;1,0;6,0;1,0;1,0;;;;;;;;;;;;;;;1,0;;;;;;;;;;;;;;;;;1,0;;;;;;1,0;;;;;;;3,0;;;;;;;;;;;;;1,0;;;1,0;;;;;;;;;;;;1,0;;;;1,0;;;;;;1,0;;;;;1,0;;;1,0;;;;1,0;;;;;;;;;;;;;;;;;;;;;;;;;;;;;;;;;;;;;;;1,0;;1,0;;2,0;;1,0;;;;;;;;;;;;;;;;;;;;;;;;;;;;4,0;;;;;;;1,0;;;;;;;;;;;;;;;1,0;;;;;;;1,0;;;;;;2,0;1,0;;;;;;;;;;;;2,0;;;;;1,0;;;;;;;;;;;;;;;;;;1,0;;;;;;;;;;;;;;;;;;;;;;;;;;;;2,0;2,0;;;1,0;;;;;;;19,0;;;;;;;;;;1,0;;;;1,0;;;;;;;;;;;;;;;;;;;;;;;;;;;;;;;;;;;;;;;;;;;;;2,0;1,0;1,0;46,0;;;;;;;;;;;;;;;;;;;;;;;;;;;;;;;;;;;;;;;;;;;;;;;;;;;;;;;;;;;;;;;;;;;;;;;;;;;;;;;;;;;;;;;;;;;
actuator;;;;10,0;1,0;21,0;4,0;34,0;2,0;32,0;20,0;;8,0;;61,0;63,0;;;;3,0;3,0;4,0;1,0;;11,0;2,0;2,0;1,0;7,0;2,0;1,0;;113,0;1,0;163,0;40,0;1,0;5,0;2,0;;4,0;1,0;24,0;6,0;13,0;9,0;16,0;79,0;21,0;3,0;57,0;9,0;;2,0;161,0;3,0;64,0;5,0;;;28,0;11,0;4,0;;12,0;2,0;45,0;71,0;48,0;5,0;2,0;;35,0;;;33,0;1,0;1,0;2,0;148,0;;43,0;;189,0;3,0;2,0;;;3,0;31,0;507,0;;;5,0;2,0;;7,0;;89,0;10,0;1,0;;229,0;27,0;;13,0;88,0;2,0;12,0;2,0;7,0;10,0;;;4,0;27,0;109,0;161,0;30,0;11,0;9,0;;7,0;14,0;10,0;4,0;2,0;;;9,0;;8,0;43,0;5,0;;;19,0;9,0;;;;2,0;;97,0;1,0;;;29,0;40,0;4,0;;1,0;;4,0;;16,0;171,0;;4,0;7,0;;12,0;164,0;3,0;3,0;;7,0;5,0;;;7,0;;9,0;;9,0;28,0;84,0;244,0;;;5,0;65,0;2,0;;;16,0;4,0;26,0;;;4,0;2,0;;89,0;3,0;41,0;;;;12,0;10,0;5,0;3,0;57,0;29,0;25,0;17,0;5,0;;37,0;8,0;2,0;55,0;;;;18,0;1,0;8,0;23,0;94,0;1,0;11,0;;;2,0;12,0;;20,0;8,0;139,0;12,0;10,0;50,0;75,0;162,0;34,0;51,0;27,0;8,0;3,0;1,0;16,0;21,0;2,0;;;4,0;5,0;8,0;27,0;;2,0;;9,0;1,0;69,0;;5,0;;4,0;8,0;;2,0;;4,0;23,0;7,0;26,0;14,0;5,0;12,0;8,0;;;36,0;2,0;36,0;14,0;59,0;3,0;;51,0;9,0;3,0;6,0;;1,0;3,0;1,0;3,0;8,0;196,0;;6,0;3,0;7,0;;15,0;12,0;;11,0;42,0;;;5,0;14,0;27,0;10,0;10,0;;15,0;;7,0;4,0;;;3,0;;92,0;8,0;;;1,0;127,0;;20,0;4,0;;2,0;2,0;3,0;4,0;12,0;3,0;5,0;;29,0;4,0;21,0;9,0;;6,0;4,0;6,0;1,0;4,0;43,0;9,0;2,0;2,0;6,0;;12,0;329,0;12,0;3,0;18,0;2,0;1,0;4,0;3,0;20,0;14,0;5,0;;1,0;1,0;6,0;;;4,0;;1,0;;2,0;14,0;;95,0;7,0;;;2,0;11,0;2,0;;6,0;;2,0;87,0;3,0;12,0;;;14,0;;6,0;2,0;;;2,0;;;19,0;1,0;;;2,0;2,0;10,0;14,0;11,0;;;;3,0;1,0;;1,0;;;1,0;10,0;2,0;;1,0;5,0;;;;;7,0;;129,0;2,0;7,0;1,0;4,0;2,0;;;8,0;112,0;;2,0;11,0;21,0;;4,0;8,0;;;;;7,0;2,0;1,0;;2,0;23,0;5,0;;;4,0;9,0;13,0;;13,0;2,0;4,0;;7,0;5,0;;9,0;;;;8,0;9,0;24,0;3,0;1,0;3,0;;;;1,0;;;;1,0;;3,0;;1,0;;;1,0;;14,0;1,0;;3,0;;1,0;;;1,0;;;;;;1,0;;;;;;;2,0;;6,0;1,0;;;3,0;;;;;2,0;20,0;;;;;2,0;4,0;;75,0;;3,0;;2,0;4,0;;4,0;1,0;;;2,0;;;3,0;;;5,0;13,0;;3,0;;10,0;1,0;2,0;;9,0;;11,0;1,0;;1,0;;1,0;2,0;2,0;1,0;;;;2,0;;3,0;3,0;3,0;;;1,0;;;;1,0;11,0;7,0;;;;3,0;1,0;20,0;;;;;;;8,0;;;;;1,0;;4,0;;3,0;;;;;;;;4,0;;1,0;;;;;;;2,0;;;1,0;4,0;;;;48,0;1,0;1,0;;;1,0;2,0;;44,0;4,0;1,0;;4,0;4,0;2,0;31,0;1,0;;3,0;;;;6,0;13,0;11,0;2,0;;;2,0;21,0;4,0;;;5,0;;;1,0;10,0;;4,0;;2,0;4,0;;4,0;1,0;;;6,0;1,0;;;;;5,0;1,0;;7,0;;;;1,0;;5,0;7,0;;3,0;3,0;2,0;7,0;;;15,0;;;;;20,0;25,0;;11,0;;;6,0;106,0;5,0;;;2,0;;;;;1,0;;;5,0;;1,0;;;;2,0;1,0;;4,0;2,0;5,0;;;;1,0;;1,0;14,0;;;2,0;;;;;;;6,0;;6,0;;;;18,0;;;;1,0;;1,0;;8,0;;;;;;;;;4,0;15,0;;;1,0;1,0;;;;;3,0;23,0;4,0;;1,0;;;;;10,0;;;2,0;;;1,0;1,0;;;;1,0;;2,0;;3,0;2,0;;5,0;1,0;1,0;;;;1,0;;;;;1,0;20,0;6,0;1,0;;;;;;;63,0;;;1,0;;;;;8,0;;;;;;2,0;;;;;;;;;;;3,0;1,0;13,0;;10,0;;1,0;2,0;38,0;13,0;;1,0;;;;;;;;4,0;;4,0;2,0;;;1,0;;17,0;;;;13,0;;;;5,0;21,0;1,0;5,0;2,0;2,0;4,0;8,0;4,0;1,0;1,0;4,0;2,0;1,0;1,0;4,0;30,0;21,0;13,0;;;;;;;;;;;;;;;;;;;;;;;;;;;;;;;;;;;;;;;;;;;;;;;;;;;;;;;;;;;;;;;;;;;;;;;;;;;
adapt;;;;6,0;3,0;3,0;9,0;25,0;3,0;1,0;31,0;;7,0;;18,0;29,0;8,0;2,0;4,0;1,0;11,0;72,0;2,0;10,0;15,0;;13,0;4,0;2,0;2,0;29,0;8,0;11,0;2,0;123,0;33,0;;;8,0;;51,0;;11,0;1,0;46,0;27,0;32,0;135,0;21,0;49,0;3,0;18,0;;;18,0;10,0;39,0;2,0;1,0;;10,0;8,0;5,0;;12,0;13,0;10,0;36,0;20,0;12,0;15,0;;42,0;1,0;;1,0;1,0;2,0;11,0;220,0;1,0;27,0;14,0;40,0;;7,0;;;;6,0;77,0;1,0;5,0;;7,0;1,0;28,0;;21,0;;2,0;7,0;40,0;29,0;;;45,0;8,0;76,0;16,0;5,0;16,0;2,0;3,0;;39,0;55,0;86,0;14,0;3,0;;;31,0;40,0;46,0;11,0;;1,0;15,0;20,0;;20,0;1,0;2,0;3,0;7,0;2,0;33,0;14,0;1,0;10,0;1,0;6,0;75,0;8,0;1,0;1,0;11,0;68,0;2,0;;5,0;12,0;22,0;12,0;8,0;97,0;2,0;6,0;17,0;1,0;26,0;137,0;;;;34,0;25,0;16,0;5,0;8,0;;1,0;;19,0;2,0;36,0;6,0;;;4,0;16,0;1,0;6,0;1,0;23,0;;57,0;;2,0;1,0;;5,0;40,0;;6,0;1,0;1,0;;7,0;5,0;;;42,0;;;1,0;3,0;6,0;9,0;;;1,0;;;;2,0;4,0;2,0;13,0;65,0;6,0;6,0;2,0;2,0;6,0;1,0;;104,0;;30,0;1,0;3,0;94,0;4,0;11,0;7,0;35,0;6,0;23,0;3,0;5,0;;1,0;1,0;;1,0;2,0;30,0;13,0;25,0;;4,0;1,0;2,0;7,0;132,0;11,0;;;;;30,0;25,0;;;5,0;;17,0;;11,0;17,0;5,0;;2,0;1,0;1,0;37,0;4,0;54,0;7,0;1,0;3,0;;;20,0;;;;;7,0;4,0;;;11,0;;2,0;6,0;1,0;;19,0;7,0;36,0;2,0;;;;9,0;11,0;;;6,0;2,0;;18,0;;6,0;17,0;2,0;22,0;6,0;1,0;4,0;6,0;1,0;1,0;44,0;4,0;;;1,0;10,0;3,0;12,0;;1,0;8,0;8,0;15,0;1,0;8,0;1,0;6,0;7,0;;5,0;12,0;9,0;4,0;4,0;1,0;;3,0;6,0;;10,0;4,0;10,0;3,0;;;5,0;1,0;;;3,0;;;7,0;2,0;1,0;;12,0;;;2,0;11,0;1,0;15,0;10,0;2,0;;1,0;1,0;;3,0;;;2,0;58,0;;11,0;4,0;2,0;5,0;5,0;2,0;8,0;1,0;2,0;11,0;21,0;1,0;;1,0;;1,0;2,0;;18,0;17,0;21,0;7,0;;10,0;;5,0;2,0;1,0;1,0;2,0;2,0;25,0;12,0;;2,0;;21,0;1,0;;;18,0;6,0;16,0;11,0;;3,0;9,0;13,0;1,0;4,0;6,0;10,0;;1,0;7,0;11,0;3,0;3,0;4,0;6,0;1,0;;1,0;7,0;9,0;4,0;5,0;1,0;;4,0;1,0;;4,0;;3,0;;3,0;;6,0;;;;2,0;32,0;1,0;;4,0;;3,0;9,0;17,0;4,0;3,0;4,0;1,0;;1,0;1,0;2,0;;7,0;;17,0;;1,0;10,0;3,0;20,0;;36,0;;;2,0;1,0;2,0;;;2,0;1,0;2,0;5,0;1,0;;3,0;;4,0;;1,0;2,0;4,0;2,0;6,0;9,0;2,0;;1,0;2,0;1,0;10,0;;2,0;22,0;11,0;;7,0;;5,0;5,0;;4,0;1,0;;1,0;;21,0;7,0;1,0;2,0;19,0;3,0;12,0;;4,0;;37,0;;3,0;18,0;2,0;;11,0;2,0;5,0;1,0;24,0;9,0;18,0;5,0;;5,0;1,0;9,0;;;3,0;13,0;3,0;;;2,0;;;;;;;;5,0;;1,0;;;6,0;2,0;1,0;4,0;1,0;;3,0;7,0;2,0;;2,0;;2,0;2,0;1,0;3,0;;2,0;4,0;2,0;1,0;2,0;;4,0;2,0;10,0;5,0;2,0;;3,0;6,0;2,0;;22,0;;11,0;2,0;2,0;2,0;;3,0;4,0;1,0;1,0;12,0;9,0;;2,0;;5,0;1,0;7,0;4,0;;4,0;2,0;1,0;7,0;4,0;;7,0;3,0;22,0;;;1,0;1,0;2,0;;;;1,0;2,0;;5,0;8,0;;1,0;3,0;2,0;;;;;6,0;2,0;5,0;1,0;;13,0;1,0;;2,0;;;3,0;;;1,0;;1,0;;1,0;2,0;;2,0;;;;3,0;;;;;;;1,0;;;;3,0;1,0;6,0;7,0;;2,0;;;1,0;4,0;3,0;9,0;;1,0;4,0;;1,0;;1,0;1,0;;12,0;;12,0;2,0;8,0;3,0;2,0;;;9,0;4,0;;;;3,0;;2,0;;;;;7,0;1,0;;;;;2,0;;4,0;;1,0;4,0;;;;;1,0;6,0;10,0;;;;;2,0;1,0;;;;;;;5,0;;1,0;4,0;;3,0;1,0;14,0;;;;;1,0;2,0;3,0;3,0;3,0;15,0;;;5,0;;4,0;1,0;;1,0;;;;;;;;2,0;;;1,0;1,0;;;4,0;;7,0;;5,0;5,0;;;12,0;4,0;3,0;;;;;;1,0;;10,0;;;;;;1,0;;2,0;;1,0;;6,0;2,0;5,0;;2,0;;1,0;;;7,0;6,0;;;3,0;1,0;;1,0;;;1,0;;1,0;;;1,0;;;;;;;;;;;2,0;;;;;;;3,0;5,0;11,0;;1,0;;7,0;;;;;2,0;;2,0;4,0;;6,0;;2,0;3,0;;;;;5,0;3,0;;11,0;1,0;1,0;6,0;1,0;2,0;7,0;2,0;1,0;2,0;1,0;2,0;1,0;2,0;2,0;2,0;5,0;2,0;3,0;1,0;3,0;2,0;7,0;;;;;;;;;;;;;;;;;;;;;;;;;;;;;;;;;;;;;;;;;;;;;;;;;;;;
ambient;;;;1,0;1,0;3,0;;15,0;1,0;1,0;11,0;;42,0;;;49,0;;;23,0;1,0;2,0;15,0;;;5,0;;30,0;;;;;25,0;13,0;;3,0;2,0;2,0;2,0;;;16,0;1,0;;1,0;30,0;;62,0;18,0;10,0;7,0;;1,0;;;;6,0;9,0;;;;;5,0;;1,0;5,0;;;;6,0;7,0;4,0;;2,0;;;;1,0;14,0;42,0;47,0;;4,0;;14,0;2,0;;1,0;;;;6,0;;;;13,0;;2,0;;54,0;3,0;;;14,0;25,0;;9,0;17,0;;8,0;6,0;8,0;5,0;;4,0;;9,0;6,0;3,0;1,0;12,0;;;;2,0;3,0;1,0;;2,0;20,0;5,0;;4,0;;;4,0;;;1,0;;;6,0;;;34,0;12,0;;;;6,0;;;;2,0;11,0;;;21,0;;1,0;;;3,0;28,0;;1,0;;;1,0;11,0;2,0;1,0;;;;18,0;2,0;;;;;;4,0;;;;4,0;;2,0;;;;;;;;;;;;;;;2,0;1,0;;;;17,0;3,0;1,0;;;1,0;;;;;;;;11,0;8,0;;;;;;;373,0;;3,0;;;;;;1,0;2,0;6,0;;;;1,0;;;;;;7,0;;;;;;2,0;2,0;24,0;7,0;;;;;;8,0;;;;2,0;;;;6,0;1,0;;13,0;;;;;8,0;1,0;;;;;5,0;;;;;4,0;;;;;;11,0;;;;3,0;7,0;;;;;;8,0;;;;;;;6,0;1,0;;;;;;;;5,0;3,0;;;;;2,0;;;;;;;;3,0;;;;;;;1,0;;;;;2,0;;;;;;;;3,0;1,0;;;;;;;7,0;;;;;;;;1,0;1,0;;;;;;;3,0;1,0;;;;;;;;;8,0;;;;;;;;;;;;;;;;;3,0;31,0;9,0;;5,0;;5,0;;;;;;;;2,0;5,0;;;;5,0;;3,0;;13,0;39,0;;2,0;;4,0;10,0;12,0;;4,0;;;;;8,0;1,0;;;;;;;;;2,0;;;;;11,0;;7,0;3,0;;;1,0;;12,0;3,0;;;;2,0;1,0;1,0;;;;;21,0;;1,0;;;;;1,0;1,0;1,0;;11,0;;;;;1,0;1,0;;;;2,0;2,0;10,0;2,0;;;;;;;;;;;;;;;;;2,0;;1,0;;;4,0;;;;;3,0;;;;;7,0;;;1,0;;;;1,0;1,0;2,0;;;;;;;;;;;;1,0;;;;;;19,0;;1,0;;;;3,0;;;5,0;;;;;;;;3,0;;;;13,0;;;;;;;;;;;;;;;;;;;;5,0;;;;;;;;;;;;;;;;;;;1,0;1,0;;25,0;;;;;;;;;;;;1,0;;;;;;;;;;;;;;;;;;;1,0;;;;;;;;;;6,0;;;;;;1,0;;;;;;;;;1,0;;;;;;;;;5,0;;;;;;;;;;;;;;;;2,0;;;;;;;;;;;;;;;;;;;;;;;3,0;;;;1,0;;;3,0;;;1,0;;;;;;;;;1,0;;;;;;;;;3,0;;;;;;;;;;;;;;;2,0;;;;;;1,0;;;;;;2,0;;;7,0;;;;;3,0;;;;2,0;;;9,0;;;6,0;;1,0;;;34,0;;;4,0;;;;;8,0;;;;;;;14,0;;;;;;;;26,0;;;;;;;;;;;;;;;;;;;1,0;;;;;1,0;1,0;;1,0;;;;;1,0;;1,0;;;;;;;;;;;;;;;;;;;;;;;;;;;;;;1,0;;;82,0;;;;;;;;;;;;;;;;;;;;;1,0;;;;;;;;;;;;;;3,0;;;;;;;;;;;;;;;;1,0;;2,0;;;;;;1,0;;;;;;1,0;;;;;;;;;;;;;;1,0;;;;;;;;;;;;;;;;;;;;;;
amount;;;;1,0;1,0;10,0;40,0;65,0;52,0;5,0;3,0;12,0;23,0;2,0;17,0;277,0;3,0;48,0;23,0;2,0;15,0;70,0;53,0;;;5,0;36,0;3,0;;4,0;4,0;54,0;124,0;10,0;209,0;25,0;30,0;146,0;;;111,0;12,0;10,0;11,0;194,0;65,0;206,0;114,0;20,0;11,0;1,0;62,0;42,0;3,0;173,0;19,0;50,0;;47,0;;10,0;3,0;3,0;4,0;21,0;12,0;88,0;28,0;134,0;5,0;11,0;15,0;71,0;1,0;2,0;24,0;5,0;10,0;26,0;460,0;;48,0;3,0;94,0;21,0;38,0;9,0;;;29,0;257,0;;;3,0;3,0;7,0;27,0;;82,0;;3,0;2,0;9,0;53,0;3,0;14,0;49,0;2,0;129,0;17,0;21,0;49,0;1,0;1,0;29,0;55,0;59,0;93,0;38,0;201,0;;;32,0;40,0;8,0;5,0;4,0;;3,0;69,0;;120,0;43,0;2,0;10,0;10,0;28,0;11,0;23,0;32,0;10,0;;2,0;44,0;27,0;5,0;;19,0;221,0;8,0;5,0;;7,0;45,0;68,0;3,0;138,0;26,0;6,0;16,0;8,0;11,0;610,0;10,0;25,0;;61,0;11,0;8,0;12,0;32,0;7,0;;3,0;;12,0;;1,0;;;2,0;10,0;;1,0;67,0;6,0;;21,0;;;1,0;2,0;;2,0;6,0;;1,0;;9,0;6,0;;6,0;58,0;139,0;50,0;2,0;13,0;73,0;199,0;13,0;;;3,0;;;;;1,0;3,0;5,0;11,0;39,0;;;;;2,0;;497,0;;20,0;;2,0;9,0;9,0;61,0;244,0;9,0;4,0;1,0;30,0;;;2,0;52,0;;27,0;;119,0;12,0;3,0;;;8,0;8,0;6,0;50,0;2,0;;1,0;;;1,0;76,0;;59,0;5,0;;25,0;2,0;8,0;4,0;6,0;;1,0;3,0;21,0;1,0;;27,0;4,0;4,0;;2,0;;157,0;7,0;;;;8,0;18,0;21,0;1,0;;4,0;11,0;;7,0;;9,0;16,0;;16,0;;;;3,0;1,0;3,0;;13,0;;;22,0;3,0;;;;;;;2,0;;96,0;;2,0;;;8,0;1,0;;5,0;9,0;;11,0;;;1,0;1,0;;1,0;;28,0;41,0;7,0;;;3,0;9,0;;44,0;1,0;27,0;2,0;;;24,0;1,0;1,0;11,0;1,0;;2,0;;;;5,0;;;4,0;2,0;;2,0;;;4,0;;11,0;28,0;;;;1,0;7,0;161,0;;;1,0;1,0;;23,0;1,0;;;8,0;1,0;2,0;4,0;;1,0;;1,0;19,0;;;6,0;1,0;35,0;393,0;374,0;21,0;35,0;4,0;27,0;2,0;;1,0;3,0;4,0;3,0;6,0;18,0;28,0;;;36,0;128,0;2,0;12,0;;38,0;32,0;;2,0;1,0;2,0;46,0;32,0;;3,0;144,0;57,0;2,0;8,0;1,0;43,0;;2,0;21,0;16,0;;7,0;3,0;25,0;16,0;6,0;4,0;3,0;1,0;19,0;1,0;;16,0;;;;1,0;77,0;13,0;;3,0;3,0;51,0;11,0;3,0;39,0;;10,0;;170,0;7,0;1,0;16,0;21,0;2,0;5,0;4,0;;;3,0;;5,0;5,0;8,0;2,0;;4,0;1,0;1,0;8,0;;;26,0;25,0;5,0;1,0;;16,0;;;5,0;;;1,0;;;;;;12,0;1,0;;131,0;3,0;;;3,0;1,0;1,0;;33,0;2,0;2,0;2,0;;94,0;1,0;3,0;10,0;;;;2,0;5,0;;20,0;2,0;;5,0;8,0;;2,0;1,0;;;6,0;3,0;;1,0;4,0;6,0;;40,0;;1,0;2,0;4,0;;4,0;19,0;;15,0;;;;;;;1,0;;;;4,0;70,0;17,0;;1,0;;;;2,0;;;;;;1,0;9,0;3,0;1,0;;;;;1,0;9,0;;;;2,0;;7,0;;1,0;;;;;2,0;6,0;;;;4,0;;46,0;21,0;;11,0;9,0;;5,0;;;1,0;;;10,0;;10,0;;2,0;2,0;4,0;2,0;1,0;1,0;3,0;;4,0;;3,0;;;;;15,0;;;;8,0;;;16,0;;4,0;19,0;;32,0;3,0;;134,0;;2,0;16,0;;;;;;3,0;1,0;;;10,0;;;1,0;8,0;;2,0;;;;;;8,0;;;;;;2,0;;7,0;19,0;4,0;;;;2,0;;2,0;;;;;1,0;;;;4,0;;1,0;1,0;;6,0;2,0;;12,0;;;;89,0;;1,0;6,0;;3,0;1,0;;2,0;3,0;;;;;;;;;;;;11,0;;;;27,0;27,0;1,0;2,0;;;;;1,0;;;11,0;;23,0;22,0;2,0;;4,0;2,0;7,0;21,0;2,0;3,0;;;8,0;1,0;8,0;;17,0;;3,0;2,0;;8,0;;;;;;1,0;5,0;1,0;4,0;86,0;;;;;71,0;;7,0;8,0;4,0;;;1,0;5,0;1,0;;1,0;4,0;;2,0;;287,0;4,0;2,0;;1,0;2,0;;3,0;;;23,0;;;3,0;;8,0;;;;4,0;;;;5,0;;3,0;1,0;;3,0;;10,0;;11,0;;;2,0;;;;;;;1,0;;;;;18,0;;3,0;;;;2,0;;;;;1,0;3,0;6,0;;;1,0;;;5,0;;;;;;;;7,0;;;;4,0;2,0;;;;;;;;;2,0;;;;42,0;;18,0;;;;;3,0;;6,0;;;47,0;1,0;4,0;;;6,0;3,0;;;;;4,0;;2,0;;;8,0;3,0;;;5,0;;;2,0;24,0;;;;1,0;1,0;;2,0;5,0;;;;;112,0;3,0;;;;3,0;;18,0;;5,0;;;;;30,0;;;1,0;2,0;;;;;;;;;;4,0;1,0;;;;;
arrangement;;;;1,0;;6,0;9,0;12,0;15,0;91,0;31,0;;10,0;2,0;13,0;12,0;;;9,0;1,0;7,0;17,0;;5,0;10,0;;94,0;3,0;;;;1,0;33,0;;41,0;;;;3,0;;21,0;1,0;17,0;1,0;6,0;16,0;26,0;143,0;5,0;19,0;33,0;6,0;1,0;6,0;5,0;3,0;70,0;;;;6,0;2,0;31,0;8,0;45,0;;;25,0;7,0;;4,0;;21,0;1,0;1,0;6,0;10,0;4,0;5,0;73,0;3,0;18,0;3,0;107,0;2,0;1,0;10,0;;;8,0;85,0;;;3,0;;3,0;2,0;;34,0;2,0;;4,0;11,0;26,0;1,0;2,0;73,0;2,0;21,0;3,0;3,0;16,0;;2,0;2,0;67,0;15,0;48,0;3,0;5,0;;34,0;4,0;13,0;4,0;5,0;;;6,0;4,0;;11,0;12,0;;1,0;4,0;10,0;;;1,0;5,0;6,0;;47,0;8,0;;25,0;3,0;33,0;9,0;8,0;3,0;3,0;13,0;5,0;2,0;75,0;;10,0;10,0;;6,0;65,0;;;;12,0;7,0;;3,0;;;;3,0;;;32,0;;2,0;;;6,0;;;;5,0;1,0;10,0;;;;;;17,0;1,0;235,0;;1,0;;15,0;;4,0;;26,0;;;;;;4,0;;2,0;;;1,0;;;;2,0;;11,0;;;1,0;;1,0;2,0;;38,0;;8,0;5,0;4,0;82,0;13,0;6,0;4,0;5,0;24,0;3,0;2,0;2,0;;9,0;1,0;;10,0;3,0;149,0;11,0;9,0;;3,0;;;;16,0;;;;;;18,0;6,0;;;1,0;7,0;44,0;;3,0;16,0;10,0;1,0;;15,0;;13,0;11,0;50,0;1,0;;3,0;;;16,0;;;;1,0;31,0;5,0;;;1,0;;1,0;;1,0;;3,0;6,0;2,0;;1,0;;1,0;2,0;;;;2,0;2,0;1,0;3,0;1,0;;1,0;3,0;11,0;;;2,0;11,0;;;1,0;;;;;42,0;4,0;;2,0;;1,0;1,0;5,0;7,0;2,0;;1,0;6,0;3,0;1,0;3,0;6,0;5,0;17,0;;2,0;;18,0;;4,0;2,0;6,0;;;;1,0;;;;6,0;;;;;6,0;;;;;3,0;;1,0;11,0;12,0;;;;;1,0;1,0;2,0;;;15,0;7,0;7,0;;1,0;2,0;8,0;;1,0;3,0;;;;12,0;37,0;;;;1,0;2,0;8,0;2,0;3,0;6,0;;1,0;;2,0;;;3,0;;2,0;8,0;2,0;;18,0;1,0;14,0;;3,0;;2,0;;3,0;14,0;1,0;;4,0;;;6,0;6,0;3,0;;1,0;14,0;11,0;;1,0;9,0;;5,0;;;1,0;12,0;1,0;;;;3,0;1,0;;;;;;1,0;4,0;;1,0;;;;;1,0;;;2,0;8,0;16,0;3,0;;5,0;;4,0;;;3,0;9,0;;3,0;3,0;1,0;1,0;3,0;1,0;;3,0;;6,0;;;;1,0;;;;7,0;1,0;;3,0;;;;;;;;;;;18,0;43,0;;;1,0;1,0;2,0;2,0;;;3,0;1,0;;7,0;9,0;4,0;;4,0;;1,0;;;;3,0;;;;3,0;;1,0;5,0;10,0;1,0;;;;;;;9,0;6,0;3,0;3,0;;;7,0;;;2,0;;4,0;2,0;1,0;2,0;4,0;24,0;;1,0;1,0;1,0;;;8,0;;;;2,0;;;;;;4,0;;;1,0;;5,0;3,0;;;;;6,0;3,0;3,0;;;;;7,0;2,0;;;;3,0;;;1,0;;5,0;1,0;;;13,0;;3,0;5,0;;;;2,0;;;1,0;5,0;;;;2,0;24,0;;;;;5,0;12,0;;;1,0;1,0;7,0;;;6,0;;;;;;;1,0;;;3,0;6,0;;6,0;;1,0;;1,0;;5,0;;;;;;;;11,0;2,0;5,0;;1,0;2,0;4,0;;;;;;3,0;3,0;;1,0;;;;1,0;;2,0;;;;;;;;;;;;;;46,0;;;;2,0;51,0;1,0;1,0;2,0;3,0;3,0;1,0;;;;;8,0;;;2,0;1,0;1,0;1,0;;;;;1,0;;1,0;;1,0;;3,0;;3,0;2,0;3,0;;;;;;;;;;;9,0;29,0;;;;;4,0;1,0;;;;;6,0;1,0;;;;;;15,0;2,0;;;2,0;;;;9,0;;;;1,0;;;1,0;;2,0;1,0;;;;;2,0;;;;;;;;;;;;4,0;;;;;;;;;1,0;;1,0;;;2,0;4,0;;;1,0;2,0;;3,0;;;1,0;;;;;2,0;;;;;;;4,0;1,0;14,0;;;22,0;;;4,0;1,0;;;;1,0;;;;;;1,0;;;;1,0;;;;;1,0;;;9,0;1,0;;;;1,0;;;;;;5,0;;;;4,0;;;1,0;;;;;;;;;2,0;1,0;2,0;;5,0;;2,0;;8,0;1,0;;;;10,0;;;3,0;;2,0;;;;;;;;;;;;2,0;;;;;;;;3,0;;;;2,0;1,0;;3,0;;;;1,0;;;;;1,0;;;;;;;;;;2,0;;;1,0;;1,0;;;1,0;;;;;;;1,0;;;;;;1,0
automatic;;;;2,0;1,0;4,0;1,0;44,0;5,0;;3,0;;1,0;;4,0;29,0;;;1,0;4,0;12,0;43,0;;;;;;;;;2,0;2,0;6,0;1,0;64,0;2,0;1,0;5,0;5,0;;2,0;5,0;;3,0;1,0;21,0;11,0;43,0;14,0;5,0;1,0;7,0;;;5,0;4,0;2,0;;;;;;;1,0;;1,0;71,0;;13,0;;14,0;1,0;3,0;4,0;;1,0;3,0;;1,0;58,0;1,0;4,0;;6,0;;10,0;;;;1,0;21,0;;;1,0;;4,0;2,0;;54,0;3,0;;;3,0;16,0;;;3,0;;17,0;98,0;;16,0;;4,0;;4,0;2,0;35,0;1,0;3,0;;;16,0;2,0;5,0;2,0;;;;2,0;;2,0;4,0;;;;;2,0;;;4,0;;;4,0;4,0;;;;4,0;3,0;;;2,0;3,0;4,0;;40,0;;4,0;1,0;;;16,0;;;;2,0;2,0;;;;;;;;4,0;1,0;;;;2,0;2,0;;;;14,0;;;;;;;;10,0;;;1,0;;;;;;2,0;6,0;;;;;55,0;;1,0;;;;;;;;;;4,0;;;2,0;;;;;9,0;;1,0;;1,0;6,0;;;1,0;;;;1,0;8,0;;;;;;;2,0;;6,0;;;1,0;;;2,0;;;;;1,0;;2,0;;;2,0;;;;1,0;1,0;;;;;;;;2,0;2,0;;;;;15,0;;1,0;;;2,0;1,0;;;;;;;;;6,0;4,0;;;;;;1,0;;2,0;;;2,0;;;;;11,0;;;;;;;;;;;;;;3,0;;;;;;;;;;;;;;;;1,0;;1,0;;;2,0;2,0;;1,0;;;1,0;;;;;1,0;;;;1,0;;;;;;;;;;;;;;;;;;;;;;;;4,0;;;;;;1,0;;;;;;1,0;;3,0;;;;17,0;17,0;;;;7,0;;;;2,0;;;;;2,0;;1,0;4,0;1,0;;;;9,0;4,0;;1,0;;;;26,0;;3,0;2,0;;;;1,0;6,0;;;2,0;1,0;;;;;;1,0;;1,0;;1,0;;;5,0;;;3,0;1,0;7,0;67,0;;;;4,0;4,0;;3,0;;;;18,0;;;;2,0;;;1,0;;;;1,0;4,0;12,0;;;;1,0;;1,0;10,0;;1,0;4,0;1,0;;;;1,0;;;3,0;;;;;;;;;2,0;1,0;;36,0;;;;;;;;;1,0;1,0;;;12,0;;5,0;;;;;;;1,0;;;;38,0;;;;2,0;4,0;;;;;;;1,0;;;;;;;;1,0;;;;;;2,0;;;;1,0;;;;;5,0;12,0;;;;;3,0;;;;2,0;;;;1,0;;;;3,0;;;;;;;;;;;;;;;;;1,0;;;;7,0;;;8,0;;;;;;;;;;;;;;;4,0;19,0;;2,0;2,0;;;1,0;2,0;;1,0;;;;;;4,0;;;;;;1,0;;2,0;;;;;5,0;;;;;;;;;;;1,0;;;;;;;;;;2,0;;;;;;1,0;;;;;;;;;;4,0;;;;;;;1,0;;;;;;;;;2,0;;;;;;;;;;4,0;;;;;;;;;;;;;;;;;;;1,0;;;;;;;1,0;;;;;;;;;;1,0;;;3,0;1,0;;;;;2,0;;;2,0;;;;;7,0;;2,0;;;;;1,0;;;;;6,0;3,0;;21,0;;3,0;;1,0;;;1,0;1,0;;1,0;;;;;;;;;2,0;3,0;;;;;;5,0;;;;1,0;;;;1,0;;4,0;;1,0;;3,0;2,0;;;;2,0;3,0;;;;;;;;;;;;;4,0;;;;;;;;;;;;;;;;;;;;;;;;2,0;1,0;;;;;2,0;;1,0;;;;;;;;;;;;;;;;;;;;;;;;;;;;;;;;;;;;;;;;;;3,0;;;;;;;;;;2,0;;;;2,0;;;;;;;;;;;;;;;;;;;;;1,0;;;;;;;;9,0;;;;;;3,0;;;;;;;;;;;4,0;;;;;
brake;;;;2,0;;5,0;;15,0;;;;;;6,0;10,0;4,0;;;;;;;1,0;;;;;;;;;;3,0;;46,0;1,0;;;;;3,0;;;;10,0;1,0;6,0;3,0;;13,0;3,0;;;;35,0;;;;;;;;;;;;;2,0;;;;;;;;;;;;;;;;20,0;;;;;;3,0;;;;;;;;;6,0;1,0;;;54,0;;;;;;;;;;;;;2,0;2,0;38,0;;11,0;2,0;;;3,0;;;;;;;;;;6,0;;;4,0;5,0;;;;;;16,0;1,0;;;5,0;6,0;;;1,0;;;;;89,0;;;;;9,0;8,0;;;;;8,0;;;;;;;3,0;27,0;3,0;;;;;;;;1,0;2,0;;;;;;;;6,0;;19,0;;;;;;;;4,0;;;3,0;;;;;;3,0;;;;;;;;;;;;;;;56,0;;;69,0;;115,0;3,0;;19,0;8,0;;;;;;2,0;6,0;;;;;;;1,0;;;8,0;3,0;;1,0;1,0;;;;;;;;;;;11,0;;4,0;;3,0;;;2,0;;;;1,0;;;;1,0;;13,0;;;1,0;;12,0;;;;;;;;;;13,0;8,0;6,0;;;;5,0;;;;;;;;;;;;;4,0;9,0;;;;2,0;;5,0;;;3,0;3,0;;;;;;;;2,0;;;;;;;2,0;2,0;4,0;2,0;;;;;;;2,0;;;;;;;;;;;;2,0;6,0;;;25,0;;;;;;3,0;22,0;4,0;;;2,0;29,0;;;;;;;6,0;;;;;;2,0;;;1,0;;;;;2,0;;;;;4,0;;;1,0;;1,0;;;;;;;;;;;;7,0;;;5,0;;;;;;;;3,0;;;1,0;;6,0;;;3,0;6,0;;;2,0;;;;;;;;;;;5,0;;;1,0;;;;2,0;13,0;24,0;;2,0;;;;;;;;;;4,0;;;;;;;;;;;2,0;;;1,0;;;;;61,0;;;;;;;;;;;1,0;;;;;;;;;;4,0;;7,0;;;;;;1,0;;;;;;;2,0;;;;;;;;;5,0;4,0;;11,0;;;;;;;;;;;;;;;4,0;;2,0;;27,0;;;;;;;;;;;;;;;;;;;;;;;;;;;;;;;;;4,0;;;;;;1,0;;;;2,0;;;1,0;;;;;;;;;;;;;;;;;;;;;;;;;;;;;;;;;;;;;;;;;2,0;;;2,0;;;8,0;;;;;;;;;;1,0;;;;4,0;;;;;;6,0;;;;4,0;;;;;;;;;;;;;;;;;;;;;3,0;;;;;;;;;;;;;2,0;;;;;;;;;;;;;;;;;;;;;2,0;;;3,0;;;;;;;7,0;;;;;;;;;;;;;;;;;;;;;;;;;;;;;;;;;;;2,0;;;;;;;;;1,0;;;;;;;;;;;;;;22,0;;;;;;;;;;;;;;;;;;1,0;;;;;;;;;;;;;7,0;;;;;;;12,0;6,0;3,0;;;;;;;;;;;;;;;;;;;;;;;;;;;;4,0;;;1,0;30,0;;;;;;;4,0;;;;;;;3,0;;;;;;;;;;;;;;;;;;;;4,0;;;;;;;;;;;;;;;;;;;;;;;;;;;;;;;;;;;;;;;;;;;;;;;;;;;;;;;;;;;;;;;;;;;;;;;;;;;;1,0;;;;;;;;;;
chip;;;;2,0;1,0;2,0;1,0;42,0;14,0;10,0;42,0;;;;6,0;11,0;;;;1,0;;6,0;;;1,0;;14,0;16,0;;;5,0;;21,0;;4,0;3,0;;;;;12,0;;10,0;;4,0;3,0;;94,0;27,0;1,0;44,0;3,0;;;2,0;1,0;31,0;;;;15,0;5,0;2,0;;6,0;3,0;1,0;90,0;24,0;11,0;5,0;;3,0;;;;;;2,0;336,0;6,0;65,0;4,0;75,0;1,0;;;;;7,0;107,0;;8,0;1,0;;;109,0;;42,0;;1,0;;62,0;2,0;1,0;4,0;21,0;1,0;3,0;3,0;3,0;2,0;3,0;;3,0;103,0;32,0;7,0;7,0;;;;5,0;121,0;15,0;4,0;;;;;;;;3,0;;4,0;12,0;;25,0;;1,0;1,0;;282,0;;;;14,0;91,0;26,0;;29,0;1,0;5,0;;;96,0;4,0;;;;11,0;40,0;;;;2,0;;;2,0;1,0;;3,0;;;1,0;20,0;5,0;;18,0;20,0;3,0;40,0;4,0;2,0;70,0;2,0;5,0;;;4,0;13,0;;64,0;2,0;18,0;;;;24,0;;;2,0;4,0;;;;;;8,0;20,0;6,0;2,0;1,0;1,0;;;4,0;;19,0;17,0;4,0;;;1,0;1,0;28,0;;31,0;4,0;19,0;8,0;1,0;27,0;;;1,0;8,0;3,0;3,0;5,0;;1,0;;4,0;2,0;3,0;1,0;45,0;;16,0;;;4,0;;;10,0;;1,0;;;;1,0;;118,0;;1,0;5,0;;6,0;;5,0;6,0;14,0;;;;23,0;81,0;62,0;2,0;;2,0;7,0;2,0;19,0;;;;15,0;;;;6,0;;;;;13,0;1,0;;2,0;10,0;;9,0;2,0;;6,0;7,0;3,0;15,0;;;;;4,0;;4,0;;6,0;1,0;;4,0;1,0;17,0;;1,0;;;;;;;;;;1,0;2,0;1,0;6,0;4,0;;2,0;69,0;;;;;3,0;4,0;;1,0;;23,0;;;;;1,0;;2,0;;5,0;1,0;;2,0;;;2,0;;2,0;;;;;;5,0;;;3,0;;;;;;2,0;;;;11,0;8,0;;;8,0;;;;;;1,0;;43,0;;2,0;;;;;;;;;;3,0;;;;;;;1,0;;7,0;;;;;1,0;;;;4,0;8,0;;;;2,0;;1,0;;;;;;;1,0;;;;;3,0;;;;;1,0;;;1,0;;6,0;2,0;;;;;;;;1,0;;;;;2,0;;1,0;;2,0;;;5,0;;1,0;;;;;1,0;;;;;;;1,0;;;14,0;;;;1,0;4,0;;;1,0;;2,0;;9,0;;;;;;;;;;5,0;3,0;4,0;;1,0;;;;;2,0;;;;8,0;;;;2,0;;;;;;1,0;;2,0;;;;;;;2,0;;;2,0;;3,0;;;;3,0;1,0;;;;;1,0;3,0;;4,0;;2,0;;;;1,0;;;;2,0;;;;1,0;;;;;;;;;;2,0;;;;;;;1,0;1,0;;;8,0;;;;;;;11,0;;;;;;;;5,0;;1,0;;1,0;;14,0;;;2,0;;;;7,0;;;;;;;;;1,0;4,0;;;;;;;;1,0;;3,0;;;;;;;;4,0;;;3,0;1,0;;;;;9,0;;1,0;;;;;;1,0;;;1,0;1,0;;;5,0;;;;;;;;;;;;;5,0;;;;;;;;;;;;;;;;;;;;;;1,0;29,0;;;;;17,0;;;;;;2,0;;20,0;1,0;;5,0;;2,0;;15,0;;;;4,0;;;34,0;;;;;;8,0;;3,0;;9,0;;;;;1,0;1,0;2,0;;;;;;22,0;;;;;;2,0;;;;;;;;;;;;5,0;;;9,0;;;;;;;29,0;;;;;;;;;;;;2,0;;1,0;;1,0;;;;;;;;;;;18,0;;;;;;;;;;;;;;;;4,0;;;;;;;3,0;;;;;;;;;;;;;;;;;;;1,0;;;;;;;;;4,0;;;;;;;;;;;;;3,0;;;5,0;2,0;5,0;;;;;4,0;;;;;;;;;;;;;;;;;;1,0;;;;;;;15,0;;2,0;;;;;2,0;;;;;;;3,0;;;;;;;;;;;;;2,0;;;;;;;;;2,0;1,0;;;;;;;;;;;;;;1,0;;;;;;7,0;;;;;;;;;;;;;;;;;
comparison;;;;1,0;;1,0;;16,0;3,0;3,0;1,0;;4,0;;;158,0;;;20,0;;;17,0;2,0;;;;2,0;;;3,0;;;64,0;1,0;23,0;2,0;;2,0;2,0;;71,0;1,0;;14,0;21,0;5,0;66,0;14,0;13,0;16,0;1,0;7,0;1,0;3,0;1,0;2,0;4,0;3,0;2,0;;;1,0;;2,0;4,0;3,0;2,0;4,0;25,0;;3,0;;63,0;;;1,0;1,0;;;192,0;1,0;4,0;;24,0;;8,0;;;;2,0;10,0;1,0;5,0;;;6,0;9,0;;48,0;2,0;10,0;3,0;20,0;29,0;;5,0;1,0;3,0;81,0;23,0;1,0;37,0;;;4,0;20,0;8,0;18,0;;29,0;;;40,0;16,0;2,0;1,0;;5,0;;6,0;2,0;95,0;1,0;;1,0;1,0;11,0;4,0;;;2,0;5,0;;3,0;1,0;;;8,0;64,0;;;;5,0;51,0;2,0;;15,0;;2,0;2,0;3,0;1,0;72,0;;10,0;;19,0;4,0;;1,0;1,0;;;;33,0;3,0;;;;;;;;;;25,0;;1,0;;;;;;6,0;;;;1,0;6,0;;;;32,0;3,0;;;1,0;;2,0;3,0;;;;;;;;;;;;;;;3,0;;;;15,0;;;;;;;1,0;2,0;;;;;;;1,0;11,0;;2,0;;90,0;;;;;;;;14,0;1,0;;;;;;3,0;;;1,0;2,0;;;;5,0;;;;1,0;;1,0;;12,0;15,0;;3,0;;1,0;109,0;1,0;;;;8,0;;;;;;;1,0;;;;5,0;;;;;;32,0;;2,0;;;;;;2,0;;;;2,0;;;;1,0;2,0;;;;1,0;;;;;;;7,0;;;;;;;;4,0;2,0;;;1,0;;4,0;;;;4,0;;;;33,0;;;;;;;;;3,0;;;;8,0;;;3,0;;;;;;;;;;;;;;;7,0;;2,0;3,0;3,0;;;;;;7,0;;;;;2,0;;;;;19,0;34,0;26,0;15,0;55,0;;14,0;;;;;;;;;22,0;3,0;;5,0;10,0;2,0;;;11,0;30,0;;4,0;2,0;1,0;13,0;22,0;;6,0;18,0;5,0;;1,0;3,0;27,0;;3,0;3,0;;;;2,0;3,0;7,0;1,0;;;;29,0;;;4,0;3,0;;;;51,0;;;;;2,0;6,0;;3,0;;67,0;;8,0;;;1,0;5,0;116,0;;1,0;;1,0;;2,0;8,0;;;;;2,0;;;;1,0;;4,0;;3,0;2,0;;1,0;;2,0;3,0;;;;;;;;14,0;;3,0;;6,0;;;;;2,0;7,0;;;;;;;10,0;6,0;;;;;;7,0;1,0;2,0;12,0;;;;1,0;;2,0;2,0;;;;;;;;2,0;;4,0;;;;;1,0;1,0;1,0;4,0;;;;1,0;;;;;;;1,0;;4,0;;3,0;;;;;1,0;;;;;;1,0;;;;;;;;;;;;;;;;;6,0;;;3,0;;;1,0;;;2,0;3,0;;13,0;1,0;;;;;;;;3,0;;;;;5,0;;;;2,0;;;;5,0;1,0;;3,0;;;;;;;;;1,0;9,0;;;3,0;;;1,0;;1,0;1,0;;3,0;;;;;;;;;;11,0;1,0;;8,0;;;24,0;;;2,0;;;;;;1,0;1,0;;;;;1,0;;;;4,0;;;;;;1,0;;;;;;;;;;;;;;3,0;2,0;1,0;;;;1,0;;;;;;;;;;2,0;;;;;;8,0;;;;;;1,0;;;;;;10,0;;2,0;;;;2,0;;;;;4,0;10,0;;;6,0;;;6,0;6,0;1,0;;;8,0;1,0;;;1,0;3,0;;;1,0;5,0;;;;;;15,0;2,0;;;1,0;;;;;8,0;;;;;4,0;;;;;;;;;;;3,0;3,0;;;;;;8,0;;;;;;;;8,0;;;2,0;;;;;1,0;;22,0;;;;;;;;;2,0;;;4,0;;;;;;;;;1,0;3,0;2,0;;;;2,0;;;;;;;;;;;1,0;;;9,0;;;;;;1,0;5,0;2,0;;;;;1,0;;;;;1,0;;;;;;;;;;;;;;;2,0;;7,0;;156,0;;;;1,0;1,0;;1,0;;2,0;;;;2,0;;;;;;;;;;;;;;;;;;;;;;;;;;;;;;;;2,0;;;;;;;;;1,0;;;;;4,0;2,0;1,0;4,0;2,0;;;;;;;;;
complete;;;;3,0;;;4,0;11,0;3,0;;;;;;;;1,0;;;;6,0;11,0;;1,0;1,0;;2,0;;;;;1,0;2,0;;19,0;11,0;;29,0;;;30,0;;1,0;;;6,0;15,0;13,0;8,0;11,0;;4,0;;;12,0;1,0;2,0;;;;;;1,0;;1,0;;11,0;6,0;16,0;;2,0;1,0;5,0;7,0;2,0;4,0;;;1,0;57,0;;1,0;;8,0;;1,0;7,0;;;1,0;21,0;;;;4,0;4,0;3,0;;31,0;;2,0;;3,0;2,0;;;5,0;1,0;6,0;;;12,0;;;;4,0;;9,0;2,0;10,0;;;27,0;28,0;2,0;;;;;;2,0;4,0;;;;;1,0;2,0;7,0;;3,0;;6,0;8,0;8,0;;;;25,0;1,0;1,0;;4,0;1,0;2,0;1,0;9,0;;;7,0;;13,0;66,0;;;;1,0;1,0;;;1,0;;;;5,0;;;;;;;2,0;;;15,0;9,0;;;1,0;;;2,0;;;;;;;;;;;;;3,0;;2,0;;20,0;;1,0;;;;;;;;;1,0;;;;;;;;;3,0;;6,0;;1,0;;;2,0;2,0;;;;;3,0;;3,0;;;;;7,0;;;;;1,0;;2,0;8,0;;;;;;;;;;;;3,0;;;;;;;;1,0;;;;3,0;2,0;;;;29,0;;;;;3,0;;1,0;;;;;;;;;1,0;;;;;;;;;;2,0;;;1,0;2,0;;;;;;;;;5,0;;;;;;;;;;;3,0;;1,0;;;;;;;;;;;;2,0;;;2,0;;;;;3,0;;;;;;;;;;;;;;;;;;;3,0;;2,0;1,0;;1,0;;;;;;;;;;8,0;;;;7,0;;;;;;;;;2,0;2,0;;;;2,0;;;2,0;;;;;1,0;;;;;;3,0;;;3,0;;;;;;;;;;;;8,0;;;1,0;11,0;;;;22,0;3,0;;2,0;7,0;;;;;4,0;;2,0;;;;;;;;;1,0;;;;;;;;8,0;;;;1,0;;2,0;2,0;1,0;4,0;1,0;;;;1,0;;14,0;;;1,0;;;2,0;;;;3,0;;;12,0;21,0;1,0;;;2,0;;;;;;;;;;;;;;3,0;11,0;;;;;1,0;;;1,0;1,0;;;;8,0;;;;;;;;2,0;;;1,0;;5,0;;;;;4,0;;;;;1,0;1,0;;;;;7,0;;9,0;;;3,0;;;;;;;;;;;;;;3,0;6,0;;4,0;;;4,0;;27,0;;;;;;;;;;;;1,0;11,0;;;4,0;;1,0;;;;;;;;;;;;;;2,0;;1,0;1,0;;5,0;;;;1,0;;;;;;;;;1,0;3,0;1,0;2,0;;;1,0;;;;;;;;;;;;;1,0;;;;;;1,0;;2,0;;;;;;;;;;;;;;;;;;6,0;;;;;;;1,0;;;;;;;;;4,0;;;2,0;7,0;;;;;;;;;;;;;;;;;;;;;;1,0;2,0;;1,0;;;;;;;;;;;1,0;;;;;;;;;;1,0;;;;;;;;;;;;3,0;;1,0;;;;;;1,0;;;;;1,0;;;;;;;4,0;1,0;;;3,0;3,0;2,0;;;;;;;;1,0;;;;;;;;;;;;;;1,0;;;;;;;;;;;;;;4,0;;;;;;;;;;;;;;;;;1,0;;;;;;;;;;;;;;;;;;;;;;;;;;;;;3,0;;;;;;;;;;;;1,0;;;;;;;;;;;;;;;;;;;;;;;2,0;;;;;;;;;;;;;;;;;;;;;;;;1,0;;;;;;;;;;;;;;;;;4,0;;;;;;;;;;;7,0;;;;;;;;;1,0;;;;;1,0;;;;;;;;;;;;;;;;;;;;;;;;;
compute;;;;1,0;8,0;83,0;18,0;64,0;10,0;4,0;12,0;;44,0;1,0;3,0;97,0;;6,0;22,0;4,0;19,0;110,0;3,0;10,0;;1,0;23,0;2,0;4,0;2,0;25,0;;83,0;;58,0;16,0;;15,0;3,0;;103,0;;8,0;78,0;39,0;3,0;90,0;1127,0;30,0;103,0;3,0;65,0;1,0;;2,0;33,0;30,0;11,0;21,0;19,0;;1,0;17,0;7,0;16,0;9,0;3,0;6,0;58,0;2,0;27,0;;37,0;1,0;;8,0;23,0;;7,0;403,0;1,0;3,0;35,0;65,0;;108,0;;;4,0;5,0;9,0;;1,0;;9,0;14,0;19,0;2,0;176,0;59,0;26,0;;33,0;91,0;2,0;23,0;19,0;2,0;38,0;32,0;4,0;67,0;1,0;;1,0;55,0;26,0;98,0;4,0;18,0;3,0;;10,0;39,0;111,0;42,0;14,0;;;8,0;;42,0;36,0;;16,0;5,0;11,0;41,0;4,0;1,0;18,0;;9,0;46,0;7,0;;;4,0;31,0;10,0;2,0;;14,0;32,0;13,0;;158,0;;12,0;2,0;6,0;18,0;123,0;9,0;;;67,0;46,0;1,0;;8,0;;;5,0;27,0;11,0;6,0;;2,0;;;4,0;;;;2,0;;19,0;1,0;2,0;2,0;;;8,0;;1,0;18,0;5,0;3,0;1,0;;;34,0;6,0;7,0;;;;43,0;5,0;;1,0;;;;;;;2,0;;;;;;;;2,0;;19,0;;;;;4,0;1,0;1,0;12,0;;;;1,0;;2,0;9,0;4,0;;;29,0;92,0;3,0;;3,0;2,0;;;;80,0;;;;;;2,0;30,0;;;12,0;;18,0;;2,0;3,0;15,0;;;;;12,0;;25,0;2,0;;3,0;;;26,0;;;;;23,0;6,0;;;;;6,0;;;;;3,0;4,0;;;;;15,0;3,0;5,0;1,0;;;;2,0;7,0;;1,0;;36,0;;;;;;;;;;;;;;;;1,0;;;1,0;;;;;4,0;;4,0;14,0;;13,0;3,0;;1,0;;;;2,0;33,0;64,0;112,0;;1,0;;;;;;;2,0;;;2,0;;;1,0;;4,0;;6,0;6,0;10,0;;;2,0;;;9,0;;;;14,0;;18,0;2,0;10,0;;1,0;;2,0;4,0;;17,0;2,0;;10,0;8,0;5,0;;3,0;20,0;26,0;24,0;6,0;31,0;12,0;;;3,0;;2,0;2,0;6,0;1,0;1,0;2,0;3,0;2,0;7,0;44,0;12,0;2,0;4,0;37,0;3,0;10,0;25,0;;11,0;22,0;5,0;;8,0;70,0;4,0;;14,0;5,0;30,0;3,0;51,0;4,0;3,0;;2,0;;4,0;3,0;10,0;9,0;;;1,0;;1,0;20,0;;;;;10,0;27,0;5,0;1,0;2,0;8,0;91,0;2,0;77,0;2,0;;;15,0;;8,0;2,0;30,0;1,0;1,0;1,0;22,0;8,0;;16,0;1,0;129,0;1,0;3,0;9,0;;35,0;;3,0;1,0;6,0;3,0;33,0;1,0;11,0;;1,0;;7,0;15,0;2,0;4,0;4,0;;6,0;2,0;;2,0;;9,0;;2,0;8,0;;6,0;;1,0;;1,0;14,0;;2,0;;;4,0;6,0;4,0;8,0;;;4,0;2,0;4,0;1,0;8,0;4,0;;6,0;2,0;;;4,0;;1,0;;;4,0;;;1,0;1,0;27,0;;9,0;5,0;35,0;3,0;2,0;4,0;2,0;7,0;;;15,0;;;2,0;;;2,0;2,0;2,0;3,0;1,0;1,0;24,0;;41,0;;12,0;;;6,0;;;;8,0;;6,0;;15,0;2,0;;12,0;5,0;;;;;3,0;;;;1,0;;3,0;;9,0;;4,0;;4,0;7,0;;14,0;;;1,0;1,0;;4,0;27,0;7,0;1,0;;;17,0;;7,0;8,0;3,0;1,0;10,0;3,0;;;15,0;3,0;;6,0;;;2,0;;;;;;;1,0;;;;3,0;;2,0;;;;;;;2,0;3,0;;;;6,0;;;15,0;;;4,0;3,0;2,0;;;;8,0;;;;1,0;37,0;;;2,0;;;4,0;13,0;;;2,0;2,0;;;;;;;;;;;;;;;;;;;;;1,0;10,0;1,0;1,0;3,0;1,0;1,0;;1,0;1,0;;;4,0;;;;;;;;;12,0;;1,0;;;;;;1,0;13,0;10,0;5,0;;;;;7,0;9,0;1,0;;;;;35,0;3,0;;;1,0;;42,0;;1,0;;;;1,0;2,0;2,0;2,0;;6,0;;32,0;;3,0;;;;1,0;6,0;;42,0;1,0;;4,0;5,0;2,0;;;3,0;5,0;4,0;10,0;;6,0;;;4,0;;;9,0;10,0;;1,0;6,0;;;4,0;9,0;;;;1,0;3,0;;;3,0;;;;;;2,0;1,0;1,0;18,0;;1,0;;;;;3,0;;2,0;;;23,0;;7,0;;;1,0;;;;5,0;;4,0;1,0;;4,0;5,0;;1,0;1,0;;6,0;;;;;;;;1,0;;;;;;;4,0;;;1,0;;11,0;4,0;;1,0;4,0;;2,0;;1,0;;;;;;;;;;;;3,0;;;1,0;;;;;;;;;;;4,0;;;;;;10,0;;;7,0;;;;;2,0;;;;;;;6,0;;;;;3,0;1,0;;;2,0;;10,0;;;4,0;;;;3,0;;;4,0;;2,0;4,0;;1,0;;11,0;2,0;24,0;2,0;;;5,0;;;;2,0;;3,0;;;;1,0;;;;
conductor;;;;2,0;;;;;1,0;2,0;1,0;;1,0;;;;;;;;;;;;;;;;;;;;3,0;;1,0;;;;;;;;3,0;;;;;2,0;;3,0;2,0;;;;;;35,0;;;;10,0;;;;;;;3,0;;1,0;4,0;;;;;28,0;;;;;;3,0;;10,0;;;;;;;;;;2,0;;;;;5,0;;;;15,0;;;;4,0;;1,0;;1,0;1,0;;;;3,0;4,0;3,0;7,0;1,0;;;1,0;;;;;;;;;;;;;;1,0;1,0;;;;;;6,0;;;;5,0;9,0;;;;;;;1,0;2,0;;;;;2,0;1,0;;;;2,0;;;;;;;3,0;;;3,0;;;;5,0;1,0;;;;10,0;3,0;8,0;4,0;;;;;35,0;;4,0;;;;16,0;;;;;;;3,0;;;;15,0;;;;;;;1,0;;1,0;5,0;;;;;1,0;;;;1,0;9,0;12,0;;4,0;;;;1,0;;2,0;;;;;;3,0;;;;;;;;;;;2,0;;;;;;;;6,0;;;6,0;2,0;;;1,0;;;;1,0;;3,0;5,0;38,0;;;1,0;;;;;;;1,0;4,0;;;8,0;;;;;;;2,0;;;;2,0;1,0;;;;;;;5,0;;;;;6,0;;;;;;;;;;;;;;;;;;;30,0;;;;;;;;;;;;;1,0;;;;;;;;4,0;;;;;;;;;;;2,0;;;;;;;;1,0;2,0;;;;;;;;;;;;4,0;;;;;;;;;;;;;;;;;;;;;;;;;;;1,0;;;;;;;;;;;;;;;;8,0;;;;;;;;1,0;;;;;;;;;;;;;;;;;;;;1,0;;;;;;;;1,0;2,0;;;;;;;;;2,0;4,0;1,0;;;;;;;;;1,0;;;;;;;;;;;;;;;;;;;;;;;;;;;;;;;;;1,0;;;;;7,0;;;;;;10,0;;;;;;;;;;;;;;;;;;;6,0;;;;;;;;;5,0;;;;;;;;;;;;;1,0;1,0;;;;;;;;;;;;;;;;;;;;;;;;;3,0;;;;;;;;;;;;;4,0;;;;;;;;;;;;;2,0;;;;;;;;;;;;;;;;;;;;;;;;;;;;;;;;;;;;;;;;;;;2,0;1,0;;1,0;;;;;;;;;;;;;;;;;;;;;;;;;;;;;;;;;;;;;;;;;;;;;;;;;;;;;;7,0;;;;;;;;;;;1,0;;;;1,0;;;;;;;;;;;;1,0;2,0;;;;;;;;;;2,0;;;;;;;2,0;;;;1,0;;;;;;;;;;;;;;;;;;1,0;;;;;2,0;;;;;;;;;;;;;;;;;;;;;;;;;;;;;;;;;;;;;;;;3,0;;;;;;;;;;;;;;;;;;;;;;;;;;;;;;;;;;;3,0;;;;;;;;;;;;;;;;;;;;;;;;;;;;;;;;;;;;;;;;;;;;;;;;;;;;;;;;;;;;;;;;;;;;;;;;;;;;;;;;;;;;;;;;;;;;;;;;;;;;;;;;;;;;;;;2,0;;;;;;;;;;;;;;;
continuous;;;;2,0;;1,0;;6,0;23,0;1,0;;;1,0;;1,0;3,0;;;1,0;;1,0;28,0;2,0;1,0;1,0;3,0;7,0;;;;1,0;;3,0;;5,0;1,0;;;1,0;;32,0;;2,0;;6,0;1,0;13,0;14,0;12,0;4,0;3,0;;;;8,0;3,0;9,0;;;;4,0;;1,0;4,0;;;4,0;14,0;18,0;4,0;14,0;;10,0;1,0;;;;2,0;5,0;96,0;;25,0;;15,0;;;;;;2,0;5,0;;;3,0;2,0;2,0;5,0;;28,0;1,0;;;5,0;11,0;;;2,0;5,0;15,0;;;11,0;1,0;;;14,0;15,0;5,0;;3,0;;;10,0;5,0;;;;;;9,0;;4,0;1,0;2,0;;;3,0;;1,0;;2,0;1,0;;13,0;1,0;;;1,0;17,0;1,0;;;15,0;1,0;15,0;;8,0;;;1,0;;;51,0;;;;10,0;11,0;4,0;;;;1,0;;1,0;;2,0;;;;;5,0;;;;;;1,0;1,0;;;;;;;3,0;;1,0;;5,0;;3,0;;17,0;;;;;2,0;1,0;1,0;2,0;;2,0;;;;;;;;;2,0;;;2,0;2,0;;73,0;;2,0;;;3,0;;1,0;11,0;4,0;;;;1,0;;;27,0;;;;2,0;2,0;;;;2,0;;;2,0;;8,0;;;;;10,0;2,0;1,0;1,0;;2,0;;;18,0;2,0;;3,0;;4,0;;;29,0;3,0;;1,0;;;11,0;;;;;5,0;;;;4,0;;;;;;;4,0;3,0;;;;;;;;;2,0;;1,0;;1,0;;;1,0;;;;;;1,0;;;;;;1,0;;;;;1,0;;1,0;;;3,0;;3,0;5,0;;;;;2,0;1,0;;;5,0;8,0;;;2,0;10,0;3,0;1,0;3,0;1,0;;;;;;;2,0;2,0;;4,0;;;;;;;;;;;;;;2,0;;;;;1,0;1,0;;1,0;;2,0;;1,0;;;13,0;3,0;1,0;2,0;;;;;;2,0;11,0;;1,0;;;2,0;;;1,0;;;1,0;;6,0;;;;;;;;10,0;5,0;;7,0;;;;38,0;2,0;;5,0;3,0;1,0;1,0;3,0;26,0;;;5,0;6,0;;;;;21,0;2,0;;;;;2,0;;2,0;;;;;1,0;2,0;;;;2,0;3,0;;;2,0;;1,0;2,0;;;;4,0;;;1,0;;1,0;;1,0;2,0;;;;;;;1,0;;;;38,0;1,0;;;;4,0;;;;;;8,0;;;;1,0;;4,0;;;2,0;;;;;;;;;;;;;;;1,0;3,0;2,0;;;;;;1,0;5,0;;1,0;;1,0;;;;;;2,0;;;;;;2,0;3,0;;;;;;2,0;;;;1,0;3,0;;;;;1,0;1,0;;;8,0;;;;;;;;;;;;;;7,0;;;;1,0;;;3,0;;;;1,0;;;3,0;;;;;;;;1,0;2,0;;;;;2,0;;;1,0;2,0;;;;;;;;;;;;2,0;;;;;;;;;;;;1,0;;4,0;1,0;;;;;;;3,0;;;2,0;;;;1,0;;;;;;;;;;;;;;;;1,0;;;13,0;;;;;;2,0;;;;;;1,0;;;;1,0;71,0;;2,0;;;;;;;;;;;;1,0;;;;;;;1,0;;;;;;11,0;;;;;;;;;2,0;;;;;;;;;;;;3,0;;;;;;;;;;;;;;;1,0;;;;1,0;;;;;;;2,0;;;6,0;1,0;25,0;;;6,0;4,0;;;;;;;;;2,0;4,0;1,0;;;;1,0;;;1,0;;;;;;;;1,0;;;;;1,0;1,0;3,0;;;;;;;;;;;7,0;;;;;;;1,0;;;;;;1,0;;;;;;;1,0;;;;;;1,0;;4,0;;;;;;;1,0;;;;;;;;;;;;;;;;;;;;;;;;;2,0;;;;2,0;;;;3,0;1,0;;;;;;;;;;;;;4,0;;;;;;;;;2,0;;;1,0;;;;;;;;;;;;;2,0;;;;1,0;;;;;;4,0;;1,0;;;;;;;;;;;1,0;;;;;;;;;;;;;2,0;1,0;;;;;;;;;;;;;;;;;;;;;
convert;;;;1,0;;10,0;2,0;33,0;15,0;25,0;28,0;1,0;6,0;;1,0;40,0;12,0;2,0;2,0;3,0;4,0;32,0;;;;10,0;77,0;;1,0;1,0;35,0;18,0;249,0;2,0;41,0;13,0;4,0;15,0;2,0;1,0;203,0;;10,0;14,0;28,0;12,0;23,0;97,0;141,0;102,0;14,0;26,0;;;10,0;;154,0;7,0;2,0;2,0;;3,0;;4,0;20,0;1,0;4,0;211,0;116,0;8,0;21,0;;66,0;;;13,0;1,0;6,0;;1498,0;3,0;92,0;2,0;80,0;;16,0;;;;3,0;205,0;;;1,0;4,0;;19,0;1,0;62,0;;18,0;3,0;29,0;289,0;;27,0;563,0;3,0;97,0;14,0;19,0;90,0;;2,0;6,0;58,0;48,0;19,0;15,0;34,0;;2,0;37,0;47,0;20,0;5,0;;4,0;43,0;12,0;;27,0;;;16,0;6,0;14,0;4,0;3,0;;4,0;;;259,0;2,0;;;1,0;760,0;;;;4,0;96,0;101,0;9,0;211,0;5,0;7,0;6,0;;34,0;284,0;;;;73,0;12,0;6,0;28,0;75,0;;;4,0;19,0;2,0;4,0;5,0;;32,0;4,0;19,0;1,0;1,0;102,0;84,0;;43,0;;;11,0;;;11,0;;2,0;21,0;;;4,0;1,0;;7,0;7,0;10,0;;148,0;17,0;;6,0;;;;;;2,0;;2,0;1,0;5,0;9,0;59,0;2,0;;;2,0;;;292,0;;2,0;;;3,0;2,0;;7,0;5,0;;;5,0;6,0;;10,0;33,0;11,0;145,0;4,0;240,0;8,0;;3,0;;;;20,0;91,0;7,0;;;;;;15,0;1,0;;5,0;;1,0;;;21,0;20,0;;;;;2,0;3,0;19,0;9,0;6,0;;;3,0;30,0;;6,0;6,0;;2,0;;;;;;;;;;1,0;2,0;;1,0;1,0;;;5,0;1,0;;;;4,0;;1,0;7,0;;;4,0;2,0;;;;;1,0;8,0;;;1,0;6,0;;;;;;22,0;;8,0;3,0;1,0;;;;1,0;37,0;;;6,0;;10,0;;;;36,0;;;11,0;25,0;2,0;;;15,0;;;;;4,0;;3,0;;;;;;;1,0;;;1,0;22,0;;;9,0;;;15,0;;;;1,0;;15,0;;4,0;;28,0;;;;;;;1,0;5,0;;;;1,0;3,0;12,0;6,0;45,0;6,0;;4,0;2,0;;2,0;;;;1,0;8,0;;1,0;;;4,0;;;;66,0;20,0;3,0;17,0;;4,0;2,0;9,0;;13,0;11,0;9,0;;;3,0;13,0;;9,0;2,0;4,0;;;;37,0;3,0;11,0;;;;7,0;3,0;6,0;;;;;;6,0;;3,0;;;2,0;3,0;3,0;2,0;;60,0;;15,0;3,0;;1,0;127,0;9,0;1,0;;;5,0;;;;1,0;2,0;;;;25,0;;3,0;;3,0;9,0;14,0;;;;32,0;1,0;8,0;1,0;5,0;1,0;11,0;;;;1,0;;6,0;2,0;3,0;9,0;2,0;;5,0;;;3,0;;1,0;3,0;;;;1,0;3,0;;;13,0;;;;1,0;7,0;;;;1,0;4,0;2,0;3,0;;;2,0;;;;7,0;;7,0;10,0;4,0;4,0;15,0;;4,0;;;;;9,0;;3,0;;;;1,0;2,0;;;;;2,0;9,0;;;;1,0;2,0;;;2,0;2,0;;1,0;;3,0;;5,0;;;2,0;1,0;;;;;;;;11,0;;1,0;;;;3,0;;4,0;;;2,0;;;24,0;5,0;;;2,0;;;17,0;3,0;;6,0;;;;9,0;;;;14,0;;2,0;;;5,0;;;2,0;;;;;3,0;;3,0;;34,0;;;182,0;;1,0;;;1,0;1,0;2,0;;;;;;;;;;;;;;12,0;;;18,0;;2,0;;;;;;;;;;;;;1,0;;8,0;;9,0;;;;;7,0;;;;;;;;;2,0;2,0;;1,0;1,0;;72,0;;;;6,0;;;18,0;3,0;;;;2,0;;;;;;;;3,0;3,0;;;;;;3,0;;;;26,0;19,0;;;2,0;129,0;;;1,0;16,0;;;;;1,0;3,0;6,0;;1,0;;35,0;2,0;11,0;1,0;;1,0;;;8,0;;17,0;9,0;3,0;;15,0;;2,0;;;;1,0;;3,0;3,0;;1,0;2,0;2,0;;;24,0;;2,0;;;;1,0;;1,0;;3,0;1,0;;7,0;1,0;3,0;;1,0;;1,0;1,0;8,0;;6,0;1,0;4,0;;;;;;1,0;;;;4,0;;;;3,0;;7,0;;5,0;10,0;;;;;;2,0;;;;;;9,0;4,0;1,0;;;;;;;;12,0;5,0;;;;2,0;;;3,0;;8,0;2,0;;;;;;10,0;;;;4,0;;;6,0;;6,0;;1,0;1,0;1,0;;;;;;;;;1,0;2,0;;;;6,0;;;;2,0;2,0;;;;1,0;;;2,0;;64,0;;1,0;;;;;;;;;;;;1,0;;;;;8,0;1,0;5,0;;;1,0;1,0;;;;;4,0;;;;;12,0;;;;;1,0;;;2,0;1,0;;;;;;;1,0;;;;;4,0;;;;3,0;;;;;;;
cylinder;;;;2,0;;4,0;;;;2,0;2,0;;;;22,0;11,0;;;;;;9,0;;8,0;;;;1,0;;;;;36,0;;3,0;;3,0;;;1,0;;;8,0;;;;;11,0;;;3,0;1,0;;;10,0;;;;;;16,0;5,0;;;;1,0;;21,0;26,0;6,0;;;;;;41,0;;;;8,0;;1,0;;20,0;;;;;;2,0;87,0;;;4,0;;;;;1,0;;;;16,0;6,0;;;12,0;;4,0;;4,0;;;;;36,0;23,0;35,0;1,0;3,0;;;;;;;;;;5,0;;;;1,0;;;5,0;2,0;;;;;;7,0;;;;10,0;;;;1,0;;3,0;;;11,0;;1,0;;;2,0;3,0;;;;;;;;;;;;;2,0;1,0;27,0;;;2,0;5,0;;2,0;;2,0;;4,0;;;;;;10,0;1,0;6,0;;;;;9,0;;;10,0;;;;;;4,0;;1,0;;8,0;;;1,0;;1,0;;6,0;;2,0;;;;;2,0;;;3,0;;;9,0;12,0;8,0;;9,0;3,0;12,0;;;;7,0;;;;;;;12,0;;;;4,0;;10,0;;;;3,0;;;;;;9,0;;;;1,0;;14,0;;;;;;;28,0;;;;2,0;;1,0;;;;;2,0;;;;16,0;;;;4,0;2,0;8,0;3,0;12,0;2,0;;1,0;;8,0;10,0;;;1,0;1,0;4,0;6,0;;;;;2,0;;;20,0;2,0;8,0;;11,0;;;;;;2,0;2,0;;;;2,0;2,0;3,0;38,0;5,0;4,0;;;2,0;10,0;1,0;3,0;;6,0;;;;;;;;2,0;;;;;;9,0;2,0;;;1,0;;;;;;;;8,0;;15,0;;6,0;4,0;;9,0;;1,0;;1,0;;14,0;;;;;4,0;;;;;;;;;6,0;;;;;;;;;;;;;;;;;;;4,0;;;;;;;;;;;;1,0;;;;;;1,0;;3,0;;;1,0;;;4,0;;;;;;;;;;;;;;;4,0;;;;;;;;;;;;;;;;;2,0;;;3,0;;;1,0;;;;;;;;;;;;;;4,0;;;20,0;;;;;;;;;;;;;4,0;;;;;;1,0;;;;;1,0;;;;;;5,0;;2,0;;;;;;3,0;2,0;;;;;;18,0;;;;;;;;;;;;;;;;1,0;;2,0;2,0;;;;;;;;;;;;;;;;;;;;;;;;;;;;2,0;;;;1,0;2,0;;;;;;;;;;;;;;7,0;;;;;;;;;;;;;;6,0;;;;;;;;;;;;;;;;;;;6,0;;;;;;21,0;;9,0;;;;3,0;;;;;;;;;;;;1,0;;;;;;;;;;;;;;;;;;;;;;;;;;;1,0;;;;;;1,0;;;;;;;;;6,0;;;;;4,0;;;;;1,0;;4,0;;;;2,0;;;;;;;1,0;;;;;;;1,0;;;;;;;;;;;;;;;;;;;;;;;;;;;;;;;;5,0;;;;1,0;;;;;2,0;;;;;;;;;;;;;;2,0;;;;;;;;3,0;1,0;;;;;;;;;;;;;;;;;;1,0;;;;;;;;;2,0;;1,0;41,0;7,0;;;;;;;;2,0;;;;;;;;;;;2,0;;;;;;;;;;;;2,0;;;;9,0;;;;;18,0;2,0;;;;;;;12,0;;;;;;;;;;;;;;;;;;;;;;;;;;;;;;;;;;;;;;;;;;;;;;;;;;;;;;;;17,0;;;5,0;;;;;;;;;2,0;;1,0;;;;;;;;;;;;;;;;;2,0;;;;;;;;;;;;;;;;;;;;;;;;;;
diode;;;;1,0;;2,0;1,0;13,0;11,0;2,0;11,0;;;;1,0;6,0;3,0;;2,0;4,0;;2,0;2,0;;;;12,0;12,0;;;;;6,0;;17,0;1,0;;1,0;;;;1,0;4,0;5,0;3,0;;2,0;28,0;7,0;14,0;2,0;1,0;;2,0;3,0;;39,0;;;;;;8,0;;1,0;;;1,0;;3,0;;;5,0;;;1,0;;19,0;8,0;15,0;;3,0;;31,0;;;;;;1,0;8,0;;;;;;5,0;;21,0;1,0;;;8,0;3,0;;5,0;11,0;;8,0;;13,0;;;;;29,0;;14,0;6,0;;;;;2,0;;;;2,0;12,0;;;6,0;2,0;;;;1,0;;;;;2,0;;3,0;;;;10,0;3,0;2,0;;;;4,0;;4,0;35,0;;;;2,0;;8,0;;;;2,0;2,0;1,0;1,0;;;;3,0;;;1,0;;;8,0;3,0;1,0;;;1,0;;;1,0;;;;;;27,0;;;;;;;1,0;;;12,0;;;13,0;;1,0;3,0;;;;;;6,0;;1,0;;;;2,0;;;;;;;296,0;;;1,0;;10,0;;1,0;;;2,0;;;3,0;;3,0;;;4,0;;;3,0;;;;;;;1,0;1,0;;;;;1,0;3,0;;;;3,0;;;;32,0;1,0;;5,0;;;6,0;2,0;;4,0;;8,0;;4,0;5,0;;1,0;;1,0;;;;;;;;;;;;;;;;;;1,0;;;2,0;;2,0;;;;;;;10,0;;;;;;;;;;;;;2,0;;;;;6,0;;;;;;;;;;;;;;2,0;;4,0;;;;2,0;2,0;;;;;;;;;;;;;;;;;;;;;;;;;;;;1,0;;;1,0;;;;;;;;;;;;;;;;;;;1,0;;1,0;;;;1,0;1,0;;2,0;;;;;;;;;;;;;;13,0;;5,0;1,0;;;1,0;2,0;;;2,0;;;;7,0;3,0;;;4,0;;;;;;;;;;;;;;;;;;;;1,0;;;;;;;;;5,0;;2,0;2,0;;;;;;;1,0;;;;;;;12,0;5,0;1,0;;;;;;;;;1,0;9,0;;;;2,0;;;;2,0;;;;;;;;;;;;;;;;;;4,0;;;;;;;;;;1,0;;3,0;;;;;;;1,0;;;;;5,0;;;;;;;;;;;;;;;4,0;;1,0;;;;;;;;;;13,0;;;2,0;;;;;;;;;;;;;;;;;1,0;2,0;;;;;;;;1,0;;;;;;;;;;;;;1,0;;;;;;;;;;;;;;;;1,0;;;;;3,0;;;;;;;1,0;;;;;;;;;1,0;8,0;1,0;1,0;;;;1,0;1,0;11,0;;1,0;;;;;;;;;;;;;;;1,0;;;;;;2,0;3,0;4,0;;;;;;;;;;;;;;;;;;4,0;;;;;10,0;;;;;6,0;;;;;;;;;276,0;;7,0;;;;;;3,0;;;;;;;;;;;;;;;;3,0;;;;;1,0;;;;;;;3,0;;;;3,0;;;;;;;6,0;;;;;2,0;;;;;;16,0;;;;;;;1,0;;;;;;;1,0;;;;;;;;;;;;;;;;;;;;5,0;;;;16,0;14,0;;;;;;;;;;;1,0;;;;;;;;;;;;;;;1,0;;;;;;;;;;;;;;;2,0;;3,0;;;;;;;;;;;;;;;;;;;;;;;;3,0;;;;;;;;;;;;;;;;62,0;;;;;;;;;;;;;;;;2,0;;;;;;;;;;;;;;;;;;;;;;;;;;;;;;;;;;;;;;;;;;;;;;;;;;;;;;;;;;;;;;;;;;2,0;;;
document;;;;1,0;2,0;16,0;;34,0;;1,0;;;1,0;;;2,0;;;2,0;;;17,0;;;;;2,0;4,0;;;6,0;;3,0;;12,0;;1,0;2,0;19,0;;12,0;;;;6,0;9,0;8,0;7,0;75,0;28,0;11,0;4,0;;;;13,0;;;3,0;;1,0;6,0;;;4,0;1,0;1,0;9,0;16,0;1,0;9,0;;1,0;;;2,0;4,0;21,0;;105,0;7,0;44,0;;20,0;;;;;;1,0;6,0;;;1,0;;;2,0;;29,0;;;;;9,0;;;3,0;;5,0;1,0;2,0;4,0;;;;15,0;22,0;6,0;;7,0;;;3,0;20,0;21,0;1,0;;10,0;;;;2,0;;3,0;;;;;1,0;;;;4,0;2,0;2,0;;;35,0;;5,0;;;;3,0;;;22,0;;;;1,0;4,0;3,0;;;;14,0;1,0;;;2,0;;;;;5,0;6,0;;;;;1,0;;;;;;;;;;;;4,0;;;20,0;;;1,0;;1,0;;;;;;;;3,0;;2,0;;;;;;;;;;;;1,0;;;;;14,0;;;;;6,0;;;;3,0;;;;;;;;;;;9,0;;;;;;;1,0;6,0;;;;;;;34,0;;;;;;;;8,0;;;;;;6,0;;12,0;3,0;1,0;3,0;3,0;;1,0;1,0;1,0;;1,0;;;;;1,0;;;;;;;;;;;;;;1,0;;;2,0;;;;1,0;;;;;;;;;;;;;;;;;;;;1,0;;2,0;2,0;;;;;1,0;;;;;;1,0;;;;;;;;1,0;2,0;;;1,0;;;;;;;;;;;;;;;;;4,0;5,0;;;2,0;;2,0;;;;;;;;;1,0;;3,0;;;;1,0;;;;;;;;;;2,0;;;;1,0;1,0;;;;;;;;;;;;;9,0;;;;4,0;;;;;1,0;;7,0;;;;;;4,0;;;7,0;;;;;;;;;3,0;4,0;;;3,0;;;;;;;;2,0;;;;;4,0;8,0;;;;;;2,0;2,0;;;;;2,0;;1,0;;;;;;;;;;;;2,0;;;6,0;;;;;1,0;;1,0;3,0;;;1,0;;;;;;2,0;;;1,0;;;15,0;;3,0;;;1,0;;;;;;;;;;;;;;7,0;;;;9,0;;;;3,0;;;;;;;;2,0;;;;;;3,0;;;;;;;;3,0;3,0;;;;;;4,0;;;;;;;;35,0;;;;;3,0;20,0;;;;;;;;;1,0;;;;;;;;;;;;;;;;1,0;;2,0;;;12,0;;;;;1,0;;;1,0;2,0;;;;;;;;;;;;;;;;1,0;;1,0;4,0;;;2,0;1,0;;;;7,0;2,0;;;;;;;2,0;;;;;;;;;;;1,0;;;;;;12,0;;;;;;;;1,0;;;1,0;;;;;;;;;1,0;;;1,0;;;1,0;;;;;;;;;1,0;;;;;;;;;;1,0;;;;;;;;1,0;;;;;;1,0;;;;;;;;;;;;;;;;;;;4,0;;;;;;;;7,0;;;;;4,0;;;4,0;;;;;35,0;;;;3,0;;;2,0;;;;;1,0;;;;;1,0;;;;;;2,0;;;;;;;;;1,0;;;;;;;;;;;;;;;;;;;;;2,0;;;;;;;;;;;;19,0;;2,0;;;;;;;;;;;;;;;;2,0;;;;;;;1,0;;;;;;;;;;;;;;;;;;;;;;;;;;;;;;;;;;;;;;;2,0;;;;1,0;;;;;;;;;;;;;;;;;;;;;;;;4,0;;;1,0;;;;;;;;;;;;;;;;;;;;;;;1,0;;;;;;;;;;;5,0;;;;;1,0;;;;;;;2,0;;;;;;;
emitter;;;;3,0;;1,0;1,0;3,0;1,0;4,0;;;;;1,0;1,0;9,0;;;;;3,0;;;;;;;;;2,0;;8,0;;3,0;5,0;;;1,0;;;;;;5,0;;;21,0;;4,0;3,0;2,0;;;2,0;;2,0;;;;1,0;;1,0;;;;1,0;2,0;;11,0;;1,0;2,0;;;2,0;;9,0;5,0;21,0;;1,0;;15,0;;1,0;;;;;2,0;;;;;1,0;2,0;;14,0;;;;7,0;3,0;;;41,0;;;;1,0;4,0;;;;16,0;1,0;21,0;;4,0;;;4,0;;2,0;;;;1,0;1,0;;;5,0;4,0;;;;2,0;;;1,0;;3,0;4,0;;;;5,0;12,0;;;;;2,0;1,0;;12,0;;2,0;;;1,0;1,0;;1,0;;;4,0;;5,0;;;;8,0;;;1,0;;;;;2,0;;1,0;;4,0;;;;;;;;2,0;;;;;;;;;;;;;;4,0;;6,0;;;;;;;;;;8,0;8,0;;;;;;3,0;;128,0;;2,0;;5,0;2,0;;1,0;3,0;;;;;;;5,0;;;;;1,0;;;;;;;;9,0;9,0;1,0;;;;;3,0;;;;;2,0;;;7,0;2,0;;2,0;;;4,0;;9,0;;;;;;;;;;;3,0;;;;;;;;;;;;4,0;2,0;;;;;1,0;;;;;;;;;;;2,0;;;;;2,0;8,0;;;;;;;;;;1,0;;;;;;;;;;;;4,0;;5,0;;1,0;;;;;;;;;;2,0;;;;;;;;;;;;;;;;;1,0;;;;;;;;;;;1,0;;1,0;;;;;;;;1,0;;;;;;;;;;;;1,0;1,0;;1,0;;;;;;;;34,0;1,0;;;;;;1,0;;;;;;;;;;1,0;8,0;3,0;;;;;2,0;;1,0;;;;;;;11,0;;;;;;5,0;;;;;;;;6,0;;;;;;;;;;;;2,0;;1,0;;;;;;;;1,0;;;;;;;;;;;;;;;;;;;;2,0;;;;;;;;;;2,0;;2,0;;;5,0;;;;;;;;;;2,0;;;;;;;1,0;;;;;;;;;;;;;;;;1,0;;;;;;;;;;;12,0;;5,0;;;;;;;;;;;;1,0;;;;;;;;;;;4,0;;;;;1,0;;;;2,0;1,0;;;;;;;;;1,0;;2,0;;;;;;;;;;3,0;;;;;;;;1,0;;;;;;2,0;;1,0;;;;;;;;;;;;;;;;;;;;;;;;;;;;2,0;;3,0;;;;;;;;;;;;;1,0;;7,0;;;;2,0;;;;;;;;;;;15,0;;;;1,0;;;;;;;2,0;;;1,0;;;;1,0;;;;;6,0;;;;;;;;;49,0;;2,0;3,0;;;;;;;;3,0;;;;;;;;;;;;;;;;;;;;;;;;;;;;;;;;;;2,0;;;;;;2,0;;;;;;;1,0;;;;;;;;;;;;;;;;;;2,0;;;;;;;;;;;;1,0;;;;;;;;;;;;;3,0;;;;;;;;;;;;;;;;;;;;;;;;;;;;;;;;;;;;;;;;;;;;;;;;;;;;;;;;33,0;;;3,0;;;;;;;;;;;;;;;;;;;;1,0;;;;;;;;;;;;;;;;;;;;1,0;;;;;;;;;2,0;;;;;;;;;;2,0;;;;;;;;;;;;;;;;;;;;;;;;1,0;;;;;;;;1,0;;;;;;;;;;;;;;
evaluation;;;;2,0;22,0;11,0;1,0;33,0;44,0;11,0;;;16,0;;;126,0;1,0;7,0;3,0;;1,0;68,0;;3,0;4,0;;51,0;;;;3,0;14,0;52,0;31,0;82,0;34,0;;;5,0;;127,0;;2,0;1,0;26,0;38,0;63,0;71,0;39,0;1,0;;18,0;;;6,0;4,0;1,0;3,0;2,0;;;5,0;5,0;;;3,0;114,0;4,0;21,0;2,0;8,0;5,0;45,0;19,0;;3,0;12,0;1,0;;417,0;;11,0;;25,0;4,0;14,0;1,0;1,0;;5,0;60,0;;;;4,0;12,0;21,0;;30,0;;9,0;;82,0;51,0;1,0;18,0;5,0;6,0;26,0;3,0;1,0;30,0;;4,0;;45,0;22,0;64,0;;20,0;;;24,0;46,0;1,0;3,0;;1,0;2,0;4,0;2,0;;4,0;;9,0;1,0;2,0;5,0;11,0;12,0;22,0;16,0;1,0;17,0;3,0;;;5,0;37,0;8,0;;1,0;28,0;6,0;56,0;;40,0;;24,0;;1,0;2,0;181,0;;;;12,0;;;;;;;;23,0;9,0;;;;1,0;;2,0;;;;2,0;;3,0;5,0;;;;;10,0;;;;;;;;3,0;6,0;25,0;;;3,0;;29,0;5,0;;;;3,0;;1,0;;;1,0;;;;;;;;;;6,0;;4,0;;2,0;1,0;;9,0;13,0;;;;;;;;;;;2,0;19,0;;;;;;;;4,0;2,0;;;;;;24,0;;;5,0;2,0;;;;1,0;;;;;2,0;;;2,0;5,0;;;;;12,0;1,0;;;;3,0;3,0;;;;;4,0;;;;;1,0;;;;;;;;;4,0;21,0;;;;5,0;;;;;;;;;1,0;;;;;;;;;;;6,0;;;;;;;;3,0;10,0;4,0;;2,0;4,0;22,0;;;;5,0;;;;11,0;;;1,0;;;;;;;;;;5,0;1,0;;;;;;;;;;;3,0;;;19,0;;;1,0;;;23,0;;;;1,0;;;2,0;;;;;6,0;;;;;22,0;159,0;8,0;2,0;30,0;;35,0;;;;1,0;;;1,0;1,0;20,0;1,0;;1,0;22,0;5,0;2,0;;6,0;20,0;;;;10,0;6,0;4,0;1,0;;27,0;26,0;;1,0;2,0;28,0;1,0;;4,0;8,0;;;;4,0;13,0;1,0;;;2,0;;;;;;;1,0;;24,0;11,0;;;;14,0;4,0;;7,0;;;;1,0;;2,0;1,0;3,0;4,0;1,0;2,0;;;;1,0;;6,0;;;;;2,0;;5,0;;;1,0;;1,0;;;10,0;;1,0;;;;5,0;;1,0;;;;2,0;4,0;;2,0;2,0;;;;;4,0;;4,0;2,0;5,0;;;16,0;3,0;;;;;;;;10,0;2,0;;;5,0;;;4,0;;;4,0;;;;;;7,0;;7,0;;;;10,0;;;1,0;5,0;;;;;;;;;36,0;;;;2,0;2,0;3,0;;;;;;;;;1,0;;17,0;;;;;;2,0;;;;;;;;;;;;5,0;;1,0;;2,0;;;;4,0;2,0;;19,0;;;;;;30,0;;12,0;;;;;;;;5,0;2,0;;;;;16,0;;;;;;;;1,0;4,0;;;;1,0;;;3,0;;;22,0;;;;;;;;;;;;;;;;;;11,0;;;;;;;;;;;;4,0;;;;;1,0;1,0;;;;32,0;;;;;;10,0;;;;;;;;;;;;;;2,0;;;;;1,0;;1,0;;;;;;;;;;;;;;;;;;;;;;;;;1,0;125,0;;;2,0;;3,0;1,0;6,0;;;;;;;;1,0;2,0;;7,0;14,0;;;;;;1,0;7,0;44,0;;;;;;;;;;10,0;;11,0;7,0;;;12,0;3,0;;;;6,0;;;;;3,0;;;2,0;;;4,0;;;;6,0;;;;;;1,0;;4,0;;;6,0;;;;;;;;;;;14,0;1,0;;;1,0;2,0;;;;;;;;;;;;;;;;;;1,0;;;;;;;;;;;;;;;;6,0;;;2,0;;;;;1,0;;;;;;;;;;;;;;;;;;;;;;;;4,0;;;;;;;;;5,0;;;1,0;;8,0;;;;3,0;;;;;;2,0;;;;1,0;;;;1,0;;;2,0;4,0;;;;;5,0;;;;;;;;;3,0;;;;;;;;;;;;;;;;;4,0;;;;;;;5,0;;;;;;;;;
exceed;;;;2,0;;13,0;;6,0;14,0;;;;9,0;;;5,0;;;6,0;1,0;1,0;29,0;5,0;2,0;1,0;;1,0;;;;;5,0;;;20,0;1,0;;1,0;2,0;;15,0;3,0;;3,0;32,0;1,0;52,0;8,0;6,0;4,0;;36,0;;6,0;2,0;1,0;10,0;13,0;;;;2,0;2,0;;1,0;2,0;6,0;4,0;39,0;;8,0;;2,0;;;;;;1,0;77,0;;1,0;;5,0;1,0;1,0;1,0;;;;14,0;;;;6,0;3,0;2,0;;30,0;;4,0;;;18,0;;2,0;5,0;1,0;9,0;;;3,0;;;;13,0;18,0;12,0;;94,0;;;3,0;3,0;3,0;;;1,0;;14,0;;7,0;1,0;;;13,0;1,0;9,0;11,0;;8,0;;2,0;3,0;;;;;16,0;9,0;3,0;;;2,0;2,0;;7,0;;;2,0;;4,0;11,0;2,0;;;15,0;1,0;;;;;;6,0;36,0;2,0;;1,0;;;;2,0;;;1,0;4,0;;2,0;;;;1,0;;;;;;;;;2,0;;10,0;6,0;22,0;;1,0;7,0;8,0;9,0;;;2,0;;;;;;15,0;;2,0;;;;;;;;8,0;;;;1,0;;;;;;;3,0;;;;;1,0;;;;16,0;;3,0;;;;;;6,0;2,0;;;;;;12,0;;;;;;;;;1,0;2,0;;;1,0;;1,0;2,0;1,0;1,0;;3,0;;46,0;;;;;3,0;;1,0;;;1,0;6,0;;1,0;;5,0;;;;;;;3,0;;3,0;4,0;;;;;;;;;;;;5,0;2,0;1,0;;;;;2,0;;;;;;4,0;;;;;;;;1,0;10,0;;;1,0;;1,0;1,0;;;2,0;;;;1,0;;;1,0;;;;;;;;2,0;;;;;;;;;;;3,0;;;;;;2,0;1,0;;;18,0;1,0;2,0;;;2,0;;;4,0;;;3,0;3,0;;;;;;;;6,0;19,0;;1,0;;7,0;2,0;;;;1,0;;;4,0;2,0;1,0;;;5,0;4,0;;;5,0;33,0;;1,0;2,0;4,0;17,0;10,0;;2,0;22,0;3,0;1,0;1,0;2,0;9,0;4,0;2,0;;;2,0;;6,0;16,0;;;;;;2,0;;;2,0;;;2,0;;247,0;;;;1,0;;5,0;;;28,0;;2,0;13,0;;3,0;;4,0;1,0;;;;;;2,0;;2,0;;;;;;;;;;;2,0;;;;1,0;;;;;;;4,0;;;;;;1,0;;;9,0;2,0;;;;;;5,0;;;4,0;;2,0;1,0;1,0;3,0;;;;7,0;;;5,0;6,0;;;;;6,0;3,0;;1,0;;5,0;;;;;;;;4,0;;;;;;;;;;3,0;;;;;;;;;3,0;;;3,0;;;;;;1,0;;;;;;;5,0;;1,0;;;1,0;1,0;;;;;;;;;2,0;;;;;;;;2,0;;;13,0;;;;;;;;;;;1,0;;;1,0;;;;;;2,0;;;;;2,0;;;;;;;;;;;;;;;;4,0;;2,0;;;;;;;;;;;;;;;;2,0;;;;;;;;;1,0;;;;;;;;;;;2,0;;;3,0;;;;;4,0;;;;;;;;;;;;;;;;;;;;;;1,0;;;;;;;;;;;;;;1,0;;;;;;2,0;1,0;;;;1,0;3,0;;1,0;1,0;4,0;;;;;5,0;;1,0;;5,0;;;;;12,0;5,0;;;;3,0;2,0;1,0;11,0;;1,0;;;;;;;;;2,0;;4,0;;;;;;;;10,0;;;10,0;;13,0;;;;;;;;;;;10,0;;;;;;;12,0;;;5,0;;;;;2,0;;;;;;1,0;;3,0;;;5,0;;3,0;1,0;;;;1,0;1,0;;;;;;;;;;;;;;;7,0;;;;;;;;;2,0;;;;;;;;;;;;;;2,0;;9,0;;;;;1,0;;;;;;;;;;;;;;;;;;;;1,0;;2,0;;;;;;;;1,0;;;;;;;;;;;;1,0;;;1,0;;;;;;;;;;;;3,0;;;;;;;;;;;;1,0;;;;;;2,0;7,0;;3,0;;;;;;;;;;;;;;;;;;
gear;;;;1,0;;;;2,0;;4,0;;;3,0;;13,0;15,0;;;;;;;1,0;;5,0;;;;;;;;15,0;;4,0;1,0;;;;;;;2,0;;;;1,0;49,0;;;13,0;;;;62,0;;12,0;;;;4,0;1,0;;;2,0;;7,0;8,0;4,0;1,0;2,0;;;;;;;;;;;;;26,0;;;;1,0;;;10,0;;;;;;;;1,0;;;;2,0;;;;;;25,0;;1,0;;;;;22,0;16,0;10,0;3,0;2,0;;;;;;;;;;;;;8,0;;;;;;;;;;;2,0;;;;2,0;1,0;;;;;;;;9,0;;3,0;39,0;;13,0;14,0;;;;2,0;;;;;;;1,0;;;19,0;;;;;11,0;1,0;;;;;17,0;;;;;;14,0;;;;;;4,0;2,0;1,0;;14,0;;1,0;;;;;;;9,0;;;;;;;5,0;15,0;;8,0;;;;;;;;4,0;;4,0;13,0;1,0;20,0;17,0;;1,0;7,0;4,0;;2,0;;;;;;;3,0;1,0;;;;;;2,0;;;;;;3,0;;;;1,0;;3,0;;6,0;;;;;2,0;;5,0;;7,0;;;;;;;;;12,0;;14,0;1,0;;;;;1,0;;;;10,0;1,0;22,0;5,0;1,0;14,0;;3,0;;;;5,0;;;;;;;;34,0;;;1,0;;132,0;;89,0;;;;;;;;;3,0;1,0;19,0;;1,0;10,0;;;9,0;;11,0;;49,0;5,0;;;6,0;;;;;7,0;;4,0;2,0;;;;2,0;;;;;2,0;;2,0;;1,0;;;;8,0;7,0;30,0;32,0;5,0;;5,0;66,0;;2,0;;;8,0;15,0;;;;1,0;5,0;8,0;18,0;;;;;;;1,0;;2,0;;;2,0;;;;;;;;1,0;;;;;;;;;;;;;1,0;;4,0;;28,0;1,0;;1,0;;;;;;4,0;;;1,0;16,0;;;;1,0;;;;;;;;4,0;;;;;6,0;;;;;;1,0;;;;;;;;;;;1,0;;;;;;;;;;;;;;;2,0;;;;;30,0;;;;;;10,0;;;;;;;;;;;;;;;2,0;1,0;;;;;1,0;;;;;1,0;;;;;;;;;5,0;;;;;;;;;;;;;;1,0;;;1,0;;;;;;10,0;;;3,0;;;5,0;;;;;;;3,0;;;;;;;;;;;;;;;;;2,0;;;;;;;;;;;;;;;;;;1,0;;;;;;;;;;;;;;;;;;;;;;;;4,0;;;;;;;;;;2,0;4,0;;;;;;;1,0;;1,0;;;;;;;;;;;;;;;;;;;;;;;;;;11,0;;;3,0;;;;;1,0;;2,0;;;2,0;;;;;;;;;2,0;16,0;6,0;;;;;;;1,0;;;;;;;;21,0;;;;;;;;;;;;;;;;;;;;;;;2,0;;;;;;;;;;;;;;;;;;;;;;;;;;;;;;;;;;;;;;;;;;;;;;;;;1,0;;;;;;;;2,0;;;;;;1,0;;;;;;;;9,0;;13,0;;;;;;;;;;;;;;;;;;;8,0;7,0;;;;2,0;2,0;;;;3,0;;;;;;;;2,0;;;;;1,0;;;;;;;;;;;;;;4,0;;;;5,0;;1,0;;;;;;;;1,0;;;;;;;;;;;;;;;;;;5,0;;2,0;;1,0;;;;;;;;;;;;;;;1,0;;1,0;;;;;;;;;;;;;;;;;;;;;;;;;;;;;;;;;;;;;;;;;;;;3,0;;;;;;;;12,0;;;;;;;;;;;;;;1,0;;;;;;;
indication;;;;3,0;3,0;5,0;;4,0;9,0;1,0;;;9,0;;13,0;26,0;;;;;1,0;18,0;;;;;1,0;1,0;;1,0;5,0;5,0;26,0;;68,0;8,0;;;2,0;15,0;19,0;5,0;;12,0;8,0;1,0;18,0;37,0;23,0;62,0;;;;;1,0;;16,0;;;;;1,0;2,0;4,0;;;7,0;1,0;11,0;1,0;3,0;;21,0;;5,0;3,0;3,0;;;83,0;;;2,0;25,0;7,0;20,0;;;;;6,0;;2,0;;2,0;17,0;6,0;3,0;59,0;12,0;2,0;;4,0;17,0;;2,0;3,0;1,0;22,0;18,0;3,0;2,0;;;;7,0;8,0;4,0;;1,0;;;;4,0;8,0;2,0;;;1,0;3,0;;2,0;1,0;;3,0;1,0;9,0;10,0;2,0;4,0;4,0;2,0;7,0;9,0;4,0;;;3,0;16,0;8,0;3,0;;4,0;12,0;3,0;1,0;20,0;;;;1,0;6,0;37,0;;3,0;;11,0;5,0;;;3,0;;;;1,0;;;;;;;;;;;2,0;;1,0;;;;;;;;;4,0;;;;;;;10,0;;;;;;1,0;;2,0;;;;;;;;;;;;;;;;;9,0;;;;;;;2,0;5,0;;;;;;1,0;2,0;;;;;;;;;;;;;63,0;1,0;;;;;;13,0;;3,0;;;;;;9,0;2,0;;;;5,0;;;24,0;1,0;;2,0;;;7,0;;;;;8,0;;;;;;;;;;;;;;;;;2,0;;;;;;;;5,0;;;;2,0;;;;8,0;;;;1,0;;;;;;;;;;1,0;;;;;;1,0;;1,0;;;;3,0;;;;1,0;;6,0;;7,0;1,0;;;8,0;;;;;;11,0;;;;;;3,0;;;;;1,0;4,0;;;;;;1,0;;;;16,0;;19,0;;;;;;;;;;;;2,0;;;;;;2,0;7,0;1,0;1,0;;4,0;;;;;;;4,0;5,0;;1,0;;;;;;;10,0;15,0;;23,0;;3,0;;5,0;;2,0;9,0;2,0;;12,0;3,0;3,0;1,0;;1,0;;;;2,0;3,0;7,0;7,0;17,0;;;;2,0;1,0;;;;1,0;1,0;;9,0;2,0;;;4,0;63,0;4,0;2,0;5,0;1,0;;1,0;4,0;1,0;2,0;;;;;;1,0;;;1,0;1,0;;1,0;2,0;2,0;18,0;;;;;3,0;7,0;;;1,0;;;44,0;3,0;4,0;;;;;4,0;3,0;;;2,0;;;;1,0;;;;1,0;;;;2,0;2,0;;26,0;;;4,0;;;;1,0;;;1,0;;;6,0;;;14,0;22,0;;1,0;;;;;;;;;;;;12,0;2,0;;;;;;;3,0;;;;;6,0;;;;;;1,0;9,0;;2,0;1,0;5,0;;;;;;1,0;;;;;;4,0;;;1,0;;;;;1,0;;;;;2,0;4,0;;;;;;1,0;2,0;;2,0;;;;;;;;1,0;1,0;;;;;1,0;;;;;;;;17,0;2,0;;11,0;;2,0;1,0;;;;;;;;;3,0;;;;;;;;;;;;;;;;;;;;;;;;;;;;;;;1,0;;;;;;;;;;;;1,0;;;;;;;;;;;;;;;;;;;;;;;2,0;;;;1,0;1,0;;;4,0;;;;;;;;;;;;3,0;;;;;;;;;1,0;;;;;2,0;;;;;;2,0;;;;;;;;;4,0;;;7,0;;;;;;;;1,0;4,0;;;;;;;;12,0;2,0;1,0;;;;2,0;;;;;;;;;1,0;;;;;;;;;;;;;;;;;;;;;;;1,0;;;;;1,0;1,0;1,0;2,0;;;;;;5,0;;;;3,0;;;;3,0;1,0;1,0;;3,0;;;1,0;1,0;;;;;1,0;5,0;;;;;;;;;;;2,0;5,0;3,0;;1,0;1,0;;;;;;;;3,0;;8,0;;;;3,0;1,0;4,0;;;;;;;;;;;;;;;6,0;;;;;;;;;;;;;;9,0;;;;;;;;;;;;;1,0;;;;;;;;;;;;;;;;;;;;;6,0;;;;;;;1,0;;;1,0;;;1,0;1,0;;1,0;;;2,0;;1,0;;;;;;;;;;;
indicator;;;;6,0;5,0;9,0;2,0;15,0;13,0;7,0;;;6,0;;3,0;17,0;;;4,0;;;29,0;13,0;1,0;1,0;;53,0;3,0;;;1,0;2,0;18,0;;24,0;15,0;;;1,0;;38,0;;;3,0;8,0;4,0;31,0;69,0;6,0;179,0;1,0;25,0;;;;5,0;;1,0;;;;;;;2,0;3,0;8,0;4,0;2,0;1,0;3,0;;22,0;;;17,0;4,0;3,0;1,0;114,0;1,0;2,0;;16,0;;13,0;3,0;;;1,0;8,0;2,0;1,0;;1,0;4,0;3,0;;40,0;6,0;;2,0;4,0;19,0;;1,0;5,0;6,0;13,0;13,0;1,0;1,0;;;;14,0;7,0;52,0;1,0;6,0;;;1,0;1,0;6,0;5,0;;;;19,0;;7,0;3,0;;27,0;;1,0;16,0;;2,0;9,0;3,0;;4,0;5,0;;;2,0;4,0;25,0;;1,0;5,0;6,0;6,0;;32,0;;1,0;;1,0;2,0;32,0;;3,0;;1,0;2,0;3,0;;36,0;;;4,0;4,0;1,0;2,0;3,0;;;1,0;3,0;;;;6,0;;1,0;;;;;;1,0;;;3,0;;1,0;;;;5,0;10,0;;;;;;14,0;;;;;;;1,0;;;;5,0;;;;;1,0;;2,0;22,0;;7,0;;;1,0;;3,0;4,0;;;;1,0;;;;;;;;;3,0;;;;1,0;;;5,0;;;;;;2,0;16,0;;;5,0;;1,0;;;;4,0;;;;3,0;;;3,0;2,0;;2,0;;;13,0;;1,0;;;11,0;;1,0;;;;;;;;;3,0;;;;;;;;57,0;;1,0;;;;2,0;;;;12,0;;;;;;;;;;1,0;;;;;;;1,0;1,0;;;;;2,0;;;;3,0;6,0;;2,0;1,0;;;;;;;24,0;;;;;;;1,0;;;;;;;;;4,0;;;;;;;;;1,0;;;2,0;;;;1,0;;1,0;2,0;;;;4,0;;;2,0;;1,0;;3,0;;;;;2,0;1,0;6,0;;2,0;;;;;;2,0;;1,0;2,0;4,0;10,0;;;;2,0;;4,0;;22,0;2,0;1,0;29,0;;;1,0;5,0;;9,0;3,0;14,0;;;5,0;13,0;1,0;4,0;;1,0;;;8,0;;2,0;5,0;;;;;;;;;;6,0;2,0;3,0;;;2,0;4,0;3,0;47,0;;;;;;11,0;;2,0;20,0;1,0;;;;;;3,0;1,0;5,0;;3,0;;2,0;;32,0;6,0;3,0;;;;1,0;;;;;;3,0;33,0;;;;2,0;;;1,0;6,0;;24,0;;1,0;;;5,0;1,0;;12,0;;2,0;;1,0;;;78,0;6,0;1,0;4,0;;;;;5,0;;;1,0;;2,0;;;;32,0;;;;1,0;;;;;;1,0;;6,0;1,0;;;;;;;;2,0;4,0;;;4,0;;;;;;;;;;;;2,0;;;;22,0;;;;;;9,0;;2,0;1,0;;;;;;;3,0;;;;;;;1,0;;1,0;;4,0;;;2,0;;2,0;;;;2,0;;;;;1,0;;;;;;;6,0;;;3,0;;;1,0;;;4,0;;;3,0;;;;;;;;;;;;;;;;4,0;;;;;;;;;;;;;;;;;;;;;;;;1,0;;;;;;1,0;;;;;;;7,0;;;;;;;;;;;;;;;;;5,0;;;;3,0;;;5,0;;;8,0;;;;;;2,0;;;;;;;;;;;;;;;;;;1,0;;;;;;;1,0;;;;;;;;;;;;;;;;;;;;1,0;9,0;;;2,0;;;;9,0;;;;;;;;;;;2,0;;;;;;;;;1,0;;;4,0;;;;;;;;;;;;;;;11,0;;;;;;;;;;;;;;;;;;8,0;;2,0;3,0;;8,0;;;10,0;15,0;6,0;2,0;;;;;2,0;4,0;;;;;1,0;1,0;;;;7,0;;;;;;;;2,0;;;;;;;;;;1,0;;;;;;;;;;;;;;;;;;;;3,0;;1,0;;;7,0;;;;;;;;2,0;;;;;;;;;25,0;;;8,0;;;;;;;;;;;;;;4,0;;;;;;;;;4,0;;;;;;;;;;;;;;;;;3,0;;3,0;;;;;;;;;;;;;;;;;;
initiate;;;;1,0;;;;6,0;1,0;4,0;;;;;1,0;;2,0;;;;1,0;55,0;;1,0;;;3,0;;;;20,0;2,0;24,0;1,0;45,0;10,0;;1,0;;;15,0;;6,0;;10,0;2,0;5,0;67,0;13,0;4,0;;1,0;;;1,0;14,0;1,0;;;4,0;;1,0;1,0;4,0;;;12,0;;4,0;;3,0;;6,0;;;;3,0;;5,0;77,0;;1,0;;13,0;;20,0;;;;;3,0;;4,0;;;3,0;;;42,0;2,0;;;5,0;5,0;;6,0;;;10,0;2,0;;;;;;1,0;3,0;;18,0;2,0;;;11,0;3,0;13,0;2,0;;;;;;14,0;;;;;2,0;15,0;;;9,0;;1,0;6,0;;;;2,0;18,0;;;;4,0;5,0;3,0;;11,0;;;31,0;;22,0;8,0;;;;29,0;1,0;;;3,0;;;;3,0;;3,0;4,0;;;;;;;;8,0;;;;;;;;13,0;;;;;;;;;;2,0;2,0;;;;5,0;;;;;;;;;;1,0;;;;;;;;;;9,0;1,0;5,0;;;;;;5,0;;1,0;;;;;2,0;;;;;;;;;;;;6,0;6,0;;;;;;;4,0;;1,0;;;2,0;;;;;;;;1,0;;;5,0;10,0;12,0;1,0;;;11,0;;8,0;;;;;;;;;;;;;2,0;;;;1,0;;;;;1,0;;;;;;;;2,0;;1,0;;;;;;;;;;;;;;;;2,0;;1,0;;;;;;;;;;2,0;;;;;;;;1,0;;4,0;;;;4,0;1,0;;;;;;;;;;;;;;;;3,0;;;;;;;;;;;;;1,0;;;;25,0;;;;;;;;5,0;;;;;;2,0;11,0;2,0;1,0;;4,0;;;1,0;;;;;3,0;;;;1,0;;;;;23,0;6,0;;1,0;;;5,0;22,0;;4,0;3,0;2,0;;13,0;;46,0;;;1,0;1,0;1,0;;;4,0;13,0;;2,0;;;2,0;1,0;;2,0;;;2,0;;4,0;;;;4,0;;41,0;;;;;;2,0;;1,0;;;;;;;;;;15,0;2,0;;;1,0;1,0;4,0;;;;1,0;11,0;2,0;;;;;;;5,0;;;;1,0;;;;1,0;2,0;2,0;;;;;2,0;;;1,0;1,0;;1,0;26,0;;;2,0;;;;3,0;;;;;1,0;;9,0;;4,0;1,0;;;;5,0;;;;;5,0;;;;2,0;;6,0;;7,0;2,0;5,0;;;10,0;;1,0;;;;;;;;3,0;3,0;15,0;;4,0;;;4,0;;;1,0;;;1,0;4,0;;;;;;1,0;4,0;;1,0;;;;;;;;;3,0;;;;2,0;;;;;;;;;8,0;;2,0;;;;;1,0;;;;1,0;;2,0;1,0;;;1,0;2,0;;;;;;1,0;;;2,0;;;;;;;;;;4,0;;;;;;;;1,0;;;;;;;;;;;;;;1,0;;;;;;;;;;;;;;;;;14,0;;;;;;;;;;;;;;;;;;;;;;;;;;;;6,0;;;2,0;;;;2,0;;;;;;;;;;;;;;;;;;;;1,0;;;;;;;5,0;;;;9,0;;;;;;;;;;;1,0;;;2,0;;2,0;;1,0;;23,0;2,0;;;;;;;;;;;6,0;;;;;;;;4,0;;;;1,0;;;;;;;;;;;1,0;;;1,0;;;;;;1,0;;;;;;;;;;;12,0;;6,0;;;;;;;;4,0;;;;;;1,0;;;;;;5,0;;;;;;;;;;;;;;1,0;1,0;;1,0;;;;;;;;3,0;;;;;;;;3,0;;;1,0;;;;;;;;;;;;10,0;;;;;3,0;;;;;;4,0;;2,0;;;;;;;;;;;;;;;;;;;;;;;;1,0;;;;;;;;;;;;;;;;;;;;;;;;;;;;;;;;;5,0;;;;;;;;;;;;;;;
intensity;;;;4,0;1,0;2,0;3,0;32,0;33,0;14,0;122,0;;11,0;;2,0;115,0;23,0;;11,0;2,0;5,0;39,0;5,0;1,0;13,0;4,0;74,0;3,0;;8,0;;5,0;21,0;11,0;49,0;5,0;;2,0;1,0;;94,0;3,0;3,0;23,0;49,0;2,0;112,0;46,0;12,0;26,0;;24,0;2,0;5,0;9,0;31,0;15,0;3,0;19,0;;;;16,0;;24,0;6,0;;40,0;27,0;;17,0;4,0;38,0;;;1,0;3,0;23,0;42,0;250,0;2,0;13,0;2,0;27,0;12,0;4,0;1,0;;;1,0;6,0;2,0;;;18,0;;1,0;;108,0;6,0;4,0;;4,0;92,0;;10,0;10,0;5,0;33,0;4,0;2,0;3,0;;;;132,0;22,0;9,0;11,0;31,0;;;6,0;18,0;15,0;;;;18,0;19,0;2,0;19,0;8,0;5,0;16,0;13,0;5,0;11,0;12,0;1,0;8,0;;;47,0;29,0;;;;76,0;7,0;2,0;;;33,0;16,0;;35,0;;;3,0;;1,0;28,0;5,0;14,0;2,0;2,0;21,0;7,0;41,0;;;;7,0;3,0;7,0;2,0;;;1,0;;;;;3,0;6,0;;8,0;;;;2,0;;;1,0;;;;;;;;42,0;3,0;;;3,0;14,0;19,0;;;1,0;;2,0;;5,0;;;;2,0;1,0;29,0;;;;;3,0;;521,0;;;;;;;;;3,0;;;;;3,0;3,0;11,0;;;;154,0;;;9,0;;;;7,0;39,0;10,0;;1,0;;;;18,0;4,0;;4,0;;5,0;;;55,0;2,0;;2,0;;;6,0;;16,0;25,0;;;;;13,0;3,0;3,0;;;3,0;12,0;2,0;;;;22,0;;;;1,0;;;;;;;;1,0;;;;;;2,0;8,0;;;;;;;;;;;;;;;;;;;;11,0;;;;;;;;2,0;1,0;;;;4,0;12,0;2,0;;;1,0;;;;15,0;;4,0;14,0;4,0;;;;;;;;4,0;1,0;;;14,0;;;;;;;;;2,0;;;2,0;;;;;6,0;3,0;;;;;;;3,0;;;;;5,0;;;;;14,0;39,0;9,0;;10,0;;1,0;3,0;2,0;;;;;2,0;4,0;4,0;1,0;;12,0;17,0;7,0;6,0;;4,0;50,0;1,0;11,0;1,0;6,0;21,0;11,0;4,0;;2,0;2,0;;;5,0;4,0;;3,0;2,0;2,0;;;;2,0;19,0;;1,0;;2,0;16,0;9,0;5,0;3,0;;;;;83,0;;;;1,0;2,0;3,0;;2,0;2,0;5,0;;41,0;2,0;1,0;1,0;10,0;;;5,0;1,0;2,0;;;;5,0;;;;11,0;;;;;;9,0;4,0;;;;8,0;1,0;4,0;;;;;3,0;;;;;1,0;;;14,0;;;;;;;;8,0;;;3,0;;3,0;1,0;;1,0;;;;46,0;;6,0;25,0;;;4,0;;;15,0;7,0;;1,0;;;;;;2,0;27,0;12,0;;;;;;10,0;6,0;;;;;5,0;;;;;1,0;;;;24,0;;;;;;;;;;;;;;;;3,0;;2,0;;49,0;8,0;;;;;;;;;;;;;;;;;;;2,0;;127,0;;;2,0;1,0;;;1,0;1,0;;1,0;;;;2,0;;;;;20,0;;;;;18,0;;;;;;;2,0;;;;;7,0;;2,0;;;;;;;;26,0;1,0;;;;;;;;;;;;;;2,0;;;;;;;;;;;;;;;2,0;;;;;4,0;;;1,0;;;18,0;;;;;;;;;;;;;;1,0;;8,0;3,0;;;;46,0;;;2,0;;;;;;2,0;;;;;;;;7,0;;;;2,0;;;;;;;;;;1,0;;5,0;;;;;4,0;9,0;;;;7,0;;89,0;3,0;4,0;;1,0;8,0;5,0;;;19,0;3,0;1,0;;;2,0;;;;;;;19,0;;6,0;2,0;;;;;4,0;;;;;;;;10,0;;;;;;;2,0;3,0;;;;;;;;1,0;10,0;;;;;;;;;1,0;;;;5,0;;;;2,0;;;;2,0;;;2,0;1,0;;1,0;;;;1,0;;;;1,0;;;26,0;;;;;;;;;;;2,0;;1,0;;;7,0;;;;2,0;;;14,0;;;;13,0;2,0;1,0;;;3,0;;;;;;;;;;;5,0;;;7,0;;1,0;;;;17,0;;;;5,0;;;25,0;;;;;;30,0;;;;;5,0;;;;;;18,0;;;;;1,0;;;;;;;;2,0;5,0;;9,0;5,0;;;;;;;;;;2,0;;;;;;;;;;;;;;;;;;;1,0;;;2,0;;;
mechanical;;;;1,0;;2,0;4,0;3,0;1,0;7,0;1,0;;1,0;;9,0;2,0;1,0;;;;;1,0;1,0;2,0;;;;;;;;;5,0;;34,0;2,0;;;2,0;;;;4,0;;1,0;;1,0;27,0;;;3,0;5,0;;;6,0;;1,0;;;;3,0;2,0;2,0;;2,0;;5,0;15,0;;1,0;;;;1,0;;7,0;;;;9,0;;3,0;;15,0;;;1,0;;4,0;;16,0;;;1,0;;;;;10,0;4,0;;;35,0;;;;6,0;1,0;;;1,0;1,0;;;;1,0;22,0;7,0;3,0;;1,0;;1,0;;4,0;5,0;1,0;;;;;1,0;4,0;3,0;;;;4,0;;;;;;10,0;;;;2,0;4,0;;;1,0;;;;;18,0;;1,0;;;1,0;26,0;;;;;;;;5,0;;;;;4,0;10,0;2,0;;;;3,0;;;;3,0;;3,0;;;;;;4,0;;;;;;2,0;;3,0;;7,0;;3,0;2,0;11,0;1,0;2,0;;1,0;9,0;;;;2,0;;;;1,0;;1,0;;;;1,0;;1,0;;1,0;;3,0;5,0;4,0;7,0;20,0;2,0;4,0;2,0;1,0;4,0;;;;;;;;2,0;12,0;;;1,0;;;2,0;;;;;;5,0;1,0;;;2,0;;46,0;;1,0;4,0;;;;;;;4,0;3,0;1,0;;;;1,0;5,0;;;;;;;;;1,0;;;;;;38,0;6,0;3,0;;1,0;1,0;;2,0;;;;4,0;;;6,0;;;;;3,0;2,0;;1,0;;;;2,0;2,0;;;;14,0;1,0;;;;;29,0;;1,0;1,0;;1,0;1,0;4,0;7,0;;;2,0;;;1,0;;;;1,0;17,0;4,0;;;;;;1,0;1,0;;;1,0;1,0;;1,0;;;;;1,0;3,0;;1,0;2,0;;;;1,0;1,0;;;;;14,0;;;;;;1,0;1,0;;;;;;;;;;;2,0;;2,0;1,0;;;;;;;;;;;1,0;2,0;;;;;;;;;2,0;;3,0;2,0;;;3,0;;;3,0;1,0;2,0;;;1,0;4,0;;1,0;;;;;;;;;;;;;1,0;;1,0;;;;;;5,0;;;2,0;;9,0;1,0;;;;;3,0;5,0;;;;;;;;;1,0;;;1,0;;;;;2,0;;5,0;;;;;;;;;;1,0;;;;;;;;;;;1,0;4,0;;;;;1,0;;;;;1,0;1,0;;2,0;1,0;;;1,0;;2,0;;1,0;;;;;2,0;;;;;2,0;;1,0;;;;;;;;;;1,0;;28,0;;;2,0;;;;;3,0;;;;;;;;;;;;;2,0;;;;;1,0;;;;;;;;;;;;2,0;;;;;;;;;;;;;;;;;;;;;3,0;;;;1,0;;;;;;;;;1,0;;;4,0;;;;;;1,0;1,0;;;;;;11,0;;;;;18,0;;;3,0;;1,0;;1,0;;;1,0;;;;;2,0;;;;3,0;;;;;;;;;;1,0;;2,0;;;;;;;;;;;2,0;;;1,0;;;;;;;;;;;;;16,0;;;;;;;;1,0;;3,0;;;;;;;;2,0;;;1,0;;;1,0;;;;;;;;;;;;4,0;58,0;;;3,0;;;;;;;;;;;;;;;;;;1,0;1,0;;;;;;;;;;;;6,0;;;;;;;;;2,0;;;;;;;;;;;;;;;;;;;;;;2,0;;;;;;;;;;;;;;;;;;;;1,0;1,0;;;;;2,0;;;1,0;;;;;2,0;;;;;;;;2,0;;;;;;;;;;;30,0;;1,0;;;;;;;;1,0;1,0;;2,0;;;;;;;;;;;;;;;;;;1,0;8,0;;;;;;;4,0;1,0;1,0;;;4,0;2,0;2,0;;;;;;;;;;;;;;;;;;4,0;;;;;;;;2,0;;;;2,0;;;2,0;;;;;1,0;;;;;;;;;;;;;;;;;2,0;;;;;7,0;;;;;;2,0;;;;;;;;;;;;;;
message;;;;2,0;11,0;;2,0;10,0;1,0;;;;12,0;2,0;;33,0;;;;;;23,0;;91,0;1,0;;1,0;3,0;;;12,0;1,0;24,0;;58,0;7,0;;;2,0;;7,0;;;12,0;16,0;1,0;14,0;64,0;33,0;63,0;;2,0;;;;2,0;;45,0;;3,0;;6,0;;2,0;;;;8,0;22,0;2,0;2,0;;47,0;;;4,0;16,0;;;91,0;;5,0;1,0;73,0;;8,0;5,0;;;1,0;4,0;;4,0;;4,0;7,0;6,0;;40,0;7,0;;;27,0;8,0;;;3,0;1,0;21,0;26,0;;2,0;;2,0;;8,0;2,0;8,0;7,0;8,0;;;7,0;11,0;6,0;4,0;;1,0;;;2,0;20,0;;;3,0;;8,0;118,0;;;27,0;;26,0;2,0;2,0;;;;7,0;1,0;;;8,0;4,0;2,0;;38,0;;10,0;;;83,0;10,0;;;;18,0;;;;2,0;;;;;;;;;;;3,0;;;;;;5,0;;;;;;5,0;;2,0;3,0;;;;;;2,0;1,0;;;;;;3,0;;;;;;3,0;;;;;;;;;;;;;;;2,0;;;;;1,0;;;;;;3,0;;;;;;;;;;;;;;;89,0;;;;;;;14,0;;;;;;;;1,0;;;;;;;;;;;;;;15,0;;;;;8,0;2,0;;;;;;;;;;;;;;;;;;;;1,0;;;;;;;;;;;;;3,0;;;;;;;;;;;;;3,0;;;;;;;2,0;8,0;;;;;;;;;;;;;;;;;;;;;;;;;;;;1,0;;;;;;4,0;;;2,0;;;;;;;;;10,0;;;;7,0;;;;;;;10,0;2,0;;;;;;2,0;16,0;;;;2,0;;;;;;;;13,0;;;3,0;;;;;;6,0;;;2,0;;6,0;2,0;10,0;;22,0;;;;8,0;;3,0;;;2,0;;;;;;1,0;8,0;;;;1,0;;6,0;1,0;;;;;4,0;3,0;;;;39,0;101,0;2,0;;;;;1,0;;3,0;1,0;;;1,0;;6,0;;;1,0;6,0;3,0;;1,0;;1,0;11,0;2,0;1,0;1,0;4,0;6,0;1,0;;;;;;;10,0;;2,0;10,0;;;4,0;;;2,0;1,0;;;;;8,0;;1,0;;2,0;;;;;;46,0;;4,0;;;;;;;;;108,0;;5,0;4,0;;;;2,0;;;;;;;11,0;2,0;;;11,0;5,0;15,0;1,0;;2,0;;;;;;;;;;3,0;;2,0;;;;;;28,0;;19,0;26,0;;;;;1,0;;;;2,0;;1,0;;;;;;2,0;9,0;2,0;;;;4,0;;;5,0;4,0;;;;;3,0;2,0;;;2,0;;;;;2,0;;16,0;10,0;;;;4,0;;7,0;;;25,0;;;;;3,0;;8,0;;;;;;;;;;;;3,0;;;;;;;2,0;;;;;;;;;;;2,0;;;;;;;;;;1,0;;;28,0;;;;1,0;;;;2,0;4,0;;;;;;;;;6,0;;;;;;;;;;;;;;;;;;;11,0;;;1,0;12,0;;;;;4,0;;;;;;1,0;;;7,0;;;;;;;;;;;;;;;3,0;;;;;7,0;;;2,0;3,0;;;;;4,0;;3,0;;;;;;;;;2,0;;;;;;;;;;;;;;;;;;;;;2,0;;;;;;;;;;;;;;;;;;;;;;;;;2,0;;;;;;;;;2,0;12,0;1,0;;;;;;4,0;;6,0;3,0;;1,0;;;1,0;;;;;;;2,0;;;;;;;;;4,0;;;;;;;3,0;1,0;;;;;;;;;;;;1,0;;;;;;;;;;;;;;;;;;;;;;;;27,0;;;;;;;;;;;;;;;;;;;;;;;;;;;;;;;;;;;;;;;;;;;;;;;4,0;;;;;;;;;;;;;;;;;;1,0;;;10,0;;;;;;;;;;;
motor;;;;9,0;;53,0;7,0;36,0;11,0;30,0;7,0;;7,0;;97,0;41,0;12,0;;;;2,0;7,0;;1,0;1,0;;;1,0;;;1,0;;47,0;1,0;156,0;68,0;;4,0;2,0;;3,0;;11,0;4,0;81,0;13,0;11,0;108,0;6,0;10,0;4,0;29,0;;1,0;353,0;2,0;25,0;2,0;2,0;1,0;3,0;8,0;4,0;;;;83,0;10,0;32,0;23,0;3,0;;28,0;;;6,0;4,0;3,0;;50,0;;2,0;4,0;155,0;;12,0;5,0;;;4,0;82,0;;;;2,0;2,0;2,0;;59,0;13,0;;;56,0;5,0;;;9,0;13,0;23,0;;;3,0;;;;15,0;39,0;187,0;43,0;17,0;1,0;11,0;1,0;10,0;7,0;;;;;2,0;;;4,0;4,0;3,0;;2,0;8,0;;;1,0;;3,0;46,0;11,0;;16,0;12,0;45,0;;;;3,0;5,0;4,0;15,0;54,0;;70,0;1,0;;20,0;103,0;;1,0;;1,0;4,0;;2,0;36,0;;1,0;7,0;;12,0;90,0;35,0;;;8,0;47,0;;5,0;2,0;35,0;;10,0;;;4,0;;;69,0;;2,0;;;3,0;34,0;1,0;2,0;2,0;59,0;1,0;15,0;90,0;3,0;3,0;6,0;5,0;;10,0;;;;10,0;;1,0;16,0;39,0;;3,0;;;;;;11,0;1,0;64,0;;11,0;40,0;28,0;74,0;25,0;11,0;5,0;19,0;;;;2,0;3,0;;;;;11,0;24,0;;4,0;6,0;;7,0;32,0;4,0;;;4,0;;13,0;;;;2,0;;53,0;;16,0;6,0;5,0;2,0;7,0;10,0;;23,0;2,0;18,0;3,0;;3,0;7,0;4,0;27,0;;;11,0;;224,0;2,0;1,0;;2,0;2,0;4,0;;1,0;3,0;43,0;8,0;33,0;;4,0;4,0;2,0;2,0;6,0;;;5,0;;;9,0;2,0;;;;62,0;1,0;;3,0;2,0;134,0;1,0;15,0;;;13,0;4,0;6,0;;;;11,0;;9,0;14,0;;4,0;;4,0;11,0;1,0;44,0;2,0;;7,0;15,0;;1,0;;;43,0;15,0;22,0;7,0;2,0;2,0;3,0;8,0;2,0;2,0;2,0;;;22,0;11,0;;;;;;;4,0;6,0;14,0;135,0;18,0;48,0;;1,0;81,0;4,0;2,0;2,0;;1,0;98,0;;;2,0;1,0;1,0;10,0;18,0;1,0;2,0;6,0;1,0;;1,0;9,0;;;;7,0;6,0;2,0;10,0;;4,0;;;3,0;1,0;;3,0;;;9,0;17,0;;;;1,0;1,0;;;;10,0;24,0;66,0;4,0;;1,0;5,0;1,0;3,0;1,0;16,0;35,0;;1,0;15,0;13,0;;6,0;4,0;;;;1,0;;5,0;4,0;;43,0;;10,0;;;41,0;3,0;;;4,0;7,0;6,0;;2,0;;;3,0;4,0;;3,0;;6,0;33,0;3,0;;1,0;1,0;2,0;;3,0;5,0;;;5,0;;4,0;5,0;;2,0;6,0;;;63,0;;;4,0;3,0;;2,0;;;;2,0;1,0;1,0;;;;;;;4,0;;9,0;;3,0;;;7,0;3,0;;;;1,0;;2,0;;;;;2,0;;;12,0;;1,0;;18,0;;1,0;2,0;;;;;;;6,0;3,0;;2,0;;;4,0;;1,0;4,0;6,0;;6,0;1,0;;6,0;;4,0;1,0;3,0;1,0;1,0;3,0;;;;7,0;;;;;;;1,0;;;;1,0;3,0;10,0;;;;22,0;1,0;10,0;;;;1,0;;;1,0;;;1,0;;;;;;1,0;;;;;;;;2,0;1,0;14,0;;;1,0;;14,0;;7,0;;;1,0;1,0;;;1,0;;;;;;3,0;2,0;1,0;172,0;73,0;1,0;1,0;;6,0;2,0;1,0;;;27,0;;;;6,0;2,0;7,0;;2,0;;33,0;24,0;6,0;;;2,0;;;9,0;11,0;;;2,0;28,0;7,0;;2,0;;;;;11,0;;12,0;;;2,0;;;8,0;;2,0;;;;7,0;11,0;18,0;1,0;47,0;;1,0;;;9,0;;;;1,0;11,0;;;;1,0;3,0;;188,0;;1,0;;;;;;;;17,0;2,0;2,0;;;;;3,0;1,0;;;;;;;1,0;;;3,0;;11,0;;;2,0;;;15,0;7,0;;2,0;1,0;;1,0;;;;;2,0;;;;;;;;;1,0;;;2,0;2,0;;;;5,0;;;;4,0;;;;2,0;2,0;3,0;;13,0;;1,0;;;;;;;;12,0;;;;2,0;;15,0;;;;;6,0;2,0;2,0;;;;;;;;;;;2,0;;48,0;3,0;;;;6,0;;;11,0;3,0;;;2,0;;;;1,0;11,0;;2,0;1,0;2,0;;5,0;;1,0;;;1,0;;;;9,0;;;1,0;4,0;4,0;49,0;;41,0;;;2,0;;;2,0;;;;1,0;;;2,0;;;;;1,0;3,0;;;;;;1,0;2,0;2,0;2,0;4,0;1,0;1,0;20,0;1,0;;;;12,0;;2,0;;;1,0;;;5,0;1,0;;;2,0;;;;3,0;;;;;8,0;;;;;1,0;;1,0;;;;;;;5,0;;;;3,0;;;;;;;;1,0;;;2,0;;;;;1,0;3,0;;;;4,0;;;;3,0;;;;;;;;;;;;;;;4,0;2,0;;;;;
occur;;;;8,0;;1,0;2,0;9,0;12,0;3,0;;;5,0;;5,0;13,0;;14,0;;;;21,0;8,0;;;1,0;1,0;;;2,0;1,0;8,0;7,0;;14,0;2,0;;1,0;;;10,0;2,0;1,0;;11,0;4,0;62,0;20,0;7,0;9,0;;4,0;;;16,0;3,0;7,0;9,0;;;;1,0;1,0;3,0;2,0;;4,0;6,0;32,0;;1,0;;6,0;3,0;;2,0;8,0;1,0;;83,0;;2,0;;13,0;1,0;11,0;;;;1,0;4,0;;1,0;;;;1,0;;34,0;2,0;;1,0;3,0;31,0;;;17,0;3,0;2,0;4,0;3,0;;;;;21,0;6,0;15,0;;16,0;2,0;;3,0;8,0;4,0;;;;;1,0;;12,0;;1,0;3,0;1,0;4,0;10,0;2,0;;4,0;;;7,0;2,0;;;;24,0;;4,0;;2,0;6,0;;;17,0;;2,0;3,0;1,0;1,0;23,0;;;;9,0;5,0;;;1,0;;1,0;;9,0;;2,0;;;;;4,0;;;3,0;3,0;;7,0;;;1,0;4,0;;1,0;;1,0;;;;1,0;;;5,0;7,0;3,0;;;3,0;36,0;6,0;2,0;;1,0;;;;;;;;1,0;;;;12,0;;;1,0;14,0;;;;;;;4,0;9,0;1,0;;;4,0;;;;;;3,0;2,0;20,0;;;;;;;7,0;5,0;;;;1,0;;;16,0;;7,0;2,0;4,0;3,0;;;1,0;;;;;2,0;;;25,0;4,0;7,0;;;;95,0;;2,0;;;2,0;4,0;47,0;;;;;;4,0;;;3,0;;;;;;;;2,0;;;;;;3,0;;;;1,0;;;;;1,0;;;;;;;;;;;7,0;;;;;;;;;;;;;;1,0;;;;;;;;11,0;;;;;1,0;;;;2,0;2,0;;1,0;1,0;2,0;;;;;8,0;;3,0;;;;;;;;;;;;;9,0;;;9,0;;;;;;;;4,0;2,0;1,0;;;;;;60,0;;1,0;;5,0;1,0;;;;;;;;5,0;5,0;;1,0;;;;;7,0;14,0;;9,0;2,0;9,0;2,0;32,0;;;30,0;5,0;;1,0;2,0;8,0;1,0;1,0;67,0;;;;;3,0;3,0;;;;;4,0;;;;;;3,0;;1,0;5,0;;;6,0;;15,0;;2,0;;;;6,0;4,0;2,0;;;5,0;;;1,0;1,0;3,0;3,0;71,0;3,0;;;1,0;;1,0;;2,0;;;1,0;2,0;;;;1,0;;;;;;3,0;;;;;;2,0;;;;;;;;;;1,0;;1,0;2,0;;;17,0;;;6,0;;2,0;;;6,0;;;3,0;;1,0;;;;2,0;6,0;3,0;;;;2,0;;;;;;1,0;;14,0;2,0;2,0;;;;;;;;2,0;;;1,0;;;;3,0;;12,0;;;;1,0;6,0;3,0;;;;;;;;2,0;;2,0;;;1,0;;;;;;;;;;;;;;1,0;;1,0;1,0;;;;9,0;;;;2,0;2,0;;;;;1,0;11,0;;;2,0;;;;;;;;1,0;;;4,0;1,0;;2,0;;;;;;2,0;;;2,0;4,0;;;;;;;;;;;;;;;;;1,0;1,0;;;;;;;;;;;;4,0;;;;;;;;;;;2,0;;2,0;;;;;;;;;;;;;;;;12,0;;;;;;;2,0;;;;1,0;;;;;;1,0;;;;;;;;;;;;;;;1,0;;;5,0;;;;;2,0;;;;;;;;1,0;;;;1,0;;;;3,0;;;;;;4,0;;;1,0;1,0;;1,0;;;;;;;;;;;3,0;;;;;;4,0;;;;;;;;2,0;;;;;;;;2,0;;3,0;;;;;;1,0;;;;;;;;;1,0;;;16,0;3,0;1,0;;;;;;;;;1,0;;;3,0;;2,0;;;;;1,0;;;;3,0;;;;1,0;;;;;;;;;;;;;;;;;;3,0;1,0;;;;;;;;;;1,0;;;;;;;;;;;;;;;;;;;;;1,0;4,0;;;;1,0;;;;;3,0;;;;;;;;;;;;2,0;;;;;;;;;;;;;;;3,0;;;;;4,0;;;2,0;1,0;;;;;;;;2,0;;;2,0;;;;;;;;2,0;;;;;;;;;;;
operative;;;;1,0;;;;2,0;;1,0;;;1,0;4,0;2,0;1,0;;;;;;6,0;;;;;3,0;;;;2,0;3,0;5,0;;9,0;;;;;;5,0;;1,0;2,0;6,0;;1,0;16,0;1,0;14,0;4,0;;;;5,0;;4,0;;1,0;2,0;3,0;;2,0;;1,0;;;5,0;;;3,0;1,0;2,0;;;;;;;49,0;;;;5,0;;4,0;;;;;11,0;;2,0;;;;4,0;;5,0;;2,0;;7,0;;;;7,0;;;;;4,0;;;;3,0;4,0;44,0;;1,0;1,0;;1,0;12,0;5,0;;;;;;;;1,0;;;;1,0;1,0;;;1,0;;;5,0;1,0;;;;2,0;;;;1,0;3,0;1,0;;14,0;;;1,0;;2,0;18,0;;;;4,0;5,0;;;3,0;;;3,0;;;3,0;;;;;;;;;6,0;;1,0;;2,0;;;;1,0;;5,0;;;;2,0;;;;2,0;;;;;;;;;;;;;;1,0;;;2,0;;;;;4,0;5,0;;6,0;;;;;9,0;;6,0;1,0;;;;;;;4,0;;;;;4,0;;;;2,0;;;;3,0;;;;;;4,0;6,0;;;;;3,0;;;;;;;;;;;;1,0;1,0;;;;;;;;3,0;;;;;;;;;;;4,0;;2,0;;;;;1,0;1,0;;;;;;;;;;;1,0;;;;1,0;;;2,0;;;;;;;;14,0;;;;1,0;5,0;;;;;;;;;;;;;;;;;2,0;;4,0;;;;;;;2,0;;;;;;;;;;;;;;;;;5,0;;;;4,0;;;8,0;1,0;;;1,0;;;;;;;;;;;;;;;;;;;;;;;;;;;;;;;;;;2,0;;;;;;;;;;;;;;1,0;2,0;;;1,0;1,0;;8,0;;;;;;;2,0;;;;;2,0;;;;;;;;1,0;;;;;;1,0;;;;;;7,0;2,0;;;;;;;1,0;;;;1,0;2,0;;;;;1,0;;5,0;;1,0;;;;;;;;;5,0;;;;;;;;;;;;;;;;;;8,0;;;2,0;9,0;;;;;;;;5,0;;;;3,0;;;;;;;;;;;;;;;;;;;;;;10,0;;;;;;;;;;;1,0;;;;;;;;;;;;2,0;;;;5,0;;;;;;;1,0;;1,0;;1,0;;;;;;;;;;;;;;;;;;;;;2,0;;;;;;;;1,0;;;;2,0;;;1,0;;;;2,0;;;;;;;;2,0;2,0;;;;;;2,0;;;;;;;;;;;;;;;;;;;;;;7,0;;7,0;2,0;;;4,0;;;;;;;2,0;;;;;;;;;;;;;;;;;;;;;;;;;;;;;;;;;;;;4,0;;1,0;;;;;;;;1,0;;;;;;;;2,0;;;;;;;;;;;;;;;;;;;;;;;;;;;;;;;;1,0;;;;;2,0;;;;;;;;;;;;;;;;;;;;;;;;;;;;;;;1,0;;;;;;;;;8,0;;;;;;;;;;;;;;;;;1,0;;;;;;1,0;;;4,0;;;;;;;;4,0;;;;;1,0;;;;;;;;;;;;;;;;;;;;;;;;;;2,0;;;;;;;;1,0;;;;1,0;;;;;;;;;;;;;;;;;;;;;;;;1,0;;;;;;;;;;;;;;;;;;;;;;;;;;;;;;;;;;;;;;;;;;;;;;;;;;;;;;;;;;;;;;;;;;;;;;;;
partial;;;;2,0;;;1,0;3,0;83,0;;2,0;;;;3,0;62,0;;;5,0;;6,0;15,0;6,0;;;2,0;5,0;7,0;;;2,0;;5,0;;14,0;;1,0;;4,0;3,0;14,0;3,0;6,0;2,0;27,0;2,0;55,0;5,0;4,0;32,0;;4,0;1,0;;5,0;9,0;5,0;1,0;;;1,0;2,0;9,0;;2,0;18,0;4,0;10,0;7,0;;2,0;;4,0;;;4,0;4,0;1,0;2,0;471,0;9,0;5,0;;21,0;6,0;1,0;;;;19,0;43,0;;;3,0;;;;;31,0;;1,0;;;50,0;;;11,0;;2,0;11,0;4,0;12,0;;6,0;;44,0;12,0;9,0;1,0;15,0;3,0;;10,0;10,0;1,0;;;;8,0;;;8,0;13,0;;3,0;5,0;8,0;14,0;;;2,0;;;22,0;5,0;;;6,0;4,0;59,0;6,0;;1,0;10,0;2,0;;14,0;;1,0;2,0;3,0;;36,0;;;;;4,0;6,0;;;;1,0;1,0;23,0;1,0;1,0;1,0;;;;13,0;;;;2,0;;7,0;2,0;;;;14,0;;6,0;;;5,0;;3,0;6,0;2,0;14,0;11,0;13,0;;;;6,0;13,0;;;1,0;;;;;;;;;;;;2,0;1,0;;;7,0;1,0;2,0;;3,0;1,0;11,0;;;;;3,0;18,0;;1,0;;5,0;;;;34,0;3,0;;;;;;;2,0;;;3,0;;;;;;;17,0;;10,0;;;;2,0;;;;;;;79,0;;;1,0;;;5,0;;;;;1,0;3,0;;;;;;;;;;;;;;;;1,0;1,0;;1,0;1,0;;;;7,0;;;46,0;;2,0;;;6,0;;;;;1,0;;;;;;;4,0;;;;1,0;;;;1,0;;;;;1,0;2,0;;;;;;;3,0;1,0;;;;;;;;;;;;;;10,0;;;;;;;;;;;;;;;;;;;;4,0;;;;;;2,0;;;;;;12,0;;;;;4,0;13,0;9,0;8,0;6,0;5,0;;;;7,0;;;;;7,0;7,0;;;5,0;22,0;;;;4,0;1,0;;1,0;;3,0;2,0;5,0;;1,0;;9,0;;1,0;;;;;4,0;;;;;;11,0;;;;6,0;;;;;;;;5,0;3,0;1,0;;;;;4,0;;1,0;;;;12,0;;;25,0;3,0;;1,0;;;;;;;;;;;;;;;;;;16,0;;;;2,0;;;;1,0;;;;1,0;;;;2,0;;;;;;;;;;;;;;;;5,0;2,0;;;;2,0;;;;7,0;18,0;;;6,0;;;1,0;;;2,0;;;;;;1,0;;4,0;;;;;;;;;;;;;;;;;1,0;;;;;;;;;;;;1,0;;;;;1,0;;;1,0;;;;;;;;;;;;;;;;;;;;1,0;;;4,0;;;114,0;;;;;;1,0;;;;;;;;1,0;;;;;;;;;;;;;;;;;2,0;;;;3,0;;2,0;;;;3,0;;;;;;;;4,0;;;;;;2,0;;;;;;;;;;21,0;;;;;;;;;;;;;;;;;;;;;;;;5,0;;;;;;;;;2,0;;;;;1,0;;;;;;;;8,0;;1,0;;;;11,0;;;;1,0;;;;;;;;;;;;;;;;;;;;;;;;;6,0;50,0;;;;;;3,0;;;;;;;;;;;7,0;2,0;;;1,0;;;;;;2,0;;;2,0;;;;;2,0;1,0;;5,0;;;3,0;;;;;;;;;;;;;;2,0;;;;;;;;;;;;;;;2,0;;;3,0;;;;;;;;;;;;4,0;;;;;;;;;;;;;;;;;;;;;;;;;;2,0;;;;;;;;;;;;;;;;;;;;;;;;;;;;;;;;;;;;;;;2,0;1,0;5,0;;;7,0;;;2,0;;;;;;;;;2,0;;;;2,0;;;;;;;5,0;4,0;3,0;;;;;1,0;;3,0;;;;7,0;5,0;6,0;;;;;;1,0;;;;;;;;;;;20,0;;;;;;;;;;;;;;;;
partition;;;;1,0;;;;7,0;7,0;9,0;5,0;;;;;3,0;;;;;;1,0;;;;1,0;5,0;;;;;;;;;;;2,0;;;1,0;;64,0;1,0;;;11,0;16,0;;1,0;5,0;;;1,0;2,0;;3,0;;1,0;;21,0;;6,0;7,0;9,0;;;8,0;2,0;;1,0;;1,0;;1,0;3,0;;;;26,0;;8,0;;5,0;;;;;;;71,0;;;;;2,0;;;3,0;;1,0;;;1,0;;;4,0;;;2,0;;;1,0;;;17,0;7,0;2,0;;1,0;2,0;;;1,0;;;;;1,0;;;3,0;;;1,0;4,0;2,0;;;;1,0;;;6,0;;;;2,0;9,0;;;;3,0;1,0;;;1,0;;;;;3,0;5,0;;;;4,0;12,0;;;1,0;;1,0;4,0;;;;;;1,0;;;4,0;1,0;;;;6,0;;;;;;;;1,0;1,0;;;2,0;;;4,0;6,0;;;;;17,0;;;;1,0;;;3,0;;;;;3,0;;41,0;;;;;;3,0;;202,0;;;3,0;;;;;;11,0;;1,0;;;;3,0;;;20,0;;49,0;;;;;;;;;1,0;;;;1,0;9,0;;3,0;;;;;;3,0;;;;;1,0;9,0;63,0;;;;;;14,0;;1,0;;1,0;1,0;;;;20,0;;12,0;;1,0;;;;;;;;;;36,0;;;1,0;;;;;2,0;;2,0;;;;;;3,0;;;;;;;;;;;;1,0;;;;;;;;;;;1,0;10,0;;;;;;;;;;;;;;;;;;;;3,0;;;;;;;2,0;;;;;;;;;1,0;;46,0;;;;5,0;1,0;;;;1,0;;;;;;;;1,0;;;;;9,0;;;;;;;;;4,0;;;;;;;1,0;1,0;;;;;;2,0;;;;;;;;;;1,0;1,0;;;1,0;;;1,0;1,0;;;;;;1,0;;;;;2,0;;;;;;;;;;;;;;;;;;;;;;;;;;;;;2,0;;;;;;;1,0;;2,0;;;;;;4,0;;;2,0;;;3,0;;;;;;;;;;;;;;;;;;;;;;;;;;;;;;;;;;;;;;;;;;1,0;;;;;;;;;;5,0;;4,0;1,0;;;;;;;;;;;;;;;;;;;;;;;;;;;;7,0;;;;;;;;;;;;5,0;;;;;;;1,0;;;;;;;;;;;;;;5,0;2,0;;;;;;3,0;;;;;;;;;;;;;;;1,0;;;;;;;;;;;1,0;;;;;;;;;;;;;;;;;;1,0;;;;;1,0;;;;;1,0;;;;;;;;;;;;;;;2,0;;;;;;;;;;;;;;;;;;;;31,0;;6,0;;;;;;;;;;;;;;;1,0;3,0;;;;;1,0;;;2,0;;;;;;;;;;;;;;;;11,0;;;4,0;;;;44,0;;;;;;;;;;;;;;1,0;;;;1,0;;;;;;;;;;;12,0;;;;;;;;;;;;;;;;;;;;;;;;;;;;;;;;;;;;;;;;;;;;1,0;;;;;;;;;;;;;;;;;;;;;;;;;;;;1,0;;;;;;;2,0;;;;;;;;;;;;;;;;;;;;;;;;;;;;;;;;;;;;;1,0;;;;;;;;;2,0;;;;;;;;;;;;;;;;;;;;;;;1,0;;;;;;;;;;;;;;;;1,0;;;;;;;;;;;;;;;;;;;;;9,0;;;;;;;;;;;;;;
photosensitive;;;;1,0;;2,0;;;14,0;1,0;41,0;;;;2,0;1,0;;;;;;9,0;;;;;12,0;;;;;;3,0;;;;;;;;2,0;;2,0;;;;3,0;5,0;1,0;;3,0;2,0;;;;;19,0;;;;;;;;4,0;;2,0;16,0;;;;;1,0;;;;;;;50,0;;3,0;;9,0;1,0;;;;;;10,0;;;2,0;;;;;1,0;;;;1,0;7,0;;;12,0;;1,0;;;23,0;;1,0;;2,0;5,0;9,0;;;;;13,0;;1,0;;;;;;;;;;;;2,0;3,0;;;;;;11,0;;;;;3,0;2,0;;;;;;;13,0;;;;;1,0;1,0;;;;;2,0;;;;;2,0;;;1,0;1,0;;;;;;;;;;;2,0;;;;;;;;;;;;2,0;;;;;;;;;17,0;1,0;22,0;;;;;1,0;;;;;;;;;;;5,0;;17,0;;;;;;;;;;;;;;;;;;;;6,0;2,0;;;;;;;5,0;3,0;;;;24,0;;;;;;;;1,0;;3,0;;3,0;;;;;2,0;14,0;;;;;;;;;;;;;;;;;;;1,0;;;;;;;;;;;;;;5,0;;;;;;;;;;;;;2,0;;;;;;;;;;;;;;2,0;;;;;;;;1,0;;2,0;;2,0;;;;;;;;;;2,0;1,0;1,0;;;;;;;;;;;;;;;;;;;;;;;;;;1,0;5,0;13,0;;;;;;;;;;;;;;;;;;1,0;;;;;;2,0;;;;;;;;;;;;;;;;1,0;;;;2,0;;4,0;;;;;;;;;;;;;;;;;;;;;;;;;;;;;;;2,0;;;;;;;;;;;;1,0;;;3,0;;;;;;;;;;;;;;;;;;;;;;;;;;;;;;;;;;;;;;;;;;;;;;;;;;;;;;;;;;;;;;;;;;;;;;;;;;;;;;;3,0;;;;;;;;4,0;;;;;;2,0;;;;;;;;;;;;;;;;;;;;;;;;1,0;;;;;;;;;;;;;;;;;;;;;;;;;;4,0;;;;;;;;;;;;;;;4,0;;;;;;;;;;;;;;;;;;;;;;;1,0;;;;;1,0;;;;;;;;;;;;;;;;;;;;;;;;;;;;;;;;;;;;;;;;;;;;;;;;;;;;;;;;;;;;;;;;;;;;2,0;;;;;;;;;;;;;;;;2,0;;;;;;;;;;;;;;2,0;;;;;;;;;;;;;;;;;;;;;;;;;;;;;;;;;;;;;;;;;;;;;;;;;;;;;;;;;;;;;;;;;;;;;;;;;;;;;;;;;;;;;;;;;;;;;;;;;;;;;;;;1,0;;;;;;;;;;;;;;;;;;;;;;;;;;;;;1,0;;;;;;;;;;;;;;5,0;;;;;;;;;;;;;;;;;;;;;;;;;;;;;;;;;;;;;;;;;;;;;;;;;;;;;;;;;;;;;;2,0;;;;;;;;;;;;;;;;;;;;;;;
platform;;;;4,0;1,0;10,0;;49,0;2,0;9,0;1,0;;3,0;;39,0;34,0;13,0;;;2,0;13,0;26,0;1,0;;;;3,0;;;;3,0;8,0;16,0;;32,0;22,0;1,0;5,0;1,0;;6,0;;26,0;;12,0;2,0;2,0;87,0;1,0;13,0;5,0;;;;19,0;6,0;12,0;4,0;26,0;;16,0;3,0;2,0;;;;;11,0;25,0;15,0;5,0;;7,0;;;;8,0;;1,0;133,0;;9,0;;62,0;;1,0;;;2,0;5,0;15,0;;;4,0;;;1,0;;46,0;64,0;4,0;;9,0;6,0;;2,0;6,0;;10,0;;;2,0;;;1,0;15,0;18,0;130,0;1,0;2,0;;;;1,0;7,0;;;;;;;8,0;48,0;2,0;;;1,0;;;;;;;27,0;2,0;;;14,0;18,0;1,0;;;8,0;3,0;3,0;;132,0;;24,0;7,0;;6,0;20,0;;1,0;;14,0;15,0;;;;;;2,0;;2,0;104,0;;;;;;;;;;;8,0;;;;;;54,0;;;8,0;;;;3,0;;;12,0;;;;;;;;24,0;1,0;;;;;2,0;;3,0;9,0;;2,0;;;;;;7,0;;28,0;;3,0;56,0;16,0;12,0;21,0;4,0;2,0;7,0;;6,0;;1,0;;;;;;7,0;50,0;;2,0;;;;8,0;2,0;7,0;;;;17,0;16,0;;;7,0;;;;1,0;;;;;;;9,0;;11,0;;;;2,0;;2,0;;;3,0;;24,0;17,0;;;13,0;;3,0;;;2,0;3,0;8,0;43,0;;;6,0;;;6,0;;;;;;1,0;;;18,0;;14,0;;;;2,0;5,0;5,0;7,0;3,0;;;;2,0;;;2,0;;4,0;27,0;9,0;1,0;;;;4,0;3,0;15,0;17,0;22,0;7,0;1,0;;4,0;11,0;2,0;;7,0;;1,0;1,0;;3,0;;;3,0;;;;4,0;11,0;;;2,0;1,0;;;11,0;;3,0;34,0;28,0;1,0;3,0;5,0;8,0;;;;10,0;;75,0;2,0;11,0;1,0;7,0;4,0;3,0;6,0;;1,0;;;;1,0;4,0;31,0;;;8,0;;2,0;4,0;16,0;2,0;1,0;33,0;;1,0;2,0;2,0;;;1,0;;;;;;2,0;1,0;1,0;;;14,0;8,0;3,0;;2,0;4,0;;;;8,0;54,0;;;7,0;7,0;;7,0;;;;;1,0;;6,0;2,0;;11,0;;3,0;;;;18,0;;;;;12,0;;;;1,0;26,0;;;1,0;;2,0;14,0;2,0;1,0;18,0;;;;;;9,0;;1,0;;;;;3,0;;10,0;;19,0;1,0;;3,0;3,0;;;;2,0;;5,0;2,0;5,0;;2,0;;;2,0;;;;5,0;12,0;;;4,0;1,0;7,0;;4,0;;;;2,0;;;;1,0;;;54,0;;2,0;;;17,0;;;1,0;;3,0;2,0;;3,0;;2,0;;;1,0;;;3,0;;;;4,0;;3,0;;;11,0;1,0;;;12,0;2,0;;;;;;;;;;;;;10,0;1,0;;;;2,0;;;;10,0;2,0;2,0;8,0;;4,0;;;4,0;;;;;1,0;;1,0;;;;;;7,0;;;;;3,0;4,0;;;1,0;;;;;;;4,0;;;2,0;3,0;4,0;;;3,0;;;;;2,0;;;;5,0;;;13,0;4,0;;;;2,0;6,0;;;1,0;;2,0;;2,0;;;;;;;;1,0;;1,0;;2,0;;2,0;13,0;;;5,0;;;;;4,0;;3,0;;;5,0;;;;;;;8,0;;1,0;;1,0;;;;1,0;;;11,0;;;;1,0;;;;1,0;;12,0;1,0;;;;3,0;9,0;;;4,0;;1,0;2,0;;;;1,0;;;;7,0;;;2,0;;;;;;;;;16,0;;;;;;2,0;;;;;;1,0;;;;;;;;1,0;;1,0;4,0;4,0;;;;;1,0;;;;;3,0;2,0;;;;;;;2,0;8,0;;;1,0;;3,0;;;;;;;;;;1,0;;;;;;;;;;3,0;;;;1,0;;;;;;;3,0;;3,0;1,0;;;12,0;;;4,0;2,0;1,0;3,0;;;;;;;1,0;5,0;;;;1,0;;;;;;;1,0;;;2,0;;;;;;;7,0;;;;17,0;1,0;1,0;;1,0;1,0;;;;;;22,0;;1,0;;;;;;;1,0;;;5,0;;;4,0;;1,0;;;;;;1,0;;;4,0;;;;14,0;;4,0;3,0;;;;;;;;;2,0;;2,0;;;;11,0;1,0;;;6,0;;6,0;3,0;;;1,0;;;;;6,0;;40,0;;2,0;;;;;;;;1,0;;;;3,0;;;;;;;;;;;2,0;6,0;;;;;3,0;;;;;;4,0;;;;;;;
polarization;;;;5,0;;7,0;1,0;1,0;1,0;18,0;4,0;;;2,0;3,0;8,0;18,0;;;;;1,0;1,0;1,0;;;2,0;;;;;;16,0;;8,0;;;;;1,0;1,0;;10,0;;9,0;;7,0;19,0;1,0;21,0;4,0;2,0;;;;;17,0;;2,0;;;;;;34,0;;4,0;1,0;2,0;;;;3,0;;;1,0;1,0;;;44,0;;18,0;;14,0;5,0;;;;;;9,0;;;15,0;1,0;;2,0;;13,0;;;2,0;8,0;7,0;;4,0;3,0;;26,0;;30,0;4,0;;;;39,0;5,0;2,0;;2,0;;2,0;6,0;8,0;4,0;;;;;;;1,0;;6,0;1,0;1,0;10,0;7,0;;;;;;17,0;;;;;3,0;;;;;;;;69,0;;;;;20,0;;1,0;3,0;;;;;3,0;;3,0;;2,0;;9,0;;;;;;;;;;;2,0;52,0;;;;;;;2,0;;1,0;;;1,0;;;;11,0;;;;;;;;;;;1,0;;;;;;1,0;1,0;;;;;14,0;;132,0;;;;3,0;;;;;5,0;;;;;;5,0;15,0;;;;7,0;18,0;5,0;;;;;2,0;3,0;10,0;;;;;;4,0;;;;;2,0;;;4,0;;;1,0;;;;;2,0;22,0;;;;;2,0;;;;;2,0;13,0;;;;;;;;;;7,0;;;;;;;;;;;;;;;;;;1,0;;;;2,0;;;;;;;;;;4,0;;;;;;;;;;;;;;;;2,0;;;;;;;;;;;;;;;;;;;;4,0;;;;;;;;;9,0;5,0;;;10,0;;;;;;;;1,0;1,0;;;;2,0;;;1,0;;;;;;;;5,0;;4,0;;12,0;;;;3,0;;5,0;;;;;;8,0;;1,0;;;;;;;8,0;;6,0;2,0;;;;24,0;;;;1,0;;;;;;6,0;;;;;;;2,0;;;;;6,0;;;;;;;;;;;4,0;;;;;;;2,0;;1,0;3,0;;;;;;;;;;;;;;;1,0;;;;;;;;;;;7,0;;;;4,0;;;1,0;;;;;;;;;;;;;;;;;;;;;;;;;;;;;;;;;;;;;;;;;;;;;;;;;;2,0;;;;;;3,0;;;;;3,0;;;;;;;;;;;;;;;;;;;;;;;1,0;;;;;;;;;;;;;;;;;;;;;;;9,0;;;;;1,0;;;;;;;9,0;;;;;;;;;;;;;;;;;;;;;;;;;;;;;;;2,0;;;5,0;;;;;;2,0;;;;;;;;;;;;13,0;;;;1,0;;;;;;;;;;;;;;;;6,0;;2,0;;;;;;;;;;;;;;;;;;;;8,0;2,0;;;5,0;;;3,0;;;;;;;;;;;;;35,0;;;;;;;;;;;;;;;;;;;;;;;;;;;;;;;;;;;27,0;1,0;1,0;;;;;;;;;;;;;;;;;;2,0;;;;;;;;;;;;;;;;4,0;;;;;;;;;;;;;9,0;;;;;;;;;5,0;;;;4,0;;;;;;;;;;;;;;;;;;;;33,0;;;1,0;;;;;;;;;;;;;;;;;;;;;;;;1,0;;;;;;;;;;;;;;;;;;;;;;;;;;;;;;;;;;;;;;;;;;;;;;;;;;3,0;;10,0;;;;;;;;;;;;;;;;;;;;5,0;;;;;;;;;;;;;;;;;;;;;;;;;;;;;;;;;;;;
post;;;;1,0;;1,0;1,0;6,0;1,0;11,0;;;3,0;;10,0;42,0;;;;;1,0;;;1,0;;;;;;;4,0;;11,0;;2,0;;1,0;;;;2,0;;11,0;5,0;;;3,0;11,0;;1,0;14,0;9,0;;;;1,0;;;;;39,0;;;1,0;;1,0;;29,0;24,0;1,0;;;;;;;;;;15,0;;;;26,0;;;;;7,0;;14,0;1,0;;2,0;;;;1,0;8,0;;;;19,0;1,0;;4,0;6,0;;;1,0;4,0;;2,0;;;21,0;36,0;90,0;;;;2,0;;3,0;4,0;;;;;;;4,0;;2,0;;;8,0;;;;2,0;;;3,0;;2,0;5,0;23,0;;;1,0;;;;;;6,0;;;1,0;;1,0;6,0;;1,0;;4,0;;;;;1,0;;4,0;;;14,0;20,0;6,0;;5,0;3,0;;1,0;;4,0;;5,0;;;;;;18,0;;5,0;;;;7,0;1,0;;;6,0;;16,0;1,0;;;9,0;;;1,0;1,0;;3,0;2,0;;3,0;62,0;16,0;;7,0;;;2,0;;2,0;2,0;;57,0;1,0;3,0;19,0;15,0;;1,0;13,0;20,0;5,0;;3,0;1,0;;;;;;;5,0;33,0;;;;;;65,0;;1,0;;;;32,0;11,0;;;3,0;;;;;4,0;4,0;;;19,0;;6,0;;13,0;;;;;;2,0;;;;;4,0;30,0;3,0;;5,0;;;;;;2,0;6,0;25,0;4,0;;;1,0;8,0;12,0;;;2,0;;;4,0;;;;;11,0;;;;18,0;;;1,0;;;;;1,0;1,0;;3,0;;3,0;27,0;;16,0;14,0;2,0;1,0;;12,0;;2,0;4,0;4,0;;6,0;2,0;;;;3,0;2,0;1,0;8,0;23,0;;;;10,0;7,0;;;1,0;5,0;;;;;;;2,0;;;;;8,0;;;6,0;;;4,0;2,0;1,0;42,0;2,0;;;8,0;9,0;;;2,0;;;1,0;;;4,0;;1,0;;;;;;;;;2,0;;;;;;;;;;;;;;;;;;;;;;;;;;;5,0;;;4,0;;;;;;;;;;;3,0;;;;;;;;;1,0;;;;;3,0;1,0;;;;;;;1,0;;;25,0;5,0;;41,0;2,0;;;;5,0;;3,0;;;;;3,0;;;;;2,0;;;;;;6,0;;;;;1,0;;;;;;;;;;;;2,0;;;;;;;;;4,0;1,0;;1,0;1,0;;;;;3,0;;;;;;;;;;;;;;3,0;;;17,0;;;;;;2,0;;;;;;;;;;;;;;;;;;;;;;;;4,0;4,0;;;;;;;;;;;29,0;;;;;;;2,0;;;;;2,0;;1,0;;;;1,0;;;;;;1,0;;;;;1,0;;1,0;;;1,0;;;3,0;;;;;;;1,0;;;;;3,0;;;;;8,0;6,0;;;1,0;1,0;;;;;;4,0;;1,0;;;;2,0;;;;;;;;;;;;;;4,0;;1,0;1,0;;;4,0;;;;2,0;;;;;;;;;5,0;;;;;5,0;;;;18,0;;4,0;;;;;;;;;;5,0;;;5,0;1,0;;;;;;;;;;;;;;5,0;1,0;;2,0;1,0;;;2,0;;;;;1,0;1,0;;;;;;;;;;;;;;;;;;;;;;;;;;;;;;;;;5,0;;;;1,0;;;;;1,0;;;3,0;;;;;6,0;;;;;1,0;;;;1,0;;;;;;;1,0;;;;;;;;;;;;;;5,0;;;;;1,0;;;;;;;;;;;;;;;;;;;;;;;;;;;;;;;;;;;;;;;3,0;;;;;;1,0;;;;;;2,0;;;;;;;;;;;;;1,0;;5,0;;1,0;;;;1,0;;;;;;1,0;;;2,0;;;;;;;;;;;;;13,0;;4,0;;;;;;;;;;;;;;;;;;;;;;;;;;;;;;;;;;;;;;;;;;;;;;;;;2,0;;;;;;;;;;;;;
preset;;;;2,0;;25,0;14,0;13,0;13,0;;1,0;;37,0;;6,0;49,0;;;14,0;1,0;2,0;20,0;15,0;;1,0;5,0;12,0;9,0;;;5,0;4,0;12,0;5,0;69,0;8,0;8,0;2,0;2,0;;4,0;;3,0;;79,0;7,0;31,0;33,0;8,0;45,0;;50,0;;3,0;;5,0;5,0;2,0;7,0;;;;3,0;;;4,0;41,0;12,0;16,0;;37,0;;8,0;;;2,0;1,0;;;78,0;1,0;60,0;40,0;65,0;;21,0;2,0;;;2,0;37,0;2,0;;;;;19,0;;62,0;1,0;14,0;1,0;19,0;12,0;;2,0;7,0;8,0;8,0;99,0;;4,0;;;;95,0;1,0;128,0;32,0;10,0;;;2,0;1,0;4,0;1,0;;;;10,0;;22,0;4,0;1,0;4,0;2,0;34,0;50,0;;;7,0;1,0;;6,0;39,0;;;;50,0;16,0;5,0;;42,0;44,0;;6,0;39,0;;6,0;;9,0;2,0;25,0;;5,0;;1,0;7,0;;8,0;5,0;;;10,0;3,0;;2,0;;;;;19,0;;;;;;4,0;;;;;;7,0;;;;4,0;;;;;37,0;11,0;;;;;;;;;;;;6,0;;;;;;;;;;;;;3,0;;2,0;;;;2,0;16,0;7,0;2,0;;;;;;1,0;;;;;5,0;6,0;;;;;;;11,0;;;;;;;29,0;;1,0;;;2,0;;;4,0;;;;;11,0;;;;2,0;;2,0;;;19,0;;;;;1,0;;;;;;;;;;;2,0;;;;;;;;;;4,0;;;4,0;;;;;2,0;;;;;;;;;5,0;1,0;;;;;;;5,0;;;;;;;8,0;4,0;;9,0;1,0;;55,0;;;;;;;1,0;30,0;2,0;;;;;;;;;;;;2,0;;;;;;;2,0;1,0;3,0;;;3,0;;;;;;;;2,0;1,0;3,0;;;1,0;;2,0;;1,0;4,0;;;1,0;;;;;;26,0;18,0;;7,0;;;1,0;1,0;;4,0;;;4,0;;3,0;;;6,0;3,0;;6,0;;35,0;30,0;;37,0;;1,0;;69,0;;2,0;7,0;11,0;;1,0;38,0;33,0;3,0;5,0;5,0;;;;;7,0;5,0;8,0;;3,0;;;;;3,0;;;;;35,0;1,0;;;;;38,0;;3,0;7,0;;1,0;7,0;;8,0;8,0;31,0;6,0;;;;;;1,0;;1,0;;;;8,0;39,0;6,0;1,0;;;4,0;;1,0;;;28,0;16,0;;5,0;;;;;;;;;2,0;6,0;;7,0;;;;1,0;4,0;;;2,0;;1,0;;;;;;13,0;8,0;;;;1,0;2,0;6,0;;;6,0;;;;;;;;;;2,0;;;;;1,0;3,0;;;1,0;;;;1,0;;;3,0;;;;;;;;;;;;;;;;;;;;;;;4,0;;;;;;;;;;;1,0;;;8,0;;;1,0;;;;;6,0;;;;1,0;;72,0;17,0;;;;;;;1,0;;;;;;;;;;;;;;;2,0;;;;;;;;;;;;;;;3,0;;;4,0;;;;;;;;;;;;;;;;;;3,0;16,0;;;;;;;;;;1,0;;;;;;;7,0;;;;;;;;;;1,0;;;;;4,0;;;;;;;;;1,0;;1,0;4,0;;;;;;;;;;2,0;;;;;;;;;;;;;;;;;;;4,0;;;;;;;;;;4,0;;;;7,0;;;2,0;;;29,0;;4,0;;;3,0;2,0;;;7,0;;3,0;;;;;;;;1,0;1,0;;;;;;;;;;;;;;1,0;3,0;;;;;;;;;;64,0;;;;;2,0;;;;;;;;;;;;;;;;;;;;;;;;;;;3,0;;;;;;;;;;4,0;;;6,0;;;;;;;14,0;;;;;;;;1,0;;;;;;;;42,0;;;;;;1,0;;;;1,0;1,0;;;;;;;;;;;;;;;1,0;;31,0;;;2,0;;;;;;;;;;;;;;;;;;;;;22,0;;;;;;;2,0;;;;;;4,0;;;;;;;;;;;;1,0;;;1,0;;;;;;;2,0;;6,0;;;;;;;;;;;;;;;;;4,0;
projection;;;;16,0;3,0;21,0;2,0;22,0;6,0;7,0;;;16,0;;39,0;27,0;;;8,0;;17,0;9,0;3,0;;;4,0;;6,0;;;;2,0;25,0;1,0;15,0;7,0;1,0;8,0;4,0;;6,0;1,0;22,0;12,0;14,0;2,0;42,0;140,0;17,0;36,0;5,0;7,0;17,0;;;24,0;2,0;6,0;9,0;;9,0;7,0;5,0;1,0;2,0;;46,0;57,0;37,0;2,0;2,0;9,0;21,0;10,0;4,0;;8,0;1,0;11,0;213,0;;4,0;1,0;56,0;;22,0;;;;5,0;62,0;;;;2,0;5,0;3,0;2,0;48,0;;14,0;;22,0;38,0;1,0;4,0;80,0;2,0;12,0;27,0;1,0;15,0;2,0;;;78,0;37,0;35,0;1,0;13,0;;4,0;1,0;15,0;8,0;;;;;3,0;;8,0;10,0;;8,0;;22,0;3,0;12,0;9,0;5,0;;1,0;3,0;1,0;;;7,0;3,0;7,0;;;2,0;1,0;22,0;;87,0;;4,0;2,0;6,0;;88,0;;1,0;;2,0;6,0;1,0;;;;;2,0;1,0;3,0;13,0;7,0;6,0;;;1,0;;;;1,0;;;;;;;;6,0;;9,0;;;;13,0;1,0;;1,0;5,0;;1,0;;;;13,0;;1,0;;2,0;;;15,0;1,0;;36,0;2,0;;5,0;1,0;2,0;;;2,0;46,0;;31,0;;4,0;15,0;5,0;15,0;9,0;6,0;7,0;18,0;4,0;;3,0;8,0;21,0;;;1,0;8,0;82,0;6,0;;6,0;;;;23,0;9,0;;;;;1,0;9,0;;;9,0;4,0;3,0;;;21,0;23,0;;;;32,0;3,0;8,0;73,0;;1,0;1,0;2,0;;7,0;3,0;;;4,0;3,0;1,0;;;5,0;;;;;;;2,0;;1,0;;;1,0;9,0;4,0;36,0;;3,0;1,0;;11,0;4,0;;;;28,0;;1,0;1,0;6,0;3,0;;18,0;34,0;;1,0;1,0;;;;;2,0;8,0;9,0;4,0;5,0;1,0;2,0;11,0;1,0;2,0;;18,0;2,0;4,0;13,0;8,0;29,0;3,0;14,0;;;;23,0;1,0;;;72,0;4,0;8,0;3,0;;;7,0;11,0;5,0;;2,0;;;;;;;1,0;7,0;;;;7,0;;4,0;1,0;;;12,0;5,0;51,0;1,0;;;;;2,0;1,0;1,0;;3,0;;;;;;;;3,0;3,0;1,0;;;11,0;;;;;3,0;;;1,0;2,0;;;;14,0;3,0;;;7,0;2,0;9,0;18,0;;;;34,0;;;;8,0;;6,0;2,0;40,0;1,0;3,0;;14,0;;;;25,0;1,0;1,0;;;;8,0;;;;;;;;;;;;;2,0;;;22,0;;;;15,0;4,0;;15,0;3,0;4,0;;;1,0;4,0;;14,0;;6,0;;;;;;;4,0;;;13,0;;;;;;;;5,0;2,0;;;;;;;;;9,0;1,0;9,0;;;;;;;;2,0;1,0;;;;3,0;;;;;2,0;;1,0;;5,0;;;;;;;;;;;2,0;;;3,0;;;;;;4,0;;;;;;3,0;12,0;;;2,0;;;;3,0;;1,0;;1,0;;;;;;;;;;2,0;2,0;;;;1,0;;17,0;;;;;1,0;;;;;;;18,0;;;;;;;;;;;;1,0;;7,0;;;;;;;;;;;2,0;;;4,0;;1,0;;;;;;32,0;;;;;2,0;1,0;2,0;;;1,0;7,0;;;;;;1,0;;6,0;;;2,0;;;;;2,0;1,0;2,0;;;;;3,0;;22,0;34,0;1,0;58,0;;;;6,0;;;;;2,0;;10,0;;;;1,0;2,0;;;;;;;;;1,0;3,0;;;;;;;1,0;;;;;1,0;;;;;1,0;;;;3,0;;2,0;;;;;;;;;;;13,0;;;;;;1,0;;;;;;4,0;;;;;;;;;;;;;;;;;;16,0;54,0;5,0;4,0;1,0;1,0;;;2,0;;;;;;7,0;;3,0;10,0;;;1,0;2,0;;2,0;;;;;;;;;;;7,0;;2,0;;;;3,0;4,0;;4,0;;;;;;;4,0;;;;;4,0;;;42,0;;;;;;1,0;;;;;;;9,0;;;;;;;;;;3,0;;;;;;2,0;1,0;;;;6,0;;;1,0;;;10,0;;;;;;;4,0;;3,0;14,0;;;;;;;;;1,0;;;;;;3,0;;;;;;;;;;;;;1,0;12,0;;8,0;;;2,0;;1,0;1,0;;1,0;1,0;;;;4,0;;;;3,0;;;;3,0;;;;;;;1,0;;;;;4,0;;;;;4,0;;;;;;;;;;;;;2,0;;11,0;;;;1,0;;;;;;;;10,0;;;;2,0;9,0;;;;;;;;;;;;;
projector;;;;1,0;1,0;;;15,0;5,0;4,0;;;4,0;;1,0;12,0;48,0;;;9,0;6,0;21,0;1,0;2,0;;;;1,0;;;;1,0;17,0;;35,0;20,0;;;2,0;;3,0;4,0;1,0;2,0;;;3,0;121,0;5,0;40,0;13,0;7,0;;;3,0;1,0;1,0;;;;4,0;;21,0;;2,0;;4,0;1,0;57,0;13,0;1,0;;25,0;;3,0;1,0;3,0;2,0;10,0;181,0;;3,0;;42,0;;2,0;;;;;17,0;2,0;;;2,0;;;;38,0;;;;34,0;18,0;;;18,0;3,0;1,0;7,0;;5,0;;;;35,0;34,0;5,0;;;;3,0;;9,0;;;;;;2,0;;;9,0;;4,0;1,0;1,0;;;;9,0;;1,0;22,0;1,0;;;18,0;14,0;;;;3,0;1,0;5,0;;64,0;;;;3,0;1,0;12,0;1,0;1,0;;26,0;16,0;3,0;;;;;6,0;;1,0;;;;;;2,0;;;;10,0;;14,0;;;;;;5,0;;;;;;2,0;;;5,0;3,0;;;;;1,0;;;2,0;;2,0;;;;;1,0;;5,0;;;;;;;;55,0;;;;6,0;3,0;;;;;3,0;1,0;8,0;;;6,0;5,0;;;;2,0;5,0;;;;;;1,0;7,0;2,0;;;;;;;;;1,0;;;;;7,0;19,0;;;;3,0;9,0;;45,0;;17,0;;;;7,0;;;;;;;;;2,0;;;;;;;1,0;9,0;;;;;;1,0;;;;;;;;;;;5,0;;;;;2,0;;;;1,0;;;;;;;;;1,0;;;;;;4,0;;;;2,0;2,0;21,0;;1,0;1,0;;;;;8,0;5,0;;;139,0;;;;;;6,0;;;;;;;;;;;2,0;1,0;;;1,0;;;7,0;;;;;;5,0;6,0;;;;;;;;;;;4,0;;;;;;3,0;;;;;3,0;;;;;;;;;;;;;;;;;8,0;;;4,0;;2,0;6,0;2,0;;;;;;4,0;5,0;10,0;;3,0;;1,0;;;;26,0;;20,0;1,0;;;;;;;;;;;;;;;2,0;;4,0;3,0;;;;;31,0;;1,0;;10,0;;;;11,0;4,0;;6,0;;1,0;;;1,0;;;;2,0;;;8,0;;;42,0;;;;2,0;10,0;;;;;;1,0;;;1,0;;;1,0;;;;;;;;;;;;;;1,0;;7,0;;;;;;;;1,0;;;;;;;;4,0;;2,0;;;;;;;;7,0;1,0;;;;;;4,0;;;;1,0;;;;;;;;1,0;;;;;;;;;;2,0;;;;;1,0;;;1,0;2,0;;8,0;;;;;;;;;;;;;;;;1,0;;;3,0;;2,0;6,0;;;;;;2,0;3,0;;;;;;;;;2,0;;;;;8,0;;;;;;;;;;;;;;;1,0;;1,0;;;;;;;;;3,0;;;;;;;;7,0;;;;;;;;;1,0;;;;;1,0;;;;;;;5,0;;;;;;;;;;;;;;;;;1,0;;4,0;;;;;;;1,0;;;;;2,0;;;;;;;;;2,0;;;;;;;;;;;;;;;1,0;;;;;;;1,0;;;;;;;;;;;;1,0;;;;;;;;;;;;1,0;2,0;;;;;;;;;;;;;;;2,0;;;;;;;;;;;;;1,0;;1,0;;;1,0;;;2,0;;;;;;;;;;;4,0;;;;;3,0;;;;;;;;;;;;1,0;;;;;;;;;;;2,0;;;;;;;;;3,0;;;;;;2,0;;;;;;;;;;;;2,0;;;;;;;;;;;;;;;;;;;;;;17,0;;;;;;;;;;;;;;;;;;;;1,0;;;;;;;;;;;;;;2,0;4,0;;;;;1,0;;;;;;1,0;;;1,0;;;;2,0;;;;;;;;;;;;;;1,0;;;;;;;;;;;;;;;;;;
protective;;;;2,0;;1,0;5,0;11,0;2,0;7,0;;;;;4,0;;;;;;;;;1,0;;;1,0;;;;;;18,0;;;;;;;;2,0;;7,0;;;;;62,0;3,0;;30,0;;;;7,0;4,0;130,0;;;;4,0;3,0;;;15,0;;;35,0;12,0;2,0;;;4,0;;;;;;;41,0;;23,0;1,0;17,0;;;;;1,0;;32,0;;;8,0;;;1,0;;15,0;2,0;;;30,0;6,0;;;2,0;3,0;1,0;;1,0;;;;;22,0;16,0;35,0;2,0;1,0;7,0;;;1,0;;;;;;;;;3,0;8,0;;;4,0;;;;2,0;;;35,0;;;;14,0;1,0;;;6,0;4,0;1,0;2,0;1,0;27,0;;1,0;;;1,0;72,0;;;;;2,0;;;;;4,0;;;5,0;25,0;;;;7,0;5,0;1,0;6,0;;11,0;1,0;;;;;;;18,0;1,0;4,0;;;;131,0;;1,0;;1,0;;2,0;;;;11,0;39,0;;4,0;;4,0;;4,0;2,0;;4,0;60,0;;2,0;;;;22,0;;3,0;;29,0;12,0;;15,0;2,0;14,0;6,0;19,0;4,0;12,0;1,0;1,0;;1,0;;;;1,0;;1,0;6,0;;;;;;9,0;;;;2,0;;9,0;;8,0;;4,0;3,0;;6,0;12,0;;6,0;3,0;;;;17,0;28,0;16,0;;;;4,0;2,0;;;;1,0;7,0;5,0;;;12,0;8,0;;;;;2,0;20,0;;16,0;;;;;6,0;;;;18,0;5,0;1,0;18,0;;;;;24,0;;;;4,0;;;3,0;;;1,0;;3,0;;;;;;23,0;10,0;2,0;;;;1,0;;7,0;;2,0;2,0;;;;;5,0;;5,0;;1,0;8,0;;;;;;;;;2,0;;;;;2,0;;;;1,0;2,0;;;;;;;;;;2,0;;6,0;4,0;;;3,0;;;2,0;;1,0;;;;1,0;1,0;;;;;;;;;;;;;;;;;;;;;;;;1,0;;;;1,0;2,0;2,0;4,0;;;;;;;;4,0;;;12,0;;;;;9,0;;;;;2,0;;;;;;;;;;;;;;;;1,0;;;;;;;;;;;;;;;;;;;;2,0;;;;;;;;;1,0;;;;;;4,0;;;;;1,0;;;;;;;;;;;;;;;;2,0;;;;;;;;;;;1,0;;;;;;;;;;;;;;;;;;;;;;;;;;;;;;;;;;;;;2,0;9,0;9,0;;;;;;;8,0;;;;;;;;;;1,0;;;;;;1,0;;;;;;1,0;;;;;;1,0;6,0;;;;;;;;1,0;;;;;2,0;;1,0;;;;;3,0;;;1,0;2,0;;;;;;;;;;37,0;;;;;;4,0;;;;;5,0;;;;;;;;;2,0;;;;;;;;;;;;3,0;;;;2,0;;;;2,0;6,0;;;;;;;;;;1,0;;;;;;3,0;;;;;;;;;1,0;;;;;;;;2,0;;;;;2,0;;1,0;1,0;;;;;;;1,0;4,0;;3,0;;3,0;;;;2,0;;;;;;;;7,0;;2,0;;;;;;;;;;;;;;;;;;;;;;2,0;;;;;;;;;;;;;;;;;;;;;;;;;;;;;1,0;;;;;1,0;;;;2,0;;;;;;;;;;;;;;;1,0;;;;;;;;;;;;;;;;;;;;;;;;;;;;;;;;;;;;;;;2,0;;;;;;;;;;;;;;;;;;;;;;;;;;1,0;;;;;;;;;;;;;;;;;;;;;;;;;;;;;;;;;;;;;;;;;;;;;;;;;;;;;;;;;;;;;;;;;;;2,0;;;;;;;;2,0;;;1,0;;;;;;;;;;;;;;;;;;;;;;;;;;
pulse;;;;1,0;;;;6,0;1,0;1,0;27,0;;4,0;;;9,0;10,0;;;1,0;;4,0;2,0;;;;;;;;2,0;2,0;12,0;;75,0;18,0;;;2,0;;10,0;;9,0;6,0;36,0;4,0;24,0;60,0;11,0;;;4,0;;;48,0;1,0;10,0;;4,0;;;;4,0;;;;2,0;17,0;38,0;;4,0;;133,0;69,0;;11,0;;11,0;18,0;32,0;;7,0;;43,0;;;;;;4,0;1,0;;;;2,0;2,0;2,0;2,0;27,0;;;;3,0;14,0;;15,0;238,0;4,0;77,0;3,0;;52,0;;;;28,0;35,0;2,0;31,0;21,0;;;1,0;7,0;19,0;4,0;15,0;;23,0;22,0;;5,0;5,0;;;;3,0;32,0;3,0;;32,0;;7,0;12,0;4,0;;;;171,0;1,0;;;;5,0;6,0;51,0;36,0;;;111,0;;18,0;273,0;13,0;2,0;;3,0;1,0;9,0;4,0;;1,0;;;6,0;14,0;;;;;;8,0;;;4,0;31,0;;;;;22,0;150,0;;11,0;;;;;;;;;4,0;7,0;;;;;3,0;;;;1,0;23,0;;;;;;;;1,0;;;;;;;189,0;;;;1,0;;;;;;;;2,0;;;1,0;79,0;;;;7,0;;;2,0;;;;;13,0;95,0;;;;;;1,0;5,0;;23,0;;36,0;;;58,0;;;4,0;;11,0;;6,0;3,0;15,0;18,0;4,0;;;104,0;;;43,0;;;9,0;;;;7,0;2,0;;;;1,0;;;;;;2,0;;;;;1,0;;;;;;;;3,0;;;;;37,0;;;;;;;;;;;7,0;;;2,0;;;;;2,0;9,0;;;7,0;4,0;1,0;;;;1,0;1,0;;;6,0;;;;4,0;;1,0;;;1,0;;;8,0;;;;;;1,0;;;;;;;;;;5,0;;;;;;1,0;;;;9,0;;64,0;;;2,0;;4,0;7,0;;;48,0;;;;26,0;21,0;;;;5,0;;;;;;;36,0;;14,0;;;;;;1,0;33,0;42,0;4,0;;8,0;;3,0;1,0;12,0;12,0;;;;;6,0;9,0;;;58,0;;;;;8,0;1,0;;;;;1,0;4,0;;1,0;;;;1,0;1,0;1,0;;1,0;5,0;;;;;10,0;5,0;;9,0;;;;1,0;17,0;;2,0;2,0;5,0;1,0;;;;;;;;;;;;;2,0;15,0;;;1,0;;;;;;;;3,0;;;;;;;;3,0;;;;;;;;;;;;;1,0;;6,0;8,0;;;;1,0;;17,0;8,0;;;9,0;;;;;;;;;;;;;2,0;4,0;;2,0;;1,0;;11,0;20,0;;2,0;;;;;;;;2,0;;;;35,0;;;1,0;;;;;;;11,0;;;;;11,0;;;;;9,0;1,0;7,0;;5,0;;;;;;;;;1,0;;;1,0;;;;;;4,0;13,0;;2,0;17,0;;;;;;;;;;;;1,0;6,0;;18,0;;;;;12,0;;3,0;;;;;2,0;;;;19,0;;;16,0;;;;;1,0;;;4,0;;;;;;;;;;;;;2,0;;;21,0;;;;;;;2,0;1,0;6,0;;;;;;3,0;;;1,0;;;;3,0;;;;;;17,0;;;;2,0;;;;;4,0;;;;;;;;1,0;60,0;;;1,0;;1,0;;;;3,0;;;;;;;;;;;;10,0;;;;;;1,0;43,0;;2,0;;;2,0;;;;16,0;;;;;;;;;2,0;;;;3,0;1,0;;;;2,0;;;7,0;10,0;;1,0;;;1,0;;4,0;;;2,0;;;2,0;;;;;;;;;;7,0;1,0;8,0;;;;3,0;;10,0;;;;;;;7,0;;;;1,0;;;;;;;;;;;;2,0;;19,0;;;;1,0;;;;;;;;;;;;;;;;;;2,0;;;;;;;;;2,0;;;1,0;;;;;;;;;;;;;;;;10,0;4,0;;1,0;;;;;;;;;;;;43,0;;3,0;1,0;;;;;;;;;;6,0;;;2,0;;;;;;;;;;;;;;;;;9,0;4,0;;;;;;;;;;;;4,0;;;;;;;;;;;;;;;;;;;;;;;;;;;;;;;;;2,0;;;;;;
radio;;;;3,0;;;;36,0;;;1,0;;6,0;;;6,0;;;;;;3,0;;5,0;;;;;;;;;54,0;;20,0;23,0;;;;;14,0;;;;6,0;1,0;9,0;246,0;6,0;6,0;;;;;;;17,0;;;;;1,0;2,0;;;;;;;;8,0;;;;;2,0;9,0;;;4,0;;6,0;2,0;28,0;;24,0;;;;;;;;;;;;;34,0;5,0;;1,0;10,0;;;5,0;1,0;;27,0;;;1,0;;;;6,0;1,0;9,0;21,0;;;;4,0;;1,0;;;;;8,0;;1,0;;;;;3,0;17,0;;;;2,0;26,0;1,0;4,0;;;;109,0;;;;;4,0;;1,0;38,0;;;1,0;;66,0;89,0;;;;14,0;;;;;;;;3,0;;2,0;;;;;;;;1,0;17,0;;;;;;;;2,0;;;1,0;;;;;;;;;;;1,0;6,0;;;;;;;;;;;;;;;;;;2,0;;39,0;;;;;;;;;;;;1,0;;1,0;;;;;2,0;;;;;;;;1,0;59,0;;;;;;22,0;2,0;1,0;;;;;;;6,0;;;2,0;;25,0;;;;;2,0;1,0;;;15,0;;;;;9,0;;;;;;;;5,0;;;3,0;;;;;;;;;;;;;;;;;;22,0;;;;;;1,0;;;;;;;;;;177,0;2,0;;;;;;;;1,0;5,0;;2,0;;1,0;;;;;;;1,0;;1,0;;;;;;;;;;;;;;;;5,0;;;;;;;;3,0;;;;;;;;;2,0;;;;9,0;;;;;;;;;1,0;;;;1,0;;;3,0;;;;;;;;;;;;;1,0;;;4,0;;;;;8,0;;2,0;;;;3,0;8,0;1,0;3,0;;;5,0;8,0;3,0;;;1,0;;;;;;;19,0;;;4,0;4,0;;;2,0;;;;;;5,0;;;1,0;;4,0;1,0;;;;;5,0;;;;;;;;;;;;;1,0;;;;;1,0;;;1,0;7,0;;;;;;1,0;;;;;2,0;4,0;;;31,0;;;;2,0;;9,0;;;;;;1,0;3,0;;;50,0;;;3,0;;1,0;3,0;;;;;;;;5,0;;1,0;3,0;;;;;;;1,0;;;;;1,0;;;5,0;12,0;296,0;5,0;;;;;;;;;;;;;;;;33,0;;;;;;16,0;4,0;;;;;;;;;;;1,0;3,0;;;;;6,0;;;;;;;;;;5,0;;;;;;1,0;;;;;;;;;1,0;3,0;;;;;3,0;;;;;;;;;;1,0;89,0;116,0;;;2,0;;1,0;2,0;;;;;;2,0;;;;;;;;;10,0;;;;;;;;;;;;;;;7,0;;;;;;;;;;;;;;;10,0;;;;;;;;;;;;;;15,0;;;;;;;;;;;;;;;;;;25,0;;;;;;2,0;;;;;;;2,0;;;;;;;;;;;;;;;;;2,0;;;;;;;;;;;;;;;;;;;;;;;;;3,0;;;;;;;;;1,0;;;;;;;;;;;;;;;;;;3,0;;;;;;;;3,0;;;1,0;;;;;;;;;;1,0;;;;;1,0;;;;;;;;;;;;;;;;;;;;;;;;;;;;;;;;;;;;;1,0;;;;;;;;;;;;;;;;;;;;20,0;;;1,0;;;;;;;;;2,0;7,0;;;;;;;;;;;;;;;;;;;;1,0;;;;;;;1,0;;;;;;;;;;;;;;;;;;8,0;;;4,0;;;;;;;;;;;;;;;;;;;;1,0;;;;;;;;;;;;;;;;;;;
recognize;;;;1,0;5,0;5,0;15,0;30,0;34,0;1,0;;;11,0;3,0;1,0;47,0;3,0;;15,0;;;34,0;;;;;5,0;;;2,0;11,0;2,0;44,0;;18,0;13,0;1,0;;3,0;;43,0;;1,0;2,0;23,0;2,0;26,0;46,0;5,0;32,0;;3,0;1,0;;;4,0;1,0;;5,0;1,0;;;4,0;;3,0;;1,0;3,0;4,0;1,0;6,0;;8,0;;3,0;12,0;26,0;;;212,0;;3,0;3,0;39,0;;1,0;6,0;1,0;;1,0;38,0;;2,0;;;14,0;;10,0;66,0;15,0;10,0;1,0;28,0;86,0;;7,0;1,0;8,0;7,0;6,0;2,0;23,0;;5,0;;22,0;17,0;11,0;4,0;19,0;;;4,0;14,0;21,0;5,0;;2,0;;6,0;;6,0;1,0;;2,0;;1,0;9,0;;;13,0;;;3,0;5,0;;;;22,0;8,0;12,0;;1,0;9,0;16,0;;19,0;1,0;;;3,0;4,0;75,0;;;;;4,0;;;6,0;;;2,0;4,0;;;;;;;2,0;;;;2,0;;15,0;;;;;;1,0;;;;;;3,0;;;1,0;3,0;;;2,0;2,0;3,0;51,0;;;;;;;;;;;;;;;;;;;5,0;;15,0;;3,0;1,0;;;2,0;;;;;1,0;1,0;;;;;1,0;;;14,0;;1,0;1,0;;;6,0;;1,0;;;;;17,0;;;5,0;;2,0;;;3,0;3,0;;;;1,0;5,0;;3,0;;;;;;;;12,0;;;26,0;1,0;;;;;;;;;4,0;1,0;;;;;;7,0;;1,0;;;1,0;;1,0;1,0;;;;1,0;;;;;1,0;;;;2,0;;;;;;;;1,0;2,0;;;;;;5,0;;;;2,0;2,0;11,0;;;;;;;4,0;30,0;3,0;;3,0;3,0;;;;;;2,0;;;;;;;2,0;;;;8,0;1,0;;;3,0;;;;;;;10,0;;26,0;;;;;;;;;;;1,0;2,0;;5,0;;;4,0;1,0;3,0;2,0;6,0;;7,0;;3,0;;;;;;1,0;1,0;;;;46,0;;;;10,0;5,0;;14,0;;2,0;;1,0;;;11,0;;;;;25,0;;3,0;;1,0;;;1,0;;5,0;2,0;3,0;;3,0;;;9,0;;;;;1,0;5,0;4,0;1,0;;3,0;6,0;40,0;1,0;4,0;;;2,0;;;10,0;;;;;;1,0;;;3,0;5,0;;;;;2,0;2,0;;;3,0;;5,0;3,0;;1,0;;1,0;2,0;;2,0;7,0;;;;;;1,0;;;;;;2,0;1,0;11,0;;88,0;2,0;;3,0;;2,0;1,0;;8,0;6,0;;2,0;;;;2,0;;2,0;4,0;1,0;;1,0;;;;3,0;;;;;;;1,0;;1,0;1,0;;19,0;2,0;1,0;;;;10,0;;;;4,0;;;;;3,0;;18,0;;;1,0;;16,0;1,0;;1,0;;;2,0;;;;;;;7,0;;;2,0;;6,0;;;;1,0;;12,0;6,0;;;2,0;;;1,0;;;1,0;;88,0;;;14,0;11,0;;;;;2,0;;;;;;1,0;;1,0;1,0;;2,0;49,0;;2,0;;3,0;13,0;;;;;;;1,0;;;;;;;;;;;;;;6,0;;;;;;;2,0;;1,0;;;;;;3,0;;2,0;;;;2,0;;;;;;2,0;;;;;2,0;4,0;;;;;;;1,0;;5,0;;;;;;;;;;;;;;;;;1,0;;;;;;;;;;;2,0;;2,0;;;;;;;;;;;;;;;;3,0;;;;;;1,0;;3,0;;;;;;2,0;25,0;;1,0;;;;;;;;;;2,0;;1,0;;6,0;;;;;;;;;1,0;1,0;;;;;2,0;;;;;5,0;;1,0;;;;;2,0;;;;;;;;;;;;;;;2,0;;;;3,0;;;;;;1,0;;;2,0;;;2,0;;;;;;;;9,0;;6,0;3,0;;;;;6,0;;3,0;;;;;;1,0;;;;;;;;;;;;1,0;;6,0;;;1,0;2,0;;1,0;;;;;;;2,0;;;2,0;;;;;;;;;;1,0;;;;;;;1,0;;1,0;;;;;;;;;;;;4,0;;;;;;15,0;2,0;;;;;;;;;;;;;;14,0;;;;;;;;;;;;;;;;;;;;;;;;;;1,0;;1,0;;;;;;;;2,0;6,0;;;;;;;;1,0;2,0
region;;;;12,0;27,0;17,0;7,0;91,0;148,0;271,0;27,0;;68,0;2,0;16,0;222,0;40,0;1,0;23,0;;87,0;145,0;7,0;99,0;10,0;7,0;125,0;11,0;2,0;4,0;20,0;19,0;103,0;19,0;148,0;23,0;10,0;11,0;21,0;3,0;175,0;5,0;128,0;59,0;235,0;100,0;405,0;356,0;68,0;277,0;99,0;86,0;12,0;47,0;33,0;92,0;166,0;1,0;38,0;;76,0;15,0;105,0;17,0;68,0;71,0;192,0;285,0;155,0;27,0;33,0;14,0;101,0;2,0;3,0;25,0;71,0;29,0;33,0;1671,0;123,0;166,0;5,0;491,0;10,0;11,0;;4,0;1,0;17,0;162,0;8,0;1,0;36,0;22,0;14,0;5,0;;355,0;6,0;14,0;87,0;23,0;385,0;8,0;21,0;230,0;20,0;86,0;33,0;51,0;64,0;121,0;10,0;5,0;566,0;324,0;246,0;1,0;105,0;1,0;3,0;7,0;80,0;59,0;7,0;21,0;;33,0;47,0;;157,0;10,0;10,0;49,0;12,0;153,0;30,0;7,0;2,0;128,0;2,0;5,0;339,0;80,0;1,0;;116,0;190,0;104,0;70,0;11,0;31,0;44,0;166,0;10,0;117,0;;9,0;110,0;10,0;39,0;278,0;53,0;5,0;1,0;99,0;175,0;70,0;59,0;7,0;;2,0;75,0;46,0;50,0;6,0;6,0;62,0;16,0;;11,0;11,0;1,0;143,0;139,0;1,0;28,0;4,0;2,0;2,0;1,0;;61,0;18,0;110,0;5,0;10,0;;56,0;;5,0;26,0;55,0;6,0;;10,0;8,0;39,0;148,0;59,0;37,0;4,0;57,0;36,0;16,0;4,0;9,0;15,0;28,0;39,0;25,0;21,0;;;41,0;93,0;4,0;594,0;5,0;15,0;5,0;18,0;34,0;12,0;10,0;3,0;35,0;25,0;36,0;149,0;2,0;38,0;24,0;1,0;55,0;166,0;10,0;668,0;54,0;15,0;1,0;;1,0;;4,0;108,0;18,0;1,0;111,0;;1,0;8,0;115,0;626,0;;59,0;5,0;6,0;6,0;1,0;92,0;35,0;6,0;14,0;14,0;8,0;23,0;152,0;332,0;22,0;;3,0;6,0;;62,0;4,0;52,0;2,0;24,0;81,0;42,0;1,0;;8,0;5,0;3,0;1,0;34,0;;1,0;11,0;1,0;;;;1,0;12,0;28,0;92,0;;12,0;14,0;8,0;22,0;31,0;;4,0;8,0;5,0;;;;9,0;18,0;;1,0;;24,0;9,0;1,0;;2,0;;;3,0;6,0;3,0;15,0;6,0;2,0;18,0;2,0;22,0;135,0;;4,0;14,0;6,0;73,0;12,0;8,0;6,0;35,0;;1,0;;137,0;6,0;2,0;15,0;24,0;2,0;5,0;;9,0;;4,0;13,0;13,0;13,0;;;3,0;;;;2,0;4,0;4,0;;4,0;36,0;41,0;7,0;12,0;1,0;;2,0;17,0;111,0;133,0;11,0;1,0;;8,0;;29,0;73,0;2,0;;;19,0;22,0;;;;;14,0;72,0;51,0;1,0;30,0;20,0;14,0;12,0;10,0;2,0;3,0;2,0;8,0;16,0;20,0;65,0;;4,0;13,0;79,0;5,0;6,0;2,0;104,0;71,0;7,0;54,0;1,0;24,0;40,0;60,0;;40,0;71,0;20,0;4,0;;14,0;26,0;4,0;11,0;20,0;37,0;1,0;1,0;72,0;24,0;56,0;2,0;17,0;;27,0;32,0;83,0;6,0;10,0;1,0;;;;73,0;81,0;;;1,0;8,0;69,0;5,0;20,0;;8,0;;19,0;22,0;15,0;79,0;56,0;1,0;41,0;10,0;4,0;20,0;;11,0;21,0;6,0;6,0;6,0;2,0;2,0;41,0;12,0;9,0;;;45,0;48,0;5,0;7,0;;18,0;4,0;4,0;66,0;;8,0;8,0;;2,0;;7,0;;10,0;1,0;;6,0;;4,0;1,0;10,0;22,0;5,0;9,0;13,0;16,0;10,0;1,0;;45,0;17,0;;2,0;4,0;;;24,0;1,0;21,0;32,0;13,0;;28,0;;;8,0;;3,0;13,0;;1,0;;1,0;9,0;13,0;19,0;26,0;3,0;3,0;9,0;12,0;;1,0;24,0;2,0;16,0;;3,0;13,0;5,0;4,0;;17,0;3,0;18,0;18,0;3,0;21,0;1,0;;24,0;2,0;;1,0;;;36,0;;1,0;;;18,0;;88,0;2,0;6,0;;;39,0;9,0;1,0;5,0;;1,0;27,0;3,0;2,0;;;;5,0;;6,0;28,0;5,0;;34,0;14,0;;;11,0;;1,0;39,0;;;65,0;4,0;;12,0;11,0;1,0;1,0;2,0;1,0;14,0;2,0;47,0;27,0;2,0;;14,0;;2,0;;;;20,0;;3,0;2,0;;2,0;6,0;;2,0;11,0;156,0;13,0;6,0;7,0;;7,0;3,0;;53,0;;1,0;19,0;;3,0;1,0;3,0;2,0;3,0;10,0;4,0;;10,0;;16,0;;3,0;3,0;7,0;3,0;;;3,0;17,0;29,0;3,0;;;2,0;2,0;6,0;;1,0;6,0;;5,0;;1,0;;;30,0;4,0;4,0;8,0;;3,0;;18,0;53,0;1,0;5,0;;3,0;107,0;29,0;4,0;18,0;47,0;7,0;3,0;12,0;27,0;;29,0;36,0;3,0;3,0;2,0;33,0;15,0;6,0;;1,0;2,0;;11,0;16,0;;2,0;;;4,0;19,0;;;413,0;69,0;135,0;5,0;25,0;;35,0;8,0;15,0;7,0;171,0;;181,0;48,0;19,0;99,0;138,0;7,0;;17,0;8,0;23,0;65,0;5,0;6,0;1,0;4,0;13,0;17,0;6,0;29,0;20,0;4,0;;166,0;11,0;5,0;52,0;126,0;4,0;2,0;2,0;15,0;;7,0;16,0;;5,0;;;37,0;10,0;3,0;;;5,0;;;6,0;5,0;5,0;6,0;6,0;16,0;8,0;4,0;;;41,0;;18,0;;;127,0;24,0;;114,0;2,0;15,0;;;;1,0;1,0;1,0;;2,0;3,0;5,0;1,0;;1,0;4,0;;4,0;1,0;;2,0;;23,0;350,0;13,0;;10,0;5,0;;2,0;17,0;13,0;7,0;2,0;5,0;;25,0;;;3,0;;6,0;2,0;;3,0;1,0;30,0;14,0;;25,0;;;22,0;;2,0;;8,0;1,0;2,0;1,0;4,0;26,0;;16,0;5,0;16,0;;7,0;5,0;38,0;;;3,0;5,0;;;25,0;;;;18,0;;3,0;;7,0;1,0;;2,0;1,0;;1,0;;;20,0;1,0;18,0;;1,0;2,0;;;2,0;3,0;;13,0;1,0;4,0;;8,0;3,0;;3,0;3,0;;12,0;;8,0;15,0;17,0;;;;7,0;;3,0;;;5,0;29,0;16,0;;11,0;1,0;;;;8,0;2,0;;;10,0;;9,0;;3,0;9,0;1,0;;10,0;;;9,0;;7,0;;;4,0;1,0;6,0;;5,0;7,0;;;
reproduction;;;;2,0;;;;18,0;2,0;;;;;;;10,0;;;;;;17,0;;;;;8,0;;;2,0;;;8,0;;32,0;;;;;;21,0;;;;;2,0;13,0;29,0;5,0;42,0;;;;;;;;2,0;;;;1,0;;;;;;;4,0;2,0;;;10,0;;;;2,0;;;109,0;;1,0;1,0;16,0;;2,0;;;;;;;;;;1,0;;;22,0;;;;;20,0;;21,0;;16,0;6,0;;;28,0;;;;8,0;;27,0;;5,0;;;18,0;27,0;1,0;;;;;;;1,0;;;;3,0;;1,0;;;5,0;;1,0;;6,0;;;2,0;3,0;;15,0;;3,0;1,0;3,0;;;;;;;1,0;50,0;;3,0;;12,0;;;;;;;;;;;;;;;;;;;;;;;;;1,0;;1,0;;;7,0;;;;;;;;;;1,0;;;;;;;;;;;;;;;;;;1,0;;;;;;;;;;;;2,0;;;;;;;;;;;;1,0;;;;;;;;3,0;;;;;;;20,0;;;;;;;1,0;;;;;;4,0;;;;36,0;;;;;3,0;;;;;;;;;;;;;;;;;;;;;;;;;;2,0;;;2,0;;;;;;;;;;;;;;;;;;;;;;;;;;;;;;2,0;;;;;;;;;;;;;;;;;;;;;;;;;;;;;;;;;;;;;;;;;;;;;;;4,0;;;;;;;;;;;;;;;;;;1,0;14,0;;;;;;;;;1,0;;;;;;3,0;;;;;;4,0;;2,0;;;;;154,0;;1,0;1,0;7,0;;1,0;3,0;28,0;;;;5,0;;;;;13,0;;;;1,0;;;;1,0;;;;;;;;;;;1,0;;;;;;;;;;;;;;;;;;;2,0;;5,0;;;;;;;;12,0;1,0;;14,0;;;;;3,0;;;;;;;;;;4,0;;;;;;;;4,0;;;;;;;3,0;;;;;;;;;;;;;;;;2,0;;;;;;;;;;;4,0;;6,0;;;;;2,0;;;;;;;;;;;;;;;;;;;;;;;;;;;;;;;;;;;;;;;;;;;;;;;;;;;;;7,0;6,0;;;;;1,0;;;;;;;;;;;;;;;2,0;;;;;;;;;;;;;;;;;;;;;;;;;;;;;3,0;;;;;;;;;;;;;11,0;;;;;;;;;;;;;;;;;;;;;11,0;;;;;;;;;;;;;;;;;3,0;;;;;;;;;;;;;;;;3,0;;;;;;;;;;;;;;;;;;;;;;;;;1,0;;;;;;;;1,0;;;;;2,0;;;;;;;1,0;;1,0;1,0;;;2,0;;;;;;;;;;;;;;;;;;;4,0;;;3,0;;;;4,0;;;;;;;;;;;;2,0;;;;;;;;;;;;;;;;;;1,0;;;;;;;;;;1,0;;;;;;;;;;;;4,0;3,0;;;;;;;;;;;;;;;;;;;;;;;;;;;;;;;;6,0;;;;;;;;;;;;;;;;;;;;19,0;1,0;;;;;;;;;;;;;;;;;;;;;;;;;;;;;;;;;;;;;;1,0;;3,0;;;;;;1,0;;;;;;;;;;;;;;;;;;;;;;;;;;;;;;
screen;;;;6,0;2,0;4,0;;52,0;116,0;10,0;10,0;;11,0;1,0;6,0;22,0;;;3,0;1,0;8,0;56,0;10,0;14,0;1,0;;7,0;14,0;;1,0;24,0;2,0;102,0;4,0;94,0;21,0;1,0;3,0;8,0;;78,0;;3,0;1,0;33,0;6,0;39,0;322,0;33,0;1287,0;6,0;28,0;6,0;13,0;1,0;3,0;11,0;2,0;1,0;;3,0;2,0;3,0;4,0;12,0;2,0;33,0;19,0;36,0;24,0;46,0;9,0;20,0;;20,0;7,0;6,0;6,0;4,0;642,0;;27,0;1,0;146,0;1,0;38,0;;;;;22,0;4,0;12,0;4,0;3,0;12,0;16,0;;133,0;15,0;3,0;2,0;61,0;42,0;;10,0;72,0;1,0;58,0;6,0;19,0;9,0;;24,0;2,0;99,0;63,0;161,0;5,0;22,0;1,0;;5,0;36,0;34,0;11,0;;;;10,0;;4,0;15,0;;8,0;33,0;;39,0;;;15,0;1,0;5,0;26,0;69,0;;;79,0;39,0;50,0;13,0;;16,0;11,0;15,0;;101,0;;;2,0;4,0;13,0;83,0;;2,0;;68,0;97,0;9,0;;4,0;;;6,0;5,0;8,0;1,0;;1,0;1,0;;9,0;;;;2,0;;3,0;7,0;;;6,0;;11,0;;3,0;11,0;4,0;1,0;12,0;;;;25,0;;;3,0;;1,0;23,0;;10,0;1,0;;1,0;3,0;1,0;;2,0;5,0;21,0;6,0;3,0;;3,0;20,0;9,0;;42,0;;5,0;;2,0;30,0;7,0;9,0;2,0;13,0;1,0;3,0;2,0;36,0;1,0;9,0;;;;21,0;23,0;7,0;2,0;4,0;1,0;;;;49,0;5,0;6,0;;;;6,0;63,0;;;23,0;;6,0;;6,0;6,0;34,0;;;1,0;4,0;5,0;;35,0;12,0;7,0;10,0;;;28,0;;367,0;;4,0;47,0;8,0;;;12,0;;;;;;;26,0;3,0;;;;;9,0;2,0;3,0;;11,0;;;12,0;25,0;4,0;5,0;;27,0;;3,0;;;1,0;1,0;2,0;;5,0;7,0;;2,0;;;;;;13,0;;3,0;;1,0;3,0;12,0;;;5,0;1,0;6,0;21,0;;3,0;1,0;4,0;;2,0;2,0;28,0;9,0;;;14,0;1,0;;;;;15,0;;;;5,0;2,0;1,0;;2,0;4,0;;6,0;2,0;;1,0;;2,0;3,0;;;1,0;;7,0;8,0;13,0;12,0;1,0;;1,0;;19,0;6,0;1,0;;2,0;;5,0;;;;;1,0;19,0;36,0;2,0;3,0;3,0;15,0;;1,0;;3,0;;;4,0;2,0;2,0;;11,0;;4,0;;;;74,0;6,0;;34,0;;;14,0;36,0;;96,0;6,0;19,0;4,0;7,0;8,0;18,0;9,0;29,0;2,0;3,0;;;5,0;12,0;11,0;11,0;8,0;;3,0;7,0;96,0;;7,0;;;;2,0;3,0;10,0;;;;10,0;181,0;1,0;1,0;;;;23,0;6,0;9,0;9,0;10,0;;8,0;;2,0;14,0;;4,0;1,0;2,0;;1,0;10,0;33,0;129,0;6,0;4,0;9,0;27,0;14,0;28,0;2,0;5,0;;9,0;;1,0;;2,0;15,0;13,0;1,0;1,0;2,0;25,0;;1,0;4,0;;1,0;4,0;;;;6,0;2,0;;3,0;;6,0;;;24,0;;5,0;;5,0;;;;55,0;6,0;16,0;12,0;;38,0;1,0;;;4,0;10,0;3,0;3,0;;17,0;17,0;1,0;;2,0;;;3,0;4,0;12,0;4,0;;1,0;;6,0;2,0;8,0;16,0;2,0;;1,0;4,0;;2,0;7,0;4,0;8,0;;;8,0;;1,0;;;;;7,0;;2,0;20,0;3,0;;5,0;;1,0;10,0;;5,0;;1,0;;;3,0;;;13,0;1,0;;;1,0;;3,0;;7,0;;3,0;2,0;1,0;66,0;5,0;11,0;;;;;;2,0;;2,0;;;;;;5,0;1,0;6,0;;2,0;2,0;3,0;4,0;3,0;16,0;;1,0;;1,0;;;;;;;;5,0;2,0;9,0;8,0;3,0;3,0;;8,0;;2,0;;1,0;;;;1,0;;;5,0;;;;2,0;1,0;2,0;;8,0;;3,0;2,0;;;13,0;6,0;;17,0;;3,0;;3,0;;2,0;;2,0;14,0;1,0;;;;1,0;4,0;;;;;;;;;;;;;;;;;;1,0;9,0;3,0;3,0;1,0;1,0;2,0;5,0;1,0;3,0;;;1,0;;1,0;5,0;;;1,0;2,0;;1,0;2,0;;;;;6,0;;;;;;;3,0;8,0;;;;4,0;;;1,0;;;3,0;1,0;;7,0;;4,0;;;;;17,0;;;3,0;4,0;1,0;;7,0;;;;;5,0;;;;1,0;;5,0;;;;8,0;1,0;1,0;;;8,0;;;44,0;;;1,0;18,0;;;;;;;;1,0;;2,0;;;;;10,0;3,0;;;;;;3,0;;1,0;;;;;2,0;;5,0;4,0;;1,0;1,0;;;;;1,0;;;5,0;;3,0;16,0;;;2,0;;;7,0;1,0;2,0;;33,0;;;;2,0;;;;;3,0;;1,0;11,0;;;;;;2,0;;;;;;;;2,0;;;;;;1,0;;;;3,0;;3,0;17,0;1,0;;;9,0;;;;2,0;;;;;;;;;1,0;;1,0;;;;;1,0;;;;31,0;;;;2,0;3,0;;;21,0;;1,0;3,0;;4,0;1,0;;;3,0;;4,0;1,0;3,0;;2,0;6,0;;;;1,0;;3,0;;19,0;;6,0;;;1,0;;;2,0;6,0;;1,0;;1,0;2,0;;;;;;;;;8,0;
selection;;;;9,0;2,0;3,0;5,0;33,0;40,0;14,0;9,0;;17,0;3,0;;103,0;;;;;;35,0;9,0;;2,0;;20,0;3,0;;;4,0;5,0;72,0;2,0;216,0;34,0;13,0;46,0;5,0;;45,0;;6,0;;38,0;3,0;43,0;172,0;26,0;98,0;4,0;11,0;8,0;4,0;18,0;9,0;44,0;;;;1,0;1,0;7,0;7,0;9,0;4,0;21,0;5,0;73,0;;12,0;3,0;14,0;;;7,0;12,0;;5,0;252,0;;38,0;1,0;81,0;1,0;32,0;7,0;;;2,0;18,0;8,0;3,0;;;6,0;5,0;;91,0;20,0;;;21,0;37,0;;18,0;5,0;7,0;103,0;9,0;;35,0;;1,0;;80,0;16,0;8,0;1,0;39,0;;;7,0;33,0;24,0;6,0;;;;17,0;;5,0;3,0;;1,0;1,0;2,0;79,0;4,0;1,0;9,0;;3,0;23,0;6,0;;;2,0;153,0;3,0;1,0;;15,0;18,0;11,0;20,0;58,0;;4,0;14,0;4,0;17,0;215,0;;;;38,0;15,0;2,0;12,0;4,0;;;10,0;5,0;13,0;;;;;;4,0;;;5,0;109,0;;11,0;;;1,0;5,0;;24,0;;;9,0;;;;;;3,0;23,0;;;;2,0;8,0;4,0;;;;9,0;;;;;;;2,0;1,0;;;;;3,0;;49,0;;11,0;;;;;;8,0;;;;3,0;2,0;;3,0;2,0;2,0;3,0;9,0;91,0;;;;;2,0;;9,0;194,0;;;;;;;285,0;3,0;;4,0;;18,0;;;43,0;;;;;33,0;1,0;;1,0;27,0;3,0;2,0;;;25,0;;10,0;;;7,0;5,0;;;;;1,0;;;;1,0;13,0;;;;;;43,0;;;;3,0;;;1,0;;;;;5,0;;;;;8,0;;1,0;;;1,0;;;;2,0;;5,0;;;11,0;;;;3,0;1,0;1,0;2,0;;;;;;;2,0;;;;;21,0;5,0;2,0;;;;;;;;;2,0;2,0;4,0;;;17,0;1,0;;;;;1,0;;;1,0;;;2,0;;;;6,0;;24,0;;1,0;;6,0;;7,0;;4,0;;;2,0;19,0;;;;;2,0;6,0;13,0;3,0;10,0;3,0;6,0;;1,0;1,0;;4,0;;17,0;10,0;12,0;1,0;;;13,0;;6,0;;129,0;1,0;;5,0;;8,0;;199,0;;6,0;7,0;1,0;;7,0;12,0;68,0;9,0;;7,0;3,0;;;6,0;3,0;9,0;5,0;1,0;;;12,0;9,0;;4,0;;;;2,0;10,0;9,0;;;;2,0;200,0;;6,0;;;;18,0;;;1,0;;1,0;;;;;6,0;;5,0;24,0;;7,0;;2,0;37,0;10,0;4,0;;3,0;23,0;;;;;24,0;1,0;;38,0;;4,0;9,0;;;;2,0;12,0;2,0;7,0;;3,0;;1,0;4,0;;53,0;5,0;;;18,0;6,0;11,0;;48,0;9,0;4,0;;;;;;3,0;;;12,0;2,0;;;;;1,0;26,0;3,0;;;;4,0;;13,0;4,0;;1,0;29,0;2,0;15,0;1,0;;1,0;1,0;3,0;;;22,0;;;2,0;4,0;;;;1,0;7,0;2,0;;26,0;;1,0;2,0;2,0;;;;;;10,0;9,0;1,0;6,0;3,0;13,0;5,0;;1,0;1,0;;;44,0;2,0;12,0;1,0;11,0;;;;10,0;;1,0;11,0;1,0;;2,0;1,0;;28,0;2,0;;1,0;16,0;;1,0;16,0;;13,0;8,0;;;;1,0;;11,0;;6,0;8,0;;;3,0;5,0;;34,0;;;;;4,0;4,0;;;1,0;7,0;;;17,0;;;;;;50,0;;;;;;;;;;;;1,0;;;7,0;2,0;1,0;6,0;;;2,0;;;1,0;;;2,0;2,0;;;;2,0;3,0;;;2,0;1,0;;;;;;;;;;;;;;2,0;;;5,0;;2,0;1,0;;;1,0;;;9,0;;5,0;;;;;6,0;;;;;;;;;;;1,0;;;;1,0;;;2,0;;;9,0;13,0;;6,0;38,0;2,0;4,0;;6,0;4,0;;5,0;;2,0;1,0;;;4,0;;11,0;48,0;;;;5,0;7,0;2,0;;10,0;1,0;1,0;79,0;;;1,0;;;2,0;5,0;1,0;;;2,0;4,0;2,0;1,0;;4,0;1,0;1,0;1,0;;2,0;;;;1,0;1,0;;1,0;;2,0;5,0;;;;;;;1,0;4,0;;;6,0;;;;;33,0;;3,0;1,0;;9,0;;;5,0;;;35,0;8,0;5,0;;;;1,0;1,0;3,0;;16,0;;;;;9,0;6,0;;;;;;1,0;;;;8,0;;;;;;2,0;1,0;1,0;;;;1,0;;;4,0;4,0;;;;;3,0;;3,0;;;;;;;;;;;;;;;;1,0;;;;;;;;;;5,0;;;;;4,0;;2,0;;6,0;;;;;;2,0;;;;;;4,0;;;;;1,0;;;;;;;;;;;4,0;9,0;2,0;;;8,0;;;;4,0;;;;2,0;;4,0;;1,0;1,0;;;;;;;4,0;;;;;;;;;;;8,0;
semiconductor;;;;1,0;;2,0;;37,0;29,0;97,0;23,0;;2,0;;;5,0;;;;;;;;6,0;;;14,0;;;;;;4,0;;10,0;;;;;;3,0;;4,0;3,0;1,0;3,0;;165,0;4,0;;42,0;13,0;;4,0;;;86,0;;;;25,0;1,0;;;14,0;;3,0;228,0;9,0;5,0;8,0;;10,0;;;1,0;;;15,0;128,0;1,0;112,0;;130,0;2,0;;;;;;6,0;;;77,0;;;5,0;;63,0;;;;109,0;;1,0;;18,0;;2,0;;2,0;1,0;2,0;1,0;6,0;77,0;69,0;32,0;;2,0;;;;24,0;2,0;;;;;;;;4,0;9,0;2,0;;4,0;3,0;3,0;;2,0;;;107,0;;;;78,0;44,0;1,0;;17,0;6,0;6,0;;7,0;14,0;;2,0;20,0;;1,0;52,0;;2,0;;1,0;9,0;;1,0;;5,0;6,0;1,0;;4,0;3,0;;6,0;;3,0;;15,0;3,0;26,0;41,0;2,0;1,0;5,0;3,0;;;1,0;42,0;7,0;52,0;;;;29,0;;;5,0;17,0;;;;;;73,0;47,0;;;21,0;3,0;;2,0;10,0;2,0;12,0;1,0;3,0;;;30,0;2,0;333,0;;78,0;43,0;45,0;38,0;;10,0;;;;27,0;12,0;7,0;12,0;;10,0;1,0;;43,0;71,0;;77,0;;4,0;;;;;5,0;4,0;;;;;2,0;;;;;4,0;3,0;;9,0;;14,0;6,0;;;;;5,0;501,0;231,0;;;7,0;15,0;18,0;;;;;12,0;;3,0;;56,0;4,0;;;;50,0;;;1,0;1,0;;2,0;;4,0;2,0;8,0;5,0;;;118,0;4,0;2,0;;;1,0;;8,0;;1,0;3,0;;;;;;;3,0;;;;;;;;;;;10,0;;2,0;5,0;;;;;3,0;7,0;12,0;1,0;;9,0;;;;;;;;;8,0;1,0;;;;;5,0;;3,0;;;;;;;;;;;;;;;;7,0;;;29,0;21,0;;;5,0;;;;2,0;;;;;;;;;;;;;2,0;;;;;8,0;1,0;2,0;;;;;;;;;;;;;;2,0;16,0;;;;;;;;;;;;;;;;;;;;;;;;;;;;19,0;;;;;;;;;1,0;;;3,0;;;;;;19,0;4,0;;;;;;2,0;;;;2,0;3,0;;;;1,0;;;;;;;;;;;;;;26,0;;;;;;;;;;;;;;;3,0;;;;;;4,0;;;;8,0;2,0;;;1,0;;;;;;5,0;;1,0;;;;3,0;;;;;;;;;;;;4,0;1,0;3,0;;;;1,0;;;1,0;;3,0;;3,0;;;;;;;;;;1,0;;;;;;;;;3,0;;;1,0;;;;28,0;;5,0;;;;;1,0;;;;;;9,0;;;;;;;3,0;;;;;;626,0;;5,0;;9,0;;;4,0;;;;;;;;;;;;1,0;;;;;6,0;;1,0;1,0;;;;3,0;;;;;;3,0;47,0;1,0;;;;;;1,0;4,0;;;;;;;;;;;;;;;3,0;;;;;;;;;;5,0;;;;;;;;;;;;;;;;12,0;;;10,0;;;;4,0;25,0;;;;;81,0;31,0;;;;;;;;;;9,0;;;;57,0;;;;;;;39,0;;;;;;2,0;;;;178,0;28,0;7,0;;7,0;;1,0;;;;119,0;;6,0;58,0;;;4,0;;;;2,0;;;5,0;2,0;;6,0;;;;1,0;4,0;;;35,0;;;2,0;37,0;;;;;;;;2,0;;;;;2,0;;1,0;;;;;;3,0;;;;;;;;;;;;;;4,0;;;;;;;;;;;1,0;;;;;;;2,0;;;;;;;;;;;;;9,0;;;;;;;;;;;;;;;;;;;2,0;;1,0;;;;1,0;;;;;;6,0;;;;;;;4,0;;;;;;;;;;;;;2,0;6,0;;;;2,0;;;;;;;;;3,0;;;;;1,0;;;;;;;3,0;;;;;;;;9,0;;7,0;;;;1,0;;;;;;11,0;;;1,0;;;;;;;;;;;;;;;;;;;;7,0;;;;;;;;;;;;;;;;;
sharpness;;;;2,0;7,0;;;2,0;;2,0;1,0;;5,0;1,0;;16,0;;;;;;7,0;;;;;;;;;;;8,0;2,0;3,0;;3,0;;;2,0;4,0;8,0;5,0;;7,0;2,0;32,0;;18,0;1,0;;2,0;;;;36,0;;;4,0;;;;1,0;1,0;20,0;2,0;42,0;4,0;4,0;;11,0;;11,0;;;;;;;91,0;;2,0;;9,0;6,0;;;;1,0;2,0;16,0;;;;1,0;1,0;;1,0;22,0;;;;2,0;1,0;;;2,0;;;3,0;1,0;2,0;3,0;;;11,0;11,0;20,0;;2,0;;;;;4,0;;;;;5,0;;6,0;;;2,0;;10,0;;;;4,0;2,0;;;;;;;;;;;;1,0;1,0;;5,0;;7,0;14,0;1,0;;3,0;;1,0;;;3,0;;;;;;1,0;;;;;;;;;;;;;;1,0;;;1,0;;;;;;3,0;;;;;;12,0;;20,0;;;;1,0;1,0;;;;;;;;;;;;;;;;;;;13,0;;;;;;;;;;;;;;;;;;;;;;;;;;;;2,0;;;;;;;5,0;;;;;;;;;;;;;;;;;;;;;;4,0;;;;;;;;;;;;;;;1,0;;;;;;;;;;;;;;;;;;;;;;;;;;;;;;;;;;;4,0;;;;;;;;;;;;3,0;;6,0;;;;;;;;;;3,0;;;;;;;;;;;;;;1,0;;;;;;;;;;;;;;;;;;;;;;;;;8,0;;;;;;;;;;;10,0;6,0;;3,0;4,0;11,0;;;;;;;;;1,0;;1,0;2,0;8,0;;;;4,0;4,0;2,0;1,0;;6,0;3,0;;3,0;;;;;;;1,0;;;;;;;;2,0;;;;;;;;;;;;;;;;;;;;1,0;;;;;;1,0;;;2,0;;;;1,0;;;;;;;15,0;;;;1,0;;;;;;;;;;;;;;;;;;;;;;;;;;;6,0;;;;;;1,0;;;;;4,0;1,0;;;;;;1,0;;;1,0;;;;;;;;;;;;;;;;;6,0;;;;;;;;;2,0;;;;;;;;13,0;;;;;;;;;;;;;;;;;;;;;;;1,0;;;;;;;;;;;;;;;;;;;;;;;26,0;;;;;;;;;;;;;;;;;;;;;;;;;;;;;;;;;;;;;;;;;;;;1,0;;;3,0;;;;;;;;;;;;;;;;;;;;;;;;;;;;;;;;;1,0;;;;;;;;;;;;;;;;;;;;;;;;;;;;;;;;;;3,0;;;;;;;;;;;;;;;;;;;;;;;;;;10,0;;;;;;;1,0;;;;;;10,0;;;;;7,0;;;;;;;;;1,0;;;;;;10,0;25,0;1,0;;;;;;;;;;2,0;;7,0;;;4,0;;;;2,0;;11,0;;;;;;;1,0;;;;;;;;;;;;;;;;;;;;;;;;;;;;;3,0;;1,0;;;;;6,0;;;;;;;;;;;;;;;;;4,0;;;;;4,0;;;;3,0;;;;;;;;;8,0;;;1,0;1,0;;;;;;;;;;;2,0;;;;;;;;;;;;;;;;;;;;;;;;;;;;;;;;;;1,0;;;;;;;;2,0;;;;;;;;;;;;;;;2,0;;;;;;;1,0;;;;;;;;;;;;;;;;;;;;
signature;;;;6,0;3,0;;;3,0;8,0;;;;28,0;;;15,0;;;;;;9,0;;;;;;;50,0;;2,0;;;;3,0;;;;1,0;;8,0;;;;11,0;;25,0;2,0;3,0;;;;;;;;;;;;;1,0;6,0;;;;;;2,0;;;;6,0;;;1,0;3,0;;;38,0;;;;8,0;;;;;;;;;;;;;3,0;5,0;32,0;;;;4,0;111,0;;;;6,0;;1,0;18,0;1,0;;;;2,0;1,0;;;2,0;;;1,0;1,0;1,0;5,0;;;1,0;;;1,0;;;21,0;;1,0;;;;1,0;;1,0;;;;;;1,0;;;;;33,0;;;7,0;;;1,0;2,0;2,0;;;;;9,0;13,0;;;;;;;;;;;;;;2,0;;;;;;1,0;;;;;;;;;;;;;;;;;;;;;;;;;;;;;;;;;;;;;;;;;;;;;;;;;2,0;;;;;;;;;;;;2,0;;;;;;;;2,0;;;;;;;;;;;;;;;;2,0;;;;;;;;;;;;;1,0;;;2,0;;;;;;;2,0;;;;;;;;;;;;;;;;;;;;1,0;;;;;;;;;;;;;;;;;;;;;;;;;;;;;;;;;;;;;;;;;;;;;;;;;;;;;;;;;;3,0;;;;;;;;;;;;;;;;;;;;;;;;;;;;;;;;;;;;;;4,0;20,0;;4,0;;;;;;;;;;;;;15,0;;1,0;;1,0;1,0;;;;41,0;1,0;27,0;;;;;;;;;;;;;;;;;;2,0;;;4,0;;;;;;;;;;6,0;;;;1,0;6,0;;;;;;;;1,0;;;;;14,0;;;;1,0;;;;;;;;;1,0;;;;;;;;;;2,0;;;;1,0;;;;;;;;;;;5,0;;;;;12,0;5,0;;;;;4,0;;;;;;;;;12,0;;6,0;;3,0;1,0;;1,0;;;;;;;;;;;3,0;;3,0;;;;;;7,0;;;;;;;;;;;;;;;;;;;;;;;;;;;3,0;;;;;;;1,0;;;;;;;;;;;;;;;;2,0;;;;;;;;;;;1,0;;8,0;;;;;;;;;;;;;;;;;;;;;;;;;;;;;;;;;;;;;;;;;;;;;;;;;;;;;;;;;;;;2,0;;;;;;;;;;;;;;;;;;;;;;;;;;;;;;;;;;;;;;1,0;;;;;;;;;;;;;;;;;;;;;;;;;;;;;;;;2,0;;;;;;;;;;;;;;;3,0;;;;;;;;;;;;;;;;;;;;;2,0;;;;;;;;;;;;;;;;;;;3,0;;;;;;;;;;;;;;;;;;;;;;;;;;;;;;;;;;;;;;;;;;;;;;;;;;;;;;;;;;;;;;;;;;;;;;;;1,0;;;;;;;;;;;;;;;;;;;;;;;;;;;;;;;;;;;;1,0;;;;;;;1,0;;;;;;;;;;;;;;;;;;;;;;;;;;;;;4,0;;;;;;;;;;;;;;;;;;;;;;;;;;;;;;;;;;;;
slave;;;;4,0;;;;2,0;;;;;;;;;;;;;;5,0;;5,0;;;1,0;;;;;;7,0;;3,0;;1,0;;;;4,0;;;;;;5,0;3,0;;1,0;;;;;4,0;;;;;;;1,0;;;;;;;2,0;;3,0;4,0;4,0;;;;;;;10,0;;1,0;;3,0;;;;;;;;;;;;1,0;;;;;1,0;;2,0;;;;1,0;;;;;2,0;;;;;;;;;;;;2,0;;;;;;;;2,0;;;;;;1,0;;;;;;3,0;;;;;5,0;;;;1,0;1,0;;;6,0;;;;;1,0;;;;;;;;;;;;;;2,0;;;;;;1,0;;;;;;2,0;;;;;;2,0;;;;;;;;;;;;;;;;;;;;;;;;;;;;;;;;;;;;;;;;4,0;;;;;1,0;;;;;;;;;;;;;;1,0;;;;2,0;;;;;;;;;;;;;;;;;;;;;3,0;;1,0;;1,0;;;;;;;;;;;;;;;;;;;;;5,0;;;;;9,0;;;;;;;;;;;;;12,0;;;;;1,0;;;;;;;;;;;;;;;;;;;;;;;;;;;;;;;;;;;;;;;;;;;;;;;;2,0;;;;;;;;;;;;;;;;3,0;;;;;;1,0;;;;;;;;;;;;;;;;;;;;;;;;;;;;;;;;;;;;1,0;2,0;;;;;;;;;3,0;;;8,0;;;;3,0;;;;;;;;;;;;;;;;;;;;;;;;;;;;;;;;2,0;;;;;;;;;;;;;;;;;;1,0;;1,0;;;;;;;;;;;;;;;;;;;;;2,0;;;;;;;;1,0;2,0;;1,0;;;;;;;;;9,0;;;;;;;;;;;1,0;;;;;;;;;;;;;;;;;;;;;;;;;2,0;;;;;;;5,0;1,0;;;1,0;;;;;;;;;;;;;;;;;;;;;;;;;;;;;;;;;1,0;;;;;;;;;;;;1,0;;;;;;;;;;;;;;1,0;;;;;;;;;;;;;;;;;;;;;;;;;;;;;;;;;;;;;;;;;;;;;;;;;;;;;;;;;;;2,0;;;;;;;;;;;;;;;;;3,0;;;;;;;;;;;;;;;;;;;;1,0;;;;;;;;;;;;;;;;;;;;;;;;;;;;;;;;;;;;;;;;;;;;;;;;;;;;;;;2,0;;;5,0;;;;;;;;;;;;;;;;;;;;;;;;;;;;;;;;;;;;;;;;;;;;;;;;;;;;;;;;;1,0;;5,0;;;;;;;;;;;;;4,0;;;;;33,0;2,0;;;;;;;;;;;;;;;;;;;;;;;;;;;;4,0;;;;;;;;;;;;;;;;;;;;;;;;;;;;6,0;;;;;;;;;1,0;;;;1,0;;;;;;;;;;;;;;;;1,0;;;1,0;;;;;1,0;;;;;;;;;;;;;;;;;;;;;;;;;;;
stabilization;;;;1,0;;1,0;;10,0;1,0;1,0;;;;;6,0;7,0;;;;1,0;2,0;9,0;;;;;;;;2,0;;;13,0;;11,0;7,0;2,0;1,0;1,0;;7,0;2,0;;;3,0;;6,0;12,0;11,0;3,0;;;;;;;6,0;1,0;;;;;;;6,0;2,0;;1,0;17,0;1,0;12,0;;1,0;;;;;;;190,0;;4,0;;16,0;5,0;;;;;4,0;12,0;;;;;2,0;;;42,0;1,0;;1,0;47,0;1,0;;;44,0;;;25,0;;27,0;;;;6,0;1,0;20,0;3,0;1,0;;;1,0;9,0;7,0;1,0;;;;;;;;;;1,0;;1,0;1,0;;;;;10,0;7,0;;;1,0;10,0;;;1,0;2,0;;2,0;3,0;50,0;1,0;2,0;;1,0;;5,0;;;;63,0;2,0;;;6,0;;;;5,0;;;;;;1,0;2,0;;;;1,0;;3,0;;;;2,0;;9,0;;1,0;;;;;;;4,0;7,0;;;;;2,0;;1,0;;;;;;;;1,0;1,0;;2,0;;;;;;;2,0;;;;;4,0;2,0;1,0;7,0;;;;;;;1,0;;;;;;1,0;2,0;;;;;;3,0;;;;;;;4,0;;1,0;;;;;;;;;;2,0;;3,0;;2,0;;;;;;1,0;;;;;2,0;1,0;8,0;;;;;;;;4,0;3,0;9,0;;;;;1,0;;;;2,0;3,0;;;1,0;;4,0;;1,0;;;;;2,0;;;;2,0;;;;;;;;;;;;;;;1,0;1,0;;;2,0;;;;;;;3,0;;22,0;;;;;;;;;;;;;;;;;;;;1,0;1,0;;;;;;;;1,0;;;;11,0;;;;;;;;;;;;;;;;;;;;;2,0;;4,0;;;;;;;;;;;;;;;1,0;;;;4,0;5,0;;;1,0;;7,0;4,0;;8,0;11,0;1,0;;;;12,0;;;;5,0;;;;1,0;;;;1,0;;;;;;9,0;2,0;;;11,0;;;;;;3,0;;;;;;4,0;;;;;;;;;;;;;2,0;5,0;;;;;;14,0;;;1,0;;;;;;;;;;;;;;;;;;1,0;;3,0;;;;;;;;9,0;;;;;;;;;;3,0;;;;;;;;;;2,0;;;;;;;1,0;;;;;;;;;1,0;;3,0;;;;;;3,0;;;;;;;2,0;;;;;;1,0;;;;;;;;;;;;1,0;;;;;;;;;;;;;;;;;;;;;1,0;;;;;;;;2,0;;;;;;;;;;;;;;;;1,0;;;;1,0;;;;;;2,0;2,0;;1,0;;;;;1,0;;1,0;;;;;1,0;;;;1,0;;;;1,0;2,0;;;;;;1,0;;;;;1,0;;;;;;;;;;;;;;;;1,0;;;;;;;;;;;;;;;;;;;;;;;;;;;;;;;;;;;;;;;;;;;;;;;;;2,0;;2,0;;;;;;;;2,0;;;;;;;;1,0;;;;;;;;;;;;;;;;4,0;;;;5,0;;;;;;2,0;;;;;;;;1,0;;;3,0;;;;;;1,0;;;;1,0;;;4,0;2,0;;;;;;;;;;;;;;;;;;;;;;;;;;;;;4,0;1,0;;;;1,0;;1,0;;;;;;;;;;;;;;;;;;;;;;3,0;;;;;;;;;;;;;;;;;;;;3,0;;;;;;;;;;;;;;1,0;;;;;;;;;;;;;;;;;;;1,0;;;;;;;;;;3,0;;;;;;;;;;;;1,0;;;;;;;;;;;;;;;;;;;;;;;;;;;;;;;;;;;;4,0;;;;;;
station;;;;3,0;;;;9,0;1,0;2,0;;;1,0;;;58,0;;;;;;4,0;2,0;7,0;;;2,0;;;;;;50,0;1,0;26,0;3,0;;;;;5,0;;;;;;7,0;32,0;5,0;7,0;;3,0;;;;;;;;;1,0;3,0;1,0;;;;5,0;;1,0;;;;4,0;;;;;;;17,0;;1,0;;24,0;;2,0;;;;2,0;3,0;;;;;;2,0;;11,0;1,0;;;22,0;2,0;;;1,0;1,0;6,0;;;1,0;;2,0;;3,0;1,0;2,0;3,0;4,0;;;4,0;2,0;4,0;;;;;;;1,0;2,0;1,0;;3,0;;5,0;;;;;4,0;3,0;;;;1,0;13,0;;;;1,0;6,0;;;22,0;;;4,0;;14,0;2,0;;;;21,0;2,0;;;;;;;;;1,0;1,0;;;;1,0;;;;4,0;;;;;;;;12,0;;1,0;;;;;;;;4,0;;;;;;2,0;;;1,0;;;;;;2,0;6,0;;;;;1,0;;;;;;;;;2,0;4,0;2,0;1,0;;;;;;;;;;;;;;;;;;;;23,0;;;;;;1,0;1,0;;;;;;;;2,0;2,0;;;2,0;;;;3,0;1,0;;;;;2,0;10,0;;3,0;;8,0;;;;3,0;;;;;;;1,0;1,0;;;;;1,0;;;4,0;;;;;;;1,0;;2,0;;;;;;;;;;;;;;;;;;;;;;;;3,0;;7,0;;;;;;;;;;;4,0;5,0;;;1,0;;;;;;;;;;;;;1,0;;;;;1,0;1,0;;;1,0;;;;;;;;;2,0;13,0;;;1,0;;;;;;;5,0;;;;;;;;;3,0;;;;;;;;2,0;;;;2,0;;;;;;;;3,0;;;4,0;;;8,0;2,0;1,0;16,0;;1,0;;8,0;43,0;1,0;;;;;;;;;5,0;27,0;;;;;;2,0;;;;5,0;;1,0;;4,0;;2,0;;1,0;;;;;;;1,0;;5,0;2,0;;;;;;;1,0;;3,0;;;2,0;;;;;8,0;1,0;;1,0;;;;;;;;1,0;8,0;;;;;;;;;;;;;1,0;;;1,0;2,0;;;2,0;;;1,0;;;4,0;;;;;;3,0;;10,0;;;;;1,0;;;;;5,0;;;;;1,0;;;4,0;;18,0;;;;;3,0;;;;;;;;;;;;;;;;;;;;;;;;;;;1,0;1,0;;;4,0;;1,0;;;;;;;;;;;;;;;;;1,0;;;;1,0;;;;;;;1,0;5,0;14,0;1,0;;;;;;;;;;;;;;;72,0;;;1,0;;;;;;;;;;;;;;;;;;;;;5,0;;;;;;;2,0;;;;;;;;;;;;;;;;;;;;;;;;;;;;;;;;;;2,0;;;;;;;;;;;;;;;;3,0;;;;;;;;;;;1,0;;;;;;1,0;2,0;;;;;6,0;;;;;;;;;;;;1,0;;;;;;;;;;;;;;;;;;;;;;;;;;;;;;;;;;;;;;;;;;;;;;1,0;;;;;;;;;;;;;;;;;;;;;;;;;;;;;;;;;1,0;;;;;;;;;;;;1,0;;1,0;;;;;;;;;;;;;;;;;;;1,0;;;;3,0;1,0;;;;10,0;;;;;;;;;;3,0;1,0;;;;;;;;;;;;;;;;;1,0;;;;6,0;;;;;1,0;;;;;;;;;;;;;;;;;;;1,0;;;;;;;;;;;;;;;;;;;;;;;;;;;;;;;;;;;;;;;;;;;;;;;;;;;;;;;
temperature;;;;1,0;;;;34,0;43,0;8,0;26,0;;17,0;;;53,0;2,0;;;1,0;10,0;25,0;10,0;;6,0;11,0;412,0;1,0;;4,0;1,0;5,0;23,0;;27,0;29,0;12,0;7,0;3,0;;180,0;6,0;17,0;5,0;65,0;12,0;95,0;17,0;10,0;39,0;;2,0;;1,0;;;17,0;2,0;17,0;;;3,0;3,0;;3,0;;2,0;8,0;5,0;;4,0;;13,0;;6,0;2,0;;8,0;6,0;129,0;2,0;27,0;;36,0;10,0;1,0;;;;;29,0;;;3,0;19,0;;3,0;;80,0;;;;15,0;64,0;;1,0;3,0;10,0;9,0;54,0;;25,0;;;;15,0;4,0;14,0;5,0;62,0;1,0;3,0;1,0;14,0;6,0;4,0;3,0;3,0;13,0;58,0;;41,0;6,0;4,0;17,0;1,0;1,0;4,0;;;22,0;1,0;1,0;64,0;37,0;5,0;;;17,0;9,0;1,0;1,0;4,0;18,0;23,0;3,0;18,0;;;;2,0;1,0;103,0;;6,0;1,0;17,0;12,0;;;;;2,0;;7,0;3,0;10,0;7,0;;;;;4,0;;1,0;1,0;;;;;;3,0;;1,0;;;;;;1,0;;;52,0;8,0;2,0;;;2,0;19,0;;1,0;;4,0;10,0;2,0;;;15,0;;;2,0;5,0;;;;2,0;4,0;;188,0;;2,0;3,0;;3,0;;4,0;;;3,0;;1,0;;1,0;4,0;;;;3,0;5,0;;;;;;4,0;;15,0;4,0;;;;;;32,0;;;2,0;6,0;3,0;;;74,0;;1,0;14,0;;;4,0;12,0;17,0;;;;;;53,0;5,0;;;;4,0;;3,0;;;;1,0;;3,0;;17,0;2,0;;;;;7,0;;;1,0;;4,0;;;2,0;1,0;;;;;;;;;10,0;;3,0;;;;;;;;;;;1,0;;;;;1,0;;4,0;2,0;;;;3,0;;;9,0;1,0;;;;49,0;;;12,0;;;;;;;;;;5,0;;;;;;;;;;;;;;;3,0;;;;4,0;4,0;19,0;2,0;;;;;;1,0;50,0;;;;3,0;;;;;22,0;20,0;79,0;1,0;4,0;;;2,0;;2,0;11,0;15,0;;2,0;39,0;;1,0;;9,0;;5,0;15,0;;8,0;29,0;;5,0;4,0;19,0;11,0;13,0;2,0;17,0;3,0;;;;31,0;17,0;;;6,0;7,0;;;1,0;34,0;2,0;;;;;18,0;;;3,0;;1,0;;;33,0;;;;;8,0;3,0;;;;6,0;3,0;29,0;;;8,0;2,0;;;;;;;22,0;1,0;;1,0;;;;;;2,0;;;;1,0;;;;7,0;;9,0;;11,0;;;;;;22,0;;;;;19,0;;;;;;;;2,0;;;3,0;;4,0;;;16,0;;;6,0;15,0;;6,0;3,0;;;;;;53,0;;6,0;5,0;;3,0;;;;2,0;23,0;21,0;;;;1,0;;;6,0;;;;;;;;5,0;;;2,0;;;9,0;2,0;;;;;;;;4,0;;;;;;5,0;;;;;;26,0;;;;;;;;;;;;;;1,0;;3,0;;;2,0;;16,0;29,0;;;;;;1,0;;;;;;3,0;;;;;;2,0;;;;;;;;;1,0;;1,0;;;;;;6,0;1,0;3,0;;;45,0;;;;;81,0;;;;;;;;;;;;;;;;;2,0;;;;;1,0;;;;;;;;;;;;;14,0;;;;;;4,0;;;;;;;;;;;;;;;;;13,0;;;;14,0;;;;;;8,0;;3,0;9,0;;3,0;;;;;;;;;;;;;;;;;;;;;;;;;;;;5,0;;;;7,0;;14,0;;;;;;;;;6,0;2,0;;;;;;;;;;4,0;21,0;13,0;;3,0;;;;;1,0;;;1,0;;;;;2,0;;;;;;8,0;4,0;;6,0;;;;;;13,0;;;;;;;;;;;1,0;;;;;;;;12,0;;;;;;;;;;;;;;;4,0;;;;;;82,0;11,0;;;;;;;;;;;;;;;;;10,0;;2,0;;;3,0;;;;;;;3,0;5,0;;;;;;;;;;;;1,0;;;;;2,0;;;;;;;;;;;9,0;;;;;;;;;3,0;;;;;;;;;;;;;;;;;;3,0;;;;;;;8,0;;;;;;;3,0;4,0;1,0;;;;;;8,0;2,0;;;;;;;8,0;;;;;;;;;;;;
threshold;;;;3,0;4,0;34,0;2,0;59,0;50,0;;5,0;;10,0;;5,0;92,0;1,0;1,0;94,0;4,0;2,0;49,0;13,0;12,0;7,0;3,0;32,0;19,0;;;6,0;22,0;42,0;24,0;63,0;26,0;3,0;15,0;2,0;;81,0;10,0;25,0;27,0;59,0;26,0;227,0;66,0;27,0;27,0;1,0;152,0;;6,0;5,0;21,0;7,0;21,0;9,0;;1,0;;15,0;;25,0;12,0;32,0;15,0;83,0;1,0;31,0;;72,0;;;9,0;18,0;1,0;10,0;346,0;;29,0;;38,0;22,0;12,0;;4,0;;17,0;22,0;2,0;4,0;;6,0;5,0;2,0;;217,0;4,0;25,0;;40,0;65,0;;8,0;;3,0;47,0;82,0;21,0;28,0;1,0;;;48,0;12,0;50,0;8,0;412,0;;;19,0;54,0;35,0;9,0;1,0;4,0;1,0;25,0;;17,0;16,0;2,0;7,0;;18,0;16,0;6,0;26,0;9,0;5,0;2,0;15,0;41,0;;;;96,0;56,0;1,0;;9,0;23,0;11,0;;102,0;;28,0;5,0;15,0;;135,0;15,0;11,0;;30,0;34,0;7,0;;2,0;;;5,0;77,0;15,0;;;;2,0;2,0;2,0;;;12,0;15,0;;19,0;;;4,0;10,0;;9,0;;;13,0;3,0;8,0;;;;187,0;13,0;55,0;;;9,0;28,0;22,0;;;4,0;4,0;;6,0;;1,0;;;2,0;;1,0;;;;;;47,0;;;;2,0;1,0;;9,0;22,0;;;;15,0;;1,0;;;;;;128,0;5,0;;;;;7,0;1,0;27,0;2,0;;;;;;73,0;;15,0;;;1,0;;;8,0;2,0;;1,0;;4,0;;;2,0;47,0;;4,0;;3,0;73,0;1,0;;;;35,0;6,0;1,0;;;;16,0;;;;2,0;;;;;;;14,0;8,0;3,0;14,0;12,0;;;7,0;6,0;;;;6,0;;;;;4,0;;;;2,0;1,0;2,0;;;5,0;;21,0;4,0;;1,0;;;;;51,0;20,0;;18,0;7,0;;1,0;2,0;;4,0;1,0;;;;26,0;1,0;;;3,0;;;;;;;;6,0;6,0;1,0;;10,0;;;;;;;;;8,0;;;;;;;3,0;5,0;14,0;3,0;;;12,0;;12,0;7,0;;4,0;7,0;;;;;3,0;10,0;3,0;62,0;38,0;20,0;85,0;1,0;10,0;7,0;;1,0;2,0;2,0;5,0;1,0;15,0;69,0;;10,0;247,0;62,0;9,0;2,0;;33,0;123,0;1,0;25,0;6,0;7,0;17,0;30,0;15,0;2,0;163,0;15,0;16,0;6,0;1,0;7,0;1,0;5,0;20,0;13,0;3,0;;35,0;5,0;11,0;1,0;;;2,0;3,0;;;8,0;;;9,0;1,0;;13,0;1,0;2,0;5,0;38,0;11,0;2,0;39,0;32,0;43,0;;54,0;3,0;2,0;10,0;8,0;26,0;;3,0;;12,0;;;32,0;7,0;38,0;2,0;;3,0;11,0;3,0;;;1,0;1,0;9,0;;;;;7,0;;3,0;;11,0;;2,0;10,0;;;;;1,0;1,0;29,0;7,0;2,0;5,0;;1,0;;;51,0;;1,0;6,0;;34,0;10,0;4,0;2,0;;;1,0;26,0;;11,0;11,0;1,0;;10,0;;;14,0;4,0;;4,0;;2,0;;1,0;;1,0;3,0;11,0;;;;1,0;;;6,0;1,0;;;;5,0;;;1,0;;5,0;;3,0;;37,0;6,0;;;;;;;;1,0;;;;;;;7,0;;3,0;4,0;;2,0;1,0;;;;;;;;11,0;2,0;;3,0;;4,0;;;;21,0;5,0;;73,0;2,0;;2,0;7,0;;;4,0;1,0;;;;;1,0;11,0;;2,0;;;1,0;2,0;;8,0;;;1,0;;;;;20,0;5,0;;;;;2,0;;11,0;;;14,0;;5,0;2,0;;;;1,0;;;;;;;6,0;1,0;;;;1,0;2,0;;;;;2,0;;3,0;;;1,0;;;;;;2,0;;;1,0;1,0;4,0;;;;3,0;32,0;;;;;;;;;;;5,0;;7,0;;2,0;;3,0;;;2,0;2,0;4,0;;;;;;;;1,0;;;1,0;;;1,0;;;;;;5,0;4,0;;;17,0;13,0;3,0;1,0;12,0;24,0;7,0;14,0;;;;;;24,0;7,0;;2,0;11,0;;2,0;53,0;26,0;;;;24,0;15,0;5,0;47,0;7,0;4,0;;;7,0;19,0;;;;1,0;9,0;19,0;34,0;19,0;;25,0;;8,0;;;53,0;6,0;2,0;38,0;;23,0;;5,0;;;;20,0;;;20,0;4,0;12,0;1,0;;;;;;83,0;;1,0;3,0;;1,0;;;;;;;1,0;1,0;2,0;;;;4,0;7,0;;4,0;1,0;;;;;6,0;;;1,0;;5,0;;6,0;1,0;;;;;12,0;;13,0;;;;;;;;;20,0;;4,0;;;2,0;;;11,0;1,0;;1,0;;2,0;;;33,0;2,0;;;1,0;14,0;30,0;;;;2,0;;;;;;;;3,0;2,0;;2,0;3,0;;1,0;3,0;;5,0;;14,0;6,0;;4,0;1,0;;;;;15,0;;;;;;;;;;;;2,0;;;2,0;1,0;;;;;1,0;;;;1,0;;;12,0;;9,0;;;;;1,0;7,0;1,0;;4,0;2,0;;;17,0;;6,0;;;;1,0;;4,0;;;1,0;1,0;;;;;;;;1,0
timer;;;;1,0;5,0;;;1,0;;1,0;;;2,0;;;4,0;;;;1,0;;26,0;;;;;;;;;1,0;;9,0;;5,0;5,0;;;;;6,0;;;;25,0;11,0;4,0;22,0;13,0;3,0;1,0;;;;;;;;;;2,0;;3,0;;;;4,0;1,0;1,0;;13,0;;1,0;;;;;;1,0;35,0;;1,0;;39,0;;12,0;;1,0;;1,0;9,0;;;;;;1,0;;23,0;1,0;;;9,0;;;5,0;2,0;;9,0;;;6,0;;;;;;6,0;1,0;12,0;1,0;;6,0;9,0;1,0;;;;;;;;;;10,0;;;35,0;;;2,0;;;13,0;20,0;;;;13,0;;;;1,0;3,0;4,0;;19,0;;;;1,0;9,0;12,0;;;;1,0;3,0;;;;;;;;;;;;;;2,0;;;;7,0;;2,0;;;;;;7,0;;;;;;;;;;;;;;;1,0;;;;;;;;;;;;;;;;;;;;17,0;;;;;;;;;;;;;;;;;;;;;;;;;1,0;;3,0;5,0;1,0;;;;;;;;;;;;;;;;;;;22,0;;;4,0;4,0;2,0;;;;49,0;;;;;;;4,0;;;;;;;;;;;;;;;;;;;;;;;;;2,0;;;;;;;1,0;;3,0;;;2,0;;;;;;;;;;;;;;1,0;;;;;;;1,0;;11,0;;;;;6,0;;;;;;;;;;;;;;;;;;;;;;;;;;;;;;;;2,0;;6,0;;;;1,0;;;;;;2,0;;;;;;;;2,0;;;1,0;;;;;;;1,0;;;1,0;;;;4,0;;;;;4,0;;;5,0;1,0;;7,0;15,0;;4,0;4,0;;;1,0;6,0;7,0;;3,0;13,0;1,0;;;;;;1,0;;;;;;;;;;6,0;;2,0;3,0;;;6,0;;7,0;;;;;;2,0;;;;;5,0;;;;;;;2,0;6,0;;;;2,0;;;3,0;;1,0;2,0;;;;;;;;1,0;;6,0;;;;;;;;;1,0;;;;;;;;;;;;;;2,0;;1,0;6,0;;;;;;;;;;;3,0;;2,0;1,0;;;;;;;;;;;;;;3,0;;;;;;;;2,0;;;;3,0;;;;;1,0;;;2,0;;;;;;;;;;;;;2,0;;1,0;;;;;;;;1,0;;;;;;;;;;;;;1,0;;;;;;;25,0;;;1,0;;;;;;;;;2,0;2,0;;;;;;;;;;;;;;;;;;1,0;;;;;;1,0;;;;;;;;3,0;;;;;;;;;;;1,0;;;;;;;;;;;;;;;;;;;;;;;;;;;;;;;;;;1,0;;;;;;;;;;;;;;2,0;;;;;;;;;2,0;;;;;;;1,0;;;;;;;;;;3,0;;;;;;;;;;;;;;;;;;;;;;;;1,0;;;;;2,0;;;;2,0;;;;;;;;4,0;;;;;;;;;;;;;;;;;;;;;;;48,0;;;6,0;;;;3,0;;;;;;;;;;;;;;5,0;;;;2,0;;;;;;1,0;;;;;;;;;;;;;;;;;;;;;;;;;;;;;;;;;;;;;;;2,0;;;;;;;;;;;;;;1,0;;;;;;1,0;;;;;;;;;;;;;1,0;;;;;;;;;;;;;;;;;;;;;1,0;;;;;;;;;;;;10,0;;;;;;2,0;;;;;;;;;;;;;;;;;;;;;;;;;;;;;;;;;
transmitter;;;;1,0;;5,0;3,0;10,0;;13,0;;;10,0;;8,0;9,0;1,0;;;;2,0;8,0;;4,0;;;;;;;4,0;;43,0;;23,0;6,0;;5,0;;;46,0;;2,0;1,0;6,0;1,0;7,0;41,0;9,0;8,0;5,0;4,0;;;;;12,0;2,0;;;;;1,0;;1,0;;;;3,0;9,0;2,0;;3,0;;;6,0;3,0;1,0;2,0;41,0;2,0;3,0;;19,0;;3,0;;;;;12,0;;;;;2,0;1,0;;15,0;6,0;;;14,0;10,0;;20,0;32,0;;46,0;2,0;;8,0;1,0;;;18,0;1,0;30,0;21,0;2,0;;;2,0;17,0;10,0;;;;2,0;1,0;;2,0;1,0;;;;4,0;3,0;9,0;;;;4,0;24,0;6,0;;;;67,0;;;3,0;1,0;2,0;;6,0;52,0;;;2,0;;97,0;16,0;;1,0;;13,0;1,0;;2,0;;;;1,0;;1,0;;;1,0;;3,0;1,0;;;;5,0;;9,0;3,0;;1,0;;;13,0;;1,0;;;;1,0;;;;2,0;;;;7,0;4,0;;;;;;;;;;;3,0;24,0;;;;;;;;32,0;;3,0;;;2,0;;;1,0;1,0;;;;;;2,0;;;;;;;;;;;40,0;10,0;18,0;;;;;;;1,0;;;1,0;;;;;9,0;6,0;;;;2,0;;;11,0;3,0;;1,0;;;8,0;;;;;6,0;1,0;;;1,0;2,0;;;1,0;;;1,0;1,0;;;;;9,0;;;4,0;;;;;1,0;;;2,0;12,0;;;2,0;;;;;;;;;;;;;7,0;;;;;;5,0;;3,0;1,0;8,0;;;1,0;2,0;;;;;;;1,0;;1,0;;;;;;;;;;;;;;1,0;;;2,0;5,0;2,0;;;;;;3,0;;;;;;4,0;;;6,0;;;13,0;;;;1,0;;;;5,0;;;2,0;;;3,0;3,0;;;;1,0;;;;;;;;3,0;;;;;;;;;16,0;;;12,0;;;;;;2,0;5,0;2,0;;4,0;2,0;4,0;;1,0;1,0;;;;;;;34,0;;;;2,0;;;;;;1,0;4,0;2,0;13,0;;;;3,0;25,0;1,0;;;36,0;1,0;8,0;;;;;2,0;;1,0;1,0;2,0;;;;;;;;;3,0;;2,0;2,0;2,0;;2,0;;;4,0;;;;;1,0;;;;;13,0;;;;;;;;;;2,0;;;;;;;;;;;3,0;;;;;;;;;;;3,0;6,0;;;;;;;1,0;;1,0;;;2,0;1,0;;;4,0;11,0;1,0;;;;;;;;5,0;;;;;;;;34,0;2,0;;;1,0;;;1,0;;;;;;;;;7,0;;1,0;;1,0;;;;1,0;;1,0;1,0;;;;;;;;;;;;;;1,0;5,0;;;;;;;6,0;;;;;;1,0;;;;;;;;;;;;54,0;;;;;;;;;;3,0;;1,0;;;;;;;;;;;2,0;;;;2,0;;;;;;;3,0;1,0;3,0;1,0;;;;;;;;;;;1,0;;;49,0;;;3,0;;;;;;;;;;;1,0;;;;;1,0;;;1,0;;;;;;;;;;5,0;;3,0;;;;;;;;;;1,0;;;;;;;;;;;;;;;;;;;;;;;;;;;2,0;;;;;;;;;;;;;;;;;;3,0;;;;;;;;;;;;;;;;;;;;;;;;;;;;;;;;;;;;;;;;2,0;;;;;;;;3,0;;;;;;;;;;;;;;;;;;;;;;;;;;;;;;;;;;;;;;;;;;;;20,0;;;;;;;;;;;;;;;;;;;;;;;;;;;;2,0;;;40,0;;;1,0;;1,0;;;2,0;;;;;;;;;;;;1,0;;;;;;;;;;;;;;;;;;;;;;2,0;;;;;;;;1,0;;;;;;;;;;;;;;;;;;;2,0;;;;;;;;;;;;;;;;
visual;;;;2,0;11,0;3,0;1,0;32,0;46,0;1,0;8,0;;46,0;1,0;;97,0;;;3,0;;4,0;95,0;2,0;;;;1,0;10,0;;;7,0;20,0;31,0;1,0;22,0;2,0;1,0;3,0;3,0;;240,0;;2,0;10,0;20,0;3,0;94,0;62,0;;65,0;2,0;17,0;2,0;;;9,0;8,0;;;1,0;;;51,0;16,0;4,0;1,0;1,0;;13,0;3,0;4,0;;23,0;;2,0;1,0;34,0;3,0;1,0;598,0;2,0;111,0;1,0;64,0;;25,0;3,0;;;1,0;20,0;;;5,0;6,0;3,0;2,0;;133,0;28,0;10,0;12,0;3,0;69,0;;13,0;16,0;6,0;21,0;55,0;1,0;9,0;;;;26,0;55,0;18,0;2,0;4,0;2,0;;5,0;13,0;28,0;1,0;2,0;2,0;;7,0;;10,0;13,0;;1,0;5,0;;22,0;1,0;;27,0;1,0;3,0;40,0;2,0;;;1,0;3,0;;4,0;1,0;20,0;45,0;1,0;;65,0;;1,0;2,0;5,0;6,0;57,0;;;;22,0;29,0;2,0;;;;;;1,0;8,0;4,0;;;;;4,0;;;;1,0;;40,0;;;1,0;1,0;;;;;70,0;;1,0;;;;8,0;8,0;41,0;;;2,0;;1,0;;;;3,0;;;;;8,0;;;;;;4,0;;;;67,0;;3,0;;3,0;3,0;;1,0;2,0;;;;;3,0;;3,0;;;;;5,0;;;;;;;;49,0;;;;;;2,0;7,0;;;2,0;;2,0;;;4,0;6,0;;2,0;;;3,0;;2,0;2,0;;7,0;;;16,0;;2,0;1,0;;6,0;3,0;;;;2,0;;;;;;1,0;2,0;;;;;1,0;;;;;;;;1,0;;;1,0;4,0;;;;;;;1,0;1,0;;;;;;1,0;;;;6,0;2,0;;;;;1,0;;;;;;4,0;;2,0;;;;;3,0;11,0;;;1,0;;;;;;;1,0;;2,0;2,0;;;2,0;;;2,0;;;;;6,0;8,0;;;;;;;;12,0;;3,0;;;;;;;;;;14,0;4,0;;;;;2,0;2,0;9,0;3,0;47,0;1,0;4,0;;;;;;;;23,0;;;2,0;3,0;185,0;;;;14,0;;;60,0;;4,0;12,0;;;1,0;6,0;2,0;12,0;5,0;2,0;19,0;;7,0;1,0;;;;;;139,0;;10,0;;;19,0;1,0;;;;;;;4,0;23,0;;;;1,0;38,0;;;;;;6,0;34,0;;;6,0;;2,0;;2,0;;1,0;22,0;11,0;2,0;;;1,0;32,0;6,0;;1,0;;;6,0;;;;;;13,0;;4,0;;;3,0;1,0;;;;18,0;30,0;2,0;;3,0;4,0;8,0;20,0;;;30,0;;2,0;;13,0;1,0;;11,0;11,0;;;1,0;;;9,0;2,0;16,0;;1,0;;1,0;;;1,0;;;10,0;;1,0;;4,0;;1,0;;1,0;;;3,0;;;;;4,0;19,0;;;2,0;3,0;;1,0;1,0;1,0;;;3,0;;2,0;;3,0;;;4,0;2,0;;;;;;44,0;2,0;;8,0;;42,0;;;1,0;2,0;;;;1,0;4,0;;;;;;1,0;;1,0;;8,0;;6,0;3,0;3,0;;1,0;;;;;;1,0;14,0;2,0;1,0;;;;16,0;73,0;8,0;1,0;2,0;1,0;;;2,0;1,0;;1,0;;;;;;;3,0;;;;1,0;;;;;1,0;;;10,0;;;9,0;;;;;;;;3,0;;;;1,0;;1,0;;;;9,0;;;;;1,0;2,0;2,0;;1,0;;2,0;;;;;5,0;;;;;2,0;;;;;;;;;;;;;;;;;;;;;3,0;3,0;;;;1,0;;22,0;;;;;;;;;;;3,0;;;;;;;3,0;;;;;;;2,0;1,0;;;;;;;42,0;;1,0;;;;;;;;;4,0;;;10,0;;4,0;2,0;9,0;;2,0;;;;;2,0;;1,0;;1,0;;;;;;;1,0;2,0;;;;;;;;;;1,0;;;;;;;;;;;7,0;;;;;;;;;;;1,0;;3,0;1,0;4,0;;;;;;;;6,0;;;;1,0;;;;;;;72,0;1,0;6,0;;;;;;;;;1,0;;;2,0;;;;;1,0;;;;1,0;3,0;;14,0;;;;;;;;;;;;;1,0;;;;;;;;;;2,0;2,0;;;;;;;;;;;;;;;4,0;;;;;;1,0;;;19,0;;;;;;;8,0;;1,0;;;1,0;;;2,0;;;;;;;;;2,0;;15,0;;;;2,0;;;;;;;;;;;6,0;1,0;;;;;;;8,0;;;;;;;;;;;
voice;;;;2,0;;;;5,0;;1,0;;;18,0;;6,0;14,0;;1,0;;;;6,0;3,0;;;;1,0;3,0;;;6,0;;38,0;;20,0;2,0;;1,0;;;14,0;;1,0;;2,0;5,0;31,0;37,0;3,0;6,0;;5,0;;;7,0;;1,0;;;;;;;;1,0;;;8,0;3,0;1,0;33,0;;5,0;;;3,0;;;;29,0;;2,0;;40,0;1,0;8,0;;;;;35,0;;;;;;3,0;;35,0;7,0;;;81,0;18,0;;16,0;5,0;;15,0;;1,0;9,0;;;;2,0;6,0;18,0;;1,0;1,0;1,0;2,0;9,0;4,0;2,0;;;;;;;2,0;2,0;1,0;;1,0;8,0;;;;;;6,0;;;1,0;3,0;12,0;1,0;;;;1,0;1,0;1,0;12,0;;;;;6,0;78,0;;;;6,0;1,0;;;;;1,0;;;2,0;;16,0;;;;2,0;;2,0;;3,0;;;;;;;;7,0;;;9,0;;1,0;8,0;1,0;1,0;;1,0;;11,0;;;;5,0;;;3,0;;;;;;;6,0;4,0;;1,0;;;;;;1,0;;7,0;;;;13,0;7,0;;1,0;2,0;4,0;;;;;;;;;;;4,0;;3,0;;;;70,0;;;;;;;1,0;;;5,0;10,0;;;;;3,0;1,0;;1,0;1,0;1,0;2,0;7,0;2,0;;;;;4,0;1,0;7,0;;;;;1,0;;3,0;;;;3,0;;44,0;1,0;;;;;;3,0;7,0;;;;;;;1,0;;;;5,0;;;1,0;;16,0;;3,0;;;;;;;;;4,0;;1,0;;;;;2,0;3,0;;1,0;;172,0;;2,0;;3,0;;1,0;2,0;;;;4,0;;;;;;1,0;;;;5,0;;1,0;;;1,0;;2,0;;;;;;;;;;;;;;10,0;;;;;1,0;1,0;;;;;;;2,0;1,0;;;;;;;;;2,0;;3,0;;1,0;;;;;;;11,0;;;;;;;;16,0;;;2,0;;3,0;3,0;4,0;;;;6,0;;;1,0;6,0;3,0;;3,0;;;;2,0;;20,0;;;;;10,0;6,0;9,0;;;;;;;6,0;;;1,0;;52,0;1,0;;;;;;1,0;1,0;;;;1,0;;5,0;;;1,0;5,0;;;;;;16,0;1,0;6,0;20,0;24,0;;1,0;;;;;;;4,0;;14,0;1,0;;;;1,0;;33,0;44,0;;;1,0;;11,0;;;;;1,0;;1,0;;;;;;;;8,0;;;;5,0;;3,0;;5,0;;;;1,0;;;;;;;;;1,0;;;109,0;1,0;10,0;2,0;;5,0;;1,0;;;;;;;;;;;;;;;6,0;;;;;;;3,0;;1,0;;;;4,0;;;3,0;;4,0;;1,0;;;1,0;6,0;;;;;;;;;;;;28,0;13,0;;;6,0;;;;2,0;;3,0;2,0;;;1,0;;;1,0;1,0;;;2,0;1,0;;;;;;4,0;;;;;;;;;;;;3,0;;2,0;;;;;5,0;;1,0;;;2,0;;;;;;;;;;;;;;;;;;;;;;;12,0;;;;;;;;2,0;7,0;;;;;;7,0;;;;;;;;1,0;;;;231,0;;;;;;1,0;;;;;;;;2,0;2,0;;;;;;;;;;;;;;;;;;;;;;;;1,0;2,0;;;;;;;;;;;;;;;;;;;;;;;;;;;;;;;;;;;;;;;;6,0;;;;;;;;;;;;;;;;;;;;;;;;;;;;;;;;;;;;;;;16,0;;;;;;2,0;;;;;;;3,0;1,0;;;;;;;;;;;;;;;;;;;3,0;;1,0;2,0;;;1,0;1,0;;;;9,0;;1,0;;;;;;;;;;;;;;;;8,0;;1,0;;;;;;;;;;;;;;;;;;;;;;;;;5,0;;;;;;;;;;;;;;;;;;;;;;;;;;;;;;;;;;;;;;;;;;;;;;;;;;;;;;;1,0;;;;;;;;;;;
accelerometer;;;;;3,0;2,0;;1,0;;;;;5,0;;2,0;1,0;;;;;3,0;9,0;;;;;;;;;;;5,0;;;;2,0;;;;20,0;;;;6,0;;32,0;34,0;49,0;2,0;6,0;3,0;;;;;2,0;2,0;9,0;;;;;;2,0;;;;;;2,0;;6,0;;;;8,0;;;15,0;;;;23,0;;2,0;;;;5,0;;;;;23,0;;6,0;;43,0;14,0;;;;6,0;;4,0;;;34,0;2,0;;;;;;1,0;3,0;15,0;;9,0;;;;2,0;18,0;;;;;2,0;;2,0;;1,0;1,0;;10,0;12,0;;;;;;41,0;;;;;31,0;;;;;5,0;;;52,0;;1,0;;;1,0;5,0;;;;3,0;;;;;;;;;3,0;;;;;;;;;;;;;;;;;;;;;;;;;;;;79,0;;;;;;;;;13,0;;;;;;;;1,0;;;;;;;;1,0;;;;;4,0;;;1,0;;;;;;;3,0;;;;1,0;;6,0;;;;;;;9,0;;;;;;;;;;;;;;;;;;;;;;;3,0;;;;;;5,0;;;;;2,0;;1,0;;;;;;;;;;3,0;;;;;;;;;;43,0;;;;;;;6,0;;;;;;;;;;;;;;;;;;;;;;;;36,0;;;;;;;;3,0;;;;;;3,0;2,0;;;;;;;;;;;;;;;1,0;;;;;;4,0;;;;;;;;;;;;;;;;;;;;;70,0;;;21,0;;;;2,0;;;3,0;;;;2,0;;;3,0;2,0;;;;;;3,0;5,0;3,0;2,0;;;5,0;2,0;;;4,0;2,0;;9,0;;;;25,0;;;;;;;13,0;;;;;;2,0;8,0;;;;;;40,0;;2,0;;;;;7,0;3,0;2,0;;;;5,0;;6,0;7,0;;;3,0;3,0;2,0;1,0;2,0;1,0;1,0;1,0;3,0;4,0;1,0;5,0;1,0;1,0;1,0;1,0;1,0;1,0;1,0;2,0;1,0;1,0;1,0;1,0;2,0;1,0;3,0;1,0;3,0;1,0;1,0;2,0;1,0;1,0;1,0;2,0;1,0;1,0;1,0;;;;;;;;;;;;;;;;;;;;;;;;;;;;;;;;;;;;;;;;;;;;;;;;;;;;;;;;;;;;;;;;;;;;;;;;;;;;;;;;;;;;;;;;;;;;;;;;;;;;;;;;;;;;;;;;;;;;;;;;;;;;;;;;;;;;;;;;;;;;;;;;;;;;;;;;;;;;;;;;;;;;;;;;;;;;;;;;;;;;;;;;;;;;;;;;;;;;;;;;;;;;;;;;;;;;;;;;;;;;;;;;;;;;;;;;;;;;;;;;;;;;;;;;;;;;;;;;;;;;;;;;;;;;;;;;;;;;;;;;;;;;;;;;;;;;;;;;;;;;;;;;;;;;;;;;;;;;;;;;;;;;;;;;;;;;;;;;;;;;;;;;;;;;;;;;;;;;;;;;;;;;;;;;;;;;;;;;;;;;;;;;;;;;;;;;;;;;;;;;;;;;;;;;;;;;;;;;;;;;;;;;;;;;;;;;;;;;;;;;;;;;;;;;;;;;;;;;;;;;;;;;;;;;;;;;;;;;;;;;;
accept;;;;;9,0;;;2,0;;;;;4,0;;;15,0;;;;1,0;1,0;2,0;;;;;2,0;;;;;3,0;15,0;;4,0;7,0;5,0;;1,0;;166,0;;;;;;19,0;16,0;;10,0;;;;;;4,0;;;;;;;;3,0;;;1,0;1,0;5,0;;;;;;;;;;3,0;12,0;;;;20,0;;77,0;;;;;9,0;;;1,0;;17,0;6,0;;4,0;4,0;;;8,0;5,0;;;7,0;2,0;;7,0;;;;;;10,0;25,0;;;;;;6,0;8,0;;;;;;;;1,0;;;2,0;;;3,0;;;;;;;1,0;;;;;;;;11,0;2,0;;;20,0;;;;;;68,0;;;;2,0;2,0;;;3,0;;2,0;2,0;;;;;;;;;;;;;;5,0;;;;;;1,0;;;;;;;;;;4,0;;;;;;1,0;;;;;;;;;;3,0;2,0;;;;;;;;5,0;;1,0;;;7,0;;;;;;;;;;;;;;;;;2,0;;;;;;;;;;;;1,0;9,0;;;;;;;;;;;;;2,0;;3,0;7,0;4,0;;;;;20,0;;1,0;;;;;;;;;;;1,0;;;1,0;;;4,0;4,0;;;;;;;;;;;;2,0;;;;;;;;;;;;;;;;;;;2,0;;1,0;;;;;4,0;;;;4,0;;;;;;3,0;;;;;;;;;;;;;;;2,0;;;;;;;;;;;;;;;;;;;;;;;;;;;;;;;;;;;2,0;;;;;;5,0;5,0;;36,0;;2,0;;;;;;;;;8,0;;;;;;2,0;;35,0;;;;;1,0;1,0;11,0;;;;2,0;;1,0;1,0;19,0;;;;;;;;;4,0;;;;;;;;;;;;;;;;;;;37,0;;;;;;1,0;;;;2,0;;;;;;;;14,0;1,0;;;;6,0;1,0;;;;;4,0;3,0;;;;;;;;;;1,0;;;;2,0;;3,0;2,0;1,0;2,0;26,0;24,0;7,0;1,0;2,0;66,0;1,0;14,0;2,0;4,0;1,0;3,0;2,0;22,0;1,0;14,0;6,0;2,0;3,0;2,0;1,0;1,0;30,0;8,0;1,0;12,0;1,0;2,0;2,0;18,0;;;;;;;;;;;;;;;;;;;;;;;;;;;;;;;;;;;;;;;;;;;;;;;;;;;;;;;;;;;;;;;;;;;;;;;;;;;;;;;;;;;;;;;;;;;;;;;;;;;;;;;;;;;;;;;;;;;;;;;;;;;;;;;;;;;;;;;;;;;;;;;;;;;;;;;;;;;;;;;;;;;;;;;;;;;;;;;;;;;;;;;;;;;;;;;;;;;;;;;;;;;;;;;;;;;;;;;;;;;;;;;;;;;;;;;;;;;;;;;;;;;;;;;;;;;;;;;;;;;;;;;;;;;;;;;;;;;;;;;;;;;;;;;;;;;;;;;;;;;;;;;;;;;;;;;;;;;;;;;;;;;;;;;;;;;;;;;;;;;;;;;;;;;;;;;;;;;;;;;;;;;;;;;;;;;;;;;;;;;;;;;;;;;;;;;;;;;;;;;;;;;;;;;;;;;;;;;;;;;;;;;;;;;;;;;;;;;;;;;;;;;;;;
action;;;;;4,0;2,0;;23,0;2,0;1,0;;;38,0;;15,0;15,0;;;;;;17,0;;;;;;1,0;;1,0;4,0;;30,0;;42,0;11,0;1,0;3,0;;;33,0;;9,0;1,0;23,0;8,0;63,0;78,0;10,0;19,0;6,0;5,0;;1,0;29,0;;;1,0;;;;4,0;1,0;;;1,0;4,0;9,0;6,0;;2,0;;6,0;;;1,0;4,0;;;38,0;;4,0;4,0;54,0;;9,0;;2,0;;5,0;12,0;1,0;;;;3,0;3,0;3,0;36,0;16,0;;7,0;9,0;61,0;;3,0;;11,0;5,0;;2,0;106,0;;;;23,0;7,0;7,0;;13,0;;;4,0;6,0;15,0;1,0;;;;;;21,0;;2,0;;3,0;1,0;18,0;;;8,0;1,0;7,0;8,0;;;;;5,0;;4,0;;2,0;1,0;7,0;;20,0;;2,0;5,0;6,0;;23,0;1,0;;;5,0;4,0;;;5,0;;;;;2,0;1,0;;;;;1,0;;;3,0;5,0;;;;;2,0;;;4,0;;;2,0;;;;;;;2,0;;;;;9,0;1,0;4,0;;15,0;;;3,0;;;;;1,0;;;;;;;2,0;6,0;;3,0;;;1,0;2,0;4,0;6,0;;;;;;;;;;;;;;;4,0;;;;;19,0;;;;;;;5,0;;1,0;;;1,0;;2,0;;;;;2,0;;;3,0;1,0;11,0;;;;;9,0;;;;;1,0;;;;;;;;;;;;;;;;;1,0;;;;1,0;;;5,0;;;;;;;;;;9,0;;;;;;;;;;;;;;;1,0;;;;3,0;;;;;4,0;3,0;;3,0;1,0;;;6,0;2,0;1,0;3,0;;;1,0;;;;;1,0;;;;;2,0;;2,0;;;2,0;;;9,0;;2,0;;1,0;;;;;;12,0;;1,0;;;;;;;1,0;;;;;10,0;;;;;1,0;3,0;1,0;10,0;;;18,0;;;;;5,0;3,0;;;17,0;;4,0;;2,0;;2,0;;20,0;4,0;2,0;9,0;;11,0;2,0;21,0;;3,0;12,0;4,0;4,0;;;2,0;9,0;;2,0;;;;;;14,0;2,0;1,0;;;7,0;;;;;;5,0;3,0;1,0;3,0;;;12,0;9,0;64,0;;;;;;5,0;;13,0;;2,0;5,0;;;;;;12,0;20,0;14,0;;;9,0;;4,0;;3,0;;;;4,0;;;;;;2,0;1,0;;;;;;;;;;2,0;;;2,0;;;;;;;;6,0;1,0;24,0;;14,0;1,0;12,0;;6,0;3,0;1,0;;2,0;;1,0;5,0;;9,0;;;;3,0;;1,0;;;;;;;;;;17,0;2,0;;;;;;1,0;;;23,0;;;1,0;;1,0;;1,0;;;;56,0;2,0;;;;30,0;;;;;;;1,0;;;;2,0;2,0;;;16,0;;;2,0;;2,0;;;;;1,0;1,0;;;;1,0;;;2,0;;2,0;;;5,0;;;5,0;;;6,0;;;6,0;;;;;;;;;;19,0;16,0;;;;;1,0;;2,0;1,0;;;2,0;;;1,0;;;;;;;5,0;;;;;;;;;;;;2,0;;;;1,0;;;;;;;;2,0;6,0;;;3,0;;;;;;;;;4,0;;;;;;1,0;;;;;;;;;;;;3,0;;1,0;;;;9,0;;;;;;;;;2,0;;;;;;;;;3,0;;;;1,0;;;;;;;;;;;1,0;;;;;1,0;;;;;;;;;;;;2,0;1,0;;;5,0;;;;4,0;13,0;;4,0;;;;;;;;;;;;;6,0;;;;2,0;;;;;;;;;;;1,0;;;1,0;;;;1,0;1,0;;;;;;;;5,0;;;;;;;;;9,0;1,0;1,0;3,0;5,0;12,0;1,0;6,0;18,0;1,0;1,0;1,0;5,0;1,0;1,0;1,0;1,0;1,0;1,0;2,0;1,0;2,0;3,0;1,0;1,0;4,0;;;;;;;;;;;;;;;;;;;;;;;;;;;;;;;;;;;;;;;;;;;;;;;;;;;;;;;;;;;;;;;;;;;;;;;;;;;;;;;;;;;;;;;;;;;;;;;;;;;;;;;;;;;;;;;;;;;;;;;;;;;;;;;;;
addition;;;;;2,0;;1,0;3,0;5,0;1,0;3,0;;;;2,0;2,0;2,0;;3,0;;;2,0;3,0;;4,0;7,0;27,0;;;;2,0;;10,0;;6,0;;4,0;6,0;;;6,0;;1,0;;4,0;3,0;4,0;7,0;10,0;12,0;;9,0;;3,0;;;6,0;1,0;;;;1,0;;;3,0;2,0;;;5,0;;14,0;;14,0;1,0;;2,0;;;;47,0;;6,0;;11,0;;;;;;1,0;3,0;;;;;;1,0;;6,0;2,0;;;1,0;6,0;;;4,0;1,0;21,0;1,0;1,0;41,0;1,0;;;20,0;6,0;5,0;;5,0;1,0;1,0;19,0;10,0;1,0;;;2,0;1,0;4,0;;3,0;;;;2,0;6,0;;;;;;;3,0;1,0;;;;145,0;1,0;;1,0;;;5,0;1,0;12,0;;;11,0;;2,0;21,0;;;;5,0;;;;1,0;;;;5,0;;;;1,0;;3,0;1,0;;;3,0;9,0;;7,0;4,0;;;1,0;2,0;2,0;;;4,0;;;;;;1,0;6,0;;;;;4,0;4,0;;;;;;;;;17,0;1,0;2,0;2,0;;;;;1,0;;4,0;;;;;;;2,0;;;3,0;;4,0;;;;;;;15,0;72,0;;;;;;;4,0;;;;;;;;2,0;;2,0;1,0;;;;;2,0;;;;;;9,0;16,0;5,0;6,0;8,0;3,0;16,0;2,0;10,0;;;2,0;1,0;3,0;1,0;;;;;5,0;;;;;;;;;;1,0;;;;;;;1,0;1,0;1,0;;5,0;;;;;;;1,0;;;;;;2,0;;;1,0;;4,0;;2,0;;;;;;3,0;;;1,0;;;;;;;1,0;;;1,0;;;;1,0;2,0;;;;;;;;;;;;;;;;;;;2,0;;;;;2,0;;;;;;7,0;;;;2,0;;;1,0;;;;;;;;2,0;1,0;1,0;2,0;5,0;1,0;1,0;3,0;;;;;;;;;;2,0;;1,0;1,0;;;;;;6,0;;;;;;1,0;;;;;;;;10,0;;;4,0;1,0;;;;1,0;2,0;;;;;;;;;;;;;2,0;;;;;;1,0;1,0;;1,0;3,0;;8,0;;;;1,0;;;;;1,0;;;;5,0;3,0;;;;1,0;1,0;;;2,0;;6,0;;;;63,0;;3,0;3,0;;;;1,0;;;;;;;1,0;;;;8,0;;1,0;;;;;;;;1,0;;;;;;;;;;1,0;;;;;;;1,0;;;;1,0;;;;1,0;;2,0;;;;;;1,0;;;;;;;;;;;;;;;;;;;;;;;;;;;;;;;;;6,0;;;;;;;2,0;;;;;;;;;;;8,0;1,0;;;;;;2,0;;;;;;;;;;1,0;1,0;;;;1,0;;;;;;;;;;2,0;;;;;;;;;6,0;;;6,0;;;;;1,0;;;;;;;;;;;1,0;;;;;;;;;;;;;;;;;;;;1,0;;;;;;;1,0;;;;;;;;;;;;;2,0;;;;3,0;4,0;;;;;2,0;;;;;;;;;;;;;;;2,0;;;;;;;;;;;;;1,0;;;2,0;1,0;;;2,0;;21,0;;;;;1,0;4,0;;;1,0;;;;;;;;;;;;6,0;;;;;2,0;;;;;;;2,0;;2,0;;3,0;;1,0;;1,0;;1,0;;;;;;;;1,0;;1,0;;;;2,0;;;;;;;;;;;2,0;;;;1,0;;;1,0;;;;;;;;1,0;;2,0;;;;;;;;;;1,0;;;;;;;;;;1,0;;;;;;;;;;;;1,0;;1,0;;;;;;;;;;;;;;;;;;;;;;;;;;;;;;1,0;;;;1,0;;1,0;;;;;;;;;;1,0;;;;;;;;;;;;;;;;;;;;;;;;;;;;1,0;8,0;1,0;3,0;;;;;;;;;;;;;;;;;;;;;;;;;;;;;;;;;;;;
aerial;;;;;1,0;1,0;;;9,0;2,0;2,0;;;;5,0;3,0;;;;1,0;;11,0;;4,0;;;;;;1,0;7,0;;1,0;;10,0;7,0;6,0;1,0;;;1,0;;1,0;;5,0;;;;15,0;1,0;;;5,0;;;;3,0;1,0;;;;;2,0;;1,0;5,0;1,0;4,0;1,0;;;;;;;;1,0;;;14,0;;3,0;;10,0;;;;;;6,0;13,0;;;4,0;;;1,0;;21,0;;2,0;;;10,0;1,0;;7,0;;;5,0;;;;;;3,0;;2,0;;;;;2,0;;;;;;;3,0;;;1,0;;;;5,0;;;;2,0;;;10,0;1,0;;;3,0;;;;;;1,0;3,0;;103,0;;2,0;;;;3,0;;;;11,0;1,0;;3,0;;;;3,0;;;8,0;;;;1,0;;;;;1,0;;3,0;;;;;;1,0;;;;;;2,0;;;;4,0;;;;;1,0;1,0;;;2,0;;;;;;;;11,0;;2,0;;;;;;2,0;;;;;4,0;;4,0;8,0;;;;1,0;;;;;;;;;12,0;;;;;;;;;;;;;;2,0;;;;;2,0;;;;;;;1,0;;1,0;;8,0;;;;;;7,0;;;;;46,0;;;;;1,0;;;;;1,0;;;;;;1,0;;;;;;;;1,0;;;;;4,0;;;;;;2,0;1,0;;;2,0;;;;1,0;;;4,0;2,0;;;;;;2,0;;;;;1,0;1,0;;;3,0;;;;31,0;;;;3,0;;;;;;;;;;;;;;;;;;1,0;3,0;;;;;;;;;;;;1,0;;;;;;;;;1,0;;;1,0;;38,0;;;;;;;;;8,0;3,0;;;;;;;2,0;;;;;5,0;;;;;11,0;;2,0;;;;1,0;;;;3,0;;;;;;;;;;;;;2,0;;;;;;;;;;;;;;10,0;;;;;5,0;;;1,0;;;;;;1,0;;;;;;1,0;;;;;4,0;5,0;7,0;;;;;;;13,0;;;;;;;;;;;;;;;;;;;;;;;;5,0;;;;;;;;;;1,0;;;;;;;;;;;;;;;;;;;;;1,0;;;1,0;;;;1,0;;1,0;;5,0;;;;;;;;;;;;;;;;;;;;;;;;;1,0;;;;;;;;;;;;1,0;;;;;;;;;;;;;;;1,0;;;;;;;;;;;;;;;;;;;;;1,0;;;;;;;;;;;;;;;;;;;;4,0;;;;;;;;;;;;;;;;1,0;;;;5,0;;;;;;;;;;;;;;;;1,0;;;;;;;1,0;;;;;;;;;;;;;;;;;1,0;;;;;;;;;;;;;;;;;;;;;6,0;;;;;;;;;1,0;1,0;;;;;;;;;;;3,0;;;;;;;;;1,0;;1,0;;;;;;;;;;2,0;2,0;;;;;;;;;;;;;;;;;;;;1,0;;;;;;;;;;;;;;;;;2,0;;;;;;;;;;;;;;;;;;;;;;4,0;;2,0;;;;;;1,0;;;;;;1,0;;;;;;;;;;;;;;2,0;;;;;;;;;;1,0;;;;;;;;;;;;;;;;;;;3,0;;;;;;;;;;;;1,0;;;;;;;;;;;;;;;;;;;;;2,0;;;;;;;;;;;;;;;;;;;1,0;;;;;;;;;;;1,0;;;;;;;;;;;;;;;;1,0;;;;;;;;;;;;;;;;;;
alert;;;;;1,0;3,0;;3,0;5,0;1,0;;;2,0;;;15,0;;;;;;7,0;;;;;1,0;;;;4,0;2,0;4,0;;2,0;8,0;;;;;3,0;;5,0;;2,0;22,0;13,0;11,0;;21,0;;4,0;;;;4,0;;;;;;;2,0;;2,0;;;4,0;;;3,0;;7,0;;;;;;;20,0;;3,0;;9,0;;;;;;;;;;;2,0;2,0;;3,0;23,0;;;;10,0;12,0;;;1,0;;6,0;1,0;;;;;;3,0;2,0;2,0;;9,0;;;;;3,0;2,0;;;;2,0;;;;;;;;10,0;;6,0;;2,0;;9,0;2,0;;;;12,0;;;;1,0;2,0;3,0;;18,0;;;;2,0;4,0;1,0;;1,0;;11,0;9,0;;;;;;;;;;;;;;1,0;;;;;;3,0;;;;6,0;;;;;;;;;;;;1,0;;;;;;;;;;;;;;;;;;;;;;;;;1,0;;;;;;;;1,0;;;;;;;;;;;;;;;;;;;;13,0;;;;;;;1,0;;;1,0;;;;;;;;;;;1,0;;;;;;;;6,0;;;;;5,0;2,0;;;;;1,0;;;;;;;;;;;;;;;6,0;;;;;;;;2,0;;;;;1,0;;;;;2,0;;;;;;;;;;;;;;;;;;;;;;;;;;;;3,0;;;;;;;;;;;;;;;;1,0;;;;;;;;;;;;;;;;;;;1,0;;;;;;;;;;;;;;;;;1,0;;;;;;;;;;;;;1,0;;;;;;;2,0;;;3,0;;1,0;;;1,0;;;10,0;;1,0;;1,0;;;1,0;;;;;;;6,0;1,0;;;;;;;4,0;1,0;;;;;;6,0;;;10,0;;16,0;;;;;;;;1,0;2,0;;;;;;;;;7,0;;;;;;3,0;;;;;;;;;;;;;1,0;;2,0;;;;;;;;;;;;;12,0;;;2,0;;1,0;;;;;1,0;;;;;;;;;1,0;;;;;;;;8,0;;;;;;;;;;1,0;;;;;;;4,0;;;;;;3,0;;;;;;;;;;;;;;;;;;;;;;;;;;;10,0;;;2,0;;;;;;;;;;;;;2,0;;;;;;;7,0;;;;;;6,0;;4,0;;;;;;1,0;;;;;;;;;1,0;;2,0;;;;;;;;;;;;;;;;;;;13,0;;;;2,0;;;;;;;;1,0;;;;;;;;;;;;;;;;;;;;1,0;4,0;;;;;;;;;;;;;;;;;;;;;;;;;12,0;;;;;;1,0;;;;;;1,0;;;;;;;;;;;;;;;;;;2,0;;;;;;;;6,0;1,0;;;;;;;;;;;;;1,0;;;;;;;;;;;;;;;;;;;;;;;;;;;;;;;;;;;;;;;;;;;1,0;;;;;;;;;;2,0;;;;;;;;;;;;;;;;;9,0;;;;;;;;1,0;;;;;;;;;;;;;;;;;;;;;;;;;;;;;;3,0;;;;;;;;;;;;;;;;;;;;;;2,0;;;;;;;;;;;;;;;;;;2,0;;;;;;;;;;;;;;;;;;;;;;;;;;;;;;;;;;1,0;;;;;;;;;;;;;;;;;1,0;1,0;;;;;;;;;2,0;;;;;;;;;;
algorithm;;;;;1,0;3,0;;4,0;5,0;;3,0;;26,0;;;19,0;;2,0;;1,0;;7,0;3,0;;;;29,0;6,0;;2,0;17,0;;6,0;;11,0;9,0;2,0;17,0;;;27,0;;3,0;3,0;7,0;20,0;36,0;20,0;14,0;4,0;;17,0;3,0;;;13,0;;5,0;7,0;;;3,0;;4,0;10,0;4,0;3,0;1,0;5,0;;8,0;;20,0;;;5,0;8,0;6,0;;180,0;;2,0;2,0;24,0;;6,0;;;;2,0;4,0;2,0;;;2,0;2,0;;;78,0;2,0;1,0;3,0;6,0;16,0;3,0;1,0;6,0;1,0;1,0;59,0;;27,0;;;2,0;28,0;;5,0;;12,0;;;10,0;21,0;6,0;11,0;;1,0;;;;;;;1,0;;11,0;2,0;3,0;;7,0;;1,0;13,0;7,0;;;3,0;25,0;1,0;3,0;;2,0;8,0;3,0;;21,0;;;;6,0;;11,0;;2,0;;7,0;;;1,0;;;;;;79,0;;;;;;;;;;7,0;;2,0;;;1,0;9,0;;1,0;;;;;;;;2,0;5,0;1,0;2,0;;;1,0;2,0;8,0;;;;;;;;;;;;;;;;;;;21,0;;;;1,0;;;;;;;;2,0;;;1,0;8,0;;;;8,0;8,0;;;;;;;;;;;;;;88,0;;10,0;1,0;;;;;6,0;;;;;;1,0;1,0;;;;;;;4,0;;;14,0;;5,0;;;;;;9,0;1,0;;;2,0;2,0;;;;;;4,0;;;;;;;;2,0;;;;1,0;;;;;;1,0;;;;;;;;;;;;;;;;;;1,0;;;17,0;2,0;;3,0;;;;;;;3,0;2,0;2,0;;;;;;;;;;;;;;;4,0;;;;1,0;;;;;;;;10,0;;;1,0;1,0;;2,0;;;;;1,0;;;;;;;1,0;2,0;;;;;9,0;5,0;1,0;7,0;1,0;6,0;3,0;4,0;3,0;;;1,0;;;;;3,0;;8,0;;;;11,0;1,0;12,0;;;5,0;14,0;23,0;;4,0;5,0;1,0;;9,0;1,0;19,0;1,0;;;3,0;1,0;;;4,0;;;63,0;;;;2,0;;2,0;;;;3,0;4,0;9,0;;;;;11,0;5,0;1,0;;;2,0;9,0;;9,0;;3,0;;3,0;1,0;;6,0;;;;5,0;2,0;1,0;;;1,0;;;1,0;;4,0;6,0;4,0;;;;;2,0;;;;3,0;;;;;;1,0;2,0;;37,0;;;2,0;;1,0;;;;;;;;;1,0;;;;;;;;4,0;;;;5,0;;;;;;;;;;;;;;8,0;;1,0;1,0;;3,0;30,0;3,0;1,0;;;;4,0;;;4,0;;;;9,0;;2,0;;;1,0;;;;;;;2,0;;;;;;2,0;2,0;;;;3,0;;;;;;2,0;3,0;;;;;;;2,0;;1,0;;16,0;;;4,0;;;;;;;;3,0;1,0;;;1,0;;;;1,0;;;;;;1,0;;;;;;4,0;;4,0;;;;;;8,0;4,0;;1,0;;;;;4,0;;;2,0;;;;;;;;;;;;3,0;4,0;;;;;;;;;;;;;;;;;2,0;;;;;;;;;;;;;;;;;;;;;;;;;1,0;;;;2,0;;;;;;;;;;;;;;;;;;;;;;;;;;1,0;;;;;;2,0;;;;;;;;6,0;;;;;;6,0;;;;;;;;2,0;;;8,0;;3,0;;;1,0;;;;4,0;;1,0;2,0;;2,0;;3,0;;;3,0;13,0;;1,0;;36,0;;;;;;;;;;;;;1,0;9,0;2,0;11,0;;2,0;;;;1,0;;;;5,0;;;4,0;;1,0;;;;;;1,0;;6,0;14,0;1,0;;;4,0;3,0;;;;;;;;;;1,0;;;14,0;;;;;;;;;;;;;;;;;;;4,0;;;;;;;;4,0;;;;3,0;;;;;;;;;;;;;;;;;;;;;1,0;;;;;1,0;;1,0;;;;;;;;;;;;;;5,0;;;;;;;;;;;;1,0;;;;;12,0;;;;;;;;;;2,0;;;;;;;;;;6,0;;;;;;;1,0;;7,0;;;;;;;;;
analysis;;;;;24,0;4,0;;15,0;3,0;2,0;;;10,0;;2,0;70,0;2,0;1,0;1,0;1,0;;56,0;;;;2,0;17,0;6,0;;;2,0;3,0;51,0;;15,0;6,0;1,0;9,0;;;70,0;;;;10,0;12,0;56,0;37,0;25,0;5,0;;6,0;3,0;4,0;;21,0;2,0;1,0;;5,0;;1,0;2,0;1,0;8,0;6,0;1,0;1,0;49,0;;4,0;;39,0;;;1,0;21,0;1,0;1,0;260,0;1,0;;;35,0;1,0;3,0;;4,0;;8,0;2,0;;2,0;3,0;;1,0;4,0;;54,0;;10,0;4,0;124,0;69,0;;3,0;;;12,0;7,0;1,0;85,0;;;;13,0;11,0;8,0;;12,0;;;9,0;9,0;10,0;7,0;;;;4,0;;8,0;2,0;;;1,0;7,0;7,0;1,0;;20,0;;;8,0;3,0;;;3,0;5,0;;;;2,0;3,0;2,0;;49,0;;;;2,0;1,0;39,0;;;1,0;30,0;3,0;;3,0;;;;;1,0;1,0;;;;;;;;;;2,0;;13,0;;;;;;10,0;;;5,0;;;;;;4,0;;1,0;;;1,0;5,0;1,0;;2,0;;;;;;;;;;;;1,0;;;;;12,0;;;;;;;;1,0;;;;;1,0;;6,0;7,0;;;1,0;6,0;;;;;;;;8,0;;;;;;;9,0;;;;;;;;2,0;;;;;2,0;;;1,0;;1,0;;;;6,0;;;2,0;;8,0;2,0;2,0;;;;;;;;1,0;1,0;1,0;;;;;5,0;;;;1,0;;;;4,0;;;;6,0;;;;;;;;;;1,0;;;;;;4,0;;;;;;;3,0;1,0;;;;;;6,0;;;;;;;1,0;4,0;2,0;;1,0;;;;;;;;;;;;;2,0;;;;;;;;;7,0;;;2,0;;;;3,0;;20,0;1,0;;;;;;3,0;;;2,0;1,0;4,0;;;;;;15,0;4,0;;16,0;3,0;8,0;;;;1,0;;1,0;1,0;;21,0;;;3,0;6,0;6,0;;;8,0;;3,0;1,0;;2,0;4,0;1,0;;2,0;13,0;1,0;;;;6,0;1,0;3,0;1,0;;;;8,0;;4,0;1,0;;;2,0;2,0;;2,0;;;;;;2,0;4,0;;;;1,0;14,0;1,0;4,0;;;;;;;;;;1,0;8,0;2,0;1,0;;1,0;;5,0;;;;2,0;3,0;;2,0;;;1,0;3,0;3,0;;;;;2,0;9,0;;2,0;2,0;;1,0;;;;;;;;;1,0;;;;;;;14,0;;;;;2,0;1,0;;3,0;;;;;;;;;;;;;;;;;;;;1,0;;;5,0;;4,0;;3,0;6,0;2,0;;1,0;2,0;;1,0;5,0;;;;;;;;5,0;4,0;;;1,0;;;1,0;;;;1,0;;;3,0;4,0;2,0;5,0;;3,0;3,0;;7,0;2,0;;4,0;;;2,0;;;;;;1,0;;;;1,0;;3,0;10,0;;15,0;;;1,0;;;;2,0;4,0;;;;3,0;;2,0;1,0;;;5,0;3,0;;;;1,0;;1,0;;;;;;;;;;;;;;;;;;;1,0;;;1,0;;;;3,0;;4,0;;;1,0;;;6,0;;;;5,0;;;;;;;;;;;;;;;;;;;;1,0;;;;;;;;;;;;;;;;;;;;3,0;;;1,0;;2,0;1,0;;1,0;;;1,0;;;;;;;;;1,0;;;;;;1,0;;;;;;;;1,0;;;1,0;;;;;;2,0;4,0;;;;;;;;2,0;;;;5,0;11,0;;;7,0;2,0;;;;1,0;;;;;;2,0;;4,0;;;1,0;;;2,0;;;;;1,0;;;;;;;2,0;2,0;;9,0;;;;2,0;3,0;;;1,0;;;;1,0;1,0;;;;;;;;13,0;1,0;;1,0;;;1,0;;6,0;;;;;;2,0;;;;;;;;;;;;;1,0;1,0;;;;;;;;;;;;;;;7,0;;;;3,0;;;;;;1,0;;;;;;;8,0;;;;;;;;;;;;4,0;;;;;;2,0;;;4,0;;;;;3,0;;;;;;3,0;;;;;;;;1,0;;;;;;;;;;;;1,0;;;;;;;2,0;;3,0;;;;;;;7,0;;;;;;;;;;;;1,0;;;;1,0;;;;;;;;;;;
attribute;;;;;12,0;20,0;;4,0;;1,0;1,0;;26,0;6,0;4,0;62,0;;;;4,0;;15,0;1,0;;;;2,0;4,0;;;1,0;5,0;26,0;;12,0;;;;;;40,0;;13,0;;5,0;;65,0;27,0;1,0;16,0;;2,0;;;;;1,0;;3,0;;;11,0;;6,0;6,0;;;7,0;14,0;;3,0;;8,0;;;4,0;20,0;;;101,0;1,0;9,0;1,0;50,0;1,0;23,0;;;;4,0;1,0;;1,0;;4,0;6,0;4,0;22,0;38,0;;4,0;;24,0;59,0;;;2,0;1,0;5,0;5,0;;;;;;20,0;;24,0;;5,0;;;;2,0;14,0;2,0;;;;2,0;;8,0;1,0;;1,0;4,0;9,0;;;;2,0;;4,0;;5,0;;;;6,0;10,0;;;9,0;20,0;1,0;;14,0;;3,0;1,0;8,0;1,0;65,0;;;;45,0;1,0;3,0;;3,0;;;;;;;;;;;3,0;;;;;;;;;;4,0;;;;;1,0;;;;;;;2,0;;;;;8,0;8,0;;;;;;;;;7,0;;;;;;;1,0;;;3,0;;;;;;;;;;;;;;;;;;;1,0;7,0;;;;;;;;18,0;;;;;;;4,0;;;;;;;;;;;;;1,0;4,0;;;;;;;;9,0;;;;;;;;;4,0;;;;;;;1,0;;;;;;7,0;;;;;;;;1,0;;;;;;;;;;;;;;;;;;;;;2,0;;;;;;;;;;;;;;;;;;;;4,0;;;;;;;;;;;;;;;;;;;;;;;;;;;6,0;;;;;;;;30,0;;;;4,0;;;1,0;;;;10,0;;;;;;4,0;2,0;5,0;1,0;12,0;;;;;;;3,0;;;;1,0;;;2,0;23,0;;2,0;;;;;12,0;;5,0;11,0;;;2,0;1,0;7,0;1,0;6,0;;;;;;3,0;;;;11,0;39,0;;;;;;;;2,0;;;;;2,0;4,0;;;;1,0;4,0;;;;;;;;1,0;1,0;2,0;;;5,0;4,0;;;;9,0;6,0;;1,0;;;;;;;;;33,0;;;;;7,0;;;;;;;;;;24,0;;2,0;;;;;;;;29,0;;;;;;;6,0;58,0;;;;;;3,0;;;10,0;9,0;;1,0;4,0;;;8,0;2,0;;;;;;;;;22,0;;21,0;;;;;;6,0;;;;;;;;;2,0;;;;;;;;5,0;1,0;15,0;;;;;;;;;;1,0;;;;;4,0;;;5,0;;;1,0;;;;;;;;;;2,0;;3,0;1,0;;4,0;4,0;;;;;;;2,0;;44,0;;;;;;;;3,0;;5,0;;5,0;;;;;;;;;;;;;;;4,0;;;;;;;;;;5,0;;;;24,0;;2,0;;;;;;;;;;;;;;;;;;;;;;;;;;;;;;;;;;;;;;;;;;;;;;;;;;4,0;;;3,0;;3,0;;;;;;1,0;;;4,0;;;;;;;;;;;;;;;6,0;;;;;;1,0;;;;;35,0;;;;6,0;;;;;;;;12,0;;;;;;;;4,0;;;;;;;;;;;;;;4,0;;;;;;;;6,0;;14,0;;;1,0;;;;;1,0;;;;;;;;;;;;;;;;;;;;;;;;;;;;;;5,0;;;;;;;;;;;;;;;1,0;;;;;;;;;;;;;;;;;;;;;1,0;;;;;;;;;6,0;5,0;;;;;;;;;;;;;;;;;;;;;7,0;;;;;;;;;;;;3,0;;;;4,0;;;;26,0;1,0;;;;;;;3,0;;;;;;;;;;;;;;;;;;1,0;;;;;7,0;;;;;;;;;;;;;;1,0;;;;;;;;;1,0;;;;;;;
blue;;;;;1,0;;;7,0;1,0;14,0;6,0;;;;;7,0;;;;1,0;;4,0;;8,0;;;130,0;21,0;;;;;15,0;;;2,0;;;;;24,0;;;;5,0;1,0;2,0;5,0;6,0;1,0;2,0;1,0;;;;;28,0;;1,0;;;;;;106,0;;;3,0;;;;9,0;11,0;;;10,0;;2,0;6,0;90,0;;4,0;;32,0;;2,0;;;;;1,0;;;22,0;1,0;1,0;;;24,0;1,0;;;4,0;;;2,0;;;;3,0;4,0;;;;;27,0;5,0;4,0;;5,0;;;;;8,0;;;;;4,0;;;;;4,0;1,0;3,0;;2,0;;;;;7,0;;;;1,0;32,0;;;1,0;;;;;10,0;;;;;5,0;12,0;;;;3,0;;26,0;57,0;;4,0;;3,0;;;;;;;;;;;9,0;;1,0;26,0;;;;;;;;;;;;2,0;;;;5,0;;;;;;;1,0;;;;;141,0;;;;;;2,0;;;;;;;198,0;;9,0;;;;;;;;;;;;;2,0;;3,0;2,0;;95,0;;;;;;;;1,0;8,0;;;;;;2,0;;;2,0;;;;;8,0;;;5,0;;;;;1,0;;;;;;;3,0;;;1,0;2,0;2,0;;;;;1,0;;;;;4,0;;;;;;;;;;;18,0;;;;;;;;;;;;1,0;;;;;1,0;;;;;;;;;;;;;1,0;;;5,0;;;;2,0;;1,0;;;;;;;;10,0;;;;;;;;;;;;;;;;;;;;;;;;;;;;;;;;;;;;;;6,0;;;;;;;;;;;;8,0;;4,0;;;;1,0;3,0;;;;;;;;;;;;;3,0;;;15,0;;2,0;;;;;;;;;;;;;;;;;;;;;1,0;;;;;6,0;;;;;;;;2,0;;;;;;4,0;;;;;;;;;;1,0;;;;1,0;;;;;;;;;;3,0;;;;;3,0;;;;;;;;1,0;;;;;;;1,0;;;;;;;;;;;;;;1,0;;;;;3,0;;;;;;;;5,0;1,0;;;;;;;;;;;;;;;;13,0;;;;1,0;;;;32,0;;;;;;;;;;;;;;8,0;11,0;;;;;;;;;;;;;;;4,0;;;;;;;;;;;;;;;;;;;;;;;;;;16,0;;;;;;;7,0;;;;;;;;;;;;;;;;;;;;;;;;;;;;;;2,0;28,0;;;;;;;;;;;;;;;;;;;;;9,0;;;;;;;;;;;;;;;;;;;;;;;;;;;;;;;;;;;;;;;;;;;;;;;;;55,0;;;;;;;;;4,0;;;;;;;;;;;;;;;;;;;;;;;;;;;;;1,0;2,0;;;;;;;;;;;;;;;7,0;;;;;;;;;;;;1,0;;;;;;;;;1,0;;;;;;;;;;;;;;;;;;;;;;1,0;;;;;;;;;1,0;;1,0;;;;;;;;;;;;;;;;;;;;1,0;;;;;;;;;;;;;;;;;;;;14,0;;;;;1,0;;;;;;;8,0;;;;;;;;;;4,0;;;;;;;;;;;;;;;;;;;;;;;;;;;;;;;;;;;;;;;2,0;;;;;;;;;;;;;;;;;;;;3,0;;;;;;;;;;;2,0;1,0;;;1,0;;;;;;;;;;;;;;;;;;;;;
candidate;;;;;1,0;1,0;;2,0;11,0;4,0;;;;;3,0;28,0;;3,0;;;;20,0;2,0;;;;3,0;28,0;;;;2,0;2,0;;9,0;3,0;;;;;27,0;;;;4,0;6,0;50,0;18,0;1,0;16,0;;1,0;;;;42,0;6,0;1,0;1,0;1,0;2,0;;1,0;21,0;8,0;3,0;2,0;3,0;10,0;;;;6,0;;;8,0;37,0;;;179,0;;17,0;;10,0;;4,0;;;;20,0;;;;;;6,0;;;21,0;;;;;107,0;;;;;2,0;5,0;3,0;7,0;;;;83,0;8,0;16,0;;10,0;;;1,0;4,0;;;4,0;;;9,0;;;;;4,0;;;9,0;;3,0;2,0;;;;12,0;;;;6,0;8,0;2,0;;3,0;19,0;24,0;;2,0;;;13,0;;;52,0;;;;1,0;16,0;;;;;;1,0;;1,0;;;;;;;;;;1,0;;;;;;1,0;;1,0;;;;;;1,0;;;5,0;;34,0;;;;;23,0;;;;;;;;;12,0;;;;;;;;;;;;;;;;;;;;;;;;;;;;;;21,0;20,0;;;;;;;6,0;;;;;;;89,0;;;18,0;;;;;;;;;;;;;;;;1,0;;;;;;2,0;;1,0;45,0;;;;;;;;;;;;;;;;4,0;;4,0;;;;;;4,0;;;;;;;;;;;;;;4,0;;;;;;;;;;;;;5,0;;;;;;;;;;;2,0;;;;18,0;1,0;;;;;;;;;;;;;;;5,0;;;;;;;;;4,0;;4,0;;;;;;;13,0;5,0;;;;;;12,0;;;;;4,0;;;;4,0;;6,0;;3,0;;;9,0;;;;;;;10,0;;2,0;;;;28,0;2,0;;;5,0;2,0;;2,0;1,0;2,0;6,0;2,0;;;;1,0;;;2,0;6,0;;;;7,0;;;;2,0;13,0;;;;15,0;;;;;;;1,0;;14,0;5,0;;;;5,0;3,0;;;;;;;;1,0;;;;;;;;;;;;25,0;;;;;;;;;2,0;;;;;;;;8,0;1,0;;;;;;;;;;;;;;;;4,0;;;;;;;;8,0;2,0;;;;;;;;1,0;;;;2,0;;;;1,0;;9,0;;;;;;;;;;;;;;;1,0;;;;;;;;;;;;;;;;;;;;1,0;;;;;;;;;;;;;;;;;;;;;;;;;;;1,0;;;;;;14,0;3,0;;15,0;;;;;;;;;;;;;;;;1,0;;;;;;;;;;;;;;;;;;;;;;;;;;;;;;;;;;;;;2,0;;;2,0;;;;;;;;;4,0;;;;;;;;;;;;;;;;;;;;;;;;;;;;;;;;;;;;;1,0;;;;;;;;;;;;;;;;;;;;;1,0;;;;;;;;;;1,0;;;;;;;;;;1,0;;;1,0;1,0;;;;;1,0;40,0;;;;;;2,0;;;;3,0;1,0;;;;;;;;;;;;2,0;;;;;;;;3,0;;;2,0;;;;;;58,0;;;;;;3,0;;;;;;;;;;;1,0;;;1,0;;;;;;;;;;;;;;;;;;;1,0;;;3,0;;;;;28,0;;;2,0;;;;;;;;;;;;;;;;;;;;;;;;;;;10,0;;;;;;;;7,0;;;;;;;;;;;;;;;;;;;1,0;;;;;;;;;;;;;;;;;;;;;;;;;;;;;;;;;;;;;;;;;19,0;;3,0;;;;;;;;;;;;;7,0;;;;;;;;;6,0;;;;;;;;;;;
character;;;;;3,0;3,0;;24,0;51,0;5,0;;;17,0;;;10,0;;2,0;;;;7,0;;;;;12,0;;;6,0;4,0;2,0;4,0;;14,0;;;;;;18,0;;;;15,0;10,0;28,0;28,0;3,0;55,0;;;4,0;;;12,0;2,0;;;;1,0;;;12,0;13,0;;9,0;3,0;2,0;;9,0;;13,0;;;2,0;19,0;;;130,0;;2,0;1,0;64,0;;2,0;;;;4,0;;;;;;2,0;5,0;;53,0;10,0;;;;29,0;4,0;;19,0;3,0;9,0;1,0;;14,0;;;1,0;13,0;41,0;9,0;;20,0;;;7,0;5,0;2,0;1,0;;;;26,0;;;1,0;;;;7,0;;;;;;;;1,0;;;;6,0;63,0;1,0;;3,0;33,0;4,0;;5,0;;;;1,0;;8,0;;;;5,0;2,0;;;10,0;;;;1,0;1,0;;;;;;;;;;;;;;;;;;1,0;;;;;;;;;2,0;;;;;;;;;;;;;;;;2,0;;;;;;;;;;;;;;;;;4,0;3,0;;;;4,0;1,0;;2,0;;;;2,0;;;;;;;;;7,0;;;;;;;65,0;;;;;;;;;7,0;;;;;;;;;;;;;6,0;;2,0;;;;;;;;;8,0;;;;;5,0;;;;;;;;6,0;;;;;;16,0;;;;;;;;;;;;;4,0;1,0;;;;;;;;;;;;;;2,0;8,0;;;;;;;;;;;;;8,0;8,0;;;;;;;;;;;;;;;;;;;;;;;;8,0;;;;;;;5,0;;1,0;;;;;;;;;;;;1,0;;;;;;2,0;;2,0;17,0;;1,0;;2,0;;;;;;;1,0;;;;;;3,0;;38,0;16,0;;23,0;;;;13,0;;;;3,0;;;;5,0;4,0;5,0;;;;;4,0;1,0;2,0;;;;18,0;;;;;;;;;1,0;;;;;1,0;59,0;;;4,0;;;8,0;1,0;;;12,0;;3,0;1,0;;;;;;3,0;;4,0;;;5,0;1,0;;;;18,0;;;;;3,0;;;6,0;;;;;;;;2,0;;4,0;;;;;;;;;;2,0;;7,0;;;4,0;11,0;;;;;;4,0;15,0;;3,0;4,0;;53,0;;;;;;2,0;;;;;3,0;;;;;;1,0;2,0;;;;9,0;;;;13,0;;;;8,0;;;;;;;1,0;;;;;;;;;;;2,0;4,0;3,0;1,0;;1,0;1,0;;2,0;;;;;;;1,0;;;5,0;;;;;;1,0;;87,0;88,0;;22,0;;;;;;;9,0;;;;;;;;;;;44,0;;6,0;;7,0;;2,0;;3,0;;;;5,0;;;;;;;;;;;2,0;;;;;;;;;;;;10,0;;;;;;1,0;;;;;;;;;;;;;;;;;;;;;;;;;;;5,0;;;;;;;;;;;;;;;;;;;2,0;1,0;3,0;;;;;;;;;;;;;;;;6,0;;;;;;;;;;;;;;;3,0;;4,0;;;;;;;34,0;;;;;;7,0;;;;;;;3,0;;;;4,0;;;;12,0;;;;;1,0;;;;;;;3,0;;;;;;;;;;2,0;;;;;;;1,0;;;;;2,0;;;;;;;;;;;;;1,0;;2,0;;;;1,0;;;;5,0;;;;2,0;;;;;;;;32,0;;;1,0;;;;;;;;;;;;;;;;;;;;;;;;;6,0;;;;;;;;;;;;;;;;;;;;;;;;;;;;;;;;;;;;;;;;;;1,0;;;;;;;;;;;;;;;1,0;;;;;;;;;;;;;;;;;;;;;;;;;;;;;;;;2,0;;;;;;;;;;8,0;;;;;;;;;2,0
characteristic;;;;;9,0;3,0;8,0;17,0;63,0;26,0;14,0;;58,0;;4,0;139,0;;1,0;15,0;8,0;4,0;40,0;1,0;4,0;14,0;1,0;44,0;11,0;;6,0;5,0;3,0;16,0;3,0;35,0;4,0;10,0;24,0;1,0;8,0;119,0;3,0;14,0;5,0;38,0;25,0;91,0;84,0;20,0;25,0;2,0;11,0;2,0;13,0;2,0;14,0;31,0;3,0;16,0;;;2,0;15,0;;76,0;13,0;9,0;13,0;20,0;;6,0;2,0;50,0;18,0;5,0;46,0;44,0;1,0;10,0;309,0;18,0;71,0;;112,0;2,0;1,0;50,0;3,0;;13,0;187,0;;;5,0;7,0;4,0;10,0;6,0;131,0;1,0;;7,0;39,0;73,0;6,0;;345,0;12,0;12,0;30,0;;16,0;19,0;;1,0;156,0;18,0;34,0;;23,0;1,0;;1,0;35,0;17,0;17,0;;90,0;1,0;9,0;37,0;15,0;1,0;1,0;13,0;6,0;6,0;4,0;5,0;1,0;13,0;;;33,0;6,0;13,0;;8,0;37,0;2,0;7,0;;76,0;140,0;18,0;;50,0;;3,0;3,0;3,0;65,0;274,0;3,0;3,0;;60,0;35,0;15,0;8,0;4,0;;;;40,0;3,0;8,0;1,0;2,0;;1,0;56,0;;;1,0;3,0;;21,0;;;;;;3,0;;;4,0;7,0;;7,0;;;30,0;;2,0;14,0;;3,0;9,0;4,0;;;2,0;;2,0;8,0;;;4,0;2,0;1,0;22,0;;;;;;;141,0;;17,0;;3,0;4,0;;1,0;37,0;;;;;;;21,0;1,0;;;1,0;90,0;1,0;;;;;;4,0;89,0;22,0;;;;1,0;;39,0;3,0;3,0;16,0;;4,0;;;31,0;26,0;;15,0;;2,0;3,0;3,0;9,0;7,0;;;;;11,0;;;4,0;2,0;1,0;6,0;1,0;;;8,0;9,0;;;;10,0;;2,0;;1,0;;;9,0;;6,0;;2,0;;;25,0;5,0;;;;6,0;;;;;3,0;;;;;;;;3,0;;;85,0;;;4,0;;;;;1,0;;1,0;;1,0;;20,0;;2,0;;4,0;;;;31,0;;3,0;;5,0;;;;;;4,0;;2,0;1,0;;;2,0;;;;;2,0;2,0;;;42,0;;;7,0;;;5,0;5,0;;15,0;4,0;;;112,0;;7,0;1,0;3,0;;;10,0;5,0;;;2,0;;4,0;55,0;5,0;5,0;34,0;;27,0;;;2,0;;4,0;3,0;;1,0;7,0;;5,0;;29,0;3,0;15,0;;29,0;4,0;2,0;14,0;;22,0;11,0;1,0;2,0;7,0;44,0;3,0;;;16,0;27,0;;;1,0;3,0;2,0;;;;1,0;2,0;;;6,0;4,0;;2,0;;;;;1,0;11,0;13,0;2,0;;;7,0;12,0;4,0;15,0;;;1,0;21,0;1,0;5,0;;1,0;;;1,0;;3,0;;4,0;32,0;2,0;8,0;;;1,0;;;;2,0;;19,0;13,0;4,0;;;4,0;2,0;;;;20,0;2,0;;;;;;;;2,0;6,0;;22,0;16,0;;;1,0;;4,0;;;;;39,0;9,0;2,0;1,0;;;;2,0;;4,0;11,0;4,0;;;2,0;;5,0;1,0;;3,0;;1,0;;;;;26,0;;;;1,0;1,0;;1,0;4,0;10,0;11,0;;;7,0;;;1,0;;4,0;1,0;9,0;1,0;10,0;1,0;;;;;2,0;;1,0;;4,0;;;;;;4,0;;4,0;;;4,0;;;;7,0;;;3,0;;;;;2,0;;1,0;1,0;1,0;;5,0;1,0;;26,0;5,0;;4,0;1,0;;1,0;;1,0;;3,0;;1,0;;;4,0;1,0;;4,0;;;;15,0;;;;;1,0;2,0;;1,0;;;;;;;5,0;37,0;;;5,0;;;10,0;;3,0;3,0;2,0;;;;;3,0;;;;14,0;;;;8,0;;;;4,0;4,0;;;;;;;;;;;;;;1,0;;;;;;;1,0;;;;;;;;;;;;;;1,0;;35,0;2,0;1,0;1,0;;4,0;;4,0;;;;;;;2,0;;;;;7,0;;;;;2,0;;;;;7,0;1,0;2,0;;;1,0;4,0;;;;;;;;7,0;37,0;;1,0;;;;9,0;16,0;6,0;;;;2,0;;;56,0;;9,0;;8,0;1,0;;;;2,0;;8,0;;;1,0;4,0;12,0;5,0;2,0;;4,0;;1,0;3,0;;7,0;2,0;;6,0;;1,0;30,0;5,0;27,0;3,0;8,0;;;;;4,0;6,0;;12,0;;;4,0;;;;;1,0;;;;2,0;;;;;;;3,0;;;2,0;3,0;1,0;;;5,0;;;7,0;;;;8,0;2,0;;4,0;;;19,0;;4,0;;;;;1,0;;;2,0;10,0;;;4,0;;15,0;;;;7,0;;;;;6,0;3,0;21,0;1,0;;4,0;;;10,0;;;;;;;;;2,0;;;3,0;6,0;;;2,0;;;5,0;;1,0;;;;2,0;8,0;1,0;8,0;;;;;;25,0;;;;;8,0;2,0;;4,0;;2,0;;;3,0;;;;;;;;;;;;118,0;3,0;;;;;;;1,0;;7,0;;;;;;1,0;1,0;10,0;;;;;;;1,0;;18,0;;;;;;;;;
classify;;;;;2,0;1,0;;3,0;6,0;1,0;;;1,0;1,0;;6,0;;;1,0;;;1,0;1,0;;;;5,0;;;;2,0;4,0;8,0;;;;;2,0;1,0;;16,0;;;;13,0;5,0;;;;1,0;;3,0;;1,0;;;2,0;1,0;;;;;;;4,0;1,0;3,0;7,0;6,0;4,0;1,0;;4,0;;;23,0;7,0;;;61,0;;1,0;1,0;7,0;1,0;1,0;;;;1,0;2,0;;;;;1,0;;;30,0;;3,0;;;28,0;1,0;;;;2,0;2,0;;1,0;;;1,0;17,0;3,0;3,0;1,0;2,0;;;1,0;4,0;8,0;6,0;;13,0;;;;;;;;;1,0;1,0;4,0;;1,0;2,0;;12,0;;;;;1,0;7,0;;;;11,0;1,0;;8,0;;1,0;;;;13,0;;;;2,0;;;;;;;;;;;;;;;;;;;;;2,0;;;;;;;;;2,0;;;;;;2,0;;;;;;;3,0;;;;;;;;;;;;;;;;;;;1,0;;;;;;;;3,0;;;;;1,0;;;;;;3,0;49,0;;;;;;;;;;;;;;;6,0;;;5,0;;;;;1,0;8,0;;;;;;;;;;;;;4,0;4,0;;2,0;;2,0;3,0;;;;;;;;;;;;;;;;5,0;;1,0;;;;;;1,0;;;;;;;;;;;;;;;;;;;;1,0;;;;;;;;;;;;;;1,0;;;;;;;;;;2,0;;;;;;;;;;;;;;;;;;;;;;;;;;3,0;;;;;;1,0;2,0;;;;;;;;;;;;;;;;1,0;;;4,0;1,0;;;;1,0;;1,0;;;;8,0;1,0;;;;8,0;;;;8,0;4,0;;2,0;;;;;;;;;;;;2,0;3,0;3,0;;;;;;1,0;4,0;;;;;;;;;;;;;1,0;9,0;;;;;;;;;;;;;;;;;;;;;;;1,0;;;;;;;;;;;3,0;2,0;;;;3,0;;;;;;;;;;;;;;;;;;;;8,0;;;2,0;;;;;;;;;;;;;;;2,0;;;;;;;;;;;;;;;3,0;;18,0;;2,0;;;;;;3,0;;;;;;;1,0;;;2,0;8,0;;;;;;;;;;;;;;;4,0;;;;;;;;;;;;;;6,0;;;;;;2,0;;1,0;;1,0;;;6,0;;;1,0;;;;;;1,0;;1,0;;;;;;;;;4,0;;;;;;;;;;;;;;;;;;1,0;;;;;;;;;;;;;;;;;;;;1,0;;;;;;;;;;;;;;;1,0;;;;;;;;;;;;;;;;;;;;;;;;;;;;;;;;;;;3,0;;;;;;;;;;;;;;;;;;;;;;;;;;1,0;;;;;;;;;;;;3,0;;5,0;3,0;;;;;;;;1,0;;;;1,0;;;;;;1,0;;;;;;;;;;;;;;;;;;;;1,0;;;;1,0;3,0;;;;;4,0;3,0;7,0;;;;;;;;;;;;;;;;;;;;;;;;;;;2,0;;;;;;;;;;;;;;;;;;;;;;;;;;;;;;;;;;;;;;;;;;;;;;;;;;;;;;;;;;;;;;;;;;;;;;;;1,0;;;;;;;;;;;;;;;;;;;;;;;;;;;;;;;;;;;;;;;;;;;;;;;;;;;;;6,0;;;;;;;;;;1,0;;;;;;;;;;;;;;
communications;;;;;1,0;;;6,0;;2,0;;;6,0;;;15,0;;;;;;18,0;;2,0;;;;1,0;;;6,0;;30,0;;25,0;6,0;;;;;46,0;;;;;1,0;21,0;202,0;24,0;26,0;1,0;;;;;;;;;;;2,0;1,0;4,0;1,0;1,0;;;;;8,0;;2,0;;;2,0;2,0;;;26,0;;2,0;1,0;14,0;;3,0;;;;;4,0;;;;;3,0;12,0;;27,0;16,0;;1,0;13,0;3,0;;16,0;;;;;;7,0;;;;13,0;5,0;29,0;3,0;2,0;;;2,0;5,0;20,0;;;;1,0;;;;5,0;;;;;5,0;;;2,0;3,0;11,0;6,0;;;;;22,0;;;;8,0;19,0;;2,0;53,0;;;9,0;1,0;23,0;16,0;;;;5,0;1,0;1,0;;1,0;;2,0;;;2,0;;;;;3,0;1,0;1,0;;;35,0;;13,0;;;2,0;1,0;;15,0;;1,0;4,0;;;;;1,0;;1,0;;;;;;1,0;;;;;;;;;1,0;;4,0;;;;;;;;3,0;;1,0;;;1,0;1,0;;;;;2,0;;;;;;;;;;1,0;;;;;;;37,0;;;;;;2,0;16,0;;;;;;;;1,0;;;;;;;;;3,0;;2,0;;;3,0;1,0;;;;2,0;;;;1,0;;;;4,0;;;1,0;;;;;;;;;;;3,0;;;;;21,0;;20,0;;;;;;1,0;;;;;;;;;;;;;;;;;;3,0;;12,0;2,0;1,0;;;;;;;;;;;20,0;;;;;;;;;;;;;;;;;;;;;;;;;;;;;;;8,0;;9,0;;;;3,0;;;;;;;1,0;5,0;;;;;2,0;;2,0;;;;3,0;;;;;;;;1,0;;;;;;;;;8,0;;;6,0;;;;5,0;;;;;;76,0;3,0;4,0;;;1,0;;;;1,0;;5,0;15,0;;;;;;;;;;;;;;;;;2,0;22,0;2,0;;;;;;;6,0;;;;;;;;;;;4,0;;2,0;10,0;;45,0;;;;5,0;;6,0;;;;;;2,0;4,0;;8,0;1,0;;;1,0;;;4,0;4,0;2,0;;;;1,0;;;9,0;1,0;1,0;;2,0;;1,0;;;2,0;;;;;;;6,0;;6,0;;1,0;;;;;;;1,0;;;;;;;;;4,0;18,0;27,0;;;;6,0;3,0;3,0;;2,0;;;;;;;;;11,0;;;;;;1,0;;;1,0;;;1,0;4,0;;;1,0;3,0;;1,0;;;2,0;;;;;;;;6,0;;;;30,0;;;;;;;;;;1,0;;;;1,0;;8,0;8,0;2,0;;;;;;;;;;;;;2,0;;148,0;;;2,0;;;1,0;;;2,0;;;1,0;1,0;;;;;;4,0;;;;;;;;;;;;;;;;1,0;;;;;;;;;;;;2,0;;;;4,0;;;;;;;;5,0;;;;;;;;;;;2,0;;;;;;;;;;1,0;;;;;;;;;2,0;;;1,0;;;;;;;;;;;;;;1,0;;;;;;4,0;;;;;;4,0;;;;;;;;;;;;;;;;;;;;1,0;;;;;;;;;;;;;;;;;1,0;;;;;;;;;;;;;;;;;3,0;;;;;;;;;;;;;;;;;;1,0;;;;;;;;;;;;;;2,0;;;;;;;;;;;;;;;;;;;;;1,0;;;;;;;5,0;;;;;2,0;;;;1,0;;;;;;;1,0;;;;;;;;;;;;4,0;;;;;;;;;;;;;;1,0;;;;;;;;;;;;;;;;;;;;;;;;;;;;;;;;5,0;;;;;;;;;;;;;;;;;;;;;;;;;;;;;;;;;;;;;;;;;;
comparator;;;;;1,0;;;3,0;;45,0;6,0;;18,0;15,0;;9,0;;;;6,0;5,0;;4,0;;;;3,0;;1,0;;;;121,0;;44,0;;;5,0;;;5,0;1,0;;;;;37,0;21,0;26,0;;48,0;;;;;1,0;2,0;;1,0;;;;;;;;;1,0;1,0;;;;15,0;;;;2,0;;;11,0;;21,0;;147,0;;;;;;1,0;;;6,0;;;;6,0;;18,0;;;;5,0;;;3,0;;5,0;279,0;;;6,0;;;44,0;167,0;19,0;;2,0;16,0;;;35,0;11,0;;;;;;;;85,0;3,0;;;;35,0;;7,0;;;;;3,0;;;;2,0;261,0;;;;10,0;52,0;8,0;12,0;12,0;;1,0;;;6,0;68,0;;;;;;;;;;;4,0;;8,0;;;;;;;;;1,0;50,0;;;;;;;;29,0;;;;;;;;;1,0;8,0;;;3,0;;;;;;;4,0;;;;;;;;;;;;;;;7,0;;;;;;;;2,0;;;;;;;;1,0;;;;59,0;;;;;;;6,0;20,0;;;;;;;3,0;3,0;;;;;;;3,0;;;;;11,0;;12,0;2,0;23,0;4,0;12,0;;;139,0;;;;;;6,0;;;;;;;2,0;;;;;;;;17,0;;;;;;2,0;;;;;;;7,0;;;;;;;;;;;;;;;;2,0;;;9,0;;;;2,0;12,0;1,0;;;;16,0;;;;;9,0;;;;38,0;;;;;;;;;16,0;;;;;;;;;;;;;;;;;;;;;;7,0;2,0;;;;;;;;;;;;;;1,0;;;1,0;;;5,0;15,0;;146,0;;;;;;;;;;;8,0;;;;1,0;;;;98,0;15,0;;;;2,0;4,0;;;2,0;;;;;9,0;35,0;;;;;4,0;;;;;;;;;4,0;;;;;;;;14,0;;;;8,0;;;1,0;;;115,0;;;;;;;238,0;;2,0;;;;;;;;;;2,0;1,0;;;;;;;;;;20,0;;;;;;;1,0;;;;;;;;4,0;;;;;;;1,0;156,0;;;3,0;;1,0;;2,0;;;;;;;;;;;;;;;;;10,0;;;;;;;2,0;;;;;2,0;;;1,0;1,0;3,0;;;1,0;;;;;;;;;;;;1,0;;;30,0;;;;2,0;;;;;1,0;;;;;;;;;;;;;;;9,0;;;;;;16,0;1,0;;;;;;;;;5,0;;;;;;;;;;;;;5,0;1,0;4,0;;;;;6,0;;;;;;;;;;;14,0;;;7,0;;;;;;;;;;;;;;;;;;;;;;;;71,0;;;;;;;;;14,0;;;;;;;;;;;;;;;;;;;;;;;1,0;;;;;;;63,0;2,0;;5,0;4,0;;;;;;;;10,0;;;;2,0;;;1,0;;;;;;;;;5,0;;;1,0;;;22,0;1,0;45,0;2,0;;;34,0;1,0;;;;;;;2,0;;;5,0;;6,0;;;;;;;;;;;;32,0;5,0;;;;;;;;;;;;5,0;;;;;;;;;;;;18,0;;;;;;;43,0;14,0;;;;;;5,0;;;;;;;;;;;;;;;;;;85,0;;;;;;;;;;;;;;;;;;;;2,0;;;;;;;;;;;;;;;;;;;;;;;;;;;;1,0;;;;;2,0;;;;;;;;;;;;;;18,0;;;;;;;2,0;;3,0;;;;;;;;;;;;;;;;;;;;;;;;;;;;;;;;;;;1,0;;;;;;;;;;;;;;;;;;;;;1,0;;;;;;2,0;;;;;;;;;;;;
compare;;;;;2,0;21,0;1,0;9,0;49,0;3,0;13,0;;24,0;2,0;;47,0;;3,0;21,0;1,0;2,0;73,0;13,0;1,0;1,0;10,0;31,0;;9,0;;17,0;10,0;123,0;5,0;22,0;6,0;3,0;1,0;;3,0;170,0;1,0;7,0;10,0;49,0;8,0;97,0;75,0;43,0;23,0;3,0;22,0;;8,0;;27,0;11,0;12,0;7,0;;2,0;;12,0;4,0;1,0;4,0;22,0;11,0;80,0;;18,0;2,0;24,0;;2,0;10,0;18,0;1,0;4,0;611,0;3,0;1,0;;90,0;7,0;30,0;;4,0;2,0;19,0;14,0;;5,0;5,0;20,0;13,0;8,0;;105,0;12,0;36,0;;40,0;77,0;;10,0;13,0;4,0;34,0;21,0;1,0;30,0;;1,0;6,0;68,0;39,0;49,0;8,0;61,0;;;22,0;20,0;25,0;7,0;2,0;3,0;6,0;13,0;4,0;208,0;11,0;;9,0;4,0;8,0;6,0;14,0;3,0;8,0;3,0;3,0;26,0;18,0;;;5,0;245,0;20,0;;;25,0;69,0;14,0;14,0;39,0;;13,0;4,0;2,0;5,0;93,0;2,0;;;58,0;17,0;3,0;4,0;2,0;;;5,0;35,0;7,0;;;;;6,0;;;;;21,0;;13,0;;;;;;4,0;;;6,0;3,0;2,0;;;1,0;113,0;13,0;18,0;;3,0;;14,0;11,0;1,0;;;2,0;;;2,0;;7,0;;;3,0;1,0;;1,0;;;1,0;39,0;;1,0;;;1,0;;2,0;15,0;2,0;;;3,0;;;;11,0;;;3,0;195,0;3,0;4,0;;;;;;52,0;2,0;;;;;;18,0;;1,0;14,0;4,0;;;1,0;14,0;4,0;;1,0;;;;1,0;20,0;;11,0;5,0;1,0;;61,0;2,0;;3,0;;29,0;;;;;;3,0;;;;;3,0;;;;;5,0;19,0;;3,0;;4,0;;;5,0;6,0;;;;1,0;;;;;2,0;;;;;;3,0;;;;;19,0;;;1,0;;;;;8,0;4,0;;8,0;4,0;;26,0;6,0;2,0;;;;;2,0;32,0;;;4,0;;;;;;52,0;;;10,0;2,0;;;3,0;;;;;;6,0;;;;;1,0;;;;;;10,0;28,0;21,0;;;;;6,0;6,0;;1,0;;7,0;7,0;;1,0;1,0;7,0;20,0;51,0;26,0;14,0;;;31,0;;;1,0;;;;17,0;6,0;19,0;;5,0;1,0;92,0;11,0;2,0;;75,0;38,0;;67,0;4,0;35,0;15,0;20,0;3,0;9,0;41,0;2,0;;6,0;6,0;23,0;1,0;9,0;15,0;2,0;;2,0;7,0;12,0;10,0;2,0;;;4,0;9,0;;1,0;5,0;;;2,0;;85,0;33,0;3,0;1,0;2,0;3,0;13,0;;18,0;;104,0;2,0;13,0;1,0;16,0;;11,0;15,0;;;;1,0;;5,0;14,0;3,0;5,0;3,0;;2,0;1,0;;;;10,0;24,0;9,0;14,0;;;25,0;1,0;1,0;3,0;;4,0;2,0;1,0;;;5,0;36,0;1,0;1,0;;2,0;2,0;12,0;15,0;;17,0;19,0;8,0;55,0;;;;;8,0;9,0;1,0;;9,0;;;12,0;7,0;2,0;9,0;;;10,0;;;3,0;47,0;;6,0;;;;;1,0;2,0;;34,0;;44,0;;;;;6,0;4,0;;2,0;;;;;;4,0;6,0;;5,0;1,0;4,0;;;6,0;;;18,0;1,0;;;;1,0;;7,0;6,0;5,0;1,0;;5,0;;;;1,0;;;;;2,0;;;;;;5,0;;1,0;5,0;1,0;;15,0;6,0;;30,0;1,0;;15,0;5,0;;;3,0;3,0;;;;2,0;;7,0;1,0;;2,0;18,0;;;;4,0;2,0;10,0;4,0;;;;;;;;;4,0;5,0;;;10,0;;1,0;10,0;;1,0;1,0;;;2,0;;2,0;;1,0;;;;;9,0;;;1,0;2,0;2,0;1,0;;5,0;1,0;;;;;;26,0;1,0;;;;4,0;;;;1,0;7,0;2,0;;;;3,0;1,0;;;;;;;;;;;2,0;1,0;;17,0;;1,0;;;7,0;;2,0;;;;;;1,0;;2,0;1,0;;;;;;3,0;;;1,0;;;3,0;4,0;1,0;2,0;11,0;;4,0;1,0;48,0;;;;8,0;;;;;30,0;43,0;;1,0;1,0;;1,0;11,0;1,0;3,0;;;;6,0;1,0;9,0;1,0;17,0;2,0;2,0;13,0;5,0;3,0;;;;1,0;1,0;21,0;7,0;6,0;3,0;;;;;19,0;1,0;;10,0;;19,0;2,0;;;2,0;;3,0;;;;7,0;4,0;10,0;;3,0;;;;10,0;;;6,0;;;;;3,0;;;;;;5,0;;2,0;;1,0;2,0;1,0;;;;;;6,0;3,0;;;;;;;9,0;;;;;;5,0;1,0;1,0;1,0;;;;;;;;7,0;;9,0;;;4,0;;;4,0;17,0;;;;;3,0;20,0;4,0;;;;;7,0;1,0;;;;;;;;;;2,0;;8,0;;3,0;;;;;21,0;;13,0;;146,0;;3,0;14,0;3,0;;;1,0;;10,0;;1,0;1,0;;;;;;;5,0;;1,0;;;;;;;;;7,0;;;1,0;;;3,0;;3,0;2,0;;;;;7,0;1,0;;;11,0;;;;14,0;;16,0;;;;;;4,0;;2,0;1,0;;;;;;;;;
composite;;;;;2,0;;;1,0;20,0;;29,0;;6,0;;;41,0;1,0;;;;;10,0;1,0;1,0;;;1,0;;;;2,0;109,0;17,0;;11,0;4,0;;1,0;10,0;;12,0;4,0;16,0;1,0;;;30,0;11,0;55,0;46,0;;1,0;;;;1,0;25,0;2,0;;;;;7,0;;1,0;242,0;20,0;41,0;21,0;2,0;2,0;;42,0;1,0;;21,0;2,0;1,0;;295,0;;;1,0;53,0;;2,0;;;;277,0;302,0;;;2,0;;2,0;8,0;;50,0;;1,0;;8,0;11,0;;;15,0;8,0;16,0;17,0;;1,0;;;;15,0;14,0;16,0;12,0;6,0;;;5,0;9,0;13,0;1,0;;;;6,0;;8,0;2,0;1,0;;1,0;;;;103,0;11,0;;;;1,0;;;5,0;1,0;1,0;;8,0;;19,0;3,0;;72,0;;;;9,0;;100,0;;;;44,0;26,0;;;1,0;;;4,0;4,0;5,0;;;;;;2,0;;;;2,0;;4,0;4,0;;;;;;;;8,0;;;;;;4,0;4,0;;;;;;;;;;;;;;;;;1,0;;;;;;13,0;;1,0;;1,0;;;1,0;;3,0;;;;;3,0;;;1,0;;;;;7,0;;;;;;;;7,0;;;;;;;23,0;;;;;;;;;2,0;;;;;1,0;;14,0;6,0;;1,0;;;8,0;;;;;3,0;;;;;;;;;;;;;;;;;2,0;;8,0;;;3,0;;;15,0;;;;;;1,0;;;;;;;;;;;;;;1,0;;;1,0;;;;2,0;1,0;5,0;;;;2,0;;;2,0;;;;;1,0;;;;;;;;;;;2,0;;;;;;;;;;;;19,0;;;;;;;;;;;;7,0;;;;;;;;;2,0;;;;;;;6,0;2,0;5,0;;;;;12,0;;1,0;;;;;1,0;;;13,0;;;4,0;;;;1,0;;;5,0;;;;10,0;;;2,0;3,0;;;;2,0;;21,0;12,0;;;;;4,0;3,0;1,0;50,0;;;;;;;;;;;1,0;7,0;1,0;;;;3,0;;5,0;;;;;;3,0;;12,0;;1,0;;;3,0;;2,0;;1,0;;;;;3,0;;;;;1,0;;;;;1,0;;1,0;3,0;;;22,0;;;;;;1,0;;;;;;1,0;;;;;;6,0;;;;3,0;4,0;;;;;;;7,0;11,0;;;;3,0;;;;1,0;;;;;;;;;;;;;;;;;;;;;;;;;;;;;;7,0;;;;;;1,0;;1,0;;;;;;1,0;;;;5,0;31,0;;;5,0;;;;;;;;;;;;;;1,0;;3,0;;;;;20,0;;;1,0;;;1,0;3,0;;;;;2,0;;2,0;;;;;;;;7,0;;;;;;;;;;;;;;;;;;;4,0;;;;;;;;;;;;;;;;;;;;;;;;4,0;;;;;;;;;;;;;;;1,0;;;;;;;;;;;;;;;;;;40,0;;1,0;;;;;;;1,0;;;;;;;;;;1,0;;;;;;3,0;;;;;;;;;;;1,0;;;1,0;6,0;;;3,0;;;;;;2,0;;;;;56,0;;;;;;;1,0;6,0;;;19,0;;;;;2,0;;;;2,0;;18,0;;;;1,0;;;;;3,0;3,0;;33,0;;;;;;;;;;;1,0;;;2,0;;;;;;;;5,0;;;;;;;;1,0;;;;;;;;;1,0;7,0;1,0;;;;;;;;;;;;1,0;5,0;;3,0;;;;;;;;;;;;;;;;;;;;;;;;;;;;4,0;;;;;;;;4,0;;;;;;;2,0;;;;;1,0;;;;;;;3,0;1,0;1,0;;;;2,0;;;;;;;;;;3,0;;;;;;;;;3,0;;;;;;;;1,0;;;;;;1,0;;;;;;;;;2,0;;;;;1,0;3,0;;;;4,0;;3,0;;;;;;;;;;;;;;;;
compound;;;;;2,0;;2,0;4,0;2,0;1,0;4,0;;;;;2,0;;;;;;;;;2,0;;5,0;1,0;1,0;;;1,0;2,0;;;;;1,0;;;;;;3,0;;;2,0;18,0;;3,0;2,0;5,0;;;;;10,0;;1,0;;4,0;;;;13,0;;;10,0;;;;;3,0;;;17,0;;;;46,0;;8,0;;5,0;;;;;;;17,0;;;4,0;;;;;6,0;;;;15,0;4,0;;;6,0;4,0;;;;;;;;1,0;2,0;3,0;;;;;;;;;;;;;;;;;10,0;;1,0;;;2,0;;;;17,0;;;;5,0;4,0;;;17,0;;;;;9,0;;;;;;1,0;;;;;6,0;;5,0;2,0;5,0;;;;;6,0;;;;;;;;;;;1,0;;;;;1,0;1,0;2,0;;3,0;;;7,0;;;;13,0;;;;;;2,0;;;;;;;;;;;;;1,0;;;;121,0;;3,0;;;3,0;;7,0;;;2,0;;;1,0;;;;;;;;;;;1,0;;;;;;;;;;;5,0;;3,0;3,0;;;1,0;;;;;;;;;;;4,0;1,0;2,0;;;;;;;;;17,0;;;;;;;4,0;;;;;;9,0;;;;;1,0;;;;;;;;;;;;;;;;;;;;;;;;;;;;;;;;;;;;;;10,0;;;2,0;;;;;;;;;;;;;;;;;;;;;;;;;;;;3,0;;;;;;;;;1,0;;;;1,0;;1,0;;;1,0;;;;1,0;;;;;2,0;;;;;;;;;;;2,0;;;;;;;;1,0;;;;;;;;;;;;;;;;;;;;;;;;;;1,0;;;;;;;1,0;;;;;;;;;;;;;;;;;;;1,0;;;;;;;;;;;;;;;;;;;;;;;;;;;;;;;;;;;;;;;;;;;;;;;;;;;;;;;;;;;;;1,0;;;;;;1,0;;;;7,0;;;;;;;;;;;;;;;;;;;;;;;;;;;2,0;;;;;;;;;;;;;;;;;;;;;;;;;;;;;;;;;;;;;;;;;;;;;;;;;;;;;;2,0;;;;;;;;;;;;;;;;;;;;;;;;3,0;;;;;;;1,0;;;;;;3,0;;;;;;;;2,0;6,0;;;;;;;;;;;;;;;;;;;;;;;;2,0;;;;;;;;;;;;;;;;;;;;;;;;;;;;;;;;;;;;;;4,0;;1,0;;;;;;;;;;2,0;;;;;;;;;;;;;;;;;;;;;;;;;21,0;;;;1,0;;1,0;;6,0;;;;;;;;;;;;;;;;;;;;;2,0;;;;5,0;;;;;;;;;;;;;4,0;;;;;;;;;;;;;;;2,0;;;;;;;;;;;;;;;;;;;;;;;;;;;;;;;;;;;;;;;;;;;;;;;;;;;;;;;1,0;;;;;;;;;;;;;;;;;;;;;;;;;;;;;;;;;;;;;;;;;;;;;;;;;;;;;;;;;;;;3,0;;;;;;;;;;;;;;;1,0;;;;;;;;;;;2,0;;;;;;;;;;3,0;;;;;;;;;;;;;;;;
content;;;;;22,0;;;29,0;18,0;1,0;;;58,0;;;49,0;;;3,0;;;82,0;4,0;5,0;1,0;;6,0;5,0;;;12,0;1,0;35,0;2,0;42,0;12,0;;1,0;20,0;;53,0;;1,0;5,0;4,0;;24,0;144,0;204,0;184,0;;2,0;;;;4,0;2,0;;6,0;1,0;1,0;1,0;2,0;14,0;4,0;;;11,0;30,0;;4,0;3,0;28,0;;3,0;25,0;70,0;;;358,0;;3,0;1,0;90,0;;6,0;;;;;1,0;2,0;;;3,0;2,0;15,0;14,0;92,0;15,0;11,0;16,0;12,0;48,0;;4,0;;15,0;104,0;3,0;16,0;14,0;;;;29,0;33,0;2,0;;;;;12,0;6,0;16,0;15,0;2,0;;;;;;6,0;;40,0;10,0;16,0;8,0;;3,0;6,0;4,0;16,0;1,0;1,0;;;;2,0;5,0;;;15,0;59,0;2,0;;80,0;;6,0;33,0;11,0;22,0;38,0;33,0;;;178,0;53,0;2,0;2,0;;2,0;;;1,0;1,0;;;;;;;;;;;;8,0;;3,0;10,0;;;3,0;;;;;;;;1,0;;;;;;;;4,0;;;2,0;;;;;;;;;;;;;;10,0;;1,0;;;;1,0;;;12,0;;9,0;;;4,0;;1,0;;;;;;4,0;;;1,0;;;;;91,0;;;;;1,0;1,0;80,0;;5,0;;;;;;10,0;;;;;1,0;6,0;;;2,0;10,0;5,0;;;26,0;1,0;3,0;;;2,0;;;;;;13,0;;;;;3,0;;;;;;8,0;;;;;;;;3,0;;;1,0;;;;;;1,0;;;;;;;;;;;11,0;;;;;;;;16,0;;2,0;;;;;;;;;;;8,0;17,0;11,0;;;;;;;;;;;;;;;4,0;2,0;;;;;;;;3,0;;;;;;;1,0;;12,0;4,0;;;8,0;;;;;;;19,0;1,0;;;1,0;;;;2,0;1,0;6,0;8,0;18,0;;;;;;;;;;6,0;32,0;;;;;;23,0;4,0;;8,0;;10,0;1,0;;1,0;8,0;2,0;5,0;;9,0;9,0;3,0;;;16,0;;;;;33,0;3,0;23,0;7,0;;;;2,0;;;;;;;13,0;;;;1,0;2,0;89,0;;;;;;3,0;2,0;5,0;;;;;5,0;;;;4,0;;6,0;9,0;3,0;1,0;3,0;34,0;;1,0;5,0;26,0;3,0;8,0;;;;;;1,0;11,0;;29,0;19,0;;;;1,0;;4,0;1,0;;1,0;;1,0;47,0;;;;;;;2,0;;;13,0;;;1,0;1,0;;;;9,0;;;6,0;;9,0;1,0;;24,0;70,0;2,0;;;;;;;1,0;;4,0;;14,0;8,0;15,0;4,0;5,0;21,0;;7,0;;;4,0;;;5,0;;;;;;1,0;;;;;;2,0;;;;2,0;;4,0;19,0;;;;2,0;72,0;3,0;;6,0;;;;;;;;;2,0;;;4,0;6,0;3,0;;;;10,0;;;5,0;44,0;1,0;1,0;;;;5,0;6,0;4,0;8,0;;4,0;;2,0;;1,0;;16,0;;;;;9,0;;62,0;;;;;;;;;;;;;;;;;;;1,0;;;1,0;;;;;;;;;;;;;;;;;;;;;;1,0;;;3,0;;;;;;;;;;;;;;;;;;;;;;;;;;20,0;;;;;;;1,0;;20,0;;;;;;;4,0;;;;;;;;;;;;;;;;;;35,0;;;;;;4,0;1,0;;;;;;;;;;;;;;1,0;6,0;2,0;;;;;1,0;;;8,0;2,0;;;;;;;;;;;;;;2,0;;;;3,0;5,0;;;;13,0;;;6,0;;;;;;1,0;;;;;;;;;;;;;;;;;;;;3,0;;2,0;;;;;;;12,0;2,0;;;;;;5,0;;3,0;;1,0;;;;3,0;1,0;;;;;1,0;;;;;;;;;;;1,0;;7,0;;6,0;3,0;;;2,0;;;;;3,0;;;;;;;;;;;;;;;;;;;;;;;3,0;;;;;;6,0;;;;;3,0;;45,0;;;;;;;3,0;1,0;;;;;;6,0;;4,0;;;;;1,0;;;;26,0;;;;;;15,0;;;2,0;15,0;;;;;;;3,0;;;;;1,0;8,0;2,0;;;;;;;;2,0;2,0;;1,0;;;;;;12,0;1,0
context;;;;;7,0;;;1,0;;;;;24,0;6,0;;29,0;;;;;;6,0;;;;;;2,0;;;4,0;;10,0;;;1,0;;;6,0;;5,0;;;;2,0;;19,0;17,0;75,0;3,0;;3,0;;;;;;;7,0;;;;;;;;;2,0;1,0;;1,0;;;;;;4,0;;;53,0;;5,0;;4,0;;;;;;;;;;;1,0;;7,0;;29,0;;;2,0;4,0;16,0;;;1,0;;;;;1,0;;;;14,0;;1,0;;10,0;;;;1,0;8,0;;;;;;;;;;;;1,0;4,0;;;41,0;;;2,0;8,0;;;;;;2,0;;3,0;5,0;;;4,0;;;;3,0;;;;;;;;1,0;;1,0;;;;;1,0;;;;;;;;;;;;;;;;;;1,0;;;;;;;;1,0;;;;;;;1,0;;;;;;;;;;;;;;;;;;;;;;;;;;;;;;;;;;;;;;;;;;;;;;;;8,0;;;;;;;17,0;;;;;4,0;;;;;;;;;1,0;;2,0;;;;;;1,0;;;;;;;;;;;;;;;;;;;;;;;;;;;;;;;;;;;;;;;;;;;;;;;;;;;;;;;;;;;;;;;;3,0;;;12,0;;;;;;;;;;;;;;;;;;;;;;;;;;;;;;;;;;;;;;;7,0;;;;;;;;;;;;;;;;;;;;;;;;;;;;;;;;2,0;;;;;;;;2,0;1,0;;6,0;;14,0;;21,0;;;;;;;2,0;;;;;;;;;;;;;;;16,0;;;;;;;;;1,0;;;;;12,0;;;;;;;;;;;;;;1,0;;;2,0;6,0;;9,0;;;;2,0;;;;;;;;;;;;;;;;;;;;;;;;;;;;3,0;;;;;;;;;;;;;;;;;;;;;;;;;;2,0;;;;;;;4,0;;;;4,0;;;;1,0;;;;;;;;;;;;;;;;;;;;3,0;;;;;;;;;;;;;;;;;;;;;;;;;;;;;;;;;;;;;2,0;;;;;;;;;;;;1,0;;;;;;;;;;;;;;;;;;;;;;;;;;;;;;;;;;;;;;;;;;;;;;;;;;;;;;;;;;;;;;;;;;;;;;;;;;;;;;;;;;;;;;;;;;;;;;;;;;;;;;;;;;;;;;;;;;;;;;;;;;;;;;;;;;;;;;;;;;;;;;;;;;;;;;;;;2,0;;;;;;;;;;;;;;;;;;;;;;;;;;;;;;;;;;;;;;;;;;;;;;;;;;;;2,0;;;;1,0;;;;;;;;2,0;;;;;;;;;;;;;;;;;;;;;;;;;;;;;;;;;;;;;;;;;;;;;3,0;;;;;;;;;;;;;;;;;;;;;;;;;;;;;;;;;;;;;;;;;;;;;;;;;;;;;;;;;;;;;;;;;;;;;;;;;;;;;;;;;;;;;;;;;;;;;;;;;;;;;
count;;;;;2,0;;;1,0;18,0;4,0;1,0;;8,0;3,0;;35,0;;;;;;2,0;;;;17,0;2,0;;;;5,0;6,0;92,0;;16,0;;2,0;8,0;;;12,0;1,0;;;;1,0;22,0;19,0;8,0;;9,0;3,0;;1,0;60,0;10,0;7,0;;3,0;;;2,0;4,0;;;;;3,0;3,0;;3,0;;45,0;;;2,0;1,0;;1,0;58,0;;20,0;1,0;13,0;4,0;;;1,0;;;3,0;;8,0;;1,0;2,0;15,0;;39,0;;;;8,0;20,0;;7,0;1,0;10,0;174,0;;;70,0;;;15,0;58,0;2,0;5,0;;6,0;4,0;;6,0;2,0;;;;;2,0;1,0;;59,0;;;;6,0;31,0;10,0;11,0;;3,0;;;8,0;2,0;;;4,0;183,0;3,0;;;13,0;48,0;;4,0;13,0;;;23,0;1,0;1,0;22,0;;1,0;;2,0;1,0;;;;;;;2,0;;;;;;;1,0;;;;82,0;;;;;;2,0;;;;;;;;;;;129,0;4,0;;;1,0;1,0;;9,0;;;;;;;;;;;;;;;;;;;2,0;;;;;;;;9,0;;;;;;;;10,0;;;;86,0;;;;;;;17,0;17,0;;;;;;;6,0;2,0;;;;;;;;;;;;52,0;;;;11,0;3,0;;;;184,0;1,0;;7,0;;;1,0;;;;;1,0;;;;;;;;;;;;4,0;;1,0;;;;;2,0;;;;;;;;;1,0;;;;;;;;;;;5,0;;;21,0;;;;;15,0;1,0;;;2,0;;;;;;9,0;;;;23,0;;;;;;;;;;;;;1,0;;;;;;1,0;;;;;;;;;2,0;;;;;;1,0;;;;;;3,0;;;;1,0;2,0;1,0;;;;;1,0;3,0;1,0;33,0;15,0;;1,0;3,0;;;;;;;16,0;13,0;;;1,0;2,0;;2,0;;10,0;4,0;;1,0;3,0;;4,0;14,0;;;19,0;;;1,0;2,0;96,0;1,0;;20,0;;;;6,0;18,0;2,0;;;;;17,0;;;;;;;;26,0;;;;6,0;;5,0;;19,0;;33,0;;12,0;;;7,0;;;;;;;;;4,0;2,0;1,0;;;;;;;;;;;;4,0;;70,0;;;;;;;5,0;;;;;;4,0;;15,0;;;;;;;;116,0;;;17,0;;8,0;3,0;;;;;;5,0;;;;;;1,0;;;;;;4,0;;;;1,0;;30,0;;;;;;3,0;;;9,0;;2,0;;;7,0;;;;;;;;;;2,0;;;;;;;;;;;;;1,0;;1,0;;;;;;5,0;;;;2,0;;;;;;;;;;;;;;;;1,0;2,0;;1,0;17,0;;1,0;;;;8,0;;;;;;;1,0;;18,0;;;;;;;;;;;;;;;1,0;79,0;;;20,0;;;;;;;;;;;;;;;;;;;;;17,0;;;84,0;;;;;;;;;;;;;;;;;;1,0;;;;;;;2,0;;;;;;;;;;;;;;5,0;;;2,0;;;;;;;;;18,0;;;;4,0;;;;;;;;;;;;;;;;;3,0;;;11,0;3,0;;;9,0;;;;;4,0;;;;3,0;1,0;11,0;5,0;;;;;12,0;;;;;;;;;;;;;;;;13,0;;;1,0;;;;;1,0;;;12,0;;6,0;;;;9,0;;;;;;;7,0;16,0;;;;1,0;;;;;;;;;;;;;;;5,0;;;;;147,0;;;;2,0;;;;;;;;2,0;;;;;;;;;;;;;;;;;;;;;4,0;;;;;1,0;;;;;;;;;;;;2,0;;;2,0;1,0;;;;;;;;;;;1,0;;4,0;;;;;;;;;1,0;;238,0;;3,0;;;;;24,0;;;;;;;;;;;;;;;;;2,0;;;;;1,0;;;;13,0;;;;;;;;;;;;;;;;;;;;;;;;;1,0;;3,0;;;;;;;;;;;;
dark;;;;;5,0;3,0;13,0;5,0;28,0;;2,0;;4,0;;;7,0;;;7,0;;1,0;20,0;;;;4,0;72,0;1,0;;1,0;;1,0;5,0;;7,0;17,0;7,0;28,0;;;19,0;;2,0;;2,0;2,0;;9,0;1,0;;;;;;;7,0;;1,0;;;2,0;4,0;;;;;;15,0;46,0;;;1,0;14,0;2,0;;;6,0;5,0;;106,0;;8,0;1,0;13,0;3,0;;;;;;1,0;;;5,0;3,0;;;;38,0;;;;2,0;10,0;;;8,0;9,0;2,0;;;7,0;;;;25,0;33,0;;;3,0;5,0;;;4,0;10,0;;;;;1,0;;8,0;;4,0;;;;1,0;;;8,0;;;18,0;;;;3,0;16,0;;;;6,0;6,0;5,0;;1,0;;;;;;6,0;;;;5,0;;;2,0;;;;2,0;12,0;;;;;;;;;;1,0;;;16,0;;;;1,0;;;;;;;;4,0;;;2,0;;;;;;84,0;;;;;2,0;15,0;;;4,0;;3,0;;;;;;;;;11,0;;;;;;;;;14,0;;2,0;;;;;;1,0;;;48,0;;;;;;;;;;;;;;1,0;2,0;;;;;1,0;2,0;;1,0;3,0;;;;6,0;;2,0;6,0;;;;;;26,0;;;;5,0;2,0;;;;;2,0;4,0;;;;;;;;;;;;;4,0;;22,0;;;;4,0;;;;3,0;;;;;2,0;;;;;;;;;;;1,0;;;;;;;;3,0;;2,0;;;;11,0;;;;;;;;;;;;;;;;;;;;;;;;;1,0;;2,0;;;;;;;;;2,0;;;;;8,0;3,0;;;;3,0;;;21,0;;;;;;;;;;10,0;2,0;3,0;;;;1,0;;;;;;;;1,0;;;;;2,0;;;;3,0;28,0;;;;;;;;;1,0;;;;1,0;3,0;;;4,0;;;;4,0;;5,0;;;;;;;;;;;;;3,0;;;;;;;1,0;;;;;8,0;;;;;2,0;;;;;;3,0;;;;;;;;;;;;;2,0;;1,0;;;;2,0;;;;;;;;;;;2,0;;1,0;;;;;;;;;;;;;1,0;1,0;;2,0;;;;;2,0;;;;;1,0;;;;;8,0;;;;;;;10,0;;2,0;;;;;;;;;;;;2,0;;;;;;;;;8,0;;;;;;;;1,0;1,0;;;;;;;;;;;;1,0;2,0;;;;;;;;;;;;;;;;;;;;47,0;;;1,0;2,0;;;2,0;;;;;;;;;;;;1,0;;;1,0;;;2,0;;2,0;;;;4,0;;;;;;;2,0;;;;;;;;;;;;;;;;;;;;;;;;;;;;1,0;;;;;;;;;;;;;;1,0;13,0;;;3,0;;;;;;;;;;;;;;;;;;;1,0;;;;;;;;;;;;;;;;;;;1,0;;;;;;;6,0;;;;;2,0;;;;;;;;;;;;;;;;;;;1,0;;;;;4,0;;;;13,0;;;;;1,0;;;;;;;6,0;7,0;3,0;;;;;;4,0;;;4,0;;;;4,0;;;;;;1,0;;;;;;;;3,0;;3,0;;;;;;;;;;;;;;;;2,0;;8,0;;;;;;;;;;;;;;;;32,0;;;;;;3,0;;;;;;;;;;39,0;4,0;;;;;;;6,0;;;;;;;;;13,0;;;;;;;;;;;;;;;;;;10,0;;;;;;;;;;;5,0;;;3,0;;;;;;;;;;;;;;;;;;2,0;;;;;;;;;;;;;;;;;;;;;;;;;1,0;;;;;;;;;;;;;;;;;;;;;;;;;;
database;;;;;1,0;;;7,0;3,0;2,0;;;20,0;3,0;;14,0;;;;4,0;1,0;7,0;2,0;;;;13,0;5,0;9,0;;16,0;3,0;7,0;;;;;;6,0;;49,0;;4,0;;7,0;3,0;40,0;24,0;22,0;10,0;;1,0;;;;;3,0;1,0;8,0;;;11,0;;13,0;3,0;2,0;;;;;;2,0;2,0;;;;9,0;;2,0;134,0;;1,0;2,0;26,0;;1,0;;;;2,0;1,0;3,0;6,0;;1,0;4,0;7,0;2,0;37,0;3,0;19,0;;6,0;52,0;;;2,0;2,0;;5,0;;3,0;;;;21,0;6,0;17,0;2,0;7,0;;;2,0;3,0;17,0;;;;;;;12,0;;;3,0;1,0;2,0;5,0;;;3,0;1,0;5,0;;;;;;4,0;3,0;1,0;;6,0;107,0;;;22,0;;;;1,0;4,0;2,0;;;;17,0;;1,0;;;;;;;2,0;;;;;4,0;;;;;4,0;;;;;;;;1,0;;;;;;;;;;;;;;;;7,0;;;;;;;;;;;;;;;;;;;1,0;;1,0;;;;;;2,0;;;;;;;;2,0;;;;1,0;2,0;1,0;;;;;;7,0;;;;;;;10,0;;;;;1,0;;;;2,0;;;;2,0;1,0;;;;;;;;2,0;;;1,0;;15,0;;;;;;;;;;;;1,0;;;;;;;;;1,0;;;;;;;;3,0;;;;;;;;;;;;;;;;;;;;;;;;2,0;;2,0;;;;1,0;;;;;;;1,0;12,0;;1,0;5,0;3,0;;;;;;;;;;1,0;;;;;;;;;;;;;;;;;;;;;;;;;;;;;;;6,0;1,0;;;;;3,0;5,0;;;4,0;;2,0;;6,0;;;5,0;4,0;4,0;1,0;3,0;;;;29,0;;;;1,0;;;35,0;;35,0;;;;1,0;;2,0;1,0;8,0;;;;4,0;;;;;;;6,0;2,0;;;17,0;;;;;;;;;1,0;18,0;;1,0;;20,0;19,0;2,0;4,0;;;;;;1,0;;2,0;;;1,0;4,0;;;1,0;1,0;2,0;;;;;4,0;;;;7,0;6,0;2,0;;3,0;;;2,0;1,0;;;;;;7,0;;;;1,0;1,0;;;1,0;6,0;;;9,0;;1,0;4,0;;4,0;;;;;;;;;;;;;;6,0;;1,0;;;;4,0;;;;;;;1,0;;;10,0;;;4,0;6,0;6,0;;;;;;;;;;;;;;2,0;;;;1,0;;;;6,0;;;;;;;4,0;;;3,0;7,0;;;;;;;;1,0;;20,0;;;;;;5,0;;;;2,0;;2,0;10,0;;2,0;12,0;;;;;6,0;1,0;22,0;4,0;1,0;;4,0;;;;1,0;;2,0;;1,0;;;;;5,0;;;;;;;;;;;;;;;;;;;;;;1,0;;;;;;;;;;;;;;;;;;;;;;;;;;;;;3,0;;;;;;;;;;;;;;;;;;;;;;;;;;;;;;;;;;;;;;;;;;;;;;;;;;;;;;;;;4,0;;;;;1,0;;;;;;;;5,0;4,0;;;;;4,0;2,0;;;;;;;;2,0;;;;5,0;;;;;;;;;;;;;;;1,0;;;4,0;;;;;;;;;;;;;;1,0;;;;;3,0;;;;;;;;;;;;;;;;;1,0;;;;;;;;;;;;2,0;;;1,0;;;;;;2,0;;;;;;;;;;;;;;;;;;;;;;;;;1,0;;;;;;7,0;;;;;1,0;;;;;;;;;;;;;;;;;;;;;;;;;1,0;;;4,0;;;;;;;;55,0;;;;;;;;1,0;;;;;;;;;;;;;;;;;2,0;;;;;;;;;;;;;;;;;;3,0;;;;;;;;;3,0;;;;;;;;;
decision;;;;;2,0;;;6,0;;2,0;;;2,0;;;28,0;;;;2,0;1,0;1,0;;;;;1,0;;;;2,0;;26,0;;9,0;2,0;;4,0;;;7,0;;;6,0;5,0;;5,0;39,0;9,0;13,0;;;2,0;;4,0;;;;;;;;;;;;3,0;;17,0;;1,0;;;;;4,0;2,0;;;11,0;;6,0;;25,0;;;;1,0;;;1,0;;;;;;7,0;;7,0;8,0;;1,0;4,0;14,0;;;;;8,0;1,0;;12,0;;;;6,0;3,0;11,0;;9,0;;;4,0;5,0;;2,0;;;;8,0;1,0;30,0;;;1,0;;1,0;8,0;;;16,0;;;1,0;1,0;;;;5,0;;6,0;;;;2,0;;9,0;;;;1,0;3,0;29,0;;;;3,0;1,0;;;;;;;2,0;5,0;;;;;;5,0;;;;38,0;;;;;;;;;;;;;;;;;;1,0;;;2,0;;2,0;;;;;;;;;;;;;6,0;;;;;;;17,0;;;;;;;;;;;;;;;4,0;;;;;18,0;;;;;;;;4,0;;;;;;;6,0;2,0;;;;;;;1,0;;;;;;;2,0;;;;;;;3,0;;;;;;;;;;;;;;;;1,0;;;;;2,0;12,0;;;4,0;1,0;;;;1,0;;;;;;;;;;;;;;;;;;;;;;;;;;;2,0;28,0;;1,0;;;;;;;;3,0;;;;5,0;;;2,0;;;;;;;;;;;;;;;;;;;;;;;;;;;;;19,0;;1,0;;2,0;;3,0;;;;;;;;;;;;;3,0;4,0;18,0;;;;;;;;;;;;1,0;5,0;;;4,0;1,0;;;;10,0;1,0;;;;3,0;;35,0;;;4,0;2,0;;;3,0;1,0;;;14,0;;;;;;2,0;;;;;21,0;;;;;;;;6,0;;;;;3,0;8,0;;2,0;;;;;;;;2,0;17,0;;2,0;;;;;8,0;3,0;;;;;;1,0;;;;2,0;;;;;1,0;;;;;;2,0;;;;;1,0;;;;1,0;;;;;;;;;3,0;;;;;;;;;;;;;1,0;;;;11,0;;;2,0;1,0;;;;;;;;1,0;;;;1,0;;;;;;;;;;;;;;;;;;;13,0;;;;;;;;;;;;;2,0;;;;;;;;5,0;;;;4,0;;;;;;3,0;;;;;;;;;1,0;;1,0;;;2,0;1,0;;;;3,0;;;;;;;;;;;;;;;;;;;;;;;;;;;1,0;;;;;;;;;;;;;;;;;;;;;;;;;;;;;;;;;;;;2,0;;;;;;;;;;1,0;;;;;;;;;;;;;;;;;;;;;;;;;;;;;;;;;2,0;;;;;;;;;;;;;;;2,0;;;3,0;;;;;;;;;;;;;;;;;;;;;1,0;;;;;1,0;;;;;;;;;2,0;;;;;;;;;;;;;;;;;;;;;;9,0;;;;1,0;;;;;;;;;2,0;;;3,0;;;;;;;;;;;;;24,0;;;;;;;;3,0;;;;;;;;;;;;;3,0;2,0;;;;;;13,0;;;;;;;;;;;;;;;;;;;;;;;;;;3,0;;;;;;;;;;;;;;;;;;6,0;;;;;;;;;;;3,0;24,0;;;;;;;;;;;;;;;;;;1,0;;;;;;;;;;;;;;9,0;;;;;;;;;;;;;;;;;;;;;;;;;;;;;;;;;;;5,0;;;;
derive;;;;;2,0;3,0;2,0;6,0;13,0;3,0;;;14,0;;;21,0;;28,0;3,0;;16,0;29,0;;;1,0;;11,0;2,0;;;2,0;;16,0;;8,0;2,0;;2,0;;;70,0;;1,0;6,0;4,0;1,0;15,0;10,0;7,0;17,0;;6,0;2,0;;;15,0;1,0;;24,0;;;1,0;3,0;1,0;7,0;;1,0;;35,0;;3,0;;7,0;;;4,0;5,0;;;192,0;1,0;5,0;;11,0;;2,0;1,0;;1,0;;6,0;3,0;;;3,0;3,0;12,0;1,0;51,0;3,0;3,0;;9,0;23,0;;;;5,0;12,0;21,0;;1,0;;;1,0;9,0;5,0;26,0;2,0;;;;14,0;7,0;10,0;1,0;;;1,0;15,0;;2,0;;;15,0;1,0;1,0;4,0;5,0;;3,0;;;19,0;1,0;;;;28,0;5,0;;;1,0;3,0;1,0;;18,0;;;;;3,0;11,0;;;;14,0;9,0;2,0;;2,0;;;1,0;4,0;18,0;;;;;;1,0;;;;1,0;;3,0;1,0;;;4,0;;;;;5,0;;;;;2,0;6,0;1,0;6,0;;;;1,0;;;;;;;;;;;;;;;;;;;;14,0;;;;;;;;2,0;;;;;;;8,0;;;2,0;1,0;85,0;3,0;;;;;;2,0;10,0;;;;;;;;;;;;;;;1,0;;;;;;;;;2,0;;;;;1,0;;;1,0;;1,0;;;;;;;;;;1,0;;;;;;1,0;;;;8,0;;;;;6,0;;;;;;;;;;;;;;;;;;;;3,0;;;;;;;;2,0;;;;3,0;;;;;;;;;;21,0;2,0;;;;;;;;;;;1,0;;;;;;;;;;9,0;;;;;;;;;;;;5,0;;;;;;;;;;1,0;;1,0;;;1,0;8,0;;2,0;;3,0;;;1,0;;2,0;1,0;;;;;;2,0;2,0;;;12,0;5,0;3,0;;7,0;;;6,0;1,0;7,0;;9,0;2,0;;52,0;;;3,0;;4,0;;7,0;1,0;;;;;;1,0;;3,0;;;;;;;;;;;3,0;2,0;;;;17,0;12,0;;13,0;;;;;;8,0;4,0;4,0;;2,0;;;1,0;;;;1,0;4,0;;;;7,0;1,0;;;;;4,0;;;;3,0;;14,0;;;;3,0;;;;6,0;;;;;;;5,0;3,0;;1,0;;;1,0;;;2,0;;;;;;;;;1,0;;3,0;;;;;;;;;1,0;;1,0;;;;;1,0;;1,0;;;;;;1,0;;1,0;;;;;;;3,0;;4,0;;;;;;;1,0;;;5,0;;;;;;;4,0;;;2,0;;3,0;;1,0;10,0;;;;;;2,0;;;;;;2,0;;;;;;2,0;;;10,0;;;;;;2,0;;2,0;4,0;2,0;;;;;;;;;;;;2,0;;;;;;;;;;;;;;1,0;;2,0;3,0;;;;;;;;;;;;;;;;;;;;3,0;;3,0;;;;1,0;;;;;;4,0;;;;;;1,0;;2,0;;;;;;;;;;;;;;;;;;;;;;;;;;;2,0;;;;;;;;;;;;;;;;;;;;;;;;;;;;;;;;1,0;1,0;;;;1,0;;;2,0;4,0;;;1,0;;1,0;;;;;;;2,0;;;2,0;2,0;;1,0;;;;;;;;1,0;1,0;;2,0;1,0;;;;;4,0;;;2,0;;;;1,0;3,0;;;;1,0;;;1,0;;;;;;2,0;;5,0;;;;;;;;;;;;;;;;;;;;;9,0;7,0;;5,0;;;7,0;;;;;5,0;;2,0;;5,0;;;;1,0;;;;;;;1,0;;;;;;;;;1,0;;;;4,0;;;;;1,0;14,0;;1,0;;;;;4,0;;;;;;3,0;;;;;;1,0;;;1,0;;;;;;;;2,0;;;;;;1,0;;;4,0;;2,0;;;;;;1,0;;;;;;;3,0;;;;;;;;;;;;;;;;;;;;;4,0;;2,0;;;;;1,0;;10,0;;;;;;;;;;;;;;;;;;
destination;;;;;1,0;;;10,0;;1,0;;;11,0;;;22,0;;;;;;14,0;;1,0;;;;;;;27,0;;1,0;;9,0;4,0;;;;;59,0;;2,0;2,0;4,0;1,0;31,0;54,0;30,0;11,0;;;;;;;;3,0;;;;14,0;;18,0;;;;;4,0;;;;4,0;;;;9,0;;;64,0;;11,0;;48,0;;11,0;;;;;;;;;;;3,0;;33,0;4,0;;1,0;2,0;;;;;;10,0;;;1,0;;;;18,0;2,0;;;7,0;;;2,0;5,0;15,0;1,0;;;;;;;;;;8,0;5,0;;;;;;2,0;;17,0;;;;7,0;5,0;;;8,0;2,0;1,0;;20,0;;;22,0;1,0;22,0;19,0;;;;17,0;1,0;;;;;;;;;;;;;;;;;;;;;;;;;;10,0;;1,0;;;;;;;;;;;;;;;;;;;;;;;;;3,0;;;;;;;;;;;;;;;;;;;;;;;;;;;;;1,0;;;;;;;21,0;;;;;;;41,0;;;;;;;;4,0;;;;;2,0;;;1,0;;;;;;3,0;;;;;1,0;;;;;;;;;;;;;;;;;;;;;;;;;;;;;4,0;;;;;;;;;;;;;;;;;;;;;;;;;1,0;;;;;;;2,0;;;;;;7,0;2,0;;;;;;;;;;;;;;;;;;;;;;;;;;;;;;;;3,0;1,0;;;;9,0;;;;;;;;;;;;;2,0;;4,0;;;;;;;;;;;5,0;;1,0;;;;;;;;4,0;;;17,0;;2,0;;4,0;;;2,0;;1,0;46,0;;;;;;1,0;;;4,0;1,0;3,0;;;;2,0;;;;;;;;;;;;4,0;3,0;;16,0;3,0;;;;;;;;;;;;1,0;;;;3,0;2,0;1,0;;;;;6,0;;;;3,0;8,0;70,0;;;;;;;;;;2,0;;;;;;;;;1,0;;35,0;;;;;;;1,0;11,0;;;6,0;1,0;9,0;;;;;;;;;1,0;;6,0;;;;;21,0;;;;;2,0;;;;;;3,0;6,0;14,0;4,0;;;;;;;;;;;;;;;1,0;;;;;;;1,0;5,0;;;;;8,0;;;1,0;1,0;;3,0;7,0;;;;;;;;;;;6,0;4,0;;1,0;1,0;1,0;;3,0;;;;;;3,0;;2,0;;;;;3,0;1,0;40,0;;;;;2,0;1,0;;;;;;;;;9,0;;;;;;;;;;;;;;;;;;;;;;;;;;;;;;;;;;;;;;;;;;;19,0;2,0;;;5,0;;;;;;;;;;;;;;;;;;;;;;;;;;;;;;;;;;;;;;;;;;2,0;;;;;;;;;;;;;;;;;;;2,0;1,0;;;;;1,0;1,0;;;;;;;;;;;;;1,0;;;;;;;;;;;;;;;;;;;;;;;;;;;;;;;;;;;;;2,0;;;;;;;;;;;;;;;;;;;;;;;;;;;;1,0;;;;;;;;;;;;;;;;;;;1,0;;;;;;;;;;;;;2,0;;;;;;;;;;;;;;;;;;;;;;;;;;;;;;;;;;;;;;;;;;;;;;;;;1,0;;;;;;;;;;;;;;;;;;;;;;;;;;;;;;;;;;;;;;;3,0;;;;;;;;;;;;;;;;;;;;;;;;;;;;5,0;;;;;;;
disparity;;;;;2,0;;;7,0;2,0;;1,0;;16,0;2,0;1,0;19,0;;;1,0;;1,0;8,0;;1,0;;;7,0;1,0;;;1,0;4,0;11,0;;12,0;;10,0;2,0;9,0;;74,0;;2,0;19,0;7,0;;56,0;6,0;;12,0;;23,0;;;2,0;1,0;;;15,0;;;;15,0;;;46,0;11,0;;23,0;;3,0;;20,0;;;;;;;137,0;;14,0;;23,0;2,0;;;;;24,0;11,0;;;;;1,0;;3,0;27,0;;;;2,0;28,0;;;2,0;;5,0;5,0;;3,0;;;;11,0;1,0;4,0;;25,0;;;;4,0;5,0;;;;;29,0;;;;;5,0;;12,0;;3,0;;22,0;;;6,0;29,0;;;;10,0;;11,0;;1,0;1,0;6,0;;18,0;;;;;;15,0;;4,0;;;23,0;;;15,0;;;2,0;18,0;3,0;;;;;;;;;;1,0;;2,0;;;;;;;;;;;;;;;4,0;33,0;;;;;;;;;;;;;;;;;;;;;;;;;2,0;;;;;;;;;;;;;;;;1,0;;;;35,0;2,0;;;;;;;1,0;;;;;;;;;;;;;;;;;;;;;;;;;;;;;3,0;;;;;5,0;;;;;;;;;;;;;;;;;;;;;;;;;3,0;;;;;;;;;;;;;;;;;;;;;;;;;;;;1,0;;;;;;2,0;;;;;;;;;;;;;;;;;;;;;;;;9,0;;;;;;;;;;;;2,0;;;;;;46,0;1,0;;;;;14,0;26,0;;;;;;;;;;7,0;64,0;;;1,0;;4,0;;18,0;;;;;;6,0;;;;1,0;;;;;2,0;;1,0;8,0;;6,0;1,0;;;;;;;;4,0;;;;2,0;;;;1,0;;5,0;;3,0;;5,0;;;;;;;;;7,0;;;;;;1,0;;;;;;;;7,0;14,0;;;;4,0;;;;;;;;;;;;;1,0;;;1,0;;;;;;;;;;;8,0;;;;;;;;;;;;;;;4,0;;2,0;;;;;15,0;;;;;;;;;4,0;;;;;;;;;;;;;8,0;;;3,0;;;;;;;;;1,0;;;;;;;;4,0;;;;;;;;;;;;;;;;;1,0;;;6,0;;4,0;;;;;;;;;;;;;;;;;;;1,0;;;;;;;2,0;;;;;;;;;;;;;;;;;;;;;;;;;;;;;;;;;;;;;;;;;3,0;;;;;;;;;;;;;;;;;;;;;;;;;;;;;;;;;;;;;;;;;;;;;;4,0;;;;;;;;;;;;;;;;;;;;;;;;;;;;;;1,0;;;;;;;;;;;;;;;;;;;;;1,0;;;;;;;;;8,0;;;;;;55,0;;;;;;;;;;;;;;;;;;;;3,0;2,0;;;;;;;;4,0;;;;;;;;;;;;14,0;;;;;;;;;;;;;10,0;1,0;;;;;;;;;;;;;;;;;;;2,0;;;;;20,0;;;;;;;;;;;;;;;;;;;;;;;;;;;;1,0;;;;;;;;;;2,0;;4,0;;;;;;24,0;;;;;;;;;;;;;;13,0;8,0;;;;;;;;;;;;;;;;;;;;5,0;;;;;11,0;;;;;;;;;;;;;;;;;3,0;;;;3,0;;;;;;;;;4,0;;3,0;;;;;;;;;;;;;;;15,0;;;;;;;;
distribution;;;;;1,0;32,0;;7,0;9,0;1,0;;;;;;19,0;4,0;;27,0;;14,0;5,0;1,0;;1,0;;51,0;1,0;;1,0;2,0;1,0;2,0;2,0;6,0;;1,0;2,0;3,0;;18,0;;1,0;8,0;11,0;;22,0;7,0;1,0;6,0;;1,0;;7,0;;6,0;2,0;;2,0;;;;29,0;;6,0;3,0;;2,0;12,0;3,0;6,0;;11,0;1,0;;;15,0;5,0;3,0;79,0;;2,0;;15,0;;;;;;4,0;3,0;;;;;;1,0;;21,0;8,0;14,0;;;9,0;;1,0;;;1,0;3,0;;11,0;;;;20,0;2,0;13,0;2,0;8,0;;;;5,0;1,0;3,0;;;2,0;15,0;;5,0;6,0;;4,0;;2,0;;17,0;;;;;1,0;3,0;;;;14,0;;;;2,0;8,0;2,0;;17,0;;;;1,0;2,0;4,0;;;;9,0;;;;;;;;4,0;;;;;;;;;;;;;6,0;;;;;;;1,0;;3,0;;;;;;6,0;3,0;;;;;1,0;4,0;;;;;;;;;;1,0;1,0;;;;;;;;129,0;;;;;6,0;;;;;;;;;;;4,0;;;;34,0;3,0;;;;;;2,0;;;;;;;;13,0;;;3,0;;2,0;;;1,0;6,0;;;;;;;10,0;;;;;;;;;;;2,0;9,0;;;;;9,0;;;;;;;;;;;5,0;;;;;;;;;;;;;;;;;;;;;;2,0;;;;1,0;;20,0;;1,0;;;;;;;;;;3,0;4,0;52,0;6,0;1,0;;1,0;;;;28,0;;;1,0;1,0;;;;;;;;1,0;;;;;;;;;;;;;2,0;;;;;;;;;;2,0;;;;;;2,0;;;;;2,0;;;;;;3,0;3,0;;14,0;;4,0;4,0;;;;;;14,0;;;;;;2,0;11,0;;;4,0;;;7,0;;;;;;;27,0;;;7,0;;;;;2,0;2,0;;;;;8,0;;;;;;;;;;;;;4,0;8,0;;;;17,0;1,0;;29,0;;;;2,0;4,0;3,0;1,0;4,0;;;;;;;;1,0;;;;;;4,0;;;;;1,0;;4,0;;;;1,0;;;;;4,0;;;;;;;;;1,0;;3,0;1,0;;;;;;1,0;;;;4,0;;;;;;;;;;;;;4,0;;;;4,0;;3,0;;;;;;2,0;;8,0;;;;;;;2,0;4,0;;;;;;;;;3,0;2,0;;;5,0;;;;;;;;;;;;;;;;;;;;;1,0;;3,0;;;;1,0;;;;;;2,0;;;;;;;;;18,0;;;;;;;;3,0;1,0;;;;;;;1,0;1,0;;;;;1,0;;;;;;;;;;;;;;3,0;;;2,0;;;;;1,0;;1,0;;;;;;;;;;;;;;;;;;;9,0;;;;2,0;;1,0;;;;;;;;;;;;;;;;;;;;;;;;;;;;;;;;2,0;3,0;;;;7,0;;;;;;;;;4,0;;;;;;;;;;;;;1,0;;;;;;;;;;;;;;;;8,0;1,0;;;;;2,0;;;;;;4,0;;;;9,0;;4,0;;;;;;;;;;2,0;;;;;;1,0;;20,0;2,0;;;;1,0;;;;;;3,0;;5,0;1,0;1,0;;;;;;;;25,0;;;;;;;;;;;;3,0;;;;;;;;;;;;;;;;;;;;;;1,0;4,0;;;;;;1,0;;;;;;;;;;;;;;;9,0;;;;;;;2,0;;;;9,0;;;;4,0;;;;;;;;;;;;;;5,0;;3,0;;;;4,0;;;;;;;;;;;;;;12,0;;;;;;;;;;;;;;;;;;;;;;;;;;;14,0;;5,0;;;;;;;;;;;;;;;;28,0;;;;;;;;;;;;;;;;;;
engine;;;;;3,0;;;24,0;3,0;10,0;3,0;;11,0;;;32,0;1,0;;;1,0;;6,0;1,0;;;;;2,0;;;4,0;1,0;37,0;;17,0;;2,0;;2,0;;8,0;;3,0;2,0;5,0;;8,0;29,0;2,0;10,0;1,0;1,0;;;3,0;2,0;;1,0;1,0;;;;2,0;;2,0;;17,0;4,0;13,0;;1,0;;17,0;;;;;;;31,0;;16,0;6,0;33,0;;;;;;;3,0;8,0;;;;5,0;2,0;5,0;20,0;1,0;5,0;;4,0;19,0;;2,0;1,0;1,0;2,0;;;3,0;;;;7,0;;4,0;3,0;1,0;;;;6,0;6,0;;;;1,0;;;2,0;1,0;;;;;1,0;2,0;;;;2,0;3,0;1,0;;;;3,0;;;;6,0;5,0;1,0;1,0;53,0;;;;1,0;;7,0;;;;9,0;;;;;;;;;14,0;;;;;;;;;;26,0;;4,0;;;4,0;6,0;;2,0;;;5,0;;;;;;9,0;;;;;;;;;;2,0;;;;;3,0;;;5,0;;;;;;;;18,0;;;;;3,0;1,0;;;;;;;;;;;;;;11,0;;;;;;;;13,0;;;;;;;5,0;;;;;;;;1,0;;;;;;3,0;;;;;;;;2,0;;;7,0;;5,0;;;;;1,0;13,0;;;;;2,0;;;;;;;;;;;;;;;;;;15,0;;;;;3,0;;;;;;;;;;;;;;;;;;;;;;;;1,0;;;;;;;;;;;;;;;;;;;;;;;;;1,0;;;;;;;;;;;;;;;;3,0;;6,0;;1,0;;;;;1,0;;;;1,0;;;;;;1,0;;;15,0;;;2,0;;;;;;;;1,0;;;;;3,0;1,0;;;6,0;;;6,0;;1,0;;;;1,0;1,0;;;;;1,0;;3,0;;;;;;2,0;;2,0;8,0;;4,0;;;;5,0;;1,0;1,0;;1,0;2,0;;;;;6,0;;1,0;;;;2,0;3,0;;;1,0;;;3,0;;3,0;;;;5,0;;;;4,0;8,0;;;;;;1,0;;;;;5,0;;1,0;;;;;;;;;;1,0;;1,0;;;;;;;1,0;;;;;1,0;;;;;;;;;;1,0;2,0;2,0;;2,0;;;;1,0;;;;;;;;;;1,0;;20,0;;1,0;;1,0;1,0;;;1,0;2,0;;;;;;;;;;;;;;;6,0;;;;;3,0;1,0;;1,0;;1,0;6,0;4,0;;;;7,0;;;;;;;;1,0;;;;;;;;1,0;;16,0;;;;;;;;;19,0;;2,0;;;;3,0;;;;;;;;49,0;;;;;;;;4,0;;;;;;;2,0;;;;;;;;;2,0;;;;;;;;;;;;;;;;1,0;;;1,0;;1,0;;;;;;;;;;;;1,0;;;;;3,0;;;;;;;;;;;;;;;;;;;;;;;2,0;1,0;;2,0;;;;;;;;;;;;1,0;;;;;;;;;;;;;;;;;;;;;;;;1,0;;;;;1,0;;;;;;;;;;;;;;;;;;;;;;;6,0;;;;;;;;;;;48,0;;;;;;;1,0;;;;;;;4,0;;;;;;;;;;;;;;;;;;;1,0;;1,0;;;;;;;;;;;1,0;;;;;;;;;;;;;;;;;;;;;;;;;;;;;;;;10,0;;1,0;;;;;;;;;5,0;;;;2,0;;15,0;;;;;;;;1,0;;;;;;;;;;;;;4,0;;;;;;;;;;;;;;;;;;;8,0;;;;;;;;;;;;;;;;;;;;;;;;;;;3,0;4,0;;;;;;;;1,0;;;;;;;;;;1,0;;;;;;;;;
environment;;;;;1,0;6,0;1,0;14,0;1,0;2,0;2,0;;21,0;;2,0;57,0;1,0;;4,0;;5,0;72,0;2,0;;;;1,0;2,0;;;5,0;3,0;17,0;;14,0;;1,0;4,0;11,0;;49,0;;8,0;28,0;33,0;7,0;68,0;76,0;9,0;22,0;15,0;14,0;;;;4,0;;1,0;2,0;1,0;;31,0;9,0;;;2,0;4,0;9,0;10,0;2,0;4,0;;43,0;;;2,0;3,0;19,0;24,0;212,0;4,0;16,0;1,0;39,0;;10,0;;;;;14,0;1,0;;;9,0;1,0;7,0;;86,0;52,0;69,0;5,0;22,0;101,0;;2,0;16,0;1,0;18,0;32,0;;14,0;;;;40,0;29,0;55,0;;8,0;1,0;1,0;4,0;6,0;19,0;10,0;1,0;;3,0;;;10,0;17,0;;10,0;1,0;2,0;1,0;3,0;;23,0;;2,0;56,0;3,0;;;3,0;5,0;1,0;;;3,0;15,0;3,0;2,0;66,0;;1,0;;4,0;4,0;22,0;4,0;1,0;;37,0;73,0;3,0;;2,0;;;7,0;;;1,0;;1,0;;;8,0;;;;;;14,0;;;;1,0;;2,0;;;4,0;;;;;;;3,0;;;;3,0;;7,0;1,0;;;1,0;;;;;;1,0;8,0;;1,0;;;2,0;;;77,0;2,0;;;;1,0;;1,0;1,0;4,0;;;;;2,0;32,0;2,0;;;20,0;3,0;4,0;;;;;;;21,0;7,0;;;;;;7,0;;1,0;;;;;;34,0;3,0;;;;;3,0;;13,0;;;;;;9,0;;1,0;;2,0;82,0;;;;;3,0;;;;;1,0;2,0;;;;4,0;;;;7,0;17,0;;;;;;;;;4,0;;;;;2,0;;;;;2,0;;;;1,0;;7,0;2,0;;;;;;1,0;;2,0;1,0;;5,0;;8,0;;;;;;;1,0;14,0;7,0;;;14,0;2,0;;;;;;;;;;;3,0;;;;;1,0;5,0;;;5,0;;;1,0;;;;3,0;51,0;13,0;3,0;;3,0;;;;12,0;;;5,0;2,0;7,0;;1,0;;4,0;5,0;10,0;11,0;2,0;5,0;2,0;16,0;;2,0;1,0;;3,0;2,0;1,0;1,0;3,0;;2,0;2,0;16,0;5,0;10,0;1,0;27,0;4,0;;95,0;;4,0;1,0;1,0;;7,0;32,0;6,0;4,0;3,0;18,0;6,0;;33,0;2,0;1,0;;;1,0;;20,0;3,0;32,0;;;9,0;;2,0;;;;;;;8,0;;1,0;2,0;12,0;32,0;;;4,0;;4,0;5,0;;1,0;;10,0;;;;2,0;7,0;;;2,0;5,0;1,0;;;1,0;8,0;;;8,0;;;23,0;;14,0;;2,0;;;4,0;;;;;1,0;;;;23,0;;;;3,0;;26,0;;;2,0;;2,0;10,0;;;;4,0;;;;;;;;;4,0;;;;;;;2,0;22,0;;3,0;;;;;;1,0;;4,0;;;;7,0;;1,0;;1,0;13,0;;;;;;;1,0;;15,0;;18,0;2,0;;16,0;4,0;;;;;;2,0;;;;;;;17,0;;1,0;1,0;;4,0;3,0;;;5,0;;11,0;1,0;;;;;1,0;;;;7,0;;1,0;3,0;;11,0;;;;;;3,0;3,0;6,0;;1,0;;2,0;1,0;;;11,0;1,0;1,0;;;;152,0;1,0;;7,0;;;1,0;2,0;;;;;;;;;;1,0;;2,0;;;;;;;;;;;;;;1,0;3,0;;;1,0;;;;;;2,0;;;;2,0;1,0;;;;;2,0;1,0;;;;;3,0;;;3,0;;;5,0;;;;;;;;;;;;;;;;1,0;3,0;;;;;;1,0;12,0;;;;;;1,0;;;;;;;;;;;;;1,0;1,0;8,0;;;;;;;1,0;;;;3,0;;;1,0;5,0;;;;;;;1,0;2,0;;;1,0;;;;;7,0;15,0;;;;10,0;;;3,0;;;;;;3,0;;;1,0;;;3,0;;1,0;;;;;;;;;1,0;;;;;;;5,0;;;;;;;;6,0;1,0;;;;;;;3,0;12,0;;;;;;;;;1,0;;1,0;;1,0;4,0;;;;;4,0;;3,0;;21,0;;2,0;;11,0;;;1,0;;;;;;;1,0;;;;;;;;1,0;;;;;;;;1,0;22,0;;4,0;2,0;3,0;;14,0;;;;;;;;3,0;;2,0;1,0;;4,0;;1,0;;;;2,0;;;;;;;;;;8,0;;;;;;;;;;;;;;;;;;1,0;;;;;;;;;;1,0;;;;;;;;11,0;;;;;;11,0;;3,0;;;;15,0;;7,0;;;1,0;;;;;3,0;;;;;;;;
evaluate;;;;;3,0;6,0;;23,0;11,0;1,0;3,0;;10,0;;8,0;48,0;1,0;;1,0;;4,0;12,0;;1,0;3,0;;6,0;;;;3,0;1,0;22,0;1,0;11,0;8,0;;;;1,0;26,0;;2,0;4,0;11,0;8,0;21,0;9,0;4,0;8,0;;11,0;;;;13,0;4,0;;3,0;;;;2,0;;34,0;;18,0;3,0;51,0;;13,0;;6,0;;;;;1,0;1,0;124,0;;3,0;;30,0;6,0;2,0;;;;1,0;8,0;;;;3,0;2,0;4,0;;38,0;1,0;8,0;21,0;4,0;4,0;;5,0;2,0;3,0;15,0;13,0;;29,0;3,0;2,0;;39,0;9,0;6,0;;1,0;;;4,0;9,0;6,0;;;2,0;;;;21,0;;;4,0;;5,0;;20,0;;15,0;1,0;;14,0;7,0;;;;15,0;3,0;4,0;;2,0;6,0;3,0;;14,0;;;1,0;;;35,0;1,0;;;;3,0;;4,0;;;;;;5,0;;;;;;;;;;4,0;;;;;;;;;;;;;;;;;32,0;4,0;;;2,0;2,0;11,0;1,0;1,0;;;;;;;;;;;;;;1,0;;;;15,0;;;;1,0;;;;2,0;;;;6,0;;2,0;;;;;;;12,0;;;;;;2,0;8,0;2,0;;;;;;10,0;;;;;;;;2,0;2,0;;1,0;;;1,0;;1,0;;;;;;7,0;;;;;5,0;;;;;;;4,0;;;;1,0;;;;;;;;;2,0;1,0;2,0;;;1,0;;;;;;;;1,0;;;;;;;;;;;;;;;;;;;;;;;1,0;;1,0;12,0;;15,0;;;;;;7,0;;;1,0;7,0;;;;;;;;6,0;2,0;;;1,0;;;;;2,0;;;;;;;;;;;;;7,0;5,0;;;;;;13,0;3,0;;;2,0;2,0;;;;;2,0;1,0;17,0;1,0;6,0;;;;;1,0;;1,0;5,0;2,0;5,0;;1,0;;;10,0;;;;;8,0;1,0;;;10,0;10,0;;1,0;;37,0;;;2,0;;9,0;;;;1,0;;;;7,0;9,0;;;;;;;;;;;6,0;;5,0;4,0;;;;;18,0;;21,0;;;1,0;5,0;;;;8,0;;;4,0;;;;;;2,0;1,0;;;;3,0;;;;;;;;;;2,0;;1,0;;;;;;;;;;;;;2,0;;2,0;;;;5,0;;;;1,0;;;3,0;3,0;;;;;;;;8,0;2,0;;;;;;1,0;1,0;;1,0;;;;;;1,0;1,0;4,0;;;;1,0;;;;;;;;;;;;1,0;;;;;;;3,0;;;4,0;;;;;;;;;;;;;4,0;3,0;;;1,0;;;;;;1,0;;;;;;;2,0;;;;2,0;3,0;;3,0;;;;;;;;;;;;;;;;;;;4,0;;;;;;;2,0;;2,0;;;;;;;;;;;;;2,0;;;;;;;;;;;;;;;;;;7,0;;;;;;;;;;;;;4,0;;;;;3,0;;;;5,0;;;2,0;;;;;;;;;;;;;;;;;;;;;;;;;;;;;;6,0;;;;;;;;;;1,0;;;;;;;;;1,0;;;;;1,0;;;2,0;;;;;36,0;;;2,0;;2,0;;;;8,0;;4,0;;;1,0;;;20,0;;;;;;;;;;;;;1,0;;1,0;4,0;1,0;;;;5,0;;;15,0;1,0;;;;;;;;1,0;;;;;;2,0;;;1,0;;;1,0;;;;;;;;;;1,0;7,0;;;;;;;;2,0;;;;;;;;;;;;27,0;;;;;;3,0;1,0;;;;;;;;;;;;;;;1,0;;;;1,0;;;;;13,0;;;;;;;1,0;;;;;;;;;;;;;;;2,0;1,0;;;;;;;;;;;3,0;;;;;;;;;;1,0;;;;;;;;;;;2,0;;;;;1,0;;;;;;;;;;;;;;;;;;;;;;;3,0;;3,0;;;;;;;;;;;;;1,0;;;;;
event;;;;;9,0;5,0;;6,0;8,0;20,0;;;89,0;;;71,0;;;23,0;;2,0;25,0;4,0;;;;;12,0;;;14,0;1,0;19,0;;41,0;6,0;;;8,0;;152,0;;5,0;7,0;131,0;57,0;63,0;53,0;8,0;24,0;;3,0;;;;;2,0;;;;1,0;4,0;5,0;2,0;3,0;;8,0;3,0;17,0;;6,0;;27,0;;;6,0;60,0;;1,0;99,0;1,0;3,0;7,0;98,0;;61,0;;;;;;3,0;;2,0;;16,0;10,0;3,0;98,0;5,0;7,0;1,0;19,0;52,0;;3,0;1,0;6,0;35,0;21,0;;9,0;;;;35,0;5,0;42,0;10,0;18,0;;;10,0;12,0;50,0;17,0;;;;7,0;;1,0;6,0;;7,0;;2,0;75,0;;2,0;30,0;1,0;4,0;15,0;8,0;;;;47,0;;63,0;;14,0;10,0;15,0;;70,0;;2,0;;3,0;12,0;14,0;;;;106,0;50,0;3,0;1,0;3,0;;;;5,0;;;;;;;;;;;2,0;;2,0;;;2,0;2,0;;1,0;;;;;;;;;2,0;3,0;;;;;2,0;;;;;;;;;;;;;;;;;;;;4,0;;2,0;1,0;2,0;;;;9,0;;;;;1,0;;3,0;;;;;3,0;3,0;2,0;;;;;;61,0;2,0;;;;;;45,0;;;;;;;;7,0;2,0;;1,0;;15,0;;;;4,0;;1,0;;;83,0;;3,0;1,0;;22,0;3,0;;;;;;;;;;1,0;;;4,0;;;;;4,0;;2,0;;;3,0;4,0;;;;9,0;;;;;;;2,0;;;;2,0;;;;;3,0;;;;;;;;3,0;1,0;4,0;;;;1,0;;;;;;;;8,0;;;;;;;;;;;;;;;;23,0;;;;;;;;;;;;;;;;4,0;;22,0;;;;1,0;;;1,0;1,0;;1,0;;;;;;;;;19,0;;14,0;;1,0;;;2,0;2,0;7,0;2,0;1,0;41,0;10,0;5,0;3,0;;16,0;1,0;2,0;;23,0;1,0;;53,0;;;1,0;28,0;;23,0;46,0;6,0;;14,0;2,0;3,0;1,0;;34,0;;;;;1,0;55,0;1,0;;;1,0;3,0;;1,0;9,0;;;13,0;;32,0;7,0;2,0;2,0;98,0;15,0;15,0;5,0;;;;;1,0;;;2,0;1,0;4,0;;;3,0;;1,0;2,0;;14,0;9,0;1,0;;5,0;4,0;3,0;4,0;;;5,0;10,0;3,0;;;16,0;11,0;;1,0;;;10,0;2,0;;1,0;2,0;14,0;;28,0;;1,0;;9,0;2,0;;;42,0;2,0;8,0;;;8,0;;25,0;16,0;15,0;44,0;4,0;;;;4,0;19,0;;4,0;;5,0;;;;11,0;;3,0;1,0;;;;;;;32,0;;1,0;;16,0;;;;1,0;2,0;;;2,0;;4,0;;;;;;2,0;27,0;;;2,0;;;;2,0;;;;;1,0;4,0;;;2,0;;5,0;6,0;;20,0;71,0;;;48,0;1,0;3,0;;;;1,0;;9,0;;;;2,0;;13,0;5,0;8,0;21,0;;1,0;3,0;;;4,0;2,0;4,0;1,0;;;;;4,0;2,0;12,0;2,0;;32,0;;;1,0;5,0;;8,0;2,0;;;;2,0;;;;;1,0;;2,0;;;2,0;4,0;;;5,0;;;8,0;;;;;;;;1,0;;;;;;;;;;;;;2,0;;;;;;;1,0;;;;;1,0;2,0;;;;;;;;;;;;;;;;;;;;;;;;;;;;;;1,0;;;1,0;;;2,0;;;1,0;;;;;;;;;;;;109,0;;2,0;;;;;4,0;;;;2,0;;;;29,0;;1,0;;;1,0;3,0;;;;;;;4,0;;;11,0;;;;1,0;;;;2,0;;12,0;;;;;;;22,0;;1,0;1,0;;2,0;;;;;;;;1,0;;;;;17,0;;;8,0;;8,0;3,0;;;7,0;;;;;;1,0;;;;1,0;20,0;;;;;;12,0;;;;1,0;3,0;;19,0;23,0;;;1,0;;5,0;;8,0;;23,0;;;;;;2,0;;;;2,0;;;;;;;1,0;;;;1,0;;;;;;;;;;1,0;;;6,0;2,0;20,0;1,0;;;;;;;;;;;2,0;;;;3,0;;;;;;5,0;;;;;1,0;;1,0;;;;;;;;;;;;;;;;;;;;;;;;;14,0;;;;;;;1,0;;;;;;;;;;;;;1,0;;;2,0;;;;;;2,0;;7,0;26,0;1,0;;;;;;;;;
expose;;;;;7,0;;5,0;5,0;49,0;3,0;9,0;;1,0;;5,0;23,0;1,0;;;;3,0;11,0;3,0;;1,0;;2,0;;1,0;;;3,0;13,0;;2,0;12,0;;3,0;;;6,0;;5,0;;4,0;2,0;8,0;35,0;1,0;9,0;7,0;;;;3,0;5,0;5,0;;1,0;;4,0;15,0;3,0;;1,0;7,0;4,0;30,0;53,0;26,0;8,0;2,0;7,0;;;2,0;2,0;2,0;4,0;108,0;;43,0;;45,0;2,0;;;;6,0;4,0;111,0;;;;;;2,0;;31,0;4,0;;;27,0;2,0;;4,0;20,0;1,0;2,0;1,0;4,0;;1,0;;3,0;7,0;82,0;34,0;3,0;5,0;5,0;;2,0;9,0;4,0;;2,0;;17,0;;;;;3,0;;;2,0;2,0;3,0;;11,0;1,0;;123,0;3,0;;;16,0;9,0;;;4,0;;;4,0;2,0;10,0;;1,0;;;;39,0;;;;;3,0;;1,0;;;5,0;;6,0;;4,0;12,0;;;3,0;38,0;1,0;4,0;3,0;6,0;;;;;;;2,0;8,0;;4,0;;;;43,0;3,0;;;12,0;;1,0;;;40,0;41,0;18,0;;;;;;7,0;1,0;;42,0;74,0;8,0;14,0;1,0;;7,0;29,0;;37,0;4,0;40,0;5,0;;11,0;7,0;6,0;;59,0;5,0;4,0;;2,0;20,0;7,0;;;;2,0;51,0;;2,0;;;;;1,0;11,0;;;;;;;;9,0;3,0;1,0;8,0;17,0;;3,0;1,0;2,0;7,0;;1,0;10,0;1,0;14,0;136,0;2,0;;18,0;;;39,0;;;;3,0;12,0;1,0;;;2,0;;;;9,0;;5,0;1,0;2,0;;4,0;4,0;;;18,0;1,0;;13,0;5,0;1,0;8,0;;;23,0;1,0;6,0;;;;3,0;4,0;1,0;1,0;;;;2,0;;2,0;1,0;;;6,0;13,0;;10,0;;;;;;;;2,0;;7,0;;;;1,0;;;;1,0;5,0;;;1,0;4,0;1,0;;1,0;;1,0;12,0;;5,0;;;;;;4,0;;4,0;7,0;;;;1,0;;;2,0;4,0;;8,0;;6,0;;;1,0;;;;1,0;;;;;2,0;;;;1,0;;;5,0;;;;1,0;;;;3,0;;;;9,0;2,0;;;;2,0;;;;2,0;;;2,0;;;;;;3,0;11,0;;2,0;;2,0;15,0;;;10,0;4,0;;;;;;;;;;3,0;;;1,0;;;;;;;;1,0;;;5,0;;;;1,0;;3,0;7,0;1,0;5,0;;;;;;;;12,0;1,0;11,0;;;;;2,0;;14,0;;;3,0;;;;;4,0;;;2,0;;;;;2,0;;;;;1,0;3,0;;;;;3,0;;2,0;;;;14,0;;;;1,0;;;;2,0;;;;;;;1,0;;;;;;;2,0;;;;8,0;;;;;;;;;;;;;1,0;4,0;4,0;1,0;1,0;4,0;;;;17,0;;;4,0;;;1,0;1,0;;;;;1,0;;;;;6,0;;1,0;;;;;7,0;;1,0;;;;;2,0;;;;;;;;1,0;;2,0;;;;36,0;;;;2,0;;;;;;;7,0;;;;;5,0;;;;;;;;;;;3,0;;;;;3,0;3,0;;;;;1,0;1,0;3,0;;;;1,0;;;;;;;;;;;;;;;;2,0;3,0;;;;;;;;;;;1,0;;;;;;;;;;;4,0;1,0;;;11,0;;;;;;;;1,0;;;;;19,0;;;1,0;;;;;;;;;;;4,0;3,0;;3,0;;5,0;;;1,0;;;;;2,0;8,0;;2,0;;;;;;;;;;;10,0;;;;11,0;;;;1,0;2,0;;;;;;;4,0;;;1,0;;;12,0;;;;4,0;;;1,0;;;;1,0;1,0;;;;;;;;;;;;2,0;;;1,0;;1,0;;;;;;2,0;;;;;6,0;;2,0;;;8,0;;;2,0;;;;;;;;;;;;;2,0;;;;;;;;;;;;;;;;;;;;;3,0;;;3,0;;;;;;;;;;;;;;;;;;;1,0;;2,0;;;;;;;;;;;;;;;;;;;2,0;;;2,0;5,0;;;;;;2,0;2,0;;;;;;;;;;;;;;;;;;2,0;;;4,0;;;4,0;;1,0;;;;;;;;;1,0;;;;;;2,0;;;;;;;2,0;;;;;;;;;;;;;;;;;;;;;;;;1,0;;
facial;;;;;4,0;;;4,0;2,0;;1,0;;2,0;;;17,0;;;4,0;;;8,0;;;;;;;;;12,0;;;;;;;;;;10,0;;;3,0;10,0;7,0;22,0;17,0;14,0;12,0;;;;;;;;;;;;;;;;;;;;;4,0;;;;;6,0;12,0;;;144,0;;;1,0;22,0;;;;;;;;;;;;;1,0;;29,0;1,0;;1,0;10,0;4,0;;4,0;;;;;;8,0;;;1,0;11,0;11,0;;;11,0;2,0;;3,0;8,0;5,0;1,0;;;;;;;;;;;;3,0;;;1,0;;;2,0;;;;;;;;;1,0;12,0;12,0;;20,0;;;;;;4,0;;;;32,0;4,0;;;;;;;;1,0;;;;;;6,0;;;;;;;;;;;;;;;;;;;;;;;;;;;;8,0;;;;;;;;;;;;;;;;;;;1,0;;;;;;;3,0;4,0;3,0;;;;;;;;;;;;;;;;;;;10,0;;;;;;;10,0;;;;;;;;4,0;;;;;;;;;;;;;;2,0;;;;;;;;;;;;;;;;1,0;;;;;;;;2,0;;;;;4,0;;;;;;;;;;;;;;;;;;;;;;;;;;;;8,0;;;;;;;;;;;;;;;;;;;;;;;;;;;;;;;;;;;;;;;;3,0;;;;;;;2,0;;;;;;;;;;;;;1,0;;;;;;3,0;;2,0;;5,0;;2,0;;1,0;;;2,0;;;;;;;;48,0;;3,0;;19,0;1,0;;;;;;3,0;;2,0;6,0;;;;1,0;2,0;;;4,0;1,0;;;;;;;;;;;;;;;;1,0;;3,0;3,0;;;2,0;;9,0;2,0;2,0;;;;;;;;;;2,0;;;;;;;2,0;;;;;;;;;;13,0;3,0;;;;;;;7,0;;;;;;;;;;;;;;;11,0;;;;;1,0;;1,0;;;10,0;3,0;3,0;;;;;;1,0;;;;;;;;;;;;;;;;;;;9,0;;;;;;;;2,0;;;;;;;;;;;;;;;;8,0;;;6,0;;;;;;2,0;;;;1,0;;;2,0;;;;;;;;16,0;;;;;;;;;;;;57,0;18,0;;18,0;9,0;;;;;;;;;;;10,0;;;;;;;;;;4,0;;;;;;;;;;;;;;;3,0;;;;;;;1,0;;;;;;;;;;;;;;;;;;;;;;;;;;;;;;;;;;;;;;;;;;2,0;;;;;;;;;;;;;;;;;;;;;4,0;;;;;;;;;;;;;;;;;;;;;;;;;;;;;;;1,0;;;;;;;;;44,0;;;;;;;;;;;;;;11,0;;58,0;;1,0;;1,0;;;;;;;;;;;;;;;;;;;;1,0;;;;;3,0;;;3,0;;9,0;;;;;;;;;;;;;;;;;;1,0;;;1,0;;;;;;5,0;;;;;;;7,0;;;;;;1,0;;;;;;;;;;;;;;;;;;;;;;;;1,0;7,0;;2,0;3,0;;;;;;;;;1,0;;2,0;8,0;;;;;2,0;;;;;;;;;;;;;;;;;;;;;;;15,0;;;;;;;;;;;;;;;2,0;;;;;;;;;;;;;;;;;;;;;;;;;;;;;;;;;;;;;;;;;;;;8,0;;;;;;;;;
feature;;;;;16,0;12,0;7,0;51,0;162,0;1,0;9,0;;131,0;6,0;1,0;278,0;;;7,0;3,0;54,0;88,0;3,0;2,0;20,0;4,0;19,0;5,0;1,0;2,0;29,0;22,0;108,0;8,0;49,0;5,0;3,0;3,0;18,0;;160,0;;40,0;50,0;109,0;35,0;301,0;109,0;30,0;26,0;2,0;32,0;19,0;4,0;;36,0;17,0;6,0;44,0;;12,0;4,0;10,0;;8,0;21,0;14,0;18,0;181,0;;18,0;;101,0;4,0;11,0;101,0;179,0;3,0;7,0;1262,0;2,0;11,0;5,0;178,0;6,0;4,0;7,0;21,0;1,0;1,0;19,0;1,0;;;23,0;21,0;3,0;;203,0;5,0;40,0;6,0;59,0;313,0;4,0;5,0;16,0;17,0;3,0;29,0;5,0;19,0;1,0;;21,0;177,0;105,0;165,0;2,0;52,0;5,0;1,0;15,0;30,0;33,0;6,0;2,0;26,0;;10,0;;115,0;49,0;21,0;66,0;12,0;93,0;25,0;13,0;10,0;80,0;2,0;2,0;20,0;14,0;;;17,0;6,0;69,0;19,0;;26,0;88,0;49,0;;113,0;;;1,0;12,0;4,0;190,0;10,0;6,0;;33,0;19,0;5,0;1,0;8,0;;;18,0;128,0;13,0;12,0;4,0;;;1,0;15,0;;;;12,0;;6,0;;;1,0;1,0;;17,0;2,0;;;;;;;5,0;3,0;31,0;25,0;;1,0;;1,0;59,0;3,0;;;;;;6,0;;7,0;2,0;26,0;;2,0;4,0;;;2,0;;58,0;1,0;;;;39,0;4,0;3,0;12,0;7,0;4,0;1,0;6,0;10,0;3,0;1,0;;;;12,0;51,0;18,0;2,0;;;;;;54,0;2,0;;;;;8,0;96,0;;;9,0;1,0;6,0;;;7,0;14,0;2,0;;2,0;1,0;14,0;4,0;90,0;3,0;;5,0;2,0;;31,0;1,0;3,0;12,0;1,0;27,0;9,0;;;1,0;1,0;1,0;;;;;17,0;7,0;;2,0;;;73,0;4,0;10,0;;7,0;1,0;;;2,0;;;;7,0;;;;;;;11,0;1,0;7,0;1,0;8,0;1,0;;;2,0;3,0;29,0;19,0;6,0;3,0;;1,0;1,0;7,0;6,0;;3,0;1,0;27,0;27,0;1,0;6,0;;;;;2,0;529,0;2,0;17,0;4,0;33,0;1,0;;;;;1,0;;1,0;15,0;;;;;3,0;1,0;;1,0;6,0;2,0;2,0;8,0;;;7,0;3,0;1,0;;5,0;23,0;58,0;9,0;1,0;4,0;;;;123,0;;5,0;2,0;13,0;21,0;5,0;5,0;;3,0;9,0;79,0;21,0;4,0;92,0;4,0;44,0;;1,0;;3,0;2,0;8,0;8,0;39,0;7,0;;10,0;5,0;;7,0;18,0;5,0;66,0;8,0;1,0;114,0;;205,0;25,0;9,0;;;51,0;14,0;5,0;11,0;;23,0;;36,0;3,0;9,0;;;3,0;;68,0;11,0;1,0;;4,0;10,0;1,0;;5,0;;1,0;;;62,0;165,0;14,0;3,0;3,0;85,0;53,0;1,0;31,0;;;;22,0;4,0;6,0;9,0;71,0;2,0;4,0;12,0;7,0;29,0;;16,0;16,0;4,0;8,0;;;2,0;2,0;7,0;1,0;;6,0;40,0;7,0;4,0;14,0;6,0;1,0;;29,0;4,0;1,0;;;;4,0;;;;;7,0;8,0;16,0;2,0;23,0;;;;3,0;;10,0;;8,0;1,0;1,0;22,0;29,0;;;;;1,0;3,0;21,0;2,0;1,0;;;13,0;;;3,0;185,0;;14,0;;;6,0;4,0;5,0;;10,0;29,0;2,0;;;4,0;;2,0;4,0;29,0;;;;3,0;;;3,0;;10,0;;48,0;;9,0;1,0;;2,0;;;22,0;3,0;;3,0;;;;28,0;3,0;;14,0;1,0;3,0;;;15,0;;3,0;;;3,0;10,0;20,0;;;1,0;;4,0;;5,0;;5,0;;40,0;46,0;;79,0;31,0;;7,0;2,0;;3,0;4,0;;;8,0;6,0;4,0;;45,0;2,0;;;;;;;5,0;;;1,0;;;;1,0;;;2,0;;;;9,0;13,0;1,0;10,0;;16,0;1,0;;1,0;;;5,0;;;;2,0;1,0;5,0;1,0;;7,0;1,0;;10,0;;;;;;20,0;;;;4,0;2,0;9,0;;;;;;22,0;;;1,0;24,0;;;1,0;;;12,0;;;;;1,0;;;2,0;;1,0;11,0;;4,0;;5,0;2,0;2,0;;4,0;9,0;;;1,0;2,0;;;;;;;4,0;;2,0;;3,0;2,0;;;2,0;2,0;2,0;8,0;;;2,0;;;;;;11,0;1,0;28,0;1,0;;;;;22,0;360,0;;8,0;;2,0;8,0;1,0;1,0;17,0;;;;2,0;1,0;2,0;;13,0;3,0;9,0;;1,0;5,0;;;2,0;44,0;7,0;11,0;;2,0;8,0;;25,0;1,0;;4,0;1,0;;;;;;1,0;37,0;;;16,0;;4,0;1,0;8,0;;;5,0;;53,0;;;17,0;14,0;7,0;22,0;;2,0;;;1,0;;1,0;6,0;;2,0;;;;;;4,0;;;9,0;1,0;;;13,0;26,0;;1,0;10,0;;;;12,0;;;;2,0;1,0;5,0;;;;;;;;;;;2,0;4,0;4,0;;;2,0;1,0;5,0;1,0;18,0;;;;;8,0;15,0;;;;;1,0;5,0;36,0;1,0;;;;;1,0;;;;10,0;9,0;;;;10,0;2,0;;;2,0;;;;1,0;1,0;;2,0;;;;;;13,0;;37,0;;;;;;23,0;;9,0;;;3,0;;;;1,0;;;;2,0;;;;;1,0;;;;21,0;;;3,0;;;;;;2,0;;;;2,0;;84,0;;6,0;1,0;;1,0;;;;8,0;1,0;1,0;1,0;;;;;;
feed;;;;;7,0;;;1,0;1,0;7,0;1,0;;3,0;;;26,0;2,0;;;;;36,0;;;1,0;;3,0;2,0;;;18,0;;21,0;;14,0;2,0;3,0;;7,0;;61,0;;5,0;;15,0;1,0;21,0;27,0;5,0;24,0;10,0;10,0;;;11,0;1,0;3,0;;1,0;;2,0;;;;6,0;;;6,0;36,0;;1,0;;14,0;;;2,0;;1,0;1,0;54,0;;10,0;;35,0;;2,0;3,0;;;;10,0;;;1,0;;2,0;1,0;1,0;19,0;;2,0;5,0;1,0;4,0;;5,0;;;18,0;;;1,0;;;;13,0;1,0;6,0;63,0;3,0;;;10,0;5,0;3,0;7,0;;;;;;7,0;;;;;1,0;1,0;;;2,0;;;12,0;;;;7,0;12,0;;;;1,0;1,0;18,0;14,0;77,0;;20,0;2,0;3,0;3,0;19,0;;;;294,0;8,0;;2,0;17,0;;;;4,0;;;;;;2,0;2,0;;;;;;;;;;;;7,0;;;;1,0;;;;;;20,0;1,0;;2,0;;;;;;;3,0;;;;;;;1,0;;;;;;;;14,0;;9,0;;;6,0;1,0;1,0;1,0;;;;;;;;;;;;;;;;;;;;33,0;;;;;;;21,0;;;;;;;;4,0;;;;;4,0;;;6,0;;3,0;12,0;1,0;;10,0;;;;;;;2,0;;;;;;2,0;;3,0;;4,0;;;;;;;;;;;;;12,0;;;;1,0;;;;;;;;;;;;;;;;;;1,0;;1,0;;;3,0;;;;;;2,0;1,0;;;;4,0;;2,0;;36,0;;21,0;1,0;;;;;;;;;;1,0;;;;;;;;;;;;1,0;2,0;1,0;;;;;1,0;;4,0;2,0;;;1,0;1,0;;;;;;4,0;;;;;;;4,0;;4,0;1,0;7,0;2,0;;;;;;1,0;;;;;;;;;;;7,0;;;2,0;;;2,0;;;;5,0;2,0;3,0;7,0;4,0;;;4,0;;;;;;;1,0;5,0;28,0;;;;;;;;;;;;1,0;;;;;3,0;;;;4,0;;;4,0;5,0;8,0;16,0;;6,0;;;;;18,0;2,0;;;7,0;;;11,0;1,0;5,0;;;;;;1,0;;;3,0;;4,0;;;;;;;;;;;6,0;1,0;;;1,0;6,0;;;;;;;;;;;3,0;;18,0;;;;;9,0;;13,0;;1,0;;;;3,0;;;;;;;;;;1,0;;;;1,0;;;;;7,0;;;;;;;;;;;;2,0;;;;;1,0;;;;;;;;;3,0;;;;81,0;;;1,0;;;;;;;;;;;;;;;;;;1,0;;;3,0;;;;;;;;;1,0;4,0;;;;;;6,0;15,0;;1,0;;;21,0;;;;;;1,0;;;;2,0;;;;;;;34,0;;;;;;;;;;2,0;;;;;2,0;;4,0;;;;;;;;;;;;;;;;2,0;5,0;;;6,0;;;;;;;;;2,0;;30,0;;1,0;;3,0;;;;;;;;;6,0;;;;;;;;;;;;;;;;1,0;;;;;;;;;;;5,0;;;;;1,0;;;;4,0;2,0;;;;;;1,0;;22,0;;1,0;;;;;;;;;;;;;;;;;;;;;;;;;2,0;;;;;2,0;;;;;;;;;;;;1,0;;;;;;;;;1,0;;;;;;;;;;;;3,0;;;;2,0;;;;;;;;;;;;;;4,0;;;;1,0;;;;;;;1,0;;10,0;;;;;;;;;;;;;;;;;;;;1,0;;;;;1,0;;;;;;;;;;;;;;;;23,0;;;;;;;;;;;;;;;;;7,0;;;;;;;;;;;;;;4,0;6,0;;;;;;;;;;;;;;;;;;;;;;;;;;;;;;;;;;;;;;;;;;;;;;2,0;;;2,0;;;;;;;;;;
game;;;;;3,0;;;20,0;77,0;11,0;;;13,0;3,0;;29,0;;;;;;34,0;1,0;;;;;;;;15,0;3,0;16,0;;10,0;9,0;;;5,0;;22,0;;1,0;4,0;6,0;;3,0;30,0;2,0;49,0;;1,0;;;;;;1,0;;;3,0;;;1,0;;;;4,0;2,0;;3,0;;;;;;;;;150,0;;;;11,0;;1,0;;;;;;;;;;1,0;1,0;;27,0;6,0;;;11,0;2,0;;;;;2,0;1,0;1,0;25,0;;;;2,0;;49,0;;1,0;;;;2,0;5,0;;;;;;;1,0;9,0;;;;;3,0;;;2,0;;;4,0;;;;9,0;3,0;;;;5,0;3,0;;;23,0;;;2,0;1,0;;3,0;;;;20,0;4,0;;;9,0;;;;;;;;;;;;;;;;;2,0;;;;;;;;;;;;;;;;;;;;;;;;;;;;;;;;;;;;;;;;;2,0;;;;;;;8,0;6,0;;3,0;;8,0;1,0;;1,0;;;;;;;;;;;;;8,0;;;;;;;1,0;;;;;;;16,0;;1,0;;;;;;;;;;;;;40,0;;55,0;;;;;;;;;;;;;;;;;2,0;;;;;;;;;;1,0;;;;;3,0;;;;;;;;;;;;;;;;;;;;;;;;;;;;;;;;;;;;;;2,0;1,0;;;;;;;;;;;;;;;;;;;;;;;;;;;;;;;;;;;;;;;;;;;;;;;;;;;;2,0;;;;;;;;;;;;;;;;;;;4,0;;18,0;;;1,0;;;;;;4,0;6,0;;;1,0;3,0;9,0;1,0;;;;;;;;2,0;1,0;;;;;;;;;;;;;8,0;;;;;6,0;;;;;;;;;;2,0;;;5,0;3,0;;;1,0;3,0;1,0;;;4,0;;;;;;;;4,0;;;;;;;1,0;1,0;;;1,0;;;;;;;;;;;;;2,0;1,0;;;;;;;2,0;;;;;;;;;;;;;;;;;;;;;;;;;;;1,0;;1,0;;;2,0;;;;;;;;;;1,0;;;;;;;;2,0;3,0;;;59,0;;;;;;;1,0;;;;;2,0;3,0;;;1,0;;;;;;;;;;;;;;;1,0;;;9,0;;2,0;;;;;;;;1,0;;;;;;;;;;;;;;5,0;;;3,0;;;;;;;;;;;;;;;;;;;;;;;;;;;;;;;1,0;;1,0;;;;;;;;;;;;;;;;;;;;;;;;;;;;;;;;;;;;;;;;;;;;;;;;9,0;;;;;;;;;;;;;;;;;;;;;;;;;;;;;;;;21,0;;;;;;;;;;;;;;;;;;;;;;5,0;;;1,0;;;;;;;;;;;;;;;;;1,0;;;2,0;;;;;;;;;;;;;;;;;;;;;;;;;;;;;;;;;;;1,0;;;;;;;;;;;;;;;;2,0;;;175,0;;;;;;;;1,0;;;;;;;;;;;;;;;;;;;;;;;;;;;;;;;2,0;;1,0;;;;;;;;;;;;;;;2,0;;;;83,0;;;;;;;;;;;;;;;;;;;;;;;;;;;;;;;;;;;;;;;;;;;;;;;;;;;;;1,0;;;;;;;;;;;;;;;;;;;;;;;
gaming;;;;;28,0;;;12,0;;;;;14,0;;;13,0;;;;;;;;;;;;;;;7,0;;2,0;;;2,0;;;;;25,0;;1,0;;1,0;;50,0;94,0;13,0;27,0;;1,0;;;;;;;5,0;;;;;;;;;;;;;;19,0;;1,0;;3,0;;;15,0;;;;24,0;;3,0;;;;;;;;;;7,0;1,0;;39,0;3,0;4,0;6,0;;6,0;;;;9,0;1,0;;;2,0;;;;;;35,0;;;;;;;8,0;;;;;;;1,0;35,0;;;1,0;;;;;;3,0;9,0;34,0;;;;;1,0;;;;1,0;;;;30,0;;;;11,0;;;;;;9,0;2,0;;;;;;;;3,0;;;;;;;;;;;;;;;;;;;;;;;;;;;;;;;;;;;;;;;;;;;;;;;;;;;;;;;;;;;;;3,0;;;;;;;;;;;;;;;;;;;;5,0;;;;;;;;;;;;;;;;4,0;;;;;;;;;;;;;;;;;;;;;;;;;;;;;;;;7,0;;;;;;;;;;;;;;;;;;;;;;;;;;;;;;;;;;;;;;;;;;4,0;;;13,0;;;;;;;;1,0;77,0;;;;;;;;;;;;;;;;;;;;;;;;1,0;;;;;;;;;;;;;;;;;;;;22,0;;;;;;;;1,0;;;;1,0;;;;;;;;;;;;;;;;;18,0;;;4,0;;;;;;;;6,0;;52,0;8,0;;;21,0;;;;;;;;;1,0;;3,0;2,0;;;2,0;;;2,0;;;;;;;4,0;95,0;;;8,0;;;;;;;;;;;1,0;;;16,0;;1,0;;;2,0;;;;1,0;;1,0;;;;;;;;;;;4,0;;;;;;;;;;;;;;;1,0;;6,0;3,0;;;;;6,0;;4,0;;;;;;;;;4,0;;;2,0;;;;;;1,0;;;;;;;;;;;;;;;1,0;;;;;3,0;;;;3,0;;;;;;;;;;;15,0;;;;;;;;;6,0;2,0;;;;;12,0;;;;;;;;;;;;;;;;;3,0;;;;;;;;;1,0;;18,0;;;;;;;;;;;1,0;;;7,0;;;16,0;;;;;;;;;;;;;;;;;;;;;;;2,0;;;;;;;;;;;;15,0;;;;;;;;;;;;;;;;;;;;;;;;;;;;;;;;;;;;;;;;;;;;;;;;;;;;;;1,0;;;;;;;;;;;;;;;;;;;;;;;;;;;;;;;;3,0;;;;;;;1,0;;;;;1,0;;;;;;;;;;;;;;;;;;;;;1,0;;;;38,0;;;;;;;;;;;;;;;;;;;;;;;;;;;;;;;;;;;56,0;62,0;;;;;;;;;;2,0;3,0;1,0;;;;;;5,0;;2,0;;;;;;;;;;;;;;;;;;;;;;;;;;;;;;;;;;;;;1,0;;;;;;;;;;;;;;;;;;;;;2,0;;;;;;;;;;;;;;;;;;;;;;;;;;;;;;;;;;;;;;;;;;;;;;;;;;;;;;;;;;;;;;;;;;;;;;;;;;;;
gamma;;;;;2,0;9,0;1,0;25,0;;;1,0;;1,0;;;7,0;;;1,0;;2,0;1,0;;;;;7,0;;;;;;4,0;;3,0;;2,0;40,0;;;1,0;;;;24,0;4,0;8,0;18,0;1,0;;1,0;;;;;6,0;3,0;;;;1,0;;;;;;;1,0;;;1,0;;;;;;4,0;;;18,0;;7,0;;7,0;1,0;;;;;;1,0;;;;;;;;20,0;;;;1,0;2,0;;;1,0;;1,0;2,0;;4,0;;;;2,0;;12,0;;1,0;;;6,0;4,0;;;;;81,0;2,0;;1,0;;;1,0;;;;;;;;;;;;;1,0;8,0;;;;1,0;2,0;;;9,0;;;;;;4,0;;;;3,0;;8,0;;;;;;2,0;4,0;;;;;;;;;8,0;5,0;;;;;;;;;;15,0;;;;;;;2,0;1,0;;;;5,0;;;;;;2,0;;;;;;;13,0;;;;;;1,0;;13,0;;;;2,0;;;;;1,0;;;;;;;;;;;3,0;;;;;;;;15,0;;;;;;;8,0;;;;2,0;;;;;;;;;;;;5,0;;;;;;5,0;;;;;;;;;1,0;;7,0;;;;;;;;;;;;;;;;;;;;;;;7,0;;;;;;;;;;;;;;;;;;;;;;;;4,0;;;;;;;;;;;;;;;;;;;;;;;;;;;;;;;;;;;;;;;;;;;;;;;;1,0;;;;;;;;;;;;;;;;;;2,0;;2,0;;;;;;;;;;;11,0;;;2,0;;;;;;;22,0;;;;;5,0;8,0;2,0;;;;;;;4,0;;;;;1,0;;2,0;1,0;;;;;;;;;;;;;;;;;;1,0;;;;;;;;;;;;;1,0;;2,0;;;;;8,0;;10,0;;;;;;;;;;;;;;;;2,0;;;;;;;;;;1,0;;;;;;;;;;;;2,0;;;;;;;;;;;;;1,0;;;1,0;;;;;;;1,0;;;;;;2,0;2,0;6,0;;;;;;1,0;8,0;;1,0;;;5,0;1,0;;;;;;;;;;;;;;;;;;;;;;;;1,0;;;;;2,0;;;;;;;;;;;;;;;;;;;;;;1,0;;;;;;;;;;;;;;;;;;;1,0;3,0;;;;;;;;;;;;;;;;;1,0;;12,0;3,0;;;;;;2,0;;;;;;;;;;;;2,0;;;;;;;;;;;;;;;;;;;;;;;;;;;;2,0;;;;;;;;;;;;;1,0;;;6,0;3,0;;;;2,0;;;6,0;;;;;;;;;;;;;;;;;;;;;;;;;;;;;;;;;;;1,0;2,0;;;5,0;;1,0;;;;;2,0;;;;;;;;;2,0;;;;;;;;;10,0;;;;;;;;;;3,0;;;;1,0;;;;;;;;11,0;;;;;;;;;;;;;;;;;;;;;;;;;;;;;;;;;;;6,0;;1,0;;;;;;;;;;;;;;;;;;;;;;;;;2,0;;;;;;;;;;;1,0;;;;;;;;1,0;;;;;;;;;;;;1,0;;;;;;;7,0;;;;;;;;4,0;;;;;;;;;;;4,0;3,0;;;;;;;;;;;;;;;;;;;;;;;;;;;;;;;;;;;;1,0;;;;;;;;;;;;;;;;;;;;
generator;;;;;1,0;4,0;7,0;11,0;1,0;8,0;1,0;;;;1,0;12,0;7,0;;;;1,0;14,0;1,0;1,0;;;4,0;;1,0;1,0;;;55,0;;32,0;17,0;;;1,0;;10,0;;4,0;1,0;7,0;2,0;;19,0;12,0;9,0;6,0;4,0;;;10,0;;;;;;;;117,0;1,0;2,0;;7,0;7,0;27,0;6,0;;;132,0;4,0;;2,0;;;1,0;49,0;1,0;4,0;;21,0;;;1,0;;;;13,0;;;2,0;;;;;;;6,0;1,0;9,0;6,0;;4,0;6,0;13,0;10,0;2,0;;;;;;16,0;10,0;27,0;;4,0;;;7,0;;;;;;;;;74,0;3,0;;;1,0;3,0;3,0;;;1,0;;;11,0;;;;4,0;140,0;;;;;3,0;;1,0;6,0;;1,0;7,0;;9,0;22,0;;;;9,0;;;;4,0;;1,0;12,0;3,0;11,0;;1,0;;;5,0;;;;;14,0;;8,0;;;1,0;;;3,0;;4,0;;;4,0;;;;;8,0;4,0;;2,0;;2,0;7,0;;;10,0;;;;;57,0;;4,0;;;;2,0;;;;;5,0;;2,0;;;7,0;1,0;4,0;;;6,0;;;;;;;;;;2,0;;1,0;;;;;;17,0;;;;;;;1,0;;1,0;1,0;;;;;3,0;7,0;;;;;1,0;;10,0;;5,0;;;;42,0;;;;;;;1,0;;;;;;;;;1,0;2,0;6,0;;;;11,0;2,0;;;2,0;;;;;;;;4,0;;;;;5,0;;;;;;;;;;;1,0;;6,0;;;;;2,0;;;2,0;;;1,0;17,0;2,0;;;4,0;;;2,0;1,0;;;;;;2,0;6,0;;;;;;;;;;;;;;4,0;;;;;;;1,0;;;;4,0;;;8,0;;2,0;;;;;;;;;2,0;;;;;;3,0;;4,0;1,0;;;1,0;4,0;;;;;;;;;;;;5,0;;;3,0;;;;;2,0;;;;1,0;2,0;2,0;;;;6,0;2,0;;2,0;;;;;;2,0;;;;3,0;;;;;;;2,0;;;;;;;;;;2,0;;9,0;;2,0;2,0;;3,0;;24,0;;;1,0;;14,0;;;;;5,0;;;;;;;;;1,0;;;;;;2,0;1,0;;;;;;;;;;;;;;4,0;;;;2,0;1,0;1,0;;;;;6,0;;;1,0;;26,0;;;;8,0;;;;6,0;;;3,0;;8,0;;;5,0;;;;;3,0;;;8,0;;;;;1,0;;;;;;;1,0;;;;;;;;3,0;;;;;;;;;;;;;;;3,0;;;;;1,0;;;;;;1,0;;;;;;;;;;;;;;;;;;;;;;;;;;;;;;;1,0;6,0;;;;;;;;;;;;;;;;;;6,0;;;;;;;;;1,0;;;;;;;;;;;;;;;3,0;;;;;;;1,0;;6,0;;;;;;;;;;;;;;;;;;;;;;;;10,0;;;;;;;1,0;;9,0;;;;;;;;;;;;4,0;;;1,0;4,0;;;;;;;;;;;;;;;;;;;;;;3,0;;;;;;;3,0;;;4,0;;;2,0;;;;;;;;;;;1,0;;;;;;;;10,0;;;1,0;;;;;;;;2,0;;;2,0;;;;;;;;;;;;;;;2,0;;;;;;1,0;;;1,0;;;;;;;;;;;;;;1,0;;;;;;;;;;;;;;;;1,0;;;;;;;;;1,0;;;;;;19,0;;;;;;;;;;;;;;;;;1,0;;1,0;;;;;4,0;;1,0;1,0;;;;;4,0;;;;;;;;2,0;;6,0;;;;;;;;;;;;;;;;;;;;;;1,0;;;;;;;7,0;;;;;;;;;1,0;;;;;;;;;;;;;;;;;;;;;;;;;14,0;;;;;;;;;;;;;3,0;
gesture;;;;;18,0;;;4,0;3,0;;;;2,0;;;52,0;;;;;;28,0;1,0;;;;;2,0;;;5,0;;13,0;;33,0;;;;;;39,0;;1,0;19,0;106,0;23,0;16,0;59,0;;23,0;;1,0;;;;5,0;8,0;;;;;;5,0;;3,0;;;4,0;23,0;;2,0;;1,0;;;11,0;1,0;1,0;1,0;88,0;;2,0;1,0;30,0;;10,0;;;;;;;1,0;;;3,0;;;76,0;;;3,0;3,0;36,0;;5,0;;;3,0;2,0;3,0;33,0;;;;10,0;20,0;;10,0;1,0;;;7,0;9,0;38,0;;;;;3,0;;;8,0;;7,0;21,0;;9,0;17,0;;;;8,0;102,0;;;;;8,0;1,0;7,0;;2,0;;9,0;;43,0;;;;7,0;2,0;;;;;31,0;4,0;;;;;;;1,0;;;;;;;1,0;;;;;;;;;;;;3,0;;4,0;;;;;;;1,0;24,0;;;;;;;;;;;;;;;;;;1,0;;;;;;;5,0;;;;;;;;1,0;;;;1,0;;;;;;;4,0;21,0;;;;;;;1,0;13,0;;;;;;;4,0;;;;;15,0;;6,0;;5,0;;;;7,0;3,0;;3,0;;;;;;14,0;;23,0;;;;;;;;;;;;;;;;;;;;;;;;;;;;3,0;;;;1,0;;;;;;;;;;;;;;;;;;;20,0;;;;;;;;;;;;;;;;;;;11,0;;;;;;;;;;;;;;;;11,0;;;;;;;;;3,0;;;;;;;;;3,0;;;;;;;;;;;2,0;;;;;;;;3,0;;6,0;;24,0;;4,0;;;;;;2,0;1,0;;;3,0;2,0;;11,0;;56,0;;;7,0;;2,0;;12,0;;1,0;4,0;3,0;;;6,0;5,0;;1,0;3,0;;;;;16,0;;;3,0;;;1,0;;;;;;;;;15,0;;;;2,0;87,0;2,0;;;;4,0;;;1,0;;;;;1,0;;;;4,0;2,0;1,0;4,0;;1,0;;8,0;;14,0;;;;;;;;;;1,0;8,0;4,0;;3,0;2,0;;;1,0;;;3,0;;;5,0;;;;;12,0;;;1,0;;;;;;;6,0;;;2,0;1,0;18,0;;4,0;5,0;;26,0;;;;3,0;;;;;;4,0;;;;;;9,0;;;;;;;;;;12,0;;;;;;;8,0;;;;;;;;;;;;;;;1,0;3,0;;10,0;;3,0;;;3,0;;;;3,0;;3,0;;;;;;;;;;2,0;;15,0;16,0;;24,0;;;2,0;;;;7,0;;;2,0;;;;1,0;;;3,0;;1,0;;;;6,0;;;;;;;;;;;;;;1,0;;;;;;;;;;;;;;;;;;6,0;;;;;;;;;;1,0;;;;;;;;;;;;;;;1,0;;1,0;;;;;;;;;;;;;;;;;;;;;;;;4,0;;1,0;;;1,0;4,0;;9,0;;;1,0;;;;;;;;;;;;;;;2,0;;;;;;1,0;;;;;;;;;2,0;;;;;;3,0;;4,0;;;3,0;;1,0;;;24,0;;;;;;;;;;;;;;;;;;;;;;;;;;;;;;;;;;1,0;;;2,0;2,0;;;;;;;;;2,0;;;;;;;4,0;2,0;;;4,0;;;;;1,0;;;3,0;;9,0;20,0;;;;;3,0;;7,0;1,0;;;;;;;;;;;;;;;;;;1,0;;;;;;;7,0;;;2,0;;;;;;;3,0;1,0;;;;;;;;;;;;;;;;;;;;;;;7,0;;1,0;;;;4,0;;3,0;;;;;;;;;;;;;;;;;;;;;;;;;;;;;;;10,0;;;;;10,0;;;;;;;;;;;;;;;;;;;;1,0;;;;;;;;;;
guide;;;;;1,0;21,0;14,0;46,0;125,0;30,0;10,0;;2,0;;179,0;78,0;28,0;3,0;;1,0;;20,0;2,0;6,0;13,0;;6,0;;;;;;116,0;;27,0;13,0;7,0;;2,0;1,0;2,0;;33,0;1,0;1,0;6,0;2,0;88,0;7,0;72,0;65,0;15,0;;1,0;40,0;11,0;122,0;;8,0;;130,0;20,0;8,0;;9,0;;18,0;129,0;66,0;10,0;6,0;;24,0;5,0;;3,0;;8,0;9,0;191,0;3,0;40,0;;137,0;2,0;4,0;1,0;;5,0;3,0;245,0;;;3,0;3,0;3,0;15,0;;33,0;11,0;;3,0;117,0;20,0;2,0;8,0;272,0;5,0;3,0;;26,0;5,0;3,0;1,0;;48,0;256,0;114,0;;3,0;13,0;14,0;3,0;;3,0;2,0;;;4,0;3,0;;10,0;25,0;1,0;3,0;;21,0;3,0;;;33,0;3,0;2,0;21,0;;;;57,0;9,0;4,0;1,0;;2,0;19,0;59,0;1,0;100,0;;3,0;12,0;;6,0;203,0;6,0;;;3,0;68,0;1,0;;7,0;;1,0;8,0;;5,0;77,0;105,0;;;3,0;54,0;;13,0;5,0;6,0;;28,0;;;;;5,0;41,0;;39,0;;7,0;;35,0;4,0;3,0;;174,0;;28,0;2,0;;3,0;12,0;6,0;5,0;8,0;;1,0;;169,0;8,0;;132,0;62,0;33,0;11,0;8,0;;3,0;1,0;5,0;422,0;;291,0;2,0;25,0;35,0;65,0;72,0;104,0;25,0;21,0;5,0;14,0;1,0;17,0;23,0;;;4,0;;9,0;7,0;47,0;;27,0;;2,0;;94,0;11,0;;2,0;2,0;;8,0;10,0;;;26,0;;7,0;;83,0;21,0;27,0;;;18,0;2,0;14,0;16,0;118,0;2,0;;4,0;7,0;;1,0;;1,0;;9,0;16,0;3,0;4,0;;57,0;;4,0;;3,0;3,0;29,0;6,0;17,0;2,0;23,0;17,0;2,0;27,0;48,0;;;6,0;2,0;9,0;19,0;7,0;;11,0;;62,0;2,0;;;6,0;35,0;1,0;27,0;28,0;;3,0;9,0;4,0;6,0;;;;;;23,0;105,0;7,0;9,0;64,0;6,0;1,0;10,0;6,0;9,0;54,0;1,0;3,0;19,0;;21,0;6,0;15,0;27,0;10,0;2,0;;3,0;21,0;23,0;16,0;116,0;12,0;;17,0;10,0;4,0;;;;3,0;10,0;2,0;23,0;9,0;36,0;31,0;3,0;2,0;1,0;62,0;3,0;3,0;1,0;16,0;15,0;83,0;94,0;6,0;4,0;15,0;4,0;;5,0;2,0;13,0;;;;;8,0;2,0;6,0;;;1,0;3,0;3,0;;;;;1,0;;1,0;;;;;2,0;;;;;19,0;;;;9,0;;80,0;9,0;;9,0;2,0;4,0;;2,0;17,0;41,0;;;4,0;27,0;;8,0;;15,0;;;;;7,0;;;;;;;;;;4,0;;18,0;;30,0;5,0;11,0;3,0;;13,0;;;2,0;;;11,0;19,0;;12,0;;;4,0;;;;12,0;;;;;;;1,0;7,0;2,0;47,0;;;23,0;;;9,0;;4,0;;;13,0;5,0;;;;;;3,0;;2,0;;16,0;2,0;;;1,0;3,0;;;;;3,0;8,0;;;3,0;;1,0;3,0;;12,0;2,0;;;1,0;;4,0;2,0;;;1,0;;6,0;;1,0;3,0;;13,0;;;1,0;;;8,0;;3,0;2,0;;;8,0;;2,0;;1,0;4,0;;;;;;6,0;;1,0;5,0;;;;51,0;;;;;15,0;10,0;;;;11,0;;22,0;;;3,0;;;;1,0;;;;3,0;5,0;;10,0;;;;;;;;;;2,0;;3,0;;2,0;;;3,0;;1,0;;;2,0;47,0;;;;;;;2,0;;;101,0;;1,0;3,0;;;5,0;2,0;4,0;;;4,0;;6,0;;;;3,0;7,0;4,0;10,0;1,0;1,0;5,0;1,0;;;1,0;12,0;;3,0;2,0;;;;;;;5,0;2,0;2,0;;2,0;;;2,0;;1,0;2,0;1,0;1,0;5,0;5,0;;;2,0;;4,0;9,0;2,0;;18,0;;1,0;1,0;;13,0;;;;;1,0;;;39,0;;;;7,0;;1,0;4,0;11,0;;;2,0;2,0;8,0;;1,0;13,0;;6,0;1,0;;;6,0;2,0;3,0;;12,0;;63,0;6,0;;;8,0;;30,0;6,0;;2,0;;;;;;;;;;;;;;;5,0;;4,0;;;;1,0;2,0;4,0;;;;;3,0;;;;;;;6,0;;;;2,0;39,0;;;;1,0;;17,0;;6,0;;;;;;;;1,0;;;;;;6,0;3,0;;;;;;;;;;;;;;1,0;2,0;6,0;;;;;;;;;2,0;1,0;;;;;;;;;;;;;4,0;;;;12,0;3,0;;11,0;;2,0;;3,0;4,0;;;19,0;;1,0;;29,0;28,0;;;;;;;;;3,0;;;;;6,0;;;;1,0;;;;;;;4,0;;134,0;;5,0;1,0;1,0;;;3,0;;;3,0;2,0;4,0;;3,0;21,0;24,0;1,0;;;;;;1,0;;;;6,0;1,0;;;;5,0;1,0;6,0;;5,0;;;15,0;;2,0;4,0;3,0;;;1,0;2,0;;;;;;;;;;;;;;;;2,0;;;3,0;;;;;8,0;;;;;4,0;;;2,0;;;;;;;;2,0;;;2,0;;
histogram;;;;;3,0;;;8,0;6,0;10,0;;;15,0;;;13,0;;;5,0;;8,0;9,0;;;;2,0;19,0;;;;1,0;;2,0;5,0;;;;6,0;6,0;;9,0;;4,0;15,0;2,0;32,0;24,0;1,0;;3,0;;;;6,0;;38,0;12,0;;5,0;;;;;;2,0;;;5,0;51,0;;8,0;;28,0;;;1,0;4,0;;;103,0;;2,0;;14,0;2,0;;;;;;;;;;;;;;26,0;1,0;6,0;;;27,0;;1,0;;3,0;3,0;7,0;;7,0;;;;30,0;7,0;;;3,0;;;;15,0;3,0;;4,0;;;4,0;;9,0;3,0;;6,0;2,0;;;2,0;;5,0;;;2,0;;;;;5,0;;;;;2,0;1,0;;9,0;;;;;3,0;7,0;;;;46,0;;;;;;;;2,0;;1,0;;;;;;;;;2,0;;7,0;;;;;;;;;;;;;;;34,0;;;;;;;1,0;;;;;;;;;;;;;;;;;;;3,0;;;;;;;;;;;;3,0;;;;;;;;30,0;;;;;;;;1,0;1,0;;;;;;4,0;;;2,0;;;;;;4,0;;;;;;;3,0;;;;;;3,0;9,0;2,0;;;3,0;;;;;;7,0;;;;;;;;;;;2,0;;;;;;;;;;;;;;;;;;;;;;;;;;;;6,0;;;;;;;;;;;;;;;;;;;;;1,0;1,0;;;;;;;;;;;;;;;;;;;;;;;;;;;;;;;;;;;;;;;;;30,0;;4,0;;;1,0;;;;;;10,0;6,0;;11,0;;12,0;;;;;;1,0;;;1,0;;2,0;4,0;7,0;;;;;8,0;;5,0;;9,0;1,0;;;;25,0;3,0;;;;1,0;;6,0;;;;;;;;;;;1,0;;;;;;;;;9,0;5,0;;;;;;;24,0;;;;;;6,0;2,0;3,0;;;5,0;;;;5,0;1,0;3,0;;;;;1,0;;;;;;1,0;;3,0;;;;1,0;;;;;;;;;;1,0;;;;;;;;;;;2,0;;;;;5,0;;;;;;;;;1,0;11,0;;;;;;9,0;;;;;;;;;3,0;;3,0;;;;;;;;;;;;;;;1,0;;;;;;;;;;;;;;;;;;;;;;;;;;;;;;;;;;;;;;;;;;;;;;;;5,0;;;;;;;;1,0;;;;;;2,0;;;;;;;;;;;;;;;;;;;;;;;;;;;;;;1,0;;;;;;;;;;;;;;;6,0;;;;;;;;;;1,0;;;;;;;;;;;;;;;;;;;;;;;;;;;;;;;;;;;;;2,0;;;;;;;;;;;;;;;;;;;;;;;;;;;;;;;;;;2,0;;;;;;5,0;1,0;;;;;;8,0;;;;;;;;;2,0;5,0;;;;;;;;;;;3,0;;;1,0;;;;;3,0;;;20,0;;;;;2,0;;;13,0;;;2,0;;;;1,0;;1,0;;;7,0;;;;;;;;;;;;;;;;;;;;;;2,0;;;;;;;;;;;;;;;;;;;;;;;;;;;;;14,0;;;;;1,0;;;;1,0;;;;;;;5,0;;;;;1,0;;;;;;;;;;;;;;;;3,0;;;;;;;;;;;11,0;;;;5,0;;6,0;;;;;;;;;;;;;;;;;;;;;;;;;;;;;;;;;;;;;;2,0;1,0;;;;;;;;;;;;;;;;;;;;;;;;
human;;;;;4,0;4,0;;6,0;3,0;2,0;;;6,0;;;11,0;;;1,0;;;10,0;;;3,0;;20,0;3,0;1,0;;5,0;2,0;9,0;1,0;1,0;1,0;;4,0;1,0;;8,0;;;20,0;22,0;6,0;10,0;27,0;2,0;6,0;;;;3,0;;;1,0;;1,0;;4,0;1,0;10,0;;;;3,0;;4,0;;1,0;1,0;;;1,0;7,0;;2,0;;49,0;1,0;4,0;;22,0;;5,0;;6,0;;8,0;3,0;;1,0;;;2,0;;;42,0;;5,0;;;21,0;;;2,0;;9,0;;5,0;4,0;;;1,0;5,0;32,0;8,0;;2,0;;;1,0;13,0;2,0;5,0;;;2,0;24,0;;1,0;1,0;;13,0;1,0;;;;;3,0;;1,0;;;1,0;1,0;;3,0;10,0;4,0;;2,0;4,0;113,0;;16,0;;;;;5,0;7,0;;1,0;;11,0;18,0;3,0;3,0;;;;;;;;;;;;31,0;;1,0;;;;1,0;;;;;;3,0;;1,0;;;;;;;;1,0;;1,0;;;;33,0;;;;;;;;;9,0;;2,0;;;1,0;;1,0;;;5,0;;;;1,0;;;4,0;9,0;2,0;;;;;1,0;;;;;;;;;;;;1,0;;;4,0;;;;;;9,0;;;6,0;;;;;2,0;;;;;;;;1,0;;;;;;4,0;;;4,0;;1,0;1,0;;;;;;;;;;;1,0;;;;;4,0;;;5,0;;;;;;;;;2,0;2,0;;;;;;;;;1,0;;4,0;;;;1,0;;;;;;;;2,0;;;;1,0;;;;;;1,0;;;;;;3,0;;;;;;;;;;1,0;;;;;;1,0;;;;;;;2,0;;;;;;;;;24,0;;;;;;11,0;;;;;;2,0;;;;;;1,0;3,0;;6,0;;;;6,0;;1,0;;;;;3,0;;;1,0;13,0;;16,0;;7,0;5,0;;1,0;;3,0;;1,0;;;18,0;1,0;;1,0;;1,0;;;;;;;;;1,0;1,0;1,0;;8,0;2,0;;3,0;;;6,0;;;;12,0;;2,0;;;29,0;;;;;;;;;1,0;1,0;;;;1,0;;;1,0;19,0;;1,0;;4,0;10,0;1,0;;2,0;4,0;;;;;;;;;5,0;;11,0;;;;;;;;;;;;;;;;;;;;;;;;3,0;;;;;;;2,0;;;;;;1,0;;13,0;;;;1,0;;;;;;;;;;2,0;;1,0;;;;2,0;2,0;;;;;4,0;;;;;7,0;;;;1,0;9,0;;;;;;;;;;1,0;;;2,0;;;1,0;;;;;;;;;3,0;;;;;2,0;;;;;2,0;2,0;6,0;;23,0;;;;;;;;;;;;;;;1,0;;;;;;;9,0;3,0;;;;;;;;1,0;;;3,0;;;7,0;;;;;;;;;;;1,0;;;;;5,0;;18,0;;2,0;2,0;;;;;;1,0;;1,0;;;;;;;;;;;;;;;;;;;;;1,0;1,0;;;;;;;;;;;;;;;2,0;;;3,0;;;;;;;2,0;;;;3,0;;;;;;;;2,0;;;;;;;;;;;;;2,0;;;;;;;;;12,0;;;;;;;;;;;6,0;;;1,0;1,0;3,0;1,0;;;;;;;;;;;;;2,0;;;;;;;;;;;;;1,0;;;;;12,0;;4,0;;;2,0;;3,0;;;2,0;;1,0;;;2,0;;;;;2,0;1,0;;5,0;4,0;;;;;1,0;;;;;;;;2,0;;;;;;;1,0;;;;1,0;;;;;;;;;;;;;;;2,0;1,0;;;;;;;;;1,0;;;;;;;;;;;;;;;;;;;;;;;;;;;;;;;;;;;;;2,0;;;;;;1,0;;;;;;;;;;;;;;;;;;2,0;1,0;;;;;;;;;;;;;;;;;;;;;;;;;13,0;;;;;;;;;;;;;;;;;;
incident;;;;;4,0;62,0;5,0;2,0;22,0;8,0;27,0;;2,0;2,0;37,0;7,0;46,0;;;;3,0;16,0;;2,0;;;14,0;;;;;12,0;54,0;;6,0;1,0;;1,0;;1,0;4,0;4,0;24,0;;13,0;5,0;13,0;32,0;10,0;8,0;9,0;15,0;4,0;5,0;;1,0;30,0;;;;2,0;;2,0;;40,0;2,0;7,0;37,0;1,0;5,0;11,0;;31,0;;;8,0;;;3,0;140,0;4,0;66,0;;16,0;3,0;;7,0;;1,0;3,0;172,0;;;5,0;;;;;14,0;;;;12,0;66,0;2,0;2,0;137,0;;29,0;;29,0;13,0;4,0;;;23,0;52,0;29,0;;8,0;;19,0;;3,0;4,0;;;14,0;26,0;;2,0;12,0;;;15,0;4,0;7,0;13,0;2,0;4,0;16,0;;;51,0;;;;61,0;76,0;;;;1,0;8,0;21,0;3,0;78,0;;;5,0;;24,0;43,0;;9,0;;2,0;2,0;2,0;34,0;9,0;1,0;;13,0;39,0;;5,0;;1,0;2,0;7,0;10,0;1,0;;55,0;10,0;3,0;3,0;;;;;3,0;10,0;;;;;;2,0;;;3,0;52,0;;;19,0;1,0;5,0;31,0;7,0;1,0;;1,0;;2,0;;;;11,0;3,0;;13,0;;;;;;963,0;;20,0;;15,0;9,0;6,0;1,0;;16,0;6,0;3,0;;4,0;;19,0;2,0;13,0;28,0;;115,0;5,0;;1,0;;;;1,0;47,0;45,0;4,0;;;;;;3,0;;1,0;15,0;18,0;;;37,0;5,0;;;;;;33,0;233,0;;;1,0;2,0;;3,0;1,0;;;6,0;4,0;1,0;;1,0;;;;;5,0;;1,0;39,0;;;;;;22,0;;;;8,0;4,0;3,0;2,0;;;;1,0;;;;1,0;;;;;;;4,0;;;1,0;;;;;33,0;7,0;3,0;;2,0;;4,0;3,0;;;;1,0;;1,0;10,0;;11,0;;;;;5,0;;;;;;1,0;;;;1,0;20,0;4,0;;;8,0;7,0;;;;;;;;3,0;;;11,0;;;;2,0;;;;36,0;;;;;;2,0;;;;6,0;;;;;;;5,0;;3,0;;;;;;;1,0;2,0;1,0;5,0;;;;;;;;;4,0;11,0;4,0;;;;3,0;;1,0;;;2,0;;;;2,0;;;2,0;2,0;;;;1,0;3,0;;;;2,0;15,0;;;;;;;;;;11,0;;;;;;;;5,0;;2,0;4,0;;5,0;;;;;;1,0;;;;1,0;1,0;;;;;;;;;27,0;;;;;4,0;;2,0;6,0;;;;;;;5,0;;;;;;;;;;;;;;;;6,0;;;8,0;;;;;;;;4,0;;;;1,0;;;7,0;;;;;;;2,0;;;3,0;22,0;;;2,0;2,0;;2,0;59,0;;8,0;;;1,0;;;;;;;;;;;;1,0;;;;;;;;;;;2,0;;2,0;;;;;;;1,0;;;;;;;;;;;;;3,0;;;1,0;;;25,0;;;;5,0;;;2,0;;;;;;;;;;;;;;;;;4,0;;;;;;;;;;;;;;28,0;2,0;;18,0;;;2,0;;;;;5,0;;;;;;;;;;2,0;;;;;;;;;;3,0;;;;;;;3,0;;;;;3,0;;;;;;4,0;;;6,0;;;;;1,0;;;;;7,0;2,0;1,0;1,0;;;;;16,0;;1,0;8,0;;;;;;;;;;1,0;;;6,0;;;2,0;;;;;;8,0;1,0;;;9,0;1,0;;;;1,0;;;2,0;;;2,0;;;;5,0;;4,0;;2,0;3,0;;;2,0;;1,0;;;;4,0;5,0;;;;;;;1,0;;;5,0;2,0;;;;9,0;;;;21,0;;;;;;;;;;3,0;;;;;;;;;29,0;;;;;;;;;10,0;;;1,0;;;;;;;;;;;;;;;;1,0;;;;;42,0;;;2,0;;;;8,0;;;;;;12,0;;;;;;;4,0;;;;;;2,0;;;;2,0;;;;5,0;;12,0;;4,0;;;;;2,0;;;;;;;3,0;;;2,0;;;;;;;;;;;;;;;;;;;;;;;;2,0;;13,0;;;;;2,0;;;;;;2,0;;2,0;;;;;;;26,0;;;;;;;;;;;2,0;;;;;1,0;;;39,0;;;;;;;;;;;;;;;;;
interest;;;;;21,0;7,0;1,0;14,0;92,0;2,0;;;20,0;;4,0;44,0;2,0;;;2,0;2,0;28,0;;;2,0;;41,0;;;;5,0;35,0;13,0;;11,0;1,0;5,0;2,0;7,0;;19,0;;25,0;7,0;92,0;5,0;84,0;13,0;14,0;35,0;2,0;16,0;;;;2,0;24,0;4,0;10,0;;1,0;;15,0;;4,0;10,0;20,0;3,0;17,0;4,0;3,0;;35,0;;3,0;4,0;34,0;8,0;;322,0;;17,0;;48,0;1,0;6,0;2,0;;;;3,0;;2,0;;;1,0;5,0;4,0;72,0;;8,0;1,0;7,0;250,0;;6,0;5,0;7,0;10,0;;;10,0;;;;58,0;16,0;46,0;;20,0;;;2,0;12,0;18,0;2,0;;;3,0;12,0;;20,0;13,0;;7,0;9,0;17,0;12,0;1,0;;63,0;;;21,0;16,0;;;2,0;11,0;5,0;4,0;;1,0;14,0;10,0;;51,0;;1,0;;1,0;1,0;6,0;;;;27,0;37,0;1,0;1,0;11,0;;;4,0;;2,0;1,0;;;;;;;;;7,0;;;2,0;;2,0;1,0;;;1,0;;5,0;;1,0;1,0;;;16,0;5,0;;;;;;4,0;;;;;;;;;;;1,0;;;;;3,0;;;8,0;;;;;;;13,0;3,0;;;;19,0;;10,0;;;;;;184,0;3,0;;;;;;;13,0;;;;;;6,0;18,0;;;1,0;;;;4,0;4,0;10,0;;;;3,0;7,0;;9,0;;;;;;9,0;;4,0;;;20,0;1,0;;;;;2,0;;;;;;;;;;;11,0;;7,0;;;;;1,0;;;;;1,0;;;;;;;;;9,0;;;;;;;;;;;;;;;;4,0;;;2,0;;2,0;;;;;;;1,0;105,0;;10,0;;;;;;;;2,0;;;1,0;;;1,0;;;;;;;;;;;;1,0;;;;;8,0;57,0;3,0;;;;;4,0;9,0;;;;;5,0;;;;;;15,0;4,0;;3,0;;7,0;;4,0;;1,0;1,0;;;;;;1,0;1,0;26,0;;;;1,0;3,0;;45,0;;26,0;1,0;6,0;1,0;8,0;12,0;8,0;;13,0;3,0;;5,0;;;;;;;3,0;7,0;3,0;;;2,0;1,0;;;;;;;;6,0;6,0;2,0;;1,0;2,0;15,0;4,0;25,0;;;;3,0;6,0;2,0;31,0;32,0;;20,0;7,0;;3,0;;4,0;23,0;2,0;;4,0;;15,0;2,0;;2,0;;;;6,0;;3,0;;;;4,0;;;;1,0;;2,0;;5,0;;;;;;;;;;;;;2,0;;;;;2,0;;;;;;;2,0;;4,0;1,0;3,0;;3,0;;;1,0;1,0;;14,0;;;;;;;;5,0;1,0;3,0;;1,0;;;2,0;;3,0;;;2,0;;;;;;;;1,0;;;;20,0;;;6,0;;;3,0;;;;;2,0;;8,0;;;;;1,0;3,0;;;;;2,0;;;;;;1,0;;;;;;4,0;3,0;;350,0;3,0;;;;;;1,0;1,0;;1,0;;;1,0;1,0;;6,0;1,0;;;;;3,0;1,0;;;;;;;;;;;;;2,0;;;1,0;;3,0;;;1,0;;;;;;;;;;;2,0;;;;;;;;;;;;;;;4,0;2,0;;;;;;1,0;;;2,0;;;;;;;3,0;;2,0;;;3,0;;;;;;;;;;;2,0;;;;;1,0;;;;;;3,0;;1,0;;;;;;;10,0;;17,0;;;;;;;1,0;;;;;;4,0;;1,0;4,0;;;;;;41,0;;;;;;2,0;;;;;;;10,0;10,0;;2,0;;;;;2,0;;;;;;;;2,0;;;;;;3,0;;1,0;14,0;;1,0;;7,0;1,0;;;1,0;8,0;;6,0;3,0;;;;;;6,0;1,0;1,0;;7,0;4,0;;;;;;;;1,0;1,0;1,0;1,0;3,0;;;;;;3,0;;;;;2,0;;;1,0;16,0;;;;;;;2,0;;;1,0;;;;;;;;;;;6,0;;;;1,0;6,0;;2,0;1,0;21,0;;;;;3,0;;;;1,0;;7,0;2,0;4,0;;;;1,0;;;;;;;1,0;;;9,0;2,0;;;;;;;;;;;;;;;;;;;;;1,0;;;;1,0;;;;;;;;;;;;;;;;;;;1,0;6,0;;;;;;;;20,0;;1,0;10,0;;3,0;;2,0;;;;;;;1,0;;1,0;;;;;;;;;;;
interval;;;;;4,0;2,0;21,0;10,0;;16,0;1,0;2,0;62,0;;132,0;26,0;;1,0;1,0;;4,0;27,0;20,0;;;2,0;5,0;;;1,0;3,0;27,0;17,0;;29,0;1,0;;;1,0;;29,0;81,0;4,0;;13,0;5,0;23,0;16,0;11,0;4,0;23,0;19,0;;1,0;18,0;6,0;26,0;;;3,0;5,0;;3,0;;1,0;5,0;16,0;13,0;50,0;4,0;2,0;;2,0;;5,0;59,0;14,0;;3,0;134,0;;14,0;;15,0;24,0;9,0;3,0;;;19,0;708,0;;;;4,0;;3,0;;55,0;;1,0;;6,0;60,0;;1,0;142,0;7,0;11,0;1,0;1,0;22,0;;;;34,0;22,0;29,0;25,0;120,0;;;11,0;17,0;2,0;4,0;;2,0;;9,0;;7,0;25,0;;6,0;;30,0;9,0;6,0;30,0;6,0;;5,0;17,0;5,0;;;57,0;49,0;13,0;15,0;;3,0;3,0;4,0;5,0;23,0;19,0;;15,0;2,0;8,0;384,0;6,0;51,0;;33,0;;;2,0;52,0;;;11,0;10,0;1,0;;;;;;4,0;;;2,0;3,0;;;4,0;;;;1,0;;;;1,0;;;2,0;17,0;;4,0;145,0;1,0;;3,0;3,0;23,0;;;;;;;2,0;4,0;;;1,0;10,0;;1,0;3,0;;;2,0;;28,0;;30,0;7,0;;12,0;1,0;79,0;4,0;8,0;;8,0;8,0;;;2,0;5,0;;;;53,0;9,0;4,0;;;;;8,0;7,0;7,0;;;;;;23,0;;;;;4,0;;;8,0;11,0;;;;36,0;11,0;5,0;53,0;2,0;5,0;;;;375,0;2,0;;;;7,0;26,0;;;1,0;;1,0;;;;4,0;4,0;;39,0;;;4,0;3,0;1,0;;;14,0;;51,0;3,0;2,0;;3,0;6,0;;;;;;1,0;;;2,0;;;;;;;;16,0;;3,0;;;;;2,0;3,0;30,0;;;;;4,0;2,0;4,0;;1,0;2,0;;;18,0;;;;6,0;;;10,0;;;2,0;;;4,0;;;1,0;;;1,0;;;;;;;;;3,0;;;;1,0;;;;;;5,0;;;;;;;;;;;;8,0;;5,0;11,0;1,0;;;8,0;2,0;;3,0;3,0;2,0;2,0;;;1,0;6,0;;3,0;;;;1,0;;3,0;;;;4,0;9,0;4,0;1,0;3,0;7,0;4,0;;;2,0;18,0;;;22,0;;;;13,0;12,0;8,0;;;;;;;;4,0;;;;;2,0;3,0;;;6,0;;5,0;;;;;;18,0;;;6,0;;;2,0;;;;2,0;;44,0;1,0;;;;4,0;;;4,0;;;9,0;;;;;5,0;;4,0;;;;;6,0;;;;14,0;2,0;5,0;;;1,0;;;;;8,0;;;;;;;;8,0;;;;4,0;;5,0;;;;4,0;;;;;5,0;;;4,0;;;;;;;;1,0;4,0;7,0;;1,0;;;;;;;;5,0;;1,0;;;;;;;3,0;4,0;;6,0;;1,0;27,0;;;1,0;;;;;;;6,0;1,0;;;1,0;11,0;6,0;;2,0;;;;;;;;;;;1,0;;1,0;;6,0;2,0;;2,0;4,0;;2,0;20,0;;4,0;15,0;;;;;;4,0;7,0;;;;;;;;2,0;;;2,0;;;;;;;;;;;;;10,0;;;13,0;;20,0;;;5,0;;;;;;1,0;;;;;;;5,0;;2,0;;;;;;;;;;;;;;;;;;;1,0;4,0;;;;;;3,0;;;;;;;;;;;;18,0;;;;;2,0;;1,0;;;;;;;1,0;4,0;;;10,0;;;;;;;2,0;;;;;;;;1,0;;1,0;;;;;;;2,0;;;;;;5,0;;;2,0;;;3,0;;;;1,0;;3,0;;;1,0;1,0;;;;3,0;;;;1,0;;;;;6,0;;;;;;;;2,0;1,0;9,0;;;1,0;;;;;1,0;;;;28,0;;9,0;;1,0;;;1,0;3,0;;;7,0;;2,0;;;;;;;;;2,0;;4,0;;;;;;;;;;;;;;;;;2,0;;;;;;1,0;1,0;;;;;;;1,0;;;;3,0;7,0;;;4,0;;;;;;;;;;;16,0;;;;;;;;;2,0;;;;;;;;;;;1,0;;;;;;1,0;8,0;;;;3,0;;5,0;;;1,0;;;;;;;;;;3,0;;;;;12,0;;2,0;;;;;1,0;;1,0;;1,0;;;;10,0;;;;;;;2,0;;;1,0;;;;;;;;;;;;;;;;;2,0;;;;;;;;
iris;;;;;3,0;8,0;5,0;31,0;;8,0;;1,0;2,0;;;8,0;;;2,0;;;2,0;;;1,0;;8,0;1,0;;;;3,0;;;15,0;;;;3,0;;4,0;;;4,0;;;10,0;3,0;3,0;6,0;;19,0;;;6,0;;;;;;;;1,0;;3,0;;1,0;1,0;;;20,0;1,0;;;;9,0;4,0;;;29,0;;1,0;;8,0;;;;;;2,0;45,0;;;;;;;;16,0;;;;5,0;2,0;2,0;;28,0;6,0;;;2,0;10,0;;;;11,0;4,0;15,0;;;2,0;1,0;;;2,0;;;;;21,0;;3,0;;;;1,0;;;;;3,0;;;2,0;9,0;;;;8,0;;;;;3,0;4,0;;20,0;;;;;4,0;13,0;;;;;;;;5,0;;;;2,0;;3,0;;;;;3,0;;;;;;1,0;;;;;;;;;;;;;;;;1,0;;;;;1,0;3,0;1,0;;;;;;;;;;;1,0;;;;;3,0;;10,0;1,0;;;1,0;;;;;;;;3,0;;;;;;;;;5,0;1,0;;;;;;;;;;;;;;;;2,0;;22,0;;;;2,0;;;;;;1,0;5,0;;;;;;;;;;;;;;;;;;;;;;1,0;;1,0;;;;;;;;;;;2,0;1,0;;1,0;;;;;1,0;2,0;3,0;;;;4,0;;;;;;;;2,0;;;;;;;;;;;;;;;;;;;;;2,0;;1,0;;1,0;;;;;;;;;;;;;;;;;;;;;;;;;;;;;;;;;;;;;;;;;;;1,0;;;;;2,0;;;;;;;1,0;;;;;;;;;;;;;;;1,0;15,0;;1,0;;;;;;;;;;;1,0;1,0;;;;1,0;;;;;;;;;;;;;;;;;;;;;;;;;;;;;;10,0;6,0;;;1,0;;;;;;;;;;;;;6,0;;;;;;;;;;;;;;;;;;;;;;;;;;1,0;;;;;;;;;;;;;2,0;;;;;;;;;;;;;;;;;;;;;;1,0;;;;;;;4,0;;2,0;;;;;;;;;;;;;;;;;;3,0;;;;;;;;;;;;;;;6,0;;;;;;;;;;;;;;;;4,0;;;;;;;13,0;;;13,0;;;;;;;;;;;;;;;;;;;;;;;;;;;;8,0;;;3,0;;;;;;;;;;1,0;;6,0;;;;2,0;;1,0;;;;;;;;;;;;;;;;;;;1,0;;;;;;;;;;;;;;;;;;;;;;;;4,0;;;;;;;;;;;;;;;;;;;;;;1,0;;;;;;;;2,0;;;;;;;;;;;;;;;;;;;;;;;2,0;;;;;;;;;;;;;;;67,0;;;;;;;;;;;;;;;;;;;;;;;;;;;;;;;;;;;3,0;;;;;;;;;;;;;;;;;;;;;;;1,0;;;;;;;;;;;;;;;;;;;;;;;;;;;;;;;1,0;;;;;;;;;;;;;;;;;;;;;;;;;3,0;;;;;;;;;;;;;;;;;;;;;;;;;;;;;;;;;;;;;;;;;;;1,0;;;;;;2,0;;;1,0;;;;;;;;;;;;;;;3,0;;;;;;;;;;;1,0;;;;;;;;;;;;;;;;;;;;;
limit;;;;;3,0;338,0;21,0;30,0;19,0;3,0;2,0;;13,0;1,0;22,0;13,0;2,0;;1,0;2,0;1,0;16,0;26,0;1,0;;;1,0;;;;4,0;92,0;24,0;;42,0;4,0;1,0;3,0;4,0;;21,0;7,0;36,0;5,0;17,0;4,0;6,0;76,0;8,0;13,0;4,0;42,0;8,0;4,0;14,0;;46,0;1,0;;;1,0;;18,0;;3,0;579,0;101,0;11,0;19,0;2,0;6,0;2,0;5,0;;;;2,0;1,0;3,0;350,0;;87,0;;63,0;8,0;8,0;27,0;3,0;9,0;580,0;1005,0;;;;;36,0;12,0;;31,0;1,0;;76,0;13,0;69,0;;4,0;69,0;1,0;10,0;14,0;9,0;7,0;4,0;;;10,0;25,0;148,0;86,0;14,0;1,0;;27,0;2,0;3,0;;;7,0;3,0;49,0;;41,0;6,0;;1,0;7,0;5,0;7,0;;45,0;5,0;;;14,0;14,0;;;47,0;13,0;24,0;1,0;;43,0;7,0;;;1275,0;1137,0;1,0;3,0;1,0;5,0;364,0;1,0;4,0;2,0;5,0;212,0;1,0;9,0;626,0;;;;41,0;6,0;10,0;3,0;2,0;;7,0;4,0;;;;3,0;;1,0;2,0;;;;;10,0;;10,0;;1,0;;9,0;;;5,0;52,0;1,0;2,0;1,0;;55,0;2,0;;;;;;;2,0;;43,0;8,0;10,0;3,0;6,0;8,0;;;3,0;;26,0;;20,0;3,0;3,0;8,0;16,0;22,0;105,0;4,0;2,0;1,0;1,0;;;4,0;;;;4,0;6,0;6,0;1,0;;12,0;;;9,0;6,0;;;4,0;;;;3,0;;;5,0;2,0;3,0;;2,0;9,0;4,0;;12,0;7,0;;14,0;;27,0;;;;6,0;;250,0;1,0;;;;8,0;;20,0;;5,0;10,0;;;;3,0;6,0;;1,0;9,0;;2,0;3,0;3,0;1,0;;;6,0;;;3,0;1,0;;2,0;;6,0;;;;;;;3,0;2,0;;;15,0;;1,0;;;12,0;;1,0;1,0;5,0;;;8,0;2,0;;;;1,0;1,0;2,0;1,0;;2,0;;;4,0;3,0;30,0;1,0;1,0;;6,0;;2,0;1,0;;7,0;2,0;;;;3,0;;;;;;;;16,0;13,0;1,0;;;;2,0;;5,0;;6,0;2,0;;;;1,0;11,0;;13,0;;;;;;;;;10,0;3,0;;4,0;5,0;;4,0;5,0;;1,0;;;;;;;;5,0;;;10,0;6,0;;;;9,0;2,0;1,0;;;4,0;3,0;7,0;1,0;1,0;8,0;6,0;;1,0;3,0;20,0;;;4,0;2,0;;;4,0;;15,0;5,0;;;;3,0;;;17,0;;;;;20,0;1,0;;3,0;1,0;;8,0;;;1,0;;;15,0;;;7,0;;1,0;1,0;;1,0;1,0;;2,0;1,0;1,0;4,0;1,0;2,0;;5,0;;9,0;;1,0;2,0;;;2,0;;;;2,0;;;1,0;;;1,0;;;;;;;1,0;;;1,0;;8,0;;;2,0;;;;;7,0;48,0;;30,0;;1,0;;12,0;;2,0;7,0;;;1,0;;;;;;3,0;;;8,0;6,0;1,0;;1,0;;;8,0;;;;18,0;37,0;;;5,0;;2,0;;1,0;;1,0;;3,0;;;4,0;;;;7,0;;;;;28,0;;1,0;;;;;1,0;8,0;;2,0;;2,0;;;;;1,0;;3,0;;6,0;16,0;;;;;;;;;;;135,0;;;;2,0;;1,0;1,0;;1,0;8,0;;;;10,0;;;;;;2,0;;1,0;;;5,0;;;;1,0;2,0;;2,0;;;;;;;3,0;;281,0;;11,0;;;;;;;;;1,0;;2,0;;;;;;4,0;1,0;;;;;;;;;;;;;;;4,0;;;7,0;;13,0;;;;;;72,0;;;;;;;;1,0;1,0;;1,0;;;;;;;;12,0;;13,0;;6,0;;;;;;;2,0;;;;;;;1,0;;;3,0;;16,0;;4,0;;24,0;;;;;1,0;;;;;1,0;;;10,0;;;5,0;;;1,0;21,0;1,0;7,0;;3,0;9,0;;;;24,0;1,0;;;;2,0;;;;;;;2,0;1,0;4,0;;3,0;;;;;;7,0;2,0;163,0;1,0;;2,0;;2,0;;;2,0;;5,0;;;;;;;;1,0;1,0;;;;;;;;;;;3,0;;;1,0;;;;1,0;;;;;1,0;;;;4,0;;;;;;;;1,0;;;;;1,0;;;;;;2,0;;4,0;;;2,0;1,0;;2,0;;1,0;;;1,0;4,0;4,0;;;;;;4,0;1,0;;;;;;;1,0;;;;;1,0;1,0;;;;;;;3,0;;;;;;1,0;;1,0;;;;1,0;;;;;;2,0;;;;;;;1,0;;;;;;2,0;2,0;;4,0;;;;;;;;;;9,0;3,0;;;1,0;;;;;;2,0;4,0;;;;1,0;1,0;;;18,0;;;;;;;1,0;;;;137,0;;4,0;;;;19,0
live;;;;;6,0;1,0;;5,0;;;;;;1,0;;9,0;;;4,0;;;54,0;;;;;;;;;4,0;5,0;5,0;;86,0;8,0;;;1,0;;35,0;1,0;;1,0;6,0;2,0;1,0;70,0;44,0;95,0;;;;;;;1,0;;;;;5,0;;;;;;;11,0;;12,0;;14,0;;;;;;1,0;358,0;;4,0;1,0;9,0;;2,0;3,0;;;;9,0;;;;;7,0;9,0;;32,0;;;;1,0;2,0;;3,0;;13,0;2,0;;;5,0;;;;23,0;42,0;;;4,0;;;4,0;8,0;7,0;;;;;;;13,0;;2,0;;1,0;12,0;2,0;;;7,0;;;;19,0;;;;9,0;;3,0;;5,0;5,0;21,0;2,0;17,0;;;21,0;;21,0;22,0;;;;59,0;206,0;;;;;;;;;;;;;;8,0;;;;;;;;;;;;;;;1,0;;;;;;1,0;5,0;;;;;;5,0;;;;;;;;;;;;;;;;;;;11,0;;;;;9,0;8,0;4,0;1,0;;;;1,0;;;;;;;;2,0;;;;;;;;14,0;;;;;;;8,0;;;;;;;;;;;;;;;;;6,0;;;;;15,0;;;;;;;;;;;;;;;;;;;;;;;;;;2,0;;;1,0;;;;;1,0;;;;;;;;;;;;;;;;1,0;;;;;;;2,0;2,0;;4,0;;;;;;;;;;;54,0;;;;;;;;;;;;;2,0;;2,0;;;7,0;;;;;;;;;;;13,0;;;;;;;;;;2,0;;;;;;;1,0;4,0;;;;;;2,0;;16,0;9,0;;;;;2,0;4,0;;;;;;;;;;;;;7,0;;;4,0;;9,0;2,0;112,0;;1,0;5,0;6,0;;7,0;3,0;3,0;4,0;;1,0;;;;8,0;7,0;13,0;1,0;;;;;;;;;;;;;1,0;;;;;38,0;;;;1,0;;7,0;1,0;3,0;15,0;;;;;;;;;4,0;;;;;;5,0;;;;;15,0;;;;;1,0;;;5,0;;;56,0;;;;12,0;6,0;;5,0;;4,0;;;2,0;;;;2,0;;1,0;;;;9,0;1,0;3,0;;;;4,0;;3,0;2,0;2,0;2,0;;;;;;1,0;;;1,0;2,0;;;;;;;;;;5,0;;;13,0;;1,0;;10,0;2,0;;;;;;;;18,0;3,0;;;;;;;;;;;;;;;;2,0;;;;;1,0;;;;;2,0;1,0;;3,0;;;;;3,0;;;;;3,0;;;4,0;;;;;;;;;;;;1,0;;;;1,0;;1,0;;;;;;;1,0;1,0;;;;;2,0;;;;;;;;;;;;;;;;1,0;;;;;;;;;;;;1,0;;;;;;;;;;;;;;;;;;;;;;2,0;;;;;;;;;;;;;;;;;;;;2,0;;;;;;;;;;;;;;;;9,0;;;;;;;;;;;;2,0;;;;;;;;;;;;;;;;;;;;;;;;4,0;;;;;;;;;;2,0;2,0;;;4,0;;;;;;3,0;;;;;;;;;;;;;;;;;;;;10,0;;;;;;;;;;;;;;;;;;;;;;;;;6,0;;;;;;;;;;2,0;;;;;;;;;;;;;;;;;;;;;;;;;;;;;;;;;;;;;;;;;;;;;;;;;;1,0;;;;;;;;;;;;;;;;;;;;;;;;;;;;12,0;;;;;;;2,0;;;;;;;;;;;;;;;;;;;;;;;;;;;;;;;;;;;;;;;;;;;;;;;;;;;;;;;;;;;;
manner;;;;;1,0;;;5,0;12,0;19,0;1,0;;5,0;;22,0;11,0;1,0;1,0;;1,0;;5,0;7,0;3,0;2,0;;4,0;;;2,0;;10,0;14,0;;24,0;2,0;5,0;2,0;;1,0;34,0;;1,0;;6,0;6,0;1,0;46,0;8,0;41,0;3,0;5,0;;2,0;12,0;9,0;10,0;;1,0;;6,0;;;;2,0;4,0;8,0;10,0;5,0;2,0;17,0;;2,0;4,0;;6,0;2,0;1,0;5,0;85,0;2,0;23,0;1,0;32,0;;;5,0;;2,0;;44,0;;;;1,0;;2,0;;18,0;;2,0;2,0;11,0;20,0;;;21,0;6,0;3,0;2,0;2,0;6,0;;;;12,0;31,0;28,0;1,0;6,0;1,0;1,0;10,0;10,0;3,0;;2,0;;2,0;3,0;;6,0;7,0;;1,0;;1,0;3,0;3,0;8,0;1,0;;;36,0;;;;7,0;9,0;1,0;;;5,0;12,0;3,0;;32,0;;6,0;3,0;2,0;1,0;42,0;;2,0;;13,0;1,0;10,0;;5,0;;;2,0;3,0;;1,0;14,0;1,0;4,0;2,0;18,0;;;3,0;5,0;;3,0;;;;;;5,0;1,0;;;;;13,0;;3,0;;27,0;3,0;;;;4,0;7,0;2,0;;;;3,0;4,0;2,0;;2,0;2,0;10,0;;1,0;;;1,0;1,0;;20,0;;12,0;;;36,0;14,0;20,0;;5,0;;3,0;3,0;1,0;;2,0;1,0;;;1,0;13,0;7,0;;;5,0;;;3,0;5,0;;;;;;3,0;4,0;;2,0;5,0;2,0;5,0;;3,0;4,0;3,0;;;1,0;1,0;2,0;5,0;23,0;4,0;;;;3,0;14,0;1,0;;;;5,0;11,0;;;;;1,0;;;;2,0;21,0;4,0;;1,0;1,0;1,0;3,0;2,0;;;;;;3,0;7,0;;1,0;3,0;9,0;1,0;18,0;;;;;;1,0;;;2,0;4,0;;;1,0;1,0;;6,0;2,0;7,0;;1,0;;1,0;2,0;4,0;;1,0;9,0;9,0;;1,0;;5,0;;14,0;7,0;7,0;3,0;1,0;;13,0;;3,0;;;;;;1,0;;;;;;;;10,0;4,0;5,0;8,0;;2,0;4,0;;2,0;1,0;;4,0;27,0;1,0;14,0;;;2,0;1,0;;;;1,0;;;;9,0;6,0;1,0;1,0;1,0;;8,0;2,0;1,0;1,0;1,0;;;1,0;2,0;;7,0;1,0;;1,0;;1,0;;;;;;;3,0;2,0;2,0;8,0;;;;6,0;2,0;1,0;1,0;4,0;;;13,0;2,0;3,0;9,0;1,0;;;;;1,0;1,0;;;;6,0;3,0;2,0;;;3,0;2,0;;;1,0;2,0;;;2,0;5,0;10,0;;;;;;8,0;6,0;;5,0;5,0;4,0;;;;;2,0;1,0;2,0;;;1,0;3,0;;;;5,0;;;3,0;4,0;4,0;;;8,0;;;1,0;2,0;;1,0;2,0;;;;;;3,0;;;;4,0;;;;;;2,0;;1,0;;;6,0;3,0;;10,0;9,0;;1,0;;;4,0;6,0;2,0;;;;;;;;;;;;;;1,0;2,0;2,0;;1,0;;5,0;1,0;;;;3,0;;5,0;3,0;;;;;;;;;;2,0;;1,0;8,0;;;5,0;;3,0;5,0;;;;;2,0;4,0;;1,0;;;1,0;;1,0;;;5,0;;1,0;;;;2,0;;;;1,0;;;1,0;;;6,0;6,0;9,0;;;;;;;1,0;6,0;2,0;;1,0;;;2,0;6,0;;1,0;;2,0;1,0;;;3,0;;1,0;1,0;;1,0;2,0;;;;;;;1,0;2,0;;2,0;;;1,0;;;4,0;;;;;;;;;3,0;1,0;;1,0;;1,0;3,0;;;;;;;11,0;1,0;;;;;;1,0;;;;1,0;;;;;3,0;;;1,0;;;;;;2,0;3,0;10,0;;;3,0;;;;1,0;;;3,0;;3,0;;;3,0;;2,0;;;;;;;;6,0;;;;;;;2,0;4,0;;4,0;;;;;;;3,0;;;5,0;;;;1,0;;10,0;1,0;;;;5,0;;;;;;;1,0;10,0;;;4,0;;;;;;;;4,0;;1,0;;6,0;;2,0;1,0;;;;;;3,0;1,0;;;;;;;;2,0;1,0;;;;1,0;;5,0;;;;2,0;2,0;;;11,0;2,0;;1,0;;;;;1,0;;;;4,0;1,0;;1,0;;;;;;;;3,0;;;;;;;;3,0;;;;1,0;;;;;;;;2,0;;;1,0;;;;;;1,0;;;;;;1,0;;;;;;9,0;;;;;2,0;4,0;;;;;;;;;;;;2,0;;;2,0;;1,0;;3,0;;;;2,0;;;4,0;;;1,0;4,0;;;;;;;2,0;;;;;;;;;;1,0;;;;;;;;;;;;;;;4,0;;;1,0;;;1,0;;;;;;;;;;;2,0;;;;1,0;;;;;;;;;;;;1,0
minimum;;;;;1,0;7,0;15,0;11,0;9,0;;;;1,0;;7,0;17,0;1,0;;24,0;1,0;13,0;4,0;;1,0;;1,0;14,0;3,0;;;3,0;2,0;5,0;3,0;7,0;1,0;;;1,0;1,0;18,0;;1,0;2,0;10,0;;20,0;15,0;4,0;2,0;;53,0;;4,0;5,0;16,0;16,0;8,0;5,0;;;;2,0;;12,0;13,0;4,0;1,0;14,0;;10,0;;1,0;;;2,0;3,0;;2,0;43,0;;2,0;;19,0;1,0;;2,0;;2,0;31,0;15,0;;;2,0;6,0;3,0;;;31,0;1,0;;;8,0;23,0;;1,0;10,0;2,0;38,0;8,0;;10,0;;;;32,0;5,0;16,0;;32,0;;;4,0;6,0;4,0;1,0;;2,0;1,0;9,0;;12,0;3,0;;8,0;6,0;;2,0;1,0;10,0;1,0;;;2,0;8,0;;;;67,0;26,0;;;;18,0;2,0;;16,0;5,0;4,0;4,0;4,0;;30,0;;3,0;1,0;6,0;5,0;;12,0;6,0;;1,0;11,0;2,0;2,0;;;;;;3,0;2,0;;;2,0;;8,0;;;2,0;3,0;;2,0;;;;;;3,0;;;31,0;7,0;9,0;;;;7,0;6,0;2,0;;;;;;;;1,0;1,0;;;5,0;;;;1,0;;25,0;2,0;2,0;4,0;1,0;;;11,0;1,0;23,0;;18,0;1,0;;;;;;3,0;;88,0;;3,0;;;;;1,0;3,0;;;4,0;;;;2,0;5,0;;;;1,0;;;5,0;1,0;;;;3,0;2,0;;2,0;6,0;;3,0;;;25,0;3,0;;;;;;2,0;;;;14,0;;;;3,0;;;;;;;6,0;2,0;;2,0;;1,0;;1,0;2,0;;;;4,0;;;1,0;;2,0;;;;;2,0;;;;;;2,0;;;;1,0;;1,0;;;12,0;;;1,0;3,0;2,0;;;;3,0;;;;5,0;;;1,0;;;;;;;;;;;;;;2,0;;19,0;;;5,0;;;;;;1,0;;;;2,0;;21,0;1,0;;;;;33,0;1,0;;;;;1,0;;;;2,0;2,0;16,0;2,0;6,0;12,0;;2,0;;;;3,0;;;;2,0;13,0;;2,0;7,0;3,0;;;;2,0;19,0;;;;4,0;1,0;;;;20,0;2,0;;;;3,0;;;4,0;;;;;4,0;9,0;;;;2,0;;3,0;2,0;11,0;;;;2,0;26,0;2,0;3,0;;;;1,0;;19,0;;78,0;;1,0;;;3,0;12,0;5,0;1,0;1,0;;;;;;;;1,0;;;;;;;;;;;1,0;;1,0;;;;;;;;;;;2,0;;;;;;3,0;;;4,0;;;7,0;1,0;;;;12,0;;;5,0;;;;;;1,0;4,0;;;;;;;9,0;;;;;;;;;;2,0;;;;;;1,0;;;;;;;;;;;;;;;;;;1,0;;;;;;;;;;;1,0;;4,0;;;;;;;;;;;;1,0;;;;;4,0;;2,0;;;;;2,0;;24,0;;;1,0;;;;;;1,0;;;;;;;;;;;;;1,0;;1,0;1,0;;;3,0;;;10,0;;;;;2,0;;2,0;1,0;;3,0;;7,0;;;;;;;;;;;;;;;;;;;;;;;;;;;;;;;;;;;;;;3,0;;;;;;3,0;;;;;;;;;;;2,0;;;5,0;;;;;2,0;;6,0;;;;;;1,0;;;;;;;;;;;;;;;;;;1,0;4,0;;;;20,0;;;;;1,0;;;;;5,0;;;;;4,0;131,0;;;;;5,0;;;;;3,0;;;;;;;;;1,0;;14,0;;;;;;;;;;11,0;;3,0;;1,0;;;;;;1,0;;3,0;;2,0;1,0;;;;;;46,0;1,0;;;;;;1,0;;;;;;;;;;;;;;;;;;;2,0;2,0;;;;;;;;;;;3,0;;1,0;;;1,0;;;;;1,0;;;3,0;;;;;;;;;;;;1,0;;1,0;;15,0;;;;1,0;1,0;;;;;;;;;;1,0;;;3,0;;;;;;;;;;;;;2,0;;;;;;;;;10,0;;;;;;1,0;;;;;;;;;2,0;;;;;;;3,0;10,0;;;2,0;;;;1,0;;;;;;;2,0;;;;2,0;;;;;;;;;;;;;;;;;;;;
navigation;;;;;1,0;;;5,0;4,0;5,0;;;3,0;;4,0;23,0;;;;2,0;;1,0;2,0;;;;;;;;2,0;1,0;8,0;;1,0;;;2,0;;;25,0;;;1,0;4,0;3,0;6,0;97,0;2,0;54,0;;4,0;;;;;;;2,0;;;;;;1,0;;1,0;1,0;1,0;3,0;;;22,0;;;;4,0;;;26,0;1,0;;;14,0;;11,0;;;;;;;;;2,0;2,0;8,0;;23,0;38,0;;;9,0;;;;;;7,0;;6,0;1,0;;;;1,0;;15,0;2,0;1,0;;;;7,0;5,0;3,0;;;;1,0;;1,0;;;;;;;;;;;;1,0;1,0;;;;1,0;;;;1,0;8,0;;2,0;38,0;;;;;7,0;11,0;;;2,0;;22,0;;;;;;;2,0;;;;;;;;;;;;;8,0;;;;;;;;;;;;;;;;8,0;1,0;;;;;;;;;;;;;;;;;;;;;;;;;;;;;2,0;;;2,0;;1,0;;;;;2,0;;;;3,0;;;;;;;;;17,0;2,0;;;;;;5,0;;;;;;;;;;;;;;;;;;;1,0;;;7,0;;2,0;;;21,0;;;;;;;;;;;;;;;;;;;;;;;;;;;;;;;;;;;;;;;;;;;;;;;;;;;;;3,0;;;;;;;;;;;;2,0;;1,0;;;;;;;;;;;;;;;;;;;;;;3,0;;;;;;;;;;;;;1,0;;;;;;;;1,0;;3,0;;;3,0;;1,0;;;1,0;;;;;;;1,0;;;;;;1,0;;;1,0;5,0;;1,0;14,0;12,0;2,0;;28,0;;;3,0;;;1,0;;3,0;;;;;;;5,0;;;;;;;;3,0;;;;;;;;;;;16,0;3,0;1,0;4,0;1,0;;11,0;;;4,0;;;1,0;;;;;;;;;;;4,0;;3,0;;;;;1,0;;;;;;;;;;;;;4,0;;;;;18,0;;;;;;;;2,0;1,0;8,0;;;2,0;;;;1,0;;;3,0;1,0;;;;;;;;;;;;;;;;12,0;;;;;;1,0;6,0;3,0;;;;3,0;;2,0;;;;1,0;;;;1,0;;;;;;;;3,0;;;;;;;;;;;;;;;;4,0;;;;;;;;;1,0;;;;;;;;;;1,0;2,0;;1,0;;;;;4,0;;;1,0;;;;;;1,0;;;4,0;;;;;;;;;;4,0;;;;;;;;;;;;;;;;;;;;;;;;;2,0;;;;;;;;;;;;;;;;;;;;;;;;;;;;;3,0;;;;1,0;;;;;;;;;;;;;;;;;;;;;;;;;;;;;;;2,0;;;;;;;;;;;;;;;;;;;;;;;;;;;;;;;;1,0;;;;;;;1,0;;;;;;;;6,0;;;;;;;;;6,0;9,0;;;;;;;;;;;;;;1,0;2,0;;;;;;;1,0;;;;;;;;;;;;1,0;;;;;;;;;;;;;1,0;;;4,0;;;;;;;;;;3,0;;;;;;;;;;;;;;;;;;;;;;;;;;;;;;1,0;;;;;;;;;;;;;;;;;;;;;;;;;;;;;;;;;;;1,0;;;;;;;;;;;;;;;;;;;5,0;;;;;;;;;;;;;;;;;;;;;;;;;;;;;;;;;;;;;;;;;;1,0;;;;;;1,0;;;;;;;;;;;;;
neighboring;;;;;1,0;;;2,0;14,0;7,0;7,0;;;;;24,0;;3,0;9,0;;6,0;4,0;;2,0;;;64,0;;;2,0;1,0;;1,0;;2,0;;;;;;9,0;1,0;2,0;5,0;;;41,0;9,0;2,0;;;25,0;2,0;;;6,0;29,0;;;;4,0;;;;8,0;;;1,0;31,0;;;;8,0;;;3,0;9,0;;;71,0;;;;3,0;;;;4,0;;;;;;;1,0;;;;8,0;1,0;4,0;;3,0;3,0;;1,0;;1,0;;1,0;;3,0;;;;16,0;18,0;13,0;;2,0;;;;2,0;2,0;;;;;;;;13,0;2,0;3,0;;25,0;;2,0;;3,0;;1,0;5,0;;;;;3,0;3,0;;;2,0;12,0;;;6,0;;;12,0;;3,0;6,0;;;;22,0;;;;;;;2,0;;4,0;;;;;;;1,0;;;1,0;;;;;;;;5,0;;;;;;;;;6,0;6,0;;;;;;2,0;;;;;;;1,0;;;;;;;;;;5,0;;5,0;;5,0;;;;;;7,0;;;;8,0;;;;;3,0;;;217,0;1,0;;;;;;;6,0;;;;;;;;;;;;;;;;6,0;;;;;;;;2,0;;;;1,0;;3,0;;;;1,0;;;;;;5,0;;;;;;;;;;;;;;;;;;;;;;;;;;;;;;;;;;;;;;;;1,0;;;;;;;1,0;;;;;;1,0;;;;;;;;61,0;;2,0;;;;;;;;;;;7,0;;;;;;1,0;;2,0;;;;26,0;;;1,0;;;;;;7,0;;;;;;;;;;;;;;;;;3,0;6,0;;2,0;;;1,0;;;;;;8,0;;;;;;;10,0;;;;9,0;2,0;;2,0;;8,0;;;;;9,0;;;;;3,0;;11,0;;;;;;;;;;;2,0;;;;;;;;;1,0;2,0;;;;;;;;;;;;;;5,0;;2,0;;;;;;;1,0;;2,0;;;;;;;;;;8,0;;;;;;;;;;;;;;;;;;;;;;;;;;;4,0;;2,0;;;;;;;;2,0;;;;;;;;;;;;;;22,0;;;;;;;3,0;7,0;;;;2,0;;;;;;;;;;;;;;;;;;;;;;;;;;;;;2,0;;;;10,0;;;;;3,0;;;;;;;;;;1,0;;;;;;;;;;;10,0;1,0;;;;;;;;;;;;;;;;;;;;;;;;;;;;;;;;;;;;;;2,0;;6,0;;;;;;;;;;;;;;;;;;;;;;;;;;;;;;;;;;;;;;;;;;;;;;2,0;;;;;;;;;;;;;;;;;;6,0;;;;;;;;;;3,0;;;;;;;;3,0;;;;;;;;;7,0;;;;;;;;3,0;;;;;12,0;;5,0;;;;;1,0;;2,0;;;;;;;;;;;;;;;;;;2,0;;6,0;;;;;;;;;;;6,0;;;3,0;;;;;4,0;;;;;;;;;;;;;2,0;1,0;;;;;;;;2,0;;;1,0;;;;;;;;;;;;1,0;;16,0;;;;;;;;;1,0;3,0;;;;;;;;;;;;;;;;2,0;;;2,0;;;;;;;;;;;;;;;3,0;;;;;;1,0;;;;;;;;;;2,0;;1,0;;;;;;;;;;;;;;;;;;;;;;;;;;;;;1,0;;;;2,0;;;;;;;;;;;;;;;;;;;;;;;;;;;;;;;;;;1,0;;;;;;;;;;;;
network;;;;;14,0;2,0;;42,0;36,0;1,0;3,0;;40,0;3,0;;61,0;;;;10,0;7,0;43,0;3,0;2,0;;;;1,0;;;168,0;20,0;55,0;;120,0;10,0;;;4,0;;202,0;;8,0;1,0;12,0;9,0;30,0;354,0;96,0;24,0;;7,0;;;;4,0;;;1,0;9,0;1,0;10,0;14,0;45,0;1,0;;;4,0;3,0;;15,0;;50,0;;1,0;14,0;21,0;;;303,0;2,0;27,0;4,0;106,0;;10,0;;2,0;;;6,0;2,0;10,0;;;9,0;28,0;;145,0;25,0;1,0;;28,0;25,0;;5,0;3,0;14,0;26,0;15,0;4,0;11,0;;;2,0;115,0;29,0;17,0;;14,0;;;8,0;42,0;36,0;8,0;;;;;;2,0;1,0;;11,0;2,0;5,0;15,0;;7,0;17,0;5,0;18,0;37,0;20,0;;;;48,0;;;;59,0;61,0;2,0;;174,0;;1,0;33,0;9,0;78,0;90,0;;2,0;;129,0;33,0;;;1,0;;;;8,0;1,0;;;1,0;;3,0;2,0;;;;19,0;;30,0;;;;1,0;;131,0;8,0;;9,0;;;;;;;4,0;;;;;;3,0;;2,0;;2,0;;;;;;;6,0;;;;1,0;;1,0;;;;19,0;;;8,0;1,0;;;1,0;;1,0;;;;3,0;1,0;;;4,0;;;;;4,0;;;;106,0;;;2,0;;;;95,0;;;1,0;;;;;66,0;1,0;;;;;4,0;;;13,0;;12,0;;;22,0;;6,0;;1,0;3,0;;;;;;9,0;;;;2,0;4,0;1,0;;;;;4,0;;2,0;;;;;;1,0;;20,0;;43,0;;;;;;;;;;;;;;;;7,0;;;;;;;;6,0;1,0;12,0;;1,0;;4,0;;;;;;;;3,0;7,0;;2,0;9,0;;;;;;;;;;;;;;;2,0;;;;;;4,0;;;1,0;;;;2,0;;1,0;;;;61,0;;;;;1,0;;26,0;1,0;;;;;;5,0;9,0;2,0;6,0;;14,0;;1,0;1,0;;;;4,0;2,0;5,0;;;1,0;11,0;;2,0;;24,0;2,0;1,0;21,0;;;1,0;40,0;;11,0;2,0;5,0;;;26,0;14,0;;;1,0;2,0;;;1,0;9,0;19,0;26,0;;;;;3,0;2,0;;;;1,0;;6,0;1,0;;;7,0;;68,0;9,0;;;2,0;2,0;11,0;;;1,0;;1,0;;3,0;1,0;;;3,0;14,0;10,0;;4,0;;;154,0;;3,0;1,0;19,0;15,0;4,0;;6,0;;;16,0;;7,0;;3,0;23,0;1,0;;3,0;;1,0;5,0;1,0;90,0;2,0;;6,0;4,0;1,0;;2,0;64,0;1,0;50,0;45,0;;;;8,0;13,0;;7,0;;1,0;;;1,0;;15,0;;7,0;2,0;;;5,0;92,0;1,0;3,0;;;2,0;1,0;1,0;2,0;;;15,0;28,0;100,0;76,0;;;8,0;;;1,0;8,0;;;;;2,0;;;7,0;;;52,0;;;11,0;22,0;12,0;;;1,0;7,0;47,0;4,0;;3,0;1,0;28,0;5,0;8,0;;26,0;1,0;;16,0;2,0;9,0;26,0;1,0;1,0;5,0;18,0;;1,0;14,0;4,0;;6,0;;;;3,0;;31,0;;;2,0;;4,0;3,0;106,0;16,0;20,0;7,0;6,0;8,0;1,0;;42,0;2,0;1,0;;;;1,0;;;211,0;;;;;;1,0;;;;;;1,0;;;;;6,0;;;;;;;;;;;;;1,0;4,0;;;;;5,0;;;1,0;;;;4,0;2,0;;;;;;;10,0;2,0;;;;;;;3,0;;;3,0;;1,0;;;;;;;;;15,0;;;;;;;;;4,0;;1,0;;;;;12,0;;;;;;;;;;;;;;;;;;2,0;;;;;2,0;;;;;;46,0;;;1,0;9,0;;;;;4,0;4,0;5,0;1,0;;;;1,0;;;;2,0;;;;;;;;1,0;;;;;1,0;;3,0;;;;;8,0;;;;;;;;;;;;;;9,0;5,0;;1,0;;;;;;;10,0;1,0;4,0;;;;;;1,0;;;;74,0;;;;;;5,0;6,0;;1,0;1,0;;1,0;13,0;;;;;1,0;;1,0;;4,0;;;;;;;;;5,0;;15,0;;;;;5,0;;1,0;8,0;;;;;;;;;;;;;4,0;;;1,0;;;;;;;;;;;;;3,0;1,0;;;;;;;;;3,0;;;;;7,0;;;;;;;;;;;;;;;;1,0;;;;;;;;;;;;;;;;;;17,0;;;3,0;;1,0;;;;;;;;;;;;;;;;;;;1,0;;;;2,0;;;;;;;
observe;;;;;1,0;3,0;;;15,0;1,0;2,0;;14,0;;;16,0;;;1,0;;2,0;2,0;;;;;;;;;2,0;1,0;7,0;;2,0;;2,0;4,0;;;1,0;;;6,0;7,0;2,0;16,0;2,0;;18,0;1,0;5,0;2,0;;;;;;;;1,0;;9,0;;;;4,0;2,0;7,0;;1,0;18,0;15,0;;;;2,0;2,0;;74,0;;1,0;;4,0;;;;;;;3,0;;;2,0;;;;;9,0;;3,0;;1,0;25,0;;;8,0;1,0;3,0;2,0;;2,0;;;;19,0;3,0;2,0;1,0;1,0;;;;4,0;2,0;;;;;2,0;;2,0;5,0;2,0;;;;;;;18,0;;;13,0;;;;;;;;;;;22,0;;13,0;;2,0;;;1,0;26,0;1,0;;;1,0;21,0;15,0;;;;;;;3,0;5,0;;1,0;;;5,0;;1,0;;;;;;;;;;;;;;;;2,0;;;5,0;13,0;12,0;;;;;6,0;;1,0;;;;;;;;;;;;;1,0;;;;43,0;;;;1,0;;;1,0;2,0;;;;2,0;;;5,0;;;;2,0;4,0;;;;;;;;4,0;1,0;;1,0;;;;1,0;;;;;;;;;3,0;;1,0;;;;;4,0;;;;;;2,0;;;;;2,0;;;;;;;;;;1,0;12,0;;;;;;;;;;16,0;;;;;;;;;;;;;1,0;;;;;;;;;;;;;;;;;;;;;;;;;1,0;;1,0;;;;;;2,0;;;;;;;;;;;;;;;;;;;;;;;;;2,0;;;;;;;;;5,0;;;;;;;;1,0;;;;;;;;;;6,0;4,0;;;;;;;;;;;2,0;;;;;;9,0;;;;;;;11,0;;;5,0;10,0;;;6,0;;;3,0;;4,0;;;;;;;;;4,0;;;;;;;;;;;;;;;;;;;22,0;;;;7,0;;;;;;;;;;;;;1,0;2,0;;;;;;;;;;;9,0;;4,0;;;;;;17,0;1,0;;;;;;7,0;;;;;1,0;;;;;;;;;;;;;5,0;;;;;;;;;;;;;1,0;;;;2,0;;1,0;;;;;;1,0;;;;;;;;;;;;;;6,0;;;;1,0;;;;;2,0;;;;;;;;;;;;;;1,0;;1,0;;;;;1,0;;;;;;5,0;;;;;;;;;;;;1,0;;;18,0;;;;;;;;;;;;;;;2,0;6,0;;;;;;;;;;;;1,0;;;1,0;;;;;;;;;;3,0;;3,0;;;;;;;;;;;;;;;;;;;;;;;;;;1,0;1,0;;;;;;;;;;;;;;;;;;;;;;;;;;;;;;;;;;;;;2,0;;;;;;;;;;;;;;;;7,0;;;;;;;;;;;;;;;;;;;;;;14,0;;;;;;;;;2,0;;;;;;;;;;;;;3,0;;;;;;;;;;;;;;;;;;;;;;;;;;;;;;;;;;;;;;;;10,0;;;;;;;;;;;;;;;;;2,0;;;;;;;;1,0;;;;;;;;;;;;;;;;;;;;;;;;1,0;;;;;;;;;;;;;;2,0;;;;;;;;;;;;;;;1,0;;;1,0;;;;;;;;;1,0;;;;;;;;;;3,0;;;;;;;;;;;;;;;;;;;;;;;;;;;;;;;;;;;;;;;;;;;;;;;;;;;;;;;;;;;;;;;;;;
offset;;;;;1,0;16,0;11,0;10,0;8,0;6,0;8,0;;1,0;;71,0;44,0;3,0;9,0;;3,0;2,0;45,0;2,0;4,0;;;7,0;3,0;;11,0;2,0;1,0;35,0;;14,0;;25,0;41,0;3,0;;17,0;1,0;3,0;2,0;9,0;4,0;61,0;47,0;12,0;;6,0;65,0;;;2,0;1,0;2,0;15,0;9,0;;6,0;;1,0;;5,0;4,0;1,0;7,0;48,0;2,0;2,0;1,0;20,0;;;3,0;2,0;;;152,0;5,0;18,0;1,0;17,0;6,0;;1,0;;18,0;5,0;36,0;;;;1,0;5,0;3,0;;73,0;;6,0;;25,0;8,0;;5,0;40,0;7,0;12,0;44,0;1,0;30,0;;24,0;8,0;21,0;30,0;50,0;;22,0;;;3,0;8,0;15,0;1,0;;;2,0;6,0;;76,0;9,0;12,0;3,0;;11,0;;9,0;2,0;1,0;;;27,0;8,0;;;8,0;55,0;2,0;;;7,0;11,0;2,0;;22,0;;11,0;;2,0;1,0;21,0;;3,0;;34,0;7,0;;;15,0;;;2,0;42,0;29,0;1,0;3,0;;;;6,0;;;;8,0;;10,0;;;;;;1,0;;1,0;;;;1,0;;;24,0;22,0;3,0;;;;50,0;1,0;1,0;3,0;2,0;;;;6,0;;;;1,0;;;;;;;;16,0;;;;3,0;11,0;1,0;1,0;2,0;3,0;;;5,0;;3,0;1,0;7,0;5,0;;;135,0;26,0;1,0;;;;;3,0;11,0;2,0;;;;;;2,0;;4,0;2,0;;1,0;;;14,0;9,0;;;;;;;9,0;1,0;;;;;43,0;;;;;30,0;26,0;;;1,0;;;;2,0;;1,0;1,0;3,0;;;;11,0;;;;;1,0;;;1,0;2,0;;;;3,0;;;;3,0;13,0;;1,0;3,0;;;2,0;;1,0;;;4,0;;;1,0;;;;1,0;1,0;;5,0;;2,0;10,0;12,0;;1,0;;1,0;;3,0;4,0;52,0;1,0;4,0;1,0;1,0;;;;;5,0;;;;;;;;;3,0;;;;18,0;;;7,0;;;10,0;;;2,0;5,0;;4,0;9,0;;1,0;;3,0;3,0;;;;;;2,0;;;;;;76,0;10,0;;8,0;1,0;3,0;2,0;2,0;4,0;;;2,0;1,0;1,0;;;;;;;;;18,0;17,0;1,0;17,0;;;10,0;6,0;;2,0;8,0;5,0;;1,0;3,0;11,0;1,0;1,0;;;2,0;;;;6,0;;;;;1,0;;2,0;7,0;;;;;3,0;2,0;;;;1,0;;;21,0;1,0;50,0;;37,0;4,0;4,0;20,0;3,0;4,0;;1,0;;2,0;;;;;20,0;1,0;;1,0;1,0;;2,0;;;;;1,0;8,0;;2,0;;15,0;1,0;;;;;2,0;;6,0;;;;;69,0;2,0;;2,0;;;;2,0;;2,0;1,0;6,0;;3,0;;;;;5,0;;3,0;;3,0;2,0;;;;;;2,0;;;2,0;;;;1,0;;1,0;;3,0;;;;;;;;;;;;;;;;;;;;;4,0;23,0;;;2,0;;;;3,0;;;;;;3,0;1,0;6,0;;4,0;;;;;;;;;;;;;;;;;2,0;1,0;;;;;;;;;2,0;1,0;;;1,0;2,0;;;;;1,0;1,0;;;;;;1,0;;2,0;;3,0;;;;;;;;;1,0;;;;;6,0;6,0;;3,0;;;;;;;;;;;;;;1,0;24,0;;;4,0;1,0;3,0;;;;2,0;3,0;;;;;2,0;;;;15,0;;;;3,0;;;;;1,0;;;1,0;;;;;;;3,0;;;;8,0;;;;;2,0;10,0;;;;;1,0;1,0;;9,0;2,0;;;;2,0;1,0;;;;;;;;2,0;;;;1,0;;;;;3,0;;;1,0;;;9,0;;;;9,0;4,0;;;;;;4,0;3,0;;;;;;2,0;1,0;;;;;;;;;;;;8,0;;50,0;1,0;;3,0;;;;;;1,0;1,0;9,0;;;4,0;;2,0;;;;;;11,0;;1,0;2,0;;;;1,0;;;;;;;;;;;;1,0;;;;;;;;1,0;;;;;1,0;;2,0;;;;1,0;;1,0;;;1,0;;;;2,0;;;2,0;;;;;;;;;;2,0;;;;;;;;1,0;1,0;;;;;;;;;;;2,0;;;;1,0;;;;2,0;;;;;;;;;;1,0;1,0;;5,0;;;;18,0;;;5,0;;;;;;2,0;;;4,0;;;;;7,0;;;2,0;1,0;;3,0;9,0;;;;;2,0;2,0;;3,0;;;;;;25,0;;;;5,0;1,0;;;3,0;1,0;;;2,0;;;;;;;;;;;;;;;;3,0;1,0;;;;;
packet;;;;;2,0;;;;3,0;1,0;3,0;;;;;3,0;;;;;;;;2,0;;;;;;;1,0;2,0;1,0;;26,0;;;;36,0;;122,0;;;;8,0;5,0;4,0;16,0;3,0;;;;;;;;;;;;;8,0;;1,0;;;;6,0;18,0;;;;5,0;;;20,0;4,0;;;17,0;5,0;7,0;1,0;50,0;;;;;;;;;;;3,0;;4,0;;20,0;;;;;2,0;;;2,0;;46,0;;;4,0;;;;46,0;4,0;;;;;;;7,0;1,0;;;;;;30,0;;2,0;2,0;;;2,0;;;;;;4,0;6,0;;;;;5,0;;1,0;;;;;;7,0;;;82,0;1,0;30,0;127,0;;;;28,0;;;;;;;;;;;;2,0;;;;;;7,0;6,0;;;;;;;;2,0;;;;;;;;;;;;;;;;;;;;;;;;;;;;;;;;;;;7,0;;;;;;;;;;;;;;;;;;;;1,0;;;;;;;5,0;44,0;;;;;;;12,0;;;;;;;;;;;;;10,0;;;;3,0;14,0;;;;21,0;;;;;;2,0;;;;;;;;;;;;;;;;;;;;;;;;;;;;;;;;;;;;;;;;;;;;;;;;;;;;;;;;;;;;;7,0;;;;;;;;;;;;;;;;;;;;;;;;;;;;;;6,0;;;;;;;;;;;;;15,0;;;;;;;3,0;3,0;;;1,0;;;;;2,0;;;;;;;1,0;;;;;;;;;;;;1,0;;;;;;;;1,0;;;;;1,0;16,0;;2,0;;;12,0;;;;;;6,0;;1,0;;;;;1,0;;;;;;;;;;9,0;;3,0;;;;;;;;4,0;;;;;;2,0;;;;;;;;;;;;;;;;;;;;7,0;;;;;;1,0;;;;;;;;;;;5,0;1,0;;;;;;;1,0;;;2,0;;;2,0;;;;;;10,0;;1,0;;;;;;;8,0;;;;;;;;;;;2,0;;91,0;;;;;6,0;;;;;;;;;10,0;;;2,0;;;;5,0;;;;;;;;;;;;1,0;;;2,0;;;;;;2,0;;;;;6,0;13,0;;;3,0;;;;;2,0;;;5,0;;;1,0;;;;;;;;;8,0;;;;;;;;2,0;;;;;14,0;;;;;;;;;;;;;;;;;;;;;2,0;;;;;;;;;;12,0;;;20,0;;;;;;3,0;;;;1,0;;;;;;;2,0;;;;;;;;;;;;;;;;;;;;;;;;;;;;;;;;;;;;;;;;;;;;;;;;;;;;;;;;10,0;;;;;;;;;;;;;1,0;;;;;;;;;;;;;;;;;;;;;;;;;;;;;;;;;;;;;;;;;;;;;1,0;;;;;;;;3,0;;;;;;;;;;;;;;;;;;;;;;;4,0;;;;;;;;;;;;;;;;;;;;;;;;;;;;;;;;;;;;6,0;6,0;;;;;;;;;;;;;;;1,0;;;;;;;;;;;;;;;2,0;;;;;;;;;;;1,0;;;;;;;1,0;;;;;;;;;;;;;;;;;;;;;;;;;;;;;;;;;;3,0;;;;;;;;;;;;;;;;;;;;;;;1,0;;;;;;;;;;
park;;;;;1,0;16,0;;6,0;34,0;;;;3,0;;;10,0;;;;;;4,0;;;;;3,0;;;;;;5,0;;5,0;6,0;;;;;2,0;;23,0;;20,0;1,0;15,0;3,0;12,0;11,0;;8,0;;;2,0;1,0;;;45,0;;;;;;;;;;13,0;;2,0;;;;;;5,0;;;142,0;;;;25,0;2,0;1,0;;;;;;;;;;;7,0;;49,0;;;;1,0;1,0;;;2,0;1,0;13,0;1,0;;7,0;;;;15,0;3,0;1,0;;;;;;3,0;7,0;;;;;;;;2,0;;2,0;;;3,0;;;;;;1,0;;;;2,0;8,0;10,0;4,0;;1,0;5,0;4,0;;37,0;;;;;1,0;7,0;;;;3,0;13,0;;;;;;4,0;;;;;;;;;;;;;;;;;;;;;;;;;;;;;;13,0;;;;;;;;;;;;;;;3,0;;;;;;;;;;;;;;;;;;;1,0;;;3,0;;6,0;;;;;;14,0;;;;;;;;7,0;;;;;;;24,0;;;;;;;;;134,0;;;;;;;;;;;;;2,0;6,0;;1,0;;117,0;1,0;;;;;2,0;;;;;8,0;;;;;;;;1,0;;5,0;;;3,0;6,0;;;;;;;;;13,0;;2,0;;;3,0;;;;;;;;63,0;;;;;;;;;;;20,0;;;;;;;;;3,0;;;;;;;;;;2,0;;;;;;;;;;;;;;;;;;;;;;;;;;;;;3,0;18,0;;3,0;;;;;;;;;;;1,0;;3,0;3,0;12,0;;;;1,0;;;;;;;;1,0;2,0;;6,0;;2,0;;;;;13,0;12,0;43,0;;2,0;;2,0;;;;;;;2,0;;;;;3,0;;;;;;;;2,0;;;;;13,0;1,0;;7,0;26,0;;;1,0;;;;;;;;1,0;4,0;;;;;1,0;;;;;;;2,0;;;;4,0;;;;9,0;;;;;1,0;;;1,0;;;;;;;;;;;;;;;2,0;;6,0;;;8,0;;;;;13,0;;;;;;;;;;;;;;;;;;;1,0;5,0;;;;;;;;;;;;;;;;;6,0;;1,0;;;;;;;;;;;;;;;;;;;1,0;;;;;;1,0;;;7,0;;;;;;;5,0;;;;;;;;;;;;;;;;16,0;;;;;;;;;;;;;1,0;;;;;;;;;;;;;;2,0;;;;;;;;;;;;3,0;;;;;13,0;;;;;3,0;;;;;;;;;;;;;;;;18,0;;;;;;;;;;;;;;;;;;;;;;;;;;;;;;;;;;;;;;;;;;;;;;;;;3,0;;3,0;;;;2,0;;;;;;;;;;15,0;;;;;;;;;;1,0;;;;;;;;;;;;;;;;;;;;;;;;;;;;4,0;;;7,0;;;;;;1,0;;;;;;;;;;;;;;;;;;;;;;;;;;;;;3,0;;;;;;;;;;;14,0;3,0;;;;;;;;;;;;;;10,0;;;3,0;;;;1,0;;49,0;;;;1,0;;7,0;;;;;;;;;;;;;;;;16,0;;;;;;;;;;;;;;;;;;;;;;;;;;7,0;;;;;;;;;;;;;;;;;;;;;;;;;;;;;;;;;;;;;;;;;;;;;;;;;;;;;;;;;;;;;;;;;;;;1,0;;;;;;;;;;;;;;;;
participant;;;;;2,0;;;13,0;;;;;18,0;;;14,0;;;;;;10,0;9,0;;;;;;;1,0;;;6,0;;22,0;3,0;;;;;15,0;;;5,0;13,0;1,0;19,0;5,0;;2,0;;;;;;;;;;;;;;;;;;;1,0;;1,0;;7,0;;;1,0;7,0;;;11,0;;;1,0;42,0;;9,0;;;;;;;;;;1,0;1,0;;17,0;;;;1,0;8,0;;;;;2,0;;;;;;;27,0;;1,0;;;;;;1,0;1,0;2,0;;;;;;;2,0;;;;13,0;;;;2,0;;;;;;;;2,0;;;;;4,0;3,0;;6,0;;1,0;1,0;1,0;2,0;5,0;;;;25,0;2,0;;;2,0;;;;;;;;;;;;;;;;;;;;;;;;;1,0;;13,0;;;;;;;;;;;;14,0;;;;;;;;;;;;;;;;;;;;;;;;;;;3,0;;;;;;;;;;;;;;;;;;;;6,0;;;;;;;25,0;;;;;2,0;;;4,0;;;;;;;;;;;;;;6,0;;;;;;;;;;;;;;;;;;;;;;;;2,0;;;;;;;;;;1,0;;;;;;;;;;;;;;;;3,0;;;;;;;;;;;;;;;;;;;;;;;;;;;;;;;;;;;;2,0;;;;;;;;;;;;;;;;;;;;;;;;;;;;;;;1,0;;;;;;;;19,0;;;;;;;1,0;;1,0;;;;;3,0;;;;;;;12,0;;;12,0;;2,0;;55,0;;;3,0;;;2,0;;;;;;;;;1,0;;2,0;1,0;;;;;;;;;;;;;;6,0;;11,0;;;;;;;;;;;;;;;;;;;5,0;48,0;1,0;;;;;;;;;;;;;;;;;;;;5,0;13,0;;;1,0;;;;;;2,0;;;4,0;;;;;;;;4,0;;2,0;;;;;;;;;;;3,0;;44,0;;;;;;;;;;2,0;;3,0;;7,0;;;;;;;;1,0;1,0;;;;;;;;;;;;;;;3,0;;;;;;;;;;;;;1,0;;;9,0;;1,0;;;2,0;;;;;;;1,0;;1,0;;;;2,0;;2,0;1,0;;;;;6,0;;;;;;;1,0;;;;;;;;;;;;24,0;;;;;;1,0;;;;;;;;;;;;;;;;;;;;;;;;;;;1,0;1,0;;;;1,0;;;;;;;;;;;;;;;;;;;;;;;;;;;;;;;;;;;;;;;;;;;;;;;;;;;;;;;;;;;;;;;;;;;;;;;;2,0;;;;;;;;;;;;;;;;;;;;;;;;;;;;;;;;;;;;;;;;;;;;;;;;;;;;;;;;;;;;;;;;2,0;;;;;8,0;;;;;;;;;;;;;;;;;2,0;;;;;;;;;1,0;;;;;;;;;;;;22,0;;1,0;;;;;;;;;;;;;;;;;1,0;;;;;;;;;;;;;;;;;;2,0;1,0;;;;;;;;;;;;;;;;;;;;;;;;;;;;2,0;;;;;;;;;;;;;;;;;2,0;;;;;;;;;;;;;;;;;;;;;;;;;;;;;;;;;1,0;;;;;;;;;;;;;;;;;;
patient;;;;;6,0;;;6,0;17,0;;;;5,0;;2,0;2,0;21,0;;;;;4,0;;;;;;;;2,0;3,0;11,0;2,0;;;;1,0;;;;1,0;;;;1,0;;2,0;7,0;1,0;5,0;;6,0;;;;;6,0;;;;;;;;;;2,0;;;;;5,0;10,0;;;;;15,0;3,0;46,0;;5,0;;2,0;;;2,0;;;;4,0;;;;2,0;;;;7,0;;;;4,0;2,0;;;1,0;1,0;3,0;;;3,0;;;;;1,0;6,0;1,0;1,0;;;;12,0;4,0;;;;;2,0;;;;;1,0;1,0;;;;;;;;8,0;;;;;;;;;3,0;3,0;1,0;;9,0;;;;;;2,0;;;;;2,0;;;;;;;;;2,0;;;;;2,0;;2,0;;;;1,0;;;;;;7,0;;;;;;;;;;;;;;;;3,0;;;;;;;;;;;;;;;;1,0;;;36,0;;;;3,0;;2,0;1,0;4,0;;;;;;1,0;;;;;;;;;;;;;;20,0;11,0;;;;;;;;;;;;;;1,0;;;;;;;;15,0;;;;;;2,0;;;;2,0;;;;;;;;;;;;2,0;;;;;;;;;;;;;;;;;;1,0;;;;1,0;;;;;;1,0;;;;;;;;;;;;;1,0;;;;;;;;;;;;;;;3,0;2,0;;;16,0;;;;;;;;;;;;;;;1,0;;;;;;;;;;;;;;1,0;;;;;;;;1,0;;;;;;;;;;;2,0;;;;;1,0;;;;;;;;3,0;;;1,0;;;;;;;3,0;;1,0;;;;;;15,0;;;;;;;;;;;;;;;10,0;;;;;;;;;;;;;;2,0;;;;;1,0;;;;;;;;;;;;;;;;;;;;;;;;1,0;5,0;1,0;;;7,0;1,0;;;;;;;;;;;;;;;;;;;;;;;;;;;;;;;1,0;;;;;;1,0;;;;;;;;1,0;;;;3,0;;3,0;;;;;;;;;;;;;;1,0;;;5,0;;;;;;;;;;;;;;;;1,0;;2,0;;;;;;;;;;;;3,0;;;;;;;;;;;;;;;;;;;;;;;1,0;2,0;;;;;;;;;;;;;;;;;;;;;;;;;1,0;;1,0;;;;;;;;;;;;;;;;;;;;1,0;;;;;;;;;;;;;;;;;;1,0;;;;;;;;;;;;;;;;;;;;;;2,0;;4,0;;;1,0;;;;;;;;;;;;;;;;;;;;;;;;3,0;;;;;;;;;;3,0;;;;;;;;;;;;;;;;;;;;;;;;;;;;;;;;;;1,0;;;;;;;;;;;;2,0;;;;;;;;;;;;;;;;;;;;;;;;;;;;;;;;;7,0;;;;;;;;;;;;;;2,0;;;;;;;;;;;;2,0;17,0;;;;;;;;;;;;;;;;;;;;;;;;;;;;;;;;;;;;;;;;;;;;;;;;;;;;;;;;;;;1,0;1,0;;;;;;;;;;;;;;;;;;;;;;;;;;;;;;;;;;;;;;;;;;;;;1,0;;;;;;;;;;;;;;;;;;;;;;;;;;;;;;;;;;;;
peak;;;;;1,0;16,0;;;;;13,0;;4,0;;;4,0;;;2,0;;1,0;;6,0;;;2,0;54,0;;;;;3,0;2,0;9,0;;;;;;;1,0;1,0;6,0;;10,0;3,0;11,0;4,0;1,0;1,0;;23,0;;;;;2,0;;2,0;;;;;;66,0;;52,0;1,0;1,0;;10,0;3,0;;;;;10,0;;4,0;20,0;;;1,0;3,0;3,0;;;;;;31,0;;2,0;;;;1,0;;8,0;;;;;14,0;;;;3,0;;;;;;;;15,0;10,0;29,0;;10,0;;;;6,0;2,0;;;;;2,0;;;;;;;3,0;2,0;;;5,0;;;;;;;;23,0;;;;;1,0;1,0;;7,0;;;;;;2,0;;;;;;;10,0;;;;1,0;1,0;;;;;14,0;;;;;;1,0;;;;;;;;3,0;;;;;;;;3,0;3,0;;;;;11,0;;;;;;;;14,0;;;1,0;;;;;;;;;;9,0;;;;;;;4,0;3,0;;;;;;;;;;;;53,0;;;;;;;;;;;;;;;;;;7,0;;;;;;1,0;;1,0;;;;;;;;;;;3,0;;;;;;;;;;;;;;;1,0;;;;;;;;3,0;;;1,0;;;;1,0;;;;;;;;;;;;;;;;;;;;;;;;;;;;;2,0;;;;;;;;;1,0;;4,0;;;;;13,0;;;;;;;;;;;;;;;;;;;;;;;;;7,0;;;;;6,0;2,0;;;;5,0;;3,0;;;;;;;;;;;;5,0;12,0;;7,0;;;;;;;;5,0;;;;;;2,0;2,0;14,0;;;;2,0;;4,0;;;;2,0;;2,0;10,0;4,0;;;;1,0;;;;2,0;;;;;;;;;2,0;;;;2,0;;;;;20,0;3,0;;;;;;;9,0;;;;6,0;;;;5,0;4,0;;;;2,0;;;;;;;;;;;;;;;;;4,0;;;;;;;;;;;;;;;1,0;;;;;1,0;;;;;;;;;;1,0;;;;;;;3,0;;;1,0;;;2,0;;;;;;;;;;;;;;10,0;;;;;;;3,0;;;;;;;;;;;;;;5,0;2,0;;;;;;;;;;;;;;;3,0;;;;;;;;;;;;;;;;;;;;;;;;;;14,0;;;;;;;;;;;;;;;;;;;;;;;;;;;;;;;;;;;;;;;;;;;;1,0;;;;;;;;;;;;;;;4,0;;;;;;;;;;;;;;;;;;;;;;;;;;;;;;;;;;;;;;;;;;;;;4,0;;;;2,0;;;;;;;;;;;;;;;;;;;;;;;;;;;;;;;;;;;;2,0;;;;1,0;;;;;13,0;;1,0;;;;2,0;;;22,0;;;;;;;;2,0;;;1,0;1,0;;;;;;;;;;;;;;;;;;;;;;7,0;;;3,0;;;;;;2,0;;;;;;;;;;;;;;;;;;3,0;2,0;;;;;;;;6,0;;;;;;;;;;;;;;1,0;;;;;;;;;;;;;;;12,0;;;3,0;;;;;;4,0;;;;;;;;;;;;;;;;;;;1,0;2,0;;;;;;;;;;;;;;;;;;;;;;;;;;;;;;;;;;;;;;;;;;;;;;;22,0;;;;;;;;;;;;;;;;;;;;;;;;;;;;;;;;;;;;
person;;;;;5,0;1,0;;18,0;23,0;;;;18,0;8,0;4,0;40,0;;;1,0;1,0;11,0;13,0;2,0;;1,0;;4,0;1,0;;;22,0;2,0;13,0;;7,0;;4,0;;2,0;;20,0;;6,0;4,0;34,0;2,0;33,0;41,0;36,0;40,0;3,0;;2,0;3,0;;2,0;1,0;;8,0;1,0;5,0;;9,0;;;;;4,0;1,0;4,0;2,0;;18,0;;;14,0;82,0;1,0;;411,0;1,0;2,0;;59,0;1,0;5,0;;;;4,0;1,0;;2,0;;2,0;2,0;3,0;1,0;65,0;1,0;8,0;12,0;3,0;36,0;;;1,0;1,0;9,0;;4,0;7,0;;;;34,0;18,0;28,0;;12,0;1,0;;7,0;22,0;4,0;10,0;;;;7,0;;1,0;3,0;;18,0;1,0;;2,0;2,0;1,0;27,0;;;10,0;;;;4,0;7,0;7,0;15,0;;2,0;26,0;2,0;;52,0;;;;2,0;6,0;5,0;;;;17,0;9,0;;1,0;8,0;;;15,0;;1,0;1,0;;;;;1,0;;;;;;;;;;;;2,0;;6,0;;;;;;5,0;;12,0;;;;;;97,0;;;;;;;;;4,0;;2,0;;;;;;;;3,0;;2,0;;1,0;14,0;;1,0;10,0;1,0;1,0;;;;;;;;;3,0;3,0;;6,0;;;1,0;;;4,0;;;;;;;11,0;;;1,0;;;;;15,0;6,0;;;;;1,0;;1,0;;;;;;12,0;;;10,0;;4,0;;;;;;2,0;;;;;5,0;1,0;;;;;;;6,0;;1,0;;;;1,0;;4,0;;1,0;;;;;1,0;;;;3,0;;;;;;;;;3,0;8,0;;;;;;;4,0;;;1,0;;;;;;;;;13,0;;;;;;;;;;;;;10,0;;;1,0;;;;3,0;1,0;;;;;;;1,0;;;;;1,0;8,0;;;7,0;;;;3,0;;;;7,0;4,0;;;;;1,0;7,0;8,0;;2,0;;3,0;;2,0;;1,0;;;;4,0;;;;;10,0;;1,0;;24,0;;;24,0;;8,0;5,0;;;16,0;2,0;5,0;;26,0;2,0;3,0;;;;6,0;;;;8,0;10,0;2,0;;;1,0;2,0;;1,0;;;;;;;7,0;;;1,0;;24,0;1,0;;;;;;;2,0;;4,0;;;2,0;;;;11,0;3,0;1,0;3,0;;1,0;;5,0;11,0;2,0;;;4,0;2,0;;;;;4,0;;;;;;;;;;;;;2,0;;;1,0;4,0;;;;;;;;;;5,0;1,0;;;1,0;;;;;1,0;;;;12,0;;2,0;1,0;4,0;;;2,0;;1,0;3,0;;4,0;;;1,0;;10,0;6,0;;;;20,0;;;;4,0;;;;;;;16,0;;;;;3,0;;;5,0;;;;;;;1,0;4,0;;;;;;;5,0;;;;;;;;;;1,0;;3,0;;;;;;7,0;12,0;3,0;27,0;9,0;;;;;;;;;;;;;;;4,0;;4,0;;;;3,0;6,0;;;;;;;;;;;;;;;;;;3,0;;;;;;;;;;;1,0;1,0;;2,0;6,0;;;;2,0;;;;;;3,0;;;;;;6,0;;;;;;8,0;;;5,0;;;;;;;1,0;;;;;;;;;;;;;;;;;;;;;;;;;2,0;1,0;;;;;;;;;;;;;;;;1,0;4,0;;;;;;;1,0;;;;;;;;;3,0;;;;;;;;1,0;;;;;1,0;6,0;;9,0;;;;;;;;;;;2,0;;;;2,0;5,0;;;;16,0;;;;;;;6,0;;;;;31,0;;2,0;2,0;;;;;;;;;;;;1,0;;;;;;4,0;;2,0;;;;;;;1,0;;;;;;;2,0;;;;;;;3,0;5,0;2,0;;;;;;;;;;;;;;;;;;;;2,0;1,0;;;51,0;;;;;;;;1,0;1,0;;;1,0;;;;;;;;;;;1,0;5,0;;;;;;;;;;;;;;;1,0;2,0;;2,0;1,0;;;;;;;;;;2,0;;16,0;;;;;;1,0;;;1,0;;;;;;;;;9,0;;;;;1,0;;;;;;10,0;;;;;;13,0;;;;;1,0;;;;6,0;;;;;;;;;
photo;;;;;16,0;2,0;;3,0;6,0;6,0;31,0;;11,0;;1,0;17,0;;1,0;;4,0;;41,0;4,0;4,0;;;1,0;1,0;;;30,0;1,0;14,0;;24,0;2,0;;;3,0;;5,0;;;;18,0;3,0;31,0;31,0;54,0;49,0;2,0;4,0;;;1,0;;4,0;;;;;;4,0;22,0;4,0;;1,0;2,0;16,0;;6,0;;13,0;;;;;3,0;;56,0;;;;12,0;;2,0;;;;;24,0;;;;5,0;;10,0;2,0;39,0;;;;15,0;31,0;;;6,0;;5,0;9,0;;6,0;;;;42,0;12,0;6,0;;17,0;8,0;;;2,0;10,0;14,0;;;1,0;;;1,0;1,0;;9,0;;7,0;6,0;7,0;;20,0;;;112,0;1,0;;;;7,0;;3,0;;7,0;23,0;;;16,0;;;4,0;;1,0;49,0;;;;40,0;24,0;;;;;;;3,0;;21,0;;;;;;;;;4,0;;1,0;10,0;;;;;1,0;2,0;;2,0;;;9,0;;;5,0;2,0;;;;1,0;1,0;2,0;;;;;;;;;;1,0;2,0;;;;;;;;50,0;;8,0;;;3,0;;;3,0;1,0;;;;1,0;;;;;;;5,0;1,0;;;;;;;3,0;;1,0;;;;;29,0;5,0;;;;1,0;;;9,0;;;;;;;;;1,0;;;;;2,0;;;;;11,0;;;;;;;;;;;;;1,0;;;;;;;;1,0;;;;2,0;;;;11,0;;;;;2,0;;;;;;;;;;;;;4,0;;;;;;1,0;7,0;;;1,0;;;;;;;;;;8,0;;;;;;;;;;;;;;;;;;;;;;1,0;1,0;;;;;;;;;;;9,0;;;;;1,0;2,0;;;;;;;;;;;2,0;;12,0;;3,0;;;;;2,0;;;5,0;8,0;34,0;;;;;17,0;;4,0;;1,0;4,0;;;;8,0;5,0;19,0;;;6,0;;;1,0;;1,0;;;2,0;;;;4,0;;9,0;13,0;;;;17,0;;;;;;;;;;;;7,0;;148,0;1,0;;;;;;1,0;2,0;1,0;;;;;;;1,0;2,0;;;;;;;28,0;;;;1,0;9,0;17,0;;1,0;;;;;4,0;;2,0;;;;;;;;;;1,0;;12,0;;;;;;1,0;1,0;;;;;1,0;;;;;;;;2,0;1,0;;;48,0;;;;;;;;;;3,0;;2,0;1,0;6,0;;7,0;;;;;1,0;;2,0;;1,0;;;;;4,0;8,0;;;;;;;4,0;;;;;;;;;13,0;;;;;1,0;;;;;;;;;;1,0;;;;;;1,0;;;;;;;;1,0;5,0;;;;3,0;;;;2,0;12,0;;;1,0;;;;;;;;;;3,0;;;1,0;;;;;;;;;;;;;;;1,0;2,0;;;;5,0;;;8,0;;;;;;;;;;;;;;;;2,0;;;;;;;;4,0;;;;;1,0;;;;7,0;;;;;;;;;;;;;;6,0;;;11,0;;;;;;;;;4,0;;;;;;;7,0;;;;;;1,0;;;;;;;;;;;;;3,0;;;10,0;;;2,0;;;;;;;;2,0;;;;;;;;;;1,0;8,0;2,0;5,0;2,0;14,0;2,0;;;1,0;1,0;;;;;1,0;;;;;;;7,0;;;;;;;;63,0;;;;;;;;;;;;;;;;;;4,0;;;;;;;;;;;;;2,0;;;;;;3,0;;;;;;;;;;;;;;;;;;;;;;;;;;;;;;;;1,0;;;;;;;;;2,0;;;6,0;;;;;;;;;2,0;;;;;;;;;;;;;;;;;;;;;;;;;;;;;;11,0;;;;;;;;;;;1,0;;;;;;;;;;;;;;;;;;;;;;;;;;2,0;;;;;;;;;;4,0;;;;;1,0;;;;;1,0;;3,0;;;;;;;
photography;;;;;1,0;;;7,0;;;2,0;;1,0;;2,0;33,0;;;;;3,0;15,0;1,0;;;;11,0;2,0;;;3,0;92,0;19,0;;19,0;3,0;1,0;;3,0;;13,0;;;;4,0;11,0;20,0;62,0;43,0;28,0;3,0;;;;17,0;;8,0;;;;;3,0;2,0;8,0;;2,0;1,0;;2,0;;3,0;7,0;3,0;;;;1,0;3,0;47,0;57,0;;24,0;;22,0;;3,0;;;;;5,0;;;;;6,0;1,0;;32,0;;;;;;;;12,0;;6,0;;;43,0;;;;18,0;2,0;10,0;1,0;17,0;2,0;;2,0;33,0;;;;;;6,0;;1,0;1,0;;;;;;;;19,0;;;4,0;14,0;;;22,0;9,0;;2,0;;4,0;1,0;9,0;;52,0;;1,0;;3,0;2,0;77,0;;;;6,0;1,0;;;;;;;1,0;1,0;;1,0;;;;6,0;;;;;;25,0;1,0;;;;;2,0;9,0;;;;;;;;1,0;2,0;1,0;;;;3,0;;2,0;;;;;;;;2,0;;;;;;;;;;26,0;;;;11,0;3,0;;;1,0;;;;;;;2,0;;;;;;;;;;;;;4,0;;1,0;;;;;39,0;;;;;;;;5,0;;;;;23,0;;;2,0;;32,0;;;;32,0;;;;;;;8,0;;5,0;;;;;1,0;;3,0;;;;;;1,0;;;;;;;;;;;;;;;;;1,0;;;;;;;;;;;;;;;;;;;2,0;2,0;;;;;;;2,0;;;;1,0;11,0;3,0;;;;;;;;;;;;;;;;;;;;;3,0;;;;;;;1,0;;;;9,0;;;;;;6,0;;;;1,0;;;;3,0;3,0;;;;16,0;;4,0;;;;;;;5,0;1,0;;;2,0;;4,0;;;;;;;;11,0;5,0;;1,0;;13,0;;130,0;;;13,0;44,0;;;2,0;6,0;3,0;;1,0;53,0;;;;;16,0;;;;;9,0;;;;;;;;4,0;;;;;;7,0;1,0;;1,0;;;12,0;;;13,0;;;;;;8,0;;;;11,0;2,0;;1,0;;2,0;;;;;3,0;57,0;;3,0;;;;;1,0;;;1,0;11,0;;;1,0;;1,0;;;7,0;;;;;;;;;;;;;;1,0;;;;;;;;;;;;2,0;;;;;;;;;;;;6,0;;;;11,0;;10,0;;8,0;;;9,0;;;1,0;;;;;;;;;18,0;1,0;;;;;;4,0;;;;;;;;;;1,0;;;;3,0;;;7,0;;;;;;;;;;;;;;;;;4,0;6,0;;;;;;;;;;;;;;;;;4,0;;;;;;;;6,0;;;;;1,0;;;;;;;;;;;;;;;1,0;18,0;1,0;;;;;;;;;;;;;;;;;;;;;;;;;;;;;;;;2,0;;4,0;;;;;;;;;;;;;;;;;;;;;;;;;;;4,0;;;;;;;;;;;;;;;;;;;;;;;;1,0;;;;;;;2,0;;;;;;;;;;;;;;1,0;;;;;;;;;1,0;;3,0;;;2,0;;;;;;2,0;;1,0;;;;;;;;;;;;;;;;;;;6,0;;;;;;;;;;;;;;;1,0;;;;1,0;;;;;1,0;;;2,0;;;;;;;;;;;;;3,0;;;;;;1,0;;;;;;6,0;;;;4,0;;;;;;;;;;;;;;;;;;;;;;9,0;;;12,0;;;;;;;2,0;;;;;;;;;;;;;;;;;;;;;;;;;;;;;;;;;;;;;;;;;;;;2,0;;;;;1,0;;;;;;;;;;;;;;;;;;;;3,0;;1,0;;;;;;;;;;;;;;;;;;;;
physical;;;;;4,0;2,0;;4,0;9,0;;;;56,0;4,0;19,0;31,0;;1,0;;;19,0;70,0;4,0;;;2,0;;3,0;;;11,0;;33,0;;7,0;;;1,0;1,0;;52,0;;4,0;16,0;9,0;3,0;39,0;70,0;4,0;24,0;6,0;10,0;2,0;;;10,0;6,0;3,0;15,0;;;8,0;7,0;;3,0;2,0;1,0;10,0;7,0;;;;17,0;;14,0;1,0;9,0;1,0;3,0;122,0;;16,0;3,0;34,0;;6,0;;;;3,0;12,0;;1,0;;3,0;3,0;28,0;;49,0;1,0;2,0;;8,0;207,0;;2,0;4,0;4,0;10,0;8,0;;7,0;;;;31,0;4,0;63,0;;11,0;;;5,0;11,0;10,0;9,0;16,0;3,0;1,0;1,0;;6,0;22,0;;6,0;4,0;;12,0;;2,0;20,0;;3,0;40,0;1,0;;;;7,0;6,0;;;4,0;8,0;;;63,0;;4,0;;3,0;23,0;14,0;;;;26,0;8,0;;5,0;;3,0;;;;3,0;;3,0;2,0;;1,0;2,0;;4,0;;11,0;;1,0;;;2,0;;;;;10,0;;1,0;;9,0;;;1,0;11,0;2,0;;1,0;;;;2,0;;;;;;;;18,0;1,0;1,0;;6,0;;;;6,0;;12,0;;;4,0;2,0;2,0;;2,0;35,0;2,0;;;1,0;3,0;;3,0;;;;;9,0;;3,0;;;;;;44,0;2,0;3,0;;;;;29,0;;;23,0;;1,0;;;3,0;72,0;;;;;4,0;;15,0;6,0;;;15,0;;5,0;3,0;4,0;;;;1,0;;;1,0;;;;;;4,0;2,0;;;5,0;;;;;;;;1,0;;1,0;2,0;;2,0;;12,0;;;;;2,0;;1,0;;;;2,0;;;5,0;;1,0;3,0;;;;;;;;4,0;;;;;6,0;;1,0;;;;;;7,0;8,0;;;1,0;1,0;;;;;;;;4,0;;;4,0;;;;;3,0;;;;;;;;;;;;1,0;18,0;1,0;;;4,0;;;;;;1,0;1,0;2,0;;;;;5,0;6,0;3,0;7,0;3,0;;29,0;;;;;;;;2,0;4,0;;;;12,0;;;1,0;4,0;;;54,0;;2,0;2,0;;;1,0;6,0;;3,0;4,0;2,0;;;54,0;;;;3,0;;;4,0;2,0;2,0;;;3,0;;;;;;;;;9,0;;;;;60,0;;;;;;7,0;8,0;1,0;2,0;;;3,0;1,0;6,0;;;20,0;;;;2,0;2,0;;30,0;;2,0;;1,0;;;;1,0;;3,0;;1,0;21,0;;;;;;;;;;2,0;;;;1,0;;;2,0;;;;1,0;8,0;;;3,0;6,0;;;;;;;;;1,0;;;9,0;;;11,0;;22,0;3,0;;1,0;;4,0;1,0;;;1,0;;;;2,0;;;4,0;;7,0;;;4,0;;;;;;;;;;;;4,0;1,0;1,0;20,0;36,0;;;;;;4,0;;;7,0;;2,0;;;2,0;2,0;;;;;3,0;6,0;1,0;;;;9,0;;2,0;;;;;1,0;;10,0;4,0;;;;;;4,0;;8,0;1,0;;;;7,0;;;;;;;;22,0;;;8,0;;;;4,0;;;;;;1,0;;;1,0;;;;;;;;;;;;;1,0;;;;;;;;6,0;3,0;;1,0;;;36,0;;;;;;;15,0;;;;;5,0;;;11,0;;;;;;1,0;;;;;;;;;;;;;;;;;;;;25,0;;4,0;;;2,0;;;;;;1,0;;;;;;;;;;3,0;;1,0;;;2,0;;;;;1,0;;;;;;;;;2,0;;;;;;1,0;;3,0;;;1,0;;;5,0;;;7,0;3,0;;;;;;;;4,0;;10,0;;;;;;4,0;;;;;;;;;;11,0;;;1,0;;;;;;;;;;;;;;;;;1,0;;;;;;;18,0;;;;;;1,0;;;;1,0;;;1,0;;;;;;;;;2,0;;;;;;;;;;;;;;;;;;2,0;;;;3,0;;;;;1,0;;;;;;3,0;;1,0;;;;;;;;;;;;;;;2,0;;;;5,0;;;;;;5,0;;;;;;;1,0;;;;;;;;;;;;3,0;;;;15,0;;;;;;;;;2,0;;;;;5,0;;;;;1,0;;2,0;;;;;2,0;;;;;;;;;;;;;;;3,0;3,0;;1,0;;4,0;;;;;
player;;;;;3,0;3,0;;7,0;25,0;7,0;;;4,0;1,0;;27,0;;;;1,0;;12,0;;;;;;;;;6,0;19,0;12,0;;6,0;11,0;;;14,0;;27,0;;1,0;5,0;2,0;1,0;14,0;15,0;9,0;14,0;;5,0;;;;;;;;;;;2,0;;;;;;;;1,0;;;;;;;;1,0;65,0;;;;7,0;;;;;;;;;;1,0;;2,0;1,0;;11,0;2,0;;;8,0;19,0;4,0;;;;2,0;;;3,0;;;;5,0;;35,0;3,0;;;;;;2,0;2,0;;;;;;;6,0;;;;;9,0;;;;;;1,0;;;;6,0;1,0;;;;4,0;;;;9,0;;;;1,0;;;;1,0;;16,0;5,0;;;6,0;;;;;;;;;;;4,0;;;;;;;;;;;;;;;;;;;;;;;;;;;;1,0;;;;;1,0;;;;;;;;;;;;;;1,0;;;;;;;;7,0;2,0;3,0;;;;;;;;;;;;;;;;;;12,0;;;;;;;;;;;;;;;;4,0;;;;;;;;;;;;;8,0;;48,0;;;;;;;;;;;;;;;;;5,0;;;;;;;;;;;;;;;;;;;;;;;;;;;;;;;;;;2,0;;;;;;;;;;;;;;;;;;;;5,0;;;;;;;;;;;;;;;;;;;;;;;;;;;;;;;;;;;;;;;;;;;;;;;;;;6,0;;4,0;;;;;;;;;;;;;;;;;;;;;25,0;;;1,0;;;;1,0;;1,0;5,0;5,0;;1,0;12,0;6,0;;;;;;;;1,0;;;;;;;;;;;;;;5,0;20,0;;;;;;;;3,0;;;;;;;;;;5,0;;;;4,0;5,0;;;;;;;;;1,0;6,0;;;;;;;;;5,0;2,0;;6,0;;;;;;;;;;;;;;32,0;;;;;;;;;1,0;;;;;;;;;;;;;;;;;;;;;;;;;;;;;;;;;;;;;;;;;;;;;1,0;;;;5,0;3,0;;;57,0;;;;;;;3,0;;;;;7,0;;;;;;;;;;;;;;;;;1,0;;1,0;;;6,0;4,0;;;;;;;;;;;;;;;;;;;;;;;16,0;;;;;;;;;;;;;;;;;;;;;;;;;;;;;;;8,0;;22,0;1,0;;;;;;;;;;;;;;;;;;;;;;;;;;;;;;;;;;;;;;;;;;;;;;;;;;;;;;;;;2,0;;;;;;;;;;;;;;;;;;;;;;;;;6,0;;;;;1,0;;;;;;;;;;;;;;;;;5,0;;;;;;;1,0;12,0;;;;;;;;;;;;5,0;;;;;;;;;;;;;;;;;;;;;;;;;;;;;;;;;;;;;;1,0;;;;;;;;;;;175,0;;;;;8,0;;;;;;;;;;;1,0;;;;;;;;;;;;;;;;;;;;;;;;;;;;;;;;;;;;;;;;;;;;;;;;;;;;7,0;;;;;;;;;;;;;;;;;;;;;;;;;;;;;;;1,0;;;;;;;;;;;;;4,0;;;;;;;;;;;;;;;;;;;;;;;;;;;;;;;;
pose;;;;;8,0;9,0;1,0;16,0;;5,0;;;48,0;;;59,0;;;;;3,0;45,0;1,0;;;;2,0;;;;17,0;;16,0;;4,0;3,0;13,0;23,0;;;25,0;;10,0;35,0;6,0;8,0;165,0;32,0;;7,0;;6,0;2,0;;1,0;;;20,0;70,0;;;6,0;1,0;;1,0;;;;8,0;;14,0;;31,0;;;39,0;20,0;;;268,0;;2,0;3,0;11,0;;5,0;1,0;;1,0;;4,0;;;;32,0;1,0;3,0;;111,0;16,0;6,0;;8,0;39,0;2,0;;2,0;9,0;5,0;14,0;1,0;10,0;;;;79,0;1,0;42,0;;3,0;1,0;;5,0;17,0;10,0;7,0;;;;15,0;;67,0;38,0;;25,0;;4,0;4,0;29,0;;31,0;;;34,0;35,0;;;;24,0;6,0;1,0;;1,0;;24,0;;58,0;;;;3,0;;10,0;;;;22,0;1,0;;;13,0;;;;;18,0;1,0;;;;;6,0;;;;;;;;;;;;;;;2,0;;;;;9,0;11,0;;1,0;;;;;6,0;;;;;;;;;;;;;;;;;;;;;;;;4,0;;13,0;;;;;1,0;;;12,0;;;;;;1,0;;;;;;;13,0;;;;;;;8,0;;;;;;;;;5,0;;;;;4,0;;1,0;;;;;;28,0;;;;;38,0;;;;;;8,0;;;;;;;;;;;;;;;;;;;32,0;;;;2,0;;;;;;;;;;;;;;;;;;;;;;;;;;;;;;;;;;5,0;;;6,0;35,0;6,0;;;1,0;;;;;;;;;;;;;;;;;5,0;13,0;;;;;;;;;;;;15,0;;2,0;;;;;;;;;;;1,0;;;33,0;12,0;25,0;16,0;4,0;16,0;4,0;24,0;;2,0;;;;;;;2,0;;;3,0;84,0;;7,0;;5,0;;;22,0;;48,0;15,0;;;9,0;22,0;6,0;;;;;;30,0;;;;;6,0;7,0;1,0;1,0;;;;;;;;;;;;6,0;55,0;;;;7,0;14,0;;30,0;;;;4,0;4,0;;;35,0;;;10,0;;2,0;;15,0;;1,0;8,0;;;3,0;;;;;;3,0;;13,0;10,0;;;;4,0;;;;;;;;;;;;;8,0;;;;;;;;1,0;;;;;3,0;;;;;;;;;1,0;;4,0;;;;;;1,0;;1,0;1,0;;;;;;;10,0;;;;2,0;;;;3,0;;;;;;;;;3,0;;;;;;;;;;;;;;;;;;;;;;1,0;;;;;;;1,0;;13,0;;;;;;;;4,0;;;;;1,0;;1,0;;;;;;;;;;;;;;11,0;;;1,0;;;29,0;;5,0;;;;;;;;;;;;;;;;;;;1,0;;;;;;;;;;;;;;1,0;73,0;;;;;38,0;;;;1,0;;;;;;;;;;;;7,0;;;8,0;;;;;;;;;;;;;;;;;;;;;;;;;;2,0;;;;;;3,0;;1,0;;;;;;;;;;;;;;;;;;4,0;;;;;;;;;;;;;;;42,0;;;;;27,0;;;;;;4,0;2,0;;;;21,0;;27,0;;;;;;;;;;;;1,0;;2,0;;;;1,0;;;;10,0;1,0;;;;;1,0;;;16,0;6,0;;;;;;;;;;;;1,0;;;;9,0;;6,0;2,0;;;;;;;;;;;12,0;10,0;;;13,0;;;;;;;;;;;;;;;;;;;;;;;2,0;;;;;;;;;;;1,0;;;;;;;;;;;;;;;;;;;;;;;;;;;2,0;1,0;17,0;;4,0;;;;;1,0;1,0;;28,0;;;;;;;;;;;;;;;;;;;;1,0;;;;;;2,0;;;;;;;;;;;;;;;;;;;;;1,0;;;;;;;;;;;;;;;;;;;;;;
predict;;;;;4,0;6,0;;11,0;;;1,0;;7,0;;;51,0;;;5,0;;;1,0;;;;;;;;;1,0;;27,0;;47,0;1,0;10,0;;;;8,0;1,0;;9,0;3,0;;23,0;9,0;;12,0;;21,0;;;2,0;1,0;3,0;4,0;;;;;3,0;;;;43,0;;12,0;;6,0;;59,0;;;1,0;;;;60,0;4,0;3,0;;8,0;;;1,0;;;;34,0;;;;;;1,0;;30,0;6,0;8,0;;2,0;36,0;;;2,0;;5,0;23,0;;11,0;;;;;1,0;31,0;;10,0;;;1,0;11,0;;;;;;2,0;;6,0;8,0;;;;;1,0;;;4,0;;;1,0;3,0;;;;1,0;;1,0;;1,0;1,0;17,0;2,0;6,0;;;2,0;;;56,0;;;;5,0;;;;2,0;;;;5,0;;1,0;;;;1,0;3,0;;;;;;;;;;;;1,0;;;;;;1,0;;;16,0;17,0;13,0;;;;4,0;;;;;;;;;;;;;;;;;;;;;;;;;;1,0;2,0;6,0;;;;;;;38,0;;;;;2,0;2,0;;;;;;;;;;;;;;1,0;;;;;;;;1,0;;;;;;;;2,0;;;3,0;;;49,0;;;;;42,0;;;;;;;;;;1,0;;;;;;;1,0;;1,0;;;;;;;;;;;;;;;4,0;;;;;;;;;;;;;;;;;;;;;;;;;;;;;3,0;;;;27,0;;;;2,0;;;;;;;;;;;;;;;;;;;;;;;;;;;1,0;;;4,0;;;;;;;1,0;;;1,0;;2,0;;;;;;4,0;8,0;13,0;14,0;;1,0;;;;;;;4,0;1,0;;;;;4,0;;;;;;;9,0;;2,0;;2,0;;;66,0;3,0;;;;6,0;;2,0;10,0;2,0;4,0;;1,0;;;;;;1,0;;;;14,0;1,0;;;3,0;;31,0;5,0;2,0;;6,0;;1,0;16,0;;1,0;;4,0;;3,0;2,0;1,0;;;;;;;;3,0;;3,0;;;;;;;;;2,0;2,0;;;2,0;;;;2,0;;14,0;;;;;;;3,0;;;;;;;;;;;3,0;;;;;3,0;;;;;;;;;1,0;2,0;;;;;;;;;;;;;;;;;4,0;;3,0;;;;;;;;;;;;;;;;;;;;;;;;1,0;;;;1,0;;;;;;;;;1,0;;;;;;;;;;;;;;;;;;1,0;;;5,0;;;5,0;8,0;;;;;;;;;;;;;3,0;;;;;;;;;;;;;;;;;;;;4,0;;;;;;;1,0;;9,0;;;;;;;;;;;;;7,0;;;;;;;;;;;;;;;;;;;;;;;;1,0;;;;;;;;;;;1,0;;;;;;;;;;;;4,0;;;;;;;;;;;;;;4,0;;;;;;;;;;;;;;;1,0;5,0;;;;;;;;;;;;;1,0;;;;;;;;15,0;;;;;;1,0;;;;1,0;;;;;;;;;1,0;;;;;;;;;;;;;;;;;;;;1,0;;;;4,0;;1,0;;;;;;;;;;;;;;;;;;;;;;1,0;;;;;;1,0;;;;;;;;;;;;;;;;;;;;;;;;;;;;;;;;;;;;;;;;;;;;;;;;;;;;;;;;;;;;;;4,0;1,0;;29,0;;;;;;;;;;;;4,0;;;;;1,0;;;;;;;;;;;;;;;;;;;;;;;;;;;;;;;;;;;;;;;1,0;;10,0;;;4,0;;13,0;;2,0;26,0;;;;;;;;;;2,0;;;;;
presence;;;;;2,0;;;;4,0;4,0;;;2,0;;;11,0;;;;;;2,0;;;;1,0;1,0;;;;;;7,0;;;2,0;;;;;23,0;;5,0;;47,0;7,0;59,0;3,0;;2,0;;;;;;;6,0;;6,0;;;;2,0;;;;;;2,0;;1,0;;3,0;;;11,0;22,0;;;34,0;1,0;;;2,0;;2,0;;;;;;;;1,0;;;;2,0;23,0;;;;3,0;48,0;;2,0;1,0;1,0;;7,0;;;;;;6,0;2,0;5,0;;20,0;;;;;;;;3,0;;1,0;;1,0;1,0;;1,0;;1,0;4,0;;1,0;3,0;;;5,0;;;;;4,0;;26,0;;;;5,0;;4,0;;;;1,0;;5,0;;;;4,0;24,0;;1,0;;;;4,0;2,0;;5,0;;;;;3,0;;;2,0;1,0;;;;;;;;;;;;;;3,0;;3,0;9,0;4,0;;;;;;5,0;;;;;;;;;;;1,0;;;;;;;;12,0;;;;5,0;;;3,0;;;;;;;;;;1,0;;;6,0;;;;;;1,0;;;7,0;;;;;;3,0;;1,0;;1,0;;;;1,0;3,0;;;;2,0;;1,0;;4,0;;;;;2,0;1,0;;;;13,0;;;;;;;;;;;3,0;1,0;;;;;;;5,0;;1,0;;;5,0;;;;;;;;;;;;;;;;;;;;;1,0;;;;;;;;;;2,0;;2,0;;;;;;;;;;20,0;;;;;;;;;;;;2,0;2,0;;;;;;;;;;;;;;;;;;;;1,0;4,0;;;;;;;1,0;;;;;;;;;;1,0;;3,0;;7,0;;;;;1,0;;;;;2,0;;;;1,0;5,0;1,0;3,0;;;2,0;;41,0;;;;;;;30,0;;;;1,0;2,0;;;1,0;1,0;;;1,0;;2,0;1,0;;;;;;;;;;;;14,0;;;2,0;;5,0;4,0;;;;;;;;;;1,0;1,0;;;;;;;20,0;;2,0;;;;1,0;;;1,0;;;;;;;;;;;;;;;;;;;;;;3,0;;;;;;4,0;;1,0;;;;;11,0;3,0;;;;;;1,0;;1,0;5,0;;;;;;;;;;;10,0;;;;2,0;;;;;2,0;;;;1,0;;;;;;;;;;1,0;;8,0;;;;;;;1,0;;;;;;;;3,0;;;;;;;;;;;;1,0;;1,0;;;;;;;;;;;;2,0;;;5,0;;;;;;;;;;;;;;;;;;;;;;;;;2,0;;;;;;;;;;;1,0;;;;;2,0;;;;;;;;;;;;;;;;;;;;;;;;1,0;;;;;;1,0;;;;;;;;;;;;;;;;;;;;;;;;;;;;;;;2,0;;;;;;;;;;;;1,0;;;2,0;;;1,0;;;;;;;;;;;;12,0;;;;;;1,0;;;;;;;;;3,0;;2,0;;5,0;;;;2,0;;;;;;7,0;;;;;;;;;;;;;;;;;;;;;;;;;;1,0;;;;;;;;;1,0;;;;;;;;;3,0;13,0;;;;;;;;;;;;;2,0;;;;;;;;;;;;;2,0;;;;;;;;;;;;;;;;;;;;;;;;;;;;;;;;;;;;;;1,0;;;;;;;;;;;;1,0;;;;;;;;;;;;;;;;;;;;;;;1,0;;;;;5,0;;;1,0;;;;;;;;;;;;;;;;;;;;;;;;;;;1,0;;;;;1,0;;;;3,0;;;;1,0;;;;;1,0;;;;;;;;;;;;;;;
produce;;;;;1,0;14,0;9,0;23,0;7,0;11,0;40,0;1,0;6,0;1,0;11,0;49,0;20,0;13,0;2,0;2,0;9,0;61,0;;5,0;;5,0;59,0;13,0;;;7,0;1,0;76,0;1,0;15,0;7,0;10,0;14,0;;;224,0;2,0;5,0;22,0;11,0;8,0;30,0;80,0;30,0;51,0;1,0;5,0;14,0;;14,0;6,0;30,0;7,0;2,0;;;6,0;7,0;22,0;22,0;1,0;22,0;2,0;60,0;5,0;10,0;3,0;10,0;;4,0;7,0;5,0;2,0;26,0;778,0;9,0;94,0;1,0;49,0;;8,0;5,0;;;3,0;45,0;1,0;;7,0;7,0;5,0;8,0;;169,0;3,0;4,0;18,0;29,0;58,0;8,0;14,0;35,0;6,0;97,0;10,0;2,0;20,0;;3,0;4,0;68,0;56,0;17,0;4,0;10,0;1,0;2,0;34,0;44,0;20,0;8,0;;;7,0;10,0;11,0;30,0;8,0;3,0;11,0;8,0;3,0;21,0;;;67,0;;1,0;62,0;1,0;;;14,0;182,0;4,0;4,0;;3,0;20,0;19,0;;72,0;1,0;1,0;5,0;8,0;9,0;69,0;1,0;3,0;1,0;86,0;28,0;10,0;7,0;8,0;;;;;7,0;5,0;1,0;1,0;5,0;3,0;13,0;;;5,0;10,0;2,0;3,0;;7,0;5,0;;;3,0;;;;;;;;;13,0;1,0;6,0;1,0;9,0;2,0;19,0;4,0;9,0;9,0;9,0;2,0;1,0;8,0;;1,0;3,0;;2,0;4,0;;;;;7,0;1,0;139,0;;1,0;;6,0;;;;3,0;1,0;;1,0;4,0;3,0;2,0;6,0;;1,0;1,0;;36,0;15,0;3,0;;;1,0;;17,0;16,0;6,0;4,0;;1,0;4,0;;16,0;1,0;2,0;6,0;;4,0;;;47,0;5,0;1,0;20,0;2,0;3,0;9,0;8,0;35,0;11,0;;2,0;1,0;;22,0;;4,0;;;17,0;2,0;7,0;2,0;;;5,0;;;;2,0;;;;;;;14,0;;2,0;;;2,0;;1,0;32,0;;1,0;;3,0;;;;;3,0;;;1,0;;3,0;;;;;;9,0;;1,0;4,0;;;;4,0;1,0;2,0;4,0;;18,0;;17,0;2,0;;;5,0;;;17,0;4,0;;12,0;7,0;1,0;;1,0;;;23,0;1,0;;3,0;6,0;;;2,0;;;1,0;;13,0;5,0;;;10,0;;;4,0;;;3,0;4,0;;24,0;8,0;1,0;;5,0;;;1,0;;;;;21,0;;;2,0;19,0;13,0;7,0;8,0;3,0;2,0;11,0;1,0;;;;;1,0;;3,0;6,0;;4,0;5,0;;2,0;1,0;9,0;3,0;17,0;;1,0;6,0;5,0;12,0;10,0;8,0;;10,0;18,0;23,0;;1,0;25,0;26,0;;4,0;6,0;3,0;;2,0;2,0;4,0;26,0;4,0;;;;6,0;;4,0;;;5,0;14,0;;11,0;14,0;;;17,0;;10,0;;18,0;4,0;22,0;;3,0;2,0;;2,0;;;8,0;3,0;;7,0;;4,0;19,0;6,0;;;;;11,0;;4,0;;1,0;1,0;20,0;1,0;5,0;;7,0;;36,0;6,0;1,0;;42,0;;;;;1,0;;;1,0;;;;9,0;;;6,0;;2,0;;2,0;1,0;;3,0;8,0;1,0;;2,0;8,0;2,0;1,0;;;3,0;;;;;;3,0;16,0;;3,0;;;;3,0;;1,0;6,0;4,0;;8,0;;1,0;6,0;;7,0;;3,0;;;2,0;;;1,0;2,0;8,0;;;9,0;18,0;2,0;;;;;;2,0;;;;;;33,0;1,0;;2,0;;3,0;;2,0;6,0;;;10,0;;;1,0;;;1,0;;;1,0;;;1,0;3,0;;3,0;2,0;;21,0;;;1,0;4,0;;;28,0;;;;;2,0;3,0;1,0;;;2,0;4,0;5,0;;1,0;5,0;5,0;7,0;5,0;;;4,0;;;;;;;3,0;;;5,0;;11,0;1,0;;;;;1,0;14,0;1,0;3,0;;;1,0;1,0;;;2,0;;;1,0;;10,0;;10,0;;3,0;;;2,0;;;;9,0;;;1,0;4,0;1,0;;2,0;3,0;;;;;;;1,0;;;;5,0;;;;;;;;;1,0;6,0;;2,0;;;;7,0;1,0;;;;;;;;;4,0;;13,0;3,0;;2,0;;;;;;;;;;1,0;;;;1,0;11,0;;1,0;1,0;2,0;;;3,0;;10,0;7,0;;4,0;;2,0;10,0;1,0;3,0;2,0;6,0;;;2,0;16,0;;8,0;22,0;6,0;10,0;1,0;;;;1,0;10,0;2,0;;9,0;1,0;2,0;1,0;;;;;12,0;1,0;5,0;9,0;;2,0;;1,0;6,0;1,0;;;1,0;1,0;;4,0;1,0;;1,0;;;1,0;2,0;6,0;1,0;2,0;7,0;;;;;;;;1,0;;;2,0;1,0;;;;1,0;;25,0;6,0;;;;;4,0;;1,0;;;;;35,0;;;4,0;1,0;;2,0;5,0;5,0;;;;;1,0;;;;;;3,0;;;9,0;5,0;;;2,0;3,0;;3,0;;;12,0;6,0;;;;1,0;1,0;3,0;;;;;;;;;;6,0;;3,0;2,0;;;;;;2,0;;2,0;;;;1,0;;;;;8,0;;;;2,0;3,0;;2,0;;1,0;;;1,0;;;;1,0;3,0;;;;;;3,0;;;3,0;9,0;;;3,0;1,0;;1,0;;1,0;;;4,0;;;;;6,0;;1,0;;1,0;;;1,0;8,0;4,0;;1,0;1,0;;;;;;3,0;;;1,0;
product;;;;;1,0;2,0;1,0;2,0;2,0;1,0;;;23,0;1,0;3,0;3,0;;;;;2,0;10,0;;;14,0;;;3,0;;;263,0;;20,0;;22,0;12,0;;;;;19,0;;1,0;;5,0;1,0;12,0;50,0;15,0;26,0;2,0;2,0;;2,0;;3,0;;1,0;7,0;2,0;;;8,0;;2,0;3,0;2,0;2,0;8,0;;;;9,0;2,0;;2,0;14,0;;;98,0;;5,0;2,0;62,0;;18,0;;;4,0;2,0;6,0;24,0;5,0;;;9,0;4,0;;53,0;;1,0;6,0;7,0;21,0;;;2,0;2,0;6,0;9,0;;14,0;;;;8,0;17,0;15,0;;4,0;;;2,0;11,0;9,0;276,0;;;;;;3,0;;;7,0;;2,0;1,0;;;;;;9,0;;;;1,0;7,0;1,0;;;5,0;18,0;16,0;;43,0;;1,0;;58,0;6,0;;;;;18,0;7,0;;;;;;3,0;;;;;2,0;;;11,0;1,0;1,0;;;;3,0;;;;;;1,0;;;4,0;;;9,0;;;3,0;2,0;;;2,0;;;1,0;1,0;;;2,0;13,0;;;;;;8,0;;8,0;;;1,0;4,0;;8,0;;;5,0;1,0;14,0;;1,0;1,0;;;3,0;;;;1,0;;;;9,0;3,0;4,0;;;;;;1,0;8,0;;;;;1,0;;9,0;;;1,0;;;;;2,0;2,0;;;;;1,0;;7,0;;;2,0;;;4,0;;4,0;;9,0;1,0;;;;;;;;;;;;;;;;;1,0;;;;;;;6,0;2,0;;;;;;;;;;;;;;;;;;;;;;;;1,0;;;1,0;1,0;;;;;;;;;;;;;;8,0;1,0;;;5,0;;;;;;;;;5,0;;;1,0;;;;;;1,0;;;;;;;;;;;;1,0;;2,0;;4,0;;;11,0;;;;1,0;2,0;;;;;4,0;8,0;1,0;24,0;5,0;;3,0;;;;;;1,0;15,0;;1,0;;;;4,0;;;;2,0;;2,0;4,0;3,0;1,0;4,0;;;4,0;3,0;5,0;;1,0;1,0;2,0;;2,0;;14,0;;;;3,0;2,0;2,0;;;;3,0;;;1,0;;;;;3,0;6,0;3,0;;;;10,0;;19,0;;;;;;1,0;;2,0;;;2,0;5,0;;;1,0;9,0;10,0;;;;1,0;4,0;;;;;4,0;;;;;;;;1,0;;;;;;;;;;;;;;;;;;;;3,0;23,0;4,0;;;7,0;;;;;;;4,0;;1,0;2,0;;;10,0;;;;1,0;1,0;3,0;;;;;1,0;1,0;3,0;2,0;;;;1,0;;;;5,0;;;;;;;;;;4,0;;;23,0;;;;;;27,0;1,0;;;;;1,0;2,0;;2,0;2,0;;5,0;5,0;;3,0;;;;1,0;;3,0;;;;;;;;22,0;;;;;;;5,0;1,0;;1,0;;;2,0;;;22,0;;;11,0;;;;;;;;;;;;;3,0;;;;;;;;;;;;;;1,0;;1,0;;;;;;1,0;;;;1,0;;1,0;;;;;;;;;;;;;;;;;;;3,0;;;;;;;;;;;;;;1,0;;;;;;;;;;;;;;;;8,0;;;1,0;;;5,0;;;;;;4,0;;;;;1,0;;;8,0;;;;;;;;;;;;;;;;1,0;;1,0;;;1,0;;;1,0;6,0;;;;;;3,0;;1,0;;;;;1,0;;;4,0;;3,0;;;;;;;1,0;;;;;1,0;;1,0;5,0;;;;4,0;;;;;;;;2,0;1,0;;;;;2,0;;;;;;1,0;;;;;;;;;;;1,0;1,0;;1,0;1,0;;;;;;;1,0;;;;1,0;2,0;1,0;;;;;;;;6,0;;;;;;;;;;;;;;;;;;;;;1,0;;;;1,0;;;;;;;;;;;;;1,0;;;;;;;;;;;;;;;;;;;;;;;;4,0;4,0;2,0;;;;;;;;;;;;;;;;;;;;;;;;;;1,0;;;;;;;;2,0;;;1,0;;;;;;;;;;;1,0;;;;;;;;;;;;2,0;;;;;;1,0;;;
pupil;;;;;2,0;;6,0;16,0;8,0;6,0;2,0;;;;1,0;10,0;16,0;;3,0;;;6,0;;;;;;1,0;;;;;8,0;5,0;1,0;;9,0;26,0;;;4,0;;;;17,0;19,0;5,0;1,0;4,0;2,0;3,0;61,0;;8,0;3,0;4,0;3,0;;;;;;;;5,0;4,0;29,0;8,0;5,0;1,0;;5,0;1,0;;;;;2,0;5,0;27,0;1,0;9,0;;6,0;1,0;;1,0;13,0;;3,0;39,0;;;;;;;;5,0;;;;;3,0;6,0;9,0;46,0;;4,0;;17,0;4,0;;;;10,0;4,0;16,0;;1,0;1,0;;;;1,0;;;;;;;;1,0;;;;;;;;;;;3,0;;;;1,0;1,0;;4,0;;2,0;4,0;11,0;;46,0;;;;;4,0;37,0;;;;;;;;;;;;24,0;;;3,0;;;;2,0;;;;;;;;;;;;1,0;1,0;;;;;;;;3,0;7,0;;;;;;4,0;;;;;;;;;2,0;7,0;1,0;;;;1,0;;;;23,0;;;;1,0;;;1,0;;3,0;2,0;4,0;8,0;;;5,0;1,0;;;;3,0;10,0;1,0;;;;;;3,0;4,0;;;;;;;;;2,0;;3,0;;;3,0;;;;;;;;3,0;1,0;;;;;;;;;;;2,0;;;;;;;;;;;;;;;;1,0;;;;;2,0;;3,0;;;;1,0;;;;3,0;;;;;;;;;;;;;;;;;;;;;;;;;;;;1,0;;2,0;2,0;;;;2,0;;;;;;1,0;;;;;;2,0;;;;;;;1,0;;;;;;;;;1,0;;;;;;;;;;;;;;;;;;;;;;;1,0;3,0;2,0;;;;;;;;;;;;1,0;;1,0;1,0;;;;4,0;;2,0;;;9,0;;;;1,0;;1,0;2,0;;;;;;;;;12,0;;;;;2,0;;;;;;;;;;;;;1,0;;;;1,0;;1,0;6,0;;;;;6,0;2,0;;5,0;;;;;;;;;;;5,0;3,0;;;;;2,0;;;4,0;;;;;;;;;1,0;;;;;;;;;;2,0;;;;;;;;;;;;;;5,0;;;;;;;;;;3,0;;;;;;;;;3,0;;;;;;1,0;;;;;;1,0;;;1,0;;1,0;;;;;;;6,0;;;;;1,0;;;;;;;;;;;;;;;;6,0;;;;;;;;;;;1,0;;;;;;;;;;;;;;;15,0;;;;;;;;;;;;;;;;;;;;;;1,0;;;;;;;;;;;;;;;;3,0;;;2,0;;1,0;4,0;;1,0;;;76,0;;;;;;3,0;;;;;;;;;;;;;;;2,0;1,0;;;;;;;;;;;;;;;;;;4,0;;;;;;;;;;;;;;;;;;;;;2,0;;;;;;;;;;;;;;;;;;;;;;;;;;;;;;;1,0;;;;1,0;4,0;;;3,0;;1,0;;;;;;;;;3,0;;;;;;;;;;;;1,0;;;;;1,0;;3,0;;;;;;10,0;;;;;;;;;2,0;;;;;;;;;;;1,0;2,0;;4,0;;;;;;;;;;;;;;;;;;;;;;;;;1,0;;;;;;;;;;;;;;;;;;;;2,0;;;;;;;;;;;;;;;;;;;;;;;;;;;;;;;;;;;;;;3,0;;;;;;;;;;;;1,0;;1,0;;;;;6,0;;;;;;;28,0;;;;;;;;;;;;;;;;;;;;;;;;;;;;;;;;;;;;;;;;;;;;;;;;;;;;;1,0;;;
rate;;;;;2,0;16,0;;30,0;3,0;1,0;4,0;;11,0;;1,0;113,0;;;9,0;;1,0;106,0;11,0;4,0;;;23,0;12,0;;1,0;11,0;;26,0;26,0;68,0;13,0;;5,0;6,0;;236,0;17,0;5,0;4,0;35,0;21,0;170,0;59,0;69,0;41,0;;18,0;1,0;1,0;3,0;2,0;9,0;5,0;7,0;;2,0;3,0;6,0;13,0;1,0;12,0;8,0;1,0;701,0;;3,0;;27,0;;1,0;;7,0;2,0;4,0;300,0;;22,0;;59,0;48,0;10,0;;10,0;1,0;21,0;20,0;;1,0;;1,0;3,0;26,0;;117,0;4,0;;;18,0;41,0;;;9,0;3,0;57,0;30,0;4,0;30,0;;;1,0;26,0;10,0;45,0;5,0;88,0;;;14,0;31,0;18,0;6,0;;;8,0;17,0;;17,0;;;;46,0;1,0;14,0;40,0;1,0;7,0;;;39,0;23,0;6,0;;;27,0;2,0;2,0;;5,0;14,0;21,0;1,0;58,0;;2,0;116,0;7,0;12,0;72,0;;1,0;;144,0;14,0;;;15,0;;;;25,0;2,0;;;;;;3,0;;;39,0;11,0;;23,0;;;20,0;170,0;;3,0;;;33,0;1,0;;4,0;;;5,0;12,0;;;1,0;1,0;41,0;;;;;;;;;;;;2,0;1,0;;;;;;;30,0;;3,0;;;4,0;;2,0;7,0;;;;2,0;;;;20,0;;;;47,0;3,0;;;;;;8,0;28,0;;;;;1,0;;14,0;;5,0;;;1,0;;;15,0;1,0;;;;4,0;;;;2,0;6,0;2,0;;;50,0;1,0;;;;12,0;;7,0;;;;;;;;7,0;;;;;;;1,0;;;;46,0;;;;;1,0;;;3,0;;;;;6,0;;;;;;;;;;;19,0;;;;;;;;3,0;;1,0;;;4,0;3,0;;;;2,0;;1,0;;12,0;2,0;1,0;;1,0;;;;;;;;;;;;9,0;4,0;;;;1,0;21,0;;;3,0;;;4,0;;;;;;23,0;3,0;;;67,0;;1,0;;;6,0;2,0;;7,0;;;;14,0;5,0;45,0;137,0;3,0;12,0;4,0;4,0;21,0;;;10,0;;1,0;;5,0;;7,0;3,0;16,0;;;7,0;1,0;12,0;33,0;6,0;;12,0;5,0;10,0;24,0;;19,0;45,0;16,0;;9,0;22,0;24,0;;1,0;21,0;3,0;;;7,0;;11,0;;;;;5,0;;;59,0;;;;2,0;5,0;2,0;;;32,0;5,0;6,0;;;5,0;11,0;1,0;46,0;;;5,0;;18,0;;;1,0;2,0;8,0;;1,0;4,0;;;2,0;;12,0;;2,0;;;11,0;3,0;;25,0;;9,0;1,0;2,0;12,0;2,0;;43,0;;;;9,0;;13,0;6,0;;;;11,0;3,0;;1,0;7,0;;3,0;1,0;1,0;;;15,0;;4,0;12,0;7,0;;;4,0;;4,0;10,0;2,0;;3,0;;;4,0;;;1,0;;9,0;;1,0;;2,0;;;2,0;;;88,0;;4,0;37,0;;;;;1,0;;;2,0;;7,0;;;;;6,0;;16,0;;1,0;1,0;;;;;;;4,0;;;;;;;4,0;15,0;3,0;;;;1,0;8,0;;;1,0;5,0;;3,0;102,0;3,0;4,0;1,0;;3,0;;4,0;24,0;;;3,0;;;;;;;;;;;;;1,0;3,0;;5,0;1,0;;4,0;;;;3,0;;2,0;;;2,0;;;;27,0;;;70,0;;3,0;8,0;;;2,0;;;2,0;;;;;;;;;15,0;;;2,0;1,0;;;3,0;;;;1,0;;;;;;;;2,0;3,0;;;8,0;1,0;1,0;;;;;;7,0;;;;;;;;;;;;;;11,0;;;;14,0;1,0;;;;;;;;3,0;;;1,0;;;;;;3,0;;;;;;2,0;;;;;1,0;;;;5,0;;2,0;10,0;;1,0;;;4,0;5,0;;;;;;38,0;3,0;;;4,0;;2,0;1,0;;;7,0;;;;3,0;1,0;;;4,0;;2,0;7,0;2,0;5,0;1,0;;;3,0;6,0;7,0;1,0;2,0;;;12,0;;2,0;;;;;;;9,0;4,0;4,0;;;1,0;1,0;1,0;;2,0;;;;26,0;;;;;;2,0;;;;;;;;;1,0;;15,0;;;;1,0;;3,0;;;;;1,0;;4,0;1,0;;;;;;2,0;;;;;;;;;;;;;;;3,0;;;1,0;11,0;;;;;2,0;;34,0;;;;1,0;;;;;;;;;;;;3,0;;;1,0;;;;;;3,0;;13,0;;;;10,0;;;4,0;;;;;;;;;6,0;;;;;;;1,0;;;;;;;;;10,0;;;8,0;;;;4,0;;;8,0;;;;;;;;;;;;;3,0;7,0;;;;;;26,0;6,0;;1,0;;;;;;;;;
realtime;;;;;3,0;6,0;;1,0;1,0;2,0;;;1,0;;1,0;11,0;;;;;4,0;28,0;;;;;4,0;;2,0;1,0;2,0;;7,0;;8,0;1,0;1,0;2,0;1,0;;40,0;;;8,0;1,0;1,0;11,0;16,0;11,0;46,0;;4,0;2,0;;;;;1,0;;;;;4,0;2,0;1,0;;;;18,0;;;;11,0;;;;3,0;;;108,0;;11,0;2,0;7,0;;4,0;;;;;3,0;;;;6,0;;1,0;1,0;41,0;11,0;3,0;;9,0;10,0;;;2,0;;3,0;10,0;2,0;5,0;;;;9,0;22,0;9,0;2,0;;;;;6,0;3,0;;;;;;;;1,0;;;1,0;;2,0;1,0;;9,0;;5,0;6,0;1,0;;;6,0;1,0;;1,0;2,0;1,0;2,0;;;21,0;;;;1,0;10,0;13,0;;;;22,0;51,0;;;;;;;;2,0;2,0;;;;;;;;;;;;;;1,0;;;1,0;;;;2,0;;;12,0;;;;;;;;;2,0;;;;;;;;;;;2,0;;;;;;;;2,0;;;;14,0;;;2,0;2,0;;;;4,0;1,0;;3,0;4,0;;;;24,0;;;9,0;;;;;5,0;;;;;;;1,0;;;;;;;;;1,0;;;;;1,0;;1,0;;;;6,0;;3,0;;1,0;;;8,0;;;;;;;;;;;2,0;;;;;;;;1,0;;;;;;;;;;1,0;;;;;1,0;1,0;;;;;;;;1,0;;2,0;;;;;;;;;;1,0;;;2,0;1,0;;;;;;;;6,0;;;;;1,0;;;;;;;;2,0;;;;;;;;13,0;1,0;;;;;;;;;;;;1,0;;;;1,0;;;1,0;;;;1,0;;1,0;1,0;;;;1,0;;;1,0;3,0;4,0;;3,0;2,0;2,0;;;;;10,0;;;;5,0;;;;13,0;;1,0;;;;9,0;3,0;;3,0;11,0;4,0;1,0;6,0;3,0;7,0;;3,0;;;;;;1,0;1,0;1,0;3,0;;;3,0;;4,0;1,0;;;;;;15,0;1,0;;;8,0;8,0;;3,0;3,0;;;6,0;10,0;1,0;;15,0;;;;;2,0;;7,0;2,0;;;;1,0;4,0;2,0;;1,0;;;2,0;2,0;;;;;1,0;;7,0;;;2,0;;;;7,0;;8,0;;;;;2,0;;1,0;1,0;;9,0;;;;;;4,0;;;1,0;;;;;2,0;3,0;;4,0;;1,0;;;;8,0;7,0;;;;;;;;;1,0;;1,0;;1,0;;;;2,0;;;;1,0;;;1,0;;;;;;;;;2,0;;;2,0;;;;;;;;;;;;3,0;;;1,0;1,0;;;2,0;;;;1,0;;;1,0;;2,0;;;;;;1,0;;5,0;2,0;;;;;;;2,0;1,0;;;2,0;;;1,0;;;;;2,0;;9,0;;;6,0;1,0;;;;1,0;;2,0;;;4,0;;1,0;;;;;;;;;;1,0;;;;;;;;;1,0;;;;;;;;;;;;;;;;2,0;;;;;2,0;;;2,0;;;;;;;;;;;;;;;;;;;;;1,0;;;;;;1,0;;;;;;;;;;;;;;;;;;;2,0;;;;;;;3,0;;;;;;;;;;3,0;;;;1,0;;;;;2,0;;;;;;;;;;;5,0;;;;;;;;;3,0;;;;;1,0;;1,0;1,0;;;;;;;;;;3,0;;;;2,0;;;1,0;1,0;;;;;;;;;;;1,0;;;;;;;;;1,0;;;;;;;;1,0;4,0;1,0;1,0;;;;;;;;1,0;;2,0;;;;;;;;;;;;;;;;;;;;;1,0;;;;1,0;;;;;;;2,0;3,0;;;;;;24,0;;;;;;;1,0;;;;;;;;;;;;1,0;;1,0;;1,0;;;;;2,0;;;;;;5,0;;;;;;;;;;1,0;;;;;10,0;;;;;;;;;;;;;;;;1,0;;;;;;;2,0;;;;2,0;;;;;;;;;;1,0;;;;;;;;;
rectangular;;;;;2,0;1,0;7,0;12,0;51,0;5,0;5,0;;2,0;;3,0;39,0;;;;;;20,0;;;;;;;;;1,0;;8,0;;;2,0;2,0;;;;3,0;;9,0;1,0;2,0;;10,0;41,0;2,0;28,0;4,0;1,0;;;2,0;1,0;42,0;;;;4,0;;8,0;;8,0;1,0;;8,0;44,0;2,0;;;7,0;;;1,0;11,0;;4,0;154,0;4,0;10,0;;28,0;;;;;;9,0;15,0;;;;;;6,0;;13,0;;;;15,0;12,0;;;9,0;;1,0;;1,0;11,0;6,0;;;14,0;48,0;17,0;;1,0;;6,0;17,0;1,0;11,0;;;;;4,0;;9,0;;;1,0;;2,0;;;;2,0;;;7,0;;;;38,0;4,0;5,0;;;3,0;2,0;;;20,0;;;;1,0;1,0;9,0;;9,0;;1,0;14,0;;;3,0;;;3,0;;;5,0;2,0;;;14,0;7,0;;;;1,0;;;1,0;;;;;9,0;;;1,0;1,0;;8,0;4,0;;;6,0;;15,0;1,0;;;10,0;;4,0;;;2,0;;;;11,0;16,0;6,0;;;;;;16,0;;19,0;;30,0;;;12,0;1,0;;;3,0;6,0;;;;;;;2,0;;;49,0;6,0;15,0;;;;;;17,0;;3,0;;;;7,0;;1,0;;56,0;;5,0;;;14,0;6,0;;;2,0;;1,0;1,0;19,0;;;;;1,0;5,0;;4,0;;;;2,0;;1,0;8,0;;;;;;;;;;;;;;3,0;;;16,0;;;1,0;;;;;8,0;;;;1,0;1,0;;;;9,0;;;;;;;;;1,0;;6,0;2,0;;;;4,0;;;3,0;10,0;7,0;;1,0;;7,0;1,0;4,0;6,0;;1,0;16,0;;1,0;;;;;;;1,0;;;;;;;;4,0;;4,0;;1,0;;1,0;;7,0;;5,0;;;4,0;4,0;3,0;2,0;;;;;11,0;;1,0;;;;;;;;;;1,0;;1,0;;;;1,0;;1,0;;;;;4,0;;;;;1,0;;;;4,0;;3,0;4,0;;6,0;4,0;;;1,0;;;;;;4,0;;2,0;;4,0;;;;;;;;;;1,0;;;;;;;;;3,0;;;;;;;;;;;3,0;3,0;;11,0;52,0;;5,0;;1,0;1,0;;;;;;;;4,0;5,0;;3,0;3,0;;;;;;;;;;1,0;;;;;;;;;;;3,0;1,0;1,0;;;;;;;;1,0;;;;1,0;;;;;2,0;;2,0;;;1,0;;;;;;;;1,0;;;;;;6,0;1,0;;;10,0;;;;;;5,0;;;;;3,0;;2,0;;;;1,0;;;2,0;;;;;;;;;;;;;;7,0;;12,0;;;;;;;1,0;;;;;3,0;;;;;;;;;10,0;;;14,0;;17,0;;;1,0;;;;;;;;2,0;;;;;;;2,0;;;1,0;;;;;2,0;;;3,0;;;;2,0;;;;;4,0;14,0;;;;1,0;;1,0;;;;;;;1,0;;30,0;;1,0;3,0;;1,0;;;;;;3,0;;;;4,0;1,0;;1,0;;;;;;;;1,0;;;3,0;;;;10,0;;1,0;;;13,0;;1,0;2,0;2,0;;;2,0;;;13,0;1,0;;;5,0;;;1,0;;;;;;;;;;;;;5,0;;;;;;;;;;;;;;;;;;;1,0;;;;1,0;;;;;;;;;;;;;;;;;;;;;;;;;;;4,0;;;;7,0;;;2,0;;;;;12,0;;;;;;;;;;;;;;;;;;;;;;;;3,0;;;;;;;;;2,0;;;;;;;;;;;;;;;;;;2,0;;;;;;;;;;;;;2,0;;;;;;;;;;;;;;;;;9,0;;;;;;;;;;;1,0;;23,0;;;;;2,0;;;1,0;2,0;3,0;;;;;;;;;;;;;;;;;;3,0;;;;;;;2,0;;;;;;;;;;;;3,0;;;;;3,0;;;;;6,0;4,0;;6,0;;;;;9,0;;;;;;;;51,0;;;;;;;;1,0;;;;;;;;2,0;;;1,0;;;
relationship;;;;;12,0;5,0;1,0;3,0;60,0;3,0;;3,0;3,0;;;88,0;1,0;;;;13,0;1,0;4,0;4,0;1,0;4,0;3,0;;;;1,0;5,0;18,0;;12,0;1,0;;;;;36,0;2,0;25,0;2,0;7,0;;47,0;25,0;8,0;4,0;4,0;22,0;;;10,0;;2,0;;3,0;;;;9,0;;1,0;7,0;8,0;9,0;9,0;1,0;4,0;4,0;2,0;;6,0;11,0;3,0;1,0;;76,0;;9,0;;11,0;2,0;1,0;;;2,0;7,0;23,0;;1,0;3,0;;1,0;;;34,0;;;2,0;8,0;47,0;;1,0;8,0;1,0;6,0;13,0;1,0;2,0;;;1,0;17,0;10,0;77,0;6,0;32,0;;;1,0;18,0;4,0;5,0;1,0;1,0;1,0;10,0;;10,0;34,0;;16,0;;8,0;4,0;;29,0;2,0;;;10,0;2,0;;;2,0;16,0;3,0;;;4,0;14,0;3,0;;24,0;;;;1,0;;27,0;;1,0;;5,0;7,0;;3,0;5,0;;;1,0;4,0;4,0;;;;;5,0;4,0;;;;12,0;;1,0;;;;;;2,0;;;;;;7,0;;2,0;3,0;21,0;;;;;7,0;8,0;;;;1,0;;;;;1,0;;3,0;4,0;1,0;1,0;;;1,0;;25,0;;22,0;;2,0;8,0;5,0;1,0;3,0;;;;;3,0;;;1,0;;11,0;4,0;33,0;1,0;;;;;;;4,0;;;;;;1,0;7,0;3,0;;1,0;;;2,0;7,0;2,0;4,0;;;;;;2,0;32,0;;;20,0;2,0;;29,0;;;;2,0;5,0;;1,0;;;;1,0;;;1,0;;2,0;5,0;;2,0;;2,0;;;;;7,0;2,0;11,0;;;1,0;21,0;;1,0;;;2,0;;4,0;;2,0;1,0;1,0;3,0;;;;;;7,0;;;;2,0;;;;8,0;;;;;1,0;;;;;1,0;;;;38,0;;3,0;;1,0;;;;;;;;;;;2,0;;;;1,0;4,0;;1,0;1,0;;;;1,0;2,0;;;;5,0;1,0;23,0;;;3,0;;;1,0;7,0;;1,0;;;1,0;;;;6,0;6,0;9,0;3,0;;2,0;;2,0;6,0;;;;;;1,0;1,0;5,0;;5,0;;15,0;;;;9,0;2,0;4,0;12,0;;;8,0;3,0;;6,0;;13,0;;;2,0;5,0;1,0;1,0;;;;3,0;2,0;;5,0;5,0;;;;6,0;;1,0;3,0;;;;;6,0;11,0;;;;1,0;17,0;4,0;2,0;;;;7,0;;;12,0;19,0;1,0;;;2,0;1,0;;;;;5,0;;1,0;;1,0;;2,0;;;1,0;;;;;1,0;;;;;;;;2,0;;;;1,0;;3,0;;;;;2,0;;;;8,0;;3,0;;;29,0;4,0;;4,0;;;;;;6,0;2,0;;;4,0;;4,0;;2,0;4,0;6,0;;;;;;;;1,0;2,0;;;;;;;;1,0;;;;;;;;2,0;;;1,0;;;;;1,0;;;;;;;;;1,0;;;3,0;;;;;;1,0;;;;;10,0;;;;;;5,0;;;3,0;2,0;1,0;1,0;;;13,0;;2,0;;1,0;;1,0;1,0;;;5,0;;;;;2,0;7,0;;;;;;5,0;1,0;;;;;6,0;2,0;;;;;8,0;1,0;;;4,0;;;19,0;;;;1,0;8,0;;;;;;;3,0;;1,0;;;;;;1,0;;;2,0;;;;;;6,0;;;;;4,0;;;;3,0;;;;7,0;;;;;;;;;;;;;;;;;;6,0;;;;;;;;;5,0;5,0;;1,0;;;;;2,0;;;6,0;;;;;7,0;1,0;;;;;8,0;;;;2,0;1,0;2,0;;;;;;;4,0;5,0;;;;;;3,0;;;;;;2,0;;;2,0;5,0;;;4,0;;;5,0;;;;;;;;;;;7,0;;;8,0;;1,0;2,0;;;2,0;;;;;3,0;3,0;;6,0;;;;;;;;;1,0;2,0;;;;;;;;;;;;;3,0;;;;4,0;;;;;;;;;1,0;;1,0;7,0;;;;1,0;;;;;;;;;;2,0;;1,0;;1,0;;;;;;;;18,0;;;;;;;;;;;5,0;;;;15,0;2,0;2,0;;;13,0;;;;;;;6,0;;;;108,0;;6,0;;1,0;16,0;;;;;;;;;;1,0;;;;;;;1,0;;;1,0;3,0;;;;;1,0;;;;;;;;;1,0;;;;;;;4,0;;;;;;;;;;;6,0;;;1,0;;;1,0;1,0;;;2,0;;;;;;;;;;;;;
representation;;;;;8,0;;1,0;15,0;22,0;;4,0;;2,0;;;50,0;;;;;8,0;57,0;1,0;;1,0;;78,0;6,0;;;6,0;;20,0;;19,0;;36,0;3,0;14,0;;80,0;;3,0;4,0;7,0;;25,0;96,0;87,0;76,0;;20,0;;;;22,0;3,0;3,0;7,0;;6,0;;12,0;;69,0;;3,0;8,0;10,0;;1,0;;77,0;;4,0;1,0;7,0;;;194,0;;2,0;2,0;47,0;2,0;10,0;;;;;1,0;;;;1,0;;3,0;;62,0;8,0;;8,0;5,0;83,0;;4,0;7,0;8,0;7,0;4,0;3,0;9,0;;;2,0;54,0;13,0;18,0;;1,0;;;13,0;22,0;23,0;;3,0;;;2,0;;25,0;3,0;3,0;3,0;2,0;1,0;1,0;2,0;;12,0;;3,0;5,0;;;;;14,0;6,0;5,0;;4,0;12,0;1,0;;21,0;;;3,0;6,0;1,0;13,0;;;1,0;16,0;16,0;5,0;;;;;;;2,0;;;;;;8,0;;;;8,0;;10,0;;;4,0;;;1,0;;1,0;;3,0;;;;;15,0;4,0;;;;3,0;11,0;3,0;1,0;9,0;;3,0;;;;;;;1,0;;;;;;;;7,0;;;;;1,0;;;4,0;;;8,0;;;;8,0;;;;2,0;8,0;;;;;;;;21,0;;;;;;;20,0;;;1,0;;;;;1,0;9,0;;;;;;;1,0;;;;;;18,0;;;;;17,0;1,0;;;;2,0;1,0;;;;;;;;;;;;;4,0;;;;;;6,0;;;8,0;1,0;;;;;;;;;1,0;;;;;;;;2,0;3,0;;;;;;;;;;1,0;;34,0;;;;;;;1,0;4,0;;;;9,0;;2,0;;;;;;2,0;1,0;;;;3,0;;;;;;;;2,0;;;1,0;;;;;3,0;8,0;;;;;;;;1,0;;;;7,0;;2,0;;;1,0;3,0;5,0;2,0;9,0;1,0;5,0;;;;5,0;;;2,0;;2,0;;;;12,0;;;;2,0;;;14,0;;16,0;10,0;;;1,0;8,0;1,0;;1,0;;10,0;2,0;1,0;;4,0;;;;4,0;12,0;;10,0;;;4,0;;;2,0;;;;;6,0;10,0;2,0;3,0;;5,0;40,0;2,0;;2,0;;;9,0;5,0;;31,0;7,0;;;2,0;;35,0;;3,0;8,0;;;;5,0;2,0;7,0;4,0;;;;;2,0;;1,0;;2,0;;6,0;3,0;;;2,0;;2,0;;1,0;;;1,0;;;;;;;;;;;;;3,0;;5,0;;;2,0;;;1,0;;;35,0;4,0;4,0;;9,0;2,0;;;72,0;;1,0;;;;;;;;8,0;;;1,0;;;;4,0;;;;;1,0;;;;1,0;27,0;;;1,0;;;2,0;7,0;;;8,0;;;;;;;1,0;;;3,0;2,0;1,0;;;;1,0;;;22,0;1,0;3,0;;;;;;;;;;2,0;;3,0;3,0;;17,0;;;;;;;;12,0;;2,0;;;;;;;;;3,0;1,0;;34,0;;2,0;;;;;;;1,0;;;;;2,0;;4,0;;;6,0;1,0;;;;;3,0;;;;;;;;5,0;;;;4,0;;;;;;10,0;;;;;;;;;;;;;;;;;;;;;;;;;;;;;;;;;1,0;;;;;;32,0;2,0;4,0;;;1,0;5,0;;;;1,0;;;3,0;;;1,0;;;1,0;;;;;;12,0;;;;;;;;4,0;1,0;;;;;;;;;;;;;2,0;;;2,0;;;;3,0;;4,0;;;11,0;;;;6,0;;;;;;;;;;;;;;;2,0;2,0;;26,0;;;;2,0;;;;;;;;;1,0;;1,0;;;;;;5,0;;;2,0;;;;;;;;;1,0;;;;;;1,0;;;;;;;1,0;;;;;;;;;1,0;6,0;;;6,0;1,0;16,0;;;;;;;;;;;;7,0;;;;;;;1,0;;;;;6,0;;4,0;;;;1,0;;;;;;;;2,0;;;;;;1,0;2,0;;;;;;;;;;;;;1,0;;18,0;;1,0;;;;2,0;2,0;;;;;;;3,0;;;;;12,0;;;;;;;;;;;;;;;;;;;;;;;;15,0;;;;;2,0;;;6,0;;;;;;;;4,0;;;;7,0;;;19,0;
retrieve;;;;;6,0;;;4,0;;1,0;2,0;;11,0;;;15,0;;;1,0;;10,0;11,0;3,0;;;2,0;5,0;;;;5,0;5,0;17,0;2,0;13,0;4,0;;;;;36,0;;;;1,0;4,0;3,0;18,0;6,0;1,0;;3,0;;;;;5,0;;;3,0;;1,0;2,0;4,0;;;14,0;1,0;1,0;1,0;;;6,0;;;;1,0;;;91,0;;14,0;;15,0;;8,0;;;;1,0;10,0;;;;1,0;2,0;16,0;2,0;23,0;2,0;3,0;2,0;7,0;8,0;;4,0;;;1,0;22,0;;5,0;;4,0;2,0;22,0;2,0;12,0;3,0;2,0;;;2,0;11,0;12,0;2,0;;;;1,0;;2,0;;1,0;;4,0;3,0;2,0;;;1,0;;;5,0;11,0;;;;2,0;1,0;;;16,0;22,0;5,0;;6,0;;;9,0;;;11,0;;;;2,0;2,0;;;2,0;;;;;;1,0;;;;;;;;;1,0;;5,0;;;2,0;;;;;1,0;;;;;;;;3,0;;;;;5,0;;;;;;;;;;;;;;;;;;;;9,0;;;;;2,0;;;;;;;2,0;;;;;;;;3,0;2,0;;;;;;;7,0;;;;;;;4,0;;;;;;;;1,0;;;2,0;;;;;;;;;;;;;;;;4,0;;;;;;;;;;;;;;;;;;;;;6,0;;;;;;;;3,0;;;;;1,0;;;;;;;;;;;;;;;;;;;1,0;;;;;;;;;;;;;;19,0;;;;;;;;;;1,0;;;;;;;;;;;;;;;12,0;;;;;;;;;17,0;;1,0;;;;;;;;1,0;;1,0;;;;;;1,0;1,0;21,0;1,0;;;;;;;;;;1,0;;;;;;;4,0;;7,0;;9,0;3,0;;;;24,0;;;;;;16,0;7,0;11,0;1,0;1,0;;;;;16,0;1,0;8,0;;;;;;;;;;;;;7,0;1,0;;;;;13,0;;1,0;;;;;;;;2,0;;;;;;;;11,0;14,0;2,0;;;;5,0;;;;;;1,0;;;;;;;;;2,0;1,0;;;;;;;;;4,0;;7,0;3,0;;;2,0;1,0;;22,0;4,0;;;;2,0;;;;;;;;;;5,0;;1,0;;;6,0;13,0;6,0;1,0;;;;;;2,0;;2,0;;5,0;;2,0;;;1,0;2,0;1,0;;;3,0;;;5,0;;;;;3,0;;;;;;;;;;1,0;;;;;;;5,0;;7,0;;;;;;;;;4,0;;;;;;;;;;1,0;;;2,0;;4,0;2,0;;1,0;;;;;5,0;1,0;;;;;;;;;;;16,0;;;;;;;;;;;;5,0;;;;;;;;;;;;;;;;;;;;;;;;6,0;;;;;;;;;;;;;;;;;;;;1,0;7,0;;;;;;;;;;;;;;;;;;;;;;;;;;;;2,0;;;;;;;;;;;;;;;;;;;;;;;;2,0;;;6,0;;;;;;;;;;;;;;;1,0;;;;;;1,0;3,0;;;;;;;;;;;;;;;;;;;;;;;;;;;;1,0;1,0;;;;;;;;;;;;;;;;;;1,0;;;;1,0;;;;;;;;;;;;;;9,0;;;;;;2,0;;;2,0;;;;;;;;;;;;;;;;;;;;;;;;;;;;;;;;;;;;;9,0;;;;;;;;;;;;;;;;;1,0;;;;;;;;;;;;;;;;;1,0;;;;;1,0;;;;;;;;1,0;;;;;;2,0;;1,0;;;;;;;;;;;1,0;;;;;;;;;;;;;;;;;;;2,0;;;;;;;1,0;;;;;;;;;;;;8,0;;;6,0;
rule;;;;;2,0;1,0;;3,0;;;;;12,0;;;65,0;1,0;;;;;3,0;1,0;;;;;4,0;;;;;6,0;;5,0;;2,0;1,0;2,0;;8,0;;3,0;;7,0;;19,0;5,0;1,0;1,0;;;;4,0;;;5,0;;3,0;;;;3,0;2,0;;;;;;;;;2,0;;;3,0;1,0;;;31,0;;;;35,0;;;;;;1,0;;;;;;;;5,0;16,0;;;;;10,0;;;;2,0;4,0;;;3,0;;;;1,0;;4,0;;24,0;;;;;4,0;;;;;;;10,0;;;;;5,0;;;;;15,0;;;3,0;;;;;;1,0;;6,0;12,0;;;11,0;;;;;1,0;11,0;;;;9,0;2,0;;;;;;2,0;5,0;18,0;;;;;;;;;;;;4,0;;;19,0;;;3,0;;;;;;;;;;40,0;7,0;;;;;2,0;;;;;;;;;;;;;;;;;;;1,0;;;;;;;;;;;;;;;;;;;;11,0;;;;;;;;8,0;;;;;;;1,0;;;;;;;;;;;;;;;;;;;;;;2,0;;;;;2,0;;;;;;;;;;;;;;;;;2,0;;;;;;;;;;;;;;;;;;;;;;;;;;;;4,0;;;;;;;;;1,0;;;;;;;;;;;;;;;;;;;;;;;;;;1,0;;;;;;;;;;;;4,0;;1,0;;;;;;;1,0;;;;;;;;;;;1,0;;;;;;;1,0;2,0;;;1,0;4,0;;;;;;;;1,0;6,0;;;;3,0;;1,0;;;4,0;;3,0;;1,0;;3,0;;;;2,0;;4,0;;;;;;;;;;;;;;;9,0;;;;;;;;;;5,0;;;;;3,0;;;;2,0;1,0;1,0;;;;;1,0;;2,0;;;1,0;3,0;4,0;;;;;;2,0;5,0;;;1,0;;;;;;;;;;;;1,0;;;;;;1,0;;;;;;;;;;;;;;;;2,0;;;4,0;;;;;;;;;;1,0;;;;;;;1,0;;;;;;;1,0;;;;;1,0;;;6,0;;;;;;;19,0;1,0;;;;;;;1,0;;;;;;;;;;;1,0;;;;;5,0;2,0;;8,0;;;;;;;;;;;;2,0;;;;;;7,0;2,0;;;;;;;;;;7,0;;;;;;;;;1,0;1,0;;;;;;;;;;;;;;;;;;;;;;;;;;;;;;;;;;;;;;;;;;;;;;;;;;;;;;;;;;;4,0;;;;;;;;;;;;;;;;;;;;;;;;;;;;;;;;;;;;;;;;;;;;;;;;;;;;;;;3,0;;;;;;;;;;;;;;30,0;5,0;;;;;;;3,0;;;;;;;22,0;;1,0;1,0;;;;;;;;;;;;;;;;;;;2,0;2,0;;;;;;;;;6,0;;;;;;;;20,0;;;;;;;1,0;;;;;;;;;;5,0;6,0;;;;;1,0;;;;;;;;;;;;;;;;;;;;;;;;;;;;;;;;;;4,0;;;4,0;;;;;;;;;;1,0;;;;;;;;;;;;;;;;;;;;;;;;;;;;4,0;;;;;;;;;;;;;;;;;;;;;;;;;;;;;;;;;;;;;;;1,0;;;;;;;;;;;;;;;;;;;;;;;;6,0;;;;;;;;;;;
segment;;;;;14,0;7,0;5,0;18,0;21,0;2,0;3,0;;3,0;;8,0;25,0;1,0;;;;;27,0;;;1,0;6,0;2,0;7,0;8,0;;1,0;;30,0;;10,0;;3,0;1,0;6,0;2,0;146,0;;10,0;13,0;10,0;11,0;36,0;25,0;5,0;22,0;11,0;11,0;;13,0;3,0;17,0;3,0;;23,0;;17,0;;1,0;;30,0;;;35,0;17,0;55,0;;;14,0;;;41,0;32,0;;1,0;217,0;6,0;2,0;8,0;50,0;1,0;3,0;;7,0;;27,0;8,0;;;;3,0;4,0;2,0;;71,0;;5,0;;37,0;36,0;;2,0;13,0;2,0;13,0;5,0;5,0;9,0;4,0;;4,0;82,0;19,0;18,0;6,0;20,0;;;4,0;18,0;21,0;9,0;;;;1,0;;14,0;;15,0;4,0;3,0;23,0;4,0;;;9,0;;;53,0;1,0;;;9,0;21,0;3,0;2,0;1,0;7,0;4,0;1,0;;22,0;;;;1,0;2,0;12,0;;;;106,0;16,0;12,0;;1,0;;;24,0;;11,0;;2,0;;;3,0;1,0;;;;11,0;;6,0;;;7,0;;;20,0;;28,0;3,0;;1,0;1,0;1,0;1,0;1,0;23,0;;1,0;;;;10,0;;;2,0;4,0;;;1,0;;;12,0;3,0;3,0;;;;;14,0;;15,0;;2,0;;;2,0;1,0;6,0;37,0;;3,0;1,0;8,0;2,0;1,0;3,0;;;;;14,0;13,0;;10,0;;;;;10,0;;;;;;1,0;27,0;;1,0;1,0;;;;2,0;8,0;7,0;;;;2,0;6,0;33,0;3,0;4,0;;1,0;;15,0;11,0;3,0;;;30,0;;12,0;;;3,0;;;;2,0;1,0;2,0;9,0;18,0;;4,0;3,0;1,0;5,0;;;;;;;3,0;5,0;;18,0;;24,0;;1,0;;;1,0;;5,0;;;;44,0;;;;13,0;6,0;;1,0;1,0;;;;;;;;;1,0;3,0;12,0;;10,0;;;4,0;4,0;5,0;59,0;;;;1,0;;1,0;2,0;;;1,0;1,0;4,0;;;;;;;4,0;1,0;6,0;;;;;;;;4,0;;;4,0;4,0;8,0;;;;7,0;1,0;4,0;;;4,0;;2,0;1,0;;;;;;6,0;;52,0;;;2,0;;;;;;;;6,0;3,0;8,0;;;8,0;;;;16,0;;7,0;6,0;;;;;;;10,0;;;4,0;;3,0;;7,0;;;;;3,0;3,0;17,0;1,0;;13,0;;;;;;3,0;;;;8,0;31,0;1,0;1,0;4,0;;1,0;;7,0;;;;;5,0;7,0;9,0;;;;;;3,0;;5,0;;8,0;;1,0;;1,0;9,0;;;;;13,0;1,0;;;;;12,0;;;;;4,0;;1,0;;;;2,0;;10,0;3,0;;;4,0;5,0;8,0;1,0;;;2,0;;;;;2,0;;;;18,0;6,0;;;10,0;1,0;;;1,0;;;1,0;8,0;;;;;1,0;;3,0;7,0;;42,0;12,0;8,0;4,0;2,0;;2,0;9,0;;8,0;;;2,0;8,0;1,0;;;;;3,0;1,0;2,0;;1,0;3,0;;1,0;1,0;;;5,0;;;;;7,0;;2,0;;;2,0;;6,0;;;6,0;;5,0;;1,0;;;;;;;2,0;;;;1,0;3,0;;36,0;2,0;5,0;2,0;;;4,0;9,0;5,0;;1,0;;1,0;1,0;4,0;1,0;;;2,0;;;2,0;;;;3,0;;;;2,0;;10,0;;;6,0;;;;;2,0;4,0;1,0;1,0;;;;;;;;;;3,0;;;;1,0;;;22,0;;;;4,0;;;19,0;6,0;;3,0;;21,0;3,0;;;;;;;;;;;;;;3,0;1,0;;4,0;;1,0;;;;;;;17,0;;;;;6,0;;2,0;1,0;2,0;2,0;;1,0;;;3,0;;2,0;;2,0;;;5,0;6,0;;;;;;;;;;;5,0;7,0;;;;;1,0;;4,0;2,0;;;;67,0;3,0;16,0;;;;2,0;;3,0;1,0;;;;;;;1,0;;8,0;;1,0;;2,0;1,0;;;;;2,0;2,0;1,0;;;;;;;;2,0;;1,0;;;;;2,0;;5,0;;;;;;1,0;;;;;;;2,0;1,0;;;1,0;;;;;;;;;;;;;;;4,0;4,0;2,0;11,0;;;;2,0;;;;26,0;;;6,0;2,0;1,0;;1,0;2,0;;1,0;11,0;2,0;;5,0;;;;;;1,0;;3,0;2,0;;;;;;;1,0;;;;;;;;;;;;;2,0;;1,0;;;;6,0;;;2,0;;2,0;7,0;;;;;;;2,0;;;;;;;2,0;;10,0;;;;7,0;;;;;;;;;;;;;4,0;;1,0;;1,0;;;;;;;;;;8,0;5,0;;5,0;;;;;;;;;2,0;;2,0;;6,0;;;;;;;;1,0;;;;;;;;;;;;1,0
sense;;;;;1,0;29,0;3,0;61,0;59,0;33,0;47,0;;10,0;9,0;27,0;48,0;4,0;2,0;4,0;;4,0;24,0;1,0;5,0;1,0;;6,0;2,0;1,0;2,0;7,0;5,0;97,0;;43,0;19,0;;2,0;11,0;;59,0;1,0;2,0;10,0;28,0;5,0;58,0;344,0;31,0;33,0;4,0;52,0;;2,0;11,0;;98,0;;;;1,0;;63,0;;8,0;3,0;13,0;23,0;13,0;4,0;18,0;2,0;51,0;;;25,0;1,0;3,0;11,0;671,0;9,0;30,0;;88,0;2,0;3,0;1,0;;;4,0;95,0;;2,0;2,0;;4,0;7,0;;71,0;3,0;3,0;;134,0;94,0;;3,0;86,0;4,0;37,0;;3,0;18,0;;;;119,0;24,0;105,0;17,0;12,0;;;13,0;30,0;17,0;5,0;;;8,0;9,0;;26,0;3,0;;9,0;1,0;9,0;16,0;;2,0;49,0;;;276,0;4,0;1,0;;9,0;137,0;5,0;3,0;3,0;7,0;17,0;15,0;3,0;78,0;1,0;2,0;15,0;;17,0;165,0;;2,0;;14,0;37,0;5,0;11,0;3,0;;1,0;2,0;19,0;3,0;8,0;8,0;7,0;6,0;5,0;4,0;;;17,0;303,0;;15,0;;;;;;21,0;;;;;3,0;5,0;;;1,0;25,0;1,0;;7,0;14,0;6,0;2,0;1,0;;;6,0;1,0;2,0;;;;3,0;16,0;15,0;;;;1,0;4,0;;240,0;6,0;2,0;;4,0;6,0;2,0;;28,0;10,0;;1,0;5,0;3,0;1,0;6,0;6,0;;7,0;3,0;126,0;9,0;1,0;6,0;;;;1,0;57,0;16,0;;1,0;;;;24,0;19,0;1,0;6,0;4,0;4,0;;4,0;23,0;14,0;;13,0;;;4,0;19,0;95,0;9,0;;;;;45,0;;16,0;2,0;5,0;9,0;3,0;6,0;1,0;;2,0;2,0;;1,0;;5,0;2,0;;;;1,0;1,0;3,0;;6,0;2,0;3,0;6,0;;9,0;3,0;;;;11,0;;;3,0;;;;;;;5,0;;;;;;;;;1,0;2,0;;2,0;;25,0;3,0;;1,0;10,0;7,0;3,0;;6,0;9,0;1,0;;;3,0;4,0;1,0;5,0;2,0;1,0;;;;;1,0;2,0;;9,0;6,0;;;1,0;;;;;8,0;16,0;;;;;;2,0;1,0;;;5,0;;7,0;3,0;2,0;;1,0;5,0;1,0;1,0;44,0;3,0;;;4,0;;;1,0;7,0;;6,0;34,0;1,0;9,0;;1,0;;;;;3,0;;;17,0;13,0;;1,0;2,0;10,0;;7,0;1,0;24,0;29,0;6,0;21,0;;5,0;5,0;48,0;1,0;11,0;12,0;7,0;;;12,0;28,0;4,0;21,0;4,0;;1,0;;;5,0;5,0;4,0;;;;;5,0;;13,0;;2,0;;3,0;3,0;6,0;;2,0;1,0;;19,0;4,0;;1,0;33,0;;8,0;7,0;2,0;3,0;;17,0;2,0;;;13,0;5,0;9,0;3,0;4,0;1,0;1,0;8,0;;4,0;4,0;2,0;2,0;;4,0;;;8,0;6,0;31,0;;;7,0;1,0;;5,0;;;;;;;15,0;1,0;;;;8,0;1,0;;2,0;2,0;29,0;;1,0;21,0;;7,0;15,0;2,0;;;;2,0;;;6,0;;;;12,0;;;12,0;19,0;;3,0;;;;;20,0;4,0;1,0;4,0;1,0;3,0;;10,0;;;7,0;;13,0;;3,0;2,0;;3,0;;1,0;;;;;9,0;4,0;2,0;1,0;;;;3,0;2,0;;2,0;;;;4,0;;6,0;;2,0;1,0;;4,0;4,0;4,0;;;;2,0;17,0;3,0;;;;3,0;;;3,0;3,0;;;;;32,0;6,0;5,0;;3,0;1,0;;6,0;;;6,0;1,0;;;3,0;;1,0;1,0;;;;;;10,0;1,0;2,0;;1,0;3,0;;;1,0;1,0;;;1,0;;6,0;11,0;;;2,0;;3,0;6,0;2,0;2,0;;;;;;;;;1,0;2,0;7,0;;1,0;;;;;;1,0;;;;;;9,0;14,0;;;;;;;1,0;;38,0;;;2,0;;;2,0;;;;2,0;1,0;;1,0;;;;;3,0;8,0;5,0;;;;6,0;1,0;3,0;9,0;;1,0;3,0;10,0;;;1,0;;3,0;;;2,0;4,0;1,0;;;;5,0;;2,0;1,0;;2,0;3,0;;;;3,0;;;1,0;;9,0;;;1,0;;;;;5,0;6,0;2,0;10,0;1,0;8,0;17,0;5,0;;;1,0;7,0;;;;1,0;;20,0;5,0;;2,0;1,0;;1,0;;2,0;;;;;3,0;;;;;;;;;;;;4,0;;;1,0;;;;;;;;;;2,0;16,0;;;;;;;;;;18,0;;;7,0;4,0;1,0;;;1,0;;;6,0;;1,0;;1,0;2,0;1,0;;;;2,0;;2,0;4,0;;;2,0;;;11,0;;5,0;;;18,0;;;;;;;4,0;5,0;;;;;1,0;;1,0;6,0;1,0;;;;;18,0;2,0;;16,0;;;1,0;;;7,0;3,0;;;;;3,0;12,0;;1,0;;1,0;;;;;;;1,0;;4,0;;;;;;;;;;2,0;;;;;;;1,0;;;;;;;;;1,0;3,0;;1,0;1,0;;;1,0;;;1,0;1,0;;;;;;;;;;;9,0;;2,0;;;2,0;;;;2,0;;;;;;;;2,0;;4,0;;;1,0;;
serial;;;;;1,0;;;5,0;;;;;3,0;;;9,0;;;;;;1,0;;3,0;;;8,0;;1,0;;1,0;;18,0;;31,0;1,0;;;2,0;;83,0;;1,0;2,0;6,0;1,0;;60,0;7,0;2,0;;;;;;;2,0;;;;;9,0;1,0;;1,0;;;;3,0;;;;5,0;;;;7,0;;1,0;21,0;;1,0;;28,0;;;;;;;1,0;;;;;1,0;1,0;4,0;19,0;;5,0;;17,0;13,0;;;;2,0;25,0;;;7,0;5,0;1,0;;9,0;1,0;;12,0;9,0;;;1,0;3,0;6,0;1,0;;;;;;2,0;;;;;;3,0;1,0;;;;5,0;;;;;;66,0;;;;4,0;1,0;;12,0;8,0;;;19,0;;9,0;27,0;;;1,0;6,0;1,0;;;;;;;8,0;1,0;;;;;;;;;;11,0;;5,0;;;;;;25,0;;;1,0;;;;;;;1,0;;;;;;;;;;2,0;1,0;;;;;;;;;;;;;;6,0;;;;;;;;;;;;;2,0;;;4,0;;;;;;;;;;;;50,0;;;;;;3,0;8,0;;;;;;;;2,0;1,0;;;;;;;;;1,0;;;;3,0;;1,0;;;;;;;;;;;;;;;2,0;;;;;;;;;;;;;;;9,0;;9,0;;;;;;1,0;;;;;;;;;;7,0;;;;;;;;;;6,0;;;2,0;;;;;;;;3,0;;;;;;;;;;;;;;;;;;;;;;;;;;;;;;;;;;;9,0;;;;15,0;;;;;;;1,0;3,0;;;;;;2,0;;5,0;;;2,0;;;;;;;;1,0;6,0;;;;;;;;5,0;1,0;;;1,0;6,0;;;;;;;;2,0;3,0;;1,0;;;;;;;;;3,0;;;;;;;12,0;;;;;;;1,0;;;2,0;1,0;;1,0;1,0;1,0;;5,0;;;;;;;;;;;;;;;;;;37,0;;;1,0;;1,0;;;;;;;;1,0;;3,0;2,0;3,0;;;;1,0;;;12,0;2,0;;4,0;1,0;1,0;;;;1,0;;18,0;;;1,0;;1,0;;;;;;;;;1,0;;;;;;;;;;;;;;4,0;;2,0;;9,0;4,0;33,0;;;4,0;;;;;3,0;;;;;;;;;6,0;;2,0;;;4,0;1,0;1,0;;;;;;;;;;;;4,0;;;;;;;;;;2,0;26,0;;;;6,0;;;;;;;1,0;;;;;;;;1,0;;;;;;;;;;;;;;;;;;7,0;;;;1,0;;;;;;27,0;;1,0;;;;;;;1,0;;;;;;;1,0;;;;;9,0;;;;;1,0;;;;;;;;;;;;;;;6,0;;;;;;;;;;;1,0;;;;;;;;;;;;;;1,0;;;;;;;3,0;;;;;;;;;;;;;;;;;;;;;;;;;;;;;;1,0;;;;;;;;;;;;;;;;5,0;;;;;;;;;3,0;;;;;;;;;;;;;;;;;;;;2,0;;;;;;;1,0;;1,0;;;;;;7,0;;;;;;;;;;;;;;;;;;;;;;;;;2,0;;;1,0;;;;;;;;;;;;;2,0;;;;;;;;;;;;;;;;;;3,0;;;;;;;;;;;;;;1,0;;6,0;;;;;2,0;;;;;;;;;;;;;;;;;;;;;;;;;;;;2,0;;;;;;;;;;;;;;;;;;;;;;;;;1,0;;;;;;;1,0;;;4,0;;;;;;;;;;;;;;;;3,0;;;;;;3,0;;;7,0;;;;;;;
shot;;;;;7,0;6,0;;2,0;18,0;;;;1,0;;1,0;32,0;;;1,0;;;46,0;;;2,0;;5,0;;;;6,0;27,0;6,0;;23,0;2,0;1,0;5,0;15,0;;23,0;;4,0;;13,0;2,0;34,0;33,0;26,0;37,0;;;5,0;3,0;;;;;2,0;;;;8,0;;6,0;;;10,0;20,0;;2,0;;15,0;1,0;;;2,0;;1,0;268,0;;15,0;;17,0;1,0;2,0;;2,0;;;3,0;;;;;4,0;;3,0;20,0;7,0;;;2,0;37,0;;;5,0;6,0;;1,0;2,0;17,0;1,0;4,0;1,0;42,0;4,0;9,0;;3,0;;;6,0;7,0;4,0;1,0;;;;3,0;;;2,0;2,0;7,0;3,0;5,0;;;;18,0;;;1,0;3,0;;;1,0;8,0;4,0;;;14,0;8,0;11,0;;9,0;1,0;2,0;;2,0;;18,0;;;;18,0;43,0;1,0;;3,0;;;;3,0;1,0;;;;;;;;;1,0;;;5,0;8,0;;;;;;;;2,0;;;;;;6,0;8,0;;;;;43,0;4,0;;;;;;;;;;;;;;;;;;;7,0;;;;1,0;;;1,0;12,0;;;;;1,0;;1,0;;;;3,0;8,0;2,0;;;;2,0;;;12,0;13,0;;;;;;13,0;;;;;17,0;;;2,0;6,0;;;;6,0;1,0;;;;;;;;7,0;;;;;;1,0;;;;;;;;;;;2,0;;1,0;;;1,0;;1,0;;;;;;2,0;;;;2,0;;;;;;;;;;;;;;;;;;;;;;;1,0;;;;;;;7,0;;;3,0;4,0;;;2,0;2,0;;;;1,0;;;;;;;;;;4,0;;;;;;;8,0;2,0;;;;;;;;;;;;8,0;;;;;;;;;;;;;;;;;2,0;;2,0;;2,0;;;;;4,0;7,0;;;;;;;1,0;;3,0;;1,0;;3,0;;;1,0;;;1,0;56,0;;;1,0;3,0;;;1,0;23,0;3,0;;;1,0;;;3,0;;5,0;;;;2,0;1,0;4,0;;6,0;;;;;;1,0;;;;6,0;5,0;;2,0;1,0;;;1,0;;2,0;;;;;;;;;15,0;;1,0;2,0;2,0;;;;1,0;;;;2,0;6,0;1,0;;;;;2,0;4,0;;;;;;;;;11,0;1,0;;;;;;;4,0;;;;;2,0;;;1,0;1,0;2,0;;2,0;;;;;6,0;1,0;1,0;;1,0;;;;2,0;;;;;;5,0;;;;9,0;;;;;;;3,0;;8,0;;;1,0;;;;;;;;;62,0;3,0;;;;;;;;1,0;;;;;1,0;;;;;;;9,0;;;;;;;1,0;;;;;;;2,0;1,0;;;;;;4,0;;;;;;1,0;;;;;;;;;;;;;1,0;;;17,0;;;;3,0;;;;;2,0;;;;;;;1,0;1,0;;7,0;;;;;2,0;;;;;4,0;;;;;;;;1,0;;;;;;;;;;;2,0;;;;;;6,0;;;1,0;29,0;25,0;;;;;;;;;;;;;;;;;;;;;;;;;;3,0;1,0;;;;;;4,0;;;;;;;;;;;;;;;;;;1,0;1,0;;;;;;;1,0;;;;;;;5,0;;;;;;;;;;;;;;11,0;3,0;2,0;;;;;5,0;;;;;;4,0;;;;1,0;;;;;;;5,0;;2,0;;;;;;;1,0;;;;;;;;;;;1,0;;;7,0;2,0;;;;;;;;9,0;13,0;;;3,0;;;;;;13,0;;;;1,0;;;;;;;;;;;;;8,0;;;;;;3,0;1,0;;;;;;;;;;;;;;;;;;;;;;;;;;;3,0;;;;;;;;;;;;;;;;;;;;;;;;4,0;;4,0;1,0;;;;;;;;;;;;;;;;;;;;;;;2,0;;;1,0;;;;;;;;;47,0;;;;;;;;;1,0;;4,0;;;3,0;;;;;;;3,0;;;;;;;;;;;;
spatial;;;;;1,0;8,0;3,0;10,0;18,0;2,0;5,0;;2,0;;;30,0;7,0;1,0;2,0;1,0;14,0;19,0;7,0;;;4,0;10,0;;1,0;;4,0;;4,0;7,0;4,0;;1,0;1,0;;;50,0;;5,0;2,0;2,0;7,0;51,0;13,0;8,0;5,0;3,0;25,0;5,0;;2,0;2,0;2,0;;6,0;1,0;;;8,0;;44,0;1,0;4,0;8,0;12,0;;21,0;;23,0;;3,0;2,0;3,0;5,0;96,0;115,0;;22,0;;28,0;1,0;;1,0;;;1,0;3,0;;;;8,0;2,0;;;46,0;;2,0;;3,0;32,0;;;10,0;;4,0;1,0;1,0;3,0;;;;18,0;8,0;45,0;;3,0;;;2,0;8,0;5,0;6,0;;;1,0;8,0;;4,0;7,0;1,0;4,0;108,0;12,0;18,0;11,0;;18,0;;;25,0;1,0;;;;4,0;1,0;1,0;;3,0;2,0;;;32,0;;;3,0;;5,0;8,0;;4,0;;22,0;3,0;;11,0;1,0;;;;1,0;17,0;;1,0;;1,0;;1,0;;;;1,0;;8,0;;1,0;8,0;;;2,0;;;6,0;;;1,0;;2,0;5,0;2,0;3,0;;;13,0;;;;;;;;2,0;;;2,0;11,0;;;;1,0;1,0;;;;17,0;;;;;16,0;;1,0;5,0;;;1,0;8,0;;;5,0;3,0;;;3,0;14,0;;;;;;;;1,0;;;;;;;5,0;1,0;;5,0;;;;;2,0;;;;;;4,0;;7,0;1,0;;;;;7,0;;;;;2,0;;;;;;4,0;;;;;;;;;;;2,0;;5,0;;;;;;;;1,0;;4,0;;;;1,0;;;;;;;2,0;;;;;109,0;;;;;;;2,0;1,0;1,0;;;1,0;;120,0;;;;;;1,0;;9,0;;2,0;12,0;3,0;;;;;;;;;18,0;;;;;;;;;2,0;;;;1,0;;7,0;;;;;;15,0;1,0;;;;;;;;;;;;;;;6,0;;13,0;4,0;;4,0;;;;;;;;2,0;;1,0;1,0;;5,0;;2,0;1,0;2,0;1,0;4,0;2,0;;14,0;;;22,0;4,0;2,0;4,0;3,0;;;;1,0;;;1,0;;1,0;;;;3,0;;;3,0;;;;;1,0;;;;;;2,0;1,0;4,0;;;;2,0;;;;;;7,0;5,0;7,0;1,0;16,0;1,0;;1,0;1,0;17,0;;;;1,0;;;;;3,0;4,0;;;;;9,0;;;;;;4,0;1,0;;2,0;1,0;;;;;;;1,0;;;2,0;1,0;1,0;;;;;1,0;8,0;;;;;3,0;;4,0;;;;;;9,0;1,0;;;;;;;;;9,0;;;5,0;;;;5,0;15,0;;;;;;1,0;;;1,0;;;5,0;;;10,0;;1,0;;1,0;1,0;;;;;;;;;;;;;;;7,0;;;;;;7,0;2,0;;3,0;;;;2,0;;;;;;1,0;;2,0;;;1,0;1,0;;;22,0;;;1,0;;;4,0;1,0;;;;;1,0;;8,0;10,0;;3,0;;2,0;1,0;;1,0;;;;;;;;5,0;2,0;;;;;;;;;;1,0;;;;;;;;;;;;;;;;;;1,0;;;;;;;;;;2,0;1,0;;;;;;;;;;;1,0;;;;;;;;;;;;;;;;;;;;;;4,0;;;9,0;;19,0;1,0;8,0;;;;1,0;;;;;;;;;;;;7,0;;;;;;;;;;;;;;;;;;;;2,0;;;;;;1,0;1,0;4,0;;;;;;1,0;;;19,0;;9,0;;;;;;;;;1,0;4,0;6,0;;;;;;2,0;4,0;3,0;8,0;;4,0;;;;;;2,0;5,0;;;;2,0;;;;2,0;;;7,0;;;;;;;;;;3,0;;;;;;;;;;;7,0;;;;1,0;;6,0;;;2,0;;;;;;;;;;;;;;1,0;;;;;;;12,0;;;;;;;;;;;;;;4,0;;;;6,0;;3,0;;21,0;;;;;;;;;;6,0;;;;5,0;10,0;;;;;;;;;;;9,0;;;;;;;;;;;;;;3,0;;;;;;1,0;1,0;;;;;;;;;1,0;;;3,0;2,0;2,0;1,0;;;;;;;;;;;;;3,0;;;;7,0;;;2,0;;;;;;;;;;;;;
spectral;;;;;2,0;;5,0;1,0;1,0;19,0;34,0;;;;6,0;11,0;7,0;;2,0;;1,0;9,0;;18,0;;;78,0;;;6,0;;;16,0;;;;;;;;8,0;;7,0;2,0;7,0;;11,0;10,0;12,0;3,0;2,0;;;3,0;;;10,0;;;;;2,0;;;304,0;6,0;3,0;8,0;2,0;;15,0;2,0;1,0;;;6,0;2,0;;2,0;42,0;12,0;21,0;;29,0;;;;;;;46,0;;;;4,0;;;;13,0;;;;2,0;6,0;;;59,0;5,0;11,0;6,0;29,0;2,0;;;;95,0;14,0;4,0;;1,0;;;;;5,0;;2,0;;54,0;95,0;;4,0;2,0;;10,0;16,0;13,0;163,0;2,0;;2,0;;;25,0;2,0;;;;20,0;2,0;12,0;8,0;6,0;8,0;2,0;;27,0;;;;1,0;;48,0;9,0;;;;1,0;21,0;21,0;;;;;;3,0;;;;3,0;;7,0;;;;;;20,0;5,0;;;;;1,0;2,0;;15,0;;;;;6,0;1,0;5,0;;;;8,0;1,0;;;;;;1,0;11,0;;;;;;26,0;;;;;;;103,0;;;;;;;;2,0;;;;;;1,0;4,0;1,0;;3,0;;54,0;6,0;;5,0;;;;;15,0;3,0;;;;;;10,0;;;2,0;;3,0;;;5,0;1,0;;;;;;;3,0;34,0;;;;;7,0;15,0;;;2,0;;;;;;9,0;;;;;;5,0;2,0;;;;;3,0;;;;;;;;2,0;;;;;;;;;;;;;;;;;;;;4,0;;;;;;;;2,0;9,0;;;;;1,0;;;;2,0;;;;3,0;;21,0;;;;;;;;;;1,0;;;;;;;;;1,0;;;;8,0;;1,0;2,0;;;;;;1,0;;;;26,0;4,0;11,0;;;;;;;;;3,0;;3,0;4,0;2,0;;3,0;;;;;;1,0;24,0;;;6,0;;1,0;11,0;;;;;;4,0;;;;;1,0;5,0;;1,0;;;1,0;;;2,0;2,0;;;1,0;;;;;;8,0;;;;;1,0;3,0;;;;;;;;;;;;;3,0;;;;;;;;2,0;;;;;;;1,0;;;;;1,0;;;;;;4,0;;;5,0;;;;;;;;1,0;;;;;;;;;;;;;;;;;;;;;4,0;;;;1,0;;;;;;;;;;;;;9,0;;;;2,0;;1,0;;;;;;;2,0;118,0;;2,0;;;;;;2,0;3,0;;;2,0;;;;;;;;;4,0;;;;;;;;;;;;;;2,0;;14,0;;;;2,0;5,0;;;;;;;;;;;;;;;;;;;;;29,0;1,0;;;;;;3,0;;;;;;;;;;;;;;;;;;;;;;;;;;;;;;;5,0;;;;;;;;3,0;;;;;;;;;;;;;;;;;;;;;;;;;;;;;;;;;;3,0;;;;;;;;;;;;;;;;;;;;;;;;;;;;3,0;;;;;;;;;;;;;;;;;1,0;;;;;;;1,0;;;;;;1,0;;;;;;;;;;;;;;2,0;4,0;;;;;;1,0;;;70,0;;;;;;;;;;;;;4,0;65,0;;;;;;;;;;;;;;2,0;;6,0;;;;2,0;;;;;;;;;9,0;;;;1,0;1,0;;;;2,0;;;;;;;;;;;;;;;;1,0;;1,0;;;;;;;;;;;;;1,0;;;;;;;;;;;22,0;;;3,0;;3,0;;;;42,0;;;;;;4,0;;;4,0;;;;;;;;;;;;;;;;;;;;;;;;;;;;;;14,0;;;;;;;;;;;;;;;;;1,0;3,0;;;3,0;;;;;;;;;;;;;;;;;;;;;;;1,0;;;;;;;;;;;;;;;;;;;3,0;;;;;;
stage;;;;;2,0;2,0;;8,0;;17,0;7,0;;1,0;;19,0;13,0;;1,0;;;1,0;20,0;1,0;;;;;;;;;;33,0;4,0;12,0;2,0;;2,0;;;21,0;;3,0;11,0;9,0;1,0;3,0;15,0;7,0;;8,0;4,0;;;24,0;1,0;4,0;;;;;;;1,0;3,0;;13,0;7,0;11,0;;1,0;;9,0;1,0;;1,0;;;;48,0;;14,0;;49,0;;;;1,0;2,0;;51,0;;1,0;;4,0;;1,0;;24,0;;;;3,0;5,0;;1,0;33,0;1,0;42,0;1,0;1,0;12,0;;;;35,0;28,0;28,0;;9,0;;;9,0;26,0;1,0;;;;;;;3,0;17,0;;;;3,0;7,0;;;3,0;;;20,0;8,0;;;2,0;19,0;;;;;2,0;;11,0;12,0;;21,0;57,0;;1,0;86,0;;;;;2,0;;;1,0;;3,0;1,0;11,0;3,0;40,0;4,0;;;;2,0;;;24,0;20,0;;1,0;;;2,0;5,0;;15,0;;3,0;;;2,0;4,0;;;1,0;20,0;3,0;;2,0;;5,0;2,0;;;2,0;7,0;;;;;1,0;1,0;22,0;;;;;;;;22,0;;10,0;1,0;;20,0;32,0;21,0;32,0;;2,0;1,0;;;2,0;5,0;;;;1,0;1,0;9,0;14,0;;1,0;1,0;;10,0;18,0;;;;;;6,0;3,0;;1,0;1,0;;1,0;;;1,0;;;;9,0;3,0;;6,0;19,0;4,0;;10,0;;;26,0;;;;;1,0;4,0;;3,0;;;2,0;;;;14,0;1,0;35,0;;1,0;;20,0;;;;;;;;;;;;;12,0;;;;;13,0;;;2,0;;2,0;;;;;;4,0;;30,0;1,0;2,0;;;;3,0;16,0;;1,0;11,0;5,0;2,0;;3,0;;4,0;7,0;;16,0;2,0;;1,0;1,0;;2,0;;;;;;;;;;;1,0;;;;;4,0;;;;;3,0;;7,0;;;;16,0;1,0;1,0;;;;;;;;;;;;7,0;;;3,0;;2,0;4,0;5,0;;3,0;;;;1,0;3,0;;;;;;;;;2,0;8,0;;;;26,0;11,0;;1,0;;;;;;;5,0;29,0;;;1,0;3,0;;;7,0;;;;;2,0;15,0;;;;;1,0;;1,0;2,0;;;;;5,0;5,0;;1,0;;;2,0;;1,0;2,0;6,0;;8,0;11,0;1,0;;2,0;;;;2,0;;;;;;;;;;;;3,0;;;;2,0;;;;1,0;2,0;1,0;;;;;;;;;;;;2,0;3,0;;;;;;;;1,0;2,0;;2,0;;;;;;2,0;12,0;;;;;5,0;;;1,0;;;2,0;;;3,0;;;;1,0;;2,0;;;;;;;;;;;1,0;;;;2,0;;;;;;;;;;;;1,0;;;;;;4,0;;;;;;;;;;;1,0;1,0;;;;;;1,0;;;;;;;;;;;;;;19,0;74,0;;;54,0;;;;;;;;;6,0;45,0;;1,0;;;;;;1,0;;2,0;;1,0;1,0;4,0;1,0;2,0;;;;20,0;19,0;;1,0;9,0;;;11,0;;;1,0;;;;;;;;;;;;;;;10,0;;;;2,0;;;;;;;3,0;2,0;;;;;;;3,0;;;1,0;;;;;;2,0;;;;;;;4,0;;;;;14,0;;5,0;2,0;;6,0;;;;3,0;;;;;;;;;4,0;;;;;;;;;;;;;;;;;;3,0;1,0;8,0;;;;7,0;;;;7,0;;3,0;;4,0;;;;;8,0;;;;;;;;;;;;23,0;3,0;;;;;;;1,0;;3,0;1,0;;;1,0;;1,0;;;3,0;;;;2,0;;;;;;;;;4,0;;;;6,0;;;2,0;;;;;;3,0;1,0;;;;;;;;4,0;;;2,0;;;2,0;;;;;;;;;;;;;12,0;;;;;;;;;;;;;2,0;58,0;;;;;1,0;;;;;;2,0;;;;;;;;;;;;4,0;;4,0;;;;;;;;;;1,0;;;2,0;2,0;;;;8,0;1,0;;;;5,0;;;;;;;;2,0;;;;;;;;;;;;;;;10,0;;;;;;;;;;;;1,0;;;;1,0;;7,0;;;;;;;;;;;;;;;;;;;;;;;;;;;;;;;
standard;;;;;1,0;1,0;;4,0;;;3,0;;5,0;;;4,0;2,0;2,0;2,0;;2,0;8,0;;;;3,0;12,0;;1,0;;;;6,0;;2,0;2,0;;3,0;;;7,0;;;;1,0;;8,0;9,0;15,0;3,0;2,0;1,0;;;;9,0;7,0;;;1,0;3,0;1,0;1,0;;2,0;1,0;1,0;6,0;10,0;2,0;3,0;;14,0;6,0;;10,0;;;1,0;91,0;;6,0;1,0;18,0;;;;;;;4,0;;2,0;;3,0;1,0;2,0;;27,0;;;;1,0;1,0;2,0;5,0;6,0;;8,0;11,0;1,0;1,0;;;;;1,0;;5,0;;;;1,0;9,0;4,0;;;;;;;14,0;;;;7,0;;;3,0;;2,0;1,0;3,0;1,0;1,0;;;2,0;18,0;4,0;;;3,0;2,0;;;6,0;;;;;1,0;15,0;;;;39,0;1,0;;;1,0;;;;1,0;;1,0;;;;4,0;1,0;;;;2,0;;4,0;;;;3,0;1,0;2,0;;;26,0;;;;;;2,0;;;;;;;;;;;;;;;;;3,0;1,0;;;;1,0;;2,0;;;;2,0;;1,0;11,0;;;;1,0;8,0;;2,0;;;1,0;;;;2,0;15,0;1,0;;;;;;;3,0;;;;;;1,0;6,0;;;;;1,0;;;;1,0;1,0;;;;1,0;;1,0;;;;;;2,0;;;;;;;;;;;1,0;;;;;1,0;2,0;;;1,0;;;;;;;;;;;;2,0;;2,0;;;4,0;;;;;;;;1,0;;;;1,0;5,0;;;;;;;;11,0;;1,0;1,0;;;8,0;;;1,0;;;;2,0;3,0;;1,0;;1,0;;;;;3,0;;;2,0;;;;;;;;;1,0;;1,0;;;;;;1,0;;6,0;3,0;;;8,0;;;2,0;;;;;;;;;;;;;;10,0;;6,0;7,0;;1,0;;;;1,0;;;5,0;;;;;;2,0;;;;;8,0;;;;;;4,0;;;9,0;2,0;;;4,0;4,0;;;;;;;4,0;10,0;2,0;;;;;1,0;;;1,0;;;;;1,0;;;;;;1,0;;7,0;;6,0;;1,0;;;1,0;1,0;;;;3,0;;;;14,0;;3,0;;;;5,0;;;;5,0;;4,0;;;;;1,0;;1,0;;6,0;1,0;;;;2,0;;;;1,0;1,0;4,0;;2,0;;;;;;1,0;4,0;;;;;;;;;;;;3,0;4,0;;;;1,0;;2,0;;;1,0;;3,0;;;1,0;;;;;;;5,0;5,0;;1,0;;;;;2,0;;;;;;;;;12,0;1,0;;;1,0;;;;;;;;;;;;;;1,0;;;;;;;;;;;;1,0;;;;34,0;;;;;;;;7,0;;;;;;;;;;;;2,0;;;;;;;;;3,0;;;;15,0;;;;2,0;;;;;1,0;3,0;;1,0;;;1,0;1,0;;;;;1,0;;;;;;;;;;;;;;;;;1,0;;;;;;;;;;1,0;;;1,0;;;2,0;;1,0;;;;;;;;;;;;;;;;;1,0;;;;;;;;;;;1,0;;;;;;;;;;;;;1,0;;;;;;;;;2,0;3,0;;;;;;;;;;;;;;5,0;4,0;;;;;;;;;;;;;;;1,0;;1,0;;;;;;;;1,0;4,0;5,0;3,0;;;;;1,0;;;;;;;1,0;;;;;;;;1,0;;;;;;;;;;;;1,0;;;;;;;2,0;1,0;;;;;;;;;;;7,0;;;;;;;;;;;;;;;;;;;1,0;;;;;;;1,0;1,0;;;;8,0;;;;;;;1,0;;;;;;2,0;;3,0;;;;1,0;;;;;;;;;;;;;;2,0;;;;;;;;;;;;;;;;1,0;;;;;;;;;;;;;;;;;;;;;;;;;;;;;;;;;;;;;;;;;;;;;;;28,0;1,0;;;;;;;;;;;;;;;;;;;
stereo;;;;;4,0;18,0;;61,0;5,0;2,0;10,0;;51,0;2,0;4,0;31,0;;;;18,0;58,0;10,0;;1,0;;;9,0;1,0;;1,0;5,0;2,0;11,0;;42,0;3,0;6,0;7,0;;;5,0;1,0;4,0;9,0;21,0;7,0;41,0;26,0;2,0;21,0;5,0;42,0;1,0;1,0;;21,0;2,0;1,0;1,0;;;;2,0;;;13,0;11,0;3,0;33,0;2,0;2,0;;32,0;;;;2,0;;;389,0;;32,0;;32,0;;2,0;;;;2,0;18,0;;;;10,0;3,0;4,0;;64,0;1,0;18,0;;33,0;57,0;;;7,0;1,0;10,0;59,0;;21,0;;2,0;;10,0;;13,0;;2,0;;;;10,0;1,0;2,0;2,0;1,0;;1,0;;2,0;9,0;1,0;4,0;2,0;1,0;;;1,0;2,0;;;17,0;9,0;;;;2,0;;5,0;;2,0;1,0;3,0;1,0;59,0;;;;;3,0;24,0;;;;1,0;7,0;1,0;;7,0;;;4,0;8,0;1,0;;;;;;4,0;;;;;;1,0;1,0;;;;;;;1,0;;;;1,0;;;1,0;5,0;;;;;;;3,0;;1,0;;;;;;1,0;1,0;;;;;;;;;3,0;;;;;7,0;2,0;5,0;8,0;;;;;;;;;;;3,0;62,0;;3,0;;;;;;12,0;;;;;;;29,0;;;;;1,0;;;;1,0;;;;;4,0;;2,0;;;;;;14,0;;2,0;;;2,0;3,0;;;;;;;;;;;;;;;;;;;;1,0;;;;;;;;6,0;;;;;1,0;;;;;;;;;;;;;;;;;;;9,0;1,0;;;;2,0;14,0;;;;;;1,0;6,0;16,0;;;2,0;5,0;;1,0;;;;;;;3,0;;;;;;;;;2,0;;;;;;4,0;;;;;;6,0;1,0;1,0;;;;;;;;;;1,0;;;;;3,0;8,0;5,0;;;;2,0;3,0;2,0;;;;;2,0;3,0;4,0;;;;23,0;;;1,0;7,0;;;2,0;;6,0;3,0;15,0;;9,0;1,0;5,0;;;2,0;2,0;3,0;;;;2,0;;22,0;;23,0;;;2,0;;1,0;;;7,0;;;;;;;;;;9,0;3,0;2,0;;;;;9,0;3,0;1,0;;4,0;;;1,0;1,0;9,0;;;;;;;;;3,0;;7,0;;;9,0;;;1,0;;;2,0;4,0;;;;1,0;;;;;;;;;1,0;;;;;;7,0;;;;;;;;;;3,0;;;;1,0;;;;;;;;;2,0;;;2,0;;;;;;1,0;;2,0;;;1,0;1,0;;;;;;;;;;;8,0;;;;;;;;;;;;;;;1,0;;5,0;;;11,0;;3,0;;;;;4,0;;;;;;2,0;;;;;;;;2,0;;;;;;;3,0;;;;;;;3,0;;;;1,0;;1,0;;;;;;;;;;;;;;;;;;8,0;;;;;1,0;;;;;;;4,0;1,0;;;;;;;1,0;;;;;;;;;;;;;;2,0;;;;;3,0;;;1,0;;;;;;;1,0;;;;;;;;;;;;;;;;;;;1,0;;;;;;;;;;;2,0;;;;;;;;;;;;;;;;;;;;;;;;;;;;;2,0;;4,0;;;;;1,0;5,0;;;1,0;;3,0;4,0;;1,0;;;;2,0;;;24,0;;;4,0;;;;;;;;;;;1,0;1,0;5,0;3,0;;;;;3,0;;;;;;;;;;16,0;;;5,0;;;;;;;;;;;2,0;;;;;;;2,0;11,0;;;;;;;;;;;;;;;;1,0;;;;;;;;;;;;;;;;;;;;1,0;;;;;;;;1,0;3,0;;;;;;;;;;;;;4,0;;1,0;;3,0;;;;;;;;;;;;7,0;;1,0;2,0;;1,0;;;1,0;;;;;;;;;;1,0;;;;;;;;;;;;;;;1,0;;;;;;;;;;;;;;;;1,0;;;;;;;11,0;;;2,0;;;;1,0;;;1,0;;;1,0;6,0;;;;;7,0;;;;;;;;
stitch;;;;;1,0;;;1,0;1,0;;12,0;;;;;7,0;;;;;;15,0;;;;;;;;;1,0;;12,0;;6,0;;3,0;4,0;2,0;;13,0;;1,0;5,0;;;;4,0;1,0;6,0;;;;;1,0;4,0;;1,0;;;;;;;;;;3,0;5,0;;;;4,0;;;;;;1,0;96,0;;2,0;;;;;;;;;9,0;;;;;;1,0;;12,0;;;;1,0;1,0;;;;;;;;5,0;;;;13,0;1,0;;;;;;;4,0;10,0;;;;;;;;;;;;;;;;5,0;;;9,0;;4,0;;;;;;;;1,0;1,0;;9,0;;;;;1,0;10,0;;;;12,0;1,0;;;;;;1,0;;;;;;;6,0;;;;;1,0;;;;;;;;;;;;;;;;;;;;;;;;;;;;;;;;;;;;;;;;;;;;;;;1,0;;;1,0;1,0;;;;1,0;;;;;;;;1,0;1,0;;;;;;;;;;;;;;1,0;;;;;;;;1,0;;;;;;;;;;;;;;;1,0;;;;;;;;;;;;;;;;;;;;;;;;;;1,0;;;1,0;;;;;;;;;;;1,0;;;;;;;;;;1,0;;;;;;;2,0;;;;;;;;;;;;;2,0;;1,0;;3,0;;;;;;;;;;;;;;;;;;;;;;1,0;;;;;;;;;;;;;;;;;;;;;;;;;;;;;;;3,0;1,0;;;;;;;;;;;;;;;;;;;1,0;1,0;;;;1,0;;;;;;;;1,0;;;;;;;;;;1,0;;;;2,0;;;;1,0;;;;;;1,0;;;;2,0;;;;;;1,0;;;;;;;;;;;;;;;;;;;;;;;;;;;;;;;;;;;;;;;;;;;;;;;;;;;;;;;;;2,0;;;;;;;;4,0;;;;;;;1,0;;;;;;;;;;;4,0;;;;;;;;;;;;1,0;;;;;;;;;;;;;;;;;;;;;;;;;;;;;;2,0;;;;;;;10,0;;;;;;;;;;;;;;2,0;1,0;;;;;;;;;;;1,0;;1,0;;;;;;;;;;;;;;;;;;;;;;;;;1,0;;;;;;;;;;;;;;;;;;;;;;;;;;;;;;;;;;;;;;;;;;;;;;;;2,0;;;;;;;;;;;;;;;;;;;;;;;;;;;;;;;;;;;;;;;;;;;;;;;;;;;;;;;;;;;1,0;;;;;;;;;;;;;;;;;3,0;;;;;;;;;;;;;;;;;;;;;;;;;;;;;;;;;;1,0;;;;;;;;1,0;;;;;;;;;;;;;1,0;;;;;;;;;;;;1,0;;2,0;;;3,0;;;;;;;;;;;;;;;;;;;;;;;;;;;;;;;;;;;;;;;1,0;;;;3,0;;;;;;;;;11,0;;;;;2,0;;;;;2,0;;;;;;;;;;;;;;;;;;;;;;;;;;;;;;;;;;;;;;;;;1,0;;1,0;;;;;;;;;;;11,0;;;;;;;;;;;;;;;;;;;;;;
stream;;;;;24,0;1,0;;16,0;5,0;3,0;1,0;;13,0;1,0;;50,0;;;;1,0;;54,0;;3,0;;;;;2,0;;10,0;9,0;30,0;;54,0;6,0;3,0;2,0;2,0;;333,0;;1,0;;19,0;2,0;20,0;97,0;65,0;44,0;;;;;2,0;;4,0;2,0;;;;2,0;2,0;10,0;5,0;;2,0;6,0;77,0;1,0;3,0;;71,0;3,0;;4,0;44,0;;;413,0;4,0;2,0;1,0;47,0;;4,0;;;;;5,0;;;;10,0;17,0;11,0;13,0;88,0;11,0;;2,0;14,0;14,0;5,0;4,0;2,0;5,0;75,0;18,0;3,0;10,0;;;;68,0;32,0;7,0;1,0;5,0;;;14,0;28,0;25,0;2,0;;;9,0;7,0;;7,0;;;10,0;27,0;12,0;7,0;6,0;2,0;10,0;;12,0;29,0;5,0;;;;35,0;;;;27,0;21,0;14,0;;66,0;;2,0;6,0;8,0;49,0;17,0;;1,0;;549,0;18,0;2,0;;;;;;1,0;1,0;;;;;;;;;;4,0;;2,0;1,0;;18,0;5,0;;3,0;;;19,0;;;;;3,0;1,0;;;;;;1,0;2,0;;;1,0;;1,0;;;;;;;;;;;;8,0;;6,0;;;;2,0;;;3,0;;;;;;;;7,0;;;;;9,0;;3,0;1,0;;;;;89,0;;;;;;;31,0;;;;;;;;19,0;2,0;;2,0;;;;;4,0;4,0;;;;;20,0;3,0;;;;;;;;;;;;;;1,0;2,0;2,0;;;;;12,0;;2,0;;;;;2,0;8,0;;;;5,0;;;;;;;;;;;;;;;;3,0;;;3,0;;;;;;;;4,0;;;;;;1,0;;;;2,0;15,0;3,0;12,0;3,0;;;;;;;;;;;;;2,0;;;;;1,0;;;;4,0;;;4,0;;;;;;6,0;;;;6,0;;;1,0;;;1,0;3,0;3,0;;;4,0;;1,0;24,0;;5,0;2,0;22,0;4,0;3,0;;8,0;1,0;;;4,0;1,0;;;1,0;;;;;;60,0;28,0;1,0;35,0;;;2,0;2,0;;8,0;12,0;9,0;;23,0;2,0;3,0;;;25,0;;;;;43,0;34,0;16,0;;;;5,0;;;;;;;;;;;;2,0;4,0;13,0;1,0;;;;;7,0;2,0;2,0;;1,0;;13,0;3,0;;1,0;;;10,0;8,0;;;;;9,0;;;;2,0;1,0;1,0;;;;2,0;1,0;1,0;13,0;;2,0;;;;6,0;2,0;1,0;5,0;;;;;;36,0;1,0;;2,0;34,0;;32,0;1,0;2,0;;9,0;;;;56,0;;;;7,0;42,0;;6,0;;9,0;2,0;;;3,0;;;;;;;;;1,0;2,0;3,0;2,0;3,0;7,0;1,0;;11,0;;5,0;;4,0;3,0;;;;;;;;;;;;3,0;2,0;4,0;1,0;;2,0;;;;1,0;8,0;;;1,0;3,0;14,0;10,0;;10,0;3,0;;1,0;13,0;;;;9,0;1,0;;;;12,0;3,0;;2,0;;3,0;;2,0;8,0;2,0;;1,0;;;1,0;9,0;18,0;1,0;;3,0;3,0;;2,0;2,0;4,0;3,0;2,0;4,0;;;4,0;1,0;;6,0;;;;1,0;;;;;;1,0;;1,0;2,0;;;;;;;;;2,0;;;;;;;;;1,0;;;;;;;;;;;;1,0;;;1,0;;;1,0;;1,0;;;;;;;;;;;;;5,0;;;;;;;;;1,0;;;;;5,0;;28,0;;1,0;;;;;;;;;;1,0;;;;;;;;;;;;;;;41,0;;;;;9,0;;;;;;2,0;;;5,0;8,0;;4,0;;;1,0;1,0;;;;;;2,0;;;;5,0;;1,0;;;;;;7,0;;;24,0;;;1,0;1,0;;1,0;;;1,0;;;;20,0;;;;;;;16,0;;;3,0;;;2,0;;2,0;;;;;1,0;;;;;;3,0;;2,0;;2,0;;;;;;;7,0;;197,0;;2,0;;1,0;;1,0;;1,0;;;6,0;;2,0;;1,0;;;;;;;;;;;;;;;;4,0;;;;1,0;;;;4,0;;;;;;1,0;;;7,0;;;;;;;;5,0;;;;;;;;;;;;;;;1,0;;1,0;;;;;4,0;;3,0;;;;;;;;;;;;1,0;;1,0;;;;;;;;;;;1,0;;;;;;;;;2,0;2,0;;;;;8,0;;;;;5,0;;1,0;;;;;;;;;;;;;;;;;;;;
subset;;;;;6,0;3,0;14,0;4,0;8,0;34,0;24,0;;5,0;;;28,0;4,0;3,0;;;10,0;55,0;2,0;;;;;3,0;;;1,0;9,0;29,0;;5,0;2,0;;;1,0;;30,0;;5,0;;;;36,0;15,0;81,0;8,0;;2,0;;;1,0;;9,0;;;2,0;;;1,0;;100,0;1,0;5,0;3,0;36,0;;;1,0;24,0;;;2,0;50,0;1,0;;443,0;;18,0;1,0;69,0;;3,0;;;;8,0;1,0;;;;;5,0;4,0;;69,0;;;;5,0;12,0;;2,0;1,0;2,0;9,0;59,0;5,0;7,0;;;;82,0;84,0;23,0;;8,0;;;5,0;8,0;17,0;6,0;;;7,0;5,0;;;;2,0;4,0;32,0;8,0;51,0;18,0;;22,0;;4,0;20,0;13,0;3,0;;2,0;13,0;;;;3,0;32,0;;;20,0;;;;5,0;;4,0;;;;20,0;6,0;;4,0;3,0;;;5,0;;2,0;8,0;;;;4,0;;;;;1,0;;;;;5,0;1,0;;6,0;;;2,0;;;;;;;20,0;1,0;;;;3,0;1,0;;6,0;;;;;;;;;;;;;;;;;47,0;;;;;;;;;;1,0;;2,0;;;1,0;;;;;123,0;11,0;;1,0;;;;;9,0;;;;;;;64,0;;;;;;;;4,0;4,0;;1,0;;;;;6,0;;;;;;9,0;;8,0;1,0;2,0;;17,0;;1,0;;;1,0;;;;;5,0;;;;;;;;;;;;;;25,0;;;;3,0;;;;;;;;;;;;;;;;1,0;;;;;;;;;4,0;;;;;5,0;;;;;;;;25,0;2,0;28,0;8,0;2,0;;;;;;;;;;;;;;;7,0;;;;;;1,0;;;8,0;;;;;;19,0;3,0;;;;;;;;;;;2,0;;;;;;3,0;3,0;8,0;17,0;;4,0;;3,0;;;1,0;;3,0;;;;2,0;;18,0;1,0;;;3,0;3,0;;6,0;;17,0;2,0;;;4,0;4,0;3,0;;;;5,0;;1,0;3,0;;;;;11,0;11,0;;1,0;;2,0;1,0;;;;;;;;1,0;9,0;;;;;11,0;;1,0;;;;;4,0;3,0;1,0;9,0;;;4,0;;;;;;1,0;;;;;2,0;;;;;;2,0;;;;;9,0;;;;;4,0;;;;;;;4,0;;;;;;;6,0;7,0;;;5,0;23,0;;;2,0;;3,0;;;;;;;2,0;;;;4,0;;;7,0;14,0;3,0;;;;;;;;7,0;7,0;;;;2,0;;54,0;10,0;1,0;4,0;;;;;;;;1,0;;3,0;;4,0;;;7,0;;;;;;;;;;;;;1,0;;1,0;;2,0;;3,0;;;;;51,0;;;;;;1,0;;;;;;;1,0;;8,0;;;;;;;87,0;;;;;;;1,0;;4,0;3,0;;;;;;;;;;;;;;;;;;;;2,0;;;;1,0;;;;;;;;;;;;;;;1,0;;;19,0;;11,0;;;;;;;;;;;;;;;3,0;;;;;;;;;;;;;;1,0;;;;;;;;;1,0;;;;;;1,0;;;3,0;;;;;;;;1,0;;;;2,0;;;;;;;;;;;;4,0;;;;;;1,0;;;;;;;;;12,0;;;;;1,0;;3,0;2,0;;6,0;;2,0;;;;7,0;;;;;;;;;;;6,0;;;;;1,0;;;;;;1,0;;12,0;;;;;;;;;;;;;;;;;;2,0;5,0;;;;;;;;;1,0;;;;;;;;;;;;;;;;;21,0;;;;;;4,0;1,0;6,0;;;;;;;;33,0;;;;;;;;;;7,0;;;;;;;;;;;;3,0;1,0;2,0;;;;2,0;;;;;;;;;;;;;;1,0;;;;;;1,0;1,0;;;;;;;;;;;;;;;;;;;;;;;;;;;;;;9,0;;;;;;9,0;;;;42,0;;1,0;;;;;;;;;7,0;;;;;;;1,0;;;;;;;;3,0;;;;;;;;;;
successive;;;;;2,0;;;;5,0;;;;;;;7,0;;;1,0;;2,0;36,0;;;1,0;;6,0;;;;;3,0;4,0;;;;;;;;24,0;;1,0;7,0;6,0;;8,0;20,0;25,0;15,0;;7,0;;5,0;1,0;6,0;2,0;;3,0;;;;;;;2,0;;4,0;75,0;;7,0;;6,0;;;20,0;10,0;;;160,0;;23,0;;18,0;2,0;1,0;;1,0;;;;;;;;;2,0;;14,0;;;;;8,0;;4,0;;1,0;6,0;;4,0;;;;5,0;14,0;1,0;12,0;;7,0;;;6,0;5,0;10,0;;;;;;;8,0;;;2,0;3,0;2,0;2,0;;;;;;15,0;2,0;;;;9,0;1,0;;;3,0;1,0;1,0;;3,0;;1,0;1,0;1,0;;7,0;5,0;;;24,0;3,0;;;;;;2,0;3,0;;;;;;1,0;;;;;1,0;;;7,0;;;;;;;;2,0;;;;;;2,0;4,0;;;;;10,0;;4,0;;;;;;;;1,0;;;;;;;;;;4,0;;;;;;;;7,0;1,0;;;3,0;;;4,0;3,0;;;;6,0;2,0;;;;2,0;;;4,0;;;;;;;14,0;;;;2,0;6,0;;;;;;;;9,0;;;2,0;;;;;;12,0;;;;;2,0;;;;;;;;;;;;;;;;;7,0;;;;3,0;;;;;;;;;;;;;;;;;;;;;;;;;2,0;;;;;;3,0;;;;;;;;;;;;;;;22,0;;;;2,0;;;;;;;;;;3,0;;;;;;;;;;;5,0;;;;;;;;;4,0;;;;;;;;3,0;;;;;;;;;;1,0;2,0;5,0;2,0;;;;;;;;;;;;;;;21,0;;;;1,0;3,0;;15,0;;15,0;;14,0;;;11,0;;;;;2,0;1,0;;1,0;;;;;;2,0;;;;;;;;2,0;;;;;9,0;25,0;1,0;;;2,0;1,0;;;;;;;;;;;;;;;;;;;;;;;;;1,0;;;;;15,0;;;;;;;2,0;;;2,0;2,0;;;;;;;;;;;;;;;;;;;;;7,0;1,0;;;;;;;;;2,0;;;;;;;;3,0;;;;;2,0;;;;;;;;;;;;;;;;;;;;;;;;;8,0;;;;;;;;;;;;;;;;;;;;;6,0;;;3,0;;;;;;;;;;;;;;;;;;11,0;;;;;;;;;;;;;;;;3,0;2,0;;;;;;;;;1,0;;;;;;;;;;;;;;;;;;;;;;;;;;;3,0;2,0;;12,0;;;;;;;;;;;;;;;;;;;;;;;;25,0;14,0;;;;;;;;;;;;;;;;;;;;;;;;1,0;;;;;;2,0;;;;;;4,0;;;;;2,0;;;;;;;1,0;;;;;;;;2,0;2,0;;3,0;2,0;;;;;3,0;1,0;;;;;;;;;;;;4,0;;;4,0;19,0;47,0;;;;;;;;;4,0;3,0;;;;;;;;;;;;;;;;;;4,0;;;;1,0;;2,0;;;1,0;;;;;;;6,0;;;;;;;;;1,0;;;;;;;;;;;;;;;;;;;;;;;;;1,0;;;;;;;;;;;;;;;;;;;1,0;;;;;;;;;;;;;;;;1,0;;;;;;;;;;;;;;;;;;;;;;1,0;;;1,0;;;;;;;;;;;;;;;1,0;;;;;;;;;;;;;;;;;;;;;3,0;;;;;;;;;;;;;;;1,0;;;;;;;;;;;;;;;;;;;;
surveillance;;;;;1,0;4,0;2,0;36,0;160,0;4,0;;;;;4,0;20,0;1,0;;1,0;2,0;2,0;40,0;;2,0;;;8,0;2,0;;;5,0;1,0;19,0;;28,0;4,0;;1,0;;;46,0;;2,0;;13,0;7,0;22,0;38,0;20,0;17,0;6,0;1,0;;3,0;;;3,0;;;;2,0;1,0;17,0;;10,0;;;1,0;4,0;7,0;2,0;;18,0;1,0;1,0;1,0;12,0;5,0;1,0;92,0;;16,0;;37,0;;;;;;;17,0;1,0;1,0;2,0;;2,0;8,0;;50,0;4,0;6,0;;3,0;45,0;;1,0;18,0;1,0;17,0;1,0;;6,0;;2,0;;41,0;17,0;37,0;18,0;7,0;;;5,0;6,0;5,0;1,0;2,0;;6,0;;;11,0;4,0;2,0;8,0;1,0;5,0;8,0;;;10,0;11,0;1,0;11,0;9,0;;;6,0;5,0;2,0;2,0;;22,0;26,0;;2,0;217,0;;2,0;1,0;1,0;8,0;44,0;;;;192,0;28,0;;;11,0;;;1,0;2,0;2,0;3,0;;;;;2,0;;;1,0;3,0;;1,0;;;;;;27,0;;1,0;1,0;;;11,0;1,0;;;13,0;;;2,0;2,0;;2,0;1,0;;;1,0;;;;;;5,0;37,0;;1,0;;;;;2,0;27,0;;6,0;;6,0;10,0;1,0;2,0;;;;2,0;;13,0;1,0;;1,0;;;;;3,0;;;;;;1,0;7,0;5,0;;;;;;21,0;;;;;;;1,0;2,0;3,0;;;;1,0;2,0;1,0;2,0;2,0;;37,0;;;12,0;2,0;1,0;;1,0;18,0;;;;3,0;;;;2,0;;1,0;3,0;;;2,0;;;4,0;2,0;2,0;;3,0;1,0;;1,0;;3,0;;;3,0;;1,0;;;;;;;4,0;;;5,0;;;;3,0;1,0;;1,0;;;;;1,0;;;;;;;;;;;;1,0;3,0;2,0;1,0;8,0;;;;;;;;1,0;5,0;;7,0;;;;;;3,0;1,0;6,0;3,0;;;;;;;;;;4,0;2,0;24,0;;;;2,0;;1,0;6,0;1,0;;;2,0;5,0;1,0;2,0;;;;3,0;;;;;3,0;1,0;1,0;2,0;2,0;;;1,0;3,0;;;6,0;;;;3,0;;2,0;2,0;1,0;6,0;;1,0;;8,0;;13,0;1,0;4,0;;42,0;6,0;4,0;;5,0;;;;;;1,0;15,0;2,0;3,0;;;1,0;;2,0;1,0;;;;1,0;2,0;24,0;;;;;9,0;1,0;1,0;2,0;;1,0;8,0;2,0;;6,0;6,0;;;;;1,0;;11,0;12,0;;;;;6,0;22,0;;7,0;;1,0;3,0;;;1,0;1,0;;;;5,0;5,0;;4,0;2,0;;;;;;2,0;;;;;;2,0;;1,0;;;14,0;4,0;;4,0;;4,0;;;1,0;;1,0;;;;;7,0;1,0;11,0;;;10,0;8,0;;24,0;;2,0;;;;;1,0;1,0;1,0;;;5,0;;;;1,0;1,0;4,0;;2,0;7,0;3,0;;;;8,0;;6,0;;;;;;;11,0;;;;3,0;9,0;1,0;1,0;;;14,0;;;;8,0;17,0;;;;;;4,0;;3,0;1,0;1,0;;;;;;;;2,0;;1,0;14,0;;2,0;;;;;1,0;3,0;;1,0;;;;;;;;;3,0;;;;;;2,0;;;;;1,0;;;1,0;;;1,0;;;;;3,0;;;;5,0;;;2,0;;;;2,0;;;4,0;2,0;;;;;1,0;;;1,0;;;;;6,0;3,0;;;;;;3,0;;;;7,0;;;;;;;;;;3,0;;;;;2,0;;7,0;;;;;;;;;;;9,0;1,0;;5,0;;;;;;2,0;;;;;;;;;;;;1,0;33,0;;;;;;;2,0;;19,0;1,0;;;1,0;;;5,0;8,0;;;;2,0;1,0;4,0;;;;;;3,0;;;;6,0;;;;;;;;;;;;;1,0;1,0;;1,0;3,0;;;8,0;;;;;;;;;;;;;;1,0;;;;;;;;;1,0;1,0;;;2,0;;;;;;;1,0;;;;1,0;;;;;;;;;;;6,0;;;;;;;;;;;;;;;;1,0;;;2,0;;4,0;;2,0;;;;;;;;;;4,0;;;1,0;;;;;;1,0;;;;;;;;;;;;;;;6,0;;;;1,0;;;6,0;2,0;;;;;;;1,0;;;;1,0;;;;;;2,0;;;;;;;;1,0;;;3,0;;;;;;;;;;;3,0;;;;3,0;1,0;;;;;;1,0;;;;;;10,0;;;;;1,0;10,0;;;;3,0;;;;;;;;;;
synchronize;;;;;1,0;;4,0;4,0;1,0;;4,0;;;;;10,0;;;;1,0;;15,0;;;;;5,0;;;;;;18,0;;19,0;17,0;;;4,0;;18,0;;2,0;1,0;3,0;2,0;;63,0;2,0;4,0;;;;;6,0;;5,0;;;;;4,0;6,0;2,0;;;9,0;;9,0;;16,0;;43,0;;;11,0;2,0;;6,0;48,0;2,0;25,0;;21,0;;1,0;16,0;;;;26,0;;;;;;1,0;6,0;26,0;1,0;;;7,0;1,0;;5,0;3,0;3,0;22,0;3,0;;11,0;;;;16,0;;5,0;1,0;;;;9,0;4,0;7,0;;;;2,0;;;9,0;2,0;;1,0;;5,0;3,0;;;;;22,0;22,0;2,0;;;;160,0;;1,0;;3,0;5,0;;;21,0;;;2,0;1,0;1,0;34,0;;;;31,0;;1,0;;;;;1,0;2,0;;;;;;;21,0;;;;3,0;;4,0;;;1,0;;;1,0;;;;;;;;;;;;;1,0;;11,0;2,0;;;;;;;;;;;;;;;;;;;19,0;;1,0;;;;;1,0;4,0;3,0;;;;;;;17,0;;;;3,0;;;;;;;6,0;38,0;;;;;;;5,0;;;;;9,0;;;6,0;;;;;3,0;;;;1,0;31,0;;;;33,0;;;;;;19,0;2,0;;;;;;;;1,0;1,0;3,0;;;;;1,0;;;;;4,0;;;5,0;;;;;;;;;1,0;;;;;;;;;;;9,0;;;;;;;;;;;;;6,0;1,0;;;4,0;;;;;1,0;;;;1,0;;;;;;;;;;;;;;;;;;;;;;;;12,0;;;;;;3,0;;;;1,0;;;;;;;2,0;1,0;;;;1,0;;;;;2,0;;1,0;;5,0;;;6,0;;;3,0;;;;;;;;;;2,0;;;;3,0;;6,0;;;7,0;3,0;;2,0;1,0;6,0;;;1,0;1,0;;;;3,0;3,0;15,0;;;;1,0;;;;;;;;;;;;1,0;1,0;1,0;;;;;;;1,0;;;;1,0;;;;;;1,0;2,0;2,0;;1,0;;;;;;;;;1,0;;;;;;;1,0;;;3,0;2,0;;;;;;1,0;;2,0;;;5,0;;;;;;;3,0;;;6,0;;;;;;;;;2,0;;;;;;;3,0;1,0;;;;;;;;;;;;15,0;;16,0;;;;;;;;3,0;;;;;;1,0;;15,0;10,0;;;3,0;;;2,0;;;;1,0;;;;;;;;3,0;;;2,0;;;;;;;3,0;;;;;;;;7,0;;;;2,0;;2,0;12,0;;2,0;;;1,0;2,0;1,0;;;;;;;;;;;;;;;;;4,0;;;;;6,0;;;;;38,0;;;1,0;;;;;;1,0;;4,0;;;;;;;;;;;;;1,0;;;;;;;;;;;;;;;;;;;;;;1,0;;;;;;;;;;;;;;3,0;;;3,0;;;;;;;4,0;;;;;;;;;;;;6,0;;;;;;;;;;;;;;;;;;;;;3,0;;;4,0;;;1,0;1,0;2,0;;;;;;;;;;1,0;;;;3,0;;;2,0;;;;;;;;;;3,0;;;;;;;;;;;;;;;;;;;;;;;;;4,0;;;1,0;;;1,0;;;;;2,0;;;;;;;;;;;1,0;3,0;;18,0;;;;;12,0;;;;1,0;;;;;;2,0;;;;;;;;;;;;;;1,0;;;;;;;;;3,0;;;;3,0;;;;;;;;;;;;;;;;;;;;;;;2,0;;;;;;;;;;;;;5,0;;;1,0;;;;6,0;;;;;;;;;;;;3,0;;;;;;;;;;;;;;17,0;;;;;;2,0;;;;;;;;;;;;;;;1,0;;;;;;;;;;;;;;;;;;
synthesize;;;;;1,0;2,0;;10,0;;1,0;;;;;;7,0;;;;;;;;;;;20,0;;;;1,0;;28,0;4,0;5,0;1,0;2,0;2,0;;;7,0;;1,0;;1,0;2,0;;3,0;7,0;5,0;;;;;;;2,0;;9,0;;;2,0;;;2,0;;;4,0;1,0;;;;39,0;;;;;;;200,0;;3,0;;21,0;5,0;;;;;;2,0;;;;2,0;1,0;1,0;;9,0;;2,0;;;5,0;;;;;51,0;5,0;;8,0;;;;18,0;1,0;7,0;;2,0;;;1,0;21,0;4,0;1,0;;;;4,0;;;;;;9,0;;;;;;;;;9,0;1,0;;;30,0;;;;;5,0;3,0;;11,0;;;2,0;;;32,0;;;;82,0;6,0;;;;;;6,0;;2,0;;;;;;3,0;;;;3,0;;7,0;;;;;;;;;;;;;;;1,0;2,0;;;;;7,0;1,0;;;;;;;;;;;;;;;;;;;;;;;;;;;;;;;;;;;1,0;;3,0;;8,0;;;;;;;;10,0;;;;;;;3,0;;;;;;;;;;;;;;;;;;;;;;4,0;;;;;9,0;;;;;;;;;;;;;;;;;;;2,0;;;;;;;;;;;;;;;1,0;;;;;;;;;;;;;2,0;;;;;1,0;;;;;2,0;;;;;;3,0;;;2,0;;;;;;;;;;;;;;;;;;;;;;;;;;;;;;;;;;;;;;;;;;;;;;;;;;;;;1,0;;1,0;;;1,0;;;;;;;;;;;7,0;;2,0;;;;30,0;16,0;;;;1,0;1,0;3,0;;;1,0;2,0;;1,0;;;;2,0;2,0;2,0;1,0;;;4,0;5,0;;;;;;;;;;;;2,0;1,0;;11,0;9,0;;;;1,0;;;;;4,0;;;;;;;;;;;3,0;2,0;;;;;;;;;;;8,0;1,0;;1,0;;1,0;;;;;;7,0;;;;;;;;;;;;;;;;;;;;;;;;;1,0;;;;;;10,0;;;;;;;;;;1,0;;;;;;;;2,0;;;;;;;;;;;;5,0;;;;;;;;;;;;;;;;;;;;;;;;;;;;;;1,0;;;;;;;;;;;;;;;;;;;;;4,0;;;3,0;;;;;;;;;;;;;;;;;;;6,0;;;;;;;;;;;;;;;;3,0;;;;;;;;;;;;;;;;;;;;;;;;;;;;;;;;;;;;;;;;;;;;;;;;;;;;;;;;;;;;;;;1,0;;2,0;;;;;;;;;;;;;;4,0;;;;;;7,0;;;;;;;1,0;;;;10,0;;;13,0;;;;6,0;;;;;10,0;;;;;;;;;;;;;;;;;26,0;;;;;1,0;;;;;;1,0;2,0;;;;;;;79,0;;;;;;;1,0;;;;;;;;;1,0;;;;;;;;;;;;;;;;;;;;;;;;;;;;;;2,0;;;;;;;;;;;;4,0;;;;;2,0;;;;;;;;;;;;;;;;;;;;;;;;;;;;;;;;;;;;;;;;;;;;;;;;;;;;;;;;;;;;;;;10,0;;;;;;;;;;;;1,0;;;;;;;;;;;;;;;;;;;;;;;1,0;;;;;;;;;;;2,0;;;7,0;;;;;;;;;;;;;;;;
technique;;;;;3,0;6,0;;3,0;1,0;;9,0;;1,0;;;7,0;;;;2,0;20,0;8,0;;;;;1,0;1,0;;3,0;2,0;2,0;6,0;;1,0;;;1,0;1,0;;8,0;;;10,0;6,0;1,0;17,0;15,0;10,0;3,0;;4,0;;;;;;1,0;1,0;;6,0;;;;5,0;;8,0;;14,0;;2,0;;24,0;;;6,0;4,0;;;74,0;;7,0;8,0;12,0;2,0;1,0;;;;;2,0;2,0;1,0;1,0;3,0;1,0;1,0;;30,0;1,0;;1,0;3,0;22,0;;;3,0;1,0;11,0;1,0;1,0;11,0;;;;13,0;6,0;5,0;1,0;;;;1,0;49,0;;3,0;;;;1,0;;2,0;;1,0;;1,0;;;1,0;;6,0;;3,0;5,0;;1,0;;;1,0;;2,0;1,0;;;;;15,0;;;1,0;1,0;;1,0;;;;11,0;;;;;;;;;30,0;1,0;;;;;;;1,0;;4,0;;1,0;;;;11,0;;;;;;;;;;;;;;;;;1,0;3,0;;;;;2,0;;;;;;;;;;;;;;2,0;2,0;;;;;;;;;;;;;;2,0;1,0;;;;11,0;4,0;;;1,0;;;;2,0;;;;;;;13,0;;;;;;;;;2,0;;;;;;1,0;6,0;2,0;;;2,0;;2,0;;;;;;;;4,0;;;;;;;;4,0;;;;;;3,0;;;;;;;;1,0;;;;2,0;;;;;;;;;;;;;;1,0;;;1,0;;;;;;;;;;;;12,0;6,0;;;;;;;;16,0;1,0;;;;;;;;;;;1,0;;;;;;;;;;;;;;;;;;;;;;8,0;2,0;;2,0;;;;;;;;;;;;;;;2,0;5,0;2,0;;;2,0;;;1,0;1,0;;;;;;1,0;3,0;;1,0;;;;3,0;4,0;2,0;3,0;;;;4,0;1,0;4,0;5,0;3,0;1,0;1,0;1,0;3,0;;;;;;;;2,0;1,0;;36,0;;1,0;18,0;;;;;;;;;11,0;;;;;5,0;7,0;1,0;;;1,0;4,0;;;1,0;1,0;;;;14,0;1,0;;;;3,0;;;;;1,0;;1,0;;;;3,0;;1,0;;1,0;;;;;;2,0;;1,0;;;;1,0;;1,0;;;;;;1,0;;;;;;;;;;;;;;;;;;;;;3,0;;;;;;3,0;;1,0;;;1,0;;;;;2,0;;;1,0;;;;;;;1,0;;;;1,0;;;1,0;;1,0;;;;;;;;;;;;;;1,0;;1,0;;2,0;;;10,0;1,0;;;;;;;;;;;1,0;;1,0;;;;7,0;1,0;;1,0;;;2,0;;;;1,0;;1,0;;;;;1,0;;;;2,0;;2,0;;1,0;;;3,0;;;;;;;;;;;;7,0;1,0;1,0;;;;;;;;;;;;;;;;;2,0;;;;;1,0;;;;1,0;;;;;;;1,0;;;;;4,0;;;;3,0;;;;;;1,0;;;;;;;;;1,0;;;1,0;;;;;;;1,0;;;;;;;;1,0;;;;;2,0;;;3,0;;;;;;;;1,0;;1,0;;;;;2,0;;3,0;;;;;;;;1,0;;1,0;;;1,0;;;;;;;;;1,0;;1,0;;7,0;;;;;;;;;1,0;;;2,0;;;;;;7,0;;7,0;;;;7,0;;;1,0;;;;;;;;;1,0;;;;;;1,0;;;;;;;;;;1,0;;;;;;;;;2,0;1,0;;;2,0;2,0;;;;2,0;;;;;;;;;;;;;;2,0;;2,0;;1,0;;;;;;;;3,0;;;;1,0;;;;;;;;;;2,0;;;1,0;;;;;;;1,0;;;;;1,0;2,0;;;;;;;;;;;;;;;2,0;;;;;;;;;;;;2,0;;;;;;;;;;1,0;;1,0;1,0;;;;2,0;;;;;;;;;;;;;;;;;1,0;;1,0;6,0;;;;;;;;;;;;;;;;;;
television;;;;;1,0;;;12,0;;;;;9,0;;;11,0;;;;;;5,0;;1,0;;;1,0;7,0;;;2,0;;8,0;;51,0;12,0;;;;;2,0;;;;12,0;2,0;5,0;35,0;9,0;44,0;;;;;2,0;;;;;;;;2,0;;;;;;;;;;3,0;1,0;;;;;;38,0;;3,0;;;1,0;;;;;;2,0;12,0;;;;;1,0;;25,0;2,0;22,0;;1,0;2,0;;;5,0;2,0;95,0;;;;;;;1,0;;;4,0;;;;;;20,0;44,0;;;;;;;;;;8,0;;5,0;;;;;5,0;;;;;;34,0;;3,0;;;6,0;3,0;1,0;40,0;;;;;3,0;;;;;21,0;;;;;;;;;;;;;;;;;;;9,0;;;;;;;;4,0;;;15,0;;;;;;3,0;;;;1,0;;;;1,0;;;;;;;;;;;;;;;;1,0;;1,0;;;;;;;;;;;;;;;;2,0;;;1,0;;;;;;;;;42,0;;;;;;;19,0;;;;;;;;1,0;;;;;;;;;;;;;;;;;;;;;;;;;;;;;;;;;;;;;;;;;;;8,0;;;;;;;;;;;;;;;;;;;;;;;;;;;;;;1,0;;;;;;;;;;;;;;;;;;;;;;;;;;;;;2,0;;;;;;;;;;;;;;;;;;;;;;4,0;;;;;;;;;;;;;;;2,0;6,0;;;;;;;;;;;;1,0;;;;;;;;3,0;6,0;;;;;;;;3,0;2,0;;;3,0;;;;;2,0;;;;;8,0;;42,0;;;;;;7,0;;;;;;;;;;;;6,0;;;;;;7,0;1,0;;;;;1,0;;;;;;;;;;;;7,0;;;;;4,0;1,0;;2,0;;;;;6,0;;;2,0;;;;;;;;;;;;;1,0;;;;;;9,0;;;;;;;;;;;;1,0;;2,0;;8,0;4,0;;;;2,0;;;;;;;;;;;12,0;;;;;12,0;;;;;;;;;;;;;;;;;;;;10,0;;;;;;;;;;1,0;;1,0;4,0;;;;;;;;;;;7,0;;;1,0;;;;;;;;;1,0;;;;;;;;;2,0;;;;;;;1,0;;;;4,0;;;;;2,0;;;;;;;;;;;;;;;;;;;2,0;;;;;;;;;;;;1,0;;;;;;;;;;;;2,0;;;;2,0;;;;10,0;;;;;;;;;;;;;;;;;;;;;;;;;1,0;;;;;;;;;;;;;6,0;;;;;;;;;;;;;;;;;;;;;;;1,0;;;;;;;;;;;;;;;3,0;;;;;;;;4,0;;;;;;;;;;;;;;;5,0;;;;;;;;;;;;;;;;;;;;;;;;;;;;;;;;;;2,0;;;;;;;;;;;;;;;;38,0;;;;;;;;3,0;;;;4,0;;;;;;;;;;;;;;;1,0;;;;;;;;1,0;;;;;;;;;;;;;;;;;;;;;;;;;;;;;;;;;;;;;;;;;;;;;;;;;;;;;3,0;;;;;;;;;;;;;;;;;;;;;;;;;;;;;;;;;;;;;;;;;;;;;;;;;;;;;;;;;;;4,0;
text;;;;;8,0;1,0;;3,0;21,0;;;;30,0;1,0;;13,0;;;1,0;;;10,0;;;3,0;;1,0;;;2,0;10,0;;4,0;1,0;3,0;;;1,0;6,0;;57,0;;;;21,0;7,0;33,0;27,0;3,0;23,0;;;;4,0;;;6,0;;;1,0;;;;16,0;;;;10,0;9,0;;4,0;;27,0;;;1,0;15,0;5,0;1,0;82,0;;;2,0;35,0;;2,0;;;;;2,0;;;;;3,0;1,0;;45,0;7,0;;;4,0;3,0;;;1,0;1,0;25,0;;;23,0;;;;9,0;3,0;2,0;;3,0;;;8,0;7,0;4,0;;;;;1,0;;;;;1,0;;2,0;11,0;;;20,0;;;2,0;;;;;1,0;;;;3,0;33,0;;;9,0;;;2,0;5,0;2,0;7,0;;;;8,0;4,0;;;1,0;;;1,0;4,0;;;;;;;2,0;;;;;;1,0;;;;;;1,0;;2,0;16,0;;;;;;;;;;;;;;;;;;;;;;;;1,0;;;;;;4,0;;3,0;;;;;;;;;;;;;;;;;;;;;;;;1,0;;;;5,0;;;;;;;17,0;;;;;;;2,0;;;;;;1,0;1,0;;;;;;;;1,0;;1,0;;;;;;;;;5,0;;;;;;;;;1,0;;18,0;;;;1,0;;;;6,0;;;;;;;;;;;;;4,0;1,0;;;;;;;;2,0;;;4,0;;;3,0;;2,0;;;;3,0;;;;;;;;;3,0;;2,0;;;;;;;;;;;;;1,0;;;;;;;;;2,0;;;;;;;;2,0;20,0;3,0;4,0;;1,0;;;;;;;2,0;7,0;;;;;1,0;1,0;;8,0;18,0;;10,0;;;;;;;1,0;;1,0;;;;;;1,0;;22,0;;;6,0;;4,0;;;;;;;;1,0;;6,0;2,0;6,0;;;;;;;1,0;;5,0;;;;;;;;;;;;;;;;4,0;6,0;;2,0;;;;;;5,0;;;;28,0;;1,0;;;1,0;;;;10,0;;;2,0;;;1,0;2,0;6,0;;;;;;;;6,0;;;2,0;;;;6,0;;;;;;;3,0;12,0;;44,0;;;2,0;1,0;1,0;;;;1,0;1,0;;1,0;;;;;4,0;;;;6,0;;;;2,0;2,0;;;;;;2,0;;1,0;4,0;;2,0;11,0;5,0;;;14,0;2,0;1,0;;3,0;10,0;;;;1,0;;;;;2,0;1,0;;;;;;;;;;;1,0;;;;5,0;;3,0;25,0;;2,0;;;;;;4,0;;;;;;;2,0;3,0;;;;16,0;49,0;;47,0;;;;;;1,0;1,0;12,0;;;;;;1,0;3,0;;;;;;;1,0;2,0;;;;;;;;;;;;;;2,0;2,0;;;;;;;;;;;;;;;;;;;;;1,0;;;;;;3,0;;;;;;;1,0;;;;;;;;;;;;;;8,0;;;;;;;;;;;;;;;;1,0;;;;;;;;;;;2,0;;;;;;;;;;;;;;;;;;;47,0;;;;;;1,0;2,0;;;;;;;;37,0;;;;;;;;;;;;1,0;1,0;;;3,0;;;;;;;;;1,0;;;;;;;;;;;;3,0;;;;;;;;;;;;;;;;;;;;;;;;;;;;;;;2,0;7,0;;;;;1,0;;;;;;;;;;;;;;;;;;;3,0;;;;1,0;;;;;;5,0;;;;;;;;;2,0;;;1,0;;;;;;;;;;;;;;;;;;;;;;;;;;;;;;;;;;;;;;;1,0;;;;;;;;;;;;20,0;;;;;;;3,0;;;;;;;2,0;;;;;;;;;;;1,0;;;;;;;;;;;;;;;;4,0;;;;;;;;;;4,0;;;;;;;;;
thermal;;;;;1,0;10,0;;1,0;62,0;7,0;7,0;;7,0;;3,0;18,0;7,0;;3,0;12,0;14,0;83,0;3,0;2,0;33,0;10,0;17,0;;;;;1,0;25,0;3,0;14,0;4,0;10,0;2,0;3,0;;84,0;;3,0;5,0;31,0;27,0;25,0;40,0;3,0;74,0;16,0;15,0;;;;3,0;15,0;;1,0;;4,0;1,0;8,0;;2,0;8,0;2,0;20,0;18,0;2,0;6,0;;13,0;;1,0;4,0;2,0;;1,0;389,0;1,0;265,0;;20,0;;4,0;2,0;;;;9,0;;;15,0;9,0;;8,0;;70,0;;;1,0;4,0;41,0;;5,0;11,0;4,0;16,0;3,0;;1,0;;;;6,0;2,0;28,0;13,0;9,0;;;8,0;16,0;10,0;1,0;;;50,0;7,0;;11,0;4,0;;5,0;3,0;;;;;41,0;5,0;1,0;20,0;8,0;;;1,0;10,0;5,0;;3,0;3,0;8,0;10,0;3,0;60,0;;;2,0;4,0;2,0;25,0;;;;2,0;12,0;;13,0;;;1,0;;2,0;1,0;1,0;;;;2,0;4,0;1,0;3,0;;2,0;;4,0;;;;1,0;;8,0;;4,0;24,0;3,0;;2,0;;2,0;1,0;17,0;;;;29,0;;;;;;;;;;15,0;;1,0;23,0;7,0;3,0;;;1,0;3,0;;18,0;;9,0;6,0;;25,0;;;1,0;;;;;;;20,0;8,0;;;11,0;7,0;8,0;5,0;;;;;;21,0;4,0;;;;2,0;;7,0;;;2,0;4,0;7,0;;2,0;8,0;1,0;;12,0;;;17,0;5,0;17,0;4,0;;;;;17,0;10,0;;;;;;;;;;5,0;;;;2,0;2,0;;;;;;;;1,0;;1,0;2,0;;1,0;1,0;;1,0;1,0;7,0;;;5,0;;;;;;;;;;;;;;4,0;;;;;;;4,0;;1,0;;;;2,0;;;;;;3,0;;15,0;3,0;;;;;;;;;1,0;;;;;;;;;;;4,0;;;;1,0;;3,0;;;;;3,0;;26,0;;;;6,0;;;1,0;2,0;;;;;;;;2,0;3,0;18,0;11,0;5,0;3,0;;;2,0;;;;;;2,0;33,0;1,0;;1,0;6,0;3,0;9,0;;;;4,0;2,0;;;;14,0;12,0;;4,0;12,0;1,0;;;4,0;7,0;;13,0;2,0;1,0;;;;4,0;14,0;;;;;12,0;4,0;;;;;;;14,0;;;;;1,0;13,0;;1,0;;;;6,0;;;;14,0;;;;;1,0;;2,0;;3,0;;;2,0;;;5,0;;;;;;;;;6,0;6,0;17,0;;3,0;;;2,0;6,0;;;2,0;5,0;;;;;;;;;2,0;;2,0;;7,0;2,0;;5,0;;;5,0;;1,0;;;;3,0;1,0;;;;;;;1,0;;5,0;;1,0;;;;4,0;;5,0;2,0;;;6,0;;;3,0;;;;;;;1,0;;;1,0;;;;;2,0;;;;;1,0;;;;;;;;;;3,0;;;;;;;;;;;1,0;;;;;;;;;;;;1,0;;;8,0;15,0;;;;;;4,0;;;;2,0;;1,0;;;10,0;3,0;;;1,0;;;;;;;;;;;1,0;;;;3,0;;2,0;;1,0;;5,0;;2,0;;1,0;;;;;;;1,0;;;;1,0;;;;;2,0;;;;;;;;;;;;;;;;;;;;;;;;;1,0;;;;;;;;;;;;;;17,0;;;2,0;;;;;1,0;;;;;;14,0;;;;;;;1,0;;;;;;;;2,0;3,0;;;;;;;;1,0;;;;31,0;;;;4,0;8,0;;;;;1,0;2,0;;;;;;;;;10,0;6,0;;;4,0;;;;;;;;2,0;;;;;;;;;;;4,0;;2,0;;1,0;3,0;;;;;;;;6,0;;;;;;;15,0;;;1,0;;;;;;;;;;;;;;;;3,0;;;;;;;;1,0;;;;1,0;;;;;;1,0;;11,0;;;;;;;;8,0;;;;;;1,0;2,0;1,0;;;;;7,0;1,0;6,0;1,0;;;1,0;53,0;;1,0;2,0;;;2,0;;;;;;;2,0;;3,0;;;2,0;;;6,0;;;;;;;;;;;;;;;3,0;;;;;1,0;;;;;2,0;;;;;;;;;;1,0;;;2,0;;;;;;;;;;;;;;1,0;;1,0;;;;;;;;;;2,0;;;;;;;;;;;;;;;;
touch;;;;;1,0;10,0;1,0;30,0;46,0;3,0;;;12,0;;;10,0;2,0;;;7,0;12,0;14,0;1,0;8,0;1,0;1,0;1,0;;;1,0;6,0;;44,0;;40,0;8,0;1,0;1,0;7,0;;23,0;4,0;6,0;;75,0;6,0;26,0;75,0;33,0;203,0;19,0;;4,0;1,0;3,0;2,0;14,0;2,0;;;3,0;2,0;6,0;;2,0;;24,0;22,0;6,0;13,0;22,0;;15,0;;10,0;1,0;4,0;;3,0;188,0;2,0;28,0;1,0;58,0;;10,0;1,0;;;;21,0;;6,0;4,0;;5,0;14,0;1,0;60,0;1,0;11,0;;49,0;46,0;;7,0;56,0;1,0;2,0;3,0;9,0;11,0;2,0;;;27,0;64,0;55,0;;15,0;;;6,0;14,0;21,0;1,0;1,0;;;10,0;;10,0;6,0;;7,0;1,0;1,0;35,0;;;5,0;;;45,0;2,0;;;3,0;53,0;1,0;6,0;;2,0;5,0;;6,0;67,0;;1,0;3,0;;10,0;16,0;;;;1,0;13,0;5,0;2,0;11,0;1,0;;7,0;;;3,0;3,0;;;9,0;18,0;;;1,0;6,0;;2,0;;;;;;7,0;;13,0;3,0;1,0;;14,0;;;;17,0;;;1,0;;;4,0;5,0;1,0;;;1,0;;1,0;;1,0;;;;3,0;;;;7,0;;23,0;;3,0;;5,0;23,0;1,0;8,0;;;6,0;;3,0;185,0;2,0;4,0;;;;4,0;12,0;9,0;2,0;;;;;;82,0;2,0;5,0;;;;;15,0;;;4,0;2,0;19,0;;3,0;3,0;;;;;4,0;1,0;;98,0;3,0;1,0;2,0;;;22,0;;;;1,0;;5,0;;;;;;;4,0;4,0;1,0;2,0;;;;;;2,0;2,0;;;8,0;;;;7,0;;5,0;;4,0;;1,0;;;9,0;;;;;3,0;;;;10,0;;3,0;3,0;1,0;8,0;3,0;;2,0;;1,0;;;5,0;;1,0;18,0;8,0;1,0;;4,0;4,0;;;23,0;5,0;;;1,0;;;3,0;;;1,0;;;;4,0;;;;;4,0;;3,0;;;;;;3,0;;4,0;;;3,0;2,0;10,0;;;;1,0;;1,0;5,0;4,0;;;1,0;;;;;;;;4,0;;;;;1,0;;;;;;;3,0;5,0;;5,0;;3,0;2,0;;;108,0;2,0;3,0;54,0;;;2,0;27,0;;14,0;3,0;10,0;2,0;6,0;1,0;14,0;;;2,0;6,0;;;;;5,0;1,0;;;;16,0;128,0;;;;;;;;3,0;;;;3,0;74,0;1,0;;;1,0;2,0;8,0;1,0;;1,0;4,0;;5,0;;;1,0;;1,0;3,0;;;;1,0;1,0;70,0;;2,0;7,0;7,0;1,0;8,0;;;;;;;367,0;;6,0;;;;;6,0;1,0;;3,0;;7,0;4,0;;;1,0;2,0;2,0;;;;4,0;;;10,0;1,0;8,0;;;;;;17,0;4,0;;1,0;;10,0;1,0;;;2,0;;;;;10,0;37,0;;1,0;;;;11,0;;12,0;;;6,0;;1,0;;;7,0;;;;;;;;;7,0;;;23,0;;1,0;;;;;;;4,0;1,0;;;5,0;;;;;8,0;2,0;;;;;;;;3,0;;;4,0;;3,0;;1,0;;3,0;12,0;;52,0;;4,0;;;;;;;1,0;;;;;;;1,0;;1,0;;;1,0;21,0;7,0;1,0;3,0;2,0;;;;;;;;;;;;2,0;2,0;;1,0;;;;;;1,0;;;;;3,0;;;8,0;;;;6,0;;;;;;1,0;;;;;1,0;;9,0;;;;1,0;;;;;2,0;1,0;;;;;5,0;;;;;;;;1,0;;;;;;;;;;;12,0;1,0;3,0;;;;1,0;;;1,0;;;;;;;;;2,0;;;;;;8,0;2,0;4,0;;2,0;;;;1,0;1,0;;;3,0;;2,0;3,0;;3,0;2,0;;;;;;;;;;;2,0;;;;1,0;;;;;;;;;3,0;;1,0;1,0;1,0;;;;2,0;;11,0;;;;;;;;;;;;4,0;;2,0;;;;;;;;;3,0;;;;;7,0;;;;;;;;;;;;;;;;;;;55,0;;;4,0;;;;1,0;48,0;;;;;;;;;;;;;11,0;;;;2,0;;;;;;;;4,0;;;8,0;;;1,0;;;;;;3,0;;;;;;;;;;;;1,0;;;;;1,0;;4,0;;;;;;;;;;;;;;3,0;;;;;;;;;;;2,0;;;;;;;;;4,0;3,0;;4,0;;;;;;;;11,0;;;;;;;;;;;;;;;;;;;;;1,0;;;;;;;2,0;;;;;;;
track;;;;;12,0;3,0;2,0;122,0;74,0;12,0;2,0;;78,0;;14,0;142,0;3,0;;;1,0;8,0;59,0;10,0;12,0;2,0;1,0;15,0;3,0;;;41,0;9,0;104,0;;83,0;38,0;10,0;8,0;4,0;17,0;59,0;;19,0;37,0;158,0;32,0;96,0;236,0;8,0;51,0;3,0;16,0;;3,0;12,0;10,0;1,0;4,0;41,0;3,0;3,0;3,0;83,0;;3,0;13,0;28,0;10,0;52,0;9,0;102,0;;33,0;6,0;;41,0;45,0;1,0;22,0;309,0;2,0;25,0;11,0;123,0;;15,0;1,0;3,0;;19,0;18,0;;;2,0;8,0;9,0;12,0;4,0;261,0;34,0;13,0;;48,0;595,0;;10,0;17,0;8,0;35,0;35,0;6,0;28,0;;22,0;;170,0;37,0;230,0;2,0;19,0;1,0;;11,0;45,0;46,0;21,0;4,0;;1,0;9,0;;20,0;15,0;5,0;16,0;1,0;13,0;8,0;8,0;3,0;16,0;3,0;3,0;47,0;13,0;;;17,0;20,0;4,0;11,0;;3,0;22,0;137,0;;165,0;;13,0;;7,0;11,0;136,0;7,0;2,0;;66,0;103,0;;;8,0;;;;13,0;3,0;13,0;;;;13,0;17,0;;;;3,0;;;;;;;;28,0;;;;1,0;;4,0;;4,0;1,0;17,0;10,0;;;;;45,0;;5,0;2,0;1,0;1,0;;;;1,0;;6,0;;5,0;3,0;;3,0;;;30,0;;16,0;;2,0;21,0;5,0;43,0;48,0;;3,0;7,0;2,0;2,0;2,0;9,0;1,0;;;9,0;9,0;18,0;1,0;;3,0;;;1,0;23,0;4,0;1,0;;;;;30,0;1,0;;9,0;;;;26,0;10,0;7,0;;;;5,0;7,0;3,0;20,0;3,0;;3,0;;;23,0;14,0;3,0;;;53,0;15,0;;;12,0;;3,0;;;;4,0;8,0;5,0;;;7,0;;2,0;;3,0;2,0;1,0;1,0;;7,0;1,0;;2,0;;10,0;;;;;7,0;2,0;16,0;2,0;;5,0;3,0;;;;;5,0;11,0;30,0;1,0;1,0;;;1,0;2,0;1,0;2,0;1,0;6,0;17,0;3,0;;;;4,0;;3,0;12,0;98,0;1,0;4,0;3,0;1,0;;2,0;;;;1,0;2,0;4,0;11,0;;;1,0;;;;;5,0;11,0;2,0;;31,0;1,0;;;;3,0;2,0;20,0;6,0;146,0;1,0;2,0;2,0;;18,0;2,0;1,0;;1,0;3,0;;6,0;10,0;17,0;;1,0;3,0;30,0;25,0;7,0;33,0;7,0;27,0;;2,0;2,0;7,0;1,0;;9,0;17,0;8,0;;4,0;;165,0;5,0;3,0;2,0;23,0;6,0;9,0;93,0;;52,0;12,0;25,0;;4,0;80,0;47,0;3,0;1,0;3,0;16,0;;29,0;;3,0;;;1,0;2,0;9,0;1,0;21,0;18,0;23,0;6,0;3,0;;18,0;;1,0;;1,0;13,0;;4,0;15,0;1,0;42,0;51,0;2,0;7,0;3,0;1,0;;1,0;5,0;4,0;4,0;10,0;;;2,0;4,0;28,0;;8,0;7,0;21,0;1,0;;6,0;;4,0;3,0;5,0;1,0;;34,0;18,0;31,0;;1,0;;1,0;;10,0;2,0;28,0;;3,0;;;;;;10,0;5,0;;;4,0;10,0;2,0;;1,0;;;;5,0;;;10,0;33,0;;3,0;1,0;;;2,0;5,0;14,0;;8,0;;9,0;;;;23,0;;;1,0;1,0;;;;;;13,0;4,0;5,0;2,0;1,0;;1,0;;18,0;1,0;;4,0;2,0;;;2,0;;4,0;;3,0;1,0;;;;15,0;;;12,0;5,0;;3,0;1,0;;;28,0;19,0;;9,0;;4,0;3,0;;41,0;5,0;;;;2,0;7,0;3,0;;;15,0;5,0;6,0;;4,0;;15,0;1,0;15,0;4,0;;81,0;3,0;;2,0;2,0;17,0;5,0;5,0;3,0;;;;;;1,0;12,0;24,0;;;8,0;1,0;14,0;17,0;6,0;;1,0;;7,0;6,0;6,0;4,0;;4,0;;;;6,0;1,0;1,0;5,0;;2,0;;;4,0;;;1,0;2,0;;;;1,0;;12,0;4,0;36,0;;1,0;2,0;;;;;;17,0;;;;1,0;;2,0;;3,0;;;1,0;2,0;;;7,0;;3,0;;;;;4,0;3,0;;;15,0;;;;6,0;;;5,0;1,0;3,0;;3,0;37,0;;;11,0;;2,0;;;;8,0;;9,0;;;2,0;;;;;;;11,0;2,0;;;;5,0;4,0;;3,0;2,0;;;;1,0;18,0;67,0;5,0;;;;;2,0;11,0;10,0;;;;;1,0;14,0;76,0;;;;;2,0;3,0;;1,0;26,0;1,0;3,0;;1,0;;;;;3,0;4,0;4,0;;;3,0;;20,0;;;6,0;3,0;1,0;1,0;;2,0;;1,0;3,0;;;6,0;1,0;;;9,0;;;;4,0;;;;;2,0;2,0;1,0;;5,0;;;;;11,0;1,0;10,0;3,0;4,0;;;;;2,0;1,0;;4,0;2,0;8,0;;12,0;6,0;;2,0;2,0;;20,0;;10,0;;6,0;;3,0;;3,0;;24,0;6,0;1,0;;;;5,0;5,0;;3,0;5,0;1,0;;;1,0;4,0;;;9,0;;2,0;1,0;;;6,0;;13,0;1,0;1,0;5,0;;7,0;;;;;;3,0;;;;4,0;;2,0;;;3,0;;;;21,0;;;4,0;;3,0;;8,0;;;25,0;;1,0;1,0;2,0;2,0;;;;;;;;6,0;;;;2,0;1,0;;3,0;2,0;;2,0;;;;3,0;;6,0;;2,0;;25,0;;;2,0;1,0;;;;;6,0;;1,0;;1,0;;55,0;;5,0;2,0;;2,0;;6,0;1,0;9,0;;;;;;;;;
traffic;;;;;2,0;;;;;;;;;;1,0;7,0;1,0;;;;;;;6,0;;;2,0;;;;;2,0;2,0;;22,0;;;;;;34,0;;;;10,0;4,0;14,0;9,0;6,0;57,0;;8,0;;;;3,0;;;2,0;;;;1,0;;1,0;;;;;;;;;;;4,0;4,0;;1,0;7,0;;;;6,0;;1,0;;;;;;;;;;;2,0;;37,0;;;;14,0;4,0;;;;;;;;3,0;;1,0;;10,0;;8,0;;9,0;;;;;;;;;;2,0;;;1,0;;;;2,0;;;;;;;;;;;;47,0;1,0;;;;6,0;;;18,0;;;;;2,0;;;;;7,0;51,0;;;;;;;;;;;;;;;;;;;;;;;;;;;;;2,0;;;;;;;;;;;;1,0;;;;;;;;;;;;;;;;;;;;10,0;;;;;;;;5,0;6,0;;;;;;;;;;3,0;;;;;;;;;7,0;;;;;;;20,0;;;3,0;;1,0;;;4,0;;;;;;;;;;;;;;3,0;;;;;34,0;;;;;;;;;;;;;;;;;;;;;;;;2,0;;;;;;;;;;;;;;;;;;;;;;;;;;;;;;1,0;;;;;1,0;;;;2,0;;;;;;;;;;;;;;;;;;;;2,0;;;;;;;;;;;;;;;;;;1,0;1,0;;;;;;;;;;;;;;;;;2,0;;;2,0;;2,0;;;;;;;;;;;;;;;;;1,0;2,0;;17,0;;;;;;9,0;;2,0;;;1,0;;;1,0;3,0;;;;;;;;;;;;;;14,0;;;;;;1,0;;;1,0;3,0;3,0;;;;;;;4,0;;;;;;;;;;;26,0;;;;;;2,0;1,0;;;;;;;;;;;;2,0;;;;;;;;;;;;;;;;;;;;4,0;;;;;3,0;;;;;;;;;1,0;1,0;;;;3,0;;;;;;;;;;;;;;;;;;;;;;;;;;;;;;;;;2,0;;;;1,0;;;;;;;;;;;;;9,0;2,0;;;;1,0;;;1,0;;;;;;;;;;;;;;;5,0;2,0;;;;;;;;;;2,0;2,0;;;;;;;3,0;;;;;;;;;;;;;;;;;;;;;4,0;;;;1,0;;;4,0;;;1,0;1,0;;;;;;;;;;;;;;;;;;;;;;;;;;;1,0;6,0;;;;;;;;;;;;;;;;;;;;;;;;;;;;;;;;;;;;;;;;11,0;;;;;;;;;;6,0;;;;;;3,0;;;;;;;;;;;;;;;;;;;;;;;;;;;;;;;;;;;;;;;;;;2,0;;2,0;;;;1,0;;;;;;;;;;;;;;;;;;;;;;;;;;3,0;;;;;;;;;;;;;;;;;;;1,0;;;;;;;;;;;;;;;;;;;;;;1,0;;;2,0;;;;;;;;;;;;1,0;;;3,0;;;;;;;;;2,0;;;;;;;;;;;;;;1,0;;;;;;;;;;;;;;;;;;;;;;;;;;;;;;;;;;;;;;;;;;;;;;;;;;;;;;;;;;;;;;;;;;;;;1,0;;;14,0;;2,0;;;;;;14,0;;;;;14,0
vector;;;;;2,0;43,0;;35,0;36,0;1,0;;;49,0;8,0;9,0;157,0;;18,0;2,0;7,0;8,0;29,0;;4,0;2,0;1,0;30,0;14,0;;8,0;6,0;1,0;53,0;;4,0;1,0;24,0;59,0;4,0;;36,0;;28,0;28,0;66,0;27,0;206,0;99,0;11,0;7,0;;21,0;3,0;3,0;;9,0;11,0;24,0;40,0;;6,0;;12,0;;9,0;;2,0;10,0;130,0;;13,0;;112,0;;;53,0;35,0;;;309,0;1,0;2,0;1,0;57,0;;13,0;;;;3,0;3,0;;;;5,0;11,0;9,0;;107,0;74,0;25,0;27,0;15,0;49,0;3,0;9,0;2,0;1,0;6,0;17,0;;7,0;;;6,0;66,0;3,0;135,0;;32,0;;;9,0;47,0;20,0;4,0;;2,0;;10,0;;86,0;45,0;;81,0;29,0;80,0;4,0;38,0;;23,0;;;14,0;8,0;1,0;;2,0;10,0;3,0;2,0;;7,0;11,0;11,0;6,0;40,0;1,0;10,0;;15,0;;121,0;;;;18,0;8,0;;;12,0;;;4,0;39,0;40,0;5,0;;;;;3,0;;;;6,0;;62,0;;;8,0;5,0;;;6,0;;;;;;;;44,0;79,0;101,0;;;;2,0;;;;5,0;;;;;;20,0;;;;1,0;;;;1,0;;2,0;;1,0;;;1,0;1,0;11,0;18,0;;1,0;;2,0;;;3,0;;;;;101,0;47,0;;;;;;;2,0;3,0;;;;;;48,0;;10,0;2,0;;;;;11,0;11,0;;2,0;3,0;;;;3,0;;;;;;21,0;6,0;;5,0;;4,0;14,0;1,0;1,0;;;35,0;;;;;;;;;2,0;4,0;27,0;1,0;;3,0;;1,0;;;1,0;;;;1,0;;;;;4,0;;;;;1,0;;;;;;20,0;;;11,0;;;;;2,0;;;;;3,0;4,0;;22,0;;1,0;;;;148,0;;1,0;;47,0;;;;;;;;;2,0;;;1,0;;;;;4,0;32,0;;;7,0;;;4,0;;;;21,0;;40,0;30,0;;;;;;16,0;;32,0;6,0;;;;17,0;;13,0;29,0;179,0;25,0;1,0;18,0;5,0;77,0;;;;1,0;;4,0;1,0;20,0;4,0;1,0;4,0;;31,0;24,0;;8,0;2,0;2,0;;9,0;10,0;9,0;20,0;12,0;;15,0;865,0;11,0;;;4,0;4,0;;5,0;12,0;;8,0;1,0;3,0;;4,0;;2,0;;12,0;;;;4,0;;;;;39,0;7,0;1,0;;4,0;41,0;8,0;10,0;;40,0;;;6,0;;4,0;25,0;59,0;19,0;;13,0;1,0;12,0;;;;4,0;2,0;6,0;;;;1,0;;;3,0;10,0;4,0;16,0;22,0;5,0;5,0;1,0;15,0;1,0;31,0;;;;1,0;;;;14,0;;;11,0;;;;;;;1,0;3,0;;;2,0;;30,0;15,0;;;;;;19,0;;18,0;4,0;2,0;;6,0;1,0;;1,0;;9,0;;;;;;;3,0;1,0;15,0;;;;;;5,0;2,0;4,0;2,0;;;1,0;;;1,0;9,0;21,0;;2,0;;;;;;;;;;;;;;;;;;;;;;;13,0;2,0;;;;;;;;;;;19,0;;3,0;;3,0;;;4,0;;20,0;1,0;;1,0;;;;3,0;4,0;;;;1,0;;10,0;;1,0;;2,0;;52,0;;15,0;;;;2,0;;;6,0;1,0;1,0;;;;;10,0;5,0;1,0;;;6,0;;;;;;;;;;;;2,0;;;17,0;;;36,0;2,0;5,0;;;4,0;1,0;;;;;;;;;;;;3,0;;1,0;;8,0;;;;;;3,0;;;;;;;;;;;;;;;8,0;;;;;;;2,0;;;;;2,0;;;;;;;;;;;;;;;1,0;2,0;;1,0;18,0;;;;;3,0;3,0;;8,0;;;;;7,0;22,0;;;;;56,0;7,0;9,0;;;;5,0;1,0;5,0;;;18,0;2,0;12,0;;;;;;;11,0;;32,0;;;10,0;;;;;1,0;19,0;;;;;;;1,0;;;9,0;;;;1,0;;;;;;;;2,0;2,0;4,0;1,0;;;;;5,0;;1,0;;;;;;;;;;;;13,0;;;;;25,0;;;;;;;;;;;5,0;;;;;;;;;;;;;9,0;;;;;;;2,0;;1,0;;;;;;;;;;;;;22,0;;;;;;;;;;;;21,0;;;5,0;;;;;;;;;;1,0;29,0;8,0;;4,0;2,0;;;;;;;;;;;;;;;;;2,0;;;;;;7,0;;;;;;;;;;;;;;;;;4,0;8,0;6,0;;;2,0;6,0;30,0;3,0;1,0;;;;;;;;;;;2,0;;;;;
velocity;;;;;1,0;5,0;;25,0;7,0;;;;4,0;;2,0;32,0;;6,0;;;;2,0;1,0;;;;2,0;;;12,0;7,0;;15,0;;10,0;1,0;2,0;40,0;;;28,0;;;;90,0;1,0;64,0;15,0;4,0;7,0;;29,0;;5,0;3,0;;;;11,0;1,0;;;;;;;;2,0;9,0;;3,0;;1,0;;;11,0;1,0;;;36,0;;11,0;4,0;14,0;1,0;2,0;;;1,0;1,0;2,0;;;;2,0;2,0;;;34,0;3,0;;;5,0;33,0;;;15,0;;27,0;1,0;1,0;6,0;;;;3,0;1,0;37,0;;30,0;;;4,0;1,0;10,0;2,0;1,0;4,0;;6,0;;1,0;12,0;;13,0;;2,0;12,0;4,0;1,0;4,0;;;34,0;;;;1,0;24,0;;;;1,0;;2,0;;47,0;;4,0;;8,0;2,0;19,0;;1,0;;1,0;7,0;;;;;;1,0;;;;;;;;;;;;7,0;;2,0;;;;11,0;;2,0;;;;;;;;;;37,0;1,0;;;;;;;;;;;;;;;;;;;;;;;;1,0;;;;;2,0;;9,0;5,0;;;;;;;2,0;;;;;2,0;2,0;;;1,0;;2,0;10,0;24,0;1,0;1,0;;;;;9,0;;20,0;;;2,0;;5,0;;;;;;2,0;;;4,0;;;;;;10,0;3,0;;;;19,0;;11,0;;;;3,0;;;;;1,0;;;1,0;;;;;;;;;;;9,0;;;;;;;;;7,0;;;;;;;;;;;1,0;1,0;2,0;;;;;;16,0;1,0;;;3,0;;;;1,0;1,0;;;6,0;1,0;4,0;;;;;;;;;;;;;;;;;;;;;2,0;6,0;;;;;;;;;;;;39,0;;;;;;;;;61,0;7,0;;4,0;1,0;24,0;5,0;253,0;;32,0;10,0;1,0;;;2,0;4,0;;2,0;;;;4,0;11,0;4,0;;3,0;28,0;;;12,0;28,0;1,0;15,0;7,0;;1,0;1,0;24,0;1,0;;5,0;35,0;71,0;4,0;;;;;5,0;;;6,0;;7,0;5,0;17,0;;;5,0;2,0;1,0;;8,0;;1,0;;;;32,0;3,0;1,0;;4,0;;2,0;1,0;40,0;;;2,0;1,0;;;;2,0;;;;2,0;3,0;;4,0;;;;;;;;;;1,0;;;;;;;;;;;8,0;;;;;;;;;;;9,0;;;;;4,0;;;;;;;;23,0;;;;;;;;;4,0;2,0;1,0;;;1,0;;;;;;;;;;;;;;2,0;6,0;;;;14,0;;;;;;;;;;;;;;;;;8,0;;;;;;;;;;;;;;;;;;;;;;;;;;;;;;;;;6,0;;3,0;;;;;;1,0;;;;;;;;;;;;;;;2,0;;;9,0;;;41,0;;4,0;;;;;;;;;;;;;;;;;;;;;;;;;;;;;;;;1,0;;;1,0;;;;;;;;;;;;;;;;;;;;;1,0;;;;;;;;;;;;;;;;;;;;;;;;;;;;;1,0;;;1,0;;5,0;;;;;;;1,0;;;;;;;;2,0;;1,0;;;;;;;;;;;;;;;;;;;;;;;;;;;;1,0;10,0;;;7,0;1,0;;;;3,0;;;;;;3,0;;;;;;;;;;;;;;;4,0;4,0;;;;;;;;2,0;;;;;;;2,0;;;;;;;;;;;;1,0;;;2,0;;;;;;;1,0;;;;;;;;;;3,0;;2,0;;;;;;;;;;;;;;;;;;;1,0;;;;;;;;;;;;;;;;;;4,0;;9,0;;;;;;1,0;;;;;;1,0;;;;1,0;;;;;;;;;;;;;;;2,0;;8,0;;;;;;;;;;;1,0;;;1,0;;;;;;;;;;;;;;1,0;;;;;;;;;3,0;;;;;;;;;;;;;;;;;;;;;;;;;
version;;;;;3,0;;;1,0;;;;;1,0;;;21,0;1,0;;;;;5,0;;;;1,0;10,0;6,0;1,0;;;;;;;;1,0;7,0;13,0;;37,0;;;2,0;;;14,0;3,0;8,0;13,0;;1,0;;;;;;1,0;;;;;;;;;;;;;;;4,0;;;;2,0;;;92,0;;2,0;;15,0;;;;;;;;;;;;1,0;1,0;;12,0;;;16,0;;2,0;;;;;4,0;;;;;;;4,0;3,0;3,0;;;;;11,0;1,0;;;;;;;;1,0;;;;15,0;28,0;;;;2,0;;;2,0;;;;1,0;2,0;;;;;21,0;1,0;;3,0;;;;;3,0;1,0;;;;3,0;;;;;;;;;;;;;;;;;;;1,0;;;;;1,0;;;;;;;;;;;;;;;;;;;;;;;;;;;;;;;;;;;;;;;;;;1,0;;;;;;;;;;;;;;;;21,0;;;;;;;;3,0;;;;;;;2,0;;;;;;;;;;;;;;;;;;;;;;7,0;;;;;;;;;;;;;6,0;;;1,0;;;;;;;;;;;;;1,0;;;;;;;;1,0;;;;;;;;;;;;;;;;;;;;;;;;;;;;;;;;;;;4,0;;1,0;;;;;;;;;;;;;;;;;;;2,0;;;;;;;6,0;;;;;;;8,0;;2,0;;;;1,0;;;;;1,0;;;;;;1,0;;4,0;;;4,0;;;;;;;;;;;;;1,0;;;;2,0;1,0;;;;;;2,0;;;4,0;;;;;;;;1,0;;;;;;10,0;;2,0;;;;;;;;;;;;;;;;17,0;2,0;;;;;;6,0;;;3,0;;;3,0;;;;;;;;;;;;;;;;;15,0;;;;;;;2,0;;;;;;;;;;;;;;;;1,0;;;;;1,0;;;;;;;;;;;;;;;;;;;;;11,0;;1,0;;;;;;;;;;;;;;;;;;;;;;;;;;;;;;;;;;;;;;;;;;;;;;;;6,0;;3,0;;;;;;;;;;;;;;;;;;;;;;;;;;;;;;7,0;;;;2,0;;;;;;1,0;;;;;;;;;;;;;;;;;;;;;;;;;;;;;;;;;;;;;;;;;;;;;;;;;;;;;;7,0;;;;;;;;;;;;;;;;;;;;;;;;;;9,0;;;;;;;;;;;;;;;;;;;;;;;;;;;;;;;;;;4,0;;;;;;;;;;;;;;;;;;;;31,0;;;;;;;;2,0;;;;8,0;24,0;;;;;;;;;;;;;;;;;;;;;;;;;;;;;;;;;;;;;;;;;;;;;;;;;;;;;4,0;;;;;;;;19,0;;;;;;;;;;;;;6,0;;;;;;;;;;;;;;;;;;;;3,0;;;;;;;;;;;;;;;;;;;;;;;;;;;;;;;;;;;;;;;;;;;;;;;;;;;;;;;;;;;;;;;;;;;;;;;;;;;;;;;;;;;;;;;;;;;;;;;;;;1,0;;;;;;;;;;;;;;;;
virtual;;;;;4,0;22,0;;29,0;24,0;21,0;3,0;2,0;26,0;3,0;22,0;63,0;1,0;1,0;2,0;2,0;1,0;51,0;25,0;;;;6,0;;;;30,0;1,0;26,0;;58,0;1,0;3,0;3,0;25,0;;55,0;1,0;40,0;81,0;26,0;19,0;89,0;121,0;8,0;194,0;5,0;42,0;;;;3,0;9,0;;1,0;4,0;7,0;;43,0;;6,0;31,0;24,0;12,0;38,0;1,0;6,0;;171,0;3,0;6,0;;18,0;;3,0;414,0;1,0;44,0;3,0;55,0;9,0;33,0;;;;2,0;38,0;;3,0;;;18,0;27,0;;159,0;13,0;106,0;11,0;9,0;225,0;4,0;6,0;6,0;11,0;47,0;24,0;2,0;43,0;;;1,0;48,0;16,0;266,0;;15,0;5,0;;1,0;20,0;16,0;25,0;;;;15,0;;91,0;7,0;6,0;29,0;5,0;14,0;24,0;;;125,0;50,0;6,0;16,0;15,0;;;5,0;1,0;7,0;3,0;7,0;7,0;11,0;22,0;;138,0;;32,0;1,0;18,0;1,0;6,0;1,0;8,0;;40,0;139,0;4,0;;29,0;;;1,0;3,0;4,0;;;;;;47,0;;;;;;17,0;;;1,0;;;6,0;;1,0;;1,0;;4,0;;7,0;3,0;34,0;;;;;1,0;2,0;;;;;;;;;3,0;2,0;1,0;;;1,0;1,0;;;;5,0;;;;4,0;;;30,0;48,0;;;;1,0;;3,0;7,0;;;;22,0;36,0;59,0;2,0;;;;;;44,0;9,0;2,0;;;;;23,0;;;7,0;;1,0;;10,0;12,0;196,0;;;;1,0;1,0;;20,0;;;;;;18,0;;21,0;;;19,0;1,0;;;;;1,0;;;;;5,0;;;62,0;;;2,0;;2,0;;;;;13,0;1,0;;;1,0;14,0;;;;1,0;5,0;;;;;;;;;27,0;;;8,0;;;;;;;7,0;1,0;;;1,0;1,0;4,0;;7,0;;1,0;;12,0;;86,0;;;;26,0;;;;;;3,0;;;5,0;;;;;4,0;;;18,0;20,0;;;;;;;;;;12,0;2,0;15,0;;;;;;5,0;;;;;4,0;2,0;;;;;3,0;17,0;34,0;1,0;4,0;7,0;15,0;9,0;9,0;;;5,0;;8,0;;4,0;8,0;1,0;;5,0;;1,0;;30,0;19,0;1,0;87,0;;11,0;6,0;15,0;;5,0;27,0;73,0;4,0;1,0;13,0;27,0;2,0;61,0;;;;;;4,0;13,0;10,0;70,0;;;;;;10,0;;;;;8,0;17,0;8,0;3,0;1,0;23,0;53,0;;15,0;41,0;;;24,0;5,0;;27,0;21,0;;;2,0;;5,0;;152,0;1,0;4,0;;;16,0;1,0;12,0;;2,0;;;15,0;;;32,0;;;;2,0;3,0;1,0;;4,0;;9,0;;;;;1,0;;2,0;1,0;5,0;1,0;;7,0;;;5,0;10,0;1,0;;;2,0;;;2,0;;;19,0;1,0;;5,0;2,0;9,0;;3,0;;;;2,0;1,0;12,0;;;;3,0;;;;15,0;;12,0;1,0;1,0;;;;;1,0;;;4,0;1,0;2,0;;;;;4,0;21,0;;;7,0;;;;1,0;;;3,0;;;;1,0;1,0;;12,0;;1,0;;;12,0;1,0;;;24,0;;3,0;1,0;;;;;;;9,0;;9,0;;1,0;3,0;;14,0;;;;;;;;1,0;20,0;4,0;;2,0;;;4,0;;;1,0;3,0;;;;;;;1,0;;1,0;;;;;;;;;;;3,0;;;;;4,0;;;;;;;;;2,0;;;15,0;;;;;;;;;1,0;;;;;;;;;;;;1,0;;;1,0;35,0;6,0;;;;;3,0;;;;;;;;;;;9,0;;;;;;1,0;;1,0;;;;1,0;;9,0;1,0;17,0;;;1,0;;;;;;;;;;;;1,0;;1,0;;;;;;;;1,0;;1,0;;;;;16,0;1,0;;;;5,0;;;;3,0;;;;;1,0;5,0;;3,0;17,0;1,0;;2,0;105,0;;;6,0;1,0;;;;;2,0;1,0;5,0;;;;2,0;4,0;;;;1,0;;2,0;;;;1,0;;6,0;1,0;2,0;;;;;;3,0;;;;;8,0;;;;;;1,0;15,0;6,0;19,0;2,0;;1,0;;;;;;;;5,0;;9,0;3,0;;;;1,0;16,0;;34,0;;9,0;;3,0;;;;;;;2,0;;;1,0;;2,0;;;3,0;;;1,0;;;;;;;;;;;;;;;9,0;;4,0;;;;;;;;;;;;2,0;;9,0;;;;1,0;1,0;;;;;;;1,0;;;25,0;;;;;;;6,0;7,0;;;;;3,0;;;;;1,0;1,0;;;;;;;;;;;;1,0;;;;;42,0;;;;1,0;;1,0;1,0;;2,0;;7,0;5,0;;20,0;;;3,0;;;;;;;;;;;;;
wave;;;;;1,0;3,0;;31,0;4,0;43,0;;;1,0;;5,0;24,0;2,0;;;;;;;;;;2,0;;;;1,0;;72,0;;12,0;2,0;;2,0;1,0;;1,0;;8,0;;164,0;47,0;1,0;152,0;2,0;;;;;2,0;31,0;;15,0;;;;;;;;5,0;;;9,0;;4,0;1,0;;124,0;33,0;;;;;1,0;7,0;;22,0;;22,0;;24,0;;;;3,0;16,0;;;8,0;6,0;1,0;;;2,0;;;;6,0;22,0;;5,0;12,0;1,0;;2,0;8,0;4,0;;;3,0;6,0;7,0;;1,0;7,0;;;;;;;;;6,0;4,0;;67,0;17,0;;;;;;;6,0;;;;3,0;;;;4,0;90,0;;;;1,0;2,0;;11,0;10,0;;;2,0;1,0;9,0;145,0;;;;;1,0;2,0;8,0;;;;1,0;4,0;2,0;;11,0;;;;17,0;;2,0;1,0;4,0;;1,0;;3,0;;2,0;;1,0;;4,0;;;;;;;1,0;3,0;;19,0;;;;9,0;2,0;;6,0;;;;2,0;;1,0;;1,0;4,0;;;;;4,0;;86,0;;17,0;;;;;6,0;3,0;2,0;3,0;;;;;;1,0;;;;;3,0;5,0;;;6,0;;12,0;11,0;8,0;;;1,0;;;;6,0;;;10,0;;;2,0;11,0;;;;;12,0;;;18,0;;;;1,0;4,0;3,0;;1,0;;;2,0;;29,0;;;;;1,0;;;4,0;;;;;;2,0;;;;;2,0;;;;;;;;;;;1,0;;21,0;;;;;;2,0;;;;;7,0;;3,0;;;;;;;;;;73,0;;2,0;;;;;4,0;;;;;;;;;;1,0;;70,0;;;6,0;;;;;;;11,0;;;;;;;;;3,0;;;3,0;1,0;;;;;;1,0;;4,0;;;;;1,0;7,0;;;4,0;2,0;;2,0;;1,0;10,0;;;;;;;;;;;;;;;;;;;21,0;;;;;;19,0;;;1,0;9,0;4,0;;;1,0;1,0;;;1,0;;;;;;;1,0;;;;1,0;;2,0;;;;;;;;;2,0;;;;;;4,0;33,0;;3,0;;;;;;;;;;;;;;;;;;;;;1,0;;2,0;;;;1,0;8,0;;;3,0;;;;;;;;;12,0;;;;;;1,0;;2,0;;;;;;;;;;;;;;;1,0;;7,0;;;;;;;;;;;;;;;;;;;;;8,0;71,0;;;;;;;;;;;;;;;;;2,0;5,0;;;;;;;;;;;;;;;;;;;;;;;;;;;;;;;;;;;3,0;;;1,0;;;2,0;;;;;13,0;;;;;;;;;;;;;;;;;;;;1,0;;;;;;;;;;;;;11,0;;;1,0;;;;;4,0;;;;;;;;;;;;;;;;;;;1,0;;;;2,0;;8,0;2,0;;;;;;;;;;;;;;;;;;36,0;;;;;;;;;;1,0;1,0;;;;;;;89,0;;;;;1,0;;;;;;;;;;;;;;;;2,0;;;;;;;5,0;33,0;;;;;;;;4,0;;;;;;;;;;;;;;;;;;;;;;;;;;;;;;;16,0;2,0;;;;;;;;;;;;;;;;;;;;;2,0;;;;;;;18,0;;;;;;;;;;;;;;;2,0;;;;;;;;;;;;;;4,0;;;;;2,0;;;;;;;;;;;;;;;;;;89,0;;;;;;;;;;;;;;;;;;;;;;;;;;22,0;2,0;;;;3,0;;3,0;;;;;;;;;;;6,0;;;;;;;;;;;;;;;;;;;;337,0;;;;;;;;;;;;;;;;;;;;;;;;;;;;;;;;;;;;;;;;;;;;;;;;;;;;
acceleration;;;;;;16,0;;1,0;;;;;;;1,0;17,0;;;1,0;;1,0;4,0;;;;;;;;1,0;2,0;;8,0;;7,0;;1,0;2,0;;;53,0;;;1,0;5,0;3,0;16,0;14,0;10,0;1,0;;;;;2,0;;4,0;;9,0;;;;;;11,0;4,0;;2,0;;;10,0;;2,0;;;;25,0;;;19,0;;11,0;;7,0;;1,0;;;1,0;;;;;;1,0;;;;27,0;;;;7,0;1,0;;1,0;4,0;;58,0;4,0;1,0;;;;;12,0;1,0;6,0;;6,0;;;3,0;10,0;17,0;;;;;2,0;;;;;3,0;;3,0;34,0;1,0;;;;;38,0;1,0;;;;64,0;;;;1,0;11,0;;;45,0;;1,0;;;2,0;10,0;;;;;1,0;;;1,0;;;;1,0;;;;;;;;;;;;;2,0;;;;;;3,0;;;;;;;;;;109,0;3,0;;;;1,0;;;;;;;;;;;;;;;;;;;;;;;;;1,0;;;7,0;;;;;;;;3,0;;;;;14,0;;;1,0;;;2,0;15,0;1,0;;;;;;4,0;;1,0;;;1,0;;;;;;;;8,0;27,0;;;;;1,0;;;18,0;3,0;;;;5,0;;;;;;;;;;2,0;;;;;;;3,0;;;;;;;;6,0;;;;4,0;;;;;;;;;;;;;;;;;;;;;;;;13,0;;;;1,0;;;;;;2,0;;;;;;;1,0;;;;;;;;;;1,0;;;1,0;;;;;;;;;4,0;;;;;;;;;;;;;;;;;;;70,0;3,0;11,0;1,0;1,0;1,0;53,0;1,0;3,0;17,0;5,0;1,0;2,0;17,0;6,0;1,0;13,0;1,0;2,0;1,0;1,0;1,0;2,0;6,0;16,0;3,0;5,0;4,0;1,0;34,0;1,0;1,0;2,0;2,0;8,0;1,0;24,0;1,0;4,0;2,0;35,0;2,0;1,0;1,0;1,0;1,0;1,0;3,0;4,0;4,0;3,0;1,0;4,0;6,0;22,0;3,0;2,0;12,0;1,0;3,0;36,0;1,0;9,0;1,0;1,0;1,0;2,0;4,0;1,0;2,0;1,0;2,0;4,0;1,0;3,0;32,0;61,0;2,0;1,0;;;;;;;;;;;;;;;;;;;;;;;;;;;;;;;;;;;;;;;;;;;;;;;;;;;;;;;;;;;;;;;;;;;;;;;;;;;;;;;;;;;;;;;;;;;;;;;;;;;;;;;;;;;;;;;;;;;;;;;;;;;;;;;;;;;;;;;;;;;;;;;;;;;;;;;;;;;;;;;;;;;;;;;;;;;;;;;;;;;;;;;;;;;;;;;;;;;;;;;;;;;;;;;;;;;;;;;;;;;;;;;;;;;;;;;;;;;;;;;;;;;;;;;;;;;;;;;;;;;;;;;;;;;;;;;;;;;;;;;;;;;;;;;;;;;;;;;;;;;;;;;;;;;;;;;;;;;;;;;;;;;;;;;;;;;;;;;;;;;;;;;;;;;;;;;;;;;;;;;;;;;;;;;;;;;;;;;;;;;;;;;;;;;;;;;;;;;;;;;;;;;;;;;;;;;;;;;;;;;;;;;;;;;;;;;;;;;;;;;;;;;;;;;;;;;;;;;;;;;;;;;;;;;;;;;;;;;;;;;;;;;;;;;;;;;;;;;;;;;;;;;;;;;;;;;;;;;;;;;;
accumulate;;;;;;3,0;2,0;3,0;5,0;5,0;5,0;;;;;50,0;;;;;;2,0;7,0;34,0;;;22,0;;;;;;35,0;8,0;21,0;1,0;3,0;1,0;;;16,0;;2,0;3,0;18,0;18,0;17,0;28,0;1,0;;;2,0;;1,0;7,0;2,0;13,0;3,0;;;;;12,0;;5,0;1,0;4,0;3,0;45,0;;9,0;;55,0;;;2,0;;;;67,0;2,0;1,0;;37,0;;2,0;;;;;8,0;;;2,0;;6,0;5,0;;15,0;;4,0;;;3,0;;14,0;1,0;;34,0;;;11,0;;;2,0;24,0;15,0;5,0;;10,0;6,0;;;;1,0;2,0;;2,0;;;;13,0;;;1,0;;10,0;4,0;;;;;;21,0;1,0;;;;272,0;;1,0;;9,0;5,0;;;6,0;;;88,0;;;126,0;;;;11,0;;;;2,0;;;;27,0;2,0;;;3,0;;;1,0;;;256,0;15,0;;;;;;;;3,0;;2,0;;;;1,0;;;13,0;1,0;;6,0;79,0;5,0;51,0;;;;4,0;13,0;;;;;;5,0;;8,0;;;;;4,0;;49,0;;2,0;;;;;;5,0;;;;;;;4,0;2,0;12,0;72,0;;93,0;;;;;;;;14,0;2,0;;;;;;1,0;28,0;;;2,0;5,0;2,0;2,0;;;;;;;4,0;2,0;9,0;6,0;;;;;85,0;;;;;;1,0;;;;;11,0;;1,0;;;;;;;;;5,0;;2,0;;;;;;4,0;;;;;;;;;2,0;;;;;;;;;;;;;;8,0;;;;;;24,0;;;;3,0;4,0;;;;9,0;;;;4,0;;;;;;;;;;;;;;;;3,0;;;2,0;;;;;;7,0;;;11,0;;;;;;;;;;;;;1,0;;;;;;;;;;;34,0;4,0;5,0;11,0;;10,0;;;;1,0;;;;;;;;;;;;1,0;3,0;2,0;;;;;1,0;;;;40,0;6,0;;;;4,0;;;25,0;;;;4,0;;;;6,0;;;;1,0;;4,0;;;;;17,0;2,0;;1,0;;12,0;2,0;;18,0;;2,0;;5,0;1,0;;;;;;;;;9,0;;;;;;;;;;;;;3,0;2,0;5,0;4,0;;19,0;;;;;;;;;;;;;;;;;;;;;1,0;;;;;;;;2,0;;;;;;4,0;;;2,0;;;;;;;;;;;;;;;;3,0;1,0;;;;;;;19,0;4,0;;;;;;;;;1,0;;;;5,0;;;;;;;;;;;;;;;;;;;;;;;;;;1,0;;;;;;;;;;;3,0;;;;;69,0;1,0;;;17,0;;;3,0;;;;2,0;;;;;;;;;;;;;;;4,0;;;;;;;;;;;;68,0;;;;;;;;;;;;;;;;;;;;;2,0;;;;;;;;;;;;7,0;;;;;;;;;;;2,0;;;;;;;;;;;;22,0;88,0;;;;;8,0;4,0;;;;;;;1,0;;;;;;;;;;;;;;;;;;;;;;;;10,0;;24,0;5,0;19,0;5,0;1,0;1,0;1,0;1,0;7,0;2,0;9,0;14,0;1,0;2,0;6,0;2,0;4,0;4,0;5,0;11,0;5,0;3,0;4,0;2,0;3,0;1,0;2,0;2,0;2,0;11,0;1,0;5,0;28,0;3,0;2,0;;;;;;;;;;;;;;;;;;;;;;;;;;;;;;;;;;;;;;;;;;;;;;;;;;;;;;;;;;;;;;;;;;;;;;;;;;;;;;;;;;;;;;;;;;;;;;;;;;;;;;;;;;;;;;;;;;;;;;;;;;;;;;;;;;;;;;;;;;;;;;;;;;;;;;;;;;;;;;;;;;;;;;;;;;;;;;;;;;;;;;;;;;;;;;;;;;;;;;;;;;;;;
accumulation;;;;;;7,0;2,0;8,0;2,0;;3,0;;;;;1,0;;;;;;2,0;;;;;;;;;;;7,0;;67,0;1,0;;1,0;3,0;;2,0;;;;21,0;4,0;9,0;8,0;2,0;;;4,0;;2,0;;4,0;8,0;;;;;;7,0;;;;8,0;2,0;4,0;;32,0;;21,0;;;18,0;;;;97,0;5,0;18,0;;6,0;1,0;;;;;1,0;5,0;;;;2,0;;3,0;;17,0;;;;;;;20,0;1,0;;16,0;;1,0;11,0;1,0;;;5,0;1,0;1,0;;13,0;;;;21,0;;;;3,0;;;;5,0;;;;;5,0;16,0;;;;;;9,0;;;;6,0;36,0;;;;2,0;8,0;;;7,0;;;4,0;1,0;;132,0;;;;;;;;;;;6,0;27,0;;;;1,0;;;;;;146,0;3,0;;;;;;;;9,0;;29,0;;;;;;;9,0;;;;33,0;;106,0;6,0;7,0;;;16,0;;;;;;11,0;;1,0;;;;;22,0;;13,0;;;;;;;;2,0;;;;;;;;;;10,0;;39,0;;;;;;;;11,0;4,0;;;;;;;7,0;;;;;2,0;;;;;;;17,0;;14,0;32,0;1,0;3,0;;;;60,0;1,0;2,0;;;;;;;;;1,0;;2,0;;;;;;;;;;12,0;;;;;;1,0;;;;;;;;;;4,0;;3,0;;;;;;;;;;;;2,0;;;;;2,0;;;;;;2,0;;;;;;;;;;;;;;;;;;2,0;;;;;;3,0;;;;;;;;;;;;2,0;;;;;;30,0;;;;;;;;;;;;;;;1,0;;;;7,0;;;1,0;5,0;;;;;;;;1,0;;;;1,0;;;;;;17,0;;;3,0;;5,0;;2,0;;;;;;;2,0;;;15,0;;;;;1,0;2,0;;;;;;;;2,0;;;;;13,0;;;;;;;;;;1,0;;;;;;;3,0;;;;;2,0;;2,0;7,0;;;;;6,0;;;;;3,0;;;;;;;;;;;;3,0;;;;;;;;;;;;;;1,0;;;6,0;;;;;;;1,0;;;;;;;1,0;;;;;;;;;;;;;;;;2,0;2,0;;;;;;;;;;;3,0;;;;;;;;;;;2,0;;;;;;;;;;;;;;;11,0;;;;;2,0;;;;;;;;;;;;;;;18,0;;;;;;135,0;4,0;;1,0;22,0;;;2,0;;;;;;;;;;;;;;;;;;;;;;;;;;;;;;;22,0;;;;;;;;;;;;;;;;;;;;;;;;;;;;;;;;;10,0;;;;;;;;;;;;;;;;;;;;;;;;6,0;;;;;1,0;;;;2,0;;;;;;;;;1,0;;1,0;;;;;;;;;;;;;;;;;44,0;24,0;;1,0;;;;;;;15,0;1,0;4,0;;125,0;;3,0;;2,0;;;1,0;;;2,0;17,0;4,0;;;;3,0;;;;19,0;2,0;;2,0;2,0;10,0;;;;;;;;;;;;;;;;;;;;;;;;;;;;;;;;;;;;;;;;;;;;;;;;;;;;;;;;;;;;;;;;;;;;;;;;;;;;;;;;;;;;;;;;;;;;;;;;;;;;;;;;;;;;;;;;;;;;;;;;;;;;;;;;;;;;;;;;;;;;;;;;;;;;;;;;;;;;;;;;;;;;;;;;;;;;;;;;;;;;;;;;;;;;;;;;;;;;;;;;;;
adaptor;;;;;;1,0;2,0;2,0;1,0;7,0;4,0;;;;27,0;12,0;6,0;;;;;;;;;;;16,0;;;;;32,0;;11,0;2,0;;1,0;;2,0;13,0;;5,0;;;;;73,0;7,0;1,0;4,0;;;;;;;;;;6,0;2,0;;;5,0;4,0;;3,0;2,0;6,0;;;1,0;;;;;;1,0;22,0;;16,0;;51,0;;;;;;3,0;49,0;;;3,0;;;;;6,0;;;;;;;;45,0;;8,0;;4,0;;;;;6,0;9,0;8,0;7,0;;;;;3,0;1,0;;;;;1,0;;;9,0;3,0;;17,0;;;;;;;1,0;;;;;5,0;2,0;1,0;;;;1,0;;1,0;19,0;;2,0;;;1,0;19,0;;;;7,0;3,0;;;;;;;;;;;;;;16,0;;;;;;6,0;;;;;;20,0;;21,0;;;;;4,0;;;5,0;;;;;;1,0;;;;;;;;;;;8,0;;;;12,0;2,0;;;10,0;;;;5,0;26,0;;;;4,0;;;;;;4,0;;;;;;;7,0;;4,0;;;;7,0;;;;;;6,0;;;;3,0;;;;;5,0;;2,0;;;;3,0;;3,0;;;;;;;3,0;;;5,0;;;;;;;;;;;;3,0;3,0;;;;;1,0;1,0;;;1,0;;;;;;17,0;;11,0;;;3,0;2,0;;;6,0;1,0;;;;;;;;;;;1,0;3,0;;;9,0;;;;;;;;;;;;;;;23,0;7,0;;;;;;4,0;;;4,0;;;;;;;;;3,0;;1,0;;;;4,0;;;;;;;4,0;;;;;;;;;;;;;;6,0;;;;;;;;;;;;;;;;;;;;;;;;;;;;3,0;;4,0;;;;;5,0;;3,0;;;;1,0;1,0;1,0;;;;1,0;;;;;1,0;;;;;;;;;3,0;;;;;;;;;;;;;;;;;5,0;;1,0;;;;;;;;;;;;;;;16,0;;5,0;;2,0;3,0;;;;;;;;;;;5,0;;;4,0;;;;;5,0;5,0;;;1,0;7,0;;;;;;7,0;;2,0;;;;;;;;;;;;;;;;2,0;;;;;;5,0;;;;;2,0;;1,0;;2,0;;;;;;3,0;;;;;;;;;;;1,0;3,0;;;;;;2,0;;;;;;;;;;;;1,0;;;;;;;;;;;;;;;;;;;;;;;;4,0;;7,0;;;;;1,0;;;;;;;;;;;;;;1,0;;;;2,0;;1,0;1,0;1,0;;;;;;;;1,0;;;;;;;;;;;;;1,0;1,0;4,0;;;;;;;;;;;;;;;;;;;;;;;;;;;;;;;;;;;;;;;;;;;;;;;;;;;;;;2,0;;4,0;;;;;;;;20,0;;;;;1,0;;;;4,0;;;;;;1,0;;;;;;;;;;;;;;;;;;;;;;;;;;;;;36,0;;;;;;;;;;;;;;;;3,0;;;;3,0;;;;;;;;2,0;;;;;;;;2,0;;;;;;;;;;;8,0;5,0;;;;;;3,0;;;;;;;;;;;;;;;;;;2,0;;;;;;4,0;;;;;;;;;;;;;;;;;;;;;;;;;1,0;;;;;4,0;;;;;;;;;;;;;;;;;;;4,0;;;;;;;;;;;;;;;;;;;2,0;;;;;;;;;;;;;;;;;;;;4,0;1,0;;;;;2,0;2,0;;;;;;;;;;;;;;;;;;;;;;;;;;;;;;;;;;;;;;;;
address;;;;;;1,0;;20,0;;6,0;7,0;;3,0;;3,0;19,0;;;2,0;;;3,0;16,0;11,0;2,0;;1,0;2,0;;;15,0;;14,0;;44,0;2,0;;4,0;;;74,0;;;;16,0;;36,0;74,0;8,0;6,0;1,0;;1,0;;11,0;3,0;4,0;;;3,0;;;;5,0;1,0;;;3,0;21,0;;1,0;;38,0;15,0;;2,0;;;;55,0;;8,0;;58,0;;10,0;;;;;1,0;;3,0;;;;22,0;;41,0;4,0;;;;;;;1,0;2,0;112,0;4,0;;2,0;;;5,0;9,0;2,0;11,0;;6,0;;;10,0;11,0;2,0;;;;;;;9,0;;;;2,0;6,0;8,0;;;;;2,0;3,0;5,0;;;111,0;148,0;;4,0;;27,0;51,0;;2,0;19,0;;;4,0;;13,0;49,0;;;;28,0;;;;;;;16,0;;4,0;;;;;;;;;;42,0;;;;;;;;7,0;;1,0;2,0;;;;;;3,0;1,0;1,0;;;;1,0;;;;;;;;;;;;1,0;;;;;;;;10,0;;;;;;;;;;;2,0;;;;;;;1,0;22,0;66,0;;;;;;;;9,0;;;;;;;72,0;;;5,0;;67,0;;;26,0;;;;;22,0;;;;5,0;;3,0;;;11,0;;;;;;;;;;;;;;;;;;;2,0;;;;;;;2,0;;;;3,0;;3,0;;2,0;;;;;2,0;;;;;2,0;;;;;;;;;4,0;;;;;;;32,0;;;;;;;;2,0;;;;;2,0;;2,0;;;;;;;;;;4,0;;;5,0;;;;;;;;;;;;1,0;;;;;;4,0;;;;5,0;;;1,0;;;;10,0;;;;;;2,0;3,0;21,0;7,0;;;;;;;;13,0;;1,0;;;;;;;;;;108,0;7,0;1,0;;;4,0;;13,0;;;;;;92,0;3,0;4,0;;;2,0;;;;;;3,0;4,0;;;8,0;;;;;;;;;;;;;6,0;;11,0;;9,0;;;;;;;;1,0;;;1,0;;;;;;5,0;;;;;4,0;;1,0;;4,0;;1,0;;;;59,0;6,0;;10,0;;;;;;;;;2,0;;28,0;;;2,0;;;;1,0;3,0;;9,0;5,0;;;1,0;6,0;5,0;;;;;;;;;;;26,0;;;;;;1,0;;;;;1,0;6,0;;;;;3,0;13,0;;;;;;;;1,0;;;;;;;;;;;;;;;24,0;2,0;;;;;27,0;4,0;;;;;3,0;2,0;;;6,0;;8,0;;1,0;;;;73,0;;;1,0;21,0;;1,0;7,0;;;;;3,0;3,0;;;31,0;;;;10,0;;5,0;;;;;;;;2,0;;;;1,0;;;;;;;1,0;;;;;;;;4,0;1,0;;;;;;;;10,0;;;;;;;;;1,0;;;;;;;;;;;;;;;;;8,0;;;;21,0;;;;;2,0;;;2,0;;;;;;;;;;;;;;;;;;;;8,0;44,0;;;10,0;;;;;6,0;;;;;;;;;;;;;;;;;;;4,0;;;;;;16,0;4,0;;2,0;;21,0;;;;;;;;;6,0;;;;;;;;1,0;;6,0;;;3,0;;;;;;;;;;;;3,0;;;4,0;;;;;;;;;;;;;;;;;;;;;;;;;;;;;;;;;;;;;;;;;4,0;;16,0;;;1,0;;;;;;;;;;;;;;;;;;1,0;;;;;;;;1,0;;;;;;;;;;;20,0;;3,0;;;;;;;6,0;;;;;;1,0;;;;;;;;;;;;;;;2,0;;;;44,0;;3,0;;;;;;;;;8,0;;;;;;;;;;;;;;;;;2,0;;1,0;;;;;;;;;;;19,0;4,0;3,0;2,0;;;;;;;;;;;;;;;;;;;;;;;;;;;;;;;;
aircraft;;;;;;1,0;;9,0;8,0;1,0;;;;;2,0;16,0;;;;;;;;;;;1,0;;;1,0;;;10,0;;4,0;4,0;2,0;;;;7,0;;;;13,0;2,0;5,0;4,0;;2,0;;5,0;;;;;;;;;;;2,0;;;;;;;1,0;;;;;;;3,0;;;19,0;;1,0;;8,0;;;;;;;1,0;;;;;1,0;;;23,0;;;;;;;;;;;5,0;;;;;;1,0;3,0;23,0;;3,0;;;3,0;4,0;7,0;;;;;;;1,0;;;12,0;;;;;;;;;3,0;1,0;;;;22,0;;;;;;;;27,0;;;;;2,0;2,0;1,0;1,0;;3,0;3,0;;;;;;;;;;;;;;;;;;;;;;;;;;;;;;;;3,0;;2,0;;7,0;;;;;;;;;;;;;;;;;1,0;;;;;1,0;;;;;4,0;;;6,0;;2,0;4,0;;;;;1,0;;;;;;;;;1,0;;1,0;;;;13,0;;;;;;;1,0;;;;;;;;;;;;;;7,0;;2,0;;;1,0;;;1,0;;;;;42,0;;;;1,0;;;;;;;;2,0;;;;;;;;;;;;;;;;1,0;3,0;;;;;;;;;;;;;;;;;;6,0;;;;;;1,0;;;;;;;;;;2,0;;;;;;;;;;;;;;;;;;;;1,0;;;;;1,0;2,0;;;;;;;;;;1,0;;22,0;;;;;;;;;1,0;;;;38,0;;;;;16,0;1,0;;1,0;;5,0;;;;;;;;;;;1,0;;5,0;;;;1,0;;;13,0;;;;;;1,0;3,0;4,0;3,0;;;;;;;;;;;;1,0;;;;;;;;;;;;;;17,0;2,0;4,0;1,0;;1,0;;17,0;24,0;;;;;;;;;;;;2,0;;1,0;;;;;;;;;;;;;;;;;;;;;4,0;;;;;;;;;;;;;;;;;;;;;;;3,0;;;;;;1,0;;;;;;3,0;;;;;;;;;;;;;;3,0;;;;1,0;;;;3,0;;;;2,0;;;;;;;;;;;;;;;;;3,0;;;;5,0;;;;;;;1,0;;;;;;;;;;;;;;;;;;;;1,0;;;5,0;;;;;;;;;;;;;;;;;;2,0;;;;;;;;;;;;;;;;;;;;1,0;;;;;;;;5,0;;;;;;;;;;;;;;;2,0;;;;;;;;;;;;;;;;;4,0;;;;;;;;;;;;;;;;;;;;;;;;;;;;;;;;;;;;;;;;;1,0;;;;;;;;;;;;;;1,0;;;;;;;;3,0;;;;;;;;5,0;;;;;;;;;;;;;;;;;;;;;;;;;;;;;;;;;;;;;;;;;;;;;;;;;;;;;;;;;;;;;;;;;;;;;;;;;;2,0;;;;;;;;;;;;;;;;;;2,0;;;;;;;;;;2,0;;;;;;;;;4,0;;;;;;;;;;;;;;;;;;1,0;;;;;;;;;;;;;;;;3,0;;;;;;;;;;;;;;;;;;;;;;;;;;;;;;;;;;;;;;;;;;;;;;;;;;;;;;;;;;;;;;;;;;;;;;;;;;;;;;;;;
amplitude;;;;;;4,0;;6,0;;;;;4,0;;12,0;8,0;2,0;;4,0;;;;;1,0;;;;;;;1,0;;27,0;;26,0;7,0;;44,0;;;51,0;1,0;;;3,0;1,0;46,0;14,0;4,0;1,0;;;;;8,0;;11,0;;;;;1,0;11,0;;7,0;;8,0;5,0;;;3,0;;17,0;;;1,0;;2,0;4,0;42,0;;3,0;;5,0;5,0;2,0;2,0;;;;8,0;;1,0;3,0;2,0;;;4,0;12,0;;;;9,0;1,0;;;16,0;1,0;33,0;4,0;;15,0;;;;8,0;;12,0;;23,0;;;16,0;4,0;2,0;;;;;;;3,0;5,0;;11,0;;2,0;;6,0;;;;;8,0;;;;;38,0;;;;2,0;4,0;2,0;1,0;4,0;;1,0;4,0;;;41,0;7,0;2,0;;4,0;;;1,0;;;;;6,0;;;;;;;2,0;;;1,0;1,0;;;;;;;;;;;1,0;;;;;;19,0;;;;;;;;;;;;;;;;;;;;;;;;;;12,0;;;;1,0;;;;;;;;;;;;29,0;;;;17,0;;;5,0;;;;48,0;;4,0;;3,0;;;;;;;;;2,0;;;;;;;;1,0;;;9,0;1,0;;;;;15,0;;;;;;;5,0;;;;;;;;;;;;;;;;1,0;;;;;;1,0;10,0;;;;;;;;;7,0;;;;;;;;;;;41,0;;;1,0;;;;;3,0;10,0;;;;;5,0;;;;;;;;6,0;;;3,0;;;;;;;;;1,0;;;;;;;;;;;;;;;;16,0;;;;;;3,0;;;;;;13,0;;;1,0;;4,0;1,0;;;;5,0;;2,0;5,0;;1,0;;;;;;;;;;;2,0;;;;;;;;4,0;1,0;;;;;70,0;1,0;;;;;;;4,0;;;;;;;;;;;;1,0;;1,0;1,0;;;;;;;2,0;3,0;;;;;;;;;5,0;29,0;;19,0;;;;;;;1,0;6,0;;;;;;;;;;;;;;;;6,0;;;;2,0;;;;;;4,0;;;;;;;;;5,0;;;9,0;;;;;;;;;;;;;;;;;;;2,0;;;;;;;;;;;;;;;;;;2,0;;;;;;;;;;;;;;;;;;;;;16,0;11,0;;;;;;;;;;;;;;;;;;;12,0;;;;1,0;;;;;;;;;;;;;;;;;;;4,0;;;;;;;;;;;;;;;;;;1,0;;;;;4,0;;3,0;;;;;;;;;;;;3,0;;;;;;3,0;;;;;;;;;;;;;;;;;;;;;;;;;;;1,0;;;;;;;;;;;;;;;;;;;;;;;;;;;;;;2,0;;1,0;;;;;;;;;;;;;;1,0;;;;;;;;;;;;3,0;;;;;1,0;;;3,0;;;;14,0;;;;;;;;;;;;3,0;;;;;;;;;;1,0;;;;;;;;;;;;;2,0;;;;;;;;;6,0;;;;;;;1,0;;;;3,0;;12,0;;;;10,0;;;;;;;;;;;;;;;;;;;;;;;;;;;;;;;;;;;;;;1,0;;;;;;;;;;;;;;;;;;;;;;;;;;;;;;;;;2,0;;;;;;;;;;;;;;;;;;;;;;;;;;;;1,0;;;;;;;;;3,0;;;;;;;;;;;;2,0;;;;;;;;;;;;3,0;;;3,0;;;;;;;;;;;;;;;;;;;;;;;;;;;;;;1,0;;;;;;
annular;;;;;;2,0;3,0;1,0;4,0;4,0;;;;;9,0;3,0;;;;;;;;1,0;;;;;;;;;6,0;;;;;;;;;;16,0;;;;;11,0;1,0;;15,0;2,0;;;;5,0;9,0;;;;10,0;2,0;;;3,0;;;25,0;3,0;14,0;;;2,0;;;;;;;1,0;;;;12,0;;;;;;;35,0;;;1,0;;;;;1,0;;;;20,0;;;2,0;18,0;;;;1,0;;3,0;;;20,0;42,0;4,0;;;;;;;;;;;;;;;;;;;2,0;;;;;;;1,0;;;;13,0;;;;;;;;;2,0;;;;;4,0;;;;;;5,0;;;;;1,0;2,0;;3,0;8,0;16,0;;;3,0;9,0;;8,0;;;;1,0;;;;;;9,0;;1,0;;;;7,0;3,0;;;4,0;;9,0;;;;14,0;;4,0;4,0;;;;26,0;;;5,0;6,0;;15,0;;;7,0;4,0;;13,0;;20,0;;;16,0;10,0;1,0;;8,0;1,0;7,0;;;;;;;;;;;1,0;;1,0;1,0;;;8,0;1,0;20,0;;;;;;;;14,0;3,0;;;1,0;2,0;7,0;1,0;;;;8,0;;45,0;;;;1,0;;;;;;;;;;;26,0;;;;;;5,0;4,0;2,0;1,0;;2,0;;1,0;;1,0;;;;;1,0;;;;;11,0;;;1,0;;;;6,0;;1,0;2,0;;;;;;;;5,0;;;1,0;;;;;;1,0;20,0;;;3,0;;;;7,0;;;;1,0;;;1,0;;9,0;6,0;;;7,0;3,0;;;;;;;;16,0;;10,0;;;1,0;;;;;1,0;;3,0;5,0;5,0;;;;3,0;;;;4,0;;;;;2,0;;;;;;;;;;;;;;;;;;;;;;;;;;;;;;;;;;;;;;;1,0;;;;;;;;;;;;;;;;;;;;;;;;;;;;;;;;;;;;;;;1,0;;9,0;;;;;;;;;;;;;;;;;;;;;;;;;;;;;;;;;;;;;;;;3,0;1,0;;;;;;;;;4,0;;;;;;;;7,0;;;;;;;;;;;;;;;;;1,0;11,0;;;;;8,0;;2,0;;;;;;;;5,0;;;;;;;;;;2,0;;;;;;;;;;;;;;;;2,0;;;;;2,0;;;;;;;11,0;;;;;;;;;;;;;;;;;;;4,0;;;;;2,0;7,0;;;;;;;;;;;;;22,0;;;;;;;;7,0;;;;;;;;;;;;;;;;;;;1,0;;;;;1,0;;;4,0;;;;;;;;;;;;;;;;;;;;;;;;;;;;3,0;;;;;;;;2,0;6,0;;1,0;3,0;;;;;;;;;2,0;;2,0;;;;;;;;;;;;;;;;;3,0;;;;;;;;;;;;;;;;;;;;;;4,0;;;;;;;;;;;;;;;;;;;;;;;;;;;;;;;;;;;;;;;;;;;;;;;1,0;;;;;;;;;;;;;;;;;;;;;;;;;;;;;;;;;;;;;;;;;;;;;;;;;;;;;1,0;;;;;;;;;;;;;;;;;;;;;;;;;;;;;;;;;;;;;;;;;;;;;;;1,0;;;;;;;;;;;;;;;;;;;;;;;;;;;;;;;2,0;;1,0;;;;;;;;;;;;;;;;;;;;;;;2,0;;;;;;;;;;;;;;;;;;;;;
antenna;;;;;;2,0;;1,0;;14,0;;;;;1,0;2,0;3,0;;;;;3,0;;;;;;;;;1,0;;53,0;;1,0;7,0;;;;;6,0;;1,0;;13,0;;1,0;45,0;22,0;2,0;9,0;2,0;;;;;2,0;;;;;3,0;2,0;;;;;6,0;;4,0;;;42,0;;1,0;;;;;6,0;;8,0;;12,0;1,0;;;;;;2,0;;;4,0;;;;;3,0;;;;1,0;28,0;;;17,0;;;;;;;;;12,0;4,0;14,0;1,0;1,0;;;1,0;;17,0;;;;;;;7,0;5,0;;;3,0;1,0;;;;;;;3,0;;;;;11,0;;;;;1,0;;;18,0;;2,0;;;24,0;8,0;;;;;2,0;;;;;;;;;;;;;;;;;;2,0;;;;;2,0;;;4,0;;;;;;2,0;;1,0;;12,0;;;2,0;;;1,0;;;;;;;;;;;7,0;6,0;;;;;16,0;;88,0;;;;;2,0;;;;3,0;5,0;;;;;;1,0;;;;;5,0;;;;;;17,0;7,0;27,0;;;;;;;10,0;;;4,0;;;;68,0;;;;;;;1,0;2,0;;;;;;1,0;2,0;;;;;1,0;;;;;;;;;;1,0;;;;;;;;;;5,0;;;;;;;;17,0;;;;;;;;;;;;;;;;14,0;2,0;;;;;;;2,0;;3,0;;;4,0;;;1,0;;;;;;1,0;;;;;;;;4,0;;;;;;;;;;;;;;;;;;;;;;;;;1,0;1,0;;;;2,0;;;;;;;;7,0;;;;;;1,0;;;;;;2,0;;;;;;;;;;;;;;;1,0;;;;;;;3,0;;;;;;;;;;;;;;;;;;1,0;2,0;;;;;;;;;;;1,0;;;;;;;;;;;;;;;;;1,0;;;;;1,0;;;;;;2,0;8,0;;;;;6,0;;;;;;3,0;;;;;;2,0;;;;8,0;;;;;;;;;;;;;;;1,0;;;;;;;;;;;;;;;;;;;;;;;;;;;;2,0;;;;;;1,0;;;;;;;;1,0;;;;;;;;;;;3,0;;;;;2,0;;;;3,0;;;;;;;;3,0;;8,0;;;;;;;;;;;;;;;;;;;;;;8,0;;;;;;;;1,0;;;;;2,0;;;3,0;;;;;;;;36,0;3,0;;2,0;;;;;1,0;;;;;;;1,0;;;;;;;;;;;;;;;;;;;;;;;;;1,0;1,0;;;;;2,0;;;;;;6,0;;;;;;;;;;;;;;;;;;;3,0;;;;;12,0;;;;;;;;38,0;;;;;;;4,0;;;;;;;;;;;;;;;;;;;;1,0;;;;;;;;;;24,0;;;;;1,0;;;;;;;;;;;;;;;;;;;;;;;;;;;;;;;;;;;;;;;;;;;;;;;;;;;;;;;;;;;;;;;;;;;3,0;;;;;;;;;;;;;;;;;;;;;;;1,0;;;;;;;;1,0;;;;;;;;;15,0;;;;;2,0;;;1,0;;;;;;;;1,0;;;;;;;;;;;;;;;;;;;;;;;;;;;;;;;;;;;;;;;;;;;;;;;;22,0;;;;;;;2,0;;;;;;;;;;;;;;;;;;;;;;;;;;;;;;;;;;;;;;;;;6,0;;;;
apart;;;;;;1,0;4,0;1,0;;10,0;2,0;;1,0;;20,0;13,0;7,0;;;;15,0;6,0;;2,0;1,0;;1,0;1,0;1,0;;;;6,0;;;5,0;;;;;1,0;;8,0;;;;2,0;1,0;;;24,0;24,0;;;;7,0;16,0;;;;6,0;;;;1,0;1,0;4,0;8,0;9,0;10,0;;;;;;6,0;;;;11,0;;;;10,0;;;;;5,0;6,0;32,0;;;1,0;;;2,0;;4,0;;;;25,0;1,0;;;2,0;;;;;;;;;10,0;29,0;33,0;;23,0;2,0;18,0;;;1,0;;1,0;;;;;3,0;;;;;3,0;;;;;;;9,0;8,0;;;17,0;;;2,0;;;;;;2,0;;1,0;1,0;;;27,0;;;;4,0;;2,0;;1,0;;3,0;10,0;;;3,0;6,0;2,0;;1,0;3,0;;;;5,0;;2,0;;;;1,0;1,0;5,0;;1,0;;;;;;;;25,0;;5,0;;;;7,0;;;;;5,0;;2,0;;;25,0;11,0;;5,0;;;1,0;1,0;1,0;7,0;;19,0;5,0;4,0;16,0;3,0;1,0;1,0;5,0;6,0;8,0;;2,0;1,0;;;;3,0;;2,0;1,0;20,0;;;;;;10,0;3,0;2,0;;1,0;;1,0;3,0;7,0;;3,0;4,0;;;2,0;2,0;258,0;4,0;;16,0;;7,0;8,0;58,0;;;1,0;;;2,0;;;;;4,0;2,0;;;2,0;;3,0;;1,0;;;1,0;12,0;;5,0;6,0;3,0;;17,0;2,0;;2,0;;4,0;1,0;2,0;;4,0;;9,0;;;;;4,0;;;6,0;;;3,0;2,0;2,0;;;;3,0;4,0;2,0;11,0;;2,0;;;;;4,0;5,0;21,0;2,0;1,0;1,0;;;7,0;8,0;;17,0;;;;;;2,0;18,0;;;3,0;;;1,0;4,0;1,0;;;;3,0;;3,0;1,0;1,0;3,0;4,0;4,0;2,0;;2,0;;;12,0;;;;;2,0;;2,0;1,0;2,0;;;;;;;;;2,0;;;1,0;;;;;;;;;;;;;;;;;3,0;;;;1,0;3,0;;4,0;;;1,0;;;;;3,0;;;;;;;;;;;;;1,0;8,0;;;;;;;;;3,0;;1,0;;;;;;;1,0;;;;;;;2,0;;10,0;;;;;;5,0;;;;;;;1,0;;1,0;;;;;1,0;;;4,0;;;;;;;;;;;;;;;;4,0;;;;;2,0;;;;;;;;1,0;;;;12,0;;7,0;;;;;;;;;;;;;;;;;1,0;;;;;;2,0;;;;;;;;;;;;;1,0;;;;2,0;;;1,0;;;;;;;;;;1,0;;;;4,0;;5,0;;;;;;;2,0;;;;;3,0;;;;;;;;;;;;;;12,0;;;;;1,0;;2,0;;;;2,0;;;;;;;;;;;;;;;;;3,0;1,0;;;;;4,0;;;;2,0;;;5,0;;;;1,0;;;;;;;4,0;2,0;;;2,0;;;1,0;;;;1,0;;;;;;;2,0;2,0;7,0;3,0;;;3,0;;;;;;;;;;;13,0;;;;;;;;;;;;5,0;5,0;;2,0;;;;1,0;;;;;4,0;3,0;;;;;;;;;1,0;;;;;;;;;;;4,0;;;;;;;;;1,0;4,0;;;2,0;;3,0;1,0;;;;;;;;;;;;;;;;;;;;;;;;;;;;;;;1,0;;;;;;;;;;;;;2,0;;;;1,0;;;;;;;;;;;;;4,0;;;;;;;;;;;;4,0;;;;;;;;;;;;2,0;;1,0;;;;;;;;2,0;;1,0;;;;;;;;2,0;5,0;;;;1,0;;;;;;;;;;;;1,0;;;;;;;;1,0;;;;;;;;2,0;;3,0;;;;;;;;3,0;;2,0;5,0;1,0;;;;;;;;;;;;;;;;;;1,0;;;;;;;;;;;;;;;;;;;;;;;;;;;;;;;;;;;;;;3,0;;;;1,0;;;;;;;;;;;;;
aspect;;;;;;2,0;;7,0;6,0;;1,0;;1,0;;1,0;15,0;;;;;1,0;15,0;3,0;;;;;;;;1,0;2,0;12,0;;24,0;1,0;1,0;7,0;;;19,0;;3,0;;14,0;1,0;13,0;19,0;11,0;14,0;;3,0;3,0;;;;4,0;;1,0;;1,0;;;1,0;;11,0;;;13,0;1,0;;;;;;;3,0;;;54,0;;5,0;;17,0;;6,0;;;;16,0;3,0;;;;1,0;1,0;;;26,0;;;;6,0;4,0;1,0;;11,0;;;21,0;;;1,0;;;16,0;33,0;2,0;;1,0;;;5,0;8,0;2,0;1,0;;;;;;;2,0;;15,0;1,0;;2,0;;;;;;6,0;3,0;;;;;9,0;;;;;1,0;;23,0;;6,0;;3,0;1,0;8,0;;;4,0;20,0;6,0;;;;;;2,0;3,0;;2,0;1,0;;;1,0;;1,0;;;1,0;;12,0;;;;;;2,0;;1,0;;;;;;;;6,0;;;;;;;;1,0;;;;;;;;;7,0;;;;1,0;;;;;;5,0;;;1,0;;;2,0;;;1,0;;1,0;;;;;;;3,0;4,0;;;;;;;2,0;;;;;;;5,0;;;;;;;;9,0;;;;;;2,0;;14,0;4,0;;;;;;;4,0;;;2,0;13,0;1,0;;;;;;;;1,0;;;;;;;;;;;1,0;1,0;;2,0;;;;;2,0;;;1,0;;;;1,0;;;1,0;;;;;;;1,0;;;;;;;;;;;;;;;1,0;;;;;;3,0;1,0;;;;;;;;;;;;;;;;;;;;;;;;;;;;;;;;;5,0;;;;;;;;;;;;2,0;;;;;;3,0;2,0;;2,0;;8,0;;;;;;;4,0;2,0;;;;9,0;2,0;;;;18,0;;;1,0;;4,0;;1,0;;;39,0;1,0;2,0;;;8,0;;;;;;;;;4,0;;1,0;;;;1,0;;;;;;;7,0;;;;;;24,0;;;;;1,0;4,0;;;1,0;;;10,0;;5,0;3,0;;3,0;;;;;;;2,0;;3,0;;;;1,0;;;;;;;4,0;;;;;;;21,0;26,0;;1,0;;1,0;;;;1,0;;;1,0;;5,0;;;;9,0;;;1,0;;;;;6,0;;193,0;;;;;;;4,0;;;;;;;;;;;;4,0;;;;;2,0;1,0;2,0;;;;;;;;;;;;;;;5,0;;;;;;1,0;;1,0;;;;;;;2,0;;;1,0;;;;;;;;;;;2,0;;;;;;;3,0;2,0;;;;;;;;;1,0;2,0;;;;;;;;;;;1,0;;;1,0;1,0;;1,0;;;;;;;;;;;;;1,0;;;;;;;;;1,0;;;;;;;;;2,0;;;10,0;;;;;;;;;;;;;;;;;;;;3,0;;;;;;;;;;;;;;;;;;;;;;;;;;;4,0;;;;1,0;;;;;;;;;;;2,0;;;;;;;;;;;1,0;;;;;;;;;;;;;;2,0;3,0;;;;;6,0;1,0;;;;;;;6,0;;;;;;;;;;;;;;;;;;1,0;;;;;;;;;4,0;;;1,0;;2,0;;;;;;;;;;;;;;;;;;;;;;;;;;2,0;;;;;;;;;;;;;;;;;;;;;;;;;;;;;;;;;;;;;;;;;;;2,0;;;;;;;;;;;;;;;2,0;;;;;;;1,0;;;;;;;2,0;;;;;;;;;;;;;;;2,0;;2,0;;;;;5,0;;;;;;;;;;;;;;;1,0;4,0;;;4,0;;;;;;;2,0;;;;;;;;;1,0;;;;;;;;;3,0;;;;;;;;;;;;;;;;;
assign;;;;;;3,0;4,0;2,0;19,0;2,0;;;3,0;;1,0;23,0;;;;;;10,0;;6,0;;;25,0;;;;5,0;;15,0;;27,0;3,0;3,0;4,0;;;44,0;2,0;1,0;4,0;4,0;;9,0;54,0;2,0;7,0;;5,0;2,0;;;2,0;6,0;1,0;1,0;;;;3,0;31,0;7,0;;2,0;;13,0;1,0;15,0;;6,0;2,0;;38,0;13,0;;;98,0;;3,0;;20,0;2,0;7,0;2,0;;;2,0;11,0;2,0;;;;5,0;1,0;8,0;47,0;2,0;1,0;3,0;11,0;23,0;;2,0;22,0;60,0;12,0;11,0;;7,0;;;9,0;50,0;8,0;11,0;1,0;15,0;;;2,0;14,0;3,0;7,0;2,0;;;1,0;;51,0;1,0;;;;9,0;;1,0;;;;3,0;36,0;5,0;;;;11,0;3,0;4,0;;7,0;13,0;11,0;;7,0;;;;3,0;1,0;38,0;;1,0;;9,0;7,0;;;2,0;;;1,0;;;;;;;;;;;;;;3,0;;;;;;;5,0;;4,0;;;1,0;;;5,0;3,0;2,0;;1,0;3,0;3,0;1,0;;4,0;;;;1,0;;;;;;1,0;;;;3,0;;;2,0;;3,0;;;;;;5,0;1,0;;;;3,0;;;;;;;62,0;2,0;;;;;;2,0;2,0;;;;;;;6,0;1,0;;;;;;;;3,0;;;;7,0;;;2,0;;;1,0;;;21,0;;1,0;3,0;;4,0;;;;;;24,0;;;;;;;;;;;9,0;;;;1,0;1,0;;;1,0;;;;;;;;;;;;;;;;;;;;;;;;;;;;1,0;1,0;;;2,0;;1,0;;;;;;;;24,0;;1,0;;;;;;;;;;;2,0;;;;;;;;;;;;1,0;;;;;;;;;24,0;12,0;;;1,0;;;13,0;;;;;;3,0;;;;;2,0;3,0;11,0;;6,0;;;;;;;;1,0;2,0;4,0;6,0;2,0;1,0;11,0;;;;3,0;;;12,0;;3,0;;;;9,0;;;;;2,0;2,0;1,0;1,0;;;;;;5,0;7,0;2,0;;;;;2,0;;2,0;;;;;24,0;18,0;1,0;;;1,0;5,0;;3,0;;;1,0;1,0;2,0;;1,0;;3,0;2,0;1,0;;;;;;;;;;;1,0;2,0;2,0;;2,0;2,0;25,0;;;;2,0;;;;;;;;;2,0;;;2,0;;;;;1,0;;;3,0;1,0;;;4,0;;;;9,0;16,0;;;;;;;1,0;;2,0;5,0;;6,0;1,0;;1,0;;16,0;;;;;;1,0;2,0;6,0;4,0;;;;;;2,0;;1,0;5,0;;;;;;;7,0;1,0;;1,0;;;1,0;;1,0;1,0;2,0;1,0;;;;;;;2,0;;;;;22,0;3,0;;2,0;;;;;;1,0;;;;7,0;;1,0;;;;;;23,0;1,0;;35,0;;;;;;;;;;;1,0;;;4,0;;;3,0;1,0;;3,0;;;1,0;;;;;;;;;;;;;;;;;;;;;;;2,0;;;;;;;;;;;;;;;;;;;;;;;;;;;;;;1,0;;;;;;;;;;;;;;;;;;;;;;57,0;;;;;1,0;;;;;;;;;;;;;;3,0;;;;;;;;;;;;;;;;1,0;;;;;;;;;;;;;;;;1,0;;;5,0;2,0;16,0;;;;;2,0;;27,0;2,0;30,0;;;;;;;;;;;8,0;;;;;5,0;;;4,0;2,0;;;;;;;3,0;;;;;;2,0;2,0;;;;;;;;;;;;;;;;;;;;1,0;1,0;1,0;;;;;3,0;2,0;;1,0;;21,0;;2,0;4,0;;;;11,0;6,0;;1,0;;;;;;;;;;;;;;;;;;2,0;;;;;;;;1,0;;2,0;;;;2,0;;;;;;1,0;3,0;;;;;;;;;;;;1,0;;3,0;4,0;;;;11,0;;;;2,0;4,0;;;;1,0;;;;;;;;;;;;;;;;;;;1,0;;;;;;;;;;;;1,0;1,0;;2,0;;;;;1,0;1,0;;;;5,0;;;;;;;;;;;;;;;;;;;;;;;
auxiliary;;;;;;5,0;3,0;20,0;4,0;31,0;;;;;2,0;24,0;;;;;2,0;4,0;3,0;1,0;;;24,0;;;;;;30,0;;15,0;35,0;;;1,0;;9,0;;1,0;;7,0;1,0;6,0;93,0;6,0;79,0;;7,0;;1,0;;;49,0;;;;;85,0;;;;3,0;3,0;22,0;5,0;;1,0;;4,0;;;;;;;48,0;;;;33,0;1,0;;;;;3,0;27,0;;;;1,0;;2,0;;10,0;3,0;;;7,0;30,0;;;7,0;1,0;12,0;1,0;;5,0;;;;8,0;16,0;8,0;4,0;8,0;;;;3,0;2,0;;;;;1,0;2,0;9,0;2,0;;3,0;2,0;;1,0;;;1,0;;;5,0;2,0;;;1,0;6,0;4,0;;;2,0;8,0;2,0;13,0;17,0;;2,0;;;;14,0;;;;5,0;3,0;;1,0;3,0;;;;;;;;;;1,0;5,0;;;;1,0;1,0;1,0;;;;;;11,0;;1,0;1,0;;1,0;;;1,0;;4,0;;;2,0;;1,0;;13,0;;1,0;;;;2,0;;;1,0;;;;;27,0;;8,0;;200,0;;1,0;;;12,0;1,0;5,0;3,0;3,0;1,0;3,0;5,0;;;4,0;;;;;12,0;;25,0;;;;;;6,0;;;1,0;;;;3,0;;;1,0;;6,0;;;122,0;;;;;;2,0;3,0;4,0;;;1,0;;;2,0;;;;6,0;2,0;2,0;;;;;;;;;1,0;;;;;2,0;;;;3,0;;;;;1,0;;;2,0;1,0;1,0;;;;6,0;;;;;1,0;;;;;;;;2,0;4,0;;;;;1,0;4,0;;;;1,0;1,0;;;1,0;6,0;18,0;;;;4,0;1,0;2,0;;;;3,0;;1,0;;;;;;;1,0;;;;;;;2,0;11,0;;11,0;1,0;;;;1,0;;5,0;;;1,0;;11,0;;;;;;;;;1,0;;;;;8,0;2,0;8,0;1,0;1,0;;;;1,0;;;;;;;6,0;;;;;;;;3,0;11,0;;;;2,0;1,0;;;2,0;;;;;3,0;;2,0;2,0;;4,0;;;;2,0;5,0;;;;;;;;;;;;;;;;1,0;;;;;;;18,0;;7,0;;1,0;1,0;;;;;2,0;2,0;;;;;;;;1,0;15,0;3,0;2,0;2,0;;3,0;3,0;;1,0;;;;3,0;7,0;;;;;;;;;;6,0;;14,0;;;3,0;;;;;2,0;;;13,0;;3,0;;;1,0;;;;;2,0;5,0;;;;1,0;;;;;;;;2,0;;;;;;;1,0;;;2,0;;;;;;;;;;;;;1,0;;;;39,0;;;;;;;;;;;;;;;;1,0;;;;;;;;;;2,0;;;;;;;;;;;;;;;;;;;;;;;;;;;;;;;;;;;;;;;;;1,0;;;;;;1,0;;;;;;1,0;;;;;2,0;;;;;;;;;;;;;;;;;;;7,0;;;;1,0;;;;;;3,0;;;;;;;;;;;;1,0;;;;;;;;;1,0;;1,0;;3,0;;;;;2,0;;;;;;;10,0;;;;;1,0;5,0;;;;;;;;;;;;;;;;;;;;;;;;;;;;;;;34,0;;1,0;1,0;;;;;;;;;;;;1,0;;;;;;;;;;;;;;;2,0;;1,0;;;;;;;;;;;;;;;;;;;1,0;;;;;;;;;;;;;;;;;;;;;;;;;;;;;;;;;;;;;;;;1,0;;;16,0;;;;;;;;;;;;;;;3,0;;1,0;;3,0;;;;;;;;;;2,0;;;;11,0;;;;;;;;;;;;;;;;;;2,0;;;1,0;;;;;;;;;35,0;;1,0;;;;;;;;;;;;;;;;;;1,0;;;;;;;;;;;;;;;;;;;;;;;;;;;;;;;;;;;;;;;;;;;;;;2,0;;;;;
barrier;;;;;;1,0;2,0;6,0;5,0;19,0;;;2,0;;5,0;;;;;;;;;3,0;;3,0;4,0;;;;;;37,0;;24,0;6,0;;;;;;1,0;;3,0;6,0;2,0;;27,0;;;8,0;7,0;;;14,0;2,0;;;;;3,0;;;;33,0;;;19,0;12,0;2,0;2,0;4,0;6,0;;;16,0;;;4,0;24,0;;2,0;;30,0;;2,0;;;4,0;;28,0;;;4,0;;;;;12,0;3,0;2,0;;;;;4,0;57,0;;4,0;;3,0;4,0;;;;12,0;25,0;12,0;;;1,0;;1,0;1,0;;;;;2,0;;;;2,0;;;;;3,0;;;;;;3,0;;;;8,0;8,0;;;;;1,0;;;10,0;;;13,0;;16,0;42,0;;;;2,0;;;3,0;;4,0;;5,0;;3,0;;12,0;;;;1,0;;;9,0;;;;;;;;;1,0;1,0;14,0;;;1,0;11,0;;;;19,0;;5,0;6,0;;;2,0;3,0;;12,0;14,0;4,0;;;;12,0;6,0;8,0;1,0;1,0;;;3,0;64,0;;13,0;;58,0;22,0;1,0;2,0;11,0;13,0;12,0;30,0;;1,0;11,0;;8,0;3,0;;1,0;19,0;2,0;;6,0;;;6,0;;;;1,0;;;;;;;4,0;6,0;;;3,0;;;2,0;1,0;;;;10,0;;2,0;8,0;20,0;;;2,0;5,0;1,0;1,0;;;;14,0;4,0;1,0;;;;;;;;;;;;;;;;;6,0;;;;;;21,0;;;;;8,0;;;1,0;;34,0;;;;;;;;4,0;;;;;;3,0;;;;18,0;;2,0;;;;;;1,0;;;1,0;;;;2,0;;2,0;;2,0;;;;;;;;;;;;2,0;1,0;;5,0;2,0;8,0;5,0;;;;7,0;2,0;;;;;2,0;4,0;;;;;1,0;;;6,0;;;;1,0;;;;;;;;;;;;2,0;;;;;1,0;;;;;;;;;;;;;2,0;;;;;;3,0;;;3,0;;;1,0;;;4,0;;;2,0;;;;;;11,0;;;;7,0;;;;;;;;;;;;;;1,0;;;;7,0;;;;;6,0;;;;;;;1,0;1,0;;;;1,0;;;;;19,0;;;7,0;;;6,0;;;;;1,0;;;;;;;;;;;;;;;;;;;;;;;;;;;;;;5,0;;;;1,0;;;3,0;;;;;;;2,0;;;;;;;;2,0;;;;;;;;;;;;;;1,0;;;;;;;;;;;;3,0;;;;;1,0;;;;;;6,0;;;;;;;;2,0;;;;;;;;;2,0;;;;;;;;;62,0;;;;;;;6,0;;;;;;;1,0;;;;;;;3,0;;;;2,0;;;;;;;;;;;;;16,0;;;2,0;;;2,0;;;;;;;;;;1,0;;;;1,0;2,0;1,0;;;;;;;;;;;59,0;;;;;;;5,0;;;;;;;;;2,0;;;;;137,0;;;;;;;1,0;4,0;;;1,0;;;;;;;;;;;;;2,0;1,0;;;;;;;;;;2,0;;;;;19,0;3,0;1,0;;;;;;;2,0;6,0;;1,0;2,0;;;;;;;;;;;;;;;;;;;;;5,0;;;1,0;12,0;;;;;;;;;;1,0;;;;;;;;;;;;;;;;;;;;;;;;;;;3,0;;;;;;;;;;;;;;;;;;;;;;;;;;;;;;;;;;;;;;;;;;;;;;;;;;;;;;;;;;;;;;;;;;1,0;;;6,0;;;;;;;;;;3,0;;;1,0;;;;1,0;;;;;;;;;;;;;;;;;;;;;;;;;;;;;1,0;2,0;;;;;;;;;;;;;13,0;;;;;;;;;;;;;;;;;;;;;;;;9,0;;;;;;;;;9,0;;;;
bias;;;;;;11,0;15,0;12,0;;12,0;;;;2,0;4,0;1,0;;;;;2,0;;;3,0;;;1,0;;;1,0;;;51,0;;34,0;;;39,0;;;1,0;1,0;3,0;1,0;;;18,0;68,0;5,0;1,0;6,0;;;;18,0;;8,0;5,0;1,0;;2,0;;;;;;5,0;11,0;14,0;6,0;4,0;;22,0;;;2,0;;1,0;;14,0;;37,0;;78,0;3,0;;3,0;;2,0;2,0;61,0;;;1,0;;;;;4,0;1,0;;;14,0;4,0;;;3,0;;19,0;1,0;1,0;2,0;;;;12,0;38,0;63,0;1,0;10,0;3,0;;;;;;;;;2,0;;11,0;4,0;;;;3,0;3,0;41,0;;;;;12,0;1,0;;;5,0;32,0;1,0;1,0;;;;;36,0;3,0;;2,0;1,0;;;81,0;;;;;14,0;;;;;;;;10,0;16,0;6,0;;;4,0;26,0;;;6,0;67,0;;12,0;;;7,0;1,0;;18,0;2,0;19,0;;;;5,0;;;5,0;67,0;2,0;16,0;;;;3,0;;;49,0;15,0;;;2,0;;;2,0;47,0;;1,0;;;;;5,0;5,0;;199,0;;21,0;16,0;15,0;32,0;9,0;1,0;7,0;4,0;;4,0;13,0;2,0;;;;;11,0;1,0;14,0;;1,0;3,0;;2,0;8,0;2,0;;;18,0;;2,0;22,0;4,0;;1,0;;5,0;;12,0;16,0;1,0;;2,0;103,0;;26,0;14,0;18,0;6,0;;2,0;;;;;;;1,0;9,0;1,0;5,0;;4,0;;;8,0;5,0;1,0;14,0;1,0;8,0;1,0;7,0;;;;1,0;;;5,0;;;1,0;;9,0;6,0;;12,0;;;;3,0;3,0;;16,0;10,0;;;;;;;;;;2,0;12,0;1,0;;;;1,0;3,0;2,0;6,0;2,0;1,0;4,0;;3,0;;6,0;;3,0;;2,0;3,0;;;6,0;;2,0;5,0;;;3,0;;;2,0;9,0;;;1,0;;7,0;;2,0;9,0;4,0;3,0;1,0;26,0;1,0;;;2,0;;;;;;;;2,0;;;2,0;;;;;;1,0;;;1,0;;;;;5,0;;;;;;3,0;;;;2,0;;;;;;;;;5,0;;2,0;;;;;;;;;2,0;;;10,0;6,0;;;5,0;;;;;;;;;;;1,0;;;;;;;;;;;;;;2,0;;4,0;;134,0;;;;;18,0;;;;1,0;;;;;;;;3,0;;;;;54,0;;;;;;1,0;;4,0;;1,0;;;;;;;;;;;;2,0;;;;;1,0;;;;;;1,0;2,0;;;;;4,0;;;;;;;;;6,0;;;;;;;1,0;;;6,0;2,0;;;;;3,0;;;;;;;;;2,0;;;2,0;2,0;;;;;;;;4,0;;;;;;;;1,0;;;;;;11,0;;;;;;;;;;;1,0;;;;;;;;;;7,0;;;;;;1,0;;;;3,0;;;1,0;;;;2,0;;;;;;;;;;1,0;;;2,0;;;1,0;;;;;;2,0;43,0;;;;5,0;;;7,0;;6,0;;1,0;;;;2,0;;;;;2,0;;;;;;;;;;;;;;;;;6,0;2,0;;;;;;;6,0;2,0;1,0;10,0;;3,0;;;;;;;;1,0;;6,0;6,0;;;5,0;8,0;2,0;1,0;;;;;;;;;;;;10,0;;;;1,0;4,0;2,0;;2,0;;;2,0;;;;;20,0;;;;;;;;7,0;;;;;;;;1,0;;1,0;;6,0;;1,0;;;5,0;;;;;;;;;;;;38,0;1,0;;;;;;;;;;;;;;;;;;;;;;2,0;;;;;;;;;;5,0;;;;;;;;;;;;;;;;;;;;;3,0;;;;;;;;5,0;;;;;;;;;;;;;;;;;;;5,0;;;;1,0;;;;;;;;;;;;;;;;;;;;;7,0;;;;;;;;;;;;;;;;;;11,0;;;;;;;8,0;;;;17,0;;;;;;;;;;;;;;;7,0;;;;;;1,0;3,0;3,0;;;;;;;;;;;;2,0;;;;;;;;;;;;;;;15,0;;;;;;;;;;;;;;;;;;;;;;
buffer;;;;;;1,0;;20,0;41,0;6,0;6,0;;26,0;;1,0;10,0;;;;;;48,0;2,0;;;;6,0;2,0;;;2,0;1,0;19,0;;12,0;6,0;1,0;3,0;5,0;;224,0;;1,0;2,0;11,0;4,0;14,0;44,0;51,0;10,0;6,0;;;;;1,0;;;4,0;;;;;20,0;11,0;;3,0;15,0;103,0;;1,0;;2,0;;;3,0;15,0;;;310,0;;4,0;4,0;25,0;;2,0;1,0;;;;4,0;;;5,0;4,0;9,0;199,0;1,0;41,0;;;;29,0;;;5,0;;1,0;33,0;1,0;1,0;5,0;;3,0;;14,0;18,0;1,0;3,0;28,0;2,0;;35,0;32,0;15,0;1,0;;;;1,0;;7,0;2,0;;2,0;5,0;1,0;15,0;1,0;2,0;1,0;;;9,0;;;;6,0;17,0;26,0;;;33,0;142,0;5,0;;34,0;;;8,0;2,0;7,0;66,0;;;;127,0;1,0;;;;;;;6,0;1,0;2,0;2,0;;;;;;;;4,0;;2,0;;;11,0;5,0;;41,0;;;6,0;;;;;;;2,0;;;;;;1,0;;;;;;;;;;1,0;1,0;;1,0;;;;6,0;;2,0;;7,0;;;;;;19,0;1,0;1,0;1,0;;;2,0;3,0;;;;5,0;27,0;;;;;;1,0;;28,0;;;;;;;10,0;;;;2,0;;1,0;;5,0;8,0;;;6,0;;3,0;1,0;2,0;9,0;;11,0;;;25,0;;;;;;;;;3,0;;3,0;;3,0;;;1,0;2,0;;;;;;;;1,0;;15,0;;;;;;;2,0;;;;;;;;;;;;;;;;;2,0;;1,0;1,0;;;;2,0;1,0;;;;6,0;2,0;;;;1,0;;;;;2,0;;;2,0;;;;;;;;;;;;1,0;;;;;;;;;;;;;;;;1,0;;1,0;;;;2,0;1,0;;;;;;;11,0;;;;;;;;3,0;13,0;1,0;;;;2,0;;1,0;;;;1,0;1,0;5,0;2,0;;;;;21,0;2,0;;;;;1,0;1,0;;1,0;15,0;;;3,0;2,0;9,0;;;4,0;;;;;13,0;59,0;;7,0;;8,0;1,0;2,0;;;;;;1,0;5,0;;;;1,0;;2,0;1,0;;;;;6,0;;4,0;;;1,0;;;2,0;;;;5,0;;;;;;11,0;;;;;;4,0;;1,0;;9,0;1,0;1,0;;;;1,0;;;3,0;;;;;;2,0;;;;;;7,0;;7,0;1,0;5,0;;;;;4,0;8,0;;;;;;2,0;;3,0;;5,0;;;;;3,0;;;;;;2,0;;;1,0;20,0;1,0;2,0;3,0;1,0;;;;;;1,0;;;;4,0;;;;;7,0;1,0;;;7,0;;;;5,0;;;;;;;;;;;8,0;;;;;;1,0;;3,0;;2,0;;6,0;;;;;;2,0;1,0;;;;1,0;1,0;1,0;;;;;4,0;5,0;1,0;1,0;;;;1,0;;;;;;;;;;;;9,0;2,0;;;;1,0;2,0;;;;;;;2,0;;;;;;23,0;;;;;;;;;;;;9,0;;;;2,0;5,0;;;;1,0;;;;;;;;;;;;;;;4,0;;;;;;;;;;;;;;;;;;3,0;;4,0;2,0;;1,0;;2,0;2,0;;;;;2,0;;;;;;;;;;;;;;;;;2,0;;;;3,0;;;;;;;;;;;1,0;;;5,0;3,0;;3,0;;;;;;;;;2,0;1,0;8,0;;;8,0;;;8,0;4,0;;;;;;;;;;;7,0;;;;;;;1,0;;;;;;;;;;;;;;;;;;;;;;;5,0;;;;;;;;1,0;;;;;;;;;1,0;1,0;;2,0;;;;;;;;2,0;;;;;;;;;;;;;;;1,0;;;;;;;;;;;;;;;;;;;;;;;;;3,0;;;;;;;;;;1,0;;;;;;;;;;1,0;;;;;3,0;;;;;7,0;;;;;;;;;;;;;;;;;5,0;;;;;;;;;;;;;;;12,0;;1,0;;;;;;;;;;;;;3,0;5,0;;;1,0;;;;;;;;;;;;;;;;
cable;;;;;;14,0;;4,0;10,0;3,0;;;6,0;;9,0;16,0;;;;;;2,0;6,0;3,0;1,0;;1,0;1,0;2,0;1,0;10,0;;18,0;;53,0;4,0;;1,0;1,0;;11,0;1,0;;;15,0;5,0;2,0;40,0;3,0;11,0;19,0;1,0;;;16,0;2,0;6,0;;;;25,0;6,0;;;3,0;;;25,0;2,0;8,0;;;1,0;;;2,0;;;1,0;20,0;;11,0;;56,0;1,0;1,0;;;;5,0;15,0;;;1,0;;;;;12,0;;;;28,0;;;;5,0;1,0;8,0;;1,0;6,0;;;;6,0;50,0;5,0;24,0;;4,0;;;;;;;;;;;;;;;;;4,0;;;;;;15,0;;;;3,0;45,0;1,0;;;;3,0;;15,0;60,0;;4,0;1,0;;19,0;61,0;12,0;;1,0;29,0;1,0;;;1,0;;;2,0;3,0;;31,0;1,0;;;13,0;3,0;;;1,0;19,0;;16,0;;;;1,0;;197,0;;8,0;;;;8,0;1,0;;;10,0;;2,0;5,0;;;1,0;;10,0;1,0;;2,0;;;;;;19,0;;2,0;;;13,0;;;6,0;;21,0;11,0;;12,0;6,0;;;6,0;;6,0;;;10,0;;;;;;;;5,0;;;;1,0;;30,0;;;;;;2,0;;;;3,0;5,0;;;;2,0;;;;7,0;;15,0;;13,0;14,0;;2,0;;;;;1,0;1,0;;5,0;5,0;;;4,0;;4,0;;25,0;;3,0;;16,0;;6,0;;1,0;5,0;1,0;;;8,0;;2,0;1,0;;;24,0;;22,0;1,0;1,0;;17,0;;2,0;3,0;;;6,0;;6,0;;1,0;;;8,0;3,0;1,0;3,0;;;4,0;1,0;;10,0;3,0;3,0;;;;4,0;;;;2,0;7,0;4,0;2,0;;;;2,0;1,0;2,0;4,0;;8,0;8,0;;2,0;;2,0;;;2,0;;1,0;2,0;2,0;;;5,0;23,0;1,0;;;;;16,0;1,0;2,0;1,0;;4,0;9,0;3,0;1,0;;;;;;2,0;5,0;;;;;;;;;;;3,0;;;1,0;;;1,0;;;;1,0;;;;;;;7,0;;;;;2,0;;;;;;;1,0;3,0;3,0;;;;1,0;;;1,0;;;3,0;;;;1,0;;;;1,0;;;;;2,0;;;;;1,0;2,0;;;;2,0;5,0;2,0;;5,0;;;;;;;;;;1,0;;;;1,0;14,0;;4,0;3,0;;;;;;;;;;;;1,0;1,0;;;;;1,0;;;18,0;1,0;1,0;;2,0;;;5,0;;;1,0;42,0;;;;;;;;;;;;;;;1,0;;1,0;;;;;1,0;;3,0;;2,0;;14,0;;;;;2,0;10,0;;;;;2,0;;;4,0;1,0;2,0;;;;;;6,0;;;;;2,0;2,0;;;;3,0;;;;;3,0;;5,0;;3,0;;;3,0;;;;;;;;7,0;20,0;;;;;;;1,0;1,0;;;;10,0;;1,0;;;;;1,0;;;;2,0;1,0;;;;2,0;;;;;16,0;;;;9,0;;;4,0;1,0;;;4,0;;3,0;;;2,0;;;;;;;;3,0;;;;24,0;;39,0;12,0;;1,0;;22,0;;;;1,0;1,0;;1,0;10,0;;;;;;;;6,0;;;;2,0;;1,0;1,0;;;4,0;1,0;1,0;;;3,0;;7,0;;;;;;8,0;;;;1,0;1,0;;;1,0;;;;;;;21,0;3,0;;;;;;;1,0;7,0;;1,0;;;;;;2,0;1,0;;6,0;;;;;;;;;;;;;;;;;1,0;;;;;;;;;;;;;;;;;;;;;;;;;;;;7,0;;;;;;;;;;;;;;;;;4,0;;;;;;;;;;;;1,0;;;;;;;;;;;;1,0;;;;;;;2,0;;;;;;;;;;;;;;;;;;1,0;;;;;;;;1,0;;;;1,0;;;;;;;;;;;;;;7,0;;;;;;2,0;1,0;;8,0;;;1,0;;4,0;;;;;;3,0;;;;;;;;;3,0;1,0;1,0;;2,0;;;;;;;;;4,0;;;;;;;;;;1,0;;;;2,0;;;;;;;;;;;;;;;;;;1,0;;;4,0;;;;;;;;;;;;;;;;;;;;;;;;;;;;;
carry;;;;;;1,0;6,0;6,0;2,0;5,0;;;1,0;;;24,0;;2,0;;2,0;;3,0;2,0;4,0;;;5,0;3,0;;;16,0;2,0;34,0;;60,0;13,0;6,0;41,0;;1,0;29,0;;3,0;;7,0;16,0;5,0;67,0;6,0;11,0;8,0;4,0;1,0;1,0;30,0;;9,0;;4,0;2,0;6,0;;1,0;;3,0;3,0;3,0;7,0;15,0;6,0;15,0;2,0;9,0;;;3,0;;4,0;5,0;142,0;;12,0;1,0;35,0;2,0;10,0;;;5,0;2,0;28,0;;;4,0;1,0;4,0;2,0;;49,0;4,0;;1,0;20,0;5,0;;;4,0;10,0;15,0;5,0;;7,0;3,0;2,0;7,0;15,0;43,0;8,0;23,0;5,0;1,0;;6,0;75,0;17,0;12,0;;;;1,0;;8,0;5,0;2,0;;29,0;4,0;1,0;15,0;;4,0;;;37,0;3,0;6,0;;22,0;85,0;1,0;;;1,0;7,0;14,0;1,0;27,0;;4,0;14,0;5,0;1,0;71,0;8,0;;;24,0;1,0;;;5,0;;;20,0;6,0;;14,0;5,0;;;;19,0;;;1,0;20,0;;17,0;;;;2,0;;13,0;;6,0;1,0;;;1,0;;2,0;4,0;6,0;7,0;1,0;1,0;1,0;22,0;15,0;5,0;1,0;;;2,0;;3,0;3,0;;1,0;47,0;;1,0;;;1,0;13,0;;23,0;;18,0;1,0;;15,0;1,0;6,0;12,0;22,0;;4,0;3,0;3,0;;11,0;13,0;;9,0;;32,0;6,0;12,0;;;;;;16,0;2,0;;;;;3,0;5,0;4,0;2,0;5,0;3,0;34,0;;1,0;6,0;;;;;2,0;2,0;16,0;44,0;2,0;1,0;;;2,0;17,0;1,0;1,0;;;12,0;9,0;;;3,0;2,0;2,0;;;;3,0;1,0;;;3,0;4,0;;9,0;3,0;;;34,0;3,0;;9,0;2,0;;10,0;;17,0;;1,0;;2,0;27,0;1,0;5,0;5,0;;;1,0;9,0;;;;4,0;3,0;1,0;1,0;4,0;;;;;;6,0;12,0;4,0;1,0;6,0;;3,0;6,0;16,0;;2,0;3,0;28,0;;;;;;;;;;3,0;;;;;3,0;2,0;;;9,0;;5,0;;11,0;;7,0;5,0;;;;;;3,0;;;;3,0;14,0;2,0;;;5,0;;;;1,0;11,0;1,0;3,0;;;3,0;3,0;4,0;5,0;2,0;;1,0;;;;1,0;;;;;;;;;;3,0;;1,0;1,0;16,0;3,0;3,0;;8,0;2,0;14,0;;1,0;5,0;2,0;3,0;1,0;6,0;50,0;;;14,0;4,0;;;;2,0;4,0;;;1,0;;4,0;;;1,0;;;;;1,0;;;;3,0;1,0;17,0;;3,0;;2,0;;2,0;;;3,0;4,0;30,0;;1,0;1,0;;10,0;1,0;;2,0;;4,0;5,0;;1,0;1,0;10,0;1,0;;2,0;4,0;;;;59,0;2,0;;;;;;;;2,0;1,0;;;1,0;1,0;10,0;;;;14,0;;1,0;;2,0;21,0;22,0;1,0;;1,0;2,0;;;;;;;;1,0;;;;13,0;4,0;64,0;4,0;1,0;6,0;9,0;;;1,0;;1,0;;12,0;;;1,0;1,0;17,0;;;7,0;;;;;;;;;;1,0;;;;7,0;;;;;;;;;;;;;;;2,0;1,0;;2,0;11,0;;;;2,0;;3,0;;4,0;5,0;;;;4,0;1,0;;;;;;4,0;;;13,0;;;;16,0;;;1,0;;;;;5,0;;;;;;;;;;;;;3,0;;;3,0;1,0;1,0;;;;2,0;2,0;1,0;1,0;26,0;;;5,0;7,0;1,0;;2,0;3,0;;1,0;;;;2,0;;;;;2,0;;5,0;2,0;;4,0;;4,0;;;;;1,0;1,0;;6,0;;;;1,0;4,0;1,0;1,0;;8,0;;;1,0;;;2,0;;;;;;;;10,0;;;1,0;1,0;3,0;;;1,0;10,0;3,0;2,0;2,0;;;;;1,0;1,0;;;2,0;1,0;;1,0;;;;;2,0;;;;2,0;2,0;;4,0;;;;;;2,0;2,0;1,0;;3,0;;;;;7,0;2,0;;;;;8,0;;;2,0;2,0;;;;1,0;2,0;;2,0;;2,0;;;;;;;;;7,0;;;2,0;;;;;1,0;;;;;;;;;;;3,0;1,0;;1,0;;1,0;;;2,0;;2,0;21,0;2,0;;;1,0;;;;;1,0;;;;;;;;;;1,0;;1,0;3,0;;;;;;;;;;;;;;;;;;;;;;;;;;;;;;;;4,0;;;;;;;;;5,0;;;;;2,0;;;;;2,0;;;;;;;;;;;;1,0;1,0;;;;;;;1,0;;;2,0;;1,0;;2,0;;;;;;;2,0;;;;;;;1,0;;;;1,0;;1,0;6,0;1,0;1,0;;;;;;;1,0;;5,0;;;2,0;;;;;;12,0;3,0;;;;;;;;;;;;;1,0;;;;;3,0;;;;;;1,0;;;
circle;;;;;;1,0;6,0;1,0;5,0;9,0;1,0;;;;20,0;1,0;;;;;;;;;;;2,0;1,0;;;;;;;2,0;;;;;;;;9,0;;1,0;4,0;5,0;12,0;;4,0;2,0;;;;;;;;;;3,0;;1,0;;;1,0;2,0;5,0;2,0;3,0;;;2,0;;3,0;1,0;2,0;;;2,0;;;;3,0;;;;;;2,0;3,0;;;;;;;;7,0;7,0;;;3,0;;;;22,0;;;;;;;;;8,0;3,0;11,0;;5,0;;;1,0;;1,0;1,0;;;;;;2,0;;;1,0;;;;;;;;;;;;;4,0;;;;;2,0;;1,0;;2,0;;1,0;;;;1,0;;1,0;;;2,0;;;;;;;;1,0;;;;;;;;;;;;;;;;;;;;;;;;;;;;33,0;;1,0;;;;2,0;;;8,0;;;;;;;;;;;;;;;;3,0;;;;;22,0;;;;;1,0;;;;;;;;;;5,0;1,0;;;;;;;1,0;;;;;;;4,0;;;12,0;;;;;;;;;;;;;;;;11,0;;;3,0;;;;;;;;;1,0;;;;;;2,0;;;;;;;;;3,0;;;;8,0;1,0;;2,0;2,0;;1,0;;;5,0;;;;;;;;;;;;;;1,0;1,0;;;;;2,0;;;;;1,0;2,0;;1,0;2,0;;;6,0;;;2,0;;;;7,0;;1,0;1,0;;;;;;;;;;;;1,0;1,0;;;;;6,0;;;;1,0;;;;;;;;;;;;;;;;;;;;;;;;;1,0;;;;;;;;;;;;;;;;1,0;;;;;;2,0;6,0;;;;;;;;1,0;;;;;;4,0;;;2,0;;;;1,0;;;2,0;;;;;;;;;;;3,0;;2,0;;;;4,0;;1,0;;;;2,0;;82,0;;;;3,0;;;;;;;;;;;;1,0;;;;2,0;;;;2,0;;;;;;;;;;;;;;;;2,0;;;;;;;;;;;;;;;;;;;;;;;;;1,0;;;;;;;;;;;;;;;;1,0;;;;;;;;;;;;;;;;;;;;2,0;;;;;;;2,0;;1,0;;;;;;;12,0;;;;;;;;;;;;;;;;;;;;;;;;;;;;;;;;;;;;;;;;;;;;;;;;;;2,0;;;;;;;2,0;1,0;;;;;2,0;;;;3,0;;;;;;;;;;;;;;;;;;;;;;;;;;;;2,0;;;;;;;;;;;1,0;;;1,0;;;;;;;;;;;;;;;;;;;5,0;;;;2,0;;;;;;1,0;;;;;;;;;;;;;;;;;;;;;;;;;;;;;;;;;;;;;;;1,0;;;;;;;;1,0;;;;;;;;;;;;;;;;;;;1,0;;;;;;;;;;2,0;;;;;;;;;;;;;;;;;;;;;;;;;;;;;;;;;;;;;;;;;;;;;;;;;;4,0;2,0;;;;2,0;;;;;;;;;;;;;;;;;;;;;;;;;;;;;;;;;;;;;;2,0;;;;;;1,0;2,0;;2,0;;;;;;;;;;;;;;;;;;;;;;;;;;;;;;2,0;;;;;;;;;;5,0;;;;;;;;;;;;;1,0;;;;;;;;1,0;;;;;;;;1,0;;;2,0;;;;;;;;;;;
client;;;;;;1,0;;62,0;;;;;10,0;;;13,0;;;;;;14,0;;;;;;;19,0;;2,0;29,0;3,0;;20,0;3,0;;;;;42,0;;;;1,0;;16,0;198,0;;16,0;;;;;;;;;;1,0;;;;;;;1,0;4,0;4,0;;;;5,0;;;1,0;14,0;;;44,0;;;1,0;10,0;;7,0;;;;;;1,0;;;;8,0;7,0;;18,0;3,0;;;20,0;1,0;;1,0;4,0;;1,0;12,0;5,0;6,0;;;;23,0;2,0;1,0;6,0;;;;31,0;7,0;3,0;5,0;;;;;;;;;;;1,0;21,0;;;;;4,0;;6,0;;;1,0;11,0;12,0;;;11,0;11,0;;;48,0;;;;6,0;23,0;16,0;;;;20,0;15,0;;;;;;;;;;;;;;;;;;5,0;;;;;4,0;3,0;;21,0;;;;;;;;;;;;;;;;;;;;;;;;;;;;;;;;;;;;;;;;1,0;;;;;;;;;;1,0;;;;;;;;;;;;;31,0;;;;;;;3,0;;;;;;;;;;;;;;;;;;;3,0;;;10,0;;;;;;;;;;;;;;;;1,0;2,0;;;;;4,0;;;;3,0;;;;;;;;3,0;;;;;;;;;;;;;;;;;;;;;;;;;;;;;;;;;;;;;;3,0;2,0;;3,0;1,0;;;;;;;;;;;;;12,0;;;;;;;;;;;;;;;;;;;;;6,0;;;;;;;11,0;;;;;;;;;4,0;8,0;;1,0;;;;;;;;;1,0;;;;;;;;;;;9,0;;6,0;;6,0;;3,0;;;;64,0;6,0;3,0;;;;;;;;;1,0;1,0;;;;2,0;;;1,0;;;;;;;;;;3,0;50,0;;1,0;;;;;;;;;;;;1,0;;;;2,0;1,0;;;;;9,0;;;;5,0;;;;;;4,0;1,0;;;;;34,0;;;;;1,0;1,0;;;;1,0;;3,0;;;;;;38,0;4,0;;;2,0;;1,0;;2,0;;;;;;6,0;65,0;;;;;;;3,0;;;;;;1,0;;;;;1,0;4,0;6,0;1,0;;;1,0;;;;1,0;;;1,0;;;;;;;;6,0;;;;;;;;;;;;;;2,0;9,0;1,0;2,0;;5,0;1,0;;;;;;;;;;;;;;;9,0;;;;;9,0;;;1,0;;;;2,0;27,0;6,0;3,0;;;2,0;;;;;;;;;;;;2,0;;;;;;;;;;;;;;;;;;;;;;;;;;;;;;;;;;;6,0;;;;;;;;;;;;;;;;;;;;;;;;;;;;;;;;;;;;;;;;;;;;;;;;;;;;;;;;;;;;;;;;;;;;;;;;3,0;;;;;;;;;;;;;;;3,0;;;;;;;;;;;;;;;;2,0;;;;;;;;;;;;;;;;;;;;;;;;;;;;;;;;;;;;;;;2,0;;;;;;;;;;;1,0;;;;;;;;;;;;;3,0;;;;;;;;;;;;;;;;;;;;;;;;;;4,0;;;;;3,0;;;2,0;;;;;;;;;;;12,0;;;;;;;;;;;;;;;;;;;2,0;;;4,0;;;;;;;;1,0;;;;;;;1,0;;;;;;;;;;;;;;;;;;;;;;;;;;;;;;1,0;;;;;;;;;;;;;;;;2,0;;;;;;;;;;;;;;;;;;;
clip;;;;;;6,0;2,0;17,0;29,0;;;;10,0;;;23,0;;;;;;21,0;;;;;3,0;;;;;;16,0;;10,0;3,0;;;18,0;;63,0;;13,0;1,0;;;13,0;48,0;6,0;53,0;4,0;5,0;;2,0;;;2,0;;3,0;;3,0;;;43,0;;;;3,0;9,0;;1,0;;36,0;1,0;;120,0;15,0;;;297,0;;33,0;;143,0;;7,0;;;;;2,0;3,0;;4,0;;40,0;2,0;19,0;26,0;;1,0;2,0;2,0;10,0;;;2,0;74,0;4,0;1,0;;4,0;;;;107,0;10,0;40,0;2,0;;1,0;;1,0;12,0;2,0;1,0;;;;6,0;;63,0;;1,0;;16,0;3,0;6,0;2,0;;3,0;;;;4,0;;;4,0;81,0;11,0;;;5,0;26,0;;1,0;13,0;;;6,0;35,0;7,0;25,0;;;;179,0;7,0;;;2,0;;2,0;4,0;1,0;4,0;22,0;;;;;2,0;;1,0;;;;;;;;1,0;;32,0;;;20,0;;;;;;12,0;;;;;;;;;1,0;;;;;1,0;;;1,0;3,0;;6,0;;;;2,0;;1,0;;4,0;9,0;;15,0;;;;10,0;2,0;6,0;3,0;22,0;;;;;;;13,0;5,0;14,0;;;;;;26,0;3,0;1,0;;;;2,0;47,0;;;;;;;;17,0;1,0;;;3,0;16,0;1,0;;9,0;1,0;1,0;;;;45,0;;;;;5,0;;;;2,0;;;;;;6,0;1,0;15,0;;;;5,0;;5,0;;;1,0;;;;;;3,0;;2,0;;;;;;;20,0;;;;;;;;;;1,0;;3,0;5,0;;;;;1,0;;2,0;;15,0;;;;;;;;1,0;;;;;3,0;;;;;;4,0;;;;;8,0;;3,0;;;;7,0;10,0;5,0;;17,0;;;1,0;;;;;;5,0;;;;;1,0;;;;;;;9,0;;;;1,0;10,0;;1,0;1,0;2,0;40,0;;2,0;1,0;;;;;2,0;;2,0;26,0;;;11,0;;2,0;;3,0;;;4,0;;;;3,0;;;4,0;12,0;;15,0;;7,0;;;;1,0;;;;;87,0;4,0;1,0;;;;;3,0;;;;;;5,0;5,0;;;;;16,0;;;;;;4,0;3,0;;;;;;;;;;;;1,0;;;;5,0;9,0;;;;;;37,0;;;;4,0;;;;;;1,0;;;1,0;;;;;;1,0;;;24,0;;;;;;;4,0;;3,0;9,0;;;;;;2,0;2,0;4,0;;;;;5,0;;3,0;;;;1,0;;;;;;1,0;;;4,0;1,0;;1,0;;;1,0;;;;;;;;;;;;;;;3,0;;;;;6,0;;;;1,0;;;6,0;;;1,0;;254,0;;;;;;;;;;3,0;;;;;;;25,0;;;;;;;;;1,0;;;;;4,0;22,0;;;3,0;;;6,0;;;3,0;;;;;9,0;;;2,0;13,0;1,0;;6,0;;1,0;;;5,0;;;;;;;;;;;;;;;;;1,0;3,0;2,0;;;;;3,0;;;;;;3,0;;5,0;;;;;;;;;;2,0;;;;;;;;;;;;;;;;;;;2,0;;;;;;3,0;;;;;;;;;;;2,0;;;;;;;;;;1,0;;;;;3,0;;;;;7,0;;;;;;57,0;;;3,0;;;;;;2,0;;;;;1,0;1,0;;11,0;;;;2,0;;;;24,0;;;;;;;;;;;;;;2,0;;;;;2,0;29,0;;;;;;;89,0;;;;;;2,0;;;;;;;;;;;;2,0;;;;;3,0;;;2,0;;;;;;;;5,0;26,0;;;;;;;;;;;6,0;;;1,0;2,0;;;;9,0;;;;;;18,0;;;;;;;;1,0;3,0;;;;;;;;;;;;;;1,0;;;3,0;;;;;;;1,0;;;;;1,0;;8,0;;;;;;4,0;;;3,0;;;;;;;;;;;;3,0;;;8,0;;;;;;;;3,0;;;;;;;1,0;;1,0;;;;7,0;;;5,0;;;;;;;;;;;;;;;;;;;;;;;;;;;;;;1,0;;;;;
coil;;;;;;3,0;1,0;34,0;3,0;60,0;6,0;;5,0;1,0;62,0;54,0;;2,0;;;;2,0;;;3,0;;;10,0;;1,0;;7,0;54,0;;34,0;7,0;4,0;34,0;6,0;;1,0;;10,0;1,0;9,0;4,0;1,0;40,0;3,0;1,0;90,0;6,0;;2,0;242,0;3,0;2,0;;;;21,0;3,0;24,0;;;;7,0;59,0;16,0;4,0;;;32,0;;;29,0;;;;25,0;;4,0;;96,0;1,0;;;;1,0;9,0;228,0;;;;5,0;;1,0;;33,0;;;;174,0;1,0;;5,0;40,0;9,0;5,0;;16,0;2,0;11,0;;;62,0;182,0;99,0;53,0;12,0;1,0;1,0;;2,0;5,0;;;;;;;2,0;7,0;5,0;4,0;;23,0;7,0;;;;;;25,0;;;13,0;66,0;17,0;3,0;8,0;;;;1,0;35,0;10,0;;39,0;;;;64,0;;4,0;;2,0;2,0;;;2,0;;11,0;13,0;1,0;36,0;31,0;62,0;1,0;;22,0;69,0;2,0;6,0;11,0;20,0;;13,0;4,0;;;;;101,0;6,0;;;;34,0;9,0;6,0;2,0;10,0;96,0;1,0;14,0;39,0;2,0;;135,0;6,0;;47,0;3,0;;;3,0;;4,0;18,0;56,0;;28,0;;;;;3,0;;1,0;139,0;5,0;2,0;28,0;54,0;46,0;7,0;2,0;37,0;86,0;7,0;;;1,0;3,0;;;;;13,0;13,0;;5,0;7,0;;4,0;51,0;;;;1,0;;3,0;;;5,0;16,0;12,0;19,0;;;11,0;34,0;2,0;;49,0;;4,0;8,0;52,0;2,0;;50,0;16,0;4,0;5,0;1,0;;;;;;1,0;;29,0;;;;53,0;;106,0;;82,0;2,0;1,0;4,0;8,0;9,0;13,0;4,0;;3,0;;45,0;3,0;;;2,0;;29,0;4,0;;5,0;9,0;133,0;;4,0;;;;4,0;1,0;11,0;;;5,0;8,0;7,0;21,0;41,0;4,0;1,0;11,0;2,0;;;1,0;188,0;7,0;;20,0;10,0;;2,0;2,0;;;4,0;;15,0;;1,0;;;4,0;;;10,0;16,0;;;;;;2,0;2,0;9,0;;21,0;6,0;2,0;;;2,0;;;7,0;;;64,0;12,0;;;;1,0;1,0;;6,0;;;;;;;;;;;;;5,0;;1,0;;;;2,0;;;;;;2,0;;;1,0;;;;;;2,0;;16,0;2,0;;3,0;4,0;3,0;5,0;1,0;;44,0;;;5,0;3,0;;;3,0;1,0;;;;;;;;;;3,0;;;;6,0;8,0;;;;1,0;;;;;;1,0;;;;;;10,0;;18,0;;;;;6,0;;;;;;;2,0;;;;1,0;12,0;;;;;;1,0;;1,0;;;;;;;;;6,0;;;;;;4,0;;;;1,0;;;;;;9,0;;;2,0;;;18,0;;285,0;;;;;;;;;;;;;;1,0;;3,0;;;;1,0;;;3,0;;;1,0;;1,0;1,0;;;;;1,0;;3,0;;;;;;;;;;;;;;;;14,0;8,0;;;;10,0;;9,0;;;;12,0;;;1,0;;;1,0;;;;;;;;;;;;;;;;3,0;;;;;2,0;;21,0;;;16,0;1,0;;;1,0;;;;;1,0;;;;231,0;;;;5,0;;5,0;2,0;;1,0;;;;;3,0;;2,0;;4,0;;;13,0;2,0;;;4,0;2,0;;;3,0;;;;1,0;2,0;;;;;;;2,0;;;;;6,0;7,0;;3,0;3,0;;;;;3,0;2,0;6,0;;;;;;;54,0;;;;;35,0;62,0;2,0;2,0;;;;;4,0;1,0;4,0;;;;1,0;;;;2,0;;;;;;;3,0;;1,0;;;;;1,0;;2,0;2,0;;14,0;;;;;;;4,0;;;;;1,0;;;;2,0;;2,0;;27,0;;;;;4,0;;2,0;;;;;;;;;;1,0;;;;;;;5,0;3,0;;1,0;;;;;1,0;;1,0;;;;;;;;3,0;;;2,0;;;;;;1,0;;;;;;;;;;;11,0;13,0;;;1,0;;1,0;3,0;;;;;;;;;1,0;;;;;;;;;;;;;1,0;;;10,0;;;;;6,0;;;29,0;;;7,0;;;;;;;;;;;1,0;;;6,0;;;;;;;;;;;1,0;30,0;22,0;1,0;3,0;;;3,0;;;;;;;;;22,0;51,0;;44,0;;;;;;;;;;1,0;;2,0;;;;;;;;1,0;3,0;;;4,0;5,0;1,0;;;2,0;;;;;;;1,0;;;;;;;;;;;;;;;;;;2,0;;;;;;;;;;;;;;;;;;;;;
collect;;;;;;16,0;3,0;3,0;6,0;1,0;19,0;;1,0;;4,0;10,0;7,0;;;;6,0;2,0;;;;;16,0;;;;4,0;4,0;50,0;;1,0;1,0;;;5,0;;79,0;;;3,0;1,0;;9,0;23,0;2,0;5,0;5,0;5,0;;1,0;;3,0;2,0;;;;3,0;6,0;10,0;1,0;3,0;2,0;9,0;7,0;17,0;;3,0;;1,0;;;1,0;2,0;;3,0;159,0;2,0;19,0;;13,0;;;;;;;49,0;;;;7,0;;5,0;;11,0;;;;1,0;10,0;6,0;7,0;35,0;;1,0;1,0;5,0;3,0;2,0;;;21,0;25,0;10,0;;;;;9,0;1,0;7,0;;1,0;;6,0;3,0;;2,0;1,0;4,0;1,0;12,0;4,0;2,0;2,0;;13,0;;;15,0;;;;1,0;14,0;5,0;1,0;;2,0;6,0;30,0;;47,0;;;2,0;;5,0;18,0;;;;25,0;10,0;4,0;;1,0;;;;;;;1,0;;;7,0;2,0;;;7,0;;;5,0;;;;;;1,0;1,0;;;;;;2,0;;;2,0;;;;9,0;;25,0;;;;2,0;;;1,0;;;3,0;4,0;12,0;;;1,0;;;;126,0;1,0;2,0;;2,0;4,0;;;;2,0;;2,0;;3,0;;6,0;;;2,0;1,0;12,0;1,0;;;;;;4,0;8,0;8,0;3,0;;;;;2,0;4,0;;3,0;;3,0;;;4,0;8,0;;;;;;;3,0;1,0;;1,0;;;2,0;;3,0;;;3,0;1,0;;;1,0;;;;1,0;;;;;;;;;3,0;;;;;4,0;;;;;2,0;;;;;;;4,0;1,0;;;;;;;;;;;;;4,0;;;2,0;;2,0;;;;;;;;;;;;;;5,0;1,0;;;;;;;;;;;3,0;;;;2,0;;;;;;;;;;;;;;;;;3,0;1,0;5,0;;;;;;2,0;1,0;;;;11,0;;;;;6,0;3,0;1,0;;;;4,0;;3,0;;;;;;17,0;;;;;;;;1,0;4,0;1,0;;2,0;;2,0;1,0;;2,0;;1,0;3,0;;;;;;2,0;;4,0;;;;;1,0;4,0;;;1,0;;3,0;8,0;3,0;;;;;;1,0;4,0;;;;1,0;;;;;;1,0;;;1,0;3,0;;;;1,0;2,0;;4,0;;;;;;;2,0;;;2,0;;1,0;4,0;;3,0;;2,0;;;;;;7,0;;;;;;;;;;;;3,0;1,0;;;;;;;;;;;;;;;1,0;;;;;;;;;;1,0;;;;;3,0;;;;;1,0;;;2,0;2,0;;;1,0;6,0;;9,0;;3,0;;;5,0;;;;;1,0;;;;;;;;;;;;;;;1,0;;;1,0;;;;;12,0;;;;;;1,0;;;1,0;;;;;;;;;;;;16,0;;;;;;;;1,0;;;;;;;;1,0;;;;;;;;;;;;;;;;;;;;;;;;2,0;1,0;;;1,0;;;;;;;;;;;;;;;;;;;;;;;;;2,0;;;2,0;;;;1,0;;;;;;;;1,0;;;;;;;;;;;;;2,0;;;;1,0;;2,0;;;;;6,0;1,0;;;;;;;;;;;;;;;;;;;;;;;;;;;;2,0;;;;;;;;17,0;;4,0;;;;;;;;;;;;;3,0;;;;;;;;;;;;;;9,0;;2,0;;;;;;;;;;;;;;4,0;;;;;;;;;;;;;;;1,0;;;;;;;;;2,0;;;2,0;;1,0;1,0;;;2,0;;1,0;1,0;1,0;;;;;1,0;3,0;;;;;;;;2,0;1,0;;;;;;;;;;;;;;;;3,0;;;6,0;;;;;;;;1,0;8,0;;;;;;;;;;;;;;;1,0;;;1,0;;;6,0;1,0;;;;2,0;;;;;;;;;;;;;;;;;;;;;;4,0;;;;;;;;;;;;;;;1,0;;;;4,0;;;;;;;;;;;;;;;;;;;;;;;;2,0;;2,0;;;;;;;;;;
column;;;;;;13,0;;18,0;1,0;101,0;89,0;;10,0;5,0;1,0;16,0;1,0;;;;;4,0;11,0;2,0;6,0;;80,0;;;2,0;1,0;1,0;37,0;;37,0;1,0;6,0;2,0;;;75,0;;;;2,0;4,0;11,0;48,0;10,0;;72,0;;;11,0;1,0;;9,0;1,0;;;11,0;;;;19,0;11,0;4,0;34,0;2,0;3,0;3,0;;19,0;;;26,0;2,0;;;120,0;2,0;66,0;;94,0;1,0;;;;;;3,0;;;;;;3,0;;14,0;10,0;;;3,0;3,0;;;12,0;;43,0;;;59,0;2,0;;40,0;170,0;16,0;35,0;2,0;16,0;;;28,0;111,0;4,0;;;;;;;12,0;7,0;2,0;38,0;;27,0;2,0;1,0;;;;;50,0;2,0;1,0;;6,0;305,0;;;1,0;1,0;7,0;2,0;17,0;29,0;;4,0;32,0;3,0;14,0;190,0;;;;;;2,0;;4,0;;1,0;94,0;1,0;4,0;;;2,0;;;;;;9,0;98,0;;2,0;3,0;;;2,0;;55,0;5,0;1,0;;;;;;;7,0;126,0;;;;;13,0;1,0;;;;11,0;;;;;5,0;1,0;2,0;;;;;;3,0;;13,0;;;;;1,0;2,0;3,0;;;2,0;;;;;;;30,0;15,0;;537,0;5,0;3,0;;;;;2,0;6,0;;;;;;;47,0;;;;8,0;2,0;;;17,0;3,0;;;;2,0;;1,0;5,0;22,0;1,0;;;4,0;10,0;;;;;;23,0;;;1,0;;;;22,0;;6,0;1,0;9,0;;;1,0;;2,0;3,0;2,0;;;;;2,0;4,0;2,0;2,0;;8,0;;;;1,0;16,0;;;;;;;;;;;;19,0;;11,0;;;;;3,0;;2,0;1,0;1,0;7,0;8,0;;;;3,0;;5,0;1,0;13,0;;;;;;3,0;;;;;;;;;;;;;;;;3,0;;;2,0;;;22,0;1,0;;;1,0;;;;;;2,0;1,0;;;;;;;;;;14,0;;10,0;12,0;3,0;5,0;8,0;3,0;1,0;;;;;2,0;;;;2,0;;;;1,0;;;;39,0;16,0;4,0;4,0;;3,0;2,0;6,0;;;;1,0;;;5,0;8,0;;2,0;5,0;;;;;10,0;;;;;;9,0;;;;;;;1,0;;;;;;;;;8,0;;19,0;2,0;;6,0;;2,0;;9,0;1,0;;;5,0;;;;;;;;;1,0;;;;;;;;;;100,0;;11,0;;;;;;;;;;1,0;4,0;;;;;;;;2,0;;2,0;2,0;1,0;;;;2,0;;2,0;;;;;;2,0;;;;4,0;;;;;2,0;29,0;;;;;;3,0;7,0;;;;;;;;16,0;;;;;;;;;;2,0;;;;;11,0;;;;;;;;;;;;;34,0;;4,0;1,0;;;;40,0;;;;;;;;;;;;;;1,0;16,0;;;;;;7,0;13,0;;;9,0;;;3,0;;;12,0;;;1,0;;;;4,0;;1,0;;;1,0;;;;;;;1,0;;4,0;;8,0;;10,0;;5,0;36,0;;;;;;1,0;;;;;;;;;;;;1,0;;1,0;10,0;;;25,0;;1,0;;;;;3,0;;25,0;;;;;;;;;1,0;;;1,0;;;;;;;;;;;24,0;;;;3,0;1,0;4,0;16,0;;;;;;;;;;10,0;;;;;;5,0;;;;;;;;;;;;7,0;;;2,0;1,0;;8,0;5,0;7,0;;;;;;;9,0;17,0;6,0;;6,0;;1,0;2,0;28,0;;;;;;;1,0;11,0;;;2,0;;;25,0;;;2,0;;6,0;;;6,0;;;8,0;;11,0;;;;;;1,0;;;;3,0;;;;;;;1,0;;1,0;;;;;;;5,0;16,0;;;;;;;;;;;;;;;1,0;;25,0;1,0;;;;;;;;4,0;;;;4,0;;;;;;;1,0;;;;;;;;;;;;;;;;;;;;;;;;;;2,0;;;;;;;;;;;;;;;;;;;;;9,0;;;;;;;;;;;34,0;;3,0;;;;;;;;;;;;;;;4,0;;;;21,0;1,0;;;1,0;1,0;;;;;;;;;;;4,0;;2,0;;;;;;;;;;2,0;;;1,0;;;;;;;;;1,0;;;;;;;2,0;;;;
concave;;;;;;2,0;4,0;12,0;4,0;;1,0;1,0;;;10,0;12,0;8,0;;;;;;;;;;;;1,0;;;;2,0;;6,0;;;;2,0;2,0;;;10,0;2,0;;;;5,0;1,0;;28,0;;;;3,0;28,0;29,0;;;;4,0;;;;;;1,0;43,0;1,0;3,0;;;;;;2,0;;;;37,0;;21,0;;42,0;;;2,0;;;;87,0;;;3,0;;;;;4,0;1,0;;;5,0;20,0;;;28,0;;;;;;;;;13,0;210,0;7,0;5,0;1,0;1,0;;;;;;;;;3,0;;;;;;;3,0;;;;1,0;;;5,0;;;;63,0;;1,0;;1,0;;;4,0;;6,0;;2,0;;;;28,0;;;;;3,0;;;;1,0;4,0;2,0;;;2,0;;;;1,0;21,0;1,0;2,0;;;2,0;3,0;3,0;1,0;;;;3,0;;1,0;;;11,0;15,0;1,0;1,0;;4,0;;;;;;28,0;21,0;7,0;;;;;7,0;;;6,0;4,0;3,0;19,0;;;;17,0;;7,0;2,0;17,0;5,0;4,0;6,0;6,0;;;11,0;;;;;2,0;1,0;;14,0;;;;;1,0;;;;;;;5,0;;9,0;;;;;1,0;;26,0;;;;15,0;4,0;3,0;;;2,0;;7,0;10,0;188,0;;;3,0;1,0;1,0;;;;;;1,0;;;;19,0;;;;6,0;5,0;;;1,0;;1,0;;;;28,0;;;;;;;;;;29,0;2,0;;;5,0;5,0;5,0;;11,0;2,0;;;3,0;;;;;;;5,0;;;;;6,0;;;;;;;;;;;4,0;;;;6,0;2,0;;3,0;;;1,0;1,0;5,0;;;1,0;2,0;;;;;;;;;;1,0;;;;3,0;;;;;;1,0;6,0;;;;1,0;2,0;2,0;;3,0;;;;;5,0;;;;;;;;;;;;;;;;;;;;;;;;;;;;;;1,0;;;;;;;;;;;;;;;;;;;;;;;;;;;;;;6,0;;;;;;;;;;;;;;;;;1,0;;;2,0;;;;;;;;;;;;;;;;;;;;2,0;;;;;;;;;;;;;2,0;;;;;;;;;;;;;;;;;;;1,0;;;;1,0;;3,0;;;;;;;;;;;;;;;;;;;;;;;1,0;;;;;;;;;;;;;;;;;;;;;;;;1,0;;;;;2,0;;;;;;;;;;;;;;;;;;;;;;;;;;;;;;;;;;;1,0;;;;;2,0;;;;;;;;;;;;;;;;;;;;;;;;;;;;;;10,0;;1,0;;;;;;1,0;;;;;;;;3,0;3,0;;4,0;;;;;2,0;;;;;;;;;1,0;;;1,0;;;;;;;;;3,0;;;;;4,0;;;;;;;;;;;;;;;2,0;5,0;;;1,0;;;;;2,0;;3,0;;19,0;;;;2,0;;;;;;;;1,0;;;;;;;;;;;;;;;;;;4,0;;;;;;;;;;;;;;;;;;;;;;;;;;;;;;;;;;;;;;;;;;;2,0;;;;;;;;;;;;;;;;;;;;14,0;;1,0;;;;;;;;;;;;;;;;;;;;;;;;;;;;;;;;;;;;;;;;;;;;;;;;;;;;;;;;;;;;;;;;;;;;;;;;;;;;;;;;;;;;;;;;;;;;;1,0;;;;;;;;5,0;;;;1,0;;;;;;;2,0;1,0;;;;;1,0;;2,0;1,0;;;;;1,0;;;;;;;;;;;;;;;;;;;;;;;;;;;;;;;;;;;;;
constant;;;;;;1,0;3,0;3,0;7,0;2,0;2,0;4,0;2,0;;1,0;16,0;2,0;;7,0;3,0;;2,0;2,0;1,0;1,0;4,0;10,0;;;1,0;;1,0;4,0;;5,0;;3,0;1,0;4,0;;14,0;6,0;2,0;2,0;;1,0;1,0;22,0;3,0;1,0;9,0;15,0;;;14,0;;6,0;;;;1,0;2,0;;;;6,0;3,0;6,0;5,0;;9,0;;7,0;1,0;;3,0;;;6,0;32,0;;9,0;;5,0;9,0;;1,0;;;9,0;28,0;;;10,0;;;3,0;;22,0;;3,0;;3,0;10,0;4,0;;2,0;3,0;20,0;2,0;;12,0;;;;4,0;1,0;15,0;17,0;5,0;;;1,0;;;;;;;7,0;;7,0;19,0;;;4,0;;;;4,0;2,0;;;6,0;;;;18,0;23,0;;6,0;;4,0;5,0;;13,0;11,0;;1,0;;1,0;2,0;18,0;;3,0;;3,0;;;4,0;7,0;;;;2,0;2,0;;5,0;;1,0;1,0;5,0;;;1,0;6,0;;2,0;;;1,0;;;5,0;;4,0;;;;1,0;;;2,0;32,0;;3,0;;;11,0;5,0;;;7,0;6,0;;;;;;;2,0;;4,0;;;18,0;2,0;;10,0;;8,0;;;1,0;;;10,0;5,0;;15,0;;;;;1,0;;;;5,0;;;;;;;5,0;1,0;;;4,0;;1,0;;7,0;8,0;2,0;;;4,0;;;14,0;;;;37,0;7,0;;2,0;9,0;10,0;1,0;;3,0;;8,0;;1,0;;;;3,0;;;;;15,0;;2,0;;3,0;1,0;3,0;1,0;;;;1,0;1,0;;;;;4,0;;;;;;;;;5,0;;6,0;4,0;;;;;;;;3,0;;5,0;1,0;1,0;;1,0;1,0;;;;1,0;;1,0;3,0;;2,0;;;;4,0;1,0;;;2,0;;2,0;;;;;1,0;;;;;;6,0;;;;;;20,0;;2,0;2,0;;;;1,0;;;;;5,0;;;;;;;;;9,0;;;6,0;;;;3,0;;;2,0;;4,0;16,0;;;;;;;2,0;1,0;;;;2,0;2,0;1,0;;2,0;;;;;9,0;9,0;;6,0;;9,0;7,0;18,0;3,0;;2,0;;;;3,0;14,0;;1,0;19,0;2,0;4,0;;1,0;21,0;2,0;;;;;;;;20,0;;;;;7,0;;;;;4,0;;;;4,0;26,0;;2,0;;;;;3,0;;;;;;;;;4,0;;;;;;3,0;;4,0;2,0;;;;;12,0;;;;;;3,0;;;;2,0;;;;;;;;;3,0;;;;;;1,0;;;;1,0;;2,0;;;;;;;7,0;;;;;;2,0;;;;;5,0;;;;;4,0;;4,0;;;;;2,0;2,0;;5,0;;;1,0;;;;;;;;;;4,0;;;;;;;;;;;;;;1,0;;;;;2,0;;1,0;;;;;;;3,0;1,0;;;;;;;;;;;;12,0;;;;2,0;;;;;;;1,0;;;;2,0;1,0;;;;1,0;;9,0;;;1,0;;;;1,0;;;;;;1,0;;;1,0;3,0;;;;7,0;1,0;;;;;;;;;;;;;;;;;;;;;8,0;;;;;;6,0;;;;;;;;4,0;;;;;;;;3,0;;;2,0;;;;;;;;2,0;;2,0;;;3,0;;;;;1,0;;;;;;;;;;;;;1,0;;;;;;;;;;;5,0;;;5,0;;;;;;;;;;;;;;;;;;4,0;;;;;;;;;;;;;7,0;;;;;;1,0;;5,0;;1,0;;;;;;4,0;;4,0;;;;;;;1,0;;;;;2,0;3,0;;2,0;;;;;;3,0;;;;;;;;;;;;;;;;;;3,0;;;;;;;;;;;;;;;;;;;;;;;;;;;;;;;1,0;;;;11,0;;;;;;;;;;1,0;2,0;;;2,0;;;;30,0;;;;;;;;;;;;7,0;;2,0;;;;;;;4,0;;;;;;2,0;4,0;;;;1,0;;;;;;;;;;3,0;3,0;;;;;;6,0;;1,0;;;1,0;;;;2,0;;;;;;;;;;;;;;;;;1,0;;;;;;;;;;;;;;;;;;;;1,0;;
contour;;;;;;2,0;;5,0;35,0;;;;9,0;;1,0;28,0;;;;;3,0;2,0;1,0;;;1,0;4,0;;;;1,0;;2,0;;1,0;2,0;;1,0;;1,0;7,0;;1,0;5,0;5,0;3,0;17,0;5,0;4,0;3,0;;3,0;1,0;;2,0;17,0;45,0;1,0;3,0;;;2,0;;;;2,0;2,0;13,0;1,0;;;;13,0;;;;;;;44,0;;1,0;1,0;2,0;;1,0;;;;;;;;1,0;2,0;;;;7,0;1,0;;;7,0;8,0;;;;;;;;1,0;;;;1,0;3,0;5,0;;;;;6,0;3,0;;;;;;2,0;;1,0;;;1,0;;;;;;;;;;;;;4,0;52,0;2,0;;;;1,0;6,0;;2,0;;;;;;1,0;1,0;4,0;;2,0;;5,0;;;1,0;;;;;1,0;;;;;;;;;2,0;;75,0;;;;1,0;;2,0;;2,0;;;;2,0;;;1,0;;;1,0;;;1,0;7,0;;;;;;;;;;;3,0;;8,0;;;;;;5,0;;;;;1,0;;;;1,0;;10,0;3,0;2,0;;;;;;1,0;4,0;2,0;3,0;;;;1,0;;1,0;;;;;;;2,0;;;11,0;;2,0;;;;;;;;;2,0;;8,0;;;;;;;;1,0;;;;4,0;;;1,0;;;;;;;1,0;1,0;;;;;;;7,0;;6,0;;;;;;;;;;;;;1,0;;;;;;;;;;;;;7,0;;;;;;;1,0;;;;3,0;;;;;;;1,0;;1,0;;3,0;;;;;;;;1,0;3,0;;;;;;;1,0;1,0;;;1,0;;;;;;;;1,0;;5,0;4,0;;;;;;1,0;;;;;;;1,0;;;;;;5,0;1,0;;3,0;;5,0;;;1,0;8,0;;;;1,0;;;;;;;;;2,0;;2,0;;;4,0;1,0;;3,0;;;1,0;;;;;;;;;;;4,0;1,0;;;;;1,0;;1,0;;;;;;;3,0;1,0;;;;1,0;2,0;;;;;;4,0;;;3,0;1,0;;;;;1,0;;;;;;;;;;3,0;1,0;;;1,0;;;;;;;;4,0;;;;;;;;;1,0;;;3,0;;;;;;;;1,0;1,0;;;;;;;;;;;;;;;;;;;;3,0;;;1,0;;;;;;;1,0;7,0;6,0;;;;;;;;;;;;;2,0;;;;;;1,0;;;;;;;;;;2,0;;;;;;;;;1,0;;17,0;;;;;13,0;;;;;;;;;;;;2,0;;;;;10,0;;;;;;;;;;;;;;;1,0;;;;;2,0;;1,0;;;;;;;;;;;;;;;;;;;;;;;;;3,0;;;;;;1,0;1,0;;;;;;;4,0;;;;;;;;;;;;1,0;;;1,0;;;;;;;5,0;;;;;;;;;;;;;;;;;1,0;;;;;;;;;;;;;;;;;;;;;;;;;;;;;;1,0;;;;;;;;;;;;;;;;;43,0;;;;;;1,0;;;;;;;;;;;;;;;;;;;;;;;;;;;;;41,0;;;;;;2,0;;;;;;;;;;;;;;26,0;;;;;;5,0;;;;;;;;;;;;;;;;;;;1,0;;;;;;;;;;;;3,0;;;;1,0;;;;;;;;;;;;;;;;;;;;;;;;;;;;;;;;;;;;;;;;;;;;4,0;;;;;;;;;;;;;;;;;;;;;;;;;;;;;;;;;;;;;;6,0;;1,0;;;;;;;;;4,0;;;;;;;;;;;;;;;;;;2,0;;;;;;;;;;;;;;;;;;;
convex;;;;;;5,0;2,0;8,0;5,0;8,0;1,0;17,0;;;19,0;2,0;;;;;;;;;;;1,0;;;;;;1,0;;1,0;;;;;10,0;1,0;;5,0;1,0;;1,0;4,0;4,0;4,0;;2,0;7,0;;;;4,0;54,0;;;;9,0;;1,0;;2,0;4,0;;29,0;;15,0;1,0;1,0;;;;3,0;;1,0;;43,0;1,0;7,0;;27,0;;;;;;;211,0;;;1,0;;;;;3,0;;;;12,0;129,0;6,0;;57,0;;;;4,0;1,0;2,0;;;19,0;49,0;13,0;70,0;2,0;4,0;1,0;3,0;;2,0;;;;1,0;3,0;;;4,0;;;;2,0;;;4,0;;;;5,0;;;;153,0;;1,0;;;;4,0;12,0;;8,0;1,0;1,0;5,0;;;10,0;;;;;2,0;;;4,0;;;6,0;;;1,0;1,0;;;2,0;7,0;1,0;;;;;7,0;;;1,0;;29,0;7,0;;5,0;1,0;;;6,0;3,0;;;14,0;;;;;6,0;82,0;3,0;1,0;1,0;4,0;;;1,0;;;;3,0;1,0;1,0;;;;;;3,0;;16,0;;11,0;2,0;1,0;5,0;;6,0;1,0;25,0;3,0;;;1,0;;;2,0;;;11,0;3,0;;;;;;1,0;4,0;;17,0;;;;3,0;;;67,0;;;;;1,0;1,0;;;;;4,0;2,0;277,0;;;;1,0;;;;;;5,0;;2,0;;;1,0;;;;;4,0;;;1,0;;;;;3,0;;;;;;;;;;;;;;;9,0;3,0;1,0;;10,0;;;;;3,0;2,0;;;;;;;;;;2,0;;;;;;1,0;1,0;10,0;2,0;;;;;;;;9,0;;;;7,0;;3,0;;10,0;1,0;;;;;;;;22,0;;2,0;;;;;;;1,0;4,0;4,0;;;2,0;;;;;;;;;;;;;2,0;;1,0;;;;;;;;;;;;1,0;;;;;;;;;;;;;;4,0;;;;;;;;;;;;;;;7,0;;;;;;;;;;;;1,0;;;;;;;;;;;;;;;3,0;;;;;;;1,0;1,0;;22,0;;;;;;;;;;;;;;;;;;;;1,0;;;;;;;;;;;;;1,0;;;;;;;;;;;;;;;;3,0;;;;;;;6,0;;4,0;;;;;;;;;;;1,0;1,0;;3,0;;;;;;;;;;;;;;;4,0;;6,0;;;;;;;;;;;;;;;;;;;;;;;;;;;;2,0;;1,0;;;;;;;;;;;;;;2,0;;;;;;;;;;8,0;;;;;;;;;;;;;;;2,0;;;;;;;1,0;;;;;;;;;1,0;;6,0;;;;2,0;4,0;1,0;;2,0;;;;1,0;;;;1,0;;;;;;;;;;;;1,0;;;;;;;;;;;;;;;;;;;;;;;;;;;;;;;2,0;;;;;;;;;;2,0;2,0;;;;;;;;1,0;;;;;;3,0;;;;;2,0;;;;;;;;;;;;;;;;;;;;;;;;;;2,0;;;;1,0;3,0;;;;;;;;;;;;;;;;;;;;;;;;;;;;;;;;;;;3,0;;;;;;;;;;;;;;;;;;;;46,0;;;;;;;;;;;;;;;;2,0;;;;;;;;;;;;2,0;;;8,0;;;;;;;1,0;;;;;;;;;;;;;;;;;;;;;;;;;;;2,0;;;;;;;;;;;;;;;;;;;;;;;;;3,0;;;;;3,0;;;;;;;;;;;;6,0;;;;;;;;;;;1,0;;1,0;;;;4,0;1,0;;;;;;;;;;1,0;;;;;;;;;;;;;;;;;;;;;;;;1,0;;;;;;6,0
correlation;;;;;;2,0;;;3,0;;;;1,0;;;14,0;;;;;;;;;;18,0;3,0;;;;2,0;;7,0;;;;;;;;13,0;;5,0;4,0;10,0;10,0;14,0;2,0;2,0;;;1,0;3,0;;;;1,0;;3,0;;;;;;;;;;21,0;;9,0;;4,0;;;1,0;;;;40,0;;;;5,0;1,0;;;;;;1,0;;;;1,0;;;;14,0;;;;7,0;4,0;;;;;4,0;3,0;;2,0;;;;6,0;1,0;5,0;;2,0;;;2,0;2,0;2,0;2,0;;;;;;5,0;1,0;;1,0;;9,0;4,0;9,0;;;;;1,0;;;;;9,0;3,0;5,0;;;10,0;;;8,0;;;;;;5,0;;;;3,0;1,0;;;;;;11,0;3,0;2,0;;;;;;;;;;3,0;;;;;;;;;;;;;;;;;3,0;;;;;;3,0;;;;;;;;;;2,0;;;2,0;;;;;;;5,0;;;;;;;;;;;;;;;2,0;7,0;;;;7,0;1,0;;;;;;;;;;;;;;4,0;;;;;;;;;;;;;;1,0;;2,0;;;;;;2,0;;;;;;;;;;;;;;;;;;;;;;;;;;;1,0;;;1,0;;;;;;;;;;;;;;;;;;;;;;;;;;;;;;;;;;3,0;;;;;;;;17,0;;;;2,0;;;;;;;;;;;;;;;;;;;;;;;;2,0;;;;;1,0;;;;;;;;2,0;;1,0;;;2,0;;;;;;5,0;1,0;;;;6,0;;;;;5,0;;;2,0;;;;;8,0;1,0;5,0;;;;;1,0;;;2,0;;;;1,0;;;;;1,0;5,0;;;;;;;1,0;;;;;;;;;;;;;;5,0;;;;2,0;;8,0;1,0;4,0;;;;1,0;;1,0;;1,0;;2,0;;;;;2,0;2,0;;;;;1,0;;;;;;;1,0;;;;;;;;;;;;;;;;;;;;;;1,0;;;;;;;;;;2,0;;;2,0;;;;;;;;;;;;;;;;;;;;;;;;3,0;;;;;;;;4,0;;;;;;;;;5,0;;;1,0;;6,0;;;1,0;;;1,0;;;;;;;;;;;2,0;;;;;;;;;;;;;;;1,0;;;;;;;;;8,0;;;;;;;;;;;;;;;;;;;1,0;;;;;;;;;;;;1,0;;;;;;1,0;;8,0;;6,0;;;;;;;;;;;;;;;;;;;;;;;;;;;;;;;;;;;;;;;;;;;;;2,0;;;;;;;;;;;;;;;;1,0;;;;;;;;;;;;;;;1,0;;;;;;;;;;;;;;;;;;;;6,0;;;;;;;;;;2,0;;;;;;3,0;;5,0;;;;;;1,0;;2,0;;;;;;;;;2,0;;;;;4,0;;;;;;;;;;1,0;;;;;;;;;;1,0;;;;;;;;;;;;;;;;;;;;;3,0;;;;;;;;;;;;;;;;;8,0;;;;;;;;;;;;;;;;;;;;;5,0;;;;;2,0;;;;;;;;;;;;;;;;;2,0;;;;;;;;;;;;2,0;;;;;;;;;;;;;;;;;;;;;;;;;;;;;;;;;;;;;;;;;;;;;;;;;;;;;;;;;;;;;;;;;;;;;;;;;;;;;;;;;;;
criterion;;;;;;24,0;;1,0;3,0;;;;;;;29,0;;;;;;4,0;;;;;;;;;4,0;;4,0;;3,0;;;;;;21,0;;12,0;;5,0;14,0;32,0;6,0;15,0;4,0;;4,0;;1,0;;;3,0;5,0;3,0;;;;;;4,0;;1,0;;8,0;;3,0;;;;1,0;;7,0;;;62,0;;1,0;;30,0;;;;1,0;;;;3,0;;;6,0;;;;52,0;;;;;8,0;;;;5,0;2,0;8,0;;3,0;;;1,0;5,0;;;;60,0;;;;6,0;5,0;;7,0;;;;;;;;2,0;3,0;;7,0;5,0;31,0;6,0;;;3,0;4,0;3,0;;;7,0;1,0;2,0;;1,0;1,0;26,0;;12,0;;;;4,0;;5,0;4,0;;;6,0;6,0;;;;;;;1,0;5,0;;;;;1,0;;;;;;;;;;;7,0;;;;;;;;;;;3,0;7,0;;;;;1,0;;;;;;;;;;4,0;;;;;;;;;;1,0;;1,0;;1,0;;;;5,0;5,0;;;2,0;;;;1,0;;;;;;;;;;;;2,0;1,0;;;;;;19,0;;;10,0;;1,0;;;3,0;;;;;;;;3,0;;;;;;13,0;;;;;1,0;;;;;;3,0;;;;;2,0;;;3,0;;;2,0;;;;;;;;1,0;;;2,0;;;;;;1,0;;;;;;;;;;;;3,0;;;;;;;;;;;;;2,0;;;;;;;;3,0;;;;;;;;;;;;;;;;2,0;;;;;;;;;4,0;;;;;;;;;1,0;1,0;;;;;;;;;;;1,0;;;;;3,0;1,0;;2,0;2,0;;;;;;;;;1,0;2,0;5,0;;;5,0;4,0;;;;;1,0;;8,0;;10,0;;;;1,0;22,0;;;;;;;;;;;;;1,0;3,0;;1,0;;1,0;;;3,0;1,0;;;;;7,0;2,0;;1,0;3,0;;11,0;;;;;2,0;1,0;;1,0;2,0;;;;;;;;;12,0;4,0;;;1,0;;2,0;;;;;1,0;5,0;;;;;;1,0;;;;7,0;;;;;;;1,0;;;;;;;;;;;;;;;6,0;;;;;;;;;1,0;1,0;;;35,0;;;3,0;;;;;;;;;;;3,0;;;;;;;;;;;;4,0;;;;;;;5,0;;;;;;;;;;;;;;;;;;;;2,0;;;;;;;;;;;;;;;;;3,0;;;;3,0;;;4,0;;;1,0;;;1,0;;;;;;;;;;;;;;;;;2,0;;;;;;;;;;;;;;2,0;;;;;;;;;;;;;;;;;;;;;;;;;;;;;;;;;;;;;;;;;;;;;;;;;;;;;;;;;;;;;5,0;;;;;;;;;;;;;2,0;;;5,0;;;;;;;;;;;;;;;;;;10,0;;;;;;3,0;;;1,0;;;;;2,0;;;;;;;;;3,0;;;;8,0;7,0;;;9,0;;1,0;;;;;;;;;2,0;;;1,0;;;;;;1,0;;1,0;;37,0;;;;;;;;;2,0;1,0;;;;;;;;2,0;;;;;;;;;;;;;12,0;;;;;;;;1,0;;;;;1,0;;;;;;;;1,0;2,0;;;;;1,0;;;;;;;;;;;2,0;;;;;;;;;;;;;;;;12,0;;;;;;;;;;;;;;;;;2,0;;;;;;;;;;;;;;;;6,0;;24,0;;;;;;;;;;;;;2,0;;1,0;;;;;;;;6,0;;;;;;;;;;;;;3,0;;;;;;;;1,0;;;;;;;;;;;9,0;;2,0;;;;;;;;;
crop;;;;;;3,0;;6,0;17,0;2,0;;;1,0;;;9,0;;;;;;15,0;;;;;4,0;;;;;;7,0;2,0;3,0;3,0;4,0;3,0;4,0;;6,0;;7,0;2,0;5,0;;7,0;3,0;7,0;13,0;;5,0;3,0;1,0;;;;;;2,0;1,0;;3,0;;;9,0;3,0;1,0;45,0;;1,0;;12,0;;;1,0;3,0;;1,0;228,0;;;3,0;10,0;1,0;5,0;;;;8,0;9,0;;;11,0;;1,0;;;26,0;;1,0;1,0;2,0;10,0;;;;3,0;2,0;29,0;4,0;22,0;;;;45,0;40,0;16,0;;5,0;;;3,0;;18,0;1,0;;;;1,0;;;1,0;6,0;;20,0;2,0;;;;1,0;;4,0;14,0;1,0;;;7,0;2,0;22,0;;;1,0;;;;17,0;;1,0;;;;3,0;;;;37,0;4,0;;;15,0;;;;5,0;3,0;1,0;;;;;2,0;;;;1,0;;;5,0;;;;;;;;;;;;;;;4,0;;;;;;4,0;;;;;;;;;;;;;;;;;;;1,0;;;;;3,0;;2,0;3,0;;12,0;;9,0;;;11,0;;;;3,0;7,0;;;;;;;;5,0;;;;;;;3,0;;;;;;;;3,0;;;;;;;;4,0;1,0;;;;;24,0;;5,0;;;7,0;10,0;;;;;;;;;;;;;;;;;2,0;4,0;1,0;1,0;;;3,0;8,0;;;;;1,0;;;;;;;;;;;;;;;;;4,0;;;;;1,0;;1,0;;;;;;;;;4,0;;;;;1,0;22,0;;;;;;;;;;;;;;;;;;;3,0;;;;;;;2,0;;;;;;;;1,0;;;;;4,0;;;1,0;;;;;;;1,0;2,0;5,0;;;1,0;1,0;;;;;;2,0;;;;;;;4,0;;;;6,0;7,0;;;;2,0;;;;3,0;1,0;4,0;;;5,0;8,0;1,0;;;4,0;;;;;;;;;;2,0;1,0;;;;;;;;;;;;2,0;8,0;;;;;;9,0;;1,0;4,0;1,0;;;2,0;;;;;;;12,0;;1,0;;7,0;;5,0;;;1,0;;;;;;;18,0;8,0;;;13,0;;;;5,0;;;1,0;;;10,0;;;;3,0;;;;1,0;4,0;;;3,0;1,0;;2,0;;;;1,0;2,0;8,0;12,0;;;;;;;2,0;;;;;;4,0;;;;;;;6,0;;;;1,0;;;;;2,0;;;;;;;2,0;6,0;;;;;;;;;;;;;;2,0;3,0;;1,0;;1,0;1,0;;;;;;;1,0;;1,0;2,0;;;;;;;;;;6,0;;;41,0;;;4,0;;;;10,0;;;;;;;;;;;28,0;;1,0;;;1,0;;;;;1,0;;;;;;;;;;;2,0;;;;;;;;;;;;;;;;;;;;19,0;;12,0;;;;;2,0;;;1,0;1,0;;1,0;;;;;;;;;;;;;;;;;;;;;;;;;1,0;;;;;;;;3,0;;2,0;;;;;;;;;;;;;;;;;;;;;;;;;2,0;;;;;;2,0;;;1,0;;;;;1,0;16,0;;20,0;;;2,0;;;;;;;;2,0;;;11,0;;5,0;;;;;;;;;;;;;5,0;;;;;;1,0;;;5,0;;;;;;;;;;3,0;;;;;;;;;;;1,0;;;;;;;;;;;;;;;;;;;;;;;;20,0;;;;;;;;;;;;3,0;;;;;;;;;;;;;;;;;;;;;;;;;;;;;;;;;;;;;;;;;;;;;;;;;3,0;;;;4,0;;;;;;;;;;;;;;;;2,0;;;;;;;;;;;;;;5,0;;;;;;;;;;;;;;1,0;;2,0;;;;;;;;;;;;;;;;;;;;;;3,0;;;;;;;15,0;
cross;;;;;;19,0;;3,0;17,0;9,0;;;1,0;;34,0;10,0;5,0;;;;;1,0;1,0;3,0;;;2,0;4,0;2,0;;;;3,0;1,0;2,0;;2,0;1,0;;;;;8,0;;2,0;5,0;6,0;10,0;1,0;;;5,0;;;;22,0;6,0;1,0;;;5,0;2,0;;;2,0;;;11,0;6,0;4,0;1,0;1,0;;;3,0;2,0;;;10,0;20,0;3,0;8,0;;14,0;2,0;2,0;;;;1,0;13,0;;;17,0;;;3,0;;18,0;;;5,0;20,0;28,0;;1,0;24,0;;2,0;1,0;;1,0;;;;4,0;31,0;5,0;;2,0;1,0;11,0;;1,0;;2,0;;;;;;7,0;1,0;;;;3,0;2,0;;;2,0;;;3,0;;;;23,0;;5,0;;1,0;;;1,0;;11,0;;1,0;;;;8,0;;;;2,0;15,0;;;2,0;;;4,0;2,0;;7,0;6,0;;;;3,0;;2,0;;2,0;;;;;;;2,0;1,0;;3,0;;;;6,0;;1,0;;34,0;;1,0;;;;2,0;2,0;6,0;;1,0;;;9,0;;1,0;3,0;9,0;1,0;1,0;;;;;2,0;6,0;;38,0;;4,0;4,0;2,0;1,0;3,0;11,0;1,0;;;;;;;1,0;;;8,0;11,0;2,0;2,0;5,0;;;;2,0;;;2,0;9,0;1,0;;4,0;;1,0;27,0;;1,0;;;1,0;6,0;1,0;;;;1,0;;17,0;;;2,0;1,0;;;;;;;1,0;5,0;2,0;;1,0;;;3,0;;;;;4,0;;;;;;;;;1,0;;;;;;6,0;2,0;6,0;;;1,0;4,0;2,0;;5,0;;;;;;;;;5,0;;4,0;;3,0;3,0;;;;;4,0;;;1,0;1,0;;5,0;;;;;3,0;28,0;;8,0;11,0;;1,0;5,0;7,0;;;;;2,0;;;;;;2,0;2,0;;6,0;1,0;;;;1,0;;;1,0;;;1,0;;1,0;2,0;;;;;;;;;;;;;;;;;4,0;20,0;;;;1,0;;;1,0;1,0;;1,0;;;1,0;;1,0;;5,0;;;;3,0;;1,0;;3,0;;;;;2,0;;;;;1,0;;1,0;3,0;;;2,0;;;;;1,0;;;;;;;;;;;;2,0;3,0;;2,0;2,0;;;1,0;8,0;;10,0;2,0;1,0;;;6,0;6,0;;;;;3,0;;;;1,0;;;;3,0;2,0;;2,0;;;1,0;;;;;;;4,0;;;;;;;;;;2,0;;2,0;3,0;;;;;;;;2,0;1,0;;;1,0;;1,0;;;;5,0;;;;;;;;;;;;;;3,0;;;;;;;;;6,0;;1,0;;;;;;3,0;;;;1,0;;;;;1,0;;;;4,0;;;1,0;;;;;1,0;;;;;;;3,0;;8,0;;;1,0;;;;;;;2,0;;;;;8,0;;;;;;;;;4,0;;;;;;;7,0;;;;2,0;;;;;;;1,0;;;2,0;;;;;;2,0;;3,0;;1,0;;;;;;2,0;1,0;2,0;;9,0;;1,0;;7,0;;2,0;;;;;2,0;;;;5,0;;;;;1,0;1,0;;;1,0;;;;2,0;;;3,0;;;;;2,0;;5,0;;2,0;;;;;;;;;;;6,0;;;;4,0;;;4,0;2,0;;;2,0;;;6,0;;1,0;;5,0;;3,0;;;;;;1,0;;;;2,0;;;;;;;2,0;;;;;;5,0;;1,0;;;1,0;;;;;;;1,0;;;;;;;;;;;;;;;;;;4,0;2,0;10,0;;;;;1,0;;;;;;;;;;;;;1,0;;;;;;;;;2,0;;;1,0;;;;;;;;;;3,0;;;;;;;2,0;;;;;;;;;;;;;;;;;;;;;;;;2,0;;;;;;;;;;;;;2,0;;3,0;1,0;;;;;;;;;;;;;;;;;;;;;;;2,0;;;;;;;5,0;;;;2,0;;;2,0;;;;;;;2,0;;;2,0;;4,0;;;;;;;;;;;;;;;;9,0;;;;2,0;;;;13,0;;;3,0;;;;;;;;;;;;;;;;;;;;;;;;;;;;;;;;12,0;;;;;;;;;;;
decide;;;;;;25,0;;5,0;4,0;;;;;;;14,0;;;;;;;12,0;;;;5,0;1,0;;;4,0;26,0;41,0;2,0;7,0;50,0;1,0;3,0;2,0;;1,0;;10,0;;3,0;11,0;3,0;82,0;6,0;2,0;;7,0;;;3,0;2,0;;;;;;23,0;;;;1,0;9,0;1,0;2,0;;;;1,0;;;1,0;;;;17,0;;6,0;;17,0;;;5,0;;;1,0;37,0;8,0;;;;;;;5,0;;;;1,0;18,0;;;;;;28,0;;1,0;;;;33,0;5,0;9,0;;7,0;;;4,0;3,0;2,0;4,0;5,0;;;2,0;1,0;;;;3,0;;1,0;;;;;;;;1,0;;;;4,0;;14,0;;1,0;;14,0;;2,0;;;2,0;;;45,0;;;;2,0;;;;5,0;;;1,0;47,0;;;;;;;7,0;;;;;;;;;;;;;;;;;;;;;;12,0;;;;;57,0;;;;;;;;;;;;;;;;;;;;54,0;;;;;23,0;;1,0;;;2,0;;;;;1,0;;;;;9,0;;;;;;;;3,0;;;;;;;;;;;;;;;7,0;;;;;1,0;;;1,0;;;;;;1,0;2,0;;;;;;;;;;1,0;;;;;1,0;;;;;;;;;;2,0;;;;3,0;;;;;;;;;17,0;;;;;;;;;;;;;;;;;;;;;;;;;2,0;;;;3,0;;;;3,0;;;;;;;;;;;;;;;;;;;;;;;;;;;;;;;;;;5,0;;;;;;;2,0;;;;;6,0;;;;;1,0;;1,0;;;;;;;1,0;;;;;;7,0;;;;1,0;;;;;2,0;;;;1,0;;2,0;;3,0;;1,0;;;;;;2,0;3,0;4,0;;;;;1,0;;;;2,0;;;1,0;22,0;;;;;6,0;3,0;;;;6,0;1,0;;;;;;1,0;;;;1,0;;;;;;;;;;1,0;;;;;;3,0;;;2,0;;;;;;;;;;13,0;;;;;;;;;;2,0;;;;;;1,0;;;;1,0;24,0;;;2,0;;;;;;;;;;;;;;;;;;;;;;;;1,0;;;;1,0;;;;;;;;;;;;;;;;;;;31,0;;;;;;;;;;;;;;;;1,0;;;;;;1,0;;;;;;;;;1,0;;4,0;;;;;;2,0;;;20,0;;;3,0;;;;;2,0;;;;;;;;;;;2,0;;;;;;;;;;;;2,0;;;;;;;;;;2,0;;;;;;;;;;;;;;;;;;;;;;;;;;;;;;;;;;;;;;;1,0;2,0;;;;;;1,0;;;;;;;;;;;;;;;;;;;;;;;;;;;;;;;;;;;;;;;;;;;;;2,0;;;;;;4,0;;;;;;;;1,0;1,0;;;;;;10,0;14,0;;;;;;;;5,0;;4,0;;;;;;;;;;;;;1,0;;3,0;;;4,0;;;;;1,0;;;;;;1,0;;;2,0;1,0;;;;;;;;;;;7,0;;;;;;;;;;;;;;;;;;;;;;;;;;;;;;;;;;;;;;35,0;;;;;;;;;;;;;;;;;;;;;;;;;;;;;;;;;;;;1,0;;;;;;;;;;;;;;;;;;;;;;;;;;;;;;;;;;;;;;4,0;;;;;;;;;;;;;;;;;;2,0;3,0;1,0;;;;;;;;;;;;;;;1,0;;;;;;;2,0;;;;;;;;;;;
decode;;;;;;3,0;;23,0;10,0;;;;;;;24,0;;;16,0;;;25,0;;;;;10,0;;;;13,0;;38,0;;7,0;1,0;5,0;3,0;;;136,0;;1,0;2,0;8,0;1,0;24,0;40,0;18,0;32,0;1,0;;;;;;1,0;5,0;;;8,0;;;3,0;2,0;;;2,0;143,0;;;;45,0;;;3,0;7,0;;1,0;147,0;;8,0;3,0;23,0;;1,0;;;;1,0;2,0;2,0;1,0;;;1,0;5,0;;44,0;1,0;;1,0;3,0;;;2,0;7,0;2,0;25,0;9,0;;20,0;;;2,0;22,0;3,0;1,0;;;;;6,0;16,0;18,0;9,0;;;;;;10,0;;;;;3,0;1,0;8,0;;;;1,0;6,0;8,0;;;;90,0;3,0;;;5,0;8,0;;2,0;22,0;;;1,0;2,0;1,0;32,0;;;;49,0;3,0;;;;;;;;;;;;;;;;;;8,0;;;;;4,0;10,0;;;;1,0;1,0;;;;;;;1,0;;;;;;;;;;;;;;;;;;;;;;;;;;;;;;;;;;;;;2,0;;;;8,0;;;;59,0;;;5,0;;;;;28,0;;;;;;;2,0;;;;;28,0;;;;;;;;1,0;5,0;;5,0;;2,0;;;;2,0;;;;;1,0;;;;;;;;;;;;;;;;;3,0;;13,0;;2,0;;;;;;;;;;;;;;;;;;;;;;;;;;;;;;;1,0;;;;;;;40,0;;;;;;;;;5,0;;;;;;;;;;;;;;;;;;;;;;;;2,0;;;;;;;;;8,0;;1,0;;2,0;;;;;;;;1,0;;;;;2,0;;3,0;104,0;;;1,0;;2,0;;;;;;3,0;2,0;;2,0;;;;;;11,0;6,0;;2,0;;;;;9,0;;6,0;;;;;15,0;;3,0;;;;;;14,0;;1,0;;;;6,0;;;;;;;;;;;;;6,0;2,0;;;;;;2,0;;;;;;3,0;;;23,0;;;;5,0;2,0;;5,0;5,0;3,0;2,0;;;1,0;;;;;;38,0;2,0;4,0;1,0;;;28,0;;;;;;;;5,0;;;;6,0;;2,0;6,0;;;;;;;1,0;2,0;6,0;;;;;;;;;3,0;;;;;;;44,0;;;;;;7,0;3,0;2,0;1,0;;2,0;1,0;;1,0;;6,0;;1,0;;4,0;;;;2,0;;;;;;;;;;;;;;;;;;;7,0;;;6,0;;;11,0;5,0;;;;;;;;;;1,0;;;1,0;;1,0;;;;4,0;;;7,0;;;3,0;;;;2,0;1,0;;;1,0;1,0;;3,0;1,0;;4,0;;;;;;1,0;;5,0;;3,0;;;;;;;;5,0;;;1,0;;;;;;;;;;;;;;;;;;;;;;1,0;;13,0;;;;;;;;;;6,0;;;;2,0;;;;;;;;;;3,0;;;;;;;;;;;;;;;2,0;;;;;;;;3,0;;;;;;;;;;;4,0;10,0;;;;;4,0;;;;;;1,0;;;;;5,0;;;;;;;;;;10,0;;;;;1,0;;;;;;;;1,0;;;2,0;;;;;;;;;;;2,0;;;;;;;;;;;;;;;;;;;;5,0;;;;;;;;;;;;;;;;;;;;;;;;9,0;;;;;;;;39,0;1,0;;;;;;;;6,0;;;10,0;2,0;;;;;;;;;;;;;;;;;;;;;;;;;;1,0;;;;;;;;;;;;;;;;;;;;;;;;;;;;;;;;;;2,0;;4,0;;;;;3,0;;;;;;;;;;;;;;;;;;;;;;;;;;;;;;;;14,0;;1,0;;;;;;;;;;4,0;;;;;;;;;;;;;;;;;;;;;;;
delay;;;;;;2,0;;10,0;;2,0;;;17,0;1,0;;36,0;1,0;;1,0;;;19,0;5,0;;;;;;;2,0;1,0;;121,0;;68,0;7,0;4,0;10,0;;;137,0;1,0;;;50,0;14,0;28,0;39,0;7,0;6,0;47,0;4,0;;;13,0;;242,0;;1,0;2,0;;;;;;;5,0;18,0;35,0;;24,0;;21,0;3,0;2,0;;;;3,0;70,0;;13,0;42,0;209,0;1,0;16,0;;;;;13,0;;2,0;;1,0;;5,0;;44,0;;;;5,0;;;2,0;1,0;;151,0;;4,0;14,0;;;3,0;217,0;1,0;2,0;19,0;64,0;1,0;;2,0;20,0;4,0;3,0;2,0;;;11,0;1,0;109,0;1,0;;;;9,0;55,0;;3,0;7,0;;1,0;6,0;80,0;;;10,0;275,0;1,0;;;5,0;9,0;3,0;64,0;41,0;;;15,0;;27,0;313,0;;2,0;;50,0;;;;3,0;;;;287,0;6,0;;;;;;6,0;;;2,0;174,0;;1,0;;;;;;14,0;;;;;;;;;7,0;;;;1,0;;6,0;;;;;;;;;;;;1,0;;;1,0;;;;;78,0;;;;22,0;;;;;;;;;;1,0;10,0;90,0;;;;;;6,0;;;;;10,0;16,0;4,0;;;;;;18,0;;;1,0;;2,0;;;1,0;;;;;28,0;1,0;;;2,0;9,0;;;;325,0;;;;;3,0;4,0;;;;;;;;;;1,0;;;;;;1,0;;;;;;;1,0;2,0;;;;4,0;;;;;4,0;;;;;;;;;;;;;;2,0;;;;;8,0;;;31,0;2,0;4,0;;;;;13,0;;;;;1,0;;;2,0;;;;;;;;12,0;;;;;;;;;;;;;1,0;;;;;;;;;2,0;6,0;;;50,0;;;;;;;;;;;12,0;;4,0;18,0;20,0;9,0;4,0;;;;;;;;;1,0;;2,0;1,0;;10,0;;;2,0;;49,0;21,0;1,0;1,0;;3,0;27,0;;;2,0;3,0;;;5,0;1,0;7,0;;;33,0;;;;64,0;4,0;4,0;12,0;;;;;;;1,0;;;;;12,0;;;;15,0;9,0;1,0;;;2,0;52,0;;139,0;;;;;7,0;;;;;;;17,0;5,0;;1,0;;;2,0;;1,0;;;;9,0;;;;;;;;;;;48,0;;;;;25,0;;1,0;110,0;;;5,0;;;;;3,0;4,0;2,0;;;15,0;;1,0;28,0;;;;2,0;;1,0;;;;;7,0;;6,0;;;;;;;;;1,0;;;;;;5,0;;1,0;;;;;;;;;;;;;;1,0;1,0;11,0;;;2,0;;;;1,0;;;;;;1,0;;;;;;1,0;;2,0;;3,0;;;2,0;;;;2,0;;2,0;;;;1,0;;;;;;;;12,0;1,0;;;5,0;;;;;;;3,0;;;4,0;;2,0;;;2,0;;2,0;5,0;;;;;;;;;;89,0;;;6,0;;;6,0;;;;;54,0;;;;;;;;;;10,0;;;;;;5,0;;23,0;;;;;;;;;;;;;;;;1,0;;;;;;;;;;;;;;;;;;;;;21,0;;;;;;;13,0;;;2,0;;1,0;;;;1,0;;;;;;;;;;;;4,0;;;;;;;;;;;;1,0;;;;;;;;;;;;3,0;;;;;;2,0;;;;5,0;;;;;;;;1,0;;;;;;;;;1,0;;;;;;;;;;8,0;;;;;;;;;;;;;;;3,0;;4,0;;;;;;;1,0;;;;;;;;;2,0;;;2,0;;8,0;;3,0;;;;;;;;3,0;1,0;;;;;;;;;;;;2,0;;;;;;3,0;;;;2,0;;;2,0;;;;;;;;;;;;;;;;;;;;;;;;;;1,0;;;;;;;;;;;43,0;;;;;1,0;;;;;;;;;;;2,0;;;;;2,0;;;;;;;;;;;;27,0;;;;;;2,0;;;;;;;;3,0;;;;;2,0;;;;;;;;;;;;;;8,0;;;;;;
denote;;;;;;7,0;;7,0;7,0;;;;;;2,0;6,0;;;;;;;;;;6,0;;;;;;21,0;;;;;;;;2,0;2,0;;;3,0;;;;1,0;;;;28,0;;;;;6,0;;2,0;;;;;;1,0;56,0;3,0;1,0;13,0;5,0;5,0;;;;;8,0;;;2,0;35,0;;6,0;;4,0;;;;;6,0;49,0;59,0;;;6,0;;8,0;;;6,0;;;;;21,0;;;13,0;;;6,0;;;;;;;;;;2,0;;2,0;;;;;;;;;;5,0;;;4,0;;;;;32,0;;;;2,0;;;;14,0;3,0;1,0;;;;;;;15,0;10,0;;;;;5,0;;;;;;;;18,0;;;;1,0;;;;;;;;;;;;;;;;;;1,0;;;3,0;;;;;;;;2,0;;;;;;;;;;;;;;;10,0;;;;;;;;;;;;;;;1,0;;;1,0;;;;;;;;;;4,0;;3,0;1,0;;;;;;;;;;11,0;;;;;;;;;;;;;;;;;;;;10,0;;;;5,0;;8,0;;;;;7,0;;4,0;;;;2,0;;;;;;;;;;;;;3,0;;;;;;;;;3,0;;;;3,0;;;;;;;;;;;;;4,0;3,0;;;;;;;;;;;;;;;;;;;;;7,0;;;;;;;;;;;;;;;;;;;;;;4,0;;;;;;;;;;2,0;;4,0;;;;;;4,0;;;;;;1,0;;;;;;1,0;;;3,0;2,0;;2,0;;;;;;;;;;;;;;;;;2,0;1,0;;;;;1,0;;;;;;;;;;;;;3,0;;;10,0;;;;;;;;;;;;;;;;;;;;;;1,0;;;;;;;8,0;2,0;3,0;;;;;;;;;;;;;;;4,0;;;3,0;;;4,0;;9,0;;;;;;;;;;;;;;;;;;;;;;;;;;;;;;;3,0;;;;2,0;;1,0;;;;;;;;;;;;;;;;;2,0;2,0;;;;;;;;;;;;;;;;;;;;;;;;;;;;;;;;;;;;;;;;;;;;;;;;;;;;;;4,0;;;;;;;;;1,0;;;;;;;;;;;;;;;;;;;;;;;;;;;;;;;;;;;;;;4,0;;;;;;;;;;;1,0;1,0;;;;;;;;;2,0;;;;;;;1,0;;;;;;;;;;;;;;;4,0;;;;;;;;;;;;;;;;;;;;;4,0;;;;;;;;;;;;;;;;;;;;;;;;;;;;;;;;;;;;;;;3,0;;;;;;2,0;;;;;1,0;6,0;;;;;;;;;;;;6,0;;;;;;;;;3,0;;;;;;;;;;5,0;;;;2,0;;;;;;;;2,0;;;;;;;;;;1,0;;;;;;;;;;;;;;;;17,0;3,0;;;;;;;;;;;;;;;;;;;;;;;;;;;;;;;;;;;;;;;;;;;;;;;;;;;;;;;;;;;;;;;;;;;;;;;;;;;;;;;;;;43,0;;;;;;;;;;;;;;;;;;;;;1,0;;;;;;;;;;;;;;;;;;;;;;10,0;;;;;;;;;;;;;;;;;;;;;;;;;
describe;;;;;;9,0;1,0;25,0;3,0;1,0;11,0;2,0;1,0;1,0;8,0;4,0;;;;4,0;5,0;19,0;2,0;;;2,0;;1,0;;;1,0;12,0;5,0;;4,0;3,0;2,0;1,0;2,0;1,0;58,0;;1,0;9,0;5,0;2,0;6,0;94,0;22,0;8,0;1,0;6,0;;;1,0;;2,0;2,0;5,0;;;;5,0;2,0;4,0;8,0;3,0;4,0;4,0;;6,0;1,0;9,0;1,0;;2,0;;2,0;;54,0;7,0;15,0;3,0;36,0;2,0;;;;;1,0;9,0;5,0;;3,0;;5,0;3,0;5,0;83,0;7,0;4,0;;94,0;18,0;;1,0;9,0;3,0;;4,0;;3,0;1,0;;;19,0;8,0;18,0;1,0;;;;2,0;;5,0;;2,0;;;;;2,0;2,0;;1,0;1,0;4,0;1,0;;;12,0;;;27,0;;;;3,0;;1,0;1,0;1,0;5,0;1,0;3,0;;58,0;;2,0;;2,0;2,0;4,0;3,0;;;6,0;3,0;3,0;;1,0;;;;;1,0;5,0;3,0;;1,0;7,0;2,0;;1,0;;4,0;;7,0;;;;2,0;;2,0;;3,0;;;;1,0;1,0;4,0;;4,0;5,0;3,0;;;;1,0;;;;;3,0;;;;2,0;5,0;9,0;;4,0;;1,0;;2,0;;11,0;;14,0;;;12,0;2,0;;9,0;21,0;1,0;;;;;;;;;6,0;13,0;14,0;8,0;;5,0;;;2,0;12,0;;;;;;2,0;8,0;;1,0;2,0;1,0;3,0;;;;11,0;;;3,0;;;7,0;17,0;1,0;;;;;3,0;;;;1,0;4,0;;;;2,0;;;;7,0;;;;4,0;;;;;10,0;3,0;;;;1,0;;;4,0;;8,0;;;;;;;3,0;;1,0;;;;;3,0;2,0;;;;4,0;;3,0;2,0;;;;;1,0;;;5,0;;2,0;;4,0;;;;;;3,0;24,0;4,0;;;;;1,0;;;;5,0;;2,0;;;;;;;;3,0;1,0;;;;;;3,0;;;;;2,0;7,0;6,0;;;;;;;;;3,0;1,0;1,0;;;6,0;;19,0;4,0;2,0;;;;22,0;;1,0;;;;;;1,0;1,0;;2,0;;7,0;;;3,0;5,0;4,0;;;;;3,0;7,0;;2,0;6,0;1,0;;1,0;2,0;2,0;;17,0;;1,0;;;;1,0;3,0;;6,0;;;;;;;;;1,0;;;4,0;;;;;25,0;;1,0;2,0;2,0;;1,0;;2,0;;3,0;;;;;2,0;;2,0;3,0;1,0;2,0;;2,0;;;1,0;2,0;;3,0;;5,0;;1,0;;;;1,0;2,0;;;;;1,0;;;;;;;;5,0;4,0;1,0;;;;1,0;;8,0;1,0;;;;1,0;;;;;1,0;;;;1,0;8,0;;;;3,0;;2,0;;3,0;;1,0;;1,0;;1,0;;;2,0;;2,0;;;1,0;;4,0;;;;3,0;;1,0;;;;;;;8,0;12,0;1,0;;;;1,0;1,0;;;;;;16,0;;;;;1,0;6,0;;2,0;1,0;;2,0;;;;;;;;1,0;5,0;;;;;;;1,0;;4,0;;;;;;;;;3,0;1,0;;1,0;;;;;;1,0;;1,0;;;5,0;;1,0;2,0;1,0;1,0;;1,0;;;;;;1,0;6,0;3,0;;;;;;1,0;;;;;;;;1,0;;;;2,0;;;1,0;;1,0;1,0;;;;;1,0;;;1,0;;1,0;;;;1,0;;;;;;;;;;;;1,0;;;;;;;;;;;6,0;;;;2,0;;;;1,0;;;1,0;;;;;;;;;;1,0;;;1,0;;;;1,0;;2,0;;2,0;4,0;;;;;4,0;;;;;;;;3,0;;2,0;;;;;;;4,0;;;;;;5,0;;;2,0;;2,0;;;;;;;1,0;;;;;;;;;;;;;;;1,0;;;;;;;1,0;;3,0;;;;;;;;;1,0;;;;11,0;1,0;;;;1,0;14,0;;;;;;1,0;;;;1,0;1,0;1,0;;3,0;;1,0;;;;;;;;;;;;;;1,0;2,0;;;;;;;;;;;;1,0;;;1,0;1,0;;;;;;1,0;;;;;1,0;1,0;1,0;6,0;;;;;;;;;;;;;;;;;1,0;;;;;;2,0;;;;;;;;;1,0;;;;1,0;;;;;;1,0;;;;;;;;;1,0;;;;3,0;;;;;;;;;;;;;;;;;5,0;;;;;2,0;;;1,0;;;;;;;;;;;;;;;;;
designate;;;;;;17,0;4,0;1,0;72,0;;4,0;;9,0;;3,0;13,0;;;4,0;;;26,0;27,0;;;2,0;7,0;3,0;;;6,0;1,0;3,0;5,0;23,0;4,0;4,0;;;;38,0;2,0;;;28,0;;11,0;17,0;21,0;18,0;;9,0;3,0;7,0;3,0;;3,0;;1,0;;;3,0;5,0;4,0;;6,0;3,0;;31,0;;3,0;;6,0;;;2,0;2,0;;;148,0;5,0;3,0;;11,0;1,0;4,0;;;;49,0;11,0;;1,0;;;1,0;6,0;;21,0;;;;2,0;42,0;;;;;11,0;4,0;1,0;14,0;;;7,0;42,0;11,0;22,0;2,0;4,0;;;;8,0;2,0;8,0;;;;;;9,0;5,0;;3,0;3,0;1,0;6,0;4,0;;6,0;;;4,0;22,0;;;3,0;37,0;5,0;29,0;;9,0;10,0;;2,0;4,0;;8,0;6,0;;5,0;29,0;;1,0;;12,0;17,0;;;;;;2,0;;;;;;;;;;;1,0;10,0;;7,0;;;;;;;;;;;;;;1,0;;23,0;;;;;;1,0;;;;2,0;;;;;;;5,0;;;;;;;;4,0;;1,0;;;;1,0;2,0;2,0;2,0;6,0;;;;;2,0;;;;;25,0;6,0;;;;;;;5,0;;;;;;;11,0;;;6,0;2,0;9,0;;;3,0;;;;;5,0;;;7,0;;1,0;;;;8,0;;11,0;;;;6,0;;;;;;;;;;;;;;;;;;1,0;;;;;2,0;2,0;;;;;;;;;;;;;;;;;;;;3,0;;;;;;;1,0;3,0;3,0;;;2,0;;;;;;;;;;30,0;1,0;3,0;;;;;;;;;;;;;;;;;;;;;;;5,0;;4,0;6,0;;;;;;3,0;;;;4,0;;;2,0;10,0;;;;;;;;;;;11,0;2,0;;;;;;1,0;;;;2,0;3,0;12,0;;;;;;;;32,0;1,0;;8,0;;7,0;1,0;7,0;;5,0;16,0;3,0;;17,0;2,0;11,0;;;10,0;4,0;;;;4,0;7,0;;;;1,0;1,0;;;3,0;;;;;12,0;2,0;;;;4,0;35,0;2,0;;;;;18,0;;;3,0;2,0;;;;;;;;1,0;;;;;;14,0;;;;;3,0;4,0;;;;10,0;;;3,0;;;;;;;2,0;;;;;;2,0;1,0;;;;1,0;1,0;;1,0;2,0;;;2,0;;;10,0;;;;2,0;7,0;3,0;2,0;;;2,0;1,0;;;;19,0;;;;;1,0;;;5,0;3,0;4,0;;;8,0;;2,0;;;;;;1,0;;;;;;;;;;2,0;;10,0;;2,0;;;;;;;2,0;3,0;4,0;;1,0;;;;;6,0;;;;;;9,0;;;;;;2,0;;;;;;;;;16,0;5,0;;;8,0;;1,0;;;2,0;4,0;;1,0;;;;;;1,0;;;;1,0;;;2,0;;;;;;;;;;;3,0;;;;;;;;;;;;;;;;;;;;;;;;;1,0;;;;1,0;;;;;;;;;;;;;;1,0;;1,0;;;;;;;;;;;;;;;;;5,0;;;;;;;14,0;;;;;;;;;;;;;;;;;;;;;;;;;;;1,0;;;;;;1,0;;19,0;4,0;;3,0;;;;;;;;;3,0;1,0;2,0;;;;;;;;;;;4,0;;;;;;;;1,0;;;;;;;;;4,0;;;;;;;;8,0;;;;;;;;;;;;;;;5,0;1,0;;7,0;;;;;3,0;;;;;;;;;;;;;;;;;;;6,0;;1,0;;1,0;;;;1,0;;1,0;1,0;;;;;;;2,0;;1,0;;;;;;;;1,0;2,0;;;;;;;;;;;8,0;1,0;;;;;;;;;;;;;;;;;;;;;;;;1,0;;12,0;;;2,0;;;;;;;;;;;;;;;;;;2,0;;;;;;;6,0;;;;;;;55,0;;;;;;3,0;;;;;;;;3,0;;;2,0;;;;;;;;;;;;;;;;;1,0;;;;12,0;
deviation;;;;;;15,0;3,0;4,0;;;;;;;6,0;15,0;;2,0;1,0;;7,0;1,0;;;;;8,0;;;2,0;;2,0;11,0;2,0;14,0;;5,0;3,0;;3,0;2,0;;2,0;13,0;2,0;;48,0;6,0;6,0;5,0;;11,0;1,0;;;4,0;;7,0;14,0;;;1,0;5,0;;6,0;9,0;4,0;3,0;2,0;;9,0;;5,0;3,0;1,0;7,0;;;;54,0;;33,0;;19,0;;1,0;;;;;3,0;;;;;;3,0;;32,0;2,0;3,0;;8,0;4,0;;;5,0;1,0;;2,0;2,0;2,0;;;;5,0;;17,0;;31,0;1,0;3,0;1,0;2,0;1,0;;1,0;;;2,0;;9,0;3,0;;1,0;;;4,0;3,0;;;;1,0;;9,0;;;;5,0;4,0;;;;7,0;1,0;;13,0;;5,0;;;;25,0;;;;2,0;;;8,0;2,0;;;;30,0;;;;;;;;;;;1,0;;7,0;;;;;;;;;1,0;;;;;;;15,0;3,0;;;1,0;18,0;;;;;;;;;;2,0;;;1,0;;;;;;;15,0;;;;;6,0;2,0;;3,0;;;;;;;2,0;;;;;12,0;2,0;;;;;;;1,0;;;;;;;8,0;;2,0;1,0;;1,0;;;4,0;1,0;;;;;1,0;;7,0;;;1,0;;;5,0;;;;;13,0;5,0;;;;;;;;;;;;;;;;;;;;;;;;;;;;2,0;;;;;;;;;;;;;;;;;;;;1,0;;;;;1,0;;;;2,0;2,0;;;1,0;1,0;;;;5,0;;;;;;;;;;;;;1,0;;;;;;;;;1,0;;;6,0;;15,0;;;;;;;23,0;;;;;;2,0;3,0;;;;;;;;;37,0;4,0;41,0;6,0;;14,0;;11,0;;;;1,0;;;;;3,0;;;7,0;2,0;;;;;8,0;2,0;4,0;;9,0;17,0;;;;;1,0;;;1,0;6,0;1,0;12,0;2,0;;12,0;3,0;2,0;;4,0;;;15,0;2,0;;;;4,0;;;;3,0;17,0;1,0;;;;;;;2,0;;;;9,0;;;8,0;;;;1,0;2,0;;;;;;1,0;;;3,0;;;;;;;;4,0;;;;;;;10,0;;1,0;;;;;;;;;3,0;;;;;;2,0;;;;;;;1,0;3,0;;;;;;2,0;;1,0;;;;1,0;;;;;;;;;;;;;;1,0;;4,0;;;;;;;;;;;;;;;3,0;;;;4,0;4,0;;;;;;;;;;3,0;;;;;;;;;;;;;;;;;3,0;;;;;;;;;;;;1,0;;3,0;;;;;;;;;;;;;;3,0;;10,0;;;;;;;;;;;;;;;1,0;;;;;;;;;;1,0;;;;;2,0;;;;;;;;;;;;;3,0;1,0;;;;;;;;;;;;;;;;;;;;;3,0;;;;;;;;;;;;;;;;;;;;;;;;;;;;;;;;;;;;;;;;;;;;;;;;;;;;;;;2,0;;;;7,0;1,0;;;;;;6,0;;;;;;2,0;;;;;;;;;1,0;;;1,0;;;;;;;4,0;;12,0;1,0;;;;;;;;;;1,0;;;;;;;;;;;;;2,0;1,0;;;;1,0;;;;;;;;;;;;;;;;;;;;;;;;;1,0;;;;2,0;;;;;;;;;;;1,0;;;;;;;;;1,0;7,0;;;;;;;;3,0;;;;;;;;;1,0;;8,0;;;;;1,0;;;;;;;;;;;;;;;4,0;5,0;;;;7,0;;3,0;;;;;;;;;;;;;;1,0;;;;;1,0;;;;;;;;;;;;;28,0;;;1,0;;;;;;1,0;;;;;;;;1,0;;;;;;;;;;;;;;1,0;;;;;;5,0;;;;;
diameter;;;;;;6,0;28,0;10,0;39,0;7,0;7,0;1,0;;;11,0;21,0;2,0;;;;;3,0;1,0;2,0;6,0;;;2,0;4,0;;;2,0;10,0;;5,0;1,0;;;;;3,0;4,0;22,0;;;3,0;2,0;22,0;2,0;;1,0;7,0;;;4,0;1,0;5,0;;;;8,0;15,0;1,0;;;5,0;3,0;17,0;;15,0;6,0;4,0;;;;;;;5,0;13,0;;8,0;;10,0;16,0;;2,0;;;11,0;171,0;;;;;;1,0;;5,0;;;;25,0;4,0;2,0;;31,0;;;;5,0;;8,0;;;13,0;107,0;8,0;1,0;5,0;4,0;;;;1,0;;;;;3,0;;2,0;2,0;;8,0;;3,0;2,0;;5,0;3,0;;;20,0;;;;15,0;;9,0;;1,0;;1,0;5,0;;22,0;;2,0;;;;16,0;;3,0;;2,0;;;2,0;;;2,0;6,0;2,0;2,0;16,0;26,0;1,0;;4,0;5,0;;5,0;;1,0;;5,0;3,0;;;;5,0;4,0;;;;;;14,0;37,0;1,0;5,0;10,0;;2,0;;;;17,0;;2,0;;;2,0;;3,0;;;51,0;9,0;1,0;76,0;;;3,0;3,0;;13,0;;10,0;1,0;1,0;22,0;;3,0;;38,0;;125,0;;;;3,0;;;;;1,0;1,0;11,0;;;;1,0;;28,0;5,0;;3,0;1,0;;1,0;;3,0;;5,0;5,0;5,0;;2,0;3,0;3,0;1,0;;5,0;;8,0;10,0;83,0;1,0;;3,0;5,0;4,0;2,0;;;;6,0;;;;;11,0;2,0;;;1,0;8,0;;9,0;;;4,0;1,0;;;2,0;2,0;1,0;3,0;4,0;2,0;5,0;;;;9,0;5,0;20,0;;;7,0;;;3,0;2,0;;;;;2,0;1,0;1,0;;;;;26,0;5,0;;;;;;1,0;3,0;7,0;;1,0;2,0;;2,0;;;;6,0;5,0;3,0;;3,0;;3,0;7,0;6,0;;10,0;3,0;;2,0;2,0;1,0;;;;10,0;2,0;;1,0;12,0;6,0;;;;1,0;10,0;6,0;;7,0;9,0;;;;32,0;;;;4,0;;;;;4,0;;;;2,0;;1,0;3,0;;;;;5,0;2,0;;;;;;1,0;;;;5,0;;;;;;;;;;;2,0;2,0;;;2,0;4,0;;;;3,0;;;;4,0;;;;;;;;;;3,0;;;;;;;;;;;;;;;;;;;2,0;5,0;4,0;;17,0;;;;;;;;;;;;;;;3,0;;5,0;;;;;;1,0;2,0;;;;;;;;;2,0;;;;;;3,0;1,0;1,0;;;;;;;;;;;;1,0;;;;;2,0;;1,0;;;3,0;;;;;1,0;5,0;;;2,0;;;;;;;;;18,0;;;1,0;;2,0;;;4,0;;;;;;;;;26,0;;;2,0;;;;;;;;;1,0;2,0;;;;;;;;;;;;;2,0;;;;;;;1,0;;5,0;;;;;;;;;;;;;;;;;;;;;;;;;;;;;3,0;;5,0;;1,0;1,0;;;1,0;2,0;2,0;;;1,0;;8,0;;;;;;;2,0;;30,0;;1,0;;;;;1,0;;;;;;5,0;;;;;1,0;;;1,0;1,0;;;;;1,0;;;;;;;;;;;;;;;;;17,0;;3,0;;;5,0;;;;;;;5,0;;;1,0;2,0;;;7,0;;2,0;;2,0;;;;;;;;;;;;;;;;;;;;;3,0;1,0;;;;;;;;;;;;;9,0;;;;;;1,0;;26,0;;;;1,0;;;;;;;;;;1,0;;;;;6,0;2,0;4,0;;;;2,0;;2,0;;;;1,0;;4,0;;2,0;;;;;;;;2,0;;;;;;;;1,0;;;;;;;;;;;;;;;;;;;;;;;;;;;;;1,0;;;;;;;;;;;1,0;;;;;1,0;;;;1,0;;;;;;;;;;;;;;;;;;;;2,0;;;2,0;;;;;;;1,0;5,0;;1,0;;4,0;;;2,0;;;;;;;;;;;;3,0;;;;;;;;;;;;;;;;;;;;;;;3,0;;;;8,0;4,0;;1,0;;;1,0;;;;;;;4,0;;;;6,0;4,0;;;;1,0;;;;;;;;;;;;;;;1,0;;;;;;
dimension;;;;;;5,0;4,0;27,0;13,0;1,0;20,0;;;;14,0;35,0;2,0;;;1,0;4,0;22,0;1,0;;;;21,0;;1,0;;2,0;;15,0;;6,0;;3,0;;1,0;;8,0;;24,0;14,0;3,0;3,0;30,0;48,0;5,0;29,0;1,0;8,0;2,0;;;8,0;10,0;;;;8,0;4,0;5,0;;6,0;11,0;;6,0;4,0;4,0;2,0;;2,0;;8,0;1,0;2,0;;18,0;98,0;8,0;6,0;;21,0;;;;;1,0;26,0;18,0;;;13,0;2,0;;;;42,0;1,0;2,0;;11,0;48,0;;6,0;15,0;1,0;;3,0;;4,0;;;;7,0;16,0;5,0;2,0;8,0;3,0;;2,0;1,0;5,0;1,0;;;1,0;4,0;;14,0;11,0;;;;19,0;;3,0;;;;;14,0;5,0;;;9,0;1,0;13,0;;1,0;3,0;;;;33,0;;1,0;;;1,0;3,0;;1,0;;1,0;3,0;;5,0;;;;;;;;;;;1,0;4,0;1,0;;;4,0;;;;;;1,0;1,0;3,0;;4,0;;;;2,0;2,0;;1,0;37,0;;1,0;;;;3,0;;;;;;6,0;4,0;;20,0;2,0;3,0;;3,0;;;;;;12,0;;6,0;20,0;;1,0;3,0;;3,0;11,0;;8,0;2,0;;;8,0;1,0;;;25,0;22,0;15,0;3,0;;;;;;3,0;2,0;3,0;;;;;1,0;;;36,0;1,0;;;;3,0;12,0;1,0;;1,0;;3,0;2,0;8,0;;;2,0;2,0;3,0;41,0;;12,0;;;10,0;14,0;;1,0;7,0;;;;1,0;;;2,0;1,0;6,0;;;;;2,0;1,0;;;2,0;1,0;1,0;;;5,0;;1,0;;;7,0;;;;4,0;;;;13,0;;;;;;1,0;2,0;1,0;2,0;;;;;12,0;;;;8,0;11,0;;;;;;3,0;4,0;4,0;1,0;;1,0;;;;;;;;1,0;3,0;;;;;;;;;;1,0;6,0;;1,0;;;;;;;1,0;;11,0;1,0;;3,0;;;57,0;;;;;;1,0;;;;3,0;;10,0;3,0;;7,0;;3,0;;;;;;;;3,0;;;;;4,0;2,0;;;2,0;;4,0;8,0;;;10,0;;;2,0;14,0;1,0;;;;2,0;;1,0;;;;;;1,0;3,0;;1,0;;;1,0;2,0;;;;;;;;11,0;2,0;;;2,0;7,0;;;;;;1,0;2,0;1,0;;34,0;;;2,0;;16,0;;;;;1,0;;;;4,0;;1,0;;;;8,0;;;;;;2,0;9,0;;;;;;;3,0;;;;;5,0;4,0;3,0;;;1,0;;;;1,0;1,0;;1,0;2,0;7,0;;1,0;;;;2,0;;;4,0;;;;;2,0;;;;;;1,0;;;;2,0;1,0;1,0;;;;;;;;;2,0;;;1,0;;3,0;1,0;11,0;;;;;4,0;;;4,0;;;;;;11,0;;;;;;;1,0;;1,0;;2,0;9,0;;;;;1,0;;;;;;;;;;;;1,0;;;;3,0;;;;;;;;;;;2,0;1,0;3,0;;12,0;;;;;;3,0;1,0;;;;;3,0;10,0;;;;;;1,0;;;;;1,0;;5,0;;;;3,0;;;;;;15,0;;2,0;;3,0;4,0;;;15,0;;;;;;1,0;;;;;;;;;;;;1,0;;;;;;;;;;1,0;;2,0;;;;;1,0;2,0;4,0;;;1,0;;;6,0;2,0;;;;1,0;;;7,0;;1,0;;;;1,0;3,0;;;;12,0;;;5,0;;;;;;;;4,0;;;;;;;;;;;;;;1,0;;;;2,0;;;5,0;;;;9,0;;;2,0;;;7,0;;;;;;;;;;;8,0;;;;;;;2,0;;7,0;1,0;;;;;;8,0;;;;;;1,0;2,0;;;;;;;;;;;;;;;;;;1,0;;3,0;;;;1,0;;;;;;;;9,0;;3,0;;;;;;;2,0;4,0;;;;;;;;;;;;;;;;;;;;;;9,0;1,0;;;;;;;;;1,0;;;;;;;;;;;;;2,0;;;;;;;;;;;;;4,0;;2,0;;;;;;;;;;;;2,0;;;;;;;;;;;;1,0;;;;5,0;;;;;;2,0;;;;;;;;;;;;;;;;;;;;;;2,0;;;;;;;;;3,0;;;;;;;1,0;;
dome;;;;;;3,0;;;;;;;;;4,0;3,0;;1,0;;;;1,0;;;;;1,0;;;;;;1,0;;2,0;2,0;;;;5,0;1,0;;;;;;;;;;3,0;;;;;;;;;;1,0;;;;3,0;4,0;;11,0;;;1,0;;1,0;;;;;;;3,0;;1,0;;11,0;1,0;;;;;3,0;46,0;;;;;;;;4,0;;;;2,0;;;;2,0;;;;6,0;;;;;;11,0;15,0;;1,0;;;;;;;;;2,0;;;;;1,0;;;;;;;;22,0;;1,0;;;;1,0;;;;;;;;;9,0;;6,0;;;1,0;17,0;;;;;;3,0;1,0;;;;1,0;;;22,0;;;;;14,0;;;;;1,0;1,0;;2,0;;2,0;;;;;;;;103,0;;;;19,0;;;;1,0;;4,0;;1,0;;;1,0;;6,0;;1,0;6,0;26,0;;14,0;2,0;;;;;1,0;;1,0;1,0;;9,0;;;;;7,0;15,0;;;3,0;;;;;;;2,0;;;;;;;4,0;;;;;;1,0;;;;5,0;;;;;;3,0;;;;;;;7,0;;;;8,0;1,0;6,0;;;;1,0;;;;;6,0;;;;1,0;;;;1,0;;;;;3,0;;;2,0;;;;1,0;;;;;11,0;2,0;;6,0;2,0;;;2,0;;1,0;;;;;;;;;3,0;;4,0;5,0;3,0;2,0;;2,0;;9,0;;3,0;;;;;;;;;4,0;;;;;1,0;;5,0;;;;1,0;;;;;;;;;4,0;2,0;3,0;1,0;1,0;;1,0;1,0;;;;;8,0;1,0;;;;;1,0;;1,0;1,0;;;;;;;;;;;;;;;;;;;;;;;;1,0;;;;;;;;;;;;;;;;;;;;;;;;1,0;;;;;;;;;;;;;;;;;;;;;;1,0;;;;;;;;;;;1,0;;1,0;;8,0;;;;;;;2,0;;;;1,0;;;;;;;;;2,0;;;1,0;;;;;3,0;;;;;;;;;;;;;1,0;;;;;;;;1,0;;;;;;;;;;;;;;;;;;;;1,0;;;;;;3,0;;;;;7,0;;;;;;;;;;;;;1,0;1,0;;;;;;;;;;;;;;;;1,0;2,0;2,0;;;;;7,0;;;;;;;;;;;;;;;;;;;;;;;;;;;;;;;;;;;;;;;;;;1,0;;;;;;1,0;;;;;;;;;;;;;;;;;;;;;;4,0;1,0;;;;;;;;;;;;;;4,0;;;;;;;;;;;;;;;;;;;;;;;;;;;;;;;;;;;;;;;;;;;;6,0;1,0;;;;;;3,0;2,0;;;;;;;;2,0;;;;;;;;2,0;;;;;17,0;;;;;;;;;;;;;;;;;3,0;;;;;;;;;;;;;;;;;;;;;;;;;;;;;;;;;;;;;;;2,0;;;;;;;;2,0;;;;;;;;;;;;;;;;;;;;;;;;;;;;;;;;;;;;;;;;;;2,0;;;;;;;;;;;;;;;;;;;;;;;;;;;;;;;;;;1,0;;;;;;;;;;;;;;;;;;3,0;;;;;;;2,0;;;;;;;;;;;;;;;;;;;;;;;;;;;;;;;2,0;;;;;;;;;;;;;;;;;;;;;;;;;;;;;;;;;;;;;;;;;;;;;
dynamic;;;;;;1,0;;9,0;9,0;;15,0;;5,0;;;12,0;;;9,0;;8,0;8,0;1,0;1,0;;2,0;49,0;;;;4,0;;9,0;8,0;12,0;;;16,0;;;30,0;;3,0;4,0;3,0;1,0;30,0;19,0;9,0;26,0;1,0;;;3,0;;;;1,0;2,0;;7,0;;24,0;;5,0;5,0;;2,0;7,0;;5,0;;35,0;1,0;;2,0;2,0;;;169,0;;14,0;;20,0;3,0;1,0;;;;1,0;1,0;;;;3,0;21,0;;;40,0;2,0;;;14,0;26,0;;;1,0;;6,0;9,0;1,0;17,0;;;;10,0;8,0;7,0;1,0;;;;2,0;;4,0;3,0;2,0;;;212,0;;3,0;;2,0;;20,0;;4,0;;;18,0;;;37,0;4,0;;;;14,0;;;3,0;;9,0;;;18,0;;2,0;1,0;2,0;2,0;13,0;;2,0;;7,0;;;;;;;2,0;;6,0;;;;;;;;;1,0;;;3,0;;;4,0;1,0;;;;;32,0;;;;;1,0;3,0;5,0;;;;3,0;10,0;;;2,0;;;;;;;1,0;;;;;;1,0;;;;5,0;;;1,0;;;;2,0;4,0;;;;;;;;;;2,0;;24,0;;;;;;;;10,0;;;;;;;3,0;;;;1,0;8,0;;1,0;;;;;;;1,0;;;;;;;;10,0;;5,0;;;;;;;;;5,0;;;;1,0;1,0;;;;;;;;;;;;;;5,0;;;;2,0;;;;;;;;;;;;;;;;;;;2,0;;;;;;;;;;;;;;;;;;;7,0;;3,0;;1,0;;;;;;;;;5,0;;;;;;;;;;;;;;;;;;2,0;;;4,0;;;;;;;;;16,0;5,0;;2,0;;1,0;;;;11,0;3,0;4,0;5,0;;2,0;;;;;;;;6,0;;1,0;;;10,0;2,0;;;5,0;1,0;1,0;;;;3,0;6,0;;1,0;1,0;1,0;;;4,0;7,0;;2,0;;;;;;3,0;5,0;;;;2,0;1,0;2,0;;;;;;2,0;10,0;4,0;4,0;;1,0;3,0;5,0;;4,0;3,0;1,0;;1,0;;;;3,0;;;;2,0;;;2,0;3,0;;;;;;;;2,0;;;;;;;;;;;11,0;2,0;;1,0;;;;;;;;;30,0;;;;1,0;;;;;16,0;;;;8,0;;;;;;;2,0;;5,0;1,0;;;;;;1,0;2,0;;18,0;;;;;;;1,0;5,0;;4,0;;;;1,0;;;;;;;1,0;13,0;;;;;;;;1,0;;;;7,0;;;;;;;;;;4,0;;;2,0;3,0;;1,0;;;;;2,0;;;;;;;;4,0;;;;;2,0;;;4,0;;;;2,0;;;;;;;;;;;;6,0;;;2,0;;;1,0;;;;;;;;;;;;;;15,0;1,0;;;;;;;;;;;2,0;;;;;;;1,0;6,0;;;;;;;;;;;;;;;;;;1,0;;;;;;;1,0;;;;;;1,0;;;;;;;;;;;;1,0;;;1,0;4,0;;2,0;;;;;;;;;;;;;;;;;;;;1,0;;;;;;;;;;;2,0;;2,0;1,0;;;;;1,0;;;2,0;;6,0;2,0;;1,0;5,0;2,0;;;;;;;;4,0;;1,0;3,0;;;;;;7,0;1,0;;1,0;4,0;3,0;;;;;;2,0;1,0;;4,0;;;;3,0;;;;;;4,0;;3,0;;;;;;2,0;;;;;;;;;;;;3,0;1,0;1,0;4,0;1,0;;;;;;;;;;;1,0;;1,0;;;;1,0;;;;;;;;;;;;;;;;;;;;;;;3,0;;5,0;;;;2,0;;;;;1,0;;;;;;1,0;;1,0;;;;;;;;;;;;;;;;;;;2,0;;5,0;;;;;;;;;;;2,0;;;;;;;;;;;;1,0;;;1,0;1,0;;;;;;;;;;3,0;11,0;;;;;;;;;;;;;;10,0;;;;;;;;;;;;;;;;;;;;;;
electrode;;;;;;2,0;1,0;28,0;34,0;68,0;42,0;;4,0;;2,0;8,0;;;;;;;3,0;47,0;;;4,0;;3,0;;;;25,0;;30,0;3,0;;;;;;;95,0;2,0;8,0;31,0;;114,0;;34,0;45,0;3,0;;1,0;84,0;13,0;60,0;;4,0;;34,0;29,0;20,0;;2,0;;23,0;316,0;1,0;3,0;6,0;;12,0;;;2,0;;;4,0;49,0;8,0;48,0;;98,0;;;;;;1,0;143,0;;;37,0;;;;;31,0;;;;45,0;;;4,0;23,0;3,0;22,0;;8,0;;24,0;3,0;;206,0;129,0;50,0;16,0;31,0;;;;9,0;;;2,0;;4,0;;;8,0;;;7,0;;26,0;7,0;;;;;;67,0;3,0;;;74,0;67,0;1,0;;11,0;1,0;;1,0;32,0;8,0;;;542,0;;2,0;70,0;;1,0;;;;1,0;;;;2,0;22,0;;69,0;;4,0;2,0;;5,0;9,0;6,0;2,0;44,0;17,0;;4,0;4,0;21,0;;;4,0;226,0;;41,0;;;;22,0;;;1,0;69,0;1,0;2,0;17,0;;;38,0;58,0;;11,0;153,0;12,0;;2,0;3,0;;36,0;7,0;2,0;60,0;;;;342,0;;82,0;6,0;20,0;4,0;;7,0;1,0;;;5,0;29,0;10,0;17,0;7,0;1,0;2,0;8,0;3,0;23,0;;84,0;5,0;38,0;;;;;16,0;18,0;3,0;2,0;3,0;7,0;1,0;;10,0;58,0;;3,0;5,0;18,0;5,0;;18,0;3,0;5,0;;2,0;;3,0;194,0;191,0;4,0;;61,0;11,0;;;;3,0;;113,0;;33,0;45,0;9,0;14,0;;;;63,0;;18,0;2,0;;;;;1,0;4,0;11,0;;;;22,0;;2,0;;;1,0;;4,0;;;9,0;;95,0;;;;;;;;;1,0;;2,0;;;;8,0;1,0;;;3,0;;;;;9,0;34,0;1,0;12,0;;8,0;16,0;;;;;;;;;;;;;4,0;1,0;;4,0;;;;;;;;;;;;67,0;;;2,0;13,0;;;5,0;15,0;;;3,0;;;;20,0;1,0;;;;;1,0;;;;;;1,0;5,0;;;;;;1,0;;;;;1,0;14,0;;;;;;;;;1,0;6,0;;;;;3,0;1,0;;;;;;;;1,0;;;1,0;;;;;;;;;;;;;;;;;3,0;;;2,0;;;;;1,0;;;;82,0;;4,0;;;;;;;;3,0;;;;;;;;;;5,0;;3,0;;2,0;;1,0;;;;16,0;;;;;;;;;;;;;;;;;;;;;;;;10,0;24,0;;;;;;;;;;;;;;;;;;;;;;;;;;;;;10,0;;26,0;;;;;;;;;;;;;;;;;;;22,0;;;;;;;;;;1,0;1,0;;;;;;6,0;;;;;;1,0;11,0;1,0;;;;6,0;1,0;;;;;;;;;;;;;48,0;2,0;;;16,0;;;9,0;;;;;;;;2,0;;1,0;;;;;;;4,0;;;;;;2,0;18,0;;;;;;2,0;24,0;;5,0;1,0;;;17,0;;;;;;;;2,0;;;;;;;64,0;;11,0;;28,0;;;;;;1,0;1,0;71,0;3,0;;;;5,0;;;;;;;;;;;23,0;;;24,0;;;;2,0;3,0;115,0;;;2,0;60,0;4,0;;;;;;;1,0;;;11,0;;1,0;;49,0;;1,0;;1,0;;;7,0;;;;;8,0;;7,0;;;6,0;14,0;;;17,0;;;;;17,0;4,0;;6,0;;;;5,0;10,0;;;;;10,0;;;;;1,0;;;1,0;2,0;;;126,0;3,0;;6,0;5,0;;;;;;;;;;;;;;;;;;;;;;2,0;;;;2,0;;;;;;;;;;;5,0;;;;;;;;;;;;;;;;39,0;;;;;;;;;;2,0;;12,0;44,0;;1,0;;;;;;;;34,0;;;;;1,0;;;2,0;;;;12,0;;;;;;;;2,0;2,0;;;;;;;17,0;;4,0;;;;;;;;;;;;;14,0;9,0;;;;;;;;;;;;;;;;;4,0;;;1,0;;;;;;;;;;;2,0;;2,0;;;1,0;1,0;;;;;;;;;;;;;;;;;;;;;;;;;;;;;;;;;;;;;;;;1,0;;;;;;
enclose;;;;;;6,0;3,0;1,0;12,0;1,0;4,0;;;;4,0;7,0;;;;;3,0;3,0;;;1,0;;;;4,0;;;;14,0;;;;;;;;1,0;;10,0;;;;;18,0;2,0;9,0;11,0;2,0;;;1,0;2,0;6,0;;;;;6,0;1,0;3,0;;;;16,0;9,0;5,0;1,0;;5,0;;;5,0;1,0;4,0;2,0;17,0;2,0;7,0;;9,0;;;;;2,0;;31,0;;;;;;;;4,0;1,0;;;21,0;2,0;;;11,0;;;;;;;;;13,0;21,0;8,0;2,0;;1,0;;;;5,0;;;;4,0;;;;;;;;1,0;;;;;;;20,0;;;;20,0;;;;4,0;1,0;;;2,0;14,0;;;;;2,0;4,0;;;;11,0;9,0;1,0;;1,0;;;2,0;;;6,0;7,0;;;7,0;16,0;;17,0;;8,0;;18,0;1,0;;;;;4,0;;2,0;;;1,0;22,0;1,0;;;;;;;;;6,0;;;;;;;;;;4,0;82,0;;3,0;;;6,0;2,0;;9,0;;1,0;7,0;1,0;26,0;1,0;;;14,0;;1,0;;2,0;10,0;5,0;;;;;;;7,0;;;;;;5,0;;5,0;;;;1,0;;;;5,0;9,0;1,0;;;13,0;21,0;2,0;;4,0;;21,0;3,0;11,0;1,0;;;;;;;;;;2,0;;1,0;2,0;19,0;;;;;;2,0;2,0;5,0;;;;2,0;4,0;2,0;1,0;;14,0;1,0;;7,0;;2,0;1,0;;9,0;;;;1,0;;1,0;;;;;2,0;2,0;;;6,0;;;;3,0;2,0;2,0;;;2,0;;;;1,0;1,0;;;;;;;;;5,0;1,0;;;;9,0;;;;;1,0;;;;2,0;;;;;7,0;;;;;1,0;8,0;;;;;3,0;;16,0;5,0;;;4,0;2,0;;;;1,0;;;;1,0;13,0;;;;;;;1,0;;;;;;;;;;;;2,0;;;1,0;;;;;;;;;2,0;;1,0;;2,0;;1,0;;;;;;;;;;;;;;;3,0;;;;;;1,0;;;;;;;;;;;;;;;;;;;3,0;;;1,0;;;;;;;;;;;;;;;2,0;;5,0;;;;;;;;;;2,0;2,0;;;;;;;;;;;;1,0;;;2,0;1,0;;;;;17,0;2,0;;2,0;;;;;;2,0;;;;;;;;;;4,0;;3,0;;4,0;;7,0;;;;;;;;;2,0;;;;;;;11,0;;;;10,0;;1,0;;1,0;;;;;3,0;;;;2,0;;;13,0;;;;;;;;;;;;;;;;;;;;;;;;;;;;;;;;5,0;5,0;;4,0;;;;;;;;1,0;1,0;;;;1,0;7,0;;;1,0;;4,0;1,0;;;;;;;1,0;;;7,0;;;;;;;;1,0;;1,0;;;;2,0;;;;;1,0;;;;;1,0;1,0;;;;2,0;;;;;4,0;;;;;;;;;;;;;;;;;;;;;10,0;;;;;;;;;;;;;;;1,0;;;;;3,0;;;5,0;1,0;;;;;;;;;;;;;;;;2,0;;2,0;;;;;;;;;;;;;;;;;;;;1,0;;;;;;;;;;;;;;;;;;;;;;;;;;;;;;;;;;5,0;;;;;;;;;;;;;;;;;;;;1,0;;;;;;1,0;;;;2,0;;;5,0;2,0;;;1,0;;;;;;;;;;3,0;;;;;;;;;;;;;;;;;;;;;;;;;;;;;;;;;;;;;;;2,0;;;;5,0;;;;;;;;1,0;;;;;;;;;;3,0;;;;;1,0;;;;;;;;;;;;;;;;;;;;;;;;;;;;;;;;;;1,0;;;;;;;;;;;;;;;;;1,0;;;;;;;;;;;;;;;3,0;;;;;;;;;;;
enclosure;;;;;;1,0;11,0;15,0;12,0;1,0;1,0;;5,0;;;5,0;;;;;;6,0;;;;;;3,0;1,0;;;;27,0;;3,0;1,0;;1,0;1,0;2,0;2,0;;27,0;1,0;;;;37,0;8,0;;17,0;6,0;;;4,0;1,0;7,0;;;;10,0;37,0;13,0;3,0;5,0;3,0;;6,0;1,0;3,0;;;1,0;;;1,0;;;;24,0;;6,0;;52,0;;;;;;5,0;47,0;;;4,0;;;2,0;;7,0;5,0;1,0;;16,0;6,0;20,0;;33,0;;;;4,0;;3,0;;;5,0;30,0;38,0;8,0;;2,0;;1,0;;;;;;21,0;;;;4,0;;;;1,0;1,0;;;;19,0;;19,0;;;;13,0;10,0;3,0;1,0;;8,0;;1,0;;21,0;;12,0;;;1,0;3,0;;;;1,0;4,0;;;;;2,0;3,0;;;27,0;5,0;1,0;;6,0;23,0;;1,0;;6,0;;;;;1,0;;;14,0;;2,0;;2,0;2,0;18,0;8,0;3,0;1,0;6,0;;;;;;13,0;;;1,0;;;;4,0;;;1,0;19,0;;5,0;;;25,0;;;1,0;;6,0;10,0;;88,0;2,0;1,0;;18,0;3,0;6,0;;3,0;2,0;;;;;;;9,0;;;;;;;15,0;;;;;;6,0;;;1,0;8,0;56,0;1,0;;8,0;7,0;2,0;;;6,0;;;1,0;22,0;3,0;;;2,0;;;;;3,0;12,0;;;;;37,0;6,0;;;1,0;;1,0;5,0;27,0;;14,0;;2,0;1,0;7,0;;;1,0;;;7,0;1,0;;;;21,0;;;;;1,0;2,0;6,0;3,0;;;;4,0;3,0;;;;;;;;4,0;;4,0;2,0;1,0;1,0;;3,0;6,0;;;;;;;6,0;;3,0;1,0;;2,0;;9,0;2,0;;;;3,0;8,0;;;;;;;9,0;;2,0;;3,0;;;1,0;2,0;;;7,0;;;;2,0;;3,0;;;3,0;2,0;1,0;4,0;1,0;;;2,0;3,0;;;;;;;1,0;;;;;;;;;;;;5,0;;;13,0;;;;;;;1,0;1,0;4,0;;;;;;2,0;;;;;;;;;;;;;;;6,0;3,0;;1,0;;3,0;2,0;;;;;;;;;;;;;8,0;;;;;;1,0;7,0;;;;;;;1,0;1,0;;;4,0;;;;;;;;6,0;;;;9,0;;;;;;;;;;;;;;;;;3,0;1,0;1,0;;;3,0;2,0;;;;;14,0;2,0;;;;;;1,0;;2,0;;;;;;;2,0;;;14,0;1,0;;;24,0;;7,0;;;;;;;2,0;;1,0;18,0;;;;;4,0;1,0;1,0;;10,0;;;;;16,0;;;;;;;;;;;;11,0;6,0;;;;2,0;;7,0;;;;;1,0;2,0;;;;;;1,0;;;;;;;;;;;;;;4,0;;1,0;;;1,0;;;;;1,0;3,0;;;;;3,0;;;1,0;;;2,0;;;;;;2,0;;;;1,0;3,0;3,0;;;;;;;;1,0;;;3,0;;;;;;;1,0;;10,0;2,0;;;;;;;;;;;;;;2,0;;;;;;;;;;2,0;1,0;;2,0;;;;;;;;;;;;;6,0;13,0;5,0;;3,0;;;;7,0;;;3,0;;;;;4,0;;4,0;;;;;;1,0;;1,0;3,0;;1,0;;;3,0;;;;;;;;;;;;;;;;;;;;;;;;;;;;;;;6,0;;5,0;;;;;;;;;;;;1,0;;2,0;;1,0;;;;;;;;;;;4,0;;;;;;;;;;;;;;;;;1,0;;;;;;;;;;;;;15,0;;4,0;5,0;;;;;;;;;;;4,0;;;;;;;;;;;;;;;;;;3,0;;;;;;;;;4,0;;2,0;;;;;;;;;;;;;;5,0;;;;;;;2,0;;;;;;;;;;;;1,0;;;;;;;;;;;;;;;1,0;;;;;;;;;;;1,0;;;;1,0;;;;2,0;;4,0;;;;;1,0;;;;;;;;;;;;;1,0;;;;;;;;;;;;;;;;;;;;;;;;;;
encoder;;;;;;9,0;;19,0;;5,0;;;2,0;;30,0;3,0;;;;;;1,0;2,0;;;;2,0;;;;1,0;;29,0;;2,0;1,0;;;;;13,0;;;4,0;9,0;;;16,0;3,0;6,0;;1,0;;1,0;1,0;;8,0;1,0;;;;1,0;;1,0;1,0;;;4,0;4,0;1,0;;;4,0;;;2,0;3,0;;;54,0;1,0;;;13,0;;1,0;;;;;7,0;;;;;1,0;7,0;;10,0;;;;9,0;;;;4,0;2,0;8,0;19,0;;1,0;;;;10,0;;15,0;;1,0;;;;3,0;9,0;1,0;;;;;;;;;;;5,0;;11,0;;8,0;;;3,0;1,0;;;;12,0;;;;1,0;5,0;;;10,0;;6,0;2,0;;1,0;2,0;;;;36,0;2,0;;;1,0;;;;;;1,0;;;;;2,0;;;;7,0;;4,0;1,0;;10,0;10,0;;3,0;;;;;;1,0;;;;1,0;;;;;;;;;;1,0;;;;;;;;;;;;;;;;;;;1,0;4,0;;2,0;2,0;;;;1,0;;;;1,0;;;;;;;;;;;;11,0;;1,0;;;;;4,0;;;;;;;;2,0;;;;;;1,0;;1,0;;;2,0;;;1,0;;;;;2,0;;;;;;;;;;;1,0;;;;;;1,0;;;;;1,0;;1,0;;;;;3,0;;;;;6,0;;;;;;;;;;;;;;;;;2,0;1,0;2,0;;4,0;;17,0;;;;;;;;1,0;2,0;;;1,0;;;;1,0;;;;;;;;;;;;;;;1,0;9,0;;;;2,0;;;;;;1,0;;1,0;;;;;7,0;;;;;;;;;;;1,0;;3,0;1,0;1,0;;;;;;;;;;;4,0;9,0;;;1,0;;;;;7,0;;1,0;;;1,0;7,0;5,0;;;2,0;3,0;;1,0;;;;;;;;;;;;1,0;;6,0;;;;;;;;;;4,0;;;;1,0;11,0;4,0;2,0;2,0;1,0;;;;;1,0;;;;;;;;;;;3,0;2,0;;;;1,0;;;1,0;;;6,0;;;;;;;1,0;;;;;;;;;2,0;;;;;;4,0;;;;;;6,0;;;;;1,0;;;;;;;;;;2,0;;5,0;;;;;;;;;;;;;;;;;;;;;3,0;;;;;;;;;;;;;;;;;;;;;;;;;;;;;1,0;2,0;;;12,0;;;;;;;;;;;;;;;;;;;;;;;;;;;;;;4,0;;1,0;;;;;;;1,0;;;;;;;;;;;1,0;;;;;;;;;;4,0;;;1,0;;;;2,0;;;;;;;;;;;;;;;;;;;1,0;2,0;;;;;;;;;;;;;;;1,0;;;;;;;;;;;;;;;;2,0;;;;;;;;;;3,0;;;;;;;;;;;;;;;;;;;;;;;;;;;;;;10,0;;2,0;;;;;;;;;;;;;;;2,0;;;;;;;;2,0;;;;;;;;;;;;;;;;;;;;;;;;;;;1,0;;;1,0;;;;1,0;;;;;;;;;;;;;;;;1,0;2,0;;;;;;;;;;;;4,0;;;21,0;;3,0;;;;;;;;;;;1,0;;;;;;;;;;;;;;;;;;;;;;1,0;;;;;;;;;;;;;1,0;;;;;;;;;;;;1,0;;4,0;;1,0;3,0;;;;;;;;;1,0;;;;;;9,0;;;;;;;;;;;;;;;;;;;;;1,0;;;;1,0;;;;;;;;;;;;;;;;;;;;;;;;;;;;;;;;;;;;;;;;;;
engagement;;;;;;1,0;2,0;10,0;;;;;1,0;;16,0;9,0;7,0;;;;3,0;;6,0;1,0;;;;4,0;;;;;21,0;;7,0;;;;;;;;2,0;7,0;1,0;3,0;1,0;21,0;3,0;;16,0;24,0;;2,0;12,0;5,0;8,0;;;;14,0;2,0;;;;1,0;2,0;42,0;4,0;11,0;;;;;;;;;;2,0;;7,0;;39,0;;;2,0;;1,0;1,0;38,0;;;;;;;;4,0;;;;8,0;;;1,0;9,0;;;;1,0;;2,0;;;23,0;190,0;19,0;1,0;3,0;5,0;;;;;;;;;;;;;1,0;;;;1,0;;;;1,0;;;1,0;;;10,0;;10,0;;;1,0;;;;20,0;;5,0;;;;28,0;;;;;;;;;;;5,0;;;8,0;7,0;;;;20,0;;1,0;;;;3,0;;;;;2,0;2,0;;18,0;;;;12,0;;1,0;;19,0;;;;;;21,0;4,0;1,0;;;;;21,0;;;63,0;14,0;;13,0;;;;;1,0;;;142,0;12,0;2,0;13,0;4,0;3,0;;1,0;4,0;12,0;;;;;;;;;;;36,0;;;;1,0;;10,0;;;;;3,0;2,0;;;;18,0;;;;2,0;;14,0;;;4,0;;8,0;;51,0;1,0;;2,0;;13,0;;;;;1,0;1,0;1,0;;;26,0;;;;;9,0;4,0;2,0;15,0;;;;10,0;;20,0;;;13,0;;;2,0;;;7,0;;11,0;;;2,0;10,0;1,0;;91,0;;8,0;;;;2,0;;;;;28,0;1,0;5,0;;3,0;54,0;2,0;2,0;2,0;37,0;;;;2,0;4,0;;2,0;2,0;3,0;3,0;8,0;1,0;;8,0;1,0;;9,0;57,0;2,0;;11,0;2,0;;1,0;5,0;;;1,0;;12,0;1,0;10,0;3,0;19,0;7,0;;35,0;11,0;5,0;3,0;;;17,0;;1,0;;;19,0;;1,0;;;;;;;4,0;;;;2,0;;;1,0;;;;;;;;;;;1,0;;;;;;1,0;;;;;;1,0;;;;;;;;;;;;;2,0;;;;1,0;;;;;1,0;;;;;;;;;;;;1,0;;2,0;;;1,0;;12,0;;;;;;4,0;;;1,0;;;;;;;;;;;;;1,0;;6,0;;7,0;;;;;;34,0;;;;;;;;;;2,0;;;;;;13,0;;;;;;;;;;;1,0;;1,0;;;;2,0;;;;;;1,0;;;;;;7,0;;1,0;;;1,0;;;;;5,0;;;;;;;;;;;6,0;;;;;3,0;;1,0;;;;;;;;;2,0;1,0;;;;15,0;;;;;;;3,0;;;;;;;1,0;;;1,0;;49,0;4,0;;;;;;;;;1,0;;;;;;7,0;;;1,0;;3,0;;;;1,0;;;;;;;;;;2,0;;;;;;;;6,0;;1,0;;8,0;12,0;;;;;;;1,0;;;;1,0;;;;;;2,0;;;7,0;;;;33,0;;;;2,0;;2,0;;;;;;1,0;;;;;;;;1,0;1,0;6,0;;2,0;1,0;5,0;;;1,0;;1,0;;;2,0;;;;2,0;;;;;;;2,0;;;;;;;3,0;;;3,0;1,0;;;1,0;;;;;;;1,0;;;;;2,0;;1,0;;;;;;;;;;;;;;;;;;;;;;;;;;;;;;;;;;;;5,0;;;;;3,0;;;;;;;;;;;;2,0;;;;;;;;;;3,0;;;;;;;;;;;;;;;;;;;;;;;;;;;;;;;;;;;;;;;;;;;;;;;;;;;;;;;;;;;2,0;3,0;;;;;;;;;;;;;;;;;;;;;;1,0;;;;;;;;;;;;;;3,0;;;;;;;;;;;;;;;;;;;;;;;;;;1,0;;;;;;;6,0;;;;;;;;;;;;;;;;;;;;;;;;;;;;11,0;4,0;;;;;;;;;;;;;;;;;;;;;
equation;;;;;;5,0;;11,0;3,0;;;3,0;5,0;;;6,0;;2,0;;9,0;1,0;;;;;9,0;4,0;;;;3,0;;3,0;;4,0;1,0;;4,0;;2,0;1,0;;7,0;2,0;2,0;;39,0;4,0;;;;10,0;;2,0;1,0;;;5,0;;;;;;;2,0;6,0;;7,0;1,0;;10,0;;3,0;;;1,0;;;;25,0;;3,0;;1,0;;;;;;9,0;33,0;;;;;2,0;;;22,0;;;;;3,0;;;;3,0;1,0;10,0;;3,0;;1,0;;;;25,0;;;;;;;1,0;1,0;;;;4,0;;4,0;;;24,0;;1,0;;4,0;15,0;;;;2,0;;;;19,0;6,0;;;;2,0;1,0;;;42,0;;;;3,0;;9,0;3,0;;;9,0;4,0;;;;;;1,0;5,0;7,0;;;;2,0;;2,0;;;;;;4,0;;;;;;;;;3,0;;;;;;;2,0;;;1,0;;3,0;24,0;;;;;;2,0;;;;;;2,0;;;;;;;2,0;;;;;;;3,0;;4,0;;;;;;1,0;;;;2,0;3,0;31,0;;;;;;;;;;4,0;;;;9,0;;;2,0;;;;;;1,0;;;;3,0;;;3,0;;;;;;12,0;;;;;1,0;;;;;;;;;;;;;;;;;;;3,0;;;;;;;;;;;;;4,0;;;;;;;;;;;;;2,0;;;;;;;;;4,0;;;4,0;;;;;;2,0;;;;28,0;;;;;;;;;;;;;;;;;;;;;;1,0;;;;;;;;;2,0;;;2,0;;;;;;;;;;;;;;;;;;27,0;;6,0;;;2,0;;1,0;;;;;;;;;;;;2,0;;;;;18,0;5,0;;;;;;;6,0;;;;;2,0;;;;;;;;;;;;;2,0;;;;3,0;;;;4,0;;;;5,0;;1,0;;4,0;4,0;3,0;;;2,0;;;6,0;25,0;;;2,0;5,0;;;;;;3,0;;;;;;3,0;;;;2,0;1,0;;;;;1,0;;;;;;;;;;;;;;;;;;;;;;;;;;;;;1,0;;;;;;;;;;;;;;;;;;;;;;;1,0;;;;;;;1,0;;;;;;;;;;;;;;;;3,0;;;;;;;;;;;;;;;3,0;;;;;;;;;;;;;;;;;;;;;;;;;;;;;;;;;;;;;;;;;;;;;;;;;;;;;;;;;;;;;;;;;;;4,0;;;;;;;;;;;;;;;;;;;;;;;;;;;;;;;;;;;;;;2,0;;;;;;;;;;;;;;;;;;;;;;;;1,0;;;;;;;;;;;1,0;;;;;;;;;;;;;;;;6,0;;;;;;;;;;;;;;;;;5,0;;;;1,0;2,0;1,0;;;;;;;1,0;;;;;;;;3,0;;;;;;;7,0;1,0;;;;;;1,0;;;4,0;3,0;3,0;2,0;;;;;;;;2,0;;3,0;1,0;;;;;;2,0;10,0;;;;;;;;;;;;;;;1,0;8,0;;;;;;;;;;1,0;;;;;;;;;;;6,0;;;;;;;;;;2,0;;;;;;;;;;;;7,0;;;;;;;;;;;;;;;;;;;;;;;;;1,0;;;;;;;3,0;;;;;;10,0;;;;;;;;;3,0;;;;;;;;;;;;;;;;;;5,0;;1,0;;;;;1,0;3,0;1,0;;;;;;;4,0;;;;;;;1,0;;;4,0;;;;;;;;;;;4,0;;;;;;
estimation;;;;;;1,0;;36,0;2,0;8,0;;;1,0;;;12,0;;;;3,0;1,0;2,0;;;;1,0;3,0;;;;5,0;;21,0;;8,0;9,0;6,0;5,0;;;9,0;;;25,0;3,0;5,0;31,0;24,0;4,0;;;47,0;;;2,0;2,0;;13,0;45,0;;;;;2,0;3,0;1,0;14,0;;8,0;;3,0;;18,0;;;7,0;1,0;13,0;1,0;54,0;;1,0;5,0;21,0;;1,0;;;;1,0;18,0;;;;2,0;4,0;1,0;;69,0;4,0;3,0;;13,0;29,0;;;1,0;;1,0;10,0;;27,0;;;;1,0;;31,0;;4,0;;;7,0;9,0;4,0;4,0;;;;;;;2,0;;1,0;;6,0;7,0;;;;;;11,0;;;;;21,0;22,0;;;4,0;9,0;14,0;;12,0;;4,0;;4,0;2,0;62,0;;;;5,0;5,0;;;1,0;;;1,0;;3,0;;;;;;1,0;;;;5,0;;1,0;;;;;;;;;;1,0;;;;;2,0;11,0;;;;;3,0;;;;;;;;;;;;;;;;;;;;15,0;;;;;;;2,0;;;;;1,0;;;;;;;1,0;5,0;1,0;;;;;;1,0;7,0;;;;;;;17,0;;;;;;;;1,0;1,0;;;;2,0;4,0;;1,0;;;;;;4,0;7,0;;;;1,0;;;;;;2,0;;;;;;;;;;;8,0;;2,0;;;;;3,0;1,0;;;;4,0;;;;;;1,0;;;;;;;;;;6,0;3,0;;;;;;;4,0;;;;1,0;;;;;;;;;1,0;6,0;6,0;;;5,0;;;;;;;;;;;;;1,0;;;;;23,0;;;11,0;;;;;;3,0;1,0;;5,0;;;;;;;;2,0;;;;;1,0;;;4,0;1,0;41,0;;;;1,0;2,0;;;;;;;;;1,0;;;1,0;9,0;2,0;;;2,0;;4,0;29,0;;2,0;2,0;;;;64,0;;;;;3,0;;1,0;;;3,0;2,0;;;;;;;;;;;;;;;;1,0;4,0;;;;4,0;1,0;3,0;13,0;1,0;1,0;;2,0;;;1,0;6,0;2,0;;7,0;1,0;;;1,0;;1,0;;;;;;;;;;;1,0;1,0;;2,0;;;8,0;;;;;;;;;;;;;;;;;;;;;;;;;;;;;;;;;;;6,0;4,0;;;;;;;;;;;;;;;;1,0;2,0;;;;;;;;;;;;;;;;;2,0;;;;;;;;;;3,0;;;;;;;;;;;;;;;;;;;1,0;;;1,0;;;;1,0;;;1,0;;4,0;;;;;1,0;;;;;;;;;;;;;;;;;;;;8,0;;;;;;;;1,0;;2,0;;;;;;;1,0;;;;;;;;;;;;;;;;;;;1,0;;;;;;;;;;;;;;2,0;;;;;;1,0;;;;;2,0;;;;;;;;;;;;;;;;;;1,0;;;;1,0;;1,0;;2,0;1,0;;;;;;;;;;;;;;;;;;;;;;;;;;;;;;1,0;;;;;;;;;2,0;;1,0;;;36,0;6,0;;;;;4,0;2,0;;;;1,0;13,0;8,0;;;;;;;5,0;1,0;;;4,0;6,0;;;;1,0;;;;17,0;;;1,0;;2,0;;;;1,0;;3,0;14,0;;;;;2,0;;;;1,0;1,0;;;;;;;;1,0;;;18,0;;;;;;;;;;;;;;;;;;;;;;;;;;;;;;;;;;;;;;;;;;;;;;4,0;;;;;;;;;;1,0;2,0;;;2,0;;;;;;;;;;;;;;;;1,0;;;;;;;;;;;2,0;;4,0;;;1,0;;7,0;;;;;;;;;;;;;;;;;;3,0;;;;;;;;;;;;;;;;2,0;;;;;1,0;;;;12,0;;;;;;;;;;;;;;;;;;
exterior;;;;;;2,0;3,0;2,0;11,0;;;;;;2,0;69,0;;;;;2,0;5,0;;2,0;;;6,0;;;;;1,0;;;2,0;;;;;;;;8,0;;;3,0;3,0;17,0;1,0;13,0;18,0;;;1,0;2,0;;7,0;;;;18,0;2,0;19,0;;2,0;;;4,0;2,0;7,0;3,0;;1,0;;;;;;3,0;8,0;2,0;8,0;2,0;14,0;;1,0;;;;2,0;35,0;;;3,0;;;3,0;;10,0;3,0;;;28,0;4,0;1,0;;6,0;;5,0;2,0;3,0;1,0;;;;5,0;33,0;13,0;1,0;2,0;1,0;;;;2,0;;;;;;;;1,0;;1,0;;6,0;;;;7,0;;;8,0;;;;129,0;2,0;;;;;1,0;;;14,0;;;;;1,0;2,0;;;;1,0;23,0;;;;;;1,0;;6,0;3,0;14,0;;;2,0;23,0;;6,0;;3,0;;7,0;;;1,0;;;4,0;;3,0;;;;30,0;;;2,0;43,0;;3,0;;;;12,0;;3,0;2,0;;14,0;;;1,0;;3,0;62,0;;6,0;;;91,0;80,0;;8,0;;12,0;;5,0;27,0;;3,0;;35,0;2,0;4,0;;7,0;1,0;2,0;;;;;;2,0;;;;;2,0;;8,0;1,0;;;;;1,0;;;;4,0;2,0;;;;1,0;1,0;;;2,0;;;;131,0;1,0;;2,0;4,0;;;;;;2,0;65,0;;;;12,0;;2,0;;;;2,0;3,0;16,0;;;;;;;3,0;;2,0;;;1,0;2,0;1,0;1,0;;4,0;;;26,0;;1,0;2,0;;;;;1,0;;;;;;;6,0;;3,0;1,0;;;;3,0;;;7,0;;;2,0;;;;;;;;2,0;;;6,0;;3,0;;;;3,0;1,0;;;;2,0;;2,0;;15,0;;;;;9,0;;10,0;;;;;;;;1,0;;1,0;7,0;;;;4,0;;;;1,0;;;;;;;;;1,0;;;2,0;;;1,0;;;;;;;;;;;;;;2,0;;;3,0;;;;;;5,0;;;;;2,0;1,0;4,0;1,0;;;;;;;9,0;1,0;;;;;;4,0;;;;;1,0;;;1,0;;;;6,0;;;;;;;;;3,0;1,0;;;;;;;15,0;;;;;;;6,0;;3,0;4,0;2,0;;1,0;;1,0;;;;;2,0;;;;;;;;;;4,0;;;;;1,0;;;;;;;2,0;;;;1,0;;;;4,0;;;;;;;;;;8,0;;;;1,0;;2,0;1,0;7,0;;;2,0;1,0;;;2,0;20,0;;;;;2,0;5,0;;;1,0;16,0;;;;;;;;;;;1,0;;3,0;;;;3,0;;;;1,0;;24,0;;2,0;;;;;1,0;10,0;;;;;;10,0;;;4,0;;;;;;;;6,0;18,0;;1,0;;;;;;;;;1,0;;;;;8,0;1,0;;;;1,0;;;;5,0;;;;;;;27,0;;3,0;;;;;;1,0;2,0;2,0;;1,0;1,0;;;1,0;10,0;;;;;;;;1,0;;;;;;1,0;;;;;;;8,0;;3,0;6,0;4,0;3,0;;;3,0;;1,0;;;;;;;3,0;;;;;;;;7,0;;;;;1,0;;1,0;;;;;;;;;17,0;;;;;;;;2,0;;;;;;;;4,0;;;;;1,0;;;;;;;;;;;;;;;;;;;;;;;;;;;;;;;;;;;;;;;;;;;;;;1,0;;;;;;;;;;;;;;;;;;;;;;;;;;;;;;;;;;;;;;4,0;2,0;;;1,0;;;;;;;;;;;;;;;;;;;;;;;;;;;;;;;;;;;1,0;;;2,0;;;;;;;;;;;;;;2,0;;;;;;;;2,0;;2,0;;;;;;;;;;;2,0;;;;;;;;;;;2,0;;;;;;;;;;;;;;;;;;;2,0;;;;1,0;;2,0;;;;;;;;;;;;;;;;;;;;;;2,0;2,0;;;;;;;;;;;;2,0;;;;;;;;;
extraction;;;;;;2,0;;6,0;14,0;;;;2,0;3,0;1,0;1,0;;;11,0;;;;;;;2,0;6,0;;;1,0;;;16,0;;6,0;4,0;;4,0;;;45,0;;;2,0;2,0;5,0;6,0;23,0;3,0;3,0;;3,0;;;;32,0;20,0;;;;;;;;1,0;1,0;1,0;4,0;3,0;;;;10,0;1,0;;2,0;10,0;;;56,0;;5,0;1,0;6,0;;;;3,0;;;;;;;;1,0;1,0;;4,0;;;;;25,0;;2,0;4,0;;3,0;2,0;;17,0;1,0;;;2,0;26,0;6,0;;13,0;;1,0;19,0;11,0;11,0;;;1,0;;;;15,0;;1,0;1,0;;;1,0;;;2,0;;;3,0;4,0;;;;33,0;5,0;;;1,0;2,0;16,0;;16,0;;1,0;;;;83,0;;5,0;;;;;1,0;2,0;;;;1,0;;1,0;;;;;1,0;;;;3,0;;17,0;;;;;;4,0;;;;26,0;1,0;;;;;;;;;;;5,0;;;;;;;;;;;;;;1,0;;;;;15,0;;;;;;;;;;;;;;;;;;;;10,0;1,0;;;;;;;;;;;;;;4,0;;;1,0;;;;;4,0;;;;;;;;5,0;2,0;;2,0;;;;;;;;;;;;;;;;;;;;1,0;;;;;22,0;;;;;;;;;;;;;;;;;;;;;;;;;;;;2,0;;;;;;;;1,0;;;;;4,0;;;;;1,0;;;;;;;;;;;;;;;;;;;;;;;;;;;;;;;;;;;;;;;;;;;;2,0;;;;;;7,0;;;10,0;2,0;;8,0;13,0;;;;;;;;;;;;;2,0;;;;53,0;1,0;;;;8,0;;;;1,0;;6,0;;;8,0;;1,0;;;8,0;;;;3,0;;;;1,0;;;;;3,0;;;;;;;;1,0;;;;;;;2,0;;;;;;6,0;;3,0;;;;;;;;;;;1,0;;;;;;;;;;3,0;;;;;;;1,0;1,0;;;2,0;;;;;;1,0;;;2,0;;;;;2,0;1,0;2,0;;;;2,0;;;;;1,0;;;;;;;14,0;;;;;;;;;;;;;;1,0;;;4,0;;1,0;;;;;1,0;3,0;;;;1,0;;;;;2,0;;;;4,0;;;;;;;3,0;;;;;;;;;;;;;;5,0;;;;;;;;;;;;;;;;;;1,0;;;18,0;;;;;;;;;;;;2,0;;;;;;;;;;;;;;;;;;;;;;;;5,0;;;;;;;;;;4,0;;;;;;;;;;;;;;1,0;;;;;;;;;;;;;;;;1,0;;;;;;;;;;;1,0;;;;;;;;;;;;;;;;1,0;;;;;;;;;;;;;;;;;;;;;;;;;;6,0;;;1,0;;;;;;;;;;;;;;;126,0;;;;;;19,0;;;;;;;;;;;;;;;2,0;;;;;;2,0;4,0;2,0;3,0;;;;;11,0;;;12,0;;;;1,0;1,0;;;;;;;2,0;;;;;;;;;;;2,0;;;;;;;;;;1,0;;;;;;;;;2,0;1,0;;;3,0;;;;;;;;;;;;;;;;;;;1,0;;;;;;;;;;;2,0;;;;;;;;;;;;;;;;;;;;;;;;;;;;;;;;;;;;;;;;;;;;;;;;;;;3,0;;;;;;;;;;;;;;;;;;;;;;;;;;;;;;;;;;;;;2,0;;2,0;;;;;;;;;;;;;;;;;;;;;;
factor;;;;;;10,0;3,0;9,0;1,0;;13,0;;2,0;1,0;2,0;74,0;;;12,0;;14,0;8,0;14,0;1,0;;;31,0;4,0;;;8,0;5,0;13,0;;10,0;3,0;2,0;59,0;1,0;;17,0;;16,0;3,0;12,0;2,0;79,0;18,0;11,0;9,0;;19,0;16,0;1,0;;;4,0;;2,0;1,0;;;;;7,0;9,0;7,0;20,0;15,0;;11,0;1,0;22,0;;1,0;;;;11,0;167,0;2,0;22,0;;13,0;12,0;;;;;11,0;14,0;;;;4,0;2,0;3,0;;46,0;;;;7,0;12,0;;1,0;3,0;;24,0;17,0;;26,0;;;;23,0;5,0;7,0;2,0;32,0;;;10,0;5,0;8,0;2,0;;2,0;;14,0;;16,0;3,0;;5,0;18,0;4,0;7,0;18,0;;7,0;;;31,0;11,0;;;;24,0;17,0;1,0;;2,0;6,0;3,0;;19,0;;21,0;;10,0;;29,0;9,0;;;1,0;9,0;4,0;;78,0;;;;8,0;8,0;;;;;;;;;;5,0;;9,0;;;;;;5,0;;;9,0;;;;;;3,0;13,0;45,0;;;7,0;11,0;3,0;;;;1,0;;;;;;;2,0;1,0;;;;1,0;;;2,0;;5,0;;;;;;1,0;;;;;;;;9,0;;;;13,0;2,0;1,0;;;;;;3,0;;;1,0;;;1,0;24,0;1,0;;3,0;;4,0;;;13,0;;;4,0;;;;;2,0;1,0;;;;3,0;20,0;7,0;;;;2,0;4,0;3,0;;;;39,0;;;;;;;;;;;;;4,0;1,0;1,0;;;3,0;;2,0;;;;;;;;;;;;3,0;;;;;;;6,0;;;;;;;2,0;;4,0;;;5,0;1,0;4,0;;2,0;2,0;;;;;21,0;2,0;5,0;1,0;2,0;;;;;;;;;5,0;;;;;;;;;;;;;;;1,0;;;;1,0;;1,0;2,0;;;;;12,0;6,0;;;1,0;;;4,0;;;1,0;;31,0;14,0;;5,0;;1,0;4,0;;;6,0;;;1,0;2,0;;;;;8,0;;;;12,0;16,0;3,0;2,0;1,0;11,0;4,0;12,0;;1,0;2,0;;;;;2,0;;;;;;;;;3,0;;;;;1,0;2,0;3,0;8,0;;;5,0;;38,0;1,0;;;;;4,0;;2,0;;1,0;1,0;27,0;8,0;;1,0;1,0;1,0;12,0;4,0;2,0;1,0;;1,0;9,0;1,0;;;2,0;3,0;;1,0;;;;3,0;;3,0;;;;2,0;114,0;;;;;;;;6,0;;;;;11,0;;;3,0;;;;;;;;;;7,0;7,0;;;;;;;;;23,0;1,0;;;;;;;;1,0;;8,0;;;;;;8,0;;6,0;;;;22,0;2,0;;;;;;;;;2,0;1,0;;;;;5,0;;4,0;;;;;;;;1,0;;;;;;;;;;;;;;;;3,0;;;;;;;;3,0;17,0;;;;;;6,0;;;;;;;1,0;;;1,0;;;;2,0;;;;;;5,0;;;;;;;;3,0;;3,0;;;;;1,0;;;3,0;;;;;;;;;;;;;;;;;3,0;;;;5,0;;;;;;;;;;;;;5,0;;;;;;;;3,0;;;;;;;;;;;;;;;;;;;;;;;;;2,0;1,0;;;2,0;4,0;;;;;;;;;;;;;;;;;;;;;2,0;;;;;;3,0;;;25,0;;;;;;;;;;;;1,0;2,0;;;8,0;;3,0;;;;2,0;;2,0;4,0;2,0;;;;;;;;2,0;13,0;2,0;7,0;;;;;;;46,0;4,0;;65,0;;3,0;6,0;;;37,0;;;4,0;2,0;;;;;;10,0;;;2,0;1,0;;;;;;;;;3,0;;;;1,0;;;1,0;;;;;1,0;;;1,0;;;;2,0;;;;;;;;13,0;;;;;;;;;;;;;;;;;;;;;5,0;;;;;;15,0;;1,0;;;9,0;;2,0;3,0;;;;3,0;;;;;;1,0;;20,0;;;;;;;;;;;;1,0;;;2,0;;;;;;;;;;;;;;;4,0;;3,0;;;;5,0;;;;;3,0;;;;;;1,0;;;;;;;;;;1,0;3,0;;;;;1,0;;8,0;1,0;;;;;;;;;;;;;1,0;;;;
feedback;;;;;;3,0;;2,0;;;;;6,0;2,0;11,0;18,0;1,0;;;5,0;11,0;4,0;1,0;;;;2,0;2,0;;;3,0;;14,0;;33,0;4,0;;1,0;;;15,0;2,0;;;1,0;1,0;6,0;27,0;1,0;22,0;1,0;2,0;2,0;;2,0;;2,0;5,0;;;;2,0;;;1,0;;1,0;3,0;4,0;;3,0;;17,0;;;1,0;;;1,0;11,0;;;;31,0;3,0;3,0;;;;;;;1,0;;6,0;;1,0;;24,0;2,0;;;3,0;6,0;;5,0;;1,0;17,0;3,0;;4,0;;;2,0;3,0;2,0;5,0;;;;;2,0;1,0;7,0;;;;;;;22,0;1,0;;1,0;;1,0;5,0;1,0;;3,0;;1,0;11,0;10,0;1,0;;2,0;54,0;;;;2,0;;2,0;;20,0;;9,0;7,0;1,0;3,0;7,0;;;;8,0;;;;1,0;;;2,0;10,0;1,0;6,0;;;;;;;;;;;2,0;;;;;;14,0;;;;;;;;;;7,0;2,0;;;1,0;;2,0;;;;;;;;;;;2,0;;;;;;;;5,0;;1,0;;;5,0;;1,0;3,0;;2,0;;;;;;32,0;;;;1,0;;;;;;;;13,0;;;;;;;11,0;;;;;5,0;;;1,0;;;;;;;2,0;;;;6,0;;;1,0;1,0;;1,0;;;;3,0;;;;;;1,0;;8,0;;;;;;5,0;;;1,0;;;;;;3,0;;;;11,0;;;;;2,0;;;;;;;;;;;;;;1,0;;;;;;1,0;1,0;;11,0;;1,0;;;;;;;5,0;2,0;;;;;;;;;;;;;;;;;;;;;;1,0;;;;4,0;;;;;;;;;;;;;;;;;;;;1,0;;;;;;5,0;3,0;;;;;;;1,0;;;;;;;;;;1,0;;2,0;;6,0;;2,0;2,0;;1,0;5,0;;;4,0;5,0;;3,0;1,0;;5,0;2,0;1,0;;;;;;;;2,0;;4,0;;1,0;;;;;;;;;2,0;;;;;20,0;;;;;;14,0;;;5,0;;;;;;;;;1,0;;1,0;;2,0;8,0;12,0;;5,0;;;;1,0;;;;;2,0;;1,0;;;2,0;;;;;;;;;14,0;;;7,0;;;;;;2,0;1,0;;;7,0;;4,0;;2,0;1,0;;;;;2,0;;;;;;;6,0;;;;;;1,0;1,0;;;3,0;;1,0;;15,0;;;;;3,0;;;2,0;;;;;;;;4,0;;10,0;;;;;;;;;2,0;;;;;;;;;6,0;;1,0;;;;;;;;;;;;;;;;1,0;;;;;;;;;;;;;;1,0;;;;;;9,0;;12,0;;;;;;;;;;;;;;;;;;28,0;;;1,0;;;;;;;;;;;;;;;;;;;;;;;;;;21,0;;;;;;;;;;;;;;;;;;;;;;;;;;;;4,0;;;;;;;;;4,0;;4,0;;;;;3,0;3,0;;;;;3,0;;;;;;;;;;;;;;;;;;6,0;;;4,0;2,0;;;;;;;;2,0;;;;4,0;;1,0;;;;;;;;;;;;;;;1,0;7,0;;;;;2,0;4,0;4,0;;2,0;;1,0;;;;;;1,0;;;;4,0;;3,0;;;;;1,0;;1,0;1,0;8,0;2,0;;;1,0;;;2,0;;;;1,0;;;;1,0;;;;;1,0;;;;;;;;;;;;;;;;;;;;1,0;;;;;;;;;;;2,0;;;;2,0;;;;;;;;;;;1,0;;;;;;;;;;;;3,0;;;;;;;;;;;;;;1,0;;2,0;;;;;;;2,0;;;;;;;;;;;;;;;;;;;;;;;;;;;;;;;;;;;1,0;;;;;;;;;1,0;;;;;;;;;;1,0;;10,0;;;;;;;;;;;;;;;;;;
film;;;;;;4,0;18,0;54,0;18,0;60,0;2,0;;;;2,0;22,0;;;;;;4,0;1,0;;1,0;1,0;17,0;;;;1,0;;16,0;;65,0;;;;3,0;;;;14,0;1,0;1,0;4,0;3,0;121,0;3,0;12,0;134,0;5,0;;;4,0;11,0;40,0;;;;39,0;1,0;3,0;;44,0;10,0;1,0;321,0;6,0;26,0;12,0;1,0;11,0;;;2,0;4,0;;3,0;33,0;12,0;67,0;;99,0;;;;;;;50,0;;;66,0;;;;;110,0;;;;53,0;3,0;;;40,0;;;;;13,0;15,0;;5,0;57,0;85,0;13,0;;8,0;2,0;2,0;29,0;5,0;2,0;2,0;4,0;;;4,0;;1,0;;19,0;4,0;;;2,0;;2,0;1,0;;;41,0;1,0;;;50,0;16,0;;;17,0;2,0;1,0;3,0;3,0;17,0;;;19,0;1,0;2,0;42,0;;;;47,0;;1,0;12,0;2,0;23,0;6,0;14,0;;10,0;;3,0;3,0;1,0;;;12,0;1,0;36,0;13,0;18,0;3,0;3,0;;;4,0;21,0;29,0;;37,0;;;10,0;90,0;;;7,0;21,0;;2,0;;;32,0;8,0;;1,0;6,0;27,0;3,0;;;2,0;2,0;12,0;10,0;7,0;19,0;;2,0;;166,0;8,0;81,0;13,0;26,0;47,0;;;2,0;7,0;13,0;20,0;2,0;7,0;9,0;4,0;4,0;4,0;;27,0;48,0;2,0;13,0;13,0;14,0;;;;;;14,0;8,0;2,0;47,0;;34,0;;8,0;47,0;;;25,0;23,0;152,0;;6,0;1,0;12,0;;1,0;;26,0;92,0;118,0;;;2,0;30,0;25,0;6,0;2,0;5,0;;79,0;1,0;7,0;7,0;2,0;24,0;;;;29,0;;8,0;1,0;9,0;1,0;1,0;;;8,0;16,0;1,0;;;20,0;;3,0;4,0;;;3,0;;;;;;4,0;;8,0;4,0;;1,0;;;;;1,0;;5,0;6,0;;1,0;;;;2,0;;2,0;;5,0;3,0;42,0;;;2,0;16,0;4,0;;;1,0;;;;;39,0;;;;;2,0;;25,0;;;2,0;;;;;;1,0;;;;;;2,0;3,0;8,0;;;10,0;1,0;;;1,0;;3,0;;7,0;2,0;;;;;;;;;;;;1,0;;1,0;;;;;1,0;5,0;;;;2,0;;;;;3,0;;;;;;2,0;4,0;;;3,0;16,0;;;2,0;1,0;;;8,0;1,0;;;;45,0;;;;;2,0;;;;;1,0;;;1,0;;;;;;;;1,0;;;2,0;;;;9,0;;;;;;;;;;;;2,0;1,0;;;;;;;7,0;;6,0;;;1,0;2,0;;;;3,0;;;;;;;;;;;;;1,0;;;;;;;;;;;;1,0;;;;;;;;;;2,0;;9,0;4,0;;;;;;;;;;1,0;;;;;5,0;3,0;;;;;;;;;;3,0;;23,0;;;;;;1,0;;;;5,0;;;;;;;;;2,0;;;;;;;9,0;;1,0;;;;2,0;2,0;;;;;;4,0;;;;1,0;;;;;;;;;59,0;;;;1,0;;;2,0;;2,0;;;;;;;1,0;;;;;;;;2,0;;;2,0;;;;;;;1,0;;;2,0;26,0;;2,0;5,0;1,0;;;;;;;;;;31,0;;;;;1,0;;11,0;;5,0;;11,0;;;;;;;;2,0;5,0;;;;;;3,0;;;2,0;;3,0;;;;21,0;;;;;4,0;;;5,0;;1,0;;6,0;87,0;16,0;2,0;1,0;;;;;;;;18,0;;;;388,0;;2,0;;;;;6,0;;;;;7,0;1,0;;;;12,0;;7,0;;18,0;;;1,0;;;2,0;;18,0;58,0;;;9,0;;;;;;;;3,0;;;;;;;8,0;;;38,0;;;2,0;2,0;;;;;3,0;;1,0;1,0;;;1,0;;2,0;;;;;;;;2,0;;;;;;;;;;;;;;;;;;;;;;;;;;;4,0;;;1,0;;;;;;;;;;;;1,0;;;;;2,0;1,0;;;;;;;13,0;;;;;;;;;;;;;;;;;;1,0;;;15,0;;22,0;;;1,0;;;;;;;;;;;;;;;1,0;4,0;;1,0;;;;;;;2,0;;;;;;;;;;;;;;;;;;;;;3,0;1,0;;;;;1,0;3,0;;;2,0;;;;;6,0;;;;;;;4,0;1,0;1,0;;;;;;;;;;;;;;;;;;;;;;;2,0;;;;;;;;
finder;;;;;;2,0;;1,0;4,0;3,0;;;2,0;;;2,0;;;;;;6,0;;;;;2,0;;;;4,0;1,0;5,0;;;;;;2,0;;;;3,0;;;;2,0;14,0;7,0;19,0;1,0;4,0;;;;;;;;;;;;;;1,0;;2,0;1,0;;;;3,0;;;;;;1,0;31,0;;;;4,0;;;;;;;2,0;;;2,0;;;;;7,0;;;;;10,0;;;18,0;;;;;3,0;;;;;;28,0;;;;;4,0;2,0;3,0;1,0;;;;15,0;2,0;;1,0;;;;;1,0;;;1,0;;;2,0;;;;;18,0;;;;2,0;;5,0;;14,0;;;;2,0;6,0;4,0;;;;10,0;43,0;;;;;;;;;;;;;;;;;1,0;;;;;;;;;2,0;;;;;;;;;;;;;;;1,0;;;;;;;;;;;;;;;;;;;;5,0;;1,0;;1,0;1,0;;3,0;;;;;;;;;;;;;;1,0;1,0;;;;;;1,0;;;2,0;;;;;;;;;;;;1,0;;;;;;;;;;;;;;;;;;;;;;;;;;;;;2,0;1,0;;;;;;;;;;;;;;;;;;;;;;;;;;;;;;;;;;2,0;;1,0;;;;1,0;;;1,0;1,0;1,0;;;;;;;;;;;;2,0;;;;;;;;;;;4,0;;;;;;;;;;;;;;;;;;;;;;12,0;;;;;;;;;;;;2,0;;;;;;3,0;;;;2,0;;;;;1,0;;;;1,0;;;;;;;;;2,0;;;4,0;;;;3,0;;;;1,0;;;;2,0;;1,0;;;;;;;;;;;;;;;;;;;;;;;;;1,0;3,0;;;;;;1,0;;;;;;;;;;;;;;;;;;3,0;;;;;2,0;;;;;;;;;;;;;;;;;;;;;;;1,0;;;;;;;;;;1,0;;;;;1,0;;;;;;;;;;;2,0;;;;;;;;;;;;;;;1,0;4,0;;;;;;;2,0;;;;;;;;;;;;;;;;;;2,0;;;;;;;4,0;;;;;4,0;;;;;;;;;;;;;;3,0;;1,0;;;1,0;;25,0;;;;;;;;;;;;;;;3,0;;;;;;;;;;;;;;;;;;;;;;;;;2,0;;;;;;;;;;;;;;;;;;;;;;;;;1,0;;;;;;;;;;;;;;;;;;;;;;;;;;;;;;;;;;;;;;;;;;;;;;;;;;;;;;;;;;;;;;;;;;;;;;;;;;;;;;;;;;;;;;;;;;;;;;;;;;;;;;;;;;;;;;;;;;;;;1,0;;;;;;;;1,0;;;;;;;;;;2,0;;;;;;;1,0;;;;;1,0;;;1,0;;;;;;;;;;;;;;;;;;;;;;;;;;;;;;;;;;;;;;;;;;2,0;1,0;;;;;;;;;;;;;;;2,0;1,0;;;;;;1,0;;;;;;;;5,0;1,0;;;;;;;;;;;;;;;;;;;;;;;;;;;;1,0;;;;;;;;;;;;;;;;;;;;;;;;;;;;;;;;;;;;;;;;;;;;;;;;;;;;;;;;
fixture;;;;;;1,0;;;5,0;9,0;;;5,0;;;6,0;;;;2,0;8,0;9,0;3,0;;;;;;;;;;14,0;;18,0;;3,0;;;;1,0;;3,0;;1,0;3,0;2,0;7,0;1,0;;3,0;;;;;5,0;;;;;;3,0;7,0;;4,0;1,0;;3,0;5,0;;;;;;;;;3,0;;22,0;;4,0;;20,0;;;;;2,0;1,0;11,0;;;;;;;;5,0;1,0;;;26,0;2,0;;2,0;1,0;;;;;;;;;5,0;24,0;10,0;1,0;;;;;1,0;1,0;;;;;;;1,0;3,0;;;;1,0;;;;;8,0;;18,0;;;;6,0;1,0;;;;;;;3,0;12,0;;;;;2,0;;;1,0;;3,0;3,0;;;;;1,0;;2,0;;6,0;3,0;3,0;;9,0;4,0;;;;16,0;;10,0;;;;;;7,0;;2,0;;;;;;;;2,0;1,0;;;;;1,0;;;;;;;;;;3,0;7,0;;3,0;1,0;;1,0;;;79,0;2,0;3,0;;;32,0;3,0;3,0;2,0;1,0;4,0;;;;2,0;;;;;;;1,0;;;;;;;8,0;;1,0;;;;9,0;;;;4,0;;2,0;;;6,0;1,0;;;;;;;19,0;;;;4,0;;;;1,0;;;;4,0;;;6,0;;;;7,0;;4,0;1,0;3,0;;;;;;5,0;;;6,0;;;1,0;;;4,0;;14,0;;;1,0;;2,0;;;;;;;;2,0;;;4,0;;;5,0;6,0;4,0;;5,0;;1,0;;;;1,0;;1,0;;;;;;;2,0;;;;;;;;;1,0;1,0;;;;;;;;;35,0;;2,0;1,0;;2,0;;;;;1,0;;;10,0;2,0;5,0;9,0;;;4,0;;;;2,0;;;;4,0;;;;;;;;;;;;;;;;;;;1,0;;;;;;;;;;;;;;2,0;;;;;3,0;6,0;;;2,0;;;8,0;;;;;;;;;;;;;;;;;;;;;;;;;;;1,0;;;;;;3,0;;;;;;;;;;3,0;;;;;1,0;;;2,0;;;;;;;;;;;;3,0;;;;;2,0;11,0;;;;;1,0;;;;;;;;;;;3,0;;1,0;;;;;;8,0;;;;;;;;;;;;;;;;;3,0;;;;;;2,0;;;;;;;;;;;1,0;;;1,0;;;;;;;;;;1,0;;;4,0;;1,0;5,0;;;;;;1,0;;;;;;;;;;;;;;;;;;;;;;4,0;;;;;;;;;;;1,0;;;;;;;;;;;;;;;;;;;;;;;;;;;2,0;;;;;;;1,0;;;;;;;;;;;2,0;1,0;;;;;;;;;;;;1,0;;;;2,0;;;;;;;;;;1,0;;;;;;;;3,0;;;;;3,0;;;;;;;3,0;;;;;;;;;;1,0;10,0;;;3,0;;;18,0;;;;;1,0;;;;;;;;;;;;;;;;;;;;;;;;;;;;;;;;;;;;;;1,0;;;;;;;;;;;;;;;;;;;;;3,0;;;5,0;;;;;;;;;;;;;1,0;;;;;;;;;;;;;;;;;;;;;;;;;;;;;;;;;;;;;;;;;;;;;;;1,0;;;;;;;;;;4,0;2,0;;;7,0;;;;;;;;;;;;;;;;;;;2,0;;;;;8,0;;;;;;;;;;1,0;;;;;;;;1,0;;;;;;;;;4,0;;;;;;;;;;;;;;;2,0;;;;1,0;;;;;;;;;;;;;;;;;;;;;;;;;;;;;;;;;;;;;;;;;;;;;;
flange;;;;;;7,0;2,0;4,0;;4,0;;;;;13,0;44,0;;;;1,0;;2,0;;3,0;;1,0;;;;6,0;;;25,0;;9,0;;;1,0;;;;;18,0;2,0;;;1,0;15,0;1,0;;20,0;49,0;;;4,0;13,0;13,0;28,0;;;59,0;;;;;42,0;;43,0;;4,0;2,0;;2,0;;;1,0;;;;1,0;;2,0;;34,0;1,0;;1,0;;;10,0;88,0;;;1,0;;;4,0;;4,0;;;;21,0;2,0;10,0;1,0;7,0;;;;4,0;;5,0;;;17,0;134,0;19,0;;2,0;2,0;;;1,0;8,0;2,0;;;;;;1,0;2,0;;;;4,0;;;;;;;2,0;;;;43,0;7,0;3,0;;;;4,0;;;8,0;;;;;;7,0;;;;;;;;;;;6,0;5,0;;24,0;24,0;4,0;;;24,0;;1,0;;3,0;;2,0;;;;;;12,0;;5,0;;;1,0;8,0;8,0;;3,0;4,0;;;;;;8,0;;5,0;;;;;4,0;;1,0;24,0;18,0;1,0;15,0;;;;;;2,0;;20,0;3,0;;80,0;15,0;3,0;;8,0;24,0;13,0;5,0;11,0;10,0;;;;;;;5,0;20,0;;1,0;;;;11,0;;;;;;26,0;;;;11,0;;1,0;;1,0;;14,0;;;;;13,0;2,0;97,0;;;8,0;7,0;7,0;;;;;;;;;;5,0;;2,0;;;4,0;4,0;;14,0;;;;;;9,0;;;1,0;;;1,0;;;5,0;2,0;14,0;2,0;;2,0;;1,0;;6,0;2,0;;;3,0;6,0;;;7,0;;;6,0;2,0;;;3,0;1,0;;1,0;2,0;;;;;9,0;8,0;;;;;;;1,0;;;6,0;;4,0;3,0;;;12,0;1,0;;;2,0;;;1,0;;8,0;1,0;3,0;;;1,0;;7,0;;;13,0;8,0;;12,0;6,0;3,0;1,0;1,0;2,0;;;;;;;;;3,0;;;;;2,0;1,0;;;;;;;;;;;;;;;;;;;;;;;1,0;;1,0;;;1,0;;;;;;;;;2,0;;;;;;;;;;;;;;;;;;;;;1,0;;;;;;;;;;;;;;5,0;;1,0;;;;;2,0;;;;;;;;;;;;3,0;;;;;;;;;;;;;;;;2,0;;;;;;39,0;3,0;;;;;;;;;;1,0;;10,0;;;;;;;;;;;;;;;;;;;;4,0;;;4,0;;;;;3,0;2,0;;;;;;;;;;1,0;;;3,0;;;;;;;;;;;3,0;;;;;;;;;;;;3,0;;;;;;;2,0;;;;;12,0;;6,0;;;;;;;;2,0;;;;2,0;;;;;;;2,0;;;;6,0;;;;;;;;;;1,0;;;;;;;;;;;;;2,0;;;2,0;;;;4,0;;;;;;;;;;2,0;3,0;3,0;;;;;2,0;;;2,0;;;;;;;;2,0;2,0;;1,0;;;;;;;;;;;;;;;16,0;;;;;1,0;5,0;;1,0;;;;11,0;;;;3,0;;;;;;;;2,0;;1,0;;2,0;;;64,0;;;;;;;;;;;;1,0;;;;;;;;;;;;;;;;;;;1,0;;;;;;;;;;;;;;;;;;3,0;;;;;2,0;;;;;;;;;;;1,0;;;;;;;;;;;;;;;;;;;;;;;;;;;;;;;;;;;;;;;;;;;;;;;;;;;;;;;;;;;;;;;;;;;;;;1,0;;;;;1,0;;;;;;;;;;2,0;;;;;;;;;;;;;;;;;;2,0;;;;1,0;;;;;;;;;;;;;;;;;;;;;1,0;;;;;;;;;;;;2,0;;;;;;;;;;;;;46,0;;;;;;;;;;;;;;;;2,0;;;;;;;;;;;;;;;;;;;;;
flat;;;;;;6,0;1,0;4,0;14,0;;1,0;;;;20,0;14,0;7,0;;;;;51,0;1,0;2,0;;;;;;;;;21,0;;;;;1,0;;13,0;3,0;;1,0;;3,0;;20,0;25,0;6,0;23,0;9,0;3,0;3,0;1,0;;8,0;8,0;;1,0;5,0;21,0;1,0;9,0;;3,0;;1,0;27,0;;3,0;;;13,0;;3,0;;3,0;;1,0;67,0;2,0;7,0;9,0;38,0;;11,0;;;;2,0;37,0;;;3,0;;4,0;7,0;;34,0;1,0;;;16,0;4,0;2,0;;39,0;1,0;14,0;;1,0;3,0;1,0;;;36,0;116,0;36,0;;1,0;;;3,0;;6,0;2,0;;;;2,0;;1,0;5,0;;6,0;2,0;7,0;6,0;;;15,0;;;22,0;;;;49,0;;2,0;;;5,0;6,0;;;16,0;;;;3,0;;8,0;;;;;;;;1,0;3,0;2,0;5,0;;1,0;8,0;6,0;;;1,0;10,0;2,0;;;2,0;;;;;;;7,0;15,0;;18,0;;;;9,0;5,0;;;2,0;1,0;;1,0;1,0;7,0;21,0;1,0;;;;4,0;;2,0;;;1,0;15,0;1,0;4,0;;;;;;1,0;;43,0;2,0;;15,0;2,0;;;2,0;9,0;18,0;2,0;37,0;;;;;;;12,0;10,0;49,0;;;;;;3,0;1,0;;;1,0;;4,0;;;;23,0;2,0;;;;3,0;;1,0;;16,0;;5,0;8,0;187,0;;;1,0;3,0;24,0;6,0;;1,0;1,0;5,0;4,0;;;3,0;14,0;;2,0;;;;2,0;;7,0;;;;;1,0;12,0;;;5,0;6,0;;1,0;30,0;;3,0;1,0;10,0;1,0;4,0;2,0;2,0;;;3,0;1,0;2,0;;;;5,0;;;;4,0;5,0;1,0;6,0;;1,0;;3,0;;2,0;;;10,0;;;3,0;;;;;24,0;22,0;1,0;;7,0;6,0;;7,0;7,0;;;4,0;;;;1,0;;;;3,0;8,0;;6,0;;1,0;;;;3,0;;;;;12,0;3,0;3,0;;;4,0;;;1,0;12,0;;;;;;;;;;;19,0;2,0;;;;1,0;;;2,0;;;;;18,0;;;2,0;;;;;;2,0;6,0;;6,0;;6,0;;;;1,0;;2,0;;2,0;;2,0;;;;;;;;;2,0;;4,0;;;;;;;;;;;;5,0;;;;1,0;1,0;;;;;1,0;7,0;;2,0;3,0;;;;;;17,0;;;;;;;;;1,0;;;2,0;5,0;7,0;;;1,0;;5,0;;;10,0;;3,0;;;;;2,0;;;;;;1,0;;;10,0;;;;;2,0;2,0;;5,0;2,0;;;;;;;;;9,0;;;;;;1,0;;;;2,0;;;1,0;;;1,0;;;2,0;;;;;;;;;;;;;;;;;3,0;;;;;;;;;;;;;;;;;1,0;;1,0;;;;;;;;;;;;;;;;;;;;;;;;;;37,0;;;;;;;84,0;;;;2,0;;;;;;;;1,0;;5,0;;;;;;;;8,0;;1,0;4,0;;3,0;;;;;;;1,0;;;;;;;;;;;2,0;4,0;;;2,0;1,0;;1,0;;15,0;1,0;6,0;;;;;;4,0;;2,0;;;;;;1,0;3,0;;;;;;;;;21,0;;;;;10,0;;;4,0;;;1,0;;2,0;;6,0;14,0;;;;2,0;;;;;13,0;;2,0;7,0;;;;1,0;;;;;;;;;;;4,0;1,0;2,0;;;;;;4,0;;;;;;;;;;;;;;;;;;;5,0;;;;1,0;;;;;;;;;;;7,0;;;;;;;;;;;1,0;11,0;;;2,0;6,0;;;;;;;;;;;;;;;;;1,0;;;;2,0;;;;;;;;;;;;;;;;;;;;;;;;;;;;;;9,0;;;;;;;;;;;;;;1,0;;;;;;;;;4,0;;;6,0;;;;;;;;;;;;;;;;;;4,0;;;;;;1,0;3,0;;;;;;;;;;;;;;;;;;;;;;;;;;4,0;;;;;;;;;;;4,0;;;;;;4,0;;;;;;;;;;;;1,0;;1,0;;;;;;;;;;;;;1,0;;;;;;;;;;;;;
fluid;;;;;;2,0;2,0;2,0;;;;;4,0;;5,0;1,0;;;;1,0;;1,0;;90,0;;;2,0;;;;;;32,0;;8,0;;;;1,0;;8,0;;1,0;;;;1,0;5,0;2,0;;1,0;;;;;;12,0;;;;19,0;3,0;;;;;2,0;9,0;;26,0;;;;;;;;;;8,0;;;;14,0;;;;;;6,0;37,0;;;4,0;;;;;5,0;;7,0;;4,0;;;;11,0;;2,0;2,0;;2,0;;;1,0;15,0;4,0;18,0;;;1,0;;;;;;6,0;;;;;;1,0;;15,0;;;;;;;;;;;;;42,0;;;;;1,0;;;5,0;14,0;;;2,0;1,0;;1,0;;;;1,0;;;;;;;;9,0;1,0;6,0;;;;;3,0;;8,0;4,0;;;82,0;;;1,0;;;12,0;;3,0;;;;8,0;4,0;;;1,0;;;;;;10,0;;;1,0;;;;1,0;;3,0;;2,0;;3,0;3,0;;5,0;13,0;;1,0;;12,0;2,0;;;2,0;;;49,0;1,0;2,0;;;;6,0;;;;5,0;;;3,0;4,0;;;10,0;;9,0;2,0;;6,0;;;;2,0;;;;;1,0;;;11,0;;;;;;6,0;;24,0;;;;;;;;10,0;;2,0;;;;;;;;;;1,0;12,0;1,0;;;2,0;12,0;;;3,0;;1,0;;;;7,0;;1,0;;;2,0;2,0;;1,0;21,0;;13,0;;;;;;;;;;;1,0;;;;;;6,0;;;;;;;;;1,0;;;;;;;;;;;;;;20,0;;1,0;;;;;2,0;;;;;;;;;1,0;;;;;;;;9,0;;;2,0;;;;;;;;;;;12,0;1,0;;;;;;2,0;;;;;3,0;;;;;;;;;;;;;;;;1,0;;;;;;;;;;;2,0;;;;;;;;;;;;;;;1,0;;;;;;;1,0;;;;5,0;;;;;;3,0;;;;;8,0;;1,0;;;;;;;;2,0;;1,0;;;;;;;7,0;;;;6,0;;;;;;;;;;;;;;6,0;;;;;;;;;;;1,0;;;;;;14,0;;;6,0;;;;;;4,0;;;;;;;2,0;;;;1,0;;;;;;;;;8,0;;;;;20,0;;;;;;;;;;;;1,0;;;;;;;;;;;;;;;;;;;4,0;;;;;;;;;3,0;;;;;;;10,0;;;;;;;1,0;;;;;;;;;;;;;;3,0;;;;;;;;;;;;4,0;27,0;;;;;2,0;;;;;;;;;;;;;;;;;;;;;;6,0;;;;;;;;;;;;;;;3,0;;;;;;1,0;;;;;;;;;;;;;;;;;3,0;;;;;;;;1,0;;41,0;;;;;;;;;;;;;33,0;1,0;;;;;;;2,0;;;;;;10,0;;;5,0;;;1,0;;2,0;;;;;;;;;;;;;1,0;;;;31,0;;;;;;;;;;;;;;;;;;;;;;;;;;;;;;;;;;;;;;;;;;;;;;;;;;;2,0;;;;7,0;;;;;;;;;;;1,0;;;;;;;;;;1,0;;;;;;;;;;;;;;;;;;;;;;;;;;;;;;;;;;;;;;;;;;;;;;;;;;;1,0;;;;;;;;;;;;;;;;;;;;;;;;;;;;1,0;;;;;;;;;;;1,0;;;;;;;1,0;;;;;;;;;;;;;;;;;;;;;;;;;;;;;;;;;;;;;2,0;;;;;;;;;;;;;;
gate;;;;;;2,0;;2,0;23,0;25,0;32,0;;15,0;;1,0;21,0;2,0;;;;;;;33,0;;;164,0;3,0;;;;1,0;22,0;;89,0;2,0;;2,0;;;13,0;1,0;16,0;;5,0;1,0;14,0;37,0;;;34,0;6,0;;4,0;4,0;2,0;20,0;;;;5,0;;33,0;;;;;47,0;17,0;2,0;5,0;;48,0;10,0;;;9,0;;1,0;56,0;2,0;32,0;4,0;49,0;5,0;6,0;;;;7,0;1,0;;19,0;2,0;;;2,0;;21,0;;1,0;;10,0;13,0;;19,0;1,0;;28,0;;1,0;8,0;23,0;;;35,0;50,0;4,0;101,0;5,0;1,0;;2,0;2,0;17,0;;;;;13,0;;23,0;;;;1,0;11,0;2,0;5,0;;;;;24,0;4,0;;;39,0;58,0;;;;1,0;;;36,0;24,0;;;205,0;;1,0;50,0;;;;2,0;5,0;;4,0;;3,0;3,0;6,0;;20,0;;;14,0;;;18,0;1,0;2,0;27,0;43,0;;1,0;1,0;;;;;118,0;;3,0;;;;6,0;;;;2,0;;;6,0;;;1,0;27,0;;;;;;;;6,0;1,0;4,0;1,0;3,0;;;;24,0;;53,0;;1,0;;2,0;2,0;1,0;;1,0;16,0;5,0;;17,0;;15,0;1,0;6,0;2,0;9,0;;30,0;;;;1,0;;;23,0;23,0;4,0;1,0;;;1,0;;8,0;21,0;;8,0;4,0;4,0;2,0;;58,0;1,0;2,0;;;5,0;2,0;29,0;49,0;126,0;;5,0;2,0;1,0;16,0;;;;;;;;;6,0;7,0;;;3,0;;;4,0;1,0;;;;15,0;;2,0;;;;1,0;;1,0;;2,0;;4,0;11,0;8,0;;;;1,0;;;;;;;;;;;;1,0;;3,0;;;;;2,0;;;;;5,0;10,0;5,0;1,0;;6,0;;;;1,0;;;;;;1,0;;;;1,0;3,0;4,0;1,0;;;;;;;;;;;;4,0;;;1,0;;;2,0;1,0;2,0;4,0;;1,0;;;;20,0;;;;;;;;;;;2,0;1,0;15,0;1,0;2,0;;;6,0;;2,0;2,0;;;;7,0;;11,0;;;;;;;54,0;5,0;1,0;;;;;5,0;;;2,0;;;2,0;4,0;8,0;;;8,0;;;;;;;;;;;6,0;2,0;;1,0;;;;;4,0;1,0;;;;;;;;;99,0;;3,0;3,0;;2,0;;;;;;;;1,0;;6,0;1,0;;;;;;;;;;;;2,0;;8,0;;;;;4,0;;;;;;;;;;5,0;;;;;;;;;2,0;1,0;;;;;;;;;;;;2,0;;;;9,0;2,0;;;3,0;;;;;;;;;6,0;;;;;;;;;;1,0;;;3,0;;;;;;;;3,0;;6,0;;;;;;;;1,0;;;;;;6,0;2,0;;;;;3,0;;;;;;;;1,0;1,0;;;2,0;;;16,0;;;;;;57,0;3,0;;;33,0;1,0;;7,0;;;;4,0;;;;;1,0;;;;;;;;;;;;;;9,0;;;;2,0;1,0;;;10,0;5,0;;;;;;;;;;;;;;;;;1,0;;;;;1,0;3,0;;;;;;;;;68,0;;;1,0;;;;;;10,0;;;1,0;;;;13,0;;;;;;;30,0;;;;;3,0;7,0;8,0;1,0;;2,0;;;;;1,0;;;;;;28,0;;;;7,0;;;;;;;;;;7,0;;;47,0;13,0;16,0;21,0;12,0;;;;;11,0;41,0;;18,0;153,0;3,0;;16,0;2,0;6,0;;1,0;;24,0;;14,0;17,0;;1,0;;;;;;;349,0;39,0;;31,0;7,0;;;;;17,0;;;;;;;;;;;;;;;;;2,0;;;;;;;28,0;;;;2,0;;2,0;;;;2,0;;;;;;;;;;;;;;;;;;;;;;;;;;;;;;3,0;;;;3,0;;;;;;;;;;;;;;;4,0;;;;;;;;;;;;;;10,0;;2,0;;1,0;;;;;;;;;;;;;;;;;;;;;;;;;4,0;;;;;;;;1,0;;;;;;;;;;;;;;;;;;;;;;;;;2,0;;;;2,0;;;;;;;;;;;;;;;;;;;1,0;;;;161,0;;;;;;;;;;;;
gaze;;;;;;5,0;3,0;;3,0;;;;4,0;;;21,0;;;;;1,0;11,0;8,0;;;;;;;;1,0;;10,0;;;1,0;;;;;;;6,0;1,0;23,0;;22,0;22,0;9,0;15,0;;9,0;;;;;;3,0;4,0;;;;;;2,0;6,0;6,0;;;;7,0;;10,0;;1,0;;;;;33,0;;;;6,0;;;;;;;8,0;;1,0;;;;;;10,0;;1,0;;;26,0;;13,0;;;;18,0;;2,0;;;;5,0;;14,0;;9,0;;;;1,0;3,0;2,0;;;;2,0;;;1,0;;2,0;;;3,0;;;1,0;;;2,0;9,0;;;;8,0;;2,0;;;2,0;;;8,0;;;;;;20,0;;;;;;;;;;;;6,0;1,0;;;;;;;;;;;;1,0;;;;;;;;;;;;;;;2,0;69,0;;;;;;;;;;;;;;;;;;;;;;;;;3,0;;;;;;;11,0;4,0;;;;;;;;;;;;;;;;;;;;7,0;;;;;;;;;;;;;;;;13,0;;;;;;;;;;;;;3,0;;3,0;;;;;;;;;;;1,0;;;2,0;;;;;;;;1,0;;;;;;;;;;1,0;;;;;;;;;;;;;;;;1,0;;;;;;;;;;;;;;;;;;;;;;40,0;;;;;;;;;;;;;1,0;;;;;;;;;;;;;;;;;;;;;;;1,0;;;;;;;;;;1,0;;;;;;4,0;9,0;;;;;;;;;;;4,0;;;;;1,0;;;;;8,0;;;17,0;;7,0;1,0;1,0;;;1,0;1,0;;;;1,0;;;2,0;;;;;;;;;;;;3,0;2,0;;;;;;;25,0;;;1,0;;99,0;;4,0;;3,0;;;;;2,0;11,0;;;1,0;;;;8,0;;;;;;;2,0;;2,0;3,0;;8,0;3,0;;3,0;;;;;;;;;;;;3,0;;;;;;2,0;;;;1,0;;;;;;;;12,0;;;;;;1,0;;;;;;;;;;;;;;;;;;;;;;;4,0;;;;;;;;;;;;;;;;;;;3,0;;;3,0;;;;;;;;;;;2,0;;;;;;;1,0;3,0;;;;;2,0;;;;;;;;;;;;5,0;;;2,0;;;;;;;;;;;;;;;;;;;;;;25,0;5,0;;1,0;;;;;;;;;;;;;;;;;;;;;;;;;;;;;;;;;;1,0;;;;;;;;;;;;;;;;;;;;;;;;;;;;;4,0;;;;;;;;;;;;;;;;;;;;;;;;;;9,0;;;1,0;;;;;;;;;;;;;;;;;;;;;;;;;;;;4,0;;;;;;;;;;11,0;;;;;;;;;;;;;;;;;;;;;;;;;;;;;;;;;;;;;;;;;;;;;;;;;2,0;;1,0;2,0;;;;;;;;;;;;;;;;;24,0;;;4,0;;;;;;;;;;;;;;;;;;3,0;;;;;;;;;;;;;;;;;;;;;;;;;;;;;;;;;;;;;;;;;;;;3,0;;;;;;;;2,0;;;;;;;;;;;;;;;;;;;;;;;;;;;;;;;;;;;;;;;;;;;;;;;;;;;;;1,0;;;;;;;;;;;;;;;;;;;;;;;
gradient;;;;;;4,0;;6,0;7,0;;;;2,0;;;12,0;;;11,0;;;;6,0;1,0;;;15,0;1,0;;;;;7,0;5,0;;;3,0;3,0;2,0;4,0;1,0;;3,0;;15,0;3,0;32,0;3,0;2,0;;;;2,0;;;33,0;;;4,0;;;;2,0;;3,0;;;2,0;6,0;;;;3,0;2,0;;;1,0;;;96,0;;;4,0;6,0;3,0;;;1,0;;;2,0;;;3,0;;;1,0;;20,0;;;;4,0;;;8,0;;4,0;1,0;2,0;;1,0;;;;2,0;;;;1,0;;;;2,0;;;;2,0;;2,0;;5,0;;;4,0;;1,0;;;;;;;;1,0;;;;35,0;1,0;2,0;;;5,0;;4,0;;;;;1,0;;;;;;;;;;;;;;;3,0;;2,0;;;;;;;;;;;;;;;;;2,0;;;;;;;;25,0;9,0;;;;;;;;;;;;;;;;;1,0;;;;;;1,0;;;;;;;;;;;;;;1,0;;;;5,0;;;;17,0;;;;;;;;;;;3,0;;;;5,0;;;;;;;;;;;;;1,0;;;;;;;;;;;;;;;16,0;;;;;;;;;;;;;;;;;;7,0;;4,0;;;;;;;;1,0;;;;;;;;;;;;;;;;5,0;;;;;;;;3,0;;;1,0;;;3,0;;;;;;;;5,0;;;3,0;;;;;;29,0;;;;;;;;;;;;;4,0;;;7,0;;;;;;4,0;;;;;;;;;;;;;;;2,0;;;3,0;;;33,0;14,0;;10,0;;10,0;;;;;;;;;;;2,0;;13,0;6,0;;;40,0;;;1,0;;;;;;;;;;;;;5,0;1,0;;;;;;;;;;;;;;;;;;;;15,0;1,0;;;;;;;;;4,0;;;;3,0;4,0;1,0;;;4,0;;8,0;;;;;;;;25,0;;;;;;;;;;;;;;;;;;;;;;;;;;;;;;;;;;2,0;;;;;1,0;;;;;;;;;;;;;;;;;1,0;;;;;;;;;;;;;;;;;;;;;;;;;;;;;;;;;;;;;;;;;;;;;;;4,0;;;;;;;;;;;;;;;;;;;;;;;;;;2,0;;;;;;;;;;;;;;1,0;;;;;;;;;;;;;;;;;;;;;;;;11,0;;;;;;1,0;;;;;;;;;;;;;;;;;;;;;;;;;1,0;;1,0;;;;;;;;;;;;;;;;;;;;;;;;;;;;2,0;;;;2,0;;;;;;;;;;;;;;;;;;;;;;;1,0;;;;;;;;;2,0;;;;;;;2,0;;;1,0;;;;;;;;1,0;;;;;;;3,0;;;;;;;;;;1,0;;;;;;;;;;;;;;;6,0;;;;;;;;;;;;;;1,0;;;;;;30,0;;;;;;;;;;;;;;;;;;;;;;1,0;;;;;;;;;;;;;;;;;;;;;;;;;;;;;;;;;;;;;;;;;;;;;;;;;;5,0;1,0;;;;;;;;;;;;2,0;;;;;;;;;;;;;;12,0;;;;;;;;4,0;;;;;;;;;;;;;4,0;6,0;;;;;;;;;;;;;;;;;;;;;;;;;;;;;;;1,0;;;;;;;;;;;;;;;;
green;;;;;;4,0;2,0;4,0;;13,0;6,0;;;;;8,0;1,0;;;;;5,0;;11,0;;;109,0;17,0;;;;3,0;15,0;;;;;;;;16,0;;;;31,0;2,0;1,0;5,0;6,0;4,0;3,0;1,0;;;;;14,0;;;;;;;;82,0;;;8,0;;;;3,0;13,0;;;6,0;;;1,0;107,0;;9,0;;23,0;;;;;;;5,0;;;1,0;;;;;21,0;;;;11,0;;;1,0;;;;;6,0;1,0;;2,0;;14,0;20,0;10,0;;11,0;;;7,0;;;;;;;6,0;;;;3,0;5,0;1,0;9,0;;6,0;;;;;17,0;;;3,0;;60,0;3,0;;1,0;;1,0;1,0;1,0;4,0;;;;1,0;9,0;15,0;;;;3,0;;10,0;28,0;;2,0;;3,0;;;;;;141,0;;;;;7,0;;1,0;32,0;2,0;;;;;;;;;;;;;;;2,0;;;;;;;;;;;;;;;;;;2,0;;;;;;;141,0;;;24,0;;;;;;;;6,0;;;;;;3,0;;;138,0;;;;3,0;;;;1,0;;;;;;;2,0;;;2,0;;;;;6,0;;;;;;;;;;1,0;;;;3,0;6,0;;;1,0;1,0;2,0;;;1,0;;1,0;;;;;1,0;;;;;;2,0;;;;;;;;;;;;;;;;;;;;;;1,0;;;;;;2,0;;;;6,0;;;;2,0;;;;;;;;;;;;;;;1,0;10,0;;;;;;;;;;;;;;;;;;;;;;;;;;2,0;;;;;;;;;;;;;;;;;;;;;;;;5,0;;;;;;;3,0;;;;;;;;;;;;;;;1,0;24,0;;1,0;;;;;;;;;;;;;;;;;;;6,0;;3,0;;;;;2,0;;;2,0;;;;;6,0;;;;;;;;;;;;1,0;;;;2,0;;;;;;;;;;;;;;2,0;;;;;;;;;;1,0;;;3,0;;;;;;;2,0;;;;;;;;;;;;;;1,0;;;;;3,0;;2,0;;;;;;8,0;8,0;;;;;;;;;;;;;;;;69,0;8,0;;;;;;;2,0;;;;;;;;;;;;;;;11,0;;;;;;;;3,0;;;;;1,0;;3,0;;;3,0;;;;;;;;;;;;;;;;;;;;;;;16,0;;;;;;;12,0;;;;;;;;;;;;;;;;;;1,0;;;;;;;;;;;;1,0;2,0;;;;;;;;;;;1,0;;;;;;;;;;9,0;;;;1,0;;;;;;;;;;;;;;;;;;;;;;;;;;;;;;;;;;;;;1,0;;;;;;6,0;;14,0;;;;;;;;12,0;4,0;;;;;;;1,0;;;;;;;;;;;;;;1,0;;;;;;;;1,0;1,0;;;;;;9,0;;;;;;;;;16,0;;;;;;;;;;;;4,0;;;;;;;;4,0;;;;;;;;;;;;;;;;;;;;;;;5,0;;;;;;;;;4,0;;;;3,0;;;;;;;;;;;;;;;;;;3,0;;;;;;;;;;;;;;;;;;;;14,0;;;;;2,0;;;;;;;6,0;1,0;;;;;;;2,0;;;;;;;;;;;;;;;;;;;;;;;;;;;;;;;;;;;;;;;;;1,0;;;;;;;;;;;;;;;;;;;;11,0;;;;;;;;;;;2,0;;;;;;;;;;;;;;;;;;;;;;;;;
grid;;;;;;1,0;;5,0;15,0;11,0;6,0;;6,0;;2,0;7,0;;;;;18,0;5,0;;;;;;1,0;;;1,0;;4,0;;;2,0;;;1,0;;18,0;;;2,0;2,0;1,0;20,0;16,0;2,0;4,0;;3,0;2,0;4,0;;;2,0;;3,0;1,0;;2,0;9,0;;1,0;;1,0;3,0;;;;1,0;14,0;;2,0;;5,0;;1,0;25,0;;;;12,0;;2,0;;;;;1,0;;;;;;;;14,0;;;2,0;8,0;9,0;;;3,0;;;3,0;1,0;2,0;;;;14,0;1,0;8,0;4,0;2,0;;;;1,0;1,0;2,0;;;;;;7,0;;;1,0;;6,0;;;;9,0;1,0;;2,0;;;;;7,0;1,0;;;2,0;2,0;;1,0;9,0;;1,0;;2,0;2,0;7,0;;;;;8,0;;;1,0;;;;;;;;;;;;;;;;;1,0;;;;;;1,0;;1,0;;;;5,0;;;;4,0;;;;1,0;;;;;;;;;;;1,0;1,0;;;;;;;2,0;;1,0;;;;;5,0;;2,0;;;;;;;;;;;;;1,0;11,0;;;;;;;1,0;;11,0;;;;;;;;2,0;;;;;;6,0;;;;;3,0;2,0;3,0;;;;;;;2,0;1,0;;1,0;;;;;;;;;1,0;;;;;;7,0;;;1,0;;;;;;;;1,0;;;;;;;;;;;;;;;;;;2,0;;1,0;12,0;;;;;;;;;;;;;29,0;;;;;;;;45,0;;;;8,0;;;;;;;;;;;;;;;;;;2,0;;;;;;;;;;;;3,0;;;;;;;;;;;;;;;;;;4,0;;;;;5,0;;12,0;;;;;;2,0;;;;;;;;;;;;8,0;;;1,0;1,0;;;;;;;1,0;1,0;;3,0;;;;;;;;;1,0;;;;;;;;;;;1,0;;;;;;;;;;;;;;;10,0;2,0;1,0;;;;6,0;;;;;;;;;;;;;;;;;2,0;8,0;;;9,0;;;;;;;;;;;;;;;;;;;;;;;;;;12,0;;;;;;;;;8,0;;;;;;;;;;;;;;;;1,0;54,0;;1,0;;;;;;;;;;;;;;;;;;;;;;;;;;;3,0;;;;;;;;;1,0;;;1,0;1,0;;;;;;;;;;;;;;;;;;;;;;;;;;;;;;;;;;;;;;10,0;;;;2,0;;;;;3,0;;;1,0;;;;;;;;;;;11,0;;;;;;;;;;;;;;;;;;;;;;;;;;2,0;;;;;10,0;;;;;;;1,0;;;;;;;;;;;;;;;;;;;;;;;;;;;;;;1,0;;;;;;;;;;;;;;;3,0;;;;;;1,0;;;;2,0;;;;;;;;;;;;;;;;;;;1,0;;;;1,0;;;;;;;;;;;;;;;;;;;;;;;1,0;;;;;;;;;;;;;;;;;;;;;;;;;;;;2,0;12,0;;;;;;;;;;;;;;;;;;;;;;;;;;;;;9,0;;;;;;;;;;;;1,0;;;;;2,0;;;;;;;;;1,0;;;;;;;;;;;;;;;;;;;;1,0;;1,0;;;;;;;;;;2,0;;;;;;;;;;;;;;14,0;;;;;;;;;;1,0;;1,0;;;;;;;1,0;;;2,0;;;;;;;;;;;;;;;;;;;;;;;;;;;;;;;;;;1,0;;;;;;;;;
half;;;;;;226,0;;2,0;1,0;1,0;;;;;1,0;6,0;1,0;;;;;1,0;;1,0;;;5,0;;1,0;;;5,0;2,0;;5,0;;;;;;;;19,0;2,0;10,0;;9,0;;;6,0;;5,0;;2,0;3,0;;64,0;;3,0;;2,0;;1,0;;5,0;;12,0;1,0;8,0;12,0;13,0;;2,0;;;;1,0;;4,0;31,0;;2,0;;9,0;;;;;;16,0;167,0;;;6,0;4,0;;;;6,0;;;;15,0;;;;5,0;;3,0;;;3,0;;;;2,0;10,0;17,0;;2,0;;;;;;;;;;;;2,0;;;9,0;2,0;4,0;;6,0;5,0;2,0;;;;;;;3,0;;1,0;;;;;14,0;2,0;6,0;18,0;2,0;;1,0;2,0;101,0;2,0;;;1,0;320,0;;4,0;2,0;;;;4,0;;;;;;;7,0;;;;;;;;;;;;1,0;;2,0;;;;9,0;;;12,0;;;;;;;;;;;;;;;;9,0;;3,0;;12,0;;;;6,0;;5,0;;4,0;;15,0;;;;;4,0;;;4,0;4,0;;1,0;10,0;;;;18,0;;;;;1,0;;2,0;;7,0;;;;;;;;;2,0;;27,0;;;1,0;4,0;;;;;;2,0;22,0;;;1,0;11,0;;9,0;2,0;;;;;;;;1,0;;;;;;;;;4,0;1,0;;;;9,0;;;;;;;;;20,0;1,0;;;;1,0;;1,0;;;;;8,0;2,0;;;;;6,0;;;;;;;;;137,0;;1,0;4,0;;7,0;;;;;;2,0;;6,0;;;;;;;;;;1,0;60,0;;;1,0;;;;4,0;2,0;;6,0;;;;;;;2,0;;;;;;2,0;;;;2,0;;10,0;1,0;;;;;;;;1,0;;;4,0;;;;;;;;;;;;;;;4,0;;;1,0;;;;14,0;2,0;;;;;;11,0;;5,0;;2,0;;;;;;;6,0;6,0;;;;;1,0;;;;;;;;;;;;;;;;;;;1,0;;;;2,0;;;;;1,0;;;;;;;;;;;;;;;;;1,0;;;;;;;;2,0;;;;;;;;;;3,0;;;;;;;;;;;;;;;;;;2,0;;;;;;;;;;;;;;;;;;;1,0;;;;1,0;;;4,0;;2,0;;;10,0;;;;;;;;;;;;;;;;;;;;;;;;;;;;;;;3,0;;;;;;;6,0;;;;;;;;;;;;;;;;;;;;;6,0;;;;;;;;;;;;;;;;;;;;;;;;;10,0;;;;;;1,0;;;;10,0;;8,0;;;;269,0;;1,0;;;;;;;;;4,0;;;;;;;;;;;;;;;;;;;;;;;;;;;;;;3,0;;;;;5,0;;;;;;;;;;;;;;;;;;;;;;;;;;;;;;;;;;;;;;;;;;;;;;;;;;;;;;;;;;1,0;;;;;;;;111,0;;;;;;;;;1,0;;;;;;;;;;;;3,0;1,0;2,0;;;;;;;;2,0;;323,0;;;;;;;;1,0;;;;8,0;;;4,0;;;;1,0;;;;;;;;;;;;;;;;;;;;;;;;;;;;;;;;;;;;;;;;;;;;;;;;;;;;;;;;;;;4,0;;;;;;;;;;;;;;;;;;;;;;;;3,0;;3,0;;;;;;;;;;;;;;;;;;;;;;;;;;;;;;;;;;;;;2,0;;;;;;2,0;10,0;;;3,0;;;;;7,0;;;;;;4,0;;;;;;;;;;;;;;;;;;;;;;;;;
handle;;;;;;14,0;;12,0;2,0;10,0;;;10,0;;19,0;13,0;;;;;;1,0;;;;;;1,0;;3,0;2,0;1,0;10,0;;14,0;4,0;;;;;5,0;;11,0;;;;2,0;77,0;3,0;10,0;15,0;;;1,0;11,0;;12,0;27,0;1,0;;27,0;;;7,0;5,0;;2,0;4,0;10,0;2,0;3,0;2,0;1,0;;;2,0;;1,0;;14,0;1,0;22,0;;37,0;;;3,0;;12,0;4,0;7,0;;;6,0;;;;;10,0;1,0;3,0;3,0;13,0;3,0;3,0;3,0;;2,0;2,0;;2,0;3,0;;;;16,0;97,0;15,0;2,0;1,0;1,0;;2,0;1,0;3,0;6,0;;;;2,0;;2,0;29,0;1,0;;;4,0;;;;;;;5,0;1,0;;;7,0;5,0;;1,0;;;2,0;;;92,0;;;2,0;;5,0;14,0;;;;6,0;3,0;;;;;;;;4,0;62,0;6,0;;;;13,0;;;;;;6,0;;;;1,0;1,0;40,0;2,0;1,0;;;2,0;;;4,0;;13,0;;8,0;;;;;;;5,0;;;;;;4,0;7,0;12,0;;;8,0;;1,0;;;3,0;;62,0;1,0;;25,0;38,0;11,0;10,0;5,0;2,0;4,0;1,0;2,0;3,0;;;;;1,0;1,0;;6,0;;4,0;;;;5,0;;;;2,0;;5,0;7,0;;;11,0;;3,0;1,0;24,0;2,0;1,0;;;;;10,0;1,0;17,0;1,0;;;;;2,0;;;;1,0;17,0;11,0;;2,0;2,0;1,0;1,0;;;;1,0;14,0;63,0;4,0;;3,0;;;;;;2,0;;2,0;8,0;;;10,0;;27,0;;4,0;;18,0;1,0;;15,0;2,0;;2,0;6,0;3,0;3,0;;;;;51,0;7,0;;3,0;;1,0;2,0;7,0;3,0;13,0;1,0;;;;6,0;;;;13,0;10,0;;4,0;;;;;3,0;;3,0;;3,0;1,0;;1,0;23,0;;;;2,0;1,0;6,0;11,0;4,0;2,0;;;23,0;2,0;6,0;;;;117,0;;;4,0;;2,0;6,0;7,0;8,0;1,0;;;;4,0;5,0;;;;;1,0;;1,0;2,0;;;;;;;;;1,0;4,0;8,0;;;;;;;;;;;;2,0;;;;3,0;;;16,0;2,0;;;8,0;2,0;4,0;8,0;;;;;;;1,0;2,0;;;;;;;;;3,0;;63,0;;;;;1,0;;10,0;1,0;;;;1,0;5,0;8,0;;13,0;;;;;;;;;;1,0;;;;;10,0;;4,0;1,0;;3,0;;;;;;;2,0;;;;2,0;;1,0;;6,0;;;3,0;25,0;9,0;;5,0;;2,0;;;;;;6,0;;5,0;4,0;;;;;;1,0;;;;;2,0;2,0;;;1,0;;;;2,0;1,0;6,0;74,0;7,0;;;;;;2,0;1,0;3,0;;7,0;;;;;;5,0;;;;;;1,0;;;;;;;;;;;;1,0;1,0;;;5,0;1,0;1,0;14,0;;10,0;28,0;;2,0;;;5,0;;;;1,0;;2,0;;;;;1,0;;;3,0;;1,0;2,0;2,0;;3,0;;;;;3,0;;;;13,0;;;1,0;;;;;1,0;;68,0;;;;4,0;;4,0;4,0;8,0;;;;4,0;;;;;;;;;1,0;;4,0;10,0;;;;;2,0;16,0;1,0;;39,0;2,0;14,0;;10,0;4,0;;;;;;;;1,0;;;;2,0;;;;;14,0;;7,0;;2,0;;2,0;;7,0;;;4,0;;;;2,0;11,0;;;;;2,0;;;;;1,0;;;;;;;;8,0;1,0;3,0;3,0;;;;8,0;;;;;;;7,0;1,0;;;;1,0;;;2,0;;;;;;1,0;;;;;;;;;2,0;;;;;;1,0;;;;;;;;;;3,0;;;;;;;;;1,0;;;15,0;;;;;;1,0;;;;;;;;;;;;;;;;;2,0;;;;;;;;;;;;24,0;2,0;;;;;;;;;15,0;;;;;;;;;;;;;;2,0;;;;;;;;;;;;;;;;;;;2,0;;;;;;;1,0;;;;1,0;;;;;;;;;1,0;;;1,0;;;6,0;;16,0;4,0;;;;1,0;;;;2,0;;;2,0;;;12,0;;1,0;;;;;;;;1,0;;;24,0;;8,0;;1,0;;;;;;;;;;;;;;;;;3,0;1,0;;;;2,0;;;;;;;;;;;;;;;;;3,0;;;;;;;;;;;;;;;;;;;;;
hardware;;;;;;2,0;2,0;1,0;;;3,0;;;;;3,0;;;;;;17,0;;;;;1,0;4,0;;;5,0;;15,0;;9,0;1,0;;;;;16,0;;;;2,0;1,0;6,0;26,0;;6,0;;;;;19,0;;;;;1,0;;;;1,0;1,0;;;;7,0;;6,0;;2,0;1,0;;1,0;;;;29,0;;4,0;6,0;10,0;;7,0;;;;;6,0;;;;;52,0;5,0;;10,0;1,0;;;1,0;7,0;;12,0;;;3,0;2,0;;9,0;;;;2,0;2,0;1,0;6,0;;;;4,0;15,0;17,0;;;;2,0;;;;;1,0;2,0;;;2,0;;;;;;5,0;1,0;;;;29,0;;1,0;;51,0;1,0;;;37,0;;;;;6,0;16,0;;;;16,0;;;;;;;;11,0;;;1,0;;;;13,0;;;;;;;;;;;;;;;;;;;;;;;;;;;2,0;;;;;;1,0;;;;;;;;;;;;;;3,0;;;;;2,0;;;;;;;;;1,0;;;;;1,0;2,0;;;;;;;;5,0;1,0;;;;;;3,0;;;;;;;;;;;;;1,0;;;1,0;1,0;1,0;;;;;;;;;;;;;3,0;;;;;;;1,0;;;;;;1,0;;;;;;;;;;17,0;;5,0;;;;;;;;;;;;;;;;;;;;;;;;2,0;;;;2,0;1,0;1,0;;;;;;;;1,0;2,0;;;;;;;;;;;;;5,0;;;;;;;;1,0;;;;;;;;;;3,0;;1,0;;;;;;;;;;;;6,0;;;;;;17,0;3,0;1,0;;;23,0;;;;;;;;;;;1,0;;;;2,0;;3,0;6,0;;1,0;;;;1,0;;1,0;2,0;1,0;;;9,0;1,0;;2,0;;;;;3,0;1,0;;9,0;;;;1,0;;;1,0;;;;;;;;;;;3,0;;;;;;2,0;;;1,0;1,0;;;;;;;;;17,0;;;;;1,0;;18,0;;;;;;;;;;;;;;1,0;;;;;;;2,0;;3,0;;;;;;;;;4,0;;;;;;;;;;;;;;;;;1,0;;;;;;4,0;2,0;;;3,0;;;;;;;3,0;3,0;;1,0;;;;;;3,0;3,0;;;;;;;;;;3,0;;;;;;;;;;;;;;;;;;;;;;;;;;;;;;;1,0;;2,0;;;;;;;;;;1,0;;;;;2,0;;;;32,0;;;;;;;;;;;;;4,0;;;;;;;;;;;;;;;;;;;9,0;;;;;;;;;;;;;;;;2,0;;;1,0;;6,0;;;;;;;;;1,0;;;;;;;;;;;;;;;;;;;;;;;;;;;;;;;;;;;;;;;;;;;;;;;;;;;;;;;;;;1,0;;;;;14,0;;;;;;;;;;1,0;;;;;;;;;;;;;;;;1,0;;;;;;;;;;;;;;;;;;;;3,0;;;;;;;6,0;;;;;;1,0;;3,0;;;1,0;;;;;;;;;;;;;;2,0;;;1,0;;;;;;;;;;;;;;;;;1,0;;;;;;;1,0;;;1,0;;;;;6,0;;;;;;;;1,0;;;1,0;;;;;1,0;;;;;;;;;;1,0;;;;;;;;;;;;;;2,0;;;;;;;;;;;;;;;;;;;;;;;;;;;;;;;;;;;;;;;;;;;;;;;1,0;;;;;;;;1,0;;;;1,0;;2,0;;;;;;;;;;;;;;;;;;;;;;
held;;;;;;1,0;;5,0;4,0;1,0;1,0;;;;10,0;7,0;;1,0;;;;9,0;;;;1,0;;;;;;10,0;12,0;;9,0;2,0;5,0;23,0;;;11,0;;2,0;;7,0;5,0;7,0;32,0;10,0;4,0;2,0;6,0;14,0;;15,0;1,0;11,0;;;;;;4,0;;12,0;;5,0;7,0;15,0;6,0;3,0;;2,0;;;3,0;2,0;;;28,0;;18,0;;6,0;;;;;2,0;2,0;77,0;;;2,0;;;2,0;;4,0;2,0;;;7,0;12,0;;;17,0;1,0;15,0;;;20,0;;;;9,0;22,0;51,0;2,0;10,0;;;9,0;13,0;8,0;;;;;1,0;;;4,0;4,0;;1,0;2,0;4,0;3,0;;;;;9,0;4,0;;;15,0;22,0;1,0;;;5,0;3,0;3,0;4,0;9,0;;1,0;;1,0;3,0;88,0;;;;;1,0;;;;;2,0;3,0;3,0;;23,0;6,0;;;11,0;9,0;1,0;1,0;;13,0;;10,0;;;;;3,0;9,0;;15,0;;;1,0;12,0;1,0;2,0;7,0;9,0;;6,0;;;;5,0;;;;;;;2,0;;;5,0;7,0;;;;1,0;;;6,0;;;54,0;;10,0;10,0;12,0;4,0;1,0;9,0;;1,0;;5,0;1,0;;;;1,0;;19,0;2,0;4,0;;;2,0;1,0;1,0;3,0;;;;1,0;;5,0;6,0;;;2,0;1,0;7,0;;1,0;;6,0;4,0;;2,0;3,0;;9,0;7,0;15,0;;3,0;;;4,0;;;;4,0;2,0;;1,0;1,0;1,0;;;;;;1,0;10,0;2,0;;6,0;;10,0;;;;1,0;3,0;2,0;;2,0;;;5,0;;2,0;;;;;5,0;;;3,0;;;;1,0;1,0;;;;2,0;6,0;80,0;16,0;;;2,0;;;3,0;5,0;;3,0;;;;;4,0;;;1,0;4,0;9,0;;;;3,0;1,0;4,0;;;9,0;3,0;;1,0;15,0;;;;3,0;7,0;4,0;7,0;;4,0;;3,0;5,0;;;;;;3,0;;3,0;;;2,0;5,0;;3,0;;1,0;;;;3,0;;;;;2,0;9,0;;;;;;;1,0;;;;;2,0;;;;;;;;;;13,0;3,0;5,0;;;10,0;;5,0;;;;5,0;;;2,0;11,0;7,0;12,0;7,0;4,0;;;;;;;;;;;;;2,0;;;;;;;;;;;14,0;;;;25,0;;;1,0;;6,0;;18,0;;;;1,0;;;;;;;3,0;;2,0;;1,0;;1,0;;1,0;;;;1,0;;;1,0;;;;;;;1,0;;4,0;;1,0;;;;;;;;;;;;;;;5,0;;1,0;;5,0;;;;;;;;;;;;;6,0;1,0;;1,0;10,0;2,0;;1,0;;;3,0;1,0;2,0;2,0;;3,0;2,0;;2,0;;;;;4,0;;;;;;;1,0;1,0;;;3,0;;30,0;;;2,0;;;;;;;;;;;;1,0;;;;;;2,0;;1,0;;;;;;;;;;;;;3,0;1,0;5,0;;1,0;;;;;;;1,0;3,0;;;2,0;;;2,0;1,0;;;1,0;2,0;1,0;;;2,0;1,0;1,0;;;;;2,0;4,0;;;4,0;;4,0;;;;;;;;;;;;;;9,0;72,0;;;2,0;2,0;;;5,0;4,0;;;;;;;;;;;;;2,0;2,0;1,0;;;;1,0;2,0;6,0;1,0;;;;;;;8,0;;2,0;8,0;;;;;2,0;1,0;;2,0;;;;;;;1,0;;;;;;;2,0;;1,0;;;;;;;;4,0;;;;;;;1,0;;;2,0;;;;;;;3,0;1,0;;;3,0;;;;;;;;;;;;;;;;;;;;;;;;4,0;;;1,0;;;;;;1,0;11,0;;2,0;;;;;;;;;;1,0;;2,0;;1,0;1,0;;;;;1,0;;;;1,0;;;1,0;;;;;;;;;;;;;;;;;;;;2,0;;;;;1,0;2,0;;;;;;;;;1,0;2,0;;;;;;1,0;;;;;;;;;;;;;;;;;;;;;;;;;;;1,0;;;;;;3,0;;;;2,0;;1,0;4,0;;;;3,0;9,0;;;10,0;;;;;;;4,0;1,0;;;;;;;;;;;;;;;;;;;;8,0;;;;;;6,0;;;;;;;;;;;;;;;;;;;;;;;;;;;;;;;;;;;;1,0;;
intersect;;;;;;13,0;4,0;4,0;12,0;3,0;2,0;;4,0;;84,0;1,0;6,0;;;;7,0;1,0;;1,0;;;;;;;1,0;;4,0;;1,0;;;1,0;;;1,0;;12,0;3,0;3,0;;7,0;5,0;;8,0;2,0;3,0;;1,0;5,0;13,0;7,0;;7,0;;9,0;;12,0;;2,0;10,0;5,0;8,0;2,0;;3,0;3,0;3,0;;4,0;17,0;3,0;;;40,0;1,0;12,0;;7,0;;;;;2,0;;16,0;;;;2,0;;;;9,0;1,0;;;4,0;28,0;;;26,0;;4,0;;;;;;;17,0;15,0;19,0;;14,0;;;;3,0;1,0;;;;;1,0;;2,0;;;;;18,0;;6,0;;;;;5,0;2,0;;;6,0;6,0;1,0;1,0;;1,0;;2,0;;21,0;;6,0;1,0;2,0;;6,0;;;;1,0;13,0;2,0;;4,0;;;3,0;2,0;2,0;;1,0;;;;1,0;;;;;;;;1,0;;;;3,0;;;;;;3,0;;;;50,0;;;;;;6,0;;;1,0;;1,0;;;;;4,0;13,0;;3,0;;;5,0;2,0;2,0;3,0;;4,0;;4,0;;11,0;4,0;;2,0;;6,0;4,0;;;9,0;;;;;11,0;52,0;2,0;;;;;;2,0;;;;;;;3,0;;1,0;8,0;;;;;;1,0;;;5,0;;;4,0;15,0;;;;;;2,0;;;;;;4,0;;;2,0;;;;5,0;;1,0;1,0;3,0;1,0;3,0;;1,0;;2,0;7,0;;;2,0;;;;1,0;;;;;;1,0;;;;;;;;;;;;;;2,0;;;;;;;;;4,0;1,0;;5,0;3,0;2,0;;;;3,0;;1,0;76,0;;;;;2,0;;;;;;;;;1,0;;;;;;;1,0;21,0;;;2,0;3,0;;3,0;1,0;1,0;;3,0;;11,0;;;;2,0;;;3,0;2,0;;;;;;;;;;1,0;;;;;;;;;;;;1,0;;;;;;2,0;;;;;;;7,0;;6,0;20,0;;;;1,0;2,0;;;;;;;;1,0;1,0;;;;;;;1,0;2,0;2,0;;;;1,0;;;;;;;2,0;;;;;;;;;;2,0;;17,0;6,0;1,0;;;;;;;;;;;;;;;1,0;;;;;;16,0;;3,0;;;1,0;2,0;;;;;;;;;;;;;;;;;;;;;1,0;;;;2,0;;;;2,0;;;;2,0;;;;;;;;;;;;;;;;;;;;;1,0;;;;;;3,0;;;;;;;;2,0;;;;;;;;;;;1,0;;;;1,0;;;;;1,0;;;;;;;;;;;;;;;;;;;1,0;;;1,0;;;;17,0;;;;;;;;;;;2,0;;;;;2,0;;;;;;5,0;;;;;;;;;;;;;;;;;3,0;;10,0;;5,0;;;;;;4,0;;;;;;;1,0;;;5,0;;;;;;1,0;1,0;;;;3,0;;;;;;1,0;;;2,0;;;;2,0;;;;3,0;;;;;;;;;;;;;;;;;;;;;;;;;;;;;;;;;;4,0;;;;;;;;;;;;4,0;;;;;;;;2,0;;;;;;;;;;;;;;;;;;;;;;;;;;;1,0;;;;1,0;;;;;;;;;;;;;;;;3,0;;;;;;;;;;;;;;;;;7,0;14,0;;;1,0;;;;;;;1,0;;;;;;;;;;;;;;;;;;;;;;;2,0;;;;2,0;;;;;;;;;;1,0;;;;;;;;;;;;;;;;;;;7,0;;;;;5,0;;;2,0;;;;1,0;;;;;;;;;1,0;;;;;;;;;;;;;;;;3,0;;;;;;;;;;2,0;2,0;;;;;2,0;1,0;;;;;;;;;;2,0;;;;;;;;;;;;1,0;;;2,0;;;;;3,0;;;1,0;;;;;;;;;;1,0;;;;
intersection;;;;;;9,0;;8,0;15,0;;;;5,0;;6,0;30,0;2,0;;3,0;;27,0;1,0;;;;;;;;2,0;1,0;;21,0;;;;;;;;7,0;;13,0;8,0;31,0;2,0;20,0;3,0;;2,0;5,0;17,0;;;;7,0;9,0;1,0;24,0;;1,0;;;;;8,0;;10,0;3,0;;2,0;;5,0;;;7,0;7,0;;1,0;47,0;;3,0;2,0;12,0;1,0;;;;1,0;10,0;11,0;;;;;;;;15,0;;4,0;;;6,0;;;8,0;1,0;;4,0;7,0;2,0;;;;4,0;10,0;12,0;;4,0;;;;1,0;3,0;1,0;;;4,0;;;;9,0;;19,0;;13,0;;3,0;;14,0;;;1,0;14,0;;;9,0;;;1,0;;;;;;14,0;;;;1,0;;19,0;;1,0;;;2,0;;;;;;33,0;;;2,0;;;;;;;;;;;;;2,0;;;;13,0;;;;;;;;;9,0;4,0;;;;;;;;;;;;;;;1,0;2,0;7,0;;3,0;;;;1,0;;3,0;;13,0;;7,0;;;;;4,0;;3,0;;;;7,0;;;;;20,0;70,0;;;;;;;;1,0;;;;;;;;;;;;;;2,0;2,0;;;;;;4,0;15,0;;;1,0;;;1,0;;;;;;1,0;;;4,0;;;;2,0;;;;;;;;;;;2,0;;;;6,0;4,0;;;;;;;;;2,0;;;;;;;;;;;;;6,0;;;1,0;;;;3,0;;;4,0;;6,0;6,0;;2,0;;;;;;193,0;;;;6,0;;1,0;;;;4,0;;;2,0;;;;;;;;;;;;1,0;;;;;;;;2,0;4,0;;;;;;;;;;;;;;;;;;12,0;1,0;;;;3,0;;3,0;;;;;;;;;;;14,0;;;;;;15,0;28,0;;6,0;2,0;;;;11,0;1,0;;;;;;;;11,0;;;;;1,0;;;6,0;;;;;;;;;;;2,0;2,0;;;;;;2,0;;;;;2,0;;3,0;10,0;;;;;;;;;;2,0;;;;;;;;;;;;4,0;;;;4,0;;1,0;;;;;;;;2,0;;;1,0;;;;;;;;;;1,0;;;;1,0;;3,0;;;;1,0;;1,0;;;;;;;;;;;;;;;;;;;;;;;;;1,0;;;;;;;;;;;;;;;;;;;;;;;;;;;;;;2,0;;;;;;1,0;;;;;;;;;;;;;;;;;;;;24,0;;;;;;;;;;;;;;;;1,0;;;;;;;;;;;;;;;;;;;;;;1,0;3,0;;;;;;;;;;;;;;;;;;;;;;;;;;6,0;;;1,0;;;;;;;;;;;;;;;;;;;8,0;;;;;;;;;;;;;;;;7,0;;;;;;;;;;;;;;;;;;;;3,0;;;;;;;;;;;;;;;;;;16,0;;;;;;49,0;;;;14,0;1,0;2,0;;;;;;;;;;;;;;;;;;;;;1,0;;;;;;;;;;;;;;;;;;;;;;2,0;;;;;;;;;1,0;;;;;;;;;;;1,0;;;;;;;;;;;1,0;;;;;;;;2,0;;;;5,0;;;;15,0;;;;;;;;;;;1,0;;;;;;;;;;;5,0;;;;;;;;;;;;13,0;1,0;;;;1,0;;;;;;;;;;;;;;;;;;;;;1,0;;;;1,0;1,0;;;;;;;;;;;;;;;;;4,0;2,0;;;;;;;;;;3,0;;1,0;;;;;;;;;;10,0;9,0;;;;;15,0;;;;;2,0;;;;3,0;;;;;;;;;;
join;;;;;;2,0;;1,0;3,0;2,0;1,0;;;;6,0;7,0;;;;;;;;;;;;2,0;;;;;8,0;;;;;3,0;;;;;;;;;;8,0;;;;;;;1,0;4,0;21,0;;;;3,0;;;;;1,0;;14,0;2,0;13,0;;;3,0;;;;;;;19,0;;1,0;;7,0;;1,0;;;1,0;1,0;27,0;;;;;;;;1,0;;;;6,0;3,0;;;1,0;;;;4,0;;;;;12,0;34,0;1,0;2,0;;;2,0;;1,0;;;;;;;;;;2,0;;;;;;;;;;4,0;;2,0;;27,0;5,0;;;1,0;;;11,0;1,0;;;;;;;8,0;;;;1,0;2,0;;;2,0;;10,0;2,0;;2,0;6,0;2,0;;;;20,0;5,0;;;;;2,0;3,0;;;;;7,0;;4,0;;4,0;;4,0;;;;21,0;;6,0;;;;42,0;1,0;;8,0;;;;;5,0;1,0;1,0;20,0;;5,0;1,0;;;13,0;;5,0;2,0;34,0;;2,0;7,0;2,0;;;1,0;;5,0;;;;1,0;;;;;;1,0;6,0;;1,0;;;;;;;;;7,0;2,0;;2,0;;8,0;2,0;1,0;;;2,0;;;;;;6,0;21,0;36,0;;;2,0;3,0;1,0;;;;;;4,0;3,0;12,0;;14,0;3,0;;;3,0;;8,0;;;2,0;1,0;;;1,0;5,0;;;2,0;;;1,0;;;1,0;;1,0;;;;1,0;9,0;;;;;;2,0;;;;;;1,0;;;6,0;;;;;;1,0;;;13,0;;;;;;;;1,0;4,0;;;;2,0;;;;4,0;;14,0;;;;;;;;;3,0;;;1,0;2,0;;2,0;;;;;;;3,0;1,0;;;;3,0;1,0;;2,0;;;;;;;;;;;;;;;;;;;;;;;;;;;;;;;;;;;;;;;;;4,0;;;;1,0;;;;;;;;;;;;;;;;;;3,0;;;;;;;;;;;;;;1,0;;;;;;;;;;;;;;;;;;;;;;;;;;2,0;;;;;;1,0;;;;;;;;;;;;;;;;;;;;;3,0;;;;;4,0;3,0;;;;;;;;9,0;;1,0;;;;;;;;;3,0;;;;;;3,0;;;;;2,0;1,0;;1,0;;;;1,0;;;;;1,0;;;;;;;;;;;;;;;;;;1,0;;2,0;;;2,0;;2,0;;;;;;;;;;;;11,0;;;;;;;;;;1,0;;;;;;;;;;;2,0;;;;;;;;;;;;;;2,0;;;;;;;;2,0;;;;;;;;;15,0;4,0;;2,0;;;;3,0;;;;;;;;2,0;1,0;;;3,0;;;;1,0;;;;;;;;;;;;;;;;;;;;;;;;;;3,0;;4,0;;;;;;;;;;;3,0;;;1,0;;;;;;;;;2,0;;;;;;2,0;5,0;;10,0;5,0;;;;1,0;2,0;1,0;;2,0;;;;;;;;;;;;2,0;;;;;;;;;;;1,0;;;;;;;;;;;;;;;;;;;;;;;;;;;;1,0;;;;;;;1,0;;;;;;;;;;;;;;;;;;;;;;;;;;;;;;;;;;;;;;;;;;;;;;;;;;;;;;11,0;;;;;4,0;;;;;;1,0;;;;;;;;;;;;;;;;;;;;;;;;;;;;1,0;;;1,0;;;;;;;;;;;;;;;;;;;;;;;;;;;;;;;;;;;1,0;;;;;;;;2,0;;;;;;;;;;;;;;;2,0;;;;;;;;;;;;;;;;;;;;;;;;;;;;;;;
lamp;;;;;;2,0;;4,0;12,0;;6,0;;;;4,0;4,0;2,0;;;;;2,0;;;;;12,0;3,0;;;;;4,0;;23,0;10,0;;;;;;;;;15,0;;;11,0;;9,0;3,0;1,0;;;;1,0;;;1,0;;;;;;;;;;;1,0;;;1,0;;;3,0;2,0;8,0;1,0;3,0;;;;9,0;;5,0;;;;;3,0;;;;;1,0;1,0;;6,0;1,0;;;10,0;4,0;;;4,0;;1,0;;;;;2,0;;7,0;5,0;5,0;16,0;;;;;;2,0;;;;1,0;;;;5,0;;;;9,0;;;;3,0;;;5,0;;;1,0;3,0;83,0;;;;;;1,0;6,0;12,0;;;1,0;;;3,0;;;;3,0;3,0;;;;;;;2,0;1,0;5,0;;2,0;;;1,0;;;;4,0;;;;;;;;6,0;;;;;1,0;7,0;;;;;;;;1,0;1,0;2,0;;;;;;12,0;;2,0;2,0;;10,0;;;;;;;;49,0;;;;;8,0;2,0;;;;;1,0;;;3,0;;;;;;1,0;;3,0;;;;;;;;;;;;2,0;1,0;;;5,0;;;;;6,0;;;1,0;;;;9,0;3,0;;;;;;2,0;;;;1,0;26,0;1,0;;;;;;;1,0;;;;2,0;;;;;;;;;;;;1,0;;;;;3,0;;;;;;;4,0;;;;;;;;;3,0;;;3,0;;2,0;;;;;;;3,0;;;;;;2,0;;;;;4,0;;;;;;;;;12,0;;;;;;;;;;;;3,0;;;;;;;;;;8,0;6,0;;;;;;;;;1,0;;;;;;;;;3,0;;2,0;;2,0;;;;;;;;;;;;;;;;;;;;11,0;;;;;;;;19,0;;;;;14,0;;;;;;;;;;;4,0;;;;;;;3,0;;;1,0;;;;;;;;;;;;;;6,0;1,0;;4,0;;;;;;;2,0;;;;;;1,0;;;;;;1,0;6,0;;;;;1,0;;;;;;;;;;;;;;2,0;;;;;;;;;;;;;1,0;;;;;;;;;;;4,0;;;;;2,0;;;;;;;;;;2,0;;;;;;2,0;;;;;;;;2,0;;;;;;;;1,0;18,0;3,0;;;;;;;;;;;;;;;;;;;1,0;;;;;;;;;;;;;;;;;;;;2,0;;15,0;;;;;;;1,0;;;;;;;;;;;;;;;;;;;;1,0;1,0;;;;;;;;;;;1,0;;;;;;;;;2,0;;;;;;;;6,0;;;;;;;;;;;;;;;;;;;;;;;;;;;;;;;2,0;;20,0;;;;;;;;;;;;;;;;;1,0;;4,0;;;;;;;;;;;;;;;3,0;;3,0;;;;;;;;;;;;;;;;;;;;;;;;;;;;;;;;;;;;;;;;;;1,0;;;;;;;;;;;;;;;;;;;;1,0;;;;2,0;;;;;3,0;;;;;;;;1,0;;;;;;;;;;1,0;;;2,0;;;;;;;;;;;;;;;1,0;;;;;;;;;;;;;;;3,0;;;;;;1,0;1,0;;;;;;;;;;;1,0;;;3,0;;;;3,0;;;;;;;;;1,0;;;;;18,0;;1,0;;;;;;;;;4,0;;;;;;;;;;;1,0;;;;;;;;;;;;;;;;;2,0;;;;;;;;;;;;;;;;;;;;;;;;;;;;;;;;;;;;;;11,0;;;;;;;;;;
landmark;;;;;;12,0;;1,0;;;;;2,0;;;;;;;6,0;;33,0;2,0;;;;4,0;;;;;8,0;;;1,0;1,0;;;1,0;4,0;34,0;;6,0;;16,0;;;;7,0;4,0;;14,0;;;;4,0;2,0;;14,0;;;;;;2,0;2,0;;4,0;;;;;2,0;;;;7,0;;;16,0;;;;16,0;;;;;;2,0;;;;;4,0;2,0;;;22,0;;;;;6,0;;;2,0;;31,0;;;2,0;;;;20,0;;23,0;;;;;4,0;;1,0;;;;;6,0;;;;;2,0;;1,0;;;;;;;;;;;;;;;;2,0;13,0;;;3,0;;;;;;3,0;;;;;4,0;;;;;;;;;1,0;;;;;;;;;;;;;;;;;;;;;;;;;;;6,0;;;;;;4,0;;;;;;;;;;;;;;;;;;;;;;;;;;;;;;;;;;;;;;;;;;;;;;;2,0;;;;;;;12,0;;;;;;;;;;;;;4,0;;;;;;;;;;;;;;2,0;2,0;;;;;;;;;;2,0;;;;;;;;;;;;;;;;;;;;;;;;;;;;;;;;;;;;;;;;;;4,0;;;;;;;;;;;;;11,0;;;;;;;;;;;;;;;;;;;;;;;;;;;;;;;;;;2,0;;;;;;;;;;;;;2,0;;;;;;6,0;;;1,0;;;;;;;9,0;;;;;;;;37,0;;;;2,0;;;9,0;;;;;;;;;5,0;;;;;;;;;;;;;;;;18,0;;;;;;;;;;2,0;;;;7,0;1,0;;;;;;;;;;132,0;;;2,0;1,0;;;;;2,0;;;;;;;;;;;;;;;;1,0;;;;;;;;;;;;;;;5,0;26,0;;;;;;;;;;;;;;;;;;10,0;;2,0;;;;;;;;;;;;;;;;;;25,0;;3,0;;;;;;55,0;;;;;;;;;;;;;;;;;;;1,0;;;3,0;;;;;;;17,0;;;;;;;;;;;;;;;;;;;;;5,0;;5,0;15,0;;;9,0;;;;;;;6,0;;;;;;;;;;;;;;;;;3,0;;;;;;;;;;;;;;;1,0;;;;;;;2,0;;;;;;;;;;;;2,0;;;;1,0;;;;;;;;;;;;;;;;;;24,0;;;;;;;;;;;;;;;;;;;;;;;;;;;;;;;;;;;;;;;;;;;;;;;;;;;;;;;;;;;;;;;;;;2,0;;;;;;;;;;;;;;;;;;;;;;;;;1,0;;;;;;;;;;;;;;;;;;2,0;;;;;;;;;;;;3,0;;;;;;;;;;;;;;;;;;;;;;;;;7,0;;;;;;;;;;;;2,0;;;;;;;;;;;;;;;;;;;;;;;;;;;;;;;;;;;;;;;;;;;;;;;;;;;;;;;;;;13,0;;;;;;;;;;;;;4,0;;;;;;;;;;;;;;;;;;;;;;;;;;;;;;;;;;;;;;3,0;;;;;;;;;;;;;;;;;;;;;;;;;
lane;;;;;;1,0;;2,0;3,0;;;;;;2,0;6,0;1,0;;;;;6,0;;;;;;2,0;;;;;2,0;;7,0;;;;;;3,0;;;;16,0;14,0;9,0;3,0;;;;;;;;22,0;;;3,0;;1,0;;3,0;;;;;;;;1,0;;6,0;;;1,0;;;;23,0;;;;10,0;;;;;;;;;;;;;;;16,0;;9,0;;8,0;2,0;;;1,0;;;;;5,0;;;;1,0;;14,0;;1,0;;;;1,0;4,0;;;;;;;;1,0;;1,0;1,0;;;2,0;;;;;;;;;;1,0;;;;;;;;6,0;;;;;1,0;1,0;;;;;1,0;;;;;;;1,0;;;;;;;;;;;;;;;;;;;;;;;;;;;;;9,0;;;;;;;;;;;;;;;;;;;;;;;;;6,0;;;;;;;;;;;;;;;;;;;4,0;;;;;;;;;;;;;;;;2,0;;;12,0;;;;;;;;;;;2,0;;;;;;;;;;;;;40,0;;;;;;;;;;;;;;;;;;;1,0;;;;;;;;;;;;;;;3,0;;;;;;;;;;;;;2,0;2,0;;;;;;;;;2,0;;;;1,0;;;;;;;;1,0;;;;;;;;1,0;;;;;;2,0;;;;;;;;;;;;;;;;;;;;;;;;7,0;;;;;;;;;;;;6,0;1,0;;;;;;;;;;;5,0;;4,0;;;;;;;;;;;;;;;;;2,0;;;;;;;;8,0;;;;4,0;;;1,0;;;;;4,0;;;;;;;1,0;;;;;;3,0;;;2,0;;;;;;;7,0;;;;;;;;;;;;9,0;;;1,0;43,0;;;;2,0;;2,0;;;;;;;;;;;;;;;;;;;;;;;;;;;;;;;;;;;;;;;;;;;;;;;;;;;;;;;;;;;;;;;;;;;;;;;;;;;1,0;;;;;;;;;;;;;;1,0;;;;6,0;;3,0;;2,0;;;1,0;;;;;;;;;;;;;;;;;;;;;;;;;;;;;;;;;;;;;;;;;;;;;;;;;;;;;;;;;;2,0;;;;;;;3,0;;;;;;;;;;;;2,0;;;1,0;;;;;;2,0;;;;;;;;;;;;;;;;;;;;;;;;;;;;;;;;;1,0;;;;;;;;;;;;;;;;;;;;;;;;;;;;;;;;;;;;;;;;;4,0;;;;;;;;;;;;;;;;;;;;;;;;;;;;;;;;;;;2,0;;;;;;;;;;;;;;;;;;;3,0;;;;;;;;;;;;;;1,0;;;;;;;;;3,0;;;;;;;;;;;;;;;;;;;;;;;;;;;;;;2,0;;;;;;;;;;;;;;;;;;;;;;;;;;;;;;;;;;;;;;;;;;;;1,0;;;;;;;;;;;;;;;;;;;;;;;;;;;;;;;;;;;1,0;;;;;;;;;;;;;1,0;;;;;;;;;;;;;;;5,0;;;;;;;6,0;;;14,0;;;;;;;;;;3,0
laser;;;;;;11,0;;10,0;2,0;7,0;13,0;;1,0;;41,0;15,0;70,0;;;;1,0;9,0;;1,0;;;;;;;4,0;1,0;23,0;;4,0;21,0;;;;;13,0;;7,0;7,0;3,0;3,0;11,0;47,0;23,0;17,0;3,0;47,0;;4,0;12,0;1,0;26,0;;;1,0;;1,0;9,0;;2,0;;;;2,0;2,0;4,0;;31,0;;;7,0;;15,0;13,0;38,0;;2,0;;27,0;;1,0;;;;;43,0;;;1,0;29,0;;;;28,0;;3,0;;5,0;9,0;;1,0;110,0;;47,0;2,0;;;;;;14,0;27,0;20,0;12,0;4,0;;;3,0;3,0;4,0;;;;6,0;12,0;;4,0;3,0;1,0;;;1,0;6,0;15,0;;5,0;;3,0;18,0;1,0;;;2,0;13,0;;;;1,0;1,0;1,0;;107,0;;;;1,0;3,0;7,0;;5,0;;10,0;8,0;6,0;8,0;1,0;;;2,0;;1,0;12,0;;;;;2,0;;1,0;;4,0;;2,0;;;;;;4,0;;1,0;;;1,0;3,0;;;;11,0;4,0;;;;;7,0;4,0;;1,0;;7,0;;;;;;3,0;3,0;;;4,0;4,0;2,0;;88,0;;2,0;1,0;7,0;7,0;;;;1,0;;;9,0;;;8,0;1,0;1,0;;;2,0;4,0;;;;;;43,0;9,0;22,0;;2,0;;;1,0;7,0;6,0;;8,0;;;;;50,0;9,0;;;;;8,0;;12,0;14,0;;;;26,0;14,0;;;;2,0;3,0;1,0;;;;;;;;;4,0;;3,0;;;1,0;;;;;2,0;;;;;;;;;21,0;;;4,0;3,0;;8,0;;;;;;1,0;;;;8,0;;3,0;;;;;;1,0;;;;12,0;;15,0;;4,0;;;;;;13,0;;;9,0;15,0;;;;;;;;8,0;6,0;;1,0;;;1,0;3,0;1,0;3,0;2,0;2,0;;;;;;;;;3,0;2,0;36,0;;;;6,0;1,0;;;2,0;;;;6,0;1,0;;;3,0;;9,0;;;2,0;;;7,0;4,0;;;2,0;;;35,0;;;;;10,0;;;;;;;5,0;;;26,0;1,0;2,0;7,0;;;;;;2,0;;7,0;;;;;;3,0;1,0;6,0;;2,0;;12,0;;;3,0;;;;13,0;;4,0;;;1,0;;;2,0;;;;;;9,0;;;14,0;1,0;;;;2,0;;2,0;;;1,0;2,0;;3,0;;;3,0;;;;;;12,0;79,0;;;1,0;3,0;4,0;;;1,0;1,0;;;;;;;2,0;;;;;;;;;2,0;;;;5,0;1,0;10,0;;;;;;;6,0;;;;;;;;2,0;;2,0;;;;;;;1,0;;;2,0;;1,0;;;2,0;;17,0;;;;;;;;;;;;76,0;23,0;;;;;;;;;;;;;;;2,0;;27,0;;;;;;2,0;;;1,0;;;;;9,0;;;;;;;1,0;;;;;;;;;;2,0;;;;;;;;12,0;;2,0;;;;1,0;;;3,0;;;;;1,0;;;;;;;;2,0;;;2,0;10,0;;;4,0;;4,0;;;;;1,0;;;;;2,0;;;1,0;7,0;;;2,0;;;;;;;1,0;;;;;2,0;;1,0;;;;;;;;4,0;;;;;;;1,0;;;6,0;;;1,0;;;;2,0;;;;;;31,0;4,0;;2,0;;;;;1,0;;;;;;;;;;46,0;;;1,0;;;;;;;;;;;;;;;;;;;;;;;;;;;2,0;;;;19,0;;;;;;;3,0;;;;;4,0;;;;;;;;;;;;5,0;;;;;;;;;;;;;;;;;;;;;5,0;;;;17,0;;;;;;;8,0;;;;;;;;;;;;;;;;;;;;;;;;;;;;;;;;1,0;;;;;1,0;;;;;;;;6,0;2,0;6,0;;;;;62,0;5,0;;;1,0;40,0;1,0;;;;;;;;;;2,0;5,0;;;;1,0;;9,0;;;;;2,0;;;;6,0;;;;;;;;;;;;;1,0;;;;;;;;3,0;;3,0;;;;3,0;;;;;;;;;;;;;;;1,0;;;;;;;;;1,0;;;;;;;;;;;;1,0;;;;3,0;;;;;;
link;;;;;;2,0;;8,0;;25,0;1,0;;4,0;;24,0;16,0;11,0;;;;1,0;4,0;4,0;1,0;;;;3,0;;2,0;3,0;;10,0;;32,0;12,0;1,0;5,0;2,0;;41,0;;2,0;;2,0;;4,0;44,0;;3,0;3,0;2,0;;;25,0;;12,0;1,0;;;17,0;;;5,0;3,0;1,0;23,0;10,0;20,0;4,0;;3,0;11,0;;;19,0;;;;31,0;;9,0;;62,0;;4,0;;;;15,0;32,0;3,0;;1,0;1,0;;;1,0;24,0;11,0;2,0;;22,0;17,0;;6,0;15,0;2,0;26,0;;;;;;;10,0;26,0;27,0;9,0;;;;1,0;1,0;4,0;1,0;;;;;;;8,0;;;;1,0;1,0;;;5,0;;4,0;7,0;;;;12,0;9,0;3,0;;;2,0;7,0;;7,0;24,0;;2,0;2,0;;11,0;47,0;;;;34,0;2,0;;;18,0;;;10,0;7,0;;19,0;2,0;;5,0;;13,0;;;;;;5,0;;10,0;;;;68,0;;7,0;2,0;;1,0;2,0;;;;13,0;;1,0;22,0;;;;2,0;2,0;10,0;;;;1,0;;;2,0;1,0;;7,0;1,0;;;;16,0;8,0;;74,0;;;18,0;24,0;11,0;;8,0;;6,0;;;;6,0;1,0;;;;;1,0;18,0;;;1,0;;;30,0;;;;;;;18,0;;;3,0;;;;4,0;4,0;4,0;;;21,0;2,0;;19,0;9,0;5,0;;1,0;2,0;;3,0;;;;;5,0;3,0;;;2,0;;1,0;;27,0;6,0;1,0;6,0;8,0;;2,0;;2,0;5,0;2,0;;11,0;;;;;4,0;2,0;7,0;;62,0;2,0;;;7,0;3,0;;5,0;2,0;;2,0;13,0;3,0;2,0;;;2,0;;10,0;3,0;8,0;;;;;;;1,0;44,0;9,0;;1,0;;;;5,0;9,0;15,0;7,0;3,0;1,0;;;7,0;;;4,0;2,0;;1,0;;;;;3,0;;;9,0;13,0;19,0;8,0;;;;12,0;;2,0;;;;24,0;1,0;6,0;;1,0;;3,0;21,0;;2,0;;;;3,0;5,0;;;;;;;1,0;3,0;;;4,0;;1,0;;;;;;3,0;3,0;;;;;;;;23,0;;4,0;;;;;;;2,0;;11,0;;12,0;3,0;9,0;4,0;1,0;;;;;;1,0;9,0;5,0;;1,0;;;5,0;;1,0;;;2,0;1,0;;2,0;;;2,0;;6,0;;;;;;3,0;;;6,0;6,0;;;;;3,0;;1,0;4,0;3,0;;1,0;1,0;;2,0;;31,0;;2,0;3,0;;;;;5,0;;;;4,0;4,0;;;2,0;;;;;;;2,0;;;6,0;10,0;;;;;;4,0;1,0;;6,0;;;;4,0;;;;;4,0;;;;2,0;6,0;;1,0;;32,0;1,0;;;;1,0;;6,0;8,0;1,0;;2,0;3,0;49,0;12,0;;;2,0;4,0;;2,0;;;1,0;;;;;;;9,0;1,0;;;3,0;;;;;4,0;6,0;;;;;;28,0;;3,0;8,0;;12,0;;;;;;4,0;1,0;;32,0;;1,0;;;;;1,0;;;;;;;;;;2,0;;;;1,0;;;;7,0;;4,0;;;2,0;;;5,0;;1,0;;68,0;1,0;1,0;7,0;;;1,0;;6,0;;;;;;1,0;;;1,0;;7,0;1,0;;;;;;;;;;;2,0;5,0;;;;;;;;;2,0;;8,0;;;;;;;;6,0;;44,0;22,0;;;2,0;;;;;6,0;;;3,0;22,0;3,0;;;10,0;;;;;;2,0;4,0;1,0;2,0;;;;;4,0;;;3,0;3,0;1,0;2,0;;4,0;;;;;;;;;;;;;;1,0;;;;;;;;;;2,0;;;;;4,0;;;;;4,0;2,0;;;;;;1,0;;2,0;;;9,0;;;;;;;;;2,0;;;;;;;;;;;3,0;;;;;;7,0;;;;;;;5,0;;;;;;;;;;;;;;;;1,0;;;;;;;;;;;;;;;;1,0;;;;;;1,0;;;;;;4,0;2,0;;;;;;2,0;;11,0;;;;7,0;4,0;;;5,0;1,0;;;;;;;;;;;;;;2,0;8,0;;;;2,0;;1,0;;;;;;1,0;;1,0;;;5,0;;;;;;1,0;3,0;;;11,0;;;;;;;;2,0;1,0;;7,0;;;;;;;;1,0;;;;;;;;;;;;1,0;;;;;;;;;;;;;15,0;3,0;;;;;;;;;;;;;;;;;;;;;;;;;;;;
linkage;;;;;;1,0;;4,0;;;;;;;4,0;;;;;;;;;;;;;;;;;;7,0;;1,0;1,0;;;;;;;1,0;;;;;25,0;;4,0;5,0;2,0;;;2,0;6,0;;;;;10,0;;;;;;;;;;;;;;;13,0;;;;2,0;;;;13,0;;;;;;6,0;22,0;;;;;;;;1,0;;;;2,0;;;;2,0;;;;;;;;;;;2,0;;;;;;;;;;;;;;;1,0;;;;;;;;;;;3,0;;;;1,0;;;;;;;;;3,0;;4,0;5,0;;;2,0;;;;;;;;;;;;;;3,0;;;;;8,0;;;;;;;;;;1,0;;43,0;;2,0;;;;;;1,0;;1,0;;;;;;;;;6,0;;;;;;;1,0;4,0;;;;;;;4,0;4,0;;1,0;;4,0;26,0;;3,0;3,0;2,0;6,0;;10,0;;13,0;;;;;;;;;;1,0;;1,0;;;;;;;;;;;;;;;;1,0;;;;;;;;;2,0;;;;;;;;;;;3,0;1,0;;;;;;;;;;1,0;8,0;;;;;;;;;;;;3,0;;;;;;;;;5,0;6,0;;;;;;;;;;;;;4,0;;1,0;;;;;;1,0;;2,0;1,0;;;1,0;;;;;4,0;;;;;;;;;;;;;;;;;;;;;;17,0;2,0;;;;1,0;;2,0;;;;1,0;;;;;;;;;;;;;;;;;;;;;;;;;;;;;;;;;;;;;;1,0;;;;;2,0;;;;;;1,0;;;;;;;;;;1,0;;;;;;;;;;;;;;;;;;;2,0;;;;;1,0;;;;;;;;;1,0;;1,0;;;;;;;;;;;;1,0;;;;;1,0;;;;;;;;;;;;;;;;;;;;;;;1,0;;;;1,0;;;;;;5,0;;;;;;;;13,0;1,0;;;;;;;;;;;;;1,0;;;;2,0;;;;;;;;;;;;;;;;;;;;;;;;;;;;;6,0;;;;;;;;;;;;3,0;;;;;;;;;;1,0;;8,0;;;;;;;;;;;;;;;;;;;;;;;;5,0;1,0;;;;;;;;;;;;;;;;;1,0;4,0;;;1,0;1,0;;;;;;;;3,0;;;;;;;;;;;;;;;4,0;27,0;;1,0;;4,0;;;;;;;;;2,0;;;;;1,0;;;25,0;;;;;2,0;;;;;;;;;;;;;;;;1,0;;;;;;;;;;;;;;;;;;;;;;;;;;;;;;;;;;;;;;;;;;;;;;;;;;;;;;;;;;;;;;;;;;;;;;;;;;;;;;;;;;25,0;;;;;;;;;;;;;;;;;;;;;;;;;;;;;2,0;;;;;;3,0;;;;;;;;;;;;;;;;;;;;;;;;;;;;;;;;;5,0;;;;8,0;;;;;;;;;;;;;2,0;;;;;;;;;;1,0;;;;;;;;;;;;;;;;;;;;;1,0;;;;;;;;;;;;;;3,0;;;;;;;;;;;;;;;;;;;;;;;;;;;;;;;;;;;;;;;;;;;;;;;;;;;;;;;;;;;;;;
magnet;;;;;;8,0;1,0;45,0;4,0;104,0;6,0;;5,0;7,0;61,0;41,0;;6,0;;;;10,0;;;;;;1,0;1,0;;;;26,0;;23,0;2,0;3,0;39,0;1,0;;;;19,0;;26,0;13,0;;33,0;;;89,0;7,0;;;218,0;1,0;8,0;;;;9,0;3,0;72,0;;8,0;1,0;10,0;49,0;23,0;1,0;3,0;;64,0;;;18,0;;;;37,0;;5,0;2,0;106,0;;;;;6,0;1,0;114,0;;;13,0;;;;;18,0;;;;85,0;2,0;;2,0;45,0;1,0;1,0;;7,0;1,0;3,0;;;66,0;109,0;85,0;;17,0;1,0;;;;;;;;;1,0;;17,0;22,0;;;;31,0;16,0;;;;;;37,0;;;1,0;111,0;3,0;3,0;;;;;;3,0;19,0;;55,0;3,0;;;86,0;;1,0;;;2,0;;;2,0;;7,0;30,0;;10,0;45,0;42,0;5,0;;2,0;38,0;;10,0;3,0;9,0;;1,0;18,0;1,0;;1,0;3,0;22,0;2,0;13,0;;;41,0;24,0;4,0;3,0;;63,0;1,0;2,0;5,0;;;174,0;;;76,0;;;;8,0;1,0;;31,0;58,0;;34,0;;;5,0;;9,0;14,0;;151,0;1,0;;85,0;113,0;43,0;8,0;4,0;71,0;31,0;1,0;5,0;4,0;12,0;;;;;;13,0;26,0;;3,0;;;;53,0;;;;;;3,0;6,0;;15,0;26,0;3,0;42,0;;;2,0;6,0;4,0;;9,0;;2,0;1,0;40,0;2,0;;13,0;;11,0;7,0;;;;1,0;;;6,0;;18,0;;;;2,0;;75,0;;69,0;36,0;6,0;4,0;;11,0;5,0;12,0;;7,0;;31,0;2,0;2,0;;3,0;4,0;33,0;3,0;;2,0;1,0;136,0;;8,0;;;;1,0;8,0;;;;;;12,0;17,0;28,0;4,0;;6,0;2,0;1,0;;1,0;12,0;5,0;;17,0;9,0;;;5,0;6,0;;4,0;9,0;3,0;;1,0;;1,0;2,0;;;4,0;4,0;;;7,0;;;3,0;;13,0;1,0;113,0;50,0;;;18,0;2,0;;;17,0;;;54,0;11,0;;;8,0;1,0;;;;;;;;;1,0;;1,0;;;;9,0;7,0;;;;;;2,0;;;;;;5,0;;;;;;;;;;;13,0;6,0;;;;;;;4,0;49,0;;;11,0;1,0;;;;1,0;;;;;;;;3,0;;;;;1,0;1,0;5,0;;;;;;;1,0;;2,0;;;;1,0;;1,0;18,0;;20,0;;;;;;2,0;;;;;;;;;;;12,0;;;;;;2,0;;;;;;;;;;;;1,0;2,0;;2,0;;2,0;;;;;;;;;1,0;7,0;;1,0;;4,0;;4,0;;;;;;8,0;;;;;;;1,0;;;1,0;;;2,0;;;;;;4,0;;;;;;;;;2,0;;3,0;2,0;2,0;;;;4,0;;;;;;;;;;;;8,0;13,0;;;;;;21,0;;;;;4,0;2,0;;;;1,0;;3,0;;;;;;;;;;;;;;;;;;;;;;;;64,0;2,0;;;;;;;;;2,0;;;8,0;;;;1,0;2,0;2,0;;;1,0;;;;;5,0;;9,0;;8,0;;5,0;2,0;;;;4,0;;;;1,0;;;;;2,0;14,0;;;2,0;3,0;;2,0;;12,0;;;;4,0;;1,0;5,0;;;;;2,0;2,0;5,0;;7,0;;;;;52,0;;;;;21,0;7,0;;1,0;;5,0;;285,0;;;5,0;;;;;;;;;2,0;2,0;5,0;;;;;6,0;1,0;5,0;2,0;;;;1,0;1,0;;;12,0;;;4,0;;;;;;;;;;;;;;;;;5,0;;2,0;;;;;;;;;;;;1,0;;;;;;;;;4,0;7,0;;;2,0;;;2,0;;1,0;;;;;;;;;;5,0;;;;;;;;;;;;;;;;;2,0;;;5,0;2,0;;;;;;3,0;;1,0;;;;;;;;1,0;;;;;;;2,0;;;2,0;;;;;10,0;;;;;;5,0;;3,0;;2,0;7,0;;;;;;9,0;;;;3,0;;1,0;;;;;;;;;;;;;13,0;241,0;118,0;;7,0;;1,0;8,0;9,0;;;5,0;2,0;;2,0;;26,0;7,0;;61,0;;;;;;;;;;26,0;;;;;;;;;;;;;;;7,0;1,0;;;2,0;;;;;;;1,0;;;;;;;;;;;;;;;;;;2,0;;;;;;;;;;;;;;;;;;;;;
magnitude;;;;;;20,0;;2,0;4,0;;;;;;;16,0;1,0;;;;;;;;2,0;;2,0;;;;;;2,0;1,0;5,0;7,0;;;;6,0;;;3,0;10,0;30,0;;22,0;21,0;2,0;2,0;;6,0;;10,0;;;;;1,0;;;;16,0;;;;2,0;;9,0;;7,0;;1,0;;;2,0;2,0;;;6,0;;11,0;;5,0;2,0;;;;;6,0;15,0;;;;2,0;;1,0;;13,0;1,0;;;4,0;2,0;;;8,0;3,0;1,0;;;;;;;7,0;1,0;2,0;;4,0;;;;14,0;1,0;;;;;22,0;;;;;2,0;1,0;5,0;;;;1,0;;;;3,0;;;;20,0;;;1,0;1,0;1,0;8,0;;5,0;;;;1,0;;8,0;1,0;;;1,0;;;;3,0;;;;1,0;;;;;;;2,0;;;1,0;5,0;;2,0;;;;;;1,0;;;;;;;;;20,0;31,0;;;2,0;1,0;;;;;;;;;;;;;;;;;;;;;16,0;;;;;;;;;;;;;;;;1,0;;;;;2,0;;;;;;8,0;1,0;;;;;;;3,0;;4,0;8,0;;;;;6,0;;;;;2,0;;;7,0;1,0;;;;;18,0;;;;;;;6,0;;;;;;;;7,0;1,0;;;;;;3,0;;;;;;;;;;;;1,0;;;;;1,0;;;;;;1,0;;;;;5,0;;;;;;;;;;;;;;1,0;;;;;;;;1,0;;;;;;;;;2,0;;;;;;;1,0;;;;;;;;;;;;1,0;;;;;;5,0;;;;;;;;;8,0;2,0;;;;;;3,0;4,0;2,0;20,0;;4,0;;;;;;;;;;9,0;2,0;6,0;;2,0;;;3,0;;2,0;2,0;1,0;;;2,0;4,0;8,0;1,0;;33,0;8,0;;;;;;;3,0;5,0;;;;12,0;;;;;;;;;;;;;;6,0;;;;;;;;10,0;1,0;3,0;;2,0;;;2,0;4,0;3,0;;1,0;;;1,0;;;;1,0;;;;;;;;;;;;;;;;;;;;;1,0;;;;;;;;;;;1,0;;;;;2,0;;;;;1,0;;;;;;;;;5,0;5,0;;;;1,0;;;;;1,0;;;;;;;;;;;;;;2,0;;;;;;;;;;;;;;;;;;;;;;;;;;;;;2,0;;;;;;1,0;;2,0;;;;;;;;;;;3,0;;;;;;;;;1,0;;;;;;;;;;2,0;;;;;;;;;;;;;;;;;;;;;;;;;;;;;;;;;4,0;;;;;;;;;;;;;;;;1,0;;;;;;;;;;;;;;;;;;;;;;;;;;;;2,0;;;;;;;;;;;;;;1,0;3,0;;;;;;;;;;;;;;;;;;;;;;;;;;;;;;;;3,0;;;;;;1,0;;;;;;;;;;;;;;2,0;;;;;;;;;;;;;;;;;;;;;;;;;;;;;;3,0;3,0;;;6,0;1,0;;;;;;;;;;;;1,0;;;;1,0;;;;;;;;;;;;;;;;;;;;;;;;;;;;;;;;;;;;;;2,0;;;;;;;;;;;;;;;;;;;;;1,0;;;;;2,0;;;4,0;;;;;;1,0;;;;;;;;;;;;;;;;;;;;;;;;;;;;;;;;;;;;;;;;;;;;;;;;;;;;;;;3,0;;;;;;;;;;;;;;;;;;;;;;;;;;;;;;;;;;;;;;;;
maintain;;;;;;18,0;;12,0;12,0;;2,0;;;;15,0;13,0;;;;;3,0;4,0;1,0;1,0;;;4,0;;;;1,0;7,0;27,0;;37,0;9,0;3,0;2,0;7,0;;5,0;;;8,0;8,0;6,0;2,0;21,0;6,0;21,0;1,0;14,0;;;7,0;;12,0;;;;1,0;1,0;23,0;;22,0;3,0;12,0;1,0;2,0;2,0;1,0;;4,0;;1,0;;2,0;1,0;3,0;58,0;;4,0;;15,0;;;;;;2,0;24,0;1,0;12,0;;;3,0;1,0;;25,0;;6,0;;14,0;35,0;;1,0;11,0;1,0;20,0;1,0;3,0;10,0;;;;5,0;20,0;54,0;19,0;12,0;;;;5,0;3,0;;;;;1,0;;3,0;4,0;;;6,0;;3,0;1,0;;3,0;;;28,0;2,0;;2,0;2,0;15,0;;;;5,0;1,0;4,0;5,0;23,0;;;1,0;2,0;5,0;26,0;;1,0;;6,0;13,0;;;2,0;;3,0;7,0;4,0;7,0;5,0;7,0;6,0;;1,0;8,0;2,0;;2,0;5,0;;8,0;;;;;;5,0;;16,0;;;;;;;4,0;7,0;;3,0;;;1,0;1,0;;;9,0;1,0;5,0;2,0;1,0;3,0;;2,0;14,0;4,0;;;;;2,0;;23,0;;26,0;;;6,0;4,0;7,0;6,0;20,0;2,0;1,0;;2,0;1,0;;;;1,0;;22,0;2,0;3,0;;;6,0;2,0;1,0;8,0;;;;;;2,0;3,0;;1,0;;1,0;12,0;;1,0;10,0;3,0;1,0;;;1,0;6,0;4,0;16,0;3,0;1,0;3,0;;;17,0;3,0;;;;4,0;1,0;3,0;;;;4,0;;;;13,0;;2,0;;;;;2,0;1,0;;;2,0;;;6,0;;;1,0;;1,0;;;2,0;;;;4,0;1,0;;;2,0;3,0;;1,0;;;;;;2,0;;;;;;;8,0;1,0;2,0;;2,0;;;;8,0;;5,0;12,0;5,0;2,0;;1,0;;3,0;1,0;;1,0;;;3,0;15,0;2,0;;;2,0;;5,0;;3,0;5,0;;;;;1,0;;;;;2,0;;10,0;;;1,0;;;1,0;1,0;;;;;1,0;3,0;1,0;;1,0;;3,0;4,0;;;;2,0;30,0;;3,0;;;;7,0;1,0;;;1,0;;1,0;;;;24,0;15,0;;;;1,0;2,0;10,0;;;;4,0;;1,0;7,0;17,0;3,0;14,0;9,0;;;;1,0;1,0;2,0;;1,0;;;;;;1,0;;1,0;;;1,0;5,0;;;;3,0;12,0;;;4,0;1,0;;8,0;3,0;;7,0;;2,0;;;6,0;;2,0;3,0;2,0;;;;;;4,0;;6,0;;;;1,0;;;;;;;2,0;11,0;1,0;;;1,0;;8,0;;;;3,0;6,0;2,0;;;8,0;;;;;5,0;2,0;;;3,0;;1,0;;;;;1,0;4,0;1,0;3,0;;3,0;;;3,0;;;;4,0;4,0;4,0;1,0;7,0;;;;;1,0;4,0;;;;;1,0;1,0;2,0;;;;;;2,0;;;;2,0;;2,0;4,0;1,0;1,0;1,0;;;;;;1,0;2,0;;3,0;;;;;1,0;;;17,0;1,0;;;2,0;;;1,0;;;;;;;;;;3,0;;;;7,0;3,0;;;4,0;;;1,0;;;;;5,0;;3,0;;;;;1,0;;1,0;9,0;;;1,0;;;;2,0;;;1,0;;5,0;;;;1,0;;;2,0;;;19,0;;7,0;;;;;;1,0;;1,0;;1,0;;;1,0;;1,0;2,0;;;;;;;;;;1,0;;;;1,0;1,0;;7,0;;;;;2,0;;;;;;;;;;;;;;3,0;;;;;;;;;;2,0;;2,0;;;;3,0;;;;2,0;;;;4,0;;;;;;;4,0;;;;;;3,0;;;;;;;;;;4,0;;2,0;;;3,0;;;1,0;3,0;;;;1,0;1,0;2,0;;;1,0;;;3,0;;;;;;2,0;2,0;;4,0;;;;;;2,0;;;2,0;2,0;;2,0;;2,0;;2,0;;;2,0;;;3,0;;;;;;;;;;;;;;;;;;;;;;1,0;;;;;;;;;3,0;2,0;1,0;;7,0;;2,0;3,0;;;;1,0;;;;;;;;;;;;;;;;;;1,0;;6,0;;3,0;;;3,0;2,0;;;;;;;5,0;;;;;;;1,0;;;;;;;2,0;;;;2,0;;;1,0;;;2,0;5,0;;3,0;;2,0;;;4,0;;;;;4,0;;3,0;;2,0;;;;;1,0;;;;;;;6,0;;1,0;;;;1,0;;;;;;;;;;;3,0;2,0;;1,0;;;;;1,0;;;;;;;;;;;;;;;;;;;;;;1,0;
manual;;;;;;1,0;;16,0;;1,0;;;1,0;;8,0;9,0;1,0;;;;;1,0;8,0;1,0;;;;;;;1,0;3,0;13,0;;16,0;10,0;1,0;;;;4,0;;;;5,0;3,0;5,0;17,0;7,0;13,0;;;;;1,0;;;1,0;;;;;;;2,0;2,0;28,0;;1,0;;;5,0;1,0;;;2,0;2,0;;4,0;14,0;;1,0;;15,0;;2,0;;;;;13,0;;;;;;;;11,0;;;;8,0;;;1,0;12,0;;5,0;2,0;;1,0;;;;;4,0;5,0;4,0;2,0;;;;2,0;4,0;;;;;1,0;;;1,0;;;;;2,0;;;1,0;;;;1,0;;;;2,0;;;;;;1,0;3,0;6,0;;;;;;22,0;;;;;1,0;;;5,0;;;1,0;;;;11,0;;;1,0;1,0;;;;1,0;;2,0;;;;;;;;10,0;3,0;;;;;;;3,0;;;;;1,0;;;;2,0;;;;;;;;1,0;;;;;;;1,0;;;2,0;;;3,0;;2,0;4,0;;;;;;;2,0;;;;;;;;;;3,0;;;14,0;;;;;;;2,0;;;;;2,0;;;;;;;;;2,0;;6,0;8,0;;;;;1,0;;;;;;;;;;;;;1,0;;2,0;4,0;;;;;;;;;;;;;;;;;;1,0;;;;;;1,0;1,0;;;;2,0;;;;;;;4,0;;;;;;;;1,0;;5,0;;;;;3,0;;;;;3,0;1,0;;;;;;;;;1,0;;;1,0;;;3,0;;;48,0;8,0;9,0;3,0;;;;;;;;;;2,0;;1,0;2,0;;;2,0;5,0;;3,0;;;;;2,0;;;;;3,0;;;1,0;;;;;;1,0;;;;3,0;;1,0;;;;1,0;;;;19,0;3,0;;5,0;;;;10,0;;1,0;2,0;1,0;;;4,0;51,0;;;;;;;;;2,0;;;;2,0;;;;1,0;;;;;;2,0;;;;;12,0;;;;;;15,0;;;;;;;;;;;;;;;;;2,0;5,0;;3,0;;;;1,0;;;;;;;1,0;;;1,0;;4,0;;;;;;;18,0;;;;;;1,0;;;;11,0;;;6,0;;1,0;;;;;;;1,0;2,0;1,0;;16,0;;;;;;;;;;4,0;;;;;;1,0;;4,0;;;;1,0;;;;3,0;;;;;;;;;10,0;;;;2,0;;2,0;;;;;;;;;;;;;1,0;;;2,0;;;;;;;;;;;;;;;;;;;;;;;2,0;;7,0;;1,0;;;;;;1,0;;;;;;1,0;;1,0;;;4,0;;;;5,0;;2,0;;;;;;;;;;;1,0;;;;;;;1,0;;;;;;1,0;3,0;;;;;4,0;;4,0;;;;;;;;;;;;;;1,0;2,0;;;;;;;;;;;;;;;;;;;;;;;;;;;;;;;;;;;;;1,0;;;;;;4,0;;;;;;;;;;;;;;;;;;;4,0;;;;;;;;;;;;;;1,0;;;;;1,0;;;;;;;;;5,0;;;;;1,0;5,0;;1,0;;;;;;;;;;;;;;;;;;;1,0;;;;;;1,0;;;1,0;;1,0;;;;;;;;;;;;;1,0;;;;;;;1,0;;;;2,0;;;1,0;;;;;8,0;1,0;;;;;;;;;;;;;;;;;;;;;;5,0;;;;1,0;;1,0;;;;1,0;;;;;;2,0;;;;;;;;;;;;;;1,0;;;;;;;;;;;;;;;;;;;;;;;;;;1,0;;;;;;;;;;;;;;;;;;;;;;1,0;1,0;;;;;;;;;;;;;;;;;;;;;;;;;;;;;;;;;;
mark;;;;;;1,0;;9,0;3,0;1,0;;;2,0;2,0;;9,0;;;2,0;;6,0;27,0;2,0;;;;15,0;;;;1,0;1,0;17,0;;10,0;;1,0;9,0;;;10,0;;;1,0;17,0;4,0;32,0;29,0;9,0;118,0;;3,0;;2,0;;13,0;21,0;;3,0;;;3,0;;;2,0;;;2,0;3,0;2,0;;;6,0;;;4,0;5,0;;2,0;96,0;;1,0;;17,0;;;;;;3,0;2,0;;4,0;;2,0;2,0;2,0;;16,0;;2,0;;1,0;11,0;;;5,0;;;8,0;;1,0;;8,0;;29,0;10,0;30,0;;30,0;;;1,0;3,0;5,0;;;;;11,0;;38,0;1,0;1,0;6,0;;5,0;1,0;1,0;;;;;;2,0;;;2,0;;2,0;2,0;;5,0;4,0;1,0;;17,0;;29,0;;;3,0;18,0;;;;12,0;;1,0;;2,0;;;4,0;1,0;5,0;1,0;;;;;;;;;;;;;;;;;5,0;;;;3,0;;;;;7,0;6,0;;;;;1,0;10,0;;;2,0;;;;;;;;;;;;1,0;;;;8,0;;1,0;;;;;;1,0;;;5,0;1,0;6,0;;;;;;;38,0;6,0;;;;;;;1,0;;;;;;;6,0;;;12,0;;2,0;;;6,0;;;;;;1,0;2,0;5,0;;;;;;;;;;;8,0;1,0;;;;;;;;;;;;;;;;;1,0;6,0;;;;;;1,0;;;;;;;;1,0;;;;;;;;;;;;;31,0;2,0;;;;;1,0;;;;2,0;;;3,0;;;;;;;;15,0;;;;4,0;;;;;;;;;;;;;;;;;;;;;;1,0;4,0;2,0;;;;;;20,0;8,0;3,0;;;;;1,0;;;2,0;;;;;;;;10,0;4,0;2,0;;;;;;1,0;;1,0;;;20,0;;;;;7,0;;;;3,0;2,0;;9,0;;2,0;1,0;;;10,0;1,0;;;;2,0;2,0;;;;9,0;;1,0;6,0;;;;1,0;;;4,0;;;;;;;;3,0;3,0;;;;2,0;1,0;;1,0;;;;;2,0;;6,0;45,0;;;1,0;1,0;4,0;;;3,0;;1,0;;;6,0;;;;;;5,0;;;;;1,0;;1,0;6,0;;;;;;;;;;;;11,0;;;;;1,0;;;;3,0;;1,0;;30,0;1,0;;;;;;;;;;;;10,0;;;5,0;;;;;;;2,0;;1,0;;;;;;;;;;;;;1,0;;;;;;;;;1,0;;;;;;;;2,0;;;;;;;6,0;;;;;2,0;;;;;;;;11,0;;;;;;;;2,0;;;;2,0;;;12,0;;;;2,0;;5,0;2,0;;;;;;;;;;;;;;;;1,0;;;;;;;;;;;;;;3,0;;;;;;;;;;;;;;;;;;;1,0;;;3,0;;;;;;3,0;;;;;2,0;;4,0;;;;;;;;;;;;;;;1,0;;;;;;;;;;;;1,0;;;;;;2,0;;;;;;;;;;;;;;1,0;;;;4,0;;5,0;;;;;;;;;;;;;2,0;1,0;;;;;;;;9,0;;;;;;;;;;;;2,0;1,0;;;;1,0;;;;;;;;1,0;4,0;;;;;;2,0;;;;;;;;6,0;;;;;;;;;;;;;;;;;;;;1,0;;;;;;;;;;;;;;;;;;;;;;;;;;;;;;;;4,0;;;;8,0;;;3,0;;;;;;;;;;;;1,0;;;4,0;;3,0;;;;;;;;;;;;;;;;;;;;;1,0;;2,0;;;;;;;;;;;;;;;;;;;;;;;;;;;;;;;1,0;;;;;1,0;;;2,0;;;;;;;;;;;;;;;1,0;;;;;;;;;;;;1,0;;;;;6,0;;;1,0;;;1,0;;;;;43,0;;;;;
mask;;;;;;4,0;28,0;11,0;90,0;11,0;6,0;;;;8,0;16,0;2,0;;1,0;;;14,0;2,0;;4,0;;66,0;1,0;;;;;35,0;;4,0;4,0;;2,0;30,0;;10,0;;9,0;;8,0;6,0;13,0;20,0;;3,0;13,0;6,0;;;;10,0;13,0;;3,0;;2,0;4,0;9,0;;10,0;;;53,0;10,0;8,0;;13,0;26,0;10,0;;;2,0;26,0;16,0;155,0;;14,0;2,0;43,0;;;;;;3,0;38,0;;2,0;27,0;;2,0;8,0;;38,0;;2,0;7,0;15,0;6,0;8,0;;7,0;;8,0;;3,0;11,0;3,0;;;38,0;16,0;38,0;;4,0;;1,0;2,0;11,0;14,0;1,0;;1,0;3,0;;;1,0;17,0;6,0;3,0;4,0;2,0;4,0;2,0;;3,0;;;23,0;9,0;;;3,0;81,0;4,0;;;1,0;3,0;5,0;2,0;23,0;;3,0;;1,0;1,0;24,0;;;;1,0;7,0;;;2,0;;;2,0;2,0;18,0;;;;;1,0;;;;;15,0;;;1,0;;;;;6,0;;2,0;;6,0;;8,0;;1,0;3,0;4,0;;;;;;1,0;3,0;;;;;;;;;11,0;4,0;;;;;;81,0;;21,0;;6,0;5,0;1,0;1,0;5,0;;;26,0;2,0;;1,0;;2,0;1,0;;;1,0;;47,0;16,0;1,0;;;;;;6,0;2,0;;;;;4,0;2,0;;;5,0;1,0;;;;6,0;;;;2,0;;1,0;;4,0;;;;;;4,0;;;;19,0;7,0;;;;;;;;;;;1,0;;;;;;5,0;;;;5,0;;;;13,0;;;;;;;;;;;;;;;;;;;;;6,0;;;;1,0;;1,0;2,0;2,0;;;;;4,0;;;;;;;;6,0;;;;13,0;;;;;;;;2,0;;;;;;;;;1,0;9,0;;;1,0;;8,0;1,0;;;;1,0;;15,0;;;;3,0;;1,0;3,0;2,0;;;;;;;;;;34,0;2,0;;;;6,0;6,0;;4,0;;;;;;;;1,0;;;;;;18,0;9,0;;2,0;;;1,0;2,0;2,0;1,0;5,0;;;;;;1,0;;;;;;2,0;;;;1,0;;;;4,0;;3,0;;;;;2,0;1,0;;1,0;;;;1,0;2,0;1,0;;;;3,0;;;31,0;2,0;;3,0;;13,0;;1,0;;;;4,0;;;;2,0;3,0;;;;10,0;;;;;;1,0;21,0;;;;;;;;;;;1,0;1,0;;;1,0;;;;;;5,0;;;;;;1,0;2,0;;;;;;3,0;6,0;;;1,0;;;;1,0;2,0;;;;;;;6,0;;3,0;2,0;;;;;;8,0;;;;;;;;;;2,0;;;;10,0;;;;;;;;;;1,0;;;;;;1,0;;;;1,0;1,0;;8,0;;;;;;;;;;;;;;;;;;;8,0;;;;;;;;;;;;;;;;3,0;;;11,0;;1,0;1,0;;;;;;;;;;;;;2,0;;;17,0;27,0;;;;3,0;;;;1,0;;;;;;;;;;;;;;;16,0;;;;;;;;;;;;;;1,0;1,0;;;;6,0;;;;;;1,0;;;;;;;;1,0;;;;;2,0;;;;;;;;;;;1,0;;;;;2,0;1,0;;;;;;;4,0;;;;;;;;;;;;;;1,0;;;;;;;;2,0;7,0;;;;2,0;5,0;;;;;;;1,0;;;1,0;1,0;;;;;;;;;2,0;;;;;;;;;;9,0;;;1,0;;;1,0;;;;1,0;;;;;;;;;;;;;;4,0;;5,0;;;;;;;;;1,0;;;;;;14,0;;;;;;;;;;;;;;;;12,0;;;;;;2,0;;;;;;;;;;85,0;;;;;;1,0;;;;;;;;;;;;;;;6,0;;;;1,0;;2,0;;;;;;;;9,0;;;3,0;;;;4,0;;;;;;;;;;;7,0;;4,0;;;;2,0;;;3,0;;;;;;;;;;3,0;3,0;;;;;;;;;3,0;;;;;1,0;;;;;;;35,0;;;;;;;;;;;;;;;;;;;1,0;;;;;
mate;;;;;;3,0;3,0;3,0;;2,0;;;;;1,0;31,0;;;;;;1,0;;7,0;;;;;;1,0;;;22,0;;;;;;;;3,0;;2,0;;;1,0;1,0;3,0;2,0;;16,0;;;;;2,0;14,0;;;;5,0;5,0;;;;;;2,0;;41,0;;;;;;;;;;1,0;;;;17,0;;;3,0;;;;51,0;;;1,0;;;;;2,0;;;;22,0;;1,0;;4,0;;;;1,0;;1,0;;;3,0;122,0;7,0;;;;;;;;;;;;;;1,0;3,0;;;;4,0;;;;;;;;;;;6,0;;1,0;;;;;;;7,0;;;;;;;;;;1,0;;;;;;;;;;2,0;;;;4,0;;;;;5,0;;4,0;;;;;;1,0;;16,0;;;;15,0;2,0;2,0;;;;;;;;59,0;;;;;;;;1,0;;4,0;91,0;;1,0;;;;;;1,0;;60,0;;;18,0;;;;;8,0;1,0;1,0;1,0;9,0;;;;;;;3,0;8,0;;1,0;;;;4,0;;;;2,0;;12,0;;;;2,0;2,0;;;;1,0;;;;1,0;;27,0;;73,0;;;;;;;;;;;;;;;3,0;;;;;;1,0;1,0;;;;;4,0;;3,0;;;;;;1,0;;;29,0;;5,0;;;;;;;1,0;;;;;;64,0;2,0;;;;2,0;6,0;;;;;1,0;;;2,0;;4,0;;2,0;;;;;;;;;;;;;1,0;4,0;;;19,0;;;2,0;;;;;;1,0;;;;10,0;1,0;;;;;1,0;;;1,0;;;;;27,0;1,0;;;1,0;;;;;4,0;;;;;;;;;;;;;;;;;;;1,0;;;;;4,0;;;;;;;1,0;;;;;;;;;;;;2,0;;;;;;;;;;;;;;;;;;;;;;;;;;;;;;;;;4,0;3,0;8,0;;3,0;;;;;;;;;;;;;1,0;;13,0;;6,0;;;;;;;;;;;;;;;;;;;;;;;2,0;;;;1,0;;;;;;1,0;;1,0;;1,0;;;;6,0;;;;;;;;;;;;;;;;;;;;;1,0;;2,0;;;;;;;;;;;;;;;;;;;;;;;;;;;;;1,0;;;;;;;1,0;;;;;1,0;;1,0;;;;;1,0;2,0;2,0;;;;;;1,0;;;;;;;;;;;;;2,0;;;;;;;;;;;;;;;;;;;;3,0;;;;;;;;;;;;;;;;;;2,0;;;;;;;2,0;;;;;;;;;1,0;;;;;;;;;;;;2,0;;;;;;;;;;1,0;2,0;;;;;;;;;;;;1,0;;;;;;1,0;;;;;;;;;;;;;;;;;;;;1,0;;;;;9,0;;;;;;;;;;;;;;;;;;;;;;;;;;;;;;;;;;;;1,0;;;;;;;;;21,0;;;;;;;;;;;;;;;;;;;;;;;;;;;;;;;;3,0;;;;;;;;;;;;;;;;;;;;;;;;;;;;;;;;;;;;;;;;;;;;;2,0;;4,0;;;;;;;;;;;;;;;;;;;;;;;;;2,0;;;;;;;;;;;2,0;;;1,0;;;;;;;;;;;;;;;;;;;;;;;;;;;;;;;;;;;;;;;;;;;;;;22,0;;;;;;;;;;;;;;;;;;;;;;;;;;;;;;;;;;;;;
microlens;;;;;;1,0;17,0;2,0;10,0;20,0;97,0;;1,0;;;;1,0;;;;;6,0;;;;;23,0;;;;;;5,0;;;;;;;2,0;;;8,0;11,0;;;3,0;9,0;;1,0;1,0;49,0;;6,0;;;26,0;;;;7,0;;4,0;;29,0;57,0;4,0;14,0;;11,0;;;;;;4,0;;;;16,0;1,0;6,0;;18,0;5,0;;;;;27,0;12,0;;;1,0;;2,0;;;20,0;;;;;;9,0;;26,0;;1,0;;15,0;;;;;71,0;8,0;7,0;;;;;;;1,0;;;;;4,0;;;3,0;;;;17,0;;2,0;1,0;16,0;;;1,0;;;;6,0;2,0;7,0;6,0;8,0;3,0;;;;3,0;;;;5,0;;5,0;;;;;;;10,0;;;;1,0;2,0;;;;;;;1,0;;;;;;;;;;;;;1,0;;;;;;;3,0;3,0;8,0;;;;;;9,0;6,0;4,0;;;;;;;4,0;;;;;;;;3,0;;31,0;;;;;2,0;;;;;;;2,0;;1,0;;;1,0;3,0;;30,0;25,0;;;;;;;5,0;2,0;;1,0;;;;1,0;11,0;;;;;;;;1,0;1,0;;;;;7,0;;;;;;;2,0;;;;5,0;;;;3,0;;;;;;;;;1,0;;;;;;1,0;;;;;;;2,0;;;1,0;;;;1,0;;;;;;;;;;;;;;;;;;;;1,0;;;;;;;;;;;3,0;;;;1,0;;;;9,0;;;;;;;;;;;;;;;;;;;;;;;;;;;;;;;;;;;;;;;;;;;;;;;;4,0;;;;;;;;;;;;;;;;;;;;;;;4,0;;;3,0;;;;;;;;;;;;;;;;8,0;;;;;;1,0;;;;;;;;;;;;;;;;;;;;;;;;8,0;;4,0;;;;;;;;;;;;;;;1,0;;;;;;;;;;;;;;;;;;;;;;;;;;;;;;;;;;3,0;;;;3,0;;;;;;;;;;;;;;;;;;;3,0;;;;;;;;;;;;;;;;;;;;;;;;;;;;;;;;;;;;;;;;;;;;;11,0;;;;;4,0;;;;;;;;;;;;;;;;;;;;;3,0;;;;;;;16,0;;;;;;;;;;;;;;;;;;;;;;;;;;;;;;1,0;3,0;;;;;;;;;;;;;;;;;;;;;;;;;;;;;;;;;;;;;;;;;;;;;;;;;;;2,0;;;;;;;;;;;;2,0;;;;;2,0;;;;;;;;;;;;;2,0;;;;;;;;;;;;;3,0;;;;;;;;;;;;;;;;;;;;1,0;;;;;45,0;;;;;;;;;;;;;;;;;;;;;;1,0;;;;;25,0;;;;;;;;;;;;;;;;;;;;;;;;;;;;;;;;;;;;;;;;;;;;;;;;;;;;;;;;;;;;;;;;;;;;;;;;;;;;;;;;;9,0;;;;;;;;;1,0;;;;;;;;;;;;;;;;3,0;;;;;;;;;;;;;;;1,0;;;;;;;;;;;;;;;;;;;;;;;;;;;;;;;;;;;;;;;;;;;;;;;;;;;;;;;;;;;;;;2,0;;;;;;
modulate;;;;;;5,0;;2,0;4,0;2,0;3,0;;;;;2,0;23,0;;;;;;;;;;;2,0;;;1,0;1,0;5,0;;3,0;;;;;;14,0;;1,0;;14,0;;4,0;1,0;2,0;;;;;;;;5,0;;12,0;;;;8,0;;;14,0;11,0;;12,0;;9,0;;15,0;;;5,0;;19,0;44,0;58,0;1,0;1,0;;5,0;;;;;;;5,0;;;;1,0;1,0;;;15,0;;;;7,0;17,0;;1,0;24,0;1,0;19,0;;;2,0;2,0;;;;7,0;;14,0;;;;2,0;2,0;6,0;;1,0;;15,0;2,0;;5,0;;;;1,0;10,0;;;;11,0;;;7,0;;;;;32,0;;;;;2,0;;4,0;7,0;;;;;5,0;2,0;;;;3,0;12,0;2,0;3,0;;;;;;;;;;;;;;;;1,0;;18,0;;;3,0;;;9,0;;;;17,0;;;;;1,0;;;;;;18,0;;;;;;;;;;;;;;;;;;;;129,0;;;;3,0;;;;;;;;;;;;7,0;;;;17,0;12,0;1,0;;;;;9,0;22,0;11,0;1,0;;;;;;;;1,0;;;;;18,0;;;;;;;;4,0;2,0;;14,0;;;16,0;;;;2,0;;;;;;;;;;;;;;;;;;;;;5,0;;;;;1,0;;;;;;;;;1,0;;;;;;;;;;;5,0;6,0;;;;;;;;;;;1,0;;32,0;;;;;;;;;;;;;;;;;;;;4,0;;;;;;;;;;;;;;;;4,0;;;;;;5,0;;;;2,0;;6,0;;;;;4,0;;;;12,0;1,0;;;2,0;;;;;2,0;;;;;;;2,0;1,0;;;;;;1,0;;11,0;1,0;1,0;;1,0;;;1,0;12,0;;;;;;1,0;;;;;;;;;4,0;;;;;;;;;2,0;;;;;;;;;;;;;;;;;3,0;;;1,0;;;;1,0;;25,0;;;;;;;;;;;;;;;;;;;;;;;;;;;;;;;1,0;;;3,0;;;;;;;;;;;;;;1,0;;1,0;;;;;;2,0;;;;;;;;;;;;1,0;;;;;;;;;;1,0;;;1,0;;1,0;;;;;;;;;;;;;;;;;;;;;;;;;;;;;;;;;;;;;;;;;;3,0;;;;;;;;;;;;;;;;;;;;;;;;;;3,0;;8,0;;;;;;;;;;;;;;;;;;;;;;;;;;;;;;;3,0;;;;;;;;;;;;;;;;;;2,0;;;;;;;;;;;2,0;;;;;;;;;;;;;;8,0;;;;;4,0;;;;12,0;;;;;;5,0;2,0;;9,0;;;;;;;;1,0;;;;;;;;;;;;;;;;;;;;;;;;;;;;;;;;;;;;;;;;1,0;;;;;;;5,0;;;1,0;;;;;;;;1,0;;;;;;;;9,0;;;;;;;;;;;;;;;;1,0;;;;;;;49,0;;;;;;;;;1,0;;;;;;;1,0;;;;;;;;;;;;;;;;;;;;;;;3,0;5,0;;;2,0;;;;;;;;;;;;;7,0;;;;2,0;;;1,0;;;;;1,0;;;;;;;;;1,0;;;;;;;;;;;;;;;;;;;;;;;;;;;;;;;;;;;;;;;;;;;1,0;;;;;;;;;;;;2,0;;;;;;;;;;;;;;;;;;;;;;1,0;;;;;;;;;;;;;;
observation;;;;;;4,0;;10,0;26,0;4,0;;;;;;14,0;9,0;;;;;3,0;;2,0;;;16,0;4,0;;;;;14,0;;7,0;;;;;;14,0;;1,0;;4,0;1,0;14,0;44,0;8,0;3,0;5,0;1,0;;;4,0;;;;2,0;;;;20,0;;10,0;2,0;1,0;9,0;;1,0;2,0;38,0;16,0;;;2,0;;5,0;27,0;52,0;;10,0;;17,0;2,0;;1,0;;;;10,0;;;;10,0;;;;3,0;;1,0;;4,0;3,0;;1,0;122,0;;5,0;1,0;;23,0;;;;20,0;6,0;8,0;;2,0;;;2,0;1,0;8,0;;;1,0;;3,0;;1,0;2,0;5,0;2,0;7,0;9,0;;;;10,0;;;7,0;;;;;16,0;;;;;;12,0;;70,0;;;;;1,0;47,0;;;;8,0;27,0;9,0;5,0;1,0;;;1,0;;1,0;;;3,0;;;;;;;;;1,0;2,0;;;;;;;;;;;1,0;1,0;;2,0;16,0;;;;;2,0;;;;;;;;1,0;;;;1,0;;;;16,0;;;;73,0;;1,0;;;3,0;;9,0;1,0;;;;;;;32,0;;;;;10,0;;;;;;;;4,0;5,0;;;;;6,0;1,0;;;;;;;;27,0;;;;;;;;;4,0;;;;;47,0;;;;;3,0;;;;;;1,0;;;;;2,0;7,0;;;;;;;;;5,0;;;;;;4,0;;;;;;;2,0;;;;;2,0;;1,0;;;;;;;;2,0;;;3,0;3,0;;;;;4,0;;;;;;;;;10,0;;1,0;;;;;;3,0;;;;;;;;;;;;;;;;;;;;;;7,0;;;;6,0;;;;;;;1,0;;;;;;;;;;;24,0;14,0;;;;;;;;;;;;;2,0;;;;7,0;;;;;;;2,0;;2,0;3,0;35,0;;4,0;;1,0;;10,0;2,0;;2,0;;2,0;18,0;;;;;1,0;1,0;;;;;;;;;;;;1,0;2,0;;;;;3,0;;4,0;;46,0;;5,0;1,0;;;;;;;;;;;7,0;;1,0;;;;8,0;1,0;;;;81,0;;;;;4,0;;;;;;1,0;;;;1,0;;15,0;;12,0;1,0;;;;;;;;;;4,0;;;;;1,0;;;;;;;2,0;;;3,0;;;;;;;;;;;;;;20,0;;;;;;;;4,0;;;;;;;;;;;;;;;2,0;;;;;;;;2,0;;;;;;;1,0;;;;;4,0;;;;;;;;;8,0;;;;;;;;;;;;;;;;;;;;;;2,0;;;;;;1,0;;;;;;;;;;;;;;;2,0;;;;;;;2,0;;;1,0;;;;;;;;;4,0;;;;;;;;;;;;;;;;;;;;;;;;;;;;;;;;;;;;;;;8,0;;;;;;;;;;;;;3,0;;;;;;1,0;;;;;;;;;;;;;;;;;;;;;;;;3,0;;;;;;;;;;;;;5,0;;7,0;;;1,0;;;;;;;;;;;;;;;;;;;;;;;;;;2,0;1,0;;;;;42,0;;13,0;13,0;;;;;;;;;;;;;4,0;;;;;;;10,0;;;;;;;;;;1,0;;;;;;;;;;;;1,0;;;;1,0;7,0;;;1,0;;;;;;;;;;;;;;;;;;;;;;;;;;;;;;;;;;;;;;;;;;;;;;;;;;1,0;;;;10,0;;;;;;;1,0;;;;;;;;;;;2,0;;;;;;;;;;;;;;;;;;;;;;;;1,0;;;;;;;;;;;;;;;10,0;;;;;;;;;;;;;12,0;;;2,0;;;;;;1,0;;;;;
orthogonal;;;;;;9,0;;1,0;4,0;12,0;10,0;;2,0;;122,0;8,0;2,0;;;;10,0;;;;;;5,0;;;2,0;;;5,0;;3,0;;;;;;;;9,0;3,0;4,0;1,0;3,0;14,0;1,0;4,0;2,0;2,0;;2,0;5,0;4,0;19,0;;;;13,0;;20,0;;7,0;;;1,0;12,0;2,0;;;9,0;;;12,0;;;4,0;26,0;;28,0;;14,0;;;;;;;20,0;;;;6,0;2,0;;;10,0;;;;;4,0;;;109,0;;2,0;;1,0;;;;;6,0;12,0;10,0;;8,0;;3,0;3,0;1,0;6,0;3,0;;;;;;12,0;22,0;;4,0;;7,0;1,0;;;;;;11,0;;;;;5,0;;1,0;;;;;;25,0;;6,0;8,0;2,0;2,0;8,0;;;;11,0;6,0;;;;;;;;1,0;6,0;2,0;;;;;;;;1,0;;20,0;;;;;;6,0;;;;;;;;3,0;;279,0;;8,0;;;1,0;43,0;;;1,0;;;;3,0;1,0;2,0;1,0;;1,0;;;;;6,0;;15,0;;28,0;;3,0;7,0;25,0;9,0;19,0;;2,0;1,0;;;;6,0;6,0;;;;4,0;68,0;4,0;35,0;1,0;;1,0;;1,0;;;;;;;1,0;;;1,0;;;;;2,0;2,0;;1,0;;;;1,0;39,0;;;;3,0;1,0;;;;;7,0;;3,0;1,0;;3,0;;;;2,0;;2,0;;;;;2,0;2,0;;;1,0;;2,0;;2,0;;;;;;;;;;9,0;1,0;;;;;2,0;;;;;;8,0;;12,0;;;;2,0;;;;;;;18,0;2,0;2,0;3,0;;1,0;12,0;2,0;;8,0;1,0;3,0;;4,0;;1,0;;1,0;;2,0;;;6,0;;;;;;;;2,0;3,0;;;6,0;4,0;;;;;;7,0;;3,0;;;;;;2,0;5,0;;;;;;;;;1,0;1,0;2,0;;1,0;;;;1,0;1,0;;;;;;2,0;;;;;;;;;8,0;;6,0;4,0;;;;;10,0;;6,0;1,0;;;1,0;;;;;5,0;;3,0;;;;3,0;;1,0;;4,0;;;;;;;;;;;;;;;;;1,0;;;;;;1,0;38,0;;;;;5,0;;;;;;1,0;;;;;;;;11,0;;;13,0;;;;;;;;;;;;;;2,0;;;2,0;2,0;;;1,0;;;;;;;;;;;;;;2,0;;;;;;;;;;;1,0;;;1,0;;;;;;;;;4,0;;;;;;3,0;;;;;;;1,0;;;;;;;;;;;;;;;;;;;;;6,0;;10,0;;;;;;;;;;;;2,0;;2,0;;;;;;;;;;;;;2,0;;;;;;2,0;;;;;;;;;;;;;;;;;;;;1,0;;;;;;;;;;;4,0;;;;;3,0;;;1,0;;;;;;;;;;;;;4,0;;;;;;;1,0;;;3,0;1,0;;;;;1,0;;;;3,0;;;;;;;;;;1,0;;;;;;;;;;;3,0;;;;;10,0;12,0;;;;;;;;;;;6,0;;;;;;;;;1,0;;;;;;;;;;;;;;;;;;;;;;;;;4,0;2,0;;;;;;;;;;;;;;;;;;;;;1,0;;;;;;3,0;;;;;;;;;;;6,0;;;;;;;;;;;;;;;;;;1,0;;;;;;;;;;;;;;;;;;;;;;;;;;;;;;12,0;;;;;11,0;;;;;;;;;;;;;;2,0;;;;;;;;;;;;;;;;;;;;;;;;1,0;;;;;1,0;10,0;;;;;;;;;;3,0;;;;;;;;;;;;;;;;;;;;;;2,0;;;;1,0;;;;;;;;;;;;;;;;5,0;;;;;;;;;;;;;;;;;1,0;;;;;;;;;;;;;;;;;
pane;;;;;;3,0;;;4,0;4,0;;;1,0;;1,0;4,0;27,0;;;;;4,0;;;;;;;;;;;3,0;;;;;;;;4,0;;;;7,0;1,0;7,0;10,0;;34,0;5,0;;;1,0;;;2,0;;;;1,0;;;;;;;3,0;;7,0;5,0;;3,0;;;11,0;;;;10,0;;;;3,0;;;;;;1,0;;;;;;2,0;;;10,0;;;2,0;;2,0;;;5,0;8,0;;2,0;;;;;;10,0;1,0;;;;;;;;;;;;8,0;4,0;;;;;;;;1,0;;;;;;2,0;;;;5,0;;;;;;1,0;;;20,0;;;;1,0;13,0;1,0;;;;16,0;12,0;;;;;;;;;;;;;;;;;;;;;;;;;;;;;1,0;;;;;;;;;;;;;;;;;;1,0;;;;;;;;26,0;;;1,0;;;17,0;;;;;1,0;;;;2,0;;32,0;;;8,0;;;;;;;;;;;;;;1,0;20,0;;;;;;7,0;;;;;;;;18,0;;;;;;;;56,0;;;;;;;;;;1,0;18,0;1,0;;;;;;4,0;;;;;;;;;;;;;;;;;;;;;;8,0;;;;;;;;;;;;;;;;;;1,0;;;;;;;;;;1,0;;;;;;;;;;;;14,0;;;;;;;;;;;1,0;;;;;;;;5,0;;;;;;;;;;;;;;;;;;;;23,0;;;;;2,0;;;;;;;;;;;;;;;;;;;;;;;;;;;;2,0;;;;;;;;;;;;;;;;;;;;;;;;;;;;;;;;;;;;;;;;;;;2,0;;;;;;;;;1,0;;;;;;;;;;;;;;;2,0;;;;;;;;;;;;;;;;;;;;;;;;;;;;;;;;;2,0;;;;;;;;;;;;;17,0;;;;;2,0;;;;;;;;;;;;;;;;;;;;;;;1,0;;;;;;;;1,0;;;6,0;;;;;;;;;;;;;;;;;;;;;;;;;;;;;;;;;;;;;;;;;;;1,0;;;;;;;4,0;;;;;;;;;2,0;;;;;;6,0;;;;;;1,0;;;;;;;;;;;;;;;;2,0;;;;;;;;;;;;;;;;;;;1,0;;2,0;;;;;;;;;;;;;;;;;;;;;;;;;;;;;;;;;8,0;;;;;;;;;;2,0;;;;;;;;;;;;;;;;;;;;;;;;;;;;;;;;;;;;;;2,0;;;;;;;;;;;;;;;;;;;;;;;;;;;;2,0;;;;;;;;;;;;;;;;;;;;;;;;;;;;;;;;;;2,0;;10,0;;;;;;;;;;;;;;;;;;;;;;1,0;;;;;;;;1,0;;;;;;;;;;;;;;;;;;;;;;;;;;;;;;;;;;;;;;;;;;;;;;;;;;;;;;;;;;;;;;;;;;;;;;;;;;;;;;;;;;;;;2,0;;;;;;;;;1,0;;;;;;;;;;;;;;;;;;;;;;;;;;;;;;;;;;;;;;;
panoramic;;;;;;15,0;;14,0;20,0;5,0;;;1,0;;5,0;23,0;1,0;;;;;25,0;3,0;;;;;;;3,0;6,0;;14,0;;4,0;9,0;6,0;;15,0;3,0;22,0;;6,0;;2,0;;7,0;106,0;20,0;37,0;1,0;;1,0;;;;;;1,0;;1,0;;29,0;9,0;;;;16,0;8,0;1,0;;;36,0;2,0;;;1,0;;;393,0;2,0;2,0;;35,0;;;;;;;5,0;;;;;1,0;5,0;;29,0;3,0;;;17,0;3,0;;;3,0;;3,0;;5,0;7,0;;;;17,0;14,0;12,0;;;;;20,0;7,0;11,0;1,0;;;2,0;10,0;;;3,0;;;;;2,0;;;7,0;;;4,0;16,0;;;;2,0;;;;1,0;7,0;2,0;;12,0;;1,0;;;;9,0;;1,0;;9,0;55,0;5,0;;3,0;;;3,0;;4,0;;;;;;;;;;1,0;;1,0;1,0;;3,0;;;3,0;;;;;;2,0;2,0;;;6,0;;;1,0;;;1,0;;;;;;;;;;;11,0;;;;;;25,0;;;;27,0;;;7,0;;2,0;5,0;;1,0;3,0;;;1,0;2,0;;;;;3,0;1,0;1,0;;;;;;12,0;;;;;;;1,0;;;;;1,0;;;1,0;11,0;;;10,0;;;;31,0;;;;;;1,0;7,0;;;;2,0;;;;;;;;;;;;7,0;;1,0;;15,0;;1,0;2,0;;;;;;14,0;;;;;;;;;;;;11,0;15,0;;;;;;;;;;;;;;;2,0;;;;;1,0;;3,0;1,0;3,0;;;;;6,0;2,0;;;1,0;;;;;;;;;;;;;;;10,0;;2,0;5,0;22,0;;2,0;;;;;5,0;;;10,0;3,0;;;5,0;;;9,0;;1,0;;;;;;;;;;;3,0;;;3,0;1,0;1,0;;2,0;2,0;;;;6,0;;;10,0;;;;;;3,0;11,0;;2,0;;2,0;;12,0;;5,0;3,0;;;;;4,0;1,0;5,0;;;;;;;4,0;;3,0;;;2,0;2,0;;;;;;;;1,0;1,0;;;;20,0;;;;;;;1,0;;6,0;2,0;;;;;1,0;;3,0;1,0;;;;;;12,0;;20,0;;;2,0;;;;;;;;6,0;;;5,0;;;;;;;;;;;;;;;1,0;;;;;;;2,0;1,0;;;;;;;;6,0;;2,0;;4,0;;;;;;;;;;;;;;;1,0;1,0;;;;;;;;;;10,0;;;;;;2,0;;;;;;;;;;;;;;;;;10,0;;5,0;;;;;11,0;2,0;;;;;;;;;;;;;;;;;;;;9,0;19,0;;1,0;;;;2,0;1,0;;;;;;1,0;1,0;;;;;;;;;;;;;;;;;;;27,0;;;;9,0;;;8,0;;;;;;;;;;;;;;;8,0;;;;;;;;;;;;;;;;;;2,0;;;;3,0;;2,0;;;;;;;20,0;;;;;;;;;;;;;;;;1,0;;;;;1,0;;;;;;1,0;;;;;;;;;;;;;;;;;;1,0;;;;;;;9,0;;;;;;;;1,0;;;;2,0;;;;;;;;;;;;2,0;4,0;;;;1,0;;;;;;;;;;;;;;;;13,0;;;;;1,0;;1,0;;;;;;;;;;;2,0;;;;;;;;1,0;;;;;;;;;;;;;;1,0;;;1,0;;;2,0;;3,0;;;;;;;;;;11,0;;;1,0;;;1,0;;;;;;;;;;;;;;;1,0;;;;;;;;;;;;;;;2,0;;;;;;1,0;;;;1,0;;2,0;;;;;;;3,0;;;;;;;;;1,0;;;;;;;;;;;;;;;;;;;;;51,0;;;;;;;;;;;2,0;;;;;;;;;;;;;;36,0;;;1,0;;;;;;;;;;;;;;;;;;
parallax;;;;;;2,0;;3,0;1,0;;7,0;;7,0;;6,0;34,0;;;;;;18,0;1,0;;;;;;;;;;24,0;;2,0;6,0;21,0;18,0;;;3,0;;;1,0;4,0;2,0;45,0;6,0;1,0;5,0;;27,0;;;1,0;;3,0;19,0;;;;;;;;6,0;4,0;1,0;;;2,0;;7,0;;;2,0;;;;160,0;1,0;10,0;;10,0;;1,0;;;;1,0;31,0;;;;;1,0;;;10,0;;;;4,0;12,0;;5,0;2,0;;6,0;2,0;6,0;2,0;;;3,0;5,0;7,0;3,0;;4,0;;;;10,0;13,0;;;;3,0;;;3,0;1,0;;2,0;;2,0;;2,0;;5,0;;;2,0;;;;;7,0;;;;;;5,0;;2,0;;;;1,0;;9,0;;;;;13,0;;;1,0;;;;112,0;;;;;;;;;;;;;;;;;;;;;;;;;;;;4,0;17,0;8,0;;;;;3,0;;;;;;;;;;;;;;;;;;;;;;;;;;1,0;3,0;;;;;;;2,0;;;;;6,0;4,0;;;;;;;;;;;;;;5,0;;;;;;;;;;;;;;;;;;;;;;5,0;;;;;;;;;;;2,0;;;;;;;;;;;;;;;;;;;;;;;;;;;;1,0;;;;;;;;;;;2,0;;;;;;;;;;;;;;;;;;;;7,0;1,0;45,0;;;;;;;;;;;;;4,0;;;;;;;;4,0;;;;;;;3,0;;;;;;4,0;;;;;;;;;;;;;1,0;;;;2,0;52,0;;;3,0;;4,0;;;;;;;;8,0;;;;;;;1,0;;;;1,0;5,0;;;5,0;;;;2,0;4,0;;;;1,0;;;;;;;;;1,0;;;;;;;;;;;;;;;;;;;4,0;;;1,0;;;15,0;3,0;3,0;;2,0;;;;;;;;;;;;;;;;1,0;;;;;;;;;;;;;;;;;;;;;;;53,0;;;;;;4,0;;;;;;;;;;;;;;;;1,0;;;;;;;;15,0;4,0;;;;;;;2,0;;;;;;;;;;;;;;;;;;;;;;;;;;;;;;;;1,0;;;;;4,0;;;;;;;;4,0;;;;;;;;;;;;;;;;;;;;;3,0;;;;;;;;;;;;;;6,0;;;;;;;;;;;;;;;;;;;;;;;2,0;;;;;2,0;;;;;;;;;;;;;;;;2,0;;;;;;2,0;;;;;;;;;;;;1,0;;;16,0;;;;;;;;;;;;;;;;;;;;;;;;;;;;;;;;;;;;;;;;;5,0;;;;;;;;;;;;;;;;;;;;;;;;;;;;;;;;;;;;;;;;;;;;11,0;;;;;;;;;;;;2,0;;;;;9,0;;;;;;;;;;;;;;;;;;;;;;;;;;5,0;;;;;;;;;;;;;;;;;;;;;;;;;;1,0;;;;1,0;;;;;;;;;;;;;;;;;;;;;;;2,0;;;;1,0;;;;;;;;;;;;;;;;;;;;;;;;;25,0;;3,0;;;;;4,0;;;;;3,0;;5,0;;;;;;;;;;;;;;1,0;;;;;;;;;;;;;;;;;;;;;;;;;4,0;;;3,0;;1,0;;;;;;;;;;;;;;;;;;;;;;;;;
perimeter;;;;;;1,0;1,0;1,0;2,0;2,0;1,0;;1,0;;;11,0;;;;;;8,0;;2,0;;;;;;;;1,0;4,0;;;4,0;;;;;;;9,0;;;;1,0;1,0;2,0;24,0;12,0;5,0;;;;10,0;12,0;;;;31,0;;14,0;;4,0;;;7,0;;4,0;;;;;5,0;2,0;5,0;1,0;1,0;23,0;;;;22,0;;;;;;1,0;11,0;;;2,0;1,0;;;;10,0;;;;8,0;;;;9,0;;;;;;;;;4,0;51,0;9,0;;;;;;;;;;;;;;;1,0;1,0;2,0;;14,0;;;;;;2,0;13,0;;;;7,0;4,0;;;;;;;;11,0;;;;;;;;;;49,0;11,0;1,0;;;;3,0;3,0;;4,0;5,0;4,0;13,0;;;2,0;3,0;3,0;;;5,0;3,0;;1,0;;;1,0;2,0;;10,0;;4,0;;8,0;;;;;;;;;;1,0;;;;;6,0;;;;;3,0;15,0;;14,0;;;4,0;13,0;;14,0;;12,0;7,0;;2,0;1,0;;3,0;14,0;14,0;51,0;9,0;6,0;8,0;;;;;5,0;8,0;4,0;;;;;;;;;;;;;27,0;4,0;1,0;;18,0;;;;;;4,0;;;1,0;;8,0;11,0;50,0;;;;;;;;;;8,0;;;;;10,0;;;;;;;6,0;1,0;;;;2,0;;1,0;;;2,0;1,0;;;;;;;9,0;;;1,0;;;;1,0;;;;;;46,0;;;;;;;1,0;;;;;;;;;1,0;5,0;;;;;;3,0;;1,0;;2,0;;3,0;2,0;2,0;1,0;;;1,0;5,0;;;;2,0;;;;6,0;;2,0;;;;;;;;;;;;15,0;1,0;1,0;;10,0;;;4,0;5,0;;;;;;;;;;;;;;;1,0;10,0;;;;;;;;1,0;;;3,0;;1,0;;1,0;;1,0;;;18,0;;4,0;1,0;3,0;;;;;;;;;;;;;;;;;;;;;;;;;;;;;;;6,0;;;;;5,0;;;;;;;1,0;;1,0;;;;;;;;;;;;5,0;;4,0;3,0;;;;;;;;;;;;;4,0;;;;;3,0;;;;;;;;;;;;;;;;;;;;;;;;;;;;;;;;;4,0;;;;;;;;;;;;5,0;;;7,0;;;;;;4,0;;;;3,0;;;;;;;;;;;;;;;;;;;8,0;;;;;;;5,0;;;;;;;;;;;;2,0;;;;;;;;;;;;;;5,0;;;;;;;;;;;;;;;;3,0;;;;;;;;;;;;;;;;;;;;;;;;;;;;;1,0;;;;;;;1,0;;;;;;;1,0;;;;;;;;;;;;;;;;;;;;;;;;2,0;;;;14,0;;;;;;;;;;;;;5,0;;;;;;;;;;1,0;;;;;;;;22,0;;;;;;;;;;;1,0;;;;;;;;;;;;;;;;;;;;;;2,0;;;;;;;;3,0;2,0;;;;;;;;;;;;;;;;;;;;;;;;;;;;;;4,0;;;;;;;;;;1,0;;;;3,0;;3,0;;;;12,0;;;;;;;;;;;;;;;;;;;;;;;;;;;;;;;;;;;;;;;;;;;;;;;;;;;;;;;;;;;;;;;;;;;;;;;;;;;;;;;;;;;;;;;;;;;;;;;;;;;;;;;;;;;;;;;;1,0;;;;;4,0;;;4,0;;;;;;;;;;;;;;;1,0;;;;;;;;;;;;1,0;;;;;1,0;;;;;;;;;;;
permit;;;;;;1,0;11,0;6,0;11,0;;;;1,0;;5,0;3,0;;;;;;4,0;;;;;;;2,0;;3,0;;14,0;;16,0;2,0;2,0;;;;17,0;;4,0;;;2,0;12,0;16,0;4,0;20,0;2,0;7,0;;;;;6,0;;1,0;;2,0;3,0;1,0;;;;8,0;;8,0;1,0;;;10,0;;;1,0;;;;31,0;;4,0;;4,0;;;;;1,0;;23,0;;1,0;;;1,0;6,0;;3,0;1,0;;;4,0;20,0;;1,0;15,0;;10,0;;6,0;1,0;;;;3,0;9,0;22,0;5,0;1,0;2,0;1,0;;4,0;;3,0;;;;24,0;;;4,0;;1,0;;;2,0;;;4,0;;;14,0;7,0;;;5,0;4,0;1,0;6,0;;5,0;9,0;3,0;3,0;2,0;;3,0;2,0;;8,0;28,0;;;;4,0;10,0;;;1,0;;;1,0;2,0;2,0;5,0;2,0;;;3,0;4,0;;;;1,0;;;;;;;;10,0;;2,0;;;;4,0;;;;;;;1,0;;;1,0;;;2,0;;2,0;;1,0;;;;23,0;;1,0;2,0;;1,0;;;10,0;;20,0;;;8,0;9,0;1,0;31,0;4,0;;;;;;3,0;;;;;;;8,0;;;;;;;;;;;;;11,0;;;4,0;;2,0;;2,0;;;;;;;8,0;;8,0;7,0;;;;;1,0;;;8,0;;4,0;1,0;5,0;;1,0;;;;;;;1,0;;;2,0;1,0;1,0;;;;;;;1,0;;;;13,0;;5,0;;1,0;;1,0;;;;1,0;;6,0;2,0;6,0;;;;2,0;2,0;;;1,0;;;;;1,0;;1,0;1,0;1,0;;;;;;;;1,0;1,0;;;;;;1,0;;;;1,0;;;;;;;7,0;2,0;4,0;;2,0;20,0;;;5,0;;;;;;;8,0;;3,0;;;;12,0;;;3,0;;;;4,0;2,0;;;;;;;8,0;1,0;;;;;;;;;;1,0;2,0;2,0;;2,0;;3,0;;;;2,0;;1,0;;;;;5,0;;1,0;2,0;2,0;;9,0;1,0;24,0;;;;2,0;1,0;;;1,0;7,0;3,0;;;1,0;;;;;;;2,0;;;2,0;1,0;;;;19,0;;;;1,0;;;;;9,0;;2,0;1,0;;;;;;1,0;;;;;3,0;2,0;;10,0;;;1,0;1,0;;;;;;;3,0;1,0;;;1,0;;;;;;;1,0;10,0;;;;;;;;;1,0;2,0;;;3,0;;;;2,0;1,0;2,0;;;;;;;2,0;;;;1,0;1,0;;;1,0;4,0;1,0;1,0;;;;;11,0;;9,0;;2,0;;;;;;;;;;1,0;;;;;;;;;;;;;;;;;;;;;;;;2,0;;6,0;;;;;;;;2,0;1,0;;;;;;;;;;;;1,0;1,0;1,0;;;;;;;;2,0;1,0;;;;1,0;;;;1,0;;;;1,0;;1,0;;;2,0;;;;;;2,0;;;;;;;2,0;;;1,0;;;;;;;;;;;;1,0;;;2,0;;;;;;;;1,0;;1,0;;;;1,0;;1,0;2,0;;;5,0;1,0;;;;;;;;;;;3,0;;;;;;;;1,0;;;;;;;1,0;;;;;;;;;;;5,0;;1,0;;;;5,0;4,0;;;;;;;;;1,0;;;;;;;;;;;1,0;;;;1,0;1,0;3,0;;;1,0;;;;;2,0;;2,0;;;;;;;;;;;;;;;;;;;;;1,0;;;;;;;;;;;;;;;;;;;;;;;;;;;;;;;;;;;;;;;;1,0;;2,0;;;;;;;;;;;;;;;;1,0;;;;;;;2,0;2,0;;;;;;;1,0;;;;;;;;;7,0;;;;;;;;;;1,0;;;;;;1,0;1,0;;;;;;;;;;;1,0;;;;;;;;3,0;;;;;;;;;;;;9,0;;;;;;;;;;;;;;;;;;;;;;;;;;;;;;;;;;;;;;;;;;;;;;;;;;3,0;;;;;;;;;;;;
perspective;;;;;;6,0;;1,0;4,0;;1,0;;3,0;;9,0;15,0;;;;1,0;;4,0;6,0;;;;6,0;11,0;;;5,0;;6,0;;9,0;;13,0;3,0;;;16,0;;2,0;1,0;;2,0;10,0;31,0;2,0;63,0;;3,0;12,0;3,0;;;;;4,0;;;6,0;3,0;;3,0;;1,0;2,0;31,0;;3,0;;11,0;;;4,0;14,0;;;70,0;;1,0;;3,0;;;;;;1,0;5,0;;;;1,0;;;;34,0;1,0;2,0;13,0;;28,0;;;6,0;;1,0;6,0;;15,0;;;;10,0;11,0;8,0;;;1,0;;;1,0;5,0;;;;;;;13,0;5,0;1,0;3,0;;1,0;4,0;;;6,0;;;2,0;;;;1,0;;;;;;;;;12,0;;4,0;;2,0;;1,0;;2,0;;9,0;78,0;;;;;1,0;;;4,0;;;;;;;;;;;;3,0;;;;;;;;;;;;;;;;;;;;;;;;;;;;;;;;2,0;;;;;;;;;1,0;;;;;;;;3,0;;;;;;;3,0;;;;2,0;1,0;14,0;;;;;;;20,0;;;;;;1,0;2,0;;;4,0;;;;;;3,0;;;;;;;7,0;;;;;;1,0;;;;;1,0;;;;2,0;;;;;;;;;;2,0;;;;1,0;;;;;;;1,0;;;1,0;;;;4,0;;;;;;;;;;;;;;2,0;;;;;;;;;;;1,0;11,0;1,0;;2,0;;;;;3,0;16,0;4,0;;4,0;;;;;;;;;2,0;;;;;;;;;3,0;;;;;;;;;;;;1,0;1,0;;;;;;;;;;;;;;;;;;;2,0;;;;3,0;;;;;;;1,0;;;1,0;;;3,0;;2,0;;;;;4,0;;6,0;1,0;;;;2,0;6,0;;1,0;;;;4,0;;;;;1,0;;5,0;;2,0;;;;;;1,0;;;;;;2,0;;;;;8,0;;;;;;1,0;3,0;;15,0;;;2,0;;;5,0;;11,0;;;;;;;;;;;;;;;11,0;;;;;;4,0;;;;;;;;;;;;;7,0;;;;;;;;;;;;;;;;;;;;1,0;;;;;;;;2,0;;;;;;;;;;;;;;;;;;;;;1,0;;;;;;;;;;;;;10,0;;;;;;;;;;;;;;;1,0;;;;1,0;;;;;1,0;;;;;1,0;;;1,0;;1,0;;3,0;;;;;;;;;;;;;;;;;1,0;;;;;;;;42,0;;;;;;;;;;;;;;;;;;;;;;;;;;;;;;;;;;;;;9,0;;4,0;;;;2,0;;;;;;;;;;;;;;;;;;;;;;2,0;;;;;;;;;;;;;;;;;;;;1,0;;;;;;;;;;1,0;;;;;;;;;;;;;;;;;;;;;;1,0;;;;;;;;;;;;;;;;;;;;1,0;;;;4,0;;5,0;;;;;;1,0;;;4,0;;;;;;;;;;1,0;;;;;;;;;;1,0;;;;;;;;;;;;;;;;;;;;;;;;;;;1,0;;;3,0;;;;1,0;;;;;;;;;;;;;;;;;;;;;;;;;;;;;;;1,0;;;;;;;;;;;;;;;;;2,0;;8,0;;;;;;1,0;;;;;;5,0;;;;;;;;;;;;;;;;;;;;;;;3,0;;;;;;;;;;;;;;9,0;;;;;;;;;;;;4,0;;;;;;;;;;;;;;;3,0;;;1,0;;;;;;;;1,0;;;;;;;;
phone;;;;;;2,0;;40,0;2,0;1,0;1,0;;23,0;;1,0;5,0;;;;;;35,0;;;;;;3,0;;5,0;18,0;;14,0;;24,0;16,0;;;;;20,0;;;;9,0;;14,0;110,0;75,0;21,0;1,0;;4,0;;;2,0;2,0;;;9,0;;1,0;;;1,0;;4,0;5,0;;;34,0;;5,0;;;2,0;;;3,0;63,0;1,0;12,0;2,0;52,0;;2,0;;;;;13,0;;;;1,0;1,0;7,0;;51,0;204,0;3,0;;18,0;4,0;;27,0;1,0;;54,0;;3,0;5,0;;;;3,0;3,0;3,0;10,0;;;;2,0;5,0;30,0;6,0;;;;;;4,0;1,0;1,0;;;1,0;5,0;;;;3,0;2,0;20,0;1,0;;;;7,0;1,0;;;21,0;17,0;1,0;1,0;43,0;;;19,0;3,0;16,0;29,0;;;;15,0;2,0;;;;;;;;;;;;;2,0;13,0;;;;2,0;;6,0;;;;;;7,0;;1,0;26,0;;;;;;;;;;;;5,0;2,0;;5,0;;;;;1,0;;;6,0;9,0;;;;;2,0;;;;1,0;1,0;;7,0;4,0;;;5,0;3,0;;;;;;;;;;1,0;;;;;;1,0;;;26,0;;;4,0;;;;19,0;;8,0;2,0;;18,0;;;1,0;;;;1,0;3,0;1,0;1,0;2,0;;;20,0;;;4,0;;7,0;2,0;;;;;;2,0;;;;;;;11,0;10,0;;;;;;;;;3,0;1,0;;2,0;;;5,0;;4,0;;;;;1,0;1,0;;;;1,0;;;;6,0;;8,0;;;;;;;;14,0;1,0;2,0;;;2,0;;;;;;;;;;25,0;;;;;;;;;;;;;;2,0;;1,0;;1,0;3,0;;6,0;;;;;;;;;;12,0;;;;;;1,0;;1,0;;;;1,0;1,0;;;;;;;4,0;;;10,0;;6,0;4,0;;;;;;2,0;;1,0;;;;6,0;;;6,0;4,0;6,0;;20,0;;4,0;4,0;55,0;;1,0;5,0;;;19,0;12,0;2,0;;2,0;;;;;;;7,0;1,0;;;1,0;;5,0;10,0;;;;21,0;;1,0;;;;2,0;;23,0;1,0;3,0;;;;;;;;1,0;;;;3,0;;;;;2,0;;;15,0;;35,0;;;2,0;;;22,0;;;;;;;27,0;;262,0;2,0;1,0;;;;;1,0;62,0;7,0;;;;2,0;;;2,0;5,0;;;18,0;;;10,0;;1,0;;;;;;2,0;1,0;1,0;2,0;;3,0;;;;;4,0;;;8,0;;6,0;;;133,0;;;9,0;13,0;31,0;5,0;2,0;3,0;7,0;2,0;;;20,0;;;;;;2,0;;;;;1,0;;;;;3,0;;1,0;5,0;;10,0;;;;2,0;2,0;5,0;4,0;;;;;;;;;;;7,0;;;;1,0;;;;;;;;;;;;9,0;;1,0;;;;;;18,0;1,0;;;1,0;;2,0;;;;;24,0;;99,0;;;;1,0;;4,0;;;2,0;;;1,0;;;1,0;2,0;2,0;;2,0;;;;5,0;;;;;1,0;;2,0;;;;;;;;1,0;;;;;;4,0;1,0;;;;;;2,0;;;;;;;1,0;;;;;;2,0;;;;;;;;;;;;;;;;1,0;;;;;2,0;;;1,0;;;1,0;;;;1,0;;;;;;;;;;;;2,0;;;;;;2,0;1,0;;;;3,0;;2,0;;;;;;;;;;1,0;;;;;;;;1,0;;;;2,0;;;;;;;;;;;;;;;;1,0;;;;1,0;;;;;;;1,0;;1,0;;;;;;;;;;;;;;;;;;;;1,0;;;;2,0;;;;;;4,0;;;;;;;;;;;6,0;;;;;;;;2,0;;;;;;;;;;;;7,0;;;;;42,0;;;;;;;;;;;2,0;;;;;2,0;;;;;;;;;;;;;1,0;;;;;;;1,0;;;;;;;;;;;;;;;;;;;;;;;;2,0;;;;;;;;;5,0;;;;;;;;;;;;;;;;;;;;;;;;;;;;;;;;;;;;;;;;;;
picture;;;;;;2,0;;54,0;23,0;3,0;5,0;;21,0;;1,0;31,0;;21,0;20,0;4,0;;208,0;;;;;36,0;5,0;;;5,0;6,0;88,0;2,0;31,0;20,0;;1,0;9,0;;105,0;;;44,0;12,0;5,0;86,0;152,0;71,0;133,0;2,0;4,0;;2,0;8,0;25,0;100,0;;;;;4,0;23,0;8,0;19,0;3,0;11,0;6,0;93,0;;1,0;;38,0;9,0;1,0;46,0;2,0;7,0;1,0;333,0;1,0;30,0;6,0;139,0;1,0;4,0;;12,0;;2,0;16,0;;;;4,0;7,0;56,0;7,0;147,0;13,0;;4,0;53,0;19,0;;7,0;18,0;;114,0;97,0;1,0;23,0;;;11,0;62,0;14,0;55,0;3,0;40,0;2,0;;11,0;39,0;74,0;3,0;1,0;;;2,0;12,0;99,0;6,0;9,0;6,0;51,0;3,0;20,0;5,0;;29,0;;7,0;46,0;37,0;3,0;;3,0;202,0;118,0;5,0;;34,0;63,0;18,0;16,0;53,0;;;17,0;7,0;27,0;86,0;45,0;1,0;;70,0;13,0;12,0;;9,0;;;6,0;25,0;5,0;;1,0;;;6,0;15,0;;;;20,0;;12,0;;;2,0;4,0;;4,0;3,0;;8,0;;;4,0;;;15,0;11,0;;;;2,0;5,0;1,0;2,0;;;;;;;1,0;1,0;2,0;4,0;;;;3,0;;;;36,0;;;;6,0;6,0;2,0;4,0;2,0;4,0;10,0;;;4,0;;17,0;;;;;38,0;3,0;1,0;;;3,0;;15,0;39,0;2,0;;;;;;48,0;;;1,0;2,0;12,0;;;7,0;3,0;;;;;;1,0;1,0;32,0;;6,0;;;33,0;3,0;8,0;;4,0;7,0;4,0;;;2,0;;2,0;;;;;8,0;;;;;;22,0;;;;11,0;;;7,0;;;2,0;;5,0;;;;2,0;;;;;;;;;;;;1,0;2,0;;1,0;;;;;2,0;;;;3,0;2,0;1,0;;;57,0;2,0;;;3,0;19,0;2,0;;3,0;;;;;;;;;;;;;6,0;;;;;3,0;;;;1,0;;;;;;;6,0;3,0;43,0;12,0;;;4,0;;4,0;;;;2,0;7,0;1,0;;;6,0;;4,0;23,0;18,0;106,0;9,0;;33,0;;1,0;1,0;1,0;;1,0;4,0;3,0;7,0;;;2,0;7,0;1,0;;;17,0;1,0;;11,0;;1,0;2,0;96,0;;1,0;121,0;164,0;;4,0;5,0;18,0;1,0;6,0;;3,0;;;;3,0;20,0;7,0;1,0;;40,0;;6,0;;1,0;1,0;1,0;9,0;;9,0;18,0;;;4,0;;92,0;2,0;4,0;;;;9,0;3,0;3,0;13,0;1,0;;;4,0;5,0;9,0;2,0;23,0;10,0;10,0;;;21,0;1,0;16,0;;4,0;;22,0;37,0;;2,0;;;34,0;1,0;11,0;28,0;2,0;5,0;1,0;;;2,0;2,0;3,0;1,0;15,0;2,0;2,0;1,0;33,0;1,0;;;;;;3,0;;;;30,0;6,0;2,0;;;;1,0;;13,0;20,0;5,0;6,0;;;;5,0;;;1,0;1,0;;2,0;;5,0;;4,0;6,0;13,0;;13,0;;7,0;6,0;2,0;14,0;2,0;;;;15,0;;9,0;1,0;;;1,0;3,0;;43,0;4,0;;;;11,0;6,0;;;;2,0;;17,0;12,0;;1,0;2,0;;2,0;1,0;;1,0;2,0;;;;1,0;2,0;;;;;;;10,0;3,0;;2,0;;1,0;3,0;4,0;48,0;;;2,0;;;;;2,0;1,0;4,0;;;1,0;5,0;3,0;;1,0;;3,0;1,0;;;1,0;;3,0;6,0;;;;5,0;;;2,0;;4,0;2,0;1,0;;;;1,0;;;;;2,0;4,0;2,0;;;10,0;1,0;;1,0;;3,0;;;16,0;1,0;10,0;;;;;;3,0;;;;;7,0;;;;6,0;;2,0;;;6,0;;;;;;1,0;;;;1,0;;;;1,0;;;37,0;;;2,0;;9,0;2,0;;8,0;;;6,0;;;;1,0;7,0;;;4,0;;;;;;;;1,0;;;;2,0;;;3,0;2,0;;;;1,0;25,0;1,0;;;;70,0;;1,0;;5,0;;;4,0;;1,0;3,0;;17,0;;;;3,0;7,0;;3,0;32,0;6,0;2,0;;;;;;1,0;;1,0;2,0;2,0;;1,0;;1,0;;;1,0;1,0;1,0;4,0;;45,0;;;3,0;;;;;;1,0;6,0;9,0;;;;;;;4,0;;;16,0;;;;;;;3,0;;;4,0;;9,0;21,0;;2,0;5,0;4,0;3,0;1,0;1,0;4,0;;;6,0;;1,0;8,0;4,0;;3,0;2,0;;;;;;2,0;3,0;;;;;1,0;;;;;;;2,0;1,0;;9,0;;;;2,0;16,0;;;;;;1,0;2,0;4,0;;1,0;;159,0;;;2,0;;;;;;;;;;;;;;;;7,0;;4,0;;;;;;;18,0;3,0;1,0;;;;;2,0;;;;;;;;;6,0;;;10,0;;;;;;4,0;;;5,0;2,0;;;4,0;;15,0;1,0;;;;;;;2,0;;;;;;;;;10,0;;;4,0;;;;2,0;;5,0;;;;;;1,0;
piezoelectric;;;;;;2,0;2,0;7,0;;15,0;;;3,0;;35,0;42,0;;;;;;2,0;;;;3,0;;2,0;;;;;32,0;;21,0;;;;1,0;;;;6,0;3,0;2,0;;;31,0;;;52,0;1,0;;2,0;64,0;4,0;331,0;;;;7,0;2,0;;;1,0;;1,0;16,0;12,0;1,0;;;9,0;;;18,0;;;;25,0;;2,0;;43,0;2,0;;;;;1,0;77,0;;;14,0;;;1,0;;7,0;;;4,0;116,0;;;7,0;10,0;;2,0;;;2,0;;;;40,0;57,0;12,0;11,0;7,0;1,0;;;;3,0;;;;;;;;11,0;;;;;;;;;;;18,0;;;;7,0;9,0;3,0;;2,0;;;;13,0;4,0;;;6,0;;8,0;59,0;;1,0;;;;;;;;1,0;5,0;2,0;22,0;2,0;58,0;;;7,0;88,0;;4,0;;16,0;;;;;4,0;2,0;;27,0;;31,0;;;;1,0;2,0;1,0;1,0;100,0;2,0;15,0;2,0;;;48,0;4,0;;23,0;;;;3,0;;;10,0;9,0;;7,0;;;;;;;;328,0;;;36,0;21,0;24,0;5,0;2,0;26,0;2,0;;;;;;;;;;1,0;35,0;;;;;1,0;46,0;;;;16,0;;;;;1,0;10,0;;;;2,0;;10,0;;;16,0;;2,0;;25,0;;;;8,0;;;;4,0;;;;;22,0;;1,0;;5,0;;;15,0;329,0;;5,0;;;;;;4,0;;;;;4,0;;;;;;9,0;;;;;155,0;;5,0;2,0;;;;;;;;;;6,0;;13,0;6,0;;2,0;;;5,0;;43,0;19,0;;2,0;6,0;;;;4,0;;;2,0;;;;;12,0;4,0;;;;2,0;;;;;;;;;;7,0;3,0;;;4,0;23,0;5,0;;19,0;;1,0;49,0;;1,0;;;;10,0;;1,0;;;;;;;;;;;;3,0;;;;;;1,0;;;;;;;2,0;;;;;;;;;;;10,0;;;;;2,0;;;9,0;27,0;;;;;;;;;;;;;;;;;;;;;;1,0;3,0;;;;;;2,0;;;;;;;29,0;;2,0;;;4,0;;;;;;;;;;;;;;;;;10,0;;;;;;;;;;;;;;;;;;;;;;;;;;;;;;;;;;;;;;;2,0;;5,0;;;;;5,0;;;;;;;;;;;;;;;;;;1,0;;4,0;;;;;;;;;;;;;;;;;;;;;;;;;;;1,0;2,0;;;;;;;;;;;;;;;;;;;;;;;;;;;;;;;;;;;;;;;5,0;;;;;;;;;;;;;;;;2,0;4,0;;;2,0;;;;;;;;;;;;;;;;;3,0;6,0;;;;;;;15,0;;;;;;;;;;;;;;;;;;;;4,0;;;;;;;;;2,0;;;;;;1,0;;;;;;;1,0;1,0;;;;2,0;2,0;;;2,0;;;;;;;;;;;;5,0;;;;;;12,0;;;;;;;;7,0;;;;;;;;;;;;;;;;16,0;;;;;;3,0;;;;;;;;;;;;;;;;1,0;;;;;;8,0;2,0;;;;;;;38,0;;;;;;;;;;;;;;;;;;;;;;;;;;;;;;;;;;;;;;;2,0;;;;;;;;;;;;;;;;;;4,0;;;;;;;;;;;;;;;;6,0;;;;;;;;;;3,0;;;;;;;;;;;;8,0;;;;;2,0;;7,0;6,0;;;;;;;;;;;;5,0;;;;;;;;;;;;;;;;;;;;;;;;;;;7,0;;;;1,0;;;;;;;;;;;;;;;;;;;;;;;;;;;;;;;;;;;;;;;;;;;;;;
pitch;;;;;;146,0;;5,0;11,0;;15,0;;1,0;;18,0;8,0;;;;;4,0;2,0;5,0;;1,0;;2,0;;;1,0;;;3,0;;3,0;1,0;1,0;3,0;;;5,0;;;11,0;3,0;;32,0;7,0;5,0;5,0;5,0;;;;;;19,0;;19,0;;3,0;1,0;;;2,0;;5,0;3,0;1,0;3,0;1,0;4,0;2,0;;1,0;1,0;11,0;;;44,0;;;;15,0;1,0;;;;;2,0;21,0;;;;;;1,0;;27,0;;;;6,0;6,0;;1,0;6,0;;2,0;12,0;;1,0;;;;9,0;7,0;4,0;;31,0;2,0;;;2,0;3,0;;;;;1,0;;2,0;4,0;;4,0;1,0;;;;4,0;2,0;;;25,0;19,0;;;;1,0;2,0;;;;2,0;;;10,0;;4,0;;;;6,0;1,0;3,0;;;;;;4,0;;;;;6,0;3,0;1,0;;;;;;;;;;4,0;;;;;;;;;;;;;;;3,0;35,0;;;;;;3,0;;;;;;;2,0;;;;;;2,0;;;;;;2,0;;1,0;;;7,0;;2,0;10,0;;;;;;1,0;1,0;;;1,0;;37,0;2,0;;;;;;;1,0;;;;;;;;;4,0;;4,0;;;;;11,0;;;;;2,0;4,0;11,0;;;;;;11,0;;;;;30,0;8,0;5,0;;1,0;;;;;;;;;;1,0;;;2,0;;;;;;4,0;2,0;;;1,0;;;;;;;;;;;;;;;;;;;2,0;;;;;1,0;;;;;;;;;;;;4,0;;;;8,0;;1,0;;;;;;;;;;;;;;;;;;;1,0;13,0;6,0;;;;;;;;3,0;2,0;;2,0;;;13,0;;;4,0;;;3,0;;;1,0;;;;8,0;;11,0;35,0;;;;;4,0;;;1,0;;;;1,0;;;;2,0;;;1,0;;3,0;;;;;;;;;;5,0;1,0;;;1,0;2,0;;10,0;;3,0;;;;;10,0;;1,0;61,0;;1,0;;;;;;1,0;;3,0;;;;;3,0;;;8,0;6,0;3,0;;2,0;;;11,0;;;;;;1,0;;;;;;;;;;;1,0;;;;;4,0;;;;;;;;;;;;;;;;;;3,0;;;;;;;;;3,0;;;;3,0;;1,0;;;;;;;;;;;;;;;;;5,0;;;;;;;9,0;2,0;;;;;;;;;;;1,0;;;;;;;;;;;;;;;;;;;;;;;;;;2,0;;;;;3,0;;;;;1,0;;;;;;;;;;1,0;;;;;;1,0;;;;;;;;;;;;;;;;;;;;;;;;;;;;;;;1,0;;;;;;;1,0;;;2,0;;;;;;;;;;;;;;;;;;4,0;;;;;;;;;;;;;1,0;;;;;;;1,0;;;;;;;;;;;;;;;;;;;;;;5,0;2,0;6,0;;;;;;;;;;;;;;;;;;;;;;;;;;;;;;;;1,0;;;;;;;;;;;;;;;;1,0;;;;;;;;;;;;;;;3,0;;;;;1,0;;;;;;3,0;;;;;6,0;;;;;;5,0;;;;;;;6,0;;1,0;;;;;;1,0;;;;;;;;;;;;;3,0;;;;;;;;;;;3,0;;;;;;;;;;;;;;;;7,0;;;;;;;;;;;;;;;;;;;;;;;;;;;;;;;;;;;;;;;;;2,0;;;;;;2,0;;;;;4,0;;;;;;4,0;;3,0;;3,0;;;;;;;;;;;;;2,0;;;;;;;;;;;;;;;8,0;;;;;;;;;1,0;;;;;;;;;;;12,0;;;;;;;;;;;;;;;;;;;;
polarize;;;;;;20,0;;2,0;12,0;9,0;5,0;;;2,0;2,0;;14,0;;;;;6,0;1,0;;;;9,0;;;;;;4,0;;1,0;6,0;;;;;2,0;;1,0;;14,0;1,0;;4,0;;1,0;7,0;1,0;;;;;14,0;;;;;;;;105,0;;8,0;3,0;14,0;4,0;;4,0;;;;15,0;3,0;1,0;;119,0;1,0;3,0;;13,0;;;;;;;13,0;;;;3,0;;;;21,0;;;;1,0;15,0;2,0;;29,0;;8,0;;6,0;;;;;2,0;;1,0;;;;6,0;;;6,0;;;;;;;;2,0;1,0;1,0;1,0;1,0;;;;;;;5,0;;;;;3,0;;;1,0;;;;;9,0;;;;;1,0;10,0;;;;;11,0;1,0;2,0;;;;;;;;;;;;2,0;;;;;1,0;84,0;;;;;;;;;;;;1,0;;;;14,0;;;;;;4,0;2,0;;;;2,0;;;;;;;42,0;;;;;1,0;;236,0;;4,0;;1,0;;;;;;;;;1,0;1,0;;5,0;;;;1,0;11,0;8,0;33,0;;;;;13,0;31,0;;;;;;;;;;;2,0;;;22,0;;;;;;;;6,0;;;;;;;;;;;;1,0;;;;;;;;;;12,0;;;;;;3,0;;;;;;;;;;;;1,0;;;;2,0;;;;;;2,0;;;;;;;;12,0;;;;;1,0;;;;;;;;;;;;4,0;;;;;;;2,0;;;;4,0;;;;14,0;;;;;;;;;5,0;8,0;;;6,0;;;;;;;;;7,0;;;;;2,0;;;;;;;;;;;;1,0;;6,0;;;;;;4,0;;2,0;;;;13,0;;;;;;;;;2,0;;7,0;;;;;;;1,0;;1,0;;;;;;4,0;;;;;;;;;;;;2,0;;;;;;;;;;;;;;;;;;;;;;;1,0;;;;;;;;;;1,0;;;;;1,0;;1,0;;;;3,0;;2,0;;;;;;;;;;;;;;;;;;;;;;;;;;;;;;;;;;;2,0;;;;;;;;;;;;;;4,0;;;;;;;;;;;;1,0;;;9,0;;4,0;;;1,0;;;;;;;;;;;;;;;;;;;;;;;6,0;;1,0;;;;;;;;;;;;;;;;;;;;;;;;;;2,0;;;;;;;7,0;;;;;;;;;;2,0;;;;;;;;;;;;;;;;;;;;;4,0;;1,0;6,0;1,0;;;;;;;;;;;;;;;;;3,0;;;;;;;;;;1,0;;;;;;;;;;1,0;;2,0;;;;;;;;4,0;;;;;;;;;;;;;2,0;;;10,0;2,0;;;;;;;;;;;;;;;12,0;2,0;;;;;;;;;;;;;;;;;;;;;;;1,0;;;;;;;;;;;4,0;2,0;1,0;;;;;;;;;;;;;;;;;;;;;;;;;;;;;;;;;;;;;;;;3,0;;;;;;;1,0;;;;;;;;;8,0;;;;2,0;;;;;;;;;;1,0;;;;;;1,0;;;;;;;;;;;;;;;;;;;;;;;;;;;;;;;4,0;;;;;;;;;;;;;;;1,0;1,0;;;4,0;;;;;;;;;;;;;;;;;;;;;;;;;;;;;;;;;;;;;;;;;;;;;;;;;;;;;;;1,0;;;;;;;;2,0;;;;;1,0;;;;;;;;;;;;;;;;;;;;;
pole;;;;;;3,0;;17,0;;12,0;;;;;23,0;34,0;;;;;;;;;;;;;1,0;;1,0;;14,0;;10,0;4,0;;;;;2,0;;4,0;;2,0;3,0;;6,0;;;24,0;;;;1,0;;1,0;;;;42,0;;4,0;;10,0;;;13,0;67,0;;;;1,0;;;;;;;23,0;;;;14,0;;;;;;2,0;10,0;;;5,0;;;;;1,0;1,0;;;39,0;;;;5,0;;1,0;;7,0;;;;2,0;25,0;13,0;40,0;3,0;2,0;1,0;;;;;1,0;;;;;;;4,0;;;;2,0;;;;;;;14,0;;;;8,0;;4,0;;;;;;;47,0;;;;;;20,0;;;;;5,0;;;;;;14,0;;;18,0;;;;3,0;15,0;;;;7,0;;18,0;;;;;;72,0;;2,0;;;;1,0;4,0;;;21,0;;8,0;;;;28,0;;;;;;;3,0;;;41,0;3,0;2,0;7,0;;;;;;11,0;;27,0;;2,0;15,0;19,0;3,0;;;32,0;15,0;;;;;;;;;;2,0;19,0;;5,0;;;;6,0;;;;;;1,0;;;;3,0;;1,0;2,0;;;4,0;;;2,0;;10,0;;5,0;;;1,0;;2,0;;;;;7,0;;;;;2,0;;2,0;;1,0;;21,0;;43,0;2,0;;1,0;;2,0;2,0;5,0;;;;20,0;;;;;;5,0;;;;18,0;;;5,0;;;;3,0;;;;;;;134,0;;4,0;;;5,0;;;;1,0;1,0;7,0;;;8,0;;;2,0;;1,0;;2,0;86,0;;;;3,0;1,0;;;;3,0;;13,0;;;;3,0;;1,0;6,0;22,0;8,0;3,0;;;10,0;;;1,0;;1,0;27,0;;10,0;;2,0;5,0;;;;1,0;;;;;;;;;11,0;;;2,0;;;;;;;;;;;;1,0;;;;;;;;;;;2,0;2,0;;;;;;;1,0;3,0;;;;;;1,0;;;;;;;;8,0;;;;7,0;4,0;;;;6,0;;;;;;;;;2,0;;;;;;3,0;8,0;;53,0;;;;;;;;;;;;;;;;;11,0;;;4,0;2,0;;;;;;;;;;;;;;;;;;;;;;;4,0;;;;;;2,0;;;;;;2,0;;118,0;;;;;;;;;;;;;;;;;4,0;;;;;;1,0;;;;;;;;2,0;;5,0;;1,0;2,0;;;;;;;;;;;16,0;;;;;;2,0;;;;;;3,0;;;;;;;;;;;;3,0;;;;;;;;3,0;;;;;;3,0;;;;;;;1,0;;;;;;;;;;;;;;;;;;;;;4,0;2,0;;1,0;;;4,0;;;;;;;11,0;;;;6,0;;;;;;1,0;2,0;;3,0;;;;;;;10,0;;;;;;;;;;;1,0;;;;3,0;;2,0;;;;;;;;;6,0;;;;;1,0;;;;;;;22,0;60,0;;;2,0;;;;;;;;;;;;;1,0;;;;;1,0;;;;;;;;;;;;;;;;;;;;;;;;;;;;;;;;;;;;;;;;;;;;;;;;;;;;;;247,0;;;;;;2,0;;;;;;;;;;;;;;;;;;2,0;4,0;;;;;;;;;;;2,0;12,0;;;;;;;;;;;;;;;;;;;;;;;;;;1,0;;;;;2,0;;;;;;2,0;;;6,0;;21,0;;;;;;4,0;;;;;;1,0;;;;;;;;;;;;;;15,0;;;;2,0;;8,0;1,0;;;;;;;;;18,0;;5,0;;;;;;;;;;1,0;82,0;;;;;;;;;;;;;;;;;;;;;;;;;;;;;;;;;;;;;;;;;;;;;;;;;;;;;;;;;;;;;;;;
posture;;;;;;7,0;;8,0;;;;;;;;31,0;;;;2,0;3,0;;;;;;;;;;;1,0;14,0;;;;;;;;;;3,0;;11,0;;18,0;1,0;;3,0;;8,0;;;4,0;;;;60,0;;;;;;;;;;;2,0;3,0;;;;;;;2,0;;12,0;;;;1,0;;;;;;;3,0;;;;;;3,0;;4,0;;;;;5,0;;;;;;3,0;;1,0;;;;3,0;3,0;17,0;;2,0;;;;;;;;;;;;8,0;4,0;;;;;;;1,0;;;;3,0;;;;;;;2,0;;;;;;2,0;;;;;;43,0;8,0;;;;;;;;;;;7,0;4,0;;;;;6,0;8,0;;;;;;11,0;;;;;;;;;;;;1,0;;24,0;8,0;;6,0;;;;;;;;;;;;;;;;;;;;;;;;;;;;;14,0;;;3,0;;;8,0;;2,0;;;;;;3,0;;;;;;;;;;;;;;;;;;;;;;;;;;;;;;;;8,0;;;;;;2,0;;;;;18,0;7,0;;;;;;;;;;;1,0;;;;;;;;;;;;;;;;;;;;;;;;;;;;;;;;;;;;;;;;;;;;;;;2,0;;;;;;;;7,0;;;;2,0;;;;;;;;;3,0;;;;;;;;;6,0;;;;;2,0;;;;;;;;;;;;;4,0;;;1,0;;;;;;;;;11,0;;;2,0;;2,0;;;;;;;;2,0;;;;;;;;;;;;;;;10,0;;;1,0;;;;;;;;;;;;;;;2,0;;;;;;;;;;;;;;;;;;;;;1,0;;;;3,0;;;;;;;;;;;;;;;;;;;1,0;;;;3,0;;;;;;;;;;;;;;;;;;;;2,0;;;;;;;;;3,0;;;;;3,0;;;;;;;;2,0;;;;;;;;;;;;;;;;;;;;;;;;;;;;;;;;;;;;;;;;;;;;;;;;;3,0;;;;;;;;;;;;;;;;;;;;;;;;;;;;;;;1,0;1,0;;;;;;;;;;;;;;;;;;;;;;;;;;;;;;;;;8,0;;;;;;;;;;;;;;;;;;;;;;;;;;6,0;;;;;;;;;;;;;;;;;;;;;;;;;;;;1,0;;;;;;;;;;;;;;;;;;;;;;;;;;;;;;;;;;3,0;;;;;;;;;;;;;;;;;;;;;;;;;;;;;;;;;;;;;;;;;;;;;;;;;;;;;;;;;;;;;;;;;;;;;;;;;;;;;;;;;;;;;;;;;;;;;;;;;;;;;;;;;;2,0;;;;;;;;;;;;;;;;;;;;;;;;;;;;;;;3,0;;;;;;;;;;;;;;;;;;;;;;;;;;;;;;;;;;;;;;;;;;;;;;;;;;;;;;;;;;;;;;;;;;;;;;;;;;;;;;;;;;;;;;;;;;;;;;;3,0;;;;;;;;;;;;;;;4,0;;;;;
press;;;;;;2,0;;3,0;;;;;1,0;;3,0;;;;;1,0;;6,0;1,0;;;;;;;;1,0;;22,0;;4,0;12,0;;4,0;;;3,0;;2,0;;10,0;1,0;2,0;11,0;3,0;10,0;1,0;;;;;5,0;2,0;;;;;;;;;1,0;12,0;13,0;4,0;1,0;2,0;2,0;;;;1,0;;;;9,0;;1,0;;5,0;;2,0;;;;1,0;12,0;;;3,0;;1,0;;;18,0;1,0;;;8,0;;;7,0;6,0;;;;;5,0;;;;3,0;28,0;23,0;;8,0;1,0;;;;1,0;;;;;2,0;;;4,0;;;;4,0;2,0;;;;2,0;1,0;4,0;;;;10,0;9,0;;;;2,0;2,0;1,0;;3,0;;;1,0;;1,0;7,0;;;;;1,0;;;;2,0;;;8,0;5,0;2,0;1,0;;;2,0;8,0;;;;;;1,0;;;;1,0;;1,0;;14,0;;;;1,0;10,0;;;11,0;;11,0;1,0;;;3,0;;;5,0;;;;1,0;;;5,0;13,0;;3,0;;;;;2,0;1,0;;57,0;6,0;20,0;1,0;17,0;19,0;;2,0;2,0;4,0;;;;2,0;;;;;;2,0;8,0;;;;3,0;;4,0;;;;5,0;;1,0;1,0;;;3,0;1,0;37,0;;1,0;;;;;10,0;2,0;4,0;9,0;23,0;10,0;;8,0;3,0;;8,0;;;;;;1,0;;;;;;;;2,0;;1,0;;;;1,0;3,0;;;;;6,0;4,0;;1,0;;;4,0;;3,0;;;;4,0;;;;;2,0;;1,0;;;;;;;;4,0;5,0;1,0;5,0;1,0;;;1,0;4,0;6,0;2,0;;;;;;;1,0;;1,0;2,0;;;2,0;;;;;;;13,0;;;2,0;;;;1,0;4,0;;1,0;2,0;;1,0;;3,0;1,0;;;2,0;2,0;;;;;;;;;;;;;;;1,0;;;;;;;;;;;;;;2,0;;;;;;;1,0;;;;;;;3,0;;1,0;;;;;26,0;;1,0;;4,0;;;2,0;26,0;;;;;;;;;;1,0;;;;;;;;;;1,0;;;;;;7,0;;16,0;;;;;4,0;1,0;1,0;;5,0;;;;;;;;;;;;;1,0;1,0;3,0;;;;1,0;8,0;3,0;;;;;;;;;;;1,0;14,0;;;;;2,0;1,0;;;;;;;;;;;;;;4,0;;;;;;;;3,0;1,0;;;;2,0;;;;;;;;;1,0;66,0;;;;;;;;;;;;;;;;5,0;;;;;;;;;;;;;;;;;;;;2,0;;;;1,0;;;;;;;;;;;;1,0;1,0;;;;;;;;;;;;1,0;;1,0;;;;;2,0;;;;;;1,0;;;;;;;;;;1,0;;;6,0;;;;;;;;;;1,0;;;;;;;;;;;1,0;;;;;;;;;8,0;;1,0;;;;;;;;;;;;;;;;;;;;;;;;;2,0;;;;;;;;;;;;;;2,0;;;;7,0;3,0;1,0;;2,0;;;;;;;;;;2,0;;;;;;;;;;;;;1,0;3,0;;1,0;;;;;;;;;;1,0;;;;;;;;;;;;;;;;;;;;;;;;;2,0;;;;;;;;;4,0;;;;;;;;;;;;;;;;;;;;;;;;;;;;;;;;;;;;;;;;;;;;;;;;1,0;;;;;;;;;;;;;3,0;;;;;;;;;;;;;8,0;;;;2,0;;1,0;2,0;;;;;;;;;;;;;;;;;;;;;;6,0;;;;;;;1,0;;;;;;;;;;;;1,0;;;;;;;;;;;;;;;;1,0;;;;;;;;;;;;;;;;;;;;;;;;;;;;;2,0;;;;;;;;;;;;;;;;;;;;;;;;;;;1,0;;;;;;
pressure;;;;;;5,0;;2,0;2,0;1,0;;;;;1,0;;;;;;;;1,0;;;;;;;;;;30,0;;23,0;;;;7,0;;;1,0;1,0;2,0;6,0;;;23,0;;2,0;1,0;;;;7,0;2,0;9,0;;;;5,0;;;;;;;2,0;;;;;3,0;;;;;1,0;;5,0;;1,0;;13,0;4,0;;;;;;15,0;;;2,0;;1,0;;;7,0;;;;23,0;;;;1,0;;35,0;;;;;;;7,0;63,0;16,0;3,0;4,0;1,0;;;;;;;;;2,0;;4,0;14,0;;;;1,0;1,0;;;;;;18,0;;;;;5,0;;;;2,0;2,0;;;11,0;;;;;4,0;7,0;;1,0;;;2,0;;1,0;;2,0;;;8,0;55,0;3,0;12,0;;;;14,0;;;;;;11,0;;;1,0;5,0;;1,0;;45,0;;1,0;1,0;6,0;;;3,0;14,0;;13,0;4,0;;;12,0;;;20,0;;;;;;;11,0;9,0;;;;;4,0;;;5,0;;37,0;;;3,0;11,0;7,0;6,0;2,0;1,0;4,0;;;;;;;;;;;7,0;;;3,0;;;16,0;;;;;4,0;;1,0;;;;;;;;7,0;6,0;;;5,0;;2,0;;5,0;2,0;;;;;;;;;;;1,0;1,0;;;8,0;1,0;;;;9,0;4,0;1,0;;;2,0;;9,0;;;;6,0;;;1,0;;;;;;4,0;;1,0;;18,0;;;1,0;;;1,0;;;10,0;;;2,0;2,0;;4,0;1,0;3,0;;;;;;;1,0;;;;;;;;;;;;;;;;;;;;;;;1,0;;;;;;;;;;;;;;;;;;2,0;;;;;;;;;;;;;;2,0;;;;;;2,0;2,0;;;;;;;;;;;;4,0;;;;;;;;;;;2,0;;;;1,0;;;2,0;8,0;5,0;;;;;;;;3,0;;;;;;3,0;;;;;3,0;4,0;1,0;;;;;7,0;;;;;;;;;2,0;43,0;6,0;11,0;;;;;;;;;;;;;;;1,0;;;;;8,0;;;;;;;;;;;;;;;;;;;;;;;;;;;1,0;;;;;;;;;;1,0;;;;;;;;;;;2,0;;;;;;;;;;5,0;;;;;;1,0;;12,0;;;;;;;;;;;;;;;2,0;;;;;;;;;;;;1,0;2,0;;;;;;5,0;;;;;;;;;;;;;;1,0;;;;;;;;;;;;;;;;;;;;;;;;;;;;;;;;;;;;;;;;5,0;2,0;;;;;1,0;;;;;;;;;;;;;;;;;;;;;;;;;3,0;;;;;;;;;;;;;1,0;;;;;;;;;;12,0;;3,0;;;;;;;;;;;;14,0;1,0;;;;;;;;;;;;;;;;1,0;;;;;;7,0;;1,0;3,0;;;;;2,0;;;;;;;;;;;;;;;;;;;;;;4,0;;;;;;;;;;;;;;;;;;4,0;;;;;;;;1,0;;;2,0;;;3,0;;;;;;;;;;;;;;;1,0;;;4,0;;;;;;;;;;;;;;;;;;;;;;;;1,0;;;;;;;;1,0;;;;;;;;;;;;;;2,0;;3,0;;;;;4,0;;;;;;;;;;;;;;;;;;;;4,0;40,0;;;2,0;1,0;;1,0;;;;;;;;;;;;2,0;;;;;2,0;;;1,0;;;;;;;;;;;;;;;;;;;;;;;;;;;;;;;;;;;;;;;;;;;;;;;;;;;;;;;;;;;;;;;;;;;;;;;;;;
primary;;;;;;1,0;4,0;57,0;9,0;8,0;10,0;;8,0;;11,0;14,0;2,0;;;;;3,0;;;;1,0;60,0;2,0;;1,0;2,0;;33,0;2,0;6,0;;;;1,0;;33,0;2,0;3,0;4,0;8,0;5,0;24,0;8,0;8,0;13,0;29,0;5,0;2,0;7,0;1,0;2,0;7,0;;2,0;;5,0;;1,0;;127,0;16,0;1,0;14,0;23,0;;13,0;;3,0;;;1,0;1,0;;;161,0;2,0;14,0;;42,0;;;;;;26,0;45,0;;;2,0;;;2,0;;14,0;;1,0;;2,0;16,0;;;19,0;1,0;16,0;22,0;3,0;15,0;;;;124,0;38,0;20,0;6,0;;1,0;;2,0;9,0;5,0;;;;;;;23,0;3,0;;8,0;9,0;4,0;20,0;42,0;;2,0;;;5,0;;;;1,0;23,0;17,0;;;;4,0;;9,0;88,0;;;1,0;1,0;5,0;18,0;;2,0;;45,0;20,0;;;2,0;;;;1,0;2,0;6,0;;2,0;10,0;;;;1,0;6,0;1,0;;78,0;;;1,0;;;45,0;;;;3,0;2,0;5,0;;3,0;4,0;8,0;3,0;;;6,0;;;;;1,0;;;10,0;5,0;;;1,0;8,0;;5,0;;;;2,0;;5,0;;2,0;;1,0;4,0;;;2,0;;1,0;7,0;;;5,0;3,0;3,0;;;;43,0;;;;23,0;;;;6,0;;;;;;2,0;2,0;;;;;2,0;;;19,0;;2,0;;4,0;;2,0;1,0;5,0;;;;;;4,0;;;;;2,0;3,0;;;3,0;;4,0;;;2,0;1,0;2,0;11,0;;;;;;1,0;;;;;;6,0;6,0;;;9,0;5,0;;1,0;3,0;;3,0;;1,0;;;;;;;;;;2,0;;1,0;;1,0;3,0;2,0;;1,0;1,0;6,0;2,0;4,0;33,0;;1,0;;;;6,0;;29,0;1,0;;;;;;;;;;3,0;;3,0;;;;;7,0;2,0;;;18,0;12,0;;;;;10,0;;2,0;;25,0;1,0;6,0;1,0;1,0;3,0;3,0;;;4,0;;;;;;;;;13,0;;1,0;2,0;1,0;;;;2,0;;1,0;;;;;3,0;;;3,0;;17,0;;;;;2,0;;1,0;;6,0;8,0;9,0;;2,0;36,0;5,0;;;;9,0;;;;;1,0;;;1,0;1,0;;;;;5,0;;9,0;;;;;;;4,0;;1,0;;;4,0;;1,0;;13,0;;;;;36,0;;;22,0;;4,0;1,0;;;;;5,0;;;;5,0;;41,0;2,0;;1,0;;;;;1,0;;11,0;;;;12,0;;;;2,0;;;;;9,0;;;;;;;;;;25,0;;;8,0;1,0;;;;3,0;;;;12,0;;;;2,0;;1,0;;;;;;1,0;;2,0;;;2,0;3,0;;1,0;;7,0;;;;1,0;5,0;;;;;;;;;;;21,0;;6,0;;;;;;;;4,0;;;5,0;;;;3,0;;3,0;;;;;;;;;;;;;2,0;;;;1,0;1,0;;;1,0;;;2,0;;1,0;;1,0;;;8,0;;;;;;;;1,0;8,0;;;2,0;;12,0;;;;;3,0;;;;;;;;;;;;1,0;;1,0;17,0;;;;;;1,0;;1,0;;;;;;;2,0;1,0;1,0;5,0;;;1,0;;;;;;;1,0;;;;;;;;;24,0;2,0;;;;5,0;;;;3,0;;;;;5,0;;;;;;;15,0;;1,0;8,0;;;;;;;1,0;;;;;;;;1,0;;;;3,0;1,0;;;;;;;1,0;;;;;;;;;1,0;;;;;;;;;15,0;;1,0;;;;;;;;;;1,0;1,0;1,0;1,0;1,0;;;;1,0;;;;;2,0;;2,0;86,0;2,0;2,0;;;4,0;1,0;;;1,0;;;8,0;2,0;;;;;;6,0;2,0;2,0;;;;;;;;;4,0;;1,0;;;1,0;;;;;;;;;;;;;1,0;;;;;;;;3,0;10,0;1,0;;2,0;;;;;;;;;1,0;;2,0;;;2,0;;;;;;;;;;;;2,0;;;;28,0;;;;;3,0;;;;;;2,0;;;;;86,0;;;;;;;;;4,0;2,0;;3,0;;;;;38,0;;;;;;;;7,0;;;164,0;;6,0;;;14,0;;;;;;;;;;1,0;;;16,0;;;;1,0;;;;;2,0;21,0;3,0;;;;;;;;;;;;;;;;;;19,0;4,0;;;;;;;2,0;;;;1,0;;;;;
principal;;;;;;27,0;;2,0;;;;;;;15,0;5,0;;;;;1,0;;;;;;;;;;;;3,0;;1,0;;;;;;;;18,0;;;;10,0;;;2,0;2,0;5,0;1,0;;;;;;2,0;;;;;;2,0;19,0;;6,0;4,0;;;;;;;3,0;2,0;;;47,0;;;;5,0;;;;;;10,0;32,0;;;;;4,0;;;4,0;;;;;1,0;;;8,0;;;47,0;;;;;;;6,0;;;;2,0;;;;2,0;;;;;;;;;;18,0;;1,0;3,0;;;1,0;;;21,0;22,0;;;;;;;;;;4,0;;3,0;;1,0;;;;2,0;;;;9,0;16,0;;;1,0;;;;1,0;;;;;;;;;;;;;1,0;;;;;;;;2,0;;;;;;4,0;;3,0;;;;;;14,0;;;;;;;;;;6,0;;39,0;;;;;;;21,0;;4,0;;6,0;;;;;;;;;;;1,0;;;;;4,0;9,0;3,0;;;;;;;;;;;;3,0;;7,0;;;;;;;;4,0;;;;;;;;;;;;;;;;;;;;;;;;;;;;;;2,0;1,0;;1,0;;;;;;;7,0;;;;;;;;;;;;;;1,0;;;;;;;;;;;;;;;;;;18,0;;;;10,0;;;;;;;;;102,0;;19,0;;;;5,0;;;;;;;1,0;;;;;;;;4,0;;;;;;;;;;;;1,0;;;;;;;;;;;;;;;;;;;2,0;;;;;2,0;;;;;;;;;;;;;;;;;1,0;;;;;;;;;;3,0;;;;;;;;;2,0;;;;;;;;;;;;;;;;;;;;;;;;;;3,0;;;;1,0;2,0;;1,0;6,0;;;;1,0;;;;;;1,0;;;;;;2,0;;;;;;;;;;1,0;;;;;;;;;;;;;;3,0;;;;;;;;;;;;11,0;;;;;;;;;;2,0;;;;;;;;;;;;;;;;;;;;;;;2,0;;;;;;;;;;;;;;;;;;;;;;;;;;;;;2,0;;;;;;;;;;;;;;3,0;;;;;;;;;;;;;;;;;;;;;;;;;;;;;;;;;;;;;;;;;;;;;4,0;;;;;;;;;;1,0;;;;;;;;;;;;;;;;;;;;;;;1,0;;;;;;;;;;;;;;;;;;;;;;;;;;;;;;;;;;;;;;;;;;;;;;;;;;;;;;;;;1,0;;;;;;;;;;;;;;;;;;;;;;;;;;11,0;;;;3,0;;21,0;;;;;;;;;;;;;;;;;;;;;;;;;;;;;;;1,0;;;;;;;;;;10,0;;;;;;;;;;;;;;;;;;;;;;;;;;;;;;;;;;;;;;;;;;;;;;;;;;;;;;;;;;;;;;;;;;;;;;;;;;;;;;;;;;;;5,0;;;;;;;;;;;;;;;;;;;;;;;;;;;;;;;;;;;;;;;;1,0;;;;;3,0;;;;;;;;;;;;;;;;;;;;;;;;;4,0;;;;;;;;;;;;;;;;;;;;;;;;;
printer;;;;;;2,0;;;;;;;;;2,0;2,0;;;;;;12,0;;;;;5,0;;4,0;;3,0;;6,0;;3,0;;;;;;17,0;;;;;;1,0;14,0;3,0;5,0;;;;;;;;;;;;3,0;1,0;;;;;;;;;;;;;;;;;38,0;;1,0;;16,0;;;;;;;;;;;;1,0;3,0;;5,0;;;;32,0;;;;;1,0;6,0;;;;;;;6,0;1,0;1,0;6,0;;;;;4,0;2,0;5,0;;;;;;;;;;;;1,0;;;;;;5,0;2,0;;;;;1,0;;;14,0;5,0;;1,0;11,0;;;4,0;;;3,0;;;;;2,0;;;;;;;;;1,0;;;;;;;;;1,0;;;;;;;;5,0;;1,0;1,0;;;;;;;;;;;;;;;;;;;;;;;;2,0;;;;;;;;2,0;;;;;3,0;;;;1,0;;;;1,0;;;;;;1,0;2,0;;;;;;;;4,0;;;;;;;1,0;;;10,0;;;;;5,0;3,0;;;;;;;4,0;;;;;;;;2,0;;;;;;;;;;;3,0;;;;;;;;;;;;;;;;;;;1,0;;2,0;;;;;;;;;;;;;;;;;;;;;;2,0;;2,0;;;;;;;;;;;;1,0;4,0;;;;;;;;;;;2,0;;;;;;;;;;;;;;;;1,0;;;;;;;;;;;;2,0;;1,0;;;;;;;;;;;;;;;;;;;;;;;;;;;;;;1,0;;;;1,0;;;;;;;1,0;;;;;;2,0;3,0;;;;;;;;;;;;;;;2,0;;;2,0;;;;;;;;;;;;;;;;;;;;;;;;;;;;;;;;;;;10,0;;3,0;;;4,0;5,0;;;;;;;;;2,0;;;;;;;;;;;;1,0;;;;;;;;4,0;;;1,0;;;;;;;;;;;;;;7,0;;;;;;;;;;5,0;;;;;;3,0;3,0;;;3,0;;2,0;;;;;;;;;;;;;;;;;;;1,0;;;;;;;;;2,0;;4,0;;;;;;;;;;;;;;;;;;;;;;;;1,0;;;;;1,0;;;;2,0;;;;;;;;;;;;;;;;5,0;;;;;;;;;;;;;;;;;;;;;;;;;;2,0;;;;;;1,0;;;;;;;;;;3,0;;;;;20,0;;;;;;;;;;;;;;;;;;;;;;;;;;;;;;;;;;;2,0;;;;;;;;;;;;;;;;;;;;;;;;;;;;;;;;;;;;5,0;;;;;;;;;;;;3,0;;;;;1,0;;;;;;;;;;;;1,0;;4,0;;;;;;;;;;;;;;;;;;;;;;;;;;;;;;;;;;;;;;;;;;;;;;;;;;;;;;;;;;;;;;;;;;;;;;;;;;;1,0;;;;;;1,0;;;;;;;;;;;;;;;;;;;;;;;2,0;;;;;;;;;;;;;;;;;;;;;;;;;;;;3,0;;;;;;;;;;;;;;;;;;;;;;;;;;;;;;;;;;;;;;;;;;;;;;;;;;;;;;;;;;;;;;;;;;;
protrusion;;;;;;5,0;13,0;10,0;7,0;24,0;2,0;;3,0;;20,0;33,0;;;;;;9,0;;9,0;;;;1,0;;;;;24,0;;3,0;;;;;;;;44,0;;;;;12,0;2,0;1,0;14,0;10,0;;;;13,0;12,0;;;;106,0;15,0;6,0;;3,0;2,0;2,0;108,0;10,0;27,0;;;;;;7,0;;;;12,0;;4,0;;86,0;2,0;;3,0;;1,0;16,0;144,0;;;5,0;;;;;10,0;22,0;;;107,0;;;;24,0;;;;3,0;;11,0;;2,0;139,0;126,0;68,0;;7,0;5,0;;;;;;;;;;;;3,0;;;;8,0;;;;;1,0;;2,0;;;1,0;70,0;;3,0;;53,0;;;;;6,0;;3,0;;;;91,0;;;;;6,0;;;;;2,0;19,0;;3,0;18,0;61,0;;;4,0;64,0;12,0;1,0;;1,0;;5,0;;;;;1,0;53,0;;41,0;;;;32,0;18,0;;;47,0;1,0;12,0;;;;41,0;;7,0;4,0;;19,0;;67,0;;3,0;75,0;24,0;1,0;39,0;13,0;;;;;3,0;;98,0;6,0;;33,0;18,0;19,0;2,0;45,0;16,0;39,0;2,0;;2,0;;;;;;;6,0;71,0;;7,0;;;;52,0;;1,0;;9,0;1,0;29,0;16,0;;;37,0;9,0;5,0;;18,0;;28,0;;;20,0;;35,0;20,0;184,0;4,0;;;3,0;8,0;;;3,0;;;;;;2,0;41,0;;;;;28,0;5,0;4,0;2,0;;;4,0;5,0;21,0;49,0;;;11,0;;8,0;2,0;;;10,0;;23,0;9,0;;7,0;3,0;16,0;;80,0;57,0;;1,0;7,0;11,0;3,0;;;;;116,0;2,0;44,0;9,0;9,0;79,0;;1,0;;40,0;2,0;4,0;;10,0;7,0;;1,0;4,0;1,0;;;;;;19,0;;63,0;;1,0;9,0;20,0;62,0;;;1,0;;;7,0;;19,0;;11,0;3,0;;6,0;2,0;;4,0;3,0;8,0;4,0;6,0;53,0;16,0;2,0;;11,0;15,0;2,0;3,0;6,0;2,0;;;;;;;;;2,0;;;;;;;;1,0;;;;;;;1,0;;;;;;;;;;;3,0;4,0;;1,0;;;;2,0;1,0;2,0;;;1,0;1,0;;1,0;;;;;;;;;;;;;;;;;;;;;;;;;;;;;;;;13,0;12,0;;25,0;;;;;1,0;;1,0;;;;;6,0;;1,0;7,0;;18,0;;;;;;3,0;;;;;;;;;;;;;;;;5,0;1,0;;;;2,0;;;;;;15,0;;;;;;10,0;;2,0;;;;;;;3,0;;;;;;;;;;3,0;;;;;;76,0;;1,0;;;;;;;;2,0;2,0;;;;;;;;;1,0;;;;;;;;;16,0;;;;;24,0;;5,0;;;;;;;15,0;;;;;3,0;2,0;;;;;;;;;;1,0;;;;;;;;2,0;;2,0;;;;6,0;;;;;;;;;;1,0;;1,0;1,0;;;1,0;;1,0;;2,0;;;4,0;;;1,0;;5,0;;10,0;;;;5,0;;1,0;;3,0;;4,0;12,0;;;;;;;1,0;;;4,0;;;;;;;2,0;1,0;;;;;;;;5,0;;;;;6,0;;;;10,0;;4,0;;;6,0;;;4,0;;;;4,0;;;7,0;;;;;;;;;;;4,0;;;;;4,0;;;;1,0;;;;;;;;;;3,0;;;;;;;;;;;;;;;;;;;;;;;;;;;;;;;;;;;1,0;;;;;6,0;;;;;;;;;;;;;;;;4,0;;;;;;;;;;;;1,0;;;;;;;;;;;2,0;;;;;;;;;;;;;;;;;;;;;;;;;;;;;;;;;;;;;;;;2,0;;1,0;3,0;;;;;;;;;;;;;;;;;;;;;;1,0;;;;;1,0;;6,0;1,0;;;;;;;;;;;4,0;9,0;;;;;;;;;;;;6,0;;;;;;;;;;;;;;;18,0;;;;;;;;;;;;;1,0;;;;;;;;;;;5,0;;;;;;;;;;;;;;;;;;;;;;;;;;
proximate;;;;;;1,0;5,0;1,0;2,0;6,0;27,0;;;;10,0;9,0;8,0;1,0;;;;28,0;;1,0;;;4,0;;;;1,0;;11,0;;4,0;2,0;;;;;8,0;;;1,0;6,0;;7,0;19,0;3,0;31,0;16,0;2,0;;;;5,0;14,0;;;;1,0;;13,0;;3,0;1,0;2,0;8,0;;1,0;;;;;;;;;3,0;42,0;;1,0;1,0;4,0;;;;;;3,0;21,0;;;;;;;;5,0;3,0;;;3,0;25,0;1,0;;6,0;;;;;;;;;7,0;13,0;24,0;;1,0;;;;;2,0;;;;;3,0;;;1,0;;;;;1,0;;;;2,0;;15,0;;;;7,0;;;;1,0;;;;;13,0;;;;;;;;;;17,0;11,0;1,0;;3,0;;2,0;;;2,0;5,0;;;;;4,0;;;;;;13,0;;;;;1,0;;;3,0;;;;;;;;;;;;;3,0;;;;;;1,0;;;;;;9,0;;;;;;;;13,0;;1,0;;;15,0;;;;2,0;3,0;;;5,0;;2,0;;;;1,0;1,0;1,0;;;5,0;;;;;5,0;1,0;;;;;2,0;;;;;;;;6,0;2,0;;;;;;9,0;29,0;;;;;;5,0;;7,0;;2,0;26,0;;;;2,0;1,0;;;;;1,0;3,0;12,0;;;;;;1,0;;;1,0;;;4,0;;;;;12,0;1,0;;;9,0;;;1,0;;;;;;;;;;;2,0;;5,0;3,0;;;;;;;;1,0;;;;;;;1,0;3,0;3,0;;1,0;;;;;;;;;;;;;;;;;;;;6,0;;;;;;;1,0;;;37,0;1,0;1,0;;;3,0;;;;3,0;;;;;3,0;;;;;;;1,0;;;;;;;;;;;;1,0;;;;;2,0;;;;3,0;;;18,0;;;;;;;;3,0;;;;;4,0;;;;;;;;;5,0;4,0;;;;;;;;;;;1,0;5,0;2,0;;1,0;;11,0;;;;;3,0;;;1,0;;;;;;1,0;;;1,0;;2,0;;;3,0;;1,0;;3,0;;;;;;;;;;;3,0;;;;;;;;;3,0;;;;;;4,0;;;;;;;;;;4,0;2,0;;;;;;;;;;;;;;;;;;;;;36,0;;;;;;;;;;;;;;3,0;;;;;;;;;;;3,0;;;;2,0;24,0;;;;;1,0;;;;;;;3,0;;;;;;;1,0;;;;1,0;3,0;;;;;;;;;;;;;;15,0;;;;;;;;;;;3,0;;;;;2,0;;;;;;;;;;;;;8,0;;;;;;;;;;1,0;;;;;;;;;;;;;;;;1,0;4,0;;;;;;;;;;;;1,0;5,0;;;;;;;;;8,0;;2,0;;;;;;;;;;;;;;;;2,0;3,0;;;;;;;;;;;;1,0;;;;;1,0;;;;;;;;;;;;;;;;;;;;;;;;;;1,0;;;;;;;;;;;;;;;;;2,0;;;;;;;;;;;;;;;5,0;;;;;;;;;;;;3,0;;;;;;;2,0;;;9,0;;;;;;;;;;;;;;;;;;;;8,0;;;;5,0;;;;;;;;;;;;;2,0;;;;;;;;;;;;;;;;;;8,0;;;;;1,0;;;;;;;;;;;;2,0;;;;;;;;;;;;;2,0;;;;;;;;;;;;;;;;;;;;;3,0;;;;;;;;;;;4,0;;;10,0;;;;;;;;;;;;;;;;;;;;;;12,0;1,0;;;;;;;;;;;;;;1,0;;;;;;;4,0;;;;;;;;;;;;;;;
radar;;;;;;2,0;;;1,0;;1,0;;6,0;;8,0;7,0;23,0;;;;1,0;7,0;;;;;;;1,0;;;;5,0;;;3,0;;;;;66,0;;3,0;;5,0;3,0;5,0;36,0;;1,0;2,0;;;;;;1,0;1,0;;;;;12,0;;;1,0;;1,0;;1,0;;;3,0;;;;;;;15,0;;14,0;;1,0;;;;;;;7,0;;;;3,0;;;;7,0;;;;18,0;19,0;;;13,0;;7,0;3,0;9,0;;;;;1,0;1,0;2,0;;;;;1,0;8,0;;;;;1,0;4,0;;;5,0;;5,0;;4,0;;6,0;;;;;38,0;;;;1,0;14,0;;;;;;;;6,0;;2,0;;;7,0;;;;;;13,0;;4,0;;;;;;;;;;;;;;;;1,0;;19,0;;;;;;;;;;;;;;;;1,0;;;;;;;;;;;2,0;;;;;;6,0;;;;;;;;1,0;;;;4,0;;;;;;;;;;;;1,0;;;;2,0;5,0;5,0;7,0;;;;1,0;22,0;7,0;;;;;;4,0;;;;5,0;;;;;;;;;;;;1,0;11,0;;;;10,0;;;;;;10,0;;;;;;;7,0;;;;;;;1,0;;;;;;;;;;;;;;;;;;2,0;;;;;;;;;;;;;;;;;;;;;;;;;;1,0;;;;;;;;;;;;;6,0;;;;;;;;;;;;;;;;;;;;;;;;;;;1,0;;;6,0;;;;;;;4,0;;;1,0;;;;;;;;2,0;;;;;;;;;;;;;1,0;;;;;6,0;;;;;;;;;;2,0;;;;;;;;;;;;;;;;;;;;;;1,0;6,0;;;;;;;;;1,0;;;3,0;;;1,0;5,0;;;;;;;;;;;;;;;;;;;4,0;;;;;;;;;;2,0;;;;;;;;;;;;1,0;;;;;;;;;;;;2,0;;;;;;;;;;;;;;;;;;;;;;;;;;;;;;;;;6,0;;;;;1,0;;;;;;;;;;;;;;;;;56,0;4,0;;;;;;;;;1,0;;;;;;2,0;;6,0;;;;;;;;;;;;;;;;;;;;;;;;;3,0;;;;;;;;;;;;;;;1,0;;;;;;;;1,0;;;;;;;;;;;;;;;;2,0;;;;;;;;;;;;;;;;;;;;;;;;;;;1,0;;;;;;;;1,0;2,0;;;;;;;;;;;;;;3,0;;;;;;;;;;2,0;;;;;;;;4,0;;;;;;1,0;;;;;;;;;;;;;;;;;;;;;;;;;;;;;;;;;;;;;;;;;;;;;;;;;;;;;;;;;;;;;;;;;;;;;;;;;;;;;;;;;;;;;;;;;;;;;;;;;;;;;;1,0;;;;;;;;;;;2,0;;;;;;;;;2,0;;;;;;;;;;;;;;;;;;;;;;;;;;;;;;;;9,0;;;;;4,0;;;;;;;;;;;2,0;;;;79,0;;;;;;;;;;;;;;;;;;;;;;;;;;;;;;;;;;;;;;;;;;;;;;;;;;;;;;;;;;;;;;;;;;;;;;;8,0;;;;;;;;;;;;;;
reach;;;;;;11,0;;2,0;9,0;1,0;10,0;;;;8,0;2,0;8,0;;;;1,0;6,0;;;;;4,0;;;;;;;;3,0;3,0;;4,0;;;16,0;6,0;1,0;4,0;4,0;3,0;14,0;20,0;7,0;4,0;2,0;14,0;;;;9,0;;;1,0;;1,0;1,0;2,0;4,0;12,0;1,0;1,0;12,0;;;;;1,0;;;;;1,0;4,0;59,0;;13,0;;;;;1,0;3,0;2,0;;19,0;;;2,0;;;6,0;;9,0;1,0;;;5,0;9,0;;;9,0;;2,0;1,0;9,0;;;;;1,0;7,0;68,0;1,0;13,0;13,0;;4,0;2,0;1,0;;;;;;;22,0;1,0;1,0;2,0;;1,0;3,0;4,0;;1,0;;;48,0;2,0;;;5,0;24,0;1,0;;;4,0;3,0;;1,0;8,0;;2,0;;1,0;;18,0;;;;6,0;1,0;;6,0;3,0;;;;8,0;;2,0;1,0;;;2,0;2,0;;;;3,0;;1,0;;;;;;;;;;;;1,0;;;1,0;9,0;;;;3,0;4,0;;;;;;1,0;;7,0;;2,0;;5,0;;;;;;11,0;;71,0;;9,0;;8,0;;1,0;4,0;7,0;4,0;;4,0;;;;1,0;;4,0;2,0;;20,0;;;1,0;;;;3,0;;9,0;3,0;;;;;6,0;6,0;2,0;3,0;;3,0;;;15,0;2,0;2,0;2,0;;2,0;;1,0;4,0;;;;1,0;;16,0;;;1,0;;4,0;;;6,0;4,0;;;;5,0;;;18,0;;;1,0;;;3,0;3,0;1,0;1,0;1,0;;;2,0;;;;;;2,0;;;;1,0;;;;;1,0;;;;;;;;;3,0;;;;;;9,0;1,0;;2,0;;;;;;7,0;;;1,0;8,0;;;3,0;;;1,0;;;1,0;1,0;;;2,0;;;4,0;;;;;;;;;;;;;;;;;;19,0;;;;;1,0;1,0;;;;;;;;;;;;;1,0;;;;1,0;;;6,0;;;;4,0;7,0;;;;3,0;;;;;1,0;13,0;;1,0;;;;3,0;;;5,0;2,0;6,0;;1,0;3,0;1,0;2,0;4,0;1,0;;;3,0;;6,0;;3,0;;;;;;12,0;;;;;24,0;;;4,0;;3,0;17,0;;5,0;;15,0;;;;;1,0;;12,0;;;;2,0;;1,0;;;3,0;;;;;;2,0;;;12,0;;;;;;;;;;;;1,0;;;;;;;;;;;;;;;;8,0;;2,0;1,0;;6,0;;;;;;;5,0;;;;;2,0;;;;;4,0;;;;;;1,0;;;;;1,0;;;;;;;;;;;1,0;;6,0;;;;;;;;;1,0;3,0;;;;;;;;;;;;;2,0;;;;;1,0;;;;;2,0;;;;;;;;;;;;;;;;4,0;;;1,0;;;;;;1,0;;;;;;1,0;;;;;;;;;;;;;;;;;;;;;;;2,0;;;5,0;;1,0;;;;;;;;;;;;;;;;;;1,0;;;;;1,0;;;;;;;;;;;;;1,0;;1,0;2,0;;;;;;;;;;1,0;;;;1,0;;;;5,0;;;;4,0;;;;;;;;;;;;;;;;;;1,0;;;;;;;;;;;3,0;4,0;;;;;;;;;;;;;;1,0;;;;4,0;36,0;;8,0;;7,0;;2,0;;;;;;2,0;;10,0;2,0;;;;;1,0;;;;;;;;;;;1,0;;;;;;;;;;;;;;;;;2,0;;;;8,0;;;;;;;;;;;;;;;;;;2,0;;;;4,0;;;;6,0;;;1,0;;;;1,0;3,0;3,0;;;;;;;2,0;;;;;;;;;;;;;;;;;;;2,0;;;;7,0;;;;;;1,0;;;;;;;;;;;;;;;;;;;;4,0;2,0;;2,0;;;;;4,0;;;;;;;;;;;;;1,0;;;;;;;;;;;;;;;;;;;;;;;;;;;;;;;;;;;;;;4,0;;;;;;2,0;;;;;;;;;;;;
readable;;;;;;5,0;;4,0;11,0;;1,0;;4,0;;;3,0;;1,0;1,0;;;7,0;3,0;3,0;;1,0;12,0;4,0;;;615,0;3,0;15,0;1,0;8,0;;1,0;5,0;;;23,0;;1,0;1,0;2,0;1,0;12,0;50,0;7,0;11,0;;;1,0;;;1,0;5,0;2,0;;16,0;;1,0;1,0;2,0;4,0;;1,0;5,0;10,0;;3,0;;4,0;;;15,0;2,0;;2,0;59,0;1,0;2,0;2,0;14,0;;102,0;;1,0;;1,0;3,0;;9,0;;;526,0;21,0;1,0;22,0;4,0;2,0;2,0;4,0;13,0;;;1,0;7,0;1,0;7,0;;8,0;;;;6,0;3,0;3,0;;1,0;;;1,0;22,0;77,0;128,0;;;;2,0;;;3,0;;6,0;;;;;;14,0;1,0;;7,0;2,0;;;2,0;10,0;5,0;;;201,0;106,0;;;11,0;;1,0;;420,0;;7,0;;;;14,0;2,0;;;1,0;;;;2,0;1,0;;;;;;;;;;1,0;;2,0;;;;;;;;;3,0;;;;;;;1,0;;;;;2,0;1,0;;;;;;;;;;;;;;;1,0;;;;1,0;;2,0;;;1,0;;;2,0;;;;;;1,0;2,0;;;;2,0;3,0;;;;;;;;15,0;;;;;;;10,0;;;;;;;;4,0;4,0;;;;1,0;1,0;1,0;3,0;;;;;;13,0;;3,0;;;1,0;;;;;;1,0;;;;;;;;;2,0;;;;;;;;;;;;;;6,0;;;;;1,0;;;;;1,0;;;;;;;;;;;;;;;;;3,0;;;2,0;;;;;;;;13,0;6,0;1,0;;;;;;;;;;;;;;;;;;;;2,0;;;2,0;;;;;;;;;3,0;;14,0;;1,0;;;1,0;;;;1,0;5,0;;;;;;1,0;;85,0;1,0;1,0;9,0;;;;;;;1,0;;;5,0;;;5,0;;;;2,0;1,0;;13,0;;;1,0;3,0;;1,0;2,0;;2,0;4,0;2,0;4,0;;3,0;;1,0;;;;3,0;31,0;2,0;2,0;;;;;1,0;1,0;;;;;4,0;4,0;;;;1,0;3,0;;3,0;6,0;;;3,0;1,0;;5,0;2,0;;;;;;;;;27,0;3,0;1,0;;1,0;5,0;2,0;1,0;;;;3,0;;;;;;;3,0;;;3,0;;;;;;1,0;;;;;;;;;;;;6,0;;;;;;;1,0;;;;2,0;4,0;;1,0;;;1,0;;;;1,0;;;;;;;1,0;;;1,0;;1,0;2,0;4,0;;;;;;;;11,0;;;;;2,0;;;;3,0;1,0;;;1,0;;1,0;1,0;;;;;;2,0;;2,0;;;36,0;;;;1,0;;;;;;;;;;;22,0;;;;;;3,0;;;6,0;;;;;;;2,0;3,0;2,0;;;11,0;;;;;;3,0;;;;9,0;;;;;;;;;;;;;;;;1,0;;;1,0;;;4,0;;;;;;;;;;;;1,0;;;1,0;2,0;;;;;;;;;;;;;;;;6,0;;;;1,0;1,0;;;;;1,0;;;;;;;;;;;;25,0;;;;;2,0;;1,0;;;;;;;;;;;;;;;;;;;;;1,0;;;;;;6,0;;;;;2,0;;1,0;;1,0;;1,0;;;2,0;;;;;1,0;;;;;;;;1,0;1,0;;;9,0;2,0;1,0;;;;;;;1,0;;;;;;3,0;;;;;109,0;1,0;;;1,0;1,0;;3,0;;;;;;;2,0;;;;;;;;;;;;;;;;;;1,0;;;;;1,0;;;;3,0;3,0;12,0;1,0;;;2,0;;;;;;;1,0;;;1,0;;;;;;;;;;;;;;;;;;;;;2,0;;;;;;;;;;;1,0;;;;;;;;;;1,0;;;3,0;;;;;2,0;;;;;;;;;;;;;;;;;;;;;;;;;;;;2,0;;;;;;;;;;;;;;;;;1,0;;;;;;;;1,0;;;1,0;;;;;;;;;4,0;;;;;;;2,0;;1,0;;;;;;;;1,0;
reflective;;;;;;12,0;2,0;19,0;2,0;2,0;3,0;;6,0;;1,0;11,0;17,0;;;;;5,0;;;;;4,0;1,0;;;;;21,0;;2,0;;;;;;;;5,0;;2,0;;2,0;14,0;2,0;10,0;13,0;;;;;;35,0;;;;;;9,0;;7,0;;;15,0;;;;;;;;1,0;;4,0;6,0;22,0;;3,0;;19,0;;;;;;;24,0;1,0;;15,0;;3,0;;;10,0;;;;12,0;;;1,0;21,0;;;1,0;5,0;1,0;;;;5,0;17,0;40,0;3,0;;;4,0;2,0;9,0;5,0;;;;1,0;;;2,0;;3,0;;;;;;;5,0;;;20,0;;;;10,0;1,0;;;;;;;;12,0;;;;;;4,0;;;;;9,0;;5,0;;;;1,0;;;5,0;;;;1,0;3,0;;;;;7,0;3,0;;;;;1,0;;;2,0;;;;3,0;;;;2,0;;;;;;7,0;2,0;;;;5,0;;;;;;8,0;2,0;;;;;2,0;;61,0;2,0;26,0;;57,0;;1,0;;;1,0;;;;;8,0;1,0;;;;;1,0;5,0;3,0;;;;;;2,0;35,0;6,0;1,0;;;;;;;13,0;;1,0;;;1,0;2,0;;;;;;3,0;134,0;1,0;;;;;;;3,0;;8,0;9,0;;;;1,0;;;;;;;;;;;;;;4,0;;;;;;;;;;1,0;;2,0;;;;;;;;;1,0;;;;;;;;2,0;;1,0;;4,0;;;;;;;;4,0;;8,0;;1,0;;;;8,0;;;;;;;;2,0;;1,0;3,0;;;;;;;;;4,0;5,0;;;;;;6,0;;6,0;;;3,0;;11,0;;;;;;;1,0;;;;;;1,0;;;;;;;;;;;;;;;;;1,0;1,0;;;;;;;;;;;;1,0;;;;;1,0;2,0;;;;;;;;;;;;;;;1,0;;;;;3,0;;;;;;;;;2,0;;;4,0;;1,0;;;;;;8,0;1,0;;;;;;;;;;;;;;;;;;;;;;;;;4,0;;;;;3,0;;2,0;;;;;3,0;;;;1,0;;4,0;;;;;;;;;;;1,0;;;;;;;;;;;;;;;;;1,0;2,0;;;1,0;;;;;;;;;;;;;;;;4,0;;;1,0;;;;;;;;;1,0;;;;;;;;;2,0;1,0;;;;;;;;;;;1,0;;;;;;;;;;;;;;;;;;;;;;;1,0;;;;;2,0;;;;4,0;;;;;;;;;;;;;;;;;;;;;;;1,0;;;2,0;;;1,0;2,0;;;1,0;;;;;11,0;;;;;;;;;;;;5,0;;1,0;;2,0;;;;2,0;14,0;;;;;;;;;;;;;;;;;;;;2,0;;;;;1,0;1,0;;;;;;;2,0;;;;;2,0;;;;;;;;;;;;;;;;;;;;;;;;;;;;;;;;;;;;;;;;;;;;;;;;;;;;6,0;;;2,0;2,0;;;;;;;;;;;;;;;;;;;;;;;;;;;;;;;;;;;;;;;;;;;;;1,0;;1,0;;;9,0;1,0;;;;;;;;;;;;;;;;;;;;;;1,0;;;;;;;;;;;;;;;;;1,0;2,0;;;;;;;;;;;;;;;;;;;;;;;;;;;;;;;;;;;;1,0;;;;;;;;;;;;;;;;;;;;;;;;;;5,0;;;;;;;;3,0;;;;;;;;;;;;;;;;;;;;;;2,0;;;;;;;;;;;;;;;;;;;;;;;;;;
refract;;;;;;22,0;;5,0;;;1,0;;;;50,0;2,0;6,0;;;;;21,0;3,0;;;;;;;;;;19,0;;;;;;4,0;;;;;;;;1,0;17,0;;4,0;1,0;2,0;;;;6,0;31,0;;1,0;;;;3,0;;1,0;2,0;;1,0;;1,0;;1,0;3,0;;;2,0;;3,0;;21,0;;6,0;;15,0;6,0;;;;;;174,0;;;;;;;;6,0;;;;2,0;7,0;23,0;;57,0;;;;6,0;;;;;3,0;12,0;66,0;11,0;10,0;;3,0;;;;;;;3,0;;;;16,0;;4,0;;;;;;8,0;;;3,0;;;;6,0;;;;;;;;;4,0;;;;;;;1,0;3,0;;2,0;4,0;;;1,0;;;;2,0;;1,0;9,0;;;;3,0;;;;;;;;;;;1,0;;;;;;;;;;2,0;10,0;;;;1,0;;;;;;;;;;;;;;2,0;1,0;;;;;;67,0;;;;;7,0;;1,0;;;2,0;;;;;;;;;;;4,0;;3,0;;;;;10,0;8,0;;1,0;;;;;;;;;;;;1,0;;;;;;;;6,0;2,0;;;;;;;;;;;;;;;;;;;;;3,0;;;;;;;;;;;;;;;;;6,0;;;;;;;;;;1,0;6,0;;;;1,0;;;;6,0;6,0;;;;;;;;;;8,0;;;4,0;;;;2,0;;;;;1,0;1,0;;;;;;;;;;;;;;;;;17,0;1,0;;;;;;4,0;;;;;;;;;;;;;;;;;;5,0;;;;;;;12,0;;;;;;;2,0;3,0;;;;3,0;;;;;;;;;;;;;;;;;;1,0;;;;;;;;;;1,0;;;;6,0;;;;;;;;;;;;;;;;;5,0;;;;;;;1,0;;12,0;8,0;;14,0;;;;;;;;;;;;;;;;;;;;1,0;;;;;;;;;;;;;;;;;;;;;;;;;;;;;;;;;;;;;;;;;;2,0;;;;;;;;;;;;;;;;;;;;;;;;;;;;;;;;;;;;;;;;;;;;;;;;;;;;;;;8,0;;;;;;;;;;;;;;;;;;;;;;;;;;4,0;;;;;;;;;;;;;;;;;;;;;;7,0;;;;;;8,0;;;;;;;;;;;;;;;;;;;;;;;;;;;;;;;1,0;;;;;;;;;;;;;;;;;;;;;8,0;;;;;;;;;;;;;;;;;;;;;;;;;;;;1,0;;;;;;;;;2,0;;;;;;;;;;;;;;;;;;;;;;;;;;;;;;;;;;;;;;;;;;;;;;;;;;;;;;;;;;;;;;;;;;;;;;;;;;;;;;;;;;;;;;;;5,0;;;;;;;;;;;;;;;;;;;;;;;;;;;;;;;;;;;;;;;;;;;;;;;;;;;;;1,0;;;;;;;;;;;;;;;;;;;;;;;;;;;;;;;;;;;;;;;;;;;;;;;;;;;;;;;;;;;;;;;;;;;;;;;;;;;;;;;;;;;;;;;;;;;;;;;;;;;;;;;;;;;;;;;;;;;
refractive;;;;;;1,0;10,0;2,0;1,0;17,0;3,0;7,0;;;22,0;1,0;1,0;;;;;4,0;;;;1,0;1,0;2,0;;;;85,0;2,0;;4,0;;;1,0;2,0;;7,0;1,0;7,0;;1,0;;2,0;25,0;;22,0;11,0;6,0;;;;;180,0;;;;;;1,0;;1,0;2,0;1,0;27,0;;1,0;;2,0;;;;180,0;;1,0;;26,0;;19,0;;57,0;1,0;;;;;2,0;748,0;;;115,0;6,0;23,0;;;4,0;;;;26,0;29,0;;1,0;88,0;21,0;14,0;;;;1,0;;2,0;3,0;12,0;8,0;331,0;;;12,0;;;;;6,0;;;1,0;;;5,0;;11,0;;3,0;;;101,0;;;;3,0;;;;67,0;1,0;;;4,0;;;;;44,0;;;;;;71,0;;1,0;;;2,0;;1,0;30,0;3,0;1,0;2,0;1,0;;1,0;1,0;;;;1,0;;;1,0;;;6,0;;;;;9,0;;11,0;;;;9,0;1,0;;;27,0;1,0;;;;;;1,0;47,0;;;;2,0;;;;5,0;2,0;;;1,0;;;;30,0;;12,0;;8,0;;;;1,0;1,0;;;;1,0;;;;6,0;;;6,0;;4,0;8,0;;;;;;;;1,0;1,0;;;;;4,0;;;10,0;;1,0;20,0;;2,0;1,0;;;;;1,0;22,0;86,0;;;;12,0;;;5,0;;;19,0;;;;;1,0;7,0;;;;;;;1,0;;;;;2,0;;;;1,0;;;5,0;1,0;;;17,0;;;;3,0;;;;;;;;;;;6,0;;;;2,0;;;;18,0;;;4,0;;;;;;4,0;;;1,0;;;;6,0;;;4,0;;;;;;;1,0;;7,0;;;;;;;;;;;;;;;1,0;;;;;;;1,0;;1,0;;;;;;;;;;;;;3,0;;;;5,0;;;;;4,0;1,0;;;;;;1,0;;;;;;;;;;;;;;;;;;;;2,0;;2,0;;2,0;;;;;;;;;;;;;;1,0;;;;;;;;;;;;;;;;;;;;1,0;;;;;;;;;;;;;;1,0;;;;2,0;;;;4,0;;;;;;;;;;;;;;;;;;;;;;;;;;;;;;;;;;1,0;;;;;;;4,0;;;11,0;;;;;;;;;;;;;;;;4,0;;;;;;;;;;;;;;;;;;;;;;3,0;1,0;;;;;;;;1,0;;;;;;;4,0;;3,0;;;;;;;;;;;;;;;;;;;;;;;;111,0;;;;;;;;;;;;;;;;;;;;;;;;;;;;;;;;;;;;;3,0;3,0;;16,0;;;;;;;;;;;;;;;;;;;;;;;16,0;;;2,0;;;;2,0;;;;;;;;;;;;;;;;;1,0;;;;;;;;;;;;;3,0;6,0;2,0;;;;;;;;;;;;;7,0;;;;;;;1,0;;;;;;;;;;4,0;;;;;;;;;;;;;3,0;;;;;;;;10,0;;;;;;;;;;;;;;;;;;;;;13,0;;;;;;;;;;;;62,0;;14,0;;;;;;;;6,0;;;;;;;;;1,0;;;3,0;;;;;;;;;;;;;;13,0;;;;;;;;;;;;;;1,0;;;;;;;;;;1,0;;;;;;;;;;;;;;;;;;;;;;;;;;;;;;;;;;;;;;;2,0;;;2,0;1,0;;4,0;;;;;;;;;;;;11,0;;9,0;;;;;3,0;;;;;1,0;;;;;;;;;;;;;1,0;;;;10,0;1,0;;;;;;;;;;;;;;;4,0;;;;;;;;;;;;;;;;;;;;;;;;;
relation;;;;;;5,0;5,0;8,0;9,0;6,0;1,0;;6,0;1,0;4,0;34,0;;;1,0;;6,0;6,0;;;1,0;1,0;9,0;;2,0;;;;4,0;;13,0;;3,0;2,0;;;12,0;;;4,0;4,0;2,0;16,0;23,0;;5,0;9,0;11,0;8,0;;1,0;5,0;4,0;;4,0;;1,0;12,0;;;2,0;8,0;1,0;2,0;8,0;;1,0;3,0;8,0;;3,0;7,0;;;;59,0;2,0;7,0;;9,0;;;;;;2,0;29,0;;;;5,0;;1,0;;26,0;16,0;1,0;;6,0;16,0;;;14,0;;7,0;13,0;;3,0;;;2,0;11,0;3,0;63,0;;7,0;;;2,0;1,0;1,0;;;;9,0;;;3,0;1,0;;6,0;;4,0;1,0;;;1,0;;;11,0;4,0;1,0;;7,0;4,0;13,0;20,0;;;1,0;3,0;;12,0;1,0;4,0;;2,0;;17,0;;;;;;2,0;8,0;7,0;;;;;;1,0;;1,0;;4,0;11,0;;;;2,0;;5,0;;;;;;2,0;2,0;;3,0;;;2,0;;;2,0;7,0;4,0;;;6,0;1,0;3,0;;;4,0;;;;1,0;;;;4,0;;;;7,0;1,0;;;12,0;;5,0;;;8,0;2,0;;7,0;;;;;;;6,0;4,0;;;5,0;8,0;1,0;;;1,0;;;;6,0;;;;;;;;;;3,0;1,0;2,0;;;;5,0;;;5,0;3,0;;;9,0;2,0;;;;;1,0;4,0;4,0;;;4,0;2,0;6,0;;;;1,0;;;;1,0;;;2,0;1,0;1,0;;4,0;;;;;;;6,0;;;4,0;;4,0;;;;;5,0;;;;;;;;;;;4,0;1,0;4,0;;3,0;;1,0;2,0;;3,0;;11,0;1,0;;6,0;;2,0;;;;5,0;;28,0;;3,0;;;;;;;;;;;;;;;;2,0;1,0;1,0;4,0;6,0;;2,0;;1,0;;;;;;6,0;;8,0;;3,0;;;2,0;;5,0;3,0;;;;;;;;;1,0;9,0;10,0;;;;1,0;;;;;;;5,0;2,0;;;;;10,0;3,0;3,0;;2,0;6,0;;11,0;;2,0;3,0;;;;1,0;1,0;1,0;;;1,0;;10,0;;;;;;;14,0;;;;;;;;4,0;;;;;2,0;3,0;;;;;17,0;;5,0;;2,0;;;2,0;;10,0;15,0;;3,0;1,0;1,0;;;1,0;3,0;;;2,0;3,0;7,0;;;;;;;;;2,0;;;;7,0;9,0;;4,0;;;;;;;;;;;;;;;;;4,0;;1,0;1,0;;;2,0;;3,0;;;2,0;;;;;2,0;;;;;;6,0;;2,0;;;;;;;;2,0;;;;;;;;;;;;;;;1,0;;;1,0;2,0;;;;;;;2,0;;;;;;;;;;2,0;;;;;;;;;;;;;;;;;;2,0;;;;;;;;;;7,0;;;;;;;;;;;;;;;;1,0;;;;;;;;;;;;4,0;2,0;;;;1,0;;2,0;;;;3,0;;;;;;;;;;;;;;;1,0;;4,0;;;3,0;;1,0;;;;1,0;;;;5,0;;;1,0;;;;;;;1,0;;3,0;;1,0;;;;1,0;;;;3,0;;;;1,0;;2,0;;;;;;;;;;1,0;;;;;;4,0;6,0;;;2,0;;;;;;;;;4,0;1,0;;;;;;;;;;;4,0;;;;;;;;;5,0;;;;1,0;;1,0;4,0;;;;;;5,0;;;;;2,0;;1,0;;;;;4,0;;;;;;;5,0;;;;;;;;;;;;;;;4,0;;;;;;;;;;;1,0;;;;;;;;;;;2,0;;;;;;;;;;;;;2,0;;;2,0;;;;;;;;;;;;;1,0;1,0;;;;;;;2,0;;;;;;;;10,0;;;;;;;;;;;2,0;1,0;;;1,0;;;;;;;;;;;;;;;;5,0;;;;;1,0;;;;;;;;;;;;;;4,0;;;;;;;2,0;;;;;;;3,0;;;;3,0;;;;;;;;;;;;;;;;;8,0;;;;;;;5,0;;1,0;;;;;;;;;;;;;;;;;;
remain;;;;;;5,0;4,0;3,0;6,0;3,0;2,0;;7,0;;2,0;7,0;;;;;3,0;1,0;;3,0;;;8,0;;;;;;6,0;;25,0;;;1,0;4,0;;27,0;;;3,0;4,0;1,0;14,0;19,0;4,0;39,0;4,0;1,0;;6,0;;;17,0;;2,0;;4,0;;14,0;;13,0;3,0;8,0;8,0;37,0;3,0;1,0;;3,0;2,0;;1,0;;;;54,0;7,0;4,0;2,0;1,0;;;;;;7,0;12,0;;;;;8,0;2,0;;17,0;2,0;;;5,0;20,0;;5,0;6,0;;2,0;2,0;;1,0;;;;13,0;17,0;13,0;8,0;7,0;;1,0;3,0;1,0;6,0;1,0;1,0;;2,0;1,0;;;7,0;2,0;3,0;1,0;2,0;1,0;15,0;;;;;9,0;3,0;;;5,0;4,0;1,0;;;;1,0;1,0;;19,0;;2,0;;5,0;1,0;12,0;;2,0;;1,0;28,0;2,0;;3,0;;;;6,0;9,0;5,0;;;;;9,0;;;11,0;4,0;;10,0;;;4,0;5,0;;9,0;;3,0;;;;5,0;;;3,0;3,0;2,0;;8,0;;2,0;;;;;4,0;;;;;1,0;;4,0;4,0;2,0;;;;;;9,0;;5,0;;;5,0;;6,0;3,0;3,0;1,0;;;1,0;2,0;2,0;;;8,0;;31,0;2,0;;;;;;;3,0;2,0;;;;;;8,0;;;1,0;1,0;;;;7,0;1,0;;;;;;2,0;5,0;2,0;3,0;12,0;;;11,0;;;;;1,0;;;;;1,0;;;2,0;;;2,0;1,0;;;;;6,0;;;;3,0;;;2,0;2,0;;4,0;;2,0;;;;2,0;;;2,0;;;;1,0;;1,0;;;;1,0;;;1,0;1,0;;;;;1,0;2,0;;;2,0;;;;;;3,0;1,0;16,0;1,0;;1,0;;;;;;;2,0;;2,0;;1,0;;1,0;;1,0;2,0;;;5,0;1,0;;2,0;;;;1,0;;;1,0;4,0;9,0;1,0;1,0;;;;;;;;;;;;4,0;;;;7,0;1,0;;9,0;;1,0;11,0;3,0;;1,0;;;;2,0;5,0;2,0;;;4,0;;;;3,0;5,0;;8,0;;4,0;2,0;7,0;;1,0;;6,0;1,0;;3,0;13,0;;1,0;;;;3,0;1,0;;19,0;2,0;;;;5,0;;;;;;1,0;;4,0;1,0;;1,0;;;11,0;;;1,0;;;6,0;2,0;;11,0;1,0;;;;1,0;;8,0;;1,0;1,0;;;;2,0;1,0;1,0;;;;1,0;2,0;;3,0;;;;;;6,0;;;;;2,0;;;;2,0;;2,0;;;;;;;;;1,0;;;;4,0;;;7,0;;;;;;3,0;;1,0;;1,0;;8,0;1,0;1,0;;1,0;;3,0;;2,0;;4,0;;;;;;1,0;;1,0;8,0;;1,0;;;;;4,0;;;;2,0;;;1,0;;;1,0;;;;1,0;;;;;;;;;4,0;;1,0;1,0;;;;;6,0;1,0;;;5,0;;;;;;;;;;;2,0;;;25,0;;1,0;1,0;;;4,0;1,0;;;2,0;;;1,0;1,0;;;;;;;;3,0;1,0;;2,0;;;;;1,0;;;;;;;;;;;6,0;;2,0;;;;;;;;;1,0;;1,0;1,0;;;;;;;4,0;;;6,0;;;;;;;;;;;;;;;;;;;;;2,0;;;;;;1,0;;;;;;1,0;;;;;;;;;;2,0;;;;2,0;;5,0;1,0;;;;4,0;;;;;;;;;;1,0;;;5,0;;;;;;;2,0;;;;;;12,0;6,0;5,0;2,0;;;;2,0;2,0;;;;;;2,0;;;;;;2,0;;;1,0;;;;;;2,0;;;1,0;;;1,0;;;;1,0;;;1,0;;;;;;;;;;;;;;1,0;;;1,0;1,0;;;2,0;;;;;;;;;;;;;;;2,0;;;2,0;;;;1,0;2,0;;;;2,0;;;;7,0;;;;;;;3,0;;;;;2,0;;1,0;;;;;;;;;;;;7,0;;;;;;;;;3,0;;;;;;;;;;;1,0;;;;;;;;;;;11,0;;1,0;;;;;;;;;;;;;;;;;1,0;;;;2,0;;;1,0;1,0;;;;;;;3,0;;;;;;;;;;;;;;;;;;;;;;;;;;;2,0;4,0;;;;;;;;;;;;;;;
render;;;;;;3,0;;5,0;6,0;1,0;2,0;;2,0;;16,0;24,0;;;;1,0;;22,0;3,0;2,0;;;19,0;1,0;;;8,0;;24,0;;25,0;25,0;3,0;;5,0;12,0;34,0;;6,0;14,0;;;25,0;22,0;17,0;50,0;;2,0;;;;;14,0;;4,0;1,0;;1,0;9,0;2,0;5,0;;12,0;1,0;10,0;;9,0;;58,0;;3,0;3,0;6,0;;;236,0;;2,0;3,0;23,0;;25,0;;;;;10,0;;;;1,0;3,0;2,0;;72,0;;14,0;5,0;17,0;49,0;;;9,0;4,0;87,0;14,0;;18,0;;;;51,0;25,0;15,0;;3,0;;;13,0;40,0;36,0;22,0;1,0;;;6,0;;;2,0;;1,0;1,0;4,0;3,0;2,0;1,0;63,0;1,0;;1,0;;;;;3,0;3,0;3,0;;8,0;;;;74,0;;;3,0;4,0;1,0;15,0;;;;43,0;29,0;;;2,0;;;;4,0;10,0;;;;;;;;;;1,0;;20,0;;;1,0;;;;;;7,0;;;;;5,0;;8,0;;;;;;;;4,0;;;;;;;;;;;;;;3,0;1,0;;3,0;;;;;;;;2,0;;;;7,0;;;12,0;4,0;;;2,0;29,0;10,0;;;;;;;3,0;;;;;;;54,0;;;;;;;;3,0;11,0;;;;3,0;1,0;;6,0;;;;;;13,0;;;;;10,0;;;;;;;;;;;;;;;;;3,0;;;;;;;1,0;10,0;;;;;;;;;;;;;;;;;;1,0;;;3,0;;;;;;1,0;7,0;;;;;12,0;;;;;;;;;38,0;3,0;;;;;;;;;;;;;;;;;;;;;5,0;;;;;;4,0;;;;;;6,0;;;;;;;;;2,0;;2,0;5,0;;;1,0;3,0;;3,0;1,0;4,0;;50,0;9,0;;;;;;;1,0;1,0;1,0;2,0;;;1,0;;2,0;;12,0;;4,0;15,0;;;2,0;;;3,0;20,0;1,0;3,0;;1,0;5,0;;2,0;1,0;;1,0;;;;2,0;;;1,0;;;;1,0;;;;1,0;;;21,0;;;1,0;2,0;35,0;3,0;2,0;;;2,0;1,0;;;2,0;3,0;;;3,0;6,0;8,0;;32,0;;7,0;;;;;6,0;1,0;;1,0;;;1,0;;;;;;;8,0;;;;;;;;;;;;1,0;1,0;;22,0;;;;;;16,0;;;;;;2,0;;;;;;;;1,0;2,0;;1,0;;;;10,0;;;;;;;;;;;1,0;2,0;;;;1,0;;;;;;1,0;;;8,0;;;;;28,0;;;1,0;3,0;;;;;;5,0;;;;;;;1,0;;4,0;;;9,0;;;1,0;;;;;;;;;;;2,0;;3,0;;;3,0;;17,0;;;;;;;3,0;;1,0;1,0;;4,0;;3,0;;3,0;;5,0;;;;70,0;;;1,0;;;;;;;;;;;;;1,0;;;;;;;;;;;;;;;;;;2,0;;;;;9,0;;;;3,0;;;;;;;;;;;;1,0;;;;;;;;;;;;;;;;;;;;;1,0;;;;;1,0;;;1,0;4,0;1,0;;;;;;17,0;;;;;;;;;;;;;;;;;;2,0;6,0;;;;;;;;;;;;;;;;;;;1,0;;;;;;3,0;6,0;;;3,0;1,0;;3,0;;;10,0;;;;;;;;;4,0;2,0;;;;;;3,0;;;1,0;;;2,0;;;1,0;10,0;;;63,0;;;;;;;;1,0;;;;1,0;4,0;;;5,0;;36,0;;;1,0;;;2,0;;;1,0;;;;;;;1,0;;;;;;;;10,0;;;;;2,0;;;;;;;;;;;;;;;;;3,0;2,0;;;1,0;;;;;;;;;;;1,0;;3,0;;;;;;;;;;;;;;;;;;;;;7,0;;;;;;;;;;;;;;6,0;;;;;;;;;;;;1,0;;;;;;;;1,0;;;;;;;;;;2,0;;;3,0;;;17,0;;3,0;;;;;;4,0;;1,0;;;;;;;;;;;;;;
responsive;;;;;;1,0;;8,0;2,0;;1,0;;4,0;;1,0;;;3,0;7,0;;1,0;43,0;;;;;6,0;;;;7,0;1,0;15,0;;20,0;10,0;;;;;37,0;;;3,0;8,0;11,0;75,0;53,0;6,0;15,0;1,0;4,0;1,0;;;1,0;5,0;;3,0;1,0;;3,0;10,0;1,0;3,0;2,0;8,0;4,0;17,0;;7,0;;18,0;;;5,0;8,0;;4,0;135,0;2,0;5,0;;3,0;;8,0;;;3,0;1,0;6,0;;5,0;;7,0;;5,0;;27,0;2,0;2,0;;13,0;14,0;;;12,0;6,0;24,0;1,0;;4,0;;;;11,0;9,0;25,0;1,0;2,0;;;;7,0;16,0;8,0;2,0;1,0;1,0;8,0;;6,0;2,0;;;;;2,0;5,0;2,0;29,0;;6,0;4,0;2,0;;;;60,0;1,0;;;2,0;2,0;3,0;;33,0;;;1,0;1,0;4,0;6,0;;;;23,0;10,0;;;8,0;;;;2,0;1,0;;;2,0;;;;;;2,0;3,0;;1,0;;;;;;3,0;;;4,0;;;;;;6,0;2,0;;;;;2,0;;;;1,0;;;;;;;;;8,0;;;;;3,0;;40,0;;2,0;;;3,0;;1,0;4,0;;;;;;;3,0;;;;4,0;16,0;;3,0;;;;;;51,0;1,0;;;;;;13,0;;;;;;;3,0;1,0;4,0;;;;;;;;5,0;;;;;12,0;1,0;;;;18,0;1,0;;;;1,0;;;;1,0;1,0;;;;;;;;;;;;;;;;;;;2,0;;;;;4,0;;;;;;;;;;;;;3,0;;;;;;1,0;;3,0;4,0;;;4,0;;;;;;;;;6,0;;;1,0;;;;;;1,0;;;;;;;;;;;;4,0;;;;;;;;;;;;6,0;;;;1,0;;;1,0;;1,0;1,0;3,0;;;1,0;;;3,0;2,0;22,0;;3,0;;1,0;;;;;;;3,0;;32,0;;;;;;1,0;;37,0;19,0;;2,0;1,0;10,0;2,0;4,0;;17,0;23,0;17,0;;;;5,0;5,0;10,0;3,0;;;;;9,0;1,0;8,0;;;;1,0;;;5,0;;;;;10,0;1,0;;;3,0;2,0;49,0;;1,0;;1,0;;1,0;;2,0;;;;;;;;;3,0;23,0;3,0;;3,0;;4,0;2,0;;9,0;;;;6,0;;;;;;;1,0;;;2,0;;;;;;1,0;;;12,0;;;4,0;;;1,0;;3,0;6,0;1,0;;4,0;3,0;;;1,0;;;;;;2,0;;10,0;;17,0;;;;2,0;5,0;;;;;3,0;;2,0;;2,0;;6,0;1,0;6,0;;;;;;;;4,0;;;1,0;;1,0;;;;3,0;;;11,0;;6,0;;1,0;;;;;2,0;;;;;;3,0;1,0;;;;;;;;1,0;;;1,0;4,0;;1,0;;;;;;6,0;;;3,0;1,0;;;;;;;8,0;2,0;;;1,0;1,0;;;;;1,0;5,0;;;;1,0;;2,0;;;11,0;;;;;;;;;;;;;;;;5,0;;;;;;;;;;;;5,0;;;;;;;;;;;;2,0;;;;;;;1,0;2,0;;;;;3,0;;;;;;;;;;;;;;;;;;;;;;;;;;;;;;;;;3,0;;;;;;;;;;;;;;;1,0;;;;3,0;3,0;;;;;;5,0;;;;;;;8,0;;;;;;;;;;2,0;4,0;;8,0;;;1,0;;;;;;;;;;;;;;;;;9,0;;;2,0;;4,0;;;;;;1,0;;;;;;4,0;;;;1,0;;;;14,0;;;;;;;;7,0;;;2,0;;2,0;;1,0;;4,0;;2,0;3,0;;;;;;;1,0;;3,0;;;;;;;;;;;1,0;;;;;;;2,0;;;;;;1,0;;2,0;;2,0;;;;;;;;1,0;3,0;;;2,0;;;;;;;;;;;;;;;;;;;;;;;;;1,0;;;;;;;;;;;;;;2,0;;;;1,0;;;2,0;;;;;;;;;;;;;;;;;;;;;2,0;;;;;9,0;;;;;;;;;;;;1,0;;2,0;;1,0;2,0;;;;;2,0;4,0;2,0;;;
retractable;;;;;;3,0;;;;;;;;;19,0;1,0;;;;;;;;;;;;;;;;;46,0;;;;;;;;;;;;2,0;;;11,0;;;5,0;;;;4,0;;;;;;13,0;;;;2,0;;;7,0;48,0;;2,0;;;;;66,0;;;;7,0;;;;16,0;;;;;;;154,0;;;;;;;;2,0;;;;;;;;13,0;;;;3,0;1,0;;;;7,0;3,0;28,0;3,0;;;;;;;;;;;;;3,0;;;;;;;;;;;;;;;;;;;;;1,0;4,0;;;1,0;;;;;;7,0;;;;;;;;3,0;;;1,0;;;2,0;6,0;;;;6,0;;;;;;3,0;;;;;;1,0;;;;;;;;;;7,0;;;;;;;;4,0;;;;;;;;;27,0;;;;;1,0;;1,0;2,0;;12,0;;;1,0;4,0;16,0;4,0;1,0;;;;;;;;;;;;3,0;;;;;;;;;;;;;1,0;;;;;;;;;;4,0;;;;;;;2,0;;;;;;;;;;;;;;;23,0;;1,0;;6,0;;;2,0;3,0;;;;7,0;;;;;1,0;;;;;;;;9,0;17,0;;;1,0;9,0;;;1,0;;2,0;;;;;;;;;;;;;;;;;2,0;1,0;;;;4,0;;;;;6,0;;;;;;;;;;;;;;;;;;;;;;;;1,0;;;;;;;;;;;;;;;;3,0;;;;;;;2,0;;;;;;;4,0;;;;;;;;;;;;1,0;;;;;;;;;;;;3,0;;;;;;;;2,0;;;;1,0;;;;;;;;;;1,0;;;;;;;;;;;;;;;1,0;;;3,0;;;;;;;2,0;;;;;;;;;;;;;;;;;;;11,0;;;7,0;;;;;;;;;;;;;;;;;;;;;;;;;;;;;;;;;;;;;;;;;;;;;19,0;;;;;;;;;;;;;;;;;;;;;;;;;;;;;;;;;;;;;;;;;;;;;4,0;2,0;;;;;;1,0;;;;;;;;;;;;;;;;;;;;;;;;;;;;;;;1,0;;;;;;4,0;;;;;;;;;;6,0;;;;;;;;;;;;;;;;;;;;;;;;;;;;;;;;;;;;;;;;;;;;;;;;;;;;;;;;;;;;;;;1,0;;;;;;;;;;;1,0;;;;;;;;;;;;;;;;;;;;;;;;;;;;;;;;;;;;;;;;;;;;;;;;;;;;;;;;;;;;;;;;;;;;;;;;;;;;;;;;;;;;;;;;;;;;;;;;;;;;;1,0;;;;;;;4,0;;;;;;;;3,0;;;;;;;;;;;;1,0;;;;;;;;;;;1,0;;;;;;;;;;;;;;;;;;;;;;;;;;;;;;;;;;;;;;;;;;;;;;;;;;;;;;;;;;;;;;;;;;;;;;;;;;;;;;;;;;;;;;;;;;;;;;;;;;;;;;;;;;;;;;;;;;;;;;;;;;;;;;;;;;;;;;;;;;;
rigid;;;;;;1,0;;2,0;4,0;3,0;17,0;;2,0;;11,0;14,0;1,0;;;;8,0;2,0;;;;;;;2,0;;1,0;;7,0;;;;;;;;;;3,0;;;;3,0;6,0;;1,0;10,0;1,0;;;;3,0;30,0;;;;1,0;;1,0;;;;;11,0;47,0;1,0;;;;;;;;;;8,0;4,0;;;9,0;;;;;;9,0;4,0;;;16,0;;;;;4,0;;;2,0;14,0;2,0;;;1,0;;;2,0;1,0;;1,0;;;6,0;36,0;10,0;1,0;;;;;;;;;;1,0;;;;6,0;;;;5,0;;1,0;;;;;5,0;;;3,0;6,0;2,0;;;;;;;;8,0;;;;;;10,0;;;;7,0;1,0;;;;;;;;;9,0;;;;40,0;5,0;;;;21,0;;12,0;;;2,0;;;32,0;;;;1,0;;5,0;4,0;2,0;;1,0;;6,0;1,0;;;5,0;;3,0;;;;;;;3,0;;6,0;;3,0;;2,0;3,0;;;;;5,0;3,0;;35,0;;3,0;;;5,0;;;3,0;;;;;;;;21,0;;;2,0;1,0;;1,0;1,0;;3,0;;;;;;;;4,0;1,0;;;1,0;1,0;2,0;;;1,0;;11,0;39,0;2,0;;;;5,0;;;;;;;;;;;2,0;;;;2,0;3,0;2,0;7,0;10,0;;;;;;3,0;;;10,0;;;2,0;;;;;16,0;;;;2,0;;;;;;;;3,0;;;;;;2,0;;4,0;;;9,0;;;;;4,0;7,0;;;10,0;;;;13,0;11,0;5,0;;7,0;;;;;;1,0;;6,0;5,0;;;;;;;;;6,0;13,0;;3,0;;;;1,0;;;;;4,0;1,0;3,0;;;;;3,0;4,0;;;;;;2,0;;;;;;;;;;;4,0;;4,0;;;;;;2,0;;;;;3,0;;;;;;;;;;;;;3,0;1,0;3,0;;;;;;;;;;;;;;;;;;;;;;;;;;;;;;;;1,0;;;;;;1,0;1,0;;;;;;;;2,0;;;;;;;;;1,0;;7,0;;;;;;;;2,0;;;2,0;;;;;;;;;;;1,0;2,0;;;;2,0;;;;;;14,0;;;;;;;;;;;;;;;;;;2,0;;;;3,0;;;3,0;;;;4,0;;6,0;;;;;;1,0;;;;;;;9,0;;;;;;;;;;;2,0;;;;;;;;;;;;;;;;;;;;;;2,0;;;;;;;;;;;;;;;;;;;;;;;5,0;;;;;;;;;;;;;;2,0;4,0;2,0;;;;3,0;4,0;;;;3,0;;5,0;;;;;;1,0;1,0;;;;2,0;;;;;;2,0;23,0;3,0;;;3,0;3,0;;;;1,0;;;;;;;;1,0;;;14,0;;;;;;7,0;;;;;;4,0;;;14,0;;;;2,0;;;;;;;;2,0;;;2,0;;;;;;;;1,0;;;3,0;;;;;;;;;;;;;;;;;;;;;;;;;;;;;;;;;;;;;;;;;;;;;;;;;;;;6,0;;;;;;;8,0;;3,0;;;;;;;;;;;;;;;;;;;;;;;;;;;;;;;;;;;;;;;;;;;;;;;;;;;;;;;;;1,0;;;;;2,0;;;;;;;1,0;;;;;;;;;;1,0;;;;;1,0;;;;;;;;;;;;;;;2,0;;;;;;;;;;;;;;;1,0;;3,0;;;2,0;;;1,0;;;;;;;;;;;;;;;;;;;;;;;2,0;;;;;;;;;;5,0;2,0;;;;;;;;;;;;;;;;;;;;;;;;;;;;;;;;;;;;;4,0;;;;;;
robot;;;;;;2,0;;10,0;;1,0;;;;;1,0;12,0;;;;;;10,0;;;;;;;;;;;34,0;;14,0;21,0;;;;;3,0;;9,0;;8,0;2,0;16,0;1,0;;6,0;2,0;;;;19,0;;;;3,0;;2,0;;4,0;;;;;1,0;;;;;;;;2,0;5,0;;;35,0;;;;17,0;;1,0;;;;;2,0;;;;;;;;26,0;24,0;17,0;;6,0;2,0;;;5,0;;1,0;;23,0;5,0;;2,0;;12,0;;24,0;;2,0;;;;;;3,0;;;;;;3,0;;;2,0;;12,0;2,0;;;;;;2,0;;;;1,0;6,0;;;;2,0;12,0;;;45,0;;;;;2,0;25,0;;3,0;;12,0;6,0;;;;;;;;;;;;;;1,0;;;;;;;;;;;;1,0;;;;;;;;;;;;;;;;21,0;;;2,0;;;;;;2,0;;;;;;;;;;;;;;;13,0;2,0;20,0;19,0;;;;1,0;;;;;;;;;;;;;;;;3,0;;;;;;;4,0;;;;;;;;;5,0;;;;;;;1,0;4,0;;;;;8,0;;;;;3,0;;;;;;;;;;1,0;2,0;1,0;;;;;;;;;1,0;;;;;;;;4,0;;;;;1,0;;;;;4,0;;;;;;;;;;;;;;;;;;;;1,0;;;;5,0;;;14,0;30,0;;;;;;;;;;;;;6,0;;;;;;;;4,0;4,0;;;;;;;;;;1,0;;2,0;3,0;1,0;;;;;;4,0;;;;;;;;;;3,0;;;;;;;;;;;;1,0;;;;;;2,0;;;;4,0;;;4,0;;;;1,0;;12,0;1,0;13,0;;;;3,0;;1,0;;;;;31,0;;1,0;4,0;;;;;;2,0;;;;;;3,0;;;;;;1,0;;;1,0;;;;;;1,0;55,0;;;;;;;;;;;;;;;;;18,0;;;;;;;;;;;;;;;22,0;3,0;;;;;;;;;;;;;;;;;;;;;;;;;7,0;;;;;;;;;;;;;2,0;;;;;;;2,0;2,0;;;;3,0;;;;;;;;;;;;;;;;;;;;;;;;16,0;;;;;;;;;6,0;;;27,0;;;;;;;;;;;;;;;;;;;;5,0;1,0;;1,0;2,0;;;1,0;;;;;;;;;6,0;;;;;;;1,0;;;;;2,0;;;;;;;;;;;;;;;;1,0;;;;;;;;;;;;;;6,0;;;;;;;;;;;;;;;;;;;;;;;;1,0;;;;;;;;1,0;;;;1,0;;;;;;6,0;;;;;;;;;;;;;;;;;;;;;;;;;;;;;;;;;;;;;;;;;;;;;;;;;;6,0;;;;;;;;;;;;;;;;;;10,0;;;;;;;;;;;;;;;;;;1,0;;;;;;;;;;;;;;;;;;;;;;;;;;;;;;;;;;;;;;;;;;;;1,0;;;;;;;;1,0;;;;;;;;;;;;;;;;;;;;;;;;;;;11,0;;;;;;;;;;;;;;;;3,0;;;;;;;;;;;;1,0;;5,0;;;;;;;;;;;;;;;;2,0;;;;;;;;;;;;;;1,0;;;;;;;;;;;;;;;;;;;;;;;;;;;;;;;;;17,0;;;;2,0;;;;;;;;;;;;;;
roll;;;;;;173,0;;3,0;;;;;;;93,0;4,0;;;;1,0;14,0;;;;;;;1,0;;1,0;;;4,0;;2,0;9,0;7,0;4,0;;;10,0;;3,0;;;;19,0;3,0;11,0;7,0;;;;;;2,0;;2,0;23,0;;3,0;;;;1,0;;;;29,0;13,0;;;;;;1,0;25,0;;;35,0;;4,0;;32,0;;;;;;2,0;5,0;;;;;13,0;;;19,0;1,0;;1,0;;1,0;;3,0;1,0;;4,0;2,0;;2,0;;;;1,0;23,0;7,0;1,0;9,0;4,0;;;1,0;4,0;;;;;8,0;;;6,0;;1,0;;2,0;;;;;;;10,0;;;;;2,0;;;;;3,0;;8,0;7,0;;32,0;;;;6,0;;3,0;;;;;;;;2,0;;3,0;;15,0;;;;;;;;;;;;;;;;;3,0;;;;;;;;;1,0;10,0;4,0;;;;;;;;;;;;;;;;;;;;;;;;;;;;1,0;1,0;1,0;2,0;1,0;;1,0;;;;1,0;1,0;;;;;;;5,0;;;;;;2,0;;;;;;;1,0;;4,0;;;2,0;;;;;;;;;1,0;;2,0;;;;;2,0;;;;;;17,0;9,0;5,0;;;;1,0;;;;2,0;2,0;13,0;;3,0;3,0;;;;;;;1,0;;;;;;1,0;1,0;;;;;2,0;;3,0;;;;;2,0;;;;;;;6,0;;;;;;;1,0;;43,0;1,0;;;1,0;;;;;11,0;7,0;;;;;;;;;;;;;;;;;;;;1,0;1,0;9,0;;;13,0;8,0;;;;;3,0;19,0;;;;;;;2,0;;;;12,0;;;1,0;;;;6,0;;3,0;;;;;;;;;;;;;;;1,0;;;;;1,0;;;1,0;;;;;;;;;5,0;10,0;;;;2,0;;25,0;;;61,0;;3,0;;18,0;1,0;1,0;;;;;;;;;1,0;;;18,0;;;;;3,0;2,0;;5,0;;;1,0;1,0;;2,0;;;;;;;;;;1,0;;;;;;;18,0;;;;;;;;;;;;;;;;;;;;;;;1,0;;;;;;;;;;;;;1,0;;;;;3,0;;;;;;;;;;;;;;;;;;;;1,0;;;9,0;;;;;;;;;;;;;1,0;;;;;;;;;;;;;6,0;;;3,0;;;;;11,0;;2,0;;15,0;;;;;;;;;;;;;;;;;;;;;;;;;;1,0;;;;;;;;1,0;;;;;;;;;;;;;;;;;;;;;;1,0;4,0;;;;;;;;12,0;;;;1,0;;;;;;;;;;;8,0;;;12,0;;;;;4,0;;;;;;;;69,0;;;;;;;;;1,0;;;;;;;;;;;1,0;;;;;;;;;;;1,0;;;;;;6,0;;;;;;;;;;;;1,0;;;;;;;;;;;;;;6,0;1,0;;;1,0;;;;;;;;;;;;1,0;;;;;;;;;;;;;;;;;;;;;;;;1,0;;;;;;;;;;;;;;;;;;;;;;;;;;;;;;;6,0;;;;;;;;;;;;;;;;;1,0;;1,0;;;4,0;;;;;;;;;;;;;;;;;;;;;4,0;;;;;;;;;;;;;;;1,0;;;;;;;;;;;;;;;;;;;;2,0;;;;2,0;;;;;;;;;;;;2,0;;;;;;;;;;;;;;;;;;2,0;;;;;;;;;;;6,0;;;;;;;;;;;;;1,0;;;;;;;;;;;15,0;;;;;;;;;;;;;;;;;;1,0;;
rolling;;;;;;6,0;;8,0;1,0;6,0;;;;;18,0;;;;;;;;;;;;;;;;;;;;9,0;;;;;;;;;;;;;2,0;;;1,0;1,0;1,0;;38,0;;45,0;;;;;;;;;;;2,0;;4,0;;;2,0;;;;;;;1,0;;;;8,0;;;;;;;8,0;;;;;;;;4,0;;1,0;;10,0;2,0;;;6,0;3,0;;;2,0;14,0;;;;5,0;13,0;4,0;;;2,0;;;;;;;;;;;;;;;;2,0;;;;;;;2,0;;;;16,0;1,0;;;;;;;;20,0;;19,0;;;;14,0;;;;;;;;;;;8,0;;6,0;3,0;10,0;;;;;;;;;;1,0;;;;;;1,0;;;;;;3,0;;;;30,0;;2,0;;;21,0;8,0;;;8,0;;;;2,0;;;;;;1,0;;;;;;;;7,0;;;1,0;5,0;;19,0;;;;;;;;;;;;17,0;;;;;1,0;;;;;;;;;1,0;6,0;;;2,0;;41,0;;1,0;;;;;;;;;2,0;;;;;;;;;;;10,0;1,0;;;;;;;1,0;;4,0;;;;6,0;44,0;;;;;;1,0;;2,0;;;;;;;;;;;51,0;;;;;;;;;;;;1,0;3,0;1,0;;;;1,0;1,0;;;;;;;;4,0;;;;;;;;;;;;;4,0;;;2,0;;;;;;;;;;;20,0;9,0;;;;;;;;;;8,0;;;;;;;6,0;;;;;;;;;;;;;;;1,0;;;;;;;;;;1,0;2,0;;;;;;;;;;;2,0;;;;;2,0;;;1,0;6,0;;;3,0;19,0;;1,0;;;4,0;;;;;1,0;;;;;;;;;;;;;;;;;;;;;;;;;;;4,0;;;;;;;;;;;;;;;;;;;;;;;1,0;;;;;;;;;;;;;;;;1,0;;;;;;;;;;;;;;;;;;;26,0;;;;;;;;;;;;;;;;;;;;;;;;;;;;;;;;;;;;;;;;;;;;;;;;;;;;;;;;;12,0;;3,0;;;;;;;;;;;;;;;;;;;;;;;;;;;;;;;8,0;;;;;;;;;;;;;;;;24,0;;;;;;;;;;;;;;;;;;1,0;;;;;8,0;1,0;;;;;;;;;;;;;;;;;;;;;;;;2,0;;;;1,0;;;;;;;;;;1,0;;;;2,0;;;;;;;;;;;;22,0;;;;;;;;;;;;;;;;;;1,0;;;;;;;;;;;;;;;;;;;;;;;;;;;;;;;;;;;;;;;;;;;;;;;;;;;;;;;;;;;;;;;;;;;;;;;;;;;;;;;;;;;;;;;;;;;;;;;;;;;;;;;;;;;;;;;;;;;;;;;;;;;;;;;;;;;;;;;;;;;;;;;;;;;;;;;;;;;;;;;;;;;;;;;;;;;;;1,0;;;;;;;;24,0;;1,0;;;;;;;;;;;;;;;;;;1,0;;;;;;;;;;;;;;;;;;;;;;;;;;;;;;;;;;;;;;;;;;;;;;;;;;;;;;;
rotary;;;;;;5,0;10,0;7,0;;22,0;2,0;;;;19,0;29,0;1,0;;;;;;;;;;;;;;1,0;;25,0;;65,0;3,0;;1,0;;;;;14,0;;7,0;1,0;;20,0;;1,0;1,0;2,0;;;27,0;4,0;4,0;;;;7,0;;;;;;3,0;5,0;;4,0;5,0;;2,0;;;1,0;;;;3,0;9,0;12,0;1,0;23,0;;15,0;;;;5,0;15,0;;;;;;;;3,0;;;;35,0;;;;27,0;;4,0;;1,0;;;;;3,0;15,0;30,0;5,0;8,0;;;;2,0;;;;;;;;;;;;;;;;;;;7,0;3,0;;;;14,0;4,0;;;;1,0;;;2,0;19,0;;6,0;;;15,0;38,0;;;;4,0;6,0;;;;;;1,0;3,0;1,0;8,0;;;;;8,0;;;;9,0;;2,0;;;;;;16,0;;;;;;8,0;;;;16,0;6,0;;2,0;;;1,0;;;3,0;;;;;;;5,0;6,0;;;;;;;;33,0;;15,0;;28,0;8,0;4,0;6,0;;;3,0;;1,0;;;;1,0;;;;;;7,0;;;;;;10,0;;;;;;15,0;;;;;;3,0;;5,0;;;;;;;;;4,0;4,0;;;;;;;;;;1,0;;;;;;;;;;20,0;;6,0;1,0;2,0;;;;;;;;;3,0;1,0;;;;;17,0;41,0;;;;14,0;;12,0;;1,0;;;;;;;;;6,0;;4,0;;;3,0;;;;;48,0;1,0;;6,0;4,0;;;;6,0;1,0;2,0;5,0;;;2,0;;;2,0;;;6,0;;;;;;;;;1,0;5,0;69,0;13,0;1,0;;;70,0;4,0;;;;;3,0;;2,0;;;1,0;7,0;;;2,0;;;;;;;;;1,0;;;1,0;;;;;;;;2,0;;;;4,0;;;;;;;;;2,0;;3,0;2,0;;1,0;;1,0;;;15,0;5,0;;;;8,0;;;;;;;;;;2,0;;;;;;;8,0;;;;;;;;;;;;;;;;;;;;3,0;;;;;;;;;;;;;;;;;20,0;;;6,0;;;;;;;;;;;;;;;;;4,0;;;;;;;;;;;;;4,0;;;1,0;;;2,0;;5,0;;;;;;;;;;;;;;;;;;;;;;;1,0;;2,0;;;;;;;;;2,0;;;;;;;;;1,0;;;;2,0;;;;;;7,0;;;;;;;;2,0;;;1,0;;;;;;;;;;;;;;;;;;;;;;;;;;;;;;;;;;;;;;;;;;;;;;1,0;;;;;;1,0;;;2,0;;;4,0;;;;;;;14,0;;1,0;;;;;;;;;;13,0;2,0;;;;3,0;;;;;;;;;2,0;;1,0;;;;;;12,0;4,0;;;;;;;;7,0;;;;;;;1,0;1,0;;4,0;;11,0;1,0;;;;;;;;;2,0;;2,0;;1,0;;;;1,0;;;;;;;;;;;;3,0;;;1,0;;;;;;;4,0;;;;;;;;;;;;;;;;;;;;;;;;;;;;5,0;;;;;3,0;;;;;;;;;;;;;;;;;;;;;;;;;;;;;;;;;;;;;4,0;;;2,0;;;;;;;;;;;;;;;;;;;;;;;;;;;;;;;;;;;;;7,0;;;;;;;;1,0;;;;;;;;;;;;;;;;;;;;;;;;2,0;;;;;;;;;;;;;;;7,0;;;;;;;;;;;;;;;51,0;;;;;3,0;;;;;;;;;;;;1,0;;;;;;;;;;;;;;;;;;;;;;;;;;;;;;;;;2,0;;;;;;;;;;;;
score;;;;;;10,0;;;;;;;13,0;;4,0;14,0;;;;;;5,0;;;;;;1,0;;;;;5,0;2,0;;;;8,0;;;3,0;;2,0;;1,0;;35,0;8,0;;14,0;;1,0;;;;2,0;;;4,0;;;;;;1,0;;7,0;;3,0;;3,0;;13,0;;;;3,0;;;39,0;;;;4,0;;5,0;;;;;;;;;;;1,0;;34,0;;1,0;;;10,0;;;;1,0;;;;3,0;;;;26,0;11,0;9,0;;10,0;;;1,0;3,0;2,0;;;;;1,0;;;2,0;;1,0;;;;;;1,0;;1,0;1,0;;;;;;;1,0;;;;1,0;;5,0;;;1,0;1,0;;3,0;;;;6,0;9,0;;;;;;;;8,0;2,0;;;;;;;;;3,0;;;;;1,0;1,0;;;;;;;;;;;;;;;;;;3,0;;1,0;;;;;;;;;;;;;;;;;;;;;;;;;;;;;5,0;;;;;;;;;;;;;;;;;;;;;;;15,0;;;2,0;;;;;;;;;;;;;;;;;2,0;;;;;;;;;;;;;;;;;;;;;;;;;;;;;;;;4,0;;;;;;;;;;;;;;;;;;;;;;;;;;;;;;;;;;;;;;;;;;5,0;1,0;1,0;2,0;;;;;;;;;;2,0;;;;;;;;;;;;1,0;;;;;;;;;1,0;;;;;;;15,0;;;;;;;;;;;17,0;;;9,0;;2,0;;;;;;1,0;;;;;;11,0;2,0;;;;2,0;;1,0;4,0;;17,0;4,0;17,0;;;9,0;;;;;1,0;;;;;;;;;;;;;4,0;;;;;;;;;47,0;;;;;;2,0;;;;;;;;;;;;;;;;;;;;;;;;;;;;;;;;;;;;;;;;;;;;;;;;;;;;15,0;;;;;;;;;;1,0;8,0;1,0;;;;;;;;;;;2,0;;;;10,0;;;;;;;;2,0;;;;1,0;;;;;;2,0;;;;;;;;;;;11,0;;;;;;;;;;;;;;;;;;;;1,0;;;;;;;;;6,0;;;;3,0;;;;;;;;;1,0;;6,0;;;;;;22,0;;1,0;;;;;;;;;;;;;;5,0;;;;;;;;;;;;;;;;;;;6,0;;;;;;;;;;;;;;;;;;;;;;;;;;;;;;4,0;2,0;;;;;;;;;;;;;;3,0;;;;;;;;;;;;;;;;;;;;;;;;;;;;;;;;;;;;;;;;;;;;;;;2,0;;;;;27,0;;;;;;;;44,0;3,0;;;;;;1,0;;2,0;;;;;4,0;;;4,0;11,0;21,0;;;;;;;;;;;;;;;;;;;2,0;;;2,0;;;;;;;;;;;;;;;;;;;;;;;;;;;;1,0;;;;4,0;;;;;;;;;;;;1,0;10,0;;;;;;;;;;;;;;;;;;;;;;;;;;;1,0;;;;;;;;;;;;;;;;;;7,0;4,0;;;;;;;;;;;;;;;;;;;;;;;;;;;;;;;;;;;;;;;;;;13,0;;;;;;;;;;2,0;;;;;;;;;;;;;;;;;;;;8,0;;;;;;;;;;;;;;;;;;;;;;;
seal;;;;;;1,0;1,0;13,0;5,0;5,0;2,0;;;;;3,0;3,0;;;;;1,0;;2,0;;;4,0;3,0;;;;2,0;16,0;;2,0;;;;;;;;6,0;;2,0;;;18,0;11,0;2,0;15,0;;;;1,0;3,0;23,0;;;;;4,0;;;8,0;2,0;4,0;41,0;1,0;10,0;;;;;;3,0;;;2,0;11,0;;24,0;;21,0;;;;;;;35,0;;;44,0;;8,0;;;17,0;;;;57,0;4,0;;;9,0;2,0;1,0;;1,0;;6,0;1,0;;13,0;41,0;11,0;6,0;;8,0;;;;;;;;;;;1,0;1,0;10,0;;;3,0;1,0;;;;;;12,0;1,0;;;19,0;2,0;;;1,0;;;;1,0;10,0;;;;;;21,0;;;;4,0;2,0;;;;;12,0;;;5,0;14,0;13,0;2,0;;2,0;5,0;4,0;6,0;;10,0;;3,0;;;;;1,0;6,0;;11,0;;;;32,0;;;3,0;1,0;;;;1,0;;6,0;7,0;;2,0;;8,0;;3,0;4,0;;23,0;106,0;2,0;2,0;;;9,0;34,0;;27,0;2,0;93,0;2,0;3,0;11,0;1,0;1,0;;21,0;15,0;3,0;;2,0;4,0;;;;3,0;3,0;2,0;;17,0;;;3,0;2,0;;16,0;;;;4,0;5,0;11,0;3,0;;;1,0;1,0;4,0;3,0;;2,0;16,0;;;;;14,0;14,0;53,0;;;;1,0;;;;;;8,0;;;;;3,0;6,0;;;;;;1,0;4,0;;;;;;5,0;;1,0;2,0;;;10,0;1,0;1,0;2,0;;1,0;;2,0;;1,0;;1,0;10,0;;;1,0;;4,0;;5,0;;;;8,0;;;;;;;3,0;;;3,0;;;3,0;;;;;;;1,0;2,0;;;;7,0;;;;;10,0;;;1,0;;;;;;30,0;;1,0;;3,0;5,0;;;1,0;;1,0;1,0;;5,0;2,0;;;;6,0;;;;23,0;2,0;;;;;1,0;;;;;;;;;;;;;;;;;;2,0;;;;;2,0;;;;;;;;;;;1,0;;1,0;;;;;;3,0;;;;;;;;;;;;;;;;;;;;;;;;;;1,0;;;;;;;;1,0;1,0;;;;;;;1,0;;;;;;;;;;;;;;;;;;1,0;;;;;2,0;;;;;;;;;;;;1,0;;;;2,0;;;;;;3,0;;1,0;;;;;;;;;;;;;;;;;;;;3,0;;;3,0;;;;;2,0;1,0;;;2,0;;;;;;6,0;;;2,0;3,0;;1,0;;4,0;;5,0;;;;;;;;;;10,0;2,0;;;;;;10,0;;;;;;;1,0;;;;;1,0;;;;;;;;2,0;;;;;;;;12,0;;;;;1,0;;;;1,0;;;;;;;;;;2,0;;;;;;4,0;;;;;4,0;;;;;;;;4,0;;;4,0;;7,0;;;;1,0;;;1,0;;;;3,0;;;;;;;10,0;;;;;;;;;2,0;1,0;;;;;;;;;;1,0;;;;2,0;;;;;;;;;15,0;15,0;3,0;2,0;14,0;;;;;;;;2,0;;;2,0;;4,0;;1,0;;;9,0;9,0;;;5,0;;;;;;;;1,0;;1,0;;;;;;;;;;;;;8,0;;;;;;;;;;;;;;;;;;;;;;;;;;;1,0;;;;;;;;;;;;;;;2,0;;;;;1,0;;;;;;;;;;;;;;;;;;;;;;;;;;1,0;;;1,0;;5,0;;;;;;;;;;;;;;;;;;;;;;;;;;;;;;;1,0;;;;;;;;;;;;;1,0;;2,0;;;;;;;;;;;;;;3,0;;;;2,0;;;;;;1,0;;;;;;;;;;;;;;;;;;2,0;;;;;;;;;;;;;;;;;;2,0;;;;;;;;;;;;;;;;;;2,0;;;;;;;;;;;;;;;;;;;;;;;;4,0;;
search;;;;;;25,0;;;25,0;1,0;;;2,0;2,0;3,0;40,0;;;;;;18,0;;11,0;;;13,0;1,0;;;;3,0;9,0;;12,0;3,0;;2,0;1,0;;31,0;;6,0;1,0;8,0;2,0;31,0;64,0;2,0;20,0;;7,0;;4,0;;8,0;1,0;1,0;;;;;1,0;;;;54,0;;34,0;;;;2,0;1,0;;;1,0;;;155,0;;7,0;;15,0;2,0;13,0;;;;1,0;11,0;5,0;;;;8,0;2,0;1,0;31,0;4,0;;;3,0;54,0;;2,0;;5,0;12,0;5,0;;27,0;;;;10,0;18,0;26,0;;20,0;;;14,0;9,0;14,0;;;;;102,0;6,0;17,0;;;1,0;;6,0;2,0;7,0;;24,0;;3,0;15,0;29,0;;;;7,0;5,0;17,0;;10,0;16,0;2,0;;11,0;;;;;;26,0;6,0;;;20,0;;;;;;;1,0;1,0;2,0;;;;;;;;;;1,0;;1,0;;;;2,0;;4,0;;;;1,0;;;;;;11,0;;;;2,0;4,0;17,0;;;;;;;;;;;;2,0;;3,0;;;;;;;;;;2,0;;;;;;;8,0;;;1,0;;;;;10,0;8,0;;;;;;;10,0;;;;;;;18,0;;;2,0;;;;;;;;;;;;;4,0;;;2,0;;;7,0;;;;;2,0;14,0;;;;;;;;;23,0;1,0;1,0;;;;;7,0;;1,0;;;;;;2,0;;;;;;;;;1,0;1,0;;;;;;;;;;5,0;;;;;;;;2,0;;;;;;2,0;;;;;;;;7,0;36,0;;;1,0;;;;;;;;;;;;;1,0;;;;;;;;;;;;;;;;;23,0;;;;;;;5,0;;1,0;;;;;;1,0;;3,0;8,0;4,0;10,0;4,0;;;;1,0;;;;;;;1,0;;2,0;;4,0;1,0;;;13,0;;;3,0;;12,0;;1,0;;;21,0;11,0;;;4,0;1,0;;;1,0;;;;;;;;;;;;;;2,0;;;;;2,0;23,0;2,0;;;2,0;13,0;;12,0;2,0;;5,0;4,0;;2,0;;24,0;;;;;;;;1,0;5,0;;;;;;;;;1,0;3,0;40,0;1,0;;1,0;3,0;;;3,0;;1,0;;;5,0;;;;;1,0;;;;;;;18,0;1,0;;;5,0;4,0;;;4,0;1,0;;;;;;2,0;;;;8,0;;;;;;;8,0;;;;;;;;;6,0;;;;2,0;;;;17,0;;;;;;;4,0;;;;;;;;3,0;;;;1,0;;;;;;6,0;4,0;;1,0;7,0;4,0;;;;1,0;;;;;1,0;1,0;;;;;;;;;;;;2,0;3,0;;27,0;1,0;;1,0;;;9,0;4,0;3,0;;;;1,0;;;2,0;;;;3,0;7,0;;;;;17,0;1,0;;;;28,0;;;;;2,0;;1,0;;2,0;;2,0;;;;;;;;;;;;;;2,0;;;;9,0;18,0;;;;;;;;;;1,0;;;;;;;;;;;33,0;;;;;;;;;;;;;;;;;;;;;;;;;;;;;;;;;;;;6,0;;;;;;;;;;;;;;;;;;;;;;;15,0;;;2,0;;;2,0;5,0;;;;2,0;1,0;4,0;;;;;;;;4,0;10,0;1,0;2,0;3,0;;;;;;;;;;;;5,0;;2,0;;;;;;;;5,0;;;;;;;;;;;;;;;3,0;;;2,0;;;6,0;;;;;;;1,0;;;;;;;;;1,0;;;;;;;8,0;2,0;;2,0;2,0;;;;;;2,0;;;;;;;;;;;;;;;2,0;4,0;;1,0;;;;;;2,0;;;;;;4,0;;;1,0;;;;8,0;;;;;;;;;;;;;;;;;;;6,0;;8,0;;;2,0;;;;;;3,0;;;;18,0;;;;;;;;;;;;;;;;;;2,0;;;;;;;;1,0;;;;;;;;5,0;;2,0;;4,0;;;2,0;;;;;;;;;;;;;;;;;;;;
selectable;;;;;;2,0;1,0;1,0;4,0;;14,0;;6,0;;;2,0;2,0;;;1,0;;2,0;1,0;;;;1,0;26,0;;;;;3,0;;20,0;1,0;;4,0;;;5,0;;1,0;;1,0;6,0;4,0;25,0;5,0;30,0;1,0;2,0;;;;;6,0;;;;;3,0;2,0;1,0;;4,0;;;;;;;4,0;;;6,0;2,0;;1,0;58,0;;29,0;;37,0;;1,0;;;;;6,0;1,0;;2,0;;1,0;;;11,0;;;2,0;1,0;4,0;;;1,0;1,0;9,0;7,0;1,0;1,0;;;;43,0;2,0;9,0;1,0;;;;;35,0;;;;;;8,0;;9,0;;;4,0;;4,0;;;1,0;;;;6,0;8,0;;;1,0;5,0;;;;1,0;1,0;;;6,0;;4,0;;;4,0;1,0;;;;2,0;;;;2,0;;;;1,0;;2,0;;;;;;;;;4,0;;7,0;;;;2,0;;1,0;;;3,0;;;;;;;10,0;;;;;;;;;;;;;;;1,0;;;;;;;;;;3,0;;;;3,0;4,0;;;;;1,0;;;;;;;;;;34,0;;;;;;;;5,0;2,0;23,0;;;;;18,0;;;;;;;;1,0;;;1,0;;;;;3,0;2,0;;1,0;;;6,0;;;;;;;;;;;;;;;;1,0;;;;;;;;;;;;;;;;;;;;;;;;;;;;;;;;;;3,0;;;;;;;;;1,0;4,0;;;;1,0;;;1,0;;;;;10,0;2,0;;;;;;;;;;;1,0;;;;;;;;;;;;;1,0;;;;;;;;;2,0;;;;;;;;;;;;6,0;;;1,0;;;1,0;;;;5,0;;;;;;;;14,0;1,0;1,0;1,0;;;;;1,0;;10,0;;;;;;;34,0;;;1,0;;;;;8,0;;;;;;;4,0;1,0;1,0;;;;;;;;1,0;;;;1,0;1,0;;;;;;39,0;;;;;;1,0;;;;;;;;;;;;;;;;;4,0;3,0;;;;;1,0;;;;;;;;16,0;;;;;;;;;;3,0;;;;1,0;;;1,0;1,0;;;3,0;;2,0;;;;5,0;;;;;;2,0;;;;;6,0;;;;1,0;;;;;;;;;;2,0;;;;1,0;;;1,0;2,0;;;;4,0;;;;;;;;;;;;1,0;;;;;;;;;;7,0;3,0;;;;3,0;;;1,0;;;;;;5,0;;;;;;6,0;;1,0;;;;;;;13,0;;;1,0;;;;1,0;;1,0;;;;;;;;;3,0;;;;;;;;;;1,0;;;;;;;3,0;;;;;;1,0;;;;;;;;1,0;;;;;;;3,0;;;;;;;;;;;;4,0;;;;;;;;;;;;;;;;;;;;;;1,0;;;;;;;;2,0;1,0;;;;;;;;;;;;;;;1,0;;;;;;;;;;;;;;;;;;3,0;;;;;;;;28,0;;;;;;;;;;;;;;;;;;3,0;;;;;;;;;;;;;4,0;;;;;;;;;;;;1,0;;;;3,0;;;2,0;;;;;3,0;;;;;;;;;;;;;;;;;;6,0;;;;;2,0;;;;;;2,0;;;;;;;;;;;;;;;1,0;;;;;;;;;;;;;;;;;;;;;;;;;;6,0;;;;;;;;;;;;;;;;;;;;;;;;;;;;;;;;;;;;;;;4,0;;;;;;;;;;1,0;;;;;;;;;;;;;;;;;;;;;;;;1,0;;;;;;;;;;;;;;;;2,0;;;;;;;;;;;;;;;;;;;
sequential;;;;;;1,0;;3,0;;1,0;2,0;;;;;3,0;;;1,0;;;13,0;;;;;8,0;;;;2,0;;3,0;;4,0;;;;;;4,0;;1,0;;73,0;8,0;4,0;3,0;1,0;10,0;;;;;1,0;;;;;;;2,0;4,0;;;1,0;1,0;;49,0;1,0;;;5,0;;;5,0;;;4,0;69,0;;;8,0;48,0;;12,0;;;;;2,0;;;;;1,0;2,0;;25,0;1,0;;;1,0;;;;1,0;7,0;8,0;;;3,0;;;;13,0;;1,0;;2,0;;;;1,0;8,0;4,0;;;;;;;;;;;2,0;1,0;;;2,0;;;2,0;1,0;;;;12,0;;;;;;2,0;;6,0;;;;;;3,0;;2,0;;14,0;6,0;;;;;;;;1,0;;;;;;27,0;;;;;;2,0;;;;;;;;;;;;;;;6,0;;1,0;;;;;;;;;;;;;;;;;;;;;;;;;;;;;4,0;;;;;;;2,0;;;1,0;;;;;10,0;;;;;;;;8,0;;;;;;;6,0;;;1,0;;20,0;;;3,0;1,0;;;;;;;;;;;;;5,0;;;;;5,0;;;;;;;;2,0;;1,0;;;;;;;;;1,0;;;;;;;;;;;;;;;1,0;;;;;;;;;;;;;;;;;;;;;;4,0;1,0;1,0;14,0;;;2,0;;;;;1,0;;;;;;;;;;;;;;24,0;;;;;;;;;;;;;;;;;;;;;;;;;;;1,0;;;;;;;;;;2,0;1,0;;5,0;;;;;;;;;;;;;;;;;;;;1,0;;1,0;;;;1,0;1,0;;2,0;3,0;;;;;1,0;;;3,0;;;;;;2,0;1,0;;;;3,0;;;;;;;1,0;2,0;;;;;1,0;;;;;;;;;;2,0;;;;;;4,0;;;;1,0;3,0;;1,0;;2,0;;;;;2,0;;;;;3,0;1,0;;1,0;;;5,0;1,0;;;;;;;;1,0;;;;;;;;1,0;;;;;;;;;;;;;5,0;;;;;;;;;;;;;;;;;;;;;;;;;;;;;;;;;;;;;2,0;2,0;23,0;;;;;4,0;;;;;;;;;7,0;;;;;9,0;;1,0;;;;;;;;;;;;;;;1,0;;;;;;;5,0;;;;;;;;;;;;;;4,0;;;;;;;;;1,0;;;;;;;;;;;;;;;;;;;;;;;;;;;;;;;;;;;;;;;;;;;;;;;;;;;2,0;;;;;;3,0;1,0;;;;;;;;;;;;;;;;;;1,0;;;;;;;;;;;;;;;;;;;;;;;;;;;;;;;;;;;;;;;;;;;;;;;;1,0;;;;;;;;;1,0;;;;;;4,0;2,0;;;;;;;;;;;;;;;;;;;;;;;;4,0;;;1,0;;;;;;;;;;;;;;2,0;;1,0;;;;;;;;;;;;;;;2,0;;;;;;;;;;;1,0;;;1,0;;;;;;;;;;;;;;;;;;;;;;;;;;;;;;;46,0;;;;;;;;;;;1,0;;;;;;;;;;;;;;;;;;;;;;;;;1,0;;;;;;;;;;;;;;;;;;;;;;;2,0;;;;;;;;;;;;;;;;;;;;;;;;;;;;;;;;;;1,0;;;;;;;;;;;;;;
sidewall;;;;;;6,0;21,0;8,0;7,0;15,0;;;;;2,0;30,0;;;;;;;;10,0;;;;;;;;;14,0;;;;;;;;1,0;;150,0;2,0;1,0;;;10,0;;6,0;9,0;4,0;;;6,0;56,0;8,0;;;;65,0;1,0;1,0;;;;3,0;38,0;34,0;19,0;;;;;;;;;2,0;7,0;;;;56,0;;;;;;;56,0;;;1,0;;;;;7,0;;;;33,0;;;;7,0;;;;;2,0;18,0;;;36,0;58,0;7,0;;;;;;;;;;;;;;;1,0;1,0;;;11,0;;;;;;;25,0;;;4,0;51,0;;5,0;2,0;6,0;;;;;2,0;;;;;;9,0;;;;;1,0;;;;;;18,0;;;9,0;47,0;;;8,0;5,0;2,0;15,0;;9,0;10,0;1,0;;;6,0;;;65,0;;13,0;;;;33,0;1,0;;2,0;19,0;;4,0;;;;34,0;8,0;;;;9,0;;11,0;;;51,0;31,0;;65,0;3,0;;18,0;38,0;;8,0;;462,0;8,0;1,0;50,0;30,0;3,0;;36,0;59,0;44,0;;;;;;;;;;10,0;85,0;;4,0;;;;63,0;;;;;;15,0;;7,0;;4,0;6,0;1,0;;5,0;1,0;17,0;11,0;;;;3,0;1,0;123,0;;;;;;;;4,0;;19,0;;16,0;;3,0;25,0;;;;;1,0;6,0;2,0;23,0;;;;;5,0;84,0;;;2,0;;;;;1,0;;4,0;9,0;;;10,0;5,0;4,0;;7,0;3,0;;;2,0;5,0;13,0;;;;;1,0;;5,0;1,0;9,0;1,0;;;;;2,0;40,0;;11,0;2,0;;;19,0;9,0;;;;;;;;10,0;8,0;;;2,0;33,0;;;;5,0;;;;20,0;3,0;;1,0;3,0;;4,0;10,0;;;;3,0;3,0;16,0;29,0;;;1,0;;;;4,0;16,0;;;;;;;;;;;1,0;;;;;;;3,0;;;;;1,0;;;;;1,0;3,0;;;;;2,0;;;;;;;;;;;;;;;;2,0;;;;;;;;;;;;1,0;;;;;;;;;;;;;;;;;;;;;5,0;;4,0;;;;;;;;;;;;;;;1,0;;;;;;;;1,0;;;;;;;;;;4,0;;2,0;;;;1,0;;;;;;;;;;;;;2,0;;;;;;17,0;;;;;;;1,0;;;2,0;;;;2,0;;;;1,0;;;;;2,0;;4,0;;;;;;;;3,0;5,0;;7,0;;;;;;;;;;;;;;;;3,0;1,0;;;;13,0;;2,0;;;;;;;5,0;;;;;3,0;;6,0;;;;;;;;;;;;1,0;;;;;;;;;;2,0;5,0;;;;;;;;1,0;;;;;;;;;;;;;;;4,0;;;;;1,0;;;;;;;;;;2,0;;;;;1,0;;;;;;;;4,0;;;;;;;;2,0;;6,0;;;;;;2,0;;;;;;;;;11,0;;;;;3,0;;;;14,0;2,0;;7,0;7,0;;1,0;1,0;;;;;1,0;;;2,0;;;;14,0;;1,0;1,0;;4,0;;4,0;;2,0;;;1,0;;;;;;;;;;;;;;1,0;;;;13,0;;;;;;1,0;;;;;;;;;;;;;;;;;;;;;3,0;;1,0;;;;;;;18,0;;;;;;;;;;;;;;;;;;;;;;;;;;;;;1,0;;;;;;;;;;;;;;;;;;;;;;;;;;46,0;;;;;;;2,0;;;;;;;;;;;14,0;2,0;;;1,0;;;;;;;;;;1,0;;;;;;;;;;;;;1,0;;1,0;1,0;;1,0;;;;;;;;;;22,0;;;;;;;;;;;;;;;;;;;;;;;;;;;2,0;;;;5,0;6,0;;;1,0;;;;;;;;;;;;;;;;;;;;;1,0;;;;;;3,0;;;;;;;;;;;;;3,0;;
site;;;;;;29,0;;2,0;3,0;;3,0;;2,0;;;3,0;;;;;;4,0;;;;;;;;;;;9,0;;2,0;4,0;;;;;38,0;;8,0;;2,0;;8,0;8,0;1,0;;3,0;;;;;;3,0;;4,0;;7,0;;;;;;1,0;1,0;;;;;;;;;1,0;6,0;3,0;60,0;6,0;5,0;;15,0;;19,0;;;;;1,0;;;2,0;;2,0;1,0;;12,0;;6,0;;2,0;15,0;;;;;9,0;;;;;;;2,0;4,0;62,0;;;;;;;6,0;;;;;;;1,0;9,0;;4,0;;;;;;6,0;;9,0;13,0;1,0;;;2,0;5,0;;;;;3,0;30,0;;11,0;;1,0;;2,0;;10,0;;;;52,0;;;;1,0;;;;;;1,0;;;;10,0;;;;;5,0;;;1,0;;;;;10,0;;2,0;1,0;;;2,0;;;;;;;;;;;;;;;;;;;;;;2,0;;;;;1,0;;14,0;;;;;;;;;;;;1,0;;;1,0;;;;;29,0;;;1,0;;;;;17,0;;;;;;;3,0;;;;;;;;4,0;;;;;;;;1,0;5,0;;;;;;;;;;1,0;;;;;;;;;;;1,0;;;;;;;;;;;;;;4,0;;;;1,0;;;;;1,0;;4,0;;;;;;;;;6,0;;11,0;;;;;;2,0;;2,0;;;;;;;;;;;;;;;;;;;;;;;;;;;;;;;;;;;;;;;;;;;;;;;;;;;;;;;;;;;;;;;;3,0;;;;;4,0;;;;;;;;3,0;;;;;;;;;2,0;;;14,0;;6,0;7,0;2,0;;;;;;4,0;2,0;;;;1,0;2,0;;;;;;11,0;;;2,0;;;;;;;;1,0;;6,0;;7,0;;;1,0;;;;;;;1,0;;;;;;5,0;;2,0;;21,0;23,0;;;;;;2,0;;;1,0;;4,0;;;;;;;;;;;1,0;;;;;;;;;;;;8,0;1,0;;2,0;;;;12,0;;;1,0;5,0;;;;;;;;;;;;;;;;6,0;;;;;;;;;;;;;;3,0;;;;;9,0;;;;;;;;;;;10,0;;;;;;;;;;;1,0;;1,0;;;;14,0;;;2,0;;2,0;;;;1,0;;2,0;;;;;;;;;;;;3,0;;;7,0;;;2,0;;;;;;;;;;;;;;;;;;;9,0;;;;;;;;;;;;;;;;;;;;;;3,0;;;;;;;;;;;;1,0;;;;;;;;;;;;;;;;;;;;;;;;;;;;;;;;;;;;;;;;;;;;;;;;;;;;;;;;;;;1,0;;;;;;;;49,0;;;;;;;8,0;1,0;;;;;;;;;;;;;;;;3,0;;;;;;;;;;;;;;;;;;;;;;;;;;;;;;;;;;;;;;;;;;;;;;;;;;;;;;;;;;;;;;;;;;;;;;;3,0;;;;;;;;;;;;;;;;;1,0;;;;6,0;;;;;;;;;;;;;;;;;;;;;;;;;;;;;;;;;;;2,0;;;;;;;;;;;;;;;;;;;;;;;;;;;;;;;;;;;;;;;1,0;;;;;;;;;;;;;;;;;;;;;;;;;;;;;;;;;;;;;;;;;;;;;;;;;;;;;;;;;;;;
sleeve;;;;;;11,0;18,0;14,0;;1,0;;;;;40,0;39,0;;;;;;2,0;;8,0;;;2,0;;;;;;6,0;;;;;;;;;;13,0;;;;;19,0;1,0;3,0;15,0;3,0;;;1,0;;1,0;;;;15,0;;;;2,0;;2,0;7,0;6,0;;;;;;;;;;;5,0;;;;28,0;;;;;;2,0;17,0;;;;;;;;5,0;;;;26,0;;1,0;;2,0;;;;5,0;;4,0;;;1,0;36,0;9,0;;1,0;1,0;;;;;;;;;;;;6,0;1,0;;;3,0;;;;;;;5,0;;;;2,0;;;;;;;;;4,0;;;;;;13,0;;;;;1,0;;;;;;1,0;;;10,0;3,0;;;1,0;3,0;;3,0;;;;;;;4,0;;;42,0;;2,0;;1,0;;2,0;27,0;;;;;;;;;2,0;;;1,0;;1,0;;5,0;;;11,0;23,0;;15,0;;1,0;1,0;2,0;1,0;5,0;;27,0;;;28,0;10,0;;;22,0;9,0;17,0;;;2,0;;;;;;;4,0;16,0;;2,0;2,0;;;43,0;;;;;;13,0;;;;2,0;;;;9,0;;1,0;;;4,0;;7,0;;25,0;;;;;;;;;;;;2,0;;;6,0;;;;;10,0;;4,0;15,0;1,0;4,0;8,0;2,0;3,0;7,0;;;6,0;;1,0;;;;27,0;4,0;;1,0;;6,0;;1,0;;8,0;;;;;6,0;8,0;;;;;16,0;;4,0;13,0;;9,0;;5,0;;11,0;;5,0;;;2,0;;;;11,0;10,0;;2,0;2,0;;1,0;2,0;;4,0;;;;;;;2,0;5,0;;;;10,0;11,0;9,0;19,0;9,0;2,0;;6,0;;;3,0;;1,0;4,0;12,0;;;2,0;32,0;4,0;;2,0;;;;;;;;;;;;;;;;;;;;;;;;;;;;;;1,0;;;;;;;2,0;;;;;;1,0;;3,0;;;;;;5,0;;;;;;;1,0;;;;;;;;;;2,0;;;;3,0;;1,0;;;;;;;;;5,0;3,0;;1,0;;;;;;;;;;;;;;;;;14,0;;;;;;;;;;;1,0;;;;;;;;;;;15,0;;;;;;;;;;;5,0;;;;;;;;;;;;;;;;;;;;;;;;;;;;;;;2,0;;;;;;;;1,0;;;2,0;3,0;;;;;;;;;;;;;;;;;;;;;2,0;;;1,0;;;;;;;;;;;;3,0;;;;6,0;;;;;;;;;;;;;;;;;;;;;1,0;;;;;;;;;;6,0;;;;;;3,0;2,0;1,0;;;;;3,0;;;1,0;;;;1,0;;;;;;;;;6,0;;;1,0;;;12,0;;;;;;2,0;;;;1,0;;;1,0;;;;;;;2,0;;10,0;1,0;;;;15,0;2,0;;;2,0;;;;;;;;2,0;;;;;;1,0;;;;;;;;;;4,0;;;;;;;;;;;;;;;;1,0;;;;;;;;;;;;;;;;;;;;;;;;1,0;;;;;;;;;;;;;;;;;;;;;1,0;;;;;;;;;;;;;;;;;;;;;;;;;;;;3,0;;;;;;;7,0;;;;;;;;;;;;;;;;;;;;;;;;;;;;;;;;;;;;;;;1,0;;;;;;;;;;;;;;;;;;;;;;;;;;;;;;;;;;;;;;;;;;;;;;;;;;;;;;;;;;;;;;;;;;;;;;;;;;;;;;;;;;;;1,0;;;;;;;;;;;;;;;;;;;;;5,0;;;;;;;;;;;;;;;;;;;;;;
splitter;;;;;;4,0;1,0;8,0;;11,0;;;1,0;;7,0;;307,0;;;;;8,0;;;;;3,0;;;;;;16,0;;;;;;;;;;4,0;;2,0;;;6,0;2,0;;6,0;;;;;;9,0;;;;;;;;8,0;;1,0;1,0;22,0;5,0;;14,0;;;;;;;6,0;33,0;;1,0;;21,0;;;;;;2,0;31,0;;;;1,0;;;;6,0;;;;;11,0;6,0;;27,0;;9,0;;13,0;;;;;;10,0;4,0;;2,0;;28,0;;;;;;;;4,0;;9,0;;;;;1,0;;;;6,0;;;19,0;;;;;;;;;;;;;26,0;;;;;6,0;4,0;;;;6,0;2,0;9,0;1,0;4,0;;;4,0;;;2,0;;;1,0;;;;;1,0;;;5,0;;;;;;3,0;;;;;;;;;1,0;2,0;;;;1,0;;29,0;;;;;1,0;4,0;;;;;8,0;10,0;;;;;;;114,0;;1,0;;18,0;14,0;;;;;;3,0;;;5,0;18,0;;;;;;;1,0;5,0;;;;;26,0;20,0;;;;;;;;;4,0;;;;;11,0;;;;;;;;35,0;;;;;;;1,0;;;3,0;;;;;8,0;2,0;;;;;;1,0;;1,0;;1,0;;;;;;;;;;;;;;2,0;;;;;;;;;;;;3,0;;;;;;;10,0;;;2,0;;9,0;;;;;4,0;1,0;;2,0;;;;;12,0;;;;;4,0;;;;2,0;;1,0;;14,0;;;;;;;1,0;;1,0;;;;;;;1,0;;;;32,0;;4,0;;1,0;;;;1,0;;;;;;;;;;;;;;;;;;;;;;;;;;;;;;;;;;10,0;;1,0;;;;1,0;;;;;;;;;;;;;;;;;;;;;;;;;;;;;;;;;;;;;;;;;;;;;;;;;;;1,0;;;;;;;;;;4,0;;;;;;;;;;;;;;;;;;;;;;3,0;;5,0;;;;;;;;;;1,0;2,0;;;;;;;;;;;;;;;;;;;;;;;;;;;;;;;;;;;;;;;16,0;;;;;;;;;;;2,0;;;;;;;;;;;;;;;;;6,0;;;;1,0;;;;;;;;;;;;;;;;;;;;;;1,0;;;;;;;5,0;;;;;;;;;;;;;;;;;;;;;;;;;;;;;;;;;1,0;14,0;;;;;;;;23,0;;;;;;;;;;3,0;;;;;;;;;;7,0;;;;;;;;;;;;;;;;;;;;3,0;;;;;;;;;;;;;2,0;;;;;;;;;;;;;;1,0;;;;;;;;;;;;;;;;2,0;;;;;;;;;;;;;;;;;;;;;;;;;;;;;;;;;;;;;;;;1,0;;;;;;;;;;;;;;;;;;;;;;;;2,0;;1,0;;;;;;;;;;;;8,0;;;;;;;;;;;;;;;;;;;;;;;;;;;;8,0;;;;;;;;;;;;;;;1,0;1,0;1,0;;;;;;;;;;;;;;;;;;;2,0;;;;;;;;;;;;;;;;;;;;;;;;;;;;;;;;;;;;;;;;;;;21,0;;;;;;;;;;;9,0;;;2,0;;;;;;2,0;;;;;;;;;;;;;;;;;;;;;;;;;;;;;;;;;;;;
square;;;;;;15,0;;2,0;7,0;6,0;2,0;;;;3,0;;;;;;;;;;;4,0;9,0;;;;2,0;15,0;5,0;;2,0;;;1,0;;;4,0;;;;;;2,0;1,0;;2,0;;23,0;;6,0;;;2,0;1,0;2,0;;3,0;;;;1,0;14,0;;12,0;5,0;1,0;;;1,0;;;2,0;2,0;;;9,0;;1,0;;4,0;;2,0;;;;10,0;6,0;;;;;;;;23,0;;;;5,0;1,0;;;7,0;;;1,0;1,0;;;;;6,0;19,0;11,0;2,0;6,0;;;;1,0;2,0;2,0;;;;;;1,0;3,0;;;;2,0;;12,0;17,0;;;;3,0;;;;4,0;;1,0;;2,0;;;;;17,0;3,0;1,0;;1,0;;1,0;;;;;1,0;;;3,0;;;;1,0;5,0;2,0;;;;;5,0;;;;;;1,0;;;;;2,0;2,0;;2,0;;;;2,0;2,0;;9,0;9,0;;;;;;2,0;;;;;;;2,0;;;;4,0;2,0;4,0;;;;;;6,0;;3,0;1,0;;2,0;;1,0;;8,0;;3,0;;;;;;;;;8,0;;;;;;;;10,0;;;;;;;6,0;;;29,0;;;;;2,0;4,0;;;;;;;11,0;1,0;;;1,0;;1,0;;4,0;;;;2,0;;;1,0;;;;;;;;;;;;;;1,0;;;7,0;;1,0;;;;;;;1,0;;8,0;;1,0;;1,0;;;;;;;;;;;;;1,0;;;;;;;;;;8,0;;;;;;;;13,0;;;;;;;;;;;;;;;;;;2,0;4,0;;;2,0;;1,0;;;;;;1,0;;;2,0;1,0;;;;;;2,0;;;;;;;;;;2,0;1,0;3,0;;;;1,0;3,0;1,0;;;;;;1,0;1,0;;;;;;;;;;;8,0;13,0;;3,0;1,0;;;;1,0;;;;;1,0;;2,0;;;;;;;;;;;2,0;1,0;;;;;;;3,0;;2,0;2,0;;;;;;;;3,0;;2,0;2,0;1,0;3,0;;1,0;;;;;;;;2,0;;;;;;;1,0;;;;;;;;;;;4,0;;;;;;;;;;;2,0;;;;;;;;;;;;;;;;;1,0;;;;;;;;;;;;;;;;2,0;;;3,0;;;;;;4,0;;;;;;1,0;;1,0;;;;1,0;;;;1,0;;;;;;;;3,0;;;;;;;;;;;;;;;;;;;1,0;;;;;;;;;;1,0;;;;;;;;;;;;;;;;;;;;;;;;;;;;1,0;;1,0;;;;;;;;;;;;2,0;;;;2,0;;5,0;;;;;;4,0;;;;;;6,0;;1,0;;;;;;2,0;;;;;;;;;;;6,0;;;;;;;;;;;;;;;;2,0;;;;;;;;;;;;;;;;3,0;2,0;;;;;;;;;;;;;;;;;;;;;;;;;;;;;;;;;;;;;;;;;;;;;;;;;7,0;;2,0;;;;;;;2,0;;;;2,0;;;;;;;;;3,0;;;;;;;;;;;;;;;;;;;2,0;;;;1,0;;;;;;;;;;;;;;;;;;1,0;;1,0;;;;;;;6,0;;;3,0;;;;1,0;;;;;;;;;;;;;;;;;;;;;;;;;;;3,0;;;;;;;;;;;;;;;2,0;;;;;;;;;;;5,0;;;;;;2,0;;;;;;;;1,0;;;;;;;;;;;;;;;;;;;;;;2,0;;;;;;;3,0;;;;;;;;;4,0;;;;;;;;;;;;5,0;;;;;;;2,0;;;;2,0;;;;;;;;;;;;;;
stabilize;;;;;;1,0;;18,0;;;;;2,0;;12,0;9,0;;;;;;22,0;;;;;;;;4,0;;;12,0;;6,0;3,0;2,0;;;;2,0;;;;6,0;2,0;;24,0;2,0;;1,0;;;;15,0;;1,0;;;;3,0;;;;;;;6,0;17,0;;1,0;;3,0;;;;;;2,0;141,0;;1,0;;20,0;;;;;;1,0;42,0;;;;;;;;13,0;;;;7,0;11,0;;;22,0;2,0;5,0;1,0;;4,0;;;;3,0;16,0;9,0;;;;;;;1,0;;;;;;;5,0;3,0;;1,0;;1,0;2,0;;;;;;9,0;;;1,0;1,0;18,0;1,0;;1,0;1,0;1,0;;;72,0;;;;;;14,0;;;;7,0;4,0;;;;;;;;;1,0;;;;;6,0;;1,0;;1,0;;;;;;;;10,0;;;;;1,0;;;;1,0;6,0;;1,0;;;;;;;2,0;;;;;;1,0;;3,0;;;;;;;;;;4,0;;;6,0;22,0;2,0;11,0;;;1,0;;;;;;;;;;4,0;5,0;;1,0;;;;5,0;1,0;;;;;;;;9,0;;;;;;;;;;;;1,0;;;;3,0;;;;;;;;;;4,0;1,0;;;;6,0;;;;9,0;3,0;18,0;;;;;1,0;;1,0;;;;2,0;;;;;;2,0;;;;;7,0;;1,0;;;;;;;1,0;;;2,0;;1,0;;;;;;;;;3,0;2,0;;;5,0;;;1,0;5,0;18,0;3,0;3,0;;;;;;;;;;;;;;;;;;;;;;;;3,0;;;;;;;18,0;;;;3,0;;;;;;;1,0;;;;;;;;;;1,0;;;;;;;;;;;1,0;1,0;;;;;;;1,0;;;3,0;;;;;;;;;3,0;11,0;;;;1,0;4,0;1,0;;;;;;;3,0;;;;;;;;;;7,0;;;;;;;;;6,0;;;1,0;;;2,0;;;;;;;;;;;;;1,0;;;3,0;;;;3,0;;;;1,0;1,0;;;1,0;;;;;;;;;;1,0;;;;;1,0;;;;1,0;;;;3,0;;;;;;;;;;1,0;;;;;;;;;;9,0;;;;;;;4,0;;;;;;;;;;;1,0;;;;;;;;;;;;;;;;;;;;;;;;;;;;;;;;;;;;;;;;;;;;;;;;;;;;;;;;;1,0;1,0;;;;1,0;;;;;;5,0;;;;;;;;;;;;;;;;;;7,0;;;;;;;;;;;;2,0;;;;;;;;;;;;3,0;1,0;;3,0;;;1,0;;;;;;;;;;;;;;;;;;;;;;;;1,0;;;;;;3,0;;;;;;;;;;6,0;;;;;;;;;;;;;;;;;;3,0;;;;;;;;;;;;;;2,0;;;;;;;;;;;;;;;;;;;;1,0;;;;;;;;;;;;1,0;;;;;;;;;2,0;1,0;;1,0;;;;;;;;;;;;;;;;;;;;;;;;;;;;;;;;;;;;;;;;;;;;;;;;;;;;;;;;;;;;;;;;;;;1,0;;;;;;;;;;;;;;;;;;;;;;9,0;;;;;;;;;;;;;;;;;;;;;;;;;;;1,0;;;;;;;;;;;;;;;;;;;;;;;;;;;;;;;;;;;;;;1,0;;;;;;;;;;;;;;;;;;;;;;;;;;;;;;;;;;;;;;;;;;;;
steer;;;;;;115,0;;2,0;;5,0;;;;;5,0;34,0;20,0;;;;;6,0;3,0;;;;;8,0;;;;;9,0;;20,0;13,0;2,0;1,0;;;2,0;;4,0;;6,0;1,0;3,0;6,0;;12,0;5,0;6,0;;5,0;6,0;;;;4,0;;1,0;;;;;;1,0;;;;4,0;;17,0;;;;;;;42,0;;;;12,0;;;;;2,0;;;;;;2,0;;4,0;;22,0;5,0;1,0;;4,0;4,0;;15,0;1,0;;;2,0;2,0;2,0;;;;13,0;3,0;11,0;;11,0;1,0;;1,0;;23,0;;;;;3,0;;1,0;6,0;2,0;;;;10,0;;1,0;1,0;;1,0;19,0;;;;1,0;27,0;;;;;5,0;;;66,0;;1,0;;;4,0;6,0;;;;5,0;10,0;;;15,0;;;;1,0;6,0;2,0;;;;;8,0;;;;;;;;;;;;11,0;;2,0;;;;;;;;16,0;;;;;;;;;2,0;;;;;;1,0;1,0;;;;;3,0;;;;7,0;;15,0;;2,0;5,0;4,0;2,0;11,0;;1,0;;1,0;;;10,0;;;;;;;;;;;;1,0;25,0;;6,0;;;;;8,0;;;;;;;;;1,0;;;;;2,0;;1,0;7,0;;;;;7,0;;;;;119,0;1,0;;;;3,0;;;;;13,0;9,0;7,0;;;;;;;;;;;;;;;;;6,0;;;;;;;10,0;1,0;;;8,0;;1,0;;;;1,0;18,0;1,0;;;;;3,0;;1,0;;4,0;1,0;4,0;;;;;;2,0;;9,0;;;;;;;;;;1,0;;;;;;;;;;1,0;3,0;2,0;;;;;;14,0;;;;7,0;;1,0;;;3,0;;67,0;1,0;;;2,0;;;3,0;;;2,0;7,0;;14,0;2,0;;;;;;;;1,0;;;4,0;3,0;1,0;;2,0;;;;7,0;;10,0;;;4,0;;5,0;;15,0;;;;;;;1,0;;5,0;1,0;1,0;;;;;2,0;;;;;;3,0;2,0;;5,0;;;2,0;;1,0;1,0;6,0;6,0;;2,0;3,0;;;;;;3,0;5,0;;2,0;5,0;;;;;;;;;;;;;2,0;;;1,0;;;;;3,0;;;2,0;;;2,0;;;;;;;;;;;23,0;3,0;;;;;;;;;;;;5,0;2,0;;;;;;;2,0;;;;;;2,0;;;;;;1,0;4,0;;;;;;;1,0;;14,0;;2,0;;;;;2,0;;;;;;;;;1,0;;;;;;;63,0;;;;;;;;;;7,0;;;9,0;2,0;;;1,0;;;;;;;;;;;;;;;;;;;1,0;;;;;;;;;4,0;;;;1,0;;;;;1,0;;;;;11,0;;;;;;;;;;;;8,0;;;;;;2,0;;1,0;;;13,0;;;;;;;21,0;;;2,0;;;;;5,0;;;;;;;;;;;;;;;5,0;7,0;2,0;;;;;;;;;;;1,0;;;1,0;;;;;;;4,0;;;;;;;;;;;1,0;;;;;;1,0;;;;;;;;;13,0;;;;;;;6,0;;;;;;;;;1,0;;1,0;;;;;;2,0;;;;;;6,0;;;;;;;5,0;;;;;;;1,0;;;;2,0;1,0;;;1,0;;;;;;;;;;;;2,0;;;;;;;;;;3,0;;1,0;;;1,0;;;;;;5,0;;;;;1,0;;;2,0;;3,0;;;;;;;;;;;;;;;;;;;;;;1,0;1,0;;;;;;2,0;;;;;;;;;;;;;;;;;;;;;;;;;;4,0;;;;;;2,0;;;1,0;;;;;;13,0;;;;4,0;;;;;;;1,0;;;;;;;;;;;;;;2,0;;;;;;;;;;1,0;;;;;;;3,0;;;;;;;;;;;;;;;;;;4,0;;;;;3,0;;;;;6,0;;4,0;;;;;;;;1,0;;;;;
straight;;;;;;25,0;;7,0;5,0;21,0;4,0;;;;18,0;6,0;;1,0;;;6,0;;;2,0;;;1,0;;;;;;4,0;;1,0;;;16,0;4,0;;;;4,0;;22,0;1,0;16,0;8,0;;1,0;3,0;6,0;10,0;3,0;16,0;36,0;2,0;1,0;;;11,0;;;;1,0;;2,0;20,0;;2,0;;;;;;1,0;;;;38,0;;4,0;;10,0;3,0;;;;;5,0;6,0;;;;;;;;15,0;;;;3,0;9,0;;;34,0;;;;21,0;;;;;27,0;13,0;51,0;;2,0;;;;;;;;;;;;14,0;2,0;;3,0;1,0;8,0;;;;;;;1,0;;;;5,0;;;;;;1,0;;;6,0;;8,0;2,0;;;18,0;;;;1,0;1,0;1,0;;;;;;;1,0;;2,0;;;;3,0;;2,0;;;;;;;;;;43,0;;5,0;;1,0;;;5,0;1,0;;30,0;2,0;;;;;5,0;;;;3,0;;;3,0;;;4,0;;;;;;;1,0;;5,0;;9,0;;;;5,0;16,0;1,0;;3,0;;;;;6,0;;;2,0;;21,0;16,0;2,0;;;;;;;;;;;;1,0;;;;5,0;;;;1,0;2,0;2,0;;1,0;1,0;;1,0;;2,0;;;;;;;;;;;6,0;8,0;;;;;;;1,0;;;1,0;;;;;;;3,0;8,0;;;;;5,0;;;2,0;;;2,0;;;;5,0;;;;;;;;;;3,0;;;2,0;5,0;3,0;;;3,0;;;;;9,0;10,0;8,0;;17,0;;;;;;29,0;;;;;2,0;;;;;;;;;;;;;1,0;;;;;;;2,0;;;;2,0;;;;;4,0;2,0;;;;;;;;;;;3,0;;;;;;1,0;8,0;;;;;;;1,0;;;;;2,0;;;;;2,0;;;;;;5,0;1,0;2,0;;;;;;4,0;9,0;;;;;;1,0;;;7,0;;6,0;;1,0;;;;;;;;;;2,0;;;;3,0;4,0;2,0;;;;;5,0;;;;;10,0;;22,0;11,0;;;;;1,0;;2,0;;;13,0;;;;;8,0;;;;;;;6,0;;;;;2,0;;;;;2,0;;;;;;;;;;;;;;;;;;;;;;;;;10,0;;3,0;;1,0;;;;;;;;;;1,0;;;2,0;;;;1,0;;;;;;;;;;;;;;;;;;;;;;;;;;;;;;;;;;;;;1,0;2,0;;;;;;3,0;;;;;;2,0;;;;;;;;;;;;;;5,0;;;;;;;1,0;;;;2,0;;;;;;;;;;;3,0;;;;;;1,0;;;;;;;;;;1,0;5,0;;6,0;;;;2,0;;;;;;8,0;;;1,0;;2,0;1,0;;4,0;;4,0;;;;2,0;;;;;;;;;1,0;;;;;;;;;;;;;2,0;;;;1,0;;;;;;;;10,0;;;;4,0;;;;2,0;;;;;;;;;;1,0;;;;11,0;;;;;;;;;;;2,0;;;;;;;;2,0;1,0;;;1,0;;;2,0;1,0;;;2,0;;;;;;;;;;;;;;1,0;2,0;;;;;;;;;;;;;;;;;;;;;;;;;;;;;;;;;;;;;;;;15,0;;;;;;;;;;;;1,0;;;;;;;;;;;;;1,0;;;;;;;;;;;;;;;;;;;;;;;;;;;;4,0;;;;;;;;;;;;;;;;;;;1,0;;;2,0;;;2,0;;1,0;;;;2,0;;;;;;;;;;;2,0;;;;;;;;;;;;;;;;;;;;;;2,0;;;;;;;;;;;;;;;1,0;;;;;;;;;;6,0;;;;;1,0;9,0;;;;;;;;;;;;;;;;;;;
substrate;;;;;;6,0;15,0;54,0;129,0;65,0;82,0;;11,0;;14,0;47,0;1,0;;;;;47,0;;14,0;;1,0;12,0;3,0;;;5,0;;58,0;;32,0;24,0;;6,0;;;11,0;1,0;70,0;13,0;4,0;9,0;12,0;281,0;5,0;23,0;192,0;13,0;;;4,0;27,0;119,0;;;;29,0;15,0;4,0;1,0;52,0;1,0;8,0;619,0;22,0;97,0;2,0;;12,0;;1,0;7,0;;23,0;3,0;403,0;10,0;158,0;;356,0;2,0;6,0;;;4,0;1,0;388,0;;1,0;55,0;;;9,0;;147,0;1,0;;;363,0;2,0;;;125,0;5,0;31,0;;17,0;9,0;5,0;14,0;3,0;205,0;310,0;128,0;12,0;10,0;2,0;2,0;5,0;31,0;25,0;;;;8,0;2,0;;3,0;9,0;17,0;;;18,0;;1,0;1,0;;;1,0;319,0;2,0;1,0;5,0;310,0;45,0;4,0;;50,0;;1,0;7,0;13,0;72,0;;4,0;32,0;1,0;8,0;126,0;;;2,0;;12,0;3,0;4,0;4,0;23,0;72,0;38,0;;21,0;44,0;25,0;8,0;;32,0;12,0;159,0;48,0;48,0;383,0;7,0;40,0;7,0;4,0;1,0;;10,0;174,0;2,0;82,0;;;1,0;57,0;5,0;;;56,0;;5,0;25,0;5,0;;148,0;92,0;8,0;2,0;29,0;257,0;;8,0;11,0;19,0;77,0;159,0;33,0;11,0;4,0;1,0;10,0;281,0;;235,0;38,0;41,0;26,0;;173,0;13,0;16,0;;100,0;85,0;38,0;6,0;4,0;6,0;9,0;;27,0;36,0;;80,0;43,0;45,0;;;9,0;;6,0;67,0;2,0;8,0;22,0;;33,0;24,0;4,0;501,0;4,0;12,0;18,0;16,0;56,0;;29,0;33,0;58,0;;7,0;;56,0;;1047,0;;;26,0;63,0;19,0;10,0;2,0;;7,0;222,0;;3,0;;52,0;11,0;;;;121,0;22,0;14,0;6,0;93,0;;6,0;2,0;14,0;30,0;56,0;9,0;2,0;23,0;81,0;20,0;23,0;1,0;;3,0;2,0;92,0;;;10,0;2,0;12,0;;;;;14,0;1,0;4,0;2,0;;;;9,0;16,0;19,0;81,0;25,0;10,0;14,0;72,0;;19,0;4,0;2,0;26,0;25,0;17,0;18,0;;64,0;;;;2,0;;1,0;3,0;7,0;28,0;37,0;20,0;;;46,0;41,0;;2,0;1,0;;;;39,0;2,0;10,0;2,0;13,0;9,0;;33,0;1,0;4,0;;1,0;;8,0;236,0;31,0;;;27,0;;2,0;;11,0;4,0;;;;;4,0;;;;1,0;8,0;2,0;2,0;16,0;1,0;;;2,0;;;;;;1,0;30,0;;;;1,0;4,0;;;;2,0;16,0;1,0;9,0;;;3,0;;;3,0;;1,0;;;2,0;3,0;;;;;4,0;;;;;;;;;19,0;6,0;;12,0;;;;;;3,0;;;;;;;;;21,0;;7,0;26,0;;3,0;;;;;7,0;1,0;1,0;;;;;;4,0;;1,0;2,0;1,0;;1,0;;1,0;;8,0;;30,0;;;;;;;;;;;3,0;;;;;;;;;;22,0;;;1,0;46,0;2,0;;;7,0;;5,0;;1,0;;;;8,0;;;;;;;5,0;;;11,0;;;4,0;;3,0;16,0;20,0;3,0;;;;1,0;;;3,0;;1,0;;6,0;;3,0;1,0;;;;;;;2,0;;;;1,0;2,0;;;;12,0;2,0;1,0;;;;;66,0;1,0;1,0;;;8,0;;6,0;;;;;41,0;7,0;6,0;;;;;1,0;19,0;;1,0;;;3,0;152,0;2,0;;;5,0;;;33,0;;;6,0;3,0;;;;;1,0;;;;;;;2,0;;;;21,0;;20,0;1,0;6,0;2,0;2,0;4,0;;;1,0;28,0;6,0;28,0;;;;2,0;;;;2,0;;;;179,0;;;;2,0;;;3,0;;11,0;;36,0;;;1,0;;;2,0;9,0;4,0;35,0;;;;3,0;;;;;;;1,0;;;;56,0;;;1,0;;1,0;;;15,0;7,0;;;8,0;175,0;13,0;;12,0;2,0;;2,0;;1,0;;;14,0;;9,0;;104,0;9,0;5,0;;63,0;;1,0;24,0;;;;;14,0;13,0;6,0;11,0;;46,0;2,0;14,0;4,0;5,0;4,0;;;;1,0;13,0;;12,0;194,0;;;11,0;;;4,0;4,0;;;;17,0;;1,0;1,0;;;1,0;2,0;;;33,0;;;4,0;14,0;;3,0;;;;;;1,0;;;;;10,0;;;;;;1,0;;;1,0;;;;3,0;1,0;;;12,0;;;;1,0;;4,0;;;;9,0;;;;;1,0;2,0;2,0;3,0;;;;;;;;;;2,0;;;;;1,0;;;9,0;;;;;;;;;;3,0;;;;;2,0;;4,0;4,0;11,0;;;2,0;;;;;;;;;5,0;2,0;2,0;;;12,0;;;;4,0;1,0;;;1,0;;;;;;;21,0;;;;11,0;;;;;1,0;;;1,0;;12,0;;;;1,0;;;;;;29,0;;;;;;;;;;;16,0;8,0;;;;1,0;3,0;;;;;7,0;;;11,0;;;;;;4,0;;;;;;;;;;;;;;;;;2,0;;;;;;;;2,0;;;;;;
subsystem;;;;;;1,0;;6,0;3,0;10,0;12,0;1,0;2,0;;13,0;13,0;;;;1,0;7,0;21,0;;;;;1,0;;2,0;;7,0;;57,0;;22,0;3,0;;;;;10,0;;3,0;6,0;1,0;1,0;24,0;39,0;35,0;54,0;4,0;22,0;1,0;;5,0;1,0;22,0;;;16,0;1,0;1,0;;1,0;2,0;;22,0;2,0;11,0;;4,0;;25,0;2,0;;;2,0;;32,0;91,0;;94,0;;66,0;;17,0;;;;9,0;20,0;;14,0;;1,0;;5,0;;14,0;;3,0;1,0;3,0;18,0;;3,0;86,0;;3,0;3,0;;4,0;;;2,0;6,0;2,0;11,0;4,0;2,0;;;1,0;22,0;12,0;2,0;;;;3,0;;;;;;;1,0;3,0;;;16,0;;;9,0;2,0;;;;1,0;;;;6,0;1,0;1,0;3,0;59,0;;;;;2,0;1,0;;;;13,0;4,0;1,0;;;;;;;5,0;3,0;;;;;1,0;;;;;;5,0;;;1,0;3,0;;9,0;;;;1,0;;3,0;;;;;6,0;;;;;1,0;;;;;;;;;;;2,0;;;11,0;;;;;17,0;;;;4,0;17,0;;;;;;;;8,0;;;;;;;1,0;3,0;;;;;;;10,0;3,0;2,0;;;;;2,0;;;3,0;;;;;8,0;;;;;;3,0;;;;;;;;;;;;;1,0;;;;;;;;11,0;;48,0;2,0;;;;;;;;4,0;;2,0;;;;;;;2,0;28,0;;;;;;;;;;;;;;;;;;;10,0;;;;4,0;;;4,0;;;1,0;9,0;;2,0;;;;8,0;;10,0;27,0;1,0;;;;;;;;;;1,0;2,0;;;;;;;;;1,0;;;1,0;;1,0;;;;;7,0;;21,0;4,0;;;;;;;;;;3,0;;;;;;;2,0;;2,0;1,0;;8,0;2,0;;;;;;1,0;12,0;1,0;;;;2,0;;;;;1,0;;1,0;;;1,0;8,0;1,0;2,0;;;;;5,0;;;1,0;;;;;;;1,0;7,0;;;2,0;;;;;;;;;;12,0;;;;;9,0;1,0;;;;;;14,0;1,0;;;;;;;2,0;;;2,0;;;;4,0;;3,0;;1,0;;;2,0;3,0;;;;;;;;;;2,0;;;;1,0;;;;;;;;;;;;;;;;;;;;1,0;;;;;;;;;;;;;;;73,0;;2,0;2,0;;;;;;;4,0;;2,0;;1,0;;;;;1,0;;1,0;1,0;1,0;;;;;;;;;;;;;;3,0;;;;;;;;;;2,0;;2,0;7,0;;;;;;;1,0;;;;;;;;;;;1,0;;1,0;1,0;;1,0;1,0;9,0;;;;;;5,0;;;;;;;;;;3,0;4,0;;;4,0;1,0;;;;;;;;;;;;;;;;;1,0;2,0;;;;;;4,0;;;;;;;;;;;;;2,0;;;1,0;;;;;;;;;;;;;;;;;;;;;;;;;;;;;;;;;;;;;1,0;;;;;1,0;12,0;;19,0;;;;;2,0;;;;;;;1,0;;;;;;;;;;;;;;;;;;;4,0;;;;2,0;;2,0;;;;;1,0;;;;;;;;1,0;2,0;1,0;;4,0;3,0;;;;;;;;;;2,0;;;;;;;;;;;;;;;;;1,0;;;;;;;;;4,0;;;;;3,0;;;;;;;;;;;;2,0;1,0;;;;;;;;;;;9,0;;;1,0;;;;;;;;;;;;;;;;;;;;;;;;;;;;;;10,0;;;;;1,0;;;4,0;;;;;;;;;2,0;;;;;;;3,0;;;12,0;2,0;;;3,0;;;;;;;;;;;;;;;;;;;;;;;;;;;;;;;;;;;;;;;;;;;;;;;6,0;;;;;;;;;;;;1,0;;;;;;;;;;;;;;;;;;;;;;
superimpose;;;;;;1,0;;5,0;16,0;;;;;;3,0;2,0;;;;;52,0;2,0;;;;1,0;11,0;;;;;4,0;31,0;;15,0;2,0;2,0;4,0;4,0;;42,0;2,0;;;8,0;8,0;2,0;19,0;2,0;55,0;3,0;7,0;3,0;2,0;;;;;;;;;2,0;1,0;;;;7,0;5,0;;;;55,0;;;;;;2,0;244,0;1,0;;;16,0;;3,0;;;;;10,0;;;;10,0;;;2,0;13,0;;6,0;;1,0;75,0;;;2,0;1,0;2,0;;;1,0;;9,0;4,0;6,0;36,0;25,0;2,0;8,0;;;3,0;10,0;8,0;;;;;7,0;;3,0;1,0;;4,0;;;;;4,0;12,0;;;5,0;;;;;8,0;4,0;1,0;;;;11,0;7,0;3,0;;;;;;49,0;;;;28,0;1,0;3,0;;3,0;;;;2,0;1,0;;;;;;9,0;;;;;;12,0;;3,0;;;;;;;;;;4,0;;;;8,0;;;;;;;;;;1,0;;;;;;;;;1,0;;;;;;;;11,0;;;;12,0;1,0;1,0;;;10,0;;;1,0;;;;;;7,0;3,0;;;;;;;1,0;;;;;;;2,0;;;1,0;;;;;;1,0;;;;;6,0;;;8,0;;14,0;;;2,0;2,0;;;;10,0;1,0;;;;;;;;;;;;;;;;;;;;;;;;;;;;;;;;;2,0;;;;1,0;;;;;;;;2,0;4,0;;;;;4,0;;;;;;;10,0;;;;;;;;8,0;;4,0;;2,0;;3,0;;;;;;;1,0;;;;;;6,0;;;1,0;;;;;1,0;10,0;;;;;1,0;2,0;;;;1,0;;;;;;;;;;;;;;2,0;4,0;;;3,0;;;;;;;;;1,0;;;;;6,0;;;;3,0;;;;;;;2,0;;3,0;1,0;7,0;;;;2,0;;2,0;;3,0;;;;;1,0;;4,0;;;;;;;;;3,0;;;5,0;;;;;4,0;;1,0;;4,0;;4,0;;;8,0;1,0;;;;;;;7,0;;;;;;;;6,0;;;;;10,0;2,0;;;;1,0;3,0;2,0;;;;;;;;;;;;6,0;;1,0;;;;;;;;;;;5,0;;;;;;;;6,0;;;;;;3,0;;2,0;;;1,0;;;;;;;;;;;;;;;1,0;;;;;;;;;;;;;;;;;;;;;1,0;;;;;;2,0;;;;;;;;;;;;;;;;;;;;;;;;;;;;;10,0;3,0;;;2,0;;;;;;;;;;;;;;;;;;20,0;;;;;;;;;1,0;;;;;;;;;;;;;;;;;;;;;;;;;;;;2,0;;;;;;3,0;1,0;;;;;;5,0;;;;;;;;;;;;;;5,0;1,0;;;;;;;;;;;;;;;;;;;;;;;;;;;1,0;;;2,0;;;;;;1,0;;;;;;;;;;;;;;;;3,0;;;;;;;4,0;3,0;;;;;;;;;;;;;;;;;;;;;4,0;;;7,0;;1,0;;;1,0;2,0;;;;;2,0;;;2,0;;;;;2,0;;;;;;;;;;;;;;;;;;20,0;;;;;1,0;;;;1,0;;;;;;;;;2,0;;;;;;;;;;;;;6,0;;;;;1,0;;;;;;1,0;;;;;;;;2,0;;;7,0;;;;;;;;;;;;2,0;;;;;;;;;;;;;;;;;;;;;;;;;;1,0;;;;;;;;;;;1,0;;;;;;;;;;;;;;;;;;;;;;;;;;1,0;;;;;;;1,0;;;;;;7,0;;;;;;;;;;;2,0;3,0;;1,0;;;;;;;;;;
table;;;;;;3,0;2,0;27,0;48,0;10,0;;;7,0;;3,0;57,0;;;12,0;2,0;35,0;22,0;2,0;1,0;;7,0;27,0;3,0;;;;9,0;21,0;1,0;20,0;;3,0;67,0;;;99,0;;9,0;;1,0;;26,0;33,0;23,0;10,0;3,0;16,0;2,0;;6,0;19,0;2,0;2,0;1,0;;7,0;1,0;;;;8,0;14,0;3,0;3,0;;1,0;;28,0;1,0;;9,0;22,0;;;104,0;;3,0;1,0;45,0;;2,0;1,0;;;4,0;32,0;;4,0;;1,0;6,0;35,0;;51,0;;3,0;;18,0;14,0;;;2,0;3,0;18,0;7,0;;27,0;;;;52,0;36,0;16,0;1,0;13,0;;;;2,0;9,0;;1,0;;;15,0;;8,0;8,0;;;;2,0;;1,0;;2,0;;;10,0;9,0;;;19,0;24,0;;;;8,0;80,0;;4,0;14,0;;17,0;;1,0;;49,0;1,0;;;6,0;4,0;;;19,0;;;;3,0;1,0;;;;;;12,0;;;;;;5,0;;;11,0;;;10,0;;;;;;20,0;5,0;;2,0;67,0;;6,0;;14,0;16,0;;2,0;;2,0;;;;;;;;1,0;;4,0;;;;;;2,0;1,0;2,0;2,0;;30,0;22,0;20,0;3,0;;6,0;;;;;;;;;;9,0;1,0;;;;;;;6,0;;;;;;;8,0;;8,0;;;;;;;11,0;;;;2,0;1,0;;20,0;5,0;;1,0;4,0;;13,0;;;3,0;;1,0;1,0;1,0;;;;1,0;;;;21,0;;;;;;8,0;7,0;5,0;;;1,0;;;;14,0;;;;;;;;;8,0;;;;;;;;;;;;;24,0;3,0;;;;;;;3,0;;1,0;2,0;;;5,0;;1,0;;;3,0;19,0;;;;;;;;;;;;;16,0;;;;;;;8,0;;7,0;;;2,0;;;;;;6,0;30,0;2,0;4,0;;1,0;;;;;3,0;;;;;3,0;;;;;1,0;15,0;6,0;14,0;21,0;3,0;;4,0;8,0;;;9,0;;1,0;;1,0;;2,0;1,0;2,0;;;;32,0;2,0;16,0;5,0;;5,0;;;;1,0;3,0;4,0;;;;4,0;;1,0;6,0;;;;2,0;3,0;15,0;2,0;;;6,0;;;;1,0;;;;;3,0;21,0;;;;3,0;2,0;;;;3,0;2,0;7,0;1,0;;1,0;21,0;;4,0;;;;;2,0;;10,0;;;;;4,0;;2,0;2,0;;1,0;7,0;;;;9,0;;1,0;2,0;;1,0;1,0;;;;;;;;;5,0;;;1,0;1,0;;;;2,0;1,0;;;;7,0;2,0;;;;;;;;2,0;1,0;4,0;;;;;;;44,0;1,0;;;;;;1,0;;5,0;;43,0;;;;1,0;2,0;;;;;4,0;;;;10,0;;;;;3,0;5,0;2,0;;;;8,0;;;;;;;;1,0;;13,0;1,0;;;;2,0;1,0;;;;;;;;5,0;;;;;;;1,0;;;;;1,0;1,0;;2,0;;;;;1,0;;;;2,0;;;;2,0;;;;6,0;;1,0;;;;;;;;4,0;;;;;;4,0;1,0;;2,0;;;;;2,0;;;;;;;;;;;;4,0;;;4,0;;21,0;;;;2,0;;;;1,0;;;;;;;;;;1,0;;13,0;;;;;;6,0;;;;;;;;;;;;;;;;2,0;;;4,0;;;;;;;3,0;;;4,0;3,0;;;;3,0;;;;;;;;1,0;;;;;;;;;11,0;;1,0;;;;;;;9,0;;;;;2,0;2,0;1,0;;;;2,0;;;;1,0;;;;;;3,0;;;;;;2,0;;;3,0;;8,0;;;1,0;2,0;1,0;1,0;;;5,0;;;;;2,0;;;;1,0;;;;;;7,0;;17,0;;;2,0;;;;;;;;;;;;;;;2,0;;;;;;83,0;;;;;;;;7,0;;;;;2,0;;;;;;;;;;;;;;;;;1,0;;;;;;1,0;;;;;;;;;;;5,0;;1,0;1,0;;;;;;;;;;1,0;5,0;;;1,0;;;;;;;;2,0;;;;;;2,0;;;;;13,0;;;;;;;;;;;;;4,0;;;;;;;1,0;;;10,0;;;1,0;4,0;;;;;;;;2,0;3,0;2,0;2,0;3,0;;7,0;;;;;;;;;;;;;;;;;;;;
test;;;;;;1,0;1,0;20,0;;5,0;;;1,0;;2,0;33,0;4,0;;;2,0;21,0;51,0;;;2,0;1,0;135,0;2,0;2,0;1,0;4,0;9,0;37,0;1,0;14,0;18,0;4,0;1,0;1,0;;17,0;;;;8,0;3,0;56,0;112,0;37,0;167,0;7,0;12,0;;1,0;;1,0;5,0;4,0;1,0;;;1,0;8,0;;6,0;;19,0;7,0;1,0;;17,0;;40,0;2,0;;3,0;8,0;14,0;10,0;425,0;;28,0;;77,0;;2,0;;4,0;;1,0;27,0;;;;10,0;;;;100,0;;3,0;;119,0;17,0;;2,0;32,0;1,0;38,0;23,0;6,0;16,0;;5,0;;23,0;30,0;95,0;2,0;11,0;;;1,0;;3,0;1,0;6,0;;;7,0;;33,0;3,0;;5,0;6,0;19,0;54,0;;;26,0;;3,0;20,0;2,0;;;7,0;19,0;1,0;5,0;;3,0;13,0;20,0;;44,0;;5,0;7,0;1,0;15,0;28,0;;1,0;;34,0;7,0;;;;;;;1,0;4,0;9,0;;;;;7,0;;;;6,0;;6,0;;;;;;5,0;;4,0;4,0;;;2,0;;;10,0;16,0;1,0;;;1,0;1,0;51,0;;;;;;;;;;;1,0;;;;1,0;;2,0;;35,0;4,0;8,0;;1,0;11,0;;2,0;;3,0;2,0;;;1,0;;;;;;1,0;6,0;;;;;;;;7,0;;5,0;;;;2,0;7,0;;;5,0;;;;;25,0;;;;;;6,0;;7,0;;;;;;19,0;2,0;;12,0;2,0;32,0;;;3,0;;;;;1,0;1,0;;2,0;2,0;;;;;;;;1,0;;;;1,0;5,0;;7,0;;4,0;;;;;1,0;;;;;12,0;;;1,0;2,0;;;;4,0;;4,0;;;;6,0;;;;2,0;;206,0;;2,0;;8,0;;1,0;1,0;74,0;;1,0;;10,0;;;;;1,0;4,0;;1,0;;;;;;;;;1,0;;;1,0;;;;7,0;;;;4,0;;60,0;;1,0;;2,0;;1,0;;;;;;4,0;;;;;1,0;17,0;5,0;6,0;21,0;;2,0;;1,0;;;;;;4,0;2,0;;;;9,0;;20,0;;12,0;5,0;;14,0;;8,0;19,0;12,0;;24,0;8,0;8,0;1,0;;4,0;4,0;1,0;;3,0;;;;3,0;3,0;12,0;5,0;;;;3,0;;;2,0;;;;;3,0;1,0;;2,0;;;9,0;1,0;30,0;;1,0;;11,0;4,0;1,0;5,0;12,0;;;;6,0;;;3,0;;1,0;2,0;;;2,0;;8,0;;;;33,0;12,0;;1,0;;;;6,0;12,0;;;;;;;;;;2,0;;5,0;;;;1,0;;;;3,0;;1,0;;;4,0;;;;;;;1,0;;8,0;;;;;;;;3,0;;;;;;;;;;4,0;;;3,0;;;;;;;;13,0;;;3,0;;;5,0;;;2,0;;;;;4,0;;2,0;;;;4,0;;;;3,0;1,0;9,0;;;;;;;;;;;;;;;;;;;;;;;;;;11,0;;;;4,0;;;8,0;;;;;;13,0;6,0;4,0;;;3,0;;2,0;;;;;;;4,0;1,0;;;;;;;;;;;4,0;;2,0;;;;;;;;1,0;;;;;;;7,0;3,0;;1,0;;;;;;;;;;;2,0;;12,0;;;;;;;;1,0;16,0;;;;;;;;;;;;;;1,0;;;;;;;2,0;;;;1,0;;17,0;;;;;;;;;;;;;;;;;;;;;;;1,0;;;;;;;12,0;;5,0;;;;;;;2,0;;;;;1,0;;;;;1,0;;10,0;10,0;;;59,0;;;;1,0;;;;;5,0;1,0;3,0;2,0;;;;;8,0;;;;;;;;;;;;;1,0;;;2,0;;6,0;;;;;;;;;;;6,0;;;;;;2,0;;;;;;;;;1,0;;;;;;;;3,0;;2,0;;;;;;;;;2,0;8,0;;1,0;;;;;;;;;;;;1,0;;;1,0;;;;3,0;;;;;;;2,0;6,0;5,0;;;;1,0;;;;;;;;9,0;;;;9,0;;;;3,0;;;;;;;;;;2,0;;;;8,0;;;;;;;;;;1,0;;;;;;;;;2,0;;;;8,0;;;;;1,0;;;;;;;;;;1,0;;;;;;;;;;;;;;3,0;1,0;1,0;1,0;2,0;;;;;14,0;;;;
thickness;;;;;;5,0;4,0;5,0;32,0;14,0;1,0;;2,0;;22,0;15,0;2,0;;;1,0;16,0;6,0;;;;;;;4,0;;1,0;26,0;9,0;;7,0;;;;;;1,0;6,0;2,0;15,0;12,0;2,0;7,0;27,0;4,0;;13,0;14,0;;;;20,0;44,0;;;;22,0;4,0;;;2,0;8,0;2,0;28,0;2,0;2,0;1,0;1,0;;;;9,0;;2,0;1,0;52,0;;13,0;;13,0;2,0;;;;1,0;4,0;170,0;;;30,0;8,0;13,0;;;19,0;;;;37,0;17,0;;;104,0;;;;;;11,0;;;11,0;182,0;2,0;3,0;4,0;;;3,0;2,0;2,0;2,0;;;3,0;14,0;;;4,0;;6,0;;3,0;;;38,0;;;;40,0;1,0;;;25,0;1,0;10,0;;2,0;1,0;;;;11,0;5,0;1,0;2,0;;;101,0;7,0;3,0;;;1,0;;2,0;8,0;3,0;6,0;1,0;2,0;1,0;4,0;6,0;5,0;;1,0;17,0;5,0;3,0;2,0;4,0;;;;;;;1,0;15,0;1,0;6,0;;;;12,0;;1,0;15,0;49,0;1,0;4,0;;6,0;;10,0;30,0;3,0;;2,0;6,0;;1,0;;21,0;6,0;3,0;2,0;1,0;;;4,0;83,0;;18,0;;83,0;4,0;6,0;3,0;;6,0;;2,0;;6,0;;;;;;2,0;4,0;15,0;22,0;1,0;22,0;;;3,0;;;;5,0;1,0;12,0;;;;2,0;15,0;;10,0;4,0;;17,0;;12,0;9,0;31,0;;6,0;;4,0;63,0;47,0;;;;;48,0;1,0;20,0;;1,0;7,0;;;9,0;11,0;34,0;;;;1,0;;9,0;3,0;3,0;60,0;1,0;;;;2,0;2,0;;32,0;7,0;;12,0;2,0;;;1,0;1,0;2,0;;5,0;;5,0;;;;;;;;7,0;;;;;7,0;;;1,0;1,0;;;6,0;2,0;2,0;7,0;5,0;;3,0;;;2,0;8,0;;2,0;;;;;;4,0;;3,0;;;1,0;10,0;;2,0;;;;;5,0;16,0;;7,0;;3,0;;;;10,0;;;;;6,0;1,0;2,0;;;3,0;;;4,0;2,0;;;;;;;;;;;7,0;3,0;1,0;1,0;;;3,0;;;;;;1,0;4,0;;;;3,0;2,0;;;;;1,0;;3,0;;1,0;4,0;1,0;;;2,0;;;;1,0;;;;;;;;;;1,0;;;;;;;;;;;;;;;;;;;;;;;4,0;;2,0;;;35,0;;;;;;;;;;;;;1,0;;;;2,0;;;;;;2,0;;1,0;;;;;;;;;;;;;;;;;;;;;;;;;2,0;;;;1,0;;;;;;;;1,0;11,0;;3,0;;;1,0;;;;;;;;;;;;;1,0;;;;;;;;2,0;;;;;2,0;;;;4,0;;1,0;2,0;;;;;;;;;1,0;;;;;;;11,0;;;;;2,0;;1,0;;;;;;;;;;;;;;6,0;;;;;6,0;;;;;;;1,0;;;;;;;2,0;;;;;;;1,0;;;1,0;;;1,0;1,0;;;2,0;;;;;;2,0;7,0;;;3,0;;1,0;;3,0;;;;;;;3,0;1,0;;;1,0;;;;;1,0;;;;;;;;;1,0;;3,0;;;;5,0;;;;;;;;1,0;;;5,0;;;;;2,0;1,0;;2,0;;;;16,0;10,0;;1,0;;;;2,0;3,0;1,0;;;;4,0;;;13,0;;;;;;3,0;1,0;;;;;1,0;1,0;;;;5,0;;;;;;;;;;;;;11,0;;;;;;;;6,0;;;;;1,0;;1,0;2,0;;;;;3,0;;;;;;3,0;;2,0;;;;1,0;;;6,0;;1,0;5,0;;4,0;;5,0;1,0;;;;;;;59,0;;;3,0;;;;;;;;;;;;;;;;2,0;;;;;;;;;;;;;;;;;;;;;;;;;;;;;;;;1,0;;;;;;;;;;;;;;;;;;;;;;;;;;;;;;;;;;;;1,0;;;4,0;3,0;;;;;;;;;;4,0;;;;;;5,0;;1,0;;;;;;1,0;;;;;;;;;;;16,0;;;;;;;;1,0;;1,0;;;;;;;;;;;;;;;8,0;;;;;1,0;;;;;;;;;;;;;;;11,0;;;;;;
tool;;;;;;26,0;;;;3,0;;;10,0;;22,0;5,0;;;;;5,0;5,0;;8,0;1,0;4,0;;;;;3,0;;29,0;;6,0;6,0;;1,0;;;2,0;;12,0;;;;5,0;22,0;;15,0;1,0;4,0;;;2,0;8,0;;;;;5,0;;2,0;;;4,0;;1,0;;15,0;6,0;;3,0;;;;3,0;;;22,0;;5,0;1,0;16,0;;2,0;;;;3,0;33,0;;;8,0;;;2,0;;47,0;7,0;4,0;1,0;;9,0;;1,0;5,0;;;;;1,0;;;;6,0;17,0;14,0;;2,0;1,0;;1,0;;10,0;;;;;;;;1,0;10,0;4,0;1,0;;2,0;;;3,0;;2,0;3,0;4,0;;;2,0;1,0;1,0;;;;9,0;;;21,0;;;;;;11,0;;;;1,0;9,0;;;2,0;;4,0;5,0;;;16,0;5,0;;;2,0;21,0;;8,0;2,0;2,0;;3,0;;;;;2,0;4,0;;2,0;;;;1,0;9,0;;2,0;3,0;;;;;;3,0;;;;;1,0;;;;;4,0;1,0;;2,0;22,0;1,0;;;;1,0;;6,0;;;6,0;1,0;1,0;;1,0;;7,0;;;;;;;;;;1,0;;;;14,0;;;4,0;;;;;;;3,0;;;3,0;;;;;;;;;;;4,0;;17,0;;;;;;1,0;;;;;5,0;1,0;;;;;;;;;;3,0;12,0;;;;;2,0;;;;;;1,0;2,0;;;2,0;1,0;10,0;4,0;;2,0;1,0;4,0;;19,0;2,0;;;;2,0;2,0;6,0;;;;;1,0;12,0;;;10,0;2,0;1,0;2,0;;;4,0;2,0;;1,0;;;;;;11,0;;;;;;;;;;;2,0;;2,0;;;;;;;;4,0;;;;1,0;1,0;;;4,0;;;;2,0;;;1,0;4,0;;;;1,0;;;1,0;1,0;4,0;;;;;;6,0;;2,0;;;6,0;;6,0;;;;;;;2,0;2,0;;;4,0;;;;1,0;;;13,0;;;;;;;2,0;6,0;18,0;;3,0;2,0;1,0;1,0;;;;;;;;;;;5,0;;;;;;;;;10,0;;;;;;3,0;;1,0;;;3,0;2,0;7,0;1,0;2,0;11,0;;;;1,0;;;1,0;;;;;;;2,0;;1,0;;;2,0;;;;;1,0;;2,0;1,0;;3,0;;;;;;;;;;;;;;;;;;;;6,0;;41,0;;;;;;;;;;;;;;;;;6,0;;;;;;;;;;;;;;5,0;4,0;;;;7,0;;;;;;;;;;;;;;;;;1,0;;;;;2,0;6,0;80,0;;;;;6,0;;;;;;;;;;;;;;2,0;;;;;;;;;4,0;;;2,0;;;;;;;3,0;;1,0;;;8,0;;;;;;;;;;9,0;;;2,0;;;;7,0;;;;;;;;;;;;;;;;6,0;;;;;;;;;14,0;3,0;2,0;;;2,0;;;;;;;;;;;;;;;;;;;;2,0;;;;14,0;;;;;;;;;;;;;;21,0;;;;;;;;;;;;;4,0;2,0;;;;;;;;;;;;;;;;;;;;;;;;;;;;;;;;;;;1,0;;;;;;1,0;;;;;;;;;;;;;1,0;;4,0;;;;;;;;;;;;;;;;32,0;1,0;;;;;;;;;;;;;;;;;;;;;;;;1,0;;;;;;;1,0;;;;;;;;;;;;;;;;;2,0;;4,0;;;;;2,0;;;;2,0;;;;;;;;;;;;1,0;;;;;;;;;;;;;;;;;;;;;1,0;;4,0;;;;;;;;2,0;;1,0;;2,0;;;;22,0;;;;;;;;;;;;;;;;;4,0;;;;;;;;;;;;;;;;;;;;;;;;;3,0;;;;;;;;;;;;;;;;;;;;;;;;;;;;;;;;;;;;;
tooth;;;;;;1,0;;1,0;4,0;5,0;;;;;;2,0;;;;1,0;;6,0;;1,0;;;3,0;;;;6,0;;3,0;;;;2,0;;;;1,0;;;;1,0;;;7,0;11,0;6,0;;;;;3,0;2,0;1,0;;;;5,0;2,0;;;4,0;;;17,0;;14,0;;;6,0;;;;;1,0;2,0;56,0;;4,0;;12,0;;;;;;;;;;;1,0;;;;6,0;;;;3,0;1,0;;;;;;;;;1,0;;;16,0;10,0;13,0;;2,0;2,0;;;;4,0;2,0;;;;2,0;;;;;;;1,0;;;;;;1,0;1,0;;9,0;;2,0;;;;;;;;;4,0;;;1,0;;;;;;;1,0;;4,0;;;;;4,0;;;3,0;;;1,0;;6,0;;1,0;;;;;;;;;;3,0;;;;;;;1,0;;;;;;;;1,0;;;;;;;;;;;1,0;;;2,0;;;3,0;;;5,0;;4,0;;;13,0;1,0;1,0;;;1,0;3,0;;;;;;;;;;;2,0;;;;;;;;;;;;4,0;1,0;;;2,0;;1,0;;5,0;2,0;1,0;;;2,0;;;;18,0;2,0;;;1,0;;2,0;;;;;;;;;3,0;;;;;;;2,0;3,0;8,0;1,0;1,0;;7,0;2,0;;;;;;;14,0;;2,0;;;;;1,0;;;;26,0;4,0;;;;;2,0;;;;1,0;8,0;;;1,0;3,0;;;1,0;;5,0;3,0;1,0;;2,0;;;;;;;;;;;9,0;;2,0;;;;;;;;1,0;;;;;;;;;;;;1,0;;3,0;1,0;;;;;;;;4,0;3,0;2,0;;;;;;;;;;;1,0;;7,0;;;;;;;1,0;1,0;3,0;;;;;;;;2,0;;;;;;;;;;;;1,0;;3,0;;1,0;;;;;;;;;;;;;;;;;;;;;;;;;;;;;;;;;;;;;;1,0;1,0;;12,0;;;;;;;;;;;;;;;;1,0;1,0;;;;;;;;;;;;;;;;;;;;;;;2,0;;;;;;;;;1,0;;;;1,0;;;;;2,0;;;;;;;;;;;;;;2,0;;;4,0;;;;;;;;;;;;;;;;2,0;;;;;;;2,0;;;;;;;3,0;;;;;1,0;;;;;16,0;;;;;;;;;;;;;;;;;;;1,0;;;;;;;;;;;;;;;;;;;2,0;2,0;;;;;;;;;1,0;;2,0;;;;;;1,0;;;;;;1,0;;;;;;;;;;;;;;;;;;;;4,0;;3,0;;;;;;;;;;2,0;;;;;;;;;1,0;;;3,0;1,0;9,0;;;;;;;15,0;;;;;;;;;;2,0;;2,0;;;;2,0;;;;;;;;;;;;;;;;;;;;;;;;;;;;1,0;;;;;;;;;;;;;;;;;;;;;;;;;;;;;;;;;;;;;;;;;;;;;;;;;;;;;;;;;;;;;;;;;;;;;;;;;;;;;;;;;;;;1,0;;;;;;;;;;;;;;;;;;1,0;;;;;1,0;;;;;;;;;;;12,0;;;;;;;;;;;;;;;;;;;;;;;;;;;;;;;;;;2,0;;;;;;;;;;;;;;;6,0;;;;;;;;;;;;;;;;;;;;;;;;;;;;;;;;;;;;;;;;;;;;;;;;;;;;;36,0;;;;;;;;;;;;;;;;;;;1,0;;;
total;;;;;;8,0;;5,0;62,0;18,0;1,0;;4,0;;5,0;26,0;3,0;;;;;10,0;1,0;8,0;;;3,0;5,0;;;;7,0;4,0;16,0;5,0;;;;1,0;;9,0;4,0;5,0;1,0;1,0;4,0;17,0;12,0;7,0;10,0;3,0;3,0;;9,0;;;12,0;;1,0;;;;;;12,0;23,0;3,0;9,0;14,0;2,0;;;9,0;;;7,0;;3,0;8,0;135,0;;9,0;;17,0;3,0;;;;;45,0;50,0;;;1,0;1,0;1,0;1,0;;15,0;;;;21,0;11,0;;3,0;47,0;1,0;35,0;5,0;;;;;;33,0;;13,0;21,0;3,0;;16,0;;6,0;5,0;;;3,0;;4,0;;4,0;;;4,0;4,0;1,0;;5,0;4,0;7,0;;;39,0;;;;7,0;11,0;6,0;4,0;;2,0;3,0;;;2,0;;;1,0;;3,0;26,0;;;;;;1,0;3,0;2,0;2,0;1,0;4,0;7,0;2,0;4,0;;;3,0;;;1,0;;1,0;;;3,0;;;;;;2,0;;15,0;1,0;;;8,0;;;8,0;20,0;;;;46,0;10,0;3,0;2,0;;;;;6,0;;;5,0;;6,0;1,0;;;;;;;26,0;;;;1,0;2,0;;;2,0;;;;;;;1,0;;;2,0;3,0;98,0;2,0;2,0;;;;;;1,0;4,0;2,0;5,0;;;;16,0;;;;1,0;;;;;4,0;;2,0;;;;2,0;29,0;;;;20,0;;28,0;;;;4,0;8,0;21,0;;1,0;;;3,0;;;;;;;16,0;;;;1,0;;;;;;;;6,0;;;;;;;;;;;;;;7,0;;;;;;;;;;1,0;;;;;1,0;;;;;6,0;;;;;;1,0;;;;;1,0;;;;;;;;;26,0;;;;1,0;;;;;;;;;3,0;;;;;;;;;12,0;2,0;;;;;;10,0;3,0;3,0;;;;;;;;1,0;11,0;2,0;;2,0;;;;;;;2,0;;;4,0;1,0;;;;1,0;9,0;;;2,0;1,0;;7,0;;1,0;10,0;1,0;;6,0;9,0;;;;;;;;11,0;;;;;1,0;;;;;;;;;;;;1,0;;1,0;14,0;;;;;2,0;5,0;6,0;3,0;5,0;;;;;3,0;4,0;1,0;;;;;;;;;7,0;;;;;;;;;;3,0;;3,0;;;;;;1,0;;3,0;;;;;;;;;;;;3,0;;;;;1,0;;;;;;;;2,0;;;;3,0;;;6,0;;;;;;10,0;;;;;;;;;1,0;;;2,0;;1,0;3,0;1,0;;;;;;;;;;;6,0;;;;;;;;;;;;;;;;;;3,0;;;3,0;;;;;;;;;;;;;;;;;;;;;;;;;;4,0;10,0;;;;;;;;;;;;10,0;1,0;;2,0;;;;;;;1,0;;12,0;;;;;;;;;;;;;2,0;;;1,0;;;;1,0;;;;11,0;;;;;;;;;;19,0;;;;;;;2,0;;;;;;;;;;;;;;;3,0;;;;;3,0;;;3,0;2,0;;;;;;;;;1,0;4,0;;;;;;;1,0;;;;;;;;;;1,0;;;;;;6,0;;;;;;;;;;;1,0;;;;;;;;;;;;1,0;;;;;;;2,0;;;;;;;1,0;;;5,0;;;;;1,0;;;;;;2,0;;;1,0;;;;;;;;5,0;;;1,0;;2,0;;;;;;;;;;;;;;;3,0;;;;;;;;;1,0;;;;;;;;4,0;;;;;7,0;1,0;;;;;;;3,0;;;;;;;1,0;;;;;;;;;;;;;;;;;;;;;3,0;;;;;;;;;5,0;;;;3,0;1,0;1,0;;;;;;;;;;;;;;;4,0;;;;;;;;;2,0;;;7,0;;;;;;2,0;;;;;;;;;;;;;1,0;;;;;;;;;;;;;15,0;;;;;;;;;;;;;;7,0;;;;;;2,0;;2,0;;;;;4,0;;;2,0;;;;;;
trace;;;;;;6,0;;;14,0;1,0;2,0;;2,0;;;1,0;;2,0;;;;3,0;;;;;3,0;;1,0;;;;1,0;;10,0;4,0;2,0;1,0;3,0;;2,0;2,0;2,0;;6,0;;2,0;5,0;2,0;6,0;1,0;;;2,0;1,0;;1,0;;36,0;;2,0;;;;2,0;;;6,0;3,0;;2,0;;10,0;;;;;;;35,0;;;;7,0;1,0;;;;;;2,0;;;1,0;;2,0;1,0;;12,0;;;3,0;17,0;10,0;;;8,0;2,0;3,0;;7,0;4,0;;;;20,0;18,0;13,0;;3,0;1,0;;1,0;;;;;;;;;;;;2,0;1,0;2,0;2,0;;;;2,0;;10,0;;;;5,0;;13,0;4,0;1,0;;;;;17,0;;;;1,0;;7,0;;2,0;;1,0;;;;5,0;;;;;;;;;;;1,0;;2,0;;2,0;;2,0;2,0;;;;;6,0;;13,0;;1,0;;2,0;;;;;;;2,0;;1,0;;;4,0;;;4,0;;;;;;12,0;;7,0;;;2,0;;;4,0;;3,0;4,0;;2,0;;2,0;;;;2,0;;;1,0;1,0;;;;;1,0;5,0;;;1,0;;;;4,0;;;;;;;;;;;;;;;;;;;;;;11,0;10,0;;;;;;3,0;;8,0;;1,0;12,0;2,0;;;;;;;;;;2,0;;;1,0;;;;;;;;3,0;;;;;;;4,0;;;;;;;1,0;;3,0;;;;1,0;1,0;;;;6,0;;;;;;;;;;;;2,0;;3,0;;;;;;;;;;;;;;;;;;;;;;;;;;;;3,0;;;;;1,0;;;;;;;11,0;;;;;;;;;;;;1,0;;;;;1,0;;3,0;;4,0;;;;;;;;;;3,0;;;;1,0;;;;;4,0;;;3,0;;6,0;;;;2,0;2,0;2,0;;;;7,0;;;;4,0;;;;;;;;;;;2,0;;;;;;6,0;4,0;4,0;;38,0;;;1,0;;2,0;;;;6,0;;;;6,0;;;;;;;1,0;;;;;;;;;;;;;;;;;;;;;;;;;;;;;2,0;;;;;;;6,0;;;;;;1,0;;;;;;;;;;;;;;;;;;;3,0;;;;;;1,0;;;;;;;;;;;2,0;;;;;8,0;;;;;;;;;;;;;;;;3,0;;;4,0;2,0;;;;;;;;;;;1,0;;;;;;1,0;2,0;;;;;;;;;;;;;;;;;;;;;2,0;;;;;;;;;33,0;;;;;;;;;;;1,0;;;;1,0;;;;;;;;;;;;;;;;;;;;;3,0;;;4,0;;;;;;;;;;;;;;;1,0;;2,0;;;;;;;;;;;;;;;;;;;;;;;;;;;;44,0;;;;;;;;;;;2,0;;;;2,0;;;;;;;;15,0;;;;1,0;1,0;;;;;;;;;;;;;;;;;;;;;;;;;4,0;;;;;;;;;;;;;;;;;;1,0;;;;;;;3,0;;;;;;2,0;;;;;;;;;;;;2,0;;;;;;;;;;;;;;;;;;;1,0;;;;;;;;;;;;;;;;;;;;;;;;;;8,0;;;;;;;;;;;;;;;;;;;;;;;;;;;;;;;;;;;;;;;;;;;;;;2,0;;;1,0;;;;;;;;;;;;;;1,0;;;;;;;;;;;;;;;;;;;;;;;;;;;;;;;;;;;;;;;;;;;;6,0;;;;;;;;;;;;;;;;;;;;;;;;;
trailer;;;;;;5,0;;4,0;;;;;4,0;;1,0;5,0;;;;;;2,0;;1,0;;;;;;;;;2,0;;33,0;1,0;4,0;;;;33,0;;;;;;20,0;;;25,0;1,0;4,0;;;;;9,0;;;;;;1,0;;;;;1,0;;2,0;;;;;;;2,0;;;29,0;;;;9,0;;;;;;4,0;;;;;;;;;36,0;;;;5,0;;;4,0;;;;;;;;;;4,0;13,0;36,0;3,0;;;;;;;;;;;;;;;;;;;;;;;;;1,0;;;;;12,0;;;;;12,0;;;47,0;;;;;;19,0;;;3,0;10,0;2,0;1,0;;;;;;;3,0;76,0;;;;;;;;;1,0;;;;;;;;3,0;;;;;;;;;;;;;;;;;;;;;;;;;;;;;;;;3,0;;;2,0;;;;;7,0;;;4,0;;;;;;;48,0;;;;;;;;;;;;;1,0;;;;;;;1,0;;;;;;;;;3,0;;;;;;;1,0;;;;;;;;;;;119,0;;;;;;;;1,0;;;;;;;;;;;;;;;;;;8,0;;;;;;;;1,0;;;;;;;;;;;;;;;;;;;4,0;;;;;;;;;;;;;;15,0;;;;;;;;;;3,0;4,0;;;;;1,0;;;;;;;;;;;;;3,0;;;;;;;;;;2,0;4,0;;;;;;;;;;;;4,0;;;;;;;2,0;;;;;3,0;;;;;;1,0;;2,0;;34,0;;;6,0;;4,0;;4,0;;2,0;;;;;;;;;;;;;;;;;;;;2,0;;;;;;;6,0;;2,0;;2,0;;3,0;;;;;;;2,0;1,0;1,0;;;;;;;;;;;;;;3,0;;;;2,0;;;;;26,0;;;;;;6,0;;;;;;;;;;;;;;;;;;;;;12,0;;;;2,0;;5,0;;;;;;;1,0;;;;;;;;;;;1,0;;;;;;;;;;;;;;;;5,0;;;1,0;;;;;;;;;;;;;;;;;;;;2,0;;;;;;;;;;;;;;;;;1,0;19,0;;;;;;;;;;;;;;;;;;;;1,0;;;;;;;2,0;;1,0;;;;;;;;;;;;;;;;;;;;;;;;;;;;2,0;;;;;;;;;;;;;;;;2,0;;;;;;;;;;;;;;;;;;;;;;;;;;;;;;;;;;;;;;;;;;;;;;;;;;;;;;;;;;;;;;;;;;;;;;;;;;;;;;;;;;;;;;;;;;;;;;;;;;;;;;;;;;;1,0;;;;;;;;;;;;;;;;;;;;;;;;1,0;;;;;;;;;;;;;;;;;;;4,0;;;;;;;;;;;;;;;;;;;;;;;;;;;;;;;;;;;;;;;;;;;;;;;;4,0;;;;;;;;;2,0;;;;;;;;;;1,0;;;;;;;;;;;;;;;;;;;;;;;;;;;;;;;;;;;;3,0;;;;;;;;;;;;;;;;;;;;;;;;;;;;;;;;;;;;;;;;;;;;;;;;;;;;;;;;;;;;
travel;;;;;;3,0;1,0;1,0;9,0;1,0;;;3,0;;12,0;8,0;5,0;;;1,0;5,0;8,0;;1,0;;;7,0;;;;;;1,0;;6,0;3,0;;;1,0;;;;2,0;;;1,0;22,0;15,0;1,0;10,0;1,0;32,0;;2,0;;;;;56,0;;7,0;4,0;2,0;;8,0;;;5,0;2,0;4,0;1,0;;25,0;;;2,0;;2,0;3,0;22,0;;6,0;;;;4,0;;;;;22,0;;;1,0;;6,0;;;11,0;4,0;;;5,0;26,0;;2,0;17,0;;3,0;;1,0;2,0;1,0;;;2,0;5,0;29,0;;5,0;2,0;3,0;;;2,0;;;;;1,0;;10,0;1,0;;;;;;;;8,0;;;15,0;;;;;1,0;;;;;;;;22,0;;;;2,0;3,0;4,0;;;;4,0;4,0;;1,0;;;;3,0;3,0;2,0;2,0;;;;;3,0;;;;;;7,0;2,0;;;;;1,0;;2,0;;;;4,0;;;1,0;44,0;5,0;;1,0;;;2,0;1,0;;;;;;;;1,0;;4,0;;;;;;;;41,0;;2,0;;1,0;8,0;1,0;2,0;;;;;;;;35,0;;;;;1,0;6,0;1,0;4,0;;;;1,0;7,0;7,0;3,0;;;;;1,0;;;;;;;;10,0;2,0;;;;;;;7,0;;;1,0;;;15,0;;;;;65,0;;;;;3,0;;;;;7,0;5,0;1,0;;;;;3,0;;2,0;;;;;;1,0;;;;;;;;;;;;;;;;;;;;;;11,0;;;1,0;;;;3,0;;;2,0;4,0;;;4,0;;;2,0;;;3,0;;1,0;2,0;;1,0;;;;;;;;;;;;2,0;;2,0;;2,0;;;;1,0;1,0;;2,0;;1,0;;2,0;;6,0;2,0;;;;3,0;3,0;1,0;;1,0;;;;;4,0;;2,0;;4,0;2,0;;1,0;;1,0;;;;;;;;;;;;;3,0;;;;4,0;;;21,0;;8,0;8,0;2,0;;;;2,0;4,0;;;3,0;;;;5,0;;;;;2,0;;;;;2,0;;;4,0;;;;6,0;2,0;15,0;23,0;;;;;;;;;;2,0;;;;12,0;;;;;;2,0;1,0;2,0;;;4,0;;2,0;;;1,0;;;8,0;;2,0;;;;;;;;;;;;;;;;;;;;;;;;;;;;;;;;;;;;;;;;;;;3,0;;;;;;;;;;;;;;3,0;;;;;;;;;1,0;2,0;;;;;;;;;;;;2,0;;;;;;;;;;;;;;;;;;;;;;;;;;;;;1,0;;;;;;;;;;;;;;;;;;;;;;;;;;;;;;;;;;;3,0;;2,0;;;;2,0;1,0;;;;;;;;;;;;;;;;;;;;1,0;;;;1,0;;;;;;;;;;;;;;;;;;;;;;;;;;1,0;;;;;;;;;;;;;;;;;;3,0;;;;;2,0;;;;;;;;1,0;1,0;;;;;;;;;;;;26,0;1,0;;;;;1,0;38,0;;;1,0;;;;;;;;;;4,0;;;;;;;;2,0;;3,0;;;;;4,0;1,0;2,0;;;;;;;1,0;;;;9,0;;;;;4,0;;3,0;;1,0;;;;;;;;;;;1,0;;;;;;;;;;;;;;;;;;;;;;;;;;;;;6,0;;;;1,0;;;;;;;2,0;;;;;;;;3,0;;7,0;;2,0;;;1,0;2,0;;;;;;;1,0;1,0;;;1,0;;;;;;;;;;;;;;;;;;;2,0;;;;;;;2,0;;;;;;;;;;;;;;;;2,0;;;;;;;;;;;;;4,0;;5,0;1,0;4,0;;;;;;;;1,0;;;;;;;;;;;;;;;;;;;;;;;5,0;;;;;;;;;;2,0;;2,0;;;;;;;;;;;;;
tripod;;;;;;1,0;1,0;3,0;4,0;;;;;;2,0;10,0;;;;;;;;;;;;;;;;;7,0;;5,0;;;;3,0;;1,0;;;;;1,0;;20,0;4,0;;2,0;;;;2,0;;2,0;;;;3,0;;;;;1,0;;2,0;;;;;;;;;;;;;;;;12,0;;;1,0;;;2,0;2,0;;;;;;;;;;;;;;;1,0;;1,0;;;;;;;;3,0;2,0;3,0;;;7,0;;;;;;;;;;;;1,0;;;;;;;;;;;3,0;;;;5,0;;1,0;;;;;;;4,0;;;;;;2,0;;;;8,0;;;;6,0;;;;;;13,0;;;;;6,0;;;;;;;;;;;;10,0;;;;;;;;1,0;;5,0;;2,0;;;;;;1,0;;;;;;;;2,0;3,0;;;;;;;;;;10,0;1,0;;30,0;;2,0;3,0;;1,0;;;1,0;;;;;;;;;15,0;;;;;;1,0;;;;;;3,0;;;;;;;;6,0;;;;;;;2,0;;4,0;2,0;;2,0;;1,0;1,0;;2,0;;;1,0;1,0;2,0;;2,0;;;;;;;1,0;7,0;;;;;;1,0;;;;;4,0;;;;3,0;;12,0;;1,0;3,0;;;;11,0;1,0;;;2,0;4,0;;;1,0;1,0;;;1,0;;;1,0;2,0;;4,0;1,0;6,0;;;;;;;1,0;;;;;3,0;;;;;;;;;;;;;;;;;;2,0;4,0;1,0;4,0;37,0;;;3,0;;;;;;22,0;4,0;2,0;1,0;;21,0;1,0;;;;;;;;;;1,0;;;;;;;1,0;;1,0;;;;;;;1,0;;;;;;;;;;;;;;;;;1,0;;;;;;;1,0;;;;;1,0;;;;;;;;;;2,0;;;;2,0;;;;;;;;;;1,0;;;1,0;;;;;;;;;;;2,0;;;1,0;;;2,0;;3,0;;3,0;;1,0;;;1,0;;;;;;;;;;;;;;1,0;;;;2,0;;;;;;;;;;;;2,0;;;1,0;;;;;;;;;;;;;;;11,0;;;;;;;;;;4,0;;;1,0;;;;1,0;;;;;;;1,0;;;;;;;;;;;;;;;;;;;2,0;;;;;;;;;;;;;;;;;4,0;;;;;;;1,0;;;;1,0;;;;;;;2,0;;;;;;;;1,0;;;;;;;;1,0;;3,0;1,0;;;;;2,0;1,0;3,0;;;;;2,0;;;;;;;1,0;;;;;;;;;;;;4,0;;;24,0;;;;;;;;;;;;;;;;;;;;17,0;;3,0;;;;;5,0;2,0;2,0;;;;1,0;;;;;;;;;;;;;;;;;;;;;;;;;;;;4,0;;;;;;;;;;;;;;;;;;;;;;;;;;;;;;;;;;;;;;;;;;;;;;;;;;2,0;;;;;;;;1,0;1,0;;;;;1,0;;;;;;;;2,0;;;;;;;;;;;;;;;;;;;;;;;;;;;;;;;;;;1,0;;;;;;;;;;;;;;;;;;1,0;;;;;;;;;;;;;;;;;;;;;;;2,0;;;;;;;;;;;;;;;;;;;;;;;;;;;;;;;;;;;;;;;;;;;;;;;;;;;;;;;;;;;;;;;;;;;2,0;;;;;;;;;;;;;;;;;;;;;1,0;;;;;;;;;;;;;;;;;;;;;
turn;;;;;;18,0;;23,0;;3,0;;;;;13,0;14,0;20,0;;3,0;1,0;11,0;13,0;;3,0;;;;;;;2,0;3,0;36,0;;80,0;3,0;3,0;4,0;4,0;;12,0;;2,0;;27,0;10,0;8,0;39,0;18,0;37,0;4,0;19,0;;;66,0;;80,0;;;;5,0;3,0;4,0;;;;7,0;4,0;2,0;1,0;19,0;3,0;7,0;;;;;3,0;6,0;72,0;;9,0;1,0;22,0;;7,0;;1,0;;1,0;23,0;;1,0;3,0;;;;;27,0;3,0;1,0;;19,0;26,0;;3,0;4,0;1,0;37,0;;16,0;8,0;;;;15,0;14,0;32,0;45,0;4,0;;;2,0;15,0;6,0;;;3,0;;;1,0;10,0;2,0;;;;1,0;3,0;8,0;;2,0;1,0;7,0;13,0;4,0;;;;105,0;2,0;;;1,0;1,0;8,0;12,0;13,0;;7,0;108,0;3,0;2,0;29,0;;;;1,0;19,0;10,0;;1,0;;;2,0;8,0;7,0;3,0;6,0;;;1,0;20,0;;;42,0;39,0;;2,0;1,0;;;;;7,0;;1,0;;;;3,0;;;1,0;14,0;;;6,0;;6,0;;;;1,0;39,0;1,0;;;;;;5,0;5,0;1,0;;;;;2,0;64,0;;67,0;;5,0;9,0;;8,0;3,0;7,0;1,0;4,0;;6,0;1,0;3,0;;;7,0;;12,0;;23,0;;1,0;;4,0;10,0;5,0;;;;;;1,0;6,0;;1,0;;;17,0;;2,0;38,0;;1,0;;;3,0;;;11,0;97,0;;4,0;;4,0;14,0;;;;;1,0;2,0;;1,0;;;;;;;1,0;3,0;2,0;;;1,0;1,0;;;;;2,0;;2,0;1,0;;;;;1,0;;;1,0;;9,0;;2,0;5,0;;;;1,0;3,0;;;2,0;;6,0;1,0;1,0;;;;1,0;2,0;;4,0;4,0;;2,0;;;2,0;1,0;1,0;2,0;;2,0;2,0;1,0;3,0;;;1,0;1,0;;;5,0;1,0;;;1,0;;;;;;;4,0;;6,0;;2,0;5,0;;;;;6,0;10,0;;19,0;1,0;;;;4,0;;;;;;;14,0;;;;;;1,0;2,0;2,0;5,0;;3,0;;;;;;;;2,0;4,0;4,0;;;1,0;;;;9,0;18,0;;3,0;;1,0;1,0;5,0;;11,0;;12,0;6,0;;7,0;25,0;1,0;1,0;10,0;3,0;;;;3,0;8,0;3,0;;;;5,0;;;;;;;1,0;19,0;1,0;;1,0;;;5,0;;;;33,0;;5,0;;;1,0;1,0;;;;;3,0;1,0;;1,0;;;1,0;;9,0;;;2,0;;2,0;2,0;;;3,0;;16,0;;;7,0;;;;2,0;4,0;;;;4,0;1,0;5,0;6,0;;;;;;;;5,0;;4,0;2,0;4,0;12,0;;;3,0;4,0;;1,0;;;;;;;;;;;2,0;;9,0;4,0;;;2,0;;;2,0;1,0;;;;;;;;;;;;4,0;;;;;;;1,0;;1,0;;;;;;;;5,0;;1,0;;;;2,0;;;;1,0;;;;;;;;;;1,0;;;;;;;;4,0;;;;;;11,0;2,0;;;72,0;;;;;;;2,0;;;2,0;;;;;4,0;;;2,0;;;;;;3,0;;2,0;12,0;;;3,0;;;;2,0;;;;;;5,0;;3,0;;1,0;;;;;;;;10,0;;;;1,0;5,0;;;;;;;;1,0;;7,0;;;;;1,0;;;6,0;;1,0;;;;;;4,0;;;;1,0;;;11,0;;;2,0;;;;2,0;10,0;1,0;1,0;;;2,0;4,0;;;4,0;;;;;1,0;;;;;;;;1,0;;1,0;;;3,0;;2,0;;3,0;2,0;10,0;;8,0;;1,0;;;;;;3,0;;;;;;;;;23,0;1,0;;4,0;10,0;;;;;;;;80,0;;;;;;;;;;;;;;5,0;;2,0;2,0;;;;;;;;1,0;;;;;;;;;;;;;;2,0;;;;;;5,0;;6,0;;;;;;;1,0;;;1,0;;;;;;;;;;;5,0;;;1,0;;6,0;;;;;;3,0;;1,0;;1,0;;;;;1,0;;;;;;;;;;5,0;;;1,0;;;1,0;;;;;;;;;;;;;;;;;;3,0;3,0;;;;1,0;;;;;;4,0;2,0;5,0;;;;;;;;;;4,0;;;;;;;;;;;2,0;;;;;;;;;;;;;;;;;;;;;;;;;;;;;;;;;;;;1,0;;;;;;;;;;;;;;;
type;;;;;;5,0;4,0;29,0;9,0;37,0;8,0;5,0;37,0;;7,0;49,0;3,0;;;1,0;4,0;18,0;2,0;9,0;;1,0;70,0;1,0;;;5,0;1,0;11,0;3,0;18,0;3,0;;;6,0;;105,0;;1,0;14,0;51,0;33,0;49,0;114,0;14,0;26,0;13,0;3,0;;;26,0;1,0;76,0;5,0;;;;3,0;12,0;36,0;29,0;;17,0;93,0;36,0;3,0;5,0;2,0;8,0;;;31,0;17,0;2,0;23,0;196,0;14,0;33,0;3,0;148,0;2,0;5,0;28,0;2,0;1,0;;58,0;1,0;;9,0;;5,0;2,0;2,0;45,0;1,0;3,0;;24,0;77,0;;4,0;30,0;12,0;21,0;;;10,0;1,0;;;112,0;11,0;36,0;1,0;15,0;;;5,0;15,0;6,0;3,0;1,0;2,0;2,0;5,0;5,0;1,0;1,0;1,0;6,0;;10,0;6,0;;;12,0;15,0;;81,0;7,0;;;12,0;106,0;6,0;42,0;2,0;45,0;18,0;13,0;3,0;50,0;;;16,0;8,0;17,0;65,0;;;;20,0;5,0;;3,0;1,0;;;;;3,0;1,0;;19,0;;2,0;17,0;;;32,0;20,0;;1,0;4,0;;1,0;5,0;;19,0;;16,0;35,0;;4,0;3,0;;;4,0;6,0;;;;;;15,0;12,0;2,0;;47,0;;;2,0;;2,0;5,0;2,0;;1,0;;;;168,0;;14,0;;21,0;;6,0;17,0;;1,0;2,0;6,0;29,0;1,0;1,0;1,0;5,0;14,0;11,0;9,0;47,0;2,0;224,0;;3,0;;;;;;31,0;;;4,0;;;;22,0;178,0;;3,0;;7,0;1,0;;13,0;;7,0;;4,0;;22,0;46,0;41,0;9,0;;15,0;5,0;;7,0;;4,0;;;13,0;;;1,0;;4,0;;;4,0;;2,0;8,0;2,0;;1,0;;;;;14,0;;;9,0;;2,0;;;4,0;;9,0;;3,0;1,0;;4,0;;1,0;;;;;;;2,0;;;1,0;2,0;;2,0;;1,0;;1,0;;;1,0;2,0;2,0;7,0;;;1,0;11,0;;;;7,0;2,0;;;;;;3,0;;;;;4,0;8,0;;1,0;;;;1,0;;3,0;2,0;1,0;1,0;5,0;;;1,0;;;;11,0;4,0;26,0;;;1,0;28,0;;2,0;;;;;;;;;;;7,0;3,0;2,0;1,0;2,0;;13,0;5,0;;;;;;;5,0;1,0;;;;2,0;;2,0;;42,0;8,0;;20,0;;;;13,0;;3,0;51,0;5,0;;2,0;1,0;4,0;;;4,0;1,0;;;;;1,0;5,0;2,0;;;3,0;;;3,0;;;;;;3,0;;;;;19,0;2,0;1,0;;14,0;;4,0;;;;1,0;;2,0;;4,0;1,0;;8,0;109,0;5,0;;;1,0;1,0;40,0;;6,0;;2,0;2,0;3,0;1,0;;;12,0;6,0;3,0;6,0;1,0;;41,0;;;;;;;;;;1,0;6,0;4,0;;;9,0;3,0;;24,0;6,0;3,0;1,0;17,0;;1,0;1,0;;4,0;;1,0;1,0;1,0;3,0;5,0;;2,0;;1,0;;3,0;4,0;;;7,0;1,0;1,0;;;;7,0;;2,0;2,0;3,0;;;26,0;;5,0;;;1,0;;;;;;1,0;;1,0;;;;2,0;2,0;;;;3,0;2,0;1,0;;;16,0;;1,0;10,0;;4,0;;;38,0;5,0;;10,0;2,0;;;;;;;;;3,0;6,0;2,0;;;;3,0;3,0;413,0;;;2,0;;;3,0;6,0;1,0;;4,0;;3,0;;;;;;47,0;;1,0;;;;;;;3,0;;;1,0;1,0;;;1,0;7,0;2,0;2,0;29,0;;;1,0;;;;;;;;;;;;;;;13,0;;1,0;10,0;;;36,0;1,0;1,0;;2,0;;1,0;;;9,0;;;;;1,0;;;;9,0;11,0;1,0;;;8,0;;1,0;;;;;;;;3,0;;;7,0;;88,0;23,0;;1,0;;1,0;4,0;;;;;;;;1,0;2,0;;;;;;;3,0;;;;;1,0;;;;;;10,0;44,0;28,0;;8,0;;;;2,0;267,0;;13,0;6,0;;3,0;12,0;;;;2,0;10,0;;;3,0;5,0;;;;;;7,0;1,0;;98,0;;;4,0;73,0;;;1,0;;;4,0;;;;4,0;;;3,0;;;;1,0;;2,0;5,0;3,0;;;;;;1,0;;2,0;1,0;;1,0;;2,0;;;3,0;;1,0;;1,0;;;2,0;1,0;2,0;;;;;;;2,0;10,0;;1,0;;6,0;;1,0;;1,0;;;7,0;;;;;3,0;;;2,0;4,0;3,0;;;;;;;1,0;3,0;;;;;5,0;;;;;;;4,0;1,0;;3,0;;;;;;;;;12,0;;;;;;;;;;;;;;;7,0;;;;4,0;;;3,0;;1,0;2,0;;;;2,0;;;;;;;11,0;;;;;;;;;1,0;4,0;;;;;;;;3,0;;3,0;;;;1,0;1,0;;;;;;;;;17,0;;;;1,0;;;;4,0;;;;2,0;1,0;;2,0;3,0;1,0;;;;;;;;;
update;;;;;;3,0;;10,0;104,0;;;;33,0;;1,0;70,0;;3,0;;;29,0;10,0;;2,0;;9,0;7,0;;;;9,0;40,0;61,0;;22,0;2,0;3,0;4,0;8,0;;66,0;1,0;8,0;49,0;15,0;37,0;135,0;46,0;9,0;52,0;;5,0;;;34,0;2,0;5,0;9,0;44,0;3,0;;;1,0;6,0;6,0;;10,0;7,0;36,0;;17,0;;31,0;3,0;3,0;;;;;178,0;1,0;1,0;2,0;40,0;;4,0;2,0;;;4,0;9,0;3,0;1,0;1,0;5,0;7,0;7,0;1,0;82,0;11,0;33,0;4,0;26,0;49,0;;8,0;;1,0;30,0;88,0;3,0;12,0;;4,0;;29,0;10,0;41,0;;12,0;;;29,0;46,0;28,0;1,0;;;;8,0;8,0;16,0;7,0;1,0;3,0;1,0;41,0;12,0;22,0;1,0;5,0;;7,0;12,0;15,0;;;;29,0;4,0;1,0;;5,0;22,0;4,0;1,0;26,0;;;;6,0;10,0;175,0;;;;12,0;4,0;;;7,0;;;1,0;51,0;9,0;;;;;1,0;8,0;;;;12,0;;;;;;;;;;;2,0;1,0;;;;;4,0;5,0;6,0;;;;1,0;1,0;;1,0;;;;;;;;;;;;;;;3,0;;4,0;;;;;;;1,0;24,0;;;;;1,0;;13,0;;;;;61,0;;;;;;;;35,0;5,0;;;;;;5,0;;;1,0;;1,0;;;4,0;5,0;;;;8,0;7,0;;1,0;;;;;;47,0;;3,0;;;16,0;;1,0;;;;40,0;;;;;2,0;;;;;;1,0;;;3,0;2,0;;;;4,0;;;3,0;6,0;;;;;;;;;;;;;;;;5,0;;;;;;;;1,0;;;;;;;;;;;;;1,0;50,0;;;1,0;;;;;;;;;;1,0;;;2,0;;;;;;7,0;;;;;;3,0;;;;;;31,0;;;;6,0;;2,0;;;4,0;;;2,0;;;;;10,0;30,0;8,0;2,0;3,0;;8,0;4,0;;2,0;13,0;1,0;;3,0;2,0;44,0;;3,0;;85,0;;2,0;;11,0;22,0;;21,0;;16,0;6,0;6,0;;2,0;15,0;;;;1,0;18,0;;5,0;1,0;1,0;3,0;;;5,0;9,0;1,0;2,0;;2,0;;1,0;;2,0;;;;2,0;38,0;42,0;;;1,0;;40,0;;41,0;;1,0;;14,0;;1,0;;27,0;;2,0;17,0;;3,0;;12,0;15,0;1,0;;;;3,0;3,0;2,0;1,0;;;;;6,0;2,0;;2,0;;;10,0;;;4,0;;;;3,0;;;;;28,0;;1,0;1,0;;1,0;1,0;3,0;2,0;16,0;;3,0;;19,0;5,0;;;;;;;2,0;;;1,0;;2,0;2,0;;1,0;1,0;;;;;;;;1,0;;7,0;;8,0;;;2,0;;2,0;20,0;;;;;;;;;;;;;;6,0;4,0;2,0;;;;;;;;;;2,0;;;;3,0;2,0;39,0;;4,0;;;;;;;;;;1,0;1,0;;;1,0;;8,0;;;6,0;;8,0;16,0;;;4,0;;;;9,0;9,0;;;5,0;;;;;1,0;4,0;;;;23,0;;;2,0;;;;;7,0;;;;;;2,0;1,0;1,0;;;;;;;;;;;;;;;;;;1,0;;;1,0;;;;;7,0;6,0;;;;1,0;;;;;;;2,0;4,0;;;8,0;3,0;2,0;;;;;;;;;;;;;;;;;;;;;10,0;;6,0;2,0;4,0;;11,0;;;;;4,0;;;5,0;;;;;;;;;;;;;;;;12,0;;;;;1,0;4,0;5,0;;;;;;14,0;10,0;;3,0;1,0;;42,0;6,0;8,0;;;;3,0;3,0;4,0;;1,0;2,0;6,0;25,0;;;3,0;;;;3,0;;5,0;;;23,0;2,0;;;;;;;;;;;;2,0;;;8,0;6,0;;;;9,0;3,0;1,0;2,0;;;;2,0;;;;;;;;;;;;;9,0;1,0;;;;3,0;;1,0;5,0;4,0;;;;;2,0;;;;;;;5,0;;;;;17,0;2,0;;;;;4,0;;;;;;;;;;;;;;;;;;;;;1,0;8,0;3,0;;;3,0;5,0;;;;;1,0;;;1,0;;;;;1,0;;;;;;;3,0;;;;;6,0;;17,0;;2,0;;;;;;7,0;;;;;;9,0;;24,0;;;;;;;;;;;;;;65,0;;;;4,0;;2,0;;;;;;;;1,0;2,0;;;;;1,0;7,0;;;3,0;;;2,0;;3,0;;1,0;;;3,0;;;;4,0;
vibration;;;;;;9,0;;17,0;5,0;31,0;;;1,0;;32,0;9,0;;22,0;1,0;;;4,0;1,0;2,0;;;;;;42,0;;7,0;27,0;;79,0;5,0;10,0;38,0;;1,0;10,0;;16,0;;126,0;107,0;31,0;117,0;11,0;13,0;9,0;5,0;;;144,0;;56,0;;13,0;;9,0;8,0;1,0;;8,0;;;2,0;7,0;;4,0;;46,0;;;;;;;161,0;1,0;13,0;;51,0;;1,0;;1,0;3,0;1,0;83,0;;;2,0;;;;;55,0;;;;6,0;;;;70,0;14,0;37,0;;;16,0;;;;24,0;12,0;149,0;;20,0;1,0;;;3,0;;;1,0;;;46,0;;21,0;20,0;1,0;5,0;;2,0;7,0;;;;;;30,0;4,0;;;4,0;77,0;;;1,0;;;16,0;2,0;55,0;;3,0;;1,0;1,0;315,0;1,0;2,0;;1,0;1,0;;2,0;20,0;15,0;;8,0;21,0;20,0;9,0;46,0;;;1,0;54,0;;2,0;;25,0;;57,0;;;1,0;10,0;;7,0;2,0;4,0;;;;;;;16,0;27,0;17,0;40,0;3,0;;;23,0;7,0;;8,0;;;;3,0;;;;6,0;;7,0;;24,0;;3,0;1,0;3,0;11,0;119,0;;2,0;12,0;1,0;17,0;25,0;;;2,0;;;;;10,0;;;;;5,0;15,0;;3,0;;1,0;;1,0;;;;;8,0;18,0;;;6,0;7,0;;3,0;;1,0;;6,0;;;4,0;5,0;3,0;;67,0;;;;9,0;;3,0;;;;;8,0;;;;6,0;;5,0;;3,0;;196,0;;;;;;5,0;;3,0;;;6,0;;1,0;3,0;;;;;1,0;;;;;101,0;;;;1,0;;;;;;;29,0;1,0;4,0;;;;;5,0;1,0;20,0;;;1,0;1,0;;;;8,0;10,0;22,0;1,0;;;;;4,0;;;;;;;1,0;;;1,0;1,0;;;;;7,0;;1,0;;;;;7,0;;32,0;;;;11,0;1,0;68,0;;1,0;;9,0;;;;;;1,0;;;;;5,0;3,0;;12,0;12,0;1,0;;;;;;;;;;;11,0;;;;1,0;;;1,0;;;2,0;10,0;;6,0;;;24,0;;;6,0;6,0;;;;7,0;17,0;;8,0;34,0;5,0;;;7,0;5,0;;;5,0;;6,0;;;5,0;1,0;;1,0;;1,0;;;;2,0;1,0;10,0;;1,0;11,0;2,0;1,0;5,0;;2,0;34,0;;;;;;;1,0;;;;3,0;1,0;;1,0;;;63,0;1,0;;2,0;;;;;;;;;;1,0;;4,0;;;;;;;;1,0;1,0;;1,0;;;;;;;1,0;;;;;;;;6,0;;2,0;;7,0;1,0;;;;;;;;;;;;;;;;;1,0;;16,0;;2,0;;254,0;;;;;;;1,0;;;;;;;2,0;;1,0;;;;;;;;1,0;;;;;1,0;;1,0;;;;;;47,0;;;;5,0;;;;;;;;;;;;;;;;1,0;3,0;;1,0;1,0;;;;;;;;;;;;;2,0;;;;2,0;;1,0;29,0;;;;;;;;;;;;;;11,0;;;3,0;;1,0;5,0;;1,0;;1,0;;;;;;;7,0;;;;5,0;;;;;1,0;;;;;;;;;;;;;;;;;8,0;4,0;;2,0;;;1,0;;;;;;;;;;;;1,0;;;2,0;;;;;;;;;;;1,0;;;;;;;;1,0;;;;;;;;;;2,0;;;;;;1,0;;;;;;;;45,0;;4,0;;;;;;;28,0;;1,0;;;;1,0;;;;;;;;;;;;;;3,0;;;18,0;;1,0;;11,0;;;;;;;3,0;54,0;3,0;;;;;1,0;2,0;;;;;;;;;2,0;;;;;;;;;;;;;;;;1,0;;;;;;;3,0;;;;;;;;;;;;;;;;;;;;;;;;;;4,0;;;;;;;;;;8,0;;;;;;;;3,0;;;;3,0;;;;2,0;;;;;;;12,0;;;;1,0;1,0;6,0;;;8,0;1,0;;;;;;4,0;;;;;1,0;;;1,0;;;;;;;;1,0;;;;;;;;;;;;;;;4,0;;;;;;;;;;;;;;;;;;;;;;;;;;;;;;;;;;;;;;;
viewpoint;;;;;;2,0;1,0;6,0;3,0;2,0;;;3,0;;1,0;22,0;;;;;1,0;21,0;2,0;;;;10,0;;;;3,0;1,0;1,0;;;;;;8,0;;4,0;2,0;;5,0;1,0;;10,0;1,0;2,0;54,0;;4,0;4,0;;;;;;;;;;;;;;;1,0;30,0;;;;21,0;3,0;;;1,0;;2,0;85,0;;2,0;1,0;9,0;3,0;5,0;;;;;;;;;;1,0;;;13,0;;4,0;;4,0;7,0;4,0;2,0;15,0;4,0;4,0;;;5,0;;;;36,0;6,0;55,0;;6,0;;;;3,0;1,0;;;;;7,0;;3,0;2,0;;4,0;2,0;1,0;;;;7,0;;;9,0;;;;;;;;;1,0;2,0;;;11,0;;14,0;;3,0;;9,0;;1,0;;10,0;23,0;;;4,0;;;;;;;;;;2,0;;;;;;;;1,0;;;;;;;;;;;4,0;;;4,0;23,0;;;;;;;;;;;;;;;;;;;;;;;;;1,0;;;;;;;5,0;3,0;;;;;;;;;;;;5,0;8,0;;;;;;;;3,0;;;;;;5,0;;;1,0;;;;;1,0;9,0;;;;;;;1,0;;;;;;;1,0;;;;15,0;1,0;;;;;;;;;;;1,0;;;;;;;;;;;;1,0;;;;;;;;;;1,0;;;;;;;;;;;;;;3,0;;;;;;;;;;1,0;;;;;;;;;3,0;;;;;;;;;;;;;5,0;;;;;;;;;1,0;;;1,0;;;1,0;;;;;;4,0;;;;;;;;;;;;;;;;;;1,0;10,0;1,0;3,0;2,0;;;;;;;;;;;;;;5,0;;;;;;;6,0;;;;;;;;3,0;9,0;;;;;9,0;;;;;;1,0;;;10,0;;;;;;5,0;;;;;;;;;;3,0;7,0;3,0;;3,0;;;5,0;;1,0;17,0;2,0;;;;;2,0;;10,0;;1,0;;;;;;;;;;;;;10,0;;;;;;;;;;;;;;;;;9,0;;;;;12,0;;;;;;;;;;;;;;;;;;;2,0;;;;;;;;;;;;;;;;;;;;;;;2,0;;;;;;;;;;;;;;;;;;;;;;;;;;;;;;10,0;;;;;2,0;;;;;;;;;;;;;;;;;;;;;5,0;;;;;;;;;;;;1,0;;;;;;;;;;105,0;;;;;;;1,0;;;;;;;;;2,0;;;;;;2,0;;;;;;;;;;;;;;;1,0;1,0;6,0;;;;;;;;;;;;;;;;;;;4,0;3,0;;;;;;;;;;;;;;;;;;;;;;;;;;;;;;;;;;;;;;;;;;4,0;;;;;;;;;;2,0;;;;;;;;;;;;;;2,0;;;;1,0;;;;;;;2,0;1,0;;;;;5,0;6,0;;;;;;1,0;;;;;;5,0;;;;;;;;;;;;;;;;;6,0;;;1,0;;;;;2,0;;;;;;1,0;;;;;;;;;;;2,0;;;;;;;;;;;;;2,0;;;;;12,0;;;;;;;;;;;;;;;;;;;;;1,0;;;;;;;;;;;;;;;;;;;;2,0;;;;;;;;;;;;;;5,0;;;;;3,0;;;;;;;;;;;;;;;;;;;;;;;;;;;;;;;;;;;;;;1,0;;;;;;;;;;;;;3,0;4,0;;1,0;;;;;;4,0;;;;;;;;;;;;;;;;
vision;;;;;;2,0;1,0;15,0;;4,0;2,0;;5,0;1,0;3,0;20,0;;;;4,0;6,0;7,0;;;;;11,0;1,0;;;14,0;2,0;1,0;1,0;8,0;;;;;;7,0;;3,0;;2,0;3,0;1,0;9,0;;17,0;1,0;2,0;;;3,0;;2,0;;;;;;11,0;;1,0;1,0;2,0;;3,0;10,0;1,0;;1,0;;;;3,0;;7,0;45,0;1,0;24,0;2,0;14,0;;;;;;2,0;23,0;1,0;;;20,0;;;;13,0;1,0;16,0;;20,0;6,0;1,0;13,0;4,0;;7,0;8,0;1,0;4,0;;;;20,0;2,0;4,0;1,0;;1,0;;;9,0;25,0;;;;;6,0;;;2,0;;;;;2,0;;;;;;41,0;3,0;;1,0;2,0;2,0;;;;;1,0;1,0;;227,0;;;;;;4,0;;1,0;;12,0;30,0;1,0;5,0;;;;;;4,0;54,0;;;1,0;;1,0;;;;;;1,0;;;;;;2,0;;;3,0;;;3,0;;1,0;;;;;;;;5,0;;;;;;;3,0;;;;17,0;;2,0;;;2,0;5,0;;22,0;;1,0;;2,0;9,0;;;;;;3,0;;;;3,0;;;;;4,0;;7,0;;;;;;6,0;;;;;;5,0;1,0;1,0;;;;;;;;;;;1,0;;;2,0;10,0;5,0;;;;;1,0;;;;1,0;53,0;;;;;;4,0;2,0;;;;3,0;1,0;;;;;;;;;;4,0;;;;;7,0;;5,0;;;;;1,0;;3,0;;;;3,0;;;;;1,0;1,0;;;2,0;;;;;3,0;;;6,0;;;;;;;;;;7,0;2,0;;4,0;;;;;;;;1,0;;;;1,0;2,0;;;;;;1,0;;;;;;;;;;;;;;;2,0;;;;1,0;;;;;1,0;;;;1,0;;1,0;2,0;;;1,0;1,0;;3,0;;;;;;1,0;2,0;;1,0;;6,0;;;1,0;;1,0;;1,0;;;2,0;19,0;;2,0;3,0;;;;15,0;2,0;;;;;3,0;;;;;1,0;;;;;;;1,0;;;;2,0;;1,0;;;;;5,0;;;;;;4,0;1,0;;2,0;;;;;;;;;;;3,0;3,0;;;2,0;;1,0;;1,0;;;;;1,0;;;2,0;3,0;;1,0;;;;;;;2,0;4,0;;;;;;1,0;;4,0;;2,0;;4,0;;2,0;;;;;;;1,0;;;1,0;;;;1,0;;1,0;;1,0;;;;2,0;;;;;;;;2,0;;4,0;;;;;;;;4,0;5,0;;1,0;;;4,0;;;;;;;;;;;;;;;;;9,0;;1,0;;;;;1,0;;;;;;4,0;;1,0;;;;1,0;;;;;;;;;1,0;;;;;;;;;;;;;;;2,0;;;7,0;;;;15,0;;;4,0;;;;1,0;1,0;;;;;;;1,0;;;;;;;7,0;;;4,0;4,0;;;;;;;;;;;;;;;5,0;;1,0;;;;;1,0;;;;;;1,0;;;1,0;;;;;;;;;;;;;;;;;;;2,0;;;;;2,0;;;;;1,0;;;;;;1,0;;;1,0;;;;;;;;;;;;;;;2,0;;;;;;;2,0;;;;;;;;;;;;1,0;;;;;;;;;;;;4,0;;1,0;;;;;;;2,0;2,0;;;;;;;1,0;;;20,0;;1,0;;;;1,0;;2,0;;;4,0;;;4,0;;;1,0;;;;1,0;1,0;1,0;;;3,0;;;;;;;;;;;2,0;;;;;;;;;;;1,0;1,0;;;;;;;;;;;;;;;;;2,0;;;;;;;;1,0;;;;;;;;;;;1,0;;;;1,0;;;;;;;3,0;;;;;;;;;8,0;;;1,0;;2,0;;;;;;1,0;;;;;;;;;;;;;;;;;;;11,0;;1,0;;1,0;;;;;;;;;;;;;;;;;;;;;;;;;;;;;;;;;2,0;;;;;3,0;;;;;;;;3,0;;;;;
volume;;;;;;4,0;;2,0;2,0;1,0;;;3,0;;;11,0;1,0;;;;;32,0;5,0;;;;;;4,0;;1,0;;15,0;;5,0;1,0;;;2,0;;19,0;;24,0;8,0;;5,0;5,0;7,0;1,0;8,0;4,0;2,0;1,0;;;2,0;3,0;;7,0;;2,0;;6,0;;2,0;2,0;;4,0;3,0;;;;8,0;;;;;4,0;1,0;29,0;2,0;7,0;;9,0;;;;;;16,0;7,0;;;;2,0;;;;16,0;;4,0;1,0;7,0;30,0;;2,0;8,0;;;;;;;;;7,0;7,0;18,0;2,0;4,0;;;;5,0;2,0;;;;;5,0;;;2,0;;;;;;;;2,0;;;;;;;2,0;4,0;2,0;;;;;2,0;;7,0;;;;;;1,0;;2,0;;3,0;20,0;1,0;;2,0;;;3,0;4,0;1,0;15,0;;;;;4,0;;;;;;;;;3,0;;;3,0;;;;;;1,0;;;;;;;;2,0;;4,0;;;;;5,0;;;2,0;1,0;1,0;6,0;1,0;2,0;;;26,0;1,0;;8,0;;7,0;1,0;2,0;;;;5,0;;;;;2,0;1,0;1,0;2,0;;;18,0;;6,0;;;;;;;4,0;1,0;1,0;;;2,0;;5,0;;;;13,0;;;;2,0;35,0;;;;;;2,0;2,0;1,0;;;;;;;;;;;;;;1,0;;;;;;;2,0;;;;;;;;;;;;;;;4,0;;;2,0;;;;2,0;2,0;;;;;;;;;;;;;;;;;;;1,0;;;;;;1,0;;;;;;;4,0;8,0;;;;;;;;;;;;;;;;;;;;;;;;;;;2,0;;;;;10,0;1,0;7,0;;;;;;;;;;;;;;;;;3,0;3,0;8,0;;;;1,0;;;;;;;1,0;6,0;;;1,0;;;;3,0;;;;;;;;8,0;;;;25,0;;;;2,0;;;4,0;;1,0;;;;;2,0;;;;;;;;;;;;;1,0;10,0;;;;;2,0;;;1,0;2,0;;4,0;;;1,0;2,0;;;;;2,0;;3,0;1,0;;;;;;1,0;;1,0;;;;;;;;1,0;;;;;;2,0;;;;;;6,0;;;;;;1,0;;2,0;1,0;;;3,0;;;;;;;;;;;;;;2,0;;;;;;;;;;;;;;;;;2,0;;;;;;;4,0;;1,0;;;;2,0;15,0;;;;2,0;;;7,0;;;4,0;;1,0;;;;;;;;;;;2,0;;;;;;;;;;;;;;;1,0;;;;;;;;;;;;;;;;;;;;;2,0;;;;;1,0;1,0;;;;;;6,0;;;;;;;;;;;;;;;;;;2,0;;;4,0;;;;;;;;;;;;;;;;;;;;4,0;;1,0;;;;3,0;;;;;;;;;;;;;;;;;;;;;3,0;;;;;;10,0;;;1,0;2,0;2,0;;;;;3,0;;1,0;;;;;;1,0;;2,0;;;;1,0;;;14,0;;;;;;;;;;;;;;;1,0;;;;;;;;;;;;;;;;;;;;;;11,0;;;;9,0;;;;;;;;;;7,0;;;;2,0;;;;;2,0;;;;2,0;;;;;;;4,0;;4,0;;;;;;;;;;;;2,0;;;;;;;1,0;;;;;;;;;;;;;;;;;1,0;;;;;;;;;;;;;;;;;;;;;;;;;;;;;;;;;;;;;;;;;;2,0;;;;;;;;;;;;;;;;;;;;;;1,0;;;;;;;;3,0;;;;;;;;;;;;;;;;;;;;;1,0;;2,0;;;1,0;;;;;;;;;;1,0;;;;;;;;;;;;;;;;;1,0;;;;;;;;2,0;;;;;;;;
wall;;;;;;20,0;26,0;35,0;10,0;26,0;3,0;;6,0;;22,0;58,0;10,0;;;;9,0;3,0;;15,0;;;4,0;;8,0;;;;47,0;;24,0;1,0;;;;1,0;7,0;1,0;158,0;;3,0;;6,0;60,0;2,0;9,0;48,0;5,0;;1,0;4,0;49,0;44,0;;;;189,0;22,0;5,0;;17,0;;;142,0;34,0;150,0;2,0;;;;;21,0;;22,0;4,0;52,0;2,0;35,0;;177,0;;;;;21,0;3,0;122,0;;;14,0;;;;;23,0;6,0;;;81,0;6,0;;;58,0;2,0;;;5,0;2,0;173,0;;;63,0;274,0;83,0;4,0;1,0;5,0;;1,0;4,0;;;;;5,0;3,0;;;13,0;6,0;4,0;;17,0;;1,0;;;;;17,0;1,0;;3,0;655,0;2,0;5,0;;1,0;;1,0;1,0;;39,0;;14,0;12,0;;;94,0;8,0;;;4,0;22,0;;;;1,0;6,0;36,0;;3,0;38,0;96,0;;;13,0;147,0;;33,0;;4,0;4,0;16,0;2,0;;;2,0;19,0;115,0;;17,0;;1,0;;52,0;58,0;1,0;;28,0;;28,0;2,0;;6,0;127,0;24,0;14,0;4,0;6,0;;1,0;49,0;1,0;7,0;58,0;301,0;;425,0;5,0;;26,0;15,0;1,0;50,0;2,0;114,0;46,0;5,0;64,0;15,0;15,0;3,0;106,0;32,0;361,0;1,0;2,0;3,0;6,0;;;;1,0;4,0;6,0;58,0;;5,0;;;;42,0;11,0;2,0;1,0;;4,0;21,0;;4,0;;26,0;23,0;;;35,0;23,0;39,0;2,0;;6,0;;34,0;11,0;318,0;3,0;;5,0;34,0;1,0;2,0;;;;10,0;6,0;5,0;6,0;;;2,0;;3,0;3,0;17,0;6,0;3,0;35,0;1,0;;5,0;4,0;11,0;316,0;3,0;7,0;23,0;;42,0;12,0;;9,0;39,0;1,0;25,0;16,0;;11,0;18,0;8,0;;38,0;26,0;;3,0;2,0;31,0;5,0;;4,0;;;57,0;5,0;57,0;5,0;8,0;15,0;4,0;5,0;2,0;22,0;2,0;82,0;;12,0;15,0;5,0;13,0;1,0;7,0;13,0;1,0;12,0;3,0;;33,0;8,0;29,0;41,0;5,0;;148,0;45,0;3,0;;;2,0;;;2,0;8,0;7,0;7,0;;8,0;1,0;3,0;6,0;39,0;2,0;25,0;6,0;;167,0;9,0;;;6,0;22,0;3,0;;9,0;22,0;;;;;11,0;;1,0;;;;;;;;;;;;4,0;8,0;;;2,0;;;;;;1,0;;;;;6,0;2,0;4,0;;;1,0;2,0;;1,0;;;;;;1,0;;;2,0;14,0;1,0;;;;5,0;2,0;;;;;;;;;;;;;12,0;;;;;4,0;;;;;1,0;;6,0;;14,0;;;;;2,0;;;;;;;4,0;;;1,0;;14,0;;2,0;;2,0;;5,0;;;;;12,0;2,0;2,0;;;;;1,0;;;;8,0;;;4,0;;4,0;;;;;1,0;2,0;;2,0;;;;1,0;;18,0;;;;;3,0;;7,0;;;;;;;1,0;2,0;21,0;7,0;;;3,0;4,0;;56,0;;1,0;11,0;1,0;;;;6,0;13,0;1,0;4,0;19,0;37,0;;;;12,0;;;7,0;;;;2,0;;1,0;;;29,0;7,0;4,0;;;41,0;2,0;14,0;;;;;1,0;;2,0;;;1,0;;2,0;1,0;2,0;;;;;;;;;;;;8,0;;6,0;;;;;18,0;;2,0;;21,0;;3,0;;;3,0;;;;;36,0;;3,0;;;;9,0;14,0;9,0;;;13,0;15,0;7,0;;;;1,0;5,0;2,0;4,0;3,0;;;6,0;;;1,0;3,0;;;3,0;5,0;3,0;;4,0;3,0;6,0;7,0;;;20,0;;;;2,0;;;3,0;6,0;;2,0;;;3,0;4,0;;1,0;;;;;12,0;;;2,0;92,0;;;;1,0;;;;;22,0;;2,0;29,0;4,0;;1,0;19,0;;;7,0;1,0;1,0;;15,0;2,0;;1,0;;4,0;;;3,0;1,0;;3,0;;;8,0;;;3,0;;;;2,0;;;;;;;;;;1,0;;;;14,0;;;;1,0;;2,0;;;;;;;4,0;;;;;;;;4,0;;;;;;;;;;;;;;;;;;;;;;;;;;;;;;;;;;2,0;;;1,0;1,0;;4,0;;;2,0;2,0;;;;8,0;;;1,0;;;4,0;;;;;;;;;;3,0;;;;;;20,0;;;;;;;;;;;;;;;;;1,0;2,0;10,0;;;;;;;;;;;;;;;;;;1,0;1,0;;;;;;1,0;2,0;;26,0;1,0;;6,0;14,0;;;1,0;;;;;;;;6,0;3,0;;;;;;;;;;;;;;;;;23,0;;;;;;;2,0;;;;8,0;1,0;5,0;1,0;;;;;;10,0;;;;;;;2,0;;;;6,0;;;;;3,0;;;;;;;;;;;;;;;1,0;;;;1,0;;
warp;;;;;;1,0;;;6,0;;;;5,0;;;14,0;;;;;;1,0;;;;;;;;1,0;;;6,0;;;;7,0;;6,0;;1,0;;3,0;6,0;;;21,0;;2,0;;;;2,0;;1,0;;;1,0;5,0;;;;;;;2,0;;2,0;10,0;;23,0;;8,0;;;;;;1,0;65,0;;;;;;3,0;;;;;4,0;;;;;;;;10,0;;;;1,0;;;;5,0;;;14,0;;2,0;;;;;2,0;;;;1,0;;;1,0;4,0;1,0;;;;;;;;1,0;;;;;;;;;;3,0;;;;;;;;3,0;;;;;;;;;;;1,0;;;;;;;;14,0;;;;;4,0;;;;;;;;;;;;3,0;;;;;;;;;;;;;;;;7,0;;;;;;;2,0;;;;;;;;;;;;;;;;;;;;;;;;;;;;;;;;;1,0;;;;;;;;;;;;;;;;;;;;5,0;;;;;;;;;;;;;;;;;;;;;;8,0;;;;;;1,0;;;;;;;;;;;;;;;;;;;;;;;;;;;;;;;;;;;;;;;;;;;;;;;;;;;;;;;;;1,0;;;;;1,0;;;;1,0;;;;;;;;;;;;;;;;;;;;;;;;;;;;;;;;;;;;;;;;;3,0;;;;;;;;;;;;1,0;;;;3,0;;;;;;;;;;;;;1,0;;;;;;;1,0;;4,0;;;;;1,0;;;;;;;;;;;;;;;;;;;;;;;;;;;1,0;;;;;1,0;;;;;;;;1,0;;3,0;;;3,0;;;;;3,0;;;;;;;;;;;;;;;;;;;;;;;;;;;;;;;;;;;;;;;;;;;;;;;;2,0;;;;;;;;;;;;;;;;;;;;;;;;;;;;;;;;;1,0;;;;;;;;;;;;;;;;;;;;;;;;;;;;;;;;;;;;;;;;;;;;;;;;;;;;;;4,0;;;;;;;;;;;;;;;;;;;;;;;;;;;;;;;;;;;;;;;;;;;;;;;;;;;;;;;;;;;;;;;;;;;;;;1,0;;;;;;;;;;;;;;;;;;;;;;;;;;;;;;;;;;;;;;;;;;;;;;;;;;;;;;;;;;;;;;;;;;;;;;;;;;;;;;;3,0;;;;;;;;;;1,0;;;;;;;;;;;;;;;;2,0;;;;3,0;;;;;2,0;;;;;;;;;;;;;;;;;;;;;;;;;;;;;;;;;2,0;;;;;;;;;;;;;;;;;;;;;;4,0;;;;;;;;;;;;;;;;;;;;;;;;;;;;;;;;;;;;;;;3,0;;;;;;;;;;;;;;;;;;;;;;;;;;;;;;;;;;;;;;;;7,0;;;;;;;;;;;;;;;;;;;;;;;;;1,0;;;15,0;;;2,0;;;;;;;;;;;;;;;;;;;;2,0;;;;
weight;;;;;;6,0;;22,0;14,0;9,0;8,0;;25,0;;13,0;31,0;;;5,0;;;12,0;2,0;1,0;;24,0;24,0;2,0;;3,0;3,0;;18,0;;11,0;;1,0;11,0;5,0;;21,0;9,0;10,0;3,0;11,0;10,0;44,0;20,0;2,0;3,0;3,0;18,0;;;2,0;7,0;5,0;2,0;6,0;;2,0;1,0;;;7,0;;1,0;8,0;11,0;2,0;62,0;1,0;14,0;;;1,0;6,0;;19,0;185,0;1,0;8,0;1,0;20,0;8,0;2,0;;;4,0;4,0;17,0;;;25,0;2,0;2,0;1,0;;55,0;;3,0;4,0;4,0;20,0;4,0;;15,0;6,0;20,0;2,0;;10,0;1,0;;;43,0;2,0;16,0;1,0;7,0;3,0;;12,0;17,0;10,0;2,0;;;;2,0;;8,0;14,0;2,0;8,0;4,0;33,0;;18,0;;1,0;;;1,0;38,0;;;5,0;16,0;2,0;2,0;;;2,0;2,0;;14,0;;2,0;1,0;2,0;;62,0;10,0;3,0;;;15,0;;;2,0;3,0;;5,0;11,0;33,0;7,0;27,0;;1,0;4,0;11,0;;;;;;18,0;;4,0;;4,0;;11,0;;;13,0;;;1,0;;;1,0;21,0;;;;;14,0;12,0;;2,0;2,0;;;1,0;10,0;;3,0;1,0;;;2,0;;;;1,0;;14,0;;16,0;;;5,0;11,0;4,0;10,0;1,0;2,0;;;;1,0;2,0;;;2,0;;46,0;;2,0;;;;1,0;2,0;3,0;;;;;6,0;;3,0;;;6,0;;4,0;1,0;;;8,0;;5,0;1,0;;6,0;;5,0;6,0;;;;;14,0;3,0;;;;8,0;1,0;5,0;;;2,0;;;;;7,0;;12,0;;;;;19,0;;;2,0;1,0;;1,0;;10,0;;;;6,0;;;;;1,0;;11,0;;;;;1,0;2,0;;;4,0;;4,0;1,0;;;;;;;1,0;;4,0;;;;1,0;;;5,0;11,0;3,0;13,0;4,0;4,0;;;;;;;;;;;1,0;2,0;2,0;;;;;;4,0;10,0;;4,0;;;1,0;;;;;37,0;;16,0;;3,0;2,0;;;;11,0;;;;;2,0;;;;1,0;12,0;54,0;2,0;1,0;3,0;;6,0;15,0;;;;;;;;;;5,0;6,0;1,0;7,0;;;4,0;14,0;7,0;6,0;;;9,0;2,0;;;1,0;5,0;;9,0;;3,0;;1,0;1,0;;;;;;3,0;;;1,0;;2,0;17,0;;1,0;6,0;32,0;;;16,0;3,0;;;;40,0;4,0;;35,0;3,0;;;29,0;;;3,0;;1,0;;;;;;;;;39,0;;;;;;3,0;;;;2,0;;;;4,0;;;;;1,0;;;;;;;1,0;;1,0;13,0;;;;4,0;8,0;;;;1,0;;;;5,0;4,0;;1,0;;;;14,0;;5,0;12,0;;5,0;1,0;;;5,0;;;1,0;;1,0;;;;2,0;;9,0;3,0;4,0;;;;10,0;;;;1,0;;;;;13,0;;;2,0;;;;4,0;;;1,0;;;;;2,0;1,0;;;;1,0;;7,0;;1,0;;;;;;;;;2,0;;;;1,0;;;;1,0;;;;1,0;;;3,0;;;;1,0;;;;;;;;;;;;;;5,0;;;11,0;1,0;;;;;;4,0;;;;;;5,0;;;;;;;9,0;;;;2,0;3,0;;;;;;;;;;5,0;;;7,0;;1,0;;;;;;;;;;;;;;;;;;1,0;;1,0;1,0;;;1,0;;7,0;;;;;;;;13,0;;;;;;;;5,0;4,0;;;;1,0;;;;;;;;;1,0;;1,0;;;;2,0;;;;;;2,0;;;;11,0;1,0;;;1,0;24,0;;;;;;;;4,0;3,0;;4,0;;;1,0;29,0;15,0;;;;;;;;1,0;;;;;;;;;;;2,0;24,0;12,0;3,0;18,0;;;11,0;2,0;12,0;23,0;;4,0;;;1,0;1,0;;;;13,0;;;1,0;9,0;;4,0;1,0;;;7,0;;22,0;;1,0;;;;;;;;;4,0;;;;;;;15,0;3,0;;;2,0;;;;;2,0;;;5,0;12,0;;;1,0;;;;;;11,0;;;;1,0;;;;;;;;;;;;4,0;;;;1,0;;;;;;;1,0;;;;4,0;;;;;2,0;;;;;;;;;;;1,0;1,0;;;;1,0;;3,0;;;1,0;2,0;9,0;2,0;;;;;;;;;;;1,0;;;;2,0;;5,0;3,0;1,0;;;;;;;1,0;;;;4,0;;;;2,0;;;;;;;;;;;2,0;;;;;8,0;;;;;;;1,0;;;;;;;;;;;
zone;;;;;;5,0;;2,0;19,0;2,0;;;13,0;;3,0;10,0;3,0;;3,0;;;14,0;;;3,0;;2,0;;;;;;22,0;;1,0;13,0;;;;;16,0;;17,0;;30,0;35,0;17,0;13,0;;7,0;1,0;4,0;;;;3,0;5,0;;4,0;;3,0;2,0;1,0;;;;;11,0;1,0;;11,0;;4,0;;;3,0;12,0;5,0;1,0;48,0;;35,0;;12,0;1,0;1,0;;;2,0;2,0;4,0;;;;;;;;27,0;;1,0;;3,0;15,0;;;4,0;1,0;8,0;2,0;1,0;;;;;28,0;6,0;7,0;;2,0;;;1,0;;;;;;2,0;3,0;;2,0;;1,0;;;;17,0;1,0;;1,0;;;28,0;;;;4,0;12,0;17,0;;1,0;2,0;2,0;2,0;;14,0;;;;;3,0;;;;;1,0;1,0;;;;;1,0;2,0;;1,0;;;;;;;;;;;;;;;;;;3,0;;;;;;1,0;;;2,0;1,0;;;;2,0;;3,0;;;;;;;;7,0;;1,0;;2,0;;;;;1,0;;11,0;;2,0;2,0;;3,0;;2,0;1,0;2,0;;;;;2,0;5,0;;;;;11,0;1,0;1,0;;;;;;13,0;;2,0;;;;;5,0;;;;;;;8,0;;1,0;;;;;1,0;;5,0;;;;;;17,0;3,0;4,0;;;8,0;;;;;;;;;2,0;;3,0;;;2,0;;;10,0;1,0;4,0;;1,0;1,0;;1,0;3,0;;;;;;;;;;;1,0;;;4,0;;;;;;3,0;;;1,0;1,0;;;;;;;3,0;6,0;1,0;;;;1,0;;;;;32,0;4,0;;1,0;;;;;;;;;;;;;;5,0;;1,0;;4,0;;;;;;;1,0;;;;;11,0;3,0;;1,0;;2,0;;1,0;2,0;;;;;2,0;;;;1,0;;2,0;1,0;1,0;;;;;;;;3,0;;2,0;2,0;;;;;;;6,0;;6,0;;1,0;;;1,0;2,0;25,0;;;2,0;1,0;;;5,0;;;;;;;;1,0;;;1,0;;;;44,0;;;2,0;;;4,0;;;;;;;;;;;;;;4,0;1,0;;4,0;7,0;;;;;;;;1,0;;;;;2,0;3,0;;;;;;;;1,0;;;;;1,0;;;;;;;;;2,0;13,0;;;;;;;;;;;;3,0;;;4,0;;;;;;;;;;;2,0;;4,0;;;2,0;;;;;;;;;;;3,0;1,0;;2,0;1,0;;;;;;;;7,0;;1,0;;;3,0;;;;;;;;;;;4,0;;;;;;;;;3,0;;;;;22,0;;1,0;;;;;;;;;;;;;;;;;;;2,0;;;;;;;;;;;;;;;;1,0;;;;;;;;;;;;;;;;;;;;;;;;;;;;34,0;;;;;;;;;;;;;;;;;;;;;;;;;;;;;;;;;;;;;24,0;;;;;;;;;;;;;;;1,0;;;;;;;;;;;1,0;;;;;;1,0;;;1,0;1,0;;;;;;3,0;1,0;;;2,0;;;;;;;;;;;;;;;;;;;;;;;;2,0;1,0;;;;;;;2,0;6,0;;;4,0;;;;;;;;;;;;;;1,0;;;;;;2,0;;;;;1,0;;;;;;;;2,0;;;2,0;1,0;;;;3,0;;;;;;;;;;;;;;;;;;;;;;;2,0;;;;;;;;;;;;1,0;;;;;;;;1,0;1,0;;24,0;;;;;;;;;;;;;;;;;;;;;;50,0;1,0;1,0;;;;;;;;;;;;2,0;;2,0;1,0;;;;3,0;4,0;;;;;;;;;;;;;;;;;;;;;;;;;;;;;;;2,0;;1,0;;;;;;;;;;;10,0;;3,0;;;;;;;;;;;1,0;;;;;;;;;;;;;;;;;;;;;;
abut;;;;;;;5,0;1,0;;1,0;;;;;5,0;12,0;;;;;;;;;;;;;;;;1,0;16,0;;34,0;;;;;;;;;;;;;9,0;;;3,0;1,0;;;18,0;1,0;8,0;;;;10,0;;;;;;;8,0;11,0;3,0;;;;;;;;;;14,0;;4,0;;23,0;;;;;;;38,0;;;;;;;;;;;;5,0;5,0;;;2,0;5,0;1,0;;;;2,0;;;4,0;54,0;22,0;;;3,0;;;;;;;;;;;;2,0;;;;4,0;;;;;;;1,0;;;;16,0;2,0;;;;;;;;3,0;;1,0;;;;15,0;;;;1,0;;;;;;5,0;2,0;;;1,0;4,0;;;8,0;15,0;5,0;;;1,0;;5,0;;;;;5,0;12,0;;8,0;;;;11,0;1,0;;;3,0;;11,0;3,0;;;4,0;;;1,0;;16,0;;6,0;;;2,0;6,0;;9,0;;;;3,0;;;;87,0;6,0;11,0;6,0;2,0;2,0;;3,0;1,0;10,0;;;;1,0;;;;;1,0;3,0;5,0;;;2,0;;;18,0;;;;;;4,0;;;;2,0;6,0;;;5,0;;1,0;3,0;;3,0;;9,0;22,0;99,0;1,0;;8,0;;;;;4,0;;5,0;4,0;;;;17,0;;;;1,0;;12,0;10,0;2,0;4,0;14,0;5,0;1,0;6,0;1,0;3,0;1,0;2,0;1,0;1,0;6,0;1,0;2,0;3,0;4,0;1,0;2,0;4,0;8,0;6,0;1,0;1,0;4,0;9,0;1,0;1,0;1,0;4,0;4,0;1,0;1,0;1,0;3,0;3,0;2,0;13,0;2,0;2,0;8,0;1,0;3,0;6,0;2,0;3,0;13,0;5,0;2,0;4,0;1,0;13,0;15,0;2,0;2,0;1,0;2,0;2,0;1,0;3,0;2,0;2,0;28,0;4,0;2,0;8,0;2,0;2,0;1,0;2,0;6,0;1,0;1,0;3,0;3,0;3,0;3,0;5,0;2,0;3,0;1,0;13,0;3,0;1,0;1,0;10,0;3,0;14,0;1,0;1,0;1,0;4,0;3,0;2,0;2,0;1,0;2,0;2,0;;;;;;;;;;;;;;;;;;;;;;;;;;;;;;;;;;;;;;;;;;;;;;;;;;;;;;;;;;;;;;;;;;;;;;;;;;;;;;;;;;;;;;;;;;;;;;;;;;;;;;;;;;;;;;;;;;;;;;;;;;;;;;;;;;;;;;;;;;;;;;;;;;;;;;;;;;;;;;;;;;;;;;;;;;;;;;;;;;;;;;;;;;;;;;;;;;;;;;;;;;;;;;;;;;;;;;;;;;;;;;;;;;;;;;;;;;;;;;;;;;;;;;;;;;;;;;;;;;;;;;;;;;;;;;;;;;;;;;;;;;;;;;;;;;;;;;;;;;;;;;;;;;;;;;;;;;;;;;;;;;;;;;;;;;;;;;;;;;;;;;;;;;;;;;;;;;;;;;;;;;;;;;;;;;;;;;;;;;;;;;;;;;;;;;;;;;;;;;;;;;;;;;;;;;;;;;;;;;;;;;;;;;;;;;;;;;;;;;;;;;;;;;;;;;;;;;;;;;;;;;;;;;;;;;;;;;;;;;;;;;;;;;;;;;;;;;;;;;;;;;;;;;;;;;;;;;;;;;;;;;;;;;;;;;;;;;;;;;;;;;;;;;;;;;;;;;;;;;;;;;;;;;;;;;;;;;;;;;;;;;;;;;;;;;;;;;;;;;;;
bond;;;;;;;5,0;4,0;3,0;6,0;8,0;;;;2,0;2,0;;;;;;8,0;;;;;;2,0;1,0;;;;10,0;;1,0;;;;;;;;3,0;;;;;20,0;;;4,0;;;;;4,0;19,0;;;;1,0;2,0;;;6,0;;;88,0;;8,0;1,0;;;;;10,0;;1,0;;41,0;4,0;13,0;;14,0;2,0;;;;4,0;;94,0;;;15,0;;;;;40,0;2,0;;;55,0;1,0;;;11,0;;;;;9,0;6,0;5,0;;17,0;33,0;13,0;1,0;;;;6,0;;2,0;;;;;;;;;1,0;2,0;;8,0;;;;;;;39,0;;;;14,0;4,0;;;11,0;;;4,0;;4,0;;;;;2,0;19,0;;1,0;;;1,0;;;;2,0;43,0;;;1,0;2,0;14,0;;;6,0;8,0;;2,0;;7,0;;2,0;;;;2,0;1,0;43,0;;25,0;;;;12,0;;;;3,0;;;;;;20,0;12,0;2,0;1,0;1,0;15,0;;1,0;13,0;;10,0;23,0;1,0;3,0;1,0;;3,0;252,0;;18,0;18,0;27,0;8,0;;9,0;;;;3,0;8,0;4,0;;;;;;;;;10,0;1,0;12,0;;;;;;1,0;;;;;11,0;;2,0;15,0;;3,0;;;5,0;;;9,0;15,0;;2,0;;13,0;159,0;99,0;;;6,0;5,0;7,0;6,0;1,0;;;7,0;;;;17,0;;;;;77,0;5,0;2,0;;2,0;;3,0;;;1,0;14,0;;4,0;2,0;40,0;;;;;2,0;1,0;1,0;;;;;3,0;;1,0;;;;;;;;;;1,0;;;14,0;;;;;;;;;7,0;2,0;;;;1,0;;;;;;;;;1,0;6,0;12,0;;;2,0;3,0;;;;;;;;13,0;;;;;1,0;;;;;2,0;;;19,0;3,0;;;4,0;;;;;2,0;;;;;1,0;;;;;;;;;;;;;;;;;;;;;;;;;;;;;2,0;;;;;;;;;;;;;;;;;;;;;;;;;;;;;2,0;;;;;;;;;;;;;;;;;;;;;;;;;;;;;;;;;;;;;3,0;;;;;;;;;;1,0;;;;;;;;;;;;;;;2,0;1,0;;;;;1,0;;;;18,0;;;;;;;;;;2,0;;;2,0;;;;;;1,0;;;;;;1,0;;;;;;;;;;1,0;;1,0;;;;;;;;;;;;;;;;;;;;;;;1,0;;;;;;;1,0;1,0;;;;;;;;;;;3,0;;;;;1,0;;;;;;;;;11,0;;;;;;;7,0;;;;;;;;;;;;;;;;;;;;2,0;1,0;;;;;;;;;2,0;1,0;;;2,0;;;;;;;;;;2,0;;;;;;;;;;4,0;;;3,0;;;;;;;;2,0;;;;4,0;;;;;;;;1,0;;;3,0;;;;;;;;2,0;;;;2,0;48,0;;;;;;1,0;;;;;1,0;;1,0;;2,0;;;;;;;6,0;;;;;4,0;4,0;;;;;;;;;;;;;;;;;6,0;;;;;;;;;;;;;;;;;;;;;;;;;;;;;;;;;1,0;;;;;;;;;;;;;;;;;;7,0;;;;;;;;;;;;;;;;;;;;;;;;;;;;;;;;;;;;;;;1,0;4,0;;;;;;;;;;;;;1,0;;;;;;;;;;;;;;;;;;;;;;;4,0;;;;2,0;;;;;;;;;;;5,0;;;;;;;;;;;;;;;;;;;;;;;;3,0;;;;;;;;;;;;;;;;;;;;;;;;;3,0;;;;;;9,0;;;;;;;;;;;;;;;;;;;;;;;;;;;;;;;
carrier;;;;;;;3,0;12,0;;20,0;6,0;;2,0;;11,0;28,0;;;;;;4,0;;8,0;3,0;;;2,0;;;;;1,0;;3,0;;;;2,0;1,0;4,0;;15,0;;4,0;;3,0;47,0;4,0;;22,0;3,0;;;6,0;5,0;32,0;;;;2,0;4,0;;;;2,0;1,0;17,0;7,0;7,0;;;16,0;;1,0;;;;;37,0;1,0;4,0;;66,0;;;;;;;172,0;;;26,0;;;;;18,0;2,0;;;43,0;;27,0;2,0;10,0;;1,0;2,0;;4,0;;;;33,0;32,0;17,0;1,0;4,0;1,0;;;1,0;6,0;;;;7,0;;;;11,0;1,0;;5,0;1,0;;;;;;;43,0;;;;3,0;33,0;;1,0;;;3,0;2,0;5,0;26,0;;1,0;41,0;;3,0;96,0;;5,0;;;11,0;;;;;9,0;;;1,0;3,0;31,0;;;4,0;45,0;2,0;6,0;10,0;37,0;;69,0;1,0;;1,0;;;30,0;;14,0;;;;1,0;2,0;;;26,0;;;1,0;;;16,0;5,0;4,0;;;;;;;3,0;2,0;14,0;1,0;2,0;;;12,0;29,0;1,0;9,0;;16,0;4,0;3,0;21,0;13,0;8,0;12,0;13,0;7,0;;;2,0;1,0;;;;54,0;;12,0;3,0;8,0;;;2,0;;;17,0;;;;;;;;25,0;;1,0;;5,0;;5,0;4,0;9,0;1,0;;9,0;;3,0;15,0;66,0;;;10,0;2,0;;1,0;;1,0;2,0;2,0;32,0;3,0;;3,0;;;13,0;;3,0;;11,0;2,0;18,0;;2,0;9,0;6,0;3,0;7,0;;;;29,0;;;;;;;12,0;;;;;3,0;;5,0;;;;8,0;10,0;1,0;1,0;2,0;;;39,0;19,0;1,0;;;3,0;6,0;1,0;10,0;;;4,0;1,0;;1,0;;5,0;1,0;2,0;1,0;6,0;;;2,0;;2,0;;4,0;;2,0;7,0;;;;;1,0;;1,0;;10,0;53,0;15,0;2,0;1,0;21,0;;23,0;;3,0;;2,0;3,0;15,0;2,0;;1,0;2,0;1,0;;8,0;;;;;;;1,0;;;;;;;;;;;;;1,0;1,0;;;;;11,0;;;;;2,0;;;;3,0;;12,0;2,0;;;;;;;6,0;6,0;;;;2,0;;1,0;3,0;;;;;;;;;;;;;;;;;;;;6,0;;;;;;1,0;;;;;1,0;4,0;;;;;;;;;1,0;;;;;;;;;;13,0;;;;1,0;;;;12,0;;2,0;;;;;;;;;;3,0;;19,0;10,0;;;;8,0;;;;;;6,0;;;;;;;;1,0;1,0;;;;3,0;;1,0;2,0;;;;;;;;;7,0;;;10,0;;;;;;;2,0;;2,0;;1,0;;;;;6,0;;;;7,0;;;;;;;;;;;;;2,0;;;;;;1,0;;;;4,0;;;;;;;;4,0;;;;;;;;3,0;;;;;;53,0;;;;6,0;;;2,0;;;;;;;;;2,0;3,0;;;;10,0;;1,0;;;;5,0;1,0;;;;15,0;2,0;;;;;59,0;;;;;;4,0;1,0;;;;;;2,0;1,0;3,0;1,0;;;;;2,0;;;;2,0;;;;;;2,0;;3,0;30,0;5,0;;;;;;3,0;;;1,0;;;;;;;;3,0;5,0;;;10,0;;;;2,0;2,0;4,0;;;;;;2,0;;;2,0;;1,0;;8,0;;1,0;;3,0;;1,0;;;2,0;;5,0;;;;;;;;3,0;88,0;6,0;;25,0;;;;;;6,0;;18,0;3,0;;;20,0;7,0;;;;;;6,0;;;;;1,0;;;;;;6,0;;;5,0;;;4,0;1,0;;;;;;;;;;;;;;1,0;;;;1,0;;;;;;;;;5,0;;;;;;;;;;;1,0;;;;;;;;;;;;13,0;;;;;;;;;;;;;;;;;;;;;;;;;;21,0;;;;;3,0;;;;;;;;;;;;;;;;;;;1,0;;;;;;;;;;2,0;;;;;6,0;;;12,0;;1,0;;;;;;;2,0;;;;;;;;;;;;;;;;1,0;;;;;;;;;1,0;;2,0;1,0;;;;;;;;;;;;;;;;;;;;;;;;;;;;;;;;;;;;;;;;;;;;;
cavity;;;;;;;12,0;5,0;3,0;31,0;33,0;;;;12,0;21,0;;;;;;2,0;;11,0;4,0;;;1,0;4,0;;;;18,0;;1,0;1,0;;;3,0;;1,0;;111,0;1,0;2,0;;;39,0;3,0;1,0;35,0;;;;1,0;11,0;7,0;;;;27,0;1,0;1,0;;9,0;;;65,0;19,0;16,0;;;1,0;;;2,0;;1,0;1,0;39,0;6,0;13,0;;41,0;;;;;1,0;;58,0;;;15,0;1,0;2,0;;;16,0;;;;48,0;1,0;;;22,0;;;;25,0;1,0;;;;26,0;56,0;33,0;5,0;3,0;1,0;;;;24,0;;;;9,0;1,0;;;1,0;2,0;;;;;;;;;;57,0;1,0;;1,0;16,0;4,0;3,0;;;;1,0;;;3,0;;;;;;51,0;;;;;1,0;;1,0;3,0;1,0;3,0;7,0;1,0;;19,0;64,0;;;10,0;60,0;2,0;;;19,0;;24,0;;;6,0;;2,0;24,0;;13,0;;;;5,0;16,0;;;7,0;;19,0;2,0;;;17,0;1,0;;;2,0;3,0;;2,0;5,0;10,0;11,0;68,0;;50,0;5,0;3,0;22,0;4,0;;17,0;1,0;31,0;2,0;6,0;40,0;44,0;3,0;;39,0;9,0;10,0;3,0;;8,0;5,0;;;;4,0;2,0;;12,0;;1,0;;;;323,0;;;;;;3,0;;3,0;;1,0;19,0;;;3,0;6,0;3,0;;;3,0;;8,0;48,0;79,0;;;;3,0;1,0;;;;;7,0;;3,0;2,0;;33,0;1,0;;;9,0;;;1,0;15,0;;7,0;5,0;;6,0;56,0;;;1,0;4,0;6,0;1,0;;5,0;;;14,0;2,0;;5,0;7,0;4,0;1,0;5,0;1,0;;4,0;;;1,0;8,0;1,0;;3,0;13,0;3,0;2,0;2,0;;31,0;;;;2,0;5,0;1,0;;3,0;3,0;;;4,0;1,0;;;4,0;1,0;;1,0;6,0;;1,0;;;4,0;15,0;;;;1,0;;;;2,0;;3,0;;;;;;1,0;;15,0;3,0;;15,0;15,0;2,0;;;2,0;;;2,0;9,0;;;;3,0;6,0;;;;;;;;;;;;;;;;;;;12,0;;;;;;;;;1,0;1,0;;4,0;;;;;;4,0;2,0;2,0;;;3,0;1,0;;3,0;;;;;;;;;;;;;;;;1,0;;;;;;;;2,0;;1,0;;;;;4,0;;8,0;;14,0;;;;;1,0;;1,0;;;;;4,0;2,0;;;;;;;;;;;;;;;;;;;;8,0;;1,0;;;;1,0;;;;;;;1,0;;;;7,0;;;;;;;;10,0;;;;;;;;;;;3,0;;;;1,0;7,0;;;;;2,0;;1,0;;18,0;12,0;;;1,0;;;4,0;13,0;;17,0;1,0;;;;6,0;;;1,0;;;;;;;;;12,0;3,0;;;;4,0;;30,0;;5,0;;;1,0;;;;;;;5,0;2,0;2,0;;;1,0;;;;;;;;;1,0;;2,0;;;6,0;;6,0;;;7,0;;;;;;;;;;;11,0;;2,0;2,0;;;4,0;1,0;;;;3,0;2,0;;;;1,0;;2,0;2,0;;;;;1,0;;;;1,0;;1,0;9,0;;;;1,0;1,0;;;;2,0;1,0;4,0;;;;;;;4,0;;5,0;;;;;;2,0;;1,0;1,0;;1,0;;;;21,0;;;;;;;;6,0;1,0;13,0;1,0;6,0;5,0;;2,0;3,0;;;;;7,0;;15,0;4,0;;1,0;;1,0;;;;3,0;;;9,0;;4,0;2,0;;6,0;3,0;;2,0;;;;;;;;;;;;;;;2,0;;;;;;;;;;;;;;;;;;;;;;;;;;;;;;;;;;2,0;;2,0;;;;;;;;;;;;;;;;;;;;;;;;;;;;;;;;;;1,0;;;;;;;;;;;;;;;;1,0;;;;;1,0;;;;;;;2,0;;;;;1,0;;;;;;;2,0;;;;;;;;;;;;;;;;;;;;;;;;;1,0;;;8,0;;;;;1,0;1,0;;;;;;;;;;;;;;;;;;;;;;2,0;;5,0;;;;;;;;;;;;;;;;;;;;;;;3,0;;;;;;;;;;;;;;;;1,0;;;;;;;;;;;;;;;;;;;;;
cement;;;;;;;1,0;1,0;;3,0;;2,0;;;;;;;;;;;;;;;;;;;;6,0;;;;;;;;7,0;1,0;;5,0;;;;;2,0;;;;;;;;;244,0;;;;;;;;;15,0;;9,0;;;;;;;;29,0;;;;29,0;;2,0;;25,0;;;;;;13,0;458,0;;;1,0;;;;;;;;;;25,0;;;35,0;6,0;;;;;;;;;;;29,0;;;;;;;;;;;;;;;;;;;;;9,0;;;;;;;;52,0;;1,0;;;;;;;2,0;;;;;;32,0;;;;;;;;8,0;;;;;;;;;;;;;;;;;5,0;9,0;;;;;;7,0;;;;;;;;;;;;;;;5,0;;;;;;;;;;;;;;;1,0;;;;;;;;;;;;;;;;;;;;;;;;;;;;;;;;1,0;;;10,0;;;;;;;;;;;;;;;;;;;;13,0;;;;1,0;;;;;;;;;;;;;;;;;;;;;;;;;;;;1,0;;;;;;;4,0;;;;;;;;;;;;;;;;;;;;;;;;;;;;;;;;;;;;;;;;;;;;;;;;;;;;1,0;;;;;;;;;;;;;;;2,0;;;;;;;;;;;;;;;;;;;;;;;;;;;;;;;12,0;;;;;;;;;;;;;;;;;;;;;;;;;;;;;;;;;;;;;;;;;;;;;;;;;;;;;;;;;;;;;;;;;;;1,0;;;;;;;;;;;;;;;;;;;;;;;;;;;;;;;;;;;;;;;;;;;;;;;;;;;;;;;;1,0;;;;;;;;;;;;;;;;;;;;;;;;;;;;;;;;;;;;;;;;;;;;;;;;;;;;;;;;;;;;;3,0;;;;;;;;;;;;;;;;;;;;;;;;;;;;;;;;;;;;;;;;;;;;;;;;;;;;;;;;;;;;;;;9,0;;;;;;1,0;;;;;;;;;;;;;;;;;;;;;;;;;;;;;;;;;;;;;;;;;;;;;;2,0;;;;;;;;;;;;;;;;;;;;;;;;;;;;;;;;;;;;;;;;;;;;;;;;;;;;;;;;;;;;;;;;;;;;;;;;;;;;;;;;;;;;;;;;;;;;;;;;;;;5,0;;;;;;;;;;;;;;;;;;;;1,0;;;;;;;;;;;;;;3,0;;;;;;;;;;;;;;;;;;;;;;;;;;;;;;;;;;;;;;;;;;;;;;;;;;;;;;;;;;;;;;;;;;;;;;;;;;;1,0;;;;;;;;;;;;;;;;;;;;;;;;;;;;;;;;;;;;;;;;;;;;;;;;;;;1,0;;;;;;;;;;;;;;;;;;;;;;;;;20,0
chamber;;;;;;;4,0;3,0;;11,0;;;;;2,0;6,0;;;;;;2,0;4,0;;;;;;;;;;7,0;;4,0;;;;6,0;;;;138,0;;;;;11,0;;;6,0;;;5,0;;3,0;;;;;12,0;1,0;;;;2,0;;18,0;2,0;2,0;1,0;;;;;;;;7,0;8,0;2,0;9,0;;15,0;;;;;;2,0;195,0;;;3,0;;8,0;;;7,0;;;;10,0;;;;10,0;2,0;;;;;;;;16,0;7,0;13,0;7,0;1,0;2,0;;;4,0;;;;1,0;;;;;1,0;;;;3,0;;;;;;;11,0;;;1,0;4,0;;;;;;;3,0;2,0;7,0;;;;;;12,0;;;;;2,0;;;;;;;4,0;;2,0;11,0;;;7,0;5,0;;1,0;;1,0;;2,0;;;;;;3,0;;;;;;10,0;14,0;;6,0;;;1,0;;;;1,0;;;;;;;;;;10,0;25,0;;62,0;;;6,0;;;3,0;;94,0;;1,0;22,0;4,0;;1,0;5,0;3,0;6,0;;;;;;;;;;1,0;34,0;;;;14,0;;27,0;;;;;;;1,0;;;8,0;;4,0;;2,0;12,0;4,0;;;;;;7,0;64,0;;;;;;;;;;;;;;;22,0;;;;1,0;;;2,0;;;;;;2,0;5,0;;;;;;5,0;;;3,0;;;;;;;1,0;;3,0;2,0;;1,0;;;;;;;;;7,0;;;;;2,0;1,0;;;1,0;3,0;;;;;;;2,0;;;1,0;;;;;1,0;;;;2,0;1,0;;;;;;;;1,0;;;;1,0;;;;;;14,0;;;7,0;7,0;;;1,0;1,0;;;;;1,0;;;;4,0;1,0;;;;;;11,0;;;;;;;;;;;;;;;;;;;;;1,0;;;;;;;;;;;3,0;;;2,0;1,0;;;;;;;;;;;;;;;;;;;;;;;;;;;;;;;;;;8,0;;;1,0;;;;;;;;;;;;;;;;;1,0;;;;;;;;;;;;;;;;;;;;;;;;;;;;;;;;;;;;;;;;;;;;;;;;;;;;;;;2,0;;21,0;6,0;;;;;;;;14,0;9,0;;;2,0;;;;;;;13,0;;;;;;;;;;;;;;;;4,0;1,0;;;;;;7,0;;;;;;;;;;;;1,0;;1,0;;;;;;;;;;;1,0;1,0;;;;;;;7,0;;;;;;;;;;;;;;;;;;;;5,0;;;;1,0;2,0;;4,0;;;;;;;;2,0;4,0;;;;;;;;;;;;;1,0;;;;;4,0;;35,0;;;;;;;;;;;;;;;;;;;;;;1,0;;1,0;;;;;18,0;;;;;;;;;;4,0;;;;4,0;1,0;;;;;;;;;;10,0;1,0;1,0;;;1,0;;;;;15,0;;;;;;;;;;;;;;;;;;115,0;;1,0;;;;;;;;;;;1,0;;;;;;;;;;;;;;;;;;;;;;;;;;;;;;;;;;;;;;2,0;;;;;;;;1,0;;;;;4,0;2,0;;;;;1,0;;10,0;;;;;;;;;;;;;;;;;;;31,0;;;;;;;;;;3,0;;;;;1,0;;;;2,0;;;;;;;;;;;;;;;;;;;;;;;;;;;;6,0;;;;;;;;;;;;;;;;;;;;;;;;;;;;;;;;;;;;;;;;;;;;2,0;1,0;;;;;;;;;;;;;;;;;;;;;;;;;;;;;;;;;;;;;;;;;;;4,0;;
coat;;;;;;;6,0;8,0;3,0;1,0;2,0;1,0;;;1,0;2,0;;;;;;;;6,0;;;;2,0;3,0;;;;3,0;;;;;;;;;;;;;2,0;;7,0;;;;;;;;1,0;;;;;;;2,0;;14,0;;2,0;26,0;;10,0;1,0;;1,0;;;;;;;1,0;;4,0;4,0;6,0;;;;;1,0;;29,0;;;33,0;;;;;15,0;1,0;;;34,0;3,0;;;6,0;;;;17,0;2,0;2,0;;2,0;3,0;18,0;1,0;;;1,0;4,0;1,0;;;;3,0;;;;1,0;;;3,0;;;1,0;2,0;;;;;;5,0;;;;3,0;;;;2,0;;;;;;;;;;;12,0;;;;;1,0;12,0;;;1,0;13,0;;;2,0;3,0;4,0;;1,0;;;;;;;;3,0;;;;;2,0;5,0;;4,0;;;;13,0;;;;;;1,0;;;;;18,0;;;;9,0;1,0;3,0;;;1,0;21,0;3,0;9,0;;;4,0;43,0;;37,0;;36,0;22,0;1,0;3,0;;;;3,0;;4,0;;;;;;;;;;;5,0;2,0;;;;;;21,0;2,0;;;2,0;;;2,0;;5,0;15,0;1,0;;;;1,0;7,0;1,0;3,0;;3,0;7,0;62,0;;;4,0;;2,0;1,0;;;;8,0;;8,0;;1,0;4,0;;;;2,0;;4,0;;;;;;;4,0;1,0;;;;2,0;1,0;;;;;;2,0;;;;;;;1,0;;;;;;;;;;3,0;;;4,0;1,0;;;;;;;;;;;;;;;;;;;;;;1,0;;;1,0;;9,0;5,0;12,0;;;;;;;;;;;2,0;;;;;;10,0;;;2,0;2,0;;;;2,0;;;;1,0;;;;;;;;;;;;1,0;;;;;;;;;;;;;;;;;;;;;;;;;;;;;;;;;;;;;;;;;;;;;;;;;;;;;;;;;;;;;;;;;;;;;;;;;;;;;;;;;;;;;;;;1,0;;;;;;;;;;;;;;;;;;;;;;;;;;;;;;;;;;;;;;;;;;;;;;;2,0;1,0;;;;;;;;;1,0;;;1,0;;;;;;;;;;;;;;;;;;;;;;;;;;;;;;;;;;;3,0;1,0;;;;;;;;;;;;;;;;;;;;;;;;;;;;;;;;1,0;;;;;;;2,0;;;;;;;;;;;;;;1,0;;;;;1,0;;;;;;;2,0;;;;;;;;;;;;;;;;;;;;;;;;;;3,0;;;;;;;;;;;;;;;;;;;;;;;;;;;;;;;;;;;;;;1,0;;;43,0;;;;;;;;;;;;;;;3,0;;;;2,0;;;1,0;;;;;;;;;;;;;;;;;;;;;;;;;;;;;;;;;;;;;;;;;;;;;;;;;;;2,0;;;;;;;;2,0;;;;;;;;;;;;;;;;;;;;;;;;;;;;;;;;;;;;;;;;;;;;;;;;;;;;;;;;;1,0;;;;;;;;1,0;;;;;3,0;;;;2,0;;;;;;;;;;;;3,0;;;;;;;;;;;;;;;;;;;;;;;;;;;;;;;;;;;;;;;;;;;;;;;;;;;;;;;;;;;;;7,0;4,0;;;;;;;5,0;;;;;;;;;;;1,0;;;;;;;;;;;;;;;;;;;;;;;;;;
conductive;;;;;;;3,0;17,0;13,0;25,0;3,0;;2,0;;;2,0;1,0;;;;;;;3,0;;;;;7,0;;;;22,0;;2,0;;;;;;;1,0;4,0;;7,0;2,0;1,0;46,0;6,0;4,0;41,0;1,0;;;6,0;;18,0;;;;29,0;8,0;5,0;;;;1,0;184,0;11,0;11,0;17,0;;4,0;;;;;5,0;;66,0;;28,0;;83,0;3,0;;1,0;;1,0;;38,0;;;141,0;;;;;19,0;1,0;;;126,0;;;;29,0;1,0;1,0;;10,0;;1,0;;2,0;91,0;78,0;31,0;10,0;1,0;;;2,0;;;;8,0;;;;;;;1,0;;;13,0;;;;;;;65,0;;;1,0;44,0;6,0;;;5,0;;1,0;;7,0;7,0;;;16,0;;3,0;20,0;;;;;5,0;;;;;54,0;5,0;;22,0;2,0;6,0;4,0;;14,0;11,0;48,0;5,0;12,0;23,0;43,0;20,0;;;;;;164,0;;69,0;;1,0;;15,0;;;2,0;24,0;;2,0;7,0;;;17,0;87,0;2,0;1,0;7,0;2,0;1,0;;31,0;4,0;35,0;31,0;7,0;9,0;;;3,0;314,0;;56,0;4,0;126,0;8,0;;35,0;;;;17,0;12,0;8,0;;;2,0;6,0;;;3,0;;9,0;1,0;50,0;;;3,0;;;15,0;;1,0;3,0;;4,0;1,0;2,0;81,0;;10,0;30,0;;;;7,0;14,0;2,0;;5,0;;24,0;175,0;216,0;10,0;;24,0;10,0;4,0;;4,0;;;57,0;;3,0;;2,0;4,0;;;;59,0;;5,0;1,0;7,0;2,0;2,0;;2,0;7,0;29,0;7,0;;;17,0;;2,0;4,0;;8,0;;13,0;;;;;2,0;;;;;2,0;;;;;;;10,0;;11,0;2,0;;;2,0;;;;;;;43,0;;;;5,0;2,0;;;;1,0;;2,0;;2,0;1,0;;;;3,0;33,0;;;;;;;;5,0;;;2,0;4,0;;;1,0;11,0;;7,0;;;12,0;13,0;;;6,0;;1,0;;3,0;;;;;;1,0;;;;;;;1,0;;;1,0;;2,0;;;;;;;1,0;;;;;4,0;;;;3,0;5,0;;4,0;;;;;14,0;;;;;;;;;;;;;;;;;;;;;8,0;3,0;;;;;;;7,0;3,0;;;;;;;;;12,0;;;2,0;;;;;;;;1,0;1,0;;;;;;;;;;;;;;;;;2,0;;;;;;;;;;;3,0;;;;;;;;;1,0;;7,0;;;;16,0;;2,0;;;;;;;;;;1,0;;;;2,0;;;17,0;;;2,0;;2,0;2,0;;;3,0;10,0;;;;;;;;;;;;11,0;;;;;;;1,0;;6,0;;;;;;1,0;;;;6,0;1,0;;;;;1,0;;;;;;;;8,0;;;;;5,0;;;;;;;;2,0;;;;;;107,0;;;;;;;1,0;;;;1,0;;;;1,0;;;;;;;;;1,0;;;1,0;;;;1,0;;7,0;;;;;1,0;;2,0;;;;;;2,0;;1,0;;;;6,0;;;;;;;3,0;;11,0;;7,0;;;1,0;;;;;2,0;6,0;;;;10,0;;;;;;;3,0;;;;3,0;;;12,0;;;2,0;;4,0;;;;4,0;;;2,0;3,0;;;;;;;;19,0;;2,0;;9,0;;;;1,0;;3,0;5,0;;;;;14,0;5,0;;44,0;;88,0;8,0;1,0;1,0;;;;;;4,0;1,0;;;60,0;;;;1,0;;;;;2,0;;;;5,0;;;;;;;;17,0;;;3,0;56,0;;1,0;;;;;;;;;;;;;;;;;;;;5,0;;;;2,0;;;;;;;1,0;;;;;;;;1,0;;;;;;2,0;;;;;;;;;;;;;;;;;;;;;;;;;;;;;;;;;;1,0;;1,0;;3,0;;;;;;;;;;;;7,0;;;;;;;;;;;;;;60,0;;;;;;3,0;;;;;;;;;;;;4,0;;;;;;;;;;;;;;2,0;;;;;;;;;;5,0;;2,0;;;;;;;;;;;5,0;;;;;;;;;;;;;;;;;;;;;;;;;;;;;;;;;;;;;
construct;;;;;;;3,0;5,0;2,0;45,0;4,0;;9,0;;7,0;19,0;1,0;;6,0;5,0;19,0;10,0;;2,0;;;10,0;1,0;;;1,0;1,0;6,0;;6,0;2,0;;;1,0;;5,0;;2,0;7,0;4,0;2,0;3,0;13,0;7,0;3,0;;1,0;;;;1,0;21,0;;;;;;1,0;;1,0;;5,0;8,0;16,0;6,0;5,0;;;;;1,0;;2,0;4,0;94,0;;3,0;;28,0;1,0;1,0;;;;2,0;44,0;;;8,0;;1,0;;;29,0;;12,0;;6,0;16,0;1,0;2,0;15,0;;7,0;2,0;2,0;3,0;1,0;;;13,0;14,0;2,0;;3,0;;;4,0;11,0;8,0;1,0;;;1,0;;;1,0;;;;1,0;;;;1,0;1,0;;;12,0;;;;;7,0;;;;;2,0;8,0;;34,0;;;;1,0;;22,0;;;;6,0;2,0;;2,0;;;;1,0;;5,0;11,0;2,0;;3,0;;9,0;;;;;;2,0;;;;;;5,0;;;;;;3,0;;1,0;;3,0;;;;3,0;6,0;1,0;;;;;;3,0;;;;;10,0;;4,0;;;3,0;1,0;;2,0;;2,0;6,0;;20,0;;2,0;2,0;1,0;;5,0;;;;4,0;;;;;4,0;3,0;2,0;5,0;;;;;12,0;;;1,0;;;7,0;2,0;1,0;;2,0;;;;;;9,0;3,0;;3,0;1,0;3,0;;2,0;;;1,0;;;5,0;;;;;2,0;;;;;;;;;;1,0;2,0;;;2,0;;;1,0;1,0;2,0;;;;;;3,0;;;;;;;2,0;6,0;;;6,0;;;;;;;;;;;;;;1,0;;1,0;;;1,0;;1,0;3,0;4,0;;2,0;;1,0;;2,0;1,0;3,0;;;;4,0;;;;;;3,0;;;;;7,0;;;4,0;1,0;;2,0;;;1,0;;;;;3,0;;;4,0;;10,0;1,0;;1,0;;;;1,0;;1,0;;;5,0;;;;;1,0;;1,0;;;1,0;3,0;;;;3,0;;;1,0;5,0;;;;;1,0;;;;;2,0;1,0;4,0;;;;;;;2,0;;;1,0;2,0;;1,0;1,0;;;;;1,0;;5,0;;;;1,0;;;;;;;;;;2,0;4,0;;;;1,0;1,0;;;;2,0;;;;;;;;2,0;1,0;9,0;;2,0;;;;;;;;;;;;2,0;1,0;;;;;;2,0;1,0;;;;;6,0;;;;;;;8,0;;;;;2,0;1,0;;;;;;;;2,0;;;;2,0;;;;;;;;1,0;;;;;;2,0;1,0;;;;;;5,0;;;;;1,0;;2,0;;6,0;1,0;;;;;;;;;;1,0;;;;;4,0;;;;;;;;;;;;;;;;;;;;;;;;2,0;5,0;;;;;;;;;3,0;;;3,0;;10,0;;;2,0;;;;5,0;1,0;;;;;;1,0;;1,0;5,0;;;;;9,0;1,0;;;;1,0;;4,0;;;;;;;;;;;;;;;;3,0;;;;;;;;;;2,0;6,0;2,0;;;;1,0;;2,0;;8,0;;;;;;;;;;;;;1,0;;;;;;;;;;;;;;;;;1,0;;;1,0;2,0;;;;;;2,0;;;;;;;;1,0;;;;1,0;;;;1,0;;;;;;;;1,0;;;;;;;;;;;;;;;;1,0;;;1,0;;;;4,0;;;;;;;;6,0;;;4,0;;;;;;;;;;;2,0;;;;;;;;;;;;;3,0;;;;;;;;;1,0;4,0;;;;;;;1,0;2,0;3,0;;;;;;;;;;3,0;;;;;;;;;;;;;;;6,0;4,0;1,0;;;;;4,0;;;;;;;;1,0;;;1,0;;;;;;1,0;;;3,0;;;;;;;3,0;;1,0;;;;;;;3,0;;;;;;;;;;;;;;4,0;;2,0;;;;;;;8,0;;;;;;;;;;;4,0;;;;;4,0;;;;;2,0;;;;;;;;;;;;;;12,0;;;;;;;;;;;;;;18,0;;1,0;14,0;;;1,0;;2,0;2,0;;;2,0;12,0;3,0;;;;1,0;;;;;;;;;
dental;;;;;;;1,0;;;3,0;;;;;;;5,0;;;;;;;;;;;;;;;;2,0;;;;;;1,0;;6,0;;9,0;;2,0;2,0;;5,0;;1,0;1,0;1,0;;;;;;;;;;;;;;;1,0;1,0;;;;;;;;;;2,0;1,0;6,0;;2,0;;6,0;;;;;;1,0;2,0;;;;2,0;;;;10,0;;1,0;;;9,0;7,0;;1,0;;;;;2,0;;;;7,0;;;;;;;;;;;;;3,0;3,0;;;;;;;;;;;;;;1,0;;;;;;;;;;;1,0;;3,0;;;;;;;;;;;;;;;;;;;;;;;;;;;;;;;;;;;;;;;;;;;;;1,0;;;;;;;;;;;;;;;;;;;;;;;;;;;8,0;;;;;;;1,0;;;;;1,0;;1,0;;;;;;;2,0;;;;;;;;;;;;;;;;;1,0;;;;;7,0;;;3,0;;;;;3,0;8,0;;;;;;;;;;;;;;;;;;;;;;;;;;;;;;;;;;;;;;;;;;;;;;;;;;;;;;;1,0;;;;;;;;;;;;;;1,0;;;;;;;;;2,0;;;;;;;;;;;;;;;2,0;;;;;;;;;;;;1,0;;;;;;;;;;;;;;;;;;;;;;;;;;;;;;;;;1,0;;;;;;;;;;;;;1,0;;;1,0;;;3,0;5,0;;7,0;;;;;6,0;;;;;;;;;;3,0;;;;;;1,0;;;;;;;;;;;;;;;;;;1,0;;;;1,0;;;;;;;;;;;;;12,0;;;;;;;;;;;;;;;;;;;;;;;;;;;;;;;;;;;;;;;;;;;;;;;;;;;;;;;;;;;;;;;;;1,0;;;;;1,0;;;;;;;;;;;;;;;;;;;;;;;;;;;;;;;;;;1,0;;;;;;;;;;;;;;;;;1,0;;;;;;;;;7,0;;;;;;;;;;;;;;;;;;;;;;;;;;;;;;;;;;;;;;;;;2,0;;1,0;;;;;;;;;;;;;;;;;;;;;;;;;;;;;;;;;;;;;;;;;;;;;;;;;;;;;;;;;;;;;;;;;;;;;;;;;;;;;;;;;;;;;;;;;;;;;;;;;;;;;;;;;;;;;;;;;;;;;7,0;;;;;;;;;;;;;;;;;;;;;;;;;;;;;;;;;;;;;;;;;;;;;2,0;;;;;;;;;;;;;;;;;;;;;;;;;;;;;;;;;;;;;;;;;;;;;;;;;;;;;;;;;;;;;;;2,0;;;;;;;;;;;;;;;;;;;;;;;1,0;;;;;;;;;;;;;;;;;;;;;;;;;;;;;;;;;;;1,0;1,0;;;;;;;;;;;;;;;;;;;;;;;;;1,0;;;;;;;;;;;;;;;;;;;;;
differential;;;;;;;2,0;3,0;3,0;5,0;6,0;;;;2,0;12,0;;;;;1,0;;;;;1,0;9,0;;;1,0;;;10,0;;12,0;1,0;2,0;2,0;1,0;;23,0;;8,0;7,0;;;7,0;2,0;;;;1,0;;;5,0;18,0;;1,0;4,0;;;;;;;;;10,0;;;5,0;;8,0;;;2,0;;;;55,0;;1,0;;29,0;;;;;;;6,0;;;;;;1,0;;2,0;;;;3,0;2,0;;;8,0;;24,0;;;1,0;;;;4,0;9,0;4,0;;1,0;;;3,0;9,0;;;;;;;;13,0;;2,0;4,0;;2,0;;4,0;;;;;1,0;;;;4,0;33,0;;;;2,0;1,0;;30,0;7,0;;;;;2,0;24,0;1,0;;;;;;;;;;1,0;4,0;8,0;;;;;;;;;;5,0;;12,0;;;;;;17,0;;;;;;;;;19,0;9,0;;;;;;;;;;28,0;;;;;;;;;;;;;;;2,0;;;;;;;;;;;;;;;;;;;;14,0;1,0;;;;;4,0;;14,0;;;;;;;;;;;;;;;7,0;;;;;;2,0;;3,0;8,0;;23,0;3,0;;;;;;;1,0;;;;;;4,0;;3,0;;5,0;;;;;;5,0;8,0;;;;;;2,0;;12,0;;;;1,0;1,0;;;;;;;;;;;;;;;1,0;;;1,0;;;;1,0;;;;;;;;;;;;;;;;;;;;;;;;;;;;;;;;;;;;;1,0;;;;;;;;;;;;;;;;;;;;2,0;;;;;;;;;3,0;48,0;1,0;7,0;10,0;;;2,0;;;;;;;8,0;;;;;;;2,0;;16,0;1,0;;;;1,0;1,0;;;;2,0;1,0;;;1,0;4,0;9,0;;;;;;;;;;;;;;;;1,0;;;;1,0;1,0;;;;;3,0;;3,0;;;16,0;;;;;2,0;;16,0;;;;;;;;5,0;;;;;;;;;;;;1,0;;;;;;;;;;;;;;;1,0;;2,0;;;;;;;;;3,0;2,0;2,0;;;8,0;;;;;;;1,0;;;3,0;;;;;;;;;;;;;;;;7,0;;;4,0;;;;;1,0;;;;;;;;;;;;;;;11,0;;;;;;;;;;;;;;2,0;;;;;;;;;;;;;;;;;;;;;2,0;;;;;;;;;;;;;;;;;;;;;4,0;;;;;;;;;;;;;;2,0;;1,0;;;;;;;4,0;;;;;;4,0;;;;;;;;;;;;4,0;;;;;;1,0;;;;;;;;;2,0;;;;;;;;;1,0;;;;;;;;;;;;;;15,0;;;1,0;;;;3,0;;;;;;;;;;;;1,0;;;;;;;;;;;;;;;;;;;2,0;;;32,0;2,0;;;;3,0;;;;;;;8,0;;;;;;;11,0;;;;;5,0;;;;;;;153,0;;;8,0;;;10,0;;;;;19,0;;2,0;;;;;;1,0;;;;1,0;;;;;;;1,0;;;;;;;;;;;;;;;;2,0;;;;;;;;;;;2,0;;;;;2,0;;;;;;;;;;;;;;;;;;;1,0;;;;;1,0;;;;3,0;;;;;;;;;;;;;;;;6,0;;;;;;;;;2,0;;;;;;;;;2,0;;1,0;;;;;;;;;14,0;;;;;;;;;1,0;;;;;;;;;;;;;;;;;;;;;;;;;;;;;;;;;;;;;;1,0;;;;;1,0;;;;;;;;;;;;;;;;;;;;
embed;;;;;;;1,0;7,0;;4,0;1,0;;1,0;1,0;;15,0;;;;;1,0;14,0;;;;;1,0;1,0;;;4,0;;27,0;;17,0;32,0;;;;;28,0;;1,0;1,0;2,0;;10,0;21,0;17,0;28,0;8,0;;1,0;;6,0;1,0;7,0;;1,0;;;4,0;;;2,0;;3,0;5,0;16,0;6,0;;;16,0;4,0;;;;;;81,0;1,0;3,0;1,0;36,0;;1,0;;;;;27,0;;;8,0;;;;5,0;21,0;;;;17,0;3,0;;2,0;1,0;3,0;13,0;27,0;;8,0;;;;23,0;17,0;3,0;5,0;;2,0;;11,0;;9,0;4,0;;;;2,0;;;1,0;;;8,0;;;;;;;1,0;8,0;;;;;18,0;;;;;1,0;;6,0;29,0;;1,0;3,0;1,0;;9,0;;;;38,0;1,0;;;2,0;;1,0;;;;12,0;9,0;;;4,0;16,0;;13,0;;3,0;;7,0;;;;;;10,0;;3,0;;;;;1,0;;;;;;;;;1,0;23,0;;;;;;;;;3,0;19,0;;6,0;;;1,0;14,0;;21,0;;10,0;;2,0;12,0;;2,0;1,0;5,0;;3,0;;;6,0;;;;;;1,0;;3,0;;;;;;7,0;;5,0;;;;4,0;1,0;3,0;;2,0;1,0;3,0;;;2,0;;4,0;;6,0;;16,0;6,0;19,0;6,0;;;;;6,0;;;;2,0;;;;;1,0;;;;15,0;;1,0;1,0;;;1,0;;;;;;;2,0;;;1,0;3,0;;7,0;;6,0;;;;2,0;;9,0;;;;;;;1,0;;;1,0;1,0;1,0;;1,0;7,0;;;1,0;;2,0;;3,0;;11,0;;3,0;;;;;12,0;1,0;1,0;;;;;;2,0;;;2,0;;;;;;;;;;1,0;;;2,0;;;3,0;;;3,0;;;5,0;;2,0;13,0;1,0;;;;;;;;;1,0;;;;;;;;;51,0;;;;;;1,0;;;;;3,0;;;;;;;1,0;;;;2,0;4,0;;;4,0;;5,0;1,0;1,0;5,0;;1,0;3,0;1,0;;;;13,0;1,0;;;;1,0;;;;;3,0;3,0;2,0;;;;4,0;;;4,0;;;;;10,0;;;;;1,0;1,0;;1,0;5,0;;;;;;;;;;3,0;;;2,0;2,0;;1,0;3,0;3,0;;;;;;;;;1,0;8,0;;;4,0;;;;;;;;;;;;3,0;;;;;;;;;;;;1,0;;10,0;;;;;;;;;;;;;;;1,0;;;;;;;;;;;;1,0;;9,0;3,0;;;;;8,0;;1,0;2,0;;;;;;3,0;;;;;;;;;;;1,0;2,0;;2,0;;1,0;;6,0;;;1,0;;;;;;;;14,0;;;;;;;;;;2,0;;1,0;3,0;;;;;;;1,0;2,0;;;3,0;2,0;;;1,0;;;3,0;;;1,0;;;;;;;;2,0;;;1,0;;;;;;;1,0;;;;;2,0;;;;;;;2,0;1,0;;2,0;;;;;;;;;;;2,0;;1,0;;;;;;;;;;;2,0;;;;;;;;1,0;;;;1,0;;;;;;;;;;11,0;2,0;;;;4,0;;;;;2,0;4,0;;;;19,0;;5,0;;;;;;;;;;;;;8,0;;;;3,0;;;;;;;;;;;;;;;;;;;;;1,0;;;;;;;;10,0;;;1,0;;;;;;;;;2,0;;;2,0;;;2,0;;3,0;;;;;;;;;;;;;;;;;;;;;;;;;;;;;;;;;;;;;;;;;;;1,0;;;;;;;;;;;;;;;;;;;;;;;;;;;;;;;;;;;;;;;;;1,0;1,0;;;;;;3,0;;;;;;;5,0;;5,0;;;;;;;;;;;;;;;1,0;1,0;;;;;;;8,0;;;;;;;;;;;;;;2,0;;;;;;;;;;;;;;;;3,0;;;;;;;1,0;;;;;;;;;2,0;;;;;;;;;;;;;;;;;;;;;
expression;;;;;;;1,0;;6,0;;2,0;;1,0;;;6,0;;;2,0;;;1,0;;;4,0;1,0;1,0;;;;;3,0;6,0;;9,0;;6,0;9,0;;6,0;4,0;;;;2,0;3,0;9,0;3,0;;2,0;1,0;13,0;7,0;;;;12,0;2,0;1,0;;;;;;1,0;35,0;3,0;;;;;;10,0;;;9,0;;;;5,0;;10,0;;15,0;;;;;;16,0;88,0;;;;;;;;5,0;;1,0;1,0;15,0;1,0;;1,0;14,0;3,0;2,0;8,0;;2,0;;;;1,0;1,0;8,0;2,0;9,0;;;4,0;1,0;1,0;;;;;1,0;;;;;13,0;;1,0;;;115,0;;;;;8,0;;;5,0;;;1,0;;2,0;;1,0;;31,0;;;;;;15,0;;;;;;;;;;;;;;;;;;;1,0;;;;;;26,0;;;;;;;;;;;;;;;4,0;;;;;;6,0;;;;;;;;;;;;;;;;;;;;;;;;;;;;2,0;3,0;;;;;;;;;;;3,0;;;;;;;;;;;9,0;;;;;;;2,0;;;;;;1,0;1,0;;;;;1,0;12,0;;;;1,0;;;7,0;;;;;;;;;;2,0;;;;;;;;;;;;;;;;;;;;;;;;;;;;;;;;;;;;;;;1,0;;;;;;;;1,0;1,0;;;;;4,0;;;;2,0;;;;;;;;;;;;;;;;;;;;;;;;;;;;;;;;;;;;;;;;;;;;1,0;;;;;;7,0;;;;;;9,0;5,0;2,0;3,0;;;;;;;;;;;;;;;;;;;1,0;;;1,0;;;4,0;;;;15,0;1,0;;;;3,0;;;;;3,0;;;;;;;;;;;;;;;;;1,0;;;;;;1,0;;8,0;;;;2,0;;;2,0;;;;;;;;;;1,0;2,0;;;;;;;;;;;;;;;;4,0;;;;;;;;;;;;;;2,0;;;;;;;1,0;;;;;24,0;;;5,0;;;;;;;2,0;;;;;;;;;;;;;;;;;1,0;;;;;;;;;;;;;;;;;;;15,0;;;2,0;;4,0;;;;;;;;;;;;;;;;;;;;;;2,0;;2,0;;;;;;;;;;;;;;;;;;;;;;;;;;;;;;;;;;;;;;;;;;;;;;;;;;;;;;;;;;;;;;;;1,0;;;;;;;;;;;;;;;;;;;;;;;;;;;;;;;;2,0;;;;;;;;;;;;;;;;;;;;;;;;;;;;;;;;;;;;;;;;;;;;;;;;;;;;;;;;;;;;;;;;;;;;;;;13,0;;;;;;;;;;;;1,0;4,0;;;;;;;;;;;;;;;;;2,0;;;;;;4,0;;;;18,0;;;;5,0;;;;;;;4,0;;;;;2,0;;;;;;;;;;;;;;166,0;;6,0;;;2,0;;;;2,0;;;;;;;;;;;;;;;;;;;;;;;;;;;;;;;;;;;;;;;;;;;;;;1,0;;;;;;;;;;;;;;;;;;;;;;;;;;43,0;;;;;;;;;;;;;;;;;2,0;;;;;;1,0;;;;;;;1,0;;;;;;;;;;;;;;;;;;;;;;;;;;;;;;;;;;;;;;;;
extension;;;;;;;4,0;9,0;7,0;2,0;;;1,0;;36,0;19,0;4,0;;;;;;;;10,0;;;3,0;5,0;;;;14,0;;4,0;;;;;;;;12,0;;6,0;;2,0;23,0;;;15,0;8,0;;3,0;1,0;1,0;18,0;;;;52,0;;;;1,0;;1,0;17,0;11,0;2,0;;;2,0;;3,0;4,0;;;;2,0;;1,0;;41,0;3,0;;;;;48,0;11,0;;;;;;;;5,0;;;1,0;20,0;3,0;;;5,0;;;;3,0;;;;2,0;3,0;115,0;28,0;;;1,0;;;1,0;;;;;2,0;1,0;;;6,0;;;3,0;1,0;;;;3,0;;;11,0;;;;7,0;;2,0;;;;;;;23,0;;7,0;;;;19,0;;;;;5,0;;;;;;2,0;1,0;4,0;10,0;4,0;;;4,0;9,0;;;;11,0;;5,0;;;;;3,0;26,0;;3,0;;;;5,0;;3,0;;53,0;6,0;3,0;;1,0;;1,0;;;;;;;1,0;4,0;;14,0;9,0;;;;;;2,0;12,0;9,0;;55,0;;6,0;20,0;1,0;3,0;5,0;2,0;2,0;6,0;2,0;;3,0;3,0;;;;2,0;;;11,0;;;1,0;1,0;;1,0;;;;;;3,0;;;;5,0;;;;;;4,0;1,0;;6,0;;32,0;1,0;11,0;1,0;;30,0;;;;;;1,0;;3,0;6,0;;;2,0;;;;1,0;1,0;2,0;4,0;8,0;;;;;;2,0;1,0;;1,0;;5,0;;1,0;;;;18,0;;1,0;;37,0;3,0;;8,0;;;;;4,0;3,0;;4,0;;;9,0;6,0;10,0;;;7,0;2,0;15,0;13,0;2,0;4,0;10,0;;;22,0;;;;2,0;;2,0;;;3,0;;;7,0;7,0;26,0;;3,0;;;;1,0;;;;;14,0;6,0;4,0;2,0;3,0;;44,0;6,0;;14,0;2,0;;;27,0;2,0;;;;7,0;;8,0;;;;;;;1,0;;;;;;;;;3,0;;;;;1,0;;;;;3,0;;;;;8,0;;;;;;;;1,0;;;;;1,0;;3,0;;;1,0;;;2,0;;;;;;;;;;;;;;;;;;;8,0;2,0;3,0;;;;;1,0;;;;;;12,0;5,0;;;;;;;;;;;2,0;;;;;;;;3,0;;;;;;1,0;;;;;;;;;;;;;;;;8,0;2,0;;;;;;;;;;2,0;;2,0;;;;;;1,0;;;;;6,0;;;;;8,0;;;;;;;11,0;4,0;;1,0;;;4,0;;;;;;;;;2,0;;1,0;2,0;;;;;1,0;;;;;;;6,0;;;;;3,0;;;;;;;2,0;;;;;;;;;;2,0;;15,0;;;;;;;;;;;;;;1,0;;;;;;;1,0;;;;5,0;;;;;;;;;;34,0;;;2,0;;;;9,0;;;;;;;;;2,0;;;;;;;;;;2,0;;;;4,0;34,0;2,0;2,0;;9,0;;1,0;;;;3,0;;;;2,0;;;1,0;1,0;;6,0;;;2,0;;3,0;1,0;7,0;;;;;;;;14,0;;;;4,0;;;;8,0;;;;4,0;;;;;;;13,0;;;;;2,0;27,0;;;;;2,0;;;;;;;;;;;;;;2,0;;;;;;;;;;;;;;;;;;;;;1,0;;;;;;;;;;;;;;;;;;;;1,0;3,0;;1,0;1,0;;;;;1,0;;;;;;;;;;;;;;;;;;;;;;;;;;;;;;;;;;;3,0;;;;;;;;;;;;;;;;;;2,0;;;;;;;;;;;;;3,0;;;;;;;;;;;1,0;;;2,0;;;;;;;;;;;;;;;2,0;;;;;3,0;;;;;;2,0;;;2,0;;;;;;;;2,0;;;;;;;;;;;2,0;;1,0;;;;;;;;;;;2,0;3,0;;;;;;;;1,0;;;;;;;;;;;;;;;;;;;;;;;;;;;;;;;;;;;;2,0;;;;;;
flow;;;;;;;3,0;2,0;;3,0;;;10,0;;8,0;6,0;;;;1,0;;3,0;2,0;12,0;;;;;1,0;;;;19,0;;16,0;;;4,0;4,0;;8,0;4,0;2,0;3,0;1,0;;6,0;6,0;2,0;2,0;2,0;;;1,0;6,0;;6,0;;6,0;;;;2,0;;;4,0;;5,0;31,0;1,0;;2,0;17,0;6,0;;2,0;;;1,0;52,0;10,0;5,0;;;1,0;2,0;1,0;;1,0;;16,0;;;7,0;;;;;11,0;;;;5,0;;;;20,0;;10,0;8,0;6,0;2,0;;;;17,0;16,0;10,0;1,0;9,0;2,0;;6,0;3,0;37,0;;;;;;;15,0;3,0;2,0;;;1,0;6,0;;;;;;2,0;;;;7,0;11,0;2,0;;3,0;;;;8,0;6,0;;;1,0;;2,0;8,0;;1,0;;3,0;;;;;;2,0;2,0;;1,0;1,0;;;;;4,0;;;3,0;3,0;;1,0;;1,0;;;;13,0;1,0;2,0;;;;13,0;;;1,0;10,0;;4,0;15,0;;1,0;5,0;;;6,0;2,0;;;2,0;8,0;;9,0;4,0;;2,0;;;3,0;4,0;;19,0;;6,0;;;;;5,0;5,0;16,0;1,0;6,0;;;1,0;62,0;;;5,0;;8,0;;;;;;4,0;;5,0;;;;;;;;;2,0;;;1,0;2,0;;4,0;1,0;;;1,0;3,0;;;6,0;;;2,0;;;7,0;;;;;10,0;;;;1,0;19,0;4,0;;;;1,0;22,0;2,0;;;;6,0;3,0;;6,0;;;;;3,0;2,0;;;;;5,0;;;2,0;1,0;;;;;;;1,0;1,0;31,0;;;1,0;4,0;2,0;;;;;;5,0;;;;;;;;;;;;1,0;;;1,0;;;;2,0;;3,0;;;;11,0;;;;;;;;;;;;1,0;;;;1,0;;;;2,0;;;;;;;;;;;;;;;1,0;;;;2,0;;2,0;;1,0;;;;;;;;;2,0;;;;6,0;;8,0;;;;;;;2,0;;1,0;;1,0;;1,0;6,0;11,0;;;;1,0;2,0;;4,0;;;;;;;;;;;5,0;;;6,0;;;;;2,0;;;;2,0;3,0;2,0;;;;7,0;;6,0;3,0;;;;;20,0;;;;4,0;;1,0;;;;;;2,0;;;;;1,0;;;;;2,0;;;;;;4,0;;;;;;;;;;;;;;;;;;;7,0;;;;1,0;;;;5,0;;;;4,0;3,0;;;1,0;;;;1,0;;;;;;;;;;1,0;;;;;;;;;1,0;;;1,0;1,0;;1,0;2,0;2,0;;;;;4,0;;;;;;;;;2,0;;;;1,0;2,0;;;;;;;1,0;;;;1,0;;;;9,0;;;;;;;;;;1,0;;7,0;;;;;;;1,0;;;;;;;;;;;;;;;;;;;;;;;1,0;;13,0;;;;;;9,0;;;;;;3,0;1,0;;;;;;;;;;;;1,0;;4,0;;;;;3,0;;;;;;;8,0;;;;;;;;;;;;;;;;3,0;;;;;;;;7,0;;;;27,0;1,0;3,0;;;;;;;;;;1,0;;;;;;;;;;;;;5,0;;;;;4,0;;;;2,0;;;;;1,0;;;;;;7,0;10,0;1,0;;4,0;;;;;;;;;;;;;;;1,0;;3,0;;;;;;;1,0;;;;;;;;;;;;;;;;;;;;;;;;;;;;;;;;;;;;;;;;;;;1,0;;;;;;;;10,0;;;;1,0;;;;;;;;;;;;;;;;;;;;;;;;;;;;;;;;;;;;;;;;1,0;;;;;;;;;;2,0;;;1,0;;;4,0;;;;;;;;;;;;;;;;3,0;;2,0;;;;;;;4,0;;;2,0;;;;;;;;;;;;;;;3,0;;;;;;;;;;;;;;;;;;;;;3,0;;;;;;;1,0;;;;;;;;;;;3,0;;;;;;;;
glass;;;;;;;13,0;10,0;;21,0;3,0;1,0;;;;1,0;1,0;;1,0;;;4,0;;1,0;1,0;;8,0;2,0;2,0;;;;32,0;;8,0;2,0;;;;;;;12,0;;;;10,0;19,0;5,0;84,0;14,0;;;;1,0;1,0;26,0;;;;4,0;;1,0;;43,0;;;41,0;5,0;3,0;;;;;;3,0;;;2,0;70,0;;4,0;2,0;40,0;;;;;;6,0;68,0;;;11,0;;1,0;;;36,0;;;;69,0;;1,0;1,0;14,0;10,0;;;8,0;;7,0;;;24,0;23,0;22,0;2,0;1,0;1,0;1,0;2,0;4,0;;;1,0;;;;;2,0;2,0;;;;3,0;;;;;;;53,0;;;;12,0;4,0;4,0;;;;;;;21,0;;;;;4,0;11,0;;;;2,0;9,0;;;;3,0;6,0;21,0;;;4,0;1,0;4,0;;4,0;1,0;15,0;3,0;;10,0;9,0;10,0;;;;;;12,0;;6,0;;;;99,0;;;;5,0;;;;;;12,0;3,0;4,0;;;;;3,0;1,0;;2,0;17,0;;1,0;;;2,0;40,0;;8,0;;16,0;18,0;32,0;9,0;;4,0;;9,0;11,0;2,0;2,0;;;;;;;;;4,0;33,0;1,0;;;;;4,0;1,0;;2,0;;4,0;;4,0;3,0;;1,0;;11,0;;;1,0;9,0;15,0;;;;7,0;257,0;46,0;10,0;;;6,0;;;;1,0;;63,0;;;;11,0;;;;1,0;3,0;16,0;;6,0;24,0;;4,0;1,0;;;8,0;;;1,0;1,0;;5,0;;;;;24,0;;;2,0;;;;;;;2,0;;3,0;;;;;;1,0;4,0;9,0;;;8,0;2,0;;;;;11,0;;4,0;;;;;;;2,0;;;;2,0;4,0;2,0;19,0;1,0;;2,0;;;;;;;;;;;;;;;;;1,0;;9,0;1,0;;4,0;;;;;;3,0;2,0;;40,0;;;;;;;;;;;;1,0;;;;;;;;;;;;;;;;;;;;;;;;2,0;;;1,0;;;16,0;;;;;;4,0;;;;;;;;;;43,0;;;;1,0;;;;;;;;;1,0;;;;;16,0;;;;;;;6,0;;3,0;3,0;;;;3,0;1,0;;;;;;;;;;;4,0;;;;;;;2,0;;;1,0;1,0;;13,0;1,0;;1,0;;;;;;;;;;1,0;2,0;;9,0;;;;2,0;;1,0;;;;;;;;;;1,0;;;;;1,0;;;;;1,0;;;;;;2,0;;2,0;1,0;;;;;;;;4,0;;;1,0;;;;;;14,0;;;2,0;;;;;;;;;;6,0;;;;;;14,0;;;;;1,0;;;;;2,0;;;;1,0;;;13,0;;;;;;;;;36,0;;;;;;;3,0;;;;;;;;;;;;2,0;3,0;2,0;;;;;;1,0;;7,0;;;;;;;;6,0;;;14,0;2,0;;;;1,0;;1,0;;;;;;;;2,0;9,0;;;;;;;16,0;;;;1,0;;;26,0;;;;;;;;;;;;;;;;;2,0;;;;;1,0;;;;;;;;2,0;;;1,0;15,0;;;;;;;;;;;3,0;;3,0;;5,0;;;2,0;;;;;8,0;;;4,0;;;;;;;;;;;;;;;12,0;;;;;2,0;1,0;;;;;;;1,0;;;;;4,0;;;;1,0;;;;;;;5,0;;;;;;;;;;;;;;6,0;;;;2,0;;7,0;;;;;;;;;;8,0;;;;;;1,0;;;;1,0;2,0;;5,0;;;;;;;;;;;;;1,0;;;;;;;1,0;2,0;;;;;;;;;;;;;5,0;;;;17,0;;;;;;;;;;;;;;;;;2,0;;;;5,0;;;;;;;;;;;;7,0;;;;;;;;1,0;;;;;;;;;;;;;;;;;;1,0;;;;;;;;;5,0;;;;2,0;5,0;;;;;;;;6,0;1,0;;;;;;;;;;1,0;;;;;;;;;;;;;;;;;;;;;;;;;;
hollow;;;;;;;6,0;;2,0;3,0;;;3,0;;13,0;23,0;3,0;;;;;1,0;;5,0;;;;;;;;;3,0;;;;;;;;;;6,0;;;;;31,0;;;11,0;2,0;;;7,0;1,0;10,0;;;;8,0;2,0;;;;;;42,0;3,0;2,0;2,0;3,0;;;;4,0;;;;14,0;;3,0;;26,0;;;;;;;53,0;;;5,0;;;;;2,0;26,0;;;13,0;1,0;;;4,0;;;;3,0;;5,0;;;8,0;74,0;8,0;;;;;;;;;;;;3,0;;;;;;;;;;;;;;3,0;;;;1,0;;4,0;;;;;;2,0;;;3,0;2,0;;;5,0;;;1,0;;1,0;;;;;6,0;2,0;;2,0;13,0;22,0;;;10,0;71,0;;2,0;;8,0;1,0;;1,0;;1,0;;;29,0;;2,0;;;;3,0;42,0;;;1,0;;2,0;2,0;;;2,0;;;2,0;;;;7,0;;;40,0;45,0;;4,0;4,0;;7,0;;;7,0;;9,0;;;31,0;4,0;;;9,0;2,0;9,0;;;1,0;2,0;;;;;;1,0;6,0;;14,0;1,0;1,0;;34,0;;;;;;2,0;;10,0;;20,0;1,0;;;;;6,0;1,0;;;;17,0;25,0;36,0;;;;1,0;;;;;1,0;;;;;;5,0;;;;;2,0;9,0;;6,0;;;;;3,0;20,0;;;41,0;4,0;;5,0;;;;;8,0;38,0;;5,0;3,0;5,0;;4,0;;;;;;;;;;;7,0;;7,0;;;4,0;;;;3,0;4,0;4,0;3,0;1,0;4,0;;;6,0;;;;1,0;1,0;;1,0;;;9,0;5,0;;1,0;;;;;2,0;;;;19,0;;2,0;;;5,0;;20,0;;2,0;1,0;13,0;1,0;13,0;2,0;;;3,0;4,0;3,0;;;;;;;;8,0;;;;;;;;;;;;1,0;1,0;3,0;1,0;;;;;;;;;;;;;;;2,0;;;;;;;1,0;1,0;;;;;;;;;;;;;;;;;;;;;;;;;;;;;;1,0;;;;;;;;;3,0;1,0;;3,0;;;;;;;;;;;;;;;6,0;;2,0;;;;;;1,0;;;;;;;;;;;;;;;;9,0;;;;;;;;;;;4,0;;;;;;;;4,0;;;;;;;;;;;;;;2,0;;1,0;4,0;;;;;;3,0;;1,0;;;;;;;;7,0;1,0;2,0;4,0;;;;1,0;;;;;;;3,0;;;;;1,0;;;;;;;4,0;;3,0;;;;;;;;;;;3,0;1,0;;;;;;;;;;;2,0;2,0;;6,0;;;;;;;;;2,0;;;;;;;4,0;;;9,0;;;;;;8,0;3,0;10,0;;;1,0;;1,0;;;;;;;;;;;;;;;;;;5,0;;;;1,0;2,0;10,0;;;;;;;;;;;;;;1,0;;;;;;1,0;;;;;;2,0;;;7,0;;;;;;;;;;;;4,0;;4,0;3,0;4,0;;;;;1,0;;;;;;;;2,0;;;3,0;;;3,0;;8,0;;;;;;;;;;;;;;;;;;;;;1,0;;;;;;;;1,0;;;;;;;;;;;;;;;;;;;;;;2,0;;;;;2,0;;;;;;;;;;;;;;;;;;;;1,0;;;;;;;;;;3,0;;;;;;;;;;1,0;;;;;;;;;;;;;;;;;;;;;;;;;;;;;10,0;;;;1,0;3,0;;;;1,0;;;;;;;;;;;;;;;;;;;;;;;;;1,0;;;4,0;;;;;;;;;;3,0;;;;;;;;;;;;;;;;;;;;;;;1,0;;;;;;1,0;;2,0;;;;;;;;;;;;;;;;;;;;5,0;;;;;1,0;;;;;;;;;;;;;;;;;;;;;
illuminator;;;;;;;2,0;1,0;8,0;19,0;3,0;;28,0;;6,0;11,0;;;;;;5,0;;1,0;;;;18,0;1,0;;;;49,0;;11,0;9,0;;;;;2,0;;;3,0;2,0;3,0;6,0;5,0;;3,0;3,0;1,0;;;;;2,0;;;;1,0;;8,0;;1,0;;;4,0;;73,0;;;;;;;;46,0;17,0;18,0;;10,0;;12,0;;1,0;;;;;;;;;;1,0;;;7,0;;;;6,0;;;;12,0;;;;;2,0;;;;37,0;;16,0;1,0;2,0;;;2,0;2,0;2,0;;;;;;;65,0;10,0;;;;;2,0;;;5,0;;;8,0;;;;108,0;2,0;;;;;;1,0;;28,0;;;;1,0;;;;;;1,0;2,0;3,0;2,0;;;;3,0;;;14,0;;;;1,0;;;;;1,0;;6,0;;;;;;;;;;;;7,0;2,0;;;;;;;;3,0;;;;;;8,0;;;;;;;;;;;;;;19,0;;;;4,0;;;;;1,0;;;;;;;;;;;;;;;;;;;3,0;1,0;;;;;;10,0;;;2,0;;;;;8,0;;;;;;;1,0;45,0;2,0;;;;;8,0;;;;11,0;;;;;1,0;;;;;;;;;;;;;;;;;;;;;;;;;4,0;;;1,0;3,0;;;;;;;;;;7,0;2,0;1,0;;;;;;;;3,0;1,0;;;;3,0;;;3,0;;;;;;1,0;;;;2,0;1,0;;;2,0;;;;10,0;;;1,0;;;;2,0;;;;;;;;;;;;;1,0;;17,0;;;;;;;11,0;3,0;;;;5,0;;;;;1,0;;;;;;;;1,0;;;;;;1,0;;;;;;;;;;;;;;;;4,0;;;;;;;1,0;;;;;4,0;;;;;;;;;;2,0;;;;;;;;;;;;;;3,0;;;;;2,0;;3,0;;;;;;;;;;;3,0;;;2,0;;;3,0;;;;;;;;;;;;;2,0;;;;;;;;;3,0;15,0;;;;;;1,0;;;;;4,0;;;;;;;;;;;;;2,0;;;;1,0;;;;;;;;1,0;;;;21,0;;;;;;;;;;;;;;;;1,0;;;;;;;;;;;;;;;;;1,0;;;;11,0;;2,0;;;;;;;;;;;;;;;;;1,0;;;;;;;;;;;;;;;;;;;1,0;;;;;3,0;;1,0;;;;;3,0;;;;;;;;;;;;;;;;;;;;;;;;;;;1,0;;;;;;;;;;;;;;;;;;;;;;;;;;;;;;;;;;;;2,0;;;;;;;;;;;1,0;;;;;;;;;;;;25,0;;18,0;;;1,0;;;1,0;2,0;3,0;;;;;;;;;;;;;;2,0;;;;;;;;;;;;;;;;;;;;;;;;;;;;2,0;;;;;;;;;;;;;;;;;;;;;;;;;;;;;;;;;;;;1,0;;;;73,0;;;;;;;;;;;;;;;;1,0;;;;;;;;;;;;;;;;1,0;;;;;;;;;;;;;;;;;;;;;;1,0;;;;1,0;;;;;;;;;;16,0;;;;;;;;;;;;;;2,0;;;;;;;;;;;;;;;;;;;;;;;;;2,0;;;;;;;;;;;;;;;;;;;;;;;;;;;;;3,0;;;;;;;;;1,0;;;;;;;;;;;;;;;;;;;;;;;;;;;;
initialization;;;;;;;5,0;;;;;;;;;1,0;;;;;;;;;;;;;;;;1,0;9,0;;10,0;7,0;;;;;1,0;;;;7,0;1,0;34,0;3,0;1,0;1,0;;;;;50,0;;;;;;;;;;2,0;;4,0;1,0;;;1,0;;3,0;;;;;;;6,0;;;;2,0;;;1,0;;;;13,0;;;;;55,0;;;2,0;;2,0;;8,0;1,0;;;;1,0;4,0;;;18,0;;;;6,0;;1,0;;1,0;;;17,0;135,0;1,0;;;;;;2,0;;;;;;;8,0;3,0;;;;1,0;2,0;3,0;;;;12,0;;1,0;;;;;;4,0;;;;;13,0;81,0;;;;;;;;;;;;;10,0;;1,0;;;;4,0;;;;5,0;;;;;;;;3,0;;;;;;;;;;;;;;;;;;;9,0;;;;;;;;;;;;;;;;;;16,0;;;2,0;;;;;;;;;;2,0;;;;;;;;;;;;;2,0;;;;;;;8,0;;;;;;;;;;;;;14,0;;;;9,0;;;;;;;;;;;;;;;;;;;;1,0;;;;;;;;;;;;;;;1,0;;;;;;;;;1,0;;;;;;;;;;;;;;;;;;;1,0;;;;1,0;1,0;1,0;;;;;;;;;;;;;;;;;;;;;;;;;;;;;1,0;;;;;;;;;;;;;27,0;;;;18,0;;;;;;;2,0;;;;;;;;11,0;;;;;;;;;;;;;;;;;;;;;1,0;2,0;;;;;;10,0;;;;5,0;;;3,0;13,0;;;4,0;;;;;;57,0;;;;;2,0;;;;;;63,0;;;;;;;;6,0;;;;1,0;;;;;;;;;;;;;;;34,0;;;;;;;7,0;;;9,0;;;;;3,0;;;;;;2,0;;;;;;;;7,0;3,0;;;;;;;;;;;;;32,0;;1,0;;;;;;;;;;;;;;;;;;;;;1,0;;;;1,0;;;;;;;;;;;;;;;;;;;;;;;;;;;;;;;;;;;;;;;;;;;3,0;;;;;;;;;;;;;;;;;1,0;;;;;;;2,0;;;;;;;;;;;;;;;;;;;;;;;;;;;;;;;;;;;;;;;8,0;;;;;;;;;;;;;;;;1,0;;;;;;;;;;;;;;;;;;;;;2,0;;;;;;;2,0;;;;;;;3,0;;;;;;;;;;1,0;;;;;;;;;;;;;;;;;;;;;;;;;;;;3,0;;;2,0;;;;;;;3,0;;;;;;;;;;;;;;;;;;;;;;;;3,0;5,0;;;;;;1,0;;;;;;;;;;;;;;;;;;;;;;;;;1,0;;;1,0;;;;;;;1,0;;;;;;;;;;;;;27,0;;1,0;;;;;;;;;;;;;;;;;;;;;;;;;;;;;;;;;;;;;;;;;;;;;;;;;;;;;;;;;;;;;;;;;;;3,0;;;;;;;;;;;;;;;;;;;;;;;;;;;;;;;;;;;;;;;;;;;;2,0;;;;;;;;;;;;;;;;;;;;;;;;;;;;;;;;;;;;;;;
interpolation;;;;;;;1,0;8,0;;6,0;2,0;;;;;16,0;;;;;;2,0;;1,0;;;58,0;2,0;;4,0;5,0;;5,0;;3,0;;2,0;17,0;1,0;;17,0;2,0;;6,0;1,0;;37,0;25,0;;;;;;;;4,0;26,0;;1,0;;;;1,0;;6,0;;2,0;;2,0;;2,0;;9,0;;;3,0;;;1,0;57,0;;1,0;;19,0;1,0;;2,0;;;;8,0;;;;;1,0;1,0;;22,0;;1,0;;4,0;;;;;1,0;1,0;5,0;;65,0;2,0;;;3,0;;4,0;;;;;26,0;52,0;2,0;;;;;32,0;;;;;;;;;;;;;;4,0;6,0;2,0;;1,0;23,0;;1,0;;;1,0;7,0;;3,0;;;2,0;1,0;;52,0;;;;3,0;7,0;;;;;;2,0;;;;;;;;;;;;;;10,0;;;;;;;;;;;2,0;;7,0;;13,0;1,0;;;;;3,0;;;;;;;;;;2,0;;;;;;;;;;;;;;;;;;;;;;;;;;;;6,0;;59,0;;;;;;;;2,0;;;;;;;67,0;;;;;;;;;;;;;;16,0;;;;;;;;3,0;;;;;;;;;;;4,0;;;;;;;;;;;2,0;;;;;2,0;;;;;;;;;;;;;;;;;;;;;;;2,0;;;;;;;;;;;;1,0;;;;;;;;;;3,0;;;;;;;;;;;;;;;;;;;;;;;;;;;;;;;;;;6,0;;;;;;;;;;;;;;;;;;17,0;2,0;;;;;;;;;3,0;;;;;;;;;;;;5,0;13,0;12,0;;;;;;;;2,0;;;;;17,0;;;;;;;;;1,0;;;;;;;;;;;;;1,0;;;;;;;;;;;1,0;8,0;;;1,0;18,0;;;;;;;1,0;;5,0;;;;;;;;;;;2,0;;;;;;2,0;;;;;;;;;;;;;;;;;;;;;;;;;;;;;;;;;10,0;;9,0;2,0;;;;;;;;;;;;;;;;;;;;;;;1,0;;;;;;;;;;;;;;;;;;;2,0;;;;;;;;;;;;;;;;;;;;;;;;;;;;;;;1,0;;;;;;;;;;;;;;;1,0;;;;;;;;;;;;;;;;;;;;;;;;;;;1,0;;3,0;4,0;;;2,0;;;;;;;;;;;;;;;;;;;;1,0;;;;;;;;;;;;;;;;;;;;;;;;;;;;;;;;;;;;;7,0;;;1,0;;;;;;;;;;;;6,0;;;;;;;;;;;;;;;;;;;;;;;;;;;;;;;;;;1,0;;;;;;12,0;;;;;;;;;9,0;;;;;;1,0;;;;;;;;;5,0;;;;;5,0;;;;;;;;;;;;;;;12,0;;;;;;;;5,0;;;;;;;;;;2,0;;;;;;;;;;;;;;;;;;;;;;;;;;;;;;;;;;;;;;;;;;;;1,0;;;;;;;;;;;;;;;;;;;;;;;;;;;;;;;;;;;;;1,0;10,0;;;;;;;;;;;;;;;;;;;;;;;1,0;;8,0;;;;;6,0;;;;;;;;;;;;;;;;;;;3,0;;;;7,0;;;;;;;;;;;;;;;;;;;;;;;
joint;;;;;;;2,0;7,0;;9,0;;;2,0;2,0;6,0;9,0;;;;;;1,0;;;;;;3,0;;;;;17,0;;2,0;;;3,0;;;7,0;2,0;2,0;1,0;;;;16,0;;10,0;11,0;2,0;;;;;10,0;;;;25,0;1,0;12,0;1,0;;;;17,0;2,0;6,0;;;2,0;2,0;;9,0;;;;11,0;;4,0;;46,0;2,0;2,0;;;;3,0;2,0;;;;;;1,0;;9,0;;1,0;;2,0;2,0;;;15,0;;1,0;;10,0;3,0;;;;24,0;15,0;25,0;4,0;2,0;;;1,0;5,0;;;;;;1,0;;;2,0;;;;3,0;;;;;;7,0;3,0;;;;26,0;4,0;;;;1,0;;;;10,0;;;;;2,0;11,0;;1,0;;1,0;;;;;;12,0;;;;3,0;;;;;7,0;3,0;2,0;;3,0;;7,0;;;1,0;;5,0;69,0;;3,0;;;;;1,0;;;3,0;;;;;;10,0;;;;;;;;;;8,0;1,0;;1,0;;;33,0;;;19,0;;22,0;;32,0;13,0;2,0;1,0;3,0;6,0;;1,0;;;;1,0;;;;;;3,0;36,0;;4,0;1,0;;;10,0;;;;;;1,0;;;;;;1,0;;10,0;1,0;;;;1,0;;7,0;29,0;7,0;;;;1,0;;;2,0;;;;4,0;;1,0;;;7,0;;;3,0;;;5,0;23,0;2,0;127,0;2,0;;;4,0;;;;;;;;;1,0;;1,0;;;;14,0;;;3,0;;;;1,0;;1,0;;;;;;1,0;10,0;;;1,0;;2,0;7,0;5,0;;2,0;;;2,0;;;;162,0;;3,0;;6,0;;;;1,0;;10,0;;;;;;;;;;;1,0;5,0;7,0;8,0;3,0;;;14,0;;;;;;16,0;;;;;2,0;;;;;;;;;1,0;;;;6,0;;;1,0;;;;;;;;;;;;;;;;;;;;;;16,0;;2,0;;;;;;;2,0;;;;;;;2,0;;9,0;;;;;;;;;;2,0;;;;;10,0;;;;2,0;;;;;2,0;;;8,0;;;12,0;;;7,0;;;;;;;;;;;;1,0;;;;;4,0;;;;;;3,0;;;;;;;;;;4,0;;;;;;5,0;1,0;;;;;;4,0;;;;3,0;;;;;;;;;;;;;1,0;;;;;;;;;;;4,0;5,0;;;2,0;;;;;;2,0;;;;;;;;1,0;;;;;;;;;;;;;8,0;;;;;;;4,0;;;5,0;;4,0;;1,0;;;8,0;;;;;9,0;;27,0;;;;;;;;;;;;;;3,0;;;1,0;;;;;;;;2,0;;;;;;;;;;;;;;;;;7,0;5,0;;;;;6,0;;;;;4,0;;8,0;;;2,0;4,0;;1,0;;;;;14,0;;5,0;1,0;9,0;16,0;;;;19,0;;;;;;;;1,0;;;1,0;;31,0;11,0;;;14,0;10,0;;;;113,0;;;;1,0;;;;20,0;;;;;;;3,0;;;;;;;;2,0;;;;;;;;;;;;;;;;;;4,0;;;2,0;16,0;;;;;;;;;;;;;;;;;;;;;2,0;;;;;;;;3,0;;;;;;;;;;4,0;;;;;;;;;;;;;;12,0;;;;;;;;;;;;;;;1,0;;;;;;;;;;;;;;4,0;51,0;;;;;;;;;;;;;;;;;;;;1,0;;;;;;;;;;;;;;;;;;;;13,0;;4,0;5,0;;;;;;;;;;;;;;;;;;;;;;3,0;;2,0;3,0;;;;;;;;;;;;;;4,0;;;9,0;;;;;;;;;;3,0;;;;;;;;;;;;;;;;;;1,0;;;;;;;;;;;;;;;;;;;;;;;;;;;;;;;;;;;;;;;;;;;;;;;;;
metal;;;;;;;5,0;20,0;1,0;7,0;5,0;;4,0;;2,0;2,0;;;;;;3,0;;2,0;;;;5,0;;;;;5,0;;;2,0;;;2,0;;;;12,0;;;1,0;;37,0;3,0;;31,0;3,0;;;3,0;2,0;21,0;;;;6,0;10,0;1,0;;6,0;;3,0;86,0;46,0;1,0;1,0;;7,0;;;40,0;;;;28,0;;25,0;;36,0;;;4,0;;;16,0;59,0;;;41,0;;;;;19,0;1,0;;;69,0;;;;41,0;3,0;2,0;;2,0;4,0;5,0;;2,0;20,0;33,0;4,0;;3,0;;;4,0;;;;;;;2,0;;3,0;;4,0;;;1,0;;1,0;;;;;48,0;;;5,0;22,0;5,0;5,0;;14,0;;;;;7,0;;;;1,0;;13,0;;1,0;;;;;2,0;;3,0;6,0;4,0;;4,0;14,0;1,0;22,0;;18,0;9,0;8,0;2,0;1,0;10,0;22,0;27,0;;3,0;1,0;;5,0;23,0;2,0;17,0;;;1,0;83,0;;1,0;;6,0;;3,0;;;;5,0;47,0;2,0;;;18,0;24,0;;21,0;4,0;12,0;63,0;;4,0;;;1,0;116,0;;35,0;1,0;67,0;;1,0;43,0;;;6,0;7,0;1,0;25,0;1,0;2,0;2,0;3,0;;;;4,0;2,0;3,0;65,0;;1,0;6,0;;;13,0;2,0;1,0;;;6,0;2,0;6,0;38,0;;6,0;38,0;;1,0;;8,0;1,0;2,0;;9,0;;109,0;26,0;48,0;;;12,0;4,0;1,0;1,0;;;;8,0;;3,0;;1,0;46,0;;;;17,0;6,0;12,0;;15,0;;23,0;2,0;;5,0;13,0;;;4,0;8,0;;1,0;;;18,0;;13,0;;;1,0;;;;4,0;12,0;2,0;;;3,0;3,0;2,0;;;10,0;2,0;3,0;35,0;;;3,0;1,0;3,0;;1,0;;1,0;3,0;;2,0;;7,0;;;;;;;;4,0;12,0;1,0;6,0;;;2,0;1,0;;;;;;;3,0;1,0;;1,0;;8,0;;;4,0;57,0;;8,0;;;30,0;3,0;;;2,0;;;;;9,0;2,0;;;;1,0;;;;;1,0;;;;;;;;6,0;;;;;;1,0;;;1,0;;;;;;;1,0;2,0;;;;;;;;;;;;;;;;;;;;;;;;;;;;;;;;;;;;;;;;;;;;;2,0;3,0;;5,0;;4,0;;;;;;;;;1,0;;;;;;;;;;;;;;;;;;;;;;;;;;;;;;;;;;;11,0;;2,0;;;1,0;8,0;;;;;;7,0;;1,0;;4,0;;;;;;;;1,0;6,0;;;5,0;;1,0;22,0;2,0;;1,0;;;1,0;;;;;;;;2,0;;;;7,0;10,0;;;;;;;;;;;1,0;;;;;11,0;;;;;2,0;;1,0;;;;;39,0;;1,0;;;;;5,0;;;;;5,0;;;4,0;;;;;;5,0;;;;;;;3,0;;;;;;;;;;;;2,0;;10,0;;;;;;;;4,0;;;;;;;;3,0;8,0;;;;;2,0;;4,0;;;;;;;1,0;7,0;;;;2,0;;;;;5,0;;;2,0;;;;;;;6,0;2,0;1,0;;;;;;;;;7,0;;;;;;;;;;;;4,0;;;9,0;5,0;8,0;;;;;;20,0;;;;2,0;5,0;;;;4,0;;;;13,0;;;1,0;;;;;2,0;2,0;1,0;4,0;1,0;;;;;;;;;;;3,0;;;4,0;;;;;;;1,0;1,0;;;;;;;;;;;;;3,0;;;;;;4,0;;;;1,0;;;;;;;15,0;;;;;;;;;;;;;1,0;;;;;;;;;;;;;;;;;;;;;1,0;;;;;;;;;;;;;;;;;;;;;;;;;;;;;;;;;;;;;;1,0;;;;;;;;;;;;12,0;1,0;;;;3,0;;;;;;;;3,0;;;;;;;;1,0;;;;;;;;4,0;2,0;2,0;;;;;;;;;;;;;;;;;;;;;;;;;5,0;;5,0;;;;4,0;1,0;;;;;;7,0;;;;;;1,0;;;;;1,0;;;;;;;;;;;;;;;;;;;;;;;;;;
mold;;;;;;;2,0;18,0;1,0;3,0;9,0;;;;2,0;14,0;;;;;;;;;11,0;;;4,0;1,0;;;;2,0;;;;;;1,0;;;2,0;1,0;;;;;7,0;1,0;3,0;17,0;;;1,0;5,0;;20,0;;;;1,0;;;;;;;64,0;12,0;6,0;;;;;;;;;;5,0;;2,0;;34,0;3,0;;;;;;130,0;;;39,0;;;;;48,0;;;;24,0;;;;11,0;;;;;4,0;;;;8,0;44,0;11,0;;;3,0;;8,0;2,0;;;;;;;;;2,0;1,0;;;1,0;;;;;;;4,0;;;;3,0;1,0;;;1,0;;;2,0;;1,0;;;4,0;;;28,0;;;;;;;;;;3,0;3,0;;4,0;10,0;6,0;;;4,0;10,0;;3,0;;11,0;2,0;11,0;;;;11,0;2,0;3,0;;2,0;;;13,0;17,0;8,0;;;;;;1,0;;;2,0;;1,0;;7,0;5,0;;;;1,0;28,0;28,0;;6,0;1,0;;;5,0;;12,0;3,0;23,0;13,0;;1,0;1,0;;;7,0;1,0;8,0;1,0;3,0;;;;;;;;;4,0;;;;7,0;;1,0;;;;;36,0;;1,0;;;11,0;;;;;1,0;2,0;6,0;;4,0;;19,0;63,0;51,0;;;9,0;;;1,0;;;1,0;3,0;1,0;;;1,0;1,0;;1,0;;;;;;4,0;;;;2,0;;10,0;;;;4,0;;;;;14,0;;4,0;;4,0;;2,0;2,0;;;;;;;2,0;;;1,0;;;3,0;11,0;12,0;3,0;;25,0;5,0;;;;;;3,0;;;;4,0;;;;;;;17,0;;2,0;;;;;9,0;3,0;;;;;;;;;;;;;;;;;;;;;2,0;3,0;;;6,0;2,0;;;;;;;;;;;;;;;;;;;;;;;;;;;;;;;;;;;;;;1,0;;;;;;;;;;;;;;1,0;;;;;;;;;3,0;;;;;;;;;;;;;;;;;;;;;;;;;;14,0;;;;;;;;;;;;;;;;;;1,0;;;;;;;;;;;;1,0;;;;;;;;;;;;;;;3,0;7,0;;;;;;4,0;;;;1,0;;;;1,0;;;;13,0;;;;;;;;;;1,0;;;;4,0;3,0;1,0;;;;;;;;;;;1,0;;;;;1,0;;;;2,0;;;;;;;;;;;;10,0;;;;;;;1,0;;;;;3,0;;;;;1,0;;4,0;;;;;1,0;;;;;;;;;1,0;;;;;;;2,0;;;;;;;;;;;;;;2,0;;;;;;10,0;;;;2,0;2,0;;;;;;;;8,0;;4,0;;;;;;;;;;2,0;;;;;1,0;;;;13,0;;9,0;;;;;;;1,0;;4,0;;;;;;;;;;;;;;;3,0;;;;;;;;1,0;1,0;;;1,0;1,0;;;;;;;;;;1,0;5,0;;1,0;;;;;;;;;2,0;;;;;9,0;;;;;;;;;;;;;;;;;;1,0;;;;;;;;;;;;;;;;;;;;;;;;;;;;;;;;;16,0;2,0;;;;;;;;;;;;;3,0;;;;;;;;;;;;;;;;;;;;;;;2,0;;;;;;;;;;;2,0;;;;;;;;;;1,0;;;;;;;;;;;;3,0;;;;;;;;;;4,0;;;;;;;;;;;;;;3,0;;;;;;;;;;;;;;;5,0;;;;2,0;;;;;;;;;;;;;;;;;;;;;;;;;;;;;;;2,0;;;;;;;;;;;2,0;;;;;;;;;7,0;;;;;2,0;;;;;;;;;;;;;;;;;;;;;;;;1,0;;
moveable;;;;;;;3,0;;3,0;6,0;;;2,0;;35,0;28,0;1,0;;;;;1,0;;;;;;3,0;;;1,0;;23,0;;2,0;;;;;;1,0;;12,0;;14,0;;4,0;9,0;3,0;14,0;9,0;8,0;;;10,0;;11,0;2,0;2,0;;13,0;3,0;18,0;;2,0;;3,0;8,0;136,0;4,0;;;;;;1,0;;;1,0;52,0;;2,0;;16,0;;3,0;;;2,0;;53,0;;;;;;;;3,0;;;;22,0;;;;6,0;;1,0;;;;;;;5,0;48,0;66,0;;4,0;;;2,0;;3,0;;;;;1,0;;;21,0;;;;;4,0;;;;;;33,0;;;1,0;38,0;2,0;;;;;;;;16,0;;1,0;;1,0;;9,0;;;;;;;;2,0;;;;;2,0;50,0;3,0;;;5,0;6,0;;;;6,0;;;;;;;;31,0;;2,0;;;2,0;1,0;;;;11,0;2,0;11,0;;;;5,0;;;11,0;;;;10,0;;;10,0;1,0;;3,0;;;;;2,0;5,0;;227,0;;6,0;30,0;5,0;15,0;15,0;4,0;4,0;11,0;;;;2,0;;;;;1,0;16,0;21,0;;3,0;2,0;;2,0;71,0;;;;36,0;;3,0;;;;;;;;;4,0;25,0;;;3,0;;;4,0;19,0;;;1,0;;;;;2,0;;;1,0;12,0;4,0;;2,0;;;;8,0;;13,0;;18,0;;;;;;2,0;;;2,0;;;3,0;;;;;5,0;;;;;31,0;;7,0;3,0;;;;;;;;;;28,0;;3,0;3,0;2,0;;;;4,0;5,0;2,0;4,0;;;4,0;;;6,0;3,0;1,0;1,0;2,0;;;;;;3,0;;;6,0;;;;1,0;;;;;;3,0;11,0;;;1,0;;1,0;;;14,0;;;31,0;;5,0;;;;3,0;6,0;;;;;;;1,0;;;;;;;1,0;;;;;1,0;;;;;;1,0;;;;;;;;;;;;6,0;;;;;;;;;3,0;;;;;;;;;;;;;6,0;;;;;;;;;;5,0;;;;5,0;;1,0;;;4,0;;;;2,0;;2,0;;;2,0;;;;;;;;;;1,0;;;;;3,0;;7,0;;;;;;;;;;;2,0;;;;;;;;;;1,0;;;;;;;;;;;;2,0;;;;;1,0;;;7,0;;;;;;;;;;;;;;;;2,0;;;;;;;;;;;;;;;;;;1,0;;;;;;;;;2,0;;;;;;;;;;;;;;;;2,0;;1,0;;;;;;;;1,0;;;5,0;;;;;;;;;;;;;1,0;;;;;;;;;;;3,0;;;;;;;;;2,0;1,0;;2,0;;;;;3,0;;;;;3,0;2,0;;;;;2,0;;2,0;;;8,0;;;;;;;;5,0;;2,0;;2,0;1,0;;;;;;3,0;;;1,0;;;;;;3,0;2,0;;;;;;;;;5,0;;1,0;;;4,0;;;;2,0;;;;3,0;;;;7,0;;;1,0;2,0;;;;;;;;;;;;;1,0;1,0;;;;;;;;;;1,0;;;;;;;;;;;;;;;;;;2,0;;;;;;;;;;;3,0;;;;;;;;;;;1,0;;;;;;3,0;;;;;;;;;;3,0;;;;;;;;;;;;;;;;;;;;;1,0;;1,0;;;2,0;1,0;;;;1,0;;;;;;;;;;;;;;;;;;;;;;;;;;;;;;;;3,0;;;;;;;;;1,0;;;;;;;;;;;;;;;;;;;;;;;;;;21,0;;;;;2,0;;;;;;;;;;54,0;;;;2,0;;;;;;;;19,0;;;5,0;;;;;;;;19,0;;;;5,0;;;;;1,0;;;;;;;;;;;;;;;;;;;;;;;;;;;2,0;;;;;;;;;;;;;;;;;;
opaque;;;;;;;15,0;18,0;8,0;3,0;3,0;;4,0;;;3,0;9,0;;;1,0;4,0;6,0;;3,0;;;6,0;;;;;;1,0;;1,0;;;;;;;;11,0;5,0;5,0;;2,0;11,0;;11,0;19,0;1,0;;;;;4,0;;1,0;;4,0;1,0;;;9,0;2,0;;24,0;;2,0;;1,0;;;1,0;1,0;;23,0;2,0;30,0;4,0;6,0;;27,0;;;;;1,0;;9,0;;;28,0;;1,0;;;22,0;;1,0;;9,0;8,0;;;9,0;;;;1,0;;;;;19,0;49,0;6,0;;2,0;15,0;;;;;;;;;;;;10,0;;;;1,0;17,0;;;;;;7,0;;;;7,0;1,0;;2,0;1,0;;;;;6,0;;;;;;4,0;;;;;4,0;2,0;;;;;9,0;;1,0;4,0;;;;1,0;;;2,0;3,0;2,0;2,0;;;;;;;;;;;;;7,0;;;;4,0;;;;;;3,0;;;;;17,0;;;1,0;;13,0;27,0;;1,0;;;1,0;70,0;;30,0;;18,0;1,0;2,0;2,0;6,0;;;22,0;;2,0;1,0;26,0;4,0;;;;;;7,0;;1,0;;;;;;1,0;;2,0;;;;2,0;1,0;2,0;;;1,0;;;4,0;3,0;;6,0;;;;1,0;11,0;37,0;13,0;;;;;2,0;;;;52,0;;;;;10,0;;;;;;;11,0;;;3,0;;;;;9,0;;;;;;;;;;3,0;;;;;;;;;;;;;;;;;;;;;;;;1,0;;;;;1,0;;1,0;;;;;;1,0;5,0;;;;1,0;;;;;;;;;;;;;;;;2,0;;;;;1,0;;;;2,0;;;;4,0;4,0;;;;3,0;;;11,0;;;;;;;;;;;;;1,0;;;;;1,0;;;;;;3,0;;;;;;;;;;;;;;;2,0;;;;;1,0;;;;;;;4,0;;;;;;;;;;;;4,0;;;;;;;;;;1,0;;;2,0;;;;;;2,0;2,0;;;;;;;;3,0;;1,0;;;;4,0;;;;;;;;;;;;;;;;;;1,0;;;1,0;;;;;1,0;;;;;;;;;;;;2,0;;;;;1,0;;;;;;;;;1,0;;;;;;;;;;;;;;;;2,0;1,0;;;;;;;;;;;1,0;;;;;;1,0;;;;;;;;;;;;;;;;;;;2,0;;;;;;;6,0;;;;;;;;;;;;;;;;;;;30,0;;;;;;;2,0;;;;;;;;;2,0;;;;1,0;;2,0;;;;;;;;;;3,0;1,0;;;;1,0;;;;;;;;;;;;;;;;;;;;;;;;;;3,0;;;;;;1,0;2,0;;;;;;;;;;;;;;;;;;;;;;;;;;2,0;;;;3,0;;;3,0;39,0;;;;;;;;;;;;;;;;;;;;;;;;;;;;;;;;;;;;;;;;;;;;;;;;;;;;;;;;;;;;;1,0;;;;;;;;;;;;;;;;;;;;;;;1,0;;;;;;;;;;;;;;;;;;;;;;;;;;1,0;;;;;;;;;;;;;;;;;;;;;;;;;;;;;;;;;;;;;;;;1,0;;;;;;;;;;;;;;;;;;;;;;;;4,0;;;;;;;;;;;;;;;;;;;;;;;;;;;;;;;;;;;;;;;;;;;;;;;85,0;;;2,0;;;;;;;;;;;;;;1,0;;;;;;;;;;;;;;;;;;;;;;;;1,0;;;;;;;
optics;;;;;;;1,0;2,0;3,0;9,0;2,0;;6,0;;13,0;1,0;3,0;;;;;5,0;;12,0;1,0;;;;1,0;5,0;2,0;2,0;12,0;;;2,0;;;;;1,0;;;;4,0;2,0;;12,0;1,0;;3,0;3,0;;;;;26,0;;;;;;3,0;;1,0;4,0;6,0;22,0;2,0;2,0;;9,0;4,0;;;;;2,0;6,0;41,0;;35,0;;30,0;;;;;;2,0;17,0;;;;;;2,0;;16,0;3,0;;;2,0;12,0;18,0;2,0;34,0;;1,0;;8,0;2,0;;;;14,0;1,0;3,0;;;;1,0;;1,0;5,0;;;;1,0;;6,0;;;;1,0;;2,0;2,0;3,0;;6,0;;;30,0;;;;;7,0;;;19,0;;;1,0;2,0;27,0;;4,0;5,0;;;12,0;;4,0;;3,0;;;;2,0;;;1,0;;;14,0;;;;1,0;3,0;;;;;;;;;;;;1,0;;;;;;5,0;2,0;1,0;;;;;;;;7,0;;;;;;;;;;1,0;10,0;2,0;;;;1,0;;1,0;59,0;;2,0;;3,0;7,0;2,0;6,0;5,0;7,0;1,0;;1,0;;3,0;17,0;;;;;3,0;2,0;;;;;2,0;1,0;24,0;8,0;;4,0;;;7,0;;;;1,0;;;;2,0;4,0;;;2,0;;;2,0;11,0;15,0;;;;;;2,0;;1,0;1,0;1,0;;;1,0;4,0;;2,0;;;;;4,0;;1,0;;;;;;;;;;;1,0;;;;;;3,0;;;2,0;;;1,0;;;;;;;;;5,0;;;3,0;1,0;;;;;;;;;;;;;2,0;;;;;;5,0;2,0;2,0;;;;;;;;;;;;;;;;;2,0;1,0;;;1,0;;;;;3,0;;;;2,0;;9,0;;;;2,0;;;3,0;;;;;3,0;;;;;;;;3,0;;;;;;;;;;;13,0;;;;;;;;;;3,0;;;;;1,0;;;;3,0;24,0;;;2,0;5,0;;;;;;;;1,0;4,0;;;;;;1,0;;;1,0;;;;2,0;;;;;;2,0;;;;;;;2,0;;2,0;;;;;;;;4,0;;;;;;;1,0;;2,0;;1,0;;;;;;1,0;;;;;;;;;;;;;;;1,0;;;;;;;;;;1,0;;;;2,0;;;;2,0;;;;2,0;;;;;;;;;;;;;;;;;;6,0;;;;2,0;;;;;10,0;;;;3,0;;;2,0;;;;;;;;;;;;;;2,0;1,0;;;;12,0;;1,0;;2,0;;;;;;;;1,0;;;;;;;;;;;;1,0;;;;3,0;;;;;;;4,0;;;;;;;;;;;;;;4,0;;;;;;;1,0;;;;;;;;;2,0;;;;;;;3,0;3,0;;;;;;;;;;3,0;;;;;;;;;;;;;;1,0;1,0;;;;;;1,0;;;;;;;7,0;;;;2,0;;;;;;;;12,0;;;;;;;2,0;;;;;;;3,0;;2,0;;;;;;;;2,0;;;;;;1,0;;;;2,0;;;;;;;;;;;;;;;;;;;;;;;;;;;;;;;1,0;;;;;;;;;;;;;1,0;;;;;;;;;;;;;;;;;;1,0;;;4,0;;1,0;;;;;;;;;7,0;;;;;;;;;;2,0;1,0;;;;;;;;;;;;;;;;;;;;;;;2,0;;;;;;;;;;;;;;4,0;;;;;;;;;;1,0;;;;;;;;;;1,0;6,0;;;;;;;;;;;;1,0;;9,0;;;;;;;;;;;;4,0;;;;;;;;;;;;;;;;;;;;;;;;;;3,0;;1,0;;;;;;;;;;;;;;;;;;;;;;;;;;;;;;;;;;;;;;;;;;1,0;;;
passage;;;;;;;4,0;;4,0;5,0;;;1,0;;5,0;2,0;;;;;;;1,0;25,0;;;;;;;;;27,0;;7,0;;;;;1,0;;;18,0;;2,0;;3,0;3,0;1,0;1,0;7,0;;;;;;2,0;;;;23,0;5,0;1,0;;6,0;;;5,0;;3,0;;;6,0;2,0;;;;;;5,0;;;;9,0;;;;;1,0;;2,0;;;;;2,0;;;3,0;;;;2,0;2,0;2,0;;2,0;1,0;;1,0;12,0;;;;;11,0;5,0;3,0;;6,0;2,0;;;;;;;;1,0;;;;;;;;;1,0;;;;5,0;;2,0;;;;3,0;1,0;6,0;2,0;3,0;;2,0;;9,0;1,0;;;;;;2,0;;;;;;;3,0;;;;;;;11,0;;;;;4,0;;4,0;;;;;;;;;;;;;;;;;;;;2,0;;;;;;1,0;;;;;;1,0;;;4,0;1,0;4,0;6,0;;;1,0;;;;19,0;;6,0;;1,0;;;2,0;1,0;11,0;1,0;;;;;2,0;;;;;;;5,0;;2,0;;;;11,0;;;;;;;;;;7,0;;1,0;;;2,0;8,0;;;;;;;;4,0;;;;;6,0;;2,0;;;2,0;;;;8,0;36,0;;;5,0;;;18,0;2,0;1,0;;;2,0;10,0;;;;;;1,0;;;;1,0;;;;;;9,0;;;2,0;1,0;;2,0;;;;10,0;;;;6,0;;;8,0;;;;1,0;;2,0;1,0;;;4,0;;;;;;;;;;;;;;;4,0;;6,0;1,0;;;2,0;2,0;;;;4,0;;;;;;;1,0;;;2,0;;;4,0;2,0;;;;;;;;2,0;1,0;;;;2,0;;;;;;;;;;;;;;;;;;;;;;;;;;;;;;;;;;2,0;;;;1,0;2,0;;;2,0;;;2,0;1,0;;;;;;;;;;;;;;;;;;;;11,0;2,0;1,0;;;;;;;;6,0;;2,0;;;;;;;;4,0;;;;;;;;;10,0;;;;;;;;;;;;;2,0;;;;1,0;;;;;;;10,0;;;;;;;;;;;2,0;;;3,0;;;2,0;;;;;;;;;;;;;;;;;;;4,0;;;2,0;;;;;;;;;;;;;;;;1,0;;3,0;1,0;;;;;;;;7,0;;;;;;2,0;;;;;;;;;;;;;;;;4,0;;;;;;;;;;;;;;;;;;;;;;;;;;;;;2,0;;;;;;;;7,0;;;;2,0;;1,0;;;;;;;;;;;;;;;;;;;;;;;;;;;;;;;;;1,0;;;;;;;;;;;;;;;;;;;;;;;;1,0;;;5,0;;;;1,0;;;;5,0;;;;1,0;;;;;;;5,0;;3,0;;;;;;;;;;;;;;;;;;;;;;;;;;;;;;;;;;;;;;;;;5,0;;;;;;;;;;;;;;;;;;1,0;;;;;;;;;;;;;1,0;;;;;;;;;;;;;;;;;;;;;;;;;;;;;;;;;;;;;;;;;;;;;;;;;;;;;;;;;;;;;;;;;;;;;;;;;;;;;;;;;;;;;;;;;;;;;;;;;;;;;;;;;;;;;;;;;;;;;;;;;;;;;;;;;;;4,0;;;;;;;;;;;;;;4,0;;;;;;;;;;;;;;;;;;;;;;;;;;;;;;;;;;;;;;;;;;;;;;;;
priority;;;;;;;9,0;;2,0;;;;11,0;;;20,0;;;;;;6,0;;;;;1,0;;;;;;2,0;;2,0;;;;;;26,0;1,0;;;;;21,0;10,0;2,0;4,0;;2,0;;;;;;;4,0;;;3,0;2,0;;;;;;;;12,0;;4,0;;;;4,0;;1,0;31,0;;;;;;3,0;;;;1,0;;;2,0;;;;1,0;;8,0;;;;2,0;25,0;;;;12,0;3,0;1,0;;1,0;;;;9,0;;1,0;;5,0;;;1,0;8,0;;1,0;;;1,0;;;;7,0;;;;3,0;;;10,0;;;;;5,0;;;;3,0;3,0;;;;;;;6,0;;;;3,0;7,0;20,0;;;;11,0;2,0;;;;;;;;;;;;;;;;;;;;;;;;;;1,0;;;;;;;;;;2,0;;;;;2,0;;;;;;;;;;;;;;;;;;;;;;;;;;;;;;;;;;;;;;;;;;;;;;;;;;;;;;;2,0;;;;;;;;2,0;1,0;;;;;;;;;;;;;2,0;;;;;;;;;;;1,0;;;;;;;;;;;;;;;;;;;;;;;;;;;;;;;;;;;;;;;;;;;;;;3,0;;16,0;;;;;;;;;;;;;5,0;;2,0;;;;;;;;;;;;;;4,0;1,0;;;;;;;;;;;;;;;;;;;;;34,0;;;;;;;1,0;;;;;;1,0;;1,0;;;;1,0;;;;;;;;;4,0;;;2,0;1,0;;4,0;;;4,0;;;;2,0;2,0;7,0;;;;;;18,0;;3,0;;;;;;;1,0;5,0;;;;;;;;;;;;;;2,0;15,0;;;;1,0;5,0;;;;;1,0;;;;;;;;;;;;;1,0;1,0;;;;;1,0;;;;;1,0;;;;;;;;;;;;;;;;;;;;;;;;;5,0;2,0;;;;1,0;3,0;;;;;;;;;;;;;2,0;;;;;;;;;;;;;;;;;;;;4,0;;;;;;;;;;;;;;;;;;;;;;;;;;;;;;5,0;;;;;;;;2,0;;;13,0;1,0;;1,0;;;;;;;;;;;;3,0;2,0;;;;;1,0;;;;;;;5,0;;;;;;1,0;;;;;;;;;4,0;2,0;;;;;1,0;;;;;;;;;;8,0;;;;;;;;;;;;;;;6,0;;;;;;;;;1,0;;;;;;;;;;;;;;;;;;;;;;;;;;;;;;;;;;;;;;;;;;;;;;;;;;;;;;;;;;;;;;;;;;;;;;;;;7,0;;;;;4,0;;;5,0;1,0;;;;;5,0;;1,0;;;;;;;3,0;;;;;;;;;;;;;;;;1,0;;;;;1,0;;1,0;;;;;;;;;;;;;;2,0;;;;;;;;;;;;;;;;;;;1,0;;;;;;;;;;;;;;;;;;1,0;;;;;;;;;;;;;;;;;;;;;;;;;;;;;;;;;;;;;;;;;;;;;;;;;;;;;;;;;;;;;;;;;;;1,0;;;;;;;;;;;;;;;;;;;;;;;;;;;;;;;;;;;;;;;;;;;;;;;;;;;;;;;;;;;;;;;;;;;;;;;
probe;;;;;;;2,0;;2,0;;2,0;;3,0;;4,0;5,0;;;;;;3,0;;;;;;;;;;;2,0;;;;;;2,0;;;;;;1,0;;2,0;8,0;;1,0;;2,0;;;8,0;;;;;;;;;;;;;5,0;;;1,0;;1,0;;;;;;7,0;9,0;;;;;;;;;;1,0;12,0;;;;;;;;2,0;;1,0;;2,0;;5,0;;2,0;;1,0;;;1,0;;;;;7,0;24,0;;;;;;;;;;;;3,0;;1,0;8,0;;;;;;;;;;;6,0;1,0;;;;4,0;1,0;;;;;;;1,0;;;;;3,0;;;;;2,0;1,0;;;;;;;;;5,0;;;;2,0;2,0;;;;4,0;;;;;;;;5,0;;4,0;;;;4,0;;;;2,0;2,0;;;;;;;;;;;;;;;;1,0;;;;;1,0;;;6,0;;5,0;;;10,0;;7,0;1,0;2,0;;5,0;;;;;;;;;;;;;;;;;1,0;;;;;;;;;;1,0;;;;8,0;1,0;4,0;;;2,0;;;;1,0;;;3,0;;;;;;;2,0;;2,0;;;;;;;;;3,0;1,0;2,0;;;;;;;;;5,0;;;2,0;;;;2,0;;;;5,0;5,0;;;4,0;;;;;;;;;;;;;;;;1,0;;;1,0;4,0;1,0;;2,0;;2,0;;;;;;1,0;;;;;;;;;;;;1,0;;;;;;;1,0;;1,0;4,0;;;;6,0;;;;6,0;;;1,0;1,0;;;4,0;;;;;;;;1,0;4,0;;;;1,0;;;;;;;;;;;;;;;;;;;;;;;;;;;;;;6,0;;;;2,0;2,0;;;;2,0;;;;;;;;;1,0;;;;;;;;1,0;;;;;;5,0;;;;1,0;;;;;;;;;;;3,0;;;;1,0;;;;;;;;;;;;2,0;;;;;;;;;;;;;;;;;;;;;;;;2,0;;;;;;;;;;;;;;;;;;;;;;;;;;;;;;;;;;;;;4,0;;;;;;3,0;;;;;1,0;;;;;;;;;;;;;;;;;;;;;;;;;;;;;;;;;;;1,0;;;;;;;;;;;;;;1,0;;;;;;;;;;;;;;;;4,0;;;;;;;;;;;;;;4,0;;;12,0;;;;;;1,0;;;;;;;;;;;;;;;;;;;;1,0;;29,0;;;;;;;;;;;;;;;;;;;;;;;;;;2,0;;;;;;;;;;;;;;;;;;;;;;;;;;;;1,0;;;;2,0;;;2,0;;;;;;;;;;;;;;;;;;;;;;;;;;;;;;;;;;;;3,0;;;;;;;10,0;;;;;;;;;;;;;;;;;;;;1,0;;;;;;;;;;;;;;;;;;;;;;;;;;;;;;;;;;;;;;1,0;;7,0;;;;;;;1,0;;;;;;4,0;;;;;;;;;;;;;;;2,0;;;;;;;;;;;;;;;;;;;;;;;;;;;;;;;;;;;;;;;;9,0;;;;;2,0;;;;;;;;;;;;;;;;;;;;;;;;;;;;;;;;;;;;;;;;;;;;;;;;;;1,0;;;;;;;;;;;;;;;;;;;;;;;;;;;;;;
protrude;;;;;;;4,0;6,0;2,0;4,0;;;;;9,0;48,0;;;;;;5,0;1,0;1,0;;;;;;;1,0;;3,0;;2,0;;;;;;;;25,0;;3,0;;1,0;24,0;;4,0;26,0;6,0;;;4,0;21,0;23,0;;;;19,0;5,0;3,0;;10,0;;5,0;35,0;6,0;23,0;2,0;;;;;2,0;;;1,0;15,0;;12,0;;48,0;;;;;5,0;1,0;104,0;;;8,0;;1,0;1,0;;7,0;;;;61,0;16,0;2,0;;22,0;;;;2,0;;6,0;;1,0;35,0;281,0;48,0;3,0;;1,0;;;;1,0;;;;;8,0;;5,0;1,0;1,0;;;3,0;;;;;;;6,0;;;1,0;90,0;;;;;;;;3,0;9,0;;;1,0;1,0;;46,0;;;;;2,0;;;;;2,0;5,0;2,0;;17,0;28,0;;;2,0;52,0;6,0;;;3,0;;6,0;;;;;1,0;17,0;;23,0;;;;35,0;12,0;;;51,0;;5,0;;;;47,0;;7,0;11,0;1,0;2,0;;24,0;2,0;3,0;31,0;46,0;;15,0;2,0;;3,0;;10,0;5,0;1,0;68,0;1,0;;17,0;5,0;4,0;3,0;44,0;18,0;14,0;;7,0;12,0;;;;;;4,0;2,0;50,0;;10,0;;;1,0;22,0;;;;1,0;27,0;2,0;;1,0;;11,0;12,0;3,0;;8,0;2,0;2,0;;;2,0;;7,0;37,0;127,0;;;23,0;;;;;;6,0;;;;;;29,0;11,0;;;4,0;2,0;14,0;4,0;;;1,0;;2,0;17,0;24,0;;;11,0;1,0;2,0;1,0;;;12,0;7,0;24,0;;;3,0;7,0;2,0;;20,0;9,0;;1,0;7,0;4,0;4,0;;;;3,0;16,0;1,0;19,0;;2,0;24,0;6,0;2,0;;6,0;2,0;5,0;1,0;3,0;8,0;;8,0;12,0;5,0;3,0;2,0;13,0;;1,0;4,0;;;63,0;;;9,0;26,0;2,0;;1,0;;;1,0;;7,0;2,0;10,0;9,0;1,0;1,0;1,0;8,0;;;10,0;;;26,0;1,0;;;;2,0;;3,0;18,0;2,0;;;;;;;;;;;;1,0;;;;;;;;;;;;;;;;;;;;;;;1,0;1,0;;;;;;;;6,0;;;7,0;2,0;;;;;;;;;;;;;;;;1,0;;;;;;;2,0;;;14,0;;1,0;;;;;;9,0;;;7,0;;;;;;;;;;;;;;;3,0;;3,0;;;1,0;;;8,0;;;;;;;;;;;;2,0;;;1,0;1,0;;;;;1,0;;;;;;8,0;;;;;;;;1,0;;;;1,0;;;;;;;;;;;;1,0;2,0;5,0;;;;;7,0;;;;;;;;;;;;;2,0;;;;3,0;;;3,0;;;;3,0;;;;;7,0;;;;;2,0;;5,0;;2,0;;;;;4,0;;;1,0;;9,0;;6,0;;;;;;;;;;;;5,0;1,0;;18,0;;;;;;;;6,0;;;;;;;;;;3,0;;;;;;3,0;;2,0;;1,0;4,0;1,0;5,0;;;1,0;;2,0;;;;;;13,0;;;;;;;2,0;;3,0;;1,0;;6,0;1,0;;1,0;1,0;;;;;;;;;;1,0;1,0;;1,0;1,0;;;;;;11,0;;;;;18,0;;;;;20,0;2,0;;;1,0;;;;1,0;;5,0;5,0;;;;;;1,0;;1,0;;1,0;;2,0;;3,0;1,0;;;1,0;7,0;;;;;;1,0;;;;;;;;;;;1,0;;3,0;;;;;;;;2,0;;;;2,0;;;;;1,0;;;;;;;;;1,0;;;;;11,0;7,0;;1,0;;;;;;1,0;;;;;;;;;;;1,0;;;;;;;;;;;;;;1,0;;;;;;;;;;;;;;;;;;;;;;;;;;;;;;;;;2,0;;;;;;;3,0;;;2,0;;;;1,0;;;;;;;;;;;;;;;;1,0;;;;;;;3,0;;;;;3,0;;9,0;1,0;;;;;;;;;;;;;;3,0;;;;;;;;;;2,0;1,0;;1,0;;;;;;;1,0;;;;;2,0;;;1,0;;;2,0;;;;;;;2,0;;;;;;;;;;;;;;;;2,0;;;;5,0;3,0;;;;;;;;;;;;;;;;
proximal;;;;;;;2,0;7,0;1,0;8,0;1,0;;;2,0;11,0;3,0;4,0;;2,0;;;1,0;;24,0;;;;;;;1,0;;9,0;;;;;;;;;;9,0;;;;;4,0;;11,0;10,0;1,0;;2,0;;13,0;35,0;;;;31,0;;;;;;;8,0;;5,0;;;;;;;;;;4,0;1,0;;;19,0;;;;;2,0;7,0;8,0;;;4,0;;;;;1,0;;;;;;;;36,0;;5,0;;1,0;;;;;6,0;82,0;25,0;;;1,0;;;;;;;;;;;;;;;;2,0;;;;;;;2,0;;2,0;4,0;7,0;;;;2,0;;;;;11,0;;;;;;;;;;2,0;;;;;;;3,0;;;3,0;;;;;2,0;;;;;1,0;25,0;;;;;5,0;17,0;;1,0;;;;4,0;1,0;;;;;;;;;11,0;;;1,0;;1,0;;1,0;;;;17,0;;7,0;1,0;;;;1,0;21,0;1,0;8,0;;2,0;8,0;14,0;;;42,0;;8,0;;4,0;1,0;1,0;;;;;;;3,0;;;;;;10,0;;;;;;;;;;2,0;2,0;;;;2,0;;;;1,0;;14,0;;28,0;;;;;;;;;5,0;8,0;;;;;5,0;;;;;4,0;;;6,0;;;;;4,0;1,0;;;;2,0;2,0;1,0;;;4,0;3,0;8,0;2,0;;6,0;140,0;;3,0;;2,0;;;26,0;;;20,0;;;;12,0;1,0;5,0;5,0;;3,0;;;4,0;;;3,0;;;2,0;;;;;;;;;2,0;;;;1,0;;;;6,0;;;;5,0;;;1,0;;8,0;;;;;;6,0;;;;;;;;;;;;;1,0;;;;;;;3,0;;;;;;;;;;;;;;;;;;;1,0;;;;;;;;;;;;1,0;;;;;;;;;;;1,0;;;;;;;;;;;;;;;;;;;;1,0;;;;;;;;;;1,0;;;;3,0;4,0;;;2,0;;;;;;;;;;;;;;;;;3,0;;;;;;;;;;;;;;;;;3,0;;;;;2,0;;;;;4,0;;;;;;;;;;;;;;;;;;;;;;;;;;;;6,0;;4,0;7,0;3,0;;;;;;;1,0;;;;;;6,0;;;;;;;;;;;;;;;;3,0;;;;;;;;;;;;7,0;;;;;;;2,0;;;;;3,0;1,0;2,0;;;;;;;;;;;;9,0;;;;;;;;;3,0;;;;;;;;;;;;1,0;;;;;;;3,0;;;;;;2,0;;;;;;;2,0;;;;2,0;;;;2,0;1,0;;2,0;;1,0;;2,0;;;;;;;;;;;;;;2,0;;;;;;;;;;;;;3,0;;;;9,0;;;4,0;9,0;14,0;;;;;;;;;;;3,0;;;;;;;15,0;1,0;10,0;;;;;;;;2,0;1,0;2,0;;4,0;;;;;;;;;;;;;;;;;;;;;;;;;3,0;;;;;;;;;;;;;;;;;;;;;;;;;;;;;;;;;;;;;;;;;;;;;;;;;;;1,0;;;;2,0;;;3,0;;;;;;;2,0;;;;;;;;;;;;;;;;;;;;;;;;4,0;;;;;;;7,0;1,0;;;;;;;;;;;;;;;;;;;;;;;;;;;;;;;;;;;;;;;;;4,0;;;;;;;;;1,0;;;;;;;;;;;;;;;10,0;;;;;;1,0;;;;;;;;;;;2,0;;;;;;;;;;;;;;;;;;;;;;;;;;;;;;;;;;;;;;;;;;;;;
shoulder;;;;;;;2,0;4,0;;;;;;;6,0;7,0;;;;;;;;;;;;;1,0;;;;21,0;;1,0;;;1,0;;;;;;;;;;13,0;;;1,0;1,0;;;;1,0;5,0;;;;20,0;;;;2,0;;;5,0;4,0;2,0;;;;;;;;;;;;;;15,0;;;;;;5,0;3,0;;;;;;;;;;;;1,0;;;;2,0;;;;;;4,0;;;;25,0;18,0;;;;;;;;;;;;;3,0;;30,0;;;;6,0;;;;;;;2,0;;;;3,0;;11,0;;;;;;;7,0;;;;;;9,0;;;;1,0;;;;;;;9,0;;;82,0;;;;;13,0;;;;;4,0;2,0;;;;;;19,0;;;;;;1,0;2,0;;;5,0;;1,0;;;;;;;;;;;;;1,0;;;;;;;;4,0;;;;12,0;4,0;;5,0;7,0;6,0;1,0;1,0;2,0;5,0;;;;;;;;;;4,0;7,0;;;;;;2,0;;;;;;;;;;1,0;;;;;;;4,0;;8,0;;;;4,0;;;;;;;;;;;;2,0;;;5,0;;;;;;;;11,0;;2,0;1,0;;;6,0;;;;;;4,0;;;6,0;;;;;;2,0;;;2,0;;;;;5,0;;;;;;;2,0;;;;;;;;;;5,0;;2,0;1,0;;;;9,0;40,0;1,0;1,0;;;;;2,0;;;;;;;;;2,0;;;5,0;2,0;1,0;;;;;;;;;;;;67,0;;;;2,0;5,0;;;2,0;;;;;;;;;;;;;;;;;;;;;;;;;;;;;;;;;;;;;;;;;;;;;;;;;;10,0;;;;;;;;;;;6,0;;;;;;1,0;;;;;;;;;;26,0;;;;;;;;;;;;;;;;;;;;;;;;;;6,0;;;;;;;;;;;;;;;;;;;;;;2,0;;;;;;;;;;;;;;;4,0;;;;;;;;;;;;;;32,0;;;;;;;;;;;;;1,0;;;;;;;;;;;;;4,0;;;;2,0;;;;;;;;;;;;;;;;;;;1,0;;;;;;;;;;;1,0;1,0;;;;;;;;;;;;;;;;1,0;;;;;1,0;;;;;;;;;;;;;;;;;;;;;4,0;;;;;;;;;;;;;;;;;4,0;;;;;;1,0;;2,0;;4,0;5,0;;;1,0;;;;;;;;;;;;;;;;;;;;;;;;1,0;;;;13,0;;;;;;;;;;;1,0;;;;;;;;;;;;;;;8,0;;;;;;;;;;;;;;2,0;;;;;;;;;;;;;;;;;;;;;;;;;;;;;;;;;;;;;;;;;;;;;1,0;;;;;;;;;;;;;;;;1,0;;;;;;;;;;;;;;;;;;;;;;;;;;;;;;;;;;;;;;;;;;;2,0;;;;;;;;;;;;;;;;;;;;;;;;;;;;;;;;;;;;;;;;;;;;;;;;;;;;1,0;;;;;;;;;;3,0;;;;;;;;;;;;;;;;;;;;;;;;;;;;;;;;;;;;;;;;;;;;;;;;;;;;;;;;;;;;;;;;;;;;;;;;;;;;;;;;
spacer;;;;;;;3,0;3,0;1,0;24,0;12,0;;;;1,0;17,0;1,0;;;;;;;;;;;;6,0;;;;2,0;;1,0;;;;;;;;4,0;;;;;18,0;;;33,0;2,0;;4,0;1,0;13,0;46,0;;;;11,0;;;;10,0;;;74,0;8,0;33,0;1,0;;2,0;;;;;;;20,0;1,0;;;40,0;;;;;2,0;;197,0;;;11,0;;;2,0;;23,0;1,0;;;72,0;;;;46,0;2,0;;;2,0;;18,0;;;48,0;68,0;8,0;;;6,0;;5,0;;;;;;;;;;2,0;;;;5,0;;;1,0;;;;22,0;;;;23,0;1,0;;1,0;12,0;;;;;5,0;;;;;;69,0;;;;;;;1,0;;4,0;1,0;4,0;;;10,0;3,0;;;12,0;1,0;15,0;;;6,0;7,0;;;;;;;7,0;;6,0;;;;13,0;;;;4,0;;14,0;;;;5,0;12,0;1,0;;2,0;15,0;;5,0;;7,0;26,0;1,0;;2,0;1,0;;;35,0;;15,0;8,0;15,0;2,0;;8,0;;3,0;;2,0;4,0;6,0;;;;;;;1,0;;32,0;3,0;26,0;;;;;;2,0;;;;;;;;;;8,0;21,0;1,0;4,0;;;7,0;;;12,0;;6,0;58,0;61,0;;;1,0;31,0;;;;;;17,0;;2,0;;52,0;2,0;;;;8,0;3,0;;;14,0;;1,0;;;2,0;6,0;3,0;;;14,0;2,0;;;;;;9,0;;;1,0;;;;3,0;;;2,0;1,0;;;;;;;;2,0;16,0;1,0;;3,0;;;;;2,0;;15,0;;;;4,0;;;;;2,0;2,0;;;3,0;;;;;1,0;;;;;;;;;58,0;2,0;;;1,0;;;;3,0;;11,0;;;17,0;15,0;;;6,0;2,0;4,0;;1,0;2,0;;;;;;;;;;;;;;;;;;3,0;;;;;1,0;;;;;2,0;2,0;;;;;;;;;;;;;;;;;;;;;;;;;;;;;;;;;;;;;;;;;;;;;;;;;;;;;;9,0;;;;;;;;;;;;;;;;;;;1,0;;;;;;;;;;;;;;;;;;;;;;;1,0;;;;;;;;;;;;;;;;;;4,0;;;;1,0;;;;;;;;;;1,0;;;;;;;;;;;;;;;;;2,0;;4,0;;2,0;;;;;;;;;;;;;;;;;;;;;;;;11,0;;;;;;;;;;;;;;;;;;;;;;4,0;;;;6,0;;;;;;;14,0;;;;;;;;;;;;;;2,0;;1,0;;;;;;15,0;;;;;;;;;;;;4,0;;;;;;;;;;;4,0;;;;;;;1,0;;;;;;;;;;;;;7,0;;;;;;1,0;;;;;;;;;8,0;;2,0;;;;;;1,0;;;;2,0;2,0;1,0;1,0;;;;1,0;;;;;7,0;;4,0;;2,0;;;;6,0;;;6,0;;;;;;3,0;;;;7,0;;;;;;;;;;;;;5,0;;;;;;;;;;;;;2,0;;;;;;;;2,0;1,0;;;;;;;;;;;;;;;;2,0;;;;;;;;;;;;;;;;;;;;;;;;;;;;;;;;;;;;;;;;;;;;;;;;;;;;;;;;;;;;;;;;;;;;;;;;6,0;;;;;;;;;;;;;;3,0;;;1,0;;;;1,0;;;;;;;1,0;;;;;;;;;;;;;;;1,0;;;;;;;1,0;;;;;;;;;;;;;;;;;;4,0;;;;;;4,0;;1,0;;1,0;;;;;;;;;;;;;;;;;;;;;;;;;;;;;;;;;;;;;;;;
split;;;;;;;2,0;10,0;4,0;14,0;;;;;2,0;4,0;95,0;;;;;8,0;;1,0;;;2,0;1,0;;;;;23,0;;2,0;;;;;;2,0;;;;4,0;4,0;;2,0;;6,0;4,0;;;;2,0;;11,0;;;;;1,0;;;4,0;;21,0;9,0;;;;3,0;1,0;;;;;2,0;7,0;50,0;;3,0;;11,0;;;;;;;7,0;;;;6,0;;;;9,0;;;2,0;;3,0;;5,0;80,0;;2,0;;11,0;5,0;;;;20,0;2,0;;;;;7,0;;;;;;1,0;10,0;2,0;;4,0;;1,0;;;1,0;;;;4,0;;;24,0;;;;8,0;2,0;;;;;;4,0;;18,0;;;;;8,0;96,0;;;;;5,0;9,0;12,0;;;;;;;;;;2,0;;;;;;;;4,0;;;;;;;;;;;;;;;2,0;;;;;1,0;1,0;;;;;;;1,0;;;;14,0;;13,0;;;;;;;75,0;;;;11,0;;;1,0;;1,0;;;;;2,0;59,0;1,0;;;;;;;10,0;;;;;12,0;19,0;;;;;;2,0;;;1,0;;3,0;;;3,0;;;;;;;;28,0;;;;;2,0;1,0;;;2,0;1,0;;;;;;;;;;;;;;1,0;;;;;;;;13,0;;;2,0;1,0;;;;;;;;1,0;1,0;;;;;;;;;;;;;5,0;;;;3,0;7,0;;;;;;2,0;;;;;;;;;;;;;4,0;;;;1,0;;;;2,0;1,0;;;1,0;;;;;;;;;;;;;;;;;;18,0;;3,0;;2,0;;;;;;;;3,0;;;;;;1,0;;;;;;;;;;;;;;;;;;;;;;1,0;;;;;;;3,0;;;;;;;;;;1,0;;;;;;;;;;;;;;;;;;;;;;;4,0;;;4,0;6,0;;;;;;;;;;;;;;;;;;;;;;;2,0;1,0;;;;7,0;;;;;;;1,0;31,0;;;;;;;3,0;;;;;;;;;;;;;;;;;;;;;;;;;;;1,0;;;;;;;;;;;;;;;;;;8,0;;;;;;;;;4,0;;;2,0;;;;;;;;;;;;;;;;;;;;;;;;;9,0;;;;;;;;;;;;;9,0;;;;;;;;;;;;;8,0;;1,0;;;;;8,0;;;;;;;;;;;;;;;;;;;;;;;;;;;;;;;;;2,0;;;1,0;;;;;;3,0;;;;;;;;;;;;;;;;;;;;;;;;;;;;;;;;;;;;;;;;;;;;;;;;;;;;;;1,0;;;;4,0;;;;2,0;;;;;;;;;;;;;;;;;;;;;;;;;;;;;;;;;;;;1,0;;;;;;;;;;;1,0;;2,0;;;;;;;;;;;;;;;;;2,0;;1,0;;;;;;;;;;;;;;;;;;;2,0;;;;;3,0;;;;;;;;;;;21,0;;;;;;;;;;;;;;;;;;;1,0;;;;;;;;;;;;;;;2,0;;;;;;;;;;;;;;;;;;;;;;;;;;;;;;;;;;;;;1,0;;;;;;;;;;;;;;;;;;;;;;;;;;;;;;;;;;;;;;;;3,0;28,0;;5,0;;;;;;;;;;;;1,0;;;;;;;;;;;;;;;;;;;;;;;;;;;;;;;;;
spot;;;;;;;3,0;2,0;;;1,0;;;;;3,0;;;;;2,0;;;;;1,0;;;;2,0;;;1,0;;4,0;5,0;1,0;4,0;;;;;;;10,0;3,0;14,0;4,0;;;;2,0;;;;2,0;1,0;;;;;;2,0;;;;1,0;2,0;;;;5,0;3,0;;;;1,0;3,0;2,0;12,0;;1,0;;3,0;;1,0;;;;;;;;;;1,0;;;5,0;;;;;4,0;;;1,0;;;;;4,0;;;;2,0;6,0;7,0;;3,0;;;;;;;;;;7,0;;2,0;3,0;;;;;;;;5,0;;;;;;;;16,0;;8,0;;1,0;3,0;2,0;;9,0;;;;;2,0;5,0;;;;18,0;4,0;;;;;;;;;;;;;;;;;;;;;;;;;;;;;;;;;;;2,0;;3,0;;;;2,0;;;;;;;;;;;;;;;;;;;;19,0;;;;;2,0;;;;;;;;;;;;;2,0;;;;;;;;;;3,0;;;;;;;;;;;;;;;;1,0;;;;;;;1,0;;;;;;5,0;3,0;;;;14,0;1,0;;;;;;;;;;;2,0;;;;;1,0;;;;;;;;;;;;;;;;;;;;;;2,0;;;;;;;;3,0;;;;;;;;;;;;1,0;;;;;;;;4,0;;;;;;;;;;;;1,0;;;;;;;;;;;;;;;;;;;;;;2,0;;;;;;;;;;;;;;;;2,0;;4,0;;;;;;;;;;;;;;;;;;5,0;;;;;8,0;;;;;;;;;;;;;;5,0;;;;;;;;;1,0;;;;;1,0;;;;;;;;;;;;;;;;2,0;;;;;;;7,0;1,0;;;;;;;1,0;;;;;;;;3,0;;2,0;;;;;;;;;;;;;;;;;;;;1,0;;;;;;;;;;;;;;;8,0;;;;;;;;;;;;;;;;;3,0;20,0;;;;;;;;;;12,0;;;;;;;;1,0;;;;;;1,0;;;;;;;;;;;2,0;;;;;;;;;2,0;;;;;;;;;;;;7,0;;;;;;;;;;;;;1,0;2,0;;2,0;;;;;;;;;1,0;;;1,0;;;;;;;;;;;;;;;;;;;;;;;;;;2,0;;;;;;1,0;;5,0;;;;;;;;;;;;;1,0;;;;;;;;;;;;;;;;;;;;;;2,0;;;1,0;;;;;1,0;;;;;;;;;;;;;;;6,0;;;;;;;;;;;;;;;;;;;16,0;;;;;;;;;;;;;;;;;;;;;;;;2,0;;;;;;;;;;;;;;;5,0;;;;;;;;;;;;;;;;;;;;;;;;;;2,0;;;;;;;;;;;;;;;;;;;;;;;;;;;;;;;;;;;;;;1,0;;;;;;2,0;;;;;;;;;;;;;;;;;;;;;;;;;;;;;;2,0;;;;;;;;;;10,0;;;;;;1,0;;;;;;;;;;6,0;;;1,0;;;;;;;;;;;;;;;;;;;;;;;;;;;;;;;;;;;;;;;;;;;;;;;;;;;;;;;;;;;;1,0;;;;;;;;;;;;;;;;;;;;;;
stationary;;;;;;;10,0;11,0;4,0;22,0;;;4,0;;32,0;78,0;1,0;10,0;;1,0;;;;;1,0;;3,0;2,0;;;1,0;1,0;8,0;;3,0;;;;4,0;;;;15,0;;6,0;2,0;13,0;15,0;2,0;;4,0;1,0;;;11,0;5,0;1,0;;;;3,0;;12,0;;;2,0;;3,0;119,0;5,0;;;8,0;;;2,0;1,0;;;64,0;6,0;6,0;;38,0;;;;;;2,0;25,0;;;;;;;;16,0;2,0;;;16,0;61,0;;;27,0;;2,0;2,0;;;;;;19,0;81,0;65,0;2,0;3,0;;;1,0;9,0;;;;;1,0;1,0;;10,0;44,0;;;;7,0;;4,0;;2,0;;3,0;22,0;;;;7,0;8,0;;;;;;;;12,0;;4,0;;;;52,0;;;;10,0;7,0;;;1,0;;4,0;2,0;;;18,0;7,0;;;5,0;4,0;;;;15,0;;;;;;;;21,0;;1,0;;;;;;;;36,0;;;2,0;;1,0;16,0;;;3,0;;1,0;;;;;8,0;3,0;;;;;;;;9,0;;210,0;4,0;1,0;26,0;29,0;7,0;6,0;;4,0;;;2,0;;8,0;;;;;;8,0;14,0;;2,0;;2,0;;42,0;;;;10,0;;5,0;5,0;;;1,0;;;;2,0;1,0;12,0;;;6,0;;7,0;1,0;9,0;;;;;;1,0;;;;;1,0;;8,0;;;;;;;;30,0;;25,0;;;;;4,0;;;;2,0;;;;;;2,0;;3,0;;;;;13,0;;8,0;;;;;;;;;;;21,0;1,0;16,0;3,0;;;;;1,0;;5,0;2,0;2,0;;1,0;;;5,0;2,0;4,0;2,0;;;;;;;9,0;1,0;;;;2,0;1,0;;;;;1,0;17,0;4,0;15,0;;;;;4,0;;;22,0;;;35,0;7,0;6,0;;1,0;;;;;;;;;;5,0;;;;;;;5,0;;;;;;;;;;;;1,0;;;;;;;3,0;;;;;6,0;;;1,0;8,0;;2,0;13,0;27,0;;;2,0;2,0;;1,0;;;;;;;2,0;;;;;;;;;;7,0;;;1,0;;;;;;;;;;1,0;1,0;5,0;;2,0;2,0;2,0;;;;;4,0;2,0;;;;;;;;;;;;;4,0;;;1,0;;;;;;;1,0;;;;;;;;;;;;;;3,0;;;;;;15,0;;;;;;;;7,0;;;;;;;;;;;;;;8,0;1,0;;;;;;;;;;;5,0;;;2,0;;1,0;;;;1,0;;;;;;;;;;;;12,0;;;;;;;1,0;;;;;7,0;;;;;;;;;;;;;;;;;;;;;;;;;2,0;2,0;;;;;;;1,0;;;9,0;;;;;;6,0;;;;;;1,0;;;;;;3,0;;;3,0;1,0;;;;;2,0;;2,0;;1,0;;1,0;;;;;;;;1,0;3,0;;;;12,0;;;;;7,0;;;;2,0;;;;;;2,0;;;;;;;;;;;;;;;;23,0;;;;;23,0;;1,0;;;;4,0;51,0;;;;;;;;;2,0;;;;;;;;;;;;;;;;;;;;;8,0;;;4,0;;;;;;;;;;;;;;;;;;;;;;;;3,0;;4,0;;;;;;;;;;;;;;;;;;;;;;;;;;;1,0;;;;;;;;;;;;;;;;;;;;;;1,0;;;;7,0;;;;;;1,0;;;;;;;;;;;;;;;;;;;;;;;;;;;;;;;;;;;;;54,0;;;;11,0;19,0;;;;;;1,0;;;;;;;;2,0;2,0;;2,0;;1,0;;;18,0;;1,0;;;;;2,0;;;;;;;;;;;1,0;;;;;4,0;;;;6,0;;;9,0;;;;;;;;;;;1,0;3,0;1,0;;;;;;;;;;;1,0;;;;;;;;;;;;;;;;;;;;4,0;;;;;;;;;1,0;;;;;;;;;
subsequent;;;;;;;7,0;;3,0;2,0;2,0;3,0;1,0;;;11,0;;;1,0;1,0;6,0;42,0;;1,0;;;15,0;;;;;5,0;3,0;;6,0;;2,0;2,0;;;25,0;;1,0;1,0;12,0;5,0;24,0;1,0;14,0;12,0;;1,0;3,0;;;5,0;7,0;;9,0;;;;2,0;;12,0;6,0;13,0;1,0;19,0;;;;12,0;3,0;;2,0;2,0;;7,0;209,0;2,0;2,0;;31,0;4,0;;1,0;;;6,0;172,0;;1,0;1,0;1,0;;4,0;;21,0;;4,0;1,0;3,0;29,0;;1,0;34,0;8,0;2,0;8,0;;11,0;;;;30,0;7,0;7,0;35,0;16,0;;;13,0;11,0;19,0;;;;1,0;6,0;;18,0;5,0;;;;11,0;5,0;65,0;1,0;25,0;;1,0;20,0;10,0;;;8,0;45,0;11,0;;;2,0;11,0;30,0;1,0;13,0;;1,0;12,0;3,0;1,0;203,0;;8,0;1,0;6,0;1,0;;;19,0;;;7,0;10,0;3,0;;;1,0;;;2,0;;;;7,0;;4,0;;;3,0;1,0;;2,0;2,0;;2,0;;1,0;;;;9,0;;7,0;;;;19,0;2,0;;;;;;;;;;;;;;;;;;1,0;12,0;1,0;;;;;;10,0;15,0;1,0;;;3,0;;;;;;;7,0;72,0;3,0;;;;;;;9,0;3,0;;;;;;3,0;;;1,0;;4,0;;;4,0;2,0;;;;3,0;;;7,0;6,0;;;2,0;;90,0;1,0;;;;;;;;;;;;;;;;;2,0;;;;5,0;;1,0;;;;;5,0;1,0;6,0;;;;;;;;;;;;;;;;;;;;;;6,0;;;;;;10,0;;;1,0;;14,0;;;;;;;;;2,0;;;1,0;;;;;;;;;;;;;;;;;;;;;4,0;;;1,0;;;;;5,0;4,0;6,0;;;;;;2,0;;;;1,0;2,0;;;;;7,0;4,0;5,0;;7,0;2,0;7,0;;1,0;;1,0;;;;2,0;1,0;10,0;;1,0;45,0;2,0;;;3,0;;;22,0;;1,0;2,0;;;3,0;1,0;5,0;;1,0;;31,0;1,0;3,0;3,0;;;;;;11,0;;3,0;;;3,0;;;4,0;;;;;11,0;1,0;;;;;5,0;1,0;10,0;;12,0;;12,0;2,0;2,0;7,0;;;;;;2,0;;;4,0;1,0;2,0;;;;;;;;;2,0;5,0;3,0;4,0;;24,0;;;;;;2,0;;;;;;3,0;;;2,0;;;;;;;;5,0;2,0;;;;1,0;;2,0;7,0;;;;;;1,0;1,0;6,0;;1,0;;;;16,0;;;;;;;;;;;;10,0;;7,0;;3,0;9,0;;;;;;;;;6,0;;;;;;;;1,0;1,0;1,0;;;;;;;;;;;3,0;;2,0;;3,0;2,0;2,0;;;;;;;;;;;;;;;;;1,0;1,0;;2,0;37,0;;4,0;19,0;;;2,0;;;;;;;;;;;1,0;1,0;;;;1,0;;4,0;1,0;;;;;;;;;;;5,0;1,0;;;;;1,0;;;;1,0;;;;;;;;;;;;;;9,0;;;1,0;3,0;;;;;;;;;;;;;;;;;;;;;;1,0;;;;;;;;;;;6,0;1,0;;;;;;3,0;;;;;1,0;;;;1,0;;;;;;;;;;;;;;1,0;45,0;;;;;;;;2,0;4,0;;;;;;;;;6,0;;;;;;4,0;;;;;;;;;2,0;2,0;;;11,0;2,0;;;;;4,0;;;8,0;;;;;;;2,0;1,0;;5,0;;8,0;;1,0;;;;;;;1,0;;3,0;;;;;;;2,0;;;1,0;;;;;;;1,0;;;;;;;;3,0;;;4,0;;;;;;1,0;;;;;;;;;;1,0;;;;;;2,0;;;;;;;;;;1,0;;;8,0;;;;1,0;;;;;;;;;;;3,0;;3,0;;;;4,0;;;;;;;;1,0;;;;;;;;;;;;;;;;5,0;;;;1,0;;;3,0;;;;;;;;;;;;;;;;;;;;;3,0;;;;;;;;;1,0;;;;;;;;1,0;;3,0;;11,0;;;2,0;;;;1,0;;;;;;;2,0;;;;
train;;;;;;;5,0;11,0;1,0;;;;1,0;;;6,0;;;;1,0;1,0;;;4,0;1,0;;;;6,0;;;2,0;11,0;;;;;;;;7,0;;6,0;;;;2,0;6,0;;;14,0;1,0;;;40,0;;2,0;;;;1,0;;;;;4,0;;;;;1,0;;3,0;;;;;6,0;;74,0;;1,0;;26,0;;;;;;;26,0;;;1,0;;;;;14,0;;5,0;;15,0;9,0;;;79,0;;2,0;3,0;;4,0;;;1,0;23,0;23,0;5,0;;;;;4,0;;1,0;;;;;10,0;;;;;;;5,0;12,0;;;6,0;;;28,0;;;;5,0;12,0;1,0;;3,0;;;7,0;;13,0;;13,0;;;2,0;;;;;;;;;;1,0;;;;2,0;2,0;1,0;;;;2,0;;;;11,0;;;;;;;;2,0;;2,0;;;;;;;;1,0;;;;;3,0;1,0;;1,0;;;;;;;2,0;;11,0;;3,0;;;5,0;;;7,0;;4,0;;;5,0;3,0;;2,0;;;11,0;5,0;;8,0;9,0;10,0;;;;4,0;3,0;;;;;;43,0;12,0;;;;;;;1,0;;;;6,0;;;;;4,0;;;;;;7,0;18,0;;;;1,0;;1,0;;;;1,0;1,0;;;;;;;;;;3,0;;3,0;;;;;1,0;;;;;;;4,0;1,0;;;;26,0;;;;7,0;;;1,0;;;;1,0;;;;;;;;9,0;60,0;1,0;;;2,0;;;;11,0;;;;;;;;;3,0;1,0;;;;;1,0;6,0;;5,0;;;;;;;;;;;;;1,0;;;;;5,0;;;;;;2,0;;6,0;12,0;;;1,0;;;;;;;;;;;;;1,0;1,0;;8,0;3,0;;;;;;;1,0;;;;;;;;12,0;;;;4,0;;;2,0;;5,0;;4,0;;;5,0;1,0;;;;2,0;;;;;;;;;3,0;2,0;;;;2,0;;;2,0;;;;;;;;;;;1,0;;5,0;;;1,0;;6,0;2,0;1,0;;7,0;;1,0;;;;;1,0;;;;;;;;2,0;;2,0;;;;;;;;;;;;;;;;;;;2,0;;;;;;1,0;;1,0;;;;;;;;;;;;;;;;;1,0;;;;;;;1,0;;;;;;;;;;4,0;2,0;;;1,0;;;6,0;1,0;;;;;;3,0;7,0;;;;;;;;;;;;;;;;;;;;;;;;;;;6,0;;;;;8,0;10,0;;;;;;;;;;;;;;;2,0;;;;;;;;;;;;;3,0;;;;;;;2,0;;;;;;;;;;;;;;;8,0;;;3,0;;;;;;;1,0;;;;;;;1,0;;;;2,0;;;;;;13,0;;;;;;;;;;8,0;;;;;;;1,0;;;;;2,0;;;;;;;;;;;2,0;;;;;;;;2,0;;;;;;;;;;;;;;;;1,0;;;;1,0;;;;;;;;;;;;;;;3,0;;2,0;;;;;;;1,0;;;;;;;;;;;1,0;2,0;2,0;;;;;;;;;;;;1,0;3,0;;2,0;;;;;;;;22,0;;;;;;;;;;;;;;14,0;;;;;;;;;;;;;;;;;;;;;;;;;;;;;;;1,0;;;4,0;;;;;;;;;;;;;;;;1,0;;12,0;;;;;;;;;;;;;1,0;;;1,0;;;;;;2,0;;;;;;;;;;;;;;;;;;;;1,0;;;;;;3,0;1,0;;;;;;;;;;;;;;;;;;;2,0;;;;;2,0;;;;;;;;;;;;;;;;;;;;;;;1,0;;;;;;;;;;;;;;;;;;;2,0;;;;;;;;;
tube;;;;;;;1,0;6,0;2,0;6,0;1,0;;5,0;;16,0;4,0;;;;;;;;5,0;;;;;2,0;2,0;;;15,0;;3,0;;;;;1,0;;;4,0;2,0;1,0;1,0;;29,0;;5,0;22,0;6,0;;2,0;13,0;4,0;10,0;;;;38,0;;1,0;;2,0;;1,0;21,0;1,0;23,0;;14,0;;;;;;;;9,0;3,0;1,0;;25,0;;;;;;11,0;54,0;;;1,0;;;;;7,0;1,0;;1,0;7,0;1,0;6,0;;21,0;2,0;;;1,0;;;;;32,0;72,0;20,0;1,0;;3,0;3,0;;2,0;1,0;;;;3,0;2,0;1,0;;13,0;;;;1,0;1,0;;;;;;10,0;;;;68,0;1,0;;;5,0;;;;7,0;24,0;;6,0;;1,0;;38,0;;2,0;;;1,0;;;;;4,0;28,0;1,0;3,0;55,0;10,0;3,0;;;19,0;;11,0;;;1,0;;;;;;;23,0;1,0;2,0;;;;7,0;2,0;;;7,0;;;;;;7,0;;5,0;2,0;;2,0;;;;;9,0;35,0;;24,0;;;16,0;;;16,0;;3,0;10,0;1,0;23,0;10,0;4,0;3,0;12,0;7,0;34,0;5,0;5,0;1,0;;;;;;;6,0;8,0;;;1,0;;;12,0;3,0;;;3,0;;;;;;7,0;2,0;;;1,0;;3,0;2,0;;13,0;;1,0;;20,0;5,0;;;1,0;;;;1,0;;;;20,0;2,0;1,0;36,0;;11,0;;14,0;;2,0;9,0;31,0;4,0;2,0;1,0;1,0;2,0;13,0;;;;;2,0;4,0;;;;;8,0;6,0;;5,0;17,0;;;10,0;2,0;;1,0;34,0;;1,0;4,0;;;;101,0;6,0;7,0;9,0;2,0;11,0;;;5,0;29,0;2,0;3,0;;;5,0;;;;3,0;2,0;;;12,0;;;37,0;3,0;1,0;1,0;;21,0;;;;2,0;1,0;;;2,0;6,0;;12,0;2,0;1,0;2,0;2,0;4,0;;3,0;;6,0;;27,0;3,0;;;1,0;7,0;3,0;;1,0;;;;;3,0;4,0;;;;;;1,0;;;;;;;;;;;;;2,0;;;;;;;;;;1,0;1,0;1,0;;;1,0;;;;2,0;2,0;;;;1,0;;4,0;;1,0;;;;;1,0;1,0;;;;;;;;;;;11,0;;14,0;;;4,0;;2,0;;;;1,0;;3,0;7,0;;11,0;;;;;;1,0;;;;;;;;;2,0;;;;;1,0;;;;;;;1,0;2,0;;;;;;;;;1,0;;7,0;;;;;16,0;;;;;;9,0;;3,0;;1,0;;;;;;;;1,0;;;14,0;;;;;;;5,0;;;2,0;;;;;;4,0;;;1,0;;;;;;;1,0;;4,0;;;1,0;;1,0;;;11,0;1,0;;;68,0;;;;;11,0;;;;;65,0;;;;;;;;;3,0;;;;;;;;;;;;;;;;;;;;;;;;31,0;;4,0;;;;5,0;;;;;;;;;;;;;;;;3,0;1,0;5,0;;;;2,0;;;;2,0;;6,0;;;;;;1,0;;;3,0;;;20,0;16,0;13,0;3,0;;;;;5,0;;;6,0;;;;;;;;;;;;;;;;2,0;;;;;;;;;33,0;;1,0;;;;;;10,0;;1,0;;;;3,0;2,0;;;;3,0;;3,0;;9,0;;1,0;;;;;2,0;;2,0;;;;;7,0;;;2,0;;;;3,0;;;;;;;;;;;;;;;;;;;;;;;;;;1,0;;;;;;;;;;;;;;;1,0;;;;;;;;;;;;;;;;1,0;;;;;;;;;;;;;;;3,0;;;;;;;;;;;;;;;;;;;;6,0;;;;;;;;;;;1,0;;;;;;;;;;;;;;;4,0;;;;;1,0;;;;;;1,0;;;;;;;;3,0;;;;;;;;1,0;;;;;;;;;;;2,0;1,0;;;4,0;;;;24,0;;;;;5,0;;;;;;;;;4,0;;;;;;;6,0;;;1,0;;;;;;1,0;;1,0;;;1,0;3,0;;;;;;;;;;;;;;;;;;;;;;;;;;;;;;;;;;;;;;;;;;
yoke;;;;;;;1,0;39,0;1,0;13,0;;;;;12,0;8,0;;2,0;;;;;;;3,0;;;;;;;;6,0;;1,0;;;2,0;;;;;2,0;;1,0;;;12,0;;;31,0;2,0;;;36,0;;;;;;4,0;;2,0;;1,0;;;16,0;3,0;;;;;;;;;;;2,0;;;;25,0;;;;;4,0;3,0;33,0;;;5,0;;;;;1,0;1,0;;;34,0;;;;13,0;;;;1,0;;;;;;20,0;7,0;4,0;;;;;;;;;;;1,0;;;;;;;2,0;;;;;;;1,0;;;;33,0;;;;;;;;;1,0;;35,0;;;;17,0;;;;;1,0;;;;;;;;4,0;14,0;10,0;;;;11,0;;;;;;;;;;;;32,0;4,0;2,0;;;3,0;13,0;;;;15,0;;;4,0;;;42,0;;;14,0;;;;1,0;;;1,0;27,0;;38,0;;;1,0;;15,0;;;16,0;2,0;;13,0;10,0;15,0;;2,0;2,0;46,0;1,0;;4,0;;;;;;;2,0;6,0;;;;;;1,0;;;;;3,0;;;;;19,0;3,0;3,0;;;;1,0;1,0;;6,0;;;;35,0;;;5,0;;;;;;1,0;;;;;;6,0;;;;;;13,0;5,0;23,0;;;;;4,0;;;;1,0;;17,0;;2,0;;;3,0;5,0;;;;;21,0;;;;;;2,0;2,0;;;;;;1,0;;6,0;;;1,0;;;;;;;;7,0;7,0;;;;6,0;;2,0;;38,0;;;;3,0;;;;2,0;;;;4,0;;;;;;;;2,0;;;;1,0;;;;;;9,0;3,0;;;;;;;;;;;;;;;;;1,0;;;;;;1,0;;;;;;;;;1,0;;;;;;;;;;;;;;;;;;;12,0;3,0;;;;;;;;;;;;;;;;;;;;;;;2,0;;;;;;;;;;;;;;;;;;4,0;;;;;;;;;;;;;;;;;13,0;;1,0;;;;1,0;;;;;;;;;;;;;;;;;;;;;1,0;;;;;;13,0;;;;;;1,0;;61,0;;;;;;;;;;;;;;;;;;;;;;;;;;8,0;;;;;;;1,0;;;;;;;;;;;;;;1,0;;;;;6,0;1,0;;;;2,0;;5,0;;;;;;4,0;;;;;;;;;;;;;;;;;;;;;;;;;;;2,0;;;;;;;;;;;;;;;;;;;;;;;;;;;;;;;;3,0;;;;1,0;;;;;;;;;;;;;2,0;;;;;;;;;;;;;;1,0;;;;;;;;24,0;;;;;;;;;17,0;;;;;1,0;7,0;;;;;;44,0;;;2,0;;;;;;;;;2,0;;9,0;;;;;;;;;;;;;;;;;;;;;;;;;;;;;;;;;;;;;;;;1,0;;;;;;;;;;;;;;;;;;;;;;;;;;;;;;;;;;;;;;1,0;;;;;;;;;;;;;;;;;1,0;;;;;;;;;;;;;;;;;;;;;;;;;;;;;;;;;;;;;;;;;1,0;;;;;;;;;1,0;;;;;;;;;;;;;;;;;;;;;;23,0;5,0;;;;;;;;;;;;;;24,0;;;;;;;;;;;;;;27,0;;;;;;;;;1,0;;;;;2,0;;;;;;;1,0;;;;;;;;;;;;;;;;;;;;;;6,0;;;;;;;;;;;;;;;;;;;;;
amplifier;;;;;;;;9,0;;9,0;;;4,0;;20,0;3,0;;;;;;;2,0;4,0;;11,0;4,0;;;;;;11,0;;4,0;1,0;;;;;;;;2,0;4,0;;1,0;16,0;16,0;1,0;20,0;;;;3,0;;23,0;1,0;2,0;;;;16,0;;;;;3,0;;;;;4,0;2,0;;;;;;11,0;;14,0;;65,0;;;;;;;;;1,0;;;;;;4,0;;;;2,0;;;;;;119,0;;;6,0;;;;41,0;1,0;1,0;13,0;11,0;;;;6,0;;;;;;;;11,0;;3,0;;;3,0;1,0;13,0;;;;;9,0;;;;17,0;72,0;;;;2,0;2,0;;10,0;5,0;;6,0;11,0;;;7,0;;1,0;;;;;;;;;3,0;1,0;1,0;;;;;;;;;1,0;66,0;;;2,0;;;;;46,0;4,0;;;;;;;;;2,0;;;1,0;;2,0;1,0;;;1,0;21,0;;;;;;;;;;;;;;;1,0;;;;21,0;;;;;;;;1,0;;;7,0;;7,0;16,0;;40,0;;;;;;;1,0;8,0;;;;;;;1,0;;;;;;;;25,0;;;;;;;4,0;;11,0;;35,0;;;;;;;;;3,0;;;;;;;;;;;;;;;;1,0;;;;;;;;;;;;5,0;;;;;7,0;;;;;;;;;;;1,0;;;9,0;;;;;;;;;15,0;4,0;1,0;;;;2,0;;;2,0;2,0;;;;;;;;;;;;;;;;;;;;;;;;;;;;2,0;;;5,0;;;;;;;;;2,0;;;;;;2,0;;;;;3,0;5,0;2,0;;4,0;;;5,0;;;;;;;;;;;3,0;;;;;74,0;17,0;;;;;;4,0;1,0;;;;;;;6,0;;;;;1,0;;;;;;;6,0;;;;;;;;;;3,0;;;;;;;;;;49,0;;;;;;;;;;;;;;;;;;;;;;;;;;;;;;4,0;;;;;;;;;;;;;;;3,0;;;;;;;;10,0;4,0;1,0;;;;;;;;;;;;;3,0;;;9,0;;;;;;;;;;;;;1,0;;;;;;;;;;;;;;;;;;;;;;;32,0;;;;;;;2,0;;;;;;;;;;;;;;;;;;;;;;;;;;;;3,0;;;;;;5,0;2,0;;;22,0;;;;;;2,0;;;;;;;;;;;;;;;;;;;;;;;;;;;;20,0;;;;;;;;;;;;;;;;;;;;;;;;;;2,0;;;;;;;4,0;;;;;;;;;;;;;;;;;;;1,0;;;;4,0;;;;;;1,0;15,0;5,0;;;;;;;10,0;;;;;;;;;;;;;;;;;;;;3,0;;;28,0;5,0;1,0;;18,0;2,0;;;;8,0;15,0;;14,0;;;;16,0;;;;;;32,0;;;;;;;;;;;;139,0;10,0;;2,0;;;;;;;;;;1,0;;;;;;1,0;;;;;;;;;;;21,0;;;32,0;;;;;;;;;;;;;;;;;;;;;;;;3,0;;;;;4,0;;;;;;;;;;;;;;;;;;;;;;;;;;;;;;;;;;;;;;;;;;;;;;;;3,0;;;;;;;;;;;;;;3,0;;;;;;;;;;;22,0;;;;;;;;;2,0;;;;;;;;;;;;2,0;;;;;;;;;;;;;;;;;;;;;;;;;;;;;;;;;;;;;;;;;;;;;;;;;;;
analog;;;;;;;;14,0;;2,0;10,0;;2,0;;;23,0;;;1,0;;;8,0;5,0;;3,0;27,0;2,0;2,0;;;;;50,0;;31,0;;;8,0;;;19,0;;;;10,0;4,0;7,0;13,0;224,0;3,0;5,0;;;;11,0;3,0;2,0;;5,0;;1,0;2,0;;;1,0;;;2,0;;2,0;7,0;;38,0;;;6,0;;;;107,0;;3,0;;40,0;;;;;;;3,0;;;;;;1,0;;24,0;;;1,0;8,0;5,0;1,0;;1,0;;86,0;;;16,0;;;6,0;19,0;9,0;8,0;;27,0;;;14,0;20,0;3,0;;;;1,0;8,0;;59,0;;;4,0;;11,0;2,0;14,0;;;6,0;1,0;36,0;6,0;;;;587,0;;;;;18,0;;20,0;20,0;;2,0;2,0;;21,0;64,0;;4,0;;67,0;1,0;;;2,0;;;;;5,0;;;;;2,0;;;;;24,0;;12,0;;;3,0;;;3,0;;;;;;;;;1,0;;;;;1,0;;;;;;;;;;;;3,0;;9,0;;;;;1,0;;12,0;;;;1,0;6,0;;;;;;;;;;2,0;3,0;;1,0;1,0;146,0;;;;;;;;43,0;;;;;;;5,0;;;1,0;;;;;1,0;;;;;;;4,0;;8,0;;;;3,0;8,0;;;;;2,0;;1,0;;;;1,0;;;;;;;;;;7,0;2,0;;;;4,0;1,0;;;;;4,0;;;;;;;4,0;1,0;;;;;;;;;;;;;2,0;;;;;1,0;;;;;;;;;;;;;;;;;;;;;;;34,0;;;;1,0;;;;;;;;;;;;;;;2,0;;;;4,0;;;;2,0;;9,0;;;;;;;;4,0;;;3,0;;;10,0;3,0;2,0;48,0;1,0;;;;;;6,0;6,0;;7,0;4,0;;;1,0;;;;;98,0;18,0;;;;11,0;1,0;;;3,0;1,0;;;2,0;;6,0;;;22,0;;;;;;;;;;;;;2,0;1,0;;;;;12,0;1,0;;;;;3,0;;;;172,0;;4,0;;1,0;;1,0;11,0;;;4,0;;;;;;3,0;;;;5,0;;6,0;3,0;;;1,0;;;;83,0;;2,0;;;1,0;9,0;;;;;;;;;;;;2,0;;;;;2,0;;;;;7,0;;;;;;;20,0;;11,0;;;;;;;;;;;;;;;;2,0;3,0;1,0;;1,0;1,0;9,0;4,0;;129,0;;1,0;;;4,0;;;;;;;;2,0;;87,0;;;;;;;;;;;;;;;;;1,0;;;;2,0;;;;;;;;9,0;;;;1,0;2,0;11,0;;;;;;;;;;9,0;;;1,0;;;;;;;2,0;;2,0;;;;;;;;33,0;;;;;;;3,0;;;;;;2,0;53,0;;;;;;1,0;;;;;;;;;;;;1,0;;;;;;6,0;;;;;;;;;33,0;;;;;;;;;;;;;;;;;;;;;;;;;;;;;;62,0;1,0;;;5,0;;;;2,0;;;;2,0;2,0;;;;;;;;;;;;;;;8,0;;;8,0;5,0;;2,0;15,0;;;;;7,0;;;;;2,0;6,0;;;;;;20,0;1,0;;;;;;;;1,0;;;;5,0;8,0;;;;13,0;;;2,0;;;;2,0;;;;1,0;;;;;7,0;;;;;;;;;;;;;;;;;;;;;;;;;;;;2,0;;;;;;;;3,0;;;;;;;14,0;;;;;;;;;4,0;;;;;;;;;;;;;;;;;;;;;;;;;;;;;1,0;;;;;;2,0;;;;;;;;;;;;;;;;;;;;;;;;;;;45,0;;;;;;;;;;;;;;;;;;;;;;;;;;;;;;;;;;;;;;;2,0;1,0;;;;;;;;;;;;;;;;;;;;1,0;;;;;;;;;;;;
articulate;;;;;;;;21,0;;6,0;;;;;4,0;11,0;;;;;;;;;;;;2,0;;;1,0;;6,0;;4,0;;;;;11,0;1,0;;;;;;;1,0;1,0;;2,0;1,0;;;1,0;;5,0;;;;6,0;;;;;;;5,0;;;;;;;;1,0;;;;;;1,0;;5,0;;;;;;;16,0;;;;;;;;4,0;;;;;;;;2,0;1,0;;;1,0;;;;;15,0;8,0;3,0;;;;;;1,0;;;;;;2,0;;;;;;;3,0;;;;2,0;;;2,0;;;;1,0;1,0;;4,0;;;;1,0;;9,0;;;;;;1,0;;1,0;;5,0;;;;2,0;;;;;;3,0;;;;;1,0;;;;;;;;;;;;17,0;;;;;;;;;;;;;;;;;;;;;;;;;;;;;;;;;;1,0;3,0;;1,0;;;15,0;;1,0;8,0;1,0;1,0;1,0;;;;1,0;;;;;;;6,0;;;;;;;;;;;;;1,0;;;3,0;;;;;1,0;;;;;;3,0;;;;;;;;1,0;;;;;;;;;1,0;;;;3,0;;;;10,0;;;;;;;;;;;;1,0;;;;;23,0;;1,0;;8,0;;;;;;;4,0;;;;;;;;;1,0;;;;;;22,0;2,0;1,0;;;;;;;;1,0;1,0;;;;;;;;;9,0;;;;;;;;;;2,0;;7,0;5,0;5,0;;;1,0;1,0;;;;;;26,0;;;;;;;49,0;;;;;;;;;;;;;;1,0;;;;;;;;;;;2,0;;;;;;;;;;;1,0;;;;;;;;;2,0;5,0;;;4,0;;;1,0;;;;;;;;;;;;2,0;;;;;;;;;15,0;;;;;3,0;;;;;;1,0;;;2,0;;;;;;;;;;;;;;;;;6,0;;;;1,0;1,0;;;;;;;;;;;;;;;;;6,0;;;;;;;3,0;;;;;;;;;;;;;;;;5,0;;;;;;;;;;;;4,0;3,0;;;;;;;;;;;;;;;;;1,0;;;;;;;;3,0;;;;;2,0;;;;;;;;;;;1,0;16,0;;;;;11,0;;;;;3,0;;;;;;;;;;;;;;;;;;;;;;;;;;;;;;;;;;;;1,0;;;;;;;8,0;1,0;;;;;;;;;2,0;;;;3,0;;;;1,0;;;;;;;;1,0;;;7,0;;;;;;;;;;;;;;;;;;;;;;;;;2,0;;;;;;;;;;;;;;5,0;;2,0;;;;;;;;;;;;;3,0;;;;;;;;;;;;;;1,0;;;;;;;;;;;;;;;;;;;;;;;;;;;;;;;;;;;;;;;;;;;1,0;;;;;;;;;;;;;;;;;;;;;;;;;;;;;;;;;;;;;;;;;;;;;;;;;;;;;;;;;;;;;;;;;;;;;;;;;;;;1,0;;;;;;;;;;;2,0;;;;;;;;;;;;;;;;;;;;;;;;;;;;;;;;;;;;;;;3,0;1,0;;;;;;8,0;;;;;;;;;;;20,0;;;;;;;;;;;;;;;;;;;;;;;;;;;;;;;;;;;;;;;;;;;;;;;;;;;;;;;;;;;;;;
capacitor;;;;;;;;2,0;;1,0;;;;;;8,0;;;;;;;6,0;;;;1,0;1,0;;;;;11,0;;37,0;;;2,0;;;1,0;;;;;;1,0;9,0;2,0;8,0;41,0;;;;;;43,0;;;;1,0;;;;;;;13,0;;1,0;;;1,0;;;1,0;;;1,0;9,0;;49,0;;19,0;;;1,0;;;;5,0;;;;1,0;;62,0;;4,0;;;;5,0;;;;;;27,0;;5,0;35,0;;;27,0;14,0;2,0;1,0;17,0;12,0;;;;5,0;;;;;;;;18,0;;;;;7,0;;5,0;;;;;1,0;;;;5,0;96,0;;;1,0;4,0;8,0;16,0;22,0;9,0;;;15,0;;;65,0;;;;;7,0;;;;;;2,0;;1,0;;;;;12,0;22,0;;;80,0;14,0;;4,0;;;;;;74,0;;;;;;;1,0;;9,0;14,0;;;29,0;5,0;;25,0;;;2,0;30,0;;;1,0;;;;9,0;;;;;;1,0;;25,0;;7,0;;2,0;6,0;2,0;;2,0;;;1,0;10,0;;;;;2,0;11,0;;9,0;;;;;;;2,0;20,0;;;;;;;1,0;4,0;;1,0;;;;;2,0;5,0;;;;1,0;;;1,0;17,0;;22,0;;;2,0;;;;;;;;;;;;;14,0;;;1,0;;;;;6,0;;1,0;;;2,0;1,0;;1,0;2,0;;;;14,0;;;;;;;;;;;;;;;;;2,0;;10,0;2,0;;;;1,0;;;;;12,0;;;3,0;;5,0;1,0;;;1,0;;;;;;;;;;1,0;;;;;;;;;1,0;;;;;;;;;1,0;;;;;;;;;;;;;;;;;;;;;;;;;5,0;;;;;;;;;;;;;;;;;;;;;37,0;1,0;;;;;1,0;2,0;;;;;;;1,0;1,0;;7,0;2,0;;;;;;;;;;;1,0;;;1,0;;;;;;;;;;;;;;;26,0;;;;;;;;;;;;4,0;;;;;;;;;;;;;;;;1,0;;3,0;;;;;;;1,0;;;2,0;;;;;;;;;;;;;;;5,0;;;;;;;;;;;;;2,0;;;;;;;;;;;3,0;;;;;4,0;;;;;;;;;;;;;;;;;;;;;;6,0;1,0;;;;;;;3,0;;;;;;;;;;;;;;;;;;;;;;3,0;;;;;;5,0;;;;;;18,0;;;;11,0;;;;;;;;;;;;;;;;;;;;;;16,0;17,0;;;;6,0;;;3,0;;;1,0;8,0;;;;;;1,0;;;;;;;;;;;;;1,0;;;;;;;;;;;;;;7,0;;;;;;;;;;12,0;;;;2,0;;;;;;;;;;10,0;;;;2,0;;7,0;;;;;1,0;;6,0;;;;;2,0;;;;2,0;;;;;;;;;;;1,0;4,0;;;;22,0;;4,0;17,0;;;;;24,0;3,0;;;2,0;;;1,0;;;;;;12,0;;;;;;;;4,0;;;;21,0;11,0;;10,0;;;;;;;;;;;;;;;;7,0;;;;;;;;;;;2,0;;;15,0;;;;;;;;;;1,0;;1,0;;;;;;;;;;;;;;;;;;;;;;;;;;;;;;;;;;;1,0;;1,0;;;2,0;;;;;;;;;;;;;;;;;10,0;;;;;;;;;;;;;;;;;;;;;;3,0;;;;;;1,0;;;;;1,0;;;;;;;;;;;;;;;;;;;;;2,0;;;;;1,0;;;;;;;;;;;;;;;;;;;;;;;;;;;;;;;;;;;;;;;;;;;;;;
capsule;;;;;;;;140,0;;;5,0;;4,0;;;16,0;;;;;;19,0;;3,0;;;;2,0;;;;1,0;;;40,0;6,0;;;;;19,0;;;;2,0;7,0;6,0;1,0;3,0;;1,0;;;;;;1,0;;;;;4,0;4,0;;;;;5,0;33,0;;2,0;;;;;2,0;;6,0;5,0;49,0;;2,0;;21,0;;;;;;;2,0;;;;;;24,0;;42,0;;;;35,0;;;;;;;;;6,0;;;;17,0;4,0;1,0;14,0;;;;2,0;9,0;1,0;;;;;;;;;;;1,0;4,0;;2,0;;;;4,0;26,0;;;;;;;;;11,0;5,0;;;33,0;;;;;5,0;5,0;2,0;;;4,0;4,0;;;;;;;;;2,0;;;;16,0;4,0;4,0;;;1,0;;;;;2,0;6,0;;;;;;;;;;;2,0;;;;;1,0;;;;;;;;;;;;;7,0;;1,0;;;;;;19,0;;5,0;;;;;7,0;1,0;;3,0;1,0;2,0;;;;;4,0;;;1,0;;;;;;;;11,0;;;;;;;11,0;;;;;;;;14,0;4,0;;;1,0;;;2,0;1,0;3,0;;;;2,0;9,0;;;;;;;;;7,0;;2,0;;4,0;1,0;;;1,0;;;1,0;;;;;;;15,0;;;;;;;2,0;;;1,0;;;;;;;10,0;;;;1,0;;;;;;;;;;1,0;;11,0;;;;;;;;;;;;;;;1,0;;;;;;;;;;;;;;;;;;2,0;;;;;;;1,0;;;;;;;1,0;;;2,0;;;1,0;;;;2,0;;;;;;;;3,0;;;;1,0;;;;;;;;;1,0;;;4,0;;;;;;6,0;;;;;6,0;32,0;;;21,0;;;;10,0;22,0;;;6,0;;;;;;;;;;;2,0;;;;;;28,0;;14,0;2,0;;;;3,0;;;3,0;;;;;;;;6,0;1,0;1,0;8,0;;;;17,0;;;1,0;;;;;;2,0;;;;;;;;;;;;;;;;;;;;;3,0;;;;;;;;;;;;;4,0;;;;;;;;;2,0;;;1,0;;;;;;;;;;;22,0;;;;;;;;;;4,0;;;;;;;;1,0;;;;;2,0;;;;1,0;;;;;;;;;10,0;;;;;;;;;;;5,0;43,0;;;;;;;5,0;;;;;;;;;;;;;;;;;;;;;;;;;;;4,0;;;;;;;;;;;;23,0;;;;;;;;;;;;2,0;;;;;;;;;;;;2,0;;;;;;;;;;;;;;;;;;;;;;;1,0;;;;;;;;;;;;;;;;;;;;;;;;;;;;;;;;;;;;;;;;;1,0;;;;;;;;;;;;;;1,0;2,0;;;;;;;;;;;;;;;;;;4,0;;;;;;2,0;1,0;;;;;1,0;;;;;;;;4,0;;;;;;;;3,0;;1,0;;;;;;;;;;;;;;;;;;;;;;;;;;;;;;;;1,0;;;;;;;;;;;;;;;;;;;;;;;5,0;;;;;;;;;;;;;;;;;;;;;;;;;;;;;;;;;;;;;2,0;;;;;4,0;;;;;;;;;;;;;;;2,0;;;;;;;;;;;1,0;;;;;;;;;;;;;;;;;;;;;;;;;;;;;;;;;;;;;;;;;;;;;;;;2,0;;;;;;;;;;;;;;;;;;;;;;;;1,0;;
card;;;;;;;;4,0;3,0;1,0;2,0;;10,0;1,0;;;;3,0;;;;14,0;;20,0;;;;1,0;6,0;;3,0;;18,0;;17,0;;;;6,0;;47,0;;8,0;1,0;;;6,0;37,0;22,0;13,0;;;;;;;4,0;;;;;2,0;;6,0;;;5,0;6,0;;;;2,0;1,0;;;;8,0;7,0;11,0;63,0;10,0;3,0;1,0;21,0;;9,0;;;2,0;;;;;;;4,0;151,0;;17,0;4,0;1,0;;22,0;1,0;;2,0;1,0;;2,0;;;2,0;;;;29,0;4,0;;1,0;2,0;;;;9,0;11,0;8,0;;;;3,0;;;;;5,0;;;3,0;;;;;;5,0;;;;4,0;10,0;3,0;;;9,0;18,0;1,0;;19,0;;;1,0;1,0;6,0;8,0;;;;;1,0;;;;;;;4,0;1,0;;1,0;;;1,0;;;;;2,0;;5,0;;;;;;3,0;;;;;;3,0;;;;;;;;;;;;;;;;;;;;;;;3,0;;;;;;7,0;;;;;6,0;;;5,0;6,0;;3,0;;4,0;;9,0;;;;1,0;2,0;;;;;;;;19,0;4,0;;;;;7,0;;;;6,0;;;;;1,0;2,0;;;;;;3,0;25,0;;;;;;;;;;;;2,0;;;;;;;;;;;;;;;;;;;;;;;;;;3,0;;8,0;;;;;;1,0;;;;;;;;;;4,0;;;;2,0;;;24,0;6,0;1,0;;;;;5,0;;1,0;;;;;;;;;2,0;;;;;;;3,0;;;;;;;;;;;;;;;3,0;;;;;;;;;;;1,0;;5,0;;;;;;;1,0;;;;;;;2,0;;2,0;1,0;;;;;;;;;;11,0;4,0;;;;5,0;;5,0;;5,0;;7,0;;;;;;;2,0;;;6,0;1,0;;;;;1,0;;;;;;34,0;2,0;;;;20,0;;3,0;5,0;;;;;;;;;;;4,0;1,0;;;;1,0;;3,0;1,0;3,0;2,0;;;;;4,0;;;;;;;;;11,0;;;;;2,0;;;;;5,0;;;1,0;;7,0;;;;;;;9,0;;;;;;;;3,0;;1,0;;2,0;;;;;;;;;;;;;;;;;;;;;;1,0;;;1,0;;;;1,0;;;;;3,0;12,0;;;;1,0;1,0;;;;;;;18,0;;;;;16,0;;;;;;2,0;;;;;1,0;1,0;;;;;;3,0;;;4,0;;;;;1,0;;2,0;;;;;1,0;1,0;1,0;;;4,0;;1,0;;9,0;1,0;23,0;;;;;;3,0;;2,0;35,0;;;;;;;2,0;2,0;;;;;;2,0;;;;;;;;1,0;;;;3,0;;;;;;;;;;;;;;;;;;;;;;;;;;;;;;;;;;;23,0;;;;;;;;4,0;;;6,0;;;;;;;2,0;;;;;;;;;;;;;;;7,0;;;;;;;;;;;;;;3,0;;;;;;;21,0;;;;;;;;;;;;1,0;;;;;;;;;15,0;;;;;;;;;;;;;7,0;;;;;;;;;;;;;;;;;;;1,0;;;;4,0;;;;;;;;;;;;;;;;;;;1,0;;;;;;;;;;;;;1,0;;;;;;1,0;;;;;26,0;;1,0;;;;;;;;;;;;;;;;;;;;;;;;;;;;;;;;;;;;;;;;;;;;;;;;;;;;;;;;;;;;;;;;;;;;;;;2,0;;;;;;;;;;;;;;;;;;;;;;;;;;;;6,0;;;;1,0;;;;;;;;;;;;;;;;;;;;;;;;;;;;;;;;;;;5,0;;;;;;;
carriage;;;;;;;;2,0;;2,0;;;;;9,0;3,0;;;;;;;;;;;;;;;;;1,0;;;;;;;;;;;;1,0;;;5,0;2,0;;4,0;1,0;;;5,0;1,0;5,0;;;;;;1,0;;;;;;1,0;;;;4,0;;;;;;;;;5,0;;3,0;;;;;2,0;;19,0;;;;;;;;2,0;;;;;;;4,0;13,0;;;;;;;;;;;7,0;;;;;;;;;;;2,0;;;;15,0;;;;8,0;;;;;;;2,0;;;;;;;;;;;;;17,0;;;;;;;;;;2,0;1,0;;;;;;;;;30,0;;;;;17,0;;;;;;;;;;;;7,0;;;;;;;;;;4,0;;;;;;;;;1,0;;;;;;;;;;;;;4,0;;;4,0;;10,0;;;33,0;7,0;1,0;5,0;;;;;;;;;;;;;;;;;;;;1,0;;;;;;;;;;;;;;2,0;8,0;2,0;;;;;;;4,0;;;;;;;;;;;;;;;;;;;;;;;9,0;;;1,0;;1,0;1,0;;;;;;;;;;;10,0;;;;;;;;;;;;;;;;;;;;;;;;;;11,0;;2,0;2,0;;;;;;;6,0;;;;;;;;;;;;;;;;;;;;;6,0;2,0;1,0;2,0;;;;3,0;;;;;;18,0;;;;3,0;;;4,0;;;;;;;1,0;;;;;;;;;;;;;;;;;;;;;;;;;;;;;;7,0;;;;;;;;;7,0;;;;;;3,0;;;;;;;;;;2,0;;;;;;;;;;;4,0;;2,0;;;;;;;;;;;;;;;;;;;;;;;;;;;;;;;;;;;;;;;;;;;;;;;;;;;;;;;;2,0;;;;;;1,0;;1,0;;;;;;;;;;;;;;;;;;;;;;;;;;2,0;;;;;;2,0;;;;;3,0;;;;;;;;;;;;;;;;;;;;;;2,0;;;;2,0;4,0;;;;;;;;;;;;;;;;;;;;;;;;;;;;;;;;3,0;;;;;;;;;;;;;;;;5,0;;;;;;;6,0;;;;;;;;;1,0;;;;;;;5,0;4,0;;;;;;;;1,0;;;;;;;;;;;;;;;;1,0;;;;2,0;;;;;;;;;;;;;;;;;;8,0;;;;2,0;;;;;;;;4,0;;;;;;1,0;;;;;;;;;;;;;;;;;;;;;;;;;;;;;;;;;;;;;;;;;;;;;;;;;;;2,0;;;;;;;2,0;;;;;;;;;;;;;1,0;;;;;;;;;;;;;;;;;;;;;;;;;;;;;;3,0;;;;;;;;;;;;;;;;;;;;;;;;;;;;;;;;;;;;;;;1,0;;;;;2,0;;;;;;;;;;;;;;;;;;;;;;;;;;;;;;;;;;6,0;;;4,0;;;;1,0;;;;;;;;;;;;;;;;;;;;;;;;;;;;1,0;;;;;;;;;;;;;;;;;;;;;;;;;;;;;;;;;;;;;;;;;;;;;;;;;;
cleaning;;;;;;;;13,0;1,0;1,0;;;3,0;;;1,0;;;;;;2,0;;7,0;;;;;;;;1,0;20,0;;;;;;4,0;;;;1,0;;2,0;;22,0;33,0;;1,0;1,0;;;;3,0;;4,0;;1,0;;;5,0;;;;;1,0;;;9,0;;;1,0;;;;6,0;;;7,0;;;;28,0;;;;;;;33,0;;;2,0;;;;;61,0;1,0;;;12,0;;;;4,0;;;;;29,0;;;;1,0;16,0;2,0;8,0;2,0;;;2,0;26,0;;;;;;;;;;18,0;;;2,0;;;2,0;;;;1,0;;;;12,0;1,0;;;;;1,0;;;28,0;;1,0;2,0;;;;;;;;1,0;;;;;;4,0;;;15,0;;;;1,0;12,0;;13,0;;;1,0;5,0;;;;;;5,0;;;;;;;;;;4,0;;;;;;1,0;1,0;;;;;;1,0;;2,0;57,0;3,0;;;2,0;;;;;3,0;;2,0;;6,0;13,0;;5,0;2,0;2,0;2,0;2,0;;;;2,0;;;;;;;;;;;1,0;;2,0;2,0;;;;;;;;;;;;;;;2,0;;;;;;;9,0;;;;;;66,0;;;;1,0;15,0;;;;;7,0;;;;;;2,0;5,0;;;;;;;;;;;;2,0;;;;;;1,0;;;;1,0;;3,0;;;;;;;41,0;;;2,0;;2,0;5,0;;;13,0;;;;;3,0;;;;;;;;;12,0;1,0;;;;;;;;;;;;;;;;;;;;1,0;5,0;6,0;;;;;;;2,0;;;1,0;;11,0;;;;;1,0;;;;;;;3,0;;;;;;;;;;;;;;;;;;;;;;;;1,0;;;;;;;2,0;;;;;;2,0;;8,0;;;3,0;25,0;;;13,0;;;;;;;1,0;;;;;;;;;;;4,0;;;;3,0;;;;1,0;;;;1,0;1,0;;;1,0;;;1,0;;;;;;;2,0;;;;;;;2,0;;;1,0;;;;;;;;;;;;;21,0;;;;;4,0;;;;;;;;;;;;;;;;;;;;5,0;;;;;;;;;;;;;;51,0;;;;;;;;;;;;;;;;;;;;;;5,0;;;;;;;;;;;2,0;;;;;1,0;;;;;;;2,0;;;;;1,0;12,0;1,0;;;;;;;;;;;;;;;;;;;5,0;;12,0;8,0;;;;;;1,0;;43,0;;;;;7,0;;;;;1,0;;;;;;1,0;;;;;;;;;;;;;;;;;;;;;;;;;;;;;21,0;;;;;;;2,0;;;;;;3,0;;;;;;;;;;;;;;;;;;1,0;;;;2,0;1,0;;;;;;;;;;;;;;;;;;14,0;;;;;;;;;;;;;;;;;15,0;;;;;;;;;;;;2,0;;;;;;;;1,0;;;;;;;;;;;;;;;;;;;;2,0;;;;;2,0;;;;;;;;;;;;;;;;;;;;;;;;;;;1,0;11,0;;;;;;;;;;3,0;4,0;;;;;;;;2,0;2,0;;;;;;;;;;;;;;;;;;;;;;;;;;;;;;;;;;;;;;;;3,0;;;;;;;;;;;;;;2,0;;;;;;;;;;;;;;;;;;;2,0;6,0;;;;;;;;;;;;;;;;;;;;;;;;;;;;;;;;;;;;;;;;;;;;;;;;;;;;;;;;;;2,0;;;;;;;;;6,0;;;;;;;;;;;;
compress;;;;;;;;24,0;;2,0;;;;;1,0;23,0;;;;;;21,0;;1,0;;9,0;9,0;;;;1,0;1,0;55,0;;2,0;5,0;3,0;1,0;;;325,0;;;;1,0;;2,0;48,0;68,0;12,0;1,0;;;;;;3,0;;;;3,0;4,0;1,0;53,0;7,0;;;8,0;58,0;;2,0;;36,0;4,0;;7,0;1,0;;;365,0;;3,0;;39,0;3,0;;;;;1,0;15,0;;;;;2,0;57,0;;54,0;;;1,0;15,0;3,0;;9,0;17,0;5,0;50,0;4,0;;8,0;;;;41,0;19,0;1,0;2,0;15,0;1,0;;2,0;21,0;13,0;1,0;;;;4,0;;;;;8,0;13,0;1,0;;51,0;2,0;2,0;;;3,0;2,0;;;1,0;25,0;3,0;;2,0;17,0;89,0;;;35,0;;;7,0;;14,0;53,0;1,0;;;86,0;1,0;;;2,0;4,0;1,0;;1,0;2,0;1,0;1,0;;;1,0;2,0;;6,0;;9,0;;19,0;;;;78,0;;5,0;;2,0;10,0;;;5,0;;;;3,0;;2,0;4,0;;4,0;;;;1,0;;;;;;2,0;1,0;7,0;;4,0;;;2,0;;;1,0;;19,0;1,0;1,0;4,0;;2,0;1,0;6,0;;;;;1,0;2,0;;;;2,0;31,0;;4,0;;;;1,0;22,0;8,0;;;;4,0;;2,0;5,0;;;;;7,0;;1,0;;1,0;;;13,0;;;1,0;5,0;1,0;1,0;1,0;;6,0;6,0;;;;;;1,0;1,0;;;;;;;;4,0;5,0;;;1,0;1,0;7,0;4,0;;;2,0;4,0;4,0;;1,0;;;7,0;1,0;5,0;;;;;4,0;;;;;;;;;1,0;;1,0;;;3,0;5,0;1,0;;5,0;;;;;4,0;;;;;;1,0;4,0;;;6,0;1,0;1,0;1,0;;;;;;;5,0;;;;2,0;;;1,0;2,0;7,0;;;;1,0;3,0;7,0;;3,0;;6,0;4,0;;;1,0;5,0;;;3,0;6,0;;;;;;;4,0;1,0;;;;;;;4,0;10,0;;;2,0;1,0;;;3,0;;;;;2,0;;4,0;;1,0;;;;23,0;2,0;2,0;1,0;;;;5,0;;;5,0;4,0;;;1,0;6,0;;;6,0;1,0;;;;20,0;33,0;;1,0;;;;;;3,0;;;;;4,0;;;;;;2,0;;8,0;;;;2,0;;;2,0;;;;;;;;;2,0;2,0;;;;;5,0;;;;;1,0;2,0;;;;17,0;2,0;10,0;;;;18,0;;;;;;;;;;;;;;;3,0;4,0;;;;;;2,0;;;;;;8,0;2,0;;5,0;3,0;2,0;;1,0;;1,0;;1,0;;;;;;2,0;;;2,0;;;;1,0;3,0;2,0;12,0;11,0;;;;;2,0;;1,0;4,0;3,0;;1,0;;;3,0;;;;;4,0;;;;;;;2,0;1,0;;2,0;3,0;;;;3,0;5,0;1,0;;;;;;;;;;;;1,0;;;1,0;;;;4,0;2,0;;2,0;;;;19,0;1,0;2,0;;;;;;3,0;1,0;;1,0;;;;;1,0;;;2,0;;1,0;1,0;1,0;;2,0;;2,0;3,0;;;;4,0;;;1,0;;;;;;1,0;;;;;1,0;;;;4,0;;;1,0;;3,0;;;;2,0;;1,0;;;;;1,0;;;;1,0;;;;1,0;;;3,0;;;;1,0;;;2,0;;;;;1,0;;;;;;;;;;4,0;;;2,0;10,0;;;;;;;;;;;;;;;;;;;;2,0;;;1,0;;;;;3,0;;;;;;;;;;;;;;;;;;;;;;;;1,0;;2,0;;1,0;;;;;;;;;;;;;;;;1,0;;;;6,0;;1,0;;;;;;;;;;1,0;;;;;;;;;;;;;;;;;;;;3,0;2,0;;2,0;;;;;;6,0;;;;;;2,0;;;;;;;4,0;;;;;1,0;;;;;;;;;;;;;;4,0;;;8,0;;;;5,0;;;;;1,0;;;1,0;;;;;10,0;;;;;;;;;;;;;;;;;;;11,0;;11,0;;;;;;;26,0;;1,0;;;1,0;;;;;;;;;;;;;1,0;;;;;;;;;;;;;;;;;;;;;;;;;;;3,0;;;;;;;;;;;;;;;;;;;;;16,0;2,0
conductivity;;;;;;;;1,0;3,0;21,0;2,0;;;;;;;;;;;;2,0;5,0;5,0;;;;;;;;2,0;;;;;;;;;;;1,0;;1,0;;20,0;;;5,0;1,0;;;;1,0;7,0;;;;;;;;;2,0;;22,0;2,0;;;;;;;2,0;;;;;4,0;13,0;;26,0;;;;;;;;;;1,0;;;;;4,0;;;;;;;;;;10,0;;;;;;;5,0;5,0;1,0;;2,0;;;;;;;;;;;;;;;;;;;;;;;;1,0;;;;;4,0;;;;3,0;;;4,0;2,0;;;10,0;;;4,0;;;;;;;;;;;;;;;;6,0;;;1,0;;;16,0;3,0;;;4,0;;;;;14,0;;11,0;;;;;;;;3,0;;;;;;2,0;2,0;;;41,0;;;;3,0;;;6,0;1,0;3,0;;;1,0;18,0;;3,0;;6,0;3,0;6,0;1,0;;;;1,0;29,0;;;;;5,0;;4,0;;;3,0;2,0;1,0;;;;;;2,0;;;;;4,0;;;119,0;;;;;;;8,0;1,0;;;;;5,0;13,0;5,0;;;;;;;;3,0;;;;;;;;;;;4,0;;;4,0;;;;;;;;;;;;;;;;;;;;;;;;;;;;;;;;;;;;;;;;;;;;;;;;;;;;;;;;3,0;;;;;;;;;;;;;;;;;;;;;;;;;;;;;;;;;;;;;;;;;;;;;;;;;;;;;;;;;;;;;;;;;;;;;;;;;;23,0;4,0;;;;;;;;;;;;;;;;;;;;;;;;;;;;;;;;;;;;;;;;;;;;;;4,0;;;;;;;;;;;;;;;;;;;;;;;;;;;;;;;;;;;;;;;;;;;;;;;;;;;;;;;3,0;;;;;;;;;;1,0;;;;;;;;;31,0;;;;;;;;;;;;1,0;;;;;;;;;;;;;;;;;;;;;;;;;;;;3,0;1,0;;;;;;;3,0;;;;;;;;;;;;;;;;;;;;;;;;;;171,0;;;;;;;;;;;;;;;;;;;;;;;;;;;;;;;;;;;;;1,0;8,0;;;;;;;;;;;;;;2,0;;;;;;;;;1,0;;;;;;;;;;9,0;;;;;;;;;3,0;;;;;;;;;;;;;;3,0;6,0;;;;;1,0;2,0;;;;;;;;;;;;;;;;;;;;;;;;;;;;;;;267,0;7,0;15,0;15,0;;;;;;;;;11,0;4,0;;;8,0;;;;3,0;4,0;;;1,0;;;;;;;;;;61,0;;;;23,0;;;;;;;;;;;;;;;;;;;;;3,0;;;;;;;;;;;;;;;;;;;;;;;;;;;;;;;;;;;;;;;;;;;;;;;;;;;;;;;;;;;;;;;;;;;;;;;;;;;;;;;;;;;;;;;;;;;;;;;;2,0;;;;;;;;;;;;;;1,0;;;;;;;;;2,0;;;;;;;;;;;;;4,0;;;;;;;;;;;;;;;;;;;;;;;;;;;;;;;;;;;;;;;;;;;;;;;;;;
container;;;;;;;;3,0;;;;;;;;;;;;;;;;;;;;;;;;;;;;;;;;;;;;;;;;2,0;;5,0;2,0;;;;;;;;;;1,0;;;;;;;1,0;2,0;;;;;;;;;;;;;;;12,0;;;;;;;2,0;;;;;19,0;;;2,0;;;;8,0;;;;;;;;;;;;;4,0;;1,0;4,0;;;;;;;;;;;;;;;;;;2,0;;1,0;;;;;;;;;;;;;;5,0;;;2,0;2,0;;;;;;;;;;;;;;;;;;;;;;;;2,0;;;;;2,0;;2,0;;;;;;1,0;;;;;2,0;;;;;;;;;;;;;;2,0;;;;;;;;;;;;;;;;;;4,0;;;;;;;;;;;1,0;;;;;;;;;;;;;;;16,0;;;;;;;;;;7,0;;;;2,0;;1,0;;;1,0;;1,0;;7,0;;;;;;;;;;;;;;;1,0;;;;;;;;;;;;;;2,0;;1,0;;;;;;;;;;;;;;;;;;;;;;;;;;;2,0;;;;;;;;;1,0;;1,0;;;;;;;;;;;;;;;;;;;;;;;;;;;;;;;;;;;;;;3,0;;;;;;;;;;;;;;;;;;;;;;;;;;;;;1,0;;;;;;;;;;;;;;;;;;;;;;;;;;;;;;;;;;;;;;;;;;;1,0;;1,0;;;;;;;;;;;;;;;;;;;;;;;;;;;;;;;;;;;;;;;;;;;;;;;;;;;;;;;;;;;;;;;;;;;;;;;;;;;;;;;;;;;;;;;;;;;;;;;;;1,0;;;;;;;;;4,0;;;;;;;;;;;;;;;;;;;;;;;;;;;;;;;;;;;;1,0;;;;;;;;;;;;;;;;;;;;;;;;;;;;;;;2,0;;;;;;;;;;;;;;;;;;;;;;;;;;1,0;;;;;;;;;;4,0;;;;;;;;;;;;;;;;;;;;15,0;;;;;;;;;2,0;;;;;;;;;;;;;;;;;;;;;;;;4,0;;;;;;;;;;1,0;;;;;1,0;;1,0;;;;;;1,0;;;;;;;;4,0;;;;;;;;;;;;;;;;;;;;;;;;;;;;;;;;;;;;;;;;;;;;;;;;;;;;;;;;;;;;;;;;;;;;;;;;;;;;;;;;;;;;;;;;;;;;;;;;;;;;;;;;;;;;;;;;;;;;;;;;;;;;;;;;;;;;;;;;;;;;;;;;;;;;;;;;;;;;;;;;;;;;;;;;;;;;;;;;;;;;;;;;;;;;;;;;;;;;;;;;;;;;;;;;;;;;;;;;;;;;;;;;;;;;;;;;;;;;;;;;;;;;;;
converter;;;;;;;;4,0;8,0;28,0;7,0;;2,0;;3,0;5,0;5,0;;;;1,0;2,0;;5,0;;;6,0;1,0;2,0;1,0;1,0;;58,0;;25,0;1,0;1,0;6,0;1,0;;44,0;;;;2,0;5,0;1,0;37,0;58,0;3,0;15,0;3,0;;;4,0;;6,0;;;;2,0;;2,0;;4,0;;4,0;22,0;6,0;2,0;2,0;1,0;30,0;8,0;;27,0;;;2,0;103,0;;18,0;1,0;143,0;1,0;;;;;2,0;12,0;;5,0;4,0;;1,0;13,0;;13,0;;;;2,0;2,0;;;72,0;;79,0;;3,0;5,0;4,0;;9,0;52,0;5,0;6,0;33,0;6,0;;;7,0;5,0;3,0;1,0;;;1,0;11,0;;21,0;1,0;;1,0;;;;7,0;;4,0;;;20,0;;;;7,0;127,0;;;;1,0;13,0;;18,0;44,0;;;28,0;;;53,0;;;;6,0;;;;;;;4,0;6,0;2,0;;;;;;3,0;;;30,0;47,0;;1,0;;;;;;20,0;1,0;;;;;17,0;;;;5,0;;;2,0;;;4,0;16,0;;;8,0;;;;;;;6,0;2,0;2,0;;;7,0;4,0;;40,0;;27,0;;1,0;5,0;1,0;;;5,0;;;1,0;;2,0;6,0;1,0;;240,0;;130,0;;;8,0;;1,0;;;43,0;;;6,0;;;;7,0;31,0;;1,0;;;;;7,0;8,0;1,0;;;;1,0;13,0;7,0;19,0;3,0;6,0;;;30,0;;;;;4,0;;;;;;;;2,0;;;2,0;3,0;;;;1,0;;;;;;;;2,0;;;;;1,0;;;;;2,0;2,0;;;1,0;;;;;;;6,0;;1,0;6,0;;4,0;;;30,0;;2,0;1,0;1,0;3,0;3,0;1,0;;;4,0;;;;8,0;1,0;1,0;;1,0;;;;;10,0;;;1,0;6,0;;1,0;;;;3,0;;;;;1,0;;;;;;1,0;;;1,0;;;1,0;2,0;1,0;;3,0;;;;;;4,0;;;2,0;;;6,0;3,0;4,0;17,0;;;;;;;;;1,0;9,0;;;;;;;;;14,0;4,0;3,0;;1,0;;;1,0;;;;1,0;;;13,0;9,0;;;;;5,0;;1,0;11,0;4,0;;;;;5,0;;;;;;;;;;;;;;;1,0;;;51,0;;2,0;;;4,0;2,0;5,0;;;;;;;;2,0;;;;;29,0;;;;;;2,0;;;;9,0;;;;;;;;;;;;;;10,0;;;;;;;40,0;;3,0;;2,0;;;;;;;2,0;;;5,0;;6,0;1,0;;;1,0;1,0;;;;;3,0;;1,0;;;;;;1,0;;;;20,0;;;72,0;;;;2,0;;;;;;;;;;;9,0;;;;;;;;1,0;;;;;;1,0;11,0;;;;;;;;;;;;;;1,0;;;;;;7,0;1,0;;;;;29,0;;;;10,0;;;;;;8,0;;;;;;;;;;;3,0;;;1,0;;;3,0;;3,0;;;;;2,0;30,0;;;15,0;;;;;;2,0;;;;1,0;;;;;;;;;;;;;;11,0;;1,0;;;;;;;6,0;;;;;;;;;;;;;;;;4,0;;;;;;;7,0;;;;3,0;1,0;;;;;;2,0;;;2,0;;;;;1,0;;4,0;;;;;;;;;;;;;;5,0;;;23,0;4,0;;15,0;1,0;62,0;;;;16,0;2,0;;6,0;4,0;2,0;;11,0;3,0;;;;7,0;13,0;;;6,0;;;;;;;;;50,0;2,0;;;2,0;1,0;;;1,0;;;;;2,0;;;3,0;;;1,0;;2,0;;;3,0;1,0;;;;2,0;;;21,0;3,0;;;;;;1,0;;;;;;;;;;;;2,0;1,0;;;;;9,0;;;;;4,0;;;;;;;;;;;;;;;;;;2,0;;;;;;;;;;;;;;;;;;;;;;;;;;;;1,0;;;;;;;;;;;;;;;;;;8,0;;;;;;;2,0;;63,0;;;;;8,0;;9,0;;;;;;;;;;;;;;;;;;;;;;;;;2,0;5,0;1,0;;;;;;1,0;;;;;;;;;;;;;;;;;;;;;;;;;;;;;;;;
core;;;;;;;;18,0;;21,0;1,0;;;;2,0;;;;3,0;;1,0;;;;;;19,0;;;;;;4,0;;3,0;;;2,0;;;3,0;;1,0;;;2,0;;23,0;4,0;2,0;10,0;;;;1,0;12,0;15,0;;;;1,0;3,0;3,0;;14,0;;;31,0;4,0;5,0;;;5,0;;;;;;1,0;16,0;;1,0;;35,0;;;;;;1,0;37,0;;;8,0;;1,0;;;19,0;;;;12,0;1,0;;1,0;25,0;;12,0;;;27,0;;;;7,0;46,0;2,0;1,0;4,0;;;36,0;10,0;3,0;1,0;;;1,0;;;;;;;;1,0;;;;;;;;;;5,0;4,0;6,0;;;1,0;1,0;;5,0;3,0;6,0;;;;;;67,0;;;;2,0;1,0;;1,0;;8,0;;2,0;9,0;;43,0;;1,0;;3,0;10,0;;;2,0;5,0;;3,0;2,0;;;;11,0;1,0;1,0;13,0;;;;4,0;1,0;1,0;17,0;4,0;;2,0;1,0;;6,0;10,0;10,0;;2,0;;;;;2,0;;;20,0;;;;;;56,0;;3,0;4,0;23,0;1,0;;5,0;;;;2,0;15,0;;3,0;3,0;1,0;;;5,0;;;1,0;;9,0;;;;1,0;;3,0;;;9,0;;23,0;1,0;;;;;;6,0;5,0;;;3,0;;;;;1,0;1,0;24,0;1,0;;;;;;;;;2,0;;;;;;;;;;;;;;;5,0;;;;5,0;;;2,0;;;;;;;;3,0;;;;7,0;5,0;;;;;;;6,0;1,0;;;;;;1,0;1,0;;;;1,0;;1,0;;3,0;4,0;;2,0;;;6,0;;;;;;2,0;;;;;;;;3,0;1,0;;;;;;;;;18,0;8,0;;;;1,0;;;1,0;;;;;;;;;;1,0;;;;;;;;;;;;;;;6,0;;2,0;;3,0;;;;;;;;4,0;;;;;;;;;;;1,0;;;;;4,0;;;;;;;2,0;2,0;;;;;;;;;;;;;;3,0;;;;1,0;;;;8,0;;;;;;1,0;;;;3,0;;11,0;1,0;;2,0;;;;;;;;;;;;;;1,0;1,0;;3,0;;;1,0;;;;;;;;1,0;;;;;;6,0;2,0;;;;;1,0;;;;;;;;6,0;;;;;;;;;;41,0;;;;;;;;;;;;1,0;;;;;;;;;;;;1,0;;;;;;;;4,0;;;1,0;2,0;;;;;;;;;;;2,0;;;;;2,0;5,0;;;;2,0;;;;1,0;;;1,0;;;;;;;;3,0;;;;;;;;;;;;;;;;1,0;;;;2,0;;;2,0;;;;1,0;;;;;;;;;1,0;;1,0;;;;;;;;;;;;;;;;2,0;1,0;;;2,0;;;;;;1,0;;;;;;1,0;;;;;;;;;;;;;;;1,0;;;;;;2,0;;1,0;3,0;;;;;;1,0;;;;;7,0;;;;;;;34,0;;;;3,0;;;;;1,0;;2,0;;;1,0;;4,0;1,0;;;13,0;;;;;;;;;5,0;2,0;;;4,0;;;;;;;;;;;;;;;1,0;;;;;;;;;;;;;;;;;;;;;;;;;;;;;2,0;;;;;;;;;;;;;;;;;;;;;;;;;;1,0;;;;;;;;;;;;;;;;;;;;;;;;;;;;;;1,0;;;;;;;;;;;;;;1,0;;;;;;;;2,0;;;;;;;;;;;;;;;;;;;;;;;;;;3,0;;;;;;;;1,0;;;;;;;;;;3,0;;;;;;;;;;4,0;;;;;;;;;;;;;;;;;;;;;;;;;;;2,0;;;;;;;;;;;;;;;;;;;;;;;;;;;;;;;;;;;;2,0;;
correlate;;;;;;;;4,0;3,0;;1,0;;;;;3,0;;4,0;2,0;;1,0;7,0;;;;3,0;5,0;1,0;;;1,0;1,0;10,0;;4,0;2,0;1,0;;;;59,0;;;;6,0;;1,0;11,0;3,0;11,0;;;1,0;;;9,0;3,0;;;;;;6,0;;;1,0;1,0;;4,0;;4,0;;4,0;;;;8,0;;2,0;80,0;;10,0;;8,0;;1,0;;;;1,0;4,0;;;;;;1,0;;13,0;2,0;;;5,0;4,0;;;1,0;1,0;3,0;;;11,0;;;1,0;16,0;5,0;11,0;;8,0;;;;26,0;1,0;1,0;;1,0;1,0;1,0;;4,0;;;;;2,0;24,0;19,0;;;;4,0;2,0;;;;8,0;16,0;2,0;2,0;;1,0;13,0;;;8,0;;2,0;;;;2,0;;;;5,0;11,0;;1,0;2,0;;;1,0;4,0;1,0;;;1,0;;;1,0;;;;10,0;;;;;;;;4,0;;;;;;1,0;;;2,0;1,0;;;;;7,0;;;;;;;;;;;;;1,0;;;;;;;1,0;;;;;;;;3,0;;;;1,0;;;;;;;;1,0;;;;;;;;;;;;;;;5,0;;;;;;;;2,0;;;;;;;;;;;;;;22,0;2,0;;1,0;;1,0;;;;;;;;;;;;;;;;;1,0;;2,0;;;;;;;;;;;;;;;;;;;;;;;;;;1,0;;;;;;;;;;;;;;;;;;;;;;13,0;;;;;;;;;;;;;;;;;;;;;;;;;;;;;;;;;;5,0;;;;;;;;3,0;2,0;;1,0;1,0;;;;;;2,0;2,0;;;;2,0;;;;;;5,0;;3,0;;;;1,0;2,0;;1,0;;13,0;;;7,0;;;;3,0;;1,0;3,0;;;;4,0;2,0;;;;2,0;;;;;;;;;;3,0;;;;;;;;2,0;1,0;;;5,0;1,0;1,0;1,0;;;;;;;;;1,0;;;;;1,0;;3,0;7,0;1,0;;;;;;1,0;;;;;;;3,0;;6,0;;2,0;;;;;1,0;;;;;1,0;;;;;3,0;2,0;;;;;;;1,0;;;;;;2,0;;;;;;1,0;;;;4,0;;;;;13,0;3,0;;;;;;;;4,0;;;;;;;;5,0;;;;;;;;;1,0;;2,0;;;6,0;;;;;3,0;1,0;;;;;;;;;;;;;;;;;;1,0;;;;;;;;;;;;;;1,0;;;2,0;;;;;;;;;;;;;2,0;;;;6,0;;;;;5,0;;;;;;1,0;;;;;;;;;;;4,0;;;;;;;;;;;;;;;;;;;;;2,0;6,0;3,0;;;;;;;;;;;;;;;;;;7,0;2,0;;;;;2,0;;;;;;;;;;;;;;;;;;;;;;;;;;;;;;;7,0;;;;;;;;;;;;;;;;;;;;6,0;;;;2,0;;;2,0;;;;2,0;;;;;;;;;;;2,0;2,0;;;1,0;;3,0;;;;;;;1,0;;;;;;;;;;5,0;2,0;;;;;;;;;;;;;;;;;;;;;;;;;;;;;;1,0;;;;;5,0;;;;;1,0;;;;;;;;;1,0;;;;;;;;;;;;;;;;;;;;;;;;;;;1,0;;;;;;1,0;;;;;;;15,0;;;;;;;;;;;;;;;;2,0;;;;;;;;;9,0;;1,0;;;;;;;;;;;;;9,0;1,0;;;;;;;;;;;;;;;;;;;;;8,0;3,0;;24,0;;;;;;;;;;;;;;;;;;;;;;;;;;;;;;;;1,0;;;;2,0
counter;;;;;;;;3,0;;16,0;4,0;;7,0;11,0;;18,0;;;;;;;;;;;2,0;;;;;;72,0;;37,0;4,0;3,0;7,0;;;19,0;2,0;1,0;;7,0;1,0;5,0;24,0;7,0;8,0;16,0;3,0;;;6,0;;11,0;;1,0;;5,0;;;;2,0;;2,0;4,0;;1,0;28,0;;20,0;;;6,0;;;1,0;39,0;;15,0;;71,0;2,0;;;;;;;;10,0;;;;13,0;;12,0;;;;1,0;;;5,0;;2,0;135,0;;;19,0;;;6,0;100,0;11,0;4,0;4,0;26,0;3,0;;1,0;8,0;1,0;;;;;;;17,0;4,0;;;;13,0;3,0;2,0;;;;;12,0;1,0;;;15,0;141,0;;;;;7,0;1,0;7,0;9,0;;;1,0;;;14,0;;4,0;;;;;;;;;4,0;3,0;6,0;2,0;2,0;;;;;;;2,0;80,0;;;;;;;;24,0;;;;;;2,0;;;3,0;7,0;;;8,0;;2,0;;;;;;;;;;;5,0;2,0;;;;;;14,0;1,0;3,0;;;;;5,0;6,0;;3,0;;;1,0;;;;;14,0;;2,0;1,0;41,0;;1,0;;;;1,0;19,0;9,0;;;;;;;3,0;2,0;;;;;;;;;;;;16,0;;;;26,0;;;;;62,0;;;;;;;;;;;15,0;;1,0;;1,0;;3,0;;;;;2,0;2,0;;;;3,0;;;1,0;;;;3,0;;;;;1,0;;;;;1,0;;;;;;8,0;;;10,0;;;;2,0;;1,0;;;2,0;;;;;;21,0;;;;1,0;;1,0;;;;;;;3,0;;;;4,0;;;;;;;;5,0;;1,0;;;;;27,0;;;;1,0;;;;2,0;4,0;;;2,0;;;;;;;;;;;3,0;1,0;11,0;21,0;1,0;;;3,0;;;;1,0;;;;17,0;3,0;;;;;;;38,0;22,0;;;;;8,0;28,0;;;;2,0;;;19,0;38,0;;;7,0;;;;;;;;;1,0;;1,0;;;;;;;;4,0;;;;11,0;3,0;4,0;;;;33,0;;;;;;;147,0;;;;;;;;;1,0;;;8,0;;;2,0;;;;2,0;;;;19,0;;;2,0;;;;2,0;;;;;;4,0;1,0;6,0;;;;2,0;;;;22,0;;8,0;;;4,0;15,0;;;;;;;;;;;5,0;;2,0;;;;16,0;2,0;;;;;;1,0;;;;;;1,0;;;7,0;;1,0;;;1,0;;;;;;;;;;;;;;;;;1,0;;3,0;;;;1,0;;;;2,0;;;;;1,0;;;2,0;;1,0;;;;;;;;2,0;;;;;;1,0;18,0;;;16,0;;;;;;5,0;;;;3,0;;;18,0;;9,0;;6,0;;;;;;;;;;;;;;51,0;;;24,0;;;;;;;;;;;;;;;;;;;;;;;1,0;80,0;;;;;;;;;2,0;2,0;;;;;;;1,0;;;;;;;;4,0;;;;;;;;13,0;;;;;;9,0;;;8,0;;;;;4,0;;;;;;;;1,0;;;1,0;;;;;;;5,0;;2,0;;1,0;2,0;;;3,0;;3,0;;;;25,0;;;;39,0;1,0;;;10,0;1,0;;3,0;2,0;;;;;2,0;;;;;;;;3,0;1,0;;;;;;;4,0;3,0;;;;;;;;;;;;;;;;10,0;;;;;;;2,0;2,0;;;;;;;;;;;;;;2,0;;;;;5,0;6,0;;;;;;;;;;;;;;;;;;;;;;;;;;;;;;;;;;1,0;;;3,0;;2,0;;;;;;;;;;;;;;;;2,0;;;;;;;;;;;;;;;;1,0;;;;;;;2,0;;;;85,0;;3,0;;;;;1,0;;;;;;;;1,0;;;;;;;;;14,0;;;;;;;;;;;;;;;;;;;;;;;;;;;;;;;;;;;;6,0;;;;;;;;;;;;
cure;;;;;;;;2,0;;;1,0;;;;;;1,0;;;;;;;;;;;;;;;;1,0;;;;;;;;;;;;;;;4,0;;;;;;;;;10,0;;;;;;;;1,0;;;4,0;;;;;2,0;;;;;;;4,0;8,0;2,0;;2,0;;;;;;;32,0;;;7,0;;;;;17,0;;;;4,0;;;;1,0;;;;2,0;;;;;;5,0;2,0;;;;;130,0;;;;;;;;;;1,0;1,0;;;;;;;;;;9,0;;;;;;;;;;;;;;;;;;;2,0;;;4,0;;;;;;;153,0;;;2,0;6,0;3,0;;;;2,0;9,0;;;3,0;;;;;;;;;;1,0;;;;;;;;;;;;;16,0;;1,0;;2,0;;;;1,0;11,0;2,0;;6,0;;;;;;14,0;;14,0;1,0;1,0;1,0;;;;19,0;;;;;;;4,0;;;;;;;;2,0;;;;;;;;;;;32,0;;;;;;;;;;;;;;;;1,0;4,0;3,0;;;;;;;;;;;;;;1,0;;;;;;;;;1,0;;;;;;1,0;;;;;;;;;;;;;;;2,0;;;;;;;;;;;;;;;9,0;4,0;;;;;;;;;;;;;;1,0;;;;;;;;;;;;;;;;;;;;;;;;;;;;;;;;;;;;1,0;;;;;;;;;;;;;;;;;;;;;;;;;;;;;;;;;;;;;;;;;;;20,0;;;;;;;1,0;;;2,0;;;;;;;;;1,0;;;;;;;1,0;;;;;;;;;;;;;;;;;;;;;;1,0;3,0;;1,0;;;;;;;;;;;;;;;;;;;;;;;;;;;;;;;;;;;;;;;;;;;;;;;;;2,0;;;;;;;;;;;1,0;;;;;;;;;;;;1,0;;;;;;;;;;;;;;;;;;;;;;;;;;;;;;;;;;;;;;;;;;;;;;;;;;;2,0;;;;;;;;;;;;;;;;2,0;;;;;;;;;;;;;;;;;;;;;;;;;;;;;;;;1,0;;;1,0;;;;;;;;;;;;;;;;;;;;;;;;;;;;;;;;;;;;;;;;;;;;;;;;;;;;;;;;;;;;;;;;;;;;;;;;;;;;;;;;;;;;;;;;7,0;;;4,0;;;;;;1,0;7,0;;;;;;;;;;;;;;;;;;;;;;;;;;;;;;;;;;;;;;;;;;;;;;;;;;;;;;;;;;;;;;;;;;;1,0;;;;;;;;;;;;;;;;;;;;;;;;;;;;;;;;;;;;;;;;;;;;;;;;;;;;;;;;;;;1,0;;;;;;;;;;;;;;;;;;;;;3,0;;;;;;;;;;;2,0;1,0;;;;;;;;;;;;;;;;;;;;;;;;;;;;;;;;;;;;;1,0;;;;;;;;;;;;;;;;;;;;;;;;;;;;;;;;;;;;;;;;;;7,0;;;;;;
cycle;;;;;;;;1,0;1,0;;;;1,0;1,0;8,0;16,0;;;2,0;;2,0;21,0;5,0;;;;;3,0;;;1,0;17,0;9,0;9,0;25,0;22,0;;2,0;;;12,0;1,0;1,0;;6,0;;13,0;14,0;6,0;2,0;1,0;11,0;;;24,0;;6,0;;1,0;;1,0;;1,0;;1,0;;4,0;2,0;5,0;;2,0;;14,0;1,0;;;8,0;;;61,0;5,0;15,0;;3,0;1,0;5,0;42,0;;;52,0;66,0;;1,0;;;;;;12,0;;;;;9,0;;;12,0;2,0;27,0;1,0;;17,0;;;;3,0;2,0;12,0;3,0;37,0;;;;;6,0;3,0;;;5,0;2,0;16,0;60,0;;;6,0;14,0;2,0;1,0;;;12,0;;32,0;11,0;6,0;1,0;;;105,0;;;;12,0;3,0;;3,0;7,0;;;;;4,0;47,0;2,0;;;;2,0;2,0;2,0;;;;;5,0;;;;;;;54,0;;;;8,0;;3,0;;;;;;;;;;;;;;;10,0;2,0;;;;;2,0;;;;1,0;2,0;;;;;;;;;;;;;;;4,0;;1,0;;;;;;1,0;;;;;;;46,0;13,0;;;;3,0;;;;;;;4,0;32,0;;;;;;;;;;;;7,0;;;;;;;;6,0;;;;51,0;3,0;;;;29,0;;;;;3,0;;4,0;;;;;;;;;5,0;;;;;;;;;;;;;;;;;;4,0;;;;;15,0;;;;;;;;;;;4,0;;;2,0;;;;;6,0;;;;;;;;;;;;;;;;;;;;;;;;;;;;;1,0;;;;;;;;;;;;;;;;;;;4,0;;;;66,0;;;1,0;;;;;;;;3,0;;;;12,0;1,0;1,0;;2,0;2,0;;;;8,0;;;;8,0;;;3,0;;;;;12,0;;;;;;2,0;1,0;;;1,0;1,0;;;;28,0;1,0;;17,0;1,0;;;;8,0;17,0;;;;;1,0;;;;;;;;;3,0;;;2,0;65,0;;;;;;;18,0;;;;;13,0;;;;;;;;2,0;;1,0;;;;;;;;;5,0;;;;1,0;;;3,0;;;;10,0;;;;;;;;1,0;;;;;;;;;;;9,0;;35,0;;;1,0;;1,0;;3,0;;3,0;2,0;;;;;;;;;;;;;3,0;;1,0;;;1,0;5,0;;12,0;;;;;;;;;;1,0;;;;;;;4,0;3,0;;;;;;;2,0;;;;;;;;;;;;;17,0;3,0;;;;;;;;;;;;;;;;;;;;;;;9,0;1,0;;;;;;2,0;;;;3,0;;;17,0;;;;;;;;;;;;;;;;;;50,0;;;1,0;;;;3,0;1,0;;;;;;;;;;;;;;;;;1,0;;3,0;;;;;;;;;;;;;;;;;;;;;;;;;;;;;;;;;;;;;1,0;;5,0;;;;;;;;;;1,0;;;;;;;;;;;;;;;;;;;;;;;;;;;;;;;;;;;;;;;;;;3,0;;;;;;8,0;4,0;;;;;;;;;;;;;23,0;1,0;;;;;;;;;;;;;;;;;;;;;;5,0;;27,0;;;;;;;2,0;;;3,0;1,0;;;;;;;;;;;;7,0;;;;;;;1,0;;;;;;;;;;;;;;;;;;;;;;;;;;;;;4,0;;;;1,0;;;;;;;;;;;;;;;;;;;;;;;;;;;;;;;;;;;;;;;;1,0;;;;;;;1,0;;;;;;1,0;;;;;;;;1,0;;;;;;;;;;;;;;;;55,0;;;;;;;;;;;;;;;1,0;;;;;;;;;;;;;;10,0;;;;;;
defect;;;;;;;;11,0;1,0;;5,0;;;;;7,0;;;;;;2,0;;;;;;;;1,0;;;2,0;5,0;;1,0;9,0;81,0;2,0;;;;;;4,0;1,0;89,0;5,0;5,0;1,0;;4,0;2,0;;;;;;15,0;;;;;;;2,0;;;;;1,0;;2,0;;;;6,0;;3,0;30,0;;4,0;;27,0;;;;;;;3,0;;;;;;;;24,0;;1,0;;7,0;1,0;;;;;15,0;;;40,0;;;;11,0;4,0;3,0;;;3,0;;;22,0;;;;;;;;1,0;;7,0;;;;;;;;;;1,0;2,0;;;;9,0;;;;;;;;4,0;;;;;;90,0;1,0;1,0;;;;;;;;;4,0;;2,0;;;;;;1,0;;;;25,0;;3,0;;;;;;;;;;;;;;;6,0;;;;;;;;;1,0;;;;;;;;;;;;;;;;;5,0;3,0;;;;;;;;;;;;1,0;;;;;;;52,0;1,0;;;;;;;;;;;;;;15,0;;;;;;;;;;;;;;8,0;;1,0;2,0;;;;;1,0;;;1,0;;;9,0;;;;;;;;;;;1,0;;;;;;;;;2,0;;;;;;;;;;;;;;;;;;;;;;;;;;;;;;;;;;3,0;;;;1,0;3,0;;;;;;;2,0;2,0;;;;;;;;;;;;;;;;;;;;1,0;;;;;;1,0;;;;;1,0;;40,0;;;;;;4,0;;;;;;;;;;;6,0;;2,0;;7,0;2,0;;;;;;;;;3,0;48,0;;;;;;;;;13,0;1,0;;;;2,0;;;1,0;1,0;;;;1,0;2,0;;;;;;;;;;;;;;;;;;;;;;1,0;;;;;;;;;;;;1,0;;;;;;;;;;;;;;;;;;;;;;;;;;;;;;;1,0;;;;;;;;;;;;3,0;;;;;;;;;;;;;;;;2,0;;;;;;;;;;4,0;;;1,0;;;;;;;;;12,0;;1,0;;;;;;2,0;;;;;;4,0;;;3,0;;;;;;14,0;6,0;;;;;;;;;;;;;;;3,0;2,0;3,0;;;;;;;;;;;;;;;;;;;;;;;;8,0;;;;;;;;;;;;;;;;;;;;;;;;;;;;;;;;;;;;;;;;;;;;;;;1,0;;;;;;;;;;;;6,0;;;;;;;;;;;;;;;;;;;;;;;;;;;;;;;;;;;;;;;;;;;;;;;;;;;;;;;;;;;;;;;1,0;;;;;;;;;;;;;;;;1,0;;;;;;;;;;;;;;;2,0;;;;;;;4,0;;;;;;;;;;;;;;7,0;;;;1,0;;;;;;;4,0;;1,0;;7,0;;;;;;;;2,0;;;;;;;1,0;;;;;;;;;;;;;;;;;;;;;;;;;;1,0;;;;;;;;;;;;;;;;;;;;;;;;;;;;;;;;;;;;;;;;;;3,0;;;;1,0;1,0;;;;;;;;;;;;;;;;;;;;;;;;;;;;;;;;;;;;;;;;;;;;;;;;;;;;;;;;;;;1,0;;;;;;;;;;;;;;;;;;;;;;;;;;;;;;;;;;;;;
diffusion;;;;;;;;13,0;14,0;9,0;3,0;;21,0;;6,0;1,0;;;;;;2,0;;12,0;;14,0;1,0;;;;;;12,0;;1,0;;;;;;;;;1,0;;;;23,0;;;16,0;4,0;;10,0;1,0;;23,0;;;;1,0;;;;;;;25,0;;;;;3,0;;;5,0;;;;10,0;2,0;32,0;;13,0;;;;;;4,0;3,0;;;;;;;;2,0;;;;;;;1,0;;;6,0;;1,0;2,0;9,0;;8,0;52,0;75,0;13,0;2,0;5,0;5,0;;;;;;;;;;;;;;;;7,0;6,0;;;1,0;;;15,0;;;;33,0;54,0;;;;3,0;12,0;;2,0;8,0;;;63,0;;;14,0;;7,0;;;;;;;;;1,0;11,0;;;;1,0;;;1,0;;;27,0;10,0;;;;;;;;46,0;;11,0;;;;5,0;;;;2,0;;;10,0;;10,0;3,0;18,0;;;18,0;;;;;4,0;;1,0;;;;;;10,0;;5,0;;;;;;;;;2,0;3,0;;;;;2,0;;35,0;26,0;;66,0;;;;;;;;1,0;;;;;;;;6,0;;5,0;;;;;;;;;;;3,0;12,0;8,0;2,0;;4,0;;;3,0;;2,0;;;;2,0;;;;1,0;;;2,0;;;;;;;;;;;;;;;;;;;;;;;;;;4,0;;;;;;;;;;;;;;8,0;;;;;3,0;;;;;2,0;2,0;3,0;;;2,0;;;;;;;;;;;;;;;;;;;;;;;;;;;;;;;;;;;;;2,0;;;;;;;11,0;;;;;;;;;;;;;2,0;;;;;;;1,0;2,0;2,0;;;;;;1,0;5,0;;;;;;4,0;3,0;;;;;;;;;;;;;;;;;;;;;;1,0;;;;;1,0;;;;;;;;;;;;;;;;;;10,0;;;;;1,0;;;;;;;;;;;;;;;;;;;;;;;;;1,0;;;4,0;;;;;;;;;1,0;;1,0;;;;;;;;;;;;;;;4,0;;;;;;;;3,0;;;;4,0;;;;;;;;;;;;;2,0;;;;;1,0;;;;;1,0;;;;;;1,0;;;;;;;;;;;;;;;;;;;;;;;;;;;;;1,0;;;1,0;;;8,0;;;;;;;5,0;;;;;;181,0;2,0;;;42,0;;;;;;30,0;;;;;;;1,0;;;;;;;;;;;;;;;;;;;;;30,0;;3,0;;;;1,0;;;;;;;;;;;;;;;;;;;3,0;;;;;;;;27,0;;;;;;;;;;;;;1,0;;;;;;;;;;;18,0;;;;;;6,0;;;;;;;1,0;;;;;3,0;;7,0;;;;;;;;;;;;;;;;;13,0;9,0;4,0;14,0;18,0;;;;;9,0;11,0;;;6,0;;;357,0;7,0;;;;;27,0;;;;;;;;;;;;96,0;;;2,0;45,0;;;;;;;;;;;;;;;;;;;;;;;;;;;;;;;;;;;;;;;;;;;;;;;;;;;;;;;;;;2,0;;;;;;;;;;;;;;;1,0;;;;;;;;;;;;;2,0;;;;;;;;;;;;3,0;;;;;;;;;;;;;;;;;;;;;;;;;;;;;;;;;;;;;;;;;;;;;;;;;;;;;;;;;;;;;;;;;;;;;;;;;;;;;;;;;;;;;;;;;;;;;;;;3,0;;;;;;;;;
discharge;;;;;;;;13,0;;;;;1,0;;;10,0;;;;;;2,0;;7,0;;;;;;;;;4,0;;52,0;11,0;;;;;3,0;;;1,0;;;1,0;27,0;;2,0;1,0;2,0;;;9,0;;2,0;;3,0;;;7,0;3,0;;4,0;;;5,0;;4,0;6,0;;20,0;1,0;;;1,0;;1,0;22,0;;2,0;;15,0;;;;;;;2,0;;;;;;3,0;;5,0;;;;3,0;3,0;;;1,0;8,0;15,0;;;8,0;;;;;2,0;4,0;2,0;7,0;;;;;1,0;1,0;;;1,0;;;1,0;;;;;5,0;;;;;3,0;;16,0;2,0;;;1,0;133,0;;;;20,0;13,0;;4,0;2,0;;;24,0;;8,0;59,0;;2,0;;3,0;4,0;;;;;;1,0;3,0;;;;1,0;;;;;1,0;110,0;49,0;;3,0;;;;;;12,0;;1,0;;;;9,0;;;;;;;32,0;;1,0;;2,0;;2,0;;;;4,0;2,0;;14,0;1,0;;2,0;;;;1,0;;16,0;;2,0;;11,0;2,0;;10,0;3,0;10,0;;;16,0;;5,0;10,0;;;6,0;;19,0;;4,0;;3,0;;;1,0;;;;;;;;3,0;3,0;;;3,0;10,0;;;5,0;;;1,0;;;5,0;1,0;;2,0;;;;;19,0;;;;;4,0;;1,0;;;7,0;;;;;;2,0;;;;;;2,0;;;;1,0;;;1,0;;;;;;;;;;14,0;;;;;;;;;;;15,0;2,0;12,0;10,0;;;;;;;;1,0;;;1,0;;;;1,0;;;;9,0;;;;;;;1,0;;;;;;;;;;;;;;2,0;1,0;;;;;;;;;;7,0;;1,0;;;;;;1,0;3,0;;;1,0;;;;;;;;;;;;;;;;;;;;;;;;;;;;;;7,0;3,0;;4,0;1,0;;2,0;3,0;;;;3,0;;;5,0;62,0;;;41,0;;;;;8,0;1,0;;;;;5,0;;;1,0;;;;;;;;2,0;;;;1,0;;;10,0;;;;;;;;;;;;;;1,0;13,0;;;;3,0;;;;;;;2,0;;;;;;;;;;;;;;;;;8,0;;;;;;;;;;;;;;;1,0;;;2,0;;;;;;;;;;6,0;;;;1,0;;;;;2,0;;;10,0;;;;;2,0;;;;;;;;;;;;;;;;;;2,0;;;;;;;;;;;;;;;;2,0;;;;;;3,0;7,0;;;;;;;7,0;;;;;;10,0;;;;;;;;;;8,0;;1,0;;;;;;;;;;;;;3,0;;;;;;;1,0;;;;;;;2,0;;;;;5,0;;;;;;;;;;;;;;;;;;;;;2,0;;;1,0;;;;;;5,0;;;5,0;;;7,0;;;;;;;18,0;;;;;;;;;;;;;4,0;1,0;;;;;1,0;;;;;;;;2,0;;;;;;;;2,0;2,0;;;;;;;;;;;;;;;;9,0;2,0;;;;;;;;;;;;;;;4,0;;;;;10,0;1,0;;;;;2,0;;;;;;13,0;1,0;;8,0;;;;;;;;;;;;;;;;;;;;;;;;;;;;;;;;;;;;;;;;;;;;;;;;;;;;14,0;;;;;;;;;;;;;;;;;;;;;;;;;;;;;;;;1,0;;;;;8,0;;;;;;;;;;;;;;;;;;2,0;;;;;;;;;;;;;;;;;;;;2,0;;;;;;;;;;;;14,0;;;;;;;;;;;;;;;;;;;;;;;;;;;;;;;;;;;;;;;2,0;;;;;;;;;;;;;;;;;;;;;;;;;;
discrete;;;;;;;;1,0;;1,0;8,0;;17,0;;;2,0;5,0;;;;5,0;13,0;;;;9,0;6,0;3,0;;;1,0;;15,0;;2,0;5,0;;;;;5,0;;2,0;;;;5,0;27,0;5,0;1,0;3,0;2,0;;;;;1,0;;1,0;;;;;;;4,0;;4,0;1,0;37,0;3,0;;2,0;;;2,0;;6,0;;33,0;;1,0;;19,0;;5,0;4,0;;;4,0;24,0;;;;4,0;;1,0;;13,0;;;;7,0;3,0;;1,0;3,0;;2,0;;;6,0;;;;49,0;5,0;48,0;;18,0;;;;3,0;4,0;;;;;;;;9,0;;;3,0;4,0;;;;;;;16,0;;;;35,0;1,0;;;;;3,0;;;6,0;;;;;4,0;12,0;;;;2,0;2,0;;7,0;12,0;;1,0;;2,0;2,0;4,0;3,0;;;10,0;;;;;49,0;;10,0;;;;2,0;;;;5,0;;;;;3,0;;;5,0;;;;;;1,0;;;;;;;1,0;;;1,0;15,0;;1,0;;;;2,0;;1,0;;17,0;;;25,0;;1,0;;1,0;1,0;1,0;;;;;;;;;1,0;9,0;1,0;;;;;;8,0;;;;;;;2,0;;;;;;;;1,0;4,0;;;;;;12,0;19,0;;;;;;12,0;;;;;;;;;2,0;;1,0;;;;1,0;1,0;2,0;;;;;10,0;8,0;;;;18,0;;;1,0;;;;1,0;;;;2,0;;;;;;;;;;2,0;6,0;;;;;;1,0;;;;;;9,0;;1,0;3,0;;;;;;;;15,0;;;;;;;1,0;1,0;;;;;;;;;;;;2,0;;;;;;;;;;3,0;;21,0;;7,0;;;;;;;3,0;1,0;;;;4,0;;;;;2,0;;;;;2,0;4,0;;;;;;;;2,0;;;;;5,0;1,0;;1,0;3,0;2,0;3,0;2,0;;;1,0;;2,0;;;;;1,0;2,0;11,0;;2,0;4,0;;;;;;;;;;;;;;;;;;;;;;;;1,0;;;;;;1,0;;3,0;;2,0;;;;;;;;;;2,0;;;;;2,0;;2,0;;;;;;;;;;;;;;2,0;;;;;;1,0;;;;;;;;;;;;;;;;1,0;;;9,0;;;;;;1,0;;2,0;;;;;;;;;;;;2,0;;;;;;;;1,0;;;;;;;;3,0;;;;;;;;;1,0;;;2,0;;;;;;1,0;1,0;;1,0;;10,0;;1,0;;;;;4,0;3,0;;;;;;;;;;;;;;;;;;;1,0;41,0;;;;;;;8,0;;;1,0;;;;;;;;;;;;;;;1,0;;;;;;;;;2,0;;;;;;;;;;;1,0;;;;;;;3,0;;;2,0;;;;;;;;;;;;;;4,0;3,0;;9,0;;;;;;;;;;;;;;;;;;;;;;;5,0;;11,0;;1,0;;;;1,0;;;;;1,0;;11,0;;;;;;;5,0;;;8,0;;;;;;;;;;;;1,0;;;;;;;;;;;;;;;;;;;;;;;;;;;2,0;;;;;;;;;;;;;;;;;;;;;;;;;;;;;;;;;;;;;3,0;1,0;;;;;;;73,0;;;;;2,0;;;;;;;1,0;;;;;;;;;;5,0;;;;;2,0;;;1,0;;;;;1,0;;;;;;;;;;;;;;;;;;;;;;;;;;;;;5,0;;;;;;;;;;22,0;;;4,0;;;;2,0;;;;;;;;;;;;;;;;;;;;;1,0;;2,0;;;;;;;;;;;;;;;;;;;;;;;;;;;;1,0;;;;;;;;;;;;;;;;;;;;;;;;;;;;;;;;;;;;;
drain;;;;;;;;1,0;1,0;;1,0;;;;;;;;;;;;;2,0;;;;;;;;;;;2,0;;;;;;;;;2,0;;1,0;;9,0;;;6,0;;;1,0;1,0;;7,0;;;;3,0;;;;;;;15,0;;;;;;;;1,0;;;;3,0;;11,0;;8,0;1,0;;;;;;;;;;;;;;;;;;;1,0;;;;;;;;;;;;4,0;6,0;2,0;1,0;2,0;;;;;;;;;;;;4,0;;;;;;;;;;;;1,0;1,0;;;8,0;7,0;1,0;;;1,0;;;1,0;;;;2,0;;;6,0;;;;;;;;;;;;;;;;1,0;;;;;;7,0;3,0;;;;;;;;35,0;;6,0;;;;;;;;2,0;;;;;;;2,0;;;31,0;;;;;;;;;;;;;3,0;;;;;;;;;;;;5,0;;;;;;;3,0;5,0;;24,0;;;;;;;1,0;;;;;;;1,0;2,0;2,0;;1,0;;;;;67,0;;;;;2,0;1,0;4,0;7,0;9,0;;1,0;;;;;;;;;;;;;5,0;;;6,0;;;;;;;;;;;;;;;;;;;;;;;;;;3,0;;;;;;;;;;;;;;1,0;;;;;1,0;;;;;;;;;;1,0;;;;;;;;;;;;;;;;;;;;;;;;;;;;;;;;;;;;;;;;;;2,0;;1,0;;;;;;;;;;;;;;;;;;;;;;;;;;;;;;;;;;;1,0;;2,0;;;;;;;;;;;;1,0;;;;;;;;;;1,0;;;;2,0;;;1,0;;;;;;;;;;;;;;;6,0;;;;;;;;;;;;8,0;;;;;;;;;;;;;;;;;;;;;;;;;;;;;;;;;;;;;;;;;;;;;;;;;;;;;;;;;;;1,0;;;;;;;;;;;;;10,0;;;;;;;;;;;;;;;;;;;;;;;;;;;;;;;1,0;;;;;;4,0;;;;;;;;;;;;;;;;;;;;;;;;;;;52,0;;;;14,0;;;;;;6,0;;;;;;;;;;;;;;;;;;;;;;;;;;;;3,0;;;;;;1,0;;;;;;;;;;;;;;;6,0;;;;;;;;;;;;6,0;;;;;;;;;;;;;;;;;;;;;;;10,0;5,0;;;;;3,0;;;;;;;;;;;;;;;;;;;;;;;;;;;;;;;;4,0;;2,0;2,0;16,0;;;;;2,0;;;2,0;6,0;;;1,0;;;;;1,0;;;;;;;;;;;;;91,0;;;;;;;;;;;;;;;;;;;;;;;;;1,0;;;;;;;;8,0;;;;;;;;;;;;;;;;;;;;;;;;;;;;;;;;;;;;;;;;;;;;;;;;;;;;;;;;;;;;;;;;;;;;;;;;;;;;;;;;;;;;;;;;;;;;;;;;;;;;;;;;;;;;;;;;;;;;;;;;;;;;;;;;;;;;;;;;;;;;;;;;;;;;;;;;;;;;;;;;;;;;;;;;;;;;;;
edit;;;;;;;;14,0;54,0;;;;4,0;;;21,0;;;;;;8,0;4,0;;;;;;;;;;5,0;;8,0;2,0;;;3,0;;20,0;;;;2,0;;3,0;9,0;12,0;28,0;;;;;;;;;;;;;;;3,0;;1,0;;3,0;;17,0;;1,0;;;;;;;177,0;;8,0;;8,0;;2,0;;;;;;;;;;3,0;16,0;;24,0;;7,0;6,0;4,0;;;;;1,0;49,0;;;4,0;;;;;3,0;;;;;;;;16,0;29,0;1,0;;;;;;;;;;;9,0;;;;;;4,0;1,0;;;;14,0;;;;1,0;33,0;;;3,0;;;3,0;2,0;;12,0;;;;19,0;2,0;;;;;;;;5,0;;;;;;;;;;;;;;;;;;1,0;;;12,0;;;;;;;;;;;;;1,0;;;;;;;;;;;;;;;;;1,0;;;;;;;;;;;;;;;;;;;;;;;;;;;;;;24,0;;;;;;;4,0;;;;;;;;;;;;;1,0;;;;;;3,0;;;;;;;;;;;;;;;;;;;;;;;;;;;;;;;;;;;;;;;;;;;;;;;;;;;1,0;;;;;;;;;;;;;;;;;;;;;;;;;;;;;;;;;;;;;;;;3,0;;;;;1,0;;;;4,0;;;;;;;16,0;;;;;;;;;;;;;;;;;;;;;6,0;;1,0;1,0;3,0;;;;;;;;;;;;;;;;;6,0;;;;;;;6,0;;;;3,0;;5,0;4,0;10,0;;;;;;;;;1,0;4,0;;1,0;;;1,0;;;;;;;;1,0;;;;1,0;20,0;;;;;;;;;;;;;;1,0;;;;;3,0;;;;2,0;21,0;;;;;5,0;4,0;;;;;2,0;;5,0;;;;;;;;;;;;;;5,0;9,0;;5,0;;;;;;;;2,0;;;;;;1,0;;12,0;;;6,0;;8,0;;;;;;;;;;;;1,0;;;;59,0;;1,0;;;5,0;;;;;3,0;;;;;;;;;;;;;;;;;;;;;12,0;;;;;2,0;8,0;;;;;;;;;1,0;;;;;;;;3,0;;;;;;;;;;;;;;1,0;7,0;;;;1,0;;;;;;;;2,0;;;;;1,0;5,0;;;;;;;;;;;;;;;;;;;;;;;;;;;;;;;;;;;;;;;;;;;;;;;;;;;;;;;;;;;;;;;;;;;;;;;;26,0;;;;;;;;;19,0;;;;;;;;;;;;;;;;;;;;;;;;;;;;;;;2,0;;;;;;;;;;;;;;;;;;;;;;;;;;;;;;;;;;;1,0;;;;;;;;;;4,0;;;;;;;;;;;;;;;;;;;;;;;;;;;;;;;;;;;1,0;;;;;;;;;;;;;;;;1,0;;;;;;;;;;;;;;;;;;;;;;;;;;;;;;;;;;;;;;;;1,0;;;;;;;;;;;;;;;;;;;;;;;;;1,0;;;;;;;;;;;;;;;;;;;;;;;;;;;;;;;;;;;;;;;;;;38,0;;;;;;;;;;;;;;;;;;;;;;1,0;;;;;;;;;2,0;
encode;;;;;;;;12,0;10,0;2,0;;;2,0;;;12,0;;2,0;1,0;;;34,0;;;;;9,0;;;;30,0;;46,0;;26,0;7,0;;9,0;1,0;;283,0;;;1,0;8,0;1,0;8,0;43,0;35,0;7,0;;;;1,0;;;6,0;9,0;1,0;6,0;;;;3,0;;;;5,0;65,0;;;;15,0;;;;6,0;2,0;4,0;146,0;;;;33,0;;37,0;;;;4,0;1,0;;13,0;;;42,0;5,0;1,0;45,0;1,0;;3,0;21,0;;;3,0;7,0;;9,0;17,0;1,0;12,0;;;;60,0;20,0;;;8,0;;;11,0;13,0;23,0;18,0;;;;;;20,0;;;8,0;;6,0;9,0;4,0;;10,0;;5,0;15,0;1,0;;;;62,0;8,0;2,0;;12,0;31,0;;;39,0;;2,0;1,0;14,0;19,0;18,0;;;;221,0;;1,0;;2,0;;;;3,0;;;;;;;;;;;18,0;;1,0;;;6,0;14,0;;4,0;;;2,0;;;;;;1,0;;;;;;;;;;;;;;;;;;;;;;;;;;8,0;;;;;;;;;1,0;;;;1,0;;;;;;;21,0;;;;;;;;30,0;4,0;;;;;;12,0;;;3,0;;;;;10,0;;;;;;3,0;;4,0;;4,0;6,0;;;26,0;;;;;;;;;;;;;;;;;;;;;;34,0;;;;;;;2,0;;;;;4,0;;;;;;;;;;;;;;;;9,0;;;1,0;;;;8,0;1,0;;;;;;17,0;;;;;;;;;2,0;;;1,0;;;;;;;;;;;;;;;;;;;;;2,0;;;;;;;;;1,0;;4,0;;14,0;;;;;;;;2,0;;;;;2,0;;3,0;25,0;;7,0;;;;;1,0;;;;;4,0;;;3,0;;;2,0;;10,0;6,0;2,0;6,0;;1,0;;7,0;;;3,0;1,0;;6,0;;7,0;;2,0;1,0;;;;;15,0;16,0;2,0;;;;6,0;;;;;;1,0;;4,0;;;;1,0;5,0;3,0;;;;;;4,0;;6,0;;1,0;;;9,0;1,0;6,0;;;;13,0;;;5,0;3,0;4,0;;;4,0;4,0;1,0;3,0;;;;2,0;;1,0;4,0;;3,0;197,0;;;3,0;;;;;8,0;;;;19,0;;;9,0;3,0;;6,0;;3,0;;9,0;;;;;;4,0;;;25,0;1,0;3,0;;5,0;1,0;;;;1,0;;;;;;26,0;3,0;8,0;;;3,0;2,0;1,0;;;10,0;;;;1,0;1,0;;;;;;;;;;;;1,0;;;;;;;;;;;;4,0;2,0;3,0;8,0;4,0;;;;;;;;;2,0;;;;;1,0;;12,0;;1,0;;;;;4,0;1,0;;3,0;;;;9,0;;1,0;;;1,0;;4,0;;;;;;;;;;;5,0;1,0;;;;;;;;;;;;1,0;;;;;;;;;;;;;;;;;;2,0;;;;1,0;;;;;;;;;;1,0;;9,0;;;;;;;;1,0;;;;;;1,0;;;;;;;;;;;;;;;;;;;39,0;;;5,0;21,0;;;;;;;;;;2,0;4,0;;;;;;;;;2,0;;;1,0;;;;;;;;;;;;;;;21,0;;;;;;1,0;;;;;;;;;;;;;;;;;;;;;1,0;3,0;;;;;;;;1,0;;;;11,0;;;;;;;4,0;;1,0;6,0;2,0;;5,0;4,0;;;;;;;;;;;;;;2,0;;;6,0;1,0;;;;;1,0;;;;;;;;3,0;;;;;;;;;;;;19,0;;;;;;;;;;;;;;2,0;;;7,0;;1,0;;;;;;;;;;;1,0;;;;2,0;;;;;;;;;;;;;;;;;;;;;1,0;;;;;;;2,0;;;;;;;;;;;;;;;;2,0;;;;;;;;;7,0;;;;;;;;;;;;;;;;;;;;;;;;;;2,0;;;;;;;;;;;;;;;;
entry;;;;;;;;6,0;35,0;1,0;;;2,0;;1,0;7,0;;;;;;7,0;;;;;24,0;;;;1,0;;7,0;;9,0;1,0;;7,0;;;3,0;;8,0;3,0;8,0;;10,0;6,0;3,0;8,0;1,0;;;;4,0;5,0;8,0;;;;;;;2,0;;;;3,0;;;;;3,0;;;7,0;;1,0;;11,0;;2,0;;11,0;;;;;2,0;4,0;4,0;;;1,0;;;1,0;;14,0;2,0;;;;10,0;2,0;;5,0;;1,0;2,0;11,0;7,0;;;;14,0;;4,0;;;4,0;3,0;;;;;;;1,0;;;;1,0;;;;1,0;4,0;;;4,0;2,0;;3,0;;;;;1,0;;;;1,0;2,0;4,0;;13,0;;;;;;5,0;;;;4,0;;;;;;;;1,0;;;2,0;;;;4,0;;;;1,0;;;;;3,0;;;;;1,0;;;;;;;4,0;1,0;8,0;;;;;;;;;;;;;;1,0;;3,0;;4,0;;;1,0;;;5,0;;8,0;;;;;;1,0;4,0;;3,0;2,0;5,0;;;;;;;4,0;;;;;;;;4,0;;;;;;;;;;16,0;;;;;;16,0;;;;3,0;;;13,0;;;;;;2,0;6,0;;;;9,0;;;;;2,0;;;;;;2,0;1,0;;;;;;;3,0;;;;;4,0;8,0;;8,0;;;;;;;3,0;;;1,0;;;;;;1,0;;;1,0;;;;;;;2,0;1,0;;;;2,0;;;;;;;;;5,0;1,0;;;;;;;;;;;6,0;;;;;;;;;;;;;;;;;;;;;;;;;;;;;1,0;;;;4,0;;;;;;;6,0;4,0;;4,0;;;;;;;;;;;;;;;;;;;6,0;;;;;;;3,0;;1,0;1,0;;;;;2,0;;;;;;;;;3,0;;;;;1,0;;;;;;;;;;7,0;;;;19,0;;9,0;;;;;;;;1,0;;;;;17,0;;1,0;;;2,0;;1,0;;5,0;;3,0;;;;;;3,0;;;;;4,0;;;;3,0;;;;;;;;;;;;;8,0;;;;;1,0;;;;;;;;;;;;2,0;;;;4,0;;;;1,0;;1,0;;;;;18,0;;;;;5,0;;;;;2,0;;;;;4,0;1,0;;;;1,0;;;;;;;;;;;;;;;1,0;;;;;;;;;;7,0;;;;;1,0;;;;;;;;;;;;;;;;17,0;;;;;;1,0;3,0;;1,0;3,0;16,0;;;6,0;;;;1,0;2,0;2,0;1,0;;;;;;;;;;;;;;;;;9,0;;;;;;;;;;;;;1,0;;;;;;;;;;;;1,0;;;;;;;3,0;;;;;;;;;;;;;;;;;4,0;;;;;;;;;;;;;;;;;;;11,0;;;;1,0;;;;;;;;;;;;;;3,0;;;1,0;;;;;;;;;;;7,0;1,0;;;;;;;;;;2,0;;;;;;4,0;;;;;;;;;;;;;;;;;;;;;;;;;;;;2,0;;;;;;;;;;;;3,0;;;;;;;;;;;;;;;;;;;;1,0;;;;;;;;;;;;;;;;;;;;;;;;1,0;;;;;;;;;;;;;;;;;;;;;;;;;;;;;;;;;;;;;;;;;;;;;;;;;;1,0;;2,0;;;;;;10,0;;;;;;;;;;;;;;;;;;;;;;;;;;;;;6,0;;;;;;;;;;;;;;;;;;;;;;;;2,0;;;;;;;;;;;;;;;;;;;;;;;
execution;;;;;;;;13,0;1,0;;;;3,0;1,0;;7,0;;;;2,0;5,0;7,0;;;;;;;;;8,0;;7,0;;8,0;3,0;;2,0;;;6,0;;;;;2,0;11,0;31,0;4,0;2,0;;;;;1,0;;;;;7,0;;1,0;;1,0;;;3,0;1,0;2,0;;47,0;;5,0;;;;;;;19,0;;2,0;;5,0;;36,0;;1,0;;;1,0;3,0;;;;14,0;8,0;;19,0;;;;10,0;2,0;;8,0;;;2,0;9,0;1,0;8,0;;;;6,0;;1,0;1,0;17,0;;;2,0;33,0;36,0;10,0;;;;;;5,0;;;1,0;;3,0;18,0;10,0;;1,0;;;;2,0;;;;3,0;;1,0;;1,0;31,0;1,0;;6,0;;;;2,0;;43,0;;;;1,0;;;;;;;;;1,0;;;;;;;;;;5,0;;;;;;2,0;;;;;;;;;;;;;;;;;;;;;;;;;;;;;;;;;;;;;6,0;1,0;6,0;;;;;;;5,0;;;;1,0;;;1,0;;;;;;;;;;;;8,0;;;;;;;4,0;;1,0;18,0;;11,0;;;;;;;;10,0;;;;1,0;3,0;;;;8,0;;;;;;;;;;;;;;;1,0;;;;;;;1,0;;;;;;;;;;;;;;;;;;;;;;;;;;;;4,0;;;1,0;;;;;;;;;;1,0;;;;;1,0;;;1,0;;2,0;;;;;;;;;;;;;;;1,0;;;;;;;;;;;;;;;;2,0;;1,0;;9,0;6,0;;;;;;;;;;;;;;;2,0;;6,0;3,0;;9,0;;;;;;;;;;;;;;;1,0;;19,0;;;;1,0;;;11,0;;;;1,0;;;5,0;15,0;;;4,0;;;;;1,0;1,0;;;;;;;;;;;;;;4,0;;;;2,0;3,0;;;;;;9,0;;2,0;;;;;;;;;5,0;8,0;19,0;;;1,0;;3,0;;;;;;;;4,0;;;1,0;;;;;;6,0;;;;;1,0;;;10,0;;;;;;;;;;;;;2,0;;1,0;;;;;;10,0;;;3,0;;;;;;;;;;;;;;2,0;;;;1,0;;1,0;;;1,0;;;;;11,0;;;;;;;;;;;;2,0;;;;;1,0;;;1,0;;;;;;2,0;7,0;;;;;;;8,0;;;;;;;;;;;;;;;;;;;;3,0;4,0;;20,0;;3,0;;;;3,0;;;;;1,0;;;;;;;;;;;;;1,0;;;;;;;;;;;;;;;;4,0;;;;;;;;;;;;;;1,0;;;;;;;;;;;;;;;;;;;;;;;;;;;;;;;;;;;;;;;;;;;;;;;;;;;;;;;;;;;;;;;;;;;;;;;;;;;;;;;5,0;;;;;;;;2,0;;;;;;;;;;;2,0;2,0;;;;3,0;;;;;;;;;;;;;;;;;;;;;;;;;;;;;;;;;;9,0;;;;;;;;;;;;;;;;;;1,0;;;1,0;;;4,0;;;;;4,0;;;;1,0;;;;;;;;;;;;;;;;;;;;;;;;;;;1,0;1,0;;;;;;;;;;;;;;;;;;;;;;;;;;;;;;;;;;;;;;;;;;;;;;;;;;;;;;;;;;;;;;;;;;;;;;;;;;;;;;;;;;1,0;;;;;;;;;;;;;;;;;;;;;;;;;;;4,0;;;;;;
finger;;;;;;;;9,0;15,0;;;;1,0;;6,0;;18,0;;;;;4,0;;;1,0;;2,0;13,0;;;1,0;;1,0;;4,0;5,0;;;;;;1,0;1,0;;17,0;;11,0;11,0;1,0;3,0;2,0;1,0;;;;;10,0;;;;4,0;;;;;;4,0;6,0;1,0;;1,0;;;;;;2,0;;;14,0;;;;26,0;6,0;;;;;12,0;1,0;;;;;;;;9,0;;11,0;;2,0;4,0;;;5,0;10,0;;;;1,0;;;;7,0;37,0;20,0;;1,0;1,0;;4,0;;;;;;;3,0;;9,0;2,0;;2,0;;;2,0;;;;;;;1,0;;;11,0;2,0;3,0;;;;;;;20,0;;;;;;2,0;;;;;1,0;;;1,0;;;4,0;;1,0;1,0;;;;;2,0;;;;;;1,0;;;;;;26,0;;29,0;;;;;;3,0;;3,0;;;;;;;;13,0;1,0;;;;;;;;1,0;;;;;;;;2,0;;34,0;;;6,0;;10,0;10,0;1,0;8,0;;;2,0;8,0;;;;;;2,0;;;;;;;;1,0;1,0;;;;;;1,0;;;2,0;;;;3,0;;1,0;;;3,0;;2,0;;6,0;1,0;;;4,0;4,0;1,0;;1,0;;;;;;;;;;;2,0;;;;;;;;;1,0;;;;;;;5,0;;;;;;;;;17,0;;;8,0;;;;27,0;;;;;;;;2,0;;;;;;;3,0;;;4,0;;;;;;;;;2,0;1,0;;5,0;;;;;10,0;;;1,0;;;2,0;3,0;;;;3,0;;7,0;;;;;;;;;;;10,0;;;;;;;;11,0;;;;;;8,0;;;;;;;2,0;;;;;;;;;;;;;;;;;;;;;1,0;;1,0;4,0;;3,0;1,0;;;;12,0;22,0;;;1,0;1,0;1,0;;;;;;;;;;;;;10,0;1,0;;;;;;;;8,0;;;;;29,0;;;1,0;;;2,0;;;;;;;;;;;;;3,0;;;2,0;;11,0;;;;;;;;;;;;;5,0;;;;;;;;;;;;13,0;;;;;;;;;;;;;4,0;;2,0;;;2,0;;;8,0;;;;;;;;;1,0;;1,0;;;;4,0;;1,0;;;;;;;;;;;;;;;;;;;;;;;;;;4,0;3,0;;;;;;1,0;;;;2,0;;1,0;;;;;;;;;;;;;;;;;;;;;;;;;;3,0;;;;;;;;;;;3,0;;;;;;;;;;1,0;9,0;;;;;2,0;;;;;;;;;;1,0;;;;1,0;;;;;;;;;;;7,0;;;18,0;;;;;;;;;;;2,0;;;;;;;;;;;;;;;;1,0;;;;;1,0;;;;;6,0;;;;;;2,0;;;;3,0;;;;1,0;;;;;;;;;;;;;;;;;;;;;;;;;;;;;;;;;;;;;;;;;;;;;;;;;;;;;;;;;;;;;;;;;;;;;;;;;;;7,0;;;;;;;;;;;;;;2,0;;;;;;;;;;;;;;;;;;;;;;;;;8,0;;;;;;;;;;;;;;;;;;;;;;;;;;;;;;;;;;;;;;2,0;;;;;;;;;;;;;;;;;;;;;;;;;;1,0;;;2,0;;;9,0;;;;;;;;;;;;;;;;;;;;;;;;;;;;;;;;;3,0;;;;;;;;;;;;;;;;;;;;;4,0;;;;;;;;;;;3,0;;;;;;;;;;;;;;;;;;2,0
float;;;;;;;;15,0;12,0;7,0;6,0;;17,0;;;;;;;;;;;10,0;;;;;;;;;12,0;;6,0;;;;;;;;;;1,0;;1,0;24,0;;2,0;13,0;;;22,0;;;20,0;;;;1,0;;;;;;;18,0;;;2,0;;7,0;;;9,0;;;;10,0;2,0;28,0;;26,0;;;;;;4,0;;;;1,0;;;;;2,0;;;;;;;1,0;3,0;;12,0;;;2,0;;;8,0;49,0;69,0;13,0;1,0;4,0;5,0;;;;;;;;;;;;;;;;5,0;6,0;;;;;;18,0;;;;28,0;61,0;;;;4,0;15,0;;5,0;5,0;;;58,0;;;16,0;;;;;;;;;;;2,0;2,0;4,0;;;;;;;;;40,0;11,0;;;;;;;;45,0;;11,0;;;;3,0;;;;2,0;;;7,0;;;3,0;9,0;;;16,0;;;;;2,0;;;2,0;1,0;;;;5,0;1,0;2,0;;;;;;;;;1,0;1,0;;;;;;;29,0;40,0;;71,0;;;;;;;;1,0;;;;;;;;4,0;;2,0;;;;;;;;;;;2,0;11,0;4,0;3,0;;4,0;;;;;2,0;;;;4,0;;;;;;;2,0;;;;;;;;;;;;;;;;;;;;2,0;;;;;;4,0;;;;;;;;;;;;;;8,0;;;;;;;;;;2,0;5,0;4,0;;;1,0;;;;1,0;;;;;;;;;;;;;;;;;;;;;;;;2,0;;;;;;;;;2,0;;;;;;;3,0;;;;;;;;;;;;;;;;;;;1,0;1,0;2,0;2,0;;;;;;;5,0;;;;;4,0;4,0;3,0;;;;;6,0;;;;;;;;7,0;;;;;;;;;;;;;;;;;;;;;;;;;;;;;;;;9,0;;;;;1,0;;;;;;;;;;;;;;;;;;;;;;;;;2,0;;;;;;;;;;;;;;;;;;;;;1,0;;;2,0;;;;;;;;;;;;;;3,0;;;2,0;;;;;;;;;;;;;2,0;;;;;1,0;;;6,0;;1,0;;;;;;;;;;;;;;;;;;;;;1,0;;;;;;;;;;;;;;1,0;;;1,0;;;4,0;;;;;;;12,0;;;;;;138,0;4,0;;1,0;68,0;;;1,0;;;31,0;;;;;;;;;;;;;;;;;;;;;;;;1,0;;;;32,0;;;;;;;;;;;;;;;;;;;;;1,0;;;;;;;;;;;;33,0;;;;;;;;;;;;;;;;;;;;;;;1,0;20,0;;;;;;11,0;;;;;;;;;;;;3,0;;5,0;;1,0;;;;;;;;;;;;;;;12,0;6,0;3,0;16,0;22,0;;;;;6,0;8,0;;357,0;5,0;;;;4,0;;;1,0;;56,0;;;;1,0;;;;;;;;105,0;;;1,0;4,0;;;;;;;;;;;;;;;;;;;;;;;;;;;;;;;;;;;;;;;;;;;;;;;;;;;;;;;;;;4,0;;;;;;;;;;;;;;;1,0;;;1,0;;;;;;;;;;1,0;;2,0;;;;;;;;;;3,0;;;;;;;;;;;;;;;;;;;;;;;;;;;;;;;;;;;;;;;;;;;;;;;;;;;;;;;1,0;;;;;;;;;;;;;;;;;;;;;;;;;;;;;;;;;;;;;;;;;;;;;;;;;;
foreground;;;;;;;;3,0;12,0;;;;;;;20,0;;;;;;2,0;;;;;4,0;;;;1,0;2,0;17,0;;2,0;4,0;4,0;;35,0;;2,0;;1,0;11,0;25,0;3,0;15,0;1,0;4,0;19,0;;65,0;;;;5,0;2,0;;9,0;;;;1,0;;1,0;;9,0;1,0;20,0;3,0;;;3,0;;;;;;;124,0;;;1,0;13,0;1,0;1,0;;;;2,0;4,0;;;;;1,0;;;20,0;1,0;17,0;;;134,0;;;;;8,0;;;6,0;;;;19,0;12,0;9,0;;10,0;;;;;2,0;;;;;6,0;;2,0;;;5,0;;4,0;;;;17,0;;1,0;20,0;6,0;;;;;6,0;;;1,0;2,0;7,0;;9,0;;;;3,0;;5,0;;;;;4,0;1,0;;1,0;;;1,0;;;;;;1,0;;;;;;;;;;;;;;;;;;;;;;;5,0;;;;;;;3,0;;;;;;;;;3,0;;;;;;;;;;5,0;;;;;;;3,0;;;;;3,0;;;;;;;;62,0;6,0;;;;;;;2,0;;;;;;;;;;;;;;;;5,0;;;;;;;;;;;;;7,0;;;;;;;;;;;;;;;;;;;;;;4,0;;;;1,0;;;22,0;19,0;;;;1,0;;;;;;;;;;;;;;;;;15,0;;;;;;3,0;;;;;;;;;;;;;;;;;;;15,0;;;;;;;;;;;;;;;;;;;;;2,0;;;8,0;;;;;;1,0;;;;;;3,0;;;;;;;;;;;;4,0;3,0;;11,0;;4,0;;14,0;;2,0;;;;11,0;;;;;2,0;1,0;2,0;;16,0;;;5,0;;;;1,0;;;7,0;3,0;;;;;;;;;;;;;;;17,0;;;9,0;;;;;;;;4,0;6,0;;;;2,0;3,0;;8,0;;;;1,0;;;;;;;;;8,0;;11,0;;;;;;;1,0;;5,0;;;2,0;;;;;;;;19,0;;;;;;;;;;;;;;;;;;;;;;1,0;;;9,0;;;;;;;2,0;12,0;;;;;2,0;;;;;;;;;;;;;;;;;;;;;2,0;;1,0;;;;;;;;;;;;1,0;;;;;;;;;;;;;;8,0;;2,0;;;;;;;;;;;10,0;;;;;;;;;;;;;;;10,0;;;;;;;14,0;;;;;;;;;;;;1,0;;;1,0;;;;;;1,0;;;;;;;;13,0;;;;;;;;;;;;;;;;;;;;;;;;;;;;;;;;;;;;;;;;;;;;;2,0;;;;;;;;;;;;;;;;;;;;;;;;;;;;;;;;;;;;;;;;;;;;;;;;;;;;;;;;;;;;;;;;;;20,0;;;;;;;;;;;;;;;;1,0;1,0;;;;4,0;;;;;;;;;;;;;;;;;;;;;;;;;;7,0;;;;;;;;2,0;;;;9,0;;;;;;;;;;;;;;;;;;;;;;;;1,0;;10,0;;;;;;;15,0;;;;;;;;;;;;;;;;;;;;;;;;;;;;;;;;;;;;;;3,0;;;;;;;;;;;;;;;;;;;;2,0;;;;;;;;;;;;;;;;;;;;;2,0;;1,0;;;;;35,0;;;;;;;;;;;;;;;;;;;;;;;;;;;;;;;;7,0;;;;;;;6,0;2,0;;;;;;;;
format;;;;;;;;15,0;1,0;;3,0;;1,0;;;3,0;;;;;1,0;16,0;;;;2,0;29,0;;;;7,0;;17,0;;20,0;7,0;;5,0;1,0;;180,0;;;;;;2,0;35,0;23,0;11,0;;;;;;;2,0;;;5,0;;;;37,0;;;;6,0;11,0;;;;22,0;;;4,0;;;;265,0;;;;20,0;;9,0;;;;;;;3,0;;;3,0;15,0;;38,0;;2,0;;8,0;;;;2,0;8,0;28,0;1,0;;9,0;;1,0;;15,0;3,0;;;13,0;;;19,0;11,0;12,0;;;;;;2,0;3,0;;;1,0;28,0;1,0;1,0;3,0;;;;;8,0;6,0;;;3,0;74,0;4,0;2,0;;20,0;17,0;;;19,0;;;13,0;;5,0;10,0;;;;19,0;;;;;;;;;;;;;;;6,0;;;;5,0;;2,0;1,0;;26,0;3,0;;;;;45,0;;;2,0;;;;;;;;;;;;;;;;;;;;;3,0;;;;;;;;;;;;;1,0;;;;;;;4,0;;3,0;;3,0;;;1,0;6,0;;;;;;;;23,0;;;;;;;10,0;1,0;;;;;;;;14,0;;1,0;;;;;2,0;;;;;;1,0;;;;;;1,0;;;;;;;;;;1,0;;;;;;1,0;;;;1,0;2,0;;;;;;;1,0;;;;;;;;;;;;;;;;;;;;;;;;2,0;;;;;2,0;;;3,0;;;;;2,0;10,0;;7,0;;;;;;;;;;;;;;;;;;;;;;;10,0;;;;;;;;;2,0;;;;14,0;;;9,0;;;;;2,0;;;;;1,0;;2,0;12,0;;;;;;;2,0;;;;3,0;;1,0;;;;;;;;;2,0;;;;;3,0;;;1,0;3,0;;;;1,0;;1,0;;3,0;;;;4,0;;1,0;;;;;;;;;;;;;;;;1,0;2,0;;;;;;;3,0;6,0;;5,0;;;;;;3,0;;;1,0;;;;2,0;;5,0;;;;;2,0;18,0;;;;;;5,0;1,0;;;3,0;;;;;;;;2,0;2,0;;;;;;;;1,0;;;;;4,0;;;;12,0;;;;;;1,0;4,0;;2,0;2,0;;;;;2,0;;;;;;;;8,0;;2,0;1,0;3,0;;;64,0;;3,0;;8,0;;;;;;;;;;2,0;;;;1,0;1,0;8,0;;;;;;;;;;;;4,0;;;2,0;;;1,0;;;;8,0;;1,0;;;;12,0;;;2,0;;;4,0;;1,0;5,0;;;;;;;2,0;3,0;;;1,0;;5,0;;;;;;;;;;;7,0;6,0;;;;;1,0;;;;2,0;;;9,0;;;;1,0;;;;;;;;;;;;;;;;;;;5,0;;;;;;;;;4,0;;7,0;;;;;;;;;;;;;;;;;2,0;;;;;;;;;;;;8,0;;;;3,0;;;2,0;9,0;;;;;;;;;;;;;;;;;;;;;;;2,0;;;;;;1,0;;;;;;;;;6,0;;;;;;;;;;;;;3,0;;;1,0;;;;;;;;;;;;;;;;;1,0;;;;1,0;;;;;;;;;;;4,0;1,0;;1,0;;1,0;;;;;;;;;;;;;;;2,0;;;;;;1,0;;;;;2,0;;;;;;;;;;;;;18,0;;;;;;;;;;;;;;;;;;1,0;;;;;;;;;;;;;;;;;;;;;3,0;;;;;;;;;;;;;;;;;;;;;7,0;;;;;;;;;;;;3,0;;;;;;;;;1,0;;1,0;;;;;3,0;;;;1,0;;;;;;;;;;;;;;;;;;;;1,0;;;;;;;;;;;;;;;3,0;;;;;;2,0;
gimbal;;;;;;;;90,0;;;;;1,0;;7,0;1,0;;;;;;;;;;;;;;;1,0;;10,0;;4,0;;;;;;;;;;;;;2,0;;;23,0;3,0;;;1,0;;;;;;3,0;;;;;;;;;;;;;;;;;;;;;;;2,0;;;;;;;;;;;;;;;4,0;;;;;;;;;;;;3,0;;;;;2,0;;;;;;;;;;;;;;;;;;;;;;;;;;;2,0;2,0;;;;;;;;;;;;;17,0;;;2,0;;;;;;;;;;;;;;;;;16,0;1,0;;;;3,0;;;;;;20,0;;;;;;12,0;;;;;;;;;1,0;1,0;;;;;;;;;;1,0;;;;;;;5,0;;11,0;;;;;;1,0;;;;;3,0;;2,0;12,0;;;24,0;;;;;;;;;;1,0;;;13,0;;;;;;;;;;1,0;;;;2,0;;;;1,0;1,0;;;;;;2,0;;;;;;;;;;;;;;;;;;;;;;;;;29,0;;;;;;;;;;;;;;;;;1,0;;;;;;;;;;;2,0;;;;;;;1,0;;;;;;;;1,0;;8,0;1,0;;;1,0;;;;1,0;;9,0;;164,0;;;;1,0;;;;;;;;;;;;;1,0;;3,0;12,0;;;;;;;;;;20,0;;;;;;;2,0;;;;;;;1,0;2,0;;;6,0;;;1,0;;;;;;;;;;;;;;;;;;;;;;3,0;1,0;;;;2,0;;;;55,0;5,0;;;;;;2,0;;;;;;;;;;;;;;;1,0;;;;;;1,0;;;;;;;;2,0;;;;;;8,0;;;;;;;;;;;;;;;;;16,0;;;;;1,0;;;;;;;1,0;;;;;;;;;;;;;;;4,0;;;;;;2,0;;;;;;;;;;;;;;;;;;;;;;;;;1,0;;;;;;;;;;;1,0;;;;;;;;;;;;;;;;;;;24,0;;;;;;;;;;;;;;;;;;;;;;;;;;;;;;;;;;;;;;;;;;;;;;;;;;;;;;;;;;;4,0;;;;;;;;;;;;;2,0;;;;;;;12,0;;;;;;;;;;;;;2,0;1,0;2,0;;;;;;;;;;;;;;;;;;;;;;3,0;4,0;;;;;;;;;;;;;;;;;;;;;;;;;;;;;;;;;;1,0;;;;;;;;;;;;;;;;2,0;;;;;;;;;;;;;;;;;;;;;;3,0;;;;;;;;;;;;;;;;;;;;;;;;65,0;;;;;;;;;;;;;;;;;;;;;;;;;;;;;;;;;;;;;;;;;;;;;;;;;;;;;;;;;;;;;;;;;;;;;;;;;;;;;5,0;;;;;;;;6,0;;;;1,0;;;;;;;;;;;;4,0;;;;;82,0;;;;;;;;;;;;;;;;;27,0;;;;;;;;;;;;;;;;;;;;;;;;;;9,0;;;;;;;;;;;;;;;;;;;;;;;;;;;;;;;;;;;;;;;;;;;;;;;;;
graphic;;;;;;;;3,0;7,0;1,0;5,0;;2,0;2,0;;17,0;;;;;4,0;13,0;;;;;5,0;4,0;;;7,0;1,0;12,0;;17,0;14,0;5,0;;10,0;;10,0;;1,0;;26,0;1,0;2,0;5,0;;78,0;1,0;;;;;11,0;138,0;4,0;;1,0;1,0;;;;1,0;;;21,0;11,0;;1,0;;4,0;1,0;;1,0;12,0;;;53,0;;1,0;2,0;27,0;;1,0;;;;;;;;;1,0;2,0;;;14,0;1,0;2,0;;15,0;4,0;;;1,0;;1,0;13,0;;3,0;;;1,0;6,0;2,0;20,0;;3,0;;;5,0;35,0;13,0;1,0;;;;;;;2,0;;1,0;;;8,0;;;2,0;;;3,0;6,0;1,0;;;7,0;;;;;18,0;;;6,0;;;;3,0;5,0;47,0;;;;26,0;6,0;1,0;;;;;;;;;;;;1,0;;;;;;;;;;;;;13,0;3,0;;8,0;2,0;;;;;;5,0;5,0;;;;;;;;;;;;;;;;;;;;;;;;;;;;;3,0;;;1,0;;;;;;;5,0;;;;;2,0;2,0;;;;;;;4,0;;;;;;;1,0;;;;;;;;6,0;3,0;;;;;;;1,0;;;;;;1,0;;;;;9,0;;;;;1,0;;;;;;;;;;;;;;;;;;;;1,0;;;;2,0;;;;;;;;;;;;;;;;;;;;;;;;;;;;;;6,0;;;;;;;2,0;21,0;7,0;;;;;;;;;1,0;;;;;;;;;;;;;;;;;;;;;;;7,0;;;;;2,0;;1,0;;;;;;;;;;;;;11,0;;;;2,0;;2,0;;;;;;;;;;;;;;;5,0;;26,0;8,0;;;;1,0;;2,0;1,0;2,0;1,0;;1,0;2,0;2,0;;;;;;;3,0;;;;;;2,0;;;1,0;;;;;;;;;;1,0;6,0;1,0;6,0;;;;2,0;;;;;;;;;3,0;;;2,0;1,0;;;;;4,0;;;;;1,0;;;;;6,0;;;1,0;4,0;;;;;1,0;;;;;;1,0;;;;;2,0;;2,0;;;16,0;;;1,0;;;;;;;;;;;1,0;;1,0;;;;6,0;;;1,0;;;2,0;;;;1,0;;;3,0;;;;;;;;;;;;1,0;;;;;;;;;;;;;;;2,0;3,0;;;;;;;;;;;;2,0;;;;;;;;;;;;;;;2,0;;;;;9,0;;;;;;;;;1,0;;2,0;3,0;;;;;;4,0;7,0;;;7,0;;;;;;;;;;;;;;;;;;;;;;1,0;;;3,0;;;;;;;;;;;;1,0;1,0;44,0;;;;2,0;;;;;;;;;;;;1,0;;;;2,0;;;;;;;;;;;;;;;;;;;;;;30,0;;;;5,0;;;;;;;1,0;;;;;;;;;;;;;;;;;;;;;;;;;;;;;;;;;;;1,0;;;;;;4,0;;;;;;;;1,0;3,0;;;;;;;2,0;;;;;;;2,0;;;;;;;;;;;;2,0;;;;;;;;;;;;;;;;15,0;;;;;;;;;1,0;;;;;;;;;;;;;;;;;;;;;;;;2,0;2,0;;;9,0;;;;;;;;;1,0;;;;;1,0;;;;;;;;;;;;;;;2,0;;;;;;3,0;;;;;;;;;;;;;;;;;;;;;5,0;;;;;;;;;;;;;;139,0;;;;;;;;;;;;;;;;;;1,0;;;;;;;;;;;;3,0;;;;;;;;;;;;;;;;;;;1,0;;;;;;;;;;;
heat;;;;;;;;2,0;8,0;4,0;3,0;;1,0;;3,0;1,0;;;;;;;1,0;2,0;;;2,0;;;;;;16,0;;1,0;5,0;;;;;3,0;;4,0;;1,0;;1,0;28,0;9,0;11,0;21,0;;;1,0;3,0;2,0;49,0;;;;7,0;;;;3,0;1,0;;43,0;30,0;11,0;2,0;;51,0;1,0;;1,0;;2,0;3,0;59,0;;11,0;;26,0;2,0;1,0;;;;3,0;22,0;;;25,0;;1,0;;;14,0;;;;41,0;;;3,0;5,0;4,0;;;5,0;;;;;18,0;19,0;8,0;1,0;1,0;;;1,0;5,0;;;1,0;;5,0;;;;;;;;;;;;;;;48,0;;;;13,0;7,0;1,0;;;;;1,0;3,0;20,0;;;32,0;;5,0;40,0;;;1,0;;;;;;7,0;5,0;3,0;1,0;1,0;16,0;3,0;;;14,0;12,0;13,0;5,0;;20,0;;11,0;;;;;;16,0;;13,0;;;2,0;19,0;;;;6,0;;;;2,0;4,0;2,0;2,0;;;;1,0;;6,0;;;16,0;31,0;;8,0;5,0;;4,0;23,0;;30,0;3,0;49,0;21,0;;15,0;;1,0;;1,0;3,0;;;1,0;;11,0;;;;;1,0;1,0;36,0;;;;;;8,0;;;;;6,0;;2,0;10,0;;7,0;20,0;;;;16,0;12,0;;;;2,0;10,0;11,0;33,0;;;3,0;;;3,0;;;;5,0;;;;;1,0;;;;1,0;;1,0;;6,0;;;;;4,0;4,0;;;7,0;4,0;;1,0;;;;;7,0;;;;;2,0;;;;;;4,0;;;;;;2,0;8,0;;4,0;;;2,0;2,0;;;;;;;;;;3,0;;1,0;2,0;1,0;4,0;;;2,0;2,0;2,0;;;;7,0;;;;11,0;;;;;;;;;1,0;;;;2,0;;;;;4,0;5,0;;;;;9,0;;;5,0;7,0;;;;4,0;;;;;1,0;;4,0;;;;;;;;;;;;2,0;;;;;;;;;;4,0;;;;;;;;;;2,0;;;6,0;7,0;;;;;;;;;;;;;;;;;;;;;;1,0;;;;;;;;;;;;;;;;;;;;;;2,0;;;;;;;;;;2,0;;;1,0;1,0;;1,0;;1,0;;;;;;;;;;;;1,0;;;;;;;;;;;;;1,0;;;;;;;;1,0;;;;1,0;1,0;;;;;;15,0;;;;;3,0;;;;3,0;;;;;2,0;;;;2,0;;;;;;;;3,0;;;1,0;;;;;;;;;;;;2,0;;;;;;;2,0;;;;;1,0;;11,0;;;;;;;;;;;;;;;;;;;9,0;;;4,0;;;;;;;;;;;;;;;;;;;;;;;;6,0;;;;;3,0;1,0;;;;;;;;7,0;;1,0;;1,0;14,0;;1,0;;;;3,0;;;;;;;;;1,0;;4,0;;;;;;;;;8,0;;;;;;;;;;;;;;;4,0;;;;;;;;;;;;;31,0;;;3,0;4,0;;;;3,0;;;1,0;;;;12,0;2,0;;1,0;;1,0;1,0;;;;;;4,0;2,0;;;;;;;;;;;;;;3,0;;;3,0;;;;8,0;;;;;;;;;;;;;;;;;;;;;1,0;;;;;1,0;;;;;;;;;;;;;;;;;;;;;;;;;;;;;;;;;;;;;;;;;;2,0;;;;;;;;;;;;;;;;;;;;;;;;;;;;;;;;;;;;;;1,0;;;;;;;;;;;;1,0;1,0;;;;15,0;;;;3,0;;;;;;;;;;;5,0;;;;;;;;;;;;;;;;;;;;;57,0;;;;;;;;;;;;;;;;;;;;;;;;;;;;;;;;;;11,0;;;;;;;;;;;;;;;;;;;;;;;;;;;;;;;
icon;;;;;;;;6,0;12,0;;;;7,0;3,0;2,0;;;;;;;2,0;2,0;;;;3,0;;;;;;1,0;;17,0;1,0;;1,0;;;1,0;;1,0;;7,0;1,0;7,0;17,0;11,0;102,0;;2,0;;;;;;;;1,0;3,0;;;1,0;;;;1,0;;;25,0;;2,0;;;;;;;27,0;;;;13,0;;3,0;;;;;;;;;;3,0;;;17,0;2,0;2,0;;8,0;1,0;;4,0;;;;;;4,0;;;;26,0;;4,0;;;;;;5,0;1,0;1,0;;;;1,0;;;;;12,0;;1,0;10,0;;;23,0;;;1,0;2,0;;;1,0;3,0;2,0;3,0;;2,0;3,0;1,0;;1,0;;;;1,0;;10,0;;;;18,0;8,0;;;3,0;;;;;;;;;;;;;;;;;;;;;;;5,0;;1,0;;;;;;;;6,0;;;;;;2,0;;;;;;;;;;;;;;;;;;;;;;;;;;3,0;3,0;;;;;2,0;;14,0;;;;;;;;;;;;;11,0;;;;;;;21,0;;;;;;;4,0;;;;;;9,0;;;;;;;;;;;11,0;;;1,0;1,0;;;;;;;;;;;;;;2,0;;;;;;;;;;;;;;;;;;;;;;;;;;;;;;;;;;;;;;;;;1,0;;2,0;;;;4,0;;;;;;1,0;;;;;;;;;3,0;;;;;;;;;;;2,0;;;;;;;;;;;;;15,0;;;;;;;;24,0;;;;;;;;;;;5,0;;;;6,0;;;;;;;;;;;;;;;2,0;;2,0;;;2,0;;2,0;;35,0;;;1,0;;;5,0;8,0;2,0;;1,0;;9,0;;;14,0;;;;;;;18,0;2,0;2,0;;;;;;;;;;;4,0;23,0;;;;;;2,0;;;2,0;9,0;;;;;;;;;4,0;;;;7,0;9,0;;;;;1,0;;;;;;;;33,0;;;;;;;6,0;;;12,0;;1,0;;;1,0;;;;;2,0;;;;;12,0;;;;;;;;;;;;;8,0;;;;1,0;;;;;;1,0;;;;;;1,0;;;1,0;;;;;;;;;;;;;;;;;;;;;;;1,0;;;;;3,0;1,0;;;2,0;;;4,0;;;;;;;;;;7,0;;;;;;;;;;;;;6,0;;;;;;;;;;;;1,0;;;;;;5,0;;;;2,0;;;4,0;;;;;;;;;;;;;;;;;;;;;;;;;;;;;;1,0;;;;;2,0;;;;;2,0;;;;;;;;;;;1,0;;;;;34,0;;;;;;;;;;;;;;;;;18,0;;;;;;;;;1,0;;;;;;;;;;;;;;;;;;;;;;;;;;;;;;;;;;;;2,0;;;;;;;;;;;;;;;;;;;;;3,0;;;;;;;;;;;;;;2,0;;;;;;1,0;;;1,0;;;30,0;;;;;;;;;;;;1,0;;;;;;;;;;;;;;;;;;;;;;;;;;;;6,0;;;;;;;;;;;;;;;;;;;;;;;;;;;;;;;;;;;;;;;;;;;;;;;;;;;;;;;;;;;;;;9,0;;;;;;;;;;;;;;;;;;;;;;;;;;;;;;;;;;;;;;;;;;;;;;2,0;;;;;;;;;;;;;;;;;;;1,0;;;;;;2,0;;;;;;;;;;
inertial;;;;;;;;5,0;;;5,0;;2,0;;3,0;30,0;;;;1,0;;2,0;;;;;2,0;;;2,0;1,0;;3,0;;2,0;;;;1,0;;21,0;;;1,0;;;12,0;27,0;1,0;5,0;;;;;;;;1,0;8,0;;;;;;2,0;;;;34,0;;;;5,0;;;;1,0;;;4,0;;;;33,0;;;;;;;;;;;43,0;;4,0;;30,0;3,0;;;;4,0;;;5,0;;8,0;;;;;;;2,0;;27,0;;;;;2,0;2,0;18,0;3,0;;;;3,0;;1,0;3,0;;;;;2,0;1,0;;;;;96,0;;;;;;;;;;;1,0;;111,0;;;;;2,0;30,0;;;;1,0;;;;;;;;;5,0;;;;;;;;;;3,0;;1,0;;;;;;7,0;;;;;;;;;;;;;;;;;;;1,0;;;;;;;;;;;;;;;;1,0;;1,0;;;2,0;;;12,0;;;;;;;;;;;1,0;2,0;;;;;;;1,0;10,0;1,0;;;;;;;;;;;;;;;;;;;;;;;5,0;;;;;6,0;;;;;;3,0;;;;;;;;;;;1,0;;;;;;;;;1,0;;;;;;;;3,0;;;;;;;;;;;;;;;;1,0;;;;;;;;2,0;;;;;;;;;;;;;;10,0;1,0;;;;;;;;;;;;;;;;;;;;;11,0;;;;;;;;;;;;;;;;;;;;;34,0;5,0;;;;;;18,0;1,0;;;2,0;;;4,0;;;;;;;;5,0;;;;;5,0;;;;24,0;;;8,0;;;29,0;3,0;;;2,0;;14,0;;;;;5,0;;2,0;;;;1,0;4,0;;;;;1,0;;;;;;;;;2,0;6,0;;;;;;8,0;28,0;;;;;;1,0;;;;;3,0;;;1,0;;;;;;;;;1,0;;6,0;;;;;;;;;;;;;;;;;;;;;;;;;;;;;;;;;;7,0;;;1,0;;;;;;3,0;;;;;;;;;;;;;;;;1,0;6,0;;;;;1,0;;;;;;;;;;;;;;;;;;;;;;;;;;;;;;;;;;;;;;;;;1,0;;;;;;;;;;;;;;;;;;2,0;;;;;;;;;;;;;;;;;;;;8,0;;;;;;;;;;;;;;;;;;;;;;;;;;;1,0;;;;;;;;;;;;;;;;;;;;;;;;;;;;;;;;;;;;;;;;;;;1,0;;;;;;;;;;;;;;;;;;;;;;;;;;;;;;;;;;;;;;;;;;;1,0;;;;;;;;;;;;;;;;;1,0;;10,0;;;;;;;;1,0;;;;;10,0;;;;;;;2,0;;1,0;;;;;;;;;;;;;;;;;;;;;;;;;;1,0;;;;;;;;;;;;;;;;1,0;;;;;;;;;;;;;;;;;;;;;;;;;;;;;;;;;;;;;;;;;;;;;1,0;;;;;;;;;;;;;1,0;;;;;;;;;;;;;;;;;;;;;;;;;;;;;;;;;;;;;;;;;;;;1,0;;;;;;;;;;;;;;;;;;;;;;;;;;;;;;;;;;;;;;;;;;;;;;;;;;;;;;;
insulate;;;;;;;;2,0;20,0;43,0;;;;;;8,0;;;;;;;1,0;12,0;;;9,0;;1,0;;;;2,0;;4,0;2,0;;1,0;3,0;;;6,0;2,0;;;1,0;1,0;72,0;;1,0;59,0;7,0;;2,0;;3,0;12,0;;;;11,0;1,0;;;16,0;;;110,0;4,0;5,0;6,0;;;;;;;;;12,0;;51,0;;34,0;6,0;;;;;;21,0;;;21,0;;;;;5,0;;;;22,0;;;;6,0;;;;2,0;;21,0;;;16,0;164,0;5,0;;1,0;;;1,0;;;;4,0;;;4,0;;;1,0;1,0;;;;;;;;;;34,0;;;;23,0;18,0;;;7,0;;;;;1,0;;;4,0;;;1,0;;;;;;;;;;7,0;2,0;;4,0;2,0;6,0;;;3,0;1,0;2,0;1,0;18,0;7,0;3,0;7,0;4,0;;;;19,0;13,0;;33,0;;;4,0;32,0;2,0;;1,0;6,0;;;;;;39,0;388,0;7,0;;28,0;3,0;;;12,0;2,0;10,0;1,0;;15,0;;;1,0;210,0;;9,0;3,0;10,0;4,0;;9,0;;;;23,0;;8,0;;;7,0;;1,0;13,0;8,0;;3,0;;;;;;;;;;;7,0;;;;;57,0;1,0;2,0;10,0;6,0;16,0;;1,0;1,0;2,0;;1,0;;7,0;104,0;56,0;;;5,0;13,0;1,0;;;1,0;;4,0;;6,0;;;4,0;;;;48,0;;;;4,0;;3,0;;;;12,0;4,0;;1,0;15,0;;;;;1,0;;4,0;;;;;9,0;;;;;;;;2,0;;;;;;;7,0;;;2,0;;;2,0;;;;4,0;1,0;;;3,0;5,0;;;;;;;;3,0;2,0;;;;10,0;;;;;;;;;;;;;;;2,0;1,0;;;14,0;;;8,0;1,0;;;;;;;;;;;;;;;;;;;;2,0;;;;;;;;3,0;;;;1,0;;;;;;;;;;;;;;;;;;;;;;;;;;;;;;;;;;;;;;1,0;;;;;;;;;;;;;;;;;;11,0;;;;;;;;;;;;;;;;;;;;;;5,0;;;;;;;;;;;;;;;;;;;;;;;;;;;;;;;;;;;;;;;;;;;;;;;;;;;;;;;;;;;;;;;;;;;;;;;;;;19,0;;;;;;;;;;;;;;;;;;;3,0;;;;;;;5,0;;;;;;;;;;;;;2,0;;;;;;;;;;;;;33,0;;;;1,0;;;2,0;;;;;;;;;;;;;;;;;;;;2,0;;1,0;;;;;;;;6,0;1,0;;;;;;2,0;;;;;;;;;;;;;;;;;;;10,0;;;;;;1,0;;3,0;;;;;1,0;;;;;;;;;;;47,0;;;4,0;;2,0;;;1,0;;;;;9,0;4,0;;;;;;;;;;3,0;;;;;;;;;1,0;;4,0;;;;;1,0;4,0;;2,0;;2,0;;1,0;;1,0;;;;;;;;7,0;49,0;;;5,0;;;;;;;;2,0;;;;;;;;;;28,0;;;;3,0;;;;;;;;;;;;;4,0;;;;;;;;;;;;;;;;;;;;;;;;;;;;;;;;;;;;;;;;;;;;;;;;;;;;3,0;;;;;;1,0;;;;;;;;;;;;;;;;;1,0;;;;;;;;;1,0;;;;;;;;;;;;;;;;;;;;;;;;;;;;;;;;;;;;;;;;;;;;;;;;;;;;;;;;;;;;;;;;;;;;;;;;;;;;;;;;;;;;;;;;;;;;;;;;;;;;;;;;;;
integration;;;;;;;;8,0;1,0;;2,0;;2,0;;;16,0;;;1,0;;2,0;;;8,0;;;18,0;;2,0;;;;10,0;3,0;27,0;6,0;;;;;34,0;;;16,0;;;7,0;10,0;3,0;1,0;2,0;;;;;;;;1,0;;;;;;1,0;4,0;1,0;2,0;5,0;;1,0;1,0;2,0;;;1,0;;;;19,0;;6,0;;3,0;;;;1,0;;;;;;;1,0;;2,0;;11,0;;;;1,0;1,0;;1,0;2,0;;10,0;4,0;2,0;;;;;6,0;;1,0;;1,0;2,0;;;3,0;2,0;;;2,0;;1,0;;8,0;1,0;;2,0;2,0;4,0;;2,0;;2,0;;;4,0;11,0;;;;8,0;;;;;1,0;;1,0;7,0;;1,0;;1,0;;26,0;;;;;;;;;;;;4,0;;1,0;;;;;;;;4,0;19,0;;1,0;;;;;;;;;;;;2,0;;;;1,0;;;2,0;;18,0;;;;;6,0;2,0;;;;;;;;;;;;;;2,0;;1,0;;;;;;;;;;;;;;2,0;;;;25,0;4,0;;;;;;;2,0;;;;;;;;;;;;3,0;;;;;;;;;;;;6,0;;;;;103,0;;;;;2,0;;;;;;;;;;;1,0;;;;;;;;;;;;;;;;;;1,0;;;;;;;;;;;;;;;;;;;;;;;;21,0;;;;;;;;;;1,0;;;;;;;;;;;;;;;;;;;;;;;;;;;;;;;;;;;;;;9,0;;;;;;;1,0;;;;;;;;;3,0;4,0;10,0;2,0;;1,0;;1,0;;;;;;;;;11,0;;2,0;;;;;1,0;;;;;;;10,0;3,0;;1,0;7,0;;1,0;;;1,0;;;3,0;;;;2,0;;;;;;;6,0;;;2,0;;;;;11,0;;;;2,0;1,0;;;;;1,0;;20,0;;;;;3,0;;1,0;;;;;;;;;;;;;;;;;4,0;;;;2,0;;;3,0;;;;;;;;;;;;5,0;;;;;;;;6,0;;;;;;;;2,0;;;;;;;;;;;;;;;;;;;;;;;;;;;;;;;1,0;;;;;2,0;;;;;;;;;;15,0;;;;;1,0;;;;;;;;;;;;;;;2,0;;;;;3,0;;;;;;;;;;;;;;;;;2,0;;;6,0;;;;;;;;;;;1,0;;;;;;;;;;1,0;;;1,0;;3,0;;;;;;;;;;;;;;;;;;3,0;;;;;;;;;;;;;;;;;;;;;;;;;;;;;;;;;;;;;;;;;;1,0;;;;;;;;;;;;;;;;2,0;;;;;2,0;;;;;;;;;;;;;;;;;;;;;;4,0;2,0;;;;;;;1,0;;;;;2,0;6,0;;;;;1,0;;;;;8,0;;;;;;;;;;;;;;;;;1,0;13,0;;;;;;;6,0;1,0;;;;;;;;;;;;;;;;;;;;5,0;;;;1,0;;;;;;;;;;;;;;;;1,0;;;;;1,0;;;;;;;;;;;;;;;;;;;;;;;;;1,0;;;;;;;;;;;;;;;;;;;;;;;3,0;;;;;;;;;;;;;;;;;;;;;;;;;;;;;;;;;;;;;;;;;;1,0;;;;1,0;;;;;;;;;;;;;;;;;;;;;;;;;;;;;;;;;;;;;;;18,0;;;;;;;;;;;;
internet;;;;;;;;10,0;1,0;;;;4,0;;;4,0;;;;;;6,0;;;;;;4,0;1,0;;28,0;;9,0;;13,0;4,0;;;;;5,0;;;;2,0;;3,0;87,0;14,0;9,0;;;;;;;;;;;;6,0;;2,0;;;;;;;3,0;;1,0;;;;;;;34,0;;9,0;3,0;22,0;;3,0;;;;;2,0;;;;;1,0;5,0;;12,0;11,0;;1,0;;;;7,0;2,0;;;;;3,0;;;;5,0;;;10,0;2,0;;;;1,0;2,0;5,0;;;;;;;;;;;;;;;;;2,0;;4,0;;1,0;;;;;6,0;6,0;2,0;;2,0;31,0;;;8,0;1,0;13,0;12,0;;;;36,0;3,0;;;;;;;;;;;;;;1,0;;;;;;1,0;;;2,0;;;17,0;;;4,0;;;;;;;;;;;;;;;;;;;;;;;2,0;;;;;;;;;2,0;;;;;;;;;;;;;;;;;;;;;;;;;;;;11,0;;;;;;;2,0;1,0;;;;;;;1,0;;;;;;;;;5,0;3,0;;;;1,0;;4,0;;;;;;;;;;;1,0;;;;;;;;;;;;;2,0;;;2,0;;;;;3,0;;;;;;;;;;;;;;;;;;;;;;;;6,0;;;;;;;;;;1,0;;;;2,0;2,0;5,0;;;;;;;;;;;;;;2,0;;;;;;;;;;;;;;;;1,0;;3,0;;;;3,0;;;;;;;18,0;4,0;;;;;;;;;;;;;;;;;;;;;;;;;;;;;;;4,0;;;;5,0;;;;;;47,0;7,0;4,0;1,0;;;1,0;;;;;;14,0;;;6,0;;1,0;;;;;;;;;;;1,0;;22,0;;;;;;;;;;;;;;;;;;1,0;6,0;;;;;19,0;;3,0;1,0;10,0;2,0;17,0;;;;;;;2,0;;3,0;1,0;;;;;;1,0;;4,0;;;;8,0;;;;;;9,0;32,0;;;;;4,0;;;;;;;;;2,0;;;;;;;27,0;;;1,0;;;1,0;;2,0;;;;4,0;14,0;1,0;;1,0;;55,0;;2,0;2,0;;;;;;;2,0;;1,0;;;;;10,0;2,0;;;;3,0;;;;;;;6,0;3,0;1,0;;;;;;;;;;;3,0;;;1,0;41,0;;;;;2,0;;;;9,0;;;;;;;5,0;29,0;;;;;;;1,0;;1,0;;;;;1,0;;12,0;;;;;;;;;;;;;;;;;;;;;;;2,0;;;;;;;;;;;;;;;;;;;;;;;;;;;;2,0;;;;;;;;;;;;;;;;;;;;;;;;;;;;;;;20,0;;;;;;;;;;;;;;;;;;;;;;;;;;;;;;;;;;;;8,0;;;;;;;;;;;3,0;13,0;;;;;;;;;;;;;;;;;;1,0;;;;;;;;;;1,0;;;;;;;;;;;;;;;;;1,0;;;;;;;;;;;;;;;;;;;;;;;;;12,0;;;;;;;;;;2,0;;;;;;1,0;;;;;;;;;3,0;;1,0;;;;;;;;;;;;;;;;;;;;;;;;;;;;;;;;;;;;;;;;;;;;;;;;;;;;;;;;;;;;;;;;;;;;;;;;;;;;;;;;;;;;;;2,0;;;;;;;;;;;;;;;;;;;;;;;;;;;;;;;;;;;
interpolate;;;;;;;;1,0;5,0;;1,0;;;;;26,0;;;4,0;;1,0;;;;;;12,0;;;;1,0;;2,0;;;;1,0;8,0;;;6,0;;;1,0;;;8,0;3,0;;;;;;;;1,0;6,0;1,0;2,0;;;;;;2,0;2,0;1,0;;42,0;;13,0;;9,0;;;4,0;;;;28,0;;1,0;;;;;;;;;;;;;;;1,0;;19,0;;3,0;;;5,0;;;;;10,0;;;3,0;;;;15,0;;5,0;;2,0;;;1,0;1,0;1,0;;;;;4,0;;12,0;;;;7,0;;;;;;;;3,0;;;;;6,0;11,0;;;;4,0;;;2,0;;;2,0;;;12,0;;;;2,0;1,0;;;;;;1,0;;;;;;;;;;;;1,0;;;;;;;;;;;;;;;;;;1,0;;;;;16,0;;;;;;;;;;;;;;;;;;;;;;;;;;;;3,0;;;;;;;;12,0;;2,0;;38,0;;;;;;;;;;;;;;;;;;;;;;;;;;;;;;;;;;;;;1,0;;;;;;;;;;;2,0;;;;;;;;;;;;;;;;1,0;;;;;;;1,0;;;;;2,0;;;;;;;;;;;;;;;;;;;;;;;;;;;;;;;;;;;;;;;;;;;;;;6,0;;;;;;;;;1,0;;;;;;;;;;;;4,0;;;;1,0;;;6,0;;;;;;;;;;6,0;4,0;5,0;;;1,0;;;;;;;;;;;;;;;;;;;;8,0;;;;;5,0;;;2,0;;;;;2,0;;2,0;;2,0;;;;;;;;;4,0;;;;;;;;;2,0;;;;;;;;6,0;;;;4,0;;;3,0;;;;;;;;;;;;;;;;;;;;3,0;;10,0;;;;2,0;2,0;;;;;;;;;;;;;;;;;;;;;;;;;;;;;;;;;;;;;;;;;;;;;;;;;;;;;;;;;;;;1,0;;;;;;;;;2,0;;;;;;2,0;;;;;;;;;;;;;;;;;;;;;;;;;;;;;;;;;;;;2,0;;;;;;;;;;;;;;;;;;;;;;;;;;;1,0;;;;;;;;;;;;;;;;6,0;;;;;;;;;;;;;;;;;;;;;;;10,0;;;;;;;;;;;4,0;;;;;;;;;;;;;;;;;;;;;;;;;;;;;;;;;4,0;;;;;;;;;;;;;;;;;;;;;;;;;;;;;;;;;5,0;;;2,0;;;;;;1,0;;;;;;;;;;;;;;8,0;;;;;;;;;;;;;2,0;;;;;;;;;;;;;;;;;;;;;;;;;;;;;;;;;;;;;;;;;;;;;;;;;;;;;;;1,0;;;;;;;;;;;;;;;;;;;;;;;;;;;;;;;;;;;;;;;;2,0;;;;;;;1,0;;;;;;;;;;;;;;;;;;;;;2,0;;;;;;;;;;1,0;;;;;;;;;;;;;;;;;;;;;;;;;;;;7,0;;;;;;;;;;;3,0;;;;;;;;;;;;;;;;;;;;;;;;;;;
judgment;;;;;;;;5,0;7,0;;;;;;;13,0;;;;;;2,0;;;;2,0;261,0;;;;;3,0;12,0;;1,0;;;2,0;;;69,0;;13,0;;9,0;2,0;9,0;6,0;;6,0;;;;1,0;2,0;;;2,0;;;3,0;;;;;;;;;;;;28,0;12,0;;;1,0;;;15,0;;2,0;;1,0;;17,0;;55,0;;;;;;;;;1,0;;3,0;;;;3,0;;;;;;22,0;;;21,0;3,0;;;12,0;6,0;15,0;;1,0;;;;3,0;;;;;;11,0;;27,0;;;;;;2,0;;;1,0;;;3,0;;;;;17,0;;3,0;;2,0;1,0;;;6,0;;;52,0;;;119,0;;;;2,0;;;;;;;;;;;;;;;;;;;;;3,0;;;;;;;;;;;;;;;;1,0;;;;;;7,0;;;;161,0;;;;;;;;;;;;;;;10,0;;;;2,0;;;;6,0;;;;;;;;;;;;18,0;;;;;;;;;;;;;;;3,0;;;;;;;;9,0;;;;;2,0;;;;37,0;;;;;4,0;;;;;24,0;1,0;;;;;;;;;;;1,0;;;;;;;;;1,0;;;;;;;;;;;;;;;;;;;;;;;;;;;2,0;;;;;;;;;;;9,0;;;;;;;;;;;;;;;;;;;;;;;;;;;;;4,0;;;;1,0;;;3,0;;;;;;9,0;1,0;;;7,0;;;;;;;;;;;;;2,0;;8,0;;4,0;;;;;;1,0;;;;;;;;;;;;;;;;;;;;;;;1,0;;;;;7,0;;1,0;;1,0;;;;26,0;;;;;;;;;3,0;;;;;4,0;;;;;2,0;;;;;13,0;;;;;;;3,0;;;;;;;;;;;;;;;4,0;;;3,0;;;;;1,0;;;;;;;;;;;;;;;23,0;;;;;;;;2,0;;;;;1,0;;;;;;;;;;;;;4,0;;;;;;;4,0;;;;;;;;;;;9,0;;;;;;;;1,0;;;;;;;;;;14,0;;;;;;;;;;;;;;;;;;;;;;;;;3,0;;;;;;;;8,0;;;;;;;;;;;;;;;;;;;;;;;;;;;;;;;;;;;;;;7,0;;;;;;;;1,0;;;;;;2,0;;;;;;;;;;;;;;;2,0;;;;;;;;;;;;6,0;;;;;;;;;;7,0;;;;;;;;;;;;;;;;6,0;;;;;;;;;;;;;;;;;;;;1,0;;;;;;;;;;;;;;;;;;;;1,0;;;;;;;;;;11,0;;;18,0;;;;;;;;2,0;;;;;;3,0;;;;;;;;;;;18,0;;2,0;;;;;1,0;;;;;;;;;;;;;;;;;;;;;;;;;;;;;2,0;;;;;;;;;;;;6,0;;;;;;;;;;;;1,0;;;;;;;;;;;;;;;;;;;;;;;;;;;;;;;;;;;;;8,0;;2,0;;;;;;;;;;;;;;;;;;;;;;;;;;;2,0;;;;;;;;;;;;;;;;;;;;;;;;;;;;;;;;;;;;;;;;;;;;;;;;;;;;;;;;3,0;;;;;;;;;;;;;;;;
lead;;;;;;;;5,0;3,0;;;;4,0;;2,0;4,0;;;;;;2,0;;;;;1,0;;;1,0;;;12,0;;;2,0;1,0;;;;3,0;;;;;;;6,0;1,0;;25,0;1,0;;;15,0;;;;1,0;;15,0;;;;;;7,0;4,0;;;;;1,0;;;;;;;1,0;;3,0;;28,0;;;;;;4,0;15,0;;;;;;;;1,0;;;;15,0;;;2,0;16,0;;2,0;;22,0;2,0;;;;4,0;13,0;20,0;3,0;1,0;;;1,0;;;;;;;;;1,0;1,0;;;;;;;;;;;3,0;;;;4,0;3,0;2,0;;;;;;;20,0;;;;;1,0;2,0;;;;1,0;;;;;;;;2,0;;3,0;;;;7,0;4,0;;;;2,0;3,0;4,0;;;;;;41,0;;;;;;4,0;;;;1,0;;;;;;3,0;;;1,0;;5,0;;1,0;;;;6,0;12,0;;;;;1,0;;13,0;;10,0;;8,0;1,0;1,0;15,0;4,0;;;3,0;;;;;8,0;;7,0;;4,0;;4,0;;;2,0;;;;;;;2,0;;;;;;1,0;;;;3,0;;;;;;;;2,0;5,0;3,0;;;;;3,0;;;;;;;;;;;;;26,0;;1,0;1,0;7,0;;;;1,0;8,0;2,0;;;1,0;4,0;;;;;;;7,0;;3,0;;;9,0;;4,0;;;;;;;;;;1,0;1,0;1,0;;;;3,0;1,0;2,0;;;41,0;5,0;3,0;;;;;;20,0;;1,0;1,0;;;;;;2,0;;;;;;1,0;;;;;;;;24,0;15,0;145,0;;;6,0;;;;;;2,0;;6,0;;;10,0;;;;1,0;;;;;1,0;;;;;;;;1,0;;;;;;;;;;;7,0;;;;;;;;;;;;;;;;;;;4,0;2,0;;;4,0;;;;;;;;;;;;;;;;;;;;;;;;;;;;;;;;;;;;;;;;;;;;;;;2,0;;;;;;;;9,0;;;2,0;1,0;;;;;;;;1,0;;;;;;;;;2,0;1,0;;;;;;;18,0;;;;;;;;;;;;3,0;;;;;;;;;;;;;;;;;;;;;;;;;;;;3,0;;;;;;;;;;;;;;;;;;;;;;;;;3,0;;;;;;6,0;;;;;;;;;;;;;;;;;;;;;;;;;;2,0;;;;;;;2,0;;;;;;;;;2,0;;;;;;;3,0;;;;;;;;;;;;;;;;1,0;;;;1,0;;;;;;;;;;;;;2,0;;;;;;;;;;;1,0;;;;;3,0;;;;;;;2,0;2,0;2,0;13,0;;;;;;;;;;;;2,0;;1,0;;;29,0;1,0;;2,0;;;;;;1,0;;;;;;;;;2,0;4,0;;;;;;;;;;2,0;;;;;;;;;;;;;;;;;1,0;;;;;;;;;;;;;;;;;;;1,0;;;;;;;;;;;;;;;;;;;;;;;;;;;;;;;;;;2,0;;;;;;;;;;;;;;;;;2,0;;;;;;;;;;;;;;;;;;;;;;;;;;;;;;;;;;5,0;;;;;;;;;2,0;;;;;;;;;;;;;;;;;;;;;;;;;;;;;;;;;;;;;;;;;1,0;;;;;;;;;;;;13,0;;;;;;;;;;;;;;;;;;;;;;;;;;;;;;;;;;;;;;;;;;;;;;;;;;;;;;;;;;;;;;
management;;;;;;;;13,0;3,0;3,0;2,0;;;;;3,0;;;;;1,0;3,0;;;;;1,0;2,0;;;3,0;;5,0;;22,0;5,0;;;2,0;;30,0;;;;1,0;;16,0;31,0;12,0;10,0;;;;;;6,0;1,0;;;;;2,0;1,0;3,0;2,0;;;2,0;;;;;1,0;;;;3,0;;1,0;24,0;;26,0;;6,0;;2,0;;;;;1,0;1,0;;;1,0;7,0;1,0;1,0;14,0;1,0;;;34,0;;;19,0;;;7,0;1,0;;3,0;;;;7,0;;2,0;17,0;1,0;;;;;25,0;;;;;;;1,0;1,0;;;;;1,0;;;;;;;3,0;;;;3,0;;;1,0;14,0;6,0;;2,0;71,0;;1,0;2,0;1,0;5,0;13,0;;;;19,0;2,0;;;1,0;;;;;2,0;;;;;;;1,0;;;11,0;;2,0;;;;;;3,0;;;2,0;;;;;;;;1,0;;;;;;;;;;;;;;;;;;;;;;;;;;;;;;;;;;;;;;;;;;;;5,0;3,0;;;;;;;5,0;;;;;;;2,0;;;;;;;;;;;;;;;1,0;;;;;;;4,0;;;;;9,0;;;;;;;;1,0;;;2,0;;;;;;;;2,0;;;1,0;;;;;;;6,0;;;;;1,0;;;;;;;;;;;1,0;;;;;;;;;8,0;;;;;;;;1,0;;;;;;;;;3,0;;;;;;;;;;;;;;;;;;;;;;;;;;;;1,0;;;;;;;;;;;;;11,0;2,0;;1,0;;;;;;;;5,0;;;;;;;;;2,0;;;;;1,0;;;;2,0;;;2,0;;2,0;;3,0;;;;;;28,0;;3,0;;;;;;;;;11,0;3,0;;;4,0;;;;;;;;9,0;;;;;2,0;3,0;5,0;;;;1,0;;;;;;2,0;;;;;;;;;;;;;;3,0;;;;2,0;;;;;;;;;;;2,0;3,0;;;;;;;;;;;;;;;;9,0;;;5,0;;;;2,0;;1,0;;;;;;;;;;3,0;;;;;;;;1,0;;;;;;;;2,0;;5,0;3,0;;;7,0;1,0;;;;;;4,0;;;;;;;;2,0;;;;;1,0;;;;;6,0;;;;;;2,0;;;3,0;;;;;;;;1,0;;;;;5,0;;;;;;;;2,0;;;;;;;;34,0;15,0;;;4,0;;;;;;;;;;;;;6,0;2,0;;;;;;;;;;;;;;;;;;;;;;;;;;;;;;;;;;6,0;;;;;;;;;;;;;;;;1,0;;;;;;;;;;;;;;;;;;;;;;;;;;;;;;;;;;;;;;;;;;;;1,0;;;;;;1,0;;;;;;;;;;;;;;;1,0;;;;;;;;;;;;;;1,0;;;;;;;;;;;;;;;;;;;1,0;;;;;;;;;2,0;;;;;;1,0;;;;;;;;2,0;;;;2,0;;;;;;;;;;;;;;;;;;;;;;;;2,0;3,0;;;;;;;;;;;;;2,0;;;;;;;;;;;;;;;;;;;;;;;;;;;;;;;;;;;;;;;;;;;;;;;;;;;;;;;;;;1,0;;;;;;;;;;;;;;;;;;;;;;;;;;;;;;;;;;;;;;;;;;;;;;;;2,0;;;;;;;;;;;;;;;;;;2,0;;;;;;;;;;1,0
master;;;;;;;;1,0;;2,0;;;;;;;;;;;;1,0;;1,0;;;1,0;;;;;;7,0;1,0;22,0;;;;;;4,0;;;;4,0;;4,0;19,0;3,0;2,0;;;;;;2,0;;;;;;;1,0;;;;;;;1,0;6,0;;;;;1,0;5,0;;;10,0;;6,0;;5,0;;;;;;;7,0;;;;;2,0;;2,0;5,0;;;;8,0;;;;;;;;2,0;5,0;;;;4,0;;;;;;;;3,0;3,0;;1,0;;;;;4,0;;;;;;;;;;;;9,0;11,0;;;;11,0;;;;1,0;1,0;2,0;;6,0;;;;;7,0;19,0;;;;6,0;1,0;;;;;;;;;;;;;;1,0;;;;;;2,0;;;;;;5,0;;;;;;;;;;;;;;;;;;;;;;;;;;;;;;;;;;;2,0;;2,0;;;;;;4,0;;;;;;;;;;;;;;2,0;;;;4,0;;11,0;;;;;;;3,0;;;;;;;;;;;;;;;;4,0;;6,0;;;;1,0;;;;;;;;;;;;;;;2,0;;4,0;;;;;5,0;;;;;;;;;;;;2,0;18,0;;;;;;;;;;;;;;;;;;;;;;;;;;;;;;;;;;;;;;;;;;;;;;;1,0;;;;;;2,0;;;;;;;;;;;;;;;;;;;;;;;2,0;;;;;;;;;;;;;;;;;;;;;;;;;;4,0;;;;;;;;;1,0;1,0;;;;;1,0;;;;3,0;;;15,0;;;;2,0;;;;;;;7,0;4,0;;;;;;;2,0;;;;;;;;;5,0;;5,0;;;;;;;;;;;;;1,0;;;;;;;;;;;2,0;;3,0;;;1,0;;;;;1,0;;;;;;;;;;;;;2,0;;;;;;;;1,0;4,0;;1,0;;;;;;;;;;;;;1,0;;2,0;;;;;8,0;;1,0;;;;;;;;;1,0;;;2,0;1,0;;;;;;;;;;;;;;;;;;;;;;;;;;;;;1,0;;;;;;;;;;;;;;;;;;;;;;;;;;;;;;;;;;;;;;;2,0;;;;;;;;1,0;;;;;;;;;;;;;;;;;;1,0;;;;;;;;;;;;;;;;;;;;;;;;;;;;;;;;;;;;;;;;;;;;;;;;;;;;;;;;;;;;;;;;;;;;;;;;;;;;;;;;;;;;;;;;;;;;;;2,0;;;1,0;;;;;;;;;;;;;;;;;;;;;;;;;;;;;;;;;;;;;;;;;;;6,0;;;;;;;;;;;;;;;;;;;;;;;;1,0;;;;;;;;;;;;;;;;;;;;;;;;;;;;;;;;;;;;;;;;;;;;;;;;1,0;;;;;;;;;;;;;33,0;;;;;;;;;;;;;;;;;;;;;6,0;;;;;;;;;;;;;;;;;;;;;;;;;;;;5,0;;;;1,0;;;;;1,0;;;;;;;;;;;;;1,0;;;;;;;1,0;;;1,0;;;;;;;;;;;;1,0;1,0;;;;;;;;;;;;;;;;;;;
matrix;;;;;;;;17,0;24,0;186,0;66,0;;23,0;;7,0;61,0;;4,0;;19,0;29,0;3,0;3,0;;;11,0;44,0;2,0;;;2,0;;39,0;;15,0;2,0;7,0;15,0;5,0;;6,0;;30,0;4,0;4,0;2,0;93,0;41,0;7,0;5,0;22,0;15,0;4,0;;16,0;;32,0;21,0;91,0;3,0;4,0;8,0;;;35,0;2,0;;97,0;23,0;1,0;19,0;;44,0;10,0;;18,0;5,0;;2,0;159,0;;6,0;1,0;73,0;;6,0;;;;;4,0;;;1,0;29,0;3,0;7,0;;67,0;9,0;20,0;3,0;15,0;9,0;;;11,0;3,0;12,0;61,0;2,0;33,0;;;5,0;118,0;15,0;7,0;;3,0;;;5,0;8,0;3,0;13,0;;1,0;2,0;;;26,0;4,0;1,0;34,0;8,0;49,0;;;;7,0;;;42,0;12,0;;;1,0;64,0;12,0;2,0;;4,0;8,0;8,0;;51,0;;4,0;8,0;5,0;;106,0;;;;7,0;2,0;;;;;1,0;4,0;7,0;29,0;1,0;;;;;7,0;;;9,0;35,0;;2,0;;;;;;7,0;;;;;;;;;8,0;30,0;;;4,0;2,0;5,0;;;;;1,0;;;;;2,0;;;5,0;;;;;;;19,0;;;1,0;;;1,0;;1,0;;;;;;1,0;1,0;;3,0;55,0;1,0;351,0;27,0;;;;;;;2,0;;;;;1,0;;35,0;2,0;1,0;32,0;;;;;5,0;13,0;;;;;;4,0;9,0;;;;;2,0;43,0;;;;;2,0;7,0;;;;;1,0;;5,0;;;2,0;;;2,0;;;12,0;;;2,0;;;;4,0;14,0;;;1,0;;;;;;19,0;;;;;;1,0;;;;;2,0;10,0;;5,0;;;;;;1,0;2,0;;;3,0;19,0;;;;5,0;;;4,0;50,0;;;;7,0;;;;;;;;;3,0;;;;1,0;;;;2,0;243,0;;;;;;;;;;1,0;;15,0;1,0;;;4,0;;;3,0;1,0;;;;2,0;;;;10,0;4,0;53,0;9,0;10,0;1,0;56,0;42,0;;4,0;;;;;;1,0;1,0;;1,0;;8,0;;;10,0;10,0;2,0;14,0;5,0;;18,0;16,0;4,0;7,0;;2,0;2,0;;4,0;3,0;2,0;1,0;13,0;5,0;;;;;;5,0;;1,0;;1,0;10,0;;;;;;;;2,0;1,0;;;;42,0;;;56,0;;1,0;;1,0;4,0;;4,0;45,0;11,0;2,0;1,0;;14,0;;;1,0;6,0;1,0;;;;;;;;;;1,0;;54,0;;37,0;;23,0;;;;1,0;;1,0;;;;;3,0;;8,0;6,0;;;;;;;;23,0;;;;23,0;36,0;;;;;;4,0;;10,0;9,0;;;4,0;;;1,0;;6,0;6,0;;;;;;8,0;5,0;;;;;;;2,0;35,0;4,0;;;;;;;;;;;;;;;;;;;;;;;;;;;;;;;;4,0;;2,0;;;;;;;;;;5,0;;;;;19,0;2,0;;;;;8,0;;;;1,0;;;11,0;;;;;;;;;1,0;;;;93,0;;;;;;3,0;;;;;;;;;2,0;2,0;;69,0;1,0;;;;;;;1,0;;;;;;;;;;8,0;;;;;1,0;2,0;;4,0;;;;;;;;;;;;;;;2,0;;;;;;;;7,0;;;;;;;;;;;1,0;;;;;;;1,0;;4,0;1,0;2,0;;;;;4,0;;;5,0;;;;2,0;;;;;;;2,0;;;;2,0;5,0;;;;;5,0;2,0;1,0;28,0;3,0;;;;7,0;6,0;1,0;;1,0;;;4,0;1,0;;;;4,0;;4,0;;4,0;27,0;;290,0;;;;;;;15,0;;3,0;;;2,0;;8,0;;;6,0;3,0;;2,0;;;;1,0;;3,0;;;2,0;;;6,0;;;;;;1,0;;;1,0;;;;;;;;;1,0;;;;;;1,0;;3,0;;;;36,0;;;;;;;;1,0;;;;;;;;;31,0;;;;;;;;;;;;;;2,0;2,0;;1,0;;;;1,0;;;;;;;;;;;;;16,0;;;;;;;;;;;;4,0;;;;;;;2,0;;;;5,0;;1,0;2,0;13,0;;;2,0;;;;;4,0;;;;;3,0;;;;;;;5,0;;;;;7,0;;;1,0;;;;2,0;3,0;;;3,0;;;;;;;2,0;;;;;;;27,0;;;;;;;;;;;;;;;;;;
microphone;;;;;;;;12,0;;11,0;42,0;;4,0;;1,0;11,0;;;;;;33,0;;;;;;;;;7,0;;12,0;;5,0;1,0;;;;;19,0;;;;7,0;;4,0;31,0;11,0;7,0;2,0;1,0;;;;1,0;;;2,0;;4,0;1,0;7,0;;;;;2,0;2,0;11,0;1,0;;12,0;;2,0;;;;;16,0;;2,0;;28,0;;;;;;;10,0;;;1,0;;2,0;8,0;;18,0;;;;13,0;;;2,0;1,0;;6,0;;;5,0;;6,0;;11,0;;;4,0;;;;6,0;12,0;12,0;2,0;;;;;;;;;3,0;;;;;;;;3,0;20,0;1,0;;;7,0;27,0;;;;2,0;5,0;;1,0;34,0;;;;1,0;7,0;29,0;;1,0;;13,0;4,0;;;1,0;;;1,0;;1,0;5,0;;;;5,0;1,0;;;;4,0;;;;;;;;13,0;;;5,0;;;;;;;1,0;;;;4,0;;1,0;;2,0;;;;;;;;1,0;19,0;;;;;;;;4,0;;;;;14,0;;;;1,0;;;;;;;;;;;;;;;;;;;47,0;;;;;;1,0;;;;;;;;;3,0;;;;;;4,0;;9,0;7,0;;;;;2,0;;7,0;;;;;1,0;;;;;;;;1,0;;8,0;;;;;;1,0;;;;;;1,0;1,0;1,0;2,0;;15,0;;;;;;4,0;;;;;;;;;;2,0;;;;;;;;4,0;;;1,0;;;4,0;;;;;;;1,0;1,0;2,0;2,0;;;;;;;;1,0;;;;;;;;;;;;;;;;;1,0;;;;;;;;;;;;;;;;;1,0;2,0;;;;;;;;;;;;1,0;;;;;;;;1,0;;;;;;;1,0;;26,0;1,0;;1,0;;;;;;;1,0;;;1,0;1,0;5,0;;;;;;;;;11,0;4,0;1,0;;;2,0;8,0;40,0;;;;;;;1,0;;;;;13,0;1,0;;1,0;1,0;;;1,0;;;;;;;;;;8,0;;;;;1,0;;20,0;;;;2,0;;;;;;;;;9,0;;1,0;;;;4,0;;;1,0;4,0;;;;;78,0;3,0;;1,0;;1,0;;;;;;1,0;;;;;;;;;;;;;1,0;;;;;;;1,0;;1,0;;1,0;;2,0;;11,0;2,0;;;;;;3,0;1,0;3,0;1,0;;;;;;4,0;;;3,0;;;;1,0;;;;;3,0;;;1,0;;;;8,0;;;1,0;;1,0;;;;;;;;;;;;;;;;;;6,0;3,0;7,0;;;1,0;;;;;;;;;;;8,0;;;;;1,0;;;;;20,0;1,0;8,0;;;;;;;;;;2,0;;1,0;;;;;;;;;;;;;;;;;;;;;;;;;;;;;;;;1,0;;;2,0;1,0;;;4,0;;;;;;;;;;;3,0;;;6,0;;;;;;;;;;;;;;;;;;;1,0;;;;;;;;;;;;;;;;;;;;;;;;;;;;3,0;;;;;;;;;;;;;;;;;;;;2,0;;;;;;;;;;;;;;;;;;;1,0;;;;;;;;;;;;;;;;;;;;;1,0;;;;;;;;;;;;;;;;;;;;;;;;;;;;;4,0;;;;;4,0;;;;;;1,0;;;;1,0;;;;2,0;2,0;;;;;;;;;;;1,0;;;;;22,0;2,0;;;;;;;;;;2,0;2,0;;;1,0;;;;;;;;;;;;;;;;;18,0;;;2,0;;;;;;;;;;3,0;;;;;;;;;;;;;;;;;;;;3,0;;;;;;;;;;;;;;;;;;;;;;;;;;;;;;;;;;;;;;;;;;;;;;
overlay;;;;;;;;3,0;;;;;19,0;;6,0;4,0;;;;;;7,0;;;;;4,0;;;;1,0;1,0;17,0;;7,0;5,0;;;;;13,0;;;;9,0;;6,0;6,0;1,0;51,0;;;;;1,0;;170,0;;2,0;;;;;3,0;;;;;22,0;;14,0;;16,0;;;;4,0;;;76,0;3,0;6,0;1,0;28,0;;2,0;;;;;;;;;;1,0;;;10,0;3,0;1,0;;6,0;1,0;;8,0;1,0;1,0;2,0;1,0;;11,0;;;;5,0;13,0;6,0;;;;;1,0;1,0;21,0;2,0;;;;1,0;;3,0;6,0;;1,0;;;;;;;;1,0;2,0;2,0;;;2,0;;4,0;;;;3,0;5,0;;6,0;;;;;2,0;4,0;;;1,0;12,0;26,0;;;6,0;;;4,0;4,0;6,0;;;;;;;;5,0;;;;;;;;;;1,0;;1,0;3,0;;;;;;;1,0;;;;;;14,0;;;;;;;;;;;;;;;;;;;1,0;;;;2,0;;1,0;5,0;;;;;1,0;1,0;5,0;;;;;;2,0;;;;;;;;2,0;;;;;;;4,0;3,0;;10,0;;;;;;2,0;;;;;;;;;;;;;;;;;;4,0;;;;;;;;;;;1,0;;;;;;;;;;;3,0;;;8,0;;;;2,0;;;;;;;;;;;;;;;;1,0;;5,0;;;;;;;;;;;;;;;;;;;1,0;4,0;;;;1,0;;;;;;;;;;;;2,0;;;;;;;;;;;;4,0;;;;;;;;;;;1,0;;1,0;;;;;2,0;;;;;;1,0;8,0;1,0;1,0;3,0;7,0;;4,0;;;1,0;;;;;;;;;;1,0;;3,0;;;2,0;;;;;;2,0;;;;;;;;;;;;;;;1,0;3,0;6,0;;;;1,0;;;;;;2,0;;;5,0;4,0;;;7,0;;;;;;3,0;1,0;;3,0;1,0;;2,0;;;;;;;;;;;8,0;4,0;;1,0;;;;2,0;;;;;;;1,0;;;;;;;5,0;;;;;;;1,0;;;;1,0;;;2,0;12,0;;;5,0;;;;2,0;;1,0;;;3,0;;7,0;;;;;1,0;19,0;;;2,0;;;;;;;;;;4,0;;;;;;1,0;;;;;;;;;;;4,0;;;;;1,0;;;;;;1,0;;;;;;;;;;;;;;;;;;;;;;;;;;;;;;2,0;;13,0;;;;;;;;1,0;;;;;;3,0;;;;20,0;7,0;;;;;;;;;;;;;;;;;;;;;;;;;2,0;;;;;;;;;;;;;;;;;40,0;;;;;;;2,0;;;;;;;;;;;;;;;;;;;;;;;;;;;;;;;;2,0;;;1,0;;;;;;;;;;;;;;;;;;;;;;;;;;;;;11,0;;;;;;;;;;;;;;;;;;;;4,0;;;;;;;;;;;;;;;;;;;;3,0;;;;;;3,0;;;;;1,0;;;;;;;;;;;;;;;;;;;;;;;;;;;;;;;;;;;;;;;;;;;;;;;;;;;;;;;;2,0;;1,0;;;;;;;;;;;1,0;;;;;1,0;;;;;;;;;;;;;;;3,0;;;;2,0;1,0;;;;;;;;;;;1,0;;4,0;;;;;;;;;;;;;;;;;;;;;;;;;;;;;;6,0;;;;;;;2,0;;;;;;;;;;;;;;3,0;;3,0;;;5,0;;;;;;;1,0;139,0;;;;3,0;;;;;;;;;;;;;;;
package;;;;;;;;4,0;1,0;;4,0;;;;2,0;6,0;;;;;;;;;12,0;;3,0;;3,0;;;;10,0;;3,0;;;;1,0;;2,0;;1,0;;;4,0;5,0;46,0;;;21,0;3,0;;;;3,0;13,0;;;;;1,0;3,0;2,0;4,0;5,0;;31,0;;1,0;;;2,0;;;3,0;;7,0;1,0;86,0;;7,0;;48,0;;;;;;;49,0;;;4,0;;;;;23,0;;;;36,0;1,0;;;16,0;3,0;;;;;2,0;;;5,0;32,0;13,0;2,0;;1,0;2,0;3,0;;;;;;2,0;;;;14,0;;;;1,0;2,0;;;;;;87,0;;;;23,0;;4,0;;;;;;;15,0;;;2,0;;2,0;1,0;;;;;1,0;;;;;12,0;;;4,0;35,0;3,0;;;7,0;10,0;6,0;9,0;;11,0;1,0;22,0;;;;1,0;;3,0;;3,0;;;;8,0;;;;4,0;;;;;1,0;3,0;6,0;;;;2,0;;;;;5,0;33,0;;1,0;;;;4,0;;31,0;5,0;17,0;1,0;1,0;12,0;;4,0;;6,0;3,0;1,0;;;;1,0;;;;;;5,0;3,0;;;;3,0;;11,0;1,0;1,0;1,0;;13,0;2,0;;39,0;;4,0;3,0;;;;5,0;4,0;6,0;;1,0;;1,0;24,0;34,0;;;1,0;1,0;;3,0;;;;10,0;;1,0;;18,0;;;;;5,0;;5,0;;1,0;;3,0;1,0;;;;3,0;;;34,0;;7,0;1,0;;;2,0;4,0;;2,0;;1,0;;;;;;;;1,0;;;;;13,0;;;1,0;3,0;;2,0;7,0;;;;;2,0;;;;;10,0;;;;2,0;;1,0;1,0;;;7,0;1,0;2,0;;;6,0;1,0;;;;;;;6,0;3,0;3,0;;;2,0;;;1,0;;4,0;;;1,0;1,0;;;;;1,0;;;2,0;;;;;3,0;;;;;;;;;;;;;;;;;;;7,0;;;;;3,0;;;;;19,0;11,0;;;;;;;;;4,0;;;;;;;;;;;;;;;;;;1,0;;;;;2,0;;;;;;;;;;;;;;;2,0;1,0;;;;;;;;;;;;;;;;;3,0;;;;;;;;;;;;3,0;;;;;;;;;;;;;2,0;;;;;;;;;7,0;2,0;;;;1,0;;;;;;;;2,0;;;;;;;;;;;;;;;;;4,0;7,0;;;;;;;3,0;;;;;;;3,0;;;;;;;4,0;;;;;;;;;7,0;;;;1,0;2,0;;1,0;;;;;;;;;;;;1,0;;;;;8,0;;;;;6,0;2,0;;;11,0;;;;;;;2,0;;;;;;;;;;;;;1,0;;;;;1,0;;3,0;2,0;1,0;;;;;;;;5,0;;4,0;;;;;1,0;;;;;;;1,0;;;;;;;;;;;;;;;;;;1,0;;;2,0;;;;;2,0;;;;;;;;;;3,0;;;;;;;;2,0;1,0;;1,0;;5,0;;2,0;2,0;1,0;;;;10,0;;;1,0;;;;4,0;;;1,0;2,0;;;;;;;;5,0;;;;;3,0;;;;;;;;;;;;;7,0;;;;;;;;;;;;;1,0;;;;;10,0;;;;;;;;;5,0;1,0;;;;;;;;;;;;;;2,0;;;;;;;;;;;;;;;;;;;;;;;;;;;;3,0;;;;;;;;;;;;;;;;;;2,0;;;2,0;;2,0;;;;;;;;;;;;;;;;;;;;;;;;;;;;;;;;;;;;;;4,0;;;;;;;;;;;5,0;;;;;;;;;;;;;;;;;;;;;;;;;;;;;;;;;;;;;;;;5,0;;;;1,0;;;;;;;;;2,0;;4,0;;;1,0;;;;;;;;;;;;;;3,0;;;;;;;;;;;;;;
photodetector;;;;;;;;5,0;;6,0;40,0;;;;1,0;;3,0;;;;;;;;;;6,0;;;;;;4,0;;13,0;4,0;;;;;1,0;;;;4,0;;;6,0;;1,0;10,0;;;;;;1,0;;;;;;9,0;;5,0;1,0;11,0;5,0;;;3,0;;10,0;;;1,0;;;;15,0;;4,0;;19,0;;;;;;;4,0;;;7,0;6,0;;1,0;;8,0;;;1,0;;7,0;5,0;;10,0;1,0;18,0;;;;;;;44,0;1,0;6,0;;;;2,0;1,0;2,0;;;;;1,0;3,0;;1,0;3,0;;;;2,0;;;;3,0;;;5,0;;;;4,0;30,0;;;1,0;;;;;7,0;;;8,0;;4,0;1,0;;;;;7,0;;;;;;7,0;;;;;;;3,0;;;;5,0;3,0;;;;;;;;2,0;;;;;;;;;1,0;5,0;;;;;;7,0;3,0;;;14,0;;;;;;;1,0;2,0;;;;;3,0;;31,0;;9,0;;;;;;3,0;;;;2,0;;2,0;;2,0;;3,0;;17,0;5,0;;27,0;;;;;18,0;;;;;;1,0;1,0;2,0;;;;;;;1,0;;;;;;3,0;17,0;24,0;2,0;;;;;;;;;;;;1,0;;;;;;4,0;;;;;;;;;;;;;;;;;1,0;;;;;;;;;;;;;;4,0;;;;;;1,0;;;;;;;;;;;;;2,0;;;;;;;;;1,0;;;;4,0;;;;;;;1,0;;;;;;;;;;;;;;;;;;;;;;4,0;3,0;;;;;;;;;;;;;;;;;;;;;;;;;;;;;;;;;;;;;;;;;1,0;;3,0;;;;;;;;1,0;;;;;;;;;;;;;2,0;;;;;5,0;;;;;;;;;;;;;;;;;;;;;2,0;;;;;;;;1,0;;;;;8,0;;;;;;2,0;;;;;;1,0;;1,0;;;;;;;;;;;;;;1,0;;;;;;;;;;;;;;2,0;1,0;;;;;;;;6,0;;;;;;;;;;;;;;;;2,0;;;;;;;;;;;;;;1,0;;;;;;;;;;;;;;;;;;;;;;;;;4,0;;;;1,0;;;;;;;;;;;;;;;;;;;;;;6,0;;;;;;;3,0;;;1,0;;;;;;;1,0;;;;;;;;;;;;;;;;;;;;;3,0;;;;;;;;;;;;5,0;;;;;;;;;;;;;;;;;;;;;5,0;;;;;1,0;;;;;;;;;;;;;;;;;;;;;;;2,0;;;;;;;;;;;;;;;;2,0;;;;;;;;;;;;;;;;;3,0;4,0;2,0;;;;;;;;1,0;;;;;;;;;;;;;;;;;;;;;;;;2,0;;;;1,0;;;;;;;;;;;;;;;;;;;;;;;;;;;;;;;;;;;;;;;;;;;;;;;;1,0;;;;;;;;;;;;;;;;;;;;4,0;;;;;;;;;;;;;;;;3,0;;;;;;;;;;;;;;;;;;;;;;;;;;;;1,0;;;;;;2,0;;;;;;;;3,0;;;;;;;;;;;;;;;;;;;;;;;;;;;;;;;;;;;;;;;;;;;;;;;;;;;;;;;;;;;;;;;;;;;;;;;;;;;;;
photodiode;;;;;;;;9,0;29,0;17,0;12,0;;4,0;;;;;;;;;;;2,0;6,0;5,0;22,0;;;;;;18,0;;1,0;;;;;;;;3,0;;;5,0;;27,0;;;27,0;6,0;;2,0;;;16,0;;;;2,0;;;;16,0;;5,0;38,0;;;;;51,0;;;1,0;;;;26,0;;26,0;;67,0;;;;;;;;;;4,0;;;;;9,0;;;;4,0;;;;8,0;;1,0;;;1,0;;;;59,0;37,0;9,0;;;;;;8,0;1,0;;;;;1,0;;;;;;;19,0;;;;;;;14,0;;;;9,0;94,0;;;;4,0;13,0;1,0;;;;;53,0;;6,0;11,0;;6,0;;;;;6,0;;3,0;;5,0;;;;;1,0;3,0;;;;;112,0;;;;3,0;;;;14,0;27,0;1,0;;;;5,0;25,0;;;;;;;;;;;27,0;;;2,0;;3,0;;;;;;13,0;;;;;23,0;;20,0;;2,0;;;;;;;;;;3,0;;;;;;5,0;;79,0;1,0;;;;;;;3,0;;;;;;;1,0;43,0;;;;;;;1,0;;;2,0;;;;27,0;34,0;;;;2,0;;;;;;;;;;;;;;;;;;;;;;;;;3,0;;4,0;;2,0;;;5,0;;;;;;;;;1,0;;;;;1,0;;;;;;1,0;;;;;;;;1,0;;;;;;2,0;;;;2,0;;;;;;;;;;;;;;;;;;;;;;;;;;;;;;;;;;;;;;;;;;;;;;;;;;;;;;;4,0;;;;;;;;;;;;;;4,0;;;;;;;;;;;3,0;;;;;3,0;;;;;;;6,0;;;;;;;;;;;;;;;;;;;;;;;;;;;;;;;;;15,0;;;2,0;;1,0;;;;;;4,0;;;;;;;;;6,0;;;;;;;;;;42,0;;;;;;;;;;;;;;;;;;;;;;;;;;;;;;;;;;;;;1,0;;;;2,0;;;;;;;;;;;;;3,0;;;;;;;;11,0;;;;;;;;;;;;;;;;;;;;;;;;;;;;;;;;;;;;;;;;;;;;;;;;;;13,0;;;;;;55,0;;;;11,0;;;;;;;;;;;;;;;;;;;;;;;;;;;;;;;;;;12,0;;;;;;;;;;;;;;;;;;;;;;;;;;;;;;;;;;;;;;;;;;;;;;;;;;;;;;;;2,0;;;;;;;;1,0;;1,0;;;;;;;;;;;13,0;;;;;;;;;;;;;;;;;9,0;12,0;;7,0;14,0;;;;;30,0;4,0;;35,0;3,0;;;29,0;;;;3,0;;2,0;;;;4,0;;;;;;;;76,0;;;3,0;2,0;;;;;;1,0;;;;1,0;;;;;;;;;;;;1,0;;;;;;;;;;;;;;;;;;;;;;;;;;;;;;;;;;;;;;;;;;;3,0;3,0;;;;;;;;;;;;;;;;;;;;;;;;;;;;;;;3,0;;;;;;;;;;1,0;;;;;;;;;;;1,0;;5,0;;;;;;;;;;;;;;;;;;;;;;;;;;;;;;;;;;;;;2,0;;;;;;1,0;;;;;;;;;;;;;;;;;;;;;;;;;;;;;;;;;;;;;;;;
photoelectric;;;;;;;;21,0;53,0;121,0;74,0;;2,0;;9,0;14,0;;;;;;16,0;;2,0;;;40,0;;;;;;100,0;;6,0;2,0;;;;;10,0;;3,0;5,0;19,0;15,0;1,0;186,0;;3,0;38,0;10,0;;13,0;1,0;;506,0;;;;4,0;;2,0;;20,0;;6,0;79,0;6,0;2,0;24,0;;99,0;;;52,0;;;3,0;90,0;6,0;47,0;;277,0;;;2,0;;;2,0;17,0;;;10,0;3,0;;;;14,0;;;;;6,0;;3,0;98,0;;105,0;;13,0;124,0;5,0;;32,0;272,0;141,0;13,0;4,0;;;1,0;6,0;7,0;4,0;;;;;10,0;;;1,0;2,0;;;28,0;;1,0;;;;;14,0;2,0;1,0;;35,0;197,0;;;;7,0;8,0;27,0;6,0;50,0;;;129,0;;9,0;439,0;;;;;4,0;1,0;2,0;2,0;3,0;;7,0;27,0;;;;19,0;2,0;;1,0;;;226,0;34,0;;11,0;;;;;;21,0;;9,0;;;;26,0;;;6,0;20,0;;;48,0;;6,0;14,0;48,0;;;9,0;;;;;2,0;;;28,0;;;;;64,0;;124,0;4,0;38,0;;;2,0;;;;6,0;4,0;;1,0;;1,0;7,0;4,0;5,0;;;447,0;2,0;;;;;;;68,0;6,0;;6,0;;;;;71,0;;7,0;11,0;3,0;2,0;;;;1,0;;;2,0;1,0;36,0;52,0;;;1,0;4,0;;8,0;2,0;;;5,0;;5,0;;;;;2,0;;8,0;;;2,0;;;;;;3,0;1,0;;;;3,0;;;;;;2,0;;;;;;2,0;;;;;2,0;;;;;;;;4,0;7,0;;;;;3,0;;;;;1,0;1,0;3,0;;;15,0;;;;;;;;;;;;;;;;1,0;11,0;;;;;;;;;;;;;;;4,0;;;;;7,0;;;2,0;;1,0;;1,0;;;;;;1,0;;;;;;1,0;;;;;;;;;2,0;;;2,0;4,0;;;2,0;;;;;;12,0;2,0;;;;2,0;;4,0;;;;;;;;;;;16,0;6,0;1,0;;;;;;;;;7,0;;;;;;;;;;;;;;;;;;4,0;;2,0;;;6,0;;;;2,0;;;6,0;;;7,0;;;;;1,0;;;;;;;;;;42,0;;;;;;;;;;;;;;;;;;;;;;;2,0;;1,0;;;1,0;;;;;;;3,0;;1,0;;;;3,0;;;;;1,0;10,0;;;;;;9,0;90,0;;;;;;;;145,0;;;;;;;;;;;;;;;;;;;;;;;;;;;;;;13,0;;;;;2,0;3,0;11,0;;;;;;1,0;;;;;;;8,0;;;;;;166,0;4,0;;;17,0;;;;;;18,0;;;;;;;;;;;;;;;;;;;;;2,0;;;;;;;1298,0;5,0;;1,0;;;;;;;;;;;;;;;;;;12,0;;;2,0;;;;;;;;;18,0;;;;;;;;;3,0;1,0;;;;;;4,0;;;;;;;11,0;54,0;;;;;3,0;240,0;;;;;;;2,0;;;;;1,0;;8,0;;;;;;;;;;;;3,0;;;;;47,0;72,0;10,0;16,0;21,0;1,0;;;;15,0;;;26,0;23,0;;;40,0;5,0;;;55,0;2,0;31,0;;3,0;;2,0;;4,0;;39,0;;;1,0;54,0;7,0;;5,0;6,0;3,0;1,0;;;;;;;;;;;;;;;;;;;2,0;;;;;;;;;;;;;;;;;;;;;;;;;;;;;;;;2,0;;;;;;;;;;;;;;;;;;;;2,0;;;;;;;;7,0;;;;;;;8,0;;;;;2,0;;;;;4,0;;;;;;2,0;;1,0;;;;;;;;;;;;;;;;7,0;;;;;;;;;;;4,0;;;;;;;;;;;;;;;;;;;;3,0;;1,0;;;;;;;;3,0;;6,0;;3,0;;;;;;;;;;;;;2,0;;;;;;;;;;;;;;;;;;;;;;;
plug;;;;;;;;8,0;;;14,0;;12,0;;;4,0;;;;;;;;;;;;;;;1,0;;18,0;;3,0;5,0;;;2,0;;;;1,0;;2,0;1,0;3,0;18,0;3,0;14,0;5,0;;;;;;4,0;;;;;;3,0;1,0;;;;10,0;;2,0;3,0;;;;;;;;1,0;16,0;;1,0;1,0;14,0;;1,0;;;;;6,0;;;2,0;;;1,0;;12,0;9,0;;;12,0;2,0;;2,0;;;;;;5,0;2,0;2,0;;2,0;51,0;2,0;12,0;;;;;1,0;;12,0;;;;;;;;;;;;;;;;;1,0;2,0;;;;2,0;7,0;1,0;3,0;;;2,0;;6,0;20,0;;1,0;1,0;1,0;3,0;4,0;;;;16,0;4,0;;;;;;;;;1,0;1,0;;;;6,0;;2,0;;3,0;;2,0;;;;;;24,0;;35,0;;;3,0;19,0;;1,0;;1,0;;;36,0;;;;4,0;;1,0;1,0;;;2,0;;;2,0;1,0;;;;;;;;1,0;;3,0;;;18,0;3,0;;;7,0;;;;;;;;;1,0;1,0;17,0;;1,0;;;;;;10,0;;;;1,0;;4,0;10,0;9,0;;2,0;;;;2,0;1,0;;;;3,0;;7,0;7,0;3,0;1,0;;1,0;;;;;;;;17,0;;;;1,0;;;;1,0;;;2,0;14,0;;;;;;;;;4,0;;;;;;22,0;;1,0;;;;1,0;;;1,0;4,0;;;;;;;;;;;2,0;1,0;3,0;;3,0;1,0;;;;;;;1,0;;;;;;;;;;;;6,0;;2,0;1,0;;2,0;;;;;1,0;;;;;;1,0;;;;;4,0;;;;;;1,0;;;;;4,0;;;;;;;;1,0;1,0;;;;;;;;;;;;3,0;;;;;;;;;;;;;;2,0;;1,0;;;;;;;;;1,0;;;;1,0;;;;;;;;;;;;;;;;3,0;;;;;;;;;;;1,0;;;7,0;;;;5,0;;;;;;;;2,0;;;;;;;1,0;;;;;10,0;;35,0;;;;;;;;;;;13,0;;;9,0;;;;6,0;;;2,0;;;;;1,0;7,0;;;;;;3,0;;;;;;;3,0;;;;;;;;;11,0;2,0;;;;;2,0;;;;;;;;;;;5,0;1,0;;;;;;;14,0;1,0;;;1,0;;;;;;;;;;;;;;;3,0;;;;;;;;1,0;;;;1,0;;;;;2,0;;;;3,0;;;;;;;1,0;2,0;1,0;;;2,0;;;;1,0;;;1,0;;2,0;;2,0;1,0;;;;3,0;;;;;;;;;;;;;2,0;;;;;;;;;1,0;;;6,0;;;;;;;;;;;;;2,0;;;;;;;;;;;;;;;;;;;;;;1,0;;;;;;;;;;;1,0;;;;;;;;;;;;;;;;;;;;;1,0;;;;;1,0;;2,0;;;2,0;;;;;;;;;;;;;;;;;;;;;;;;;;8,0;1,0;;1,0;4,0;;;;;;;;;;;;;;;;;;4,0;;;;3,0;;;;;;;;;;;;;;;;;;;;;;;;;;;;;;;;;;;;;;;;;;;;;;1,0;;;;;;;;;;;;;;;;;;;;;;;;;;;;;;;1,0;;;7,0;;;;5,0;;;;;;;;;;;;3,0;4,0;1,0;;;;;;;;;;;;;;;;;;;;;;;;;;;;;;;;;;;;;;;;;;;;;;;;;9,0;;;;;;;;;;;;;;;;;;;;;;;;;;;;;;;;;;;;;;;;;19,0;;;;;;;;;;;;;;;
positional;;;;;;;;12,0;12,0;2,0;;;;;1,0;76,0;;;;;4,0;;1,0;;;;;;;1,0;;;7,0;;11,0;;11,0;1,0;;;85,0;2,0;4,0;;14,0;2,0;17,0;;1,0;6,0;;3,0;;;2,0;;;24,0;25,0;;;;;;;;4,0;;4,0;;;;13,0;;;12,0;1,0;;1,0;37,0;;4,0;3,0;5,0;;1,0;;;;;3,0;;;;;;3,0;;13,0;;13,0;;6,0;4,0;;13,0;10,0;;14,0;1,0;;4,0;;;;9,0;7,0;24,0;;14,0;;;;11,0;2,0;5,0;;3,0;;1,0;;5,0;22,0;;3,0;;4,0;3,0;;5,0;1,0;;2,0;11,0;3,0;;;;1,0;;;;;10,0;3,0;;7,0;;;;;;9,0;;;;;2,0;;;;;;3,0;18,0;2,0;1,0;;;;;;;;;;;;;;;;;;;;;;;1,0;;;9,0;3,0;2,0;;;;;5,0;;;;;;;;;;;1,0;;;;;;1,0;;2,0;;7,0;;;14,0;2,0;;4,0;;;;;;;3,0;3,0;;7,0;;9,0;;;;;;;;2,0;3,0;;;;;;2,0;2,0;;;;;;;1,0;8,0;;;;16,0;;;;;;11,0;;;;;;;;59,0;12,0;1,0;;;;1,0;;;;2,0;;10,0;;;;;13,0;;;;8,0;1,0;11,0;;22,0;;21,0;;;;;;;;;;;;;;;;;;;;2,0;;1,0;;;;;;;;;;;;;;;;;;44,0;;;;12,0;;;;;;13,0;;;108,0;;;;;;;;;;;;;;;14,0;;;;1,0;;23,0;;;;;;;;;;;;;;3,0;;;18,0;4,0;4,0;19,0;3,0;;;;;;;;;25,0;4,0;3,0;;;;;;3,0;;;;;8,0;;11,0;2,0;1,0;;6,0;;4,0;;;;;;1,0;;;;;1,0;;1,0;;;;;1,0;;;;;;;4,0;;;;;;;;;;;;;3,0;;;12,0;37,0;;;;;;;;;;;6,0;;;;;2,0;;;;;29,0;;;;;;;;;;;;;;;;;3,0;;;7,0;;;;;;;;1,0;;1,0;17,0;;;1,0;;;;;;;;;;;;;;;;5,0;1,0;;;;;;;;;4,0;;;;;6,0;;1,0;;;;;;;;2,0;;;;;;;;;;;;;;;;;;;;;;;;;;;;;;;;;;;;;;;;;;;;1,0;;;;2,0;;;;;;;;;;;;;3,0;;;;1,0;;;9,0;;;;;;;;;;;;;;;;2,0;;;;;;;;;;;;;;;;;1,0;;;;3,0;;1,0;;;;;;;;;;;;;;11,0;;;;;;;;;;;;;;;;;;;;;;;;;;8,0;;;;;;;;;;5,0;;1,0;;;;;;;;;;;;1,0;;;;2,0;;;7,0;;;;;;3,0;;;;;;;;;;;;;;;;1,0;;;;;;;;1,0;;;;;;5,0;;;;4,0;;;;;;;;;;;;;;;;;;;;;;;;;;;1,0;;;;;;;;;;;;;;;;;;;;;;;;;;;;;2,0;;;;9,0;;;2,0;;;;;;;2,0;;;;;;;;9,0;;;2,0;;;;;;;;5,0;;;;;;;;;;;;;1,0;;;;2,0;;;;;;;;;;;;;;;5,0;5,0;;;;;;;;;;3,0;;;;;;;;;;;;;;1,0;;;;;;;;;;;;;;;;;;;;;3,0;;;;;;;13,0;;;;;;;4,0;;2,0;;;;;;;;;;;;;;;;;;
protocol;;;;;;;;3,0;;2,0;;;2,0;;;11,0;;;;;;;6,0;;;;;1,0;;;6,0;;17,0;;24,0;2,0;;6,0;;;101,0;;;;1,0;1,0;;50,0;34,0;2,0;;;;;;2,0;;4,0;;3,0;;;;14,0;;;;8,0;;;2,0;;5,0;;;;1,0;;;17,0;;4,0;7,0;16,0;1,0;9,0;;8,0;;;1,0;;;;;;;;36,0;;;1,0;4,0;;;14,0;;;;;;12,0;;;;1,0;1,0;;6,0;9,0;;;3,0;4,0;4,0;;;;;;;2,0;1,0;;;;;1,0;;;4,0;1,0;4,0;;6,0;;;;22,0;;;10,0;10,0;;;2,0;29,0;;;86,0;1,0;12,0;45,0;;;;9,0;1,0;;;1,0;;;;;;1,0;;;;;;;;;3,0;;;;;1,0;;;2,0;;;6,0;;;;;;;;;;;;1,0;;;;;;;;;;;;1,0;;;;;;3,0;;;;;;;1,0;;;;;;;;;;;;;;;;2,0;;;1,0;;;;15,0;;;;;;;4,0;;;;;;;;;;;;;;;;;15,0;;;;;11,0;;;;;2,0;;;;;;;;;;;;;;;;;;;;;;;;2,0;;;15,0;;7,0;;;;;;;;;;;;;;;;3,0;;;;;;;;;;;;;;;;;;;;;7,0;4,0;2,0;;;;;;;;;;;;;;;;;;3,0;;;;;;;;;;;;;3,0;;;;;;13,0;;;;;;;2,0;10,0;;;;;;;2,0;;;;;;;;;;;;;;;4,0;;;;;;;;;1,0;;;;5,0;;;;;1,0;14,0;4,0;;;;;;;;;102,0;;4,0;;;;;;;;;;;;;;;;;;8,0;;;;;;;;;;;;;;;;;;;6,0;;;;;12,0;;3,0;;1,0;;10,0;;;;;;;;;6,0;12,0;;;;;;;1,0;5,0;;;;;;;;;;17,0;25,0;;;10,0;;2,0;;3,0;;;;;;;2,0;;;6,0;;;;21,0;;;;;;1,0;;;;;3,0;16,0;146,0;30,0;;3,0;;;;;1,0;;;;;;;;;1,0;;;;;7,0;;;;;;1,0;41,0;;;2,0;;5,0;;4,0;;;;;3,0;;;;;;2,0;;;;;;;2,0;;2,0;1,0;;;;;;;;;;2,0;;1,0;3,0;;;;;;;2,0;;;;;;;52,0;;;;;;1,0;;;;;;;;;;;;;;;;;1,0;;;;;;;;;;;;;;;;;;;;;4,0;;;1,0;;;;;;;;;;;;;;;;;;;;;;;;;;;;;;;1,0;;;;;;;;;;;;;;;;;;;;;;;;;;;;1,0;3,0;;;;;1,0;;;;;;1,0;;;;;;;;;;;;;;;;;;;;;;;;;;;;;;;;;;;;;;;;;;;;;;;;;;;;;;;;;;;;;;;;;;;;;;;;;;;;;;;;;;;;;;;;;;;;;;;;;;;;;;;;;;;;;;;;;;5,0;;;;;;;;;;;;;;;;;;;;;;;;;;;;;;;;;;;;;;;;;;;;;;;;;12,0;;;;;;;;;;;;;;;;;;;;;;;;;34,0;;;;;;;;;;;;;;;;;;;;;;;;;;;;;;8,0;;;;;;;;;;;;
readout;;;;;;;;5,0;31,0;6,0;41,0;;;;;;;;;;1,0;4,0;1,0;28,0;;;17,0;3,0;;;;3,0;51,0;;37,0;6,0;;3,0;;;43,0;;3,0;;1,0;3,0;10,0;46,0;7,0;2,0;12,0;6,0;;13,0;4,0;;;;;;2,0;;4,0;;7,0;;;27,0;;;4,0;;6,0;;;10,0;;;;97,0;;66,0;;83,0;;;;;;;3,0;;12,0;;;;1,0;;5,0;;;;3,0;1,0;;2,0;11,0;7,0;32,0;;;53,0;;;6,0;37,0;23,0;2,0;;2,0;;;13,0;19,0;2,0;;;1,0;;1,0;;14,0;;1,0;1,0;1,0;5,0;;10,0;;2,0;;4,0;40,0;6,0;;;5,0;342,0;;;1,0;22,0;;2,0;3,0;23,0;;;27,0;;;92,0;1,0;;;;;;;;;;;6,0;7,0;;;;;;;;;67,0;199,0;;3,0;;;;;;4,0;;1,0;;;;2,0;;1,0;1,0;3,0;;;41,0;;4,0;;;;;16,0;;;;;;;;3,0;;;;;14,0;;4,0;;;4,0;;;;;;;;;1,0;;;2,0;;13,0;8,0;;325,0;;;;;;;1,0;6,0;;;;;;;28,0;3,0;;3,0;;17,0;1,0;;4,0;1,0;;;;6,0;2,0;19,0;10,0;2,0;;;;2,0;19,0;;;;;;9,0;;;;;;;1,0;;;10,0;;;;;7,0;;;;;;5,0;;;2,0;;;;26,0;;;;;9,0;;;;;;;;;;;2,0;1,0;;3,0;;;;;29,0;;;;;8,0;;2,0;;;1,0;;;;;;1,0;;;;;;;4,0;;;;3,0;;;;;;;;;;;;;;;3,0;;;2,0;;;;;;;;;;;;;;1,0;2,0;;;;;;;4,0;;5,0;;;;;1,0;;;;;4,0;1,0;;;;;;;;7,0;1,0;1,0;;;;6,0;55,0;;;;1,0;;;14,0;61,0;;2,0;13,0;;1,0;;6,0;4,0;1,0;3,0;;;;3,0;;;;;;;;;;;;;;;;;;21,0;;;1,0;;;;;;;;1,0;10,0;;;4,0;17,0;;;;;;;;;;;1,0;;;100,0;;17,0;;;;;;;;;;;;;;;;;;;51,0;;1,0;13,0;1,0;;;1,0;;;;;;;;;1,0;;;;11,0;;;;;1,0;1,0;;;;;;;4,0;1,0;;;;1,0;;;4,0;;;;;2,0;;;;;;;;;;4,0;;;;;;;;;;;;;;2,0;;;;;;;;;;;;;;;;;;;;;;;;;;;28,0;6,0;;;5,0;;;;;;21,0;;;;;;;7,0;;5,0;;;;;3,0;;;;;;;;;;3,0;2,0;;;37,0;;;;;;;;;;;;;;;;;;;;;8,0;6,0;;2,0;;;;;;;;;12,0;1,0;;;;1,0;;;;;1,0;;;;;;;;;;;;;5,0;3,0;;;;;2,0;7,0;;;;;;;;;;1,0;;;;;;1,0;1,0;;;;;;;;;2,0;;;;;2,0;;18,0;3,0;;11,0;;;;16,0;;;5,0;;;;12,0;;;;19,0;;6,0;;;4,0;;;3,0;;1,0;;1,0;;26,0;4,0;;;;;;;;;;;;;;;5,0;;;2,0;;;;;;;;;;4,0;;;;2,0;;;;;;;;;1,0;;;;;;;;;;;;;;;2,0;;;;;;;;;;;;;;;;;;;;;;;;;;;;;;;;;;;;;;;;;;;;;;;;;;;;;;;;;;3,0;;;;;;;;;1,0;;;;;;;;;2,0;;16,0;;;;;;;;;;;;;;;;;;;;;8,0;;;;;;;;;;;;;;;;;;;;;;;;;;;;;;;;;;;;;;;;;;;;;;;;;;;
recorder;;;;;;;;15,0;;3,0;;;6,0;;;2,0;;;;;;25,0;;;;;;;;;;1,0;17,0;3,0;11,0;2,0;;;2,0;;11,0;;;;1,0;;;30,0;34,0;12,0;;;;;;;;;;;5,0;16,0;;;;;;;4,0;11,0;2,0;;;;;;;;;66,0;1,0;1,0;;11,0;;2,0;1,0;;;;7,0;;;;;6,0;18,0;;5,0;;;;;7,0;;;;;3,0;;;1,0;;;;;6,0;3,0;13,0;;;;1,0;;1,0;;;;;;;;;;;1,0;;4,0;;1,0;1,0;1,0;;2,0;;;;;4,0;;;;7,0;4,0;;;8,0;;;2,0;;;7,0;;;12,0;220,0;1,0;;;;;;;;;;;;;;11,0;;;;;;1,0;;;4,0;;;51,0;;;;;;12,0;;;2,0;1,0;;;;;1,0;1,0;;;;;;;;;;;48,0;;;;;;;;;;;;;17,0;;;;;;;;;;;;;;;;;1,0;;;;;;5,0;;;;;;;;;;;;;;;1,0;;;;;;;3,0;1,0;;;;;;10,0;;;;;2,0;;;;;;;;;;;;2,0;;;;;;;;;;;;;;23,0;;;;;;;;;;1,0;;;;;;;;;;;;;12,0;2,0;;;;;;;1,0;;;;;4,0;1,0;;;;;;;;;;;;;;12,0;;;;;;;;;;;;;;;;;;;;;;;;;;2,0;7,0;;;;;;;;1,0;;;;;;;;;;;;;;;;;;;1,0;1,0;;;;;;;;;3,0;;;5,0;;;;8,0;;2,0;;3,0;;3,0;1,0;15,0;;;3,0;;;1,0;;4,0;71,0;;;;;;;2,0;;;;;;;;;;1,0;;;;;;;;2,0;;;;;;;;;;;;8,0;2,0;;5,0;;;;;;7,0;;;4,0;;;;;;;1,0;;;2,0;;;;;;;;;2,0;;;2,0;;;;;;;;;;;;;;;;;;;;1,0;;;;1,0;;;3,0;;;;26,0;;9,0;;;;;;;;;;;;;;;1,0;;5,0;;;;;6,0;;;;;;;2,0;;;;;;;;;;;;36,0;;4,0;;;;;;;;;3,0;;;20,0;;;;;;;;;1,0;;;;;19,0;;;;;;;;;;;;;;1,0;;;;;;;;;;;;;;;;;;;;;;;;2,0;;;;;;;;;;;;;;;;;;;1,0;;;;4,0;;;;;;;;;6,0;12,0;;;1,0;;;;;;;;;;;;;;;;;;;;1,0;;;;;;;;;;;;;;;;;;;;;;;;;;;;;1,0;;;;;;;3,0;;;;;;;;;;;;;;;;;;;;;;;1,0;;;;;1,0;;;;;;;;;;;;;;;;;;;;;;;;;;;;;;;;;;;;;;;;1,0;;;;;;;;;;;;;3,0;;;;;;;;;;;;;;;;;;;;;;;;4,0;;;;;;;;;;;;;;;;;;;;;;;;;;;;;;;;;;;;1,0;;;;;;;;;;;;;;;;;;;;;;;2,0;;;1,0;;;;;;;;;;;;;;;;;;;;;;;;;;;;;;;;;;;;;;;;;;;;;;;;;;;;;;;;;;;;;;;;;;;;;;;;;;
resilient;;;;;;;;3,0;;9,0;;;;;12,0;2,0;;;;;;;;;;;;;4,0;;;;22,0;;2,0;1,0;;;;;;;;;3,0;3,0;;3,0;;;9,0;;;;2,0;;4,0;;;;6,0;5,0;1,0;;;;;11,0;7,0;;;;;;;;;;;6,0;;;;16,0;;;;;;;10,0;;;3,0;;;;;1,0;3,0;;;20,0;;;;5,0;;;;;;;;;7,0;31,0;30,0;;;;;;;;;;;;;;;;;;;;;;;;;;;;;;17,0;;;;;;;;;4,0;;;;;;2,0;;;;;;;;;9,0;3,0;2,0;;5,0;23,0;19,0;;;;;;;;1,0;;14,0;1,0;;4,0;;;21,0;;;;;;5,0;2,0;;;9,0;;3,0;;;;7,0;;1,0;30,0;;;;2,0;;;13,0;8,0;;;;;3,0;;1,0;;;137,0;;;4,0;6,0;4,0;;;3,0;;;;1,0;;;;;;;;56,0;;;5,0;;;11,0;;;;;;1,0;;;;1,0;;;;;;2,0;;;24,0;;2,0;;6,0;;;4,0;;;;;;;;3,0;;;;;;;3,0;12,0;;4,0;;5,0;;;;18,0;;2,0;;;1,0;;;1,0;;;3,0;;13,0;3,0;;1,0;4,0;2,0;;1,0;;;;;1,0;;;;;;2,0;11,0;8,0;;;2,0;;;;;4,0;9,0;;;5,0;;;16,0;;;;;;;3,0;2,0;1,0;9,0;;;;;;;;;;;;6,0;;1,0;1,0;1,0;1,0;;1,0;;;;;;12,0;;1,0;;;3,0;;;;;;;;;;;;;;;;;;;;;;;;;;;;1,0;;;;;;;;;;;;;;;;;;;;;;;;;;;;;;;;;;;;;;;;;;;5,0;;;;;;;;;;;;;;;2,0;;;;;;;;;;;;;;;;;;;;;;;;;;;;;;;;;;;;;;;;;;;;;;;;;;;;;3,0;;;;;;;;;;;;1,0;;;;;;;;;;;;;5,0;;;;;;;;;;;;;;;;;;;;;;;;;;;;;;2,0;;;;;3,0;;;;;;1,0;;;;;;;1,0;1,0;;;;;8,0;1,0;;;;;;;;;5,0;;;;;;;;;;;;;;;1,0;;;;;;;;;;3,0;;;1,0;;;;;;;;;1,0;1,0;;;;;;;;;2,0;;1,0;;;;;;;3,0;1,0;;;;;;;;;;;;;;;;;;;2,0;;3,0;;;;;;;;2,0;2,0;;;;8,0;;;;;;;;;;;;1,0;;;9,0;;;;;;;;;;;1,0;;;;;2,0;;;;;;;;;4,0;;;;;;;;;;;;;;;;;;7,0;;;;;;;;;;;;;;1,0;;;;2,0;;;;;;;;;;;;1,0;;;;;;3,0;;;;;;;;;;;;;;;;;;;;;;;;;;;;;;;;;;;;;;;;;;;;;;;;;;;;;;;;;;;;;;;;;;;;;;2,0;;;36,0;;;;;;;;;;;;;;;;;;;;;;;;;;;;;;;;;;;;;;;;;;10,0;;;;;;;;;;;;;;;;;;;;;;;46,0;;;;1,0;;;;;;;;;;;;;;;;;;;;;;;;;;;;;;;;;;;;;;;;;;;;;;;;;;
resin;;;;;;;;5,0;1,0;1,0;1,0;3,0;;;1,0;35,0;;;;1,0;;1,0;;;10,0;;8,0;;;;;;;;;;;;;;;;;;;;;19,0;2,0;;13,0;1,0;;;;;29,0;;;;;1,0;;;18,0;;;109,0;5,0;;;;;;;5,0;;;;16,0;;8,0;;25,0;;;;;;;42,0;;;35,0;;;;;20,0;;;2,0;56,0;;;;14,0;;;;;10,0;2,0;2,0;;2,0;20,0;2,0;;2,0;3,0;;17,0;;;;;;;;;;;;;;2,0;;;;;;;5,0;;;;33,0;;;;;;;;;;;;;;;10,0;;;;;;;;1,0;2,0;8,0;;;10,0;;;;;6,0;20,0;11,0;;;5,0;2,0;7,0;6,0;5,0;;;;2,0;2,0;10,0;1,0;;23,0;8,0;;;;;;3,0;;;12,0;2,0;34,0;;;1,0;4,0;;16,0;6,0;2,0;4,0;;;;;;2,0;129,0;;67,0;11,0;24,0;6,0;;1,0;1,0;;1,0;3,0;7,0;;;;;;;;;;;;12,0;;;;4,0;;;;;;;;1,0;2,0;2,0;;;56,0;;;4,0;;4,0;;;2,0;;2,0;33,0;54,0;;;2,0;;;;;;;2,0;;;8,0;;4,0;;6,0;;6,0;;8,0;1,0;1,0;;4,0;;;;;;;8,0;;;;1,0;;;;;;;;2,0;3,0;;;3,0;;4,0;;;;;;;;;;1,0;;;7,0;7,0;;;;;;1,0;;;;10,0;;;;;;;;1,0;;27,0;1,0;;;2,0;1,0;;;;;;;;;;;;;;;2,0;1,0;;;;;7,0;;;;;;;;3,0;1,0;;;;;;;;;;;;;;;;;1,0;;;;;;;;;;;;;;;;;;;;;;;;;;;;;;;;;;;;;;;1,0;;;;;;;;;;;;;;;;;;;;;;;;;;;;;;;;;;;1,0;;;;;;;;;;;;;;;;;;;;;;;;;;;;;;;;;;;;;;;;;;;7,0;;;;;;;;;;;;;4,0;2,0;;;;;;2,0;;;;;;;;;;;1,0;;;;;;;;;;;;;;;;;;;;;;;;;;;;;;6,0;;;;;;;6,0;;;;;;;;;;;;1,0;;3,0;;;1,0;;;;;2,0;;;;1,0;;;;;;;;;;;;;;;;;;;;;;;;;;;;;4,0;;;;;;;;5,0;4,0;1,0;35,0;;;;;;;;;;;;;;;;;2,0;;;;;;37,0;;;;;;;;;1,0;;;;;;;;;;;;;;;21,0;;;;;;;;;;;;;4,0;;1,0;1,0;;;;;;;;;;;;;;;;36,0;;;13,0;;;;;5,0;5,0;;;;;;;;;;;1,0;;;4,0;;;1,0;;;;;;;1,0;;;;;;;;;;;;;;;;;;;;1,0;1,0;;;;;45,0;;;;;;;;;;;;;;;;;;;;;;;;;;;;;;;;;;;;;;;2,0;;;;;;;;;;;;;;;;;;;;;;;;;;;;;;;;;;;;;;;;;;;;;;;;;;;;24,0;;;;;;;;;;;;;;;;;;7,0;;;;;;;;;;;3,0;;;;;;;;;;;;;;;;;;;;;;;;;;;;;;;;;;;;;;;;;;;;32,0;;;;;;;;;;;;;;;;;;;;;;;;;;;;;;;
road;;;;;;;;1,0;9,0;1,0;;;4,0;;;16,0;;;;;15,0;1,0;2,0;;;3,0;2,0;1,0;;;;17,0;2,0;;3,0;3,0;6,0;;;;;;13,0;;20,0;7,0;5,0;7,0;;20,0;;5,0;;;;2,0;1,0;;;;4,0;;;;3,0;;3,0;2,0;9,0;4,0;;;6,0;1,0;;1,0;2,0;;2,0;44,0;;9,0;2,0;12,0;;;;;5,0;;3,0;;;;;;2,0;;21,0;;1,0;;5,0;2,0;;1,0;;;;;;1,0;;;;11,0;8,0;3,0;;;4,0;;;;5,0;;;;;;;;3,0;;;;;;;;;;;;2,0;;;2,0;;;;;;11,0;;;15,0;;;;;1,0;1,0;;;;2,0;6,0;;;;;;;;;;;9,0;;;4,0;;;;;;1,0;;;;;;;;;;;;2,0;1,0;;;7,0;;;;;;;;1,0;;;;;;;8,0;;4,0;;;;;;;;;;;;;3,0;4,0;;;1,0;;;;;;1,0;;;;;;30,0;;;2,0;;;;3,0;1,0;1,0;;;;;5,0;;;1,0;;;;;;7,0;;;;;;;70,0;2,0;;;;;;;;;;46,0;3,0;;;;1,0;;;;;;;;;;;;;;;;;;;;;;;;;;;;;1,0;;;;;;;;;;;;2,0;2,0;;;;;;1,0;;;;;7,0;4,0;;2,0;;;;;3,0;7,0;;;5,0;4,0;;;;;;3,0;;2,0;2,0;;;2,0;;;;;;;;;;;;;;;;;;;3,0;2,0;;;1,0;;1,0;;;;;;;;;;;5,0;;;;;;;3,0;;1,0;;;;;;;;;1,0;;1,0;;11,0;;1,0;2,0;;;1,0;22,0;;1,0;1,0;;1,0;;2,0;1,0;;;;;;;;;1,0;;;;;;;;23,0;;;;4,0;;2,0;;2,0;;;;;;;;;;4,0;;;2,0;;;;;;;1,0;2,0;;;1,0;5,0;;;1,0;;;;;4,0;;9,0;;;;;1,0;;;;;;;;;;;;;;;;;;1,0;;4,0;;;;;;;;;;;;;;4,0;;;;;;;;;;1,0;1,0;;;;;;;;;;;;;;;;;;;9,0;;;;;;;;2,0;;;;;;;;;;;;;;;;;2,0;;;;;;;;;;;1,0;;;;;;;;;;;;1,0;;;9,0;;;;;;;;;;;;;;;;;;;;;;3,0;;;;;;2,0;;;2,0;;;;;;1,0;;;;;;;19,0;;;;;;;;;;;;;;;;;;;;;8,0;;;;;1,0;;;;;;;;;;;1,0;;;;;;;;;;;;;;;;;;;;;;1,0;;;;;;;;;;;2,0;;;;;;;;;;;;;;;;;;1,0;;;;;;;;;;;;;;;;;;;;;;;;;;;;10,0;;;;;;;;;;;;;;;;;;;;;3,0;;;;;;;;;;;;;;;;;;;;;;;;;;;;;;;;;;;3,0;;;;;;;;;;;;;;;;1,0;;;;;;;;;;;;;;;;;;;;;;;;;;;;;2,0;;;;;;;;;;;;;;;;;;;;;;;;;;;;;;;;;;;;;;;;;;;;;;;;;;;;;;;;;6,0;;;;;1,0;;;;;;;;;;;;;;;;;;;;;;;;;;;;;;;;;;2,0;;;;;;14,0;;;;;6,0;5,0;;;;5,0
roller;;;;;;;;1,0;2,0;3,0;;;2,0;;16,0;4,0;;;;;;;;;;;;;;;;;1,0;;;;;;;;;;;;;;;4,0;;1,0;8,0;;;;2,0;;5,0;;;;1,0;;;;;;;3,0;2,0;14,0;;;;;;;;;;2,0;;1,0;;16,0;;;;;;;11,0;;;;;;;;1,0;;;;10,0;;;;8,0;;;;;;;;;11,0;2,0;11,0;;;;;;;;;;;;;;;1,0;;;;7,0;;;;;;;;;;;51,0;;;;;;;;2,0;5,0;;;;;;2,0;;;;;;;;;;;2,0;;;10,0;15,0;;;;9,0;;6,0;;;;;;;;;;14,0;;18,0;;;;;6,0;;;1,0;;6,0;;;;;;;;1,0;;;1,0;;;;;;7,0;;;;;;;;11,0;;1,0;7,0;15,0;2,0;;;;6,0;;;;;;;;;;;3,0;;1,0;2,0;;;21,0;;;;;;;;;;;;;;;;1,0;;;;;1,0;;8,0;;;;;;;;;;1,0;;;;;;;;;;;;5,0;12,0;2,0;;23,0;;;;;;1,0;;;;;;;;;;;;;6,0;;10,0;1,0;;;;2,0;;;;;;3,0;;;;;;;;2,0;;14,0;1,0;;;3,0;;;;2,0;;;;;;;;;2,0;;;15,0;6,0;;;;;;;;54,0;9,0;6,0;2,0;10,0;;;2,0;6,0;;;;;41,0;6,0;;;;;;5,0;;;;;;2,0;2,0;;;;;;;1,0;;;;;;;;;;;;;;;;;;;;;;;;;;;;;;;;;;;;;;;;;;;;;;;;;;1,0;;;;1,0;;;;;17,0;;;;;;;;;;;6,0;2,0;;4,0;;;;;;;;;;;;;;;;;3,0;;;;;;;;;;;;;;;;;;;;;;;;;;;;;;;;1,0;9,0;;;;;;;;;;;;;;;;;;2,0;;;;;;;4,0;;;;;;;;;;;;;;1,0;;;;;1,0;;;;;;;;;;;;;;;;5,0;;;;;42,0;;;;13,0;;;;2,0;;;;;;;;;;;;;;;;;;;;;;;;;;;;;;;8,0;;;;;;;;;;31,0;;2,0;13,0;;;;1,0;;;;2,0;;;;;;;3,0;;;;;;;;;;2,0;;2,0;;;;;2,0;;;;;;;;;;;;;;;;10,0;2,0;;;;;8,0;1,0;;;;;;;;32,0;;;;;;;;;;;;2,0;;;;;;;;1,0;;;;;;;;;;;;;;;;;;;;;;;;;;;;;;;;;;;;;;;;;;;;;;;;;;;;;;;;;;;;;;;;;;;;;;;;;;3,0;;;;;;;;;;;;;;;;;;;;;;;;;;;;;;;;;;;;;;;;;;;;;;;;;;;;;7,0;;;;;;;;;;;;;;;;;;;;;;;;;;;;;;;;;;;;;;;;;;;;;;;;;4,0;;;;;;;;;;;;8,0;;;;;3,0;;;;;;;;;;;;;;;;1,0;;;;;;;1,0;;;;;;;;;;;;;;;;;;;;;;;;;;;;;;;;;;;;;;;;;;;1,0;;;;;;;
scanner;;;;;;;;8,0;1,0;2,0;;;1,0;;11,0;1,0;4,0;;;;1,0;4,0;;;;;1,0;;;;2,0;;5,0;;;;;;;;4,0;;12,0;;;;;15,0;16,0;;;3,0;;;1,0;;4,0;;1,0;;;;1,0;;;1,0;1,0;1,0;1,0;;;;2,0;;;2,0;3,0;;6,0;8,0;;2,0;;8,0;;;;;;;1,0;;;;8,0;;;;7,0;;2,0;;;;;2,0;4,0;;3,0;;;;;;;4,0;;6,0;1,0;;;;1,0;;4,0;3,0;;;;6,0;;2,0;;;;;;;;;;;;1,0;;;;;3,0;;;2,0;;1,0;;;22,0;;;;1,0;;3,0;;;;2,0;;;;;;;3,0;;;2,0;;;;;;;;;;;7,0;;;;;;;;;;;;;;;;2,0;;;;1,0;;;;;;;;;;;;;;;1,0;;;;;;1,0;;;;;1,0;;;;;;;;;;;2,0;;;;;;;;;1,0;;;4,0;;;;;;1,0;2,0;;;;2,0;;;;10,0;6,0;;;;;4,0;;11,0;;;;;;1,0;;;;;;;;;;;;;;;1,0;;;;;;;;;;;;;;;;;;;;;;;;;;;;;;;;;;;5,0;;;;;;;;;;;;;;;;;;;;;;10,0;9,0;;2,0;;;;;;;;;;7,0;;;;;;;;;;;;;;;;;;;;;;;;;;;;5,0;;;;;;1,0;;;;;;;2,0;1,0;;;;;;;;;;;;;;;2,0;;;;4,0;;5,0;;;;9,0;;;2,0;2,0;;;;;;;2,0;1,0;;;;;;1,0;;;;;5,0;;1,0;;;;;;;;;;4,0;;;;;;;;;5,0;;;16,0;;;;;1,0;;;;;;;;;3,0;;1,0;;;;;;;;2,0;;;1,0;;;;;;;;;;;;;;;;;;;;;;;;;;;;;;1,0;;;1,0;;;;;;;;;;;;;;;;21,0;;;;;;;;;;;;;;;;;;;;;;;;;;;;;;;;;;;;;7,0;;;;1,0;;;;;;;;;;;;;;;;;;1,0;;2,0;;1,0;;;;;5,0;;;;;;;;;;;;;;;;;;;;;;;;;1,0;;;;;;;;;;;;;;14,0;;;;;;;;;;1,0;;;;;;;;;;;;;;;;;;;;;;;;;;;;;;;;;;;;;;;;;;;;;;;;2,0;;;;1,0;;4,0;;;;;;;;;;;;;;;;1,0;;;;3,0;;;;;;;;;;;;;;1,0;;;;;;;;2,0;;;;;;;;;;;;;16,0;;;2,0;;;;1,0;;;;;;;;;;;;;;;;2,0;;;;;;;;;;;;;;;;;;;;;;;;;;;;;;;;;;;;;;;;;;;;;;;;;;;;;;;;;;;;;;;;;;;;;;;;;;;;;;7,0;;;;;;;;;;;;;;;;;5,0;;;;;;;;;1,0;46,0;;2,0;;;4,0;;;;;;;;;;;;;;;;;1,0;;;;;;;;;;;;;;;;;;;;;;;;;;;;;;;;;;;;;;;;;;;;;;;;;;;;;6,0;;;;;;;;;;
selector;;;;;;;;6,0;4,0;;;;2,0;;;7,0;;5,0;;;;6,0;;;;;;;;;;2,0;31,0;;12,0;1,0;;6,0;;;21,0;;;;11,0;3,0;2,0;7,0;2,0;16,0;;;;;;;17,0;;;;;;;3,0;;;21,0;;8,0;;;;4,0;;;;8,0;;;78,0;4,0;22,0;;27,0;;;2,0;;;;9,0;;;;;6,0;3,0;;9,0;;;;;6,0;;3,0;4,0;;25,0;;;1,0;;;;19,0;1,0;8,0;;;;;2,0;20,0;4,0;;;;;;;1,0;;;;;;;;;1,0;;;11,0;5,0;;;2,0;18,0;2,0;;;;3,0;14,0;;13,0;;;;1,0;;13,0;;;;6,0;;;;1,0;;;;8,0;;;;;;;9,0;;;;4,0;;;;;;2,0;;4,0;;;;;;;;;;;;;;;;;;;;;;;;;;;;;;;1,0;;;;3,0;;;;;;;;1,0;;;;;;;;4,0;;;;;;;;;;;;5,0;2,0;;;;;;154,0;;1,0;;;;;;6,0;;;;;;;;;10,0;;2,0;;;16,0;;;;;;;;;;;;;;;1,0;2,0;;;;;;;;;;;;;;;;;;;;;;;;;;;1,0;;;;;;;4,0;;;5,0;;;;;;;;;;;;;;1,0;;;;;10,0;;;;;;;;;;;;;;;;7,0;3,0;;;;4,0;;;;;;;;;;;;;;;;;2,0;4,0;;;;;;;;;;;;3,0;;8,0;;3,0;;;;;;;1,0;;1,0;15,0;;3,0;;2,0;1,0;;;;2,0;9,0;;1,0;;3,0;2,0;81,0;;;8,0;3,0;;;3,0;22,0;;;2,0;;;;;;8,0;;5,0;;;;;;4,0;;;;1,0;;;;;;;9,0;;5,0;;;;5,0;;;4,0;;;;;;;;;1,0;;;;;;3,0;;;;;;;;;;;;;;;;3,0;;;;;;2,0;;;1,0;;;;;;;1,0;8,0;;;;;;;;;;;;;;;2,0;4,0;;33,0;;;;;;2,0;;;;5,0;;1,0;;1,0;;2,0;;3,0;;1,0;1,0;;2,0;;;;2,0;;;;;;;;;;;;;;;8,0;;;;;;;;;;;;;;;;;;;;;;;;;;;;;;;;;;3,0;;;;;;;;;;;;;;;;;;;;;;;;;;;;;;;;;;;;7,0;;;4,0;;;;;;;;;;;;;;;;;;;;;;;;4,0;;;;;;;;;1,0;7,0;;;;;;;;;6,0;;;;;;;;;;;;;;;;;3,0;;;;;;;;;2,0;;;;;;;;;;;;;;;;;;;;;;;;;;;;;;;;1,0;1,0;;;;;;;;;;;;;;;;;;;;;;;;;3,0;;6,0;;;;;;1,0;1,0;;;;;;;;10,0;1,0;;;;1,0;;;;;;;;;;5,0;;;;;;;;;;;;;;;;;;;;;;;;;;2,0;;;;;1,0;;;;;;;;;;;;6,0;;;;;;;;;;;;;;;;;;;;;;;;;;1,0;;;;;;;3,0;;;;;11,0;;;;;;;;;;;;;;;;;;;;;;;;;;;;;;;;;;;;;;;;;;;;1,0;;;;;;;;;;;;;;;;3,0;;;;;;;;;;;;;;;;;9,0;;1,0;;;;;;;;;;;;;;;;
silicon;;;;;;;;5,0;21,0;;;;2,0;;;;;;;;;;;;;;;;;;;;;;;;;;2,0;;;;;;;;;22,0;2,0;2,0;1,0;;;;;;2,0;;;;3,0;;;;;;;73,0;1,0;4,0;;;2,0;2,0;;5,0;;;;19,0;1,0;11,0;1,0;15,0;;;;;;;6,0;;;16,0;;;;;36,0;;;;6,0;;;;3,0;;;;;2,0;;;;;10,0;2,0;;1,0;4,0;;;1,0;;;;;;;;;;;;;;;;1,0;;;;18,0;;;;3,0;;4,0;;1,0;;;;2,0;1,0;;;;;;1,0;;;;;;;1,0;;1,0;4,0;;2,0;;1,0;2,0;;;;;5,0;;;;;;3,0;;;;;;;1,0;;;5,0;9,0;;;;;;;;;;;152,0;;;2,0;;;;;;2,0;;;;;;;49,0;1,0;6,0;4,0;5,0;1,0;;;2,0;;;4,0;;;;;8,0;;;;2,0;;;;2,0;;;;;;;;2,0;20,0;;;;3,0;9,0;;1,0;;8,0;;;;2,0;4,0;;;;3,0;56,0;19,0;;;;17,0;2,0;1,0;;;;4,0;;;;6,0;;;1,0;;;;14,0;;;;;;;1,0;;6,0;;;6,0;;;;;;;1,0;;;;;;;;;;;;;;;;;;;;;;;;;;;;;;;;;;4,0;;;;;;;;;6,0;;;;;5,0;;;2,0;;;;;;3,0;;;;;;;;;;;;;3,0;2,0;;;;1,0;;;7,0;1,0;;;;;;;;;;1,0;;;;;;;;;;;;;2,0;;;;;;;;;;;;;;;;;;;;;;;;;;;;;;;;;;;;;;;;;;;;;;;;;;;;;;;;;4,0;;;;;;;;;;;;;;;;;;;;;;;;;;;;;;;;;;;;;;;;;;;;;;;;;;;1,0;;;;;;;;;;;;;;;;;;;;;;;;;;;;;;;;;;;;;;;;;;;;;;;;;;;;;;;;;;;1,0;;;;;;;;;;;;2,0;;;;;;;;;;;;;;;;;;;;1,0;;;;;;6,0;;;;;;;;;;;;;;;;;;;;;;;;;;;;;;;;1,0;;;;;4,0;2,0;;4,0;;;;;;;;;;;;;;;;;;;;;;;3,0;;;;;;;;2,0;;;;;;;;;;;;;;;;;;;;;;;;;;;;;;;;;2,0;;;;;;;;;;;16,0;;;;;;;;;;;;3,0;;;;;1,0;2,0;2,0;;;;;;;;;;;5,0;;;;2,0;;;;;;;;;;;;;;;;;4,0;;;;;;;;;1,0;;;;;;;;2,0;;;;;;;;;;;;;;;;;;;;;;;;;;;;;;;;;;;;;;;;;;;;;;;;;;;;;;;;;;;;;;;;;;;;;;;;;;;;;;;;;;;;;;1,0;;;;;;;;;;;;2,0;;;;;;;;;;;;;;;;;;1,0;;;;;;;;;;;;;;;;;;;;;;;;;;;;;;;;;;;;;;;;;;;;;;;;;;;;;;;;;;;;;;;;;;;;;;;;;;
slope;;;;;;;;3,0;;;;;1,0;8,0;1,0;25,0;1,0;9,0;;3,0;;;20,0;1,0;1,0;;2,0;;;;4,0;3,0;15,0;;;;1,0;11,0;;;2,0;2,0;12,0;5,0;4,0;;39,0;6,0;2,0;;1,0;2,0;;;;6,0;1,0;;;;6,0;;1,0;;4,0;;1,0;10,0;;;;;8,0;;;;;;;3,0;;6,0;;4,0;;;;;;;1,0;;;;;;;;8,0;;3,0;;1,0;;;;6,0;1,0;6,0;;4,0;21,0;;;;6,0;38,0;16,0;;1,0;;;;;4,0;;;;;5,0;;41,0;2,0;;3,0;;2,0;;11,0;;;;;;6,0;;;3,0;124,0;;;;;2,0;8,0;9,0;;;;7,0;;;6,0;;2,0;;;1,0;;;;;4,0;2,0;1,0;;2,0;;;;;;;;;2,0;;8,0;;;;;;;;1,0;;;;2,0;;;;16,0;;;;;;5,0;;;;2,0;;;;;;;2,0;;4,0;3,0;;;2,0;;;;;;;;;3,0;3,0;6,0;20,0;3,0;;;;;1,0;;;;3,0;9,0;5,0;;1,0;2,0;;;7,0;;;;;;;1,0;;;19,0;;;;3,0;;;;;;;;8,0;55,0;;;5,0;;;7,0;;;;;3,0;1,0;;;;;;;;3,0;2,0;;;;;;;;6,0;;;13,0;;1,0;;;;1,0;;6,0;;;;;;;3,0;;;;;;;;;;;15,0;;;1,0;1,0;;;;;;1,0;2,0;;;;;;1,0;;;;;;;2,0;;;6,0;;10,0;;1,0;;;;;;;;;;;3,0;;;;;;;3,0;1,0;;14,0;;10,0;;2,0;;1,0;;;;;;;1,0;2,0;;;;;;4,0;12,0;;;;;5,0;;;1,0;;;;;2,0;;2,0;;;;;;14,0;16,0;3,0;4,0;;12,0;;;;1,0;;;;;;;;;1,0;;3,0;;;;;;;3,0;;;;;;;;;;;2,0;;;;;;;;;31,0;;;;;;3,0;;;;;;;;;;;;;;;;;;;;;1,0;;1,0;9,0;;;;;;;;;;;;;;;;;;;;;;;7,0;;;;;;;;;;;;;;3,0;1,0;;;;;;;;;;;;;;;;;5,0;3,0;;;;;1,0;;;;;;;;;;;;;;;;;;;;;;;;;;;;;;;;;;;;1,0;;;;;;;;;;;;;;;2,0;;;;;;2,0;;;;;;;;;;;;;;;;;;;;;;;;3,0;;;;4,0;;;;;;6,0;;;2,0;27,0;;;5,0;;;1,0;;;;;;;;;;;;1,0;;;2,0;;;2,0;;;;;;;;2,0;2,0;;;;;;;1,0;;;;;;;;;3,0;;;;;;;;3,0;;;;;;;;4,0;;;;;;;2,0;;;;;;;4,0;;;;;;;;;;;;;;;;;;5,0;;;;;;;;;;;1,0;5,0;;;;;;1,0;;;;;;;;;;;;;4,0;6,0;;;;;;;;;;;;;;;2,0;;;;;;;;;;;;2,0;;4,0;1,0;;;;;;;;;;;;;;;;;;;;;;;;;;;;;;3,0;;;;;;;;;;;;;;;;;;;;;;8,0;;;;;;;;;;;;;;;;;;;;;;;;;;;;;;;;1,0;;3,0;;;;;;;2,0;;;;;;;6,0;;;;7,0;;;;;;;;;4,0;;;;;;;;;;;;;;;;;;;;;6,0;;;;;;;;;;;;;;;;;2,0;;;;;;;;;;;;;;;;;;;;;;;;;
smart;;;;;;;;6,0;;;5,0;;4,0;;;1,0;;;;;;9,0;4,0;;;;;4,0;;;7,0;2,0;48,0;;11,0;3,0;;;;;3,0;;;;13,0;1,0;5,0;203,0;46,0;22,0;1,0;6,0;;;;2,0;13,0;;;9,0;;;1,0;1,0;;;;;;;12,0;;1,0;;;3,0;4,0;;;44,0;;;3,0;25,0;;6,0;;28,0;;;1,0;;;;;;;2,0;20,0;14,0;1,0;;13,0;79,0;;19,0;2,0;;47,0;1,0;3,0;7,0;;;;7,0;6,0;2,0;2,0;;1,0;;6,0;6,0;8,0;11,0;1,0;;;;;1,0;2,0;;;;1,0;4,0;;2,0;;2,0;2,0;3,0;2,0;;;;1,0;1,0;;;1,0;;;2,0;18,0;;;44,0;2,0;8,0;23,0;;;;3,0;3,0;;;;;;;;;;;;;;;;;;;;;;;;;;10,0;;;29,0;;;2,0;;;;;;;;;;;;3,0;;4,0;13,0;;;;;;4,0;;;;;;;;;;;;;8,0;;;;;;;;;;11,0;;;;;;;;;;;;;30,0;;;;;;3,0;18,0;;;;;;;;1,0;;;;;;;;;4,0;;1,0;;;9,0;;6,0;;3,0;;;1,0;;2,0;;1,0;;;;;8,0;6,0;;;;;;;6,0;;;;;;;;;;4,0;;;;;;;;;;7,0;;;;;;13,0;;;;;;;;;1,0;4,0;;;2,0;;;;;;;;;14,0;;;;;;;;;;;;;;;2,0;;;;;;;;;;;;;;;;;11,0;;1,0;;;;1,0;;;;;;1,0;17,0;;;;;;;1,0;5,0;1,0;4,0;;4,0;;;;;;;;;;;;;;;;;3,0;;;;;;;13,0;;1,0;1,0;;;3,0;24,0;5,0;;;;;;;;;2,0;;;;1,0;;11,0;;;;;;;11,0;28,0;;;2,0;;16,0;;;;;;;;2,0;4,0;1,0;;;;;;;;;6,0;;2,0;8,0;;26,0;;;1,0;262,0;;5,0;14,0;;;;2,0;;15,0;;;2,0;6,0;3,0;;;;;4,0;5,0;;;;2,0;1,0;;;;;;27,0;;;;;;;;;;;;;;10,0;;4,0;3,0;;;;;;;3,0;;;7,0;;;20,0;;6,0;8,0;38,0;8,0;;1,0;;;;;;;;;;;;;;;;4,0;;;;;;;13,0;3,0;;3,0;;;;;2,0;3,0;2,0;;2,0;;;;5,0;;;;;;;;;6,0;;;;;;;;8,0;;;;;;;;1,0;;1,0;4,0;16,0;8,0;;;;;;;;;;14,0;;117,0;;;;;;2,0;;;2,0;;;3,0;;;;;;;;;;;;;;;;;;;;;;;3,0;;;;;;;3,0;;4,0;;;;;;;;;;;;;;;;;;;;;2,0;;;;;;;;;;;;;;;;;;;;;;;;;;;;;;;;;;;;;;;;;;;;;;;1,0;;;;;;;;;;;;;;;;;275,0;2,0;;;;;;;;;;;;;;;;;;;;;;;;;;;;;;;;;;;;;;11,0;;;1,0;;;;;;;;;;;;;;;;;;;;1,0;;;;;;;;;;3,0;;;;;;;;;;;;;;;;;;;;;;;;;;;;;1,0;;2,0;;;;2,0;5,0;;;;;;;;;;;;;;1,0;;;;;;;;;;;;;;;;;4,0;;;1,0;1,0;;;;;13,0;;;;;;;;;;;;;;;;;;;;;;;;;;2,0;;;6,0;;;;;;;;;;;;;;;;;;;;;;;;;;;;;;;2,0;;;;2,0;;;;;;;
solder;;;;;;;;2,0;;4,0;;;;;;10,0;;;;;;11,0;;;;;;;;;;;1,0;;;;;1,0;;;;;1,0;;;;;17,0;;;5,0;;;;;;8,0;;;;2,0;1,0;;;;;;43,0;4,0;4,0;1,0;;;;;3,0;;;;20,0;;3,0;;16,0;;;;;1,0;;12,0;;;1,0;;;2,0;;18,0;3,0;;;38,0;;;1,0;;;;;;1,0;;;;41,0;22,0;3,0;2,0;1,0;;;3,0;2,0;;;;;;;;;;;;;8,0;;;;;;;8,0;;;;16,0;2,0;;;2,0;;;;;4,0;;;;;;5,0;;;;;;;;1,0;;2,0;;;;3,0;;;;12,0;;4,0;3,0;;10,0;;4,0;;;;;;19,0;;12,0;;;5,0;2,0;1,0;1,0;;2,0;;3,0;;;;7,0;1,0;;;;;;1,0;2,0;3,0;4,0;5,0;;1,0;1,0;;;5,0;;1,0;;4,0;2,0;;10,0;;;;7,0;3,0;;;;;;;;;;;1,0;3,0;;;;;;2,0;;;;;5,0;1,0;;2,0;;1,0;3,0;;;;;1,0;3,0;;2,0;;1,0;13,0;47,0;;;20,0;1,0;;;;;;1,0;;;;;;;;;11,0;;1,0;;2,0;;75,0;;;1,0;7,0;;2,0;;8,0;;;;;1,0;;1,0;;2,0;;;1,0;;;;;;;;;;;;3,0;;1,0;;;;;;;;;;;5,0;;2,0;;;;;;;;;;;;1,0;;;;9,0;3,0;;;;;;;;;;;;;;;;3,0;;;;;9,0;2,0;;;;;;;;;;;;;;;;;;;;;;;;;;;;;;;;;;;;;2,0;;;;;;;3,0;;;;;;;;;;;;2,0;;;;;;;;;;;;;;2,0;;;;;;;;;;;;;;;;;;;;;;;;;;;;;;;;;;;;;;;;;;;;;;;;;;;;;;;;;;;;;;;;;;;1,0;;;;;;8,0;;;;;;;;;;;;;;;;;;;;;;2,0;;;;;;2,0;;;;;;;;;3,0;;;;;;;;;;;;;;;;;;;1,0;;;;;;;;;;;;;;;;;;;;;;;4,0;;;;;;;;;;;;;;4,0;;;;;;;;;;;;;;1,0;;;;;;;;;;;;;2,0;;;;;;;1,0;;;;;3,0;3,0;;;;;;;1,0;;;;;1,0;;;;;;;2,0;;;;1,0;;;;;;;;;5,0;;;;;;;;;;;1,0;1,0;;;4,0;;;;;;;1,0;;;;;;5,0;;;;;;;;;;;8,0;;;;4,0;;2,0;;;;;;;;;;;;;1,0;;;;;;;;;;;;;;;;;;;;;;2,0;;;;;;;;;;;;;;;;;;;;;;;;;;;2,0;;;;;;;;;;;;;;;;;;;;;;;;;;;;;;;;;;;;;;;;;;;;;;;;;;;;;;;;;;;;;;;;;;;;;;;;2,0;;4,0;;;;;;;;;;;;;;2,0;;;;;;;;;;;;;;;;;;;;1,0;;;;;;;;;;;;2,0;;;;;;;;;;;;16,0;;;;;;;;;;;;;;;;;;;;;;;;;;;;;;;1,0;;;;;;;;;;;;;;;;;1,0;;;;;;;;;;;;;;
sound;;;;;;;;3,0;1,0;;1,0;;7,0;;2,0;16,0;;;;;;14,0;1,0;;;;2,0;;;;;5,0;18,0;;29,0;8,0;;3,0;3,0;;49,0;;;;24,0;4,0;11,0;61,0;6,0;9,0;1,0;5,0;;;45,0;;;;;;;;31,0;8,0;2,0;;;2,0;1,0;2,0;;;17,0;;;;;;;25,0;;2,0;;9,0;;1,0;14,0;;;;18,0;;4,0;1,0;;1,0;3,0;2,0;9,0;16,0;;;21,0;16,0;;22,0;;;33,0;1,0;;4,0;;69,0;;1,0;4,0;7,0;7,0;6,0;;;3,0;12,0;19,0;;32,0;;;2,0;;;4,0;;;;;4,0;2,0;;;;8,0;2,0;3,0;;;1,0;33,0;;5,0;;2,0;7,0;2,0;1,0;24,0;;;;;11,0;60,0;;1,0;;18,0;1,0;;;6,0;;;1,0;;1,0;1,0;;;;1,0;20,0;;;;1,0;;;;;;;;6,0;;;;;;1,0;;;;2,0;;;;;;;;;;;;;;;;4,0;1,0;;;;;;;;3,0;;;;1,0;7,0;;;1,0;;;;;;;;;;;;;1,0;;;;;4,0;;33,0;;;;;;;4,0;;;;;;;;24,0;1,0;;;;;;;1,0;8,0;2,0;;;;12,0;;;;;;;;;;;;;1,0;;;1,0;;;;;;;;;;;;;;2,0;1,0;;;1,0;;;;;8,0;1,0;;;;;;;;;;6,0;;;1,0;;;;;2,0;;;;;;2,0;;;;51,0;;;;;;9,0;;;;1,0;;;;2,0;;;1,0;;;;;;1,0;;;;;;;;;;;;;;;;;;;;;;;;1,0;;;;;;;;;;7,0;1,0;1,0;;1,0;;;;;;;4,0;;;;;;;;;;4,0;20,0;;5,0;;;;27,0;;;5,0;2,0;;2,0;2,0;4,0;;5,0;7,0;2,0;;;;;28,0;;1,0;;;;;;10,0;;;5,0;;;;;;;;12,0;1,0;;8,0;;1,0;9,0;;2,0;;;;;;;;;2,0;1,0;;3,0;1,0;1,0;;7,0;;;40,0;10,0;;;;;;2,0;;;;;;;;;;;;1,0;6,0;;;;;21,0;;;;;;;;;;18,0;;;;;;;2,0;2,0;4,0;;;;;;;;;;;;;;5,0;3,0;;;2,0;;11,0;;;;;6,0;;2,0;;2,0;4,0;;;;;;4,0;;;;;;;;;;;;3,0;1,0;;;;2,0;;5,0;;;6,0;;;;;1,0;;;1,0;;;;;;;;1,0;;4,0;;1,0;9,0;2,0;6,0;;;;;;;;;;;;;2,0;;;2,0;;;;;;;9,0;2,0;2,0;2,0;;;;;1,0;;;;1,0;;;;;;3,0;;2,0;;;;;;;;;;;;;2,0;;;;;;;;;;;;2,0;;;;;;;;;;;;;;;;;;;;;;;;;;;;;;3,0;;;;;;;;;;2,0;;;;;;1,0;;;;;;;;;2,0;;;1,0;;;1,0;;;;;;;;2,0;;;;;;;;;;;;;;;;2,0;;;;;;;;;;;;;;;;;;;;;;1,0;;;;;;;;;5,0;3,0;;3,0;;;;;;;;;;;;;;;;;;5,0;;;;;;;;;;;;;;;;;;;3,0;;;;;;;3,0;;;;;;;;;;;;;;7,0;;;;;2,0;;;;;;;;;;;1,0;16,0;;;;;;;;;;;;8,0;;;;;;;;;;;;;;;;2,0;;;;2,0;;;;;;;;1,0;;;;;2,0;;;;;;;;;;;;;;;;;;;;;;;;;;;;;;;;;;7,0;;;;;;;;;;;;;;;;;;;;;4,0;;;;;;;;;;;
speaker;;;;;;;;21,0;;3,0;;;9,0;;1,0;8,0;;;;;;8,0;;1,0;;;;1,0;;;3,0;;3,0;;4,0;;;;;;6,0;;;;1,0;;9,0;12,0;4,0;8,0;;4,0;;;;;;;;1,0;;;;;1,0;;;2,0;;;;;8,0;;1,0;1,0;2,0;;;35,0;;;;14,0;;1,0;;;;;;;;2,0;;;1,0;;7,0;4,0;4,0;;;3,0;;2,0;;;15,0;;;2,0;;;;;2,0;;;3,0;;1,0;;;9,0;;;;;;;;;;;;1,0;;;;;;;;;;;1,0;4,0;;;;2,0;5,0;;;6,0;;;;;1,0;;;;;;7,0;;;2,0;;;;;;;;;;;;;;;;;;;;;;;;;;3,0;;;;;;;;;;;;;9,0;;4,0;;;;;;;;;3,0;;;;;2,0;;;2,0;;;;;2,0;;3,0;;;;;;;;;;;;;;;;;;;;;4,0;;;;;;;1,0;;;;;;;;2,0;;;;;;2,0;;1,0;9,0;;;;;;;4,0;1,0;;1,0;1,0;;;;;;;;;;;;;;;;;;;;;;;;;;;;2,0;;;;;;;4,0;;;;;;;;;;;;;;;;;;;;;;;1,0;;;;;;;;;2,0;;;;;;;;;;;;;;;2,0;;;;;;;;;;;;;;;;2,0;;;;;;;;;;;;;;;;;;;;;;;;;;;;;;;;;;;;;;1,0;;;;7,0;;;;;;;42,0;;;;;;;;;;;;;;;;;;1,0;2,0;;;;;16,0;;;;21,0;;;4,0;;;;;13,0;;;;;;;;;;;;;;1,0;;;;1,0;1,0;;;;;19,0;;;22,0;42,0;;;;;;;;;11,0;;5,0;;;;5,0;;;;16,0;;;;;19,0;;;2,0;;;;;;;15,0;;;;;;;;;5,0;;;;1,0;;;;1,0;;1,0;;;;1,0;;;;;;2,0;2,0;;2,0;;;;8,0;;;4,0;;;;;;;7,0;;1,0;;;;;;1,0;;;1,0;;;;;1,0;;1,0;;;;;2,0;;;;;;1,0;;;;;;;;;;;;1,0;1,0;;;;;;;;;;;;;;;10,0;;;;;1,0;;;;;9,0;;4,0;;;;;;;;;;;;1,0;;;;;;;;;;;;;;;;;;2,0;;;;;;;;;;;;;;;;;;;;;;;;;;;;;;;;;;;2,0;;;;;;;;;;;;;;;;1,0;;1,0;;;;;;1,0;;;;;;;;;;;;;;;;;;;;;;;;;;;;;;;;;4,0;;;;;;;;;;;;;;;;9,0;;;;;;;;;;;;;1,0;;;;;;;1,0;;;;;;;;;;;;;;;;;;;;;;;;;;;;;;;;;;;;;;;;;;;;;;;;;;;;;;;;;;;;;;;;;;;;;;;;;;;;;;;;2,0;;;;;;;;;;;;;;;;;;;;;;;;;2,0;;;;;;11,0;;;;;;;;;;;;;;;;;;;;;;;;;;;;;;;;;;;;;;;;;;;;;;;;;;;;;;;;;;;;;;;;;1,0;;;3,0;1,0;;;;;;;;;;
stabilizer;;;;;;;;6,0;1,0;8,0;;;;;8,0;5,0;;1,0;;;1,0;;;;;;;;;1,0;;;7,0;;6,0;4,0;3,0;;;;1,0;;8,0;;;;1,0;21,0;6,0;;;2,0;;;15,0;;9,0;;;;8,0;;;;;;;2,0;4,0;;;;;;;;;;;199,0;;;;34,0;;5,0;;;2,0;2,0;10,0;;;;;;;;7,0;;;;30,0;1,0;;;115,0;;;;;;;;;8,0;22,0;6,0;;;;;;;2,0;;;;;4,0;;1,0;8,0;;;;;;;;1,0;;;14,0;;;;4,0;9,0;;;;;;;2,0;15,0;;1,0;;;1,0;4,0;;;;1,0;6,0;;;;;;;;;18,0;;;;4,0;11,0;;;;4,0;;2,0;;;;;;3,0;;1,0;;;;2,0;2,0;;;16,0;;2,0;;;;6,0;;;1,0;;;;;;3,0;9,0;21,0;;3,0;;;;;1,0;2,0;;32,0;;;23,0;7,0;;2,0;4,0;1,0;5,0;;;2,0;;;;;;;;3,0;;;;;;12,0;;;;5,0;;3,0;;;1,0;4,0;;;;1,0;;3,0;;;2,0;1,0;1,0;;9,0;;;2,0;;;2,0;;;;;;;;;;;32,0;;;;13,0;;13,0;;1,0;5,0;;2,0;2,0;;;1,0;;;;;;3,0;;8,0;;;;2,0;7,0;;4,0;;;;;;;;;;;4,0;;2,0;;;;;;;1,0;;1,0;;;;;;3,0;1,0;;7,0;;;;;;;;1,0;;;4,0;;;;;;;;;;5,0;;;4,0;;;;4,0;;2,0;;38,0;;;;;1,0;;;;;;1,0;;;3,0;;;;2,0;;;1,0;;;;;;;;;;;1,0;;;;;;1,0;;1,0;;;;;1,0;;;;;;;4,0;2,0;;;1,0;;2,0;2,0;;;;;;;;;;;;2,0;;;;7,0;;;;;1,0;;;;;3,0;;;;;;1,0;;;1,0;;;;;;;;;;;;;;;1,0;;;;;2,0;1,0;;;;;;;;;;;;;;;;;;;2,0;;;;;;;;;;;;1,0;;;;;;5,0;;;;5,0;;;;;;;;;;;1,0;;9,0;;;;;;2,0;2,0;;;;;;;;;;;;;1,0;;;;;;;;;;3,0;;;;;;;;;2,0;;;;;;;;;;;;;;;5,0;;;;;;;;;;;;;;;;;;;;;;;;;;;;;;;;;;;;;;;;;2,0;5,0;7,0;1,0;;;;;;;;;;;1,0;;;1,0;7,0;;;;;;;1,0;9,0;8,0;2,0;;;;2,0;;;;;;;;;;;;;1,0;4,0;;;1,0;;;1,0;;;;1,0;;;;6,0;;;;;;;;;;;;8,0;;;;;;;;;;;;;;;;;;2,0;;;;;2,0;;;;;;;;;;;;;;;;;;;;;;;;;;;;;;;;;;;;;;;;;;;;;;;;;;;;;7,0;;;;;;3,0;;;;;;;;;;;;;;;1,0;;;;;;;;;;;;;;;;;;;;;;;;;;;;;;;;;;;6,0;;;;;;;;;;;;2,0;;;;;;;;;;;5,0;;;;;;;;;;2,0;;3,0;;;;;;1,0;;;;1,0;;;;;6,0;;;;;;;;;;;;;;;7,0;;2,0;;;;;;;;;;;;;10,0;;;;;;;;;;;;3,0;1,0;;;;;;;;;;;;;;;;;;;;5,0;;;;;;;;;;;;;;;;;;;;;;;;;;;;;
suspension;;;;;;;;9,0;;5,0;;;;;5,0;9,0;;;;;;2,0;;;1,0;;;;;;;;;;;;;2,0;;;;;;;;;;1,0;4,0;;;;;2,0;2,0;;2,0;;;;7,0;3,0;;;;;4,0;1,0;18,0;3,0;;;;;;;;;;6,0;;;;7,0;;;;;;;11,0;;;;;;;;;4,0;;;7,0;;;;5,0;;;;1,0;4,0;2,0;;;16,0;9,0;4,0;3,0;;2,0;;;;;;;;;;;;4,0;;;;4,0;;;;;;;;;;;11,0;;;;;;;;3,0;6,0;;;;;;12,0;;;;1,0;;;;;;;;3,0;3,0;13,0;;;;;8,0;;;;;;;2,0;;;;;24,0;1,0;;;;;;;2,0;;11,0;2,0;10,0;3,0;;;1,0;1,0;;3,0;;;;;;;4,0;;;1,0;1,0;;;;;;;30,0;;;;2,0;1,0;;1,0;3,0;9,0;;;;;;;;;;;;;;;;;;;;;46,0;;;;;1,0;;;;;;;;;;19,0;;1,0;;;;;;;;1,0;;;;;1,0;;1,0;;;;;;75,0;;;;3,0;;;;;;2,0;;;;;;;1,0;;;;;5,0;;;;8,0;;;;;;;;;;;;;;1,0;1,0;1,0;;3,0;;;1,0;5,0;;3,0;;;;;1,0;;;3,0;;1,0;;;1,0;;;;;;;;;;;;;;2,0;;;;1,0;;;;;;;;;;5,0;;;;;;;8,0;;;;;;;3,0;;;;;;;;;;;;3,0;;1,0;;;;;;;;;1,0;;;;;;;;;;;;;;;;;;;;4,0;;;;;;;;;;;;;;;;;;;;;;;;;;;;;;;;;;;;;;;;;;;;;;;;;;;;;;;;;;;;;;;;;;;;;;;;;;;;;;;;;1,0;;;;;;2,0;;;;;;;;;;;;;;;;;;2,0;;;;;;;;;;;;;2,0;;;;;;;;;;;;;1,0;;;;;;;;;;;;;;;;;;;;;3,0;;;;;;;;2,0;;;;;;;;;;;;;;;;;;;;;;;;;;;;;;;;;;;;;;;;;1,0;;;;;;;;;;;;9,0;;;;;;;;;;;;;;;;;;;;2,0;;1,0;;;;2,0;;1,0;;;;;8,0;;;;;;;;;;;;;;;1,0;;;;;;2,0;;;;;;;;;;;;3,0;;;9,0;1,0;;;;;;;;;;;;;;;;;;2,0;;;;;;;;;;;;;;;;;;;;;;;;;;;;;;2,0;;4,0;;;;;;;;;;;;;;;;;;;1,0;;;;;;;;;;;;;;;;;;;;;;;;;;;;;;;;;;;;;;;;;;;;;;;;;;;;;;;;;;;;;;;;;;;;;;;;;;;;;;;;;2,0;19,0;;;;2,0;;;;;;3,0;;;;;;;;;;;;;;;;;;;;;;;1,0;;;;;;;;;;;;;;;;;;;;;;;;;;;;;;;;;;;;;;;;;;;;;;;;;;;;;;;;;;;;;;;;;;;;;;;;;;;;;;;;;;;;;;
template;;;;;;;;2,0;9,0;;;;16,0;;;36,0;;;1,0;7,0;26,0;14,0;;;;2,0;6,0;2,0;;;2,0;;9,0;;;;;3,0;9,0;;18,0;;1,0;;;1,0;17,0;3,0;4,0;24,0;;1,0;;8,0;;;11,0;;3,0;;1,0;;;2,0;2,0;;;;9,0;;;;12,0;;;;2,0;;;155,0;2,0;;;22,0;;10,0;;;;5,0;2,0;;;1,0;11,0;;4,0;;21,0;;1,0;6,0;1,0;7,0;;;;;5,0;;;3,0;;;;16,0;2,0;7,0;;1,0;;;;36,0;13,0;1,0;;2,0;;;1,0;20,0;;;5,0;;3,0;3,0;1,0;;6,0;;;2,0;;;;;4,0;3,0;2,0;;1,0;2,0;1,0;;14,0;;;;3,0;;19,0;;;;25,0;;1,0;;;;;;;;;;;;;1,0;;;;;;11,0;;;;;;;3,0;;6,0;;;2,0;;;2,0;;;;;;4,0;1,0;;;;;;;;;;;;;;4,0;;;;;;;;;3,0;;;;;;;;1,0;;;;;;;;13,0;1,0;;;;;;;18,0;;;;;;;15,0;;;;;;;;;2,0;;;;;;;7,0;;;;;;4,0;;;;;;;;;;;2,0;;;;;;;;;;;;;;;;;;;;;;;;;;;;;;;;;;;;;;;;;15,0;;;;;7,0;;;;;;;11,0;;;;;;;;4,0;;;;11,0;;;;;;;;;;;;2,0;;;;;;;;;;;;;;;;;;15,0;;;;;;;1,0;;;;;2,0;;;;;;2,0;;;5,0;;;;;;;;;;;4,0;3,0;;;9,0;;;;5,0;8,0;;14,0;;39,0;;;;1,0;9,0;;;1,0;;;;;;;;;;;9,0;1,0;;;;;;;;;;;;;6,0;;;;24,0;10,0;;;;;;;;;;4,0;;;;;;;;;13,0;4,0;;;;2,0;;;;;;;;;;;1,0;15,0;;;;1,0;;;;;;;;;;;3,0;;;;;;;;;1,0;;14,0;2,0;;;;;;;;1,0;;1,0;;4,0;;;;8,0;;;;;;;;;;4,0;;3,0;;1,0;;;1,0;1,0;1,0;;2,0;;;;;;;;2,0;;;;;;;1,0;;;;;;;;;;;;;;;;25,0;;2,0;;;;16,0;;;;;;;;;;;;1,0;;;3,0;;;;;;;;;1,0;;;2,0;;;;;3,0;3,0;;;;3,0;;;;;;;;;;;;;;;;;;;;;;;;;;1,0;;;;;;;;;;;;;;;;;;;;;;2,0;;;;;;;;;;;3,0;;;;;;;;;;;;;;;;;;;;;;;;;;1,0;;;;4,0;;;1,0;;;;;;;;;;;;;;;;;;;;;;;;;;;;;;;;;;;;;2,0;;;;;;;;;;13,0;;;;2,0;;;;;;1,0;;;1,0;;;;;8,0;;;4,0;2,0;2,0;;;;;;3,0;;;18,0;;28,0;;;;;;;;;;;;;;;;;;;;;1,0;;;;;;;;2,0;;;;;;;;;;;;;;;3,0;;;;;;;;;;;;;;;;;;;;;;;;;;;;;;;;;;;;;;;1,0;;;;;;2,0;;;;;;;;;;;;;;;;;;4,0;;;2,0;1,0;;;;;;;6,0;;;;;;;;;;;;;;;;;2,0;;;;;1,0;;;2,0;;;;;;;;;;;1,0;;;;;;;;;;1,0;;;;;;;;;;;;;;
thin;;;;;;;;11,0;4,0;5,0;;;;;3,0;4,0;1,0;;;;;;;;;;4,0;1,0;3,0;;;;4,0;;;;;;;;51,0;1,0;;1,0;;;4,0;37,0;9,0;9,0;7,0;;;;5,0;9,0;;;;;;3,0;1,0;;7,0;;;18,0;2,0;1,0;;;1,0;;;;;;;55,0;;4,0;7,0;8,0;1,0;;;;1,0;;6,0;;;7,0;;;5,0;;8,0;;;;2,0;;1,0;;9,0;2,0;12,0;;;9,0;1,0;;;;104,0;1,0;6,0;;;;;15,0;;;;;;;;;;6,0;1,0;2,0;;;6,0;;;;;1,0;;;;7,0;29,0;;;;9,0;8,0;1,0;;11,0;;;;;;12,0;;;;2,0;1,0;;;4,0;12,0;1,0;;;6,0;;;1,0;;;11,0;7,0;1,0;6,0;1,0;2,0;;;;6,0;;1,0;1,0;;;;;;;;;8,0;8,0;;;2,0;1,0;;10,0;25,0;24,0;1,0;1,0;;;;;;3,0;10,0;;6,0;;;;11,0;;3,0;2,0;39,0;1,0;2,0;;;1,0;2,0;3,0;1,0;4,0;;;4,0;;;;;;65,0;;82,0;;;;;;21,0;;1,0;;;;;12,0;18,0;;13,0;;2,0;2,0;;1,0;1,0;;;;;;19,0;55,0;;;4,0;48,0;;1,0;;;;2,0;;5,0;;1,0;1,0;;;;;;3,0;;;;;1,0;;;;1,0;2,0;1,0;2,0;5,0;4,0;;;;;6,0;;;4,0;;5,0;;12,0;13,0;;;;;7,0;;;5,0;;;2,0;4,0;;;3,0;;;;;4,0;;;1,0;;;;;;;;;;3,0;1,0;2,0;;8,0;;;1,0;;;;;;;2,0;;;;1,0;;;;15,0;;4,0;;;;;3,0;;4,0;;;;;;;1,0;;;;5,0;;;;;;;;;;;;;;;;;;;;;2,0;;;;;;;;1,0;;;;;;1,0;37,0;;;;;;;;12,0;;;;;;;;;;;;2,0;;;;;1,0;;;;;3,0;;;;;;;;;;;;;;;;;;;;;;;;;2,0;3,0;;;;;;;;;;;;;10,0;51,0;;;;;;;;;;;;;;;;;;;;;;;1,0;;;;;;;;;;11,0;;;;;1,0;;;;;2,0;;;;;;;;;;2,0;;;;;;;;;3,0;;;;;1,0;;;;;;;;;8,0;16,0;;;;;;;;;;;;;;;1,0;;;;;;;;;;;;;;;;;;;;2,0;;;;;;;;;;;;;;;;;;;;;;;;;;;;;;4,0;;;;;;;2,0;;;;4,0;;;;;2,0;;;;;;;;;;;;1,0;;;;;1,0;;5,0;;;1,0;2,0;;;;;;6,0;;;;;;;;;;;;;;;;;;1,0;;;;;2,0;1,0;;;;;;4,0;4,0;;;;;;3,0;;;;;;4,0;;;1,0;;3,0;;;;1,0;;;;;;;;;;1,0;;;;;;3,0;;;;4,0;;;;;;;;;;;2,0;1,0;;;;;;;;;;;;;4,0;4,0;;;;;;;;;;;;;;;;;;;;;;;;;;;;;;;;;;;;;;;;;;;;;8,0;;;;;;;;;;;;;;;;;;;;;;;1,0;;;;;;;;;;;;;;;;;;1,0;;;;;;;;;;;;;;;4,0;;;;;;;;;;;;;2,0;;;;;;1,0;26,0;;;;;;;;;;;;;;;;;;;;;;;;;;;;;2,0;;;;;2,0;;;;;1,0;;;;;;;;;;;;;;;;;;;;1,0;;;;;;;;;;;;;;;;;;;;;;;;;;
thumbnail;;;;;;;;5,0;3,0;;;;6,0;;;12,0;;;;;;5,0;1,0;;;;;;;;2,0;;15,0;;4,0;;;;4,0;;40,0;;;;;;;12,0;22,0;75,0;;;;;;;;;;;;;7,0;11,0;;;;;;;;;9,0;1,0;;;;;;97,0;;2,0;;11,0;;3,0;;;;4,0;;1,0;;;;;1,0;4,0;20,0;;;;2,0;2,0;;;;10,0;3,0;;;9,0;;;8,0;84,0;;15,0;;;;;2,0;;1,0;3,0;;;;;;;;;;1,0;14,0;3,0;1,0;;;;2,0;;2,0;;;;;22,0;;;3,0;9,0;;;6,0;;;;2,0;;9,0;;;;;27,0;;;;;;;;;;;;;;;;;;;;;;;16,0;;;;;;12,0;;;;;;;;;;;;;;;;;;;;;;;;;;;;;;;;;;;;;;;;;1,0;;;1,0;;;;;;;;;;;;;;;;13,0;;;;;;1,0;25,0;;;;;;;;;;;;;2,0;;;;;2,0;;;;;;;;;;;;;;;;;;;;;;;;;;;;;;;;;;;;;;;;;;;;;;;;;;;;;;;;;;;;;;;;;;;;;;;;;;;;;;;;;;;;;;;;;;;;;;;;;10,0;;;;;;;;;;;;1,0;;;;;;;;;;;;;;;;;;;;4,0;;;;;;;;;;;;;;;;;;;;;3,0;;;;;;;5,0;;;;1,0;;;;1,0;;;;2,0;;;4,0;;7,0;;;;;;;;;;;;;;;;;;4,0;25,0;;;;;;;;;;;;15,0;;;;;;;;;;;;13,0;;;;;1,0;1,0;;;;1,0;6,0;;8,0;;;;;;;;;;;;;;;;;;;;;;2,0;;;1,0;;;;;;;;;1,0;;2,0;;8,0;;;;;;;;;;4,0;;;;;;1,0;;2,0;;;;;;;;;;;;;;;;;;;;;;3,0;2,0;;;;;;;3,0;;;;;;;;;;;;;;;;;;;;;;1,0;;;;;1,0;;;;;;;;;;;;;;;;;;;;;;;;;;;;;;;;;;;;;;;;;;;;;;;;;;;;;;;;;;;;;;;3,0;;;;;;;;;;;;;;;;;;;;;;;;;;;;;;;;;;;;;;;;;;;;;;;;;;;;;;;;;;;;;;;;;;;;;;;;;;;;;;;;;;;;;;;;;;;;;1,0;;;;;;;;;;;;;;;;;;;;;;;;;;;;;;;;;;;;;;;;;;;;;;;;;;;;;;;;;;;;;;;;;;;;;;;2,0;;;;;;;;;;;;;;19,0;;;;;;;;;;;;;;;;;;;;;;;;;;;;;;;;;;;;;1,0;;;;;;;;;;;;;;;;;;;;;;;;;;;;;;2,0;;3,0;;;;;;;;;;;;;;;;;;;;;;;;;;;;;;12,0;;;4,0;;;;;;;;;;;;;;;;;;;;;;;;;;;;;;;;
trajectory;;;;;;;;11,0;7,0;;;;;;5,0;18,0;;;;;3,0;14,0;;;;;1,0;;;3,0;4,0;;1,0;;4,0;1,0;1,0;;;7,0;10,0;;;;4,0;;58,0;24,0;2,0;14,0;;2,0;;;1,0;;5,0;;75,0;;;;4,0;;1,0;;;6,0;10,0;;20,0;;18,0;;;1,0;;;;58,0;;4,0;;17,0;;;;;1,0;2,0;4,0;;;;3,0;1,0;3,0;;37,0;;;;;46,0;;3,0;1,0;6,0;;2,0;7,0;2,0;;;;12,0;7,0;29,0;;2,0;;;3,0;4,0;8,0;5,0;;1,0;;9,0;;8,0;5,0;3,0;13,0;;1,0;;;;3,0;;;13,0;;;;;;;;;1,0;;34,0;;17,0;;2,0;;;6,0;9,0;;;1,0;3,0;11,0;;;1,0;;;;;11,0;;;;;;;;;;1,0;;;;;;;;;;;;;;;;;;6,0;;;;;;1,0;;;;;;;;;1,0;;6,0;11,0;;;;;;;2,0;;;;;;;6,0;37,0;;;;;;;2,0;;;;;12,0;3,0;;;1,0;;;;4,0;;;;;;;4,0;;;5,0;;;;;6,0;1,0;;;;4,0;;;3,0;;;1,0;;;14,0;;;;;41,0;;;;;;;;;;;;;;5,0;;;;;1,0;;;;;;8,0;;;;;;;;;7,0;;;;;1,0;;;;;;;;5,0;;;;;;;;;;;;2,0;;;;;;;;25,0;;;;7,0;;;;;;;;;;;;;;;;;1,0;4,0;;;1,0;;;2,0;;;;;;5,0;;;;;;;;;2,0;2,0;;;;2,0;;;9,0;11,0;3,0;;3,0;1,0;5,0;;4,0;;;;;;1,0;8,0;;4,0;;14,0;;1,0;6,0;;;7,0;16,0;;5,0;3,0;;;;1,0;16,0;1,0;;;1,0;4,0;5,0;;;;;;;8,0;;;;2,0;;;;7,0;;;;6,0;1,0;4,0;;23,0;2,0;;;;1,0;1,0;;;1,0;;;1,0;8,0;;;;;7,0;;;2,0;;;;;;;;;;;7,0;;5,0;;;;;;;;;;;;;;;;;;;;;;;;;;;;2,0;;;3,0;2,0;;;;;;3,0;;;;;;;1,0;;;;;1,0;2,0;;;;;;;2,0;;;1,0;;;;3,0;;1,0;;;;;;;7,0;;1,0;;;;;;;;;;;;;;;;;1,0;;4,0;;;;;;;;;6,0;1,0;;;;;;;3,0;;;;1,0;;;1,0;;;;;;;;;;;;;;1,0;4,0;;;;;;;1,0;;8,0;;;;;;;;;;;;;;;1,0;;;;;;;3,0;;;;;;;;;3,0;;;3,0;;;;;;;;;;;;;;1,0;;;;3,0;;;1,0;;;;;;;;;;4,0;;;;;;;;;;;;;;;;;;;2,0;;;;;;;;2,0;;;;;;;;;7,0;2,0;;;;;;;;;;;;;;1,0;;;;;;;;;;;;;;;;;;;;;;;;;1,0;;;;;;;;11,0;2,0;;;;;;;;;;;;;;;;;;;;;;;;;;;;;;;;;;2,0;;;;2,0;;;;;;;;;;;;;;;;;;;;;;2,0;;;;;;;2,0;;;1,0;4,0;;;;;;;;;;;;;;;;;;4,0;;;;;;;;;;;;;4,0;;;;3,0;;;;;;;;;;;;;;;;;;;;;;;;;;;;;;;;;;;5,0;;;;;;;;;;;;;;;;;2,0;;;;;;;;;;1,0;;;;;;;;;;;1,0;;;;;;;;;;;;;;;;;;;;;;
transceiver;;;;;;;;2,0;;;;;3,0;;;2,0;1,0;;;;;2,0;;1,0;;;;;;;1,0;2,0;29,0;;10,0;5,0;;;;;16,0;;1,0;;2,0;23,0;;35,0;4,0;8,0;;;;;;;6,0;;;1,0;;6,0;;;1,0;;;2,0;2,0;;;;2,0;;;;;;;12,0;2,0;;;14,0;;2,0;;;;;;;;;;;5,0;;13,0;4,0;;;27,0;;;7,0;;;;;;3,0;;;;7,0;4,0;21,0;6,0;;;;;2,0;13,0;;;;;;;;;;;;;2,0;;;;;2,0;2,0;7,0;;;;9,0;;;;;;;1,0;22,0;;;;;42,0;9,0;;;;19,0;3,0;;;;;;;;;;;;;;3,0;;;;10,0;;;;;;;;8,0;;;;;6,0;;;;;;;;;7,0;;;;;;;;;;;;;2,0;;;;;;;;12,0;;;;;2,0;;;;;;;;;;;;;;;;;;;;;;;57,0;;;;;;;1,0;;;;;;;;2,0;;;;;;;;;7,0;2,0;;;;;;;;;6,0;;;;;;;;6,0;;;;;;;;;;;;;;;;;;;6,0;;17,0;;;;1,0;;;;;;;;;;;;45,0;;;;;;;;5,0;;;;;;1,0;;;;;;;2,0;;1,0;;;;;;;3,0;;;;;;;;;;;;;;;;;;1,0;;;;;;2,0;;;;13,0;;5,0;;;;;;1,0;3,0;;;;;;;;;11,0;;;2,0;;;;;;;;;5,0;;;;;;;;7,0;1,0;;1,0;;;;18,0;;;1,0;;;3,0;5,0;;;;;;;;;;2,0;11,0;;;;;;;;;;;;;;;;1,0;;;;;;;;;;;;;;;;;1,0;;;1,0;1,0;;;8,0;;1,0;;7,0;4,0;;;2,0;;;1,0;;;;2,0;;;6,0;;;;;;1,0;1,0;;;;;3,0;;;1,0;;;6,0;4,0;;;;;;;;;;;;;3,0;;;;;;;;;;;4,0;;;;2,0;3,0;;;4,0;11,0;20,0;1,0;;;;;;;;;;;;;;;;3,0;;;;;;;;;;;;;;;7,0;2,0;;;4,0;;;;;;1,0;;;;;1,0;;;;;;;;;;;;;2,0;;1,0;;;;2,0;4,0;;;;;;;;;;;;;;;;;53,0;;;;;3,0;;;;;;;;;;;;;;;;;;;;;;;;;;;;;;;3,0;2,0;;;;;;;;;;;;;;13,0;;;;;;;;;;;;;4,0;8,0;;;;;;;;1,0;6,0;;;;;;;;;;;16,0;;;;4,0;;;;;;;;;;;;;;;;;1,0;;;;;;;2,0;;;;;;;;;;;;;;;;;;;;;;;;;;;;;;;;;;;;;;;;;;;;;;;;;;;;;;;;;;;;;;;;;;;;;;;1,0;;;;;;;;;;;;;;;;;3,0;;;;;;;;;;;;;;;;;;;;;;;;;;;;;;;31,0;2,0;;;;5,0;;;;;;;;;;;13,0;;;;;;;;;;;;;11,0;;;;;;;;3,0;;;;;3,0;;;;;;;;;;;;;;;;;;;;;;;;;;;;;;;;;;;;;;;;;;;;;;;;;;;;;;;1,0;;;;;;;;;;;;;;;;;;;
transform;;;;;;;;6,0;34,0;4,0;10,0;;1,0;1,0;;42,0;;;;2,0;12,0;50,0;;;;8,0;53,0;;;1,0;4,0;;48,0;;6,0;;17,0;1,0;;;99,0;;3,0;13,0;10,0;7,0;12,0;13,0;18,0;9,0;;;1,0;3,0;;7,0;3,0;;27,0;;;;1,0;;24,0;2,0;;3,0;70,0;;19,0;;65,0;;37,0;16,0;27,0;;2,0;440,0;;;;23,0;;2,0;;;;2,0;;;;;17,0;2,0;14,0;1,0;45,0;2,0;39,0;1,0;15,0;15,0;;3,0;4,0;2,0;42,0;310,0;;35,0;;;1,0;46,0;48,0;23,0;;48,0;4,0;;5,0;15,0;11,0;1,0;1,0;3,0;;3,0;;16,0;7,0;;6,0;;16,0;1,0;;;13,0;;;6,0;10,0;;;;13,0;;2,0;;26,0;30,0;1,0;;33,0;;1,0;2,0;3,0;2,0;28,0;7,0;;;21,0;58,0;;;4,0;;;5,0;;30,0;;;;4,0;;2,0;;;;11,0;;9,0;;;10,0;1,0;;;;;;;;;22,0;;57,0;26,0;;;;1,0;;;;;;;;;;;;;2,0;;;2,0;;;;;8,0;;;;;;;2,0;6,0;;;;11,0;;2,0;1,0;;;;;113,0;3,0;1,0;;;;;;11,0;4,0;;;;;;4,0;;;8,0;;;;2,0;2,0;17,0;;;;1,0;17,0;;6,0;;;;;;8,0;1,0;;;5,0;7,0;20,0;;;;;;;;;;;;;;;;12,0;;;;;;;;2,0;;;;4,0;;;;;;;;;1,0;;;;;;;10,0;3,0;;;;;;;1,0;;;;2,0;;2,0;;;;;;;;15,0;;;;2,0;;;;;;1,0;;;2,0;;;;;;;;1,0;4,0;;;2,0;;;2,0;;;;;;18,0;1,0;;;1,0;;;2,0;;;;;7,0;;;;7,0;5,0;73,0;2,0;1,0;1,0;4,0;1,0;;;;;;2,0;;;;;1,0;;36,0;;;;2,0;2,0;8,0;19,0;1,0;12,0;16,0;;;1,0;29,0;7,0;;;;4,0;;4,0;;;;;;;10,0;;3,0;;8,0;1,0;;;1,0;;;;;30,0;7,0;3,0;;;;5,0;3,0;22,0;9,0;;;3,0;17,0;8,0;3,0;80,0;;;4,0;;;;14,0;1,0;1,0;3,0;;;;1,0;;;;2,0;;159,0;;;;;;18,0;;;;;;4,0;;;;;;;1,0;;;7,0;;;;;;;;;;3,0;;;;1,0;;;;;3,0;3,0;;;;2,0;;2,0;1,0;1,0;;;;;1,0;;;;10,0;;2,0;;;;16,0;1,0;;;;;11,0;;;15,0;;;;;;;;;;;;;;;;;;;;1,0;;1,0;;;;;;;;;;;;;;;;;1,0;;;;24,0;;6,0;;;38,0;1,0;;;;;;11,0;;;;;;;3,0;2,0;;;;;1,0;;4,0;;;;;;;;;;;;;;;;1,0;1,0;;;;;;;;1,0;;;;;;3,0;;;;;;12,0;;;;;;;;;;5,0;6,0;2,0;13,0;;;;;;;2,0;;;;;;;;7,0;;;;;;;;;;;;;;;;;;;;;;;;;;;4,0;;;4,0;;;;;;;;;5,0;;;4,0;;;;;;;;;3,0;;7,0;;;;;;;1,0;;;;;16,0;;;;;;;1,0;5,0;4,0;;14,0;3,0;18,0;;;2,0;;;;4,0;;1,0;;;4,0;;1,0;;;2,0;;2,0;4,0;;16,0;;2,0;;;2,0;;;;;;;;22,0;;;1,0;;;1,0;;;;;;;11,0;;1,0;;;;2,0;1,0;;;;;;2,0;2,0;;1,0;;;4,0;;;;;;;;;;3,0;1,0;;;;;;;;;;1,0;;4,0;;;;;;21,0;;1,0;;;;;;;1,0;;;;;;;;;;;;;;;;;;;;;;2,0;;3,0;;1,0;1,0;;;;;;;;;3,0;;4,0;;1,0;2,0;;;;;;;3,0;;1,0;;;1,0;;;;23,0;;;;;;;;;;;;;;;;8,0;;;24,0;;;;;2,0;;;3,0;;5,0;;;;;;;;;3,0;2,0;;;;;;;
transistor;;;;;;;;46,0;16,0;46,0;7,0;;13,0;;;7,0;;;;2,0;11,0;;;93,0;;;5,0;;;;;;39,0;;89,0;1,0;;11,0;;;;;;1,0;16,0;15,0;9,0;106,0;6,0;8,0;47,0;2,0;;2,0;8,0;2,0;57,0;;;;11,0;;96,0;;4,0;;;78,0;;4,0;43,0;;40,0;;;;;3,0;;63,0;;100,0;;261,0;1,0;;;;;17,0;;;;;;;1,0;;14,0;1,0;;;4,0;;;2,0;2,0;;184,0;;2,0;22,0;49,0;;2,0;222,0;43,0;2,0;21,0;22,0;1,0;;1,0;;2,0;;;;;2,0;;34,0;;;;;12,0;1,0;6,0;;;;;35,0;8,0;;;36,0;188,0;;;2,0;;5,0;;89,0;5,0;;;374,0;;;120,0;;;;;;;;;;;16,0;;13,0;;;5,0;;;;;;106,0;164,0;;;6,0;;;;;295,0;6,0;9,0;;;;7,0;1,0;;;9,0;;;25,0;;1,0;3,0;38,0;;2,0;349,0;;;;;;10,0;;4,0;2,0;;;;29,0;;11,0;;;3,0;7,0;2,0;;;;;6,0;;3,0;;5,0;7,0;;76,0;54,0;;228,0;;;;;;;7,0;29,0;;;;;;;46,0;35,0;;;;;4,0;;196,0;;2,0;;;2,0;14,0;33,0;23,0;188,0;;73,0;3,0;4,0;8,0;;;;;;5,0;;;4,0;;;;13,0;;1,0;;;;;;38,0;;;;4,0;;9,0;;;;;;;5,0;;;;;14,0;;;;;;;;;;;;6,0;;12,0;;;;;6,0;;;;;3,0;8,0;;1,0;;14,0;;;;6,0;;;;;;;;;;;20,0;;;;;;;;;;;;;;;;;1,0;;;4,0;;1,0;;;2,0;;2,0;;12,0;;;;;;1,0;;;;;;;;;13,0;;;7,0;;;;;;;;;;;;;;;;90,0;15,0;6,0;;;;;;4,0;;;;;;9,0;5,0;;;2,0;;3,0;;;;;;;;;20,0;;;;;;;;7,0;;;;;;;;;;163,0;;;1,0;;;;;;;;;13,0;;;;2,0;;;;;;;;;;;;;;52,0;;;;;;;;;;;;;2,0;;;;;;;;;;1,0;1,0;13,0;;;;;;;;;;;;1,0;;;;79,0;;;4,0;;;;;;;;;;37,0;8,0;;;;;;;15,0;;;;1,0;;;;;;;;;;;23,0;;;;;;;3,0;;;;;;;41,0;2,0;;;;1,0;;;;;;;;;4,0;;;;;;;26,0;;;;;;166,0;13,0;;;301,0;;;2,0;;;27,0;;;;11,0;;;;;;;;;;;;;;;;;;;;;;;;79,0;1,0;;;;;5,0;;;;;;;;;;;;;;;2,0;;2,0;;;;;;;;;;73,0;;;;;;;;;26,0;;;;;;;5,0;;;;;;;21,0;6,0;;;;1,0;17,0;50,0;2,0;2,0;;;;;;;;;;;;28,0;;;;;;;;;;;;;;23,0;;;98,0;28,0;19,0;139,0;83,0;5,0;;;;25,0;61,0;;96,0;126,0;;;105,0;;;;;;143,0;1,0;2,0;;;;;;;;;;;80,0;;91,0;2,0;;;;;;;;;;;;;;;;;;;1,0;;1,0;;;;;11,0;;;153,0;;;;2,0;;;;;;;;;;;;;;;4,0;;;;;3,0;;;;;7,0;;;;;;;;;;;;;;;2,0;;;;;1,0;;;;;;;;;;;;;;;;;;;;16,0;;;;;;;;3,0;;;;;;;;;;;;;;;;;;;;;;;8,0;;32,0;;;;;;;;;;;;;;;;;;;;;;;;;;;;;;;;;;;;;;;;;;;;;;;;;;;;;;;;;;;;;;;;;;;;;;;;
wafer;;;;;;;;1,0;1,0;4,0;35,0;;;;2,0;;;;;;;2,0;;;;1,0;;;;;;;7,0;;1,0;;;;;;;1,0;1,0;2,0;;;;10,0;;;6,0;;;9,0;;1,0;38,0;;;;;1,0;;;;;1,0;69,0;;5,0;;;;;;7,0;;;;69,0;;1,0;1,0;27,0;;2,0;;;;;132,0;;;14,0;;;;;35,0;;;;56,0;;;;43,0;;;;;1,0;;;2,0;43,0;11,0;8,0;;;;;4,0;4,0;2,0;;;;;;;;;6,0;;;13,0;;;;;;;67,0;;;;2,0;;;;18,0;;;;;3,0;;;;;;11,0;;;;;;;;;4,0;2,0;1,0;1,0;;23,0;;;;;3,0;17,0;;;;1,0;1,0;;;;1,0;;5,0;;1,0;;;;18,0;;;;5,0;;;;;;3,0;2,0;3,0;;;11,0;;5,0;;1,0;3,0;4,0;1,0;;;;;6,0;;45,0;7,0;12,0;1,0;;1,0;;;;;;;;;;;;;;;26,0;4,0;5,0;;;;;;11,0;;;;;;12,0;;56,0;;2,0;;4,0;6,0;;;1,0;52,0;;;;4,0;52,0;30,0;;;;11,0;1,0;;1,0;;;26,0;;;;;;;;;;;;;4,0;;;;;;1,0;;;;6,0;;;;;;;9,0;;;;;;;;;;;;;;;;;;;;;;;;2,0;;;;;1,0;1,0;;;;2,0;;;;;;;;;12,0;;2,0;;;;2,0;;;;;;;;1,0;;;;;;;;;;3,0;;;;1,0;;3,0;;;;;;;;;;;;;;;;;;;;;;;;;;;;;2,0;3,0;;;;;;;;;;77,0;;;;;;;;;;;;;;;;;;;;;;;;;;;;1,0;;;;;;;;;;;;;;;;1,0;;1,0;;;3,0;;;;;;;;;;;;;;;;;1,0;;;;;;;;;;;;3,0;;;;;;;;;;;;;;;;;;;3,0;;;;;;;;1,0;;;;;;;;2,0;;;;;;;;;;;;;;;;;;;;;;;;;;;;;;;2,0;;;;;;;;;;;;2,0;1,0;;;;;;;;;;;6,0;;;;;;;;;;;;;;;;;;;;;;;;;;;;;;;;;5,0;;;2,0;;;;;;;;;;;1,0;;;;;;;;;;;;;;;;2,0;;;;;;;;;;;;;;;;;;;;;;;;4,0;;;;;;;;;;;;;;;;;;;;;;;;;;1,0;;;;;2,0;;;3,0;;;;;2,0;;;;;;1,0;;1,0;;;;;1,0;;;;;;1,0;;;18,0;;;;;;;3,0;;;1,0;;;;;;;;;;;;;9,0;;;;;;;;;;;;;6,0;;;;;;;;;1,0;;;;;;;;;;;2,0;;;;;1,0;;;;;;;;;;;;;1,0;;;;;;;;;;;;;;;;;;;4,0;;;;;;;;;;;;;;;;;;;;;;;;;;;;;;;;;;;;;;;;;;;;;;;;;;1,0;;8,0;;;;;;;;;;;;;;;;;;;;;;;;4,0;;;;;;;;;;;;;;;;;;;;;;;;;;;;;;;;;;;;1,0;;;;;;3,0;;;;;;;;;1,0;;;;;;;;;;;;;;;;;;;;;;;;;;;;;;;
work;;;;;;;;3,0;2,0;6,0;;;3,0;;;20,0;;;;;;;;86,0;;;1,0;1,0;;;;3,0;22,0;;7,0;;;1,0;1,0;;3,0;;17,0;5,0;11,0;;;56,0;;2,0;6,0;12,0;1,0;;;;;;;;39,0;2,0;7,0;;;4,0;;5,0;2,0;10,0;4,0;;;;;;4,0;2,0;5,0;18,0;;;;8,0;;;;;;1,0;16,0;;;1,0;;;;;2,0;;;;4,0;20,0;;1,0;3,0;;8,0;4,0;1,0;20,0;;;;3,0;33,0;9,0;;;;;4,0;9,0;;;;;;34,0;;5,0;;;;;;;;;;;2,0;4,0;1,0;;;5,0;8,0;1,0;;;;1,0;2,0;;16,0;;;3,0;;2,0;8,0;;;;;3,0;2,0;;;;;3,0;;1,0;18,0;;;;;;;4,0;;1,0;;3,0;4,0;;;;;;;1,0;;;;1,0;;10,0;1,0;11,0;;;2,0;;;7,0;;1,0;;;;;;;;;4,0;;1,0;17,0;;;1,0;;3,0;;;3,0;1,0;3,0;8,0;1,0;;19,0;;5,0;4,0;1,0;;;;;;;1,0;;3,0;;;4,0;6,0;;1,0;1,0;;;;;;4,0;4,0;;;2,0;;;;3,0;2,0;;;;;3,0;;57,0;;;3,0;;;4,0;;2,0;1,0;;17,0;1,0;1,0;;1,0;;;;;;9,0;1,0;;;;;;;;;;1,0;;;;1,0;;;;2,0;;;2,0;7,0;3,0;;;;;;;;;8,0;;;;;;6,0;;;1,0;1,0;;;2,0;6,0;;1,0;;;;;;;2,0;9,0;;;;1,0;;;;3,0;;6,0;1,0;;;;;;;;;2,0;16,0;;;;;;;;;;;;;;;;;;;;;;1,0;;;3,0;;;;;;;3,0;1,0;2,0;;;;2,0;1,0;;;;;;;;;2,0;;;;;10,0;;;;;1,0;2,0;3,0;;11,0;1,0;;;2,0;4,0;1,0;;;2,0;;;;1,0;1,0;;;2,0;;5,0;;;1,0;;;;2,0;;;;;;;;3,0;;;2,0;;;2,0;1,0;;;1,0;;;;;2,0;;4,0;;;1,0;;19,0;;1,0;;1,0;;;1,0;;;;;;;;;;;;;3,0;;;;;;;3,0;1,0;;2,0;2,0;;;;;1,0;;;;;1,0;;;;;;;;;;;;;;2,0;;;;8,0;;;;;1,0;;1,0;1,0;;;1,0;6,0;;;;;1,0;;1,0;;;;;;1,0;;;;;;;4,0;1,0;;;;;19,0;;1,0;;;;;1,0;;;;;6,0;;;;;;;3,0;;;1,0;;;;;;;;;2,0;;;2,0;;;;;1,0;2,0;1,0;;;1,0;;;;;1,0;;;;;;;;;;;1,0;2,0;;;;3,0;;;;;;;;;;;;1,0;;;;1,0;8,0;;;;;12,0;;;;;;2,0;;;;;;;;;;;;1,0;;;;2,0;;;;;;;;;;;3,0;;;;;;;;;;1,0;;;;;2,0;3,0;;;;;;;3,0;;;;;;;;4,0;;;;;;6,0;;;;;;;;;;;;;;1,0;;;2,0;;;;;;2,0;;;;;;;;;;;;;;;;;;;;;;;;;;;;;;;;;1,0;;;;14,0;;;;;;;;;;;;;2,0;;;1,0;;;;2,0;;;;;;3,0;;;;;1,0;;;;;;;;;2,0;;;;;;;;;;;;;;;;;;;;;;;;;;;;;;;;;;;;;;;;;;;4,0;;;;;3,0;1,0;;;;;;;;;;;;;;;;;;;;;;;1,0;2,0;;;;;;;;;;;;;;;;;;;;;;;;;;;;;;;;;;;;;;1,0;;;;;;;;;;;;1,0;;;;;;;;;;;;;;;;;;;;;;;1,0;;;
write;;;;;;;;5,0;13,0;10,0;;;1,0;;;3,0;;;;;;4,0;;;2,0;;2,0;1,0;;;2,0;;8,0;;9,0;4,0;;2,0;;;50,0;;1,0;;1,0;;1,0;17,0;2,0;9,0;;;;;;;4,0;;1,0;1,0;;2,0;;5,0;;;;;2,0;;4,0;;1,0;1,0;;;1,0;;;87,0;;;;23,0;;3,0;;;;;5,0;;;;4,0;10,0;53,0;2,0;6,0;;4,0;;2,0;23,0;;;;11,0;3,0;;;4,0;;3,0;;12,0;1,0;;;3,0;;;5,0;12,0;4,0;4,0;;;;;;3,0;1,0;;;;;2,0;;;;;;4,0;;;;15,0;27,0;1,0;2,0;;16,0;6,0;2,0;;7,0;;;5,0;;;57,0;;;;;1,0;;;;;;;3,0;;;1,0;;;12,0;1,0;;;;2,0;1,0;;;;;;;6,0;;;;;;;;;;;1,0;;;;;1,0;;;;;;;;;;1,0;;;;;;;;;;;1,0;;;;;;;;;;;;;;;;;;6,0;2,0;2,0;;;;;3,0;2,0;;;;;;;;1,0;;;;;;;;3,0;;;;;1,0;;4,0;;;4,0;;;8,0;;2,0;;;;;;;;;;;;;;2,0;;;1,0;;;;;;;;;;;;;;;;;;;;;;;;;;;;;;;;;;;;;;;;;1,0;;1,0;4,0;;;;;1,0;;1,0;;3,0;;3,0;1,0;;;;;;;;;;;;;;;;;;;3,0;;;;;1,0;;;;;5,0;;;;;3,0;;;1,0;;;;;3,0;;;;3,0;;;;4,0;1,0;;;;;;;;;;1,0;;;;;;;;;;4,0;;10,0;;;;;;;;2,0;3,0;;;;7,0;;;;;;;;3,0;19,0;;;;1,0;;;2,0;;;;;;;;;;;;5,0;;2,0;;;;;;;;;;;;2,0;8,0;1,0;;2,0;1,0;;;;;1,0;;;;;4,0;6,0;;;;16,0;;;;;;;;;;;;;;;;;;;;3,0;5,0;;;;;;;1,0;;;;1,0;;;;;;;3,0;;;;;;;;1,0;;;;;;;8,0;;;;;;;;2,0;;;;;2,0;;;;;2,0;;;;7,0;;;;;;;1,0;;;;;;;;;;2,0;;;;;1,0;;;;;;2,0;;;2,0;;;;;;1,0;;;;;;;;;11,0;;;;;;;;;;1,0;;;;;;;;1,0;;;;;;;;;;;;;1,0;;;3,0;;;;;;;;;;;;;;;;;;2,0;;;;2,0;;2,0;;;;;;;;;;;;;;;;;;2,0;1,0;;;;;;;;;;;;;16,0;;;;13,0;;;;;;;;;;;;;;;;;;;;;;;;;;;;;;;1,0;;;;4,0;;;;;;;;;;;;;;2,0;;;;;3,0;;;;;;;2,0;;;;2,0;3,0;;;;;;;;;;;;;;;;;;;;;5,0;;;;;;;;;;;;;;;;;;;;;;;;;;;;;;;;;;;;;;;;5,0;1,0;;;;;;;;;;;;;;;;;;;;;;;;;;;;;;;;;;;;;;;;;;;;;;;;;;;;;;;;;;;;;;;;;;;;;;;;;2,0;;;;;;;6,0;;;;;;;;;;;;;;;;2,0;;;;;2,0;;;;;;;;;;;;;1,0;;;;;;;;;;;;;;;;;;;;;;;;;;;;;;;;;
conditional;;;;;;;;;4,0;;;;;;2,0;;;;;;;2,0;;;;;;;;;;;;;;;;;;1,0;;;;;;;;;;;;2,0;;;;;7,0;;;;;;;;;20,0;3,0;6,0;;;;;;;;6,0;;;;6,0;;42,0;;;;1,0;;;;;81,0;;4,0;;;;;;1,0;;;;13,0;5,0;;;17,0;;;;;;;;;;;10,0;1,0;;;;;;;;;;;;;;;;;;1,0;;;129,0;;;;;;;;10,0;;;;;;;;;26,0;;;;;;;;;;;;;;2,0;;;;;;;1,0;;;;;;;;;;;;;;;;;;;;;;;;;;;;;;;;;;;;;;;;;;;;;;;;;;;;;;;;;1,0;1,0;;;;;;;;;;;;;;;;;;;;;;;;13,0;;;;;;;2,0;;;;;;;;;;;;;1,0;;;;;;;4,0;;;;;;;;;;;;;;;;;;;;;;;;;1,0;;;;;;;;;;;;;;;;;;;;;;;;;;;;;;;;;;;;;;;;;;;;;;;;;;;;;;;;;;;;;;4,0;;;;;;;;;;;;;;;;;;;;;;;;;;;;;;;;;;;;;;;;;;;;;;;;;;;;;;;;;;4,0;;;;;;;;;;;;;;;;;;;;;;;;;;;;;;;;;;;;;;;;;;;;;;;;;;;;;;;;;;;;;;;;;;;;;;;;;;;9,0;;;;;;;;;;;;;;;1,0;;;;;;;;;;;;;;;23,0;;;4,0;;;;;;;;;;;;;;;;;;;;;;;;;;;;;;;;;;;;;;;;;;;;;;;;;;;;;;;;;;;;;;;;;;;;;;;;;;;;;;;;;;;;;;;;;;;;;;;;;;;;;;;;;;;;;;;;;;;;;;;;;;;;;;;;;;;;;;;;;;;;;;;;;;;;;;;;;;;;;;;;;;;;;;;;;;;;;;;;;;;;;;;;;;;;;;;;;;;;;;;;;;;;;;;;;;;;;;;;;;;;;;;;;;;;;;;;;;;;;;;;;;;;;;;;;;2,0;;;;;;;;;;;;;;;;;8,0;;;;;;;;2,0;;;;;;;;;;;;;;;;;;;;;;;;;;;;;;3,0;;;;;;;;;;;;;;;;;;;;;;;;;;;;;;;;;;;;;;;;;;;;;;;;;;;;;;;;;;;;;;;;;;;;;;;;;;;;;;;;;;;;;17,0;;166,0;;;;;;;;;;;;;;;;;;;;;;;;;;;3,0;;;;;;;;;;;;;;;;8,0;;;;;;;;;;;;;;;;;;;;;;;;;
impurity;;;;;;;;;4,0;3,0;;;;;;;;;;;;;1,0;9,0;;14,0;;;;;;;;;1,0;;;;;;;;;2,0;;2,0;;20,0;;;;;;;;;3,0;;;;;;;;;;1,0;27,0;;;;;;;;1,0;;;;2,0;3,0;4,0;;8,0;1,0;;;;;;;;;10,0;;;;;3,0;;;;2,0;;;;;1,0;;;;;7,0;;;1,0;6,0;5,0;;1,0;;;;;;;;;;;;;;1,0;;;;;;;;;;3,0;;;;;1,0;;;1,0;2,0;;;;;;;1,0;;;2,0;;;;;;;;;;;3,0;;;;;12,0;;;;;;1,0;;;;;;;;;3,0;;3,0;;;;4,0;;;;1,0;;;;;;1,0;2,0;;;7,0;;;;1,0;;;3,0;;;;;;49,0;;1,0;;;;;;;;;;;;2,0;;2,0;;;2,0;6,0;;9,0;;;;;;;;;;;;;;;;37,0;;;;;;;;1,0;;;;;1,0;14,0;14,0;;;;;;;;;;;;;;;;;;;1,0;;;;;;;;;;;6,0;;1,0;;;;;;;;;;;;;;;;;;;;;;;;;;;;;;;;;;;;;;1,0;1,0;;;;;;;;;;1,0;;;;;;;;;;;;;;;;;;;;;;;;;;;;;;;;;;;;;;;;;;;;;;;;;;2,0;;;;;;;;;;;;;;;;;;;;;;;;;;;;;;;;;;;;;;;;;;;;;;;;;;1,0;;;;;;;;;;;;;;;;;;;;;;;2,0;;;;;;;;;;;;;;;;;;;;;;;;;;;;;;;;;;;;;;;;;;;;;;;;;;;;;;;;;;;;;;1,0;;;;;;;;;;;;;;;;;;;;;;;;;;;;;;;;;;;;;;;;;;;;;;;;;;;;;;;;;;;;;;;;;;;;3,0;;;;;;;;;;;;;126,0;;;;;;;;;;;;;;;;;;;;;;;;;;;;;;;1,0;;;;;;;6,0;;;;;;;;;;;;;;;;;;;;;;;;;;;;1,0;;;;;1,0;;;;;;;;;;;;;;;;;;;;;;;;;;;;;56,0;2,0;;;;;;;;;;1,0;;;;3,0;;;;;;;;;;;;;;;;;73,0;;2,0;;;;;;;;23,0;;45,0;5,0;;;4,0;;;;;4,0;;;1,0;;;;;;;;;;2,0;;;;;;;;;;;;;;;;;;;;;;;;;;;;;;;;;;;;;;;;;;;;;;;;;;;;;;;;;;;;;;;;;;;;;;;;;;;;;;;;;;;;;;;;;;2,0;;;;;;;;;;;;;;;;;;;;;;;;;;;;;;;;;;;;;;;;;;;;;;;;;;;;;;1,0;;;;;;;;;;;;;;;;;;;;;;;;;;;;;;;;;;;;;;;;;;;;;;;;;;;;;;;;;;;;;;;
retract;;;;;;;;;1,0;;;;2,0;;30,0;1,0;;;;;;;;;;;;;;;;4,0;38,0;;5,0;10,0;;;;;;;;;8,0;;;4,0;;;;3,0;;;1,0;;;;;;56,0;3,0;;;2,0;;;3,0;3,0;3,0;;;;;;46,0;;;1,0;22,0;;2,0;;9,0;;;;;;3,0;77,0;;;;;;;;1,0;;;;;;;;62,0;;10,0;;;;;;;13,0;10,0;200,0;;;;;;;;;;;;2,0;;4,0;1,0;;;;;;;;;;;;;1,0;;4,0;;;;;;;;;15,0;;4,0;;;;51,0;;;;;23,0;;1,0;1,0;;;;;;21,0;1,0;3,0;;;15,0;;;;;;;;;;;;2,0;;2,0;;;;1,0;;;;3,0;;;;;;;;;1,0;;;;;;;;21,0;;;;;;;3,0;15,0;;15,0;;84,0;7,0;41,0;16,0;3,0;7,0;;;;;;39,0;;;;;;5,0;4,0;;;;2,0;;1,0;9,0;;;;;;3,0;;;;;10,0;;5,0;;;;;;;1,0;;3,0;1,0;;8,0;3,0;;6,0;;;;;1,0;;;;7,0;;5,0;;;;4,0;6,0;;;;;6,0;1,0;;;;;;;;;;;;;18,0;;;;;;2,0;;;15,0;;;;;;;;2,0;5,0;;;;7,0;;;;;2,0;5,0;;;1,0;;;;2,0;1,0;;13,0;;;5,0;;;3,0;;;;1,0;;;3,0;;;1,0;;;5,0;14,0;6,0;;;;;;;1,0;;;2,0;;;;1,0;;;;;;;;;;2,0;;;;;;;;;;;;;;;;;;2,0;;;;;;;;;;;;2,0;;;;;3,0;;;2,0;;;;;3,0;;;;12,0;;;;;3,0;;;;;;;;;;;;;;;;3,0;;;;;;;;;;;;;;;;;;;;;;;;;3,0;;;;5,0;;;32,0;;;;;;;;;;;;;;;27,0;1,0;;;1,0;;;;;1,0;;;;;1,0;;;1,0;;;;;;;;;;;;;;2,0;;;;;;;;;17,0;;;;;;;;;6,0;;;;;;14,0;;5,0;;2,0;;;;;;;;;;;2,0;;;;;;;;;;;;2,0;;;;;1,0;;;;;;;;;1,0;;;;;;;;;;;;;;;;;;;;;;;4,0;;;;;1,0;;;;;14,0;;;;;;;;;;;;;;;;;;;;;;2,0;;1,0;;;;;;;2,0;;;2,0;;;;;;;;;;;;;;2,0;;;;;;;;;;1,0;;;;;;;;;;;;;14,0;;;1,0;;;;;;;;;;;;;;;;1,0;;;;;;;;;;;;;;;;;;;;;;;;;;;;;;;;;;;;;;;;;;;;;;;2,0;;;;;;;;;;;;;;;;;;;;;;;;;;;;;;;;;;;;;;;;;;;;;1,0;;;;3,0;;;;;;;;;;;;;;;;5,0;;;;;;;;;;;;;;;;;;;;;;;;11,0;;;;;;2,0;;;;;;;;;;;;;;;;;;;;;;;3,0;;;;;;;;1,0;;;;;;;;;;;;;;;;;;;;;;;;;;;;;;;;19,0;;;;;;;;;;;;;;;;;;;;;;;;;;;;;;;;;;;;;;;;;;;;;;;;;;;;;;;;;
amplify;;;;;;;;;;8,0;1,0;;;;6,0;12,0;;;1,0;;;2,0;;9,0;;;;;;1,0;;;6,0;;17,0;;;;;;7,0;;3,0;;2,0;2,0;2,0;16,0;2,0;;;;;12,0;;;11,0;;;;4,0;;;;;;;;;2,0;;;14,0;8,0;;2,0;;;;7,0;;11,0;;26,0;;;;;;;;;;;4,0;;8,0;;8,0;;;;4,0;;;6,0;16,0;;38,0;;;2,0;;;2,0;4,0;45,0;;;4,0;;;;2,0;;;;;;1,0;;3,0;;;;;7,0;;;;;;16,0;;;;;1,0;144,0;;;;;;;1,0;2,0;;1,0;15,0;;4,0;153,0;1,0;;;11,0;;;;;;;1,0;2,0;;;;;;;;;;21,0;30,0;;;;;;22,0;;35,0;;1,0;;;;;;;;;;;8,0;;;;18,0;;4,0;12,0;;;;;;;;;;;;;4,0;4,0;6,0;;4,0;;;;;;;;;;;;;;;14,0;21,0;;40,0;;;;;;;43,0;2,0;;;;;;;;7,0;;;;;;;20,0;;;;;;;5,0;4,0;1,0;;10,0;;;2,0;;;;;;2,0;;;;;;;;;;;;;;;;;;;;;;;;1,0;;;;2,0;;;;;3,0;;;;;;;;;;;;4,0;;8,0;;;;;1,0;;;;7,0;2,0;;;;;2,0;;;;2,0;;;;;;;;;;;;4,0;2,0;;;;;;;;;;;;;;;3,0;;;;;1,0;;;;;1,0;;;;;;;;;;;;;;;;;1,0;;;;;;;;;;;1,0;;2,0;;;;;;41,0;4,0;;;;;;;;;;;;;;;;;1,0;;;;;;;;;1,0;;3,0;;;;;;;;1,0;;;;;;;;;;13,0;;;;;;;;;;;;;;;;;;;;;;;;;;;;;;8,0;;;;;;;;;;;;;;;;;;;;;;;;;;;;;;;;;;;;;1,0;;;;13,0;;;;;;;;;;;;;8,0;;;;;;;;2,0;;;;;;;;;;;;;4,0;;7,0;;;;;;;;;11,0;;;;2,0;;;;;;;;;;;;;;;;;;;;;;;;;;;;25,0;6,0;;;16,0;;;;;;2,0;;;;;;;;;;;;;;5,0;;;;;;;;;;;;;;29,0;;;;;;16,0;;;;;;;;;;;;;;;;;;;;;;;;;;;19,0;;;;;;;;;;;;;;;;;;;;;;;17,0;25,0;;;;4,0;;1,0;;;;;;;7,0;;;;;;;1,0;;;;;;;;;;;;;;1,0;;;;19,0;;18,0;;15,0;;;;5,0;;;18,0;17,0;;;22,0;;;;;;12,0;10,0;;;;;;;;;;;83,0;;;16,0;;;;;;;;;;;;;;;;9,0;;;;1,0;;;;;;;1,0;;;2,0;;;;;;;;;;;;;;;;;;;;;;;;;;;;;2,0;;;;;;;;;;;;;;;;;;;;;;;;;;;;;;;;;;;;;;;;;;;;;;;;;;;;;;;;;;;;;;;;;;;;;;;;;1,0;;;;;;;;;;;;;;;;;;;;1,0;1,0;;;;;;;;;;;;;;;;;;;;;;;;;;;;;;;2,0;;;;;;;;;;;;;;;;;;;;
bobbin;;;;;;;;;;7,0;;;;;3,0;20,0;;;;;;;;11,0;;;;;;;;;14,0;;;;;;;;;;;;;;;7,0;;;21,0;1,0;;;5,0;;;;;;;;;;;;;14,0;2,0;;;;1,0;;;;;;;3,0;;;;25,0;;;;;4,0;;25,0;;;;;;;;;;;;15,0;2,0;;;;;;;;;;;;1,0;25,0;9,0;;;8,0;;;;;;;;;;;;;;;;;1,0;;;;;;3,0;;;;10,0;;1,0;;;;;;;;;12,0;;;;11,0;;;;;;;;;;3,0;;;;8,0;7,0;;;;14,0;;;;;;;;;;;;;;3,0;;;;4,0;;;;4,0;;14,0;;;;9,0;;;3,0;;;;;;;;4,0;;2,0;;;1,0;;;;;26,0;;;3,0;;5,0;3,0;;3,0;10,0;;;;;;;;;;;;;;;;;3,0;;;;;;;;;;4,0;2,0;;;;;3,0;;;16,0;;;;17,0;;;;1,0;1,0;;;;;;;2,0;;;;;;;1,0;;25,0;;4,0;11,0;;;;2,0;1,0;;;;;2,0;;;;;;23,0;;;;;10,0;;;;;;;;5,0;;;;;;;9,0;;;3,0;;;;;;2,0;;9,0;3,0;;;;2,0;;1,0;;;;;;2,0;;;;;;;;;;;2,0;;;;;;9,0;;;;;;;;;23,0;;;;;13,0;;;;;;;;;;;;;;;;;;;;;;;;;;;;;;;;;;;;;;;;;;;;;;;;8,0;;;;;;;;;;;;;;;;;;;;;;;;;;;;;;;;;;;;;;;;;1,0;;;;;;;;;;;;;;;;;;;;;;;;;;;;;;;;;;;;;;;;;;;;;;;;;;;;;;;;;;7,0;;;;;;;;;;;;;;;;;;;;;;;;;;;;1,0;;;;;;;;;;;;;;;;;;;;;;;;7,0;;;;;;;;;;;;;;;;;;;;;;;;;;;;;;;;;;;;;;;;;;;;;;;;;;;;;;;;;;;;1,0;;;2,0;;;;;;;;;;;;;;;;;;;;;;;;;;;;;;;;;;;;;;;;;;;;;;;;;;;;;;;;;21,0;;;;;8,0;;;;;;;62,0;2,0;;;;;;;;;;;;;;;;;;;;;;;;;;;;;;;;;;;;;;;;;;;;;;;;;;;;;;;;;;;;;;;;;;;;;;;;;;;;;;;;;;;;;;;;;;;;;;;;;;;;;;;;;;;;;;;;1,0;;;;;;;;;;;;;;;;;;;;;;;;;;;;;;;;;;;;;;;;;;;;;;;;;;;;;;;;;;;;;;;;;;;;;;;;;;;;;;;;;;;;;;7,0;;;;;;;;;;;;;;;;;;;;;;;;;;;;;;;;;;;;;;;;;;;;;;;;;;;;;;;;;;;;;;;;;;;;;;;;;;;
chain;;;;;;;;;;6,0;;;;;2,0;1,0;11,0;;;;;;;;;;;3,0;;;;;2,0;;2,0;1,0;;;;;;;;;;;;1,0;3,0;;2,0;;;;3,0;;;;;;;;;;;;;5,0;;;;;;;;;;;;;;;;6,0;;;;;;;;;;;;;;;;;;;2,0;;;;;;;;;1,0;;;;1,0;;;;;;;;;;;;;;;;;;;;;;;;;;;;1,0;;;;;;;;;;;;;5,0;;;1,0;;;;;;;;;;;;;;3,0;3,0;;;;;;;;;;;;;;;;;;;16,0;;3,0;;;;2,0;;;;;;;4,0;;;;;;;;;;;;;;2,0;;;;;2,0;;;;;;;;3,0;;;;;;;;;;;;;;;;;4,0;;;;;;3,0;;;;;;;;;;;;;;;;;;;;;;;;;;1,0;;;;;;;;;;;;;;;;15,0;;;1,0;;;;;;;;;;;;;;;;;;;;;;;6,0;;2,0;;;;;;;;;;;2,0;;;;;;;;15,0;1,0;3,0;;;;;;;;;;;;;;;2,0;;;;;;;;;;;;;;1,0;;1,0;;;;;;;2,0;;;;;1,0;;;;;;1,0;;;;;;;;;;;;;;1,0;;;;;;;;;;;;;;;;;;;;;2,0;;;1,0;;;;;;;;;;;;;;;;;;;;;;;;;;;;;;;5,0;;;;1,0;;;;;;;;;;;;;;;;;;;;;;;;;;;;;;;;;;;;;;;;;;;;;;;;;;;;;;;;;;4,0;;;;;;;;;;;;;;;;;;;;;;;;;;;;;;;;;;;4,0;;;;;;;;;;;;;;;;;;;;;;;;;;;;;;;;;;;;;;;;;;;;;;;;;;;;1,0;;;;;;;;2,0;;;;;;;;;;;;;;;;;;;;;;;;;;;;;;;;;;;;;;;;;;;;;;;;;;;;;;;;;;;;;;;;;;5,0;;5,0;;;;;;;;;;;;;;;;;;;;;;;;;;;;;;;;;;;;;;;;;;;;;;;;4,0;;;;;;;;;;;;;;;;;;;;;;;;;;;;;;;;;;;;;;;;;;;2,0;;;;;;;;;;;;;;;;;;;;;;;;;;3,0;;;;;;;;;;1,0;;;;;;;;;;;;;;;;;;;;;;;;;;;;;;;;;;;;;;;;;;;;;;;;;;;;;;;;;;3,0;;;;;;;;;;;;;;;;;;;;;;;;;;;;;;;;;;;;;;;;;1,0;;;;;;;;;;;;;;;;;;;;;;;;;;;;;;;;;;;;;;;;;;;;;;;;;;;;;;;;;;;;;;;;;;;;;;;;;;;;;;;;;;;
permanent;;;;;;;;;;12,0;;;2,0;;3,0;13,0;;4,0;;;;1,0;;;;;;;;;;;9,0;;;;;4,0;;;;;1,0;;1,0;;;8,0;;;19,0;1,0;;;10,0;;5,0;;;;1,0;2,0;7,0;;;1,0;1,0;7,0;9,0;;;;17,0;;;4,0;;;;6,0;;1,0;;8,0;;;;;1,0;;8,0;;;1,0;;;1,0;;5,0;;;;12,0;1,0;;2,0;3,0;;1,0;;2,0;1,0;;;;28,0;20,0;17,0;;;1,0;;;;;;;;;;;;2,0;;;;5,0;;;;;;;6,0;;;;7,0;;;;;;1,0;;;4,0;;;3,0;;;1,0;;;;;1,0;;;;;;1,0;;;1,0;1,0;;;;1,0;;1,0;;;;;2,0;;;;;3,0;;;;;3,0;;1,0;;;13,0;;;;;;30,0;;;23,0;;;;;;;2,0;7,0;;9,0;;;;;3,0;;;10,0;3,0;;4,0;2,0;2,0;2,0;;3,0;8,0;;;;;;;;;;1,0;6,0;;;;;;5,0;;;;;;;2,0;;;5,0;5,0;8,0;;;1,0;3,0;;;1,0;;;1,0;1,0;;;1,0;;;;;;;;;;2,0;;1,0;;;;;;5,0;;3,0;1,0;;2,0;;;4,0;;;;;3,0;;;;;;1,0;;;;;11,0;;;;;;;1,0;;;;;;;6,0;5,0;;;1,0;;1,0;;;4,0;;;;1,0;;;;1,0;;;;;;;;;;;;;4,0;;;;;;2,0;;6,0;;1,0;;;;1,0;;;;;;;8,0;5,0;;;4,0;;;;;;;;;;;;;;;;;;;;;;;;;;;;;;;;;;;;;;;;;2,0;;;;;;;1,0;3,0;;;1,0;;;;;;;;;;;;;;;;;;;;;;;;;;;;;;;;;1,0;;;1,0;;2,0;;;;;;;;;;;;;;;;;2,0;;;1,0;;;;;;;;;;;;;;;;;;;;;;;;;;;;;;;;;;;;;;241,0;;;;;;;;;;;;;;;;;;;;;;;;;;;;;;;;;;;;;;;;2,0;;;;;;;;;;;;3,0;;;;;;;2,0;;;;;;;;;;1,0;;;;;;;;;;;;;;;;;;;;;;;;;;;;;;;;;;;;;;;8,0;;;;;;;1,0;;;;;;;2,0;;;;;;1,0;;;;;;;;;;;;;;;;;;1,0;;;;;;;;;;;;;;;;;;;;;;;;;;3,0;;;;;11,0;;;;;;;30,0;;;;;;;;;;;;;;1,0;;;;;;;;;;;;;;;;;;;;;;;;;;;;;;;;;;;;1,0;;2,0;;;;;;;;;;;;;;;;;;;;;;;;;;;;;;;;;;;;;;;;;;;;;;;;;;;;;;;;;;;;;2,0;;;;;;;;;;;;;;;;;;;;;;;;;;1,0;;;;;;;;;;;;;;;;;;;;;;;;;;;;1,0;;;;;;;;;;;;;;;15,0;;;;1,0;;;;;1,0;;;;;;;;23,0;;;;;;;;;;1,0;;;;;;;;;;;;;;;;;1,0;;;;;;;;;;;;;;;;;;;;;;;;;;;;;;;;;;;;;;;;;;;;;;;;
rotor;;;;;;;;;;2,0;;;;;4,0;;;;;;;;;;;;;;;;;;2,0;;4,0;2,0;;;;;;;;;;;;13,0;;;11,0;;;;11,0;;7,0;;;;4,0;;;;;1,0;;1,0;;;;;7,0;;;4,0;;;;;;6,0;;3,0;;;;;;;;;;2,0;;;;;;1,0;;;;2,0;;;5,0;;30,0;;;;;;2,0;;25,0;4,0;;;;;;;;;;;;;;;;;;;2,0;;;;;;;2,0;;;;6,0;;;;;;;;;2,0;;;;;;;;;;;;;;;;;;;;;;;;1,0;;;;;;;;;;;;;8,0;;;;;;2,0;7,0;;;2,0;4,0;;1,0;;;4,0;;;11,0;;;;;;2,0;2,0;2,0;;;;;;;;;;24,0;;;;;;12,0;;2,0;;;;4,0;;;;;;;;;;;;;;4,0;;;;;;;4,0;;;;;3,0;;;2,0;;;;;;;;4,0;;;;;8,0;;;;;;;;;;;;;;;;6,0;;3,0;;;;;4,0;;3,0;;;;4,0;4,0;;;;;;7,0;;;;3,0;;3,0;;;;;;;;;;;;;;;;1,0;;;1,0;;3,0;1,0;;;1,0;;1,0;;;;;;;;;;;;;;;;;;;;;;;;10,0;10,0;;;;;8,0;;;;;;;2,0;;;;;;;;;;;;;;;;;;;;;;;;;;;;;;;;;;;;;;;;;1,0;;;;;;;;;;;1,0;;;;;;;;;;;;;;;;;;;;;4,0;;;;;;;;;;;;;;;;;;;;;;;;;;;;;;;;;;;;;;;;;;;;;;;;;;;;;;;;;3,0;;;;;;;;;;;;;;;;;;;;;2,0;;1,0;;;;;;;;;;;;1,0;;;;;;;;;;;;;;;;;;;;;;;;;;;;;;;;;;;;;;;;;;;;;;;;;;;;;;;;;;;;;;;;;;;;;;;;;;;;;;;;;;;;;;;;;;;;;;;;;;;;;;;;;;;;5,0;;;;;;1,0;2,0;;;;;;;2,0;;;;;;;;;;;;;;;;;;;;;;;;;;;;11,0;;;;;2,0;;;;;;;;19,0;1,0;;;;;;13,0;;;;;;;;;;;;;;;;;;;;;;;;;;;;;;1,0;;;;;;;;;;;;;;;;;;;;;;;;;;;;;;;;;;;;;;;;;;;;;;;;;;;;;;;;;;;;;;;;;;;;;;2,0;;;;;;;;;;;;2,0;;;;;;;;;;;;;;;;;;;;;;;;;;;;;;;;;;;;7,0;;;;;;;;;;;;;;;;;;;;3,0;;;;;;;;;;;;;2,0;12,0;;;;1,0;;;;;;;;;;;;;;;;;;;;;;;;;;;;;;;;;;;;;;;;;;;;;;;;;;;;;;;;;;;;;;;;;;;;;;;;;;;;;;;;;;;;;;;;
sign;;;;;;;;;;1,0;;;;;;2,0;1,0;;;;;;;;;;;;;;;;;;;;;;;;2,0;;;;1,0;6,0;2,0;2,0;10,0;4,0;;1,0;;;;;34,0;;;;;;;;;;;1,0;;;;;;;;4,0;;1,0;1,0;3,0;;;;;;;;;;2,0;33,0;;;;;;;;11,0;;;;1,0;5,0;;;46,0;;;;;1,0;;;;;;1,0;50,0;1,0;;;1,0;1,0;;;;;;;;;;;;;3,0;;;;;;;;;;;6,0;2,0;;;;;;;;6,0;;;;;1,0;12,0;;;;1,0;1,0;;;20,0;;;;;;;;;;;;;;;;;;;;2,0;;;;;;1,0;;;;;;;;;;;;1,0;3,0;;;;;;;;;;;;;;;;;;;4,0;;;;;;;;;;;6,0;;;;;;;;;;1,0;;;;;;;;;;;;;;2,0;;;;;;;;2,0;;;;;;;;18,0;;;;;;2,0;;;;;;;;;;;;;;;;;2,0;;;;;;;;;;;;;;;;6,0;;;;;;;;;;;;;;;;;;;;;;;;;;19,0;;;;;;;;;;;;;;;;;;;;;;;;;;;;;;;;;;;;;;1,0;;;;;;;;;;;;;;;;;;;;;;;;;;;;;1,0;;;;;;;;2,0;;;;;;;;;;;;2,0;;;;;;1,0;;;;3,0;;;;;;;;;;;;;;;;;;;;;;2,0;;;;;1,0;;;;;;2,0;;;;;;;;;;1,0;;;;;;;;;;;2,0;;;;;;;;;;;;;;;;;;;;;;;;;;;;;;;;;2,0;;;;;;;;;;;;;;;;;;;;;;;;;;;1,0;;;;;;;;;;;;;;;;;;;;;;;;;;;;;;;;;;;;;;;;;;;;;;1,0;;;;;;;;;;;;;;;;;;;;;;5,0;2,0;;;;;;;;;;;;;;;;;;;;;;;;;;;;;;;6,0;;;;12,0;;;;2,0;;;;;;;1,0;;;;;;;;;;;;;;;;;;;;;;;;;;;;;;;;;;;;;;;;;;2,0;;;;;;;;;;;;;;;;;;;;;;1,0;;;;2,0;;;;;1,0;;;;;;;;;;;;;;;;;;;;;;;;;;;;;;;;;;;;;;;;;;;;;;;;;;;;;;;;;;;;;;;;;;;;;;;;;;;;;;;;;;;;;;;;;;;;;;;;;;;;;;;;;;;;;;;;;;;;;;;;;;;;;;;;;;;;;;;;;;;;;;;;;;;;;;;;;;;;;;;;;;;;;;;;;;;;;;;;;;;;;;;;;;;;;;;;;;;;;;;;;;;;;;;;;;;;;;;20,0;;;;;;;;;;;;;;;;;;;;;;;;;;;;5,0;;;14,0;;;;;3,0;;;;;
terahertz;;;;;;;;;;43,0;;;;;;26,0;;;;;;;;;;;;;;;;;55,0;;;;;;;;;;;;152,0;46,0;;144,0;;;;;;;;;;;;;;;;;;;;;;;;;122,0;39,0;;;;;;9,0;;4,0;;1,0;;;;;;;;;;1,0;4,0;;;;;;;;;44,0;;;5,0;;;;;4,0;;;;;1,0;;;;;;;2,0;;;;;;4,0;;;;;;;;;;;;;;1,0;;;;;;;;;;;;;;;;;;;76,0;;;;;1,0;;;;;;;;;;;;;;;;;;;;;;3,0;;2,0;;2,0;;;;;;;;;;1,0;;;;;;;;;;;;;;;;;;;;;;;7,0;;45,0;;;;;;;;;;;;;;;;;;;;;;;;;;;9,0;;12,0;;;;;;;9,0;;;;;;;22,0;;;;;;;;6,0;;;;;;;;;;;;;;;;;;;;;;;;;;;;;;;;;;;;;;;;;;;;;;;;;;;;;;;;3,0;;;;;;;;;;;;;;;;;;;;;;;;;;;;;;;;;;;;;;;;;;;;;;;;;;;;;;;;;;;;;;3,0;;;;;;7,0;;;;;;;;;;;;;;;;;;;;;1,0;;;;;;;;;;;;;12,0;;;;;;;;;;;;;;;;;;;;;;;;;;;;;;;;;;;;;;;;;;;;;;;;;;;;;;;;;;;;;;;;;;;;;;;;;;2,0;;;;;;;;;;;;;;;;;;;;;;;;;;;;;;;;;;;;;;;;;;;;;1,0;;;;;;;;;;;;;;;;;;;;;;;;;;;;;;;;;;;;;;;;;;;;;;;;;;;;;;;;;;;;;;;;;;;;;;3,0;;;;;;;;;;;;;;;;;;;;;;;;337,0;;;;;;;;;;;;;;;;;;;;;;4,0;;;;;;;;;;;;;;;;;;;;;;;;;;;;;;;;;;;;;;;;;;;;22,0;;;;;;;;;;;;;;;;;;67,0;;;;;;;;;;;;;;;;;;;;;;;;;;;;1,0;;;;;;;;;2,0;;;;;;;;;;;;;;;;;;;;;;;;;;;;;;;;;;;;;;;;;;;;;;;;;;;;;;;;;;;;18,0;;;;;;;;;;;;;;;;;;;;;;;;;;;;;;;;;;;;;;;;;;;;;;;;;;;;;;;;;;;;;;;;;;;;;;;;;;;;;;;;;;;3,0;;2,0;;;;;;;;;;;;;;;;;;;;;;;;;;;;;;;;;;;;;;;;;;;;;;;1,0;;;;;;;;;;;;;;;;;;;;;;;;;;;;;;;;;;;;
freedom;;;;;;;;;;;;;;;2,0;;1,0;;;;;1,0;1,0;;;;;;;;;;2,0;;;;;1,0;2,0;;;;;;;;1,0;4,0;;;1,0;;;;;;;;;;;;;;;;;;;;;;;;;4,0;;;1,0;3,0;;10,0;;4,0;;;;;;;6,0;2,0;;1,0;;;;;11,0;;;;;;;;2,0;;;;1,0;;;;;;2,0;7,0;;;;;;;;;;;;;;;1,0;;;;4,0;1,0;;;;;;;;;;;;;;;;1,0;;;4,0;;2,0;;;;;;;;1,0;;;;;;;;;2,0;2,0;;;;;1,0;;;;;;1,0;;;1,0;;;1,0;;;;;;;;;;3,0;;;;;;1,0;1,0;;;;;;;;;;;;1,0;;;;;;1,0;;;;;1,0;;3,0;26,0;;;;;;;;;;;;;;;;;;;;3,0;;;;;;;3,0;;;;;;;3,0;;;;;3,0;;;;;;;;;;;1,0;;;;;1,0;;;;;1,0;;;;;;;;;;3,0;;;;;;;;;1,0;;;;;;;;;;;;;;;;;;;;;;3,0;;;;;;;2,0;;;;;;;;;;;4,0;;;;1,0;;;;;;;;;;;;;;;;;;;;4,0;;;;;;;;;;4,0;;;;;;;;;;;;;;;;;;11,0;;;;;;;;;;;2,0;;;;;;;;;;;;;;;;;;;;;;;8,0;1,0;;;2,0;;;;;;;;;;;;;;;;;;;;1,0;;;;2,0;;;;;;;;;;;;;;;;;;;;;;;;;;1,0;;;;;4,0;;;;;;;;;;;;;;;;;;;;;;1,0;;;;;;;;;;;;;;;;;;;1,0;1,0;;;1,0;;;;;;;;;;;;;;;;1,0;;;;;;;;;;;;;;;;;;;;;;;;;;;;;;;;;;;;;;;;;;;;;;;;;;;;;;;;;;;;;;;;;;;;;;;;;;;;;;;;;;;;;;;;;;;;;;;;;;;;;;;;;;79,0;;;;;;;;;;;;;;;;;;;;;;;;;;;;;;;;;;;;;;4,0;;;;;;;;;;;;;;;;;;;;1,0;;;;;;;;;;;1,0;;;;;;;;;;;;;;;;;;;10,0;;;;;;;;;;;;;;;;;;;;;;;;;;;;;;;;;;;;;;;;;;;;;;;;;;;;;;;;;;;;;;;;;;;;;;;;;;;;;;;;;;;;;;;;;;;;;;;;;;;;;;;;;;;;;;;;;;;;;;;;;;;;;;;;;;;;1,0;;;;;;;;;;;;;;;;;;;;;;;;;;;;;3,0;;;;;;1,0;;;;;;;;;;;;;9,0;;1,0;;;;;;;;;;;;;;;;;;;;;;;;;;;;;;;;;;;;;;;;;;;;1,0;;;;;;;;;;;;;;;;;;
patch;;;;;;;;;;;;;;;1,0;4,0;;;;;;;;;;;37,0;;;;;;4,0;;;;3,0;1,0;;;4,0;;;10,0;;;4,0;9,0;;;;;;;;;;;2,0;;;;2,0;;;;;;2,0;;;;;;;;;;;52,0;;;;2,0;;;;;2,0;;1,0;;;;;;;;10,0;;1,0;6,0;8,0;;;3,0;;;;;;1,0;;;;6,0;;;;;;;;;;;;;;;;3,0;2,0;;;;;;2,0;;;;;;;1,0;;;;;;;12,0;;;;2,0;;;;;2,0;1,0;;;;;;;;;;;;;;;;9,0;;;;;;;;;;;;;;;;;;;;;;;;4,0;;;;;;;;;;;;;;;;;;;;;;;;;;2,0;;;;;1,0;;;;2,0;;;;;;;;;;;2,0;1,0;;;;;;;2,0;;;;;;;;;;;;;;;4,0;1,0;;;;;;;7,0;;;;;;;;;;;4,0;1,0;;;;;;;;;;;;;;;;;;;;;;;;;;;;;;;;;;;;;;;;;;;;;;;;;;;;;4,0;;;;;4,0;;;;;;;;7,0;;;;;;;;;;;;;;;;4,0;;;;;;;;;;;;;;;;;;;14,0;;;;;;;;;;;;;;;;;5,0;;;;;1,0;;;;;1,0;;;;;;;;;;;;;;;;;;9,0;1,0;;;21,0;;;;;;;;;;;;;;;;;;;;;;;;;;;;;;;;;;;;;;;;;;;4,0;;;;;;;;;;1,0;2,0;;;;;;;;;;;;;;8,0;4,0;;;;;;;;;;;;;;;;;;;;;;;;5,0;;;;;;;;;;;3,0;;;;;;;;;;;;;;;;;;;;;;;;;;;;;;;;;;;;;;;2,0;;;;;8,0;;;;;;;;;;;1,0;;;;;;;;;;;;;;;;;;;;;;;;;;5,0;;;;;;;;;;;;;;2,0;;;;;;;;;;;;;;;;;;1,0;;;;;;;;;;;;;;;;;;;;;;;;;;;;;;;;;;;;;;1,0;;12,0;;;;1,0;;;;;;;;;;;;;;6,0;;;;;;;;;;;;;;;;;;;;;;;;;;;;;;;;;;;;;;;;;;;;;;;;;;;2,0;;;;;;;;;;1,0;;;;;;;;;6,0;;;;;;;;;;;;;;;2,0;;;;;;;;;;;;;;;;;;;;;;;;;;;;;;;;;;;;;;;;;;;;;;;;;;;;;;;;;;;;;;;;7,0;;;;;;;;;;;;;;;;;;;;;;;;;;;;;;;;;;;;;;;;;;;;;;;;;;;;;;;;;;;;;;;;;;;;;;;;;;;;;;;;;;;;;;;;;;;;;;;;;;;;;;;;;;;;;;;;;;;;;;;;;5,0;;;;;2,0;;;;;;;;
ramp;;;;;;;;;;;;;;;;3,0;;;;;;;4,0;;;;;;;;;;27,0;;;;3,0;;;;;2,0;;;3,0;;;4,0;2,0;;;;;;;;4,0;;;;4,0;;;;;;;5,0;;;2,0;;14,0;17,0;;1,0;;;;3,0;;4,0;;5,0;4,0;;;;;1,0;7,0;;4,0;;;;;;4,0;;;;3,0;;;;5,0;;3,0;;1,0;3,0;;;7,0;2,0;24,0;5,0;;12,0;;;1,0;1,0;;;;;;14,0;;131,0;2,0;;;;;;;;;;;;;;;1,0;229,0;;;;;;;18,0;2,0;;;;;;19,0;;5,0;;;;;;;;;3,0;;4,0;2,0;17,0;;;;;;;;;;6,0;;;;;;3,0;;3,0;;;;;;;;;;;2,0;;;1,0;;;2,0;;;;;;;;8,0;;;;;;;;15,0;;;;;;;8,0;;;1,0;;;;;;;;;;20,0;;2,0;;;;;1,0;2,0;;;;;;;;;;4,0;;;;;12,0;1,0;;;;22,0;1,0;;7,0;2,0;;4,0;;;34,0;;;;;5,0;7,0;;;;;;;;2,0;1,0;1,0;4,0;;;;;9,0;3,0;;;4,0;;;;;;;;3,0;;;;;;;;;;;;;;;9,0;;3,0;;;;;;1,0;;7,0;2,0;4,0;;2,0;;;;;;;;;;;;;;;;9,0;;;;;;;;;;;;;;3,0;;;;;;;;;;10,0;1,0;;;1,0;;;;;1,0;;;;;;;;;;;;;3,0;;52,0;;;;;;;;;;;;;;;;;;;26,0;19,0;;;2,0;;;1,0;;;;;;;;;;;6,0;;;;;;;;;;;1,0;;;;;;;;;;;;;;;;;;83,0;;1,0;;;;;;;;;;;;;;;;;;1,0;;;;;;;;;;15,0;;;;;;;;;;;;;;;2,0;;;;;;;;3,0;;;;1,0;1,0;;;;;;;;;23,0;;;;;;;;;;;;;;;;;;;;;;;;;4,0;;;;;;;;;;;;;;;;;;;;;;;;;;;;;2,0;;;;;;;2,0;;;;;;1,0;;;;;;;;4,0;;;;;;;;;;7,0;;;;;;;4,0;;;;;;;;2,0;;;;;70,0;;;;;;;;;;2,0;;;;8,0;;;;;;;;;;;;;;;15,0;;;;;;;;;;;;;;;;;;6,0;;;;1,0;;;;;2,0;;;2,0;;;;;;;;;;;;2,0;;;;;;10,0;;;;;;;;;;;;;;;;;;;;;;;;;;;;;;;;;;;;34,0;;;;;;;;;;;;;;;;;;;;;1,0;;;;;2,0;;;;;;;;;;;;;;;;;;;;;;;;;;;;1,0;;;;;;;;;;;;;;;;;;;;;;;;;;;1,0;;;;;3,0;;;;;;;;;;;;;;;;;;;;;;;;;;;;;;;;;;;;;;;;;;;;;;;;;;;;;1,0;;;;;;;;;;1,0;;;;5,0;;;;;;;;;;;16,0;;;;;;;;;29,0;;;;;;;;;;;;;;;;;;;;;3,0;;;;;;;;;;;;;;;;;;;;;;;;;;;;;;;;;;;;;;;;;;
