;aberration;accessory;achieve;adjust;amount;apparatus;array;assembly;association;attribute;axial;band;barrel;base;blue;brightness;capture;cell;channel;characteristic;chip;circle;color;communicate;communication;compensate;compensation;component;computer;condition;configure;controller;correct;correction;crystal;data;define;degree;depth;design;determine;device;diameter;digital;display;dispose;distortion;element;equation;error;estimate;exit;extend;external;field;focal;form;freedom;frequency;generate;glass;green;group;hardware;image;implement;include;increase;individual;lateral;length;lens;light;liquid;magnification;magnitude;material;measurement;media;memory;method;microlens;mode;model;module;movable;operative;optical;optics;order;parameter;partially;pass;peripheral;photograph;pick;pixel;plane;plurality;point;position;predetermine;prism;process;processing;processor;product;program;property;pupil;reduction;reference;region;remain;removable;representative;resolution;respective;scene;sensor;sequence;shade;signal;size;spectral;store;system;telephoto;test;thickness;time;total;trace;unit;vary;vehicular;view;virtual;zoom;absorb;abut;adjacent;aerial;amplitude;aperture;apply;area;arrange;associate;attach;bias;block;body;bottom;buffer;charge;circumferential;coat;composition;compound;conductive;connect;content;convert;converter;correspondence;couple;cover;decrease;detection;detector;deviation;direct;direction;dome;edge;electric;emit;enable;encoder;energy;equip;expose;face;fastener;film;filter;force;frame;front;gamma;hand;heat;hold;holder;hole;house;incident;inner;insert;insulate;layer;limit;load;measure;medium;member;metal;mirror;mount;move;movement;offset;opaque;opening;outer;output;parallel;partial;path;pattern;period;person;photoelectric;plate;plug;portion;pressure;prevent;produce;protrude;radiation;range;ratio;rear;recognize;reflect;reflection;removably;represent;resin;ring;rotatable;rotatably;seal;select;separate;shape;side;slide;slot;spacer;stack;structure;substrate;supply;support;surface;surround;terahertz;transfer;transmit;type;vehicle;wall;water;wave;wavelength;weight;window;windshield;wire;actuator;adapt;adapter;adaptor;allow;angle;apart;arrangement;attachment;autofocus;axis;board;candidate;carriage;carrier;case;circuit;circular;coil;configuration;cylinder;cylindrical;dimension;distal;distance;driver;elastic;engage;fasten;flange;flexible;flow;gimbal;groove;handle;head;height;imaging;incline;insertion;inside;latch;left;lever;locate;lock;manner;mechanism;mobile;object;opposite;overlap;panel;periphery;pickup;pole;power;print;protrusion;proximal;rail;recess;record;rectangular;release;resilient;restrict;rotary;rotate;rotation;rotational;screw;seat;secure;segment;space;split;spring;stabilize;strap;subsequent;thin;track;tube;turn;upper;video;wireless;zone;acceleration;accelerometer;action;activation;adjustment;analyze;angular;articulate;automatic;bearing;brake;calculate;center;change;changing;collect;command;compare;comparison;control;coordinate;cycle;describe;desire;detect;determination;difference;dynamic;event;exceed;execute;extract;focus;forward;function;half;identify;indicate;indicative;inertial;input;integrate;level;linear;location;modify;monitor;motion;motor;moveable;moving;observe;operate;operation;orientation;orthogonal;pitch;posture;predict;quantity;rate;reach;read;readable;receive;remote;response;responsive;roll;sense;service;setting;sound;speed;steer;storage;subject;switch;synchronization;temperature;terminal;threshold;tilt;transform;transitory;translation;travel;user;velocity;viewpoint;voltage;activate;adjustable;ball;battery;calculation;calibration;clip;combination;compute;consist;count;create;dental;encode;estimation;execution;feedback;gaze;indication;indicator;instruction;interface;interior;joint;laser;link;logic;machine;magnet;mark;microphone;multiple;operable;panoramic;perform;physical;portable;pose;positional;presence;profile;project;receiver;reflective;screen;security;software;stabilization;stereoscopic;stream;thereon;touch;vector;vertical;vision;wearable;accept;assign;audio;average;button;card;characterize;circuitry;cleaning;close;compartment;conductor;connection;connector;construct;corner;criterion;decision;enclosure;fixture;fluid;gaming;gear;gesture;grip;guide;horizontal;host;interval;item;maintain;match;metadata;minimum;objective;open;overlay;picture;player;plural;port;preview;rearward;receptacle;recognition;render;request;selection;sequential;series;shoulder;signature;standard;start;surveillance;thermal;update;version;visual;voice;access;acquisition;activity;actuate;address;adhesive;align;alignment;ambient;analysis;annular;antenna;balance;barrier;beam;cable;carry;cavity;clamp;client;code;combine;communications;database;delay;distribution;door;edit;engine;enter;environment;equipment;evaluation;executable;facial;feature;feed;file;finger;flash;gain;gate;generation;generator;geometric;ground;handheld;hinge;human;identification;identifier;imager;initiate;instruct;intensity;interest;internet;interpolate;intersect;judge;list;live;loop;management;modular;network;package;packet;park;permit;perpendicular;phase;phone;photo;piece;platform;potential;primary;priority;protective;protocol;proximate;readout;realtime;register;registration;relationship;remove;representation;require;sample;scale;scanner;send;server;share;shutter;silicon;site;slave;sleeve;smart;source;station;stationary;status;stitch;subset;subsystem;table;target;template;timer;tool;transceiver;transmission;transmitter;trigger;utilize;wafer;accommodate;actuation;become;bracket;clock;complete;compress;contact;continuously;curve;detachable;detachably;diode;discrete;divide;drive;driving;elongate;engagement;exterior;eyepiece;factor;finder;fitting;flat;format;held;illumination;initialization;install;interchangeable;maximum;message;middle;mold;notification;occur;orient;pivot;probe;projector;quality;rearview;reception;reflector;relation;relative;retrieve;rigid;shaft;shift;sidewall;specific;stand;straight;thread;tripod;variable;viewfinder;visible;work;auto;blade;bobbin;casing;chamber;compose;concave;contour;diaphragm;enclose;endoscope;extension;fold;foot;hollow;hook;installation;manufacturing;partition;patient;post;preset;press;projection;retract;retractable;rotor;sheet;shell;shield;socket;square;television;tooth;transition;transparent;variation;vibration;width;accumulate;accumulation;amplifier;amplify;basis;capacitor;comparator;conductivity;conversion;counter;destination;diffusion;discharge;drain;electrode;exposure;float;histogram;impurity;integration;marker;matrix;node;parallax;photodetector;photodiode;reset;search;semiconductor;shake;sign;similarity;slope;spatial;traffic;write;column;composite;constitute;mask;sensitivity;solder;synthesize;transistor;algorithm;cement;character;coefficient;compression;continuous;cure;defect;intermediate;join;lane;patch;sharpness;shoot;spectrum;spot;technique;aircraft;boundary;calibrate;constant;correlate;derive;differential;dimensional;document;duration;electronics;foreground;illuminate;instrument;iris;landmark;modulate;observation;photographic;photosensor;radio;repeat;road;satisfy;scan;stereo;successive;superimpose;synchronize;transformation;volume;wheel;addition;alert;aspect;aspheric;classify;compact;context;crop;curvature;decode;embed;enhance;evaluate;game;icon;manual;master;operator;photography;recorder;robot;selectable;shot;text;auxiliary;bond;contrast;cross;emission;emitter;graphic;illuminator;lamp;lead;manipulate;mechanical;pane;radar;rolling;serial;slid;stage;strobe;symbol;trajectory;displacement;noise;pulse;radius;rule;friction;linkage;planar;separation;stabilizer;permanent;piezoelectric;printer;reverse;suspension;analog;blur;chassis;conditional;core;passage;refractive;roller;selector;train;yoke;assist;convex;designate;enlarge;extraction;fundus;interpolation;luminance;mate;modulation;peak;photosensitive;polarization;container;entry;intersection;sight;trailer;cluster;participant;perimeter;sensitive;correlation;dark;gradient;grid;polarize;refract;speaker;warp;denote;navigation;perspective;score;splitter;tone;disparity;principal;expression;chain;reproduction;neighboring;thumbnail;ramp;capsule;decide;omega;judgment
accessory;4,0;;;2,0;13,0;25,0;;23,0;;;;;;28,0;;;34,0;1,0;5,0;12,0;;;;9,0;36,0;;;;2,0;;72,0;1,0;1,0;;;61,0;9,0;3,0;;;50,0;335,0;6,0;3,0;2,0;17,0;;12,0;;;;;3,0;8,0;1,0;;11,0;;;9,0;;;12,0;;69,0;2,0;68,0;3,0;;2,0;18,0;105,0;33,0;;;;1,0;;;1,0;52,0;;12,0;;19,0;2,0;;58,0;;6,0;10,0;1,0;;;;;;;45,0;192,0;56,0;14,0;9,0;1,0;12,0;20,0;2,0;4,0;;;;1,0;2,0;;9,0;;;5,0;;4,0;1,0;1,0;71,0;1,0;;4,0;127,0;;;;14,0;;;40,0;;;19,0;;;4,0;1,0;7,0;;;9,0;3,0;1,0;9,0;21,0;49,0;;;171,0;;;2,0;10,0;;;;;62,0;;;;;33,0;16,0;;5,0;;;;24,0;;;12,0;1,0;15,0;;;26,0;3,0;1,0;;;13,0;1,0;10,0;5,0;;;;21,0;8,0;5,0;17,0;;1,0;9,0;;4,0;4,0;;;1,0;29,0;3,0;1,0;322,0;19,0;2,0;;;;;34,0;;;11,0;15,0;4,0;2,0;;38,0;;19,0;;9,0;9,0;;;7,0;;4,0;;;;12,0;;;9,0;;;;7,0;;8,0;45,0;12,0;3,0;;;17,0;;12,0;46,0;75,0;3,0;;1,0;20,0;22,0;39,0;3,0;;;;1,0;;29,0;;12,0;15,0;30,0;;10,0;3,0;;2,0;20,0;;18,0;;;3,0;;6,0;6,0;;;3,0;;2,0;1,0;;1,0;3,0;;33,0;3,0;1,0;;;;;2,0;3,0;;;;;3,0;;2,0;;1,0;9,0;1,0;16,0;24,0;9,0;4,0;;;;10,0;1,0;21,0;;;;7,0;2,0;6,0;2,0;2,0;4,0;4,0;;3,0;24,0;;3,0;;11,0;;4,0;;2,0;;4,0;;;;3,0;1,0;2,0;32,0;12,0;;;;4,0;1,0;;1,0;;;;;;;1,0;7,0;1,0;1,0;26,0;;;47,0;9,0;7,0;;;25,0;2,0;;;;;2,0;;2,0;;6,0;;11,0;11,0;5,0;;25,0;;20,0;;;;1,0;1,0;;;3,0;;8,0;35,0;3,0;;;;;3,0;;;;;104,0;1,0;8,0;4,0;;3,0;3,0;1,0;;;;1,0;8,0;10,0;7,0;;;;4,0;;1,0;;;22,0;;;2,0;3,0;2,0;;3,0;;;23,0;13,0;;5,0;;;;;;;;;1,0;1,0;7,0;26,0;1,0;1,0;3,0;4,0;1,0;2,0;;;;2,0;2,0;;3,0;2,0;14,0;;;;;3,0;6,0;;;1,0;;;;;;;;;;;1,0;;1,0;;2,0;;2,0;11,0;;2,0;1,0;;10,0;9,0;2,0;;;;2,0;;;;;;6,0;17,0;;;;;;;;1,0;1,0;12,0;;2,0;;;17,0;2,0;;2,0;2,0;;10,0;;;;3,0;;;2,0;;;1,0;;2,0;;;;;1,0;;6,0;2,0;1,0;;;;2,0;1,0;;;4,0;2,0;6,0;1,0;;10,0;;;;2,0;;;;;5,0;;;;1,0;2,0;10,0;;1,0;;4,0;;;;;;5,0;;1,0;;19,0;;;2,0;1,0;;;;;3,0;;;;;;4,0;;;;;4,0;;1,0;5,0;;;14,0;;;;4,0;2,0;1,0;;;3,0;1,0;;;;;;;1,0;19,0;1,0;;;;;;;6,0;24,0;;;10,0;;1,0;;;4,0;;;;;5,0;;;;;3,0;3,0;1,0;1,0;14,0;8,0;2,0;303,0;2,0;1,0;2,0;33,0;1,0;1,0;3,0;5,0;12,0;4,0;1,0;1,0;5,0;1,0;2,0;1,0;1,0;1,0;4,0;2,0;6,0;5,0;3,0;1,0;4,0;12,0;1,0;7,0;1,0;3,0;1,0;15,0;4,0;1,0;5,0;1,0;1,0;1,0;7,0;3,0;1,0;3,0;8,0;1,0;8,0;1,0;2,0;11,0;6,0;1,0;16,0;2,0;2,0;;;;;;;;;;;;;;;;;;;;;;;;;;;;;;;;;;;;;;;;;;;;;;;;;;;;;;;;;;;;;;;;;;;;;;;;;;;;;;;;;;;;;;;;;;;;;;;;;;;;;;;;;;;;;;;;;;;;;;;;;;;;;;;;;;;;;;;;;;;;;;;;;;;;;;;;;;;;;;;;;;;;;;;;;;;;;;;;;;;;;;;;;;;;;;;;;;;;;;;;;;;;;;;;;;;;;;;;;;;;;;;;;;;;;;;;;;;;;;;;;;;;;;;;;;;
achieve;2,0;;;4,0;;1,0;2,0;4,0;;;;;;2,0;;1,0;15,0;;;;;;13,0;;;;;4,0;;;1,0;;6,0;5,0;;7,0;;2,0;5,0;;3,0;13,0;3,0;;2,0;2,0;;7,0;;;;;;;10,0;4,0;1,0;2,0;1,0;;;;;;37,0;5,0;3,0;1,0;;;3,0;17,0;8,0;;;;;1,0;;;11,0;;;;3,0;;;30,0;20,0;7,0;2,0;;;1,0;;;6,0;3,0;4,0;;36,0;1,0;;8,0;9,0;;1,0;1,0;1,0;;4,0;;1,0;;;;5,0;;2,0;15,0;;;;8,0;;;12,0;;;;28,0;;;3,0;1,0;4,0;11,0;;1,0;;;4,0;;;;1,0;;1,0;;;;;;;4,0;;;;;;;;;;;;;;1,0;;;;1,0;8,0;;;;;;;;;2,0;2,0;;;5,0;;1,0;5,0;;;;;;;5,0;;;;;;1,0;;;;;;;1,0;1,0;6,0;2,0;;;;5,0;;;;;7,0;;;;;;;;;;;1,0;1,0;;;;;;;;;1,0;;1,0;5,0;;;2,0;;;;2,0;1,0;;;;;;;1,0;;;;;;;1,0;;;;;;;;;;5,0;;1,0;;4,0;7,0;5,0;;;;2,0;6,0;;;1,0;;;;;;1,0;;;;;;;;;;1,0;;2,0;;;;;;;;;1,0;1,0;;5,0;1,0;;;;;;3,0;1,0;;;;;1,0;;;;;;;1,0;;;1,0;;1,0;;;;;;;1,0;;;;;3,0;;;;;;;2,0;;1,0;;;1,0;;;;3,0;1,0;;9,0;;;10,0;;;;16,0;;;;;;;3,0;;25,0;;1,0;;;;;;;;4,0;;;1,0;1,0;1,0;;;2,0;1,0;4,0;3,0;;;;;;;1,0;;;;;;;;;;;6,0;;2,0;2,0;;8,0;;2,0;;;;;;;;;2,0;;;1,0;;1,0;2,0;;;2,0;;;;;;;1,0;;;;;;;;;2,0;;1,0;1,0;1,0;1,0;;2,0;;;1,0;;;1,0;;;4,0;;;1,0;;;;1,0;;;2,0;2,0;;;;;;;;;;;;;;;;;1,0;;;;;;;;;;;;;1,0;;;;;;;;;3,0;;1,0;;;;;;;;;;;;;;;;;;;;;1,0;;1,0;;;;;;;;;5,0;;3,0;;;;;;;1,0;;;;;;;;;;;;;;;;1,0;;3,0;;;10,0;;1,0;;;;;;;;;;;;3,0;;28,0;;;;;;1,0;;;;;;;;;;;;;;;;;;;;;;;;;;;;;;;;1,0;;;;;;;4,0;;;;;1,0;7,0;;;;2,0;;;1,0;13,0;;;;;;;1,0;2,0;;;1,0;;;;;1,0;;2,0;;;;;1,0;;;2,0;;1,0;;;;;;;;;;;;;5,0;;;;;;;;;;8,0;;;;2,0;31,0;;;2,0;;;;;;;;;;;;;;;;;1,0;;1,0;;;3,0;;;;;;2,0;;;;;;;;;;;;;;1,0;;;;;;;;;;;;;;;;;;;;;;;;7,0;;;;;;;;;;;;;;2,0;;;;3,0;;;;;;1,0;;;;;3,0;1,0;1,0;1,0;4,0;2,0;9,0;1,0;2,0;1,0;2,0;3,0;5,0;2,0;1,0;1,0;1,0;;;;;;;;;;;;;;;;;;;;;;;;;;;;;;;;;;;;;;;;;;;;;;;;;;;;;;;;;;;;;;;;;;;;;;;;;;;;;;;;;;;;;;;;;;;;;;;;;;;;;;;;;;;;;;;;;;;;;;;;;;;;;;;;;;;;;;;;;;;;;;;;;;;;;;;
adjust;1,0;2,0;4,0;;112,0;120,0;25,0;72,0;3,0;4,0;;3,0;29,0;299,0;7,0;166,0;276,0;;7,0;17,0;12,0;34,0;115,0;;6,0;10,0;39,0;54,0;13,0;30,0;334,0;95,0;20,0;17,0;;104,0;7,0;13,0;87,0;1,0;158,0;287,0;7,0;58,0;106,0;6,0;26,0;69,0;;22,0;39,0;;3,0;5,0;95,0;59,0;36,0;2,0;24,0;69,0;;2,0;7,0;;795,0;5,0;191,0;6,0;2,0;3,0;58,0;365,0;234,0;6,0;23,0;10,0;6,0;20,0;8,0;9,0;505,0;10,0;42,0;26,0;144,0;19,0;1,0;159,0;31,0;14,0;226,0;18,0;19,0;7,0;22,0;;77,0;21,0;124,0;179,0;465,0;41,0;;26,0;56,0;123,0;2,0;11,0;18,0;;;23,0;94,0;2,0;;;25,0;27,0;42,0;164,0;6,0;;142,0;53,0;3,0;26,0;215,0;2,0;13,0;8,0;116,0;;;197,0;7,0;;161,0;19,0;116,0;;;8,0;3,0;1,0;68,0;23,0;46,0;15,0;36,0;12,0;5,0;4,0;44,0;6,0;3,0;2,0;2,0;4,0;5,0;;;15,0;12,0;6,0;;1,0;24,0;10,0;3,0;16,0;11,0;13,0;23,0;163,0;1,0;4,0;1,0;37,0;12,0;1,0;3,0;;5,0;14,0;1,0;1,0;63,0;7,0;108,0;30,0;8,0;;;2,0;18,0;13,0;86,0;7,0;;8,0;2,0;9,0;21,0;;13,0;17,0;67,0;;109,0;38,0;14,0;39,0;37,0;;2,0;;50,0;4,0;1,0;18,0;49,0;27,0;3,0;;13,0;;61,0;4,0;8,0;10,0;4,0;4,0;52,0;50,0;4,0;5,0;4,0;3,0;1,0;1,0;;26,0;2,0;7,0;2,0;40,0;9,0;10,0;5,0;3,0;2,0;4,0;2,0;13,0;6,0;12,0;25,0;31,0;3,0;;6,0;6,0;3,0;38,0;;2,0;3,0;1,0;21,0;42,0;3,0;3,0;62,0;10,0;3,0;2,0;64,0;277,0;1,0;5,0;;25,0;103,0;24,0;;2,0;14,0;11,0;34,0;;9,0;26,0;;1,0;1,0;;116,0;10,0;;8,0;7,0;4,0;5,0;2,0;6,0;11,0;2,0;32,0;59,0;70,0;3,0;3,0;8,0;;2,0;10,0;6,0;6,0;9,0;24,0;26,0;99,0;2,0;25,0;;2,0;9,0;5,0;48,0;8,0;2,0;;3,0;2,0;10,0;;1,0;;;2,0;50,0;26,0;16,0;4,0;;5,0;8,0;21,0;;1,0;5,0;6,0;19,0;;24,0;11,0;15,0;13,0;164,0;4,0;16,0;5,0;;6,0;;156,0;2,0;18,0;4,0;5,0;;;18,0;15,0;25,0;28,0;5,0;75,0;18,0;13,0;222,0;19,0;2,0;15,0;9,0;48,0;11,0;21,0;7,0;7,0;12,0;18,0;1,0;259,0;1,0;61,0;;16,0;6,0;7,0;;43,0;3,0;68,0;5,0;72,0;3,0;6,0;42,0;35,0;;36,0;;53,0;83,0;133,0;5,0;3,0;7,0;11,0;5,0;37,0;1,0;44,0;5,0;59,0;4,0;39,0;32,0;3,0;12,0;1,0;312,0;6,0;62,0;7,0;12,0;44,0;11,0;6,0;46,0;9,0;49,0;74,0;10,0;13,0;2,0;;71,0;9,0;8,0;29,0;6,0;45,0;2,0;2,0;2,0;45,0;1,0;16,0;52,0;;2,0;11,0;;;3,0;;14,0;6,0;7,0;9,0;38,0;14,0;6,0;4,0;7,0;1,0;5,0;3,0;1,0;1,0;3,0;19,0;31,0;1,0;52,0;25,0;6,0;99,0;;;12,0;9,0;4,0;1,0;18,0;4,0;7,0;13,0;9,0;73,0;1,0;8,0;5,0;41,0;;;2,0;2,0;25,0;10,0;8,0;;1,0;19,0;2,0;7,0;;9,0;8,0;30,0;1,0;2,0;4,0;;;;5,0;;1,0;;3,0;7,0;24,0;3,0;39,0;10,0;14,0;19,0;;1,0;19,0;6,0;13,0;11,0;;1,0;;19,0;2,0;;13,0;7,0;6,0;2,0;;1,0;3,0;;1,0;14,0;33,0;5,0;8,0;;16,0;4,0;1,0;14,0;;7,0;;4,0;10,0;44,0;5,0;8,0;;14,0;42,0;;50,0;12,0;7,0;1,0;14,0;4,0;4,0;11,0;2,0;1,0;7,0;17,0;;;6,0;5,0;23,0;;5,0;4,0;;39,0;1,0;1,0;;49,0;111,0;;1,0;4,0;2,0;7,0;;5,0;2,0;;1,0;24,0;1,0;5,0;31,0;32,0;1,0;;1,0;;;4,0;5,0;;;33,0;;4,0;;3,0;3,0;14,0;2,0;4,0;1,0;9,0;;7,0;;2,0;;5,0;;;;1,0;4,0;3,0;9,0;2,0;16,0;16,0;;4,0;1,0;;34,0;;;;;1,0;33,0;;3,0;4,0;15,0;18,0;2,0;6,0;55,0;2,0;;5,0;2,0;30,0;3,0;10,0;4,0;4,0;1,0;;1,0;11,0;18,0;;;16,0;5,0;14,0;;2,0;4,0;;1,0;46,0;24,0;1,0;1,0;;1,0;38,0;;;;;;39,0;4,0;6,0;8,0;18,0;;27,0;;2,0;12,0;6,0;14,0;;8,0;12,0;;3,0;;11,0;101,0;2,0;1,0;;6,0;;1,0;3,0;1,0;5,0;;15,0;1,0;8,0;4,0;8,0;;;2,0;;;;;42,0;;7,0;5,0;2,0;;2,0;;4,0;1,0;;;1,0;48,0;;19,0;;;19,0;;;;9,0;;3,0;1,0;1,0;4,0;6,0;2,0;7,0;;;;;30,0;10,0;2,0;;3,0;12,0;1,0;;;;7,0;168,0;2,0;1,0;;7,0;6,0;4,0;1,0;11,0;;;2,0;5,0;4,0;11,0;;;;7,0;;;;2,0;;3,0;6,0;;;;29,0;;8,0;4,0;27,0;2,0;;;1,0;3,0;2,0;;2,0;32,0;;;2,0;4,0;5,0;24,0;5,0;3,0;15,0;;2,0;1,0;13,0;2,0;;13,0;;16,0;;;24,0;7,0;4,0;6,0;6,0;1,0;3,0;4,0;17,0;;2,0;4,0;16,0;14,0;2,0;13,0;;6,0;;;;;3,0;8,0;;6,0;;;1,0;;5,0;4,0;5,0;;2,0;20,0;5,0;2,0;1,0;;;12,0;2,0;2,0;;;3,0;63,0;;3,0;10,0;;4,0;;;8,0;4,0;;;2,0;3,0;11,0;8,0;;16,0;2,0;1,0;7,0;3,0;4,0;2,0;;;5,0;;2,0;1,0;;;;;6,0;;;;;1,0;;2,0;;;2,0;;10,0;;;2,0;;8,0;;;3,0;5,0;3,0;;;;;3,0;1,0;;;5,0;;;19,0;4,0;1,0;6,0;5,0;12,0;1,0;;;;;;;;;;;;
amount;1,0;13,0;;112,0;;55,0;8,0;5,0;1,0;;;7,0;6,0;301,0;;6,0;77,0;1,0;;9,0;3,0;2,0;25,0;;;2,0;11,0;37,0;7,0;25,0;212,0;48,0;55,0;150,0;7,0;153,0;23,0;6,0;46,0;;268,0;120,0;;18,0;52,0;;33,0;30,0;;56,0;13,0;;2,0;;31,0;21,0;19,0;;25,0;43,0;;;38,0;;517,0;;79,0;63,0;1,0;10,0;8,0;280,0;556,0;7,0;86,0;4,0;23,0;32,0;;26,0;116,0;3,0;26,0;2,0;23,0;2,0;;53,0;;;28,0;;26,0;;6,0;;198,0;40,0;64,0;41,0;116,0;146,0;;12,0;13,0;26,0;;3,0;4,0;3,0;4,0;58,0;31,0;10,0;;4,0;2,0;32,0;16,0;85,0;1,0;2,0;82,0;28,0;4,0;33,0;124,0;1,0;;1,0;199,0;21,0;1,0;282,0;16,0;1,0;38,0;;36,0;2,0;;;;20,0;18,0;39,0;43,0;3,0;12,0;4,0;2,0;1,0;30,0;;21,0;50,0;;;2,0;1,0;1,0;;5,0;19,0;4,0;3,0;;8,0;14,0;60,0;62,0;25,0;7,0;86,0;;4,0;14,0;48,0;2,0;8,0;26,0;;2,0;1,0;;13,0;24,0;7,0;52,0;3,0;;;6,0;5,0;3,0;;;43,0;;7,0;;20,0;10,0;;34,0;17,0;60,0;;7,0;6,0;26,0;172,0;38,0;;;;89,0;;;2,0;4,0;22,0;;15,0;2,0;;59,0;5,0;5,0;8,0;;9,0;30,0;13,0;;;27,0;14,0;;46,0;6,0;6,0;3,0;;;35,0;1,0;3,0;6,0;2,0;;3,0;1,0;;1,0;26,0;1,0;7,0;;;16,0;53,0;8,0;23,0;;;;4,0;16,0;4,0;2,0;2,0;37,0;4,0;;;17,0;35,0;1,0;4,0;1,0;7,0;53,0;;5,0;;;18,0;22,0;;4,0;24,0;;;1,0;1,0;67,0;11,0;2,0;;2,0;2,0;;4,0;;;;2,0;13,0;46,0;4,0;;;;1,0;2,0;8,0;3,0;1,0;14,0;1,0;51,0;;15,0;;;24,0;;62,0;;;;;;11,0;;3,0;;;;27,0;127,0;16,0;;;;34,0;14,0;;;3,0;;2,0;;;;17,0;2,0;24,0;5,0;1,0;1,0;1,0;;2,0;105,0;10,0;3,0;;1,0;1,0;;186,0;13,0;229,0;8,0;;4,0;36,0;6,0;146,0;5,0;1,0;4,0;33,0;225,0;12,0;46,0;3,0;4,0;41,0;14,0;17,0;217,0;;18,0;;20,0;52,0;9,0;;44,0;7,0;31,0;5,0;18,0;1,0;6,0;52,0;10,0;;83,0;;28,0;88,0;27,0;;2,0;;7,0;;19,0;14,0;6,0;3,0;118,0;16,0;37,0;7,0;9,0;6,0;1,0;34,0;;24,0;7,0;24,0;32,0;12,0;3,0;5,0;3,0;211,0;56,0;7,0;11,0;14,0;4,0;20,0;3,0;;66,0;7,0;3,0;1,0;2,0;26,0;10,0;9,0;;25,0;4,0;;3,0;;12,0;3,0;;15,0;;10,0;;5,0;;;;6,0;1,0;5,0;1,0;4,0;;;4,0;2,0;1,0;16,0;4,0;6,0;1,0;;;4,0;12,0;6,0;;8,0;;1,0;2,0;;6,0;1,0;10,0;8,0;18,0;;2,0;1,0;3,0;1,0;24,0;;;;13,0;6,0;6,0;;;;;;;4,0;3,0;1,0;1,0;36,0;2,0;;4,0;;1,0;9,0;;3,0;2,0;2,0;7,0;;5,0;1,0;6,0;5,0;;;;;;;;1,0;5,0;2,0;3,0;;4,0;;;;18,0;1,0;;1,0;;;;;20,0;;1,0;;2,0;;3,0;16,0;8,0;;;2,0;;7,0;2,0;6,0;;1,0;3,0;1,0;3,0;;;7,0;5,0;;;2,0;16,0;2,0;;5,0;;;53,0;;;;59,0;7,0;3,0;1,0;;3,0;;;;;1,0;2,0;3,0;6,0;;4,0;18,0;;1,0;;;;4,0;;;;2,0;;24,0;;2,0;4,0;23,0;;1,0;;;6,0;3,0;;;;;10,0;;24,0;;2,0;8,0;2,0;19,0;18,0;9,0;;5,0;;;8,0;;;3,0;;2,0;18,0;1,0;13,0;3,0;;4,0;;1,0;18,0;;9,0;;;2,0;;2,0;;;;;3,0;2,0;;1,0;;9,0;7,0;2,0;;2,0;15,0;;6,0;67,0;144,0;1,0;1,0;;;1,0;2,0;;;;;16,0;;;16,0;9,0;;;2,0;;4,0;;3,0;;1,0;;;1,0;;;22,0;;;;52,0;;7,0;;2,0;;;6,0;2,0;3,0;1,0;;;;;21,0;;;;40,0;;;7,0;;;;8,0;;;;;;3,0;;;;;;;;1,0;3,0;;;;;;4,0;2,0;;21,0;10,0;;1,0;15,0;1,0;;;37,0;;;15,0;1,0;;4,0;60,0;;6,0;8,0;6,0;5,0;4,0;;21,0;1,0;;4,0;;;173,0;;;;;4,0;2,0;2,0;;1,0;;7,0;;;2,0;;;1,0;25,0;1,0;;;1,0;;;6,0;9,0;7,0;2,0;;;;2,0;5,0;1,0;5,0;;14,0;;4,0;4,0;12,0;;5,0;2,0;1,0;;;;1,0;9,0;2,0;;;5,0;21,0;2,0;1,0;;;2,0;1,0;4,0;11,0;34,0;;;;;;;;1,0;3,0;;;1,0;2,0;;1,0;2,0;6,0;2,0;10,0;1,0;1,0;;5,0;;;1,0;;27,0;;;;1,0;;;;;;;;;;2,0;;;19,0;2,0;9,0;;;;;;;;;;;;;4,0;52,0;;;1,0;;2,0;;1,0;2,0;;;;;;3,0;;;1,0;;9,0;5,0;;;2,0;;;;;;;;;17,0;;;19,0;;2,0;;15,0;;;4,0;6,0;;;9,0;;3,0;;;2,0;2,0;;;;;
apparatus;1,0;25,0;1,0;120,0;55,0;;141,0;133,0;9,0;9,0;4,0;16,0;44,0;360,0;4,0;9,0;609,0;12,0;33,0;24,0;24,0;11,0;105,0;29,0;99,0;12,0;17,0;70,0;119,0;69,0;1133,0;301,0;41,0;157,0;3,0;372,0;96,0;96,0;102,0;6,0;383,0;794,0;17,0;77,0;818,0;133,0;18,0;244,0;3,0;42,0;51,0;4,0;60,0;76,0;98,0;44,0;189,0;4,0;34,0;189,0;21,0;3,0;49,0;15,0;2653,0;60,0;1093,0;24,0;4,0;4,0;50,0;1440,0;445,0;4,0;15,0;2,0;81,0;111,0;15,0;187,0;816,0;2,0;120,0;39,0;437,0;76,0;9,0;449,0;28,0;21,0;89,0;14,0;13,0;21,0;95,0;31,0;213,0;87,0;473,0;97,0;544,0;113,0;27,0;63,0;877,0;667,0;19,0;120,0;10,0;3,0;2,0;112,0;190,0;14,0;5,0;8,0;26,0;53,0;55,0;640,0;19,0;18,0;423,0;50,0;7,0;136,0;583,0;1,0;57,0;14,0;167,0;12,0;3,0;718,0;11,0;;224,0;41,0;110,0;1,0;5,0;13,0;5,0;3,0;97,0;39,0;99,0;91,0;72,0;148,0;22,0;29,0;197,0;29,0;18,0;24,0;2,0;7,0;2,0;1,0;23,0;225,0;18,0;32,0;13,0;12,0;190,0;71,0;4,0;118,0;68,0;9,0;32,0;254,0;11,0;50,0;17,0;38,0;25,0;8,0;8,0;7,0;9,0;95,0;4,0;17,0;132,0;14,0;220,0;38,0;7,0;25,0;14,0;62,0;95,0;24,0;287,0;9,0;45,0;7,0;4,0;57,0;13,0;6,0;44,0;43,0;263,0;27,0;53,0;646,0;56,0;96,0;9,0;4,0;;37,0;193,0;24,0;;50,0;60,0;28,0;29,0;32,0;104,0;18,0;385,0;2,0;6,0;13,0;8,0;3,0;96,0;32,0;16,0;9,0;10,0;19,0;21,0;14,0;8,0;36,0;35,0;2,0;8,0;113,0;30,0;65,0;144,0;6,0;25,0;3,0;15,0;83,0;62,0;32,0;139,0;295,0;26,0;20,0;16,0;96,0;53,0;183,0;37,0;2,0;18,0;24,0;13,0;32,0;19,0;69,0;114,0;56,0;39,0;2,0;41,0;120,0;5,0;32,0;43,0;26,0;243,0;115,0;2,0;2,0;10,0;55,0;190,0;12,0;146,0;24,0;11,0;17,0;15,0;12,0;230,0;59,0;34,0;24,0;20,0;15,0;24,0;15,0;9,0;23,0;31,0;105,0;15,0;804,0;8,0;7,0;25,0;23,0;29,0;4,0;106,0;34,0;10,0;71,0;134,0;351,0;20,0;20,0;9,0;13,0;236,0;26,0;132,0;19,0;24,0;8,0;15,0;22,0;102,0;19,0;20,0;2,0;1,0;13,0;58,0;60,0;20,0;21,0;20,0;32,0;63,0;42,0;2,0;41,0;42,0;17,0;5,0;2,0;137,0;9,0;47,0;61,0;399,0;59,0;9,0;5,0;14,0;19,0;6,0;116,0;26,0;12,0;3,0;48,0;12,0;8,0;86,0;51,0;97,0;14,0;6,0;32,0;17,0;20,0;890,0;68,0;1,0;71,0;26,0;259,0;37,0;33,0;9,0;19,0;7,0;91,0;27,0;177,0;17,0;91,0;55,0;80,0;39,0;1,0;8,0;125,0;40,0;52,0;10,0;80,0;8,0;155,0;111,0;92,0;12,0;294,0;6,0;69,0;150,0;93,0;3,0;5,0;5,0;1,0;;28,0;5,0;15,0;11,0;288,0;31,0;83,0;5,0;23,0;99,0;29,0;116,0;45,0;37,0;14,0;91,0;75,0;51,0;19,0;18,0;84,0;83,0;53,0;5,0;13,0;11,0;3,0;254,0;11,0;12,0;42,0;20,0;28,0;14,0;34,0;20,0;148,0;9,0;24,0;74,0;3,0;7,0;21,0;3,0;9,0;30,0;32,0;15,0;1,0;19,0;28,0;171,0;106,0;8,0;17,0;43,0;23,0;28,0;19,0;142,0;13,0;65,0;41,0;30,0;26,0;197,0;44,0;137,0;60,0;4,0;3,0;30,0;27,0;36,0;43,0;90,0;38,0;8,0;9,0;34,0;34,0;6,0;33,0;17,0;50,0;5,0;88,0;4,0;5,0;57,0;12,0;16,0;4,0;5,0;89,0;10,0;87,0;11,0;16,0;49,0;56,0;9,0;25,0;7,0;4,0;11,0;13,0;7,0;;25,0;24,0;2,0;72,0;81,0;4,0;7,0;14,0;26,0;22,0;8,0;13,0;3,0;52,0;9,0;50,0;;15,0;13,0;9,0;;6,0;25,0;7,0;53,0;29,0;5,0;10,0;14,0;;8,0;38,0;99,0;37,0;13,0;1,0;19,0;37,0;9,0;16,0;4,0;11,0;38,0;14,0;27,0;22,0;4,0;25,0;5,0;31,0;17,0;13,0;40,0;61,0;10,0;7,0;15,0;1,0;75,0;22,0;17,0;19,0;10,0;19,0;20,0;13,0;21,0;19,0;39,0;17,0;35,0;21,0;1,0;79,0;7,0;19,0;2,0;35,0;10,0;12,0;19,0;38,0;8,0;50,0;15,0;13,0;16,0;12,0;29,0;24,0;9,0;10,0;29,0;32,0;7,0;1,0;19,0;4,0;3,0;9,0;6,0;11,0;6,0;111,0;3,0;4,0;15,0;;29,0;17,0;9,0;21,0;8,0;35,0;27,0;3,0;3,0;11,0;20,0;15,0;3,0;15,0;24,0;4,0;14,0;10,0;9,0;1,0;27,0;25,0;4,0;25,0;21,0;20,0;103,0;11,0;7,0;;8,0;2,0;155,0;8,0;22,0;23,0;8,0;30,0;3,0;13,0;147,0;5,0;21,0;13,0;7,0;39,0;13,0;22,0;16,0;1,0;3,0;9,0;2,0;65,0;24,0;4,0;9,0;42,0;6,0;21,0;8,0;13,0;17,0;;11,0;250,0;497,0;11,0;4,0;12,0;12,0;9,0;11,0;2,0;18,0;10,0;5,0;151,0;3,0;10,0;190,0;13,0;11,0;8,0;5,0;15,0;9,0;8,0;17,0;13,0;26,0;14,0;8,0;1,0;2,0;18,0;77,0;5,0;8,0;6,0;15,0;6,0;30,0;13,0;17,0;10,0;2,0;15,0;35,0;14,0;3,0;15,0;;31,0;6,0;3,0;4,0;28,0;3,0;35,0;7,0;7,0;42,0;1,0;9,0;11,0;9,0;10,0;70,0;5,0;4,0;4,0;40,0;7,0;22,0;3,0;2,0;2,0;;1,0;30,0;15,0;11,0;29,0;6,0;14,0;14,0;13,0;25,0;21,0;2,0;5,0;12,0;5,0;24,0;16,0;11,0;8,0;70,0;8,0;15,0;6,0;5,0;2,0;20,0;92,0;21,0;5,0;7,0;2,0;26,0;27,0;6,0;19,0;2,0;10,0;19,0;28,0;122,0;121,0;3,0;8,0;4,0;14,0;2,0;3,0;6,0;3,0;4,0;5,0;11,0;3,0;14,0;68,0;34,0;;8,0;14,0;21,0;10,0;2,0;1,0;2,0;11,0;16,0;1,0;5,0;13,0;2,0;4,0;14,0;19,0;6,0;55,0;5,0;4,0;9,0;6,0;32,0;24,0;7,0;2,0;;23,0;16,0;8,0;1,0;3,0;9,0;22,0;3,0;42,0;2,0;10,0;18,0;14,0;69,0;3,0;;13,0;25,0;3,0;5,0;8,0;8,0;19,0;4,0;2,0;3,0;3,0;11,0;4,0;12,0;11,0;2,0;2,0;6,0;3,0;12,0;8,0;12,0;10,0;13,0;;1,0;8,0;5,0;25,0;21,0;1,0;19,0;13,0;4,0;4,0;7,0;13,0;3,0;1,0;22,0;;19,0;9,0;27,0;6,0;34,0;1,0;12,0;27,0;17,0;36,0;28,0;9,0;1,0;5,0;;23,0;7,0;46,0;;8,0;2,0;19,0;7,0;9,0;11,0;;;1,0;12,0;3,0;25,0;;5,0;15,0;;9,0;;36,0;3,0;4,0;6,0;8,0;7,0;2,0;3,0;1,0;8,0;;9,0;5,0;5,0;5,0;2,0;4,0;1,0;4,0;6,0;10,0;;3,0;3,0;1,0;19,0;3,0;5,0;33,0;5,0;;19,0;4,0;11,0;;;49,0;16,0;4,0;4,0;5,0;4,0;2,0;;
array;2,0;;2,0;25,0;8,0;141,0;;81,0;;;1,0;33,0;9,0;124,0;42,0;1,0;521,0;78,0;81,0;42,0;30,0;6,0;402,0;;18,0;2,0;4,0;79,0;5,0;1,0;279,0;25,0;13,0;21,0;8,0;343,0;56,0;19,0;117,0;11,0;80,0;360,0;3,0;78,0;48,0;247,0;8,0;431,0;;2,0;43,0;1,0;26,0;2,0;140,0;355,0;299,0;;9,0;168,0;12,0;34,0;82,0;;1768,0;49,0;857,0;13,0;25,0;;39,0;824,0;531,0;7,0;3,0;1,0;26,0;34,0;1,0;28,0;412,0;82,0;41,0;5,0;464,0;4,0;4,0;327,0;181,0;10,0;73,0;18,0;59,0;3,0;3,0;;1905,0;390,0;1151,0;36,0;224,0;29,0;143,0;104,0;161,0;161,0;2,0;9,0;3,0;9,0;4,0;76,0;97,0;3,0;2,0;12,0;116,0;195,0;85,0;1509,0;31,0;;159,0;25,0;92,0;7,0;501,0;2,0;11,0;24,0;421,0;15,0;3,0;202,0;8,0;8,0;116,0;32,0;9,0;1,0;;53,0;;;82,0;16,0;63,0;292,0;91,0;12,0;1,0;36,0;1,0;7,0;;1,0;;7,0;;1,0;5,0;34,0;4,0;31,0;7,0;5,0;106,0;29,0;9,0;34,0;256,0;1,0;28,0;74,0;1,0;100,0;14,0;52,0;3,0;;2,0;5,0;34,0;18,0;;6,0;501,0;14,0;49,0;22,0;3,0;;4,0;4,0;;20,0;66,0;31,0;6,0;9,0;4,0;32,0;8,0;5,0;55,0;19,0;23,0;16,0;72,0;55,0;12,0;21,0;31,0;5,0;2,0;9,0;92,0;20,0;1,0;20,0;126,0;17,0;;31,0;11,0;3,0;191,0;1,0;4,0;63,0;;47,0;47,0;6,0;9,0;;15,0;1,0;1,0;7,0;1,0;5,0;;;10,0;75,0;65,0;36,0;148,0;;1,0;8,0;223,0;33,0;205,0;14,0;8,0;115,0;14,0;1,0;11,0;31,0;21,0;14,0;5,0;;4,0;26,0;3,0;52,0;;2,0;4,0;21,0;4,0;;16,0;46,0;12,0;30,0;2,0;2,0;108,0;44,0;;;5,0;1,0;97,0;12,0;1,0;94,0;;27,0;18,0;;105,0;11,0;11,0;;2,0;1,0;17,0;6,0;;1,0;3,0;3,0;2,0;447,0;6,0;;2,0;;38,0;;75,0;;1,0;4,0;6,0;41,0;43,0;31,0;1,0;3,0;1,0;;14,0;4,0;;;;;13,0;36,0;;;3,0;;18,0;40,0;;;;;15,0;26,0;1,0;1,0;;;3,0;7,0;3,0;1,0;;13,0;86,0;1,0;15,0;;4,0;;1,0;17,0;4,0;5,0;;;2,0;;18,0;81,0;2,0;2,0;4,0;;8,0;17,0;91,0;14,0;6,0;20,0;27,0;104,0;9,0;22,0;31,0;10,0;1,0;11,0;4,0;63,0;3,0;23,0;2,0;26,0;2,0;;;19,0;77,0;38,0;115,0;82,0;4,0;13,0;8,0;5,0;4,0;15,0;1,0;72,0;23,0;7,0;3,0;33,0;;;;1,0;8,0;69,0;3,0;130,0;1,0;8,0;5,0;9,0;52,0;;13,0;2,0;3,0;4,0;12,0;35,0;2,0;;3,0;11,0;20,0;8,0;2,0;14,0;5,0;1,0;20,0;;28,0;11,0;8,0;4,0;9,0;;3,0;46,0;;20,0;30,0;19,0;2,0;16,0;4,0;;1,0;5,0;1,0;;;2,0;14,0;14,0;;5,0;14,0;26,0;6,0;5,0;2,0;2,0;71,0;54,0;8,0;8,0;73,0;16,0;1,0;2,0;;;5,0;36,0;17,0;10,0;1,0;;22,0;;5,0;;2,0;1,0;12,0;17,0;14,0;;3,0;4,0;21,0;15,0;;;3,0;69,0;;6,0;;;4,0;4,0;14,0;9,0;;;1,0;;;;1,0;;;7,0;65,0;;;1,0;3,0;19,0;;3,0;6,0;6,0;;;;11,0;3,0;2,0;;;;3,0;;2,0;;10,0;;;17,0;;2,0;7,0;;;6,0;;2,0;4,0;;7,0;7,0;9,0;49,0;19,0;3,0;;1,0;54,0;7,0;10,0;42,0;2,0;5,0;25,0;1,0;6,0;4,0;20,0;;;1,0;2,0;;;2,0;3,0;14,0;1,0;;2,0;;7,0;4,0;;;6,0;19,0;21,0;74,0;1,0;13,0;3,0;;;2,0;;7,0;301,0;;;94,0;15,0;;8,0;8,0;;;;;1,0;2,0;1,0;12,0;3,0;;3,0;28,0;15,0;3,0;91,0;2,0;2,0;2,0;18,0;4,0;2,0;;14,0;24,0;3,0;8,0;13,0;32,0;8,0;9,0;4,0;81,0;;;2,0;9,0;11,0;17,0;18,0;6,0;;;;96,0;1,0;;3,0;24,0;23,0;;6,0;37,0;40,0;1,0;;2,0;22,0;;12,0;29,0;20,0;2,0;;;;5,0;12,0;1,0;10,0;2,0;65,0;1,0;;17,0;7,0;12,0;68,0;10,0;2,0;1,0;;;7,0;;;7,0;17,0;;92,0;;3,0;;1,0;;17,0;10,0;;9,0;2,0;;;27,0;3,0;1,0;;2,0;1,0;87,0;;;;12,0;1,0;3,0;2,0;2,0;;;2,0;;22,0;;1,0;;;;1,0;2,0;59,0;;;7,0;7,0;1,0;18,0;;;1,0;;36,0;10,0;1,0;;2,0;;14,0;;;1,0;5,0;;23,0;;15,0;;;2,0;36,0;5,0;;10,0;;;;3,0;2,0;;7,0;;26,0;17,0;;2,0;;;4,0;26,0;4,0;1,0;;25,0;2,0;48,0;6,0;84,0;112,0;15,0;6,0;;57,0;;;4,0;;32,0;;2,0;112,0;34,0;4,0;5,0;2,0;13,0;12,0;12,0;;;;9,0;2,0;1,0;8,0;4,0;1,0;;5,0;;;1,0;27,0;13,0;6,0;;1,0;30,0;2,0;2,0;;;222,0;;;10,0;1,0;40,0;;;;19,0;;;201,0;2,0;3,0;;;;12,0;16,0;;2,0;1,0;3,0;1,0;18,0;;12,0;;;;;;15,0;1,0;4,0;7,0;2,0;;;;3,0;;;;;4,0;;;;17,0;1,0;2,0;27,0;7,0;5,0;19,0;;;;4,0;;1,0;32,0;;;4,0;;1,0;;12,0;7,0;10,0;13,0;;2,0;;51,0;3,0;;;4,0;;;;11,0;;4,0;;1,0;;8,0;;;;;;9,0;3,0;;;6,0;5,0;3,0;;4,0;1,0;31,0;3,0;;5,0;12,0;;;4,0;;1,0;23,0;4,0;7,0;;16,0;5,0;3,0;14,0;1,0;;;1,0;6,0;1,0;;9,0;;2,0;2,0;;5,0;;;;2,0;;
assembly;55,0;23,0;4,0;72,0;5,0;133,0;81,0;;;;16,0;;153,0;611,0;5,0;4,0;115,0;11,0;36,0;7,0;11,0;3,0;11,0;10,0;26,0;2,0;3,0;122,0;8,0;2,0;453,0;38,0;9,0;2,0;2,0;65,0;81,0;83,0;8,0;4,0;23,0;344,0;34,0;182,0;70,0;268,0;13,0;566,0;;35,0;;1,0;129,0;24,0;123,0;150,0;195,0;34,0;4,0;51,0;26,0;3,0;117,0;1,0;873,0;5,0;1078,0;8,0;10,0;51,0;106,0;3367,0;310,0;39,0;36,0;1,0;69,0;25,0;;26,0;279,0;;24,0;;497,0;93,0;2,0;1547,0;16,0;18,0;7,0;34,0;19,0;12,0;12,0;12,0;32,0;129,0;456,0;120,0;447,0;32,0;31,0;36,0;41,0;41,0;9,0;4,0;1,0;1,0;1,0;12,0;42,0;4,0;11,0;1,0;6,0;19,0;39,0;940,0;;8,0;63,0;8,0;;15,0;375,0;10,0;3,0;19,0;21,0;14,0;5,0;158,0;6,0;50,0;138,0;9,0;77,0;4,0;1,0;49,0;5,0;;138,0;26,0;40,0;86,0;39,0;344,0;17,0;16,0;232,0;55,0;3,0;;1,0;7,0;;15,0;32,0;136,0;;6,0;10,0;;363,0;201,0;2,0;11,0;12,0;1,0;43,0;183,0;11,0;21,0;7,0;16,0;26,0;;5,0;17,0;12,0;41,0;108,0;6,0;42,0;35,0;142,0;319,0;;20,0;19,0;146,0;101,0;67,0;803,0;23,0;32,0;27,0;;68,0;8,0;8,0;15,0;;653,0;31,0;238,0;1300,0;129,0;40,0;17,0;5,0;5,0;45,0;30,0;41,0;;21,0;5,0;1,0;;;163,0;;595,0;20,0;19,0;7,0;12,0;8,0;49,0;36,0;102,0;;15,0;4,0;34,0;15,0;6,0;123,0;49,0;42,0;39,0;12,0;17,0;96,0;438,0;33,0;75,0;47,0;10,0;296,0;175,0;8,0;569,0;464,0;32,0;;16,0;12,0;7,0;233,0;43,0;6,0;;9,0;16,0;50,0;8,0;107,0;113,0;35,0;80,0;16,0;35,0;55,0;13,0;15,0;129,0;14,0;346,0;133,0;2,0;11,0;77,0;8,0;167,0;5,0;75,0;22,0;7,0;49,0;9,0;17,0;89,0;12,0;16,0;70,0;67,0;33,0;54,0;1,0;6,0;28,0;64,0;99,0;30,0;173,0;10,0;8,0;45,0;4,0;11,0;3,0;61,0;65,0;6,0;79,0;23,0;121,0;63,0;10,0;16,0;8,0;;8,0;72,0;56,0;26,0;13,0;32,0;70,0;52,0;13,0;8,0;11,0;10,0;15,0;196,0;55,0;22,0;73,0;3,0;161,0;8,0;75,0;1,0;51,0;22,0;21,0;1,0;;109,0;67,0;15,0;76,0;77,0;24,0;5,0;2,0;3,0;58,0;;33,0;1,0;10,0;18,0;12,0;27,0;11,0;1,0;84,0;8,0;1,0;;7,0;3,0;;135,0;7,0;1,0;33,0;6,0;23,0;2,0;;;1,0;;;;120,0;16,0;3,0;5,0;7,0;5,0;9,0;2,0;16,0;39,0;34,0;12,0;18,0;;24,0;39,0;55,0;47,0;84,0;;29,0;18,0;41,0;35,0;5,0;;;1,0;2,0;11,0;5,0;3,0;322,0;33,0;10,0;9,0;31,0;20,0;4,0;10,0;2,0;1,0;9,0;24,0;1,0;51,0;;10,0;18,0;3,0;96,0;;6,0;3,0;54,0;105,0;;;3,0;23,0;61,0;37,0;11,0;;18,0;20,0;15,0;9,0;10,0;;7,0;;;;;;;;18,0;11,0;77,0;80,0;52,0;8,0;16,0;4,0;2,0;77,0;11,0;24,0;33,0;16,0;19,0;7,0;16,0;22,0;3,0;3,0;1,0;27,0;16,0;5,0;11,0;4,0;15,0;4,0;16,0;2,0;;25,0;6,0;;48,0;65,0;;3,0;;16,0;;3,0;5,0;4,0;11,0;15,0;51,0;3,0;7,0;70,0;120,0;14,0;16,0;;;32,0;18,0;29,0;;54,0;2,0;24,0;98,0;43,0;1,0;3,0;;11,0;2,0;;5,0;13,0;133,0;;;;;5,0;;3,0;13,0;;1,0;;2,0;5,0;2,0;35,0;;12,0;2,0;11,0;28,0;;;6,0;11,0;14,0;1,0;;4,0;1,0;50,0;64,0;37,0;6,0;1,0;23,0;5,0;11,0;2,0;6,0;52,0;32,0;37,0;41,0;;3,0;3,0;2,0;;;2,0;98,0;;;9,0;11,0;11,0;;1,0;;20,0;;;;10,0;2,0;1,0;1,0;;;9,0;1,0;31,0;;;1,0;89,0;1,0;;4,0;4,0;;;1,0;;;;1,0;1,0;38,0;1,0;61,0;;;15,0;23,0;;44,0;;7,0;82,0;;5,0;;14,0;;3,0;;1,0;2,0;;3,0;13,0;;;7,0;;7,0;6,0;;4,0;17,0;4,0;;1,0;4,0;;60,0;3,0;24,0;1,0;;2,0;3,0;;25,0;2,0;;13,0;;16,0;4,0;34,0;;6,0;29,0;34,0;;110,0;14,0;7,0;;70,0;1,0;13,0;8,0;21,0;5,0;10,0;3,0;94,0;75,0;19,0;24,0;15,0;16,0;;;7,0;7,0;3,0;12,0;70,0;;32,0;8,0;11,0;1,0;2,0;49,0;;1,0;19,0;69,0;43,0;16,0;;124,0;;16,0;31,0;155,0;;24,0;45,0;6,0;;5,0;84,0;;61,0;12,0;27,0;15,0;30,0;10,0;3,0;10,0;17,0;10,0;2,0;;16,0;1,0;5,0;18,0;24,0;13,0;18,0;16,0;10,0;2,0;4,0;17,0;;5,0;22,0;4,0;2,0;111,0;9,0;10,0;6,0;16,0;27,0;18,0;21,0;15,0;;7,0;2,0;21,0;;8,0;8,0;;;;;;1,0;;1,0;;1,0;;;;;8,0;3,0;;;;;12,0;1,0;;6,0;;2,0;2,0;;17,0;2,0;2,0;;11,0;7,0;;;2,0;4,0;2,0;5,0;;4,0;;;1,0;;;10,0;5,0;1,0;2,0;3,0;4,0;17,0;;;2,0;22,0;7,0;2,0;1,0;;3,0;3,0;27,0;1,0;;;17,0;2,0;;27,0;;22,0;;2,0;;;2,0;10,0;2,0;2,0;1,0;;19,0;10,0;11,0;;1,0;1,0;;6,0;94,0;3,0;;7,0;106,0;;3,0;;;21,0;;5,0;1,0;;;;6,0;;2,0;;;1,0;2,0;;;11,0;41,0;;3,0;;2,0;;18,0;21,0;5,0;9,0;43,0;2,0;;1,0;;22,0;11,0;;2,0;;14,0;;;2,0;;17,0;7,0;18,0;2,0;66,0;1,0;;4,0;19,0;129,0;;;43,0;;3,0;5,0;10,0;5,0;1,0;7,0;6,0;2,0;16,0;;10,0;4,0;;;;11,0;2,0;7,0;6,0;;;;;;;;;11,0;2,0;;1,0;2,0;2,0;;14,0;2,0;2,0;;1,0;6,0;;1,0;;;3,0;;5,0;;;;;;;;
association;1,0;;;3,0;1,0;9,0;;;;;;;1,0;22,0;;;24,0;;;;;;;;;;;;1,0;;4,0;4,0;;2,0;;48,0;1,0;;6,0;;16,0;13,0;;4,0;8,0;1,0;;8,0;;7,0;1,0;;;;3,0;4,0;;;1,0;15,0;;;4,0;;72,0;;13,0;;;;4,0;8,0;1,0;;;;;22,0;6,0;16,0;26,0;;4,0;;;;5,0;;;6,0;;;;;;;6,0;;24,0;25,0;23,0;10,0;;6,0;19,0;5,0;;;;;;3,0;4,0;;;3,0;;;9,0;;;3,0;;;;26,0;13,0;;;;1,0;;;5,0;;;11,0;4,0;;;;;;;;3,0;7,0;3,0;26,0;;;3,0;2,0;;;;;;;;;;4,0;1,0;;;;;;2,0;3,0;;;2,0;;;;;;;;;;;;;3,0;;14,0;;;;;2,0;;;2,0;;;;;;;;;1,0;6,0;;1,0;5,0;2,0;9,0;;;;;1,0;;;5,0;;;2,0;;3,0;;3,0;;;;;;2,0;;;3,0;1,0;;;1,0;;;;;;;;;;;;;;;;;4,0;;;;;;;5,0;;;;;;1,0;;;;;;;1,0;2,0;;;;;4,0;;3,0;;;;3,0;;;;;;;1,0;3,0;;;;;;;;;;;4,0;3,0;9,0;;;;;;;;2,0;;;1,0;47,0;;;;;;;1,0;;;1,0;;;1,0;;1,0;;;;4,0;5,0;1,0;;;;;;;;;;;;12,0;;;;20,0;;;;;;;2,0;1,0;;;;;;1,0;;;;;;;;13,0;19,0;;1,0;6,0;5,0;;1,0;;4,0;;7,0;4,0;;;24,0;;8,0;6,0;1,0;;1,0;;;;21,0;1,0;;6,0;;;3,0;;;1,0;;;;;3,0;;;;;1,0;1,0;;3,0;;;3,0;;7,0;;;;3,0;2,0;;;;;;4,0;;4,0;;;4,0;;;;;;;;1,0;1,0;;2,0;3,0;;;;;;;1,0;;;3,0;;;;;;;;;;;;;;;;17,0;;2,0;9,0;3,0;;;;;;1,0;;;;;;;2,0;;3,0;1,0;;;3,0;3,0;;;;;;;;;;;;;2,0;;;;;;;;2,0;;;;;;3,0;;;3,0;;;;1,0;;;;;;;;;5,0;;1,0;;;;3,0;;1,0;;;4,0;;1,0;;1,0;;;;;;;2,0;;;;;;;;;;;;;;;;2,0;;;;;;;;;;;;8,0;;14,0;;;;;3,0;;;;3,0;;;5,0;20,0;;;;;4,0;;;;;;;;;;1,0;;;;;;;;;;;;;;;;;;;;2,0;;;;;2,0;;;;;;;;2,0;;;;;;;;;;;;3,0;;;;;;;;;;;;;;;;;;;;;;;;;2,0;;;;;;;;;;;;;;;1,0;4,0;;;;;2,0;;;;;;;;;;;;;;;;3,0;;;;;;;;;;;;;;;;;1,0;;;;;;;;;;;2,0;;1,0;;;7,0;;;;;;;;;;1,0;;;;;;;;;;;;;;;;;;;;;;;;;;;;;;;;1,0;;;;;;;;;;;;;;;;5,0;2,0;;;;;2,0;;;;;;;;1,0;;;;;;;;;3,0;;;;;;;;;;;;;;;;;;;;;;;;;;;;;;;;;4,0;;;;1,0;;;;1,0;;;;1,0;;;;;;;;;;;;;;;;;;;;;;;;;;;;;1,0;;;;;;;;;;;;;;;;;;;;;;2,0;;;;;;;;;;;;;;;;;;;;;;;;;;10,0;;;;;;;;;;;;;;;;;;;;;;;
attribute;2,0;;;4,0;;9,0;;;;;;;;56,0;;1,0;22,0;;;;;;22,0;;1,0;2,0;;;4,0;;14,0;15,0;;6,0;;16,0;16,0;;5,0;;72,0;21,0;;3,0;10,0;2,0;;;;;;;;;2,0;;6,0;;;25,0;;;40,0;;145,0;;50,0;;16,0;;2,0;27,0;1,0;;;;;;16,0;6,0;34,0;;;6,0;;;;;;;3,0;;;;;;;;58,0;3,0;5,0;16,0;;6,0;;12,0;3,0;6,0;19,0;;;29,0;4,0;1,0;;;5,0;;6,0;3,0;2,0;;2,0;18,0;;11,0;10,0;;;;6,0;;;1,0;;;;17,0;;;;;;;;9,0;15,0;;16,0;;;7,0;;;;;;;2,0;;;2,0;15,0;;;9,0;;;;1,0;;;;4,0;;;;;;;;;;7,0;;;;;4,0;;;;;;;;;;;;;;;;3,0;5,0;;;;;;;;;;;;;1,0;;;;50,0;;;;3,0;;;1,0;;;4,0;5,0;;;;;;;;;;;;71,0;3,0;13,0;;;;;;;;;;;;;;2,0;10,0;59,0;;;;;4,0;;;;;;;;;4,0;;;4,0;;;;12,0;;;;;;;;;;3,0;;11,0;1,0;;;;;;;;;;;;3,0;;;;;;;;;;;12,0;93,0;;;;;;;;;;;;;6,0;;;;;;;;;;;;;;;;;;;;2,0;;1,0;;7,0;;;;;;;6,0;4,0;;;;;;5,0;1,0;6,0;;3,0;2,0;10,0;;4,0;1,0;;11,0;;16,0;8,0;;;7,0;;;31,0;;1,0;5,0;;43,0;4,0;8,0;;6,0;;9,0;;4,0;6,0;;7,0;;;;;1,0;27,0;;;2,0;;;;16,0;;;1,0;12,0;1,0;8,0;;;6,0;;6,0;;1,0;;2,0;8,0;35,0;;;4,0;2,0;4,0;;4,0;1,0;;13,0;;;;;;;;;1,0;;1,0;9,0;16,0;;;;;;;;;1,0;;16,0;3,0;;;;1,0;;;;;;;;;3,0;1,0;;;8,0;1,0;;;;;1,0;;;;;2,0;;2,0;;;;10,0;6,0;28,0;4,0;;5,0;;12,0;5,0;;;;;;;;;;;;;;;;;3,0;;;;;;;14,0;;;;;2,0;33,0;;;8,0;4,0;;;;;3,0;5,0;;;;;;4,0;;;;2,0;;;;;;;;;;;;;;;;;;;;;;;;2,0;;9,0;;;;;2,0;;;;;;;2,0;;;;;;;;;2,0;;;;;13,0;9,0;;;;;;;;;;;;;;;;;;;;;21,0;;;8,0;;;;;;8,0;;;;;;;;;;;;;3,0;;;36,0;;;;;;;;;;;2,0;;;4,0;;;;;4,0;;;1,0;;;;;;;;;;;;;;;;;1,0;;;;;;;;10,0;;16,0;;;;2,0;;;;;;;;;;;;;;;;;8,0;2,0;;;;;;;;;;7,0;;;;;;;;;;;;;;;;;;;;;;;;;;;;;;;;;;;;;;;;;;;;;;;;;;;;;31,0;;;;;;;;;;;;;;;;;;;;;3,0;;;;;;;;13,0;;;;;;;;;;1,0;;;;;;;;;;1,0;1,0;;;;;2,0;;;;;;;;;;;;;;;;;;3,0;;;;;;;;;;;;5,0;;12,0;;21,0;;;;;;;;2,0;;;;;;;;;3,0;;;;;;;;;;;;;;;;;;;;;;;;;;;;;;;;;;;;;;;;;;;;;;24,0;;;;;;;;;;;;;;;;;;7,0;;;;;;;;;;;;;;;13,0;;15,0;;;;;;;;;;;;;;
axial;12,0;;;;;4,0;1,0;16,0;;;;;21,0;16,0;2,0;;3,0;;3,0;;;;;;1,0;;;12,0;;25,0;9,0;;;;;4,0;13,0;1,0;4,0;;5,0;39,0;;2,0;;4,0;;14,0;;;;;13,0;;3,0;2,0;6,0;;;2,0;;3,0;;;22,0;;7,0;;;7,0;84,0;199,0;10,0;;;;;2,0;;;2,0;;;;11,0;2,0;;75,0;;;;2,0;1,0;;;;;4,0;4,0;5,0;19,0;2,0;;;1,0;1,0;;;;;;;2,0;1,0;;;;;;2,0;1,0;;1,0;;;;10,0;4,0;;49,0;;13,0;;49,0;;;;;;;;3,0;;;8,0;;;5,0;;;4,0;;7,0;2,0;;;6,0;;;;;4,0;;;;;4,0;4,0;;;;;;75,0;;;;;6,0;3,0;;;3,0;5,0;;;4,0;;1,0;8,0;2,0;;;2,0;3,0;3,0;;;3,0;2,0;;;16,0;;;;7,0;;;5,0;2,0;8,0;3,0;;1,0;13,0;2,0;1,0;;;;;;;7,0;;6,0;;;;4,0;;1,0;1,0;5,0;;;;;1,0;;2,0;1,0;3,0;9,0;;3,0;;48,0;9,0;;;;;1,0;2,0;3,0;39,0;1,0;;;;;;1,0;;;;;;;;1,0;1,0;;;;1,0;;6,0;;;42,0;1,0;;2,0;6,0;4,0;3,0;;1,0;;2,0;2,0;;16,0;61,0;;1,0;5,0;;;;;;14,0;;;2,0;1,0;;2,0;1,0;;;;2,0;;1,0;1,0;2,0;19,0;5,0;;;;;2,0;;;;6,0;;2,0;;;;;2,0;;3,0;10,0;;;1,0;;;5,0;;;;;3,0;4,0;;25,0;;6,0;;;;;;;;1,0;;;;2,0;7,0;;;4,0;;;;;;;7,0;;;;;;;;;;;;;2,0;3,0;;2,0;;;;;;;;1,0;8,0;;;;4,0;;9,0;;;;;;;;;;;;;;2,0;;;;;12,0;;;;1,0;;;;1,0;;;;;;;;;4,0;;;;;1,0;;2,0;;;;;;;;;;;;;;;;;;;;;;;;;;;;;;;;;;;;;;6,0;;;;;;;;;;;;;6,0;;;;;;1,0;;;;;;2,0;;;3,0;1,0;;;;;3,0;;;;2,0;;;;;;3,0;;;;;2,0;;2,0;;;;;2,0;;;;;;;;;;;;;2,0;;;;;;;;;;;;1,0;;6,0;;;2,0;;;;3,0;;;2,0;;;;5,0;;;;;;;;1,0;;;;;;;;;;;;;;;;;;;;;;;;;;;;;3,0;;;;;;;;;;;;9,0;;;;;;;;;2,0;;;;;;;;;;;;;;;;;;;;;;;;;;;;;;;;;;3,0;;;;;;;;5,0;;;;;1,0;4,0;;;;;;;;6,0;10,0;;9,0;;;;;;;;;;;1,0;2,0;5,0;;;;;;4,0;;;;;;;;;5,0;;;10,0;;;;;;1,0;;;;;;;;2,0;;;;;;8,0;;;41,0;;;;;;;;;8,0;;1,0;1,0;2,0;;;;;2,0;;;;;;4,0;;1,0;;;;;;;;;;;;;;;;4,0;;;;;;;;;;;;;;;;;;;;;;;;;;;;;;;;;;;;;;1,0;2,0;;;;;;;;;;;;5,0;;;;;;;;;;;;;;;2,0;;;;23,0;;;;;;;;;;;;;;;;;4,0;;;;;;;;;;;;;;;;;;;;;;;;;;;;;;;;;;;;;9,0;;;13,0;;;;;1,0;2,0;;;;;3,0;;;;;;12,0;;;;;;;;;;;;;;1,0;;;;;;;4,0;;;;;;;;;;;;;;;13,0;;;;;;;;6,0;;;;;;;;;
band;2,0;;;3,0;7,0;16,0;33,0;;;;;;;26,0;5,0;;12,0;;6,0;2,0;10,0;;32,0;1,0;8,0;;;595,0;;;124,0;18,0;;;;85,0;3,0;;;;27,0;18,0;2,0;4,0;3,0;15,0;;27,0;;;4,0;;15,0;1,0;4,0;;26,0;;79,0;2,0;;4,0;14,0;;408,0;;38,0;;7,0;;;24,0;231,0;;;;2,0;1,0;;6,0;65,0;;;;10,0;;;49,0;;1,0;1,0;;231,0;;;;21,0;19,0;85,0;2,0;18,0;12,0;;7,0;29,0;6,0;8,0;;4,0;;;2,0;16,0;2,0;;14,0;38,0;4,0;11,0;31,0;1,0;3,0;24,0;;336,0;5,0;98,0;;;2,0;15,0;;1,0;29,0;8,0;;1,0;1,0;;;;6,0;;;3,0;1,0;;9,0;16,0;5,0;;6,0;8,0;11,0;;;;1,0;;;1,0;5,0;;4,0;1,0;;6,0;3,0;1,0;7,0;3,0;;9,0;1,0;;;;12,0;1,0;11,0;10,0;;;;;;189,0;;2,0;4,0;;;;;1,0;18,0;5,0;6,0;9,0;;12,0;4,0;6,0;3,0;4,0;1,0;3,0;1,0;4,0;10,0;;4,0;1,0;2,0;;;65,0;3,0;2,0;12,0;1,0;2,0;;1,0;2,0;;48,0;;1,0;29,0;;33,0;10,0;1,0;;;;;;4,0;;;;;;46,0;;9,0;14,0;1,0;;;2,0;6,0;2,0;4,0;7,0;13,0;;;;5,0;8,0;;5,0;;4,0;151,0;;5,0;;;;8,0;;;29,0;7,0;;;2,0;;;;;;;8,0;9,0;2,0;;;;;;;7,0;;21,0;1,0;2,0;;3,0;;;;;21,0;;;;;;;;;2,0;;;1,0;;;1,0;3,0;;;;;2,0;;;;;;4,0;;;;;;;;;1,0;;7,0;1,0;;3,0;1,0;;2,0;;;5,0;;3,0;4,0;9,0;8,0;;;;1,0;;4,0;10,0;4,0;;;;;2,0;8,0;1,0;;;;9,0;6,0;12,0;;;;;37,0;;12,0;;;;;;2,0;4,0;11,0;;2,0;;1,0;;9,0;5,0;9,0;1,0;1,0;;;14,0;;;;;17,0;;;;;;;;;;;;45,0;;23,0;2,0;2,0;7,0;;4,0;9,0;;;4,0;;;;3,0;4,0;1,0;;;1,0;;;15,0;;;2,0;;;;;2,0;1,0;2,0;;;13,0;;;;68,0;4,0;;;;;;;8,0;11,0;;;;;;;;;11,0;;;1,0;;5,0;;;;17,0;;3,0;3,0;;;;;;;1,0;;2,0;;;;;;;;;;;4,0;;;;;3,0;1,0;2,0;;;;;;;;;;;3,0;;;1,0;;;2,0;;;;;;;;;;;;7,0;;;;1,0;;1,0;;;;;;;;;;;;;;;;;22,0;2,0;5,0;;;5,0;;;15,0;;;4,0;;;;1,0;;;;;;;4,0;;;;7,0;;;1,0;1,0;;1,0;;;1,0;2,0;;;1,0;;;3,0;2,0;;11,0;;;28,0;;;;;;;;1,0;;;9,0;;;;;;1,0;;;;;2,0;;;;;;;;;;;;16,0;;6,0;;;;;;6,0;;;1,0;;;14,0;;;;;82,0;;;;;;;;27,0;3,0;;2,0;1,0;;;;4,0;;;;1,0;;;;;;;2,0;;;4,0;;;;4,0;;;1,0;;;8,0;;;;4,0;;;;;;;;;;;;1,0;;;4,0;;;;1,0;;80,0;;;;;;;28,0;;;;;;;1,0;;;;;;2,0;;2,0;;;;;;;;12,0;;;;;;;;;1,0;6,0;;;;3,0;1,0;;2,0;;;;;8,0;;;;1,0;;;;;;;2,0;;;;8,0;2,0;1,0;;;11,0;;;;2,0;;;;;;;;;;1,0;;7,0;;;2,0;;;;;;5,0;;;5,0;;;;2,0;;19,0;;;;1,0;;2,0;;;;;;;;;6,0;;;;;;;;34,0;;;;;;;;;;;;1,0;;;;;;;;;4,0;;;;;;;1,0;1,0;;;;;;;;;;5,0;;2,0;;7,0;;1,0;;;;;;;;;;;;;4,0;;;;;;;;;;;;;;;;;;;;;;;;;;;;;;;;;;;3,0;;;;;;;;9,0;;;7,0;;;;;2,0;2,0;;;;;;;;;;;;;;;;;;;;
barrel;2,0;;;29,0;6,0;44,0;9,0;153,0;1,0;;21,0;;;66,0;2,0;;3,0;;6,0;;;2,0;;1,0;6,0;6,0;4,0;51,0;;;106,0;7,0;3,0;28,0;;4,0;15,0;3,0;;;2,0;56,0;25,0;20,0;1,0;238,0;7,0;38,0;2,0;;;;54,0;7,0;4,0;11,0;113,0;;1,0;6,0;4,0;;19,0;;87,0;1,0;263,0;4,0;;28,0;17,0;2842,0;17,0;4,0;;3,0;17,0;;;;42,0;;19,0;;311,0;70,0;;229,0;47,0;;;21,0;2,0;2,0;12,0;;1,0;17,0;135,0;6,0;122,0;7,0;;8,0;;;;2,0;1,0;;;5,0;19,0;2,0;;;;7,0;;95,0;;3,0;7,0;;;;43,0;;;5,0;2,0;;42,0;126,0;;;1,0;;5,0;;;9,0;;;8,0;4,0;3,0;24,0;2,0;84,0;6,0;2,0;44,0;72,0;;;29,0;2,0;1,0;;38,0;80,0;;4,0;;2,0;119,0;28,0;;3,0;11,0;;12,0;146,0;2,0;14,0;2,0;4,0;2,0;4,0;;;14,0;69,0;;;32,0;4,0;75,0;83,0;;2,0;6,0;44,0;147,0;21,0;340,0;2,0;70,0;19,0;;2,0;4,0;3,0;3,0;;128,0;13,0;2,0;178,0;97,0;33,0;7,0;;2,0;101,0;9,0;21,0;1,0;1,0;2,0;;;;3,0;;266,0;;6,0;7,0;22,0;1,0;10,0;;4,0;;1,0;;2,0;;2,0;38,0;8,0;10,0;34,0;;7,0;29,0;129,0;6,0;2,0;2,0;25,0;13,0;13,0;1,0;56,0;202,0;6,0;;3,0;2,0;;4,0;22,0;;3,0;;1,0;9,0;;;34,0;2,0;3,0;;11,0;14,0;11,0;1,0;1,0;10,0;199,0;41,0;;;106,0;11,0;49,0;5,0;57,0;;;97,0;;16,0;21,0;6,0;38,0;17,0;;26,0;3,0;2,0;25,0;20,0;;;;22,0;3,0;3,0;30,0;;;5,0;17,0;10,0;5,0;7,0;6,0;6,0;17,0;2,0;;10,0;3,0;1,0;1,0;12,0;12,0;1,0;;9,0;;;;;2,0;;28,0;31,0;57,0;25,0;4,0;33,0;;28,0;;13,0;1,0;;;;2,0;3,0;5,0;50,0;7,0;5,0;;;1,0;;;7,0;;;1,0;4,0;4,0;;1,0;13,0;10,0;;;;1,0;;8,0;;;1,0;1,0;7,0;;;;;;;;11,0;8,0;1,0;;;4,0;;;2,0;16,0;;1,0;;;;15,0;2,0;1,0;86,0;;9,0;49,0;;3,0;5,0;1,0;;;;;;;53,0;3,0;3,0;;2,0;7,0;;;;;;;8,0;5,0;;2,0;22,0;;4,0;;;;;2,0;;;4,0;;1,0;1,0;;;1,0;;1,0;;;;5,0;;;;;;;1,0;21,0;;;5,0;;;;;;64,0;;;9,0;1,0;;7,0;1,0;5,0;;;;;4,0;;;;;;2,0;;;5,0;;;5,0;;;;;;;1,0;;;7,0;;9,0;;1,0;11,0;14,0;2,0;1,0;;;2,0;;2,0;;2,0;;10,0;52,0;8,0;1,0;;;1,0;1,0;;;3,0;35,0;;;;1,0;1,0;;1,0;;1,0;;;1,0;;;;;;;;5,0;;;;1,0;1,0;;;1,0;;29,0;28,0;8,0;;;3,0;59,0;;;;3,0;10,0;10,0;3,0;;;1,0;;;;;;;;;1,0;;;;;;7,0;2,0;;;;;;;;4,0;;19,0;;;;;;;;;;;1,0;;;;;;;;1,0;;;3,0;14,0;;;;3,0;;;;;4,0;;;;;;;;4,0;;2,0;3,0;12,0;;1,0;;1,0;2,0;2,0;;;3,0;;4,0;;2,0;;;;;;12,0;;;6,0;;1,0;;;;;65,0;;1,0;8,0;;;1,0;112,0;;1,0;;5,0;;;;27,0;101,0;;2,0;11,0;;;4,0;1,0;1,0;;9,0;;;13,0;5,0;3,0;;;14,0;;;9,0;13,0;;;;;;;;58,0;;1,0;1,0;9,0;12,0;;1,0;90,0;29,0;;;;;;;1,0;25,0;9,0;;3,0;1,0;;4,0;1,0;2,0;16,0;;;14,0;;1,0;3,0;;;3,0;1,0;1,0;2,0;;1,0;;3,0;9,0;10,0;;;;;;;1,0;11,0;7,0;;;;;;;;;;;;;;;18,0;;;;;;;;;;;;;;;7,0;;;1,0;;;;;;;;;4,0;;;;;;;;;;;5,0;22,0;;;;3,0;;;;;;;;;;;;;;2,0;;;;2,0;;;;2,0;;3,0;;;;;1,0;;;4,0;;;3,0;;;;1,0;;;;;1,0;;2,0;;;;;7,0;;;;;;;;;1,0;5,0;;;;;;;;3,0;;9,0;;;4,0;;;;;;;2,0;;;2,0;;2,0;;2,0;1,0;;1,0;4,0;;1,0;;;4,0;1,0;;;;;2,0;;8,0;9,0;;4,0;;;;;;;6,0;;;1,0;;;;;;;;;6,0;;;;;;1,0;1,0;;;;;;;;;;;;1,0;;;;;;;;
base;5,0;28,0;2,0;299,0;301,0;360,0;124,0;611,0;22,0;56,0;16,0;26,0;66,0;;5,0;92,0;847,0;6,0;93,0;184,0;11,0;8,0;450,0;42,0;75,0;18,0;17,0;277,0;93,0;170,0;639,0;110,0;103,0;214,0;2,0;1698,0;173,0;93,0;524,0;8,0;2348,0;1301,0;18,0;234,0;520,0;530,0;41,0;415,0;44,0;78,0;281,0;3,0;323,0;49,0;201,0;143,0;301,0;30,0;81,0;806,0;4,0;13,0;102,0;30,0;4961,0;13,0;896,0;31,0;59,0;94,0;162,0;878,0;527,0;13,0;45,0;46,0;136,0;130,0;39,0;74,0;879,0;;259,0;291,0;486,0;142,0;2,0;343,0;7,0;30,0;370,0;34,0;55,0;38,0;153,0;5,0;792,0;242,0;1191,0;705,0;1634,0;189,0;4,0;144,0;183,0;229,0;13,0;26,0;44,0;36,0;4,0;348,0;378,0;23,0;14,0;27,0;58,0;212,0;247,0;836,0;69,0;22,0;1133,0;164,0;26,0;221,0;795,0;;52,0;44,0;563,0;21,0;38,0;593,0;19,0;;375,0;169,0;145,0;1,0;5,0;79,0;15,0;24,0;104,0;97,0;290,0;119,0;322,0;240,0;35,0;85,0;175,0;255,0;23,0;29,0;27,0;3,0;3,0;3,0;38,0;275,0;98,0;47,0;6,0;53,0;507,0;264,0;16,0;328,0;43,0;44,0;36,0;531,0;42,0;280,0;25,0;22,0;57,0;9,0;25,0;2,0;12,0;313,0;151,0;33,0;171,0;74,0;786,0;149,0;12,0;36,0;19,0;137,0;152,0;142,0;456,0;18,0;82,0;33,0;14,0;353,0;31,0;28,0;269,0;34,0;1622,0;111,0;92,0;1108,0;92,0;360,0;117,0;;12,0;113,0;376,0;100,0;31,0;105,0;248,0;111,0;45,0;16,0;426,0;12,0;1457,0;3,0;14,0;35,0;128,0;54,0;212,0;90,0;45,0;28,0;62,0;14,0;55,0;71,0;6,0;118,0;155,0;49,0;24,0;498,0;45,0;167,0;830,0;94,0;92,0;23,0;17,0;361,0;78,0;46,0;627,0;1365,0;27,0;31,0;37,0;119,0;59,0;447,0;67,0;17,0;38,0;20,0;106,0;88,0;10,0;54,0;151,0;79,0;50,0;12,0;41,0;517,0;49,0;42,0;60,0;100,0;197,0;106,0;52,0;3,0;111,0;90,0;147,0;30,0;227,0;165,0;30,0;48,0;60,0;24,0;722,0;106,0;42,0;63,0;88,0;14,0;77,0;59,0;14,0;51,0;19,0;124,0;109,0;334,0;7,0;4,0;30,0;12,0;78,0;55,0;109,0;23,0;25,0;75,0;170,0;1271,0;82,0;85,0;5,0;17,0;29,0;26,0;134,0;28,0;48,0;19,0;51,0;82,0;108,0;37,0;21,0;7,0;17,0;1,0;193,0;332,0;54,0;36,0;49,0;144,0;122,0;207,0;1,0;45,0;17,0;27,0;46,0;;204,0;62,0;52,0;331,0;624,0;75,0;2,0;43,0;28,0;75,0;27,0;234,0;75,0;59,0;19,0;15,0;26,0;24,0;486,0;136,0;311,0;18,0;27,0;126,0;117,0;307,0;798,0;357,0;21,0;19,0;33,0;661,0;285,0;257,0;44,0;140,0;29,0;45,0;133,0;408,0;33,0;203,0;2,0;376,0;109,0;25,0;12,0;513,0;17,0;207,0;36,0;708,0;88,0;145,0;497,0;122,0;9,0;326,0;1,0;74,0;265,0;354,0;19,0;28,0;31,0;66,0;27,0;126,0;6,0;16,0;1,0;827,0;110,0;71,0;24,0;24,0;127,0;23,0;304,0;25,0;152,0;33,0;62,0;182,0;75,0;69,0;94,0;108,0;125,0;103,0;29,0;78,0;79,0;63,0;737,0;56,0;57,0;104,0;68,0;19,0;28,0;25,0;40,0;256,0;25,0;76,0;186,0;9,0;77,0;51,0;48,0;11,0;39,0;8,0;24,0;33,0;77,0;57,0;132,0;94,0;71,0;123,0;15,0;20,0;6,0;23,0;147,0;13,0;62,0;57,0;5,0;125,0;248,0;77,0;53,0;274,0;29,0;39,0;48,0;58,0;17,0;15,0;115,0;29,0;13,0;28,0;37,0;134,0;14,0;97,0;151,0;99,0;22,0;18,0;4,0;49,0;101,0;89,0;8,0;4,0;6,0;15,0;13,0;53,0;6,0;10,0;67,0;72,0;21,0;37,0;57,0;9,0;22,0;26,0;14,0;1,0;25,0;79,0;12,0;54,0;61,0;7,0;48,0;36,0;9,0;171,0;97,0;23,0;17,0;179,0;29,0;35,0;5,0;10,0;15,0;40,0;2,0;24,0;78,0;80,0;53,0;87,0;5,0;24,0;12,0;28,0;12,0;40,0;45,0;25,0;142,0;22,0;115,0;45,0;55,0;31,0;21,0;19,0;18,0;27,0;71,0;83,0;36,0;157,0;24,0;5,0;52,0;;57,0;28,0;16,0;55,0;238,0;13,0;70,0;28,0;2,0;91,0;28,0;19,0;6,0;34,0;4,0;50,0;133,0;20,0;74,0;10,0;23,0;455,0;19,0;44,0;14,0;57,0;52,0;8,0;14,0;2,0;50,0;34,0;6,0;24,0;47,0;43,0;36,0;16,0;4,0;3,0;98,0;147,0;13,0;16,0;4,0;10,0;16,0;17,0;36,0;6,0;27,0;71,0;20,0;13,0;16,0;7,0;48,0;45,0;5,0;18,0;21,0;74,0;19,0;19,0;55,0;4,0;6,0;10,0;9,0;12,0;25,0;24,0;60,0;24,0;54,0;8,0;121,0;53,0;6,0;21,0;30,0;14,0;81,0;1,0;23,0;;18,0;2,0;128,0;189,0;37,0;58,0;121,0;87,0;7,0;49,0;371,0;27,0;59,0;7,0;10,0;31,0;6,0;59,0;15,0;15,0;19,0;7,0;6,0;70,0;76,0;4,0;9,0;75,0;7,0;76,0;20,0;26,0;8,0;9,0;21,0;136,0;226,0;33,0;30,0;93,0;11,0;77,0;3,0;37,0;52,0;7,0;27,0;74,0;3,0;38,0;21,0;51,0;26,0;12,0;16,0;13,0;25,0;33,0;25,0;8,0;36,0;69,0;6,0;6,0;10,0;37,0;422,0;15,0;32,0;33,0;90,0;55,0;113,0;57,0;8,0;67,0;27,0;17,0;31,0;36,0;2,0;1,0;47,0;78,0;16,0;17,0;3,0;10,0;5,0;1,0;31,0;6,0;31,0;2,0;30,0;18,0;18,0;24,0;3,0;5,0;44,0;9,0;41,0;16,0;113,0;16,0;;16,0;9,0;1,0;16,0;13,0;17,0;8,0;10,0;21,0;24,0;35,0;33,0;71,0;14,0;;;8,0;20,0;2,0;9,0;;70,0;24,0;27,0;2,0;5,0;;2,0;232,0;64,0;29,0;1,0;14,0;95,0;77,0;7,0;53,0;8,0;;21,0;57,0;11,0;40,0;9,0;47,0;3,0;59,0;19,0;2,0;21,0;33,0;3,0;46,0;8,0;8,0;15,0;7,0;62,0;;38,0;45,0;13,0;6,0;;;35,0;48,0;77,0;65,0;43,0;60,0;12,0;19,0;10,0;6,0;34,0;105,0;14,0;9,0;49,0;23,0;64,0;21,0;30,0;3,0;47,0;6,0;7,0;18,0;55,0;7,0;8,0;12,0;6,0;18,0;1,0;62,0;11,0;30,0;41,0;8,0;4,0;54,0;60,0;27,0;28,0;11,0;27,0;5,0;;56,0;6,0;31,0;19,0;16,0;13,0;10,0;19,0;17,0;2,0;16,0;10,0;10,0;29,0;2,0;4,0;79,0;3,0;19,0;14,0;17,0;20,0;41,0;12,0;8,0;2,0;3,0;8,0;11,0;1,0;7,0;21,0;3,0;37,0;38,0;4,0;19,0;7,0;;7,0;50,0;48,0;87,0;28,0;24,0;56,0;21,0;8,0;55,0;2,0;13,0;6,0;1,0;;28,0;29,0;26,0;33,0;14,0;;13,0;5,0;5,0;4,0;1,0;19,0;32,0;18,0;1,0;33,0;;;;20,0;70,0;26,0;32,0;31,0;10,0;10,0;1,0;14,0;36,0;12,0;22,0;11,0;15,0;3,0;11,0;62,0;15,0;42,0;65,0;1,0;3,0;7,0;34,0;;11,0;88,0;71,0;;24,0;142,0;;12,0;;10,0;16,0;;12,0;;5,0;;13,0
blue;5,0;;;7,0;;4,0;42,0;5,0;;;2,0;5,0;2,0;5,0;;1,0;6,0;3,0;47,0;;2,0;;193,0;1,0;;;;21,0;;;8,0;4,0;4,0;4,0;1,0;38,0;;;2,0;;3,0;12,0;;4,0;3,0;18,0;;44,0;;;;;;;4,0;5,0;10,0;;;7,0;25,0;318,0;8,0;;115,0;;41,0;2,0;;;;12,0;116,0;1,0;;;;;;;27,0;;;;11,0;;;3,0;;4,0;;;5,0;;;;187,0;6,0;22,0;;5,0;3,0;;2,0;5,0;3,0;;;;;;;13,0;;;;;;8,0;18,0;;;42,0;;17,0;1,0;11,0;;;;17,0;;;4,0;;1,0;;;;;;2,0;;;2,0;;;22,0;3,0;;;;1,0;;;;;;3,0;;;2,0;;3,0;;;5,0;1,0;;3,0;1,0;;;;;;;1,0;1,0;;;;;;;3,0;272,0;;3,0;2,0;4,0;;;;;;1,0;1,0;;;;3,0;;;2,0;;;;;;;;;;;;8,0;;;;7,0;;;18,0;;;8,0;;;7,0;;;15,0;9,0;;;2,0;6,0;;;;;;;;1,0;;2,0;;;;;;3,0;;;1,0;9,0;2,0;;;2,0;1,0;;;;;19,0;1,0;;;;;;;;3,0;;;;;;;;;;;1,0;7,0;;;9,0;;;;;5,0;;;;;;;;;;;1,0;;12,0;;;3,0;;;;20,0;;1,0;;;5,0;9,0;;2,0;;;;;;;;;;;;;;;;;;;;;;1,0;5,0;;;;;;;;;;;2,0;;;;;;;8,0;;;;;;;;;8,0;;;;1,0;;;;;;;1,0;;8,0;;;;;5,0;;;1,0;;;;;;;;13,0;;1,0;;1,0;;;;;9,0;;10,0;;;;;;;;;;;6,0;;;;;3,0;;1,0;;;;;;;;;;3,0;;5,0;;;;1,0;;;;;;;;;;;2,0;1,0;25,0;;;;3,0;;;;;;;;;;;;;1,0;;;;;;1,0;;2,0;1,0;;;;;;1,0;;;;;;;;;;;;;;;;;;13,0;;;;;;;;;;1,0;;;;;;;;;;;;;;;;;;;;;;;;;;;;;;;;;;;;;;;;;;;;;2,0;;1,0;;;;;;3,0;;1,0;;;;21,0;;5,0;1,0;;;;;4,0;;;;;;;;;;;;1,0;;;;;;;;113,0;;;;;;;;;;;19,0;;;12,0;;;2,0;;;;;;;;;;;;;;;;;;;;5,0;;;;;;;;;1,0;;;1,0;;;;1,0;;4,0;;;;;;1,0;8,0;;;;;;;3,0;;;;;;1,0;;;;;;;;;;;;1,0;;1,0;;;;1,0;;;;;;;;29,0;;;;2,0;;2,0;;;;;;;2,0;;;1,0;;;1,0;;;;;;;;;;1,0;;;;;;;;;7,0;;;;;;;;1,0;;;;;;;;;;;2,0;;;;;;;;;;;;;;;;;;;;;;;;;;;;;;17,0;;;;;;;7,0;2,0;;;;;13,0;;;;;;;;;;1,0;;1,0;;;4,0;;1,0;1,0;5,0;;;2,0;;;;;;;;;;;;;;;7,0;;;;;;;;;;;;;;;;;;;2,0;;;;;;;;;;;;;;;;;;;3,0;;;;;;;;;2,0;;;;;;;;;1,0;;;;;2,0;;1,0;;;;;;;;;;;;;;;;;;;;;;;;;;;;;;;;;;;;;;;;;;;;;;;;;2,0;7,0;;;6,0;;;;;;;;;;;7,0;;;;;;;;;;;;;;5,0;;;;1,0;;;;;;;;
brightness;8,0;;1,0;166,0;6,0;9,0;1,0;4,0;;1,0;;;;92,0;1,0;;64,0;;10,0;1,0;;2,0;95,0;;;15,0;6,0;2,0;;15,0;62,0;19,0;9,0;3,0;;58,0;18,0;;14,0;;100,0;34,0;;3,0;40,0;;;20,0;;;2,0;;;2,0;2,0;;;;;39,0;;1,0;4,0;;390,0;1,0;51,0;35,0;3,0;;;2,0;77,0;;2,0;;;38,0;;1,0;81,0;;20,0;;4,0;;;3,0;;7,0;30,0;2,0;;9,0;34,0;8,0;174,0;;74,0;7,0;1,0;54,0;;4,0;12,0;20,0;;1,0;6,0;;;19,0;123,0;;;4,0;5,0;11,0;35,0;29,0;2,0;1,0;33,0;5,0;4,0;5,0;33,0;;34,0;1,0;48,0;1,0;;26,0;3,0;;9,0;1,0;2,0;;;4,0;;;14,0;3,0;33,0;1,0;19,0;;;17,0;3,0;;;;;;1,0;;;1,0;;2,0;;;;;22,0;2,0;1,0;;;6,0;;1,0;;1,0;2,0;;;;;;;;;;39,0;;28,0;;2,0;;;;2,0;1,0;2,0;;;1,0;2,0;;11,0;2,0;;;1,0;1,0;;1,0;;;;;5,0;;2,0;;7,0;11,0;;;;;14,0;;;1,0;;;75,0;6,0;;;1,0;1,0;;4,0;;;;;;22,0;;2,0;;;;;;4,0;;;;1,0;11,0;;1,0;3,0;;23,0;;;;;34,0;3,0;;;;5,0;;;14,0;7,0;;2,0;;24,0;2,0;;9,0;;;16,0;3,0;;;2,0;;;;1,0;3,0;;;;;;;;;;;;2,0;6,0;;;;;;;7,0;;;;15,0;12,0;;;;;;;2,0;;;;;;25,0;;;;;;5,0;2,0;;;;;12,0;6,0;;;;;;1,0;;;;1,0;13,0;;1,0;;;;1,0;13,0;9,0;;;19,0;;;38,0;;23,0;11,0;12,0;6,0;16,0;21,0;40,0;;;;1,0;23,0;1,0;27,0;;26,0;5,0;3,0;;5,0;;23,0;1,0;12,0;11,0;;;;;126,0;;4,0;3,0;7,0;13,0;1,0;;;6,0;8,0;;;;;;2,0;;3,0;9,0;2,0;;14,0;1,0;22,0;6,0;;2,0;;34,0;2,0;3,0;;5,0;17,0;3,0;;22,0;8,0;98,0;1,0;;4,0;;;;;;;5,0;;;;3,0;;;1,0;;;;;;;;;;;;6,0;4,0;2,0;;;;;;3,0;;3,0;;14,0;1,0;2,0;25,0;1,0;;;;;5,0;2,0;;;10,0;;2,0;;;1,0;;2,0;;;2,0;;;11,0;3,0;34,0;;;1,0;1,0;;1,0;;;;;;;;;;;;;;;;;1,0;1,0;14,0;2,0;;6,0;;2,0;;4,0;;4,0;;;;44,0;;;2,0;;2,0;;;;;;4,0;5,0;24,0;;;;;;;;;;;;;;19,0;1,0;;;7,0;;;;1,0;;;;;10,0;;;1,0;73,0;;1,0;;2,0;27,0;;;;;2,0;;;;33,0;50,0;;;;2,0;;;;;;;1,0;;;10,0;;;8,0;;10,0;;;;;;2,0;;;;;;;;;6,0;;;;;;;;;;;;2,0;8,0;;;71,0;1,0;;1,0;;;;;;;;;26,0;;;6,0;2,0;2,0;;5,0;12,0;;;;;2,0;;;;;;;19,0;;;;;;3,0;3,0;;;;;;;2,0;;;;;2,0;;;;;;10,0;;;;19,0;;20,0;;;;;;;;5,0;8,0;;;;4,0;;;;;;9,0;;;;;;;;2,0;3,0;;;;;;;1,0;;;;;;;;;;;;2,0;;24,0;;;;;;;;;;;;;1,0;;6,0;;1,0;43,0;;;;3,0;;;;1,0;3,0;;;;;;47,0;;4,0;;9,0;;;;3,0;;1,0;1,0;2,0;6,0;;;;3,0;1,0;;;18,0;;1,0;2,0;;;2,0;;;;;;;;;;;;;;2,0;;;;;;;;2,0;3,0;3,0;;;;;;;13,0;;;;4,0;;2,0;;;4,0;;5,0;;;2,0;1,0;;;;;1,0;;;;2,0;;;;;;;;2,0;;;;;;;;;;3,0;;;;11,0;;1,0;;;;80,0;;;;;;;;;;;;;;11,0;;;;;;;;;;;;;;;;;;;;;;;;;;;;;;;;21,0;;;;;;;;;;;;;1,0;;;1,0;;;;;;;;;;;;;;;;;;;;;;;;
capture;6,0;34,0;15,0;276,0;77,0;609,0;521,0;115,0;24,0;22,0;3,0;12,0;3,0;847,0;6,0;64,0;;6,0;32,0;104,0;92,0;3,0;154,0;41,0;80,0;42,0;9,0;247,0;134,0;111,0;1414,0;150,0;50,0;57,0;;2767,0;84,0;79,0;356,0;7,0;738,0;4066,0;3,0;516,0;981,0;166,0;29,0;277,0;1,0;10,0;76,0;;46,0;77,0;419,0;135,0;175,0;;30,0;543,0;9,0;12,0;64,0;13,0;20392,0;17,0;982,0;45,0;52,0;10,0;87,0;658,0;615,0;;74,0;;21,0;54,0;325,0;131,0;1582,0;7,0;657,0;49,0;651,0;30,0;17,0;338,0;10,0;30,0;154,0;19,0;53,0;53,0;115,0;;645,0;119,0;1655,0;228,0;739,0;153,0;6,0;302,0;549,0;639,0;18,0;79,0;29,0;1,0;2,0;306,0;388,0;15,0;;60,0;131,0;143,0;881,0;1564,0;300,0;2,0;387,0;88,0;6,0;311,0;1389,0;5,0;175,0;5,0;925,0;13,0;;1007,0;7,0;16,0;692,0;89,0;63,0;;;54,0;55,0;;38,0;92,0;514,0;65,0;339,0;31,0;3,0;58,0;94,0;9,0;79,0;4,0;1,0;;7,0;;3,0;52,0;148,0;62,0;;15,0;132,0;24,0;15,0;82,0;57,0;21,0;127,0;247,0;;38,0;2,0;21,0;86,0;9,0;10,0;35,0;31,0;213,0;;25,0;77,0;10,0;792,0;87,0;5,0;55,0;4,0;19,0;7,0;15,0;127,0;59,0;3,0;3,0;;12,0;4,0;17,0;71,0;74,0;51,0;9,0;56,0;97,0;78,0;181,0;19,0;;4,0;10,0;161,0;38,0;25,0;74,0;343,0;164,0;76,0;9,0;15,0;;561,0;1,0;13,0;78,0;;34,0;261,0;22,0;98,0;44,0;49,0;37,0;;116,0;;20,0;1,0;3,0;9,0;289,0;70,0;26,0;142,0;2,0;1,0;;32,0;56,0;33,0;12,0;78,0;177,0;48,0;;38,0;268,0;51,0;519,0;6,0;9,0;5,0;38,0;10,0;78,0;3,0;6,0;14,0;86,0;1,0;3,0;33,0;124,0;21,0;12,0;4,0;19,0;81,0;35,0;11,0;;5,0;40,0;57,0;5,0;2,0;69,0;;4,0;36,0;25,0;161,0;28,0;;6,0;5,0;;1,0;9,0;2,0;;11,0;36,0;25,0;806,0;5,0;;32,0;;72,0;1,0;56,0;3,0;9,0;38,0;215,0;1033,0;10,0;154,0;13,0;21,0;36,0;5,0;43,0;15,0;;;;6,0;177,0;1,0;6,0;;19,0;;35,0;40,0;12,0;;14,0;9,0;27,0;55,0;1,0;8,0;5,0;;81,0;;80,0;4,0;14,0;22,0;2308,0;52,0;15,0;1,0;25,0;22,0;40,0;46,0;146,0;18,0;24,0;19,0;3,0;;94,0;81,0;139,0;40,0;16,0;142,0;112,0;18,0;570,0;172,0;2,0;33,0;30,0;437,0;63,0;58,0;75,0;142,0;23,0;82,0;106,0;153,0;33,0;179,0;3,0;186,0;115,0;20,0;2,0;216,0;33,0;95,0;16,0;307,0;42,0;114,0;396,0;21,0;4,0;212,0;6,0;186,0;220,0;277,0;1,0;8,0;11,0;37,0;30,0;118,0;4,0;45,0;22,0;737,0;81,0;294,0;85,0;11,0;62,0;8,0;433,0;23,0;33,0;4,0;110,0;281,0;87,0;10,0;29,0;73,0;87,0;52,0;22,0;124,0;7,0;32,0;596,0;3,0;148,0;10,0;94,0;5,0;3,0;5,0;21,0;207,0;36,0;23,0;217,0;13,0;10,0;46,0;31,0;81,0;19,0;22,0;11,0;4,0;84,0;18,0;288,0;107,0;51,0;4,0;13,0;21,0;23,0;12,0;;34,0;117,0;185,0;111,0;129,0;280,0;40,0;57,0;128,0;7,0;9,0;9,0;105,0;26,0;19,0;81,0;8,0;15,0;19,0;160,0;205,0;6,0;31,0;26,0;29,0;38,0;62,0;2,0;18,0;312,0;11,0;30,0;24,0;15,0;66,0;3,0;26,0;16,0;9,0;28,0;4,0;9,0;;27,0;13,0;4,0;2,0;;;2,0;56,0;4,0;11,0;44,0;29,0;124,0;29,0;11,0;35,0;44,0;5,0;5,0;47,0;3,0;124,0;4,0;24,0;8,0;134,0;17,0;;23,0;44,0;144,0;58,0;44,0;93,0;;2,0;37,0;75,0;31,0;24,0;18,0;10,0;204,0;9,0;40,0;20,0;9,0;24,0;1,0;1,0;111,0;23,0;51,0;90,0;;5,0;14,0;14,0;20,0;1,0;40,0;14,0;3,0;17,0;72,0;110,0;15,0;3,0;41,0;16,0;17,0;3,0;18,0;28,0;175,0;6,0;32,0;13,0;35,0;214,0;51,0;105,0;2,0;46,0;8,0;2,0;14,0;2,0;19,0;57,0;53,0;2,0;55,0;6,0;13,0;180,0;106,0;21,0;39,0;127,0;31,0;;1,0;;8,0;62,0;9,0;6,0;3,0;186,0;5,0;1,0;1,0;2,0;10,0;25,0;7,0;85,0;1,0;5,0;26,0;54,0;14,0;1,0;1,0;5,0;12,0;23,0;13,0;1,0;24,0;22,0;56,0;16,0;70,0;44,0;16,0;39,0;23,0;7,0;70,0;;16,0;6,0;;17,0;83,0;22,0;8,0;12,0;79,0;38,0;8,0;2,0;400,0;3,0;21,0;2,0;6,0;34,0;25,0;96,0;33,0;23,0;;5,0;6,0;27,0;11,0;8,0;32,0;26,0;23,0;14,0;4,0;;2,0;7,0;32,0;20,0;22,0;3,0;;19,0;3,0;10,0;9,0;5,0;10,0;15,0;4,0;80,0;10,0;20,0;8,0;6,0;5,0;3,0;;9,0;28,0;24,0;2,0;28,0;44,0;33,0;8,0;11,0;3,0;18,0;103,0;8,0;6,0;2,0;37,0;2,0;118,0;;;;4,0;17,0;29,0;60,0;8,0;3,0;6,0;;8,0;9,0;;11,0;4,0;;2,0;11,0;2,0;5,0;10,0;;2,0;11,0;6,0;;60,0;1,0;57,0;9,0;62,0;;;;1,0;;24,0;1,0;;2,0;;22,0;29,0;6,0;4,0;6,0;5,0;;;3,0;41,0;2,0;;;18,0;7,0;;;5,0;2,0;8,0;114,0;3,0;9,0;;5,0;55,0;9,0;1,0;96,0;10,0;2,0;3,0;23,0;24,0;11,0;;2,0;;28,0;11,0;5,0;3,0;39,0;;25,0;10,0;20,0;22,0;3,0;16,0;;13,0;7,0;30,0;38,0;;3,0;13,0;7,0;6,0;4,0;12,0;12,0;14,0;13,0;18,0;30,0;19,0;59,0;5,0;27,0;63,0;1,0;76,0;34,0;16,0;21,0;29,0;90,0;27,0;39,0;12,0;4,0;14,0;20,0;36,0;7,0;15,0;26,0;15,0;15,0;53,0;20,0;11,0;67,0;20,0;49,0;2,0;15,0;4,0;20,0;;4,0;;35,0;41,0;1,0;21,0;7,0;17,0;23,0;2,0;22,0;2,0;13,0;28,0;7,0;16,0;54,0;1,0;4,0;42,0;8,0;2,0;37,0;4,0;5,0;4,0;6,0;30,0;1,0;;21,0;4,0;;4,0;35,0;1,0;1,0;12,0;3,0;10,0;16,0;5,0;12,0;44,0;6,0;20,0;;;14,0;2,0;2,0;;;;3,0;;2,0;33,0;6,0;;;5,0;2,0;;;25,0;;3,0;1,0;13,0;4,0;6,0;12,0;;36,0;;1,0;12,0;4,0;13,0;4,0;13,0;11,0;11,0;11,0;28,0;39,0;3,0;11,0;14,0;27,0;;12,0;1,0;1,0;9,0;12,0;;5,0;27,0;27,0;3,0;7,0;19,0;11,0;6,0;92,0;;9,0;17,0;;24,0;9,0;;
cell;1,0;1,0;;;1,0;12,0;78,0;11,0;;;;;;6,0;3,0;;6,0;;;;2,0;;51,0;;;;1,0;1,0;2,0;;28,0;1,0;;;42,0;21,0;11,0;;10,0;2,0;7,0;41,0;;4,0;1,0;9,0;18,0;8,0;;2,0;;;;;4,0;8,0;3,0;;8,0;5,0;;2,0;59,0;;64,0;;89,0;;;;6,0;16,0;30,0;42,0;;;5,0;;;77,0;36,0;;19,0;;14,0;;;6,0;;;;2,0;16,0;18,0;;;151,0;7,0;95,0;12,0;13,0;1,0;;;3,0;;;2,0;;;;35,0;17,0;2,0;;;;10,0;6,0;47,0;5,0;1,0;40,0;3,0;;2,0;9,0;;;;16,0;;;131,0;;;5,0;;;;;2,0;;;1,0;;60,0;16,0;12,0;3,0;;;;;;3,0;;;;7,0;3,0;13,0;1,0;3,0;2,0;;9,0;;;1,0;2,0;;3,0;10,0;;4,0;;;1,0;;1,0;6,0;;4,0;;;1,0;;6,0;9,0;;;;12,0;;;1,0;5,0;1,0;;11,0;23,0;1,0;3,0;8,0;;1,0;;;10,0;;;1,0;;;6,0;35,0;1,0;;1,0;;;;8,0;;;3,0;3,0;2,0;2,0;;;5,0;;4,0;;;;;;;;;;;1,0;;6,0;12,0;;;;;;19,0;4,0;;1,0;1,0;;4,0;1,0;;;;;;3,0;;8,0;;;;1,0;;;2,0;;;28,0;;;;9,0;;;;2,0;46,0;;;;;;2,0;;3,0;;;;;;;3,0;;;;1,0;;12,0;;;2,0;;;;19,0;;2,0;;3,0;1,0;;;;;2,0;;6,0;;;;;;;4,0;;;;;;;;;;;;12,0;;;;;;;;;;;4,0;;;;;;;3,0;2,0;;;;;;4,0;1,0;4,0;;;;3,0;;1,0;;1,0;;;3,0;;8,0;;;;;3,0;3,0;;2,0;2,0;;;;;6,0;10,0;;;9,0;2,0;1,0;;;;;;5,0;5,0;1,0;;;;;;;;;;6,0;3,0;9,0;;;;;3,0;;;;6,0;;7,0;;16,0;3,0;2,0;;;;;;;;;;;;;4,0;;5,0;;2,0;3,0;2,0;2,0;16,0;;29,0;;;2,0;;;;;;;;;;29,0;1,0;;;;;2,0;;1,0;2,0;1,0;;;;;;;;;2,0;;;;4,0;;;;;;;;;;5,0;1,0;;;;;5,0;;;1,0;2,0;;3,0;;;;;1,0;;;;1,0;;;;;;1,0;;;;;1,0;;;;2,0;;;;;;;;14,0;;;;;;4,0;3,0;;;;3,0;;1,0;3,0;;;;2,0;3,0;;2,0;1,0;;;2,0;;;2,0;;2,0;;;1,0;;;;;;;;;;;;;;;;;;;;3,0;1,0;;;3,0;1,0;2,0;;;;;4,0;;;17,0;;1,0;2,0;;;;;;;;;;;;;;2,0;53,0;1,0;;;1,0;;;;;1,0;11,0;;3,0;;2,0;;1,0;;4,0;;2,0;;;6,0;12,0;6,0;;;;;5,0;;;;;;;;32,0;;;;;;;;;;;;;;8,0;;;5,0;;;1,0;;;;;1,0;2,0;;;;;;;;;;9,0;;;;;;;;;;;1,0;;1,0;;;;1,0;1,0;;;;;;5,0;;;;;;;;;;;;;;;;2,0;;;;;;;;;;;;;;;;;;;;;;;;;;1,0;;1,0;;16,0;;;1,0;;2,0;3,0;3,0;;1,0;;;8,0;7,0;;2,0;;4,0;6,0;;2,0;;;;;10,0;;;2,0;;14,0;;5,0;;;;;7,0;;5,0;8,0;;1,0;;21,0;;;14,0;;;;1,0;;;;;5,0;;;;;;;;;;2,0;;;;;;12,0;;;;;2,0;;1,0;;;;;4,0;;;;;;;;;2,0;;;;1,0;;;;;;;;;4,0;;;;;;;;;;;;;;;;1,0;;;;;;1,0;;;;;;;;;;;;;;;2,0;;;;;;1,0;;2,0;;;;;;1,0;;;;;;;;;;;4,0;;;;;;;2,0;;;;;;;;;;;;;1,0;9,0;;;;;;;;;;;;;;;;;1,0;;;1,0;;;;;;
channel;1,0;5,0;;7,0;;33,0;81,0;36,0;;;3,0;6,0;6,0;93,0;47,0;10,0;32,0;;;2,0;;;185,0;10,0;44,0;;3,0;24,0;4,0;;135,0;31,0;5,0;2,0;;139,0;52,0;18,0;23,0;;39,0;87,0;2,0;10,0;3,0;44,0;;52,0;;;4,0;7,0;95,0;3,0;8,0;18,0;95,0;;5,0;21,0;1,0;51,0;6,0;1,0;210,0;1,0;162,0;;2,0;;17,0;68,0;18,0;3,0;;;4,0;;;6,0;82,0;;3,0;1,0;49,0;14,0;;285,0;11,0;28,0;3,0;5,0;18,0;2,0;;;120,0;23,0;291,0;1,0;39,0;78,0;;;9,0;72,0;;5,0;6,0;;;15,0;55,0;;2,0;;2,0;19,0;6,0;51,0;9,0;1,0;122,0;3,0;45,0;4,0;103,0;;;2,0;27,0;;;24,0;;;8,0;2,0;1,0;;2,0;46,0;;;33,0;8,0;1,0;19,0;26,0;8,0;3,0;;30,0;15,0;;27,0;2,0;;;1,0;1,0;44,0;2,0;3,0;9,0;;100,0;12,0;1,0;;19,0;;15,0;9,0;;15,0;;3,0;4,0;;;;;16,0;10,0;1,0;99,0;2,0;38,0;43,0;;;;3,0;7,0;4,0;35,0;3,0;10,0;2,0;2,0;2,0;2,0;;3,0;;17,0;2,0;2,0;84,0;4,0;;3,0;2,0;3,0;11,0;46,0;11,0;4,0;12,0;7,0;3,0;;1,0;58,0;;108,0;;13,0;;11,0;3,0;3,0;;3,0;;2,0;;6,0;18,0;;9,0;6,0;2,0;16,0;34,0;18,0;6,0;80,0;65,0;4,0;3,0;4,0;19,0;26,0;4,0;27,0;57,0;3,0;;50,0;22,0;9,0;30,0;12,0;9,0;;7,0;9,0;4,0;;25,0;3,0;9,0;;1,0;7,0;9,0;8,0;8,0;5,0;4,0;16,0;1,0;;;1,0;2,0;16,0;5,0;3,0;2,0;;4,0;2,0;24,0;12,0;2,0;1,0;23,0;3,0;15,0;1,0;48,0;;5,0;5,0;1,0;;163,0;2,0;12,0;10,0;7,0;38,0;;74,0;9,0;4,0;17,0;14,0;15,0;6,0;5,0;1,0;3,0;;;11,0;;4,0;10,0;9,0;44,0;3,0;;5,0;2,0;1,0;;;2,0;;7,0;2,0;22,0;22,0;14,0;;25,0;1,0;6,0;;;;14,0;2,0;4,0;32,0;13,0;;;;;1,0;;4,0;;;1,0;12,0;;6,0;8,0;67,0;8,0;;1,0;13,0;2,0;47,0;;1,0;;1,0;3,0;;9,0;;;;1,0;9,0;7,0;28,0;7,0;;6,0;3,0;;;32,0;6,0;5,0;1,0;11,0;;;1,0;11,0;;2,0;;12,0;6,0;1,0;1,0;;;;;8,0;;43,0;;102,0;;28,0;1,0;;2,0;2,0;5,0;18,0;5,0;;1,0;4,0;14,0;11,0;;58,0;2,0;;;2,0;;1,0;16,0;;2,0;27,0;4,0;;;2,0;;1,0;3,0;7,0;1,0;7,0;5,0;17,0;2,0;16,0;;;;;;5,0;8,0;3,0;8,0;;;10,0;1,0;;;;52,0;27,0;;;16,0;3,0;;;;;46,0;11,0;24,0;1,0;;2,0;2,0;;13,0;20,0;;;2,0;16,0;4,0;;2,0;1,0;73,0;9,0;;;;;5,0;11,0;8,0;;22,0;14,0;3,0;4,0;2,0;;23,0;3,0;78,0;;2,0;;1,0;15,0;;2,0;;;;;3,0;2,0;3,0;109,0;;;;;22,0;;1,0;1,0;1,0;3,0;7,0;4,0;;;;;;;1,0;;9,0;;3,0;;22,0;;;5,0;1,0;;14,0;9,0;;;16,0;;;;3,0;6,0;7,0;11,0;16,0;;;1,0;11,0;2,0;1,0;4,0;4,0;;;7,0;;1,0;;;;17,0;1,0;2,0;;2,0;13,0;17,0;;8,0;;9,0;;4,0;;;1,0;23,0;;;3,0;;;43,0;;;;;;1,0;3,0;2,0;;8,0;;2,0;1,0;;;8,0;;4,0;;2,0;;;;2,0;;;;;9,0;5,0;6,0;1,0;12,0;;;;2,0;;21,0;;2,0;;7,0;;10,0;2,0;;6,0;1,0;;;3,0;3,0;;;2,0;;13,0;8,0;4,0;1,0;;4,0;;;19,0;;6,0;;10,0;1,0;6,0;;;;;9,0;;1,0;22,0;5,0;6,0;;;;;;1,0;5,0;14,0;;1,0;;;;3,0;;;4,0;;6,0;3,0;;7,0;;2,0;13,0;;3,0;11,0;1,0;3,0;6,0;;10,0;1,0;;3,0;;2,0;;;38,0;;8,0;;4,0;;;;1,0;2,0;3,0;5,0;3,0;;;3,0;;;;;4,0;2,0;9,0;4,0;;2,0;;;;;2,0;;;;7,0;1,0;1,0;;;15,0;;;3,0;;;1,0;;;3,0;;;7,0;;17,0;;;16,0;2,0;4,0;8,0;;5,0;4,0;;;;7,0;;34,0;;;8,0;7,0;18,0;5,0;;;1,0;;;;;;55,0;;;;3,0;1,0;13,0;;;;2,0;;;;;8,0;;;;;;;;7,0;5,0;6,0;;;1,0;;4,0;8,0;;;5,0;;;;35,0;;;;4,0;1,0;;;;;;;;;;;;1,0;;1,0;1,0;;7,0;;;;;;;;;;;;;;;;1,0;2,0;;;;1,0;;1,0;1,0;7,0;;;;2,0;1,0;;;;;;2,0;;1,0;;;4,0;;2,0;1,0;;;;34,0;;3,0;;;;;2,0;;;;;;1,0;;;;;2,0;11,0;6,0;33,0;1,0;;;;;;;;;3,0;;5,0;;2,0;;1,0;;;;;;;1,0;;;;;1,0;;;1,0;;;;;;;;
characteristic;24,0;12,0;;17,0;9,0;24,0;42,0;7,0;;;;2,0;;184,0;;1,0;104,0;;2,0;;;;37,0;1,0;;;1,0;14,0;5,0;5,0;32,0;12,0;5,0;2,0;1,0;185,0;28,0;1,0;1,0;;212,0;85,0;;8,0;37,0;;2,0;9,0;1,0;1,0;5,0;;;4,0;17,0;11,0;3,0;;11,0;52,0;;;15,0;;433,0;;130,0;3,0;9,0;;8,0;95,0;66,0;;;;24,0;3,0;8,0;26,0;153,0;;2,0;10,0;37,0;;3,0;116,0;8,0;16,0;53,0;;;;16,0;;41,0;3,0;73,0;50,0;26,0;27,0;;9,0;20,0;22,0;3,0;6,0;100,0;;;56,0;38,0;;2,0;1,0;13,0;28,0;41,0;42,0;4,0;;27,0;6,0;24,0;50,0;81,0;4,0;;;34,0;;;34,0;7,0;;23,0;6,0;2,0;;;1,0;;2,0;7,0;3,0;8,0;6,0;28,0;2,0;;1,0;10,0;;;;;18,0;;;;1,0;4,0;2,0;;;1,0;;;34,0;13,0;;11,0;3,0;;2,0;;3,0;4,0;;;;;7,0;;;36,0;;33,0;3,0;;;;1,0;;;;2,0;;;;;;1,0;25,0;;;1,0;;6,0;;9,0;;;;;38,0;;;2,0;42,0;8,0;4,0;;1,0;;23,0;;;6,0;;1,0;12,0;3,0;;7,0;2,0;2,0;;5,0;;5,0;;;;27,0;;2,0;4,0;;;;;15,0;;1,0;1,0;24,0;;;;15,0;16,0;139,0;;;3,0;18,0;4,0;6,0;;;;;;;5,0;9,0;;8,0;;4,0;3,0;;4,0;;;;;;;4,0;;;7,0;;19,0;;;;;;;;;;;;5,0;172,0;;;;;;;11,0;;;5,0;4,0;194,0;;1,0;;;;;2,0;3,0;;;;;2,0;;;;;;;2,0;;;;;3,0;6,0;;;;;;;16,0;;1,0;;39,0;;;;;10,0;;3,0;46,0;3,0;;1,0;;2,0;36,0;;22,0;15,0;;;50,0;24,0;32,0;37,0;;;8,0;117,0;9,0;21,0;141,0;4,0;9,0;6,0;20,0;12,0;;7,0;6,0;46,0;9,0;9,0;;28,0;;1,0;2,0;11,0;2,0;2,0;11,0;1,0;;2,0;2,0;13,0;9,0;34,0;;2,0;;4,0;2,0;1,0;;1,0;;17,0;5,0;42,0;8,0;;24,0;;10,0;2,0;4,0;;8,0;29,0;;;9,0;1,0;4,0;;3,0;7,0;;7,0;8,0;2,0;;3,0;7,0;;;;1,0;5,0;;5,0;9,0;6,0;;3,0;;;;;;;41,0;2,0;4,0;1,0;;;8,0;;;5,0;;1,0;7,0;20,0;;;11,0;31,0;6,0;;;9,0;1,0;5,0;;1,0;1,0;;3,0;;;23,0;1,0;1,0;7,0;1,0;1,0;;1,0;3,0;11,0;2,0;;;1,0;14,0;;7,0;;;;3,0;6,0;1,0;;;;;;1,0;;;;;1,0;;;16,0;3,0;24,0;;1,0;;;3,0;3,0;20,0;8,0;;8,0;;;6,0;;4,0;1,0;6,0;;;;1,0;;3,0;4,0;1,0;2,0;59,0;6,0;;;;2,0;;;4,0;;;7,0;;;;;26,0;;2,0;;;;8,0;2,0;;14,0;1,0;4,0;;;;;1,0;;;;3,0;91,0;;15,0;;2,0;4,0;;;1,0;12,0;;;;30,0;23,0;1,0;60,0;;;2,0;6,0;;;;;;1,0;;;1,0;;3,0;;;;;10,0;3,0;;;;4,0;1,0;;;;;;3,0;1,0;;;;6,0;1,0;6,0;1,0;;2,0;4,0;6,0;4,0;;;;;7,0;17,0;1,0;1,0;7,0;2,0;2,0;;;53,0;17,0;;;;3,0;1,0;;8,0;;;;1,0;;;1,0;;1,0;;1,0;;;;3,0;4,0;12,0;6,0;;;2,0;;;;;;4,0;;25,0;;;7,0;4,0;;;;;;;;;2,0;4,0;;1,0;;;3,0;;;;2,0;;22,0;;;;;;;;;1,0;;;;;4,0;;;;;2,0;;1,0;4,0;;;1,0;;;;;;;6,0;;;;;;;;;;;;2,0;3,0;;3,0;;;;;2,0;;;;2,0;1,0;;;;;;8,0;;12,0;;;26,0;;;20,0;;;;41,0;3,0;;;;;32,0;1,0;;;;;;20,0;;;;13,0;;4,0;;;2,0;4,0;;;;;2,0;2,0;1,0;12,0;;;1,0;;;1,0;;;1,0;14,0;;;;3,0;;;12,0;;;;;2,0;;;1,0;3,0;2,0;5,0;;;;;;;;25,0;;;17,0;;;;1,0;;;3,0;6,0;1,0;;;;3,0;;;2,0;;;;;;4,0;;;;;10,0;;;;;;1,0;;;;;;;;;8,0;7,0;;;1,0;;;1,0;;;;;1,0;;;7,0;;;;;;;;3,0;;;;;;;;;;;3,0;4,0;;12,0;;;;;;;;;;2,0;;13,0;1,0;;;;;;;;;;2,0;;;;;;;;;1,0;;;
chip;3,0;;;12,0;3,0;24,0;30,0;11,0;;;;10,0;;11,0;2,0;;92,0;2,0;;;;;28,0;;32,0;;;13,0;;;95,0;2,0;;;;72,0;10,0;1,0;;;5,0;56,0;11,0;4,0;;32,0;;36,0;;;;;2,0;3,0;12,0;;82,0;;;5,0;3,0;7,0;4,0;9,0;598,0;13,0;130,0;;2,0;;;160,0;29,0;;;;8,0;;;21,0;51,0;;1,0;;55,0;;;65,0;2,0;1,0;;5,0;;11,0;;;79,0;2,0;70,0;16,0;11,0;3,0;;20,0;77,0;64,0;;;;;;;58,0;;3,0;2,0;;28,0;;374,0;;;144,0;3,0;2,0;4,0;41,0;;3,0;1,0;10,0;;;38,0;;;16,0;;2,0;;;8,0;;;;1,0;4,0;42,0;;;;7,0;4,0;12,0;;;;8,0;;;28,0;72,0;;;;;36,0;28,0;;1,0;9,0;;11,0;3,0;;7,0;5,0;1,0;2,0;11,0;;1,0;5,0;5,0;;11,0;24,0;1,0;3,0;;;;8,0;;5,0;34,0;15,0;36,0;2,0;6,0;5,0;62,0;;;3,0;;22,0;;1,0;74,0;8,0;;2,0;;;3,0;42,0;2,0;8,0;13,0;1,0;;;4,0;16,0;;36,0;;;21,0;;;;;;;2,0;8,0;;;;10,0;;;2,0;;3,0;2,0;44,0;;5,0;11,0;10,0;25,0;53,0;13,0;67,0;56,0;6,0;;6,0;19,0;13,0;4,0;1,0;;;;1,0;;;49,0;1,0;5,0;;;;;;3,0;;1,0;1,0;28,0;;;9,0;2,0;120,0;4,0;5,0;;2,0;;;;;7,0;;;3,0;;2,0;;;1,0;;7,0;;49,0;;;;;2,0;;13,0;;6,0;;3,0;6,0;5,0;;;15,0;;;5,0;20,0;;;;10,0;;;;;;;1,0;;;;1,0;;;1,0;;;;;3,0;;;1,0;1,0;;27,0;;;;;;;3,0;;;;;;;;3,0;;;;;1,0;;17,0;;;;;3,0;;;;;6,0;3,0;;5,0;;;;2,0;1,0;;;15,0;37,0;;;1,0;1,0;;;2,0;;8,0;;2,0;2,0;;;;;;;;;9,0;;47,0;;;;;1,0;;4,0;;;;;;;;;;8,0;;;;;;;;;4,0;;;;1,0;;;;9,0;4,0;;;2,0;;8,0;;;;;;;5,0;24,0;1,0;2,0;2,0;;5,0;;;;5,0;1,0;5,0;;5,0;;1,0;;;;3,0;2,0;;;;;3,0;;;;10,0;;;;;;;;1,0;;;27,0;;5,0;;;;1,0;35,0;4,0;1,0;1,0;;;;;;;;;2,0;2,0;;1,0;2,0;;;;;;3,0;8,0;;;;;1,0;;;;;1,0;;1,0;;;;;;;1,0;1,0;;;;;3,0;34,0;;;;12,0;6,0;1,0;;2,0;;;1,0;;;2,0;;;;;;7,0;3,0;;;;;;5,0;2,0;1,0;;;;;;;;;2,0;;1,0;;1,0;;;4,0;;;;;50,0;;;;;;;;;;;;1,0;;;20,0;;;;;3,0;;8,0;;;;;;;;3,0;3,0;;;;;;;1,0;10,0;6,0;;2,0;;6,0;;;;;;;5,0;;;;;1,0;2,0;;;;;;;;;;2,0;16,0;2,0;;;;3,0;;6,0;10,0;;;;;2,0;2,0;2,0;1,0;1,0;;;;;;;;;2,0;;;;2,0;;;;2,0;;;;;;;;;;;1,0;;5,0;;7,0;;;;;;1,0;;;;;;;;;;3,0;;;;12,0;;;;;;;;;3,0;8,0;;;;;;;;;;;;;1,0;;;;;10,0;;;;;;;2,0;;;;16,0;10,0;4,0;;;;;4,0;;;;;;;;;;;;;;62,0;;;;;;;;2,0;;1,0;1,0;;10,0;;14,0;;;;;16,0;;;;;4,0;;;;;;;;;;;;;;;;;;4,0;;;;;;;;;3,0;1,0;;;;;2,0;;;;;;;;;;;;;;;;;6,0;;1,0;;;;;;;;;;;;;38,0;;1,0;;;;;;1,0;;2,0;;;;;;3,0;;;;;3,0;;;;;;;;;;;;;;2,0;;;;;;;;;;;;;;;;;;;;;;48,0;;;;;;;;;1,0;9,0;;;;;;;3,0;;;;;;;;;1,0;;;;;;;;;;
circle;4,0;;;34,0;2,0;11,0;6,0;3,0;;;;;2,0;8,0;;2,0;3,0;;;;;;7,0;;;;;;1,0;;6,0;1,0;;;;8,0;22,0;6,0;1,0;;44,0;16,0;57,0;;10,0;2,0;4,0;;1,0;;1,0;;;;;32,0;10,0;;;;;;4,0;;127,0;;12,0;;;5,0;3,0;30,0;7,0;;;;;;;;34,0;2,0;;;1,0;;;7,0;;;4,0;1,0;;;;;56,0;1,0;16,0;33,0;17,0;4,0;;6,0;12,0;;;;;;;18,0;110,0;;;;1,0;;;4,0;;;7,0;50,0;;;14,0;;2,0;;2,0;2,0;1,0;10,0;10,0;;4,0;4,0;15,0;2,0;;7,0;;;4,0;5,0;12,0;1,0;2,0;;;;3,0;;;;1,0;;2,0;;;2,0;;;;;;;;;;;1,0;9,0;;3,0;;3,0;;;2,0;;;3,0;;1,0;;;;;2,0;;;;2,0;5,0;;;43,0;;;1,0;;;8,0;;1,0;;;2,0;2,0;;7,0;2,0;;39,0;2,0;;;2,0;1,0;;;;;;6,0;;;;;1,0;12,0;22,0;;1,0;;3,0;;6,0;;;;;;;;11,0;4,0;;5,0;;;2,0;;;;3,0;;;;;;;;;1,0;;;;;;;;;;;2,0;2,0;;;;8,0;1,0;;;;;;2,0;;;3,0;;36,0;1,0;46,0;;;1,0;;;;;;;;1,0;3,0;10,0;;;16,0;;;;11,0;;;;;6,0;;2,0;;;;;;;;;;;;;;;;;5,0;4,0;;;;;4,0;3,0;;;;;4,0;;;1,0;;2,0;;;;;;1,0;;4,0;;;;;;;3,0;80,0;1,0;;;;;;2,0;2,0;;2,0;4,0;2,0;23,0;;;;2,0;1,0;;;;1,0;;;;;;4,0;;4,0;;8,0;4,0;;;;;;;1,0;;1,0;;4,0;;;;;;;1,0;1,0;;;;;;;26,0;;2,0;;;5,0;;;;;2,0;;1,0;1,0;;;1,0;;;;;51,0;;;2,0;;;8,0;4,0;;1,0;;;;;;;;;5,0;;2,0;;;;;;;;;;;;;2,0;;1,0;;;;;5,0;;;;;;;;;;;;2,0;;;;;;;;;;2,0;;;;;;;;2,0;;;;;;;2,0;3,0;;4,0;1,0;;4,0;;2,0;;;3,0;;1,0;;;;;;;;;;;;;;;;;;;;;;;;;;;;;;;;1,0;;;1,0;;;;;;;;;;;85,0;;;;3,0;;;;4,0;;;;;;;;;;;;;1,0;;;;;;2,0;;;;;;;16,0;;;;;;;;;;;;;;;;;;;;;;;;;;;;;1,0;;3,0;;;;8,0;14,0;;;;1,0;;;;;;;1,0;;;;;;;1,0;3,0;;;;;;;;9,0;;;;;;;1,0;;1,0;;1,0;;;;;;1,0;;;;;;2,0;;1,0;;;;;;;2,0;6,0;;;;;;;;;;;;;;;9,0;;;3,0;;;2,0;4,0;;;;5,0;;;;;;;;;;;6,0;;;;;;;;;;;;1,0;;;;;;;;;;;;2,0;;;;;;;2,0;;;;;;;;;;;;;;;;;;;;;2,0;1,0;;;;;;;;;;;;;;;;;;;;;;;2,0;;;;1,0;;;;;2,0;;;;;;;;;5,0;;;;;;3,0;;;;;;;;;;;;;;;;1,0;;;;1,0;;;;;;;;;;;;;1,0;;;;;;;;;;;;;;1,0;;;;;3,0;;;;;;;;;;;;;;;;;;;;;5,0;;;;;;;;;;;;;;;2,0;;;;;;;;;3,0;;;;;;;;;1,0;;;;;5,0;;;;;2,0;;3,0;5,0;;;;;;;;;;;;;;;2,0;2,0;;;;;;;;
color;1,0;;13,0;115,0;25,0;105,0;402,0;11,0;;22,0;;32,0;;450,0;193,0;95,0;154,0;51,0;185,0;37,0;28,0;7,0;;;2,0;2,0;16,0;477,0;19,0;18,0;174,0;27,0;67,0;104,0;3,0;614,0;34,0;10,0;165,0;15,0;324,0;346,0;;105,0;190,0;75,0;;70,0;29,0;47,0;28,0;4,0;16,0;4,0;25,0;19,0;116,0;;4,0;227,0;;231,0;108,0;;2632,0;22,0;391,0;16,0;20,0;;3,0;69,0;588,0;13,0;2,0;2,0;60,0;18,0;4,0;24,0;407,0;5,0;50,0;32,0;113,0;40,0;4,0;35,0;;62,0;38,0;11,0;48,0;2,0;22,0;;1591,0;45,0;716,0;108,0;76,0;78,0;4,0;68,0;87,0;80,0;93,0;16,0;6,0;;13,0;159,0;370,0;36,0;;32,0;81,0;74,0;66,0;395,0;45,0;17,0;276,0;72,0;44,0;51,0;193,0;;39,0;13,0;163,0;2,0;2,0;247,0;8,0;1,0;77,0;5,0;8,0;;;42,0;;;19,0;99,0;132,0;121,0;164,0;20,0;;192,0;15,0;;9,0;2,0;;7,0;3,0;;;8,0;77,0;75,0;11,0;15,0;31,0;34,0;5,0;22,0;;6,0;18,0;35,0;1,0;80,0;14,0;40,0;5,0;1,0;3,0;;12,0;10,0;;22,0;1110,0;;128,0;5,0;6,0;3,0;;2,0;;8,0;7,0;24,0;20,0;1,0;9,0;189,0;;;24,0;27,0;3,0;;1,0;7,0;6,0;14,0;1,0;2,0;3,0;12,0;153,0;;;1,0;196,0;3,0;7,0;22,0;3,0;;147,0;;8,0;45,0;;8,0;59,0;57,0;4,0;7,0;2,0;;;64,0;;85,0;;;;68,0;9,0;43,0;40,0;;;;18,0;23,0;60,0;;;67,0;21,0;;2,0;33,0;63,0;58,0;;2,0;;56,0;27,0;5,0;1,0;5,0;14,0;28,0;;;1,0;7,0;;33,0;;2,0;51,0;;11,0;;55,0;109,0;3,0;3,0;;9,0;;;8,0;1,0;40,0;4,0;;;;;;;;1,0;;6,0;15,0;103,0;2,0;;6,0;;45,0;;48,0;;5,0;;2,0;145,0;18,0;15,0;6,0;2,0;4,0;;8,0;2,0;;;;1,0;53,0;15,0;;;1,0;;6,0;1,0;;;;2,0;18,0;329,0;3,0;;;;27,0;;24,0;;3,0;14,0;99,0;;;;;1,0;;164,0;16,0;1,0;;3,0;;;165,0;4,0;65,0;29,0;2,0;23,0;51,0;22,0;55,0;16,0;3,0;6,0;2,0;83,0;45,0;103,0;19,0;2,0;;35,0;81,0;47,0;2,0;29,0;4,0;83,0;39,0;10,0;;57,0;2,0;63,0;6,0;59,0;55,0;3,0;12,0;2,0;;9,0;7,0;24,0;17,0;5,0;4,0;1,0;;3,0;;15,0;1,0;31,0;9,0;128,0;4,0;51,0;;;60,0;;61,0;;2,0;;22,0;90,0;7,0;3,0;299,0;5,0;33,0;;19,0;16,0;1,0;1,0;22,0;;11,0;;11,0;2,0;;4,0;4,0;73,0;;21,0;25,0;19,0;;82,0;4,0;48,0;3,0;1,0;1,0;;5,0;27,0;27,0;7,0;1,0;;6,0;1,0;3,0;5,0;;46,0;;58,0;14,0;;113,0;2,0;3,0;6,0;1,0;;52,0;41,0;28,0;1,0;8,0;;;;89,0;27,0;2,0;;4,0;16,0;10,0;;;32,0;6,0;32,0;1,0;;8,0;25,0;9,0;9,0;2,0;;1,0;1,0;17,0;11,0;1,0;;;;;;;;;9,0;15,0;;6,0;13,0;7,0;66,0;3,0;4,0;6,0;78,0;16,0;1,0;;18,0;;6,0;;;8,0;19,0;1,0;10,0;6,0;7,0;;;13,0;;;;20,0;1,0;13,0;;;1,0;;3,0;;1,0;12,0;7,0;19,0;8,0;;;94,0;;11,0;4,0;4,0;;;21,0;35,0;28,0;;6,0;;16,0;;4,0;;;28,0;;1,0;;8,0;55,0;45,0;2,0;;52,0;66,0;;72,0;;8,0;1,0;2,0;;7,0;6,0;3,0;26,0;;;75,0;6,0;3,0;64,0;;3,0;;42,0;6,0;;1,0;12,0;;;1,0;;;32,0;;2,0;5,0;;;90,0;;6,0;;;1,0;1,0;22,0;;22,0;8,0;59,0;;67,0;25,0;5,0;4,0;;2,0;3,0;1,0;2,0;;;3,0;79,0;;5,0;4,0;7,0;15,0;;2,0;40,0;;;2,0;;8,0;4,0;1,0;5,0;1,0;;;2,0;1,0;;;7,0;1,0;;8,0;4,0;;3,0;1,0;16,0;2,0;4,0;;;20,0;;87,0;;1,0;2,0;31,0;1,0;37,0;;;;4,0;17,0;7,0;2,0;;5,0;1,0;;;6,0;25,0;1,0;;;2,0;16,0;1,0;;;13,0;;35,0;;1,0;;;2,0;;23,0;2,0;5,0;;;;;34,0;;6,0;;2,0;;;;;;;;;;;;4,0;2,0;7,0;;;;4,0;;8,0;;2,0;;2,0;6,0;11,0;19,0;;31,0;;;;;19,0;2,0;;;153,0;;;;;;;23,0;;37,0;;1,0;45,0;84,0;;6,0;;7,0;;6,0;9,0;;18,0;7,0;2,0;17,0;6,0;4,0;21,0;7,0;2,0;2,0;14,0;;17,0;4,0;13,0;;2,0;6,0;4,0;5,0;;;4,0;;;11,0;4,0;;12,0;2,0;2,0;;20,0;8,0;4,0;82,0;2,0;11,0;18,0;;;;12,0;20,0;;5,0;;3,0;1,0;;;;6,0;1,0;;3,0;11,0;5,0;3,0;6,0;37,0;;;7,0;1,0;4,0;1,0;1,0;;;22,0;;6,0;4,0;47,0;1,0;;3,0;;2,0;;;;;3,0;;13,0;;;44,0;;6,0;3,0;3,0;;5,0;;2,0;;;;;;;;3,0;2,0;3,0;1,0;35,0;3,0;1,0;;;;14,0;9,0;;;;;;;;1,0;;;;;;;;7,0;;1,0;;;;4,0;2,0;46,0;103,0;;4,0;21,0;;5,0;3,0;20,0;2,0;;;3,0;;3,0;34,0;10,0;140,0;30,0;2,0;;;;;5,0;;3,0;20,0;;11,0;57,0;;;1,0;2,0;;;;;;;
communicate;2,0;9,0;;;;29,0;;10,0;;;;1,0;1,0;42,0;1,0;;41,0;;10,0;1,0;;;;;172,0;;;6,0;22,0;4,0;199,0;22,0;;;;132,0;15,0;;5,0;;15,0;326,0;;42,0;31,0;4,0;;17,0;;;2,0;;;30,0;;2,0;14,0;;2,0;5,0;;;3,0;1,0;144,0;1,0;44,0;;;;2,0;75,0;9,0;;;;1,0;6,0;3,0;15,0;80,0;;32,0;1,0;64,0;2,0;;7,0;;;9,0;;4,0;14,0;;;12,0;;46,0;14,0;16,0;1,0;;9,0;15,0;66,0;6,0;9,0;;;;1,0;3,0;;1,0;;2,0;5,0;9,0;36,0;4,0;4,0;138,0;4,0;;10,0;65,0;;3,0;;3,0;;;111,0;;;5,0;;1,0;;;2,0;4,0;;4,0;1,0;8,0;10,0;7,0;2,0;;;48,0;;;;;;;;;13,0;6,0;;;;7,0;;;7,0;1,0;;24,0;2,0;;3,0;2,0;;15,0;2,0;;;6,0;3,0;;2,0;;;8,0;2,0;;;4,0;2,0;1,0;49,0;10,0;;3,0;14,0;;1,0;1,0;;1,0;6,0;4,0;4,0;7,0;18,0;;5,0;;;;3,0;3,0;;;3,0;6,0;10,0;1,0;;1,0;;66,0;3,0;;2,0;;5,0;5,0;;;;;;;;;2,0;;;2,0;6,0;4,0;;7,0;;3,0;;;8,0;;;;10,0;3,0;;5,0;17,0;4,0;32,0;2,0;;;;;3,0;;26,0;3,0;4,0;1,0;;8,0;1,0;;;;;3,0;6,0;;;;4,0;3,0;;;1,0;;;;;7,0;2,0;;;;;;;;30,0;;5,0;;28,0;;;;;;;4,0;3,0;4,0;6,0;22,0;16,0;1,0;;;;5,0;;19,0;;;;;31,0;12,0;;1,0;;;;;5,0;;1,0;;8,0;7,0;24,0;;;;;;1,0;4,0;;2,0;;60,0;97,0;;;;;;;;;7,0;;;;2,0;;4,0;;2,0;11,0;;;128,0;1,0;;2,0;;8,0;1,0;;;19,0;;8,0;;7,0;;4,0;;14,0;11,0;1,0;;21,0;;4,0;;17,0;7,0;10,0;13,0;3,0;3,0;2,0;;9,0;30,0;4,0;;;;;;8,0;;;;41,0;36,0;9,0;;1,0;2,0;15,0;6,0;1,0;4,0;;6,0;2,0;;13,0;4,0;30,0;5,0;;;2,0;;3,0;38,0;;3,0;;2,0;;;12,0;;31,0;4,0;;23,0;;;;;3,0;;;;1,0;2,0;1,0;26,0;56,0;;;;3,0;;;;;4,0;2,0;2,0;4,0;17,0;1,0;10,0;;;1,0;;;8,0;;6,0;4,0;;;;10,0;;;;7,0;1,0;2,0;1,0;;16,0;;1,0;2,0;;11,0;;;1,0;1,0;12,0;10,0;;;;;3,0;1,0;;;2,0;;;;8,0;7,0;1,0;;;1,0;1,0;;;14,0;;8,0;;;5,0;;;;;;9,0;2,0;;4,0;;;15,0;;2,0;;1,0;;;;6,0;1,0;4,0;;;3,0;;;;;;7,0;;;;3,0;1,0;5,0;;14,0;;;11,0;4,0;3,0;;4,0;;;;;;;2,0;;1,0;3,0;18,0;;2,0;;;;;;;5,0;;;10,0;1,0;;;1,0;;4,0;21,0;;;;;6,0;;;2,0;90,0;;;;1,0;;;5,0;;;;2,0;5,0;;;16,0;;;;;2,0;;;;;;4,0;;1,0;18,0;;1,0;;3,0;14,0;;9,0;9,0;9,0;;5,0;;;;2,0;15,0;;;3,0;22,0;2,0;2,0;1,0;1,0;;1,0;;;;4,0;;;15,0;;3,0;5,0;6,0;;;;4,0;3,0;2,0;;;;8,0;;;;1,0;;7,0;;3,0;17,0;;11,0;;;;;;;2,0;;2,0;;;;;8,0;;;4,0;;4,0;6,0;;;;1,0;;;;;;;;2,0;2,0;;;;;;;;;2,0;;;;1,0;;;4,0;;;;;;;;1,0;;1,0;;2,0;;;1,0;;2,0;9,0;1,0;;;;4,0;;;;;;2,0;;;;2,0;1,0;;;;;;;2,0;;;;2,0;;;;;;;;;;;;;;;1,0;;;1,0;;;;;;;;;;;;;;;2,0;;;;;1,0;;;;;;;2,0;;;;3,0;;;;;;12,0;;1,0;;;;;;1,0;;;1,0;;3,0;;;;;;;;;;2,0;;;;;6,0;;;3,0;;;;1,0;;;;;;;2,0;;;;;;;;;16,0;;;;3,0;;;;;;;;;;;;;;;;;;;;;;;;;;;;;;;;;;;;;;;;;;;;;;;;;;1,0;;;1,0;;;1,0;;;;;;;;;;;;;;;;;;;
communication;2,0;36,0;;6,0;;99,0;18,0;26,0;;1,0;1,0;8,0;6,0;75,0;;;80,0;;44,0;;32,0;;2,0;172,0;;;;18,0;64,0;42,0;363,0;169,0;4,0;4,0;;416,0;10,0;;3,0;;49,0;980,0;;81,0;125,0;34,0;;66,0;;;14,0;4,0;2,0;74,0;25,0;2,0;14,0;;19,0;30,0;;;37,0;7,0;263,0;3,0;187,0;3,0;4,0;;13,0;255,0;55,0;2,0;;1,0;;7,0;6,0;111,0;252,0;;164,0;2,0;240,0;1,0;4,0;30,0;1,0;4,0;20,0;;9,0;14,0;15,0;;6,0;2,0;80,0;38,0;57,0;20,0;;3,0;70,0;259,0;2,0;9,0;3,0;;;4,0;9,0;;2,0;1,0;2,0;11,0;3,0;139,0;2,0;;263,0;7,0;;49,0;366,0;;8,0;;75,0;;;628,0;;8,0;24,0;;7,0;;;1,0;11,0;;10,0;25,0;16,0;33,0;24,0;5,0;;2,0;256,0;;;1,0;;2,0;;;9,0;106,0;7,0;5,0;;;95,0;5,0;;16,0;21,0;3,0;23,0;24,0;;;43,0;1,0;66,0;9,0;2,0;21,0;1,0;3,0;2,0;;5,0;;41,0;14,0;2,0;;1,0;30,0;1,0;14,0;58,0;4,0;6,0;2,0;;2,0;10,0;;1,0;24,0;23,0;1,0;26,0;51,0;7,0;11,0;;;1,0;2,0;55,0;12,0;;86,0;3,0;59,0;4,0;;5,0;;15,0;;2,0;2,0;1,0;14,0;56,0;;8,0;2,0;;1,0;;3,0;;;;;7,0;10,0;12,0;1,0;10,0;2,0;3,0;;;2,0;8,0;34,0;26,0;21,0;1,0;;19,0;198,0;1,0;162,0;;3,0;2,0;2,0;;3,0;2,0;21,0;1,0;4,0;3,0;;15,0;14,0;;6,0;7,0;;4,0;11,0;;;2,0;8,0;156,0;2,0;2,0;14,0;4,0;;1,0;8,0;7,0;7,0;;3,0;;;;;12,0;;1,0;16,0;;55,0;;2,0;3,0;;;;29,0;2,0;3,0;22,0;137,0;14,0;;3,0;3,0;;27,0;;100,0;2,0;1,0;4,0;7,0;1,0;15,0;;1,0;;3,0;;7,0;13,0;6,0;;2,0;5,0;6,0;5,0;;;;3,0;;;9,0;10,0;1,0;;179,0;547,0;1,0;;;;3,0;2,0;1,0;6,0;5,0;4,0;1,0;2,0;6,0;3,0;26,0;6,0;3,0;32,0;1,0;;329,0;8,0;;1,0;3,0;30,0;6,0;3,0;1,0;7,0;1,0;47,0;;10,0;21,0;22,0;5,0;10,0;26,0;;;41,0;4,0;17,0;;30,0;2,0;18,0;7,0;26,0;1,0;4,0;;40,0;95,0;16,0;;7,0;;;;17,0;;3,0;14,0;273,0;96,0;65,0;3,0;;15,0;6,0;47,0;2,0;38,0;1,0;34,0;9,0;81,0;18,0;3,0;200,0;6,0;3,0;3,0;11,0;;;89,0;;;34,0;10,0;8,0;;10,0;1,0;2,0;;22,0;44,0;5,0;6,0;;21,0;2,0;;1,0;;1,0;5,0;2,0;42,0;283,0;7,0;;;109,0;9,0;4,0;;;17,0;2,0;18,0;5,0;182,0;16,0;17,0;;;;;;38,0;;11,0;14,0;6,0;;4,0;25,0;4,0;1,0;;1,0;13,0;18,0;;;28,0;;3,0;5,0;;76,0;;7,0;;1,0;75,0;34,0;;;;;7,0;;73,0;2,0;;;1,0;10,0;2,0;21,0;7,0;;4,0;3,0;1,0;;;80,0;4,0;5,0;1,0;2,0;146,0;;;4,0;5,0;;75,0;7,0;;;3,0;;48,0;9,0;4,0;1,0;4,0;4,0;9,0;5,0;18,0;6,0;;;2,0;;2,0;;;3,0;;31,0;;5,0;3,0;15,0;15,0;;;35,0;7,0;2,0;21,0;16,0;2,0;4,0;4,0;;5,0;1,0;3,0;3,0;;4,0;;3,0;5,0;26,0;;4,0;;;3,0;2,0;;1,0;19,0;3,0;7,0;9,0;2,0;18,0;22,0;;;3,0;14,0;;;;2,0;9,0;;3,0;4,0;250,0;;5,0;;4,0;1,0;4,0;11,0;1,0;1,0;7,0;;91,0;1,0;;42,0;;;22,0;7,0;;2,0;3,0;;9,0;;1,0;;48,0;33,0;1,0;4,0;;;39,0;;16,0;63,0;32,0;1,0;37,0;;;16,0;;12,0;;;1,0;37,0;65,0;20,0;8,0;1,0;;;1,0;;3,0;33,0;2,0;;113,0;;;;3,0;1,0;2,0;;11,0;25,0;2,0;;6,0;;3,0;;6,0;;;;9,0;;5,0;98,0;1,0;16,0;;;4,0;6,0;1,0;6,0;3,0;2,0;1,0;2,0;25,0;;;2,0;1,0;;7,0;2,0;;14,0;;;2,0;2,0;;;5,0;1,0;;;;7,0;8,0;;;;;;;2,0;;2,0;;;;;;;5,0;;;1,0;;;;;;4,0;3,0;;;;;;;1,0;2,0;1,0;;;;4,0;;;;2,0;;2,0;;2,0;;;2,0;2,0;;;;;;;;;;1,0;;3,0;3,0;;;;2,0;;1,0;;1,0;;;2,0;;1,0;;;;;;1,0;1,0;;4,0;1,0;;;;;6,0;;3,0;;8,0;;;3,0;;5,0;11,0;;;;13,0;;2,0;3,0;4,0;2,0;2,0;;1,0;;31,0;1,0;;;1,0;;;;2,0;;3,0;;1,0;4,0;;;;;;;;1,0;6,0;;;;;2,0;7,0;11,0;2,0;4,0;3,0;;;2,0;3,0;;;;;2,0;;;;5,0;;15,0;1,0;3,0;1,0;29,0;;;;2,0;;;;6,0;;2,0;;;7,0;;7,0;;;3,0;;2,0;7,0;;;;31,0;2,0;;;;;;;;4,0;;;;;2,0;;2,0;;;;2,0;;;;4,0;;13,0;;;;;;1,0;;3,0;16,0;;;2,0;;;1,0;;;;;;;;;;;;;
compensate;7,0;;;10,0;2,0;12,0;2,0;2,0;;2,0;;;6,0;18,0;;15,0;42,0;;;;;;2,0;;;;19,0;5,0;5,0;7,0;85,0;5,0;3,0;3,0;;43,0;;;4,0;2,0;16,0;10,0;;10,0;3,0;;37,0;23,0;;88,0;4,0;;;3,0;8,0;15,0;2,0;;17,0;24,0;1,0;;17,0;;228,0;3,0;18,0;1,0;1,0;;11,0;103,0;11,0;;;;;20,0;;3,0;37,0;;;;31,0;1,0;;77,0;1,0;12,0;4,0;11,0;;;;;28,0;3,0;18,0;5,0;27,0;7,0;3,0;3,0;3,0;9,0;1,0;4,0;;;1,0;17,0;1,0;;1,0;7,0;;;1,0;18,0;4,0;;13,0;4,0;1,0;2,0;44,0;;;1,0;15,0;;;60,0;;1,0;19,0;;17,0;;;;;;1,0;8,0;2,0;1,0;8,0;;;;1,0;;;;;;;;;1,0;;2,0;;;1,0;1,0;;4,0;1,0;9,0;;30,0;;;;;;;;;;1,0;;;8,0;;37,0;;;2,0;;;;;3,0;;2,0;;;;;1,0;4,0;3,0;3,0;;2,0;4,0;20,0;33,0;19,0;;;;4,0;;;8,0;4,0;;;;2,0;;8,0;;;1,0;;;3,0;4,0;;2,0;;;;;;;;;;11,0;;;;;;;;;;;1,0;3,0;;;5,0;;;4,0;;;;;;;3,0;;24,0;2,0;;;3,0;6,0;;;;2,0;24,0;1,0;;;4,0;;15,0;;1,0;;;;;;8,0;2,0;;;;;3,0;;;;;2,0;;3,0;;;;;;;3,0;;1,0;2,0;5,0;8,0;;;;;1,0;;3,0;2,0;;;;;;;;;;;;8,0;;;1,0;;;1,0;;;3,0;;;;2,0;2,0;;;14,0;;;;;;;2,0;;5,0;;;;;6,0;;5,0;1,0;;3,0;4,0;;19,0;2,0;;1,0;;7,0;;8,0;2,0;;2,0;;;3,0;;12,0;;;;;;1,0;;8,0;;5,0;4,0;1,0;34,0;;;4,0;;3,0;5,0;4,0;;2,0;;;;5,0;;;;3,0;;;;5,0;;2,0;2,0;;3,0;;1,0;1,0;;;2,0;;1,0;13,0;1,0;;9,0;;3,0;;;2,0;1,0;;4,0;;;6,0;;3,0;1,0;;1,0;8,0;;;1,0;;;;;;5,0;;;;;;1,0;;1,0;;;1,0;;;9,0;1,0;1,0;;;;1,0;;2,0;;1,0;;;13,0;;;;;;1,0;;;;;;;;;;2,0;;1,0;;;;6,0;;;;3,0;;;;;;;;3,0;4,0;;;;;;;;;1,0;;;;4,0;;;;;;;;;;;;;;;;3,0;1,0;;;;;4,0;;2,0;;;7,0;4,0;1,0;;;;;;;;3,0;;;;;1,0;;;3,0;;;;;;;;;;;10,0;;;;;8,0;;1,0;;3,0;;;;1,0;;;4,0;;;;;;;;;;;;;;;;;;;;1,0;1,0;;;;;;;;;;;3,0;;;;;;;6,0;3,0;;;;;3,0;;;;;;4,0;;;;;1,0;;;1,0;;;;;;;;;;;;;;;;2,0;;;;;;;;;2,0;;;;;;3,0;;;1,0;;;;;;1,0;3,0;;;;;1,0;;;;;1,0;;;;;7,0;2,0;;;6,0;;;;;;;;;;;1,0;;;;;2,0;;;4,0;;;;5,0;;;;;2,0;;;;;;;;;;;;;;;;;1,0;1,0;11,0;3,0;;;;;2,0;3,0;;;;2,0;;;;;;;4,0;;;;;;;;30,0;;;;;;12,0;;;;;;;;;;1,0;6,0;;;;2,0;;4,0;1,0;;;;1,0;;;;;;;;;;1,0;;;;;;;2,0;;;;;;1,0;;;;;;;;;;;;;;;;2,0;;;;;1,0;15,0;;;;1,0;4,0;;;;;;;1,0;;;;;;;;1,0;;;;;;;;;;;;2,0;;;1,0;;;1,0;;;;4,0;4,0;;;;;;;;2,0;;;;;1,0;;72,0;;;;;;;;;1,0;;;;;;;;11,0;;;;;;;;;;;;1,0;;;;2,0;;;;;;5,0;;;;;;;;;;;;2,0;;;;;;
compensation;1,0;;;39,0;11,0;17,0;4,0;3,0;;;;;4,0;17,0;;6,0;9,0;1,0;3,0;1,0;;;16,0;;;19,0;;15,0;2,0;5,0;47,0;5,0;2,0;;;23,0;;;;;57,0;62,0;;1,0;4,0;7,0;6,0;;;3,0;2,0;;;;5,0;4,0;11,0;;7,0;16,0;1,0;;1,0;;60,0;;25,0;2,0;;;1,0;123,0;8,0;;;2,0;1,0;1,0;;5,0;83,0;;1,0;;56,0;8,0;;22,0;;;15,0;;1,0;;;;10,0;;20,0;7,0;72,0;17,0;;3,0;9,0;6,0;1,0;2,0;;;;34,0;;;;;;;;21,0;;4,0;32,0;2,0;;2,0;32,0;;17,0;8,0;11,0;;;57,0;;;4,0;3,0;27,0;;;;1,0;;2,0;7,0;;4,0;13,0;;9,0;2,0;1,0;1,0;;;;;;;;6,0;;;;;3,0;;;6,0;4,0;;;16,0;;;;;4,0;1,0;;;;11,0;;2,0;8,0;6,0;13,0;;4,0;;;;;;5,0;3,0;3,0;;;;8,0;;3,0;4,0;33,0;2,0;5,0;;16,0;10,0;19,0;;;;;;1,0;;5,0;1,0;;;;;4,0;;;;;1,0;7,0;;;;1,0;;;2,0;1,0;;;;;5,0;1,0;1,0;4,0;;;;;;;2,0;1,0;7,0;;;;2,0;;15,0;;;;;;;;;6,0;2,0;;;;34,0;;;;10,0;14,0;1,0;9,0;;1,0;1,0;34,0;;23,0;;;;;;13,0;5,0;;;;;;;;;;;;6,0;;;;;;;5,0;;;25,0;1,0;5,0;3,0;;;;;1,0;;2,0;;;;;9,0;;;;;;1,0;26,0;9,0;;;;;;;;;;3,0;5,0;;;;2,0;9,0;;;;;;;11,0;1,0;18,0;;9,0;;;14,0;9,0;13,0;;;;1,0;;30,0;;;2,0;;1,0;3,0;1,0;7,0;;4,0;2,0;1,0;14,0;6,0;36,0;;;1,0;;;4,0;2,0;8,0;;;;;35,0;8,0;;7,0;;;4,0;3,0;;;;;;;;;1,0;3,0;;2,0;1,0;3,0;1,0;;1,0;;1,0;;6,0;;;;48,0;5,0;3,0;3,0;;3,0;5,0;;;10,0;;2,0;1,0;;;;2,0;25,0;;1,0;;;;2,0;;;;;;;;;3,0;;;;;;;;14,0;;;16,0;;;24,0;;;;;;;;;;;;;4,0;;;;;;;;;;;;;;;;;;4,0;;;;;;3,0;;;;;;;;2,0;;1,0;1,0;;;;;;;;1,0;;;;;;;;;;;;;;;;;;;;;9,0;7,0;;;;;;;3,0;;;5,0;19,0;;;;;2,0;;;;2,0;;;;;;;;;;;;;;6,0;;;;;;;;;1,0;11,0;;1,0;;;;;;;;;;;;;;;;1,0;;;;;;;;;;;;1,0;13,0;;;;1,0;;;;;;;1,0;2,0;;;2,0;;;4,0;48,0;;;;;;1,0;;;;;2,0;1,0;;;;;;;15,0;4,0;;;;;;;;;5,0;;;;;;;1,0;1,0;;1,0;;;;;;16,0;11,0;;;;;;;;2,0;;;1,0;;3,0;5,0;;;;;;;;;;;;;;;2,0;9,0;;;;;;;;;;;;;;;3,0;;4,0;;;;;;;1,0;;;2,0;;;;;15,0;;;;;;;;;;;;;;;;;;4,0;;;;;;1,0;;11,0;3,0;1,0;;2,0;;;;;;;56,0;;;;5,0;;;;;;;;2,0;;40,0;;;;43,0;;;;;;;3,0;;;;;;;11,0;;;;2,0;;;;;;;;;2,0;;;1,0;1,0;3,0;2,0;;;;;2,0;;;;;;;;;;;;;2,0;2,0;1,0;3,0;;;;;;4,0;;;;;2,0;;;;;3,0;;;;;;;;;;;3,0;;;28,0;3,0;2,0;;1,0;;;;;;;;;;1,0;;;;;;;47,0;7,0;;;;;;;;;;;;;;;48,0;;;;;1,0;;;;;3,0;;;;;;;;;;;;;;;2,0;;;;;;;;;;;;;;;;;;;;;;;;;;;;;;;;
component;5,0;;4,0;54,0;37,0;70,0;79,0;122,0;;;12,0;595,0;51,0;277,0;21,0;2,0;247,0;1,0;24,0;14,0;13,0;;477,0;6,0;18,0;5,0;15,0;;17,0;14,0;445,0;12,0;35,0;16,0;7,0;246,0;19,0;26,0;53,0;12,0;171,0;311,0;22,0;55,0;83,0;110,0;2,0;90,0;3,0;9,0;52,0;4,0;26,0;36,0;64,0;36,0;89,0;5,0;87,0;89,0;8,0;14,0;11,0;1,0;1156,0;7,0;449,0;3,0;14,0;2,0;53,0;482,0;220,0;10,0;;8,0;24,0;49,0;2,0;67,0;235,0;7,0;52,0;17,0;201,0;77,0;7,0;340,0;84,0;28,0;21,0;31,0;16,0;23,0;2,0;;367,0;34,0;796,0;22,0;245,0;72,0;3,0;71,0;156,0;116,0;5,0;23,0;11,0;;;159,0;61,0;2,0;6,0;16,0;51,0;79,0;37,0;310,0;;;235,0;12,0;46,0;34,0;432,0;;47,0;11,0;49,0;;5,0;70,0;;;46,0;13,0;12,0;3,0;14,0;19,0;;10,0;12,0;19,0;94,0;107,0;171,0;38,0;7,0;21,0;42,0;66,0;1,0;28,0;;7,0;15,0;14,0;50,0;193,0;20,0;11,0;8,0;9,0;390,0;97,0;;71,0;11,0;;60,0;40,0;;35,0;48,0;41,0;11,0;13,0;31,0;6,0;30,0;53,0;;2,0;65,0;31,0;33,0;66,0;16,0;12,0;58,0;12,0;23,0;91,0;233,0;14,0;66,0;41,0;1,0;34,0;;2,0;52,0;7,0;31,0;60,0;23,0;812,0;39,0;43,0;11,0;31,0;13,0;90,0;103,0;19,0;;49,0;48,0;5,0;;4,0;14,0;12,0;171,0;7,0;12,0;37,0;22,0;35,0;15,0;7,0;36,0;2,0;33,0;4,0;3,0;19,0;3,0;13,0;11,0;17,0;8,0;73,0;22,0;23,0;166,0;118,0;3,0;2,0;2,0;62,0;66,0;18,0;102,0;340,0;38,0;;18,0;30,0;2,0;85,0;16,0;;;46,0;5,0;29,0;;20,0;89,0;44,0;12,0;;26,0;48,0;1,0;21,0;11,0;29,0;74,0;115,0;4,0;;25,0;22,0;163,0;7,0;40,0;37,0;3,0;22,0;6,0;18,0;32,0;114,0;89,0;11,0;5,0;1,0;17,0;4,0;9,0;55,0;8,0;29,0;15,0;493,0;;26,0;41,0;115,0;14,0;20,0;46,0;27,0;;41,0;17,0;40,0;18,0;7,0;8,0;2,0;;1,0;188,0;30,0;83,0;7,0;101,0;7,0;8,0;7,0;25,0;1,0;5,0;1,0;95,0;32,0;41,0;118,0;4,0;70,0;19,0;186,0;18,0;12,0;1,0;9,0;3,0;;34,0;3,0;16,0;118,0;114,0;18,0;2,0;2,0;1,0;2,0;4,0;22,0;18,0;8,0;2,0;;;1,0;84,0;26,0;18,0;7,0;7,0;11,0;19,0;18,0;242,0;29,0;;18,0;2,0;66,0;11,0;41,0;2,0;3,0;;13,0;12,0;27,0;3,0;31,0;1,0;63,0;13,0;38,0;2,0;74,0;27,0;22,0;20,0;23,0;17,0;24,0;109,0;28,0;2,0;33,0;;13,0;92,0;37,0;4,0;22,0;23,0;;12,0;5,0;2,0;1,0;3,0;229,0;8,0;59,0;2,0;9,0;77,0;19,0;12,0;3,0;6,0;2,0;17,0;12,0;13,0;;32,0;14,0;23,0;20,0;8,0;14,0;15,0;6,0;58,0;3,0;3,0;19,0;11,0;5,0;92,0;35,0;;37,0;8,0;26,0;28,0;16,0;;8,0;;64,0;36,0;;18,0;;14,0;9,0;17,0;46,0;37,0;;8,0;3,0;48,0;76,0;6,0;26,0;11,0;20,0;5,0;;47,0;33,0;21,0;;17,0;2,0;5,0;11,0;8,0;36,0;16,0;2,0;3,0;6,0;5,0;11,0;10,0;13,0;60,0;36,0;5,0;;;9,0;55,0;22,0;1,0;;18,0;5,0;6,0;53,0;9,0;26,0;23,0;13,0;9,0;3,0;1,0;14,0;16,0;1,0;91,0;1,0;3,0;5,0;8,0;16,0;13,0;1,0;4,0;;10,0;12,0;;11,0;6,0;69,0;;1,0;;;2,0;;;1,0;2,0;17,0;3,0;;;2,0;;;2,0;3,0;;14,0;;1,0;15,0;4,0;7,0;15,0;;16,0;;54,0;39,0;26,0;6,0;11,0;6,0;11,0;5,0;;30,0;35,0;4,0;18,0;7,0;3,0;7,0;7,0;10,0;;10,0;1,0;6,0;;6,0;2,0;18,0;2,0;;;1,0;27,0;6,0;6,0;;7,0;3,0;11,0;4,0;2,0;5,0;11,0;10,0;8,0;2,0;4,0;;;3,0;;33,0;;3,0;9,0;13,0;;;;18,0;8,0;27,0;16,0;10,0;;;3,0;20,0;2,0;10,0;;9,0;2,0;2,0;23,0;;12,0;;2,0;;;;;7,0;63,0;4,0;1,0;13,0;25,0;;22,0;2,0;6,0;10,0;1,0;5,0;;109,0;45,0;33,0;2,0;2,0;10,0;;80,0;;3,0;26,0;;5,0;2,0;2,0;;8,0;9,0;2,0;36,0;35,0;12,0;;9,0;9,0;;4,0;64,0;1,0;14,0;3,0;31,0;;2,0;5,0;47,0;4,0;1,0;;23,0;;5,0;;1,0;4,0;3,0;6,0;40,0;;5,0;3,0;6,0;;1,0;22,0;2,0;3,0;2,0;41,0;;18,0;;;;2,0;17,0;121,0;;2,0;24,0;13,0;;16,0;5,0;2,0;36,0;;4,0;;16,0;7,0;4,0;68,0;;;;1,0;14,0;31,0;;43,0;25,0;8,0;;;1,0;1,0;3,0;8,0;;;3,0;;13,0;11,0;;1,0;2,0;3,0;4,0;15,0;95,0;7,0;;;3,0;104,0;2,0;6,0;4,0;2,0;;;1,0;1,0;3,0;1,0;;34,0;;7,0;;;1,0;3,0;6,0;;1,0;;;13,0;16,0;3,0;16,0;1,0;;;;4,0;4,0;;9,0;;8,0;3,0;2,0;4,0;18,0;;;;1,0;;;1,0;;;3,0;1,0;;;66,0;2,0;6,0;1,0;3,0;4,0;;4,0;;4,0;;7,0;9,0;;;16,0;2,0;2,0;1,0;;4,0;;17,0;2,0;;2,0;23,0;;;;22,0;;;24,0;3,0;6,0;;1,0;4,0;6,0;1,0;6,0;5,0;3,0;2,0;19,0;6,0;21,0;;;;9,0;15,0;4,0;1,0;1,0;3,0;2,0;10,0;;2,0;;4,0;3,0;;;1,0;21,0;;5,0;;4,0;;17,0;;3,0;;16,0;;1,0;;;;;;;10,0;3,0;42,0;;;;19,0;2,0;11,0;19,0;1,0;;10,0;;4,0;2,0;1,0;;4,0;;3,0;48,0;136,0;5,0;;56,0;;;24,0;1,0;1,0;2,0;;3,0;9,0;23,0;2,0;;21,0;10,0;;11,0;8,0;;5,0;10,0;7,0;7,0;6,0;1,0;;3,0;3,0;;10,0;6,0;;3,0;1,0;;;6,0;;;4,0;;2,0;;2,0;;;;1,0;;
computer;2,0;2,0;;13,0;7,0;119,0;5,0;8,0;1,0;4,0;;;;93,0;;;134,0;2,0;4,0;5,0;;1,0;19,0;22,0;64,0;5,0;2,0;17,0;;24,0;269,0;23,0;6,0;3,0;;210,0;9,0;8,0;36,0;1,0;170,0;479,0;2,0;77,0;158,0;2,0;1,0;20,0;4,0;8,0;14,0;;5,0;42,0;14,0;7,0;5,0;2,0;3,0;77,0;3,0;;13,0;5,0;555,0;85,0;170,0;7,0;11,0;;10,0;35,0;29,0;;17,0;6,0;1,0;9,0;139,0;249,0;388,0;1,0;29,0;46,0;41,0;1,0;2,0;22,0;;8,0;19,0;;1,0;2,0;6,0;;46,0;12,0;96,0;46,0;49,0;19,0;1,0;48,0;134,0;465,0;565,0;1279,0;4,0;;;14,0;31,0;;1,0;1,0;27,0;12,0;43,0;62,0;13,0;;74,0;6,0;1,0;325,0;705,0;1,0;4,0;1,0;53,0;4,0;;80,0;;;48,0;25,0;19,0;;;5,0;2,0;;8,0;8,0;23,0;6,0;54,0;1,0;;11,0;14,0;1,0;3,0;;;;1,0;;;42,0;42,0;3,0;;2,0;40,0;5,0;;11,0;12,0;;9,0;24,0;1,0;11,0;;2,0;15,0;;4,0;2,0;4,0;13,0;;;8,0;;57,0;4,0;1,0;4,0;;1,0;9,0;;7,0;;1,0;1,0;;;;13,0;7,0;1151,0;;;7,0;21,0;4,0;10,0;2,0;1,0;;1,0;29,0;7,0;1,0;11,0;27,0;7,0;2,0;;1,0;;32,0;12,0;;18,0;;7,0;12,0;5,0;10,0;9,0;8,0;;;9,0;;1,0;;;;62,0;5,0;5,0;8,0;;;;2,0;8,0;1,0;4,0;5,0;31,0;;;12,0;39,0;1,0;37,0;1,0;;2,0;3,0;6,0;22,0;;2,0;1,0;6,0;1,0;;7,0;28,0;;1,0;;;7,0;4,0;3,0;;1,0;3,0;6,0;;;27,0;;;1,0;;28,0;2,0;;;;;;2,0;;;3,0;18,0;24,0;54,0;;;;;;;13,0;1,0;;4,0;115,0;104,0;;10,0;4,0;;;;22,0;3,0;1,0;;;;73,0;;;;;;6,0;7,0;2,0;;;1,0;10,0;12,0;;;;;;;48,0;3,0;2,0;;157,0;38,0;4,0;2,0;3,0;21,0;;8,0;33,0;;2,0;3,0;3,0;;16,0;5,0;19,0;3,0;4,0;17,0;22,0;5,0;159,0;27,0;;3,0;4,0;56,0;5,0;8,0;1,0;13,0;4,0;366,0;16,0;14,0;2,0;47,0;;37,0;11,0;3,0;1,0;51,0;5,0;32,0;4,0;38,0;13,0;34,0;35,0;8,0;;16,0;2,0;24,0;56,0;20,0;;6,0;3,0;5,0;2,0;29,0;;12,0;1219,0;168,0;30,0;26,0;7,0;4,0;8,0;7,0;25,0;3,0;11,0;;608,0;41,0;1,0;;2,0;2,0;33,0;10,0;11,0;856,0;2,0;2,0;84,0;4,0;1,0;;8,0;;16,0;;1,0;26,0;4,0;7,0;63,0;;3,0;13,0;13,0;39,0;5,0;43,0;3,0;;11,0;12,0;445,0;50,0;1,0;1,0;5,0;10,0;2,0;5,0;;2,0;7,0;10,0;7,0;2,0;186,0;8,0;52,0;14,0;2,0;1,0;;6,0;4,0;;23,0;7,0;27,0;;4,0;34,0;51,0;11,0;2,0;12,0;42,0;3,0;;3,0;14,0;1,0;5,0;2,0;4,0;10,0;;4,0;;;12,0;;3,0;;3,0;;;;;2,0;;21,0;2,0;3,0;4,0;30,0;7,0;8,0;3,0;7,0;54,0;3,0;3,0;8,0;5,0;8,0;3,0;;2,0;7,0;4,0;;8,0;9,0;17,0;13,0;3,0;;;1,0;2,0;6,0;15,0;;44,0;2,0;34,0;3,0;5,0;6,0;;2,0;3,0;;;5,0;;1,0;;1,0;;1,0;1,0;14,0;24,0;;;11,0;504,0;15,0;7,0;14,0;4,0;5,0;;;13,0;;15,0;;5,0;135,0;23,0;27,0;7,0;31,0;;9,0;2,0;;3,0;;1,0;;50,0;1,0;3,0;6,0;27,0;5,0;5,0;8,0;3,0;48,0;6,0;1,0;;1,0;9,0;7,0;4,0;4,0;3,0;115,0;2,0;;2,0;1,0;3,0;4,0;36,0;2,0;1,0;2,0;2,0;4,0;1,0;;3,0;;;6,0;1,0;;2,0;2,0;4,0;;1,0;6,0;10,0;18,0;116,0;4,0;3,0;;;;;9,0;26,0;13,0;4,0;10,0;7,0;11,0;13,0;4,0;83,0;;6,0;8,0;16,0;11,0;4,0;3,0;4,0;;;3,0;;1,0;19,0;;;5,0;;1,0;;;;1,0;;;;;;;;5,0;;1,0;;3,0;;4,0;1,0;;;3,0;17,0;;;2,0;1,0;2,0;;5,0;2,0;5,0;;2,0;;4,0;3,0;5,0;1,0;;4,0;;5,0;;;;;4,0;5,0;2,0;;1,0;;;;;;;2,0;;;;;;1,0;;;1,0;;;2,0;1,0;3,0;;10,0;;;;;1,0;;;1,0;1,0;;4,0;1,0;2,0;;;;5,0;;;1,0;;;;2,0;;8,0;;;;;5,0;;3,0;;5,0;7,0;5,0;;4,0;1,0;;;4,0;;;8,0;;;11,0;1,0;;;4,0;;6,0;;;3,0;;18,0;;;1,0;3,0;4,0;;2,0;;;1,0;3,0;;4,0;4,0;;;1,0;3,0;12,0;1,0;4,0;1,0;1,0;6,0;6,0;2,0;6,0;5,0;3,0;4,0;;2,0;;;;;5,0;1,0;5,0;5,0;6,0;1,0;;;;;2,0;;1,0;1,0;1,0;;;;4,0;6,0;;7,0;2,0;3,0;6,0;1,0;2,0;;2,0;;7,0;;8,0;1,0;3,0;17,0;2,0;;3,0;;;;12,0;1,0;;;;2,0;;3,0;3,0;;;;;1,0;1,0;8,0;2,0;1,0;;;;;5,0;;;;;6,0;;;;2,0;;;;;;;;13,0;;3,0;;4,0;;;;;;;2,0;;2,0;;;5,0;;;;;1,0;;;2,0;;;8,0;;;4,0;4,0;2,0;1,0;11,0;;1,0;1,0;6,0;;32,0;2,0;;;3,0;;;;;
condition;3,0;;;30,0;25,0;69,0;1,0;2,0;;;25,0;;;170,0;;15,0;111,0;;;5,0;;;18,0;4,0;42,0;7,0;5,0;14,0;24,0;;116,0;22,0;6,0;1,0;;142,0;12,0;13,0;5,0;;298,0;170,0;;27,0;76,0;2,0;2,0;32,0;24,0;6,0;23,0;;5,0;23,0;17,0;186,0;13,0;;14,0;33,0;;;61,0;1,0;322,0;;146,0;4,0;8,0;4,0;114,0;613,0;120,0;;13,0;2,0;;21,0;1,0;9,0;192,0;;34,0;5,0;12,0;1,0;;85,0;3,0;2,0;17,0;6,0;1,0;;52,0;;14,0;14,0;89,0;62,0;39,0;130,0;;25,0;18,0;26,0;4,0;9,0;2,0;;1,0;21,0;19,0;;;2,0;11,0;10,0;23,0;62,0;13,0;;66,0;15,0;;14,0;309,0;7,0;5,0;12,0;122,0;10,0;;176,0;8,0;4,0;90,0;2,0;119,0;;;;1,0;9,0;8,0;9,0;22,0;4,0;58,0;1,0;;6,0;14,0;;;3,0;;;;2,0;;8,0;;5,0;4,0;1,0;1,0;9,0;1,0;19,0;12,0;1,0;;15,0;1,0;1,0;;2,0;9,0;;;1,0;8,0;19,0;;2,0;1,0;9,0;9,0;4,0;2,0;9,0;;1,0;;;2,0;;12,0;;;1,0;10,0;3,0;15,0;24,0;51,0;;6,0;4,0;9,0;15,0;1,0;;;;26,0;;1,0;4,0;1,0;16,0;1,0;;;;39,0;2,0;;5,0;;14,0;70,0;11,0;12,0;27,0;;;;37,0;;3,0;1,0;;;62,0;2,0;6,0;7,0;;;;;2,0;;3,0;6,0;47,0;;;2,0;52,0;1,0;68,0;1,0;8,0;;6,0;6,0;;;20,0;;11,0;3,0;;1,0;17,0;;3,0;;3,0;20,0;11,0;7,0;;1,0;6,0;9,0;;;;3,0;;;;94,0;8,0;;;;;;;;;2,0;24,0;6,0;161,0;;;;;2,0;;3,0;9,0;6,0;2,0;18,0;40,0;1,0;1,0;6,0;2,0;4,0;;48,0;7,0;;;2,0;;55,0;;;;;;6,0;7,0;;;;2,0;1,0;5,0;;;;4,0;6,0;;11,0;;6,0;;27,0;15,0;4,0;1,0;6,0;2,0;3,0;20,0;10,0;6,0;;3,0;;;27,0;1,0;68,0;22,0;7,0;9,0;11,0;2,0;77,0;6,0;4,0;40,0;4,0;167,0;157,0;4,0;;38,0;7,0;2,0;2,0;264,0;2,0;7,0;1,0;45,0;21,0;12,0;;7,0;;39,0;;87,0;3,0;16,0;11,0;3,0;;7,0;1,0;41,0;63,0;10,0;;;1,0;5,0;;;;;12,0;39,0;5,0;32,0;18,0;;33,0;;72,0;7,0;10,0;;33,0;28,0;7,0;;10,0;9,0;92,0;3,0;;14,0;;21,0;31,0;6,0;;5,0;7,0;4,0;1,0;6,0;11,0;44,0;;3,0;25,0;14,0;;5,0;;11,0;10,0;;;;4,0;6,0;63,0;1,0;1,0;1,0;8,0;;6,0;11,0;;;21,0;5,0;8,0;;42,0;10,0;;4,0;1,0;6,0;11,0;;7,0;;6,0;4,0;;5,0;20,0;9,0;;;6,0;1,0;;;;;14,0;12,0;;;10,0;;;1,0;;;12,0;4,0;;;13,0;;;;1,0;;;100,0;;;;;7,0;4,0;4,0;39,0;3,0;1,0;;;;9,0;;2,0;;15,0;2,0;;8,0;12,0;11,0;4,0;3,0;2,0;;;2,0;49,0;2,0;1,0;6,0;;12,0;1,0;3,0;23,0;;1,0;;;8,0;7,0;4,0;20,0;;4,0;1,0;;8,0;;;;;5,0;;3,0;;5,0;1,0;3,0;;;;20,0;35,0;2,0;20,0;;;23,0;5,0;3,0;;4,0;4,0;;1,0;3,0;19,0;;3,0;;5,0;2,0;6,0;2,0;3,0;2,0;8,0;4,0;;1,0;;1,0;6,0;;;1,0;;16,0;1,0;7,0;;;;;;1,0;;;;1,0;2,0;8,0;2,0;;1,0;1,0;2,0;;4,0;2,0;4,0;;;;;14,0;5,0;;1,0;;;10,0;;;4,0;;4,0;3,0;;3,0;;7,0;29,0;;;;2,0;63,0;;67,0;1,0;;;;;1,0;2,0;;1,0;7,0;;1,0;;;;;2,0;37,0;60,0;;4,0;;;6,0;;;;;;60,0;;;5,0;19,0;1,0;2,0;6,0;7,0;26,0;;;;;23,0;;;;2,0;14,0;4,0;;1,0;3,0;;38,0;;;;;1,0;6,0;4,0;7,0;;;;;;5,0;;;7,0;;4,0;;1,0;;;;36,0;;;1,0;;47,0;;5,0;2,0;1,0;;;;;;1,0;;;4,0;;;;13,0;;;;;7,0;;6,0;;13,0;;;;5,0;;;20,0;;;;;6,0;11,0;;22,0;;1,0;14,0;27,0;;3,0;;;;2,0;15,0;1,0;;11,0;1,0;;2,0;;1,0;;2,0;3,0;;2,0;4,0;1,0;;;;;2,0;4,0;6,0;69,0;;;;4,0;;2,0;1,0;1,0;;;1,0;;;;1,0;;1,0;1,0;;;;;;1,0;1,0;74,0;665,0;4,0;2,0;;;;;;1,0;1,0;54,0;;4,0;10,0;;5,0;;21,0;2,0;;1,0;5,0;;;16,0;9,0;;34,0;;1,0;;;;;;18,0;1,0;;;2,0;;;;;;;;;27,0;;2,0;;4,0;;2,0;;5,0;25,0;;3,0;;;;;;;;;;2,0;10,0;;3,0;;;36,0;;;;;;;;;;;;;;1,0;;;1,0;;;8,0;;;3,0;;;;;1,0;7,0;;;;;;23,0;1,0;;10,0;;;;;23,0;2,0;;1,0;1,0;;1,0;1,0;2,0;
configure;4,0;72,0;1,0;334,0;212,0;1133,0;279,0;453,0;4,0;14,0;9,0;124,0;106,0;639,0;8,0;62,0;1414,0;28,0;135,0;32,0;95,0;6,0;174,0;199,0;363,0;85,0;47,0;445,0;269,0;116,0;;1323,0;221,0;133,0;20,0;1177,0;111,0;115,0;194,0;2,0;1097,0;2644,0;6,0;354,0;1124,0;284,0;86,0;756,0;14,0;185,0;92,0;9,0;92,0;81,0;290,0;80,0;219,0;56,0;78,0;1145,0;9,0;8,0;327,0;60,0;5129,0;70,0;1145,0;44,0;16,0;10,0;65,0;1954,0;1688,0;39,0;26,0;3,0;81,0;164,0;60,0;487,0;271,0;18,0;317,0;50,0;1494,0;233,0;2,0;836,0;24,0;24,0;172,0;100,0;208,0;33,0;81,0;5,0;651,0;134,0;1204,0;224,0;909,0;101,0;14,0;415,0;860,0;2832,0;27,0;289,0;50,0;4,0;14,0;218,0;216,0;16,0;23,0;21,0;63,0;133,0;178,0;1575,0;67,0;5,0;2310,0;66,0;188,0;606,0;2178,0;10,0;49,0;5,0;309,0;10,0;5,0;2652,0;15,0;13,0;508,0;75,0;117,0;15,0;28,0;30,0;47,0;6,0;135,0;199,0;208,0;190,0;105,0;290,0;50,0;124,0;472,0;47,0;58,0;202,0;9,0;11,0;3,0;2,0;33,0;448,0;46,0;241,0;155,0;9,0;832,0;272,0;18,0;328,0;270,0;4,0;181,0;519,0;15,0;78,0;73,0;200,0;133,0;81,0;35,0;9,0;44,0;186,0;127,0;28,0;381,0;75,0;528,0;191,0;5,0;27,0;104,0;293,0;178,0;117,0;718,0;78,0;54,0;48,0;5,0;115,0;61,0;28,0;255,0;112,0;569,0;6,0;186,0;1056,0;532,0;269,0;52,0;1,0;17,0;79,0;940,0;63,0;10,0;96,0;111,0;34,0;41,0;115,0;146,0;29,0;1172,0;24,0;57,0;145,0;20,0;173,0;110,0;27,0;106,0;71,0;144,0;28,0;72,0;46,0;1,0;51,0;59,0;20,0;49,0;291,0;44,0;82,0;241,0;104,0;36,0;19,0;24,0;380,0;96,0;404,0;493,0;783,0;48,0;51,0;326,0;518,0;56,0;500,0;95,0;61,0;87,0;33,0;35,0;92,0;45,0;140,0;291,0;21,0;103,0;11,0;147,0;229,0;27,0;79,0;132,0;81,0;292,0;144,0;10,0;7,0;56,0;58,0;763,0;12,0;243,0;119,0;31,0;47,0;45,0;19,0;333,0;198,0;51,0;132,0;64,0;15,0;56,0;46,0;29,0;94,0;40,0;105,0;17,0;409,0;1,0;48,0;53,0;108,0;23,0;56,0;62,0;102,0;23,0;264,0;199,0;605,0;34,0;32,0;48,0;20,0;40,0;7,0;379,0;65,0;104,0;10,0;36,0;82,0;242,0;6,0;37,0;17,0;33,0;8,0;277,0;236,0;35,0;79,0;38,0;174,0;80,0;113,0;12,0;67,0;29,0;37,0;14,0;9,0;121,0;21,0;78,0;83,0;870,0;240,0;15,0;15,0;24,0;37,0;47,0;92,0;80,0;63,0;15,0;35,0;18,0;9,0;311,0;77,0;231,0;25,0;122,0;113,0;107,0;59,0;1994,0;105,0;7,0;4,0;27,0;924,0;103,0;89,0;15,0;54,0;3,0;299,0;85,0;280,0;43,0;125,0;4,0;191,0;92,0;25,0;19,0;445,0;49,0;163,0;35,0;180,0;25,0;122,0;338,0;161,0;36,0;218,0;4,0;325,0;327,0;142,0;10,0;4,0;16,0;7,0;5,0;65,0;9,0;141,0;25,0;2193,0;84,0;158,0;39,0;17,0;297,0;35,0;153,0;50,0;70,0;42,0;182,0;142,0;354,0;74,0;78,0;168,0;66,0;111,0;43,0;25,0;15,0;15,0;464,0;33,0;12,0;247,0;106,0;11,0;45,0;42,0;56,0;129,0;21,0;23,0;263,0;3,0;117,0;48,0;66,0;111,0;40,0;34,0;27,0;20,0;66,0;68,0;416,0;479,0;67,0;75,0;93,0;51,0;149,0;30,0;180,0;20,0;86,0;86,0;31,0;22,0;620,0;53,0;55,0;52,0;7,0;19,0;41,0;130,0;153,0;60,0;136,0;40,0;50,0;58,0;22,0;160,0;18,0;112,0;52,0;79,0;11,0;65,0;38,0;7,0;112,0;21,0;45,0;26,0;5,0;433,0;28,0;82,0;18,0;40,0;139,0;192,0;13,0;21,0;7,0;27,0;30,0;32,0;113,0;3,0;38,0;47,0;18,0;146,0;76,0;25,0;32,0;39,0;93,0;49,0;23,0;5,0;33,0;180,0;24,0;66,0;6,0;15,0;86,0;49,0;15,0;37,0;80,0;55,0;77,0;72,0;7,0;13,0;55,0;;39,0;74,0;23,0;45,0;41,0;4,0;71,0;56,0;96,0;92,0;7,0;10,0;12,0;18,0;104,0;50,0;20,0;79,0;12,0;93,0;15,0;7,0;115,0;82,0;62,0;43,0;59,0;17,0;201,0;94,0;60,0;23,0;20,0;14,0;54,0;4,0;119,0;42,0;77,0;14,0;79,0;35,0;6,0;139,0;32,0;17,0;3,0;49,0;42,0;70,0;65,0;132,0;13,0;31,0;34,0;22,0;11,0;30,0;23,0;80,0;28,0;44,0;42,0;40,0;11,0;22,0;12,0;16,0;2,0;30,0;17,0;21,0;29,0;163,0;11,0;24,0;6,0;35,0;36,0;33,0;25,0;19,0;25,0;26,0;94,0;46,0;5,0;17,0;24,0;8,0;52,0;9,0;49,0;3,0;11,0;30,0;35,0;1,0;103,0;37,0;56,0;92,0;64,0;18,0;129,0;2,0;12,0;30,0;30,0;79,0;320,0;54,0;21,0;93,0;22,0;62,0;31,0;19,0;156,0;11,0;25,0;22,0;86,0;110,0;82,0;70,0;26,0;;111,0;27,0;8,0;77,0;100,0;5,0;101,0;269,0;26,0;42,0;17,0;89,0;17,0;14,0;34,0;313,0;346,0;24,0;39,0;23,0;1,0;10,0;18,0;32,0;11,0;5,0;16,0;111,0;25,0;34,0;51,0;13,0;27,0;4,0;6,0;33,0;8,0;16,0;48,0;14,0;72,0;10,0;8,0;15,0;17,0;11,0;142,0;9,0;15,0;40,0;40,0;4,0;73,0;15,0;3,0;45,0;51,0;29,0;39,0;87,0;27,0;25,0;35,0;75,0;44,0;31,0;3,0;25,0;28,0;36,0;71,0;20,0;21,0;50,0;14,0;30,0;17,0;14,0;;1,0;25,0;8,0;35,0;30,0;86,0;13,0;1,0;26,0;14,0;10,0;100,0;48,0;6,0;5,0;8,0;37,0;72,0;6,0;41,0;25,0;27,0;4,0;77,0;49,0;9,0;45,0;109,0;16,0;137,0;112,0;8,0;47,0;22,0;5,0;32,0;76,0;38,0;22,0;15,0;12,0;23,0;23,0;33,0;74,0;13,0;8,0;69,0;35,0;64,0;57,0;10,0;3,0;16,0;52,0;9,0;14,0;55,0;13,0;1,0;19,0;11,0;6,0;34,0;274,0;27,0;;17,0;13,0;92,0;17,0;;10,0;8,0;18,0;15,0;3,0;5,0;6,0;17,0;3,0;4,0;13,0;11,0;35,0;54,0;14,0;23,0;36,0;41,0;7,0;7,0;34,0;5,0;105,0;15,0;22,0;1,0;26,0;14,0;17,0;46,0;51,0;7,0;51,0;23,0;43,0;23,0;8,0;13,0;29,0;18,0;5,0;20,0;11,0;30,0;5,0;100,0;18,0;3,0;7,0;28,0;10,0;31,0;18,0;9,0;19,0;1,0;25,0;16,0;35,0;28,0;1,0;16,0;21,0;26,0;9,0;12,0;11,0;12,0;8,0;14,0;11,0;30,0;21,0;27,0;4,0;9,0;3,0;14,0;2,0;30,0;27,0;27,0;15,0;14,0;;6,0;17,0;45,0;22,0;121,0;;11,0;15,0;12,0;27,0;2,0;25,0;3,0;5,0;14,0;17,0;35,0;103,0;21,0;3,0;6,0;10,0;20,0;6,0;9,0;25,0;30,0;23,0;19,0;24,0;6,0;5,0;11,0;5,0;10,0;18,0;98,0;27,0;13,0;8,0;9,0;2,0;6,0;11,0;10,0;34,0;14,0;4,0;14,0;19,0;10,0;1,0;9,0;13,0;14,0;32,0;25,0;26,0;2,0;17,0;10,0;1,0;9,0;3,0;36,0;2,0;11,0;7,0;;5,0;9,0;32,0;3,0;8,0;;
controller;4,0;1,0;;95,0;48,0;301,0;25,0;38,0;4,0;15,0;;18,0;7,0;110,0;4,0;19,0;150,0;1,0;31,0;12,0;2,0;1,0;27,0;22,0;169,0;5,0;5,0;12,0;23,0;22,0;1323,0;;12,0;29,0;;190,0;17,0;;44,0;;318,0;369,0;1,0;77,0;264,0;14,0;3,0;52,0;;17,0;9,0;;4,0;40,0;18,0;8,0;6,0;;18,0;173,0;;7,0;7,0;5,0;622,0;24,0;208,0;8,0;4,0;;10,0;352,0;145,0;;4,0;;;12,0;6,0;123,0;118,0;2,0;148,0;5,0;119,0;19,0;7,0;63,0;1,0;7,0;45,0;;14,0;2,0;30,0;4,0;35,0;8,0;158,0;24,0;278,0;40,0;;27,0;55,0;97,0;2,0;31,0;19,0;2,0;1,0;28,0;59,0;1,0;3,0;5,0;17,0;5,0;15,0;227,0;3,0;2,0;315,0;13,0;19,0;64,0;513,0;;4,0;;84,0;5,0;3,0;200,0;6,0;;67,0;11,0;33,0;;;;4,0;2,0;37,0;44,0;39,0;44,0;27,0;28,0;7,0;4,0;173,0;5,0;3,0;1,0;;;1,0;;2,0;166,0;4,0;16,0;8,0;;164,0;15,0;2,0;54,0;27,0;12,0;14,0;92,0;1,0;4,0;19,0;17,0;10,0;3,0;1,0;;4,0;18,0;;5,0;31,0;2,0;52,0;27,0;5,0;1,0;15,0;;7,0;1,0;37,0;6,0;1,0;;;4,0;3,0;1,0;19,0;5,0;30,0;;18,0;48,0;58,0;59,0;10,0;;;;135,0;4,0;;8,0;14,0;19,0;4,0;2,0;5,0;;37,0;1,0;2,0;4,0;;3,0;52,0;5,0;6,0;18,0;16,0;5,0;1,0;1,0;;1,0;4,0;;2,0;77,0;19,0;4,0;23,0;;;;3,0;11,0;21,0;45,0;11,0;42,0;;;9,0;91,0;2,0;170,0;4,0;18,0;;7,0;3,0;9,0;2,0;3,0;52,0;40,0;34,0;3,0;17,0;48,0;;;6,0;7,0;25,0;14,0;1,0;;5,0;8,0;43,0;1,0;17,0;20,0;2,0;;5,0;;49,0;60,0;;;1,0;2,0;;12,0;9,0;1,0;;24,0;;68,0;;1,0;12,0;;10,0;;13,0;22,0;6,0;11,0;53,0;102,0;2,0;8,0;2,0;;15,0;1,0;90,0;;4,0;;;5,0;20,0;;2,0;;1,0;7,0;31,0;34,0;11,0;;3,0;;;26,0;;;3,0;;;;42,0;6,0;17,0;1,0;64,0;26,0;8,0;2,0;2,0;8,0;31,0;26,0;17,0;4,0;;16,0;;3,0;87,0;5,0;86,0;7,0;6,0;62,0;27,0;5,0;835,0;21,0;7,0;1,0;4,0;120,0;16,0;7,0;;23,0;2,0;67,0;23,0;135,0;18,0;33,0;;45,0;14,0;5,0;1,0;113,0;10,0;17,0;4,0;27,0;7,0;81,0;26,0;73,0;2,0;57,0;1,0;72,0;137,0;33,0;1,0;;22,0;1,0;6,0;8,0;4,0;4,0;3,0;271,0;52,0;55,0;10,0;2,0;36,0;;44,0;18,0;23,0;5,0;48,0;31,0;54,0;22,0;33,0;49,0;18,0;26,0;5,0;8,0;5,0;7,0;83,0;7,0;13,0;54,0;51,0;16,0;6,0;8,0;9,0;28,0;1,0;1,0;8,0;;10,0;5,0;;6,0;3,0;3,0;19,0;1,0;5,0;13,0;65,0;47,0;1,0;8,0;23,0;10,0;59,0;2,0;7,0;3,0;34,0;8,0;33,0;4,0;149,0;4,0;12,0;1,0;1,0;11,0;;3,0;23,0;3,0;25,0;7,0;3,0;28,0;2,0;2,0;5,0;48,0;4,0;2,0;4,0;;3,0;9,0;21,0;6,0;10,0;;1,0;32,0;21,0;19,0;5,0;;11,0;10,0;;2,0;2,0;2,0;;;11,0;3,0;5,0;7,0;3,0;4,0;15,0;12,0;10,0;2,0;16,0;8,0;13,0;2,0;;27,0;1,0;12,0;;2,0;;23,0;;1,0;4,0;12,0;18,0;10,0;;4,0;;;;12,0;14,0;6,0;17,0;;4,0;10,0;11,0;7,0;2,0;24,0;4,0;;8,0;4,0;3,0;6,0;;3,0;1,0;5,0;7,0;;14,0;2,0;;;11,0;22,0;2,0;3,0;4,0;4,0;4,0;;4,0;5,0;19,0;5,0;6,0;25,0;4,0;23,0;7,0;5,0;;28,0;13,0;30,0;;12,0;;9,0;23,0;;3,0;12,0;8,0;10,0;11,0;14,0;10,0;11,0;2,0;;1,0;;2,0;4,0;5,0;2,0;1,0;37,0;1,0;1,0;2,0;;4,0;;;;4,0;8,0;;;;3,0;3,0;;11,0;6,0;2,0;1,0;4,0;;;3,0;12,0;1,0;6,0;30,0;5,0;8,0;26,0;2,0;;;;7,0;46,0;5,0;;1,0;;;5,0;2,0;37,0;;4,0;3,0;7,0;16,0;26,0;34,0;20,0;;;13,0;;4,0;32,0;14,0;7,0;7,0;3,0;3,0;;1,0;3,0;;3,0;76,0;88,0;3,0;;2,0;;6,0;6,0;;;;1,0;44,0;9,0;10,0;58,0;;9,0;;;3,0;4,0;;2,0;;3,0;5,0;5,0;16,0;15,0;;14,0;2,0;;2,0;5,0;;12,0;1,0;3,0;;;11,0;;6,0;1,0;3,0;;2,0;3,0;3,0;;;2,0;27,0;1,0;13,0;;2,0;1,0;;;;;;2,0;;9,0;;;;;2,0;;;5,0;1,0;;;;3,0;3,0;1,0;5,0;6,0;;;4,0;3,0;6,0;2,0;2,0;;2,0;6,0;4,0;1,0;;5,0;;68,0;;;;1,0;18,0;1,0;;4,0;;;7,0;2,0;2,0;11,0;;;;10,0;1,0;4,0;5,0;3,0;;;1,0;;6,0;5,0;1,0;;8,0;9,0;2,0;2,0;;;3,0;;4,0;;;6,0;2,0;2,0;2,0;1,0;4,0;6,0;;4,0;9,0;1,0;6,0;;1,0;5,0;;11,0;3,0;6,0;;;;1,0;15,0;3,0;7,0;2,0;;7,0;12,0;1,0;2,0;10,0;6,0;4,0;;3,0;5,0;;;;;;3,0;;;11,0;;6,0;6,0;2,0;26,0;5,0;3,0;;2,0;14,0;2,0;;;;;7,0;1,0;1,0;5,0;4,0;1,0;1,0;;;1,0;1,0;1,0;2,0;8,0;7,0;;2,0;;14,0;2,0;4,0;9,0;;;3,0;;2,0;1,0;;;;10,0;14,0;6,0;6,0;7,0;;;5,0;;;2,0;;2,0;;5,0;;3,0;1,0;1,0;1,0;;11,0;;2,0;1,0;5,0;14,0;;;;3,0;21,0;;2,0;;2,0;2,0;2,0;1,0;2,0;;;2,0;;;1,0;2,0;;;;;1,0;3,0;;;2,0;1,0;1,0;;;;
correct;28,0;1,0;6,0;20,0;55,0;41,0;13,0;9,0;;;;;3,0;103,0;4,0;9,0;50,0;;5,0;5,0;;;67,0;;4,0;3,0;2,0;35,0;6,0;6,0;221,0;12,0;;203,0;;116,0;6,0;5,0;18,0;2,0;46,0;53,0;;36,0;78,0;6,0;189,0;12,0;4,0;111,0;17,0;12,0;;2,0;26,0;19,0;6,0;;5,0;68,0;;4,0;73,0;3,0;801,0;1,0;56,0;;;3,0;5,0;142,0;37,0;;2,0;;1,0;5,0;;23,0;119,0;;3,0;28,0;50,0;1,0;1,0;171,0;2,0;17,0;40,0;14,0;3,0;8,0;9,0;;116,0;7,0;40,0;82,0;190,0;4,0;22,0;16,0;38,0;45,0;1,0;4,0;7,0;15,0;;37,0;17,0;1,0;1,0;1,0;8,0;10,0;4,0;57,0;13,0;2,0;183,0;8,0;;31,0;65,0;1,0;16,0;;19,0;2,0;1,0;109,0;;;28,0;2,0;19,0;;;6,0;;2,0;2,0;17,0;22,0;1,0;20,0;1,0;2,0;2,0;22,0;;;3,0;;1,0;;;;;;4,0;3,0;1,0;1,0;1,0;2,0;16,0;6,0;10,0;8,0;39,0;2,0;22,0;;;3,0;;;;;1,0;1,0;;67,0;;21,0;1,0;;2,0;;;3,0;;;;;;;;;;20,0;2,0;3,0;;9,0;5,0;15,0;8,0;35,0;;;1,0;88,0;3,0;;3,0;20,0;3,0;;4,0;;;22,0;;;3,0;;12,0;28,0;9,0;;1,0;;2,0;;4,0;1,0;2,0;;;;8,0;;;4,0;;;;6,0;5,0;;15,0;5,0;18,0;2,0;;;2,0;1,0;34,0;;3,0;;2,0;;;;;17,0;4,0;1,0;1,0;;24,0;;1,0;;9,0;31,0;2,0;;;3,0;4,0;40,0;;14,0;4,0;;;3,0;;23,0;;;;;;;3,0;;;;3,0;12,0;65,0;;;;;;;1,0;;1,0;18,0;1,0;31,0;;6,0;;;5,0;;;;;;;;5,0;;;;;;2,0;33,0;1,0;;;;;;;;2,0;;2,0;;15,0;;;;64,0;;;2,0;;3,0;1,0;23,0;5,0;70,0;;3,0;;;81,0;5,0;16,0;;;2,0;3,0;8,0;46,0;15,0;;;;24,0;6,0;45,0;1,0;;;15,0;5,0;63,0;11,0;33,0;;5,0;2,0;;1,0;23,0;3,0;106,0;3,0;15,0;9,0;2,0;71,0;3,0;;26,0;1,0;;3,0;20,0;1,0;15,0;2,0;4,0;10,0;1,0;;6,0;1,0;13,0;;6,0;2,0;7,0;;;6,0;;15,0;5,0;14,0;4,0;1,0;2,0;7,0;;1,0;25,0;;2,0;30,0;;8,0;62,0;3,0;;;;;;13,0;32,0;;;9,0;;4,0;16,0;6,0;1,0;10,0;;;;;;13,0;3,0;;;;;2,0;;7,0;;;9,0;5,0;9,0;22,0;;2,0;2,0;7,0;;2,0;5,0;2,0;1,0;8,0;;7,0;2,0;2,0;3,0;;;16,0;7,0;4,0;;;;;3,0;;;1,0;1,0;1,0;1,0;;;;;2,0;;;;;;;;;;;3,0;5,0;;;1,0;1,0;16,0;;;;2,0;;1,0;;2,0;;6,0;;;1,0;9,0;;;8,0;;;;;;;;1,0;;;;;1,0;;;;;6,0;17,0;1,0;;;;14,0;;;;1,0;;;2,0;3,0;9,0;;;1,0;9,0;;;4,0;;2,0;;9,0;2,0;;6,0;;;;4,0;5,0;;;;10,0;5,0;;;2,0;1,0;;2,0;;;11,0;4,0;;1,0;;;4,0;2,0;;;;;;;;;1,0;3,0;;2,0;1,0;;;;;;;;;;1,0;2,0;;2,0;39,0;7,0;13,0;4,0;;1,0;;;6,0;;;;;;5,0;;;;1,0;1,0;1,0;;5,0;;2,0;1,0;;;;;4,0;;;;1,0;;1,0;1,0;2,0;;1,0;5,0;;;;;;12,0;15,0;;;;1,0;2,0;1,0;;;;;16,0;;;6,0;1,0;;;;;11,0;;;;3,0;10,0;;;;4,0;2,0;;;;12,0;;2,0;;;;;;5,0;;;4,0;;;;;;;3,0;;;;;2,0;;;;2,0;9,0;;5,0;4,0;2,0;;10,0;;;;;;;;;;;1,0;2,0;10,0;12,0;2,0;;;;7,0;19,0;;;;23,0;4,0;;;;;;15,0;;4,0;;2,0;1,0;28,0;;2,0;;;4,0;;;68,0;2,0;;1,0;;;;;;1,0;;22,0;;4,0;;7,0;;;27,0;1,0;;;11,0;;;3,0;;1,0;;;1,0;2,0;5,0;5,0;4,0;;;1,0;;11,0;;1,0;1,0;;;;;2,0;;10,0;6,0;4,0;;;2,0;;5,0;1,0;1,0;;;7,0;;;;;;29,0;;;;14,0;7,0;;;;1,0;;;1,0;;;;;;;;;;;4,0;;2,0;;;;;;;;;;14,0;1,0;;;;;;22,0;15,0;;1,0;;;;2,0;;3,0;4,0;;;;;;80,0;;;;;13,0;;;;;;;;;1,0;5,0;2,0;27,0;;;;;;;;2,0;;;1,0;4,0;1,0;;;2,0;;;;;;3,0;2,0;;5,0;1,0;;;5,0;;;;;;;;;;;
correction;3,0;;5,0;17,0;150,0;157,0;21,0;2,0;2,0;6,0;;;28,0;214,0;4,0;3,0;57,0;;2,0;2,0;;;104,0;;4,0;3,0;;16,0;3,0;1,0;133,0;29,0;203,0;;;148,0;8,0;9,0;60,0;;212,0;157,0;;22,0;24,0;44,0;77,0;12,0;4,0;33,0;17,0;;;2,0;2,0;24,0;13,0;2,0;3,0;62,0;;6,0;84,0;3,0;483,0;5,0;113,0;3,0;3,0;4,0;11,0;308,0;89,0;;;3,0;;16,0;;28,0;178,0;;4,0;29,0;100,0;60,0;;105,0;;6,0;223,0;1,0;2,0;;9,0;2,0;130,0;25,0;114,0;33,0;85,0;26,0;1,0;18,0;118,0;37,0;;3,0;;6,0;12,0;93,0;26,0;1,0;;3,0;8,0;6,0;46,0;47,0;3,0;17,0;96,0;3,0;;69,0;166,0;;5,0;;44,0;;;255,0;5,0;;11,0;1,0;8,0;;;;1,0;;10,0;48,0;1,0;2,0;7,0;4,0;4,0;;59,0;;;;;;2,0;;;8,0;;8,0;1,0;1,0;1,0;3,0;1,0;49,0;10,0;6,0;1,0;242,0;11,0;15,0;6,0;2,0;1,0;;;;;23,0;;12,0;5,0;4,0;52,0;;32,0;;;11,0;3,0;3,0;8,0;1,0;;;;;5,0;;8,0;7,0;2,0;;2,0;26,0;27,0;24,0;78,0;;;;65,0;;;4,0;24,0;4,0;;1,0;3,0;;9,0;;1,0;3,0;;1,0;120,0;70,0;;;4,0;;;29,0;;;;;;56,0;2,0;10,0;36,0;;;2,0;;4,0;6,0;2,0;14,0;25,0;;;4,0;6,0;;10,0;;;;;;;;2,0;27,0;11,0;;;2,0;58,0;1,0;5,0;;2,0;46,0;5,0;;;59,0;9,0;151,0;;44,0;6,0;;2,0;;;37,0;3,0;1,0;;;;;2,0;;;;1,0;18,0;75,0;1,0;;;;;;4,0;1,0;5,0;5,0;4,0;12,0;13,0;1,0;;;8,0;;2,0;2,0;;;;;6,0;;;;;;2,0;25,0;;;;6,0;3,0;19,0;;1,0;;;;;11,0;;;;28,0;1,0;;;;;11,0;23,0;;10,0;;28,0;1,0;;172,0;22,0;22,0;5,0;;6,0;12,0;2,0;53,0;9,0;15,0;;5,0;22,0;2,0;26,0;1,0;;5,0;32,0;4,0;30,0;2,0;142,0;4,0;5,0;15,0;5,0;;8,0;3,0;6,0;6,0;14,0;2,0;;41,0;1,0;;25,0;;4,0;34,0;7,0;3,0;77,0;;;37,0;10,0;;31,0;2,0;31,0;;8,0;5,0;40,0;23,0;;136,0;;9,0;5,0;15,0;16,0;10,0;120,0;13,0;6,0;12,0;10,0;2,0;6,0;9,0;4,0;4,0;5,0;;;6,0;;2,0;;18,0;45,0;;1,0;24,0;4,0;3,0;12,0;;;5,0;6,0;;;1,0;;10,0;;;2,0;;1,0;6,0;;90,0;1,0;;;2,0;;267,0;12,0;;3,0;4,0;;18,0;8,0;2,0;;13,0;;5,0;3,0;19,0;;1,0;;16,0;7,0;2,0;;;;6,0;5,0;;;;8,0;;7,0;;;3,0;1,0;;6,0;;;1,0;;;;;;;3,0;3,0;;1,0;9,0;1,0;4,0;;42,0;;1,0;;;;3,0;;;;;2,0;7,0;1,0;2,0;;;;;2,0;;;6,0;116,0;;;1,0;1,0;4,0;;5,0;;;4,0;13,0;;6,0;;;70,0;;;1,0;4,0;;;;17,0;7,0;;4,0;3,0;2,0;;;1,0;;;;11,0;;;11,0;3,0;;;1,0;61,0;;26,0;;73,0;;4,0;;;;;;;;3,0;;1,0;1,0;;;;;;;;3,0;;;;1,0;7,0;32,0;;;1,0;;;;2,0;;2,0;;3,0;;;3,0;2,0;2,0;2,0;2,0;3,0;;;2,0;2,0;8,0;16,0;;;;;;8,0;;1,0;4,0;1,0;;;5,0;47,0;;;;;7,0;;;7,0;2,0;3,0;;;;8,0;3,0;;1,0;;4,0;;;;;2,0;35,0;47,0;;;;;14,0;;;1,0;;1,0;9,0;;;30,0;44,0;;;;;3,0;;;;13,0;4,0;;1,0;;1,0;6,0;;;3,0;21,0;4,0;10,0;;6,0;;;;3,0;;;3,0;;7,0;;;3,0;;;1,0;;1,0;;;;1,0;;;;;1,0;;3,0;;;1,0;;;;;2,0;;;;;;3,0;4,0;92,0;;;;4,0;15,0;35,0;;;;7,0;;;;;;;22,0;;;;;3,0;7,0;;2,0;;;2,0;2,0;8,0;337,0;;1,0;;9,0;;;1,0;4,0;1,0;1,0;24,0;;2,0;;10,0;1,0;;22,0;;;;5,0;6,0;;;;1,0;;;;12,0;1,0;;;;;12,0;;8,0;;3,0;;;;;;;;;9,0;;;;1,0;;2,0;1,0;;1,0;4,0;5,0;;;1,0;;;;;1,0;;;2,0;1,0;;4,0;10,0;;;;;3,0;;;1,0;;;;;;5,0;;5,0;;;;;;;;;;22,0;;;4,0;;;1,0;3,0;4,0;;;;;;;4,0;;2,0;;;1,0;2,0;;364,0;;;;;;;;;24,0;2,0;;1,0;;;;7,0;10,0;;;;;;;6,0;;;;;;;;;;;1,0;1,0;;;1,0;;;37,0;;;13,0;1,0;2,0;;;;6,0;;;;2,0;;
crystal;2,0;;;;7,0;3,0;8,0;2,0;;;;;;2,0;1,0;;;42,0;;1,0;;;3,0;;;;;7,0;;;20,0;;;;;;4,0;2,0;1,0;;;105,0;;4,0;87,0;17,0;;5,0;;;;4,0;;;11,0;6,0;9,0;;;;5,0;1,0;;;18,0;;29,0;;2,0;;6,0;91,0;32,0;445,0;;;6,0;;;;17,0;;1,0;;8,0;;2,0;20,0;1,0;;;;;;;;1,0;;18,0;2,0;9,0;;;;2,0;;;;1,0;;;;1,0;;;;;2,0;;3,0;;2,0;1,0;;;;21,0;;2,0;3,0;4,0;;;6,0;6,0;1,0;1,0;;;;;;;;1,0;3,0;2,0;10,0;1,0;;;;7,0;;;;2,0;;;2,0;;3,0;;1,0;;;1,0;;;;1,0;;;17,0;;;3,0;2,0;;;1,0;;3,0;;;5,0;11,0;5,0;;2,0;1,0;1,0;;;;;;;;;6,0;108,0;;;;;6,0;;3,0;;;;;;;4,0;3,0;1,0;;4,0;;;;;5,0;;5,0;1,0;;;;;;;;;;;;;2,0;1,0;;;6,0;5,0;;2,0;;;;;;68,0;42,0;;1,0;8,0;1,0;;;;;1,0;;;;;;2,0;;;8,0;;;;;12,0;;2,0;;;34,0;;;;;1,0;1,0;;;;;;;;1,0;3,0;;;;;;;;;;;;6,0;;;;;;;;;;;;2,0;3,0;1,0;14,0;;1,0;;2,0;2,0;;;;;;;;;;;;;1,0;;;;;1,0;;;;;;1,0;;;1,0;;;1,0;;;;;;;;2,0;;;;;;;1,0;1,0;;;2,0;;10,0;;;;;;;;;1,0;;;;1,0;;1,0;;;2,0;;;2,0;;;;4,0;;3,0;;;;2,0;;;;2,0;;1,0;;;;;;;;4,0;;1,0;;;1,0;;1,0;;;;;4,0;4,0;1,0;;2,0;;;;;;;1,0;;;4,0;;;;;;;;4,0;;1,0;;;;;;;;;;;;4,0;;;;;;;;;;;;;;;;;;;;;;1,0;2,0;;;;;;;;;;;;;;;;;;2,0;;;1,0;;;;;;3,0;;;;;;;;;;;;;;;;2,0;;;;2,0;;;;;;;;;;;;;;;;;;;;;;;;;;1,0;;;;1,0;1,0;17,0;;;;;;;1,0;;;;;;;;;;;;;;;;;;;;;;;;;;;;;;;;;;;;;2,0;;;;;;;;;;;;;;;;;;;8,0;4,0;1,0;1,0;;;;;;1,0;;;;;;;;;;;;;;;;;4,0;3,0;;;;;1,0;;;2,0;;;;;;;;;;1,0;;;;;;;;;3,0;;;4,0;;;;;1,0;;;6,0;6,0;;;;;;;;;;;;;2,0;;;;;2,0;;;4,0;;;4,0;;;;;;1,0;;;;1,0;;;;;;;;2,0;;;;;;;;;;;2,0;;;;;;;;;2,0;;;;;;;;;;;;;;1,0;;;;40,0;2,0;;;;;2,0;1,0;;;;;;;;3,0;;;25,0;5,0;;;;;;1,0;;;;;;;;;;;;;;;;;2,0;;;;;3,0;;;;;;;;;5,0;;;;;;;;;;;;1,0;;;;2,0;;;;;;;40,0;;;;;;;;;;;;2,0;;;;;;;;;;;;;;;;;;;;;;;;;;;;;;;1,0;1,0;;;2,0;;;;;;;;;;;;;;;;;;;;;;;5,0;;;;16,0;;1,0;;;;;;;;;;;;;;;;;;;;;;;1,0;;2,0;;;;;;;;;;;;;;9,0;;;;;;;;;;;;;;;;;;;;;
data;14,0;61,0;7,0;104,0;153,0;372,0;343,0;65,0;48,0;16,0;4,0;85,0;4,0;1698,0;38,0;58,0;2767,0;21,0;139,0;185,0;72,0;8,0;614,0;132,0;416,0;43,0;23,0;246,0;210,0;142,0;1177,0;190,0;116,0;148,0;;;110,0;27,0;343,0;13,0;1154,0;2182,0;;611,0;830,0;32,0;14,0;143,0;5,0;34,0;79,0;8,0;10,0;128,0;218,0;89,0;104,0;;76,0;1269,0;3,0;48,0;148,0;40,0;13526,0;35,0;1265,0;20,0;90,0;2,0;47,0;418,0;430,0;;17,0;34,0;8,0;164,0;233,0;470,0;1361,0;9,0;144,0;142,0;465,0;23,0;18,0;226,0;5,0;94,0;247,0;18,0;26,0;38,0;76,0;3,0;1195,0;90,0;1282,0;382,0;824,0;242,0;;729,0;1035,0;1031,0;18,0;102,0;104,0;37,0;37,0;282,0;286,0;27,0;16,0;364,0;290,0;162,0;436,0;1632,0;70,0;8,0;702,0;127,0;19,0;1085,0;1416,0;;96,0;;632,0;24,0;6,0;733,0;1,0;35,0;399,0;78,0;34,0;;;34,0;20,0;;8,0;77,0;193,0;104,0;773,0;28,0;3,0;29,0;100,0;;192,0;13,0;;;2,0;2,0;;72,0;63,0;179,0;6,0;37,0;149,0;12,0;7,0;93,0;79,0;11,0;31,0;172,0;;197,0;3,0;7,0;72,0;39,0;41,0;48,0;40,0;62,0;;6,0;90,0;11,0;1042,0;39,0;8,0;50,0;3,0;24,0;1,0;1,0;44,0;33,0;16,0;22,0;;27,0;6,0;5,0;93,0;170,0;11,0;;18,0;35,0;27,0;182,0;17,0;;;13,0;941,0;30,0;32,0;34,0;108,0;98,0;18,0;2,0;6,0;1,0;772,0;3,0;7,0;223,0;;74,0;103,0;65,0;22,0;26,0;66,0;4,0;5,0;385,0;;3,0;1,0;;;451,0;43,0;18,0;78,0;8,0;3,0;;8,0;124,0;16,0;45,0;33,0;69,0;4,0;;275,0;798,0;57,0;586,0;8,0;2,0;27,0;22,0;44,0;47,0;1,0;20,0;23,0;53,0;10,0;;27,0;93,0;;9,0;4,0;9,0;18,0;17,0;23,0;;47,0;15,0;288,0;1,0;3,0;134,0;;1,0;12,0;6,0;168,0;43,0;;4,0;6,0;;2,0;25,0;;;7,0;91,0;26,0;610,0;;11,0;13,0;10,0;21,0;;77,0;5,0;15,0;15,0;215,0;971,0;2,0;101,0;5,0;6,0;30,0;1,0;106,0;20,0;;1,0;;1,0;571,0;;6,0;;18,0;;30,0;66,0;34,0;;;14,0;41,0;58,0;38,0;;31,0;;51,0;11,0;140,0;;11,0;5,0;2826,0;185,0;15,0;26,0;67,0;42,0;3,0;86,0;280,0;30,0;;5,0;;;255,0;53,0;95,0;23,0;178,0;87,0;197,0;23,0;690,0;266,0;4,0;82,0;31,0;374,0;65,0;99,0;15,0;107,0;34,0;93,0;273,0;75,0;64,0;90,0;4,0;435,0;282,0;148,0;36,0;420,0;44,0;150,0;19,0;653,0;108,0;136,0;619,0;37,0;;103,0;1,0;103,0;292,0;273,0;17,0;12,0;8,0;21,0;5,0;232,0;6,0;230,0;41,0;2157,0;214,0;241,0;83,0;19,0;152,0;46,0;201,0;40,0;103,0;33,0;439,0;218,0;47,0;77,0;57,0;95,0;94,0;72,0;24,0;88,0;23,0;19,0;450,0;22,0;19,0;35,0;20,0;2,0;31,0;7,0;24,0;346,0;15,0;40,0;250,0;21,0;16,0;48,0;9,0;402,0;8,0;3,0;8,0;2,0;47,0;41,0;179,0;298,0;7,0;;8,0;80,0;39,0;20,0;;30,0;29,0;86,0;183,0;44,0;340,0;64,0;52,0;70,0;64,0;4,0;31,0;20,0;81,0;9,0;84,0;54,0;13,0;5,0;41,0;872,0;9,0;24,0;84,0;36,0;70,0;56,0;46,0;52,0;431,0;49,0;12,0;23,0;29,0;120,0;;23,0;1,0;5,0;103,0;47,0;1,0;9,0;22,0;4,0;;;2,0;;;35,0;;6,0;80,0;55,0;38,0;80,0;31,0;93,0;25,0;12,0;5,0;17,0;37,0;162,0;27,0;6,0;59,0;72,0;8,0;4,0;22,0;74,0;135,0;48,0;9,0;41,0;;19,0;28,0;83,0;71,0;32,0;68,0;8,0;417,0;30,0;154,0;135,0;4,0;1,0;61,0;;18,0;41,0;3,0;68,0;;11,0;15,0;;2,0;75,0;31,0;1,0;1,0;85,0;64,0;191,0;48,0;95,0;18,0;24,0;7,0;8,0;40,0;21,0;117,0;7,0;30,0;13,0;23,0;169,0;131,0;258,0;9,0;24,0;29,0;17,0;107,0;31,0;53,0;6,0;79,0;;23,0;67,0;133,0;59,0;14,0;6,0;64,0;128,0;12,0;23,0;4,0;75,0;10,0;49,0;3,0;69,0;11,0;319,0;6,0;227,0;15,0;9,0;3,0;60,0;17,0;34,0;70,0;9,0;17,0;43,0;32,0;1,0;43,0;5,0;16,0;23,0;106,0;4,0;57,0;33,0;136,0;15,0;126,0;44,0;;184,0;104,0;23,0;18,0;;11,0;86,0;;30,0;107,0;20,0;23,0;43,0;52,0;46,0;28,0;71,0;285,0;9,0;;12,0;30,0;286,0;44,0;67,0;48,0;8,0;3,0;4,0;9,0;;76,0;51,0;354,0;87,0;66,0;30,0;7,0;3,0;2,0;19,0;9,0;28,0;39,0;;;10,0;2,0;27,0;4,0;9,0;5,0;54,0;;94,0;3,0;11,0;52,0;36,0;66,0;13,0;;9,0;32,0;5,0;;5,0;2,0;78,0;6,0;35,0;;19,0;119,0;51,0;;;19,0;2,0;22,0;;1,0;5,0;7,0;2,0;21,0;57,0;6,0;9,0;3,0;;7,0;;15,0;;8,0;3,0;1,0;18,0;1,0;;24,0;;;3,0;;;21,0;1,0;40,0;;23,0;;;4,0;4,0;;3,0;1,0;5,0;2,0;;78,0;1,0;14,0;1,0;13,0;12,0;7,0;4,0;6,0;50,0;5,0;6,0;;132,0;1,0;117,0;;;;;89,0;;5,0;;5,0;47,0;42,0;15,0;56,0;7,0;;3,0;113,0;;6,0;24,0;8,0;;106,0;164,0;100,0;17,0;59,0;18,0;16,0;3,0;;38,0;3,0;67,0;;;72,0;103,0;97,0;;8,0;11,0;2,0;19,0;8,0;8,0;67,0;12,0;5,0;23,0;42,0;14,0;123,0;1,0;86,0;140,0;56,0;108,0;11,0;17,0;18,0;9,0;33,0;12,0;16,0;9,0;21,0;19,0;15,0;18,0;54,0;10,0;86,0;22,0;68,0;19,0;28,0;17,0;76,0;8,0;20,0;18,0;44,0;9,0;14,0;;51,0;;20,0;2,0;2,0;157,0;44,0;10,0;12,0;22,0;7,0;2,0;52,0;6,0;10,0;52,0;15,0;2,0;6,0;17,0;10,0;;66,0;23,0;;;10,0;;;;59,0;;10,0;59,0;2,0;70,0;;;1,0;41,0;28,0;3,0;25,0;27,0;;10,0;7,0;;20,0;;;;;1,0;27,0;9,0;47,0;19,0;;;;;3,0;;10,0;24,0;;9,0;;17,0;;11,0;6,0;29,0;60,0;;2,0;2,0;2,0;;;72,0;14,0;;12,0;35,0;6,0;;106,0;36,0;7,0;6,0;14,0;;;18,0;11,0;;4,0;22,0;5,0;;13,0;18,0;;7,0;6,0;;;10,0;3,0;;1,0;;32,0
define;3,0;9,0;;7,0;23,0;96,0;56,0;81,0;1,0;16,0;13,0;3,0;15,0;173,0;;18,0;84,0;11,0;52,0;28,0;10,0;22,0;34,0;15,0;10,0;;;19,0;9,0;12,0;111,0;17,0;6,0;8,0;4,0;110,0;;30,0;30,0;1,0;92,0;248,0;25,0;43,0;82,0;29,0;3,0;77,0;4,0;;8,0;2,0;51,0;12,0;145,0;59,0;39,0;;11,0;19,0;3,0;;48,0;;435,0;8,0;253,0;10,0;1,0;14,0;69,0;259,0;134,0;5,0;6,0;;7,0;14,0;11,0;19,0;187,0;7,0;6,0;24,0;106,0;21,0;2,0;140,0;12,0;10,0;99,0;11,0;25,0;17,0;5,0;;135,0;231,0;251,0;132,0;140,0;83,0;4,0;23,0;38,0;39,0;2,0;7,0;12,0;1,0;;50,0;159,0;4,0;1,0;2,0;37,0;65,0;83,0;160,0;6,0;2,0;48,0;42,0;7,0;19,0;180,0;2,0;8,0;8,0;63,0;12,0;3,0;81,0;4,0;;250,0;72,0;28,0;;2,0;20,0;4,0;;182,0;25,0;140,0;26,0;46,0;24,0;4,0;16,0;102,0;45,0;;;7,0;6,0;2,0;1,0;9,0;34,0;12,0;;;7,0;28,0;91,0;6,0;12,0;15,0;13,0;8,0;118,0;14,0;65,0;;10,0;3,0;;3,0;;4,0;47,0;5,0;2,0;49,0;5,0;90,0;76,0;2,0;7,0;3,0;7,0;33,0;164,0;175,0;3,0;51,0;2,0;;32,0;6,0;3,0;12,0;9,0;199,0;2,0;21,0;101,0;18,0;21,0;17,0;5,0;5,0;54,0;14,0;28,0;11,0;86,0;41,0;19,0;;6,0;87,0;1,0;296,0;5,0;5,0;;4,0;11,0;75,0;24,0;23,0;;2,0;1,0;;15,0;1,0;23,0;17,0;2,0;9,0;28,0;12,0;64,0;181,0;12,0;46,0;1,0;37,0;47,0;27,0;;114,0;364,0;14,0;;;5,0;;69,0;72,0;;3,0;21,0;3,0;32,0;;33,0;8,0;7,0;5,0;;16,0;156,0;14,0;11,0;16,0;5,0;195,0;35,0;2,0;1,0;7,0;10,0;32,0;30,0;12,0;14,0;2,0;23,0;31,0;19,0;79,0;7,0;1,0;9,0;3,0;10,0;9,0;20,0;;43,0;8,0;19,0;26,0;40,0;2,0;3,0;9,0;7,0;17,0;1,0;18,0;27,0;3,0;15,0;18,0;100,0;32,0;58,0;11,0;10,0;4,0;4,0;7,0;3,0;13,0;4,0;10,0;47,0;7,0;16,0;4,0;3,0;10,0;;13,0;51,0;17,0;20,0;10,0;11,0;24,0;140,0;;8,0;1,0;4,0;1,0;;48,0;15,0;5,0;57,0;62,0;4,0;53,0;;;26,0;1,0;3,0;7,0;15,0;1,0;3,0;11,0;;13,0;67,0;7,0;;5,0;19,0;5,0;2,0;34,0;72,0;1,0;8,0;1,0;41,0;4,0;11,0;11,0;8,0;;9,0;;15,0;9,0;40,0;1,0;18,0;;9,0;;56,0;7,0;17,0;6,0;84,0;9,0;13,0;18,0;6,0;4,0;13,0;5,0;14,0;10,0;33,0;12,0;18,0;4,0;;5,0;10,0;;10,0;5,0;111,0;4,0;12,0;2,0;20,0;16,0;1,0;31,0;;28,0;;9,0;23,0;4,0;2,0;7,0;3,0;35,0;26,0;11,0;7,0;18,0;3,0;82,0;4,0;;1,0;8,0;12,0;4,0;1,0;2,0;22,0;13,0;17,0;19,0;;7,0;6,0;;9,0;10,0;4,0;;19,0;;7,0;11,0;17,0;47,0;7,0;5,0;9,0;14,0;3,0;1,0;15,0;4,0;8,0;17,0;8,0;23,0;6,0;4,0;21,0;2,0;;1,0;17,0;1,0;;7,0;;;;1,0;19,0;4,0;9,0;27,0;27,0;4,0;;9,0;6,0;7,0;7,0;6,0;;5,0;6,0;;19,0;11,0;1,0;30,0;6,0;3,0;9,0;28,0;;38,0;2,0;4,0;;;25,0;11,0;38,0;56,0;;9,0;2,0;1,0;8,0;2,0;8,0;20,0;128,0;1,0;3,0;;16,0;9,0;;;14,0;5,0;6,0;12,0;2,0;;4,0;3,0;3,0;2,0;12,0;7,0;7,0;2,0;;27,0;15,0;16,0;6,0;;1,0;;12,0;38,0;20,0;;1,0;8,0;1,0;1,0;4,0;6,0;6,0;3,0;101,0;15,0;;1,0;26,0;;3,0;5,0;12,0;3,0;5,0;;8,0;17,0;5,0;13,0;2,0;;59,0;1,0;7,0;2,0;15,0;2,0;2,0;;;4,0;10,0;;4,0;1,0;2,0;;12,0;1,0;4,0;25,0;85,0;1,0;;15,0;;5,0;;2,0;4,0;1,0;11,0;2,0;;;5,0;11,0;1,0;;1,0;6,0;9,0;1,0;1,0;2,0;4,0;4,0;2,0;;5,0;;;50,0;1,0;5,0;;11,0;10,0;;;3,0;;15,0;;2,0;;7,0;;32,0;;7,0;;;6,0;;10,0;88,0;1,0;;;;2,0;;3,0;17,0;8,0;12,0;;;9,0;5,0;4,0;5,0;10,0;5,0;20,0;;2,0;4,0;7,0;;20,0;20,0;24,0;24,0;23,0;;10,0;;5,0;9,0;7,0;2,0;19,0;2,0;3,0;1,0;23,0;7,0;6,0;4,0;;;15,0;20,0;;9,0;4,0;;2,0;16,0;12,0;85,0;;2,0;10,0;2,0;22,0;5,0;4,0;1,0;38,0;;13,0;8,0;16,0;8,0;;4,0;;9,0;21,0;;11,0;6,0;5,0;2,0;1,0;33,0;3,0;;16,0;5,0;6,0;2,0;1,0;;;13,0;;17,0;;4,0;1,0;2,0;7,0;17,0;4,0;8,0;;1,0;7,0;28,0;7,0;4,0;18,0;;;;;7,0;;;;5,0;1,0;3,0;;;;2,0;13,0;6,0;15,0;;3,0;9,0;24,0;1,0;;;1,0;6,0;47,0;4,0;6,0;3,0;6,0;3,0;29,0;;;1,0;4,0;;36,0;2,0;;;1,0;1,0;;6,0;;;4,0;1,0;;;6,0;1,0;4,0;;2,0;5,0;6,0;;;46,0;2,0;1,0;;2,0;;30,0;2,0;5,0;;7,0;3,0;5,0;1,0;;3,0;3,0;1,0;;;3,0;1,0;1,0;6,0;;;1,0;;1,0;23,0;2,0;;3,0;7,0;;;;1,0;4,0;3,0;;2,0;;2,0;1,0;;;5,0;3,0;;;4,0;7,0;;;;;1,0;2,0;7,0;1,0;2,0;;3,0;1,0;;3,0;3,0;;9,0;18,0;1,0;9,0;;15,0;4,0;1,0;;7,0;8,0;1,0;1,0;;19,0;;;;;;2,0;1,0;;;;1,0;;3,0;2,0;;;4,0;;;6,0;;1,0;;1,0;4,0;6,0;;3,0;;6,0;5,0;2,0;8,0;21,0;4,0;;;26,0;31,0;5,0;1,0;;5,0;27,0;;;9,0;3,0;3,0;2,0;;3,0;;;3,0;;1,0;;;;;1,0;;;2,0;
degree;4,0;3,0;2,0;13,0;6,0;96,0;19,0;83,0;;;1,0;;3,0;93,0;;;79,0;;18,0;1,0;1,0;6,0;10,0;;;;;26,0;8,0;13,0;115,0;;5,0;9,0;2,0;27,0;30,0;;23,0;;74,0;144,0;1,0;21,0;29,0;28,0;3,0;133,0;;;16,0;;25,0;4,0;205,0;4,0;16,0;507,0;;18,0;8,0;;25,0;;235,0;1,0;60,0;4,0;;3,0;9,0;117,0;73,0;3,0;3,0;2,0;5,0;5,0;1,0;1,0;155,0;;5,0;28,0;57,0;1,0;14,0;77,0;2,0;3,0;7,0;5,0;3,0;1,0;3,0;;27,0;55,0;38,0;35,0;107,0;40,0;2,0;14,0;6,0;18,0;;7,0;;;;14,0;13,0;10,0;;;4,0;4,0;15,0;84,0;;1,0;18,0;3,0;;1,0;133,0;4,0;7,0;;15,0;9,0;;60,0;4,0;3,0;278,0;5,0;18,0;;;9,0;;;1,0;5,0;17,0;8,0;180,0;3,0;;1,0;31,0;3,0;;;1,0;;7,0;1,0;;14,0;10,0;3,0;1,0;1,0;7,0;26,0;1,0;5,0;1,0;11,0;4,0;261,0;12,0;37,0;;3,0;8,0;;;;7,0;20,0;69,0;2,0;10,0;9,0;13,0;12,0;;;10,0;65,0;4,0;5,0;34,0;11,0;16,0;1,0;;9,0;25,0;1,0;12,0;2,0;37,0;;20,0;46,0;11,0;133,0;24,0;;;6,0;8,0;25,0;4,0;4,0;10,0;;4,0;;27,0;;77,0;;;3,0;;5,0;178,0;13,0;5,0;3,0;6,0;;;12,0;10,0;21,0;35,0;;;14,0;4,0;4,0;11,0;3,0;;;;89,0;;;24,0;75,0;8,0;;;1,0;;21,0;3,0;4,0;;7,0;;10,0;3,0;;7,0;3,0;2,0;;25,0;398,0;14,0;5,0;4,0;1,0;175,0;1,0;;1,0;1,0;11,0;2,0;1,0;2,0;3,0;3,0;5,0;3,0;2,0;20,0;;;3,0;8,0;1,0;;;1,0;;3,0;14,0;3,0;17,0;10,0;;2,0;;14,0;;10,0;2,0;;7,0;10,0;64,0;5,0;32,0;1,0;4,0;1,0;1,0;9,0;1,0;8,0;3,0;17,0;2,0;2,0;1,0;1,0;;3,0;3,0;116,0;69,0;18,0;10,0;;3,0;6,0;5,0;1,0;;;;;;3,0;1,0;;2,0;23,0;3,0;;;3,0;;;7,0;7,0;37,0;1,0;;;;37,0;13,0;18,0;11,0;4,0;;1,0;1,0;19,0;8,0;;;2,0;17,0;6,0;4,0;;1,0;11,0;1,0;;12,0;13,0;2,0;13,0;5,0;20,0;2,0;;8,0;8,0;9,0;20,0;4,0;;6,0;242,0;14,0;3,0;7,0;;13,0;2,0;20,0;;11,0;;;;10,0;2,0;3,0;1,0;142,0;2,0;6,0;1,0;5,0;2,0;;;2,0;2,0;12,0;4,0;5,0;4,0;1,0;88,0;8,0;28,0;33,0;;8,0;4,0;66,0;5,0;;1,0;;;3,0;3,0;3,0;6,0;1,0;;;6,0;1,0;2,0;18,0;2,0;8,0;1,0;;6,0;;2,0;2,0;6,0;2,0;;64,0;5,0;5,0;1,0;11,0;8,0;2,0;4,0;21,0;2,0;33,0;2,0;3,0;2,0;4,0;;;2,0;1,0;;4,0;3,0;1,0;;1,0;7,0;;;;4,0;33,0;13,0;;1,0;;3,0;2,0;;;2,0;2,0;1,0;13,0;2,0;;1,0;11,0;;5,0;;;3,0;1,0;1,0;;13,0;12,0;2,0;1,0;65,0;;1,0;2,0;4,0;27,0;;3,0;;7,0;;12,0;;;3,0;;;1,0;;;;;;;2,0;;;;4,0;7,0;2,0;;3,0;1,0;;2,0;;;;8,0;18,0;19,0;;3,0;;;;;6,0;2,0;1,0;1,0;19,0;1,0;3,0;4,0;;;;;;;;;24,0;;10,0;;;7,0;1,0;;4,0;1,0;;;1,0;;;2,0;;5,0;2,0;;;11,0;;2,0;1,0;4,0;1,0;;13,0;2,0;;;;;;;7,0;;;2,0;11,0;12,0;1,0;2,0;2,0;1,0;;;;1,0;1,0;;;1,0;;;3,0;;;;2,0;;6,0;;;;6,0;;6,0;;3,0;;14,0;14,0;12,0;;7,0;;;;34,0;12,0;;;;;;1,0;;;;1,0;;11,0;;;;7,0;1,0;2,0;;;;4,0;1,0;7,0;26,0;;2,0;1,0;;;3,0;;1,0;1,0;7,0;1,0;;2,0;;10,0;1,0;1,0;11,0;1,0;;13,0;10,0;9,0;;;;;1,0;1,0;110,0;;1,0;11,0;2,0;;;7,0;6,0;3,0;;;1,0;;2,0;;7,0;;5,0;;;;;;3,0;;5,0;;1,0;;;;15,0;;1,0;;10,0;;3,0;;;4,0;4,0;;1,0;1,0;;;2,0;12,0;9,0;4,0;;2,0;;;;;1,0;;1,0;;1,0;;;;;;;13,0;;3,0;;2,0;;3,0;2,0;;;1,0;;1,0;;;;46,0;;5,0;;;3,0;15,0;;1,0;;;1,0;;4,0;;;7,0;1,0;6,0;3,0;4,0;;1,0;;4,0;6,0;;;2,0;;6,0;;5,0;;;5,0;;4,0;;;;;;;;;;;2,0;;;;;5,0;;2,0;;;;;;;;;;8,0;;2,0;;;15,0;;5,0;;2,0;;;;1,0;3,0;1,0;;4,0;2,0;1,0;;;3,0;;2,0;2,0;;;1,0;;;;7,0;;;;;;9,0;;;;;;2,0;4,0;;21,0;1,0;6,0;10,0;3,0;2,0;;;12,0;;;2,0;;1,0;;;1,0;;;;;;1,0;;;;;;2,0;10,0;4,0;2,0;;5,0;1,0;;2,0;;;;7,0;;;;;40,0;;7,0;;;;1,0;;8,0;1,0;2,0;;;;1,0;7,0;;4,0;;;1,0;;1,0;
depth;5,0;;5,0;87,0;46,0;102,0;117,0;8,0;6,0;5,0;4,0;;;524,0;2,0;14,0;356,0;10,0;23,0;1,0;;1,0;165,0;5,0;3,0;4,0;;53,0;36,0;5,0;194,0;44,0;18,0;60,0;1,0;343,0;30,0;23,0;;11,0;634,0;258,0;15,0;16,0;40,0;10,0;9,0;49,0;13,0;22,0;325,0;;35,0;4,0;471,0;55,0;30,0;;15,0;577,0;;4,0;20,0;1,0;2141,0;7,0;253,0;114,0;9,0;;23,0;92,0;182,0;1,0;10,0;11,0;6,0;116,0;2,0;16,0;537,0;3,0;47,0;74,0;87,0;10,0;1,0;67,0;;16,0;65,0;3,0;;7,0;21,0;;844,0;73,0;393,0;309,0;166,0;101,0;;38,0;153,0;168,0;16,0;18,0;1,0;;3,0;190,0;161,0;2,0;1,0;35,0;157,0;148,0;387,0;220,0;52,0;2,0;59,0;22,0;2,0;35,0;252,0;;;17,0;78,0;17,0;3,0;73,0;13,0;;82,0;56,0;;;;21,0;;3,0;13,0;40,0;48,0;38,0;124,0;3,0;;1,0;33,0;3,0;19,0;14,0;;;;;;26,0;4,0;43,0;;25,0;4,0;11,0;5,0;18,0;8,0;2,0;11,0;59,0;;48,0;;22,0;8,0;;;;3,0;19,0;;2,0;86,0;;303,0;6,0;;2,0;5,0;6,0;2,0;5,0;15,0;2,0;;11,0;;7,0;6,0;;123,0;20,0;6,0;;1,0;17,0;7,0;11,0;9,0;1,0;;3,0;44,0;8,0;25,0;8,0;62,0;5,0;1,0;1,0;13,0;;116,0;1,0;;29,0;;2,0;306,0;7,0;;6,0;19,0;4,0;;41,0;;1,0;;;;113,0;46,0;11,0;15,0;;1,0;;;16,0;19,0;3,0;4,0;152,0;9,0;;6,0;1,0;15,0;;2,0;1,0;;5,0;19,0;42,0;;;3,0;3,0;;;3,0;45,0;;6,0;1,0;3,0;23,0;6,0;4,0;;3,0;2,0;13,0;;2,0;51,0;;;2,0;1,0;285,0;2,0;;;;;;20,0;6,0;33,0;;20,0;13,0;52,0;;9,0;6,0;;6,0;;18,0;3,0;8,0;;72,0;429,0;;13,0;;1,0;2,0;;9,0;5,0;6,0;;;37,0;4,0;3,0;;;148,0;;;10,0;;2,0;2,0;3,0;32,0;39,0;;3,0;;;3,0;;25,0;;1,0;11,0;136,0;1,0;17,0;;;4,0;;4,0;2,0;;;2,0;;;110,0;6,0;54,0;3,0;27,0;4,0;67,0;5,0;59,0;62,0;19,0;21,0;2,0;36,0;66,0;82,0;17,0;1,0;11,0;3,0;51,0;183,0;2,0;17,0;2,0;114,0;106,0;1,0;;41,0;13,0;24,0;4,0;255,0;10,0;14,0;42,0;;10,0;20,0;28,0;15,0;40,0;19,0;1,0;;;24,0;9,0;20,0;2,0;10,0;8,0;105,0;3,0;32,0;8,0;;92,0;;82,0;;3,0;;25,0;51,0;4,0;7,0;11,0;;108,0;2,0;1,0;20,0;2,0;;22,0;;85,0;7,0;9,0;4,0;;;14,0;70,0;;14,0;239,0;6,0;17,0;42,0;;7,0;47,0;;4,0;;23,0;;30,0;3,0;;;16,0;1,0;9,0;16,0;;11,0;;76,0;17,0;12,0;97,0;9,0;;102,0;;;24,0;33,0;1,0;3,0;15,0;1,0;;;30,0;16,0;2,0;16,0;16,0;10,0;1,0;;5,0;27,0;;43,0;;;1,0;27,0;;37,0;;;;;6,0;1,0;3,0;;1,0;4,0;;2,0;;8,0;;8,0;;4,0;19,0;4,0;;13,0;9,0;22,0;;20,0;1,0;1,0;;3,0;;;;;6,0;60,0;;4,0;5,0;;;;2,0;;1,0;8,0;74,0;1,0;11,0;;16,0;25,0;1,0;;;1,0;16,0;22,0;5,0;2,0;;;2,0;1,0;11,0;;6,0;5,0;1,0;;33,0;23,0;1,0;3,0;3,0;13,0;;3,0;;;43,0;;4,0;1,0;5,0;151,0;;;;;1,0;2,0;7,0;3,0;16,0;5,0;5,0;;17,0;;;;;;32,0;66,0;;13,0;;;;4,0;;;;2,0;;;;;1,0;70,0;3,0;2,0;1,0;4,0;3,0;22,0;5,0;1,0;;26,0;;12,0;23,0;23,0;22,0;8,0;27,0;9,0;73,0;25,0;10,0;6,0;1,0;2,0;3,0;;12,0;;;4,0;26,0;;;;30,0;21,0;1,0;8,0;40,0;1,0;;2,0;;;;2,0;15,0;;1,0;;;;7,0;3,0;;1,0;;5,0;;;2,0;;9,0;3,0;7,0;;;;;11,0;1,0;12,0;1,0;1,0;;25,0;1,0;;;41,0;;;2,0;;14,0;2,0;;3,0;31,0;25,0;;;7,0;9,0;85,0;;7,0;;6,0;;16,0;3,0;;4,0;;4,0;1,0;5,0;10,0;2,0;;;;2,0;;4,0;;4,0;6,0;;;;;;;;1,0;3,0;1,0;;35,0;;26,0;;;;;;;;1,0;;;;2,0;10,0;;27,0;;4,0;;1,0;7,0;;;4,0;3,0;6,0;2,0;;;;1,0;2,0;;16,0;19,0;3,0;;2,0;2,0;58,0;;3,0;;16,0;22,0;;2,0;12,0;;28,0;1,0;;8,0;3,0;;;1,0;1,0;20,0;;59,0;;;5,0;4,0;1,0;;;6,0;7,0;;77,0;10,0;;1,0;2,0;8,0;;2,0;58,0;;1,0;12,0;13,0;69,0;1,0;;7,0;10,0;8,0;1,0;1,0;;1,0;34,0;;2,0;;2,0;2,0;13,0;5,0;18,0;2,0;;7,0;15,0;3,0;;4,0;5,0;2,0;;;;;;9,0;5,0;;7,0;6,0;;;;;;2,0;;6,0;;;;;1,0;1,0;2,0;6,0;;;6,0;;;;;;1,0;;;;;;;;1,0;33,0;3,0;15,0;;1,0;1,0;10,0;;;;;;;;;34,0;1,0;;;;;2,0;2,0;10,0;;6,0;;;;8,0;;2,0;;;4,0;35,0;;;;3,0;;;;23,0;;;;;1,0;2,0;12,0;;1,0;;30,0;40,0;;30,0;;;;70,0;48,0;;1,0;;12,0;;;;;;
design;3,0;;;1,0;;6,0;11,0;4,0;;;;;;8,0;;;7,0;2,0;;;;;15,0;;;2,0;;12,0;1,0;;2,0;;2,0;;;13,0;1,0;;11,0;;12,0;36,0;11,0;38,0;15,0;;;24,0;;;;;10,0;1,0;11,0;3,0;16,0;1,0;1,0;13,0;;;8,0;1,0;33,0;;43,0;1,0;1,0;;3,0;61,0;35,0;;;;;2,0;;3,0;44,0;;1,0;15,0;23,0;1,0;;36,0;6,0;1,0;4,0;;11,0;;1,0;;4,0;5,0;6,0;6,0;5,0;1,0;;;8,0;;;;;;;4,0;1,0;;;;3,0;;;14,0;;;6,0;1,0;;3,0;38,0;;1,0;;1,0;;;32,0;;;4,0;1,0;1,0;;;;;;;1,0;4,0;19,0;2,0;3,0;;2,0;2,0;4,0;;1,0;;;;;;13,0;;;1,0;;6,0;18,0;1,0;3,0;;1,0;4,0;11,0;;;;10,0;2,0;;;;18,0;3,0;;1,0;18,0;;5,0;8,0;;1,0;;2,0;2,0;7,0;3,0;2,0;1,0;3,0;;92,0;2,0;;3,0;1,0;2,0;1,0;1,0;4,0;20,0;5,0;;;;;2,0;5,0;;4,0;2,0;;;;;;38,0;1,0;1,0;;;1,0;7,0;;2,0;;4,0;;2,0;5,0;;;;;;2,0;;1,0;9,0;;3,0;;13,0;90,0;1,0;;5,0;6,0;2,0;;;8,0;1,0;6,0;1,0;1,0;;13,0;;32,0;;1,0;;;;;2,0;2,0;;5,0;3,0;6,0;10,0;4,0;;;1,0;;4,0;;;2,0;;;;;2,0;;1,0;;;;1,0;;;;2,0;;;5,0;;;1,0;;;;;1,0;6,0;3,0;6,0;17,0;3,0;1,0;;;;3,0;1,0;3,0;;;;;;;;;;;;;1,0;5,0;2,0;1,0;1,0;1,0;;3,0;;1,0;1,0;1,0;;;;;11,0;1,0;;;;;;1,0;;;;;;;5,0;;;;;1,0;3,0;;5,0;;;;2,0;5,0;;;1,0;;7,0;1,0;2,0;1,0;;1,0;;2,0;;;;40,0;3,0;;;1,0;;;;;1,0;;;5,0;;;1,0;;;;;;;2,0;;13,0;;1,0;;;2,0;;9,0;;;;;1,0;;;1,0;2,0;;9,0;;2,0;;;20,0;;;1,0;;1,0;;;;;;;;1,0;;1,0;;;;;;;;;5,0;16,0;1,0;;2,0;1,0;;2,0;;;1,0;2,0;3,0;;1,0;;2,0;2,0;;2,0;;;;1,0;;;7,0;;1,0;;;;;2,0;2,0;;;;2,0;;2,0;1,0;;;2,0;2,0;1,0;;3,0;2,0;1,0;;;;2,0;;;;;2,0;2,0;3,0;;;1,0;;;3,0;1,0;;2,0;3,0;1,0;;;;2,0;;;;;1,0;1,0;5,0;;;;;;;;;;;1,0;;;;;;;;;2,0;;;;1,0;;;1,0;;4,0;;;3,0;;;1,0;;;;;;;;6,0;1,0;6,0;;;1,0;1,0;2,0;;2,0;;;;;;;2,0;;2,0;;;4,0;;;4,0;;;1,0;;;;;;;3,0;1,0;;;;;;9,0;;;;;;;;;;;;;1,0;;1,0;;2,0;;1,0;;;2,0;;2,0;;;;;;;4,0;;;;;;;;3,0;;;;;1,0;1,0;;1,0;;;;;1,0;1,0;;;4,0;;;;;;;;4,0;1,0;;;;;1,0;1,0;1,0;4,0;6,0;;2,0;;;;;;;2,0;;;;2,0;;;;1,0;;;2,0;1,0;;;;4,0;;2,0;1,0;;3,0;;;;;14,0;;;;;;;;5,0;;;;;1,0;;;;1,0;2,0;2,0;;2,0;;;1,0;;;;1,0;1,0;10,0;;;;1,0;;;1,0;;;;;;2,0;;;;;1,0;;;;;;;;1,0;;;;;;;;;;;;2,0;;;;;;;;;;;6,0;1,0;;1,0;;1,0;;;;;;;;;;;;;;;;;;;;;1,0;;;1,0;;;;;6,0;;;;;;1,0;;;;;;;;;1,0;;;2,0;;;;1,0;;;2,0;;;;;;;;;;;;;;;;;;;;1,0;2,0;;;;2,0;;;1,0;;2,0;;;;2,0;;;;;;;;;;3,0;;;2,0;;;;;;;;;;;;;;;;;;;1,0;;;;;;1,0;;;;;;2,0;;;;;2,0;;;;;;;;;2,0;;;;;;;;;;;;;2,0;;;;2,0;1,0;;;
determine;1,0;50,0;3,0;158,0;268,0;383,0;80,0;23,0;16,0;72,0;5,0;27,0;2,0;2348,0;3,0;100,0;738,0;7,0;39,0;212,0;5,0;44,0;324,0;15,0;49,0;16,0;57,0;171,0;170,0;298,0;1097,0;318,0;46,0;212,0;;1154,0;92,0;74,0;634,0;12,0;;1760,0;12,0;134,0;494,0;10,0;47,0;120,0;35,0;141,0;184,0;9,0;29,0;14,0;288,0;102,0;64,0;3,0;130,0;158,0;1,0;8,0;86,0;32,0;4316,0;14,0;741,0;33,0;50,0;26,0;160,0;472,0;465,0;9,0;13,0;102,0;9,0;134,0;47,0;101,0;1972,0;;263,0;174,0;309,0;26,0;9,0;203,0;3,0;71,0;487,0;31,0;40,0;10,0;104,0;1,0;907,0;238,0;958,0;1115,0;1817,0;277,0;;137,0;269,0;1098,0;33,0;195,0;163,0;15,0;12,0;416,0;610,0;14,0;;108,0;109,0;150,0;384,0;673,0;80,0;12,0;429,0;189,0;35,0;159,0;1016,0;;96,0;13,0;637,0;30,0;15,0;655,0;4,0;;463,0;128,0;181,0;;;45,0;9,0;16,0;24,0;114,0;326,0;40,0;580,0;11,0;20,0;103,0;124,0;46,0;19,0;8,0;;8,0;4,0;1,0;3,0;28,0;102,0;15,0;2,0;101,0;32,0;41,0;5,0;133,0;53,0;42,0;43,0;610,0;12,0;411,0;3,0;25,0;21,0;6,0;44,0;5,0;7,0;149,0;;24,0;83,0;16,0;597,0;20,0;13,0;52,0;3,0;2,0;;5,0;62,0;25,0;3,0;6,0;;16,0;9,0;27,0;171,0;148,0;54,0;1,0;77,0;94,0;132,0;273,0;133,0;;;5,0;173,0;23,0;8,0;129,0;211,0;149,0;114,0;2,0;19,0;1,0;300,0;10,0;1,0;18,0;1,0;40,0;314,0;122,0;6,0;24,0;86,0;38,0;;93,0;;7,0;2,0;;;275,0;31,0;79,0;40,0;1,0;;1,0;9,0;63,0;2,0;12,0;15,0;175,0;26,0;;42,0;46,0;61,0;557,0;9,0;36,0;8,0;22,0;113,0;47,0;6,0;11,0;18,0;33,0;;;7,0;543,0;;43,0;8,0;66,0;110,0;23,0;74,0;4,0;21,0;24,0;95,0;5,0;19,0;202,0;;2,0;43,0;3,0;975,0;87,0;;1,0;1,0;1,0;2,0;58,0;1,0;;12,0;133,0;135,0;185,0;2,0;;21,0;2,0;21,0;;83,0;4,0;23,0;28,0;239,0;1742,0;10,0;121,0;3,0;1,0;3,0;;93,0;15,0;1,0;;;;58,0;2,0;6,0;;24,0;3,0;29,0;167,0;80,0;;3,0;4,0;155,0;78,0;4,0;;12,0;;63,0;3,0;258,0;;45,0;4,0;708,0;50,0;38,0;18,0;18,0;63,0;10,0;179,0;211,0;20,0;2,0;11,0;;16,0;112,0;95,0;324,0;4,0;15,0;93,0;177,0;128,0;520,0;531,0;33,0;19,0;90,0;408,0;240,0;295,0;68,0;142,0;138,0;90,0;87,0;324,0;29,0;266,0;3,0;277,0;88,0;52,0;14,0;281,0;20,0;208,0;39,0;1209,0;23,0;63,0;414,0;31,0;4,0;209,0;17,0;97,0;273,0;488,0;10,0;52,0;69,0;34,0;9,0;179,0;10,0;58,0;33,0;265,0;84,0;483,0;144,0;27,0;49,0;4,0;340,0;26,0;195,0;9,0;112,0;211,0;45,0;53,0;129,0;68,0;499,0;103,0;36,0;69,0;95,0;47,0;749,0;72,0;37,0;37,0;45,0;9,0;52,0;20,0;24,0;296,0;7,0;47,0;277,0;1,0;67,0;14,0;6,0;29,0;45,0;21,0;38,0;86,0;74,0;89,0;364,0;51,0;4,0;15,0;31,0;65,0;69,0;35,0;3,0;11,0;93,0;70,0;63,0;25,0;265,0;89,0;47,0;347,0;38,0;67,0;71,0;46,0;26,0;1,0;80,0;11,0;22,0;30,0;12,0;106,0;6,0;78,0;222,0;49,0;18,0;12,0;4,0;8,0;53,0;132,0;4,0;13,0;5,0;120,0;2,0;77,0;10,0;2,0;41,0;29,0;6,0;52,0;49,0;13,0;;;2,0;1,0;2,0;128,0;;28,0;39,0;6,0;81,0;68,0;5,0;307,0;73,0;47,0;5,0;37,0;15,0;93,0;3,0;15,0;1,0;55,0;3,0;3,0;78,0;66,0;45,0;14,0;5,0;31,0;1,0;25,0;34,0;95,0;44,0;34,0;97,0;24,0;72,0;18,0;54,0;34,0;15,0;13,0;4,0;10,0;34,0;46,0;36,0;91,0;;6,0;32,0;7,0;50,0;3,0;7,0;3,0;;27,0;107,0;48,0;6,0;74,0;19,0;64,0;16,0;4,0;23,0;23,0;149,0;8,0;70,0;52,0;31,0;638,0;16,0;57,0;9,0;53,0;63,0;25,0;11,0;1,0;74,0;37,0;9,0;;50,0;29,0;56,0;6,0;11,0;1,0;175,0;171,0;6,0;9,0;6,0;7,0;5,0;13,0;1,0;26,0;4,0;53,0;3,0;38,0;10,0;2,0;10,0;77,0;1,0;8,0;1,0;4,0;64,0;29,0;30,0;5,0;6,0;6,0;3,0;16,0;33,0;30,0;60,0;15,0;88,0;18,0;66,0;36,0;11,0;42,0;30,0;14,0;69,0;;10,0;2,0;;14,0;154,0;8,0;26,0;104,0;35,0;102,0;29,0;36,0;591,0;13,0;60,0;11,0;3,0;36,0;6,0;28,0;26,0;13,0;8,0;2,0;4,0;1,0;20,0;11,0;7,0;19,0;11,0;66,0;2,0;;10,0;17,0;30,0;14,0;49,0;2,0;7,0;11,0;;85,0;6,0;17,0;3,0;18,0;8,0;94,0;4,0;6,0;42,0;106,0;55,0;3,0;4,0;15,0;81,0;13,0;;25,0;29,0;72,0;2,0;2,0;;48,0;308,0;25,0;42,0;;145,0;;55,0;2,0;26,0;4,0;;12,0;21,0;23,0;6,0;8,0;1,0;;;;1,0;;53,0;13,0;1,0;3,0;5,0;1,0;6,0;;;21,0;;2,0;5,0;3,0;76,0;7,0;107,0;;;3,0;;;2,0;13,0;12,0;44,0;1,0;63,0;2,0;83,0;;49,0;8,0;6,0;;;68,0;10,0;15,0;;13,0;6,0;96,0;;;;2,0;212,0;3,0;17,0;;6,0;98,0;94,0;4,0;55,0;2,0;3,0;7,0;108,0;;44,0;48,0;61,0;1,0;140,0;42,0;5,0;29,0;12,0;;20,0;5,0;2,0;4,0;6,0;62,0;;72,0;44,0;28,0;7,0;;15,0;5,0;;20,0;64,0;69,0;5,0;16,0;53,0;9,0;22,0;38,0;30,0;10,0;8,0;18,0;11,0;73,0;28,0;27,0;2,0;66,0;31,0;19,0;24,0;22,0;12,0;64,0;17,0;16,0;9,0;29,0;44,0;38,0;54,0;19,0;29,0;7,0;10,0;60,0;18,0;9,0;3,0;21,0;26,0;;26,0;2,0;51,0;6,0;8,0;19,0;10,0;10,0;13,0;4,0;15,0;4,0;28,0;17,0;7,0;10,0;33,0;4,0;17,0;45,0;5,0;1,0;55,0;17,0;4,0;1,0;4,0;4,0;68,0;;6,0;7,0;;28,0;8,0;2,0;6,0;6,0;16,0;;93,0;51,0;67,0;13,0;22,0;43,0;6,0;;21,0;10,0;4,0;;;;11,0;6,0;;52,0;;4,0;1,0;1,0;1,0;1,0;1,0;19,0;;10,0;6,0;7,0;;5,0;;13,0;38,0;;16,0;41,0;5,0;1,0;;22,0;54,0;33,0;41,0;26,0;12,0;4,0;3,0;75,0;;64,0;129,0;;;22,0;39,0;18,0;4,0;47,0;85,0;;3,0;203,0;6,0;29,0;;;34,0;8,0;;2,0;6,0;2,0;
device;9,0;335,0;13,0;287,0;120,0;794,0;360,0;344,0;13,0;21,0;39,0;18,0;56,0;1301,0;12,0;34,0;4066,0;41,0;87,0;85,0;56,0;16,0;346,0;326,0;980,0;10,0;62,0;311,0;479,0;170,0;2644,0;369,0;53,0;157,0;105,0;2182,0;248,0;144,0;258,0;36,0;1760,0;;38,0;570,0;4173,0;515,0;27,0;692,0;18,0;13,0;103,0;32,0;143,0;633,0;463,0;164,0;394,0;7,0;51,0;572,0;26,0;7,0;235,0;109,0;8050,0;122,0;3095,0;41,0;52,0;31,0;223,0;2333,0;1530,0;126,0;43,0;20,0;100,0;209,0;338,0;773,0;2629,0;7,0;512,0;118,0;1162,0;178,0;21,0;1244,0;35,0;49,0;187,0;53,0;80,0;232,0;160,0;25,0;673,0;160,0;1649,0;393,0;1753,0;275,0;24,0;161,0;1095,0;1641,0;60,0;514,0;35,0;11,0;11,0;207,0;413,0;42,0;28,0;42,0;118,0;165,0;189,0;1590,0;142,0;21,0;1290,0;127,0;19,0;599,0;2281,0;21,0;145,0;33,0;564,0;24,0;8,0;1200,0;27,0;17,0;750,0;210,0;199,0;8,0;3,0;60,0;162,0;5,0;184,0;162,0;392,0;267,0;702,0;294,0;69,0;147,0;362,0;84,0;37,0;95,0;9,0;31,0;6,0;3,0;81,0;774,0;183,0;85,0;57,0;13,0;875,0;296,0;14,0;450,0;118,0;44,0;405,0;612,0;44,0;174,0;55,0;313,0;259,0;13,0;47,0;115,0;64,0;326,0;15,0;54,0;318,0;70,0;391,0;303,0;10,0;36,0;45,0;215,0;239,0;106,0;857,0;47,0;93,0;55,0;27,0;161,0;30,0;24,0;372,0;202,0;698,0;50,0;184,0;1186,0;327,0;420,0;94,0;16,0;12,0;171,0;620,0;71,0;25,0;136,0;196,0;142,0;86,0;173,0;109,0;31,0;857,0;13,0;39,0;89,0;18,0;48,0;223,0;32,0;103,0;34,0;64,0;42,0;40,0;97,0;8,0;107,0;51,0;18,0;55,0;400,0;143,0;130,0;520,0;54,0;36,0;22,0;34,0;265,0;270,0;157,0;419,0;904,0;53,0;125,0;216,0;541,0;157,0;621,0;74,0;22,0;140,0;49,0;26,0;105,0;13,0;168,0;172,0;175,0;107,0;9,0;159,0;494,0;23,0;89,0;111,0;90,0;372,0;195,0;8,0;37,0;77,0;290,0;503,0;73,0;100,0;144,0;19,0;17,0;42,0;37,0;581,0;129,0;53,0;65,0;116,0;15,0;67,0;64,0;4,0;77,0;48,0;216,0;69,0;4279,0;21,0;29,0;65,0;25,0;36,0;19,0;231,0;218,0;55,0;191,0;3635,0;901,0;95,0;88,0;127,0;55,0;434,0;28,0;499,0;75,0;45,0;10,0;30,0;62,0;459,0;30,0;48,0;30,0;29,0;11,0;216,0;239,0;75,0;86,0;34,0;131,0;39,0;139,0;8,0;111,0;8,0;14,0;41,0;49,0;236,0;47,0;151,0;107,0;1560,0;864,0;46,0;16,0;53,0;82,0;73,0;192,0;134,0;42,0;9,0;89,0;29,0;9,0;202,0;153,0;247,0;66,0;38,0;282,0;125,0;43,0;2609,0;292,0;18,0;125,0;49,0;951,0;156,0;73,0;25,0;130,0;41,0;502,0;59,0;341,0;59,0;320,0;23,0;425,0;265,0;74,0;29,0;879,0;162,0;263,0;49,0;789,0;72,0;238,0;551,0;195,0;27,0;298,0;11,0;414,0;576,0;660,0;13,0;31,0;47,0;17,0;14,0;137,0;29,0;135,0;117,0;1833,0;875,0;506,0;124,0;22,0;429,0;72,0;455,0;43,0;100,0;20,0;851,0;241,0;448,0;74,0;45,0;214,0;156,0;142,0;17,0;295,0;25,0;31,0;1963,0;28,0;26,0;82,0;210,0;80,0;57,0;63,0;72,0;357,0;24,0;87,0;2894,0;52,0;38,0;81,0;7,0;52,0;35,0;77,0;93,0;53,0;226,0;84,0;838,0;669,0;25,0;52,0;150,0;125,0;83,0;57,0;172,0;30,0;98,0;156,0;186,0;307,0;623,0;99,0;944,0;83,0;26,0;23,0;81,0;98,0;78,0;51,0;524,0;72,0;64,0;27,0;95,0;223,0;43,0;262,0;15,0;60,0;55,0;207,0;18,0;73,0;167,0;23,0;53,0;26,0;40,0;167,0;170,0;91,0;35,0;23,0;302,0;113,0;26,0;60,0;31,0;18,0;42,0;11,0;22,0;22,0;55,0;212,0;48,0;154,0;68,0;208,0;44,0;40,0;80,0;79,0;23,0;46,0;53,0;243,0;29,0;214,0;11,0;12,0;55,0;120,0;13,0;55,0;89,0;95,0;426,0;184,0;22,0;19,0;25,0;19,0;21,0;141,0;98,0;24,0;54,0;10,0;156,0;46,0;274,0;90,0;30,0;33,0;65,0;57,0;94,0;110,0;20,0;94,0;23,0;78,0;28,0;11,0;64,0;69,0;94,0;70,0;145,0;524,0;151,0;57,0;388,0;39,0;14,0;21,0;36,0;80,0;25,0;78,0;160,0;50,0;72,0;131,0;20,0;244,0;160,0;136,0;51,0;247,0;19,0;87,0;125,0;27,0;11,0;45,0;491,0;32,0;34,0;78,0;210,0;26,0;67,0;43,0;29,0;46,0;343,0;6,0;12,0;1,0;13,0;132,0;14,0;36,0;29,0;622,0;21,0;19,0;11,0;16,0;27,0;33,0;186,0;76,0;21,0;26,0;67,0;133,0;30,0;73,0;85,0;42,0;5,0;23,0;73,0;11,0;35,0;46,0;74,0;11,0;69,0;15,0;45,0;282,0;205,0;101,0;163,0;12,0;16,0;617,0;29,0;354,0;460,0;17,0;51,0;56,0;6,0;33,0;4,0;31,0;470,0;4,0;23,0;10,0;90,0;170,0;59,0;98,0;91,0;7,0;44,0;53,0;8,0;32,0;94,0;17,0;44,0;228,0;25,0;50,0;46,0;52,0;55,0;31,0;16,0;286,0;795,0;28,0;37,0;75,0;59,0;25,0;45,0;12,0;33,0;30,0;55,0;299,0;6,0;93,0;30,0;55,0;105,0;8,0;51,0;89,0;38,0;81,0;35,0;81,0;76,0;47,0;13,0;17,0;27,0;56,0;367,0;46,0;23,0;46,0;53,0;15,0;42,0;34,0;15,0;37,0;15,0;36,0;92,0;62,0;55,0;12,0;8,0;39,0;65,0;11,0;9,0;12,0;28,0;67,0;19,0;17,0;30,0;24,0;1,0;5,0;12,0;22,0;65,0;6,0;37,0;3,0;35,0;15,0;123,0;6,0;26,0;1,0;10,0;13,0;92,0;21,0;4,0;115,0;11,0;48,0;126,0;8,0;24,0;46,0;9,0;6,0;39,0;19,0;29,0;26,0;58,0;32,0;220,0;81,0;67,0;58,0;20,0;33,0;77,0;172,0;30,0;1,0;9,0;10,0;46,0;23,0;23,0;20,0;17,0;18,0;87,0;41,0;291,0;71,0;7,0;6,0;11,0;18,0;13,0;34,0;44,0;20,0;6,0;55,0;38,0;12,0;5,0;323,0;25,0;;19,0;19,0;13,0;21,0;5,0;7,0;23,0;9,0;2,0;16,0;8,0;23,0;5,0;3,0;26,0;20,0;57,0;69,0;35,0;16,0;22,0;32,0;54,0;29,0;20,0;49,0;12,0;97,0;31,0;38,0;11,0;14,0;8,0;70,0;35,0;63,0;5,0;23,0;31,0;50,0;191,0;1,0;14,0;57,0;12,0;25,0;9,0;33,0;57,0;23,0;8,0;2,0;7,0;22,0;14,0;7,0;18,0;76,0;31,0;31,0;19,0;33,0;9,0;287,0;38,0;14,0;25,0;15,0;26,0;1,0;47,0;49,0;34,0;12,0;27,0;43,0;40,0;20,0;7,0;16,0;35,0;17,0;26,0;10,0;22,0;14,0;28,0;4,0;16,0;3,0;45,0;27,0;49,0;20,0;83,0;10,0;11,0;6,0;12,0;20,0;24,0;42,0;5,0;16,0;18,0;13,0;6,0;13,0;54,0;42,0;;8,0;11,0;5,0;8,0;17,0;36,0;9,0;42,0;22,0;14,0;4,0;16,0;12,0;8,0;16,0;11,0;37,0;20,0;14,0;18,0;17,0;9,0;10,0;28,0;2,0;15,0;25,0;7,0;76,0;16,0;6,0;19,0;11,0;21,0;;54,0;2,0;2,0;28,0;44,0;17,0;13,0;4,0;22,0;6,0;9,0;99,0;1,0;10,0;13,0;15,0;11,0;5,0;;1,0
diameter;4,0;6,0;3,0;7,0;;17,0;3,0;34,0;;;;2,0;25,0;18,0;;;3,0;;2,0;;11,0;57,0;;;;;;22,0;2,0;;6,0;1,0;;;;;25,0;1,0;15,0;11,0;12,0;38,0;;9,0;2,0;14,0;;67,0;;;;;10,0;42,0;;2,0;46,0;;;2,0;;;17,0;;54,0;;52,0;19,0;;4,0;32,0;270,0;13,0;;;;7,0;2,0;;;17,0;1,0;1,0;;72,0;1,0;;49,0;1,0;6,0;4,0;3,0;7,0;4,0;;;3,0;2,0;18,0;3,0;26,0;6,0;;1,0;;;;2,0;;10,0;1,0;2,0;11,0;;;;2,0;11,0;;29,0;;;3,0;22,0;;1,0;58,0;2,0;;8,0;5,0;1,0;;19,0;1,0;;;;3,0;;;9,0;;;55,0;;10,0;13,0;1,0;;1,0;;50,0;33,0;;;12,0;;;5,0;1,0;22,0;;;;1,0;21,0;4,0;10,0;;;;;30,0;2,0;7,0;;;11,0;2,0;;;;21,0;1,0;3,0;9,0;;5,0;12,0;14,0;;1,0;1,0;10,0;128,0;24,0;2,0;159,0;19,0;;5,0;;;5,0;;47,0;;;53,0;1,0;1,0;;2,0;;201,0;3,0;7,0;;2,0;2,0;;;;6,0;;146,0;;2,0;2,0;9,0;2,0;17,0;10,0;7,0;;;;;1,0;;43,0;1,0;;;1,0;2,0;18,0;22,0;6,0;1,0;9,0;;28,0;1,0;;23,0;117,0;1,0;;;4,0;1,0;1,0;23,0;;;;;4,0;;13,0;6,0;1,0;8,0;;5,0;1,0;;1,0;20,0;1,0;12,0;7,0;;;;;2,0;24,0;12,0;1,0;9,0;45,0;8,0;10,0;8,0;;6,0;15,0;;25,0;2,0;;;4,0;;19,0;15,0;3,0;3,0;7,0;24,0;;;;3,0;;;;;11,0;;1,0;;2,0;5,0;;;;19,0;11,0;2,0;6,0;;;2,0;4,0;2,0;;3,0;2,0;;26,0;;2,0;2,0;9,0;;4,0;;;;;1,0;11,0;;37,0;3,0;;;;;;;;;3,0;;;2,0;;;13,0;2,0;;;;;;6,0;2,0;;3,0;1,0;;1,0;5,0;;;10,0;;;9,0;;3,0;2,0;;;;;6,0;;;2,0;4,0;;3,0;;;;3,0;;3,0;1,0;;;;;;;;;3,0;;14,0;;;;;;;;;;;;;;;;4,0;;4,0;;;;;;;;6,0;;13,0;11,0;3,0;1,0;4,0;;3,0;;;;;;;;;;;;2,0;;;13,0;;;1,0;;;;1,0;;21,0;;1,0;1,0;3,0;;;;;3,0;6,0;1,0;;;;;;3,0;;;1,0;;1,0;1,0;;;;;4,0;;;3,0;;3,0;4,0;2,0;1,0;2,0;9,0;6,0;;;;;;;;7,0;2,0;2,0;17,0;1,0;;;;;7,0;;28,0;1,0;105,0;;;;;;;;2,0;;;;;;;1,0;;;;3,0;;;;;;;;;;;;30,0;;;;4,0;;;;1,0;20,0;4,0;4,0;;;;;;;;;;1,0;;;;;;2,0;;4,0;;;;1,0;;;;;;;;1,0;2,0;;;;;;;;;;;;;;;;2,0;7,0;;;;;2,0;1,0;;;;;;;;2,0;;;;;;;;1,0;;;;;;;;;;9,0;;;5,0;;4,0;;;;;;;;3,0;;;;;;;;;;3,0;;6,0;2,0;;;2,0;9,0;;1,0;;;;;;2,0;1,0;1,0;9,0;1,0;23,0;;;1,0;2,0;;;;;;3,0;91,0;;;3,0;;;2,0;1,0;33,0;;;;3,0;;;;;;20,0;;3,0;;2,0;;63,0;;3,0;;2,0;;1,0;3,0;6,0;1,0;;;11,0;;16,0;3,0;2,0;4,0;1,0;;;;;;;;;;;13,0;;;;;12,0;2,0;;;;;3,0;8,0;;;26,0;;;;;;;;;;;;;;;1,0;;1,0;;;;;;;;;;;;;;;;2,0;;;;;;8,0;;;;;;;;;2,0;;;;;;4,0;;;;;;4,0;;2,0;;1,0;3,0;;1,0;;;1,0;;1,0;;1,0;;4,0;;;;;;;;;1,0;;;;1,0;;;1,0;2,0;;;2,0;;;2,0;;;;;;;;;;;;;;;;;;;;2,0;;19,0;;;;;;;;;;;10,0;;6,0;;;;;;;;1,0;;1,0;1,0;5,0;;2,0;;;;;4,0;;;;;16,0;;;22,0;;;;;10,0;;25,0;;;;;;;;;;1,0;;;;;;;;;;;;;;;;;;;;;;;;;2,0;;;;;;;;;
digital;29,0;3,0;;58,0;18,0;77,0;78,0;182,0;4,0;3,0;2,0;4,0;20,0;234,0;4,0;3,0;516,0;4,0;10,0;8,0;4,0;;105,0;42,0;81,0;10,0;1,0;55,0;77,0;27,0;354,0;77,0;36,0;22,0;4,0;611,0;43,0;21,0;16,0;38,0;134,0;570,0;9,0;;438,0;41,0;10,0;94,0;;6,0;14,0;;12,0;13,0;56,0;17,0;58,0;2,0;18,0;182,0;1,0;2,0;78,0;1,0;2642,0;12,0;361,0;2,0;8,0;23,0;23,0;313,0;87,0;;67,0;2,0;6,0;14,0;15,0;138,0;398,0;1,0;89,0;44,0;84,0;12,0;1,0;331,0;8,0;22,0;33,0;10,0;25,0;3,0;31,0;;227,0;77,0;262,0;93,0;208,0;42,0;;79,0;197,0;261,0;;37,0;;3,0;2,0;46,0;76,0;2,0;7,0;;74,0;43,0;99,0;327,0;47,0;;843,0;23,0;5,0;256,0;473,0;6,0;42,0;1,0;100,0;6,0;;191,0;3,0;2,0;105,0;12,0;202,0;;;1,0;50,0;;26,0;55,0;48,0;31,0;62,0;16,0;;5,0;34,0;1,0;28,0;9,0;;;;;1,0;102,0;46,0;121,0;91,0;1,0;50,0;5,0;1,0;23,0;25,0;3,0;21,0;47,0;;9,0;11,0;1,0;17,0;4,0;;5,0;1,0;44,0;;1,0;56,0;5,0;162,0;18,0;;;8,0;9,0;7,0;2,0;172,0;5,0;;4,0;;2,0;2,0;4,0;13,0;38,0;7,0;;15,0;42,0;9,0;26,0;4,0;2,0;;19,0;277,0;6,0;;9,0;10,0;19,0;5,0;3,0;9,0;7,0;134,0;;1,0;50,0;1,0;11,0;31,0;28,0;16,0;4,0;10,0;4,0;1,0;8,0;1,0;2,0;5,0;;5,0;94,0;12,0;11,0;19,0;1,0;2,0;4,0;3,0;7,0;19,0;13,0;20,0;63,0;8,0;;17,0;56,0;14,0;30,0;8,0;8,0;7,0;;1,0;3,0;;2,0;27,0;16,0;10,0;4,0;20,0;40,0;6,0;7,0;7,0;8,0;41,0;8,0;;;2,0;3,0;97,0;;;16,0;;;14,0;1,0;37,0;3,0;;3,0;1,0;;5,0;4,0;1,0;7,0;18,0;9,0;8,0;216,0;;;19,0;7,0;18,0;;34,0;2,0;7,0;9,0;31,0;96,0;9,0;10,0;1,0;1,0;3,0;5,0;49,0;12,0;;1,0;;3,0;77,0;2,0;1,0;;8,0;10,0;7,0;22,0;;;;14,0;20,0;16,0;;4,0;1,0;;6,0;3,0;9,0;1,0;5,0;1,0;713,0;55,0;;4,0;6,0;23,0;6,0;27,0;24,0;1,0;;7,0;;;36,0;19,0;11,0;20,0;5,0;12,0;41,0;8,0;195,0;12,0;9,0;6,0;11,0;98,0;41,0;8,0;3,0;2,0;6,0;14,0;15,0;48,0;8,0;36,0;2,0;50,0;24,0;6,0;3,0;55,0;61,0;115,0;3,0;27,0;5,0;6,0;99,0;2,0;;11,0;1,0;44,0;64,0;67,0;6,0;;;;5,0;75,0;2,0;20,0;8,0;186,0;14,0;51,0;5,0;6,0;43,0;;46,0;3,0;8,0;;63,0;56,0;22,0;3,0;1,0;30,0;67,0;28,0;9,0;16,0;6,0;1,0;120,0;;24,0;43,0;21,0;26,0;;9,0;3,0;31,0;;11,0;49,0;8,0;4,0;27,0;2,0;8,0;;;7,0;13,0;7,0;3,0;43,0;50,0;3,0;1,0;;25,0;8,0;3,0;;8,0;28,0;42,0;17,0;56,0;91,0;8,0;33,0;9,0;1,0;1,0;13,0;14,0;17,0;;63,0;4,0;7,0;9,0;19,0;54,0;3,0;26,0;3,0;11,0;1,0;8,0;2,0;1,0;22,0;6,0;14,0;10,0;3,0;4,0;1,0;6,0;2,0;;14,0;7,0;17,0;1,0;10,0;7,0;3,0;4,0;1,0;6,0;;56,0;5,0;3,0;14,0;8,0;7,0;;5,0;32,0;30,0;;1,0;4,0;6,0;87,0;4,0;12,0;21,0;53,0;7,0;5,0;3,0;1,0;5,0;9,0;5,0;28,0;;;12,0;11,0;7,0;1,0;15,0;27,0;27,0;;7,0;31,0;1,0;2,0;1,0;6,0;4,0;7,0;1,0;3,0;;26,0;8,0;1,0;;1,0;12,0;2,0;2,0;4,0;27,0;14,0;4,0;3,0;;;;4,0;1,0;3,0;23,0;7,0;2,0;3,0;1,0;42,0;13,0;264,0;;11,0;34,0;2,0;3,0;1,0;5,0;4,0;50,0;9,0;9,0;2,0;2,0;1,0;10,0;8,0;10,0;2,0;6,0;2,0;;;;28,0;;1,0;50,0;33,0;;;;;2,0;16,0;28,0;26,0;35,0;5,0;1,0;50,0;1,0;;5,0;6,0;10,0;2,0;5,0;;1,0;4,0;58,0;1,0;55,0;7,0;9,0;28,0;7,0;4,0;30,0;1,0;29,0;;;7,0;41,0;;;14,0;4,0;14,0;1,0;4,0;23,0;2,0;;3,0;4,0;23,0;8,0;19,0;2,0;;;1,0;1,0;1,0;6,0;4,0;41,0;10,0;1,0;3,0;;1,0;;2,0;3,0;13,0;3,0;;;;6,0;19,0;2,0;1,0;;32,0;1,0;6,0;;;26,0;7,0;6,0;;;1,0;3,0;3,0;;;3,0;22,0;;;;9,0;97,0;3,0;;2,0;12,0;;1,0;;;;;8,0;339,0;11,0;1,0;5,0;;;4,0;3,0;;;;;;;2,0;5,0;1,0;;;;;;;2,0;1,0;1,0;37,0;;;;2,0;;1,0;5,0;;3,0;;4,0;33,0;;1,0;9,0;1,0;;8,0;9,0;26,0;11,0;29,0;;50,0;23,0;10,0;;4,0;;6,0;15,0;;12,0;;2,0;6,0;;3,0;2,0;;3,0;3,0;2,0;5,0;4,0;50,0;4,0;12,0;7,0;;;6,0;10,0;6,0;;;;;4,0;13,0;;6,0;14,0;3,0;;;1,0;6,0;;;;;5,0;13,0;;3,0;;;18,0;2,0;9,0;26,0;10,0;105,0;;;31,0;1,0;7,0;;2,0;;9,0;;51,0;2,0;1,0;3,0;3,0;;7,0;5,0;3,0;1,0;16,0;1,0;9,0;;25,0;11,0;11,0;63,0;1,0;5,0;109,0;9,0;4,0;9,0;12,0;11,0;4,0;3,0;1,0;1,0;;;34,0;76,0;4,0;7,0;;;4,0;2,0;10,0;4,0;;1,0;;;;;;1,0;2,0;;7,0;1,0;22,0;10,0;1,0;1,0;6,0;;52,0;16,0;;;;;4,0;;;;;4,0;2,0;;127,0;2,0;;;;;;;1,0;;;;;5,0;;;5,0;2,0;9,0;;;;3,0;;;2,0;;22,0;;2,0;;5,0;4,0;1,0;2,0;3,0;;3,0;;11,0;12,0;;;;1,0;3,0;;4,0;;;;1,0;;1,0;4,0;;;;
display;1,0;2,0;2,0;106,0;52,0;818,0;48,0;70,0;8,0;10,0;;3,0;1,0;520,0;3,0;40,0;981,0;1,0;3,0;37,0;;10,0;190,0;31,0;125,0;3,0;4,0;83,0;158,0;76,0;1124,0;264,0;78,0;24,0;87,0;830,0;82,0;29,0;40,0;15,0;494,0;4173,0;2,0;438,0;;164,0;16,0;624,0;1,0;11,0;37,0;4,0;29,0;44,0;228,0;46,0;83,0;;4,0;332,0;7,0;1,0;45,0;6,0;6600,0;10,0;850,0;31,0;25,0;;56,0;178,0;237,0;102,0;92,0;7,0;6,0;43,0;57,0;177,0;1274,0;;481,0;27,0;243,0;23,0;9,0;170,0;8,0;22,0;40,0;15,0;21,0;27,0;94,0;31,0;189,0;80,0;473,0;120,0;727,0;171,0;3,0;120,0;271,0;568,0;35,0;165,0;20,0;6,0;2,0;77,0;537,0;18,0;1,0;13,0;160,0;61,0;260,0;336,0;65,0;7,0;604,0;162,0;1,0;158,0;1013,0;;44,0;2,0;418,0;8,0;13,0;1153,0;2,0;14,0;705,0;179,0;202,0;;;58,0;3,0;;16,0;53,0;579,0;75,0;247,0;14,0;;25,0;115,0;12,0;28,0;1,0;25,0;;1,0;;;124,0;382,0;62,0;1,0;1,0;195,0;77,0;12,0;77,0;21,0;2,0;37,0;238,0;;68,0;34,0;47,0;41,0;21,0;2,0;41,0;10,0;146,0;1,0;9,0;56,0;8,0;295,0;125,0;5,0;8,0;19,0;10,0;2,0;19,0;186,0;12,0;;10,0;1,0;303,0;50,0;8,0;51,0;112,0;97,0;9,0;59,0;249,0;63,0;144,0;19,0;5,0;7,0;70,0;447,0;13,0;36,0;38,0;258,0;73,0;18,0;;23,0;;649,0;;2,0;34,0;13,0;6,0;99,0;24,0;98,0;37,0;8,0;20,0;1,0;149,0;;10,0;15,0;4,0;;293,0;30,0;49,0;227,0;10,0;;;;49,0;101,0;24,0;36,0;229,0;31,0;;29,0;137,0;85,0;513,0;11,0;9,0;4,0;1,0;6,0;110,0;6,0;;;55,0;5,0;2,0;17,0;123,0;12,0;14,0;2,0;5,0;18,0;10,0;12,0;;4,0;30,0;26,0;6,0;1,0;58,0;1,0;6,0;44,0;12,0;154,0;85,0;4,0;8,0;;;17,0;;;3,0;31,0;187,0;19,0;172,0;3,0;3,0;27,0;1,0;93,0;2,0;103,0;23,0;58,0;46,0;353,0;622,0;27,0;86,0;281,0;30,0;3,0;;70,0;7,0;6,0;4,0;;2,0;95,0;7,0;13,0;;21,0;;61,0;92,0;13,0;;11,0;20,0;38,0;32,0;5,0;1,0;8,0;2,0;29,0;44,0;47,0;4,0;45,0;18,0;1379,0;55,0;27,0;2,0;6,0;65,0;19,0;94,0;31,0;5,0;1,0;14,0;4,0;;49,0;92,0;133,0;55,0;9,0;63,0;8,0;9,0;1376,0;59,0;;21,0;29,0;311,0;56,0;12,0;16,0;128,0;11,0;72,0;27,0;58,0;6,0;157,0;1,0;96,0;240,0;29,0;15,0;295,0;71,0;93,0;;281,0;57,0;212,0;119,0;16,0;;144,0;9,0;129,0;214,0;147,0;8,0;1,0;7,0;2,0;2,0;139,0;3,0;6,0;43,0;405,0;235,0;308,0;56,0;;94,0;1,0;164,0;14,0;50,0;7,0;113,0;175,0;181,0;4,0;27,0;142,0;49,0;23,0;6,0;87,0;3,0;17,0;1233,0;6,0;32,0;1,0;59,0;9,0;25,0;20,0;14,0;55,0;16,0;12,0;238,0;4,0;16,0;34,0;3,0;36,0;8,0;25,0;9,0;6,0;99,0;225,0;237,0;652,0;11,0;2,0;3,0;6,0;9,0;23,0;2,0;33,0;7,0;37,0;115,0;62,0;157,0;13,0;87,0;40,0;8,0;8,0;2,0;26,0;19,0;11,0;1932,0;7,0;37,0;2,0;53,0;253,0;13,0;535,0;21,0;50,0;76,0;58,0;7,0;12,0;32,0;2,0;69,0;6,0;;58,0;;44,0;7,0;1,0;19,0;3,0;6,0;18,0;4,0;;;8,0;;23,0;13,0;142,0;3,0;105,0;41,0;26,0;10,0;68,0;48,0;30,0;4,0;7,0;1,0;27,0;97,0;137,0;9,0;2,0;5,0;440,0;10,0;3,0;33,0;118,0;51,0;105,0;4,0;27,0;;;4,0;39,0;16,0;7,0;61,0;18,0;319,0;12,0;11,0;9,0;3,0;7,0;5,0;2,0;46,0;13,0;11,0;20,0;;8,0;4,0;;6,0;20,0;10,0;13,0;1,0;56,0;65,0;60,0;36,0;17,0;33,0;1,0;9,0;87,0;12,0;5,0;53,0;17,0;13,0;26,0;8,0;67,0;173,0;19,0;12,0;8,0;4,0;1,0;22,0;2,0;4,0;12,0;64,0;5,0;14,0;23,0;70,0;12,0;10,0;9,0;48,0;36,0;12,0;;3,0;;38,0;243,0;;4,0;42,0;42,0;;2,0;38,0;23,0;7,0;2,0;24,0;26,0;3,0;4,0;8,0;84,0;12,0;;1,0;41,0;;53,0;17,0;1,0;7,0;20,0;111,0;17,0;17,0;35,0;;80,0;26,0;11,0;88,0;1,0;42,0;;1,0;26,0;101,0;46,0;2,0;36,0;11,0;105,0;5,0;1,0;202,0;;37,0;;5,0;18,0;5,0;47,0;22,0;;7,0;1,0;3,0;29,0;10,0;9,0;13,0;30,0;31,0;3,0;4,0;1,0;22,0;6,0;27,0;9,0;43,0;3,0;10,0;8,0;30,0;23,0;82,0;;18,0;15,0;1,0;39,0;;9,0;16,0;17,0;77,0;11,0;;42,0;16,0;14,0;12,0;2,0;45,0;19,0;47,0;5,0;;25,0;168,0;5,0;4,0;16,0;18,0;;62,0;9,0;6,0;2,0;14,0;17,0;304,0;101,0;15,0;4,0;;;13,0;;;1,0;13,0;4,0;3,0;16,0;1,0;;;6,0;14,0;5,0;4,0;;22,0;;42,0;;42,0;5,0;;;1,0;;;7,0;2,0;44,0;;14,0;118,0;;4,0;42,0;2,0;7,0;1,0;2,0;23,0;;;;12,0;23,0;10,0;;1,0;;3,0;61,0;;1,0;;;141,0;47,0;;4,0;1,0;;;11,0;4,0;4,0;17,0;;;12,0;16,0;11,0;2,0;46,0;2,0;25,0;;;94,0;5,0;2,0;;32,0;1,0;31,0;3,0;;;6,0;2,0;5,0;;6,0;14,0;6,0;9,0;6,0;12,0;13,0;15,0;1,0;25,0;21,0;;50,0;42,0;6,0;17,0;9,0;19,0;5,0;1,0;6,0;2,0;12,0;2,0;;12,0;2,0;20,0;12,0;14,0;15,0;4,0;35,0;14,0;4,0;7,0;8,0;38,0;63,0;17,0;;7,0;;18,0;40,0;2,0;15,0;16,0;10,0;;32,0;130,0;5,0;4,0;16,0;8,0;6,0;30,0;36,0;23,0;70,0;16,0;;15,0;31,0;7,0;2,0;48,0;;8,0;1,0;73,0;;14,0;2,0;4,0;;3,0;1,0;;25,0;17,0;3,0;2,0;5,0;;1,0;2,0;6,0;8,0;2,0;;;;1,0;22,0;;3,0;21,0;3,0;3,0;;6,0;;;20,0;;;10,0;6,0;13,0;24,0;;2,0;;17,0;8,0;;5,0;;6,0;7,0;2,0;21,0;14,0;14,0;40,0;33,0;10,0;19,0;2,0;13,0;;22,0;6,0;;19,0;;6,0;24,0;78,0;;2,0;;10,0;2,0;5,0;;12,0;2,0;55,0;;;;;
dispose;1,0;17,0;2,0;6,0;;133,0;247,0;268,0;1,0;2,0;4,0;15,0;238,0;530,0;18,0;;166,0;9,0;44,0;;32,0;2,0;75,0;4,0;34,0;;7,0;110,0;2,0;2,0;284,0;14,0;6,0;44,0;17,0;32,0;29,0;28,0;10,0;;10,0;515,0;14,0;41,0;164,0;;;415,0;;;1,0;3,0;48,0;80,0;103,0;82,0;81,0;;;24,0;47,0;9,0;170,0;1,0;774,0;1,0;429,0;4,0;4,0;126,0;18,0;1596,0;342,0;19,0;;;61,0;2,0;2,0;32,0;106,0;15,0;6,0;;561,0;100,0;;566,0;28,0;9,0;;106,0;17,0;34,0;5,0;;248,0;187,0;569,0;29,0;387,0;33,0;22,0;5,0;25,0;93,0;1,0;1,0;;1,0;;30,0;190,0;2,0;;1,0;1,0;54,0;7,0;810,0;5,0;5,0;74,0;10,0;8,0;10,0;203,0;;11,0;9,0;17,0;3,0;3,0;582,0;3,0;10,0;112,0;14,0;12,0;5,0;2,0;146,0;30,0;;137,0;10,0;95,0;16,0;26,0;41,0;12,0;41,0;215,0;86,0;9,0;2,0;31,0;5,0;;15,0;97,0;128,0;;7,0;1,0;1,0;201,0;311,0;4,0;47,0;25,0;;14,0;228,0;4,0;57,0;5,0;41,0;3,0;3,0;10,0;100,0;13,0;329,0;6,0;75,0;289,0;13,0;226,0;211,0;2,0;2,0;28,0;40,0;312,0;165,0;1364,0;36,0;135,0;11,0;25,0;398,0;5,0;4,0;6,0;12,0;736,0;58,0;84,0;213,0;35,0;19,0;3,0;8,0;19,0;191,0;20,0;83,0;4,0;81,0;79,0;6,0;;48,0;178,0;1,0;961,0;5,0;3,0;7,0;30,0;25,0;19,0;;99,0;1,0;15,0;20,0;11,0;3,0;4,0;105,0;27,0;13,0;47,0;8,0;17,0;57,0;807,0;36,0;56,0;30,0;11,0;75,0;479,0;19,0;268,0;1004,0;23,0;1,0;12,0;16,0;8,0;371,0;99,0;14,0;1,0;2,0;6,0;61,0;60,0;90,0;107,0;8,0;1,0;6,0;2,0;44,0;70,0;13,0;12,0;8,0;249,0;501,0;;3,0;72,0;52,0;497,0;12,0;707,0;6,0;4,0;68,0;5,0;56,0;66,0;45,0;112,0;30,0;1,0;42,0;71,0;10,0;6,0;123,0;19,0;37,0;13,0;232,0;17,0;3,0;145,0;9,0;12,0;14,0;6,0;17,0;13,0;28,0;48,0;96,0;188,0;15,0;35,0;41,0;5,0;3,0;76,0;113,0;81,0;20,0;20,0;76,0;12,0;9,0;21,0;3,0;8,0;15,0;33,0;14,0;18,0;21,0;29,0;16,0;6,0;203,0;;48,0;2,0;9,0;1,0;11,0;16,0;34,0;10,0;293,0;48,0;16,0;2,0;3,0;1,0;1,0;;16,0;;2,0;3,0;7,0;35,0;;1,0;52,0;7,0;1,0;6,0;;1,0;;63,0;1,0;;4,0;3,0;24,0;2,0;;;;;;;37,0;40,0;2,0;3,0;4,0;;1,0;;29,0;7,0;12,0;7,0;49,0;;9,0;11,0;36,0;20,0;51,0;;6,0;2,0;20,0;8,0;3,0;2,0;;;2,0;6,0;5,0;3,0;76,0;12,0;1,0;2,0;5,0;99,0;;1,0;1,0;2,0;4,0;30,0;21,0;43,0;;7,0;101,0;;9,0;;;;2,0;26,0;;;;4,0;9,0;74,0;30,0;;17,0;4,0;1,0;13,0;1,0;1,0;4,0;;;;;;;;8,0;;31,0;55,0;9,0;23,0;3,0;3,0;3,0;748,0;2,0;8,0;11,0;4,0;1,0;12,0;9,0;14,0;;;;4,0;16,0;5,0;19,0;26,0;;;18,0;;5,0;47,0;28,0;1,0;37,0;29,0;3,0;;2,0;2,0;;15,0;7,0;;27,0;3,0;50,0;15,0;8,0;37,0;123,0;;100,0;;;19,0;18,0;17,0;1,0;12,0;;19,0;75,0;14,0;8,0;9,0;3,0;6,0;;;;12,0;152,0;;3,0;;4,0;23,0;;23,0;30,0;1,0;;;4,0;;;5,0;;1,0;1,0;3,0;17,0;;;2,0;3,0;8,0;;;6,0;;97,0;31,0;11,0;2,0;6,0;38,0;13,0;3,0;5,0;31,0;20,0;2,0;104,0;12,0;;4,0;;;2,0;;4,0;4,0;1,0;;3,0;9,0;3,0;;;;7,0;9,0;;1,0;13,0;;18,0;;2,0;6,0;33,0;3,0;5,0;1,0;;;130,0;;;;6,0;;;7,0;;3,0;;16,0;;;1,0;7,0;;4,0;;34,0;1,0;;4,0;14,0;8,0;3,0;1,0;;35,0;;42,0;3,0;;3,0;;11,0;5,0;2,0;;3,0;;3,0;;;1,0;31,0;6,0;2,0;;34,0;2,0;103,0;3,0;10,0;;;;;11,0;54,0;;;13,0;7,0;7,0;5,0;1,0;;15,0;55,0;1,0;;15,0;;;1,0;141,0;4,0;38,0;14,0;12,0;15,0;1,0;5,0;39,0;266,0;35,0;10,0;68,0;1,0;;4,0;7,0;16,0;;1,0;21,0;;7,0;2,0;;;10,0;7,0;1,0;;16,0;38,0;30,0;3,0;;11,0;;4,0;;49,0;;5,0;40,0;28,0;27,0;2,0;1,0;29,0;25,0;;2,0;4,0;6,0;1,0;8,0;44,0;416,0;37,0;20,0;4,0;5,0;2,0;16,0;6,0;2,0;37,0;3,0;7,0;11,0;6,0;4,0;3,0;9,0;5,0;3,0;;2,0;14,0;6,0;;4,0;2,0;6,0;90,0;17,0;8,0;;5,0;1,0;119,0;;24,0;6,0;;;1,0;;3,0;2,0;16,0;8,0;38,0;1,0;;4,0;4,0;13,0;75,0;3,0;10,0;;;3,0;12,0;6,0;10,0;;14,0;10,0;5,0;;92,0;9,0;1,0;;3,0;;;;21,0;4,0;;8,0;;85,0;;80,0;;11,0;;;;4,0;1,0;;6,0;1,0;3,0;;;3,0;3,0;;1,0;1,0;;1,0;;;;;8,0;;;5,0;;9,0;;3,0;;;4,0;1,0;19,0;;;;1,0;8,0;1,0;;;;;6,0;15,0;;1,0;;4,0;;;;;2,0;;2,0;;;2,0;;;;2,0;;15,0;;;4,0;;10,0;15,0;;5,0;4,0;3,0;;5,0;6,0;13,0;;2,0;;1,0;8,0;1,0;5,0;34,0;;1,0;;7,0;;;;;4,0;2,0;32,0;1,0;15,0;36,0;19,0;;;14,0;3,0;;8,0;;6,0;7,0;7,0;7,0;4,0;25,0;96,0;1,0;2,0;;;6,0;3,0;;;21,0;;;14,0;3,0;5,0;;6,0;1,0;7,0;10,0;;27,0;4,0;;;;4,0;3,0;1,0;15,0;;;2,0;;;6,0;;3,0;6,0;1,0;;;1,0;;;;;;
distortion;6,0;;;26,0;33,0;18,0;8,0;13,0;;;;;7,0;41,0;;;29,0;18,0;;2,0;;4,0;;;;37,0;6,0;2,0;1,0;2,0;86,0;3,0;189,0;77,0;;14,0;3,0;3,0;9,0;;47,0;27,0;;10,0;16,0;;;13,0;;46,0;5,0;;;4,0;59,0;5,0;;;1,0;23,0;;;72,0;2,0;359,0;;33,0;44,0;1,0;;7,0;156,0;1,0;;2,0;5,0;;8,0;;3,0;60,0;;;32,0;18,0;;;76,0;;2,0;65,0;10,0;2,0;;2,0;;13,0;;34,0;8,0;8,0;;25,0;14,0;10,0;11,0;;3,0;1,0;;;;34,0;;;4,0;3,0;8,0;7,0;30,0;6,0;;2,0;;1,0;2,0;56,0;;;;5,0;;1,0;19,0;;;62,0;3,0;2,0;;;;;;14,0;23,0;5,0;4,0;17,0;2,0;;1,0;;;;;;;;;;;;;;;;;;1,0;;1,0;8,0;;;3,0;;;;;14,0;;;3,0;;;2,0;;12,0;1,0;;;;;;;;;1,0;;;;5,0;;7,0;2,0;;;;2,0;;2,0;1,0;;;1,0;32,0;;;;15,0;;;;;;22,0;;4,0;5,0;;9,0;;;;1,0;;1,0;;12,0;1,0;;;;;;1,0;1,0;;;;;;;;;1,0;8,0;;;;2,0;3,0;18,0;;;;;;2,0;;;;5,0;;;;13,0;;;;;5,0;1,0;2,0;;;;;2,0;1,0;;;;2,0;;2,0;;;;2,0;;;1,0;;;;;5,0;13,0;;;1,0;;1,0;;1,0;;;;;7,0;;2,0;;;4,0;;;1,0;;;;;2,0;;;;;;;2,0;;;;;11,0;2,0;;;;;;;2,0;;;;69,0;;;;;;;;2,0;11,0;;;;;8,0;34,0;;;;;1,0;;3,0;14,0;;9,0;;6,0;1,0;6,0;;;;;4,0;1,0;7,0;26,0;;2,0;;2,0;;29,0;;7,0;3,0;6,0;3,0;;10,0;;;1,0;;;9,0;;;;;2,0;;;;;;2,0;;;;;1,0;;;;;;;3,0;;;1,0;;2,0;4,0;;1,0;;;;;;;;;;;;16,0;;;;;;14,0;;5,0;;;8,0;;;;6,0;;;;;;;;;;;9,0;;1,0;16,0;;1,0;;;1,0;2,0;4,0;;;1,0;;3,0;;1,0;;;;;;4,0;;;;;2,0;;;1,0;3,0;;;;;;;2,0;16,0;6,0;;;;;;;;;3,0;;;;;5,0;;;;1,0;2,0;;3,0;;;;;;;2,0;;;;;;;;;;;2,0;1,0;;;;;;;;;;2,0;9,0;;;;;;;;;1,0;;;;;1,0;;;;;;;;;;;3,0;1,0;;26,0;;1,0;;;2,0;;2,0;;41,0;;;;2,0;;;1,0;;;;3,0;;;;;;1,0;;;;;;;;;;;27,0;;;;;1,0;;;;;;3,0;;;;14,0;2,0;2,0;;26,0;;;1,0;;22,0;;;;;;;;1,0;;;;1,0;3,0;1,0;;;;;;;;8,0;;;;;;1,0;;;;;4,0;;;;;;;1,0;;;;1,0;6,0;;;;;;10,0;;;1,0;2,0;;;;;8,0;;;;24,0;2,0;;;;;30,0;1,0;1,0;;;;;2,0;2,0;;;2,0;;;;;;;;;;;;;;;;;;;;;;;;;;;14,0;;;;;;;;;;;;;;;;;;;;2,0;;;;1,0;;;;;;;;;;;;2,0;4,0;;;;;;;;3,0;;;;10,0;;;;;;;;;;;4,0;;2,0;21,0;;;;;;1,0;;;;;;;;;;;;1,0;;;2,0;;;1,0;;1,0;;;;;;;2,0;;;;;;1,0;;;;7,0;1,0;;;;2,0;6,0;;1,0;;2,0;6,0;2,0;1,0;;3,0;;;;;;;;;;;;;;;;;;;;;;2,0;1,0;;;22,0;;;;;;;3,0;;;3,0;;;;4,0;;;;;;1,0;;;1,0;;;;;;;;;;1,0;;;;;2,0;;;;;;;;;;;;;;;;;;;;1,0;;;;44,0;2,0;1,0;18,0;;;;;;;;;;;;;;;
element;5,0;12,0;7,0;69,0;30,0;244,0;431,0;566,0;8,0;;14,0;27,0;38,0;415,0;44,0;20,0;277,0;8,0;52,0;9,0;36,0;;70,0;17,0;66,0;23,0;;90,0;20,0;32,0;756,0;52,0;12,0;12,0;5,0;143,0;77,0;133,0;49,0;24,0;120,0;692,0;67,0;94,0;624,0;415,0;13,0;;5,0;28,0;13,0;7,0;142,0;25,0;72,0;142,0;344,0;178,0;5,0;153,0;40,0;56,0;205,0;;1253,0;15,0;1179,0;14,0;19,0;30,0;101,0;3407,0;1059,0;9,0;3,0;;131,0;19,0;4,0;84,0;354,0;3,0;79,0;6,0;327,0;100,0;10,0;1787,0;65,0;66,0;22,0;73,0;106,0;28,0;13,0;8,0;225,0;92,0;1031,0;54,0;805,0;113,0;44,0;25,0;80,0;82,0;3,0;17,0;24,0;3,0;2,0;16,0;149,0;15,0;5,0;1,0;24,0;157,0;55,0;712,0;9,0;2,0;160,0;17,0;9,0;36,0;584,0;23,0;16,0;48,0;74,0;26,0;6,0;489,0;13,0;12,0;145,0;19,0;51,0;13,0;7,0;73,0;4,0;;192,0;45,0;136,0;295,0;142,0;214,0;68,0;70,0;152,0;30,0;;65,0;5,0;12,0;3,0;5,0;156,0;311,0;16,0;63,0;;;272,0;329,0;;52,0;36,0;3,0;80,0;226,0;;32,0;76,0;144,0;34,0;5,0;1,0;6,0;28,0;127,0;72,0;21,0;382,0;32,0;74,0;129,0;1,0;19,0;187,0;296,0;70,0;63,0;529,0;72,0;109,0;17,0;20,0;112,0;31,0;12,0;37,0;14,0;141,0;34,0;97,0;322,0;177,0;309,0;19,0;4,0;5,0;199,0;115,0;34,0;27,0;153,0;81,0;12,0;1,0;587,0;71,0;7,0;669,0;58,0;32,0;23,0;67,0;32,0;53,0;14,0;113,0;8,0;99,0;26,0;4,0;62,0;10,0;71,0;49,0;9,0;110,0;97,0;53,0;99,0;410,0;76,0;18,0;31,0;38,0;418,0;244,0;33,0;442,0;788,0;26,0;3,0;94,0;48,0;32,0;99,0;39,0;21,0;6,0;13,0;12,0;44,0;6,0;36,0;63,0;95,0;9,0;;54,0;42,0;7,0;68,0;39,0;13,0;329,0;159,0;;36,0;100,0;27,0;494,0;22,0;39,0;20,0;3,0;32,0;15,0;10,0;112,0;5,0;48,0;76,0;122,0;42,0;34,0;18,0;;36,0;5,0;54,0;5,0;692,0;18,0;4,0;18,0;12,0;8,0;24,0;159,0;29,0;61,0;36,0;34,0;144,0;39,0;29,0;8,0;22,0;164,0;;357,0;21,0;16,0;18,0;2,0;45,0;46,0;12,0;13,0;1,0;3,0;29,0;88,0;43,0;1,0;22,0;9,0;86,0;15,0;72,0;2,0;87,0;2,0;3,0;17,0;1,0;29,0;8,0;25,0;31,0;30,0;9,0;2,0;;2,0;60,0;4,0;62,0;4,0;5,0;5,0;1,0;45,0;3,0;21,0;45,0;36,0;7,0;20,0;1,0;8,0;2,0;217,0;13,0;;13,0;21,0;117,0;5,0;16,0;3,0;6,0;1,0;18,0;5,0;97,0;12,0;46,0;3,0;35,0;38,0;8,0;5,0;52,0;31,0;33,0;8,0;48,0;2,0;13,0;119,0;47,0;16,0;48,0;1,0;113,0;35,0;24,0;7,0;15,0;;5,0;8,0;;28,0;22,0;10,0;758,0;10,0;51,0;9,0;2,0;223,0;1,0;41,0;1,0;2,0;4,0;23,0;46,0;73,0;1,0;40,0;51,0;6,0;13,0;2,0;7,0;1,0;31,0;88,0;;4,0;46,0;22,0;38,0;40,0;6,0;1,0;18,0;19,0;6,0;61,0;28,0;1,0;6,0;;37,0;;7,0;11,0;11,0;6,0;35,0;8,0;117,0;14,0;36,0;8,0;15,0;2,0;11,0;60,0;8,0;;170,0;30,0;;61,0;14,0;9,0;3,0;9,0;1,0;15,0;28,0;8,0;142,0;15,0;8,0;5,0;7,0;1,0;4,0;8,0;1,0;12,0;26,0;39,0;;1,0;13,0;1,0;17,0;3,0;1,0;11,0;54,0;14,0;134,0;2,0;66,0;89,0;208,0;6,0;;1,0;;15,0;;36,0;;9,0;13,0;28,0;36,0;17,0;2,0;;;17,0;19,0;;4,0;91,0;164,0;2,0;17,0;1,0;29,0;6,0;4,0;7,0;4,0;1,0;12,0;3,0;5,0;;4,0;4,0;4,0;19,0;29,0;12,0;83,0;3,0;;16,0;1,0;3,0;2,0;;34,0;8,0;35,0;43,0;78,0;1,0;4,0;22,0;77,0;18,0;1,0;48,0;12,0;11,0;37,0;35,0;;1,0;16,0;5,0;1,0;3,0;4,0;6,0;;;29,0;10,0;1,0;2,0;2,0;;48,0;1,0;;10,0;31,0;1,0;13,0;2,0;6,0;9,0;57,0;1,0;6,0;;4,0;2,0;111,0;2,0;2,0;41,0;11,0;;2,0;4,0;;2,0;2,0;9,0;8,0;;9,0;21,0;;12,0;23,0;21,0;8,0;;19,0;17,0;17,0;17,0;24,0;;65,0;;24,0;3,0;2,0;10,0;15,0;6,0;15,0;6,0;3,0;11,0;3,0;2,0;6,0;;85,0;73,0;13,0;;;6,0;1,0;116,0;;25,0;2,0;1,0;28,0;;4,0;52,0;;30,0;3,0;2,0;9,0;;28,0;2,0;43,0;27,0;31,0;5,0;25,0;;2,0;7,0;108,0;8,0;16,0;6,0;26,0;4,0;9,0;5,0;86,0;61,0;15,0;14,0;21,0;;7,0;;5,0;41,0;;30,0;88,0;14,0;15,0;26,0;19,0;;30,0;24,0;1,0;4,0;15,0;53,0;19,0;14,0;6,0;12,0;7,0;11,0;23,0;166,0;;11,0;8,0;3,0;6,0;4,0;13,0;3,0;48,0;25,0;11,0;6,0;9,0;19,0;1,0;3,0;;15,0;13,0;93,0;33,0;22,0;23,0;20,0;9,0;25,0;84,0;;20,0;18,0;;14,0;2,0;;1,0;2,0;34,0;21,0;5,0;4,0;2,0;8,0;;34,0;19,0;4,0;;1,0;5,0;153,0;8,0;10,0;19,0;8,0;5,0;5,0;24,0;2,0;11,0;;4,0;566,0;5,0;;113,0;7,0;11,0;61,0;5,0;96,0;;5,0;1,0;11,0;32,0;31,0;;6,0;7,0;52,0;2,0;71,0;17,0;2,0;2,0;6,0;12,0;;;23,0;11,0;60,0;16,0;20,0;12,0;;108,0;1,0;28,0;1,0;25,0;4,0;3,0;3,0;;4,0;9,0;;;1,0;1,0;3,0;5,0;3,0;1,0;11,0;4,0;3,0;5,0;2,0;;18,0;;;8,0;4,0;19,0;2,0;5,0;;13,0;1,0;4,0;55,0;1,0;4,0;;75,0;4,0;7,0;;12,0;;3,0;9,0;8,0;1,0;3,0;3,0;286,0;3,0;;1,0;;21,0;8,0;2,0;1,0;4,0;2,0;3,0;1,0;;1,0;1,0;;3,0;27,0;;7,0;1,0;17,0;7,0;19,0;3,0;13,0;6,0;21,0;;4,0;3,0;29,0;2,0;2,0;4,0;;;15,0;;5,0;2,0;22,0;5,0;10,0;24,0;1,0;16,0;5,0;74,0;6,0;;;54,0;;3,0;42,0;;;;1,0;5,0;20,0;233,0;1,0;16,0;11,0;2,0;10,0;44,0;;1,0;25,0;;;10,0;61,0;7,0;;96,0;;;2,0;5,0;3,0;;16,0;;29,0;9,0;;4,0;;3,0;12,0;63,0;;;;3,0;;;12,0;;;5,0;2,0;39,0;;;1,0;1,0;;;2,0;
equation;3,0;;;;;3,0;;;;;;;2,0;44,0;;;1,0;;;1,0;;1,0;29,0;;;;;3,0;4,0;24,0;14,0;;4,0;4,0;;5,0;4,0;;13,0;;35,0;18,0;;;1,0;;;5,0;;19,0;15,0;;;;1,0;12,0;17,0;;;15,0;;;;;44,0;;15,0;3,0;;;7,0;31,0;1,0;;;;;7,0;;;31,0;;;7,0;12,0;;;76,0;;4,0;12,0;;8,0;;;;15,0;82,0;15,0;43,0;;;;;2,0;7,0;;6,0;;;;;5,0;;;;;3,0;;9,0;2,0;;;;;2,0;29,0;;;4,0;2,0;3,0;;;2,0;;;;;;;;;;;3,0;;;1,0;;1,0;;;;;;;;;;;;;;;;;;;;2,0;2,0;;;;;;;2,0;;;;;4,0;;;1,0;;4,0;;4,0;;;;;1,0;;;;;;;1,0;;4,0;;;;;;;;36,0;;;;8,0;;6,0;;15,0;;;;;;;;;;;;2,0;;;;;;;14,0;;;;;;;;;;;;;;;;;;17,0;;;;;;;;;;;3,0;;;;1,0;1,0;;;;16,0;;;;;34,0;;;;;3,0;2,0;;;;;;;;22,0;;;;;;;;;;;;6,0;52,0;;;;;;;;;;;;5,0;;2,0;;;;;;;;;;;6,0;;;;;;2,0;3,0;;;;;;2,0;;;;;;;1,0;1,0;;;4,0;;4,0;;;;;;;;;;;;71,0;5,0;;;;4,0;;;;14,0;;2,0;;4,0;;;;;;2,0;1,0;;1,0;3,0;;;2,0;;;4,0;;;35,0;14,0;;;;;;4,0;;;;5,0;;3,0;;3,0;;;;;;;;;;3,0;2,0;;1,0;;4,0;;2,0;;;;;;;;;1,0;;;8,0;;;1,0;;;;;;26,0;;3,0;11,0;;3,0;8,0;;;10,0;;;14,0;;;4,0;;;;;;1,0;;;;;;1,0;;12,0;3,0;;4,0;;;;;;;24,0;;;;;;;;17,0;4,0;;;;;;;;;;;;3,0;;;;;;;;;;;;;;;;;6,0;;;;;9,0;;;;;;;;;;;;;1,0;;;3,0;;;;;2,0;;;;;;;;;;;;;;;;4,0;;;;;;;;;;;;;4,0;;;;;;;;;;;4,0;;;6,0;;;;;2,0;;;;;;;;;;;;;;1,0;;;;;;;;;;;;;;;;;;;;;1,0;3,0;;;;;;;;31,0;;;;;;;2,0;;;;;;;;;;;;;34,0;;;;;;6,0;;;;;;;;3,0;;;;;;;;;;;1,0;;;;;;;;;;;;9,0;;;;;;2,0;;;;;;;;;;;;;;;;;;;;;;;4,0;;;;;;;5,0;;;;;;;;;;;;;;;;;;;;;;;;;;;18,0;;;;;;;;6,0;;;;;;;;;;;;;;;;;;;;;;;;;;;;;25,0;;6,0;;;;1,0;;;;;;;;;;;;;2,0;;;;;;;6,0;;;;;;;1,0;;;;;;;;;;3,0;3,0;9,0;11,0;;;;;;;2,0;;;;;;;;;;78,0;8,0;1,0;;;;7,0;;;;;;;;;;;;;;;2,0;;;;;;;;;;;;;;;;;;;;;;;;;;;;;;;;;;;1,0;;;;;;;;;;;;;;;;21,0;;;;;;;;;1,0;;;;;3,0;;;;;;;;;1,0;;;;;;;3,0;;;;;;;;28,0;;;;;;5,0;;;;;;;;;;;
error;2,0;;;22,0;56,0;42,0;2,0;35,0;7,0;;;;;78,0;;;10,0;2,0;;1,0;;;47,0;;;88,0;3,0;9,0;8,0;6,0;185,0;17,0;111,0;33,0;;34,0;;;22,0;;141,0;13,0;;6,0;11,0;;46,0;28,0;19,0;;49,0;;;2,0;;2,0;3,0;;;60,0;;;71,0;;172,0;1,0;47,0;4,0;2,0;2,0;;39,0;7,0;;;4,0;;17,0;;1,0;107,0;;17,0;24,0;7,0;;;114,0;;9,0;49,0;;4,0;;14,0;;44,0;6,0;23,0;56,0;85,0;21,0;;5,0;31,0;25,0;3,0;24,0;;1,0;;17,0;8,0;1,0;;;8,0;8,0;;3,0;6,0;;44,0;1,0;;19,0;73,0;;;;20,0;6,0;;27,0;1,0;;11,0;;;;;5,0;;4,0;5,0;14,0;13,0;2,0;27,0;;2,0;2,0;1,0;;1,0;;;;;;;;;;;4,0;;6,0;5,0;15,0;;11,0;1,0;42,0;;1,0;;;1,0;;;;;10,0;;;3,0;;13,0;;;;;;;;;4,0;;;;;;;11,0;2,0;4,0;;;;2,0;2,0;6,0;;;;29,0;;;2,0;16,0;3,0;16,0;;;;12,0;1,0;3,0;;;;38,0;1,0;;3,0;4,0;6,0;;6,0;;;;;;11,0;;2,0;1,0;;;;;4,0;;;1,0;9,0;;;3,0;3,0;30,0;4,0;;1,0;;;10,0;1,0;;;4,0;6,0;;;1,0;4,0;;;;;;;4,0;;;;6,0;;;1,0;;;;;19,0;1,0;;;;;;;;;1,0;;9,0;6,0;1,0;;1,0;;5,0;;4,0;;;;3,0;22,0;3,0;12,0;;;4,0;;1,0;;;;;;6,0;;;;;;;7,0;1,0;;;;;3,0;;;;;1,0;;19,0;;6,0;;10,0;;;;;2,0;;;3,0;;;1,0;;;87,0;7,0;5,0;2,0;;;1,0;8,0;81,0;7,0;7,0;1,0;3,0;15,0;3,0;19,0;2,0;;24,0;7,0;;4,0;;70,0;;20,0;9,0;9,0;;18,0;;16,0;1,0;8,0;6,0;;21,0;1,0;;;;2,0;1,0;1,0;;;;3,0;;4,0;13,0;;;16,0;;16,0;;;1,0;;11,0;;3,0;;7,0;11,0;6,0;1,0;7,0;;64,0;7,0;6,0;4,0;5,0;;9,0;4,0;1,0;;;1,0;;;3,0;47,0;;3,0;46,0;;1,0;3,0;;;3,0;2,0;;;4,0;;21,0;5,0;;;;2,0;9,0;2,0;;;;13,0;;1,0;16,0;;;40,0;1,0;;;3,0;;;1,0;;1,0;;2,0;;;;4,0;2,0;2,0;;;4,0;1,0;11,0;;;;4,0;;3,0;;;;;;;;;;;;;;;;2,0;6,0;2,0;2,0;;1,0;5,0;;10,0;12,0;;;;;1,0;5,0;;;;10,0;2,0;;;;;;;9,0;;;;12,0;;1,0;22,0;2,0;2,0;;;;;;;;;;;6,0;;;;;;;;1,0;;;1,0;2,0;1,0;;2,0;2,0;3,0;3,0;;4,0;;;6,0;3,0;;;;24,0;;1,0;;3,0;;;;2,0;;;;;;4,0;6,0;;;;;;;;;;1,0;;9,0;;3,0;;2,0;;;;2,0;1,0;;;;2,0;;1,0;2,0;3,0;8,0;;12,0;10,0;2,0;;1,0;;3,0;;;;;;;;;5,0;;;4,0;6,0;3,0;;;13,0;2,0;;;;12,0;;1,0;5,0;;;;2,0;;;;;1,0;;;;;;;1,0;;1,0;;;;;13,0;;3,0;;1,0;;1,0;3,0;;7,0;6,0;12,0;;;8,0;25,0;1,0;;;;;;;;;;;10,0;;1,0;;1,0;;1,0;;;3,0;;;;;;;;;;;;3,0;;;;;;;;11,0;;;;;;;40,0;;;;;;;;4,0;;;;;9,0;;7,0;13,0;;;;;;;;;;3,0;;;;;76,0;1,0;;;;8,0;6,0;;36,0;;;;;;;;;;2,0;;;;;;;;;;;9,0;;1,0;3,0;;;;2,0;;;;6,0;;;;;1,0;;;12,0;;;1,0;;;;;;;;2,0;;;;3,0;;;;8,0;;1,0;1,0;6,0;;;;1,0;;;;1,0;;22,0;3,0;;;;;1,0;;;10,0;1,0;;1,0;;;;;1,0;;;;;;;;;;;;;;;;;;1,0;;;;;;1,0;3,0;;;;;;;;;;;;;;4,0;;;;;12,0;;7,0;;;;;;;;;;;;1,0;;;;;;;;;2,0;;;;;;;;2,0;2,0;;;;1,0;4,0;;1,0;1,0;;;9,0;;;;;;;;;;;
estimate;19,0;;;39,0;13,0;51,0;43,0;;1,0;;;4,0;;281,0;;2,0;76,0;;4,0;5,0;;1,0;28,0;2,0;14,0;4,0;2,0;52,0;14,0;23,0;92,0;9,0;17,0;17,0;;79,0;8,0;16,0;325,0;;184,0;103,0;;14,0;37,0;1,0;5,0;13,0;15,0;49,0;;;1,0;;33,0;26,0;3,0;;26,0;99,0;;;1,0;;568,0;3,0;114,0;13,0;20,0;;44,0;18,0;11,0;1,0;;1,0;;41,0;;5,0;281,0;;5,0;128,0;61,0;;4,0;4,0;;9,0;121,0;5,0;1,0;;16,0;;188,0;11,0;111,0;238,0;304,0;30,0;;38,0;54,0;74,0;8,0;26,0;30,0;21,0;;78,0;56,0;8,0;;;4,0;45,0;57,0;22,0;27,0;;20,0;15,0;11,0;18,0;121,0;;3,0;;64,0;12,0;1,0;51,0;3,0;;41,0;31,0;3,0;;;;;2,0;;28,0;14,0;2,0;32,0;2,0;6,0;13,0;8,0;;;;;;;;;6,0;;;;6,0;2,0;;;12,0;3,0;71,0;7,0;28,0;;31,0;;;4,0;;9,0;1,0;;11,0;;;10,0;;41,0;;8,0;;;;;;;;1,0;;;;;6,0;48,0;26,0;;;;7,0;1,0;19,0;25,0;;;1,0;18,0;;;4,0;14,0;20,0;4,0;;1,0;;17,0;;;18,0;;7,0;43,0;;2,0;2,0;;2,0;;19,0;;1,0;;;;28,0;2,0;7,0;5,0;;;;;32,0;;2,0;;34,0;;;;4,0;;84,0;;1,0;;;2,0;6,0;;;;3,0;;;1,0;51,0;;;;;2,0;1,0;8,0;;;1,0;5,0;;1,0;;;;3,0;;160,0;5,0;;;;;;9,0;;;;7,0;92,0;23,0;;;;;5,0;;;;;;57,0;153,0;;2,0;;;;;7,0;;;;;;4,0;1,0;4,0;;19,0;;1,0;30,0;3,0;;;;1,0;10,0;;;;;16,0;;35,0;4,0;1,0;;49,0;;;1,0;;1,0;;10,0;8,0;58,0;;4,0;;;47,0;57,0;42,0;;;;47,0;10,0;25,0;93,0;4,0;7,0;4,0;35,0;12,0;10,0;6,0;2,0;;7,0;9,0;42,0;;73,0;;34,0;25,0;12,0;10,0;19,0;24,0;22,0;8,0;142,0;7,0;5,0;139,0;;;24,0;6,0;;21,0;93,0;;1,0;9,0;13,0;;5,0;4,0;;9,0;11,0;3,0;47,0;;7,0;4,0;1,0;27,0;;63,0;3,0;13,0;21,0;;;3,0;;26,0;7,0;5,0;9,0;18,0;29,0;17,0;8,0;12,0;;3,0;;2,0;;2,0;48,0;;4,0;55,0;;52,0;1,0;;;77,0;;;17,0;2,0;2,0;33,0;3,0;;;;1,0;6,0;4,0;;8,0;;24,0;2,0;4,0;42,0;26,0;;274,0;3,0;;;4,0;;3,0;1,0;;2,0;;;;3,0;;26,0;32,0;2,0;;;2,0;;13,0;;;;;1,0;8,0;;;;;1,0;3,0;3,0;;;;;;;;;2,0;9,0;;6,0;6,0;;17,0;15,0;1,0;9,0;;1,0;1,0;;;1,0;1,0;;;1,0;5,0;;;2,0;;;;4,0;;;;37,0;1,0;5,0;;;5,0;;;;;;9,0;6,0;8,0;;1,0;;;;;8,0;;;;1,0;2,0;;9,0;;7,0;;;4,0;;35,0;;5,0;;;91,0;4,0;4,0;;;8,0;;;;17,0;11,0;;;5,0;;;;;;9,0;9,0;;1,0;3,0;8,0;3,0;1,0;;5,0;;2,0;;;10,0;;;2,0;;;2,0;11,0;7,0;23,0;;;;;;3,0;3,0;9,0;8,0;8,0;;4,0;27,0;;;;4,0;3,0;;;;;;;10,0;;1,0;;5,0;7,0;;10,0;78,0;;;;;;4,0;;3,0;;;;;;;;;;;6,0;;;;2,0;5,0;7,0;5,0;;;2,0;;2,0;;;;1,0;;8,0;;;4,0;7,0;;;;;;;;;23,0;1,0;2,0;;;6,0;34,0;;;;4,0;;2,0;;3,0;3,0;;;;11,0;;;;;;;;;;;;;;;;;;24,0;1,0;;36,0;;17,0;;63,0;;;;;;;;3,0;;;;;1,0;;7,0;;;;;6,0;;;;5,0;;;;;;;20,0;;3,0;;;22,0;33,0;;1,0;;;;19,0;;;;13,0;;8,0;3,0;;1,0;2,0;2,0;1,0;57,0;;9,0;;16,0;;8,0;44,0;;;;2,0;1,0;;18,0;14,0;5,0;7,0;;;10,0;;10,0;13,0;5,0;11,0;16,0;2,0;6,0;;;;1,0;;;;2,0;;1,0;2,0;;8,0;5,0;7,0;9,0;2,0;15,0;;;;18,0;9,0;4,0;;1,0;;;2,0;;;2,0;1,0;;1,0;;4,0;;;;;10,0;;1,0;17,0;;;5,0;1,0;;;1,0;;2,0;;;;;;;;;;;;;;;42,0;16,0;6,0;;;18,0;29,0;;;3,0;;;;;;;;8,0;;;;;;;;3,0;;;;;;1,0;;;;;;;;;;1,0;4,0;7,0;3,0;;;1,0;;2,0;;8,0;1,0;;;;3,0;4,0;3,0;1,0;2,0;;6,0;47,0;6,0;;;;23,0;;;;;;1,0
exit;1,0;;;;;4,0;1,0;1,0;;;;;;3,0;;;;;7,0;;;;4,0;;4,0;;;4,0;;;9,0;;12,0;;4,0;8,0;2,0;;;;9,0;32,0;;;4,0;3,0;;7,0;;;;;14,0;;12,0;1,0;6,0;;;3,0;;;8,0;;23,0;;2,0;;;;;38,0;79,0;2,0;;;;;;;3,0;;10,0;;11,0;;;32,0;2,0;;;;6,0;2,0;;;;6,0;14,0;19,0;36,0;2,0;11,0;;;2,0;;1,0;;46,0;;;8,0;;;;;12,0;29,0;4,0;2,0;1,0;7,0;;;;9,0;;;2,0;6,0;2,0;;;;;11,0;;1,0;;;2,0;1,0;;9,0;;11,0;9,0;1,0;;;;3,0;1,0;;;;;;;;3,0;1,0;;;;9,0;2,0;;;;2,0;4,0;38,0;;;;5,0;;;;1,0;;45,0;;;3,0;1,0;;3,0;;;;;;1,0;22,0;3,0;1,0;;;2,0;;;1,0;5,0;;;4,0;1,0;;;8,0;;;;5,0;2,0;;10,0;1,0;;;;2,0;;24,0;1,0;;;;10,0;;2,0;;1,0;2,0;1,0;;;;;;;;2,0;;17,0;16,0;;;;;2,0;1,0;;;40,0;;;;;;14,0;9,0;;2,0;;;13,0;5,0;;1,0;1,0;5,0;;3,0;3,0;;4,0;;;5,0;;;;;;;;2,0;;;1,0;;;6,0;3,0;;;;2,0;;1,0;;;;;8,0;10,0;;;;;;;;;;;17,0;;;;;;;;2,0;;;;;6,0;2,0;;;;;;;;;;;3,0;;21,0;;;;;1,0;;;3,0;;;2,0;;;;;;;;;;;;;;;1,0;;;;3,0;;;3,0;;;;;3,0;;;;;;;;2,0;;;;;2,0;2,0;;1,0;;;;;;;;;;;;;;;;;;;;;;;;6,0;;5,0;;;;;;1,0;;;;;;;;;;;;;;6,0;;;;;;;1,0;;;;;;;;;1,0;4,0;;;;;;1,0;;;2,0;3,0;;;;;;;;1,0;2,0;;;;20,0;;;;2,0;;;;;;;;;;3,0;;1,0;;;;;;;;;;;;;2,0;;;;7,0;;;;;;;;12,0;;;;;3,0;;;7,0;;;;;;1,0;5,0;;;;;24,0;;;;;;2,0;;;;;;;;3,0;;;;;3,0;;;;;;;;;;;1,0;;;1,0;;31,0;;;;;;;;;;;1,0;;;2,0;;;;;;;;;;1,0;;;;;;;;;;;;;;;;;;;;;;;3,0;;2,0;;;;2,0;;6,0;;;;;;;;;;;;;;;;;;;;;;;2,0;;;;;;;;;10,0;;;;;;;;2,0;;;;;;;;;;;;;;;;;1,0;;1,0;;;;;;;;;;3,0;;;;;3,0;;;5,0;;2,0;6,0;;;;;;;;;;;;;;;;3,0;;;18,0;;15,0;;3,0;;;;;;;;;;;;7,0;;2,0;;;3,0;4,0;1,0;;;;;;;;;;;;3,0;1,0;;;;;;;;;;;1,0;;;;;;;;;;;;;;;1,0;;;;;;;;;;;2,0;;1,0;;;;;;;;;;;;;;;;;;;;;;;;;;;;;;;;;;;1,0;;;;;;;;;;;;;;6,0;;1,0;;;;;;;;;;;;;;;;;;2,0;;;;;;;;;;;;;;;;2,0;3,0;;;;;;;;5,0;;;;;;;;;;;2,0;;;;;;;2,0;;;;;;;;;1,0;;;;;;;;;;;;3,0;;;;;1,0;;;;;;;;;;;;;;;;16,0;;;;;;;;;;;;4,0;;1,0;;;;;;6,0;;;;;;;;;;;;2,0;
extend;5,0;3,0;;3,0;2,0;60,0;26,0;129,0;;;13,0;15,0;54,0;323,0;;;46,0;;95,0;;2,0;;16,0;;2,0;;;26,0;5,0;5,0;92,0;4,0;;;;10,0;51,0;25,0;35,0;10,0;29,0;143,0;10,0;12,0;29,0;48,0;;142,0;;;1,0;14,0;;16,0;51,0;2,0;150,0;2,0;1,0;4,0;20,0;;1,0;1,0;112,0;1,0;240,0;8,0;;62,0;92,0;215,0;108,0;2,0;3,0;;22,0;8,0;;5,0;61,0;;8,0;7,0;153,0;19,0;;162,0;18,0;;;54,0;14,0;19,0;;;20,0;78,0;212,0;59,0;219,0;19,0;;3,0;2,0;8,0;;4,0;;;;1,0;116,0;15,0;;;;47,0;5,0;97,0;;6,0;4,0;9,0;;5,0;55,0;1,0;;19,0;16,0;3,0;28,0;97,0;1,0;3,0;59,0;21,0;6,0;;10,0;30,0;;;151,0;6,0;85,0;23,0;11,0;81,0;6,0;28,0;249,0;166,0;;5,0;33,0;2,0;;2,0;60,0;108,0;;;;;126,0;89,0;5,0;5,0;1,0;;3,0;472,0;8,0;135,0;7,0;6,0;19,0;1,0;;9,0;11,0;124,0;74,0;19,0;19,0;5,0;50,0;109,0;;1,0;16,0;78,0;48,0;81,0;293,0;2,0;80,0;14,0;14,0;89,0;;1,0;3,0;1,0;354,0;27,0;36,0;304,0;13,0;23,0;6,0;14,0;18,0;101,0;12,0;180,0;3,0;29,0;33,0;;3,0;4,0;200,0;9,0;1234,0;1,0;2,0;2,0;14,0;3,0;31,0;;85,0;;4,0;;;4,0;5,0;25,0;25,0;;37,0;4,0;2,0;53,0;486,0;17,0;52,0;17,0;14,0;113,0;62,0;2,0;250,0;734,0;15,0;;;;17,0;43,0;269,0;4,0;2,0;;2,0;41,0;11,0;90,0;30,0;26,0;8,0;;27,0;68,0;22,0;8,0;50,0;6,0;342,0;68,0;;3,0;20,0;31,0;61,0;4,0;24,0;63,0;12,0;37,0;5,0;77,0;35,0;1,0;12,0;15,0;15,0;69,0;15,0;3,0;13,0;60,0;50,0;52,0;19,0;46,0;23,0;3,0;28,0;7,0;35,0;7,0;50,0;39,0;18,0;29,0;4,0;5,0;93,0;17,0;13,0;35,0;2,0;16,0;8,0;8,0;90,0;30,0;70,0;102,0;3,0;9,0;8,0;5,0;7,0;6,0;22,0;32,0;13,0;21,0;14,0;26,0;60,0;66,0;1,0;59,0;4,0;16,0;;7,0;5,0;42,0;;116,0;13,0;1,0;7,0;;1,0;1,0;;13,0;;;6,0;;8,0;1,0;3,0;87,0;;;1,0;;;;11,0;11,0;;;2,0;8,0;5,0;;;;;1,0;;;38,0;6,0;8,0;9,0;;;1,0;;7,0;3,0;13,0;18,0;;8,0;12,0;15,0;;14,0;;7,0;10,0;17,0;16,0;;2,0;;;;2,0;4,0;;48,0;2,0;10,0;6,0;1,0;1,0;4,0;3,0;;1,0;2,0;2,0;4,0;3,0;;;39,0;4,0;3,0;;1,0;2,0;8,0;42,0;;;1,0;4,0;9,0;12,0;7,0;3,0;6,0;12,0;1,0;5,0;3,0;;3,0;;3,0;;;;;;2,0;3,0;33,0;103,0;37,0;10,0;;;1,0;14,0;2,0;5,0;5,0;6,0;1,0;2,0;2,0;3,0;37,0;;1,0;4,0;16,0;4,0;10,0;1,0;3,0;;;;;8,0;;;45,0;;;;;;;4,0;5,0;;6,0;13,0;11,0;9,0;11,0;37,0;70,0;3,0;28,0;;;57,0;16,0;8,0;;6,0;3,0;13,0;76,0;54,0;;;;3,0;3,0;;;2,0;145,0;;3,0;;;13,0;;16,0;10,0;;;;;;;22,0;;6,0;8,0;1,0;10,0;;;19,0;;6,0;3,0;;1,0;;7,0;16,0;10,0;1,0;;18,0;4,0;3,0;7,0;22,0;53,0;7,0;51,0;16,0;;;1,0;1,0;;;;11,0;;;1,0;2,0;;;;;47,0;2,0;;7,0;6,0;1,0;12,0;;;2,0;16,0;;13,0;4,0;1,0;;8,0;;;;1,0;;;4,0;;;;8,0;;10,0;1,0;;;;4,0;90,0;;1,0;;12,0;32,0;;3,0;;11,0;;5,0;;;8,0;;;7,0;;;;1,0;2,0;;;;9,0;3,0;;;15,0;;46,0;;2,0;;;1,0;;;10,0;;2,0;9,0;1,0;4,0;;3,0;2,0;4,0;6,0;;;61,0;;1,0;6,0;59,0;18,0;42,0;1,0;;;6,0;;13,0;11,0;56,0;24,0;80,0;4,0;;1,0;15,0;21,0;2,0;7,0;;1,0;3,0;;;;3,0;;;;1,0;50,0;2,0;1,0;;5,0;;5,0;6,0;73,0;;10,0;66,0;13,0;62,0;;9,0;14,0;27,0;4,0;4,0;11,0;;21,0;;4,0;5,0;3,0;6,0;;18,0;4,0;;6,0;2,0;102,0;13,0;6,0;16,0;3,0;3,0;;7,0;3,0;17,0;;12,0;51,0;61,0;4,0;2,0;;3,0;35,0;11,0;1,0;;9,0;2,0;31,0;;;19,0;;;;;;;;5,0;6,0;1,0;;3,0;3,0;1,0;15,0;;2,0;;12,0;;11,0;;;3,0;;;1,0;;17,0;;4,0;;4,0;2,0;1,0;;21,0;;;;;;;5,0;1,0;;1,0;;4,0;;;;10,0;4,0;3,0;;;;;2,0;3,0;;20,0;;1,0;;;;3,0;;;;;;9,0;1,0;;;4,0;2,0;2,0;;;7,0;;5,0;2,0;4,0;;;;1,0;9,0;1,0;;1,0;;;6,0;;;10,0;;4,0;3,0;;;;;;3,0;;;4,0;;;;3,0;1,0;;29,0;6,0;3,0;;;1,0;14,0;1,0;2,0;1,0;;5,0;;5,0;4,0;;;;2,0;;;2,0;;10,0;5,0;29,0;;2,0;;6,0;;;18,0;;;2,0;;3,0;42,0;;1,0;1,0;;9,0;2,0;4,0;;;;2,0;;;1,0;;;1,0;;;6,0;12,0;3,0;1,0;;;15,0;;;;;;;;1,0;;;;;;4,0;;;;;16,0;;1,0;;2,0;;;;
external;3,0;8,0;;5,0;;76,0;2,0;24,0;;;;1,0;7,0;49,0;;2,0;77,0;;3,0;4,0;3,0;;4,0;30,0;74,0;3,0;;36,0;42,0;23,0;81,0;40,0;2,0;2,0;;128,0;12,0;4,0;4,0;1,0;14,0;633,0;42,0;13,0;44,0;80,0;4,0;25,0;;2,0;;;16,0;;29,0;2,0;41,0;;1,0;26,0;3,0;;2,0;;272,0;2,0;101,0;;;1,0;4,0;98,0;101,0;;;;8,0;5,0;1,0;76,0;74,0;8,0;4,0;4,0;80,0;3,0;;95,0;;3,0;30,0;;7,0;14,0;15,0;;11,0;1,0;17,0;14,0;58,0;19,0;2,0;10,0;25,0;22,0;1,0;2,0;;;;15,0;30,0;;10,0;;;3,0;24,0;63,0;1,0;;78,0;2,0;;43,0;108,0;;1,0;3,0;13,0;;;95,0;;;43,0;;7,0;5,0;;3,0;2,0;;11,0;11,0;5,0;17,0;5,0;39,0;1,0;4,0;55,0;5,0;1,0;11,0;1,0;;;;11,0;105,0;7,0;5,0;;;59,0;37,0;;21,0;6,0;12,0;1,0;30,0;6,0;6,0;3,0;8,0;8,0;;5,0;39,0;17,0;45,0;3,0;2,0;6,0;34,0;20,0;38,0;2,0;2,0;15,0;3,0;1,0;9,0;169,0;16,0;7,0;5,0;;4,0;;;13,0;6,0;22,0;2,0;12,0;44,0;;3,0;;1,0;;8,0;17,0;8,0;;8,0;3,0;;;;14,0;1,0;62,0;4,0;8,0;9,0;5,0;13,0;1,0;;6,0;1,0;5,0;;1,0;3,0;;14,0;2,0;8,0;16,0;8,0;14,0;13,0;70,0;4,0;2,0;1,0;;27,0;22,0;32,0;2,0;228,0;7,0;;15,0;85,0;1,0;73,0;37,0;2,0;1,0;2,0;2,0;21,0;4,0;12,0;13,0;6,0;3,0;2,0;5,0;8,0;8,0;3,0;19,0;;6,0;10,0;;;22,0;40,0;18,0;1,0;8,0;3,0;4,0;1,0;;4,0;11,0;10,0;9,0;4,0;2,0;4,0;2,0;3,0;2,0;4,0;5,0;14,0;;10,0;;;5,0;7,0;;;27,0;4,0;3,0;33,0;47,0;28,0;22,0;2,0;;1,0;;;98,0;;1,0;;;6,0;19,0;2,0;3,0;;;;8,0;1,0;;8,0;;28,0;;33,0;;4,0;;;1,0;2,0;2,0;12,0;;7,0;29,0;44,0;;;3,0;4,0;5,0;;8,0;;;2,0;2,0;1,0;;1,0;2,0;;17,0;4,0;1,0;;76,0;2,0;;;2,0;19,0;1,0;2,0;;12,0;1,0;;;17,0;8,0;2,0;8,0;7,0;1,0;;;13,0;6,0;25,0;3,0;20,0;;13,0;5,0;4,0;;4,0;;16,0;30,0;9,0;1,0;;;;;4,0;1,0;1,0;;95,0;25,0;33,0;9,0;;36,0;;19,0;2,0;;;24,0;3,0;21,0;1,0;5,0;153,0;1,0;;;16,0;;;32,0;;;7,0;11,0;1,0;2,0;18,0;1,0;5,0;2,0;;19,0;2,0;11,0;5,0;;2,0;;;;3,0;;2,0;6,0;19,0;12,0;3,0;6,0;11,0;6,0;;52,0;;2,0;3,0;3,0;1,0;23,0;1,0;30,0;;16,0;;1,0;5,0;3,0;5,0;4,0;4,0;1,0;;;11,0;;6,0;;3,0;;;;;7,0;;3,0;2,0;1,0;1,0;;3,0;18,0;;72,0;27,0;;4,0;4,0;;11,0;;;;8,0;;;12,0;2,0;1,0;5,0;;5,0;3,0;;1,0;2,0;12,0;;6,0;;;42,0;;8,0;3,0;3,0;;29,0;17,0;;;2,0;;1,0;2,0;1,0;;;;2,0;;11,0;2,0;;;;;2,0;;1,0;5,0;6,0;19,0;;1,0;;6,0;4,0;12,0;3,0;2,0;1,0;2,0;3,0;3,0;;;1,0;;;9,0;25,0;1,0;5,0;;;3,0;12,0;4,0;;28,0;8,0;;;;;3,0;;6,0;;;1,0;;;1,0;;;8,0;;;;;1,0;;;2,0;71,0;7,0;8,0;;;6,0;;10,0;8,0;;2,0;;;1,0;7,0;;;1,0;22,0;;;;;;2,0;;;5,0;5,0;27,0;;5,0;;;;3,0;;44,0;;1,0;4,0;2,0;;;;6,0;;;;13,0;10,0;8,0;27,0;;1,0;3,0;6,0;;2,0;;;3,0;11,0;3,0;;;7,0;;;;22,0;6,0;2,0;3,0;5,0;;;;;;;2,0;8,0;;11,0;;15,0;8,0;;1,0;6,0;2,0;;2,0;11,0;16,0;;;3,0;;;10,0;1,0;3,0;11,0;;4,0;2,0;;;30,0;1,0;;3,0;;;;;3,0;5,0;2,0;;;;;7,0;;6,0;;;1,0;;;;1,0;;;;6,0;17,0;1,0;;;;30,0;10,0;2,0;;;3,0;;3,0;3,0;;2,0;2,0;;;8,0;10,0;;;;1,0;;1,0;;;;3,0;2,0;;;;;2,0;;;;;;1,0;;3,0;2,0;;;;2,0;6,0;5,0;;;;4,0;20,0;4,0;;;;;2,0;;;;;;;4,0;;;;5,0;;;;;;;;;;;3,0;;;11,0;;1,0;1,0;1,0;;1,0;;1,0;4,0;;;;;2,0;3,0;;;;;2,0;;1,0;2,0;;;;3,0;;;;;;1,0;;;;1,0;;;1,0;7,0;;;;;;;1,0;;;;;2,0;;3,0;1,0;;;;3,0;3,0;;;;;;1,0;4,0;;;;;;15,0;;3,0;37,0;1,0;;;;;;5,0;;;;;;;;1,0;;;2,0;11,0;;;;7,0;;;;;;5,0;1,0;3,0;;1,0;;;4,0;;;3,0;;;;;;;;;1,0;;;;;;;;;;1,0;;;;;
field;3,0;1,0;10,0;95,0;31,0;98,0;140,0;123,0;3,0;2,0;3,0;4,0;4,0;201,0;4,0;2,0;419,0;4,0;8,0;17,0;12,0;;25,0;;25,0;8,0;5,0;64,0;14,0;17,0;290,0;18,0;26,0;2,0;11,0;218,0;145,0;205,0;471,0;11,0;288,0;463,0;;56,0;228,0;103,0;59,0;72,0;1,0;;33,0;12,0;51,0;29,0;;39,0;66,0;1,0;9,0;204,0;;;77,0;1,0;1378,0;3,0;275,0;52,0;10,0;8,0;26,0;315,0;452,0;9,0;26,0;11,0;23,0;47,0;4,0;7,0;330,0;7,0;27,0;22,0;107,0;14,0;5,0;259,0;22,0;10,0;18,0;112,0;24,0;6,0;12,0;;65,0;36,0;247,0;132,0;369,0;32,0;7,0;11,0;63,0;86,0;3,0;17,0;;2,0;3,0;41,0;270,0;23,0;;69,0;33,0;117,0;147,0;516,0;8,0;7,0;85,0;54,0;5,0;17,0;477,0;1,0;66,0;1,0;72,0;17,0;3,0;62,0;8,0;3,0;5365,0;54,0;55,0;;;64,0;2,0;;24,0;33,0;151,0;40,0;94,0;6,0;1,0;24,0;7,0;3,0;6,0;2,0;;;;3,0;1,0;7,0;9,0;17,0;;1,0;30,0;65,0;2,0;52,0;23,0;;28,0;126,0;3,0;25,0;57,0;21,0;8,0;2,0;27,0;87,0;25,0;62,0;;15,0;10,0;9,0;76,0;41,0;5,0;1,0;1,0;;;18,0;36,0;10,0;1,0;1,0;;47,0;2,0;1,0;50,0;11,0;18,0;4,0;65,0;36,0;46,0;37,0;26,0;;;29,0;23,0;16,0;1,0;27,0;30,0;8,0;4,0;1,0;11,0;;514,0;;5,0;24,0;;27,0;118,0;35,0;13,0;5,0;30,0;6,0;;35,0;;;2,0;;;147,0;6,0;11,0;70,0;;;;4,0;10,0;2,0;2,0;33,0;81,0;16,0;;21,0;4,0;16,0;332,0;8,0;3,0;;;21,0;23,0;30,0;;7,0;11,0;1,0;;19,0;144,0;6,0;10,0;5,0;3,0;86,0;4,0;4,0;;3,0;2,0;14,0;2,0;19,0;20,0;;1,0;19,0;11,0;175,0;20,0;1,0;4,0;1,0;1,0;;44,0;;2,0;15,0;33,0;17,0;184,0;;2,0;4,0;;16,0;;45,0;3,0;3,0;16,0;93,0;468,0;8,0;516,0;8,0;3,0;;3,0;21,0;7,0;;2,0;;2,0;29,0;4,0;;;117,0;;22,0;1,0;3,0;;;;42,0;47,0;4,0;3,0;;;2,0;7,0;55,0;2,0;12,0;5,0;237,0;7,0;39,0;1,0;;72,0;4,0;20,0;14,0;49,0;;4,0;2,0;;32,0;56,0;75,0;10,0;73,0;7,0;27,0;4,0;71,0;32,0;11,0;10,0;38,0;136,0;50,0;15,0;12,0;4,0;11,0;7,0;6,0;70,0;69,0;25,0;10,0;37,0;47,0;4,0;1,0;34,0;9,0;10,0;4,0;72,0;11,0;27,0;102,0;4,0;5,0;55,0;5,0;18,0;24,0;46,0;9,0;;1,0;6,0;;12,0;2,0;28,0;6,0;81,0;33,0;33,0;5,0;;37,0;1,0;9,0;1,0;25,0;6,0;13,0;34,0;10,0;3,0;4,0;3,0;18,0;28,0;1,0;14,0;;1,0;83,0;;34,0;3,0;16,0;15,0;3,0;1,0;3,0;28,0;;16,0;33,0;1,0;;14,0;11,0;12,0;2,0;;1,0;;4,0;2,0;7,0;17,0;10,0;6,0;6,0;4,0;1,0;3,0;85,0;1,0;2,0;113,0;23,0;10,0;33,0;25,0;11,0;16,0;;9,0;5,0;54,0;9,0;5,0;7,0;7,0;3,0;;9,0;37,0;;1,0;69,0;34,0;168,0;11,0;;;3,0;;;;12,0;14,0;3,0;1,0;;;2,0;7,0;5,0;9,0;4,0;;2,0;1,0;2,0;1,0;;11,0;2,0;5,0;58,0;3,0;1,0;6,0;3,0;16,0;7,0;6,0;6,0;22,0;13,0;15,0;;1,0;;10,0;75,0;2,0;6,0;32,0;8,0;6,0;12,0;3,0;;2,0;2,0;3,0;18,0;7,0;18,0;;44,0;;4,0;2,0;5,0;1,0;;;42,0;29,0;4,0;2,0;;3,0;3,0;6,0;30,0;7,0;2,0;;;;8,0;77,0;68,0;;;9,0;;;7,0;15,0;29,0;2,0;6,0;;;27,0;1,0;5,0;;6,0;2,0;14,0;5,0;6,0;9,0;3,0;1,0;;5,0;;1,0;12,0;1,0;4,0;54,0;148,0;;3,0;10,0;8,0;1,0;8,0;;1,0;;5,0;4,0;;1,0;;2,0;6,0;;3,0;3,0;4,0;5,0;59,0;;;3,0;7,0;;22,0;4,0;5,0;13,0;2,0;56,0;35,0;1,0;5,0;6,0;6,0;3,0;3,0;23,0;;2,0;;;1,0;46,0;14,0;15,0;;;4,0;10,0;1,0;200,0;6,0;;3,0;;8,0;6,0;4,0;9,0;;3,0;;8,0;2,0;;5,0;4,0;1,0;5,0;13,0;;;2,0;2,0;15,0;3,0;4,0;;;134,0;;7,0;;1,0;3,0;7,0;1,0;96,0;;4,0;;27,0;;;1,0;1,0;;46,0;10,0;16,0;10,0;;4,0;3,0;4,0;3,0;90,0;1,0;;;12,0;;11,0;;2,0;;;20,0;;17,0;16,0;;;1,0;1,0;;;;1,0;5,0;;8,0;;12,0;1,0;;;5,0;8,0;20,0;3,0;2,0;2,0;;8,0;;1,0;7,0;;2,0;15,0;1,0;;;;4,0;4,0;;;3,0;6,0;5,0;;;2,0;1,0;;;2,0;;2,0;;2,0;4,0;1,0;10,0;;;;3,0;20,0;2,0;2,0;6,0;10,0;;;1,0;1,0;;10,0;;15,0;17,0;3,0;5,0;1,0;7,0;1,0;1,0;1,0;;6,0;19,0;39,0;;2,0;2,0;2,0;5,0;;1,0;;3,0;;;2,0;;;5,0;4,0;7,0;6,0;9,0;1,0;13,0;2,0;1,0;23,0;;;;;149,0;3,0;6,0;;12,0;1,0;8,0;4,0;9,0;;2,0;3,0;14,0;20,0;1,0;;;2,0;9,0;;1,0;2,0;9,0;48,0;11,0;6,0;;9,0;32,0;14,0;2,0;8,0;;2,0;;;;6,0;2,0;;16,0;44,0;1,0;16,0;3,0;;1,0;2,0;6,0;;12,0;20,0;1,0;10,0;8,0;;1,0;44,0;;;;;;;7,0;25,0;3,0;1,0;2,0;;;;15,0;;;1,0;;;;;;3,0;3,0;6,0;;;1,0;;8,0;;4,0;6,0;2,0;9,0;3,0;;14,0;;6,0;2,0;2,0;4,0;;;;3,0;15,0;7,0;2,0;4,0;;7,0;23,0;22,0;2,0;6,0;7,0;2,0;21,0;4,0;2,0;1,0;1,0;9,0;;4,0;;3,0;10,0;;5,0;;2,0;;;;1,0;;
focal;5,0;;4,0;59,0;21,0;44,0;355,0;150,0;4,0;;2,0;;11,0;143,0;5,0;;135,0;8,0;18,0;11,0;;32,0;19,0;2,0;2,0;15,0;4,0;36,0;7,0;186,0;80,0;8,0;19,0;24,0;6,0;89,0;59,0;4,0;55,0;3,0;102,0;164,0;2,0;17,0;46,0;82,0;5,0;142,0;12,0;2,0;26,0;1,0;2,0;2,0;39,0;;107,0;;11,0;27,0;4,0;13,0;286,0;;581,0;2,0;166,0;10,0;2,0;;2117,0;1948,0;129,0;9,0;19,0;;15,0;7,0;;7,0;125,0;12,0;4,0;9,0;65,0;4,0;2,0;542,0;30,0;3,0;56,0;;5,0;;14,0;;267,0;1292,0;416,0;223,0;299,0;24,0;2,0;9,0;8,0;17,0;;2,0;1,0;4,0;;4,0;47,0;2,0;;;11,0;59,0;29,0;272,0;1,0;;45,0;38,0;27,0;18,0;490,0;34,0;6,0;25,0;59,0;53,0;3,0;241,0;36,0;;53,0;9,0;117,0;;1,0;6,0;;;34,0;25,0;70,0;19,0;77,0;2,0;2,0;3,0;14,0;;;;;;;11,0;;6,0;1,0;1,0;;6,0;9,0;12,0;3,0;63,0;12,0;4,0;7,0;24,0;;;5,0;4,0;7,0;;3,0;4,0;1,0;7,0;1,0;6,0;31,0;;12,0;45,0;1,0;;;;;1,0;12,0;8,0;8,0;;;7,0;43,0;;15,0;1,0;10,0;;15,0;11,0;18,0;13,0;;3,0;;2,0;24,0;1,0;;1,0;2,0;9,0;;;8,0;;18,0;;8,0;11,0;;33,0;112,0;43,0;8,0;;1,0;;;97,0;;;;;;42,0;19,0;4,0;60,0;;;;71,0;1,0;7,0;2,0;15,0;72,0;2,0;;3,0;5,0;7,0;;1,0;;;;7,0;7,0;;;8,0;13,0;;;1,0;55,0;3,0;26,0;5,0;5,0;124,0;1,0;6,0;;6,0;2,0;4,0;8,0;;18,0;;;34,0;;577,0;;;4,0;;12,0;;;;;;;23,0;201,0;;;1,0;;;;40,0;4,0;1,0;7,0;3,0;89,0;;2,0;;;12,0;;93,0;2,0;;;;;6,0;3,0;1,0;;;;4,0;5,0;;;1,0;1,0;;1,0;;;;;6,0;1,0;41,0;;9,0;1,0;11,0;;2,0;1,0;;1,0;;48,0;1,0;2,0;;;;;12,0;11,0;50,0;13,0;;3,0;2,0;2,0;77,0;12,0;;21,0;4,0;55,0;2,0;12,0;;;;1,0;;75,0;;14,0;2,0;25,0;32,0;4,0;;8,0;2,0;5,0;1,0;23,0;10,0;;15,0;3,0;;22,0;;17,0;17,0;14,0;;10,0;3,0;;;8,0;;5,0;1,0;48,0;;12,0;;;12,0;;84,0;1,0;3,0;;;11,0;5,0;;10,0;1,0;3,0;8,0;1,0;2,0;1,0;;46,0;;1,0;;;8,0;;;4,0;13,0;;11,0;9,0;1,0;7,0;;1,0;;;1,0;;;2,0;;8,0;6,0;;;6,0;1,0;;;;;4,0;13,0;5,0;;9,0;1,0;21,0;;;;2,0;6,0;4,0;1,0;3,0;;2,0;;1,0;;3,0;2,0;8,0;6,0;3,0;;;11,0;;6,0;;;6,0;42,0;;10,0;;;;;8,0;1,0;;;1,0;;3,0;;;1,0;;;5,0;;;;2,0;2,0;;9,0;5,0;10,0;;1,0;;;;;;;2,0;1,0;;1,0;;;;;;2,0;;7,0;1,0;2,0;3,0;;;1,0;;;8,0;;6,0;6,0;;;;;;3,0;9,0;;;;;;;26,0;;;;;;;1,0;1,0;;;;2,0;;11,0;;;;3,0;4,0;;;1,0;;1,0;;;;;;55,0;;;;2,0;;;2,0;;4,0;;;;;;12,0;1,0;;;3,0;2,0;;1,0;3,0;;;;;;;14,0;;;147,0;6,0;30,0;2,0;;2,0;16,0;;;;1,0;2,0;78,0;;1,0;;;;2,0;;3,0;3,0;;;;1,0;9,0;;;;;;;;3,0;7,0;1,0;2,0;;;;1,0;;1,0;14,0;8,0;3,0;3,0;;10,0;2,0;6,0;8,0;;4,0;;;2,0;;;;;;5,0;;;15,0;6,0;;2,0;1,0;;;;1,0;;9,0;17,0;;11,0;8,0;23,0;26,0;2,0;;;4,0;;23,0;;;;;50,0;4,0;17,0;;;6,0;;;2,0;2,0;23,0;;7,0;;;;5,0;;;;;1,0;;6,0;;14,0;2,0;1,0;;;;;;;;5,0;;;;9,0;1,0;;4,0;;;;;4,0;;;;2,0;;;;;;2,0;15,0;;;;9,0;6,0;17,0;;4,0;;;;;;1,0;;;;22,0;;4,0;19,0;25,0;2,0;1,0;;;5,0;;3,0;9,0;;6,0;;2,0;;;4,0;;;;18,0;;1,0;16,0;;;5,0;;6,0;;;;27,0;2,0;;;;7,0;1,0;2,0;;;8,0;6,0;5,0;;;;180,0;5,0;;;;;6,0;;;5,0;;;2,0;;;;;16,0;;;;2,0;;;1,0;;;;;;;;;;;4,0;2,0;7,0;;2,0;;;;;1,0;;4,0;;;;5,0;1,0;;;3,0;;;13,0;;;;1,0;;;;;;;;;25,0;;20,0;;;19,0;;;10,0;;;14,0;;;;1,0;;7,0;;;;;;;;4,0;2,0;;;;;;;4,0;;;3,0;;;3,0;74,0;;;10,0;;;;28,0;45,0;85,0;;;;;;;1,0;
form;12,0;11,0;1,0;36,0;19,0;189,0;299,0;195,0;;6,0;6,0;26,0;113,0;301,0;10,0;;175,0;3,0;95,0;3,0;82,0;10,0;116,0;14,0;14,0;2,0;11,0;89,0;5,0;13,0;219,0;6,0;6,0;13,0;9,0;104,0;39,0;16,0;30,0;16,0;64,0;394,0;46,0;58,0;83,0;81,0;;344,0;17,0;3,0;3,0;6,0;150,0;41,0;66,0;107,0;;6,0;6,0;54,0;39,0;5,0;121,0;2,0;1838,0;2,0;447,0;7,0;13,0;82,0;45,0;1221,0;365,0;27,0;10,0;3,0;319,0;7,0;8,0;22,0;410,0;6,0;4,0;5,0;485,0;37,0;3,0;543,0;34,0;20,0;9,0;12,0;53,0;86,0;18,0;1,0;424,0;224,0;761,0;170,0;269,0;51,0;49,0;48,0;32,0;9,0;2,0;;6,0;1,0;;53,0;546,0;6,0;5,0;;14,0;88,0;92,0;363,0;17,0;4,0;129,0;20,0;24,0;25,0;329,0;9,0;15,0;33,0;36,0;;26,0;502,0;1,0;5,0;75,0;65,0;67,0;8,0;3,0;41,0;;;138,0;40,0;138,0;146,0;19,0;46,0;9,0;49,0;217,0;165,0;5,0;78,0;42,0;44,0;19,0;52,0;178,0;150,0;6,0;44,0;13,0;4,0;143,0;237,0;7,0;19,0;19,0;20,0;37,0;148,0;9,0;109,0;11,0;26,0;12,0;3,0;3,0;;47,0;126,0;12,0;342,0;155,0;15,0;199,0;130,0;;8,0;29,0;33,0;153,0;396,0;467,0;27,0;171,0;59,0;140,0;540,0;10,0;2,0;12,0;8,0;457,0;146,0;46,0;193,0;10,0;10,0;7,0;5,0;31,0;175,0;50,0;37,0;15,0;84,0;282,0;2,0;6,0;64,0;186,0;19,0;1012,0;6,0;11,0;12,0;34,0;17,0;33,0;21,0;53,0;18,0;49,0;26,0;6,0;7,0;37,0;132,0;4,0;1,0;89,0;62,0;68,0;257,0;483,0;11,0;107,0;67,0;82,0;216,0;422,0;10,0;172,0;1234,0;43,0;;46,0;25,0;124,0;29,0;192,0;15,0;7,0;12,0;5,0;91,0;13,0;98,0;45,0;10,0;10,0;;27,0;186,0;9,0;34,0;18,0;5,0;122,0;146,0;;4,0;67,0;123,0;213,0;27,0;89,0;20,0;15,0;56,0;18,0;23,0;24,0;16,0;37,0;38,0;12,0;28,0;39,0;14,0;4,0;224,0;20,0;23,0;22,0;208,0;39,0;26,0;36,0;4,0;15,0;8,0;60,0;26,0;18,0;18,0;13,0;213,0;60,0;30,0;24,0;43,0;27,0;8,0;21,0;39,0;136,0;11,0;20,0;157,0;9,0;39,0;1,0;5,0;3,0;2,0;26,0;27,0;17,0;54,0;23,0;23,0;81,0;157,0;2,0;71,0;5,0;;4,0;41,0;18,0;39,0;12,0;179,0;80,0;7,0;8,0;2,0;;2,0;1,0;16,0;1,0;11,0;;1,0;15,0;3,0;10,0;65,0;11,0;2,0;13,0;;9,0;2,0;78,0;18,0;;4,0;;15,0;1,0;16,0;1,0;2,0;;1,0;1,0;38,0;4,0;33,0;6,0;24,0;5,0;;;13,0;45,0;9,0;15,0;86,0;2,0;20,0;16,0;22,0;6,0;68,0;;13,0;16,0;14,0;5,0;1,0;5,0;;;5,0;12,0;14,0;;164,0;7,0;6,0;;6,0;46,0;;3,0;4,0;3,0;1,0;29,0;132,0;8,0;;1,0;76,0;13,0;17,0;1,0;1,0;1,0;4,0;56,0;;5,0;14,0;2,0;8,0;35,0;7,0;4,0;7,0;3,0;69,0;2,0;16,0;7,0;2,0;;8,0;8,0;;2,0;7,0;6,0;2,0;8,0;21,0;36,0;17,0;15,0;10,0;6,0;7,0;54,0;18,0;;44,0;7,0;24,0;25,0;20,0;6,0;;1,0;;10,0;74,0;2,0;12,0;11,0;7,0;3,0;3,0;22,0;18,0;42,0;9,0;43,0;37,0;3,0;;;;8,0;3,0;2,0;5,0;5,0;27,0;16,0;27,0;29,0;60,0;92,0;66,0;8,0;41,0;;;35,0;3,0;30,0;;41,0;4,0;14,0;151,0;72,0;;16,0;3,0;4,0;10,0;6,0;;47,0;354,0;1,0;3,0;;2,0;3,0;;;11,0;;8,0;9,0;7,0;10,0;20,0;3,0;;;2,0;16,0;8,0;;;1,0;2,0;4,0;;;5,0;;72,0;31,0;49,0;;;37,0;22,0;1,0;16,0;63,0;65,0;6,0;112,0;50,0;;7,0;138,0;;3,0;;6,0;3,0;3,0;3,0;6,0;1,0;8,0;1,0;;;41,0;1,0;3,0;2,0;10,0;5,0;55,0;7,0;;4,0;19,0;;33,0;3,0;2,0;;52,0;;;11,0;8,0;2,0;2,0;7,0;;1,0;2,0;31,0;1,0;13,0;25,0;16,0;;;13,0;15,0;8,0;3,0;6,0;69,0;8,0;16,0;22,0;3,0;15,0;;9,0;4,0;;18,0;1,0;1,0;11,0;20,0;2,0;21,0;7,0;8,0;;4,0;7,0;4,0;77,0;6,0;1,0;3,0;5,0;38,0;;9,0;;23,0;19,0;1,0;5,0;28,0;;;11,0;;15,0;;;1,0;63,0;54,0;;;58,0;;1,0;14,0;127,0;9,0;80,0;2,0;4,0;5,0;6,0;15,0;34,0;42,0;13,0;17,0;36,0;5,0;44,0;14,0;16,0;17,0;1,0;15,0;36,0;;17,0;15,0;4,0;3,0;2,0;92,0;1,0;2,0;1,0;8,0;2,0;8,0;2,0;3,0;12,0;12,0;1,0;32,0;;10,0;28,0;25,0;28,0;9,0;10,0;21,0;75,0;18,0;17,0;7,0;11,0;6,0;8,0;24,0;54,0;72,0;23,0;3,0;50,0;16,0;13,0;11,0;1,0;26,0;17,0;4,0;45,0;16,0;12,0;17,0;3,0;2,0;1,0;2,0;4,0;37,0;;;;26,0;11,0;64,0;5,0;12,0;;8,0;;152,0;;5,0;21,0;2,0;47,0;5,0;1,0;4,0;11,0;3,0;76,0;56,0;5,0;;13,0;1,0;5,0;150,0;5,0;13,0;6,0;57,0;;6,0;33,0;2,0;;7,0;25,0;7,0;;210,0;11,0;1,0;4,0;24,0;6,0;;3,0;45,0;34,0;8,0;34,0;;27,0;5,0;88,0;2,0;12,0;4,0;2,0;2,0;24,0;9,0;;29,0;21,0;3,0;2,0;5,0;5,0;;6,0;10,0;;25,0;1,0;4,0;;;2,0;43,0;;;4,0;;8,0;;1,0;;1,0;4,0;9,0;14,0;;;10,0;2,0;15,0;3,0;1,0;;;;1,0;;4,0;;3,0;3,0;;1,0;1,0;16,0;11,0;1,0;7,0;1,0;;;1,0;;8,0;2,0;1,0;8,0;2,0;1,0;7,0;3,0;3,0;83,0;4,0;14,0;9,0;8,0;;7,0;5,0;6,0;;6,0;1,0;;1,0;10,0;7,0;6,0;;2,0;3,0;3,0;;7,0;5,0;;1,0;1,0;26,0;6,0;2,0;8,0;;2,0;2,0;3,0;3,0;4,0;18,0;5,0;13,0;28,0;9,0;1,0;2,0;;28,0;18,0;22,0;1,0;2,0;;1,0;;10,0;6,0;;3,0;24,0;4,0;2,0;2,0;14,0;9,0;;11,0;;15,0;4,0;;42,0;3,0;7,0;6,0;7,0;;4,0;;;9,0;4,0;4,0;;4,0;5,0;9,0;11,0;1,0;15,0;;;2,0;;;
freedom;2,0;;2,0;2,0;;4,0;;34,0;;;;;;30,0;;;;;;;;;;;;;;5,0;2,0;;56,0;;;2,0;;;;507,0;;1,0;3,0;7,0;;2,0;;;;178,0;;;;;2,0;;1,0;;6,0;;;;;;2,0;;7,0;;14,0;3,0;;;;5,0;;;;;;;;;40,0;;;5,0;9,0;2,0;;;;;4,0;;;;;;;;5,0;;2,0;6,0;;1,0;1,0;2,0;;1,0;;;;;;;;;;1,0;;11,0;1,0;;;;;;12,0;;;;;;;4,0;;;;;;;;;;;;4,0;;;142,0;;;;2,0;;;;;;;;;;;;;;;;;;;;;70,0;;;;;;;;;;2,0;51,0;;;6,0;4,0;;;;;56,0;;10,0;;;;;;6,0;15,0;;;;;;;;13,0;59,0;;;;;;1,0;;;;;;;;;4,0;;;1,0;;;2,0;2,0;1,0;;;;;;;;;;;;;;;;;;;74,0;;;6,0;7,0;;;;;;;;;;;;;;;2,0;;;;12,0;1,0;;;;;5,0;;;3,0;;;;;;;;;;;;;;;;;;;;;;1,0;;;;;;;;;4,0;;;;1,0;4,0;;;;;;1,0;1,0;;;1,0;;;;;;;4,0;;15,0;16,0;4,0;9,0;;;;;;;;;;;2,0;;;;;;;;;;;2,0;;1,0;;;2,0;;;;;;;;;;1,0;;;;;2,0;;;;;;;;;;;;;4,0;;;;;;2,0;2,0;;;224,0;1,0;3,0;1,0;;;;5,0;;;;;;;15,0;;;128,0;;;;;;;;;;;1,0;;2,0;;;;;4,0;;2,0;;105,0;;;;1,0;;;;;;;;;;;;2,0;;;1,0;;;;;;;;;47,0;;;;6,0;;;;10,0;;;;;2,0;2,0;;;;;;;;;;;;;;;;1,0;;;;;;;;;;;;;;;;4,0;;;;;;;;;;;;;;;;;;;;;;1,0;;;;;;;;;;;;;;;;;;;;;;;;;;;;;;;2,0;;;;;;;;;;;;;;;;;;;;;;;;;;;;;;;;;;;;;;;;;;;;;4,0;;;;;;;;;;;;;;;1,0;;;;;;;;;1,0;;;;;;;;;;;;;;;;;5,0;;;;;;;;;;;;;;;;;;;;;;;;;;;;;;;;;;;1,0;;1,0;;;;;;;;;;;;;;;;;6,0;;;;;;;;;;;1,0;;8,0;;;;;;;18,0;;1,0;;;;;6,0;;;;;;5,0;;;1,0;;;;;;;;;;;;;;;;;;;;;;2,0;;;;;;;;;;;4,0;;;;;;;;;;;;;;;;;;;;;1,0;;;;;;;;;;;;;;;;;2,0;;;;;;;;;;;1,0;;;;;;;;;;;;;;;;;;;;;;;;;;;;;;;;;;;;;;;;;;;;;;;;;;;;;;;;;;;;;;;;;;;;;1,0;;;;;;;;;;;;;;;6,0;;;;;;;;;3,0;;;;;;18,0;;;;;;;;12,0;;;;;;;;;;;;;;1,0;;;;;;;3,0;;;;;;;;;;;;;;;;;;;;;;;;;;;;;;;;;;;;;;;
frequency;5,0;;1,0;24,0;25,0;34,0;9,0;4,0;1,0;;;79,0;1,0;81,0;;;30,0;8,0;5,0;11,0;;;4,0;2,0;19,0;17,0;7,0;87,0;3,0;14,0;78,0;18,0;5,0;3,0;;76,0;11,0;;15,0;1,0;130,0;51,0;;18,0;4,0;;1,0;5,0;;;26,0;;1,0;1,0;9,0;11,0;6,0;;;50,0;2,0;;15,0;;115,0;4,0;62,0;11,0;2,0;;;21,0;136,0;2,0;;1,0;;23,0;1,0;1,0;88,0;;7,0;14,0;22,0;1,0;1,0;76,0;4,0;4,0;3,0;;23,0;;2,0;;26,0;11,0;59,0;3,0;22,0;56,0;;8,0;6,0;23,0;;;2,0;;;34,0;29,0;;;;17,0;26,0;16,0;33,0;26,0;;352,0;2,0;15,0;2,0;51,0;;2,0;;83,0;1,0;;19,0;12,0;;5,0;10,0;1,0;;;;;15,0;2,0;4,0;7,0;2,0;36,0;1,0;3,0;11,0;7,0;;;;;;;;;5,0;9,0;15,0;4,0;;9,0;2,0;3,0;8,0;14,0;;4,0;7,0;;8,0;;34,0;1,0;;24,0;;;4,0;;1,0;64,0;2,0;24,0;;1,0;;1,0;;;;1,0;2,0;;;;2,0;;;12,0;7,0;1,0;;;;4,0;9,0;48,0;;;;30,0;;;1,0;20,0;35,0;;;;2,0;55,0;;;4,0;;8,0;98,0;17,0;;;31,0;13,0;;1,0;;2,0;;;;24,0;;1,0;2,0;;;;4,0;5,0;1,0;9,0;;18,0;1,0;;3,0;32,0;1,0;6,0;;1,0;16,0;5,0;5,0;1,0;;6,0;2,0;3,0;;;2,0;2,0;;;;;1,0;;;;13,0;1,0;31,0;;17,0;;;;;;18,0;6,0;;;;;;;;;2,0;1,0;3,0;9,0;;;;2,0;;;;2,0;;3,0;5,0;29,0;;;;;;;64,0;;;;;;2,0;;;;;;4,0;;5,0;;;1,0;2,0;1,0;1,0;;;;6,0;;11,0;;;;41,0;13,0;;;;;;2,0;7,0;19,0;;;;;25,0;1,0;21,0;1,0;;1,0;11,0;;65,0;6,0;29,0;;3,0;47,0;5,0;27,0;1,0;2,0;5,0;1,0;8,0;12,0;;58,0;12,0;12,0;15,0;1,0;;9,0;1,0;7,0;;11,0;2,0;7,0;18,0;2,0;;9,0;2,0;21,0;13,0;1,0;;5,0;;;1,0;25,0;2,0;1,0;2,0;53,0;1,0;80,0;11,0;6,0;19,0;;9,0;15,0;;;7,0;;9,0;2,0;;;9,0;2,0;6,0;7,0;;;8,0;16,0;;14,0;2,0;4,0;;;;24,0;;2,0;8,0;6,0;22,0;;;15,0;;;6,0;;;7,0;2,0;5,0;;;23,0;;4,0;1,0;3,0;;1,0;42,0;4,0;;19,0;1,0;3,0;;;2,0;;8,0;30,0;;2,0;;;1,0;;8,0;;;6,0;;;;;2,0;67,0;;;;3,0;10,0;2,0;16,0;;;;;;;;;;3,0;;;;;;;;2,0;11,0;;;1,0;;12,0;;2,0;;;;;;;;;;;4,0;5,0;;;;;;2,0;1,0;;21,0;;1,0;3,0;;1,0;;;;;;;1,0;4,0;;11,0;;;76,0;5,0;16,0;2,0;;2,0;4,0;3,0;;3,0;;7,0;;;;1,0;4,0;1,0;13,0;;;8,0;;;;;1,0;18,0;2,0;3,0;;8,0;;;4,0;12,0;;;;;17,0;3,0;1,0;;;1,0;;;1,0;;;3,0;1,0;;;;;53,0;7,0;13,0;;;;;2,0;;1,0;;2,0;;;;;12,0;14,0;;42,0;5,0;;;1,0;;7,0;;2,0;;;1,0;57,0;;;3,0;;1,0;1,0;;52,0;;;;32,0;36,0;24,0;2,0;4,0;;;;2,0;;101,0;;1,0;1,0;1,0;6,0;1,0;;;;;5,0;9,0;;;;;8,0;;;;3,0;;7,0;;;1,0;4,0;;;;;1,0;;;;;;;2,0;;2,0;8,0;;;;29,0;;1,0;;;;;8,0;;1,0;;;;;;;;;;;;;;6,0;;;;;;1,0;;;6,0;;;;;;;;;;;;;;;1,0;4,0;4,0;;;12,0;17,0;3,0;2,0;;;7,0;1,0;;;;;;6,0;;;;6,0;1,0;;;;2,0;;;1,0;1,0;11,0;;;;116,0;4,0;;;;;1,0;;;1,0;;2,0;;;5,0;;;;;18,0;;1,0;;;;16,0;;10,0;;;;4,0;;4,0;;29,0;;2,0;;;5,0;;;;54,0;;;1,0;227,0;;;1,0;10,0;;6,0;;5,0;1,0;2,0;;;4,0;1,0;;;;;;;;;1,0;5,0;;;;26,0;;;;;1,0;;;;;16,0;;;2,0;;;;;;;;3,0;2,0;1,0;;;50,0;1,0;;7,0;9,0;39,0;;5,0;;;;;2,0;;2,0;;1,0;;5,0;3,0;;;1,0;;;;;1,0;;;;;;;;;;;271,0;39,0;;2,0;;;;;;1,0;;;;;;;;;;;;;;;;;3,0;;;;;;;;;;;;
generate;3,0;9,0;;69,0;43,0;189,0;168,0;51,0;15,0;25,0;2,0;2,0;6,0;806,0;7,0;39,0;543,0;5,0;21,0;52,0;5,0;;227,0;5,0;30,0;24,0;16,0;89,0;77,0;33,0;1145,0;173,0;68,0;62,0;;1269,0;19,0;18,0;577,0;13,0;158,0;572,0;2,0;182,0;332,0;24,0;23,0;153,0;15,0;60,0;99,0;3,0;4,0;26,0;204,0;27,0;54,0;;50,0;;1,0;1,0;82,0;22,0;4800,0;17,0;418,0;12,0;21,0;14,0;14,0;187,0;441,0;5,0;3,0;4,0;5,0;68,0;57,0;47,0;823,0;;53,0;252,0;229,0;4,0;14,0;190,0;2,0;48,0;191,0;11,0;35,0;20,0;68,0;3,0;420,0;41,0;626,0;156,0;346,0;71,0;1,0;149,0;287,0;488,0;23,0;48,0;5,0;16,0;3,0;244,0;156,0;7,0;;31,0;111,0;100,0;175,0;518,0;78,0;4,0;1558,0;16,0;20,0;88,0;382,0;;52,0;;186,0;5,0;16,0;597,0;13,0;;345,0;156,0;27,0;11,0;;29,0;10,0;11,0;19,0;75,0;130,0;75,0;110,0;1,0;13,0;34,0;48,0;;41,0;165,0;3,0;;3,0;2,0;17,0;36,0;77,0;63,0;67,0;11,0;34,0;11,0;3,0;81,0;58,0;3,0;46,0;141,0;1,0;63,0;72,0;32,0;21,0;16,0;21,0;8,0;3,0;45,0;1,0;;125,0;132,0;425,0;17,0;4,0;1,0;185,0;12,0;2,0;6,0;45,0;21,0;4,0;2,0;;24,0;5,0;;57,0;34,0;69,0;2,0;14,0;16,0;36,0;77,0;20,0;;;6,0;433,0;6,0;27,0;66,0;157,0;45,0;4,0;147,0;10,0;;244,0;17,0;6,0;11,0;3,0;42,0;63,0;14,0;6,0;13,0;49,0;5,0;;94,0;;5,0;;;;106,0;11,0;20,0;12,0;4,0;2,0;;9,0;47,0;23,0;11,0;13,0;68,0;9,0;205,0;67,0;93,0;9,0;124,0;;16,0;173,0;17,0;26,0;21,0;;17,0;48,0;35,0;4,0;;15,0;64,0;3,0;14,0;;40,0;15,0;30,0;11,0;2,0;32,0;3,0;162,0;1,0;39,0;15,0;;1,0;20,0;2,0;82,0;35,0;5,0;2,0;;;;72,0;;1,0;1,0;19,0;14,0;199,0;2,0;1,0;9,0;7,0;17,0;;23,0;1,0;5,0;13,0;51,0;475,0;1,0;54,0;7,0;12,0;31,0;;44,0;;6,0;;;;38,0;8,0;;;30,0;4,0;15,0;53,0;3,0;;1,0;2,0;65,0;46,0;4,0;4,0;8,0;;23,0;;103,0;1,0;9,0;4,0;658,0;42,0;8,0;12,0;6,0;15,0;27,0;23,0;66,0;24,0;6,0;1,0;;;28,0;35,0;50,0;4,0;9,0;88,0;47,0;50,0;562,0;53,0;6,0;20,0;13,0;111,0;29,0;60,0;33,0;41,0;14,0;54,0;50,0;68,0;6,0;57,0;9,0;80,0;90,0;37,0;6,0;185,0;10,0;55,0;23,0;122,0;53,0;20,0;184,0;15,0;4,0;86,0;6,0;35,0;94,0;56,0;7,0;;2,0;6,0;6,0;36,0;6,0;35,0;14,0;174,0;19,0;178,0;14,0;;96,0;8,0;66,0;28,0;18,0;12,0;26,0;71,0;12,0;37,0;34,0;20,0;78,0;7,0;22,0;24,0;16,0;26,0;143,0;11,0;30,0;196,0;42,0;;3,0;;8,0;130,0;33,0;18,0;65,0;2,0;46,0;12,0;;53,0;12,0;9,0;65,0;15,0;37,0;31,0;193,0;61,0;9,0;;67,0;20,0;14,0;9,0;65,0;14,0;29,0;55,0;30,0;61,0;105,0;13,0;12,0;22,0;6,0;3,0;46,0;18,0;27,0;2,0;31,0;16,0;16,0;2,0;25,0;194,0;6,0;24,0;72,0;41,0;19,0;10,0;;8,0;61,0;23,0;10,0;;12,0;66,0;7,0;11,0;;1,0;51,0;;2,0;1,0;1,0;4,0;;;10,0;;2,0;7,0;5,0;29,0;61,0;18,0;13,0;22,0;5,0;31,0;49,0;3,0;5,0;9,0;44,0;102,0;2,0;9,0;4,0;107,0;2,0;1,0;22,0;40,0;28,0;23,0;1,0;35,0;;18,0;15,0;18,0;12,0;5,0;61,0;4,0;56,0;25,0;21,0;11,0;14,0;5,0;4,0;5,0;28,0;31,0;2,0;32,0;;23,0;7,0;;72,0;3,0;13,0;14,0;3,0;10,0;147,0;151,0;2,0;4,0;;25,0;;15,0;10,0;5,0;80,0;2,0;24,0;14,0;6,0;104,0;34,0;58,0;;71,0;17,0;9,0;164,0;187,0;18,0;2,0;7,0;;8,0;16,0;57,0;37,0;3,0;6,0;48,0;52,0;;24,0;2,0;;12,0;24,0;;13,0;;53,0;10,0;29,0;3,0;1,0;13,0;9,0;4,0;43,0;4,0;6,0;28,0;14,0;4,0;;7,0;1,0;13,0;25,0;17,0;8,0;12,0;8,0;75,0;3,0;121,0;43,0;1,0;9,0;47,0;10,0;24,0;1,0;12,0;7,0;3,0;5,0;165,0;3,0;4,0;2,0;82,0;16,0;9,0;30,0;285,0;22,0;2,0;3,0;7,0;27,0;16,0;34,0;9,0;;3,0;7,0;2,0;;55,0;3,0;59,0;20,0;17,0;17,0;1,0;3,0;8,0;14,0;10,0;64,0;80,0;;;;;24,0;3,0;5,0;;6,0;;74,0;2,0;13,0;4,0;16,0;25,0;2,0;2,0;7,0;8,0;6,0;1,0;1,0;26,0;18,0;;;;3,0;43,0;1,0;12,0;;11,0;2,0;23,0;3,0;7,0;9,0;;3,0;13,0;24,0;3,0;5,0;1,0;1,0;1,0;3,0;1,0;;8,0;1,0;3,0;9,0;2,0;;;2,0;;4,0;1,0;;;2,0;12,0;12,0;26,0;;;1,0;;;2,0;;10,0;;;26,0;4,0;9,0;5,0;19,0;33,0;7,0;2,0;14,0;42,0;2,0;8,0;;117,0;15,0;4,0;;1,0;;5,0;45,0;11,0;72,0;6,0;5,0;41,0;57,0;13,0;41,0;17,0;10,0;9,0;12,0;2,0;12,0;1,0;3,0;;8,0;;1,0;11,0;121,0;1,0;82,0;44,0;;61,0;4,0;29,0;;11,0;8,0;33,0;19,0;;10,0;25,0;17,0;13,0;27,0;;16,0;2,0;22,0;10,0;1,0;2,0;32,0;7,0;3,0;7,0;14,0;96,0;4,0;1,0;4,0;16,0;24,0;4,0;16,0;;8,0;;2,0;10,0;5,0;7,0;4,0;2,0;32,0;41,0;6,0;15,0;26,0;56,0;6,0;1,0;4,0;49,0;1,0;;9,0;;2,0;25,0;;21,0;6,0;13,0;2,0;3,0;13,0;;6,0;8,0;2,0;3,0;13,0;3,0;9,0;19,0;4,0;1,0;17,0;5,0;4,0;5,0;21,0;4,0;;;18,0;4,0;1,0;7,0;10,0;5,0;;42,0;1,0;14,0;41,0;21,0;34,0;179,0;1,0;4,0;7,0;;6,0;;4,0;12,0;7,0;3,0;2,0;5,0;37,0;29,0;1,0;;2,0;2,0;3,0;;2,0;10,0;11,0;20,0;6,0;4,0;8,0;13,0;1,0;10,0;22,0;;33,0;;2,0;1,0;7,0;2,0;5,0;;14,0;8,0;9,0;1,0;18,0;6,0;;10,0;10,0;;;7,0;76,0;;7,0;28,0;10,0;1,0;16,0;72,0;7,0;6,0;5,0;;2,0;12,0;27,0;;;;
glass;1,0;;;;;21,0;12,0;26,0;;;;;4,0;4,0;25,0;;9,0;;1,0;;3,0;;;;;1,0;1,0;8,0;3,0;;9,0;;;;5,0;3,0;3,0;8,0;;;1,0;26,0;;1,0;7,0;47,0;;40,0;;;;;20,0;3,0;;4,0;39,0;;2,0;1,0;;;10,0;;37,0;;63,0;;;3,0;2,0;133,0;20,0;5,0;;;23,0;;;;53,0;;3,0;1,0;41,0;1,0;;48,0;2,0;1,0;;3,0;8,0;2,0;;;1,0;5,0;2,0;10,0;37,0;6,0;2,0;;4,0;2,0;10,0;;;;;;42,0;2,0;;;;1,0;3,0;48,0;;;;3,0;4,0;;28,0;;;20,0;;;33,0;39,0;2,0;;4,0;;;;4,0;33,0;;;3,0;14,0;3,0;22,0;1,0;7,0;;1,0;12,0;9,0;;;;18,0;1,0;1,0;38,0;6,0;1,0;;;;33,0;316,0;;2,0;;;4,0;1,0;;12,0;2,0;;;;;2,0;;11,0;;3,0;72,0;;27,0;7,0;;;;2,0;2,0;5,0;44,0;;2,0;2,0;;143,0;;;1,0;;11,0;;2,0;18,0;7,0;2,0;;4,0;3,0;14,0;;4,0;3,0;3,0;;2,0;;;27,0;;39,0;1,0;2,0;;4,0;;6,0;2,0;18,0;;;;1,0;;9,0;;;;4,0;2,0;1,0;1,0;65,0;;;4,0;3,0;18,0;76,0;;10,0;110,0;2,0;;;1,0;2,0;13,0;5,0;1,0;;3,0;;41,0;3,0;;2,0;;;;7,0;15,0;;4,0;;1,0;;1,0;;;;1,0;2,0;1,0;1,0;;1,0;12,0;;;3,0;;;;1,0;;;;;1,0;;8,0;;15,0;;;7,0;;;;14,0;;5,0;;1,0;13,0;8,0;3,0;2,0;;4,0;;2,0;3,0;7,0;;;;;;;5,0;;;1,0;;;1,0;;;2,0;7,0;;;;;;3,0;;1,0;;3,0;16,0;;;;;;;;1,0;;;;;;;4,0;1,0;;;;;;2,0;1,0;;1,0;;6,0;1,0;1,0;;3,0;;;;1,0;1,0;1,0;;;;;;;1,0;;;4,0;;3,0;;11,0;;;;;;;;;1,0;;;;;;;1,0;;3,0;;;1,0;;;2,0;;;;;2,0;;7,0;;1,0;2,0;;1,0;;;4,0;;;21,0;;;2,0;;;;;1,0;;3,0;;;;;;;2,0;;;;;;3,0;;;;;;14,0;;;;1,0;;;;1,0;;;;2,0;1,0;;1,0;1,0;;;;1,0;;;11,0;;;1,0;4,0;;;;1,0;;;1,0;1,0;;3,0;;;;;;;;;;;;;;;;;;;2,0;;1,0;;;1,0;1,0;7,0;;;;;;;2,0;;;;;;;;1,0;;;;;2,0;;;;;1,0;;;;;14,0;1,0;;;;;;;;2,0;;;;;;;2,0;;;;;;;;3,0;;1,0;;;;1,0;;;;1,0;;;;;;1,0;;;;1,0;;;;;;1,0;;;;;;;;;;;2,0;;;;;;3,0;1,0;4,0;;;;;16,0;;2,0;;1,0;;;;4,0;;;;;;;;;1,0;4,0;;;;1,0;2,0;;6,0;;;;;;1,0;;;;;6,0;1,0;;;3,0;3,0;;;1,0;;;;27,0;;;;;1,0;;;;1,0;;;6,0;3,0;;;;4,0;;;1,0;;1,0;;2,0;;;6,0;;;;;;;1,0;;;;7,0;8,0;;;;1,0;;;;;1,0;;;;;;;2,0;;11,0;;;;;;1,0;2,0;;;;29,0;;;2,0;;;;;;;;;;;4,0;3,0;;;;;8,0;39,0;2,0;;;;;;;;2,0;;;;;;;;;6,0;1,0;5,0;;;1,0;;;;;;;;;;;;;1,0;1,0;;;;;;;;3,0;;;;;;1,0;;;3,0;1,0;;3,0;;;;;;;1,0;;;;4,0;;;;;;1,0;;;;;;;;3,0;;;;1,0;;;;2,0;;;1,0;;;;1,0;;;2,0;;1,0;;;;;5,0;;;;;;;;;;;;;;;10,0;;;;;;2,0;;4,0;;;;;;;;;;;;;1,0;;;;;;10,0;;;4,0;1,0;;;3,0;;;;;2,0;;6,0;;;;;;;;;;;;;;;;1,0;;;;;;;;;2,0;;;3,0;;;1,0;;;;;;;;;;;;;1,0;;;;;;;;
green;3,0;;;2,0;;3,0;34,0;3,0;;;3,0;4,0;;13,0;318,0;1,0;12,0;2,0;51,0;;7,0;;231,0;;;;;14,0;;;8,0;7,0;4,0;6,0;1,0;48,0;;;4,0;;8,0;7,0;;2,0;1,0;9,0;;56,0;;;;;;;;13,0;5,0;;;1,0;;;13,0;;133,0;;100,0;1,0;;;;29,0;135,0;1,0;;;;;;1,0;21,0;;;;15,0;;1,0;2,0;;12,0;2,0;;10,0;;;;197,0;6,0;31,0;2,0;10,0;9,0;;4,0;5,0;;;;;;;9,0;12,0;;;;;;;12,0;1,0;;47,0;;16,0;;2,0;;;;22,0;3,0;;5,0;;1,0;;8,0;;;;;;;2,0;4,0;;16,0;3,0;;1,0;;1,0;;;;;;6,0;;;5,0;;1,0;;;3,0;1,0;;;1,0;;;;;;;3,0;1,0;;;;;;;1,0;285,0;;2,0;;5,0;;;;;;;1,0;;1,0;;2,0;;;2,0;;;;;;;;;;;;4,0;;;;3,0;;;11,0;;;14,0;;;12,0;;;4,0;15,0;;;;;;1,0;;;;;;9,0;;6,0;;;;;;3,0;;;;;27,0;;;1,0;2,0;;;;;13,0;1,0;;;;;;;;2,0;;;;;;;;2,0;;;;8,0;;;12,0;;;;;5,0;;;;;;;;;;;;;12,0;;;;;;;2,0;;1,0;;;11,0;;;;;;;;;;;;;;;;;;;;;;;;;1,0;2,0;;;;;;;1,0;;;;3,0;;;;;;;10,0;;;;;;;2,0;11,0;6,0;;;;1,0;;1,0;;;1,0;;3,0;;;;;;;2,0;;;1,0;;;;;;;;16,0;;3,0;;1,0;;;;;9,0;;;;;3,0;;;;;;;;7,0;;;;;3,0;;;;;;;;;;;;12,0;;6,0;;;;;;1,0;;5,0;;;;;;;5,0;;10,0;;;;3,0;;;;;;;;;;;3,0;;;;;;;;;;2,0;;;;;;;1,0;;;8,0;;;;;;;;;;;;;;;18,0;;;;;;;;;;1,0;;;;;;;;;;;;;4,0;;;;;;;;;;;;;;;;;;;;;;;;;;;;;;;;;;;;;;;;;;;;;;2,0;;3,0;;;;;;;;;;;;;;;;2,0;;;;;;;;;;117,0;;;;;;;;;;;43,0;;;9,0;;;1,0;;;;;;;;;;;;;;;;;;;;4,0;;;;;;;;;1,0;;;;;;;;;6,0;;;;;;;14,0;;;;;;;;;;;;;1,0;;2,0;;;;;;;;;;;;1,0;;;;;;;;;;;;25,0;;;;2,0;;1,0;;;;;;;;;;2,0;;;2,0;;;;;;;;;;14,0;;;;;;;;;6,0;;;;;;;;;;;;1,0;;;;;;;;;;;;;;;;;;;;;;;;;;;;;;;;;;;;;11,0;;;;;;;;;;;;;8,0;;;;;;;;;;;;;;;1,0;;1,0;1,0;5,0;;;;;;;;;;;;;;;;;;6,0;1,0;;;;;;;;;;;;;;;;;;;;;;;;;;;;;;;;;;;;;;2,0;;;;;;;;;;;;;;;;;;;;;;;;;;;;;;;;;;;;;1,0;;;;;;;;;;;;;;;;;;;;;;;;;;;;;;;;;;;;2,0;7,0;;;6,0;;;;;;;;;;;11,0;;;;1,0;;;;;;;;;;3,0;;;;2,0;;;;;;;;
group;1,0;12,0;;7,0;38,0;49,0;82,0;117,0;4,0;40,0;;14,0;19,0;102,0;8,0;4,0;64,0;59,0;6,0;15,0;4,0;4,0;108,0;3,0;37,0;17,0;1,0;11,0;13,0;61,0;327,0;7,0;73,0;84,0;;148,0;48,0;25,0;20,0;8,0;86,0;235,0;17,0;78,0;45,0;170,0;72,0;205,0;;71,0;1,0;8,0;1,0;2,0;77,0;286,0;121,0;2,0;15,0;82,0;10,0;13,0;;1,0;890,0;7,0;765,0;4,0;1,0;17,0;144,0;2811,0;129,0;2,0;58,0;6,0;36,0;2,0;8,0;18,0;148,0;5,0;11,0;17,0;88,0;171,0;;1175,0;;74,0;94,0;4,0;6,0;;13,0;;874,0;217,0;407,0;156,0;199,0;28,0;26,0;17,0;42,0;43,0;1,0;2,0;5,0;16,0;;71,0;55,0;6,0;;11,0;111,0;59,0;12,0;198,0;27,0;4,0;157,0;13,0;14,0;21,0;261,0;28,0;2,0;6,0;101,0;10,0;;185,0;5,0;;101,0;11,0;261,0;2,0;3,0;13,0;;6,0;84,0;4,0;12,0;82,0;47,0;13,0;2,0;49,0;45,0;6,0;2,0;14,0;2,0;;31,0;42,0;9,0;31,0;20,0;36,0;42,0;3,0;40,0;16,0;9,0;9,0;30,0;;3,0;76,0;;9,0;2,0;8,0;15,0;;4,0;3,0;8,0;19,0;1,0;4,0;124,0;1,0;48,0;108,0;;5,0;14,0;27,0;4,0;6,0;20,0;5,0;;6,0;;7,0;1,0;;18,0;15,0;35,0;1,0;6,0;17,0;133,0;26,0;7,0;1,0;;5,0;78,0;2,0;9,0;30,0;28,0;34,0;12,0;17,0;6,0;1,0;111,0;;3,0;12,0;2,0;9,0;34,0;9,0;80,0;5,0;3,0;4,0;;161,0;12,0;17,0;;;9,0;666,0;21,0;24,0;326,0;;;;1,0;49,0;7,0;8,0;4,0;155,0;5,0;;5,0;16,0;27,0;29,0;1,0;2,0;;2,0;19,0;4,0;;8,0;32,0;3,0;;;5,0;30,0;14,0;;1,0;8,0;105,0;36,0;70,0;;5,0;34,0;63,0;2,0;;9,0;;;;;81,0;3,0;;;5,0;1,0;1,0;1,0;;;6,0;1,0;20,0;163,0;;;6,0;;2,0;;50,0;;7,0;6,0;18,0;391,0;;3,0;;1,0;;;377,0;1,0;1,0;;;2,0;41,0;6,0;;;;;16,0;6,0;5,0;;;2,0;46,0;34,0;;2,0;;;35,0;;18,0;;;12,0;41,0;5,0;;1,0;7,0;6,0;;4,0;4,0;2,0;1,0;;;;21,0;17,0;28,0;13,0;46,0;14,0;18,0;1,0;85,0;37,0;;9,0;;34,0;6,0;10,0;3,0;1,0;8,0;4,0;7,0;140,0;3,0;19,0;;57,0;7,0;8,0;1,0;20,0;;47,0;37,0;70,0;4,0;1,0;33,0;8,0;;58,0;2,0;34,0;49,0;9,0;;5,0;;4,0;9,0;2,0;1,0;15,0;6,0;35,0;18,0;14,0;6,0;7,0;10,0;;9,0;;9,0;;6,0;10,0;41,0;4,0;4,0;13,0;16,0;8,0;23,0;5,0;3,0;1,0;27,0;10,0;1,0;2,0;8,0;8,0;2,0;;7,0;8,0;1,0;25,0;18,0;582,0;;2,0;1,0;2,0;4,0;;3,0;;5,0;1,0;11,0;12,0;;7,0;3,0;18,0;8,0;2,0;;3,0;9,0;127,0;1,0;;81,0;6,0;6,0;4,0;4,0;;7,0;25,0;4,0;12,0;7,0;1,0;4,0;;2,0;22,0;;;6,0;13,0;6,0;;;20,0;1,0;3,0;7,0;2,0;10,0;9,0;1,0;78,0;;;6,0;1,0;8,0;1,0;13,0;8,0;;;;;14,0;;;1,0;11,0;;35,0;1,0;4,0;88,0;4,0;4,0;;14,0;;14,0;17,0;7,0;4,0;;2,0;;6,0;;6,0;22,0;;;;10,0;2,0;1,0;4,0;1,0;1,0;1,0;12,0;;;4,0;;4,0;11,0;7,0;14,0;7,0;2,0;3,0;;6,0;1,0;;9,0;7,0;;;1,0;;14,0;18,0;4,0;1,0;;19,0;1,0;;;10,0;5,0;;4,0;3,0;1,0;40,0;;24,0;2,0;;14,0;8,0;;3,0;3,0;3,0;1,0;;2,0;3,0;28,0;23,0;4,0;6,0;10,0;4,0;;6,0;;;2,0;1,0;;;;6,0;;;1,0;2,0;9,0;2,0;2,0;;10,0;5,0;2,0;;;;7,0;;4,0;;46,0;;15,0;4,0;5,0;;13,0;9,0;;3,0;17,0;13,0;3,0;1,0;3,0;32,0;;;22,0;;5,0;4,0;1,0;29,0;2,0;13,0;32,0;2,0;;6,0;;20,0;;2,0;5,0;43,0;;3,0;2,0;2,0;8,0;1,0;1,0;226,0;;1,0;;;;15,0;10,0;19,0;18,0;;;;;12,0;;;;10,0;3,0;8,0;;1,0;17,0;5,0;;1,0;2,0;2,0;;3,0;;3,0;2,0;1,0;;;;4,0;30,0;3,0;2,0;2,0;16,0;;7,0;1,0;4,0;;;4,0;;2,0;;6,0;20,0;;;;13,0;13,0;4,0;10,0;;;8,0;3,0;;;6,0;;2,0;;;;3,0;;26,0;;;;;;;;1,0;;6,0;;1,0;5,0;;6,0;;;;;8,0;;1,0;;9,0;;;15,0;;4,0;;75,0;18,0;5,0;1,0;4,0;36,0;6,0;2,0;16,0;;;4,0;4,0;24,0;;;6,0;;6,0;;2,0;11,0;16,0;22,0;3,0;7,0;1,0;4,0;9,0;1,0;26,0;83,0;5,0;13,0;;;;;;1,0;97,0;;;2,0;5,0;3,0;3,0;;1,0;4,0;;2,0;;7,0;;;;;6,0;1,0;;;;1,0;5,0;;5,0;;;59,0;;2,0;2,0;;3,0;6,0;;;;;;12,0;34,0;;;;3,0;;;1,0;2,0;;;1,0;;8,0;;;;;8,0;;1,0;39,0;1,0;;;1,0;;1,0;;;;;;5,0;;3,0;;3,0;;;3,0;4,0;1,0;7,0;6,0;5,0;;2,0;12,0;2,0;;;;4,0;;;2,0;4,0;;19,0;1,0;;234,0;;;28,0;;;12,0;4,0;1,0;;6,0;;1,0;;;;;;;15,0;;;2,0;5,0;;;1,0;;;7,0;1,0;;5,0;;2,0;11,0;1,0;;;4,0;;4,0;6,0;20,0;;1,0;15,0;;;;;;
hardware;4,0;;;;;15,0;;1,0;;;;;;30,0;;;13,0;;1,0;;9,0;;;1,0;7,0;;;1,0;5,0;1,0;60,0;5,0;3,0;3,0;;40,0;;;1,0;1,0;32,0;109,0;;1,0;6,0;1,0;2,0;;;;;;1,0;;1,0;;2,0;;;22,0;;;1,0;;59,0;19,0;23,0;;1,0;;;8,0;;;;;;1,0;1,0;12,0;20,0;;1,0;3,0;56,0;;;8,0;;;5,0;11,0;;;;;;;9,0;1,0;32,0;;;1,0;13,0;77,0;;15,0;;;;3,0;;;1,0;;;1,0;;43,0;1,0;;7,0;;;24,0;28,0;;;;1,0;;;2,0;;;3,0;;;;;;;;;;;;9,0;9,0;;3,0;;1,0;4,0;;;;1,0;;;2,0;;;;;14,0;;1,0;8,0;;;;;;;;;6,0;6,0;;;;;;;2,0;;2,0;;;;;;;;;;;;;5,0;;;1,0;4,0;1,0;;;7,0;;;;;;;;;;;;;;;;1,0;7,0;;;1,0;;;1,0;1,0;;;;;1,0;;;;;;;9,0;;;1,0;;;;;3,0;;1,0;;1,0;;;;2,0;;;1,0;;;;;;;;;1,0;;;2,0;;;1,0;3,0;;;;;;;;6,0;;;10,0;;;;;;;;1,0;;1,0;;;;;;;;23,0;;;;;;;3,0;;;;20,0;5,0;;;;1,0;;;4,0;;;;;;2,0;;;;;;1,0;;;;;;;15,0;;;;;;;2,0;;;;9,0;5,0;;;3,0;;;1,0;;;;;;;1,0;1,0;;;;;1,0;;9,0;;;;2,0;9,0;5,0;;1,0;2,0;;27,0;;;;;;4,0;3,0;;2,0;7,0;1,0;3,0;;10,0;3,0;;12,0;;;1,0;;1,0;4,0;6,0;;;;;;;;;;18,0;;;1,0;;;;;;;;5,0;;2,0;;;3,0;;1,0;;;;;5,0;;;;;;;;1,0;3,0;;3,0;6,0;;;;;2,0;;;1,0;;;;22,0;14,0;;;1,0;;24,0;9,0;;;;;;;12,0;;2,0;;;1,0;2,0;;;;2,0;;8,0;;;3,0;;;;;;;;;;;10,0;;;2,0;;;;;;;;;;;8,0;;;1,0;;;;;;2,0;;;;1,0;1,0;;;;;;;;2,0;;;;2,0;1,0;3,0;2,0;;;;;;3,0;;;3,0;2,0;;;;;;;;;;;;;;;;;;;1,0;;;;1,0;1,0;;;2,0;;;;1,0;1,0;27,0;1,0;;3,0;;3,0;;1,0;;;;;;4,0;;;;;;;4,0;5,0;;;;;;;;;;;;;2,0;1,0;;;;1,0;;;8,0;;1,0;;;;;;;;;2,0;;;;;;;;;2,0;2,0;;3,0;1,0;;;;;2,0;2,0;;;4,0;3,0;1,0;;;1,0;;1,0;;;1,0;;6,0;;;;;;;2,0;;1,0;;;;;;;;;;;;;;;;;;;;;;;;4,0;;;;;1,0;;;;;;;1,0;;;;2,0;;;;;;;;;2,0;;;;;;;;;;;;;;;1,0;;;;;;1,0;;;;;;;;1,0;;;;;;;;;;;;;;;;;;;;14,0;;;;;;;;;;;;;;;;;;;;;;;;;;;;;2,0;;;;;;;;;;;1,0;;;;2,0;;;;;;;;;;;;1,0;;;;;;;;1,0;;;;;;;;;;;;;1,0;;;;;1,0;;;3,0;;;;;2,0;1,0;;;;;;1,0;2,0;;;;1,0;;2,0;;;;;;;;;;;;;;;6,0;;;;;1,0;;;;;;;;;;;;;;2,0;;;;;;;;;;;;;;;;;;;;;;;;;;;;;;;;;;;;6,0;;;;;;;;;;;;;;;;;;;;;;;;;;;;;;;;;
image;47,0;69,0;37,0;795,0;517,0;2653,0;1768,0;873,0;72,0;145,0;22,0;408,0;87,0;4961,0;115,0;390,0;20392,0;64,0;210,0;433,0;598,0;127,0;2632,0;144,0;263,0;228,0;60,0;1156,0;555,0;322,0;5129,0;622,0;801,0;483,0;18,0;13526,0;435,0;235,0;2141,0;33,0;4316,0;8050,0;54,0;2642,0;6600,0;774,0;359,0;1253,0;44,0;172,0;568,0;23,0;112,0;272,0;1378,0;581,0;1838,0;7,0;115,0;4800,0;37,0;133,0;890,0;59,0;;127,0;5212,0;204,0;152,0;43,0;263,0;5111,0;2436,0;20,0;172,0;104,0;72,0;274,0;73,0;930,0;6710,0;52,0;1251,0;856,0;2479,0;146,0;53,0;3234,0;160,0;424,0;983,0;104,0;219,0;172,0;776,0;188,0;5148,0;1205,0;6940,0;2698,0;2807,0;943,0;39,0;1911,0;4915,0;3862,0;126,0;428,0;231,0;82,0;49,0;2105,0;2793,0;153,0;17,0;533,0;1593,0;930,0;2197,0;15276,0;1104,0;58,0;3682,0;657,0;200,0;2058,0;5145,0;90,0;359,0;22,0;2424,0;96,0;17,0;3762,0;62,0;17,0;2325,0;590,0;699,0;2,0;5,0;485,0;108,0;;343,0;678,0;2085,0;492,0;1585,0;151,0;26,0;320,0;442,0;86,0;529,0;30,0;11,0;23,0;24,0;17,0;67,0;355,0;442,0;712,0;63,0;123,0;668,0;194,0;50,0;561,0;337,0;92,0;319,0;934,0;3,0;951,0;216,0;50,0;168,0;100,0;54,0;121,0;172,0;905,0;3,0;73,0;850,0;39,0;4365,0;377,0;68,0;164,0;43,0;48,0;168,0;76,0;651,0;248,0;57,0;37,0;3,0;195,0;138,0;29,0;443,0;450,0;276,0;33,0;266,0;714,0;321,0;403,0;213,0;10,0;5,0;97,0;2763,0;208,0;275,0;337,0;953,0;319,0;220,0;96,0;73,0;;3395,0;14,0;69,0;942,0;7,0;82,0;942,0;396,0;175,0;241,0;238,0;88,0;12,0;730,0;5,0;27,0;10,0;3,0;25,0;1823,0;204,0;272,0;1979,0;26,0;7,0;37,0;80,0;336,0;549,0;154,0;282,0;1690,0;156,0;4,0;232,0;1152,0;165,0;1460,0;25,0;24,0;40,0;150,0;174,0;425,0;10,0;82,0;212,0;198,0;18,0;9,0;136,0;625,0;36,0;111,0;17,0;200,0;665,0;378,0;204,0;;223,0;130,0;732,0;27,0;124,0;170,0;8,0;31,0;173,0;37,0;1021,0;208,0;4,0;7,0;14,0;22,0;52,0;95,0;2,0;6,0;47,0;161,0;379,0;1923,0;5,0;6,0;102,0;4,0;506,0;;495,0;17,0;103,0;128,0;558,0;5686,0;118,0;836,0;58,0;104,0;1272,0;4,0;351,0;231,0;7,0;4,0;7,0;34,0;1184,0;52,0;22,0;1,0;44,0;1,0;300,0;281,0;63,0;5,0;36,0;44,0;277,0;459,0;27,0;11,0;134,0;;504,0;21,0;397,0;31,0;78,0;114,0;3064,0;166,0;229,0;3,0;16,0;65,0;37,0;267,0;777,0;98,0;43,0;75,0;;2,0;1040,0;681,0;586,0;154,0;310,0;266,0;912,0;241,0;1478,0;1031,0;49,0;116,0;178,0;2106,0;241,0;689,0;225,0;223,0;65,0;328,0;712,0;888,0;168,0;682,0;29,0;1567,0;451,0;186,0;25,0;1385,0;182,0;437,0;191,0;1332,0;371,0;351,0;709,0;84,0;6,0;874,0;105,0;372,0;1127,0;704,0;38,0;37,0;26,0;86,0;81,0;393,0;51,0;422,0;149,0;4142,0;204,0;772,0;247,0;41,0;942,0;40,0;699,0;144,0;116,0;13,0;680,0;1468,0;221,0;54,0;103,0;261,0;431,0;153,0;361,0;382,0;80,0;45,0;1741,0;41,0;345,0;68,0;129,0;29,0;32,0;15,0;86,0;908,0;75,0;139,0;815,0;82,0;247,0;593,0;112,0;634,0;63,0;49,0;39,0;90,0;158,0;84,0;688,0;393,0;70,0;14,0;89,0;52,0;111,0;110,0;65,0;270,0;36,0;787,0;363,0;716,0;1606,0;171,0;210,0;726,0;56,0;63,0;48,0;526,0;69,0;43,0;622,0;24,0;90,0;388,0;447,0;814,0;62,0;339,0;288,0;270,0;224,0;96,0;18,0;186,0;268,0;177,0;32,0;44,0;42,0;299,0;9,0;235,0;26,0;31,0;142,0;32,0;62,0;114,0;117,0;33,0;25,0;3,0;11,0;2,0;6,0;114,0;3,0;254,0;441,0;46,0;183,0;131,0;104,0;751,0;291,0;28,0;171,0;198,0;140,0;376,0;5,0;142,0;38,0;1241,0;38,0;21,0;294,0;324,0;296,0;216,0;125,0;448,0;4,0;35,0;102,0;228,0;202,0;219,0;274,0;112,0;581,0;29,0;160,0;454,0;7,0;33,0;58,0;38,0;461,0;280,0;17,0;483,0;1,0;14,0;88,0;17,0;154,0;32,0;65,0;68,0;5,0;61,0;329,0;1223,0;45,0;120,0;54,0;143,0;27,0;256,0;76,0;110,0;542,0;11,0;284,0;74,0;63,0;2399,0;138,0;825,0;40,0;202,0;230,0;28,0;220,0;65,0;248,0;99,0;83,0;3,0;185,0;96,0;71,0;382,0;108,0;42,0;442,0;663,0;107,0;230,0;43,0;8,0;32,0;511,0;5,0;32,0;24,0;303,0;67,0;21,0;52,0;10,0;64,0;178,0;28,0;126,0;47,0;31,0;66,0;282,0;108,0;18,0;17,0;85,0;53,0;134,0;165,0;103,0;198,0;140,0;368,0;72,0;464,0;445,0;42,0;161,0;133,0;86,0;231,0;9,0;107,0;63,0;8,0;27,0;771,0;62,0;63,0;46,0;950,0;438,0;30,0;77,0;1977,0;135,0;4,0;23,0;42,0;162,0;68,0;177,0;152,0;107,0;45,0;23,0;42,0;53,0;37,0;50,0;484,0;157,0;129,0;135,0;11,0;8,0;4,0;52,0;261,0;159,0;228,0;9,0;3,0;94,0;29,0;158,0;84,0;23,0;37,0;173,0;25,0;243,0;19,0;59,0;92,0;121,0;60,0;36,0;19,0;35,0;89,0;86,0;12,0;47,0;129,0;469,0;45,0;40,0;18,0;121,0;849,0;59,0;34,0;;382,0;14,0;317,0;4,0;39,0;8,0;4,0;58,0;132,0;288,0;19,0;39,0;10,0;20,0;29,0;15,0;50,0;139,0;109,0;53,0;49,0;51,0;11,0;25,0;36,0;9,0;19,0;14,0;84,0;33,0;144,0;6,0;132,0;14,0;344,0;15,0;;4,0;18,0;2,0;37,0;1,0;34,0;53,0;2,0;78,0;149,0;118,0;13,0;117,0;50,0;102,0;22,0;24,0;233,0;9,0;12,0;1,0;216,0;42,0;50,0;18,0;9,0;5,0;94,0;805,0;98,0;71,0;3,0;27,0;238,0;115,0;14,0;308,0;33,0;16,0;38,0;270,0;161,0;81,0;69,0;77,0;5,0;257,0;78,0;82,0;197,0;647,0;26,0;329,0;68,0;10,0;524,0;51,0;151,0;15,0;133,0;88,0;366,0;196,0;6,0;47,0;95,0;86,0;38,0;251,0;86,0;233,0;68,0;37,0;128,0;67,0;85,0;279,0;36,0;146,0;238,0;33,0;552,0;99,0;46,0;76,0;158,0;252,0;77,0;147,0;100,0;22,0;77,0;114,0;100,0;53,0;61,0;115,0;161,0;224,0;327,0;87,0;110,0;159,0;251,0;34,0;8,0;57,0;48,0;160,0;20,0;75,0;3,0;28,0;345,0;129,0;201,0;79,0;229,0;114,0;29,0;39,0;12,0;95,0;76,0;51,0;43,0;88,0;61,0;154,0;154,0;26,0;118,0;237,0;30,0;17,0;7,0;63,0;53,0;45,0;34,0;119,0;19,0;53,0;19,0;107,0;26,0;4,0;215,0;4,0;16,0;79,0;51,0;163,0;38,0;129,0;33,0;2,0;6,0;104,0;38,0;144,0;1,0;3,0;5,0;35,0;10,0;99,0;481,0;13,0;11,0;16,0;16,0;61,0;2,0;17,0;159,0;9,0;31,0;109,0;89,0;135,0;29,0;94,0;70,0;309,0;;34,0;53,0;46,0;80,0;12,0;17,0;84,0;31,0;44,0;79,0;44,0;27,0;70,0;106,0;41,0;96,0;84,0;17,0;7,0;13,0;706,0;46,0;71,0;146,0;106,0;20,0;41,0;430,0;35,0;30,0;81,0;48,0;60,0;269,0;4,0;59,0;20,0;1,0;
implement;1,0;2,0;5,0;5,0;;60,0;49,0;5,0;;;;;1,0;13,0;;1,0;17,0;;1,0;;13,0;;22,0;1,0;3,0;3,0;;7,0;85,0;;70,0;24,0;1,0;5,0;;35,0;8,0;1,0;7,0;;14,0;122,0;;12,0;10,0;1,0;;15,0;;1,0;3,0;;1,0;2,0;3,0;2,0;2,0;;4,0;17,0;;;7,0;19,0;127,0;;30,0;2,0;1,0;;3,0;32,0;21,0;2,0;;;;3,0;2,0;6,0;230,0;;14,0;7,0;72,0;1,0;;12,0;;2,0;4,0;8,0;;;2,0;3,0;4,0;1,0;26,0;9,0;11,0;;1,0;6,0;48,0;107,0;;58,0;1,0;;1,0;1,0;9,0;;;;1,0;;5,0;69,0;3,0;7,0;7,0;2,0;;2,0;76,0;;3,0;1,0;9,0;;;13,0;1,0;;9,0;15,0;2,0;;;2,0;1,0;;;11,0;1,0;;4,0;1,0;;2,0;2,0;;1,0;;;;;;;4,0;2,0;3,0;;2,0;4,0;6,0;;3,0;6,0;;3,0;2,0;;2,0;1,0;1,0;;2,0;;1,0;;;4,0;1,0;23,0;;3,0;;;;;;;1,0;3,0;;;;;3,0;;1,0;2,0;;;1,0;2,0;7,0;;5,0;;;;;3,0;;;;2,0;;;;;1,0;8,0;;1,0;;;;1,0;2,0;;;;;;1,0;;;2,0;;;4,0;2,0;1,0;2,0;2,0;;1,0;6,0;1,0;6,0;;1,0;7,0;;;4,0;2,0;1,0;9,0;;;;;1,0;2,0;;;3,0;5,0;1,0;;1,0;5,0;;2,0;;4,0;;2,0;;;;;7,0;;1,0;6,0;;;;1,0;4,0;2,0;;1,0;;;3,0;;;;;1,0;1,0;6,0;;;;;;;6,0;3,0;1,0;;16,0;5,0;;;;;;;3,0;;;;;;5,0;;;;5,0;;;;;;;5,0;;4,0;;;;;;1,0;4,0;;;;17,0;2,0;;;;2,0;;7,0;3,0;;;3,0;;;5,0;;3,0;;;3,0;1,0;;24,0;;;6,0;3,0;12,0;;1,0;;5,0;;30,0;1,0;2,0;;26,0;;7,0;;;6,0;5,0;8,0;6,0;3,0;1,0;;2,0;2,0;4,0;2,0;;;7,0;22,0;2,0;;;;;;;;;1,0;13,0;3,0;5,0;;;2,0;11,0;3,0;;;;1,0;1,0;;;;3,0;;2,0;1,0;;;1,0;12,0;;3,0;6,0;8,0;;3,0;;2,0;8,0;;;31,0;1,0;;8,0;;;;8,0;3,0;;;;57,0;5,0;;1,0;;;9,0;;;;4,0;1,0;2,0;1,0;6,0;7,0;5,0;2,0;;;;1,0;;;;1,0;7,0;;;3,0;4,0;;;;2,0;;;;3,0;1,0;;;;3,0;;;;;7,0;3,0;;;;;2,0;2,0;;;2,0;1,0;;;;;;;;1,0;;;3,0;2,0;;4,0;;;3,0;1,0;;;3,0;5,0;4,0;9,0;2,0;2,0;;;4,0;4,0;2,0;;;1,0;3,0;;9,0;2,0;;;;;;3,0;1,0;5,0;;6,0;4,0;;1,0;15,0;;;;9,0;11,0;5,0;2,0;;3,0;;;1,0;9,0;;1,0;;;;;9,0;;1,0;;4,0;1,0;1,0;1,0;2,0;;;;;1,0;1,0;1,0;7,0;1,0;1,0;2,0;3,0;;;;;;;3,0;;;7,0;2,0;2,0;;;;6,0;;;;;;1,0;;1,0;10,0;;;;;;;;;;2,0;;1,0;;2,0;;4,0;6,0;;2,0;1,0;;13,0;1,0;;;1,0;;4,0;;4,0;1,0;1,0;1,0;;14,0;;2,0;1,0;2,0;;;;;1,0;;1,0;5,0;;4,0;;;;1,0;1,0;;3,0;;;;;4,0;;2,0;;1,0;;6,0;;;;4,0;1,0;;1,0;2,0;1,0;2,0;;1,0;1,0;1,0;2,0;;;2,0;2,0;;;;;;2,0;;;;;;;1,0;4,0;1,0;;;;;;;;;;;;;;;;;;;;;;;2,0;;;;;;;;;;2,0;;;;;;;;;;6,0;;;;1,0;;;;;;;4,0;;;;;;;1,0;;;;;2,0;;;;;1,0;4,0;;;;;;;;;;;9,0;;;;2,0;3,0;;;;;2,0;;;;;;6,0;;;3,0;;;;;3,0;;1,0;7,0;1,0;;;2,0;;1,0;;;;1,0;;;1,0;1,0;1,0;;;1,0;;;3,0;1,0;;;;;;;2,0;;;;1,0;;;;;;;;;;;;1,0;;1,0;;;;;5,0;;;;;;;;1,0;;;2,0;;;1,0;2,0;;2,0;;1,0;;;2,0;;;;;;;;;1,0;;;;;;1,0;;;;2,0;;2,0;;;1,0;;;;;;6,0;;;1,0;;;;;;;;;;;;;;;;;1,0;1,0;;2,0;;;;;1,0;;;;;;;;
include;11,0;68,0;3,0;191,0;79,0;1093,0;857,0;1078,0;13,0;50,0;7,0;38,0;263,0;896,0;41,0;51,0;982,0;89,0;162,0;130,0;130,0;12,0;391,0;44,0;187,0;18,0;25,0;449,0;170,0;146,0;1145,0;208,0;56,0;113,0;29,0;1265,0;253,0;60,0;253,0;43,0;741,0;3095,0;52,0;361,0;850,0;429,0;33,0;1179,0;15,0;47,0;114,0;2,0;240,0;101,0;275,0;166,0;447,0;14,0;62,0;418,0;63,0;100,0;765,0;23,0;5212,0;30,0;;30,0;50,0;50,0;120,0;3774,0;1109,0;44,0;38,0;5,0;206,0;122,0;86,0;320,0;1919,0;29,0;277,0;178,0;1946,0;230,0;1,0;1049,0;52,0;128,0;328,0;33,0;38,0;63,0;107,0;6,0;2072,0;220,0;3002,0;484,0;798,0;172,0;43,0;125,0;452,0;655,0;51,0;237,0;79,0;2,0;11,0;294,0;923,0;11,0;27,0;52,0;100,0;189,0;248,0;1999,0;83,0;15,0;918,0;69,0;94,0;184,0;2371,0;15,0;55,0;18,0;334,0;20,0;13,0;2078,0;7,0;15,0;472,0;102,0;215,0;23,0;12,0;70,0;12,0;3,0;255,0;106,0;482,0;384,0;231,0;173,0;91,0;158,0;767,0;144,0;26,0;65,0;31,0;28,0;25,0;22,0;147,0;353,0;75,0;72,0;191,0;15,0;410,0;259,0;13,0;278,0;183,0;10,0;62,0;347,0;44,0;207,0;41,0;130,0;34,0;37,0;60,0;7,0;43,0;372,0;118,0;158,0;641,0;40,0;617,0;302,0;16,0;24,0;68,0;230,0;264,0;204,0;1202,0;35,0;179,0;31,0;57,0;434,0;23,0;38,0;152,0;240,0;1025,0;118,0;194,0;970,0;61,0;146,0;41,0;33,0;32,0;215,0;275,0;81,0;38,0;123,0;404,0;42,0;63,0;321,0;349,0;22,0;2020,0;4,0;21,0;42,0;48,0;63,0;219,0;49,0;175,0;23,0;34,0;59,0;12,0;77,0;34,0;184,0;83,0;17,0;39,0;333,0;60,0;223,0;612,0;44,0;64,0;52,0;104,0;555,0;552,0;71,0;482,0;1250,0;54,0;17,0;100,0;135,0;137,0;556,0;148,0;7,0;32,0;67,0;49,0;131,0;25,0;146,0;305,0;72,0;65,0;15,0;43,0;243,0;48,0;87,0;150,0;70,0;277,0;309,0;19,0;2,0;101,0;92,0;792,0;47,0;427,0;165,0;30,0;87,0;43,0;57,0;184,0;110,0;105,0;76,0;70,0;60,0;84,0;36,0;24,0;91,0;66,0;133,0;64,0;901,0;37,0;14,0;42,0;47,0;82,0;25,0;119,0;100,0;16,0;280,0;200,0;972,0;75,0;42,0;105,0;31,0;85,0;25,0;224,0;107,0;129,0;22,0;47,0;114,0;140,0;26,0;18,0;28,0;17,0;10,0;109,0;140,0;18,0;110,0;43,0;57,0;187,0;232,0;12,0;151,0;18,0;25,0;39,0;23,0;159,0;48,0;41,0;168,0;786,0;78,0;40,0;13,0;42,0;78,0;19,0;88,0;62,0;28,0;17,0;33,0;52,0;16,0;141,0;87,0;81,0;57,0;27,0;89,0;99,0;25,0;768,0;147,0;13,0;124,0;11,0;447,0;81,0;61,0;47,0;148,0;15,0;152,0;78,0;263,0;22,0;185,0;26,0;268,0;92,0;27,0;28,0;255,0;71,0;141,0;41,0;262,0;66,0;158,0;203,0;161,0;37,0;284,0;8,0;146,0;254,0;141,0;10,0;33,0;26,0;18,0;8,0;46,0;10,0;78,0;63,0;728,0;104,0;68,0;6,0;31,0;144,0;13,0;238,0;11,0;52,0;36,0;217,0;183,0;194,0;12,0;47,0;243,0;92,0;102,0;9,0;71,0;26,0;21,0;469,0;28,0;21,0;62,0;63,0;31,0;72,0;59,0;22,0;195,0;26,0;42,0;189,0;34,0;79,0;28,0;8,0;36,0;35,0;16,0;29,0;20,0;105,0;47,0;462,0;369,0;57,0;53,0;48,0;48,0;58,0;79,0;489,0;39,0;113,0;355,0;55,0;97,0;210,0;69,0;88,0;92,0;19,0;21,0;42,0;112,0;69,0;35,0;107,0;36,0;20,0;29,0;24,0;118,0;32,0;86,0;34,0;103,0;89,0;70,0;7,0;27,0;99,0;12,0;29,0;9,0;21,0;144,0;39,0;49,0;31,0;99,0;145,0;142,0;10,0;46,0;59,0;19,0;36,0;35,0;25,0;7,0;48,0;111,0;36,0;142,0;79,0;17,0;12,0;55,0;18,0;95,0;39,0;2,0;70,0;282,0;30,0;43,0;3,0;39,0;66,0;53,0;4,0;46,0;49,0;63,0;132,0;71,0;9,0;41,0;27,0;20,0;14,0;58,0;67,0;52,0;35,0;18,0;120,0;40,0;51,0;37,0;22,0;36,0;27,0;50,0;45,0;114,0;15,0;33,0;26,0;30,0;19,0;16,0;61,0;86,0;23,0;93,0;133,0;32,0;78,0;95,0;22,0;37,0;15,0;40,0;40,0;9,0;35,0;6,0;77,0;15,0;22,0;48,0;6,0;297,0;61,0;86,0;30,0;40,0;24,0;51,0;56,0;19,0;43,0;58,0;39,0;31,0;30,0;55,0;58,0;254,0;10,0;2,0;50,0;123,0;5,0;8,0;3,0;1,0;17,0;39,0;53,0;32,0;33,0;138,0;63,0;31,0;19,0;8,0;20,0;21,0;35,0;32,0;59,0;53,0;13,0;46,0;20,0;23,0;11,0;3,0;81,0;2,0;39,0;21,0;10,0;44,0;181,0;1,0;97,0;30,0;37,0;57,0;59,0;46,0;122,0;32,0;23,0;17,0;29,0;14,0;282,0;43,0;41,0;56,0;12,0;98,0;25,0;41,0;288,0;5,0;19,0;32,0;12,0;98,0;25,0;55,0;32,0;75,0;36,0;16,0;3,0;168,0;31,0;9,0;18,0;433,0;7,0;42,0;26,0;17,0;47,0;22,0;33,0;183,0;448,0;55,0;46,0;24,0;15,0;63,0;14,0;10,0;50,0;10,0;8,0;134,0;16,0;47,0;138,0;37,0;84,0;15,0;42,0;44,0;8,0;18,0;28,0;65,0;41,0;36,0;18,0;7,0;22,0;12,0;68,0;13,0;32,0;60,0;61,0;18,0;60,0;30,0;18,0;144,0;7,0;47,0;52,0;71,0;22,0;35,0;36,0;94,0;55,0;11,0;8,0;43,0;32,0;44,0;14,0;19,0;43,0;40,0;20,0;32,0;21,0;22,0;25,0;7,0;6,0;14,0;49,0;15,0;88,0;6,0;5,0;13,0;23,0;31,0;81,0;25,0;6,0;1,0;16,0;19,0;140,0;6,0;23,0;14,0;18,0;18,0;134,0;33,0;16,0;36,0;148,0;39,0;243,0;41,0;32,0;37,0;15,0;8,0;98,0;146,0;58,0;25,0;15,0;19,0;89,0;50,0;36,0;29,0;17,0;39,0;28,0;41,0;340,0;39,0;18,0;11,0;6,0;27,0;37,0;6,0;124,0;76,0;5,0;72,0;18,0;14,0;31,0;305,0;46,0;23,0;28,0;11,0;34,0;22,0;2,0;21,0;40,0;24,0;22,0;21,0;6,0;16,0;8,0;24,0;17,0;17,0;21,0;55,0;16,0;10,0;7,0;52,0;43,0;13,0;1,0;88,0;25,0;49,0;17,0;23,0;46,0;17,0;22,0;16,0;46,0;25,0;14,0;34,0;17,0;59,0;55,0;14,0;17,0;9,0;37,0;19,0;51,0;11,0;11,0;27,0;128,0;32,0;13,0;12,0;18,0;6,0;8,0;35,0;14,0;8,0;20,0;26,0;10,0;32,0;9,0;15,0;20,0;57,0;41,0;7,0;34,0;22,0;35,0;21,0;41,0;7,0;21,0;42,0;27,0;23,0;20,0;3,0;26,0;24,0;36,0;32,0;15,0;15,0;23,0;;14,0;10,0;13,0;35,0;25,0;4,0;7,0;10,0;49,0;63,0;10,0;32,0;26,0;30,0;4,0;13,0;44,0;24,0;51,0;19,0;;25,0;37,0;40,0;13,0;6,0;28,0;41,0;;30,0;3,0;17,0;26,0;9,0;13,0;21,0;11,0;25,0;13,0;35,0;20,0;;16,0;11,0;36,0;38,0;41,0;22,0;19,0;64,0;19,0;4,0;28,0;36,0;4,0;9,0;18,0;22,0;4,0;16,0;19,0;21,0;11,0;7,0;4,0;3,0;1,0;199,0;1,0;9,0;10,0;8,0;2,0;1,0;;
increase;3,0;3,0;1,0;6,0;63,0;24,0;13,0;8,0;;;;;4,0;31,0;2,0;35,0;45,0;;;3,0;;;16,0;;3,0;1,0;2,0;3,0;7,0;4,0;44,0;8,0;;3,0;;20,0;10,0;4,0;114,0;1,0;33,0;41,0;19,0;2,0;31,0;4,0;44,0;14,0;3,0;4,0;13,0;;8,0;;52,0;10,0;7,0;3,0;11,0;12,0;;1,0;4,0;;204,0;2,0;30,0;;3,0;2,0;36,0;56,0;32,0;;12,0;2,0;8,0;10,0;6,0;;82,0;;5,0;1,0;29,0;4,0;;28,0;1,0;7,0;11,0;;1,0;2,0;5,0;;55,0;9,0;14,0;16,0;26,0;21,0;2,0;4,0;15,0;13,0;;2,0;3,0;;;9,0;35,0;;;1,0;60,0;10,0;8,0;29,0;4,0;1,0;29,0;16,0;;1,0;35,0;;;12,0;31,0;8,0;;33,0;21,0;;27,0;16,0;9,0;2,0;;5,0;;8,0;1,0;10,0;17,0;3,0;9,0;4,0;1,0;;5,0;11,0;8,0;;;;;;;1,0;1,0;1,0;;;5,0;;92,0;2,0;;2,0;;58,0;;5,0;1,0;2,0;1,0;;2,0;;;3,0;;;9,0;14,0;35,0;9,0;3,0;;3,0;;;10,0;6,0;;30,0;;;3,0;4,0;5,0;16,0;6,0;10,0;;2,0;2,0;13,0;17,0;3,0;;;3,0;26,0;3,0;2,0;3,0;16,0;7,0;;2,0;5,0;;49,0;4,0;2,0;1,0;;1,0;23,0;27,0;4,0;;1,0;1,0;;1,0;;16,0;;;;4,0;;4,0;29,0;;;1,0;;4,0;8,0;8,0;3,0;27,0;;;4,0;1,0;1,0;14,0;;1,0;;2,0;17,0;1,0;;8,0;7,0;1,0;5,0;;3,0;20,0;;;;;13,0;;;;;6,0;3,0;;3,0;13,0;;;9,0;1,0;79,0;6,0;8,0;1,0;2,0;;;6,0;;2,0;2,0;;4,0;14,0;5,0;1,0;1,0;;5,0;;1,0;;1,0;5,0;4,0;23,0;;6,0;;1,0;;;19,0;;1,0;;;2,0;3,0;;;;1,0;;;5,0;1,0;1,0;;2,0;;1,0;;3,0;;;1,0;;10,0;;1,0;2,0;26,0;;;2,0;;;;5,0;2,0;;;1,0;;1,0;3,0;13,0;16,0;;;2,0;4,0;1,0;26,0;;1,0;3,0;1,0;10,0;5,0;15,0;7,0;;2,0;1,0;;19,0;1,0;18,0;;2,0;5,0;1,0;;34,0;6,0;59,0;1,0;5,0;2,0;;7,0;1,0;;3,0;;5,0;10,0;2,0;;;;;1,0;37,0;1,0;1,0;5,0;3,0;1,0;9,0;3,0;1,0;10,0;;28,0;;45,0;;2,0;2,0;;;33,0;1,0;23,0;10,0;;8,0;;9,0;4,0;3,0;5,0;23,0;6,0;;;;;;;1,0;3,0;;1,0;;;;;;;;4,0;4,0;;10,0;26,0;3,0;6,0;;;1,0;3,0;;;;;2,0;10,0;1,0;1,0;;;;3,0;11,0;;2,0;;;;1,0;;;;;2,0;2,0;;;;;;4,0;1,0;;1,0;1,0;1,0;4,0;;;1,0;;;17,0;;;;;8,0;;;2,0;1,0;2,0;10,0;;4,0;;;;;3,0;1,0;8,0;;15,0;;;2,0;;;;1,0;2,0;;;;;;;1,0;3,0;1,0;5,0;;;;3,0;;;;;1,0;;6,0;1,0;3,0;;1,0;2,0;;;7,0;;1,0;2,0;;;2,0;9,0;;;1,0;;;;;1,0;1,0;;;;;9,0;;;;2,0;23,0;3,0;2,0;;;;;;;;;1,0;;;32,0;2,0;;;;;;;;;;;;1,0;;;;6,0;;;;;2,0;;;;;;2,0;;1,0;;;1,0;;1,0;15,0;5,0;;;;;5,0;2,0;;;;;4,0;;;3,0;;2,0;;;17,0;1,0;16,0;;;2,0;;1,0;6,0;3,0;;;;;5,0;;4,0;11,0;3,0;1,0;2,0;;5,0;;;25,0;5,0;;2,0;;;6,0;2,0;;2,0;;;5,0;;;;9,0;;1,0;1,0;;;;;;9,0;20,0;;;3,0;2,0;24,0;;;;2,0;;1,0;;1,0;2,0;;6,0;;1,0;1,0;1,0;;1,0;;1,0;;;;3,0;;1,0;;4,0;;;;;2,0;;;;6,0;;1,0;;;;;;2,0;;;;;2,0;4,0;;;32,0;;;2,0;;;1,0;;;4,0;8,0;;;1,0;;;30,0;1,0;4,0;6,0;3,0;;;2,0;2,0;;;;7,0;3,0;;;5,0;;5,0;;;;1,0;;1,0;;;;1,0;;;2,0;7,0;11,0;1,0;;;1,0;;;12,0;1,0;1,0;;1,0;;4,0;;;1,0;;;;;2,0;;;1,0;2,0;;;;;;1,0;;4,0;4,0;1,0;;1,0;1,0;1,0;;3,0;;5,0;;;;;;;;;1,0;2,0;;;1,0;;;;;1,0;;;;;;;1,0;;;22,0;4,0;;;2,0;;;;11,0;;;;;;;4,0;;;;;4,0;2,0;8,0;;2,0;1,0;1,0;;;;3,0;;;;2,0;7,0;;;;;;1,0;;;2,0;;3,0;;;;;;6,0;;;;1,0;2,0;;;;;;;;;;;1,0;;7,0;;5,0;;;;1,0;2,0;;1,0;4,0;6,0;;;;1,0;;;1,0;;;;
individual;1,0;;;2,0;1,0;4,0;25,0;10,0;;16,0;;7,0;;59,0;;3,0;52,0;;2,0;9,0;2,0;;20,0;;4,0;1,0;;14,0;11,0;8,0;16,0;4,0;;3,0;2,0;90,0;1,0;;9,0;1,0;50,0;52,0;;8,0;25,0;4,0;1,0;19,0;;2,0;20,0;;;;10,0;2,0;13,0;;2,0;21,0;;;1,0;1,0;152,0;1,0;50,0;3,0;;1,0;2,0;51,0;17,0;3,0;;;4,0;8,0;;6,0;51,0;15,0;;25,0;38,0;;;33,0;;1,0;10,0;;;;;;58,0;2,0;65,0;33,0;52,0;6,0;4,0;2,0;4,0;5,0;1,0;1,0;;;;17,0;10,0;;;;6,0;5,0;27,0;64,0;3,0;;11,0;14,0;;21,0;40,0;;11,0;;18,0;1,0;;29,0;;;13,0;;;;;2,0;;;30,0;3,0;13,0;2,0;46,0;;;3,0;9,0;1,0;;3,0;;;;;5,0;;;;;;5,0;;;1,0;2,0;;1,0;;;;2,0;2,0;;;;;;8,0;1,0;;8,0;;27,0;1,0;;7,0;;1,0;;3,0;2,0;;;2,0;;2,0;;1,0;16,0;3,0;2,0;;3,0;13,0;7,0;7,0;;4,0;;1,0;12,0;1,0;4,0;;6,0;3,0;1,0;;1,0;;13,0;4,0;5,0;11,0;;;15,0;;;5,0;2,0;;;4,0;;;;;;7,0;4,0;;1,0;;;4,0;1,0;6,0;6,0;;;37,0;;;3,0;5,0;1,0;;;;;;7,0;;;;;;;;1,0;2,0;;5,0;;3,0;2,0;1,0;;;;3,0;13,0;;;2,0;8,0;1,0;6,0;;2,0;1,0;;;;;;;;;;7,0;;7,0;;;;;;;3,0;1,0;6,0;1,0;2,0;20,0;;;1,0;;;;2,0;3,0;;;;;12,0;;;;;;1,0;;;;;3,0;5,0;5,0;;;1,0;;;;16,0;;1,0;;52,0;4,0;;;;2,0;1,0;7,0;9,0;;;;;;12,0;1,0;3,0;;;;1,0;1,0;29,0;;1,0;2,0;;6,0;2,0;8,0;2,0;25,0;2,0;2,0;2,0;2,0;;17,0;;11,0;6,0;;;5,0;;18,0;1,0;37,0;;10,0;16,0;;;6,0;;1,0;1,0;1,0;;;1,0;;1,0;15,0;;;2,0;15,0;1,0;11,0;2,0;;;;4,0;;;;3,0;3,0;4,0;;4,0;;4,0;;;1,0;;1,0;5,0;;1,0;;11,0;;;;;1,0;;3,0;3,0;;;2,0;;12,0;;;;;2,0;7,0;11,0;2,0;;;;;3,0;;;2,0;;10,0;;;5,0;7,0;;;;1,0;;;;2,0;;3,0;1,0;;;1,0;;;1,0;1,0;1,0;;5,0;3,0;;13,0;;;1,0;10,0;;3,0;;;1,0;;7,0;4,0;1,0;4,0;;;;;;;8,0;;;;8,0;1,0;1,0;4,0;2,0;;4,0;3,0;;10,0;;;;;;;;2,0;5,0;4,0;1,0;2,0;;1,0;1,0;2,0;1,0;;8,0;;11,0;;9,0;5,0;;;;;4,0;;;2,0;;;2,0;;;;;;;2,0;;6,0;;8,0;1,0;;;;;1,0;2,0;4,0;1,0;;;22,0;;;3,0;;;;;;;1,0;21,0;;1,0;11,0;1,0;;9,0;;5,0;;;;;;;;;;;17,0;3,0;;;;1,0;;;;2,0;4,0;11,0;1,0;;;;10,0;;;;;;9,0;;;;;;4,0;;;3,0;;;;;;15,0;;;4,0;1,0;1,0;1,0;;1,0;1,0;;;;;;4,0;;6,0;;;;;;;;;8,0;;;2,0;1,0;;1,0;1,0;;;;1,0;;2,0;;16,0;;;;4,0;;;;;;8,0;;;;;;1,0;;42,0;;;;1,0;11,0;1,0;;;;;6,0;1,0;;5,0;;2,0;;;1,0;;;;;;;;;1,0;;;;;;;;;;1,0;;2,0;;;;;;;;;;;;;;2,0;11,0;4,0;;;6,0;;;;3,0;;;;;;;1,0;;;;38,0;;;;;;2,0;;;;;1,0;;;;2,0;;3,0;3,0;;;4,0;1,0;;;1,0;;;;2,0;;;5,0;;;;;;;;1,0;;;;;;;;3,0;3,0;1,0;3,0;;1,0;;3,0;2,0;;4,0;;;;;;;;;4,0;;1,0;;;;;;;;;;1,0;1,0;;;;;;;;1,0;1,0;;;4,0;4,0;;;;1,0;;;;;1,0;1,0;;;;;;;;;;;;;;;2,0;;;;;;;2,0;;;;;8,0;;;;;;;;;;;;;;;;;4,0;;;;;;2,0;;;3,0;;;;;;;;;2,0;;2,0;;;;;;1,0;;;;;;;;;41,0;;;10,0;;;4,0;;;;;;;;
lateral;61,0;2,0;;3,0;10,0;4,0;;51,0;;;7,0;;28,0;94,0;;;10,0;;;;;5,0;;;;;;2,0;;4,0;10,0;;3,0;4,0;;2,0;14,0;3,0;;;26,0;31,0;4,0;23,0;;126,0;;30,0;;2,0;;;62,0;1,0;8,0;;82,0;;;14,0;3,0;;17,0;;43,0;;50,0;2,0;1,0;;9,0;114,0;2,0;;29,0;1,0;;;;;19,0;;;;36,0;4,0;;83,0;;;;;;;;;50,0;57,0;22,0;26,0;61,0;12,0;3,0;;1,0;1,0;;;;;;1,0;27,0;;;1,0;;7,0;3,0;13,0;2,0;;2,0;1,0;;;26,0;13,0;;;;;1,0;47,0;;1,0;17,0;;1,0;1,0;;13,0;7,0;;1,0;;15,0;21,0;;17,0;11,0;3,0;10,0;24,0;;;;;;;9,0;14,0;;;;;21,0;87,0;;13,0;4,0;;1,0;114,0;;15,0;1,0;4,0;2,0;;;;22,0;49,0;;;4,0;2,0;25,0;9,0;;;;1,0;27,0;27,0;83,0;1,0;79,0;1,0;;3,0;8,0;;12,0;;173,0;1,0;;10,0;8,0;56,0;33,0;;3,0;76,0;1,0;17,0;;4,0;6,0;;;;140,0;;101,0;2,0;1,0;;8,0;1,0;;2,0;7,0;4,0;;3,0;;1,0;;7,0;1,0;;4,0;;4,0;15,0;155,0;;;;;9,0;15,0;1,0;56,0;420,0;4,0;;1,0;1,0;;54,0;238,0;;;;;3,0;3,0;2,0;8,0;;;;6,0;17,0;6,0;27,0;4,0;1,0;64,0;31,0;3,0;3,0;1,0;3,0;34,0;;28,0;;;4,0;5,0;;17,0;1,0;5,0;14,0;1,0;;6,0;;;27,0;;4,0;4,0;17,0;2,0;3,0;3,0;;2,0;;21,0;;;6,0;;5,0;52,0;18,0;;;;;18,0;;27,0;;12,0;12,0;;;;;;;8,0;5,0;6,0;4,0;;6,0;;28,0;;5,0;;;3,0;;6,0;;;46,0;;;;;;1,0;;11,0;2,0;1,0;;;;;;7,0;;3,0;;;;;18,0;11,0;;1,0;;8,0;;1,0;;;;;;2,0;1,0;2,0;;6,0;;;;3,0;;;;2,0;;;6,0;7,0;;10,0;;;;2,0;7,0;;1,0;;;;;;;;;;1,0;1,0;12,0;;3,0;;1,0;;7,0;2,0;;;;14,0;2,0;8,0;;1,0;3,0;3,0;;;;;;1,0;;1,0;4,0;;;;15,0;;;;;;;;;;;;;;;;;;;;85,0;;;2,0;;2,0;5,0;;;;;;;;;;;;;4,0;;;;;;8,0;3,0;;;;;;;;1,0;;1,0;3,0;7,0;;9,0;5,0;;17,0;;;;;;;;;;1,0;16,0;1,0;;;;10,0;;;;14,0;;2,0;;;;;;;;;;;;;;;;;;;;;;2,0;;;;;;3,0;5,0;10,0;;;4,0;;;;;1,0;;4,0;1,0;;;2,0;;;;;3,0;;;;;;;;;23,0;;;;;;;;;1,0;1,0;;3,0;;;;;;;;;;;4,0;;;;11,0;;;1,0;8,0;;;;19,0;;;;;2,0;;;;;;;;;;;;;;;1,0;;;;;;;;;;;;3,0;;2,0;;;2,0;;;8,0;;;;;;;;;4,0;1,0;17,0;;9,0;;;;8,0;3,0;6,0;;;;;1,0;7,0;28,0;1,0;1,0;1,0;;;;;4,0;;;;;7,0;;;;3,0;;;;6,0;6,0;;;;;;;;19,0;;;5,0;4,0;;;;1,0;7,0;;;;;;;;41,0;1,0;;;;;;1,0;;9,0;;;9,0;1,0;;;;;;8,0;;1,0;;;;;;15,0;;;;;;;;2,0;11,0;;;;;1,0;;;;;;;;;;;3,0;1,0;;;;1,0;;;;;;;;13,0;;;;1,0;;;;;2,0;;;;;;;;;;;;1,0;;;;;;;2,0;2,0;;;;;;;;;;;;;;;;;;;;;;;;;;3,0;6,0;;;;;;;;6,0;;;;;;;;;1,0;;;;;;;;;;;;7,0;;;;;1,0;;3,0;;10,0;;;;;;;;1,0;;;1,0;2,0;;;;7,0;;;;;1,0;2,0;;;2,0;1,0;;;;2,0;;2,0;;;5,0;3,0;2,0;;;;6,0;;;;;;;;;;;3,0;;;;;1,0;;;;;;;9,0;;;;;;;;1,0;;;;;;;;;;;2,0;;;;;;
length;5,0;18,0;3,0;58,0;8,0;50,0;39,0;106,0;4,0;2,0;84,0;;17,0;162,0;;;87,0;6,0;17,0;8,0;;3,0;3,0;2,0;13,0;11,0;1,0;53,0;10,0;114,0;65,0;10,0;5,0;11,0;6,0;47,0;69,0;9,0;23,0;3,0;160,0;223,0;32,0;23,0;56,0;18,0;7,0;101,0;7,0;;44,0;;92,0;4,0;26,0;2117,0;45,0;;;14,0;2,0;;144,0;;263,0;3,0;120,0;36,0;2,0;9,0;;1589,0;47,0;5,0;4,0;3,0;38,0;19,0;2,0;27,0;123,0;2,0;3,0;4,0;66,0;9,0;;372,0;4,0;10,0;13,0;3,0;;;7,0;;49,0;38,0;98,0;67,0;49,0;128,0;7,0;1,0;7,0;22,0;1,0;3,0;2,0;3,0;;4,0;12,0;1,0;;;3,0;51,0;4,0;145,0;2,0;;45,0;10,0;6,0;14,0;522,0;42,0;5,0;27,0;139,0;181,0;;257,0;31,0;;38,0;12,0;115,0;;;11,0;1,0;2,0;61,0;;25,0;5,0;57,0;5,0;;16,0;48,0;17,0;;;4,0;1,0;;7,0;;18,0;;10,0;;;20,0;14,0;3,0;4,0;;3,0;4,0;238,0;;72,0;;8,0;17,0;1,0;3,0;;;13,0;6,0;1,0;1,0;;15,0;20,0;3,0;3,0;;2,0;4,0;14,0;37,0;6,0;153,0;5,0;2,0;31,0;23,0;;34,0;2,0;37,0;13,0;10,0;63,0;30,0;20,0;8,0;;;136,0;5,0;14,0;2,0;64,0;4,0;20,0;1,0;7,0;16,0;;146,0;;;6,0;9,0;9,0;78,0;67,0;8,0;;2,0;;;103,0;;160,0;3,0;;;15,0;17,0;22,0;166,0;2,0;15,0;5,0;4,0;14,0;18,0;6,0;24,0;104,0;2,0;3,0;3,0;19,0;15,0;21,0;19,0;;25,0;2,0;4,0;17,0;1,0;25,0;1,0;7,0;3,0;;8,0;64,0;3,0;2,0;10,0;4,0;163,0;3,0;16,0;1,0;2,0;24,0;5,0;32,0;30,0;5,0;1,0;4,0;25,0;27,0;113,0;1,0;1,0;1,0;3,0;28,0;;4,0;;22,0;1,0;1,0;36,0;118,0;2,0;3,0;4,0;;4,0;2,0;14,0;4,0;;7,0;20,0;53,0;7,0;4,0;;1,0;2,0;13,0;22,0;;29,0;11,0;20,0;30,0;1,0;17,0;1,0;7,0;3,0;4,0;14,0;17,0;1,0;10,0;1,0;6,0;48,0;9,0;;5,0;3,0;2,0;2,0;1,0;140,0;25,0;1,0;17,0;43,0;1,0;11,0;;2,0;1,0;7,0;21,0;;2,0;;;;;35,0;46,0;77,0;11,0;;7,0;;2,0;41,0;16,0;1,0;14,0;12,0;10,0;1,0;28,0;1,0;;6,0;2,0;2,0;73,0;2,0;12,0;21,0;15,0;16,0;;;7,0;2,0;17,0;4,0;11,0;1,0;4,0;11,0;9,0;1,0;23,0;;13,0;6,0;8,0;;4,0;3,0;;4,0;2,0;;3,0;1,0;27,0;;18,0;1,0;12,0;6,0;;74,0;;9,0;;3,0;1,0;;;22,0;9,0;21,0;;4,0;4,0;2,0;1,0;16,0;3,0;;3,0;;30,0;5,0;;;14,0;;10,0;12,0;5,0;7,0;;;;;;;;7,0;;8,0;7,0;6,0;;28,0;3,0;;2,0;22,0;9,0;;3,0;6,0;2,0;18,0;1,0;21,0;;1,0;;5,0;5,0;2,0;;15,0;;5,0;5,0;;;1,0;14,0;21,0;30,0;2,0;;;7,0;1,0;3,0;1,0;;2,0;1,0;2,0;1,0;1,0;;3,0;10,0;4,0;2,0;;;;5,0;8,0;;;;1,0;6,0;16,0;;28,0;4,0;5,0;24,0;;70,0;3,0;92,0;1,0;;;;3,0;;;;2,0;;;1,0;;;1,0;;5,0;2,0;;9,0;;;3,0;2,0;1,0;1,0;;;;;37,0;4,0;;;;;1,0;;16,0;32,0;3,0;9,0;4,0;;3,0;18,0;3,0;;;;2,0;;;1,0;;;3,0;6,0;;12,0;;;6,0;16,0;;3,0;;;3,0;7,0;;;;;;5,0;;;;1,0;;;;;;;4,0;;1,0;1,0;6,0;2,0;;;25,0;1,0;6,0;8,0;32,0;4,0;;4,0;;4,0;;4,0;4,0;;2,0;;8,0;1,0;;1,0;;5,0;;;;;7,0;;;;1,0;;2,0;;;3,0;;2,0;;;4,0;;;1,0;2,0;10,0;;;;;3,0;;;4,0;;;;9,0;13,0;14,0;3,0;7,0;;8,0;3,0;17,0;12,0;6,0;1,0;10,0;;;;;1,0;;;3,0;;;17,0;20,0;1,0;2,0;5,0;;;7,0;4,0;;6,0;1,0;;2,0;1,0;24,0;33,0;2,0;2,0;6,0;5,0;2,0;4,0;;6,0;13,0;;23,0;3,0;;5,0;;10,0;;6,0;;2,0;2,0;3,0;8,0;;;4,0;9,0;4,0;;3,0;;3,0;;;4,0;78,0;;19,0;1,0;3,0;;2,0;;13,0;;14,0;;8,0;;10,0;5,0;;217,0;;1,0;;;1,0;;;;7,0;1,0;;2,0;;;1,0;20,0;2,0;;;;4,0;36,0;;6,0;;;;2,0;6,0;1,0;10,0;2,0;;1,0;7,0;;2,0;30,0;1,0;;;1,0;;1,0;4,0;9,0;4,0;4,0;2,0;1,0;;;1,0;1,0;;;;1,0;2,0;;;;6,0;9,0;2,0;;1,0;3,0;2,0;;;;;1,0;;2,0;;;10,0;2,0;5,0;;4,0;3,0;163,0;;1,0;;2,0;;1,0;2,0;1,0;4,0;;3,0;6,0;3,0;7,0;;;23,0;3,0;1,0;;;;;1,0;;;;;;;;1,0;5,0;1,0;3,0;11,0;7,0;;1,0;;;2,0;;1,0;;;;;2,0;3,0;;1,0;;2,0;;17,0;15,0;;;2,0;4,0;;4,0;;;;;;;10,0;;9,0;;;20,0;1,0;;;8,0;1,0;5,0;;;;;;;;;;;;;;4,0;;;8,0;;27,0;;;;4,0;;;;;5,0;83,0;;;;;;4,0;22,0;16,0;85,0;;2,0;;;;;6,0;
lens;59,0;105,0;17,0;365,0;280,0;1440,0;824,0;3367,0;8,0;27,0;199,0;24,0;2842,0;878,0;12,0;2,0;658,0;16,0;68,0;95,0;160,0;30,0;69,0;75,0;255,0;103,0;123,0;482,0;35,0;613,0;1954,0;352,0;142,0;308,0;91,0;418,0;259,0;117,0;92,0;61,0;472,0;2333,0;270,0;313,0;178,0;1596,0;156,0;3407,0;31,0;39,0;18,0;38,0;215,0;98,0;315,0;1948,0;1221,0;5,0;21,0;187,0;133,0;29,0;2811,0;8,0;5111,0;32,0;3774,0;56,0;51,0;114,0;1589,0;;1583,0;235,0;302,0;9,0;243,0;19,0;12,0;99,0;1008,0;31,0;176,0;46,0;3641,0;735,0;18,0;4986,0;298,0;316,0;90,0;94,0;215,0;87,0;215,0;14,0;222,0;483,0;1959,0;212,0;3113,0;254,0;31,0;94,0;110,0;190,0;15,0;32,0;56,0;73,0;1,0;72,0;190,0;36,0;68,0;16,0;40,0;247,0;185,0;2481,0;46,0;35,0;578,0;79,0;42,0;140,0;3647,0;356,0;10,0;229,0;250,0;74,0;18,0;4902,0;35,0;48,0;464,0;15,0;1478,0;7,0;27,0;224,0;6,0;6,0;695,0;92,0;204,0;650,0;130,0;567,0;45,0;137,0;1211,0;194,0;1,0;14,0;61,0;40,0;1,0;68,0;63,0;396,0;14,0;163,0;4,0;11,0;939,0;845,0;10,0;125,0;104,0;18,0;282,0;1289,0;26,0;136,0;66,0;53,0;95,0;8,0;11,0;20,0;178,0;612,0;33,0;78,0;432,0;104,0;356,0;988,0;8,0;8,0;61,0;307,0;1925,0;272,0;1918,0;188,0;503,0;90,0;11,0;207,0;215,0;7,0;51,0;28,0;1151,0;40,0;70,0;1800,0;1123,0;556,0;53,0;19,0;18,0;490,0;133,0;174,0;64,0;236,0;60,0;85,0;2,0;11,0;187,0;10,0;1681,0;22,0;50,0;81,0;115,0;54,0;322,0;107,0;363,0;;104,0;9,0;43,0;228,0;43,0;257,0;61,0;18,0;73,0;169,0;145,0;446,0;2823,0;41,0;22,0;127,0;537,0;360,0;591,0;74,0;712,0;3903,0;139,0;;35,0;237,0;252,0;155,0;139,0;109,0;6,0;30,0;4,0;209,0;25,0;94,0;650,0;77,0;184,0;42,0;161,0;455,0;119,0;171,0;66,0;187,0;2180,0;255,0;4,0;61,0;540,0;214,0;355,0;69,0;534,0;78,0;6,0;282,0;47,0;27,0;1009,0;112,0;200,0;115,0;24,0;79,0;64,0;41,0;9,0;104,0;20,0;46,0;121,0;1570,0;36,0;25,0;127,0;3,0;40,0;12,0;454,0;87,0;47,0;197,0;129,0;1408,0;178,0;46,0;34,0;107,0;231,0;10,0;1714,0;132,0;152,0;12,0;26,0;64,0;73,0;26,0;17,0;14,0;32,0;2,0;128,0;98,0;26,0;59,0;53,0;187,0;16,0;424,0;1,0;135,0;11,0;8,0;143,0;16,0;45,0;30,0;78,0;329,0;263,0;38,0;1,0;10,0;16,0;2,0;18,0;117,0;18,0;26,0;;39,0;21,0;;89,0;418,0;227,0;38,0;64,0;75,0;46,0;17,0;992,0;24,0;24,0;114,0;28,0;293,0;58,0;186,0;5,0;4,0;46,0;21,0;12,0;1938,0;146,0;116,0;19,0;30,0;74,0;16,0;8,0;63,0;60,0;82,0;29,0;84,0;23,0;41,0;102,0;286,0;92,0;1046,0;1,0;78,0;227,0;99,0;114,0;38,0;29,0;1,0;2,0;23,0;53,0;57,0;2,0;842,0;17,0;102,0;26,0;11,0;178,0;2,0;90,0;8,0;83,0;7,0;125,0;141,0;84,0;21,0;152,0;174,0;70,0;113,0;19,0;22,0;11,0;51,0;68,0;26,0;1,0;58,0;106,0;102,0;70,0;11,0;4,0;63,0;8,0;96,0;41,0;70,0;2,0;22,0;9,0;5,0;;4,0;19,0;;16,0;19,0;69,0;45,0;62,0;10,0;17,0;6,0;8,0;8,0;475,0;4,0;14,0;293,0;52,0;34,0;200,0;16,0;100,0;1,0;6,0;3,0;79,0;117,0;60,0;37,0;25,0;51,0;7,0;45,0;42,0;3,0;43,0;21,0;3,0;46,0;85,0;3,0;27,0;13,0;14,0;21,0;26,0;1,0;46,0;30,0;191,0;399,0;7,0;8,0;88,0;100,0;24,0;54,0;;6,0;24,0;2,0;59,0;1,0;24,0;1,0;32,0;201,0;38,0;13,0;79,0;;78,0;19,0;2,0;18,0;337,0;381,0;2,0;24,0;;3,0;16,0;14,0;9,0;6,0;12,0;5,0;56,0;19,0;5,0;3,0;3,0;;25,0;35,0;16,0;46,0;2,0;109,0;16,0;28,0;20,0;38,0;;62,0;;130,0;424,0;155,0;16,0;5,0;52,0;29,0;1,0;31,0;102,0;32,0;81,0;79,0;16,0;;19,0;81,0;16,0;1,0;6,0;5,0;2,0;;5,0;91,0;42,0;11,0;6,0;;;22,0;10,0;9,0;22,0;44,0;6,0;3,0;4,0;15,0;15,0;33,0;13,0;5,0;8,0;22,0;;384,0;5,0;13,0;12,0;10,0;2,0;3,0;24,0;13,0;;2,0;10,0;1,0;46,0;16,0;45,0;;3,0;31,0;158,0;112,0;22,0;24,0;54,0;2,0;;24,0;14,0;89,0;;88,0;;;1,0;1,0;51,0;97,0;19,0;4,0;10,0;16,0;;47,0;2,0;10,0;184,0;37,0;;;24,0;3,0;132,0;1,0;94,0;20,0;14,0;69,0;;16,0;140,0;2,0;2,0;8,0;1,0;45,0;8,0;13,0;19,0;220,0;273,0;28,0;7,0;39,0;29,0;34,0;32,0;411,0;18,0;77,0;56,0;120,0;6,0;13,0;15,0;740,0;1391,0;12,0;13,0;74,0;41,0;43,0;14,0;10,0;54,0;7,0;89,0;55,0;29,0;111,0;1499,0;68,0;2,0;4,0;75,0;7,0;9,0;75,0;9,0;5,0;29,0;8,0;10,0;9,0;21,0;108,0;630,0;;14,0;24,0;95,0;24,0;59,0;5,0;27,0;216,0;;183,0;21,0;49,0;17,0;73,0;14,0;172,0;88,0;42,0;185,0;376,0;13,0;258,0;42,0;18,0;45,0;114,0;2,0;49,0;;16,0;60,0;1,0;2,0;16,0;15,0;25,0;215,0;5,0;4,0;1,0;27,0;17,0;121,0;26,0;20,0;;2,0;14,0;159,0;18,0;54,0;66,0;5,0;1,0;1,0;4,0;43,0;7,0;;;18,0;20,0;;7,0;10,0;7,0;53,0;42,0;10,0;;;2,0;4,0;6,0;;17,0;26,0;;;2,0;42,0;100,0;5,0;;14,0;45,0;1,0;;4,0;61,0;128,0;24,0;72,0;17,0;;3,0;2,0;256,0;;56,0;8,0;11,0;57,0;2,0;29,0;54,0;;;7,0;27,0;10,0;2,0;5,0;;3,0;8,0;30,0;1,0;1,0;1,0;10,0;1,0;6,0;15,0;3,0;18,0;5,0;53,0;;8,0;10,0;32,0;66,0;4,0;10,0;;760,0;45,0;35,0;;1,0;10,0;4,0;7,0;;9,0;1,0;17,0;513,0;;16,0;;2,0;375,0;;13,0;17,0;1,0;;;19,0;5,0;1,0;4,0;5,0;4,0;;2,0;;15,0;92,0;32,0;10,0;31,0;3,0;2,0;18,0;5,0;14,0;;16,0;1,0;;10,0;5,0;1,0;15,0;1,0;;;112,0;6,0;10,0;292,0;;23,0;3,0;93,0;15,0;41,0;7,0;40,0;12,0;7,0;56,0;3,0;159,0;11,0;80,0;7,0;10,0;1459,0;9,0;;69,0;63,0;4,0;404,0;1,0;1,0;2,0;35,0;;5,0;54,0;3,0;24,0;71,0;10,0;9,0;;14,0;8,0;;1,0;1,0;34,0;22,0;;1,0;10,0;2,0;15,0;115,0;6,0;4,0;149,0;4,0;6,0;1,0;22,0;;5,0;18,0;109,0;50,0;;25,0;1,0;;3,0;1,0;7,0;15,0
light;7,0;33,0;8,0;234,0;556,0;445,0;531,0;310,0;1,0;1,0;10,0;231,0;17,0;527,0;116,0;77,0;615,0;30,0;18,0;66,0;29,0;7,0;588,0;9,0;55,0;11,0;8,0;220,0;29,0;120,0;1688,0;145,0;37,0;89,0;32,0;430,0;134,0;73,0;182,0;35,0;465,0;1530,0;13,0;87,0;237,0;342,0;1,0;1059,0;1,0;7,0;11,0;79,0;108,0;101,0;452,0;129,0;365,0;;136,0;441,0;20,0;135,0;129,0;;2436,0;21,0;1109,0;32,0;17,0;2,0;47,0;1583,0;;46,0;6,0;7,0;128,0;147,0;4,0;41,0;798,0;26,0;126,0;32,0;420,0;102,0;11,0;974,0;94,0;24,0;51,0;79,0;700,0;19,0;61,0;1,0;849,0;213,0;1328,0;185,0;644,0;178,0;66,0;73,0;135,0;164,0;18,0;31,0;34,0;27,0;3,0;118,0;561,0;13,0;3,0;106,0;9,0;239,0;429,0;1754,0;104,0;47,0;566,0;23,0;254,0;54,0;925,0;1,0;25,0;21,0;351,0;23,0;5,0;1245,0;36,0;2,0;297,0;21,0;14,0;88,0;;50,0;;12,0;211,0;64,0;258,0;473,0;164,0;86,0;6,0;436,0;130,0;29,0;3,0;70,0;6,0;23,0;18,0;;35,0;107,0;33,0;251,0;65,0;15,0;119,0;157,0;8,0;113,0;216,0;13,0;661,0;469,0;3,0;40,0;30,0;2023,0;38,0;1,0;59,0;31,0;102,0;197,0;2,0;138,0;759,0;1,0;155,0;179,0;1,0;1,0;19,0;16,0;23,0;147,0;366,0;1067,0;51,0;15,0;11,0;345,0;9,0;;248,0;46,0;270,0;16,0;252,0;156,0;59,0;23,0;24,0;33,0;19,0;66,0;432,0;55,0;14,0;372,0;670,0;83,0;6,0;237,0;150,0;19,0;1070,0;4,0;73,0;159,0;8,0;52,0;369,0;67,0;14,0;9,0;1182,0;192,0;13,0;96,0;2,0;14,0;36,0;1,0;7,0;130,0;63,0;97,0;282,0;10,0;;9,0;27,0;321,0;175,0;47,0;66,0;1129,0;39,0;48,0;42,0;650,0;58,0;180,0;50,0;2,0;85,0;803,0;7,0;208,0;65,0;19,0;39,0;77,0;33,0;;212,0;276,0;14,0;44,0;20,0;11,0;303,0;45,0;;;32,0;26,0;100,0;30,0;10,0;39,0;2,0;5,0;14,0;39,0;266,0;12,0;1,0;6,0;;2,0;16,0;19,0;;13,0;9,0;36,0;18,0;551,0;12,0;5,0;48,0;;10,0;1,0;115,0;5,0;30,0;35,0;65,0;852,0;33,0;43,0;43,0;10,0;49,0;9,0;184,0;14,0;10,0;12,0;2,0;24,0;59,0;20,0;3,0;;4,0;3,0;33,0;24,0;2,0;3,0;20,0;15,0;17,0;94,0;54,0;3,0;2,0;;25,0;15,0;61,0;24,0;134,0;43,0;92,0;28,0;18,0;1,0;3,0;;32,0;84,0;35,0;15,0;2,0;6,0;3,0;27,0;115,0;76,0;137,0;50,0;131,0;15,0;26,0;6,0;510,0;35,0;25,0;15,0;38,0;545,0;41,0;105,0;24,0;38,0;39,0;12,0;27,0;177,0;9,0;64,0;20,0;67,0;64,0;28,0;;131,0;109,0;200,0;12,0;123,0;16,0;61,0;70,0;27,0;5,0;40,0;4,0;95,0;77,0;25,0;13,0;;;9,0;124,0;36,0;95,0;32,0;9,0;1747,0;49,0;199,0;34,0;;400,0;;70,0;13,0;19,0;30,0;26,0;184,0;93,0;24,0;107,0;32,0;96,0;16,0;10,0;15,0;1,0;39,0;71,0;4,0;;25,0;202,0;6,0;;2,0;12,0;70,0;;28,0;42,0;27,0;12,0;50,0;13,0;18,0;;2,0;9,0;4,0;40,0;45,0;23,0;27,0;17,0;3,0;199,0;1,0;3,0;12,0;20,0;11,0;9,0;43,0;76,0;4,0;97,0;18,0;51,0;4,0;2,0;18,0;21,0;437,0;210,0;137,0;50,0;58,0;2,0;;11,0;6,0;31,0;18,0;39,0;31,0;7,0;3,0;9,0;3,0;5,0;23,0;6,0;5,0;6,0;33,0;1,0;60,0;23,0;4,0;10,0;14,0;26,0;30,0;;1,0;25,0;203,0;11,0;5,0;7,0;;1,0;247,0;20,0;4,0;26,0;10,0;3,0;57,0;2,0;20,0;62,0;201,0;1,0;14,0;4,0;16,0;38,0;;14,0;7,0;12,0;3,0;11,0;8,0;10,0;32,0;1,0;;7,0;34,0;36,0;16,0;12,0;;35,0;1,0;9,0;45,0;1,0;47,0;2,0;38,0;53,0;29,0;311,0;33,0;36,0;53,0;24,0;14,0;952,0;16,0;27,0;53,0;;4,0;44,0;25,0;4,0;2,0;12,0;67,0;8,0;;15,0;249,0;99,0;1,0;12,0;7,0;5,0;102,0;8,0;;;253,0;49,0;34,0;58,0;15,0;22,0;5,0;;1,0;15,0;3,0;7,0;56,0;17,0;2,0;720,0;48,0;2,0;9,0;32,0;;;;1,0;1,0;;14,0;15,0;;;22,0;28,0;37,0;11,0;68,0;10,0;5,0;21,0;147,0;4,0;33,0;1,0;29,0;7,0;1,0;42,0;;13,0;7,0;14,0;20,0;108,0;5,0;31,0;51,0;2,0;13,0;108,0;;1,0;;1,0;10,0;3995,0;;4,0;24,0;;93,0;3,0;5,0;211,0;;2,0;5,0;13,0;68,0;20,0;49,0;9,0;2,0;15,0;3,0;10,0;21,0;7,0;3,0;18,0;56,0;2,0;53,0;5,0;6,0;303,0;1,0;43,0;85,0;58,0;14,0;4,0;16,0;8,0;12,0;5,0;4,0;23,0;;3,0;748,0;1,0;45,0;11,0;41,0;1,0;10,0;3,0;6,0;11,0;29,0;4,0;7,0;146,0;6,0;2,0;37,0;53,0;9,0;83,0;2,0;4,0;5,0;25,0;4,0;178,0;1,0;7,0;1,0;4,0;67,0;14,0;859,0;30,0;12,0;6,0;;2,0;21,0;5,0;16,0;2,0;25,0;20,0;26,0;2,0;155,0;1,0;4,0;1,0;2,0;9,0;34,0;24,0;;10,0;3,0;188,0;1,0;1,0;2,0;44,0;1,0;670,0;2,0;3,0;4,0;;7,0;166,0;41,0;5,0;52,0;14,0;4,0;1,0;4,0;24,0;1,0;1,0;6,0;155,0;;;41,0;6,0;3,0;19,0;174,0;5,0;;2,0;20,0;28,0;16,0;;3,0;82,0;19,0;12,0;;152,0;5,0;5,0;;6,0;187,0;25,0;6,0;11,0;;4,0;32,0;37,0;;;31,0;9,0;2,0;;21,0;4,0;3,0;29,0;1,0;2,0;11,0;;4,0;3,0;2,0;97,0;254,0;6,0;10,0;12,0;10,0;13,0;8,0;31,0;3,0;48,0;;2,0;11,0;14,0;506,0;3,0;83,0;;170,0;45,0;29,0;96,0;7,0;8,0;15,0;5,0;92,0;15,0;9,0;4,0;19,0;6,0;5,0;;9,0;3,0;8,0;12,0;17,0;7,0;3,0;4,0;7,0;1,0;13,0;5,0;;8,0;;1,0;;7,0;3,0;5,0;2,0;12,0;;;69,0;14,0;21,0;23,0;186,0;107,0;;78,0;38,0;4,0;1,0;10,0;17,0;4,0;15,0;;;2,0;44,0;6,0;13,0;5,0;28,0;377,0;;;;2,0;27,0;;;;2,0;;2,0;;14,0;10,0;;;12,0;28,0;41,0;;5,0;34,0;1,0;1,0;2,0;5,0;;4,0;30,0;4,0;19,0;2,0;116,0;35,0;36,0;21,0;1,0;23,0;19,0;3,0;;4,0;;7,0;196,0;5,0;18,0;1,0;4,0;68,0;200,0;20,0;;;;6,0;;76,0;;1,0;5,0;2,0;89,0;2,0;6,0;;1,0;13,0;;2,0;
liquid;2,0;;;6,0;7,0;4,0;7,0;39,0;;;;;4,0;13,0;1,0;;;42,0;3,0;;;;13,0;;2,0;;;10,0;;;39,0;;;;445,0;;5,0;3,0;1,0;;9,0;126,0;;;102,0;19,0;;9,0;;;1,0;2,0;2,0;;9,0;9,0;27,0;;2,0;5,0;5,0;1,0;2,0;;20,0;2,0;44,0;;3,0;;5,0;235,0;46,0;;4,0;;14,0;;;;24,0;;2,0;;20,0;1,0;;19,0;1,0;;;;1,0;;;;2,0;1,0;19,0;2,0;23,0;8,0;;1,0;3,0;2,0;;;4,0;;;;2,0;;;;;2,0;;12,0;;4,0;2,0;;;7,0;41,0;;2,0;3,0;9,0;;;15,0;12,0;;;;1,0;;;1,0;;;3,0;7,0;8,0;24,0;1,0;2,0;;1,0;14,0;2,0;;;1,0;;17,0;;1,0;16,0;;;;;7,0;2,0;;;;;;27,0;;1,0;;;1,0;;;;2,0;;;8,0;12,0;14,0;;19,0;;;3,0;;1,0;;10,0;4,0;4,0;;11,0;106,0;;;;4,0;14,0;;3,0;9,0;;;;2,0;;7,0;2,0;1,0;;30,0;2,0;;;;5,0;;21,0;5,0;3,0;;1,0;1,0;;2,0;1,0;;;1,0;;2,0;4,0;2,0;3,0;;7,0;;1,0;4,0;;1,0;;;1,0;21,0;49,0;32,0;1,0;50,0;3,0;;1,0;;14,0;5,0;1,0;1,0;1,0;;7,0;1,0;;2,0;24,0;;;;6,0;10,0;1,0;;;;4,0;;;;;1,0;5,0;;1,0;;;;;11,0;6,0;3,0;;2,0;;;1,0;3,0;;;;9,0;;7,0;;;;;;;1,0;;1,0;;;3,0;1,0;1,0;15,0;;1,0;;2,0;2,0;;;;1,0;1,0;;;;;;2,0;;1,0;;;;;;;;;;;2,0;;;;;;1,0;;;;3,0;;;;2,0;;;;;;1,0;9,0;8,0;;;2,0;;25,0;;;1,0;1,0;;;;;;;;;8,0;;2,0;;;2,0;;;1,0;1,0;;;9,0;;2,0;;;;2,0;;1,0;;16,0;;1,0;;;;;2,0;;;4,0;;1,0;4,0;;1,0;;5,0;1,0;3,0;;;5,0;4,0;;1,0;2,0;;;;;;;;;;4,0;;1,0;;;;3,0;;10,0;;1,0;;;;;;;;;;;1,0;5,0;;;1,0;;;;;;14,0;;2,0;1,0;;;;;;;;;;1,0;2,0;;;;;;;;;1,0;8,0;;2,0;;;;;;;;97,0;1,0;;;2,0;1,0;3,0;3,0;;;;;6,0;;;;;8,0;;;;;1,0;;;;1,0;5,0;;1,0;;;13,0;;;;7,0;;;;;;;;;;;;;;;1,0;;1,0;;;;2,0;5,0;6,0;1,0;;1,0;;;;1,0;;;1,0;;;;;1,0;;;;;;1,0;1,0;;;;;;9,0;;;;4,0;;;;;;;;;1,0;;;3,0;;;;;;;;;;;;;;;;;;;8,0;3,0;1,0;;;;;3,0;;7,0;;;;;;;;;;;;;;;;;4,0;13,0;;;;;;;;2,0;;;;;;;;;;1,0;;;;;1,0;;;;;;12,0;4,0;1,0;;;;1,0;;1,0;5,0;6,0;;;;;;;;;;;2,0;;2,0;;;;;4,0;;1,0;6,0;;;3,0;;;1,0;;;2,0;;;;1,0;;;;;;;;2,0;;;;1,0;;;;;1,0;;1,0;;;;;;1,0;;;3,0;;;;;;;;;;;;;1,0;2,0;;;;34,0;;;;1,0;;;;;;;;;1,0;;3,0;21,0;7,0;31,0;5,0;3,0;;;;;;;;;;;;;;;;1,0;;;;;;5,0;;;;;;;;;;;1,0;3,0;;6,0;;;;;;;;;;;;3,0;;;;1,0;;;;;;;51,0;;;;3,0;;;3,0;;;;;2,0;;;;6,0;;;;1,0;;;3,0;;;10,0;;;2,0;;;;;;;;2,0;;;;;;1,0;1,0;;;2,0;;;2,0;;;;;;;;;;;;;;;;1,0;;;;4,0;;;;13,0;;1,0;;;;;;;9,0;;;;;;;1,0;;;;;;;;;;;1,0;7,0;;;;;;;2,0;;;;;;5,0;;;;;;;;;;;1,0;;;;;;;;;;
magnification;3,0;;;23,0;86,0;15,0;3,0;36,0;;;;;;45,0;;2,0;74,0;;;;;;2,0;;;;;;17,0;13,0;26,0;4,0;2,0;;;17,0;6,0;3,0;10,0;;13,0;43,0;;67,0;92,0;;2,0;3,0;;;;;3,0;;26,0;19,0;10,0;;;3,0;;;58,0;;172,0;;38,0;12,0;;29,0;4,0;302,0;6,0;4,0;;18,0;;;67,0;;54,0;;5,0;;10,0;2,0;;46,0;6,0;1,0;1,0;;;;4,0;;12,0;;58,0;6,0;113,0;37,0;;3,0;10,0;4,0;;3,0;;;;3,0;;;;2,0;2,0;6,0;1,0;10,0;;;1,0;5,0;1,0;12,0;21,0;30,0;;;24,0;13,0;;28,0;14,0;;35,0;;97,0;;;;;;15,0;4,0;2,0;5,0;2,0;3,0;;;1,0;;;;;;;;;;;;;2,0;;;3,0;2,0;;;2,0;6,0;9,0;6,0;2,0;1,0;;;;;;;;;;;;5,0;;;;;;;1,0;5,0;;;;;10,0;;;2,0;2,0;;9,0;1,0;28,0;6,0;;;;;4,0;;;;;4,0;;;1,0;;26,0;;;2,0;;;48,0;23,0;;;;;;13,0;;;1,0;;;19,0;2,0;2,0;;5,0;;;;;;;;7,0;;;;7,0;3,0;4,0;;;;;2,0;;;;;;1,0;;7,0;9,0;;;2,0;;9,0;;;;;;;;;2,0;;;3,0;;21,0;;;;;;;;;1,0;;;4,0;22,0;;;;;1,0;;2,0;;;2,0;;17,0;;;;2,0;;;16,0;;;;;;;;;;;;3,0;2,0;;;;;3,0;3,0;;;;;;;;;3,0;;17,0;;;;;;;53,0;;;;;;;13,0;4,0;133,0;29,0;;;1,0;;61,0;3,0;;1,0;;18,0;15,0;13,0;5,0;;12,0;3,0;;46,0;;6,0;;2,0;10,0;;;6,0;1,0;517,0;;27,0;;3,0;;;;6,0;;;11,0;;;;;;1,0;9,0;;;2,0;17,0;;7,0;;;1,0;;1,0;;10,0;;12,0;2,0;;;1,0;2,0;14,0;;;22,0;;;1,0;;;;;15,0;1,0;;;;;;;;;;;;;;1,0;;2,0;9,0;8,0;1,0;;;;;;;;;;5,0;1,0;1,0;;;1,0;;;;;2,0;;;7,0;;;;4,0;;;5,0;;2,0;6,0;;;;;;;;1,0;;;2,0;;;;;;;;;;3,0;;;;33,0;;;;;;;5,0;1,0;;;1,0;1,0;1,0;;;;;3,0;;;;;5,0;;;;;;;;4,0;;6,0;;;;;;;;;;5,0;;;;;;;;;;;;;;;2,0;;;;;;;;2,0;;;;;;;;;;;3,0;;;;1,0;;;;;1,0;;;;;;;1,0;;;2,0;;;;;1,0;;;;;;;;1,0;;;;;;;;;;;;;;12,0;;30,0;1,0;;1,0;;;;;;;;;;;;;;;;;;;9,0;;;;;;;;;;;;;;;;;3,0;5,0;;;;;;;2,0;;;;;1,0;48,0;;;;;;2,0;;1,0;13,0;1,0;;;;;;3,0;;;;;;;;9,0;2,0;;;;;;20,0;;;;;53,0;60,0;;3,0;;;;;;;;;;;;;;;;;;;;;;2,0;;1,0;;;;;;;;;;;;;;;16,0;;;;;1,0;;;;;;;;;;;10,0;;;;;;;;;;;;2,0;;;;;;;;;;2,0;1,0;;;;;;;1,0;;10,0;;1,0;;;15,0;;;;;;;;;;2,0;2,0;30,0;;8,0;;1,0;;;;;;;;;;;;;;;;3,0;;;;;;;;;;;;;;;;;3,0;;;;;;;;;;;;;;;;;;2,0;;;;;;;;;;;;;;;;;;;;;;;;;;;;;;;;;;;;;2,0;;;10,0;;;;;;;5,0;;;;1,0;;;;;;;;;;;;;;;;;;;;;;;;1,0;;;;;;;;1,0;;;;;;;;;
magnitude;1,0;;;10,0;4,0;2,0;1,0;1,0;;;;;3,0;46,0;;;;;;;;;2,0;;1,0;;2,0;8,0;6,0;2,0;3,0;;;3,0;;34,0;;2,0;11,0;;102,0;20,0;;2,0;7,0;;5,0;;;4,0;1,0;;;;11,0;;3,0;;1,0;4,0;;;6,0;;104,0;;5,0;2,0;;1,0;3,0;9,0;7,0;;18,0;;;21,0;2,0;;26,0;;1,0;2,0;5,0;;1,0;21,0;;7,0;4,0;;1,0;;;;33,0;;9,0;32,0;3,0;9,0;;;1,0;;3,0;;4,0;;;21,0;5,0;;;1,0;3,0;10,0;2,0;17,0;5,0;;47,0;;;17,0;14,0;;;;12,0;2,0;;12,0;1,0;;;2,0;;;;4,0;;;;6,0;;;8,0;;1,0;;;;;1,0;;;;;;;;;;;;;2,0;7,0;15,0;4,0;2,0;66,0;;131,0;2,0;;;;3,0;;;;;;2,0;14,0;;;;;;;3,0;;;;2,0;;;;;4,0;35,0;2,0;;;2,0;1,0;;9,0;4,0;;;;10,0;;;1,0;;5,0;;;;;37,0;4,0;;2,0;;;3,0;1,0;;2,0;;;;1,0;;;;;;13,0;;1,0;;;;;;;;5,0;;5,0;;;2,0;2,0;;1,0;;;;;;;;;;;;;;1,0;;;;3,0;2,0;;;;;;4,0;;1,0;;;;;;11,0;;4,0;;;;;10,0;;;;;;2,0;;;;;;;;;;;;;1,0;10,0;;;;;6,0;;;;;;;;;;;;1,0;3,0;;;;;;;;;;;;;;;;;1,0;;6,0;;;;;1,0;;1,0;;;;;19,0;;27,0;;;3,0;6,0;5,0;26,0;2,0;3,0;;1,0;18,0;14,0;18,0;;;2,0;;;9,0;2,0;3,0;;12,0;5,0;2,0;;4,0;;41,0;;1,0;;;18,0;;;;;;17,0;2,0;;6,0;;;;16,0;2,0;;1,0;3,0;1,0;3,0;;2,0;2,0;;9,0;;;;1,0;;2,0;;10,0;1,0;27,0;1,0;10,0;7,0;7,0;;;1,0;;4,0;;;;;;;2,0;;;;3,0;;;;1,0;;;;;;9,0;;;;1,0;;;;2,0;;;;;;;69,0;;;1,0;1,0;3,0;;;1,0;;;;3,0;1,0;1,0;;;40,0;;;;;;;10,0;;;3,0;;;;;2,0;;;8,0;;;;;;;;;28,0;;1,0;;;;;;1,0;;2,0;;;;;;;;;;;;;;;;;;;4,0;;;3,0;;;;;;1,0;;;;;;;;;;;;;;;;;;;;;;;;13,0;;;;;;;;;;10,0;;;;;;1,0;;;;;;;;;;;;;13,0;;;;;;;;3,0;;;1,0;;;;;;34,0;;;;;3,0;;;;;;;;;;13,0;;;;14,0;3,0;;;1,0;3,0;;;;;;;1,0;;;;;1,0;;;7,0;;;;;;;;;;;;;;1,0;;3,0;;;;;;;;2,0;;12,0;;;;;;;;;;;;;;;;;;;;;;;;;;;;;1,0;3,0;;;;19,0;;3,0;;2,0;;;3,0;;;;;;;;;;;2,0;;;;;;;;;;;;;;1,0;;;;;;;;;;;;;;;10,0;;2,0;;1,0;;1,0;;;;;;6,0;;;;;;5,0;;;2,0;;;8,0;2,0;;2,0;2,0;;;2,0;;1,0;2,0;;;;;1,0;3,0;;;;;;1,0;;;;3,0;;;;;;;;23,0;;;;;;;;;12,0;;;4,0;;;1,0;;;;;;;1,0;;;;;;;2,0;;;;;;;;1,0;;;;;;;;;;;;;;;;;;1,0;;;;;;;;;;;;;3,0;;;;1,0;1,0;;;;;;;;;;1,0;4,0;13,0;;;;;;3,0;;;;;11,0;;4,0;;;;;;;;1,0;;;;;;;;;;;;;;3,0;;;1,0;;;;;;;;;;16,0;;;;;23,0;;;;;;;8,0;;;;;;;2,0;;;;
material;1,0;1,0;;6,0;23,0;81,0;26,0;69,0;;;;2,0;17,0;136,0;;;21,0;5,0;4,0;24,0;8,0;;60,0;1,0;;;1,0;24,0;1,0;;81,0;;1,0;;6,0;8,0;7,0;5,0;6,0;;9,0;100,0;7,0;6,0;6,0;61,0;;131,0;;;;;22,0;8,0;23,0;15,0;319,0;;;5,0;23,0;;36,0;;72,0;;206,0;8,0;4,0;;38,0;243,0;128,0;14,0;;;;1,0;1,0;8,0;119,0;5,0;1,0;;186,0;3,0;;96,0;;8,0;;19,0;7,0;8,0;1,0;;3,0;17,0;90,0;10,0;64,0;24,0;16,0;10,0;17,0;4,0;1,0;;25,0;;;1,0;15,0;2,0;10,0;1,0;;15,0;2,0;54,0;3,0;;;6,0;4,0;;99,0;7,0;1,0;32,0;2,0;1,0;;73,0;;3,0;3,0;;10,0;8,0;;8,0;1,0;;7,0;50,0;42,0;36,0;17,0;19,0;1,0;38,0;59,0;11,0;12,0;;;90,0;13,0;7,0;297,0;11,0;;;;;74,0;70,0;;1,0;12,0;;2,0;20,0;11,0;18,0;6,0;5,0;6,0;;2,0;;9,0;18,0;11,0;100,0;102,0;1,0;13,0;34,0;4,0;;42,0;15,0;9,0;33,0;152,0;22,0;19,0;3,0;44,0;200,0;1,0;;8,0;9,0;83,0;59,0;2,0;136,0;3,0;3,0;;44,0;11,0;13,0;1,0;1,0;3,0;8,0;38,0;1,0;;;44,0;;262,0;1,0;14,0;17,0;6,0;16,0;7,0;15,0;17,0;4,0;4,0;2,0;2,0;20,0;67,0;47,0;;;18,0;34,0;8,0;43,0;72,0;2,0;;25,0;14,0;54,0;63,0;2,0;49,0;247,0;14,0;1,0;18,0;12,0;12,0;8,0;19,0;4,0;4,0;17,0;14,0;38,0;;28,0;12,0;1,0;1,0;;23,0;23,0;1,0;4,0;12,0;;5,0;14,0;;1,0;18,0;42,0;22,0;1,0;8,0;22,0;;1,0;2,0;3,0;30,0;;73,0;4,0;36,0;5,0;75,0;4,0;;5,0;49,0;4,0;3,0;100,0;12,0;;8,0;5,0;1,0;;51,0;2,0;7,0;13,0;;29,0;21,0;6,0;6,0;3,0;4,0;3,0;2,0;22,0;7,0;4,0;3,0;46,0;;4,0;;23,0;2,0;;4,0;3,0;3,0;;2,0;28,0;12,0;18,0;2,0;11,0;4,0;4,0;;1,0;1,0;11,0;1,0;49,0;2,0;;1,0;1,0;;;;2,0;1,0;;;;2,0;;;35,0;10,0;4,0;;;2,0;;3,0;;;;;6,0;;;1,0;;1,0;;1,0;7,0;;1,0;6,0;2,0;1,0;;;3,0;6,0;4,0;4,0;26,0;;5,0;3,0;3,0;;5,0;5,0;5,0;;2,0;1,0;;;;;;1,0;;;22,0;6,0;8,0;;2,0;5,0;1,0;2,0;;;;;1,0;;;6,0;10,0;;;;;;3,0;14,0;;;4,0;;4,0;7,0;;;10,0;4,0;7,0;4,0;24,0;;1,0;;;;;;;1,0;;;7,0;3,0;13,0;;;;1,0;18,0;;2,0;1,0;;1,0;2,0;34,0;2,0;;2,0;;3,0;;;20,0;4,0;;;;2,0;;10,0;;;;4,0;2,0;;2,0;;3,0;;;2,0;;7,0;16,0;;10,0;5,0;9,0;21,0;1,0;;;14,0;7,0;7,0;;;;11,0;3,0;;;;;8,0;1,0;;6,0;10,0;87,0;;1,0;1,0;2,0;;;;3,0;;3,0;;;;;;;;;7,0;82,0;;;;;5,0;;;;;74,0;3,0;;1,0;;2,0;8,0;;1,0;13,0;13,0;1,0;10,0;1,0;;;12,0;;;;2,0;;;;4,0;1,0;1,0;;;;;;;;3,0;;2,0;3,0;1,0;7,0;19,0;;1,0;;;;9,0;;;;;;;;;;;17,0;;;;3,0;;;1,0;3,0;6,0;;;25,0;3,0;;1,0;;11,0;;2,0;;;;;7,0;13,0;1,0;2,0;1,0;;;;;;13,0;23,0;4,0;;1,0;;32,0;;;;;;;;32,0;;;5,0;;2,0;;;1,0;19,0;6,0;;2,0;13,0;;;11,0;60,0;2,0;2,0;1,0;;1,0;;;4,0;12,0;;1,0;4,0;;;;2,0;3,0;;4,0;2,0;;;;3,0;;1,0;76,0;;1,0;;7,0;;;;2,0;;;2,0;7,0;;12,0;3,0;;2,0;1,0;2,0;;1,0;2,0;;;3,0;;3,0;;;10,0;2,0;38,0;10,0;;2,0;9,0;5,0;3,0;3,0;;7,0;15,0;;8,0;;1,0;;;2,0;;;;;42,0;2,0;43,0;1,0;;;;;144,0;;3,0;21,0;2,0;2,0;;3,0;2,0;2,0;;46,0;2,0;;;5,0;;;25,0;;2,0;;2,0;;7,0;2,0;;;;;;;19,0;;6,0;;;;;;;2,0;10,0;12,0;;5,0;;;;;;18,0;1,0;9,0;7,0;;7,0;15,0;;1,0;;;;;;;3,0;5,0;3,0;;1,0;;15,0;;;20,0;;2,0;;;;;;1,0;;3,0;;;4,0;;3,0;;;;;4,0;;4,0;;;;1,0;;;;5,0;;22,0;9,0;;;;;;1,0;8,0;;;;;;;14,0;;2,0;2,0;;;;;;;1,0;1,0;;;;;1,0;;;;;;1,0;9,0;;8,0;;10,0;1,0;;3,0;10,0;1,0;;1,0;;;;;20,0;;75,0;7,0;4,0;;6,0;;4,0;;;;;;;1,0;;;1,0;;;;;6,0;;4,0;;4,0;2,0;;11,0;;3,0;2,0;7,0;;;;;;;;;;;2,0;;;;;;;;;
measurement;4,0;;1,0;20,0;32,0;111,0;34,0;25,0;22,0;;2,0;1,0;;130,0;;38,0;54,0;;;3,0;;;18,0;6,0;7,0;20,0;1,0;49,0;9,0;21,0;164,0;12,0;5,0;16,0;;164,0;14,0;5,0;116,0;2,0;134,0;209,0;2,0;14,0;43,0;2,0;8,0;19,0;7,0;17,0;41,0;;8,0;5,0;47,0;7,0;7,0;;23,0;68,0;;;2,0;1,0;274,0;3,0;122,0;10,0;8,0;;19,0;19,0;147,0;;;21,0;1,0;;3,0;15,0;230,0;;3,0;9,0;166,0;3,0;4,0;83,0;2,0;2,0;13,0;1,0;;;1,0;3,0;102,0;4,0;96,0;117,0;118,0;22,0;3,0;6,0;28,0;40,0;2,0;7,0;;;1,0;27,0;36,0;;;2,0;;24,0;3,0;168,0;12,0;2,0;48,0;5,0;22,0;36,0;156,0;;12,0;2,0;80,0;3,0;2,0;195,0;5,0;2,0;29,0;8,0;;;;2,0;1,0;;;11,0;35,0;4,0;43,0;1,0;;;2,0;;;1,0;;;;;3,0;7,0;;10,0;;1,0;32,0;;;13,0;12,0;;16,0;35,0;;1,0;;2,0;2,0;1,0;59,0;;;2,0;1,0;;4,0;23,0;27,0;4,0;5,0;1,0;2,0;3,0;;3,0;3,0;3,0;1,0;;;;1,0;;127,0;6,0;20,0;;6,0;13,0;11,0;28,0;8,0;;;;22,0;2,0;;16,0;20,0;11,0;;2,0;;;76,0;4,0;;7,0;;19,0;22,0;1,0;3,0;6,0;30,0;1,0;;23,0;;1,0;2,0;;;8,0;10,0;2,0;1,0;;;;1,0;2,0;5,0;1,0;7,0;13,0;;;2,0;19,0;2,0;52,0;;;15,0;;3,0;98,0;;;26,0;3,0;;;1,0;137,0;;;;9,0;43,0;;;;1,0;1,0;4,0;1,0;;5,0;;;1,0;;173,0;12,0;;;;;;6,0;7,0;;;9,0;26,0;36,0;;;2,0;;3,0;;3,0;2,0;2,0;3,0;7,0;136,0;1,0;2,0;;2,0;11,0;1,0;;2,0;;;;;3,0;;;;;;14,0;10,0;19,0;;;;13,0;2,0;;;3,0;;1,0;;13,0;;3,0;;30,0;;1,0;14,0;26,0;;;8,0;2,0;5,0;9,0;;;;49,0;;6,0;;14,0;11,0;8,0;5,0;40,0;124,0;11,0;2,0;27,0;25,0;6,0;26,0;9,0;;28,0;8,0;4,0;8,0;9,0;15,0;;15,0;;8,0;165,0;21,0;10,0;18,0;1,0;44,0;1,0;2,0;23,0;13,0;;6,0;;8,0;7,0;21,0;;6,0;;10,0;1,0;3,0;3,0;5,0;3,0;101,0;14,0;16,0;2,0;12,0;15,0;;21,0;;5,0;14,0;5,0;6,0;;2,0;9,0;;74,0;15,0;4,0;4,0;4,0;;21,0;7,0;1,0;5,0;1,0;2,0;;;5,0;19,0;;4,0;13,0;;52,0;3,0;7,0;;2,0;;;;13,0;;6,0;;;99,0;6,0;;;17,0;;3,0;;20,0;3,0;;44,0;24,0;1,0;8,0;1,0;;12,0;5,0;1,0;;7,0;;;9,0;1,0;5,0;;;;61,0;1,0;;;;;3,0;;;;1,0;;;;;;1,0;13,0;;1,0;;;;;2,0;1,0;;;;3,0;;2,0;;1,0;5,0;3,0;18,0;;;5,0;2,0;;;17,0;;;;1,0;;4,0;;;;;;6,0;8,0;;2,0;37,0;;7,0;;;4,0;;;;;4,0;1,0;11,0;8,0;;4,0;29,0;;14,0;;9,0;;;;1,0;7,0;;;3,0;2,0;;;;1,0;8,0;1,0;4,0;;;15,0;;1,0;;16,0;1,0;2,0;;;2,0;5,0;;;6,0;;;2,0;;;68,0;21,0;;;;;3,0;;;;;;;;;;1,0;32,0;;2,0;;7,0;1,0;;;;;;;4,0;1,0;;2,0;1,0;3,0;1,0;15,0;;10,0;6,0;2,0;;3,0;;3,0;;;1,0;28,0;2,0;;;;;3,0;;47,0;;;;;;2,0;;10,0;;1,0;;;;;;;9,0;5,0;10,0;;;1,0;;7,0;4,0;4,0;;;;;;;5,0;1,0;;;4,0;1,0;;;13,0;;;;2,0;1,0;;;15,0;4,0;7,0;;1,0;;6,0;9,0;6,0;1,0;1,0;4,0;;1,0;;;;;12,0;;10,0;;;;;;;2,0;;;;;;;;;;;12,0;1,0;;;3,0;2,0;;2,0;;;;;;;;4,0;;;;;5,0;;;;;;;11,0;;3,0;;4,0;2,0;;;;;7,0;4,0;;5,0;;;10,0;9,0;;172,0;6,0;;;;;;3,0;;;12,0;9,0;;;;;;3,0;;;;3,0;;1,0;1,0;;5,0;;;1,0;1,0;;;;;1,0;3,0;16,0;;;7,0;3,0;;65,0;;33,0;;4,0;;1,0;3,0;6,0;;;;;;;1,0;;;3,0;1,0;;10,0;;;1,0;1,0;2,0;3,0;;2,0;;4,0;6,0;;;;;;1,0;3,0;9,0;;;;;;;1,0;;;;2,0;;1,0;4,0;;;;;;;1,0;1,0;;19,0;;2,0;;;;1,0;2,0;2,0;10,0;;;;;;;;;;;;;;1,0;;;;;;;;;;;4,0;;;;;;;4,0;;19,0;;;1,0;;;;;1,0;;6,0;;;8,0;;;;;;;;6,0;2,0;;;1,0;;;3,0;;;;8,0;;;;;;
media;1,0;;;8,0;;15,0;1,0;;6,0;16,0;;;;39,0;;;325,0;;;8,0;;;4,0;3,0;6,0;;;2,0;139,0;1,0;60,0;6,0;;;;233,0;11,0;1,0;2,0;;47,0;338,0;;15,0;57,0;2,0;;4,0;;;;;;1,0;4,0;;8,0;;1,0;57,0;;;8,0;1,0;73,0;2,0;86,0;6,0;;;2,0;12,0;4,0;;67,0;2,0;1,0;3,0;;7,0;91,0;;16,0;10,0;7,0;;;23,0;;5,0;4,0;;;;;;4,0;;55,0;16,0;7,0;21,0;;12,0;27,0;78,0;3,0;25,0;;;;2,0;13,0;3,0;3,0;4,0;;3,0;27,0;17,0;13,0;2,0;5,0;6,0;;87,0;92,0;;;;13,0;1,0;;1,0;;;23,0;40,0;3,0;;;12,0;;;6,0;3,0;8,0;2,0;42,0;1,0;;;;;7,0;;;5,0;;;;24,0;92,0;1,0;;;18,0;;;;1,0;;7,0;3,0;;;;;2,0;;1,0;;2,0;2,0;;;20,0;;101,0;6,0;;;;;;;;;;4,0;;;;;3,0;18,0;;;11,0;5,0;2,0;7,0;;;;;30,0;1,0;;1,0;23,0;;4,0;;;;23,0;;;31,0;;1,0;9,0;;;5,0;1,0;1,0;;4,0;;;;;;16,0;6,0;4,0;2,0;1,0;1,0;;;;;;;;;;;24,0;19,0;3,0;;;;1,0;;1,0;;;2,0;;13,0;;1,0;;;;1,0;;6,0;;;;;;;;;11,0;;;17,0;;13,0;10,0;;;;;;;;;;;;6,0;;3,0;;;;;;1,0;3,0;;39,0;40,0;;;;;;;1,0;25,0;;;;;8,0;;;;;;3,0;3,0;;;;3,0;8,0;1,0;;;;4,0;;2,0;1,0;;;;35,0;6,0;1,0;;;5,0;;5,0;5,0;;;2,0;;;1,0;1,0;2,0;;1,0;1,0;4,0;;49,0;2,0;;3,0;3,0;32,0;1,0;;;6,0;;28,0;33,0;5,0;;10,0;;30,0;;11,0;;88,0;;60,0;;20,0;;;7,0;;;7,0;;2,0;20,0;5,0;;;;2,0;;4,0;;;124,0;39,0;8,0;3,0;1,0;;;6,0;3,0;;;;147,0;2,0;4,0;1,0;6,0;3,0;8,0;;;142,0;;;44,0;;1,0;;;9,0;;;;;;2,0;21,0;;;11,0;;7,0;;4,0;;;4,0;1,0;119,0;27,0;;;34,0;;2,0;9,0;;;2,0;12,0;18,0;4,0;19,0;12,0;1,0;1,0;;;1,0;3,0;;1,0;3,0;5,0;8,0;5,0;;49,0;19,0;;;3,0;;;;3,0;4,0;;;1,0;;3,0;;;;;;;;;1,0;;;;;;;4,0;;;2,0;17,0;;6,0;3,0;1,0;2,0;1,0;2,0;1,0;1,0;;11,0;2,0;16,0;4,0;;;2,0;2,0;37,0;5,0;;;;;;1,0;;4,0;1,0;1,0;;;29,0;;4,0;;6,0;;1,0;2,0;;;;;;;;1,0;;;;3,0;8,0;;9,0;3,0;;;;4,0;3,0;;5,0;4,0;;15,0;1,0;6,0;97,0;102,0;;6,0;25,0;;5,0;;;;1,0;;;;23,0;;;1,0;;2,0;2,0;;;;2,0;4,0;;;;21,0;;;1,0;;;;5,0;3,0;;1,0;;1,0;;;34,0;;;2,0;1,0;;;6,0;1,0;2,0;3,0;;;2,0;13,0;10,0;;;1,0;;;5,0;6,0;;;;6,0;;8,0;;7,0;;7,0;;2,0;;1,0;4,0;1,0;;;;;;;;1,0;;1,0;;;;3,0;;;7,0;;;;;5,0;1,0;;;;18,0;;1,0;;;;;8,0;;;3,0;;;;;;1,0;;;;;1,0;3,0;2,0;;;;;;;;;1,0;7,0;;;;;;;;;;;;;;;;;;;;;;;1,0;2,0;;2,0;;;;;;;;;;;;;;;;;;;;1,0;1,0;;;;13,0;2,0;;;;;9,0;;;;;;;;;1,0;;;2,0;;;;;1,0;1,0;;;;;;;;;;;;;;;;;;;;;;;;;;;1,0;;;1,0;;;;;;1,0;1,0;;;;;;;;;;;1,0;2,0;;2,0;;;;;;1,0;;;;;3,0;;;;4,0;;;;3,0;;;;;1,0;4,0;;;1,0;4,0;;;5,0;;;;2,0;;;;;;;1,0;;;;;;;5,0;;;;;3,0;;;5,0;;;;;;;;2,0;;;;;;;;;;;;;;;;2,0;;;;;;;;;;;;12,0;;3,0;;;;;;;;;;;;;;;;2,0;;;;;;;;;;;;;;;
memory;4,0;1,0;;9,0;26,0;187,0;28,0;26,0;16,0;6,0;;6,0;;74,0;;1,0;131,0;77,0;6,0;26,0;21,0;;24,0;15,0;111,0;3,0;5,0;67,0;249,0;9,0;487,0;123,0;23,0;28,0;;470,0;19,0;1,0;16,0;3,0;101,0;773,0;;138,0;177,0;32,0;3,0;84,0;;1,0;5,0;;5,0;76,0;7,0;7,0;22,0;;1,0;47,0;;1,0;18,0;12,0;930,0;6,0;320,0;;6,0;;27,0;99,0;41,0;;;;8,0;15,0;7,0;;156,0;;24,0;7,0;157,0;3,0;9,0;20,0;;10,0;29,0;5,0;2,0;1,0;14,0;;80,0;;177,0;31,0;114,0;46,0;;31,0;170,0;1020,0;3,0;298,0;7,0;;2,0;65,0;23,0;3,0;24,0;4,0;34,0;37,0;30,0;178,0;17,0;10,0;213,0;8,0;;1341,0;365,0;;5,0;1,0;106,0;2,0;1,0;319,0;;2,0;23,0;7,0;43,0;;;1,0;6,0;1,0;8,0;9,0;30,0;13,0;65,0;24,0;;9,0;21,0;9,0;154,0;13,0;;;;;1,0;104,0;9,0;3,0;6,0;;292,0;4,0;1,0;44,0;13,0;;13,0;32,0;;;1,0;;9,0;18,0;6,0;2,0;4,0;24,0;;4,0;13,0;12,0;64,0;3,0;;2,0;4,0;59,0;4,0;1,0;58,0;1,0;;;;3,0;3,0;9,0;15,0;64,0;30,0;4,0;4,0;23,0;6,0;11,0;4,0;;;;59,0;13,0;;7,0;22,0;24,0;;1,0;4,0;;47,0;;6,0;3,0;;;14,0;2,0;;1,0;4,0;1,0;;10,0;;9,0;3,0;1,0;1,0;36,0;1,0;139,0;13,0;;39,0;3,0;3,0;26,0;16,0;7,0;32,0;8,0;2,0;;34,0;32,0;38,0;26,0;;;1,0;;1,0;2,0;;76,0;55,0;15,0;12,0;;;7,0;;25,0;;4,0;12,0;7,0;;;;3,0;75,0;2,0;4,0;19,0;;;1,0;;18,0;7,0;;;;;;6,0;;;2,0;6,0;1,0;68,0;;1,0;4,0;;;;19,0;3,0;5,0;8,0;27,0;83,0;1,0;1,0;4,0;;2,0;;27,0;4,0;;;;;65,0;;3,0;;8,0;;2,0;3,0;1,0;;;17,0;2,0;39,0;3,0;;;;;3,0;19,0;;3,0;29,0;187,0;41,0;;2,0;15,0;6,0;11,0;5,0;8,0;;;2,0;4,0;;13,0;8,0;5,0;;7,0;22,0;8,0;2,0;128,0;23,0;9,0;1,0;1,0;44,0;2,0;7,0;5,0;6,0;5,0;182,0;9,0;23,0;;3,0;7,0;27,0;31,0;2,0;;45,0;7,0;11,0;2,0;33,0;1,0;2,0;25,0;12,0;;18,0;1,0;21,0;86,0;7,0;;;15,0;3,0;2,0;29,0;1,0;67,0;72,0;92,0;31,0;39,0;14,0;;23,0;10,0;20,0;9,0;12,0;3,0;203,0;8,0;17,0;;5,0;12,0;20,0;9,0;1,0;119,0;;;53,0;;8,0;;6,0;;;28,0;;30,0;3,0;22,0;54,0;2,0;13,0;6,0;2,0;49,0;2,0;28,0;;;5,0;14,0;433,0;62,0;;;1,0;9,0;23,0;12,0;;7,0;3,0;6,0;36,0;2,0;87,0;4,0;17,0;;;;7,0;10,0;3,0;;20,0;7,0;22,0;;;22,0;18,0;8,0;16,0;6,0;2,0;10,0;4,0;8,0;30,0;;4,0;82,0;33,0;19,0;;8,0;;;18,0;20,0;2,0;;1,0;6,0;2,0;;;1,0;;5,0;;2,0;19,0;4,0;3,0;2,0;17,0;4,0;3,0;1,0;2,0;21,0;;64,0;1,0;29,0;7,0;1,0;;21,0;5,0;1,0;9,0;1,0;2,0;5,0;;;1,0;7,0;3,0;12,0;4,0;;17,0;1,0;51,0;4,0;1,0;7,0;10,0;;1,0;4,0;;1,0;;2,0;4,0;;2,0;3,0;1,0;4,0;;2,0;86,0;4,0;5,0;24,0;7,0;1,0;1,0;2,0;8,0;3,0;9,0;9,0;1,0;66,0;2,0;13,0;2,0;32,0;1,0;38,0;4,0;2,0;10,0;10,0;4,0;;3,0;;7,0;23,0;;9,0;4,0;7,0;9,0;3,0;1,0;;;5,0;3,0;1,0;;;3,0;21,0;1,0;20,0;3,0;;;3,0;10,0;4,0;;;;2,0;1,0;1,0;3,0;;9,0;1,0;6,0;1,0;;6,0;19,0;4,0;9,0;5,0;1,0;1,0;20,0;5,0;13,0;;;;;2,0;22,0;13,0;;10,0;;3,0;7,0;26,0;34,0;8,0;;5,0;16,0;1,0;7,0;22,0;1,0;9,0;;;;;4,0;4,0;30,0;1,0;7,0;2,0;7,0;4,0;;;;11,0;7,0;;;4,0;;35,0;;;1,0;4,0;17,0;10,0;1,0;6,0;10,0;1,0;2,0;;1,0;1,0;5,0;5,0;;;10,0;;;;;;4,0;21,0;;;1,0;;7,0;;;;;;2,0;;;11,0;;;;;1,0;;;;1,0;6,0;;;;;;3,0;;;;;14,0;1,0;;;;;;1,0;;;1,0;;;6,0;1,0;2,0;;1,0;14,0;;;2,0;10,0;7,0;38,0;;26,0;5,0;48,0;;;;;3,0;;;;1,0;2,0;3,0;;;1,0;;7,0;3,0;5,0;7,0;;;;5,0;3,0;135,0;3,0;2,0;7,0;1,0;20,0;;;1,0;6,0;;;;4,0;2,0;;2,0;4,0;1,0;;;1,0;1,0;;2,0;1,0;;2,0;10,0;;6,0;;;6,0;1,0;2,0;4,0;;;;1,0;;1,0;;2,0;2,0;1,0;2,0;;3,0;5,0;2,0;2,0;;2,0;1,0;;1,0;3,0;9,0;;;6,0;;5,0;;;8,0;9,0;;;4,0;;;1,0;;1,0;12,0;;2,0;3,0;;6,0;;;3,0;;;2,0;4,0;;;;3,0;;;1,0;1,0;;;;1,0;2,0;;16,0;;;24,0;;;;;;1,0;2,0;;;7,0;;;;;8,0;;;;;6,0;;;;1,0;;2,0;;2,0;1,0;;;;;3,0;3,0;3,0;;;4,0;;2,0;3,0;;2,0;;;2,0;;;2,0;;;3,0;;;;;;;;1,0;1,0;;15,0;;;5,0;;
method;9,0;52,0;11,0;505,0;116,0;816,0;412,0;279,0;26,0;34,0;2,0;65,0;42,0;879,0;27,0;81,0;1582,0;36,0;82,0;153,0;51,0;34,0;407,0;80,0;252,0;37,0;83,0;235,0;388,0;192,0;271,0;118,0;119,0;178,0;17,0;1361,0;187,0;155,0;537,0;44,0;1972,0;2629,0;17,0;398,0;1274,0;106,0;60,0;354,0;31,0;107,0;281,0;3,0;61,0;74,0;330,0;125,0;410,0;40,0;88,0;823,0;53,0;21,0;148,0;20,0;6710,0;230,0;1919,0;82,0;51,0;19,0;123,0;1008,0;798,0;24,0;54,0;26,0;119,0;230,0;91,0;156,0;;8,0;312,0;324,0;793,0;32,0;;453,0;42,0;41,0;478,0;42,0;56,0;35,0;172,0;4,0;713,0;176,0;1127,0;618,0;1108,0;419,0;35,0;198,0;831,0;637,0;64,0;161,0;104,0;15,0;16,0;312,0;499,0;27,0;11,0;15,0;202,0;192,0;365,0;1147,0;153,0;12,0;557,0;133,0;62,0;384,0;2034,0;1,0;103,0;33,0;630,0;26,0;20,0;407,0;38,0;34,0;619,0;223,0;186,0;2,0;2,0;68,0;35,0;9,0;68,0;275,0;292,0;63,0;342,0;158,0;18,0;113,0;181,0;35,0;19,0;20,0;1,0;23,0;18,0;5,0;44,0;139,0;117,0;92,0;16,0;44,0;157,0;104,0;18,0;238,0;110,0;37,0;91,0;349,0;16,0;214,0;22,0;76,0;69,0;26,0;60,0;11,0;46,0;163,0;22,0;98,0;273,0;54,0;612,0;127,0;31,0;34,0;41,0;35,0;53,0;49,0;300,0;29,0;24,0;37,0;22,0;160,0;36,0;22,0;275,0;84,0;167,0;45,0;78,0;280,0;88,0;258,0;68,0;12,0;17,0;17,0;270,0;55,0;25,0;116,0;377,0;158,0;77,0;17,0;57,0;16,0;530,0;11,0;9,0;132,0;2,0;90,0;265,0;81,0;72,0;68,0;44,0;26,0;10,0;88,0;15,0;56,0;15,0;;33,0;484,0;52,0;138,0;147,0;21,0;28,0;12,0;35,0;173,0;165,0;34,0;99,0;406,0;43,0;;58,0;272,0;93,0;866,0;14,0;35,0;5,0;77,0;98,0;100,0;13,0;44,0;104,0;44,0;33,0;2,0;28,0;336,0;5,0;76,0;23,0;108,0;212,0;79,0;42,0;2,0;53,0;79,0;102,0;9,0;36,0;113,0;2,0;20,0;43,0;4,0;438,0;55,0;16,0;22,0;20,0;15,0;22,0;56,0;7,0;7,0;28,0;114,0;83,0;603,0;3,0;3,0;31,0;1,0;44,0;5,0;137,0;27,0;17,0;59,0;361,0;1328,0;29,0;113,0;31,0;7,0;7,0;4,0;150,0;46,0;4,0;2,0;5,0;28,0;258,0;14,0;14,0;;19,0;2,0;106,0;151,0;44,0;13,0;25,0;74,0;131,0;116,0;6,0;15,0;23,0;12,0;54,0;12,0;356,0;19,0;86,0;21,0;1152,0;125,0;40,0;20,0;22,0;80,0;31,0;170,0;161,0;41,0;17,0;119,0;8,0;13,0;304,0;116,0;186,0;90,0;34,0;130,0;147,0;45,0;1532,0;209,0;24,0;169,0;69,0;890,0;101,0;115,0;49,0;189,0;73,0;232,0;119,0;326,0;27,0;262,0;5,0;449,0;150,0;25,0;26,0;348,0;75,0;236,0;78,0;411,0;83,0;229,0;396,0;123,0;6,0;264,0;29,0;442,0;458,0;259,0;7,0;30,0;20,0;46,0;11,0;185,0;19,0;75,0;39,0;1109,0;142,0;210,0;57,0;39,0;131,0;31,0;417,0;37,0;154,0;22,0;138,0;131,0;103,0;44,0;102,0;149,0;427,0;105,0;58,0;50,0;30,0;31,0;737,0;32,0;27,0;61,0;125,0;26,0;22,0;21,0;21,0;502,0;16,0;89,0;408,0;28,0;61,0;105,0;16,0;64,0;104,0;21,0;41,0;40,0;115,0;87,0;131,0;169,0;23,0;25,0;73,0;37,0;21,0;80,0;15,0;38,0;46,0;191,0;20,0;80,0;983,0;63,0;104,0;240,0;22,0;46,0;74,0;112,0;27,0;33,0;157,0;46,0;29,0;51,0;66,0;184,0;16,0;85,0;120,0;76,0;67,0;56,0;15,0;52,0;112,0;67,0;26,0;8,0;61,0;38,0;52,0;84,0;6,0;15,0;79,0;60,0;24,0;29,0;63,0;9,0;34,0;3,0;13,0;7,0;19,0;138,0;13,0;67,0;87,0;29,0;71,0;35,0;44,0;161,0;44,0;60,0;35,0;157,0;24,0;129,0;13,0;24,0;28,0;107,0;2,0;9,0;84,0;110,0;121,0;106,0;13,0;44,0;8,0;33,0;27,0;63,0;97,0;39,0;103,0;16,0;149,0;36,0;66,0;74,0;14,0;34,0;18,0;157,0;127,0;98,0;17,0;98,0;6,0;14,0;44,0;14,0;46,0;34,0;92,0;25,0;8,0;48,0;124,0;136,0;53,0;36,0;53,0;42,0;13,0;61,0;11,0;32,0;155,0;23,0;66,0;14,0;30,0;377,0;60,0;85,0;32,0;54,0;53,0;22,0;30,0;8,0;52,0;43,0;75,0;2,0;67,0;65,0;57,0;93,0;36,0;15,0;98,0;225,0;49,0;33,0;17,0;6,0;20,0;55,0;23,0;25,0;31,0;262,0;41,0;33,0;43,0;3,0;20,0;106,0;25,0;39,0;21,0;21,0;16,0;43,0;25,0;12,0;46,0;6,0;33,0;55,0;60,0;39,0;44,0;70,0;74,0;9,0;136,0;77,0;27,0;88,0;87,0;30,0;131,0;24,0;17,0;32,0;12,0;35,0;233,0;34,0;29,0;52,0;118,0;77,0;19,0;58,0;383,0;15,0;42,0;28,0;9,0;61,0;16,0;74,0;71,0;64,0;6,0;19,0;9,0;20,0;38,0;36,0;61,0;69,0;38,0;67,0;20,0;5,0;15,0;10,0;30,0;75,0;258,0;9,0;6,0;17,0;2,0;75,0;14,0;31,0;34,0;39,0;16,0;84,0;4,0;38,0;62,0;48,0;49,0;7,0;48,0;40,0;71,0;14,0;24,0;39,0;77,0;68,0;21,0;4,0;2,0;29,0;187,0;34,0;11,0;2,0;53,0;2,0;70,0;12,0;9,0;12,0;3,0;28,0;36,0;78,0;21,0;35,0;20,0;;40,0;4,0;4,0;4,0;52,0;5,0;8,0;17,0;15,0;25,0;7,0;5,0;4,0;10,0;517,0;5,0;54,0;12,0;116,0;18,0;84,0;2,0;;3,0;26,0;4,0;20,0;14,0;43,0;29,0;5,0;38,0;61,0;24,0;15,0;47,0;5,0;38,0;4,0;6,0;35,0;8,0;;3,0;61,0;12,0;68,0;3,0;4,0;1,0;31,0;228,0;12,0;44,0;3,0;27,0;134,0;96,0;12,0;37,0;23,0;9,0;32,0;90,0;72,0;14,0;34,0;28,0;3,0;102,0;34,0;9,0;23,0;67,0;1,0;98,0;24,0;34,0;26,0;17,0;94,0;;59,0;47,0;84,0;43,0;76,0;19,0;24,0;17,0;50,0;22,0;11,0;52,0;19,0;20,0;33,0;28,0;32,0;214,0;19,0;21,0;50,0;15,0;113,0;48,0;21,0;17,0;41,0;94,0;21,0;26,0;22,0;22,0;21,0;12,0;25,0;29,0;37,0;44,0;36,0;73,0;98,0;17,0;24,0;68,0;57,0;20,0;38,0;15,0;49,0;68,0;2,0;59,0;10,0;35,0;31,0;14,0;50,0;18,0;31,0;32,0;30,0;18,0;13,0;28,0;44,0;46,0;16,0;45,0;22,0;10,0;79,0;10,0;104,0;61,0;22,0;16,0;17,0;30,0;30,0;16,0;4,0;9,0;34,0;3,0;21,0;36,0;22,0;1,0;45,0;6,0;26,0;46,0;40,0;61,0;41,0;5,0;12,0;21,0;2,0;50,0;5,0;15,0;2,0;6,0;2,0;7,0;32,0;25,0;54,0;5,0;;3,0;3,0;8,0;1,0;3,0;49,0;2,0;20,0;8,0;28,0;6,0;8,0;13,0;22,0;37,0;23,0;21,0;20,0;6,0;8,0;3,0;32,0;23,0;10,0;28,0;33,0;25,0;17,0;16,0;56,0;17,0;45,0;33,0;2,0;8,0;24,0;76,0;10,0;69,0;51,0;36,0;9,0;5,0;67,0;6,0;23,0;36,0;15,0;30,0;20,0;11,0;18,0;5,0;2,0;
microlens;1,0;;;10,0;3,0;2,0;82,0;;;;;;;;;;7,0;;;;;2,0;5,0;;;;;7,0;1,0;;18,0;2,0;;;;9,0;7,0;;3,0;;;7,0;1,0;1,0;;15,0;;3,0;;;;;;8,0;7,0;12,0;6,0;;;;;;5,0;;52,0;;29,0;;15,0;;2,0;31,0;26,0;;;;5,0;;;;8,0;;;;10,0;;;15,0;;1,0;;;4,0;;;;49,0;11,0;135,0;3,0;39,0;;;;1,0;7,0;1,0;1,0;;;;4,0;3,0;;;;;5,0;10,0;20,0;2,0;;1,0;1,0;;1,0;23,0;;3,0;;;;;2,0;;;1,0;2,0;;;;18,0;;;4,0;3,0;1,0;4,0;5,0;;;7,0;;;;;;;;;;1,0;;;5,0;;16,0;9,0;;;;;3,0;3,0;;;;1,0;;;;;;11,0;;8,0;12,0;;3,0;;;;;;;;;3,0;;;;7,0;;;;2,0;8,0;;;;6,0;;;;;;;;;2,0;;;;7,0;;;3,0;;;2,0;;;;;;;;;;1,0;;;;;4,0;1,0;1,0;9,0;16,0;;;;14,0;;24,0;;;10,0;;;;;;;;;;;;;;;22,0;;;;;1,0;1,0;3,0;;;6,0;;;;;;;;;7,0;;;4,0;;2,0;;;;;;6,0;;;;;;2,0;;;;;;;;25,0;;;;;;;;;;;;4,0;;1,0;;;5,0;;;;;;;;;;;;;;10,0;;;;;;;2,0;;;;;;2,0;;;;;;;;;;;;7,0;2,0;;;;;;;1,0;2,0;;;;;;;;;;;;7,0;;2,0;;2,0;;;;;4,0;;;2,0;;;;;2,0;;;6,0;;;;2,0;;;3,0;1,0;;;;;;;;;11,0;;;;;2,0;;1,0;;;;;;2,0;;4,0;;;;;;;;12,0;;;;2,0;;;;;;;;;;;;;;;1,0;;;;;1,0;;;;;;11,0;;;;;;;;;;1,0;1,0;;;;;;;;;;;;;;;;;;;;2,0;3,0;;;;;;;;;;;;;;;;;;2,0;;;;;;;;1,0;;;;;;;;;;;;;;;;;;;;;;;;;;;;;;;;;;;;;;;;;4,0;;;;;;;;;;;;;;;5,0;;;;;;;;;;;;;1,0;1,0;;;;;;;;5,0;;;;;;;;;;;;;;;;;;;;;;;;;;;;;;;4,0;;;8,0;;;;;1,0;;;;;;;;;;;;;;;;;;;;;;;;;;;;;;;;;;;;4,0;1,0;;4,0;;;;;1,0;;;;;;;;;;5,0;;;;;;;;;;;;;;;;2,0;;;;;;8,0;;;;;;;;;;;;;;;;;;;;;1,0;;;;;;;;;;;;;;;;;2,0;;;;;;;;;;;;;;;;;;;;;;;;5,0;;;;;;;;;;;;;1,0;;;;;;;14,0;;;;3,0;2,0;;;1,0;;3,0;;;;;;;;;;;;;;;;;;;;;;;;;;;;;;3,0;;;;;;;;;;;;31,0;;;;1,0;6,0;;;;1,0;;;;;;;;;;;;1,0;;;;;;;;;;;;;;;;;1,0;;;;;;;;;;;;;;;;;;;;;;;2,0;;;;;2,0;;;;;;;;;;;;;5,0;;;;;;;;;;;;;;;;;;;;;;;;;;;;;;;;;;;;;;;;;;;1,0;;;;;;;;;
mode;2,0;12,0;;42,0;26,0;120,0;41,0;24,0;4,0;;;;19,0;259,0;;20,0;657,0;19,0;3,0;2,0;1,0;;50,0;32,0;164,0;;1,0;52,0;29,0;34,0;317,0;148,0;3,0;4,0;1,0;144,0;6,0;5,0;47,0;1,0;263,0;512,0;1,0;89,0;481,0;6,0;;79,0;;17,0;5,0;10,0;8,0;4,0;27,0;4,0;4,0;;7,0;53,0;3,0;;11,0;1,0;1251,0;14,0;277,0;5,0;;;3,0;176,0;126,0;2,0;5,0;1,0;1,0;3,0;16,0;24,0;312,0;;;3,0;93,0;5,0;2,0;43,0;;8,0;36,0;8,0;13,0;5,0;131,0;2,0;39,0;5,0;217,0;31,0;96,0;67,0;;44,0;183,0;142,0;1,0;7,0;;3,0;;10,0;32,0;9,0;3,0;;28,0;31,0;12,0;203,0;36,0;;243,0;7,0;2,0;66,0;258,0;;4,0;;154,0;2,0;;246,0;2,0;;135,0;4,0;32,0;;;1,0;;;6,0;33,0;30,0;5,0;49,0;2,0;2,0;12,0;27,0;;19,0;;;;;;4,0;17,0;4,0;2,0;11,0;;14,0;2,0;1,0;59,0;12,0;;30,0;20,0;;;23,0;4,0;49,0;8,0;1,0;;1,0;15,0;;2,0;10,0;7,0;73,0;8,0;1,0;;2,0;6,0;;;8,0;7,0;;1,0;;1,0;7,0;;11,0;13,0;15,0;;37,0;21,0;13,0;37,0;6,0;;;1,0;105,0;27,0;3,0;19,0;8,0;27,0;3,0;3,0;2,0;;30,0;;3,0;11,0;;16,0;53,0;;6,0;11,0;9,0;11,0;;4,0;;3,0;;;;229,0;6,0;2,0;15,0;2,0;;;2,0;10,0;;39,0;16,0;5,0;23,0;;5,0;62,0;2,0;30,0;;9,0;;3,0;;;;54,0;25,0;6,0;7,0;3,0;22,0;45,0;;3,0;;4,0;20,0;1,0;2,0;;;81,0;80,0;;1,0;74,0;;;;;30,0;19,0;;;;;;11,0;2,0;;9,0;6,0;2,0;255,0;;;2,0;6,0;7,0;1,0;2,0;62,0;4,0;2,0;94,0;101,0;;3,0;;;14,0;;146,0;;1,0;;;;118,0;1,0;33,0;;5,0;;22,0;13,0;2,0;;1,0;;4,0;;1,0;6,0;2,0;;4,0;20,0;65,0;;54,0;;322,0;16,0;1,0;7,0;;8,0;24,0;109,0;3,0;1,0;;44,0;;2,0;39,0;2,0;143,0;51,0;8,0;65,0;25,0;18,0;423,0;6,0;7,0;8,0;;154,0;50,0;1,0;29,0;39,0;1,0;33,0;3,0;161,0;35,0;63,0;2,0;80,0;58,0;7,0;2,0;85,0;;27,0;25,0;5,0;2,0;51,0;79,0;4,0;;86,0;2,0;510,0;695,0;26,0;;1,0;7,0;;2,0;27,0;1,0;38,0;4,0;134,0;4,0;141,0;39,0;8,0;59,0;;169,0;27,0;27,0;70,0;26,0;13,0;298,0;2,0;7,0;75,0;75,0;13,0;;28,0;;2,0;142,0;;;42,0;134,0;10,0;6,0;4,0;6,0;23,0;1,0;6,0;36,0;9,0;15,0;9,0;;84,0;8,0;23,0;3,0;;28,0;18,0;12,0;17,0;9,0;2,0;16,0;7,0;3,0;2,0;1,0;2,0;2,0;28,0;33,0;10,0;113,0;3,0;31,0;5,0;;;4,0;4,0;2,0;4,0;21,0;1,0;;3,0;;82,0;8,0;26,0;8,0;7,0;16,0;1,0;1,0;1,0;68,0;12,0;23,0;4,0;25,0;1,0;4,0;19,0;;;97,0;;;;;;;2,0;;1,0;9,0;18,0;4,0;;5,0;1,0;6,0;;21,0;2,0;;5,0;;13,0;1,0;20,0;;5,0;;132,0;;;14,0;3,0;32,0;46,0;2,0;2,0;;9,0;14,0;46,0;15,0;12,0;6,0;1,0;;6,0;9,0;4,0;3,0;2,0;2,0;;1,0;1,0;9,0;;;;9,0;;10,0;9,0;8,0;;;;;23,0;29,0;2,0;1,0;;5,0;2,0;;95,0;;;3,0;;1,0;8,0;2,0;11,0;1,0;93,0;18,0;2,0;4,0;;6,0;2,0;10,0;4,0;;3,0;11,0;2,0;18,0;4,0;6,0;4,0;23,0;4,0;;;3,0;45,0;1,0;3,0;5,0;69,0;;;44,0;;;15,0;3,0;18,0;6,0;17,0;9,0;66,0;27,0;;21,0;;13,0;1,0;6,0;;;1,0;7,0;9,0;11,0;;2,0;15,0;1,0;1,0;28,0;;1,0;11,0;;15,0;20,0;;;34,0;8,0;8,0;;;9,0;;25,0;2,0;;142,0;2,0;14,0;;;;7,0;3,0;;33,0;7,0;;1,0;3,0;2,0;;;1,0;1,0;1,0;87,0;94,0;;;;;10,0;10,0;;4,0;;;24,0;1,0;1,0;12,0;38,0;3,0;;;2,0;13,0;1,0;;1,0;4,0;15,0;4,0;23,0;;7,0;16,0;12,0;;;14,0;;26,0;3,0;1,0;;;29,0;9,0;12,0;23,0;28,0;2,0;;2,0;1,0;;;1,0;6,0;;;;20,0;;;;;;;;2,0;39,0;1,0;12,0;2,0;;;;2,0;;;;;;83,0;2,0;;4,0;3,0;;2,0;2,0;2,0;17,0;;7,0;;9,0;21,0;;3,0;;2,0;4,0;52,0;3,0;3,0;;2,0;1,0;1,0;13,0;;;;1,0;;;1,0;;;;6,0;;2,0;;1,0;;;34,0;;3,0;8,0;;;6,0;1,0;2,0;33,0;;;6,0;;;;2,0;59,0;6,0;;;;;;4,0;;6,0;8,0;8,0;5,0;6,0;;1,0;2,0;;4,0;;2,0;18,0;1,0;;7,0;1,0;;1,0;13,0;23,0;1,0;1,0;10,0;;;13,0;5,0;;;;;;18,0;11,0;;5,0;;;7,0;8,0;72,0;34,0;13,0;5,0;44,0;6,0;1,0;22,0;42,0;4,0;2,0;;;;1,0;;3,0;10,0;30,0;;1,0;12,0;1,0;;5,0;83,0;;;;14,0;1,0;1,0;1,0;9,0;;;;;;;;;;1,0;38,0;;1,0;7,0;6,0;;;;;;10,0;4,0;;;;42,0;;;22,0;;;;1,0;1,0;;;;;;;;4,0;4,0;;;;;;2,0;;;14,0;;;3,0;;;;;;;;8,0;5,0;2,0;3,0;;;;;
model;2,0;;;26,0;2,0;39,0;5,0;;;6,0;;;;291,0;;;49,0;;1,0;10,0;;;32,0;1,0;2,0;;;17,0;46,0;5,0;50,0;5,0;28,0;29,0;;142,0;24,0;28,0;74,0;15,0;174,0;118,0;;44,0;27,0;;32,0;6,0;7,0;24,0;128,0;;7,0;4,0;22,0;9,0;5,0;5,0;14,0;252,0;1,0;;17,0;3,0;856,0;7,0;178,0;1,0;25,0;;4,0;46,0;32,0;;;2,0;;9,0;10,0;7,0;324,0;;3,0;;29,0;;;71,0;;8,0;227,0;11,0;;;14,0;;66,0;28,0;162,0;190,0;127,0;32,0;2,0;16,0;25,0;63,0;18,0;8,0;15,0;;;37,0;57,0;;;18,0;1,0;10,0;81,0;31,0;31,0;;3,0;6,0;;118,0;159,0;;8,0;;33,0;7,0;2,0;12,0;4,0;;42,0;181,0;3,0;;;22,0;;;;80,0;4,0;7,0;75,0;9,0;;5,0;131,0;;2,0;;;;;;;12,0;4,0;10,0;;12,0;2,0;15,0;;4,0;9,0;;2,0;1,0;;110,0;;;;;;;;40,0;;;11,0;;90,0;14,0;;;;;;3,0;1,0;7,0;;2,0;;10,0;2,0;;24,0;25,0;;;;;2,0;28,0;18,0;;;4,0;16,0;3,0;9,0;11,0;9,0;2,0;;;;;50,0;;;20,0;;;3,0;4,0;;;;;;51,0;;;;;;62,0;9,0;6,0;;;;;;46,0;;;7,0;130,0;4,0;;1,0;11,0;7,0;48,0;;28,0;;;24,0;;;6,0;;;;;1,0;25,0;;;;;9,0;;23,0;;3,0;1,0;2,0;;1,0;4,0;;2,0;8,0;;28,0;;;;2,0;;;12,0;;;;3,0;;44,0;;;;;;;;;;6,0;7,0;307,0;;;;;;;3,0;8,0;;;;;10,0;5,0;;;1,0;;3,0;5,0;2,0;;3,0;7,0;19,0;37,0;26,0;1,0;3,0;;2,0;;40,0;1,0;;4,0;47,0;2,0;;1,0;;6,0;;7,0;4,0;7,0;2,0;;;;23,0;16,0;4,0;;7,0;6,0;60,0;5,0;17,0;39,0;;8,0;;43,0;3,0;7,0;;13,0;;4,0;25,0;;22,0;9,0;;74,0;16,0;28,0;1,0;15,0;1,0;15,0;12,0;53,0;55,0;10,0;148,0;;;16,0;;4,0;15,0;12,0;;8,0;4,0;86,0;1,0;4,0;;;7,0;45,0;1,0;10,0;15,0;;31,0;;12,0;3,0;4,0;;18,0;4,0;2,0;;6,0;;27,0;4,0;23,0;25,0;17,0;;54,0;1,0;6,0;;2,0;;;;1,0;87,0;;3,0;77,0;15,0;;43,0;5,0;;12,0;;;;2,0;;3,0;7,0;2,0;19,0;;3,0;;9,0;;18,0;;10,0;6,0;1,0;35,0;9,0;3,0;68,0;;;;46,0;;3,0;19,0;;1,0;1,0;1,0;2,0;3,0;;12,0;;2,0;1,0;1,0;4,0;;;;1,0;2,0;;;;;;;;16,0;1,0;;;;;;;;;;;3,0;2,0;;;;66,0;6,0;;;2,0;3,0;3,0;;;;1,0;;;1,0;56,0;3,0;3,0;;2,0;;1,0;8,0;;;3,0;73,0;10,0;15,0;;6,0;19,0;;;;;4,0;71,0;;5,0;;;;;;;3,0;1,0;;;3,0;7,0;;26,0;7,0;12,0;;;10,0;3,0;134,0;;5,0;;4,0;170,0;4,0;16,0;;6,0;;;11,0;6,0;18,0;11,0;;;29,0;3,0;1,0;1,0;;;6,0;22,0;4,0;1,0;13,0;;;3,0;;;;15,0;;;;;;2,0;;;;5,0;;1,0;3,0;;4,0;3,0;;2,0;25,0;7,0;18,0;17,0;12,0;7,0;23,0;12,0;1,0;;6,0;;1,0;;6,0;;;;5,0;;;2,0;;15,0;;12,0;80,0;4,0;;;;3,0;;;15,0;;;;;;;1,0;;;2,0;2,0;;;;;4,0;;;;3,0;;;4,0;;17,0;2,0;;;4,0;1,0;;5,0;2,0;1,0;4,0;;;4,0;2,0;;;70,0;;;;;;9,0;14,0;2,0;;2,0;;4,0;;;;;2,0;;;;;;;;;1,0;;8,0;;;;;;;;;;;;64,0;;29,0;;42,0;;;;3,0;;;;7,0;7,0;;;;5,0;;;1,0;;;;10,0;;;;4,0;;4,0;;;;;;2,0;1,0;;;4,0;20,0;10,0;;;;;5,0;;;11,0;19,0;;15,0;;;;;;2,0;;;10,0;;17,0;;;7,0;;2,0;;;;;45,0;;;;;;3,0;;19,0;40,0;2,0;7,0;15,0;;73,0;;;;15,0;;3,0;5,0;2,0;;20,0;;;;5,0;10,0;1,0;42,0;3,0;;8,0;;55,0;7,0;5,0;;;2,0;;13,0;;;2,0;3,0;;;5,0;2,0;;2,0;;;2,0;;;4,0;;;;;;;1,0;;;5,0;;;;2,0;;;1,0;1,0;1,0;;18,0;;;;1,0;30,0;;;;;;25,0;;;;;1,0;;22,0;1,0;3,0;;;;;;;;10,0;;;;;;4,0;;4,0;10,0;;1,0;1,0;;;;7,0;6,0;;;19,0;;;;26,0;;3,0;3,0;;;;39,0;;4,0;18,0;13,0;;;;4,0;6,0;;;;;;;;;
module;13,0;19,0;3,0;144,0;23,0;437,0;464,0;497,0;;;11,0;10,0;311,0;486,0;11,0;4,0;651,0;14,0;49,0;37,0;55,0;1,0;113,0;64,0;240,0;31,0;56,0;201,0;41,0;12,0;1494,0;119,0;50,0;100,0;8,0;465,0;106,0;57,0;87,0;23,0;309,0;1162,0;72,0;84,0;243,0;561,0;18,0;327,0;12,0;7,0;61,0;11,0;153,0;80,0;107,0;65,0;485,0;9,0;22,0;229,0;41,0;15,0;88,0;56,0;2479,0;72,0;1946,0;29,0;38,0;36,0;66,0;3641,0;420,0;20,0;10,0;5,0;186,0;166,0;7,0;157,0;793,0;10,0;93,0;29,0;;122,0;10,0;988,0;58,0;31,0;90,0;18,0;58,0;28,0;67,0;8,0;162,0;82,0;874,0;104,0;682,0;88,0;24,0;108,0;496,0;294,0;1,0;22,0;7,0;2,0;2,0;95,0;109,0;17,0;28,0;11,0;61,0;58,0;38,0;1241,0;5,0;30,0;302,0;46,0;24,0;86,0;735,0;6,0;92,0;49,0;161,0;6,0;8,0;867,0;5,0;3,0;185,0;17,0;75,0;6,0;4,0;64,0;;1,0;85,0;136,0;116,0;190,0;59,0;172,0;3,0;57,0;220,0;99,0;28,0;20,0;5,0;47,0;44,0;7,0;207,0;375,0;12,0;41,0;7,0;;639,0;331,0;19,0;103,0;66,0;4,0;43,0;481,0;4,0;50,0;19,0;53,0;78,0;4,0;19,0;41,0;39,0;209,0;42,0;85,0;231,0;62,0;359,0;171,0;;2,0;113,0;187,0;422,0;178,0;1016,0;32,0;71,0;84,0;16,0;136,0;21,0;27,0;104,0;22,0;629,0;55,0;107,0;651,0;171,0;133,0;15,0;6,0;17,0;106,0;172,0;36,0;4,0;70,0;153,0;9,0;3,0;22,0;150,0;11,0;833,0;14,0;25,0;46,0;35,0;23,0;94,0;8,0;125,0;16,0;17,0;20,0;18,0;6,0;38,0;46,0;15,0;9,0;50,0;121,0;40,0;141,0;291,0;11,0;8,0;40,0;41,0;230,0;385,0;86,0;303,0;739,0;36,0;;19,0;141,0;100,0;282,0;48,0;12,0;12,0;19,0;33,0;82,0;96,0;176,0;480,0;84,0;28,0;14,0;39,0;160,0;37,0;17,0;69,0;190,0;396,0;387,0;;3,0;141,0;120,0;582,0;15,0;390,0;50,0;8,0;17,0;37,0;8,0;207,0;100,0;127,0;59,0;50,0;11,0;78,0;28,0;4,0;141,0;19,0;73,0;112,0;514,0;13,0;37,0;48,0;;20,0;3,0;131,0;11,0;20,0;89,0;113,0;180,0;71,0;36,0;25,0;30,0;37,0;13,0;282,0;163,0;102,0;6,0;11,0;118,0;171,0;19,0;8,0;4,0;6,0;3,0;90,0;116,0;10,0;31,0;24,0;110,0;12,0;164,0;;126,0;8,0;3,0;4,0;25,0;90,0;29,0;19,0;115,0;323,0;157,0;15,0;17,0;11,0;3,0;1,0;82,0;21,0;18,0;;22,0;43,0;;115,0;51,0;69,0;18,0;36,0;30,0;29,0;6,0;919,0;55,0;;31,0;15,0;185,0;38,0;34,0;15,0;17,0;12,0;57,0;31,0;155,0;64,0;104,0;6,0;78,0;33,0;4,0;8,0;233,0;76,0;85,0;14,0;88,0;19,0;35,0;112,0;158,0;30,0;185,0;1,0;83,0;105,0;71,0;14,0;6,0;19,0;7,0;5,0;31,0;3,0;43,0;8,0;529,0;50,0;81,0;15,0;1,0;103,0;14,0;91,0;4,0;21,0;20,0;77,0;45,0;53,0;16,0;62,0;166,0;29,0;76,0;5,0;14,0;;8,0;152,0;14,0;1,0;40,0;41,0;17,0;79,0;38,0;25,0;79,0;9,0;37,0;35,0;17,0;1,0;11,0;15,0;5,0;33,0;7,0;18,0;;27,0;4,0;68,0;383,0;22,0;11,0;17,0;35,0;36,0;18,0;352,0;;12,0;55,0;53,0;13,0;124,0;128,0;43,0;7,0;3,0;4,0;19,0;16,0;10,0;8,0;60,0;14,0;28,0;60,0;8,0;46,0;15,0;30,0;5,0;45,0;54,0;16,0;3,0;;43,0;4,0;7,0;4,0;70,0;50,0;21,0;44,0;3,0;42,0;150,0;149,0;5,0;23,0;1,0;;34,0;12,0;19,0;12,0;12,0;15,0;21,0;113,0;52,0;12,0;13,0;5,0;26,0;33,0;;3,0;55,0;196,0;3,0;53,0;;8,0;25,0;57,0;1,0;19,0;77,0;9,0;20,0;11,0;1,0;14,0;6,0;1,0;21,0;44,0;44,0;39,0;15,0;;19,0;70,0;25,0;40,0;;17,0;18,0;138,0;63,0;53,0;4,0;75,0;7,0;89,0;25,0;4,0;19,0;35,0;17,0;57,0;9,0;18,0;21,0;32,0;62,0;6,0;9,0;19,0;10,0;3,0;4,0;29,0;41,0;7,0;;12,0;4,0;137,0;11,0;8,0;;98,0;12,0;1,0;19,0;2,0;2,0;47,0;4,0;17,0;;26,0;17,0;169,0;41,0;37,0;16,0;26,0;;8,0;3,0;84,0;2,0;;7,0;21,0;77,0;47,0;51,0;;;21,0;52,0;6,0;87,0;30,0;12,0;29,0;17,0;8,0;;18,0;1,0;2,0;;7,0;23,0;7,0;6,0;27,0;1,0;4,0;12,0;16,0;;24,0;15,0;14,0;14,0;10,0;6,0;20,0;57,0;54,0;68,0;16,0;12,0;39,0;23,0;30,0;4,0;5,0;80,0;;;5,0;25,0;23,0;18,0;22,0;20,0;52,0;146,0;24,0;3,0;151,0;2,0;5,0;14,0;144,0;3,0;41,0;114,0;27,0;5,0;13,0;12,0;304,0;491,0;3,0;33,0;43,0;5,0;6,0;;43,0;13,0;8,0;22,0;115,0;;62,0;6,0;7,0;5,0;3,0;51,0;2,0;11,0;18,0;14,0;;9,0;10,0;13,0;13,0;7,0;4,0;147,0;3,0;20,0;10,0;11,0;46,0;19,0;4,0;4,0;24,0;3,0;18,0;2,0;28,0;9,0;81,0;18,0;78,0;43,0;;10,0;16,0;25,0;1,0;21,0;7,0;84,0;102,0;7,0;25,0;10,0;19,0;189,0;6,0;3,0;11,0;26,0;17,0;26,0;4,0;;2,0;21,0;10,0;174,0;22,0;17,0;1,0;1,0;2,0;61,0;2,0;30,0;56,0;5,0;2,0;3,0;2,0;2,0;12,0;;4,0;25,0;1,0;;3,0;24,0;;44,0;32,0;1,0;;2,0;2,0;5,0;4,0;2,0;199,0;14,0;1,0;7,0;47,0;65,0;39,0;;;3,0;12,0;1,0;21,0;1,0;33,0;10,0;21,0;6,0;30,0;5,0;9,0;6,0;;;9,0;23,0;9,0;8,0;3,0;8,0;13,0;4,0;9,0;;10,0;9,0;;5,0;6,0;;114,0;6,0;3,0;8,0;3,0;13,0;;3,0;134,0;3,0;16,0;6,0;2,0;;4,0;;6,0;6,0;9,0;11,0;16,0;24,0;8,0;28,0;5,0;;11,0;16,0;9,0;21,0;5,0;3,0;9,0;1,0;2,0;95,0;1,0;7,0;6,0;2,0;26,0;11,0;8,0;4,0;;6,0;64,0;7,0;13,0;59,0;17,0;1,0;;29,0;6,0;45,0;;17,0;22,0;;;6,0;4,0;8,0;1,0;15,0;1,0;8,0;11,0;9,0;6,0;4,0;;;1,0;40,0;16,0;21,0;1,0;2,0;25,0;;37,0;7,0;30,0;14,0;21,0;;7,0;19,0;1,0;24,0;13,0;8,0;5,0;14,0;25,0;2,0;1,0;13,0;65,0;6,0;7,0;3,0;;6,0;32,0;1,0;3,0;6,0;5,0;16,0;19,0;;2,0;;;3,0;;3,0;;7,0;3,0;30,0;;6,0;1,0;2,0;3,0;22,0;8,0;1,0;25,0;2,0;;2,0;;2,0;4,0;2,0;68,0;;3,0;;1,0;1,0;;2,0;
movable;2,0;2,0;;19,0;2,0;76,0;4,0;93,0;;;2,0;;70,0;142,0;;;30,0;;14,0;;;;40,0;2,0;1,0;1,0;8,0;77,0;1,0;1,0;233,0;19,0;1,0;60,0;;23,0;21,0;1,0;10,0;1,0;26,0;178,0;1,0;12,0;23,0;100,0;;100,0;;;;;19,0;3,0;14,0;4,0;37,0;2,0;1,0;4,0;1,0;;171,0;;146,0;1,0;230,0;4,0;;4,0;9,0;735,0;102,0;1,0;2,0;;3,0;3,0;;3,0;32,0;;5,0;;122,0;;;268,0;13,0;6,0;1,0;2,0;5,0;5,0;11,0;6,0;2,0;45,0;45,0;40,0;360,0;13,0;1,0;;2,0;11,0;;;5,0;;;17,0;22,0;5,0;3,0;;1,0;4,0;9,0;102,0;7,0;3,0;19,0;1,0;;8,0;84,0;;;;5,0;;;488,0;3,0;;9,0;;84,0;15,0;;;5,0;;1,0;9,0;15,0;36,0;8,0;32,0;14,0;14,0;129,0;;;;11,0;;;;;60,0;;;2,0;2,0;73,0;66,0;3,0;10,0;11,0;3,0;3,0;368,0;4,0;7,0;1,0;15,0;8,0;3,0;;1,0;13,0;45,0;9,0;6,0;66,0;8,0;137,0;13,0;;2,0;;39,0;63,0;28,0;104,0;4,0;11,0;4,0;;1,0;25,0;2,0;4,0;1,0;513,0;1,0;269,0;90,0;204,0;100,0;;1,0;1,0;24,0;7,0;29,0;42,0;17,0;5,0;;;;86,0;;274,0;2,0;10,0;;5,0;;114,0;;7,0;;11,0;7,0;2,0;;4,0;9,0;46,0;13,0;5,0;2,0;5,0;9,0;56,0;13,0;5,0;;;32,0;3,0;1,0;197,0;97,0;6,0;;1,0;2,0;1,0;18,0;5,0;2,0;;;5,0;2,0;;12,0;104,0;18,0;;;34,0;20,0;9,0;4,0;4,0;30,0;245,0;4,0;;14,0;28,0;20,0;2,0;;60,0;11,0;9,0;5,0;2,0;4,0;28,0;4,0;13,0;27,0;2,0;2,0;4,0;;6,0;20,0;12,0;18,0;2,0;78,0;6,0;;14,0;;;18,0;32,0;51,0;24,0;98,0;7,0;97,0;16,0;1,0;1,0;2,0;8,0;;4,0;;9,0;2,0;12,0;11,0;;3,0;9,0;2,0;12,0;1,0;67,0;88,0;14,0;9,0;4,0;10,0;5,0;25,0;;19,0;4,0;;;;12,0;4,0;1,0;13,0;10,0;3,0;;1,0;;1,0;;17,0;;1,0;;;12,0;2,0;13,0;35,0;9,0;2,0;2,0;2,0;;;62,0;3,0;;;;46,0;1,0;;;;;;2,0;82,0;1,0;3,0;;2,0;10,0;;;3,0;5,0;1,0;5,0;2,0;;2,0;20,0;32,0;2,0;60,0;;15,0;17,0;;17,0;;;;;;;;;23,0;;3,0;;1,0;10,0;;7,0;;9,0;2,0;2,0;4,0;3,0;;1,0;2,0;;44,0;;;8,0;;5,0;;;5,0;3,0;18,0;21,0;2,0;;6,0;;5,0;4,0;;;1,0;;;;;2,0;;;5,0;1,0;4,0;1,0;58,0;;17,0;1,0;9,0;134,0;8,0;5,0;20,0;4,0;10,0;10,0;;;;;;;4,0;;21,0;3,0;1,0;;9,0;;3,0;3,0;1,0;;18,0;;;1,0;;;1,0;;;;;;26,0;;;9,0;1,0;;;;;1,0;;4,0;;8,0;;2,0;34,0;10,0;;;;2,0;10,0;;;2,0;30,0;;3,0;;;1,0;;1,0;;;;;;;4,0;1,0;;;6,0;;12,0;1,0;;1,0;2,0;3,0;;;6,0;;;10,0;5,0;;;3,0;;;;4,0;8,0;9,0;2,0;69,0;;;4,0;;;;;4,0;;1,0;8,0;3,0;;3,0;;;2,0;;;;12,0;1,0;;1,0;2,0;;;;8,0;;;;7,0;;;;1,0;;;12,0;;;;;;;;;;2,0;5,0;40,0;3,0;1,0;;;8,0;;9,0;;11,0;;3,0;;;;;8,0;;;;;10,0;;;;;40,0;;;;3,0;1,0;10,0;;58,0;4,0;;;;3,0;16,0;;;;;3,0;;;;1,0;15,0;7,0;;20,0;;;;70,0;;;4,0;;;;;126,0;131,0;1,0;;3,0;;1,0;;;4,0;;4,0;2,0;;14,0;8,0;1,0;;4,0;1,0;;;6,0;10,0;3,0;2,0;;;1,0;2,0;2,0;167,0;;;3,0;27,0;1,0;8,0;1,0;40,0;8,0;;;40,0;1,0;;70,0;3,0;1,0;;5,0;;;2,0;;2,0;;;4,0;;1,0;5,0;1,0;1,0;;4,0;4,0;;23,0;5,0;47,0;;;3,0;;22,0;2,0;;;;;3,0;;2,0;;;;;;3,0;;;;;2,0;;;;;1,0;2,0;1,0;;;;;;;;;;;;;11,0;;;;;;;2,0;1,0;1,0;4,0;;;;;1,0;2,0;;;;1,0;;;8,0;;;;;;;;;;;;;;;;2,0;1,0;;;;1,0;;;;;;;3,0;;;1,0;;5,0;;;;;;;3,0;;;;;;7,0;;;1,0;1,0;;2,0;;;;;;1,0;;;3,0;;;;;;1,0;9,0;;;;8,0;1,0;;;3,0;;;12,0;;13,0;3,0;;;;10,0;;;;;1,0;1,0;;;2,0;8,0;;;9,0;10,0;;11,0;4,0;;;;;2,0;;13,0;10,0;;36,0;5,0;1,0;;;;;;;;;4,0;;;;1,0;;;;;;;;;;;;;;;;1,0;;;;;;;2,0;;;;;3,0;2,0;;
operative;2,0;;;1,0;;9,0;4,0;2,0;5,0;;;;;2,0;;;17,0;;;3,0;;;4,0;;4,0;;;7,0;2,0;;2,0;7,0;1,0;;2,0;18,0;2,0;14,0;1,0;;9,0;21,0;;1,0;9,0;;;10,0;;;4,0;;;;5,0;2,0;3,0;;1,0;14,0;;1,0;;;53,0;;1,0;;;;;18,0;11,0;;;1,0;;4,0;;9,0;;;2,0;;10,0;;;19,0;3,0;;1,0;1,0;;;;;17,0;4,0;18,0;4,0;2,0;;;4,0;13,0;26,0;;7,0;;;;;4,0;;;;;3,0;5,0;12,0;1,0;;13,0;;;3,0;23,0;6,0;;;4,0;;;33,0;;;2,0;;5,0;;;;;;;6,0;;;1,0;;;;2,0;;;;;;;;;2,0;;1,0;1,0;;5,0;5,0;;;2,0;;1,0;;;;;1,0;;;;;;;;;1,0;4,0;;;;;;;;;2,0;;;;;;;;8,0;2,0;;;;3,0;4,0;2,0;;;;;11,0;;;6,0;;;2,0;;;;4,0;;;;;;1,0;;3,0;;;;;;;;;;;4,0;;;;1,0;;;;;;;;1,0;;;;;;1,0;5,0;;;;;;;;6,0;;;;;;;;;;7,0;4,0;;;;;4,0;;;;3,0;;;1,0;5,0;1,0;;;;;;2,0;;;;9,0;;8,0;;;;;;;;;;;1,0;3,0;;1,0;;;;;;;;1,0;;;4,0;;;;;;;;;;;;;;;;;;;;1,0;;;;6,0;1,0;;;;;1,0;;;;;;;;2,0;;;;;;;;12,0;;;1,0;;9,0;;;;;;;1,0;1,0;;1,0;;;3,0;4,0;;1,0;1,0;4,0;;;;;;2,0;;;;;1,0;;;;6,0;;;;;;;12,0;;1,0;;;3,0;;;;;;;;;7,0;;;3,0;4,0;;;;;2,0;;;1,0;4,0;;;;;10,0;;;2,0;;2,0;;;1,0;;;;;;1,0;7,0;2,0;;;;;9,0;2,0;;;1,0;2,0;;;19,0;4,0;;3,0;;1,0;;;1,0;;;;4,0;;;3,0;;;;;;;;1,0;;;;;;1,0;;;;;9,0;;;;;;6,0;;;;3,0;;;;3,0;;;;;4,0;;;1,0;;;;;;;;;;;2,0;1,0;;;1,0;;;;1,0;;;;;;;;;;;;;;1,0;;;;2,0;9,0;;;;;;;;1,0;;;;;;;;;;;2,0;;;;;;;;;3,0;;1,0;;;;;;;;;2,0;;;;;;;;;;;;;;;;;;;;;;4,0;;;;;;;;;;;;;;;;;;;;;;;2,0;;;;;;4,0;2,0;;;;;;;;;;;;;;2,0;;;;;;7,0;4,0;;;;;;;;;;;3,0;1,0;;;;;;;;;;;1,0;;;;;;;;;;;;;;;;;;;3,0;;;;2,0;;;;;;;;2,0;2,0;;;;;;;;;;;;;;6,0;;;;;;;;;;;;;;;;;;;;;;;;;;;;;1,0;1,0;1,0;;;;;;;;;;;2,0;;;;;;;;;;;;;;;;;;;;;4,0;1,0;;;;;;;;;;;;;;;2,0;;;;;;;4,0;;;;;;;;;5,0;;;;;;;;;;;1,0;;;;;;;;;;1,0;;;;;;;;;;;;;1,0;;;;;;;;;;;1,0;;;;;;;;;;;;;;;2,0;;;;;;;;;;;;5,0;;;;;;4,0;;;;;;;1,0;;;;;5,0;;;;;;;;;;;;;;;;;;;;;;;;;;;;;;;;;;;;;;;;;;;;;;;;;;;;;
optical;53,0;58,0;30,0;159,0;53,0;449,0;327,0;1547,0;;;75,0;49,0;229,0;343,0;3,0;3,0;338,0;6,0;285,0;116,0;65,0;7,0;35,0;7,0;30,0;77,0;22,0;340,0;22,0;85,0;836,0;63,0;171,0;105,0;20,0;226,0;140,0;77,0;67,0;36,0;203,0;1244,0;49,0;331,0;170,0;566,0;76,0;1787,0;76,0;114,0;4,0;32,0;162,0;95,0;259,0;542,0;543,0;;76,0;190,0;48,0;2,0;1175,0;8,0;3234,0;12,0;1049,0;28,0;33,0;83,0;372,0;4986,0;974,0;19,0;46,0;21,0;96,0;83,0;23,0;20,0;453,0;15,0;43,0;71,0;988,0;268,0;19,0;;97,0;63,0;33,0;23,0;277,0;22,0;115,0;9,0;261,0;494,0;712,0;263,0;792,0;118,0;84,0;49,0;114,0;87,0;1,0;8,0;113,0;24,0;4,0;73,0;148,0;14,0;2,0;4,0;16,0;136,0;80,0;1481,0;5,0;5,0;551,0;43,0;68,0;25,0;2267,0;23,0;34,0;141,0;160,0;22,0;1,0;1270,0;25,0;11,0;315,0;52,0;333,0;;10,0;67,0;;;423,0;79,0;145,0;285,0;73,0;58,0;38,0;72,0;152,0;29,0;;21,0;30,0;26,0;;30,0;31,0;83,0;5,0;196,0;14,0;8,0;203,0;92,0;15,0;64,0;133,0;32,0;83,0;2162,0;11,0;29,0;97,0;101,0;27,0;12,0;31,0;19,0;15,0;103,0;;25,0;634,0;30,0;206,0;171,0;3,0;1,0;6,0;64,0;190,0;41,0;374,0;165,0;102,0;18,0;5,0;88,0;45,0;3,0;80,0;54,0;340,0;;221,0;232,0;460,0;214,0;70,0;8,0;8,0;79,0;109,0;327,0;21,0;968,0;78,0;59,0;;23,0;52,0;;494,0;3,0;11,0;67,0;9,0;48,0;132,0;55,0;49,0;1,0;111,0;63,0;4,0;45,0;27,0;73,0;36,0;;13,0;69,0;51,0;77,0;435,0;21,0;1,0;20,0;33,0;115,0;112,0;50,0;230,0;653,0;26,0;1,0;23,0;61,0;39,0;42,0;55,0;;6,0;86,0;3,0;154,0;5,0;35,0;160,0;43,0;101,0;14,0;70,0;305,0;33,0;102,0;24,0;113,0;5188,0;58,0;;12,0;177,0;44,0;62,0;55,0;179,0;34,0;7,0;24,0;9,0;13,0;317,0;53,0;18,0;21,0;14,0;12,0;16,0;237,0;;25,0;6,0;19,0;70,0;928,0;37,0;;37,0;3,0;27,0;;165,0;16,0;29,0;49,0;68,0;475,0;61,0;33,0;2,0;14,0;159,0;5,0;440,0;33,0;20,0;2,0;8,0;33,0;39,0;22,0;1,0;;19,0;9,0;114,0;109,0;41,0;3,0;2,0;43,0;16,0;142,0;12,0;40,0;73,0;2,0;21,0;3,0;38,0;29,0;12,0;30,0;64,0;6,0;43,0;;4,0;67,0;;54,0;11,0;38,0;3,0;8,0;8,0;;102,0;274,0;104,0;25,0;61,0;13,0;8,0;5,0;209,0;86,0;;14,0;10,0;153,0;12,0;39,0;8,0;8,0;3,0;12,0;18,0;286,0;38,0;201,0;7,0;46,0;31,0;13,0;11,0;48,0;7,0;31,0;9,0;69,0;18,0;19,0;73,0;18,0;15,0;182,0;;58,0;76,0;55,0;316,0;2,0;3,0;13,0;10,0;14,0;13,0;22,0;4,0;454,0;9,0;56,0;8,0;7,0;77,0;;16,0;;15,0;7,0;13,0;207,0;21,0;6,0;26,0;32,0;14,0;169,0;3,0;25,0;13,0;15,0;87,0;10,0;1,0;21,0;6,0;73,0;37,0;;5,0;81,0;8,0;20,0;40,0;7,0;;28,0;4,0;11,0;16,0;;4,0;;15,0;15,0;12,0;76,0;14,0;3,0;74,0;5,0;1,0;4,0;241,0;11,0;9,0;127,0;19,0;32,0;107,0;15,0;53,0;3,0;8,0;2,0;8,0;91,0;21,0;18,0;22,0;24,0;7,0;214,0;21,0;19,0;18,0;4,0;41,0;38,0;16,0;;3,0;1,0;22,0;14,0;1,0;;10,0;6,0;12,0;66,0;;1,0;28,0;2,0;7,0;20,0;1,0;;6,0;3,0;22,0;;2,0;;4,0;92,0;31,0;1,0;13,0;6,0;40,0;26,0;2,0;4,0;108,0;69,0;;6,0;;3,0;2,0;22,0;6,0;4,0;53,0;4,0;9,0;3,0;2,0;14,0;;;1,0;32,0;39,0;15,0;;3,0;47,0;5,0;6,0;21,0;;17,0;;18,0;181,0;94,0;2,0;10,0;21,0;33,0;2,0;39,0;166,0;42,0;15,0;20,0;29,0;4,0;52,0;58,0;4,0;;;6,0;;;5,0;49,0;12,0;;2,0;1,0;3,0;36,0;2,0;1,0;;26,0;13,0;1,0;8,0;45,0;23,0;18,0;9,0;1,0;;2,0;;86,0;;;40,0;11,0;;;81,0;;;3,0;3,0;;8,0;4,0;126,0;;6,0;7,0;450,0;15,0;;3,0;34,0;10,0;3,0;14,0;3,0;12,0;;24,0;31,0;3,0;15,0;9,0;13,0;11,0;31,0;10,0;41,0;12,0;38,0;3,0;12,0;12,0;32,0;4,0;9,0;15,0;7,0;5,0;136,0;6,0;24,0;9,0;2,0;9,0;1,0;4,0;137,0;2,0;;2,0;;31,0;8,0;9,0;8,0;45,0;24,0;15,0;6,0;2,0;1,0;14,0;1,0;76,0;;5,0;;8,0;5,0;1,0;12,0;201,0;184,0;5,0;3,0;39,0;70,0;15,0;74,0;1,0;31,0;10,0;9,0;124,0;6,0;30,0;66,0;23,0;3,0;5,0;15,0;2,0;13,0;43,0;11,0;10,0;33,0;11,0;2,0;17,0;11,0;40,0;251,0;;5,0;11,0;58,0;5,0;15,0;1,0;10,0;11,0;;54,0;109,0;27,0;4,0;15,0;9,0;36,0;36,0;5,0;37,0;19,0;;65,0;7,0;29,0;9,0;76,0;;3,0;;5,0;19,0;2,0;6,0;3,0;17,0;6,0;93,0;48,0;;2,0;7,0;2,0;15,0;;;7,0;;4,0;104,0;4,0;1,0;11,0;4,0;2,0;4,0;1,0;53,0;;;1,0;21,0;1,0;;3,0;3,0;;18,0;12,0;26,0;1,0;;6,0;69,0;7,0;3,0;5,0;9,0;8,0;;4,0;21,0;14,0;;;17,0;59,0;;1,0;27,0;3,0;23,0;7,0;19,0;2,0;;5,0;25,0;11,0;40,0;24,0;;2,0;16,0;2,0;6,0;14,0;;4,0;3,0;10,0;27,0;5,0;8,0;;3,0;9,0;8,0;3,0;9,0;1,0;30,0;2,0;4,0;63,0;1,0;35,0;77,0;19,0;;23,0;37,0;44,0;7,0;11,0;2,0;2,0;220,0;17,0;51,0;11,0;4,0;;;5,0;;6,0;;2,0;164,0;1,0;19,0;1,0;3,0;28,0;8,0;5,0;2,0;;;;7,0;7,0;4,0;;;10,0;1,0;3,0;7,0;8,0;21,0;6,0;43,0;15,0;14,0;;31,0;;2,0;2,0;14,0;4,0;7,0;28,0;;1,0;19,0;2,0;;3,0;76,0;20,0;102,0;9,0;;1,0;;35,0;9,0;125,0;1,0;2,0;2,0;6,0;44,0;3,0;21,0;3,0;66,0;2,0;;81,0;6,0;;125,0;22,0;;28,0;;2,0;;18,0;1,0;13,0;2,0;9,0;34,0;60,0;7,0;;;12,0;4,0;;;;;5,0;;;1,0;21,0;7,0;23,0;;7,0;5,0;;7,0;;69,0;;;8,0;20,0;711,0;;5,0;1,0;;;2,0;;
optics;2,0;;20,0;31,0;;28,0;181,0;16,0;;;;;47,0;7,0;;;10,0;;11,0;8,0;2,0;;;;1,0;1,0;;84,0;;3,0;24,0;1,0;2,0;;1,0;5,0;12,0;2,0;;6,0;3,0;35,0;1,0;8,0;8,0;28,0;;65,0;;;;2,0;18,0;;22,0;30,0;34,0;;4,0;2,0;2,0;;;;160,0;;52,0;1,0;;;4,0;298,0;94,0;1,0;6,0;;;2,0;;;42,0;;;;58,0;13,0;3,0;97,0;;1,0;;1,0;2,0;;2,0;;9,0;20,0;100,0;1,0;25,0;;1,0;27,0;2,0;10,0;;;3,0;;;;12,0;;;;2,0;16,0;15,0;133,0;;;2,0;;;;60,0;;1,0;4,0;1,0;;;8,0;;14,0;14,0;3,0;1,0;;;7,0;;;10,0;;7,0;12,0;13,0;;;2,0;6,0;;;;;;;;4,0;17,0;2,0;;;;23,0;14,0;;;1,0;;7,0;10,0;;;;1,0;2,0;;;1,0;;3,0;2,0;4,0;7,0;;;9,0;;;;10,0;5,0;4,0;98,0;1,0;6,0;6,0;;2,0;;;1,0;;2,0;;3,0;9,0;5,0;17,0;9,0;;;18,0;2,0;6,0;;11,0;9,0;8,0;;;;;17,0;1,0;1,0;9,0;;2,0;2,0;;;;5,0;;;;;2,0;;;2,0;3,0;6,0;;4,0;;;;6,0;9,0;11,0;1,0;;35,0;;;1,0;3,0;;7,0;;1,0;;;;13,0;;;8,0;1,0;2,0;;2,0;2,0;4,0;3,0;1,0;4,0;23,0;11,0;;;15,0;;25,0;;;9,0;;6,0;2,0;;18,0;4,0;;;1,0;;5,0;2,0;;;;5,0;;119,0;;;;;13,0;;5,0;2,0;2,0;;3,0;19,0;;;1,0;;;;1,0;;;;;;2,0;;;;;;2,0;;3,0;;;;;12,0;;;;;;4,0;;10,0;1,0;;19,0;;;;;;;;;;;;;;1,0;1,0;2,0;;2,0;;;;12,0;;;3,0;;7,0;;1,0;;;2,0;;;26,0;1,0;1,0;3,0;;;;;;10,0;20,0;3,0;1,0;;;15,0;5,0;;5,0;;;1,0;3,0;;4,0;;;;;;;;30,0;;;;3,0;7,0;;1,0;;;4,0;;;9,0;;1,0;;;8,0;;3,0;;;2,0;;2,0;;;4,0;;1,0;;;;;;1,0;;;8,0;;;;;;;;;1,0;1,0;;2,0;;;;;;;;6,0;;2,0;17,0;;;;;;7,0;4,0;;1,0;;;;26,0;1,0;;;2,0;1,0;4,0;;;;;;;;;2,0;3,0;;;;4,0;4,0;1,0;;;;;;;;;;;1,0;7,0;;;1,0;;6,0;;;3,0;2,0;;;;;;;;;;;;;;;;;;;;1,0;;;;;;;;1,0;;9,0;48,0;4,0;;;;;;1,0;2,0;2,0;;;;;;;;;;;;;;;;;3,0;;;1,0;;;;;;;;;2,0;;1,0;;;;;105,0;;;2,0;;;;;;;;;;;;;;;;;;;;;;;;;;;;2,0;;1,0;;2,0;1,0;;;;;;;;6,0;;;;;;;26,0;;;;;5,0;;;;;;;;;2,0;;8,0;47,0;10,0;;;;;;;6,0;1,0;;;;;5,0;;;;;;4,0;;;;;;;;2,0;;1,0;;;;;1,0;;;;;;;3,0;;10,0;2,0;2,0;89,0;;;;1,0;;;;;6,0;;;10,0;1,0;;;;;;;2,0;;;;2,0;1,0;;14,0;;;;;;;;;;1,0;16,0;;;;;1,0;;;;;;;17,0;;;;;2,0;;;;;;;;;;;;;;8,0;;;;;;;;4,0;2,0;;;;18,0;;;;;4,0;;;;;;1,0;;;1,0;;;;;;;;19,0;;1,0;;;;;;2,0;;1,0;;;;;;;;7,0;;;3,0;;8,0;;2,0;;;1,0;;;;;;;;;;;2,0;;;;;;;;;;;;;;;;;;;;;;;;;;;;;12,0;7,0;;;1,0;;;;;;4,0;;;;;;;;;;15,0;;1,0;;;;;;1,0;;;4,0;;;;;;;;;;;;;;;;;;;;;;;1,0;;;;1,0;;;;;;;;;1,0;;;;1,0;;;;;;;;;2,0;;1,0;;;;;;;;;;;
order;1,0;6,0;7,0;14,0;;21,0;10,0;18,0;6,0;;;1,0;;30,0;4,0;7,0;30,0;;28,0;16,0;1,0;;62,0;;4,0;12,0;;28,0;8,0;2,0;24,0;7,0;17,0;6,0;;94,0;10,0;3,0;16,0;1,0;71,0;49,0;6,0;22,0;22,0;9,0;2,0;66,0;4,0;9,0;9,0;;;3,0;10,0;3,0;20,0;;4,0;48,0;1,0;12,0;74,0;;424,0;2,0;128,0;7,0;1,0;;10,0;316,0;24,0;;1,0;7,0;8,0;2,0;5,0;10,0;41,0;1,0;8,0;8,0;31,0;6,0;;63,0;1,0;;14,0;;1,0;8,0;5,0;;86,0;3,0;87,0;17,0;49,0;34,0;;10,0;17,0;35,0;9,0;1,0;15,0;;;13,0;16,0;;;;7,0;7,0;8,0;26,0;13,0;1,0;53,0;14,0;4,0;6,0;96,0;1,0;1,0;;20,0;;;83,0;1,0;;36,0;;49,0;;;3,0;;;13,0;2,0;18,0;53,0;4,0;3,0;4,0;10,0;7,0;1,0;;;3,0;1,0;1,0;;1,0;11,0;9,0;3,0;;;3,0;6,0;9,0;7,0;;1,0;1,0;38,0;;;;1,0;;;;;4,0;3,0;3,0;2,0;25,0;6,0;25,0;8,0;;;10,0;1,0;;2,0;7,0;5,0;5,0;;;10,0;1,0;;5,0;2,0;9,0;;6,0;12,0;22,0;10,0;5,0;;2,0;4,0;7,0;;3,0;2,0;9,0;2,0;4,0;3,0;2,0;;14,0;1,0;7,0;22,0;3,0;9,0;2,0;1,0;4,0;1,0;;1,0;;6,0;;;;;2,0;35,0;;13,0;307,0;9,0;;;3,0;6,0;7,0;;6,0;16,0;;;11,0;13,0;3,0;18,0;1,0;;;3,0;1,0;2,0;;1,0;3,0;;;;10,0;12,0;;12,0;2,0;;31,0;10,0;1,0;3,0;5,0;1,0;13,0;;9,0;4,0;;;2,0;;14,0;4,0;1,0;5,0;;;;;;1,0;;1,0;1,0;30,0;;1,0;2,0;;22,0;2,0;5,0;2,0;1,0;3,0;4,0;314,0;3,0;1,0;;;;;24,0;2,0;;;2,0;;4,0;1,0;1,0;;;;5,0;25,0;3,0;2,0;1,0;13,0;3,0;4,0;;1,0;1,0;;3,0;;9,0;;3,0;;22,0;10,0;1,0;;1,0;2,0;;2,0;;4,0;;;;;1,0;2,0;25,0;6,0;;1,0;2,0;;42,0;4,0;;1,0;5,0;32,0;1,0;6,0;1,0;9,0;;6,0;21,0;14,0;;13,0;;13,0;3,0;;;13,0;1,0;9,0;12,0;12,0;6,0;8,0;13,0;1,0;;9,0;1,0;2,0;9,0;10,0;4,0;2,0;;;3,0;7,0;;4,0;3,0;22,0;;10,0;;2,0;8,0;1,0;9,0;;5,0;2,0;1,0;7,0;5,0;2,0;1,0;5,0;;;;2,0;;;28,0;1,0;;;5,0;2,0;1,0;1,0;1,0;7,0;;8,0;5,0;8,0;;6,0;;1,0;3,0;3,0;;3,0;2,0;16,0;4,0;6,0;4,0;2,0;25,0;3,0;2,0;4,0;8,0;;;24,0;;1,0;23,0;1,0;1,0;3,0;;2,0;5,0;;1,0;3,0;12,0;;;;3,0;1,0;1,0;4,0;8,0;9,0;;;2,0;2,0;1,0;4,0;;;;;;9,0;5,0;;13,0;;;;;2,0;;;2,0;;5,0;1,0;2,0;11,0;21,0;;8,0;;10,0;18,0;;;2,0;11,0;;7,0;;;2,0;;1,0;;5,0;4,0;3,0;1,0;6,0;6,0;;1,0;1,0;1,0;1,0;9,0;4,0;1,0;2,0;1,0;2,0;3,0;;1,0;1,0;;10,0;1,0;1,0;1,0;;;;;3,0;;3,0;;;1,0;2,0;12,0;;4,0;;2,0;;4,0;;;2,0;;5,0;;1,0;9,0;;;;;3,0;;12,0;1,0;;3,0;;;1,0;;17,0;;1,0;1,0;2,0;4,0;;;1,0;;;2,0;;3,0;3,0;10,0;;;;1,0;10,0;1,0;;;;;1,0;4,0;30,0;;14,0;1,0;;;;5,0;7,0;1,0;2,0;4,0;11,0;;;;1,0;;3,0;;3,0;;;;10,0;;;1,0;2,0;3,0;;;2,0;;;;;5,0;1,0;12,0;1,0;;;1,0;;;2,0;3,0;8,0;10,0;;1,0;;2,0;27,0;;2,0;21,0;36,0;;4,0;;;6,0;6,0;;;2,0;;10,0;3,0;2,0;;4,0;;1,0;;;3,0;;;1,0;;;;1,0;;2,0;9,0;;3,0;2,0;13,0;;5,0;;;;;;;1,0;;;;;;1,0;;1,0;;2,0;1,0;;;3,0;;;;1,0;;1,0;;;11,0;;28,0;;;;;;3,0;;9,0;;;8,0;3,0;1,0;1,0;2,0;;;;;8,0;;;2,0;2,0;7,0;;;;;4,0;7,0;;;;2,0;1,0;7,0;;1,0;1,0;2,0;;24,0;;6,0;;;;2,0;;;1,0;;2,0;13,0;3,0;1,0;2,0;;;3,0;2,0;5,0;5,0;1,0;;2,0;;;;6,0;3,0;;;1,0;2,0;;;1,0;;1,0;1,0;2,0;6,0;3,0;1,0;;;5,0;;6,0;;;2,0;;1,0;;3,0;3,0;;8,0;7,0;1,0;1,0;;;;;;8,0;;2,0;2,0;;;;;3,0;;14,0;;;;;;;;;4,0;;;1,0;;;2,0;;;;2,0;1,0;;3,0;;2,0;;;;;;1,0;;;3,0;4,0;1,0;;;;1,0;;;;;;;;;;;1,0;;;;;13,0;;;;;;;;;3,0;;4,0;;;8,0;3,0;;1,0;;;;;;1,0;;;;5,0;;15,0;;;1,0;;;;;;1,0;;8,0;1,0;;6,0;;;;;;;31,0;;
parameter;7,0;10,0;2,0;226,0;28,0;89,0;73,0;7,0;;3,0;;1,0;;370,0;;30,0;154,0;;3,0;53,0;;4,0;38,0;9,0;20,0;4,0;15,0;21,0;19,0;17,0;172,0;45,0;40,0;223,0;;247,0;99,0;7,0;65,0;4,0;487,0;187,0;4,0;33,0;40,0;;65,0;22,0;12,0;49,0;121,0;;;30,0;18,0;56,0;9,0;4,0;3,0;191,0;;2,0;94,0;5,0;983,0;4,0;328,0;11,0;10,0;;13,0;90,0;51,0;;1,0;4,0;;13,0;4,0;29,0;478,0;;36,0;227,0;90,0;1,0;1,0;33,0;;14,0;;;;9,0;10,0;;53,0;44,0;366,0;44,0;108,0;66,0;;28,0;102,0;68,0;2,0;17,0;13,0;;;32,0;52,0;1,0;1,0;4,0;7,0;52,0;37,0;97,0;23,0;;91,0;30,0;19,0;75,0;291,0;;8,0;2,0;80,0;5,0;7,0;85,0;8,0;;74,0;29,0;17,0;;;6,0;2,0;2,0;3,0;35,0;8,0;4,0;140,0;1,0;1,0;8,0;5,0;;;;;;1,0;;;3,0;10,0;33,0;;14,0;4,0;5,0;11,0;23,0;13,0;9,0;10,0;23,0;;6,0;2,0;1,0;12,0;;3,0;;;14,0;;;51,0;;89,0;1,0;2,0;;;8,0;;;;;1,0;2,0;;38,0;5,0;1,0;32,0;31,0;4,0;1,0;;5,0;2,0;24,0;7,0;;;;50,0;6,0;4,0;14,0;25,0;;;;1,0;;23,0;2,0;5,0;13,0;;4,0;24,0;25,0;;1,0;7,0;1,0;;37,0;;1,0;;;;135,0;3,0;2,0;;2,0;;;;6,0;;;;6,0;;;11,0;45,0;16,0;85,0;;;;2,0;13,0;5,0;;;8,0;12,0;;;8,0;41,0;;12,0;;25,0;29,0;;3,0;;;1,0;6,0;;;79,0;;;2,0;;55,0;17,0;4,0;;;;;9,0;;;1,0;1,0;21,0;196,0;;;4,0;;7,0;;22,0;;1,0;2,0;15,0;85,0;;2,0;1,0;;;;2,0;;;;;;11,0;2,0;;;6,0;;5,0;44,0;43,0;;;;13,0;21,0;;;;;8,0;;34,0;19,0;2,0;;186,0;18,0;8,0;1,0;1,0;7,0;3,0;46,0;2,0;11,0;6,0;19,0;1,0;;163,0;18,0;84,0;12,0;5,0;20,0;45,0;26,0;460,0;87,0;3,0;24,0;1,0;58,0;20,0;73,0;;14,0;4,0;3,0;34,0;36,0;3,0;59,0;1,0;70,0;87,0;25,0;;38,0;1,0;30,0;22,0;37,0;43,0;34,0;71,0;6,0;;4,0;;181,0;125,0;32,0;1,0;7,0;;6,0;;19,0;2,0;14,0;14,0;111,0;11,0;22,0;12,0;1,0;7,0;1,0;111,0;2,0;13,0;;20,0;24,0;10,0;4,0;11,0;6,0;34,0;52,0;111,0;22,0;9,0;2,0;38,0;4,0;;4,0;5,0;9,0;1,0;;21,0;379,0;2,0;6,0;124,0;38,0;2,0;18,0;;10,0;9,0;;1,0;;5,0;14,0;44,0;27,0;;;;1,0;5,0;2,0;;;;22,0;2,0;16,0;60,0;21,0;1,0;27,0;30,0;6,0;;6,0;;;8,0;7,0;3,0;4,0;12,0;92,0;1,0;3,0;14,0;14,0;15,0;;4,0;9,0;5,0;16,0;2,0;;11,0;45,0;;22,0;1,0;;20,0;1,0;;2,0;1,0;;1,0;;;;;4,0;;;17,0;;34,0;1,0;1,0;28,0;;3,0;;4,0;4,0;9,0;1,0;23,0;;10,0;;;51,0;8,0;13,0;6,0;;19,0;;;23,0;9,0;16,0;1,0;62,0;6,0;38,0;2,0;2,0;34,0;;;8,0;;9,0;27,0;5,0;26,0;;;19,0;;;;13,0;;;6,0;4,0;8,0;;4,0;2,0;6,0;;3,0;5,0;;44,0;1,0;17,0;2,0;3,0;36,0;2,0;6,0;;10,0;36,0;1,0;4,0;;33,0;1,0;6,0;;;3,0;10,0;3,0;1,0;;17,0;18,0;;;;;;2,0;2,0;;;12,0;5,0;;;;;8,0;;12,0;;11,0;3,0;;;;4,0;;7,0;9,0;58,0;24,0;14,0;1,0;6,0;9,0;30,0;21,0;3,0;4,0;22,0;1,0;8,0;;;9,0;;2,0;19,0;;;3,0;49,0;15,0;6,0;33,0;48,0;13,0;;2,0;;5,0;1,0;7,0;55,0;4,0;;;;;3,0;;3,0;;6,0;1,0;;;6,0;3,0;9,0;7,0;14,0;;;;;18,0;;2,0;;2,0;3,0;13,0;2,0;1,0;9,0;2,0;6,0;;;;;;;;47,0;5,0;;2,0;;8,0;50,0;27,0;3,0;;41,0;;23,0;;;;;4,0;1,0;;;9,0;;;;;1,0;;;;;4,0;;;;;;9,0;;;;;30,0;;61,0;;;;;;;;1,0;;;1,0;;11,0;;3,0;6,0;;3,0;;31,0;;;;3,0;;;;;;;141,0;;7,0;;15,0;;56,0;;1,0;;;2,0;10,0;;3,0;21,0;;;6,0;;;;6,0;1,0;8,0;16,0;;;;25,0;;2,0;5,0;13,0;2,0;;;22,0;;;;14,0;26,0;1,0;;5,0;;4,0;58,0;;9,0;28,0;6,0;38,0;9,0;;;1,0;1,0;;4,0;;;;;;1,0;8,0;8,0;1,0;3,0;75,0;7,0;1,0;7,0;44,0;1,0;;;;1,0;;1,0;;2,0;8,0;2,0;21,0;9,0;1,0;13,0;2,0;;;35,0;;;1,0;3,0;1,0;3,0;2,0;4,0;;1,0;;;;1,0;;2,0;;2,0;;;;4,0;;;23,0;;;5,0;11,0;7,0;1,0;;;;;3,0;;;;;;;10,0;10,0;2,0;;;;;;;;4,0;;1,0;;;;1,0;3,0;11,0;17,0;;;1,0;;;;10,0;2,0;;;;;;;2,0;;2,0;10,0;;;;64,0;6,0;6,0;8,0;15,0;;6,0;7,0;3,0;6,0;;;3,0;;;1,0;6,0;;
partially;1,0;1,0;;18,0;;14,0;18,0;34,0;;;2,0;;21,0;34,0;;2,0;19,0;2,0;5,0;;5,0;1,0;11,0;;;11,0;;31,0;;6,0;100,0;;14,0;1,0;;18,0;11,0;5,0;3,0;;31,0;53,0;3,0;10,0;15,0;106,0;10,0;73,0;;;5,0;;54,0;;112,0;;12,0;;;11,0;3,0;;4,0;11,0;104,0;8,0;33,0;;;;3,0;94,0;79,0;;;;19,0;1,0;;5,0;42,0;;8,0;11,0;18,0;2,0;1,0;23,0;1,0;;;;14,0;;6,0;;10,0;6,0;39,0;9,0;85,0;;4,0;4,0;16,0;4,0;;1,0;;;;2,0;41,0;;1,0;;2,0;18,0;6,0;15,0;;14,0;5,0;;;5,0;40,0;;2,0;5,0;12,0;;4,0;26,0;3,0;;137,0;6,0;;;11,0;7,0;;;28,0;3,0;39,0;17,0;14,0;16,0;;30,0;57,0;6,0;;4,0;3,0;;;2,0;29,0;3,0;;1,0;;;19,0;63,0;;1,0;4,0;;3,0;27,0;4,0;4,0;2,0;4,0;3,0;;1,0;;16,0;9,0;2,0;5,0;10,0;7,0;7,0;28,0;;;6,0;1,0;3,0;3,0;109,0;17,0;19,0;10,0;4,0;12,0;;1,0;1,0;;17,0;1,0;22,0;50,0;;3,0;;;;19,0;2,0;6,0;4,0;7,0;12,0;1,0;;10,0;16,0;;158,0;4,0;1,0;2,0;8,0;15,0;3,0;;11,0;5,0;;;;3,0;1,0;3,0;;;2,0;5,0;1,0;7,0;36,0;1,0;3,0;1,0;2,0;33,0;55,0;;19,0;105,0;31,0;;;56,0;;17,0;12,0;6,0;;;3,0;5,0;;1,0;;6,0;1,0;;5,0;12,0;;2,0;9,0;;5,0;17,0;;4,0;1,0;1,0;26,0;;15,0;9,0;;35,0;5,0;1,0;1,0;;1,0;3,0;;13,0;12,0;1,0;;5,0;6,0;3,0;;6,0;1,0;;2,0;;5,0;4,0;14,0;11,0;4,0;6,0;7,0;15,0;;140,0;5,0;;;;2,0;2,0;16,0;;;24,0;4,0;;2,0;;;;3,0;;;1,0;2,0;4,0;17,0;10,0;;5,0;;;;;4,0;4,0;1,0;9,0;7,0;;8,0;;;7,0;;2,0;;;;1,0;3,0;;1,0;5,0;2,0;;1,0;;1,0;;10,0;;;;1,0;10,0;1,0;2,0;2,0;4,0;;2,0;;;;7,0;;;1,0;1,0;;4,0;;1,0;;9,0;3,0;2,0;4,0;;2,0;8,0;;3,0;5,0;2,0;2,0;;;;;;;;;94,0;;5,0;;;4,0;;2,0;;;4,0;;;2,0;1,0;;7,0;2,0;1,0;;1,0;;1,0;27,0;3,0;;1,0;;;12,0;1,0;;4,0;;;5,0;;;1,0;;;;;;;1,0;1,0;1,0;6,0;3,0;;;8,0;8,0;;5,0;;1,0;3,0;4,0;1,0;3,0;3,0;;2,0;;;3,0;1,0;;3,0;;;;;;1,0;1,0;;;2,0;3,0;1,0;;;13,0;2,0;4,0;;;7,0;;2,0;4,0;;;14,0;;;;;20,0;2,0;;;1,0;5,0;1,0;9,0;8,0;;;;;;;;4,0;65,0;6,0;3,0;;;8,0;;;2,0;;1,0;2,0;2,0;;;4,0;;3,0;;1,0;12,0;;5,0;;;;;;3,0;;;14,0;2,0;1,0;;8,0;6,0;1,0;;2,0;6,0;1,0;22,0;;4,0;;3,0;;;;;;;2,0;1,0;2,0;;;;;2,0;6,0;;;;;;;;;;;1,0;6,0;;3,0;18,0;;;;15,0;;;1,0;;;;11,0;;;;19,0;;;;;4,0;;;;;;7,0;;2,0;;1,0;;;;3,0;1,0;;;;2,0;;;;;;2,0;;;;20,0;;7,0;;4,0;;;;;1,0;4,0;;;2,0;;1,0;;1,0;;2,0;2,0;;;2,0;;;3,0;14,0;;4,0;;;2,0;;;;1,0;;4,0;13,0;;;;;6,0;;11,0;2,0;;;;2,0;;4,0;2,0;3,0;3,0;2,0;4,0;2,0;;10,0;2,0;;;;4,0;;4,0;16,0;4,0;1,0;1,0;;;1,0;;;1,0;4,0;;;4,0;;3,0;;;4,0;1,0;;74,0;3,0;6,0;1,0;;1,0;;2,0;1,0;;;;;4,0;3,0;1,0;;;;;8,0;25,0;;;;;24,0;;;;2,0;;;;;5,0;;;6,0;;;;;;1,0;4,0;2,0;;;;;;;;3,0;;;;6,0;;1,0;;;;;;4,0;;;;;2,0;;1,0;1,0;;;;;1,0;;;;;;;;;;;;;3,0;2,0;;1,0;9,0;;5,0;;2,0;;;4,0;;;;;;;;;1,0;1,0;;;2,0;;2,0;;;1,0;;;;;;;;;;3,0;;16,0;;;;;;;1,0;;;;;1,0;;;5,0;;6,0;;;;;1,0;;12,0;;1,0;;;;;1,0;;;;1,0;;5,0;;;;;3,0;;;1,0;4,0;;;5,0;;;3,0;;16,0;;;;;3,0;;;4,0;;;;5,0;;;13,0;;;;;;;;;;;2,0;14,0;;;;;;;;;10,0;;;3,0;;1,0;;;;;;;1,0;;;;;;
pass;1,0;;;19,0;26,0;13,0;59,0;19,0;;;1,0;231,0;2,0;55,0;5,0;;53,0;16,0;18,0;;;;48,0;4,0;9,0;;1,0;16,0;1,0;1,0;208,0;14,0;3,0;2,0;;26,0;25,0;3,0;;11,0;40,0;80,0;7,0;25,0;21,0;17,0;2,0;106,0;8,0;4,0;1,0;6,0;14,0;7,0;24,0;5,0;53,0;;23,0;35,0;8,0;10,0;6,0;;219,0;;38,0;1,0;;;;215,0;700,0;1,0;;1,0;7,0;;;2,0;56,0;4,0;13,0;;58,0;5,0;;277,0;2,0;1,0;;14,0;;1,0;;;51,0;37,0;85,0;51,0;56,0;28,0;9,0;13,0;20,0;10,0;1,0;;1,0;26,0;;10,0;38,0;3,0;;1,0;;9,0;11,0;108,0;;;91,0;10,0;228,0;1,0;64,0;;3,0;;23,0;;2,0;39,0;5,0;;22,0;17,0;;1,0;;3,0;;;102,0;15,0;23,0;20,0;3,0;5,0;2,0;32,0;54,0;6,0;;2,0;;13,0;15,0;;2,0;17,0;4,0;10,0;4,0;;23,0;24,0;;10,0;10,0;;24,0;26,0;;27,0;4,0;39,0;5,0;;9,0;;;11,0;9,0;1,0;454,0;4,0;15,0;30,0;2,0;;6,0;5,0;8,0;155,0;71,0;54,0;9,0;6,0;6,0;20,0;4,0;;5,0;;64,0;6,0;35,0;31,0;3,0;;;2,0;5,0;23,0;14,0;22,0;1,0;55,0;6,0;32,0;;9,0;19,0;3,0;126,0;;5,0;2,0;14,0;38,0;36,0;1,0;11,0;4,0;30,0;5,0;;6,0;;1,0;2,0;;3,0;5,0;8,0;7,0;38,0;2,0;9,0;;3,0;17,0;24,0;2,0;16,0;116,0;2,0;21,0;1,0;17,0;5,0;38,0;7,0;;21,0;72,0;;28,0;;27,0;14,0;21,0;1,0;;70,0;21,0;;4,0;;;120,0;10,0;;;8,0;6,0;17,0;13,0;28,0;;9,0;4,0;1,0;5,0;8,0;2,0;1,0;5,0;10,0;;5,0;4,0;2,0;13,0;2,0;6,0;3,0;31,0;;2,0;3,0;;5,0;;22,0;9,0;1,0;1,0;1,0;87,0;4,0;11,0;1,0;;8,0;10,0;9,0;;4,0;;1,0;3,0;3,0;;;;;;9,0;4,0;3,0;45,0;4,0;4,0;2,0;7,0;1,0;4,0;;2,0;7,0;;4,0;8,0;1,0;33,0;21,0;;1,0;;;;1,0;2,0;3,0;;4,0;1,0;3,0;;10,0;108,0;8,0;5,0;4,0;;3,0;2,0;24,0;3,0;1,0;;;41,0;;31,0;;2,0;2,0;;1,0;10,0;1,0;3,0;2,0;3,0;1,0;;;5,0;7,0;2,0;2,0;14,0;;5,0;6,0;7,0;1,0;8,0;;;9,0;7,0;3,0;1,0;;2,0;3,0;3,0;13,0;1,0;;58,0;1,0;19,0;;;21,0;;2,0;2,0;3,0;;3,0;10,0;4,0;16,0;4,0;18,0;7,0;8,0;;1,0;;8,0;37,0;;;6,0;;;11,0;1,0;;1,0;;3,0;5,0;;11,0;3,0;;;;2,0;;15,0;;;3,0;8,0;1,0;11,0;5,0;1,0;1,0;1,0;3,0;;;;7,0;13,0;14,0;;;;;;;4,0;3,0;8,0;;;;;1,0;3,0;1,0;;26,0;5,0;1,0;;;3,0;1,0;16,0;1,0;;1,0;7,0;1,0;6,0;;1,0;12,0;13,0;;2,0;5,0;;;;8,0;;2,0;;;30,0;3,0;8,0;;1,0;1,0;;;1,0;11,0;64,0;;;;1,0;;;;3,0;;;2,0;;;1,0;;3,0;;3,0;4,0;3,0;;;;;9,0;;;;;2,0;8,0;2,0;4,0;;10,0;17,0;;;56,0;27,0;1,0;5,0;31,0;;1,0;;;;;;;;;10,0;3,0;2,0;;;;14,0;3,0;1,0;;14,0;;1,0;;;;11,0;;;;;12,0;9,0;;;13,0;3,0;;;9,0;;;;1,0;;;4,0;2,0;;;17,0;15,0;4,0;;1,0;;;6,0;2,0;1,0;9,0;;;;1,0;;;;;1,0;;2,0;;5,0;;;;25,0;;;;2,0;;23,0;1,0;3,0;4,0;;;;;15,0;;;;;7,0;;1,0;;;;;1,0;7,0;30,0;;2,0;30,0;;3,0;1,0;;6,0;;;20,0;8,0;3,0;;;2,0;;;1,0;7,0;;;14,0;;;1,0;3,0;4,0;1,0;;;;2,0;10,0;2,0;6,0;;;1,0;;;6,0;;1,0;14,0;9,0;4,0;52,0;1,0;15,0;12,0;1,0;;;11,0;;;2,0;3,0;3,0;;;3,0;;9,0;;4,0;2,0;;;4,0;;;;;;1,0;2,0;;15,0;;;2,0;1,0;6,0;3,0;4,0;;;;;13,0;;;10,0;;;;;;4,0;;1,0;9,0;;;;1,0;;4,0;3,0;;;1,0;1,0;3,0;2,0;;;9,0;;1,0;;12,0;;2,0;;3,0;4,0;3,0;;4,0;;;9,0;;1,0;;3,0;;;;1,0;1,0;1,0;;;5,0;6,0;;12,0;;;16,0;;;;;;;;;;5,0;;;;;23,0;1,0;1,0;;2,0;3,0;10,0;;3,0;;1,0;3,0;2,0;;;;2,0;;;4,0;;;;2,0;;;;;1,0;;;;;;;;11,0;;;;;;;;;1,0;;9,0;;7,0;;3,0;1,0;2,0;;1,0;8,0;;4,0;;3,0;;;2,0;2,0;15,0;1,0;4,0;;;1,0;;6,0;;1,0;;2,0;;;6,0;;3,0;1,0;;1,0;;6,0;;;2,0;1,0;;29,0;1,0;;;;;;;;1,0;1,0;6,0;;;15,0;;;3,0;;;;4,0;;2,0;;6,0;2,0;;;;1,0;8,0;;14,0;;;;;32,0;;;;;1,0;;;
peripheral;8,0;;1,0;7,0;;21,0;3,0;12,0;;;;;2,0;38,0;;9,0;53,0;18,0;2,0;;11,0;;2,0;14,0;14,0;;;23,0;2,0;;33,0;2,0;8,0;;;38,0;17,0;1,0;7,0;;10,0;232,0;4,0;3,0;27,0;34,0;;28,0;;;;2,0;19,0;14,0;6,0;;86,0;;;20,0;2,0;;;;172,0;;63,0;2,0;;;;87,0;19,0;;;;8,0;;;1,0;35,0;;5,0;;28,0;5,0;;22,0;;8,0;9,0;;1,0;;1,0;8,0;367,0;3,0;62,0;11,0;38,0;7,0;;;18,0;18,0;;1,0;;;;14,0;212,0;;;;;5,0;1,0;42,0;;3,0;216,0;1,0;;5,0;58,0;;;;;;;58,0;;1,0;18,0;;1,0;;;5,0;;;12,0;;100,0;59,0;4,0;22,0;;10,0;20,0;5,0;;;;1,0;;7,0;1,0;16,0;39,0;;;;3,0;20,0;3,0;;;;4,0;15,0;;106,0;;1,0;5,0;;;;7,0;17,0;;7,0;5,0;3,0;9,0;9,0;;;1,0;1,0;22,0;4,0;22,0;3,0;65,0;2,0;6,0;8,0;;;1,0;;45,0;;17,0;33,0;;;;1,0;1,0;88,0;55,0;;1,0;5,0;;;;2,0;6,0;1,0;251,0;;3,0;;4,0;2,0;;;10,0;1,0;1,0;1,0;2,0;;1,0;23,0;2,0;1,0;3,0;1,0;;10,0;52,0;;1,0;3,0;;5,0;11,0;;12,0;162,0;12,0;;8,0;28,0;3,0;34,0;38,0;;;;1,0;16,0;;2,0;;;;1,0;16,0;5,0;3,0;4,0;2,0;1,0;11,0;;;;;4,0;133,0;10,0;19,0;6,0;;7,0;;;5,0;;6,0;;;20,0;9,0;;;11,0;;8,0;1,0;27,0;;;4,0;;;;38,0;3,0;3,0;;16,0;12,0;34,0;1,0;;3,0;2,0;;2,0;9,0;6,0;;;17,0;5,0;8,0;;;2,0;2,0;2,0;5,0;2,0;;;;10,0;10,0;;2,0;;;;;2,0;2,0;1,0;5,0;21,0;7,0;6,0;;;;1,0;;;;;;;;2,0;12,0;1,0;;16,0;32,0;14,0;;33,0;4,0;;6,0;;14,0;;4,0;;;;1,0;4,0;6,0;8,0;20,0;;3,0;17,0;4,0;;21,0;1,0;71,0;;5,0;;16,0;;8,0;;;;16,0;10,0;11,0;1,0;;;;;;;11,0;;43,0;1,0;6,0;9,0;;5,0;;3,0;;3,0;;;3,0;1,0;4,0;;10,0;;1,0;;4,0;;;12,0;8,0;;13,0;;3,0;;;;;;;1,0;;;;;;;;;;;1,0;19,0;31,0;1,0;;;7,0;;;11,0;1,0;1,0;1,0;;4,0;5,0;;4,0;;4,0;;;5,0;;;;;;;;17,0;;3,0;;;3,0;1,0;;;21,0;3,0;1,0;;;4,0;;4,0;1,0;1,0;7,0;5,0;;;4,0;2,0;1,0;;1,0;;1,0;;;4,0;;1,0;2,0;;1,0;;2,0;;;9,0;;1,0;;;8,0;;3,0;2,0;;;1,0;;;;1,0;;1,0;;;;;;2,0;4,0;;7,0;;;;3,0;5,0;1,0;20,0;;17,0;;1,0;2,0;;;;3,0;;;14,0;41,0;4,0;;;;;;1,0;;;6,0;;;;1,0;;7,0;3,0;1,0;;;2,0;;;;34,0;4,0;;;20,0;9,0;1,0;;;10,0;;;;;;4,0;8,0;;;6,0;;;;1,0;;;1,0;;4,0;;;2,0;;;12,0;;;;;;;2,0;;;;;;1,0;;;;3,0;;3,0;;1,0;4,0;;;;;;;;32,0;;;;;;;;;;2,0;;;5,0;;;;7,0;1,0;;;;;;;;9,0;;;4,0;;;;;1,0;;2,0;2,0;;1,0;;;2,0;;;2,0;;6,0;1,0;;3,0;1,0;;;;;8,0;;3,0;2,0;1,0;10,0;;;;4,0;;;;;;;1,0;7,0;1,0;;;3,0;;3,0;3,0;;3,0;1,0;;;;;;;;;;;4,0;;;2,0;;;11,0;;;;;1,0;1,0;2,0;;1,0;;;;;;;;1,0;4,0;;;;;1,0;;1,0;;;;;;4,0;;;;;;;4,0;;;;;;;;;;;10,0;;;;5,0;;;;;;3,0;;;7,0;2,0;3,0;2,0;2,0;;;1,0;;;;;1,0;;;;;;;1,0;;2,0;;;;;;5,0;;;;;1,0;;1,0;;;;;;;;;;;;;;1,0;1,0;;;;;;;;1,0;2,0;1,0;;;;;;;3,0;1,0;1,0;;;;;;;;;;;;2,0;;;;;;;;;;;3,0;;;;;;;;;1,0;;;1,0;;;;1,0;;;;;2,0;;;;;;;;;4,0;;;;;;;;;;9,0;;;;;;1,0;;;;;;;;6,0;;;;1,0;;;;;;;;;;2,0
photograph;1,0;;;22,0;6,0;95,0;3,0;12,0;;;;;12,0;153,0;;34,0;115,0;;;16,0;;;22,0;;15,0;;;2,0;6,0;52,0;81,0;30,0;9,0;9,0;;76,0;5,0;3,0;21,0;1,0;104,0;160,0;;31,0;94,0;5,0;2,0;13,0;;14,0;16,0;;;15,0;12,0;14,0;18,0;;2,0;68,0;;;13,0;;776,0;2,0;107,0;5,0;;;7,0;215,0;61,0;;4,0;;1,0;1,0;;14,0;172,0;;131,0;14,0;67,0;11,0;;115,0;2,0;5,0;10,0;6,0;;1,0;;;38,0;8,0;223,0;94,0;160,0;34,0;;34,0;56,0;31,0;1,0;9,0;2,0;3,0;;50,0;59,0;10,0;;;8,0;39,0;29,0;53,0;10,0;;26,0;12,0;;51,0;113,0;;;1,0;215,0;1,0;;215,0;6,0;;27,0;13,0;20,0;;;1,0;12,0;2,0;25,0;3,0;64,0;25,0;39,0;18,0;2,0;;71,0;;34,0;;1,0;;;;;6,0;;7,0;;1,0;;16,0;2,0;11,0;5,0;8,0;1,0;71,0;;;1,0;11,0;13,0;;;1,0;;8,0;;1,0;9,0;;88,0;16,0;17,0;1,0;;;;;9,0;4,0;;;;;2,0;2,0;11,0;3,0;4,0;;47,0;16,0;26,0;9,0;;;;1,0;44,0;;;30,0;9,0;2,0;13,0;;2,0;;40,0;;3,0;;;6,0;47,0;4,0;9,0;11,0;13,0;;;26,0;;4,0;1,0;1,0;1,0;39,0;10,0;;34,0;2,0;;;;;;;1,0;22,0;2,0;;;20,0;2,0;38,0;1,0;28,0;;;6,0;6,0;;;2,0;1,0;2,0;;17,0;47,0;;6,0;4,0;2,0;13,0;;;;;10,0;;2,0;;2,0;;1,0;;;21,0;;1,0;2,0;;1,0;;8,0;3,0;;;1,0;6,0;24,0;;;10,0;;6,0;;10,0;7,0;10,0;2,0;20,0;116,0;13,0;20,0;;4,0;2,0;2,0;4,0;3,0;;;;;11,0;;7,0;;;5,0;8,0;6,0;1,0;;;6,0;10,0;4,0;;1,0;3,0;;1,0;;;;3,0;3,0;54,0;6,0;;;;1,0;1,0;4,0;8,0;2,0;;8,0;;;24,0;12,0;24,0;5,0;14,0;4,0;7,0;;177,0;18,0;3,0;1,0;6,0;104,0;15,0;3,0;;;;6,0;8,0;26,0;6,0;22,0;;;45,0;;;63,0;17,0;19,0;;20,0;;2,0;6,0;1,0;3,0;21,0;;12,0;112,0;3,0;;;;;;3,0;;4,0;;92,0;;18,0;;;4,0;5,0;29,0;;4,0;;35,0;106,0;14,0;1,0;;73,0;2,0;13,0;;4,0;;;31,0;;;;1,0;3,0;;;8,0;8,0;;2,0;1,0;1,0;;25,0;16,0;2,0;3,0;3,0;1,0;;;2,0;60,0;5,0;32,0;;;;;;;1,0;1,0;7,0;4,0;7,0;96,0;;11,0;6,0;1,0;6,0;1,0;11,0;6,0;;18,0;;;;45,0;3,0;;52,0;;2,0;;;;;4,0;;4,0;;1,0;2,0;;9,0;19,0;;;;;;;;;;;;;7,0;;2,0;;;10,0;3,0;1,0;20,0;;3,0;2,0;11,0;;25,0;;;;23,0;;;8,0;5,0;34,0;3,0;2,0;1,0;;;2,0;94,0;2,0;1,0;9,0;;2,0;2,0;;9,0;3,0;1,0;1,0;;2,0;;;3,0;;1,0;6,0;;2,0;;1,0;;1,0;;8,0;2,0;3,0;;19,0;2,0;5,0;;;;5,0;;;2,0;;42,0;1,0;;;8,0;;;1,0;7,0;7,0;5,0;;;2,0;5,0;;;3,0;;11,0;;1,0;;;;;3,0;;;1,0;18,0;;1,0;1,0;4,0;;1,0;;13,0;;4,0;;;;;;;;;;;;;;1,0;9,0;4,0;;22,0;28,0;2,0;28,0;;2,0;;;;45,0;1,0;;1,0;18,0;;;1,0;50,0;;30,0;;;33,0;2,0;11,0;1,0;;4,0;;8,0;6,0;122,0;3,0;;2,0;4,0;;;3,0;;;5,0;7,0;3,0;;1,0;1,0;;;;;;;1,0;39,0;;31,0;14,0;;;;;1,0;;;;;2,0;13,0;2,0;3,0;;4,0;2,0;1,0;3,0;2,0;;;13,0;2,0;;;;2,0;4,0;;3,0;;1,0;;;;;;;17,0;;;;;;;;;1,0;;35,0;;10,0;;9,0;14,0;;;;;1,0;;;;1,0;;1,0;6,0;1,0;2,0;;;;;1,0;;;;10,0;;9,0;;;;;20,0;;;;;11,0;;;1,0;;;;1,0;1,0;6,0;1,0;;;;;;;;;;2,0;;5,0;;;;;;;6,0;;;3,0;;1,0;;4,0;3,0;;51,0;;;;3,0;;;;;2,0;1,0;1,0;;;4,0;;;;;15,0;4,0;;4,0;2,0;;1,0;;7,0;20,0;1,0;9,0;1,0;;;1,0;;;;;;;;;1,0;1,0;;;4,0;54,0;3,0;;;6,0;;;;6,0;;;;;;3,0;;;;;;;;;;;;;;;;;;;3,0;2,0;;;;4,0;;;;;3,0;;;;9,0;;;;;;;;;;3,0;;;;;6,0;1,0;;;;;;;;;;3,0;;;;;;2,0;5,0;;;;;;;;;;;;;;;;;;;1,0;;;;;
pick;8,0;;;;;31,0;;12,0;;;;;;5,0;;8,0;;;;;;;;;;;;;;;5,0;4,0;;2,0;;3,0;;;;;1,0;25,0;;;31,0;;;8,0;;;;;;;;;1,0;;;3,0;;;;;188,0;3,0;6,0;;;;;14,0;1,0;;;;;3,0;;;4,0;;2,0;;8,0;6,0;;9,0;;;;;;8,0;;;3,0;;2,0;;7,0;;;;5,0;2,0;;;;;;;6,0;;;;;;;21,0;2,0;;18,0;;4,0;;4,0;;;;54,0;;;36,0;;;;23,0;;;;;;;;;;;;19,0;;;5,0;;;4,0;;;;;;2,0;;2,0;;;;;;;;;;;;;2,0;;;;;;;;;;4,0;;;2,0;;;;1,0;;;13,0;;;;;;;;;;;;;5,0;3,0;;1,0;;;;1,0;;;1,0;1,0;4,0;;3,0;;;2,0;;;;;;2,0;;;;;;;7,0;;;;;;4,0;4,0;;2,0;;;;;;;6,0;;;2,0;;1,0;21,0;;4,0;;;;6,0;;;;;;2,0;;;;;;;;;;;;;;8,0;;;2,0;;;;;;;;;;;;;;;;;13,0;;;;;;;;;2,0;;1,0;1,0;;37,0;;;1,0;;25,0;;10,0;;;;;;;1,0;;;;;;;;;;;;8,0;;;;;;1,0;;;5,0;;6,0;;;;;;4,0;2,0;;3,0;;;;;1,0;;2,0;1,0;;;2,0;;2,0;;;;;;;;;;;;3,0;;;;;;;;;;2,0;;;1,0;;;;;;;1,0;2,0;1,0;1,0;;;1,0;2,0;;;;1,0;;5,0;;;;;;;3,0;;;;;46,0;;;;;;;;2,0;;;1,0;;;3,0;;;;;;;1,0;;;;;;;;;;;;;;;;;;;;;1,0;;1,0;;2,0;;;;;;;;;;;3,0;;;;;;;;;1,0;;5,0;;;;;;;;;;2,0;;2,0;;;;;;;;;;;;1,0;;;;1,0;1,0;;1,0;;;;;;;1,0;;;2,0;;;;;;;;;;;;;;;;;;;;;;;;;;;2,0;;;;;;;;;;;;;;;;;;;;;;;;;;;;;;;3,0;;;;;;;;;;;;4,0;;;1,0;;;;;;;;;;;;;;;;;;;;;;;;;;;;;;;;;;;;;;;;;;;;;;1,0;;;;;;;6,0;1,0;;;;;5,0;;;6,0;;6,0;;;2,0;1,0;;;;;;;;;1,0;;;;;;;;;;;;;;;;;;;;;;;;;;;;;;;;;;;;;;;;;;;;;;;;;;;4,0;;;;;;;;;;;;;;;;;;;;;;;;;;;;;;;;;;;;;;;;;;;;;11,0;;;;6,0;;;;;;;;;;;;2,0;;;;;;;;;;;;;;;;;;;;;;;;;;;;;;1,0;;;;;;;;;;;;;;;;;;;2,0;;;;;;;;;;;;;;1,0;;;;;;;;;;;;;;;;;;;;;;;7,0;;;;;;;;;;;;20,0;;;;;;;;;;;;;;;;;;;;;3,0;;;;;;;1,0;;;;;;;;;;;;;;;;;;;;;;;;;;;;;2,0;;;;;;;;;;;;;;;;;;;;;2,0;;;;;;;;;;;;;;;
pixel;30,0;;6,0;77,0;198,0;213,0;1905,0;32,0;6,0;;;21,0;1,0;792,0;187,0;174,0;645,0;151,0;120,0;41,0;79,0;56,0;1591,0;12,0;6,0;28,0;10,0;367,0;46,0;14,0;651,0;35,0;116,0;130,0;1,0;1195,0;135,0;27,0;844,0;4,0;907,0;673,0;3,0;227,0;189,0;248,0;13,0;225,0;15,0;44,0;188,0;;20,0;11,0;65,0;267,0;424,0;;26,0;420,0;1,0;197,0;874,0;;5148,0;4,0;2072,0;55,0;58,0;50,0;49,0;222,0;849,0;2,0;12,0;33,0;3,0;102,0;4,0;80,0;713,0;49,0;39,0;66,0;162,0;2,0;17,0;261,0;9,0;86,0;53,0;10,0;51,0;367,0;38,0;3,0;;294,0;3546,0;263,0;467,0;331,0;11,0;87,0;203,0;252,0;12,0;49,0;33,0;12,0;4,0;437,0;879,0;64,0;;68,0;231,0;590,0;193,0;1501,0;72,0;5,0;2102,0;196,0;33,0;97,0;497,0;;17,0;4,0;463,0;48,0;17,0;1017,0;22,0;4,0;136,0;61,0;4,0;12,0;6,0;274,0;;11,0;80,0;187,0;493,0;686,0;492,0;1,0;22,0;627,0;5,0;30,0;8,0;131,0;;1,0;3,0;6,0;4,0;182,0;14,0;162,0;201,0;59,0;94,0;56,0;7,0;397,0;45,0;19,0;12,0;218,0;;200,0;57,0;22,0;4,0;1,0;4,0;8,0;114,0;20,0;;42,0;724,0;;605,0;26,0;2,0;2,0;2,0;18,0;;33,0;1,0;129,0;14,0;7,0;20,0;71,0;8,0;5,0;182,0;18,0;22,0;6,0;2,0;6,0;19,0;52,0;48,0;4,0;10,0;29,0;796,0;70,0;1,0;46,0;255,0;107,0;36,0;464,0;;5,0;505,0;;18,0;80,0;;33,0;176,0;147,0;3,0;11,0;24,0;25,0;;197,0;;8,0;1,0;;2,0;321,0;48,0;30,0;100,0;;;7,0;166,0;46,0;188,0;24,0;17,0;95,0;82,0;;137,0;51,0;50,0;19,0;2,0;;;41,0;73,0;64,0;2,0;31,0;20,0;27,0;;;5,0;61,0;14,0;135,0;1,0;4,0;106,0;4,0;24,0;;12,0;13,0;428,0;4,0;;22,0;;;93,0;;291,0;1,0;;1,0;;1,0;1,0;11,0;;;3,0;6,0;101,0;779,0;;;20,0;1,0;66,0;;156,0;3,0;22,0;1,0;4,0;239,0;23,0;73,0;10,0;1,0;44,0;;16,0;;;1,0;;;80,0;60,0;;;3,0;;2,0;23,0;1,0;;;;33,0;40,0;;;2,0;;69,0;13,0;22,0;;29,0;45,0;300,0;;106,0;;;1,0;3,0;40,0;33,0;2,0;;2,0;;;376,0;158,0;65,0;15,0;1,0;1,0;282,0;82,0;344,0;175,0;5,0;15,0;13,0;287,0;55,0;398,0;16,0;34,0;86,0;23,0;78,0;444,0;3,0;239,0;23,0;302,0;107,0;21,0;2,0;143,0;57,0;209,0;71,0;590,0;80,0;26,0;74,0;;2,0;23,0;34,0;29,0;75,0;33,0;;110,0;;1,0;96,0;29,0;12,0;500,0;14,0;231,0;2,0;87,0;11,0;;185,0;;59,0;3,0;12,0;;20,0;88,0;30,0;2,0;25,0;5,0;322,0;1,0;29,0;33,0;12,0;;22,0;10,0;29,0;59,0;23,0;17,0;;;17,0;115,0;4,0;96,0;96,0;8,0;182,0;28,0;;39,0;14,0;6,0;;;;4,0;48,0;9,0;;1,0;5,0;5,0;38,0;5,0;;21,0;;69,0;9,0;4,0;198,0;51,0;;12,0;30,0;7,0;14,0;54,0;15,0;2,0;79,0;;1,0;;17,0;23,0;;23,0;144,0;147,0;2,0;;;101,0;3,0;334,0;;;5,0;117,0;2,0;45,0;;;8,0;;32,0;7,0;5,0;48,0;;;1,0;;;21,0;;9,0;227,0;1,0;44,0;;6,0;107,0;10,0;20,0;13,0;81,0;3,0;57,0;;30,0;5,0;5,0;;;27,0;24,0;2,0;87,0;4,0;33,0;;;30,0;14,0;2,0;19,0;84,0;4,0;46,0;;29,0;15,0;;1,0;28,0;;17,0;33,0;5,0;9,0;;;5,0;;31,0;2,0;13,0;;1,0;1,0;41,0;77,0;2,0;1,0;17,0;122,0;;;;17,0;10,0;;18,0;2,0;2,0;199,0;1,0;1,0;5,0;2,0;96,0;60,0;3,0;;30,0;16,0;;;4,0;2,0;20,0;127,0;;;433,0;35,0;;40,0;4,0;3,0;;2,0;;2,0;;;7,0;;;;33,0;107,0;;4,0;4,0;;25,0;13,0;;;;7,0;238,0;7,0;32,0;1,0;61,0;26,0;36,0;13,0;152,0;48,0;;;1,0;207,0;113,0;16,0;;;;;97,0;;2,0;;8,0;312,0;;27,0;204,0;16,0;;;;82,0;;19,0;12,0;6,0;;;13,0;;38,0;15,0;15,0;17,0;5,0;5,0;;1,0;6,0;32,0;66,0;122,0;77,0;;;;;39,0;;7,0;1,0;33,0;1,0;23,0;;19,0;1,0;54,0;1,0;27,0;;2,0;41,0;;;1,0;40,0;;2,0;20,0;2,0;12,0;84,0;4,0;;;224,0;;18,0;;;;;18,0;44,0;37,0;;5,0;;;2,0;5,0;11,0;4,0;10,0;;7,0;10,0;10,0;;;;;;5,0;16,0;1,0;6,0;29,0;;47,0;;;;;;23,0;;62,0;;;28,0;28,0;31,0;;94,0;30,0;47,0;15,0;57,0;47,0;10,0;37,0;7,0;318,0;12,0;21,0;63,0;21,0;7,0;53,0;334,0;83,0;71,0;4,0;48,0;;196,0;43,0;38,0;14,0;42,0;116,0;27,0;159,0;6,0;3,0;43,0;4,0;49,0;1,0;5,0;674,0;31,0;28,0;140,0;82,0;;30,0;340,0;22,0;;7,0;29,0;17,0;11,0;;49,0;17,0;;;64,0;9,0;4,0;9,0;32,0;10,0;;60,0;25,0;8,0;15,0;28,0;5,0;223,0;1,0;24,0;3,0;128,0;54,0;4,0;;;10,0;4,0;;84,0;;12,0;8,0;4,0;56,0;17,0;29,0;7,0;12,0;32,0;;;49,0;;11,0;;21,0;;;4,0;2,0;5,0;14,0;3,0;17,0;;;;;18,0;;;;;;11,0;;3,0;26,0;11,0;;4,0;4,0;4,0;2,0;;2,0;;;;53,0;;;;6,0;1,0;;16,0;42,0;28,0;6,0;;;;8,0;6,0;4,0;;;;9,0;3,0;83,0;21,0;;;1,0;;3,0;;;4,0;;;;;;2,0;;47,0;133,0;;17,0;33,0;15,0;7,0;;1,0;5,0;;;56,0;;;76,0;53,0;31,0;104,0;27,0;2,0;;;8,0;40,0;;12,0;20,0;;;111,0;12,0;;2,0;;171,0;;4,0;;;2,0;22,0
plane;3,0;;3,0;21,0;40,0;87,0;390,0;129,0;;;4,0;19,0;17,0;242,0;6,0;;119,0;7,0;23,0;3,0;2,0;1,0;45,0;;2,0;3,0;;34,0;12,0;14,0;134,0;8,0;7,0;25,0;;90,0;231,0;55,0;73,0;5,0;238,0;160,0;2,0;77,0;80,0;187,0;;92,0;82,0;6,0;11,0;6,0;78,0;1,0;36,0;1292,0;224,0;;11,0;41,0;5,0;6,0;217,0;;1205,0;1,0;220,0;9,0;2,0;57,0;38,0;483,0;213,0;1,0;;;17,0;4,0;;;176,0;11,0;5,0;28,0;82,0;45,0;4,0;494,0;20,0;3,0;44,0;6,0;37,0;3,0;8,0;;294,0;;468,0;358,0;276,0;52,0;13,0;5,0;11,0;39,0;8,0;5,0;4,0;10,0;;182,0;73,0;12,0;;;14,0;53,0;68,0;403,0;;;19,0;24,0;35,0;12,0;174,0;2,0;46,0;2,0;53,0;3,0;8,0;105,0;5,0;;73,0;204,0;20,0;;2,0;37,0;35,0;;70,0;34,0;73,0;97,0;113,0;15,0;3,0;7,0;31,0;20,0;;;5,0;2,0;3,0;1,0;23,0;19,0;;10,0;2,0;3,0;36,0;45,0;;59,0;20,0;1,0;35,0;180,0;1,0;32,0;6,0;11,0;7,0;;;4,0;;51,0;;8,0;52,0;40,0;94,0;37,0;;3,0;;9,0;21,0;2,0;67,0;13,0;9,0;5,0;;18,0;8,0;;15,0;5,0;94,0;;45,0;71,0;49,0;79,0;63,0;1,0;;25,0;14,0;319,0;1,0;43,0;26,0;2,0;10,0;3,0;45,0;;172,0;;2,0;11,0;1,0;53,0;12,0;16,0;6,0;2,0;18,0;9,0;;16,0;2,0;4,0;27,0;8,0;;125,0;9,0;31,0;126,0;2,0;8,0;5,0;78,0;30,0;25,0;;85,0;271,0;;;2,0;3,0;2,0;15,0;23,0;;2,0;11,0;9,0;21,0;2,0;5,0;43,0;17,0;15,0;;12,0;171,0;8,0;41,0;10,0;5,0;357,0;27,0;6,0;2,0;23,0;10,0;39,0;5,0;23,0;23,0;;8,0;37,0;1,0;142,0;3,0;5,0;3,0;;23,0;4,0;1,0;;7,0;9,0;13,0;21,0;405,0;76,0;1,0;3,0;;8,0;3,0;86,0;7,0;1,0;5,0;1,0;187,0;7,0;4,0;;3,0;24,0;3,0;12,0;1,0;;;22,0;7,0;16,0;50,0;;3,0;;;61,0;48,0;29,0;;;;32,0;52,0;;5,0;;4,0;4,0;;46,0;20,0;8,0;54,0;14,0;2,0;7,0;;;2,0;;4,0;7,0;3,0;;8,0;;;87,0;42,0;32,0;1,0;;7,0;1,0;7,0;70,0;157,0;;13,0;8,0;41,0;;9,0;;;1,0;;7,0;55,0;8,0;9,0;5,0;51,0;21,0;7,0;;6,0;5,0;16,0;22,0;105,0;11,0;;40,0;8,0;1,0;48,0;1,0;5,0;14,0;26,0;94,0;13,0;6,0;1,0;;;1,0;;2,0;68,0;;22,0;;5,0;29,0;;3,0;;3,0;1,0;2,0;18,0;8,0;;9,0;5,0;4,0;64,0;12,0;10,0;1,0;;97,0;;;1,0;;9,0;6,0;;8,0;48,0;;7,0;28,0;2,0;;14,0;;;13,0;;;11,0;1,0;2,0;14,0;15,0;;6,0;7,0;3,0;;;20,0;8,0;2,0;15,0;5,0;10,0;24,0;3,0;2,0;12,0;1,0;;;34,0;2,0;27,0;61,0;9,0;3,0;1,0;8,0;4,0;;10,0;28,0;43,0;3,0;;2,0;14,0;;9,0;1,0;;4,0;46,0;1,0;42,0;;2,0;2,0;7,0;5,0;8,0;6,0;1,0;;8,0;;;5,0;51,0;;33,0;164,0;;11,0;2,0;9,0;54,0;;;103,0;25,0;1,0;6,0;;;1,0;;1,0;8,0;;14,0;;;;;;;4,0;4,0;13,0;22,0;1,0;3,0;;;14,0;;;5,0;10,0;;33,0;9,0;;3,0;9,0;2,0;7,0;6,0;11,0;7,0;9,0;2,0;39,0;;8,0;12,0;;;1,0;5,0;;;1,0;9,0;14,0;;;3,0;;51,0;2,0;;1,0;2,0;5,0;24,0;;;13,0;125,0;;1,0;;;;83,0;;2,0;6,0;4,0;;;73,0;;4,0;;;;;;12,0;1,0;;;249,0;1,0;9,0;3,0;12,0;7,0;;10,0;;5,0;;27,0;5,0;1,0;114,0;;55,0;3,0;5,0;;22,0;3,0;;1,0;;5,0;72,0;;3,0;;9,0;;30,0;;33,0;;;4,0;;;64,0;3,0;;1,0;;1,0;;2,0;7,0;7,0;2,0;2,0;;10,0;;1,0;1,0;26,0;2,0;29,0;;;2,0;;14,0;26,0;22,0;4,0;6,0;3,0;;3,0;;24,0;19,0;;2,0;1,0;;;5,0;7,0;;;;;;24,0;39,0;;36,0;;;3,0;3,0;25,0;146,0;;13,0;3,0;23,0;5,0;15,0;1,0;17,0;;;1,0;1,0;9,0;4,0;;4,0;;;2,0;2,0;19,0;1,0;3,0;3,0;2,0;7,0;9,0;;4,0;;12,0;3,0;;;1,0;6,0;;104,0;;;;;8,0;1,0;;1,0;;;;2,0;8,0;;16,0;;;;;4,0;;;16,0;1,0;;4,0;;;;2,0;10,0;6,0;;1,0;3,0;37,0;27,0;;18,0;5,0;;;3,0;10,0;1,0;;;;47,0;2,0;;23,0;2,0;1,0;3,0;;;3,0;;3,0;1,0;;1,0;;1,0;;;18,0;1,0;;;;9,0;;1,0;;;4,0;7,0;18,0;;3,0;;39,0;19,0;;;2,0;9,0;;10,0;4,0;8,0;2,0;;13,0;;;13,0;21,0;18,0;34,0;;1,0;;12,0;;13,0;2,0;;2,0;1,0;;;;1,0;6,0;;1,0;;;;;;;;;;;7,0;;9,0;;1,0;;11,0;5,0;10,0;;;;;;1,0;1,0;6,0;14,0;;6,0;25,0;1,0;;6,0;6,0;2,0;;;;;2,0;36,0;1,0;1,0;;;;;;;13,0;;;;;1,0;4,0;;10,0;;;5,0;1,0;;;2,0;4,0;;;1,0;3,0;1,0;;;;72,0;;;;;1,0;13,0;;4,0;;3,0;3,0;10,0;;;22,0;;27,0;16,0;1,0;;3,0;6,0;;19,0;;;;;;4,0;;
plurality;10,0;45,0;4,0;124,0;64,0;473,0;1151,0;456,0;24,0;58,0;4,0;85,0;135,0;1191,0;22,0;74,0;1655,0;95,0;291,0;73,0;70,0;16,0;716,0;46,0;80,0;18,0;20,0;796,0;96,0;89,0;1204,0;158,0;40,0;114,0;18,0;1282,0;251,0;38,0;393,0;6,0;958,0;1649,0;18,0;262,0;473,0;569,0;34,0;1031,0;15,0;23,0;111,0;14,0;212,0;17,0;247,0;416,0;761,0;5,0;59,0;626,0;2,0;31,0;407,0;9,0;6940,0;26,0;3002,0;14,0;65,0;22,0;98,0;1959,0;1328,0;19,0;58,0;9,0;90,0;96,0;55,0;177,0;1127,0;135,0;217,0;162,0;874,0;45,0;18,0;712,0;100,0;87,0;366,0;39,0;85,0;62,0;223,0;2,0;3546,0;468,0;;935,0;1247,0;250,0;68,0;186,0;416,0;467,0;15,0;66,0;64,0;48,0;12,0;300,0;1045,0;46,0;9,0;62,0;76,0;711,0;402,0;1636,0;120,0;21,0;916,0;80,0;48,0;333,0;1361,0;6,0;141,0;2,0;413,0;25,0;25,0;1256,0;24,0;9,0;534,0;79,0;74,0;31,0;7,0;145,0;16,0;5,0;183,0;100,0;348,0;744,0;517,0;118,0;7,0;218,0;173,0;89,0;64,0;67,0;12,0;8,0;;3,0;117,0;350,0;54,0;56,0;143,0;32,0;422,0;121,0;5,0;155,0;135,0;4,0;97,0;390,0;2,0;203,0;32,0;179,0;40,0;21,0;12,0;19,0;32,0;227,0;39,0;72,0;362,0;15,0;990,0;77,0;26,0;66,0;41,0;98,0;68,0;200,0;377,0;41,0;64,0;27,0;21,0;292,0;9,0;30,0;98,0;94,0;438,0;28,0;161,0;613,0;49,0;66,0;84,0;18,0;126,0;115,0;270,0;141,0;49,0;149,0;454,0;68,0;22,0;423,0;207,0;22,0;1229,0;;7,0;80,0;63,0;47,0;124,0;22,0;46,0;23,0;78,0;40,0;10,0;123,0;4,0;93,0;13,0;3,0;13,0;661,0;107,0;121,0;336,0;14,0;45,0;38,0;169,0;230,0;549,0;59,0;212,0;742,0;77,0;;160,0;126,0;82,0;288,0;99,0;4,0;;19,0;64,0;114,0;9,0;282,0;174,0;75,0;22,0;2,0;50,0;267,0;35,0;60,0;20,0;33,0;228,0;160,0;144,0;;91,0;15,0;447,0;38,0;151,0;139,0;12,0;23,0;60,0;25,0;190,0;40,0;48,0;53,0;23,0;26,0;62,0;44,0;6,0;138,0;24,0;102,0;24,0;963,0;;3,0;18,0;30,0;37,0;5,0;176,0;45,0;13,0;50,0;100,0;732,0;55,0;153,0;36,0;69,0;34,0;21,0;85,0;56,0;241,0;13,0;15,0;103,0;116,0;11,0;7,0;1,0;12,0;5,0;76,0;69,0;57,0;21,0;22,0;64,0;284,0;226,0;8,0;88,0;10,0;8,0;22,0;2,0;191,0;36,0;38,0;63,0;767,0;14,0;59,0;3,0;10,0;17,0;10,0;43,0;58,0;13,0;8,0;11,0;47,0;;189,0;146,0;94,0;37,0;70,0;89,0;116,0;23,0;606,0;155,0;23,0;21,0;15,0;416,0;29,0;99,0;9,0;69,0;43,0;90,0;143,0;195,0;38,0;195,0;;439,0;77,0;31,0;1,0;195,0;64,0;146,0;74,0;438,0;50,0;82,0;191,0;51,0;14,0;200,0;18,0;99,0;273,0;155,0;13,0;16,0;10,0;12,0;4,0;62,0;15,0;83,0;23,0;786,0;14,0;196,0;30,0;23,0;270,0;6,0;124,0;47,0;19,0;30,0;102,0;149,0;135,0;31,0;21,0;195,0;99,0;62,0;41,0;73,0;27,0;23,0;226,0;7,0;32,0;63,0;41,0;32,0;110,0;8,0;5,0;240,0;16,0;47,0;195,0;16,0;62,0;65,0;20,0;65,0;2,0;10,0;7,0;2,0;27,0;54,0;196,0;100,0;66,0;5,0;61,0;62,0;27,0;15,0;241,0;12,0;104,0;29,0;56,0;40,0;243,0;36,0;15,0;102,0;12,0;18,0;64,0;93,0;63,0;60,0;37,0;91,0;13,0;37,0;52,0;167,0;32,0;58,0;133,0;74,0;58,0;2,0;11,0;58,0;40,0;42,0;20,0;19,0;6,0;42,0;8,0;60,0;36,0;76,0;123,0;85,0;8,0;37,0;8,0;16,0;23,0;6,0;39,0;;25,0;51,0;23,0;53,0;49,0;21,0;40,0;56,0;29,0;126,0;11,0;3,0;33,0;102,0;9,0;26,0;29,0;8,0;36,0;77,0;2,0;22,0;11,0;55,0;23,0;120,0;55,0;12,0;;15,0;11,0;37,0;88,0;15,0;28,0;20,0;73,0;11,0;40,0;5,0;12,0;10,0;6,0;14,0;144,0;104,0;6,0;53,0;15,0;34,0;13,0;16,0;124,0;26,0;22,0;48,0;20,0;13,0;252,0;136,0;39,0;38,0;10,0;65,0;4,0;8,0;4,0;17,0;91,0;8,0;11,0;17,0;9,0;727,0;70,0;28,0;7,0;33,0;31,0;58,0;12,0;20,0;37,0;45,0;28,0;5,0;23,0;41,0;76,0;307,0;17,0;10,0;117,0;113,0;4,0;24,0;26,0;;14,0;4,0;4,0;8,0;4,0;109,0;78,0;20,0;9,0;3,0;23,0;40,0;2,0;51,0;59,0;13,0;87,0;81,0;27,0;;5,0;15,0;89,0;4,0;68,0;10,0;50,0;15,0;41,0;;192,0;27,0;10,0;28,0;44,0;128,0;31,0;7,0;7,0;84,0;5,0;4,0;490,0;18,0;5,0;37,0;104,0;200,0;8,0;52,0;436,0;33,0;5,0;1,0;7,0;52,0;23,0;23,0;16,0;56,0;30,0;9,0;2,0;40,0;46,0;5,0;20,0;425,0;9,0;34,0;15,0;16,0;96,0;59,0;141,0;193,0;92,0;17,0;29,0;39,0;3,0;38,0;1,0;24,0;31,0;15,0;;151,0;34,0;36,0;25,0;8,0;9,0;2,0;17,0;9,0;28,0;48,0;4,0;28,0;41,0;28,0;1,0;9,0;60,0;30,0;173,0;12,0;33,0;31,0;36,0;12,0;56,0;;12,0;39,0;4,0;79,0;8,0;57,0;7,0;9,0;67,0;10,0;3,0;26,0;36,0;37,0;31,0;7,0;23,0;5,0;7,0;34,0;34,0;9,0;4,0;13,0;16,0;22,0;35,0;23,0;31,0;12,0;116,0;2,0;6,0;4,0;17,0;1,0;26,0;28,0;37,0;1,0;51,0;5,0;93,0;24,0;6,0;60,0;20,0;26,0;33,0;23,0;40,0;1,0;137,0;20,0;317,0;98,0;17,0;29,0;3,0;5,0;62,0;124,0;46,0;46,0;10,0;16,0;125,0;139,0;42,0;88,0;22,0;16,0;41,0;44,0;270,0;14,0;22,0;27,0;12,0;47,0;92,0;30,0;269,0;37,0;16,0;70,0;10,0;55,0;30,0;228,0;35,0;3,0;85,0;12,0;20,0;2,0;;35,0;6,0;36,0;15,0;62,0;29,0;7,0;3,0;16,0;6,0;16,0;27,0;50,0;2,0;4,0;22,0;34,0;115,0;11,0;4,0;7,0;31,0;76,0;25,0;;52,0;9,0;39,0;11,0;64,0;24,0;24,0;30,0;11,0;91,0;41,0;11,0;2,0;52,0;36,0;28,0;17,0;8,0;13,0;3,0;15,0;18,0;;14,0;8,0;2,0;35,0;14,0;32,0;18,0;6,0;9,0;12,0;69,0;3,0;7,0;;10,0;41,0;4,0;16,0;3,0;65,0;53,0;46,0;41,0;44,0;18,0;67,0;;29,0;5,0;16,0;;30,0;27,0;8,0;2,0;17,0;;12,0;27,0;32,0;18,0;29,0;1,0;2,0;1,0;6,0;50,0;11,0;15,0;7,0;3,0;1,0;1,0;93,0;36,0;34,0;26,0;;9,0;4,0;37,0;9,0;;18,0;46,0;4,0;18,0;39,0;2,0;12,0;23,0;;82,0;5,0;10,0;64,0;36,0;10,0;1,0;68,0;28,0;18,0;5,0;86,0;8,0;14,0;72,0;27,0;9,0;42,0;89,0;1,0;14,0;8,0;49,0;;4,0;16,0;51,0;;3,0;60,0;3,0;2,0;110,0;27,0;30,0;5,0;5,0;1,0;;;1,0
point;1,0;192,0;;179,0;41,0;97,0;36,0;120,0;25,0;3,0;5,0;2,0;6,0;705,0;;7,0;228,0;12,0;1,0;50,0;16,0;33,0;108,0;14,0;38,0;5,0;7,0;22,0;46,0;62,0;224,0;24,0;82,0;33,0;2,0;382,0;132,0;35,0;309,0;6,0;1115,0;393,0;3,0;93,0;120,0;29,0;8,0;54,0;43,0;56,0;238,0;19,0;59,0;14,0;132,0;223,0;170,0;;3,0;156,0;10,0;2,0;156,0;1,0;2698,0;9,0;484,0;16,0;33,0;26,0;67,0;212,0;185,0;2,0;6,0;32,0;10,0;117,0;16,0;31,0;618,0;3,0;31,0;190,0;104,0;40,0;4,0;263,0;1,0;17,0;44,0;9,0;51,0;11,0;94,0;;263,0;358,0;935,0;;664,0;132,0;2,0;62,0;81,0;104,0;14,0;19,0;4,0;10,0;2,0;907,0;206,0;22,0;3,0;26,0;19,0;180,0;231,0;173,0;36,0;2,0;185,0;36,0;1,0;161,0;496,0;4,0;111,0;1,0;425,0;17,0;17,0;179,0;5,0;5,0;334,0;147,0;9,0;4,0;2,0;102,0;3,0;;18,0;56,0;113,0;28,0;283,0;43,0;8,0;16,0;249,0;21,0;4,0;3,0;;2,0;1,0;19,0;8,0;308,0;4,0;36,0;5,0;130,0;59,0;27,0;6,0;94,0;12,0;8,0;40,0;366,0;4,0;112,0;1,0;26,0;28,0;;10,0;3,0;1,0;51,0;4,0;9,0;31,0;10,0;344,0;47,0;12,0;1,0;1,0;1,0;5,0;14,0;79,0;8,0;3,0;3,0;;8,0;7,0;7,0;164,0;28,0;75,0;20,0;66,0;128,0;51,0;69,0;77,0;2,0;;2,0;142,0;41,0;10,0;102,0;120,0;25,0;4,0;;26,0;;111,0;6,0;5,0;12,0;1,0;18,0;52,0;23,0;19,0;49,0;34,0;10,0;;130,0;5,0;5,0;6,0;1,0;;376,0;30,0;24,0;101,0;2,0;1,0;3,0;3,0;51,0;1,0;;61,0;364,0;33,0;;6,0;23,0;16,0;125,0;9,0;2,0;1,0;7,0;27,0;15,0;7,0;8,0;7,0;7,0;4,0;1,0;13,0;420,0;4,0;5,0;62,0;21,0;195,0;22,0;29,0;2,0;8,0;9,0;19,0;10,0;5,0;27,0;;;11,0;13,0;509,0;3,0;11,0;32,0;1,0;;10,0;61,0;8,0;;15,0;33,0;39,0;238,0;;7,0;5,0;13,0;44,0;40,0;155,0;6,0;4,0;22,0;33,0;808,0;22,0;18,0;;6,0;2,0;3,0;19,0;9,0;5,0;5,0;3,0;8,0;34,0;9,0;12,0;;;2,0;58,0;47,0;10,0;;;24,0;87,0;85,0;;43,0;40,0;13,0;8,0;;226,0;6,0;28,0;32,0;212,0;62,0;3,0;;;90,0;11,0;85,0;19,0;2,0;9,0;8,0;3,0;;238,0;261,0;70,0;27,0;1,0;145,0;87,0;10,0;164,0;845,0;1,0;13,0;23,0;258,0;13,0;121,0;;22,0;6,0;10,0;151,0;79,0;6,0;117,0;4,0;313,0;46,0;20,0;1,0;122,0;6,0;83,0;12,0;498,0;17,0;12,0;81,0;10,0;9,0;90,0;1,0;47,0;98,0;71,0;13,0;3,0;1,0;81,0;2,0;10,0;12,0;11,0;7,0;101,0;35,0;75,0;3,0;6,0;10,0;6,0;52,0;1,0;20,0;23,0;22,0;24,0;15,0;19,0;34,0;9,0;100,0;23,0;31,0;33,0;18,0;10,0;96,0;18,0;11,0;15,0;12,0;9,0;8,0;18,0;14,0;134,0;9,0;64,0;111,0;2,0;33,0;48,0;6,0;6,0;44,0;2,0;1,0;121,0;12,0;7,0;26,0;14,0;4,0;11,0;91,0;12,0;2,0;9,0;23,0;58,0;2,0;100,0;13,0;11,0;79,0;46,0;18,0;72,0;17,0;1,0;9,0;130,0;7,0;1,0;55,0;;1,0;25,0;5,0;16,0;2,0;55,0;61,0;142,0;91,0;4,0;;7,0;3,0;12,0;2,0;;11,0;12,0;;67,0;3,0;14,0;121,0;60,0;30,0;121,0;17,0;;;12,0;;;1,0;12,0;1,0;62,0;132,0;1,0;16,0;7,0;19,0;526,0;9,0;28,0;2,0;34,0;3,0;32,0;;2,0;2,0;31,0;3,0;2,0;51,0;77,0;2,0;32,0;2,0;27,0;17,0;4,0;1,0;103,0;10,0;;59,0;;13,0;;111,0;9,0;;23,0;3,0;;40,0;43,0;13,0;8,0;;27,0;;2,0;79,0;7,0;25,0;4,0;7,0;;2,0;22,0;;27,0;13,0;59,0;;1,0;15,0;;58,0;1,0;10,0;4,0;3,0;1800,0;55,0;13,0;6,0;11,0;7,0;;5,0;;14,0;83,0;2,0;;1,0;13,0;6,0;7,0;5,0;4,0;14,0;256,0;7,0;3,0;98,0;15,0;76,0;14,0;6,0;2,0;2,0;15,0;2,0;;;;15,0;1,0;;1,0;7,0;5,0;91,0;2,0;5,0;;;23,0;;13,0;13,0;14,0;29,0;21,0;38,0;4,0;90,0;36,0;19,0;3,0;6,0;12,0;3,0;;2,0;;1,0;14,0;167,0;12,0;19,0;2,0;2,0;112,0;3,0;8,0;390,0;2,0;5,0;18,0;2,0;7,0;;24,0;27,0;;;3,0;7,0;5,0;16,0;5,0;;494,0;1,0;57,0;1,0;3,0;1,0;1,0;24,0;9,0;21,0;7,0;3,0;2,0;1,0;34,0;11,0;13,0;3,0;1,0;1,0;19,0;4,0;1,0;1,0;31,0;7,0;15,0;3,0;4,0;15,0;11,0;27,0;39,0;27,0;16,0;;6,0;76,0;24,0;131,0;14,0;26,0;16,0;53,0;;52,0;1,0;62,0;23,0;;;4,0;65,0;3,0;;;;;;4,0;17,0;27,0;7,0;;2,0;45,0;;33,0;2,0;12,0;1,0;2,0;;20,0;;39,0;6,0;214,0;;1,0;;3,0;;23,0;1,0;30,0;2,0;1,0;52,0;8,0;12,0;;16,0;4,0;;;;14,0;;4,0;2,0;11,0;;14,0;;;;;7,0;2,0;5,0;;;42,0;50,0;29,0;15,0;;;1,0;49,0;;;7,0;6,0;33,0;37,0;11,0;8,0;25,0;12,0;9,0;8,0;7,0;6,0;29,0;8,0;43,0;;;8,0;2,0;11,0;;;12,0;83,0;13,0;3,0;;5,0;8,0;14,0;7,0;6,0;103,0;48,0;10,0;20,0;24,0;1,0;134,0;6,0;4,0;2,0;1,0;9,0;27,0;;23,0;;194,0;4,0;6,0;1,0;6,0;50,0;28,0;159,0;29,0;7,0;10,0;4,0;38,0;6,0;9,0;2,0;;3,0;57,0;;4,0;2,0;1,0;7,0;1,0;3,0;3,0;21,0;1,0;2,0;6,0;;6,0;1,0;;13,0;1,0;15,0;14,0;;4,0;12,0;15,0;11,0;;1,0;;;;;4,0;;59,0;;;1,0;2,0;;;28,0;50,0;15,0;;22,0;4,0;2,0;1,0;23,0;1,0;;2,0;;;4,0;5,0;3,0;4,0;3,0;;;;8,0;1,0;1,0;11,0;;3,0;12,0;19,0;3,0;5,0;1,0;37,0;3,0;;;14,0;9,0;;;18,0;228,0;5,0;4,0;19,0;15,0;26,0;;42,0;28,0;14,0;101,0;1,0;;41,0;4,0;36,0;13,0;29,0;14,0;;;144,0;49,0;7,0;;;47,0;;7,0;;;;
position;3,0;56,0;36,0;465,0;116,0;544,0;224,0;447,0;23,0;5,0;19,0;18,0;122,0;1634,0;5,0;1,0;739,0;13,0;39,0;26,0;11,0;17,0;76,0;16,0;57,0;27,0;72,0;245,0;49,0;39,0;909,0;278,0;190,0;85,0;9,0;824,0;140,0;107,0;166,0;5,0;1817,0;1753,0;26,0;208,0;727,0;387,0;8,0;805,0;;85,0;304,0;36,0;219,0;58,0;369,0;299,0;269,0;2,0;22,0;346,0;37,0;10,0;199,0;32,0;2807,0;11,0;798,0;26,0;52,0;61,0;49,0;3113,0;644,0;23,0;113,0;3,0;64,0;118,0;7,0;114,0;1108,0;39,0;96,0;127,0;682,0;360,0;2,0;792,0;25,0;49,0;108,0;85,0;56,0;38,0;160,0;7,0;467,0;276,0;1247,0;664,0;;372,0;29,0;65,0;108,0;245,0;9,0;34,0;26,0;103,0;;359,0;386,0;72,0;15,0;48,0;41,0;227,0;208,0;1308,0;39,0;35,0;673,0;142,0;10,0;185,0;1285,0;15,0;22,0;8,0;315,0;2,0;9,0;885,0;27,0;;407,0;215,0;403,0;4,0;24,0;172,0;21,0;6,0;216,0;92,0;331,0;236,0;313,0;140,0;94,0;156,0;448,0;114,0;8,0;20,0;13,0;2,0;2,0;2,0;34,0;132,0;71,0;28,0;13,0;14,0;243,0;303,0;8,0;407,0;208,0;18,0;80,0;644,0;31,0;169,0;18,0;62,0;50,0;21,0;31,0;17,0;59,0;344,0;25,0;78,0;237,0;77,0;371,0;276,0;9,0;11,0;20,0;144,0;205,0;142,0;745,0;33,0;69,0;42,0;12,0;69,0;68,0;14,0;139,0;62,0;1038,0;24,0;567,0;610,0;567,0;374,0;87,0;15,0;13,0;98,0;217,0;90,0;9,0;129,0;161,0;44,0;5,0;16,0;165,0;19,0;980,0;9,0;46,0;44,0;51,0;27,0;183,0;14,0;96,0;47,0;67,0;5,0;6,0;204,0;1,0;117,0;110,0;14,0;33,0;237,0;66,0;80,0;599,0;154,0;76,0;4,0;8,0;170,0;134,0;24,0;304,0;939,0;24,0;;24,0;74,0;45,0;687,0;116,0;7,0;3,0;16,0;63,0;111,0;19,0;58,0;185,0;67,0;39,0;3,0;75,0;331,0;26,0;94,0;73,0;100,0;552,0;131,0;18,0;46,0;110,0;102,0;196,0;8,0;196,0;37,0;17,0;41,0;29,0;45,0;398,0;66,0;23,0;144,0;53,0;27,0;36,0;11,0;15,0;68,0;70,0;284,0;77,0;385,0;44,0;9,0;82,0;60,0;79,0;60,0;308,0;187,0;41,0;217,0;231,0;1202,0;111,0;98,0;16,0;25,0;49,0;31,0;86,0;40,0;65,0;11,0;37,0;131,0;121,0;9,0;94,0;9,0;8,0;16,0;339,0;176,0;258,0;57,0;46,0;73,0;116,0;212,0;2,0;75,0;4,0;17,0;68,0;2,0;282,0;47,0;70,0;142,0;426,0;24,0;85,0;7,0;16,0;25,0;11,0;118,0;30,0;132,0;16,0;15,0;16,0;10,0;336,0;352,0;359,0;52,0;30,0;37,0;99,0;35,0;847,0;450,0;13,0;28,0;149,0;820,0;78,0;195,0;;114,0;55,0;19,0;63,0;923,0;49,0;105,0;25,0;207,0;251,0;109,0;9,0;172,0;16,0;179,0;39,0;286,0;25,0;133,0;208,0;210,0;91,0;352,0;3,0;195,0;317,0;917,0;34,0;26,0;98,0;40,0;2,0;38,0;102,0;61,0;8,0;496,0;60,0;157,0;14,0;39,0;205,0;3,0;178,0;24,0;96,0;43,0;91,0;142,0;59,0;;25,0;47,0;142,0;132,0;27,0;40,0;27,0;43,0;588,0;58,0;27,0;3,0;29,0;74,0;76,0;32,0;39,0;107,0;12,0;57,0;130,0;6,0;1,0;9,0;16,0;19,0;75,0;6,0;17,0;26,0;28,0;112,0;95,0;53,0;36,0;20,0;20,0;23,0;1,0;23,0;393,0;91,0;52,0;80,0;63,0;34,0;147,0;148,0;39,0;87,0;41,0;;13,0;89,0;62,0;97,0;158,0;11,0;7,0;17,0;3,0;21,0;11,0;142,0;39,0;158,0;61,0;3,0;2,0;27,0;17,0;12,0;64,0;2,0;14,0;30,0;94,0;576,0;23,0;3,0;58,0;76,0;5,0;43,0;12,0;5,0;55,0;5,0;15,0;1,0;30,0;29,0;30,0;96,0;114,0;2,0;26,0;27,0;61,0;172,0;21,0;15,0;65,0;599,0;29,0;46,0;1,0;15,0;31,0;21,0;21,0;6,0;59,0;41,0;15,0;8,0;9,0;12,0;11,0;3,0;9,0;72,0;26,0;35,0;27,0;6,0;83,0;27,0;17,0;57,0;2,0;20,0;2,0;70,0;121,0;106,0;1,0;24,0;54,0;32,0;25,0;16,0;63,0;13,0;21,0;84,0;45,0;9,0;112,0;24,0;8,0;55,0;;4,0;127,0;;10,0;22,0;106,0;4,0;18,0;3,0;7,0;355,0;32,0;87,0;26,0;30,0;15,0;29,0;6,0;17,0;55,0;42,0;14,0;28,0;53,0;39,0;21,0;77,0;2,0;5,0;40,0;188,0;;13,0;23,0;7,0;18,0;6,0;11,0;2,0;10,0;41,0;20,0;;18,0;32,0;48,0;117,0;22,0;3,0;30,0;38,0;;82,0;2,0;44,0;;83,0;;14,0;71,0;73,0;30,0;24,0;32,0;9,0;37,0;33,0;36,0;44,0;26,0;36,0;85,0;;54,0;;19,0;24,0;134,0;7,0;175,0;38,0;10,0;15,0;14,0;31,0;778,0;12,0;1,0;24,0;27,0;22,0;26,0;67,0;30,0;50,0;20,0;8,0;1,0;81,0;5,0;8,0;10,0;287,0;17,0;40,0;8,0;3,0;6,0;37,0;10,0;229,0;190,0;35,0;60,0;29,0;13,0;8,0;17,0;17,0;19,0;;46,0;40,0;7,0;33,0;39,0;69,0;25,0;32,0;5,0;2,0;24,0;55,0;64,0;34,0;30,0;21,0;8,0;27,0;52,0;70,0;1187,0;58,0;41,0;42,0;90,0;18,0;165,0;70,0;16,0;21,0;11,0;73,0;196,0;14,0;118,0;20,0;23,0;79,0;21,0;18,0;7,0;3,0;10,0;61,0;15,0;19,0;28,0;81,0;55,0;11,0;76,0;81,0;5,0;;21,0;7,0;63,0;23,0;162,0;228,0;2,0;12,0;3,0;6,0;117,0;9,0;10,0;1,0;22,0;34,0;38,0;33,0;18,0;39,0;3,0;10,0;5,0;3,0;90,0;;;18,0;21,0;6,0;90,0;3,0;8,0;;28,0;49,0;15,0;7,0;23,0;;337,0;33,0;3,0;4,0;1,0;;25,0;87,0;53,0;13,0;18,0;5,0;7,0;68,0;26,0;;50,0;7,0;15,0;42,0;;4,0;3,0;2,0;17,0;;6,0;21,0;2,0;14,0;3,0;;74,0;4,0;29,0;10,0;25,0;31,0;7,0;6,0;6,0;81,0;33,0;61,0;6,0;47,0;16,0;7,0;112,0;28,0;3,0;8,0;12,0;24,0;21,0;15,0;35,0;3,0;1,0;24,0;20,0;9,0;5,0;27,0;19,0;42,0;34,0;11,0;13,0;3,0;39,0;11,0;53,0;3,0;2,0;2,0;;7,0;7,0;;4,0;23,0;1,0;1,0;4,0;30,0;3,0;22,0;6,0;9,0;9,0;6,0;11,0;112,0;5,0;16,0;5,0;26,0;17,0;20,0;10,0;14,0;8,0;31,0;6,0;;1,0;;14,0;;22,0;5,0;;51,0;21,0;2,0;23,0;28,0;55,0;2,0;4,0;3,0;6,0;3,0;16,0;56,0;7,0;7,0;26,0;1,0;6,0;20,0;3,0;;3,0;6,0;2,0;12,0;19,0;10,0;9,0;13,0;6,0;27,0;10,0;13,0;37,0;1,0;14,0;1,0;8,0;1,0;8,0;14,0;34,0;12,0;26,0;2,0;1,0;31,0;38,0;24,0;20,0;39,0;11,0;3,0;21,0;;3,0;13,0;6,0;16,0;5,0;5,0;6,0;14,0;25,0;5,0;11,0;;9,0;16,0;9,0;26,0;;22,0;4,0;;;9,0;;
predetermine;4,0;14,0;1,0;41,0;146,0;113,0;29,0;32,0;10,0;16,0;2,0;12,0;7,0;189,0;3,0;54,0;153,0;1,0;78,0;27,0;3,0;4,0;78,0;1,0;20,0;7,0;17,0;72,0;19,0;130,0;101,0;40,0;4,0;26,0;;242,0;83,0;40,0;101,0;1,0;277,0;275,0;6,0;42,0;171,0;33,0;;113,0;;21,0;30,0;2,0;19,0;19,0;32,0;24,0;51,0;6,0;56,0;71,0;6,0;9,0;28,0;;943,0;;172,0;21,0;6,0;12,0;128,0;254,0;178,0;8,0;37,0;9,0;24,0;22,0;21,0;46,0;419,0;;67,0;32,0;88,0;13,0;;118,0;;34,0;66,0;;28,0;7,0;34,0;;331,0;52,0;250,0;132,0;372,0;;;50,0;97,0;51,0;3,0;11,0;11,0;2,0;;109,0;162,0;11,0;;7,0;56,0;35,0;22,0;152,0;14,0;1,0;313,0;112,0;4,0;81,0;162,0;14,0;7,0;3,0;576,0;7,0;;164,0;12,0;;114,0;59,0;53,0;;2,0;30,0;5,0;9,0;50,0;26,0;198,0;57,0;85,0;11,0;8,0;11,0;89,0;9,0;25,0;8,0;8,0;;2,0;;5,0;54,0;9,0;8,0;2,0;14,0;17,0;15,0;25,0;65,0;11,0;25,0;6,0;159,0;2,0;20,0;13,0;16,0;12,0;;8,0;;1,0;56,0;;3,0;20,0;16,0;140,0;21,0;8,0;2,0;;14,0;16,0;22,0;52,0;18,0;1,0;2,0;;10,0;9,0;20,0;44,0;18,0;38,0;6,0;4,0;23,0;58,0;53,0;18,0;1,0;;12,0;128,0;11,0;4,0;55,0;167,0;270,0;26,0;38,0;7,0;;197,0;11,0;;6,0;2,0;7,0;328,0;38,0;28,0;13,0;5,0;1,0;;6,0;;6,0;2,0;2,0;;92,0;30,0;52,0;74,0;8,0;;2,0;3,0;13,0;5,0;10,0;24,0;119,0;6,0;;16,0;60,0;7,0;131,0;2,0;;1,0;75,0;24,0;18,0;4,0;7,0;13,0;8,0;3,0;;11,0;214,0;52,0;23,0;19,0;1,0;80,0;14,0;9,0;;14,0;26,0;41,0;2,0;5,0;12,0;;1,0;9,0;;629,0;14,0;;13,0;;1,0;3,0;5,0;;4,0;6,0;2,0;45,0;67,0;8,0;;2,0;;31,0;;91,0;9,0;12,0;5,0;27,0;290,0;12,0;11,0;;8,0;22,0;1,0;40,0;3,0;8,0;;;;16,0;2,0;1,0;;8,0;;45,0;31,0;20,0;7,0;4,0;2,0;7,0;75,0;;7,0;;;3,0;1,0;14,0;1,0;16,0;11,0;159,0;12,0;2,0;11,0;13,0;15,0;2,0;10,0;9,0;10,0;;5,0;;;24,0;21,0;111,0;23,0;1,0;28,0;69,0;38,0;145,0;103,0;118,0;4,0;7,0;155,0;31,0;140,0;1,0;54,0;181,0;25,0;33,0;94,0;;85,0;6,0;44,0;31,0;4,0;;72,0;16,0;187,0;2,0;77,0;6,0;35,0;79,0;31,0;;79,0;7,0;27,0;59,0;83,0;;8,0;5,0;9,0;10,0;44,0;18,0;7,0;2,0;68,0;16,0;68,0;5,0;5,0;27,0;;49,0;4,0;76,0;3,0;14,0;33,0;36,0;3,0;30,0;42,0;769,0;15,0;14,0;29,0;16,0;22,0;63,0;14,0;23,0;82,0;12,0;1,0;1,0;6,0;1,0;52,0;8,0;3,0;32,0;5,0;17,0;7,0;;19,0;2,0;12,0;4,0;1,0;8,0;12,0;7,0;17,0;;2,0;23,0;2,0;2,0;19,0;5,0;19,0;7,0;7,0;1,0;6,0;54,0;;4,0;38,0;55,0;14,0;5,0;31,0;3,0;;61,0;16,0;;1,0;9,0;19,0;;16,0;17,0;92,0;6,0;4,0;;28,0;31,0;37,0;21,0;2,0;2,0;6,0;8,0;33,0;2,0;;5,0;5,0;;7,0;51,0;;;3,0;4,0;;6,0;61,0;4,0;;123,0;;158,0;7,0;25,0;55,0;3,0;25,0;2,0;11,0;1,0;35,0;4,0;3,0;4,0;7,0;;;8,0;1,0;6,0;10,0;;4,0;;6,0;21,0;15,0;2,0;;11,0;10,0;5,0;1,0;7,0;4,0;3,0;3,0;2,0;11,0;10,0;12,0;4,0;4,0;;7,0;10,0;8,0;13,0;4,0;1,0;1,0;;1,0;18,0;10,0;2,0;4,0;36,0;;5,0;;;16,0;29,0;;19,0;2,0;1,0;88,0;3,0;17,0;3,0;5,0;2,0;;12,0;4,0;8,0;5,0;1,0;;10,0;6,0;10,0;3,0;;1,0;62,0;22,0;;;5,0;1,0;;6,0;;;;27,0;;28,0;2,0;;3,0;17,0;;2,0;2,0;;26,0;13,0;10,0;3,0;13,0;1,0;1,0;;11,0;;37,0;14,0;9,0;7,0;11,0;10,0;;3,0;21,0;1,0;17,0;2,0;7,0;;1,0;;46,0;;2,0;16,0;;1,0;;8,0;66,0;7,0;3,0;;5,0;41,0;3,0;9,0;1,0;2,0;3,0;11,0;18,0;3,0;2,0;4,0;4,0;30,0;21,0;;2,0;;1,0;2,0;7,0;63,0;12,0;;8,0;2,0;;9,0;6,0;1,0;13,0;31,0;3,0;9,0;12,0;4,0;12,0;32,0;4,0;1,0;2,0;6,0;11,0;6,0;3,0;1,0;7,0;36,0;1,0;12,0;;7,0;52,0;2,0;;1,0;18,0;1,0;42,0;3,0;;7,0;;11,0;1,0;10,0;8,0;2,0;4,0;8,0;3,0;;;;1,0;7,0;1,0;;1,0;4,0;1,0;;6,0;;6,0;;1,0;2,0;9,0;4,0;27,0;;;;2,0;;3,0;;;;;6,0;2,0;19,0;;20,0;12,0;10,0;6,0;;15,0;3,0;10,0;;59,0;15,0;16,0;4,0;2,0;9,0;9,0;46,0;11,0;12,0;;15,0;50,0;4,0;7,0;33,0;;;8,0;4,0;2,0;7,0;;16,0;;26,0;13,0;5,0;3,0;6,0;;19,0;36,0;1,0;;47,0;19,0;;9,0;5,0;25,0;1,0;;11,0;2,0;1,0;14,0;5,0;12,0;2,0;;3,0;;;8,0;3,0;5,0;2,0;9,0;3,0;3,0;;27,0;;2,0;1,0;2,0;2,0;;2,0;7,0;5,0;1,0;1,0;6,0;21,0;79,0;14,0;8,0;1,0;;2,0;7,0;7,0;3,0;6,0;;5,0;;19,0;;25,0;8,0;18,0;2,0;;;3,0;;1,0;1,0;;;2,0;1,0;12,0;1,0;3,0;6,0;;1,0;2,0;5,0;;;;2,0;;1,0;1,0;;;;;;1,0;5,0;8,0;6,0;11,0;4,0;;2,0;12,0;33,0;1,0;;5,0;2,0;;;;2,0;2,0;2,0;3,0;11,0;;;1,0;9,0;2,0;23,0;;;;;6,0;3,0;;14,0;;1,0;15,0;;;2,0;1,0;;;1,0;1,0;1,0;2,0;3,0;23,0;3,0;2,0;6,0;;18,0;6,0;;1,0;2,0;9,0;3,0;;12,0;5,0;;3,0;11,0;1,0;2,0;;;1,0;9,0;2,0;;;;
prism;3,0;9,0;;;;27,0;143,0;31,0;;;;;;4,0;;;6,0;;;;;;4,0;;;3,0;;3,0;1,0;;14,0;;22,0;1,0;;;4,0;2,0;;;;24,0;;;3,0;22,0;25,0;44,0;;;;11,0;;2,0;7,0;2,0;49,0;;;1,0;2,0;;26,0;;39,0;1,0;43,0;2,0;4,0;3,0;7,0;31,0;66,0;;;;16,0;3,0;;;35,0;;;2,0;24,0;1,0;;84,0;1,0;;;4,0;9,0;;;;11,0;13,0;68,0;2,0;29,0;;;;3,0;;;;5,0;;3,0;;7,0;;;;;8,0;13,0;62,0;2,0;;;3,0;2,0;;24,0;2,0;;;4,0;3,0;;5,0;;;9,0;;;;;19,0;;;3,0;;6,0;61,0;2,0;2,0;;7,0;35,0;;;;;2,0;;;;7,0;;;;;10,0;6,0;;1,0;2,0;;18,0;7,0;;4,0;;;1,0;;;;;5,0;;;;;5,0;1,0;;;;;;3,0;1,0;4,0;2,0;;;7,0;;;;3,0;2,0;;28,0;25,0;;;;;;7,0;5,0;14,0;;5,0;3,0;3,0;;;10,0;;25,0;;;;;15,0;3,0;;;;15,0;;;4,0;;;6,0;2,0;;3,0;2,0;13,0;22,0;;3,0;;1,0;;20,0;;3,0;137,0;6,0;;;1,0;1,0;6,0;;;;2,0;;6,0;18,0;;2,0;;5,0;;2,0;59,0;5,0;19,0;;1,0;90,0;;;;;;1,0;4,0;;;;;;;4,0;;;;;;;;;;;2,0;;4,0;;;1,0;;;;9,0;;;1,0;3,0;;5,0;5,0;;;;;;;3,0;;6,0;2,0;;11,0;;;;;4,0;;;;;1,0;;8,0;;;;;;;;;2,0;;1,0;;;;;;;;;9,0;;;;;;11,0;;;;;;;1,0;;;;2,0;3,0;;;;;2,0;;;1,0;3,0;1,0;;;;;;9,0;13,0;;;;;1,0;1,0;;;2,0;;;;;;;;;;;;;;6,0;1,0;;;;;;;;;;;1,0;;3,0;;;1,0;;;;;5,0;;;;;;;;;;;;2,0;;5,0;;2,0;;;;;;;;;1,0;1,0;;;4,0;;;;2,0;;;3,0;;;1,0;;2,0;;;;;4,0;;23,0;;;;;;;;;;9,0;2,0;;;;;;;;;;;;;;;;;;;;;;;;;;;;;;;;;5,0;;;4,0;1,0;;;;;4,0;;;;;;;;;;;;;;;;;;;;;;;;;;6,0;;;;;3,0;;;9,0;;;2,0;;;;2,0;;;;;;;;8,0;;;;1,0;;1,0;;;;;;;;;;;;;1,0;;;;;;;;;;6,0;;;;;;;;;;;2,0;13,0;;;;7,0;;;6,0;;3,0;;2,0;;;;;;1,0;;;;;;;;;;;;;;;;3,0;;;;;;;2,0;;;;;;;;;;;;;;;1,0;;;;1,0;;;3,0;;;;;;;2,0;1,0;;2,0;;2,0;1,0;;;;;;4,0;;;7,0;;;3,0;;;;;;;2,0;;6,0;;;;1,0;;;;;3,0;;1,0;;;1,0;;;;;;5,0;8,0;;;;;;19,0;;;;;21,0;;;;;;1,0;;;;;;1,0;;;1,0;;;;;;5,0;;;;;;;;;2,0;;;;;;;;;;;;;;;;;;;;;;;;1,0;1,0;;;9,0;;2,0;;;;;;;;;;;4,0;2,0;;;;;;;;;;;;;;;;;;5,0;;;;;;5,0;;;;;;;;;;1,0;;;;1,0;;;;;;;2,0;;;1,0;;;;;;;;;;;;;;;1,0;;;;;;;;;;;;;;;;5,0;;;;;;;;;;;;;;;;1,0;7,0;;;;;;;;;;;;;43,0;;;;;;;;;;2,0;;;;;;;;;3,0;1,0;;;;;;;;;;;;7,0;;;;;;;;;;;;4,0;;;;;;;;
process;3,0;1,0;8,0;26,0;12,0;63,0;104,0;36,0;6,0;6,0;;7,0;8,0;144,0;2,0;4,0;302,0;;;9,0;20,0;6,0;68,0;9,0;3,0;3,0;3,0;71,0;48,0;25,0;415,0;27,0;16,0;18,0;;729,0;23,0;14,0;38,0;;137,0;161,0;1,0;79,0;120,0;5,0;14,0;25,0;;5,0;38,0;;3,0;10,0;11,0;9,0;48,0;1,0;8,0;149,0;;4,0;17,0;1,0;1911,0;6,0;125,0;4,0;2,0;;1,0;94,0;73,0;1,0;3,0;;10,0;6,0;12,0;31,0;198,0;;44,0;16,0;108,0;;4,0;49,0;27,0;10,0;28,0;4,0;13,0;;34,0;;87,0;5,0;186,0;62,0;65,0;50,0;;;272,0;406,0;12,0;42,0;2,0;;72,0;39,0;26,0;3,0;1,0;4,0;29,0;25,0;39,0;140,0;17,0;;411,0;14,0;8,0;51,0;197,0;;3,0;3,0;71,0;1,0;4,0;160,0;;47,0;72,0;6,0;12,0;;;2,0;1,0;;;34,0;29,0;16,0;26,0;22,0;3,0;3,0;19,0;5,0;8,0;26,0;;1,0;;;5,0;14,0;5,0;15,0;5,0;1,0;9,0;10,0;2,0;55,0;12,0;2,0;1,0;42,0;1,0;9,0;1,0;1,0;26,0;6,0;18,0;1,0;;9,0;;13,0;40,0;1,0;90,0;38,0;;2,0;3,0;10,0;4,0;9,0;51,0;;5,0;3,0;1,0;9,0;5,0;2,0;18,0;19,0;23,0;7,0;6,0;7,0;5,0;6,0;;1,0;;;188,0;12,0;4,0;14,0;19,0;42,0;2,0;7,0;;;35,0;;4,0;27,0;;102,0;13,0;6,0;45,0;24,0;3,0;1,0;;20,0;2,0;;;;;64,0;8,0;15,0;5,0;;1,0;2,0;3,0;15,0;13,0;3,0;5,0;13,0;;;15,0;35,0;5,0;71,0;;3,0;;10,0;16,0;7,0;3,0;10,0;11,0;24,0;1,0;;7,0;8,0;;1,0;1,0;62,0;3,0;20,0;1,0;3,0;12,0;;59,0;;;9,0;;3,0;;;23,0;5,0;1,0;;;;;2,0;;;4,0;1,0;6,0;68,0;1,0;1,0;;;2,0;;4,0;3,0;5,0;1,0;21,0;89,0;1,0;28,0;;1,0;2,0;;11,0;14,0;;;;;42,0;;;;;;6,0;7,0;1,0;;;7,0;19,0;4,0;;1,0;8,0;;7,0;2,0;83,0;3,0;2,0;1,0;211,0;15,0;7,0;1,0;;14,0;1,0;24,0;5,0;2,0;;13,0;;;10,0;4,0;10,0;2,0;1,0;17,0;37,0;1,0;129,0;12,0;;1,0;;84,0;53,0;12,0;1,0;25,0;3,0;108,0;11,0;36,0;22,0;16,0;;45,0;10,0;3,0;2,0;57,0;11,0;15,0;10,0;11,0;;26,0;22,0;5,0;;13,0;;25,0;40,0;7,0;4,0;;3,0;1,0;1,0;36,0;2,0;11,0;7,0;170,0;16,0;16,0;7,0;;28,0;13,0;28,0;13,0;5,0;;27,0;23,0;8,0;7,0;3,0;19,0;19,0;3,0;4,0;13,0;13,0;2,0;46,0;;2,0;1,0;12,0;;;5,0;3,0;90,0;3,0;5,0;50,0;12,0;25,0;35,0;3,0;18,0;17,0;4,0;5,0;;11,0;3,0;26,0;15,0;;;30,0;1,0;13,0;1,0;;;14,0;17,0;72,0;5,0;297,0;1,0;8,0;7,0;12,0;2,0;;1,0;;;12,0;2,0;12,0;19,0;14,0;74,0;6,0;10,0;6,0;26,0;17,0;1,0;6,0;7,0;35,0;5,0;3,0;;4,0;17,0;3,0;11,0;;;17,0;9,0;4,0;;1,0;6,0;;;;;;4,0;;4,0;31,0;7,0;7,0;2,0;24,0;27,0;4,0;5,0;1,0;4,0;1,0;19,0;;;1,0;16,0;;1,0;64,0;49,0;5,0;3,0;3,0;2,0;;2,0;11,0;46,0;5,0;28,0;14,0;1,0;10,0;9,0;;2,0;1,0;;;65,0;11,0;27,0;1,0;6,0;;1,0;4,0;1,0;5,0;;26,0;;3,0;2,0;14,0;10,0;1,0;9,0;5,0;7,0;;6,0;17,0;1,0;3,0;1,0;3,0;3,0;9,0;10,0;4,0;20,0;;2,0;4,0;;37,0;1,0;7,0;2,0;1,0;;2,0;2,0;4,0;30,0;20,0;4,0;5,0;11,0;;20,0;1,0;;;10,0;6,0;5,0;6,0;27,0;7,0;3,0;5,0;;;2,0;2,0;6,0;8,0;;1,0;;4,0;;;;1,0;1,0;;5,0;;9,0;5,0;6,0;3,0;10,0;;2,0;18,0;2,0;;;1,0;;;4,0;8,0;2,0;5,0;57,0;59,0;25,0;9,0;6,0;46,0;3,0;;6,0;8,0;;6,0;10,0;16,0;12,0;5,0;1,0;6,0;;1,0;13,0;120,0;2,0;6,0;3,0;;;;;1,0;1,0;25,0;;;3,0;;;;1,0;;5,0;;2,0;8,0;3,0;4,0;10,0;10,0;;27,0;1,0;3,0;;;;6,0;3,0;;;;;5,0;;4,0;2,0;;;3,0;;1,0;2,0;;;4,0;3,0;;2,0;;;4,0;;;;6,0;;1,0;1,0;;6,0;;;;;19,0;;5,0;2,0;5,0;1,0;1,0;;;;;;1,0;;1,0;1,0;;2,0;7,0;4,0;3,0;;;;;;21,0;;;;14,0;2,0;2,0;;1,0;;;37,0;1,0;2,0;;;21,0;11,0;1,0;16,0;;;3,0;4,0;3,0;4,0;4,0;1,0;;5,0;11,0;4,0;10,0;7,0;;9,0;1,0;3,0;7,0;1,0;16,0;;4,0;1,0;18,0;12,0;325,0;9,0;3,0;13,0;29,0;1,0;;6,0;;5,0;12,0;2,0;1,0;8,0;3,0;1,0;6,0;;1,0;;3,0;10,0;;1,0;5,0;3,0;;;6,0;;2,0;4,0;8,0;6,0;;11,0;6,0;;;5,0;2,0;2,0;;;6,0;7,0;;2,0;;;16,0;;9,0;4,0;22,0;4,0;;;5,0;2,0;4,0;2,0;2,0;6,0;;;1,0;;14,0;;14,0;;;1,0;6,0;;;;;;1,0;;;;62,0;;4,0;;2,0;5,0;;;2,0;;;;;;;;2,0;3,0;;2,0;1,0;5,0;;;;;;1,0;22,0;;4,0;;2,0;3,0;1,0;;3,0;4,0;;2,0;;5,0;;;1,0;4,0;;;14,0;;;7,0;;2,0;;;2,0;;9,0;15,0;;;;;;;28,0;;;;7,0;14,0;1,0;;2,0;1,0;;
processing;12,0;12,0;9,0;56,0;13,0;877,0;161,0;41,0;19,0;;1,0;29,0;;183,0;5,0;12,0;549,0;3,0;9,0;20,0;77,0;12,0;87,0;15,0;70,0;3,0;9,0;156,0;134,0;18,0;860,0;55,0;38,0;118,0;2,0;1035,0;38,0;6,0;153,0;8,0;269,0;1095,0;;197,0;271,0;25,0;10,0;80,0;2,0;31,0;54,0;;2,0;25,0;63,0;8,0;32,0;1,0;6,0;287,0;4,0;5,0;42,0;13,0;4915,0;48,0;452,0;15,0;4,0;1,0;7,0;110,0;135,0;3,0;10,0;1,0;17,0;28,0;27,0;170,0;831,0;1,0;183,0;25,0;496,0;2,0;13,0;114,0;2,0;17,0;102,0;16,0;20,0;18,0;56,0;5,0;203,0;11,0;416,0;81,0;108,0;97,0;3,0;272,0;;458,0;7,0;206,0;1,0;5,0;10,0;27,0;86,0;10,0;;8,0;82,0;54,0;75,0;296,0;39,0;;868,0;11,0;8,0;158,0;1074,0;;4,0;1,0;163,0;;1,0;1729,0;1,0;;111,0;22,0;28,0;;;13,0;1,0;;39,0;73,0;57,0;52,0;41,0;7,0;3,0;34,0;32,0;;25,0;1,0;6,0;;;;3,0;105,0;17,0;42,0;9,0;3,0;175,0;12,0;7,0;63,0;24,0;;40,0;95,0;4,0;18,0;8,0;8,0;17,0;4,0;12,0;13,0;9,0;16,0;1,0;7,0;78,0;2,0;192,0;7,0;16,0;5,0;5,0;2,0;1,0;;25,0;4,0;1,0;4,0;;9,0;3,0;55,0;23,0;91,0;38,0;;17,0;25,0;8,0;30,0;6,0;;;1,0;266,0;15,0;7,0;92,0;48,0;38,0;6,0;13,0;1,0;;74,0;;1,0;39,0;;10,0;29,0;11,0;1,0;35,0;34,0;9,0;1,0;21,0;;;;1,0;;181,0;8,0;8,0;12,0;2,0;;;3,0;15,0;22,0;16,0;8,0;42,0;4,0;;23,0;80,0;19,0;99,0;;;14,0;18,0;5,0;14,0;2,0;17,0;;44,0;3,0;;11,0;25,0;2,0;8,0;4,0;5,0;22,0;30,0;4,0;;;16,0;417,0;4,0;;24,0;;2,0;17,0;2,0;35,0;3,0;;4,0;;1,0;;2,0;3,0;;4,0;60,0;11,0;169,0;2,0;;4,0;1,0;5,0;;26,0;1,0;6,0;2,0;60,0;193,0;4,0;11,0;1,0;4,0;14,0;;63,0;6,0;;2,0;;1,0;52,0;2,0;;;;;16,0;17,0;3,0;;1,0;11,0;20,0;7,0;;;1,0;;11,0;;33,0;1,0;17,0;14,0;610,0;30,0;3,0;1,0;3,0;18,0;;44,0;26,0;2,0;;13,0;;;84,0;14,0;41,0;29,0;23,0;88,0;23,0;3,0;347,0;78,0;7,0;8,0;4,0;162,0;45,0;30,0;6,0;34,0;4,0;298,0;29,0;60,0;11,0;79,0;;80,0;47,0;5,0;;110,0;28,0;44,0;10,0;45,0;17,0;29,0;58,0;54,0;2,0;92,0;;36,0;178,0;24,0;7,0;2,0;5,0;;2,0;39,0;4,0;22,0;26,0;302,0;24,0;35,0;79,0;1,0;39,0;28,0;31,0;3,0;26,0;2,0;67,0;74,0;31,0;32,0;12,0;38,0;57,0;4,0;8,0;28,0;1,0;;131,0;1,0;9,0;6,0;22,0;;2,0;2,0;34,0;36,0;13,0;17,0;39,0;2,0;9,0;32,0;;23,0;97,0;41,0;4,0;8,0;6,0;3,0;121,0;92,0;3,0;;76,0;5,0;40,0;15,0;;29,0;1,0;22,0;53,0;24,0;650,0;3,0;58,0;24,0;3,0;6,0;1,0;22,0;10,0;;49,0;9,0;15,0;3,0;18,0;72,0;16,0;7,0;10,0;10,0;18,0;14,0;2,0;11,0;63,0;15,0;2,0;3,0;14,0;258,0;8,0;17,0;1,0;;21,0;7,0;3,0;1,0;13,0;23,0;;;;;;20,0;;14,0;13,0;6,0;31,0;18,0;3,0;9,0;16,0;2,0;1,0;9,0;17,0;33,0;;15,0;9,0;17,0;;2,0;60,0;24,0;17,0;28,0;3,0;5,0;;;7,0;18,0;11,0;11,0;21,0;;9,0;8,0;10,0;44,0;1,0;1,0;24,0;;10,0;8,0;1,0;35,0;;4,0;65,0;3,0;60,0;24,0;23,0;;12,0;6,0;27,0;36,0;10,0;3,0;19,0;4,0;1,0;4,0;3,0;9,0;24,0;2,0;9,0;16,0;3,0;41,0;10,0;9,0;;6,0;7,0;3,0;14,0;2,0;14,0;11,0;32,0;;6,0;7,0;19,0;16,0;4,0;7,0;16,0;12,0;1,0;20,0;3,0;;7,0;4,0;;1,0;12,0;99,0;11,0;11,0;;6,0;7,0;18,0;;4,0;9,0;5,0;17,0;5,0;5,0;;13,0;;2,0;14,0;3,0;2,0;4,0;4,0;17,0;20,0;16,0;15,0;1,0;13,0;70,0;6,0;5,0;;3,0;16,0;;2,0;60,0;2,0;12,0;17,0;25,0;14,0;10,0;12,0;104,0;;2,0;2,0;1,0;98,0;4,0;18,0;40,0;1,0;2,0;1,0;9,0;2,0;18,0;11,0;13,0;5,0;5,0;1,0;;;;3,0;8,0;40,0;31,0;;2,0;4,0;;7,0;2,0;1,0;1,0;22,0;1,0;56,0;89,0;;7,0;11,0;1,0;;;1,0;7,0;;;;5,0;19,0;7,0;;1,0;5,0;6,0;2,0;1,0;;3,0;;25,0;;2,0;4,0;;9,0;;16,0;3,0;2,0;;;;1,0;2,0;;11,0;3,0;2,0;1,0;;;;2,0;1,0;1,0;8,0;2,0;2,0;15,0;11,0;2,0;8,0;;;;1,0;;1,0;;;4,0;;13,0;2,0;1,0;2,0;7,0;2,0;3,0;9,0;;3,0;3,0;14,0;;66,0;3,0;6,0;1,0;5,0;;10,0;40,0;1,0;4,0;;3,0;27,0;16,0;5,0;26,0;;;3,0;6,0;13,0;35,0;1,0;2,0;;11,0;1,0;5,0;101,0;17,0;4,0;45,0;7,0;;13,0;7,0;54,0;;6,0;12,0;36,0;32,0;;19,0;6,0;9,0;4,0;4,0;;19,0;;2,0;21,0;4,0;6,0;11,0;;11,0;20,0;;7,0;4,0;3,0;52,0;1,0;2,0;7,0;2,0;44,0;2,0;2,0;4,0;7,0;16,0;;6,0;3,0;18,0;23,0;2,0;;5,0;18,0;4,0;1,0;6,0;3,0;8,0;;6,0;;1,0;5,0;1,0;5,0;8,0;4,0;8,0;1,0;5,0;;14,0;8,0;2,0;3,0;3,0;20,0;5,0;4,0;3,0;;5,0;5,0;1,0;;57,0;1,0;;;;;;;2,0;4,0;;16,0;;5,0;12,0;2,0;7,0;;;7,0;;;3,0;;;;;3,0;;1,0;8,0;1,0;;;6,0;;;;2,0;3,0;;;;3,0;4,0;;3,0;22,0;13,0;;2,0;7,0;1,0;14,0;;;;4,0;;36,0;;2,0;9,0;1,0;;4,0;1,0;1,0;;;16,0;1,0;9,0;5,0;3,0;1,0;7,0;22,0;;1,0;3,0;3,0;;4,0;4,0;3,0;1,0;;
processor;3,0;20,0;;123,0;26,0;667,0;161,0;41,0;5,0;12,0;1,0;6,0;;229,0;3,0;20,0;639,0;;72,0;22,0;64,0;;80,0;66,0;259,0;9,0;6,0;116,0;465,0;26,0;2832,0;97,0;45,0;37,0;;1031,0;39,0;18,0;168,0;;1098,0;1641,0;;261,0;568,0;93,0;11,0;82,0;7,0;25,0;74,0;2,0;8,0;22,0;86,0;17,0;9,0;2,0;23,0;488,0;2,0;;43,0;77,0;3862,0;107,0;655,0;13,0;5,0;1,0;22,0;190,0;164,0;2,0;4,0;;4,0;40,0;78,0;1020,0;637,0;7,0;142,0;63,0;294,0;11,0;26,0;87,0;10,0;35,0;68,0;4,0;10,0;18,0;31,0;2,0;252,0;39,0;467,0;104,0;245,0;51,0;;406,0;458,0;;25,0;714,0;11,0;2,0;51,0;79,0;112,0;8,0;1,0;10,0;57,0;50,0;97,0;682,0;63,0;2,0;849,0;43,0;10,0;631,0;1357,0;;40,0;2,0;168,0;3,0;;290,0;6,0;2,0;189,0;45,0;38,0;;;6,0;20,0;1,0;17,0;83,0;67,0;46,0;149,0;14,0;2,0;38,0;43,0;;43,0;22,0;;1,0;;;14,0;255,0;58,0;30,0;23,0;15,0;691,0;2,0;5,0;85,0;81,0;8,0;109,0;56,0;4,0;61,0;3,0;8,0;57,0;13,0;8,0;20,0;3,0;45,0;;1,0;53,0;3,0;183,0;12,0;3,0;11,0;34,0;20,0;;;190,0;2,0;;1,0;;6,0;11,0;35,0;87,0;230,0;10,0;6,0;23,0;46,0;33,0;53,0;8,0;;;9,0;248,0;31,0;16,0;9,0;37,0;30,0;7,0;25,0;3,0;;116,0;1,0;4,0;68,0;;14,0;50,0;21,0;7,0;29,0;9,0;4,0;4,0;20,0;;1,0;;;;139,0;32,0;5,0;15,0;3,0;1,0;;7,0;12,0;14,0;45,0;14,0;89,0;12,0;;28,0;124,0;11,0;262,0;1,0;1,0;2,0;6,0;4,0;50,0;5,0;2,0;42,0;96,0;2,0;;4,0;40,0;3,0;11,0;;16,0;20,0;68,0;16,0;;4,0;7,0;131,0;1,0;3,0;31,0;;1,0;12,0;9,0;123,0;26,0;;4,0;;;6,0;18,0;1,0;;19,0;33,0;34,0;212,0;1,0;1,0;6,0;;12,0;;41,0;10,0;6,0;18,0;216,0;235,0;7,0;29,0;5,0;4,0;2,0;;133,0;11,0;;7,0;1,0;3,0;57,0;4,0;5,0;;9,0;;39,0;32,0;4,0;;1,0;46,0;22,0;38,0;4,0;;3,0;;7,0;;109,0;2,0;2,0;4,0;421,0;117,0;9,0;9,0;19,0;49,0;13,0;23,0;80,0;8,0;7,0;10,0;10,0;;181,0;30,0;73,0;3,0;16,0;69,0;59,0;15,0;618,0;149,0;6,0;9,0;6,0;310,0;41,0;34,0;15,0;55,0;25,0;1384,0;51,0;46,0;25,0;90,0;5,0;192,0;24,0;12,0;12,0;167,0;48,0;72,0;3,0;164,0;38,0;64,0;105,0;37,0;2,0;51,0;6,0;117,0;337,0;66,0;1,0;;2,0;5,0;4,0;36,0;;77,0;165,0;819,0;37,0;153,0;97,0;1,0;42,0;8,0;48,0;11,0;26,0;4,0;205,0;70,0;63,0;9,0;14,0;38,0;78,0;15,0;50,0;137,0;15,0;4,0;218,0;10,0;3,0;16,0;97,0;;16,0;29,0;11,0;73,0;1,0;16,0;306,0;4,0;35,0;44,0;11,0;76,0;17,0;189,0;13,0;12,0;28,0;20,0;1650,0;191,0;3,0;;14,0;35,0;38,0;39,0;5,0;5,0;59,0;51,0;151,0;28,0;798,0;38,0;48,0;43,0;1,0;19,0;23,0;30,0;45,0;26,0;87,0;10,0;73,0;8,0;20,0;113,0;148,0;35,0;97,0;30,0;36,0;21,0;1,0;17,0;52,0;18,0;19,0;5,0;2,0;76,0;;9,0;4,0;;40,0;22,0;31,0;1,0;6,0;5,0;5,0;1,0;2,0;2,0;1,0;44,0;1,0;9,0;26,0;51,0;17,0;7,0;14,0;27,0;4,0;3,0;6,0;12,0;22,0;41,0;1,0;12,0;51,0;32,0;9,0;;32,0;42,0;50,0;21,0;10,0;8,0;;;8,0;10,0;14,0;6,0;33,0;2,0;61,0;19,0;48,0;13,0;3,0;12,0;4,0;;18,0;10,0;6,0;53,0;;6,0;8,0;;9,0;15,0;23,0;2,0;1,0;29,0;339,0;49,0;38,0;11,0;5,0;5,0;;31,0;7,0;6,0;43,0;4,0;8,0;356,0;2,0;76,0;8,0;20,0;1,0;31,0;10,0;;34,0;13,0;5,0;3,0;19,0;;10,0;24,0;33,0;20,0;63,0;21,0;25,0;54,0;2,0;15,0;6,0;10,0;9,0;15,0;;17,0;46,0;62,0;13,0;7,0;1,0;;5,0;18,0;11,0;20,0;2,0;10,0;2,0;31,0;13,0;1,0;8,0;;;3,0;27,0;21,0;8,0;4,0;16,0;2,0;38,0;19,0;51,0;89,0;49,0;5,0;49,0;2,0;;45,0;;16,0;133,0;15,0;9,0;36,0;52,0;21,0;18,0;3,0;121,0;8,0;13,0;12,0;28,0;33,0;16,0;33,0;38,0;;4,0;3,0;7,0;3,0;5,0;1,0;21,0;12,0;4,0;4,0;1,0;1,0;6,0;2,0;14,0;36,0;15,0;;;4,0;;22,0;8,0;17,0;;13,0;3,0;40,0;3,0;;10,0;12,0;26,0;;;13,0;6,0;7,0;1,0;11,0;17,0;19,0;1,0;2,0;;14,0;41,0;9,0;;1,0;18,0;;11,0;;1,0;3,0;;6,0;3,0;11,0;11,0;5,0;;;10,0;;1,0;;10,0;;11,0;16,0;;;3,0;;;;;;3,0;23,0;44,0;5,0;19,0;;;;;1,0;2,0;10,0;1,0;20,0;;12,0;;4,0;6,0;11,0;;1,0;4,0;3,0;3,0;1,0;3,0;;3,0;3,0;10,0;;;;1,0;55,0;;3,0;;2,0;26,0;26,0;8,0;22,0;5,0;1,0;10,0;31,0;4,0;13,0;8,0;;2,0;40,0;5,0;13,0;4,0;13,0;1,0;14,0;1,0;8,0;22,0;;26,0;;8,0;6,0;5,0;6,0;;14,0;4,0;3,0;7,0;1,0;;2,0;3,0;8,0;4,0;2,0;10,0;26,0;6,0;4,0;6,0;4,0;20,0;3,0;5,0;6,0;11,0;3,0;3,0;3,0;2,0;6,0;2,0;6,0;8,0;25,0;2,0;3,0;3,0;30,0;22,0;;3,0;15,0;31,0;2,0;1,0;1,0;23,0;6,0;;7,0;;17,0;11,0;2,0;7,0;11,0;8,0;7,0;8,0;2,0;1,0;69,0;;2,0;1,0;23,0;1,0;3,0;9,0;11,0;;11,0;3,0;9,0;5,0;20,0;4,0;12,0;7,0;11,0;1,0;;23,0;11,0;8,0;;;;1,0;12,0;10,0;18,0;2,0;1,0;4,0;;;6,0;;9,0;;;3,0;6,0;;24,0;10,0;;;3,0;;1,0;;5,0;5,0;;;;8,0;;4,0;;1,0;14,0;;5,0;;2,0;;1,0;8,0;4,0;3,0;5,0;15,0;3,0;1,0;1,0;12,0;;3,0;2,0;1,0;;19,0;20,0;1,0;8,0;6,0;1,0;;1,0;36,0;1,0;3,0;13,0;3,0;12,0;4,0;1,0;;;;6,0
product;2,0;2,0;1,0;2,0;;19,0;2,0;9,0;;3,0;;8,0;;13,0;;;18,0;;;3,0;;;93,0;6,0;2,0;1,0;1,0;5,0;565,0;4,0;27,0;2,0;1,0;;;18,0;2,0;;16,0;;33,0;60,0;;;35,0;1,0;;3,0;;3,0;8,0;;;1,0;3,0;;2,0;;;23,0;10,0;;1,0;;126,0;;51,0;;1,0;;1,0;15,0;18,0;;;3,0;1,0;2,0;3,0;3,0;64,0;1,0;1,0;18,0;1,0;;;1,0;;9,0;2,0;;1,0;;1,0;;12,0;8,0;15,0;14,0;9,0;3,0;;12,0;7,0;25,0;;531,0;1,0;;;1,0;9,0;;;3,0;3,0;17,0;9,0;23,0;;2,0;8,0;4,0;13,0;22,0;71,0;;1,0;;119,0;;;1,0;1,0;;9,0;10,0;2,0;;;4,0;;;1,0;1,0;13,0;2,0;13,0;1,0;;3,0;1,0;3,0;;;;;;;;;1,0;;;1,0;1,0;6,0;;2,0;6,0;;1,0;;;;;;;1,0;;;2,0;3,0;;;8,0;;29,0;;;2,0;;1,0;;;11,0;6,0;46,0;;;;;1,0;7,0;6,0;;;;;;6,0;;;;;1,0;2,0;;1,0;1,0;1,0;2,0;;;;14,0;;2,0;11,0;;;4,0;32,0;2,0;;1,0;;;11,0;1,0;;;;;39,0;;1,0;;2,0;;;;;;;2,0;46,0;;;1,0;2,0;;5,0;1,0;;;;2,0;8,0;;;;;;;;18,0;;1,0;1,0;;;;;;;2,0;4,0;;;19,0;2,0;;;;5,0;;;;;;;1,0;;;;;6,0;9,0;;;;;;;;;;;14,0;31,0;;3,0;2,0;;;;3,0;9,0;;;;;12,0;;;;;;;;;;;;3,0;8,0;;;;;;;9,0;;;;11,0;3,0;4,0;;;9,0;1,0;5,0;2,0;;;;;;13,0;;1,0;;;1,0;2,0;1,0;8,0;4,0;;1,0;2,0;11,0;3,0;10,0;1,0;6,0;1,0;8,0;2,0;4,0;;12,0;;17,0;9,0;;3,0;1,0;2,0;5,0;;4,0;1,0;1,0;2,0;1,0;;5,0;;;6,0;3,0;;;;;;11,0;;;37,0;27,0;;8,0;2,0;;4,0;1,0;1,0;2,0;2,0;;9,0;16,0;1,0;;30,0;3,0;3,0;1,0;1,0;79,0;3,0;;20,0;;;;3,0;;17,0;;;;;5,0;47,0;2,0;5,0;2,0;;3,0;1,0;;6,0;;;;86,0;4,0;;;1,0;6,0;2,0;;;;1,0;13,0;3,0;1,0;10,0;;;8,0;;;1,0;1,0;;;1,0;2,0;11,0;;;5,0;5,0;6,0;24,0;6,0;1,0;6,0;1,0;;;;;1,0;;3,0;;5,0;;;1,0;2,0;1,0;;2,0;;;;;;;2,0;;;5,0;;1,0;1,0;;3,0;;2,0;1,0;9,0;4,0;4,0;;;1,0;;;;1,0;1,0;1,0;3,0;;6,0;;;10,0;;2,0;;7,0;;2,0;;4,0;;;2,0;1,0;;;4,0;;2,0;;;;;2,0;1,0;3,0;;;1,0;33,0;;;5,0;;10,0;8,0;7,0;;1,0;5,0;;;11,0;;8,0;;1,0;6,0;7,0;2,0;;;;3,0;6,0;2,0;;1,0;2,0;;1,0;6,0;1,0;3,0;5,0;;;;;1,0;;1,0;;14,0;6,0;4,0;;;4,0;;1,0;1,0;3,0;;;;1,0;;;;6,0;;2,0;1,0;;7,0;;6,0;;4,0;;1,0;;1,0;1,0;1,0;;6,0;;;1,0;11,0;;;;;3,0;;4,0;4,0;2,0;;;;;;;1,0;;;;;;;;;;;3,0;;;;1,0;;;;;;;;9,0;;;;;;2,0;;;;;;;;;;;1,0;;;1,0;;1,0;;;;;;;;;4,0;;;;;4,0;1,0;;;;;;;;;;;;;;;;;;;;;;;;;;;;1,0;;;;;;6,0;1,0;;;11,0;;;;;;;;7,0;;;;7,0;;;;;;;5,0;;;;;1,0;21,0;;1,0;2,0;;;3,0;;;;;;;;;;;;3,0;;;;;1,0;;1,0;6,0;;;;;;;;;;;;;;;;5,0;;60,0;;;4,0;;;;2,0;3,0;;;;;11,0;5,0;;;;;;5,0;;;5,0;1,0;5,0;1,0;;;;;;;;3,0;;;;1,0;;;;;;1,0;2,0;;;;2,0;3,0;3,0;;;;;4,0;;;1,0;;;;;;2,0;;;;;;6,0;;;;1,0;;;;;;;;;;;;;;;;;;1,0;;;;;;1,0;;;;;;;;;;;;;;;;;;;;;;6,0;;;;;;;;;;1,0;;;;;;;;;;;;;;;
program;2,0;4,0;1,0;11,0;3,0;120,0;9,0;4,0;;6,0;;;2,0;26,0;;1,0;79,0;2,0;5,0;6,0;;;16,0;9,0;9,0;4,0;2,0;23,0;1279,0;9,0;289,0;31,0;4,0;3,0;;102,0;7,0;7,0;18,0;;195,0;514,0;2,0;37,0;165,0;1,0;3,0;17,0;6,0;24,0;26,0;1,0;4,0;2,0;17,0;2,0;;1,0;;48,0;;;2,0;15,0;428,0;58,0;237,0;2,0;1,0;;3,0;32,0;31,0;;3,0;;;7,0;25,0;298,0;161,0;1,0;7,0;8,0;22,0;;7,0;8,0;;1,0;17,0;1,0;;1,0;9,0;;49,0;5,0;66,0;19,0;34,0;11,0;;42,0;206,0;714,0;531,0;;2,0;;2,0;8,0;12,0;;;1,0;15,0;11,0;17,0;36,0;9,0;1,0;32,0;7,0;1,0;492,0;221,0;;2,0;1,0;22,0;2,0;;80,0;;1,0;28,0;17,0;6,0;;;;;;3,0;17,0;10,0;1,0;17,0;;;9,0;7,0;;6,0;;;;;;;14,0;10,0;6,0;2,0;1,0;18,0;;;3,0;4,0;;42,0;13,0;;8,0;;;20,0;;3,0;2,0;5,0;10,0;;2,0;38,0;;30,0;3,0;1,0;6,0;;4,0;2,0;;4,0;;;;;;;17,0;7,0;506,0;1,0;;2,0;5,0;4,0;6,0;2,0;;;;34,0;3,0;;7,0;3,0;5,0;3,0;;3,0;;40,0;2,0;3,0;5,0;;8,0;8,0;2,0;3,0;3,0;1,0;;;5,0;;;1,0;;;31,0;;8,0;;1,0;;;;6,0;1,0;1,0;1,0;9,0;;;2,0;15,0;;25,0;;;1,0;1,0;3,0;1,0;;1,0;2,0;2,0;1,0;;20,0;15,0;;11,0;4,0;6,0;6,0;;;;;5,0;18,0;;3,0;9,0;;;;1,0;11,0;4,0;;;;;;4,0;;;2,0;1,0;42,0;17,0;;;1,0;;;;3,0;;;3,0;42,0;49,0;;5,0;;;;;3,0;1,0;;;;;72,0;;;;;;4,0;;1,0;;;;7,0;1,0;;;;;4,0;;22,0;1,0;3,0;;73,0;21,0;;1,0;2,0;10,0;;5,0;6,0;;;7,0;3,0;;21,0;7,0;12,0;1,0;1,0;21,0;13,0;4,0;127,0;8,0;1,0;;2,0;62,0;38,0;4,0;7,0;9,0;6,0;457,0;39,0;5,0;;32,0;;38,0;6,0;;;18,0;8,0;20,0;;24,0;5,0;16,0;24,0;3,0;2,0;8,0;3,0;16,0;29,0;18,0;;1,0;2,0;2,0;;7,0;1,0;9,0;239,0;163,0;9,0;34,0;4,0;2,0;1,0;6,0;10,0;8,0;;;342,0;28,0;5,0;;1,0;12,0;12,0;4,0;11,0;189,0;3,0;1,0;46,0;1,0;6,0;3,0;6,0;;1,0;1,0;7,0;16,0;;4,0;60,0;;7,0;7,0;5,0;17,0;2,0;82,0;2,0;4,0;3,0;1,0;965,0;64,0;1,0;;1,0;;3,0;15,0;;;1,0;14,0;14,0;1,0;105,0;1,0;11,0;12,0;2,0;1,0;5,0;3,0;;;7,0;;27,0;;3,0;12,0;62,0;;1,0;13,0;2,0;;1,0;7,0;9,0;9,0;2,0;;;11,0;9,0;2,0;;;4,0;;5,0;;4,0;;;;;;;10,0;;1,0;1,0;1,0;1,0;13,0;1,0;3,0;2,0;3,0;9,0;2,0;8,0;11,0;;;2,0;8,0;3,0;;11,0;11,0;19,0;14,0;;2,0;;;;7,0;7,0;2,0;14,0;;2,0;2,0;1,0;4,0;;1,0;9,0;;;6,0;1,0;8,0;;;1,0;2,0;1,0;5,0;9,0;;;8,0;481,0;2,0;7,0;4,0;1,0;5,0;;33,0;2,0;;9,0;;3,0;118,0;2,0;14,0;4,0;16,0;2,0;9,0;;6,0;3,0;;1,0;1,0;4,0;;3,0;2,0;2,0;3,0;6,0;8,0;5,0;8,0;37,0;;;;2,0;3,0;4,0;1,0;1,0;27,0;;;;1,0;1,0;3,0;2,0;6,0;;;1,0;3,0;;;;;;8,0;;;2,0;;3,0;;2,0;2,0;2,0;20,0;26,0;5,0;13,0;;;;;;15,0;1,0;;1,0;2,0;11,0;;1,0;17,0;2,0;2,0;;2,0;10,0;;2,0;4,0;;;2,0;;;6,0;;;;1,0;1,0;;1,0;1,0;;;1,0;;;;;;1,0;;1,0;;;1,0;8,0;;1,0;;1,0;2,0;;;;2,0;3,0;;;1,0;1,0;;1,0;;3,0;2,0;3,0;1,0;;2,0;;17,0;;;;;3,0;3,0;5,0;;1,0;;;;;;;4,0;;;;;;;;;;;;6,0;1,0;1,0;1,0;;;;;1,0;;;;;41,0;1,0;;;2,0;1,0;;;;;;;1,0;;;6,0;;7,0;;1,0;;;6,0;;1,0;;3,0;12,0;2,0;;3,0;1,0;;1,0;4,0;;1,0;2,0;;;3,0;4,0;;;1,0;;8,0;;;;;5,0;;;3,0;;;;;;;2,0;;;3,0;;1,0;1,0;;;7,0;2,0;1,0;;;4,0;;;;2,0;;;;11,0;;3,0;;1,0;;1,0;2,0;1,0;4,0;2,0;;;1,0;5,0;1,0;;;;;;;;9,0;2,0;;1,0;5,0;;3,0;2,0;1,0;;1,0;3,0;;;3,0;2,0;4,0;10,0;1,0;;2,0;;;;;;;;1,0;;;3,0;;;;;;1,0;;3,0;;1,0;;;;;1,0;;;;1,0;;;;;;1,0;;;;;;2,0;;;1,0;;;1,0;;;;1,0;;;;;;;3,0;;;;5,0;;;;4,0;1,0;;1,0;;;;;2,0;7,0;7,0;1,0;;2,0;;;2,0;;1,0;2,0;12,0;;;;;
property;5,0;;1,0;18,0;4,0;10,0;3,0;1,0;;19,0;;4,0;1,0;44,0;;6,0;29,0;;6,0;100,0;;;6,0;;3,0;;;11,0;4,0;2,0;50,0;19,0;7,0;;1,0;104,0;12,0;;1,0;;163,0;35,0;;;20,0;;1,0;24,0;;;30,0;;;;;1,0;6,0;;2,0;5,0;;;5,0;;231,0;1,0;79,0;3,0;;;2,0;56,0;34,0;4,0;;4,0;25,0;;;7,0;104,0;;;15,0;7,0;5,0;;113,0;3,0;15,0;13,0;;1,0;;2,0;;33,0;4,0;64,0;4,0;26,0;11,0;5,0;2,0;1,0;11,0;1,0;2,0;;;;6,0;49,0;;;;4,0;27,0;4,0;73,0;;;8,0;8,0;1,0;12,0;33,0;;;;29,0;13,0;;21,0;;;10,0;16,0;1,0;;;;;;;4,0;51,0;5,0;57,0;;;22,0;2,0;1,0;;;;1,0;1,0;;6,0;6,0;;8,0;;2,0;1,0;9,0;2,0;;2,0;;;1,0;;6,0;;;1,0;;;;2,0;;;8,0;8,0;;64,0;11,0;;;;;;;1,0;1,0;;;1,0;2,0;4,0;;4,0;7,0;4,0;7,0;6,0;;;;;;;8,0;2,0;;;3,0;7,0;2,0;;;;;11,0;;1,0;9,0;;;15,0;1,0;1,0;4,0;1,0;5,0;;8,0;1,0;;1,0;;;12,0;;5,0;1,0;1,0;;;;8,0;2,0;;4,0;50,0;3,0;;;;;1,0;;2,0;;14,0;3,0;5,0;;;1,0;;;;5,0;;;4,0;;;;;17,0;;;4,0;4,0;;;18,0;;1,0;1,0;;6,0;;;;;;;;;;;;2,0;24,0;;;;;;;20,0;;2,0;1,0;;77,0;;3,0;;;1,0;;7,0;;;;;;3,0;;;;1,0;;;3,0;;;;;26,0;;;;;;;;8,0;;2,0;;53,0;;;;;;;5,0;55,0;;;;;;2,0;;12,0;14,0;;;45,0;1,0;29,0;5,0;;3,0;1,0;33,0;1,0;13,0;;11,0;;1,0;1,0;5,0;;7,0;;32,0;6,0;1,0;;1,0;1,0;5,0;;26,0;5,0;23,0;22,0;1,0;;8,0;;;5,0;18,0;;;;1,0;;;;3,0;;10,0;12,0;11,0;7,0;;12,0;;22,0;;2,0;;2,0;;;;;;31,0;13,0;4,0;2,0;18,0;;2,0;;;3,0;;;;;;3,0;;;3,0;5,0;;;;;1,0;;;;1,0;1,0;7,0;2,0;;;;;;;;;;1,0;;;4,0;14,0;;;;;;2,0;;1,0;2,0;;;;;;;;;;;;;6,0;;;;;4,0;;;1,0;;;;;;2,0;;;;;3,0;;;;;3,0;;;;;;21,0;1,0;;;6,0;;1,0;;;;;;;;4,0;;;;;;;2,0;;7,0;;;;2,0;;2,0;;;;;3,0;;1,0;3,0;5,0;;;;;5,0;;;;;;1,0;;;;;;;;3,0;1,0;21,0;;;;;13,0;;;;1,0;;;;;10,0;;;;2,0;;;;;;;;;5,0;1,0;;2,0;;;;1,0;10,0;;;;;;;;;;;;6,0;;1,0;;;;;;;6,0;3,0;;;6,0;;;2,0;;1,0;2,0;;;;;;6,0;;;;;;;2,0;3,0;;;;;7,0;1,0;;1,0;1,0;;;;;;;;;;;;;;;;1,0;2,0;;;;;;;;5,0;;;3,0;;14,0;;4,0;;;1,0;1,0;;2,0;;;11,0;1,0;;;;;1,0;1,0;;;;;1,0;;;;;;;;1,0;;;;;;1,0;;;;;;;;;;;;1,0;;;;;;11,0;;;;;;4,0;;;;;;1,0;;;;;;;;3,0;;;;4,0;;;;;;;65,0;;12,0;;1,0;;4,0;;2,0;;;;51,0;;;;16,0;;9,0;;;;;4,0;;;;;;5,0;;;;;;2,0;4,0;2,0;1,0;;;;;4,0;;;;;1,0;;4,0;;;;3,0;;;;1,0;;;;1,0;;;;2,0;;;2,0;;;;2,0;;;1,0;;;2,0;;;;3,0;;;;;;2,0;;;;1,0;;;;;;;;2,0;;;1,0;13,0;;;;;;;;5,0;;;2,0;;;;;;;5,0;8,0;;;;;;;;;;;;;;;3,0;;;;;4,0;;;;;;;;;;;;2,0;;;2,0;;;;;1,0;2,0;;;;;;;;15,0;;2,0;;;1,0;;;1,0;1,0;;;;;;;;;;;;;;
pupil;1,0;;;;3,0;3,0;9,0;1,0;;;;;;36,0;;;1,0;;;;;;;;;;;;;;4,0;2,0;15,0;6,0;;37,0;1,0;;;;15,0;11,0;10,0;3,0;6,0;1,0;;3,0;;1,0;21,0;46,0;;;2,0;4,0;1,0;;;16,0;;;16,0;;82,0;;2,0;;;;3,0;73,0;27,0;;;;;;;;15,0;;3,0;;2,0;;;24,0;;;;;26,0;;3,0;;12,0;10,0;48,0;10,0;103,0;2,0;;;5,0;2,0;;;;;;2,0;5,0;;;;3,0;;3,0;8,0;;1,0;3,0;1,0;;3,0;21,0;;;;;;;13,0;3,0;;7,0;2,0;;;;;;;;;7,0;;;;;1,0;2,0;;;;;;;;;;;;;;1,0;1,0;1,0;6,0;;1,0;1,0;12,0;;55,0;;;;;;;;7,0;;;2,0;;3,0;;;;;;;;4,0;2,0;;;;;;;4,0;2,0;;;;;2,0;8,0;1,0;;;;;;;;4,0;;1,0;1,0;4,0;;7,0;;;4,0;;1,0;;;;;5,0;4,0;;8,0;;;;;;14,0;3,0;4,0;4,0;;;;;;;;;14,0;2,0;;;;;;;;;;;;;;;;4,0;;2,0;5,0;;;3,0;;3,0;;;;;;;;;;;;;;52,0;;;;;;;1,0;;1,0;;;17,0;9,0;;;;;4,0;;;;;;;11,0;2,0;;;;;;3,0;1,0;;;;;;;;;2,0;;;;;;;;2,0;;;;;;;;6,0;;;;;;;;2,0;;;;5,0;1,0;;;;;10,0;46,0;2,0;;;;3,0;;;2,0;;;;28,0;;3,0;;;;;;5,0;;11,0;;;1,0;;;;;;;20,0;;;;;;;;6,0;;;;;;;;;;3,0;1,0;2,0;;1,0;;;8,0;;;;;;2,0;6,0;;;;;1,0;;;2,0;;;33,0;;;;;;13,0;;2,0;;;;;1,0;;;;;;;;13,0;;;1,0;;;;;;;5,0;;;;;;;1,0;;16,0;;;;;;;;;;;;4,0;;;;12,0;2,0;;;;3,0;;;;;;;;1,0;;;;;;9,0;;;;;;;;;;;2,0;;;2,0;;;;;;;;1,0;;;;;;;5,0;;;1,0;;;;;;;;;;;;;;;;;;;3,0;2,0;;;;;;;;;1,0;;;;;;;;;;;;;2,0;;;;;1,0;;;;;;;;;;;;;;;;;;;;;;;;1,0;;;;;;;;;;;;;5,0;1,0;;;;;;;;;;;;;;;;;1,0;1,0;;;;;;;;;;;1,0;9,0;;;;;;;;;;;;;;;3,0;;;;;;;;;;;;;;;;;4,0;;;;;;3,0;;;;;;;3,0;;;7,0;1,0;;;;;;;;;;;;;;3,0;4,0;;;;3,0;;;;1,0;;;;;;;;;;;;;;;;;;;;;;;;;;23,0;;;;4,0;;;;;;5,0;;;;;;;;;;;;;;;;;;;;;;;;;;;;;;3,0;1,0;;1,0;;;;;3,0;;;;;;;;;;;;;;;;;1,0;;;;;;;1,0;;;;;;;;;;;;1,0;;;;;;;;;;;;;;;;;;;;;;;;1,0;;;;;;;;;;;;;2,0;;;;;;;1,0;;;7,0;;;;;;;;;;;;;;;;;;;;;;;;;;;;;;;;;;;;;;;;;;;;;;;;;;;;;;;;;;;;;;;;;4,0;;;3,0;1,0;;;;;;;;;;;;;;;;;;;;3,0;;;;;;;;;;;
reduction;3,0;;4,0;;4,0;2,0;4,0;1,0;;;;;;4,0;;;2,0;;;;;;13,0;;;1,0;;;;1,0;14,0;1,0;;12,0;;37,0;;;3,0;;12,0;11,0;1,0;2,0;2,0;;;2,0;;;;;;;3,0;;;;;3,0;;;;;49,0;1,0;11,0;;;;;1,0;3,0;;;;;1,0;;2,0;16,0;;;;2,0;;;4,0;;;;;;;;;4,0;;12,0;2,0;;;3,0;72,0;10,0;51,0;;2,0;;;;;;;;2,0;5,0;;;2,0;;4,0;;12,0;;;3,0;;;2,0;2,0;2,0;;3,0;;;;;;;;;;1,0;;1,0;;1,0;;;;;1,0;;;;;1,0;;;;2,0;;;;;;;;;;;;33,0;;;1,0;;1,0;;;;;;;;1,0;;1,0;;;;;;;;;;1,0;;;9,0;;;;;;;;;;;;;;1,0;2,0;;;;6,0;;;;;;1,0;;3,0;;;;2,0;3,0;;;1,0;5,0;;;;;;;;;;1,0;;;;;;1,0;;;;5,0;;;;;;;;;;1,0;1,0;;;;2,0;;;;4,0;;;;;;2,0;;;;;;1,0;;;;;;4,0;;;;;1,0;;;;;;;;;1,0;;;;;;;;;;;;;8,0;;;;;1,0;;1,0;;;;;;;;;;;;3,0;2,0;;;;;;;;3,0;;;;;;;;;5,0;;;2,0;;;;4,0;;2,0;;1,0;;;;1,0;3,0;1,0;;;;;1,0;;;;;1,0;;6,0;;2,0;;;;;;1,0;;;;;;3,0;1,0;5,0;;;;;1,0;8,0;;7,0;;;2,0;;;;;;;5,0;;5,0;;;;;;;;;4,0;;12,0;;;6,0;;;;;;;;;;;;;;;;;;;;3,0;;3,0;;;2,0;;;;;;;;;;;;;1,0;;;;;;;;1,0;;;12,0;;;;;;;;;;;;;;;4,0;;;;36,0;;;;;;1,0;;;;;;;;;;;;;;;;;;;19,0;;;;25,0;;;;;;;;;;;;;;;;;;;;;;;;;;;;;;;;;;;;;;;;;2,0;;4,0;;;1,0;;;;;;;;;;;;;;;;;;;;;;;1,0;;;;;;;14,0;;;;;;;;;;;;;;;;;;;;;;;;;;;;;;;;;;;;;2,0;;;;;;;2,0;3,0;;3,0;;;;;;;;;;;;;;;;;;;;;;;;;;;;;4,0;;;1,0;;;;;;;;;;;;;;1,0;2,0;;;;;2,0;;;;;;;;;;;;;;;1,0;;;1,0;;;;;;;;;;1,0;;;;;;1,0;;;;;;;;;;;;;;;;;1,0;;;;;1,0;1,0;;1,0;;;;;;;;;;;;;;;;1,0;;;;;;;;;;;1,0;;;;;;;;;;;;;;;;;;;;;;;;;;1,0;;8,0;;;;;1,0;;;;;;;;;;;;;;;;3,0;1,0;1,0;;1,0;;;;;;;;;;;;;;;1,0;;;;;;;;;2,0;;;;;;;;1,0;;;;;1,0;;;;;;;;;;;;;;;;;;;;;;;;;;;;;;;;;;;;;;;;;;17,0;;;;3,0;;;;;;;;2,0;;;;;;;;;;;3,0;;;;;;;;;;;;;;;;;;;;;;;;;;;;;;;;;;;;;;;;;;;;;;;;;
reference;1,0;1,0;;23,0;58,0;112,0;76,0;12,0;3,0;29,0;;2,0;5,0;348,0;;19,0;306,0;35,0;15,0;56,0;;18,0;159,0;1,0;4,0;17,0;34,0;159,0;14,0;21,0;218,0;28,0;37,0;93,0;;282,0;50,0;14,0;190,0;4,0;416,0;207,0;2,0;46,0;77,0;30,0;;16,0;;17,0;78,0;;1,0;15,0;41,0;4,0;53,0;;34,0;244,0;;9,0;71,0;3,0;2105,0;1,0;294,0;9,0;17,0;1,0;4,0;72,0;118,0;;3,0;21,0;1,0;27,0;2,0;65,0;312,0;4,0;10,0;37,0;95,0;17,0;;73,0;;13,0;32,0;2,0;10,0;14,0;50,0;;437,0;182,0;300,0;907,0;359,0;109,0;;39,0;27,0;79,0;1,0;8,0;6,0;2,0;;;164,0;32,0;;8,0;9,0;98,0;38,0;152,0;32,0;2,0;456,0;25,0;;109,0;338,0;;36,0;;226,0;4,0;4,0;225,0;11,0;11,0;83,0;67,0;9,0;;;35,0;;;1,0;46,0;36,0;20,0;126,0;9,0;7,0;7,0;70,0;2,0;;13,0;;;3,0;5,0;;42,0;12,0;27,0;20,0;4,0;27,0;9,0;4,0;35,0;46,0;2,0;7,0;127,0;10,0;68,0;7,0;3,0;3,0;;;;1,0;65,0;;;33,0;2,0;507,0;20,0;4,0;3,0;;26,0;6,0;5,0;4,0;;1,0;1,0;;;;6,0;65,0;27,0;15,0;6,0;21,0;29,0;34,0;32,0;33,0;;;5,0;114,0;12,0;2,0;23,0;125,0;16,0;1,0;14,0;7,0;;46,0;2,0;;8,0;3,0;;52,0;27,0;2,0;8,0;29,0;10,0;;23,0;;2,0;;4,0;;212,0;4,0;9,0;51,0;2,0;7,0;;2,0;16,0;8,0;60,0;2,0;132,0;16,0;;;20,0;9,0;116,0;5,0;4,0;5,0;2,0;20,0;16,0;5,0;1,0;7,0;11,0;16,0;;2,0;142,0;;12,0;4,0;6,0;91,0;5,0;17,0;;5,0;9,0;103,0;;18,0;2,0;;;10,0;;190,0;14,0;2,0;1,0;;14,0;2,0;3,0;;;;4,0;35,0;174,0;8,0;9,0;1,0;;13,0;9,0;41,0;2,0;;2,0;4,0;452,0;3,0;11,0;4,0;;3,0;3,0;30,0;1,0;;;;1,0;19,0;;;;3,0;;19,0;25,0;7,0;;7,0;;28,0;29,0;;;;;4,0;;22,0;6,0;4,0;17,0;174,0;;9,0;3,0;3,0;;;24,0;17,0;7,0;;7,0;;;140,0;81,0;62,0;8,0;2,0;7,0;139,0;47,0;89,0;386,0;3,0;14,0;3,0;88,0;33,0;111,0;;8,0;10,0;1,0;33,0;38,0;8,0;23,0;6,0;68,0;37,0;4,0;1,0;66,0;3,0;57,0;14,0;243,0;;10,0;72,0;4,0;;15,0;;9,0;57,0;56,0;4,0;3,0;8,0;2,0;3,0;13,0;10,0;19,0;6,0;133,0;6,0;40,0;;1,0;63,0;;98,0;;19,0;;12,0;65,0;20,0;10,0;28,0;33,0;43,0;13,0;23,0;11,0;20,0;9,0;19,0;7,0;109,0;254,0;6,0;;;;18,0;196,0;12,0;2,0;35,0;1,0;13,0;8,0;1,0;14,0;1,0;;6,0;;5,0;3,0;13,0;4,0;;1,0;7,0;1,0;8,0;14,0;25,0;58,0;24,0;57,0;7,0;33,0;31,0;46,0;1,0;74,0;22,0;7,0;31,0;37,0;5,0;;9,0;;6,0;;42,0;11,0;3,0;13,0;43,0;40,0;20,0;;6,0;16,0;1,0;28,0;1,0;;11,0;8,0;;33,0;;;3,0;;6,0;4,0;4,0;4,0;;;;;1,0;5,0;;7,0;46,0;1,0;8,0;3,0;6,0;64,0;6,0;3,0;4,0;7,0;2,0;25,0;;10,0;;3,0;;;12,0;7,0;1,0;15,0;;44,0;;;4,0;28,0;2,0;;17,0;3,0;15,0;1,0;12,0;;;;;;25,0;7,0;;11,0;;;;;98,0;;9,0;;;5,0;29,0;30,0;;10,0;6,0;26,0;9,0;;;1,0;34,0;;3,0;;;157,0;4,0;4,0;9,0;14,0;34,0;2,0;31,0;24,0;21,0;2,0;;;5,0;28,0;6,0;1,0;;;29,0;32,0;;5,0;1,0;;3,0;;;2,0;;12,0;;;;1,0;22,0;13,0;;23,0;13,0;4,0;61,0;6,0;;;;;4,0;2,0;16,0;8,0;23,0;;10,0;12,0;27,0;72,0;6,0;6,0;12,0;4,0;3,0;;24,0;;;;78,0;5,0;3,0;28,0;1,0;13,0;5,0;5,0;231,0;5,0;5,0;9,0;2,0;11,0;2,0;;14,0;9,0;;;;;124,0;;;31,0;;2,0;;;;2,0;15,0;9,0;17,0;;;1,0;;;;4,0;11,0;;2,0;32,0;2,0;;8,0;20,0;2,0;6,0;;;8,0;5,0;1,0;4,0;28,0;7,0;;13,0;;9,0;206,0;2,0;;16,0;36,0;;20,0;;10,0;1,0;;;;6,0;4,0;4,0;4,0;;;;1,0;;6,0;;;;;1,0;1,0;;11,0;3,0;;;1,0;;2,0;;38,0;;;;;;;;6,0;;2,0;;2,0;;;17,0;3,0;;8,0;13,0;29,0;13,0;59,0;;18,0;39,0;;;3,0;4,0;;28,0;30,0;35,0;;10,0;19,0;10,0;28,0;7,0;4,0;;8,0;20,0;12,0;21,0;6,0;2,0;14,0;38,0;3,0;;10,0;20,0;3,0;7,0;5,0;;9,0;45,0;3,0;;1,0;3,0;10,0;4,0;;;4,0;3,0;15,0;4,0;;;12,0;1,0;4,0;10,0;24,0;12,0;11,0;6,0;16,0;11,0;21,0;;8,0;;;11,0;17,0;12,0;;11,0;35,0;;4,0;;1,0;18,0;20,0;5,0;27,0;;1,0;30,0;18,0;4,0;;16,0;3,0;2,0;;7,0;;;3,0;;10,0;3,0;8,0;2,0;;;;;2,0;;2,0;6,0;2,0;;;2,0;;4,0;13,0;2,0;;;7,0;;;;2,0;;;;1,0;;5,0;;;1,0;25,0;5,0;13,0;;29,0;;;15,0;11,0;;18,0;;;4,0;9,0;36,0;19,0;;;;;;;;10,0;;1,0;;34,0;1,0;;;11,0;3,0;;10,0;;;2,0;;;9,0;2,0;1,0;;7,0;;;4,0;1,0;1,0;3,0;;;;3,0;7,0;;4,0;;;;16,0;;;;;23,0;4,0;17,0;2,0;8,0;;
region;15,0;2,0;1,0;94,0;31,0;190,0;97,0;42,0;4,0;4,0;2,0;16,0;19,0;378,0;13,0;123,0;388,0;17,0;55,0;38,0;58,0;110,0;370,0;3,0;9,0;1,0;;61,0;31,0;19,0;216,0;59,0;17,0;26,0;1,0;286,0;159,0;13,0;161,0;1,0;610,0;413,0;11,0;76,0;537,0;190,0;34,0;149,0;5,0;8,0;56,0;8,0;116,0;30,0;270,0;47,0;546,0;;29,0;156,0;42,0;12,0;55,0;;2793,0;9,0;923,0;35,0;10,0;27,0;12,0;190,0;561,0;2,0;;5,0;15,0;36,0;13,0;23,0;499,0;3,0;32,0;57,0;109,0;22,0;4,0;148,0;12,0;16,0;52,0;41,0;38,0;212,0;59,0;6,0;879,0;73,0;1045,0;206,0;386,0;162,0;7,0;26,0;86,0;112,0;9,0;12,0;49,0;5,0;;164,0;;73,0;;6,0;31,0;174,0;152,0;420,0;31,0;5,0;88,0;188,0;26,0;108,0;224,0;;3,0;12,0;114,0;4,0;33,0;177,0;17,0;;361,0;55,0;9,0;5,0;;159,0;;;12,0;72,0;198,0;521,0;147,0;34,0;33,0;126,0;52,0;24,0;7,0;221,0;1,0;3,0;1,0;31,0;174,0;90,0;144,0;14,0;45,0;2,0;173,0;118,0;13,0;116,0;46,0;23,0;35,0;226,0;;79,0;10,0;42,0;4,0;1,0;4,0;9,0;28,0;166,0;1,0;99,0;164,0;1,0;257,0;58,0;39,0;2,0;6,0;16,0;47,0;22,0;52,0;24,0;28,0;14,0;42,0;298,0;12,0;5,0;18,0;17,0;144,0;77,0;40,0;177,0;26,0;74,0;15,0;6,0;6,0;65,0;67,0;12,0;167,0;22,0;200,0;7,0;9,0;233,0;14,0;43,0;839,0;;4,0;16,0;17,0;29,0;94,0;34,0;31,0;36,0;15,0;70,0;;77,0;;25,0;;;1,0;301,0;49,0;89,0;242,0;4,0;;10,0;8,0;22,0;257,0;70,0;94,0;395,0;121,0;2,0;105,0;38,0;394,0;151,0;25,0;50,0;;144,0;42,0;74,0;12,0;33,0;;12,0;;;11,0;32,0;6,0;7,0;;30,0;45,0;33,0;135,0;1,0;49,0;32,0;152,0;9,0;15,0;1,0;1,0;6,0;40,0;5,0;118,0;12,0;;5,0;1,0;2,0;6,0;4,0;;3,0;;51,0;15,0;237,0;8,0;11,0;33,0;;37,0;1,0;173,0;;1,0;4,0;3,0;553,0;49,0;503,0;7,0;22,0;15,0;;33,0;19,0;3,0;1,0;4,0;11,0;22,0;21,0;;;4,0;;2,0;6,0;1,0;8,0;3,0;9,0;37,0;48,0;4,0;3,0;5,0;;71,0;19,0;54,0;9,0;31,0;112,0;185,0;;3,0;;;4,0;1,0;19,0;15,0;13,0;;;1,0;14,0;86,0;156,0;116,0;47,0;4,0;13,0;73,0;42,0;87,0;37,0;;14,0;18,0;326,0;34,0;90,0;38,0;19,0;23,0;12,0;30,0;115,0;4,0;40,0;3,0;254,0;30,0;19,0;;79,0;10,0;37,0;;142,0;35,0;118,0;194,0;50,0;8,0;46,0;6,0;16,0;48,0;26,0;2,0;;;17,0;2,0;90,0;9,0;9,0;18,0;107,0;12,0;52,0;13,0;;98,0;;75,0;1,0;2,0;;75,0;88,0;16,0;;143,0;11,0;57,0;10,0;52,0;41,0;5,0;7,0;103,0;4,0;14,0;57,0;6,0;;;;22,0;47,0;7,0;13,0;49,0;6,0;2,0;19,0;1,0;3,0;5,0;50,0;1,0;8,0;12,0;6,0;39,0;11,0;22,0;3,0;3,0;1,0;1,0;18,0;6,0;23,0;4,0;69,0;9,0;3,0;133,0;12,0;3,0;2,0;;5,0;16,0;33,0;5,0;9,0;81,0;1,0;4,0;2,0;2,0;45,0;6,0;71,0;29,0;10,0;14,0;3,0;1,0;32,0;2,0;31,0;;4,0;2,0;10,0;;34,0;28,0;29,0;24,0;12,0;9,0;77,0;22,0;5,0;;;4,0;;6,0;17,0;;8,0;26,0;3,0;24,0;14,0;4,0;45,0;18,0;14,0;10,0;88,0;10,0;273,0;;5,0;4,0;23,0;3,0;;54,0;12,0;2,0;31,0;2,0;9,0;1,0;6,0;3,0;6,0;42,0;22,0;39,0;2,0;23,0;2,0;2,0;8,0;;;6,0;16,0;28,0;11,0;;17,0;5,0;3,0;2,0;48,0;17,0;7,0;;34,0;;2,0;32,0;37,0;2,0;35,0;;27,0;2,0;1,0;;4,0;3,0;;81,0;;10,0;121,0;3,0;;5,0;7,0;7,0;100,0;1,0;3,0;39,0;22,0;2,0;;20,0;12,0;1,0;22,0;1,0;;33,0;837,0;;;8,0;;;;;1,0;;8,0;2,0;4,0;;1,0;13,0;2,0;4,0;8,0;1,0;;113,0;42,0;21,0;7,0;1,0;35,0;4,0;9,0;14,0;4,0;1,0;54,0;16,0;2,0;27,0;34,0;4,0;1,0;;23,0;23,0;14,0;;;;;89,0;;2,0;3,0;35,0;16,0;;8,0;145,0;12,0;;;;3,0;1,0;1,0;11,0;1,0;1,0;12,0;3,0;3,0;;3,0;4,0;190,0;10,0;20,0;;;1,0;4,0;98,0;8,0;8,0;;;16,0;4,0;7,0;7,0;14,0;7,0;6,0;5,0;60,0;;1,0;;39,0;;4,0;2,0;1,0;37,0;8,0;3,0;1,0;13,0;3,0;2,0;1,0;;7,0;76,0;29,0;7,0;12,0;42,0;1,0;88,0;;3,0;3,0;;3,0;5,0;47,0;43,0;10,0;4,0;;2,0;6,0;4,0;13,0;9,0;11,0;8,0;32,0;6,0;2,0;2,0;11,0;3,0;4,0;15,0;7,0;21,0;6,0;36,0;;13,0;;;;1,0;;23,0;;3,0;2,0;;4,0;217,0;2,0;2,0;87,0;38,0;188,0;12,0;2,0;12,0;22,0;;311,0;226,0;;;194,0;1,0;28,0;135,0;51,0;179,0;21,0;359,0;;21,0;7,0;;31,0;2,0;41,0;24,0;121,0;1384,0;2,0;23,0;3,0;2,0;19,0;24,0;1,0;32,0;16,0;29,0;225,0;8,0;;8,0;162,0;8,0;;37,0;19,0;1,0;11,0;;8,0;75,0;1,0;;9,0;19,0;19,0;1,0;15,0;10,0;;76,0;12,0;5,0;9,0;20,0;;16,0;2,0;;3,0;84,0;117,0;6,0;5,0;;8,0;2,0;;1,0;;6,0;9,0;23,0;41,0;15,0;14,0;1,0;;;11,0;;;4,0;2,0;;1,0;;;23,0;2,0;8,0;30,0;9,0;12,0;;7,0;;;1,0;;;;;;38,0;5,0;7,0;2,0;14,0;4,0;;;24,0;16,0;;111,0;1,0;2,0;3,0;11,0;;2,0;;;;8,0;11,0;1,0;16,0;21,0;7,0;5,0;;48,0;;;;1,0;;;13,0;;25,0;;;1,0;3,0;22,0;;;20,0;2,0;1,0;18,0;27,0;34,0;;;;37,0;5,0;16,0;25,0;;14,0;;;18,0;;1,0;12,0;2,0;12,0;33,0;5,0;26,0;6,0;29,0;3,0;;;30,0;4,0;;8,0;22,0;;;19,0;6,0;2,0;4,0;;4,0;3,0;;;;2,0;
remain;4,0;;;2,0;10,0;14,0;3,0;4,0;;1,0;1,0;2,0;2,0;23,0;;;15,0;2,0;;;;;36,0;;;;;2,0;;;16,0;1,0;1,0;1,0;;27,0;4,0;10,0;2,0;;14,0;42,0;;2,0;18,0;2,0;;15,0;;1,0;8,0;;15,0;;23,0;2,0;6,0;;;7,0;2,0;;6,0;;153,0;;11,0;;;;1,0;36,0;13,0;;;;2,0;;3,0;3,0;27,0;;9,0;;17,0;5,0;;14,0;;;1,0;;3,0;;10,0;;64,0;12,0;46,0;22,0;72,0;11,0;;3,0;10,0;8,0;;;;;;32,0;73,0;;;;22,0;6,0;1,0;24,0;1,0;;16,0;2,0;;4,0;16,0;;;;13,0;1,0;1,0;20,0;;;22,0;8,0;;1,0;;;;;1,0;7,0;18,0;2,0;4,0;9,0;;2,0;1,0;;;2,0;;;;;;1,0;;;;;20,0;9,0;;5,0;2,0;;;20,0;;7,0;;;;;;;7,0;7,0;;17,0;6,0;2,0;42,0;5,0;;3,0;;;3,0;4,0;9,0;;1,0;1,0;;4,0;;4,0;;3,0;17,0;3,0;3,0;8,0;3,0;11,0;2,0;;;7,0;6,0;5,0;;;2,0;4,0;1,0;;16,0;;69,0;;;2,0;;;11,0;2,0;6,0;;;;;2,0;;5,0;7,0;;;11,0;1,0;;19,0;3,0;;;;1,0;6,0;;7,0;39,0;5,0;;1,0;2,0;4,0;9,0;8,0;5,0;;7,0;1,0;9,0;;1,0;3,0;;;;2,0;5,0;7,0;1,0;;;9,0;2,0;2,0;;;4,0;4,0;2,0;5,0;;;;;;33,0;1,0;3,0;;;2,0;1,0;4,0;;;;7,0;1,0;4,0;;;1,0;;;;;8,0;1,0;10,0;11,0;28,0;1,0;;;;;;6,0;1,0;1,0;;2,0;1,0;6,0;;;;;;1,0;1,0;;;;4,0;1,0;12,0;;1,0;;;;;6,0;;;5,0;18,0;;3,0;;;;4,0;;4,0;;;3,0;;;7,0;10,0;4,0;;;7,0;19,0;4,0;22,0;8,0;2,0;2,0;;14,0;1,0;2,0;;;2,0;3,0;3,0;15,0;;1,0;;1,0;2,0;;;5,0;;1,0;;5,0;;1,0;15,0;1,0;;13,0;;1,0;15,0;2,0;;;1,0;;;1,0;;;;5,0;1,0;9,0;;15,0;1,0;;1,0;;1,0;1,0;2,0;1,0;3,0;;;1,0;11,0;4,0;;4,0;1,0;;20,0;;2,0;;10,0;;1,0;6,0;;;;;2,0;;;;;;;;1,0;;;2,0;5,0;4,0;1,0;;;1,0;;;3,0;;;28,0;1,0;;2,0;2,0;;27,0;5,0;;;;;;1,0;;;;;7,0;;2,0;6,0;;12,0;1,0;;6,0;1,0;;;1,0;;3,0;2,0;6,0;;;;2,0;;;4,0;;;;;;;2,0;2,0;5,0;;;;;1,0;3,0;;;;12,0;;;;;;1,0;;;;;1,0;4,0;;;2,0;;;1,0;;;;;6,0;1,0;;;;;;6,0;;;;;;;;;;;;;1,0;;;;;;;;3,0;;;;;;;;;;3,0;3,0;;;;;;;;4,0;;;;;4,0;6,0;;;3,0;4,0;;1,0;;;;3,0;;;1,0;;;;;;4,0;;;;2,0;3,0;;6,0;;;;;;;;;5,0;7,0;4,0;;2,0;;;;;1,0;1,0;;;;;;8,0;;39,0;1,0;1,0;1,0;;2,0;20,0;;10,0;;;;;1,0;;1,0;;;1,0;;1,0;;8,0;17,0;;;1,0;;;;;3,0;4,0;;;2,0;;;;;2,0;1,0;;;;2,0;;1,0;;;;;;3,0;;;;;3,0;;;5,0;52,0;;;;1,0;;3,0;4,0;3,0;;;;;1,0;2,0;;;;;;;;;;;;;;;;4,0;;;;;;4,0;;1,0;;;;;;4,0;;;;;;1,0;;;;;;;;;;;2,0;;1,0;;;;;;1,0;;4,0;;;;3,0;;;;;1,0;;4,0;1,0;;1,0;;5,0;;;4,0;1,0;2,0;;;;;;1,0;;3,0;;11,0;2,0;6,0;;;;1,0;;;;;;;;1,0;;12,0;;;;;;;;;1,0;;;;;;;;;;;;;;2,0;;3,0;;;;;;1,0;1,0;1,0;;;;1,0;;;;;;;;;;;;;2,0;;;;1,0;;;;;;;;;;;;;;;;7,0;;;;;;1,0;1,0;;;;1,0;;;;;;;;;2,0;;;;;;;2,0;;;;;;;;;1,0;;4,0;;;;1,0;;;;;1,0;5,0;;;;;;;;;1,0;;;;;1,0;;;;5,0;;;;;;;;;;;
removable;3,0;9,0;;;;5,0;2,0;11,0;;;;;;14,0;;;;;2,0;2,0;3,0;;;1,0;2,0;1,0;;6,0;1,0;;23,0;3,0;1,0;;;16,0;1,0;;1,0;;;28,0;;7,0;1,0;;;5,0;;;;;;10,0;;;5,0;;;;;;;1,0;17,0;;27,0;;;;;68,0;3,0;;;;10,0;;3,0;24,0;11,0;;3,0;;28,0;3,0;;2,0;;;1,0;1,0;;;;;;;9,0;3,0;15,0;;;1,0;;1,0;;;;;;;;;;;1,0;;;8,0;;;;1,0;;4,0;23,0;;;1,0;;1,0;;31,0;;;;;;;;;;;7,0;2,0;;1,0;2,0;6,0;;;20,0;1,0;;;;;;;4,0;8,0;;;;;22,0;52,0;;;;;;;;1,0;;;8,0;;;6,0;2,0;3,0;;5,0;4,0;2,0;5,0;5,0;;;27,0;1,0;9,0;15,0;47,0;;21,0;3,0;;;;;;14,0;7,0;;;24,0;;;;;;3,0;;1,0;;;;;;;12,0;;15,0;;3,0;;7,0;;1,0;;4,0;;;;13,0;;;;;;5,0;;1,0;;10,0;4,0;2,0;;;29,0;2,0;;8,0;16,0;;;;;;10,0;8,0;3,0;;;2,0;3,0;;;4,0;3,0;4,0;;10,0;;;1,0;3,0;;3,0;1,0;;;20,0;23,0;;;3,0;2,0;;;;7,0;;;;;12,0;;2,0;1,0;4,0;;6,0;1,0;;7,0;;;;1,0;;;8,0;4,0;;;6,0;1,0;1,0;;1,0;;;;2,0;;;;;2,0;23,0;1,0;;;;;3,0;1,0;;;1,0;13,0;7,0;2,0;;1,0;;;;;;;;;15,0;;;;;;;;;;;;;;;1,0;;;;;;;3,0;;;;;3,0;;;;;;;;;;;;;;;;;1,0;;;3,0;;;3,0;;;3,0;;;;;;;;;;;;;;17,0;;6,0;2,0;;;3,0;;;;4,0;21,0;;;2,0;2,0;1,0;2,0;;;1,0;;;13,0;;;;;1,0;;10,0;;;2,0;;;;;;;;;;;;;;;;4,0;;;;;;3,0;;2,0;;;2,0;1,0;;1,0;;;1,0;2,0;;1,0;;;;;;;2,0;6,0;;;;1,0;;1,0;;5,0;;;14,0;;;1,0;;12,0;;11,0;13,0;1,0;1,0;;;8,0;;;;;;;;1,0;;;;2,0;1,0;;;;15,0;;;;;;;1,0;;;;;;;6,0;;;3,0;;2,0;;;;;7,0;3,0;;;;;3,0;4,0;1,0;;;;;;;;6,0;;2,0;4,0;;;;;;;;;;;;;;;;;;;;;2,0;;;;;;;1,0;2,0;3,0;;;1,0;;;;;;;;;;;;;1,0;1,0;;;;3,0;1,0;;2,0;;1,0;;;;;7,0;;1,0;;;;;;5,0;;;3,0;;;;;;;;;;;1,0;;;;;;1,0;;;;;;;;3,0;;;;;;;;;;;;;;1,0;2,0;;;;2,0;1,0;;;8,0;3,0;22,0;;;3,0;;;1,0;2,0;;;2,0;;;;;;;;;;;;;;;;6,0;;3,0;;;;;3,0;;2,0;2,0;;;;;;3,0;;11,0;;;;;;2,0;1,0;11,0;;4,0;4,0;1,0;;;;1,0;1,0;;;;;;;;;35,0;2,0;;;;;8,0;;;;;;;;;;;1,0;;;;;;;;;;;;;;;;;;;;;;;;;;;;;;;;;;;;;;;;;;3,0;;;;;;;;;;;;;;;;;;;;;;1,0;;;;;;;;2,0;1,0;;;;;;;;;;;;;;;;;;;;;;;;;;;;;;;1,0;8,0;;;;;3,0;;;;;;;;;;;1,0;;;;;;;;;;;;;;;;;;;;3,0;;;;;;;1,0;;;;;;;;;1,0;;;;;;;;2,0;;;;;4,0;;;;;;;1,0;;;;;;;;;;;;;;;;;;;;;;;;;;;
representative;2,0;;;;4,0;8,0;12,0;1,0;3,0;;;14,0;;27,0;;4,0;60,0;;;1,0;2,0;;32,0;;1,0;7,0;;16,0;1,0;2,0;21,0;5,0;1,0;3,0;;364,0;2,0;;35,0;;108,0;42,0;;;13,0;1,0;4,0;1,0;;;;;;;69,0;;;;;31,0;;;11,0;;533,0;;52,0;1,0;;1,0;;16,0;106,0;;2,0;1,0;1,0;2,0;4,0;4,0;15,0;;;18,0;11,0;;;4,0;;;4,0;;1,0;;;;68,0;;62,0;26,0;48,0;7,0;;4,0;8,0;10,0;3,0;1,0;;;2,0;8,0;6,0;;;;21,0;20,0;14,0;14,0;3,0;;51,0;2,0;3,0;16,0;19,0;;2,0;;12,0;1,0;1,0;4,0;;;80,0;;;;;2,0;5,0;;;2,0;6,0;;11,0;;;4,0;5,0;;;;;;;;;;8,0;;;;;;;;3,0;6,0;;15,0;;2,0;2,0;3,0;;2,0;2,0;;;2,0;;;;5,0;38,0;;;20,0;;;;;;28,0;3,0;2,0;;;;;;;;;;;1,0;16,0;;;;;10,0;1,0;;;11,0;1,0;1,0;;;;86,0;;;32,0;;1,0;6,0;;;;;;;3,0;;;;;;23,0;;6,0;;;;;1,0;11,0;2,0;;;2,0;;;;;;8,0;;;;;11,0;;;;;;;;;2,0;;3,0;;;;;;;;;2,0;;;;;;;;5,0;;;;;;;;;;;1,0;;8,0;;;;;5,0;;2,0;;;;1,0;32,0;;45,0;;;;;1,0;;;;;;35,0;;;;;;;9,0;1,0;;;;3,0;;;;;;1,0;;13,0;;;1,0;25,0;1,0;;1,0;2,0;;;;3,0;;;;;;9,0;4,0;5,0;;;1,0;16,0;1,0;;14,0;;;5,0;23,0;7,0;22,0;;2,0;2,0;;2,0;;;1,0;;4,0;;;;9,0;;2,0;;43,0;;;13,0;;;3,0;3,0;;1,0;1,0;;3,0;;;;3,0;;5,0;1,0;36,0;1,0;4,0;;;;5,0;;4,0;2,0;;1,0;;;4,0;;;;;2,0;;;;30,0;;;7,0;3,0;;;;;1,0;;4,0;9,0;;;;;2,0;;;;;5,0;9,0;3,0;1,0;;;;;;;2,0;;1,0;6,0;2,0;;1,0;10,0;;2,0;;;;;;;;;;;4,0;4,0;;;1,0;;1,0;;;36,0;6,0;13,0;;;;;;;;;;;;;10,0;4,0;;;;;;2,0;;;1,0;;;14,0;2,0;7,0;1,0;;;;2,0;6,0;;;;;;;1,0;;3,0;13,0;;3,0;1,0;5,0;8,0;;;;5,0;;2,0;2,0;8,0;;;;;;1,0;7,0;;;;;;;1,0;;1,0;;;;3,0;1,0;;4,0;;5,0;;;1,0;;2,0;;2,0;;1,0;89,0;4,0;;;;;;1,0;2,0;23,0;2,0;;;;;10,0;1,0;;;35,0;6,0;;;1,0;;1,0;3,0;;;;6,0;;;;;;;;1,0;2,0;;;;;;;;;;1,0;;;;1,0;;24,0;;;3,0;;;;;;;;;;;20,0;;;7,0;1,0;3,0;23,0;4,0;;;;;;3,0;3,0;;;;;;;;;;;1,0;;;;;;;;;;2,0;;;;;;1,0;;1,0;;;;2,0;;;;3,0;;;;;;;;;;;9,0;;;;;;1,0;;;;;;;3,0;;;;;;;;;;;;;;;;;;;;;;;9,0;;;;;2,0;;;;;;;;;;3,0;1,0;;;;;;;;;;;;2,0;;;;;;;;;3,0;4,0;3,0;;;;;;;;;;;;5,0;;;;9,0;;;;;;;;;;24,0;2,0;;;;;;;;;;;;3,0;;;;;;1,0;;;;;;;;;;;3,0;;;;;;;;3,0;;;;;;;;;;;;;;;2,0;;;;;1,0;;6,0;;;;;;;;;;1,0;;3,0;3,0;;;;;;;;8,0;10,0;;;;;;;;;;1,0;;;;;;;;;;;;;;;;;;;;;;4,0;;;;;3,0;;;;;;;;;;;;;;;2,0;5,0;;;12,0;15,0;;;;;;;2,0;;2,0;;;;;7,0;;;;;;3,0;;;;;
resolution;6,0;;5,0;25,0;2,0;26,0;116,0;6,0;;5,0;;38,0;;58,0;;5,0;131,0;;2,0;13,0;;1,0;81,0;2,0;2,0;;;51,0;27,0;11,0;63,0;17,0;8,0;8,0;;290,0;37,0;4,0;157,0;3,0;109,0;118,0;2,0;74,0;160,0;1,0;3,0;24,0;;8,0;4,0;;;;33,0;11,0;14,0;;17,0;111,0;;;111,0;;1593,0;1,0;100,0;60,0;6,0;;3,0;40,0;9,0;;2,0;3,0;;;;34,0;202,0;;28,0;1,0;61,0;1,0;;16,0;2,0;7,0;7,0;2,0;;;8,0;;231,0;14,0;76,0;19,0;41,0;56,0;;29,0;82,0;57,0;3,0;15,0;4,0;3,0;5,0;9,0;31,0;22,0;1,0;21,0;;38,0;27,0;181,0;7,0;;116,0;56,0;72,0;25,0;96,0;2,0;2,0;;42,0;;;97,0;12,0;4,0;97,0;1,0;34,0;;;;;;1,0;6,0;52,0;;28,0;;;9,0;;;1,0;;;;;;;19,0;28,0;20,0;;;7,0;1,0;17,0;26,0;3,0;;4,0;30,0;;1,0;;;;;1,0;;;10,0;;;10,0;;253,0;2,0;;3,0;;1,0;;;2,0;;;;;;5,0;;14,0;3,0;;;;;1,0;;;;;1,0;98,0;;10,0;;29,0;;;;;;46,0;;;5,0;;;50,0;9,0;;1,0;2,0;;;15,0;;;;;1,0;30,0;5,0;;1,0;;;;;3,0;1,0;4,0;6,0;2,0;14,0;;2,0;20,0;5,0;4,0;;;;1,0;4,0;2,0;;1,0;2,0;2,0;;;2,0;7,0;;1,0;;12,0;2,0;;;;;2,0;3,0;;;2,0;;2,0;3,0;;26,0;;;;;;;2,0;;;;2,0;1,0;37,0;;;;;4,0;;4,0;;;3,0;10,0;44,0;;5,0;;;;;3,0;20,0;;;;;31,0;;;;;;4,0;1,0;;;;;6,0;12,0;;;;;1,0;3,0;2,0;;1,0;;252,0;8,0;;;;;;4,0;4,0;28,0;;;;;2,0;;24,0;5,0;1,0;5,0;1,0;;34,0;4,0;;2,0;25,0;15,0;1,0;3,0;5,0;6,0;10,0;7,0;1,0;3,0;;29,0;;13,0;13,0;22,0;;5,0;3,0;51,0;1,0;7,0;5,0;25,0;7,0;;;4,0;;12,0;9,0;4,0;4,0;6,0;;;6,0;132,0;;4,0;1,0;32,0;6,0;33,0;6,0;;1,0;;48,0;2,0;13,0;;12,0;7,0;4,0;1,0;1,0;1,0;32,0;;;8,0;;;5,0;;13,0;;5,0;3,0;;;;10,0;31,0;3,0;59,0;4,0;;8,0;;15,0;1,0;;;1,0;;;10,0;3,0;;;2,0;;;;;;;100,0;2,0;9,0;29,0;;4,0;;1,0;1,0;5,0;9,0;;;12,0;;9,0;;3,0;51,0;;2,0;47,0;8,0;;;;7,0;3,0;4,0;;;1,0;11,0;;1,0;;;6,0;2,0;1,0;;2,0;;;2,0;;;;;;1,0;107,0;1,0;;4,0;8,0;12,0;2,0;2,0;;;;31,0;;1,0;;2,0;;;;19,0;6,0;2,0;;;;;;;2,0;5,0;;7,0;2,0;;8,0;3,0;2,0;;2,0;1,0;4,0;2,0;;3,0;;;1,0;;;;;;;2,0;2,0;26,0;3,0;;;;;6,0;;;;;18,0;1,0;;48,0;3,0;25,0;;;;;2,0;;3,0;;2,0;;;;9,0;8,0;;;7,0;15,0;1,0;3,0;;;1,0;6,0;;1,0;5,0;19,0;;;;;;;1,0;;;;;1,0;1,0;;1,0;;;2,0;;;5,0;;5,0;15,0;34,0;25,0;;19,0;20,0;;5,0;;;2,0;;;;;;;;9,0;1,0;;58,0;;;;;6,0;;1,0;1,0;;;;;;;8,0;11,0;;;;1,0;;;2,0;;;2,0;;3,0;;;12,0;;2,0;;15,0;2,0;2,0;;1,0;;21,0;;;;;1,0;1,0;1,0;;3,0;44,0;;;;;8,0;1,0;;;;;3,0;;;;;4,0;;2,0;;;;;;;;;;;;1,0;;;;;;;1,0;;;;6,0;;1,0;;;;;;;;1,0;7,0;;;;1,0;;;;;;;1,0;;;;;;8,0;;;;;3,0;;1,0;;;;35,0;;9,0;;;;2,0;;;;;;168,0;;;;3,0;;3,0;2,0;;21,0;;;;;13,0;19,0;;;;22,0;;;23,0;3,0;1,0;;;2,0;;3,0;;;;3,0;;5,0;;;;;;;;;;1,0;;2,0;;2,0;;2,0;;;;;1,0;;10,0;;;;3,0;;;2,0;;8,0;;;;4,0;49,0;;;;5,0;;;1,0;;;;;;;9,0;;;;1,0;;;;;;;1,0;4,0;;;;;;1,0;;2,0;;;;;;;;;;1,0;;;;;11,0;;;;;;;;;;;2,0;;1,0;1,0;;;7,0;;;;;;;;;;1,0;50,0;;;2,0;;;2,0;30,0;;;;;6,0;1,0;;7,0;;;15,0;;;;;;3,0;;;1,0;;
respective;5,0;5,0;;27,0;32,0;53,0;195,0;19,0;;;;4,0;7,0;212,0;;11,0;143,0;10,0;19,0;28,0;28,0;;74,0;5,0;11,0;;;79,0;12,0;10,0;133,0;5,0;10,0;6,0;2,0;162,0;65,0;4,0;148,0;;150,0;165,0;11,0;43,0;61,0;54,0;8,0;157,0;3,0;8,0;45,0;12,0;47,0;3,0;117,0;59,0;88,0;1,0;26,0;100,0;1,0;;59,0;1,0;930,0;;189,0;10,0;5,0;7,0;51,0;247,0;239,0;2,0;6,0;10,0;15,0;24,0;3,0;37,0;192,0;5,0;31,0;10,0;58,0;4,0;3,0;136,0;16,0;7,0;52,0;18,0;9,0;5,0;39,0;;590,0;53,0;711,0;180,0;227,0;35,0;8,0;25,0;54,0;50,0;17,0;11,0;27,0;;;98,0;174,0;6,0;;20,0;38,0;;83,0;243,0;30,0;1,0;284,0;14,0;12,0;43,0;170,0;;19,0;4,0;104,0;9,0;3,0;86,0;20,0;;159,0;37,0;20,0;;;20,0;8,0;1,0;11,0;51,0;117,0;60,0;121,0;15,0;5,0;37,0;48,0;9,0;9,0;15,0;4,0;1,0;;;37,0;75,0;2,0;8,0;3,0;11,0;66,0;20,0;;18,0;27,0;3,0;14,0;71,0;;43,0;3,0;46,0;6,0;2,0;2,0;6,0;5,0;40,0;9,0;;23,0;9,0;135,0;20,0;11,0;;2,0;38,0;2,0;14,0;32,0;13,0;25,0;7,0;3,0;4,0;2,0;;16,0;13,0;44,0;;13,0;124,0;23,0;25,0;13,0;;9,0;11,0;47,0;16,0;11,0;50,0;79,0;15,0;6,0;33,0;20,0;;225,0;;2,0;17,0;7,0;9,0;57,0;2,0;2,0;11,0;4,0;5,0;;53,0;;16,0;6,0;;4,0;66,0;23,0;13,0;82,0;4,0;10,0;3,0;;27,0;20,0;19,0;44,0;140,0;6,0;;23,0;24,0;4,0;68,0;17,0;;;10,0;23,0;6,0;;15,0;8,0;7,0;8,0;;4,0;57,0;6,0;7,0;5,0;5,0;75,0;24,0;13,0;;6,0;1,0;46,0;2,0;34,0;9,0;;2,0;16,0;17,0;84,0;3,0;;25,0;;11,0;9,0;19,0;;13,0;4,0;9,0;19,0;67,0;;1,0;1,0;3,0;18,0;4,0;22,0;5,0;5,0;17,0;3,0;173,0;31,0;31,0;1,0;2,0;;;19,0;23,0;12,0;1,0;7,0;16,0;44,0;2,0;2,0;;;2,0;26,0;28,0;25,0;2,0;1,0;17,0;44,0;19,0;;15,0;;9,0;5,0;;44,0;9,0;2,0;6,0;101,0;2,0;6,0;5,0;;12,0;5,0;12,0;6,0;15,0;;;;;48,0;40,0;12,0;2,0;1,0;7,0;19,0;15,0;87,0;35,0;3,0;;1,0;32,0;8,0;13,0;2,0;66,0;5,0;15,0;6,0;16,0;;36,0;;49,0;32,0;12,0;;32,0;9,0;23,0;9,0;119,0;12,0;3,0;46,0;20,0;1,0;21,0;1,0;14,0;28,0;55,0;7,0;12,0;;2,0;3,0;11,0;8,0;13,0;3,0;139,0;36,0;29,0;13,0;3,0;38,0;4,0;39,0;33,0;2,0;2,0;14,0;17,0;6,0;2,0;5,0;34,0;14,0;32,0;5,0;11,0;4,0;6,0;43,0;;;23,0;1,0;4,0;7,0;3,0;2,0;96,0;2,0;20,0;37,0;;6,0;14,0;1,0;1,0;;4,0;;;2,0;3,0;11,0;23,0;12,0;2,0;5,0;51,0;2,0;3,0;29,0;2,0;29,0;46,0;3,0;14,0;25,0;29,0;1,0;28,0;1,0;;6,0;22,0;25,0;;5,0;92,0;5,0;3,0;6,0;15,0;4,0;3,0;106,0;25,0;12,0;;;35,0;82,0;30,0;;;2,0;2,0;1,0;8,0;3,0;;14,0;2,0;2,0;8,0;61,0;3,0;1,0;;18,0;;3,0;;5,0;11,0;18,0;1,0;;4,0;4,0;12,0;1,0;1,0;3,0;35,0;;9,0;;9,0;2,0;5,0;;2,0;22,0;15,0;1,0;10,0;5,0;29,0;4,0;16,0;1,0;9,0;10,0;2,0;;;23,0;;42,0;2,0;1,0;7,0;6,0;;22,0;9,0;15,0;;4,0;12,0;6,0;;26,0;4,0;1,0;;3,0;;12,0;14,0;2,0;;;6,0;10,0;1,0;;4,0;7,0;;15,0;5,0;1,0;60,0;1,0;18,0;10,0;28,0;16,0;;2,0;3,0;4,0;5,0;;1,0;;2,0;13,0;14,0;;;66,0;71,0;;;17,0;;8,0;;;;;6,0;9,0;;;1,0;10,0;9,0;;3,0;;;;25,0;2,0;1,0;;12,0;8,0;;;;5,0;7,0;11,0;3,0;27,0;1,0;;5,0;14,0;111,0;3,0;;;2,0;1,0;1,0;16,0;;2,0;2,0;1,0;31,0;2,0;38,0;97,0;3,0;1,0;;4,0;3,0;12,0;16,0;1,0;;8,0;;;4,0;11,0;;;55,0;;13,0;3,0;;11,0;4,0;13,0;60,0;9,0;2,0;4,0;28,0;;1,0;;4,0;;7,0;2,0;43,0;;2,0;1,0;7,0;;8,0;4,0;;14,0;9,0;11,0;;19,0;9,0;1,0;;;7,0;42,0;;2,0;1,0;12,0;5,0;7,0;;6,0;4,0;;1,0;3,0;26,0;7,0;;2,0;;4,0;16,0;1,0;3,0;2,0;;;;11,0;7,0;;3,0;4,0;1,0;1,0;8,0;3,0;;6,0;8,0;26,0;;;1,0;;1,0;;3,0;8,0;;3,0;6,0;21,0;7,0;;6,0;6,0;;;4,0;1,0;3,0;11,0;;34,0;7,0;8,0;2,0;;;5,0;13,0;5,0;16,0;;4,0;11,0;58,0;3,0;;10,0;15,0;2,0;2,0;2,0;;3,0;11,0;;33,0;5,0;11,0;21,0;5,0;11,0;4,0;;20,0;;40,0;4,0;;;4,0;6,0;8,0;;;6,0;1,0;6,0;13,0;1,0;;;7,0;;;4,0;6,0;;2,0;5,0;3,0;8,0;1,0;6,0;3,0;13,0;15,0;;1,0;71,0;10,0;;;6,0;27,0;5,0;2,0;6,0;2,0;3,0;5,0;4,0;12,0;17,0;6,0;10,0;11,0;8,0;;;4,0;;;1,0;;6,0;1,0;;2,0;;3,0;1,0;;;;;2,0;7,0;;12,0;5,0;6,0;;4,0;4,0;1,0;;22,0;;12,0;;15,0;;;12,0;1,0;;2,0;;1,0;4,0;1,0;1,0;;1,0;6,0;;10,0;17,0;;1,0;;1,0;;;;9,0;9,0;;;5,0;1,0;1,0;2,0;4,0;6,0;3,0;;11,0;1,0;;1,0;;;9,0;12,0;1,0;2,0;5,0;;;32,0;9,0;2,0;;20,0;;15,0;5,0;1,0;;3,0;36,0;;;;20,0;;;2,0;10,0;;;15,0;12,0;3,0;4,0;;4,0;3,0;4,0;;;;
scene;6,0;;2,0;42,0;16,0;55,0;85,0;39,0;9,0;6,0;;11,0;;247,0;8,0;35,0;881,0;6,0;6,0;41,0;;;66,0;9,0;3,0;1,0;;37,0;43,0;23,0;178,0;15,0;4,0;46,0;;436,0;83,0;15,0;387,0;;384,0;189,0;;99,0;260,0;7,0;7,0;55,0;;;57,0;29,0;5,0;24,0;147,0;29,0;92,0;;16,0;175,0;3,0;;12,0;;2197,0;5,0;248,0;8,0;27,0;3,0;4,0;185,0;429,0;;1,0;2,0;2,0;3,0;27,0;30,0;365,0;10,0;12,0;81,0;38,0;9,0;5,0;80,0;15,0;8,0;37,0;6,0;11,0;1,0;29,0;;193,0;68,0;402,0;231,0;208,0;22,0;13,0;39,0;75,0;97,0;9,0;17,0;4,0;3,0;;38,0;152,0;1,0;;14,0;27,0;83,0;;199,0;23,0;;26,0;14,0;37,0;48,0;261,0;;1,0;;99,0;7,0;;41,0;2,0;;287,0;267,0;15,0;;;;;;16,0;16,0;127,0;36,0;69,0;5,0;;6,0;4,0;1,0;2,0;;;;;;;5,0;34,0;17,0;;17,0;12,0;14,0;12,0;12,0;7,0;;37,0;40,0;4,0;45,0;;21,0;1,0;;1,0;;34,0;27,0;;;19,0;;131,0;11,0;;1,0;4,0;1,0;;;5,0;33,0;;15,0;;1,0;6,0;;23,0;14,0;;1,0;12,0;30,0;12,0;42,0;2,0;;;2,0;54,0;2,0;31,0;172,0;160,0;7,0;2,0;;;;398,0;;1,0;47,0;;39,0;78,0;7,0;4,0;10,0;67,0;9,0;;160,0;;;3,0;;;61,0;19,0;3,0;21,0;3,0;;1,0;10,0;52,0;6,0;3,0;9,0;78,0;8,0;;5,0;29,0;48,0;26,0;2,0;1,0;2,0;4,0;9,0;11,0;;27,0;;10,0;;;15,0;34,0;;5,0;;18,0;21,0;;;;;1,0;2,0;;;3,0;;4,0;30,0;;141,0;;;;;;;2,0;;;;9,0;;85,0;;6,0;;;24,0;;24,0;;;6,0;16,0;548,0;6,0;79,0;7,0;15,0;;;17,0;4,0;;;;;90,0;;;;;1,0;4,0;3,0;1,0;;;3,0;75,0;30,0;6,0;;;;34,0;;68,0;;;4,0;278,0;7,0;14,0;;;1,0;;5,0;16,0;2,0;;7,0;;;36,0;41,0;79,0;10,0;7,0;13,0;27,0;4,0;57,0;58,0;;12,0;20,0;175,0;22,0;10,0;24,0;35,0;5,0;8,0;25,0;107,0;21,0;36,0;;132,0;24,0;32,0;;35,0;1,0;68,0;5,0;63,0;22,0;53,0;108,0;;4,0;47,0;30,0;15,0;23,0;31,0;7,0;;;9,0;4,0;3,0;4,0;4,0;4,0;188,0;;50,0;5,0;1,0;31,0;;19,0;3,0;18,0;1,0;11,0;19,0;4,0;2,0;20,0;1,0;16,0;3,0;2,0;19,0;2,0;9,0;88,0;1,0;47,0;;9,0;;;;;54,0;7,0;18,0;68,0;;;15,0;;;3,0;4,0;4,0;9,0;7,0;;12,0;13,0;;;4,0;10,0;;9,0;;6,0;;28,0;30,0;12,0;65,0;54,0;5,0;37,0;;13,0;;161,0;1,0;6,0;51,0;1,0;3,0;;47,0;27,0;;5,0;9,0;4,0;9,0;;2,0;2,0;3,0;4,0;;;8,0;19,0;;18,0;;;21,0;;12,0;1,0;;;;;;;;1,0;;2,0;30,0;;3,0;1,0;10,0;20,0;1,0;9,0;3,0;2,0;1,0;4,0;;;7,0;21,0;4,0;;5,0;125,0;1,0;5,0;8,0;9,0;;;;5,0;2,0;87,0;22,0;1,0;13,0;;8,0;22,0;7,0;;;;13,0;2,0;17,0;25,0;;1,0;;;9,0;;;;;2,0;16,0;20,0;;1,0;;15,0;;;4,0;10,0;39,0;;2,0;1,0;1,0;98,0;10,0;5,0;;30,0;1,0;5,0;2,0;;61,0;6,0;13,0;;9,0;7,0;2,0;47,0;;;26,0;111,0;;;;2,0;;23,0;;;5,0;9,0;;;;1,0;;13,0;1,0;2,0;;;;27,0;;1,0;5,0;1,0;;4,0;25,0;2,0;2,0;27,0;106,0;;28,0;9,0;;;1,0;2,0;9,0;;;;;1,0;49,0;;3,0;;4,0;9,0;;2,0;222,0;24,0;28,0;2,0;1,0;;6,0;2,0;4,0;;;;3,0;1,0;1,0;8,0;1,0;;7,0;10,0;;;;;6,0;1,0;1,0;;;5,0;;1,0;;2,0;10,0;1,0;;146,0;;;;10,0;1,0;2,0;;;3,0;12,0;;;13,0;11,0;4,0;;2,0;;19,0;4,0;;;21,0;;16,0;;;3,0;;;19,0;67,0;;;;;;;;;;;3,0;;;6,0;;;;;3,0;3,0;;;20,0;;18,0;;;;;;;;1,0;1,0;;;12,0;9,0;;9,0;;;;;14,0;;;;1,0;22,0;;;;;;109,0;;8,0;;5,0;3,0;12,0;;47,0;6,0;;5,0;3,0;;1,0;;;;23,0;;;4,0;15,0;;10,0;;;7,0;;5,0;;;;5,0;6,0;;;2,0;;;8,0;13,0;;10,0;4,0;5,0;;1,0;4,0;3,0;1,0;17,0;8,0;73,0;1,0;;;9,0;150,0;;5,0;;17,0;;6,0;20,0;3,0;5,0;5,0;1,0;11,0;16,0;7,0;6,0;5,0;6,0;2,0;;;4,0;2,0;;;;2,0;3,0;;;;4,0;1,0;15,0;;;;;1,0;;;14,0;16,0;17,0;4,0;1,0;16,0;;;7,0;4,0;4,0;;;8,0;;;;3,0;;;4,0;;6,0;1,0;3,0;3,0;37,0;2,0;4,0;;;5,0;;;;;1,0;;;;4,0;;;;;3,0;;;17,0;;20,0;;1,0;;;;3,0;1,0;;7,0;1,0;;;;25,0;4,0;1,0;;;;1,0;6,0;;9,0;;6,0;;3,0;;;12,0;10,0;54,0;;2,0;2,0;69,0;15,0;;14,0;;;;;;;;
sensor;20,0;4,0;15,0;164,0;85,0;640,0;1509,0;940,0;;3,0;2,0;31,0;95,0;836,0;18,0;29,0;1564,0;47,0;51,0;42,0;374,0;4,0;395,0;36,0;139,0;18,0;21,0;310,0;62,0;62,0;1575,0;227,0;57,0;47,0;3,0;1632,0;160,0;84,0;220,0;14,0;673,0;1590,0;29,0;327,0;336,0;810,0;30,0;712,0;9,0;3,0;22,0;4,0;97,0;63,0;516,0;272,0;363,0;11,0;33,0;518,0;48,0;12,0;198,0;43,0;15276,0;69,0;1999,0;29,0;64,0;13,0;145,0;2481,0;1754,0;12,0;10,0;17,0;54,0;168,0;17,0;178,0;1147,0;20,0;203,0;31,0;1241,0;102,0;12,0;1481,0;133,0;26,0;97,0;15,0;108,0;42,0;53,0;21,0;1501,0;403,0;1636,0;173,0;1308,0;152,0;62,0;140,0;296,0;682,0;23,0;36,0;73,0;8,0;2,0;152,0;420,0;24,0;8,0;14,0;181,0;243,0;199,0;;54,0;9,0;1097,0;76,0;41,0;94,0;1324,0;1,0;15,0;20,0;470,0;24,0;6,0;1125,0;14,0;8,0;556,0;50,0;51,0;4,0;11,0;127,0;19,0;6,0;162,0;52,0;320,0;432,0;288,0;205,0;13,0;72,0;248,0;73,0;39,0;40,0;4,0;4,0;2,0;15,0;97,0;359,0;13,0;111,0;74,0;2,0;699,0;183,0;6,0;317,0;92,0;17,0;165,0;350,0;;67,0;29,0;35,0;66,0;7,0;19,0;28,0;162,0;214,0;18,0;119,0;420,0;55,0;345,0;203,0;67,0;6,0;49,0;83,0;216,0;52,0;736,0;162,0;35,0;27,0;27,0;198,0;15,0;18,0;249,0;64,0;239,0;27,0;100,0;760,0;151,0;178,0;97,0;5,0;4,0;59,0;597,0;91,0;2,0;135,0;86,0;75,0;12,0;65,0;73,0;10,0;990,0;59,0;51,0;122,0;18,0;115,0;199,0;87,0;50,0;11,0;85,0;16,0;7,0;34,0;2,0;18,0;2,0;2,0;19,0;142,0;82,0;41,0;525,0;4,0;11,0;41,0;93,0;107,0;597,0;98,0;264,0;667,0;58,0;1,0;44,0;183,0;49,0;361,0;20,0;67,0;4,0;78,0;20,0;150,0;11,0;76,0;160,0;67,0;13,0;1,0;58,0;253,0;57,0;105,0;27,0;38,0;380,0;483,0;2,0;6,0;180,0;30,0;594,0;32,0;141,0;39,0;7,0;21,0;78,0;9,0;449,0;77,0;8,0;7,0;12,0;12,0;63,0;15,0;;25,0;25,0;102,0;74,0;1103,0;9,0;2,0;35,0;9,0;69,0;1,0;237,0;24,0;17,0;39,0;168,0;440,0;92,0;86,0;3,0;21,0;6,0;16,0;207,0;120,0;14,0;6,0;7,0;49,0;113,0;18,0;4,0;2,0;11,0;1,0;50,0;126,0;43,0;6,0;15,0;65,0;25,0;154,0;2,0;11,0;4,0;;55,0;20,0;53,0;6,0;11,0;141,0;369,0;58,0;63,0;90,0;80,0;8,0;10,0;61,0;28,0;102,0;28,0;7,0;;1,0;72,0;154,0;99,0;20,0;83,0;30,0;58,0;24,0;465,0;63,0;19,0;41,0;58,0;894,0;49,0;35,0;62,0;90,0;27,0;21,0;41,0;157,0;41,0;114,0;1,0;126,0;77,0;26,0;85,0;268,0;102,0;46,0;84,0;256,0;19,0;108,0;491,0;51,0;10,0;112,0;10,0;146,0;109,0;493,0;30,0;26,0;39,0;24,0;27,0;124,0;46,0;323,0;20,0;943,0;89,0;265,0;28,0;4,0;663,0;9,0;167,0;15,0;22,0;11,0;58,0;98,0;135,0;22,0;256,0;82,0;116,0;132,0;9,0;70,0;10,0;7,0;193,0;77,0;19,0;75,0;157,0;17,0;5,0;10,0;8,0;73,0;8,0;73,0;107,0;45,0;44,0;17,0;27,0;8,0;;5,0;16,0;5,0;47,0;24,0;79,0;151,0;45,0;9,0;47,0;16,0;24,0;12,0;250,0;6,0;52,0;102,0;56,0;35,0;136,0;65,0;40,0;58,0;27,0;40,0;15,0;75,0;20,0;40,0;69,0;54,0;5,0;27,0;23,0;76,0;52,0;150,0;4,0;53,0;117,0;15,0;3,0;9,0;47,0;6,0;13,0;2,0;16,0;82,0;1,0;50,0;3,0;25,0;62,0;33,0;17,0;17,0;5,0;3,0;32,0;2,0;21,0;;4,0;85,0;46,0;35,0;176,0;58,0;33,0;7,0;28,0;35,0;6,0;5,0;142,0;174,0;1,0;52,0;;10,0;7,0;37,0;14,0;3,0;47,0;6,0;9,0;5,0;8,0;10,0;;;16,0;46,0;21,0;69,0;36,0;4,0;122,0;30,0;45,0;35,0;4,0;12,0;16,0;43,0;131,0;53,0;89,0;16,0;3,0;18,0;29,0;7,0;43,0;21,0;35,0;63,0;;;7,0;47,0;7,0;1,0;37,0;1,0;46,0;3,0;5,0;27,0;81,0;7,0;27,0;11,0;2,0;41,0;17,0;3,0;5,0;35,0;47,0;33,0;6,0;3,0;20,0;27,0;16,0;;10,0;6,0;8,0;44,0;14,0;10,0;65,0;74,0;;4,0;15,0;;3,0;45,0;;9,0;16,0;12,0;39,0;3,0;;2,0;54,0;34,0;17,0;102,0;18,0;18,0;18,0;56,0;4,0;26,0;9,0;41,0;44,0;23,0;44,0;10,0;26,0;11,0;17,0;18,0;62,0;21,0;3,0;17,0;16,0;35,0;155,0;45,0;11,0;;2,0;14,0;177,0;20,0;44,0;18,0;10,0;21,0;19,0;2,0;92,0;;18,0;9,0;19,0;39,0;10,0;59,0;18,0;139,0;43,0;9,0;2,0;32,0;46,0;11,0;22,0;151,0;16,0;81,0;2,0;1,0;8,0;23,0;9,0;118,0;163,0;1,0;2,0;32,0;4,0;35,0;4,0;7,0;20,0;5,0;13,0;131,0;4,0;65,0;17,0;32,0;1,0;3,0;21,0;4,0;4,0;33,0;2,0;91,0;16,0;33,0;10,0;18,0;5,0;28,0;447,0;;27,0;8,0;82,0;13,0;17,0;2,0;9,0;8,0;1,0;37,0;18,0;96,0;1,0;21,0;;79,0;25,0;15,0;8,0;6,0;12,0;11,0;53,0;19,0;1,0;25,0;6,0;14,0;;6,0;73,0;23,0;1,0;3,0;10,0;14,0;33,0;2,0;;7,0;5,0;4,0;54,0;2,0;6,0;4,0;1,0;31,0;93,0;29,0;21,0;54,0;9,0;15,0;13,0;13,0;77,0;15,0;4,0;20,0;41,0;29,0;2,0;6,0;;3,0;69,0;138,0;3,0;;17,0;9,0;28,0;31,0;42,0;5,0;33,0;11,0;54,0;;242,0;52,0;2,0;;;47,0;;7,0;70,0;20,0;13,0;30,0;59,0;10,0;4,0;48,0;21,0;;6,0;7,0;7,0;12,0;6,0;;11,0;16,0;19,0;;;13,0;29,0;18,0;13,0;;3,0;58,0;31,0;17,0;17,0;4,0;68,0;;5,0;28,0;5,0;101,0;17,0;16,0;;16,0;16,0;12,0;16,0;23,0;11,0;2,0;10,0;52,0;61,0;7,0;3,0;71,0;5,0;6,0;10,0;8,0;6,0;20,0;8,0;1,0;1,0;1,0;6,0;10,0;2,0;23,0;4,0;8,0;13,0;;;19,0;2,0;2,0;3,0;33,0;12,0;3,0;3,0;8,0;129,0;45,0;7,0;2,0;12,0;1,0;26,0;8,0;35,0;;14,0;18,0;198,0;86,0;14,0;6,0;33,0;4,0;;8,0;45,0;24,0;34,0;8,0;;;9,0;35,0;10,0;4,0;20,0;6,0;2,0;5,0;3,0;11,0;6,0;22,0;;12,0;6,0;24,0;;6,0;31,0;9,0;2,0;6,0;3,0;2,0;1,0;10,0;3,0;22,0;;25,0;;157,0;5,0;2,0;6,0;7,0;4,0;;26,0;;14,0;61,0;8,0;7,0;3,0;10,0;3,0;1,0;13,0;8,0;4,0;4,0;8,0;10,0;7,0;2,0;10,0;2,0;;113,0;;6,0;;4,0;13,0;;;
sequence;1,0;1,0;;6,0;1,0;19,0;31,0;;;2,0;1,0;1,0;;69,0;;2,0;300,0;5,0;9,0;4,0;;;45,0;4,0;2,0;4,0;;;13,0;13,0;67,0;3,0;13,0;3,0;;70,0;6,0;;52,0;;80,0;142,0;;47,0;65,0;5,0;6,0;9,0;2,0;6,0;27,0;2,0;;1,0;8,0;1,0;17,0;1,0;26,0;78,0;;1,0;27,0;1,0;1104,0;3,0;83,0;4,0;3,0;2,0;2,0;46,0;104,0;;;5,0;3,0;12,0;13,0;17,0;153,0;2,0;36,0;31,0;5,0;7,0;1,0;5,0;;13,0;23,0;;;;10,0;2,0;72,0;;120,0;36,0;39,0;14,0;2,0;17,0;39,0;63,0;;9,0;;;;32,0;31,0;1,0;;3,0;7,0;30,0;23,0;54,0;;1,0;35,0;3,0;1,0;38,0;79,0;;14,0;;146,0;;2,0;10,0;6,0;;16,0;10,0;;;;7,0;;;;24,0;11,0;21,0;34,0;;;3,0;18,0;;7,0;;;;;;;;;23,0;;;3,0;12,0;2,0;18,0;10,0;;1,0;11,0;;2,0;;29,0;12,0;;;;;1,0;;;12,0;3,0;391,0;;4,0;5,0;;1,0;;;;;1,0;;;;;;7,0;14,0;2,0;;;;2,0;13,0;1,0;;;;41,0;4,0;1,0;10,0;55,0;42,0;;;;;20,0;;;10,0;;2,0;11,0;9,0;;8,0;4,0;;;14,0;;;;;;20,0;1,0;2,0;32,0;;;;;5,0;;1,0;3,0;15,0;;;;53,0;;20,0;;;;;9,0;6,0;;50,0;5,0;5,0;;;;6,0;;;;;5,0;;36,0;;;;10,0;;1,0;1,0;;;2,0;;25,0;6,0;;1,0;;;;5,0;;;;;;20,0;;;;;1,0;;1,0;;;;33,0;120,0;;4,0;;;;;15,0;;;;;;17,0;1,0;;;;;4,0;6,0;;;;1,0;18,0;9,0;;;9,0;;27,0;;26,0;;;;306,0;3,0;;4,0;3,0;6,0;3,0;1,0;21,0;;6,0;2,0;;;12,0;9,0;6,0;10,0;3,0;9,0;5,0;3,0;31,0;10,0;9,0;1,0;1,0;42,0;1,0;3,0;;14,0;3,0;13,0;20,0;8,0;;10,0;;41,0;10,0;4,0;;36,0;1,0;31,0;7,0;37,0;11,0;1,0;42,0;3,0;1,0;37,0;;2,0;25,0;2,0;;1,0;;4,0;;7,0;;6,0;2,0;84,0;11,0;14,0;;1,0;2,0;3,0;21,0;;6,0;;16,0;3,0;7,0;;;2,0;6,0;2,0;7,0;9,0;4,0;;27,0;5,0;4,0;;3,0;;;1,0;;49,0;;1,0;12,0;1,0;4,0;4,0;;18,0;5,0;7,0;;1,0;1,0;6,0;28,0;8,0;;;12,0;;3,0;;;2,0;;26,0;7,0;15,0;21,0;;4,0;3,0;1,0;;2,0;36,0;5,0;;;1,0;5,0;4,0;108,0;12,0;1,0;5,0;1,0;;;3,0;;;2,0;16,0;;;3,0;4,0;;;;;1,0;;1,0;;1,0;;;;;;;37,0;;;;;10,0;;;41,0;13,0;;;1,0;1,0;41,0;;;2,0;21,0;;2,0;;15,0;1,0;1,0;;34,0;;;;4,0;3,0;1,0;3,0;1,0;4,0;1,0;1,0;4,0;6,0;1,0;;;1,0;;2,0;4,0;;;1,0;;13,0;;4,0;;;;21,0;8,0;2,0;2,0;3,0;2,0;;4,0;;;15,0;1,0;2,0;5,0;1,0;34,0;;19,0;;34,0;;1,0;2,0;3,0;;;1,0;;4,0;2,0;;1,0;12,0;;24,0;12,0;;;;;1,0;3,0;;;;;;;;;;5,0;;3,0;2,0;;;2,0;;;3,0;;2,0;;;;4,0;2,0;2,0;;16,0;;;21,0;1,0;;2,0;;3,0;;;;12,0;;2,0;;3,0;6,0;;;70,0;1,0;4,0;;;3,0;;4,0;3,0;;;3,0;;1,0;14,0;2,0;;;3,0;1,0;;;;1,0;3,0;5,0;2,0;;;;;;;;;;;18,0;2,0;;;5,0;;;;;3,0;;;;6,0;;2,0;;;1,0;4,0;1,0;4,0;;;;12,0;;;;;3,0;;3,0;;3,0;;;;2,0;;;;;;;;;;;;;;;;;3,0;;4,0;;;;;;;;;8,0;;49,0;;1,0;;7,0;1,0;;;1,0;;;1,0;;;1,0;;;;;;8,0;;2,0;;;;8,0;2,0;31,0;2,0;;;;;;;;;18,0;;;;3,0;9,0;1,0;;;;;4,0;;;;1,0;5,0;;;1,0;;2,0;;;;;39,0;4,0;;;31,0;1,0;;2,0;1,0;4,0;;;;1,0;11,0;;;;10,0;;;1,0;1,0;2,0;3,0;;7,0;1,0;5,0;;7,0;20,0;;;;1,0;;;;;6,0;;1,0;15,0;16,0;1,0;;;;;;2,0;;;2,0;;;;;;;1,0;;1,0;;;5,0;;;2,0;;;;49,0;;;;154,0;2,0;28,0;1,0;25,0;;1,0;;;;;;;;;;;;1,0;;;;;;;;2,0;;;;;6,0;;;;3,0;;18,0;;;;;;1,0;;;;1,0;;;1,0;2,0;;1,0;;;;5,0;1,0;;;9,0;;;1,0;;1,0;;;1,0;;;1,0;;;
shade;1,0;1,0;;;2,0;18,0;;8,0;3,0;;;3,0;3,0;22,0;;1,0;2,0;1,0;1,0;;;;17,0;4,0;;;4,0;;;;5,0;2,0;2,0;17,0;2,0;8,0;2,0;1,0;2,0;;12,0;21,0;;;7,0;5,0;;2,0;;;;1,0;6,0;;7,0;;4,0;;;4,0;;;4,0;;58,0;7,0;15,0;1,0;;;;35,0;47,0;4,0;;;;2,0;2,0;10,0;12,0;;;;30,0;3,0;;5,0;;1,0;;14,0;;3,0;;;5,0;;21,0;2,0;35,0;1,0;;;;2,0;2,0;1,0;;1,0;4,0;2,0;5,0;;;;;1,0;;9,0;1,0;;3,0;1,0;;7,0;7,0;;;;;;;6,0;;;6,0;;;;;1,0;;1,0;2,0;;24,0;4,0;;8,0;;2,0;3,0;9,0;;3,0;;;;;;3,0;;;;;10,0;12,0;;;1,0;;1,0;10,0;1,0;1,0;;2,0;;;1,0;;;1,0;;1,0;;2,0;4,0;;;2,0;;;;2,0;1,0;12,0;1,0;;;;;;;;19,0;;;2,0;7,0;3,0;1,0;1,0;;2,0;;;;;7,0;;;;61,0;;17,0;;;;;;1,0;;;;;;;;;2,0;8,0;;;6,0;;2,0;1,0;1,0;;;;4,0;;;10,0;6,0;4,0;;;;;;4,0;;;;;;;1,0;7,0;;;;4,0;5,0;2,0;3,0;2,0;;7,0;6,0;;;;;;;;;1,0;1,0;2,0;;1,0;;1,0;1,0;2,0;;;;;1,0;;;;;1,0;;5,0;;;;2,0;;;5,0;1,0;43,0;;1,0;;1,0;;;;;1,0;;;;1,0;;;;;;6,0;2,0;;;;;;6,0;;2,0;;8,0;4,0;;;;;2,0;;2,0;1,0;;;;;3,0;;;;;;;;1,0;5,0;5,0;;;;;6,0;;;1,0;;5,0;6,0;;;;;4,0;;4,0;1,0;3,0;;14,0;1,0;;;3,0;1,0;1,0;;;;;1,0;2,0;;3,0;;;5,0;2,0;2,0;;2,0;;;4,0;1,0;;;3,0;;20,0;;;;;4,0;;;;;;;;2,0;1,0;;;;;;;2,0;;;;;1,0;;;;2,0;;;3,0;4,0;;;;;;;;;;;1,0;;;1,0;;;;;;;;3,0;;;;;;2,0;7,0;1,0;;;;2,0;;;;;;;4,0;;;1,0;;;;;;;;;;;;;;;;;;;;;;5,0;;;4,0;;;4,0;5,0;;;;2,0;;;;;2,0;;;;;;1,0;;;;;;;;;;;;;4,0;;;;;;;28,0;;;;;1,0;;15,0;;;;1,0;;;;1,0;;;;;;;;;1,0;;;;;;;;;;;1,0;;;;1,0;;;;;;;;;;;;4,0;;2,0;;;;;;;;;;;;;;;;;;;;;;;;;;;;;;;;;;;;;;;1,0;;;;;;;1,0;;;;;;;;;5,0;;;;;;4,0;;;;;;;;;;;;5,0;;2,0;;;;;;2,0;;;;;;6,0;;;;;2,0;;;;;1,0;;;;;;;3,0;;;;;;;;;;;2,0;;;18,0;;;;;;;;;;6,0;;;;;;;;;;;;;1,0;;;;;;;10,0;1,0;;;;;;;25,0;;;;;2,0;;;;;;;;;3,0;;;;;;;;;;;4,0;;;;;;;;;;;;;;;;;;;;;;;;;;;;;;;;;;;;;;;;;;;;;;;;;1,0;;;;;;;;;;;2,0;;;;;;;;;;;;;;;;;;;;;;;;;;;;;;;;;;;;;;;;;;;;;;;;1,0;;;;;;;;;;;;;;;;5,0;;;;;;;;;;;;;;;;;;;;;;;;;;;;;;;;11,0;;;;;;;;;;;;;;;;1,0;1,0;2,0;2,0;;;;;;;;;;;;;;;;;;;;;
signal;4,0;71,0;;142,0;82,0;423,0;159,0;63,0;;2,0;1,0;24,0;7,0;1133,0;42,0;33,0;387,0;40,0;122,0;27,0;144,0;7,0;276,0;138,0;263,0;13,0;32,0;235,0;74,0;66,0;2310,0;315,0;183,0;96,0;1,0;702,0;48,0;18,0;59,0;6,0;429,0;1290,0;3,0;843,0;604,0;74,0;2,0;160,0;;44,0;20,0;7,0;4,0;78,0;85,0;45,0;129,0;;352,0;1558,0;;47,0;157,0;7,0;3682,0;7,0;918,0;29,0;11,0;2,0;45,0;578,0;566,0;2,0;1,0;47,0;;48,0;5,0;213,0;557,0;1,0;243,0;3,0;302,0;19,0;13,0;551,0;2,0;53,0;91,0;5,0;91,0;216,0;26,0;18,0;2102,0;19,0;916,0;185,0;673,0;313,0;;411,0;868,0;849,0;8,0;32,0;8,0;3,0;;456,0;88,0;16,0;;51,0;116,0;284,0;26,0;1097,0;35,0;3,0;;23,0;17,0;164,0;568,0;;57,0;2,0;607,0;17,0;9,0;1505,0;12,0;7,0;139,0;6,0;60,0;9,0;;61,0;1,0;23,0;65,0;146,0;129,0;149,0;297,0;19,0;34,0;21,0;265,0;11,0;42,0;432,0;1,0;17,0;;;24,0;344,0;23,0;416,0;289,0;13,0;252,0;3,0;12,0;459,0;101,0;14,0;41,0;131,0;2,0;155,0;348,0;77,0;81,0;24,0;52,0;2,0;2,0;33,0;;12,0;205,0;8,0;419,0;22,0;3,0;3,0;5,0;164,0;3,0;32,0;41,0;53,0;9,0;7,0;14,0;65,0;14,0;16,0;58,0;37,0;27,0;15,0;13,0;64,0;45,0;147,0;88,0;;;2,0;2865,0;31,0;14,0;114,0;69,0;298,0;11,0;289,0;11,0;3,0;402,0;5,0;17,0;170,0;;36,0;134,0;48,0;20,0;14,0;56,0;43,0;1,0;144,0;;1,0;;;3,0;166,0;64,0;75,0;27,0;3,0;1,0;1,0;4,0;26,0;89,0;337,0;8,0;57,0;2,0;1,0;229,0;903,0;37,0;259,0;;3,0;157,0;68,0;8,0;10,0;;134,0;134,0;70,0;1,0;38,0;45,0;55,0;1,0;19,0;10,0;9,0;28,0;63,0;;;23,0;47,0;917,0;;196,0;39,0;;2,0;2,0;2,0;89,0;99,0;;5,0;;;11,0;5,0;;;1,0;38,0;5,0;497,0;;;6,0;32,0;41,0;;47,0;;19,0;25,0;120,0;213,0;19,0;29,0;13,0;4,0;30,0;1,0;222,0;34,0;1,0;;;1,0;163,0;;2,0;;;;35,0;62,0;6,0;;9,0;8,0;9,0;41,0;10,0;;;;6,0;6,0;33,0;1,0;188,0;9,0;1684,0;237,0;4,0;9,0;12,0;17,0;135,0;56,0;28,0;195,0;5,0;8,0;;9,0;92,0;10,0;192,0;15,0;13,0;80,0;313,0;94,0;2567,0;27,0;33,0;;33,0;415,0;145,0;151,0;14,0;108,0;26,0;36,0;168,0;123,0;51,0;82,0;16,0;96,0;271,0;77,0;23,0;724,0;105,0;812,0;17,0;70,0;69,0;95,0;112,0;97,0;2,0;70,0;;73,0;384,0;39,0;5,0;1,0;9,0;2,0;10,0;108,0;25,0;449,0;16,0;1796,0;208,0;590,0;133,0;2,0;178,0;1,0;84,0;81,0;54,0;19,0;77,0;91,0;370,0;363,0;24,0;326,0;144,0;38,0;41,0;44,0;1,0;17,0;163,0;120,0;;274,0;145,0;1,0;9,0;6,0;26,0;32,0;2,0;23,0;42,0;11,0;95,0;64,0;1,0;82,0;;7,0;75,0;9,0;34,0;60,0;123,0;153,0;3,0;;46,0;43,0;59,0;6,0;6,0;14,0;160,0;29,0;41,0;3,0;283,0;14,0;49,0;5,0;10,0;5,0;20,0;6,0;131,0;8,0;34,0;7,0;5,0;12,0;7,0;52,0;6,0;27,0;5,0;137,0;9,0;10,0;;13,0;771,0;112,0;15,0;4,0;4,0;140,0;5,0;5,0;3,0;48,0;57,0;36,0;15,0;1,0;7,0;16,0;;1,0;3,0;;3,0;11,0;;20,0;122,0;5,0;83,0;6,0;13,0;27,0;24,0;11,0;2,0;22,0;3,0;53,0;;37,0;22,0;7,0;;6,0;13,0;7,0;193,0;113,0;;38,0;2,0;;37,0;180,0;10,0;17,0;17,0;4,0;17,0;46,0;11,0;47,0;12,0;30,0;18,0;1,0;15,0;12,0;34,0;8,0;;54,0;26,0;2,0;27,0;77,0;97,0;;;6,0;47,0;106,0;26,0;2,0;54,0;2,0;6,0;27,0;1,0;7,0;7,0;10,0;21,0;6,0;4,0;46,0;14,0;12,0;;33,0;92,0;140,0;67,0;140,0;4,0;68,0;20,0;3,0;18,0;16,0;25,0;18,0;21,0;29,0;98,0;13,0;;9,0;;14,0;;11,0;2,0;;8,0;62,0;5,0;28,0;3,0;1,0;4,0;139,0;8,0;69,0;15,0;5,0;104,0;36,0;14,0;2,0;15,0;;194,0;16,0;18,0;1,0;13,0;29,0;12,0;5,0;74,0;;28,0;216,0;11,0;36,0;98,0;;8,0;8,0;;11,0;282,0;4,0;12,0;47,0;10,0;4,0;12,0;15,0;156,0;;10,0;3,0;19,0;444,0;64,0;213,0;8,0;2,0;1,0;10,0;11,0;3,0;592,0;19,0;21,0;149,0;18,0;128,0;2,0;1,0;19,0;19,0;28,0;292,0;306,0;;;2,0;;20,0;10,0;;5,0;52,0;138,0;79,0;45,0;8,0;84,0;9,0;8,0;10,0;;39,0;11,0;;4,0;13,0;17,0;9,0;1,0;73,0;;13,0;21,0;3,0;2,0;1,0;62,0;;56,0;17,0;;;;24,0;14,0;47,0;5,0;6,0;;2,0;6,0;2,0;13,0;;41,0;19,0;6,0;8,0;1,0;;;2,0;;4,0;2,0;2,0;;;42,0;;7,0;1,0;3,0;1,0;1,0;;13,0;;84,0;34,0;;77,0;1,0;14,0;12,0;43,0;94,0;8,0;124,0;172,0;72,0;66,0;150,0;3,0;177,0;105,0;17,0;30,0;12,0;21,0;24,0;85,0;53,0;4,0;;25,0;45,0;25,0;83,0;;18,0;21,0;184,0;6,0;64,0;38,0;19,0;23,0;33,0;9,0;29,0;40,0;293,0;14,0;9,0;38,0;11,0;;59,0;354,0;15,0;;8,0;17,0;1,0;18,0;;14,0;49,0;;19,0;;;9,0;25,0;;17,0;5,0;;12,0;56,0;14,0;19,0;92,0;26,0;6,0;3,0;50,0;;21,0;2,0;16,0;;103,0;3,0;3,0;19,0;138,0;;3,0;2,0;49,0;10,0;;44,0;130,0;;;14,0;54,0;15,0;5,0;;2,0;1,0;1,0;37,0;3,0;51,0;42,0;3,0;12,0;2,0;1,0;2,0;114,0;17,0;1,0;19,0;18,0;3,0;4,0;;24,0;;16,0;16,0;9,0;5,0;11,0;9,0;31,0;;;1,0;7,0;27,0;8,0;49,0;;17,0;;49,0;3,0;38,0;179,0;399,0;3,0;1,0;3,0;;2,0;6,0;10,0;;1,0;;72,0;7,0;545,0;14,0;;2,0;;2,0;;;18,0;5,0;1,0;;;11,0;5,0;5,0;;6,0;53,0;;147,0;7,0;5,0;3,0;;5,0;8,0;3,0;20,0;5,0;;;4,0;24,0;5,0;64,0;1,0;13,0;1,0;12,0;3,0;;3,0;2,0;;1,0;;1,0;;2,0;7,0;;4,0;;145,0;;;;2,0
size;8,0;1,0;8,0;53,0;28,0;50,0;25,0;8,0;;18,0;;;;164,0;;5,0;88,0;3,0;3,0;6,0;3,0;50,0;72,0;4,0;7,0;4,0;2,0;12,0;6,0;15,0;66,0;13,0;8,0;3,0;;127,0;42,0;3,0;22,0;1,0;189,0;127,0;22,0;23,0;162,0;10,0;;17,0;;1,0;15,0;;9,0;2,0;54,0;38,0;20,0;;2,0;16,0;3,0;;13,0;;657,0;2,0;69,0;16,0;14,0;1,0;10,0;79,0;23,0;;5,0;;6,0;5,0;6,0;8,0;133,0;1,0;7,0;6,0;46,0;1,0;;43,0;;14,0;30,0;;10,0;1,0;12,0;;196,0;24,0;80,0;36,0;142,0;112,0;3,0;14,0;11,0;43,0;4,0;7,0;8,0;1,0;12,0;25,0;188,0;2,0;1,0;2,0;56,0;14,0;14,0;76,0;3,0;1,0;23,0;;;13,0;81,0;;5,0;15,0;26,0;14,0;;30,0;14,0;2,0;57,0;10,0;23,0;;3,0;1,0;8,0;1,0;130,0;12,0;107,0;5,0;74,0;4,0;;11,0;36,0;3,0;3,0;;;;;;1,0;1,0;4,0;5,0;1,0;5,0;1,0;8,0;17,0;16,0;10,0;13,0;2,0;47,0;4,0;3,0;;;3,0;2,0;3,0;;;46,0;;;28,0;;65,0;12,0;2,0;;1,0;4,0;1,0;23,0;11,0;5,0;3,0;12,0;1,0;13,0;20,0;;20,0;22,0;16,0;1,0;3,0;21,0;7,0;18,0;;;2,0;8,0;15,0;1,0;2,0;3,0;20,0;6,0;;;6,0;;75,0;;;5,0;;1,0;61,0;30,0;2,0;5,0;4,0;1,0;2,0;5,0;;6,0;3,0;;1,0;17,0;6,0;121,0;16,0;;;;2,0;7,0;7,0;1,0;7,0;30,0;4,0;;6,0;6,0;4,0;45,0;4,0;;;;3,0;55,0;;;5,0;20,0;2,0;;8,0;14,0;;10,0;5,0;2,0;13,0;7,0;5,0;;2,0;12,0;11,0;;;;;11,0;24,0;;73,0;3,0;;12,0;;4,0;;4,0;;5,0;2,0;3,0;12,0;24,0;;6,0;6,0;;;;2,0;5,0;2,0;;19,0;261,0;4,0;8,0;2,0;1,0;2,0;2,0;5,0;18,0;13,0;;1,0;8,0;10,0;16,0;;;;;3,0;6,0;;3,0;;2,0;;18,0;;;;2,0;8,0;1,0;20,0;;;4,0;57,0;1,0;2,0;;;;;12,0;1,0;20,0;;5,0;;;43,0;9,0;115,0;31,0;9,0;2,0;21,0;8,0;44,0;10,0;;2,0;30,0;74,0;15,0;7,0;;;20,0;3,0;25,0;16,0;;10,0;13,0;13,0;10,0;3,0;;24,0;3,0;4,0;;64,0;13,0;5,0;18,0;1,0;;7,0;;1,0;24,0;30,0;2,0;10,0;1,0;;;1,0;3,0;;3,0;42,0;2,0;44,0;9,0;1,0;15,0;;30,0;3,0;11,0;;5,0;20,0;;;5,0;5,0;27,0;5,0;2,0;10,0;6,0;14,0;34,0;9,0;2,0;2,0;1,0;18,0;;6,0;;14,0;1,0;8,0;10,0;8,0;5,0;3,0;;4,0;;;3,0;4,0;2,0;8,0;6,0;5,0;1,0;;2,0;2,0;;8,0;10,0;3,0;2,0;7,0;;7,0;12,0;10,0;3,0;;;1,0;1,0;26,0;;;16,0;1,0;5,0;;3,0;9,0;1,0;6,0;29,0;20,0;;1,0;4,0;;1,0;13,0;1,0;;;4,0;;10,0;4,0;;2,0;17,0;;;6,0;;7,0;2,0;;;;54,0;4,0;12,0;17,0;;2,0;19,0;16,0;12,0;;12,0;;59,0;8,0;11,0;;2,0;;8,0;;3,0;13,0;5,0;;1,0;;9,0;;;3,0;8,0;2,0;4,0;3,0;1,0;21,0;;;1,0;;;;3,0;11,0;5,0;;5,0;2,0;;;2,0;1,0;5,0;;10,0;6,0;;1,0;8,0;;;;1,0;3,0;3,0;;;;1,0;;1,0;;31,0;;9,0;3,0;;;10,0;4,0;;;1,0;2,0;;2,0;1,0;3,0;10,0;;;8,0;34,0;;;;1,0;;2,0;8,0;;1,0;6,0;5,0;;;6,0;1,0;;6,0;3,0;;1,0;;7,0;2,0;2,0;1,0;;;;2,0;;8,0;1,0;11,0;7,0;17,0;16,0;;;3,0;;5,0;;6,0;;;;7,0;;;;6,0;14,0;;5,0;51,0;15,0;;2,0;;;;;3,0;4,0;12,0;1,0;;2,0;;;10,0;2,0;;;1,0;;2,0;;8,0;3,0;6,0;;;1,0;2,0;2,0;;3,0;;6,0;;6,0;;;8,0;9,0;4,0;4,0;2,0;2,0;;;;;;5,0;;;1,0;1,0;25,0;;;6,0;1,0;5,0;24,0;;;14,0;;10,0;7,0;;;1,0;2,0;1,0;;1,0;2,0;;1,0;6,0;;6,0;;;;;2,0;;;1,0;3,0;3,0;20,0;;12,0;;;;;;;;1,0;;;;8,0;1,0;;6,0;;;;;6,0;;;;33,0;8,0;;;;;6,0;20,0;;;;;27,0;9,0;2,0;;;;6,0;53,0;1,0;;;3,0;;2,0;3,0;;;;1,0;5,0;12,0;2,0;2,0;;;;76,0;10,0;18,0;2,0;;;;;;;;1,0;;19,0;;;2,0;1,0;2,0;;4,0;;4,0;;;;38,0;6,0;;7,0;;;3,0;9,0;7,0;;;;6,0;7,0;5,0;8,0;;;;3,0;;;;;5,0;1,0;5,0;;3,0;5,0;;;1,0;;3,0;;;;1,0;;;;4,0;;13,0;;;5,0;2,0;2,0;;;3,0;;2,0;;;;1,0;;;;4,0;;3,0;6,0;4,0;;;5,0;;;;;3,0;;;2,0;1,0;;;;;;;1,0;;;;;6,0;1,0;2,0;;;7,0;1,0;;1,0;;2,0;2,0;;;;;;2,0;;;3,0;6,0;2,0;;8,0;;;15,0;;;;;;;;;;;;;;;;2,0;2,0;;2,0;;;1,0
spectral;3,0;;;3,0;4,0;7,0;92,0;;;;;336,0;;26,0;17,0;4,0;6,0;;45,0;24,0;2,0;;44,0;;;1,0;;46,0;1,0;;188,0;19,0;;;;19,0;7,0;;2,0;;35,0;19,0;;5,0;1,0;8,0;1,0;9,0;;;11,0;;;;5,0;27,0;24,0;;15,0;20,0;4,0;16,0;14,0;;200,0;;94,0;;;;6,0;42,0;254,0;;1,0;;4,0;22,0;;;62,0;;2,0;;24,0;;;68,0;;4,0;19,0;;228,0;;;4,0;33,0;35,0;48,0;1,0;10,0;4,0;2,0;8,0;8,0;10,0;13,0;1,0;1,0;;;;26,0;;;3,0;72,0;12,0;37,0;41,0;1,0;;17,0;;;2,0;29,0;;;1,0;22,0;4,0;1,0;14,0;13,0;;1,0;;1,0;;;1,0;;;15,0;1,0;4,0;9,0;10,0;;;;;1,0;;;;;1,0;;;;15,0;2,0;;;;8,0;;6,0;;1,0;16,0;4,0;;;;11,0;1,0;;2,0;;;;;1,0;482,0;;1,0;2,0;;;;;;4,0;6,0;18,0;6,0;;;;22,0;;18,0;;;;6,0;4,0;2,0;;;;;;26,0;;;7,0;5,0;;;;;;41,0;;;40,0;;87,0;84,0;2,0;;;;6,0;;1,0;;;;;;42,0;5,0;2,0;;;;2,0;8,0;;2,0;;;6,0;;;1,0;6,0;24,0;;;;7,0;56,0;5,0;8,0;;;;4,0;1,0;;12,0;5,0;;2,0;2,0;1,0;;;3,0;;5,0;1,0;;;;13,0;;;;;;;;;;;;;;;;;1,0;39,0;;;;;;;89,0;;1,0;;;3,0;;2,0;;;1,0;;78,0;;;;;;7,0;;;;;;;;;;;;9,0;1,0;1,0;;;;1,0;;;;;;;;;;;;;;;;;;;;2,0;;17,0;;;;;;21,0;;;;3,0;34,0;;;;;;;;;;19,0;6,0;;;4,0;;;6,0;;1,0;7,0;3,0;;1,0;;;;;3,0;8,0;1,0;;;;;;;;;;31,0;;39,0;1,0;;5,0;;1,0;;;;;;4,0;;3,0;;;;;5,0;;;;;;;;;;;1,0;2,0;;4,0;;3,0;;;1,0;;5,0;;;;2,0;;;;;;4,0;;;;;;;14,0;;;1,0;;;;;;;9,0;2,0;;;;;;;;;;;;;;;;9,0;;;;1,0;13,0;;;;;;;;;;;;;;;;;;;;;24,0;;;;;;23,0;;;;;;;;;;2,0;;;1,0;;2,0;;;1,0;;;;;;;;;4,0;;;;;;1,0;1,0;4,0;;;;1,0;27,0;;;1,0;;;;;;;;29,0;;;;;3,0;;7,0;;2,0;6,0;;;;1,0;;;;;2,0;;;;;;;52,0;;;30,0;2,0;;28,0;;;;;;;;;;;;;;;;;;;;3,0;;;;4,0;;;;;;1,0;18,0;1,0;5,0;;;;;;3,0;;;;;;4,0;;;;5,0;;;;14,0;;;;;5,0;;;1,0;;;;;;;;;;;3,0;;;1,0;;1,0;;;;;;;1,0;;;3,0;;;29,0;1,0;;;15,0;;;;;;1,0;;;;;;1,0;;;3,0;;;;16,0;;80,0;;1,0;;;;;21,0;;;;;;;1,0;;;;;;;;;;;;2,0;;;1,0;;;1,0;3,0;;;;;;;;;;;;8,0;;9,0;;;;;7,0;;;;1,0;;;;1,0;;;;;;;;;;;;18,0;1,0;;;1,0;;;1,0;;39,0;;;;;;7,0;37,0;;;;4,0;;;;;;;;;;;;;;2,0;;3,0;;;;;;;;;;;;;3,0;;3,0;;2,0;;;;2,0;1,0;;;3,0;;;;;;;;;;2,0;;;;;;;;3,0;;;;;;;;;;;;;;;;;1,0;1,0;;;;;;;;;;;;;;;;;;5,0;;;;;;;;;;;;;;;;;1,0;;;3,0;;;;;;;;;;;3,0;;;;22,0;;;;;;;;1,0;;;12,0;;;;;1,0;1,0;;;1,0;;;;;;;;1,0;;;;;;;;;
store;4,0;4,0;;26,0;33,0;136,0;7,0;15,0;26,0;11,0;;5,0;;221,0;1,0;5,0;311,0;2,0;4,0;50,0;4,0;;51,0;10,0;49,0;2,0;2,0;34,0;325,0;14,0;606,0;64,0;31,0;69,0;;1085,0;19,0;1,0;35,0;3,0;159,0;599,0;1,0;256,0;158,0;10,0;2,0;36,0;2,0;19,0;18,0;;5,0;43,0;17,0;18,0;25,0;;2,0;88,0;;;21,0;24,0;2058,0;2,0;184,0;1,0;21,0;;14,0;140,0;54,0;7,0;12,0;17,0;;36,0;87,0;1341,0;384,0;1,0;66,0;118,0;86,0;8,0;3,0;25,0;;6,0;75,0;5,0;1,0;5,0;51,0;;97,0;12,0;333,0;161,0;185,0;81,0;;51,0;158,0;631,0;22,0;492,0;12,0;3,0;;109,0;108,0;4,0;4,0;16,0;25,0;43,0;48,0;94,0;38,0;7,0;164,0;13,0;2,0;;219,0;;11,0;3,0;105,0;18,0;;376,0;;;54,0;39,0;22,0;1,0;;2,0;1,0;1,0;8,0;17,0;46,0;46,0;111,0;6,0;;2,0;51,0;1,0;119,0;32,0;;;1,0;;;17,0;35,0;17,0;3,0;26,0;46,0;5,0;2,0;54,0;6,0;4,0;14,0;43,0;;4,0;8,0;1,0;10,0;12,0;37,0;;1,0;7,0;;4,0;26,0;6,0;197,0;1,0;;16,0;;2,0;2,0;10,0;5,0;5,0;2,0;;;;7,0;;12,0;603,0;17,0;;5,0;16,0;7,0;16,0;15,0;;;;64,0;2,0;;6,0;57,0;28,0;18,0;5,0;17,0;;98,0;;1,0;8,0;;1,0;36,0;1,0;1,0;5,0;4,0;2,0;;39,0;;4,0;;;;114,0;5,0;4,0;8,0;5,0;;;;17,0;1,0;1,0;5,0;24,0;1,0;21,0;29,0;89,0;9,0;41,0;;;21,0;1,0;8,0;26,0;;8,0;6,0;9,0;6,0;;8,0;41,0;;5,0;3,0;1,0;10,0;2,0;7,0;;;5,0;72,0;1,0;10,0;24,0;;;;1,0;33,0;2,0;8,0;;;;3,0;1,0;;;1,0;3,0;13,0;53,0;;;13,0;6,0;5,0;;4,0;3,0;4,0;5,0;45,0;154,0;;16,0;13,0;;1,0;4,0;21,0;6,0;;;;7,0;112,0;;1,0;;2,0;;4,0;5,0;10,0;;2,0;5,0;8,0;28,0;2,0;;;;11,0;3,0;42,0;;;6,0;365,0;18,0;;;3,0;3,0;3,0;7,0;10,0;3,0;;5,0;;;40,0;25,0;29,0;;6,0;19,0;68,0;18,0;154,0;88,0;7,0;2,0;7,0;75,0;17,0;9,0;4,0;24,0;4,0;464,0;56,0;20,0;9,0;28,0;;80,0;56,0;6,0;2,0;53,0;6,0;26,0;1,0;142,0;13,0;17,0;40,0;3,0;1,0;44,0;;8,0;86,0;20,0;;;17,0;10,0;1,0;;2,0;22,0;203,0;148,0;56,0;50,0;7,0;1,0;22,0;10,0;68,0;9,0;2,0;2,0;920,0;18,0;17,0;;8,0;26,0;20,0;2,0;6,0;267,0;;3,0;132,0;;8,0;12,0;2,0;;1,0;9,0;4,0;97,0;15,0;4,0;69,0;;36,0;28,0;4,0;40,0;3,0;78,0;1,0;13,0;24,0;7,0;746,0;17,0;5,0;;;5,0;15,0;31,0;;6,0;10,0;5,0;31,0;2,0;61,0;16,0;16,0;32,0;8,0;2,0;33,0;2,0;9,0;;12,0;6,0;48,0;;19,0;48,0;170,0;8,0;20,0;2,0;3,0;19,0;;9,0;79,0;8,0;16,0;10,0;4,0;5,0;8,0;5,0;20,0;;14,0;;5,0;;2,0;1,0;2,0;;5,0;2,0;;10,0;1,0;5,0;6,0;2,0;2,0;11,0;10,0;61,0;39,0;3,0;1,0;3,0;8,0;109,0;3,0;26,0;1,0;16,0;;;13,0;11,0;15,0;9,0;10,0;3,0;;1,0;4,0;22,0;4,0;8,0;28,0;24,0;9,0;4,0;55,0;8,0;4,0;;14,0;;1,0;18,0;4,0;9,0;;;19,0;;;7,0;7,0;;;2,0;147,0;7,0;7,0;158,0;1,0;4,0;;32,0;7,0;;24,0;2,0;13,0;154,0;5,0;161,0;4,0;111,0;10,0;3,0;3,0;1,0;7,0;7,0;15,0;;2,0;;11,0;17,0;26,0;7,0;5,0;12,0;40,0;43,0;3,0;9,0;;9,0;16,0;9,0;;1,0;;52,0;;12,0;5,0;;1,0;;8,0;21,0;4,0;;14,0;3,0;;;2,0;;1,0;1,0;40,0;2,0;10,0;5,0;29,0;;9,0;2,0;;7,0;42,0;2,0;19,0;;3,0;2,0;;9,0;37,0;5,0;3,0;8,0;27,0;12,0;2,0;99,0;70,0;7,0;1,0;4,0;16,0;11,0;5,0;10,0;4,0;;;;;;12,0;6,0;34,0;6,0;9,0;11,0;;;;1,0;24,0;10,0;12,0;;;3,0;;12,0;3,0;;2,0;13,0;;4,0;6,0;4,0;11,0;1,0;6,0;;;2,0;8,0;;1,0;;7,0;15,0;;3,0;;6,0;7,0;26,0;1,0;1,0;2,0;;36,0;;;;;2,0;3,0;5,0;3,0;7,0;;;;;3,0;;1,0;2,0;;3,0;2,0;;;2,0;;6,0;;;5,0;;98,0;2,0;1,0;1,0;;;3,0;1,0;;;;11,0;;3,0;1,0;9,0;2,0;;8,0;;;;4,0;34,0;16,0;;55,0;11,0;11,0;2,0;1,0;;;41,0;2,0;26,0;;3,0;3,0;2,0;11,0;12,0;;3,0;2,0;9,0;;12,0;5,0;;;6,0;12,0;1,0;;19,0;;19,0;5,0;;6,0;8,0;13,0;;25,0;17,0;27,0;3,0;;2,0;4,0;;;11,0;8,0;1,0;1,0;;1,0;;3,0;17,0;;15,0;12,0;4,0;18,0;2,0;2,0;6,0;1,0;;2,0;17,0;51,0;;;3,0;;;5,0;13,0;7,0;13,0;7,0;1,0;;2,0;;6,0;6,0;1,0;6,0;2,0;;21,0;1,0;51,0;14,0;;5,0;3,0;;3,0;7,0;;;1,0;;5,0;5,0;7,0;1,0;1,0;28,0;2,0;;2,0;;;;1,0;;;;;3,0;;15,0;;;1,0;;;;5,0;;6,0;;1,0;49,0;;;;1,0;1,0;;;;3,0;2,0;12,0;;;;;;3,0;;;12,0;;;;4,0;;2,0;;6,0;7,0;;;;;;3,0;18,0;3,0;1,0;2,0;;1,0;;2,0;5,0;;20,0;4,0;;;;;;9,0;;3,0;;;1,0;;8,0;;4,0;3,0;24,0;;2,0;2,0;;
system;17,0;127,0;12,0;215,0;124,0;583,0;501,0;375,0;13,0;10,0;10,0;98,0;43,0;795,0;11,0;33,0;1389,0;9,0;103,0;81,0;41,0;14,0;193,0;65,0;366,0;44,0;32,0;432,0;705,0;309,0;2178,0;513,0;65,0;166,0;21,0;1416,0;180,0;133,0;252,0;38,0;1016,0;2281,0;58,0;473,0;1013,0;203,0;56,0;584,0;29,0;73,0;121,0;9,0;55,0;108,0;477,0;490,0;329,0;12,0;51,0;382,0;28,0;2,0;261,0;28,0;5145,0;76,0;2371,0;35,0;40,0;26,0;522,0;3647,0;925,0;41,0;21,0;14,0;99,0;156,0;92,0;365,0;2034,0;23,0;258,0;159,0;735,0;84,0;23,0;2267,0;60,0;96,0;291,0;40,0;64,0;58,0;113,0;4,0;497,0;174,0;1361,0;496,0;1285,0;162,0;24,0;197,0;1074,0;1357,0;71,0;221,0;33,0;21,0;3,0;338,0;224,0;16,0;23,0;19,0;96,0;170,0;261,0;1324,0;79,0;7,0;568,0;81,0;29,0;219,0;;170,0;68,0;16,0;472,0;19,0;3,0;914,0;31,0;241,0;686,0;181,0;780,0;4,0;3,0;51,0;152,0;5,0;180,0;63,0;206,0;145,0;270,0;138,0;25,0;104,0;410,0;40,0;30,0;34,0;2,0;10,0;2,0;3,0;28,0;265,0;59,0;85,0;19,0;29,0;512,0;114,0;10,0;355,0;164,0;12,0;92,0;309,0;54,0;75,0;44,0;92,0;80,0;46,0;42,0;104,0;12,0;165,0;20,0;27,0;171,0;23,0;362,0;180,0;49,0;31,0;53,0;67,0;96,0;50,0;490,0;60,0;172,0;26,0;3,0;33,0;160,0;24,0;199,0;96,0;176,0;3,0;270,0;1355,0;146,0;188,0;67,0;4,0;10,0;72,0;246,0;49,0;14,0;110,0;219,0;94,0;50,0;18,0;189,0;15,0;515,0;15,0;16,0;45,0;28,0;119,0;230,0;78,0;150,0;44,0;41,0;22,0;13,0;54,0;8,0;44,0;28,0;6,0;51,0;285,0;52,0;110,0;274,0;24,0;28,0;12,0;11,0;252,0;89,0;74,0;275,0;472,0;79,0;;107,0;206,0;39,0;2047,0;30,0;33,0;5,0;65,0;45,0;97,0;27,0;47,0;159,0;98,0;63,0;38,0;80,0;294,0;13,0;40,0;85,0;74,0;370,0;114,0;11,0;9,0;72,0;23,0;200,0;13,0;22,0;113,0;10,0;19,0;43,0;19,0;433,0;185,0;10,0;35,0;17,0;7,0;74,0;46,0;83,0;20,0;157,0;157,0;72,0;1674,0;5,0;6,0;50,0;6,0;30,0;17,0;199,0;99,0;15,0;114,0;342,0;1020,0;31,0;79,0;65,0;8,0;105,0;13,0;338,0;41,0;30,0;9,0;77,0;50,0;199,0;36,0;14,0;7,0;15,0;8,0;106,0;84,0;32,0;46,0;19,0;90,0;33,0;151,0;10,0;36,0;34,0;35,0;17,0;10,0;335,0;105,0;44,0;52,0;1530,0;261,0;41,0;9,0;35,0;68,0;40,0;122,0;77,0;45,0;23,0;52,0;19,0;29,0;173,0;105,0;121,0;30,0;21,0;135,0;68,0;24,0;1768,0;1359,0;17,0;147,0;33,0;521,0;88,0;54,0;67,0;85,0;35,0;289,0;44,0;496,0;65,0;215,0;10,0;229,0;103,0;13,0;49,0;264,0;126,0;104,0;72,0;376,0;56,0;641,0;369,0;199,0;16,0;175,0;18,0;372,0;345,0;240,0;13,0;15,0;5,0;15,0;9,0;55,0;5,0;170,0;46,0;636,0;298,0;153,0;69,0;20,0;165,0;50,0;188,0;41,0;170,0;87,0;164,0;188,0;121,0;32,0;91,0;67,0;177,0;150,0;58,0;73,0;35,0;46,0;589,0;30,0;22,0;44,0;117,0;42,0;22,0;54,0;18,0;516,0;16,0;68,0;648,0;26,0;30,0;65,0;56,0;65,0;87,0;42,0;18,0;25,0;54,0;92,0;454,0;376,0;24,0;28,0;116,0;85,0;26,0;61,0;28,0;43,0;75,0;214,0;237,0;107,0;448,0;50,0;102,0;93,0;10,0;55,0;79,0;83,0;95,0;35,0;141,0;353,0;70,0;184,0;103,0;133,0;38,0;40,0;88,0;71,0;1351,0;158,0;3,0;21,0;137,0;29,0;19,0;27,0;28,0;116,0;151,0;76,0;6,0;14,0;115,0;145,0;25,0;25,0;20,0;17,0;55,0;20,0;88,0;45,0;29,0;142,0;12,0;102,0;99,0;41,0;59,0;16,0;35,0;93,0;27,0;14,0;43,0;89,0;22,0;75,0;36,0;22,0;35,0;13,0;15,0;5,0;148,0;75,0;53,0;56,0;6,0;21,0;3,0;41,0;25,0;58,0;268,0;67,0;79,0;77,0;200,0;38,0;106,0;95,0;15,0;21,0;7,0;30,0;88,0;100,0;21,0;92,0;3,0;70,0;17,0;8,0;99,0;110,0;70,0;26,0;36,0;45,0;108,0;44,0;61,0;55,0;12,0;42,0;84,0;11,0;40,0;44,0;104,0;23,0;34,0;52,0;39,0;192,0;47,0;42,0;15,0;92,0;34,0;22,0;22,0;22,0;38,0;47,0;51,0;25,0;43,0;71,0;42,0;72,0;50,0;34,0;51,0;161,0;45,0;5,0;1,0;;12,0;25,0;12,0;132,0;132,0;217,0;8,0;23,0;81,0;2,0;15,0;23,0;35,0;21,0;67,0;63,0;25,0;35,0;17,0;59,0;16,0;15,0;9,0;35,0;58,0;14,0;38,0;44,0;62,0;10,0;46,0;34,0;60,0;59,0;128,0;47,0;85,0;4,0;26,0;16,0;15,0;24,0;293,0;78,0;39,0;105,0;86,0;49,0;44,0;40,0;383,0;9,0;26,0;30,0;26,0;70,0;41,0;65,0;89,0;23,0;14,0;14,0;8,0;110,0;27,0;11,0;25,0;89,0;7,0;34,0;12,0;66,0;22,0;8,0;12,0;146,0;134,0;37,0;12,0;37,0;4,0;40,0;19,0;20,0;33,0;31,0;8,0;358,0;9,0;39,0;181,0;31,0;46,0;14,0;15,0;41,0;17,0;39,0;44,0;27,0;68,0;39,0;122,0;7,0;27,0;23,0;225,0;13,0;16,0;21,0;43,0;;53,0;23,0;21,0;50,0;8,0;61,0;22,0;56,0;39,0;8,0;48,0;;3,0;11,0;18,0;12,0;11,0;47,0;20,0;37,0;9,0;81,0;8,0;3,0;4,0;21,0;16,0;5,0;64,0;23,0;25,0;8,0;123,0;40,0;44,0;26,0;12,0;14,0;24,0;29,0;24,0;29,0;20,0;18,0;83,0;9,0;7,0;44,0;3,0;13,0;9,0;13,0;35,0;11,0;9,0;5,0;51,0;9,0;32,0;4,0;2,0;5,0;3,0;153,0;4,0;27,0;;17,0;151,0;50,0;18,0;13,0;11,0;1,0;22,0;34,0;27,0;20,0;53,0;3,0;;51,0;101,0;1,0;29,0;34,0;17,0;46,0;14,0;9,0;24,0;18,0;55,0;4,0;10,0;23,0;20,0;20,0;1,0;12,0;12,0;19,0;39,0;21,0;21,0;21,0;17,0;9,0;45,0;41,0;29,0;168,0;15,0;25,0;26,0;22,0;127,0;25,0;12,0;33,0;11,0;60,0;50,0;55,0;22,0;11,0;34,0;34,0;71,0;49,0;12,0;56,0;288,0;67,0;104,0;5,0;6,0;29,0;75,0;22,0;42,0;20,0;98,0;52,0;6,0;25,0;16,0;17,0;7,0;28,0;30,0;48,0;19,0;6,0;23,0;3,0;21,0;71,0;48,0;33,0;23,0;171,0;13,0;;29,0;15,0;9,0;31,0;60,0;6,0;11,0;38,0;88,0;14,0;6,0;13,0;46,0;5,0;118,0;23,0;19,0;2,0;33,0;6,0;7,0;40,0;24,0;10,0;20,0;19,0;36,0;12,0;35,0;44,0;5,0;30,0;1,0;6,0;;12,0;115,0;14,0;45,0;7,0;81,0;8,0;;39,0;4,0;3,0;35,0;1,0;43,0;10,0;16,0;2,0;6,0;19,0;10,0;24,0;6,0;20,0;14,0;9,0;27,0;2,0;14,0;13,0;9,0;54,0;104,0;19,0;6,0;12,0;25,0;5,0;9,0;26,0;2,0;16,0;29,0;40,0;3,0;95,0;28,0;8,0;17,0;3,0;80,0;5,0;69,0;13,0;1,0;11,0;2,0;1,0;1,0;8,0;14,0;
telephoto;2,0;;;2,0;1,0;1,0;2,0;10,0;;;4,0;;;;;;5,0;;;4,0;;;;;;;;;1,0;7,0;10,0;;1,0;;;;2,0;4,0;;;;21,0;2,0;6,0;;;;23,0;;;;;1,0;;1,0;34,0;9,0;;;;;;28,0;;90,0;;15,0;;;13,0;42,0;356,0;1,0;;30,0;;7,0;;;;1,0;;;;6,0;;6,0;23,0;;1,0;;;;;;;;2,0;6,0;4,0;15,0;14,0;2,0;;;;;;;;;;;;;;2,0;;;1,0;;;;;;;170,0;;;;63,0;10,0;;70,0;5,0;;7,0;;159,0;;;1,0;;1,0;3,0;;;3,0;2,0;;;;;;;;;;;;;;;1,0;;;;;;;;;;7,0;;;;;;;;;;;;;;;;;2,0;;;;;;;;;;;;208,0;;;;;;2,0;2,0;1,0;1,0;;;;1,0;;;;5,0;;;;;;;;;;;;;14,0;24,0;;;;;;6,0;;1,0;;;;2,0;4,0;;41,0;;;;;;;;;26,0;;;;;;;;;;;;;;;;;;;;31,0;;;;;12,0;;;;;3,0;;;;;;;;;26,0;;;;;;;;;;;;4,0;;;;;;;;1,0;;;;21,0;19,0;;;;;;;3,0;;;;;;;;;;;;;3,0;;;;;;2,0;;;;;3,0;;7,0;;;;;;;;;;;;;3,0;;;;;;;;;;;;;;;;2,0;;;;;;;;;;5,0;;1,0;11,0;;;;;;;;;;;;;;;;;;4,0;;;;6,0;;;;;;;;;;;;;;;;;;;;;;;;;;;;;;1,0;;;;;1,0;;;;;;1,0;;;;;;;;;;;;;;;;;;;;;;;;;;;11,0;;;;;;;3,0;;;;;;;;;;;;;;;;;;;;;;;;1,0;;;;;;;;;;;;;;;;;;;2,0;;;;;;;2,0;;;;;;;1,0;;;;;;;;;;;;;;;;;;;;;;;;;;;;;;;;;;;;;;;2,0;;;;;;;;;;;;;;;;;;;;;;;;;;;;;;;;;;;;;;;;;;;;;;;;;;;;;;;;;;;;;;;;;;;;;;;;;;;;;;;;;;;;;;;;;;;;;;;;;;;;;10,0;;;;;;;;;;;;;;;;;;;7,0;;;;;;;;;;1,0;;;;;;;;;;;;;;3,0;;;;;6,0;;;;;;;10,0;;;;;;;;;;;;2,0;;;;21,0;;;;;;;;;;;;;;;;;;;;;;;;;;;;;;;;;;;;;;;;;;;;;;;;;;;;;;;;1,0;;;;;;;;2,0;;;;;;;;;;;;;;;;;;;;;;;;;;;;;;;;;;;;;;3,0;;;;;8,0;;;;13,0;;;;;;;;;;;;2,0;;4,0;;;2,0;;;;;;;;;;;;;;;;;;;;;;;;;;;;;;;;;2,0;;;;;;;3,0;;;;;;;;;;;;;;;;;1,0;2,0;;;;;;;;;;;;;;;;;;;;;;;;;;;;;;;;;;;;;;;;;;;;;;;;;;;9,0;
test;4,0;;;13,0;;57,0;11,0;3,0;;;;;;52,0;;34,0;175,0;;;;3,0;2,0;39,0;3,0;8,0;;17,0;47,0;4,0;5,0;49,0;4,0;16,0;5,0;2,0;96,0;8,0;7,0;;1,0;96,0;145,0;;42,0;44,0;11,0;;16,0;;;3,0;;;1,0;66,0;6,0;15,0;;2,0;52,0;;;2,0;;359,0;3,0;55,0;;11,0;;5,0;10,0;25,0;2,0;;;1,0;12,0;;5,0;103,0;3,0;4,0;8,0;92,0;;;34,0;1,0;1,0;8,0;2,0;3,0;;;;17,0;46,0;141,0;111,0;22,0;7,0;;3,0;4,0;40,0;1,0;2,0;;;;36,0;3,0;;;2,0;2,0;19,0;1,0;15,0;14,0;;57,0;5,0;;11,0;68,0;;;;17,0;;2,0;28,0;;;17,0;30,0;;;;2,0;;;1,0;6,0;2,0;2,0;9,0;10,0;;2,0;2,0;4,0;;;;;3,0;;4,0;19,0;3,0;5,0;;1,0;1,0;2,0;;21,0;12,0;2,0;;1,0;;2,0;;;3,0;;;;8,0;14,0;;;;2,0;24,0;4,0;;;;1,0;9,0;3,0;11,0;;;1,0;;;;1,0;16,0;6,0;3,0;;6,0;8,0;3,0;;1,0;;;;6,0;;;;241,0;;;;2,0;;31,0;2,0;;;;;3,0;28,0;;;2,0;;1,0;1,0;1,0;;1,0;1,0;1,0;27,0;;1,0;9,0;;3,0;;;66,0;14,0;17,0;13,0;5,0;2,0;;;7,0;2,0;2,0;2,0;;;;;2,0;;9,0;;;;;1,0;6,0;;5,0;;;1,0;11,0;2,0;;;;21,0;;3,0;15,0;;;;;58,0;4,0;;;;;6,0;;;;;1,0;;40,0;;;;;1,0;;7,0;1,0;;4,0;;30,0;3,0;;10,0;2,0;;;;8,0;;;;2,0;4,0;;2,0;;;;5,0;;;4,0;;1,0;2,0;;;;;;;;;1,0;;5,0;7,0;3,0;;;;1,0;;;3,0;;;;;;40,0;1,0;8,0;2,0;;5,0;9,0;2,0;24,0;4,0;;14,0;1,0;24,0;5,0;7,0;;1,0;3,0;18,0;1,0;6,0;;7,0;;17,0;6,0;2,0;;7,0;;2,0;1,0;62,0;2,0;;3,0;5,0;3,0;4,0;;2,0;2,0;2,0;;;1,0;;;3,0;;1,0;4,0;25,0;3,0;14,0;6,0;1,0;4,0;;14,0;;;;3,0;12,0;1,0;4,0;7,0;1,0;8,0;4,0;;4,0;2,0;;7,0;;;12,0;2,0;;;;;22,0;;3,0;7,0;;;12,0;;1,0;1,0;8,0;;;2,0;6,0;25,0;3,0;;;;2,0;1,0;5,0;;2,0;2,0;9,0;;1,0;26,0;;;7,0;;;;2,0;;;6,0;;24,0;;;6,0;;;4,0;1,0;1,0;1,0;;;5,0;;;;;2,0;6,0;;;;10,0;1,0;;4,0;14,0;;;1,0;;;;;1,0;;1,0;;1,0;;;2,0;;2,0;1,0;3,0;;3,0;;;;3,0;;2,0;;;;;;;;;;;;2,0;2,0;2,0;1,0;4,0;;;;;;;;1,0;1,0;3,0;;;1,0;;;;5,0;;;;1,0;1,0;1,0;;;;;;;;;;;;;6,0;;;;2,0;4,0;;5,0;;2,0;;7,0;;;4,0;;;;9,0;5,0;;;;;;;;;;;3,0;;;;;1,0;;;;11,0;;;;;;;1,0;;4,0;;;;8,0;;;64,0;;;2,0;;;;;;;;;7,0;3,0;;;;;16,0;;9,0;;;24,0;;1,0;;;4,0;3,0;;;;;;;1,0;15,0;;;;2,0;3,0;;;;;;;;;;;;;;;1,0;;1,0;;3,0;;;6,0;;;1,0;;67,0;;;;;;;2,0;;3,0;;1,0;1,0;;;;;;;;13,0;;;;;;;;;;;1,0;;;;;;;2,0;1,0;;;;12,0;;1,0;;;;;;;26,0;1,0;;;;;;;3,0;;;;9,0;1,0;;;;;;;;;;8,0;;1,0;;;;;5,0;;;;;1,0;5,0;2,0;;;;4,0;2,0;1,0;;;;;;;1,0;;;;;;;;;;1,0;1,0;;;;;3,0;;;1,0;;;;;;5,0;;1,0;;12,0;1,0;;11,0;3,0;;;;;;;;2,0;;11,0;3,0;1,0;;;;7,0;;;;;;;1,0;;;;;;;;2,0;;;;;;;;6,0;;;;;;;;;1,0;;;1,0;;;;;;;;2,0;;;;;;7,0;;;;;;;1,0;;;;1,0;;1,0;;;;;;;;1,0;;1,0;;;;;;;;;;;1,0;10,0;;;;;10,0;;;;;;;;1,0;;2,0;;;;;;;;1,0;;11,0;;;;;;;;;;;;
thickness;1,0;;;8,0;1,0;14,0;24,0;19,0;;;49,0;2,0;5,0;44,0;;1,0;5,0;;2,0;;1,0;;13,0;;;1,0;8,0;11,0;1,0;12,0;5,0;;;;3,0;;8,0;;17,0;;13,0;33,0;8,0;1,0;2,0;9,0;;48,0;4,0;;;2,0;19,0;3,0;1,0;25,0;33,0;;;;20,0;;6,0;;22,0;1,0;18,0;12,0;;;27,0;229,0;21,0;3,0;;;32,0;2,0;;1,0;33,0;;;;49,0;;;141,0;4,0;;2,0;5,0;;;1,0;;4,0;2,0;2,0;1,0;8,0;3,0;;3,0;1,0;2,0;;1,0;;;2,0;;12,0;;1,0;;;4,0;;20,0;;;2,0;15,0;1,0;3,0;16,0;;;;10,0;14,0;;65,0;3,0;5,0;1,0;;11,0;2,0;;5,0;;;20,0;3,0;6,0;1,0;;;;1,0;13,0;3,0;4,0;;2,0;4,0;;2,0;13,0;4,0;;;2,0;;5,0;36,0;10,0;;1,0;;;72,0;1,0;5,0;;1,0;;;2,0;2,0;2,0;3,0;;55,0;17,0;;3,0;23,0;6,0;;;2,0;1,0;1,0;36,0;;17,0;2,0;10,0;80,0;6,0;;7,0;4,0;42,0;12,0;;6,0;;;2,0;2,0;;16,0;2,0;2,0;;1,0;8,0;;;4,0;30,0;;87,0;;;;1,0;10,0;20,0;;11,0;;;3,0;;27,0;1,0;10,0;;;;7,0;7,0;23,0;36,0;;1,0;15,0;4,0;3,0;25,0;;8,0;73,0;;1,0;;1,0;3,0;;1,0;1,0;1,0;6,0;;3,0;1,0;2,0;1,0;;4,0;;3,0;1,0;4,0;;6,0;;58,0;10,0;;;1,0;23,0;9,0;;;;;3,0;4,0;1,0;23,0;;13,0;;;2,0;;;;3,0;;1,0;27,0;46,0;;;;;;;11,0;2,0;;1,0;2,0;4,0;1,0;1,0;;6,0;1,0;3,0;2,0;1,0;13,0;;;7,0;;;;;;;;;;1,0;;1,0;4,0;9,0;;4,0;;;2,0;20,0;;;1,0;3,0;;;;;;;;2,0;;1,0;;;;;;27,0;10,0;3,0;;;2,0;;;;;;5,0;2,0;;5,0;;;3,0;;;3,0;;18,0;6,0;;;;;;3,0;;;;;;;;;5,0;;;1,0;;;1,0;;;;;;1,0;;3,0;;;;;;;;;;;;16,0;;;;10,0;;;;;;;;;;;;;;;;;1,0;2,0;;3,0;;;;;;;;;;;1,0;;6,0;1,0;;;;;3,0;;;;;;1,0;3,0;2,0;;;;;;;;;;;;;;;;;;;;;;;3,0;;;1,0;;1,0;2,0;;;;2,0;;1,0;;;1,0;3,0;;;;;;7,0;3,0;;;9,0;;;;1,0;;20,0;;;;;3,0;;;;;;;;;;;;;;2,0;;;;;;1,0;;;;;15,0;3,0;;;;;;;6,0;;;;11,0;;;2,0;1,0;;;4,0;4,0;;;;;;;;;;;;;;3,0;;1,0;;;;;;;;1,0;;2,0;;;;;;;1,0;;;;;;;;3,0;;;;13,0;;2,0;;3,0;1,0;;5,0;;2,0;;;;;;;;;;2,0;;;;;;;;5,0;;;;;1,0;;4,0;;;;;;1,0;;;1,0;;;;;;8,0;4,0;;;1,0;;1,0;;;;;;;;;;;4,0;;;7,0;3,0;;;;;;;;;;1,0;11,0;;4,0;10,0;;;;;;;;;;1,0;;;;;;;3,0;;;;;;1,0;;;;;2,0;1,0;;;;1,0;;;;;5,0;;1,0;;;;;;;;;;4,0;;;;1,0;;17,0;;;;;;18,0;5,0;;3,0;;;;;11,0;;;1,0;4,0;;;;;;5,0;;;;1,0;;;;;;4,0;;;;12,0;;;;;;;;;;4,0;15,0;;;;;;;;;;2,0;5,0;;;1,0;;;1,0;;;;1,0;;;;;;;;11,0;;;;;;;;;;;;;;1,0;;21,0;;;;;;;;;4,0;;;1,0;;2,0;;;2,0;;;;;;;;;;;;;;;;;8,0;1,0;;;;;;;;;1,0;;;;;;1,0;;;;;;;5,0;;;1,0;2,0;;;;;;;;;;;2,0;5,0;;2,0;1,0;;2,0;;;;;2,0;;;;;;;2,0;1,0;;;;;;;;;2,0;;;;;3,0;;;;;14,0;;;;;;;;7,0;;;;;;;;1,0;
time;4,0;14,0;28,0;116,0;199,0;167,0;421,0;21,0;1,0;6,0;;15,0;2,0;563,0;17,0;48,0;925,0;16,0;27,0;34,0;10,0;2,0;163,0;3,0;75,0;15,0;11,0;49,0;53,0;122,0;309,0;84,0;19,0;44,0;4,0;632,0;63,0;15,0;78,0;1,0;637,0;564,0;5,0;100,0;418,0;17,0;5,0;74,0;2,0;20,0;64,0;6,0;16,0;13,0;72,0;59,0;36,0;;83,0;186,0;;22,0;101,0;1,0;2424,0;9,0;334,0;31,0;18,0;;139,0;250,0;351,0;9,0;24,0;12,0;2,0;80,0;13,0;106,0;630,0;;154,0;33,0;161,0;5,0;4,0;160,0;1,0;20,0;80,0;12,0;23,0;;215,0;54,0;463,0;53,0;413,0;425,0;315,0;576,0;4,0;71,0;163,0;168,0;119,0;22,0;29,0;;2,0;226,0;114,0;13,0;;12,0;42,0;104,0;99,0;470,0;146,0;;607,0;26,0;22,0;105,0;472,0;63,0;17,0;10,0;;39,0;;357,0;51,0;16,0;112,0;14,0;55,0;;;33,0;26,0;9,0;17,0;72,0;59,0;42,0;188,0;1,0;32,0;40,0;32,0;1,0;44,0;10,0;;;;12,0;;11,0;45,0;15,0;6,0;5,0;12,0;12,0;3,0;64,0;38,0;3,0;19,0;45,0;6,0;27,0;6,0;37,0;25,0;;12,0;1,0;24,0;27,0;;9,0;73,0;3,0;468,0;6,0;6,0;5,0;;23,0;;4,0;14,0;2,0;3,0;1,0;;2,0;209,0;2,0;187,0;43,0;66,0;;28,0;15,0;43,0;83,0;78,0;;;1,0;180,0;21,0;6,0;23,0;49,0;1304,0;13,0;1,0;11,0;;109,0;1,0;7,0;29,0;;47,0;137,0;54,0;7,0;7,0;34,0;9,0;;46,0;;7,0;4,0;;;161,0;31,0;7,0;50,0;9,0;12,0;;5,0;24,0;4,0;28,0;4,0;39,0;3,0;;32,0;92,0;32,0;164,0;1,0;;22,0;29,0;4,0;72,0;3,0;12,0;19,0;14,0;;;16,0;95,0;4,0;11,0;4,0;2,0;18,0;2,0;;;1,0;39,0;61,0;;4,0;61,0;;;7,0;;90,0;35,0;;;;;;2,0;;;1,0;14,0;7,0;158,0;;;1,0;3,0;19,0;1,0;57,0;;27,0;8,0;43,0;268,0;39,0;56,0;;;27,0;;82,0;;1,0;;;;198,0;1,0;11,0;;6,0;;9,0;24,0;2,0;;1,0;;51,0;37,0;;;3,0;;53,0;;83,0;4,0;47,0;17,0;377,0;46,0;6,0;19,0;9,0;8,0;70,0;36,0;21,0;21,0;3,0;11,0;;24,0;191,0;40,0;210,0;31,0;10,0;56,0;64,0;40,0;408,0;78,0;73,0;12,0;12,0;194,0;36,0;225,0;16,0;129,0;107,0;37,0;24,0;104,0;12,0;81,0;2,0;85,0;125,0;33,0;17,0;89,0;24,0;87,0;11,0;206,0;6,0;53,0;122,0;15,0;;94,0;16,0;65,0;286,0;66,0;22,0;5,0;8,0;51,0;7,0;102,0;22,0;34,0;27,0;287,0;33,0;184,0;47,0;4,0;88,0;;232,0;13,0;78,0;6,0;33,0;101,0;61,0;128,0;135,0;65,0;298,0;6,0;7,0;53,0;;31,0;149,0;32,0;;55,0;52,0;2,0;6,0;6,0;40,0;77,0;5,0;4,0;78,0;39,0;111,0;22,0;3,0;19,0;3,0;5,0;11,0;8,0;26,0;9,0;77,0;19,0;;;20,0;1,0;11,0;8,0;2,0;1,0;56,0;56,0;23,0;18,0;125,0;10,0;3,0;60,0;12,0;5,0;7,0;29,0;67,0;1,0;13,0;3,0;10,0;6,0;24,0;78,0;;42,0;26,0;21,0;32,0;20,0;7,0;11,0;95,0;38,0;21,0;1,0;4,0;37,0;24,0;37,0;3,0;;6,0;4,0;12,0;10,0;3,0;6,0;;;8,0;;;27,0;;5,0;27,0;4,0;526,0;10,0;21,0;55,0;14,0;29,0;;37,0;3,0;77,0;;16,0;4,0;11,0;;;13,0;26,0;38,0;2,0;1,0;18,0;;32,0;5,0;220,0;21,0;7,0;79,0;23,0;25,0;7,0;13,0;106,0;6,0;6,0;4,0;43,0;5,0;11,0;10,0;7,0;;4,0;11,0;2,0;18,0;1,0;14,0;1,0;;14,0;28,0;3,0;4,0;3,0;243,0;8,0;9,0;5,0;;82,0;49,0;8,0;14,0;3,0;3,0;75,0;21,0;43,0;1,0;25,0;69,0;15,0;12,0;8,0;5,0;11,0;7,0;;5,0;44,0;10,0;93,0;21,0;1,0;57,0;46,0;;11,0;;6,0;;11,0;;1,0;5,0;48,0;9,0;7,0;4,0;8,0;1,0;26,0;1,0;17,0;20,0;3,0;;3,0;1,0;1,0;5,0;9,0;21,0;6,0;29,0;7,0;23,0;9,0;15,0;28,0;257,0;1,0;1,0;45,0;30,0;18,0;161,0;;3,0;4,0;1,0;6,0;109,0;3,0;8,0;10,0;5,0;33,0;3,0;6,0;168,0;15,0;43,0;2,0;;110,0;15,0;71,0;10,0;;11,0;6,0;5,0;;209,0;40,0;3,0;13,0;51,0;2,0;;;4,0;1,0;26,0;76,0;110,0;;3,0;;;17,0;1,0;7,0;;;1,0;120,0;14,0;1,0;10,0;65,0;9,0;;2,0;11,0;86,0;1,0;;;7,0;21,0;6,0;15,0;;13,0;57,0;4,0;4,0;2,0;19,0;;37,0;;;;;2,0;10,0;16,0;9,0;;;;;;2,0;;;6,0;2,0;6,0;;;6,0;;;5,0;1,0;;;3,0;105,0;16,0;16,0;;;;;;;;10,0;1,0;1,0;33,0;4,0;47,0;6,0;27,0;11,0;63,0;2,0;8,0;43,0;3,0;39,0;;11,0;46,0;42,0;;1,0;;;1078,0;3,0;13,0;;136,0;46,0;119,0;;18,0;19,0;8,0;70,0;16,0;9,0;4,0;5,0;3,0;18,0;18,0;22,0;18,0;26,0;27,0;;7,0;26,0;;5,0;5,0;4,0;;6,0;5,0;3,0;21,0;55,0;;4,0;1,0;3,0;;9,0;17,0;2,0;3,0;1,0;11,0;2,0;6,0;7,0;145,0;10,0;9,0;10,0;1,0;96,0;8,0;4,0;36,0;;18,0;;10,0;5,0;6,0;1,0;6,0;19,0;1,0;65,0;89,0;5,0;14,0;;97,0;8,0;5,0;5,0;16,0;;;43,0;6,0;4,0;1,0;2,0;;18,0;4,0;1,0;5,0;3,0;26,0;3,0;3,0;4,0;29,0;1,0;4,0;1,0;12,0;8,0;44,0;;18,0;8,0;31,0;;4,0;11,0;2,0;;;2,0;;13,0;17,0;12,0;3,0;;4,0;21,0;36,0;4,0;23,0;89,0;4,0;1,0;;;8,0;4,0;;;;;1,0;3,0;12,0;6,0;;4,0;6,0;8,0;2,0;;4,0;5,0;;;;3,0;;;1,0;6,0;12,0;;28,0;22,0;;;;14,0;1,0;2,0;;29,0;11,0;;5,0;39,0;3,0;27,0;4,0;;;4,0;7,0;6,0;14,0;7,0;8,0;;6,0;;;6,0;52,0;;8,0;5,0;15,0;1,0;16,0;;4,0
total;12,0;;;;21,0;12,0;15,0;14,0;;;13,0;;;21,0;;1,0;13,0;;;;;2,0;2,0;;;;;;4,0;10,0;10,0;5,0;2,0;;;24,0;12,0;9,0;17,0;;30,0;24,0;1,0;6,0;8,0;3,0;;26,0;3,0;6,0;12,0;2,0;3,0;;17,0;53,0;;;1,0;5,0;;3,0;10,0;;96,0;;20,0;8,0;1,0;;181,0;74,0;23,0;;13,0;2,0;1,0;3,0;1,0;2,0;26,0;;2,0;7,0;6,0;;;22,0;;;5,0;;;;1,0;;48,0;3,0;25,0;17,0;2,0;7,0;3,0;1,0;;3,0;;2,0;13,0;;2,0;4,0;4,0;1,0;1,0;1,0;;9,0;7,0;24,0;;;17,0;14,0;4,0;18,0;19,0;10,0;;14,0;39,0;;;17,0;;;9,0;10,0;11,0;2,0;;;;;4,0;2,0;12,0;9,0;;1,0;;7,0;;;;;;;4,0;;;11,0;12,0;2,0;;;5,0;;;2,0;2,0;4,0;;19,0;;8,0;;8,0;1,0;;5,0;;;1,0;;;3,0;;24,0;8,0;10,0;;;3,0;;;;1,0;2,0;;;3,0;;;20,0;4,0;2,0;1,0;1,0;;2,0;22,0;;;;;1,0;;;15,0;8,0;2,0;;3,0;;;25,0;;;;;;52,0;24,0;;;4,0;30,0;;24,0;3,0;;;;;13,0;;2,0;19,0;;;;;3,0;;3,0;2,0;35,0;;;6,0;;8,0;9,0;;;;;13,0;;;5,0;1,0;;;;;5,0;;2,0;;;5,0;;;;;4,0;2,0;;1,0;4,0;;;;;36,0;;;;;;;;;;;;5,0;13,0;;;;;;;;;3,0;;5,0;26,0;;;;;;;18,0;;;;;2,0;;;;;;;;;;;1,0;;1,0;;;2,0;;;3,0;;99,0;;;3,0;29,0;;;;;;;8,0;;;;;;;10,0;4,0;6,0;;;;4,0;;16,0;;2,0;;;1,0;2,0;9,0;;;6,0;;2,0;12,0;2,0;1,0;1,0;1,0;9,0;;;4,0;5,0;4,0;;4,0;;2,0;1,0;12,0;;6,0;14,0;;8,0;1,0;;;;;3,0;6,0;;;;7,0;;12,0;;;;;2,0;;;;11,0;;;;1,0;3,0;14,0;;;;;;71,0;2,0;;1,0;3,0;;10,0;;;;;23,0;11,0;8,0;3,0;;;;1,0;;;;;;2,0;2,0;;;2,0;;;;4,0;;;3,0;;;3,0;;;;;;;;;;;;;;;;;;2,0;10,0;;;;;;12,0;;;;;;1,0;;;6,0;;;;2,0;;;1,0;;;;;;1,0;12,0;;2,0;;;4,0;;1,0;;;;;;3,0;;;;1,0;;;;;;;;;;;3,0;;;;;1,0;;;;;;;;;;1,0;;;;;;;;;;;;8,0;;4,0;7,0;4,0;;;;14,0;;;;;;26,0;;4,0;;2,0;;2,0;;;;;;;;;;;;;9,0;;;;;;;;;;;3,0;;;;;;;;;2,0;;;;;;;;;;4,0;;1,0;;;;;;2,0;;;;;;;;;;4,0;6,0;;;1,0;4,0;;;5,0;;;;;1,0;;;;;;;;;;4,0;1,0;;;;;;;;3,0;;;;;;;;;1,0;;;;2,0;;;;1,0;;;;;;1,0;;;3,0;;;;;;9,0;;;;;;;;;;;2,0;;4,0;;;;;;;;2,0;;1,0;;;;4,0;;;;;;;;;2,0;;5,0;;;;;;1,0;;1,0;;;;1,0;6,0;;;;;;;;;;;4,0;;;;;;6,0;17,0;;9,0;8,0;2,0;;;;;;;;;1,0;;;;;;;;8,0;;;;;;;;;;;;;;;;;3,0;;;;;;;5,0;;;;;;;;;;2,0;;;;;;;1,0;4,0;;5,0;;;;13,0;;;2,0;;;;;;11,0;;;6,0;;;;;;;;;;;;;2,0;;;;;;;;1,0;;;;;;;;;;;;;;3,0;;;;;;;;;;;;;;;;;;;1,0;;1,0;;;;;;;2,0;;;;;;;;;;;;;;1,0;;;;;2,0;;;;;;;;;;8,0;;;;;;;;;;;;5,0;;;;;;;;;;;
trace;1,0;;;;1,0;3,0;3,0;5,0;;;;1,0;42,0;38,0;;;;;;;;1,0;2,0;;;;;5,0;;;5,0;3,0;1,0;;;6,0;3,0;;3,0;;15,0;8,0;;;13,0;3,0;1,0;6,0;;;1,0;;28,0;;3,0;3,0;26,0;;;16,0;33,0;;;;17,0;;13,0;;;1,0;;18,0;5,0;;;;;2,0;;1,0;20,0;;;2,0;8,0;;;1,0;;;7,0;4,0;2,0;;;;17,0;8,0;25,0;17,0;9,0;;;4,0;1,0;;;;;;;4,0;33,0;1,0;;1,0;;3,0;;6,0;2,0;;9,0;;1,0;;3,0;;2,0;;;;;1,0;;;3,0;3,0;;;;;;;;;15,0;4,0;;1,0;;1,0;;2,0;;;;;;;152,0;21,0;;;;;6,0;2,0;;;;;3,0;6,0;;11,0;;;;;;;;;;2,0;;;6,0;;;;2,0;;3,0;;10,0;;2,0;;;56,0;;1,0;;;30,0;8,0;4,0;15,0;;10,0;;;;6,0;4,0;2,0;;8,0;14,0;;;;4,0;;53,0;;;;;;;;;1,0;;;;;;6,0;;;;;;3,0;7,0;;;;;3,0;2,0;;35,0;15,0;;;4,0;;;1,0;2,0;;;;;;;3,0;;7,0;;;;3,0;;;;;;9,0;;;7,0;;14,0;;;;;2,0;;;;;;;;4,0;1,0;1,0;;;;;;1,0;;;;;;;1,0;;;;;13,0;;;;;;;2,0;3,0;;;;;;;;;;;3,0;10,0;;;;5,0;5,0;2,0;;1,0;;;;2,0;;;;;;;1,0;;;;;;;;;1,0;;;;2,0;;;;;3,0;1,0;8,0;5,0;;;;5,0;;;;;;2,0;;;;;;;2,0;;;21,0;2,0;;;;;;;;;12,0;;;;;;;;;;;6,0;;;;;4,0;;;1,0;;;;;;;6,0;;;2,0;2,0;;;;;;2,0;;;;;;;5,0;;;2,0;;;4,0;;;;;;;4,0;;;;;;2,0;2,0;;2,0;6,0;;;;;;;3,0;;2,0;;;;;;1,0;2,0;;;;;;;;;;23,0;;;;1,0;;;;;;;;3,0;;1,0;;;12,0;;;;;;;;;;;5,0;;;;;;;;1,0;;;;2,0;;24,0;;;;;;;;;;;;;;;;;;;;;;;;;;;;;;;;;3,0;2,0;;;;1,0;5,0;;;;1,0;;;;;;;;;;;;;;;;;;2,0;;;;;;;2,0;2,0;3,0;;;;;;;;2,0;;;;;1,0;;;;;;;;1,0;4,0;;;;;;;;;;;;;;;;;;;;;;;;;;;1,0;;;;;;;;;;;;;;8,0;;;;;;;;1,0;;;;;;;;;9,0;;;;;;;3,0;;;1,0;;;;;;;;;;;;;;;;;2,0;;;;;4,0;3,0;;;;;;;;;;;6,0;;;;;;;;;;;;;;;;;9,0;;;;;;;;;;;;;1,0;;;5,0;;;;;;;;;;;;;;;;;;;;;;;;;;;;;;;;;;;;4,0;;;3,0;;;;;;;;;;;;;;;;;;5,0;1,0;;;;1,0;;;;;;;;;;;;;;;;;1,0;;;3,0;;;;;4,0;;;;;;;;;;;;;;;;;;;;;;1,0;;;;;;;;;;;;;2,0;;;;2,0;;;1,0;;;;;;;;;;;;;;;;;;;;;;;;;;;;;;;;;;;;;;2,0;6,0;;;;;;;;;;;;;;10,0;;;;;;;;;;;;;;;;;;;;;;;;;;;;;;;;;;;;;;;;;;;4,0;;
unit;1,0;40,0;3,0;197,0;282,0;718,0;202,0;158,0;5,0;1,0;49,0;29,0;126,0;593,0;4,0;26,0;1007,0;131,0;24,0;34,0;38,0;10,0;247,0;111,0;628,0;60,0;57,0;70,0;80,0;176,0;2652,0;200,0;109,0;255,0;6,0;733,0;81,0;60,0;73,0;32,0;655,0;1200,0;19,0;191,0;1153,0;582,0;19,0;489,0;;27,0;51,0;;97,0;95,0;62,0;241,0;502,0;4,0;19,0;597,0;39,0;5,0;185,0;2,0;3762,0;13,0;2078,0;33,0;29,0;47,0;257,0;4902,0;1245,0;15,0;28,0;12,0;73,0;195,0;1,0;319,0;407,0;2,0;246,0;12,0;867,0;488,0;33,0;1270,0;8,0;83,0;85,0;26,0;39,0;58,0;215,0;36,0;1017,0;105,0;1256,0;179,0;885,0;164,0;5,0;160,0;1729,0;290,0;1,0;80,0;21,0;13,0;3,0;225,0;177,0;20,0;31,0;4,0;97,0;86,0;41,0;1125,0;10,0;6,0;1505,0;30,0;14,0;376,0;914,0;70,0;28,0;65,0;357,0;17,0;1,0;;9,0;;130,0;38,0;185,0;15,0;4,0;84,0;17,0;;172,0;152,0;238,0;551,0;70,0;65,0;36,0;64,0;628,0;88,0;83,0;113,0;12,0;4,0;2,0;;64,0;740,0;12,0;245,0;67,0;4,0;445,0;162,0;14,0;632,0;423,0;26,0;38,0;783,0;5,0;71,0;43,0;273,0;39,0;13,0;62,0;2,0;47,0;219,0;7,0;25,0;185,0;60,0;252,0;123,0;10,0;19,0;61,0;220,0;151,0;98,0;639,0;64,0;106,0;36,0;10,0;76,0;56,0;27,0;238,0;19,0;396,0;25,0;56,0;431,0;402,0;160,0;25,0;1,0;1,0;153,0;762,0;75,0;54,0;102,0;236,0;140,0;16,0;280,0;55,0;;506,0;15,0;39,0;36,0;34,0;51,0;147,0;71,0;86,0;97,0;100,0;21,0;12,0;45,0;16,0;34,0;49,0;21,0;23,0;195,0;53,0;86,0;538,0;19,0;15,0;10,0;3,0;96,0;301,0;355,0;318,0;709,0;41,0;167,0;259,0;365,0;40,0;247,0;35,0;5,0;161,0;13,0;9,0;62,0;16,0;132,0;243,0;105,0;49,0;20,0;76,0;299,0;73,0;6,0;39,0;106,0;491,0;199,0;;3,0;132,0;155,0;340,0;13,0;383,0;35,0;2,0;16,0;9,0;12,0;364,0;67,0;133,0;28,0;6,0;35,0;29,0;9,0;21,0;45,0;26,0;48,0;32,0;894,0;37,0;41,0;88,0;72,0;41,0;8,0;233,0;31,0;25,0;47,0;144,0;522,0;53,0;59,0;6,0;16,0;97,0;15,0;770,0;64,0;105,0;17,0;22,0;78,0;178,0;21,0;29,0;5,0;8,0;6,0;294,0;233,0;29,0;12,0;28,0;13,0;30,0;163,0;4,0;74,0;12,0;1,0;76,0;12,0;64,0;29,0;68,0;121,0;276,0;118,0;16,0;10,0;6,0;5,0;30,0;282,0;41,0;36,0;9,0;38,0;20,0;11,0;329,0;44,0;260,0;55,0;25,0;157,0;49,0;47,0;2913,0;94,0;17,0;8,0;10,0;635,0;190,0;63,0;18,0;22,0;17,0;178,0;62,0;306,0;9,0;115,0;12,0;113,0;103,0;3,0;144,0;366,0;57,0;66,0;8,0;57,0;2,0;61,0;85,0;126,0;22,0;534,0;1,0;122,0;570,0;118,0;26,0;4,0;40,0;5,0;1,0;33,0;21,0;170,0;18,0;847,0;180,0;88,0;7,0;6,0;387,0;;183,0;23,0;62,0;44,0;258,0;135,0;259,0;12,0;34,0;277,0;60,0;129,0;20,0;21,0;7,0;10,0;186,0;11,0;1,0;191,0;71,0;33,0;84,0;42,0;172,0;132,0;15,0;27,0;91,0;6,0;48,0;41,0;2,0;14,0;31,0;21,0;21,0;12,0;10,0;13,0;134,0;58,0;16,0;17,0;58,0;64,0;44,0;7,0;320,0;7,0;19,0;35,0;37,0;17,0;571,0;13,0;27,0;20,0;9,0;3,0;8,0;90,0;25,0;13,0;100,0;16,0;14,0;46,0;33,0;46,0;30,0;36,0;44,0;65,0;9,0;12,0;39,0;17,0;29,0;33,0;30,0;27,0;6,0;81,0;48,0;135,0;15,0;12,0;211,0;53,0;10,0;15,0;2,0;23,0;9,0;8,0;20,0;;41,0;89,0;6,0;214,0;139,0;9,0;35,0;4,0;13,0;36,0;2,0;6,0;38,0;150,0;46,0;16,0;;28,0;12,0;13,0;13,0;;88,0;7,0;49,0;78,0;2,0;18,0;9,0;;12,0;119,0;65,0;9,0;14,0;1,0;34,0;41,0;10,0;221,0;;52,0;15,0;61,0;49,0;26,0;;47,0;2,0;17,0;37,0;6,0;62,0;65,0;25,0;8,0;4,0;2,0;72,0;76,0;17,0;12,0;41,0;38,0;12,0;;4,0;15,0;20,0;5,0;175,0;5,0;;113,0;8,0;18,0;2,0;210,0;8,0;29,0;122,0;11,0;13,0;29,0;31,0;27,0;12,0;49,0;10,0;11,0;2,0;19,0;38,0;13,0;2,0;9,0;15,0;3,0;6,0;12,0;5,0;16,0;2,0;121,0;27,0;25,0;33,0;3,0;55,0;45,0;1,0;14,0;11,0;11,0;111,0;16,0;9,0;21,0;10,0;10,0;206,0;17,0;58,0;2,0;19,0;16,0;8,0;4,0;53,0;12,0;1,0;64,0;16,0;26,0;105,0;5,0;34,0;12,0;10,0;6,0;212,0;10,0;60,0;17,0;14,0;3,0;3,0;10,0;120,0;4,0;67,0;3,0;8,0;305,0;29,0;43,0;31,0;7,0;95,0;13,0;11,0;58,0;59,0;59,0;8,0;202,0;11,0;94,0;27,0;59,0;20,0;5,0;30,0;591,0;1105,0;;12,0;10,0;30,0;9,0;55,0;1,0;10,0;5,0;39,0;220,0;102,0;76,0;106,0;21,0;12,0;22,0;20,0;48,0;5,0;14,0;42,0;;13,0;9,0;3,0;49,0;36,0;15,0;149,0;4,0;18,0;27,0;43,0;7,0;26,0;10,0;6,0;16,0;;8,0;45,0;7,0;24,0;38,0;42,0;135,0;58,0;9,0;79,0;10,0;6,0;103,0;16,0;;33,0;6,0;2,0;9,0;17,0;15,0;9,0;3,0;;;26,0;10,0;64,0;10,0;1,0;2,0;5,0;1,0;164,0;12,0;13,0;2,0;3,0;4,0;34,0;19,0;100,0;57,0;36,0;53,0;23,0;35,0;26,0;19,0;40,0;3,0;395,0;37,0;13,0;14,0;6,0;10,0;75,0;95,0;34,0;4,0;28,0;3,0;20,0;72,0;24,0;33,0;3,0;6,0;37,0;21,0;56,0;99,0;28,0;9,0;1,0;16,0;10,0;56,0;134,0;12,0;61,0;13,0;55,0;35,0;53,0;58,0;11,0;9,0;4,0;32,0;9,0;5,0;3,0;1,0;135,0;27,0;8,0;7,0;1,0;50,0;;12,0;1,0;;8,0;15,0;11,0;13,0;40,0;7,0;22,0;8,0;7,0;11,0;18,0;76,0;13,0;8,0;19,0;7,0;7,0;27,0;28,0;81,0;22,0;34,0;41,0;65,0;58,0;4,0;21,0;12,0;23,0;3,0;15,0;31,0;6,0;10,0;4,0;10,0;9,0;;4,0;17,0;7,0;4,0;1,0;39,0;1,0;5,0;26,0;13,0;13,0;5,0;2,0;4,0;3,0;3,0;3,0;1,0;24,0;7,0;2,0;42,0;2,0;90,0;1,0;1,0;2,0;1,0;13,0;;33,0;56,0;19,0;1,0;14,0;3,0;2,0;9,0;19,0;27,0;44,0;6,0;5,0;;27,0;9,0;11,0;22,0;4,0;9,0;1,0;19,0;29,0;33,0;143,0;6,0;;1,0;5,0;32,0;;;1,0;61,0;7,0;38,0;14,0;8,0;17,0;11,0;5,0;8,0;2,0;33,0;3,0;3,0;;;;6,0;1,0;1,0;33,0;2,0;2,0;3,0;;;9,0;6,0;2,0;10,0;;5,0;22,0;9,0;1,0;;1,0;;14,0;4,0;;1,0;1,0;1,0;7,0;7,0;1,0;31,0;1,0;
vary;2,0;;1,0;7,0;16,0;11,0;8,0;6,0;;;;8,0;;19,0;;3,0;7,0;;;7,0;;10,0;8,0;;;;;;;8,0;15,0;6,0;;5,0;6,0;1,0;4,0;4,0;13,0;;4,0;27,0;1,0;3,0;2,0;3,0;;13,0;2,0;1,0;3,0;;1,0;;8,0;36,0;1,0;;12,0;13,0;2,0;;5,0;;62,0;1,0;7,0;21,0;;;31,0;35,0;36,0;12,0;14,0;1,0;;5,0;;;38,0;;2,0;4,0;5,0;3,0;;25,0;;1,0;8,0;3,0;5,0;;6,0;;22,0;5,0;24,0;5,0;27,0;12,0;;;1,0;6,0;1,0;;;3,0;;11,0;17,0;;;;12,0;20,0;2,0;14,0;6,0;;12,0;14,0;13,0;;31,0;5,0;;3,0;51,0;;;9,0;;;4,0;3,0;12,0;;;2,0;;3,0;;6,0;10,0;;13,0;;;1,0;6,0;;;3,0;3,0;;;;1,0;2,0;2,0;2,0;1,0;1,0;;2,0;5,0;1,0;1,0;;;25,0;;;2,0;3,0;;;1,0;;;6,0;;2,0;18,0;3,0;9,0;1,0;;;;1,0;;;;;22,0;;;8,0;2,0;;3,0;1,0;2,0;;5,0;1,0;3,0;1,0;;;;3,0;9,0;2,0;4,0;1,0;22,0;9,0;5,0;;4,0;;2,0;2,0;2,0;3,0;;2,0;8,0;8,0;2,0;;1,0;1,0;;4,0;;23,0;2,0;;;2,0;;3,0;3,0;;;;;6,0;;4,0;5,0;1,0;;;;;;;2,0;;;7,0;19,0;2,0;;;4,0;3,0;;;6,0;4,0;1,0;1,0;1,0;;8,0;;;;;1,0;5,0;;18,0;;;;8,0;;43,0;1,0;1,0;1,0;;4,0;;;;;;2,0;12,0;5,0;;;;;;;2,0;;3,0;5,0;;19,0;;1,0;;;;;7,0;;2,0;;;;;4,0;;;;;1,0;4,0;;;;1,0;;;;;;;;;;;;;9,0;;;;;3,0;;;1,0;;;;;;6,0;9,0;5,0;1,0;;1,0;;5,0;22,0;2,0;12,0;2,0;1,0;4,0;4,0;2,0;;;1,0;;1,0;26,0;;15,0;;3,0;;;2,0;9,0;;17,0;;4,0;;;8,0;;;8,0;1,0;5,0;2,0;13,0;;;2,0;;2,0;5,0;1,0;;;7,0;;3,0;;;;;12,0;;2,0;;;5,0;;;2,0;;3,0;;;;;;;1,0;;27,0;;4,0;;;;4,0;;;4,0;1,0;;3,0;;3,0;3,0;1,0;;;6,0;7,0;;2,0;22,0;;10,0;;;;1,0;;3,0;4,0;1,0;;4,0;;;;;;11,0;3,0;;;3,0;;;;4,0;1,0;1,0;5,0;;9,0;3,0;;;;;1,0;;;11,0;2,0;;1,0;;;;;1,0;;5,0;;;;;2,0;;1,0;;1,0;;;;1,0;;1,0;2,0;1,0;;3,0;;;;;;;1,0;;;;3,0;;;1,0;;2,0;;5,0;;;3,0;;;;;1,0;;;;;;6,0;4,0;;;;10,0;;11,0;;;2,0;1,0;;3,0;;;;2,0;1,0;;;;;;;;;;7,0;;;1,0;;8,0;1,0;;;;;;;;;;;;;9,0;6,0;;;;;;;;;1,0;;;;;;;5,0;;;;;;;;;;;;;;;8,0;;;;7,0;11,0;;;;;5,0;;;;;;2,0;;;;;;;;7,0;2,0;;;;6,0;;;;;1,0;1,0;;;9,0;;;1,0;3,0;;;;;;;2,0;1,0;;;;;10,0;;;;;;14,0;;;1,0;1,0;;;;;8,0;;;;;5,0;;;;;14,0;;;2,0;4,0;;;;;;;2,0;;1,0;;;;2,0;;;;;;5,0;;;;;;;;;;;;;1,0;;;;;;;;1,0;;;;;;6,0;6,0;;21,0;;;;;;;;;3,0;;;12,0;;;;5,0;;;1,0;;;;;;;;7,0;;;;;;;8,0;1,0;;;;;4,0;;;;;;;;8,0;;;;;1,0;;2,0;;;;;;;;3,0;;2,0;;1,0;;;;4,0;;;;;2,0;;;;;;;;1,0;;3,0;;9,0;;;;;;1,0;1,0;;;;;;;;;1,0;;;;;;1,0;20,0;;;14,0;;;;;;;;;;;;;;;;;;;;1,0;2,0;;1,0;;1,0;;4,0;;;;;1,0;;;;;;;;1,0;2,0;;;;;3,0;;;;;;;;;;;;3,0;;4,0;;;;;;;;;;;1,0;;;;;8,0;1,0;4,0;1,0;;;1,0;;;;;;;;;;;;;;;;
vehicular;2,0;;4,0;;1,0;;8,0;50,0;;;;;;;1,0;;16,0;;;;;;1,0;;8,0;1,0;;;;4,0;13,0;;;;1,0;35,0;;3,0;;;;17,0;;2,0;14,0;10,0;;12,0;;;;;3,0;;3,0;;5,0;;;;;1,0;;;17,0;;15,0;;;1,0;;48,0;2,0;;;;3,0;2,0;;2,0;34,0;;;;3,0;;;11,0;14,0;;;;;1,0;;;4,0;;9,0;5,0;;;;47,0;;2,0;;1,0;;;;11,0;;;;;4,0;;;8,0;;;7,0;2,0;;;241,0;;;5,0;16,0;;;;;;8,0;;;;;2,0;;;;1,0;;;15,0;6,0;;1,0;;;3,0;;;;;;2,0;;;;;;;;;;;;;;;;;;;;;56,0;;;6,0;;;;;20,0;;;;;5,0;;20,0;;;;;;;4,0;;;8,0;;1,0;10,0;;;;;;;;3,0;;;;3,0;1,0;;;;7,0;;;;;4,0;2,0;;13,0;;;;;;3,0;;;;8,0;;;3,0;2,0;;;;;;;;;4,0;;;6,0;;;135,0;;;;;;1,0;;6,0;4,0;;;;;1,0;;;;;;6,0;;;;;8,0;3,0;;;;;;;13,0;2,0;;;;;;;;;;;;31,0;;;;;;;;;;;;8,0;;;;;;;3,0;1,0;;;;;;1,0;;;;;;;;2,0;;;;;;;;;;;;;;;4,0;;2,0;;;;;;;;;2,0;;;;;;;;;;;16,0;;;;;1,0;;;;3,0;;;;;5,0;;;;;;;;;5,0;;;;6,0;;;;;;3,0;6,0;;;;;;;;;;;14,0;;;;;1,0;;1,0;;;;;;;2,0;;;6,0;;;;;3,0;1,0;;;;;;;;;;;;;;;;;1,0;;;;;;1,0;;1,0;;;;;;;;;;;;;;;;;;;;;;;1,0;;;;;2,0;;;;;211,0;;;;;;;;;6,0;;1,0;;2,0;6,0;5,0;;;;;;;;;4,0;;;;;;;;;;;3,0;;;2,0;;;;;;11,0;;;;;;;;;;;;;1,0;;;;;;;;;;40,0;4,0;;1,0;;3,0;;;;;6,0;3,0;;;;;;;;;;;;;;2,0;;;;;;;;;2,0;;;;;;4,0;;;;;;35,0;;;;;;;;;;;;;;;;;;;;;;;;;;;;;;;;;;;;;;;;;;;;;;;;;;3,0;;;;;;;;;2,0;;;;;;;;2,0;;1,0;;;;;;;;;;;;1,0;;;;;;;13,0;;;;2,0;2,0;;;;;4,0;;;;;;;;;;;;;1,0;;;;;;;;;;;;2,0;1,0;;;;;;;;;;;;;;;3,0;;;;;;;;1,0;;;;;2,0;;;;;;;2,0;;;;;;;;;;;;;;;;;;;;;;;;;;;;;1,0;1,0;;;;;;;;;;;;;;;;2,0;;;;;;;;;;;;;;12,0;;;;1,0;;;;;;;;;6,0;;;;3,0;;;;;;;;;;;;;5,0;1,0;;;;;;;;;;;;;;;;;;;;;;;1,0;;;;;;;;;;;;;;5,0;;;;;1,0;;;3,0;;1,0;1,0;;;2,0;;;;;;;;;;;;;;;;;;;4,0;;;;;;;;;;;;;;;;;;;;;;;;;;;;;;4,0;;;;;;;;;;;;;;;;;;;;;;;;;;;;;;
view;1,0;19,0;11,0;161,0;38,0;224,0;116,0;138,0;11,0;;;1,0;1,0;375,0;;9,0;692,0;5,0;8,0;23,0;16,0;4,0;77,0;5,0;24,0;19,0;4,0;46,0;48,0;90,0;508,0;67,0;28,0;11,0;1,0;399,0;250,0;278,0;82,0;4,0;463,0;750,0;;105,0;705,0;112,0;62,0;145,0;;11,0;41,0;11,0;59,0;43,0;5365,0;53,0;75,0;;5,0;345,0;4,0;;101,0;3,0;2325,0;9,0;472,0;27,0;13,0;17,0;38,0;464,0;297,0;;35,0;;3,0;29,0;23,0;23,0;619,0;1,0;135,0;42,0;185,0;9,0;2,0;315,0;14,0;36,0;74,0;137,0;22,0;18,0;27,0;;136,0;73,0;534,0;334,0;407,0;114,0;9,0;72,0;111,0;189,0;9,0;28,0;10,0;7,0;;83,0;361,0;22,0;;80,0;97,0;159,0;287,0;556,0;16,0;6,0;139,0;57,0;1,0;54,0;686,0;7,0;17,0;1,0;112,0;9,0;3,0;130,0;4,0;8,0;;246,0;85,0;1,0;;127,0;9,0;1,0;43,0;30,0;405,0;49,0;200,0;21,0;1,0;95,0;47,0;5,0;17,0;4,0;12,0;1,0;;10,0;8,0;36,0;66,0;10,0;;1,0;48,0;107,0;8,0;28,0;39,0;;45,0;467,0;6,0;20,0;3,0;8,0;32,0;2,0;4,0;140,0;24,0;131,0;;17,0;16,0;1,0;160,0;107,0;2,0;4,0;3,0;5,0;3,0;25,0;94,0;6,0;11,0;9,0;4,0;46,0;19,0;;31,0;18,0;70,0;1,0;120,0;110,0;54,0;40,0;15,0;2,0;1,0;36,0;91,0;19,0;11,0;87,0;34,0;11,0;43,0;4,0;26,0;;646,0;2,0;2,0;29,0;;10,0;101,0;46,0;177,0;2,0;54,0;6,0;1,0;78,0;1,0;8,0;5,0;2,0;2,0;159,0;19,0;43,0;229,0;2,0;13,0;1,0;6,0;15,0;16,0;5,0;46,0;202,0;72,0;5,0;16,0;51,0;20,0;696,0;12,0;1,0;5,0;2,0;4,0;83,0;80,0;15,0;7,0;11,0;1,0;2,0;44,0;708,0;5,0;15,0;27,0;3,0;162,0;11,0;3,0;;13,0;11,0;19,0;4,0;9,0;23,0;;3,0;37,0;14,0;161,0;81,0;1,0;;5,0;;5,0;7,0;;2,0;21,0;32,0;17,0;222,0;3,0;3,0;27,0;3,0;103,0;;47,0;;2,0;16,0;49,0;595,0;21,0;594,0;6,0;4,0;10,0;1,0;11,0;2,0;;2,0;;15,0;39,0;9,0;3,0;;8,0;6,0;38,0;18,0;12,0;;16,0;11,0;100,0;104,0;10,0;5,0;;1,0;7,0;;88,0;10,0;15,0;27,0;632,0;10,0;31,0;2,0;2,0;17,0;9,0;54,0;15,0;35,0;17,0;12,0;3,0;;70,0;61,0;95,0;33,0;4,0;22,0;36,0;8,0;186,0;50,0;;19,0;70,0;240,0;16,0;19,0;158,0;43,0;11,0;10,0;14,0;52,0;113,0;30,0;29,0;69,0;46,0;14,0;1,0;56,0;27,0;41,0;8,0;144,0;11,0;73,0;91,0;9,0;4,0;73,0;7,0;22,0;51,0;68,0;14,0;;1,0;12,0;;2,0;1,0;15,0;19,0;194,0;32,0;62,0;7,0;;24,0;3,0;30,0;6,0;30,0;8,0;38,0;58,0;77,0;5,0;4,0;14,0;21,0;38,0;23,0;57,0;1,0;4,0;342,0;;45,0;1,0;16,0;24,0;8,0;1,0;3,0;44,0;3,0;12,0;71,0;8,0;2,0;34,0;15,0;16,0;1,0;;3,0;;32,0;9,0;45,0;72,0;44,0;5,0;9,0;2,0;16,0;14,0;5,0;5,0;7,0;173,0;53,0;81,0;56,0;62,0;23,0;34,0;;11,0;9,0;55,0;6,0;17,0;135,0;38,0;5,0;4,0;80,0;86,0;1,0;9,0;16,0;91,0;53,0;12,0;;2,0;8,0;5,0;2,0;1,0;13,0;17,0;6,0;43,0;4,0;;21,0;1,0;2,0;17,0;16,0;;2,0;10,0;11,0;3,0;7,0;26,0;;7,0;106,0;6,0;3,0;31,0;6,0;45,0;1,0;8,0;13,0;48,0;5,0;34,0;2,0;2,0;12,0;44,0;153,0;3,0;6,0;84,0;29,0;19,0;14,0;16,0;;6,0;1,0;6,0;30,0;8,0;17,0;1,0;43,0;;11,0;13,0;3,0;4,0;2,0;2,0;72,0;18,0;2,0;5,0;7,0;3,0;;3,0;24,0;2,0;6,0;3,0;2,0;29,0;9,0;155,0;2,0;;1,0;2,0;7,0;4,0;5,0;22,0;97,0;1,0;;1,0;1,0;115,0;64,0;9,0;2,0;4,0;4,0;2,0;7,0;2,0;13,0;22,0;12,0;4,0;12,0;4,0;1,0;54,0;1,0;1,0;17,0;202,0;;4,0;24,0;;1,0;247,0;;1,0;7,0;39,0;;2,0;7,0;;14,0;8,0;15,0;25,0;1,0;30,0;17,0;59,0;8,0;4,0;1,0;16,0;;18,0;19,0;4,0;12,0;7,0;57,0;37,0;23,0;24,0;10,0;15,0;12,0;4,0;19,0;;14,0;2,0;2,0;7,0;65,0;8,0;5,0;;25,0;23,0;7,0;1,0;556,0;12,0;;7,0;1,0;5,0;;13,0;51,0;;5,0;2,0;2,0;6,0;1,0;3,0;10,0;6,0;8,0;6,0;1,0;2,0;;;13,0;3,0;10,0;17,0;7,0;135,0;16,0;10,0;84,0;1,0;1,0;7,0;8,0;60,0;;12,0;1,0;58,0;5,0;;1,0;5,0;4,0;43,0;8,0;15,0;4,0;4,0;15,0;2,0;3,0;3,0;100,0;7,0;6,0;7,0;34,0;4,0;27,0;1,0;4,0;;;13,0;16,0;20,0;5,0;;;;7,0;9,0;1,0;3,0;;;6,0;7,0;3,0;10,0;;1,0;;1,0;8,0;20,0;34,0;;154,0;1,0;32,0;1,0;3,0;4,0;;4,0;17,0;1,0;1,0;;1,0;9,0;14,0;;1,0;21,0;3,0;5,0;;;6,0;;;;6,0;2,0;1,0;3,0;3,0;;29,0;2,0;2,0;;3,0;7,0;24,0;30,0;5,0;44,0;11,0;;;2,0;22,0;1,0;1,0;;16,0;27,0;6,0;1,0;12,0;19,0;;7,0;;;21,0;5,0;13,0;;8,0;4,0;1,0;23,0;;;2,0;5,0;5,0;;3,0;;2,0;10,0;6,0;28,0;19,0;11,0;4,0;31,0;18,0;2,0;27,0;2,0;1,0;16,0;2,0;149,0;13,0;1,0;1,0;2,0;9,0;3,0;4,0;2,0;6,0;2,0;10,0;33,0;20,0;2,0;3,0;2,0;7,0;20,0;;3,0;1,0;13,0;3,0;12,0;7,0;8,0;14,0;3,0;18,0;7,0;14,0;;4,0;2,0;;7,0;27,0;;1,0;17,0;27,0;2,0;1,0;18,0;;1,0;9,0;3,0;7,0;10,0;22,0;;10,0;8,0;3,0;24,0;42,0;;;;;;;9,0;6,0;;1,0;;;;;38,0;2,0;;;;;4,0;;;2,0;;3,0;;;1,0;;7,0;;;5,0;;7,0;4,0;;3,0;2,0;7,0;2,0;;3,0;;;;1,0;7,0;24,0;16,0;16,0;93,0;6,0;;19,0;1,0;1,0;10,0;;2,0;3,0;18,0;;1,0;75,0;1,0;1,0;3,0;28,0;13,0;4,0;5,0;;2,0;12,0;;;;13,0;
virtual;6,0;;;19,0;;41,0;32,0;9,0;4,0;17,0;;1,0;;169,0;;1,0;89,0;;2,0;6,0;;4,0;5,0;;;;3,0;13,0;25,0;2,0;75,0;11,0;2,0;1,0;;78,0;72,0;5,0;56,0;1,0;128,0;210,0;;12,0;179,0;14,0;3,0;19,0;;;31,0;;21,0;;54,0;9,0;65,0;;10,0;156,0;;8,0;11,0;;590,0;15,0;102,0;16,0;;;12,0;15,0;21,0;;;2,0;;8,0;40,0;7,0;223,0;2,0;4,0;181,0;17,0;;;52,0;3,0;;29,0;6,0;17,0;;13,0;23,0;61,0;204,0;79,0;147,0;215,0;59,0;;6,0;22,0;45,0;10,0;17,0;16,0;2,0;;67,0;55,0;8,0;;;1,0;37,0;267,0;50,0;10,0;;6,0;10,0;;39,0;181,0;;30,0;;14,0;10,0;3,0;38,0;3,0;;246,0;;1,0;;;4,0;;;12,0;13,0;54,0;7,0;110,0;1,0;;3,0;3,0;;;;;;;;;21,0;21,0;4,0;;;1,0;2,0;14,0;72,0;1,0;;;88,0;;4,0;;;3,0;;;;;2,0;1,0;2,0;7,0;;41,0;7,0;10,0;11,0;;;;11,0;1,0;69,0;2,0;10,0;;2,0;5,0;;;9,0;;;4,0;18,0;18,0;45,0;;;;2,0;1,0;9,0;;34,0;17,0;3,0;6,0;;;;33,0;;;20,0;;;16,0;2,0;;6,0;1,0;;;62,0;;2,0;;;;30,0;;14,0;5,0;;;;;26,0;1,0;;25,0;72,0;9,0;;;12,0;;6,0;;;;;3,0;9,0;;1,0;;;;;2,0;126,0;;5,0;;;65,0;;5,0;;;3,0;;1,0;;6,0;;;12,0;;34,0;2,0;;1,0;;;3,0;;;;1,0;7,0;1,0;45,0;;3,0;;;13,0;;38,0;;;;4,0;226,0;;7,0;2,0;;;4,0;1,0;;1,0;;;;2,0;2,0;;;;;3,0;52,0;7,0;;1,0;;2,0;94,0;;;1,0;;2,0;;27,0;;1,0;;86,0;;20,0;;;6,0;;;;;;2,0;1,0;;42,0;61,0;4,0;13,0;;22,0;5,0;2,0;137,0;56,0;;1,0;11,0;17,0;20,0;16,0;1,0;6,0;;3,0;21,0;12,0;;14,0;;47,0;21,0;3,0;;49,0;4,0;;;104,0;39,0;14,0;30,0;;;29,0;;17,0;14,0;47,0;1,0;7,0;3,0;;2,0;2,0;1,0;;2,0;28,0;7,0;31,0;5,0;4,0;11,0;1,0;31,0;;;;6,0;10,0;;;;3,0;6,0;45,0;6,0;20,0;13,0;27,0;87,0;;10,0;;;1,0;;;;9,0;;;47,0;5,0;2,0;40,0;;;;2,0;2,0;;2,0;3,0;25,0;55,0;;1,0;;;;3,0;1,0;;;19,0;4,0;1,0;20,0;44,0;;53,0;10,0;;;17,0;1,0;;29,0;5,0;1,0;;8,0;44,0;;16,0;2,0;19,0;;2,0;1,0;3,0;5,0;1,0;6,0;;1,0;4,0;;;;;9,0;1,0;15,0;3,0;;;;;;7,0;;74,0;;1,0;10,0;;2,0;;22,0;7,0;2,0;;;1,0;1,0;;1,0;;;4,0;;1,0;;87,0;2,0;3,0;;;;;;;;;15,0;2,0;3,0;;2,0;3,0;;;27,0;;7,0;;;;;9,0;;;;7,0;2,0;;1,0;;2,0;9,0;;3,0;;2,0;;;14,0;;111,0;4,0;1,0;4,0;1,0;29,0;7,0;;8,0;;;;24,0;15,0;7,0;17,0;21,0;;5,0;;;;1,0;1,0;1,0;4,0;;2,0;7,0;;;1,0;;5,0;;16,0;;2,0;;;10,0;7,0;1,0;1,0;2,0;;;2,0;;;;;;;17,0;;14,0;7,0;27,0;;3,0;3,0;;14,0;1,0;;1,0;;20,0;;;;6,0;;;;;;;;25,0;;;3,0;;;;3,0;8,0;;;;2,0;;;1,0;;;;9,0;;;;;4,0;3,0;1,0;;;21,0;;4,0;5,0;21,0;;1,0;;5,0;;;;;;;;;3,0;2,0;5,0;;1,0;1,0;;;4,0;4,0;36,0;;;1,0;7,0;;1,0;2,0;11,0;1,0;;;;;2,0;;;1,0;;;1,0;3,0;;;1,0;1,0;2,0;2,0;;;;;;;1,0;;;;69,0;;;;8,0;;;;;;;13,0;;1,0;;;4,0;;;;3,0;;;;;;;;2,0;;;13,0;;52,0;;;3,0;29,0;;5,0;2,0;;3,0;5,0;;;3,0;;1,0;8,0;1,0;10,0;10,0;1,0;;;;;13,0;;;;4,0;4,0;1,0;;;;;;;;;;;;2,0;;15,0;12,0;;20,0;;;33,0;;;;;3,0;;;;3,0;;;;;2,0;1,0;;;;2,0;10,0;2,0;3,0;9,0;;;;2,0;;;;1,0;8,0;;;;2,0;2,0;15,0;;;;;;;2,0;;;4,0;2,0;1,0;;2,0;;4,0;5,0;;;;2,0;;;;;;;18,0;;1,0;10,0;;;;;;;;39,0;;;;;;;;;3,0;;;;;;;;3,0;;;2,0;3,0;;;;;;;12,0;;;;;;3,0;17,0;;;;;1,0;10,0;;10,0;2,0;;;3,0;3,0;;4,0;60,0;;;;1,0;;1,0;;;6,0;;;;1,0;;
zoom;1,0;;1,0;116,0;36,0;110,0;9,0;77,0;;;;;5,0;145,0;;2,0;63,0;;1,0;2,0;2,0;15,0;8,0;1,0;7,0;17,0;27,0;12,0;19,0;119,0;117,0;33,0;19,0;8,0;;34,0;28,0;18,0;;1,0;181,0;199,0;3,0;202,0;202,0;12,0;2,0;51,0;;;3,0;1,0;6,0;7,0;55,0;117,0;67,0;;1,0;27,0;;;261,0;;699,0;2,0;215,0;9,0;;1,0;115,0;1478,0;14,0;1,0;97,0;;10,0;;3,0;43,0;186,0;;32,0;3,0;75,0;84,0;5,0;333,0;1,0;49,0;17,0;;;1,0;20,0;;4,0;20,0;74,0;9,0;403,0;53,0;;12,0;28,0;38,0;2,0;6,0;1,0;;;9,0;9,0;;;;34,0;20,0;15,0;51,0;;;60,0;23,0;1,0;22,0;780,0;159,0;;11,0;55,0;11,0;;185,0;12,0;;85,0;1,0;;;;8,0;;;40,0;18,0;15,0;4,0;43,0;;;;10,0;;1,0;;;;;;2,0;3,0;;39,0;;6,0;9,0;1,0;9,0;15,0;9,0;;3,0;92,0;5,0;1,0;37,0;;26,0;;;2,0;;7,0;;2,0;4,0;;20,0;5,0;4,0;;;1,0;3,0;;4,0;;5,0;1,0;;5,0;180,0;;;22,0;1,0;;2,0;2,0;76,0;108,0;17,0;;;2,0;40,0;;;1,0;1,0;15,0;;;;;32,0;;2,0;5,0;1,0;;57,0;53,0;;4,0;;;;5,0;2,0;15,0;;;;34,0;1,0;;69,0;6,0;;;1,0;;;;40,0;52,0;;;3,0;33,0;9,0;1,0;;2,0;;1,0;2,0;1,0;;;12,0;;;;7,0;55,0;;1,0;1,0;22,0;37,0;17,0;;;;12,0;2,0;;1,0;3,0;;;;;83,0;5,0;;;;;;;;;;1,0;7,0;60,0;;;;;4,0;;2,0;;2,0;13,0;9,0;80,0;7,0;;;2,0;5,0;;40,0;;;;;;4,0;1,0;;;1,0;;12,0;20,0;10,0;;;;11,0;14,0;1,0;;;;11,0;3,0;9,0;;2,0;12,0;90,0;1,0;10,0;14,0;;1,0;10,0;60,0;;;;2,0;;;40,0;20,0;34,0;26,0;;22,0;5,0;1,0;376,0;8,0;;3,0;16,0;75,0;21,0;25,0;1,0;1,0;;10,0;;169,0;;74,0;1,0;2,0;17,0;79,0;;165,0;;214,0;26,0;42,0;1,0;16,0;8,0;41,0;1,0;25,0;1,0;7,0;249,0;6,0;;;5,0;;;69,0;;;5,0;40,0;17,0;38,0;2,0;1,0;1,0;;94,0;;97,0;;22,0;4,0;18,0;;26,0;2,0;73,0;100,0;2,0;16,0;1,0;;69,0;12,0;;;7,0;12,0;3,0;;;4,0;;2,0;15,0;3,0;;3,0;;2,0;;4,0;;;12,0;21,0;41,0;11,0;;;;;1,0;;;5,0;1,0;163,0;13,0;6,0;100,0;5,0;15,0;;;;;5,0;;;15,0;;2,0;3,0;2,0;5,0;;24,0;2,0;2,0;;;;1,0;;;1,0;1,0;2,0;2,0;;26,0;;;;;;2,0;2,0;;;;4,0;;;76,0;;;2,0;;4,0;4,0;10,0;7,0;3,0;8,0;1,0;9,0;;10,0;;;;;;;1,0;;13,0;12,0;1,0;;;;;1,0;5,0;;8,0;11,0;4,0;;;2,0;;;;;;4,0;;;;;;;1,0;1,0;1,0;;;1,0;1,0;6,0;2,0;;;;;;;2,0;;;2,0;;;19,0;;5,0;6,0;2,0;;;;4,0;;;;;2,0;;;13,0;3,0;;;18,0;3,0;1,0;;;;2,0;2,0;3,0;;7,0;;;;;;;1,0;;;;;;1,0;;;;;4,0;2,0;;19,0;1,0;8,0;;;13,0;;4,0;;;9,0;;;;;1,0;2,0;5,0;;;;3,0;;4,0;16,0;;;;;1,0;4,0;2,0;2,0;;;2,0;2,0;;;4,0;;5,0;4,0;2,0;;;;;5,0;12,0;9,0;1,0;;1,0;;114,0;;;;3,0;;;;;21,0;20,0;4,0;1,0;;3,0;14,0;3,0;;;2,0;1,0;;;;1,0;20,0;;;;19,0;;4,0;;;;;1,0;75,0;;;39,0;;;;;15,0;;;20,0;;5,0;;4,0;;;;;2,0;;;;5,0;;68,0;;;;1,0;;;;;;;14,0;;53,0;;;;;;;;;;;;;;;;;;10,0;;;;;;2,0;;1,0;;;;;;2,0;;;;2,0;;;;3,0;8,0;;2,0;;5,0;;;2,0;6,0;4,0;;10,0;;;6,0;;;6,0;1,0;5,0;;;;;2,0;5,0;1,0;;;;;;;1,0;;2,0;;21,0;;;;1,0;;;;2,0;51,0;2,0;1,0;;;4,0;;2,0;;1,0;;1,0;2,0;1,0;2,0;;5,0;;;;10,0;;;;1,0;;;;3,0;1,0;5,0;;;;;1,0;2,0;;;;;;;2,0;6,0;;6,0;;;;;;;;27,0;1,0;;;;1,0;;;;;;6,0;;1,0;;;6,0;1,0;18,0;;;13,0;;;3,0;;;4,0;3,0;3,0;;;1,0;1,0;;;;;;;;;;;;1,0;1,0;;;;;;;;2,0;;10,0;;;;3,0;;2,0;;9,0;;;;;;;2,0;;
aberration;;4,0;2,0;1,0;1,0;1,0;2,0;55,0;1,0;2,0;12,0;2,0;2,0;5,0;5,0;8,0;6,0;1,0;1,0;24,0;3,0;4,0;1,0;2,0;2,0;7,0;1,0;5,0;2,0;3,0;4,0;4,0;28,0;3,0;2,0;14,0;3,0;4,0;5,0;3,0;1,0;9,0;4,0;29,0;1,0;1,0;6,0;5,0;3,0;2,0;19,0;1,0;5,0;3,0;3,0;5,0;12,0;2,0;5,0;3,0;1,0;3,0;1,0;4,0;47,0;1,0;11,0;3,0;1,0;61,0;5,0;59,0;7,0;2,0;3,0;1,0;1,0;4,0;1,0;4,0;9,0;1,0;2,0;2,0;13,0;2,0;2,0;53,0;2,0;1,0;7,0;1,0;1,0;8,0;1,0;8,0;30,0;3,0;10,0;1,0;3,0;4,0;3,0;3,0;12,0;3,0;2,0;2,0;5,0;1,0;3,0;1,0;15,0;4,0;3,0;2,0;6,0;5,0;6,0;20,0;1,0;1,0;4,0;8,0;3,0;4,0;17,0;2,0;4,0;1,0;4,0;12,0;1,0;1,0;2,0;2,0;1,0;6,0;1,0;;;;;;;;;;;;;;;;;;;;;;;;;;;;;;;;;;;;;;;;;;;;;;;;;;;;;;;;;;;;;;;;;;;;;;;;;;;;;;;;;;;;;;;;;;;;;;;;;;;;;;;;;;;;;;;;;;;;;;;;;;;;;;;;;;;;;;;;;;;;;;;;;;;;;;;;;;;;;;;;;;;;;;;;;;;;;;;;;;;;;;;;;;;;;;;;;;;;;;;;;;;;;;;;;;;;;;;;;;;;;;;;;;;;;;;;;;;;;;;;;;;;;;;;;;;;;;;;;;;;;;;;;;;;;;;;;;;;;;;;;;;;;;;;;;;;;;;;;;;;;;;;;;;;;;;;;;;;;;;;;;;;;;;;;;;;;;;;;;;;;;;;;;;;;;;;;;;;;;;;;;;;;;;;;;;;;;;;;;;;;;;;;;;;;;;;;;;;;;;;;;;;;;;;;;;;;;;;;;;;;;;;;;;;;;;;;;;;;;;;;;;;;;;;;;;;;;;;;;;;;;;;;;;;;;;;;;;;;;;;;;;;;;;;;;;;;;;;;;;;;;;;;;;;;;;;;;;;;;;;;;;;;;;;;;;;;;;;;;;;;;;;;;;;;;;;;;;;;;;;;;;;;;;;;;;;;;;;;;;;;;;;;;;;;;;;;;;;;;;;;;;;;;;;;;;;;;;;;;;;;;;;;;;;;;;;;;;;;;;;;;;;;;;;;;;;;;;;;;;;;;;;;;;;;;;;;;;;;;;;;;;;;;;;;;;;;;;;;;;;;;;;;;;;;;;;;;;;;;;;;;;;;;;;;;;;;;;;;;;;;;;;;;;;;;;;;;;;;;;;;;;;;;;;;;;;;;;;;;;;;;;;;;;;;;;;;;;;;;;;;;;;;;;;;;;;;;;;;;;;;;;;;;;;;;;;;;;;;;;;;;;;;;;;;;;;;;;;;;;;;
absorb;;4,0;;;2,0;1,0;1,0;4,0;;;;;;1,0;;;;;;;;2,0;;;;;;3,0;;;15,0;;;;;;;;;;;8,0;;;;5,0;;13,0;;;;;;5,0;;;8,0;;;11,0;;;2,0;;2,0;;23,0;2,0;;1,0;;7,0;88,0;;;;8,0;;;;2,0;;;;6,0;15,0;;;;;;;1,0;;;;12,0;;31,0;4,0;4,0;;;;;;;;;;;;5,0;1,0;;;;;;4,0;;;9,0;;;1,0;4,0;;;2,0;;2,0;;15,0;;;1,0;;;;1,0;3,0;5,0;1,0;2,0;14,0;4,0;11,0;1,0;3,0;6,0;1,0;1,0;2,0;5,0;4,0;1,0;4,0;20,0;19,0;1,0;1,0;8,0;5,0;4,0;2,0;1,0;5,0;4,0;3,0;1,0;1,0;1,0;4,0;4,0;2,0;10,0;1,0;2,0;1,0;4,0;13,0;1,0;5,0;1,0;5,0;7,0;7,0;2,0;2,0;2,0;2,0;11,0;2,0;1,0;1,0;11,0;7,0;1,0;1,0;6,0;28,0;1,0;7,0;1,0;1,0;22,0;2,0;21,0;17,0;5,0;2,0;1,0;2,0;1,0;4,0;2,0;1,0;1,0;2,0;4,0;2,0;2,0;4,0;4,0;1,0;97,0;5,0;2,0;1,0;1,0;11,0;2,0;1,0;2,0;1,0;3,0;13,0;1,0;1,0;1,0;1,0;1,0;1,0;1,0;2,0;3,0;1,0;11,0;2,0;2,0;6,0;1,0;2,0;9,0;1,0;26,0;4,0;7,0;25,0;2,0;9,0;2,0;4,0;6,0;1,0;25,0;9,0;3,0;2,0;12,0;5,0;;;;;;;;;;;;;;;;;;;;;;;;;;;;;;;;;;;;;;;;;;;;;;;;;;;;;;;;;;;;;;;;;;;;;;;;;;;;;;;;;;;;;;;;;;;;;;;;;;;;;;;;;;;;;;;;;;;;;;;;;;;;;;;;;;;;;;;;;;;;;;;;;;;;;;;;;;;;;;;;;;;;;;;;;;;;;;;;;;;;;;;;;;;;;;;;;;;;;;;;;;;;;;;;;;;;;;;;;;;;;;;;;;;;;;;;;;;;;;;;;;;;;;;;;;;;;;;;;;;;;;;;;;;;;;;;;;;;;;;;;;;;;;;;;;;;;;;;;;;;;;;;;;;;;;;;;;;;;;;;;;;;;;;;;;;;;;;;;;;;;;;;;;;;;;;;;;;;;;;;;;;;;;;;;;;;;;;;;;;;;;;;;;;;;;;;;;;;;;;;;;;;;;;;;;;;;;;;;;;;;;;;;;;;;;;;;;;;;;;;;;;;;;;;;;;;;;;;;;;;;;;;;;;;;;;;;;;;;;;;;;;;;;;;;;;;;;;;;;;;;;;;;;;;;;;;;;;;;;;;;;;;;;;;;;;;;;;;;;;;;;;;;;;;;;;;;;;;;;;;;;;;;;;;;;;;;;;;;;;;;;;;;;;;;;;;;;;;;;;;;;;;;;;;;;;;;;;;;;;;;;;;;;;;;;;;;;;;;;;;;;;;;;;;;;;;;;;;;;;;;;;;;;;;;;;;;;;;;;;;;;;;;;;;;;;;;;;;;;;;;;;;;;;;;;;;;;;;;;;;;;;;;;;;
abut;;1,0;;;;5,0;;1,0;;;;;;5,0;;;;;2,0;;;;;;;;;14,0;;;28,0;;;;;;2,0;;;;;3,0;;;;2,0;;7,0;;;;;10,0;;;1,0;3,0;;;;4,0;;3,0;;5,0;;12,0;;;;;27,0;;;;;;;;;2,0;;;;4,0;;;10,0;;;;11,0;;;;;6,0;2,0;7,0;2,0;24,0;2,0;;;;;;;;;;;;;;;;;;11,0;;;;3,0;;;3,0;;;;;;;4,0;;;;;;1,0;;;;;3,0;;1,0;1,0;1,0;15,0;2,0;9,0;20,0;6,0;;;;;;;5,0;4,0;;;;;12,0;5,0;;;;;;12,0;;9,0;;;;;;;1,0;15,0;1,0;;1,0;;8,0;3,0;;;;;20,0;3,0;26,0;;5,0;;;2,0;;;;;45,0;;15,0;25,0;4,0;1,0;;7,0;;8,0;;3,0;;8,0;;;;;6,0;;37,0;;1,0;;7,0;;;;5,0;;;;;;;6,0;3,0;3,0;1,0;;;2,0;18,0;5,0;;;;4,0;3,0;2,0;10,0;98,0;;;;;;1,0;33,0;;;;;;;6,0;1,0;14,0;2,0;1,0;1,0;3,0;1,0;4,0;3,0;1,0;2,0;16,0;2,0;1,0;1,0;3,0;7,0;4,0;1,0;5,0;1,0;3,0;3,0;4,0;1,0;2,0;6,0;1,0;2,0;10,0;2,0;1,0;1,0;5,0;5,0;1,0;1,0;1,0;2,0;3,0;6,0;5,0;2,0;2,0;1,0;3,0;1,0;1,0;2,0;1,0;4,0;2,0;2,0;6,0;6,0;2,0;2,0;3,0;3,0;2,0;2,0;8,0;1,0;1,0;2,0;2,0;2,0;2,0;5,0;4,0;4,0;6,0;5,0;1,0;23,0;5,0;2,0;4,0;1,0;3,0;1,0;2,0;4,0;2,0;1,0;4,0;1,0;2,0;2,0;;;;;;;;;;;;;;;;;;;;;;;;;;;;;;;;;;;;;;;;;;;;;;;;;;;;;;;;;;;;;;;;;;;;;;;;;;;;;;;;;;;;;;;;;;;;;;;;;;;;;;;;;;;;;;;;;;;;;;;;;;;;;;;;;;;;;;;;;;;;;;;;;;;;;;;;;;;;;;;;;;;;;;;;;;;;;;;;;;;;;;;;;;;;;;;;;;;;;;;;;;;;;;;;;;;;;;;;;;;;;;;;;;;;;;;;;;;;;;;;;;;;;;;;;;;;;;;;;;;;;;;;;;;;;;;;;;;;;;;;;;;;;;;;;;;;;;;;;;;;;;;;;;;;;;;;;;;;;;;;;;;;;;;;;;;;;;;;;;;;;;;;;;;;;;;;;;;;;;;;;;;;;;;;;;;;;;;;;;;;;;;;;;;;;;;;;;;;;;;;;;;;;;;;;;;;;;;;;;;;;;;;;;;;;;;;;;;;;;;;;;;;;;;;;;;;;;;;;;;;;;;;;;;;;;;;;;;;;;;;;;;;;;;;;;;;;;;;;;;;;;;;;;;;;;;;;;;;;;;;;;;;;;;;;;;;;;;;;;;;;;;;;;;;;;;;;;;;;;;;;;;;;;;;;;;;;;;;;;;;;;;;;;;;;;;;;;;;;;;;;;;;;;;;;;;;;;;;;;;;;;;;;;;;;;;;;;;;;;;
accept;;1,0;;2,0;1,0;4,0;3,0;3,0;;6,0;;;;4,0;;;2,0;;2,0;1,0;;;;1,0;;;;;;;38,0;3,0;;;;46,0;9,0;1,0;5,0;;4,0;18,0;;2,0;7,0;;;1,0;;;;;;;;;;;;;;;;;18,0;;7,0;;5,0;;;27,0;9,0;2,0;;;;;;4,0;15,0;;1,0;1,0;3,0;1,0;;3,0;;2,0;4,0;;;;;;;2,0;11,0;;2,0;;;6,0;2,0;1,0;1,0;1,0;;;;6,0;1,0;;1,0;;;;2,0;3,0;;;;4,0;;;3,0;;;;7,0;;;39,0;;;;1,0;;;;;;;4,0;;;2,0;5,0;1,0;;1,0;;;;2,0;;;;;1,0;;3,0;;;;1,0;1,0;;;2,0;1,0;1,0;;;;;;1,0;;;;;;;;1,0;;10,0;4,0;;;;;2,0;3,0;14,0;;;;;;;;;;;;;16,0;;2,0;;;;2,0;2,0;;;;;;;;1,0;;2,0;;1,0;;;;;;;6,0;;;;;;;;;;6,0;1,0;1,0;;7,0;4,0;;;3,0;3,0;;;4,0;;;1,0;;2,0;;;;;;;;;;1,0;2,0;1,0;;2,0;;;10,0;1,0;2,0;;;;4,0;;1,0;;;;1,0;;;4,0;;;;;;1,0;;3,0;;1,0;;;1,0;;3,0;;;;;;;;1,0;;1,0;2,0;10,0;;1,0;;;;3,0;3,0;;;;;;2,0;;;;;;;;;;;;;;;1,0;;1,0;;;;;;;9,0;;;;;;;2,0;;;;;;;;;3,0;;;4,0;11,0;4,0;20,0;;;;;;1,0;;;3,0;3,0;6,0;;;1,0;;;;4,0;1,0;;39,0;;;;1,0;2,0;2,0;;;;;;2,0;26,0;1,0;;;;;;;;;;1,0;1,0;1,0;1,0;;;;6,0;;;;;1,0;1,0;;;;3,0;;;;1,0;;37,0;;;;1,0;;;1,0;;;;;;;;;;;;;;;;1,0;11,0;11,0;;;;;;1,0;;;2,0;;;2,0;;3,0;;;;;;;;;1,0;;1,0;;;3,0;;3,0;;;;;;3,0;1,0;2,0;4,0;4,0;1,0;7,0;2,0;2,0;1,0;2,0;2,0;3,0;1,0;6,0;1,0;1,0;1,0;1,0;1,0;1,0;1,0;18,0;1,0;2,0;1,0;1,0;6,0;4,0;1,0;1,0;1,0;1,0;1,0;6,0;1,0;1,0;1,0;2,0;5,0;2,0;1,0;1,0;1,0;4,0;4,0;1,0;1,0;1,0;2,0;4,0;2,0;4,0;1,0;2,0;3,0;2,0;4,0;1,0;;;;;;;;;;;;;;;;;;;;;;;;;;;;;;;;;;;;;;;;;;;;;;;;;;;;;;;;;;;;;;;;;;;;;;;;;;;;;;;;;;;;;;;;;;;;;;;;;;;;;;;;;;;;;;;;;;;;;;;;;;;;;;;;;;;;;;;;;;;;;;;;;;;;;;;;;;;;;;;;;;;;;;;;;;;;;;;;;;;;;;;;;;;;;;;;;;;;;;;;;;;;;;;;;;;;;;;;;;;;;;;;;;;;;;;;;;;;;;;;;;;;;;;;;;;;;;;;;;;;;;;;;;;;;;;;;;;;;;;;;;;;;;;;;;;;;;;;;;;;;;;;;;;;;;;;;;;;;;;;;;;;;;;;;;;;;;;;;;;;;;;;;;;;;;;;;;;;;;;;;;;;;;;;;;;;;;;;;;;;;;;;;;;;;;;;;;;;;;;;;;;;;;;;;;;;;;;;;;;;;;;;;;;;;;;;
accommodate;;3,0;;1,0;;3,0;2,0;29,0;;;;;65,0;19,0;;;;;4,0;;2,0;;;1,0;;;;35,0;;;111,0;;;3,0;;3,0;12,0;;1,0;;8,0;44,0;3,0;;7,0;55,0;;27,0;;;;;6,0;3,0;3,0;1,0;54,0;;;3,0;3,0;;;;45,0;;36,0;;;1,0;3,0;273,0;15,0;1,0;;;6,0;1,0;;;6,0;;;;146,0;15,0;;24,0;10,0;;;2,0;;2,0;4,0;;;2,0;30,0;;20,0;3,0;;5,0;2,0;4,0;;;;;;;1,0;;;;;8,0;;43,0;;;1,0;12,0;;;14,0;;;4,0;11,0;;;95,0;1,0;1,0;5,0;;;;;1,0;1,0;;9,0;;16,0;13,0;;1,0;;;38,0;9,0;7,0;1,0;1,0;;;;10,0;7,0;12,0;3,0;;;16,0;23,0;;;1,0;;;21,0;;3,0;1,0;;;;;1,0;;22,0;5,0;;15,0;5,0;57,0;24,0;;1,0;2,0;3,0;30,0;34,0;190,0;;42,0;7,0;;1,0;;;1,0;;37,0;4,0;12,0;30,0;5,0;13,0;;;6,0;12,0;;;;;1,0;;1,0;;6,0;;100,0;1,0;1,0;;6,0;;2,0;;6,0;;;1,0;;;1,0;6,0;4,0;;9,0;;4,0;14,0;26,0;4,0;9,0;;;7,0;22,0;4,0;74,0;55,0;;;;;4,0;1,0;17,0;;;;;6,0;;4,0;12,0;;;;10,0;5,0;;5,0;1,0;8,0;18,0;24,0;;1,0;39,0;14,0;30,0;1,0;15,0;4,0;2,0;6,0;4,0;;3,0;;13,0;2,0;1,0;5,0;5,0;;;86,0;;;2,0;10,0;;8,0;22,0;16,0;1,0;;15,0;;2,0;9,0;7,0;4,0;4,0;;;1,0;;;4,0;17,0;15,0;;4,0;37,0;;1,0;;;5,0;;7,0;1,0;;1,0;4,0;2,0;;88,0;;8,0;8,0;;;;1,0;9,0;;20,0;7,0;;;;;;;5,0;;;;;16,0;;;2,0;4,0;;;;;;14,0;;;;;;8,0;3,0;;;;;;1,0;;;;;;;1,0;;1,0;;;;;2,0;9,0;1,0;1,0;4,0;;1,0;;;3,0;4,0;;;;;;;;14,0;;;;9,0;;;;;7,0;;;;;;;12,0;;1,0;;2,0;;;4,0;;;;;2,0;43,0;7,0;;;;;;;;;;;;;;;;;;7,0;6,0;;;;;;27,0;;;4,0;1,0;5,0;;2,0;;;;;;;1,0;;1,0;2,0;;;;8,0;1,0;;;;;;;;;;1,0;2,0;;;2,0;4,0;;;6,0;12,0;1,0;3,0;;;;;23,0;;1,0;;2,0;18,0;1,0;;7,0;;1,0;;;;34,0;34,0;;;;;;;;6,0;4,0;;;;;;;;;;1,0;;;;;;;;;;;3,0;;;;;1,0;4,0;;1,0;;;;19,0;11,0;;;;;;3,0;1,0;1,0;;;;;1,0;;;;10,0;;12,0;;;;;;;;1,0;;3,0;;;;11,0;;;1,0;;;;;;;;;;1,0;;;;;;;;;;9,0;;;;;2,0;;;;;;;;1,0;;3,0;;;;;;;1,0;2,0;;;1,0;;4,0;;;;;7,0;;;;;;;;5,0;;;;;;;;;;;;17,0;;1,0;1,0;;1,0;;;8,0;14,0;1,0;;;;;;;;;1,0;;;3,0;;;;;;;;;4,0;1,0;;;;3,0;;;3,0;;;2,0;;18,0;7,0;;;;;;;1,0;;1,0;3,0;24,0;34,0;9,0;1,0;9,0;3,0;2,0;1,0;1,0;7,0;4,0;1,0;5,0;4,0;2,0;1,0;1,0;2,0;1,0;1,0;1,0;2,0;2,0;1,0;2,0;1,0;2,0;15,0;5,0;9,0;2,0;4,0;1,0;4,0;7,0;1,0;4,0;;;;;;;;;;;;;;;;;;;;;;;;;;;;;;;;;;;;;;;;;;;;;;;;;;;;;;;;;;;;;;;;;;;;;;;;;;;;;;;;;;;;;;;;;;;;;;;;;;;;;;;;;;;;;;;;;;;;;;;;;;;;;;;;;;;;;;;;;;;;;;;;;;;;;;;;;;;;;;;;;;;;;;;;;;;;;;;;;;;;;;;;;;;;;;;;;;;;;;;;;;;;;;;;;;;;
action;;4,0;;6,0;;19,0;;58,0;;;;1,0;;75,0;;;22,0;;;10,0;;1,0;1,0;;;;;2,0;21,0;2,0;37,0;8,0;3,0;;;42,0;26,0;;4,0;;63,0;82,0;;23,0;65,0;1,0;;60,0;;2,0;1,0;;1,0;4,0;72,0;1,0;2,0;;;15,0;;;6,0;;65,0;2,0;78,0;;2,0;1,0;1,0;2,0;;3,0;;;;;5,0;6,0;80,0;;8,0;6,0;3,0;1,0;;67,0;;2,0;7,0;7,0;;;1,0;;1,0;2,0;17,0;90,0;25,0;15,0;;14,0;18,0;49,0;9,0;10,0;;;;;4,0;;;;;12,0;1,0;8,0;6,0;;17,0;;;3,0;68,0;;1,0;;8,0;;;5,0;3,0;;17,0;6,0;1,0;;;;4,0;;;5,0;6,0;4,0;65,0;5,0;;;3,0;1,0;;;;;;;;8,0;18,0;;3,0;;3,0;3,0;;2,0;5,0;2,0;1,0;15,0;;2,0;;1,0;26,0;;;1,0;9,0;;;5,0;15,0;12,0;4,0;;;10,0;;;;2,0;2,0;;;;;;;;;9,0;6,0;;1,0;64,0;2,0;7,0;;;;;7,0;2,0;;;6,0;2,0;2,0;;3,0;;12,0;;8,0;1,0;1,0;;1,0;1,0;;4,0;2,0;;;1,0;;;4,0;1,0;;21,0;;2,0;2,0;;;;;4,0;;;14,0;8,0;5,0;;;3,0;;36,0;2,0;1,0;;2,0;6,0;;;;1,0;;;;2,0;3,0;;;;1,0;3,0;5,0;;;;4,0;1,0;;;6,0;;;;;;4,0;3,0;3,0;;;;;;1,0;3,0;2,0;;7,0;;;1,0;;1,0;;;1,0;2,0;4,0;13,0;62,0;1,0;1,0;;;;1,0;2,0;;;;;2,0;12,0;;1,0;;4,0;;5,0;2,0;1,0;;;;;9,0;;1,0;;;;;6,0;;3,0;;37,0;4,0;7,0;1,0;1,0;;;1,0;5,0;3,0;;;2,0;;2,0;;13,0;3,0;;2,0;;1,0;34,0;7,0;;;;38,0;5,0;;;14,0;;39,0;2,0;3,0;2,0;2,0;;18,0;1,0;2,0;;19,0;;;;14,0;9,0;13,0;7,0;2,0;;3,0;8,0;8,0;20,0;2,0;;;;2,0;;;;;14,0;29,0;5,0;40,0;53,0;;4,0;1,0;6,0;2,0;;3,0;2,0;;6,0;11,0;;6,0;1,0;;;6,0;;1,0;88,0;1,0;;;6,0;2,0;;;;2,0;;1,0;39,0;5,0;;;;;;14,0;4,0;4,0;14,0;;23,0;38,0;;;1,0;;;;;;1,0;4,0;1,0;;120,0;;19,0;;;;;;;;4,0;;;;1,0;2,0;;4,0;;;;8,0;;;;;8,0;;4,0;;;4,0;;;1,0;2,0;;;;12,0;;;;;;10,0;;;;;;3,0;;2,0;1,0;1,0;2,0;4,0;;1,0;;17,0;;5,0;;3,0;;1,0;31,0;7,0;;2,0;;;;3,0;;;10,0;;3,0;;;1,0;2,0;;;;;;;;;;;;;;;1,0;7,0;4,0;;;1,0;;;;2,0;;;1,0;1,0;1,0;;1,0;;5,0;;;1,0;;;5,0;;;;;;;6,0;4,0;;;11,0;2,0;1,0;14,0;;;;;3,0;1,0;5,0;;;2,0;;;;2,0;;;1,0;1,0;;12,0;;;;;;;;;;;;;13,0;;;;;4,0;;6,0;;;;2,0;;;1,0;;;;1,0;;;;7,0;;;;;1,0;;32,0;5,0;;;;;;;3,0;;;;4,0;5,0;;;;;1,0;1,0;1,0;2,0;;;17,0;;;;;;;;;;;1,0;;;10,0;1,0;2,0;;;;2,0;3,0;;;1,0;10,0;;;;;;;;1,0;;;;10,0;1,0;;;;;;;;;;;;;2,0;1,0;23,0;;;;;;;;;;4,0;;;2,0;;;;1,0;;;;;1,0;;;;;;;;1,0;;;;;;;;;;;;25,0;;;;;;;;;;;3,0;;;;;;;;;;;;;;;;;4,0;;;;;;;;;2,0;3,0;;;;;;;;14,0;1,0;;2,0;1,0;;1,0;;;;2,0;;1,0;;;;;;;;3,0;;1,0;;;;;5,0;;;;1,0;3,0;1,0;3,0;1,0;3,0;1,0;9,0;2,0;3,0;3,0;1,0;2,0;1,0;2,0;2,0;2,0;3,0;7,0;3,0;2,0;3,0;8,0;22,0;;;;;;;;;;;;;;;;;;;;;;;;;;;;;;;;;;;;;;;;;;;;;;;;;;;;;;;;;;;;;;;;;;;;;;;;;;;;;;;;;;;;;;;;;;;;;;;
activate;;3,0;;6,0;7,0;20,0;8,0;23,0;;;1,0;;;68,0;;5,0;94,0;;4,0;7,0;;;11,0;2,0;10,0;1,0;1,0;11,0;8,0;7,0;106,0;51,0;;6,0;;20,0;8,0;;9,0;;45,0;210,0;;21,0;59,0;4,0;;22,0;;;3,0;;4,0;11,0;16,0;;2,0;;2,0;42,0;;5,0;8,0;;129,0;8,0;63,0;6,0;11,0;;;106,0;202,0;;;;;1,0;;6,0;125,0;;134,0;2,0;41,0;3,0;4,0;6,0;;5,0;5,0;;;;1,0;;23,0;;41,0;12,0;29,0;12,0;;12,0;22,0;97,0;3,0;6,0;;;;6,0;6,0;10,0;;3,0;5,0;1,0;9,0;157,0;3,0;;145,0;1,0;;2,0;117,0;;2,0;;52,0;3,0;;71,0;;;16,0;;7,0;;;1,0;;;2,0;1,0;13,0;;34,0;;;5,0;7,0;;;3,0;;;;;;7,0;1,0;;;1,0;20,0;2,0;5,0;21,0;6,0;;1,0;6,0;;3,0;;43,0;2,0;;;;7,0;8,0;;1,0;11,0;3,0;5,0;8,0;;2,0;22,0;;;1,0;5,0;;;;;13,0;;2,0;4,0;12,0;1,0;;4,0;9,0;21,0;2,0;;;;;15,0;4,0;;3,0;10,0;12,0;1,0;;3,0;;21,0;2,0;3,0;15,0;;;8,0;1,0;9,0;2,0;;3,0;;;2,0;;2,0;;;13,0;;;9,0;;;;;2,0;1,0;10,0;3,0;3,0;;;;3,0;;70,0;;10,0;1,0;;;3,0;4,0;3,0;29,0;7,0;;;2,0;4,0;;1,0;;;;;;;;2,0;16,0;;2,0;;;;;;7,0;8,0;;4,0;;;;10,0;;1,0;1,0;7,0;;18,0;;;3,0;;2,0;;11,0;4,0;1,0;31,0;38,0;27,0;4,0;;9,0;;;;28,0;;;;;;13,0;;5,0;;;;17,0;15,0;;1,0;;1,0;;;;;1,0;;1,0;;1,0;;35,0;;51,0;12,0;;;4,0;6,0;38,0;3,0;;1,0;;18,0;;3,0;3,0;;8,0;;;19,0;1,0;2,0;126,0;4,0;;;;33,0;25,0;3,0;;20,0;1,0;7,0;;16,0;;60,0;;19,0;15,0;;;49,0;;4,0;;9,0;;6,0;22,0;14,0;;2,0;;20,0;16,0;10,0;;;5,0;3,0;;5,0;6,0;1,0;6,0;41,0;8,0;106,0;12,0;;11,0;;7,0;1,0;3,0;;8,0;3,0;80,0;1,0;11,0;18,0;21,0;2,0;;2,0;1,0;;61,0;1,0;;12,0;;3,0;;6,0;;10,0;;;10,0;;4,0;3,0;;;1,0;4,0;5,0;;2,0;34,0;49,0;22,0;1,0;;2,0;4,0;11,0;5,0;1,0;;11,0;;6,0;;17,0;4,0;13,0;;;2,0;;2,0;1,0;;10,0;14,0;7,0;1,0;;;1,0;43,0;3,0;;;3,0;1,0;;1,0;;17,0;;1,0;19,0;6,0;3,0;;;4,0;4,0;;;1,0;;3,0;3,0;8,0;;;14,0;3,0;2,0;2,0;;9,0;1,0;3,0;1,0;;1,0;;6,0;2,0;1,0;;;2,0;13,0;1,0;2,0;1,0;;9,0;4,0;;;;;;21,0;;;2,0;;26,0;8,0;13,0;;;;;4,0;4,0;;;3,0;;;;4,0;4,0;;1,0;1,0;;4,0;1,0;;1,0;;2,0;;11,0;;;3,0;;;;2,0;;7,0;;;;3,0;8,0;1,0;;6,0;;;1,0;;;11,0;;2,0;3,0;6,0;4,0;2,0;;;;;;1,0;1,0;;;4,0;;;;;;;2,0;5,0;2,0;1,0;5,0;5,0;1,0;;5,0;;;;1,0;;;1,0;1,0;3,0;1,0;;;11,0;;;39,0;;;4,0;;8,0;128,0;1,0;2,0;2,0;;55,0;;;12,0;;12,0;;;20,0;1,0;17,0;2,0;;;4,0;;;8,0;;;3,0;;2,0;;;4,0;;;3,0;3,0;1,0;;1,0;;;;;;;1,0;30,0;4,0;1,0;;4,0;;;;2,0;;;;;22,0;;1,0;1,0;;14,0;;;;5,0;;;7,0;;;;1,0;;2,0;1,0;3,0;;;;1,0;;;;;6,0;2,0;;;;;;;;;;1,0;;6,0;1,0;4,0;3,0;;;;;;;;;3,0;;5,0;;1,0;;;;;;;;;;;;;;;;;7,0;;;;;1,0;;;;;;;;;;;;;1,0;5,0;2,0;;;;;;;;2,0;2,0;;1,0;;;2,0;4,0;;1,0;;;;;1,0;;2,0;;;;;;;;3,0;3,0;;3,0;1,0;;10,0;;;;;;;1,0;;;;5,0;4,0;9,0;3,0;;2,0;;;;2,0;4,0;;;3,0;;2,0;;;;;;;;3,0;;2,0;6,0;2,0;;;8,0;;8,0;1,0;1,0;3,0;9,0;3,0;4,0;1,0;8,0;4,0;1,0;3,0;4,0;1,0;1,0;20,0;7,0;5,0;3,0;2,0;6,0;1,0;;;;;;;;;;;;;;;;;;;;;;;;;;;;;;;;;;;;;;;;;;;;;;;;;;;;;;;;;;;;;;;;;;;;;;;;;;
activation;;1,0;;;2,0;6,0;1,0;;;;;;;27,0;;1,0;40,0;;1,0;;;;;;3,0;;;4,0;;3,0;47,0;31,0;1,0;11,0;;3,0;1,0;;;;10,0;73,0;;6,0;19,0;;;4,0;;;;;;5,0;4,0;;1,0;;;27,0;;;;;37,0;;19,0;;1,0;;7,0;18,0;32,0;;;;;;;11,0;31,0;;24,0;;1,0;;1,0;;;;3,0;;1,0;1,0;1,0;4,0;3,0;;10,0;11,0;11,0;2,0;;1,0;;13,0;1,0;;;;;;1,0;4,0;;;;5,0;;10,0;3,0;;135,0;;;3,0;40,0;;;;70,0;;;30,0;;;9,0;;10,0;;;;;;;3,0;3,0;2,0;12,0;4,0;;4,0;1,0;;2,0;;;;;;;2,0;;;;;11,0;1,0;;;1,0;;2,0;;;;;2,0;9,0;;;;;;;;;;1,0;3,0;;;1,0;1,0;;;3,0;;;;;;;;;1,0;1,0;;;1,0;2,0;5,0;5,0;;;;1,0;;;;9,0;5,0;;;;;5,0;;2,0;2,0;;;;;;2,0;;;;;;;;;;15,0;;;;1,0;;;;;;2,0;;2,0;;;;38,0;;17,0;1,0;7,0;;;;;1,0;;;2,0;;;;;;;;2,0;;4,0;;;;5,0;6,0;;;;;;;;;2,0;;;;;1,0;2,0;;;;;;1,0;;;;;;;;;2,0;7,0;2,0;8,0;;;;;3,0;;19,0;;;;;;29,0;;1,0;4,0;2,0;;;;;;;1,0;;;;;;;;;;;1,0;;19,0;8,0;1,0;3,0;4,0;;;;1,0;;;4,0;;;25,0;;4,0;;;17,0;;1,0;82,0;1,0;;;;47,0;2,0;;;10,0;;;;2,0;5,0;26,0;;1,0;6,0;;;6,0;;1,0;;5,0;;7,0;2,0;8,0;;1,0;;3,0;30,0;6,0;;;;;;1,0;;8,0;;40,0;10,0;108,0;14,0;;;8,0;2,0;1,0;;;1,0;1,0;28,0;;1,0;1,0;;;6,0;4,0;;;76,0;;;2,0;38,0;;;;15,0;2,0;;;13,0;2,0;2,0;;;;;;;;4,0;1,0;34,0;5,0;;;2,0;2,0;;;;;;;7,0;;6,0;1,0;;;2,0;3,0;;;;;2,0;;;;;;;3,0;;;;1,0;;;1,0;;9,0;;;;1,0;;;;;;;;6,0;;;;;;;2,0;;;;;2,0;2,0;;;;;;2,0;;;;;;1,0;;;;;24,0;;;;;;;6,0;;15,0;;;;3,0;;;;;7,0;;;;4,0;;;;;2,0;;2,0;;;;;11,0;;;;5,0;;9,0;;;;5,0;2,0;;2,0;;1,0;;;;12,0;;;;;;;;;;;;;7,0;9,0;4,0;;;;;;;;;1,0;;3,0;;;;;;;;;;;2,0;;;;;;;;;;;;;;;;;18,0;5,0;1,0;31,0;;;;;1,0;30,0;1,0;;2,0;;5,0;;;;;1,0;;5,0;5,0;;12,0;;;;2,0;;;;;;6,0;;;;;;;;;;;;;;;;;;14,0;;2,0;;;;1,0;;;;1,0;;;2,0;;;;1,0;2,0;;1,0;;;;;;;10,0;;;;;;;;;;;;;;;;;;;;;;;;;;;;;;1,0;;;1,0;;;;;;;;;;2,0;;;;1,0;;;;2,0;12,0;;2,0;;;;;;;2,0;;3,0;;;;;;;;;;1,0;;;;4,0;;;;;;;;;;;;;;6,0;;;;;;4,0;;;2,0;;;;;;;;;;;;;;;;;;1,0;;;;;;;;;;;2,0;;;1,0;3,0;1,0;1,0;;;;;;;2,0;;;;;;;;;;;;;30,0;5,0;;;;;;;;;1,0;;;;4,0;2,0;;;1,0;;;;;;1,0;;1,0;;;;1,0;1,0;1,0;1,0;;;;;;;;;;;;;;;;;;;;;;;;;;;;;;;;;;;;;;;;;;;;;;;;;;;;;;;;;;;;;;;;;;;;;;;
actuate;;1,0;;7,0;1,0;11,0;7,0;4,0;;;;;1,0;19,0;;;24,0;;5,0;2,0;;;3,0;;;2,0;3,0;16,0;2,0;1,0;10,0;24,0;;5,0;;1,0;1,0;;;;13,0;33,0;;2,0;7,0;6,0;;34,0;;;;;1,0;;1,0;;5,0;;;5,0;;;4,0;;33,0;;36,0;;;;;62,0;47,0;;;;;;;7,0;34,0;;2,0;;17,0;6,0;;17,0;1,0;1,0;;3,0;;;1,0;;1,0;5,0;10,0;23,0;20,0;3,0;;;1,0;12,0;2,0;1,0;;;;;;;;;;7,0;;12,0;1,0;;30,0;;;;21,0;;;;6,0;;;52,0;;;4,0;;;;;;;;;;;2,0;;;;;;;;;;;;;;2,0;;;;;7,0;4,0;;5,0;;;1,0;13,0;;;;;;;;;;5,0;;;;12,0;2,0;4,0;3,0;;;5,0;;2,0;5,0;;;;;;;2,0;;;17,0;;1,0;15,0;22,0;4,0;1,0;;;;1,0;1,0;;1,0;3,0;;;;1,0;;18,0;;;1,0;1,0;;2,0;;14,0;;;;;;;1,0;2,0;;1,0;3,0;;7,0;1,0;7,0;1,0;;;3,0;;3,0;10,0;16,0;;;;3,0;;10,0;;;;;1,0;3,0;;1,0;26,0;8,0;;;5,0;;;;1,0;4,0;7,0;;;2,0;6,0;;6,0;;16,0;6,0;;1,0;;1,0;;5,0;;2,0;1,0;;;5,0;;2,0;;1,0;;7,0;;;;5,0;;19,0;2,0;4,0;;12,0;3,0;17,0;;;;;;;14,0;5,0;3,0;1,0;;1,0;;;7,0;;;;;;5,0;2,0;2,0;;;1,0;;6,0;;;;;;4,0;3,0;1,0;3,0;;;;;;;3,0;;;;;;4,0;;1,0;2,0;;;15,0;;;13,0;;1,0;;;1,0;;;;;;5,0;;16,0;;6,0;;3,0;;;;11,0;2,0;;6,0;;1,0;1,0;2,0;30,0;;13,0;;1,0;9,0;;1,0;;;;;;;1,0;;;2,0;6,0;3,0;;10,0;;;;;1,0;;;17,0;;;5,0;;3,0;;;;2,0;23,0;;;;;4,0;;1,0;;16,0;2,0;;;;2,0;1,0;2,0;;;;;;;1,0;1,0;9,0;1,0;2,0;;;;;8,0;1,0;;1,0;3,0;;9,0;1,0;2,0;4,0;;;;;;;1,0;;1,0;1,0;;;1,0;8,0;;;;;;;1,0;;2,0;;1,0;;;;;;;;3,0;;;;;5,0;3,0;;;2,0;3,0;;;;;;;;;;;1,0;;2,0;;;;1,0;;2,0;;1,0;;3,0;;;;;;;;;;;1,0;;2,0;;;;;;6,0;;;;;;4,0;;;;;;;;;;5,0;;;;;2,0;1,0;;;;;;;2,0;;;4,0;;;;;;;;;;;;;;2,0;;;1,0;;;1,0;;;;;;1,0;;;;;;4,0;;;;;;;;;1,0;;;;;;;;;;;;;;;;;;;;;;;37,0;;;;;;;;;;;;;1,0;;4,0;;;;2,0;;;;;3,0;4,0;;;;;;;;8,0;1,0;;;;;;;1,0;;;;;;;2,0;;;1,0;;;;;;1,0;;;;;;;3,0;;;;1,0;;1,0;;;1,0;;;;12,0;3,0;;;2,0;;;;;;1,0;;;7,0;3,0;;;;;;;;;;;;;;1,0;;;;;;;;7,0;;;5,0;;;;;;;;;;;;;;;;;;;;;;;;;;;;;;;;;;;;;;;;;;;;;;;;;1,0;;;;;;;;;;;;;;;;1,0;;;;;;;;;;2,0;;;;;;;;;;;;;;;;;;;;;;;;;;;;;;;;;;;;;2,0;;;2,0;;;;1,0;;;;;;;;;;4,0;2,0;;;;;3,0;3,0;;;;;;;;;1,0;1,0;1,0;1,0;5,0;;;;;;;;;;;;;;;;;;;;;;;;;;;;;;;;;;;;;;;;;;;;;;;;;;;;;;;;;;;;;;;;
actuation;;3,0;1,0;;;9,0;;34,0;;;5,0;;;7,0;;;5,0;;;;;;;;1,0;;;12,0;3,0;;27,0;13,0;;;;4,0;;1,0;;;2,0;53,0;;1,0;1,0;1,0;;31,0;;;;;;6,0;;2,0;;;;7,0;;;3,0;;23,0;;16,0;;;17,0;;28,0;3,0;;;;;;;;19,0;;7,0;;24,0;7,0;;15,0;;1,0;;;;;;;;2,0;9,0;3,0;8,0;11,0;;1,0;1,0;3,0;;2,0;;;1,0;;12,0;;;;;;;9,0;3,0;;10,0;1,0;;;14,0;;;;6,0;;;13,0;1,0;;2,0;;2,0;;;;;;1,0;1,0;;2,0;10,0;;;;1,0;;;;;;;;;5,0;;;;;6,0;2,0;;;;;1,0;9,0;;;1,0;;;;;;;;1,0;;12,0;3,0;1,0;1,0;;;;6,0;;;9,0;;;;;;1,0;;2,0;1,0;8,0;;;6,0;4,0;12,0;;;;2,0;;2,0;;1,0;3,0;4,0;6,0;;;;1,0;;;;;;;;;;;;;;;;1,0;;;2,0;1,0;;;2,0;;;;3,0;;;7,0;;3,0;;;;1,0;2,0;4,0;;;;;3,0;;;8,0;1,0;;;4,0;1,0;;25,0;;3,0;12,0;;;2,0;2,0;;1,0;;1,0;3,0;;;;;7,0;1,0;;;;;;;;;2,0;;;;;1,0;1,0;2,0;;;;2,0;;22,0;;4,0;2,0;;1,0;;;;9,0;;;;;;;;5,0;;;;1,0;;;;;;;;;;;;;;;;;;8,0;4,0;;;;;2,0;;;;;;;;;;6,0;1,0;;2,0;;;44,0;;;;;18,0;;;;1,0;;1,0;;3,0;;;;15,0;1,0;;;14,0;;;2,0;1,0;;;1,0;5,0;2,0;9,0;;5,0;2,0;;;;;;;;;;;11,0;;10,0;12,0;1,0;3,0;;5,0;;;;;2,0;3,0;;;;5,0;5,0;;;;;17,0;;;4,0;4,0;;;;;;3,0;;;;;2,0;;;;;;;;;7,0;2,0;1,0;;;;;;4,0;;;;;;;1,0;1,0;;;3,0;;;;;;1,0;;;;;;3,0;;;;;;1,0;;;4,0;;;;;1,0;;;2,0;;;;;;5,0;;8,0;;3,0;;;1,0;;;;;;;;;;2,0;;1,0;;16,0;;;;;;;1,0;4,0;;4,0;;;;;1,0;;;;;;;;;2,0;;;;;;2,0;;;;;;2,0;;;;;;;1,0;;;;;;;;;;;;;;;;4,0;;;;;;;;4,0;;1,0;3,0;;;4,0;;;;;;;;;;;;1,0;;;;;;;;;;;2,0;;;;;;4,0;;;;;;;;1,0;;;;;;;4,0;;;;;;2,0;;;;;3,0;;6,0;;;;;;;;5,0;;;;;;;;;;;;;;;;;;8,0;1,0;;1,0;;;;;;;;1,0;;;;;;;;;;1,0;;;;;;;;;;1,0;;;;2,0;;;;;;;;;3,0;;1,0;;;;;;;;;;;;5,0;;;2,0;;;;;;;3,0;;;;;;;;;;;;;;;;;;;;;;;;;;;;;;;;;;;;;;;;;;;2,0;;;;;;;;;;;;;;;;;;;;;;;;;;;;;;;;;;;;;3,0;;;;;;;;;;;;;;;;1,0;1,0;;;;;2,0;;;;;;2,0;;;;;;;;;;;;;;;;;4,0;;;;4,0;;;;;;;1,0;;;;;;9,0;;;3,0;;;;;;;;;;2,0;;;;;;;;;;1,0;1,0;1,0;2,0;3,0;;;;;;;;;;;;;;;;;;;;;;;;;;;;;;;;;;;;;;;;;;;;;;;;;;;;;;;;;;;
actuator;;12,0;;62,0;37,0;114,0;4,0;113,0;;;1,0;;34,0;151,0;;;14,0;;3,0;;1,0;;14,0;3,0;1,0;24,0;6,0;89,0;1,0;;291,0;52,0;17,0;27,0;8,0;23,0;8,0;7,0;3,0;;18,0;172,0;6,0;27,0;;107,0;;63,0;1,0;4,0;;1,0;30,0;13,0;7,0;8,0;45,0;2,0;2,0;48,0;2,0;;32,0;;212,0;3,0;305,0;7,0;;8,0;1,0;650,0;39,0;24,0;;;12,0;26,0;2,0;55,0;104,0;22,0;25,0;;480,0;104,0;6,0;160,0;8,0;3,0;8,0;;14,0;;2,0;;20,0;43,0;174,0;7,0;185,0;13,0;2,0;11,0;;42,0;;2,0;1,0;;2,0;7,0;;3,0;4,0;;2,0;8,0;;160,0;5,0;7,0;134,0;5,0;;6,0;159,0;;;1,0;19,0;1,0;;243,0;4,0;4,0;7,0;;12,0;;1,0;18,0;;4,0;4,0;50,0;7,0;75,0;7,0;82,0;36,0;5,0;23,0;30,0;2,0;1,0;3,0;4,0;1,0;;16,0;139,0;;5,0;1,0;;194,0;48,0;3,0;22,0;5,0;;8,0;124,0;;4,0;29,0;;8,0;;;;;9,0;;9,0;11,0;62,0;82,0;6,0;;;4,0;11,0;47,0;10,0;83,0;5,0;29,0;3,0;3,0;12,0;2,0;3,0;58,0;;90,0;3,0;19,0;116,0;222,0;21,0;4,0;;;13,0;27,0;23,0;2,0;25,0;43,0;8,0;;;18,0;;147,0;;;9,0;4,0;2,0;10,0;5,0;5,0;;1,0;10,0;2,0;;;11,0;10,0;4,0;4,0;11,0;5,0;66,0;85,0;9,0;5,0;;35,0;81,0;58,0;11,0;88,0;120,0;4,0;;3,0;2,0;22,0;10,0;31,0;;2,0;4,0;;9,0;;49,0;;9,0;4,0;;7,0;11,0;1,0;18,0;1,0;102,0;107,0;22,0;;21,0;41,0;13,0;95,0;1,0;121,0;1,0;;4,0;6,0;8,0;11,0;103,0;3,0;11,0;4,0;;14,0;11,0;1,0;2,0;8,0;1,0;5,0;57,0;;;19,0;;;1,0;11,0;41,0;1,0;13,0;19,0;13,0;24,0;5,0;2,0;5,0;3,0;5,0;44,0;30,0;;;11,0;7,0;5,0;1,0;1,0;6,0;;1,0;11,0;8,0;42,0;5,0;2,0;6,0;;14,0;;25,0;2,0;;;;8,0;;1,0;65,0;3,0;;1,0;2,0;;1,0;;10,0;;1,0;1,0;8,0;1,0;;7,0;7,0;9,0;6,0;;12,0;;;284,0;1,0;2,0;3,0;;33,0;;7,0;;1,0;2,0;4,0;;70,0;9,0;10,0;5,0;;11,0;2,0;41,0;11,0;10,0;31,0;108,0;4,0;11,0;1,0;108,0;58,0;37,0;91,0;;26,0;38,0;8,0;4,0;;4,0;4,0;;2,0;1,0;1,0;;29,0;3,0;29,0;4,0;6,0;10,0;;8,0;;1,0;2,0;;3,0;24,0;;;65,0;5,0;27,0;;1,0;;8,0;5,0;;;76,0;29,0;13,0;1,0;1,0;;4,0;3,0;17,0;2,0;1,0;;2,0;;;;;6,0;1,0;5,0;1,0;19,0;2,0;;4,0;;8,0;2,0;;64,0;2,0;;2,0;36,0;;19,0;2,0;3,0;7,0;2,0;;1,0;2,0;;2,0;;2,0;1,0;53,0;;;1,0;2,0;;;;;1,0;;;;15,0;;1,0;6,0;;16,0;;1,0;20,0;10,0;;3,0;;;13,0;3,0;;;14,0;;2,0;22,0;4,0;;1,0;;13,0;1,0;;1,0;;38,0;;;;1,0;;;9,0;1,0;;;;1,0;;4,0;1,0;;;1,0;;;;;;41,0;;;15,0;26,0;;3,0;23,0;7,0;;3,0;1,0;;2,0;5,0;1,0;8,0;3,0;2,0;;;;1,0;;;2,0;;11,0;;;2,0;;;2,0;1,0;;4,0;;;2,0;;5,0;;;1,0;;;;6,0;;;;1,0;2,0;1,0;;2,0;;;2,0;;;;8,0;;;;33,0;;;1,0;9,0;27,0;;;;10,0;;;;12,0;;;10,0;;2,0;;;2,0;;4,0;1,0;;;3,0;;20,0;31,0;28,0;1,0;;;2,0;19,0;;10,0;2,0;1,0;;;;4,0;;1,0;;;;;14,0;;;12,0;8,0;;2,0;3,0;;;25,0;;3,0;;1,0;;1,0;3,0;338,0;196,0;1,0;4,0;3,0;;;;2,0;3,0;;8,0;;1,0;11,0;;6,0;;3,0;;;3,0;6,0;12,0;;;;;;2,0;;29,0;;14,0;3,0;2,0;3,0;1,0;;;3,0;;11,0;;;;24,0;3,0;24,0;1,0;;;2,0;1,0;6,0;;;1,0;7,0;;1,0;;1,0;3,0;;;2,0;;;2,0;4,0;3,0;13,0;4,0;;12,0;;;;;1,0;;3,0;37,0;3,0;;;7,0;14,0;1,0;13,0;;;;;;;;;30,0;5,0;;;;2,0;;;;;;;4,0;;1,0;30,0;;;;;;;;;1,0;;17,0;3,0;;2,0;;;;;;1,0;;;;;;;4,0;;;;;;;;1,0;2,0;;1,0;4,0;;;;;1,0;2,0;;;2,0;;1,0;21,0;;;;1,0;;3,0;;;;;;5,0;;;;;;12,0;;;2,0;;;;;;;7,0;;;;;4,0;;;;;3,0;;1,0;;;;;;;;36,0;;;;;;3,0;1,0;;2,0;10,0;6,0;30,0;;;11,0;4,0;2,0;2,0;32,0;6,0;111,0;;8,0;9,0;2,0;4,0;5,0;1,0;2,0;2,0;2,0;2,0;1,0;15,0;20,0;;;;;;;;;;;;;;;;;;;;;;;;;;;;;;;;;;;;;;;;;;;;;;;;
adapt;;15,0;;10,0;4,0;56,0;21,0;35,0;;;1,0;8,0;2,0;79,0;;5,0;86,0;1,0;9,0;;5,0;;28,0;4,0;4,0;2,0;2,0;44,0;6,0;11,0;21,0;40,0;4,0;11,0;;53,0;7,0;3,0;3,0;;33,0;175,0;1,0;16,0;55,0;8,0;5,0;95,0;1,0;6,0;3,0;1,0;26,0;6,0;11,0;13,0;10,0;;3,0;35,0;;;3,0;1,0;198,0;5,0;72,0;1,0;;;7,0;77,0;77,0;;;;1,0;3,0;;15,0;44,0;;6,0;;84,0;18,0;;43,0;1,0;;12,0;6,0;21,0;;1,0;2,0;27,0;17,0;75,0;7,0;67,0;8,0;;24,0;44,0;96,0;;2,0;;;;11,0;12,0;;3,0;;2,0;7,0;10,0;67,0;5,0;;70,0;20,0;4,0;9,0;98,0;;;;14,0;;7,0;105,0;3,0;;11,0;;;;14,0;1,0;1,0;;3,0;4,0;15,0;5,0;15,0;36,0;1,0;3,0;35,0;7,0;;2,0;1,0;;;;7,0;59,0;;9,0;;;52,0;19,0;;7,0;33,0;;3,0;24,0;;25,0;5,0;3,0;1,0;;;1,0;3,0;15,0;14,0;;41,0;3,0;37,0;1,0;;2,0;20,0;4,0;8,0;8,0;43,0;6,0;17,0;7,0;;3,0;2,0;6,0;8,0;6,0;41,0;2,0;5,0;128,0;39,0;14,0;;;13,0;15,0;25,0;3,0;;8,0;13,0;5,0;;6,0;8,0;;91,0;3,0;5,0;7,0;;17,0;15,0;;1,0;;6,0;;5,0;3,0;;10,0;2,0;;6,0;17,0;6,0;10,0;34,0;13,0;9,0;;1,0;22,0;;2,0;60,0;91,0;2,0;2,0;6,0;21,0;;35,0;47,0;1,0;2,0;2,0;2,0;20,0;4,0;4,0;9,0;;15,0;;5,0;20,0;1,0;17,0;15,0;2,0;19,0;14,0;4,0;2,0;5,0;2,0;33,0;2,0;18,0;13,0;;;1,0;7,0;;2,0;1,0;65,0;7,0;3,0;5,0;;;6,0;8,0;8,0;2,0;7,0;4,0;2,0;10,0;7,0;;2,0;2,0;16,0;3,0;15,0;28,0;33,0;10,0;;;1,0;6,0;2,0;13,0;4,0;6,0;7,0;9,0;19,0;2,0;;;;1,0;;7,0;6,0;3,0;2,0;2,0;18,0;7,0;8,0;8,0;11,0;;8,0;3,0;;26,0;11,0;8,0;10,0;32,0;4,0;;5,0;;;2,0;39,0;10,0;4,0;;2,0;6,0;;11,0;4,0;1,0;;8,0;5,0;3,0;;83,0;5,0;1,0;;;30,0;7,0;1,0;1,0;;;19,0;3,0;9,0;2,0;12,0;;7,0;3,0;;6,0;8,0;3,0;1,0;8,0;5,0;14,0;43,0;8,0;26,0;;31,0;;7,0;18,0;4,0;;;;;3,0;4,0;;5,0;2,0;131,0;11,0;4,0;;5,0;11,0;;7,0;1,0;2,0;;7,0;8,0;2,0;;5,0;13,0;3,0;1,0;3,0;;;;23,0;;;2,0;7,0;2,0;10,0;1,0;;27,0;;7,0;5,0;;2,0;;;4,0;;;18,0;;1,0;3,0;26,0;65,0;3,0;;2,0;7,0;4,0;10,0;5,0;;1,0;4,0;2,0;3,0;34,0;1,0;5,0;7,0;1,0;1,0;1,0;4,0;16,0;11,0;1,0;;6,0;1,0;3,0;2,0;9,0;;1,0;10,0;4,0;;2,0;;2,0;2,0;;1,0;3,0;1,0;4,0;7,0;;;10,0;24,0;;10,0;;;5,0;2,0;6,0;1,0;3,0;3,0;6,0;9,0;4,0;2,0;;1,0;4,0;;;;5,0;18,0;1,0;1,0;1,0;;6,0;3,0;;4,0;1,0;3,0;2,0;4,0;;1,0;;;2,0;;4,0;1,0;;;2,0;;5,0;3,0;;8,0;3,0;;7,0;5,0;;4,0;;6,0;;;10,0;5,0;3,0;12,0;24,0;1,0;7,0;4,0;10,0;;;1,0;1,0;;3,0;;;1,0;10,0;;;14,0;1,0;;;10,0;1,0;;1,0;2,0;3,0;4,0;;4,0;4,0;1,0;2,0;8,0;4,0;;14,0;3,0;1,0;1,0;;;;;6,0;2,0;10,0;4,0;;;;1,0;1,0;;6,0;4,0;1,0;10,0;;;;5,0;1,0;;1,0;;;;2,0;4,0;;;4,0;4,0;;6,0;4,0;;2,0;;5,0;7,0;2,0;;12,0;;12,0;;5,0;4,0;;;6,0;;;4,0;;9,0;8,0;;13,0;;;1,0;;16,0;;;;9,0;2,0;4,0;1,0;6,0;1,0;6,0;;22,0;16,0;2,0;17,0;2,0;4,0;;;;3,0;1,0;4,0;25,0;;5,0;3,0;;4,0;;;;2,0;;7,0;2,0;1,0;;1,0;;1,0;;9,0;3,0;9,0;1,0;;1,0;16,0;6,0;1,0;8,0;;;1,0;7,0;1,0;;;;;;;5,0;13,0;2,0;;3,0;6,0;;6,0;;;3,0;;;3,0;;;;;;1,0;;;1,0;5,0;10,0;;;5,0;1,0;6,0;;6,0;2,0;;;;;1,0;;;;9,0;1,0;;;;;;3,0;1,0;1,0;;1,0;4,0;1,0;2,0;;;;;4,0;;3,0;1,0;;;2,0;;4,0;;;1,0;2,0;3,0;;;;1,0;;;2,0;;;;;1,0;;;;;2,0;1,0;;;;;;;;1,0;;6,0;;1,0;19,0;1,0;11,0;4,0;;;;2,0;;;13,0;;4,0;;3,0;34,0;;;1,0;5,0;1,0;13,0;;;1,0;;;;;;1,0;5,0;;;1,0;;;3,0;;;;;6,0;3,0;;;;;;;14,0;2,0;6,0;;;;;14,0;1,0;5,0;1,0;2,0;;2,0;;1,0;;2,0;;3,0;2,0;;;;5,0;2,0;;;;;;5,0;2,0;;;;;2,0;;1,0;;2,0;;4,0;1,0;4,0;1,0;1,0;4,0;1,0;2,0;2,0;1,0;2,0;4,0;6,0;;;;;;;;;;;;;;;;;;;;;;;;;;;;;;;;;;;
adapter;;30,0;;3,0;;39,0;4,0;80,0;;;;;3,0;50,0;;;1,0;;;;;;;1,0;3,0;;;12,0;1,0;3,0;103,0;34,0;1,0;;;10,0;5,0;2,0;;;;107,0;8,0;10,0;5,0;1,0;;9,0;;;;5,0;8,0;3,0;1,0;;10,0;;;4,0;;;;;18,0;1,0;65,0;5,0;;;3,0;184,0;33,0;;1,0;;1,0;;13,0;12,0;33,0;;7,0;;28,0;;;101,0;2,0;;;1,0;1,0;;2,0;;;15,0;22,0;4,0;39,0;3,0;5,0;1,0;3,0;2,0;;1,0;;4,0;;16,0;;;4,0;;;8,0;;13,0;;;1,0;2,0;1,0;6,0;63,0;;;4,0;;;;49,0;;;1,0;;;;2,0;;;;8,0;1,0;3,0;4,0;1,0;32,0;2,0;;128,0;11,0;;;12,0;;;;1,0;69,0;;2,0;;;39,0;3,0;;4,0;2,0;;8,0;5,0;2,0;9,0;;1,0;;;;5,0;;4,0;9,0;;16,0;;6,0;9,0;;;;16,0;6,0;11,0;63,0;;4,0;;;;;;;;7,0;;3,0;331,0;4,0;9,0;;;1,0;7,0;7,0;9,0;;;;;;;82,0;3,0;40,0;;;;9,0;;1,0;1,0;;;;;6,0;;;25,0;;4,0;;4,0;1,0;21,0;24,0;5,0;7,0;;1,0;6,0;;3,0;17,0;33,0;;;;11,0;7,0;10,0;16,0;;;;;2,0;;1,0;4,0;15,0;;;11,0;2,0;5,0;;11,0;2,0;15,0;2,0;;;;1,0;3,0;;;;;9,0;6,0;;1,0;;2,0;19,0;1,0;1,0;8,0;;3,0;6,0;7,0;5,0;;11,0;;1,0;7,0;20,0;;;5,0;25,0;;18,0;27,0;22,0;1,0;;;2,0;;;38,0;;16,0;;;3,0;6,0;5,0;9,0;;;2,0;8,0;1,0;;3,0;;24,0;;2,0;1,0;;;12,0;;;;9,0;;1,0;3,0;8,0;;;;;;2,0;;;;;;;;2,0;3,0;;4,0;;;;9,0;;;1,0;;1,0;;2,0;;;;3,0;;;;1,0;;;;3,0;;6,0;4,0;1,0;2,0;6,0;1,0;4,0;2,0;;;;;;8,0;;;;;;;1,0;;;;30,0;2,0;1,0;;;;;3,0;;;;;;3,0;;3,0;;;1,0;5,0;;;;6,0;;;;;9,0;5,0;1,0;;;3,0;6,0;;;;;1,0;;;;;;1,0;;3,0;15,0;3,0;1,0;;2,0;;;3,0;;;;;;5,0;;4,0;;;;;;3,0;1,0;3,0;6,0;;;;;;1,0;;4,0;;;1,0;;;;1,0;;;;;1,0;;3,0;11,0;11,0;2,0;6,0;;;;3,0;;;1,0;;3,0;1,0;;;;5,0;3,0;1,0;;;;7,0;;2,0;;;3,0;;;10,0;;;3,0;;;;33,0;;;;2,0;;;;;;;;;;;1,0;7,0;;;;1,0;;13,0;;;1,0;1,0;12,0;9,0;;3,0;;;;;;;;;1,0;;;;;;11,0;;;;;;;;;;;16,0;;2,0;;;;;;;;;;;;;;;;;12,0;;;;3,0;8,0;;;;;;;1,0;;2,0;2,0;3,0;;;;;1,0;6,0;;;;;;4,0;;;3,0;1,0;;;3,0;;8,0;;;;;;;;;;;;;3,0;;2,0;3,0;;;;;;;;3,0;;;5,0;;3,0;;;;;2,0;20,0;1,0;;13,0;;;;11,0;1,0;1,0;3,0;;6,0;18,0;1,0;;;1,0;;;3,0;;;;;;;;;9,0;;4,0;;;;6,0;;;21,0;12,0;;;2,0;;;;;12,0;;;;1,0;;;;9,0;;;2,0;;;3,0;;;;;;2,0;;;;2,0;;2,0;16,0;;;1,0;;;;;;;;;;;;;;;1,0;;;;;;;;;;;;;;;4,0;;;;;;;;;;;;;;;;;;;;;;;;;;;;6,0;;;;;;;;;2,0;;;;;;;;;;;;1,0;7,0;;;;;;;;;;;;;;;;;;;;;1,0;;;;;;;;1,0;;;;;;;;;;;;;;2,0;;;;;;;;;5,0;;;;;;;;;;;;;;;;;;;;;1,0;;;;1,0;;;;;;;2,0;;;;;;;;;;;;;;1,0;;;;;2,0;2,0;2,0;1,0;2,0;;;;;;;;;;;;;;;;;;;;;;;;;;;;;;
adhesive;;6,0;5,0;4,0;2,0;14,0;9,0;50,0;;;1,0;;29,0;27,0;;;1,0;2,0;;;12,0;;1,0;3,0;;;;54,0;;;18,0;;;;1,0;;12,0;8,0;1,0;;10,0;57,0;;6,0;2,0;97,0;;35,0;;;;;7,0;;;;72,0;;;5,0;14,0;;7,0;;38,0;;50,0;;;3,0;;130,0;38,0;2,0;;;74,0;;;;157,0;;;;138,0;;;18,0;9,0;;;;2,0;3,0;;2,0;;;14,0;;70,0;11,0;;65,0;;;;;3,0;;;;16,0;6,0;3,0;;1,0;;;43,0;;;1,0;3,0;;;30,0;;;15,0;43,0;;;61,0;;40,0;2,0;;;;;1,0;;;9,0;48,0;7,0;15,0;5,0;96,0;;1,0;14,0;24,0;1,0;;10,0;2,0;1,0;;41,0;16,0;;;;;42,0;11,0;;2,0;2,0;;;14,0;;10,0;;;2,0;;2,0;3,0;10,0;5,0;1,0;11,0;15,0;4,0;16,0;69,0;;;18,0;19,0;41,0;13,0;106,0;;28,0;2,0;8,0;104,0;4,0;;4,0;1,0;80,0;4,0;;56,0;4,0;4,0;;2,0;;13,0;;4,0;;;4,0;40,0;;;9,0;;92,0;33,0;3,0;;1,0;19,0;1,0;;6,0;2,0;;;10,0;;14,0;14,0;;;25,0;8,0;9,0;21,0;32,0;1,0;;11,0;1,0;36,0;37,0;1,0;19,0;171,0;2,0;;4,0;1,0;;15,0;6,0;;;;1,0;7,0;29,0;15,0;3,0;;1,0;;4,0;1,0;6,0;1,0;18,0;1,0;4,0;62,0;;;13,0;9,0;60,0;;5,0;;;6,0;;;9,0;;10,0;2,0;3,0;3,0;6,0;4,0;;24,0;6,0;1,0;3,0;17,0;;;2,0;9,0;11,0;;14,0;;;10,0;;2,0;2,0;2,0;2,0;3,0;;;8,0;39,0;3,0;;;40,0;;;4,0;;;;31,0;17,0;;9,0;;30,0;;11,0;;1,0;;;;;;;42,0;17,0;;;;;;;;;;;;;;;;;12,0;;1,0;;;;1,0;;;;;2,0;3,0;;;;;;;21,0;;;2,0;;;;;4,0;;60,0;;;;4,0;;;;3,0;;;;;;;;;;;4,0;;;9,0;;;;;2,0;;;;;;;;;;3,0;3,0;;;;;;;3,0;;;;4,0;;3,0;;;1,0;;3,0;;6,0;;;;;;;;;;;;5,0;26,0;;;;;1,0;10,0;1,0;;;;;1,0;;;;;;;;;;;;;;;;4,0;;;;6,0;;;;;;7,0;;;;;12,0;;2,0;8,0;2,0;;1,0;;;;;1,0;;;;3,0;;;;4,0;;24,0;;;13,0;;23,0;;;;1,0;;;;;;;;;;;;;;1,0;2,0;13,0;;;;2,0;3,0;;;;;;15,0;4,0;;;13,0;;;;;;;2,0;1,0;;;;;;;;;;;1,0;;;;;;4,0;;;;;;;;;;5,0;;1,0;;;;39,0;;;;;;;1,0;;;;1,0;;;;;;;;;;;;;;;;;2,0;;1,0;;;;;;7,0;;2,0;;;;1,0;;;;;1,0;;;;;11,0;;;;;;;11,0;;;2,0;;1,0;;;1,0;17,0;3,0;;;5,0;;;;71,0;2,0;1,0;;;;;;21,0;1,0;;;;;;;11,0;;;3,0;;;;;;;;11,0;;;;;;;;;;1,0;6,0;4,0;;1,0;1,0;;;;;;10,0;;;;;;;1,0;1,0;;;3,0;;;;;;7,0;1,0;;1,0;2,0;;2,0;;;1,0;;11,0;;;;;12,0;;10,0;;;;1,0;3,0;4,0;;;8,0;;;;;1,0;;;;;;24,0;;;;2,0;22,0;;;;;1,0;1,0;;;;;;;4,0;;;;;;;;;2,0;1,0;1,0;;2,0;;;;;;;1,0;3,0;386,0;;;25,0;;;;;;;;;;;;;;;;3,0;;1,0;;;;;;;;;;;;;;;1,0;;;;;;;;;;;;;;;;;;1,0;;;;;;;;;;;;;;53,0;;;;;;;;;;3,0;;;2,0;;;3,0;;;;;;;;;;;1,0;;;;;;;;;;;;;;;4,0;;;;;;;;;;;;1,0;;;6,0;;;;;9,0;;;;2,0;28,0;;;;;;;;;;;;;;;;;;;;;;;;;;
adjacent;;7,0;4,0;8,0;;13,0;53,0;49,0;;;3,0;6,0;9,0;79,0;2,0;4,0;54,0;2,0;46,0;1,0;8,0;7,0;42,0;2,0;1,0;;;19,0;5,0;;30,0;;6,0;;;34,0;20,0;9,0;21,0;;45,0;60,0;9,0;1,0;58,0;146,0;;73,0;;5,0;;2,0;30,0;3,0;64,0;6,0;41,0;;;29,0;33,0;;13,0;;485,0;2,0;70,0;5,0;2,0;13,0;11,0;224,0;50,0;1,0;;4,0;8,0;2,0;12,0;1,0;68,0;18,0;1,0;22,0;64,0;;;67,0;7,0;3,0;6,0;7,0;3,0;5,0;1,0;;274,0;37,0;145,0;102,0;172,0;30,0;19,0;2,0;13,0;6,0;4,0;;;;;35,0;159,0;;;2,0;;20,0;;127,0;7,0;1,0;61,0;1,0;1,0;2,0;51,0;1,0;2,0;5,0;33,0;;;84,0;2,0;2,0;127,0;4,0;8,0;3,0;;;2,0;;38,0;9,0;58,0;61,0;11,0;16,0;;39,0;42,0;10,0;;3,0;2,0;;;;2,0;32,0;;5,0;2,0;;42,0;40,0;2,0;1,0;13,0;;12,0;54,0;6,0;88,0;1,0;8,0;2,0;;;3,0;1,0;41,0;2,0;3,0;51,0;1,0;159,0;33,0;6,0;1,0;4,0;6,0;5,0;18,0;74,0;23,0;31,0;;1,0;23,0;;;6,0;1,0;43,0;7,0;5,0;103,0;7,0;10,0;3,0;2,0;18,0;32,0;15,0;1,0;;36,0;10,0;12,0;;21,0;45,0;;226,0;;7,0;1,0;5,0;9,0;3,0;;21,0;;2,0;1,0;;16,0;1,0;18,0;5,0;3,0;2,0;28,0;14,0;10,0;139,0;1,0;4,0;14,0;17,0;26,0;20,0;4,0;33,0;219,0;8,0;3,0;2,0;3,0;10,0;52,0;34,0;;8,0;;;32,0;;9,0;18,0;1,0;;;8,0;23,0;7,0;9,0;10,0;4,0;7,0;18,0;9,0;4,0;3,0;4,0;14,0;2,0;31,0;10,0;;1,0;2,0;7,0;30,0;3,0;1,0;12,0;3,0;7,0;24,0;3,0;1,0;12,0;3,0;2,0;2,0;59,0;4,0;;10,0;1,0;10,0;1,0;71,0;24,0;8,0;3,0;11,0;33,0;27,0;82,0;23,0;8,0;;;3,0;13,0;10,0;;3,0;10,0;1,0;2,0;1,0;1,0;4,0;1,0;6,0;5,0;5,0;;;5,0;22,0;41,0;;6,0;4,0;;;6,0;22,0;10,0;2,0;28,0;27,0;;8,0;;;;;1,0;;2,0;;;2,0;;11,0;16,0;6,0;3,0;1,0;;3,0;;2,0;6,0;;;;12,0;;32,0;;2,0;7,0;;4,0;2,0;4,0;28,0;1,0;7,0;7,0;;;4,0;3,0;12,0;;15,0;1,0;15,0;15,0;9,0;11,0;10,0;;1,0;4,0;9,0;3,0;13,0;;2,0;;3,0;;1,0;1,0;31,0;;;2,0;9,0;5,0;;4,0;1,0;4,0;;3,0;8,0;;1,0;3,0;20,0;9,0;1,0;18,0;4,0;;;7,0;;;3,0;1,0;4,0;;7,0;;8,0;;;2,0;5,0;3,0;1,0;;;;;;;;12,0;;10,0;16,0;;;;;;36,0;5,0;10,0;12,0;1,0;1,0;4,0;8,0;;7,0;;1,0;;8,0;1,0;1,0;1,0;;;1,0;3,0;3,0;7,0;5,0;;9,0;4,0;1,0;;;;11,0;1,0;;1,0;;1,0;16,0;5,0;1,0;4,0;7,0;2,0;13,0;;;10,0;2,0;;;6,0;;1,0;13,0;7,0;;14,0;1,0;2,0;10,0;;2,0;2,0;53,0;;;;2,0;3,0;;1,0;;3,0;;;1,0;;5,0;2,0;;2,0;1,0;;;;1,0;2,0;1,0;2,0;;;;;1,0;11,0;17,0;1,0;;3,0;2,0;2,0;4,0;1,0;2,0;5,0;15,0;4,0;;2,0;9,0;;;3,0;3,0;3,0;;;3,0;;;4,0;;;51,0;;;;2,0;;2,0;;;1,0;12,0;;;;3,0;1,0;4,0;;;2,0;1,0;;1,0;1,0;;;;3,0;;;;6,0;;3,0;2,0;7,0;1,0;3,0;4,0;13,0;1,0;1,0;6,0;;3,0;;;13,0;;2,0;3,0;1,0;4,0;;1,0;2,0;;;;;1,0;6,0;;;;4,0;1,0;18,0;;1,0;;2,0;17,0;;;19,0;;;2,0;;;;2,0;;6,0;1,0;;;4,0;;4,0;;89,0;;2,0;2,0;1,0;5,0;;9,0;3,0;9,0;6,0;;6,0;1,0;;;2,0;3,0;;2,0;2,0;;15,0;;7,0;;3,0;;;1,0;5,0;;;;;11,0;;1,0;6,0;16,0;;2,0;9,0;;20,0;5,0;3,0;;7,0;;;2,0;;1,0;;;;;;4,0;;;7,0;1,0;;6,0;7,0;;;1,0;;;;3,0;1,0;4,0;2,0;4,0;6,0;;;1,0;;7,0;2,0;1,0;;9,0;1,0;23,0;1,0;;3,0;;4,0;;4,0;;;8,0;10,0;22,0;;4,0;3,0;18,0;;2,0;;3,0;;;2,0;11,0;2,0;;3,0;1,0;;;5,0;7,0;;;;;8,0;;;29,0;4,0;6,0;1,0;;3,0;;3,0;;;4,0;;3,0;6,0;;2,0;;4,0;5,0;6,0;;;;3,0;;3,0;11,0;5,0;;;;8,0;8,0;;;4,0;;4,0;3,0;;;1,0;;8,0;8,0;;;;2,0;;;;;;;;;;;;;;;2,0;23,0;;;;;;;1,0;;;;;;4,0;;8,0;;;2,0;;5,0;1,0;1,0;;16,0;23,0;;8,0;3,0;1,0;;4,0;;8,0;5,0;;;;;;;;;;;9,0;2,0;;;;;;1,0;1,0;1,0;6,0;;;;11,0;10,0;1,0;;5,0;3,0;4,0;;;;;4,0;1,0;;3,0;;;;;;2,0;;;;2,0;2,0;;4,0;3,0;1,0;12,0;1,0;2,0;1,0;6,0;;;;;;;;;;;;;;;;;;
adjustable;;2,0;1,0;45,0;3,0;28,0;4,0;61,0;;;;;1,0;19,0;;;5,0;;;;;51,0;2,0;;8,0;;;5,0;;4,0;11,0;16,0;;;;2,0;12,0;3,0;4,0;1,0;9,0;80,0;13,0;26,0;9,0;9,0;;38,0;;1,0;;;9,0;1,0;15,0;8,0;8,0;;4,0;;;;8,0;;29,0;;31,0;;;1,0;30,0;102,0;6,0;1,0;15,0;;4,0;2,0;9,0;;26,0;12,0;10,0;;17,0;18,0;;73,0;4,0;2,0;9,0;;;3,0;3,0;;17,0;9,0;32,0;9,0;74,0;1,0;;;;;;;;;;;;;1,0;;3,0;4,0;;17,0;;1,0;1,0;18,0;;;42,0;1,0;;;2,0;;;33,0;4,0;;24,0;1,0;12,0;;;4,0;;;57,0;3,0;9,0;9,0;;14,0;;29,0;12,0;2,0;;;;;;;;13,0;;4,0;;;33,0;;;1,0;9,0;;1,0;14,0;2,0;1,0;;;4,0;;;;;1,0;8,0;1,0;3,0;23,0;2,0;5,0;;3,0;;1,0;3,0;2,0;21,0;;11,0;;;;1,0;;;;35,0;1,0;15,0;96,0;14,0;12,0;2,0;;1,0;13,0;1,0;;;1,0;;;1,0;;14,0;;22,0;1,0;;1,0;;;35,0;10,0;4,0;;;;3,0;;;12,0;11,0;1,0;;5,0;2,0;9,0;19,0;4,0;3,0;;;7,0;;1,0;25,0;13,0;;;;;;3,0;;;;;8,0;3,0;;;13,0;2,0;9,0;;9,0;62,0;;9,0;7,0;1,0;39,0;6,0;;;6,0;2,0;2,0;;1,0;2,0;1,0;;1,0;1,0;22,0;;5,0;2,0;5,0;;19,0;;8,0;1,0;10,0;1,0;5,0;5,0;;;;;1,0;;2,0;9,0;3,0;11,0;9,0;1,0;4,0;;;;;12,0;6,0;;;2,0;5,0;;7,0;;5,0;;;;11,0;5,0;6,0;;;21,0;12,0;9,0;;3,0;;41,0;;;2,0;20,0;4,0;4,0;3,0;1,0;;;1,0;2,0;;13,0;;;;3,0;;2,0;2,0;16,0;5,0;3,0;;2,0;;;7,0;;;;1,0;1,0;;;;;;;;8,0;3,0;;;;1,0;;;;;9,0;;1,0;4,0;;9,0;9,0;2,0;8,0;;6,0;9,0;14,0;;;;;;;;;;7,0;;1,0;;1,0;;;13,0;;6,0;1,0;1,0;;3,0;;;1,0;4,0;4,0;;;;;11,0;;;;3,0;;5,0;;;13,0;1,0;4,0;5,0;;;2,0;;;;;1,0;;;3,0;;7,0;;1,0;1,0;1,0;;;20,0;;5,0;7,0;;;;;1,0;16,0;;;;;1,0;;5,0;5,0;2,0;3,0;;1,0;;;;9,0;2,0;;;;;;3,0;;2,0;;;1,0;1,0;;4,0;2,0;;1,0;;;6,0;2,0;3,0;;;;4,0;2,0;6,0;1,0;2,0;2,0;1,0;5,0;;3,0;;7,0;;;;;;;1,0;;;;;1,0;;;1,0;;;;3,0;;;;;;;;;4,0;;;2,0;;;;;;4,0;;1,0;31,0;1,0;;10,0;;;1,0;;;;;2,0;;;;;;;;;;;;;13,0;4,0;1,0;;;;;;9,0;;;;2,0;2,0;;;;;;;;;;;;3,0;;4,0;;;;1,0;;1,0;;1,0;21,0;;;;;;;;;;;2,0;;1,0;;;;;;;;2,0;;;;;1,0;6,0;;;;;;;12,0;1,0;;;;;1,0;;1,0;;;2,0;;;5,0;;1,0;4,0;5,0;4,0;11,0;1,0;;;;;3,0;3,0;6,0;4,0;;5,0;;;6,0;;;;4,0;;;;;;;;;;;3,0;;;;;2,0;1,0;6,0;21,0;;4,0;7,0;;3,0;;;;10,0;19,0;1,0;32,0;;;;;;2,0;;;;;3,0;;;;2,0;6,0;2,0;2,0;4,0;2,0;;;;5,0;;1,0;;2,0;;;;;5,0;;;;1,0;;;1,0;2,0;;;;;;;;;;17,0;;;;;;;;;;;;;;;;;;;;;;;;1,0;;;11,0;;;;;;;;;;;;3,0;;;;;1,0;;;;;;;;;;;3,0;;;;;;;;1,0;;2,0;;;;;2,0;;1,0;;;;;2,0;;;;;1,0;10,0;;;2,0;;;;;;4,0;;;;;;;12,0;;3,0;;;5,0;;;;1,0;;;3,0;;;;;3,0;;3,0;3,0;;1,0;;;3,0;1,0;;;;;;;2,0;;;1,0;2,0;4,0;8,0;;;;;;;;;;;;1,0;;;;;;;;;;;;;;;4,0;2,0;;;;1,0;;;;;2,0;;;;;;;;;;;;;;;;;;;;;;;;;;;
align;;2,0;;10,0;;27,0;49,0;64,0;;;;22,0;28,0;71,0;3,0;;111,0;3,0;14,0;4,0;6,0;;12,0;;2,0;7,0;5,0;39,0;;8,0;104,0;8,0;6,0;4,0;1,0;18,0;38,0;18,0;16,0;;34,0;94,0;30,0;4,0;46,0;31,0;2,0;43,0;;;;;16,0;2,0;42,0;6,0;31,0;2,0;;28,0;1,0;;14,0;;461,0;;45,0;6,0;4,0;5,0;37,0;424,0;53,0;5,0;5,0;;3,0;4,0;1,0;1,0;127,0;;1,0;4,0;63,0;10,0;;181,0;48,0;10,0;9,0;14,0;8,0;5,0;2,0;;17,0;33,0;144,0;40,0;121,0;10,0;6,0;11,0;10,0;18,0;;;;3,0;;25,0;28,0;;4,0;1,0;4,0;22,0;13,0;131,0;1,0;1,0;15,0;11,0;;1,0;88,0;;;3,0;5,0;;;49,0;;4,0;72,0;7,0;;;;11,0;;;100,0;2,0;21,0;5,0;10,0;11,0;;8,0;45,0;10,0;;;;;;;2,0;16,0;2,0;;;2,0;24,0;22,0;3,0;11,0;6,0;1,0;1,0;66,0;4,0;29,0;;3,0;4,0;;1,0;;5,0;50,0;;4,0;3,0;1,0;57,0;58,0;;;5,0;12,0;16,0;64,0;141,0;;10,0;27,0;;21,0;;;5,0;1,0;80,0;2,0;1,0;30,0;1,0;3,0;1,0;6,0;29,0;7,0;3,0;40,0;3,0;32,0;22,0;1,0;;;40,0;6,0;180,0;3,0;;8,0;5,0;;6,0;;30,0;;3,0;8,0;;2,0;;36,0;1,0;3,0;5,0;11,0;10,0;19,0;113,0;8,0;25,0;;29,0;19,0;12,0;2,0;21,0;79,0;7,0;;;2,0;;20,0;14,0;;;;2,0;29,0;;2,0;23,0;7,0;7,0;;14,0;18,0;1,0;17,0;13,0;1,0;190,0;15,0;3,0;1,0;8,0;3,0;22,0;10,0;9,0;1,0;4,0;16,0;8,0;7,0;10,0;2,0;2,0;5,0;2,0;1,0;1,0;;;10,0;;9,0;2,0;43,0;3,0;2,0;3,0;;19,0;7,0;5,0;11,0;3,0;12,0;12,0;46,0;18,0;44,0;6,0;2,0;;3,0;1,0;2,0;30,0;;31,0;12,0;7,0;;;;1,0;1,0;15,0;4,0;18,0;16,0;;16,0;29,0;10,0;;9,0;2,0;3,0;;;7,0;3,0;1,0;2,0;52,0;8,0;1,0;;;;;6,0;;1,0;;;8,0;;19,0;34,0;4,0;;;;1,0;;5,0;14,0;;3,0;3,0;2,0;1,0;5,0;;;;;;8,0;7,0;3,0;1,0;3,0;9,0;1,0;;10,0;6,0;3,0;3,0;6,0;;;6,0;8,0;;5,0;;4,0;17,0;8,0;9,0;1,0;;1,0;;;1,0;;1,0;38,0;14,0;4,0;;1,0;;;;;;2,0;;;4,0;3,0;;;4,0;19,0;1,0;1,0;;;43,0;;;2,0;4,0;2,0;7,0;;;27,0;1,0;20,0;11,0;4,0;;9,0;;;;1,0;;;4,0;7,0;10,0;24,0;4,0;5,0;3,0;3,0;;;25,0;15,0;11,0;4,0;;3,0;29,0;6,0;;7,0;;;12,0;;7,0;3,0;5,0;;;6,0;;8,0;1,0;;;12,0;2,0;2,0;;3,0;;;5,0;;1,0;19,0;;2,0;;;13,0;64,0;1,0;1,0;;;5,0;1,0;4,0;;;4,0;;40,0;19,0;2,0;;15,0;4,0;5,0;;20,0;10,0;153,0;;6,0;;;10,0;;;;;;;15,0;1,0;6,0;;;;;1,0;;;;4,0;;9,0;;;6,0;;15,0;;60,0;2,0;;2,0;4,0;;;6,0;1,0;;11,0;10,0;;;5,0;;;1,0;;;;2,0;;1,0;;;;;26,0;2,0;;;;;;2,0;;1,0;7,0;;;3,0;;;50,0;;3,0;3,0;11,0;;2,0;4,0;;;;1,0;;;4,0;1,0;;;5,0;12,0;;;24,0;7,0;8,0;;;;2,0;;;;1,0;5,0;5,0;8,0;2,0;7,0;;;;;2,0;;3,0;6,0;1,0;4,0;;3,0;;11,0;;;;2,0;2,0;;;30,0;;1,0;1,0;;1,0;;1,0;1,0;23,0;;;;4,0;;;;10,0;;3,0;;;;4,0;;5,0;;14,0;1,0;5,0;2,0;;;3,0;3,0;;;14,0;;2,0;;;;;1,0;;;;3,0;;;1,0;;;;3,0;43,0;;2,0;6,0;2,0;;;;4,0;5,0;;;;9,0;1,0;1,0;4,0;;1,0;;;;1,0;;2,0;;3,0;12,0;;;;;;;1,0;1,0;;3,0;22,0;;4,0;;1,0;;2,0;;1,0;;3,0;;33,0;4,0;;36,0;;;;;;;;;;;;;;;6,0;2,0;;;;;23,0;7,0;6,0;6,0;;4,0;;;1,0;;;;;4,0;;;6,0;;;7,0;;23,0;6,0;2,0;;;;;5,0;;;;3,0;;1,0;1,0;;;;;;3,0;;1,0;;5,0;1,0;;16,0;;;3,0;2,0;;7,0;1,0;;;;;9,0;;1,0;;;;5,0;;;;8,0;2,0;17,0;;3,0;4,0;2,0;;1,0;;8,0;;;;;;;;;;;;;1,0;;;;2,0;6,0;;3,0;;;;7,0;;;;1,0;;1,0;1,0;;;1,0;;1,0;1,0;1,0;;1,0;;;;;9,0;;;;7,0;;;;;;;;;18,0;1,0;;;14,0;;4,0;1,0;;;;;;2,0;;;;5,0;;;;1,0;6,0;3,0;;6,0;1,0;;1,0;;;6,0;;;;36,0;;;1,0;2,0;1,0;;;;;;;;;;;;;
alignment;;1,0;3,0;44,0;3,0;22,0;19,0;37,0;2,0;;6,0;2,0;8,0;83,0;;;23,0;;9,0;;1,0;1,0;7,0;;;4,0;19,0;26,0;5,0;7,0;50,0;4,0;17,0;13,0;17,0;41,0;20,0;19,0;22,0;2,0;46,0;110,0;;7,0;13,0;11,0;9,0;78,0;;;9,0;;10,0;;29,0;6,0;49,0;;;31,0;;;7,0;;280,0;3,0;114,0;1,0;;10,0;4,0;155,0;29,0;6,0;;;;1,0;2,0;4,0;98,0;;1,0;71,0;53,0;5,0;1,0;94,0;4,0;1,0;27,0;2,0;2,0;1,0;;;33,0;9,0;104,0;43,0;106,0;12,0;;27,0;8,0;10,0;4,0;6,0;1,0;2,0;2,0;7,0;11,0;;1,0;7,0;2,0;9,0;2,0;53,0;;;12,0;5,0;1,0;18,0;100,0;;1,0;;11,0;;;26,0;6,0;;18,0;;4,0;;;17,0;;;31,0;7,0;17,0;21,0;;2,0;;9,0;9,0;3,0;1,0;2,0;;;;;1,0;4,0;1,0;;;3,0;25,0;1,0;;4,0;13,0;21,0;9,0;40,0;;8,0;;;9,0;;12,0;;;10,0;1,0;5,0;5,0;1,0;56,0;17,0;;1,0;2,0;1,0;3,0;2,0;56,0;;8,0;;;6,0;;2,0;17,0;13,0;77,0;;;36,0;5,0;11,0;6,0;;2,0;8,0;25,0;10,0;;140,0;4,0;2,0;;;16,0;;32,0;1,0;;14,0;;;5,0;5,0;14,0;1,0;;1,0;;7,0;1,0;12,0;;;;15,0;7,0;7,0;14,0;2,0;11,0;;1,0;37,0;6,0;;15,0;31,0;8,0;;;1,0;;14,0;1,0;;;;;7,0;;;7,0;5,0;;;6,0;13,0;;4,0;2,0;4,0;98,0;1,0;57,0;5,0;1,0;;2,0;;;4,0;;;;4,0;11,0;;;6,0;4,0;;1,0;;;;6,0;7,0;;17,0;;;;;4,0;;3,0;8,0;1,0;21,0;9,0;6,0;;10,0;8,0;;;;;2,0;3,0;;1,0;1,0;2,0;4,0;;1,0;2,0;;1,0;1,0;6,0;;;7,0;6,0;8,0;1,0;3,0;;;;1,0;6,0;;;1,0;18,0;;;;;;;13,0;1,0;2,0;2,0;;2,0;;17,0;24,0;1,0;;2,0;;1,0;;3,0;7,0;;9,0;1,0;5,0;4,0;1,0;;;5,0;3,0;3,0;4,0;;11,0;3,0;30,0;7,0;4,0;4,0;17,0;;;26,0;16,0;3,0;;4,0;;5,0;1,0;;1,0;3,0;7,0;1,0;1,0;;;6,0;3,0;;;1,0;24,0;13,0;4,0;;1,0;;;8,0;;;;8,0;;;8,0;;;29,0;16,0;3,0;6,0;6,0;;13,0;;;;;;;1,0;3,0;23,0;;4,0;14,0;;;7,0;;;5,0;;1,0;;36,0;66,0;;4,0;6,0;1,0;7,0;;1,0;;3,0;19,0;;13,0;;;51,0;1,0;4,0;7,0;;;14,0;11,0;1,0;;4,0;;1,0;;;;1,0;;61,0;18,0;9,0;;;;;;6,0;;;;;;;;3,0;1,0;;;10,0;;2,0;4,0;;;;;5,0;8,0;26,0;;;12,0;16,0;9,0;;;6,0;8,0;2,0;5,0;;;;;;1,0;;;1,0;7,0;;1,0;1,0;;;;1,0;;16,0;1,0;5,0;;2,0;3,0;;;;4,0;60,0;;;;;;;;1,0;;1,0;7,0;2,0;;1,0;1,0;;;;;;;13,0;;6,0;;;;;127,0;;1,0;;2,0;;1,0;2,0;;29,0;;;;;;;8,0;;;2,0;7,0;;;4,0;;;;;;;;;;;;4,0;;8,0;;;10,0;;13,0;;;;;;1,0;;3,0;2,0;4,0;6,0;;3,0;7,0;;;;1,0;;;4,0;;1,0;;8,0;;;;;;;;30,0;;;5,0;;;;1,0;3,0;36,0;;;;6,0;;3,0;2,0;8,0;;1,0;;;1,0;;;;;;;;4,0;9,0;;;2,0;;1,0;4,0;;;;2,0;;;;;;;4,0;;1,0;1,0;;;;5,0;37,0;;9,0;;9,0;1,0;;;1,0;;;;;1,0;;2,0;;;1,0;;;5,0;;;;1,0;;6,0;;;;2,0;2,0;;1,0;2,0;;;6,0;;;;;;2,0;3,0;;;;;4,0;;;;3,0;;;;4,0;;;;;;2,0;;;;2,0;;;;;;6,0;;;;;;;;;;1,0;;;3,0;;;;;;;;;;;;;;;;;6,0;;;1,0;;;;;;;1,0;14,0;;39,0;;;;;1,0;;1,0;8,0;;4,0;10,0;;;;;;1,0;;;;;;4,0;;;;19,0;;1,0;;3,0;;;;5,0;;2,0;;;3,0;;;;;;;;;;7,0;;;3,0;;;;;;;;;;;;2,0;;1,0;;;;;;;;1,0;3,0;;;;;;5,0;;;3,0;;;;;;;2,0;;;;;;;;;5,0;1,0;;;1,0;2,0;;3,0;12,0;;5,0;1,0;;;;;;;;;1,0;1,0;;;1,0;6,0;;;;2,0;;;7,0;;;;;;;;;;;;;;;
allow;;10,0;;64,0;17,0;41,0;16,0;35,0;1,0;;;29,0;11,0;41,0;3,0;14,0;33,0;2,0;7,0;5,0;;;1,0;8,0;15,0;3,0;;26,0;7,0;1,0;147,0;17,0;;2,0;;27,0;16,0;25,0;3,0;2,0;7,0;159,0;5,0;20,0;17,0;2,0;;54,0;;1,0;1,0;3,0;27,0;5,0;19,0;1,0;27,0;12,0;2,0;15,0;7,0;2,0;5,0;2,0;136,0;1,0;43,0;3,0;1,0;6,0;8,0;161,0;212,0;6,0;7,0;;23,0;1,0;1,0;;28,0;;22,0;1,0;39,0;34,0;;70,0;2,0;10,0;8,0;5,0;70,0;16,0;17,0;;5,0;12,0;50,0;13,0;75,0;11,0;2,0;7,0;11,0;4,0;;20,0;5,0;2,0;4,0;2,0;11,0;2,0;10,0;;2,0;4,0;15,0;58,0;;4,0;45,0;8,0;12,0;8,0;80,0;;1,0;3,0;16,0;;;76,0;6,0;;44,0;2,0;7,0;;1,0;8,0;;;21,0;1,0;14,0;14,0;8,0;19,0;2,0;6,0;68,0;6,0;;1,0;1,0;;;;1,0;18,0;9,0;;1,0;;26,0;25,0;;1,0;3,0;1,0;16,0;23,0;1,0;6,0;;17,0;1,0;;5,0;;4,0;20,0;6,0;;69,0;7,0;22,0;8,0;1,0;5,0;3,0;5,0;13,0;29,0;69,0;22,0;5,0;10,0;3,0;;9,0;1,0;;2,0;84,0;;32,0;137,0;55,0;76,0;1,0;5,0;1,0;5,0;16,0;3,0;;13,0;2,0;7,0;1,0;;26,0;1,0;121,0;1,0;21,0;5,0;;17,0;12,0;2,0;5,0;;6,0;3,0;;6,0;;18,0;8,0;1,0;4,0;41,0;7,0;13,0;24,0;22,0;9,0;;1,0;15,0;1,0;1,0;31,0;56,0;1,0;;3,0;8,0;6,0;7,0;7,0;7,0;;16,0;;18,0;;5,0;7,0;5,0;11,0;1,0;;20,0;8,0;11,0;22,0;2,0;37,0;6,0;;11,0;10,0;8,0;16,0;2,0;3,0;28,0;2,0;13,0;1,0;5,0;11,0;10,0;5,0;21,0;3,0;2,0;10,0;6,0;3,0;10,0;4,0;17,0;4,0;37,0;2,0;22,0;10,0;6,0;2,0;4,0;2,0;12,0;29,0;19,0;35,0;19,0;6,0;2,0;2,0;;;6,0;6,0;1,0;4,0;;12,0;14,0;15,0;;8,0;1,0;4,0;;75,0;37,0;21,0;3,0;2,0;15,0;;11,0;;10,0;2,0;3,0;1,0;;6,0;7,0;6,0;11,0;41,0;5,0;7,0;;1,0;2,0;;41,0;;1,0;;1,0;8,0;;3,0;2,0;4,0;3,0;2,0;;;2,0;63,0;;3,0;3,0;1,0;5,0;;;;2,0;;7,0;;8,0;1,0;10,0;;5,0;5,0;;;18,0;1,0;20,0;4,0;4,0;1,0;13,0;6,0;5,0;7,0;4,0;1,0;16,0;43,0;9,0;15,0;8,0;;;;;12,0;8,0;;43,0;7,0;3,0;;11,0;7,0;4,0;7,0;1,0;5,0;8,0;11,0;9,0;7,0;3,0;2,0;5,0;1,0;8,0;4,0;1,0;3,0;12,0;216,0;;;2,0;2,0;9,0;27,0;5,0;1,0;3,0;3,0;9,0;12,0;;;;;;2,0;;8,0;4,0;;3,0;2,0;42,0;;12,0;2,0;2,0;;2,0;4,0;;1,0;2,0;3,0;;12,0;3,0;6,0;;;;1,0;;1,0;1,0;12,0;;;5,0;1,0;11,0;2,0;2,0;;8,0;1,0;;2,0;1,0;3,0;;12,0;;;1,0;4,0;4,0;4,0;2,0;8,0;23,0;3,0;1,0;4,0;1,0;3,0;;7,0;1,0;1,0;2,0;1,0;2,0;17,0;2,0;;1,0;3,0;1,0;;1,0;3,0;32,0;;10,0;2,0;;1,0;6,0;;2,0;;1,0;6,0;4,0;;1,0;1,0;;3,0;3,0;;;;;1,0;;61,0;1,0;;5,0;1,0;4,0;14,0;6,0;;2,0;1,0;2,0;2,0;;26,0;24,0;6,0;4,0;5,0;12,0;1,0;3,0;6,0;;2,0;1,0;2,0;1,0;2,0;23,0;2,0;;;;;16,0;;1,0;1,0;1,0;;2,0;3,0;1,0;;3,0;4,0;10,0;1,0;;;3,0;2,0;;1,0;3,0;;;;;1,0;3,0;;3,0;1,0;1,0;1,0;;;6,0;2,0;3,0;11,0;4,0;3,0;7,0;;;;1,0;1,0;4,0;;;;1,0;;6,0;3,0;1,0;1,0;;;1,0;1,0;2,0;2,0;;2,0;2,0;4,0;11,0;7,0;4,0;3,0;6,0;;2,0;6,0;3,0;6,0;;;4,0;;3,0;;2,0;;;10,0;4,0;4,0;7,0;4,0;1,0;1,0;19,0;;;3,0;3,0;1,0;;;9,0;12,0;1,0;;1,0;7,0;4,0;1,0;4,0;;;13,0;5,0;;1,0;3,0;;;2,0;;1,0;1,0;;13,0;1,0;;3,0;;;;;31,0;4,0;;10,0;7,0;1,0;6,0;2,0;2,0;2,0;1,0;3,0;4,0;14,0;1,0;;1,0;1,0;6,0;4,0;;1,0;;1,0;1,0;1,0;2,0;;;3,0;;6,0;;1,0;1,0;;2,0;1,0;1,0;9,0;;;;2,0;9,0;;4,0;1,0;;;7,0;1,0;3,0;9,0;;;;;1,0;;;2,0;;1,0;;;3,0;5,0;;6,0;3,0;;;;2,0;1,0;;;;;2,0;;3,0;;1,0;;1,0;1,0;1,0;;;;2,0;;;2,0;;;1,0;;;1,0;1,0;8,0;;;1,0;1,0;2,0;;;2,0;3,0;2,0;2,0;1,0;;;1,0;;1,0;;;;;3,0;;;1,0;3,0;;;;1,0;2,0;2,0;1,0;5,0;;2,0;;;;;;;4,0;;;;;1,0;1,0;;;;;1,0;;;;;4,0;2,0;1,0;2,0;2,0;2,0;;;2,0;;2,0;1,0;1,0;;1,0;;2,0;14,0;1,0;2,0;;;;1,0;;1,0;;;;;8,0;;2,0;;;8,0;4,0;1,0;;2,0;;;;;2,0;;;7,0;;;21,0;;4,0;;;7,0;;1,0;2,0;4,0;1,0;;;;;;;;1,0;;2,0;;2,0;1,0;;2,0;1,0;;;;;1,0;6,0;;;;;;;;;;2,0;;;3,0;2,0;;;;;;;
analyze;;1,0;;2,0;10,0;26,0;4,0;1,0;1,0;4,0;;10,0;;75,0;;9,0;146,0;2,0;4,0;46,0;;;16,0;;1,0;;1,0;18,0;33,0;10,0;80,0;17,0;5,0;;;280,0;7,0;7,0;2,0;;211,0;134,0;;24,0;31,0;;2,0;4,0;;3,0;8,0;;;8,0;14,0;1,0;1,0;;7,0;66,0;1,0;;4,0;;777,0;3,0;62,0;2,0;9,0;2,0;;18,0;35,0;;;;1,0;2,0;5,0;8,0;161,0;;3,0;4,0;21,0;;;11,0;;;2,0;;3,0;;8,0;;33,0;7,0;58,0;19,0;30,0;9,0;;5,0;26,0;80,0;2,0;6,0;55,0;5,0;;17,0;15,0;4,0;;3,0;4,0;6,0;16,0;28,0;21,0;;28,0;1,0;;10,0;77,0;;3,0;;21,0;;;41,0;1,0;;15,0;;;;;;;;1,0;4,0;8,0;4,0;18,0;1,0;;1,0;3,0;;3,0;;;;2,0;;;2,0;19,0;;2,0;;5,0;7,0;;4,0;6,0;1,0;4,0;12,0;;1,0;;2,0;3,0;;;;;15,0;;2,0;9,0;;52,0;3,0;1,0;;1,0;;;;3,0;;;;;;;1,0;16,0;10,0;;;;;2,0;27,0;;;;1,0;15,0;;;2,0;22,0;3,0;6,0;;1,0;;35,0;;;6,0;;;3,0;5,0;4,0;10,0;2,0;7,0;;1,0;;;;;;20,0;1,0;2,0;1,0;;;;;9,0;1,0;1,0;1,0;9,0;1,0;;2,0;5,0;2,0;43,0;1,0;1,0;;;4,0;;;;;10,0;;;;1,0;;26,0;;3,0;3,0;;;;;5,0;3,0;;;1,0;;;1,0;;13,0;8,0;;;;;;22,0;;;;;4,0;15,0;;;;;7,0;;12,0;;;;;84,0;;5,0;;;;;;;;;;;10,0;;;;;;;1,0;4,0;;1,0;;4,0;11,0;;;;;4,0;;4,0;;1,0;;130,0;;;1,0;7,0;5,0;1,0;2,0;;;;;;2,0;4,0;;20,0;;2,0;;6,0;7,0;20,0;12,0;4,0;;;50,0;11,0;3,0;;7,0;;26,0;10,0;11,0;10,0;4,0;;54,0;2,0;;;26,0;1,0;9,0;1,0;8,0;6,0;5,0;14,0;;;44,0;1,0;;14,0;18,0;;;;1,0;1,0;4,0;;;2,0;38,0;5,0;23,0;5,0;;10,0;;1,0;11,0;6,0;;11,0;8,0;4,0;;5,0;;14,0;;;3,0;;4,0;64,0;4,0;;;;;2,0;;11,0;12,0;;;26,0;1,0;4,0;8,0;1,0;1,0;;;2,0;;2,0;;27,0;2,0;1,0;;;;1,0;3,0;;1,0;2,0;2,0;1,0;4,0;13,0;23,0;5,0;3,0;1,0;1,0;2,0;2,0;3,0;;;1,0;11,0;;;24,0;;1,0;1,0;;5,0;;;4,0;4,0;3,0;1,0;;1,0;5,0;;;;;;;4,0;;1,0;1,0;1,0;;;;;4,0;;;;;;3,0;;10,0;19,0;;;;;4,0;2,0;;;4,0;4,0;;4,0;4,0;9,0;1,0;;1,0;;6,0;1,0;3,0;9,0;9,0;6,0;4,0;3,0;;2,0;2,0;;;4,0;;;1,0;;35,0;;;1,0;;1,0;;2,0;;;5,0;8,0;;;;;4,0;;1,0;8,0;1,0;14,0;;18,0;5,0;2,0;49,0;6,0;27,0;;12,0;;2,0;;1,0;1,0;;;;2,0;2,0;6,0;3,0;;;12,0;14,0;;3,0;;;;;;;;6,0;2,0;3,0;4,0;;;;2,0;;;;;;1,0;;;2,0;;;;2,0;4,0;;24,0;;4,0;;;5,0;14,0;;1,0;;;;;;15,0;2,0;;5,0;;2,0;;;13,0;;;;;3,0;1,0;4,0;6,0;4,0;;;;;;;;;;;;;;;2,0;;1,0;;;;;;;;3,0;;;9,0;;4,0;;;1,0;;;;1,0;4,0;;;;2,0;1,0;;;;21,0;;;;;;;;;;;;;;;2,0;;;;;;;6,0;;;1,0;;;;;;;;;1,0;;1,0;;;;;;;;;;;;;1,0;;;;;;;;;2,0;;;;;;5,0;;;;;2,0;;10,0;;;;;;;;;;24,0;;;;;;7,0;1,0;1,0;;2,0;;;1,0;;;;16,0;;1,0;2,0;7,0;;;;;;1,0;;;;3,0;2,0;1,0;;4,0;2,0;;1,0;9,0;;6,0;;;1,0;1,0;;;7,0;;;;;;;5,0;;;;1,0;10,0;;;1,0;;2,0;1,0;1,0;;;2,0;;3,0;;;3,0;;5,0;1,0;8,0;;;;;;;2,0;;;14,0;5,0;;;;;;;;;;;;;6,0;;;;;;;3,0;;;;;;1,0;;;;;;;;;;;;;;;;;;;;;;2,0;;;;;;2,0;;;;1,0;1,0;;3,0;;;9,0;;3,0;;;3,0;;;;;;1,0;;;;1,0;;;;2,0;;2,0;;;;3,0;;;;;
angle;;3,0;5,0;277,0;35,0;120,0;46,0;55,0;2,0;4,0;1,0;7,0;14,0;517,0;;7,0;124,0;;9,0;9,0;;2,0;7,0;1,0;14,0;6,0;34,0;48,0;28,0;17,0;229,0;48,0;24,0;58,0;12,0;93,0;156,0;398,0;45,0;2,0;543,0;494,0;1,0;40,0;123,0;44,0;13,0;42,0;16,0;4,0;51,0;3,0;68,0;8,0;144,0;55,0;186,0;1,0;2,0;64,0;15,0;;30,0;;625,0;5,0;243,0;20,0;2,0;17,0;64,0;455,0;276,0;10,0;9,0;1,0;23,0;137,0;;7,0;336,0;1,0;45,0;25,0;160,0;20,0;;305,0;2,0;12,0;41,0;12,0;21,0;5,0;47,0;;61,0;171,0;267,0;420,0;331,0;214,0;59,0;8,0;25,0;40,0;18,0;15,0;;5,0;;142,0;32,0;5,0;;2,0;7,0;57,0;34,0;253,0;6,0;5,0;55,0;14,0;5,0;41,0;294,0;31,0;6,0;1,0;95,0;5,0;3,0;299,0;4,0;1,0;708,0;126,0;55,0;;3,0;23,0;;1,0;84,0;23,0;117,0;26,0;90,0;31,0;7,0;59,0;94,0;33,0;2,0;;;4,0;;;;30,0;10,0;10,0;;2,0;16,0;19,0;11,0;42,0;36,0;31,0;29,0;511,0;10,0;59,0;13,0;12,0;13,0;12,0;2,0;;5,0;71,0;9,0;6,0;41,0;3,0;35,0;52,0;9,0;14,0;1,0;8,0;22,0;4,0;60,0;136,0;12,0;5,0;;6,0;29,0;;255,0;18,0;57,0;2,0;76,0;200,0;29,0;47,0;128,0;34,0;;16,0;31,0;44,0;6,0;15,0;26,0;8,0;3,0;;45,0;;208,0;;;26,0;16,0;15,0;179,0;16,0;28,0;;22,0;9,0;;67,0;;12,0;30,0;;;71,0;9,0;45,0;122,0;17,0;19,0;;;36,0;25,0;2,0;22,0;455,0;6,0;;;36,0;3,0;201,0;63,0;19,0;;5,0;7,0;52,0;41,0;4,0;11,0;20,0;2,0;;20,0;;5,0;15,0;22,0;1,0;459,0;43,0;;;3,0;26,0;30,0;7,0;10,0;12,0;;6,0;3,0;7,0;189,0;24,0;2,0;10,0;3,0;17,0;3,0;;16,0;11,0;8,0;30,0;60,0;115,0;48,0;;10,0;1,0;36,0;4,0;48,0;21,0;3,0;27,0;60,0;123,0;21,0;17,0;6,0;;5,0;;6,0;15,0;11,0;1,0;19,0;2,0;21,0;4,0;4,0;3,0;2,0;8,0;148,0;722,0;129,0;2,0;5,0;20,0;17,0;14,0;4,0;1,0;18,0;2,0;;;21,0;4,0;14,0;14,0;128,0;;16,0;2,0;10,0;3,0;;93,0;1,0;29,0;24,0;5,0;7,0;;268,0;122,0;177,0;32,0;11,0;126,0;35,0;10,0;146,0;61,0;;4,0;25,0;117,0;12,0;158,0;2,0;16,0;48,0;13,0;6,0;22,0;4,0;51,0;26,0;38,0;30,0;11,0;9,0;14,0;17,0;6,0;21,0;134,0;1,0;31,0;110,0;76,0;18,0;31,0;;13,0;18,0;268,0;16,0;115,0;9,0;1,0;1,0;28,0;8,0;;1,0;109,0;6,0;23,0;8,0;137,0;10,0;2,0;36,0;4,0;24,0;216,0;23,0;30,0;8,0;2,0;;18,0;110,0;480,0;14,0;25,0;5,0;12,0;94,0;30,0;13,0;;4,0;62,0;23,0;1,0;42,0;42,0;33,0;6,0;80,0;2,0;2,0;5,0;2,0;7,0;3,0;;;44,0;2,0;25,0;16,0;16,0;2,0;122,0;15,0;18,0;1,0;;14,0;4,0;16,0;26,0;1,0;23,0;20,0;20,0;10,0;20,0;;;2,0;48,0;7,0;55,0;52,0;2,0;;25,0;5,0;9,0;2,0;4,0;23,0;174,0;11,0;4,0;;15,0;3,0;9,0;1,0;;9,0;12,0;;22,0;3,0;;34,0;16,0;1,0;7,0;13,0;;;;;3,0;1,0;4,0;1,0;34,0;177,0;;12,0;6,0;13,0;26,0;;15,0;16,0;53,0;1,0;1,0;;;;17,0;1,0;2,0;7,0;1,0;5,0;6,0;;4,0;6,0;;1,0;8,0;22,0;6,0;39,0;;3,0;4,0;;7,0;;;3,0;1,0;18,0;13,0;;5,0;;1,0;;;85,0;;1,0;;;;;2,0;;18,0;;1,0;28,0;;;;25,0;;8,0;1,0;;52,0;;4,0;6,0;7,0;6,0;7,0;10,0;;1,0;29,0;4,0;1,0;3,0;;2,0;18,0;;;12,0;5,0;;2,0;46,0;;1,0;7,0;6,0;;;;1,0;;18,0;21,0;37,0;24,0;1,0;1,0;6,0;8,0;;8,0;2,0;3,0;;9,0;;1,0;2,0;;14,0;7,0;1,0;17,0;;;3,0;6,0;1,0;;2,0;;2,0;;1,0;;36,0;;5,0;;7,0;6,0;2,0;7,0;144,0;4,0;1,0;2,0;;6,0;;3,0;;;5,0;1,0;1,0;30,0;;3,0;;38,0;5,0;12,0;;;3,0;30,0;8,0;11,0;53,0;2,0;4,0;;1,0;10,0;1,0;4,0;23,0;;1,0;40,0;2,0;3,0;;61,0;1,0;4,0;2,0;;1,0;20,0;12,0;;13,0;4,0;4,0;2,0;19,0;21,0;350,0;5,0;12,0;19,0;11,0;6,0;18,0;8,0;13,0;8,0;;6,0;;;5,0;;7,0;1,0;;;;2,0;2,0;;4,0;;8,0;6,0;2,0;;5,0;30,0;15,0;;4,0;;62,0;;128,0;1,0;;11,0;4,0;1,0;12,0;4,0;3,0;;;2,0;2,0;9,0;;14,0;;;;;19,0;;;;;;5,0;;;;;1,0;3,0;4,0;;;17,0;8,0;;28,0;;;2,0;7,0;1,0;31,0;3,0;;6,0;13,0;;;3,0;;2,0;;8,0;;3,0;;3,0;;;5,0;;;;;3,0;;12,0;;;32,0;1,0;12,0;2,0;8,0;1,0;18,0;14,0;12,0;64,0;;44,0;7,0;;1,0;1,0;31,0;;17,0;2,0;;3,0;;8,0;;3,0;37,0;19,0;26,0;5,0;2,0;4,0;3,0;8,0;3,0;33,0;2,0;;3,0;;1,0;2,0;;;31,0;1,0;;1,0;24,0;1,0;;3,0;;13,0;4,0;;24,0;;;3,0;;;2,0;10,0;22,0;2,0;;1,0;28,0;;;2,0;2,0;3,0;16,0;;;12,0;;;2,0;1,0;;;8,0;;2,0;1,0;19,0;;5,0;;;;3,0;;;1,0;;;;;1,0;;2,0;;;7,0;3,0;8,0;;;2,0;2,0;;2,0;;1,0;;27,0;1,0;1,0;13,0;13,0;16,0;1,0;2,0;6,0;3,0;;1,0;;4,0;13,0;7,0;34,0;;24,0;2,0;12,0;10,0;2,0;;5,0;14,0;4,0;;;27,0;1,0;1,0;3,0;1,0;19,0;
antenna;;2,0;;14,0;;31,0;54,0;5,0;;;;5,0;59,0;5,0;;;5,0;;;;;;;7,0;31,0;;;11,0;1,0;4,0;93,0;3,0;;;;11,0;1,0;;;1,0;6,0;78,0;;26,0;8,0;13,0;;77,0;;;1,0;;4,0;19,0;3,0;;22,0;;11,0;23,0;;;6,0;;14,0;6,0;30,0;2,0;;;;29,0;53,0;;;;8,0;4,0;;2,0;14,0;;;;89,0;;2,0;33,0;;;;6,0;17,0;;1,0;;;2,0;34,0;27,0;32,0;7,0;3,0;1,0;4,0;6,0;;;;;;;3,0;;;;;12,0;1,0;18,0;;;54,0;;;;70,0;;;;4,0;;2,0;17,0;;;3,0;9,0;;;;2,0;;;9,0;2,0;6,0;36,0;6,0;1,0;;;9,0;1,0;;;3,0;;;;43,0;25,0;;;;;48,0;14,0;;10,0;2,0;;2,0;17,0;;;1,0;45,0;1,0;;19,0;7,0;;;;;;;2,0;3,0;;;;;;;27,0;;4,0;;3,0;14,0;;27,0;6,0;1,0;1,0;14,0;1,0;35,0;1,0;;;2,0;;15,0;10,0;1,0;;2,0;6,0;;;;1,0;;42,0;;;2,0;4,0;15,0;4,0;;1,0;;26,0;1,0;;;;1,0;;;;6,0;6,0;2,0;1,0;;18,0;;;6,0;1,0;;15,0;24,0;6,0;53,0;;92,0;1,0;21,0;2,0;1,0;76,0;;;;;2,0;;6,0;;;2,0;1,0;;1,0;15,0;;2,0;;;;1,0;7,0;11,0;;;;;;;;2,0;;;;;;;;1,0;;;;;6,0;;;5,0;;;;2,0;;;;9,0;44,0;;;;2,0;;;9,0;;3,0;;1,0;4,0;;;;;;;1,0;2,0;;;;;;4,0;;;;1,0;;;;;;7,0;4,0;62,0;;;;;;;;;;;;;;10,0;;;1,0;2,0;1,0;;15,0;1,0;;;;2,0;5,0;;;4,0;;;2,0;1,0;;5,0;1,0;;3,0;;1,0;;7,0;1,0;;9,0;1,0;;;;;2,0;;6,0;5,0;;;;;;;;;;;82,0;;;7,0;;22,0;;;;;;4,0;;;;;;1,0;3,0;;2,0;;;3,0;;;5,0;;;;;;;;1,0;3,0;3,0;;;;1,0;;;;;;3,0;;;5,0;;2,0;7,0;;;;;3,0;14,0;3,0;;3,0;3,0;2,0;;;;;4,0;22,0;;4,0;;;;;1,0;;;;6,0;;;;;1,0;;2,0;;;;;3,0;;2,0;3,0;24,0;;;;;5,0;1,0;;;;;2,0;;;;3,0;;;;;;;5,0;;;;3,0;;;1,0;;;;;;;;;;;;15,0;10,0;;;;;9,0;;;;;;4,0;;;;;;;;21,0;1,0;;9,0;;;12,0;;17,0;;;;;;;;1,0;;;;;;32,0;;;;3,0;;;12,0;;6,0;;;;;;;;;;;;;;;;;;;6,0;3,0;;;;;;13,0;5,0;30,0;;9,0;;;;2,0;;7,0;;1,0;1,0;;;;;;;;;2,0;;;;;;;;;26,0;;;;;;;;;;;;22,0;19,0;16,0;;1,0;;4,0;;;;;;;14,0;1,0;5,0;;1,0;;;;2,0;;;;;;;1,0;;;;;;;5,0;;1,0;;;;;;;;;;;;2,0;3,0;2,0;;;;3,0;;;;;;;;;;1,0;;;1,0;;2,0;;2,0;1,0;1,0;;3,0;;1,0;;1,0;1,0;;;;;;4,0;;;;;;;;;;;;;;;;;;3,0;;;;;;;;;;;;;;;10,0;2,0;1,0;;;2,0;;;;;;;;;9,0;;;;;;;;;;;;;;;;;;;;;;;;;;;;;;;;1,0;2,0;;;;;;6,0;;;;;;;;1,0;;;;;;34,0;;;;;;;;;;;;;1,0;;;;;;;;;2,0;1,0;;;;;;;2,0;;;;;;;;;;;;;;;;;;;3,0;;;;;;;;;;43,0;;;;;;;;;;;;;;;;;;;9,0;;;;;;;;;;;;;;;2,0;1,0;;;;;;;;;1,0;1,0;;;;;;;1,0;;;12,0;;;;;;;;;;;;;;;;
aperture;;9,0;;68,0;18,0;97,0;82,0;138,0;;;8,0;3,0;8,0;104,0;2,0;14,0;38,0;1,0;33,0;7,0;;4,0;19,0;4,0;10,0;1,0;2,0;12,0;8,0;8,0;135,0;37,0;2,0;10,0;1,0;8,0;182,0;1,0;13,0;;24,0;184,0;55,0;26,0;16,0;137,0;14,0;192,0;;5,0;;9,0;151,0;11,0;24,0;34,0;138,0;;2,0;19,0;3,0;2,0;84,0;;343,0;;255,0;1,0;30,0;1,0;61,0;695,0;211,0;3,0;15,0;;7,0;;6,0;8,0;68,0;4,0;6,0;;85,0;1,0;;423,0;10,0;13,0;3,0;28,0;102,0;12,0;25,0;;80,0;70,0;183,0;18,0;216,0;50,0;3,0;;39,0;17,0;1,0;3,0;;;;1,0;12,0;1,0;7,0;;1,0;11,0;16,0;162,0;;2,0;65,0;130,0;15,0;8,0;180,0;3,0;1,0;20,0;17,0;4,0;;172,0;;;43,0;12,0;40,0;2,0;3,0;38,0;;;;11,0;110,0;76,0;13,0;15,0;15,0;27,0;44,0;19,0;3,0;;2,0;1,0;;;20,0;19,0;2,0;2,0;;;46,0;90,0;;6,0;4,0;;28,0;75,0;9,0;7,0;;11,0;8,0;;;6,0;17,0;54,0;33,0;5,0;50,0;11,0;14,0;83,0;2,0;;1,0;8,0;12,0;12,0;246,0;9,0;28,0;20,0;;39,0;31,0;;2,0;;150,0;2,0;27,0;142,0;28,0;18,0;9,0;36,0;3,0;17,0;11,0;11,0;;23,0;16,0;5,0;;;91,0;17,0;281,0;;7,0;23,0;6,0;6,0;42,0;11,0;34,0;;12,0;2,0;13,0;10,0;;25,0;11,0;4,0;26,0;16,0;27,0;66,0;175,0;16,0;21,0;;101,0;23,0;54,0;6,0;51,0;166,0;35,0;;;25,0;6,0;22,0;53,0;3,0;;8,0;2,0;22,0;4,0;5,0;4,0;3,0;8,0;;21,0;84,0;7,0;8,0;18,0;;136,0;8,0;;;5,0;22,0;17,0;100,0;2,0;3,0;3,0;23,0;15,0;11,0;51,0;3,0;;20,0;12,0;8,0;7,0;8,0;;;;14,0;26,0;63,0;;;3,0;;11,0;5,0;112,0;23,0;4,0;29,0;8,0;60,0;26,0;6,0;7,0;17,0;11,0;;52,0;1,0;23,0;5,0;3,0;14,0;10,0;4,0;7,0;;1,0;;7,0;9,0;3,0;4,0;;50,0;7,0;34,0;1,0;11,0;;8,0;10,0;;5,0;6,0;2,0;84,0;13,0;2,0;10,0;;;;;27,0;1,0;;;4,0;8,0;;3,0;62,0;57,0;4,0;1,0;9,0;;;185,0;4,0;2,0;2,0;;6,0;;1,0;;;21,0;10,0;;67,0;;21,0;4,0;4,0;8,0;;;23,0;8,0;2,0;;26,0;;;1,0;27,0;2,0;9,0;;5,0;26,0;1,0;9,0;1,0;;;4,0;12,0;3,0;4,0;1,0;160,0;;2,0;;;3,0;;88,0;4,0;31,0;;4,0;9,0;20,0;;1,0;;18,0;1,0;;1,0;;;10,0;1,0;1,0;8,0;2,0;57,0;6,0;;;;;5,0;1,0;4,0;;2,0;;3,0;;;;;3,0;1,0;33,0;5,0;14,0;;18,0;3,0;;1,0;6,0;;;9,0;4,0;2,0;19,0;10,0;15,0;1,0;;;6,0;29,0;4,0;3,0;9,0;5,0;2,0;3,0;;;3,0;1,0;;19,0;9,0;3,0;4,0;;;;4,0;5,0;;;5,0;71,0;2,0;;4,0;19,0;2,0;3,0;;;7,0;4,0;8,0;;2,0;;16,0;10,0;9,0;;3,0;;3,0;4,0;;49,0;7,0;52,0;;15,0;;1,0;9,0;;;;;;;;;;10,0;;6,0;11,0;8,0;1,0;;;1,0;;2,0;;;;;9,0;100,0;31,0;1,0;;7,0;9,0;1,0;3,0;31,0;9,0;4,0;15,0;11,0;;18,0;2,0;;;;;;3,0;;32,0;;;2,0;;;5,0;1,0;;;4,0;9,0;71,0;;;;;;2,0;;6,0;;34,0;;10,0;3,0;;;;4,0;2,0;;;36,0;;1,0;;;;;10,0;5,0;;7,0;;5,0;1,0;2,0;1,0;2,0;21,0;;20,0;;;;;9,0;4,0;;3,0;13,0;;;;;1,0;53,0;1,0;;;26,0;5,0;16,0;;1,0;;;;;;15,0;;;3,0;;1,0;;;5,0;;9,0;1,0;2,0;17,0;;20,0;1,0;12,0;;;;;3,0;3,0;9,0;66,0;55,0;73,0;;25,0;6,0;5,0;1,0;1,0;4,0;;3,0;5,0;25,0;5,0;27,0;113,0;;;;6,0;;17,0;6,0;;;2,0;3,0;;;;59,0;;2,0;4,0;6,0;;1,0;6,0;;44,0;2,0;40,0;3,0;4,0;;;2,0;;1,0;2,0;1,0;11,0;5,0;216,0;;1,0;14,0;;;2,0;;;1,0;;2,0;6,0;3,0;;9,0;4,0;2,0;1,0;3,0;1,0;20,0;1,0;;;;;43,0;;;35,0;;;;1,0;;;;;;2,0;;1,0;;;5,0;34,0;;;;;2,0;2,0;2,0;;6,0;;;6,0;9,0;;;;;2,0;;;5,0;1,0;;44,0;21,0;;;;;8,0;;1,0;;;;2,0;1,0;1,0;;;;4,0;;;4,0;3,0;4,0;1,0;7,0;;;;24,0;;2,0;;;2,0;;2,0;;2,0;3,0;;;;1,0;;8,0;;;;;;;2,0;;1,0;;;6,0;;1,0;;;1,0;;1,0;;;1,0;;;;;;;;11,0;1,0;;;2,0;1,0;1,0;;4,0;;;4,0;1,0;;3,0;3,0;3,0;;;2,0;;;;;4,0;;;;;2,0;1,0;27,0;;;;4,0;;;5,0;1,0;12,0;7,0;;;2,0;29,0;;;5,0;;3,0;3,0;3,0;;;3,0;;;3,0;;2,0;16,0;2,0;;;2,0;3,0;;;;10,0;;;;;;;;24,0;1,0;;;;;3,0;;3,0;;;46,0;;;;;;;;
apply;;3,0;1,0;23,0;39,0;39,0;16,0;26,0;3,0;9,0;;1,0;4,0;97,0;;3,0;92,0;;8,0;3,0;1,0;5,0;99,0;1,0;25,0;8,0;7,0;19,0;8,0;9,0;199,0;44,0;17,0;48,0;3,0;77,0;25,0;5,0;40,0;1,0;114,0;162,0;;55,0;53,0;10,0;23,0;45,0;3,0;14,0;28,0;;6,0;11,0;33,0;25,0;40,0;4,0;4,0;75,0;14,0;4,0;4,0;;678,0;11,0;106,0;10,0;3,0;;;92,0;64,0;7,0;4,0;6,0;50,0;11,0;3,0;9,0;275,0;3,0;33,0;80,0;136,0;9,0;6,0;79,0;;2,0;35,0;3,0;15,0;;3,0;;187,0;34,0;100,0;56,0;92,0;26,0;;34,0;73,0;83,0;1,0;17,0;4,0;;1,0;46,0;72,0;7,0;2,0;2,0;6,0;51,0;16,0;52,0;24,0;;146,0;12,0;1,0;17,0;63,0;;6,0;3,0;72,0;2,0;;152,0;6,0;1,0;30,0;13,0;18,0;14,0;;9,0;6,0;1,0;11,0;;34,0;11,0;9,0;7,0;68,0;24,0;15,0;6,0;;8,0;1,0;16,0;7,0;;27,0;20,0;;25,0;2,0;4,0;14,0;9,0;8,0;37,0;25,0;1,0;7,0;99,0;4,0;32,0;35,0;2,0;3,0;;1,0;;;23,0;;27,0;186,0;221,0;32,0;5,0;6,0;1,0;14,0;3,0;16,0;5,0;19,0;7,0;4,0;2,0;;42,0;2,0;12,0;14,0;14,0;41,0;3,0;2,0;35,0;26,0;23,0;34,0;2,0;;6,0;29,0;3,0;2,0;7,0;78,0;6,0;;3,0;29,0;;111,0;61,0;2,0;9,0;;12,0;25,0;40,0;3,0;4,0;1,0;9,0;;11,0;5,0;10,0;1,0;;4,0;19,0;2,0;3,0;37,0;3,0;;3,0;2,0;32,0;13,0;12,0;5,0;74,0;;;12,0;8,0;8,0;21,0;;1,0;8,0;;80,0;29,0;;36,0;50,0;4,0;1,0;;1,0;23,0;;8,0;;11,0;21,0;20,0;5,0;2,0;11,0;20,0;35,0;;191,0;;;2,0;2,0;1,0;43,0;26,0;11,0;11,0;2,0;;3,0;3,0;;4,0;2,0;5,0;2,0;25,0;;2,0;1,0;;2,0;5,0;6,0;4,0;6,0;9,0;16,0;57,0;15,0;12,0;2,0;2,0;1,0;1,0;50,0;15,0;;3,0;2,0;2,0;9,0;;7,0;3,0;3,0;4,0;16,0;29,0;12,0;8,0;1,0;1,0;11,0;27,0;;51,0;18,0;;12,0;9,0;9,0;1,0;;4,0;68,0;;4,0;3,0;;5,0;3,0;29,0;4,0;3,0;5,0;3,0;1,0;13,0;24,0;3,0;67,0;10,0;1,0;6,0;8,0;1,0;104,0;18,0;;3,0;1,0;63,0;4,0;20,0;5,0;10,0;4,0;20,0;7,0;20,0;12,0;127,0;;18,0;1,0;;9,0;112,0;;26,0;34,0;17,0;;4,0;42,0;52,0;;33,0;;6,0;14,0;5,0;2,0;1,0;4,0;3,0;;3,0;;3,0;3,0;25,0;22,0;38,0;5,0;4,0;16,0;;39,0;;7,0;;9,0;14,0;23,0;3,0;1,0;42,0;18,0;9,0;57,0;5,0;25,0;4,0;22,0;1,0;1,0;338,0;1,0;3,0;4,0;;;76,0;1,0;6,0;26,0;;;20,0;;;9,0;4,0;26,0;2,0;9,0;;40,0;11,0;;2,0;1,0;;9,0;7,0;18,0;3,0;2,0;8,0;7,0;4,0;33,0;2,0;1,0;18,0;1,0;2,0;9,0;3,0;;1,0;16,0;;5,0;8,0;3,0;13,0;1,0;43,0;22,0;5,0;5,0;;;;5,0;12,0;5,0;6,0;1,0;9,0;3,0;7,0;;5,0;9,0;;;1,0;;;;;1,0;1,0;2,0;8,0;;6,0;7,0;3,0;6,0;1,0;2,0;15,0;;;2,0;43,0;14,0;7,0;1,0;1,0;8,0;46,0;;;8,0;1,0;;;;1,0;;13,0;;;3,0;1,0;22,0;;7,0;37,0;4,0;1,0;6,0;;3,0;48,0;2,0;7,0;4,0;11,0;;2,0;5,0;;1,0;1,0;;9,0;14,0;11,0;2,0;21,0;;2,0;14,0;;2,0;;;3,0;13,0;2,0;1,0;;;38,0;1,0;5,0;5,0;23,0;29,0;16,0;7,0;9,0;16,0;2,0;1,0;;2,0;;;;;1,0;4,0;23,0;;;;;3,0;2,0;1,0;2,0;;2,0;2,0;;;;2,0;11,0;1,0;2,0;;;10,0;3,0;;3,0;5,0;1,0;;1,0;7,0;5,0;2,0;7,0;11,0;;14,0;39,0;;;6,0;;16,0;;1,0;1,0;;1,0;37,0;;4,0;;21,0;7,0;2,0;6,0;23,0;4,0;8,0;2,0;;5,0;2,0;1,0;11,0;1,0;;1,0;4,0;10,0;4,0;;2,0;19,0;1,0;;;;1,0;1,0;;47,0;77,0;;4,0;2,0;;25,0;;;4,0;1,0;;7,0;19,0;1,0;;1,0;;;1,0;;6,0;4,0;;3,0;6,0;3,0;;1,0;;3,0;21,0;;;14,0;35,0;;5,0;1,0;;6,0;;17,0;16,0;;1,0;1,0;2,0;8,0;6,0;;2,0;;4,0;4,0;1,0;;;;;;;;;;;;11,0;;27,0;;;1,0;;;;2,0;2,0;;;;15,0;4,0;;4,0;1,0;;2,0;;1,0;4,0;2,0;;8,0;3,0;4,0;2,0;;2,0;33,0;39,0;9,0;5,0;;;6,0;34,0;;2,0;;;1,0;4,0;3,0;2,0;1,0;3,0;;19,0;;;;1,0;;52,0;2,0;10,0;6,0;6,0;43,0;;;15,0;10,0;1,0;3,0;2,0;3,0;5,0;1,0;;;3,0;2,0;;9,0;;6,0;14,0;2,0;2,0;3,0;6,0;10,0;;2,0;2,0;;3,0;;;3,0;10,0;;1,0;;6,0;2,0;;1,0;20,0;12,0;;;;88,0;;;4,0;;23,0;;;;;2,0;;7,0;;2,0;2,0;1,0;2,0;6,0;2,0;6,0;;;5,0;;;1,0;6,0;12,0;6,0;10,0;;;4,0;;;2,0;;19,0;;;7,0;;;12,0;;;3,0;15,0;10,0;3,0;;2,0;;;;;;1,0;7,0;;19,0;;9,0;40,0;1,0;;;;1,0;;;7,0;6,0;2,0;;1,0;;2,0;;8,0;6,0;;1,0;1,0;2,0;;;;1,0;;;1,0;;3,0;8,0;16,0;15,0;6,0;4,0;;2,0;;59,0;3,0;;5,0;1,0;1,0;3,0;6,0;;4,0;;;;;;1,0;1,0;;
area;;1,0;;46,0;43,0;99,0;63,0;40,0;7,0;15,0;;;3,0;290,0;;33,0;514,0;60,0;1,0;8,0;4,0;12,0;132,0;8,0;16,0;2,0;;94,0;23,0;22,0;208,0;39,0;22,0;1,0;2,0;193,0;140,0;17,0;48,0;4,0;326,0;392,0;10,0;48,0;579,0;95,0;5,0;136,0;;13,0;14,0;11,0;85,0;5,0;151,0;70,0;138,0;;7,0;130,0;3,0;;12,0;;2085,0;1,0;482,0;17,0;13,0;15,0;25,0;204,0;258,0;8,0;2,0;;42,0;35,0;8,0;30,0;292,0;1,0;30,0;4,0;116,0;15,0;;145,0;7,0;18,0;8,0;39,0;23,0;100,0;64,0;;493,0;73,0;348,0;113,0;331,0;198,0;6,0;29,0;57,0;67,0;13,0;10,0;51,0;7,0;;36,0;198,0;18,0;;6,0;52,0;117,0;127,0;320,0;11,0;24,0;129,0;107,0;4,0;46,0;206,0;;2,0;6,0;59,0;12,0;15,0;238,0;10,0;;405,0;54,0;15,0;4,0;1,0;58,0;7,0;;110,0;34,0;;82,0;74,0;6,0;;39,0;33,0;35,0;7,0;30,0;11,0;9,0;;10,0;20,0;67,0;13,0;10,0;4,0;2,0;36,0;110,0;8,0;194,0;23,0;;17,0;129,0;;148,0;1,0;24,0;8,0;;2,0;5,0;17,0;166,0;;51,0;71,0;1,0;121,0;73,0;21,0;6,0;9,0;5,0;23,0;19,0;136,0;45,0;56,0;13,0;33,0;59,0;3,0;1,0;48,0;16,0;49,0;6,0;18,0;89,0;59,0;48,0;38,0;30,0;;87,0;53,0;19,0;77,0;20,0;50,0;5,0;36,0;14,0;21,0;;446,0;4,0;16,0;16,0;10,0;32,0;38,0;51,0;58,0;11,0;27,0;15,0;;33,0;;8,0;3,0;2,0;6,0;189,0;17,0;42,0;102,0;2,0;;2,0;11,0;33,0;57,0;1,0;31,0;378,0;97,0;;3,0;31,0;58,0;260,0;8,0;1,0;10,0;7,0;12,0;45,0;9,0;16,0;7,0;15,0;3,0;;14,0;117,0;3,0;9,0;8,0;3,0;37,0;38,0;30,0;;20,0;13,0;78,0;5,0;12,0;18,0;2,0;7,0;13,0;4,0;70,0;9,0;3,0;7,0;6,0;;1,0;2,0;;14,0;4,0;14,0;34,0;175,0;8,0;1,0;50,0;;20,0;;181,0;31,0;60,0;5,0;40,0;293,0;18,0;231,0;20,0;5,0;6,0;;15,0;10,0;3,0;;1,0;31,0;31,0;28,0;2,0;;49,0;1,0;17,0;39,0;8,0;;14,0;74,0;22,0;50,0;;4,0;;;1,0;18,0;83,0;49,0;2,0;89,0;127,0;41,0;33,0;;;6,0;3,0;24,0;8,0;5,0;;5,0;1,0;;82,0;120,0;66,0;14,0;17,0;6,0;27,0;12,0;187,0;48,0;;;24,0;164,0;30,0;55,0;7,0;28,0;37,0;16,0;35,0;195,0;7,0;36,0;4,0;136,0;43,0;1,0;;95,0;8,0;45,0;2,0;60,0;5,0;230,0;100,0;29,0;1,0;88,0;;21,0;33,0;19,0;3,0;9,0;8,0;5,0;4,0;10,0;9,0;18,0;1,0;145,0;7,0;41,0;12,0;2,0;79,0;5,0;122,0;;24,0;1,0;29,0;85,0;10,0;2,0;15,0;55,0;36,0;21,0;5,0;18,0;1,0;11,0;150,0;;1,0;;13,0;9,0;21,0;2,0;13,0;23,0;33,0;4,0;19,0;6,0;1,0;14,0;58,0;5,0;3,0;30,0;4,0;7,0;15,0;41,0;16,0;39,0;15,0;1,0;109,0;15,0;8,0;3,0;19,0;11,0;1,0;45,0;8,0;6,0;44,0;12,0;6,0;5,0;2,0;9,0;;24,0;1,0;;182,0;12,0;;3,0;4,0;9,0;7,0;94,0;11,0;25,0;5,0;10,0;;7,0;1,0;20,0;13,0;5,0;6,0;2,0;;22,0;2,0;15,0;31,0;4,0;2,0;52,0;;;8,0;3,0;6,0;1,0;;7,0;4,0;26,0;37,0;12,0;19,0;12,0;7,0;31,0;;8,0;45,0;88,0;1,0;38,0;;;6,0;72,0;3,0;;36,0;15,0;12,0;26,0;3,0;;29,0;22,0;;18,0;120,0;81,0;4,0;6,0;9,0;2,0;25,0;14,0;9,0;;5,0;7,0;21,0;17,0;;1,0;;6,0;;;30,0;6,0;4,0;7,0;19,0;2,0;7,0;21,0;4,0;;;4,0;28,0;;;9,0;9,0;1,0;62,0;1,0;;42,0;5,0;3,0;;7,0;;11,0;9,0;7,0;2,0;27,0;12,0;1,0;13,0;10,0;3,0;27,0;1,0;2,0;8,0;281,0;1,0;;7,0;5,0;5,0;52,0;;4,0;;109,0;;4,0;52,0;3,0;3,0;26,0;2,0;12,0;3,0;1,0;5,0;19,0;5,0;4,0;4,0;8,0;;4,0;3,0;1,0;12,0;14,0;18,0;7,0;108,0;7,0;5,0;2,0;30,0;1,0;21,0;13,0;3,0;;;;48,0;1,0;5,0;2,0;;19,0;3,0;3,0;329,0;;3,0;2,0;2,0;14,0;;5,0;3,0;;16,0;;5,0;4,0;;1,0;1,0;200,0;9,0;30,0;;;7,0;;96,0;15,0;12,0;6,0;;19,0;;8,0;3,0;;1,0;4,0;6,0;52,0;;23,0;;29,0;5,0;5,0;1,0;2,0;36,0;3,0;2,0;2,0;15,0;4,0;1,0;4,0;1,0;2,0;30,0;1,0;1,0;;14,0;;18,0;4,0;9,0;;;5,0;2,0;21,0;7,0;;3,0;1,0;;3,0;15,0;3,0;22,0;1,0;6,0;;3,0;;;1,0;;;5,0;;;1,0;83,0;4,0;17,0;;;;1,0;2,0;32,0;3,0;8,0;;;18,0;54,0;6,0;;79,0;19,0;;;;33,0;;;1,0;29,0;1,0;2,0;3,0;28,0;;24,0;282,0;;2,0;1,0;;7,0;11,0;3,0;8,0;;2,0;12,0;14,0;25,0;3,0;;1,0;2,0;13,0;4,0;;15,0;19,0;;72,0;5,0;7,0;3,0;39,0;8,0;;7,0;14,0;;6,0;3,0;;22,0;4,0;2,0;4,0;13,0;8,0;3,0;4,0;;8,0;44,0;7,0;1,0;;5,0;1,0;10,0;2,0;;6,0;;76,0;1,0;;;1,0;28,0;9,0;;10,0;7,0;7,0;3,0;24,0;14,0;2,0;;;3,0;10,0;4,0;11,0;12,0;4,0;;;;6,0;28,0;1,0;6,0;1,0;3,0;13,0;8,0;9,0;1,0;2,0;19,0;;4,0;4,0;6,0;4,0;14,0;;26,0;12,0;10,0;1,0;1,0;2,0;3,0;;3,0;;2,0;1,0;9,0;;;;2,0;;;4,0;;;5,0;12,0;;5,0;;9,0;;1,0;;;;1,0;2,0;2,0;;;;2,0;1,0;10,0;;3,0;;1,0;2,0;;50,0;10,0;29,0;1,0;;19,0;;9,0;;84,0;;1,0;6,0;5,0;8,0;3,0;16,0;9,0;16,0;6,0;7,0;17,0;1,0;4,0;9,0;1,0;3,0;;1,0;;6,0;;;;9,0;;;8,0;;6,0;2,0;3,0;;1,0;2,0;
arrange;;9,0;1,0;15,0;3,0;91,0;292,0;86,0;3,0;;5,0;9,0;24,0;119,0;22,0;1,0;65,0;16,0;19,0;6,0;42,0;1,0;121,0;10,0;33,0;1,0;4,0;107,0;6,0;4,0;190,0;44,0;1,0;2,0;10,0;104,0;26,0;8,0;38,0;19,0;40,0;267,0;13,0;31,0;75,0;16,0;4,0;295,0;;2,0;2,0;9,0;23,0;17,0;40,0;19,0;146,0;;2,0;75,0;22,0;16,0;82,0;;492,0;;384,0;3,0;2,0;21,0;5,0;650,0;473,0;24,0;5,0;;36,0;4,0;2,0;13,0;63,0;4,0;5,0;7,0;190,0;36,0;;285,0;12,0;53,0;4,0;17,0;20,0;59,0;25,0;;686,0;97,0;744,0;28,0;236,0;57,0;61,0;16,0;52,0;46,0;2,0;1,0;5,0;;1,0;20,0;521,0;2,0;1,0;;;60,0;36,0;432,0;21,0;4,0;149,0;5,0;9,0;46,0;145,0;3,0;2,0;1,0;42,0;9,0;4,0;551,0;;;49,0;7,0;4,0;11,0;1,0;61,0;;;76,0;11,0;82,0;;12,0;17,0;7,0;70,0;105,0;17,0;9,0;42,0;17,0;;;9,0;35,0;62,0;4,0;4,0;62,0;7,0;42,0;104,0;;38,0;20,0;;28,0;275,0;10,0;42,0;11,0;38,0;16,0;2,0;1,0;;32,0;125,0;2,0;92,0;166,0;8,0;86,0;93,0;1,0;4,0;21,0;46,0;50,0;77,0;222,0;14,0;40,0;12,0;70,0;176,0;5,0;2,0;24,0;;250,0;34,0;62,0;150,0;32,0;17,0;13,0;14,0;4,0;80,0;31,0;78,0;3,0;89,0;108,0;2,0;1,0;150,0;53,0;41,0;611,0;3,0;5,0;4,0;7,0;9,0;33,0;2,0;43,0;1,0;27,0;22,0;6,0;4,0;;33,0;14,0;9,0;28,0;23,0;13,0;42,0;424,0;5,0;24,0;8,0;12,0;214,0;295,0;58,0;118,0;405,0;40,0;19,0;50,0;37,0;65,0;40,0;41,0;17,0;20,0;3,0;11,0;55,0;8,0;67,0;75,0;5,0;4,0;;14,0;26,0;18,0;42,0;10,0;12,0;205,0;71,0;;4,0;65,0;8,0;139,0;38,0;124,0;38,0;1,0;13,0;11,0;9,0;54,0;7,0;28,0;16,0;7,0;2,0;8,0;12,0;11,0;11,0;10,0;17,0;6,0;82,0;1,0;4,0;59,0;4,0;9,0;6,0;5,0;17,0;44,0;15,0;6,0;183,0;63,0;36,0;10,0;26,0;20,0;1,0;90,0;36,0;13,0;5,0;10,0;28,0;11,0;11,0;3,0;4,0;1,0;1,0;29,0;19,0;16,0;4,0;7,0;14,0;21,0;101,0;2,0;50,0;2,0;;3,0;1,0;5,0;8,0;;80,0;28,0;21,0;13,0;;;4,0;2,0;2,0;4,0;;;1,0;1,0;4,0;10,0;63,0;3,0;4,0;8,0;1,0;6,0;;85,0;8,0;;2,0;;81,0;2,0;8,0;;2,0;1,0;1,0;1,0;44,0;1,0;6,0;3,0;7,0;3,0;;;59,0;3,0;3,0;9,0;46,0;1,0;19,0;12,0;29,0;2,0;20,0;;6,0;17,0;7,0;12,0;18,0;;;6,0;5,0;1,0;6,0;;134,0;1,0;6,0;;9,0;64,0;15,0;10,0;;2,0;1,0;29,0;10,0;22,0;1,0;5,0;48,0;1,0;32,0;1,0;2,0;;;53,0;;2,0;31,0;;9,0;25,0;2,0;1,0;12,0;1,0;18,0;20,0;1,0;5,0;;1,0;;;;2,0;;5,0;10,0;;36,0;9,0;22,0;2,0;9,0;6,0;4,0;115,0;12,0;5,0;35,0;4,0;2,0;31,0;4,0;5,0;8,0;3,0;2,0;9,0;26,0;29,0;8,0;13,0;;;2,0;5,0;3,0;16,0;11,0;;31,0;11,0;;2,0;2,0;;;6,0;3,0;2,0;5,0;8,0;51,0;16,0;10,0;22,0;12,0;48,0;14,0;2,0;1,0;8,0;6,0;3,0;;14,0;2,0;10,0;44,0;47,0;;17,0;1,0;2,0;7,0;;;21,0;79,0;;15,0;;18,0;17,0;;4,0;4,0;2,0;;;13,0;;16,0;;;5,0;7,0;11,0;1,0;3,0;;1,0;2,0;16,0;9,0;;2,0;;15,0;5,0;21,0;6,0;1,0;16,0;36,0;5,0;4,0;25,0;16,0;4,0;13,0;9,0;;1,0;1,0;3,0;;;1,0;9,0;;9,0;2,0;3,0;2,0;1,0;;;20,0;2,0;;;4,0;;61,0;2,0;14,0;5,0;9,0;1,0;3,0;2,0;2,0;;10,0;3,0;;7,0;4,0;2,0;;3,0;;2,0;;;;;4,0;;;4,0;1,0;15,0;14,0;;3,0;18,0;;6,0;5,0;;2,0;;22,0;21,0;1,0;2,0;1,0;12,0;2,0;;2,0;4,0;2,0;5,0;2,0;;6,0;18,0;12,0;;;2,0;2,0;109,0;;18,0;3,0;1,0;12,0;1,0;1,0;56,0;;;4,0;;5,0;4,0;5,0;;12,0;13,0;2,0;;15,0;13,0;;7,0;246,0;2,0;3,0;1,0;;9,0;6,0;7,0;71,0;57,0;7,0;6,0;14,0;1,0;3,0;3,0;;8,0;4,0;2,0;38,0;;6,0;11,0;;;7,0;10,0;;11,0;11,0;15,0;2,0;10,0;;;1,0;15,0;5,0;44,0;;6,0;11,0;7,0;13,0;7,0;;8,0;2,0;2,0;9,0;5,0;4,0;;1,0;21,0;41,0;9,0;9,0;3,0;10,0;13,0;3,0;3,0;4,0;10,0;2,0;;7,0;2,0;1,0;2,0;2,0;1,0;2,0;;1,0;24,0;2,0;;;7,0;8,0;58,0;10,0;3,0;;4,0;3,0;42,0;2,0;3,0;27,0;2,0;26,0;7,0;;1,0;7,0;7,0;47,0;102,0;1,0;;24,0;;;46,0;8,0;8,0;;19,0;;31,0;97,0;1,0;;7,0;8,0;4,0;;361,0;;1,0;;;15,0;;1,0;123,0;2,0;6,0;7,0;5,0;5,0;2,0;84,0;4,0;;;;4,0;1,0;;;3,0;14,0;;;;2,0;8,0;;;5,0;1,0;;3,0;;3,0;18,0;28,0;;;;;31,0;2,0;;;4,0;1,0;;16,0;16,0;6,0;3,0;3,0;5,0;1,0;3,0;1,0;;1,0;3,0;13,0;14,0;;1,0;;3,0;;;2,0;2,0;;;;1,0;5,0;;4,0;;;;;1,0;;;1,0;7,0;1,0;;5,0;12,0;;2,0;6,0;2,0;;10,0;2,0;10,0;2,0;12,0;;;4,0;;;;;1,0;;3,0;;;1,0;17,0;12,0;19,0;8,0;2,0;;1,0;1,0;;;;;;14,0;24,0;1,0;4,0;1,0;19,0;8,0;6,0;;;;3,0;;;8,0;;2,0;7,0;;;;;1,0;;7,0;;9,0;4,0;;;;18,0;2,0;1,0;3,0;;;;1,0;;1,0;;;2,0;;;;4,0;2,0;1,0;;;;
arrangement;;2,0;1,0;5,0;4,0;32,0;30,0;15,0;;;6,0;;1,0;42,0;;2,0;12,0;28,0;8,0;8,0;3,0;;33,0;;6,0;;;21,0;1,0;3,0;79,0;;1,0;5,0;2,0;9,0;11,0;5,0;6,0;5,0;43,0;89,0;1,0;7,0;14,0;13,0;;68,0;;;;4,0;8,0;3,0;10,0;26,0;34,0;;;14,0;4,0;;;1,0;111,0;2,0;87,0;;5,0;27,0;2,0;171,0;44,0;;;;4,0;;;25,0;76,0;3,0;3,0;;17,0;4,0;;102,0;3,0;12,0;12,0;2,0;4,0;4,0;6,0;;135,0;41,0;60,0;5,0;94,0;23,0;19,0;1,0;8,0;11,0;1,0;11,0;4,0;;;12,0;7,0;1,0;1,0;3,0;1,0;7,0;5,0;105,0;;3,0;19,0;10,0;2,0;5,0;40,0;;5,0;;11,0;2,0;;6,0;1,0;;15,0;5,0;1,0;;4,0;9,0;;;8,0;8,0;9,0;42,0;5,0;20,0;30,0;22,0;30,0;2,0;;;;2,0;;;7,0;49,0;;;;;12,0;52,0;;13,0;2,0;;;18,0;1,0;1,0;9,0;;8,0;;;1,0;;7,0;;2,0;22,0;10,0;6,0;20,0;2,0;;1,0;3,0;3,0;4,0;57,0;;;2,0;;2,0;;1,0;4,0;5,0;35,0;1,0;12,0;128,0;5,0;6,0;;;;5,0;8,0;4,0;;7,0;;5,0;;4,0;4,0;;33,0;;2,0;6,0;;2,0;10,0;;1,0;;1,0;4,0;3,0;;;2,0;2,0;2,0;36,0;26,0;3,0;61,0;37,0;1,0;7,0;;13,0;19,0;;1,0;54,0;56,0;;;;10,0;2,0;42,0;13,0;;;6,0;;21,0;9,0;7,0;18,0;17,0;;;11,0;15,0;;;18,0;6,0;64,0;2,0;;2,0;3,0;2,0;44,0;;2,0;5,0;;4,0;17,0;;12,0;5,0;3,0;17,0;;;1,0;;1,0;2,0;1,0;7,0;;18,0;3,0;1,0;1,0;;2,0;;12,0;2,0;4,0;1,0;;18,0;1,0;5,0;;;;;1,0;4,0;;;;7,0;2,0;1,0;1,0;;;;;5,0;28,0;;;4,0;7,0;6,0;;21,0;1,0;;;3,0;;2,0;;;36,0;1,0;;1,0;;;;14,0;26,0;2,0;;;;;7,0;;11,0;1,0;1,0;;;;77,0;;;1,0;2,0;14,0;;;;;;2,0;;7,0;2,0;5,0;;1,0;;;;;4,0;;11,0;3,0;5,0;36,0;30,0;23,0;;1,0;;18,0;2,0;5,0;1,0;6,0;;;;1,0;5,0;;;10,0;;2,0;;1,0;10,0;;17,0;;1,0;;4,0;;8,0;;4,0;1,0;;2,0;;;;;3,0;;;;1,0;9,0;11,0;;;;2,0;4,0;1,0;1,0;;2,0;;;;;;;;1,0;;12,0;5,0;2,0;;6,0;29,0;;27,0;1,0;3,0;5,0;;2,0;3,0;10,0;;;4,0;;1,0;1,0;;;9,0;6,0;;5,0;;6,0;1,0;11,0;;1,0;2,0;;10,0;;1,0;;;11,0;12,0;1,0;;4,0;1,0;;10,0;2,0;1,0;1,0;;;9,0;;;;2,0;;3,0;2,0;3,0;;3,0;;10,0;;;2,0;25,0;9,0;;25,0;;18,0;;;;9,0;;;1,0;1,0;;;;;;2,0;1,0;2,0;;;;;;1,0;;;;1,0;17,0;4,0;;2,0;2,0;1,0;14,0;;13,0;1,0;3,0;1,0;3,0;;10,0;;1,0;;;1,0;;;;;;;1,0;;;23,0;2,0;;;;;;;;3,0;;;;1,0;;;4,0;;;5,0;3,0;1,0;;;;;;;;;;3,0;;;;1,0;;;;1,0;;;;3,0;;1,0;;;;;;2,0;2,0;;;;;;;;1,0;29,0;;;;;;11,0;;;;2,0;;;;3,0;;;7,0;;;;8,0;;2,0;5,0;25,0;;4,0;6,0;1,0;3,0;15,0;4,0;6,0;;;1,0;;2,0;6,0;2,0;3,0;9,0;5,0;;2,0;;;7,0;;;37,0;;;1,0;;;8,0;2,0;;;3,0;1,0;2,0;;;;;3,0;2,0;16,0;;6,0;2,0;5,0;4,0;;1,0;;12,0;;;5,0;;;2,0;;;4,0;;;;;2,0;;;;;;;;;2,0;;;;;;3,0;;;;1,0;;13,0;1,0;;;;;7,0;3,0;;1,0;;;;;;;;;1,0;;;;;;;2,0;1,0;;;;5,0;1,0;;;;;;;;3,0;;;;46,0;;;7,0;;2,0;6,0;2,0;;;;1,0;;;2,0;;1,0;;;1,0;;;;;1,0;;2,0;1,0;;;2,0;;;;;41,0;;;;;2,0;;;;;;;;;;;;;14,0;;;3,0;;;;;;1,0;;;1,0;;;3,0;;4,0;2,0;2,0;;;;;;3,0;;4,0;;;;;;;2,0;;;;;;2,0;;24,0;4,0;1,0;;1,0;;;;;;;;;;18,0;1,0;6,0;4,0;;;;;;;3,0;;;1,0;;;4,0;;;;;;2,0;1,0;;;;;;;;;1,0;5,0;;;6,0;;;;1,0;;;2,0;;;;3,0;;;1,0;;;;;;1,0;;;;;1,0;;;;;;;;
associate;;21,0;;36,0;12,0;72,0;91,0;39,0;26,0;16,0;;16,0;2,0;322,0;3,0;19,0;339,0;12,0;26,0;28,0;;2,0;164,0;7,0;24,0;8,0;13,0;171,0;54,0;58,0;105,0;27,0;20,0;7,0;1,0;773,0;46,0;180,0;124,0;2,0;580,0;702,0;1,0;62,0;247,0;26,0;17,0;142,0;1,0;27,0;32,0;1,0;11,0;5,0;94,0;77,0;19,0;142,0;36,0;110,0;1,0;3,0;47,0;9,0;1585,0;4,0;231,0;9,0;46,0;;57,0;130,0;164,0;1,0;2,0;8,0;17,0;43,0;42,0;65,0;342,0;5,0;49,0;75,0;59,0;8,0;1,0;73,0;13,0;4,0;140,0;14,0;3,0;4,0;39,0;;492,0;113,0;517,0;283,0;313,0;85,0;2,0;26,0;41,0;149,0;13,0;17,0;57,0;;;126,0;147,0;4,0;2,0;11,0;28,0;121,0;69,0;288,0;34,0;;297,0;74,0;10,0;111,0;270,0;2,0;9,0;;188,0;;;70,0;13,0;15,0;200,0;110,0;43,0;1,0;1,0;11,0;2,0;1,0;13,0;9,0;74,0;12,0;;6,0;;25,0;14,0;8,0;3,0;12,0;;;;1,0;2,0;15,0;74,0;2,0;25,0;8,0;21,0;11,0;;27,0;12,0;6,0;44,0;145,0;;33,0;;19,0;10,0;1,0;17,0;3,0;9,0;35,0;8,0;3,0;36,0;11,0;212,0;16,0;;29,0;1,0;20,0;2,0;7,0;21,0;11,0;6,0;2,0;2,0;64,0;13,0;7,0;25,0;19,0;18,0;1,0;5,0;35,0;7,0;78,0;15,0;1,0;;4,0;100,0;;;32,0;101,0;45,0;26,0;35,0;1,0;1,0;151,0;;6,0;13,0;3,0;8,0;125,0;2,0;12,0;15,0;18,0;;;36,0;;4,0;4,0;;;116,0;20,0;13,0;24,0;7,0;4,0;;2,0;38,0;9,0;4,0;18,0;80,0;;;8,0;40,0;48,0;114,0;4,0;1,0;2,0;20,0;18,0;18,0;;4,0;7,0;15,0;1,0;;8,0;90,0;2,0;5,0;3,0;2,0;30,0;3,0;11,0;;8,0;;24,0;;9,0;64,0;2,0;2,0;14,0;;71,0;6,0;;6,0;;;;8,0;;;6,0;10,0;7,0;192,0;1,0;;;;1,0;8,0;31,0;10,0;1,0;5,0;50,0;374,0;12,0;40,0;10,0;5,0;;;43,0;;1,0;1,0;;6,0;33,0;;2,0;;4,0;;22,0;14,0;11,0;4,0;14,0;5,0;24,0;22,0;;2,0;;4,0;8,0;5,0;77,0;;11,0;8,0;302,0;20,0;29,0;1,0;10,0;65,0;12,0;20,0;18,0;16,0;9,0;1,0;;3,0;17,0;37,0;46,0;5,0;1,0;43,0;26,0;8,0;111,0;69,0;;4,0;29,0;162,0;10,0;48,0;;131,0;18,0;21,0;29,0;26,0;8,0;83,0;1,0;171,0;61,0;7,0;2,0;134,0;8,0;153,0;6,0;262,0;6,0;17,0;193,0;8,0;;22,0;;10,0;104,0;89,0;2,0;5,0;2,0;16,0;4,0;23,0;27,0;5,0;11,0;219,0;52,0;83,0;12,0;4,0;45,0;15,0;86,0;12,0;16,0;11,0;15,0;78,0;31,0;32,0;11,0;1,0;83,0;19,0;3,0;20,0;3,0;103,0;408,0;7,0;12,0;;34,0;;4,0;3,0;1,0;60,0;4,0;27,0;62,0;6,0;2,0;3,0;4,0;8,0;3,0;;8,0;63,0;37,0;62,0;29,0;53,0;8,0;9,0;2,0;8,0;14,0;18,0;4,0;6,0;26,0;70,0;6,0;9,0;46,0;20,0;4,0;55,0;6,0;9,0;60,0;8,0;2,0;1,0;11,0;53,0;8,0;3,0;6,0;84,0;;10,0;50,0;3,0;22,0;13,0;5,0;12,0;47,0;11,0;5,0;7,0;3,0;29,0;;6,0;;;15,0;6,0;8,0;11,0;2,0;;12,0;5,0;;1,0;3,0;51,0;;22,0;;5,0;28,0;20,0;5,0;50,0;49,0;6,0;5,0;9,0;2,0;17,0;13,0;1,0;32,0;8,0;;;5,0;16,0;31,0;14,0;4,0;12,0;;21,0;7,0;17,0;2,0;15,0;10,0;6,0;78,0;10,0;43,0;1,0;8,0;;26,0;5,0;10,0;;4,0;5,0;;6,0;1,0;8,0;2,0;2,0;8,0;3,0;2,0;38,0;33,0;4,0;24,0;38,0;10,0;19,0;5,0;20,0;2,0;4,0;23,0;2,0;4,0;4,0;1,0;149,0;7,0;66,0;;13,0;27,0;4,0;1,0;;5,0;3,0;8,0;;4,0;48,0;104,0;39,0;;;38,0;45,0;47,0;9,0;;;5,0;2,0;;8,0;3,0;56,0;11,0;;1,0;3,0;;7,0;3,0;1,0;;3,0;10,0;13,0;12,0;;13,0;3,0;4,0;5,0;55,0;3,0;2,0;7,0;25,0;9,0;10,0;9,0;4,0;31,0;35,0;5,0;3,0;;49,0;3,0;2,0;3,0;64,0;4,0;4,0;22,0;57,0;42,0;2,0;15,0;90,0;1,0;9,0;4,0;2,0;22,0;3,0;26,0;8,0;;;10,0;;;8,0;7,0;2,0;25,0;3,0;9,0;;;1,0;13,0;2,0;8,0;8,0;;5,0;6,0;;18,0;1,0;;2,0;17,0;34,0;31,0;2,0;3,0;2,0;14,0;3,0;;;11,0;26,0;4,0;;4,0;9,0;30,0;3,0;;5,0;4,0;41,0;3,0;;6,0;21,0;;17,0;5,0;;;;4,0;8,0;11,0;2,0;1,0;;;;;;;2,0;2,0;1,0;5,0;;;4,0;;2,0;2,0;;;7,0;1,0;15,0;3,0;24,0;;;3,0;;;2,0;;1,0;28,0;1,0;2,0;18,0;2,0;1,0;2,0;;1,0;;;4,0;;;;18,0;4,0;12,0;1,0;;;;33,0;1,0;16,0;;6,0;17,0;26,0;12,0;8,0;14,0;;;1,0;;8,0;25,0;2,0;;12,0;25,0;12,0;8,0;10,0;;3,0;12,0;;2,0;16,0;14,0;;13,0;33,0;;2,0;;;;;2,0;25,0;9,0;2,0;2,0;7,0;4,0;6,0;12,0;4,0;2,0;4,0;9,0;4,0;8,0;17,0;5,0;14,0;12,0;6,0;2,0;;1,0;5,0;5,0;8,0;2,0;7,0;;27,0;10,0;8,0;3,0;;2,0;;8,0;2,0;8,0;1,0;19,0;6,0;;9,0;;24,0;10,0;;21,0;4,0;1,0;5,0;16,0;15,0;;2,0;11,0;6,0;;3,0;;;18,0;2,0;;5,0;1,0;;1,0;;13,0;1,0;1,0;;3,0;;5,0;1,0;;;31,0;;5,0;8,0;9,0;23,0;1,0;;12,0;21,0;;;5,0;2,0;1,0;;;24,0;;2,0;2,0;2,0;;;2,0;1,0;;;3,0;;8,0;;;;3,0;1,0;;9,0;;10,0;21,0;3,0;5,0;;17,0;1,0;1,0;11,0;32,0;12,0;9,0;2,0;1,0;4,0;;12,0;;;4,0;3,0;;;18,0;20,0;;;35,0;7,0;2,0;;;;7,0;;1,0;;;
attach;;49,0;;12,0;4,0;148,0;12,0;344,0;;;;5,0;84,0;240,0;;;31,0;3,0;8,0;2,0;;;20,0;2,0;5,0;;;38,0;1,0;1,0;290,0;28,0;1,0;4,0;;28,0;24,0;3,0;3,0;3,0;11,0;294,0;;16,0;14,0;41,0;2,0;214,0;;;2,0;;81,0;39,0;6,0;2,0;46,0;;1,0;1,0;7,0;;13,0;9,0;151,0;1,0;173,0;4,0;;17,0;5,0;567,0;86,0;2,0;3,0;;19,0;1,0;1,0;24,0;158,0;;2,0;9,0;172,0;32,0;;58,0;;3,0;1,0;16,0;5,0;22,0;18,0;19,0;1,0;15,0;118,0;43,0;140,0;11,0;2,0;22,0;7,0;14,0;1,0;;;;;9,0;34,0;9,0;6,0;;;15,0;5,0;205,0;;8,0;19,0;4,0;;6,0;138,0;;10,0;;1,0;1,0;1,0;65,0;;6,0;21,0;1,0;;3,0;15,0;16,0;7,0;;15,0;7,0;6,0;17,0;6,0;;4,0;11,0;292,0;43,0;1,0;8,0;4,0;1,0;;2,0;7,0;30,0;;1,0;;;47,0;86,0;;7,0;8,0;1,0;2,0;35,0;20,0;41,0;10,0;3,0;11,0;;;29,0;9,0;40,0;40,0;16,0;58,0;20,0;131,0;150,0;1,0;6,0;16,0;27,0;149,0;33,0;407,0;;76,0;21,0;2,0;49,0;1,0;4,0;3,0;;319,0;28,0;81,0;480,0;9,0;5,0;;1,0;11,0;73,0;4,0;2,0;1,0;3,0;24,0;2,0;5,0;;213,0;7,0;468,0;;4,0;4,0;10,0;10,0;3,0;;83,0;;;;119,0;;6,0;51,0;8,0;42,0;14,0;10,0;4,0;32,0;215,0;9,0;18,0;47,0;6,0;257,0;68,0;3,0;210,0;375,0;9,0;;;3,0;4,0;207,0;75,0;4,0;2,0;;20,0;15,0;143,0;103,0;82,0;36,0;32,0;8,0;19,0;31,0;10,0;20,0;241,0;1,0;43,0;148,0;;45,0;61,0;26,0;142,0;14,0;28,0;1,0;15,0;25,0;;63,0;29,0;2,0;8,0;37,0;21,0;19,0;28,0;;18,0;7,0;41,0;44,0;;31,0;1,0;6,0;5,0;2,0;40,0;13,0;15,0;18,0;6,0;56,0;31,0;24,0;20,0;3,0;19,0;7,0;8,0;17,0;27,0;68,0;5,0;9,0;23,0;3,0;12,0;2,0;7,0;5,0;;5,0;19,0;8,0;10,0;16,0;7,0;18,0;14,0;19,0;;47,0;;30,0;;3,0;23,0;63,0;8,0;66,0;28,0;5,0;;1,0;4,0;5,0;4,0;15,0;1,0;;;2,0;13,0;8,0;;13,0;;;11,0;;;;55,0;6,0;;1,0;5,0;19,0;1,0;2,0;;1,0;;;;9,0;5,0;;;8,0;;;18,0;8,0;11,0;7,0;14,0;6,0;1,0;20,0;;40,0;29,0;70,0;;2,0;6,0;19,0;1,0;6,0;1,0;;;;;;;107,0;28,0;3,0;1,0;2,0;7,0;;;;2,0;19,0;5,0;4,0;6,0;;1,0;9,0;1,0;29,0;;2,0;;1,0;12,0;;;8,0;;14,0;19,0;6,0;;9,0;21,0;2,0;13,0;1,0;2,0;;2,0;;;;2,0;;;3,0;1,0;12,0;55,0;30,0;9,0;37,0;;9,0;67,0;10,0;3,0;1,0;4,0;10,0;3,0;1,0;8,0;;;;;9,0;5,0;2,0;4,0;5,0;1,0;1,0;;;3,0;3,0;;18,0;21,0;3,0;1,0;;;;1,0;1,0;;16,0;4,0;5,0;1,0;6,0;24,0;94,0;2,0;5,0;;;34,0;32,0;2,0;;12,0;;16,0;17,0;1,0;2,0;;;3,0;1,0;2,0;;1,0;39,0;;1,0;;;9,0;;1,0;1,0;;;;;;;3,0;;2,0;;2,0;15,0;2,0;;16,0;;;;2,0;;;96,0;11,0;2,0;;;21,0;1,0;3,0;;2,0;27,0;5,0;38,0;37,0;6,0;1,0;;;1,0;1,0;;9,0;;;;11,0;3,0;;;;7,0;4,0;6,0;;5,0;;1,0;;;;6,0;3,0;62,0;;2,0;;13,0;;;;4,0;;;;;1,0;;2,0;;3,0;8,0;13,0;;;6,0;7,0;1,0;8,0;;6,0;55,0;;7,0;;11,0;;10,0;;1,0;1,0;;7,0;11,0;1,0;2,0;;19,0;8,0;;1,0;;17,0;1,0;;;1,0;1,0;21,0;;6,0;;;;;8,0;35,0;;;8,0;;13,0;5,0;4,0;1,0;8,0;1,0;;1,0;199,0;;2,0;;30,0;1,0;8,0;13,0;64,0;;;;10,0;19,0;13,0;3,0;11,0;5,0;1,0;7,0;6,0;12,0;;;15,0;1,0;3,0;49,0;;;4,0;2,0;1,0;2,0;1,0;17,0;12,0;11,0;;23,0;;;5,0;12,0;;19,0;17,0;12,0;6,0;;12,0;2,0;17,0;11,0;;13,0;2,0;;3,0;12,0;2,0;20,0;;1,0;;3,0;9,0;3,0;7,0;29,0;12,0;1,0;7,0;22,0;;3,0;;4,0;23,0;;7,0;1,0;1,0;3,0;2,0;4,0;6,0;35,0;27,0;;;8,0;1,0;25,0;;1,0;2,0;;;;;;;;;;5,0;2,0;2,0;;;21,0;;11,0;;;;21,0;;;;;;;1,0;4,0;;1,0;;;1,0;;;2,0;;;;;7,0;;;;;;;1,0;1,0;22,0;;8,0;;;;;2,0;;;;6,0;;;;;;;;;;2,0;;;3,0;;;;1,0;2,0;;4,0;2,0;;;;4,0;;;;;1,0;28,0;;;;;;;2,0;;1,0;;;;;;;3,0;;1,0;;1,0;9,0;;1,0;;;14,0;;4,0;;2,0;;1,0;;5,0;;9,0;1,0;;2,0;;5,0;1,0;;;;;;;1,0;;2,0;20,0;18,0;;22,0;5,0;1,0;;;22,0;1,0;;15,0;;1,0;2,0;;2,0;;5,0;6,0;3,0;;;;;;;;4,0;;;;;3,0;;;10,0;25,0;;;;;;;;2,0;7,0;;2,0;;;;1,0;;;;;;;2,0;;;2,0;;;;;
attachment;;20,0;;;1,0;43,0;2,0;129,0;;4,0;;2,0;1,0;60,0;;;4,0;;5,0;;;;;;7,0;;;11,0;;;132,0;6,0;;;;4,0;16,0;4,0;1,0;3,0;8,0;111,0;20,0;7,0;2,0;12,0;;39,0;;;;;50,0;19,0;5,0;5,0;18,0;;;;;;1,0;3,0;17,0;;150,0;;;4,0;10,0;66,0;20,0;;2,0;;12,0;;1,0;;23,0;;;;69,0;4,0;;24,0;1,0;2,0;;9,0;;2,0;4,0;;1,0;10,0;20,0;62,0;73,0;19,0;;1,0;4,0;;1,0;4,0;;3,0;;4,0;;;3,0;;;5,0;;27,0;;2,0;10,0;5,0;2,0;3,0;85,0;;;6,0;4,0;;;39,0;1,0;;27,0;;1,0;;3,0;10,0;1,0;;18,0;;8,0;10,0;3,0;241,0;;7,0;41,0;14,0;;;1,0;;;;;44,0;;;;;64,0;12,0;;6,0;;2,0;;65,0;2,0;57,0;;;16,0;;;3,0;11,0;7,0;4,0;;5,0;4,0;24,0;24,0;;;1,0;16,0;5,0;9,0;96,0;;2,0;5,0;;;2,0;;;;100,0;3,0;57,0;186,0;2,0;4,0;3,0;;3,0;19,0;;7,0;;;;;;;58,0;;337,0;1,0;2,0;;7,0;;;3,0;53,0;;;;12,0;;1,0;18,0;;2,0;11,0;9,0;2,0;10,0;37,0;7,0;6,0;3,0;;71,0;;;113,0;118,0;2,0;;;5,0;;79,0;30,0;2,0;11,0;;8,0;1,0;61,0;;1,0;15,0;11,0;10,0;22,0;22,0;6,0;18,0;;;17,0;18,0;;;5,0;18,0;23,0;;;22,0;1,0;18,0;3,0;16,0;5,0;;6,0;18,0;11,0;5,0;6,0;;1,0;4,0;6,0;3,0;;16,0;;;7,0;4,0;;1,0;4,0;4,0;5,0;209,0;21,0;4,0;8,0;;37,0;;1,0;2,0;4,0;;1,0;;3,0;11,0;5,0;1,0;28,0;;;;14,0;17,0;7,0;11,0;30,0;59,0;5,0;5,0;;6,0;;15,0;;;2,0;;2,0;6,0;2,0;1,0;;;;;;1,0;;2,0;;;;;;6,0;;;;;;;9,0;;;;1,0;1,0;;2,0;;;;3,0;;2,0;1,0;1,0;1,0;;;;;4,0;2,0;;;3,0;;2,0;;6,0;;2,0;;10,0;5,0;1,0;;;;;;;5,0;6,0;;26,0;9,0;;1,0;1,0;;;1,0;;;;1,0;;1,0;;;;;1,0;;;;;9,0;;;;;7,0;3,0;6,0;1,0;;13,0;3,0;2,0;3,0;;;3,0;;;;;;;;;12,0;12,0;;1,0;2,0;;;11,0;;2,0;3,0;;;2,0;1,0;;;;;1,0;;2,0;9,0;;;4,0;;;;;;;;3,0;1,0;1,0;;4,0;;;;;;;2,0;1,0;;5,0;12,0;1,0;;;;17,0;6,0;10,0;;1,0;;5,0;5,0;1,0;;;;;2,0;;;;16,0;;;;;2,0;;;4,0;;;;;;;1,0;;1,0;;;2,0;;;;;1,0;;;1,0;;18,0;13,0;2,0;;;;15,0;;4,0;;10,0;5,0;3,0;15,0;;4,0;3,0;;;;1,0;2,0;;;;;;;;;65,0;;;;;;;;;;;2,0;10,0;;;;;;;;;;;;;;;9,0;1,0;5,0;;;;;1,0;12,0;;32,0;2,0;;11,0;;6,0;;2,0;;12,0;;2,0;;;;3,0;;;;;;;;;3,0;;3,0;;5,0;;11,0;;;;;;;2,0;28,0;;;;1,0;15,0;;;;;1,0;;;140,0;;;;37,0;;2,0;2,0;6,0;;;;1,0;1,0;3,0;5,0;3,0;33,0;;4,0;10,0;1,0;1,0;1,0;10,0;;;;;;;2,0;;;;;;;;13,0;;2,0;1,0;19,0;;20,0;2,0;1,0;2,0;;2,0;;7,0;2,0;;10,0;;;;;;1,0;6,0;;;1,0;;2,0;;2,0;3,0;;2,0;17,0;;;;;1,0;;2,0;6,0;;2,0;;;2,0;9,0;23,0;;;5,0;;2,0;;;1,0;;;;;;;;;;;;;;;;;;;;;;;;;;;;;;;;;;;;;;;;;;;;;;;;;;4,0;2,0;;;1,0;;;;;;;;1,0;1,0;;;;;;;;;2,0;;;;;;;;;;6,0;;;5,0;;;;;;;;3,0;;;;;;1,0;;;;2,0;1,0;;;;;;;2,0;;;;;;;;1,0;;2,0;;;;;;;;6,0;;;1,0;;;;;;;;;;;;;;12,0;;;;;;;;;;;;;;;;;;;1,0;1,0;;;;;;;2,0;;;;;;;;;1,0;;;;;;;;2,0;;1,0;;;;;;;;;;;;;;;;;;;;
audio;;1,0;;25,0;1,0;57,0;21,0;16,0;3,0;4,0;;;;101,0;;3,0;312,0;;73,0;11,0;1,0;;6,0;16,0;28,0;;;55,0;14,0;14,0;112,0;21,0;;6,0;;431,0;7,0;3,0;;2,0;53,0;167,0;;22,0;32,0;2,0;;1,0;;1,0;;;;7,0;3,0;;8,0;;67,0;61,0;;;1,0;;268,0;3,0;99,0;;;;1,0;14,0;5,0;;;;;;4,0;30,0;112,0;;68,0;;43,0;;;22,0;;1,0;5,0;13,0;1,0;21,0;4,0;;3,0;;40,0;3,0;17,0;31,0;;35,0;63,0;52,0;;9,0;;;;1,0;2,0;1,0;5,0;6,0;3,0;82,0;3,0;47,0;2,0;;771,0;1,0;9,0;79,0;137,0;;5,0;;95,0;;;29,0;;;8,0;5,0;;;;;;1,0;;5,0;1,0;;47,0;;;;3,0;;;;;;;;;9,0;25,0;12,0;2,0;;20,0;1,0;;7,0;2,0;;11,0;6,0;;;1,0;4,0;15,0;2,0;2,0;;;5,0;;;6,0;;8,0;3,0;;;;;;;8,0;5,0;4,0;;;;1,0;;;2,0;3,0;;3,0;4,0;;;;;6,0;2,0;98,0;;;;1,0;6,0;5,0;;;;33,0;;6,0;7,0;;;5,0;4,0;2,0;8,0;;;1,0;54,0;;;;;;47,0;6,0;;4,0;;;;;;;3,0;6,0;6,0;;;4,0;93,0;;20,0;;1,0;1,0;;4,0;;;1,0;;2,0;;;3,0;3,0;;1,0;4,0;;;1,0;;;;9,0;1,0;;;;;;;;1,0;;;;;;;;;;;;;8,0;;;3,0;;4,0;;1,0;1,0;;2,0;11,0;31,0;;;1,0;;;;15,0;;;;;;98,0;;;;5,0;;1,0;;;;;;30,0;1,0;;;;;;;2,0;;;;407,0;19,0;4,0;;;;1,0;2,0;4,0;;;;;;1,0;;6,0;;9,0;41,0;9,0;1,0;57,0;;;1,0;;86,0;1,0;3,0;;14,0;4,0;5,0;32,0;3,0;;4,0;2,0;12,0;7,0;1,0;;91,0;1,0;32,0;;4,0;2,0;7,0;13,0;1,0;;2,0;;2,0;10,0;9,0;;;;;3,0;5,0;1,0;2,0;;166,0;26,0;4,0;22,0;;45,0;;19,0;32,0;2,0;;14,0;9,0;9,0;11,0;1,0;;21,0;;1,0;3,0;;6,0;29,0;;;;1,0;;;;;1,0;;5,0;1,0;;;9,0;3,0;16,0;;;11,0;;7,0;2,0;15,0;5,0;5,0;;;4,0;1,0;;;;235,0;6,0;6,0;11,0;15,0;1,0;12,0;;1,0;1,0;15,0;3,0;8,0;;4,0;3,0;2,0;;;64,0;;3,0;5,0;;3,0;4,0;1,0;8,0;;23,0;4,0;;;1,0;;1,0;;;8,0;31,0;;;;;2,0;;;;;3,0;;;;;38,0;;2,0;16,0;1,0;;;4,0;;6,0;3,0;;5,0;;;;2,0;3,0;;2,0;;3,0;;1,0;11,0;2,0;8,0;1,0;;2,0;43,0;13,0;15,0;6,0;1,0;1,0;;;;;49,0;4,0;;1,0;;;1,0;2,0;8,0;1,0;;1,0;;18,0;10,0;1,0;1,0;;;1,0;;5,0;1,0;4,0;;3,0;2,0;7,0;14,0;21,0;;;;;7,0;2,0;;1,0;19,0;;;;3,0;;5,0;3,0;29,0;3,0;18,0;;;;;9,0;;;3,0;19,0;;;;;;7,0;3,0;;;;;8,0;2,0;;3,0;2,0;;15,0;14,0;;;;;;16,0;;1,0;1,0;11,0;1,0;2,0;;1,0;;;3,0;20,0;2,0;;1,0;;;;;9,0;;;;9,0;5,0;4,0;3,0;1,0;;;;;;16,0;;12,0;;2,0;;;;;;;;;;;6,0;;;;;;3,0;;1,0;;;;;47,0;;;6,0;1,0;;;;1,0;11,0;;;;;;4,0;1,0;4,0;;;1,0;;;;;;1,0;1,0;;;;;1,0;;;;;;;;;;3,0;4,0;;;;;5,0;1,0;2,0;;;;;;;;;1,0;;;;;;;1,0;;;;;1,0;;;4,0;;1,0;;17,0;;;1,0;;;;;;;;;;;;;;;;;;33,0;;2,0;;;;;3,0;;;;4,0;;2,0;;;;;;;;;;;;;;;;3,0;;;;;16,0;8,0;;;9,0;1,0;8,0;;;;;;21,0;;1,0;;;;;;;8,0;;2,0;10,0;;2,0;;2,0;21,0;;;;;;;;;12,0;;;6,0;;;5,0;;6,0;7,0;;2,0;;17,0;7,0;;;;;;;;4,0;;;1,0;;;;;;;;;2,0;;55,0;;;2,0;;;;1,0;;;;;7,0;;1,0;;;;;;;;;;;;;;;1,0;;;;4,0;30,0;;;;4,0;5,0;;;1,0;10,0;4,0;;;23,0;;;;1,0;;52,0;;;6,0;;;;3,0;;;;;1,0;;;;;;;
axis;;18,0;7,0;103,0;53,0;243,0;108,0;346,0;4,0;;42,0;;199,0;197,0;;2,0;81,0;;16,0;3,0;1,0;8,0;51,0;3,0;4,0;24,0;14,0;74,0;7,0;20,0;292,0;25,0;31,0;46,0;34,0;18,0;195,0;175,0;23,0;10,0;110,0;372,0;12,0;41,0;18,0;249,0;5,0;329,0;34,0;;2,0;5,0;342,0;6,0;86,0;124,0;122,0;5,0;1,0;15,0;;;105,0;;665,0;;277,0;13,0;2,0;64,0;163,0;2180,0;303,0;4,0;9,0;2,0;5,0;43,0;6,0;12,0;212,0;6,0;20,0;9,0;396,0;245,0;7,0;5188,0;23,0;31,0;29,0;5,0;120,0;11,0;13,0;;106,0;357,0;228,0;195,0;552,0;80,0;90,0;3,0;22,0;20,0;;6,0;;3,0;2,0;91,0;45,0;9,0;3,0;;2,0;75,0;21,0;380,0;5,0;7,0;28,0;13,0;;10,0;370,0;12,0;1,0;58,0;18,0;5,0;;491,0;8,0;;162,0;65,0;37,0;;2,0;7,0;;1,0;136,0;21,0;37,0;205,0;30,0;43,0;42,0;20,0;185,0;60,0;;;31,0;2,0;;;5,0;91,0;3,0;5,0;;1,0;98,0;49,0;8,0;47,0;28,0;13,0;39,0;2370,0;21,0;49,0;9,0;16,0;2,0;4,0;3,0;1,0;4,0;94,0;17,0;2,0;35,0;52,0;189,0;80,0;6,0;5,0;2,0;37,0;121,0;38,0;267,0;36,0;38,0;15,0;;4,0;29,0;4,0;41,0;9,0;363,0;1,0;98,0;226,0;290,0;209,0;77,0;;3,0;52,0;17,0;542,0;3,0;72,0;14,0;;;8,0;92,0;;417,0;3,0;9,0;21,0;8,0;3,0;77,0;5,0;18,0;;41,0;3,0;3,0;37,0;;73,0;215,0;30,0;4,0;17,0;19,0;51,0;232,0;17,0;11,0;3,0;11,0;120,0;24,0;17,0;199,0;304,0;10,0;;7,0;7,0;4,0;57,0;19,0;1,0;2,0;1,0;3,0;33,0;11,0;19,0;107,0;19,0;15,0;4,0;37,0;459,0;30,0;64,0;17,0;42,0;;26,0;;47,0;69,0;23,0;27,0;8,0;202,0;10,0;2,0;50,0;16,0;9,0;220,0;27,0;40,0;33,0;11,0;16,0;13,0;2,0;14,0;22,0;22,0;46,0;30,0;192,0;75,0;12,0;6,0;;8,0;6,0;66,0;42,0;18,0;53,0;23,0;68,0;63,0;12,0;4,0;4,0;23,0;2,0;44,0;5,0;37,0;6,0;7,0;9,0;7,0;10,0;16,0;2,0;9,0;9,0;442,0;721,0;150,0;46,0;3,0;14,0;16,0;110,0;;61,0;20,0;;4,0;;3,0;35,0;20,0;46,0;66,0;1,0;5,0;14,0;11,0;3,0;;46,0;3,0;22,0;4,0;8,0;16,0;5,0;39,0;282,0;46,0;6,0;4,0;4,0;5,0;6,0;78,0;91,0;;14,0;3,0;79,0;1,0;32,0;;;8,0;4,0;10,0;102,0;33,0;24,0;1,0;7,0;9,0;3,0;13,0;27,0;18,0;12,0;69,0;33,0;;14,0;46,0;99,0;14,0;134,0;3,0;9,0;32,0;57,0;391,0;29,0;3,0;;11,0;7,0;3,0;;1,0;69,0;10,0;15,0;9,0;193,0;29,0;;11,0;1,0;;49,0;12,0;22,0;3,0;;1,0;15,0;8,0;449,0;4,0;13,0;21,0;7,0;17,0;4,0;2,0;3,0;;39,0;51,0;;;15,0;2,0;9,0;9,0;16,0;3,0;4,0;4,0;;;;1,0;;5,0;6,0;5,0;12,0;34,0;59,0;53,0;15,0;1,0;;231,0;2,0;11,0;13,0;18,0;25,0;52,0;1,0;19,0;4,0;;;;56,0;2,0;9,0;5,0;2,0;;35,0;2,0;6,0;6,0;2,0;13,0;316,0;11,0;;;2,0;;13,0;;;5,0;4,0;15,0;28,0;2,0;;42,0;34,0;12,0;12,0;1,0;;16,0;4,0;4,0;;29,0;;7,0;35,0;274,0;1,0;5,0;2,0;5,0;5,0;;;57,0;47,0;;2,0;;2,0;4,0;;1,0;2,0;4,0;;;1,0;;2,0;4,0;;1,0;;13,0;2,0;;;32,0;5,0;;;;7,0;;4,0;190,0;98,0;;;10,0;2,0;;;62,0;4,0;14,0;9,0;30,0;;2,0;2,0;;;;;3,0;;;4,0;1,0;1,0;3,0;;;20,0;3,0;;;;12,0;;1,0;;2,0;18,0;;5,0;3,0;4,0;;27,0;;;3,0;2,0;;;130,0;;;;2,0;;3,0;;29,0;;;9,0;776,0;9,0;3,0;;19,0;24,0;;20,0;3,0;1,0;;;;;;1,0;7,0;1,0;1,0;4,0;4,0;14,0;17,0;1,0;;6,0;13,0;;;;17,0;;50,0;;13,0;;1,0;10,0;;3,0;34,0;;;1,0;;5,0;3,0;1,0;;16,0;18,0;12,0;4,0;55,0;;;2,0;44,0;4,0;12,0;;;3,0;;22,0;226,0;185,0;28,0;9,0;12,0;14,0;4,0;17,0;1,0;6,0;;13,0;26,0;;5,0;11,0;10,0;;4,0;;;8,0;47,0;81,0;18,0;18,0;;;5,0;6,0;34,0;350,0;;6,0;65,0;50,0;5,0;6,0;6,0;19,0;19,0;24,0;2,0;29,0;5,0;1,0;9,0;2,0;35,0;39,0;;8,0;23,0;2,0;38,0;2,0;9,0;29,0;62,0;1,0;5,0;2,0;;8,0;;;4,0;5,0;9,0;45,0;9,0;;10,0;;2,0;19,0;35,0;2,0;;1,0;3,0;9,0;8,0;10,0;17,0;;;;4,0;1,0;;;;3,0;;2,0;1,0;;;2,0;1,0;1,0;;;;4,0;;;2,0;;;;;1,0;22,0;;;2,0;17,0;;;17,0;4,0;1,0;2,0;;3,0;;;1,0;;2,0;1,0;;1,0;1,0;;;21,0;2,0;;;10,0;1,0;5,0;;1,0;3,0;4,0;8,0;14,0;12,0;;23,0;2,0;;;5,0;13,0;7,0;;;1,0;3,0;12,0;13,0;;1,0;12,0;50,0;5,0;14,0;;;;4,0;1,0;23,0;;;8,0;2,0;;;;2,0;5,0;;;;;;;11,0;;1,0;;;12,0;1,0;1,0;;5,0;2,0;;38,0;18,0;5,0;;1,0;;31,0;3,0;6,0;;;32,0;;5,0;37,0;;;2,0;61,0;;;19,0;;3,0;2,0;16,0;3,0;9,0;1,0;2,0;1,0;5,0;46,0;;15,0;3,0;4,0;;42,0;13,0;31,0;;1,0;25,0;;17,0;2,0;3,0;;;;;;;1,0;;4,0;;;41,0;6,0;1,0;15,0;;;;;;;6,0;;24,0;;7,0;21,0;;1,0;;7,0;;;17,0;5,0;24,0;;1,0;1,0;;;;;
balance;;1,0;;42,0;2,0;17,0;7,0;11,0;;;;;;52,0;21,0;7,0;14,0;2,0;;;1,0;;94,0;;;;2,0;5,0;;1,0;15,0;1,0;14,0;70,0;;15,0;1,0;;2,0;;32,0;28,0;;8,0;4,0;3,0;;18,0;;6,0;;;3,0;;3,0;;1,0;;;7,0;;2,0;1,0;;88,0;4,0;19,0;;2,0;;1,0;1,0;24,0;;;;;29,0;;4,0;44,0;;9,0;;25,0;;9,0;2,0;;;19,0;1,0;;1,0;6,0;;5,0;7,0;13,0;;25,0;10,0;;4,0;65,0;8,0;;1,0;;;1,0;;2,0;;;;1,0;6,0;;29,0;1,0;1,0;26,0;;;19,0;17,0;;1,0;;11,0;;;37,0;10,0;;;;;;;2,0;;;1,0;5,0;;5,0;1,0;3,0;;;1,0;;;;;;;2,0;;6,0;;;;;9,0;;2,0;1,0;6,0;;;1,0;;6,0;;1,0;;;;;1,0;;;2,0;6,0;;20,0;;5,0;;;;;1,0;;;1,0;;;1,0;;4,0;2,0;2,0;5,0;;2,0;10,0;;;1,0;;;;2,0;;;5,0;;;;;;;18,0;;;3,0;5,0;1,0;1,0;;2,0;;;;;2,0;;;;;;9,0;;1,0;7,0;;;;;;;;23,0;;;;;;4,0;2,0;;2,0;;;26,0;;;;2,0;;13,0;;2,0;;3,0;14,0;;1,0;;;;;;11,0;9,0;;;3,0;;;;;;;;;;;;;2,0;4,0;7,0;;;1,0;;;;;;;1,0;3,0;3,0;;2,0;6,0;3,0;;;;;2,0;;;;;;;8,0;;;;;;3,0;2,0;;;;1,0;1,0;4,0;;3,0;;;2,0;;;;;;7,0;;;;;;;47,0;1,0;;;15,0;;;13,0;13,0;3,0;;;;;;23,0;;;;1,0;4,0;3,0;4,0;;;;10,0;;12,0;3,0;21,0;;;;;;;;16,0;1,0;1,0;;;;1,0;;;;2,0;12,0;;;;;;;1,0;;8,0;;5,0;;2,0;;3,0;1,0;;29,0;;2,0;;;3,0;3,0;11,0;36,0;2,0;;;;;;;1,0;;;;;4,0;;1,0;;1,0;;;;;;;;;;;;;;6,0;1,0;;;;;;13,0;;;;;;;;74,0;;;;;;;;;;2,0;;;2,0;;2,0;4,0;;;1,0;7,0;;;1,0;;4,0;;;;;;;;;;;;;;;;;;;;6,0;2,0;;;;;;4,0;;;2,0;;;;1,0;1,0;;;;;;;;2,0;6,0;;;;;9,0;;;;;;;;1,0;;;4,0;;;;;;8,0;;;;;;;;;;;;;;;;2,0;;;;;;;;;;6,0;;;;5,0;30,0;;;;;;;;;;;;;;16,0;;;4,0;;;;;;;7,0;4,0;;;;;;;;;;1,0;;;;;;;;;;;;;;;3,0;;;;;;;;;;;;4,0;;;10,0;;;;;;;;;;;;;1,0;;;;;2,0;;3,0;;1,0;;2,0;;;;;;;;1,0;;;;41,0;;;;4,0;;;;;;1,0;;;;;;;9,0;;;;;;;;;;;2,0;;;;;;;;4,0;;;;49,0;;;;;1,0;;;;;;;;;;;;;;;;;;;;;;;;;;;;;;;7,0;;;;;;;1,0;;;;1,0;1,0;;;;;;30,0;;;5,0;;;2,0;;;;;;;;;;;;;;;;;;;;;;;4,0;;;1,0;1,0;;;;;;;;;;;;;;;1,0;1,0;;4,0;4,0;;;3,0;;;;;;;;;1,0;;;;;;;;;;1,0;;;;;;;;;;;;1,0;;;;;;;;;;;;;;;;;;6,0;;;;;;;;;;;;;1,0;1,0;;;;;;1,0;;;;;;;;10,0;;;;;;;1,0;;;;;;;;;;;;;;;;;;;;;;;;1,0;;;;;;;;;1,0;;;;;;;;;;;;;;;;;;;;;;;;
battery;;3,0;;2,0;2,0;34,0;;11,0;;;;;;25,0;;;5,0;4,0;2,0;;1,0;;4,0;12,0;10,0;;;35,0;;6,0;42,0;8,0;;;;7,0;1,0;3,0;;;20,0;63,0;3,0;9,0;20,0;30,0;;6,0;;;;;7,0;18,0;1,0;;7,0;;;;;;;;15,0;;59,0;;;1,0;;11,0;2,0;;;;;;;28,0;21,0;;4,0;;38,0;2,0;;;1,0;1,0;;1,0;1,0;;;;;;8,0;18,0;32,0;6,0;;5,0;2,0;29,0;;1,0;;;;;;6,0;10,0;;;3,0;;10,0;1,0;;6,0;6,0;;9,0;54,0;;;;6,0;;;42,0;;;1,0;;;;;7,0;1,0;;;;2,0;2,0;3,0;6,0;;;25,0;7,0;;71,0;;;;;;61,0;;1,0;9,0;;68,0;27,0;;;4,0;;1,0;2,0;;;2,0;;2,0;;13,0;;1,0;6,0;;;1,0;;;19,0;;1,0;;;7,0;;84,0;;14,0;8,0;;;;;;3,0;1,0;1,0;1,0;23,0;8,0;4,0;;;5,0;9,0;6,0;2,0;;1,0;;1,0;;;2,0;5,0;19,0;;5,0;;1,0;;1,0;;1,0;;;;3,0;;;1,0;;2,0;1,0;1,0;18,0;1,0;4,0;;3,0;;;4,0;;38,0;11,0;29,0;;;3,0;2,0;2,0;11,0;1,0;;;;2,0;;;8,0;1,0;1,0;1,0;1,0;5,0;1,0;;;6,0;;;17,0;;;3,0;25,0;15,0;3,0;;;;;;;1,0;1,0;;1,0;;;1,0;;;;1,0;8,0;;5,0;;4,0;9,0;;;;18,0;5,0;;5,0;4,0;;1,0;1,0;3,0;;;1,0;189,0;9,0;;;3,0;;1,0;;;;;;;;;;;5,0;;2,0;1,0;3,0;;;;;1,0;;1,0;;17,0;21,0;;;1,0;;;;;;;;;;;;;2,0;;;;;13,0;2,0;;1,0;;7,0;9,0;;;1,0;1,0;;;;2,0;2,0;8,0;;4,0;4,0;;5,0;13,0;28,0;1,0;3,0;;2,0;7,0;3,0;;;;13,0;2,0;2,0;;;;;;2,0;;1,0;;42,0;1,0;7,0;;;3,0;;;;;;13,0;1,0;;;2,0;11,0;16,0;3,0;1,0;3,0;;;5,0;;;18,0;6,0;;;;;;;;;1,0;;;2,0;;;;;;;20,0;;5,0;4,0;;;;;;;;6,0;2,0;7,0;2,0;1,0;;5,0;;;;;;4,0;;1,0;;;;;;1,0;;;;;;1,0;;;;16,0;;;24,0;;8,0;111,0;2,0;7,0;27,0;;1,0;;;8,0;;;;2,0;;1,0;1,0;;2,0;;;4,0;;1,0;;;9,0;;;;2,0;17,0;;1,0;4,0;;;;;;;1,0;;;1,0;5,0;;;;;;8,0;;;1,0;;;;1,0;;;;;1,0;;;4,0;;15,0;;6,0;;;;;;;3,0;;;;;;;;;;11,0;;1,0;9,0;;;;3,0;;;2,0;;;;1,0;7,0;2,0;;;;;;;;1,0;;;6,0;8,0;3,0;;;;;;;6,0;;;5,0;;1,0;;;;;;;;;;2,0;;1,0;;;1,0;;;2,0;1,0;;;;;;48,0;2,0;;15,0;;;1,0;;;;;;;5,0;3,0;1,0;5,0;;7,0;;;2,0;;;;9,0;;;1,0;;;;;1,0;1,0;1,0;;3,0;;;;;;;;5,0;;;;;3,0;;;;;2,0;;;1,0;1,0;;;;;;;;;;;;;;;1,0;;;3,0;;;;;1,0;17,0;;;;;11,0;;;;2,0;;1,0;;;;;;;;;;;;;6,0;;;;;;;;;;;;;;;;11,0;;;;;;;1,0;;;;;;;;;;;;;;;;;;;;;;;;;;;;;;;;;;;;;2,0;;;;;;;;;;;2,0;;;;1,0;;;;;;;3,0;;;;;;;;;;;;;;;;;;;;;2,0;;2,0;;;;;;;;;;;;;;1,0;2,0;;;8,0;;;;;1,0;;;;;;;;2,0;1,0;;;;;;;;;;;;;;;;;;;;4,0;;;;;;;;;;;1,0;;;;;2,0;;;2,0;;;;;;;;;;;;;;;;;;;;;;3,0;;;;;;;;;;;;;;;;;;2,0;;;;;;
become;;1,0;;1,0;3,0;2,0;;;;;;;1,0;6,0;;19,0;6,0;;;1,0;;;2,0;;;;;;;;8,0;;1,0;;;9,0;;;;;4,0;8,0;6,0;1,0;3,0;;;5,0;;2,0;;;;;8,0;;;;2,0;2,0;;;2,0;;42,0;;3,0;;;;;7,0;10,0;;;;2,0;;;;9,0;;3,0;;3,0;;;6,0;;;;;1,0;;8,0;;13,0;;2,0;7,0;1,0;18,0;;6,0;9,0;7,0;;;;;;;3,0;1,0;;;;;3,0;2,0;;;11,0;;;;8,0;10,0;;;5,0;;;11,0;;;2,0;2,0;2,0;;;;;;2,0;4,0;5,0;;;1,0;;1,0;2,0;;2,0;;;;;;2,0;2,0;;1,0;;;1,0;;2,0;;;;1,0;3,0;;;3,0;;;;;1,0;;;;1,0;;;;8,0;9,0;;;;4,0;;4,0;1,0;;;;2,0;19,0;1,0;;;3,0;;1,0;1,0;1,0;;;;;;31,0;3,0;;;;;;;;;9,0;;;;;;19,0;;1,0;;6,0;1,0;;;;;;;;4,0;;;10,0;;;;;;;1,0;;7,0;;;;;;1,0;;1,0;;6,0;4,0;2,0;;;;;;;4,0;1,0;;;;;4,0;;;;;2,0;;;;;;;;;;;;;;;;2,0;;;;;;8,0;;;4,0;;;;;;;;5,0;15,0;4,0;;;;;;6,0;;;;;;3,0;;1,0;;;;;;;;;;;;;;;;;;1,0;;8,0;;6,0;;;;;;;;;;;;;;3,0;;;1,0;;;;;6,0;1,0;;2,0;;4,0;;;;;;3,0;1,0;;;1,0;;;1,0;;;;;5,0;;4,0;;1,0;;;;1,0;;1,0;5,0;;;;8,0;;;;;2,0;;;;3,0;;;;;;;2,0;;;1,0;5,0;;2,0;6,0;1,0;;;;;1,0;7,0;;;8,0;;;;;;;;;1,0;;;;;;;;;;1,0;;2,0;;;;3,0;;2,0;;;;;;;;;;;;;;2,0;;;;;;;;;1,0;;;;;;;;;;;;;2,0;;;9,0;;;1,0;;;;;1,0;;;;;;;;1,0;1,0;;;;;3,0;;;;;;1,0;;;1,0;2,0;;;;;;4,0;;;;;;;;;;;;;;;;;;;;;;;;;;;;1,0;;;;;;;4,0;;;;;;;2,0;3,0;;4,0;;;;;2,0;;2,0;;2,0;;;;;;;;;;;2,0;2,0;2,0;;;;;;;;;;;;;1,0;;;;;1,0;;;;2,0;;;;;6,0;4,0;;;;;;;;;;;1,0;1,0;;;;;;;;;;;;;;;;1,0;;2,0;2,0;;4,0;;1,0;;;;;;1,0;;;4,0;6,0;;1,0;;;;;;2,0;;;;;;;;;;;;3,0;1,0;;;2,0;;;;;;;;;;;3,0;1,0;;;;;1,0;;;;;;;;;;;6,0;;;;;;1,0;;;;2,0;;;;;;;;;;;;;3,0;;4,0;;;;;;;;;;;;3,0;;;1,0;;;10,0;;;;2,0;;;;;;;;;3,0;;;;;;;12,0;;;;4,0;;2,0;;;;;;;;;;;;1,0;;;;;;;7,0;4,0;2,0;;;;2,0;;;;2,0;;;;;1,0;;2,0;;1,0;;;;;;;;;;;;;;;;;;;2,0;;;;1,0;;;3,0;1,0;2,0;;;;;;;;;;;;;;;;;;;;;;;;;;;;;3,0;;;;;;;;;1,0;;;;;;;;;;;6,0;;;;;;;;1,0;;;;;;1,0;;1,0;;;;;;;;;;;;;;;2,0;;;;;;1,0;;;;;;;2,0;;;;;;;;;;;;;;;;;;;;;;3,0;;
body;;171,0;;44,0;30,0;197,0;1,0;232,0;2,0;;7,0;8,0;44,0;175,0;1,0;3,0;94,0;;30,0;10,0;4,0;3,0;15,0;48,0;256,0;1,0;1,0;42,0;14,0;14,0;472,0;173,0;22,0;59,0;7,0;100,0;102,0;31,0;33,0;2,0;124,0;362,0;50,0;34,0;115,0;215,0;;152,0;;1,0;8,0;3,0;249,0;55,0;7,0;14,0;217,0;2,0;7,0;48,0;12,0;1,0;45,0;;442,0;2,0;767,0;5,0;9,0;10,0;48,0;1211,0;130,0;14,0;1,0;;59,0;2,0;;21,0;181,0;;27,0;131,0;220,0;129,0;2,0;152,0;6,0;7,0;5,0;57,0;54,0;20,0;71,0;5,0;5,0;31,0;173,0;249,0;448,0;89,0;35,0;19,0;32,0;43,0;1,0;7,0;2,0;2,0;1,0;70,0;52,0;1,0;20,0;5,0;;48,0;4,0;248,0;18,0;3,0;265,0;36,0;;51,0;410,0;;2,0;13,0;32,0;;;628,0;6,0;;47,0;3,0;10,0;1,0;20,0;42,0;2,0;;44,0;15,0;33,0;105,0;14,0;292,0;14,0;13,0;;132,0;;;23,0;2,0;;;43,0;365,0;1,0;3,0;4,0;1,0;298,0;235,0;1,0;40,0;19,0;4,0;17,0;255,0;8,0;94,0;34,0;7,0;21,0;6,0;1,0;2,0;39,0;178,0;25,0;6,0;26,0;22,0;114,0;200,0;7,0;12,0;70,0;83,0;70,0;98,0;423,0;2,0;104,0;48,0;5,0;16,0;10,0;4,0;16,0;2,0;247,0;35,0;35,0;847,0;63,0;77,0;7,0;1,0;14,0;114,0;62,0;33,0;9,0;39,0;8,0;31,0;12,0;;96,0;4,0;699,0;3,0;11,0;24,0;51,0;13,0;28,0;13,0;105,0;1,0;2,0;9,0;34,0;7,0;2,0;97,0;36,0;40,0;35,0;22,0;25,0;65,0;516,0;34,0;33,0;1,0;30,0;141,0;48,0;39,0;467,0;617,0;28,0;;21,0;115,0;21,0;269,0;182,0;20,0;4,0;;1,0;12,0;29,0;25,0;23,0;35,0;128,0;2,0;68,0;94,0;6,0;30,0;41,0;12,0;185,0;42,0;;148,0;46,0;50,0;95,0;7,0;37,0;19,0;59,0;197,0;8,0;47,0;50,0;5,0;32,0;112,0;16,0;23,0;17,0;6,0;15,0;39,0;51,0;20,0;19,0;115,0;15,0;11,0;122,0;33,0;47,0;8,0;129,0;23,0;11,0;103,0;46,0;61,0;55,0;11,0;13,0;20,0;10,0;;78,0;1,0;42,0;9,0;59,0;53,0;20,0;5,0;12,0;3,0;6,0;8,0;159,0;46,0;27,0;46,0;13,0;118,0;12,0;119,0;;40,0;15,0;34,0;;1,0;32,0;84,0;4,0;94,0;143,0;16,0;2,0;7,0;8,0;3,0;1,0;12,0;3,0;3,0;2,0;6,0;4,0;7,0;21,0;89,0;22,0;3,0;5,0;12,0;8,0;;245,0;68,0;18,0;8,0;;108,0;19,0;10,0;;3,0;;23,0;27,0;24,0;10,0;24,0;;12,0;21,0;2,0;6,0;46,0;29,0;40,0;2,0;33,0;;54,0;55,0;47,0;100,0;186,0;4,0;39,0;36,0;59,0;7,0;10,0;2,0;;;4,0;;5,0;;181,0;24,0;9,0;4,0;6,0;19,0;4,0;22,0;3,0;25,0;;50,0;42,0;43,0;16,0;5,0;141,0;11,0;46,0;;4,0;3,0;;136,0;;;12,0;7,0;12,0;16,0;25,0;1,0;10,0;7,0;6,0;3,0;5,0;;2,0;;;;2,0;3,0;3,0;4,0;8,0;23,0;56,0;62,0;19,0;14,0;33,0;;12,0;34,0;11,0;15,0;7,0;12,0;3,0;73,0;13,0;14,0;3,0;;1,0;6,0;41,0;13,0;21,0;12,0;21,0;;;;1,0;12,0;15,0;;16,0;;7,0;;;3,0;1,0;13,0;2,0;2,0;9,0;19,0;47,0;25,0;2,0;38,0;53,0;1,0;18,0;;;17,0;;19,0;;23,0;5,0;32,0;47,0;22,0;;5,0;9,0;10,0;8,0;;8,0;18,0;228,0;;19,0;;3,0;22,0;;3,0;13,0;3,0;1,0;27,0;;;2,0;16,0;;;9,0;1,0;1,0;1,0;137,0;3,0;2,0;2,0;18,0;;;;14,0;45,0;9,0;1,0;3,0;58,0;9,0;1,0;2,0;35,0;40,0;38,0;136,0;66,0;;2,0;12,0;18,0;1,0;;;32,0;;2,0;30,0;3,0;5,0;5,0;;2,0;24,0;1,0;;9,0;7,0;;4,0;;1,0;;11,0;4,0;49,0;99,0;16,0;;11,0;;3,0;1,0;;;;5,0;1,0;;;3,0;;5,0;1,0;;;2,0;24,0;31,0;2,0;3,0;;30,0;37,0;;6,0;;14,0;;16,0;;;;;1,0;15,0;2,0;1,0;;12,0;;25,0;;1,0;17,0;;;;2,0;1,0;19,0;;7,0;18,0;;3,0;1,0;;101,0;;;5,0;1,0;53,0;9,0;;3,0;;38,0;1,0;2,0;50,0;46,0;3,0;;328,0;2,0;16,0;37,0;143,0;4,0;4,0;4,0;77,0;75,0;29,0;16,0;29,0;25,0;3,0;7,0;5,0;15,0;3,0;20,0;4,0;27,0;34,0;306,0;9,0;;11,0;46,0;4,0;1,0;1,0;17,0;11,0;3,0;;;8,0;;12,0;105,0;;23,0;62,0;4,0;11,0;9,0;3,0;7,0;44,0;1,0;15,0;30,0;7,0;2,0;2,0;6,0;7,0;16,0;8,0;4,0;8,0;42,0;19,0;35,0;17,0;34,0;8,0;2,0;43,0;24,0;3,0;8,0;2,0;25,0;2,0;6,0;9,0;10,0;10,0;;2,0;6,0;;8,0;14,0;11,0;;6,0;3,0;47,0;2,0;3,0;5,0;;;;;2,0;;;;;;;2,0;1,0;1,0;;6,0;3,0;;;;10,0;10,0;2,0;;;;;2,0;;17,0;;1,0;;1,0;;;;;4,0;3,0;3,0;;1,0;;1,0;;;1,0;10,0;4,0;;;9,0;46,0;;;;14,0;3,0;2,0;;41,0;;9,0;;;;;3,0;;;50,0;7,0;;;4,0;;;;12,0;;15,0;2,0;;;6,0;1,0;1,0;;2,0;10,0;1,0;25,0;;2,0;4,0;;2,0;1,0;;1,0;4,0;;10,0;1,0;;;;2,0;;3,0;1,0;1,0;;1,0;2,0;;3,0;;5,0;18,0;2,0;;;1,0;4,0;7,0;;24,0;5,0;;9,0;5,0;18,0;4,0;1,0;;2,0;10,0;;2,0;4,0;3,0;3,0;;13,0;1,0;1,0;2,0;8,0;;;4,0;1,0;46,0;31,0;3,0;24,0;11,0;6,0;6,0;;1,0;5,0;5,0;3,0;2,0;8,0;1,0;;4,0;;1,0;1,0;;15,0;;22,0;1,0;4,0;26,0;1,0;;;10,0;;4,0;;;3,0;1,0;4,0;;;;2,0;2,0;;;3,0;;10,0;3,0;;2,0;;;;1,0;;;1,0
bracket;;1,0;;11,0;2,0;65,0;;110,0;;;;4,0;8,0;70,0;;;27,0;;19,0;;;;1,0;;3,0;;;9,0;1,0;1,0;77,0;4,0;;;;;9,0;11,0;;1,0;1,0;32,0;2,0;1,0;29,0;15,0;;25,0;;;;;61,0;2,0;2,0;;58,0;;;;1,0;;2,0;;53,0;;168,0;;;9,0;4,0;39,0;21,0;;;;13,0;;;;20,0;;;;151,0;20,0;7,0;2,0;;;;2,0;7,0;5,0;6,0;;;10,0;40,0;5,0;81,0;3,0;;;2,0;3,0;;;;;;;3,0;;;;;4,0;1,0;32,0;1,0;;3,0;2,0;;;110,0;;;1,0;;;;58,0;;;6,0;;;;;4,0;;;17,0;10,0;4,0;15,0;;199,0;2,0;11,0;50,0;34,0;;;;;;;7,0;102,0;;;;;56,0;42,0;;;1,0;;5,0;59,0;4,0;9,0;;;4,0;;;13,0;5,0;9,0;35,0;;13,0;14,0;2,0;23,0;;4,0;;8,0;3,0;29,0;115,0;2,0;22,0;2,0;;5,0;;;;;230,0;2,0;24,0;553,0;2,0;9,0;;;9,0;14,0;5,0;12,0;;1,0;;;4,0;;37,0;;221,0;1,0;7,0;;;;4,0;;21,0;;;;8,0;;;5,0;42,0;13,0;12,0;1,0;;88,0;37,0;27,0;19,0;;;41,0;;;104,0;111,0;6,0;;;1,0;;137,0;63,0;;;;;8,0;121,0;11,0;2,0;16,0;;;7,0;30,0;;4,0;140,0;;55,0;25,0;;;1,0;10,0;24,0;;;7,0;;2,0;2,0;3,0;2,0;3,0;1,0;35,0;17,0;6,0;4,0;;9,0;6,0;12,0;3,0;3,0;2,0;;2,0;4,0;;20,0;1,0;17,0;34,0;;21,0;10,0;;5,0;1,0;;2,0;;4,0;;4,0;1,0;;25,0;4,0;;2,0;1,0;;2,0;;28,0;38,0;3,0;20,0;3,0;33,0;;12,0;;25,0;;6,0;;;15,0;21,0;;12,0;1,0;;5,0;;;;;8,0;;;;;3,0;;;23,0;;;;1,0;;;12,0;;;3,0;;;;;;1,0;;;;1,0;7,0;;;;;;;1,0;2,0;4,0;2,0;7,0;;26,0;1,0;32,0;;7,0;;;1,0;4,0;2,0;;;;;;2,0;;;35,0;1,0;;;;1,0;;1,0;;2,0;;;;6,0;;;17,0;;23,0;;;1,0;;3,0;;;;;5,0;;2,0;;;2,0;1,0;2,0;;;4,0;;;;;;;;;1,0;1,0;13,0;1,0;;3,0;;;2,0;1,0;;1,0;1,0;;4,0;;2,0;;;;;2,0;;;;7,0;;;;;;;;12,0;35,0;;;;;;;;;;4,0;6,0;;;18,0;8,0;2,0;17,0;;;8,0;1,0;;;56,0;;2,0;23,0;10,0;;;;6,0;;;;;32,0;;;;1,0;;;2,0;2,0;;;;;;;;;17,0;;;1,0;;;;;;;;;;5,0;4,0;6,0;;;3,0;;2,0;;;;;8,0;7,0;;1,0;;;;;;1,0;;;;;1,0;;;;5,0;1,0;;;3,0;;;;;;;;1,0;;;;;;;;;;;;;;;1,0;;3,0;;;;;4,0;18,0;;4,0;1,0;2,0;2,0;;2,0;;;;2,0;;1,0;;;;10,0;;;;;;;;;;;;10,0;1,0;;2,0;5,0;14,0;;;;;;;;;;;6,0;;;;;;;1,0;;;;;28,0;;7,0;4,0;2,0;;;;16,0;10,0;5,0;22,0;;;1,0;;;24,0;;19,0;;;15,0;;;;1,0;27,0;;;;31,0;;;;9,0;;1,0;;22,0;;;11,0;;2,0;1,0;;;7,0;3,0;;5,0;;;;;;1,0;;;2,0;;;;;8,0;;1,0;;23,0;;;;;1,0;;12,0;10,0;;4,0;;;;16,0;3,0;1,0;;1,0;6,0;6,0;;;;;;;;;;;;;;;;;;;10,0;;;;;;;;;;;;;;;1,0;;;;;;;;;;;3,0;;;;;;;;2,0;;;;1,0;;;;;;;;;;;;;;;;;;;;;1,0;;;;;;;;;;;;3,0;1,0;;;;;;;;;;;1,0;;;;;1,0;1,0;;;;;;;;;;;;;;2,0;;6,0;;;;;;1,0;;3,0;;1,0;;;;;;;1,0;;;;;;;7,0;;;;1,0;;;;1,0;;;;;;;;;;;;;;;;;;;;;;;3,0;;;;;;;;;;;;;;;;;;;;;;;;;;;;;;;;;;;;
button;;2,0;;8,0;;16,0;;3,0;;5,0;;;1,0;8,0;;;30,0;1,0;;;;;1,0;1,0;3,0;;;1,0;5,0;;45,0;10,0;;;;12,0;6,0;;;2,0;4,0;53,0;;14,0;69,0;15,0;;3,0;;;;;4,0;3,0;;;2,0;;;10,0;;;7,0;10,0;32,0;;29,0;1,0;;;1,0;26,0;6,0;;;;;;;4,0;26,0;;23,0;;7,0;;;1,0;;;2,0;4,0;1,0;1,0;4,0;;;1,0;20,0;2,0;64,0;21,0;;3,0;2,0;19,0;;2,0;;;;1,0;;;;;;;;13,0;;;15,0;1,0;;16,0;19,0;;;;21,0;;;30,0;;;2,0;6,0;1,0;;;1,0;;;4,0;5,0;13,0;6,0;5,0;1,0;;;13,0;6,0;;2,0;;;;;;24,0;1,0;;;;39,0;17,0;1,0;4,0;;;;7,0;2,0;2,0;;;3,0;;;;2,0;5,0;33,0;9,0;;2,0;19,0;15,0;;1,0;;;5,0;23,0;58,0;;8,0;6,0;;;;;9,0;;14,0;1,0;3,0;12,0;4,0;2,0;;1,0;1,0;2,0;;;;1,0;;4,0;3,0;;10,0;4,0;50,0;3,0;1,0;;5,0;;2,0;;2,0;;;;7,0;;;1,0;8,0;3,0;;27,0;1,0;;31,0;18,0;5,0;;;5,0;;1,0;9,0;27,0;;;2,0;10,0;2,0;1,0;4,0;;;;;1,0;;;15,0;;1,0;;12,0;1,0;;;;;;4,0;;;3,0;10,0;5,0;1,0;;;;1,0;;2,0;;;;7,0;3,0;;1,0;;;1,0;4,0;1,0;1,0;10,0;;5,0;5,0;15,0;;;13,0;20,0;2,0;5,0;11,0;8,0;2,0;;15,0;;;;35,0;3,0;13,0;;15,0;1,0;14,0;;47,0;;;;8,0;7,0;;;;25,0;6,0;;;;;4,0;;;1,0;3,0;2,0;;39,0;6,0;;;;8,0;9,0;9,0;1,0;;;10,0;;;;1,0;1,0;;5,0;7,0;;;77,0;4,0;;;;11,0;;;;20,0;;;;4,0;7,0;6,0;;;6,0;4,0;;52,0;1,0;4,0;;4,0;;6,0;7,0;;;3,0;;27,0;18,0;1,0;;;;;;;;;;25,0;3,0;14,0;4,0;6,0;2,0;;2,0;13,0;4,0;1,0;2,0;2,0;28,0;;;6,0;;;;2,0;;;72,0;;;2,0;17,0;3,0;1,0;16,0;;;;;3,0;15,0;;;3,0;;;;;;14,0;4,0;3,0;33,0;1,0;1,0;;1,0;;1,0;;;2,0;;19,0;;9,0;13,0;4,0;;;;;;;2,0;30,0;;1,0;;;1,0;;21,0;;;;1,0;4,0;;4,0;;;1,0;1,0;6,0;;;2,0;;4,0;2,0;3,0;2,0;;;1,0;;;;;2,0;2,0;;;;;;;;;;;11,0;;19,0;;;8,0;2,0;1,0;1,0;;;2,0;15,0;1,0;14,0;;;;13,0;;;;;;1,0;3,0;1,0;;2,0;;7,0;5,0;6,0;;;;2,0;;;;7,0;5,0;2,0;;;;3,0;;;1,0;;;;;4,0;;1,0;;;;1,0;3,0;3,0;3,0;1,0;;;;;;;2,0;2,0;1,0;;;;7,0;;;9,0;;;;;;;1,0;;2,0;2,0;;;;1,0;;;;3,0;;;;4,0;;;;;;;;;;;;;;;;2,0;2,0;;107,0;;;;;;4,0;1,0;;2,0;;;;;;;;;1,0;;;9,0;;;1,0;4,0;;;1,0;3,0;1,0;;8,0;;;;;;;3,0;;1,0;;7,0;;;;2,0;1,0;;;2,0;;;;;6,0;;;;;;;;;;;;;;3,0;;;3,0;;;1,0;;;3,0;3,0;1,0;2,0;1,0;;;;;;4,0;;;;1,0;;1,0;6,0;;3,0;;7,0;;;;;;;49,0;3,0;1,0;;;;;;;;;;;3,0;;;;;;;;;;;;;;;;;;;;;;;;;;;;;;;;;;;;;;;;;;;;;;;;;;;;;5,0;;;;1,0;;;;;;;;;;;;;;;;;;;;;;;;;;;;;1,0;;;;;;;;;21,0;1,0;1,0;;;;;;;7,0;;;;;;1,0;3,0;5,0;;;;9,0;;5,0;6,0;;10,0;;;;;;;;;;;4,0;;;;;;;;;;;;;;;;;;4,0;;;;;;;;;;;;;;;;;;;;;;;;;;;;;;;;4,0;;;;;;;1,0;;;;;;;5,0;;;;;;;;;;;;;;;;;;;
cable;;4,0;;12,0;2,0;61,0;2,0;52,0;;;;;3,0;28,0;1,0;;1,0;2,0;6,0;;2,0;;4,0;3,0;15,0;;;35,0;14,0;;82,0;;;1,0;;75,0;6,0;2,0;;;3,0;69,0;20,0;1,0;20,0;20,0;;12,0;;;;31,0;53,0;6,0;7,0;;65,0;;5,0;3,0;;;7,0;;32,0;15,0;86,0;;;1,0;32,0;32,0;16,0;;;;13,0;;1,0;3,0;34,0;;9,0;;35,0;8,0;;42,0;2,0;;;6,0;27,0;;;;2,0;7,0;26,0;7,0;13,0;4,0;;;24,0;15,0;1,0;5,0;;;;;7,0;;6,0;;;4,0;;21,0;;;77,0;5,0;;7,0;110,0;;;;1,0;;1,0;65,0;;6,0;2,0;7,0;1,0;;;2,0;;;9,0;1,0;6,0;16,0;2,0;27,0;1,0;9,0;40,0;;;21,0;4,0;;;;18,0;268,0;;1,0;;;63,0;2,0;;15,0;1,0;;;53,0;3,0;4,0;10,0;2,0;;;3,0;;2,0;;1,0;1,0;1,0;1,0;6,0;4,0;;1,0;1,0;23,0;20,0;37,0;59,0;;15,0;15,0;1,0;3,0;1,0;;;;10,0;20,0;3,0;38,0;;9,0;7,0;;;34,0;16,0;5,0;;4,0;4,0;;;1,0;3,0;7,0;245,0;1,0;2,0;;1,0;1,0;4,0;;8,0;;2,0;;5,0;;3,0;39,0;;1,0;54,0;4,0;2,0;18,0;24,0;5,0;9,0;;;26,0;1,0;6,0;45,0;69,0;7,0;;3,0;35,0;;11,0;8,0;;6,0;;;2,0;;41,0;8,0;5,0;1,0;2,0;24,0;;;1,0;10,0;;4,0;20,0;;3,0;39,0;4,0;25,0;;3,0;4,0;2,0;2,0;2,0;13,0;2,0;;14,0;1,0;3,0;;43,0;;;4,0;7,0;37,0;2,0;44,0;;2,0;7,0;;;;4,0;;1,0;3,0;5,0;;13,0;6,0;;;;14,0;55,0;8,0;3,0;7,0;1,0;20,0;7,0;;1,0;;2,0;;7,0;3,0;5,0;4,0;;9,0;;;;1,0;1,0;;;;1,0;57,0;;8,0;68,0;22,0;;;;;2,0;2,0;;1,0;;;3,0;;;;4,0;2,0;;;;;51,0;7,0;;;1,0;10,0;3,0;1,0;;;;;;1,0;;13,0;2,0;3,0;8,0;;;8,0;4,0;1,0;;11,0;;20,0;14,0;9,0;;2,0;;3,0;2,0;2,0;;;;;;1,0;;;1,0;142,0;1,0;4,0;1,0;;4,0;;6,0;5,0;1,0;;5,0;;11,0;3,0;;14,0;;2,0;;;;;6,0;6,0;;;;31,0;1,0;4,0;;;2,0;1,0;13,0;8,0;;;2,0;;;;;;;;;7,0;12,0;13,0;;5,0;;1,0;;;;2,0;9,0;;5,0;5,0;;;;;8,0;;1,0;3,0;3,0;6,0;;;;10,0;;;;1,0;21,0;;;;2,0;;7,0;;3,0;37,0;1,0;2,0;7,0;16,0;56,0;146,0;;;;;11,0;1,0;;;;;9,0;54,0;1,0;2,0;;;5,0;;;;;23,0;;;4,0;;13,0;;;;;;2,0;;;3,0;;;3,0;1,0;13,0;;;;2,0;;3,0;1,0;;;;;1,0;;;;1,0;1,0;;;2,0;;6,0;;4,0;;;1,0;9,0;;;;7,0;;;;3,0;;;;;6,0;3,0;;;;;;1,0;2,0;;22,0;;;;;;;;;;1,0;;;6,0;;;;55,0;2,0;;47,0;1,0;;;5,0;7,0;;1,0;;2,0;;4,0;;;;;;;;;;;6,0;2,0;;;;;3,0;3,0;;;;1,0;1,0;14,0;;7,0;1,0;5,0;;;;;;;;;1,0;;26,0;1,0;1,0;;;;2,0;1,0;;1,0;;;9,0;;;;;;;;2,0;3,0;9,0;1,0;;;;;13,0;6,0;;2,0;;;4,0;;;;;13,0;;;;10,0;;1,0;;2,0;;;;18,0;1,0;8,0;11,0;;13,0;;7,0;;2,0;1,0;;;;1,0;;;;;;1,0;;;;5,0;3,0;5,0;6,0;;;;3,0;;;;;;;1,0;;1,0;;;;2,0;2,0;;2,0;;;;2,0;;;1,0;;;;;;;;1,0;;;;;2,0;2,0;;;;;;3,0;;;;;;;;1,0;;;;;;;;;;;;;;;;;;;;2,0;56,0;;23,0;;11,0;;1,0;;;;;;;;;;;;;2,0;;;;;1,0;;;;;;;;8,0;;;;;;;7,0;;;;2,0;1,0;;;;;;;;;;;;;;;;;1,0;;1,0;;;;;;6,0;;7,0;;;;1,0;;1,0;;;;;;12,0;1,0;;;;;;1,0;;;;5,0;;6,0;;;;;;;1,0;1,0;;1,0;;7,0;;;;;;1,0;;;;;;;;;7,0;;;;;;;1,0;;;;;1,0;;;;;;;;;;;;;;;;;;;4,0;;;;;;;;
carriage;;3,0;;2,0;;2,0;;11,0;;;2,0;;;3,0;;;;;;;;;;;;;;;;;7,0;;;;;;1,0;1,0;;;4,0;37,0;;;;3,0;;36,0;;;;;3,0;;;;4,0;3,0;;2,0;;;;;;;2,0;;;3,0;1,0;61,0;;;;;1,0;;;;2,0;;;;3,0;14,0;;12,0;;3,0;;4,0;;;;;;2,0;;2,0;46,0;;;3,0;;;;;;;;;1,0;;;;;;;6,0;;;;;;;9,0;;;;;;;3,0;;;;;;;1,0;4,0;;;;2,0;;4,0;;45,0;;1,0;148,0;;;;;;;;1,0;16,0;;;;;2,0;3,0;;;;;;22,0;;;5,0;;;;;;;;;;;3,0;1,0;1,0;;;;12,0;;;23,0;;15,0;;;;;1,0;;;6,0;;6,0;49,0;29,0;37,0;;;;22,0;;2,0;;2,0;;;;;7,0;;;2,0;2,0;;1,0;;;;3,0;;;;;;;2,0;;4,0;;;;;13,0;;2,0;;;9,0;;;46,0;;;;;;;2,0;;;;;2,0;;;;21,0;2,0;;;11,0;;;2,0;;;47,0;;;;;;3,0;;;;;;;;;;1,0;5,0;1,0;;;;;;;2,0;;;;;;;;;;1,0;3,0;5,0;1,0;;4,0;;;;;;5,0;;1,0;;15,0;;;;5,0;;;;9,0;10,0;;;;4,0;2,0;2,0;;3,0;;;;;18,0;2,0;;6,0;;;;;;;;;;;1,0;;;5,0;;;1,0;;;;;;;;;;;;;;;;;;;3,0;;;;;;;6,0;;;;1,0;;;;1,0;8,0;101,0;7,0;;4,0;;;;;;;;;;;;6,0;;;1,0;1,0;2,0;;;;;;;;3,0;;;;;4,0;;2,0;;4,0;;;;6,0;;;1,0;;;;;;;;;;;;;;;;;;;;;3,0;;;;;5,0;;;1,0;3,0;;6,0;;;;;;;;;;;;;;;;2,0;3,0;;2,0;;;4,0;;;;;;10,0;;;1,0;;;1,0;;;;;;;;;;10,0;;;6,0;4,0;;;;;;;;;5,0;;;;;;;;;;;;;;;;;;;;;;;;;;;;2,0;;;1,0;5,0;;;;;;;;3,0;9,0;;;;;;;;;;;;;;;;;;;;;;;;;;;;;;;;;;;;;;;;;;;;;;;;;;;;;;;5,0;;;;1,0;;;;;;;;;;;;;;1,0;;;;;;;;;;;2,0;;;;2,0;;;;;;;;;;;4,0;;7,0;;;1,0;2,0;;;;;;8,0;;;;;;;;13,0;1,0;4,0;;1,0;;;;;;;8,0;;;;;;;;;;;1,0;;;;;;;;;17,0;;;;;;;;;;;;;;;;;;2,0;;3,0;;;;4,0;;;;;;;;;;;;;;;1,0;;;;;;;;;;;;;;;;;;;;;;;;;;;;;;;;;;;;;;;;;;;;;;;;;;;;;2,0;;;;;;;;;;;;;;;;;;;;;;;;;;;;;;;;;;;;;;;;;;;;;;;;;;;;;;12,0;;;;;;;;;;;;;;;;;;;;;;;;;2,0;;;;;;;;;;;1,0;;;1,0;;15,0;;;;;2,0;;;;;9,0;;;;2,0;;;;;;;;9,0;;;;;14,0;;;;;;;;;;;;;;;;;;;;;;;;;;;;;;;;;;;;;;;;;;;1,0;;;;;;;;
carry;;2,0;;7,0;6,0;10,0;5,0;32,0;;;;;10,0;16,0;;1,0;40,0;;7,0;2,0;;;4,0;1,0;15,0;3,0;2,0;4,0;24,0;;62,0;14,0;1,0;4,0;;31,0;3,0;1,0;6,0;4,0;7,0;94,0;4,0;12,0;10,0;2,0;1,0;11,0;;;8,0;;7,0;4,0;2,0;;6,0;;16,0;13,0;;;;1,0;65,0;;23,0;1,0;;;3,0;81,0;27,0;;;;1,0;9,0;;1,0;92,0;;8,0;3,0;17,0;9,0;;15,0;;3,0;13,0;1,0;1,0;;1,0;;13,0;9,0;22,0;25,0;21,0;1,0;;26,0;23,0;23,0;3,0;9,0;;1,0;;9,0;;;;1,0;;1,0;;35,0;4,0;1,0;97,0;;;7,0;70,0;;5,0;;14,0;;5,0;25,0;;3,0;6,0;2,0;1,0;;;5,0;1,0;;4,0;;4,0;4,0;8,0;5,0;;1,0;38,0;4,0;;4,0;;;;;5,0;19,0;;;;2,0;35,0;2,0;;7,0;2,0;2,0;;2,0;;1,0;5,0;;4,0;;4,0;2,0;;;;;7,0;;9,0;5,0;;;1,0;1,0;3,0;;34,0;;;;;2,0;6,0;2,0;12,0;8,0;20,0;1,0;;34,0;3,0;8,0;1,0;;;4,0;6,0;3,0;;11,0;;4,0;4,0;;28,0;;23,0;;1,0;2,0;;4,0;1,0;;;;2,0;;;;;;;;1,0;5,0;1,0;1,0;3,0;3,0;;;;39,0;5,0;1,0;10,0;19,0;;;3,0;8,0;6,0;14,0;4,0;;;;;1,0;;8,0;3,0;3,0;1,0;1,0;6,0;1,0;1,0;3,0;5,0;1,0;14,0;11,0;;9,0;12,0;2,0;19,0;;3,0;9,0;;2,0;;1,0;22,0;1,0;;14,0;1,0;1,0;1,0;2,0;;;7,0;;1,0;25,0;1,0;;;1,0;2,0;1,0;1,0;1,0;;10,0;13,0;27,0;1,0;1,0;4,0;;;;18,0;9,0;;;;;3,0;;;;;;11,0;1,0;;;2,0;3,0;4,0;2,0;;2,0;;11,0;2,0;;2,0;1,0;2,0;4,0;16,0;5,0;;;;;;4,0;2,0;;;;;;3,0;1,0;;;;5,0;7,0;1,0;55,0;3,0;8,0;1,0;;6,0;8,0;;;3,0;;14,0;;14,0;;3,0;;4,0;;1,0;;9,0;2,0;5,0;1,0;;;;1,0;2,0;13,0;2,0;;13,0;50,0;3,0;;;;;1,0;;1,0;7,0;2,0;8,0;;;2,0;;3,0;;22,0;3,0;3,0;;3,0;7,0;2,0;;;1,0;4,0;;2,0;2,0;;1,0;22,0;;;1,0;1,0;1,0;11,0;;;2,0;2,0;3,0;18,0;;;;;;18,0;2,0;;;;;23,0;3,0;;;;2,0;1,0;11,0;13,0;5,0;;3,0;2,0;;2,0;2,0;2,0;2,0;;2,0;;;;;2,0;1,0;2,0;1,0;;7,0;2,0;1,0;3,0;;;;;;8,0;;5,0;;2,0;7,0;;6,0;;6,0;22,0;4,0;1,0;1,0;11,0;3,0;4,0;;2,0;;2,0;;;1,0;1,0;;;4,0;;4,0;;1,0;;9,0;;;;;;;;1,0;2,0;;4,0;6,0;;3,0;;;;;;;1,0;;1,0;;11,0;1,0;;;;;;1,0;;1,0;;;;;4,0;6,0;;1,0;;;3,0;;5,0;4,0;;;1,0;;1,0;;1,0;7,0;7,0;1,0;;2,0;;;;;;4,0;;;;10,0;1,0;;3,0;;2,0;1,0;1,0;1,0;;;;;;;;;6,0;;3,0;5,0;;5,0;;;3,0;6,0;1,0;;;5,0;;;1,0;;;;;;1,0;2,0;;;;;3,0;;5,0;;;;12,0;;1,0;;;;12,0;;;2,0;;2,0;;2,0;6,0;;9,0;2,0;1,0;8,0;;;1,0;;;;;;;3,0;;1,0;;;;;;;;4,0;6,0;;;;;1,0;1,0;5,0;;;1,0;1,0;2,0;4,0;2,0;;;;;;;;;1,0;;;;;;;7,0;1,0;;1,0;;;;;;3,0;;;;2,0;;;;;;;;;;;;;;;;1,0;;;11,0;;;;;;;1,0;1,0;;;;;;1,0;1,0;;;;;;;;;;;1,0;;;;4,0;;;;4,0;;;2,0;;;;2,0;3,0;2,0;;;;;8,0;;;2,0;;;;;;;;;;26,0;;;;;;;;2,0;;3,0;;;;;;1,0;1,0;1,0;;;;14,0;;;;;;;;;;;;;;1,0;;5,0;;8,0;;5,0;;;1,0;13,0;2,0;2,0;;;;;;;1,0;;;;;;;;;;1,0;1,0;;;9,0;15,0;;;;;;;;;;3,0;;;;1,0;;;;;;;;;;1,0;;;1,0;;2,0;3,0;;;;;2,0;;;;;;;1,0;8,0;3,0;;1,0;;;;;;;2,0;;;;;4,0;1,0;3,0;1,0;;;5,0;6,0;;;;;;;;;;;;;;;;;;;;;;;;;;5,0;;;;;;;;;3,0;;
case;;6,0;2,0;11,0;18,0;55,0;1,0;8,0;;;4,0;8,0;11,0;90,0;1,0;16,0;40,0;2,0;2,0;;2,0;;109,0;4,0;8,0;;1,0;22,0;3,0;6,0;58,0;8,0;4,0;9,0;1,0;15,0;10,0;11,0;2,0;;24,0;290,0;;3,0;30,0;52,0;;27,0;3,0;;1,0;;31,0;40,0;2,0;2,0;123,0;;1,0;3,0;1,0;;34,0;;130,0;;92,0;6,0;3,0;3,0;24,0;214,0;26,0;1,0;;;42,0;1,0;;3,0;79,0;;81,0;1,0;120,0;20,0;;44,0;;1,0;1,0;1,0;6,0;4,0;10,0;8,0;13,0;10,0;15,0;9,0;102,0;26,0;;;16,0;7,0;2,0;5,0;4,0;;;9,0;32,0;4,0;23,0;;2,0;1,0;1,0;30,0;;;47,0;12,0;1,0;5,0;23,0;3,0;;23,0;39,0;4,0;;155,0;1,0;;11,0;3,0;12,0;;3,0;4,0;;;22,0;20,0;13,0;8,0;;26,0;2,0;1,0;50,0;26,0;1,0;4,0;;;;;19,0;42,0;;2,0;;;102,0;75,0;7,0;25,0;7,0;3,0;1,0;44,0;;104,0;;11,0;5,0;;;;15,0;41,0;9,0;1,0;6,0;7,0;33,0;100,0;2,0;4,0;4,0;14,0;56,0;24,0;34,0;1,0;28,0;11,0;5,0;45,0;9,0;2,0;1,0;3,0;63,0;3,0;47,0;75,0;3,0;19,0;4,0;;5,0;30,0;23,0;11,0;1,0;;6,0;9,0;7,0;;5,0;3,0;269,0;1,0;7,0;;18,0;1,0;10,0;2,0;27,0;4,0;9,0;;3,0;;4,0;100,0;2,0;4,0;3,0;8,0;4,0;29,0;114,0;16,0;9,0;;;11,0;8,0;18,0;39,0;116,0;14,0;;1,0;7,0;4,0;28,0;29,0;4,0;;;9,0;15,0;13,0;12,0;13,0;2,0;1,0;;8,0;26,0;;2,0;18,0;1,0;23,0;17,0;;;11,0;;18,0;4,0;4,0;15,0;;4,0;12,0;8,0;6,0;6,0;7,0;3,0;3,0;;2,0;2,0;;13,0;2,0;4,0;5,0;29,0;1,0;;43,0;2,0;2,0;;15,0;2,0;8,0;3,0;90,0;42,0;14,0;3,0;7,0;2,0;18,0;;17,0;4,0;10,0;1,0;;2,0;9,0;2,0;2,0;;4,0;4,0;20,0;24,0;;1,0;48,0;5,0;2,0;9,0;;9,0;;;;1,0;3,0;3,0;;66,0;25,0;1,0;;3,0;;4,0;5,0;6,0;5,0;2,0;;5,0;;;5,0;7,0;22,0;5,0;;;4,0;;63,0;2,0;;;;40,0;17,0;7,0;;25,0;;1,0;3,0;25,0;1,0;3,0;1,0;3,0;7,0;;;12,0;6,0;33,0;1,0;4,0;;6,0;8,0;4,0;;22,0;1,0;12,0;25,0;6,0;;;;;;14,0;4,0;;1,0;98,0;1,0;3,0;2,0;2,0;4,0;;16,0;7,0;9,0;;10,0;7,0;16,0;;;21,0;3,0;2,0;;1,0;;2,0;25,0;;;7,0;2,0;2,0;;25,0;1,0;4,0;1,0;1,0;1,0;;1,0;;;2,0;;;;;;4,0;19,0;13,0;18,0;8,0;;;;;6,0;1,0;2,0;3,0;;1,0;28,0;;7,0;1,0;;1,0;;1,0;1,0;4,0;13,0;;;;;;4,0;4,0;2,0;4,0;1,0;1,0;1,0;;9,0;;10,0;2,0;;2,0;1,0;18,0;1,0;;5,0;8,0;;16,0;4,0;;10,0;;5,0;;1,0;;2,0;17,0;1,0;;9,0;1,0;1,0;4,0;;4,0;6,0;183,0;;1,0;;3,0;1,0;3,0;4,0;10,0;2,0;;11,0;4,0;;;;;;17,0;8,0;;2,0;;1,0;;;;;;;9,0;3,0;;;1,0;;7,0;11,0;;;4,0;2,0;;;3,0;3,0;4,0;;;2,0;8,0;;;1,0;;;;;;;7,0;;;;23,0;;;;;;;1,0;8,0;;;;;;;;;3,0;;;;;;2,0;;;5,0;;;6,0;;2,0;1,0;39,0;;13,0;;;1,0;2,0;74,0;;2,0;4,0;;;5,0;;1,0;;1,0;;1,0;;1,0;2,0;;5,0;;;1,0;1,0;3,0;3,0;;;;;1,0;;;7,0;;7,0;3,0;;10,0;;2,0;10,0;;14,0;;2,0;10,0;1,0;;;12,0;1,0;2,0;2,0;13,0;;;2,0;10,0;40,0;1,0;1,0;22,0;2,0;2,0;12,0;;1,0;;3,0;4,0;5,0;11,0;11,0;1,0;;;2,0;9,0;;7,0;4,0;;;2,0;1,0;8,0;;;6,0;;1,0;4,0;1,0;14,0;8,0;24,0;7,0;;;4,0;;7,0;1,0;;;1,0;;;;1,0;1,0;5,0;4,0;;2,0;4,0;;1,0;5,0;3,0;;3,0;5,0;;14,0;2,0;;;;;1,0;;14,0;3,0;;;;;10,0;;5,0;34,0;;;;;2,0;;;;2,0;;;;1,0;;;11,0;;;1,0;;5,0;3,0;;;1,0;;;6,0;;5,0;;3,0;;;;;;;;3,0;2,0;;;;1,0;;4,0;;;;;3,0;7,0;9,0;1,0;;;1,0;;;2,0;;;;;;4,0;;;;;;;;3,0;4,0;;;;2,0;;;;1,0;;;7,0;;;1,0;1,0;;;3,0;;;;;7,0;;;;1,0;3,0;;;;7,0;;1,0;;;;;;;1,0;1,0;3,0;3,0;;;;;;;;;;;;1,0;;3,0;1,0;;;;4,0;;;;;;;9,0;;3,0;;2,0;;1,0;2,0;;;;;;10,0;2,0;;;;1,0;;1,0;;;;;;;1,0;;3,0;;;1,0;;;8,0;;;;3,0;;;52,0;4,0;;;;;;;;;;;;;;;;;;1,0;;;1,0;;
cavity;;6,0;;1,0;;7,0;25,0;37,0;;;2,0;4,0;10,0;55,0;;;14,0;2,0;11,0;;;;;5,0;;;;18,0;;;43,0;2,0;;;;1,0;101,0;1,0;5,0;;3,0;70,0;4,0;2,0;13,0;104,0;;37,0;;;;;51,0;12,0;;;112,0;;2,0;14,0;;;;;68,0;;93,0;2,0;;4,0;9,0;79,0;53,0;1,0;;;10,0;;;4,0;25,0;;;1,0;57,0;2,0;;20,0;;;;22,0;5,0;3,0;;;;2,0;48,0;4,0;84,0;1,0;2,0;;;2,0;;;;;;;34,0;;2,0;;;;;63,0;;;;10,0;1,0;;26,0;;;11,0;1,0;;;8,0;2,0;;3,0;;;;;15,0;;;15,0;9,0;7,0;13,0;3,0;38,0;3,0;5,0;136,0;44,0;;;3,0;;;;5,0;22,0;;1,0;;;15,0;43,0;1,0;;8,0;;1,0;9,0;;3,0;;23,0;1,0;;;;2,0;20,0;;;5,0;;7,0;17,0;;;7,0;6,0;1,0;17,0;72,0;;13,0;50,0;6,0;4,0;;;;;52,0;2,0;7,0;102,0;3,0;5,0;;;;13,0;1,0;1,0;2,0;22,0;;;1,0;;28,0;5,0;99,0;8,0;1,0;2,0;19,0;1,0;;;3,0;;;;4,0;1,0;4,0;11,0;2,0;2,0;32,0;;6,0;25,0;33,0;11,0;6,0;3,0;3,0;12,0;70,0;1,0;25,0;168,0;4,0;;;8,0;;;18,0;;;5,0;2,0;26,0;;5,0;2,0;12,0;12,0;;4,0;;;1,0;3,0;3,0;9,0;10,0;;;4,0;;13,0;3,0;;3,0;6,0;16,0;6,0;3,0;2,0;;;26,0;;2,0;8,0;;;;3,0;11,0;10,0;9,0;;5,0;41,0;;;9,0;28,0;30,0;1,0;11,0;2,0;3,0;2,0;;1,0;8,0;;;16,0;1,0;10,0;3,0;1,0;26,0;;;2,0;;2,0;7,0;6,0;;6,0;;;22,0;;8,0;;24,0;1,0;;;;;4,0;;22,0;18,0;;4,0;;;1,0;;;;;;;2,0;;;3,0;4,0;;;;;1,0;2,0;;;;;2,0;;;;;;;;1,0;3,0;3,0;5,0;;;;;;11,0;1,0;;4,0;;;;2,0;;3,0;;1,0;;;;3,0;;;;;;2,0;;91,0;;;;;;;;;;;;;;;;;;;;;18,0;;2,0;;1,0;6,0;1,0;;1,0;15,0;;;;;;2,0;;3,0;2,0;;;;;;;1,0;;1,0;39,0;8,0;8,0;;2,0;7,0;1,0;;1,0;7,0;;2,0;;2,0;;;;;;7,0;;2,0;;2,0;;;1,0;;;;;19,0;;3,0;;;1,0;;2,0;;3,0;3,0;11,0;10,0;2,0;;70,0;5,0;;1,0;;;6,0;6,0;17,0;;4,0;;2,0;3,0;2,0;;;;;;;;;58,0;;5,0;;11,0;8,0;;;;;;;;;;;;;;;;;;3,0;;1,0;;;;;2,0;11,0;7,0;;;11,0;9,0;;;;;1,0;;1,0;;;6,0;;;;2,0;3,0;;;6,0;;;;;;;;;;2,0;;3,0;6,0;;;;;;;;;;;;;;;;5,0;;;;;;;;3,0;;;2,0;4,0;;;;1,0;3,0;;1,0;;;;9,0;;;;;;4,0;;;;;;;;;1,0;;;;;;18,0;;;;;2,0;;;;;;1,0;;;;;;16,0;19,0;;;8,0;;;;7,0;5,0;2,0;;;15,0;;4,0;;;5,0;1,0;23,0;;;;;5,0;;1,0;1,0;;;;;;;8,0;;;;6,0;;2,0;;;;;;7,0;;2,0;10,0;;18,0;;;;11,0;;;2,0;;;;;;;2,0;;;14,0;;46,0;11,0;2,0;;;30,0;;;2,0;;18,0;;;;7,0;4,0;1,0;;1,0;3,0;5,0;;;;2,0;;2,0;;;2,0;;;;;;;;;;;;;;;;;2,0;;;;5,0;;;;5,0;;;;3,0;;;;;2,0;;;;;;;;3,0;;;;;;;;;1,0;;;2,0;;;;;;;;;2,0;;8,0;;;;;;;1,0;;;1,0;;;;;;;;;;;;;;;;;26,0;;;;;;;;;;;;4,0;;;;;;1,0;;;;;;;;;;;;;2,0;;1,0;;2,0;1,0;1,0;;;;;;;;;;1,0;1,0;;;;2,0;;5,0;;;;;;;;;;;;;12,0;;;;;;;;;;;;;;1,0;;;1,0;;13,0;2,0;;;;;;;1,0;;;;;;;;;;;;;;;;7,0;;;;3,0;;;;;;
center;;1,0;;15,0;13,0;51,0;81,0;84,0;;1,0;4,0;8,0;13,0;136,0;;;81,0;1,0;8,0;;3,0;80,0;4,0;;3,0;;9,0;26,0;5,0;1,0;77,0;5,0;5,0;22,0;;53,0;67,0;13,0;6,0;;95,0;153,0;13,0;19,0;92,0;52,0;34,0;45,0;5,0;7,0;57,0;1,0;87,0;1,0;56,0;11,0;65,0;;1,0;35,0;4,0;11,0;17,0;1,0;681,0;;87,0;13,0;1,0;7,0;46,0;418,0;76,0;1,0;4,0;;35,0;;1,0;8,0;116,0;2,0;2,0;16,0;51,0;35,0;;274,0;1,0;2,0;18,0;5,0;108,0;12,0;12,0;;158,0;42,0;146,0;261,0;352,0;21,0;11,0;4,0;14,0;30,0;;7,0;;46,0;1,0;81,0;156,0;10,0;1,0;4,0;;40,0;41,0;154,0;9,0;1,0;10,0;9,0;;25,0;105,0;;1,0;27,0;40,0;4,0;2,0;44,0;9,0;;61,0;61,0;20,0;;;16,0;;5,0;62,0;3,0;120,0;63,0;37,0;13,0;7,0;19,0;89,0;19,0;;;1,0;2,0;;;7,0;49,0;1,0;6,0;6,0;;46,0;24,0;10,0;5,0;13,0;31,0;18,0;128,0;33,0;57,0;2,0;1,0;4,0;1,0;;3,0;2,0;82,0;1,0;6,0;36,0;11,0;59,0;41,0;;14,0;1,0;6,0;13,0;64,0;56,0;2,0;18,0;8,0;3,0;24,0;;;26,0;5,0;77,0;4,0;28,0;108,0;20,0;23,0;83,0;;1,0;23,0;37,0;42,0;62,0;33,0;13,0;1,0;2,0;21,0;82,0;4,0;219,0;;4,0;1,0;2,0;5,0;21,0;11,0;21,0;1,0;4,0;12,0;1,0;11,0;;19,0;8,0;12,0;2,0;35,0;7,0;23,0;114,0;3,0;3,0;;6,0;10,0;10,0;;104,0;126,0;11,0;;3,0;1,0;6,0;30,0;15,0;2,0;;30,0;30,0;19,0;3,0;5,0;7,0;4,0;2,0;;2,0;122,0;7,0;;6,0;;282,0;24,0;6,0;;10,0;7,0;7,0;12,0;35,0;15,0;4,0;12,0;9,0;20,0;200,0;2,0;1,0;10,0;1,0;4,0;;;9,0;5,0;9,0;7,0;2,0;71,0;5,0;2,0;5,0;4,0;53,0;2,0;149,0;6,0;1,0;9,0;11,0;63,0;17,0;2,0;19,0;41,0;21,0;5,0;6,0;;2,0;1,0;2,0;5,0;2,0;7,0;;;;1,0;34,0;48,0;12,0;3,0;2,0;8,0;6,0;20,0;1,0;3,0;;6,0;3,0;2,0;13,0;8,0;18,0;12,0;37,0;;22,0;2,0;2,0;;;8,0;;10,0;;;6,0;1,0;34,0;;2,0;2,0;4,0;;6,0;;37,0;210,0;;3,0;4,0;14,0;5,0;22,0;;;3,0;3,0;8,0;10,0;3,0;7,0;1,0;65,0;8,0;1,0;;15,0;4,0;6,0;;149,0;5,0;3,0;11,0;4,0;5,0;32,0;;3,0;13,0;20,0;10,0;;;;1,0;;2,0;2,0;4,0;22,0;8,0;7,0;;7,0;7,0;;6,0;3,0;29,0;6,0;7,0;19,0;3,0;;;3,0;16,0;13,0;;10,0;12,0;3,0;43,0;3,0;;6,0;;16,0;29,0;;;76,0;;2,0;7,0;;;1,0;14,0;;;;;;5,0;13,0;4,0;16,0;2,0;1,0;4,0;1,0;1,0;3,0;29,0;4,0;;4,0;3,0;8,0;12,0;;7,0;2,0;2,0;;5,0;17,0;;3,0;15,0;;;4,0;3,0;3,0;;10,0;23,0;38,0;5,0;;;6,0;;3,0;1,0;;1,0;;;24,0;4,0;;31,0;7,0;;15,0;;;;1,0;1,0;;2,0;1,0;6,0;13,0;50,0;;8,0;2,0;16,0;14,0;2,0;4,0;4,0;65,0;;29,0;1,0;;2,0;;2,0;2,0;1,0;;;1,0;;1,0;;;2,0;5,0;;1,0;1,0;;4,0;;;;;1,0;;;34,0;24,0;;1,0;13,0;10,0;13,0;;3,0;;1,0;3,0;3,0;;;4,0;;;;7,0;6,0;;2,0;;3,0;3,0;;;;15,0;;1,0;;2,0;;;2,0;;9,0;1,0;;;21,0;;;20,0;;;8,0;24,0;7,0;;12,0;;;1,0;;;3,0;;1,0;;;;26,0;11,0;;4,0;1,0;10,0;3,0;;;;;;;;3,0;1,0;2,0;2,0;1,0;16,0;9,0;8,0;19,0;;;2,0;4,0;;3,0;;1,0;1,0;21,0;;;;;11,0;;1,0;74,0;;7,0;12,0;;6,0;;;2,0;12,0;2,0;;;23,0;;;;16,0;;13,0;1,0;;;;2,0;28,0;28,0;;2,0;3,0;;4,0;3,0;;9,0;;1,0;7,0;;13,0;;6,0;;2,0;1,0;;2,0;9,0;3,0;17,0;25,0;;3,0;2,0;12,0;3,0;64,0;;3,0;30,0;13,0;9,0;7,0;4,0;8,0;3,0;6,0;5,0;3,0;1,0;;;6,0;13,0;2,0;2,0;1,0;24,0;6,0;4,0;2,0;4,0;5,0;1,0;;13,0;6,0;;;;4,0;9,0;4,0;;170,0;;;;;3,0;2,0;3,0;2,0;;;;18,0;2,0;5,0;21,0;;;;;5,0;;;;14,0;;2,0;;;;1,0;9,0;7,0;;8,0;;12,0;7,0;;1,0;;5,0;;1,0;2,0;;;;2,0;23,0;;;15,0;;;2,0;;;1,0;;;;;2,0;;;;;;6,0;;;;;3,0;;;;1,0;19,0;;;;2,0;18,0;;;2,0;;7,0;11,0;8,0;;;3,0;4,0;;;;;3,0;;19,0;;;;1,0;1,0;18,0;;;1,0;9,0;;;;3,0;7,0;;4,0;4,0;;;;1,0;;;2,0;;6,0;;14,0;1,0;1,0;;;10,0;6,0;;;;2,0;1,0;;6,0;;;9,0;;;3,0;;;;2,0;;14,0;22,0;;;4,0;17,0;5,0;8,0;;;;1,0;1,0;2,0;11,0;1,0;;;;4,0;;;4,0;13,0;;40,0;1,0;3,0;1,0;;;;;;13,0;1,0;2,0;;;16,0;29,0;;3,0;;10,0;3,0;;2,0;3,0;5,0;;;;15,0;13,0;2,0;40,0;;1,0;;;;5,0;5,0;;1,0;;;1,0;;;
change;;7,0;3,0;25,0;229,0;97,0;2,0;8,0;;6,0;;1,0;10,0;311,0;8,0;23,0;139,0;4,0;67,0;22,0;;1,0;65,0;4,0;26,0;5,0;13,0;18,0;19,0;68,0;231,0;86,0;16,0;22,0;1,0;95,0;7,0;18,0;54,0;;324,0;247,0;2,0;11,0;133,0;7,0;;36,0;;5,0;42,0;;;2,0;75,0;50,0;11,0;;21,0;50,0;1,0;6,0;28,0;;586,0;3,0;81,0;16,0;3,0;;77,0;227,0;137,0;9,0;133,0;27,0;10,0;6,0;2,0;5,0;186,0;;143,0;4,0;69,0;9,0;;104,0;2,0;25,0;84,0;2,0;8,0;1,0;24,0;2,0;65,0;32,0;94,0;70,0;359,0;111,0;;10,0;41,0;73,0;1,0;12,0;12,0;2,0;3,0;62,0;116,0;4,0;;5,0;24,0;12,0;79,0;99,0;6,0;5,0;192,0;115,0;17,0;29,0;121,0;;8,0;10,0;210,0;6,0;;260,0;5,0;;95,0;4,0;34,0;;;6,0;1,0;1,0;57,0;67,0;66,0;3,0;46,0;;;6,0;22,0;6,0;2,0;9,0;3,0;;1,0;;3,0;11,0;17,0;;17,0;3,0;5,0;5,0;7,0;42,0;4,0;;5,0;173,0;;11,0;5,0;10,0;3,0;2,0;3,0;;1,0;16,0;4,0;16,0;27,0;35,0;76,0;9,0;;2,0;1,0;8,0;3,0;;9,0;17,0;;3,0;;5,0;5,0;3,0;51,0;9,0;37,0;;12,0;18,0;34,0;75,0;5,0;;;1,0;41,0;1,0;13,0;11,0;38,0;61,0;;1,0;4,0;1,0;44,0;46,0;;3,0;;19,0;95,0;23,0;3,0;2,0;8,0;15,0;;41,0;3,0;5,0;7,0;1,0;;30,0;4,0;27,0;4,0;1,0;3,0;;;11,0;1,0;8,0;6,0;30,0;4,0;;10,0;36,0;2,0;127,0;;;4,0;12,0;12,0;4,0;2,0;8,0;9,0;1,0;3,0;;4,0;177,0;;11,0;;2,0;46,0;4,0;1,0;1,0;6,0;22,0;25,0;;11,0;31,0;;;11,0;;123,0;34,0;;1,0;;;;11,0;;;3,0;13,0;2,0;54,0;;1,0;4,0;;2,0;;1,0;9,0;1,0;11,0;45,0;160,0;10,0;2,0;;;12,0;2,0;41,0;;;1,0;;;23,0;;3,0;;;;20,0;59,0;9,0;;;;21,0;15,0;;;;;10,0;;26,0;1,0;16,0;3,0;54,0;12,0;15,0;4,0;3,0;13,0;4,0;25,0;20,0;10,0;;4,0;;;64,0;2,0;;41,0;;16,0;36,0;22,0;181,0;29,0;3,0;;9,0;319,0;51,0;18,0;3,0;19,0;15,0;14,0;8,0;121,0;2,0;51,0;;56,0;48,0;8,0;2,0;46,0;6,0;61,0;10,0;61,0;5,0;33,0;38,0;25,0;6,0;87,0;2,0;13,0;84,0;184,0;;26,0;37,0;3,0;3,0;203,0;3,0;4,0;1,0;76,0;5,0;126,0;15,0;12,0;26,0;;129,0;;50,0;17,0;16,0;54,0;36,0;3,0;117,0;19,0;68,0;36,0;;12,0;;1,0;110,0;16,0;3,0;51,0;8,0;5,0;;;6,0;9,0;3,0;2,0;31,0;3,0;12,0;2,0;;4,0;;4,0;;24,0;15,0;16,0;26,0;9,0;;;11,0;5,0;9,0;2,0;13,0;4,0;;4,0;5,0;7,0;60,0;12,0;3,0;8,0;12,0;3,0;;15,0;1,0;26,0;28,0;11,0;4,0;;;21,0;2,0;14,0;21,0;6,0;2,0;3,0;3,0;2,0;6,0;13,0;1,0;;1,0;4,0;;13,0;3,0;3,0;9,0;3,0;2,0;7,0;4,0;2,0;;2,0;6,0;;1,0;15,0;8,0;9,0;2,0;4,0;11,0;;10,0;13,0;;8,0;7,0;7,0;;7,0;;2,0;6,0;5,0;1,0;;6,0;13,0;28,0;4,0;21,0;2,0;;;1,0;27,0;;18,0;20,0;;3,0;2,0;;7,0;1,0;2,0;9,0;12,0;4,0;1,0;4,0;9,0;;;3,0;;9,0;4,0;;4,0;12,0;6,0;3,0;;;1,0;;3,0;;;;1,0;12,0;;2,0;1,0;13,0;35,0;10,0;2,0;;;18,0;8,0;4,0;6,0;3,0;9,0;;;;1,0;;;2,0;2,0;39,0;26,0;;6,0;;4,0;;9,0;;3,0;2,0;2,0;;25,0;1,0;;4,0;45,0;;25,0;;2,0;55,0;4,0;1,0;4,0;18,0;;1,0;1,0;35,0;;11,0;7,0;17,0;;1,0;19,0;;9,0;4,0;1,0;10,0;;;;;6,0;37,0;;7,0;41,0;1,0;7,0;;;28,0;10,0;7,0;1,0;;5,0;4,0;14,0;2,0;;4,0;6,0;;;9,0;14,0;;6,0;9,0;6,0;;;4,0;;12,0;32,0;41,0;;3,0;1,0;;16,0;2,0;;;;5,0;34,0;6,0;2,0;8,0;8,0;1,0;1,0;;6,0;41,0;1,0;3,0;;2,0;6,0;;1,0;3,0;1,0;58,0;1,0;4,0;;3,0;;19,0;;3,0;;;4,0;4,0;8,0;;;;;;2,0;;;1,0;15,0;;;;4,0;;1,0;;1,0;;;;;41,0;;8,0;;1,0;;;;3,0;;;;;8,0;5,0;1,0;;7,0;;2,0;3,0;2,0;9,0;3,0;3,0;;8,0;2,0;20,0;;;;6,0;93,0;;6,0;2,0;5,0;4,0;;12,0;;;;;4,0;2,0;5,0;2,0;2,0;14,0;15,0;2,0;8,0;4,0;;;9,0;3,0;;1,0;1,0;16,0;;5,0;13,0;;3,0;;;1,0;;43,0;;;3,0;;;;3,0;1,0;;4,0;9,0;2,0;8,0;7,0;1,0;;1,0;5,0;7,0;;3,0;2,0;;4,0;2,0;1,0;;5,0;11,0;15,0;9,0;;1,0;;3,0;15,0;3,0;2,0;3,0;3,0;2,0;;1,0;;3,0;;;3,0;;;6,0;1,0;;4,0;1,0;3,0;2,0;;;;2,0;6,0;;;4,0;9,0;;1,0;4,0;;;6,0;;1,0;;1,0;;4,0;4,0;;;10,0;2,0;23,0;1,0;21,0;4,0;2,0;;;;3,0;;3,0;1,0;1,0;;;;;;;;;14,0;;13,0;;3,0;14,0;;15,0;;;;;22,0;;1,0;3,0;;8,0;;2,0;;2,0;5,0;7,0;;;;;;37,0;2,0;1,0;4,0;;2,0;;4,0;13,0;;3,0;;;;17,0;;1,0;;3,0;23,0;;1,0;;
changing;;1,0;1,0;28,0;8,0;14,0;2,0;1,0;;;;;;18,0;;11,0;40,0;;8,0;15,0;;;29,0;;6,0;1,0;;7,0;3,0;22,0;25,0;7,0;;5,0;1,0;23,0;;11,0;3,0;;4,0;66,0;;20,0;55,0;1,0;;7,0;;2,0;;;;;10,0;13,0;2,0;;1,0;4,0;;;13,0;;154,0;;57,0;;;3,0;11,0;38,0;50,0;8,0;29,0;;4,0;;;;90,0;;51,0;;18,0;2,0;;25,0;;6,0;12,0;;5,0;;5,0;1,0;15,0;1,0;37,0;27,0;52,0;23,0;;2,0;29,0;3,0;;1,0;14,0;;1,0;8,0;47,0;;;;5,0;2,0;10,0;20,0;10,0;5,0;15,0;31,0;;;30,0;;2,0;3,0;31,0;;;55,0;1,0;;33,0;13,0;26,0;;;3,0;;;4,0;10,0;14,0;4,0;5,0;;;2,0;3,0;;;1,0;1,0;;;;;5,0;2,0;;2,0;;2,0;8,0;1,0;10,0;1,0;;;31,0;;;1,0;6,0;2,0;;;;;9,0;;1,0;5,0;;17,0;;3,0;;;4,0;;;2,0;2,0;;;;;;;1,0;1,0;5,0;;19,0;3,0;17,0;4,0;;;;1,0;7,0;2,0;1,0;;7,0;2,0;;;;;9,0;;;1,0;;4,0;15,0;5,0;;2,0;;1,0;;1,0;;;2,0;;;17,0;;9,0;2,0;;;;;;2,0;;;13,0;1,0;;;12,0;1,0;8,0;;;;6,0;5,0;1,0;3,0;;6,0;;;;3,0;32,0;;1,0;;;6,0;1,0;2,0;;;5,0;;;;3,0;;;;;13,0;4,0;4,0;;;;;;;;;4,0;3,0;15,0;;;;;;;;4,0;1,0;3,0;7,0;25,0;;;;;11,0;;16,0;2,0;;;;;3,0;;;;10,0;2,0;2,0;14,0;3,0;;;;;3,0;;;;;;;11,0;1,0;1,0;;22,0;;6,0;5,0;;3,0;;8,0;;3,0;;2,0;1,0;;12,0;2,0;41,0;;;4,0;2,0;1,0;42,0;11,0;;;1,0;13,0;3,0;4,0;7,0;2,0;;1,0;2,0;28,0;;6,0;;;2,0;;;9,0;;10,0;;35,0;;6,0;7,0;10,0;14,0;3,0;;4,0;73,0;20,0;;;1,0;;;30,0;4,0;;1,0;11,0;1,0;10,0;;2,0;;;44,0;1,0;30,0;;2,0;17,0;35,0;;12,0;5,0;9,0;11,0;;;;4,0;15,0;2,0;1,0;13,0;;3,0;1,0;2,0;;7,0;;;4,0;;;4,0;;10,0;;;2,0;;;21,0;8,0;4,0;;;;;2,0;;;;1,0;2,0;;1,0;25,0;;;;5,0;;2,0;;;5,0;17,0;;2,0;1,0;1,0;7,0;;2,0;2,0;3,0;;;;2,0;;3,0;;;1,0;;;3,0;2,0;2,0;;2,0;;;;;;3,0;;;1,0;9,0;;2,0;2,0;;1,0;3,0;2,0;;;;3,0;1,0;3,0;;;;;8,0;;;1,0;;1,0;;;;;;;39,0;;2,0;2,0;;17,0;;1,0;4,0;;;;;;;2,0;1,0;;;;;;2,0;;;;;;;;;;5,0;;2,0;;;2,0;;24,0;;;;;;2,0;2,0;;;;;;2,0;;;1,0;;;;;1,0;5,0;13,0;;;;;;3,0;;;;3,0;;;;;1,0;17,0;1,0;2,0;;;3,0;1,0;;;14,0;;;;5,0;;6,0;1,0;4,0;1,0;1,0;3,0;;1,0;;;4,0;;;;;3,0;25,0;;;3,0;;;;;6,0;;;;;3,0;;1,0;;;;1,0;1,0;;;;;;4,0;;;;;;;3,0;1,0;;;;;6,0;1,0;;3,0;;;15,0;2,0;;1,0;;;;;1,0;;2,0;4,0;;2,0;7,0;;;;2,0;11,0;3,0;;;;;6,0;;;;;;;;;;;;;;;;;1,0;5,0;5,0;;;;;;;;;;;8,0;;3,0;;;;1,0;;1,0;;;;;;2,0;;;1,0;1,0;;2,0;;;;;;1,0;;;;;;2,0;24,0;;1,0;;;2,0;2,0;;;;;;;;3,0;;1,0;13,0;1,0;;;;2,0;;;1,0;;;;;;;3,0;1,0;;;;;;2,0;;;1,0;;2,0;;2,0;;1,0;;;;;1,0;;;;;12,0;1,0;1,0;;;1,0;;;;1,0;;;2,0;;;;1,0;;4,0;;;;;;;;;;;;;;;;5,0;;1,0;;;;3,0;2,0;1,0;;;;;1,0;;;;;;;;;;;;;;;;;;;1,0;1,0;1,0;;;;;7,0;;;1,0;;;;;;;;;;6,0;;;;;;;4,0;;;;;6,0;;;;;;;;;;;;;;;;;16,0;;;;1,0;;;1,0;11,0;;;;;;;;;;;6,0;;;;
characterize;;2,0;;1,0;;5,0;3,0;4,0;;12,0;;;;6,0;;1,0;15,0;;;1,0;;;8,0;;;;;18,0;4,0;10,0;5,0;1,0;1,0;;2,0;29,0;5,0;2,0;1,0;;5,0;40,0;3,0;3,0;;;1,0;11,0;;;;;;1,0;12,0;6,0;5,0;;3,0;12,0;1,0;;10,0;;42,0;;21,0;1,0;1,0;1,0;2,0;46,0;6,0;;1,0;3,0;2,0;;;33,0;61,0;2,0;25,0;2,0;70,0;;;10,0;;;11,0;;1,0;;1,0;;5,0;4,0;6,0;11,0;14,0;2,0;;4,0;14,0;2,0;;;4,0;;;11,0;2,0;;;;1,0;2,0;8,0;16,0;3,0;;4,0;;1,0;4,0;28,0;;;1,0;4,0;;;6,0;11,0;;13,0;1,0;2,0;;;1,0;;;;1,0;6,0;2,0;3,0;;1,0;4,0;2,0;1,0;;;;;;4,0;2,0;11,0;;;;;;6,0;;;;;;7,0;;;3,0;;;;;;;3,0;;;4,0;8,0;4,0;1,0;;;;1,0;;3,0;20,0;;;;;;;;4,0;6,0;;;;7,0;4,0;9,0;3,0;;;;9,0;;;8,0;;;;;1,0;;;2,0;;;;3,0;3,0;;;1,0;;;;1,0;;1,0;;;3,0;21,0;;1,0;7,0;1,0;;;;14,0;2,0;2,0;1,0;15,0;;;1,0;2,0;1,0;2,0;1,0;;;4,0;;3,0;;;1,0;3,0;;;;9,0;;12,0;;;5,0;;7,0;10,0;7,0;;;1,0;9,0;;;;2,0;1,0;6,0;;6,0;;4,0;;;;;;;;6,0;2,0;1,0;;;;;8,0;3,0;;2,0;;1,0;31,0;;;;;;;2,0;;;;1,0;;4,0;;1,0;;;5,0;;;;;;;3,0;1,0;;;;;;;5,0;;;2,0;18,0;1,0;;;;4,0;;;1,0;;;;;;10,0;1,0;1,0;1,0;1,0;;1,0;;5,0;;;;;4,0;;;;2,0;4,0;;2,0;2,0;;8,0;;1,0;1,0;;4,0;6,0;1,0;;1,0;;;1,0;2,0;2,0;;3,0;;8,0;;9,0;;;;;;;;1,0;2,0;3,0;2,0;4,0;;;;;1,0;;;;4,0;1,0;5,0;;6,0;1,0;4,0;2,0;;4,0;;1,0;2,0;;;;1,0;2,0;;;;7,0;;;3,0;1,0;;;;;;;;;;;1,0;2,0;;6,0;;2,0;;1,0;;;1,0;1,0;;;3,0;1,0;;;;;5,0;;;;;;;1,0;;;1,0;;;;;;1,0;1,0;;;1,0;;;;;3,0;;2,0;2,0;4,0;;;;;;;;;;;1,0;2,0;;;;;;;;;;3,0;;1,0;;;1,0;8,0;;1,0;;;;1,0;;;;;1,0;;11,0;;;;;;;;3,0;1,0;;;1,0;;4,0;1,0;;;;;;3,0;2,0;3,0;;;;;;;;;;;;;2,0;;;1,0;;5,0;;1,0;;;;;;;;;;;1,0;1,0;;;;;11,0;2,0;;;2,0;;;;;;;3,0;;;;;;;;;;;;;;;;;;;;1,0;5,0;;;;;;;;;3,0;;;;;6,0;;1,0;;1,0;;;;;1,0;4,0;;;;;2,0;;;;;;;2,0;;;;;4,0;;;;;;;;1,0;9,0;;;1,0;;1,0;;;;;;6,0;;;;1,0;;;;;;;;;;1,0;;;;;1,0;;2,0;1,0;;;1,0;;;;;;;3,0;;;;;;;2,0;;;;;;;;;;;;1,0;;;;2,0;1,0;4,0;;;;;;1,0;;;;;;1,0;1,0;;2,0;;;;;;;;;;1,0;34,0;;;;;5,0;;;;;;;1,0;;;;1,0;;;1,0;;2,0;;;;;;5,0;;1,0;1,0;;;;;;;;;;;;;;;;;;1,0;;;;;2,0;;;2,0;;;;;;;1,0;;;;;;;2,0;;;;2,0;1,0;1,0;1,0;;;3,0;;;2,0;;;;6,0;;;;;;;2,0;;;;;;10,0;;;;;;;1,0;;;;2,0;;;;;;;;;;;;;;;;;;;2,0;;;4,0;;;1,0;;;;;;;;4,0;;;1,0;;1,0;;1,0;10,0;3,0;;;;;;;;;;;;;2,0;;;;1,0;;;;;;;;;;9,0;1,0;;;;;1,0;4,0;;;;;;;;;1,0;1,0;1,0;;;
charge;;2,0;;2,0;50,0;24,0;1,0;;;;;;;29,0;;;4,0;3,0;27,0;;;;2,0;;1,0;;;28,0;;3,0;202,0;1,0;3,0;;;13,0;;;14,0;1,0;8,0;95,0;;9,0;1,0;2,0;;65,0;;;;;5,0;11,0;2,0;;78,0;;;165,0;;;14,0;;30,0;;65,0;;3,0;;;14,0;70,0;;;1,0;;1,0;;13,0;20,0;;;;20,0;;;21,0;;;;4,0;2,0;;;4,0;131,0;;67,0;3,0;20,0;8,0;;26,0;1,0;22,0;;;;;;13,0;221,0;2,0;;;;15,0;;40,0;;3,0;432,0;;;32,0;34,0;;;;10,0;;;113,0;3,0;;4,0;;;4,0;;3,0;8,0;;;8,0;30,0;42,0;12,0;8,0;3,0;;;;;;;;;;;34,0;;36,0;211,0;;30,0;3,0;;23,0;4,0;;;18,0;;;87,0;4,0;2,0;;11,0;;9,0;1,0;;13,0;1,0;;1,0;;;;;64,0;;1,0;4,0;37,0;2,0;1,0;7,0;5,0;1,0;;;;4,0;;22,0;1,0;;1,0;;;2,0;1,0;64,0;;1,0;20,0;2,0;14,0;;349,0;;4,0;127,0;;6,0;1,0;;;4,0;;;;;;;;;;;;;9,0;;;8,0;;1,0;;;;23,0;20,0;4,0;33,0;;;275,0;13,0;24,0;14,0;;;2,0;;;;;4,0;1,0;2,0;;;1,0;;;;;;;1,0;;;1,0;4,0;32,0;;7,0;;;;;;6,0;;;;;;;;;;;;;29,0;;;;;;3,0;;;2,0;7,0;9,0;3,0;6,0;7,0;1,0;;2,0;;83,0;;;;;;;;;;;;;3,0;1,0;;;;;;;;;;2,0;3,0;1,0;;16,0;;2,0;8,0;;;;;;;;;;;;;3,0;;9,0;1,0;;1,0;;;84,0;;3,0;;1,0;22,0;1,0;8,0;1,0;;;1,0;1,0;;;;;;6,0;;;17,0;5,0;48,0;;1,0;;12,0;1,0;3,0;;2,0;;1,0;7,0;2,0;;;;;2,0;1,0;1,0;60,0;;54,0;;10,0;;;3,0;;1,0;;3,0;;22,0;6,0;38,0;;;10,0;19,0;;;;;1,0;4,0;;;57,0;3,0;;;71,0;;2,0;;;3,0;;;;24,0;;;;;;;3,0;2,0;11,0;;;;;;;;;3,0;;1,0;1,0;28,0;;;;;;;1,0;;;;;;;;;;;;13,0;;4,0;2,0;;;4,0;2,0;;;3,0;;;;;4,0;8,0;;;;;3,0;;1,0;;;;;17,0;11,0;;1,0;;;1,0;;2,0;;9,0;;;;;28,0;;;;;;;3,0;;;;;;5,0;;;;;;;;;;;;;;2,0;;;;;;18,0;;21,0;4,0;;1,0;;;;;;;9,0;;;;;;2,0;;;;;4,0;;;5,0;;20,0;;11,0;;;1,0;;;;;;8,0;;2,0;;;;;;;;;7,0;;2,0;;13,0;;;;;1,0;;;;18,0;3,0;;;;;24,0;;;;;4,0;;1,0;4,0;;;1,0;1,0;2,0;17,0;;;;;1,0;15,0;6,0;;2,0;;;;;;;;;1,0;12,0;;;;;1,0;;;;1,0;9,0;;5,0;;;;;3,0;;2,0;4,0;1,0;;;;;5,0;;;1,0;;12,0;1,0;;2,0;;1,0;1,0;;;;;3,0;2,0;;;;;;;;;;;1,0;;;;34,0;;1,0;3,0;;;;;;;;;;;;;;1,0;;1,0;;1,0;;;;;;;;;;;;;;;1,0;4,0;;;;;5,0;;;;;140,0;185,0;24,0;10,0;2,0;86,0;2,0;34,0;157,0;;;5,0;81,0;1,0;7,0;10,0;23,0;;24,0;21,0;;;12,0;1,0;6,0;23,0;22,0;;55,0;;;;;;;;7,0;;9,0;3,0;1,0;;;122,0;;;;;;2,0;;;;;;;;;;;;;;;1,0;;;;;;;;;;;;;;;;;;;;;;;;;;;;;5,0;;;;;;;;;;2,0;;;;;3,0;;1,0;;4,0;;;;;;;;;1,0;;;;;1,0;;;;;;3,0;1,0;;;;;;;;;;;;4,0;;;;;;;;3,0;;;;2,0;;;;;;;;;;;;;;;;2,0;;;;;;;;;;;;1,0;;1,0;;;;;;;;;;;;;;;;;;;;;;;;
circuit;;6,0;6,0;34,0;22,0;190,0;97,0;167,0;3,0;;3,0;9,0;49,0;147,0;7,0;3,0;57,0;46,0;16,0;;120,0;;3,0;3,0;156,0;15,0;34,0;163,0;6,0;9,0;763,0;43,0;40,0;151,0;1,0;288,0;32,0;2,0;13,0;4,0;95,0;503,0;2,0;97,0;26,0;497,0;;494,0;2,0;6,0;5,0;;61,0;18,0;14,0;4,0;213,0;;31,0;162,0;2,0;8,0;63,0;6,0;732,0;7,0;792,0;3,0;13,0;34,0;5,0;355,0;100,0;5,0;;4,0;22,0;4,0;;75,0;102,0;;80,0;2,0;582,0;2,0;4,0;62,0;25,0;13,0;6,0;26,0;17,0;133,0;;;428,0;39,0;447,0;19,0;196,0;41,0;1,0;59,0;417,0;131,0;4,0;18,0;4,0;;1,0;103,0;152,0;4,0;;2,0;3,0;46,0;2,0;594,0;10,0;;917,0;11,0;;72,0;200,0;;21,0;9,0;61,0;2,0;14,0;340,0;5,0;8,0;19,0;;2,0;;7,0;14,0;;2,0;17,0;35,0;78,0;139,0;24,0;142,0;24,0;91,0;95,0;116,0;53,0;32,0;;5,0;1,0;3,0;110,0;685,0;1,0;38,0;126,0;3,0;448,0;77,0;1,0;68,0;41,0;2,0;10,0;80,0;;36,0;92,0;5,0;23,0;3,0;9,0;5,0;15,0;49,0;16,0;11,0;63,0;12,0;37,0;147,0;;;67,0;58,0;89,0;47,0;417,0;9,0;46,0;2,0;6,0;77,0;;12,0;15,0;6,0;189,0;18,0;51,0;325,0;16,0;8,0;57,0;6,0;2,0;33,0;383,0;54,0;6,0;24,0;197,0;34,0;;10,0;51,0;5,0;370,0;2,0;5,0;20,0;25,0;10,0;16,0;6,0;51,0;18,0;;;;5,0;4,0;1,0;;;14,0;66,0;30,0;45,0;342,0;2,0;;;10,0;60,0;318,0;187,0;135,0;440,0;18,0;;57,0;81,0;17,0;70,0;13,0;;;;;11,0;22,0;78,0;95,0;33,0;3,0;;16,0;30,0;25,0;44,0;23,0;17,0;27,0;3243,0;;3,0;232,0;18,0;;4,0;182,0;3,0;;2,0;1,0;9,0;31,0;151,0;19,0;16,0;3,0;14,0;325,0;9,0;1,0;26,0;3,0;12,0;2,0;244,0;;;17,0;21,0;4,0;;50,0;;12,0;5,0;12,0;23,0;49,0;2,0;;27,0;10,0;1,0;157,0;1455,0;19,0;;;11,0;10,0;1,0;;;4,0;;2,0;3,0;;3,0;11,0;18,0;3,0;33,0;12,0;8,0;;;7,0;6,0;18,0;;21,0;97,0;70,0;10,0;6,0;1,0;;1,0;6,0;32,0;3,0;17,0;1,0;;1,0;;74,0;7,0;25,0;;7,0;9,0;81,0;14,0;657,0;18,0;3,0;1,0;;57,0;64,0;2,0;12,0;4,0;2,0;20,0;15,0;5,0;7,0;29,0;3,0;19,0;6,0;;4,0;98,0;208,0;104,0;31,0;34,0;;8,0;55,0;30,0;4,0;30,0;;38,0;47,0;8,0;2,0;;;1,0;;5,0;;47,0;6,0;263,0;16,0;20,0;3,0;2,0;287,0;;37,0;;8,0;1,0;21,0;2,0;208,0;22,0;7,0;210,0;21,0;;1,0;3,0;6,0;3,0;15,0;25,0;;231,0;16,0;2,0;4,0;15,0;28,0;16,0;3,0;4,0;23,0;2,0;128,0;6,0;;5,0;17,0;7,0;2,0;11,0;5,0;;8,0;86,0;8,0;6,0;26,0;3,0;90,0;3,0;32,0;;6,0;5,0;5,0;12,0;160,0;3,0;2,0;;2,0;1,0;;4,0;12,0;;5,0;;5,0;9,0;;8,0;30,0;3,0;22,0;28,0;9,0;3,0;;2,0;1,0;25,0;5,0;4,0;;142,0;4,0;6,0;;49,0;108,0;151,0;2,0;17,0;;47,0;2,0;15,0;7,0;;;;1,0;9,0;34,0;2,0;;;3,0;5,0;;1,0;15,0;43,0;;1,0;;2,0;6,0;2,0;;5,0;10,0;5,0;10,0;62,0;;2,0;;;5,0;34,0;4,0;19,0;1,0;;1,0;5,0;21,0;2,0;;6,0;1,0;60,0;22,0;2,0;;1,0;1,0;11,0;9,0;;7,0;25,0;19,0;13,0;52,0;;19,0;;43,0;;13,0;;5,0;;6,0;;2,0;;;;2,0;8,0;10,0;1,0;1,0;6,0;68,0;45,0;40,0;14,0;3,0;64,0;;2,0;1,0;;;155,0;1,0;1,0;1,0;1,0;;6,0;1,0;20,0;;;2,0;5,0;2,0;4,0;15,0;3,0;;4,0;18,0;20,0;;3,0;3,0;1,0;11,0;1,0;1,0;3,0;12,0;;125,0;;19,0;;1,0;11,0;7,0;1,0;52,0;;;30,0;8,0;33,0;8,0;8,0;;17,0;;;78,0;;10,0;1,0;;1,0;1,0;3,0;12,0;;6,0;4,0;58,0;33,0;16,0;53,0;1,0;6,0;30,0;1,0;;24,0;42,0;14,0;18,0;186,0;3,0;34,0;;;21,0;3,0;5,0;150,0;149,0;1,0;2,0;10,0;;;1,0;1,0;6,0;3,0;11,0;9,0;5,0;36,0;10,0;8,0;2,0;2,0;7,0;2,0;18,0;14,0;5,0;5,0;9,0;2,0;;15,0;2,0;;53,0;;68,0;1,0;5,0;9,0;11,0;;1,0;3,0;;13,0;;1,0;;1,0;;13,0;7,0;1,0;;;18,0;;12,0;4,0;29,0;4,0;2,0;8,0;;;26,0;3,0;;2,0;;5,0;3,0;;;;5,0;2,0;22,0;9,0;;;;11,0;13,0;2,0;;4,0;2,0;;56,0;49,0;3,0;61,0;125,0;5,0;99,0;35,0;;1,0;12,0;18,0;19,0;11,0;1,0;2,0;;42,0;;14,0;29,0;;1,0;11,0;26,0;;46,0;24,0;;;6,0;1,0;;1,0;77,0;;28,0;9,0;1,0;26,0;11,0;197,0;;;;11,0;11,0;;12,0;44,0;11,0;6,0;;;;;;;;;1,0;;28,0;4,0;5,0;20,0;4,0;;6,0;19,0;;;;;;1,0;;3,0;2,0;43,0;2,0;;;51,0;17,0;2,0;;8,0;;;;5,0;1,0;;;1,0;;3,0;1,0;;1,0;12,0;5,0;;;;;10,0;1,0;;;3,0;1,0;;;3,0;47,0;;2,0;1,0;;1,0;5,0;5,0;6,0;;5,0;1,0;1,0;;17,0;;14,0;1,0;;;2,0;7,0;44,0;2,0;;;1,0;4,0;2,0;;;;;2,0;19,0;67,0;17,0;;;;1,0;;;4,0;12,0;5,0;;2,0;4,0;;5,0;;5,0;1,0;18,0;7,0;;48,0;;;;6,0;;2,0;;;4,0;1,0;;;2,0;;;1,0;3,0;5,0;;;;;;;;;;6,0;;;1,0;16,0;;;;4,0
circuitry;;11,0;;19,0;13,0;89,0;69,0;11,0;;5,0;;4,0;7,0;15,0;;1,0;66,0;;;14,0;5,0;2,0;25,0;11,0;76,0;2,0;;5,0;10,0;;433,0;32,0;1,0;8,0;;120,0;6,0;2,0;27,0;;120,0;167,0;;4,0;58,0;27,0;3,0;54,0;;4,0;;;6,0;1,0;14,0;42,0;27,0;;10,0;66,0;1,0;;9,0;2,0;299,0;3,0;144,0;1,0;10,0;;1,0;30,0;33,0;;;;;1,0;3,0;19,0;38,0;3,0;1,0;;50,0;;1,0;6,0;2,0;;45,0;7,0;7,0;4,0;2,0;2,0;117,0;46,0;42,0;12,0;30,0;6,0;;17,0;258,0;76,0;3,0;11,0;;;;8,0;10,0;3,0;;;11,0;2,0;19,0;82,0;4,0;;140,0;4,0;13,0;5,0;116,0;;2,0;;37,0;;3,0;81,0;2,0;6,0;17,0;4,0;2,0;;;;;1,0;;9,0;2,0;5,0;29,0;16,0;;;9,0;;2,0;3,0;;;;;4,0;217,0;;27,0;1,0;4,0;66,0;3,0;;26,0;8,0;;2,0;19,0;1,0;;14,0;2,0;1,0;;13,0;;;;1,0;;19,0;;27,0;1,0;;;8,0;1,0;;;87,0;2,0;3,0;1,0;;2,0;;4,0;5,0;4,0;4,0;3,0;3,0;8,0;2,0;2,0;5,0;;;4,0;52,0;;2,0;1,0;8,0;5,0;;2,0;;;42,0;;5,0;1,0;;1,0;7,0;;9,0;9,0;;1,0;1,0;7,0;;;;;;27,0;1,0;;15,0;;;;5,0;1,0;37,0;7,0;14,0;21,0;;;;37,0;4,0;15,0;;;;;1,0;1,0;;9,0;6,0;1,0;;;1,0;12,0;;1,0;;5,0;4,0;103,0;;;1,0;2,0;142,0;;3,0;2,0;;;;1,0;6,0;4,0;;9,0;;;9,0;;4,0;;;16,0;2,0;110,0;;;1,0;;;;7,0;1,0;;1,0;4,0;27,0;3,0;4,0;4,0;;;;55,0;45,0;;;;;5,0;;3,0;;;;3,0;5,0;;;;;9,0;11,0;;;;;;;2,0;2,0;2,0;;94,0;74,0;;;;;;8,0;5,0;1,0;3,0;;;;20,0;;4,0;;5,0;12,0;6,0;4,0;437,0;15,0;4,0;;1,0;37,0;36,0;4,0;;13,0;;23,0;10,0;14,0;;13,0;;9,0;2,0;;;30,0;47,0;10,0;;12,0;10,0;9,0;6,0;2,0;1,0;;;18,0;22,0;1,0;;3,0;;;;9,0;;13,0;2,0;74,0;5,0;8,0;1,0;;36,0;;1,0;;4,0;9,0;8,0;;9,0;1,0;1,0;;9,0;5,0;7,0;7,0;;2,0;9,0;2,0;25,0;15,0;19,0;;;24,0;;24,0;2,0;1,0;16,0;;5,0;6,0;;4,0;;;2,0;;;3,0;9,0;7,0;2,0;;;4,0;32,0;;;;1,0;3,0;13,0;;29,0;;2,0;2,0;3,0;;;8,0;11,0;;1,0;1,0;3,0;;;;;;1,0;;1,0;;7,0;;1,0;;6,0;;;;;;1,0;;24,0;180,0;;;;12,0;;;;;;1,0;;;3,0;;2,0;;9,0;2,0;;;2,0;;;3,0;;;5,0;;;;;2,0;1,0;6,0;1,0;1,0;;;;2,0;1,0;;;;4,0;;9,0;4,0;;;6,0;;19,0;;1,0;2,0;1,0;;;5,0;1,0;37,0;7,0;3,0;11,0;27,0;1,0;7,0;11,0;;1,0;5,0;;;13,0;;;3,0;;2,0;;1,0;;;1,0;2,0;;;11,0;;;6,0;;;;;2,0;33,0;6,0;1,0;;;;1,0;;;;;;8,0;;13,0;3,0;1,0;;2,0;;;;1,0;;2,0;;28,0;;1,0;;;33,0;;15,0;3,0;;;2,0;;18,0;;;9,0;24,0;;5,0;4,0;;;;;8,0;;;3,0;;2,0;;;6,0;;4,0;;3,0;15,0;2,0;9,0;1,0;;;;;;2,0;;3,0;5,0;;5,0;;;;1,0;;5,0;;1,0;;1,0;;;;;4,0;4,0;;11,0;;;;;1,0;;;;;;;;4,0;;;;;;6,0;;;;6,0;;;;;;;2,0;1,0;4,0;;;;;;;;2,0;;;4,0;1,0;;;;;;;;;;;;;16,0;;;;;9,0;;1,0;;;;18,0;2,0;3,0;;1,0;;;2,0;;;10,0;1,0;;17,0;;;;;;;34,0;;1,0;;12,0;5,0;;;;2,0;;18,0;1,0;4,0;;;;;;;;6,0;;;;;28,0;;2,0;5,0;;;1,0;;;;;19,0;2,0;1,0;;1,0;;;;2,0;;;2,0;;;4,0;;2,0;;2,0;;;5,0;;;;3,0;1,0;;4,0;10,0;;;;;;1,0;12,0;6,0;2,0;;1,0;4,0;;;;1,0;;2,0;;2,0;1,0;1,0;;;;;;;1,0;;4,0;6,0;;;;;;;;;1,0;;;;;;;;1,0;;;;;;;;;;1,0;;;;;;;;;;;2,0;;;1,0;;;2,0;;;;;;;1,0;;2,0;4,0;;;1,0;1,0;;2,0;;;;;;;2,0;;;;;;;;;;;;;3,0;;3,0;3,0;;;;1,0;1,0;;;;;;;;8,0;;
circumferential;;10,0;;2,0;;2,0;;1,0;;;6,0;;29,0;27,0;;;1,0;;2,0;;;1,0;;;;;;;;;9,0;;;;2,0;;7,0;1,0;;;;9,0;12,0;;25,0;31,0;;5,0;;;;;33,0;1,0;;;42,0;;;3,0;;;2,0;;11,0;;31,0;;;;4,0;61,0;6,0;1,0;;;;;;;1,0;;;;5,0;11,0;;30,0;;3,0;;3,0;;;1,0;;;5,0;12,0;;13,0;8,0;;;6,0;;;;;;;;1,0;;;;;4,0;;4,0;;;1,0;;;;2,0;;;2,0;;;;12,0;3,0;;12,0;;;1,0;;2,0;;;2,0;1,0;11,0;17,0;;4,0;1,0;;23,0;;;;;;;;1,0;2,0;;1,0;;;8,0;4,0;;4,0;;;;206,0;;24,0;;;;1,0;;;1,0;34,0;;;4,0;;3,0;14,0;;;;12,0;21,0;13,0;6,0;;38,0;2,0;;3,0;;;;;35,0;;6,0;41,0;7,0;;8,0;;;136,0;;;;3,0;;;;;4,0;2,0;73,0;1,0;2,0;1,0;4,0;;2,0;;5,0;;;6,0;;;1,0;21,0;7,0;;14,0;;4,0;6,0;52,0;2,0;1,0;;;7,0;;3,0;21,0;136,0;5,0;;;;;11,0;37,0;;;;;2,0;;3,0;3,0;1,0;12,0;;1,0;;7,0;;1,0;1,0;31,0;;;;2,0;;;8,0;36,0;;15,0;26,0;;10,0;;;1,0;;8,0;12,0;;;;17,0;;;4,0;;2,0;4,0;7,0;;6,0;;7,0;6,0;1,0;;;1,0;19,0;;;7,0;;;;;7,0;2,0;;4,0;;;1,0;;;;10,0;;6,0;5,0;;;13,0;8,0;;;;;;;;6,0;2,0;15,0;;;;;;;;;;2,0;;;;;;1,0;3,0;1,0;;;;;3,0;;;;;;;;;;;;;;2,0;;;;2,0;;;;;;;1,0;;;;;;2,0;;;2,0;;;3,0;;;;;;;;1,0;;;;;;;6,0;2,0;;;;;4,0;;;;;6,0;;;;;;;;;;;3,0;;;;2,0;;;;;2,0;;;;;;;;8,0;;;;;6,0;;;;21,0;;1,0;;;2,0;;;;;;;;4,0;;;;;;;;;;;;;;;;;;;;;;;1,0;3,0;;;3,0;;;1,0;;;1,0;;;;8,0;;;3,0;;;9,0;;;;;;2,0;;;;;;;;;1,0;;;;;;;;;;;;;;;;;;;;;;10,0;;;;;4,0;3,0;;;;4,0;;3,0;6,0;;;2,0;;;;;;;;;;;;;;;;;;;;;;;;;;2,0;;;;1,0;;;;;;;;;;;;;;;;;;;2,0;;;;11,0;;;;;;;;;;;;;;;;;19,0;;;;;;;1,0;;2,0;;;;;;;;;;1,0;;;;;;;;;;1,0;;;;;;;25,0;;;;;;;;1,0;1,0;;2,0;2,0;;;;2,0;;;;;;4,0;;;;;;;;;;;;;;;3,0;;;;;;;2,0;;;1,0;12,0;;;;;;;;22,0;5,0;;;1,0;1,0;2,0;;1,0;;;;5,0;;;;;;;;;;;;;;;;;;;6,0;;1,0;;;;;;;;;;;;;;;;;;;;;;;;1,0;;;;;;;;;;;;1,0;;;;;;;;;;;;;;;;;2,0;;;;;;;;;;;;;;;1,0;;;;;;;;;;;;;;;;;;;;;;;;;;;;1,0;;;;;;;;;10,0;;1,0;;;;;;;;;;;;;;;;;;;;;;;;;;;;;;;;;;;9,0;;;4,0;;;;;;1,0;;;;;;;;;;;;;1,0;;;;;;;;;;;;;;;;;;;;;;;;;;;;;;;;;;;;;;;;;;;;;;;;;;;
clamp;;1,0;;14,0;1,0;15,0;1,0;41,0;;;;;3,0;238,0;;;3,0;;16,0;;;;;;;;;7,0;;;59,0;;;;;1,0;15,0;19,0;1,0;;;145,0;;2,0;1,0;12,0;;35,0;;;;;16,0;3,0;;;50,0;;;3,0;;;1,0;;5,0;;133,0;;;1,0;4,0;16,0;;;;;1,0;;;;8,0;;;;9,0;69,0;;29,0;;;;;31,0;;1,0;;1,0;39,0;20,0;7,0;45,0;;;3,0;12,0;1,0;;;;;;;;1,0;4,0;;;3,0;;;;;;6,0;;;36,0;;;;;;;4,0;1,0;;2,0;1,0;;;;4,0;;;11,0;14,0;19,0;9,0;2,0;37,0;50,0;;66,0;10,0;;1,0;6,0;;;;11,0;27,0;;;5,0;;42,0;14,0;;;;;;13,0;1,0;10,0;;;4,0;;;;;6,0;3,0;;;58,0;4,0;14,0;;3,0;;12,0;6,0;13,0;29,0;;5,0;8,0;;;;11,0;;;550,0;;;117,0;18,0;24,0;14,0;;1,0;20,0;7,0;10,0;;;;;;;70,0;;99,0;4,0;2,0;;;;;;;;;;17,0;;;37,0;49,0;20,0;4,0;;10,0;5,0;19,0;10,0;9,0;;1,0;51,0;;;79,0;280,0;7,0;;;1,0;;;3,0;;48,0;;2,0;;;2,0;;24,0;9,0;4,0;5,0;;5,0;3,0;15,0;;30,0;8,0;;;1,0;;52,0;12,0;2,0;10,0;;2,0;;2,0;2,0;;29,0;58,0;8,0;7,0;5,0;;;16,0;13,0;21,0;1,0;8,0;;;1,0;4,0;;3,0;7,0;6,0;12,0;99,0;7,0;31,0;2,0;;;;;14,0;;2,0;;7,0;2,0;1,0;;5,0;42,0;;;7,0;30,0;93,0;4,0;40,0;1,0;48,0;6,0;26,0;;95,0;;11,0;;;3,0;35,0;4,0;71,0;1,0;;;;;7,0;;23,0;;3,0;;;;;1,0;3,0;12,0;;;;;;11,0;;;;;;;1,0;;;;;;;;;3,0;;;2,0;;1,0;1,0;16,0;4,0;;;3,0;;;1,0;3,0;;4,0;;;;;;;;;;;;16,0;;;;;5,0;;;;;8,0;;;;;;18,0;;;;;;;3,0;;;16,0;;10,0;24,0;;6,0;;2,0;;;;;;;;;;;;;;;2,0;;13,0;;;;;4,0;;;4,0;;66,0;27,0;;;;;;;3,0;;;;;;;;;;;;2,0;;;;;;1,0;;;;11,0;;26,0;;;13,0;4,0;;;;;3,0;1,0;;;2,0;;6,0;2,0;2,0;;;;16,0;;;;5,0;28,0;;;;;3,0;;;10,0;;;;;;;;;;;;5,0;;;;;6,0;;;;;1,0;10,0;2,0;;;2,0;;;;;4,0;;1,0;;;;;;;;;;;;;;1,0;;;;3,0;;;2,0;;;;;;;1,0;;9,0;;;;2,0;;;;;;;;;;;4,0;;;;;;;7,0;;;32,0;;;;12,0;;;;;2,0;;;4,0;;16,0;;;;1,0;;;;;;;;4,0;;8,0;;4,0;1,0;;;;;;;1,0;;;2,0;;4,0;;;;;11,0;;;7,0;;2,0;5,0;44,0;;1,0;28,0;1,0;;;;;;9,0;31,0;2,0;14,0;;;2,0;;;1,0;1,0;;;;;;2,0;;;;;9,0;;;;;;;;60,0;;3,0;4,0;23,0;;;;;17,0;8,0;1,0;;4,0;;;;;2,0;;;;;;2,0;;1,0;2,0;;;1,0;;;;1,0;2,0;;2,0;;;;;;2,0;3,0;;;;;;;;;;;;;;;1,0;4,0;;;;;;;;;;;;;;;;6,0;;;;;;;;;;;;;;;;;;;;;4,0;;;;;2,0;1,0;;;;;;;;;;;;;;;4,0;;;;;;;;;;18,0;3,0;;;;;;;;;;;;;;;;;;;;;;;;;;;;;2,0;;;;;;;;;;;;;;;;;;;;;;;;2,0;;;;;2,0;7,0;;;;;;;;;;;;2,0;5,0;;;;;;1,0;;;;;;;;;;;;;;;;;;;;;;;;;;;;;;;;;;;;;;;;;;;;;;;;;;;;;;;;;;
clip;;23,0;;1,0;9,0;9,0;;20,0;;;;2,0;;25,0;;;36,0;;3,0;;;;;4,0;;;;8,0;4,0;;21,0;1,0;;;;15,0;13,0;;;;7,0;24,0;;;16,0;4,0;;19,0;;;;;12,0;2,0;;;3,0;;;33,0;;;1,0;;75,0;;26,0;;;;;8,0;;;;2,0;4,0;;;3,0;16,0;;1,0;;9,0;;;8,0;;;2,0;;;;;1,0;4,0;;16,0;9,0;12,0;8,0;;3,0;13,0;1,0;;;;;;12,0;7,0;;2,0;;31,0;2,0;7,0;8,0;;;2,0;1,0;;15,0;16,0;;;1,0;5,0;;;15,0;;;3,0;;;;;;;;;1,0;33,0;1,0;4,0;21,0;;;7,0;;;;2,0;;;;;7,0;3,0;;;;5,0;3,0;;2,0;;;;;;;;;;;;;2,0;10,0;1,0;;;;23,0;4,0;;;;10,0;;2,0;10,0;;1,0;1,0;;;;;;4,0;6,0;34,0;;44,0;1,0;1,0;;;;6,0;8,0;;;1,0;;;;;1,0;;80,0;;3,0;;;;1,0;;4,0;;;;2,0;4,0;;1,0;;1,0;;10,0;1,0;5,0;;;;;;15,0;;1,0;8,0;8,0;;;8,0;5,0;;4,0;2,0;;;;;4,0;;10,0;3,0;;3,0;;3,0;33,0;;2,0;13,0;;2,0;4,0;;;;1,0;3,0;;;2,0;;2,0;;;1,0;;3,0;4,0;;;1,0;;;4,0;2,0;;;;;1,0;;2,0;;;3,0;4,0;;2,0;6,0;1,0;4,0;;;;;3,0;1,0;;4,0;;1,0;1,0;3,0;;;6,0;;;2,0;29,0;;1,0;;9,0;25,0;;;4,0;;8,0;;;;;;5,0;154,0;1,0;;;1,0;;;;;24,0;1,0;;;;;;3,0;;;1,0;;;5,0;;;;;1,0;1,0;1,0;;3,0;6,0;2,0;;;1,0;;;9,0;;;;1,0;;;2,0;2,0;2,0;2,0;12,0;;;1,0;;;2,0;3,0;;;1,0;;;3,0;;;5,0;32,0;;8,0;;;;;1,0;;;;10,0;;;1,0;;1,0;;;;3,0;;;2,0;;;;;1,0;;;;;;2,0;1,0;1,0;;10,0;;;;;;;;;2,0;;1,0;;;;;2,0;2,0;;;;4,0;;5,0;1,0;;;;;;;;;;;;;;;;1,0;;;2,0;1,0;;;;;;;;2,0;;5,0;;;8,0;3,0;1,0;4,0;;;;;;;;;;3,0;;;;;;;1,0;;;16,0;;;;;;1,0;;1,0;2,0;;;;;5,0;;;;1,0;;7,0;;17,0;;;;;5,0;2,0;;;1,0;;;;;;;;2,0;2,0;2,0;;2,0;;;2,0;;;;;3,0;27,0;;;;;;;2,0;3,0;;15,0;1,0;;;;3,0;;;;1,0;;;;;9,0;6,0;;;;;;;;2,0;;1,0;;;17,0;;;;;;;;4,0;1,0;;;;;;;;;;;;;;1,0;1,0;6,0;;;;4,0;;;;;;;;10,0;;2,0;;;9,0;;;14,0;;;;;1,0;;;;;;3,0;;2,0;;2,0;;1,0;;;1,0;;;;;;;;;1,0;;;;;1,0;;;;;;;;;;1,0;;9,0;;3,0;;;;;;;;3,0;;;3,0;;13,0;5,0;;;5,0;1,0;;;;;;;;8,0;;;;;;;;;;;;3,0;;;;;;7,0;2,0;;;;;;;;;;;;;3,0;;;;;;;1,0;9,0;1,0;;;;;1,0;;;;;;;;;;1,0;;;;;;;;;;;;;;;;;;;;;;;;;;;;;;;;;;;;;;;;;;;;;;;;;;2,0;;;;;;;;;;;;;;;;;;;;;1,0;;;;;;;;;;;;;;;;;;;;;6,0;;;;;;;;;;;;;;;;2,0;;;;;;;;;;;;;;;1,0;;1,0;;;;;;;;;1,0;;;;;;;;;;;;;;;;;;3,0;;;;;;;;;;;;;;;;;;;;;;;;;;;;;;;;;;;;;;;
clock;;14,0;;18,0;;24,0;5,0;14,0;;;;;;76,0;;;11,0;8,0;;;3,0;;;4,0;33,0;;;9,0;19,0;2,0;100,0;32,0;1,0;8,0;3,0;76,0;5,0;;7,0;1,0;20,0;94,0;;6,0;10,0;;1,0;;;;;;;;;;;;101,0;55,0;;;8,0;2,0;37,0;1,0;31,0;5,0;;;;29,0;7,0;;;1,0;;;;4,0;38,0;;33,0;;2,0;;4,0;1,0;;2,0;3,0;;30,0;;122,0;;38,0;;46,0;16,0;5,0;2,0;;1,0;18,0;5,0;;6,0;;;;124,0;;1,0;;;;11,0;1,0;46,0;14,0;;592,0;;;12,0;27,0;;;;209,0;;;59,0;9,0;;1,0;;;;;;;;;4,0;;13,0;8,0;;1,0;1,0;46,0;;3,0;1,0;;;;;2,0;6,0;;6,0;5,0;;11,0;;;4,0;;;;1,0;;7,0;;2,0;4,0;;;;;;;;43,0;;3,0;;;4,0;;;;;;;;;;;;3,0;;4,0;;;;;;1,0;20,0;;;;91,0;;;;;28,0;;;;;;;;2,0;;;;;;;3,0;;;1,0;;;;;;9,0;;;;;;;;;;37,0;;;;;;3,0;3,0;1,0;;;;;;;;10,0;3,0;;;;4,0;;;6,0;;1,0;;;;;;1,0;42,0;;;;;;;;;9,0;;3,0;;;;;;;;;;3,0;;;;7,0;;;1,0;1,0;4,0;1,0;5,0;3,0;;;;;;;18,0;;;;;;4,0;;;;;;;3,0;;;;;;;;;;;1,0;1,0;2,0;;1,0;;6,0;;;;;;;;;;;;;;2,0;;9,0;;;;3,0;2,0;54,0;2,0;34,0;;;7,0;;9,0;;8,0;;;;;;;;4,0;42,0;2,0;;43,0;4,0;12,0;;2,0;;2,0;4,0;;;1,0;;18,0;32,0;1,0;;;;;;37,0;1,0;7,0;;93,0;;32,0;4,0;;10,0;;10,0;2,0;1,0;;3,0;13,0;19,0;80,0;;53,0;;;1,0;5,0;;;;;;;8,0;;;;1,0;20,0;;;6,0;;50,0;1,0;;2,0;;;;;4,0;;4,0;5,0;;;1,0;3,0;14,0;;;;1,0;14,0;2,0;;22,0;;;;;;;;7,0;;;;;;;3,0;5,0;;;1,0;;;;;16,0;;1,0;;;2,0;;1,0;;;;;;;;;;;;;;;;;3,0;;11,0;;;1,0;1,0;3,0;;1,0;;;;;;4,0;;;;2,0;;3,0;;;;;;16,0;;;12,0;;;;;3,0;;;;;;;;;;;;;;1,0;;;;;19,0;3,0;;;11,0;;;;;;;;;2,0;;;;;;;;1,0;6,0;27,0;;1,0;;;;;;;2,0;;;;;;;;;;;;;5,0;;3,0;;;;21,0;;;2,0;;1,0;;;;;;;3,0;1,0;;;;;;10,0;;;12,0;29,0;6,0;10,0;;;1,0;;;31,0;;;2,0;;1,0;;;;;1,0;;;17,0;;5,0;2,0;;;;;;;4,0;;62,0;;;;;;;;25,0;8,0;;;;;;;;;;;6,0;;;11,0;4,0;;;;;3,0;;;;1,0;;;2,0;;;1,0;1,0;;;4,0;;;;;;;;;;;;;;;;1,0;;;;;;;;;;;;;;;;;;;;;;;;;;;;;14,0;;;;;5,0;;;;2,0;34,0;2,0;;1,0;58,0;;;;;;;;;;;2,0;;2,0;;;;;;1,0;;;;;;1,0;1,0;12,0;;;;;;;1,0;2,0;;;;;;;;4,0;;1,0;;;;;;1,0;;;;;;6,0;;2,0;;1,0;;;;;1,0;;5,0;;;;4,0;;;;6,0;;;;53,0;;;;;;;;;;;;;4,0;14,0;;;;;;74,0;;;3,0;;1,0;;;;;;;;;;;;;;;;;;17,0;;1,0;;26,0;;;1,0;13,0;;;;;1,0;;;;;;5,0;;;;;;;;;;;;;;;;;;;;;;10,0;;;;;;;;;1,0;;;;6,0;;;;;;;;;;;;;;;;;;;;;;;;;
close;;2,0;1,0;7,0;6,0;87,0;6,0;51,0;;;2,0;;9,0;53,0;;1,0;26,0;5,0;11,0;7,0;;;9,0;;7,0;1,0;4,0;53,0;4,0;1,0;82,0;19,0;1,0;7,0;1,0;23,0;19,0;13,0;37,0;2,0;77,0;91,0;4,0;6,0;44,0;50,0;;134,0;3,0;3,0;8,0;;11,0;3,0;1,0;10,0;27,0;;16,0;11,0;3,0;;78,0;;235,0;;49,0;4,0;3,0;3,0;1,0;399,0;60,0;1,0;2,0;;16,0;;;8,0;84,0;;19,0;;44,0;26,0;;66,0;;9,0;22,0;2,0;6,0;4,0;9,0;2,0;45,0;42,0;60,0;67,0;576,0;33,0;;11,0;17,0;9,0;5,0;2,0;1,0;1,0;;33,0;34,0;6,0;;;1,0;8,0;18,0;50,0;;;5,0;10,0;;5,0;76,0;1,0;;2,0;37,0;1,0;1,0;135,0;1,0;1,0;43,0;;26,0;;;16,0;7,0;;71,0;7,0;22,0;51,0;6,0;5,0;9,0;8,0;47,0;26,0;;;3,0;4,0;;;1,0;16,0;;;;1,0;18,0;115,0;;25,0;2,0;;4,0;55,0;2,0;24,0;2,0;;4,0;;;7,0;16,0;27,0;2,0;1,0;1,0;8,0;39,0;33,0;;6,0;;14,0;11,0;9,0;129,0;6,0;20,0;2,0;;4,0;2,0;2,0;;;58,0;4,0;;43,0;83,0;18,0;;;7,0;17,0;6,0;;;3,0;28,0;5,0;7,0;4,0;5,0;1,0;204,0;1,0;8,0;;3,0;;14,0;7,0;10,0;3,0;1,0;1,0;;11,0;1,0;4,0;3,0;10,0;16,0;13,0;4,0;44,0;306,0;11,0;3,0;16,0;1,0;19,0;17,0;2,0;28,0;110,0;5,0;;;1,0;1,0;40,0;26,0;;;;;19,0;2,0;9,0;16,0;7,0;1,0;;4,0;22,0;;4,0;2,0;6,0;28,0;8,0;6,0;1,0;2,0;18,0;6,0;5,0;10,0;67,0;;8,0;;;73,0;9,0;1,0;13,0;14,0;;11,0;1,0;;11,0;2,0;3,0;;34,0;;1,0;5,0;44,0;;5,0;137,0;7,0;6,0;33,0;26,0;195,0;7,0;3,0;1,0;2,0;4,0;4,0;51,0;14,0;4,0;;;3,0;8,0;;9,0;;;;9,0;6,0;1,0;;;26,0;27,0;52,0;3,0;22,0;1,0;10,0;4,0;6,0;13,0;7,0;7,0;27,0;33,0;;3,0;;;4,0;;4,0;;;;7,0;;;7,0;24,0;13,0;3,0;2,0;5,0;2,0;2,0;73,0;3,0;;;;23,0;11,0;7,0;32,0;6,0;;1,0;1,0;24,0;3,0;4,0;;3,0;15,0;;;4,0;1,0;6,0;3,0;16,0;1,0;10,0;2,0;6,0;2,0;19,0;;11,0;36,0;6,0;;;;3,0;;5,0;1,0;;1,0;16,0;2,0;4,0;8,0;;5,0;;14,0;;8,0;;8,0;30,0;29,0;;4,0;10,0;33,0;1,0;1,0;3,0;3,0;1,0;25,0;;2,0;;3,0;1,0;8,0;8,0;;1,0;5,0;;;;;3,0;;;;;3,0;;4,0;1,0;;1,0;24,0;10,0;;5,0;;;11,0;2,0;7,0;;7,0;;26,0;1,0;;4,0;1,0;;;2,0;;;2,0;;;;2,0;;3,0;2,0;2,0;5,0;;;2,0;;1,0;1,0;;;3,0;;2,0;;12,0;2,0;1,0;1,0;;;;;11,0;2,0;4,0;;9,0;;1,0;7,0;6,0;;3,0;1,0;3,0;12,0;;2,0;;447,0;;17,0;;;;;1,0;3,0;1,0;4,0;6,0;;;;;;;3,0;2,0;;1,0;;2,0;1,0;18,0;16,0;;;3,0;12,0;2,0;;1,0;;2,0;3,0;;13,0;5,0;2,0;6,0;10,0;26,0;;1,0;;;;;1,0;136,0;;;1,0;16,0;;1,0;;1,0;7,0;1,0;22,0;;1,0;;4,0;1,0;;;3,0;;10,0;;2,0;2,0;;1,0;;3,0;2,0;;;;;;;32,0;;;1,0;;;;6,0;;12,0;;;1,0;;5,0;1,0;3,0;27,0;;;3,0;1,0;;;;4,0;4,0;;1,0;;;3,0;;;90,0;;1,0;;1,0;;22,0;1,0;;2,0;;4,0;;;8,0;;2,0;;;4,0;;4,0;1,0;;4,0;1,0;9,0;6,0;1,0;1,0;3,0;67,0;;29,0;;2,0;;;;25,0;10,0;9,0;1,0;28,0;2,0;;13,0;;;;;6,0;;1,0;2,0;8,0;3,0;1,0;;;;1,0;10,0;;4,0;;;;1,0;;15,0;;;;6,0;;5,0;15,0;;;;3,0;11,0;13,0;;;33,0;;3,0;7,0;2,0;4,0;3,0;7,0;11,0;2,0;1,0;1,0;;;1,0;;1,0;;1,0;;3,0;;1,0;3,0;;;;2,0;;2,0;;;;4,0;3,0;;1,0;3,0;2,0;;;;2,0;;;;4,0;;;3,0;;;3,0;48,0;;;;4,0;6,0;;;1,0;;;;;4,0;5,0;;;;3,0;;;1,0;;;1,0;;;;;15,0;;19,0;1,0;3,0;1,0;;;;1,0;;16,0;1,0;8,0;;;;;;;1,0;;;3,0;1,0;;4,0;1,0;;1,0;;5,0;;;6,0;;;1,0;1,0;4,0;4,0;;;;;3,0;;;6,0;;;;1,0;;1,0;;;;;1,0;;1,0;1,0;;2,0;6,0;;2,0;;;1,0;;;3,0;2,0;10,0;1,0;8,0;4,0;3,0;;2,0;;;1,0;;;1,0;;11,0;;;;;3,0;;;;;2,0;8,0;3,0;;;;;;2,0;;;;;;;2,0;7,0;;;;;1,0;;3,0;;;2,0;;;;;;6,0;;;;2,0;;6,0;12,0;;1,0;4,0;;;3,0;1,0;;;;2,0;;2,0;2,0;;;;6,0;3,0;;8,0;;1,0;;;;;;
code;;10,0;;4,0;1,0;75,0;4,0;3,0;;;;;;70,0;4,0;;72,0;1,0;;8,0;;;35,0;;7,0;;;7,0;504,0;;201,0;11,0;3,0;17,0;;64,0;1,0;3,0;33,0;;107,0;151,0;;27,0;65,0;4,0;;1,0;;1,0;1,0;;;1,0;8,0;;7,0;;4,0;147,0;;;14,0;1,0;329,0;11,0;78,0;2,0;;;3,0;19,0;44,0;;;;;1,0;8,0;86,0;124,0;;;3,0;21,0;;1,0;52,0;;2,0;4,0;;1,0;14,0;8,0;;41,0;8,0;252,0;2,0;112,0;18,0;;14,0;27,0;339,0;33,0;481,0;1,0;;;29,0;32,0;;;3,0;2,0;12,0;16,0;7,0;21,0;;47,0;1,0;;147,0;108,0;;1,0;2,0;28,0;;1,0;72,0;3,0;;9,0;2,0;1,0;;;2,0;;;18,0;2,0;7,0;1,0;33,0;1,0;;1,0;2,0;;;;;;;;;7,0;11,0;16,0;2,0;1,0;6,0;;;11,0;13,0;;2,0;7,0;;;;4,0;23,0;4,0;;;;3,0;;;2,0;;10,0;2,0;;16,0;;;;;7,0;;;;;3,0;;2,0;2,0;125,0;2,0;;;3,0;3,0;2,0;31,0;;;;56,0;7,0;1,0;6,0;142,0;;;;4,0;;31,0;;1,0;;;3,0;23,0;;;7,0;;;;6,0;;;1,0;;;30,0;1,0;3,0;1,0;;;;2,0;14,0;;5,0;2,0;;;;1,0;12,0;2,0;17,0;1,0;1,0;;;1,0;9,0;;;;7,0;3,0;;1,0;;;10,0;4,0;1,0;2,0;;55,0;;;3,0;19,0;;;1,0;;;;3,0;7,0;;;;;;;1,0;;;;1,0;2,0;23,0;;;1,0;14,0;;;6,0;2,0;;;10,0;24,0;;2,0;;;;;1,0;2,0;;;;;8,0;;;;5,0;;7,0;2,0;;;;;38,0;8,0;;;1,0;;5,0;;2,0;;1,0;;38,0;3,0;;;;;11,0;;8,0;;;;3,0;;5,0;;3,0;;6,0;14,0;5,0;52,0;61,0;7,0;3,0;;1,0;28,0;3,0;2,0;;1,0;1,0;171,0;;15,0;;3,0;;84,0;8,0;;;34,0;4,0;1,0;2,0;59,0;;2,0;16,0;1,0;;2,0;4,0;8,0;18,0;4,0;2,0;;;1,0;;6,0;1,0;53,0;142,0;53,0;7,0;47,0;4,0;;11,0;;11,0;;4,0;;77,0;1,0;4,0;;4,0;9,0;6,0;2,0;1,0;55,0;7,0;;27,0;;;;1,0;;;;2,0;21,0;;2,0;13,0;3,0;30,0;2,0;;58,0;1,0;25,0;;;20,0;1,0;119,0;7,0;;;3,0;15,0;9,0;31,0;;6,0;1,0;28,0;15,0;;59,0;3,0;3,0;5,0;;4,0;16,0;15,0;1,0;;1,0;14,0;15,0;;;10,0;21,0;2,0;2,0;1,0;;;;4,0;;2,0;;22,0;;1,0;;1,0;1,0;;1,0;4,0;19,0;;;6,0;;;;;;12,0;;;1,0;3,0;;8,0;;15,0;5,0;;;2,0;;3,0;;;;;;;10,0;3,0;1,0;19,0;6,0;;;;1,0;7,0;1,0;3,0;3,0;1,0;15,0;1,0;14,0;;;;8,0;;;1,0;;9,0;;12,0;;;;;3,0;;;;;;;2,0;3,0;;;12,0;1,0;4,0;1,0;;1,0;108,0;3,0;16,0;;7,0;2,0;1,0;;;11,0;;;;5,0;;;9,0;13,0;17,0;2,0;6,0;1,0;;2,0;;;;;;1,0;3,0;3,0;15,0;;1,0;3,0;;;;1,0;2,0;;;1,0;2,0;;;;;;1,0;7,0;;;2,0;2,0;3,0;4,0;1,0;20,0;7,0;5,0;3,0;;;3,0;;;;11,0;;;3,0;1,0;9,0;;3,0;33,0;;;25,0;;1,0;;;;;;;;1,0;19,0;;;1,0;;;;;;6,0;4,0;;2,0;;;;;;;;;2,0;;1,0;1,0;;;;;;;1,0;;;;4,0;3,0;2,0;;2,0;;1,0;2,0;2,0;;;1,0;;14,0;;;;;;;;;15,0;;;;;;;;;;;;;;;;6,0;;;;;;;11,0;;;;;;;;2,0;;;;;1,0;;6,0;;;;;1,0;9,0;2,0;;10,0;52,0;1,0;;;;;;;;;;;14,0;;;;;;4,0;;;2,0;;;5,0;;;7,0;;;4,0;;;;;9,0;;138,0;7,0;;1,0;;2,0;;;;15,0;;;;;5,0;;3,0;2,0;;;;;46,0;1,0;;2,0;;8,0;;;;1,0;;;;;;;;12,0;;;;;;3,0;;;;;;1,0;;3,0;;;45,0;12,0;;;4,0;;;;;;;;;;4,0;;;;;;;5,0;;;;;;;;;;;;;12,0;;;2,0;26,0;;;;;1,0;;;;;;;;;;;;;;;;;;;;1,0;;11,0;;;;;;4,0;;;2,0;;;;;;;;;;1,0;;;;;;;;;;;5,0;;;1,0;;;;;;;;;;;
collect;;1,0;;5,0;;6,0;4,0;;;3,0;;;;27,0;;12,0;16,0;;;;;;2,0;2,0;3,0;;;7,0;4,0;7,0;122,0;6,0;;;;178,0;5,0;4,0;27,0;;15,0;38,0;;5,0;9,0;6,0;;20,0;;;;;1,0;17,0;73,0;;13,0;;;9,0;;;46,0;;310,0;;27,0;;;;;64,0;131,0;;;;;14,0;1,0;7,0;34,0;;8,0;7,0;36,0;2,0;;61,0;2,0;;5,0;1,0;4,0;16,0;14,0;;1,0;;70,0;1,0;30,0;1,0;;1,0;23,0;16,0;;1,0;;;;2,0;4,0;;;;1,0;1,0;7,0;83,0;3,0;;13,0;9,0;;6,0;21,0;;;;10,0;;;25,0;;;4,0;;;;;1,0;;;1,0;1,0;17,0;8,0;1,0;11,0;;;5,0;;;;;;;;;6,0;6,0;;;;1,0;;;;12,0;;8,0;15,0;2,0;;1,0;3,0;2,0;;4,0;1,0;;5,0;;;7,0;;23,0;1,0;4,0;;;;;1,0;9,0;5,0;;;;;;;8,0;;2,0;;30,0;3,0;3,0;4,0;;;;8,0;5,0;;;;3,0;12,0;;;;;28,0;;3,0;;2,0;16,0;8,0;;;;7,0;1,0;;;;2,0;;;;7,0;;;1,0;;;;;3,0;;3,0;;30,0;4,0;;;22,0;;13,0;;6,0;;;;;;1,0;;8,0;4,0;;2,0;11,0;1,0;1,0;;;4,0;;1,0;;;;7,0;;;;;;8,0;;2,0;;;;;;;;;4,0;;;;20,0;;;;;;;;;;2,0;4,0;19,0;;4,0;;1,0;;;24,0;;;;;4,0;3,0;;;;;;1,0;;2,0;;;;;8,0;;;;;5,0;;5,0;;;3,0;44,0;8,0;;4,0;15,0;;;;2,0;;;;;;13,0;4,0;;;;13,0;;;10,0;8,0;;;;4,0;;;2,0;1,0;;;9,0;;;;;1,0;;1,0;1,0;22,0;9,0;1,0;;13,0;;;10,0;8,0;;9,0;;5,0;2,0;17,0;;;;;1,0;1,0;;;;20,0;4,0;1,0;;1,0;5,0;;3,0;30,0;;;1,0;22,0;2,0;;;3,0;2,0;1,0;1,0;;;;14,0;;;;;;;;;3,0;;;1,0;1,0;;1,0;2,0;3,0;;;1,0;;;;6,0;7,0;2,0;;9,0;;4,0;;;;13,0;21,0;;;8,0;;;4,0;;;4,0;5,0;1,0;;4,0;;1,0;1,0;1,0;10,0;;;1,0;;2,0;;;;9,0;2,0;5,0;1,0;1,0;5,0;;2,0;;;1,0;1,0;;;;;;;6,0;;;;1,0;6,0;;;4,0;;;;;;4,0;1,0;;;;;;10,0;;;;;;;;;;;;;;;1,0;;16,0;2,0;;4,0;;;;1,0;;2,0;;1,0;;1,0;;;9,0;;;;;;6,0;2,0;;;;;;;;;;;;3,0;2,0;7,0;;1,0;3,0;;2,0;1,0;2,0;;;;;;;;;;1,0;;;;;;;1,0;;2,0;;;;;;;2,0;;;;2,0;3,0;2,0;;2,0;;;;1,0;;2,0;14,0;;1,0;;2,0;2,0;;11,0;;4,0;;;;6,0;;8,0;;;;2,0;3,0;;;1,0;;;;12,0;;;;;;2,0;4,0;;;;;;;;;2,0;1,0;;;;;;;1,0;2,0;3,0;;;;;;;;;1,0;;2,0;;;;1,0;;;;;;3,0;;;;;;;;;8,0;;;;6,0;;3,0;;;;;;;;;;;;;;;;;;;;;;;;;;;;2,0;;;;;;;;;;;;;;;;;;;;;;;;1,0;;;;;1,0;;;;2,0;;;;1,0;;;;;;;;;;;;;;;;3,0;3,0;;;;;;;;4,0;;1,0;;;;5,0;;;;;;;;;;;;;;;1,0;;;;;1,0;;;;;2,0;;2,0;;;;;;;;;;;;;;2,0;;3,0;2,0;;;;;;;3,0;;;;;1,0;;;;;;1,0;;;1,0;;;;2,0;;;;;;;;;;;;;;;;;10,0;;;2,0;;1,0;10,0;;;;;;;;;;;;;;;;;;;;;;4,0;;;;;;;;;;;;;2,0;;;;;;;1,0;;;;;;;;;;;;;1,0;1,0;;;;;;;;;;2,0;;;;;
combination;;13,0;;16,0;;24,0;20,0;15,0;2,0;1,0;;;1,0;76,0;2,0;1,0;23,0;2,0;7,0;5,0;9,0;8,0;21,0;;22,0;3,0;1,0;26,0;7,0;3,0;23,0;1,0;;1,0;4,0;40,0;17,0;;14,0;;47,0;87,0;3,0;11,0;12,0;1,0;;6,0;3,0;3,0;4,0;;1,0;;16,0;11,0;69,0;;2,0;18,0;1,0;5,0;25,0;3,0;139,0;;42,0;1,0;3,0;;10,0;96,0;28,0;10,0;;;7,0;4,0;2,0;22,0;89,0;;6,0;3,0;37,0;5,0;;20,0;;8,0;6,0;;3,0;;2,0;;96,0;7,0;47,0;64,0;57,0;3,0;2,0;5,0;17,0;16,0;5,0;4,0;;;3,0;2,0;13,0;;;4,0;3,0;20,0;18,0;73,0;1,0;;23,0;8,0;4,0;4,0;68,0;1,0;3,0;2,0;4,0;23,0;;27,0;;;12,0;;2,0;;;;;;5,0;6,0;4,0;18,0;27,0;2,0;;8,0;6,0;;;;;3,0;3,0;1,0;1,0;2,0;1,0;1,0;;;6,0;3,0;;3,0;4,0;;5,0;11,0;2,0;4,0;;4,0;1,0;;2,0;;;6,0;;1,0;21,0;;6,0;1,0;;;;1,0;;8,0;8,0;;2,0;;;1,0;;;2,0;1,0;7,0;2,0;27,0;14,0;1,0;23,0;6,0;;;1,0;1,0;3,0;1,0;95,0;19,0;;;;7,0;;15,0;;;7,0;2,0;1,0;11,0;;1,0;;;;;21,0;;4,0;;;1,0;62,0;2,0;11,0;4,0;;;;;4,0;1,0;;14,0;11,0;;;1,0;8,0;5,0;6,0;2,0;;;6,0;24,0;6,0;;1,0;17,0;7,0;6,0;;9,0;6,0;;4,0;3,0;3,0;9,0;;2,0;;;1,0;4,0;;;;;1,0;1,0;2,0;12,0;2,0;;;;;2,0;1,0;;2,0;1,0;3,0;;26,0;;;;;;;2,0;;;1,0;10,0;27,0;;4,0;2,0;;;4,0;6,0;4,0;;;;;;2,0;;;1,0;;;;;3,0;;;14,0;;;;;2,0;;;26,0;4,0;4,0;2,0;25,0;1,0;1,0;;2,0;1,0;;3,0;;;2,0;;;;5,0;2,0;2,0;;;;4,0;1,0;19,0;16,0;23,0;;2,0;8,0;9,0;6,0;;2,0;;1,0;3,0;2,0;1,0;12,0;;4,0;2,0;;;4,0;1,0;;27,0;67,0;2,0;5,0;32,0;3,0;;4,0;;2,0;3,0;10,0;;7,0;;;;1,0;;3,0;5,0;16,0;1,0;23,0;;9,0;2,0;2,0;7,0;1,0;3,0;2,0;5,0;;1,0;;;;11,0;6,0;;3,0;3,0;;43,0;2,0;;;;4,0;;;1,0;26,0;2,0;;1,0;10,0;2,0;;;;1,0;1,0;9,0;9,0;;2,0;3,0;2,0;;;;;8,0;;1,0;;;20,0;;;18,0;;1,0;35,0;;;;;;2,0;1,0;2,0;1,0;1,0;;1,0;;1,0;21,0;15,0;1,0;;;;5,0;9,0;;;;1,0;1,0;;;;34,0;4,0;1,0;;;;;;;;;2,0;;10,0;31,0;1,0;;;;;4,0;5,0;;6,0;2,0;1,0;;8,0;;2,0;1,0;1,0;;4,0;6,0;2,0;;;;;;1,0;;2,0;2,0;;6,0;;;;;;;3,0;20,0;4,0;;3,0;;1,0;;;1,0;1,0;3,0;;;;2,0;11,0;2,0;3,0;;;1,0;;2,0;6,0;2,0;;;;;11,0;;1,0;;3,0;10,0;9,0;1,0;;1,0;2,0;;;2,0;6,0;3,0;;;;4,0;1,0;3,0;;;1,0;3,0;;;;;5,0;;;;;;;2,0;;;;;2,0;1,0;;1,0;;3,0;1,0;2,0;;2,0;;2,0;;6,0;;;;;1,0;1,0;1,0;;;;;8,0;;2,0;;1,0;;1,0;;19,0;;;6,0;;1,0;;;3,0;;;;;1,0;;3,0;;;;;;;1,0;;;1,0;;1,0;;;;1,0;;;;2,0;;1,0;;;;2,0;3,0;;3,0;2,0;;;;;2,0;;2,0;3,0;;;40,0;;2,0;1,0;;1,0;5,0;1,0;2,0;;1,0;9,0;5,0;9,0;;;2,0;;;;;1,0;;;1,0;5,0;2,0;;;;;;2,0;;5,0;;1,0;;3,0;;;1,0;;12,0;;;;;1,0;;;1,0;;;;;;;;;;;;;;1,0;;;;11,0;2,0;6,0;;;2,0;;;;;;;;;;;;;;;3,0;;6,0;2,0;11,0;3,0;;;;3,0;;;2,0;1,0;;;;;;;;;;;;1,0;8,0;;;1,0;3,0;7,0;;1,0;;;;;1,0;2,0;2,0;;2,0;2,0;;;;2,0;;;;;;1,0;;1,0;;2,0;1,0;2,0;1,0;;;6,0;;2,0;;;1,0;;2,0;;1,0;2,0;;;;;;3,0;;2,0;;5,0;;3,0;;1,0;1,0;2,0;1,0;;;;;1,0;;;;;;;;3,0;3,0;;1,0;1,0;;1,0;;;;;;;;;;;;;;;2,0;;;;1,0;12,0;;;;2,0;;;6,0;;4,0;3,0;;;;;;;;;;1,0;1,0;;;1,0;;1,0;;;;;;;;;9,0;2,0;;1,0;;;;;;;;;
command;;26,0;9,0;75,0;4,0;32,0;;7,0;;2,0;;;;126,0;;6,0;142,0;;1,0;;;;23,0;11,0;32,0;3,0;;11,0;17,0;9,0;113,0;62,0;2,0;6,0;;87,0;19,0;;4,0;1,0;93,0;282,0;;12,0;63,0;;;1,0;4,0;;;3,0;;4,0;7,0;3,0;;;1,0;88,0;;;14,0;;266,0;3,0;89,0;2,0;;;7,0;75,0;15,0;;;3,0;;11,0;1,0;22,0;130,0;;65,0;6,0;30,0;2,0;;13,0;;1,0;20,0;;;32,0;4,0;;1,0;7,0;89,0;145,0;37,0;28,0;;17,0;88,0;69,0;1,0;21,0;;;;7,0;13,0;7,0;;1,0;5,0;7,0;13,0;30,0;9,0;;80,0;2,0;;19,0;135,0;;5,0;;56,0;;;157,0;1,0;;22,0;22,0;22,0;;;;4,0;4,0;9,0;6,0;6,0;1,0;43,0;;1,0;3,0;12,0;;;1,0;;;;;;18,0;10,0;7,0;;2,0;13,0;2,0;5,0;8,0;1,0;;5,0;54,0;;;;;10,0;;;;;;;1,0;;1,0;23,0;;;1,0;;;;;;;3,0;;;;;;4,0;13,0;5,0;;18,0;3,0;26,0;59,0;4,0;;;;25,0;;;2,0;2,0;17,0;2,0;;;;9,0;;;3,0;;;4,0;;;30,0;;;;19,0;;;;;;22,0;;;7,0;;;;1,0;2,0;;;6,0;2,0;;;5,0;155,0;1,0;8,0;;;;;;8,0;;7,0;12,0;5,0;;;;126,0;1,0;;;2,0;4,0;3,0;;;;;9,0;2,0;1,0;9,0;;;;5,0;98,0;1,0;;;;;;1,0;3,0;;18,0;;;28,0;;;;;2,0;1,0;;4,0;1,0;7,0;28,0;23,0;3,0;;4,0;;8,0;;5,0;2,0;;;;;39,0;;8,0;;7,0;;2,0;34,0;;;;1,0;;6,0;;;14,0;;3,0;;10,0;;3,0;;87,0;20,0;5,0;9,0;;2,0;17,0;23,0;;9,0;5,0;5,0;;4,0;17,0;;16,0;4,0;13,0;;1,0;;581,0;38,0;;2,0;;43,0;2,0;1,0;;17,0;3,0;37,0;2,0;35,0;4,0;10,0;;47,0;28,0;8,0;;163,0;;11,0;;14,0;17,0;5,0;4,0;49,0;;177,0;1,0;27,0;17,0;24,0;3,0;;1,0;;;25,0;;22,0;1,0;288,0;50,0;144,0;11,0;2,0;6,0;;30,0;14,0;61,0;2,0;15,0;41,0;29,0;;;3,0;31,0;11,0;1,0;7,0;28,0;;145,0;12,0;10,0;1,0;19,0;2,0;;;;;1,0;;27,0;;;6,0;;1,0;;8,0;4,0;3,0;6,0;2,0;22,0;40,0;;8,0;1,0;;2,0;;;2,0;19,0;5,0;5,0;5,0;40,0;2,0;19,0;24,0;;;;2,0;7,0;;14,0;1,0;14,0;13,0;;13,0;;20,0;;3,0;3,0;1,0;4,0;6,0;41,0;1,0;7,0;;;12,0;;5,0;;;;5,0;;;;;;1,0;;;;30,0;;2,0;3,0;10,0;2,0;3,0;5,0;7,0;2,0;1,0;;6,0;;10,0;;;;4,0;;;12,0;2,0;9,0;4,0;;4,0;;;;7,0;1,0;;31,0;;11,0;145,0;11,0;13,0;;15,0;24,0;;;;6,0;;;2,0;;11,0;;;5,0;;;12,0;14,0;2,0;3,0;;29,0;;;44,0;6,0;5,0;3,0;;;9,0;;7,0;2,0;3,0;1,0;2,0;;;1,0;;;;17,0;;4,0;;5,0;2,0;4,0;6,0;;65,0;1,0;2,0;;;3,0;2,0;17,0;21,0;;31,0;;2,0;;;;;3,0;3,0;;1,0;;1,0;;;2,0;;;;19,0;2,0;;;;;;4,0;;80,0;1,0;;13,0;;;20,0;;;21,0;4,0;;10,0;;;10,0;;10,0;;;;5,0;21,0;12,0;35,0;1,0;;;2,0;;1,0;;;;;1,0;;;;;;1,0;44,0;28,0;;;;;;;;;2,0;;5,0;5,0;;23,0;;7,0;;;3,0;4,0;5,0;;;;1,0;;4,0;;;;;;;3,0;;11,0;;2,0;;;;;;1,0;4,0;;;;;;;;;;;;;;;;;;;;;24,0;;;;;;;;2,0;;;36,0;;;;;9,0;1,0;1,0;;;;2,0;;;;;;18,0;;;;;9,0;;;;;;;;;;;6,0;;;4,0;;;;;;19,0;;;;;;;;;;;1,0;;;;;;;;3,0;;;;;;2,0;;;;;;33,0;;4,0;;;;;8,0;;;;1,0;;;;1,0;;;;7,0;;;1,0;3,0;;;;;;3,0;;1,0;;1,0;1,0;;;3,0;;;;3,0;9,0;11,0;16,0;3,0;8,0;1,0;;1,0;2,0;;;;;;;;1,0;;;1,0;1,0;;1,0;1,0;4,0;2,0;;;;8,0;2,0;;2,0;;6,0;;;;;;;;;;4,0;;;;;;;;;;;;1,0;;1,0;;;;;;;;;;;;;;;;;;;2,0;4,0;;;;;;;;;2,0;;;;;;;;;2,0;;;;;1,0;;
compartment;;1,0;;;;11,0;;3,0;;;;;;6,0;;;16,0;;8,0;;;;2,0;1,0;;;;9,0;;;18,0;5,0;;;;1,0;11,0;2,0;;1,0;10,0;35,0;2,0;2,0;7,0;15,0;;2,0;;;;;9,0;18,0;;;29,0;;;;;;;;26,0;;31,0;;;7,0;1,0;7,0;23,0;;;;;;;;6,0;;;;3,0;;;;;5,0;1,0;4,0;;1,0;19,0;;;;36,0;3,0;23,0;2,0;;;1,0;4,0;;;;;;;28,0;;12,0;;;3,0;;3,0;;;3,0;4,0;;20,0;6,0;;;;3,0;;;15,0;;;4,0;;;;;5,0;;;2,0;;2,0;16,0;;1,0;;2,0;25,0;9,0;;;;;;;;21,0;;;;;1,0;25,0;;;;;1,0;4,0;;4,0;;;;;;;2,0;11,0;1,0;15,0;;;;15,0;;;;;4,0;;115,0;;10,0;18,0;;;;;;;5,0;;;17,0;;;;;5,0;6,0;;1,0;;;;;;;;3,0;7,0;;;;3,0;;1,0;;6,0;;;;1,0;;;1,0;;;14,0;;5,0;1,0;21,0;2,0;;;;3,0;;2,0;2,0;10,0;1,0;;;;1,0;33,0;42,0;;;;1,0;20,0;;4,0;;;;;4,0;3,0;;1,0;1,0;;2,0;;;;3,0;1,0;;;;;;;2,0;;2,0;;;;;;;;;;1,0;9,0;;;1,0;2,0;5,0;;;;23,0;32,0;;1,0;6,0;;3,0;2,0;4,0;;;;18,0;;1,0;;6,0;;;;;;;;;1,0;;;6,0;8,0;;16,0;;;;;;;1,0;;2,0;3,0;4,0;;;;;;;;;;;;;;;4,0;3,0;2,0;;;;;10,0;;;;6,0;1,0;;;;;;;;2,0;;1,0;;;1,0;;;1,0;;;;4,0;;4,0;;;;3,0;;5,0;;1,0;;;;;;;;;;23,0;3,0;;;21,0;1,0;;;3,0;;;190,0;;3,0;;18,0;3,0;;;;;;;;;;;;1,0;;111,0;;;;;;3,0;;;;;;;;;;;;;28,0;;;;;;;;1,0;4,0;8,0;;;;1,0;;;;;;;;;1,0;;;;;;;;;;;1,0;;;;2,0;;;1,0;;12,0;;;4,0;1,0;;;;;;;;;;;;1,0;;2,0;1,0;1,0;5,0;;;;;73,0;;2,0;;2,0;7,0;;10,0;;;;;;;;4,0;;;4,0;4,0;;;;;;25,0;;;;;;;;;;;;;;5,0;7,0;;2,0;;;1,0;;;;;;46,0;;;;1,0;;;;;;;;;1,0;;;;;;;;1,0;;;;3,0;;;;;;;;;;;;;;;;;;;;;;;;;;;;;;;;;;;1,0;2,0;;;;;;;;;;;;;;;14,0;;;2,0;;;;;;;;;;;;1,0;1,0;;;;;;;;;6,0;;;9,0;2,0;;;9,0;;;;;6,0;;;;;;;;;;6,0;;;;;;;;;;1,0;;;;;;;;;;;;;;2,0;;;;;;3,0;;;;;;;;;;;1,0;;;1,0;;1,0;;;;;;;;;;;;;;;3,0;;;;;;12,0;;;1,0;;;;;;;;;;;;;;;;;;;;;5,0;;;;;;;;;;;;;;;;5,0;;;;;;;;;;;;;;;;;;;;;;;;;;;;;;;;;;;1,0;;4,0;;;;;2,0;;;;;;;;;;;;;;;;;;;;;;;;;;;;;;;;12,0;;;;;;;;;;;;;;;;;;;;;;;;;;;;;;;;;;;1,0;3,0;1,0;;;;;;;;;;;;;;;;;;;;;;;;;;;;;;;;;;;;;;;;;;;;;;;;;;;;;;;;;;;;;;;;
complete;;8,0;;;1,0;4,0;12,0;7,0;;;;;;4,0;;;8,0;;6,0;1,0;;1,0;;;2,0;;;;;;5,0;14,0;1,0;3,0;;51,0;4,0;;3,0;;11,0;17,0;;4,0;9,0;;;2,0;;;;;1,0;;5,0;1,0;1,0;;;3,0;;;1,0;;50,0;;9,0;;;;;34,0;3,0;;;;;;;4,0;36,0;;7,0;1,0;5,0;;;14,0;;3,0;;;;;3,0;;15,0;1,0;5,0;5,0;8,0;4,0;1,0;13,0;11,0;1,0;;;;;;;3,0;;;;8,0;;8,0;11,0;2,0;;19,0;;;6,0;11,0;;;1,0;40,0;4,0;;59,0;;;3,0;1,0;4,0;;;4,0;4,0;;20,0;;1,0;;7,0;2,0;;;3,0;;14,0;9,0;;;;;;4,0;;1,0;;;6,0;1,0;;;;1,0;1,0;1,0;;;;1,0;3,0;;;;;;;;1,0;;1,0;9,0;;;;;;;4,0;;;;;;;;;1,0;16,0;;;5,0;1,0;4,0;;;;4,0;4,0;;;3,0;7,0;;;;;;2,0;;1,0;4,0;;10,0;2,0;;;;;;;;;;;;;1,0;4,0;;;;;;;5,0;;2,0;;5,0;;;11,0;14,0;;29,0;;;;;;;;;;;;;1,0;3,0;;1,0;;;;;;;;;14,0;;;;;;;;;2,0;;3,0;;;;;;;;;;4,0;;;;;;;;;;;3,0;12,0;;;;;;;7,0;;;;;;1,0;;3,0;;;;;5,0;;;;;1,0;;;;;1,0;;;;2,0;16,0;;6,0;;;;;3,0;;16,0;;;;;;;1,0;;14,0;;;;;1,0;14,0;;3,0;2,0;;1,0;7,0;1,0;;6,0;;;;7,0;;;;;11,0;;;;;;;4,0;;;2,0;1,0;;10,0;;4,0;21,0;;;;;;;;;1,0;;14,0;;4,0;;;;;;;2,0;;2,0;;1,0;7,0;;2,0;4,0;;;;;;11,0;;;;;1,0;;;;7,0;2,0;3,0;;;;;;;1,0;4,0;;;3,0;10,0;4,0;3,0;;;;;1,0;;;;2,0;;;;16,0;;;1,0;;;;;;;;;;;;9,0;;;;;;;;;;;3,0;;;;;1,0;;;3,0;;;;;;;;;;;4,0;;;;7,0;;;;1,0;;;;11,0;;2,0;;;;2,0;;;;1,0;;;;;;;6,0;1,0;;;;;1,0;;;3,0;;;;;;3,0;;;;;3,0;;;;3,0;;2,0;;;;;;;;;;;;;;3,0;;;1,0;1,0;;;;;;;;;;;;;6,0;;;;;;;;;;;;;;;;2,0;;4,0;1,0;;;;;;;;;;;;;;4,0;1,0;;1,0;;;;;;;;1,0;;;17,0;;;;;;2,0;;;;;2,0;;;15,0;;;;;11,0;3,0;1,0;;;;;;;4,0;;;3,0;;;;;;;;9,0;13,0;;;;;;;;;;;;27,0;;;;;;1,0;;;;;;;;;3,0;;;2,0;;;1,0;;;1,0;;;;;;;;;;;;;;;;;;;;;;;;;;;;;;1,0;;3,0;;;;;;;;2,0;;2,0;;;;;;;;;;;;;;4,0;2,0;4,0;;;4,0;;13,0;;;;;2,0;;;;;4,0;2,0;;;;;;;1,0;;;6,0;;;;;;;;;;1,0;;;;10,0;;;;14,0;;;;;1,0;;;;;;;;;;;;;;1,0;1,0;;;;;;;;;;;1,0;;2,0;;;;;;;;;;;;;;;;;;;;;;;;;;;;;1,0;;2,0;;;;;;;;;;;;;2,0;;;;;;;;;;;;;;;;;;;;2,0;;;;;;;;;;;;;;;;;;;;;;;;;;;;;;;;;;;;;;;;;;;;;;;;;;;;;;;;;;;;
compress;;2,0;1,0;;;9,0;1,0;;;;1,0;;1,0;9,0;;;32,0;;;;6,0;;7,0;;;2,0;1,0;4,0;;1,0;101,0;7,0;2,0;;;354,0;5,0;;;;7,0;44,0;2,0;41,0;13,0;1,0;;7,0;;;;;6,0;3,0;4,0;;14,0;;1,0;59,0;;;1,0;1,0;484,0;1,0;18,0;4,0;;;;32,0;18,0;12,0;;3,0;11,0;;1,0;30,0;61,0;4,0;;;14,0;;;1,0;;8,0;3,0;3,0;2,0;;;;15,0;1,0;20,0;;10,0;4,0;;120,0;13,0;21,0;;;;;;;4,0;8,0;;;11,0;;1,0;22,0;;;21,0;10,0;;34,0;25,0;;1,0;;3,0;1,0;;8,0;;;10,0;;;;;;;;1,0;2,0;1,0;7,0;2,0;;;;;7,0;6,0;;;;;;;7,0;;8,0;;;2,0;16,0;;;;;1,0;17,0;5,0;6,0;;;6,0;2,0;;;;1,0;;;3,0;8,0;70,0;3,0;;;;;;;4,0;3,0;3,0;1,0;;2,0;;;;;25,0;;1,0;7,0;2,0;5,0;;;;2,0;14,0;3,0;;3,0;;;;;4,0;;12,0;2,0;;2,0;;;5,0;11,0;;;4,0;;;2,0;1,0;5,0;;;8,0;2,0;;;6,0;;;;1,0;2,0;;3,0;;11,0;;;2,0;17,0;;9,0;1,0;3,0;1,0;;;;;;;;3,0;;1,0;;;3,0;;;2,0;;;;;;18,0;;;3,0;;;;2,0;;;15,0;3,0;;;4,0;10,0;;2,0;;;4,0;;;;;2,0;;1,0;;1,0;13,0;;2,0;5,0;1,0;2,0;;;;;;;1,0;;;;28,0;;10,0;7,0;;;3,0;1,0;;;;5,0;1,0;1,0;6,0;15,0;;2,0;1,0;;;1,0;;;66,0;3,0;;;;;;;;;;;;;2,0;;;;2,0;;;1,0;10,0;;;;;;2,0;;1,0;;;;1,0;1,0;;4,0;;4,0;;;;16,0;1,0;;;;10,0;;6,0;;;14,0;;7,0;4,0;;;;;;;13,0;;7,0;;29,0;1,0;4,0;3,0;;11,0;;3,0;;;;13,0;;;1,0;;;2,0;;5,0;2,0;;;;;;;;4,0;4,0;;;;;;;;;1,0;;6,0;;;;;;;1,0;7,0;;2,0;;;;;;;2,0;;8,0;;13,0;1,0;;;;;1,0;;;3,0;;;;;1,0;32,0;;;;8,0;;;;;12,0;;1,0;;;3,0;15,0;3,0;;;2,0;;;;2,0;;1,0;;2,0;;;;;2,0;2,0;;;;;1,0;;;;;;14,0;;;17,0;2,0;;;;;;;;4,0;;;1,0;;;1,0;;9,0;3,0;;;;;3,0;;;;2,0;;;;;;;;;;;5,0;;;;1,0;1,0;;1,0;;;13,0;;;;;;;;;11,0;;;;;2,0;;;;;;;;;3,0;;;;;2,0;;;;;;;;1,0;9,0;;3,0;;;6,0;9,0;;;;;;1,0;1,0;;2,0;;;;;;;6,0;4,0;1,0;49,0;;;2,0;1,0;;12,0;;;;;;16,0;;;3,0;1,0;1,0;;6,0;9,0;;;1,0;;1,0;1,0;;;;;;4,0;;;;;5,0;1,0;1,0;;;;4,0;2,0;1,0;1,0;;;;;;;;2,0;4,0;;;;;;1,0;;;;;4,0;;3,0;;;2,0;;;;;1,0;;;1,0;5,0;;;;;2,0;;;;;;;;;;1,0;;;;;;;1,0;;;;;;;;;;;3,0;5,0;;;;;;14,0;;;;;;;1,0;;7,0;;;;;;;;;2,0;2,0;;;18,0;;;;;;;;;;;;;;;;;;;;;5,0;;2,0;;;;2,0;;;;;;;;;76,0;2,0;;;1,0;;;;;;;;13,0;;;6,0;;6,0;1,0;;1,0;;;5,0;;;;;;;;;;;;;3,0;;;;;2,0;4,0;;;1,0;;;;;;;;;;;;;;;;;;;3,0;;;;;;;;;;;;;;;2,0;;;;18,0;;;;;;;;;;;;;;1,0;1,0;;;;;;;;;;;;12,0;;2,0;;;;;;;;;;;;;;;;;;1,0;;1,0;;;;;2,0;1,0;;;;;;;8,0;;;;;;;;;;;;;10,0;;;;;
configuration;;3,0;1,0;26,0;24,0;24,0;94,0;22,0;;;;;;165,0;9,0;2,0;69,0;;2,0;4,0;;;9,0;1,0;14,0;;;37,0;27,0;;119,0;20,0;4,0;6,0;;134,0;14,0;3,0;51,0;2,0;202,0;144,0;1,0;16,0;58,0;6,0;;20,0;;1,0;;;63,0;3,0;20,0;18,0;20,0;;;15,0;;12,0;9,0;10,0;170,0;6,0;165,0;13,0;2,0;;5,0;78,0;39,0;;2,0;;22,0;5,0;11,0;19,0;113,0;7,0;74,0;4,0;50,0;11,0;;34,0;9,0;4,0;79,0;9,0;;6,0;2,0;;22,0;23,0;139,0;27,0;37,0;12,0;;9,0;24,0;31,0;19,0;9,0;18,0;;;2,0;1,0;;2,0;;2,0;9,0;3,0;39,0;1,0;;39,0;;13,0;24,0;113,0;;15,0;;61,0;4,0;;35,0;;;23,0;6,0;3,0;;5,0;10,0;1,0;;3,0;;18,0;38,0;64,0;1,0;7,0;2,0;19,0;2,0;;;;;;;3,0;11,0;21,0;2,0;;4,0;15,0;44,0;;5,0;;;22,0;4,0;7,0;14,0;2,0;;19,0;;1,0;;19,0;24,0;3,0;2,0;24,0;4,0;42,0;12,0;;;2,0;3,0;1,0;2,0;61,0;3,0;32,0;3,0;;1,0;10,0;2,0;7,0;1,0;5,0;1,0;14,0;59,0;4,0;1,0;;;1,0;16,0;13,0;7,0;;16,0;1,0;;;;7,0;;69,0;1,0;4,0;10,0;2,0;;14,0;1,0;1,0;;21,0;;6,0;;;5,0;1,0;3,0;6,0;20,0;10,0;10,0;35,0;3,0;;;2,0;9,0;6,0;1,0;24,0;37,0;;;3,0;38,0;18,0;4,0;3,0;1,0;;;4,0;6,0;;;1,0;13,0;;;28,0;12,0;;5,0;22,0;1,0;10,0;;;;1,0;15,0;3,0;6,0;1,0;;;;1,0;;10,0;1,0;2,0;5,0;1,0;1,0;6,0;;5,0;;2,0;1,0;;31,0;;10,0;3,0;43,0;3,0;27,0;7,0;30,0;6,0;42,0;2,0;19,0;21,0;3,0;11,0;;;;4,0;;;;1,0;6,0;2,0;4,0;2,0;2,0;;;13,0;6,0;1,0;5,0;1,0;20,0;128,0;2,0;5,0;3,0;;2,0;2,0;;8,0;;;1,0;31,0;20,0;1,0;;;6,0;;7,0;1,0;;;5,0;;;19,0;15,0;31,0;3,0;;9,0;5,0;;28,0;2,0;;13,0;;9,0;2,0;2,0;1,0;4,0;;3,0;9,0;6,0;4,0;19,0;;33,0;2,0;;3,0;9,0;;4,0;3,0;8,0;17,0;4,0;32,0;;2,0;3,0;;6,0;25,0;2,0;;;;21,0;1,0;;;2,0;1,0;68,0;3,0;10,0;1,0;8,0;1,0;;209,0;;;;9,0;8,0;5,0;;;4,0;11,0;3,0;;4,0;;;36,0;;;;;2,0;3,0;;;17,0;2,0;;11,0;3,0;;4,0;11,0;;;;;;3,0;5,0;32,0;7,0;;;1,0;;;;12,0;;;7,0;3,0;;8,0;20,0;1,0;;11,0;;3,0;1,0;;4,0;;;1,0;;2,0;49,0;4,0;1,0;;;3,0;;1,0;;;8,0;;;;2,0;;67,0;;;2,0;4,0;4,0;;;1,0;10,0;6,0;;1,0;;2,0;3,0;2,0;11,0;1,0;;;2,0;3,0;;2,0;;71,0;;1,0;;;39,0;2,0;;;;128,0;4,0;13,0;;;;;1,0;;6,0;;9,0;;2,0;5,0;2,0;1,0;;6,0;1,0;;1,0;4,0;;;;;3,0;;4,0;4,0;9,0;3,0;10,0;;1,0;12,0;;8,0;3,0;;;;;1,0;5,0;;2,0;;;25,0;;;;4,0;;;;;29,0;2,0;5,0;2,0;3,0;;3,0;48,0;;1,0;7,0;3,0;;2,0;;;;2,0;2,0;1,0;9,0;50,0;;4,0;;;4,0;;;;;8,0;9,0;4,0;;7,0;10,0;;;;19,0;;;1,0;;;;;;2,0;2,0;;3,0;;;;3,0;9,0;14,0;4,0;;1,0;;9,0;1,0;7,0;15,0;;2,0;;;4,0;;3,0;2,0;;4,0;3,0;;7,0;;;3,0;9,0;2,0;9,0;2,0;;;3,0;18,0;;1,0;;11,0;;;;;;5,0;;;7,0;;1,0;3,0;2,0;3,0;;;6,0;8,0;;7,0;;1,0;1,0;;;6,0;3,0;6,0;5,0;3,0;3,0;1,0;1,0;2,0;;;;;9,0;3,0;10,0;4,0;3,0;;;1,0;1,0;;;;;1,0;;4,0;49,0;;;4,0;;;;1,0;;23,0;;;23,0;2,0;;;;;1,0;;;;8,0;1,0;8,0;;;;;;1,0;;;;;;;;;;;;13,0;5,0;;;;1,0;;1,0;;;;;;;3,0;4,0;;1,0;5,0;;1,0;;2,0;;;;;;3,0;3,0;;;;;3,0;;;1,0;;;16,0;;9,0;2,0;;;;;;;;3,0;1,0;21,0;;;2,0;;1,0;;;;;;1,0;;;;;;;;;;;;;9,0;;;;;;6,0;3,0;1,0;;;;4,0;5,0;;12,0;2,0;;;;1,0;;;;1,0;4,0;;;1,0;1,0;;2,0;;;1,0;;1,0;;;;;;;;;;;1,0;;;;;3,0;7,0;;;;;;1,0;1,0;;16,0;;;;;;;;6,0;;;;;;;;1,0;;;;;1,0;;;6,0;;;;;;3,0;;;;;91,0;;;;1,0;;;1,0;;1,0;;;;;2,0;;;;;;;;
connect;;62,0;;15,0;;225,0;34,0;136,0;;2,0;4,0;5,0;80,0;275,0;2,0;1,0;52,0;13,0;44,0;1,0;72,0;2,0;8,0;13,0;106,0;1,0;6,0;193,0;42,0;8,0;448,0;166,0;;8,0;3,0;72,0;34,0;14,0;26,0;13,0;28,0;774,0;22,0;102,0;124,0;128,0;;311,0;;;6,0;3,0;108,0;105,0;7,0;6,0;150,0;;5,0;36,0;6,0;5,0;31,0;2,0;355,0;4,0;353,0;1,0;;14,0;18,0;396,0;107,0;16,0;;;11,0;7,0;24,0;104,0;139,0;1,0;17,0;12,0;375,0;60,0;2,0;83,0;17,0;11,0;3,0;3,0;17,0;16,0;6,0;2,0;182,0;19,0;350,0;308,0;132,0;54,0;7,0;14,0;105,0;255,0;;14,0;6,0;;2,0;42,0;90,0;1,0;8,0;;19,0;75,0;5,0;359,0;;3,0;344,0;1,0;;17,0;265,0;;19,0;4,0;11,0;11,0;21,0;740,0;2,0;;36,0;21,0;3,0;1,0;4,0;32,0;1,0;;19,0;20,0;67,0;62,0;15,0;30,0;21,0;19,0;365,0;92,0;29,0;34,0;2,0;;1,0;1,0;228,0;;1,0;21,0;36,0;4,0;104,0;95,0;;32,0;20,0;;24,0;124,0;4,0;76,0;44,0;8,0;8,0;1,0;3,0;8,0;11,0;35,0;15,0;36,0;21,0;11,0;117,0;113,0;18,0;6,0;20,0;27,0;98,0;103,0;526,0;;88,0;10,0;5,0;138,0;1,0;43,0;10,0;3,0;646,0;35,0;50,0;342,0;25,0;6,0;15,0;;2,0;128,0;292,0;50,0;4,0;40,0;102,0;7,0;;37,0;206,0;56,0;867,0;6,0;6,0;6,0;23,0;5,0;9,0;;48,0;4,0;4,0;;46,0;;7,0;61,0;24,0;57,0;8,0;22,0;26,0;26,0;249,0;23,0;17,0;10,0;17,0;114,0;229,0;141,0;346,0;364,0;10,0;1,0;61,0;64,0;29,0;143,0;76,0;15,0;2,0;;14,0;9,0;2,0;312,0;139,0;59,0;69,0;7,0;18,0;30,0;6,0;49,0;44,0;14,0;91,0;379,0;;16,0;52,0;42,0;685,0;8,0;191,0;11,0;19,0;33,0;2,0;57,0;23,0;61,0;187,0;13,0;14,0;19,0;109,0;28,0;14,0;54,0;25,0;77,0;6,0;162,0;8,0;6,0;37,0;8,0;26,0;12,0;42,0;26,0;29,0;65,0;51,0;44,0;68,0;3,0;18,0;1,0;8,0;15,0;302,0;105,0;17,0;23,0;62,0;24,0;19,0;8,0;9,0;4,0;17,0;8,0;58,0;50,0;18,0;20,0;11,0;15,0;65,0;29,0;2,0;185,0;6,0;50,0;;23,0;18,0;39,0;11,0;160,0;146,0;108,0;5,0;;3,0;8,0;2,0;33,0;2,0;;13,0;3,0;5,0;10,0;11,0;49,0;11,0;5,0;6,0;18,0;1,0;3,0;336,0;14,0;2,0;2,0;1,0;47,0;2,0;11,0;;1,0;;6,0;;16,0;6,0;21,0;3,0;19,0;3,0;1,0;3,0;140,0;9,0;12,0;15,0;25,0;3,0;55,0;11,0;164,0;6,0;32,0;1,0;32,0;23,0;21,0;6,0;10,0;3,0;;2,0;5,0;;5,0;1,0;121,0;14,0;31,0;7,0;5,0;28,0;10,0;23,0;7,0;9,0;9,0;40,0;4,0;119,0;13,0;23,0;415,0;3,0;27,0;1,0;4,0;;;68,0;2,0;;35,0;7,0;13,0;27,0;61,0;;4,0;7,0;2,0;37,0;1,0;2,0;;31,0;;2,0;;10,0;;6,0;13,0;5,0;120,0;13,0;75,0;17,0;61,0;13,0;3,0;46,0;7,0;27,0;10,0;10,0;4,0;23,0;6,0;23,0;1,0;;1,0;3,0;13,0;33,0;19,0;17,0;7,0;4,0;3,0;;6,0;10,0;7,0;7,0;60,0;5,0;6,0;;6,0;9,0;9,0;24,0;7,0;11,0;217,0;19,0;16,0;21,0;84,0;279,0;362,0;2,0;28,0;;;39,0;7,0;33,0;;121,0;;14,0;32,0;31,0;22,0;2,0;;6,0;7,0;3,0;1,0;17,0;83,0;1,0;11,0;;11,0;46,0;;8,0;6,0;;1,0;9,0;21,0;;28,0;34,0;;4,0;5,0;7,0;3,0;1,0;;8,0;8,0;23,0;2,0;2,0;2,0;4,0;16,0;16,0;4,0;2,0;8,0;11,0;25,0;6,0;5,0;7,0;268,0;19,0;22,0;27,0;7,0;7,0;6,0;34,0;4,0;1,0;;9,0;2,0;1,0;2,0;8,0;3,0;3,0;1,0;5,0;23,0;21,0;1,0;;23,0;5,0;113,0;4,0;4,0;;109,0;5,0;45,0;;;1,0;29,0;6,0;;3,0;5,0;39,0;;6,0;;;1,0;7,0;2,0;40,0;246,0;3,0;2,0;1,0;14,0;9,0;2,0;9,0;3,0;17,0;34,0;41,0;8,0;;;7,0;6,0;8,0;1,0;9,0;;5,0;16,0;4,0;;9,0;3,0;;21,0;47,0;4,0;25,0;5,0;3,0;3,0;17,0;13,0;301,0;11,0;26,0;2,0;;;;3,0;9,0;;6,0;10,0;6,0;81,0;26,0;18,0;1,0;5,0;7,0;5,0;2,0;102,0;6,0;4,0;7,0;215,0;3,0;24,0;3,0;75,0;6,0;;6,0;94,0;100,0;21,0;4,0;9,0;9,0;;4,0;7,0;12,0;;3,0;17,0;4,0;14,0;39,0;15,0;;7,0;16,0;;6,0;4,0;62,0;3,0;3,0;1,0;6,0;3,0;3,0;3,0;15,0;2,0;23,0;69,0;7,0;27,0;2,0;20,0;28,0;61,0;13,0;7,0;;;;6,0;21,0;50,0;27,0;4,0;;16,0;1,0;;14,0;8,0;38,0;5,0;;1,0;5,0;;2,0;2,0;1,0;11,0;1,0;1,0;12,0;;4,0;4,0;5,0;19,0;41,0;12,0;1,0;5,0;6,0;3,0;14,0;;3,0;10,0;;3,0;74,0;33,0;3,0;94,0;33,0;20,0;31,0;8,0;2,0;33,0;2,0;119,0;212,0;2,0;40,0;3,0;;2,0;8,0;4,0;134,0;;;1,0;35,0;6,0;62,0;3,0;7,0;;5,0;1,0;;;40,0;4,0;14,0;2,0;3,0;35,0;;478,0;1,0;;4,0;2,0;2,0;3,0;;;50,0;12,0;1,0;;;5,0;;;1,0;;6,0;4,0;9,0;;;51,0;2,0;;;5,0;;;2,0;1,0;2,0;1,0;1,0;2,0;7,0;10,0;;3,0;;5,0;4,0;;1,0;3,0;5,0;3,0;31,0;;2,0;1,0;;2,0;;;3,0;1,0;1,0;5,0;2,0;;4,0;;;9,0;2,0;;57,0;2,0;;;1,0;7,0;36,0;;16,0;2,0;2,0;;3,0;2,0;14,0;;10,0;;4,0;4,0;14,0;3,0;16,0;1,0;;;2,0;;6,0;;;1,0;34,0;6,0;;12,0;1,0;15,0;2,0;2,0;24,0;5,0;;1,0;;2,0;18,0;;;;6,0;7,0;1,0;11,0;;;;;;;7,0;7,0;;44,0;2,0;;;13,0;;20,0;3,0;;;;;7,0;1,0;;;;4,0;1,0;;;;;;;;;3,0;7,0;;1,0;;;1,0;;;
connection;;10,0;;8,0;;49,0;4,0;70,0;;;3,0;3,0;11,0;67,0;;;28,0;1,0;22,0;;35,0;;1,0;12,0;75,0;;;23,0;12,0;12,0;139,0;11,0;;3,0;;103,0;30,0;1,0;;3,0;41,0;302,0;2,0;14,0;19,0;37,0;;89,0;;;;7,0;37,0;72,0;2,0;;92,0;;;51,0;;;6,0;;142,0;7,0;145,0;1,0;1,0;9,0;3,0;88,0;10,0;2,0;;;5,0;;;18,0;79,0;;97,0;;150,0;9,0;9,0;28,0;4,0;13,0;20,0;;12,0;7,0;;;8,0;2,0;123,0;121,0;58,0;5,0;;17,0;21,0;40,0;1,0;4,0;;;;3,0;24,0;;11,0;;6,0;14,0;21,0;62,0;1,0;;57,0;2,0;;14,0;115,0;;10,0;;6,0;6,0;12,0;211,0;;6,0;21,0;9,0;;;;4,0;2,0;;4,0;9,0;31,0;22,0;15,0;24,0;4,0;24,0;38,0;16,0;2,0;4,0;3,0;;;;33,0;279,0;10,0;2,0;;;74,0;31,0;;;;;34,0;28,0;6,0;3,0;5,0;;7,0;;;11,0;2,0;18,0;3,0;2,0;1,0;3,0;22,0;19,0;;4,0;3,0;13,0;6,0;22,0;72,0;;26,0;20,0;4,0;21,0;1,0;;1,0;5,0;104,0;7,0;9,0;102,0;12,0;8,0;1,0;;;38,0;34,0;9,0;;76,0;;8,0;3,0;7,0;41,0;25,0;275,0;;;1,0;8,0;;4,0;;19,0;;;;8,0;;1,0;12,0;6,0;1,0;;34,0;7,0;15,0;69,0;43,0;14,0;;4,0;22,0;29,0;19,0;48,0;56,0;3,0;;10,0;46,0;6,0;39,0;5,0;2,0;;;6,0;6,0;1,0;89,0;20,0;10,0;11,0;;8,0;34,0;16,0;10,0;5,0;2,0;42,0;94,0;1,0;1,0;11,0;5,0;108,0;4,0;2,0;2,0;;9,0;;15,0;17,0;;28,0;14,0;11,0;;28,0;;24,0;17,0;4,0;19,0;5,0;30,0;;;14,0;6,0;;;11,0;36,0;6,0;39,0;9,0;9,0;7,0;3,0;2,0;;27,0;;85,0;23,0;2,0;2,0;10,0;2,0;6,0;;7,0;3,0;2,0;1,0;17,0;3,0;;14,0;4,0;12,0;6,0;18,0;;19,0;1,0;4,0;;1,0;3,0;7,0;;31,0;70,0;249,0;;;;1,0;;5,0;;;;10,0;;;;31,0;9,0;;1,0;;;;65,0;;;;2,0;23,0;12,0;;;2,0;;2,0;;;;4,0;1,0;;4,0;1,0;;9,0;12,0;2,0;;12,0;;9,0;2,0;10,0;4,0;11,0;;19,0;7,0;1,0;;;;;;;3,0;;;63,0;15,0;29,0;8,0;1,0;9,0;9,0;62,0;1,0;;;18,0;;50,0;1,0;1,0;127,0;8,0;;;1,0;;2,0;24,0;;;3,0;4,0;4,0;8,0;7,0;;1,0;8,0;34,0;5,0;1,0;;8,0;3,0;2,0;;2,0;3,0;;2,0;;4,0;32,0;3,0;11,0;3,0;37,0;1,0;2,0;4,0;;;9,0;5,0;2,0;17,0;21,0;11,0;;;3,0;;2,0;;1,0;;3,0;;2,0;;33,0;1,0;2,0;;;5,0;3,0;2,0;;8,0;;4,0;;2,0;24,0;;1,0;4,0;18,0;;108,0;2,0;;;;;5,0;3,0;;10,0;2,0;4,0;12,0;;6,0;1,0;;20,0;1,0;;;37,0;39,0;4,0;14,0;;5,0;18,0;;1,0;2,0;;2,0;37,0;12,0;;7,0;14,0;;7,0;1,0;5,0;3,0;1,0;;8,0;1,0;6,0;;;;5,0;8,0;13,0;3,0;;;1,0;3,0;;;14,0;56,0;22,0;70,0;13,0;23,0;1,0;;41,0;6,0;;;;;;;;;1,0;1,0;;7,0;2,0;1,0;;;;2,0;6,0;3,0;;19,0;4,0;7,0;1,0;;1,0;6,0;2,0;;;;24,0;;;;;1,0;;4,0;3,0;258,0;1,0;5,0;;8,0;7,0;1,0;7,0;;1,0;4,0;1,0;51,0;;;30,0;;1,0;;;;5,0;7,0;;;;;;22,0;7,0;2,0;;1,0;1,0;3,0;;27,0;26,0;9,0;5,0;2,0;;6,0;;;3,0;;;;13,0;20,0;8,0;1,0;;;6,0;2,0;1,0;18,0;;3,0;2,0;66,0;3,0;;3,0;;;;;7,0;8,0;;8,0;;;;;2,0;;;2,0;1,0;;1,0;10,0;;7,0;;;2,0;1,0;1,0;10,0;11,0;3,0;;1,0;2,0;2,0;1,0;8,0;;11,0;8,0;;;4,0;2,0;;20,0;3,0;1,0;;;;;;7,0;8,0;1,0;;;3,0;;2,0;2,0;2,0;2,0;;1,0;;;;;;1,0;;1,0;2,0;;;;;2,0;4,0;12,0;;2,0;3,0;;;;2,0;7,0;;;4,0;1,0;;13,0;;2,0;15,0;;4,0;;2,0;;13,0;;2,0;;;;;7,0;3,0;;;;;;1,0;;;;1,0;;;;4,0;;;1,0;;3,0;;9,0;1,0;;;2,0;;;2,0;;14,0;2,0;;;;;;;;;;;6,0;;;7,0;;;;;;;;;;;;;2,0;16,0;;3,0;;;;;;1,0;;;2,0;1,0;;2,0;;;;;;3,0;3,0;;3,0;;;;7,0;12,0;1,0;1,0;3,0;;;;;3,0;32,0;;3,0;;;1,0;;;15,0;;30,0;;;3,0;8,0;;;;;;;3,0;;2,0;11,0;;3,0;4,0;1,0;2,0;1,0;;;;1,0;4,0;;3,0;;;10,0;;1,0;;;2,0;;;30,0;;4,0;;;;4,0;;;7,0;;3,0;8,0;;;8,0;7,0;3,0;;;;;;;;;;;;2,0;;;;;;;;4,0;;;;;;;;
connector;;9,0;;30,0;;56,0;4,0;120,0;;;1,0;1,0;14,0;72,0;1,0;;4,0;2,0;14,0;3,0;4,0;;1,0;10,0;34,0;6,0;;13,0;;4,0;192,0;10,0;;1,0;;47,0;6,0;11,0;;2,0;29,0;113,0;9,0;7,0;3,0;123,0;;208,0;;;;;70,0;27,0;7,0;;66,0;4,0;;;;1,0;1,0;;32,0;3,0;142,0;;;5,0;10,0;100,0;14,0;1,0;;;9,0;1,0;;20,0;60,0;;;;149,0;1,0;;2,0;4,0;;1,0;14,0;13,0;5,0;;;;7,0;85,0;60,0;76,0;5,0;;9,0;7,0;22,0;2,0;;;;;;12,0;2,0;13,0;;2,0;2,0;;33,0;;;36,0;17,0;;;145,0;;1,0;2,0;4,0;;;53,0;;5,0;1,0;1,0;;;;7,0;;;19,0;;4,0;12,0;6,0;94,0;16,0;12,0;53,0;13,0;;8,0;;4,0;;;84,0;362,0;;7,0;4,0;;138,0;28,0;3,0;1,0;;;4,0;17,0;;28,0;5,0;5,0;5,0;;1,0;4,0;12,0;18,0;3,0;;7,0;6,0;11,0;184,0;;6,0;9,0;8,0;18,0;11,0;447,0;1,0;47,0;16,0;;10,0;2,0;5,0;2,0;;86,0;8,0;1,0;84,0;6,0;5,0;2,0;;5,0;39,0;53,0;3,0;1,0;2,0;2,0;;;7,0;28,0;11,0;434,0;;4,0;;16,0;;5,0;;246,0;;;;20,0;;3,0;2,0;9,0;1,0;19,0;2,0;11,0;26,0;46,0;2,0;3,0;;3,0;34,0;23,0;18,0;52,0;132,0;2,0;;12,0;8,0;3,0;62,0;6,0;4,0;;;7,0;1,0;3,0;41,0;10,0;24,0;11,0;3,0;23,0;16,0;3,0;2,0;12,0;;34,0;158,0;;;5,0;8,0;151,0;;9,0;4,0;1,0;5,0;3,0;14,0;8,0;;13,0;68,0;2,0;;55,0;;;11,0;1,0;16,0;15,0;24,0;;2,0;9,0;;5,0;6,0;27,0;14,0;3,0;10,0;18,0;4,0;24,0;4,0;1,0;;;;153,0;13,0;1,0;18,0;;9,0;;1,0;;;4,0;;15,0;25,0;;2,0;4,0;6,0;2,0;5,0;;6,0;2,0;58,0;1,0;;2,0;3,0;;9,0;87,0;5,0;1,0;;;2,0;;22,0;;;1,0;;;;;7,0;3,0;2,0;1,0;5,0;;;21,0;4,0;;14,0;;1,0;;3,0;;;;;;;;4,0;1,0;1,0;;;;13,0;4,0;3,0;;;;19,0;9,0;2,0;;1,0;;5,0;1,0;8,0;1,0;;;;;5,0;;;;106,0;5,0;2,0;;4,0;;;;3,0;1,0;;11,0;;;10,0;;89,0;;6,0;;;4,0;1,0;11,0;;;28,0;4,0;2,0;6,0;27,0;;;3,0;4,0;4,0;2,0;;;;;;;;;;;1,0;76,0;17,0;3,0;2,0;4,0;8,0;;14,0;;7,0;5,0;5,0;4,0;5,0;1,0;1,0;;;;;2,0;11,0;1,0;4,0;7,0;;1,0;;;16,0;;;4,0;4,0;;3,0;;31,0;3,0;2,0;8,0;4,0;180,0;3,0;1,0;1,0;17,0;108,0;;;;;;1,0;;;;;;2,0;8,0;;7,0;2,0;;14,0;9,0;;;;13,0;;7,0;;1,0;7,0;;;22,0;;;;;;;25,0;;3,0;;;4,0;;;;;2,0;;;;3,0;2,0;64,0;1,0;1,0;;4,0;24,0;;;1,0;146,0;4,0;5,0;4,0;;4,0;1,0;;;;1,0;;;;2,0;;;;;;4,0;17,0;;;14,0;;;;3,0;;35,0;;22,0;;1,0;;6,0;;;;;;;;;;;17,0;;42,0;1,0;;;;14,0;3,0;;4,0;;;18,0;2,0;;;;;2,0;;;;;;9,0;;;;;7,0;2,0;;19,0;3,0;;;;2,0;;11,0;;;;;;;;;;;2,0;;3,0;7,0;2,0;;;12,0;;;8,0;;;;36,0;;19,0;3,0;8,0;;;;3,0;;1,0;14,0;4,0;;;;4,0;1,0;2,0;;5,0;;7,0;;;;4,0;29,0;;;;15,0;2,0;;;1,0;;;;23,0;;7,0;13,0;3,0;10,0;;1,0;;43,0;;;3,0;;;;;1,0;7,0;1,0;;3,0;;4,0;4,0;1,0;3,0;1,0;;3,0;16,0;;;;;2,0;;2,0;;;6,0;;;3,0;25,0;23,0;;;;;;;;4,0;1,0;;;;;12,0;;;4,0;;;;1,0;;1,0;;2,0;;;;;;;;;;;;1,0;;;;;;;;;;;;;47,0;;;;;;;;1,0;;;;15,0;;;;;;;;;;;;;;;;;;12,0;;;;2,0;;;;;;3,0;;;;;;;;;;;2,0;;;2,0;;;;;;1,0;;;3,0;;;;;;3,0;;;6,0;;;;2,0;;;5,0;;;;;;1,0;;;;;1,0;7,0;;2,0;;;;;;2,0;;;;8,0;4,0;;;;;;;;;;;;18,0;;;2,0;;;3,0;6,0;5,0;;;;2,0;;;21,0;;;;;;4,0;;;19,0;;;;1,0;;;;;;;;;;;;;;;;1,0;;2,0;;;;;;;;
consist;;5,0;;;4,0;3,0;19,0;10,0;;16,0;;13,0;;9,0;25,0;;13,0;2,0;7,0;6,0;;;19,0;;5,0;;;16,0;;14,0;3,0;;;4,0;1,0;21,0;;1,0;6,0;1,0;1,0;52,0;;8,0;4,0;1,0;;28,0;;;;;3,0;2,0;1,0;1,0;16,0;;6,0;2,0;3,0;10,0;582,0;;82,0;1,0;34,0;;;;5,0;70,0;27,0;1,0;;;24,0;;;2,0;28,0;;9,0;15,0;17,0;;;7,0;1,0;8,0;38,0;;;;1,0;;8,0;2,0;16,0;2,0;6,0;5,0;5,0;12,0;2,0;4,0;2,0;;5,0;1,0;;1,0;6,0;;;;4,0;;;45,0;1,0;4,0;11,0;8,0;3,0;;26,0;;;3,0;39,0;8,0;;6,0;1,0;;8,0;5,0;3,0;;;5,0;;3,0;4,0;;6,0;1,0;6,0;1,0;;3,0;5,0;1,0;1,0;;;;;13,0;1,0;1,0;;;;;;;;7,0;2,0;;1,0;1,0;;4,0;1,0;2,0;;;;2,0;;3,0;1,0;;43,0;1,0;6,0;1,0;;;8,0;;1,0;;9,0;;;2,0;;3,0;;;2,0;8,0;11,0;3,0;5,0;5,0;;1,0;4,0;1,0;;;5,0;;1,0;3,0;6,0;3,0;;;4,0;1,0;8,0;1,0;7,0;4,0;4,0;4,0;16,0;4,0;;;1,0;1,0;;9,0;6,0;3,0;;1,0;3,0;505,0;2,0;6,0;21,0;4,0;;;;5,0;3,0;2,0;1,0;4,0;;;;;11,0;18,0;1,0;1,0;;7,0;5,0;1,0;;4,0;1,0;;;;;2,0;;1,0;3,0;1,0;16,0;;;;1,0;;2,0;1,0;;3,0;;1,0;;;1,0;2,0;;;1,0;3,0;;;;;4,0;5,0;2,0;7,0;;;;;2,0;;1,0;2,0;1,0;1,0;2,0;21,0;;;;;;;16,0;;;;;2,0;7,0;2,0;;;;;;;;2,0;;1,0;7,0;;;7,0;;;;;;;;1,0;19,0;5,0;;;5,0;5,0;2,0;1,0;1,0;;1,0;2,0;;;;;3,0;;1,0;;;;21,0;1,0;;4,0;;2,0;;;;10,0;;;;1,0;1,0;13,0;2,0;2,0;1,0;;1,0;7,0;2,0;6,0;;23,0;1,0;1,0;6,0;;;;;;4,0;2,0;1,0;2,0;;;;;;;1,0;2,0;;;;;1,0;;4,0;;4,0;;;;;1,0;4,0;22,0;1,0;;;1,0;1,0;1,0;12,0;;1,0;2,0;;;4,0;1,0;1,0;2,0;1,0;10,0;;;;5,0;;1,0;;;3,0;;2,0;1,0;5,0;6,0;;4,0;6,0;;1,0;1,0;;2,0;10,0;3,0;;;3,0;6,0;6,0;2,0;;;;1,0;;3,0;3,0;;;;;6,0;;;1,0;4,0;;;;;;;15,0;1,0;1,0;;5,0;;3,0;;1,0;2,0;;;;;3,0;;1,0;;;;;1,0;1,0;;;1,0;;2,0;3,0;;;3,0;;;;1,0;;;;1,0;4,0;;3,0;2,0;;;;;1,0;2,0;;3,0;;;6,0;;;;;;;6,0;4,0;;1,0;;1,0;3,0;;;;8,0;;2,0;;;3,0;;;1,0;;7,0;1,0;;;;;;;;1,0;5,0;;7,0;1,0;1,0;17,0;3,0;;;;1,0;1,0;;2,0;2,0;1,0;23,0;3,0;;1,0;2,0;;;;;;1,0;;;;11,0;;;1,0;;;;1,0;;;3,0;;3,0;;;1,0;1,0;;;;;;;5,0;;;6,0;2,0;;;;5,0;3,0;3,0;;;8,0;7,0;;;;3,0;1,0;;3,0;1,0;;;;;;;7,0;;1,0;;;;;;;;4,0;1,0;1,0;2,0;;;;1,0;4,0;4,0;4,0;;;;4,0;;;4,0;19,0;;5,0;;;;1,0;;;1,0;2,0;1,0;;;2,0;;1,0;;;;2,0;1,0;;;2,0;;;4,0;;6,0;;;1,0;;;;;;;1,0;;;2,0;;;;;1,0;;;;6,0;;;;;;;;;;;;1,0;;;1,0;1,0;;;;1,0;5,0;;;;;;;;;;;;;;;;;;23,0;;;;6,0;3,0;;;1,0;;;;;1,0;;;;;1,0;1,0;;;3,0;;4,0;;1,0;;;1,0;2,0;3,0;1,0;8,0;;;1,0;;;1,0;;;;;;3,0;1,0;;;;;;;;;;;;3,0;1,0;;;;;1,0;;5,0;;;;;1,0;;;;1,0;;;;;;;;;;;;;;;;;;;;8,0;;;;;4,0;;;3,0;2,0;;;1,0;2,0;4,0;;;;;;5,0;;2,0;;5,0;;;;;4,0;;;;;;;;;;;2,0;;1,0;;1,0;;;;;2,0;;;;;1,0;1,0;;;;;;;;;;;;;7,0;;;;;;;;;1,0;;;4,0;2,0;;;;;;;;;;;;;;;;;;;;
construct;;2,0;;1,0;;9,0;14,0;14,0;;;;2,0;2,0;21,0;;;9,0;;3,0;6,0;1,0;;17,0;;;;;9,0;3,0;;13,0;;2,0;;;1,0;3,0;;6,0;1,0;6,0;26,0;6,0;17,0;6,0;;2,0;6,0;;;1,0;;3,0;;5,0;8,0;8,0;;;2,0;;;8,0;;62,0;;10,0;;7,0;;4,0;24,0;26,0;3,0;;8,0;21,0;13,0;;2,0;24,0;;;16,0;5,0;;;7,0;1,0;;;;;;;;32,0;5,0;8,0;30,0;5,0;;;4,0;3,0;31,0;1,0;5,0;;;;6,0;9,0;;1,0;;1,0;2,0;12,0;17,0;1,0;;15,0;;;5,0;25,0;;;;12,0;;;10,0;1,0;;2,0;15,0;;;;2,0;;;2,0;;2,0;48,0;8,0;2,0;;;1,0;;1,0;;;;;;2,0;2,0;;2,0;;;;2,0;;;2,0;;;;2,0;;;6,0;1,0;;4,0;;;;;;4,0;;8,0;;;;;;2,0;;3,0;;4,0;;;;;;;1,0;;1,0;;16,0;;;;;;6,0;1,0;;;1,0;;;;;4,0;;10,0;;;1,0;;1,0;;;3,0;;;;7,0;;;1,0;1,0;;;8,0;;2,0;2,0;;;;3,0;1,0;;;1,0;13,0;;;;;;;;;;3,0;;1,0;;;;;2,0;;3,0;1,0;;1,0;1,0;;12,0;;;;2,0;;2,0;1,0;;4,0;;1,0;;;7,0;2,0;;4,0;;;;1,0;6,0;;;1,0;1,0;5,0;;;;1,0;;;3,0;;;1,0;2,0;8,0;;;1,0;2,0;;;;;;;;;;3,0;;;;;1,0;;1,0;;;;4,0;13,0;;1,0;1,0;;;;;;;1,0;8,0;;1,0;;;;;3,0;4,0;;;;;;12,0;;2,0;;;;;;7,0;2,0;2,0;;;1,0;;;1,0;;;2,0;3,0;;;6,0;;5,0;;;;;2,0;5,0;;2,0;;1,0;3,0;;;1,0;;;1,0;;;1,0;;;;;;2,0;;11,0;;2,0;4,0;;3,0;;2,0;;;;;;;;;;;1,0;;1,0;;;;;;;;;;;2,0;6,0;1,0;1,0;6,0;;;;1,0;;;;;;;1,0;4,0;;;;;1,0;2,0;;1,0;1,0;;8,0;2,0;4,0;3,0;8,0;;5,0;;;;7,0;;;2,0;;;;;7,0;;;4,0;1,0;;;1,0;;;;3,0;;;;;;;;2,0;;;;1,0;;5,0;;;;;6,0;;;;;;;1,0;6,0;;;;;4,0;;;;;;;1,0;;;;1,0;;2,0;;;;;1,0;;;;;;;;;3,0;;;1,0;;;9,0;;;;2,0;7,0;;1,0;;;;19,0;3,0;;;;;1,0;;;;5,0;2,0;;;;13,0;;5,0;;;;;;1,0;3,0;;1,0;1,0;;;;2,0;;;3,0;;;;;;;;;;;;;;;;;;;;3,0;;;;;;;;;1,0;;;;;11,0;;8,0;2,0;;;;;;;;;1,0;;10,0;;;;;;;7,0;;;;1,0;;;;;;;1,0;;;2,0;;;;;;;;;;;1,0;;;1,0;;;;;;;;;;5,0;;;;;;;;;;;;3,0;;;;;;;1,0;;;;;;;;;1,0;;;3,0;;;;;;;4,0;;;;;1,0;;;;;;;;;;;;;;4,0;;1,0;;;;;1,0;;;;;3,0;;;;;;;;;;;;;;;;;;;3,0;;3,0;;;;3,0;1,0;;;;;;3,0;;;2,0;;;;;1,0;;;;;;1,0;10,0;;;;;;;;;;;;;;;;;;;3,0;;;;;2,0;3,0;;;;1,0;;;;;2,0;;;;;;;;8,0;;1,0;;;;2,0;1,0;;;;;1,0;;;;;;;3,0;;;;2,0;;;;;;;;1,0;;;;;;;;;2,0;;1,0;;;;;;;;;;2,0;;;;;1,0;;;;;;;;;;;;;;;;;;;;;;;;;;;;;;;;;;;;2,0;;;;;;;;;;;;;;;;;;;;;;;;;;;;;;;;;
contact;;303,0;;16,0;9,0;42,0;10,0;70,0;;;4,0;1,0;112,0;75,0;1,0;;26,0;5,0;10,0;1,0;10,0;1,0;1,0;15,0;113,0;;1,0;64,0;5,0;7,0;269,0;7,0;;1,0;4,0;87,0;10,0;7,0;1,0;4,0;19,0;228,0;9,0;10,0;30,0;141,0;;108,0;;1,0;;1,0;59,0;11,0;1,0;1,0;127,0;1,0;1,0;20,0;27,0;;226,0;;157,0;5,0;433,0;11,0;;8,0;9,0;411,0;56,0;4,0;3,0;;60,0;9,0;;1,0;69,0;1,0;1,0;;144,0;70,0;;76,0;6,0;10,0;;14,0;30,0;7,0;2,0;;17,0;26,0;425,0;494,0;287,0;30,0;;2,0;5,0;12,0;;;;;;31,0;190,0;17,0;;;;55,0;;151,0;;5,0;149,0;2,0;;6,0;89,0;;15,0;;13,0;;9,0;202,0;1,0;;6,0;;5,0;;;89,0;;;12,0;19,0;200,0;246,0;25,0;30,0;12,0;19,0;328,0;42,0;2,0;5,0;25,0;13,0;;4,0;111,0;215,0;;5,0;6,0;;164,0;65,0;1,0;15,0;12,0;;49,0;123,0;;94,0;68,0;2,0;6,0;;1,0;1,0;20,0;91,0;5,0;89,0;33,0;29,0;43,0;93,0;;3,0;38,0;173,0;79,0;57,0;194,0;4,0;84,0;8,0;61,0;96,0;;11,0;2,0;3,0;352,0;21,0;31,0;200,0;34,0;71,0;;10,0;2,0;59,0;50,0;19,0;6,0;7,0;15,0;8,0;3,0;16,0;68,0;134,0;642,0;19,0;18,0;7,0;23,0;2,0;6,0;3,0;33,0;;;2,0;;;1,0;75,0;12,0;;10,0;18,0;13,0;24,0;281,0;27,0;9,0;5,0;1,0;69,0;90,0;52,0;99,0;1067,0;13,0;;10,0;20,0;26,0;14,0;39,0;15,0;16,0;1,0;;15,0;23,0;47,0;25,0;9,0;;5,0;19,0;38,0;5,0;15,0;37,0;;44,0;147,0;;8,0;27,0;12,0;186,0;13,0;15,0;9,0;4,0;13,0;3,0;12,0;27,0;;26,0;24,0;6,0;13,0;58,0;6,0;;7,0;;32,0;2,0;33,0;2,0;10,0;12,0;2,0;4,0;9,0;39,0;13,0;26,0;13,0;7,0;28,0;27,0;3,0;11,0;1,0;3,0;5,0;163,0;48,0;68,0;5,0;13,0;21,0;10,0;3,0;16,0;9,0;8,0;1,0;28,0;54,0;5,0;6,0;27,0;4,0;1,0;23,0;;50,0;;2,0;;;2,0;7,0;7,0;58,0;5,0;;;;;;6,0;4,0;;5,0;2,0;1,0;5,0;;;16,0;6,0;;1,0;;;;25,0;15,0;;;1,0;55,0;9,0;;;;2,0;3,0;;13,0;13,0;1,0;;10,0;16,0;;2,0;34,0;2,0;14,0;5,0;18,0;;7,0;5,0;8,0;10,0;12,0;;;65,0;12,0;3,0;18,0;;;2,0;12,0;;;1,0;56,0;;15,0;;;11,0;1,0;4,0;;;;4,0;8,0;19,0;9,0;;73,0;4,0;9,0;3,0;3,0;;;47,0;2,0;;17,0;3,0;5,0;13,0;9,0;;;1,0;;2,0;4,0;;2,0;;;;;2,0;;2,0;;1,0;6,0;20,0;1,0;;2,0;2,0;;8,0;;2,0;19,0;4,0;;9,0;23,0;8,0;;;;2,0;7,0;;2,0;4,0;4,0;;;;;6,0;13,0;1,0;3,0;1,0;;;4,0;;;;;4,0;5,0;5,0;67,0;6,0;18,0;66,0;36,0;;2,0;;;1,0;3,0;13,0;;6,0;22,0;2,0;44,0;2,0;1,0;4,0;4,0;21,0;3,0;;1,0;18,0;38,0;;3,0;;;3,0;;1,0;11,0;;;;5,0;;6,0;2,0;;1,0;26,0;14,0;103,0;;;;;;;;4,0;1,0;71,0;10,0;8,0;2,0;;3,0;14,0;1,0;3,0;;9,0;1,0;7,0;44,0;;1,0;;;;;1,0;6,0;;;2,0;;;;;;16,0;5,0;;1,0;2,0;;5,0;;;;101,0;2,0;3,0;2,0;4,0;;17,0;;;;1,0;;;1,0;;1,0;;8,0;;;;;;;2,0;1,0;6,0;;;3,0;2,0;9,0;1,0;;8,0;;;;;;;5,0;1,0;;2,0;;;;11,0;;6,0;2,0;5,0;10,0;;;;73,0;;6,0;;;1,0;;;12,0;;;;;6,0;;4,0;;10,0;17,0;;6,0;28,0;62,0;3,0;5,0;;6,0;28,0;;3,0;;9,0;;21,0;29,0;5,0;15,0;5,0;;;1,0;;19,0;;47,0;6,0;4,0;4,0;49,0;2,0;5,0;;9,0;;3,0;1,0;4,0;30,0;;;;1,0;4,0;3,0;23,0;;7,0;11,0;9,0;6,0;3,0;2,0;4,0;5,0;;1,0;6,0;1,0;2,0;2,0;6,0;5,0;19,0;1,0;;9,0;11,0;2,0;;1,0;16,0;3,0;1,0;5,0;1,0;1,0;1,0;3,0;13,0;2,0;;38,0;13,0;4,0;;2,0;8,0;;53,0;5,0;;;8,0;2,0;25,0;;6,0;5,0;;2,0;;;;;;4,0;12,0;;1,0;9,0;;3,0;41,0;1,0;17,0;;4,0;;;;;;;;4,0;;45,0;;;;5,0;;;;2,0;2,0;2,0;4,0;;13,0;;23,0;;;;;3,0;5,0;;;6,0;3,0;;;;;;;2,0;;4,0;;;;;48,0;1,0;;;;;1,0;;3,0;;;;2,0;6,0;;;;2,0;;;;;;;;18,0;;;;;;;3,0;;1,0;;6,0;1,0;;;;6,0;2,0;;;;6,0;;3,0;2,0;;69,0;;1,0;;;;;4,0;13,0;;17,0;;;5,0;;5,0;7,0;;;;;;;2,0;;4,0;;15,0;1,0;;2,0;6,0;;;3,0;;;8,0;;4,0;;4,0;8,0;1,0;;5,0;1,0;25,0;;;17,0;;;;22,0;;;1,0;8,0;;1,0;;;;;9,0;3,0;;;;1,0;;;;;;;;;;;;;;2,0;;;;;2,0;;;;
continuously;;2,0;2,0;5,0;7,0;6,0;2,0;1,0;;;;;;7,0;;3,0;23,0;;1,0;;;;;;;;;1,0;;;26,0;3,0;1,0;;;66,0;5,0;1,0;;;11,0;25,0;;1,0;31,0;4,0;;8,0;;;;;18,0;3,0;5,0;14,0;9,0;;1,0;17,0;;;;;129,0;;7,0;3,0;8,0;3,0;13,0;18,0;2,0;1,0;5,0;;2,0;5,0;1,0;7,0;38,0;;3,0;2,0;3,0;;;;1,0;;6,0;;;1,0;4,0;1,0;5,0;2,0;9,0;1,0;17,0;21,0;;6,0;5,0;4,0;;1,0;;;;;10,0;;;;;;7,0;16,0;3,0;;18,0;;;9,0;7,0;;;;51,0;;;11,0;3,0;;8,0;;4,0;;;;;;;1,0;9,0;2,0;3,0;1,0;1,0;;2,0;3,0;;;;;;;2,0;3,0;15,0;;;;;2,0;;6,0;;;;6,0;;5,0;;1,0;;;;;2,0;6,0;;3,0;2,0;;17,0;6,0;;;6,0;;1,0;;1,0;;;;2,0;2,0;;;7,0;1,0;4,0;;;1,0;11,0;2,0;;;;1,0;10,0;;;;2,0;;;1,0;;;19,0;;;3,0;2,0;;;;2,0;;2,0;;;;;3,0;4,0;;;4,0;;5,0;5,0;;;;;2,0;2,0;5,0;3,0;12,0;;;;7,0;;5,0;;;;;;4,0;;;;2,0;;;;5,0;;4,0;;1,0;4,0;;;;1,0;1,0;3,0;;2,0;2,0;;;;;2,0;3,0;;1,0;;;;;;;;;;9,0;1,0;;;;2,0;;;;1,0;1,0;;1,0;;2,0;;;5,0;;2,0;;1,0;;2,0;;2,0;;;;;;7,0;1,0;3,0;;;;;;;1,0;;1,0;3,0;;9,0;;1,0;2,0;44,0;;;;;;;1,0;;;;;;;4,0;;9,0;4,0;;1,0;1,0;;15,0;;;;;2,0;;;;1,0;2,0;15,0;;14,0;;1,0;;1,0;8,0;;;10,0;;21,0;;2,0;;7,0;9,0;3,0;;2,0;;9,0;18,0;1,0;;;;;1,0;8,0;3,0;2,0;;14,0;;9,0;3,0;;1,0;;7,0;;3,0;;;11,0;1,0;;13,0;;3,0;;;1,0;;;15,0;;;;;4,0;;;;;;;7,0;1,0;;;;;;;2,0;;3,0;;2,0;3,0;2,0;;;;;;;;;;4,0;;16,0;;;;;;1,0;;;;4,0;;;;;11,0;;1,0;;;;;;;2,0;;8,0;;;;2,0;;;;3,0;;;2,0;1,0;;;1,0;;;1,0;;;;;;8,0;;2,0;1,0;;;;3,0;;5,0;;3,0;1,0;2,0;;;;1,0;7,0;;;1,0;;;;1,0;;5,0;38,0;;;;;;;;;2,0;;;;;;1,0;;;1,0;;;5,0;;1,0;;1,0;;;;;;;1,0;;2,0;;3,0;;;1,0;;;;;;;;;1,0;;;;;;;;3,0;;;18,0;;;;;;1,0;2,0;;;5,0;;;;;;;;2,0;;;;;;2,0;;4,0;;;;;;;16,0;;3,0;;;1,0;;;6,0;;;;;;2,0;;1,0;;;;;3,0;4,0;;;;;1,0;;;;;;;;;;;1,0;6,0;;1,0;;;;;1,0;2,0;6,0;;;;;5,0;;;;;;;;;;;;;;3,0;;;;;;;;1,0;;;2,0;;;;;;7,0;;;;;7,0;;1,0;2,0;;;;;;;2,0;;3,0;;;3,0;;;;;;;;;;1,0;;;;;;;;;;;;;1,0;3,0;;;1,0;;;;;;;;;;;;;1,0;;;6,0;;;;;;;;;2,0;;;;;;5,0;;1,0;;5,0;1,0;;;;3,0;;;1,0;1,0;;;;;;;;;;;;;;6,0;;;;;;;;;;;1,0;;;;;;;;;1,0;;;;;3,0;;;;;;2,0;;;;;;;;;;;;;1,0;;;;;1,0;3,0;;;;;;;7,0;3,0;;;;;;;;;;3,0;;6,0;;;;;;;;;;;;;;;;;;2,0;;;;;;;;;;;;;;;;;;;;;;;;;;;;;;;;;;1,0;;;;;;;;;;;;;;;;;1,0;;;;;;;;;;2,0;;;;;
control;;47,0;10,0;222,0;146,0;890,0;91,0;135,0;13,0;4,0;7,0;12,0;8,0;798,0;;40,0;570,0;1,0;47,0;32,0;17,0;2,0;55,0;128,0;329,0;19,0;30,0;242,0;159,0;77,0;1994,0;835,0;46,0;53,0;10,0;690,0;34,0;19,0;59,0;5,0;520,0;2609,0;6,0;195,0;1376,0;63,0;3,0;217,0;;81,0;25,0;3,0;11,0;76,0;71,0;77,0;78,0;1,0;65,0;562,0;2,0;1,0;85,0;9,0;1478,0;24,0;768,0;26,0;29,0;18,0;41,0;992,0;510,0;25,0;61,0;26,0;3,0;40,0;49,0;128,0;1532,0;1,0;423,0;17,0;919,0;62,0;12,0;209,0;12,0;42,0;460,0;10,0;24,0;33,0;177,0;2,0;344,0;70,0;606,0;164,0;847,0;145,0;1,0;129,0;347,0;618,0;8,0;127,0;29,0;;1,0;89,0;87,0;22,0;3,0;;34,0;87,0;57,0;465,0;31,0;6,0;2567,0;44,0;21,0;154,0;1768,0;;24,0;;408,0;16,0;8,0;2913,0;22,0;16,0;186,0;137,0;376,0;;;2,0;19,0;3,0;185,0;104,0;187,0;85,0;111,0;55,0;58,0;64,0;245,0;7,0;15,0;84,0;3,0;;2,0;;9,0;336,0;25,0;54,0;41,0;3,0;241,0;16,0;20,0;100,0;68,0;10,0;70,0;257,0;24,0;26,0;68,0;57,0;108,0;7,0;8,0;3,0;20,0;51,0;1,0;14,0;76,0;24,0;148,0;41,0;2,0;9,0;8,0;23,0;11,0;11,0;94,0;17,0;27,0;8,0;3,0;26,0;27,0;41,0;40,0;93,0;256,0;15,0;88,0;110,0;257,0;267,0;32,0;;;8,0;601,0;15,0;15,0;31,0;56,0;176,0;11,0;4,0;33,0;3,0;313,0;5,0;21,0;33,0;6,0;8,0;130,0;27,0;22,0;17,0;8,0;19,0;;42,0;;46,0;33,0;;4,0;242,0;29,0;26,0;51,0;16,0;5,0;;5,0;31,0;43,0;271,0;36,0;100,0;4,0;;122,0;378,0;26,0;574,0;4,0;13,0;3,0;11,0;19,0;22,0;3,0;50,0;284,0;83,0;9,0;6,0;63,0;146,0;;77,0;9,0;62,0;78,0;188,0;3,0;;9,0;63,0;657,0;5,0;95,0;28,0;7,0;1,0;11,0;16,0;226,0;224,0;3,0;7,0;7,0;;2,0;32,0;18,0;1,0;32,0;69,0;18,0;591,0;;3,0;12,0;9,0;24,0;11,0;37,0;27,0;50,0;109,0;185,0;416,0;4,0;36,0;58,0;1,0;22,0;8,0;347,0;20,0;3,0;2,0;;2,0;173,0;1,0;13,0;;10,0;7,0;159,0;154,0;11,0;3,0;12,0;5,0;19,0;35,0;4,0;13,0;11,0;;33,0;5,0;72,0;55,0;87,0;4,0;522,0;149,0;11,0;62,0;4,0;34,0;82,0;112,0;20,0;39,0;9,0;91,0;;31,0;125,0;37,0;181,0;42,0;10,0;581,0;52,0;18,0;;134,0;16,0;17,0;22,0;198,0;55,0;30,0;31,0;46,0;7,0;227,0;17,0;501,0;25,0;264,0;1,0;97,0;167,0;20,0;10,0;495,0;31,0;140,0;13,0;108,0;27,0;188,0;206,0;344,0;38,0;270,0;2,0;197,0;804,0;99,0;1,0;14,0;11,0;4,0;6,0;89,0;43,0;74,0;32,0;772,0;691,0;284,0;59,0;11,0;63,0;15,0;207,0;24,0;179,0;63,0;114,0;55,0;312,0;39,0;48,0;305,0;102,0;105,0;8,0;41,0;18,0;25,0;451,0;6,0;9,0;267,0;126,0;7,0;5,0;13,0;18,0;65,0;5,0;19,0;73,0;21,0;18,0;15,0;3,0;30,0;4,0;12,0;58,0;15,0;31,0;25,0;374,0;262,0;3,0;4,0;63,0;57,0;108,0;44,0;57,0;12,0;26,0;44,0;72,0;23,0;533,0;43,0;30,0;20,0;12,0;1,0;5,0;15,0;20,0;18,0;178,0;25,0;25,0;44,0;14,0;84,0;8,0;111,0;7,0;40,0;42,0;36,0;20,0;26,0;57,0;5,0;77,0;2,0;5,0;437,0;7,0;73,0;10,0;2,0;65,0;21,0;7,0;3,0;5,0;;15,0;21,0;65,0;;26,0;74,0;13,0;19,0;108,0;40,0;22,0;17,0;24,0;9,0;6,0;22,0;19,0;72,0;;44,0;4,0;8,0;24,0;37,0;4,0;3,0;51,0;6,0;104,0;85,0;5,0;26,0;;;10,0;91,0;27,0;5,0;45,0;1,0;19,0;61,0;67,0;23,0;8,0;13,0;46,0;1,0;5,0;3,0;28,0;35,0;;15,0;23,0;12,0;38,0;51,0;55,0;2,0;11,0;20,0;61,0;13,0;32,0;10,0;33,0;3,0;18,0;68,0;24,0;43,0;30,0;33,0;77,0;28,0;;73,0;6,0;12,0;3,0;58,0;133,0;72,0;39,0;26,0;;18,0;30,0;1,0;33,0;17,0;16,0;29,0;32,0;37,0;23,0;54,0;12,0;1,0;;4,0;10,0;28,0;67,0;32,0;2,0;128,0;24,0;5,0;16,0;10,0;4,0;38,0;31,0;8,0;7,0;26,0;117,0;13,0;30,0;4,0;41,0;8,0;31,0;6,0;36,0;;10,0;13,0;9,0;9,0;5,0;9,0;8,0;148,0;41,0;18,0;124,0;;6,0;69,0;2,0;15,0;221,0;21,0;5,0;27,0;1,0;26,0;46,0;36,0;131,0;;26,0;6,0;43,0;109,0;24,0;77,0;11,0;5,0;14,0;44,0;6,0;12,0;54,0;14,0;10,0;25,0;15,0;3,0;1,0;2,0;38,0;6,0;9,0;347,0;311,0;10,0;;3,0;4,0;13,0;11,0;;3,0;19,0;8,0;101,0;15,0;11,0;131,0;29,0;72,0;5,0;1,0;54,0;7,0;13,0;3,0;6,0;34,0;18,0;10,0;8,0;3,0;11,0;61,0;12,0;;11,0;20,0;;32,0;4,0;3,0;1,0;1,0;40,0;28,0;8,0;15,0;20,0;2,0;1,0;1,0;5,0;;3,0;2,0;230,0;2,0;15,0;17,0;3,0;;2,0;;17,0;1,0;;4,0;;119,0;7,0;13,0;7,0;;13,0;;;38,0;;3,0;148,0;1,0;33,0;22,0;8,0;80,0;8,0;9,0;55,0;30,0;6,0;34,0;44,0;24,0;1,0;47,0;24,0;16,0;;41,0;2,0;20,0;537,0;1,0;2,0;;15,0;18,0;5,0;8,0;2,0;;;41,0;14,0;45,0;39,0;8,0;;1,0;7,0;6,0;33,0;17,0;4,0;1,0;21,0;19,0;;;103,0;31,0;;17,0;9,0;8,0;16,0;;;20,0;;41,0;;8,0;29,0;3,0;8,0;8,0;1,0;5,0;9,0;65,0;8,0;29,0;5,0;34,0;6,0;14,0;21,0;4,0;33,0;12,0;42,0;1,0;3,0;6,0;6,0;17,0;26,0;7,0;22,0;4,0;59,0;13,0;5,0;32,0;13,0;2,0;7,0;14,0;13,0;19,0;27,0;;6,0;15,0;1,0;6,0;1,0;1,0;4,0;4,0;6,0;11,0;12,0;46,0;70,0;41,0;18,0;20,0;141,0;26,0;11,0;2,0;8,0;3,0;8,0;3,0;20,0;1,0;4,0;6,0;13,0;3,0;3,0;9,0;1,0;9,0;4,0;7,0;166,0;28,0;1,0;3,0;12,0;5,0;10,0;101,0;;;1,0;21,0;;5,0;4,0;;1,0;;13,0;13,0;26,0;13,0;2,0;;9,0;3,0;2,0;1,0;12,0;5,0;2,0;6,0;3,0;9,0;4,0;;6,0;2,0;11,0;;50,0;13,0;1,0;11,0;1,0;19,0;4,0;8,0;4,0;3,0;12,0;;3,0;4,0;4,0;4,0;4,0;;1,0;11,0;;;11,0;12,0;14,0;1,0;;4,0;4,0;1,0;30,0;7,0;;8,0;10,0;1,0;11,0;;
coordinate;;9,0;;19,0;5,0;68,0;14,0;7,0;19,0;1,0;;;;357,0;;;172,0;;;37,0;;2,0;16,0;1,0;8,0;2,0;;29,0;27,0;6,0;105,0;21,0;15,0;9,0;;266,0;72,0;8,0;62,0;;531,0;292,0;2,0;12,0;59,0;1,0;14,0;13,0;14,0;7,0;93,0;;11,0;2,0;32,0;12,0;18,0;;6,0;53,0;1,0;;37,0;;1031,0;;147,0;;;11,0;16,0;24,0;35,0;;3,0;2,0;;124,0;2,0;23,0;209,0;2,0;6,0;39,0;55,0;3,0;;86,0;;4,0;87,0;;3,0;4,0;18,0;;175,0;157,0;155,0;845,0;450,0;103,0;;12,0;78,0;149,0;4,0;8,0;5,0;2,0;;386,0;37,0;8,0;;14,0;4,0;35,0;58,0;63,0;10,0;;27,0;10,0;;88,0;1359,0;;4,0;;78,0;;5,0;94,0;2,0;;50,0;56,0;8,0;;;6,0;;;4,0;18,0;48,0;8,0;69,0;6,0;1,0;2,0;68,0;;;;;;6,0;19,0;;14,0;;47,0;11,0;36,0;6,0;;;7,0;15,0;;3,0;66,0;31,0;24,0;;;1,0;;7,0;;;9,0;;;12,0;;175,0;4,0;;2,0;;;;;2,0;4,0;;;;3,0;;2,0;113,0;6,0;3,0;1,0;10,0;39,0;22,0;13,0;8,0;;;;13,0;11,0;31,0;9,0;94,0;8,0;;;;;40,0;;1,0;13,0;;;27,0;8,0;;11,0;3,0;;;93,0;;15,0;;;;68,0;14,0;6,0;11,0;;;;;4,0;;;3,0;75,0;4,0;;2,0;11,0;1,0;195,0;;1,0;;;4,0;2,0;;;1,0;5,0;;;;61,0;;;;;91,0;29,0;7,0;;1,0;2,0;18,0;;6,0;2,0;;;7,0;2,0;63,0;3,0;;;;;;6,0;;;1,0;4,0;1,0;56,0;;;1,0;;4,0;;28,0;;1,0;4,0;17,0;399,0;7,0;9,0;1,0;2,0;8,0;;10,0;;;;;;3,0;8,0;;;6,0;4,0;29,0;67,0;1,0;;;;13,0;130,0;;;;;4,0;10,0;86,0;9,0;9,0;4,0;90,0;4,0;5,0;10,0;;7,0;1,0;32,0;12,0;16,0;19,0;1,0;;;264,0;210,0;29,0;11,0;8,0;38,0;42,0;24,0;134,0;;;3,0;1,0;49,0;64,0;166,0;;9,0;3,0;19,0;24,0;9,0;1,0;37,0;;72,0;53,0;3,0;1,0;16,0;5,0;1,0;9,0;292,0;4,0;8,0;29,0;14,0;1,0;60,0;3,0;4,0;112,0;70,0;4,0;4,0;;6,0;5,0;5,0;;4,0;4,0;53,0;26,0;14,0;7,0;3,0;2,0;2,0;30,0;;28,0;18,0;3,0;17,0;3,0;;;1,0;21,0;4,0;107,0;13,0;31,0;15,0;146,0;6,0;;;4,0;;1,0;2,0;13,0;126,0;;16,0;36,0;1,0;;11,0;1,0;6,0;7,0;1,0;;5,0;;;7,0;4,0;;;27,0;11,0;2,0;33,0;1,0;24,0;;8,0;2,0;;25,0;18,0;12,0;104,0;32,0;;;28,0;10,0;;140,0;;1,0;;3,0;2,0;1,0;71,0;64,0;124,0;1,0;2,0;;9,0;;59,0;4,0;;;15,0;;3,0;;;;4,0;2,0;38,0;;3,0;;;;;;3,0;;;121,0;1,0;;3,0;1,0;61,0;25,0;6,0;;;;28,0;;;;16,0;;;5,0;2,0;;3,0;2,0;3,0;;;1,0;13,0;4,0;;31,0;2,0;9,0;;1,0;;;;1,0;;14,0;7,0;;43,0;;1,0;;;12,0;7,0;3,0;;;;7,0;12,0;;2,0;7,0;;;;;1,0;18,0;;;5,0;;82,0;;2,0;39,0;8,0;1,0;;1,0;;;16,0;;;2,0;2,0;7,0;5,0;1,0;1,0;7,0;28,0;;;8,0;;4,0;;;;;5,0;;;;;7,0;5,0;;;2,0;9,0;;8,0;;;;;;6,0;33,0;16,0;62,0;;11,0;2,0;;11,0;31,0;7,0;1,0;4,0;;;;;;;16,0;;7,0;3,0;;5,0;;28,0;260,0;2,0;2,0;12,0;;1,0;4,0;2,0;4,0;;;;1,0;;2,0;;;15,0;;8,0;;;2,0;;11,0;9,0;3,0;;;;;;;3,0;;;;;2,0;;;5,0;;;;;5,0;1,0;;46,0;31,0;1,0;;;57,0;82,0;92,0;;3,0;;14,0;;18,0;;22,0;;;1,0;;10,0;7,0;;;;;;1,0;;31,0;;2,0;;7,0;;;;;4,0;;;22,0;;;;30,0;;;;;;;;5,0;;;1,0;2,0;14,0;;2,0;3,0;;;;21,0;;;;29,0;;;;;;;5,0;4,0;1,0;;;108,0;24,0;;6,0;1,0;;;5,0;;;4,0;2,0;;185,0;11,0;;11,0;4,0;6,0;3,0;;;2,0;;4,0;;;;;9,0;;1,0;;;2,0;;;;;2,0;2,0;4,0;7,0;9,0;2,0;18,0;9,0;;97,0;4,0;;;2,0;6,0;23,0;;15,0;;;;;;;5,0;2,0;11,0;2,0;6,0;2,0;;126,0;1,0;1,0;;;1,0;;1,0;;;;;4,0;3,0;;4,0;1,0;4,0;;;;;;32,0;;;11,0;;10,0;1,0;7,0;;;;;;;;;;;;;;;;;;13,0;;;1,0;50,0;;;3,0;1,0;;;;;7,0;;;2,0;;;;;;;;;;3,0;;6,0;;1,0;;21,0;1,0;;;2,0;;;;;13,0;2,0;;4,0;12,0;;;;;1,0;74,0;;;;;25,0;;4,0;;1,0;;9,0;13,0;13,0;1,0;;;;;;;;
couple;;33,0;;24,0;;190,0;106,0;363,0;;;4,0;6,0;119,0;507,0;5,0;;132,0;9,0;100,0;1,0;36,0;;31,0;7,0;95,0;1,0;3,0;390,0;40,0;1,0;832,0;164,0;1,0;1,0;1,0;149,0;28,0;7,0;4,0;6,0;32,0;875,0;21,0;50,0;195,0;201,0;;272,0;;;2,0;9,0;126,0;59,0;30,0;9,0;143,0;;9,0;34,0;33,0;3,0;40,0;14,0;668,0;4,0;410,0;5,0;5,0;21,0;20,0;939,0;119,0;7,0;;;74,0;32,0;18,0;292,0;157,0;16,0;14,0;2,0;639,0;73,0;5,0;203,0;23,0;3,0;4,0;19,0;23,0;3,0;;;94,0;36,0;422,0;59,0;243,0;17,0;10,0;9,0;175,0;691,0;1,0;18,0;1,0;1,0;;27,0;173,0;20,0;22,0;;7,0;66,0;12,0;699,0;3,0;10,0;252,0;1,0;;46,0;512,0;;1,0;5,0;12,0;5,0;6,0;445,0;;;48,0;1,0;9,0;1,0;12,0;42,0;8,0;;46,0;14,0;36,0;42,0;21,0;47,0;5,0;32,0;298,0;112,0;14,0;30,0;8,0;2,0;;3,0;102,0;104,0;;5,0;33,0;;;214,0;;25,0;70,0;3,0;25,0;50,0;8,0;46,0;2,0;28,0;17,0;16,0;22,0;;21,0;68,0;102,0;6,0;87,0;22,0;213,0;142,0;;17,0;45,0;31,0;180,0;178,0;812,0;;98,0;25,0;3,0;88,0;1,0;13,0;21,0;34,0;717,0;16,0;28,0;880,0;48,0;33,0;5,0;1,0;6,0;120,0;115,0;16,0;3,0;15,0;18,0;5,0;;3,0;240,0;9,0;874,0;2,0;5,0;20,0;24,0;5,0;7,0;1,0;87,0;4,0;5,0;;100,0;;;103,0;59,0;127,0;38,0;18,0;21,0;57,0;437,0;32,0;18,0;19,0;10,0;301,0;315,0;21,0;331,0;597,0;10,0;;27,0;18,0;8,0;122,0;55,0;;;5,0;10,0;36,0;19,0;152,0;194,0;52,0;39,0;2,0;26,0;16,0;20,0;12,0;64,0;11,0;98,0;239,0;;2,0;38,0;102,0;448,0;1,0;126,0;15,0;5,0;14,0;4,0;59,0;31,0;40,0;122,0;38,0;43,0;38,0;91,0;5,0;19,0;63,0;70,0;93,0;6,0;134,0;2,0;22,0;17,0;45,0;14,0;31,0;41,0;54,0;21,0;279,0;46,0;31,0;26,0;2,0;41,0;14,0;;4,0;129,0;95,0;97,0;26,0;17,0;26,0;5,0;3,0;6,0;17,0;5,0;4,0;66,0;48,0;23,0;53,0;20,0;49,0;199,0;105,0;7,0;108,0;4,0;64,0;;2,0;50,0;43,0;14,0;225,0;100,0;51,0;;2,0;10,0;3,0;11,0;19,0;5,0;5,0;14,0;2,0;9,0;2,0;4,0;46,0;5,0;2,0;1,0;13,0;1,0;;241,0;6,0;;8,0;;14,0;2,0;7,0;1,0;5,0;1,0;25,0;;37,0;15,0;14,0;;8,0;2,0;1,0;4,0;75,0;17,0;11,0;29,0;18,0;;31,0;32,0;161,0;9,0;78,0;;17,0;16,0;21,0;1,0;;;;;6,0;4,0;12,0;16,0;150,0;36,0;12,0;2,0;8,0;41,0;2,0;1,0;7,0;3,0;2,0;38,0;3,0;109,0;10,0;16,0;285,0;6,0;18,0;1,0;11,0;;1,0;65,0;3,0;;80,0;20,0;33,0;44,0;68,0;3,0;19,0;5,0;6,0;40,0;;;2,0;;6,0;4,0;1,0;6,0;;6,0;22,0;31,0;166,0;21,0;83,0;13,0;68,0;37,0;5,0;138,0;;45,0;21,0;51,0;3,0;11,0;16,0;13,0;4,0;6,0;;6,0;4,0;49,0;35,0;40,0;4,0;1,0;4,0;3,0;5,0;13,0;15,0;10,0;14,0;3,0;3,0;1,0;3,0;20,0;;39,0;7,0;;66,0;1,0;18,0;1,0;6,0;74,0;138,0;;8,0;;;38,0;13,0;22,0;2,0;46,0;6,0;31,0;66,0;9,0;16,0;3,0;;5,0;4,0;2,0;;18,0;84,0;;3,0;;;93,0;1,0;2,0;14,0;6,0;;7,0;58,0;;29,0;7,0;;;3,0;6,0;17,0;;;19,0;13,0;9,0;10,0;;7,0;10,0;42,0;24,0;25,0;;9,0;6,0;48,0;9,0;1,0;21,0;63,0;35,0;15,0;42,0;6,0;6,0;7,0;36,0;1,0;1,0;5,0;54,0;;10,0;2,0;5,0;13,0;;1,0;;12,0;18,0;2,0;1,0;10,0;9,0;57,0;1,0;17,0;;28,0;9,0;97,0;2,0;5,0;1,0;36,0;3,0;;;;4,0;1,0;;;;;27,0;8,0;19,0;29,0;10,0;;;9,0;4,0;1,0;13,0;18,0;36,0;33,0;20,0;56,0;;22,0;2,0;1,0;19,0;2,0;3,0;;1,0;;;;7,0;1,0;9,0;18,0;20,0;50,0;54,0;11,0;1,0;21,0;27,0;32,0;122,0;15,0;14,0;2,0;;14,0;7,0;15,0;11,0;;1,0;;41,0;7,0;27,0;22,0;2,0;3,0;16,0;6,0;1,0;56,0;11,0;6,0;2,0;164,0;;5,0;6,0;98,0;20,0;;;112,0;88,0;36,0;11,0;27,0;30,0;;4,0;18,0;24,0;2,0;1,0;29,0;;9,0;1,0;3,0;;7,0;12,0;1,0;4,0;5,0;84,0;47,0;11,0;1,0;3,0;1,0;4,0;6,0;27,0;2,0;23,0;88,0;5,0;;2,0;19,0;1,0;53,0;14,0;2,0;45,0;13,0;;4,0;28,0;229,0;36,0;8,0;4,0;5,0;1,0;1,0;13,0;14,0;17,0;6,0;7,0;10,0;6,0;1,0;2,0;1,0;4,0;21,0;;5,0;5,0;1,0;4,0;20,0;4,0;9,0;40,0;17,0;1,0;;5,0;;31,0;;4,0;18,0;1,0;;13,0;5,0;;63,0;27,0;5,0;11,0;12,0;;30,0;;48,0;12,0;;40,0;;;;26,0;;11,0;4,0;7,0;7,0;26,0;;25,0;;3,0;;;5,0;;1,0;6,0;;1,0;1,0;;28,0;;426,0;2,0;;;;9,0;;1,0;;7,0;1,0;4,0;;;;;;;3,0;2,0;;;3,0;;;4,0;;;42,0;;9,0;9,0;1,0;;1,0;;6,0;20,0;20,0;3,0;1,0;;4,0;10,0;2,0;;;;2,0;18,0;;;;;;11,0;;;1,0;;3,0;1,0;;3,0;;3,0;20,0;1,0;;1,0;42,0;;;;10,0;19,0;;11,0;;10,0;3,0;3,0;9,0;2,0;;13,0;13,0;3,0;;16,0;2,0;17,0;;8,0;2,0;;;8,0;;1,0;1,0;8,0;11,0;1,0;20,0;1,0;11,0;;3,0;12,0;8,0;;6,0;;3,0;1,0;2,0;;9,0;28,0;14,0;4,0;3,0;;;7,0;4,0;1,0;3,0;6,0;2,0;;11,0;;;;;;29,0;2,0;;9,0;4,0;;1,0;;12,0;;4,0;13,0;;;6,0;2,0;;10,0;;1,0;2,0;;13,0;;;;;1,0;;;
cover;;16,0;;10,0;8,0;71,0;29,0;201,0;;;4,0;3,0;28,0;264,0;1,0;;24,0;;12,0;;28,0;;34,0;;5,0;1,0;;97,0;5,0;9,0;272,0;15,0;1,0;3,0;;12,0;91,0;26,0;11,0;18,0;41,0;296,0;4,0;5,0;77,0;311,0;;329,0;;6,0;;2,0;89,0;37,0;65,0;12,0;237,0;;2,0;11,0;316,0;1,0;16,0;;194,0;6,0;259,0;;;87,0;14,0;845,0;157,0;2,0;;;70,0;;;4,0;104,0;9,0;2,0;15,0;331,0;66,0;5,0;92,0;14,0;6,0;5,0;63,0;24,0;20,0;16,0;;56,0;45,0;121,0;27,0;303,0;15,0;6,0;10,0;12,0;2,0;6,0;;9,0;1,0;;9,0;118,0;9,0;52,0;;1,0;20,0;14,0;183,0;12,0;12,0;3,0;8,0;8,0;5,0;114,0;;2,0;36,0;12,0;;2,0;162,0;2,0;;107,0;2,0;1,0;5,0;5,0;40,0;18,0;;90,0;9,0;110,0;104,0;11,0;86,0;1,0;26,0;235,0;78,0;;3,0;4,0;27,0;5,0;17,0;40,0;95,0;;;10,0;;214,0;;;;9,0;;4,0;70,0;132,0;70,0;7,0;4,0;9,0;2,0;;11,0;47,0;100,0;13,0;120,0;97,0;7,0;97,0;410,0;;2,0;8,0;15,0;39,0;79,0;395,0;18,0;148,0;24,0;35,0;214,0;3,0;6,0;2,0;1,0;475,0;38,0;21,0;235,0;50,0;57,0;3,0;13,0;14,0;233,0;;16,0;3,0;8,0;25,0;4,0;;18,0;244,0;2,0;665,0;7,0;30,0;3,0;41,0;6,0;24,0;;94,0;;5,0;5,0;21,0;5,0;9,0;33,0;29,0;8,0;83,0;4,0;13,0;56,0;292,0;22,0;20,0;11,0;5,0;103,0;90,0;4,0;140,0;571,0;27,0;;9,0;8,0;5,0;87,0;112,0;10,0;7,0;4,0;;80,0;17,0;20,0;48,0;19,0;3,0;4,0;25,0;19,0;12,0;52,0;12,0;2,0;49,0;57,0;;3,0;54,0;75,0;77,0;5,0;50,0;44,0;1,0;27,0;2,0;13,0;30,0;4,0;24,0;27,0;19,0;9,0;15,0;7,0;;32,0;5,0;19,0;2,0;43,0;6,0;7,0;59,0;;15,0;1,0;47,0;22,0;16,0;19,0;42,0;124,0;30,0;27,0;21,0;29,0;18,0;4,0;12,0;13,0;47,0;1,0;13,0;34,0;7,0;5,0;6,0;9,0;10,0;;41,0;39,0;12,0;2,0;13,0;58,0;10,0;70,0;;24,0;;;;27,0;13,0;8,0;11,0;195,0;33,0;;1,0;;2,0;3,0;1,0;1,0;7,0;16,0;;2,0;14,0;;1,0;24,0;5,0;8,0;;2,0;4,0;;16,0;;1,0;2,0;;48,0;;;3,0;4,0;;4,0;1,0;4,0;6,0;9,0;9,0;2,0;4,0;;;11,0;9,0;1,0;;9,0;1,0;28,0;;70,0;3,0;29,0;;32,0;20,0;1,0;5,0;;1,0;;;;1,0;1,0;;37,0;;15,0;;;24,0;6,0;11,0;4,0;1,0;;3,0;7,0;20,0;;;26,0;2,0;5,0;1,0;1,0;;1,0;13,0;;;1,0;2,0;;24,0;27,0;;2,0;3,0;3,0;3,0;;;14,0;;;;;6,0;;1,0;4,0;;11,0;24,0;3,0;;8,0;;13,0;61,0;6,0;5,0;4,0;9,0;;18,0;9,0;2,0;11,0;;4,0;4,0;20,0;3,0;10,0;12,0;16,0;;;13,0;3,0;2,0;17,0;;10,0;13,0;;1,0;;1,0;;17,0;8,0;6,0;3,0;15,0;115,0;25,0;2,0;31,0;28,0;2,0;31,0;;;58,0;4,0;9,0;;5,0;;1,0;38,0;3,0;5,0;2,0;3,0;7,0;1,0;;;4,0;225,0;2,0;;;3,0;4,0;;3,0;;;1,0;1,0;;;6,0;2,0;;2,0;;16,0;3,0;;;;7,0;6,0;;;4,0;;11,0;22,0;1,0;;1,0;13,0;14,0;;15,0;3,0;2,0;2,0;43,0;14,0;;;10,0;;;;1,0;19,0;;;15,0;10,0;;;;;4,0;;;;3,0;4,0;16,0;2,0;1,0;;12,0;;13,0;;;;23,0;;;3,0;1,0;;;2,0;1,0;;;11,0;;6,0;2,0;5,0;;;7,0;10,0;4,0;2,0;2,0;13,0;10,0;;;;129,0;;12,0;;;;;1,0;25,0;;2,0;;;;;;;19,0;12,0;;;14,0;;15,0;;6,0;;;8,0;;2,0;11,0;;;;;7,0;;11,0;;2,0;23,0;2,0;;42,0;;1,0;16,0;65,0;2,0;22,0;1,0;42,0;;7,0;5,0;23,0;36,0;14,0;4,0;44,0;1,0;1,0;;3,0;16,0;;2,0;16,0;;21,0;1,0;2,0;;1,0;9,0;;4,0;6,0;8,0;;4,0;;3,0;1,0;2,0;10,0;37,0;;2,0;2,0;;7,0;5,0;;1,0;8,0;1,0;;;11,0;3,0;;14,0;43,0;15,0;17,0;5,0;1,0;9,0;;25,0;9,0;7,0;8,0;1,0;2,0;6,0;2,0;6,0;2,0;;2,0;6,0;;6,0;12,0;;;6,0;20,0;97,0;2,0;3,0;;1,0;4,0;260,0;3,0;3,0;8,0;2,0;1,0;;;;;;2,0;11,0;;;;12,0;3,0;23,0;16,0;;3,0;2,0;1,0;4,0;1,0;;;;7,0;;;37,0;;;;4,0;3,0;;;10,0;;;17,0;;2,0;1,0;13,0;;;;;1,0;3,0;;1,0;2,0;1,0;2,0;;;;;1,0;;;4,0;;;;;;;;;1,0;;;2,0;;;;9,0;2,0;;;1,0;;;11,0;1,0;;2,0;;;5,0;;;;1,0;;;1,0;;;2,0;;9,0;;;6,0;;6,0;;5,0;;;;;;;11,0;14,0;;6,0;;1,0;;9,0;;1,0;;1,0;4,0;7,0;1,0;1,0;4,0;7,0;;;;1,0;;2,0;1,0;;1,0;2,0;7,0;7,0;13,0;5,0;2,0;;;4,0;;;;;;20,0;5,0;;;;24,0;3,0;8,0;;4,0;;;;;2,0;;;2,0;16,0;;;;;;;;7,0;;;1,0;;;;;4,0;;;;;;1,0;;;1,0;;2,0;;1,0;;;;;;
curve;;1,0;;14,0;2,0;21,0;65,0;13,0;;;;;1,0;76,0;1,0;3,0;14,0;;6,0;1,0;;1,0;8,0;3,0;;;1,0;14,0;1,0;1,0;42,0;3,0;5,0;4,0;;30,0;20,0;2,0;5,0;;66,0;50,0;1,0;3,0;3,0;38,0;4,0;16,0;1,0;;6,0;1,0;42,0;;13,0;8,0;80,0;1,0;6,0;17,0;;1,0;1,0;;135,0;4,0;42,0;1,0;;6,0;14,0;77,0;53,0;;;;2,0;10,0;;2,0;67,0;4,0;2,0;2,0;41,0;;;5,0;;1,0;1,0;4,0;3,0;;;;5,0;29,0;34,0;57,0;40,0;;1,0;3,0;1,0;4,0;3,0;1,0;;;;2,0;20,0;;1,0;1,0;;13,0;10,0;81,0;1,0;2,0;128,0;;3,0;11,0;34,0;;;;2,0;;;94,0;;;6,0;9,0;2,0;;;2,0;2,0;;;;30,0;3,0;9,0;8,0;;;16,0;15,0;;;;;;;;24,0;;3,0;;;5,0;22,0;2,0;2,0;;;9,0;6,0;4,0;14,0;3,0;;;;2,0;;;41,0;3,0;;;;2,0;10,0;;2,0;1,0;5,0;1,0;4,0;11,0;;;1,0;;7,0;;2,0;3,0;2,0;26,0;6,0;2,0;22,0;5,0;7,0;7,0;;2,0;25,0;8,0;4,0;;17,0;65,0;;;;17,0;;149,0;2,0;;5,0;4,0;4,0;21,0;8,0;11,0;;;3,0;2,0;7,0;;1,0;;;;7,0;;117,0;60,0;;27,0;6,0;;4,0;20,0;;16,0;342,0;8,0;;3,0;;;20,0;26,0;;;14,0;;4,0;6,0;11,0;3,0;4,0;5,0;;;12,0;4,0;6,0;2,0;;12,0;25,0;;;;2,0;34,0;5,0;6,0;9,0;2,0;15,0;;9,0;38,0;3,0;2,0;3,0;2,0;9,0;6,0;1,0;2,0;11,0;;5,0;;25,0;2,0;;8,0;;1,0;;5,0;;4,0;7,0;3,0;24,0;2,0;;13,0;;;;21,0;24,0;10,0;2,0;6,0;41,0;4,0;2,0;;;;;;3,0;1,0;2,0;3,0;8,0;15,0;19,0;;5,0;;;;2,0;5,0;1,0;;17,0;10,0;3,0;;;;4,0;;4,0;;;;;;;5,0;13,0;6,0;;;;1,0;9,0;3,0;8,0;;;1,0;8,0;;1,0;7,0;;;;;23,0;1,0;16,0;;1,0;1,0;;;11,0;;2,0;32,0;7,0;;1,0;2,0;27,0;;10,0;;;5,0;;;1,0;;;;;;1,0;;10,0;;25,0;;;7,0;;;;;;;4,0;;;1,0;1,0;;4,0;;;;4,0;4,0;;2,0;;2,0;11,0;;;;15,0;;;10,0;1,0;;;;9,0;4,0;;;2,0;;;;5,0;4,0;;1,0;;;;4,0;;;1,0;4,0;2,0;3,0;2,0;;;;;3,0;2,0;;1,0;1,0;;;;3,0;;;;;23,0;2,0;;;;;;;;;5,0;;29,0;;14,0;;19,0;;3,0;;;8,0;;1,0;;;;;6,0;10,0;;10,0;;2,0;4,0;;2,0;;47,0;;;;;;;;20,0;;;;;;;1,0;;;;;2,0;;;;1,0;;;;;;1,0;3,0;1,0;;1,0;4,0;5,0;2,0;;1,0;;;2,0;1,0;;;;;2,0;;;2,0;;;;7,0;;;;;1,0;;;;11,0;2,0;;;;;;;1,0;;;;;;;9,0;;;;;;;;1,0;;;;;;;1,0;3,0;;;2,0;;16,0;;;;;;8,0;;;;;2,0;;;;5,0;;;;;3,0;;;;;;;1,0;;;;;1,0;;1,0;1,0;;;;;;;;;;1,0;;1,0;7,0;;;1,0;28,0;1,0;;1,0;1,0;;1,0;;2,0;3,0;1,0;2,0;4,0;;;;3,0;38,0;;;1,0;;2,0;;;;;;;;;12,0;1,0;1,0;;;;4,0;1,0;2,0;;1,0;;;7,0;1,0;;23,0;;;2,0;;;;;3,0;1,0;16,0;;;48,0;7,0;;3,0;5,0;2,0;;;;;;1,0;;;;2,0;2,0;3,0;;2,0;;;;3,0;;;;;6,0;11,0;;;6,0;;;;;;;;;;;;;;;;;;4,0;;;;;;;;;;1,0;8,0;1,0;;;2,0;6,0;;;;;;5,0;1,0;;;;;;;2,0;;16,0;;;;1,0;7,0;;4,0;4,0;;;2,0;;12,0;15,0;2,0;;;;2,0;2,0;;;;2,0;;;;;;;16,0;4,0;;6,0;;1,0;;;;;;2,0;7,0;6,0;;;;;;;;10,0;;5,0;;;;;;;;;;;;;;;;;7,0;;;;1,0;;;;;;;;;;;;;;;;;4,0;5,0;;4,0;3,0;;1,0;;;;;;;;;;;;;;;;1,0;;19,0;1,0;;;;4,0;4,0;12,0;;4,0;;;;2,0;10,0;;;;;2,0;;;;23,0;4,0;;1,0;;;;;;;;14,0;2,0;;;;;;;;;;;
cycle;;7,0;;2,0;1,0;1,0;6,0;1,0;;;;;;21,0;;;2,0;1,0;1,0;;;;3,0;;;;;;;4,0;7,0;7,0;;15,0;;4,0;1,0;;19,0;;33,0;18,0;;9,0;;;;;;7,0;4,0;;;;11,0;;;;29,0;6,0;;;;;49,0;;13,0;1,0;1,0;;1,0;24,0;25,0;;;3,0;;11,0;;9,0;24,0;;7,0;;;;;;;;3,0;;1,0;;3,0;;5,0;;23,0;1,0;13,0;118,0;;;7,0;6,0;;1,0;;;;3,0;;2,0;;;;3,0;;19,0;9,0;;33,0;;;7,0;17,0;;;;73,0;2,0;;17,0;12,0;;;;;;;;;3,0;2,0;;;;;;;;18,0;;4,0;3,0;;;;;;2,0;;3,0;2,0;;;1,0;1,0;7,0;6,0;2,0;;7,0;;;;5,0;;;;;;;;;2,0;;12,0;;;;2,0;;;;;;;;;;;;1,0;1,0;3,0;;;4,0;4,0;11,0;;;;;15,0;;;8,0;;53,0;2,0;;;;4,0;;;;;;8,0;;;;;;;1,0;;;;;;1,0;;;;1,0;;;;;;;;;;;2,0;12,0;;16,0;;;1,0;;;;;4,0;2,0;1,0;;;3,0;;;;;4,0;;;;;;;3,0;;1,0;;;;;;19,0;;;;;;;;;;;1,0;;20,0;;;;1,0;2,0;;;;;;1,0;4,0;;;;;;;3,0;;;;;;;;;;;;;;;;;;;;;;;;5,0;;1,0;;3,0;;4,0;;;5,0;;;;;4,0;;;;;;1,0;;3,0;;;;;1,0;16,0;;;;;1,0;19,0;7,0;;7,0;1,0;;;1,0;;2,0;6,0;;1,0;;5,0;1,0;;1,0;;;;;1,0;5,0;;3,0;;2,0;15,0;;;;;;2,0;10,0;;2,0;;10,0;;2,0;1,0;;;;4,0;;;;8,0;;;3,0;;1,0;1,0;;1,0;;;;2,0;;;;;;;;;36,0;;23,0;;;2,0;;;;;;;1,0;7,0;;1,0;;;;10,0;;3,0;;;;;6,0;;;20,0;;;;;;;;3,0;;;2,0;;3,0;;;;;;;;;;;;3,0;;;;4,0;2,0;;;;;;2,0;;2,0;27,0;;;;;;;;;;;5,0;;1,0;;;;;7,0;;;;;;;;;;;;;;1,0;;;;7,0;;;23,0;;;;3,0;2,0;1,0;1,0;;;;;;;;;;;;;8,0;;;;3,0;;;;2,0;;;;;1,0;;;1,0;;1,0;1,0;;;;1,0;;2,0;;;;;;;;;;;;;3,0;;;;;;;;;;;1,0;;;;;;5,0;;;2,0;;;;;;;;2,0;;;;1,0;;1,0;;1,0;;;;7,0;2,0;18,0;;;;;;17,0;;;1,0;;;;;;;;;;20,0;;14,0;;;;;;;34,0;3,0;;;;;;;16,0;;;9,0;1,0;;;;;;;;;;;4,0;10,0;;;7,0;;;;;7,0;;;;;;;1,0;;;;;;;;;2,0;;;;;5,0;;;;;;;;;;;;;;;;;;;;;;;;;;;5,0;;;;;;;;;;;4,0;;;;;5,0;;;;1,0;1,0;;;2,0;13,0;;;1,0;;;4,0;1,0;;;1,0;1,0;;;;;;7,0;;;;;;;;;;;;;;;;;;6,0;;;2,0;;;;;;;;;;;;;;;;;4,0;;3,0;;;;3,0;;;2,0;;;;1,0;;;;;10,0;;3,0;;;32,0;;6,0;;;1,0;;;;;;;;;;;;;;;;;;;;;;1,0;;;2,0;;;;3,0;;;;1,0;;;;;;;4,0;;;;;;;;19,0;;;3,0;;;;;;;;;;;7,0;;;;;;;;;;;;;;;;;;;21,0;;;;;;;;;;;;;;;;;;;;;;;;;;;;;;;;;;;;;;
cylindrical;;2,0;;1,0;;17,0;27,0;49,0;;;2,0;;97,0;48,0;;;4,0;;4,0;;;;;;;;;22,0;;;47,0;;;2,0;;1,0;23,0;5,0;;;2,0;17,0;45,0;;6,0;68,0;;32,0;;;;1,0;37,0;1,0;1,0;;56,0;;;1,0;12,0;;;;31,0;;87,0;;1,0;4,0;4,0;282,0;5,0;;;;1,0;;;;20,0;;;2,0;17,0;5,0;;24,0;6,0;;;35,0;4,0;7,0;1,0;;;8,0;23,0;;41,0;1,0;;3,0;2,0;1,0;;;1,0;;;;6,0;;;;2,0;2,0;4,0;21,0;;1,0;2,0;11,0;;;19,0;;;3,0;;;2,0;16,0;;;3,0;;;;3,0;1,0;;;23,0;2,0;7,0;13,0;2,0;25,0;;;197,0;55,0;;;26,0;;;;14,0;33,0;;;;2,0;14,0;27,0;1,0;1,0;2,0;;2,0;31,0;64,0;19,0;2,0;;;6,0;;1,0;;7,0;1,0;;;;6,0;69,0;;1,0;1,0;19,0;37,0;2,0;217,0;;59,0;18,0;;1,0;;;;;111,0;1,0;;43,0;15,0;;;;9,0;76,0;;10,0;;2,0;1,0;;;;6,0;;499,0;2,0;3,0;;1,0;;1,0;;4,0;;;;1,0;;3,0;27,0;12,0;;20,0;1,0;;79,0;43,0;4,0;12,0;;;13,0;;;33,0;183,0;6,0;;;;;2,0;45,0;;;;1,0;5,0;;2,0;4,0;;9,0;;13,0;6,0;2,0;4,0;18,0;;50,0;4,0;;;;4,0;2,0;21,0;6,0;;5,0;;;8,0;5,0;;1,0;13,0;2,0;2,0;1,0;;2,0;11,0;;6,0;4,0;12,0;;3,0;22,0;;;;6,0;6,0;1,0;1,0;;2,0;8,0;;;;1,0;1,0;4,0;6,0;8,0;3,0;;8,0;;5,0;;;;1,0;18,0;3,0;10,0;1,0;2,0;10,0;2,0;7,0;;5,0;;;;21,0;;5,0;;5,0;4,0;;;;;;;;;6,0;;;;;;12,0;;;;;;;1,0;;;1,0;;7,0;;;;;;;;6,0;;;;;;;;5,0;;;;;;3,0;2,0;2,0;;3,0;;2,0;14,0;;10,0;;;;;;;;;82,0;;1,0;;;11,0;;1,0;;;;;;;;;11,0;;11,0;;;;;10,0;;;;;;;;;;2,0;1,0;;1,0;;1,0;;;;;;;;;;4,0;8,0;4,0;;;;;2,0;2,0;;;2,0;8,0;;;;;;;;1,0;;;;;;;;;1,0;;;1,0;;;;;;;1,0;;;;3,0;8,0;;;9,0;5,0;1,0;;;;3,0;;7,0;;;;13,0;7,0;3,0;;;;3,0;;;;5,0;61,0;;;;;;;;;;;;;;;;;;;4,0;2,0;;;;;1,0;;;1,0;;6,0;16,0;;1,0;;8,0;;;;;2,0;2,0;16,0;2,0;;;1,0;;;;;;;;4,0;;;;;;;;;;;;4,0;;;;;;;;;;1,0;;;;;;;;;;;;;;;;;;10,0;14,0;;;;2,0;;;;;5,0;;;;;;;;2,0;;;;10,0;;;;;1,0;;;;17,0;;1,0;1,0;;;;;;1,0;2,0;;;10,0;;;;;;;6,0;;;2,0;;;;13,0;;15,0;4,0;2,0;2,0;7,0;;;6,0;15,0;;3,0;24,0;;1,0;2,0;2,0;;10,0;4,0;;1,0;1,0;;;;1,0;;;;2,0;;;;;;1,0;;16,0;;;37,0;;12,0;;;10,0;20,0;;;;;;;;;53,0;;4,0;;1,0;;15,0;8,0;;;;22,0;1,0;;;;;;;;27,0;;;4,0;;4,0;2,0;;1,0;;;3,0;42,0;;2,0;1,0;;;;;;;;;1,0;;;;;;;;;;;;;;;;;;;;;;;;;;;;;;;;;;;;;;;;1,0;1,0;;;;2,0;;;;;;;;;2,0;1,0;;;;;;;;;;;;;;;;;;;;;;;;;;;;;;;;;;;;;;5,0;;;;;;;;;;;;;;;;;;;7,0;;;;7,0;;;;3,0;;;;;;;;;;7,0;;;3,0;;;;24,0;;1,0;;3,0;;;;;;;;;;;;;;6,0;;;;;2,0;5,0;;;6,0;;;;;7,0;;;;;;;8,0;;;;;;;;;;;;;;;;;;;;;;;;;;;
delay;;2,0;;7,0;7,0;10,0;1,0;;;;;;;28,0;;1,0;41,0;;1,0;1,0;;;;3,0;2,0;3,0;;10,0;4,0;1,0;20,0;4,0;1,0;3,0;;18,0;5,0;;3,0;;19,0;14,0;;;33,0;;;3,0;;2,0;;;;;;;;;;;;;;2,0;54,0;3,0;15,0;1,0;1,0;;;6,0;12,0;;;;;3,0;;7,0;53,0;;1,0;7,0;9,0;;;;;;2,0;;;;19,0;;17,0;1,0;10,0;13,0;;36,0;;5,0;19,0;5,0;;1,0;;;;6,0;;;;;;;;37,0;3,0;;54,0;;;1,0;12,0;;;4,0;243,0;7,0;;41,0;2,0;;1,0;;;;;3,0;2,0;;;14,0;;;10,0;1,0;;;;;2,0;;;;;;;1,0;1,0;;;;1,0;;10,0;3,0;;;;;;;;3,0;2,0;;3,0;;2,0;;;;;;6,0;;;;;;;;;;;;;;;;26,0;3,0;;;;;;;9,0;;;;6,0;;;11,0;;55,0;;;;;6,0;;;;;5,0;22,0;;;1,0;;;;7,0;;;;;;16,0;2,0;;;;;;;;;;;1,0;;;;12,0;;2,0;;;;;;;;;2,0;;;;2,0;;;;;;;1,0;;;;2,0;13,0;;2,0;3,0;;;;;6,0;4,0;;;;;;;;;;;;24,0;;;;1,0;;;;;;;;7,0;;;;;;;;;;;;;6,0;;;;;;;;;;;;;1,0;;;;;11,0;;;;;;35,0;;;;;;5,0;;;;;;;1,0;7,0;;;;;29,0;;;33,0;7,0;2,0;;;2,0;;22,0;;3,0;1,0;1,0;;;;;;3,0;3,0;3,0;;2,0;2,0;1,0;;4,0;;1,0;;8,0;;4,0;;3,0;2,0;;;;;;;;;;4,0;8,0;;4,0;;;;;1,0;1,0;5,0;;2,0;;3,0;7,0;;1,0;10,0;;3,0;6,0;;;5,0;15,0;10,0;;2,0;;;;;32,0;;;1,0;;2,0;;;2,0;;3,0;;;;;3,0;;;;2,0;;;;;;;;;;8,0;;;;;;;;1,0;;;;;;;10,0;;;;;;;;;1,0;4,0;1,0;;;1,0;;;;;;;;;;1,0;;;;;;;;;;;5,0;;;;;1,0;;;;2,0;;;;;;;;;6,0;;;2,0;;;;20,0;;;17,0;;;4,0;1,0;1,0;;;;;1,0;;;1,0;;;;;;;;;;;3,0;;;;;;;;;1,0;1,0;;;;;;;;;2,0;;;;;;;;;;;;;6,0;;;;;9,0;;;;1,0;;;;1,0;;;;1,0;;8,0;;;;;;;3,0;;;;;;1,0;;;3,0;;;;;;1,0;3,0;;28,0;;;;;;3,0;;;;;14,0;;;;;16,0;;;34,0;;2,0;2,0;;3,0;;;;11,0;;;;;;;;;;;;1,0;;;;;;;;;;;;;;;;;;;;2,0;;;;;;;;;;5,0;3,0;;;2,0;;;;;;;1,0;;;;;;;;;;;11,0;;;;;;;;;;;;;;1,0;;;;;;;;;;;3,0;;1,0;;2,0;;;;;;4,0;;;;;;;;;;;;4,0;;7,0;;2,0;;7,0;;;;;;;;;;;;;;2,0;2,0;;;2,0;;;;;;;;;;;;;5,0;;;;;;;;;;;5,0;8,0;;;;;;;;;;;;;1,0;;;;4,0;;;;;;1,0;;2,0;;;;;;;;;;;;;;;;;;1,0;;;;;;;;;;;;;;3,0;;;;;;;2,0;;;2,0;;;;;;;;;6,0;;;;;;;;;;;3,0;;;;;;;;;;;;;;;;;;;;;;1,0;;;;;7,0;;;;;;;;;;;;;;;;;;;;;;;;;;;;;;;;;
detachable;;2,0;;;;8,0;1,0;8,0;;;;;;20,0;;;4,0;1,0;;;;;4,0;5,0;;;;3,0;;;17,0;;;;;7,0;;;;;2,0;46,0;;;4,0;14,0;;6,0;;;;;1,0;;;3,0;2,0;;1,0;1,0;;;;;11,0;;26,0;2,0;;;3,0;56,0;5,0;;;;1,0;;;7,0;20,0;;;;114,0;4,0;;;;;;;1,0;;;;;;15,0;1,0;8,0;2,0;;;;1,0;;;;;;;;1,0;2,0;;1,0;3,0;;2,0;;;2,0;1,0;;;12,0;;;;;;;27,0;;;1,0;;;;;2,0;;;;;;1,0;;13,0;;;37,0;2,0;;;;;;;;3,0;;;;;6,0;1,0;;;1,0;;;3,0;7,0;;;5,0;;;;;;10,0;;8,0;;;23,0;4,0;;;;7,0;;3,0;28,0;;;;;2,0;;;;2,0;65,0;;;33,0;;1,0;;;;;;1,0;;;;;;;13,0;;16,0;1,0;;;1,0;4,0;3,0;;;;;;1,0;;;2,0;;;;;1,0;;12,0;10,0;;;;6,0;;;12,0;2,0;;;;1,0;5,0;7,0;;;;;2,0;;;;;1,0;;2,0;3,0;;1,0;;2,0;;;;;;1,0;2,0;;;;2,0;;4,0;;;3,0;;;;12,0;1,0;1,0;;1,0;;6,0;;;8,0;;1,0;;2,0;;;;1,0;15,0;6,0;14,0;1,0;2,0;;;1,0;;;9,0;;;;;2,0;73,0;;;;;;1,0;1,0;;1,0;1,0;5,0;;1,0;;1,0;;;;;;;1,0;;14,0;2,0;;;;5,0;;;;;;;;;;1,0;;;;;;;1,0;;;;2,0;;;;;;;;;3,0;;1,0;;;;;;1,0;;1,0;;1,0;;;5,0;;1,0;;;2,0;;;;;;;;1,0;;;;12,0;;;;8,0;;;;;;;2,0;;;2,0;;1,0;;;;;;;;;;;;1,0;;1,0;;;1,0;;;2,0;;;;;;;;;;;;28,0;2,0;;;;;;;;;;;;4,0;1,0;12,0;;;;;;;;;;;;;2,0;;;;;;;;;;;;;;;1,0;;9,0;;3,0;3,0;;2,0;;;;;;;;;6,0;;1,0;1,0;;;;;;;;;;3,0;;;;;1,0;;;;;;;;;;;;1,0;;;;1,0;;;;;;;;;;;;;;;;;;;;28,0;;;;;;;;8,0;;;;;;;;;1,0;;;;;;;;;;1,0;;;;;;;;;;;;;;;;;2,0;;12,0;;;;;;;;3,0;1,0;2,0;;;1,0;;1,0;;;;;;;;2,0;;;;;1,0;4,0;;;;;;;;;;;;1,0;;;;;;;;;;;;1,0;;;1,0;;;4,0;;;;;;1,0;;1,0;1,0;;;;;;2,0;;;;;;;;;1,0;;1,0;36,0;;;;;;;;;;;;;;;;;;;;;;;3,0;;;;;;;;;;;2,0;;;;;;1,0;;;3,0;;;1,0;;;;;;;;;;;;;2,0;1,0;;;;;;;;;1,0;;;;;;;;;;;;;;;;;;;;;;;;;;;;;;;;;;;;;;;;;;;;;;;;;;2,0;;;3,0;;;;;;;;;;;;;;;;;;;7,0;;;;;;;;;;;;;;;;;;2,0;;;;;;;;;;;;;;;;;;;;;;;;;;;;;;;;;;;;;;;;;;;;;;;;;;;;;;;;;;;;;;;;;;;;1,0;;;;;;;;;;;;;;;;;;;;;;;;;;;;;;;;;;;;;;;;;;;;;;;;;;;;;;
detachably;;33,0;;2,0;2,0;13,0;;21,0;;;;;5,0;26,0;;;;;;;;;;6,0;3,0;;;31,0;;;89,0;1,0;;;;3,0;2,0;;;;;52,0;;1,0;1,0;12,0;;26,0;;;;;;7,0;;3,0;4,0;;;3,0;;;;;8,0;;17,0;;2,0;;7,0;120,0;6,0;;;;;;;4,0;5,0;;;;27,0;;;8,0;;2,0;;;;;3,0;;1,0;;16,0;3,0;3,0;;;;;1,0;;1,0;;;;;;;;;;;;1,0;;;1,0;;;;66,0;;2,0;;;;;59,0;;;2,0;;;;;1,0;;;;;;;;64,0;;;143,0;2,0;;;;;;;;75,0;;;;;98,0;42,0;;;;;;;;;;;5,0;;;;;5,0;;;;;1,0;14,0;;6,0;;1,0;6,0;5,0;51,0;;;;;;;2,0;;;126,0;;;187,0;;3,0;;;;12,0;;;;;;;;;14,0;8,0;36,0;;;;;;;;1,0;;;;;;;4,0;30,0;;;2,0;;;74,0;2,0;2,0;;;34,0;;3,0;7,0;24,0;1,0;;;;;6,0;9,0;;;;1,0;;;1,0;1,0;6,0;3,0;;3,0;;;;6,0;;;1,0;;;1,0;13,0;;1,0;;;;2,0;;3,0;;;;10,0;54,0;;5,0;;;3,0;1,0;3,0;;;;;4,0;;;;;4,0;;5,0;12,0;4,0;;;2,0;;6,0;;7,0;;;3,0;;;2,0;;2,0;;;;;26,0;;7,0;1,0;21,0;14,0;1,0;;;;;;;;;;2,0;;3,0;;;;;;;;;1,0;2,0;;;;;;;;;;;2,0;;;;;;;;;;;;;3,0;;;;;;;;;;1,0;;1,0;;3,0;;1,0;;;;;;7,0;;;;;;;;;;7,0;;;;;;;;;;;2,0;1,0;;;;13,0;;;;;;;2,0;;;;;;3,0;;;;;;;;;;;;;;;;;1,0;;4,0;1,0;1,0;;;;;;;;1,0;;;;;1,0;;;;;;1,0;;;;;;;;;;;1,0;;;;;;;;2,0;;;;2,0;2,0;;;8,0;;;;;1,0;;;;;;11,0;;;;;;;;;;;4,0;;4,0;;;1,0;;;2,0;;;;;;;;;;;;;;;;;;;;;;;;;;;2,0;1,0;;;;;;;1,0;;;;;;;;6,0;;;;;;;;;;;;;;;;1,0;;;;;2,0;;1,0;;;;;;;;;;;;;;;;1,0;;;;1,0;;;;2,0;2,0;;;;;;;;;;;;;;1,0;;;;3,0;;;;9,0;;;;4,0;;;;;;;;;;1,0;;;3,0;;2,0;;;;;;;;2,0;;;;3,0;;1,0;1,0;;;;;9,0;;;;3,0;4,0;;;;;1,0;;;;7,0;71,0;;;;;;;;;;1,0;;;;;;;;;;;;;2,0;;2,0;;;1,0;;;;;;2,0;;;;;;;;1,0;;;;;;;;;;;;;;;;;2,0;;2,0;;;;;;;;;;;;;;;;;;;;;;;;;;;;;;;;;;;;;;;;;;;;;;;;;;;;;;;;;;;;;3,0;;;;;;;;;;;;;;;;;;;;;;;;;;;;;;;;;;;;;;;;;;;;;;;;;;;;;;;;;;;;;;;;;3,0;;;;;;;;;;;;;;;;;;3,0;;;;;;;;;;;2,0;;;;;;;;;;;2,0;;;;;;;;;;;;;;;3,0;;;;;;;;;;;;;;;;;;;;;;;;;;;;;;;;;;;;;;;
detect;;25,0;;48,0;225,0;259,0;104,0;23,0;5,0;16,0;;37,0;7,0;661,0;1,0;23,0;437,0;3,0;3,0;117,0;3,0;2,0;83,0;8,0;30,0;7,0;1,0;66,0;56,0;167,0;924,0;120,0;24,0;22,0;;374,0;41,0;17,0;36,0;5,0;408,0;951,0;;98,0;311,0;24,0;6,0;117,0;4,0;15,0;35,0;3,0;8,0;19,0;136,0;55,0;15,0;2,0;47,0;111,0;6,0;3,0;34,0;9,0;2106,0;12,0;447,0;10,0;6,0;8,0;10,0;293,0;545,0;;18,0;18,0;6,0;25,0;32,0;44,0;890,0;;154,0;43,0;185,0;46,0;9,0;153,0;7,0;32,0;58,0;10,0;41,0;14,0;104,0;;287,0;41,0;416,0;258,0;820,0;155,0;3,0;84,0;162,0;310,0;11,0;62,0;33,0;28,0;1,0;88,0;326,0;14,0;3,0;23,0;15,0;32,0;175,0;894,0;42,0;5,0;415,0;74,0;34,0;75,0;521,0;;24,0;2,0;194,0;1,0;5,0;635,0;4,0;1,0;240,0;17,0;75,0;;;12,0;6,0;5,0;6,0;63,0;164,0;81,0;162,0;19,0;6,0;66,0;108,0;4,0;2,0;22,0;;2,0;;3,0;;47,0;29,0;30,0;7,0;13,0;14,0;48,0;10,0;765,0;452,0;13,0;19,0;260,0;;110,0;2,0;97,0;16,0;13,0;19,0;15,0;;395,0;;8,0;19,0;35,0;195,0;42,0;17,0;70,0;9,0;;16,0;3,0;42,0;9,0;1,0;1,0;;19,0;6,0;9,0;48,0;43,0;48,0;7,0;28,0;43,0;30,0;271,0;3,0;;;14,0;135,0;10,0;13,0;11,0;129,0;23,0;183,0;6,0;6,0;1,0;208,0;16,0;1,0;7,0;;143,0;67,0;24,0;10,0;28,0;58,0;25,0;;35,0;;17,0;12,0;;;49,0;11,0;32,0;28,0;8,0;;;9,0;26,0;17,0;21,0;11,0;98,0;2,0;273,0;4,0;49,0;26,0;428,0;4,0;9,0;308,0;39,0;16,0;40,0;8,0;;33,0;30,0;1,0;;5,0;117,0;2,0;14,0;1,0;18,0;79,0;15,0;48,0;;6,0;40,0;57,0;4,0;39,0;9,0;18,0;7,0;19,0;;179,0;14,0;1,0;6,0;;1,0;4,0;16,0;;3,0;20,0;73,0;9,0;131,0;2,0;1,0;9,0;14,0;18,0;1,0;55,0;31,0;1,0;17,0;92,0;1148,0;4,0;39,0;5,0;2,0;13,0;;30,0;4,0;2,0;;;2,0;26,0;3,0;23,0;;;6,0;23,0;140,0;34,0;;7,0;8,0;67,0;25,0;1,0;;6,0;;37,0;;124,0;;31,0;7,0;325,0;37,0;25,0;45,0;32,0;38,0;47,0;49,0;50,0;40,0;;4,0;;3,0;55,0;14,0;319,0;13,0;4,0;43,0;73,0;18,0;198,0;49,0;1,0;6,0;13,0;;35,0;90,0;45,0;343,0;34,0;18,0;31,0;239,0;23,0;37,0;;97,0;67,0;22,0;14,0;274,0;10,0;105,0;18,0;252,0;12,0;38,0;368,0;29,0;1,0;171,0;3,0;42,0;263,0;182,0;2,0;7,0;60,0;13,0;9,0;41,0;7,0;12,0;9,0;163,0;21,0;431,0;81,0;6,0;25,0;6,0;91,0;53,0;39,0;7,0;30,0;155,0;66,0;20,0;102,0;48,0;144,0;106,0;10,0;38,0;;33,0;385,0;27,0;6,0;95,0;33,0;1,0;11,0;7,0;4,0;43,0;1,0;8,0;86,0;2,0;34,0;14,0;4,0;10,0;10,0;12,0;9,0;28,0;55,0;22,0;195,0;30,0;4,0;;4,0;17,0;12,0;17,0;126,0;55,0;49,0;31,0;45,0;;146,0;38,0;27,0;59,0;9,0;163,0;7,0;20,0;11,0;19,0;68,0;36,0;20,0;9,0;13,0;43,0;1,0;120,0;21,0;18,0;30,0;10,0;;1,0;86,0;32,0;11,0;4,0;4,0;37,0;1,0;23,0;1,0;;23,0;1,0;1,0;4,0;27,0;5,0;7,0;6,0;1,0;2,0;1,0;334,0;24,0;4,0;33,0;7,0;10,0;13,0;13,0;118,0;2,0;35,0;2,0;46,0;1,0;17,0;28,0;6,0;21,0;35,0;14,0;7,0;22,0;11,0;33,0;44,0;;2,0;;30,0;5,0;25,0;17,0;62,0;10,0;;50,0;9,0;16,0;7,0;21,0;1,0;1,0;2,0;2,0;5,0;65,0;30,0;;2,0;4,0;24,0;35,0;10,0;6,0;2,0;;6,0;28,0;26,0;5,0;13,0;2,0;2,0;27,0;2,0;3,0;17,0;40,0;;37,0;14,0;26,0;252,0;5,0;27,0;29,0;9,0;3,0;6,0;;1,0;23,0;14,0;9,0;;68,0;30,0;2,0;11,0;9,0;1,0;83,0;116,0;9,0;;16,0;;7,0;9,0;6,0;9,0;;24,0;15,0;;11,0;1,0;1,0;39,0;1,0;12,0;5,0;1,0;27,0;30,0;12,0;2,0;7,0;2,0;4,0;4,0;11,0;1,0;8,0;22,0;39,0;7,0;62,0;12,0;1,0;26,0;4,0;9,0;35,0;;2,0;7,0;;9,0;66,0;3,0;10,0;32,0;8,0;1,0;10,0;22,0;213,0;5,0;34,0;1,0;2,0;31,0;4,0;68,0;5,0;;;18,0;4,0;;7,0;1,0;;55,0;2,0;8,0;;;3,0;10,0;6,0;31,0;57,0;;;12,0;4,0;8,0;2,0;;1,0;;2,0;38,0;6,0;1,0;6,0;15,0;10,0;;;10,0;12,0;2,0;;3,0;2,0;18,0;10,0;7,0;2,0;9,0;45,0;1,0;;;42,0;4,0;30,0;16,0;1,0;4,0;;1,0;30,0;29,0;17,0;3,0;;11,0;;5,0;1,0;;3,0;10,0;2,0;;12,0;13,0;5,0;;;7,0;;;48,0;;79,0;5,0;14,0;1,0;;1,0;8,0;;2,0;;;;1,0;49,0;6,0;45,0;36,0;2,0;6,0;;18,0;1,0;17,0;;4,0;5,0;12,0;6,0;;;2,0;10,0;3,0;26,0;6,0;6,0;;1,0;83,0;1,0;9,0;46,0;9,0;1,0;6,0;16,0;9,0;114,0;23,0;3,0;;23,0;39,0;2,0;4,0;12,0;2,0;9,0;5,0;;7,0;19,0;23,0;;45,0;2,0;6,0;8,0;;15,0;3,0;;58,0;2,0;5,0;25,0;12,0;19,0;7,0;5,0;48,0;15,0;2,0;12,0;3,0;12,0;25,0;44,0;9,0;7,0;42,0;11,0;6,0;6,0;11,0;6,0;18,0;15,0;11,0;9,0;6,0;46,0;20,0;23,0;17,0;1,0;;6,0;1,0;7,0;8,0;9,0;17,0;8,0;;37,0;3,0;12,0;11,0;11,0;;;1,0;15,0;2,0;30,0;39,0;4,0;27,0;3,0;2,0;7,0;;8,0;27,0;6,0;;45,0;2,0;16,0;2,0;;9,0;;1,0;;;14,0;33,0;16,0;;4,0;3,0;16,0;;14,0;56,0;12,0;22,0;;9,0;1,0;1,0;2,0;6,0;1,0;2,0;1,0;2,0;9,0;;3,0;31,0;;;;16,0;;1,0;;5,0;;3,0;8,0;2,0;5,0;2,0;;4,0;34,0;;5,0;38,0;;6,0;;2,0;16,0;25,0;3,0;22,0;73,0;2,0;11,0;4,0;5,0;6,0;1,0;;;10,0;5,0;5,0;4,0;1,0;;2,0;2,0;5,0;;12,0;;3,0;1,0;;;;5,0;;
detection;;5,0;;16,0;60,0;118,0;34,0;11,0;2,0;1,0;;7,0;3,0;328,0;3,0;2,0;82,0;1,0;;34,0;1,0;;22,0;7,0;16,0;4,0;6,0;71,0;11,0;19,0;328,0;54,0;16,0;49,0;;93,0;12,0;5,0;18,0;3,0;133,0;450,0;;23,0;77,0;47,0;1,0;52,0;;15,0;12,0;;5,0;21,0;52,0;63,0;19,0;;8,0;81,0;2,0;;9,0;8,0;561,0;3,0;278,0;2,0;1,0;13,0;4,0;125,0;113,0;;2,0;7,0;1,0;13,0;;44,0;238,0;;59,0;4,0;103,0;10,0;;64,0;;7,0;23,0;1,0;10,0;;11,0;;397,0;59,0;155,0;94,0;407,0;65,0;1,0;55,0;63,0;85,0;2,0;3,0;;6,0;;35,0;116,0;5,0;;;26,0;18,0;12,0;317,0;18,0;;459,0;16,0;6,0;54,0;355,0;;21,0;;64,0;2,0;;632,0;1,0;;28,0;72,0;15,0;3,0;;1,0;3,0;;6,0;37,0;194,0;38,0;27,0;7,0;;4,0;40,0;;;23,0;4,0;1,0;;;4,0;32,0;1,0;3,0;1,0;;25,0;;;;48,0;8,0;9,0;88,0;;58,0;;6,0;5,0;;3,0;8,0;;166,0;;4,0;19,0;4,0;58,0;4,0;3,0;9,0;2,0;7,0;18,0;11,0;11,0;15,0;1,0;2,0;;9,0;6,0;1,0;49,0;10,0;54,0;5,0;2,0;26,0;7,0;37,0;7,0;;;3,0;174,0;;1,0;2,0;13,0;8,0;42,0;27,0;16,0;1,0;113,0;1,0;8,0;1,0;;24,0;37,0;11,0;7,0;19,0;7,0;15,0;;10,0;1,0;6,0;10,0;;;36,0;8,0;8,0;14,0;4,0;;;;9,0;26,0;35,0;18,0;42,0;3,0;192,0;23,0;20,0;5,0;112,0;1,0;5,0;186,0;1,0;1,0;14,0;;;22,0;7,0;4,0;;1,0;42,0;;13,0;6,0;54,0;47,0;14,0;1,0;;;25,0;68,0;;29,0;5,0;1,0;1,0;1,0;;47,0;7,0;;;;;1,0;1,0;;9,0;10,0;20,0;29,0;77,0;;;;;2,0;4,0;21,0;2,0;6,0;6,0;10,0;392,0;19,0;26,0;1,0;2,0;7,0;;21,0;11,0;;;;3,0;12,0;2,0;;;;2,0;2,0;42,0;3,0;;7,0;5,0;17,0;35,0;1,0;1,0;;;;;71,0;;9,0;;118,0;9,0;169,0;;1,0;2,0;;18,0;4,0;48,0;;7,0;;6,0;25,0;5,0;42,0;10,0;;8,0;10,0;3,0;100,0;7,0;7,0;3,0;;765,0;16,0;61,0;6,0;117,0;3,0;13,0;11,0;558,0;17,0;25,0;;39,0;100,0;5,0;;86,0;3,0;39,0;1,0;114,0;;17,0;184,0;17,0;;32,0;1,0;12,0;121,0;23,0;1,0;1,0;33,0;1,0;2,0;5,0;2,0;9,0;;87,0;3,0;149,0;19,0;2,0;28,0;;101,0;8,0;5,0;;21,0;58,0;45,0;8,0;11,0;55,0;29,0;8,0;5,0;6,0;;;56,0;39,0;;42,0;21,0;1,0;;;8,0;16,0;2,0;3,0;5,0;7,0;4,0;41,0;;;15,0;1,0;10,0;20,0;4,0;7,0;42,0;10,0;1,0;;7,0;;1,0;7,0;64,0;12,0;1,0;1,0;8,0;;210,0;3,0;3,0;11,0;6,0;12,0;11,0;4,0;9,0;;7,0;9,0;22,0;3,0;;2,0;1,0;5,0;2,0;1,0;2,0;;;;7,0;;4,0;1,0;;26,0;1,0;25,0;;4,0;;1,0;;15,0;6,0;3,0;2,0;;;1,0;1,0;212,0;;;11,0;4,0;2,0;1,0;19,0;11,0;1,0;4,0;2,0;17,0;3,0;10,0;5,0;;7,0;19,0;3,0;2,0;15,0;;1,0;10,0;;3,0;;3,0;5,0;9,0;7,0;;1,0;;7,0;7,0;2,0;1,0;5,0;5,0;;2,0;11,0;4,0;4,0;48,0;;10,0;1,0;4,0;3,0;15,0;7,0;;;;11,0;2,0;;1,0;3,0;8,0;6,0;;1,0;8,0;1,0;2,0;12,0;1,0;11,0;53,0;7,0;6,0;;11,0;1,0;17,0;;;;13,0;2,0;;17,0;13,0;;;1,0;;8,0;16,0;;;;;;1,0;3,0;1,0;;9,0;3,0;1,0;;;;28,0;1,0;4,0;2,0;;2,0;;1,0;2,0;;;;4,0;;;1,0;2,0;;1,0;5,0;4,0;1,0;1,0;8,0;8,0;47,0;;4,0;4,0;;1,0;20,0;1,0;;4,0;;1,0;;1,0;53,0;;28,0;;;11,0;2,0;38,0;19,0;;;;;;4,0;;;15,0;6,0;2,0;;;1,0;;12,0;15,0;37,0;;1,0;;4,0;6,0;4,0;;;;1,0;10,0;;3,0;10,0;;3,0;;;22,0;11,0;1,0;;;2,0;5,0;3,0;5,0;1,0;3,0;5,0;;;;;;12,0;;6,0;13,0;;;5,0;2,0;11,0;20,0;;19,0;;;4,0;;6,0;;1,0;;;;1,0;;4,0;5,0;1,0;;3,0;;3,0;;3,0;;;;1,0;;11,0;;;;;;;5,0;19,0;;9,0;1,0;1,0;9,0;37,0;;2,0;;14,0;3,0;;;;;17,0;5,0;2,0;;;1,0;20,0;;18,0;6,0;4,0;;9,0;8,0;1,0;84,0;11,0;;;18,0;22,0;;;;;3,0;6,0;;7,0;;66,0;;7,0;6,0;;;;25,0;2,0;;24,0;;;;1,0;10,0;19,0;1,0;5,0;27,0;;3,0;3,0;2,0;24,0;1,0;6,0;6,0;19,0;8,0;;5,0;2,0;;5,0;;4,0;7,0;;9,0;4,0;1,0;14,0;;;;;;;1,0;2,0;2,0;;1,0;;;;3,0;2,0;;5,0;6,0;13,0;;15,0;3,0;5,0;;1,0;;;;10,0;2,0;;23,0;8,0;8,0;;37,0;1,0;;;;;;19,0;3,0;;;;;;;7,0;2,0;19,0;3,0;;1,0;;1,0;;;;;;1,0;;;27,0;;2,0;;40,0;;;;1,0;1,0;4,0;1,0;;;4,0;;;1,0;;1,0;9,0;;;;;4,0;3,0;15,0;;;2,0;;;;1,0;;2,0;;5,0;1,0;;;;;;;;;4,0;;2,0;;;;1,0;15,0;;
determination;;2,0;;11,0;12,0;37,0;9,0;2,0;;8,0;;;;285,0;;1,0;63,0;;;9,0;;23,0;45,0;1,0;6,0;;3,0;11,0;5,0;157,0;103,0;16,0;6,0;2,0;;65,0;4,0;6,0;66,0;;240,0;156,0;1,0;41,0;56,0;2,0;1,0;5,0;;3,0;12,0;;5,0;1,0;50,0;2,0;1,0;;5,0;29,0;1,0;;6,0;5,0;241,0;;81,0;5,0;2,0;;1,0;58,0;41,0;;15,0;14,0;;6,0;1,0;2,0;101,0;;50,0;3,0;38,0;1,0;;12,0;;1,0;20,0;1,0;;;15,0;;55,0;;29,0;13,0;78,0;31,0;;53,0;45,0;41,0;3,0;38,0;1,0;;;33,0;34,0;1,0;;7,0;1,0;8,0;22,0;49,0;1,0;6,0;145,0;15,0;;17,0;88,0;;5,0;;36,0;2,0;;190,0;4,0;;16,0;20,0;21,0;;;;1,0;2,0;;4,0;30,0;2,0;10,0;1,0;1,0;20,0;19,0;;8,0;1,0;;3,0;;;;2,0;12,0;2,0;1,0;3,0;2,0;;1,0;16,0;1,0;2,0;8,0;52,0;;3,0;4,0;2,0;12,0;;;;;6,0;;;8,0;;28,0;1,0;2,0;;;4,0;;;;1,0;;;;1,0;2,0;;32,0;11,0;4,0;;;43,0;12,0;34,0;2,0;;;;74,0;7,0;;;6,0;24,0;4,0;;;;31,0;;;;;;4,0;;;;;3,0;;3,0;;;;;;45,0;;;2,0;;;;;1,0;1,0;8,0;2,0;3,0;;;3,0;9,0;32,0;33,0;;6,0;;2,0;3,0;2,0;;;;7,0;;;;12,0;;;;;1,0;;;;;17,0;64,0;;;2,0;;;;;29,0;8,0;;;;;;1,0;;;;1,0;3,0;23,0;;;;;;;7,0;3,0;;;13,0;109,0;1,0;12,0;;;1,0;;16,0;;;;;;10,0;;;;2,0;;5,0;;;;;;3,0;1,0;;;;;9,0;;20,0;;9,0;;26,0;;2,0;1,0;1,0;5,0;2,0;21,0;11,0;;;2,0;;;24,0;5,0;51,0;3,0;;2,0;3,0;10,0;55,0;64,0;19,0;1,0;2,0;35,0;;9,0;11,0;4,0;4,0;9,0;;20,0;2,0;25,0;;7,0;17,0;13,0;;40,0;19,0;68,0;;42,0;3,0;10,0;36,0;;;15,0;;16,0;40,0;6,0;;4,0;;2,0;4,0;35,0;3,0;7,0;3,0;9,0;12,0;159,0;74,0;3,0;26,0;;35,0;4,0;12,0;;11,0;13,0;20,0;;2,0;4,0;42,0;;;1,0;;5,0;35,0;;;25,0;25,0;;2,0;9,0;10,0;16,0;1,0;9,0;30,0;;20,0;1,0;;;;;;;4,0;5,0;37,0;10,0;;;;14,0;5,0;2,0;;2,0;1,0;5,0;3,0;1,0;68,0;4,0;1,0;15,0;1,0;4,0;;3,0;;;;6,0;;;4,0;3,0;;;1,0;2,0;9,0;;1,0;2,0;1,0;1,0;;;;36,0;;11,0;;;12,0;;;;4,0;4,0;;;;;;63,0;;;;;2,0;;;18,0;6,0;;;5,0;2,0;2,0;;1,0;;5,0;8,0;;4,0;1,0;6,0;2,0;;;;7,0;;11,0;2,0;1,0;11,0;;4,0;;3,0;1,0;;;;3,0;1,0;4,0;6,0;3,0;;5,0;3,0;2,0;3,0;3,0;8,0;;;1,0;3,0;10,0;;3,0;;;4,0;;;;3,0;;;2,0;1,0;18,0;1,0;12,0;;2,0;2,0;1,0;1,0;3,0;2,0;;;;;2,0;4,0;;1,0;1,0;6,0;;;;;;3,0;1,0;;1,0;;8,0;;2,0;10,0;;;2,0;1,0;4,0;;;;1,0;;;;;;2,0;8,0;4,0;;2,0;6,0;1,0;;;;;1,0;;;;;;;4,0;14,0;;6,0;48,0;15,0;;;3,0;8,0;23,0;1,0;;1,0;10,0;;;3,0;;8,0;;;;;7,0;2,0;9,0;;;;;;;5,0;3,0;9,0;;;;;2,0;;;;1,0;;6,0;;3,0;1,0;6,0;5,0;;;3,0;6,0;4,0;;;2,0;5,0;;;;3,0;1,0;1,0;;;2,0;;7,0;;1,0;;;;15,0;4,0;;;;;;;;;;;;;;;;;;4,0;;;;;1,0;;3,0;;;;;;;;;;;5,0;;1,0;;1,0;;;;;12,0;;;;;8,0;4,0;;;;;16,0;;1,0;;31,0;;1,0;;1,0;;2,0;14,0;2,0;;16,0;1,0;2,0;6,0;5,0;;;1,0;;;;1,0;;2,0;1,0;47,0;;;;3,0;;;1,0;;;1,0;1,0;2,0;12,0;;2,0;;1,0;1,0;1,0;;;6,0;;;1,0;2,0;;12,0;1,0;;;1,0;;;3,0;;5,0;6,0;10,0;10,0;;3,0;;2,0;;;1,0;;4,0;;1,0;;1,0;;;;;;;;;1,0;;1,0;2,0;;;;;;;;;;26,0;1,0;;;;1,0;;;;;;2,0;;;;;1,0;;2,0;;;1,0;;14,0;1,0;;;;;;;;2,0;1,0;17,0;;;;;1,0;;;;1,0;;;;1,0;;1,0;;;1,0;;4,0;;;;;;;1,0;1,0;3,0;;;;1,0;1,0;;;;;;;;;;1,0;;;15,0;;;;;;;;;1,0;;
dimension;;1,0;;1,0;1,0;15,0;18,0;9,0;;3,0;;;;60,0;;;36,0;2,0;2,0;7,0;;36,0;8,0;;1,0;;;6,0;1,0;;45,0;5,0;3,0;;;12,0;31,0;3,0;2,0;;43,0;42,0;8,0;14,0;44,0;5,0;2,0;15,0;;;3,0;;5,0;;19,0;34,0;18,0;;;20,0;;;;;173,0;;43,0;9,0;6,0;5,0;25,0;47,0;14,0;;3,0;;2,0;1,0;17,0;1,0;43,0;4,0;;8,0;37,0;2,0;;9,0;2,0;2,0;2,0;5,0;1,0;;;;93,0;37,0;60,0;11,0;29,0;9,0;;;17,0;12,0;;;1,0;;4,0;10,0;40,0;;;;3,0;16,0;30,0;78,0;2,0;2,0;2,0;24,0;;;43,0;;;4,0;7,0;;;9,0;8,0;;37,0;12,0;;;3,0;2,0;;;15,0;2,0;13,0;11,0;14,0;;;2,0;8,0;1,0;;;;;;;;2,0;;;2,0;;4,0;2,0;4,0;1,0;2,0;1,0;;28,0;;14,0;;;3,0;;1,0;;;8,0;;7,0;3,0;;2,0;7,0;;4,0;;1,0;1,0;3,0;22,0;;3,0;2,0;;2,0;1,0;;56,0;7,0;7,0;11,0;;5,0;1,0;1,0;4,0;;2,0;16,0;90,0;2,0;;1,0;14,0;;;2,0;;;53,0;;;22,0;;2,0;5,0;26,0;5,0;2,0;3,0;11,0;;;;18,0;1,0;;3,0;5,0;;32,0;14,0;;13,0;2,0;10,0;18,0;;;;8,0;;;;9,0;4,0;18,0;6,0;;;2,0;;8,0;;;6,0;1,0;6,0;;1,0;3,0;2,0;17,0;3,0;1,0;16,0;1,0;;;;12,0;1,0;;7,0;1,0;2,0;;;1,0;23,0;11,0;;5,0;2,0;;6,0;;;2,0;3,0;11,0;11,0;6,0;;;6,0;;;;8,0;5,0;;2,0;2,0;94,0;;16,0;;;;;;;1,0;;1,0;2,0;;8,0;;;;;6,0;;;;;;2,0;9,0;;2,0;;;;;7,0;2,0;;7,0;6,0;;3,0;;;;;3,0;1,0;;1,0;;;;26,0;9,0;11,0;;8,0;;14,0;;11,0;7,0;;2,0;;19,0;;;1,0;3,0;6,0;;1,0;1,0;;;2,0;12,0;1,0;;;1,0;2,0;;;4,0;4,0;;;;;2,0;;;;3,0;9,0;1,0;;;;1,0;;;;25,0;;;1,0;;2,0;;;;1,0;;1,0;;;;;;1,0;;2,0;;;;1,0;;;5,0;;1,0;2,0;;1,0;3,0;;1,0;2,0;;;2,0;;;1,0;;;;8,0;1,0;2,0;23,0;3,0;1,0;;;;4,0;;1,0;;;;1,0;3,0;50,0;;4,0;;;;6,0;;;9,0;;1,0;;;;;;;37,0;;3,0;4,0;;;;;;2,0;;1,0;;2,0;;;3,0;;1,0;8,0;;2,0;;;;1,0;;2,0;2,0;38,0;;;;;7,0;;;4,0;31,0;;7,0;;;;6,0;;;;;;;;;2,0;;3,0;;;;;;3,0;;;2,0;;;;;8,0;;3,0;4,0;3,0;;;;6,0;2,0;;6,0;;;;17,0;;1,0;;;;;;;1,0;;2,0;;;38,0;;;;;;;;;8,0;;;1,0;7,0;;4,0;3,0;;;;11,0;;;;;;;;;;;;;1,0;;;;;;2,0;;;;;3,0;;;;;;;1,0;;28,0;;3,0;15,0;;3,0;;;;;;;;;8,0;;;;;5,0;6,0;;19,0;;;;;;;;6,0;1,0;4,0;;;2,0;;;;3,0;;;;;;;;2,0;;2,0;2,0;;;;;27,0;;;;13,0;;;;9,0;;4,0;;;;1,0;1,0;;;;;;;;10,0;;;;;3,0;;2,0;;;;;3,0;1,0;;;;;;1,0;;;;;;1,0;;6,0;;;6,0;;;;;;1,0;;12,0;;;;;;;;9,0;;1,0;;1,0;;;23,0;;;;;3,0;;;;4,0;;;2,0;;;;;;;;;3,0;7,0;;3,0;;;;;1,0;;;1,0;;12,0;;;1,0;1,0;;2,0;;1,0;;;4,0;;;;;;1,0;;1,0;;;;;;;;1,0;;1,0;1,0;6,0;;;;9,0;;;;;;;3,0;;1,0;2,0;;;;3,0;;;4,0;;;;;4,0;3,0;;;;8,0;4,0;;;;;;;;;;;;;;1,0;;;;;;;;1,0;1,0;40,0;2,0;;;;;;;;;1,0;;4,0;1,0;;;;;;4,0;;;;;;3,0;;;;;;;;;;;;4,0;;;;;3,0;;;;;1,0;;;;;;;;;;;4,0;;;4,0;1,0;21,0;;;;;;16,0;;1,0;;;;;;;;;1,0;;;;;;;;;;;
diode;;1,0;;4,0;15,0;17,0;17,0;5,0;;;;;;8,0;;;2,0;;;;2,0;;3,0;;1,0;;;;;;17,0;3,0;;;1,0;2,0;4,0;;2,0;;10,0;55,0;;;22,0;15,0;;4,0;;;;;;;2,0;;5,0;;;8,0;1,0;;;;4,0;;47,0;5,0;1,0;;;6,0;303,0;1,0;;;1,0;1,0;3,0;;15,0;;1,0;;5,0;;;5,0;;27,0;6,0;2,0;6,0;;;;6,0;2,0;96,0;1,0;6,0;1,0;3,0;;;6,0;;1,0;;;;;1,0;;;;;11,0;;8,0;;;19,0;2,0;1,0;;22,0;;3,0;;4,0;;;20,0;;1,0;;;;;;5,0;;;3,0;1,0;7,0;9,0;1,0;;;;4,0;;;3,0;;2,0;;;;6,0;;2,0;1,0;;20,0;;2,0;1,0;;;2,0;;;1,0;2,0;313,0;;;1,0;1,0;;2,0;;6,0;;;;1,0;;;1,0;;;1,0;5,0;;;;;9,0;;;3,0;;;3,0;;5,0;;;;;;;13,0;;;7,0;3,0;;;;1,0;1,0;1,0;;;8,0;;10,0;1,0;3,0;;;6,0;15,0;;;;2,0;;;;5,0;4,0;;5,0;;;;;2,0;2,0;1,0;2,0;17,0;;;;1,0;4,0;4,0;3,0;;;8,0;;;;2,0;;1,0;;;1,0;3,0;;1,0;;;3,0;1,0;;;;;21,0;1,0;;;;2,0;;1,0;4,0;5,0;;;;;2,0;;;;;;;1,0;;;6,0;;;;3,0;;;;;;;2,0;2,0;;;;7,0;;;2,0;;;;;;;;;;;;;;;;1,0;;;;;;3,0;;3,0;;;3,0;1,0;;;;;;2,0;;2,0;;2,0;;;1,0;;4,0;;;;2,0;;38,0;2,0;16,0;;;3,0;;;;1,0;;;;;2,0;6,0;;;4,0;;;11,0;;3,0;;;1,0;3,0;;3,0;;;;5,0;4,0;1,0;;;;;;;;;;3,0;1,0;14,0;;;;;1,0;;;;;;1,0;;1,0;3,0;;;;1,0;;;3,0;;;36,0;4,0;;;;;;;1,0;;;;;;;;;3,0;;;5,0;1,0;;;;161,0;;;;;;;;1,0;;;;;;;2,0;;2,0;;;6,0;;;;;;;1,0;;;4,0;;;;;;;;;;;;;;;;;;;2,0;1,0;2,0;;;;;;;;;;;;;;1,0;;;1,0;;;6,0;;;;;;;2,0;;;9,0;;;;1,0;1,0;;;;3,0;;;;;;;;;1,0;;;1,0;;;;;;;15,0;;;;;;;;;;;;;;;;1,0;;;;;;24,0;2,0;6,0;;3,0;;;1,0;;;;;;;;2,0;1,0;;;;;;;;;;;4,0;;;2,0;;;;3,0;;;;;;;;3,0;;;;;1,0;;;2,0;;;;1,0;;;4,0;1,0;;;;1,0;19,0;;2,0;;;;;;;;;2,0;;1,0;;;;;1,0;;;;;;;;;;1,0;;;;;14,0;44,0;1,0;;;;7,0;;;;;;14,0;;;;2,0;;;;1,0;;;;;1,0;;;;2,0;;4,0;;;1,0;;;;;;;1,0;;;9,0;;;;;;;;;;;7,0;;;;;;;;;;;;3,0;;;;;;;;;;;;;;1,0;;;;2,0;13,0;;3,0;;;;;;;;4,0;;;5,0;;;;;;1,0;;2,0;;;;;;8,0;;;;;;;;;;;;;;;3,0;1,0;;;;;;;;;;;;;;2,0;2,0;;;;;;;;;;;1,0;;;7,0;;;;;;;2,0;;;;;;;;;2,0;;;;;;;;;;;;2,0;;1,0;;;;;;;;;;;;;;;;;;23,0;5,0;;2,0;2,0;;;;;;;;;;;;;;;;;;;;2,0;;;;;;;;;;;;;;;;2,0;;;;;;;;;;;;15,0;;;;;;;;;;;;;;;;;;;3,0;;;;;;;;;;;;;;;;;20,0;;
direction;;24,0;8,0;163,0;86,0;254,0;74,0;183,0;2,0;4,0;75,0;1,0;146,0;531,0;;6,0;247,0;10,0;9,0;3,0;3,0;9,0;35,0;2,0;24,0;30,0;16,0;40,0;24,0;15,0;519,0;92,0;39,0;242,0;17,0;172,0;118,0;261,0;59,0;11,0;610,0;612,0;30,0;47,0;238,0;228,0;;226,0;;42,0;28,0;38,0;472,0;30,0;126,0;24,0;148,0;70,0;7,0;141,0;1,0;;76,0;;934,0;2,0;347,0;58,0;;114,0;238,0;1289,0;469,0;27,0;6,0;66,0;20,0;35,0;3,0;32,0;349,0;3,0;20,0;1,0;481,0;368,0;;2162,0;10,0;38,0;23,0;27,0;26,0;15,0;71,0;;218,0;180,0;390,0;366,0;644,0;159,0;7,0;42,0;95,0;56,0;;13,0;1,0;12,0;33,0;127,0;226,0;20,0;;15,0;30,0;71,0;40,0;350,0;11,0;10,0;131,0;47,0;4,0;43,0;309,0;7,0;1,0;72,0;45,0;19,0;6,0;783,0;25,0;;467,0;88,0;92,0;4,0;12,0;54,0;21,0;;75,0;99,0;129,0;275,0;145,0;35,0;67,0;7,0;255,0;44,0;1,0;18,0;206,0;2,0;;1,0;19,0;124,0;16,0;8,0;52,0;1,0;50,0;70,0;29,0;88,0;86,0;34,0;118,0;;46,0;68,0;19,0;89,0;18,0;4,0;2,0;3,0;5,0;388,0;15,0;13,0;56,0;177,0;403,0;104,0;2,0;4,0;4,0;73,0;177,0;58,0;248,0;34,0;62,0;9,0;;42,0;57,0;6,0;63,0;11,0;427,0;3,0;60,0;201,0;578,0;661,0;73,0;1,0;;90,0;49,0;374,0;4,0;55,0;49,0;27,0;35,0;20,0;82,0;5,0;606,0;26,0;15,0;9,0;56,0;21,0;142,0;37,0;29,0;6,0;22,0;9,0;2,0;49,0;2,0;61,0;72,0;2,0;4,0;65,0;31,0;87,0;388,0;62,0;9,0;3,0;24,0;59,0;86,0;35,0;161,0;449,0;12,0;;38,0;37,0;24,0;219,0;81,0;5,0;;8,0;2,0;29,0;27,0;59,0;124,0;24,0;5,0;;23,0;511,0;63,0;18,0;65,0;55,0;2370,0;40,0;5,0;22,0;70,0;44,0;80,0;23,0;341,0;4,0;23,0;31,0;28,0;18,0;301,0;32,0;61,0;33,0;19,0;8,0;35,0;34,0;7,0;54,0;17,0;73,0;39,0;267,0;63,0;26,0;11,0;;66,0;2,0;57,0;54,0;9,0;36,0;63,0;236,0;549,0;104,0;;15,0;17,0;2,0;25,0;16,0;64,0;1,0;38,0;58,0;39,0;7,0;19,0;5,0;35,0;14,0;410,0;424,0;114,0;38,0;17,0;23,0;15,0;128,0;;45,0;23,0;3,0;7,0;6,0;44,0;23,0;38,0;72,0;132,0;11,0;14,0;24,0;10,0;15,0;;54,0;12,0;28,0;;9,0;34,0;2,0;86,0;128,0;173,0;31,0;15,0;54,0;14,0;9,0;257,0;66,0;7,0;11,0;60,0;260,0;52,0;54,0;2,0;1,0;3,0;8,0;11,0;108,0;170,0;18,0;12,0;51,0;102,0;30,0;1,0;73,0;3,0;16,0;47,0;213,0;2,0;15,0;198,0;70,0;7,0;562,0;;16,0;81,0;58,0;393,0;102,0;15,0;5,0;4,0;12,0;11,0;19,0;4,0;133,0;10,0;45,0;1,0;74,0;48,0;;24,0;9,0;122,0;68,0;11,0;105,0;20,0;;7,0;27,0;22,0;282,0;7,0;21,0;46,0;257,0;233,0;24,0;30,0;15,0;6,0;14,0;74,0;2,0;5,0;17,0;;11,0;35,0;1,0;5,0;5,0;3,0;1,0;21,0;4,0;3,0;128,0;22,0;18,0;22,0;6,0;38,0;23,0;14,0;6,0;2,0;;390,0;13,0;12,0;39,0;4,0;23,0;94,0;;21,0;22,0;7,0;2,0;11,0;51,0;7,0;15,0;56,0;;;36,0;19,0;2,0;5,0;17,0;71,0;539,0;8,0;3,0;;;6,0;5,0;7,0;;7,0;19,0;4,0;55,0;4,0;4,0;28,0;17,0;;15,0;19,0;;6,0;2,0;9,0;;5,0;10,0;2,0;98,0;494,0;2,0;26,0;5,0;18,0;47,0;4,0;13,0;6,0;127,0;2,0;17,0;;2,0;10,0;6,0;34,0;;18,0;1,0;1,0;13,0;2,0;2,0;4,0;;;5,0;;19,0;22,0;4,0;6,0;13,0;1,0;6,0;;13,0;;14,0;66,0;40,0;;1,0;19,0;17,0;1,0;;65,0;53,0;2,0;9,0;13,0;2,0;7,0;11,0;2,0;;;4,0;15,0;;;7,0;6,0;;4,0;;;31,0;6,0;2,0;22,0;25,0;2,0;57,0;2,0;2,0;1,0;15,0;;7,0;22,0;3,0;2,0;29,0;;;7,0;47,0;;;56,0;;4,0;;1,0;1,0;;2,0;4,0;;5,0;4,0;877,0;14,0;2,0;7,0;13,0;1,0;26,0;9,0;6,0;11,0;;;;1,0;8,0;1,0;11,0;1,0;9,0;8,0;2,0;38,0;1,0;4,0;1,0;20,0;63,0;;2,0;3,0;8,0;;42,0;;17,0;;;9,0;;13,0;177,0;3,0;6,0;;;2,0;;12,0;4,0;5,0;21,0;9,0;3,0;59,0;1,0;1,0;17,0;123,0;6,0;6,0;3,0;;;;4,0;233,0;396,0;9,0;15,0;35,0;;11,0;3,0;4,0;12,0;;10,0;32,0;;13,0;17,0;13,0;3,0;1,0;6,0;1,0;4,0;144,0;30,0;1,0;11,0;3,0;;;9,0;26,0;361,0;;6,0;58,0;102,0;36,0;115,0;6,0;28,0;11,0;1,0;9,0;27,0;5,0;6,0;12,0;31,0;100,0;12,0;5,0;2,0;4,0;2,0;25,0;1,0;4,0;24,0;37,0;;19,0;13,0;3,0;5,0;4,0;;3,0;31,0;30,0;25,0;4,0;5,0;2,0;;;20,0;3,0;14,0;;19,0;7,0;19,0;6,0;13,0;155,0;3,0;13,0;5,0;;44,0;;9,0;14,0;21,0;6,0;1,0;11,0;3,0;2,0;17,0;36,0;34,0;1,0;29,0;2,0;13,0;10,0;;;;6,0;2,0;55,0;84,0;48,0;5,0;2,0;9,0;87,0;;12,0;110,0;1,0;1,0;7,0;5,0;3,0;1,0;28,0;16,0;;3,0;6,0;;2,0;;;7,0;2,0;16,0;6,0;1,0;39,0;;;;4,0;19,0;9,0;11,0;2,0;6,0;2,0;15,0;6,0;3,0;;;15,0;;12,0;;2,0;14,0;10,0;1,0;1,0;2,0;17,0;12,0;18,0;13,0;3,0;1,0;3,0;2,0;2,0;9,0;1,0;2,0;;;3,0;;;5,0;40,0;;4,0;;;;;4,0;;18,0;2,0;;14,0;4,0;13,0;13,0;9,0;6,0;7,0;45,0;13,0;4,0;4,0;;;15,0;;3,0;1,0;2,0;112,0;;11,0;9,0;1,0;5,0;8,0;92,0;;;8,0;;5,0;8,0;17,0;3,0;52,0;10,0;6,0;;73,0;17,0;;240,0;;;4,0;9,0;1,0;2,0;1,0;1,0;30,0;1,0;;;2,0;4,0;;1,0;2,0;;;26,0;4,0;9,0;;3,0;;43,0;;;2,0;2,0;3,0;12,0;;66,0;2,0;7,0;6,0;;;;6,0;;;5,0;;2,0;2,0;2,0;4,0;3,0;9,0;;;;10,0;14,0;
discrete;;1,0;1,0;;;;7,0;10,0;;;;;;9,0;1,0;;7,0;;;3,0;2,0;;1,0;;2,0;;;2,0;1,0;;14,0;;;;;19,0;7,0;4,0;;;17,0;31,0;;2,0;6,0;1,0;;9,0;;;2,0;;6,0;;2,0;10,0;6,0;;;14,0;;;15,0;;52,0;1,0;22,0;;;;8,0;13,0;1,0;;;;;;;;10,0;;1,0;;13,0;;;1,0;5,0;;3,0;;;;;;32,0;;59,0;1,0;37,0;2,0;;;3,0;2,0;1,0;;;;;2,0;4,0;;;;2,0;4,0;;23,0;1,0;;19,0;;;1,0;8,0;;;;1,0;;;5,0;;;;;;;;;;;3,0;1,0;;6,0;13,0;;;;4,0;7,0;;;;;;;1,0;;;;;;;7,0;;;;;;;;;;;;;;;;2,0;;4,0;8,0;1,0;10,0;21,0;;2,0;;;1,0;;5,0;;;;4,0;10,0;;;;;28,0;;;;3,0;;1,0;;4,0;;5,0;;;;;;;4,0;;;24,0;;;1,0;;;;1,0;;;;;;;;;;;1,0;4,0;2,0;6,0;18,0;;;;;52,0;2,0;;27,0;13,0;;;;;;;2,0;;;1,0;;2,0;;;1,0;6,0;;;;30,0;;;;;;1,0;;;;;3,0;;;3,0;;7,0;;;12,0;;;;;1,0;;;;;2,0;;;5,0;;;1,0;;25,0;;6,0;;1,0;1,0;;9,0;;;2,0;;;2,0;;;;;;;2,0;;;;;;9,0;;2,0;;;;1,0;;;;;;;;;;;2,0;5,0;;;;;;;;;2,0;;;;;;;;;;;;;6,0;;;;;10,0;;;;9,0;;1,0;3,0;6,0;;11,0;;2,0;1,0;;;;1,0;;1,0;1,0;3,0;;11,0;;;2,0;;3,0;3,0;4,0;;;;;;;;3,0;;7,0;;3,0;;;1,0;;6,0;;3,0;1,0;;;4,0;;1,0;;1,0;13,0;10,0;;;;4,0;;;4,0;;;;;;;;;1,0;;;;;;;;;;1,0;;9,0;5,0;;;;;1,0;;;;;2,0;;;5,0;;;2,0;;;;;;;;;;;;;;6,0;;;1,0;;;9,0;;;;;;1,0;6,0;;;;;;;;;;;;2,0;;;;;;;;1,0;;;;;;;;;;;;;;;;;;2,0;;;1,0;;;;;;;;;;;;;;;;;4,0;;;1,0;;;;;;;;;;;6,0;2,0;;;;;;;;;;;;;;14,0;;2,0;;;7,0;;;;;;;;;;;2,0;1,0;;;;1,0;;;;;;;;;1,0;;;;;;;;;;;;;;;;;;;;;;;;;;;;;;;;;;;;;1,0;;;6,0;;;;2,0;;;;;;;;;;2,0;;;;;;;4,0;9,0;;1,0;;;;;;;;;;;;;;;;;2,0;;;1,0;;;;;;;;;;;;;;;;;2,0;;;;;;;;;;;2,0;;;;;;;;;;;;;;7,0;;;;;;;4,0;;;;;;;;;;;;1,0;;1,0;;;2,0;;;;;;;;;;;;;4,0;;;4,0;;;;;4,0;1,0;;;11,0;;2,0;;;;;;;;2,0;;;;;;2,0;;;;;;;4,0;;;;;;3,0;;;;;;;;;2,0;;;;;;;2,0;;;4,0;;;;;6,0;;;;;;;;;;;1,0;1,0;;;;;4,0;;;;;;;;;;;;;1,0;;;;;;;;;;;1,0;;2,0;;;;;;;;71,0;;;;;;;;;;;;;;;;;;;1,0;;;;;;;;;;;;;;;;;;;;;;;;;;;;;1,0;;;;;;;;;;;;1,0;;;;;;;;;;;;1,0;;;;;;;;;5,0;;;;;;
distance;;1,0;;116,0;67,0;230,0;105,0;89,0;3,0;11,0;61,0;7,0;21,0;722,0;5,0;3,0;161,0;3,0;12,0;19,0;;46,0;40,0;7,0;7,0;8,0;13,0;32,0;28,0;94,0;333,0;49,0;23,0;37,0;1,0;168,0;79,0;20,0;285,0;2,0;975,0;581,0;8,0;37,0;154,0;66,0;2,0;112,0;22,0;19,0;160,0;6,0;35,0;11,0;175,0;577,0;24,0;;18,0;82,0;3,0;5,0;81,0;;1021,0;4,0;184,0;79,0;2,0;17,0;113,0;1009,0;266,0;6,0;21,0;11,0;30,0;173,0;13,0;18,0;438,0;2,0;30,0;28,0;207,0;28,0;5,0;317,0;18,0;14,0;55,0;1,0;8,0;5,0;21,0;;291,0;142,0;190,0;509,0;398,0;629,0;4,0;23,0;35,0;123,0;5,0;11,0;6,0;52,0;;190,0;118,0;33,0;;5,0;26,0;84,0;141,0;449,0;25,0;1,0;89,0;73,0;;33,0;433,0;26,0;58,0;23,0;90,0;36,0;;364,0;43,0;13,0;161,0;34,0;83,0;;1,0;30,0;15,0;;51,0;43,0;70,0;54,0;71,0;29,0;1,0;35,0;50,0;12,0;6,0;6,0;;;;;1,0;23,0;1,0;4,0;1,0;15,0;31,0;30,0;29,0;47,0;22,0;51,0;2,0;301,0;5,0;101,0;2,0;9,0;9,0;1,0;4,0;44,0;;81,0;;17,0;15,0;8,0;49,0;34,0;12,0;2,0;3,0;15,0;10,0;20,0;51,0;1,0;22,0;6,0;1,0;1,0;33,0;;473,0;17,0;55,0;2,0;4,0;68,0;61,0;73,0;54,0;;;44,0;35,0;53,0;6,0;35,0;61,0;3,0;19,0;16,0;27,0;4,0;220,0;;2,0;29,0;11,0;17,0;290,0;50,0;38,0;11,0;28,0;29,0;;97,0;;17,0;;;;130,0;33,0;32,0;157,0;24,0;2,0;2,0;1,0;63,0;39,0;10,0;42,0;367,0;8,0;;5,0;23,0;3,0;273,0;22,0;1,0;2,0;5,0;7,0;7,0;13,0;18,0;11,0;;1,0;;11,0;189,0;107,0;12,0;5,0;32,0;220,0;62,0;8,0;;13,0;6,0;31,0;;64,0;10,0;;5,0;23,0;5,0;;25,0;3,0;3,0;1,0;38,0;4,0;6,0;3,0;17,0;9,0;39,0;49,0;172,0;14,0;;9,0;5,0;28,0;5,0;188,0;2,0;6,0;18,0;60,0;1023,0;24,0;26,0;7,0;16,0;8,0;;14,0;10,0;2,0;;4,0;7,0;12,0;2,0;1,0;;61,0;;7,0;41,0;4,0;5,0;10,0;4,0;29,0;163,0;5,0;3,0;;;6,0;2,0;25,0;;6,0;25,0;97,0;22,0;16,0;9,0;;;;27,0;13,0;4,0;;3,0;;3,0;351,0;200,0;123,0;13,0;2,0;98,0;28,0;12,0;226,0;63,0;19,0;8,0;74,0;179,0;29,0;104,0;2,0;7,0;19,0;2,0;23,0;365,0;23,0;85,0;2,0;80,0;73,0;22,0;;58,0;;68,0;5,0;223,0;1,0;18,0;30,0;44,0;2,0;151,0;2,0;49,0;17,0;14,0;6,0;5,0;2,0;11,0;3,0;1,0;10,0;5,0;8,0;63,0;9,0;33,0;15,0;1,0;34,0;;42,0;;63,0;;6,0;154,0;4,0;;15,0;34,0;260,0;21,0;4,0;27,0;7,0;39,0;146,0;4,0;20,0;22,0;7,0;22,0;44,0;1,0;26,0;63,0;1,0;12,0;123,0;1,0;9,0;9,0;1,0;;9,0;;13,0;2,0;16,0;29,0;17,0;34,0;;2,0;23,0;8,0;8,0;7,0;26,0;13,0;2,0;86,0;13,0;4,0;56,0;7,0;18,0;11,0;1,0;3,0;8,0;37,0;16,0;;51,0;2,0;1,0;;14,0;;;8,0;36,0;203,0;36,0;;;1,0;1,0;16,0;;1,0;6,0;6,0;;73,0;2,0;28,0;17,0;8,0;7,0;19,0;2,0;;;;3,0;2,0;1,0;20,0;7,0;17,0;203,0;5,0;10,0;;34,0;18,0;2,0;65,0;8,0;27,0;5,0;22,0;;5,0;12,0;26,0;9,0;2,0;6,0;1,0;;2,0;;;;;9,0;8,0;2,0;5,0;31,0;;5,0;5,0;18,0;4,0;;;;9,0;10,0;11,0;1,0;2,0;2,0;2,0;;2,0;14,0;2,0;22,0;2,0;2,0;3,0;7,0;7,0;;9,0;6,0;3,0;1,0;1,0;;14,0;13,0;;7,0;2,0;;130,0;16,0;4,0;27,0;12,0;1,0;16,0;;;9,0;21,0;;;30,0;2,0;;6,0;;;32,0;47,0;;;3,0;4,0;11,0;1,0;;;;4,0;;;;3,0;12,0;25,0;;3,0;2,0;6,0;9,0;10,0;5,0;1,0;;4,0;;;4,0;;34,0;4,0;17,0;1,0;22,0;30,0;;6,0;;;4,0;5,0;3,0;;1,0;;84,0;;4,0;;1,0;5,0;;8,0;275,0;7,0;7,0;2,0;1,0;7,0;1,0;8,0;5,0;1,0;3,0;7,0;;2,0;;;;27,0;2,0;38,0;3,0;;4,0;12,0;15,0;6,0;28,0;2,0;;9,0;;18,0;3,0;4,0;7,0;2,0;;19,0;;3,0;3,0;103,0;;10,0;1,0;;3,0;4,0;16,0;1,0;21,0;;1,0;1,0;5,0;10,0;110,0;1,0;11,0;1,0;64,0;16,0;68,0;4,0;2,0;4,0;;93,0;3,0;7,0;7,0;2,0;;13,0;3,0;1,0;1,0;2,0;2,0;16,0;;8,0;12,0;;1,0;;3,0;;;1,0;10,0;;72,0;2,0;51,0;1,0;;1,0;;;13,0;2,0;25,0;;;7,0;1,0;26,0;9,0;22,0;4,0;;;;14,0;;;;23,0;2,0;1,0;;1,0;;13,0;5,0;1,0;10,0;;3,0;14,0;24,0;4,0;28,0;;;1,0;5,0;27,0;10,0;20,0;;1,0;37,0;2,0;;3,0;1,0;3,0;2,0;6,0;4,0;3,0;7,0;10,0;;2,0;9,0;10,0;1,0;;12,0;1,0;1,0;9,0;5,0;;51,0;1,0;45,0;2,0;5,0;19,0;11,0;20,0;9,0;16,0;1,0;22,0;8,0;7,0;;12,0;15,0;1,0;1,0;7,0;1,0;4,0;;;11,0;5,0;15,0;35,0;10,0;45,0;19,0;;2,0;3,0;8,0;6,0;7,0;;2,0;9,0;13,0;3,0;;;14,0;;1,0;;;12,0;5,0;;;7,0;;;22,0;;9,0;2,0;;12,0;4,0;5,0;6,0;;6,0;1,0;;1,0;;1,0;;30,0;;;6,0;1,0;;;3,0;26,0;3,0;4,0;27,0;;;;8,0;37,0;7,0;1,0;;;4,0;;;25,0;;7,0;;1,0;4,0;;5,0;3,0;15,0;6,0;;;1,0;1,0;;;1,0;1,0;15,0;4,0;2,0;3,0;;2,0;34,0;14,0;12,0;1,0;21,0;13,0;;15,0;1,0;;15,0;;;13,0;;50,0;6,0;29,0;2,0;;;23,0;12,0;12,0;;;9,0;;;;7,0;;
divide;;3,0;;1,0;6,0;11,0;12,0;3,0;;;;2,0;;21,0;;;32,0;;9,0;4,0;2,0;;16,0;;;;;5,0;;2,0;34,0;3,0;;2,0;;9,0;;1,0;9,0;;30,0;16,0;;3,0;27,0;5,0;;5,0;;1,0;5,0;;;;15,0;2,0;15,0;;;10,0;;;10,0;;261,0;1,0;33,0;;1,0;1,0;3,0;15,0;43,0;1,0;;2,0;;7,0;;;30,0;1,0;1,0;4,0;12,0;;;12,0;;2,0;9,0;;;;5,0;;66,0;14,0;141,0;24,0;10,0;7,0;;1,0;8,0;14,0;;;;4,0;;15,0;98,0;;2,0;;;13,0;6,0;9,0;3,0;;28,0;8,0;1,0;24,0;12,0;;;;26,0;3,0;3,0;30,0;;;13,0;4,0;5,0;;;9,0;;;9,0;;96,0;7,0;2,0;;;20,0;4,0;;4,0;2,0;;;;;;6,0;2,0;7,0;;;;5,0;;12,0;1,0;;8,0;4,0;;3,0;;4,0;;3,0;4,0;;;3,0;;;3,0;;43,0;2,0;;;;;9,0;7,0;8,0;;6,0;;;;;;;2,0;20,0;3,0;3,0;;;4,0;;;;2,0;10,0;5,0;3,0;;6,0;;4,0;2,0;1,0;;15,0;2,0;;;;;7,0;9,0;1,0;2,0;21,0;;;;;;;;;11,0;3,0;;1,0;;;;1,0;1,0;1,0;;9,0;22,0;;;1,0;9,0;;1,0;2,0;;7,0;2,0;22,0;2,0;;;3,0;;;;;8,0;;2,0;;;22,0;2,0;;;;2,0;5,0;;9,0;18,0;;;;;15,0;;11,0;;;;;;;;;;17,0;6,0;;;1,0;;3,0;;2,0;;;;1,0;20,0;;21,0;1,0;;;2,0;;;;;;;21,0;;;;;;3,0;6,0;;;;;15,0;39,0;;6,0;;;;;6,0;;;18,0;30,0;7,0;14,0;;;;;;2,0;;;;;;8,0;2,0;12,0;;1,0;1,0;1,0;;9,0;11,0;;;5,0;6,0;5,0;7,0;3,0;5,0;;1,0;1,0;12,0;;2,0;3,0;3,0;8,0;;;5,0;;7,0;;;5,0;4,0;26,0;;;7,0;;3,0;6,0;;;;;;;7,0;;4,0;;15,0;;;;;2,0;1,0;4,0;2,0;2,0;;4,0;11,0;1,0;;5,0;3,0;8,0;1,0;1,0;1,0;;;;;1,0;12,0;;;;;;6,0;;;2,0;1,0;;;;1,0;;;2,0;;;;2,0;3,0;23,0;;9,0;;1,0;;3,0;1,0;;12,0;;1,0;3,0;;2,0;;2,0;;;;1,0;;5,0;;;;;;;3,0;12,0;2,0;;;;;;5,0;;;;;;;9,0;4,0;;;1,0;;;;1,0;;1,0;;;;;;3,0;;4,0;;;;;;;2,0;;56,0;;2,0;;3,0;;;1,0;;1,0;1,0;;;;;;;;1,0;1,0;4,0;;;;;;;5,0;;;;;2,0;;;;;11,0;;;4,0;;;4,0;2,0;;;;3,0;;;;;;1,0;11,0;;;17,0;;;;;3,0;6,0;;;4,0;2,0;;;;;;;;;7,0;4,0;1,0;;;;;;;;;1,0;;;;;;7,0;;1,0;2,0;;2,0;;7,0;;;;1,0;;4,0;;6,0;;;;2,0;3,0;;;;;;;;;;;5,0;1,0;;1,0;3,0;1,0;;;29,0;7,0;3,0;;;2,0;5,0;;;;;;;;;;2,0;;1,0;;;;;;;;;;;;;4,0;;;1,0;1,0;;;;2,0;6,0;;;;;;13,0;;;;;3,0;;3,0;;;7,0;;;;1,0;;;;2,0;;;1,0;;5,0;;5,0;;;2,0;2,0;;3,0;6,0;;;;;;;2,0;;;;3,0;;;4,0;;7,0;;;;;;1,0;;1,0;;;;;;1,0;11,0;;1,0;;;4,0;;;;5,0;3,0;;;;;1,0;5,0;;2,0;;;;2,0;;1,0;;3,0;3,0;2,0;;;;;;;;;5,0;;;;;;3,0;;4,0;;;;13,0;;;;;;;3,0;;3,0;;;;;4,0;1,0;;;1,0;;6,0;;;;1,0;;;;;;;1,0;;;;2,0;;;1,0;;;;1,0;2,0;;1,0;;5,0;;;;3,0;;2,0;2,0;;;;;;;;;;;;;;2,0;;;2,0;1,0;1,0;;;;;;;3,0;;;;;;;;;;3,0;2,0;;1,0;;;;;1,0;1,0;2,0;;;;;;;;;;18,0;;;;;;;;;4,0;;;;3,0;;;;;;2,0;1,0;;;;1,0;;;;;;;6,0;4,0;;;;;;;;;;1,0;4,0;;;;;;;;;;
drive;;5,0;;46,0;67,0;250,0;68,0;94,0;2,0;1,0;6,0;;27,0;136,0;;;20,0;1,0;;12,0;1,0;1,0;2,0;4,0;11,0;2,0;16,0;47,0;;37,0;313,0;76,0;12,0;35,0;6,0;28,0;20,0;7,0;3,0;4,0;14,0;286,0;2,0;13,0;9,0;39,0;;86,0;;;7,0;;13,0;22,0;3,0;6,0;34,0;;5,0;64,0;;;19,0;;159,0;;183,0;25,0;1,0;7,0;17,0;740,0;85,0;5,0;2,0;;4,0;4,0;7,0;11,0;75,0;;87,0;;304,0;126,0;3,0;201,0;;21,0;7,0;;20,0;;7,0;;122,0;26,0;193,0;9,0;229,0;63,0;;1,0;40,0;36,0;;1,0;1,0;;1,0;9,0;8,0;3,0;1,0;;;60,0;1,0;118,0;5,0;2,0;292,0;3,0;;10,0;146,0;;;;76,0;;;591,0;2,0;;3,0;3,0;12,0;;;3,0;;3,0;66,0;47,0;15,0;71,0;8,0;10,0;50,0;;77,0;3,0;12,0;4,0;1,0;6,0;;;2,0;94,0;6,0;5,0;1,0;;112,0;23,0;8,0;15,0;7,0;;5,0;233,0;;2,0;31,0;3,0;4,0;10,0;3,0;1,0;;59,0;;1,0;5,0;57,0;67,0;1,0;;8,0;;24,0;36,0;2,0;41,0;;4,0;2,0;;2,0;4,0;2,0;13,0;15,0;492,0;;38,0;49,0;116,0;20,0;3,0;;1,0;13,0;41,0;9,0;19,0;12,0;5,0;26,0;;;37,0;;208,0;1,0;8,0;6,0;;2,0;8,0;3,0;;;7,0;;;2,0;;21,0;43,0;10,0;3,0;5,0;10,0;13,0;26,0;20,0;1,0;;3,0;30,0;15,0;32,0;67,0;33,0;1,0;;7,0;39,0;12,0;55,0;;;5,0;;4,0;2,0;;19,0;338,0;22,0;;;9,0;11,0;1,0;6,0;1,0;25,0;226,0;9,0;1,0;13,0;23,0;10,0;150,0;;230,0;;3,0;;2,0;13,0;6,0;167,0;6,0;54,0;4,0;;;2,0;10,0;4,0;2,0;17,0;3,0;65,0;9,0;;12,0;;1,0;78,0;9,0;10,0;5,0;202,0;1,0;17,0;11,0;;3,0;;1,0;;103,0;1,0;2,0;14,0;24,0;7,0;2,0;4,0;4,0;;;;158,0;142,0;21,0;37,0;1,0;17,0;;16,0;;53,0;8,0;2,0;;;4,0;64,0;13,0;4,0;6,0;;2,0;;;1,0;;42,0;;1,0;;7,0;4,0;21,0;12,0;28,0;32,0;3,0;2,0;44,0;2,0;;347,0;9,0;9,0;1,0;28,0;31,0;3,0;6,0;1,0;;3,0;13,0;1,0;120,0;12,0;;4,0;;5,0;;;40,0;4,0;56,0;66,0;13,0;2,0;8,0;12,0;353,0;6,0;43,0;;48,0;68,0;2,0;3,0;1,0;1,0;;;9,0;1,0;6,0;3,0;39,0;8,0;20,0;;10,0;23,0;1,0;20,0;;45,0;21,0;16,0;14,0;67,0;;3,0;23,0;18,0;159,0;3,0;1,0;;3,0;3,0;5,0;;111,0;3,0;3,0;1,0;1,0;;5,0;;1,0;5,0;4,0;;3,0;;1,0;;1,0;3,0;;;;20,0;1,0;;;20,0;19,0;;7,0;239,0;;5,0;3,0;;1,0;48,0;;1,0;;2,0;;1,0;1,0;14,0;3,0;;;2,0;1,0;;;;1,0;;21,0;2,0;;;;;;3,0;2,0;1,0;5,0;17,0;25,0;;;7,0;3,0;;3,0;;;;1,0;;;280,0;1,0;3,0;11,0;11,0;;2,0;;1,0;2,0;;4,0;;34,0;;2,0;;3,0;2,0;4,0;;;1,0;;2,0;;;4,0;;;;7,0;1,0;;;;1,0;23,0;;3,0;;8,0;;21,0;5,0;;;1,0;2,0;2,0;;6,0;;2,0;4,0;;;;;;;;;;1,0;;2,0;1,0;1,0;;;;;7,0;;;13,0;13,0;16,0;3,0;;5,0;;3,0;;;;;;2,0;;2,0;;2,0;;;6,0;1,0;;;7,0;;;1,0;4,0;;3,0;;16,0;20,0;;;;16,0;2,0;;;2,0;;;25,0;;6,0;;4,0;2,0;;23,0;;;;6,0;;3,0;72,0;;1,0;12,0;1,0;;103,0;;5,0;4,0;1,0;;1,0;44,0;88,0;;2,0;;;29,0;1,0;2,0;1,0;;8,0;8,0;2,0;16,0;25,0;9,0;1,0;21,0;2,0;2,0;;9,0;14,0;;;;392,0;21,0;13,0;;;;;1,0;1,0;;2,0;4,0;51,0;2,0;25,0;3,0;;;;;3,0;6,0;17,0;2,0;;;;1,0;1,0;5,0;26,0;3,0;;112,0;33,0;;;1,0;;46,0;;;3,0;;1,0;1,0;12,0;2,0;;1,0;1,0;1,0;;20,0;2,0;1,0;4,0;;;;1,0;;2,0;;;1,0;5,0;;1,0;7,0;;5,0;1,0;1,0;4,0;2,0;4,0;2,0;15,0;9,0;;;3,0;11,0;1,0;;;;4,0;2,0;;;1,0;;10,0;2,0;1,0;1,0;19,0;8,0;2,0;;;5,0;;2,0;2,0;;;1,0;3,0;18,0;3,0;24,0;;;;;;;4,0;;;;2,0;;;9,0;1,0;;1,0;;;2,0;;;4,0;;;;;;;;;;;;9,0;;;2,0;2,0;;;2,0;;;1,0;2,0;;3,0;;2,0;;1,0;;2,0;1,0;3,0;1,0;6,0;;4,0;;2,0;135,0;;;;;;;;;;;6,0;;;;;3,0;4,0;;;;1,0;;;;2,0;3,0;4,0;6,0;;;;;;30,0;;2,0;;;53,0;;18,0;28,0;;;;7,0;;43,0;;;6,0;19,0;;;6,0;3,0;2,0;;7,0;14,0;2,0;13,0;3,0;;;;;5,0;;14,0;13,0;2,0;6,0;1,0;;1,0;;;;7,0;;;;;;;1,0;;;2,0;;1,0;;;;;;;;;;;;;;;;1,0;;3,0;2,0;;;;;;4,0;;4,0
driver;;3,0;1,0;10,0;11,0;59,0;11,0;12,0;;1,0;;;6,0;106,0;;;28,0;;2,0;;7,0;;4,0;2,0;7,0;2,0;5,0;114,0;2,0;8,0;198,0;60,0;;3,0;3,0;43,0;7,0;;2,0;;87,0;129,0;;3,0;85,0;45,0;;5,0;;1,0;5,0;3,0;1,0;10,0;20,0;;16,0;;6,0;35,0;;;3,0;;208,0;2,0;110,0;6,0;1,0;1,0;1,0;112,0;12,0;3,0;;;;12,0;10,0;7,0;55,0;;19,0;;100,0;4,0;1,0;53,0;4,0;4,0;17,0;;2,0;;;;1,0;3,0;40,0;3,0;66,0;14,0;;5,0;3,0;26,0;;4,0;;;;14,0;12,0;1,0;;;;3,0;;77,0;6,0;;99,0;3,0;;2,0;185,0;;4,0;;35,0;;;67,0;1,0;2,0;81,0;2,0;5,0;;2,0;3,0;;;3,0;26,0;9,0;7,0;6,0;2,0;;55,0;5,0;3,0;1,0;;;1,0;;;20,0;61,0;;1,0;1,0;4,0;40,0;4,0;;7,0;12,0;;2,0;32,0;6,0;1,0;25,0;;12,0;;;97,0;1,0;45,0;;14,0;;;22,0;22,0;;3,0;3,0;1,0;2,0;4,0;11,0;3,0;;1,0;;5,0;5,0;;21,0;1,0;38,0;;13,0;23,0;27,0;6,0;;;;;92,0;8,0;9,0;7,0;2,0;1,0;;;;;13,0;;;;2,0;;2,0;7,0;11,0;;;13,0;;;;2,0;;1,0;;10,0;6,0;3,0;33,0;;;;1,0;1,0;;64,0;12,0;29,0;1,0;;57,0;14,0;;309,0;;1,0;;3,0;2,0;3,0;3,0;3,0;103,0;2,0;;;10,0;24,0;1,0;5,0;;19,0;27,0;8,0;;;15,0;6,0;151,0;;44,0;1,0;;;11,0;;25,0;;;1,0;;;4,0;2,0;;;;5,0;1,0;11,0;;;7,0;5,0;1,0;2,0;2,0;;;2,0;5,0;6,0;1,0;;1,0;;;;30,0;5,0;;;;1,0;18,0;;;;;;23,0;11,0;;5,0;43,0;2,0;;;2,0;1,0;;;;;3,0;;9,0;1,0;106,0;;;;2,0;4,0;2,0;;8,0;6,0;;7,0;;;2,0;2,0;34,0;4,0;;1,0;7,0;;224,0;3,0;;1,0;4,0;14,0;8,0;11,0;;26,0;1,0;10,0;;8,0;27,0;22,0;;5,0;14,0;;2,0;31,0;12,0;10,0;17,0;19,0;;34,0;24,0;41,0;3,0;17,0;1,0;57,0;13,0;2,0;;;;;1,0;10,0;1,0;;;67,0;;5,0;4,0;;7,0;1,0;19,0;1,0;11,0;2,0;1,0;3,0;14,0;;2,0;13,0;3,0;68,0;;3,0;;;9,0;6,0;;69,0;8,0;;;1,0;;4,0;;2,0;2,0;2,0;2,0;;;;;;;1,0;4,0;3,0;1,0;9,0;;;49,0;1,0;19,0;1,0;11,0;1,0;;;14,0;;8,0;28,0;;;;4,0;;4,0;2,0;4,0;16,0;;8,0;;;2,0;;;;1,0;9,0;;;;;8,0;;2,0;;4,0;1,0;9,0;;;;;2,0;6,0;;;;;;;5,0;1,0;;8,0;4,0;4,0;;;2,0;3,0;1,0;;;9,0;6,0;;;;;6,0;16,0;;;;;4,0;;2,0;;;;12,0;3,0;;;;4,0;24,0;4,0;;;5,0;;;2,0;;1,0;4,0;;;;1,0;8,0;;1,0;;;;;;9,0;;4,0;;4,0;;;2,0;12,0;;;;;1,0;;;;4,0;3,0;;;3,0;;;;;;1,0;;;;4,0;5,0;1,0;;;;;;;13,0;;;1,0;1,0;;;1,0;;10,0;2,0;6,0;;;7,0;2,0;;;;;;;1,0;;2,0;1,0;;1,0;;;;1,0;2,0;;7,0;;;;;11,0;3,0;;;4,0;3,0;;;;10,0;;;;;10,0;;6,0;;;;1,0;;3,0;9,0;2,0;;;3,0;3,0;;;5,0;;;167,0;53,0;;;3,0;;;;;;;;2,0;;11,0;1,0;;6,0;;;2,0;;;;;4,0;;3,0;;;1,0;11,0;;;;15,0;;5,0;;;;;1,0;;;;5,0;;;;1,0;;;;;;;;;;;;1,0;;;;;4,0;;;;1,0;;;;23,0;;;5,0;;;1,0;;;1,0;;;2,0;5,0;1,0;1,0;;;;;;1,0;;;6,0;3,0;;;;;;;1,0;;;;;;;15,0;3,0;;;;1,0;;2,0;10,0;;;;;5,0;12,0;;;;1,0;;1,0;;;;;4,0;;;;;7,0;;;;;11,0;;1,0;14,0;;;;;;1,0;;;;;2,0;1,0;;;;3,0;;;;;;2,0;1,0;;1,0;;17,0;1,0;;;5,0;;;;;1,0;8,0;;;;;;1,0;;;;;;;;;2,0;;;4,0;3,0;;;4,0;1,0;;;;45,0;3,0;;4,0;;;;7,0;1,0;18,0;;2,0;1,0;;;;;;2,0;;15,0;;1,0;4,0;2,0;;;;;1,0;;;3,0;17,0;9,0;;1,0;;;;;;;;4,0;;;;;2,0;11,0;3,0;;;;;;;;;;2,0;;;2,0;3,0;4,0;;;;;;;;;;;;;;
driving;;12,0;2,0;24,0;144,0;497,0;10,0;75,0;;;10,0;;101,0;226,0;;2,0;22,0;2,0;1,0;6,0;1,0;;4,0;3,0;25,0;;11,0;4,0;;60,0;346,0;88,0;15,0;47,0;6,0;39,0;20,0;26,0;7,0;1,0;49,0;795,0;1,0;3,0;43,0;266,0;1,0;61,0;;1,0;5,0;;11,0;6,0;4,0;8,0;42,0;;9,0;80,0;1,0;;18,0;;228,0;3,0;448,0;5,0;;28,0;12,0;1391,0;58,0;6,0;;12,0;12,0;4,0;;7,0;258,0;;94,0;;491,0;131,0;1,0;184,0;;36,0;14,0;1,0;8,0;9,0;3,0;;77,0;22,0;92,0;21,0;190,0;12,0;;25,0;31,0;15,0;;;2,0;;2,0;17,0;8,0;4,0;;;2,0;9,0;1,0;163,0;2,0;;306,0;6,0;;12,0;134,0;;;4,0;110,0;;;1105,0;1,0;;10,0;1,0;9,0;;;9,0;;2,0;55,0;77,0;12,0;57,0;8,0;19,0;27,0;;75,0;7,0;;1,0;1,0;1,0;;;9,0;100,0;;8,0;6,0;2,0;88,0;36,0;3,0;37,0;31,0;;3,0;396,0;7,0;5,0;39,0;18,0;28,0;4,0;;1,0;6,0;91,0;;;21,0;162,0;76,0;5,0;;;;4,0;138,0;18,0;214,0;6,0;15,0;2,0;;15,0;6,0;1,0;7,0;3,0;440,0;2,0;7,0;50,0;162,0;28,0;4,0;;;15,0;61,0;9,0;20,0;3,0;5,0;40,0;;3,0;30,0;;249,0;5,0;12,0;8,0;4,0;;15,0;2,0;4,0;;1,0;;;5,0;14,0;21,0;11,0;9,0;1,0;8,0;12,0;21,0;117,0;7,0;;;;25,0;22,0;86,0;93,0;123,0;12,0;;9,0;23,0;1,0;130,0;5,0;1,0;1,0;3,0;3,0;;;48,0;196,0;16,0;2,0;;12,0;53,0;40,0;2,0;1,0;85,0;185,0;72,0;;1,0;27,0;40,0;149,0;3,0;579,0;1,0;;6,0;;;28,0;53,0;57,0;36,0;1,0;5,0;7,0;12,0;1,0;42,0;2,0;5,0;1,0;78,0;17,0;3,0;7,0;2,0;3,0;2,0;33,0;14,0;4,0;55,0;8,0;42,0;36,0;6,0;1,0;9,0;22,0;9,0;92,0;10,0;17,0;;;17,0;3,0;2,0;3,0;2,0;3,0;;133,0;91,0;7,0;1,0;1,0;4,0;2,0;38,0;;33,0;2,0;;;13,0;3,0;;10,0;22,0;5,0;1,0;1,0;;;1,0;;33,0;1,0;6,0;;21,0;23,0;3,0;16,0;28,0;41,0;1,0;3,0;28,0;4,0;;311,0;3,0;1,0;1,0;16,0;57,0;9,0;10,0;;;;5,0;;250,0;24,0;9,0;;5,0;30,0;;7,0;11,0;5,0;4,0;33,0;6,0;;5,0;3,0;194,0;7,0;130,0;;15,0;119,0;;7,0;;6,0;19,0;;10,0;1,0;15,0;1,0;110,0;;29,0;12,0;1,0;23,0;;34,0;;48,0;2,0;3,0;8,0;34,0;;6,0;46,0;7,0;104,0;;1,0;;;7,0;7,0;;41,0;3,0;3,0;29,0;1,0;3,0;2,0;;;3,0;4,0;6,0;;;3,0;;;4,0;;;;10,0;;;14,0;46,0;4,0;4,0;;511,0;2,0;3,0;4,0;;1,0;109,0;5,0;3,0;1,0;;;2,0;;;1,0;3,0;;;12,0;;1,0;7,0;2,0;;29,0;9,0;1,0;;;;1,0;;;9,0;;4,0;10,0;;;8,0;;;24,0;;;;;;;177,0;;;45,0;26,0;1,0;9,0;1,0;3,0;2,0;;2,0;;22,0;;;;1,0;;5,0;;;2,0;;12,0;6,0;;;;;;5,0;4,0;;1,0;;2,0;46,0;;;;1,0;;1,0;;;2,0;;;;;;6,0;3,0;6,0;;;;2,0;;;;1,0;;;;;17,0;1,0;1,0;;;2,0;3,0;;;;2,0;;;2,0;1,0;;2,0;;;;;;2,0;;;;;;2,0;8,0;;;;8,0;1,0;2,0;2,0;;1,0;16,0;;33,0;8,0;2,0;5,0;34,0;;1,0;;2,0;1,0;;;12,0;5,0;;;2,0;4,0;;2,0;;;;11,0;;6,0;20,0;;;10,0;;;53,0;;19,0;5,0;;;;5,0;11,0;;1,0;;;10,0;;;4,0;;14,0;1,0;;10,0;8,0;13,0;1,0;29,0;6,0;3,0;;;44,0;;;392,0;;2,0;18,0;1,0;;;;;;;2,0;5,0;;9,0;60,0;5,0;;4,0;2,0;3,0;4,0;1,0;2,0;;3,0;;8,0;2,0;;;30,0;;;31,0;18,0;2,0;1,0;1,0;12,0;;1,0;4,0;;;;21,0;99,0;71,0;;5,0;1,0;3,0;;5,0;1,0;;13,0;;;1,0;4,0;1,0;3,0;;;;14,0;4,0;3,0;1,0;;3,0;1,0;;4,0;;1,0;1,0;;;;;29,0;5,0;2,0;;4,0;2,0;3,0;4,0;2,0;;17,0;2,0;;;;;7,0;9,0;3,0;;;1,0;1,0;6,0;1,0;;;;10,0;15,0;;28,0;1,0;;;;11,0;;2,0;;1,0;;5,0;5,0;1,0;6,0;2,0;;;;;1,0;;;6,0;;18,0;;;6,0;1,0;;;;;1,0;4,0;;;1,0;;;1,0;;;;;3,0;;;;15,0;;1,0;1,0;7,0;10,0;16,0;2,0;;1,0;4,0;;;7,0;;;;;;;1,0;;2,0;;3,0;1,0;;;;;8,0;2,0;;5,0;;;1,0;;3,0;5,0;1,0;;1,0;1,0;;;;2,0;1,0;;;;45,0;;2,0;3,0;;;1,0;6,0;1,0;22,0;;;2,0;;;;19,0;3,0;2,0;;18,0;16,0;1,0;3,0;2,0;;;3,0;;4,0;;1,0;49,0;;3,0;;1,0;;;;;;2,0;;;;;;8,0;;;3,0;;;;;;;;;4,0;1,0;1,0;;5,0;9,0;;;;1,0;;2,0;;;;;;;35,0;;
electric;;12,0;;1,0;14,0;17,0;14,0;7,0;;;;;2,0;25,0;;;2,0;;;;5,0;;14,0;2,0;43,0;;;48,0;;;73,0;19,0;;6,0;3,0;3,0;;;;;3,0;55,0;;11,0;34,0;5,0;;76,0;;;;;7,0;3,0;57,0;5,0;11,0;;;72,0;2,0;;2,0;;216,0;1,0;41,0;1,0;2,0;1,0;;66,0;30,0;;2,0;2,0;6,0;;;1,0;22,0;;23,0;;19,0;1,0;;97,0;;;2,0;2,0;4,0;;1,0;2,0;57,0;6,0;32,0;1,0;18,0;13,0;;1,0;8,0;3,0;;;;;1,0;7,0;10,0;;;2,0;;3,0;;29,0;;;348,0;;;8,0;44,0;;;;6,0;;;43,0;2,0;;3,0;;37,0;10,0;;1,0;;;;35,0;1,0;11,0;;10,0;1,0;1,0;34,0;3,0;;87,0;;;1,0;;21,0;44,0;;110,0;2,0;;2,0;7,0;;;1,0;;2,0;19,0;;;;3,0;3,0;;7,0;;2,0;2,0;;6,0;12,0;19,0;9,0;;;;9,0;4,0;4,0;16,0;23,0;14,0;5,0;;;21,0;;1,0;1,0;;46,0;;;10,0;25,0;7,0;1,0;;;7,0;59,0;;;1,0;6,0;12,0;;52,0;7,0;1,0;46,0;6,0;2,0;3,0;;;;;4,0;;1,0;1,0;;;1,0;;;;;4,0;;1,0;6,0;1,0;;;;;12,0;132,0;12,0;33,0;2,0;;41,0;13,0;2,0;12,0;1,0;;1,0;5,0;;1,0;;12,0;29,0;5,0;;;;13,0;;9,0;;4,0;9,0;13,0;;5,0;5,0;;92,0;3,0;46,0;2,0;;2,0;;;2,0;25,0;10,0;11,0;;;;11,0;;;1,0;3,0;1,0;15,0;;;1,0;;;;3,0;10,0;;9,0;;16,0;2,0;;;;4,0;;207,0;;1,0;;4,0;;3,0;7,0;;;;4,0;3,0;5,0;1,0;;;;1,0;;;;;;;;;;1,0;2,0;28,0;;;;;;;;;2,0;;;;;1,0;2,0;5,0;1,0;1,0;;6,0;1,0;68,0;;;;;2,0;4,0;1,0;;;;1,0;3,0;;;7,0;;;9,0;;;13,0;2,0;10,0;5,0;;;;1,0;111,0;;12,0;;3,0;9,0;;;;;;;1,0;;8,0;;23,0;1,0;25,0;;;18,0;;;;;1,0;;;32,0;;1,0;25,0;;1,0;;;;;;;;12,0;;;;2,0;;;;;1,0;1,0;;6,0;;;;;1,0;;;;1,0;2,0;;;;2,0;;;6,0;;;;;;24,0;;;;;3,0;1,0;;1,0;;3,0;1,0;;1,0;;;;;;;;;;1,0;1,0;;;;3,0;14,0;2,0;2,0;;36,0;5,0;5,0;;;;6,0;;;;;9,0;;;2,0;1,0;;;;;;;;;11,0;;;;;2,0;;;;1,0;;6,0;1,0;;;;;;;;;;;;11,0;;;;;6,0;;;;;;;1,0;;;;10,0;5,0;;;;;;;;;2,0;;;;2,0;;3,0;;;;;;;;;;5,0;;4,0;;4,0;;1,0;;;;;;;3,0;;;3,0;;;;;1,0;;;1,0;;;;;;1,0;;18,0;;2,0;13,0;2,0;1,0;;;;2,0;;;;;7,0;;1,0;;;;2,0;;1,0;1,0;;;;3,0;3,0;13,0;4,0;1,0;;;;;;2,0;;;;;7,0;;;;;1,0;1,0;3,0;;;;;68,0;;3,0;;;2,0;;;31,0;39,0;;10,0;;;3,0;;;;;5,0;;;2,0;3,0;;;;;;1,0;;;1,0;;;;9,0;;2,0;2,0;;;8,0;;1,0;1,0;;;1,0;2,0;2,0;;;;;1,0;2,0;;;;;;;4,0;;13,0;;;;;;2,0;;;1,0;3,0;3,0;1,0;;;;;;;;;;1,0;;;;2,0;2,0;11,0;5,0;3,0;7,0;;18,0;;;68,0;;;2,0;14,0;;1,0;2,0;4,0;;;;;;7,0;;;2,0;8,0;;10,0;1,0;;;;;;;;;;;;1,0;;10,0;;1,0;;2,0;;;;;;;;;;;8,0;;;;;;;;;;;;;2,0;;;;1,0;;9,0;;;;;;;1,0;2,0;;;;;;1,0;3,0;;;;;;;;;;;;;;;;1,0;;;;;;;;;;2,0;;;1,0;;;;;;;8,0;;;;;2,0;1,0;;;;;;2,0;;;2,0;;9,0;;;2,0;;;;;15,0;;;2,0;1,0;;;5,0;;;;;;;;;;3,0;;;;;1,0;;;;;;;;;;12,0;;;3,0;;3,0;;;;;;;;;;;;;5,0;;;;;;;;
elongate;;4,0;;1,0;1,0;11,0;2,0;19,0;;;;4,0;;33,0;;;3,0;;22,0;;;;;2,0;2,0;;;1,0;;;24,0;3,0;;;;;24,0;;;;2,0;28,0;1,0;;3,0;35,0;;15,0;;;;;56,0;2,0;;;13,0;;;;;;;;9,0;;55,0;;;1,0;6,0;12,0;14,0;;;;;;;;9,0;;;;3,0;1,0;;5,0;;;;;3,0;;;;;4,0;17,0;7,0;35,0;;;;;;;;;;;;;;;;;2,0;;1,0;;;;;;;37,0;;;;;;1,0;;;;17,0;;1,0;;;6,0;;;73,0;;6,0;7,0;;13,0;1,0;;29,0;3,0;;;;;;;6,0;21,0;;;;;36,0;14,0;;;;;;9,0;2,0;19,0;;;3,0;;;;;2,0;7,0;;;;5,0;;;1,0;;3,0;2,0;26,0;31,0;;17,0;3,0;;3,0;;;;;175,0;2,0;13,0;33,0;3,0;;;;2,0;9,0;;21,0;;7,0;1,0;;;;30,0;;79,0;;;;1,0;;;;2,0;;;;5,0;;;3,0;6,0;;;1,0;2,0;18,0;15,0;1,0;40,0;;;6,0;;;22,0;31,0;1,0;;;;;14,0;17,0;;;;2,0;1,0;;;1,0;2,0;20,0;;1,0;2,0;9,0;3,0;3,0;;28,0;3,0;;4,0;4,0;1,0;1,0;;;;6,0;15,0;2,0;10,0;2,0;;;18,0;1,0;;34,0;;;;;15,0;;;2,0;;7,0;;;;8,0;16,0;;13,0;2,0;5,0;9,0;;;8,0;;2,0;;;1,0;8,0;16,0;2,0;2,0;;;;1,0;1,0;9,0;1,0;;2,0;;9,0;6,0;15,0;;2,0;;13,0;;;4,0;7,0;;1,0;1,0;;;;;1,0;;5,0;;;;;;1,0;;;;;;;;;10,0;;;;;;;;;;;;;;;;;;;;;;;;;7,0;;;6,0;2,0;1,0;5,0;;2,0;;;2,0;;;;;;1,0;;;17,0;;;;;;;;;;;;2,0;;;;;;;;;;;3,0;;;;1,0;6,0;3,0;1,0;;14,0;;1,0;;4,0;;1,0;;;;;;;;;;3,0;2,0;2,0;;;;;;;;;;;;;;;;;;;3,0;;;;;;;;;;;5,0;9,0;;;;;;1,0;;;1,0;;9,0;;;;1,0;1,0;;;;5,0;;;;2,0;;6,0;1,0;1,0;;;;;2,0;;;;18,0;;;;;;;;;;;;;;;;;;;1,0;;;;;;;;;;;;14,0;;;;;;1,0;;;9,0;;5,0;9,0;;;;;;;;;;;;;;;;;8,0;;;;;;;2,0;;;;;1,0;;;;;;;;;;;;;;;;;;;;;;2,0;6,0;;5,0;2,0;;2,0;;;;3,0;;5,0;;;;;1,0;;;;;;;;;;2,0;;;;;;3,0;;;;;;;6,0;;;;;;;1,0;;;;1,0;;;5,0;;;;5,0;;1,0;;;1,0;;;21,0;2,0;;7,0;8,0;;;;;2,0;;;3,0;;;;;;;;;;1,0;5,0;1,0;;;2,0;;;;6,0;;2,0;7,0;;;;;1,0;;3,0;;;;;;2,0;;1,0;;1,0;4,0;;;5,0;2,0;3,0;1,0;1,0;2,0;1,0;;;;;2,0;;;11,0;;;;1,0;;;;4,0;;;;;;;3,0;;;;;;;;;;;;;;;;;;;;;;;;;;;;;;;;;;;;;2,0;;;;;48,0;;;;;;;;1,0;;;;1,0;;;;;;;;;;;;;;;;;;;;9,0;;;;;;;1,0;;;;;;;;;;;1,0;1,0;;;;;;;;;;;;;;;;;;;;;;;;;;;;6,0;;;;;;;;;;;;;;;;;;;;;;1,0;1,0;;2,0;;;;;;;5,0;;;;;1,0;6,0;;;;;;;;;;;4,0;;;;;;;;;;;;;;;;;;;1,0;;;;;;;;;;;;;;;;;;;;;;;
emit;;1,0;;37,0;48,0;38,0;52,0;16,0;;;;12,0;4,0;22,0;1,0;1,0;21,0;;3,0;3,0;1,0;3,0;40,0;;1,0;;;41,0;2,0;2,0;200,0;17,0;;2,0;2,0;7,0;10,0;3,0;22,0;10,0;25,0;313,0;;1,0;47,0;41,0;;144,0;;;;5,0;6,0;8,0;21,0;4,0;26,0;;34,0;32,0;;3,0;8,0;;50,0;1,0;130,0;2,0;2,0;4,0;8,0;53,0;2023,0;;1,0;;5,0;2,0;;;76,0;1,0;4,0;;53,0;15,0;1,0;101,0;1,0;1,0;1,0;4,0;39,0;1,0;11,0;;22,0;11,0;179,0;26,0;62,0;16,0;;1,0;8,0;8,0;;;;;;3,0;42,0;;;3,0;;46,0;21,0;35,0;29,0;2,0;77,0;;11,0;1,0;92,0;;;1,0;37,0;8,0;;273,0;3,0;;8,0;;;1,0;;8,0;;1,0;11,0;2,0;24,0;38,0;19,0;3,0;;20,0;7,0;;;4,0;;;;;1,0;8,0;;3,0;;;28,0;4,0;3,0;6,0;12,0;4,0;11,0;89,0;;8,0;3,0;;3,0;1,0;33,0;;7,0;23,0;;8,0;18,0;;6,0;16,0;11,0;;5,0;3,0;1,0;3,0;26,0;24,0;;6,0;;18,0;;;24,0;1,0;31,0;;17,0;13,0;5,0;2,0;;;1,0;4,0;7,0;4,0;1,0;16,0;67,0;17,0;;3,0;12,0;1,0;54,0;1,0;2,0;11,0;;122,0;10,0;3,0;2,0;;49,0;10,0;1,0;1,0;;4,0;10,0;;;2,0;4,0;6,0;31,0;;;;;3,0;6,0;1,0;8,0;132,0;2,0;95,0;3,0;36,0;2,0;17,0;6,0;;122,0;85,0;;12,0;;;;3,0;1,0;;17,0;12,0;;;;1,0;16,0;4,0;;;1,0;11,0;5,0;;;;;;;3,0;9,0;;;;;;2,0;4,0;;4,0;;4,0;;18,0;2,0;4,0;13,0;;1,0;;6,0;;;1,0;3,0;54,0;2,0;2,0;11,0;;;;23,0;;;1,0;;;1,0;3,0;;;;;;2,0;;;;;1,0;1,0;;;;;;4,0;3,0;9,0;8,0;2,0;2,0;3,0;;;;1,0;2,0;;2,0;4,0;;1,0;;;1,0;1,0;10,0;6,0;3,0;;;6,0;57,0;;5,0;;1,0;97,0;2,0;1,0;;4,0;;;;4,0;3,0;2,0;;4,0;10,0;;;1,0;2,0;4,0;;5,0;1,0;5,0;1,0;6,0;3,0;1,0;;10,0;10,0;;;3,0;;;;1,0;5,0;7,0;;72,0;5,0;36,0;1,0;;22,0;;13,0;15,0;;;2,0;15,0;3,0;6,0;13,0;10,0;6,0;;;2,0;;3,0;10,0;;;8,0;43,0;;;;1,0;2,0;;4,0;1,0;2,0;;;;3,0;;;3,0;;;14,0;5,0;11,0;;;52,0;;;4,0;4,0;;;6,0;11,0;;8,0;;3,0;;;;4,0;18,0;5,0;7,0;;;;;;;;3,0;;5,0;4,0;1,0;;;4,0;;;;;2,0;;;;;;5,0;6,0;1,0;3,0;;2,0;2,0;3,0;3,0;;;;6,0;;;;;1,0;;;3,0;4,0;10,0;1,0;17,0;;11,0;;;2,0;;;;;;;9,0;;;;6,0;7,0;;;;17,0;1,0;;;;;;;3,0;;1,0;3,0;;45,0;1,0;;99,0;2,0;;23,0;;;4,0;;;;3,0;5,0;;;2,0;9,0;;;;1,0;;3,0;1,0;;;64,0;;2,0;9,0;2,0;;;;;;3,0;;;;;30,0;2,0;;;;;;;;;;;11,0;;;;;6,0;;;;;9,0;7,0;;;;5,0;;;;;1,0;1,0;;1,0;3,0;1,0;5,0;3,0;4,0;;3,0;;;;;1,0;339,0;;;1,0;;23,0;17,0;3,0;13,0;;;;1,0;1,0;2,0;8,0;1,0;;;;;;2,0;1,0;;2,0;1,0;;5,0;;313,0;;4,0;3,0;18,0;;;8,0;;;;;9,0;;1,0;162,0;;1,0;;2,0;;;;1,0;;;;;51,0;;;;1,0;;14,0;;;2,0;7,0;;8,0;;;;4,0;4,0;;31,0;2,0;1,0;;;;1,0;;;;;7,0;4,0;;3,0;;;;;;2,0;;;2,0;;6,0;;;;10,0;;4,0;;;;;;24,0;;2,0;1,0;;;;;2,0;;;;2,0;;;12,0;;;2,0;3,0;;;;;18,0;1,0;;;2,0;1,0;;;45,0;;;;3,0;22,0;;;;;;1,0;;;;;;2,0;;;;3,0;;;;;;;;1,0;8,0;;;;2,0;;;1,0;;;4,0;;2,0;;;54,0;3,0;;;13,0;;;13,0;9,0;1,0;;;;;4,0;;5,0;;2,0;;;;;;;;;;;;;1,0;;1,0;;;;;1,0;;;;;;;;1,0;;50,0;58,0;;49,0;9,0;1,0;;;2,0;7,0;;;;;;;;;;20,0;;;;;2,0;;;;;;;;;;;;;;1,0;;;;;;3,0;;;;2,0;;;;30,0;2,0;;;;;;;;2,0;;;4,0;;;;;8,0;10,0;6,0;;;;;;2,0;6,0;;;;;;;;;1,0;;;
enable;;15,0;;12,0;2,0;25,0;3,0;26,0;;;6,0;1,0;2,0;57,0;1,0;2,0;86,0;1,0;4,0;4,0;2,0;;5,0;15,0;66,0;;4,0;11,0;15,0;9,0;133,0;10,0;3,0;1,0;;72,0;3,0;8,0;8,0;2,0;21,0;259,0;11,0;17,0;41,0;3,0;;34,0;2,0;1,0;4,0;;19,0;8,0;8,0;7,0;12,0;;1,0;21,0;;1,0;15,0;6,0;168,0;;34,0;1,0;;2,0;17,0;95,0;38,0;1,0;;;6,0;2,0;2,0;9,0;69,0;;49,0;;78,0;8,0;;27,0;2,0;;12,0;3,0;5,0;5,0;13,0;;4,0;7,0;40,0;28,0;50,0;12,0;1,0;26,0;17,0;57,0;;20,0;1,0;;1,0;3,0;4,0;;8,0;;;6,0;1,0;66,0;12,0;;81,0;3,0;1,0;10,0;80,0;;3,0;;25,0;1,0;;39,0;;;32,0;3,0;26,0;2,0;;2,0;;;8,0;3,0;8,0;16,0;10,0;11,0;;5,0;21,0;2,0;3,0;2,0;;;;;2,0;8,0;4,0;;;;17,0;9,0;;5,0;1,0;;3,0;18,0;8,0;5,0;3,0;3,0;;;;;;1,0;;;4,0;10,0;7,0;5,0;;5,0;12,0;12,0;9,0;3,0;55,0;;;;;;8,0;9,0;2,0;12,0;53,0;;16,0;52,0;21,0;32,0;13,0;;3,0;;10,0;;;2,0;1,0;;2,0;;3,0;1,0;46,0;7,0;;2,0;;4,0;16,0;1,0;2,0;;;1,0;2,0;;;1,0;23,0;4,0;;12,0;5,0;2,0;15,0;5,0;3,0;;2,0;39,0;;9,0;18,0;28,0;;;4,0;11,0;1,0;23,0;6,0;5,0;;;;2,0;1,0;5,0;8,0;1,0;;3,0;1,0;13,0;;8,0;16,0;10,0;2,0;13,0;;;12,0;5,0;23,0;;2,0;19,0;;;3,0;6,0;9,0;12,0;1,0;1,0;24,0;;;4,0;;4,0;19,0;3,0;2,0;32,0;;4,0;1,0;4,0;4,0;1,0;4,0;14,0;5,0;29,0;41,0;12,0;2,0;1,0;;1,0;;;10,0;;;;;2,0;37,0;;13,0;;4,0;;11,0;21,0;2,0;4,0;;20,0;11,0;9,0;;4,0;4,0;;4,0;3,0;12,0;;;1,0;85,0;45,0;2,0;14,0;2,0;26,0;9,0;31,0;3,0;4,0;;20,0;11,0;2,0;2,0;4,0;3,0;2,0;2,0;10,0;;;108,0;1,0;;4,0;4,0;16,0;12,0;7,0;13,0;15,0;;22,0;;28,0;4,0;46,0;;7,0;5,0;1,0;;61,0;1,0;11,0;2,0;13,0;;8,0;14,0;13,0;2,0;11,0;1,0;14,0;43,0;12,0;;;;;;1,0;5,0;3,0;12,0;15,0;;20,0;6,0;;2,0;1,0;17,0;4,0;5,0;;6,0;;14,0;21,0;3,0;31,0;2,0;12,0;;2,0;1,0;;143,0;;;2,0;2,0;4,0;15,0;2,0;1,0;18,0;;1,0;39,0;;;5,0;;5,0;6,0;;6,0;;1,0;;29,0;37,0;;3,0;14,0;6,0;7,0;;4,0;;15,0;13,0;1,0;1,0;44,0;3,0;12,0;4,0;1,0;;3,0;4,0;6,0;5,0;7,0;2,0;17,0;15,0;3,0;10,0;4,0;6,0;1,0;11,0;1,0;16,0;1,0;;15,0;;3,0;;;1,0;4,0;4,0;;1,0;7,0;5,0;1,0;;;;1,0;1,0;;;;3,0;;;9,0;1,0;;13,0;1,0;2,0;2,0;3,0;;6,0;2,0;7,0;;8,0;;2,0;;6,0;3,0;2,0;6,0;19,0;;;;;4,0;8,0;10,0;2,0;2,0;;;3,0;14,0;2,0;1,0;;;2,0;4,0;9,0;1,0;2,0;2,0;1,0;;;12,0;;4,0;1,0;4,0;3,0;23,0;1,0;8,0;1,0;2,0;;;4,0;;21,0;;5,0;2,0;;;22,0;4,0;2,0;6,0;2,0;;1,0;5,0;;;2,0;;9,0;1,0;2,0;1,0;;2,0;1,0;3,0;4,0;;;;;;;5,0;;2,0;11,0;;1,0;;;5,0;1,0;7,0;;;5,0;;1,0;;2,0;3,0;;2,0;6,0;1,0;1,0;;6,0;1,0;3,0;1,0;1,0;;4,0;1,0;9,0;6,0;;1,0;1,0;;5,0;9,0;2,0;3,0;1,0;;;2,0;;8,0;;;8,0;3,0;30,0;1,0;4,0;1,0;;;;;4,0;4,0;3,0;6,0;6,0;;;;5,0;;;;4,0;28,0;3,0;1,0;2,0;;;;;;;1,0;3,0;;4,0;4,0;9,0;8,0;;;3,0;;;5,0;;9,0;6,0;;4,0;1,0;;9,0;1,0;;1,0;4,0;1,0;6,0;2,0;1,0;6,0;1,0;1,0;2,0;1,0;1,0;3,0;;;;;;;;4,0;;1,0;1,0;;1,0;;;;;;;;;2,0;7,0;;;;1,0;;5,0;2,0;;;;7,0;;;;1,0;;;;;;;;;;;16,0;;1,0;4,0;;11,0;;;;4,0;1,0;;;;;;;;;1,0;;;1,0;1,0;;1,0;1,0;;1,0;;1,0;;;;6,0;;4,0;;;1,0;;2,0;;1,0;5,0;;;1,0;;;2,0;;1,0;;;2,0;;;1,0;;1,0;1,0;3,0;;1,0;2,0;;;;9,0;;;;;;;2,0;2,0;;1,0;;;2,0;1,0;;;;;8,0;2,0;;;2,0;1,0;;;2,0;;8,0;;5,0;2,0;;2,0;7,0;;;2,0;;1,0;;;1,0;;1,0;;;5,0;4,0;;2,0;2,0;10,0;;2,0;2,0;4,0;;2,0;2,0;2,0;;;;1,0;;2,0;;;1,0;;6,0;3,0;;;;;;;;;7,0;1,0;;;;;;;4,0;;;2,0;1,0;;;;;;2,0;2,0;;2,0;1,0;;;;;;;;;1,0;;;1,0;;;;;1,0;;;;;;;;;1,0;;
enclosure;;2,0;;;1,0;11,0;1,0;32,0;;;3,0;;2,0;22,0;;;4,0;;23,0;;;;;3,0;7,0;;;16,0;;;30,0;;;1,0;;;38,0;3,0;1,0;2,0;;42,0;;3,0;;19,0;;15,0;;;;;57,0;11,0;2,0;1,0;35,0;;;;;;;8,0;25,0;2,0;36,0;;;;;24,0;25,0;;;;14,0;;;2,0;34,0;;;;34,0;1,0;6,0;6,0;;;1,0;20,0;;1,0;;;;;23,0;;55,0;;;;;5,0;;;;;;;;;8,0;;;1,0;;32,0;;;;7,0;;2,0;55,0;;;1,0;;;;9,0;;;2,0;;;;;10,0;;;7,0;;8,0;8,0;12,0;34,0;1,0;2,0;17,0;15,0;;3,0;1,0;;;1,0;3,0;39,0;;;;;38,0;58,0;;2,0;4,0;;5,0;6,0;14,0;6,0;;2,0;1,0;;;;1,0;14,0;2,0;;;5,0;4,0;24,0;;;3,0;4,0;2,0;3,0;66,0;;2,0;3,0;;9,0;;;;;14,0;1,0;;79,0;15,0;5,0;;;3,0;18,0;3,0;3,0;3,0;4,0;;;;;3,0;;103,0;;3,0;3,0;4,0;9,0;3,0;;9,0;;4,0;;4,0;;;;6,0;5,0;26,0;;2,0;9,0;56,0;8,0;2,0;2,0;;29,0;29,0;5,0;30,0;29,0;6,0;;4,0;1,0;2,0;1,0;14,0;1,0;;;;3,0;;1,0;13,0;5,0;;;3,0;;2,0;9,0;17,0;;16,0;5,0;;;;10,0;2,0;;;10,0;6,0;3,0;2,0;1,0;;;2,0;14,0;12,0;12,0;5,0;;;13,0;2,0;18,0;;19,0;;;9,0;1,0;;;18,0;19,0;;8,0;7,0;4,0;3,0;;2,0;3,0;;;14,0;;;3,0;;11,0;;;1,0;;;;6,0;6,0;8,0;6,0;;21,0;;9,0;;4,0;1,0;1,0;;;2,0;;1,0;1,0;12,0;14,0;;;;;;;1,0;;;;3,0;;;;;;;;;;15,0;;;;;7,0;;;;;;;;1,0;;;;;;;;4,0;;;3,0;;;6,0;;15,0;1,0;2,0;;2,0;2,0;;;;;;;;1,0;;;12,0;9,0;;;;2,0;;;;;;6,0;;;;;;5,0;5,0;;;;;6,0;;;;3,0;6,0;2,0;8,0;;;;;3,0;3,0;;1,0;;;;;1,0;;2,0;4,0;;27,0;12,0;;;;1,0;4,0;1,0;;1,0;1,0;;5,0;1,0;;7,0;;;1,0;;;6,0;6,0;;;;1,0;;;2,0;;;2,0;;;1,0;;2,0;;1,0;;;;;11,0;;5,0;;1,0;5,0;;;;;3,0;12,0;;4,0;;;3,0;;;;;;;;1,0;;41,0;;3,0;;;3,0;;;4,0;;;;;;;1,0;;;;3,0;20,0;;;;;2,0;;;;;;5,0;2,0;;1,0;5,0;5,0;;2,0;;11,0;4,0;6,0;3,0;;;;;;;;13,0;;;;;;;;;1,0;;;;2,0;;;;;;2,0;5,0;9,0;;;;;;;;;;;2,0;;;;4,0;;;;;;;;;;8,0;;8,0;8,0;;;;37,0;;4,0;;;;;;5,0;;;;;;;;;4,0;;;;;1,0;8,0;2,0;;;;1,0;;;3,0;;;4,0;3,0;;2,0;;;;;5,0;;8,0;;;1,0;1,0;;8,0;;1,0;1,0;;1,0;;;5,0;11,0;18,0;;;;6,0;6,0;;3,0;4,0;;2,0;;;;;12,0;;;1,0;10,0;;;;;;;;8,0;;2,0;1,0;;;;1,0;;;;;;8,0;;;3,0;;;;;1,0;;;53,0;;;;3,0;3,0;2,0;;1,0;;;1,0;;;;4,0;5,0;;;2,0;18,0;;;;;;3,0;;;;;;;;;1,0;1,0;1,0;;;;;;;;;;;;;;;;;;;;;;;;;;;;;;;;3,0;;;;;;;;;2,0;;;;;1,0;;;;;;;;;;;;;;;;;;;;3,0;1,0;;;;;1,0;;;;;;;;;;;;1,0;;;;1,0;;;;;;;;;;;;;;;;;;;;;;;1,0;;1,0;;;;2,0;9,0;;1,0;6,0;4,0;;;;;;;;;;;;;;;;;;;;;;;;;;5,0;;;5,0;;;;;;1,0;4,0;;;;;;;15,0;;;;;;;;;;;;;;;;;;;;;;;;;;;;;;;;;;;;;;;
engage;;33,0;;8,0;;24,0;;70,0;;;5,0;1,0;17,0;63,0;;;6,0;;23,0;;;1,0;;;3,0;;;11,0;;;132,0;;;;;4,0;9,0;3,0;;;1,0;65,0;15,0;3,0;8,0;30,0;;76,0;;;;;15,0;4,0;4,0;4,0;38,0;;;2,0;;;;1,0;7,0;1,0;76,0;1,0;;14,0;1,0;115,0;6,0;2,0;;;4,0;;;;22,0;;;;59,0;27,0;;21,0;;5,0;;3,0;5,0;;2,0;;1,0;3,0;53,0;32,0;144,0;13,0;;;4,0;4,0;;;;;1,0;1,0;5,0;;;;;25,0;;7,0;1,0;1,0;5,0;12,0;;;35,0;;;;;;;28,0;1,0;;;1,0;;;1,0;12,0;;;20,0;11,0;7,0;16,0;6,0;37,0;19,0;10,0;112,0;15,0;;;;3,0;;;6,0;13,0;;;;;38,0;27,0;;;;;1,0;33,0;3,0;28,0;11,0;;1,0;;;1,0;7,0;25,0;19,0;;12,0;12,0;15,0;49,0;;5,0;;5,0;13,0;44,0;112,0;;36,0;3,0;;4,0;3,0;3,0;1,0;;269,0;5,0;14,0;94,0;29,0;10,0;;;5,0;36,0;1,0;10,0;;5,0;;;;;71,0;;282,0;1,0;5,0;1,0;10,0;;;;18,0;;;;22,0;;;50,0;19,0;15,0;10,0;;2,0;17,0;48,0;17,0;41,0;;1,0;69,0;2,0;;68,0;176,0;6,0;;;1,0;;8,0;18,0;;;;1,0;5,0;;;11,0;65,0;19,0;;21,0;10,0;3,0;17,0;18,0;3,0;33,0;18,0;;5,0;;3,0;16,0;2,0;1,0;5,0;2,0;13,0;5,0;22,0;3,0;1,0;;;4,0;30,0;4,0;;;31,0;4,0;7,0;;6,0;1,0;1,0;5,0;12,0;7,0;13,0;10,0;77,0;2,0;53,0;8,0;4,0;2,0;7,0;5,0;;;12,0;3,0;2,0;21,0;18,0;24,0;21,0;3,0;;13,0;4,0;10,0;2,0;43,0;36,0;43,0;36,0;1,0;28,0;6,0;10,0;;52,0;4,0;24,0;;;6,0;12,0;4,0;18,0;3,0;;;;;3,0;;12,0;;;;1,0;39,0;4,0;;10,0;1,0;;;;;;7,0;;;;;6,0;;2,0;;;;;;10,0;1,0;;;;2,0;;;1,0;1,0;;;5,0;;1,0;5,0;15,0;6,0;3,0;;3,0;25,0;5,0;1,0;1,0;;;;;;;;23,0;4,0;10,0;;;1,0;;;;;4,0;;;20,0;;;26,0;;2,0;;;;;22,0;;;;4,0;2,0;13,0;1,0;;1,0;4,0;;;;;;;;;;;;;3,0;1,0;14,0;14,0;16,0;;3,0;;1,0;12,0;;1,0;2,0;;7,0;2,0;;2,0;;;;1,0;6,0;3,0;;;;;3,0;3,0;;;;;;6,0;2,0;;;;;7,0;2,0;;9,0;;13,0;;;14,0;68,0;4,0;;;;14,0;;2,0;2,0;93,0;;1,0;27,0;2,0;;;1,0;5,0;1,0;;;3,0;38,0;;;1,0;;1,0;;;4,0;2,0;2,0;;;;;5,0;;;;1,0;17,0;;;;;;;3,0;2,0;;2,0;5,0;6,0;;;4,0;;;2,0;;1,0;14,0;26,0;58,0;;;;;;;;1,0;;2,0;;;;;;2,0;17,0;;;;;;;;8,0;;8,0;1,0;2,0;;;;21,0;;;;1,0;;;;;;;3,0;;;8,0;;;;4,0;1,0;;2,0;;;10,0;;2,0;;;;1,0;;;;;;;;;;;;;;;28,0;;;7,0;10,0;;2,0;4,0;15,0;;;;;;8,0;;;1,0;;3,0;1,0;2,0;;;2,0;;;35,0;3,0;3,0;3,0;24,0;1,0;3,0;;10,0;;;;54,0;36,0;18,0;60,0;3,0;;;;10,0;5,0;;1,0;1,0;;;8,0;;;1,0;;;;1,0;8,0;;;;;;;1,0;20,0;;;42,0;1,0;1,0;;5,0;5,0;107,0;2,0;1,0;;;;;;;;1,0;;11,0;1,0;;5,0;5,0;13,0;2,0;11,0;1,0;16,0;;1,0;;;13,0;;1,0;9,0;3,0;1,0;;;1,0;14,0;16,0;;;29,0;;6,0;;;;;;;;;1,0;;6,0;;8,0;;;;;;2,0;;;;;3,0;;;;;;;;;;;;;;;;;;;;;;;;;;;;2,0;;;;;1,0;;;;;;;;1,0;;;;;;;;;1,0;;;2,0;;;;;;3,0;;;;;;;;;;;;;18,0;;;;;;;;;;;1,0;;;;;6,0;;;;;;;;;;2,0;;2,0;;;;;1,0;7,0;1,0;1,0;1,0;;2,0;;;1,0;;;;1,0;;;;;1,0;1,0;;;;2,0;;;1,0;4,0;;;;2,0;;;;;1,0;;;;8,0;;4,0;;;;;19,0;;;;;;;;;;;;3,0;;;;;;;;;;;;;;2,0;;;;2,0;1,0;;1,0;;;;;;
engagement;;1,0;1,0;1,0;1,0;4,0;1,0;24,0;;;9,0;;2,0;30,0;;;;;5,0;;;;;;;;;;;4,0;39,0;;;;;;24,0;2,0;;;7,0;37,0;9,0;;10,0;10,0;;14,0;;;;;24,0;3,0;;4,0;17,0;;;;;;;;3,0;;46,0;2,0;;1,0;1,0;13,0;4,0;;;;1,0;;;;6,0;;;3,0;33,0;;;3,0;;4,0;;4,0;;;1,0;;;6,0;29,0;3,0;60,0;8,0;;;2,0;;;;;;;;;;8,0;;3,0;4,0;;2,0;;;;;;;12,0;;;;3,0;;;12,0;;;7,0;;;;;;;;;4,0;;6,0;5,0;3,0;14,0;3,0;16,0;10,0;;;2,0;;;;;4,0;;;;;11,0;4,0;1,0;1,0;;;1,0;15,0;;6,0;10,0;;1,0;;;;;12,0;6,0;;1,0;6,0;2,0;7,0;;10,0;;3,0;7,0;21,0;18,0;;15,0;4,0;;;3,0;3,0;;;124,0;;1,0;51,0;;2,0;;;7,0;5,0;;;2,0;;;;;;10,0;;259,0;;2,0;;;;2,0;1,0;3,0;;;;;5,0;;10,0;14,0;;;;;5,0;18,0;16,0;17,0;5,0;;25,0;;;12,0;67,0;;;;8,0;3,0;4,0;6,0;;;;1,0;;;;4,0;17,0;1,0;;;4,0;;9,0;5,0;;9,0;2,0;;;1,0;1,0;2,0;;;11,0;;;2,0;13,0;;;;60,0;4,0;;1,0;;;13,0;4,0;1,0;;1,0;2,0;;;6,0;;3,0;6,0;52,0;;116,0;;1,0;;;;;;;;;11,0;10,0;6,0;3,0;2,0;;12,0;;5,0;2,0;4,0;10,0;14,0;16,0;7,0;7,0;;6,0;;1,0;;10,0;;;;3,0;3,0;8,0;14,0;;;;;2,0;;15,0;;;;;7,0;1,0;;2,0;3,0;;;;;;;;;;1,0;;;;;;;;;11,0;;;;;1,0;;;;;;4,0;;;;6,0;2,0;2,0;4,0;;;9,0;2,0;;;;;;;2,0;1,0;;13,0;;1,0;;;;;;;;1,0;;;3,0;;;;;;;;;;33,0;;;;;4,0;3,0;;;;;;6,0;;;;;;;;;;8,0;8,0;;36,0;2,0;;;;;;2,0;;;1,0;;23,0;;;;;3,0;;1,0;3,0;;;;;;;;5,0;;;;;2,0;;;;;;;;;;;1,0;;;8,0;14,0;;;;;11,0;;;;6,0;;;4,0;3,0;;;2,0;8,0;;;;14,0;7,0;;;;6,0;1,0;;;2,0;;;;;;;;;;;2,0;;;;;;;;;;;;1,0;;;;1,0;;;;;1,0;;1,0;31,0;;;;;;;;;;;;;4,0;;;;77,0;;;;2,0;;;;;;;1,0;;;;;2,0;;;;;;;;;;3,0;21,0;;7,0;4,0;;;;1,0;1,0;;;;4,0;;;;;;;;;;;;;6,0;;;;;;;;;1,0;;;;;;;;;;;;;;;;;;;;;3,0;;;;1,0;;22,0;;;;15,0;;2,0;2,0;;;;;13,0;18,0;7,0;;;;;;1,0;1,0;;3,0;;;;2,0;;;;;;;;;;;;;;;;8,0;;;;2,0;;;;;38,0;;;2,0;;;;1,0;;;;;;;;;;;;;;7,0;;;;;32,0;;4,0;15,0;;;;;1,0;;1,0;;;;;;;2,0;;;;;;;;;;;;;;;;;;;;;;;;;;;;;;;;;;;;;;;;;;;;;;;;;;;;;;1,0;4,0;;;;;;;;;;;;;;;;;;2,0;;1,0;;;;;;;2,0;;;;;;;;;;;;4,0;;;;;;;;;;;;;;;6,0;2,0;;;;1,0;;;;;;1,0;;;;;;;;;;;;;;;;;;;;;;;;;2,0;1,0;1,0;;;;;;;;;;;;;;;2,0;;;;;;;;;;;;18,0;;;;;;;;;;;;;;;;;;;;;;;;;;;;;;;;;;;;;;;
enter;;5,0;;5,0;16,0;19,0;3,0;9,0;;;1,0;;;50,0;;2,0;28,0;;7,0;;2,0;4,0;;;1,0;;;2,0;;20,0;42,0;5,0;;;;21,0;8,0;;;;23,0;78,0;;3,0;5,0;3,0;;29,0;;3,0;;2,0;1,0;9,0;15,0;1,0;6,0;;1,0;5,0;3,0;;10,0;1,0;110,0;;6,0;1,0;1,0;;1,0;91,0;249,0;1,0;2,0;;4,0;1,0;;3,0;32,0;5,0;95,0;3,0;29,0;8,0;;49,0;;;;1,0;10,0;;;;17,0;9,0;17,0;;22,0;16,0;8,0;1,0;9,0;6,0;1,0;;1,0;2,0;;1,0;4,0;;;;;4,0;10,0;27,0;;;7,0;;;;44,0;;;;82,0;14,0;;15,0;;;22,0;;2,0;;;3,0;;;32,0;3,0;9,0;2,0;4,0;;;10,0;30,0;1,0;;;;;;;3,0;2,0;;7,0;;;2,0;15,0;;8,0;1,0;;13,0;7,0;;4,0;2,0;9,0;21,0;;2,0;;1,0;5,0;;5,0;7,0;;;5,0;;6,0;1,0;;;4,0;61,0;21,0;;;;3,0;;;4,0;;6,0;;13,0;2,0;5,0;4,0;2,0;3,0;;19,0;5,0;4,0;;25,0;3,0;;8,0;16,0;1,0;;44,0;2,0;35,0;3,0;;10,0;37,0;;;6,0;14,0;2,0;;15,0;;;;;3,0;1,0;;1,0;23,0;1,0;;;8,0;3,0;9,0;;2,0;37,0;1,0;;7,0;16,0;;26,0;5,0;10,0;;2,0;;3,0;4,0;;2,0;;1,0;;23,0;;;;;4,0;4,0;;;;;;;;;1,0;;4,0;;;14,0;2,0;;;;;;4,0;;3,0;;;;15,0;;;2,0;;5,0;;4,0;3,0;;;16,0;65,0;2,0;;3,0;4,0;11,0;;9,0;;1,0;;;8,0;22,0;;;;7,0;;;;;;;2,0;;3,0;;;;3,0;2,0;;12,0;3,0;1,0;11,0;5,0;1,0;3,0;;;1,0;;;1,0;;;;;3,0;24,0;;1,0;;;5,0;;;43,0;1,0;1,0;;10,0;17,0;;;;9,0;2,0;2,0;;4,0;;2,0;;3,0;8,0;2,0;;32,0;;;;16,0;1,0;29,0;1,0;;;14,0;;14,0;1,0;;;;;17,0;3,0;;2,0;;;31,0;1,0;10,0;1,0;;;;3,0;1,0;;;;2,0;1,0;;;24,0;4,0;;;;;;65,0;;;2,0;3,0;;;;;2,0;;6,0;3,0;;;3,0;;;;;;;1,0;1,0;7,0;16,0;3,0;;;;1,0;1,0;;;1,0;;;;3,0;1,0;13,0;;;;;6,0;;;6,0;1,0;;;;2,0;;15,0;2,0;;1,0;7,0;;;5,0;;4,0;;;;1,0;1,0;;;;2,0;;;;;;;7,0;;;13,0;;4,0;;;;4,0;;7,0;;;2,0;44,0;;;;;2,0;4,0;;4,0;3,0;;10,0;1,0;;;;;;6,0;1,0;;1,0;;1,0;;1,0;3,0;;;;1,0;;;;1,0;;;;;16,0;;;6,0;;;4,0;;;;1,0;;;;;;;;;;;3,0;;;2,0;;;4,0;;;;;1,0;;2,0;;;2,0;2,0;4,0;1,0;;4,0;;;;;;;;;3,0;;;2,0;10,0;;;3,0;;;;;;;;;;;;1,0;;;;;;;;;2,0;;;4,0;;;;;1,0;5,0;;2,0;1,0;;;;;4,0;;;;2,0;4,0;;;;;;;2,0;;;;;2,0;;;;;;;;1,0;17,0;;;4,0;;;4,0;;1,0;;;16,0;;3,0;;;1,0;;;;;;4,0;;;;8,0;;4,0;;1,0;1,0;;;;;;;;;;4,0;;1,0;;;1,0;;2,0;1,0;;3,0;;1,0;;;;3,0;4,0;;;4,0;;;4,0;;2,0;;1,0;6,0;;;;;4,0;;;;;1,0;3,0;;;;3,0;;;;;;;;14,0;;;;;10,0;;;;20,0;;;1,0;;;6,0;2,0;;;;2,0;;;;1,0;;;;;;;;;;;;;;;;;;;;;;3,0;;;;1,0;;;;;;1,0;;;;1,0;;;;;1,0;;;;;;;;1,0;;;9,0;;2,0;;;;;1,0;1,0;;;;;;;;;;;1,0;;;;;4,0;;5,0;;;2,0;;2,0;4,0;3,0;;;;;1,0;;;;;;;3,0;;;;;;;;;;;;;;;;;;;;;;;;;;;;;;;;;5,0;;;;;;;3,0;;;;1,0;;;4,0;;;;;1,0;;;;;;;;;2,0;8,0;;;;;;;2,0;;;;;2,0;;;;;;;;
equip;;26,0;;;;7,0;5,0;17,0;;;;;;2,0;;;35,0;6,0;;;1,0;;;;21,0;;;6,0;2,0;1,0;9,0;;;;;48,0;;;;;5,0;115,0;;5,0;41,0;100,0;;6,0;;;1,0;1,0;9,0;39,0;87,0;4,0;;;;8,0;2,0;;3,0;;121,0;1,0;7,0;;;;;20,0;31,0;;;;;;;2,0;11,0;;;;41,0;1,0;;19,0;1,0;;;;;;1,0;;8,0;4,0;19,0;3,0;17,0;;;1,0;13,0;20,0;;2,0;;;;;9,0;;6,0;;;6,0;;28,0;;;2,0;;;;104,0;;;2,0;1,0;;;2,0;;56,0;140,0;;2,0;13,0;;3,0;1,0;;6,0;;5,0;;3,0;29,0;4,0;1,0;2,0;2,0;1,0;;;;;;6,0;8,0;;;;;;11,0;;8,0;1,0;1,0;1,0;3,0;;6,0;;;;;;;;10,0;;;16,0;;4,0;17,0;;;;;2,0;;8,0;;1,0;;;9,0;;8,0;;;1,0;;23,0;64,0;2,0;2,0;;;;5,0;7,0;3,0;;16,0;;;;;3,0;;104,0;;1,0;;2,0;;3,0;;59,0;;;;;;;1,0;;;;6,0;;;56,0;;;;;11,0;1,0;;;66,0;5,0;;;1,0;1,0;910,0;1,0;;;;;1,0;95,0;6,0;;1,0;5,0;;;;2,0;1,0;3,0;2,0;1,0;6,0;;;;;5,0;;2,0;;;1,0;;;44,0;97,0;;1,0;;;1,0;;;;;5,0;7,0;14,0;;;9,0;;3,0;;25,0;;;;5,0;29,0;;;;;2,0;1,0;;;;;;;;;;;;;;1,0;;;;;4,0;4,0;;6,0;;;;;;;;2,0;80,0;3,0;;;2,0;1,0;;1,0;;;;;;3,0;;3,0;;;1,0;;;;3,0;;;;;15,0;;;;;;6,0;;;48,0;2,0;;;;;;4,0;;;1,0;45,0;;1,0;;1,0;2,0;4,0;;63,0;;1,0;;1,0;;;;;;;;22,0;6,0;;4,0;;3,0;;;;;7,0;3,0;;;;;8,0;;;;1,0;;22,0;2,0;;;;;;;;;;;;;2,0;;;;;;;;1,0;9,0;;;1,0;30,0;;;1,0;;;;;;;15,0;;1,0;;10,0;;1,0;10,0;;;;;4,0;3,0;1,0;;;;;1,0;;2,0;114,0;;;;;;;;;;;7,0;;1,0;11,0;4,0;;;;;;;1,0;;1,0;;;6,0;2,0;2,0;;;;;;;;4,0;24,0;2,0;;;;;33,0;;;;;;;;;;1,0;;1,0;;;;18,0;;;;;;;3,0;;;1,0;;1,0;7,0;;;;;2,0;;;;;;;;;;;;;;7,0;;;;;;;;;;;;;;;;;;;;;;;;5,0;1,0;;;;;;1,0;;;;7,0;1,0;;;;;;8,0;;;;12,0;;;;2,0;;;;;;;;;;2,0;1,0;3,0;1,0;;;6,0;;;;;2,0;8,0;;3,0;;;;;;;;;;;1,0;1,0;;3,0;;1,0;;1,0;13,0;;;;1,0;;;;;1,0;;;1,0;1,0;;;99,0;;;;1,0;;;;3,0;;1,0;;;;;;;;;;1,0;;;6,0;;;1,0;8,0;;;;1,0;;;;;;;1,0;;;;;;4,0;;;;;;;;;5,0;;;;;;1,0;;;;;;;;;;;1,0;;;;;;;;;;;;;;;;;1,0;;1,0;;;;;;;;;;;;;;;;4,0;;;;;;;;;;7,0;;4,0;;;;;;24,0;;12,0;;;;;;;;;;15,0;;;;;;;;;;;;;;4,0;;;;;;1,0;;;;;;;;;6,0;;;1,0;;;;;;;;20,0;;;;;;;;;;8,0;;;;;;;;;1,0;;;;1,0;1,0;;3,0;;;16,0;;4,0;;;;;;4,0;;;;;;2,0;;;;;;;;;;;;;;12,0;;;;;;;;;;;;;10,0;;;;;;;;;;1,0;;;;;3,0;;38,0;;;;;;;;;;;;;;;;;1,0;;;;;;;;;;2,0;;;
executable;;1,0;;4,0;;21,0;2,0;1,0;;;;;;10,0;;;13,0;;;;;;;2,0;4,0;;;;135,0;;35,0;25,0;2,0;;;13,0;2,0;;1,0;;52,0;131,0;2,0;3,0;26,0;;1,0;2,0;;;;;;;;2,0;;;;14,0;;;3,0;3,0;74,0;;48,0;;;;6,0;;7,0;;;;;;15,0;66,0;14,0;;;;12,0;;;1,0;;;2,0;;;;2,0;;2,0;3,0;17,0;4,0;3,0;2,0;1,0;3,0;16,0;356,0;11,0;118,0;;;;;;;;;1,0;5,0;1,0;11,0;5,0;;6,0;1,0;;154,0;52,0;;;;3,0;;;5,0;;;1,0;4,0;;;;;;;;;1,0;;4,0;;1,0;;;;1,0;;;;;;;1,0;2,0;;;;1,0;;;1,0;;;7,0;;;;;1,0;;;;;;;;;;;1,0;;;;;3,0;;;;;;;;;;1,0;14,0;117,0;;;2,0;;;;1,0;;;;2,0;;;;1,0;;1,0;;;;;;;1,0;;1,0;;;;;;;;;;;;;;4,0;1,0;1,0;;;;;2,0;;;;;;;;;4,0;;;;;;;;;;;1,0;;;;;1,0;;;;;;;;;;;;;;;;;;;2,0;;;;;;;;;;;;;;;;;;;;3,0;;;;7,0;7,0;;;1,0;;1,0;;2,0;;;;;;2,0;;;;;;3,0;;1,0;;;;1,0;1,0;;;1,0;;;;;;;;31,0;;;;;1,0;2,0;;5,0;;;;4,0;;;;1,0;;3,0;9,0;2,0;;28,0;5,0;;;;14,0;2,0;;1,0;;;71,0;1,0;;;;;8,0;;;;7,0;;;2,0;;;6,0;;;;1,0;1,0;10,0;17,0;3,0;;;1,0;;;;;16,0;21,0;48,0;3,0;19,0;9,0;;;9,0;;1,0;;;30,0;;;1,0;;;;;;26,0;;;12,0;;;;2,0;;;;;4,0;;;25,0;;;;;10,0;4,0;29,0;;;;;469,0;;;;;;25,0;27,0;;;2,0;;3,0;;55,0;;1,0;;;4,0;1,0;2,0;;;;4,0;30,0;;;4,0;25,0;;;;;;;;3,0;;;;1,0;2,0;;;;;1,0;;;;;;;;;2,0;;;;1,0;1,0;;;;;1,0;1,0;;;;;;;;;1,0;;;31,0;3,0;2,0;2,0;;;;;;;;;3,0;;4,0;2,0;1,0;;;;;;;;;3,0;;;;;;;1,0;;;;108,0;;1,0;;;;;2,0;;;;;;;;;;;;4,0;;;1,0;;2,0;;3,0;;;;;4,0;7,0;;;;;;;;;8,0;;;1,0;;;;;;;;;;;;;;;;;;;;;;4,0;;1,0;;;;3,0;3,0;2,0;3,0;;;;;;;2,0;;;1,0;4,0;;2,0;1,0;;;;;;;;;;;;;;;2,0;;;;;;;;1,0;;;;;;;;;;;3,0;;;;;;;;;;;;1,0;;2,0;;3,0;;;;;;;;;;;;;;;;1,0;;;;;;;;;;;;;;;;;;;;;;;;;;;1,0;;1,0;;;;1,0;;;;2,0;1,0;;;;;;;;;;;;;;;;;;;;;;;;;;;;2,0;;;;;;;;;;;;1,0;;1,0;;;;;;;;;;;;;;;;;;;;;;;;;;;;1,0;;;;;1,0;;;;;;;;;;;;1,0;;1,0;;;;;;2,0;;;;;;;;;;;4,0;;;;;2,0;1,0;;;;;;;;;;;1,0;;;;;;;;;;;1,0;;;;;;;;;;;;;;;2,0;;;;;;;;;;;;2,0;;;;;;;2,0;;;;2,0;;;1,0;;;;;;;;;;2,0;;;;1,0;;;;;;;;;;1,0;1,0;;2,0;;;;;1,0;;;;;;2,0;;;;;
execute;;2,0;3,0;18,0;14,0;91,0;11,0;;7,0;;;;;45,0;;3,0;82,0;;1,0;6,0;3,0;1,0;35,0;8,0;47,0;;2,0;13,0;366,0;2,0;299,0;67,0;15,0;32,0;;93,0;9,0;1,0;3,0;1,0;90,0;502,0;;14,0;72,0;;;18,0;2,0;7,0;7,0;;1,0;;7,0;1,0;1,0;;1,0;54,0;;;4,0;27,0;328,0;30,0;152,0;1,0;2,0;;2,0;21,0;12,0;;3,0;;;8,0;28,0;182,0;232,0;;33,0;4,0;57,0;;;12,0;;6,0;3,0;2,0;;1,0;6,0;;23,0;;90,0;10,0;19,0;25,0;;108,0;298,0;1384,0;8,0;457,0;1,0;;;1,0;12,0;3,0;;;7,0;15,0;8,0;21,0;13,0;4,0;36,0;3,0;;464,0;289,0;;18,0;;37,0;;2,0;178,0;;;10,0;3,0;10,0;;;;;;10,0;20,0;16,0;1,0;21,0;;;;23,0;;;1,0;;;;;;6,0;8,0;5,0;;2,0;25,0;4,0;;13,0;1,0;4,0;47,0;8,0;;;1,0;;22,0;4,0;2,0;6,0;;2,0;;;13,0;;12,0;3,0;4,0;11,0;;3,0;;;5,0;2,0;;2,0;;;;3,0;2,0;301,0;35,0;;2,0;10,0;2,0;2,0;;;;;27,0;3,0;;;14,0;2,0;;;;;1,0;;;3,0;;;12,0;8,0;;11,0;;1,0;;3,0;;;;;;14,0;3,0;4,0;1,0;;;;;1,0;;1,0;;4,0;;;;4,0;;32,0;;;2,0;1,0;3,0;;;;4,0;19,0;3,0;;7,0;13,0;;2,0;3,0;4,0;4,0;7,0;;;;1,0;20,0;2,0;1,0;3,0;;;;;2,0;10,0;;;;;;5,0;1,0;;;1,0;;35,0;;;;1,0;4,0;;7,0;1,0;;2,0;75,0;46,0;;;;1,0;;;4,0;;;;;;9,0;;;;;;4,0;1,0;;;;;6,0;2,0;;;10,0;;1,0;2,0;14,0;;2,0;;45,0;3,0;2,0;2,0;1,0;39,0;;39,0;26,0;2,0;;5,0;8,0;2,0;8,0;3,0;14,0;1,0;;37,0;8,0;3,0;227,0;19,0;;3,0;2,0;18,0;9,0;1,0;5,0;3,0;;;3,0;15,0;1,0;110,0;;24,0;2,0;;;30,0;;3,0;;3,0;2,0;8,0;17,0;;;13,0;;28,0;132,0;2,0;;1,0;2,0;;;5,0;;29,0;47,0;114,0;6,0;54,0;13,0;;9,0;8,0;15,0;;10,0;;127,0;2,0;9,0;1,0;6,0;28,0;9,0;1,0;2,0;25,0;;;44,0;;2,0;;7,0;;;;11,0;12,0;2,0;1,0;256,0;;2,0;3,0;2,0;23,0;17,0;28,0;3,0;;3,0;3,0;1126,0;16,0;;;1,0;1,0;20,0;39,0;;;5,0;5,0;64,0;6,0;286,0;7,0;26,0;3,0;;;;3,0;5,0;;21,0;7,0;53,0;17,0;;4,0;117,0;7,0;22,0;1,0;5,0;2,0;6,0;2,0;5,0;11,0;;;;23,0;6,0;1,0;;;2,0;;2,0;;;3,0;;;;;;31,0;;1,0;;1,0;3,0;9,0;6,0;8,0;;1,0;;1,0;1,0;5,0;;2,0;;6,0;;;25,0;23,0;10,0;10,0;;1,0;;;;14,0;3,0;;12,0;;4,0;2,0;8,0;4,0;;5,0;1,0;;;3,0;1,0;5,0;;;10,0;;;;14,0;;;38,0;171,0;2,0;7,0;;1,0;;;;4,0;2,0;3,0;3,0;;71,0;1,0;4,0;2,0;3,0;;1,0;5,0;6,0;8,0;4,0;1,0;;5,0;;1,0;1,0;2,0;2,0;3,0;15,0;1,0;2,0;42,0;1,0;;;;1,0;7,0;1,0;;22,0;;;2,0;;2,0;;4,0;;;;;;;;;;;;;4,0;2,0;;1,0;;;1,0;;6,0;26,0;2,0;5,0;;;;;5,0;2,0;2,0;;9,0;6,0;;13,0;;9,0;;2,0;;;2,0;4,0;8,0;12,0;;;1,0;3,0;;;;;3,0;15,0;;;;;1,0;1,0;13,0;5,0;;;;;;;2,0;;;;6,0;42,0;;1,0;1,0;1,0;;;1,0;2,0;;;4,0;;4,0;;3,0;;;;1,0;2,0;;1,0;;4,0;;;10,0;;1,0;5,0;1,0;4,0;;;;;;;;2,0;;;;;;;;;;;;1,0;;3,0;;;;;;;;;;;;;;;;2,0;2,0;2,0;;1,0;;1,0;1,0;;;26,0;;;;;;;44,0;;1,0;;;5,0;;;;;;;26,0;;11,0;;;;1,0;;;;2,0;;5,0;3,0;;5,0;;15,0;;4,0;;1,0;;;;16,0;;;;;6,0;;;2,0;;4,0;11,0;1,0;;;;;2,0;;;;;;1,0;8,0;;3,0;;;;1,0;1,0;;6,0;8,0;;;6,0;18,0;;;4,0;;3,0;;;;;2,0;;3,0;;2,0;;21,0;;;;;3,0;;9,0;;1,0;1,0;;;;;;;6,0;;;;;;;;;;;;;;;;1,0;;;1,0;;;3,0;;;;;;1,0;;;;;;;;;;1,0;1,0;;1,0;1,0;6,0;;;;11,0;;;;;;;;;;;1,0;;;;;;;;1,0;;;;1,0;;2,0;;;;;;;1,0;;1,0;;;;;1,0;;
expose;;3,0;2,0;5,0;2,0;9,0;34,0;12,0;;;3,0;;14,0;12,0;;;31,0;;;;5,0;;12,0;6,0;1,0;;;30,0;4,0;8,0;44,0;4,0;;;3,0;40,0;4,0;7,0;3,0;18,0;7,0;64,0;;1,0;10,0;13,0;;28,0;;;;;11,0;17,0;25,0;1,0;47,0;;;3,0;;;8,0;;172,0;;43,0;;;22,0;;178,0;102,0;2,0;;;9,0;;2,0;4,0;46,0;;1,0;;39,0;13,0;;15,0;;4,0;;16,0;;7,0;;;114,0;;32,0;1,0;59,0;1,0;;;9,0;3,0;2,0;5,0;2,0;;;1,0;28,0;7,0;2,0;;;5,0;34,0;162,0;;;2,0;;;1,0;12,0;;8,0;2,0;24,0;;;47,0;;;24,0;;;1,0;1,0;1,0;;;17,0;;17,0;32,0;9,0;9,0;1,0;20,0;39,0;3,0;;9,0;1,0;;;3,0;35,0;11,0;;;;;21,0;47,0;;;5,0;;;5,0;3,0;17,0;2,0;7,0;;;;;;51,0;1,0;28,0;3,0;1,0;51,0;29,0;1,0;;7,0;5,0;4,0;83,0;67,0;6,0;10,0;;5,0;57,0;;;;2,0;31,0;9,0;;23,0;1,0;;;;5,0;31,0;4,0;;6,0;;20,0;4,0;;;12,0;2,0;158,0;;7,0;;7,0;15,0;;;4,0;;3,0;;;2,0;1,0;11,0;2,0;;;;3,0;1,0;77,0;3,0;;2,0;;34,0;12,0;;10,0;123,0;1,0;;6,0;8,0;;16,0;12,0;;;3,0;;25,0;2,0;17,0;;3,0;;;4,0;5,0;;;11,0;;4,0;10,0;;;3,0;15,0;15,0;;11,0;19,0;;;;;;1,0;;7,0;;;1,0;;;6,0;;;1,0;25,0;;;12,0;2,0;1,0;3,0;5,0;4,0;;4,0;10,0;2,0;5,0;;1,0;;;;9,0;2,0;;;;8,0;;1,0;15,0;;;;2,0;2,0;;;;2,0;;7,0;;;;;1,0;3,0;;1,0;2,0;13,0;8,0;;;;;9,0;;1,0;;;;;2,0;;;2,0;1,0;;;;;;20,0;;;2,0;;;;;;;6,0;;;;;;;;;;;4,0;2,0;;10,0;;;1,0;6,0;;5,0;;;8,0;11,0;5,0;;;;;;8,0;;53,0;;12,0;7,0;1,0;;12,0;2,0;8,0;1,0;;;;3,0;5,0;3,0;9,0;6,0;26,0;;;;;;;10,0;;;;7,0;;5,0;1,0;;;2,0;;7,0;;;;;;;;;;;;;;4,0;1,0;2,0;12,0;;;11,0;;1,0;1,0;;;4,0;2,0;;;;;;1,0;6,0;1,0;1,0;;;;;4,0;7,0;3,0;;13,0;;;;;;;2,0;;;;1,0;16,0;2,0;;2,0;12,0;;3,0;1,0;;1,0;1,0;2,0;;;1,0;;4,0;22,0;3,0;2,0;;;;;;1,0;75,0;;1,0;;3,0;2,0;;;2,0;;;2,0;;;;;;;5,0;6,0;;;;;;2,0;;;;;10,0;5,0;;4,0;;;;1,0;;1,0;2,0;;2,0;;;;;;;2,0;;4,0;;;1,0;15,0;;1,0;;;;;;;2,0;;1,0;;;;4,0;;3,0;;;;;;;8,0;;;;;;;;;;;;2,0;;;;;;;;;1,0;;9,0;;3,0;;;;;;;;6,0;;2,0;;;;;1,0;;5,0;3,0;;;;;12,0;;;1,0;;;;;1,0;;;1,0;;;;;;2,0;;;;5,0;;;;20,0;2,0;;;;;;;;6,0;;;21,0;;1,0;;;5,0;;;2,0;;;;;;4,0;5,0;;;;1,0;;4,0;1,0;;;;1,0;2,0;;;1,0;;2,0;;;3,0;1,0;;1,0;3,0;2,0;;;;1,0;8,0;;;;;;;;5,0;2,0;;1,0;;;2,0;;;;;1,0;7,0;2,0;;;1,0;;11,0;2,0;;;;4,0;21,0;;;;;;;;;;;;;;;;1,0;;8,0;11,0;;;;;2,0;;;2,0;2,0;4,0;3,0;;;;;;;;;;18,0;3,0;;3,0;;3,0;;;;;;;;2,0;4,0;;;;1,0;;;;;;;;;1,0;;;;;;;;8,0;;1,0;;;;;;;4,0;;1,0;;;;;3,0;;3,0;;;;;;;;;;;;;;3,0;;;;;;;;;;;9,0;;;;2,0;;;;2,0;;;5,0;;;5,0;1,0;;9,0;;;;;;;;;;;;;1,0;1,0;;;;;;;;;2,0;1,0;;;;;;;;6,0;;4,0;;;;;;;;;;;;;;;;;;;;2,0;;3,0;;;;;2,0;;;;;;;;;;;;;;;;;;;
exterior;;1,0;;;;12,0;;15,0;;;;;11,0;93,0;;;19,0;;6,0;2,0;;;20,0;;6,0;;;23,0;;;23,0;2,0;;;;10,0;23,0;1,0;;;11,0;75,0;1,0;;8,0;68,0;;21,0;;;2,0;3,0;80,0;5,0;134,0;;36,0;;;;6,0;;;;94,0;;24,0;;1,0;1,0;10,0;74,0;16,0;;;;4,0;;;4,0;17,0;;;;43,0;3,0;;39,0;4,0;;;13,0;;4,0;1,0;;;3,0;39,0;2,0;29,0;2,0;2,0;3,0;4,0;4,0;;;;;;1,0;16,0;2,0;3,0;2,0;;28,0;5,0;32,0;;;2,0;1,0;;3,0;37,0;;;7,0;;;;10,0;;13,0;135,0;21,0;1,0;;;6,0;;;25,0;2,0;19,0;14,0;6,0;11,0;;2,0;29,0;22,0;;;2,0;;;;4,0;9,0;;;;;27,0;44,0;;;;;1,0;35,0;2,0;39,0;;8,0;2,0;;1,0;99,0;21,0;20,0;2,0;;1,0;1,0;13,0;30,0;;;30,0;2,0;2,0;4,0;141,0;14,0;4,0;;;99,0;;;1,0;;19,0;3,0;28,0;58,0;;;;7,0;4,0;11,0;;1,0;;2,0;3,0;;4,0;;5,0;;149,0;;;4,0;18,0;1,0;1,0;;7,0;;1,0;;2,0;;;20,0;3,0;1,0;8,0;;1,0;10,0;243,0;2,0;9,0;;;6,0;1,0;2,0;16,0;306,0;5,0;;1,0;17,0;;337,0;46,0;2,0;;;6,0;6,0;10,0;;3,0;2,0;;;1,0;;1,0;5,0;3,0;;12,0;9,0;;1,0;24,0;22,0;10,0;12,0;1,0;;;3,0;;;9,0;3,0;;3,0;2,0;3,0;;1,0;;11,0;1,0;2,0;;1,0;6,0;;;;2,0;;32,0;;;10,0;21,0;21,0;8,0;1,0;4,0;;;;3,0;4,0;4,0;;;8,0;17,0;3,0;;;;;;2,0;;1,0;;3,0;2,0;7,0;;3,0;;;;;21,0;4,0;;1,0;16,0;4,0;;;;;;3,0;;;;;;;;3,0;1,0;;;;;;3,0;;;1,0;;12,0;;;;;;;;;8,0;1,0;;;7,0;1,0;;2,0;;;;10,0;;;3,0;15,0;;2,0;;1,0;1,0;11,0;;;;;;;1,0;;;5,0;;;1,0;;;;;;;;1,0;1,0;1,0;;;12,0;;2,0;;;;;5,0;;;;1,0;;;3,0;;1,0;1,0;;;;;2,0;;;;;;;;3,0;;6,0;168,0;2,0;;;;;;;;;2,0;6,0;;;1,0;;;6,0;5,0;;;;1,0;2,0;;;2,0;9,0;1,0;;;;11,0;;;;6,0;;7,0;;1,0;1,0;2,0;28,0;6,0;14,0;;4,0;;1,0;;;18,0;;2,0;;;;7,0;;13,0;;;6,0;;;;;;15,0;;2,0;;;8,0;;8,0;8,0;;;;;;;2,0;;1,0;;5,0;13,0;;;;1,0;;;;;;;5,0;;;;3,0;;;;;;;23,0;2,0;;;1,0;;;;;3,0;;;4,0;19,0;;;;;27,0;;;;;;;;;;;;;;;;2,0;;;;;;;2,0;;;;;;6,0;;;;;;1,0;;;;;4,0;6,0;;;;;;;;;;;;;1,0;;;;;;;2,0;;;;7,0;;;;1,0;;;;;;1,0;;1,0;1,0;;;;;;;;;;;;;;5,0;;4,0;;3,0;;;;;1,0;8,0;;;;;;2,0;10,0;;;7,0;;1,0;1,0;1,0;;;;;;3,0;;4,0;2,0;;7,0;;;;5,0;;;6,0;;;;;;16,0;;;;9,0;;;1,0;;4,0;2,0;;;4,0;;8,0;;;;;13,0;;;;;;;;1,0;;;;2,0;;;;;5,0;;;;8,0;;;11,0;;;;;;;;;;;;;;;;;3,0;;;;;;;;;;;;;;;;;;;;;;;;;;19,0;;;;;;;;;;;;;;;;;;;2,0;;;1,0;;;;;;;4,0;;3,0;;;;;;;;;;;;;;;;;;3,0;3,0;;;;;;;;;;;;;;;;;;;;;;;;;;;;6,0;;;3,0;;;;;;;;;;;;;;;;;;;;;;4,0;;2,0;;;;;3,0;;;;;;;;;;;;;2,0;;;1,0;;;;;;;;;13,0;;;;;;;;;;2,0;;;;;;;;;1,0;;;;;;;;;;;;;;;
eyepiece;;5,0;;1,0;;12,0;;16,0;;;;;;11,0;;;3,0;;;;;;;;;;;;;;1,0;;1,0;;;2,0;;;;;;59,0;23,0;6,0;30,0;1,0;1,0;;;;;;4,0;;;;5,0;;;;3,0;;;;29,0;;15,0;;;;;41,0;8,0;;1,0;;;;5,0;;2,0;;;;5,0;;;70,0;;;;;2,0;;;;;;3,0;1,0;13,0;;1,0;;;;;;;3,0;;;4,0;;22,0;;;;;4,0;;;;2,0;;;4,0;;;3,0;;;;30,0;;;16,0;;;;;1,0;;;6,0;;;1,0;;5,0;;;25,0;;;;;;;;;9,0;;;;;30,0;1,0;1,0;4,0;;;;;;;;;;;;;;18,0;;;;;;4,0;;;;;;;2,0;;2,0;;;;;;;;6,0;;;26,0;;;;;;4,0;;1,0;;2,0;;;;;;;14,0;;;1,0;;;;;1,0;;;;1,0;;;3,0;;;;;;4,0;1,0;;;;;;;;1,0;2,0;1,0;;;;;;17,0;;;;;77,0;;;;4,0;13,0;;7,0;1,0;4,0;;33,0;;14,0;;;;;2,0;;;;;;24,0;;1,0;;;;;10,0;;;;;;;1,0;;1,0;;;;;;;;1,0;4,0;;4,0;2,0;2,0;5,0;2,0;;;;;;;2,0;;;;;;;;;;2,0;;;;8,0;;2,0;;;;;;;;20,0;;;1,0;;6,0;;;;;1,0;;;;;4,0;;;;;;;;;;4,0;;;;;4,0;;3,0;;;;;;;;;;;;;;;;;;1,0;;3,0;;;;;2,0;1,0;;;;;;;;;;;;27,0;;4,0;;;;;1,0;;;;;32,0;;;;;;;;;;;5,0;;;;;5,0;;;;;;;;;;;;;;;;;;;;1,0;;;;;;;;;;;;;;;;;;;;;;;16,0;;;;2,0;;;2,0;;;;;;;;;;;;;;2,0;;;;;;;;;;;;;;;2,0;;;;;1,0;;;;;15,0;1,0;;8,0;;;;;;;;;;;;;;;;;;;;;;;;1,0;;;;;2,0;4,0;1,0;;;;;;;;;;14,0;;;;;;;;;;;;;;;;;;;;;;;;;;;;;;;;;;;;;;;;;;;;;;;;;;;6,0;;;;;;;;;;;;1,0;;;;;;;;;;;;;;;3,0;;;;5,0;;;;;;;;;;2,0;;;;;;;;;;;;;;;;;;;;;4,0;;;;;;;;;;;4,0;4,0;;;;;;;1,0;;;;;;;;;;;;;;;;3,0;;;;;4,0;;;;;;;15,0;;;;;;;;;1,0;2,0;;3,0;1,0;1,0;;;;;;;;;;;;;;;;;1,0;6,0;;;;;;;;;;;;;;;;;;;;;;;;;;;;;;;;;;;;;;;;;;;;;;;;;3,0;;;;;;;;;;;;;;;;;;;;;;;;;;;;;;;;;;;12,0;;;;;;;;;;;;;;4,0;;;;;;;;;;;;;;;;;;;;;;;;;;;;;;;;2,0;;;;;;;;;;;;;;;;;;;;;;;;;2,0;;;;;;;;;;;;;;;;;;;;2,0;;;;;;;;;;;;;;;5,0;;;;;;;;;;;;;;;;;;;;;;;;;;;;;;;
face;;1,0;2,0;14,0;1,0;95,0;18,0;41,0;;7,0;5,0;;69,0;313,0;;;213,0;4,0;16,0;7,0;5,0;3,0;10,0;3,0;3,0;1,0;11,0;53,0;13,0;19,0;186,0;18,0;1,0;23,0;;62,0;47,0;20,0;19,0;3,0;149,0;326,0;21,0;44,0;146,0;329,0;3,0;127,0;4,0;10,0;11,0;45,0;124,0;45,0;62,0;7,0;126,0;2,0;4,0;45,0;11,0;;19,0;;905,0;;372,0;3,0;8,0;49,0;13,0;612,0;197,0;;;;18,0;2,0;2,0;24,0;163,0;11,0;15,0;40,0;209,0;45,0;;103,0;3,0;3,0;14,0;9,0;11,0;17,0;8,0;;20,0;51,0;227,0;51,0;344,0;56,0;5,0;9,0;16,0;45,0;3,0;10,0;;7,0;;65,0;166,0;7,0;3,0;2,0;10,0;40,0;27,0;214,0;1,0;1,0;33,0;46,0;;7,0;165,0;;14,0;3,0;27,0;1,0;;219,0;6,0;;131,0;2,0;7,0;5,0;15,0;41,0;;;54,0;23,0;166,0;125,0;35,0;40,0;12,0;24,0;178,0;159,0;;1,0;34,0;3,0;4,0;2,0;10,0;35,0;1,0;3,0;16,0;9,0;68,0;100,0;;166,0;49,0;11,0;21,0;388,0;;66,0;2,0;23,0;1,0;6,0;2,0;10,0;51,0;;3,0;40,0;8,0;11,0;124,0;424,0;1,0;3,0;17,0;24,0;57,0;32,0;299,0;17,0;197,0;8,0;18,0;89,0;1,0;;3,0;9,0;180,0;17,0;46,0;149,0;22,0;22,0;4,0;4,0;6,0;156,0;61,0;91,0;5,0;10,0;42,0;8,0;137,0;32,0;112,0;1,0;455,0;6,0;;14,0;31,0;2,0;9,0;14,0;164,0;49,0;18,0;32,0;6,0;17,0;1,0;57,0;3,0;4,0;6,0;34,0;4,0;56,0;823,0;3,0;21,0;19,0;2,0;91,0;111,0;;72,0;934,0;29,0;;29,0;13,0;21,0;63,0;89,0;4,0;;;;98,0;21,0;31,0;9,0;15,0;4,0;;20,0;71,0;29,0;7,0;7,0;20,0;94,0;51,0;;;31,0;41,0;49,0;16,0;470,0;24,0;6,0;7,0;8,0;35,0;81,0;45,0;28,0;25,0;23,0;5,0;15,0;1,0;;18,0;13,0;24,0;8,0;49,0;20,0;1,0;24,0;2,0;125,0;9,0;95,0;15,0;9,0;1,0;46,0;116,0;154,0;9,0;26,0;1,0;2,0;10,0;29,0;6,0;25,0;;3,0;47,0;20,0;13,0;;2,0;;4,0;42,0;16,0;6,0;4,0;5,0;5,0;22,0;33,0;;12,0;4,0;6,0;5,0;;25,0;1,0;3,0;119,0;123,0;2,0;3,0;2,0;;;;6,0;15,0;10,0;;6,0;18,0;;31,0;82,0;16,0;9,0;5,0;;23,0;;51,0;9,0;;9,0;2,0;395,0;6,0;4,0;13,0;8,0;5,0;2,0;34,0;20,0;109,0;3,0;10,0;55,0;23,0;4,0;;45,0;27,0;7,0;1,0;59,0;;44,0;17,0;6,0;2,0;41,0;;1,0;1,0;29,0;15,0;;1,0;4,0;;1,0;4,0;;1,0;100,0;7,0;34,0;13,0;;36,0;;47,0;5,0;;;20,0;95,0;15,0;;22,0;33,0;38,0;20,0;;11,0;1,0;5,0;187,0;;4,0;;8,0;1,0;15,0;6,0;;9,0;10,0;6,0;13,0;3,0;;18,0;8,0;;;;;20,0;5,0;8,0;9,0;49,0;37,0;2,0;4,0;3,0;3,0;13,0;538,0;8,0;21,0;22,0;6,0;;44,0;4,0;31,0;11,0;2,0;19,0;1,0;10,0;2,0;2,0;16,0;10,0;1,0;11,0;;11,0;2,0;13,0;4,0;38,0;5,0;2,0;;5,0;5,0;2,0;5,0;16,0;3,0;;9,0;27,0;11,0;;18,0;18,0;;41,0;6,0;4,0;14,0;;2,0;11,0;7,0;;2,0;33,0;36,0;;6,0;3,0;4,0;28,0;;14,0;49,0;105,0;2,0;27,0;2,0;;10,0;18,0;49,0;1,0;47,0;2,0;;3,0;12,0;;1,0;;12,0;7,0;11,0;12,0;;;1,0;1,0;1,0;;;5,0;1,0;5,0;50,0;10,0;4,0;16,0;;;;2,0;;;;20,0;6,0;;3,0;15,0;4,0;2,0;;;31,0;;;5,0;9,0;1,0;;;21,0;39,0;1,0;2,0;;21,0;7,0;24,0;1,0;;;2,0;1,0;15,0;173,0;3,0;3,0;2,0;;2,0;3,0;8,0;4,0;;5,0;;;1,0;4,0;;;1,0;18,0;;;4,0;37,0;;3,0;1,0;15,0;6,0;3,0;2,0;;20,0;;3,0;;10,0;2,0;1,0;5,0;9,0;12,0;;1,0;;;;;;14,0;1,0;;3,0;3,0;;18,0;4,0;13,0;1,0;;6,0;;5,0;90,0;2,0;;;;;;2,0;1,0;2,0;22,0;;;9,0;;;1,0;91,0;6,0;41,0;10,0;5,0;2,0;2,0;3,0;59,0;91,0;2,0;12,0;20,0;18,0;2,0;1,0;3,0;40,0;;4,0;15,0;;4,0;7,0;6,0;5,0;1,0;1,0;3,0;;12,0;4,0;8,0;;24,0;7,0;2,0;4,0;6,0;33,0;;3,0;14,0;4,0;10,0;44,0;15,0;9,0;2,0;;3,0;;2,0;2,0;11,0;20,0;44,0;16,0;1,0;;34,0;5,0;14,0;9,0;4,0;5,0;20,0;2,0;2,0;6,0;4,0;4,0;2,0;;;7,0;;30,0;5,0;;;6,0;5,0;14,0;2,0;39,0;;;2,0;28,0;19,0;5,0;13,0;;;;;1,0;;;10,0;9,0;;;6,0;2,0;8,0;42,0;13,0;6,0;;;;7,0;;;3,0;;;;2,0;75,0;5,0;2,0;;2,0;3,0;2,0;;4,0;2,0;;4,0;1,0;3,0;4,0;27,0;24,0;;5,0;5,0;;1,0;;;13,0;6,0;;;;7,0;;1,0;6,0;;7,0;1,0;2,0;;2,0;;23,0;;2,0;25,0;2,0;3,0;;1,0;7,0;;7,0;2,0;1,0;8,0;;;8,0;3,0;7,0;;;;;1,0;2,0;2,0;1,0;;18,0;;;;8,0;5,0;;1,0;;1,0;4,0;;;;5,0;4,0;6,0;51,0;;16,0;1,0;1,0;6,0;3,0;50,0;;3,0;;1,0;;1,0;;;15,0;1,0;5,0;3,0;5,0;;;;1,0;;1,0;;10,0;;;2,0;54,0;1,0;1,0;33,0;;;;1,0;;9,0;;;;;10,0;2,0;;2,0;56,0;;50,0;4,0;;;4,0;1,0;;8,0;;1,0;;3,0;;6,0;1,0;4,0;;;44,0;26,0;;;;1,0;7,0;3,0;;7,0;;3,0;1,0;8,0;;14,0;;7,0;3,0;13,0;10,0;;;4,0;;3,0;;;
facial;;2,0;;;;1,0;;;;;;;;23,0;;;35,0;;;3,0;;;8,0;;;;;1,0;23,0;;6,0;4,0;;;;23,0;;;5,0;;31,0;20,0;;1,0;8,0;;;;;;;;;;;;;;;6,0;;;1,0;;63,0;;6,0;;;;;;5,0;;;;;;1,0;2,0;30,0;;1,0;4,0;4,0;;;3,0;;1,0;3,0;;;;;;2,0;;9,0;3,0;7,0;1,0;;9,0;3,0;2,0;;2,0;;1,0;;;10,0;;;1,0;;1,0;1,0;2,0;1,0;;4,0;;2,0;5,0;39,0;;;;3,0;;;;;;1,0;1,0;;;;;;;;;;;1,0;;;1,0;2,0;;;;;;;;;5,0;;;;;;;;11,0;;;1,0;;;;;;;;4,0;;;21,0;;2,0;;;9,0;;;1,0;;;;;;;;;;;;;;;;;;;;3,0;;;;;;;;;1,0;1,0;15,0;;;;3,0;11,0;;;;;;;;7,0;;;;1,0;;;;;;2,0;;1,0;;;;;;;;;;;;;;;;1,0;;;;;;;;;;;;;;;;;;;;;;;;;2,0;;;;;;;;;;;2,0;;;;;;;;6,0;;;;;;;1,0;;;;;;;7,0;;;;;;;;;;;;;;;;;;;;;;;;;2,0;;;;1,0;;3,0;;4,0;;;;8,0;;;;;;;;2,0;;;;;;;;13,0;;2,0;;5,0;;;;1,0;;;26,0;1,0;;;1,0;;1,0;;;;2,0;;17,0;2,0;;;3,0;;1,0;;8,0;2,0;2,0;4,0;;;2,0;1,0;;;;;;;1,0;;2,0;;;;2,0;;18,0;2,0;;;;;;;;;8,0;;;;;;;;2,0;;;22,0;;;;;;;;;;2,0;;5,0;1,0;;14,0;;1,0;2,0;;;;2,0;;1,0;;;;;;;;;;;;;;6,0;;1,0;3,0;;;;;;;4,0;2,0;2,0;;;;1,0;;;;;;;1,0;2,0;;;;;;;1,0;;;;;;;;;;;;;;4,0;;;;;;;;7,0;;;;1,0;2,0;4,0;2,0;;;;;;57,0;;1,0;;;;;;;;;4,0;;;3,0;4,0;1,0;;2,0;;;;;;1,0;3,0;;;;;;;;;;;3,0;;;;;4,0;;;3,0;;;;;;;27,0;;;1,0;;;;3,0;;;;1,0;;10,0;3,0;;;;;;6,0;;;;;;2,0;;;;4,0;;;;;;;;;;;;;;;;;;;;;;;;;;;;;;;;;;;;;;;;;;;;;3,0;;;;;;;;;;;;;;;;;;;;;;;;;;2,0;;;;;;;;;;;1,0;;;;;;;;;;;;;;;;;;;;;;;;;4,0;;;;;;;;;1,0;;;;;;;;;;;;;;;;;;;;;3,0;;;;;;;;;;;;;;;;;;;;;;;;;;;;;;;;;;;;;;5,0;;;;;;;;;;;;;2,0;;;;;;;;;;;8,0;;3,0;;;;;;;;;;;1,0;;;;;;;;;1,0;;14,0;;;;;;;1,0;2,0;;;;;3,0;;;;2,0;;;;1,0;;;;;;;;;;;;;;;;;;;;;;;;;;;;;;1,0;;;;;;;;;;;;;;;;;;;;;;;;;;;;;;;;;;;;;;;;;;1,0;;;;;6,0;;;;;;;;;;;;;;;;;;;;;;;;;;;;;;1,0;;;;;;84,0;;;;;;;;;
factor;;1,0;;38,0;1,0;9,0;7,0;;;;;4,0;;77,0;29,0;2,0;10,0;;;;;2,0;87,0;8,0;3,0;3,0;;5,0;5,0;6,0;10,0;6,0;2,0;14,0;;27,0;10,0;;11,0;1,0;85,0;25,0;;19,0;23,0;;6,0;7,0;9,0;13,0;2,0;;;;7,0;2,0;44,0;;8,0;24,0;;25,0;12,0;;158,0;4,0;63,0;6,0;2,0;;;43,0;12,0;;48,0;;;;1,0;35,0;75,0;;10,0;4,0;6,0;1,0;;15,0;;6,0;18,0;;;;;;39,0;3,0;38,0;34,0;8,0;9,0;;;7,0;22,0;9,0;1,0;;;2,0;;7,0;;;;12,0;1,0;1,0;35,0;;6,0;20,0;2,0;1,0;12,0;40,0;7,0;;;17,0;;;9,0;10,0;;10,0;4,0;114,0;;;;;;5,0;25,0;8,0;3,0;18,0;1,0;;16,0;3,0;1,0;;5,0;;;;;;;4,0;;;2,0;;1,0;;6,0;;;4,0;11,0;1,0;;3,0;;;;;;1,0;2,0;;;2,0;;13,0;1,0;7,0;;;1,0;;;9,0;;;;;;;;2,0;5,0;;;2,0;1,0;1,0;3,0;10,0;;;;15,0;;;;3,0;;;;;;;;;4,0;;;19,0;37,0;;;;;;7,0;;;;;;57,0;;16,0;2,0;;;1,0;;1,0;;;;;;;2,0;3,0;;;;;;;45,0;2,0;;;;;;;4,0;10,0;;2,0;;1,0;4,0;;;;;2,0;;;;;;;;;18,0;;;;;;;;;;;14,0;8,0;4,0;;;;;;;;;;1,0;4,0;;;1,0;;;;;;;;;;;20,0;;1,0;;;;;1,0;;;;;;35,0;;;;;;3,0;7,0;;;1,0;27,0;;;;;17,0;;27,0;;;;;;;18,0;4,0;16,0;6,0;;;2,0;;13,0;;;;4,0;8,0;2,0;6,0;;2,0;;;4,0;6,0;;8,0;;17,0;10,0;1,0;;10,0;3,0;7,0;15,0;4,0;2,0;1,0;13,0;;;3,0;;3,0;8,0;2,0;;;;;;18,0;;;3,0;9,0;;4,0;15,0;;5,0;;6,0;;2,0;;1,0;;11,0;;38,0;2,0;23,0;10,0;;6,0;;;17,0;;2,0;;;;;;;41,0;;1,0;25,0;4,0;;1,0;;;1,0;;;6,0;;;3,0;1,0;;;8,0;2,0;;;;;;;1,0;;28,0;;6,0;;;;3,0;;;;1,0;;;;;2,0;;;2,0;14,0;;4,0;;6,0;;3,0;;;1,0;;;;;1,0;;;;;;;;;;;;1,0;;;13,0;;1,0;;;10,0;;2,0;;;;;;;1,0;;;;;7,0;1,0;1,0;;;;;2,0;9,0;;;;8,0;;;;;;;;;;9,0;;1,0;;;41,0;;;;1,0;;;;;;1,0;4,0;;24,0;;;;;32,0;;;;;6,0;;;;;75,0;;1,0;2,0;4,0;1,0;1,0;;;4,0;;2,0;7,0;;6,0;;;;;;;;;;;;;;;;;4,0;;;;1,0;;;;;;;;;;;1,0;;;;46,0;142,0;;;;;;;;;;;;;;4,0;10,0;;1,0;4,0;4,0;;;;;;;;;;;;;1,0;;;;;5,0;;;;7,0;;4,0;;;;;;;;;;;1,0;;;;;;4,0;;2,0;10,0;;;;;;;8,0;;;;;3,0;;4,0;;5,0;;;;;;;2,0;4,0;;;5,0;;;;;;;;;;4,0;;;;;;;1,0;;5,0;4,0;3,0;;2,0;;;;;;;;1,0;;;;;2,0;;35,0;2,0;;;;3,0;;;;5,0;;;;;;;8,0;;6,0;;;;2,0;;;4,0;;;;1,0;;;;;15,0;;;;;;2,0;3,0;;;;14,0;;;1,0;21,0;;;;;;;;;;;;;;;;3,0;;15,0;;;;;;;;;;;;20,0;;1,0;;1,0;;;;;5,0;;;;;;1,0;;1,0;;;3,0;11,0;;1,0;;;;;;;1,0;;;;2,0;4,0;1,0;;;;;;;2,0;;;;;;;;1,0;;;2,0;;;9,0;;;;6,0;;;;;;;;;;;;;;;;;;3,0;;;;;;;;;;;;;7,0;;;;;;;;;;;;1,0;;;;;;;;;;1,0;;4,0;;;;;;2,0;;;;;;;;;;;
fasten;;3,0;;7,0;2,0;20,0;2,0;67,0;;;;2,0;;88,0;;;5,0;;3,0;;3,0;;;;;;;5,0;;;64,0;1,0;;;;6,0;3,0;8,0;;;1,0;116,0;;1,0;;1,0;2,0;122,0;;;;;15,0;2,0;1,0;;12,0;;;;1,0;;5,0;;14,0;;70,0;2,0;;1,0;3,0;24,0;;;;;36,0;;;;20,0;;;2,0;50,0;2,0;;14,0;1,0;;;;10,0;;;;;;23,0;1,0;53,0;;;;;;;;;;;;1,0;;12,0;;;;;12,0;;2,0;;;;;17,0;;;;;;;6,0;;;5,0;;;;2,0;3,0;;;12,0;2,0;6,0;7,0;;21,0;;7,0;16,0;6,0;;;8,0;;;;;14,0;;;;;43,0;19,0;;;;;;19,0;;20,0;;;24,0;;;;;23,0;78,0;;;2,0;3,0;44,0;;;1,0;8,0;16,0;38,0;124,0;;22,0;1,0;;;;;;;249,0;4,0;;116,0;6,0;2,0;;;3,0;4,0;;3,0;;;;;;;28,0;2,0;62,0;2,0;;1,0;5,0;;1,0;;11,0;;;;4,0;;;60,0;25,0;9,0;;1,0;12,0;2,0;93,0;;6,0;2,0;;205,0;9,0;;48,0;35,0;2,0;;;;1,0;12,0;10,0;;;;;8,0;1,0;3,0;4,0;7,0;1,0;;3,0;3,0;;;11,0;;11,0;10,0;;1,0;21,0;3,0;3,0;;;1,0;;2,0;2,0;2,0;1,0;;9,0;4,0;;6,0;2,0;;;16,0;4,0;1,0;3,0;8,0;3,0;;2,0;1,0;3,0;1,0;30,0;12,0;11,0;33,0;;;15,0;2,0;;;;;;;6,0;1,0;;13,0;2,0;1,0;11,0;;;17,0;4,0;7,0;4,0;39,0;;11,0;2,0;10,0;;21,0;;1,0;;;4,0;13,0;2,0;4,0;4,0;;;;;;;;;;;;3,0;;;1,0;;;;;;;7,0;;;;2,0;;;;;;;;;;;;;;;;;;;2,0;;;;;20,0;6,0;1,0;4,0;;;;4,0;;;;;;;;;;25,0;;;;1,0;;;;;;;;;1,0;;;;;2,0;;;;;5,0;;;;;5,0;3,0;;;;;;1,0;1,0;;;;;;;;;;;;4,0;4,0;4,0;;1,0;;;3,0;;;2,0;;;8,0;;1,0;;;;;;;;;;;2,0;;;1,0;;;4,0;;2,0;1,0;;;;3,0;;4,0;;3,0;14,0;;;11,0;2,0;;;;;12,0;;2,0;;;;1,0;;2,0;;;;1,0;;;;6,0;20,0;;;;;;;;1,0;;;;;;;;;;;1,0;;;;;;;;;1,0;;3,0;2,0;4,0;;;3,0;;;;2,0;3,0;1,0;;8,0;;;;;;;;21,0;;;;;;;;;1,0;;;1,0;;;;;;;;;2,0;;;;;;;;;;;;;;;1,0;;6,0;3,0;;;;;5,0;;;;2,0;;;;;2,0;;;;;;;;4,0;;;;;;;;;;;;;;;;;;;;;;;;;;;;;;;;;1,0;;;17,0;;;;6,0;;2,0;12,0;54,0;;;;4,0;1,0;1,0;4,0;2,0;10,0;;;;;;;;;;;;;;4,0;;;2,0;4,0;;;;1,0;;;;5,0;;;9,0;;;;2,0;;27,0;;;;;;;;;8,0;;;;;;;;6,0;;;;4,0;;;;;2,0;;2,0;;;;;2,0;8,0;8,0;;;;;;;;;;;;;;;;;;;2,0;;;;;;;;;;;;;;;;;;;;;;;;;;;;;;;;;;;;;;;;;1,0;;4,0;2,0;;;;;;;;1,0;;1,0;;;;;;;;;;;3,0;;;;2,0;;;;;;;;2,0;;;;;1,0;10,0;1,0;;;;;;;;;;1,0;;;;;;;;;5,0;;;;;;1,0;;4,0;;;;;;;;5,0;;;;;;;;;;;;;;;;;;;1,0;;;;;1,0;;;3,0;;;;;;;;;;;;;;;;;1,0;;;;;;;;1,0;;;;;;;;;;;;;;;;;;;;;;;;;;;;;;;
feature;;10,0;10,0;39,0;53,0;79,0;7,0;20,0;8,0;2,0;;1,0;;455,0;;2,0;214,0;;17,0;91,0;;;55,0;1,0;3,0;10,0;;27,0;27,0;23,0;139,0;23,0;6,0;11,0;;169,0;59,0;7,0;151,0;1,0;638,0;244,0;4,0;42,0;67,0;7,0;26,0;48,0;6,0;6,0;91,0;;47,0;3,0;27,0;11,0;41,0;;8,0;104,0;1,0;;40,0;3,0;2399,0;9,0;297,0;9,0;22,0;23,0;12,0;22,0;102,0;9,0;;10,0;;15,0;6,0;13,0;377,0;;8,0;170,0;137,0;2,0;;36,0;1,0;9,0;36,0;2,0;14,0;1,0;42,0;;199,0;51,0;727,0;1800,0;355,0;88,0;1,0;10,0;41,0;76,0;8,0;14,0;13,0;;1,0;157,0;121,0;;;89,0;48,0;60,0;98,0;41,0;34,0;;46,0;31,0;6,0;161,0;192,0;;6,0;;75,0;26,0;;113,0;7,0;;115,0;29,0;19,0;;;51,0;1,0;1,0;5,0;38,0;42,0;20,0;149,0;7,0;16,0;15,0;24,0;1,0;;;;17,0;;3,0;;23,0;50,0;12,0;;23,0;12,0;4,0;;53,0;9,0;14,0;;31,0;;65,0;;3,0;22,0;;5,0;;;39,0;1,0;1,0;15,0;;312,0;35,0;16,0;128,0;;3,0;4,0;3,0;25,0;4,0;2,0;1,0;;12,0;8,0;1,0;62,0;25,0;8,0;1,0;2,0;111,0;15,0;38,0;3,0;;;;54,0;;3,0;;51,0;12,0;19,0;;5,0;;182,0;;11,0;29,0;20,0;4,0;30,0;10,0;15,0;40,0;52,0;5,0;1,0;30,0;1,0;4,0;;;;189,0;5,0;28,0;6,0;1,0;7,0;;;41,0;;;14,0;121,0;1,0;;1,0;8,0;36,0;104,0;;4,0;1,0;;45,0;3,0;7,0;1,0;4,0;14,0;11,0;;16,0;52,0;;23,0;65,0;2,0;20,0;;4,0;;;7,0;8,0;1,0;;25,0;1,0;;38,0;;130,0;1,0;;17,0;1,0;2,0;1,0;8,0;1,0;2,0;;4,0;24,0;89,0;;;2,0;32,0;21,0;1,0;59,0;11,0;4,0;9,0;25,0;338,0;6,0;66,0;1,0;1,0;;1,0;5,0;6,0;3,0;;1,0;1,0;68,0;;;3,0;3,0;;2,0;14,0;;;;2,0;28,0;39,0;2,0;;;;13,0;;251,0;2,0;7,0;3,0;108,0;;;;;5,0;1,0;14,0;49,0;5,0;1,0;7,0;;;92,0;15,0;35,0;;7,0;7,0;235,0;27,0;73,0;82,0;1,0;37,0;3,0;252,0;18,0;88,0;6,0;5,0;8,0;4,0;490,0;14,0;10,0;32,0;;331,0;53,0;24,0;3,0;40,0;7,0;11,0;21,0;179,0;18,0;10,0;86,0;6,0;;23,0;32,0;4,0;29,0;105,0;;1,0;;4,0;5,0;2,0;;8,0;11,0;76,0;13,0;52,0;34,0;;2,0;;7,0;2,0;19,0;;28,0;79,0;3,0;;;3,0;36,0;10,0;32,0;25,0;2,0;18,0;166,0;;;2,0;7,0;;2,0;;6,0;65,0;3,0;11,0;94,0;5,0;14,0;16,0;1,0;;11,0;2,0;7,0;;4,0;32,0;44,0;43,0;25,0;;2,0;3,0;20,0;6,0;;12,0;1,0;48,0;5,0;3,0;69,0;31,0;2,0;84,0;5,0;1,0;1,0;14,0;1,0;1,0;3,0;1,0;;;1,0;4,0;;1,0;260,0;9,0;12,0;;;44,0;7,0;5,0;1,0;;5,0;1,0;;7,0;;;7,0;4,0;13,0;31,0;14,0;2,0;1,0;;;3,0;;27,0;6,0;4,0;13,0;;3,0;;10,0;510,0;6,0;4,0;4,0;2,0;2,0;8,0;3,0;12,0;;;;10,0;43,0;6,0;;11,0;;7,0;;18,0;2,0;10,0;6,0;;13,0;5,0;47,0;1,0;13,0;2,0;18,0;2,0;;4,0;26,0;127,0;;14,0;;;6,0;;;6,0;2,0;;3,0;;16,0;28,0;;46,0;;11,0;;;4,0;3,0;67,0;1,0;6,0;;27,0;;;2,0;7,0;6,0;9,0;15,0;2,0;17,0;119,0;19,0;9,0;;21,0;27,0;4,0;6,0;1,0;5,0;15,0;125,0;;;;12,0;65,0;;6,0;2,0;4,0;18,0;;;;1,0;4,0;3,0;3,0;4,0;1,0;;13,0;;55,0;3,0;;2,0;;7,0;20,0;2,0;23,0;3,0;38,0;;16,0;19,0;;19,0;4,0;27,0;2,0;;10,0;;3,0;;8,0;;5,0;2,0;42,0;108,0;1,0;3,0;150,0;7,0;;4,0;;1,0;;;24,0;9,0;10,0;;;5,0;;1,0;;16,0;1,0;1,0;1,0;;;14,0;17,0;7,0;3,0;8,0;77,0;27,0;;6,0;1,0;9,0;3,0;;2,0;3,0;;1,0;;10,0;;3,0;1,0;3,0;4,0;9,0;7,0;10,0;13,0;13,0;3,0;;;6,0;106,0;13,0;10,0;;14,0;;47,0;1,0;18,0;3,0;;;;17,0;;13,0;;;;;4,0;2,0;6,0;;;;11,0;1,0;;;;;;;;;16,0;;29,0;5,0;;;;;5,0;3,0;6,0;;;;3,0;3,0;;;4,0;;;;12,0;;;;7,0;;;;;10,0;;20,0;1,0;21,0;;;44,0;49,0;12,0;9,0;;;3,0;29,0;;;2,0;18,0;2,0;26,0;3,0;;1,0;1,0;;10,0;;;5,0;;57,0;;3,0;6,0;;8,0;;;;2,0;3,0;18,0;;3,0;14,0;;2,0;5,0;9,0;8,0;4,0;13,0;17,0;;39,0;3,0;1,0;;15,0;7,0;;7,0;;1,0;26,0;5,0;4,0;;3,0;23,0;14,0;1,0;24,0;5,0;;;18,0;2,0;1,0;2,0;4,0;7,0;;4,0;6,0;2,0;2,0;9,0;2,0;;2,0;12,0;2,0;1,0;;1,0;7,0;;4,0;6,0;2,0;1,0;3,0;;;9,0;;;;33,0;;;;1,0;2,0;;;;1,0;;2,0;;1,0;59,0;15,0;5,0;15,0;;;;;18,0;1,0;;;;;;;;2,0;;;;5,0;;;;27,0;;;;1,0;2,0;47,0;;10,0;;13,0;2,0;;;;;21,0;13,0;1,0;14,0;13,0;;3,0;1,0;45,0;;22,0;;;;;13,0;;;13,0;19,0;;;21,0;;2,0;;;7,0;;;;;;
file;;1,0;1,0;1,0;;19,0;;;14,0;;;;2,0;44,0;;;105,0;;2,0;15,0;;;2,0;18,0;26,0;;;6,0;31,0;3,0;17,0;5,0;;;;258,0;7,0;;;2,0;57,0;136,0;;264,0;19,0;;1,0;;;;4,0;;;4,0;5,0;;3,0;;;58,0;;;24,0;1,0;825,0;1,0;86,0;;;;;9,0;;;;;;1,0;102,0;32,0;85,0;;11,0;16,0;8,0;;;1,0;;;6,0;;1,0;7,0;;;1,0;;28,0;13,0;87,0;17,0;;20,0;9,0;20,0;1,0;16,0;;;;4,0;;3,0;;;25,0;18,0;5,0;3,0;19,0;;12,0;9,0;;111,0;42,0;;;;43,0;4,0;;18,0;;;9,0;;5,0;;;;;;;5,0;3,0;;66,0;6,0;;;;;3,0;;;;;;;1,0;22,0;6,0;;1,0;2,0;;;6,0;;;;2,0;;;;;2,0;;;;;2,0;;;1,0;;20,0;;;;;;;;2,0;;;;;;;;;43,0;;;8,0;2,0;3,0;4,0;;;;;3,0;;;4,0;;;;;;;59,0;;;6,0;;;;;;;3,0;;;7,0;;;;;;72,0;5,0;;;;;;;5,0;;;;;10,0;;86,0;30,0;1,0;29,0;;;;;;;;;;;;;1,0;4,0;;;;;;2,0;;;;;1,0;;;;;;;;4,0;;;;;;;;;;;1,0;3,0;5,0;;;;;;;8,0;;;;11,0;66,0;;;;;;;1,0;3,0;;;;;52,0;1,0;;;;;;;;;;1,0;10,0;3,0;;;;;4,0;;;;;;126,0;32,0;;;;;;;27,0;;;;;;1,0;1,0;2,0;;1,0;3,0;5,0;;12,0;2,0;;6,0;2,0;27,0;12,0;;;8,0;1,0;3,0;18,0;;1,0;;;33,0;12,0;2,0;;1,0;1,0;3,0;;22,0;2,0;;2,0;3,0;;3,0;;5,0;8,0;13,0;;;;8,0;;;;3,0;7,0;59,0;13,0;28,0;13,0;;;;8,0;3,0;3,0;;37,0;2,0;;7,0;;4,0;2,0;;1,0;7,0;;;13,0;;;;;;;;;2,0;15,0;1,0;39,0;7,0;6,0;13,0;2,0;4,0;;;7,0;;8,0;;23,0;21,0;;;;;;2,0;;;1,0;1,0;2,0;48,0;4,0;1,0;11,0;4,0;;;;4,0;;;;;9,0;;11,0;1,0;;;2,0;1,0;;;;3,0;21,0;;3,0;;1,0;;;22,0;;;1,0;;5,0;;;;;;;;;;;;2,0;1,0;;4,0;6,0;8,0;25,0;2,0;;25,0;6,0;8,0;2,0;;;1,0;;;1,0;4,0;55,0;6,0;1,0;26,0;;5,0;4,0;8,0;5,0;;3,0;1,0;2,0;;11,0;3,0;;;2,0;;;1,0;;;;;;;2,0;;;;;1,0;7,0;11,0;16,0;4,0;;;;4,0;1,0;;;;;;;2,0;2,0;;;;;;38,0;;;;;;;7,0;69,0;;;1,0;;8,0;3,0;;;;2,0;1,0;;4,0;;34,0;;;;;;;;;;;1,0;1,0;1,0;;2,0;;;;;;;2,0;2,0;4,0;11,0;;;29,0;26,0;2,0;;;;;;;26,0;;;;;;;12,0;79,0;4,0;;;;;3,0;1,0;4,0;;12,0;;2,0;;;;11,0;;;;;;;2,0;;;;;;;;;;;;58,0;;;;;;8,0;5,0;2,0;;;;;;;;;;;;;;;;;;;;;;;;1,0;1,0;;;;;;;;;;;;;;;;;;;;;;;;;;;;;;;1,0;;;;;;;1,0;;;;;;;;1,0;;;;3,0;;7,0;;;;;;;20,0;;;3,0;;;;;;;;;;;;;;;3,0;;;;;;;;;;;;;4,0;;;;;;;;;2,0;;;;3,0;;4,0;;;5,0;;;4,0;;2,0;;;;;;;;2,0;;;;;;;;;;;1,0;;;;3,0;5,0;;;;2,0;;;5,0;6,0;1,0;;5,0;;;18,0;;;;;1,0;1,0;5,0;;;;;;;;;;;;;;;;;;;;;;;;;;1,0;;;;;;;;;1,0;;;;;;;;;;;;;;;;;;;;1,0;;;;;;2,0;13,0;;;;;;;;;;;;;;2,0;;;;;;;;;;;;1,0;;;;;;;
filter;;13,0;5,0;63,0;24,0;132,0;501,0;42,0;3,0;;4,0;189,0;32,0;171,0;272,0;;77,0;1,0;99,0;36,0;24,0;;1110,0;;5,0;8,0;8,0;65,0;8,0;1,0;381,0;31,0;67,0;5,0;11,0;90,0;49,0;10,0;86,0;18,0;83,0;318,0;9,0;56,0;56,0;289,0;2,0;382,0;1,0;3,0;10,0;3,0;19,0;6,0;10,0;31,0;155,0;;64,0;125,0;72,0;285,0;124,0;2,0;850,0;23,0;641,0;9,0;8,0;4,0;1,0;432,0;759,0;12,0;;2,0;102,0;4,0;20,0;13,0;273,0;12,0;10,0;11,0;231,0;66,0;1,0;634,0;7,0;25,0;51,0;10,0;454,0;5,0;9,0;4,0;724,0;52,0;362,0;31,0;237,0;20,0;;40,0;78,0;53,0;8,0;38,0;8,0;2,0;1,0;33,0;164,0;6,0;4,0;;10,0;23,0;19,0;420,0;12,0;;205,0;28,0;482,0;26,0;171,0;;;17,0;73,0;3,0;;185,0;18,0;;16,0;7,0;4,0;7,0;1,0;51,0;;1,0;50,0;186,0;71,0;166,0;36,0;58,0;1,0;64,0;26,0;18,0;;1,0;4,0;39,0;29,0;33,0;14,0;21,0;5,0;20,0;7,0;3,0;87,0;97,0;5,0;19,0;9,0;1,0;25,0;56,0;;24,0;12,0;18,0;4,0;;6,0;16,0;3,0;8,0;;39,0;;5,0;134,0;91,0;;;;38,0;59,0;57,0;44,0;102,0;44,0;17,0;9,0;188,0;13,0;4,0;22,0;7,0;39,0;4,0;10,0;147,0;29,0;22,0;5,0;5,0;1,0;16,0;62,0;12,0;8,0;71,0;82,0;7,0;1,0;16,0;22,0;3,0;166,0;1,0;10,0;18,0;1,0;82,0;64,0;21,0;16,0;6,0;28,0;17,0;6,0;13,0;16,0;127,0;15,0;8,0;2,0;70,0;10,0;24,0;117,0;;13,0;9,0;27,0;35,0;70,0;20,0;54,0;133,0;20,0;;3,0;69,0;79,0;15,0;12,0;4,0;7,0;157,0;3,0;33,0;;8,0;11,0;41,0;16,0;2,0;69,0;41,0;;22,0;5,0;2,0;35,0;26,0;2,0;;6,0;6,0;63,0;17,0;;24,0;;;3,0;;15,0;;;12,0;;3,0;8,0;2,0;;6,0;1,0;2,0;10,0;167,0;;2,0;7,0;;13,0;;153,0;;10,0;2,0;7,0;72,0;32,0;19,0;5,0;6,0;19,0;;49,0;10,0;8,0;1,0;;12,0;15,0;15,0;4,0;;8,0;;57,0;4,0;2,0;;2,0;16,0;12,0;60,0;;3,0;1,0;;3,0;3,0;8,0;1,0;2,0;35,0;45,0;1,0;4,0;;1,0;15,0;;;9,0;45,0;;;13,0;;37,0;36,0;27,0;5,0;7,0;;3,0;1,0;76,0;12,0;2,0;4,0;1,0;19,0;8,0;38,0;;4,0;;13,0;27,0;28,0;7,0;28,0;;21,0;6,0;12,0;3,0;24,0;28,0;25,0;14,0;18,0;5,0;2,0;65,0;38,0;1,0;14,0;3,0;30,0;27,0;7,0;2,0;2,0;5,0;1,0;3,0;5,0;6,0;15,0;2,0;130,0;1,0;18,0;4,0;2,0;22,0;1,0;7,0;19,0;5,0;;6,0;13,0;107,0;;2,0;4,0;3,0;12,0;;12,0;;2,0;8,0;35,0;;3,0;11,0;3,0;;1,0;5,0;7,0;;21,0;6,0;43,0;10,0;9,0;;;5,0;;2,0;2,0;;;21,0;5,0;;;1,0;1,0;4,0;;29,0;;1,0;41,0;10,0;;75,0;1,0;1,0;11,0;1,0;;3,0;6,0;10,0;7,0;1,0;1,0;6,0;6,0;1,0;2,0;3,0;9,0;18,0;8,0;2,0;;1,0;9,0;6,0;21,0;;;4,0;19,0;;1,0;;1,0;1,0;7,0;4,0;21,0;2,0;;;;;;18,0;6,0;;24,0;8,0;;;14,0;1,0;11,0;;7,0;7,0;63,0;5,0;3,0;;8,0;;5,0;2,0;;3,0;7,0;6,0;7,0;9,0;5,0;;;1,0;;8,0;1,0;1,0;1,0;1,0;;;2,0;1,0;;;15,0;3,0;5,0;3,0;1,0;5,0;;6,0;1,0;48,0;1,0;7,0;5,0;;;2,0;12,0;;;;;;4,0;6,0;7,0;3,0;;9,0;;;15,0;7,0;1,0;8,0;4,0;28,0;;6,0;2,0;9,0;5,0;1,0;;;1,0;;161,0;;;41,0;6,0;;6,0;2,0;;5,0;;2,0;;;1,0;1,0;1,0;11,0;3,0;11,0;12,0;2,0;30,0;;2,0;;26,0;;15,0;;4,0;1,0;1,0;;;;10,0;5,0;9,0;16,0;2,0;;2,0;;2,0;7,0;;6,0;;;;44,0;;1,0;2,0;;1,0;;2,0;28,0;;1,0;1,0;;65,0;;9,0;22,0;1,0;15,0;12,0;;13,0;43,0;1,0;3,0;33,0;2,0;;;;;8,0;3,0;5,0;21,0;;1,0;1,0;;2,0;6,0;1,0;6,0;;10,0;9,0;1,0;19,0;2,0;12,0;;13,0;1,0;1,0;1,0;14,0;;;1,0;;;;1,0;1,0;24,0;;1,0;7,0;66,0;18,0;63,0;;3,0;16,0;;22,0;;82,0;;18,0;65,0;3,0;;4,0;2,0;1,0;;3,0;3,0;1,0;4,0;1,0;;;;6,0;16,0;;1,0;;12,0;3,0;3,0;2,0;;1,0;1,0;;45,0;3,0;;5,0;;2,0;38,0;20,0;;8,0;;;3,0;5,0;3,0;37,0;1,0;;9,0;3,0;;5,0;2,0;;4,0;24,0;3,0;16,0;;2,0;4,0;15,0;4,0;7,0;16,0;17,0;1,0;;4,0;;;;;29,0;2,0;1,0;6,0;;4,0;70,0;9,0;1,0;4,0;12,0;18,0;;;60,0;;5,0;5,0;;8,0;;2,0;6,0;;;23,0;1,0;4,0;;18,0;;3,0;2,0;;;5,0;;2,0;2,0;6,0;22,0;1,0;25,0;;1,0;3,0;4,0;6,0;8,0;3,0;;4,0;1,0;8,0;3,0;;;1,0;;3,0;;3,0;;7,0;;;;;;;8,0;7,0;4,0;;;;37,0;1,0;;;;1,0;;;;13,0;30,0;28,0;;3,0;;15,0;;;;;;;;;;4,0;;;6,0;10,0;39,0;4,0;;;;;10,0;;8,0;2,0;;;;;3,0;10,0;;;;8,0;2,0;;;2,0;;3,0;;3,0;;2,0;;7,0;9,0;;;22,0;12,0;154,0;;;;5,0;;15,0;;5,0;2,0;2,0;2,0;7,0;4,0;88,0;;2,0;1,0;4,0;;2,0;1,0;;3,0;7,0;;;28,0;;;;;1,0;;;
finder;;2,0;;;2,0;11,0;;;;;;;4,0;3,0;;;9,0;;;;;;;;;;;;;;18,0;6,0;1,0;;;4,0;;3,0;1,0;1,0;6,0;45,0;;2,0;82,0;4,0;;;;;;;1,0;;;;14,0;;;3,0;;;;;84,0;;14,0;2,0;;;;14,0;5,0;;;;;;;;14,0;;10,0;;;;;74,0;;6,0;;;;;;;;;1,0;11,0;17,0;6,0;2,0;;2,0;8,0;;;;;;;7,0;;;;;;;4,0;;;10,0;;;3,0;19,0;;;;1,0;;;55,0;;;84,0;5,0;;;;;;;1,0;;3,0;3,0;1,0;7,0;;;7,0;;;;;3,0;;;;4,0;;;;;4,0;;2,0;4,0;;;;3,0;;;;;;;;;;1,0;;;6,0;;;11,0;;;;;;1,0;;6,0;;;;;;;;1,0;9,0;;1,0;2,0;1,0;1,0;1,0;;;;8,0;;;5,0;18,0;;;;3,0;;;;1,0;;;;17,0;1,0;;;1,0;1,0;;;;2,0;;;;;;;17,0;;;;;13,0;;7,0;1,0;3,0;;;;3,0;;;15,0;;;6,0;;30,0;;;;;;2,0;1,0;1,0;;;4,0;;17,0;;;;;12,0;1,0;;;;;1,0;;;3,0;;;;;;;;;;;2,0;;2,0;;;;;;;5,0;;;2,0;;8,0;;;;;;;1,0;;;;;;;;;;;;1,0;5,0;;;;;1,0;;;;;;;;;;;2,0;3,0;;;;;;;3,0;;;;;;;;3,0;2,0;1,0;;;;;11,0;;;;;2,0;;;;;;;;4,0;;1,0;;3,0;2,0;;;;;;;1,0;;;;;;;3,0;1,0;9,0;1,0;2,0;;;;;4,0;;;;2,0;;4,0;;;2,0;;4,0;;5,0;;1,0;25,0;;;;;;;;;;;9,0;;;1,0;;;;;;;;;1,0;;;;;;;;;;;1,0;;3,0;;;9,0;;7,0;;;;;3,0;;;2,0;;2,0;;;;;1,0;;2,0;14,0;;;;;;;;;1,0;;;;;;;;;;;;13,0;;;;;;;;;;;;;;;;3,0;2,0;;;;;;;;18,0;10,0;;;;;;;;;;;;;;;;;;3,0;;;;;2,0;;;;;;;;;;;;;1,0;;;4,0;;1,0;;;;;2,0;;;;;;;;4,0;;;;;;1,0;;;;;;;;;;;;;;;;;;;;;;;3,0;;;;;;;;;;;;1,0;;;;;2,0;;;;;;;;;;;;1,0;2,0;;;;;;;;22,0;;;;;;;;;;;;3,0;;13,0;;;1,0;;;;;10,0;;;;;;;;;1,0;;;;;;;;;;;;;4,0;;;1,0;;;;;;;;;;;;;;;;;;;;;;;;;;4,0;1,0;;;;;;;;7,0;1,0;;;;;;;;2,0;;;;;;;;;;;;;;;;;;;;;;;2,0;;1,0;;;;;;;;;;;;;;;;;;;;;;;;;;;;;;;1,0;;;;;;;;;;;;;;;1,0;2,0;;;;;;;;;;;;;;;;;;;;;;;4,0;;;;;;;;;;;;;;;;6,0;1,0;;;;;3,0;;;;;;;;;;;1,0;;;;;;;;;;;;;;;;;;;;;;;;;;;;;;;;;;;;;;;;;;;;;;;;;;;;;;;;;;;;;3,0;;;;;;;;;;;;;;;;;;;;4,0;;;;;;;;6,0;2,0;;;;;7,0;;;;;;;;1,0;;;;3,0;;;;;;;;;
fitting;;1,0;;;;2,0;;7,0;;10,0;;;1,0;37,0;;;5,0;;;;;1,0;1,0;;6,0;;;1,0;1,0;;32,0;;;;;9,0;5,0;;12,0;1,0;17,0;12,0;1,0;1,0;;7,0;;5,0;;3,0;;;15,0;;1,0;;16,0;;;5,0;;;;;23,0;2,0;10,0;;16,0;;;10,0;4,0;;;;2,0;5,0;;;31,0;;;17,0;43,0;;;1,0;;;2,0;;1,0;;;;7,0;24,0;24,0;13,0;17,0;1,0;;1,0;1,0;17,0;;1,0;;;;4,0;14,0;;3,0;;2,0;4,0;2,0;7,0;;;;3,0;;;20,0;;;;7,0;1,0;;1,0;;2,0;1,0;21,0;;;;2,0;;;1,0;;;;;6,0;;2,0;5,0;1,0;;;2,0;;;;;7,0;;;;;18,0;3,0;1,0;;;;;4,0;3,0;1,0;;;;;;1,0;;3,0;1,0;;1,0;4,0;7,0;2,0;;4,0;;5,0;1,0;6,0;24,0;;5,0;1,0;;;;;;;3,0;;;23,0;2,0;3,0;2,0;;;3,0;8,0;;;;1,0;;;;9,0;;12,0;;;;1,0;;2,0;;4,0;2,0;;;;;;5,0;;2,0;;;;1,0;8,0;;12,0;;;3,0;;;19,0;33,0;1,0;;;;;1,0;1,0;;;;;4,0;;;2,0;;;;4,0;4,0;;;10,0;;1,0;3,0;6,0;;2,0;;1,0;;1,0;;1,0;2,0;27,0;1,0;4,0;;1,0;10,0;;;;;;1,0;;23,0;;;;;2,0;;;;;2,0;4,0;1,0;;;2,0;;;;;21,0;;1,0;6,0;;;1,0;;;4,0;;;;9,0;5,0;;;1,0;5,0;10,0;;1,0;;;;1,0;;1,0;12,0;;;1,0;;;;;;;8,0;;;;1,0;;;14,0;;;;;;;;;3,0;;1,0;3,0;;;;2,0;3,0;;2,0;1,0;;;12,0;;4,0;1,0;;;;;;1,0;4,0;;1,0;1,0;2,0;1,0;8,0;;;;;1,0;;2,0;;;;;;;9,0;;;;2,0;1,0;;;;;1,0;;;;;;;;;;;;;1,0;;;;;6,0;3,0;;;;;;1,0;;;;;;;;;;;;3,0;;1,0;44,0;;1,0;;;;;;3,0;;;3,0;2,0;;1,0;;;;;;4,0;1,0;;;;;;;;2,0;;;;;;;;2,0;;;;;;;;2,0;4,0;;;;;6,0;;7,0;;;;1,0;1,0;;;;;;2,0;;;11,0;;;10,0;;;;;;;;;;1,0;;;;;;;;;;;;;;;;1,0;;11,0;3,0;;;4,0;2,0;;;;;13,0;5,0;;2,0;;;;;;;4,0;;;;;1,0;5,0;;3,0;;9,0;;;2,0;;;;;;;4,0;;;5,0;;;;;;4,0;;;;;;;;;;;14,0;;;;;1,0;;;;;;;;;;;;;;;;;2,0;;;8,0;;;;;;;;;;;;;;;;;;;;;;;;;;;;;;;;;;;;;;;3,0;;;;;;1,0;;;1,0;2,0;4,0;;1,0;;;;;;;;;;;4,0;;;;2,0;37,0;;;;;;;;3,0;;1,0;11,0;;;;3,0;;4,0;;;;;;;;;;;;;4,0;2,0;;;3,0;;8,0;2,0;;;;;2,0;;;11,0;13,0;;;;3,0;;;;3,0;;;;1,0;;;;;;;;;;;;;;;;;;;;;;;;6,0;;;;;;;;;;;;;9,0;;;9,0;;;;;;;;;;;1,0;;;1,0;;;1,0;;;;;;;;;3,0;;;;1,0;;9,0;;;;;;;;;;;;;;;1,0;;;;;;;;1,0;3,0;;;;;;;;;;;;;;;;;;;;;;;;1,0;;;;;;;;;;;1,0;;;;;;3,0;;;;3,0;;1,0;;;;;;2,0;;;;;;;5,0;;;;;;;;;;8,0;;;;;;;;;;;;;;;;;;;;;;1,0;;;;1,0;;;;;;;;;;;;;1,0;1,0;;;;;;;;;
flange;;1,0;;4,0;2,0;15,0;1,0;33,0;;;;;26,0;14,0;;;;;15,0;;;;;;;;;1,0;;;15,0;2,0;;;;;10,0;1,0;;;1,0;15,0;25,0;;;42,0;;42,0;;;;2,0;69,0;4,0;1,0;12,0;28,0;;;;;;1,0;1,0;22,0;;60,0;;;;28,0;79,0;2,0;;;;5,0;;;;15,0;;;;11,0;2,0;;12,0;;;;13,0;;20,0;1,0;;1,0;23,0;26,0;;27,0;1,0;;;1,0;;;;;;;14,0;2,0;2,0;;;;11,0;;12,0;;;;4,0;;;7,0;;;2,0;;;4,0;35,0;4,0;;;;;;10,0;7,0;2,0;;8,0;;;2,0;;19,0;;4,0;23,0;25,0;;;12,0;;;;1,0;19,0;;;;;38,0;9,0;;;;;;8,0;9,0;11,0;;;;;;;;5,0;4,0;;3,0;3,0;3,0;10,0;;;;;30,0;9,0;55,0;;23,0;5,0;;;3,0;;;;24,0;;;90,0;2,0;;1,0;1,0;;22,0;;3,0;;2,0;;;;;22,0;;175,0;;4,0;1,0;18,0;;;;8,0;;;;2,0;;6,0;8,0;;;15,0;4,0;;5,0;43,0;8,0;9,0;5,0;;10,0;6,0;;7,0;88,0;6,0;;;;;2,0;11,0;;;;;;;2,0;;3,0;1,0;;2,0;17,0;;;5,0;;16,0;12,0;;;;;14,0;;1,0;1,0;;2,0;;2,0;38,0;;;30,0;6,0;;1,0;;11,0;2,0;;3,0;2,0;7,0;;;4,0;3,0;;;4,0;;;;;;12,0;6,0;;12,0;;6,0;;;;2,0;7,0;5,0;;;;22,0;;;2,0;6,0;;;2,0;33,0;4,0;2,0;;3,0;1,0;;;;;9,0;18,0;11,0;;;;;;;;;;;;;3,0;;;4,0;;;;;;;;;;2,0;;1,0;;5,0;;;;;;1,0;;1,0;;;;;;;5,0;;;;;1,0;;2,0;;;;5,0;2,0;;;;;;;;;;;5,0;;;;5,0;;;;;;;;;;;;7,0;;;;;;;;;;;;;3,0;;;;;;;3,0;;;;;;;;;;;;1,0;;;;;;;;;;;;;;;;;;1,0;1,0;6,0;;;;3,0;;;;;;;;7,0;;;;;;;;;;;;;;;;;;;;;12,0;;;;3,0;;;2,0;22,0;;;;2,0;;;;;12,0;;;;;4,0;;;;;;;;;;;;;;;;;;;;2,0;;;;;3,0;1,0;;;;40,0;;;2,0;;;1,0;2,0;7,0;;;;;;;;2,0;;;;;;;;;2,0;;;;;;;;;;;;;;;;3,0;;;;;;;;;;;;;;7,0;4,0;;;;4,0;;2,0;;;;;;;;;;;;;;;2,0;;;;;;;;;;;;;;;;;;;;;;;;;;2,0;;;;;;;5,0;;;6,0;;;;13,0;;9,0;1,0;;;1,0;;;5,0;;;3,0;;;;;3,0;;8,0;;;;12,0;;;;12,0;;;;;;;;1,0;;3,0;;2,0;;1,0;1,0;3,0;1,0;;;;1,0;;;;;;;;10,0;6,0;;;11,0;;;;;;;2,0;;3,0;;;;;;;8,0;;;;;;4,0;;;;;3,0;;3,0;;;4,0;;;;;;;;;;;;;;;;;1,0;;;;;;;;;;;;;;;;;;;;;;;1,0;;;;;;;;;;1,0;;;;;;;;;;;;;;;;;;;;;;;;;;3,0;;;;;;;;;;;;;;;;;;;;;;;;;;;;;;;;;;;;;;;;;;;3,0;;3,0;;;;;;2,0;;1,0;;;;;;;;;;;;;;;;;10,0;;;;;;;4,0;;;;;;1,0;;;;;;;;;;;;;;46,0;;;;;;;;;;;;52,0;;;;;;;;;;;;;;;;;;;;;;;;;;;
flash;;4,0;;49,0;59,0;35,0;6,0;10,0;;;;;;57,0;;33,0;46,0;;2,0;2,0;2,0;;52,0;2,0;4,0;;1,0;7,0;9,0;4,0;49,0;28,0;4,0;1,0;;24,0;15,0;1,0;;2,0;53,0;247,0;1,0;11,0;8,0;13,0;;31,0;;;;1,0;6,0;28,0;6,0;3,0;10,0;;;71,0;1,0;;;;202,0;4,0;40,0;2,0;;;16,0;44,0;253,0;4,0;;;3,0;16,0;6,0;38,0;54,0;;93,0;6,0;98,0;12,0;;26,0;;;10,0;;14,0;1,0;8,0;;2,0;2,0;33,0;11,0;30,0;5,0;;2,0;6,0;31,0;7,0;9,0;1,0;;;14,0;7,0;;2,0;;;28,0;30,0;35,0;34,0;;33,0;;1,0;3,0;92,0;;2,0;3,0;25,0;2,0;;210,0;;2,0;4,0;;2,0;;;2,0;;;4,0;23,0;7,0;4,0;13,0;5,0;;;7,0;;1,0;5,0;;;;;3,0;23,0;;;;;10,0;3,0;1,0;11,0;3,0;;28,0;25,0;;7,0;;64,0;2,0;;1,0;;2,0;21,0;;;4,0;;16,0;2,0;;1,0;;;;3,0;13,0;2,0;2,0;;;6,0;;;1,0;6,0;3,0;;2,0;25,0;3,0;8,0;;1,0;1,0;;31,0;;;12,0;5,0;12,0;;;;8,0;3,0;1,0;7,0;11,0;;;5,0;3,0;3,0;;3,0;;2,0;2,0;;5,0;10,0;;;17,0;;1,0;2,0;;;4,0;1,0;9,0;7,0;;3,0;9,0;;;;20,0;1,0;8,0;;;;13,0;;4,0;;5,0;;10,0;;;1,0;7,0;;;;4,0;;;;;;23,0;6,0;3,0;;4,0;;;;;12,0;4,0;2,0;;;;3,0;2,0;;3,0;;;1,0;18,0;;;;;;;4,0;1,0;1,0;2,0;17,0;30,0;1,0;;6,0;1,0;3,0;;35,0;4,0;;;;2,0;5,0;;;;;;6,0;1,0;;;;1,0;;5,0;;2,0;;;10,0;7,0;;1,0;4,0;1,0;6,0;;;;;;12,0;6,0;12,0;1,0;;5,0;;;6,0;2,0;;2,0;;2,0;;16,0;58,0;8,0;1,0;1,0;11,0;9,0;2,0;1,0;1,0;24,0;3,0;1,0;;4,0;;13,0;;1,0;18,0;;;2,0;6,0;1,0;;10,0;1,0;;5,0;5,0;;8,0;;5,0;9,0;4,0;;1,0;;4,0;;1,0;11,0;;4,0;34,0;98,0;10,0;;;3,0;;86,0;;2,0;;3,0;10,0;5,0;1,0;10,0;3,0;36,0;;4,0;8,0;;;12,0;2,0;3,0;16,0;3,0;13,0;;9,0;;;;3,0;3,0;1,0;2,0;;;;;1,0;;;5,0;;13,0;7,0;;;40,0;;3,0;;;;;4,0;;;5,0;;5,0;;;;;8,0;2,0;4,0;;1,0;3,0;;;6,0;;2,0;;;1,0;;;;;;1,0;2,0;;2,0;;1,0;1,0;;;14,0;;1,0;;;2,0;;;;;8,0;;3,0;;;;;1,0;6,0;;;;22,0;;14,0;;2,0;12,0;;;9,0;;;1,0;8,0;2,0;;;;7,0;2,0;1,0;;;;1,0;;3,0;5,0;;;1,0;;;2,0;1,0;;;;5,0;;1,0;;;2,0;;;1,0;2,0;;;2,0;;;;;;;7,0;;4,0;;6,0;3,0;;;;19,0;;;;;;;;8,0;;;1,0;8,0;;16,0;;;;;;;;8,0;1,0;;;;;;;1,0;2,0;;8,0;;5,0;4,0;5,0;;2,0;;1,0;1,0;;;2,0;;;1,0;2,0;2,0;;;2,0;;;12,0;;;;1,0;;83,0;;;42,0;;;;;5,0;;2,0;;;12,0;3,0;24,0;7,0;16,0;;;2,0;3,0;;;;2,0;;11,0;;;24,0;;;13,0;2,0;;2,0;;;;;;;;;36,0;;;;;;;;;3,0;1,0;6,0;;;1,0;;4,0;;6,0;1,0;;;;3,0;2,0;4,0;2,0;;;1,0;2,0;1,0;5,0;7,0;28,0;;;;;;;;;1,0;;59,0;;;;;;;;;1,0;8,0;;3,0;;;;;;;;;;;;;2,0;;;;;;;;;;;8,0;1,0;;;7,0;;;9,0;;;;3,0;;;;;;;;;;;;;;;;;;2,0;;1,0;4,0;;;;1,0;;;;;;;;13,0;;;;;2,0;2,0;;2,0;;;3,0;;2,0;;3,0;1,0;;3,0;;1,0;35,0;;;;;;3,0;;12,0;;;;;;;;21,0;;1,0;;;;1,0;;;3,0;;;;;2,0;;;;;;;;6,0;;;;3,0;;;5,0;;;14,0;2,0;;;8,0;;1,0;1,0;;15,0;2,0;4,0;;;1,0;;;;;22,0;;;;;1,0;1,0;;;;;;;;5,0;;;;;;;;;;;;;;;;;;;;;2,0;;;;;;;;;;;;;;;;;9,0;;;;;;;;;;;;;;;;;2,0;;
flat;;1,0;;;;18,0;7,0;7,0;;;;1,0;1,0;52,0;;;10,0;;;;;;2,0;;;1,0;2,0;4,0;;;11,0;;;1,0;;5,0;9,0;1,0;1,0;4,0;3,0;33,0;2,0;;18,0;16,0;;41,0;;;;3,0;21,0;;3,0;;17,0;;;;4,0;;;;37,0;;50,0;2,0;;4,0;1,0;54,0;23,0;;;;3,0;1,0;;1,0;34,0;5,0;4,0;2,0;13,0;4,0;;31,0;;;;6,0;7,0;1,0;;;1,0;19,0;31,0;3,0;19,0;13,0;2,0;;1,0;;;;5,0;;;11,0;7,0;2,0;;;;;10,0;20,0;;;5,0;;3,0;2,0;33,0;;;;;;;10,0;;2,0;1,0;;;;;3,0;;;4,0;4,0;1,0;8,0;2,0;12,0;;10,0;15,0;26,0;;1,0;;3,0;;;;12,0;;;;;24,0;16,0;3,0;;19,0;;1,0;12,0;3,0;10,0;;9,0;;;;;5,0;40,0;4,0;6,0;6,0;3,0;5,0;29,0;;6,0;;15,0;9,0;9,0;13,0;5,0;9,0;;5,0;7,0;2,0;;1,0;1,0;26,0;4,0;8,0;27,0;;;;4,0;1,0;26,0;;20,0;2,0;;2,0;;;;55,0;;64,0;3,0;;;4,0;;3,0;;2,0;;;;2,0;;4,0;;4,0;;;1,0;;41,0;64,0;1,0;6,0;;2,0;15,0;17,0;;3,0;317,0;;;1,0;;;7,0;6,0;;;5,0;1,0;1,0;;;3,0;3,0;11,0;;;23,0;;7,0;1,0;;6,0;11,0;;;;1,0;6,0;5,0;6,0;5,0;;2,0;;1,0;7,0;;1,0;5,0;;3,0;9,0;;;4,0;4,0;2,0;2,0;9,0;15,0;1,0;1,0;;;1,0;4,0;2,0;1,0;;7,0;22,0;3,0;;27,0;2,0;;;;3,0;4,0;1,0;10,0;4,0;;6,0;;;;1,0;1,0;;;1,0;5,0;8,0;;6,0;;34,0;;2,0;;1,0;2,0;1,0;1,0;12,0;2,0;;;;;;;1,0;3,0;;;;;;2,0;9,0;;3,0;;;;;3,0;;;7,0;;1,0;;;;;;;;1,0;;1,0;;;;;;;;3,0;;;;1,0;1,0;1,0;;;;;;;;;;;;;1,0;;;14,0;;;;;;;;;;;;6,0;2,0;;3,0;1,0;3,0;4,0;;1,0;;3,0;;;1,0;;;;4,0;;;1,0;1,0;;;4,0;;;;;;;;;;4,0;;1,0;1,0;4,0;;;;;10,0;;;;;;1,0;;;;2,0;;1,0;6,0;2,0;1,0;1,0;;;;;;;;;4,0;1,0;;;;;;1,0;;;4,0;;;;2,0;;1,0;;4,0;;;6,0;;;;;;;2,0;1,0;;1,0;;;1,0;;;1,0;;;;;;;;;;;;;;;;;;;;;;;;;1,0;;;;;;;3,0;2,0;;;;;;;;6,0;;5,0;;;;;;;;;;;;1,0;;;;;;3,0;;;;;;;;;;4,0;;;;;;2,0;;;;;;;1,0;;;;;;;;;;;;3,0;;3,0;;3,0;2,0;;;;3,0;;2,0;;;;;;;;;;1,0;;;;;3,0;;;;2,0;;4,0;;1,0;;;;;;2,0;;;;;;;;;;;;;24,0;;;2,0;19,0;;38,0;;;;;1,0;1,0;;2,0;1,0;10,0;;;;;;;;1,0;;;;;;;2,0;;;;2,0;;2,0;;;;;1,0;14,0;;3,0;3,0;;;2,0;;3,0;5,0;;;;;4,0;;;1,0;;;3,0;8,0;2,0;;1,0;;2,0;2,0;;3,0;;;6,0;;;;;;24,0;;;;5,0;;5,0;;;;;;7,0;;;1,0;;1,0;;;;;;;2,0;;;;;;7,0;;;;;;;6,0;;;;;;4,0;1,0;;;;5,0;;;;;1,0;;;;;;2,0;;;;;;1,0;;;1,0;;;;;;2,0;;1,0;;;;;;;;;;;;;1,0;;;;;;;;;;10,0;;;;;;;;;2,0;;;1,0;;;;;;4,0;;;;;;;;;;;;;;;;;2,0;;10,0;;;;;;;;2,0;;;;;;;;;;;3,0;;;;;;9,0;;4,0;;;;;3,0;;;;;;;;;;;2,0;;7,0;;;;;;;;;;2,0;;;4,0;1,0;;;;;;;;;;6,0;;;;;;;;;;;;;;;;;;7,0;;;;
focus;;2,0;25,0;259,0;217,0;177,0;63,0;120,0;;;2,0;2,0;11,0;408,0;;5,0;153,0;3,0;7,0;12,0;5,0;;47,0;7,0;10,0;3,0;14,0;27,0;14,0;264,0;280,0;135,0;63,0;30,0;1,0;75,0;15,0;12,0;183,0;1,0;324,0;341,0;9,0;48,0;58,0;37,0;1,0;97,0;;4,0;42,0;2,0;;17,0;70,0;75,0;38,0;;12,0;68,0;1,0;;140,0;;888,0;2,0;263,0;19,0;2,0;2,0;73,0;1938,0;177,0;8,0;46,0;9,0;7,0;8,0;5,0;23,0;326,0;7,0;161,0;;155,0;82,0;1,0;286,0;26,0;14,0;36,0;;10,0;6,0;26,0;;444,0;55,0;195,0;79,0;923,0;94,0;1,0;36,0;60,0;46,0;4,0;5,0;5,0;5,0;;38,0;115,0;15,0;;;3,0;16,0;107,0;157,0;8,0;4,0;123,0;16,0;;20,0;496,0;5,0;6,0;3,0;104,0;12,0;;306,0;26,0;;52,0;12,0;169,0;;;2,0;;4,0;67,0;20,0;195,0;44,0;26,0;9,0;;2,0;24,0;10,0;;;;;;;6,0;16,0;;31,0;2,0;;37,0;4,0;3,0;558,0;87,0;17,0;8,0;108,0;;2,0;;4,0;28,0;;;;;20,0;;3,0;28,0;10,0;70,0;18,0;;;6,0;7,0;7,0;4,0;25,0;32,0;164,0;;;5,0;43,0;;78,0;8,0;130,0;;2,0;10,0;184,0;79,0;12,0;;;4,0;84,0;3,0;5,0;25,0;11,0;10,0;6,0;10,0;;;67,0;;;13,0;;49,0;116,0;17,0;12,0;;5,0;;;40,0;;106,0;26,0;;1,0;101,0;47,0;9,0;44,0;;;;4,0;19,0;8,0;1,0;16,0;62,0;4,0;;16,0;37,0;3,0;;;3,0;1,0;11,0;24,0;131,0;;1,0;70,0;9,0;;;8,0;22,0;1,0;7,0;2,0;71,0;102,0;1,0;4,0;3,0;8,0;25,0;5,0;;14,0;6,0;;6,0;1,0;2,0;365,0;8,0;6,0;10,0;;1,0;2,0;;;;1,0;3,0;21,0;162,0;1,0;;1,0;1,0;6,0;1,0;27,0;52,0;3,0;19,0;9,0;217,0;6,0;;;;21,0;1,0;18,0;;;;;;7,0;3,0;2,0;;;;17,0;22,0;1,0;2,0;;6,0;20,0;14,0;;2,0;;;5,0;3,0;13,0;1,0;;6,0;90,0;1,0;17,0;19,0;2,0;3,0;2,0;311,0;11,0;2,0;;104,0;;;110,0;10,0;121,0;28,0;;35,0;9,0;3,0;501,0;9,0;1,0;9,0;15,0;239,0;20,0;104,0;3,0;;23,0;15,0;5,0;;;46,0;2,0;13,0;51,0;2,0;;97,0;2,0;46,0;1,0;33,0;3,0;3,0;61,0;118,0;15,0;131,0;1,0;17,0;188,0;7,0;;;4,0;;1,0;36,0;5,0;13,0;1,0;87,0;3,0;27,0;3,0;1,0;12,0;;273,0;;47,0;;18,0;189,0;11,0;;8,0;13,0;32,0;11,0;;7,0;3,0;2,0;113,0;;;4,0;16,0;8,0;;;4,0;34,0;;2,0;30,0;1,0;;1,0;1,0;;;4,0;5,0;;10,0;9,0;7,0;5,0;;;1,0;;1,0;1,0;21,0;9,0;;16,0;13,0;1,0;122,0;6,0;8,0;;;;10,0;12,0;1,0;;11,0;1,0;3,0;4,0;2,0;;4,0;20,0;;;2,0;;;;3,0;3,0;4,0;;2,0;14,0;;24,0;2,0;;;;;;;;1,0;;;;8,0;6,0;;13,0;;;4,0;35,0;38,0;2,0;;13,0;12,0;25,0;4,0;17,0;;;8,0;9,0;;;;2,0;1,0;13,0;;;;;4,0;6,0;;6,0;5,0;3,0;1,0;1,0;2,0;7,0;;16,0;;21,0;8,0;4,0;1,0;39,0;1,0;1,0;12,0;;35,0;1,0;14,0;1,0;;4,0;15,0;5,0;;;;12,0;;;;4,0;2,0;;50,0;;;14,0;4,0;;;4,0;;11,0;1,0;4,0;;;4,0;;1,0;1,0;;92,0;6,0;3,0;4,0;36,0;;;1,0;8,0;;10,0;;;;1,0;;;;6,0;1,0;36,0;1,0;;1,0;;1,0;17,0;6,0;2,0;;8,0;1,0;;1,0;;7,0;;6,0;1,0;4,0;;;9,0;;56,0;12,0;5,0;;;1,0;;1,0;;;6,0;1,0;1,0;2,0;3,0;56,0;;;1,0;;;;1,0;2,0;;1,0;3,0;;1,0;;7,0;1,0;13,0;14,0;23,0;3,0;3,0;;6,0;12,0;120,0;250,0;;11,0;;;6,0;4,0;;1,0;;1,0;7,0;;2,0;36,0;25,0;;1,0;;;;2,0;;;6,0;5,0;;;1,0;4,0;22,0;1,0;;;1,0;;17,0;;1,0;5,0;;29,0;7,0;4,0;;308,0;;2,0;;;1,0;;;35,0;;;;1,0;1,0;;;;;;;;28,0;3,0;;;;;;;2,0;;;;1,0;10,0;;2,0;1,0;;;;;2,0;;;1,0;;23,0;;;;;;5,0;52,0;;7,0;;1,0;;;20,0;;;;1,0;10,0;;5,0;;;;2,0;;;;;3,0;3,0;55,0;;1,0;;32,0;;7,0;16,0;;8,0;23,0;1,0;;;;24,0;6,0;8,0;;3,0;2,0;;;1,0;5,0;;4,0;;;;;;7,0;;;21,0;;;;13,0;14,0;;2,0;;31,0;23,0;;;4,0;;;;3,0;19,0;;3,0;;;3,0;6,0;;1,0;;1,0;1,0;;;3,0;31,0;;1,0;;;;3,0;1,0;2,0;2,0;;17,0;;;;4,0;1,0;2,0;;12,0;5,0;;;3,0;;10,0;1,0;;;;1,0;;;2,0;2,0;1,0;;;;2,0;2,0;;;;1,0;;45,0;;;4,0;;3,0;;5,0;4,0;;8,0;;3,0;4,0;;1,0;;2,0;;6,0;21,0;1,0;2,0;;3,0;;;;;17,0;9,0;2,0;;;2,0;;;4,0;;;;;3,0;3,0;9,0;;27,0;9,0;;;;;;;;;1,0;
force;;1,0;;7,0;7,0;14,0;14,0;35,0;;;;;4,0;74,0;;;10,0;;2,0;;1,0;;;;;;6,0;31,0;;9,0;75,0;2,0;;4,0;5,0;11,0;5,0;9,0;;;16,0;70,0;;5,0;8,0;13,0;;32,0;;;;1,0;5,0;34,0;9,0;;15,0;6,0;2,0;132,0;;;1,0;;39,0;;40,0;14,0;;2,0;;104,0;1,0;14,0;;14,0;1,0;23,0;;12,0;54,0;;7,0;;62,0;8,0;4,0;30,0;;6,0;;7,0;4,0;3,0;;;;40,0;15,0;10,0;77,0;16,0;;1,0;2,0;3,0;;;;;;2,0;1,0;2,0;2,0;5,0;;9,0;;55,0;3,0;2,0;8,0;;;6,0;23,0;;2,0;;3,0;;;60,0;3,0;;1,0;;;7,0;;1,0;1,0;;11,0;221,0;1,0;8,0;11,0;20,0;115,0;3,0;22,0;4,0;;;;;;;2,0;11,0;;;;;22,0;7,0;;4,0;;;7,0;177,0;6,0;8,0;19,0;;10,0;;;;1,0;11,0;1,0;;5,0;;28,0;13,0;;;1,0;7,0;12,0;8,0;40,0;1,0;3,0;;;;7,0;2,0;19,0;;157,0;;28,0;99,0;65,0;31,0;;;;6,0;6,0;2,0;;2,0;;1,0;;;12,0;;137,0;9,0;1,0;13,0;;;5,0;;2,0;;;;1,0;6,0;;7,0;15,0;;;2,0;;4,0;34,0;12,0;;2,0;2,0;17,0;3,0;6,0;27,0;60,0;;;6,0;15,0;;9,0;1,0;;;;5,0;4,0;;;62,0;3,0;;;7,0;3,0;;10,0;4,0;3,0;52,0;2,0;;3,0;12,0;7,0;12,0;2,0;75,0;4,0;;;;1,0;8,0;;53,0;12,0;2,0;3,0;2,0;3,0;;5,0;3,0;3,0;1,0;4,0;2,0;;4,0;;;14,0;2,0;10,0;5,0;3,0;2,0;12,0;22,0;1,0;;;;;2,0;3,0;;3,0;14,0;4,0;;;2,0;7,0;1,0;;32,0;30,0;18,0;6,0;;8,0;;3,0;;135,0;;1,0;;;2,0;4,0;;7,0;7,0;;;3,0;17,0;12,0;;8,0;;;;;2,0;5,0;3,0;11,0;35,0;;;1,0;;1,0;24,0;;;;;35,0;;;;;12,0;;;10,0;4,0;4,0;;;;;8,0;3,0;1,0;22,0;20,0;9,0;1,0;1,0;5,0;27,0;5,0;38,0;;13,0;2,0;;1,0;1,0;;;;2,0;1,0;;;14,0;;46,0;11,0;;28,0;;4,0;2,0;4,0;3,0;;3,0;17,0;;8,0;2,0;59,0;26,0;;;;;24,0;1,0;;2,0;3,0;23,0;8,0;;;;;;;1,0;;3,0;;;;;;;;;;3,0;;6,0;;2,0;;;120,0;4,0;22,0;;3,0;;2,0;6,0;5,0;;;;17,0;1,0;;;;3,0;;2,0;;;;;;3,0;;;;;;;2,0;;8,0;;1,0;8,0;;5,0;3,0;6,0;;;;;5,0;;;;8,0;;1,0;7,0;5,0;;;;2,0;;;1,0;4,0;7,0;;;;1,0;1,0;;;;;10,0;;;;;;;;1,0;4,0;5,0;;;;24,0;;;;12,0;;4,0;1,0;1,0;;;2,0;;;;;1,0;;;58,0;;;1,0;;;;;7,0;;2,0;;2,0;;1,0;;;;;;;;;;;12,0;;;;;;;;;;;1,0;;;;;;;;;;;;;;;2,0;12,0;;;;;;;2,0;;;;;;;;;;9,0;;2,0;;;;;;;6,0;;;;3,0;;;;1,0;;;;;;;;4,0;;;2,0;;;5,0;;5,0;3,0;;14,0;;;8,0;29,0;;;;;;1,0;;57,0;162,0;;6,0;1,0;;;;4,0;3,0;;2,0;;14,0;;;2,0;;;;;;3,0;4,0;2,0;;;;1,0;;14,0;6,0;;6,0;4,0;15,0;;;3,0;;12,0;;;1,0;;4,0;5,0;8,0;;7,0;;;;;7,0;;;;1,0;;;;2,0;;;1,0;;3,0;15,0;1,0;1,0;;1,0;;1,0;6,0;2,0;;;3,0;;;16,0;6,0;;;;2,0;;;;;;;37,0;;;1,0;;3,0;9,0;6,0;;;;;;;;;;5,0;;;3,0;;;;;;;;;;;;;;4,0;;;;3,0;;;;;;;;;;;;;;;;;;;;;;;;;;;1,0;;;;;1,0;;;;;;;2,0;;;;;;1,0;;;;;;;;;;;;1,0;2,0;;;14,0;;1,0;;;;;;;;;;;;;;;;5,0;1,0;37,0;;;;;4,0;6,0;;;;;;;;;37,0;3,0;1,0;;;18,0;20,0;;;;;;2,0;;;;;4,0;;1,0;17,0;4,0;;;;;;;;;;;;;;;;;;;;2,0;;;;;;;;;;;;;;;;;;;;;;;;;;;
format;;1,0;;;;10,0;17,0;3,0;;16,0;;;;7,0;2,0;;15,0;;1,0;4,0;2,0;;31,0;1,0;;;;3,0;3,0;;5,0;;;;;54,0;7,0;1,0;1,0;6,0;18,0;30,0;;32,0;15,0;;;;;1,0;1,0;;2,0;;7,0;;1,0;;3,0;6,0;;2,0;10,0;;173,0;1,0;10,0;;;;;7,0;;;;;;;18,0;4,0;39,0;;;;8,0;;;10,0;;2,0;2,0;;;;;;33,0;;15,0;1,0;;31,0;1,0;5,0;22,0;13,0;;;;;;;6,0;1,0;;1,0;15,0;7,0;1,0;5,0;;;52,0;6,0;;13,0;31,0;;;;;;;5,0;;;7,0;1,0;3,0;;;;;;;1,0;4,0;4,0;17,0;;1,0;6,0;3,0;2,0;;;;;;;;;;18,0;;;2,0;;;;;2,0;;;;1,0;;;;;2,0;;;;;;;;22,0;;;;;;;;;;;;;;;;1,0;1,0;;;;1,0;;;;;;;23,0;;1,0;;;;;;;;1,0;;;;;;3,0;;;1,0;;;;6,0;;;;;;13,0;;;;;;;;;;;1,0;3,0;1,0;;;21,0;9,0;;;;;;;1,0;;;;1,0;1,0;;;;;;1,0;;;;;;;;3,0;;;;;;;;2,0;;;;;;;;;;;;;6,0;;;;;4,0;;;;;;2,0;;;1,0;1,0;;;;4,0;2,0;;;;;3,0;;;;;;;;;;;;1,0;24,0;;;;;1,0;;;;;;83,0;2,0;;;;;14,0;;;2,0;;1,0;;;;;;;1,0;2,0;1,0;;19,0;;;;2,0;;1,0;;;1,0;;;2,0;;;2,0;;1,0;4,0;;;;2,0;8,0;;;;1,0;;;;;;1,0;;;;;;;;10,0;;4,0;4,0;13,0;21,0;;1,0;;;;4,0;;;;2,0;1,0;;1,0;;;;;1,0;2,0;;;2,0;;;;;;;;;1,0;;2,0;;19,0;;1,0;1,0;12,0;;;;;;;2,0;6,0;;2,0;;;1,0;;;;3,0;3,0;;2,0;5,0;1,0;6,0;;;;;;4,0;;;;;;3,0;15,0;;;;;2,0;;;2,0;3,0;;;1,0;;4,0;;;;;;2,0;;;;;;;;;;;;;5,0;;;1,0;;1,0;4,0;;;;;;;;8,0;6,0;;;;;3,0;1,0;1,0;;;;4,0;;1,0;;5,0;;;;;;;;;;;;;;;;4,0;;1,0;;;;;2,0;2,0;3,0;;;;;3,0;;;;;;;;;;;58,0;;;;;;;;;1,0;;;4,0;;1,0;;;8,0;;11,0;;;;;;;6,0;2,0;4,0;;1,0;;;;;1,0;2,0;1,0;1,0;;3,0;;;28,0;;;;;;;;15,0;1,0;;;1,0;1,0;;;;;8,0;;;;;;;;;;;;2,0;;;;;11,0;;1,0;3,0;;;;;;;;4,0;;;;;1,0;;;1,0;;;;;;;1,0;;;;;;;;;3,0;;;;;;;;;;;1,0;;1,0;;;;;;;;;1,0;;;;;;;;;;;;;;;;2,0;;;;;;;;;;1,0;;;;;;;;;;;;;;;;;;;;;;;;;;;;;;2,0;;;;;;;;;;;;;4,0;;;;;;;;;;;;4,0;;;;;;;;;;;;;;;20,0;;;;;;;;;;;;;;;;;;;4,0;;8,0;;1,0;;;;;;1,0;;2,0;;;;;;1,0;;;;;4,0;;;;;;;;4,0;;;;1,0;1,0;1,0;;1,0;;;;;;;;;1,0;;;;;;;;8,0;;;;;;;;;2,0;;;;;;;;;1,0;3,0;;;;;;;;;2,0;;;;;;;;;;;;;;;;;;;;;;;;;;2,0;;;;;;;;;;;;5,0;;;;;;;;;;;;;;;;;;;;;;
frame;;10,0;1,0;108,0;52,0;220,0;49,0;142,0;14,0;4,0;1,0;2,0;75,0;786,0;3,0;39,0;792,0;6,0;38,0;33,0;3,0;;128,0;8,0;41,0;37,0;13,0;33,0;57,0;9,0;528,0;52,0;21,0;52,0;;1042,0;90,0;13,0;303,0;5,0;597,0;391,0;5,0;162,0;295,0;226,0;12,0;74,0;4,0;13,0;41,0;;50,0;20,0;76,0;12,0;199,0;4,0;24,0;425,0;27,0;2,0;48,0;2,0;4365,0;3,0;617,0;35,0;27,0;25,0;15,0;356,0;155,0;;;;13,0;27,0;101,0;64,0;612,0;3,0;73,0;90,0;359,0;137,0;;206,0;;25,0;89,0;7,0;15,0;9,0;88,0;;605,0;94,0;990,0;344,0;371,0;140,0;5,0;90,0;192,0;183,0;29,0;30,0;64,0;3,0;1,0;507,0;257,0;42,0;5,0;38,0;253,0;135,0;131,0;345,0;391,0;4,0;419,0;65,0;1,0;197,0;362,0;;24,0;3,0;468,0;24,0;6,0;252,0;9,0;;160,0;41,0;20,0;2,0;8,0;159,0;3,0;14,0;14,0;32,0;121,0;86,0;212,0;131,0;31,0;77,0;114,0;23,0;122,0;1,0;3,0;;;;7,0;117,0;76,0;79,0;;1,0;213,0;97,0;12,0;58,0;20,0;5,0;6,0;403,0;3,0;85,0;9,0;6,0;7,0;30,0;4,0;4,0;51,0;124,0;1,0;45,0;134,0;28,0;;51,0;;7,0;61,0;126,0;38,0;34,0;252,0;7,0;93,0;16,0;2,0;;13,0;7,0;38,0;40,0;281,0;26,0;89,0;374,0;166,0;177,0;29,0;;11,0;176,0;289,0;23,0;13,0;42,0;24,0;184,0;28,0;3,0;57,0;1,0;397,0;3,0;12,0;65,0;20,0;8,0;86,0;37,0;19,0;19,0;14,0;;3,0;76,0;2,0;54,0;20,0;13,0;;367,0;12,0;46,0;272,0;15,0;7,0;4,0;20,0;58,0;30,0;6,0;312,0;176,0;22,0;;3,0;120,0;8,0;82,0;17,0;;;3,0;13,0;59,0;2,0;5,0;82,0;37,0;6,0;;22,0;35,0;16,0;6,0;24,0;8,0;189,0;24,0;62,0;1,0;3,0;33,0;37,0;39,0;73,0;42,0;8,0;6,0;2,0;;49,0;22,0;32,0;15,0;3,0;3,0;27,0;46,0;1,0;43,0;11,0;32,0;2,0;84,0;3,0;6,0;35,0;45,0;11,0;;72,0;23,0;21,0;30,0;50,0;385,0;56,0;103,0;18,0;6,0;10,0;6,0;31,0;16,0;15,0;6,0;14,0;7,0;114,0;27,0;4,0;7,0;39,0;;75,0;73,0;9,0;18,0;26,0;47,0;263,0;62,0;16,0;27,0;38,0;;69,0;;123,0;1,0;9,0;64,0;2177,0;27,0;4,0;1,0;5,0;4,0;1,0;32,0;52,0;4,0;;2,0;27,0;;133,0;59,0;76,0;17,0;23,0;23,0;99,0;12,0;148,0;175,0;12,0;26,0;8,0;195,0;28,0;94,0;7,0;13,0;42,0;12,0;112,0;70,0;28,0;66,0;2,0;206,0;36,0;2,0;4,0;285,0;31,0;67,0;8,0;124,0;67,0;9,0;304,0;41,0;47,0;437,0;10,0;28,0;62,0;70,0;22,0;1,0;;17,0;2,0;1023,0;4,0;36,0;10,0;337,0;10,0;58,0;9,0;55,0;7,0;1,0;222,0;9,0;15,0;8,0;43,0;56,0;21,0;71,0;2,0;12,0;95,0;34,0;30,0;46,0;49,0;1,0;59,0;4,0;25,0;;5,0;2,0;24,0;;;47,0;23,0;6,0;67,0;6,0;44,0;41,0;7,0;115,0;6,0;;1,0;;14,0;18,0;29,0;37,0;21,0;13,0;16,0;36,0;22,0;2,0;155,0;15,0;6,0;52,0;31,0;96,0;87,0;5,0;12,0;75,0;13,0;;45,0;72,0;10,0;13,0;45,0;8,0;2,0;23,0;26,0;162,0;6,0;14,0;60,0;33,0;7,0;1,0;10,0;12,0;8,0;57,0;19,0;;4,0;27,0;;39,0;;5,0;22,0;11,0;8,0;37,0;16,0;9,0;4,0;3,0;;;13,0;9,0;5,0;76,0;94,0;6,0;152,0;;21,0;93,0;14,0;23,0;3,0;64,0;22,0;79,0;;99,0;;15,0;;13,0;7,0;78,0;28,0;24,0;76,0;168,0;2,0;2,0;17,0;47,0;12,0;11,0;25,0;4,0;13,0;5,0;6,0;16,0;10,0;2,0;12,0;16,0;57,0;56,0;;44,0;10,0;2,0;20,0;2,0;6,0;6,0;9,0;7,0;4,0;7,0;10,0;93,0;;3,0;6,0;5,0;12,0;2,0;15,0;;20,0;;23,0;1,0;9,0;312,0;86,0;20,0;7,0;16,0;18,0;12,0;16,0;10,0;5,0;;3,0;19,0;6,0;7,0;12,0;4,0;5,0;;52,0;95,0;6,0;54,0;9,0;3,0;5,0;31,0;;;18,0;28,0;9,0;32,0;;5,0;44,0;15,0;2,0;22,0;5,0;36,0;4,0;16,0;;1,0;7,0;11,0;4,0;7,0;8,0;7,0;10,0;27,0;4,0;7,0;113,0;33,0;8,0;14,0;5,0;90,0;51,0;;20,0;;;;65,0;1,0;21,0;22,0;75,0;122,0;5,0;3,0;177,0;25,0;5,0;;;60,0;11,0;7,0;3,0;;57,0;1,0;;2,0;3,0;1,0;70,0;43,0;17,0;2,0;23,0;1,0;;10,0;43,0;67,0;76,0;5,0;2,0;13,0;;13,0;;7,0;5,0;22,0;10,0;44,0;1,0;11,0;9,0;20,0;2,0;3,0;8,0;2,0;9,0;7,0;31,0;13,0;11,0;29,0;;12,0;6,0;14,0;188,0;4,0;19,0;18,0;65,0;19,0;60,0;3,0;1,0;23,0;2,0;11,0;17,0;32,0;3,0;8,0;;38,0;3,0;8,0;1,0;1,0;11,0;1,0;8,0;;6,0;11,0;9,0;13,0;6,0;;;2,0;;9,0;37,0;31,0;22,0;10,0;9,0;1,0;;2,0;22,0;;2,0;1,0;;2,0;5,0;5,0;9,0;17,0;17,0;;;5,0;28,0;;4,0;;7,0;10,0;35,0;;;;2,0;155,0;;2,0;;7,0;16,0;33,0;;16,0;;;3,0;21,0;1,0;3,0;8,0;13,0;3,0;16,0;5,0;23,0;18,0;24,0;16,0;24,0;1,0;3,0;7,0;;2,0;;2,0;1,0;102,0;18,0;;;12,0;19,0;1,0;3,0;18,0;7,0;;;4,0;5,0;6,0;33,0;9,0;11,0;11,0;6,0;40,0;1,0;54,0;7,0;59,0;11,0;9,0;;2,0;4,0;3,0;3,0;3,0;;7,0;6,0;12,0;29,0;1,0;42,0;;43,0;61,0;2,0;43,0;1,0;8,0;11,0;;16,0;;;28,0;2,0;84,0;14,0;;3,0;1,0;2,0;1,0;6,0;;3,0;25,0;15,0;6,0;16,0;;25,0;5,0;25,0;4,0;;1,0;;;15,0;10,0;;10,0;;2,0;7,0;2,0;1,0;5,0;6,0;6,0;11,0;21,0;22,0;15,0;1,0;3,0;1,0;6,0;39,0;15,0;9,0;54,0;8,0;;1,0;2,0;7,0;34,0;2,0;;;;;;4,0;11,0;18,0;5,0;4,0;12,0;3,0;6,0;;4,0;23,0;2,0;1,0;1,0;;9,0;2,0;4,0;7,0;3,0;2,0;9,0;6,0;9,0;8,0;6,0;23,0;1,0;22,0;;;;13,0;4,0;;13,0;17,0;;5,0;1,0;;1,0;12,0;;29,0;3,0;;6,0;2,0;;
front;;5,0;5,0;30,0;3,0;38,0;22,0;319,0;;;8,0;4,0;83,0;149,0;2,0;;87,0;9,0;43,0;3,0;;;5,0;2,0;14,0;;;66,0;4,0;4,0;191,0;27,0;1,0;;2,0;39,0;76,0;12,0;6,0;8,0;20,0;303,0;12,0;18,0;125,0;211,0;1,0;129,0;;;;3,0;109,0;38,0;41,0;45,0;130,0;;;17,0;7,0;;108,0;;377,0;;302,0;9,0;1,0;9,0;20,0;988,0;179,0;19,0;5,0;;34,0;4,0;6,0;3,0;127,0;;8,0;14,0;171,0;13,0;;171,0;9,0;8,0;1,0;28,0;30,0;9,0;16,0;2,0;26,0;37,0;77,0;47,0;276,0;21,0;1,0;38,0;7,0;12,0;;3,0;11,0;;;20,0;58,0;5,0;5,0;;2,0;20,0;11,0;203,0;;;22,0;12,0;2,0;1,0;180,0;;4,0;23,0;6,0;8,0;;123,0;1,0;20,0;107,0;7,0;5,0;2,0;3,0;33,0;;;83,0;5,0;73,0;93,0;16,0;150,0;2,0;13,0;200,0;49,0;1,0;;14,0;14,0;;10,0;47,0;113,0;;;;;142,0;410,0;1,0;4,0;17,0;;35,0;104,0;4,0;80,0;;16,0;5,0;1,0;;17,0;29,0;424,0;18,0;6,0;91,0;13,0;51,0;;4,0;;21,0;44,0;32,0;27,0;1638,0;2,0;48,0;19,0;3,0;48,0;9,0;;1,0;;411,0;10,0;31,0;319,0;23,0;6,0;3,0;2,0;7,0;119,0;10,0;36,0;;13,0;21,0;8,0;5,0;;140,0;8,0;985,0;;14,0;4,0;28,0;;6,0;1,0;686,0;6,0;3,0;1,0;16,0;6,0;3,0;52,0;1,0;9,0;47,0;9,0;13,0;19,0;777,0;2,0;9,0;13,0;5,0;65,0;30,0;4,0;61,0;931,0;13,0;;5,0;4,0;4,0;341,0;114,0;;;;;111,0;34,0;2,0;6,0;1,0;9,0;1,0;8,0;52,0;13,0;20,0;24,0;;80,0;145,0;;1,0;37,0;100,0;147,0;11,0;13,0;12,0;2,0;69,0;7,0;13,0;34,0;22,0;1,0;49,0;44,0;10,0;10,0;2,0;;2,0;8,0;20,0;5,0;63,0;2,0;4,0;10,0;2,0;66,0;1,0;153,0;7,0;17,0;6,0;75,0;93,0;37,0;16,0;63,0;4,0;4,0;;16,0;89,0;36,0;3,0;4,0;49,0;8,0;;12,0;3,0;3,0;;45,0;12,0;4,0;11,0;44,0;24,0;41,0;33,0;3,0;11,0;1,0;18,0;;2,0;14,0;27,0;3,0;35,0;51,0;8,0;;2,0;;;3,0;5,0;3,0;;;1,0;1,0;;1,0;41,0;9,0;;1,0;;2,0;;41,0;4,0;;2,0;;42,0;1,0;3,0;;15,0;;3,0;;18,0;49,0;;5,0;8,0;12,0;;;4,0;25,0;;;17,0;;23,0;15,0;11,0;1,0;21,0;;6,0;10,0;21,0;1,0;;;;;;;1,0;;113,0;4,0;10,0;3,0;28,0;1,0;;6,0;;4,0;4,0;7,0;20,0;8,0;;;35,0;;3,0;3,0;;;8,0;61,0;;;;8,0;5,0;4,0;19,0;2,0;2,0;4,0;1,0;8,0;1,0;;17,0;;;;;;1,0;1,0;7,0;2,0;22,0;61,0;6,0;5,0;2,0;1,0;2,0;16,0;1,0;9,0;8,0;;3,0;12,0;5,0;12,0;;;1,0;;42,0;3,0;2,0;43,0;5,0;;;;;13,0;19,0;;7,0;18,0;1,0;4,0;;3,0;1,0;15,0;;1,0;1,0;10,0;33,0;15,0;;19,0;184,0;;11,0;;;24,0;;29,0;;4,0;;5,0;9,0;13,0;;1,0;;16,0;8,0;;3,0;29,0;185,0;;1,0;;;4,0;14,0;14,0;1,0;10,0;;;1,0;2,0;;11,0;;;1,0;3,0;2,0;;;1,0;1,0;8,0;6,0;;4,0;;69,0;58,0;17,0;;;32,0;3,0;;;13,0;4,0;5,0;17,0;14,0;;2,0;4,0;;;;;4,0;;2,0;5,0;1,0;2,0;;;;35,0;4,0;;1,0;2,0;1,0;1,0;;;;4,0;2,0;1,0;;1,0;2,0;45,0;;;1,0;5,0;;;3,0;;;4,0;;;7,0;1,0;;;;2,0;25,0;;11,0;6,0;7,0;14,0;5,0;9,0;;16,0;;44,0;;3,0;;;;13,0;;;1,0;1,0;;;;1,0;28,0;1,0;;1,0;3,0;;39,0;;7,0;1,0;4,0;;;;23,0;;;1,0;1,0;6,0;;2,0;1,0;;24,0;1,0;8,0;23,0;;9,0;3,0;93,0;6,0;10,0;4,0;14,0;1,0;21,0;2,0;1,0;5,0;;7,0;30,0;4,0;1,0;11,0;2,0;29,0;;5,0;10,0;;18,0;4,0;5,0;;4,0;;;;27,0;27,0;4,0;1,0;;4,0;1,0;5,0;2,0;52,0;;3,0;2,0;1,0;1,0;1,0;5,0;3,0;17,0;;9,0;4,0;13,0;13,0;;;;21,0;1,0;2,0;4,0;4,0;3,0;26,0;5,0;2,0;6,0;3,0;3,0;9,0;3,0;2,0;;;;;4,0;9,0;3,0;3,0;;13,0;33,0;37,0;4,0;11,0;;;1,0;79,0;;;22,0;;;;;;;4,0;1,0;;4,0;;1,0;;6,0;30,0;1,0;1,0;;;1,0;7,0;1,0;;;1,0;;;;;;14,0;;1,0;1,0;13,0;;7,0;1,0;1,0;5,0;;1,0;;2,0;3,0;1,0;;;2,0;4,0;;;11,0;70,0;9,0;;;4,0;1,0;;2,0;;1,0;1,0;2,0;;;;1,0;2,0;;6,0;;30,0;1,0;2,0;;;6,0;;;2,0;;4,0;1,0;;8,0;;;1,0;;;30,0;1,0;2,0;;4,0;;;;;15,0;;1,0;;;2,0;;;2,0;2,0;;6,0;2,0;;;;;19,0;;11,0;;1,0;;30,0;3,0;;;2,0;2,0;;1,0;1,0;3,0;;;;1,0;;;;;;;2,0;3,0;;2,0;;;;;;;4,0;16,0;;;15,0;3,0;9,0;;;3,0;1,0;15,0;;;;;;;65,0;;;;2,0;1,0;;3,0;3,0;22,0;8,0;;33,0;1,0;;;;;15,0;;9,0;;;;6,0;;;;;3,0;3,0;9,0;;;2,0;;;;;
function;;6,0;1,0;61,0;18,0;91,0;23,0;3,0;24,0;5,0;;11,0;1,0;203,0;1,0;23,0;179,0;2,0;7,0;7,0;;1,0;29,0;4,0;22,0;12,0;36,0;31,0;47,0;7,0;125,0;33,0;33,0;142,0;1,0;90,0;40,0;2,0;17,0;1,0;266,0;320,0;3,0;36,0;157,0;2,0;26,0;46,0;3,0;70,0;73,0;;6,0;2,0;25,0;14,0;33,0;;58,0;57,0;1,0;1,0;19,0;;682,0;26,0;185,0;18,0;17,0;2,0;12,0;116,0;64,0;2,0;6,0;3,0;1,0;15,0;10,0;3,0;262,0;2,0;63,0;9,0;104,0;3,0;1,0;201,0;1,0;13,0;59,0;7,0;3,0;20,0;22,0;;239,0;9,0;195,0;117,0;105,0;85,0;1,0;16,0;79,0;90,0;12,0;32,0;7,0;11,0;1,0;23,0;40,0;1,0;;1,0;29,0;36,0;36,0;114,0;10,0;3,0;82,0;10,0;19,0;28,0;215,0;1,0;7,0;18,0;81,0;1,0;;115,0;15,0;;30,0;14,0;74,0;;;28,0;;;21,0;127,0;36,0;6,0;83,0;;15,0;35,0;24,0;2,0;3,0;;;;3,0;3,0;4,0;21,0;13,0;30,0;;1,0;14,0;9,0;6,0;25,0;6,0;1,0;7,0;18,0;1,0;2,0;7,0;2,0;46,0;2,0;62,0;2,0;;3,0;;11,0;28,0;4,0;66,0;;1,0;5,0;4,0;2,0;4,0;1,0;10,0;13,0;5,0;;7,0;19,0;5,0;1,0;19,0;15,0;26,0;4,0;2,0;14,0;3,0;9,0;18,0;;;6,0;62,0;2,0;;6,0;22,0;16,0;;9,0;6,0;;52,0;1,0;4,0;20,0;1,0;13,0;15,0;24,0;1,0;9,0;8,0;3,0;;37,0;;2,0;;;;120,0;2,0;25,0;17,0;1,0;;;5,0;4,0;1,0;7,0;10,0;27,0;10,0;;47,0;4,0;5,0;32,0;;1,0;3,0;6,0;46,0;2,0;;7,0;10,0;12,0;1,0;;10,0;51,0;;5,0;1,0;25,0;24,0;2,0;4,0;;;3,0;29,0;;4,0;19,0;;;;;85,0;22,0;;;;1,0;;13,0;;;2,0;1,0;21,0;142,0;;;1,0;;2,0;;1,0;18,0;1,0;9,0;29,0;64,0;3,0;14,0;1,0;;6,0;1,0;18,0;7,0;;;;;63,0;2,0;1,0;;9,0;7,0;13,0;13,0;3,0;;;;19,0;8,0;;1,0;5,0;;4,0;1,0;6,0;5,0;42,0;;37,0;8,0;;2,0;;2,0;26,0;11,0;4,0;18,0;;26,0;;13,0;156,0;7,0;51,0;6,0;;10,0;13,0;10,0;264,0;37,0;2,0;22,0;21,0;37,0;25,0;46,0;2,0;6,0;1,0;110,0;5,0;46,0;;;;32,0;33,0;7,0;1,0;144,0;11,0;26,0;66,0;24,0;1,0;28,0;33,0;2,0;;8,0;;47,0;49,0;17,0;1,0;4,0;;4,0;;14,0;10,0;3,0;6,0;40,0;14,0;95,0;21,0;4,0;10,0;1,0;88,0;;18,0;;22,0;6,0;24,0;;1,0;19,0;16,0;22,0;46,0;27,0;5,0;1,0;114,0;6,0;;;60,0;;3,0;2,0;6,0;33,0;;12,0;34,0;13,0;23,0;7,0;1,0;1,0;14,0;18,0;1,0;4,0;8,0;11,0;28,0;51,0;;5,0;;2,0;30,0;3,0;6,0;;4,0;15,0;5,0;1,0;262,0;12,0;21,0;11,0;;;;1,0;3,0;1,0;9,0;9,0;1,0;44,0;4,0;2,0;1,0;4,0;10,0;12,0;16,0;;;15,0;4,0;17,0;6,0;;8,0;13,0;4,0;4,0;1,0;1,0;4,0;4,0;6,0;1,0;;2,0;;1,0;;;;65,0;1,0;9,0;3,0;1,0;6,0;6,0;3,0;48,0;;14,0;66,0;5,0;5,0;19,0;;3,0;3,0;5,0;;;12,0;3,0;34,0;19,0;;2,0;;;1,0;18,0;6,0;6,0;36,0;1,0;1,0;24,0;5,0;13,0;5,0;6,0;1,0;;3,0;11,0;2,0;8,0;1,0;5,0;21,0;;12,0;13,0;3,0;3,0;;;3,0;22,0;2,0;;;35,0;;1,0;;2,0;7,0;3,0;22,0;;2,0;32,0;;;;13,0;8,0;5,0;2,0;;8,0;2,0;2,0;2,0;;2,0;1,0;9,0;2,0;;21,0;5,0;2,0;4,0;;;6,0;;;19,0;11,0;13,0;;;3,0;;;12,0;4,0;10,0;5,0;;8,0;;6,0;;2,0;;5,0;3,0;12,0;5,0;18,0;2,0;3,0;2,0;33,0;43,0;;6,0;28,0;2,0;27,0;;;25,0;;2,0;16,0;3,0;2,0;1,0;9,0;7,0;;5,0;53,0;6,0;3,0;1,0;;6,0;5,0;29,0;8,0;;;;1,0;;;;4,0;1,0;1,0;16,0;1,0;;6,0;11,0;2,0;;9,0;;;1,0;;8,0;1,0;12,0;1,0;2,0;;6,0;;5,0;6,0;12,0;2,0;;;7,0;1,0;3,0;;1,0;2,0;7,0;;;;7,0;19,0;1,0;1,0;1,0;14,0;;39,0;2,0;;;;22,0;31,0;5,0;1,0;29,0;;;2,0;;;;;;;;1,0;;;;;;2,0;;2,0;;13,0;;15,0;;1,0;;1,0;;3,0;;13,0;4,0;;13,0;3,0;2,0;3,0;5,0;2,0;;;;26,0;1,0;1,0;;14,0;2,0;;;;;2,0;42,0;4,0;14,0;;3,0;11,0;9,0;1,0;;6,0;;18,0;8,0;5,0;34,0;7,0;12,0;;12,0;3,0;;8,0;;;10,0;25,0;;2,0;1,0;16,0;;12,0;18,0;12,0;8,0;;;3,0;1,0;9,0;4,0;1,0;1,0;2,0;2,0;;;5,0;16,0;7,0;11,0;27,0;;25,0;7,0;1,0;2,0;3,0;2,0;;;;5,0;;2,0;;2,0;5,0;3,0;;3,0;2,0;2,0;1,0;11,0;12,0;;;6,0;4,0;1,0;;1,0;;;6,0;;1,0;;1,0;12,0;2,0;6,0;3,0;18,0;7,0;8,0;6,0;1,0;4,0;;9,0;;;21,0;8,0;9,0;;1,0;;;;3,0;2,0;;6,0;5,0;;;;;13,0;;6,0;6,0;;4,0;1,0;;;2,0;;3,0;;;;2,0;2,0;11,0;12,0;;;1,0;;3,0;4,0;4,0;;2,0;6,0;;;3,0;;;;;;25,0;5,0;1,0;3,0;;10,0;;;;;;;;18,0;;23,0;4,0;;;7,0;96,0;27,0;;2,0;7,0;;;10,0;7,0;;1,0;;2,0;6,0;;;;2,0;
grip;;6,0;;3,0;;2,0;;24,0;;3,0;;;10,0;12,0;;;4,0;1,0;1,0;;2,0;;;;1,0;;;8,0;2,0;;18,0;3,0;;;;;11,0;2,0;;2,0;;48,0;2,0;5,0;3,0;19,0;;28,0;;;;;13,0;;2,0;;14,0;;;5,0;;;;;3,0;;36,0;1,0;8,0;;1,0;32,0;1,0;;;;11,0;;;;13,0;;4,0;;21,0;2,0;;4,0;;2,0;;1,0;;;;;;;23,0;1,0;30,0;4,0;;;;1,0;;;;;;;;2,0;;;;5,0;;46,0;;;;4,0;;1,0;12,0;;1,0;;;;;6,0;;;;;;;;1,0;1,0;;16,0;;4,0;10,0;;16,0;;;32,0;17,0;;;;;;;;14,0;;;;;31,0;1,0;;;;;;2,0;;9,0;;;;;;;;2,0;3,0;;;1,0;5,0;5,0;;36,0;1,0;9,0;1,0;2,0;17,0;;;4,0;;4,0;2,0;;3,0;;44,0;2,0;1,0;88,0;;3,0;2,0;;3,0;2,0;;4,0;;;;;;;13,0;;59,0;34,0;4,0;;6,0;1,0;2,0;;5,0;;;;6,0;;;8,0;2,0;;;2,0;1,0;4,0;26,0;4,0;10,0;;;1,0;;;34,0;39,0;6,0;;;;;1,0;;4,0;;;10,0;;;;2,0;6,0;3,0;;1,0;1,0;;3,0;5,0;;7,0;43,0;;;;2,0;1,0;;;3,0;;13,0;2,0;7,0;7,0;;4,0;1,0;1,0;;1,0;;1,0;1,0;24,0;;5,0;15,0;;2,0;1,0;;;2,0;7,0;2,0;5,0;6,0;2,0;;2,0;3,0;;;;4,0;3,0;;4,0;3,0;16,0;4,0;;;;3,0;;;4,0;1,0;2,0;2,0;1,0;16,0;16,0;1,0;;1,0;;1,0;;;6,0;2,0;;5,0;12,0;;;;;;;1,0;;;;;;;2,0;6,0;8,0;;1,0;;;;13,0;;;;1,0;24,0;;;;2,0;6,0;;;;;1,0;;;;;;9,0;1,0;;;2,0;;;;;;3,0;;1,0;;6,0;;;;;;;;;;4,0;2,0;;;;11,0;;;;;;;;19,0;;;4,0;14,0;4,0;;;;;38,0;;;;3,0;4,0;8,0;1,0;;;;;;;;4,0;;;;;;;;;;5,0;2,0;1,0;;;;;;;1,0;2,0;;;2,0;;;;;;;2,0;;;1,0;;;;;;4,0;5,0;;6,0;;;1,0;;;;2,0;;1,0;;;1,0;;;4,0;2,0;;1,0;;;;1,0;;;;;;6,0;4,0;1,0;;;;;;;;;;;;1,0;;;;;;;;;;;;;;1,0;;;;;;;1,0;;2,0;3,0;;3,0;;5,0;;;;2,0;2,0;1,0;;9,0;;2,0;6,0;;;;;;;;;;;;;1,0;;;;6,0;;;15,0;;;;;;;;2,0;;;;;;;;;;;;;;;;;;;;;;;;1,0;;2,0;;2,0;1,0;;;;;;1,0;;;;;1,0;;;;;;;;;;2,0;;;;15,0;;3,0;;;;;;;;;;;8,0;;;;7,0;;;2,0;;;2,0;;;;2,0;;;6,0;11,0;;;;3,0;;6,0;;7,0;2,0;;;1,0;;;9,0;2,0;;1,0;;;;1,0;;;;1,0;9,0;1,0;;;;;;;3,0;;3,0;1,0;;;;;;2,0;1,0;;;;;;;;1,0;;;1,0;6,0;;1,0;;3,0;;;;;1,0;;;;1,0;;;;;;;;;;;;;12,0;;2,0;;;4,0;;;;;;;;;;;;;;;;;2,0;;;;;;;;;;;;;;;;;;;;;;;;;;;;;;;;;;;;;;;;;6,0;;;;1,0;;;;;;;;;;;;1,0;;;;;;;;;;;;;;;;;;1,0;4,0;;;;;;1,0;1,0;;;;2,0;1,0;;;;1,0;;1,0;1,0;;;;;;;;;;;;;;;;;;;;;;5,0;;;;;;;;;;;;;5,0;12,0;;;;;;;;;;4,0;;;;;;;;;;;;;;;;;;;;;;;;;;8,0;1,0;;;;;;;;5,0;;;;;;;;;;;;;;;;;;;
ground;;5,0;;7,0;;50,0;3,0;9,0;;;;1,0;4,0;34,0;;;57,0;1,0;9,0;;;;1,0;;1,0;;;11,0;;;31,0;9,0;5,0;;;6,0;10,0;2,0;5,0;;37,0;45,0;;4,0;12,0;33,0;;57,0;;;11,0;;16,0;3,0;3,0;1,0;19,0;;8,0;2,0;1,0;;3,0;;99,0;;58,0;;1,0;1,0;7,0;33,0;5,0;;;;19,0;5,0;;;43,0;;2,0;11,0;47,0;;;18,0;;3,0;1,0;;11,0;;5,0;;16,0;125,0;45,0;83,0;42,0;5,0;;2,0;11,0;3,0;6,0;1,0;;;;2,0;22,0;4,0;;2,0;;5,0;6,0;27,0;;;68,0;1,0;;;47,0;;;;11,0;;2,0;29,0;;4,0;22,0;17,0;;;;12,0;2,0;;;2,0;27,0;9,0;3,0;6,0;2,0;2,0;11,0;4,0;;;;7,0;;;51,0;109,0;4,0;2,0;;;28,0;12,0;;13,0;2,0;;3,0;15,0;;1,0;4,0;;2,0;;;;4,0;2,0;1,0;2,0;5,0;;;4,0;;2,0;;;;18,0;27,0;;;1,0;8,0;24,0;;;;;44,0;15,0;;9,0;;3,0;;;;2,0;1,0;35,0;;7,0;20,0;1,0;;3,0;2,0;;35,0;;8,0;2,0;4,0;1,0;2,0;21,0;6,0;;1,0;2,0;;2,0;;;4,0;;;13,0;4,0;10,0;10,0;4,0;2,0;;;5,0;7,0;40,0;12,0;97,0;6,0;;;22,0;1,0;45,0;1,0;2,0;;;4,0;2,0;;30,0;;4,0;;;3,0;29,0;4,0;;;;18,0;38,0;;;2,0;;64,0;;2,0;2,0;;;;;21,0;;;8,0;;;4,0;5,0;;;;;42,0;12,0;;;5,0;1,0;;;4,0;;3,0;;;24,0;4,0;2,0;;3,0;1,0;12,0;39,0;20,0;12,0;;1,0;11,0;1,0;;;2,0;;;;;4,0;;;7,0;;14,0;;7,0;;;;;5,0;;8,0;17,0;19,0;;;;;;;2,0;;;;;;3,0;7,0;1,0;9,0;2,0;;;1,0;;18,0;16,0;;1,0;;14,0;;;2,0;;;;2,0;;1,0;2,0;;7,0;;;;21,0;;7,0;;20,0;;2,0;8,0;6,0;;9,0;;3,0;1,0;13,0;;;9,0;;;;5,0;;;12,0;;4,0;;3,0;1,0;;2,0;3,0;2,0;;;;3,0;1,0;;138,0;;9,0;6,0;1,0;;2,0;3,0;1,0;;36,0;;;1,0;;;1,0;;2,0;5,0;1,0;;;;;8,0;;;4,0;2,0;;;3,0;;;;12,0;;;;2,0;;3,0;1,0;;;;1,0;;2,0;;;2,0;;;;;;;;;;;4,0;6,0;3,0;;;;1,0;3,0;;;;6,0;1,0;3,0;;123,0;19,0;35,0;;;;;2,0;;;;;;;;4,0;;2,0;;2,0;;;1,0;;17,0;;;;;3,0;;;;;;;;;;;;;;2,0;;;;1,0;;17,0;5,0;;;;5,0;7,0;;;;;6,0;;;;22,0;10,0;;1,0;;;3,0;;;;;;;;;8,0;;;;;19,0;;;;;;8,0;;;;;;;;;;;;;;1,0;;;2,0;;;;;;;2,0;;;;1,0;6,0;;;;1,0;3,0;49,0;2,0;;;;4,0;1,0;1,0;;;1,0;;1,0;;1,0;4,0;;;;1,0;;1,0;2,0;;;;5,0;;;;;3,0;;;28,0;;;;;;5,0;1,0;;;1,0;;;;1,0;;;101,0;;;1,0;;;;2,0;3,0;2,0;;;;;1,0;;4,0;4,0;;;1,0;;1,0;;;;;;;;;;;;;;;;2,0;65,0;;1,0;;;;5,0;5,0;4,0;;1,0;;;;;;;;8,0;;;1,0;;;;;;;7,0;;;1,0;;2,0;;;1,0;2,0;42,0;;;;;;49,0;;;;;1,0;;;;1,0;;;4,0;;4,0;4,0;;;4,0;;;;1,0;5,0;1,0;1,0;;;;;;;6,0;1,0;;1,0;8,0;;;;;;;;;;;;1,0;;;3,0;;22,0;;;;2,0;;;;;1,0;1,0;1,0;;;;;;;18,0;1,0;3,0;;;;11,0;4,0;;;;;1,0;;1,0;;;2,0;;;;;;;;2,0;;;;2,0;;2,0;;;;;;;;1,0;;;1,0;6,0;;;;;1,0;;;;;;;;;3,0;;1,0;;;;;;;;;;;;;;;;;;1,0;;;;;;;;;;;;;1,0;;1,0;;;;;11,0;;;;9,0;1,0;;1,0;;;;;;;;;;;;;;2,0;;;;;;;;;;;;;;;1,0;;1,0;;;;;2,0;;;;;;;;;;
guide;;17,0;;7,0;1,0;72,0;7,0;98,0;;;;3,0;52,0;54,0;;;11,0;;15,0;;2,0;4,0;9,0;;10,0;3,0;1,0;16,0;3,0;;146,0;4,0;3,0;3,0;;6,0;38,0;1,0;8,0;3,0;28,0;154,0;17,0;3,0;105,0;75,0;3,0;36,0;;2,0;2,0;3,0;76,0;12,0;5,0;;151,0;;;29,0;;;1,0;;254,0;;142,0;2,0;;1,0;6,0;201,0;247,0;8,0;;1,0;3,0;;;2,0;67,0;2,0;;;113,0;34,0;;92,0;1,0;11,0;;9,0;30,0;4,0;2,0;1,0;9,0;33,0;53,0;62,0;96,0;;;4,0;14,0;9,0;;1,0;3,0;;;7,0;8,0;5,0;;;1,0;11,0;2,0;35,0;;4,0;20,0;12,0;;5,0;102,0;;;7,0;5,0;1,0;;214,0;1,0;;7,0;1,0;;;;13,0;1,0;;10,0;6,0;26,0;44,0;22,0;17,0;7,0;6,0;47,0;24,0;;17,0;3,0;5,0;2,0;;;32,0;;;4,0;1,0;66,0;38,0;12,0;;1,0;;5,0;98,0;4,0;20,0;2,0;6,0;;1,0;2,0;6,0;4,0;33,0;;12,0;24,0;7,0;76,0;9,0;;;1,0;22,0;50,0;152,0;76,0;19,0;15,0;29,0;3,0;1,0;1,0;;2,0;;191,0;14,0;11,0;103,0;110,0;63,0;2,0;1,0;;23,0;9,0;35,0;2,0;48,0;3,0;;;9,0;37,0;;135,0;4,0;8,0;4,0;26,0;1,0;9,0;;9,0;;4,0;10,0;;;;36,0;4,0;2,0;;7,0;12,0;25,0;104,0;57,0;58,0;;;51,0;23,0;3,0;53,0;190,0;11,0;;1,0;4,0;;52,0;6,0;1,0;;;;5,0;1,0;23,0;22,0;9,0;1,0;;2,0;34,0;7,0;2,0;5,0;6,0;35,0;5,0;6,0;6,0;30,0;17,0;9,0;4,0;12,0;2,0;11,0;7,0;2,0;5,0;17,0;8,0;23,0;27,0;;2,0;20,0;5,0;;174,0;2,0;7,0;;12,0;5,0;7,0;14,0;3,0;7,0;1,0;16,0;15,0;7,0;15,0;3,0;29,0;10,0;14,0;2,0;;6,0;30,0;4,0;5,0;125,0;;99,0;5,0;;1,0;;4,0;11,0;;27,0;23,0;2,0;8,0;4,0;26,0;16,0;20,0;;12,0;2,0;1,0;3,0;;64,0;12,0;27,0;44,0;44,0;;1,0;;;;;3,0;;;;;16,0;;6,0;13,0;9,0;2,0;6,0;2,0;1,0;;19,0;;;1,0;6,0;4,0;;2,0;;;;1,0;6,0;13,0;2,0;9,0;1,0;2,0;15,0;;;1,0;8,0;2,0;16,0;30,0;3,0;3,0;13,0;10,0;2,0;64,0;;2,0;3,0;42,0;;;;;;;;2,0;1,0;71,0;5,0;1,0;8,0;8,0;;;4,0;;;;;10,0;25,0;;;4,0;5,0;;;3,0;;7,0;69,0;;;1,0;2,0;2,0;71,0;1,0;;;3,0;10,0;6,0;1,0;;19,0;;;;;7,0;3,0;6,0;2,0;6,0;44,0;5,0;2,0;16,0;2,0;3,0;;22,0;;;2,0;2,0;;3,0;2,0;1,0;8,0;;;5,0;15,0;;21,0;25,0;;;2,0;;7,0;10,0;2,0;7,0;20,0;2,0;3,0;2,0;;;;;;2,0;;9,0;7,0;1,0;;12,0;8,0;;1,0;;;3,0;;;1,0;4,0;;6,0;;;;;29,0;2,0;4,0;;1,0;9,0;17,0;22,0;1,0;;2,0;9,0;3,0;;3,0;;;4,0;4,0;;;;;;3,0;6,0;;;;34,0;3,0;;1,0;;;;;40,0;8,0;2,0;1,0;2,0;;;;24,0;54,0;1,0;3,0;2,0;;;3,0;;;;1,0;5,0;;1,0;4,0;3,0;1,0;;1,0;;4,0;1,0;;1,0;3,0;15,0;;;;;;;;1,0;;;1,0;;;;;;;;;;10,0;7,0;;;;1,0;;47,0;4,0;6,0;;;;2,0;5,0;;;;10,0;;;17,0;17,0;;1,0;2,0;;;;5,0;;;;2,0;;1,0;1,0;;;22,0;1,0;11,0;;3,0;;;1,0;;3,0;3,0;;;2,0;;;;;2,0;;18,0;1,0;1,0;23,0;;;2,0;44,0;;6,0;;;;;;11,0;45,0;1,0;4,0;;;;3,0;1,0;2,0;;;9,0;;9,0;;;;1,0;;;;1,0;;;;;3,0;;;2,0;11,0;;3,0;32,0;;8,0;6,0;3,0;26,0;5,0;;18,0;12,0;5,0;;;;6,0;;;;5,0;21,0;;1,0;1,0;1,0;6,0;1,0;2,0;;1,0;3,0;;1,0;14,0;5,0;1,0;18,0;1,0;1,0;1,0;;;6,0;;;;;;7,0;;1,0;14,0;7,0;;1,0;;3,0;;;;9,0;;3,0;;5,0;;;;6,0;;;;24,0;;;;;;;;;;1,0;2,0;18,0;3,0;;;;;;;;;2,0;;;;;;;;;;;;;;;;;2,0;;;;;;;;;;;;;;6,0;7,0;;;;4,0;;;;;;3,0;1,0;1,0;;;;;;43,0;;;;;;;;;2,0;;;4,0;;;;2,0;;4,0;;;1,0;;;2,0;1,0;2,0;;7,0;;;2,0;;;;;3,0;;;5,0;;10,0;4,0;;6,0;5,0;2,0;;1,0;;;5,0;2,0;;;6,0;2,0;;;;;;6,0;;;;2,0;5,0;7,0;;;6,0;13,0;;1,0;;4,0;;;;5,0;;;5,0;;;8,0;;;17,0;;12,0;;;;;;2,0;;8,0;5,0;;;62,0;;;;;;;;;;;;9,0;;;;
handle;;2,0;;2,0;;31,0;3,0;64,0;;;;;;19,0;;;11,0;;5,0;;;;;;1,0;;;8,0;3,0;2,0;40,0;;;;;7,0;8,0;3,0;;2,0;12,0;48,0;;18,0;31,0;19,0;;5,0;;1,0;;;50,0;5,0;15,0;;20,0;;2,0;1,0;;;6,0;;47,0;;66,0;2,0;;;1,0;20,0;9,0;;;;49,0;;;2,0;28,0;;9,0;;19,0;12,0;;6,0;;;1,0;6,0;2,0;;;;3,0;9,0;24,0;15,0;70,0;6,0;;4,0;4,0;19,0;;2,0;;;;;;;6,0;;;4,0;;25,0;;;1,0;2,0;;1,0;157,0;;;;1,0;;;26,0;;;21,0;1,0;;;5,0;3,0;1,0;;;2,0;4,0;10,0;6,0;41,0;1,0;1,0;51,0;3,0;;;;;;;;25,0;;3,0;;;70,0;5,0;;10,0;;;1,0;17,0;;8,0;1,0;;19,0;1,0;;;;13,0;;;1,0;3,0;11,0;8,0;;10,0;;2,0;3,0;2,0;75,0;;6,0;1,0;;1,0;;;3,0;;31,0;;22,0;189,0;15,0;12,0;19,0;;;4,0;;6,0;;;1,0;1,0;;;16,0;;43,0;3,0;1,0;;;;2,0;;11,0;;1,0;;3,0;2,0;;4,0;8,0;12,0;;2,0;;26,0;42,0;1,0;5,0;;;3,0;;1,0;40,0;23,0;4,0;;;;4,0;7,0;6,0;1,0;;;3,0;1,0;;1,0;8,0;8,0;7,0;5,0;4,0;8,0;;1,0;6,0;;22,0;1,0;;;1,0;2,0;3,0;;;2,0;;;3,0;36,0;9,0;;3,0;4,0;4,0;;1,0;;13,0;;;5,0;4,0;9,0;5,0;10,0;1,0;;2,0;4,0;5,0;15,0;;13,0;5,0;6,0;9,0;1,0;;1,0;;4,0;5,0;;;29,0;10,0;1,0;2,0;;;;;1,0;13,0;14,0;2,0;;1,0;24,0;44,0;14,0;;7,0;6,0;1,0;;3,0;1,0;9,0;1,0;17,0;17,0;2,0;8,0;;4,0;3,0;;3,0;;2,0;;;;;;9,0;3,0;;;18,0;;;32,0;1,0;;4,0;1,0;20,0;;;;;;;;1,0;3,0;2,0;;;;;;7,0;2,0;2,0;4,0;27,0;;1,0;2,0;7,0;2,0;2,0;;16,0;11,0;42,0;;;;;;;2,0;1,0;1,0;18,0;10,0;2,0;;2,0;2,0;1,0;;2,0;;37,0;6,0;;3,0;;3,0;1,0;;3,0;;1,0;;;38,0;;;;1,0;10,0;5,0;1,0;1,0;;2,0;1,0;2,0;4,0;;;22,0;;;6,0;;;;1,0;;3,0;10,0;7,0;;3,0;;;3,0;;4,0;1,0;;;;13,0;;;;;2,0;1,0;;;6,0;;16,0;;;1,0;;2,0;;12,0;2,0;;;1,0;;;4,0;1,0;;;;2,0;1,0;;4,0;1,0;;1,0;;;2,0;;1,0;;1,0;22,0;24,0;2,0;1,0;;;;2,0;3,0;;;;12,0;;;;7,0;;;;;;;;;;;2,0;;2,0;;;1,0;;;1,0;;;;;;;6,0;;6,0;;;;;7,0;;;7,0;7,0;3,0;13,0;;;5,0;;1,0;;;13,0;;;;;;;;;;;;4,0;;;1,0;;;;;8,0;6,0;;;;;1,0;;;5,0;;;;;;;;;;;;;;2,0;8,0;;;;32,0;;;;;;;6,0;;;;;;3,0;1,0;;;;;2,0;;;;;;;8,0;;7,0;;;;1,0;;;;;;;1,0;;3,0;;6,0;;6,0;;2,0;;12,0;;;;;;;6,0;1,0;;2,0;;2,0;2,0;;4,0;1,0;;;;;4,0;;6,0;1,0;;;1,0;;;14,0;;;;3,0;5,0;2,0;;;;;;4,0;18,0;;;13,0;21,0;;2,0;7,0;2,0;;2,0;2,0;8,0;;2,0;;;;;;;;;;4,0;15,0;7,0;9,0;4,0;11,0;2,0;1,0;1,0;;1,0;2,0;;1,0;1,0;2,0;1,0;;;1,0;1,0;;;;1,0;1,0;1,0;;;4,0;;;;;;;;;;;;;;;;;;;;;1,0;;;;;;;;1,0;;;;;;;;;;;;;;;;;;;;6,0;;1,0;;;;;;;;;;;;;2,0;;;;;;2,0;;;;;1,0;;;;1,0;;;;;;;;;;;;;;3,0;;;;;;;;1,0;;;;;;;;1,0;;;;;2,0;;;;;2,0;;4,0;;;;;;;2,0;5,0;;;;;;;;;;;1,0;;;;;;;;17,0;;;;1,0;;;;1,0;;4,0;;;;;;;3,0;;;;;;1,0;;;;;;;;;;;;6,0;;1,0;;;;;;;;3,0;;;;;;;;;;;;;;;;;;;
head;;3,0;1,0;32,0;2,0;105,0;3,0;99,0;4,0;;;21,0;;124,0;1,0;;36,0;1,0;1,0;;7,0;1,0;6,0;5,0;16,0;2,0;;29,0;18,0;24,0;105,0;24,0;3,0;1,0;;91,0;19,0;14,0;20,0;;133,0;216,0;19,0;9,0;187,0;37,0;;54,0;;;7,0;;52,0;14,0;33,0;;23,0;1,0;1,0;19,0;8,0;;1,0;;161,0;1,0;133,0;;7,0;4,0;1,0;46,0;36,0;9,0;;;4,0;9,0;;6,0;114,0;;6,0;3,0;73,0;18,0;9,0;19,0;5,0;1,0;1,0;3,0;6,0;8,0;1,0;13,0;6,0;13,0;102,0;33,0;284,0;2,0;2,0;1,0;60,0;33,0;;1,0;;;;4,0;51,0;7,0;1,0;1,0;2,0;9,0;9,0;102,0;;;38,0;3,0;;3,0;157,0;;1,0;1,0;14,0;;;48,0;2,0;;32,0;7,0;1,0;;1,0;2,0;2,0;;14,0;5,0;14,0;17,0;10,0;44,0;5,0;6,0;20,0;25,0;2,0;;;1,0;;;;77,0;16,0;4,0;1,0;;93,0;19,0;;20,0;21,0;1,0;7,0;73,0;;1,0;3,0;4,0;3,0;;;5,0;;24,0;19,0;;2,0;3,0;32,0;20,0;13,0;2,0;7,0;16,0;6,0;18,0;89,0;;4,0;20,0;;;;;13,0;3,0;31,0;5,0;91,0;334,0;42,0;112,0;5,0;;7,0;18,0;19,0;4,0;;16,0;4,0;1,0;19,0;3,0;9,0;;78,0;3,0;3,0;1,0;;;43,0;;10,0;;4,0;;4,0;5,0;;9,0;3,0;1,0;1,0;25,0;3,0;27,0;63,0;23,0;8,0;;;55,0;4,0;4,0;64,0;47,0;3,0;;7,0;11,0;7,0;44,0;14,0;1,0;;;;10,0;1,0;14,0;1,0;8,0;5,0;1,0;17,0;30,0;2,0;7,0;3,0;1,0;46,0;2,0;;2,0;6,0;4,0;12,0;8,0;1,0;1,0;;6,0;11,0;25,0;39,0;5,0;;7,0;1,0;3,0;4,0;;6,0;5,0;5,0;;;77,0;;3,0;8,0;1,0;6,0;;9,0;13,0;5,0;20,0;7,0;38,0;8,0;;;1,0;;15,0;18,0;8,0;2,0;2,0;1,0;23,0;3,0;;1,0;;2,0;3,0;32,0;27,0;8,0;20,0;10,0;45,0;44,0;19,0;;2,0;;;;;52,0;;16,0;5,0;89,0;1,0;;6,0;1,0;2,0;;2,0;;3,0;;3,0;10,0;;2,0;7,0;13,0;4,0;;;3,0;;69,0;4,0;1,0;7,0;3,0;73,0;1,0;4,0;;;4,0;1,0;;3,0;5,0;1,0;;5,0;12,0;5,0;2,0;3,0;10,0;12,0;;12,0;;40,0;36,0;11,0;2,0;16,0;;1,0;8,0;61,0;;6,0;13,0;;;6,0;2,0;;;68,0;18,0;13,0;1,0;9,0;16,0;1,0;1,0;;38,0;1,0;1,0;33,0;10,0;1,0;1,0;;4,0;85,0;;3,0;;;246,0;21,0;;;7,0;1,0;52,0;8,0;;10,0;;3,0;11,0;5,0;1,0;3,0;12,0;;3,0;;;9,0;2,0;4,0;10,0;2,0;2,0;6,0;23,0;1,0;;5,0;;;;5,0;5,0;2,0;6,0;2,0;15,0;40,0;2,0;2,0;5,0;3,0;;;34,0;10,0;;;2,0;2,0;1,0;;3,0;16,0;;8,0;1,0;;;;1,0;;;16,0;105,0;3,0;9,0;;19,0;16,0;1,0;1,0;;;18,0;;;;1,0;2,0;;7,0;12,0;;3,0;;;1,0;;;19,0;13,0;2,0;2,0;3,0;2,0;2,0;;;9,0;;11,0;;1,0;;;5,0;;;8,0;5,0;1,0;;;4,0;;2,0;;;1,0;;1,0;9,0;7,0;;5,0;14,0;;;;;37,0;;11,0;21,0;;1,0;2,0;1,0;13,0;;1,0;3,0;;1,0;;7,0;;;;6,0;4,0;6,0;1,0;2,0;;;;2,0;;;;;5,0;12,0;;;2,0;;;;3,0;;;1,0;;;2,0;;;;;6,0;23,0;;3,0;3,0;;1,0;;1,0;14,0;;;;3,0;;;1,0;;1,0;;;2,0;;;2,0;;;1,0;;1,0;;1,0;2,0;;;;10,0;;8,0;1,0;;;3,0;;22,0;;;4,0;;8,0;6,0;1,0;1,0;;;;;3,0;;;;32,0;;5,0;;3,0;;;;17,0;5,0;15,0;1,0;2,0;1,0;14,0;2,0;23,0;2,0;;3,0;24,0;;;;1,0;1,0;;;;1,0;1,0;19,0;15,0;3,0;;1,0;;;;71,0;;5,0;12,0;2,0;;19,0;6,0;5,0;23,0;29,0;;;;3,0;;3,0;;17,0;1,0;1,0;;3,0;;;10,0;;;22,0;3,0;14,0;;1,0;;6,0;6,0;1,0;5,0;;9,0;;2,0;;2,0;7,0;;;;;;6,0;;3,0;;;;;;;;;;;;;;1,0;;;2,0;;;;;2,0;;2,0;;;;1,0;;;;;;;5,0;;;;3,0;;;;4,0;;;4,0;;;;4,0;2,0;1,0;;2,0;;1,0;;;;;;;;;1,0;;12,0;;1,0;4,0;9,0;;1,0;1,0;4,0;1,0;3,0;;;1,0;;;;;;;;;6,0;;;;2,0;3,0;;1,0;3,0;;2,0;;;;;;;;;;;;;4,0;2,0;;31,0;1,0;;;;20,0;;7,0;;;;1,0;4,0;4,0;;2,0;;;;;3,0;4,0;;;2,0;9,0;;;;;;;2,0;;4,0;;;;;;1,0;;2,0;;;;;1,0;;5,0;;;;;1,0;2,0;;;;9,0;;;1,0;;;;;18,0;;1,0;2,0;;;2,0;;;;;;4,0;;;;4,0;;;;;;6,0;;;;;;;;;
held;;4,0;;;;5,0;;12,0;;;;;9,0;27,0;;;4,0;9,0;5,0;;;;1,0;;;;;6,0;;;16,0;1,0;;1,0;;;2,0;7,0;;;8,0;55,0;;1,0;1,0;1,0;;30,0;;;;;7,0;2,0;1,0;;15,0;6,0;;;;;3,0;;25,0;;8,0;;;;;89,0;3,0;;;;4,0;;;17,0;16,0;;;;22,0;4,0;;9,0;;;3,0;11,0;;2,0;1,0;;1,0;2,0;;1,0;46,0;3,0;;;1,0;3,0;;1,0;;;;2,0;5,0;;1,0;;2,0;2,0;;13,0;;2,0;138,0;;;;8,0;;;;1,0;;;39,0;;;8,0;;;;;2,0;;;3,0;;6,0;2,0;34,0;;10,0;10,0;20,0;4,0;4,0;12,0;;;;;;3,0;7,0;1,0;;;1,0;2,0;;1,0;1,0;;6,0;10,0;;3,0;5,0;1,0;1,0;;;;;4,0;;;10,0;2,0;10,0;5,0;;25,0;;95,0;40,0;2,0;11,0;;7,0;1,0;;11,0;4,0;;1,0;;49,0;1,0;20,0;35,0;3,0;6,0;;;;2,0;17,0;1,0;;;;13,0;;2,0;8,0;;75,0;;5,0;;;;1,0;1,0;5,0;;;;4,0;;;7,0;1,0;4,0;4,0;1,0;;5,0;5,0;1,0;1,0;;2,0;8,0;1,0;;14,0;10,0;;;6,0;;;2,0;9,0;2,0;;;;1,0;;;8,0;4,0;1,0;;13,0;1,0;;;1,0;;13,0;10,0;;8,0;11,0;3,0;11,0;;;;;10,0;;;;;;1,0;;8,0;3,0;;1,0;2,0;6,0;3,0;;10,0;4,0;1,0;4,0;;1,0;;3,0;6,0;2,0;5,0;13,0;14,0;;2,0;;;;;;10,0;;1,0;;14,0;1,0;;;;;;5,0;2,0;;4,0;;1,0;;9,0;;3,0;;2,0;;;2,0;6,0;8,0;;8,0;;;;;;;;;;;;;;;1,0;5,0;;;;;;8,0;;;1,0;;2,0;;12,0;;;;;;1,0;;;;;;;;3,0;;12,0;;2,0;;1,0;3,0;;8,0;1,0;;9,0;6,0;6,0;;;;;;;;;;19,0;;;;2,0;15,0;;;;1,0;;;;5,0;;1,0;6,0;1,0;4,0;;;;;48,0;;;20,0;1,0;;1,0;;;;;;13,0;;;;;;;;;2,0;;;;;4,0;;;;1,0;;6,0;;;;;2,0;1,0;;7,0;;;;;;;;1,0;;;;;;;;;3,0;;;;;;2,0;;;;;;;;;2,0;;;;;;3,0;2,0;1,0;;6,0;;9,0;;2,0;;;1,0;;;;;8,0;5,0;;;;;;;;;;;3,0;;;;;;;5,0;1,0;;;;;;;;;;;3,0;;1,0;;1,0;;;;;;2,0;1,0;1,0;1,0;;;1,0;;;;;;;;;;;;;;2,0;;;2,0;;;;;;;;4,0;;;;;;;;;;;;;;;;;;;;11,0;;;;1,0;;;;1,0;;;3,0;;1,0;;;;;;;;2,0;;3,0;;;1,0;;;;;;;;;;3,0;;5,0;1,0;;;;;2,0;;;1,0;;;;;;;1,0;1,0;;19,0;;;;47,0;;;;;;2,0;;2,0;2,0;;3,0;;;;;;;;;;;1,0;;;;;;;;;;;;;;;;3,0;1,0;;;5,0;;1,0;;13,0;;;1,0;;1,0;;;;;;4,0;;;;;;;4,0;;;;;4,0;;;;;;;;;1,0;;;1,0;1,0;4,0;;;;;;;;;;;;2,0;;;;1,0;;3,0;;;4,0;;;1,0;;4,0;;;;;;;;;;9,0;;;;;;;;;1,0;;;;;;;;;;;;;;;;;1,0;;;;;;;;;;;;;;;;1,0;;;;;;;;;;;;;;;;;;;;;;;1,0;;2,0;;1,0;;;;3,0;;;;;;;;;;;4,0;;;;;;1,0;;;;1,0;;;;;;1,0;;;;;;;;;;;;;21,0;;;;2,0;;1,0;;;;;;;;8,0;;;;;;;;;;2,0;;;;;;;;;;;;;1,0;;;;;;;1,0;;;;;;;;;;;;;;;;;;;;;;;;;;;;
hinge;;1,0;;5,0;;13,0;;31,0;;;;;19,0;24,0;;;2,0;;4,0;;;;;;3,0;;;8,0;1,0;;22,0;;;;;;4,0;5,0;;;;32,0;1,0;9,0;5,0;5,0;;6,0;;;;;13,0;6,0;;;33,0;;;;;;;;3,0;;31,0;;;3,0;;5,0;1,0;;;;1,0;;;;2,0;;4,0;;17,0;8,0;;1,0;;;;1,0;;4,0;;;;1,0;5,0;;28,0;;;;;;;;;;;;;;2,0;;;1,0;;;;;3,0;;;;25,0;;;;;;3,0;27,0;;;4,0;;;;;;;;2,0;;1,0;3,0;;62,0;14,0;2,0;49,0;7,0;;;2,0;;;;;45,0;;;;;97,0;13,0;;;;;;7,0;;21,0;1,0;;9,0;;;;3,0;15,0;;;;;19,0;1,0;;;;1,0;3,0;5,0;44,0;;15,0;4,0;;;;;;;44,0;;15,0;34,0;5,0;3,0;;;;16,0;;;6,0;3,0;;;;;;;51,0;;;;;;;;;;;;;;;;10,0;3,0;5,0;;7,0;5,0;60,0;7,0;1,0;;;41,0;;;33,0;16,0;;;2,0;5,0;;2,0;19,0;;;;;;;4,0;6,0;4,0;;;10,0;1,0;;;10,0;;5,0;1,0;;;;8,0;2,0;;2,0;2,0;4,0;;1,0;7,0;;;;2,0;2,0;;2,0;;;13,0;6,0;5,0;;1,0;;1,0;;2,0;;9,0;10,0;;;42,0;;1,0;8,0;2,0;4,0;;1,0;;;2,0;;2,0;;5,0;;;;;;2,0;43,0;16,0;;3,0;;18,0;25,0;;3,0;2,0;;7,0;;;;;;1,0;;;;;;;;;;9,0;1,0;;;;;;;;;;;;1,0;;;1,0;;;;;;;;;;;2,0;2,0;;;;;;;2,0;;;4,0;;6,0;2,0;3,0;1,0;1,0;;;;1,0;;;;;;;;;;;;3,0;;;;;;;;;1,0;;;;;;;2,0;;;;;;;;;;9,0;1,0;;;;;;;;;;;;;;;;;;;12,0;;21,0;;1,0;;;2,0;;;4,0;3,0;;2,0;;;;;;;;;;;;;;;;;;;2,0;;;;;;;2,0;;;;;10,0;1,0;;7,0;22,0;1,0;;;;9,0;;;;3,0;;;;2,0;2,0;;;1,0;;;;1,0;22,0;;;;;;;;;;;;;;;;;;2,0;;;;;2,0;;1,0;;;;;1,0;;;;;;;;;3,0;;;;9,0;;;;;;;;41,0;;;;;;;;;;;;;;;;;;;;1,0;;;;;;;;;;;;;;;4,0;;;;;;;;10,0;4,0;;;;2,0;;;;;2,0;;;;;;;;;;;;;;;;;;;;;;;;;1,0;;;;;;;;;;;;1,0;6,0;;;3,0;;;1,0;;;;3,0;;1,0;;2,0;;;;;;1,0;;;;;;;;;;;;;;;;2,0;1,0;;;;37,0;2,0;;;;;;;16,0;;4,0;10,0;;2,0;;11,0;;1,0;;;6,0;;;;1,0;;2,0;;;;;;;;7,0;4,0;1,0;;2,0;;;;;;;;;1,0;;;;;;;;;;1,0;;;;;;;;;;;;;;;;;;;;;;;;;;;;;;;;;;;;;;;;;;;;;;;;;;;;;;;;;;4,0;;;;1,0;;;;;;;;;;;;;;1,0;;;;;;;;;;1,0;;;;;;;;;;;4,0;;;;;;;;;;;;;;;;;;;;;;;;;;;;;;;;;2,0;;;3,0;;;;;;;;;;4,0;;;;;;;;;1,0;;;;1,0;;;;1,0;;;;;;;;;;4,0;;;;;;;4,0;;;;;;;;;;;;;;;;;;;;;;;;;;;;;;;;;;;;;;;
hold;;21,0;;2,0;5,0;62,0;4,0;146,0;2,0;;2,0;;44,0;137,0;;;19,0;12,0;3,0;1,0;;;2,0;2,0;30,0;;;12,0;1,0;1,0;293,0;;;11,0;;24,0;7,0;65,0;6,0;2,0;2,0;215,0;1,0;9,0;10,0;40,0;;296,0;;;;;78,0;3,0;;;33,0;56,0;;12,0;2,0;;27,0;;48,0;;230,0;;1,0;1,0;2,0;307,0;16,0;;;;15,0;3,0;;59,0;35,0;;6,0;;187,0;39,0;;64,0;10,0;1,0;8,0;1,0;5,0;1,0;;1,0;18,0;9,0;98,0;1,0;144,0;14,0;;10,0;2,0;20,0;1,0;4,0;;;;26,0;16,0;;1,0;;1,0;38,0;1,0;83,0;1,0;;164,0;4,0;;2,0;67,0;;1,0;2,0;23,0;3,0;;220,0;1,0;;5,0;;1,0;2,0;;6,0;;;8,0;3,0;5,0;46,0;20,0;27,0;23,0;;83,0;12,0;12,0;64,0;12,0;;3,0;;2,0;27,0;1,0;2,0;9,0;;31,0;15,0;;7,0;5,0;1,0;2,0;73,0;;5,0;4,0;3,0;12,0;1,0;;;5,0;24,0;34,0;;38,0;7,0;126,0;44,0;;3,0;2,0;;130,0;20,0;54,0;4,0;16,0;25,0;1,0;13,0;2,0;;;2,0;350,0;3,0;97,0;82,0;26,0;26,0;2,0;1,0;4,0;32,0;73,0;7,0;;2,0;1,0;15,0;2,0;31,0;30,0;;410,0;1,0;5,0;1,0;3,0;19,0;3,0;;13,0;;;;2,0;;3,0;28,0;12,0;11,0;13,0;15,0;;12,0;31,0;8,0;10,0;1,0;2,0;134,0;29,0;30,0;101,0;105,0;8,0;;13,0;13,0;;5,0;17,0;4,0;;;1,0;21,0;3,0;2,0;11,0;4,0;16,0;;5,0;8,0;1,0;3,0;16,0;2,0;37,0;41,0;;12,0;34,0;14,0;58,0;9,0;27,0;3,0;15,0;19,0;1,0;11,0;15,0;1,0;4,0;5,0;8,0;;11,0;2,0;3,0;6,0;2,0;16,0;1,0;31,0;4,0;2,0;17,0;2,0;;;6,0;10,0;5,0;33,0;10,0;40,0;1,0;6,0;6,0;;10,0;4,0;29,0;7,0;9,0;2,0;4,0;6,0;;4,0;4,0;1,0;;;43,0;44,0;9,0;1,0;2,0;8,0;;11,0;;9,0;;9,0;;;2,0;10,0;4,0;23,0;31,0;;;;;;1,0;1,0;;;;;2,0;1,0;;6,0;8,0;4,0;;;4,0;;23,0;;;;1,0;;4,0;12,0;;;;3,0;;7,0;2,0;2,0;;;;;;12,0;8,0;146,0;3,0;;;1,0;25,0;10,0;4,0;8,0;;2,0;6,0;3,0;5,0;;;;;;11,0;2,0;;31,0;2,0;3,0;;;5,0;;2,0;;;6,0;7,0;9,0;35,0;;;13,0;;3,0;;2,0;;1,0;34,0;;;97,0;;1,0;5,0;;;;10,0;1,0;;;2,0;3,0;;1,0;;3,0;2,0;3,0;1,0;1,0;27,0;3,0;11,0;23,0;2,0;;4,0;5,0;71,0;;;4,0;1,0;;6,0;;2,0;;;;1,0;12,0;;;4,0;;2,0;;;11,0;5,0;2,0;;3,0;1,0;;;;;;;1,0;1,0;1,0;1,0;14,0;;;13,0;8,0;;3,0;;;4,0;27,0;3,0;;3,0;6,0;9,0;22,0;4,0;;1,0;;3,0;1,0;;;6,0;39,0;;;;;;1,0;;8,0;1,0;3,0;2,0;4,0;4,0;;8,0;;3,0;2,0;2,0;;;;;;3,0;;;5,0;;19,0;12,0;1,0;;;6,0;;;;;23,0;1,0;6,0;12,0;;;1,0;;6,0;;;;;;;1,0;;;3,0;;3,0;;;;;;;;;;;1,0;1,0;;;;6,0;3,0;;;4,0;;;1,0;;;;;;;;9,0;;4,0;6,0;1,0;4,0;2,0;2,0;2,0;10,0;5,0;;;;1,0;;2,0;;3,0;;4,0;;;;57,0;24,0;;;;;;;;;;;32,0;;2,0;;;3,0;2,0;6,0;5,0;;;8,0;;7,0;;2,0;;1,0;3,0;6,0;;8,0;;;;173,0;;5,0;7,0;1,0;;;;24,0;4,0;3,0;3,0;2,0;;1,0;;5,0;15,0;;95,0;2,0;;;11,0;1,0;;9,0;3,0;;;1,0;1,0;;;;;;;2,0;22,0;;3,0;1,0;3,0;1,0;;5,0;9,0;2,0;2,0;;6,0;;;;;;6,0;2,0;2,0;;14,0;3,0;6,0;3,0;;2,0;;6,0;;;;;;1,0;;13,0;4,0;9,0;1,0;;6,0;;6,0;2,0;2,0;;2,0;;9,0;;8,0;4,0;3,0;1,0;12,0;4,0;;16,0;6,0;;29,0;7,0;2,0;2,0;;;15,0;;2,0;;;;;;37,0;;;;13,0;;2,0;4,0;;;;;;1,0;4,0;2,0;3,0;4,0;2,0;1,0;;2,0;;;;;;;15,0;;;7,0;;;;;;;;1,0;;1,0;;;;2,0;;;;2,0;;;5,0;1,0;;;;3,0;;;;;4,0;;;2,0;;;;1,0;4,0;2,0;;;;;1,0;;;1,0;;;;;;;;;1,0;;;;;;3,0;;10,0;;2,0;;;;;4,0;;;3,0;5,0;;;;3,0;;;;;2,0;60,0;;;;;7,0;4,0;;4,0;2,0;;;;;2,0;;2,0;;;;2,0;;;;3,0;;;;;;;;;;;;;1,0;;;;1,0;;;;;1,0;;;;;;;;;;;;;;;;;;;;;;;;;;
holder;;8,0;;18,0;3,0;95,0;;101,0;;;3,0;1,0;147,0;152,0;;;7,0;;7,0;;5,0;2,0;;1,0;1,0;;;23,0;9,0;;178,0;7,0;3,0;3,0;;1,0;33,0;4,0;2,0;2,0;;239,0;10,0;7,0;2,0;312,0;;70,0;;;;;48,0;1,0;;;153,0;;;2,0;2,0;;4,0;;168,0;;264,0;;;27,0;4,0;1925,0;23,0;1,0;;3,0;9,0;;;4,0;53,0;;;;422,0;63,0;;190,0;5,0;;;3,0;8,0;22,0;;;;21,0;68,0;5,0;205,0;16,0;;4,0;1,0;;;2,0;;;;6,0;47,0;3,0;9,0;;;2,0;;216,0;;;3,0;1,0;;2,0;96,0;;9,0;1,0;;;3,0;151,0;;5,0;3,0;;3,0;1,0;20,0;5,0;;;12,0;16,0;23,0;50,0;2,0;149,0;11,0;8,0;70,0;53,0;10,0;;21,0;3,0;;;16,0;98,0;;;;;180,0;39,0;;18,0;3,0;;4,0;177,0;;20,0;4,0;1,0;9,0;9,0;;2,0;4,0;57,0;3,0;;59,0;12,0;38,0;32,0;;1,0;6,0;130,0;;15,0;152,0;2,0;67,0;18,0;2,0;4,0;3,0;2,0;1,0;2,0;523,0;24,0;131,0;116,0;81,0;23,0;4,0;;2,0;92,0;1,0;1,0;;4,0;19,0;;;;20,0;;327,0;3,0;6,0;1,0;27,0;2,0;9,0;;7,0;;1,0;;8,0;1,0;3,0;43,0;2,0;6,0;1,0;5,0;7,0;27,0;208,0;4,0;23,0;2,0;3,0;33,0;24,0;4,0;180,0;312,0;10,0;;;2,0;1,0;11,0;38,0;;1,0;;2,0;11,0;2,0;98,0;47,0;8,0;6,0;2,0;13,0;22,0;18,0;3,0;5,0;1,0;121,0;73,0;;;27,0;56,0;89,0;;154,0;1,0;9,0;37,0;1,0;;10,0;2,0;40,0;13,0;16,0;30,0;3,0;12,0;;15,0;3,0;6,0;8,0;18,0;8,0;;27,0;7,0;3,0;;36,0;4,0;9,0;19,0;6,0;3,0;16,0;5,0;1,0;24,0;8,0;9,0;3,0;41,0;23,0;1,0;;15,0;;;3,0;;6,0;2,0;25,0;13,0;7,0;19,0;4,0;17,0;2,0;58,0;;57,0;;;;1,0;;42,0;4,0;142,0;15,0;;;2,0;1,0;;;3,0;;;;;;;2,0;13,0;3,0;;;;3,0;;11,0;;;2,0;4,0;16,0;;;;1,0;;;;7,0;2,0;4,0;2,0;;;;;2,0;11,0;2,0;;;;3,0;8,0;13,0;2,0;47,0;;3,0;1,0;6,0;13,0;;;;;;;;;50,0;;2,0;;;8,0;;2,0;3,0;;;12,0;1,0;3,0;;;47,0;2,0;18,0;;;;1,0;5,0;;;1,0;;3,0;13,0;7,0;;9,0;;;1,0;1,0;;;;;;;;;;;;1,0;13,0;12,0;;3,0;;15,0;285,0;2,0;2,0;6,0;1,0;;7,0;4,0;3,0;;;;;5,0;1,0;;1,0;3,0;;;;3,0;7,0;2,0;;2,0;2,0;8,0;2,0;;;;5,0;30,0;;;;11,0;4,0;;6,0;18,0;2,0;19,0;;;2,0;10,0;1,0;;2,0;;1,0;50,0;4,0;;1,0;;2,0;3,0;;4,0;123,0;50,0;;;;;2,0;;;;;;;2,0;;;1,0;;2,0;2,0;6,0;3,0;;;;3,0;;;;;;41,0;16,0;3,0;;;6,0;;;;;20,0;3,0;1,0;6,0;;;5,0;1,0;;;;;;;;;7,0;;;;4,0;2,0;;;;;;;;1,0;;;3,0;;;;16,0;;;;;;;2,0;;;;;;3,0;;;;;3,0;7,0;;;2,0;10,0;;;;;3,0;;;;;;;;4,0;;1,0;12,0;52,0;;;;;;;;;5,0;;2,0;;3,0;1,0;;;;;;;;10,0;;;;;;;30,0;;4,0;3,0;;;;79,0;1,0;1,0;;6,0;;1,0;9,0;36,0;138,0;2,0;7,0;2,0;;;;1,0;9,0;;40,0;;;25,0;;1,0;;1,0;7,0;;1,0;4,0;;;;;;2,0;;4,0;56,0;;;;9,0;4,0;;;;23,0;1,0;1,0;1,0;1,0;1,0;2,0;1,0;70,0;4,0;;4,0;1,0;1,0;;3,0;9,0;7,0;4,0;;5,0;;;5,0;;1,0;8,0;;12,0;;;1,0;;1,0;;15,0;2,0;3,0;;;;6,0;;;4,0;;;;;;;;1,0;;1,0;;;;;23,0;1,0;;;;2,0;2,0;;;;;;;;;5,0;;;;;;;;;6,0;6,0;;4,0;;;;;;4,0;;1,0;6,0;;40,0;15,0;;;;;;;;;;;;;;;1,0;;;;;;1,0;;;;;;;;;;;;2,0;;;;;;5,0;1,0;;;;;;;;1,0;;1,0;;;;;;;;;5,0;;;;;3,0;5,0;;;;;;;11,0;;;;;;;1,0;;;;;;8,0;;;4,0;;;;5,0;;;4,0;2,0;;;8,0;;;8,0;;6,0;4,0;;;;2,0;13,0;;;;;;;;;20,0;;;8,0;;;2,0;;;;;;1,0;;;;;;;;1,0;;;;;;;;;;;;;;;;;;;
hole;;5,0;;13,0;;24,0;20,0;67,0;;;3,0;18,0;21,0;142,0;;;15,0;;4,0;;34,0;5,0;8,0;49,0;14,0;;;91,0;;;117,0;1,0;;3,0;;1,0;164,0;5,0;5,0;7,0;5,0;106,0;128,0;2,0;19,0;165,0;;63,0;1,0;;;1,0;81,0;9,0;18,0;1,0;396,0;10,0;;6,0;5,0;;6,0;;76,0;1,0;204,0;10,0;3,0;27,0;14,0;272,0;147,0;;;;33,0;3,0;;1,0;49,0;;;3,0;178,0;28,0;;41,0;4,0;2,0;;3,0;155,0;4,0;;;33,0;2,0;200,0;14,0;142,0;22,0;3,0;9,0;;;;;;;;5,0;22,0;4,0;15,0;;;14,0;;52,0;;2,0;32,0;23,0;4,0;10,0;50,0;;3,0;1,0;4,0;;;98,0;;;25,0;11,0;;1,0;3,0;18,0;1,0;;12,0;5,0;19,0;77,0;7,0;33,0;;15,0;98,0;65,0;;1,0;13,0;1,0;;1,0;42,0;103,0;;;;;178,0;79,0;3,0;11,0;4,0;;17,0;58,0;19,0;50,0;16,0;3,0;3,0;;;;83,0;32,0;56,0;44,0;57,0;8,0;34,0;27,0;2,0;;8,0;20,0;15,0;;135,0;11,0;72,0;151,0;15,0;156,0;2,0;1,0;1,0;;197,0;11,0;8,0;232,0;18,0;4,0;2,0;2,0;;41,0;;17,0;2,0;8,0;17,0;;;;139,0;2,0;353,0;13,0;5,0;2,0;30,0;;18,0;;23,0;;;;9,0;2,0;14,0;18,0;6,0;4,0;14,0;5,0;;30,0;131,0;21,0;18,0;2,0;6,0;136,0;121,0;;149,0;283,0;17,0;;2,0;12,0;2,0;12,0;70,0;;;6,0;;50,0;;43,0;10,0;8,0;11,0;;29,0;4,0;15,0;4,0;9,0;;38,0;71,0;;;34,0;24,0;47,0;15,0;23,0;2,0;7,0;2,0;3,0;8,0;20,0;4,0;14,0;44,0;38,0;9,0;8,0;;;30,0;2,0;18,0;3,0;28,0;6,0;37,0;30,0;12,0;7,0;22,0;33,0;79,0;1,0;4,0;5,0;1,0;26,0;1,0;8,0;25,0;;13,0;4,0;6,0;99,0;2,0;2,0;32,0;;5,0;2,0;;1,0;1,0;19,0;12,0;1,0;364,0;4,0;32,0;2,0;39,0;4,0;13,0;;12,0;;18,0;2,0;8,0;3,0;72,0;6,0;;5,0;;;2,0;;17,0;;;;2,0;10,0;;2,0;64,0;;;1,0;;3,0;;11,0;;;2,0;4,0;3,0;;2,0;;;;;;4,0;;1,0;;;;;;;4,0;;1,0;31,0;;5,0;17,0;6,0;6,0;23,0;;3,0;2,0;5,0;6,0;;1,0;;;;7,0;;;207,0;;;;2,0;9,0;;1,0;;1,0;;1,0;6,0;3,0;;1,0;16,0;;;;;;3,0;6,0;;;;1,0;2,0;11,0;;;;2,0;8,0;;;;3,0;;;;;;;2,0;;;1,0;2,0;51,0;2,0;1,0;;2,0;12,0;;8,0;2,0;1,0;;9,0;3,0;2,0;;;1,0;3,0;7,0;;;;5,0;;;;;7,0;4,0;;4,0;;;3,0;;;;23,0;;3,0;;;9,0;;7,0;22,0;11,0;;3,0;;;3,0;;16,0;;10,0;;2,0;152,0;2,0;;;;1,0;24,0;;;;69,0;1,0;;;;1,0;;;;;;;4,0;;40,0;;;;;7,0;;;;1,0;1,0;;;;2,0;;13,0;64,0;2,0;;5,0;7,0;;1,0;;;37,0;;17,0;13,0;;;3,0;;;;;3,0;;;4,0;2,0;1,0;;;;3,0;;;1,0;3,0;;2,0;;;2,0;18,0;;5,0;;;;;;;;;3,0;;4,0;;;;11,0;;;6,0;2,0;;;1,0;2,0;;8,0;2,0;4,0;1,0;;3,0;;3,0;;3,0;;;;;;2,0;;3,0;4,0;;;;;1,0;2,0;1,0;1,0;;3,0;;10,0;;;;;;;;;;;1,0;;10,0;;;;5,0;34,0;;;29,0;;;;57,0;;4,0;3,0;5,0;1,0;;7,0;2,0;18,0;26,0;21,0;4,0;;;1,0;6,0;9,0;;2,0;2,0;;7,0;;3,0;;4,0;1,0;;;;15,0;;;;;5,0;;;3,0;;4,0;87,0;;22,0;;10,0;4,0;134,0;15,0;;;6,0;2,0;1,0;32,0;13,0;21,0;4,0;;2,0;;6,0;3,0;;37,0;;;10,0;20,0;3,0;7,0;1,0;;22,0;;1,0;18,0;;2,0;2,0;1,0;;75,0;5,0;;;;;16,0;;;10,0;2,0;;;;1,0;;7,0;;;;;;3,0;;27,0;;2,0;23,0;;;2,0;;;;1,0;;;;1,0;;;;2,0;;;;;;1,0;4,0;;1,0;;18,0;;1,0;;4,0;;;;;4,0;1,0;;;;1,0;;;;18,0;4,0;;1,0;;;;1,0;;;;;1,0;;;;;4,0;;;;;;;;;;1,0;;;1,0;8,0;;;;;;;;;;;3,0;;;;;;;;;;;;2,0;;;8,0;;8,0;;;;;3,0;;;4,0;;1,0;2,0;;4,0;;;;;;;;2,0;;6,0;;1,0;;3,0;;;;;1,0;9,0;2,0;3,0;;8,0;3,0;2,0;;;;5,0;;;;;;;;;4,0;;;14,0;1,0;;;;;;;;3,0;;;3,0;;;;;;;;;;;;;;;;;;;;;;;;
house;;17,0;5,0;86,0;;287,0;66,0;803,0;2,0;;;5,0;340,0;456,0;1,0;2,0;127,0;1,0;35,0;;15,0;;7,0;10,0;58,0;3,0;5,0;233,0;7,0;2,0;718,0;37,0;;8,0;;44,0;175,0;34,0;15,0;3,0;62,0;857,0;24,0;172,0;186,0;1364,0;;529,0;;;;22,0;293,0;169,0;36,0;12,0;467,0;;1,0;45,0;44,0;;20,0;;651,0;3,0;1202,0;6,0;2,0;83,0;37,0;1918,0;366,0;10,0;1,0;;152,0;3,0;;58,0;300,0;;8,0;1,0;1016,0;104,0;2,0;374,0;98,0;7,0;;109,0;71,0;22,0;9,0;13,0;1,0;67,0;377,0;79,0;745,0;52,0;1,0;51,0;25,0;190,0;11,0;4,0;1,0;4,0;;4,0;52,0;9,0;47,0;;2,0;32,0;5,0;736,0;;1,0;41,0;11,0;6,0;5,0;490,0;;11,0;36,0;14,0;;10,0;639,0;;20,0;94,0;1,0;4,0;11,0;26,0;74,0;2,0;;246,0;19,0;136,0;222,0;21,0;407,0;24,0;31,0;423,0;232,0;8,0;4,0;6,0;58,0;;5,0;120,0;526,0;;10,0;2,0;1,0;812,0;395,0;4,0;11,0;45,0;;52,0;248,0;106,0;64,0;23,0;26,0;55,0;6,0;1,0;8,0;67,0;299,0;37,0;30,0;44,0;40,0;252,0;1638,0;21,0;4,0;109,0;54,0;152,0;135,0;;13,0;309,0;67,0;9,0;48,0;20,0;;14,0;5,0;1099,0;56,0;90,0;1052,0;107,0;62,0;7,0;10,0;27,0;412,0;31,0;41,0;6,0;32,0;44,0;;3,0;;158,0;10,0;1736,0;11,0;54,0;6,0;89,0;48,0;27,0;3,0;953,0;1,0;28,0;18,0;20,0;2,0;5,0;80,0;48,0;27,0;200,0;42,0;46,0;112,0;752,0;62,0;68,0;13,0;19,0;250,0;147,0;16,0;441,0;1253,0;70,0;;22,0;29,0;1,0;214,0;355,0;13,0;4,0;26,0;1,0;169,0;36,0;49,0;83,0;43,0;63,0;4,0;69,0;60,0;61,0;57,0;96,0;4,0;267,0;374,0;;23,0;77,0;34,0;417,0;19,0;296,0;61,0;28,0;217,0;22,0;119,0;51,0;11,0;118,0;112,0;124,0;55,0;47,0;18,0;30,0;81,0;75,0;89,0;15,0;154,0;7,0;25,0;248,0;83,0;82,0;11,0;200,0;48,0;21,0;194,0;82,0;62,0;100,0;45,0;21,0;27,0;29,0;3,0;74,0;141,0;102,0;78,0;9,0;123,0;25,0;15,0;19,0;4,0;17,0;9,0;97,0;128,0;30,0;28,0;22,0;290,0;133,0;143,0;7,0;90,0;4,0;12,0;;;26,0;16,0;20,0;238,0;170,0;50,0;3,0;5,0;;2,0;3,0;36,0;3,0;11,0;2,0;1,0;36,0;1,0;3,0;56,0;9,0;2,0;9,0;;3,0;;94,0;2,0;;8,0;10,0;42,0;;;;;;5,0;;25,0;27,0;10,0;7,0;3,0;6,0;1,0;;44,0;119,0;5,0;4,0;32,0;2,0;32,0;31,0;99,0;16,0;102,0;;14,0;22,0;128,0;7,0;2,0;12,0;;1,0;4,0;3,0;21,0;;267,0;8,0;11,0;4,0;29,0;34,0;;4,0;8,0;;1,0;37,0;3,0;26,0;;21,0;67,0;1,0;41,0;1,0;4,0;1,0;6,0;161,0;;;;5,0;21,0;24,0;84,0;;4,0;10,0;8,0;42,0;9,0;;16,0;1,0;;;;2,0;;7,0;19,0;7,0;97,0;235,0;33,0;16,0;4,0;;14,0;286,0;8,0;34,0;19,0;26,0;7,0;7,0;34,0;65,0;1,0;;;8,0;40,0;18,0;22,0;46,0;26,0;;18,0;2,0;;33,0;8,0;;34,0;42,0;8,0;14,0;;8,0;1,0;58,0;12,0;20,0;87,0;8,0;129,0;115,0;38,0;72,0;447,0;3,0;35,0;;;66,0;37,0;52,0;4,0;14,0;2,0;17,0;76,0;35,0;3,0;9,0;2,0;15,0;4,0;;7,0;48,0;421,0;;6,0;;;32,0;;13,0;6,0;8,0;;;;1,0;1,0;12,0;;1,0;2,0;70,0;75,0;1,0;;14,0;7,0;6,0;;;5,0;1,0;106,0;141,0;56,0;7,0;;12,0;27,0;;4,0;68,0;59,0;34,0;72,0;29,0;1,0;7,0;16,0;10,0;3,0;;;83,0;;5,0;61,0;25,0;3,0;;;;25,0;13,0;2,0;;13,0;;;;;;27,0;11,0;44,0;1,0;;;175,0;2,0;;;1,0;1,0;;1,0;;;;23,0;2,0;69,0;11,0;6,0;;;20,0;30,0;3,0;26,0;;16,0;42,0;;8,0;;43,0;5,0;31,0;;2,0;1,0;;3,0;14,0;;2,0;14,0;;7,0;7,0;;1,0;75,0;1,0;;;22,0;;106,0;5,0;40,0;2,0;;12,0;2,0;;11,0;;6,0;19,0;8,0;6,0;22,0;7,0;;8,0;190,0;9,0;4,0;115,0;;4,0;4,0;194,0;1,0;11,0;28,0;51,0;5,0;5,0;8,0;41,0;214,0;31,0;18,0;141,0;2,0;9,0;;24,0;13,0;;11,0;33,0;;39,0;2,0;1,0;;10,0;53,0;2,0;1,0;39,0;89,0;54,0;;;28,0;2,0;6,0;10,0;381,0;;18,0;22,0;2,0;38,0;7,0;15,0;2,0;45,0;;1,0;28,0;19,0;2,0;7,0;12,0;264,0;28,0;34,0;19,0;11,0;13,0;5,0;188,0;60,0;31,0;22,0;17,0;41,0;7,0;13,0;23,0;3,0;8,0;4,0;6,0;27,0;8,0;23,0;1,0;2,0;3,0;55,0;57,0;5,0;34,0;;3,0;3,0;110,0;;;25,0;;;;1,0;1,0;;2,0;8,0;;;;2,0;7,0;2,0;25,0;;9,0;;2,0;;10,0;;;;;;1,0;;;3,0;;;3,0;2,0;;;8,0;;1,0;5,0;;16,0;;1,0;;;;1,0;1,0;4,0;16,0;;8,0;131,0;;;;;3,0;;;4,0;8,0;1,0;7,0;;1,0;;1,0;2,0;;83,0;;18,0;4,0;;;;4,0;;21,0;4,0;;;1,0;5,0;27,0;;;;;17,0;5,0;2,0;;4,0;;;1,0;;;6,0;;16,0;1,0;1,0;5,0;;5,0;1,0;3,0;6,0;16,0;3,0;;;;;45,0;;27,0;2,0;14,0;;2,0;5,0;14,0;1,0;8,0;9,0;5,0;9,0;;4,0;13,0;;2,0;11,0;17,0;2,0;;2,0;;;1,0;21,0;;2,0;3,0;;;4,0;31,0;;;13,0;;6,0;12,0;;1,0;5,0;34,0;11,0;;9,0;;2,0;6,0;5,0;;1,0;164,0;;;1,0;;2,0;;15,0;2,0;;;3,0;18,0;1,0;;1,0;;;;4,0;24,0;;;1,0;;;18,0;;;;;17,0;2,0;1,0;;;18,0;;;
identification;;19,0;3,0;;1,0;12,0;;;5,0;13,0;;2,0;;43,0;;;6,0;;;23,0;;;6,0;10,0;9,0;;;4,0;6,0;2,0;30,0;12,0;1,0;;;67,0;2,0;;;;29,0;78,0;;2,0;23,0;;;4,0;;;;;1,0;;;;2,0;;12,0;16,0;1,0;;3,0;;96,0;1,0;55,0;;11,0;;;22,0;3,0;;1,0;;;;;23,0;65,0;;3,0;3,0;26,0;;;2,0;;;3,0;;;;5,0;;2,0;;41,0;13,0;39,0;6,0;;2,0;7,0;24,0;2,0;2,0;;;;28,0;12,0;;;;;2,0;7,0;6,0;2,0;;16,0;1,0;;17,0;71,0;;4,0;1,0;44,0;;;49,0;;;4,0;;;;;3,0;;;6,0;;10,0;2,0;48,0;2,0;;;16,0;;;;;;;;;;;5,0;;;5,0;;;13,0;3,0;4,0;8,0;3,0;;;;3,0;2,0;;;;;3,0;;;1,0;;7,0;1,0;2,0;9,0;;;;;;3,0;;;;;;;2,0;2,0;8,0;;;7,0;;3,0;;;;;2,0;;;3,0;10,0;5,0;6,0;;2,0;;12,0;;;1,0;;2,0;;;;2,0;;;;;;2,0;;;;18,0;;;;;;;;2,0;;;;6,0;3,0;;3,0;25,0;8,0;29,0;;;;;;;;;;1,0;;;;;;;;;4,0;2,0;1,0;;;;;;;;;;;2,0;2,0;1,0;;;;;;;;;;;;1,0;;;4,0;;;;;;;1,0;1,0;57,0;1,0;;;;;;1,0;;;2,0;;;2,0;;1,0;;;;;3,0;;;2,0;8,0;;2,0;;;;;;;6,0;;;;28,0;6,0;2,0;;;4,0;;1,0;2,0;;;1,0;;;1,0;;1,0;;;;7,0;2,0;17,0;2,0;;;5,0;30,0;2,0;;;16,0;;1,0;4,0;1,0;2,0;2,0;;54,0;4,0;;;2,0;1,0;;;10,0;;5,0;2,0;3,0;;;;;2,0;3,0;4,0;;;;;2,0;;9,0;;47,0;11,0;34,0;;;3,0;5,0;1,0;;;;8,0;12,0;1,0;;;;;1,0;;5,0;4,0;;72,0;;;;11,0;;7,0;;;3,0;;6,0;3,0;2,0;;;;6,0;;1,0;;;;1,0;10,0;7,0;;;2,0;;5,0;;;2,0;;1,0;3,0;;8,0;8,0;;1,0;;6,0;;;;;1,0;2,0;;;3,0;3,0;;;;;;7,0;;3,0;;;;;1,0;;2,0;2,0;;;;1,0;;;;3,0;;;;;;3,0;;;;1,0;11,0;12,0;;12,0;1,0;;;2,0;;;;;;1,0;;;5,0;;7,0;3,0;;;;;;12,0;4,0;;2,0;;4,0;2,0;8,0;;;;4,0;;;;;4,0;;;;;3,0;;;;;;9,0;;;17,0;;2,0;;;;;;3,0;;;3,0;27,0;;7,0;2,0;;;;;3,0;;;;;27,0;;4,0;;;;;2,0;;;;;1,0;;;1,0;;5,0;;;5,0;;;;;;2,0;;1,0;;;;1,0;;;1,0;;1,0;;;3,0;;;;;29,0;6,0;;;;1,0;;;;7,0;;;2,0;;;;;47,0;;;;2,0;4,0;;11,0;;;;3,0;;;;6,0;;4,0;;;;1,0;;;;;;;;;;4,0;;;;4,0;;;3,0;3,0;10,0;;;;;;;;;;;;;1,0;;;4,0;3,0;;;;;6,0;;;;;;;6,0;1,0;;;;;;;;;1,0;;;;;;;;;;;;;3,0;;;;;;;;;;;43,0;;;;;;;9,0;;2,0;;;;;;;;1,0;;;;;;;;;;22,0;;;;;;;;;;;;;;1,0;;;;;6,0;;;;;;;2,0;;;;;;;;;2,0;;;;1,0;;3,0;1,0;;;6,0;;;;;;1,0;;;;1,0;;;;1,0;;12,0;;7,0;;;2,0;;;;;;;3,0;2,0;;;;;;;;;;;;;;;;1,0;;1,0;;;;6,0;1,0;;;;;1,0;;;;;;;;;;;;;;;;;;;;;;;;;;;;;;;;;;;;;;;;;;;;;;;;;;;4,0;;;;;;;;1,0;;;;;;;;;;;;;;;;;;;;;;;;;;;;1,0;;
identify;;11,0;;16,0;20,0;80,0;26,0;7,0;8,0;43,0;;2,0;;376,0;;12,0;186,0;;6,0;46,0;2,0;;83,0;14,0;10,0;;;63,0;37,0;45,0;191,0;45,0;5,0;5,0;;435,0;18,0;5,0;114,0;2,0;277,0;425,0;;50,0;96,0;4,0;2,0;35,0;;20,0;34,0;;9,0;7,0;37,0;25,0;24,0;;12,0;80,0;;;57,0;4,0;1567,0;7,0;268,0;2,0;11,0;6,0;15,0;30,0;67,0;;2,0;12,0;2,0;15,0;30,0;27,0;449,0;2,0;80,0;74,0;78,0;2,0;;46,0;;13,0;70,0;;3,0;3,0;;;302,0;51,0;439,0;313,0;207,0;44,0;;45,0;80,0;192,0;17,0;38,0;32,0;;;68,0;254,0;1,0;;4,0;13,0;49,0;132,0;126,0;41,0;14,0;96,0;13,0;;80,0;229,0;;17,0;;85,0;1,0;;113,0;3,0;;69,0;47,0;2,0;;;7,0;8,0;2,0;4,0;18,0;136,0;7,0;171,0;8,0;;40,0;12,0;1,0;;;;;;;;19,0;25,0;2,0;;21,0;8,0;2,0;5,0;39,0;10,0;;10,0;51,0;;197,0;;4,0;7,0;;1,0;;;55,0;;;21,0;;206,0;8,0;;60,0;;;;;3,0;8,0;;;;;2,0;2,0;26,0;40,0;2,0;;5,0;3,0;10,0;71,0;6,0;;;1,0;37,0;19,0;;27,0;81,0;13,0;39,0;;15,0;;187,0;;;15,0;;2,0;26,0;9,0;4,0;1,0;1,0;14,0;;39,0;;4,0;;;;104,0;24,0;26,0;3,0;;;;;11,0;4,0;;;56,0;4,0;;5,0;12,0;32,0;97,0;;5,0;;1,0;8,0;13,0;1,0;;;7,0;;;5,0;38,0;1,0;1,0;;;7,0;1,0;55,0;;;3,0;19,0;;;33,0;;;12,0;;80,0;5,0;;;;;;11,0;;;;5,0;6,0;42,0;;5,0;;;2,0;;39,0;3,0;;;56,0;711,0;5,0;57,0;;;;;4,0;2,0;;;;;6,0;2,0;;;4,0;;5,0;17,0;;;17,0;5,0;50,0;49,0;;;1,0;;7,0;;63,0;;1,0;;144,0;2,0;8,0;2,0;2,0;18,0;1,0;3,0;54,0;8,0;;2,0;;;27,0;65,0;56,0;;1,0;47,0;50,0;22,0;97,0;72,0;;8,0;16,0;97,0;7,0;37,0;1,0;84,0;13,0;24,0;11,0;13,0;1,0;32,0;;;32,0;4,0;;108,0;;17,0;1,0;223,0;5,0;14,0;60,0;1,0;;19,0;1,0;13,0;110,0;34,0;10,0;2,0;1,0;20,0;2,0;16,0;2,0;12,0;20,0;116,0;45,0;67,0;9,0;;4,0;1,0;27,0;2,0;27,0;;11,0;70,0;;10,0;;6,0;36,0;16,0;3,0;9,0;11,0;1,0;282,0;10,0;18,0;4,0;19,0;;2,0;;1,0;36,0;9,0;4,0;61,0;2,0;6,0;10,0;3,0;7,0;7,0;6,0;5,0;11,0;13,0;16,0;93,0;15,0;;2,0;12,0;6,0;25,0;11,0;2,0;31,0;9,0;35,0;15,0;2,0;59,0;37,0;12,0;42,0;10,0;18,0;16,0;1,0;11,0;3,0;12,0;11,0;4,0;;13,0;86,0;;25,0;45,0;;12,0;5,0;;22,0;12,0;3,0;;2,0;1,0;9,0;;3,0;;;;1,0;5,0;3,0;5,0;3,0;;1,0;;;5,0;49,0;;2,0;19,0;;7,0;36,0;3,0;86,0;10,0;4,0;;1,0;2,0;16,0;8,0;11,0;1,0;14,0;;;41,0;13,0;7,0;13,0;;6,0;;1,0;;16,0;9,0;5,0;6,0;2,0;47,0;3,0;11,0;4,0;4,0;3,0;11,0;;3,0;30,0;;12,0;;;;;3,0;3,0;4,0;;;7,0;84,0;13,0;;10,0;3,0;5,0;;;8,0;3,0;44,0;;8,0;8,0;17,0;331,0;19,0;33,0;6,0;1,0;2,0;4,0;3,0;1,0;19,0;7,0;2,0;;23,0;54,0;50,0;3,0;2,0;1,0;19,0;181,0;3,0;;1,0;;11,0;8,0;2,0;5,0;1,0;24,0;6,0;7,0;4,0;;10,0;20,0;;2,0;2,0;2,0;9,0;5,0;;;;;1,0;7,0;22,0;8,0;8,0;4,0;14,0;3,0;19,0;3,0;1,0;6,0;15,0;2,0;;;1,0;10,0;;2,0;49,0;1,0;3,0;15,0;22,0;72,0;6,0;21,0;111,0;6,0;3,0;1,0;5,0;3,0;6,0;62,0;4,0;;;15,0;;;4,0;;4,0;10,0;1,0;1,0;;;;2,0;3,0;;5,0;;;;;17,0;3,0;4,0;;1,0;;13,0;1,0;1,0;;7,0;7,0;1,0;;11,0;3,0;4,0;;;1,0;5,0;;1,0;;16,0;27,0;2,0;4,0;;71,0;;30,0;;12,0;;;13,0;1,0;12,0;;2,0;;;;;;;18,0;;3,0;1,0;;;;;;1,0;1,0;;;;4,0;;3,0;;;;1,0;;;;3,0;1,0;;5,0;;1,0;;4,0;3,0;;;;4,0;;1,0;;;;25,0;;;;;15,0;;4,0;;;39,0;16,0;4,0;3,0;;;;44,0;;;2,0;8,0;;9,0;16,0;;5,0;12,0;8,0;6,0;1,0;;5,0;;11,0;;28,0;2,0;5,0;1,0;;23,0;2,0;;10,0;12,0;1,0;1,0;;2,0;6,0;10,0;14,0;10,0;;4,0;;;16,0;4,0;2,0;;47,0;5,0;3,0;8,0;10,0;6,0;;13,0;;3,0;1,0;19,0;7,0;49,0;10,0;1,0;;5,0;30,0;2,0;;2,0;;3,0;;2,0;;19,0;11,0;3,0;8,0;;1,0;;2,0;;;7,0;;3,0;1,0;4,0;2,0;2,0;31,0;;;12,0;;2,0;;14,0;3,0;4,0;;;;;6,0;6,0;2,0;;;;5,0;9,0;4,0;7,0;10,0;;2,0;;;12,0;3,0;;;;2,0;;;;10,0;;;;;;;;8,0;;1,0;;1,0;;4,0;;;20,0;;4,0;9,0;;;;8,0;10,0;6,0;37,0;57,0;8,0;8,0;1,0;15,0;1,0;;12,0;;;;9,0;;7,0;2,0;16,0;;;23,0;9,0;;1,0;;20,0;8,0;;;;;
illumination;;2,0;;39,0;16,0;151,0;92,0;70,0;;;;8,0;;74,0;2,0;10,0;80,0;;14,0;25,0;;;37,0;7,0;9,0;;1,0;40,0;4,0;60,0;111,0;44,0;16,0;9,0;;94,0;19,0;1,0;25,0;2,0;94,0;299,0;;6,0;39,0;21,0;10,0;88,0;2,0;1,0;8,0;5,0;;8,0;96,0;5,0;36,0;;7,0;74,0;1,0;1,0;8,0;;243,0;6,0;134,0;5,0;4,0;;3,0;55,0;748,0;2,0;2,0;;2,0;4,0;1,0;10,0;84,0;;24,0;4,0;115,0;2,0;1,0;124,0;2,0;10,0;13,0;2,0;14,0;2,0;39,0;;23,0;1,0;151,0;19,0;40,0;9,0;;2,0;56,0;40,0;2,0;8,0;3,0;3,0;;32,0;60,0;;2,0;1,0;2,0;43,0;146,0;131,0;18,0;;79,0;6,0;29,0;4,0;358,0;;1,0;;120,0;2,0;;220,0;14,0;;60,0;5,0;;;;2,0;;2,0;5,0;7,0;52,0;38,0;31,0;15,0;;2,0;4,0;2,0;;1,0;;1,0;;;;17,0;;;1,0;;29,0;16,0;4,0;10,0;;3,0;33,0;32,0;;;;162,0;3,0;;1,0;3,0;2,0;15,0;;2,0;9,0;;44,0;10,0;;;4,0;2,0;;2,0;33,0;26,0;;1,0;;;1,0;;20,0;5,0;8,0;;41,0;43,0;5,0;1,0;;;4,0;7,0;63,0;2,0;;37,0;187,0;80,0;5,0;1,0;8,0;;61,0;;11,0;14,0;;2,0;29,0;2,0;3,0;;45,0;48,0;3,0;28,0;;4,0;;;;33,0;1,0;10,0;27,0;8,0;;;;5,0;2,0;4,0;23,0;55,0;14,0;;3,0;28,0;9,0;14,0;4,0;;4,0;38,0;2,0;45,0;;;;25,0;3,0;;5,0;40,0;2,0;37,0;10,0;;26,0;6,0;;;1,0;4,0;9,0;;;7,0;;4,0;13,0;10,0;19,0;2,0;;1,0;;;;;;;1,0;24,0;;113,0;2,0;;3,0;;;;12,0;;5,0;;6,0;103,0;3,0;7,0;;;;;53,0;4,0;;1,0;;;12,0;1,0;1,0;;1,0;;;5,0;;2,0;;2,0;;10,0;6,0;;;;10,0;;4,0;1,0;5,0;1,0;34,0;1,0;17,0;;;;2,0;5,0;9,0;9,0;;1,0;;;5,0;7,0;34,0;15,0;2,0;5,0;5,0;;101,0;;4,0;4,0;2,0;38,0;6,0;8,0;10,0;;;6,0;;7,0;7,0;6,0;;13,0;11,0;1,0;;6,0;2,0;28,0;;12,0;11,0;23,0;8,0;1,0;6,0;4,0;4,0;24,0;37,0;2,0;1,0;;;1,0;;3,0;3,0;3,0;4,0;60,0;5,0;20,0;3,0;;49,0;;16,0;;;8,0;1,0;6,0;7,0;;17,0;4,0;4,0;4,0;;1,0;;;8,0;;1,0;3,0;30,0;4,0;;5,0;1,0;1,0;;1,0;6,0;5,0;;9,0;5,0;;;;2,0;;2,0;;5,0;9,0;;;39,0;;;1,0;;1,0;;5,0;19,0;;21,0;;;;;1,0;23,0;57,0;1,0;3,0;6,0;;;;10,0;;1,0;;;;11,0;;;;1,0;;2,0;;6,0;11,0;;6,0;;;1,0;5,0;5,0;;;;4,0;6,0;;;;;2,0;9,0;;5,0;19,0;1,0;2,0;3,0;;;13,0;12,0;;;;;2,0;;2,0;;3,0;1,0;;5,0;5,0;;;;;1,0;9,0;;2,0;;1,0;;;8,0;;;2,0;;14,0;4,0;15,0;4,0;7,0;;;;68,0;;1,0;1,0;1,0;;1,0;4,0;;5,0;;20,0;;;;16,0;82,0;1,0;3,0;;1,0;3,0;2,0;;;36,0;2,0;;;;15,0;1,0;;;1,0;;;3,0;1,0;4,0;23,0;9,0;;;;;1,0;;;1,0;;25,0;4,0;;;;4,0;6,0;;;;3,0;;;;;;;2,0;;;;;;;1,0;9,0;;6,0;;;;10,0;;2,0;;;1,0;329,0;;;;;11,0;31,0;;40,0;;;;;3,0;2,0;;10,0;;;;3,0;;6,0;;;6,0;;1,0;1,0;;14,0;;;4,0;5,0;3,0;;7,0;;;;;1,0;;;;2,0;;;12,0;;11,0;;3,0;;1,0;;5,0;13,0;5,0;;10,0;10,0;5,0;11,0;;;;2,0;;3,0;;2,0;3,0;13,0;7,0;10,0;40,0;2,0;;;;;5,0;;;;1,0;2,0;8,0;;;;1,0;;1,0;3,0;2,0;;;2,0;;10,0;;;;;;1,0;;;;;;10,0;;;1,0;;;;;2,0;5,0;;;2,0;;;;;;;24,0;;;;;2,0;;;;;;1,0;;3,0;;;;1,0;123,0;3,0;;;1,0;;;2,0;;;;;;1,0;1,0;;;;;2,0;;;1,0;3,0;;1,0;10,0;;;3,0;;5,0;3,0;;1,0;13,0;;4,0;;;224,0;1,0;18,0;;39,0;;;;1,0;3,0;;;14,0;;14,0;;2,0;;2,0;;3,0;;;;;;;;1,0;;;1,0;;;;;;;2,0;;;1,0;1,0;;1,0;;6,0;1,0;5,0;5,0;;20,0;30,0;;;;2,0;;4,0;;;;1,0;9,0;;;;18,0;;;;;2,0;;;;;;;;;;;;;1,0;;;;2,0;;;;;;;9,0;;3,0;1,0;13,0;4,0;;;;;2,0;;;1,0;;4,0;1,0;;5,0;;;;5,0;;2,0;;;;;;;;;;;;;;;1,0;;;
indicate;;11,0;;6,0;52,0;39,0;2,0;5,0;6,0;4,0;;;4,0;109,0;;11,0;115,0;;3,0;9,0;1,0;;39,0;11,0;26,0;;1,0;13,0;11,0;21,0;92,0;14,0;2,0;15,0;2,0;282,0;;20,0;106,0;;88,0;265,0;;24,0;240,0;;;38,0;2,0;9,0;25,0;2,0;;1,0;47,0;32,0;5,0;4,0;15,0;90,0;;;7,0;3,0;451,0;;92,0;5,0;6,0;;16,0;74,0;64,0;2,0;10,0;5,0;1,0;;;31,0;150,0;;58,0;16,0;33,0;10,0;3,0;31,0;;3,0;87,0;1,0;1,0;17,0;45,0;;107,0;21,0;77,0;46,0;251,0;31,0;;10,0;47,0;24,0;9,0;6,0;6,0;1,0;;37,0;30,0;2,0;;;13,0;32,0;24,0;77,0;10,0;1,0;271,0;10,0;;56,0;103,0;;6,0;;125,0;9,0;2,0;103,0;;;46,0;21,0;17,0;;;7,0;;3,0;8,0;1,0;43,0;3,0;61,0;;6,0;53,0;21,0;;;6,0;2,0;;;;;3,0;21,0;1,0;;22,0;2,0;4,0;;100,0;20,0;5,0;6,0;102,0;;12,0;9,0;10,0;5,0;;;;;23,0;;;6,0;;36,0;12,0;1,0;1,0;2,0;;;;6,0;4,0;;;;16,0;2,0;33,0;12,0;10,0;15,0;;15,0;3,0;6,0;48,0;1,0;;;;64,0;4,0;;12,0;30,0;33,0;10,0;;4,0;;33,0;;;11,0;;2,0;36,0;8,0;;4,0;2,0;;;8,0;;7,0;;;;48,0;3,0;4,0;13,0;2,0;8,0;;;11,0;;3,0;2,0;25,0;2,0;;13,0;43,0;24,0;71,0;2,0;6,0;;;5,0;3,0;1,0;2,0;11,0;3,0;;;5,0;30,0;;;;8,0;9,0;1,0;6,0;;;7,0;6,0;;;2,0;;;1,0;3,0;73,0;14,0;;2,0;;;;;;;;12,0;23,0;63,0;1,0;;1,0;;3,0;;9,0;2,0;1,0;12,0;19,0;144,0;;8,0;;;;;24,0;;;;;;48,0;;4,0;;3,0;;2,0;7,0;19,0;;;;9,0;10,0;;;;;9,0;;11,0;;26,0;;103,0;7,0;25,0;1,0;7,0;1,0;6,0;13,0;2,0;5,0;;1,0;;1,0;28,0;8,0;48,0;2,0;;28,0;11,0;30,0;167,0;53,0;1,0;;10,0;67,0;17,0;29,0;4,0;55,0;19,0;2,0;6,0;51,0;5,0;33,0;;32,0;;;1,0;76,0;;66,0;;127,0;3,0;10,0;60,0;9,0;;32,0;;13,0;120,0;57,0;;10,0;1,0;;1,0;18,0;;7,0;1,0;136,0;12,0;42,0;13,0;;11,0;;16,0;20,0;25,0;3,0;4,0;16,0;13,0;9,0;22,0;18,0;42,0;9,0;6,0;5,0;;5,0;227,0;7,0;9,0;11,0;15,0;1,0;;4,0;8,0;5,0;;2,0;10,0;1,0;10,0;3,0;14,0;;1,0;8,0;34,0;5,0;31,0;87,0;45,0;22,0;;2,0;1,0;;8,0;13,0;3,0;22,0;1,0;13,0;;;29,0;11,0;8,0;7,0;7,0;25,0;4,0;3,0;6,0;1,0;8,0;9,0;6,0;5,0;4,0;1,0;2,0;12,0;19,0;9,0;1,0;7,0;4,0;;7,0;4,0;6,0;;1,0;2,0;1,0;15,0;1,0;;4,0;;;;17,0;1,0;;;;;;23,0;;15,0;6,0;;2,0;5,0;1,0;16,0;34,0;3,0;;9,0;10,0;15,0;2,0;;3,0;7,0;4,0;;15,0;;19,0;42,0;3,0;;;4,0;4,0;36,0;2,0;;12,0;;39,0;6,0;18,0;1,0;;;6,0;;9,0;7,0;;4,0;;3,0;;3,0;6,0;8,0;;;;1,0;8,0;3,0;1,0;;3,0;14,0;3,0;1,0;1,0;8,0;70,0;;6,0;;2,0;53,0;6,0;12,0;;18,0;6,0;;1,0;4,0;;;8,0;;6,0;4,0;22,0;;;;9,0;25,0;;;5,0;;4,0;4,0;7,0;;;11,0;;7,0;;;;6,0;;1,0;1,0;;21,0;;4,0;1,0;5,0;;;3,0;12,0;4,0;8,0;2,0;11,0;4,0;;4,0;;22,0;5,0;12,0;12,0;;1,0;2,0;;1,0;18,0;9,0;1,0;106,0;;3,0;1,0;3,0;55,0;;6,0;4,0;;15,0;1,0;7,0;;;;1,0;1,0;;42,0;11,0;;16,0;8,0;1,0;;;4,0;1,0;8,0;5,0;30,0;;1,0;7,0;;10,0;2,0;1,0;;4,0;;11,0;44,0;;8,0;10,0;60,0;;;53,0;15,0;4,0;;;;11,0;;10,0;;14,0;26,0;5,0;2,0;;19,0;;13,0;;;;;2,0;3,0;6,0;2,0;;;;;;;;1,0;2,0;;;;;8,0;2,0;3,0;4,0;;;;;12,0;;1,0;;;;;;;;6,0;2,0;;9,0;1,0;11,0;1,0;1,0;;1,0;;;5,0;;;;10,0;;15,0;;;;;2,0;2,0;7,0;;;31,0;3,0;;3,0;4,0;;8,0;1,0;;1,0;1,0;10,0;;1,0;7,0;6,0;16,0;;;10,0;4,0;;3,0;;;;7,0;1,0;;8,0;;8,0;;;8,0;;15,0;2,0;;;;;;1,0;;2,0;3,0;2,0;;;2,0;;;1,0;;1,0;;;;;;;3,0;1,0;4,0;;2,0;;1,0;;;;7,0;5,0;2,0;;;2,0;;6,0;3,0;;2,0;;;2,0;;8,0;1,0;7,0;2,0;;18,0;;;;13,0;;4,0;;3,0;;;38,0;;;;;;;1,0;3,0;;;;1,0;8,0;12,0;;5,0;2,0;3,0;3,0;;;;;;;;;9,0;;;5,0;;2,0;;;;;;;;;;4,0;3,0;;;;10,0;;2,0;4,0;1,0;1,0;;;2,0;14,0;;6,0;7,0;;;5,0;1,0;9,0;14,0;;;6,0;;;5,0;;9,0;;3,0;11,0;;2,0;;;1,0;5,0;3,0;;;2,0;
indication;;1,0;;7,0;10,0;19,0;;;3,0;1,0;;;1,0;77,0;;;84,0;;;41,0;;;5,0;2,0;5,0;;;14,0;11,0;4,0;66,0;5,0;;1,0;;47,0;;2,0;23,0;;74,0;226,0;;7,0;99,0;;;6,0;;4,0;2,0;1,0;;;4,0;2,0;6,0;;;37,0;;;5,0;;158,0;;105,0;4,0;2,0;;7,0;16,0;40,0;;2,0;;1,0;13,0;4,0;5,0;115,0;;28,0;2,0;27,0;;;15,0;;2,0;5,0;1,0;;;;;;1,0;27,0;12,0;28,0;8,0;;11,0;6,0;28,0;;3,0;1,0;;;5,0;12,0;;;5,0;;2,0;7,0;47,0;1,0;;34,0;2,0;2,0;24,0;54,0;;2,0;;26,0;;;10,0;6,0;;32,0;2,0;12,0;;;;;2,0;3,0;9,0;15,0;5,0;37,0;;;6,0;4,0;;;;;9,0;;;;6,0;18,0;;;;6,0;1,0;1,0;4,0;4,0;;3,0;22,0;;2,0;;;1,0;1,0;;9,0;;5,0;;;;;14,0;1,0;;1,0;;1,0;;2,0;7,0;;;;;;;;8,0;3,0;;;;;5,0;12,0;1,0;;;2,0;58,0;;1,0;;3,0;4,0;;;;;35,0;;1,0;6,0;;2,0;8,0;;;;;;;2,0;;4,0;;;;31,0;2,0;8,0;6,0;;;;;4,0;;;;3,0;;;;15,0;1,0;41,0;3,0;;;;;7,0;;;5,0;1,0;1,0;;;2,0;;;;6,0;5,0;;;;;;5,0;;;3,0;;;8,0;;16,0;4,0;;;;;;;;;;2,0;;4,0;;;;;;;3,0;;17,0;9,0;13,0;42,0;;2,0;;;;;9,0;1,0;;;;;17,0;;1,0;;9,0;;2,0;;;;;;5,0;1,0;;;;;5,0;;4,0;;1,0;;74,0;22,0;;;2,0;14,0;4,0;1,0;2,0;;;4,0;;;;5,0;15,0;;;6,0;;;31,0;;7,0;;10,0;55,0;4,0;2,0;1,0;40,0;2,0;3,0;;10,0;;8,0;;13,0;31,0;;;46,0;;16,0;;61,0;;7,0;22,0;4,0;;8,0;;11,0;16,0;29,0;;;;;1,0;9,0;2,0;8,0;1,0;199,0;19,0;55,0;10,0;;6,0;5,0;11,0;1,0;7,0;2,0;6,0;5,0;4,0;1,0;5,0;6,0;5,0;4,0;;5,0;;;159,0;;;9,0;2,0;;;;;;;;31,0;2,0;;2,0;;;2,0;1,0;6,0;6,0;;21,0;5,0;27,0;;;;3,0;1,0;12,0;;8,0;8,0;7,0;;3,0;14,0;4,0;6,0;1,0;;13,0;3,0;;;;11,0;2,0;1,0;;;18,0;1,0;6,0;2,0;4,0;2,0;8,0;;4,0;7,0;2,0;14,0;;;;;4,0;;;2,0;;;;6,0;;2,0;;;1,0;1,0;18,0;;6,0;4,0;1,0;6,0;;;4,0;3,0;;4,0;;4,0;7,0;;;2,0;6,0;;;;11,0;5,0;;;3,0;;;;8,0;;;;;95,0;9,0;4,0;;11,0;;2,0;;4,0;36,0;8,0;3,0;;;;;2,0;;;;;6,0;20,0;6,0;;2,0;;4,0;;;;1,0;;;;;2,0;4,0;13,0;8,0;;5,0;;4,0;;2,0;;2,0;3,0;;;;;;3,0;;;41,0;3,0;;9,0;;;14,0;;;;14,0;;2,0;1,0;;;4,0;3,0;1,0;;;;5,0;;;;1,0;;3,0;;;;;2,0;;;;;10,0;6,0;;3,0;;;;;;4,0;1,0;1,0;6,0;2,0;;2,0;;26,0;;;1,0;6,0;3,0;;6,0;2,0;2,0;;;1,0;;4,0;3,0;;2,0;3,0;;;;;1,0;;;;;8,0;;;;;;;;;2,0;;2,0;;;16,0;;;4,0;3,0;;;;;;;;;4,0;11,0;2,0;;;1,0;;1,0;;;;;1,0;6,0;2,0;;;;;;;;;;4,0;;;;;;;;;;;;;;;;;;;;;;;;3,0;;1,0;;;1,0;;;;;;;;;;;;1,0;;1,0;;;8,0;;;;;2,0;;;;;;5,0;;;5,0;2,0;;;3,0;;;;;;;;;;;;;;;22,0;;;;;;1,0;;;;;;;2,0;;;;;1,0;;;;;;;1,0;;;;;;2,0;;2,0;;;;1,0;;;;;;;;;5,0;;;6,0;;2,0;9,0;;;;;2,0;;9,0;2,0;;2,0;;;2,0;;;10,0;;;;;;2,0;;;4,0;;;;;2,0;1,0;;;;;;1,0;;5,0;;;;;;;;;;;;;;;;;;;;;;;;;;;;;;;;;;;;1,0;;;;;10,0;;;;;;;;;1,0;;;2,0;;;;;3,0;;;3,0;;;;;;;;;;;
indicative;;5,0;;7,0;9,0;1,0;;9,0;1,0;8,0;;1,0;;25,0;;;20,0;;;9,0;;;10,0;1,0;;;;38,0;3,0;12,0;25,0;5,0;;5,0;;148,0;9,0;2,0;1,0;;52,0;74,0;;6,0;29,0;1,0;2,0;8,0;;9,0;12,0;2,0;;;4,0;4,0;;;1,0;37,0;;;8,0;;186,0;;27,0;1,0;;;;16,0;28,0;;;2,0;;8,0;11,0;2,0;25,0;;7,0;28,0;4,0;;4,0;13,0;;;25,0;1,0;;4,0;;;21,0;7,0;31,0;20,0;109,0;4,0;;3,0;5,0;12,0;;;1,0;;;4,0;19,0;;;;22,0;12,0;32,0;26,0;4,0;;77,0;3,0;4,0;6,0;13,0;;2,0;;33,0;;;3,0;;;14,0;3,0;79,0;;;;;;;;1,0;;7,0;;;;2,0;;;;;;;;;1,0;12,0;;;;1,0;;;5,0;1,0;1,0;;30,0;;;;;1,0;;1,0;;;4,0;;;12,0;;2,0;;;6,0;2,0;;;;1,0;1,0;;;;;;;20,0;3,0;3,0;;;6,0;;11,0;2,0;;;;18,0;9,0;;1,0;9,0;;6,0;;;1,0;13,0;;;9,0;;3,0;1,0;;;2,0;;;;;;;;;;13,0;;7,0;;;;;;1,0;2,0;6,0;1,0;3,0;;;;8,0;;34,0;1,0;;;1,0;;1,0;;;2,0;;3,0;;;11,0;;;;;3,0;;4,0;;;;;;;;;;;;22,0;;;;;;;;;;;5,0;;22,0;;;;;;;;;;;8,0;37,0;;;;;;;4,0;1,0;;;;;2,0;;;;;;;2,0;9,0;;;;;1,0;;;;;;;5,0;;;;11,0;;;3,0;;2,0;;5,0;;2,0;;;;;9,0;1,0;8,0;;1,0;8,0;2,0;;20,0;3,0;;;;22,0;13,0;10,0;;4,0;;;16,0;2,0;3,0;7,0;;4,0;;;;53,0;;3,0;;22,0;6,0;1,0;33,0;;;;1,0;2,0;9,0;33,0;;2,0;;;5,0;2,0;;1,0;1,0;30,0;;5,0;9,0;2,0;8,0;;1,0;;2,0;6,0;3,0;;1,0;;12,0;;26,0;13,0;;3,0;;7,0;41,0;;;2,0;;;;4,0;;8,0;;;16,0;;;1,0;;1,0;1,0;;1,0;;;4,0;1,0;3,0;;;;;;;;1,0;;4,0;;;;29,0;1,0;18,0;;3,0;3,0;;;;;1,0;2,0;;;4,0;;3,0;;3,0;;;1,0;;1,0;4,0;4,0;;;;;;;;1,0;;;;;;;;;;;9,0;;;2,0;;;2,0;3,0;3,0;2,0;1,0;;;4,0;;;;;;;;2,0;;17,0;7,0;;;;4,0;;;;5,0;;;3,0;;;;6,0;;;;1,0;4,0;;;;;;;;;1,0;;2,0;;;;;;3,0;;;;;2,0;14,0;;;;;24,0;;2,0;;;;;;;;;2,0;;;;2,0;;1,0;;7,0;5,0;;;;;1,0;;;;;;;;4,0;1,0;;;3,0;;;;3,0;;;;;;;;1,0;;7,0;;1,0;;6,0;;;4,0;;;;;;;;3,0;1,0;3,0;;4,0;;;;;14,0;2,0;;;;;;11,0;;;;;;;2,0;;;;;;;;;;;;;;;1,0;;1,0;;;;;;1,0;;;;3,0;10,0;;;5,0;;;;2,0;;11,0;;;;;19,0;;;;;;2,0;;;;;;;1,0;;;;;;;;;;;;;;;;;;;;;;;4,0;5,0;;;;;;;;;;;;;;6,0;1,0;;3,0;;;;;;;;;;;;;;;;8,0;;;;6,0;;;;;;;;;4,0;;;;13,0;;;;;;1,0;8,0;;;;;;;9,0;;;;1,0;;;3,0;;;;;;;;;;;3,0;4,0;;;;;;;6,0;;;;;;;;;;1,0;;2,0;;;;;4,0;;1,0;;1,0;;;6,0;;;;;1,0;1,0;;;;4,0;;;;;;;;;;;;;;;1,0;1,0;;;;;;;;;;;;;;2,0;8,0;;;;;2,0;;;;;;;;;;;3,0;;;;;;;;8,0;;;;1,0;;;;;;;;;1,0;;;;;1,0;1,0;;;;;;;;;;;;;;;;7,0;;;;;;;;;;;;;;
indicator;;1,0;;9,0;;28,0;2,0;18,0;;;;;21,0;57,0;;6,0;18,0;;5,0;2,0;;5,0;27,0;1,0;2,0;;;9,0;12,0;6,0;68,0;13,0;;;;41,0;7,0;2,0;;;89,0;84,0;2,0;3,0;225,0;8,0;;35,0;;;2,0;;2,0;2,0;2,0;;2,0;;7,0;31,0;;;1,0;;84,0;;47,0;4,0;7,0;;;19,0;45,0;;9,0;;;;1,0;14,0;87,0;;18,0;;4,0;5,0;1,0;15,0;;16,0;14,0;1,0;;1,0;2,0;;4,0;2,0;54,0;7,0;112,0;12,0;;3,0;3,0;20,0;;1,0;1,0;;;3,0;6,0;2,0;;9,0;;3,0;;24,0;6,0;;60,0;8,0;;7,0;92,0;;6,0;;9,0;;;13,0;7,0;1,0;9,0;3,0;21,0;;;12,0;;;1,0;;41,0;10,0;62,0;3,0;;;8,0;2,0;;3,0;8,0;;;;1,0;13,0;5,0;;;;22,0;4,0;;7,0;2,0;;1,0;18,0;;4,0;;14,0;;;2,0;;;8,0;;;;;18,0;7,0;;;2,0;1,0;;;19,0;;11,0;1,0;;4,0;;;7,0;3,0;21,0;;;;7,0;10,0;;;1,0;2,0;9,0;3,0;;12,0;17,0;;;;;;41,0;1,0;;1,0;;;2,0;;1,0;;;;;16,0;;9,0;4,0;;1,0;4,0;2,0;12,0;7,0;;;;;10,0;;;;8,0;;;2,0;3,0;;70,0;6,0;2,0;;;;;;;1,0;3,0;;1,0;3,0;25,0;;1,0;;;6,0;;;;;4,0;;;;5,0;;;1,0;;29,0;3,0;;3,0;;;;;;;1,0;4,0;9,0;2,0;;;1,0;;2,0;;11,0;2,0;5,0;;5,0;40,0;;;8,0;;;;2,0;;;;;1,0;10,0;;;;;;7,0;2,0;5,0;;;;1,0;;;;;;;4,0;10,0;;32,0;;34,0;14,0;5,0;;1,0;;1,0;6,0;;4,0;;;;;11,0;13,0;16,0;21,0;;2,0;2,0;4,0;25,0;;;1,0;;22,0;5,0;2,0;7,0;23,0;;3,0;3,0;9,0;2,0;11,0;;16,0;87,0;4,0;;17,0;;11,0;16,0;18,0;1,0;;1,0;3,0;;33,0;;7,0;13,0;35,0;;5,0;;;;1,0;;8,0;;70,0;1,0;23,0;5,0;3,0;14,0;;14,0;4,0;34,0;3,0;;1,0;14,0;;4,0;;5,0;1,0;;1,0;;2,0;43,0;;;5,0;34,0;3,0;7,0;20,0;;;;2,0;15,0;1,0;;1,0;;13,0;;;1,0;;21,0;;6,0;13,0;2,0;;2,0;2,0;3,0;;2,0;;;1,0;;;12,0;2,0;1,0;1,0;;4,0;;;;4,0;24,0;;;4,0;;;;1,0;;12,0;7,0;4,0;1,0;3,0;2,0;1,0;4,0;;;3,0;;1,0;;;;;1,0;;;;4,0;;;;;36,0;;2,0;12,0;;;;;6,0;;;;3,0;8,0;4,0;;;;8,0;1,0;;;;5,0;6,0;;;;;;3,0;;;3,0;11,0;89,0;1,0;;;;1,0;;;7,0;66,0;2,0;;;3,0;6,0;4,0;;;;1,0;;;1,0;7,0;;;;;1,0;;;1,0;3,0;;;;;32,0;5,0;;;;;;4,0;;;;2,0;;;1,0;9,0;;;1,0;2,0;3,0;;;;;;11,0;1,0;;;;;;;;;17,0;;;;;;;2,0;;;5,0;;;;;2,0;1,0;4,0;;;22,0;;1,0;;;;;;4,0;;;5,0;;;66,0;;;;;5,0;;;5,0;;;2,0;4,0;;;;;;;;10,0;;;;;;1,0;5,0;;;;;;8,0;3,0;;;1,0;;4,0;;;;;;;;2,0;;;2,0;4,0;;;;;6,0;;;;3,0;15,0;;;;3,0;;6,0;;2,0;;;1,0;;9,0;3,0;;;;2,0;;;;;4,0;6,0;;;;;1,0;;1,0;;;;;9,0;;;;;;;1,0;;;;;;3,0;;;1,0;4,0;;;;;8,0;;;;;;3,0;;;;;3,0;;;;;9,0;;;;;;3,0;1,0;;;;;;;1,0;;;;;25,0;;;;;;;1,0;;;;;;;;14,0;;26,0;;;;;4,0;;;4,0;1,0;;;;;;3,0;;9,0;3,0;;15,0;;;;;4,0;1,0;;;;;;8,0;;;;;;21,0;;;;;;;;7,0;;;;;4,0;;2,0;2,0;;;;;;;;;;2,0;;;2,0;;;;;;;;2,0;2,0;;1,0;;5,0;17,0;;18,0;;1,0;;;;1,0;;;;;;;;;;;;;;;;;;;;;;;;;;;;2,0;;;;;1,0;;1,0;;;;;;;4,0;;3,0;;;;;1,0;2,0;;;;;;;;;;;;;;;;
initialization;;6,0;;4,0;;3,0;;;;;;;;3,0;;;10,0;;;;;;;;;;;;1,0;;25,0;9,0;;;;3,0;2,0;;1,0;;4,0;6,0;;;;;;14,0;;3,0;;;1,0;;;;;;;2,0;;;;;19,0;;16,0;;;;;29,0;1,0;;;;;1,0;;1,0;4,0;;1,0;1,0;;;;6,0;;3,0;2,0;;;;;;;;34,0;4,0;7,0;12,0;;8,0;89,0;3,0;;;;;;2,0;;;;;;;;4,0;2,0;;45,0;;1,0;6,0;9,0;;;;14,0;;;102,0;;;;;;;;;;;25,0;19,0;;;2,0;1,0;;;27,0;;;;;;;;;4,0;2,0;;;;;;;;;;;;;;;;;;;;;;;;1,0;14,0;1,0;;;;;;;;;;;;;;;;;;38,0;;2,0;;;;;;;;1,0;5,0;1,0;4,0;9,0;4,0;;;;;;;;;;;;;;;;;;;;;;;;1,0;;1,0;;;;;;;;1,0;;;;;;25,0;;;;;;1,0;;;;;1,0;;;;;2,0;;;;1,0;;;;;;5,0;5,0;;;;;;;;;;;;;;;;;;;;;2,0;;;;;;;;;;;3,0;;;;;;;;6,0;;;;;;;;;;;;;;;;;;;;;;;;;;2,0;;;;;;;;;;;1,0;;;;;;;;;6,0;2,0;;5,0;;;15,0;2,0;10,0;;;6,0;;;;;;42,0;;;;;;1,0;44,0;;;;;8,0;;;;;;1,0;;32,0;;;5,0;2,0;;;;;;;;;1,0;22,0;2,0;;;;;2,0;7,0;;;;;;4,0;1,0;;5,0;;;;;;;;;;2,0;4,0;;;;;;;;3,0;;;1,0;;;;4,0;;;;;;;;;;;;;;;;;;;;;;;;;;;;;1,0;;1,0;;;;;;;;;;;;;;;;;;;;;;;;;;;;;;;;;2,0;;;5,0;;;;3,0;;;;;;;;;;;;;;1,0;;;;;;;;;31,0;;;;;;;;;;;;;;;;;;;;;;;2,0;;;;1,0;;;1,0;;;;;;;;;;;;;;;;;;8,0;;;;;;;;3,0;;;;;;;1,0;;;;;;;;;;;;;;;1,0;;;;;1,0;;;;;;;;5,0;;;;;;4,0;;;3,0;2,0;;;;;;;;;;;55,0;;;;;15,0;;;;;22,0;;;;;;;1,0;;;27,0;;4,0;;;;;;;;51,0;;;;;;;;;;;;2,0;;;7,0;;;;;;1,0;;;;;;;1,0;;;;;;;;;;;;;;;;1,0;;;;;;;;;;2,0;;;;;;;;;;;;;;;;;;;;;;;;;;;;;;;;;2,0;;;2,0;;;;;;;;4,0;;;;;;;1,0;;1,0;;;;1,0;;;;;;;;;;;;;;;;;22,0;;;;;;;;;;;;;;;;;;;;;;;;4,0;;;;;;1,0;;5,0;;;;;;;;;;;2,0;;;;;;;;;;;;;;;;;;;;;;;;;;;;;;;;;11,0;;;;;;;;;;;;;;1,0;;;;;;;;;;;;;;;;;;;;;;;;;;;;;;;;;;;;;;;;;;;;;;;;;;;;;;;8,0;;;;;;;;;;;;;;;;;;;;;;;
initiate;;2,0;;1,0;6,0;9,0;;1,0;;;;;;4,0;;;106,0;;;;;;;;22,0;;;3,0;5,0;3,0;28,0;11,0;;;;14,0;1,0;;;;11,0;67,0;;10,0;10,0;;;2,0;;;;;;;1,0;;;;;3,0;;;4,0;;108,0;1,0;10,0;;9,0;;;5,0;17,0;;;;;;;4,0;36,0;;18,0;;41,0;;;;;1,0;1,0;;;1,0;3,0;;;;17,0;5,0;2,0;;;20,0;4,0;63,0;6,0;6,0;;;;;1,0;;;;;;;14,0;12,0;4,0;21,0;;;5,0;50,0;;;;21,0;;;2,0;;;1,0;1,0;3,0;;;;;;;;1,0;3,0;;;;;;;1,0;8,0;;;1,0;;;6,0;4,0;;;;3,0;;;1,0;2,0;1,0;6,0;;;;;;2,0;;4,0;;;;;;;;5,0;;;;;3,0;;;2,0;;;;;;;;7,0;1,0;2,0;;;;;8,0;;;;;;;;;;6,0;;;;;;;1,0;;;;;;;;;;;;;;2,0;;;8,0;;;;;;;;;;;;;;;13,0;11,0;;10,0;;;;;;;;;2,0;4,0;;;2,0;;;;;;;;;;;;1,0;;;;;;;;;;;;;;;;1,0;;1,0;;;5,0;;;;;;;;;;;8,0;8,0;;;;;;;6,0;;;;;;19,0;;;;;;;2,0;;;;;3,0;1,0;;;;;;;1,0;;5,0;1,0;49,0;7,0;;;;11,0;7,0;;;1,0;;4,0;;;;;2,0;;1,0;4,0;;3,0;32,0;1,0;;;;9,0;1,0;;;12,0;2,0;3,0;;6,0;;2,0;;2,0;;1,0;;12,0;;3,0;;3,0;;1,0;12,0;;;1,0;;5,0;71,0;;;;;;;;;8,0;;23,0;16,0;37,0;9,0;;;7,0;1,0;1,0;1,0;;1,0;9,0;6,0;;;2,0;10,0;1,0;;1,0;3,0;1,0;51,0;;;;3,0;2,0;;2,0;;4,0;6,0;;4,0;3,0;;;;;;3,0;;;3,0;;8,0;11,0;;;6,0;4,0;2,0;;;;2,0;3,0;3,0;;11,0;;;;1,0;;;3,0;1,0;;2,0;1,0;;;;4,0;;5,0;;;;;;;5,0;;7,0;1,0;;6,0;;1,0;;;2,0;;;1,0;;;;;;;;;;;;5,0;;3,0;2,0;;;1,0;;;;1,0;;;;1,0;;;;1,0;20,0;6,0;1,0;3,0;;;;36,0;;;;;2,0;;2,0;4,0;3,0;2,0;1,0;;;;;3,0;;;;;;;1,0;;;1,0;2,0;;3,0;4,0;6,0;;;;;2,0;3,0;;;7,0;;1,0;3,0;;;8,0;;;;;;;8,0;;;;1,0;;;14,0;;1,0;;;;;;;;1,0;7,0;3,0;;;1,0;;;;1,0;6,0;;;;;;;2,0;;;6,0;;;;2,0;;;;;;;1,0;;2,0;;;1,0;;;6,0;;;6,0;;;1,0;;2,0;;3,0;;;12,0;3,0;14,0;;;;4,0;2,0;;2,0;;;;3,0;;;;;1,0;;;;;;;;7,0;;;;;;1,0;;;;;3,0;;;5,0;5,0;;;;;;;;;3,0;;;;;;;1,0;;;;;1,0;;;;;;;;;;;;;;;;;;;;;;;;;;;;;;;;;;;;;;1,0;;;;;;;;;;;;;4,0;;;;;;;7,0;;;;;;;1,0;;;;;24,0;;;;;;;;;;;;;;;;;2,0;;;;;;;;;;;;;;;;;;;;;;;;;;;;;;;;;;;;;;;;;1,0;1,0;;;;;;;;3,0;1,0;;;;;;;;;;;;;;7,0;;;1,0;;3,0;;;;;;3,0;;;;;3,0;;;;;;;;1,0;2,0;2,0;;;;;5,0;;;;;;;;;;;;;;;;;;;;;;;;;;;;;;;;;;;;;;1,0;;;;;;;;;3,0;;;;;;;;;;;;;;;;;;;;;;;;
inner;;1,0;;;;45,0;6,0;32,0;;;3,0;9,0;70,0;82,0;;2,0;3,0;1,0;10,0;;2,0;43,0;20,0;3,0;6,0;2,0;3,0;66,0;1,0;12,0;54,0;1,0;;;;16,0;51,0;16,0;;1,0;3,0;93,0;159,0;;;135,0;1,0;109,0;;;1,0;1,0;80,0;7,0;1,0;8,0;171,0;;;4,0;2,0;;;;57,0;;179,0;30,0;;79,0;153,0;503,0;51,0;4,0;;2,0;19,0;1,0;;;24,0;;;;71,0;11,0;;102,0;6,0;5,0;1,0;19,0;9,0;65,0;;;14,0;9,0;64,0;3,0;69,0;1,0;2,0;5,0;1,0;;46,0;;;;1,0;1,0;28,0;1,0;21,0;3,0;;25,0;;35,0;1,0;1,0;9,0;3,0;6,0;2,0;172,0;;;17,0;3,0;2,0;2,0;106,0;22,0;;11,0;2,0;5,0;1,0;5,0;31,0;;;28,0;4,0;56,0;40,0;6,0;76,0;2,0;6,0;104,0;88,0;;2,0;38,0;5,0;;;35,0;88,0;;6,0;;;98,0;148,0;;1,0;4,0;;9,0;62,0;10,0;88,0;5,0;;;3,0;;1,0;10,0;197,0;;3,0;44,0;3,0;93,0;48,0;;;13,0;16,0;67,0;72,0;309,0;7,0;;23,0;;54,0;1,0;;;;169,0;1,0;4,0;126,0;7,0;7,0;;5,0;11,0;552,0;2,0;14,0;3,0;7,0;24,0;3,0;;3,0;52,0;10,0;467,0;2,0;5,0;7,0;48,0;7,0;;1,0;39,0;;18,0;2,0;2,0;8,0;3,0;287,0;2,0;1,0;17,0;1,0;2,0;27,0;272,0;2,0;7,0;18,0;;38,0;15,0;1,0;111,0;1122,0;18,0;;3,0;6,0;;17,0;233,0;8,0;1,0;5,0;1,0;47,0;10,0;7,0;29,0;17,0;4,0;;5,0;12,0;25,0;;2,0;;38,0;43,0;;15,0;31,0;28,0;46,0;16,0;49,0;32,0;17,0;59,0;3,0;27,0;22,0;;41,0;36,0;22,0;23,0;5,0;2,0;4,0;53,0;6,0;4,0;14,0;10,0;8,0;6,0;17,0;8,0;9,0;;27,0;19,0;4,0;2,0;8,0;2,0;20,0;2,0;;37,0;4,0;3,0;11,0;18,0;67,0;14,0;6,0;43,0;10,0;6,0;1,0;8,0;2,0;3,0;25,0;11,0;1,0;28,0;;9,0;28,0;74,0;;18,0;3,0;2,0;;1,0;1,0;52,0;1,0;62,0;1,0;8,0;9,0;;;;;4,0;;;;;5,0;;2,0;18,0;;;;3,0;1,0;;27,0;;;3,0;;1,0;;4,0;;;1,0;;;164,0;3,0;5,0;4,0;;;;;5,0;;1,0;3,0;7,0;;3,0;4,0;10,0;;6,0;;3,0;;1,0;;;;;;3,0;;;;31,0;;;;;2,0;;;2,0;;;7,0;;8,0;;;45,0;3,0;4,0;;2,0;;;3,0;;;3,0;;11,0;8,0;14,0;;;1,0;2,0;13,0;;;1,0;;;;;;;;11,0;;19,0;3,0;;;3,0;;1,0;75,0;;;2,0;;1,0;2,0;;;;;;;18,0;1,0;1,0;;;;;1,0;;1,0;;14,0;12,0;1,0;;;;4,0;;8,0;;;3,0;3,0;20,0;10,0;10,0;26,0;47,0;4,0;3,0;;;2,0;3,0;12,0;;31,0;1,0;;15,0;10,0;;;;1,0;6,0;;47,0;59,0;114,0;;;;2,0;5,0;;2,0;;;;;;;;;;;;4,0;2,0;1,0;;;3,0;3,0;;;;;28,0;10,0;8,0;;;27,0;4,0;1,0;2,0;12,0;15,0;;13,0;5,0;;;1,0;5,0;;;2,0;19,0;;;;2,0;;;;;2,0;2,0;;;2,0;;1,0;2,0;;;;;15,0;;;;12,0;;;1,0;;;;;;;;3,0;;;12,0;;;3,0;;3,0;;1,0;1,0;15,0;;;;;20,0;;3,0;;;1,0;;4,0;1,0;2,0;;7,0;12,0;;1,0;;;;;;;32,0;;1,0;;3,0;;;;;15,0;;;;2,0;;;;;;;42,0;;;22,0;;;3,0;84,0;;;;;;;6,0;4,0;15,0;17,0;15,0;4,0;2,0;;;5,0;9,0;;7,0;;;;1,0;5,0;;6,0;17,0;;;;3,0;;;;;3,0;;;15,0;;1,0;19,0;2,0;31,0;3,0;;;63,0;;;;;;;4,0;78,0;71,0;23,0;5,0;17,0;6,0;1,0;14,0;9,0;10,0;10,0;1,0;;;3,0;;6,0;;3,0;;2,0;16,0;4,0;7,0;;6,0;15,0;14,0;;5,0;;4,0;6,0;17,0;;4,0;181,0;;;;;;;;1,0;1,0;;;;;;1,0;;;;;;;;;1,0;4,0;3,0;;;;;2,0;;7,0;;;;1,0;;;3,0;;8,0;;1,0;;;;;;1,0;12,0;;;7,0;;;;;;;;2,0;9,0;;2,0;;;;;;;;;;;;;3,0;;;;;;;5,0;;5,0;;1,0;;;4,0;3,0;;;;;;;;;7,0;;;;;;;;;;;;1,0;;;;;4,0;;3,0;;;;;;;;1,0;16,0;;14,0;;3,0;;;;;;;;5,0;;2,0;4,0;10,0;;1,0;2,0;1,0;;;10,0;;1,0;;;;7,0;;16,0;;;111,0;;;;;;;;;2,0;;;1,0;;7,0;;;;;;;77,0;;;3,0;;;1,0;;;;;;;;;;;;;24,0;;2,0;;1,0;2,0;;;
input;;25,0;;43,0;44,0;125,0;19,0;16,0;1,0;6,0;;9,0;2,0;513,0;;;216,0;6,0;32,0;28,0;15,0;4,0;57,0;21,0;41,0;1,0;4,0;74,0;51,0;7,0;445,0;113,0;23,0;8,0;2,0;420,0;56,0;8,0;41,0;40,0;281,0;879,0;6,0;55,0;295,0;29,0;29,0;52,0;4,0;18,0;19,0;1,0;;13,0;34,0;8,0;13,0;;9,0;185,0;;;20,0;7,0;1385,0;5,0;255,0;34,0;5,0;3,0;7,0;63,0;131,0;1,0;6,0;4,0;3,0;21,0;88,0;45,0;348,0;;85,0;15,0;233,0;3,0;1,0;48,0;;13,0;38,0;4,0;5,0;21,0;63,0;;143,0;6,0;195,0;122,0;172,0;72,0;9,0;57,0;110,0;167,0;1,0;18,0;1,0;;3,0;66,0;79,0;5,0;;9,0;5,0;32,0;35,0;268,0;36,0;3,0;724,0;24,0;;53,0;264,0;;7,0;;89,0;4,0;21,0;366,0;9,0;;56,0;49,0;165,0;;;4,0;;;23,0;112,0;95,0;59,0;134,0;8,0;3,0;9,0;46,0;;11,0;17,0;;;;;;140,0;10,0;13,0;60,0;;75,0;11,0;2,0;86,0;5,0;;17,0;73,0;1,0;36,0;13,0;1,0;61,0;3,0;2,0;4,0;4,0;45,0;;1,0;24,0;3,0;285,0;4,0;;6,0;4,0;12,0;2,0;;44,0;15,0;5,0;3,0;;16,0;5,0;3,0;3,0;15,0;1,0;;5,0;9,0;18,0;64,0;13,0;;;8,0;386,0;6,0;6,0;32,0;14,0;42,0;1,0;21,0;4,0;;141,0;3,0;;5,0;;2,0;31,0;34,0;;23,0;5,0;1,0;;13,0;;;49,0;;;117,0;13,0;36,0;31,0;;3,0;;2,0;8,0;;33,0;12,0;75,0;2,0;;35,0;39,0;10,0;55,0;7,0;;;2,0;5,0;9,0;1,0;2,0;11,0;8,0;6,0;2,0;18,0;14,0;3,0;;4,0;5,0;27,0;5,0;10,0;;6,0;12,0;98,0;2,0;10,0;9,0;;5,0;1,0;;58,0;31,0;;1,0;;;;8,0;1,0;4,0;7,0;3,0;;56,0;;8,0;4,0;7,0;2,0;4,0;10,0;10,0;4,0;56,0;81,0;143,0;5,0;7,0;9,0;;;;55,0;5,0;2,0;;;;40,0;;24,0;;4,0;;15,0;14,0;8,0;;;2,0;6,0;10,0;;;;;25,0;1,0;22,0;9,0;14,0;1,0;246,0;10,0;4,0;12,0;14,0;19,0;6,0;26,0;26,0;1,0;3,0;6,0;;5,0;38,0;15,0;46,0;9,0;22,0;163,0;15,0;3,0;495,0;16,0;1,0;4,0;13,0;274,0;40,0;26,0;16,0;31,0;4,0;30,0;32,0;97,0;5,0;144,0;;108,0;76,0;53,0;1,0;;11,0;58,0;25,0;131,0;26,0;16,0;83,0;28,0;;26,0;4,0;39,0;172,0;10,0;5,0;;1,0;;2,0;30,0;1,0;17,0;14,0;1008,0;15,0;296,0;63,0;1,0;38,0;5,0;53,0;28,0;10,0;5,0;15,0;50,0;96,0;6,0;3,0;355,0;17,0;20,0;3,0;33,0;;5,0;1353,0;2,0;2,0;178,0;49,0;;18,0;5,0;;12,0;1,0;4,0;63,0;7,0;7,0;20,0;1,0;2,0;7,0;39,0;6,0;1,0;46,0;17,0;92,0;193,0;;;;;4,0;4,0;5,0;4,0;45,0;22,0;9,0;5,0;81,0;18,0;29,0;27,0;5,0;;13,0;1,0;10,0;12,0;94,0;5,0;3,0;1,0;;119,0;;349,0;9,0;16,0;9,0;11,0;39,0;15,0;91,0;;52,0;;6,0;30,0;;4,0;1,0;5,0;9,0;13,0;;17,0;2,0;16,0;4,0;;9,0;;;209,0;9,0;1,0;10,0;2,0;3,0;20,0;6,0;31,0;9,0;10,0;;8,0;3,0;18,0;3,0;7,0;43,0;42,0;;;19,0;2,0;53,0;85,0;7,0;22,0;;;5,0;34,0;21,0;;7,0;2,0;11,0;86,0;31,0;1,0;;11,0;11,0;4,0;10,0;17,0;7,0;9,0;2,0;;;4,0;3,0;8,0;9,0;;1,0;16,0;34,0;9,0;11,0;1,0;2,0;;;5,0;;32,0;2,0;1,0;;7,0;3,0;40,0;22,0;1,0;2,0;2,0;3,0;60,0;5,0;11,0;5,0;21,0;22,0;;7,0;2,0;4,0;;12,0;9,0;28,0;43,0;1,0;4,0;;;1,0;12,0;1,0;3,0;3,0;7,0;;;1,0;1,0;;8,0;1,0;3,0;4,0;2,0;52,0;;;6,0;1,0;4,0;1,0;;4,0;1,0;4,0;4,0;2,0;4,0;7,0;80,0;;32,0;6,0;5,0;11,0;;;;;;72,0;16,0;1,0;6,0;7,0;2,0;2,0;10,0;24,0;9,0;7,0;1,0;6,0;4,0;5,0;12,0;8,0;;;14,0;;1,0;43,0;;16,0;34,0;10,0;11,0;1,0;;11,0;;5,0;40,0;11,0;;;2,0;;10,0;;;;;3,0;6,0;;2,0;2,0;7,0;5,0;;;1,0;9,0;1,0;1,0;;4,0;1,0;;4,0;;3,0;80,0;4,0;;;28,0;;9,0;2,0;2,0;2,0;;6,0;7,0;;;2,0;;;1,0;;2,0;;8,0;4,0;;5,0;;2,0;9,0;;;;;;3,0;;16,0;9,0;4,0;;;;;;;1,0;;;;9,0;;;10,0;6,0;10,0;;85,0;8,0;3,0;48,0;36,0;6,0;24,0;8,0;;;1,0;2,0;12,0;22,0;;5,0;;;4,0;2,0;42,0;;6,0;;32,0;11,0;4,0;;1,0;12,0;6,0;1,0;2,0;;26,0;5,0;;7,0;;;4,0;91,0;24,0;;38,0;7,0;5,0;7,0;;;7,0;;;5,0;3,0;5,0;;;8,0;;8,0;9,0;;2,0;24,0;21,0;4,0;18,0;6,0;2,0;1,0;;5,0;;;4,0;6,0;14,0;;7,0;7,0;5,0;8,0;;20,0;1,0;;4,0;23,0;3,0;;8,0;;23,0;;;;2,0;14,0;;1,0;6,0;8,0;;2,0;40,0;13,0;5,0;28,0;2,0;7,0;10,0;21,0;2,0;68,0;3,0;2,0;4,0;;;2,0;3,0;;;;14,0;;;1,0;;5,0;1,0;3,0;;3,0;7,0;2,0;7,0;14,0;1,0;4,0;;;;;;;;;1,0;;3,0;1,0;;;4,0;;3,0;;6,0;5,0;;;;24,0;2,0;14,0;;7,0;2,0;;1,0;;2,0;4,0;;4,0;;;2,0;3,0;3,0;7,0;10,0;3,0;;2,0;;;;1,0;82,0;;2,0;1,0;2,0;1,0;;;;;2,0;;13,0;4,0;;;;;
insert;;9,0;;8,0;7,0;7,0;9,0;27,0;;;2,0;;19,0;33,0;;;3,0;;2,0;;6,0;;1,0;14,0;2,0;;;41,0;1,0;;48,0;;;;;22,0;2,0;1,0;11,0;3,0;6,0;55,0;19,0;4,0;10,0;11,0;;17,0;;;;;14,0;5,0;1,0;;59,0;;;2,0;2,0;1,0;6,0;;37,0;;31,0;;2,0;1,0;5,0;90,0;15,0;;;;3,0;;4,0;;37,0;;1,0;2,0;84,0;4,0;;18,0;6,0;;2,0;10,0;6,0;2,0;;;7,0;5,0;27,0;3,0;42,0;2,0;;3,0;4,0;1,0;;;;;;1,0;14,0;1,0;3,0;2,0;;7,0;15,0;27,0;;;7,0;12,0;;;26,0;;1,0;2,0;1,0;;;36,0;;;9,0;10,0;1,0;1,0;;;;;20,0;2,0;13,0;12,0;2,0;21,0;;11,0;48,0;25,0;;1,0;2,0;;;2,0;2,0;10,0;2,0;;;;25,0;24,0;;2,0;;;;9,0;1,0;6,0;;6,0;;;;;;8,0;4,0;;17,0;;16,0;19,0;;;7,0;25,0;18,0;151,0;67,0;;23,0;;;4,0;2,0;;;;37,0;2,0;13,0;89,0;12,0;1,0;;;3,0;12,0;3,0;3,0;;6,0;3,0;5,0;;;8,0;8,0;117,0;1,0;;;5,0;;;;10,0;1,0;2,0;;;;;10,0;;2,0;8,0;1,0;1,0;12,0;30,0;10,0;23,0;4,0;;10,0;9,0;;35,0;48,0;2,0;;2,0;;;2,0;4,0;;;;;6,0;;31,0;3,0;7,0;;;10,0;5,0;4,0;2,0;5,0;;15,0;11,0;;;21,0;11,0;2,0;3,0;5,0;3,0;1,0;18,0;2,0;22,0;6,0;1,0;4,0;3,0;1,0;5,0;2,0;;2,0;64,0;1,0;20,0;;22,0;1,0;22,0;1,0;2,0;1,0;5,0;5,0;25,0;3,0;1,0;12,0;18,0;1,0;;;;;5,0;5,0;2,0;49,0;3,0;23,0;15,0;2,0;1,0;1,0;;;;6,0;2,0;4,0;48,0;;10,0;4,0;7,0;;9,0;;5,0;1,0;;6,0;23,0;;18,0;18,0;;;;;;;2,0;;1,0;;;;;;8,0;3,0;;;;;;8,0;;;1,0;;1,0;;;;;;2,0;4,0;;;;;;;;;3,0;3,0;;;12,0;2,0;3,0;2,0;8,0;2,0;10,0;;;;2,0;;;;;;;2,0;;;24,0;;6,0;;2,0;;;;;;;1,0;7,0;;;1,0;5,0;;1,0;;1,0;;1,0;4,0;;;;;;10,0;8,0;;;1,0;;5,0;2,0;;2,0;1,0;;;;;;;1,0;5,0;3,0;2,0;17,0;;1,0;;1,0;6,0;;;1,0;;1,0;2,0;3,0;1,0;4,0;;;;2,0;;;;5,0;;2,0;;10,0;3,0;2,0;2,0;1,0;;;;;;;6,0;10,0;;1,0;;2,0;18,0;;20,0;16,0;;2,0;;;3,0;;15,0;;10,0;;4,0;29,0;;;;2,0;;;3,0;;12,0;77,0;;2,0;;;3,0;;;1,0;;1,0;;1,0;;;;;;;;;;;1,0;1,0;3,0;;;;;2,0;27,0;;;;7,0;;;;1,0;15,0;;50,0;8,0;;;;;;;;;;;;;;;;;1,0;;;;;;;1,0;;;1,0;;4,0;;;2,0;8,0;;;;;;2,0;;;;2,0;10,0;;;;;1,0;;4,0;1,0;1,0;;;11,0;;;;;1,0;2,0;;;;;;;19,0;6,0;;1,0;3,0;;;;;;;;;4,0;;;;4,0;;;;;;;;;6,0;;1,0;;1,0;;;7,0;;;2,0;;;1,0;8,0;;1,0;;;;;;2,0;2,0;3,0;4,0;;;;;1,0;;;1,0;1,0;;3,0;1,0;;;;9,0;;;;6,0;7,0;;;;1,0;;;2,0;;1,0;12,0;;2,0;;4,0;1,0;13,0;;;1,0;;;;1,0;1,0;3,0;5,0;;4,0;2,0;1,0;;15,0;12,0;;;18,0;3,0;2,0;;;14,0;8,0;;1,0;6,0;3,0;2,0;;;;9,0;26,0;6,0;;4,0;;;;2,0;4,0;;;;;;;;;;;;;;;;8,0;;;;;;;;;;;6,0;;;2,0;;;2,0;;;;;;1,0;;;;;;;;;;;;;;;6,0;;;;;;;;;;;;;;1,0;;;;;;;2,0;;;;;;;;;;;;;;2,0;;;;1,0;;;;;;;;;;;;;;3,0;;;;;;;;;;;1,0;1,0;;3,0;;;1,0;;1,0;;1,0;6,0;;;;;5,0;;;4,0;;;;;;;;;;;1,0;;;;;;;;;;;1,0;;;;;6,0;;;;;;;;;3,0;;;;10,0;;;;;;;;;;;;1,0;;;;;;;;;;;;;;;;;;;;;;;
inside;;3,0;;8,0;;25,0;2,0;45,0;;;1,0;;30,0;30,0;3,0;;32,0;2,0;10,0;;;16,0;6,0;;3,0;;;41,0;;;53,0;12,0;;;;13,0;9,0;2,0;6,0;1,0;21,0;65,0;24,0;19,0;27,0;145,0;1,0;18,0;;1,0;;;28,0;5,0;4,0;1,0;36,0;;;9,0;7,0;;6,0;;102,0;;42,0;1,0;;3,0;4,0;127,0;48,0;;;;8,0;2,0;;4,0;31,0;;2,0;;48,0;14,0;;37,0;;2,0;4,0;2,0;3,0;4,0;10,0;;20,0;3,0;18,0;5,0;82,0;2,0;1,0;;4,0;6,0;;1,0;;;;1,0;33,0;1,0;;;;1,0;;35,0;;5,0;6,0;6,0;;13,0;50,0;;;;1,0;;;88,0;;;27,0;;;;6,0;10,0;;;3,0;1,0;50,0;59,0;;5,0;4,0;1,0;122,0;6,0;4,0;;7,0;6,0;;;5,0;37,0;;;;;17,0;59,0;1,0;;1,0;;;11,0;9,0;18,0;1,0;13,0;1,0;2,0;2,0;9,0;12,0;24,0;;3,0;7,0;4,0;35,0;10,0;;;16,0;17,0;27,0;30,0;248,0;3,0;17,0;1,0;;14,0;;;2,0;;68,0;9,0;10,0;91,0;8,0;5,0;;;;46,0;8,0;1,0;14,0;1,0;4,0;;5,0;;13,0;;90,0;2,0;7,0;;11,0;;6,0;8,0;13,0;3,0;8,0;;;;1,0;22,0;10,0;3,0;5,0;11,0;4,0;9,0;19,0;15,0;;2,0;3,0;9,0;23,0;5,0;44,0;181,0;6,0;;6,0;2,0;;56,0;11,0;;1,0;1,0;1,0;25,0;7,0;10,0;19,0;10,0;7,0;;10,0;10,0;3,0;1,0;7,0;1,0;6,0;16,0;;;14,0;43,0;17,0;2,0;49,0;3,0;6,0;22,0;6,0;4,0;9,0;7,0;9,0;5,0;2,0;4,0;4,0;4,0;;9,0;1,0;8,0;2,0;26,0;2,0;;;3,0;1,0;;64,0;9,0;1,0;4,0;7,0;43,0;4,0;7,0;2,0;4,0;4,0;;29,0;2,0;8,0;2,0;17,0;10,0;1,0;6,0;1,0;;;;5,0;6,0;2,0;3,0;1,0;7,0;6,0;21,0;5,0;21,0;;8,0;;1,0;25,0;13,0;;6,0;7,0;2,0;12,0;;;1,0;;3,0;;2,0;;;;;;5,0;4,0;;;;;;12,0;1,0;;;;9,0;;;5,0;;;;;1,0;;1,0;8,0;;1,0;;;4,0;10,0;;;24,0;8,0;33,0;;6,0;;14,0;;3,0;4,0;2,0;4,0;;;;;;;2,0;;28,0;2,0;;;;3,0;;;;2,0;;21,0;12,0;10,0;;11,0;5,0;1,0;4,0;;1,0;;;14,0;;;5,0;3,0;;5,0;9,0;;1,0;;;1,0;;1,0;;;;;;;;;1,0;;;12,0;2,0;1,0;;;9,0;34,0;;9,0;1,0;2,0;;;;2,0;;;2,0;;6,0;2,0;;;;1,0;2,0;;;1,0;;;2,0;;;;;3,0;;5,0;2,0;;1,0;3,0;5,0;5,0;4,0;14,0;9,0;;3,0;;;9,0;;1,0;;;;1,0;14,0;;;1,0;;1,0;4,0;;;4,0;43,0;;2,0;;;2,0;;;;;;;;;;;;;18,0;;9,0;;;2,0;;1,0;1,0;;;;2,0;3,0;;;;3,0;5,0;;1,0;;7,0;;41,0;1,0;;1,0;2,0;1,0;;;3,0;17,0;;;2,0;;;;;;2,0;;;;;;;;1,0;;5,0;;;3,0;4,0;;5,0;;;;1,0;;;;;;;;;;;22,0;;2,0;;2,0;;;;;3,0;;5,0;;4,0;2,0;1,0;;;;;;;;;;;;;;1,0;2,0;;;;5,0;;19,0;;;;;;;;21,0;3,0;;2,0;;6,0;1,0;1,0;;;22,0;1,0;4,0;4,0;;;;12,0;;8,0;;4,0;6,0;1,0;1,0;12,0;7,0;7,0;;;;;;2,0;1,0;;4,0;3,0;;19,0;;;;;7,0;;3,0;;1,0;;;;;;;;7,0;1,0;3,0;15,0;;9,0;;1,0;4,0;9,0;;2,0;;2,0;2,0;;10,0;57,0;14,0;5,0;;3,0;1,0;;30,0;2,0;4,0;;;6,0;;;1,0;2,0;6,0;;23,0;2,0;7,0;3,0;1,0;;;2,0;14,0;5,0;1,0;;4,0;;19,0;;;5,0;;;;;;;;;;;12,0;1,0;2,0;;1,0;;;;;;;;;;;;;;7,0;1,0;6,0;;;1,0;3,0;1,0;;;;18,0;;;;;2,0;;;2,0;2,0;1,0;;;;9,0;;;;;1,0;;;;;;;;1,0;;2,0;;;1,0;;4,0;1,0;;;;1,0;;1,0;1,0;;;;;3,0;;;;;5,0;1,0;;;;;;;;;;;;;;;;1,0;;;;;1,0;;;;2,0;2,0;;3,0;;;;2,0;1,0;;;;;;1,0;;6,0;3,0;;;;;;1,0;2,0;;11,0;;1,0;1,0;;3,0;;;;1,0;;;4,0;;14,0;3,0;;;;;4,0;1,0;15,0;5,0;;;;;;2,0;;;;;3,0;;;;;;;6,0;;;;;;;1,0;4,0;;;;;;;;;;;;;;;;3,0;;;
install;;5,0;;6,0;;10,0;3,0;32,0;;2,0;1,0;;13,0;38,0;;;20,0;;1,0;;2,0;;;3,0;5,0;;3,0;5,0;;;34,0;10,0;;;2,0;11,0;3,0;2,0;;;6,0;93,0;;;9,0;7,0;;15,0;;;;2,0;3,0;11,0;4,0;;17,0;;;13,0;1,0;;1,0;;59,0;;47,0;;;7,0;;111,0;45,0;2,0;1,0;;;;;6,0;38,0;;1,0;;62,0;14,0;;30,0;1,0;2,0;1,0;;;1,0;31,0;;19,0;;36,0;1,0;33,0;4,0;;3,0;;;;1,0;14,0;;;;1,0;2,0;;;1,0;2,0;;65,0;;;8,0;;;4,0;39,0;;1,0;;1,0;;;76,0;;4,0;12,0;;;;;15,0;;;5,0;1,0;23,0;6,0;3,0;3,0;;1,0;34,0;7,0;;2,0;4,0;;;;2,0;14,0;;;;;9,0;21,0;;3,0;2,0;;;13,0;;3,0;2,0;1,0;4,0;2,0;1,0;1,0;;4,0;3,0;;19,0;;11,0;18,0;3,0;;5,0;;25,0;7,0;39,0;7,0;;3,0;;;;;1,0;;30,0;;7,0;23,0;4,0;;1,0;;;16,0;3,0;2,0;;4,0;1,0;1,0;;12,0;14,0;2,0;12,0;2,0;;;2,0;;3,0;;13,0;;;3,0;;;;2,0;3,0;4,0;1,0;1,0;4,0;;41,0;;1,0;;;3,0;17,0;7,0;18,0;42,0;2,0;;;6,0;4,0;79,0;3,0;;1,0;;;18,0;2,0;14,0;11,0;5,0;6,0;;1,0;3,0;;;;20,0;5,0;24,0;;;12,0;11,0;36,0;;30,0;1,0;;1,0;;2,0;3,0;11,0;;;;;3,0;;1,0;5,0;;;;13,0;;3,0;19,0;;4,0;;6,0;;;5,0;16,0;3,0;4,0;3,0;2,0;7,0;2,0;;16,0;19,0;2,0;;2,0;2,0;;;;;;1,0;6,0;2,0;;;6,0;2,0;;16,0;;2,0;2,0;1,0;;;16,0;1,0;;23,0;1,0;4,0;;;;;;5,0;4,0;;;;;;3,0;13,0;2,0;;;;;;11,0;;;1,0;;1,0;3,0;;;;;;1,0;2,0;;5,0;;1,0;;;;2,0;;2,0;;13,0;;9,0;;8,0;;6,0;;9,0;;3,0;;;;;;;;;;14,0;;1,0;;;10,0;13,0;1,0;2,0;1,0;1,0;9,0;;3,0;;6,0;77,0;;5,0;;2,0;1,0;1,0;22,0;;;1,0;1,0;;16,0;;;;;;7,0;;;;;;;;6,0;;2,0;;;3,0;2,0;2,0;;2,0;;1,0;19,0;;3,0;2,0;;;5,0;3,0;10,0;;;;2,0;1,0;8,0;;;6,0;;3,0;1,0;;5,0;;;1,0;;;;;;;;;;;2,0;1,0;6,0;;1,0;7,0;;4,0;;;2,0;2,0;;;5,0;;1,0;9,0;2,0;4,0;;;5,0;;;;1,0;1,0;;1,0;;;;;1,0;3,0;4,0;;3,0;;;;;;;3,0;8,0;;;;;;;1,0;;;;;2,0;;;;;5,0;;;1,0;4,0;4,0;;;;;1,0;6,0;;;1,0;3,0;;;3,0;;1,0;;;;1,0;;;;;;;;;;1,0;;;;3,0;;4,0;;;;1,0;;;;;;;;10,0;;2,0;9,0;;1,0;;1,0;;4,0;;;;;;;6,0;;1,0;;;;;;;;1,0;;;;;12,0;;2,0;2,0;3,0;;;3,0;11,0;;3,0;;;;;;5,0;;;1,0;;2,0;;;;;3,0;;;15,0;;;;4,0;;2,0;1,0;7,0;;1,0;2,0;2,0;9,0;;;1,0;;;;;;;1,0;;;;3,0;;1,0;;;;;;;;1,0;;14,0;;;2,0;2,0;;;10,0;;;5,0;;;;;2,0;;3,0;;;1,0;15,0;3,0;;;;1,0;;;1,0;6,0;;;2,0;1,0;8,0;2,0;;1,0;;;;5,0;;;;;3,0;7,0;4,0;;;;;;;;;;;;;;;;4,0;6,0;;;;2,0;;1,0;;;;;;3,0;;;;;;6,0;;2,0;;;;;;;;;;;;;;;24,0;2,0;;;;;;;;2,0;;2,0;;;;;13,0;;2,0;;4,0;;;;;;;;;;1,0;;;;;;2,0;1,0;;;2,0;;;1,0;;;;;;1,0;;1,0;;;;;;;;;1,0;;;;;;;1,0;3,0;;;;;;2,0;;;;;;;1,0;26,0;;;;;;;3,0;;2,0;;;;2,0;;;;;;;5,0;;;;;;1,0;3,0;;;;;3,0;;;;;1,0;3,0;;;;;;;;;;;;2,0;;;;;1,0;;2,0;;;;;;;;4,0;;;;;3,0;;;;;;;;;;;;;;;;
instruct;;1,0;;5,0;;10,0;;;;;;;;3,0;;;21,0;;;;;;;1,0;;;;;8,0;2,0;44,0;14,0;;;;6,0;4,0;2,0;;;1,0;43,0;;8,0;9,0;;;2,0;;;;;;1,0;4,0;;;;;6,0;;;6,0;;42,0;1,0;2,0;;;;;13,0;2,0;;;;;;1,0;7,0;15,0;;4,0;;37,0;;;;;1,0;;;;;;;;2,0;10,0;4,0;5,0;1,0;;4,0;7,0;21,0;1,0;8,0;;;;;;;;;;;;10,0;;;29,0;;;12,0;34,0;;9,0;;1,0;;;19,0;;;1,0;1,0;;;;;;;10,0;1,0;2,0;;;;;;3,0;;;;;;;;;;6,0;;;;;;;;;;;;;;;;1,0;;;;;2,0;;;;;;;;;;;;;;;;;;;;;;1,0;;;;;6,0;1,0;;;;;10,0;;;;1,0;1,0;1,0;;;;;;;;;;;;;;;;;;;;;1,0;;2,0;;;;;;;;;;;;;;;;6,0;;;;;;;;;;;1,0;;;;;;;;;;;;;;;;1,0;;;1,0;;;;;;4,0;;;;;;;;;;;;3,0;;;;;;;;;;;5,0;3,0;;;;;;;;;;;;;20,0;;1,0;;;;;;;;;;;;2,0;;;;;;;;;;10,0;;;;;2,0;9,0;;;;;2,0;;;;;2,0;1,0;;6,0;;;37,0;1,0;;;;1,0;1,0;;;1,0;1,0;15,0;;3,0;;;;1,0;;;;9,0;;;;1,0;;3,0;;6,0;1,0;;;22,0;17,0;;;;;;;1,0;;8,0;2,0;9,0;;1,0;1,0;;;;10,0;;;;2,0;;32,0;;;;;;;;;;36,0;;;1,0;6,0;;;;;1,0;;;1,0;;;;;;;2,0;1,0;;;1,0;29,0;;;;;;;;;;;;;1,0;22,0;;4,0;;;;;;;;1,0;3,0;;;;8,0;;;;;;4,0;;;3,0;;;;;1,0;;;;;;;;;;;;;;;;;;;;;;;;;;;;1,0;;9,0;;;;1,0;;;;;1,0;2,0;;;;;;18,0;;;;1,0;3,0;6,0;1,0;;;;;;3,0;;;;;;;;;;1,0;;;;6,0;;;;;;;;;4,0;;;;;;5,0;;1,0;1,0;;;;;;;;;;2,0;;;;14,0;;;;;;;;;;;;;;;;;;;;;;;;;;1,0;;4,0;;1,0;;2,0;2,0;;;;;;;;;2,0;;10,0;;;4,0;;2,0;3,0;;;;;2,0;;;;;;;;;2,0;;;;;;2,0;;;;;;;;;;;;;2,0;;;;;;;;;;;;4,0;;;6,0;;5,0;;;4,0;;;;;1,0;1,0;;1,0;;;;;;;;;1,0;;;;;;4,0;;;;;;;;;;;;;;;;;;;;;;;;5,0;;;;;;;;;;;;;;;;;;;;;;;;;;;;;;;;;;;;;;2,0;;;;;;;;;;;;;;;;;;;;;;;;1,0;;;;;;;;;;;;;1,0;;;;;;;;;;;;1,0;;;;;;;;;;;;;;;;;;;;;;;;;;;;;;;;;;;;;;;;6,0;;;14,0;;;;;;;;;;;;;;;;1,0;;;;;;;;;;;;;;;;;;;;;;;;;;;;;;;;;;2,0;;;;;;;;;;;;;;;;;;;;;;;;;;;;;;;;;;;;;;;;;;1,0;;;;;;;
instruction;;7,0;;38,0;5,0;171,0;14,0;11,0;;16,0;;;;132,0;;4,0;288,0;;8,0;4,0;5,0;;27,0;26,0;42,0;5,0;3,0;17,0;445,0;63,0;416,0;65,0;13,0;10,0;;179,0;11,0;6,0;30,0;5,0;364,0;838,0;;43,0;237,0;;6,0;8,0;4,0;21,0;33,0;;3,0;6,0;7,0;8,0;8,0;;2,0;193,0;;;11,0;22,0;688,0;57,0;462,0;;11,0;;8,0;69,0;23,0;1,0;8,0;9,0;;6,0;119,0;433,0;131,0;1,0;12,0;3,0;68,0;1,0;7,0;12,0;;4,0;44,0;1,0;3,0;19,0;60,0;;48,0;14,0;196,0;26,0;95,0;7,0;1,0;26,0;121,0;1650,0;86,0;965,0;7,0;1,0;;13,0;39,0;5,0;;3,0;10,0;11,0;12,0;79,0;28,0;1,0;123,0;6,0;;746,0;454,0;;25,0;1,0;77,0;2,0;;134,0;;;45,0;25,0;41,0;;;;1,0;;33,0;40,0;16,0;;29,0;1,0;;4,0;23,0;;;2,0;;;;;;5,0;20,0;5,0;;7,0;31,0;;;42,0;2,0;;25,0;22,0;;20,0;1,0;5,0;29,0;2,0;2,0;;;9,0;;;21,0;;29,0;2,0;1,0;4,0;5,0;27,0;;;7,0;;;5,0;;;;15,0;21,0;845,0;;;6,0;12,0;8,0;9,0;3,0;;;;47,0;11,0;;4,0;4,0;5,0;4,0;2,0;1,0;;61,0;;1,0;9,0;;3,0;5,0;4,0;;3,0;;2,0;;4,0;;;;1,0;;65,0;2,0;10,0;3,0;3,0;;;;7,0;1,0;3,0;;11,0;1,0;;4,0;78,0;14,0;49,0;;11,0;;;10,0;6,0;;;19,0;26,0;3,0;;2,0;16,0;;;;11,0;5,0;1,0;2,0;;;19,0;8,0;2,0;1,0;32,0;;;2,0;;17,0;1,0;;1,0;;;;7,0;5,0;;;10,0;35,0;62,0;;;;;2,0;;9,0;8,0;;10,0;70,0;46,0;1,0;4,0;6,0;;3,0;;34,0;;;;;;73,0;;;;;;16,0;10,0;2,0;;;;9,0;;;;;;2,0;;13,0;1,0;;;94,0;26,0;1,0;;3,0;23,0;34,0;8,0;27,0;1,0;2,0;4,0;15,0;1,0;21,0;4,0;26,0;8,0;6,0;22,0;20,0;6,0;374,0;7,0;1,0;;;195,0;37,0;5,0;5,0;34,0;4,0;1126,0;10,0;7,0;4,0;28,0;;93,0;45,0;1,0;;92,0;3,0;6,0;;45,0;21,0;19,0;16,0;18,0;;9,0;1,0;21,0;175,0;13,0;;;;1,0;1,0;15,0;;18,0;262,0;359,0;30,0;133,0;21,0;;8,0;;34,0;8,0;13,0;;403,0;26,0;31,0;2,0;4,0;16,0;30,0;11,0;11,0;104,0;;38,0;131,0;1,0;11,0;3,0;49,0;;;;3,0;16,0;2,0;3,0;312,0;5,0;7,0;9,0;;35,0;9,0;163,0;;2,0;5,0;6,0;;56,0;;;;1,0;15,0;88,0;;;7,0;17,0;58,0;16,0;308,0;1,0;13,0;18,0;;8,0;1,0;4,0;3,0;;17,0;10,0;65,0;1,0;1,0;37,0;186,0;8,0;26,0;16,0;;18,0;11,0;4,0;15,0;3,0;3,0;;1,0;9,0;4,0;;;;4,0;1,0;4,0;1,0;3,0;;;2,0;;;;53,0;;6,0;1,0;;12,0;9,0;16,0;19,0;;;9,0;1,0;6,0;22,0;;;6,0;10,0;;;2,0;6,0;36,0;15,0;;5,0;;1,0;;65,0;1,0;2,0;13,0;2,0;12,0;9,0;14,0;;3,0;1,0;4,0;;10,0;;2,0;4,0;;;1,0;9,0;;;23,0;;;31,0;119,0;3,0;8,0;5,0;3,0;10,0;;6,0;4,0;7,0;11,0;1,0;9,0;469,0;1,0;44,0;4,0;23,0;;13,0;1,0;;5,0;1,0;4,0;;10,0;;4,0;10,0;6,0;2,0;8,0;29,0;8,0;8,0;3,0;;5,0;;;1,0;;;1,0;18,0;;3,0;1,0;;4,0;1,0;5,0;3,0;;;1,0;1,0;;1,0;1,0;;;3,0;5,0;;4,0;7,0;5,0;3,0;1,0;5,0;1,0;86,0;14,0;3,0;10,0;;23,0;;;6,0;31,0;2,0;1,0;2,0;17,0;10,0;17,0;1,0;22,0;1,0;4,0;8,0;4,0;12,0;3,0;8,0;11,0;;;7,0;2,0;1,0;4,0;4,0;1,0;1,0;2,0;;;;1,0;9,0;2,0;20,0;10,0;;;;;3,0;;3,0;;2,0;;5,0;;;10,0;;11,0;;;6,0;7,0;6,0;;3,0;2,0;1,0;;;;;12,0;10,0;;;14,0;3,0;2,0;;;;;1,0;22,0;;;;;;;;;;2,0;;;;;;;;;;;;;;6,0;;2,0;;;;1,0;;;;;1,0;;7,0;;1,0;1,0;4,0;;;;;;;;;;1,0;5,0;;;;;9,0;;1,0;;1,0;1,0;8,0;2,0;;;;3,0;11,0;;;;;;4,0;8,0;3,0;;1,0;;36,0;;;;;9,0;;6,0;1,0;;;;;;;;;;17,0;1,0;1,0;1,0;;4,0;22,0;;3,0;1,0;;4,0;2,0;;;1,0;;1,0;1,0;2,0;1,0;2,0;1,0;1,0;2,0;4,0;1,0;2,0;6,0;4,0;;4,0;21,0;12,0;;;;1,0;3,0;;;;13,0;9,0;;4,0;6,0;2,0;8,0;1,0;3,0;;;13,0;11,0;4,0;1,0;1,0;;10,0;;1,0;1,0;2,0;1,0;;3,0;1,0;;;3,0;;;;2,0;;;;;;1,0;4,0;3,0;;;1,0;;;2,0;1,0;1,0;;1,0;;1,0;;;;;;;;;;;2,0;;;;8,0;1,0;2,0;;;21,0;;1,0;1,0;2,0;;;;;;;7,0;1,0;;;5,0;;;;;;2,0;7,0;;7,0;8,0;3,0;;2,0;1,0;;1,0;3,0;6,0;;2,0;;;;;
interchangeable;;3,0;;8,0;16,0;190,0;;8,0;1,0;;2,0;;5,0;21,0;;;8,0;;;7,0;;2,0;;17,0;98,0;1,0;5,0;3,0;;5,0;51,0;58,0;6,0;30,0;;52,0;1,0;;;;42,0;30,0;3,0;26,0;16,0;2,0;1,0;26,0;;7,0;4,0;6,0;;;;15,0;15,0;;1,0;4,0;;;17,0;4,0;92,0;;138,0;;;;17,0;1499,0;11,0;;13,0;;;;;10,0;62,0;;12,0;5,0;6,0;8,0;;66,0;;;9,0;;1,0;;14,0;;1,0;5,0;25,0;1,0;39,0;12,0;;4,0;7,0;10,0;;;;7,0;;8,0;;;2,0;;;1,0;;17,0;;;84,0;8,0;;11,0;181,0;;;1,0;10,0;;;106,0;1,0;;1,0;;21,0;;;;;;27,0;;;11,0;2,0;49,0;1,0;;306,0;;;;;;;;;39,0;3,0;2,0;;;1,0;1,0;;10,0;5,0;1,0;2,0;17,0;;;3,0;;4,0;;;;;7,0;;;2,0;;9,0;4,0;;;;11,0;;;2,0;;1,0;1,0;;;6,0;;1,0;4,0;15,0;;;185,0;3,0;5,0;2,0;;;;13,0;;;3,0;;21,0;;;;;3,0;2,0;;;;;18,0;11,0;;;;;13,0;5,0;;6,0;;;;4,0;;2,0;17,0;7,0;;;;;;18,0;5,0;12,0;;;;34,0;28,0;;;;;;;;;;;3,0;18,0;;3,0;;;1,0;;1,0;11,0;;;;;11,0;10,0;3,0;;3,0;;1,0;;;3,0;1,0;;8,0;;12,0;;;;5,0;1,0;;3,0;21,0;;;;;;;1,0;4,0;1,0;3,0;;5,0;1,0;;;;18,0;;35,0;;;;;;5,0;;2,0;;;;1,0;6,0;;;;3,0;;;;1,0;;;;;;;5,0;;6,0;;;;;;;2,0;;2,0;;;;;4,0;;8,0;1,0;;23,0;2,0;;131,0;;;1,0;;6,0;1,0;1,0;;;1,0;1,0;;36,0;;6,0;;;8,0;;;2,0;;11,0;;;;;;4,0;;;;9,0;30,0;;;;;;;2,0;;4,0;;23,0;;16,0;2,0;6,0;;;3,0;;10,0;;22,0;4,0;22,0;6,0;1,0;19,0;;2,0;;;;;1,0;;;2,0;;;;;;;;;;;;;;;;;;;;;10,0;;;;;;;;;;;;;;39,0;;;1,0;;;;;2,0;;;;;;;;2,0;;;2,0;;;;;;1,0;;;;;;2,0;;;10,0;;;;;;;;;;;;;;;1,0;;;;;;;19,0;5,0;;;;;;;;;;;25,0;2,0;;;;;;11,0;;1,0;;14,0;;;;5,0;;2,0;;;;;;;2,0;;;;;;2,0;;;;;;6,0;;;;;;;;1,0;;1,0;;;;;;;;;;;;;;;;;10,0;;;;6,0;1,0;;;;;4,0;;1,0;;1,0;;;;;;2,0;2,0;;;;2,0;;;;1,0;;;;;;;;;11,0;3,0;1,0;;;;20,0;;;3,0;;;;;;1,0;;;3,0;;;;;1,0;;;;;8,0;;;;;;;;;11,0;;;49,0;;;36,0;71,0;;;6,0;25,0;60,0;;2,0;1,0;1,0;;;;;3,0;;;7,0;3,0;;4,0;2,0;;;3,0;;;;;;;;1,0;;;1,0;;;;2,0;;2,0;;;;;;2,0;;4,0;;;;;;1,0;;;47,0;;;1,0;;;;;;2,0;;;;;1,0;2,0;;;;;;;;;;;;;;;;1,0;;;;2,0;;;;;;;;;;;2,0;;;;;;;;;;;;;;30,0;;;;;;;;;1,0;;;;;;;;;;1,0;;;;2,0;;;;;;;;;;;;;;;;;;;;;;;;;;;3,0;;;;;1,0;1,0;;;;;;;;;1,0;5,0;3,0;;1,0;;;;;;;;;;2,0;;;;;;;;;;;;;;;;;;;;;;;;1,0;;;;;;;;;;;;;;;1,0;;;;;;;10,0;;4,0;;1,0;2,0;;;;;;;;;;;;;;;;;;;;2,0;;;;;;;;;;;;;;;;;;;;;;;4,0;;;;;;;;;4,0
interface;;26,0;2,0;14,0;;106,0;14,0;77,0;;3,0;;8,0;;94,0;;2,0;107,0;;3,0;1,0;24,0;2,0;7,0;56,0;283,0;;;46,0;50,0;1,0;479,0;47,0;3,0;;4,0;298,0;17,0;2,0;3,0;16,0;51,0;669,0;;50,0;652,0;31,0;;117,0;;5,0;3,0;2,0;33,0;19,0;17,0;6,0;21,0;;5,0;61,0;;;12,0;14,0;393,0;5,0;369,0;10,0;2,0;;7,0;45,0;27,0;5,0;1,0;;7,0;;27,0;62,0;169,0;;17,0;7,0;383,0;4,0;2,0;76,0;1,0;6,0;27,0;6,0;8,0;31,0;5,0;;9,0;15,0;100,0;14,0;53,0;17,0;1,0;15,0;92,0;191,0;4,0;64,0;2,0;;;4,0;11,0;4,0;;1,0;3,0;23,0;13,0;151,0;8,0;;153,0;5,0;;17,0;376,0;;3,0;;19,0;2,0;2,0;58,0;2,0;1,0;72,0;55,0;11,0;;;10,0;3,0;;5,0;11,0;39,0;36,0;53,0;12,0;;6,0;56,0;9,0;4,0;11,0;;1,0;2,0;;;120,0;23,0;3,0;2,0;5,0;166,0;11,0;;10,0;8,0;;31,0;6,0;;7,0;2,0;11,0;37,0;2,0;1,0;1,0;;49,0;;;5,0;3,0;37,0;22,0;;;2,0;3,0;1,0;1,0;97,0;1,0;19,0;3,0;;10,0;2,0;2,0;10,0;50,0;20,0;2,0;6,0;126,0;6,0;12,0;;1,0;;7,0;128,0;1,0;1,0;1,0;1,0;3,0;;;6,0;4,0;151,0;5,0;3,0;21,0;5,0;3,0;15,0;1,0;15,0;3,0;3,0;2,0;4,0;38,0;1,0;;3,0;2,0;10,0;92,0;7,0;4,0;19,0;9,0;1,0;2,0;2,0;18,0;8,0;11,0;37,0;67,0;11,0;;33,0;95,0;15,0;66,0;16,0;;2,0;;4,0;42,0;2,0;9,0;2,0;65,0;15,0;;42,0;16,0;7,0;12,0;12,0;3,0;12,0;24,0;;;9,0;13,0;86,0;;1,0;7,0;;4,0;23,0;3,0;34,0;9,0;;14,0;4,0;1,0;5,0;;15,0;;3,0;2,0;;106,0;3,0;2,0;;2,0;3,0;3,0;27,0;3,0;13,0;13,0;104,0;71,0;1,0;1,0;14,0;1,0;;;133,0;;6,0;;;12,0;48,0;4,0;3,0;;2,0;;10,0;4,0;1,0;;2,0;23,0;10,0;22,0;;1,0;;;;;;;1,0;9,0;183,0;194,0;3,0;;1,0;38,0;5,0;5,0;2,0;;;3,0;9,0;;3,0;16,0;9,0;4,0;7,0;40,0;;;262,0;4,0;;3,0;;30,0;10,0;2,0;;10,0;5,0;16,0;5,0;5,0;6,0;51,0;;15,0;22,0;3,0;;193,0;18,0;17,0;4,0;45,0;22,0;21,0;36,0;15,0;;12,0;1,0;30,0;65,0;21,0;;;;2,0;;9,0;1,0;2,0;12,0;375,0;57,0;40,0;11,0;;7,0;6,0;23,0;5,0;4,0;;29,0;15,0;46,0;4,0;;21,0;12,0;;;21,0;;3,0;1418,0;;1,0;11,0;22,0;7,0;1,0;5,0;;19,0;;2,0;79,0;6,0;;14,0;4,0;3,0;1,0;1,0;;18,0;27,0;13,0;56,0;;;;1,0;45,0;2,0;6,0;1,0;;7,0;24,0;24,0;;36,0;21,0;26,0;3,0;1,0;;;4,0;14,0;;90,0;9,0;4,0;;5,0;67,0;3,0;34,0;;1,0;10,0;1,0;11,0;10,0;5,0;;33,0;10,0;2,0;7,0;;1,0;;;32,0;76,0;;1,0;4,0;;27,0;2,0;;1,0;1,0;18,0;5,0;44,0;4,0;10,0;;15,0;;5,0;;;4,0;20,0;1,0;12,0;2,0;1,0;11,0;16,0;5,0;5,0;8,0;19,0;30,0;35,0;;8,0;;;6,0;25,0;3,0;5,0;19,0;1,0;25,0;2,0;44,0;6,0;4,0;9,0;15,0;5,0;24,0;4,0;;2,0;;;;3,0;2,0;7,0;3,0;1,0;2,0;68,0;7,0;1,0;100,0;;;;7,0;31,0;7,0;16,0;11,0;13,0;;;;43,0;20,0;21,0;6,0;7,0;;;1,0;3,0;2,0;3,0;14,0;12,0;3,0;7,0;;2,0;11,0;;;1,0;8,0;;;;1,0;11,0;;15,0;51,0;90,0;2,0;7,0;;2,0;1,0;;14,0;5,0;3,0;;1,0;9,0;;3,0;23,0;1,0;;1,0;20,0;1,0;;4,0;6,0;;6,0;;;22,0;10,0;12,0;7,0;1,0;4,0;16,0;;8,0;29,0;21,0;;10,0;5,0;5,0;6,0;;30,0;;1,0;1,0;11,0;10,0;6,0;8,0;4,0;1,0;7,0;2,0;;1,0;5,0;3,0;7,0;6,0;3,0;5,0;28,0;4,0;;5,0;3,0;1,0;;3,0;36,0;6,0;1,0;1,0;3,0;;1,0;6,0;;9,0;;3,0;;;4,0;3,0;;8,0;4,0;2,0;2,0;;;;;9,0;1,0;2,0;18,0;9,0;;5,0;;;13,0;;;12,0;;;23,0;1,0;2,0;;;;14,0;;;;3,0;;8,0;3,0;14,0;;6,0;;;;;;14,0;;7,0;3,0;5,0;;1,0;;;;;5,0;7,0;3,0;;18,0;6,0;;;1,0;;;;;;18,0;;;2,0;;3,0;;;;2,0;;;2,0;;1,0;26,0;;14,0;;;;1,0;3,0;1,0;1,0;5,0;;;2,0;3,0;4,0;1,0;1,0;2,0;2,0;;;;4,0;4,0;;;;1,0;;;;;3,0;;;;2,0;;;;3,0;;;;;4,0;8,0;4,0;3,0;;71,0;;;;1,0;;2,0;;15,0;;9,0;2,0;;;1,0;1,0;;1,0;6,0;;;;;2,0;;;1,0;;3,0;;;1,0;1,0;;;1,0;5,0;4,0;2,0;12,0;4,0;7,0;4,0;22,0;6,0;4,0;;6,0;7,0;;;;4,0;;6,0;;5,0;12,0;4,0;;2,0;57,0;;;;1,0;6,0;;;;;1,0;;;7,0;2,0;;;;;3,0;12,0;;;;;;;11,0;;12,0;1,0;;10,0;;2,0;;1,0;;;;9,0;1,0;;;2,0;;;;1,0;;;9,0;;6,0;1,0;;;;;;2,0;1,0;;1,0;2,0;;;2,0;;;;;;;5,0;;;;;
interior;;1,0;;6,0;;8,0;;80,0;;;;11,0;5,0;71,0;;;51,0;;8,0;;1,0;;1,0;;7,0;;;37,0;1,0;1,0;67,0;1,0;;;;7,0;47,0;;;1,0;4,0;25,0;13,0;3,0;11,0;55,0;;14,0;;;;3,0;103,0;12,0;10,0;;36,0;;;9,0;3,0;;;;70,0;;57,0;26,0;;;6,0;62,0;17,0;;;;3,0;;;;23,0;;9,0;2,0;22,0;1,0;;14,0;1,0;4,0;;3,0;1,0;1,0;32,0;;;;66,0;4,0;36,0;;;;3,0;3,0;;1,0;;;;;22,0;1,0;4,0;;;12,0;;45,0;;;3,0;1,0;;5,0;24,0;;;6,0;;;2,0;16,0;22,0;;44,0;;;;;16,0;;;14,0;;15,0;9,0;8,0;55,0;3,0;;62,0;11,0;;;;5,0;;;6,0;13,0;;;;;21,0;24,0;5,0;1,0;;;3,0;38,0;4,0;24,0;;;;;6,0;30,0;4,0;37,0;;;;;21,0;61,0;9,0;;11,0;11,0;13,0;2,0;235,0;;3,0;2,0;;52,0;4,0;;;2,0;70,0;2,0;64,0;80,0;;;;2,0;;16,0;1,0;;;1,0;4,0;1,0;;2,0;6,0;;157,0;2,0;;;3,0;;;;34,0;;22,0;;;3,0;;13,0;18,0;;16,0;1,0;6,0;9,0;243,0;30,0;13,0;;;72,0;;3,0;14,0;328,0;2,0;;8,0;6,0;;108,0;62,0;5,0;;;;5,0;40,0;16,0;;3,0;3,0;;;2,0;1,0;5,0;12,0;;34,0;11,0;;;20,0;18,0;8,0;;3,0;;2,0;8,0;3,0;2,0;;;;14,0;4,0;;;4,0;;5,0;10,0;2,0;5,0;6,0;1,0;1,0;12,0;;;1,0;21,0;1,0;;1,0;1,0;7,0;4,0;;10,0;4,0;;;5,0;3,0;1,0;3,0;4,0;25,0;6,0;;1,0;;;;;;2,0;1,0;5,0;12,0;29,0;89,0;;7,0;;;;;6,0;12,0;2,0;4,0;14,0;2,0;;;5,0;;;;1,0;;4,0;;;;;2,0;;;2,0;;;;3,0;;;;;4,0;;;;;;;;;;;;;;;;;;;;2,0;;16,0;;3,0;;;;1,0;5,0;4,0;;;;;;1,0;;;;27,0;1,0;;;1,0;;;;;;;13,0;;4,0;;2,0;1,0;;1,0;;1,0;;;1,0;;;;1,0;;1,0;4,0;;;1,0;;1,0;;;;5,0;4,0;;;;;;2,0;;;;8,0;;;;;2,0;;1,0;6,0;;1,0;4,0;;1,0;;;;;;;4,0;3,0;1,0;;;;;1,0;;;;3,0;;;;5,0;;1,0;1,0;;2,0;;24,0;28,0;16,0;3,0;17,0;;;;;12,0;1,0;2,0;;2,0;;2,0;5,0;;;;;2,0;;;;;21,0;;1,0;;;10,0;;1,0;5,0;;;;;;;2,0;;;;;17,0;;;2,0;;4,0;;;1,0;;26,0;4,0;6,0;;1,0;4,0;5,0;;;7,0;12,0;;39,0;;;;;;;;;3,0;;3,0;3,0;;;;;;25,0;;;;;;;;;;;;;;;;3,0;;;1,0;;;;8,0;;;;;;4,0;;;;;8,0;6,0;;;;;;;;;4,0;;1,0;;;;;;;;;;;;;;;2,0;;1,0;;;;1,0;;;;5,0;;;;1,0;;;;;2,0;;;;;6,0;1,0;;13,0;;;;20,0;2,0;4,0;2,0;1,0;;;23,0;;;2,0;2,0;168,0;;;;1,0;1,0;;4,0;;;2,0;;;;4,0;2,0;;;;;26,0;;3,0;54,0;;;;3,0;;;11,0;2,0;5,0;;;7,0;31,0;7,0;;;3,0;;;;1,0;9,0;11,0;;4,0;;;20,0;1,0;1,0;;;62,0;2,0;4,0;1,0;1,0;52,0;1,0;;;15,0;;1,0;;;3,0;6,0;5,0;;;;;6,0;;;9,0;;;;;;;;;;;;;;2,0;5,0;;;;;;2,0;;;;;;;;;;;;;;;;;2,0;;;;;;;1,0;;;2,0;;;;;1,0;3,0;2,0;;;;;;;;;;3,0;;;;;;;3,0;;2,0;3,0;;;;;;;;;;;1,0;;;;;;4,0;1,0;;;;;1,0;;;;;;;;;;;;;3,0;;;;;;;;;;3,0;;;;;;1,0;;1,0;;;;;;;;;;;;;;;1,0;;1,0;;;;;;2,0;3,0;;;;;1,0;26,0;;;;;1,0;;2,0;;;;;;;2,0;;;;;4,0;;;;;;;7,0;;;;1,0;;;;;;;;3,0;;;;;;;;;;;;;;;
intersect;;3,0;;1,0;;19,0;8,0;1,0;;;3,0;;1,0;4,0;;;1,0;;;;;;;;;;1,0;13,0;;;12,0;1,0;;;;4,0;15,0;13,0;;;6,0;12,0;;;3,0;7,0;;4,0;;;3,0;;4,0;;10,0;2,0;7,0;;;2,0;;;;;43,0;;3,0;;;4,0;;24,0;32,0;;;;;;;;17,0;;;13,0;3,0;12,0;;81,0;;1,0;;1,0;9,0;;;;4,0;73,0;26,0;98,0;23,0;5,0;6,0;1,0;3,0;6,0;;;1,0;1,0;;1,0;8,0;;;1,0;;17,0;;15,0;;;;;;;1,0;;;1,0;;;;15,0;;;24,0;7,0;;;;1,0;;;4,0;;7,0;3,0;;;;1,0;5,0;1,0;;;;;;;;6,0;;;;;;2,0;;;;;3,0;56,0;;8,0;;;;;;;;5,0;;;2,0;;9,0;3,0;;;5,0;1,0;2,0;4,0;1,0;6,0;;;;6,0;;;;;9,0;;8,0;3,0;1,0;1,0;2,0;;;;7,0;6,0;;28,0;11,0;;;;;;5,0;;;;;2,0;4,0;;1,0;;1,0;;;;;1,0;;;;;;;9,0;1,0;;;;;3,0;;1,0;42,0;;;;;;8,0;12,0;;;;;4,0;;2,0;2,0;;;;;46,0;;;;;130,0;;;;4,0;;1,0;;;;;;;;3,0;;;;;;;;;;;1,0;1,0;15,0;;;;;;;6,0;2,0;;;1,0;17,0;;3,0;;;1,0;;;;;;;2,0;;;;;1,0;;2,0;9,0;4,0;;1,0;;1,0;2,0;;;;;;;;;;3,0;;;2,0;;;;;;;;;;;;;12,0;;;;;2,0;;;8,0;;;;16,0;;;;2,0;;;;1,0;;;;1,0;5,0;;;;;;6,0;25,0;1,0;;4,0;;;2,0;;;;;3,0;;;;;;;;;5,0;;1,0;;;;;;;;;3,0;;;;;;;9,0;;;12,0;4,0;2,0;;;;;;;;;1,0;;;;;;2,0;;;4,0;;;;9,0;;5,0;;8,0;2,0;2,0;;1,0;;3,0;;;2,0;;;3,0;;5,0;1,0;;;1,0;4,0;;1,0;;;;;;;;;1,0;6,0;;;;;;;;;2,0;;1,0;;;;;;;;;;2,0;;;;;;;;16,0;;;;;;;;2,0;3,0;;;;;3,0;;;;;;1,0;;;;;;;;4,0;;;;;;1,0;;;1,0;;1,0;4,0;4,0;;;1,0;;;;7,0;6,0;;5,0;;;;;;;;1,0;;;1,0;;;;;;;;;;;;;3,0;;;;2,0;;;;;;1,0;;;;2,0;;;;;;;;;;;;2,0;;;5,0;;;;;;;;;2,0;;2,0;;;;;;;;;;;;;;;;;;;;;4,0;;1,0;1,0;;;;;8,0;;;;;;;;;;;;;;;;;1,0;;;;;;;;6,0;8,0;;;2,0;;;3,0;;1,0;;;;;;;;;;;;;2,0;1,0;;;;;;;;;;;;;4,0;;;8,0;;;;;;;;;;;;;8,0;;;;;;;;;;;1,0;;;;;;7,0;;;;;;;;;;;;;;;;;;;;;;;;;;2,0;;;;3,0;;;;3,0;;1,0;;;12,0;;;;1,0;;;;;;1,0;;;;;;;;;;;;;;;;;;3,0;;;;;;;;;;;1,0;;;;;;5,0;;;;;;;;;;;;;;;2,0;;3,0;;;;;;2,0;;;;;;;;;;;;;;;;;;;;;;;;;;;;1,0;2,0;6,0;;;;;;;;;;1,0;;;;;;;;;;;;;;;;;;;1,0;;;;1,0;;;;4,0;1,0;;;;;;12,0;;;;;;;;;;;;;;10,0;;;;;2,0;;;;;;;3,0;;;;;;;;;;5,0;;;;4,0;;;;;;
joint;;1,0;1,0;4,0;;17,0;5,0;52,0;;;;;;123,0;;;4,0;;;;2,0;;;;;;;;1,0;1,0;75,0;8,0;;2,0;;;7,0;64,0;;;15,0;52,0;;1,0;2,0;9,0;;36,0;;;;;37,0;3,0;6,0;;17,0;47,0;;;;;7,0;;14,0;1,0;53,0;3,0;;;;10,0;3,0;;;;13,0;99,0;;;25,0;;2,0;19,0;11,0;58,0;;3,0;;2,0;;;11,0;;;;1,0;6,0;5,0;11,0;20,0;2,0;;;;;;;;;1,0;1,0;3,0;;;;;2,0;;9,0;;1,0;;;;;28,0;;;1,0;;;;17,0;;;5,0;1,0;;;;;;;;2,0;1,0;22,0;9,0;30,0;2,0;;19,0;3,0;;;;;;;;75,0;;;;;83,0;3,0;;;;;;23,0;;7,0;;;3,0;;;;1,0;2,0;37,0;;;6,0;13,0;6,0;;;;23,0;12,0;51,0;33,0;;;17,0;;;1,0;;2,0;;60,0;;3,0;87,0;5,0;11,0;2,0;;;2,0;1,0;13,0;;;;;;;14,0;3,0;89,0;2,0;5,0;;;;2,0;;4,0;;;;;;;4,0;7,0;4,0;1,0;4,0;;3,0;29,0;;3,0;;4,0;107,0;8,0;;48,0;90,0;;;;;1,0;;;;;;5,0;13,0;;12,0;4,0;;1,0;;12,0;122,0;6,0;2,0;;;59,0;4,0;;3,0;14,0;8,0;6,0;1,0;;;;4,0;1,0;;2,0;;;16,0;4,0;;12,0;;7,0;;7,0;6,0;;12,0;1,0;1,0;2,0;;14,0;;14,0;11,0;1,0;6,0;;2,0;2,0;4,0;;;3,0;7,0;4,0;;;;;;;;2,0;;;31,0;44,0;2,0;22,0;7,0;1,0;11,0;23,0;12,0;;6,0;;;;;2,0;4,0;;3,0;10,0;;;;1,0;;;5,0;;;2,0;;2,0;12,0;;1,0;;;;8,0;2,0;;4,0;;;;1,0;;;1,0;;;15,0;;1,0;;1,0;5,0;;2,0;2,0;;;;2,0;;;1,0;;;27,0;2,0;;;;7,0;;;;;;;;;;;;33,0;;;;7,0;;;4,0;;;17,0;1,0;;4,0;;;22,0;32,0;11,0;;2,0;;;5,0;;;;;1,0;68,0;;;;;;;4,0;;;;;1,0;;;;;;;;8,0;;;9,0;;;2,0;;1,0;8,0;;;2,0;;;;;2,0;;;;;;;;1,0;;;;;;4,0;;;;;;;1,0;;6,0;;;10,0;;;11,0;3,0;;;;;;;;;12,0;;1,0;2,0;;;;;2,0;3,0;;;1,0;6,0;;;;;;;;1,0;;;;;;8,0;1,0;;1,0;;;;12,0;;3,0;;;;;2,0;;;5,0;1,0;;;1,0;;;;;13,0;;8,0;13,0;;;;;;;;;;;;;3,0;;;;;;;;;;;;;;;1,0;21,0;1,0;;;;;;;;;;2,0;;;;2,0;;;11,0;9,0;;;2,0;3,0;;;;18,0;4,0;;;;;1,0;;;;;;;;;;;;;1,0;;;;;;;;;;;2,0;;;;;;4,0;;;1,0;;;;;;;;;;1,0;;;2,0;1,0;;;;1,0;;;;;14,0;2,0;;2,0;;;;44,0;4,0;2,0;;;;2,0;;;;;;;;8,0;79,0;;;;;;;2,0;10,0;;5,0;8,0;;4,0;;6,0;;2,0;;;1,0;;;;;;1,0;;;;;;;;7,0;;;2,0;;;;;;;1,0;;;;;;;10,0;2,0;7,0;;;;;;;;4,0;;5,0;;;;;;;;;;;;;;;;3,0;;;1,0;;;;;;;;;;;;;;;;;;;;;;;;;2,0;;;;;;;7,0;10,0;;;;2,0;;;;;;;3,0;;41,0;;1,0;;;;;;;;;;;2,0;;;;;;;;;;;;;;;;;1,0;;;;;;;;;;;;;;2,0;;;3,0;;;;;2,0;;;;;2,0;;;;;2,0;;;;;;;;;;;;;;;;7,0;4,0;;;;;;;;;;;;;;;;;;;1,0;4,0;;;;;;;12,0;;;;;;;1,0;;;;;;;;;;;;;;;;;;;;;;;;;;1,0;;3,0;;;;
laser;;3,0;1,0;7,0;6,0;43,0;14,0;8,0;;;;;;15,0;;;13,0;;;8,0;2,0;;6,0;;;;;8,0;5,0;8,0;93,0;23,0;;;;8,0;5,0;5,0;16,0;2,0;31,0;150,0;;;3,0;23,0;;8,0;;;;;10,0;6,0;6,0;6,0;15,0;;23,0;67,0;;3,0;3,0;1,0;89,0;;48,0;6,0;;;28,0;17,0;199,0;1,0;;1,0;;6,0;34,0;1,0;73,0;;16,0;;17,0;;;74,0;2,0;25,0;;;5,0;;;;5,0;7,0;61,0;91,0;20,0;23,0;4,0;30,0;76,0;14,0;1,0;1,0;;;;7,0;3,0;;;;2,0;5,0;4,0;47,0;12,0;;46,0;2,0;4,0;;116,0;;;;20,0;2,0;2,0;58,0;10,0;;9,0;;;;;;;;18,0;1,0;109,0;2,0;2,0;9,0;;;14,0;;;;6,0;;;;2,0;17,0;;;;2,0;13,0;;4,0;7,0;2,0;;34,0;14,0;;2,0;;52,0;14,0;;;;2,0;4,0;;;1,0;;16,0;5,0;;;6,0;2,0;;2,0;16,0;1,0;;;;3,0;9,0;;27,0;4,0;5,0;4,0;42,0;17,0;2,0;;7,0;;;1,0;36,0;2,0;;18,0;12,0;2,0;;;4,0;;93,0;;;1,0;;13,0;21,0;;1,0;;32,0;45,0;;;;1,0;;;4,0;18,0;;7,0;16,0;;;;;13,0;;;;46,0;;;1,0;13,0;2,0;8,0;7,0;;;14,0;;1,0;;;;2,0;;;2,0;15,0;;;1,0;;53,0;;;;5,0;;26,0;;;1,0;;;;;23,0;49,0;;;;;;;;;;23,0;;22,0;;;1,0;;;;7,0;;;;2,0;23,0;3,0;2,0;;;;;18,0;5,0;;;;;3,0;1,0;;;;;13,0;19,0;7,0;;1,0;;4,0;2,0;;;;;;;37,0;;;10,0;3,0;;;;1,0;1,0;2,0;2,0;;3,0;1,0;2,0;;;4,0;4,0;11,0;;9,0;1,0;;;63,0;27,0;10,0;2,0;;4,0;;2,0;;1,0;3,0;1,0;;1,0;2,0;;;12,0;1,0;;;;3,0;1,0;;19,0;;7,0;;;;1,0;;6,0;23,0;2,0;2,0;1,0;1,0;;;3,0;;;2,0;25,0;3,0;5,0;;;5,0;;7,0;;;3,0;;1,0;4,0;;;;6,0;4,0;;1,0;2,0;;1,0;;;1,0;2,0;1,0;;;2,0;11,0;;;2,0;6,0;2,0;;;;;;8,0;;;2,0;;1,0;;;;;;2,0;;;;;1,0;;23,0;1,0;;;;;;64,0;;7,0;;;;;;;;1,0;2,0;15,0;1,0;;;;;3,0;;;;;;;;;3,0;2,0;;;;2,0;;;;;;;;16,0;8,0;;3,0;;;;;;;;;;;;;;;;;;2,0;;;;33,0;;;;4,0;;;;2,0;;1,0;;;;;;3,0;7,0;;;3,0;2,0;;;318,0;;;8,0;;;3,0;2,0;;;2,0;;;;;;4,0;;3,0;;;2,0;;;;40,0;30,0;1,0;;24,0;;;;;;2,0;;1,0;6,0;;13,0;;;;2,0;;;;;;;;;;;;7,0;1,0;;1,0;;6,0;;;;10,0;;;1,0;;;;;3,0;;;4,0;;55,0;2,0;;;3,0;;;;;;97,0;2,0;;;;10,0;;;24,0;;;2,0;;;31,0;1,0;3,0;2,0;;;3,0;;1,0;;;;;1,0;;;161,0;;9,0;20,0;46,0;;;;;8,0;9,0;;;;;39,0;;;;4,0;;;;;;4,0;;4,0;83,0;;;;2,0;5,0;8,0;;;;;;;;;;;1,0;;15,0;1,0;;;;;;;;;;;;;;;;;;2,0;;2,0;;10,0;;11,0;;;;;;;;3,0;;;;;2,0;;1,0;;;;1,0;1,0;;;;1,0;;;1,0;;;;2,0;;;;;4,0;;;;;;;;56,0;;;;;;4,0;;;;;2,0;;4,0;;;;;;;;;;;2,0;;;;;;;5,0;;;4,0;;3,0;2,0;;;1,0;;1,0;;;8,0;3,0;;;2,0;;1,0;;;;;3,0;48,0;;;;;;1,0;;;;;;3,0;;;;2,0;1,0;1,0;;;;;;;;;;;;;;1,0;;;3,0;8,0;1,0;;1,0;;;;1,0;;23,0;;;;;;;;2,0;;16,0;;;;;;;;;;2,0;1,0;;;;;;;;;;;;;;;1,0;;;5,0;;;;14,0;;;;;;6,0;;;6,0;3,0;4,0;2,0;;;;;1,0;;;;;;;;;;;;;;;;;;;24,0;2,0;
layer;;4,0;;9,0;20,0;57,0;32,0;68,0;;;;4,0;2,0;353,0;3,0;1,0;12,0;23,0;2,0;;62,0;1,0;189,0;1,0;2,0;;;34,0;;1,0;115,0;4,0;;;108,0;27,0;32,0;9,0;7,0;92,0;16,0;161,0;5,0;2,0;303,0;398,0;;112,0;;;;2,0;89,0;4,0;47,0;7,0;540,0;6,0;2,0;24,0;143,0;2,0;7,0;5,0;195,0;3,0;434,0;3,0;2,0;3,0;31,0;207,0;345,0;106,0;;;200,0;;;3,0;160,0;7,0;1,0;10,0;136,0;1,0;;88,0;2,0;10,0;38,0;12,0;20,0;8,0;;;71,0;18,0;292,0;8,0;69,0;10,0;7,0;9,0;9,0;6,0;;;2,0;;9,0;;298,0;4,0;;;;4,0;1,0;198,0;;;65,0;13,0;;;33,0;;;80,0;2,0;3,0;56,0;76,0;8,0;;46,0;2,0;5,0;28,0;2,0;23,0;;;39,0;42,0;59,0;176,0;64,0;49,0;;50,0;16,0;52,0;1,0;5,0;3,0;60,0;6,0;56,0;474,0;138,0;;3,0;21,0;2,0;88,0;214,0;1,0;9,0;33,0;;19,0;42,0;;26,0;21,0;18,0;;;4,0;9,0;57,0;89,0;;118,0;188,0;;;48,0;;;16,0;13,0;4,0;156,0;48,0;26,0;54,0;4,0;218,0;;;;;1,0;53,0;362,0;4,0;53,0;2,0;6,0;;30,0;5,0;70,0;30,0;4,0;2,0;8,0;147,0;2,0;;33,0;61,0;22,0;309,0;5,0;6,0;9,0;;184,0;23,0;;46,0;;10,0;39,0;;;61,0;53,0;;;10,0;19,0;15,0;21,0;312,0;;;15,0;102,0;177,0;466,0;5,0;115,0;409,0;21,0;22,0;2,0;36,0;49,0;16,0;7,0;;22,0;11,0;;75,0;21,0;165,0;12,0;3,0;;;;6,0;2,0;2,0;;;4,0;19,0;;;44,0;45,0;77,0;3,0;16,0;1,0;;1,0;2,0;1,0;1,0;5,0;;4,0;;;29,0;;;8,0;1,0;;8,0;85,0;1,0;;14,0;;1,0;;63,0;;;1,0;6,0;7,0;44,0;42,0;20,0;2,0;2,0;;4,0;8,0;;;;33,0;12,0;6,0;7,0;;;;;;;1,0;2,0;3,0;3,0;20,0;1,0;1,0;;1,0;2,0;57,0;;;1,0;27,0;15,0;2,0;5,0;;;;;;;;;;7,0;;;24,0;5,0;;;;;;26,0;3,0;;3,0;6,0;19,0;1,0;13,0;;2,0;2,0;;;5,0;1,0;19,0;2,0;;16,0;;;16,0;12,0;6,0;;24,0;5,0;;;1,0;;37,0;;8,0;5,0;2,0;3,0;;;;;1,0;3,0;;;40,0;;12,0;9,0;1,0;41,0;1,0;;;;;4,0;3,0;6,0;;8,0;23,0;;;;3,0;;;24,0;;;52,0;13,0;;;;;1,0;;1,0;2,0;3,0;2,0;2,0;;2,0;;;;;;4,0;;10,0;52,0;;3,0;15,0;;;2,0;;1,0;11,0;1,0;;1,0;16,0;12,0;;;1,0;3,0;;;37,0;5,0;;;1,0;;1,0;6,0;24,0;;;4,0;;;;;1,0;;;;2,0;;4,0;;49,0;21,0;10,0;;;;;9,0;;5,0;;;1,0;4,0;1,0;;;10,0;;2,0;1,0;;6,0;;127,0;;1,0;;7,0;;;;7,0;;27,0;3,0;15,0;;;;;1,0;3,0;5,0;29,0;;;;;5,0;;;;;104,0;21,0;6,0;1,0;;2,0;14,0;1,0;20,0;9,0;3,0;2,0;4,0;;;3,0;11,0;;;;2,0;1,0;;;3,0;;;;;;12,0;;;;6,0;;32,0;22,0;1,0;;24,0;;;;;;3,0;;;;6,0;;;6,0;;;;2,0;;1,0;2,0;40,0;;;;7,0;1,0;;2,0;9,0;4,0;18,0;4,0;;28,0;3,0;33,0;2,0;7,0;;;;30,0;;;;;;;;1,0;9,0;92,0;;;;;18,0;;1,0;4,0;;;;;2,0;;;3,0;;9,0;;;5,0;19,0;1,0;;2,0;5,0;;;2,0;96,0;2,0;7,0;2,0;;9,0;10,0;;2,0;15,0;3,0;;99,0;;;;;7,0;;11,0;;;;;2,0;;;18,0;;1,0;4,0;;;;1,0;;;22,0;;1,0;;;;;25,0;;;1,0;;;6,0;80,0;33,0;1,0;20,0;1,0;;22,0;;1,0;;;43,0;2,0;;;;;2,0;;;17,0;;1,0;;;;1,0;;;;7,0;;89,0;;;;;2,0;436,0;;;15,0;2,0;1,0;;1,0;;4,0;;34,0;22,0;28,0;;6,0;;6,0;418,0;;4,0;;10,0;;;2,0;1,0;;;5,0;1,0;;333,0;;;;;;;;2,0;17,0;10,0;34,0;;9,0;;87,0;;2,0;;4,0;;6,0;;;42,0;3,0;;;;;1,0;;;;8,0;;4,0;;4,0;;;;1,0;3,0;;2,0;;3,0;;9,0;;;3,0;;;;;;;;;;;1,0;;;;;;;;;;;1,0;18,0;2,0;;;;2,0;;;;;;;;4,0;;361,0;;;1,0;;;;;1,0;;;1,0;;2,0;;;;;;;;;6,0;;;5,0;;8,0;;;;16,0;;;22,0;1,0;;;;34,0;;25,0;;2,0;;1,0;;1,0;;;10,0;;;;;;;28,0;;;;;;;;;10,0;2,0;;;2,0;;;;1,0;;;;;;;;;1,0;;;;3,0;;;;;;
left;;2,0;;2,0;1,0;29,0;38,0;11,0;;;;;;78,0;;;72,0;;38,0;;2,0;;45,0;;;;;14,0;;2,0;23,0;10,0;;;;21,0;17,0;14,0;6,0;;21,0;36,0;;18,0;93,0;12,0;1,0;8,0;;5,0;5,0;;35,0;;16,0;;15,0;;;17,0;;;2,0;;506,0;;82,0;5,0;;2,0;4,0;40,0;10,0;;1,0;;1,0;3,0;;;44,0;;7,0;;20,0;;;27,0;13,0;22,0;7,0;5,0;5,0;;6,0;;66,0;8,0;37,0;44,0;79,0;31,0;;2,0;5,0;12,0;;;;4,0;;13,0;37,0;;;5,0;4,0;18,0;24,0;69,0;1,0;;41,0;;;5,0;30,0;;1,0;;19,0;;;41,0;;;103,0;13,0;4,0;;2,0;10,0;;;11,0;2,0;20,0;9,0;1,0;40,0;;26,0;47,0;82,0;;;6,0;;;;;26,0;;;;;14,0;15,0;;2,0;;11,0;;66,0;;31,0;;1,0;4,0;;;3,0;1,0;125,0;22,0;;13,0;;11,0;66,0;;16,0;2,0;;3,0;7,0;82,0;2,0;9,0;1,0;1,0;1,0;;;1,0;1,0;14,0;1,0;6,0;34,0;17,0;26,0;1,0;6,0;4,0;13,0;;14,0;;;79,0;;3,0;;42,0;;64,0;;;3,0;4,0;8,0;31,0;2,0;61,0;1,0;;;;2,0;;7,0;;1,0;5,0;5,0;1,0;9,0;358,0;;10,0;;;7,0;;2,0;25,0;103,0;1,0;;2,0;8,0;;63,0;79,0;;;4,0;1,0;8,0;;;;;;2,0;2,0;36,0;3,0;2,0;;1,0;8,0;2,0;;;;2,0;4,0;;;3,0;1,0;;;;28,0;1,0;;7,0;3,0;;;;;1,0;2,0;6,0;;30,0;1,0;;1,0;1,0;;6,0;30,0;;2,0;7,0;;16,0;2,0;15,0;;;;;1,0;1,0;2,0;;3,0;5,0;6,0;5,0;;;1,0;2,0;19,0;16,0;17,0;2,0;2,0;1,0;12,0;8,0;1,0;;;;;;7,0;52,0;32,0;43,0;16,0;;2,0;;;1,0;;;7,0;14,0;;;45,0;35,0;9,0;53,0;2,0;;;2,0;13,0;12,0;24,0;4,0;2,0;;;18,0;;7,0;;;3,0;4,0;1,0;6,0;12,0;2,0;4,0;2,0;3,0;;;2,0;;1,0;;12,0;4,0;5,0;3,0;9,0;;5,0;22,0;1,0;3,0;2,0;2,0;;;;;;;5,0;;19,0;1,0;6,0;;;1,0;;1,0;1,0;;;5,0;2,0;3,0;;;1,0;;34,0;;;;2,0;40,0;;;;2,0;1,0;1,0;;;6,0;;;8,0;2,0;;6,0;;;1,0;1,0;;;;2,0;2,0;3,0;;14,0;;1,0;;;3,0;1,0;10,0;;;;3,0;;9,0;;;;;20,0;;;9,0;;2,0;2,0;39,0;4,0;;5,0;2,0;49,0;2,0;4,0;;1,0;4,0;5,0;;;;;;;;9,0;;5,0;;11,0;;;;;3,0;;3,0;11,0;;7,0;41,0;6,0;;1,0;1,0;10,0;;;;29,0;;1,0;;;;;5,0;;;2,0;;;2,0;;5,0;;;1,0;;;;;;;;2,0;;;;11,0;19,0;4,0;;;;;;;;;2,0;;;;;;;;;2,0;1,0;;;5,0;;;;;1,0;21,0;7,0;;2,0;;;;2,0;;2,0;;;;;;;6,0;;;2,0;;;;;;;;;;;2,0;4,0;;1,0;;4,0;;;1,0;9,0;25,0;;11,0;1,0;1,0;;2,0;;1,0;;;2,0;1,0;2,0;;;;;;;;;;1,0;;;;;;9,0;;;3,0;;;8,0;;;;;;;1,0;1,0;;1,0;;;20,0;;;;4,0;2,0;1,0;;;;25,0;3,0;1,0;3,0;;;2,0;;;;;;4,0;1,0;;;4,0;;13,0;;;;;;4,0;43,0;;;;;;6,0;;13,0;;3,0;10,0;24,0;4,0;;7,0;3,0;;;;;;;;;;;;;;;;1,0;9,0;8,0;;;1,0;;3,0;;1,0;;;;1,0;37,0;;2,0;;;3,0;;;5,0;;1,0;;;;1,0;;;;;;2,0;;;;;;6,0;;;;;;;3,0;;;;;;5,0;;1,0;;;1,0;;;;;3,0;;;62,0;2,0;;1,0;;;;;;;;;;;;;7,0;6,0;4,0;;;;;;;2,0;9,0;;;;1,0;;11,0;1,0;;;;4,0;1,0;1,0;;;;;;;;;;;18,0;;;1,0;;;;4,0;;1,0;;;;;3,0;1,0;;;;;;;;;1,0;;;5,0;;;2,0;3,0;4,0;;5,0;;;;25,0;;;7,0;;;;;;2,0;8,0;;;;;;;;;;;1,0;;;;;;12,0;;;;4,0;;;;;1,0;;;2,0;;;;;;;;1,0;2,0;;;;;;1,0;;;;9,0;;2,0;;;;;;;;2,0;;3,0;2,0;5,0;;;;33,0;;;4,0;;2,0;;;;;;
level;;20,0;4,0;68,0;31,0;52,0;38,0;34,0;;9,0;;9,0;;207,0;13,0;126,0;95,0;;5,0;1,0;;4,0;63,0;4,0;17,0;8,0;8,0;22,0;32,0;39,0;163,0;17,0;106,0;6,0;;150,0;17,0;9,0;24,0;;208,0;263,0;;115,0;93,0;12,0;7,0;33,0;;16,0;22,0;;3,0;25,0;10,0;5,0;9,0;;7,0;55,0;;16,0;47,0;3,0;437,0;6,0;141,0;59,0;18,0;;17,0;82,0;200,0;;517,0;41,0;4,0;18,0;60,0;11,0;236,0;;27,0;15,0;85,0;1,0;4,0;31,0;20,0;9,0;30,0;1,0;2,0;71,0;19,0;;209,0;16,0;146,0;83,0;179,0;187,0;;15,0;44,0;72,0;5,0;20,0;5,0;;5,0;57,0;37,0;1,0;;2,0;51,0;23,0;68,0;46,0;31,0;1,0;812,0;4,0;;26,0;104,0;;2,0;;87,0;4,0;;66,0;17,0;5,0;41,0;;214,0;;;12,0;;1,0;2,0;26,0;45,0;3,0;153,0;7,0;1,0;7,0;40,0;2,0;18,0;48,0;;1,0;1,0;;15,0;12,0;5,0;3,0;8,0;;11,0;1,0;27,0;39,0;5,0;2,0;4,0;16,0;;13,0;10,0;4,0;11,0;3,0;6,0;;;7,0;1,0;7,0;25,0;22,0;67,0;;;2,0;4,0;146,0;2,0;;5,0;6,0;1,0;;;6,0;11,0;2,0;64,0;16,0;10,0;;;19,0;5,0;10,0;25,0;;;1,0;272,0;3,0;3,0;23,0;4,0;47,0;1,0;1,0;8,0;1,0;54,0;1,0;1,0;8,0;;19,0;110,0;31,0;2,0;2,0;;;1,0;17,0;;2,0;;;;51,0;7,0;3,0;4,0;;;1,0;1,0;4,0;;28,0;5,0;45,0;;;25,0;15,0;17,0;16,0;1,0;1,0;;;30,0;27,0;;1,0;31,0;1,0;1,0;;20,0;6,0;;;;;12,0;7,0;11,0;;;33,0;104,0;;2,0;4,0;1,0;;;;68,0;10,0;;;2,0;;;;2,0;;2,0;12,0;3,0;45,0;2,0;1,0;;;1,0;;;;;1,0;1,0;85,0;7,0;1,0;;;1,0;3,0;139,0;1,0;;1,0;;1,0;32,0;;3,0;;;1,0;1,0;6,0;2,0;;1,0;3,0;21,0;2,0;;;2,0;;2,0;5,0;2,0;2,0;11,0;26,0;204,0;3,0;4,0;2,0;;;1,0;32,0;9,0;4,0;;;1,0;;125,0;6,0;61,0;10,0;1,0;11,0;141,0;24,0;140,0;1,0;1,0;5,0;17,0;105,0;68,0;64,0;43,0;34,0;45,0;3,0;5,0;46,0;;26,0;;17,0;66,0;3,0;;58,0;12,0;;;18,0;3,0;23,0;94,0;7,0;;;2,0;13,0;81,0;13,0;;6,0;;1,0;;26,0;43,0;9,0;20,0;37,0;4,0;55,0;27,0;1,0;13,0;3,0;42,0;12,0;14,0;;4,0;17,0;32,0;2,0;2,0;29,0;234,0;2,0;22,0;32,0;;;52,0;;;138,0;4,0;9,0;;28,0;13,0;13,0;;;21,0;6,0;;;;23,0;;;4,0;;16,0;11,0;6,0;17,0;;;1,0;5,0;32,0;;1,0;;10,0;8,0;6,0;33,0;31,0;16,0;;2,0;;1,0;20,0;;;;3,0;9,0;;1,0;;6,0;;2,0;;3,0;7,0;;;13,0;32,0;83,0;4,0;;;10,0;;6,0;;2,0;2,0;3,0;5,0;;7,0;;;1,0;;;1,0;41,0;;2,0;14,0;;4,0;;13,0;7,0;2,0;26,0;;1,0;;86,0;;;7,0;13,0;;;;1,0;8,0;8,0;;;;;1,0;10,0;7,0;5,0;3,0;;6,0;;46,0;;29,0;;4,0;60,0;3,0;;31,0;12,0;1,0;1,0;16,0;;3,0;1,0;5,0;1,0;16,0;3,0;1,0;15,0;;;1,0;27,0;;1,0;;;3,0;1,0;15,0;;1,0;11,0;3,0;3,0;;1,0;79,0;22,0;5,0;;;7,0;3,0;;2,0;;2,0;1,0;3,0;;26,0;15,0;;1,0;;18,0;2,0;6,0;;8,0;;3,0;17,0;1,0;;1,0;;;;4,0;2,0;23,0;12,0;;4,0;2,0;;;6,0;;3,0;;13,0;7,0;29,0;8,0;11,0;2,0;;9,0;2,0;;;1,0;;2,0;;2,0;86,0;1,0;;6,0;1,0;5,0;1,0;8,0;45,0;2,0;;2,0;1,0;26,0;9,0;38,0;6,0;119,0;;;5,0;4,0;12,0;;;14,0;21,0;2,0;1,0;1,0;3,0;;7,0;56,0;4,0;;;;;7,0;;;3,0;8,0;12,0;28,0;8,0;2,0;11,0;39,0;1,0;5,0;;2,0;1,0;1,0;1,0;1,0;;135,0;;;;16,0;21,0;;;4,0;36,0;1,0;14,0;4,0;;2,0;;13,0;31,0;19,0;3,0;8,0;;;;;;;1,0;;;;;;7,0;;;;;;2,0;;18,0;;4,0;;;;;;2,0;;;;2,0;23,0;;2,0;1,0;1,0;3,0;18,0;48,0;6,0;3,0;7,0;6,0;2,0;1,0;8,0;;;1,0;;;109,0;5,0;7,0;;;;3,0;56,0;;1,0;;10,0;5,0;4,0;3,0;;27,0;14,0;;1,0;14,0;15,0;;3,0;15,0;11,0;;5,0;39,0;1,0;;5,0;7,0;15,0;1,0;54,0;20,0;15,0;;5,0;;22,0;;;;2,0;;5,0;6,0;4,0;3,0;;;;;6,0;1,0;;5,0;;;;;;1,0;4,0;;;2,0;8,0;;;;;8,0;;22,0;;4,0;3,0;;;2,0;;;5,0;;10,0;;9,0;2,0;;3,0;1,0;;2,0;1,0;4,0;;;;;6,0;3,0;38,0;3,0;2,0;2,0;;;4,0;;4,0;;;10,0;;;;1,0;;;;3,0;128,0;1,0;;1,0;;6,0;1,0;;;;7,0;;2,0;;2,0;42,0;;;4,0;;;;6,0;1,0;;;;1,0;;;;;14,0;;19,0;;;;1,0;;;6,0;;2,0;;;;3,0;4,0;9,0;18,0;;;;;6,0;4,0;;3,0;;7,0;18,0;;1,0;;;;2,0;;;3,0;;8,0
limit;;4,0;1,0;21,0;10,0;13,0;8,0;8,0;;;16,0;6,0;4,0;31,0;;2,0;4,0;1,0;2,0;;;;;1,0;10,0;;8,0;;;10,0;61,0;3,0;;5,0;;6,0;6,0;25,0;6,0;2,0;9,0;30,0;;2,0;50,0;5,0;5,0;31,0;1,0;;;;;;2,0;43,0;10,0;15,0;;5,0;;;1,0;;138,0;;23,0;4,0;;8,0;23,0;215,0;9,0;;10,0;;1,0;1,0;;3,0;36,0;;7,0;2,0;21,0;25,0;;45,0;;1,0;5,0;;4,0;;2,0;;8,0;8,0;9,0;7,0;68,0;9,0;;5,0;3,0;11,0;;;4,0;;;;12,0;;;;5,0;2,0;6,0;15,0;;;14,0;20,0;22,0;7,0;160,0;208,0;;6,0;209,0;;;56,0;2,0;;19,0;5,0;180,0;1,0;;;;;31,0;2,0;3,0;5,0;13,0;1,0;7,0;8,0;10,0;;1,0;1,0;;;;;;1,0;2,0;;;;1,0;3,0;2,0;6,0;3,0;2,0;;57,0;;4,0;;;8,0;1,0;;;;1,0;;;13,0;7,0;13,0;9,0;2,0;;;2,0;3,0;2,0;20,0;1,0;1,0;2,0;;;;;1,0;;55,0;;13,0;20,0;1,0;100,0;;;;2,0;;;;4,0;6,0;6,0;;;;;93,0;;1,0;;;6,0;119,0;;1,0;7,0;;2,0;;;;16,0;4,0;;2,0;2,0;4,0;3,0;19,0;;5,0;;;12,0;;4,0;5,0;37,0;2,0;;;2,0;;14,0;4,0;9,0;;15,0;;1,0;;;2,0;2,0;;;9,0;29,0;;;2,0;12,0;29,0;;;;3,0;9,0;;;1,0;10,0;1,0;;1,0;1,0;33,0;5,0;;3,0;;3,0;3,0;;;2,0;;;6,0;12,0;;;;;;;1,0;1,0;1,0;2,0;;9,0;2,0;;;;;1,0;14,0;;1,0;;2,0;1,0;4,0;;4,0;;7,0;;23,0;70,0;10,0;;;;;6,0;;5,0;;1,0;2,0;;5,0;;;67,0;12,0;;;2,0;;;;7,0;;4,0;;;6,0;;3,0;;5,0;;;;3,0;;27,0;;;7,0;;6,0;2,0;6,0;;;20,0;;;43,0;1,0;5,0;11,0;2,0;2,0;;;5,0;;11,0;;2,0;;;7,0;18,0;;13,0;2,0;2,0;19,0;14,0;1,0;1,0;;;;34,0;4,0;5,0;;1,0;1,0;7,0;;3,0;;;31,0;;37,0;;4,0;5,0;;;;;9,0;;3,0;;;13,0;7,0;2,0;;1,0;;1,0;2,0;;;;;;;;;;;;;;;;;;;2,0;4,0;1,0;9,0;5,0;;;2,0;;;18,0;;;8,0;6,0;;;;;;9,0;;;1,0;5,0;;;;;1,0;;1,0;3,0;;1,0;;;1,0;;;;;;;2,0;;;1,0;2,0;;;;1,0;;;;;1,0;3,0;2,0;1,0;;;7,0;;10,0;;;3,0;;3,0;;4,0;1,0;;;;;;3,0;;21,0;1,0;;;;;;;1,0;;1,0;;;;13,0;1,0;1,0;;;4,0;;;;2,0;;;;1,0;8,0;1,0;6,0;;;;;1,0;1,0;;;;4,0;;;;;;;;;8,0;;;;;;;;;;;;;4,0;;;;;;5,0;9,0;;;;;;;1,0;;;5,0;;;;7,0;2,0;;;;;;3,0;;;;;;;;;;7,0;;;3,0;;4,0;;;2,0;5,0;5,0;;;3,0;;;;;;;;;;;5,0;2,0;;;;10,0;;;;;;1,0;19,0;;;;;;;;;;;;;4,0;6,0;;3,0;;;;;;2,0;;4,0;1,0;;;6,0;11,0;2,0;1,0;;1,0;;;1,0;2,0;5,0;;1,0;;;;21,0;;;1,0;1,0;1,0;;;;1,0;;;1,0;;;3,0;;9,0;;1,0;;;;8,0;;;1,0;;;;;;;;;3,0;4,0;;1,0;2,0;;;1,0;;6,0;;3,0;2,0;;;;;;1,0;;;;;1,0;1,0;;;2,0;;;1,0;;;;41,0;;;;;;3,0;;;;;;;;9,0;13,0;;;;9,0;;;2,0;1,0;;1,0;;;;2,0;;16,0;3,0;;;4,0;;;;;;;4,0;;;;;2,0;6,0;;;;;;;;;;;;1,0;;;3,0;;;;;3,0;13,0;10,0;;;;;;;;;2,0;;;;2,0;;;;;3,0;3,0;1,0;1,0;;;7,0;;;;;;;;;;2,0;4,0;1,0;;;;;;;1,0;;;;;1,0;;;;;2,0;4,0;;1,0;;;;;;3,0;;;;1,0;;;2,0;2,0;;4,0;;;8,0;;;;;;;;;;;;;;10,0;;;;;;;;;;;;2,0;;;;;;;;;;;;;;;;;;;;;;;;10,0;
link;;4,0;1,0;1,0;1,0;23,0;26,0;16,0;;1,0;;;;20,0;;;21,0;;10,0;;;;1,0;3,0;109,0;;;3,0;10,0;;51,0;10,0;;1,0;;80,0;9,0;5,0;1,0;1,0;65,0;125,0;1,0;25,0;6,0;3,0;;15,0;;2,0;1,0;;;11,0;4,0;1,0;10,0;;;20,0;;;18,0;;52,0;;48,0;;;;3,0;6,0;1,0;;;;;;;9,0;37,0;1,0;7,0;3,0;35,0;17,0;;5,0;;3,0;1,0;8,0;1,0;7,0;;;5,0;3,0;62,0;12,0;23,0;2,0;;1,0;5,0;35,0;6,0;;;;;1,0;1,0;1,0;;;;51,0;10,0;16,0;;;43,0;2,0;;5,0;85,0;;2,0;;1,0;;6,0;64,0;;;2,0;;;;;;;;3,0;;15,0;9,0;8,0;37,0;2,0;4,0;33,0;;;;;;2,0;3,0;7,0;61,0;11,0;1,0;;;68,0;8,0;;;5,0;;2,0;6,0;;;2,0;;6,0;;;1,0;12,0;3,0;;;1,0;2,0;36,0;2,0;;;;;3,0;1,0;4,0;;3,0;1,0;;15,0;5,0;5,0;;5,0;14,0;3,0;;27,0;1,0;4,0;1,0;;;3,0;7,0;27,0;;27,0;4,0;2,0;1,0;;15,0;;1,0;;;;;3,0;4,0;;;1,0;;;5,0;21,0;;6,0;1,0;;;1,0;1,0;4,0;8,0;2,0;2,0;;;2,0;;3,0;28,0;2,0;;2,0;;17,0;;23,0;;;;;1,0;;;2,0;8,0;7,0;2,0;;2,0;18,0;3,0;6,0;2,0;;15,0;32,0;;;5,0;;3,0;3,0;;;;;;2,0;8,0;1,0;2,0;3,0;1,0;;;;;;3,0;1,0;;50,0;;;;;1,0;6,0;1,0;11,0;7,0;18,0;7,0;7,0;9,0;;;2,0;3,0;;5,0;;;;;2,0;8,0;1,0;;;3,0;;11,0;11,0;;;1,0;3,0;;12,0;1,0;3,0;;;;;13,0;;;6,0;20,0;97,0;;;1,0;;2,0;;;8,0;2,0;;;1,0;3,0;1,0;5,0;;;;;2,0;57,0;11,0;;;;17,0;14,0;;;;;1,0;;;8,0;2,0;;6,0;;;;;2,0;5,0;1,0;16,0;5,0;6,0;7,0;13,0;;1,0;;5,0;7,0;3,0;;;;;;;2,0;;;26,0;6,0;15,0;;;;;5,0;;;2,0;4,0;2,0;;1,0;;;;;;4,0;;;6,0;;;;4,0;1,0;1,0;;;;;;12,0;;;;;10,0;;;;;3,0;2,0;1,0;45,0;;9,0;;;1,0;;1,0;;;;2,0;;6,0;13,0;;;;;;;43,0;;2,0;26,0;;;;21,0;;;;2,0;1,0;;;;4,0;2,0;1,0;;2,0;4,0;;5,0;;;37,0;4,0;1,0;;;;;;;;;;;2,0;;;;;2,0;;2,0;4,0;;9,0;;;;1,0;29,0;;;;1,0;;;6,0;;10,0;1,0;7,0;;2,0;10,0;;;;2,0;;;;;;;;3,0;;;;;7,0;;;6,0;5,0;2,0;;;1,0;15,0;;42,0;;;;;;;;;;;;;3,0;;;;;;2,0;;;;12,0;4,0;1,0;;;;;4,0;;;;1,0;;;;5,0;1,0;;5,0;5,0;19,0;;7,0;;;;;2,0;;;3,0;;6,0;;;3,0;;;;4,0;;2,0;2,0;;3,0;;;;12,0;2,0;;2,0;;5,0;1,0;;2,0;2,0;4,0;1,0;1,0;;;;;19,0;;;1,0;6,0;16,0;24,0;2,0;;;;;;3,0;3,0;;;2,0;;;;;;;;19,0;4,0;;;;;2,0;;1,0;;;;;;2,0;;;3,0;;1,0;5,0;;;31,0;;;;;;;17,0;11,0;2,0;12,0;4,0;3,0;;5,0;;1,0;;;;3,0;1,0;;;4,0;;7,0;;;;;8,0;;;;5,0;;1,0;;;;;;2,0;;1,0;;;;;;;;2,0;1,0;;1,0;3,0;;;;;;;;;;;;;2,0;;;;;;;;;;;;3,0;;;;;;;2,0;;;;;;;;;1,0;3,0;;;;;;;;;;;;;;;1,0;1,0;1,0;;2,0;;;;2,0;;;;;;;2,0;;;;;;;;;;1,0;;;;5,0;;12,0;;;;;;1,0;;;1,0;;1,0;;;3,0;;;;1,0;;;;;;;;;;;14,0;4,0;;;;4,0;6,0;;22,0;;;;;;;;3,0;;;;24,0;;1,0;;;;3,0;;1,0;3,0;1,0;;9,0;2,0;;;;2,0;;10,0;3,0;;;;;;;;2,0;;;;;;6,0;;;;;;;;;;;;9,0;;;;;;;;;;;;;;;;;;;;;;;;;9,0;;;;;;;;
locate;;1,0;;6,0;8,0;106,0;75,0;61,0;;;2,0;2,0;17,0;109,0;20,0;7,0;56,0;19,0;74,0;11,0;13,0;11,0;48,0;4,0;29,0;3,0;5,0;46,0;13,0;3,0;62,0;13,0;1,0;4,0;;77,0;18,0;10,0;18,0;;83,0;231,0;3,0;34,0;103,0;6,0;1,0;159,0;;4,0;;;50,0;27,0;45,0;40,0;60,0;4,0;;23,0;14,0;2,0;50,0;3,0;495,0;6,0;119,0;1,0;3,0;21,0;14,0;454,0;115,0;1,0;2,0;;51,0;3,0;;19,0;137,0;25,0;2,0;;131,0;32,0;;165,0;5,0;5,0;22,0;14,0;22,0;38,0;10,0;2,0;156,0;86,0;176,0;155,0;308,0;91,0;9,0;4,0;26,0;41,0;;3,0;20,0;;;41,0;173,0;;8,0;2,0;4,0;22,0;24,0;237,0;1,0;2,0;47,0;2,0;89,0;4,0;199,0;1,0;7,0;11,0;57,0;;1,0;233,0;2,0;;47,0;38,0;2,0;;1,0;71,0;;;112,0;6,0;181,0;5,0;31,0;15,0;1,0;41,0;129,0;48,0;;;7,0;;;;27,0;42,0;1,0;;28,0;;41,0;47,0;;21,0;10,0;;11,0;57,0;2,0;74,0;3,0;6,0;4,0;;1,0;25,0;5,0;95,0;1,0;8,0;153,0;2,0;72,0;153,0;14,0;1,0;18,0;6,0;36,0;33,0;200,0;4,0;27,0;5,0;14,0;63,0;1,0;1,0;11,0;4,0;113,0;7,0;26,0;94,0;6,0;10,0;10,0;4,0;3,0;60,0;14,0;12,0;2,0;35,0;41,0;;25,0;45,0;31,0;2,0;367,0;1,0;4,0;1,0;10,0;5,0;42,0;4,0;55,0;2,0;1,0;16,0;;5,0;1,0;20,0;;2,0;10,0;30,0;5,0;22,0;481,0;;18,0;9,0;11,0;52,0;79,0;4,0;68,0;317,0;17,0;;7,0;12,0;13,0;194,0;34,0;2,0;;2,0;2,0;50,0;9,0;22,0;11,0;2,0;5,0;1,0;2,0;48,0;12,0;12,0;4,0;16,0;66,0;46,0;8,0;;36,0;15,0;50,0;9,0;44,0;7,0;7,0;6,0;8,0;14,0;188,0;2,0;3,0;10,0;30,0;4,0;14,0;9,0;6,0;38,0;5,0;9,0;2,0;60,0;2,0;1,0;64,0;11,0;30,0;;;14,0;1,0;22,0;35,0;328,0;94,0;21,0;16,0;24,0;2,0;2,0;36,0;9,0;21,0;11,0;4,0;27,0;9,0;13,0;13,0;2,0;17,0;;28,0;27,0;2,0;25,0;4,0;6,0;17,0;59,0;3,0;7,0;1,0;6,0;3,0;1,0;18,0;10,0;4,0;31,0;61,0;11,0;29,0;;;;;1,0;12,0;1,0;1,0;;3,0;;15,0;149,0;1,0;;;;2,0;;37,0;28,0;;2,0;2,0;55,0;7,0;;;9,0;;7,0;18,0;27,0;13,0;1,0;10,0;39,0;9,0;;1,0;10,0;2,0;;2,0;118,0;2,0;29,0;1,0;16,0;;29,0;6,0;2,0;11,0;13,0;3,0;;;;5,0;2,0;2,0;8,0;;63,0;28,0;12,0;;2,0;31,0;1,0;3,0;2,0;3,0;7,0;12,0;35,0;21,0;;9,0;33,0;11,0;9,0;6,0;5,0;4,0;;70,0;2,0;26,0;9,0;11,0;2,0;11,0;18,0;;21,0;3,0;2,0;25,0;1,0;3,0;3,0;;7,0;;;;2,0;3,0;11,0;9,0;27,0;21,0;14,0;7,0;1,0;;1,0;42,0;9,0;21,0;13,0;8,0;17,0;4,0;4,0;9,0;3,0;3,0;7,0;1,0;5,0;15,0;;31,0;5,0;3,0;1,0;1,0;8,0;6,0;10,0;7,0;46,0;4,0;2,0;;;1,0;19,0;13,0;;3,0;7,0;3,0;137,0;23,0;9,0;11,0;27,0;3,0;60,0;3,0;;18,0;5,0;;;35,0;7,0;7,0;16,0;60,0;6,0;9,0;4,0;;2,0;2,0;;11,0;54,0;;15,0;;;8,0;1,0;8,0;1,0;17,0;;;22,0;1,0;6,0;;;4,0;2,0;3,0;6,0;8,0;3,0;10,0;;1,0;;;2,0;;14,0;5,0;3,0;;3,0;4,0;2,0;1,0;5,0;17,0;4,0;1,0;28,0;7,0;7,0;6,0;1,0;4,0;3,0;;;16,0;;3,0;4,0;27,0;3,0;4,0;3,0;;59,0;2,0;8,0;;4,0;;8,0;6,0;;2,0;4,0;4,0;10,0;14,0;;8,0;51,0;;;4,0;34,0;;;6,0;;4,0;3,0;;;;8,0;3,0;;2,0;;14,0;;3,0;3,0;10,0;11,0;;11,0;;6,0;;36,0;;4,0;;12,0;2,0;;8,0;3,0;14,0;1,0;14,0;;8,0;3,0;3,0;;10,0;2,0;2,0;1,0;46,0;16,0;;1,0;1,0;13,0;3,0;4,0;45,0;;;4,0;1,0;;14,0;2,0;;;15,0;;;17,0;1,0;;;39,0;;5,0;;;3,0;6,0;2,0;9,0;33,0;8,0;6,0;32,0;;;5,0;;4,0;;3,0;12,0;;6,0;1,0;8,0;;16,0;5,0;;2,0;;18,0;23,0;2,0;1,0;9,0;;2,0;3,0;56,0;;3,0;30,0;3,0;10,0;7,0;;13,0;9,0;;11,0;;12,0;1,0;;11,0;3,0;14,0;5,0;1,0;4,0;;13,0;10,0;1,0;5,0;3,0;;12,0;2,0;;;;4,0;2,0;5,0;2,0;24,0;4,0;;;;4,0;3,0;4,0;1,0;;8,0;5,0;39,0;;14,0;1,0;7,0;;1,0;;;1,0;;;14,0;;2,0;16,0;;;27,0;7,0;20,0;;;;6,0;;2,0;9,0;1,0;;;1,0;47,0;3,0;8,0;;;2,0;14,0;;18,0;;1,0;5,0;;4,0;;1,0;;2,0;;;1,0;2,0;;;16,0;1,0;4,0;;;;2,0;4,0;1,0;1,0;19,0;3,0;;3,0;;;10,0;1,0;;6,0;;6,0;6,0;4,0;4,0;;14,0;3,0;7,0;7,0;2,0;9,0;;;3,0;;;;1,0;7,0;2,0;1,0;;;;3,0;;1,0;;;2,0;;;;;;;1,0;11,0;;4,0;6,0;;;3,0;;6,0;2,0;6,0;;8,0;;2,0;5,0;;;3,0;;1,0;5,0;;;3,0;;;2,0;;;8,0;;;;1,0;12,0;;3,0;;;;;2,0;4,0;2,0;8,0;;;1,0;6,0;8,0;;2,0;7,0;2,0;3,0;2,0;13,0;;1,0;;2,0;;;2,0;3,0;1,0;;;18,0;;12,0;1,0;12,0;9,0;;;;3,0;4,0;1,0;;39,0;;;;;2,0;1,0;;2,0;;;22,0;;1,0;;;;;;
lock;;9,0;;6,0;3,0;34,0;;65,0;2,0;;;;10,0;23,0;;;3,0;;9,0;;;;;3,0;2,0;;;27,0;1,0;9,0;102,0;22,0;;1,0;;5,0;27,0;2,0;3,0;1,0;4,0;218,0;;2,0;23,0;17,0;;29,0;;;;;39,0;4,0;3,0;4,0;26,0;;2,0;1,0;;;;;17,0;3,0;100,0;;1,0;;4,0;87,0;5,0;;;;2,0;2,0;1,0;3,0;27,0;;62,0;;11,0;51,0;;16,0;2,0;2,0;;11,0;9,0;3,0;7,0;;3,0;7,0;45,0;6,0;187,0;9,0;;3,0;1,0;10,0;;;;;;2,0;;8,0;4,0;;;5,0;;24,0;;;;5,0;;3,0;99,0;;1,0;2,0;;;;31,0;;;;;;;3,0;24,0;2,0;;23,0;4,0;31,0;17,0;10,0;18,0;11,0;28,0;23,0;9,0;;;6,0;;;;;26,0;;;;;54,0;22,0;;2,0;13,0;;2,0;54,0;9,0;3,0;10,0;;14,0;;1,0;;4,0;15,0;10,0;;;10,0;23,0;7,0;;1,0;;10,0;4,0;79,0;48,0;;19,0;25,0;;;1,0;5,0;7,0;;258,0;;5,0;132,0;74,0;35,0;;;;20,0;1,0;4,0;;1,0;;;1,0;;31,0;6,0;173,0;1,0;13,0;3,0;16,0;;10,0;;1,0;;;;2,0;;;51,0;13,0;8,0;;;2,0;11,0;21,0;29,0;23,0;;;29,0;;1,0;32,0;28,0;;;;5,0;;6,0;11,0;;;;;;1,0;3,0;41,0;16,0;25,0;2,0;12,0;21,0;4,0;2,0;4,0;3,0;42,0;1,0;;1,0;;2,0;;;1,0;30,0;;6,0;5,0;5,0;2,0;;4,0;77,0;12,0;;18,0;;13,0;66,0;15,0;13,0;2,0;8,0;12,0;16,0;9,0;23,0;;108,0;14,0;;3,0;127,0;67,0;7,0;8,0;;;12,0;;2,0;4,0;;47,0;1,0;18,0;44,0;;;113,0;;10,0;;25,0;20,0;5,0;31,0;;24,0;6,0;15,0;;10,0;;;;;3,0;13,0;2,0;5,0;3,0;6,0;2,0;;4,0;1,0;;6,0;;;2,0;;2,0;9,0;;6,0;9,0;4,0;;4,0;;;27,0;;;;3,0;31,0;3,0;2,0;;16,0;;1,0;;52,0;;18,0;;3,0;2,0;;;10,0;1,0;;4,0;21,0;;;24,0;1,0;3,0;5,0;;10,0;20,0;23,0;;;;;;;;;1,0;38,0;4,0;3,0;9,0;;1,0;2,0;8,0;3,0;;4,0;4,0;9,0;2,0;;;5,0;;3,0;;3,0;;;36,0;;;3,0;4,0;9,0;7,0;5,0;;1,0;4,0;;9,0;2,0;;;;;;;;;;2,0;8,0;3,0;1,0;11,0;;11,0;;;4,0;;;;5,0;;6,0;6,0;10,0;;;;;1,0;;1,0;43,0;1,0;1,0;;;;;;;2,0;;;1,0;;1,0;;20,0;;;1,0;;7,0;32,0;;36,0;14,0;;;;;19,0;;;;7,0;3,0;2,0;15,0;4,0;2,0;;;12,0;2,0;;;;29,0;;1,0;;5,0;;;;;;;16,0;;;;11,0;;;8,0;5,0;;1,0;;2,0;3,0;3,0;;4,0;4,0;;;11,0;8,0;;;5,0;;3,0;;;;1,0;30,0;6,0;;2,0;1,0;;;;2,0;34,0;;5,0;3,0;;1,0;;;;11,0;;;;1,0;;;2,0;;;;5,0;;;;;;;;;9,0;;;2,0;;;;1,0;;1,0;;;;;1,0;9,0;2,0;2,0;;11,0;10,0;;;;1,0;;;;;;;;4,0;1,0;14,0;;;;;;;1,0;;;;;;2,0;2,0;2,0;11,0;;;;;2,0;;;2,0;1,0;3,0;2,0;3,0;1,0;2,0;;2,0;;34,0;1,0;;1,0;13,0;;;1,0;4,0;;;;10,0;14,0;16,0;52,0;;1,0;;;2,0;2,0;;6,0;;;;4,0;;;;;;;1,0;7,0;;;;;;;;16,0;;2,0;17,0;2,0;2,0;;;;21,0;11,0;;;;;;;;;;;3,0;1,0;4,0;;;2,0;;2,0;;3,0;;1,0;;;16,0;;;42,0;2,0;4,0;;;8,0;;1,0;;;4,0;4,0;;;;3,0;;;3,0;;;;;;;;;;;;;6,0;3,0;;;;;;;;;;;;;;;;3,0;;;;3,0;;;;;;;;;;;;6,0;;;;;2,0;;;;;;;;;;;;;;;;;;;;1,0;2,0;;;;;;;;;;;2,0;;;;;;;;;1,0;;;;;;;;;;;;;;2,0;;1,0;1,0;;;;;;2,0;;;;;;;;;;2,0;10,0;;;8,0;;2,0;4,0;;;;10,0;;;;;1,0;3,0;;;5,0;;15,0;;;;;1,0;4,0;;;;;2,0;;;;10,0;1,0;;;;;;;13,0;;;;;;1,0;;2,0;;;;;;;;;;;;;;;;;;;;;;;;;;;1,0;;;;
logic;;1,0;1,0;5,0;5,0;28,0;6,0;4,0;;;;;;6,0;1,0;;23,0;29,0;1,0;;5,0;;3,0;;9,0;1,0;;48,0;2,0;6,0;149,0;59,0;2,0;6,0;;39,0;14,0;1,0;9,0;;69,0;83,0;;8,0;9,0;3,0;;2,0;1,0;9,0;6,0;;;6,0;1,0;;6,0;;4,0;14,0;;;8,0;24,0;111,0;9,0;58,0;;3,0;;;8,0;3,0;;;;;;2,0;23,0;21,0;;3,0;;36,0;1,0;9,0;1,0;;2,0;5,0;8,0;1,0;;;;38,0;;27,0;2,0;1,0;2,0;;13,0;40,0;38,0;2,0;3,0;;;;8,0;1,0;;;;;2,0;;24,0;3,0;;59,0;;;15,0;26,0;;1,0;;11,0;;;44,0;;;16,0;;1,0;;;;;;;9,0;8,0;6,0;14,0;;1,0;51,0;;;;;;;;;;13,0;;;2,0;;37,0;;;1,0;9,0;;;2,0;;;;;7,0;;;;;3,0;;;4,0;;22,0;1,0;;;12,0;4,0;;;;4,0;;;;;;2,0;;6,0;;;;6,0;;2,0;;;;;30,0;;;2,0;;3,0;;;;;13,0;;;5,0;;7,0;;;;2,0;4,0;4,0;;;;;;;;14,0;2,0;;2,0;;;;1,0;;6,0;4,0;2,0;4,0;1,0;;4,0;13,0;4,0;7,0;;;;;1,0;;;;2,0;4,0;;;;1,0;;29,0;;;1,0;28,0;;;;;90,0;;1,0;;;;;;8,0;19,0;;;;;;;;;;;1,0;2,0;;;;3,0;;;;;2,0;;19,0;7,0;;1,0;;;;;11,0;;;;;;2,0;1,0;1,0;;;;1,0;1,0;;;;;;1,0;;;;;1,0;;2,0;;1,0;;16,0;;;;1,0;;;1,0;1,0;;;;;;9,0;1,0;9,0;2,0;4,0;2,0;5,0;;108,0;2,0;3,0;3,0;;12,0;5,0;;;;1,0;20,0;3,0;1,0;;30,0;;25,0;8,0;;;4,0;15,0;32,0;;9,0;;2,0;11,0;;;1,0;;10,0;44,0;2,0;;;2,0;;;9,0;;13,0;3,0;46,0;;1,0;;;6,0;;1,0;2,0;9,0;;8,0;1,0;4,0;13,0;3,0;;;;;9,0;;;1,0;;;14,0;11,0;;;;;7,0;;8,0;11,0;1,0;3,0;;;11,0;5,0;5,0;;;1,0;3,0;15,0;2,0;;;;1,0;;12,0;;4,0;1,0;4,0;18,0;;18,0;3,0;;4,0;;;;;1,0;;8,0;;1,0;9,0;;3,0;1,0;5,0;;;3,0;;;8,0;1,0;1,0;;;;32,0;;;;;1,0;8,0;2,0;;;2,0;1,0;;;;;2,0;;3,0;;3,0;1,0;;;9,0;;1,0;;;;;;1,0;1,0;;;;6,0;1,0;2,0;3,0;;;;;;1,0;;1,0;8,0;;1,0;1,0;;;;;1,0;;;1,0;;;;;13,0;;4,0;;1,0;2,0;;;9,0;;6,0;6,0;;;;;;1,0;1,0;;3,0;25,0;;20,0;;;;3,0;;34,0;;;;;2,0;;;5,0;;;2,0;;;;;;1,0;;1,0;1,0;;;5,0;1,0;;;25,0;;;;8,0;;;1,0;;;1,0;;;;15,0;;;;6,0;7,0;;;1,0;;;;;;2,0;1,0;;1,0;;27,0;2,0;;;3,0;;2,0;3,0;2,0;3,0;;;;;2,0;;2,0;;;;;2,0;;14,0;1,0;;2,0;;;;;;1,0;1,0;;4,0;;;;;;7,0;;;1,0;1,0;;;;;1,0;;;1,0;;2,0;;;;2,0;;;;;;1,0;;;;1,0;;;;;;;1,0;2,0;;;;;;;;;;;;;;;;;;;;;;;;;;5,0;;;;;;;4,0;;;;;;;;;;;;;5,0;2,0;3,0;;;9,0;;;;;;;;3,0;;1,0;;1,0;13,0;;;;5,0;;1,0;;;;;1,0;;;;;;1,0;;;3,0;;1,0;;;2,0;;;;;;;2,0;;1,0;;2,0;;1,0;;;1,0;;;2,0;3,0;2,0;;;;;;;;;;;4,0;;;3,0;;;;;2,0;;2,0;;;;;;;;;;1,0;;;8,0;4,0;;2,0;;;;1,0;;;;;;;;;;;;;;3,0;;;2,0;;;;;;1,0;;2,0;;;;;1,0;2,0;;;;;;1,0;;;;;;;;1,0;;;;;;;;;;;;2,0;;;;;;1,0;5,0;;;;;;;;;;;;;;;;;;;;1,0;;3,0;;;;;;;;;;;;;;;;
machine;;2,0;;3,0;1,0;19,0;5,0;2,0;;;;;;23,0;;3,0;12,0;1,0;;5,0;;;5,0;;4,0;;;76,0;5,0;11,0;30,0;2,0;;;;20,0;3,0;11,0;16,0;2,0;35,0;57,0;;3,0;23,0;3,0;;11,0;;2,0;4,0;;1,0;;3,0;;7,0;6,0;1,0;9,0;;;2,0;9,0;110,0;;79,0;1,0;;;2,0;8,0;12,0;;;;1,0;17,0;9,0;12,0;80,0;;2,0;9,0;18,0;9,0;2,0;4,0;;4,0;2,0;;1,0;;;1,0;5,0;;15,0;9,0;23,0;19,0;;1,0;15,0;39,0;;15,0;;5,0;;14,0;18,0;;;;;3,0;9,0;12,0;;;6,0;8,0;;31,0;61,0;;5,0;;8,0;;;7,0;;;14,0;3,0;;;;;;;1,0;7,0;3,0;4,0;18,0;9,0;;;12,0;;;;;;;;;3,0;7,0;;;;5,0;13,0;;7,0;7,0;1,0;2,0;;;1,0;;4,0;;;;;;13,0;;;;;2,0;2,0;;4,0;2,0;5,0;15,0;2,0;14,0;;1,0;1,0;;;;11,0;40,0;131,0;13,0;10,0;2,0;10,0;4,0;9,0;;;;5,0;6,0;;;7,0;16,0;4,0;;;18,0;;40,0;;;8,0;;12,0;2,0;;;2,0;;;;3,0;;1,0;2,0;;;7,0;2,0;1,0;;;;;;11,0;;4,0;17,0;22,0;;;;2,0;;2,0;;;;;;;;;;10,0;;;2,0;;2,0;;;;;4,0;10,0;;3,0;;3,0;;1,0;;4,0;;4,0;2,0;7,0;1,0;;1,0;;;4,0;;;;;5,0;13,0;15,0;;3,0;9,0;;;;1,0;;3,0;5,0;9,0;45,0;;1,0;1,0;;;;32,0;1,0;;4,0;;;;;;;;;4,0;;;;;;;9,0;;;2,0;;;;5,0;3,0;;;6,0;;;;2,0;;;;3,0;;18,0;;;;6,0;3,0;2,0;;;;2,0;;44,0;33,0;;;;17,0;2,0;4,0;;;4,0;39,0;3,0;1,0;;3,0;;11,0;13,0;;;4,0;;;3,0;3,0;3,0;5,0;;;;3,0;;;48,0;;;;2,0;;;3,0;;4,0;155,0;22,0;6,0;23,0;;;2,0;;1,0;1,0;22,0;;42,0;3,0;;;6,0;;8,0;;;75,0;;8,0;4,0;;;;5,0;;1,0;;;5,0;2,0;;5,0;1,0;;;;3,0;;2,0;1,0;2,0;12,0;;88,0;6,0;;;2,0;;12,0;;;4,0;;;6,0;;40,0;6,0;;11,0;;3,0;;1,0;;;10,0;;12,0;;;5,0;1,0;1,0;16,0;;11,0;;1,0;;;;1,0;;1,0;;;;;1,0;2,0;;;;;2,0;4,0;;;34,0;;3,0;;;;;;;3,0;2,0;1,0;;2,0;1,0;;5,0;10,0;1,0;6,0;;;;2,0;2,0;1,0;1,0;;;;;;;;3,0;;5,0;5,0;;;;2,0;;;1,0;;;;;;;;;1,0;1,0;11,0;7,0;;;31,0;;;;;;1,0;;9,0;1,0;11,0;;;27,0;;6,0;1,0;2,0;;;;;26,0;;;;;;4,0;;;;;;1,0;8,0;;;;;;1,0;;1,0;;8,0;;;;;;;2,0;;2,0;1,0;;;;;;;;;;;;1,0;3,0;2,0;3,0;;;10,0;1,0;1,0;;;2,0;;;;5,0;;;;1,0;;;1,0;14,0;;;10,0;1,0;;;;2,0;;;;;;;;;;;;;;;;;7,0;;;;;;;;;;;;1,0;;1,0;;;1,0;;17,0;14,0;4,0;;;3,0;2,0;;;;;;4,0;;;;1,0;;;;1,0;;;;;3,0;10,0;;;;;;;;;;;1,0;1,0;;1,0;;;;3,0;2,0;15,0;1,0;1,0;;1,0;;;;1,0;4,0;;;;;;7,0;;;;;;;;;2,0;;;;;;1,0;;;;;6,0;;;;2,0;3,0;;;;;;;4,0;;;;;;3,0;3,0;;;;;2,0;;;;;22,0;;11,0;;7,0;;;;3,0;;;1,0;;;;;1,0;;;1,0;;;;;;;;;;5,0;;;9,0;;;;;;;;;4,0;3,0;1,0;;;1,0;;;;3,0;;;5,0;;;;2,0;2,0;;;;10,0;;;;1,0;;;4,0;;;1,0;;;;;;;;;;;;;;9,0;;;;;;2,0;12,0;;;;;1,0;;;;;;;;;;;;;;;;4,0;;;;67,0;;;;;;;;;;1,0;;;;;;;;9,0;;;;;1,0;;;1,0;;;;1,0;;;3,0;;;;;;;;;;;;;;;;
manner;;1,0;1,0;9,0;1,0;10,0;1,0;6,0;;;1,0;;5,0;25,0;1,0;;9,0;2,0;4,0;;6,0;;5,0;4,0;3,0;1,0;;;;6,0;23,0;6,0;1,0;5,0;;15,0;3,0;;8,0;6,0;23,0;55,0;;7,0;58,0;13,0;;61,0;;;;;18,0;3,0;3,0;1,0;18,0;;;5,0;5,0;1,0;7,0;;103,0;1,0;16,0;1,0;6,0;;;47,0;30,0;1,0;;;7,0;2,0;3,0;5,0;17,0;;4,0;;20,0;24,0;;29,0;2,0;1,0;1,0;4,0;1,0;3,0;10,0;1,0;22,0;1,0;13,0;4,0;41,0;12,0;;5,0;6,0;6,0;;;2,0;;;;1,0;1,0;;;;5,0;;17,0;;;19,0;2,0;1,0;4,0;15,0;;;;27,0;3,0;;25,0;3,0;;2,0;;2,0;;1,0;8,0;;;4,0;6,0;60,0;44,0;1,0;6,0;;2,0;11,0;;1,0;2,0;1,0;1,0;;;4,0;29,0;;;;;21,0;16,0;1,0;6,0;2,0;6,0;12,0;9,0;3,0;;;;5,0;;;;;9,0;4,0;1,0;10,0;5,0;21,0;17,0;;;;5,0;9,0;1,0;21,0;1,0;4,0;3,0;;;1,0;2,0;3,0;1,0;43,0;;;13,0;12,0;28,0;1,0;;;4,0;20,0;4,0;1,0;18,0;3,0;2,0;;1,0;5,0;;31,0;2,0;3,0;3,0;7,0;;8,0;12,0;8,0;1,0;5,0;2,0;;3,0;;11,0;17,0;7,0;5,0;6,0;1,0;;31,0;6,0;3,0;;1,0;3,0;11,0;6,0;45,0;8,0;2,0;;;3,0;;9,0;1,0;3,0;;;;1,0;1,0;10,0;1,0;3,0;;;29,0;3,0;;4,0;5,0;1,0;18,0;11,0;;3,0;10,0;8,0;12,0;3,0;9,0;6,0;;1,0;;;6,0;;3,0;2,0;11,0;;2,0;;;3,0;;5,0;;7,0;1,0;;1,0;;2,0;5,0;1,0;3,0;;3,0;6,0;31,0;3,0;8,0;;3,0;;2,0;5,0;2,0;;;;;;;2,0;;1,0;3,0;15,0;4,0;11,0;2,0;;5,0;1,0;6,0;;;;;;;1,0;3,0;8,0;1,0;22,0;9,0;;;;2,0;2,0;4,0;;2,0;8,0;;1,0;;3,0;1,0;1,0;1,0;;1,0;2,0;;50,0;1,0;;3,0;;1,0;;;;;;;3,0;3,0;2,0;1,0;;;1,0;;;4,0;2,0;;4,0;2,0;2,0;4,0;4,0;5,0;;22,0;;10,0;6,0;3,0;15,0;;;;;5,0;1,0;3,0;;10,0;1,0;4,0;;;4,0;1,0;6,0;1,0;4,0;;;8,0;2,0;;;3,0;;9,0;1,0;;;1,0;5,0;;;;1,0;3,0;2,0;;;4,0;;;;1,0;2,0;;;;;;;;17,0;5,0;;13,0;;1,0;;7,0;2,0;3,0;16,0;;;1,0;;;10,0;;4,0;;;2,0;1,0;;5,0;1,0;29,0;;;;;2,0;;;;3,0;2,0;;;;;;2,0;2,0;2,0;;;6,0;;2,0;6,0;3,0;;2,0;;;;;2,0;;2,0;;5,0;7,0;;;;;6,0;2,0;;1,0;5,0;8,0;;;;;1,0;1,0;;;;;;6,0;5,0;1,0;;;8,0;;3,0;;;;;;1,0;;;;;;3,0;1,0;;;;;3,0;;17,0;1,0;;1,0;12,0;;;;1,0;;;;;;;;2,0;;1,0;;;4,0;;;;1,0;1,0;;;;;3,0;;;;;;;;;2,0;;1,0;;;;;;;;12,0;3,0;3,0;;1,0;2,0;4,0;;3,0;;;;2,0;5,0;1,0;;;;;;;1,0;4,0;1,0;;;;;;;;1,0;9,0;6,0;;;;;3,0;1,0;;;;;;1,0;24,0;;;;;;;1,0;;;2,0;;;;4,0;;13,0;26,0;1,0;4,0;15,0;;;1,0;;5,0;4,0;;;;4,0;;;4,0;1,0;;2,0;5,0;;;1,0;1,0;5,0;;;;;1,0;1,0;3,0;4,0;3,0;;;1,0;;16,0;;;7,0;5,0;1,0;1,0;2,0;3,0;1,0;;1,0;;1,0;3,0;;2,0;;5,0;9,0;;;3,0;5,0;;;1,0;1,0;;;;;;;;;1,0;;1,0;2,0;1,0;;;;7,0;4,0;1,0;;;;2,0;;;1,0;;;;;;;;;;;;;3,0;;;;;;;;;;6,0;1,0;;;;1,0;2,0;1,0;;;;;;;;1,0;;2,0;;;;4,0;;;;1,0;16,0;1,0;;;;3,0;;;;5,0;;4,0;;;;;;1,0;;10,0;3,0;;13,0;;;1,0;;;;1,0;;;8,0;1,0;1,0;;2,0;1,0;;;;4,0;;;2,0;;3,0;;;;;;;;;;1,0;;;;;;;1,0;;;;1,0;;;12,0;;;;;;;4,0;;3,0;1,0;;;;;18,0;;;;;5,0;;;1,0;;;;10,0;1,0;;;;;1,0;;1,0;;;;;6,0;;2,0;;;6,0;1,0;;7,0;;;;;;;1,0;;2,0;;;;;;;1,0;;;;;;;;2,0;3,0;;;;;1,0;3,0;;;;3,0;;1,0;;;;2,0;;;;
maximum;;1,0;5,0;18,0;9,0;13,0;1,0;11,0;4,0;;5,0;4,0;3,0;51,0;;19,0;6,0;;;4,0;;6,0;4,0;;1,0;3,0;;6,0;3,0;19,0;13,0;;1,0;44,0;;36,0;23,0;10,0;41,0;;106,0;55,0;91,0;7,0;17,0;;2,0;19,0;;6,0;7,0;;;15,0;27,0;6,0;4,0;;4,0;16,0;2,0;;5,0;;121,0;4,0;37,0;9,0;;;20,0;68,0;41,0;;1,0;;3,0;13,0;;1,0;48,0;;38,0;2,0;7,0;1,0;;23,0;;4,0;2,0;2,0;3,0;;;;54,0;7,0;8,0;31,0;69,0;32,0;4,0;10,0;11,0;12,0;;1,0;4,0;1,0;;20,0;39,0;1,0;;2,0;21,0;7,0;10,0;32,0;5,0;1,0;9,0;9,0;15,0;1,0;31,0;1,0;3,0;11,0;65,0;1,0;;21,0;1,0;;58,0;;20,0;;;7,0;;;113,0;1,0;29,0;;14,0;;6,0;1,0;9,0;2,0;15,0;1,0;;1,0;4,0;25,0;;15,0;;;;2,0;3,0;2,0;6,0;;5,0;5,0;4,0;13,0;;2,0;;2,0;9,0;;;;;6,0;;1,0;12,0;2,0;20,0;5,0;5,0;;2,0;1,0;1,0;3,0;1,0;4,0;5,0;;;2,0;11,0;;1,0;1,0;4,0;2,0;3,0;5,0;9,0;8,0;19,0;;;73,0;8,0;;;4,0;;7,0;1,0;;1,0;;13,0;;;4,0;;;38,0;15,0;5,0;;;4,0;;6,0;1,0;8,0;;;;31,0;;4,0;13,0;;;;;;;;12,0;14,0;3,0;;4,0;2,0;1,0;;3,0;;;27,0;1,0;3,0;;4,0;6,0;;1,0;;;61,0;2,0;;;;10,0;;5,0;;;1,0;8,0;2,0;2,0;2,0;;;9,0;;103,0;;;;;;;;;1,0;;1,0;66,0;4,0;;;;;13,0;;8,0;;1,0;1,0;;12,0;;6,0;;;1,0;;50,0;;2,0;;;;;;;;;;;21,0;;2,0;;;2,0;7,0;;;;;1,0;1,0;13,0;;;17,0;15,0;;;;;;1,0;9,0;;7,0;;3,0;;;27,0;6,0;8,0;;1,0;;9,0;;29,0;5,0;7,0;;2,0;15,0;6,0;32,0;;3,0;27,0;1,0;13,0;25,0;;12,0;14,0;7,0;10,0;3,0;;7,0;;39,0;;3,0;1,0;1,0;10,0;15,0;;26,0;;;12,0;;;6,0;;;5,0;11,0;22,0;;;7,0;;15,0;6,0;;;;4,0;;48,0;3,0;1,0;4,0;;46,0;17,0;5,0;114,0;2,0;;3,0;;;4,0;3,0;;8,0;4,0;;;;;3,0;;2,0;;1,0;22,0;;;;3,0;;;;;;;;;;4,0;;1,0;;;;;32,0;4,0;10,0;3,0;;;;;;3,0;2,0;4,0;;2,0;;;;3,0;;;;;2,0;5,0;;;;;6,0;;;1,0;;;8,0;;;;;;;3,0;;;;;1,0;;2,0;;;10,0;;7,0;;1,0;10,0;;124,0;;8,0;;1,0;;;;;;;;;22,0;;;3,0;;2,0;;;2,0;;;;;;;1,0;2,0;;;;;2,0;;;;1,0;1,0;;12,0;;;;;3,0;;;;;;3,0;;;;;;;;;;10,0;;8,0;;;14,0;;;2,0;2,0;;3,0;;3,0;;;;;;36,0;;;;;;;;;;;7,0;;1,0;1,0;6,0;1,0;;;;2,0;;5,0;;;;;;;;;;4,0;;;2,0;6,0;;;2,0;;;1,0;;;7,0;;;5,0;;;;;;;;13,0;5,0;;;;1,0;1,0;1,0;1,0;;;;2,0;;4,0;;1,0;2,0;;;;;2,0;;;3,0;5,0;;;1,0;;4,0;;;;;;12,0;;;4,0;;;1,0;;;3,0;;2,0;2,0;3,0;;;;;;8,0;;;;10,0;4,0;;;;15,0;;;;1,0;;;;;;;;;;15,0;;;;;;;;;;;;;11,0;;;;;;;;;;;;;1,0;1,0;2,0;;47,0;1,0;;;;1,0;;;3,0;;;;;;;;23,0;2,0;;4,0;;;15,0;;28,0;;;;;6,0;;;2,0;;;4,0;;;;;;2,0;;;;1,0;;;;;;;;2,0;;;;2,0;;;;;;3,0;;1,0;;;;;;3,0;2,0;;2,0;;2,0;;;;;4,0;;1,0;;16,0;;;;;;;;5,0;;;3,0;3,0;;;;;;;;;4,0;;;1,0;6,0;;;;;;;;;;5,0;3,0;1,0;;;;3,0;2,0;;;;3,0;;8,0;8,0;1,0;;;;4,0;;2,0;14,0;;;;;;;9,0;;;;;1,0;3,0;;1,0;;;6,0;;;;;;;;;;;;2,0;;;4,0;;;;;;;;;;;;4,0;;3,0;;;;;;10,0;;;9,0;;;10,0;2,0;3,0;;;2,0;;;;;1,0;
mechanism;;16,0;1,0;24,0;14,0;71,0;4,0;79,0;;;1,0;1,0;7,0;75,0;;;38,0;;17,0;5,0;;;;6,0;22,0;2,0;25,0;41,0;4,0;2,0;264,0;11,0;18,0;5,0;;15,0;15,0;7,0;;3,0;28,0;191,0;;9,0;46,0;28,0;;36,0;;;;;29,0;33,0;16,0;7,0;18,0;;3,0;13,0;;;6,0;;128,0;;280,0;5,0;1,0;6,0;7,0;197,0;35,0;;2,0;;13,0;3,0;;8,0;59,0;;2,0;6,0;89,0;98,0;;49,0;;3,0;2,0;6,0;1,0;;2,0;1,0;1,0;5,0;50,0;22,0;217,0;5,0;1,0;1,0;2,0;18,0;;3,0;1,0;;;2,0;4,0;10,0;;;3,0;17,0;6,0;39,0;;5,0;25,0;;;5,0;114,0;;4,0;1,0;8,0;;;47,0;5,0;;16,0;;13,0;;1,0;3,0;;;29,0;9,0;5,0;15,0;5,0;56,0;80,0;145,0;103,0;18,0;;7,0;;1,0;1,0;;;65,0;1,0;;1,0;;279,0;19,0;;6,0;15,0;;24,0;36,0;7,0;67,0;9,0;1,0;29,0;2,0;1,0;;4,0;1,0;3,0;;2,0;3,0;30,0;6,0;;;4,0;33,0;19,0;4,0;194,0;;2,0;1,0;;1,0;2,0;13,0;2,0;2,0;116,0;8,0;95,0;308,0;73,0;89,0;24,0;;2,0;8,0;;14,0;1,0;16,0;;2,0;5,0;;60,0;;93,0;1,0;8,0;5,0;2,0;4,0;4,0;4,0;3,0;1,0;5,0;;16,0;;1,0;19,0;49,0;4,0;2,0;19,0;19,0;14,0;16,0;22,0;8,0;;1,0;53,0;;12,0;64,0;55,0;1,0;;3,0;34,0;4,0;13,0;30,0;;2,0;;8,0;11,0;3,0;1,0;13,0;15,0;18,0;10,0;19,0;27,0;;1,0;209,0;19,0;53,0;8,0;;5,0;7,0;3,0;5,0;5,0;10,0;42,0;3,0;1,0;2,0;5,0;18,0;2,0;2,0;53,0;33,0;;1,0;;6,0;8,0;13,0;20,0;13,0;43,0;;4,0;4,0;139,0;7,0;12,0;22,0;127,0;3,0;;4,0;9,0;1,0;1,0;41,0;;1,0;1,0;13,0;2,0;26,0;1,0;5,0;6,0;10,0;;73,0;2,0;1,0;1,0;71,0;73,0;15,0;17,0;2,0;100,0;52,0;10,0;3,0;69,0;;28,0;;1,0;3,0;2,0;8,0;8,0;58,0;7,0;;;1,0;4,0;7,0;80,0;;21,0;5,0;3,0;3,0;1,0;2,0;9,0;11,0;3,0;2,0;7,0;2,0;;109,0;4,0;;6,0;;17,0;;1,0;3,0;2,0;7,0;2,0;1,0;19,0;6,0;9,0;;;12,0;;;56,0;;1,0;2,0;2,0;1,0;7,0;32,0;45,0;6,0;55,0;;8,0;20,0;6,0;2,0;1,0;;;;1,0;;3,0;;42,0;8,0;13,0;4,0;4,0;17,0;2,0;13,0;2,0;5,0;11,0;2,0;3,0;23,0;;7,0;2,0;5,0;29,0;;2,0;;1,0;24,0;;;6,0;31,0;11,0;6,0;5,0;;1,0;2,0;1,0;2,0;1,0;;6,0;4,0;;;;13,0;2,0;9,0;;10,0;13,0;1,0;6,0;;18,0;;5,0;17,0;;4,0;9,0;9,0;43,0;18,0;16,0;4,0;;1,0;;4,0;7,0;1,0;12,0;7,0;3,0;;28,0;1,0;;;;;33,0;;14,0;1,0;;2,0;;5,0;;;1,0;2,0;33,0;1,0;;39,0;10,0;1,0;2,0;;;8,0;13,0;12,0;;20,0;1,0;6,0;15,0;7,0;1,0;;;22,0;;;;;37,0;;1,0;;;;;;7,0;;;;;;;5,0;;2,0;4,0;1,0;;;;1,0;1,0;1,0;3,0;;12,0;;10,0;12,0;21,0;;27,0;;;;4,0;4,0;3,0;10,0;11,0;99,0;1,0;;2,0;1,0;;;1,0;2,0;;;;2,0;;;;;9,0;4,0;;;2,0;;6,0;;;;;;42,0;;1,0;;;;;;2,0;;;;;;4,0;13,0;;3,0;33,0;;;;12,0;5,0;;;;1,0;6,0;6,0;2,0;;1,0;;3,0;;;;;;6,0;;3,0;6,0;4,0;2,0;;;;40,0;2,0;;1,0;4,0;;9,0;;2,0;;;;;11,0;1,0;;2,0;2,0;;20,0;8,0;56,0;1,0;;9,0;22,0;;21,0;1,0;;;13,0;1,0;7,0;6,0;5,0;;1,0;;202,0;55,0;13,0;116,0;10,0;;1,0;2,0;1,0;;;5,0;;;5,0;3,0;1,0;;;;;;1,0;33,0;2,0;;;;;;;18,0;;3,0;11,0;6,0;1,0;;7,0;;11,0;6,0;2,0;7,0;2,0;;;7,0;;;;4,0;;9,0;10,0;4,0;;2,0;3,0;4,0;;11,0;1,0;;;10,0;1,0;2,0;6,0;;4,0;;;1,0;;2,0;2,0;;;1,0;;;;;1,0;;;;;6,0;;;;2,0;;2,0;;;2,0;2,0;4,0;;;;;;;;;;;16,0;;2,0;11,0;;;1,0;;;;4,0;;2,0;;1,0;;;;;;;;23,0;3,0;;;;;;;;;;2,0;2,0;;1,0;;1,0;;;;3,0;;;2,0;4,0;;2,0;;;;;2,0;;;;;;11,0;;;;;;;1,0;;6,0;;;;;;;;;1,0;1,0;;;;;;;;5,0;23,0;;;;1,0;;;8,0;;;;;;;;26,0;;;3,0;1,0;1,0;10,0;;;;20,0;;4,0;;1,0;2,0;12,0;7,0;;9,0;;4,0;;1,0;5,0;;;3,0;;;;;;;;2,0;;;;;;;;1,0;12,0;1,0;;;;;;;;;;;4,0;1,0;;;;;;;;;;;;;1,0;;;;;;2,0;;;;;;;
medium;;1,0;;17,0;17,0;43,0;19,0;;1,0;5,0;;1,0;;34,0;;2,0;74,0;;;;;;27,0;6,0;24,0;3,0;4,0;7,0;1151,0;24,0;112,0;5,0;2,0;7,0;;170,0;9,0;2,0;20,0;1,0;148,0;202,0;;38,0;112,0;12,0;2,0;14,0;;2,0;26,0;5,0;1,0;6,0;11,0;1,0;8,0;;7,0;34,0;;;15,0;4,0;450,0;;240,0;6,0;3,0;;2,0;28,0;46,0;4,0;2,0;2,0;9,0;6,0;18,0;64,0;84,0;2,0;13,0;25,0;22,0;1,0;2,0;54,0;;2,0;31,0;;;;3,0;;18,0;5,0;94,0;28,0;62,0;18,0;3,0;19,0;91,0;230,0;6,0;506,0;7,0;2,0;;27,0;17,0;3,0;14,0;;3,0;13,0;14,0;64,0;14,0;;37,0;22,0;;603,0;96,0;;6,0;4,0;43,0;4,0;;19,0;1,0;;18,0;9,0;22,0;1,0;;1,0;;;;14,0;16,0;;19,0;;7,0;6,0;2,0;;1,0;;;;1,0;;;3,0;16,0;5,0;;5,0;34,0;1,0;;10,0;10,0;1,0;13,0;11,0;;20,0;;1,0;12,0;;;;2,0;9,0;;;7,0;;40,0;;1,0;;1,0;2,0;2,0;;5,0;3,0;;;;1,0;;1,0;9,0;;11,0;;14,0;4,0;;6,0;4,0;;;1,0;11,0;;;7,0;14,0;11,0;3,0;;;;43,0;1,0;;5,0;;1,0;24,0;13,0;2,0;;4,0;10,0;;7,0;;;2,0;;;42,0;;4,0;8,0;1,0;;;1,0;5,0;1,0;4,0;8,0;13,0;;;4,0;18,0;7,0;22,0;4,0;1,0;1,0;6,0;10,0;2,0;3,0;;;6,0;;;2,0;18,0;;5,0;;3,0;9,0;2,0;4,0;;1,0;3,0;6,0;;;1,0;;;7,0;1,0;17,0;1,0;1,0;;;;;2,0;;;;3,0;1,0;22,0;;;;;1,0;;4,0;;1,0;2,0;33,0;41,0;1,0;9,0;4,0;;;;8,0;3,0;;;;;262,0;;;;1,0;;4,0;9,0;3,0;;;;11,0;9,0;;;2,0;;;;24,0;1,0;4,0;;79,0;4,0;7,0;2,0;1,0;9,0;1,0;9,0;10,0;2,0;;2,0;4,0;1,0;14,0;5,0;9,0;1,0;;13,0;9,0;3,0;93,0;6,0;1,0;25,0;;43,0;11,0;8,0;2,0;13,0;2,0;301,0;8,0;8,0;2,0;15,0;;40,0;10,0;3,0;;15,0;1,0;16,0;4,0;14,0;10,0;8,0;21,0;2,0;;5,0;;10,0;78,0;12,0;;;;1,0;1,0;5,0;1,0;5,0;1017,0;61,0;14,0;28,0;2,0;1,0;4,0;;25,0;1,0;7,0;3,0;1374,0;7,0;5,0;4,0;2,0;3,0;34,0;4,0;;1633,0;5,0;10,0;44,0;;1,0;;12,0;;;3,0;;48,0;4,0;1,0;63,0;8,0;1,0;1,0;;37,0;9,0;35,0;1,0;10,0;3,0;3,0;845,0;50,0;2,0;;4,0;5,0;6,0;131,0;1,0;2,0;1,0;12,0;14,0;4,0;56,0;7,0;;10,0;;;;3,0;2,0;;13,0;1,0;19,0;;;21,0;100,0;14,0;5,0;5,0;;1,0;;3,0;2,0;2,0;;4,0;6,0;4,0;;;;;5,0;;1,0;1,0;6,0;1,0;;;1,0;;;13,0;;;6,0;4,0;10,0;3,0;6,0;13,0;5,0;;;;;14,0;;;2,0;3,0;;;13,0;2,0;11,0;6,0;;9,0;;;;7,0;2,0;2,0;8,0;2,0;11,0;1,0;5,0;1,0;1,0;;;1,0;1,0;13,0;;3,0;;1,0;2,0;;3,0;;8,0;;;2,0;125,0;3,0;14,0;6,0;3,0;2,0;;4,0;2,0;;10,0;5,0;10,0;117,0;;25,0;5,0;43,0;2,0;6,0;5,0;;12,0;1,0;2,0;;;;5,0;2,0;10,0;;1,0;1,0;1,0;6,0;35,0;1,0;;5,0;;1,0;;1,0;;40,0;3,0;;;1,0;1,0;1,0;2,0;5,0;2,0;;;8,0;2,0;;10,0;;;1,0;2,0;1,0;3,0;2,0;1,0;1,0;13,0;;;2,0;2,0;5,0;6,0;;1,0;;;1,0;21,0;1,0;2,0;4,0;23,0;2,0;1,0;6,0;25,0;1,0;2,0;;1,0;9,0;5,0;3,0;2,0;;;1,0;;;4,0;1,0;;3,0;1,0;2,0;2,0;;;;2,0;15,0;3,0;;;;;5,0;1,0;;1,0;1,0;;5,0;;;4,0;1,0;4,0;;;2,0;3,0;1,0;;;2,0;3,0;;;;1,0;6,0;6,0;;;9,0;;1,0;;1,0;2,0;;;4,0;1,0;;;;;;;;;2,0;;;;;;;;;;;2,0;6,0;;1,0;1,0;3,0;;;;5,0;;;;1,0;;;8,0;;;;;;4,0;;;2,0;1,0;;1,0;4,0;2,0;3,0;4,0;;;;17,0;;4,0;;4,0;5,0;4,0;;;2,0;;;5,0;2,0;;2,0;3,0;;1,0;1,0;6,0;;3,0;;11,0;1,0;;;;4,0;;;1,0;2,0;2,0;;;;;;6,0;1,0;4,0;3,0;1,0;3,0;;2,0;10,0;;3,0;2,0;;1,0;4,0;3,0;1,0;;5,0;;2,0;36,0;1,0;3,0;10,0;;;;;3,0;5,0;1,0;;;5,0;11,0;;;1,0;;4,0;;2,0;;;1,0;3,0;1,0;9,0;2,0;1,0;;;;3,0;;;13,0;9,0;1,0;;6,0;;;1,0;;;;;;;;;;;;3,0;2,0;;;1,0;1,0;2,0;2,0;4,0;1,0;1,0;1,0;;;2,0;;;;;;;;;12,0;;;;;6,0;;;4,0;;;1,0;;1,0;1,0;;;1,0;;;;;;;6,0;2,0;;;2,0;1,0;;;6,0;;1,0;1,0;;;;2,0;;2,0;1,0;1,0;2,0;1,0;4,0;;4,0;2,0;;1,0;1,0;;;;;4,0
member;;29,0;;67,0;60,0;263,0;23,0;653,0;6,0;;7,0;3,0;128,0;1622,0;;;51,0;1,0;17,0;;22,0;1,0;3,0;4,0;23,0;3,0;33,0;31,0;;51,0;569,0;30,0;3,0;2,0;6,0;11,0;199,0;37,0;6,0;2,0;54,0;698,0;47,0;7,0;97,0;736,0;;141,0;;4,0;;;354,0;22,0;18,0;10,0;457,0;;1,0;69,0;11,0;;35,0;1,0;276,0;;1025,0;10,0;2,0;173,0;37,0;1151,0;270,0;14,0;2,0;;83,0;20,0;;30,0;167,0;8,0;15,0;;629,0;513,0;;340,0;2,0;9,0;4,0;17,0;64,0;45,0;4,0;;22,0;94,0;438,0;75,0;1038,0;38,0;2,0;23,0;38,0;10,0;;1,0;4,0;;;15,0;144,0;17,0;7,0;;;44,0;;239,0;2,0;19,0;27,0;16,0;;17,0;176,0;;3,0;42,0;66,0;2,0;30,0;396,0;2,0;8,0;70,0;;1,0;22,0;45,0;43,0;2,0;;150,0;41,0;49,0;250,0;18,0;319,0;210,0;95,0;247,0;115,0;7,0;4,0;35,0;72,0;1,0;4,0;298,0;646,0;1,0;4,0;3,0;1,0;717,0;475,0;2,0;54,0;17,0;;21,0;427,0;14,0;106,0;46,0;31,0;53,0;4,0;;1,0;31,0;180,0;32,0;56,0;39,0;157,0;281,0;411,0;;8,0;106,0;350,0;523,0;197,0;1099,0;13,0;169,0;37,0;61,0;53,0;55,0;4,0;7,0;11,0;;70,0;287,0;990,0;271,0;302,0;13,0;4,0;23,0;214,0;31,0;56,0;10,0;28,0;59,0;5,0;4,0;10,0;371,0;2,0;1205,0;10,0;46,0;2,0;49,0;59,0;30,0;12,0;275,0;3,0;11,0;6,0;40,0;13,0;9,0;114,0;425,0;69,0;172,0;27,0;60,0;192,0;1294,0;170,0;65,0;31,0;8,0;168,0;102,0;30,0;1732,0;1186,0;63,0;;20,0;45,0;6,0;41,0;118,0;10,0;1,0;;25,0;46,0;53,0;195,0;90,0;41,0;7,0;;84,0;57,0;60,0;35,0;100,0;17,0;363,0;190,0;;6,0;32,0;63,0;189,0;14,0;255,0;5,0;12,0;111,0;7,0;67,0;55,0;38,0;912,0;269,0;249,0;24,0;97,0;2,0;37,0;136,0;31,0;31,0;3,0;110,0;17,0;12,0;68,0;24,0;14,0;14,0;113,0;258,0;43,0;116,0;17,0;40,0;155,0;32,0;4,0;46,0;23,0;5,0;70,0;20,0;98,0;30,0;87,0;87,0;10,0;24,0;28,0;58,0;87,0;7,0;373,0;342,0;238,0;106,0;9,0;173,0;13,0;133,0;;514,0;2,0;24,0;;6,0;22,0;12,0;54,0;629,0;16,0;;3,0;1,0;;6,0;1,0;93,0;;4,0;;17,0;20,0;21,0;5,0;77,0;37,0;5,0;2,0;5,0;4,0;;256,0;3,0;3,0;8,0;11,0;48,0;4,0;3,0;;;1,0;35,0;;130,0;3,0;26,0;;2,0;15,0;3,0;2,0;1,0;8,0;10,0;21,0;21,0;4,0;4,0;18,0;61,0;32,0;521,0;;85,0;537,0;30,0;6,0;2,0;7,0;;;2,0;2,0;;;146,0;4,0;30,0;;13,0;37,0;;19,0;1,0;24,0;82,0;9,0;36,0;58,0;;4,0;62,0;6,0;44,0;;;10,0;;31,0;;;5,0;1,0;35,0;86,0;1,0;;31,0;6,0;7,0;1,0;11,0;;3,0;;;;11,0;;3,0;;21,0;;20,0;70,0;60,0;5,0;14,0;;13,0;233,0;13,0;7,0;12,0;7,0;120,0;27,0;3,0;6,0;3,0;2,0;2,0;1,0;101,0;8,0;4,0;14,0;6,0;;36,0;;;30,0;39,0;;28,0;2,0;;;;3,0;;14,0;;;4,0;30,0;58,0;5,0;3,0;104,0;86,0;;81,0;;;14,0;1,0;8,0;;66,0;;44,0;191,0;19,0;;9,0;5,0;27,0;12,0;;;3,0;204,0;;;;9,0;25,0;;3,0;39,0;;;6,0;1,0;;4,0;7,0;;11,0;14,0;11,0;6,0;3,0;;;6,0;19,0;1,0;;17,0;;80,0;80,0;77,0;;1,0;29,0;1,0;5,0;;12,0;10,0;20,0;52,0;550,0;;2,0;8,0;;;;2,0;1,0;;;6,0;;10,0;;;;8,0;7,0;;;3,0;;;6,0;2,0;;44,0;4,0;44,0;;8,0;1,0;4,0;2,0;;1,0;;;;9,0;;;;5,0;1,0;6,0;;6,0;;;22,0;54,0;4,0;4,0;4,0;16,0;25,0;;5,0;;22,0;;17,0;;;;1,0;25,0;40,0;6,0;8,0;7,0;14,0;;2,0;;;28,0;9,0;12,0;10,0;19,0;2,0;33,0;;75,0;7,0;1,0;1,0;;;88,0;;;9,0;;49,0;1,0;;2,0;;37,0;8,0;3,0;230,0;;16,0;25,0;352,0;4,0;26,0;65,0;126,0;;28,0;20,0;492,0;440,0;175,0;124,0;19,0;6,0;;9,0;3,0;26,0;;49,0;8,0;38,0;30,0;15,0;4,0;;5,0;30,0;1,0;2,0;19,0;62,0;16,0;;;1,0;1,0;;13,0;219,0;2,0;57,0;97,0;14,0;8,0;3,0;32,0;8,0;128,0;2,0;12,0;14,0;1,0;1,0;7,0;82,0;223,0;57,0;12,0;11,0;11,0;1,0;6,0;18,0;;54,0;6,0;5,0;24,0;17,0;7,0;18,0;16,0;11,0;6,0;1,0;78,0;18,0;38,0;2,0;;21,0;5,0;201,0;5,0;4,0;;11,0;8,0;135,0;2,0;55,0;19,0;;;;7,0;3,0;;;3,0;8,0;20,0;;;5,0;;1,0;14,0;8,0;;;;;;;;;;10,0;;19,0;5,0;;;4,0;;;;3,0;3,0;20,0;37,0;;10,0;;;;;;6,0;1,0;4,0;6,0;;51,0;41,0;;;;;;;;;17,0;;;;1,0;2,0;1,0;;;;;4,0;6,0;;;;4,0;11,0;1,0;1,0;;;10,0;5,0;4,0;1,0;2,0;;;1,0;7,0;3,0;;;;;1,0;;;1,0;;33,0;;;;;8,0;;2,0;;2,0;3,0;1,0;;;;34,0;;27,0;;;;;;1,0;2,0;2,0;;;17,0;;12,0;31,0;;;;10,0;1,0;;;;6,0;33,0;46,0;;3,0;2,0;30,0;;8,0;122,0;;37,0;2,0;1,0;5,0;1,0;6,0;8,0;;4,0;43,0;2,0;10,0;;;;;;;56,0;;;34,0;;2,0;1,0;23,0;2,0;;2,0;6,0;7,0;;;;1,0;;;;;;;;;;;;;1,0;1,0;;;3,0;;;;1,0;;
message;;4,0;;;;11,0;;1,0;;;;;;26,0;;;5,0;;;;;;17,0;11,0;16,0;;;;17,0;1,0;27,0;9,0;;;;66,0;7,0;1,0;;;55,0;105,0;;6,0;77,0;;;;;12,0;;;;8,0;;;3,0;;;25,0;;;;;60,0;1,0;84,0;;;;1,0;2,0;1,0;;;;;;8,0;2,0;49,0;;3,0;1,0;5,0;;;3,0;;;6,0;;4,0;2,0;;;1,0;;9,0;7,0;25,0;4,0;;10,0;1,0;26,0;;2,0;;;;2,0;;;;;;;1,0;1,0;;;8,0;4,0;;6,0;46,0;;;;9,0;;;12,0;;;5,0;;4,0;;;;;;;;5,0;;3,0;;;2,0;;;3,0;1,0;;;;;;;8,0;;;;;;;3,0;3,0;;;3,0;;;;;8,0;;;;;5,0;;;;;2,0;;;;;;;;;;;;;;2,0;1,0;;4,0;;;3,0;1,0;7,0;3,0;;;;;23,0;;;;1,0;;3,0;;;;8,0;;;;;;2,0;2,0;3,0;1,0;;;;;;;;;;10,0;;4,0;;;;;;;;1,0;1,0;;;;12,0;79,0;;11,0;;;;;;2,0;;;;4,0;;;;1,0;;;;;;;;;;;2,0;;;3,0;;;;;;6,0;;;;;;;;;;1,0;;7,0;;;;;;;;;5,0;;2,0;24,0;;;1,0;;;;1,0;;;;;;9,0;;;;;;;;;;;;;;;;;;;;4,0;;;;131,0;13,0;;;;1,0;;2,0;1,0;;;2,0;;;;;1,0;;;7,0;;;72,0;;;;;10,0;5,0;;4,0;9,0;;1,0;;;;2,0;;7,0;60,0;10,0;;5,0;;1,0;;8,0;5,0;3,0;1,0;1,0;;2,0;;1,0;5,0;4,0;;;;;;;;;10,0;85,0;18,0;27,0;14,0;;;21,0;8,0;1,0;1,0;;11,0;;;;;;;2,0;1,0;4,0;;;68,0;;;;;;;3,0;2,0;;;3,0;13,0;;;3,0;3,0;;;;1,0;;16,0;2,0;11,0;4,0;;;;3,0;;1,0;;;3,0;2,0;1,0;9,0;8,0;;1,0;;1,0;;;;5,0;;11,0;1,0;1,0;;1,0;9,0;;;;;;1,0;;;47,0;;6,0;;;1,0;;3,0;;;7,0;;;;;;;;;1,0;;;;;1,0;;;;;;;;;5,0;4,0;13,0;2,0;;2,0;;;;6,0;;64,0;7,0;;;;;;9,0;6,0;;;;;2,0;;;;;9,0;;;;;;;;;;;;;;;6,0;;;2,0;1,0;;;;;2,0;1,0;;4,0;5,0;;;;;5,0;;;;;2,0;;4,0;;2,0;;;;5,0;;3,0;5,0;;;2,0;;;;;10,0;;1,0;;14,0;;1,0;;2,0;;;11,0;;;;;;17,0;;10,0;;;4,0;1,0;3,0;;;;;;;;76,0;24,0;;;;2,0;5,0;;3,0;7,0;14,0;1,0;6,0;;;;;9,0;;;;5,0;1,0;3,0;3,0;;;;;;;;;;5,0;;;;;;;;;;;;;;;;;;;;;;1,0;2,0;;;;;12,0;;;;;;;;;;;;3,0;1,0;;1,0;;4,0;3,0;;;;3,0;;1,0;;;;;;;;;;;;;;;;;;;;;;;;1,0;;;;;;4,0;;;;;;;;;;;;;;;;;;;;;2,0;;;;;2,0;;;;;;;;;;;;;;3,0;5,0;;;;;2,0;;;;;;;2,0;;;;4,0;;;;;;;;;;;;;;;;;;;;;;;;;;;;;;5,0;;4,0;;;;;;;;;;;;1,0;;;;2,0;;;;;;;;3,0;;;;2,0;4,0;1,0;;1,0;;2,0;;;;28,0;;;;;;;;;;;;;;;;;;;;;;;;;;;;;;;;;;;;;;;;;;;;;;;;;;;;;;;;;;;;;2,0;;;;;;;;;;;;;;;1,0;;;;1,0;;;;;;;4,0;;;;;;;;
metal;;3,0;;;;27,0;16,0;31,0;;;;1,0;13,0;111,0;;;9,0;;2,0;1,0;;;;4,0;1,0;;2,0;60,0;;;6,0;;;;;;2,0;;;1,0;1,0;50,0;;;9,0;58,0;;34,0;;;;;27,0;2,0;4,0;;146,0;;;2,0;;;1,0;;33,0;1,0;118,0;;;1,0;13,0;40,0;16,0;;;;59,0;;;4,0;45,0;;;;55,0;1,0;;;;;1,0;1,0;6,0;;;;6,0;;28,0;20,0;24,0;6,0;;7,0;;6,0;;;7,0;;;6,0;77,0;3,0;;;;;1,0;27,0;;;15,0;1,0;;;3,0;;;12,0;;1,0;8,0;25,0;;;1,0;;;2,0;;7,0;;;2,0;3,0;6,0;34,0;1,0;28,0;;10,0;35,0;13,0;;;;5,0;10,0;36,0;31,0;35,0;1,0;;3,0;;16,0;38,0;;5,0;18,0;;4,0;3,0;3,0;4,0;;;;;;;9,0;17,0;;27,0;4,0;;26,0;10,0;;;13,0;3,0;24,0;11,0;56,0;8,0;1,0;2,0;17,0;362,0;;;;;70,0;;12,0;49,0;;;2,0;1,0;;12,0;;6,0;2,0;;25,0;;;9,0;169,0;2,0;144,0;3,0;;2,0;8,0;;5,0;1,0;5,0;;1,0;8,0;;3,0;2,0;6,0;;;;5,0;5,0;11,0;34,0;1,0;3,0;11,0;15,0;29,0;42,0;;64,0;107,0;1,0;4,0;2,0;5,0;;1,0;9,0;;6,0;5,0;2,0;;;28,0;3,0;2,0;;;;2,0;1,0;1,0;3,0;;1,0;24,0;;;11,0;3,0;18,0;;3,0;1,0;;1,0;11,0;1,0;2,0;;5,0;5,0;4,0;;7,0;1,0;;7,0;;5,0;5,0;9,0;1,0;;9,0;4,0;1,0;;7,0;;;8,0;6,0;1,0;9,0;;1,0;2,0;;6,0;2,0;7,0;2,0;;1,0;4,0;;4,0;;3,0;;;;;1,0;3,0;2,0;2,0;1,0;4,0;;11,0;;;;3,0;1,0;;;13,0;3,0;2,0;;;;;;;;;;;12,0;;;4,0;;;;;;;15,0;1,0;;;;7,0;;;;;;;;;;4,0;;;;;;;;;;4,0;;;;;;37,0;;4,0;1,0;1,0;1,0;;;;;;;;;6,0;;;;1,0;2,0;;;;;;;1,0;2,0;;;10,0;;;3,0;;;;;;;;;1,0;4,0;1,0;;;34,0;2,0;;3,0;;;;;;;;;;;;2,0;2,0;;4,0;3,0;;10,0;8,0;5,0;;;;1,0;2,0;;;;;;;;3,0;1,0;1,0;;;;;;;;;;;;;;;;1,0;1,0;;3,0;;4,0;;10,0;7,0;8,0;1,0;1,0;;;1,0;2,0;;;;;2,0;14,0;;;5,0;;;;;;;33,0;;1,0;;3,0;;;;;;;;2,0;;;;;;;1,0;;;;1,0;;;;;;;4,0;2,0;;;;;14,0;;14,0;2,0;20,0;1,0;2,0;;;;;;;;;;;;;;;;;;1,0;2,0;;;;;6,0;;;;15,0;;;;;;3,0;;;;;;;;;;;;;;;1,0;;;;3,0;;;;14,0;5,0;;;;3,0;;;4,0;;;;;1,0;;;2,0;;;;;;;2,0;;;3,0;2,0;1,0;;2,0;;;;;2,0;1,0;;;12,0;;;;;;1,0;4,0;;;2,0;;;;21,0;;6,0;;;3,0;;3,0;;2,0;2,0;;3,0;;;;;4,0;;1,0;;;;;2,0;;;13,0;;;;;;;;;;4,0;;1,0;;1,0;1,0;1,0;6,0;;2,0;;8,0;;;;;;;;;3,0;;11,0;1,0;;;2,0;1,0;1,0;4,0;;2,0;;;3,0;;;2,0;;;;;;;9,0;3,0;29,0;;;;;4,0;;;;1,0;;;;;;;;;8,0;;;;;;20,0;;;;;;1,0;;;;;;;;50,0;;;;;;;;;7,0;1,0;1,0;;1,0;;1,0;;;;;;;;;;;;;;;;;;;2,0;;;;;;1,0;;;2,0;;;1,0;;;;;;1,0;;;;;;4,0;;;;;;;;;;;;;;;;;4,0;1,0;;;;;3,0;2,0;;;;;;;;2,0;;;;;;;2,0;;;;;;1,0;;;;;;;;;;;;;;;;3,0;;;;;10,0;;;3,0;;11,0;;13,0;;;;;;;;;;;;;;;;;;;;;;;;;;;;;;;;;;;;;;;;;;;;;;;;;;;;
middle;;12,0;;27,0;;8,0;17,0;2,0;;;;;;12,0;;20,0;3,0;;3,0;;2,0;;7,0;;;;;1,0;;2,0;4,0;;;;;13,0;6,0;1,0;;;3,0;8,0;;;11,0;10,0;;30,0;;;;;3,0;;;2,0;2,0;;;2,0;;;1,0;;36,0;;15,0;1,0;8,0;3,0;2,0;4,0;10,0;;;;1,0;;;;7,0;;;4,0;3,0;4,0;;5,0;;1,0;;4,0;1,0;;;;27,0;;2,0;15,0;32,0;1,0;;;;;;;;;;6,0;4,0;;;;;8,0;2,0;3,0;;;10,0;4,0;;;14,0;;;4,0;;;;22,0;;;;;1,0;;;3,0;;;;;5,0;7,0;;4,0;;20,0;11,0;13,0;;;;;;;;7,0;;;;;7,0;1,0;;;5,0;;;1,0;;9,0;;;;;;;4,0;1,0;;;13,0;;3,0;4,0;;10,0;;9,0;1,0;4,0;10,0;;6,0;;;;1,0;;;;5,0;;5,0;10,0;3,0;;;;;2,0;;1,0;;;1,0;;;;3,0;;74,0;;;;1,0;;7,0;8,0;1,0;1,0;1,0;;;5,0;;;;1,0;;;;;3,0;;;;;2,0;4,0;;19,0;11,0;;;;;;2,0;3,0;;;1,0;;1,0;;;3,0;;;;2,0;4,0;1,0;8,0;;;4,0;1,0;;;;;2,0;;3,0;;;;4,0;7,0;10,0;;;1,0;;;;;;;14,0;;2,0;5,0;8,0;;;6,0;;;16,0;;;;;14,0;8,0;2,0;;;;1,0;1,0;;1,0;7,0;;1,0;;8,0;;;;;;1,0;1,0;1,0;3,0;;11,0;6,0;;;;;;;;;;14,0;6,0;;;;;;;;;;;;;;;2,0;1,0;;;;;;5,0;;;;;;;;3,0;;;;;1,0;;;;1,0;;;;;;5,0;;1,0;1,0;;;;;1,0;;;2,0;;;;;;;;2,0;;;6,0;;;;;;;;;;;;;;;;;;3,0;;;;;1,0;;;17,0;;;;;;;;;3,0;;;;1,0;;;;;;;;;3,0;4,0;;;;;;6,0;;;;;;;;;;;;;;;;;;;;;;;;;3,0;;;;;;;;;;;;1,0;;;;4,0;;;;;;;;;;;1,0;1,0;7,0;;4,0;;;;;;1,0;4,0;;;;;;;;;;;;1,0;;;;;;;10,0;;;;;;;;;1,0;;;;;;;;;;;;;;;2,0;;;;;;;;;;;;;;;;;3,0;;2,0;21,0;;16,0;4,0;1,0;;;;;2,0;;;;;;;;;;;;;;;;;;;;;8,0;;;;;;;;;;;;;;;;;;;;;;5,0;;;;;;1,0;;;;;;;;;;;;;;;;;;;;;;;;;;;1,0;;;;;;;;;;;;;4,0;;;;;2,0;;4,0;;;;11,0;;;;1,0;;;;;;1,0;4,0;;;;;;;;1,0;;;;3,0;;;;1,0;;;;;1,0;;;;;;;;;;;;;;;;;;;;;;;;;;1,0;;;;4,0;8,0;;1,0;;;1,0;10,0;;;;;;;;1,0;;;;;;;;1,0;;;14,0;;;;;1,0;;;;;;1,0;;;;;;;;;;;;;;;;;;;;;;;;;;;;;;;;;;;;;;;;;;;;;;;;;;;;;;;;;;;2,0;;;;;;;;1,0;;;;;;;;;;;;;;;;;;;;;;;;;;;1,0;;;;;42,0;;;;;;;;;;;;;;;;;;1,0;;;;;;;;;;;;;;;;;;;;;;;;;;;;;;;;;;;;;;;;;;;;;;;;;;;;;;;;;;;;;;;;;;;;
minimum;;1,0;1,0;1,0;5,0;13,0;3,0;5,0;;;2,0;;;23,0;;2,0;5,0;;2,0;1,0;;3,0;4,0;;;;;11,0;3,0;1,0;5,0;2,0;;42,0;;12,0;8,0;3,0;22,0;;47,0;46,0;28,0;;7,0;;;4,0;;10,0;1,0;;;1,0;6,0;9,0;;;12,0;3,0;1,0;;4,0;;28,0;;2,0;3,0;;;70,0;18,0;20,0;;;2,0;6,0;18,0;1,0;1,0;60,0;1,0;5,0;;3,0;;;4,0;;;3,0;;1,0;;3,0;;20,0;;3,0;28,0;15,0;25,0;;5,0;2,0;3,0;2,0;3,0;;;;3,0;14,0;;;;2,0;1,0;9,0;5,0;;;11,0;12,0;;3,0;14,0;;2,0;1,0;29,0;1,0;;6,0;1,0;3,0;8,0;;8,0;;;2,0;;;49,0;;8,0;;6,0;;3,0;4,0;8,0;;13,0;2,0;;;;;1,0;1,0;;;;;;;;4,0;2,0;7,0;;13,0;;9,0;;3,0;3,0;;;;;14,0;;;7,0;1,0;23,0;3,0;10,0;;;;4,0;;7,0;;47,0;;;6,0;3,0;;2,0;;;;2,0;3,0;6,0;3,0;;;;19,0;3,0;;;1,0;1,0;8,0;1,0;;;;27,0;;;;;;19,0;4,0;;;;;;9,0;;52,0;;;;29,0;;;2,0;;;;;;;1,0;;3,0;;;2,0;;;2,0;;;;4,0;4,0;3,0;;;1,0;;;;1,0;15,0;;2,0;;;;;4,0;;;4,0;1,0;;;2,0;;;;1,0;65,0;;;;;;;11,0;;1,0;;;5,0;2,0;;;;3,0;;;;;1,0;;1,0;10,0;3,0;;1,0;;2,0;;10,0;6,0;;;;;1,0;;2,0;;;;3,0;1,0;;;1,0;;;;;;;;;;4,0;;;;4,0;1,0;;;;1,0;;2,0;;2,0;;4,0;;;9,0;4,0;8,0;;;1,0;9,0;;22,0;6,0;;2,0;;35,0;;19,0;;1,0;12,0;1,0;;13,0;1,0;14,0;;4,0;3,0;1,0;;10,0;;26,0;;11,0;;;14,0;8,0;;7,0;;2,0;9,0;;;3,0;;;4,0;3,0;20,0;;1,0;7,0;;6,0;;1,0;1,0;;7,0;;17,0;3,0;1,0;3,0;;42,0;5,0;2,0;87,0;;3,0;4,0;6,0;;4,0;;;8,0;1,0;3,0;;;4,0;;;5,0;3,0;;1,0;;;;;;;;;;;;;;;4,0;1,0;;;;;4,0;2,0;;;5,0;;6,0;;;;;;;2,0;1,0;;;;;;;9,0;10,0;1,0;;1,0;;;5,0;;;;;;2,0;;;;;;;2,0;;1,0;;;;;2,0;;1,0;4,0;;3,0;;5,0;2,0;;;4,0;57,0;;;;;;;;;1,0;;;;;;;;4,0;3,0;1,0;9,0;1,0;2,0;4,0;;;;;;;13,0;20,0;;2,0;;;;2,0;;1,0;;1,0;;;3,0;;6,0;;;1,0;4,0;2,0;;;;;;5,0;;;4,0;;2,0;;;2,0;;;;4,0;1,0;;;;;;;1,0;;1,0;3,0;;;;;;;;;;;;;;8,0;1,0;;;;2,0;;;;;;;;;;;;;;1,0;2,0;7,0;1,0;;;;;3,0;;;;;;1,0;;;;;;;;3,0;;;;;;;1,0;;;;;;;3,0;;;1,0;;2,0;;;1,0;;;4,0;2,0;;;;;2,0;;;;;;;;;;124,0;;;1,0;;1,0;;;;;;;;;;4,0;;;;2,0;;;;;;;2,0;;;;;;;;;;;;18,0;;;;;;;;;;;;;3,0;;;;;;;;;;;;;;;;;74,0;2,0;;;;;;;9,0;;;;;;;;16,0;;2,0;;;;;;;;;;5,0;7,0;;;8,0;;;;;;;;4,0;1,0;;;;1,0;;4,0;1,0;;;10,0;;1,0;;;;;;;;1,0;;;1,0;;;4,0;;3,0;;2,0;;2,0;;;;;;10,0;;;;;;6,0;3,0;;;;;;3,0;;;1,0;;;;2,0;;;1,0;;;;;;;;;1,0;;;;;;;;13,0;3,0;;1,0;;;;2,0;;;;;;;;;;;;;1,0;3,0;4,0;1,0;;;;1,0;1,0;;;;;;;;;;;;;;;;;;;;;;;;;2,0;;;4,0;;;;;;;;;6,0;;;;1,0;;;;;;;;;;;;;;;;;;;;;;;;
mirror;;1,0;;109,0;7,0;53,0;72,0;238,0;1,0;;;4,0;2,0;92,0;;1,0;56,0;;2,0;;1,0;;1,0;7,0;26,0;2,0;5,0;23,0;7,0;6,0;186,0;18,0;9,0;2,0;3,0;18,0;21,0;20,0;1,0;1,0;77,0;184,0;;15,0;59,0;84,0;;97,0;;;;4,0;36,0;12,0;65,0;15,0;46,0;;;14,0;2,0;;6,0;;266,0;2,0;194,0;2,0;3,0;;10,0;70,0;252,0;3,0;9,0;2,0;2,0;6,0;11,0;4,0;78,0;;37,0;;107,0;269,0;;221,0;3,0;6,0;;22,0;35,0;17,0;47,0;;2,0;45,0;161,0;66,0;567,0;4,0;28,0;6,0;17,0;23,0;;2,0;6,0;;;21,0;40,0;3,0;;;;13,0;12,0;100,0;;;13,0;3,0;6,0;5,0;270,0;2,0;6,0;;28,0;1,0;4,0;56,0;5,0;1,0;120,0;4,0;2,0;21,0;15,0;5,0;1,0;;27,0;2,0;18,0;62,0;5,0;81,0;5,0;25,0;35,0;13,0;2,0;22,0;6,0;6,0;;;;50,0;;1,0;;;28,0;21,0;;2,0;10,0;;74,0;60,0;1,0;1,0;;17,0;16,0;;;23,0;;46,0;;;10,0;28,0;89,0;31,0;;;;97,0;131,0;8,0;90,0;36,0;4,0;13,0;;4,0;13,0;;8,0;14,0;287,0;12,0;;274,0;35,0;8,0;2,0;2,0;;10,0;3,0;28,0;5,0;90,0;7,0;40,0;;;15,0;;278,0;1,0;6,0;11,0;2,0;2,0;9,0;1,0;41,0;1,0;166,0;87,0;;14,0;10,0;;38,0;6,0;;11,0;1,0;34,0;180,0;1,0;5,0;;;21,0;;23,0;201,0;247,0;1,0;;1,0;64,0;5,0;167,0;26,0;;;15,0;1,0;8,0;18,0;3,0;19,0;5,0;3,0;;32,0;76,0;4,0;12,0;57,0;;98,0;6,0;;6,0;3,0;47,0;51,0;6,0;;14,0;;;;1,0;4,0;13,0;;14,0;;;7,0;;;;22,0;91,0;;29,0;7,0;;10,0;;6,0;;26,0;5,0;;95,0;22,0;47,0;31,0;11,0;15,0;;10,0;;57,0;;1,0;;;5,0;13,0;5,0;2,0;;1,0;;165,0;55,0;19,0;;5,0;6,0;;13,0;6,0;10,0;;;1,0;;15,0;;4,0;5,0;47,0;28,0;;;6,0;1,0;;21,0;;47,0;;1,0;;;3,0;28,0;12,0;19,0;30,0;18,0;;;88,0;10,0;;1,0;;28,0;;;1,0;;;2,0;;2,0;5,0;2,0;14,0;5,0;15,0;;;5,0;42,0;;13,0;8,0;1,0;14,0;5,0;14,0;114,0;13,0;;9,0;5,0;31,0;2,0;;;;;;1,0;;;52,0;5,0;5,0;2,0;2,0;10,0;;1,0;1,0;1,0;6,0;4,0;8,0;35,0;;;;2,0;23,0;;1,0;;5,0;8,0;40,0;;;4,0;15,0;1,0;1,0;2,0;40,0;;27,0;6,0;5,0;;;268,0;;;;;;;;6,0;6,0;64,0;3,0;42,0;;;2,0;8,0;;1,0;18,0;1,0;1,0;10,0;1,0;9,0;84,0;;;;33,0;3,0;139,0;4,0;;;;2,0;13,0;;4,0;7,0;17,0;3,0;;;;3,0;7,0;3,0;;;3,0;;;;;9,0;1,0;;;;;;;;;3,0;;1,0;11,0;22,0;;;1,0;1,0;;;2,0;1,0;14,0;;24,0;;;1,0;;3,0;;1,0;;;;;;;;;1,0;6,0;;;;1,0;;8,0;1,0;;1,0;;;1,0;;2,0;;7,0;1,0;2,0;7,0;58,0;3,0;;7,0;;;;8,0;;;;;1,0;;;13,0;7,0;;;2,0;;2,0;;8,0;1,0;2,0;4,0;10,0;;1,0;1,0;;1,0;15,0;;;1,0;6,0;;;;;;;8,0;;;;2,0;;;1,0;1,0;;;;1,0;3,0;;;2,0;2,0;1,0;9,0;;1,0;;;;;1,0;;;;;;2,0;;5,0;;4,0;;4,0;;;;;;19,0;25,0;19,0;4,0;;;;;3,0;;;;;12,0;;;;;12,0;;1,0;24,0;;;1,0;31,0;;2,0;;;;;3,0;38,0;7,0;13,0;1,0;28,0;;2,0;1,0;;8,0;;20,0;41,0;2,0;7,0;;3,0;3,0;5,0;6,0;;;8,0;50,0;;;;114,0;;5,0;;32,0;;2,0;6,0;;8,0;1,0;5,0;;;;60,0;41,0;8,0;1,0;;;;;1,0;;116,0;1,0;;5,0;6,0;6,0;20,0;2,0;4,0;1,0;;1,0;;6,0;;;37,0;20,0;115,0;;12,0;4,0;;;24,0;;;;;11,0;;15,0;;;;31,0;;;5,0;;4,0;1,0;;;;;;;28,0;;;;1,0;;;;7,0;;;;;;;;;;8,0;;;;;;;;;;13,0;;;;;;2,0;;;22,0;;;;;;;2,0;;1,0;1,0;5,0;10,0;;;;2,0;;;;;7,0;5,0;1,0;;5,0;;10,0;;;;;;;8,0;;;2,0;;3,0;;;;;;;;;1,0;;;1,0;3,0;1,0;;;4,0;;;;;15,0;;;1,0;;;;4,0;11,0;4,0;;8,0;;;;;9,0;;;;5,0;;;;;;;4,0;;;;;6,0;;;;2,0;;1,0;;;;;;;;4,0;;;;;;15,0;;;;1,0;;;;;2,0;;;;;6,0;2,0;;;;4,0;;;;;;2,0;;;;;1,0;1,0;;8,0;1,0;;;;18,0;;;;;;;;
mobile;;24,0;;26,0;1,0;134,0;6,0;23,0;1,0;12,0;2,0;;6,0;170,0;;15,0;215,0;3,0;14,0;4,0;3,0;;2,0;22,0;137,0;5,0;1,0;17,0;115,0;18,0;199,0;53,0;1,0;4,0;;215,0;18,0;10,0;72,0;6,0;239,0;3635,0;;31,0;353,0;48,0;;34,0;;3,0;57,0;17,0;4,0;47,0;93,0;3,0;13,0;1,0;5,0;51,0;1,0;;18,0;20,0;558,0;16,0;200,0;4,0;2,0;;20,0;129,0;65,0;;;;;7,0;39,0;27,0;361,0;;94,0;7,0;113,0;7,0;1,0;68,0;3,0;4,0;15,0;7,0;1,0;16,0;20,0;;4,0;1,0;100,0;33,0;231,0;27,0;3,0;21,0;60,0;216,0;14,0;42,0;;;;4,0;3,0;11,0;6,0;1,0;10,0;3,0;16,0;168,0;33,0;1,0;120,0;19,0;;45,0;342,0;21,0;;2,0;43,0;5,0;;144,0;;;49,0;4,0;9,0;;2,0;11,0;;;8,0;16,0;40,0;6,0;50,0;31,0;;3,0;46,0;2,0;;9,0;;;1,0;;1,0;51,0;13,0;1,0;;;46,0;42,0;2,0;10,0;4,0;1,0;28,0;63,0;;44,0;;3,0;41,0;;2,0;5,0;10,0;46,0;;2,0;7,0;2,0;50,0;75,0;2,0;;;10,0;6,0;5,0;82,0;2,0;8,0;12,0;;6,0;;2,0;14,0;33,0;17,0;6,0;22,0;60,0;55,0;127,0;5,0;;2,0;13,0;21,0;3,0;1,0;5,0;38,0;9,0;4,0;;;;41,0;1,0;1,0;4,0;1,0;4,0;15,0;1,0;22,0;12,0;2,0;;7,0;10,0;;4,0;1,0;5,0;;70,0;11,0;11,0;56,0;8,0;;;;4,0;;4,0;20,0;120,0;18,0;;9,0;94,0;27,0;54,0;1,0;;;2,0;3,0;14,0;;1,0;19,0;28,0;27,0;;35,0;60,0;;;21,0;6,0;23,0;14,0;;1,0;12,0;90,0;12,0;;11,0;2,0;;;2,0;1,0;60,0;5,0;1,0;8,0;;;3,0;;;2,0;5,0;7,0;8,0;35,0;;;7,0;;;;35,0;67,0;6,0;4,0;;55,0;10,0;;1,0;6,0;;6,0;34,0;5,0;;;;3,0;26,0;3,0;5,0;;7,0;1,0;8,0;39,0;2,0;2,0;;16,0;;16,0;;1,0;;5,0;;1,0;77,0;;37,0;6,0;71,0;45,0;;15,0;15,0;13,0;2,0;1,0;;18,0;;12,0;1,0;;14,0;11,0;45,0;7,0;4,0;28,0;8,0;;185,0;17,0;1,0;8,0;8,0;92,0;13,0;2,0;1,0;20,0;1,0;75,0;9,0;9,0;;29,0;;56,0;19,0;8,0;7,0;81,0;46,0;1,0;;139,0;6,0;21,0;59,0;3,0;4,0;29,0;;46,0;40,0;123,0;15,0;3,0;;2,0;;7,0;;46,0;2,0;185,0;93,0;55,0;22,0;1,0;21,0;7,0;8,0;2,0;21,0;7,0;23,0;31,0;16,0;7,0;3,0;733,0;2,0;6,0;;49,0;;;445,0;8,0;;;38,0;9,0;16,0;4,0;4,0;3,0;6,0;10,0;422,0;2,0;1,0;4,0;;;14,0;9,0;;;13,0;5,0;70,0;104,0;1,0;;2,0;7,0;19,0;9,0;9,0;6,0;5,0;18,0;9,0;2,0;48,0;11,0;12,0;20,0;2,0;10,0;7,0;1,0;6,0;6,0;100,0;;37,0;4,0;;14,0;3,0;16,0;;;1,0;3,0;2,0;16,0;11,0;9,0;11,0;2,0;1,0;4,0;1,0;26,0;6,0;;9,0;18,0;2,0;22,0;;;7,0;;;3,0;;25,0;2,0;3,0;2,0;56,0;9,0;3,0;26,0;16,0;4,0;1,0;;2,0;1,0;29,0;1,0;;;28,0;;3,0;39,0;8,0;56,0;22,0;;;;;10,0;73,0;4,0;;12,0;;13,0;;12,0;5,0;18,0;3,0;3,0;;12,0;9,0;;5,0;;9,0;2,0;1,0;;5,0;13,0;2,0;7,0;10,0;10,0;3,0;118,0;12,0;;3,0;1,0;;1,0;16,0;27,0;4,0;;7,0;;25,0;20,0;11,0;3,0;17,0;6,0;;3,0;2,0;1,0;;57,0;;7,0;1,0;;2,0;8,0;5,0;4,0;3,0;8,0;;1,0;;5,0;2,0;1,0;3,0;22,0;39,0;2,0;2,0;1,0;1,0;3,0;;237,0;6,0;;61,0;;10,0;;34,0;2,0;14,0;;9,0;6,0;1,0;;8,0;2,0;15,0;2,0;;2,0;21,0;46,0;28,0;10,0;1,0;1,0;;;19,0;30,0;12,0;25,0;8,0;1,0;1,0;3,0;;3,0;;;;2,0;7,0;19,0;29,0;5,0;2,0;7,0;;5,0;10,0;5,0;3,0;2,0;7,0;;3,0;14,0;12,0;;;1,0;1,0;8,0;2,0;;21,0;4,0;4,0;;;7,0;2,0;13,0;6,0;3,0;16,0;;;2,0;;;9,0;13,0;;;;;1,0;;;;11,0;33,0;2,0;1,0;1,0;2,0;3,0;23,0;2,0;9,0;;;3,0;13,0;8,0;6,0;2,0;;1,0;16,0;;;;2,0;;;;14,0;;;;3,0;1,0;1,0;;1,0;2,0;21,0;3,0;1,0;3,0;;;;;;3,0;;;;2,0;1,0;5,0;6,0;2,0;;;4,0;2,0;1,0;1,0;2,0;;4,0;3,0;21,0;;;;;18,0;;;;1,0;3,0;1,0;;;;;2,0;5,0;2,0;;;;4,0;;1,0;;2,0;3,0;;1,0;1,0;;;1,0;;;1,0;;;;;;1,0;2,0;;;1,0;16,0;;1,0;3,0;2,0;1,0;3,0;;;;1,0;;8,0;;;;14,0;1,0;6,0;;;1,0;1,0;;7,0;1,0;;6,0;4,0;3,0;;;2,0;1,0;;11,0;1,0;2,0;1,0;;5,0;;5,0;;;4,0;8,0;1,0;;3,0;5,0;3,0;;6,0;9,0;3,0;99,0;1,0;2,0;19,0;3,0;;1,0;2,0;;;7,0;;;;;;;2,0;4,0;4,0;;;;;1,0;23,0;;;;;2,0;;;4,0;;;;;;;1,0;;6,0;;;;;;7,0;4,0;6,0;;1,0;4,0;;;6,0;;;;;;;;;;;;;7,0;;2,0;;;2,0;3,0;1,0;2,0;;1,0;;;17,0;1,0;;;;;;;;;;;;;;;
modular;;4,0;;;;6,0;2,0;38,0;;;;;;27,0;;;3,0;;3,0;1,0;;;1,0;2,0;4,0;;;27,0;3,0;;29,0;1,0;;;;11,0;1,0;;;3,0;4,0;29,0;2,0;50,0;42,0;;;;;;;2,0;10,0;2,0;;;13,0;;;;;;;2,0;24,0;;33,0;;;;1,0;46,0;;;1,0;;;;;3,0;31,0;;5,0;;77,0;;;8,0;;3,0;;;;;1,0;;;;4,0;2,0;10,0;;;6,0;12,0;46,0;14,0;1,0;1,0;;;;;1,0;1,0;;5,0;;5,0;16,0;;;8,0;1,0;;;132,0;;;;5,0;;;2,0;1,0;;7,0;;;;;;;;1,0;;;;3,0;3,0;;;5,0;4,0;;;;;;;;40,0;;;;;19,0;6,0;;;;;;;;;;;2,0;;;;;;7,0;;;;18,0;7,0;;;;;3,0;;69,0;;;;;1,0;;;;;6,0;;;15,0;1,0;;;;;;3,0;1,0;;;;;;;1,0;;10,0;;;2,0;;2,0;4,0;12,0;3,0;;;;;;;1,0;;;;4,0;4,0;1,0;8,0;;3,0;;3,0;37,0;;2,0;3,0;13,0;;;7,0;;6,0;2,0;;;;;;;;;;10,0;;;1,0;;;;5,0;;3,0;11,0;;;;;2,0;;;9,0;;;;;;;;;6,0;;;;;;;;;7,0;;;;;;;;1,0;12,0;3,0;22,0;1,0;;;;;;;15,0;2,0;;;8,0;;10,0;2,0;3,0;;;;;;;2,0;;5,0;6,0;;;;;;1,0;;;;;;55,0;7,0;;;;;;;;;;;;;4,0;3,0;2,0;;;;;;2,0;;;3,0;;;;;;;;;;;;11,0;;1,0;;;;3,0;14,0;;;;;30,0;102,0;3,0;;;;7,0;1,0;;;;;;;5,0;;;;10,0;2,0;;;;;;;;;;;;;1,0;;;;;;;;;19,0;;;;;3,0;;8,0;;;;;3,0;;;;;;;;;;;;1,0;51,0;4,0;;;5,0;5,0;;3,0;;2,0;6,0;;;12,0;2,0;;;;;;;10,0;;4,0;;1,0;;;;;2,0;;;;;;;3,0;;2,0;;;;;;;;3,0;42,0;;;;;;;;;;;;;4,0;;;;;10,0;;;;;;2,0;;;4,0;;;;;;1,0;;;7,0;;;;;;1,0;;;;;1,0;;;1,0;;;;;;;;6,0;7,0;;;;3,0;;;;3,0;;;;;;;;;;;1,0;;1,0;;4,0;1,0;;;;;;;;;;;;;;;;7,0;;;;;;;;;;;;;;;;;6,0;;;37,0;;;;;;;;;;;;;;;4,0;;;;;;;;;;;;;;4,0;5,0;;;;;;;;;;;2,0;;;;;;;1,0;1,0;;3,0;;;1,0;;;;12,0;;;;;;2,0;;7,0;6,0;;;;;;2,0;;;;;;;;;;;;;;;;;;;;;;;;;8,0;;14,0;1,0;;;1,0;;;;;;;;;;;;;;6,0;;;;;;;;;;;;;;;;1,0;;;;;9,0;;1,0;;;;;;;;;;;;;;;;;;;;;;;;;;;;;;;;;;;;;;;;;;;;;;;;;;;;;;;12,0;;;;1,0;;;;;;;;;;;;;;;;;;;10,0;;;;;;;;2,0;;;;;;1,0;;;;;;;;;;1,0;;;;;;;;;;;;;;;;;10,0;;;;;;;;;;;;;;;;;;;;;;2,0;;;;;;;;;;;;;;;;;;;;;;;2,0;;;;;;;;;;;;;;;8,0;;;;;;2,0;;;;;;2,0;;;;;;;;;;;;;;;;;;;;;;;;;;;
mold;;1,0;;;2,0;5,0;10,0;49,0;;;;;14,0;16,0;2,0;;;;;;;;2,0;;;;;22,0;;6,0;6,0;;;;2,0;;4,0;11,0;2,0;2,0;4,0;51,0;3,0;;;7,0;;24,0;;;;;;1,0;1,0;1,0;92,0;;;2,0;6,0;;2,0;;19,0;1,0;42,0;1,0;;;5,0;75,0;3,0;4,0;;;76,0;;;1,0;48,0;;;;51,0;1,0;;15,0;1,0;;;2,0;;;;;;;17,0;3,0;5,0;2,0;7,0;27,0;;;;;1,0;;;;2,0;;;;;4,0;;21,0;;;;2,0;;;15,0;;6,0;10,0;2,0;;2,0;20,0;;;1,0;;;;;;;;;1,0;1,0;10,0;;2,0;;;46,0;4,0;;;;;13,0;28,0;11,0;16,0;;;;;12,0;9,0;1,0;;;;;6,0;;;;;;2,0;;;5,0;1,0;;1,0;1,0;;8,0;;;;6,0;3,0;7,0;1,0;53,0;;17,0;9,0;;18,0;;;;;30,0;13,0;6,0;22,0;;;;;;12,0;;2,0;10,0;;3,0;;;;1,0;1,0;57,0;1,0;;2,0;;1,0;;;6,0;;;;;;49,0;3,0;;;5,0;1,0;5,0;9,0;13,0;6,0;;;1,0;10,0;46,0;;2,0;74,0;1,0;;8,0;;2,0;3,0;1,0;;;;;;1,0;2,0;;;1,0;;;2,0;;2,0;2,0;;;2,0;;;7,0;2,0;7,0;1,0;1,0;;5,0;1,0;;2,0;1,0;;1,0;;4,0;12,0;8,0;1,0;;;;;;;;;7,0;;;;5,0;;;;;;;;;;;;;4,0;1,0;;;19,0;;;2,0;;;;;;1,0;;;10,0;;1,0;;;;;1,0;1,0;1,0;1,0;;4,0;;;;;;;;;;;;;;;;1,0;;;;;;;1,0;;;;2,0;;;;;;;;;;;;;;;;;;3,0;;10,0;;;;;;;;;;;;;;;;;;;;;5,0;;;;2,0;;;;;;;;;;;11,0;7,0;;2,0;;;;;;;;;;;4,0;;;;1,0;3,0;;1,0;;;;;;;;;;;;;2,0;;;1,0;1,0;17,0;1,0;;;;;1,0;3,0;;;;;;;;;;;;;2,0;;;;;;;2,0;;;;;;;;;;;;;1,0;;29,0;;;;;12,0;;;;;;;;1,0;;;;;;;1,0;;14,0;;;;;;;;;;;;;;;;;;;;;;;;;;;;;;11,0;1,0;;;;;;;;;13,0;;8,0;;;;8,0;;;;;;;;;;;;;;1,0;;;;;;;;;;;;1,0;;;;;;;;;;;;;;;;;;;3,0;;;;;;;;14,0;;;;;1,0;;;;;;;;2,0;;;;1,0;;;;;;;;;3,0;;;;;;;;;;;;;7,0;;;;;;5,0;;;;27,0;;1,0;;9,0;;;;;;;;;2,0;;;;;10,0;;;2,0;;;;;;;;;;;;;;;1,0;;;1,0;;;;1,0;;1,0;;;1,0;;;;1,0;;;1,0;;;;;;18,0;;;2,0;;;4,0;1,0;1,0;;;;;;2,0;;;;;2,0;;;;;;2,0;1,0;1,0;;;;;14,0;;;4,0;;;;;;;;;;;;;;;1,0;;;;;;;;;;;;;;5,0;;;;;;;;;;;;;;;;;;;;6,0;2,0;;;2,0;4,0;;;;;;;1,0;;;;;;;;;;;;;;;;;;;;;;3,0;;;;;;;;;;;;;;5,0;;;;;;;2,0;;;;;;7,0;;;;;;;;;6,0;;1,0;;;;;;;;1,0;;;;;;;;;;;;;;;;;16,0;1,0;1,0;;;;;;;;8,0;;3,0;;;;;;;;3,0;;;;;;;1,0;;;;;;;;;;;;;;;;;;;;;;;;;;;;;;;;;;;;;;;
monitor;;1,0;1,0;6,0;6,0;155,0;13,0;24,0;;;;;;145,0;1,0;7,0;114,0;1,0;;2,0;;;3,0;10,0;18,0;1,0;;24,0;34,0;16,0;122,0;81,0;2,0;;3,0;136,0;13,0;6,0;14,0;;63,0;238,0;3,0;6,0;212,0;9,0;;13,0;;;5,0;;8,0;13,0;27,0;;20,0;;7,0;20,0;3,0;1,0;1,0;;351,0;2,0;158,0;;10,0;;4,0;41,0;61,0;2,0;3,0;;5,0;2,0;;2,0;229,0;;51,0;10,0;35,0;2,0;;19,0;;8,0;34,0;2,0;5,0;16,0;2,0;;26,0;;82,0;12,0;133,0;35,0;1,0;26,0;29,0;64,0;1,0;16,0;23,0;;;10,0;118,0;1,0;;;25,0;3,0;53,0;108,0;1,0;;95,0;5,0;;17,0;641,0;;;;53,0;2,0;;61,0;;6,0;73,0;14,0;16,0;;;15,0;4,0;;;4,0;230,0;19,0;17,0;20,0;;2,0;54,0;3,0;1,0;12,0;;;;;3,0;55,0;7,0;2,0;;;31,0;28,0;1,0;17,0;6,0;;7,0;15,0;12,0;13,0;;5,0;8,0;2,0;7,0;1,0;1,0;44,0;;;2,0;1,0;9,0;23,0;;5,0;1,0;1,0;3,0;5,0;32,0;;3,0;3,0;1,0;;;;17,0;8,0;4,0;;14,0;103,0;6,0;35,0;2,0;;;9,0;34,0;;7,0;4,0;5,0;9,0;4,0;;5,0;1,0;59,0;2,0;14,0;6,0;1,0;3,0;52,0;1,0;4,0;7,0;;17,0;5,0;6,0;;;3,0;;;43,0;1,0;7,0;30,0;1,0;1,0;;;5,0;1,0;1,0;28,0;35,0;10,0;;5,0;50,0;;145,0;7,0;;;2,0;;5,0;;10,0;1,0;43,0;4,0;;13,0;31,0;;36,0;2,0;1,0;14,0;4,0;;;;6,0;8,0;2,0;;4,0;1,0;3,0;;7,0;18,0;34,0;1,0;1,0;;1,0;1,0;7,0;1,0;;1,0;40,0;1,0;23,0;;;33,0;;5,0;;29,0;;4,0;7,0;21,0;113,0;;27,0;8,0;1,0;;;109,0;;4,0;2,0;1,0;14,0;68,0;;;;;2,0;2,0;2,0;3,0;;3,0;15,0;;15,0;6,0;;;;;;15,0;14,0;;12,0;242,0;38,0;17,0;1,0;2,0;13,0;7,0;;5,0;;9,0;4,0;;;12,0;3,0;33,0;6,0;;5,0;4,0;;188,0;8,0;;10,0;3,0;38,0;10,0;15,0;1,0;28,0;7,0;8,0;3,0;3,0;;28,0;;14,0;10,0;1,0;;16,0;8,0;23,0;6,0;54,0;4,0;;22,0;16,0;;18,0;;17,0;52,0;51,0;;;1,0;1,0;;10,0;;;1,0;75,0;48,0;28,0;12,0;1,0;6,0;14,0;43,0;4,0;5,0;3,0;30,0;6,0;17,0;2,0;25,0;107,0;25,0;27,0;12,0;5,0;;3,0;69,0;;;11,0;6,0;;;2,0;5,0;4,0;2,0;5,0;10,0;1,0;1,0;;2,0;;;5,0;4,0;2,0;7,0;;19,0;21,0;16,0;;7,0;6,0;2,0;5,0;;4,0;2,0;12,0;20,0;2,0;45,0;1,0;8,0;;3,0;2,0;;1,0;9,0;1,0;37,0;12,0;8,0;;5,0;11,0;1,0;6,0;;;17,0;;2,0;2,0;7,0;;6,0;;1,0;9,0;8,0;10,0;4,0;;9,0;19,0;1,0;3,0;1,0;;6,0;;3,0;;1,0;7,0;;3,0;14,0;4,0;;4,0;;1,0;3,0;;;3,0;3,0;10,0;;1,0;1,0;1,0;5,0;;9,0;2,0;55,0;5,0;;;;;;9,0;20,0;5,0;;;4,0;;6,0;1,0;8,0;1,0;6,0;4,0;;;2,0;8,0;;;;;4,0;20,0;;;3,0;4,0;2,0;4,0;1,0;;1,0;2,0;;;1,0;29,0;12,0;7,0;1,0;6,0;2,0;10,0;29,0;;;;;;1,0;1,0;;2,0;;6,0;5,0;5,0;1,0;3,0;1,0;3,0;4,0;11,0;;;;;2,0;2,0;;2,0;30,0;48,0;;;4,0;2,0;;3,0;4,0;;;6,0;1,0;2,0;2,0;3,0;25,0;2,0;;2,0;10,0;4,0;1,0;7,0;2,0;5,0;3,0;;;16,0;14,0;;1,0;;5,0;7,0;2,0;3,0;18,0;50,0;;27,0;22,0;1,0;5,0;;32,0;1,0;;2,0;;5,0;13,0;7,0;7,0;;2,0;;1,0;26,0;2,0;;;7,0;7,0;1,0;;3,0;3,0;;4,0;8,0;5,0;;;;3,0;1,0;;1,0;1,0;1,0;1,0;23,0;;9,0;;1,0;3,0;;;5,0;1,0;;2,0;;;3,0;6,0;;;6,0;18,0;1,0;2,0;6,0;4,0;;36,0;8,0;3,0;2,0;;1,0;4,0;;5,0;;;;4,0;;;;;;1,0;;6,0;1,0;;1,0;14,0;;;;15,0;4,0;4,0;1,0;2,0;1,0;;;;;5,0;;;4,0;;8,0;4,0;2,0;;;;;;;1,0;;;;;;;;;;;4,0;;;;;;;2,0;;;;;2,0;;;4,0;;;1,0;31,0;;;;1,0;17,0;;;10,0;;3,0;;;1,0;;1,0;;;4,0;16,0;3,0;;;;;10,0;3,0;9,0;;2,0;1,0;1,0;;;6,0;;;;;2,0;31,0;;;;4,0;;;2,0;3,0;2,0;;3,0;1,0;;;1,0;;2,0;4,0;1,0;6,0;;;;;;;;;1,0;;3,0;1,0;;;26,0;2,0;;42,0;42,0;;;2,0;4,0;;;;;4,0;9,0;;;3,0;;;;1,0;;8,0;;3,0;;;9,0;1,0;;2,0;;;1,0;;4,0;;4,0;;;1,0;;;;;1,0;;;;;;;;;1,0;;2,0;1,0;;;;;;;;;1,0;;;6,0;;2,0;;;1,0;1,0;;;;2,0;;;2,0;;;2,0;4,0;2,0;;;1,0;2,0;2,0;;;;;;;8,0;;
motion;;1,0;1,0;42,0;52,0;111,0;8,0;39,0;6,0;7,0;;14,0;15,0;497,0;;13,0;396,0;;1,0;11,0;;;12,0;13,0;7,0;34,0;35,0;109,0;35,0;11,0;338,0;26,0;71,0;41,0;;619,0;18,0;242,0;42,0;;414,0;551,0;;99,0;119,0;11,0;10,0;119,0;;21,0;139,0;;12,0;5,0;102,0;15,0;16,0;224,0;18,0;184,0;;;33,0;12,0;709,0;2,0;203,0;7,0;16,0;6,0;11,0;102,0;70,0;;;18,0;3,0;23,0;7,0;25,0;396,0;;79,0;148,0;112,0;20,0;;73,0;15,0;13,0;71,0;4,0;6,0;;6,0;;74,0;40,0;191,0;81,0;208,0;79,0;1,0;22,0;58,0;105,0;2,0;24,0;22,0;;1,0;72,0;194,0;15,0;3,0;13,0;7,0;46,0;108,0;491,0;42,0;1,0;112,0;18,0;1,0;40,0;369,0;;3,0;;122,0;1,0;;85,0;8,0;;91,0;30,0;8,0;;;15,0;;;1,0;42,0;100,0;12,0;193,0;;2,0;28,0;55,0;;2,0;1,0;;;;1,0;;11,0;9,0;5,0;;10,0;32,0;;1,0;184,0;99,0;;1,0;198,0;;9,0;1,0;1,0;14,0;4,0;4,0;;6,0;17,0;44,0;2,0;65,0;5,0;304,0;15,0;;73,0;2,0;25,0;8,0;17,0;31,0;;4,0;2,0;;;7,0;2,0;58,0;21,0;18,0;;5,0;45,0;42,0;79,0;12,0;;;;41,0;14,0;;144,0;27,0;40,0;12,0;1,0;2,0;;84,0;3,0;2,0;35,0;;2,0;172,0;4,0;1,0;13,0;4,0;5,0;;75,0;;3,0;2,0;;;47,0;18,0;15,0;3,0;6,0;;;2,0;82,0;;9,0;7,0;48,0;2,0;;8,0;33,0;26,0;96,0;;;8,0;;65,0;24,0;;;108,0;8,0;2,0;;6,0;110,0;1,0;30,0;;11,0;46,0;1,0;1,0;1,0;51,0;8,0;55,0;8,0;1,0;32,0;;2,0;;9,0;30,0;24,0;2,0;5,0;20,0;;;46,0;;;2,0;36,0;2,0;17,0;;;;;3,0;1,0;1,0;24,0;4,0;32,0;59,0;267,0;6,0;8,0;1,0;;27,0;2,0;33,0;;;12,0;;1,0;102,0;;3,0;1,0;13,0;10,0;18,0;39,0;96,0;13,0;34,0;4,0;12,0;21,0;;2,0;13,0;;4,0;;182,0;;;2,0;292,0;13,0;9,0;12,0;47,0;7,0;2,0;13,0;14,0;36,0;;1,0;2,0;;68,0;11,0;38,0;7,0;10,0;4,0;49,0;4,0;206,0;29,0;1,0;12,0;33,0;368,0;36,0;33,0;;111,0;36,0;17,0;30,0;61,0;29,0;33,0;2,0;60,0;60,0;33,0;12,0;83,0;7,0;94,0;19,0;31,0;20,0;22,0;;10,0;;81,0;4,0;38,0;58,0;67,0;2,0;21,0;2,0;32,0;;18,0;;11,0;1,0;179,0;7,0;81,0;45,0;14,0;106,0;6,0;42,0;29,0;38,0;;13,0;13,0;4,0;1,0;3,0;12,0;146,0;39,0;32,0;15,0;30,0;24,0;116,0;8,0;;1,0;22,0;9,0;10,0;7,0;8,0;5,0;12,0;32,0;44,0;6,0;1,0;16,0;2,0;7,0;55,0;;5,0;2,0;22,0;1,0;16,0;36,0;;27,0;;7,0;11,0;;6,0;5,0;18,0;18,0;6,0;4,0;69,0;25,0;1,0;48,0;;9,0;19,0;4,0;2,0;;13,0;42,0;3,0;26,0;;7,0;2,0;2,0;380,0;11,0;23,0;4,0;;3,0;13,0;5,0;7,0;3,0;2,0;6,0;;2,0;;1,0;2,0;9,0;3,0;;6,0;;;3,0;8,0;;1,0;21,0;;13,0;13,0;8,0;10,0;4,0;7,0;32,0;4,0;14,0;;4,0;1,0;238,0;1,0;;;;;;8,0;8,0;1,0;;16,0;16,0;9,0;;;15,0;14,0;4,0;8,0;1,0;6,0;;4,0;8,0;;2,0;1,0;;6,0;4,0;;48,0;;;;12,0;1,0;14,0;1,0;;;;16,0;9,0;1,0;;;2,0;3,0;;12,0;1,0;32,0;3,0;;;4,0;86,0;;2,0;17,0;5,0;7,0;;1,0;5,0;9,0;8,0;49,0;2,0;3,0;2,0;;6,0;12,0;;4,0;23,0;;;4,0;2,0;;1,0;;;102,0;15,0;9,0;;;4,0;3,0;3,0;;15,0;;8,0;;;3,0;1,0;;;;1,0;;;8,0;36,0;9,0;2,0;64,0;6,0;1,0;4,0;2,0;;8,0;;;;;13,0;31,0;;3,0;24,0;1,0;17,0;2,0;9,0;77,0;6,0;13,0;;2,0;2,0;6,0;13,0;15,0;;9,0;1,0;;1,0;4,0;2,0;6,0;5,0;9,0;2,0;5,0;;;11,0;26,0;12,0;3,0;6,0;6,0;3,0;;13,0;;1,0;1,0;;3,0;8,0;;;;10,0;1,0;;;6,0;59,0;3,0;6,0;2,0;2,0;;;;;9,0;107,0;;6,0;6,0;17,0;;8,0;13,0;11,0;;;7,0;6,0;5,0;;12,0;;;;;3,0;;;5,0;;;4,0;1,0;4,0;;;;;;;;19,0;;1,0;;1,0;;;;;2,0;1,0;1,0;;3,0;;21,0;2,0;2,0;2,0;5,0;;2,0;10,0;1,0;;;;1,0;2,0;;;;;14,0;;4,0;;;7,0;8,0;;14,0;;1,0;;10,0;;7,0;6,0;14,0;;3,0;;3,0;;1,0;;4,0;;;1,0;3,0;13,0;;;16,0;12,0;9,0;;;;6,0;1,0;;3,0;;1,0;;5,0;19,0;;4,0;2,0;16,0;27,0;7,0;13,0;;;2,0;4,0;2,0;1,0;;;;10,0;1,0;;3,0;;6,0;21,0;9,0;;11,0;;11,0;6,0;31,0;6,0;;10,0;4,0;;14,0;2,0;;;;12,0;;;4,0;1,0;;;;22,0;4,0;;23,0;1,0;;5,0;1,0;;1,0;2,0;;2,0;9,0;;2,0;;1,0;12,0;;1,0;18,0;;;17,0;;;25,0;24,0;23,0;;;;6,0;8,0;1,0;;1,0;;32,0;;3,0;;;52,0;;;;;;;;1,0;;3,0;;1,0;1,0;;;;8,0;;;14,0;;;;;;;;;;2,0;;12,0;;;1,0;;;;1,0;;1,0;5,0;1,0;;;4,0;;1,0;2,0;;1,0;;;1,0;;;
mount;;322,0;1,0;38,0;6,0;646,0;55,0;1300,0;5,0;;5,0;10,0;178,0;1108,0;;1,0;97,0;10,0;84,0;6,0;74,0;2,0;7,0;18,0;51,0;4,0;;812,0;21,0;4,0;1056,0;48,0;5,0;26,0;;35,0;101,0;46,0;17,0;4,0;94,0;1186,0;53,0;42,0;249,0;213,0;2,0;322,0;;;7,0;1,0;304,0;44,0;36,0;11,0;193,0;;;16,0;18,0;;17,0;7,0;714,0;7,0;970,0;2,0;13,0;10,0;63,0;1800,0;156,0;9,0;1,0;1,0;136,0;13,0;5,0;23,0;280,0;;21,0;;651,0;90,0;3,0;232,0;9,0;12,0;5,0;50,0;31,0;33,0;16,0;5,0;6,0;71,0;613,0;128,0;610,0;23,0;25,0;7,0;25,0;46,0;;5,0;;;;29,0;177,0;8,0;24,0;;;124,0;30,0;760,0;;2,0;64,0;21,0;4,0;16,0;1355,0;2,0;8,0;6,0;15,0;;15,0;431,0;1,0;10,0;110,0;18,0;2,0;17,0;25,0;103,0;23,0;;142,0;35,0;89,0;150,0;35,0;480,0;25,0;65,0;847,0;224,0;;1,0;41,0;3,0;;6,0;20,0;342,0;13,0;5,0;1,0;1,0;880,0;235,0;;26,0;27,0;1,0;33,0;201,0;44,0;75,0;10,0;13,0;52,0;;4,0;64,0;23,0;149,0;135,0;4,0;147,0;99,0;374,0;319,0;4,0;24,0;56,0;82,0;116,0;232,0;1052,0;3,0;126,0;89,0;3,0;53,0;20,0;11,0;12,0;4,0;990,0;49,0;274,0;;56,0;68,0;19,0;3,0;20,0;120,0;19,0;51,0;5,0;32,0;16,0;;13,0;3,0;725,0;11,0;1364,0;10,0;30,0;6,0;81,0;1,0;24,0;1,0;127,0;2,0;16,0;5,0;79,0;2,0;10,0;187,0;162,0;87,0;31,0;19,0;20,0;100,0;730,0;221,0;132,0;38,0;12,0;541,0;178,0;31,0;553,0;1561,0;30,0;;12,0;15,0;45,0;589,0;236,0;4,0;12,0;1,0;32,0;35,0;84,0;60,0;116,0;128,0;331,0;8,0;137,0;200,0;10,0;128,0;186,0;15,0;226,0;473,0;;49,0;145,0;75,0;325,0;17,0;131,0;59,0;19,0;43,0;5,0;45,0;68,0;23,0;36,0;94,0;116,0;90,0;116,0;4,0;124,0;26,0;189,0;334,0;16,0;263,0;20,0;20,0;91,0;29,0;34,0;61,0;94,0;132,0;13,0;308,0;60,0;58,0;104,0;7,0;28,0;27,0;30,0;35,0;84,0;115,0;106,0;17,0;219,0;110,0;17,0;21,0;57,0;31,0;6,0;6,0;175,0;95,0;94,0;130,0;37,0;323,0;116,0;62,0;6,0;109,0;64,0;75,0;1,0;4,0;37,0;48,0;40,0;261,0;199,0;8,0;52,0;1,0;3,0;64,0;1,0;104,0;;22,0;21,0;5,0;4,0;7,0;16,0;108,0;18,0;3,0;3,0;3,0;4,0;;110,0;39,0;4,0;33,0;22,0;43,0;43,0;1,0;;4,0;;10,0;;10,0;8,0;14,0;12,0;3,0;3,0;6,0;18,0;9,0;56,0;19,0;26,0;74,0;3,0;103,0;45,0;87,0;32,0;102,0;1,0;18,0;22,0;147,0;17,0;9,0;6,0;;;3,0;2,0;;1,0;232,0;25,0;9,0;3,0;4,0;56,0;1,0;8,0;2,0;4,0;3,0;13,0;6,0;39,0;;6,0;66,0;10,0;52,0;;5,0;5,0;3,0;168,0;;;9,0;9,0;96,0;77,0;23,0;;30,0;44,0;14,0;22,0;5,0;;4,0;1,0;;1,0;;2,0;;;;12,0;126,0;80,0;87,0;17,0;27,0;6,0;10,0;230,0;8,0;30,0;27,0;11,0;22,0;54,0;35,0;42,0;7,0;1,0;;6,0;29,0;26,0;17,0;28,0;27,0;;48,0;6,0;1,0;90,0;6,0;1,0;132,0;24,0;17,0;16,0;;4,0;2,0;12,0;;7,0;8,0;9,0;43,0;17,0;21,0;102,0;84,0;16,0;72,0;;;79,0;70,0;5,0;;31,0;5,0;88,0;103,0;40,0;3,0;2,0;4,0;14,0;8,0;;3,0;95,0;201,0;;2,0;;7,0;40,0;;6,0;15,0;;2,0;;1,0;;3,0;56,0;;26,0;6,0;57,0;15,0;;65,0;5,0;;12,0;1,0;;15,0;;56,0;30,0;36,0;;;20,0;35,0;10,0;;48,0;38,0;34,0;102,0;117,0;1,0;3,0;6,0;;;;6,0;26,0;;3,0;2,0;5,0;31,0;2,0;;;111,0;4,0;2,0;;25,0;3,0;;1,0;1,0;2,0;9,0;38,0;34,0;2,0;7,0;;52,0;;;1,0;3,0;;2,0;3,0;;;1,0;25,0;;15,0;2,0;13,0;;1,0;7,0;55,0;4,0;63,0;1,0;121,0;114,0;;30,0;;3,0;;15,0;;;2,0;;15,0;19,0;1,0;5,0;;1,0;9,0;3,0;1,0;;18,0;2,0;5,0;;63,0;4,0;55,0;5,0;5,0;1,0;;;19,0;20,0;49,0;;28,0;16,0;;10,0;12,0;18,0;3,0;;30,0;6,0;1,0;553,0;;5,0;7,0;200,0;1,0;22,0;33,0;187,0;5,0;;;49,0;50,0;33,0;51,0;58,0;26,0;1,0;2,0;23,0;27,0;1,0;35,0;43,0;;23,0;185,0;5,0;1,0;10,0;22,0;3,0;1,0;40,0;64,0;8,0;12,0;1,0;11,0;8,0;15,0;26,0;272,0;;78,0;90,0;12,0;26,0;24,0;39,0;15,0;112,0;65,0;6,0;43,0;1,0;2,0;5,0;58,0;44,0;30,0;2,0;1,0;20,0;11,0;3,0;20,0;;39,0;8,0;30,0;14,0;12,0;10,0;1,0;;4,0;83,0;5,0;8,0;17,0;9,0;3,0;;6,0;2,0;21,0;70,0;11,0;;11,0;4,0;17,0;;30,0;11,0;;;;;;7,0;;4,0;;8,0;;1,0;9,0;;12,0;;42,0;;;1,0;4,0;;;;2,0;;2,0;;13,0;4,0;;;;1,0;3,0;;3,0;;;;;16,0;;8,0;;;;2,0;3,0;3,0;2,0;;11,0;9,0;;;;10,0;;2,0;5,0;5,0;3,0;5,0;;;;;1,0;1,0;1,0;9,0;;;4,0;4,0;1,0;;2,0;19,0;1,0;3,0;1,0;2,0;;2,0;23,0;;1,0;;5,0;8,0;30,0;1,0;;;;;2,0;;;4,0;;9,0;6,0;;3,0;;2,0;;12,0;2,0;18,0;10,0;1,0;;;20,0;18,0;2,0;17,0;;4,0;;;16,0;;;23,0;2,0;2,0;3,0;;13,0;13,0;;;;;;;14,0;1,0;24,0;18,0;17,0;6,0;86,0;7,0;5,0;;4,0;16,0;2,0;;40,0;4,0;2,0;1,0;3,0;4,0;1,0;5,0;26,0;4,0;1,0;;1,0;;;;;33,0;;;;;;12,0;3,0;13,0;1,0;;6,0;9,0;;;1,0;;1,0;;;14,0;;;2,0;7,0;;9,0;;;6,0;2,0;38,0;2,0;;;2,0;3,0;;;
move;;19,0;1,0;14,0;26,0;56,0;12,0;129,0;2,0;;2,0;;97,0;92,0;;;78,0;;4,0;;8,0;2,0;6,0;;7,0;20,0;16,0;39,0;4,0;9,0;532,0;58,0;15,0;27,0;;27,0;18,0;11,0;7,0;20,0;132,0;327,0;1,0;9,0;63,0;35,0;;177,0;;2,0;1,0;;13,0;;46,0;18,0;10,0;13,0;4,0;36,0;7,0;;133,0;;321,0;;61,0;13,0;7,0;8,0;30,0;1123,0;59,0;;28,0;;3,0;11,0;2,0;6,0;88,0;6,0;13,0;2,0;171,0;204,0;4,0;460,0;5,0;22,0;2,0;;3,0;;26,0;3,0;19,0;49,0;49,0;51,0;567,0;58,0;;5,0;8,0;33,0;;4,0;;2,0;;34,0;26,0;3,0;;1,0;1,0;23,0;12,0;151,0;2,0;7,0;45,0;7,0;2,0;7,0;146,0;1,0;3,0;;43,0;2,0;;402,0;3,0;;54,0;18,0;76,0;5,0;4,0;7,0;8,0;;28,0;26,0;59,0;32,0;7,0;9,0;22,0;28,0;63,0;4,0;;;7,0;;;;;25,0;17,0;;;;48,0;50,0;3,0;7,0;4,0;;26,0;578,0;4,0;17,0;25,0;5,0;21,0;;;2,0;1,0;22,0;3,0;4,0;29,0;65,0;166,0;23,0;;1,0;1,0;26,0;81,0;18,0;107,0;;7,0;12,0;;2,0;1,0;2,0;4,0;;271,0;;35,0;56,0;;104,0;3,0;1,0;1,0;2,0;8,0;23,0;;34,0;7,0;6,0;9,0;2,0;46,0;;125,0;;16,0;4,0;1,0;;57,0;2,0;4,0;2,0;2,0;;;5,0;;11,0;4,0;7,0;;21,0;2,0;9,0;64,0;22,0;2,0;;1,0;15,0;26,0;20,0;56,0;118,0;7,0;;4,0;19,0;3,0;68,0;8,0;;;4,0;3,0;3,0;;14,0;222,0;39,0;4,0;;55,0;29,0;11,0;5,0;2,0;27,0;290,0;9,0;8,0;29,0;79,0;3,0;16,0;9,0;139,0;4,0;4,0;15,0;1,0;2,0;61,0;27,0;12,0;29,0;6,0;2,0;8,0;;;23,0;15,0;42,0;3,0;84,0;3,0;4,0;8,0;;17,0;22,0;6,0;74,0;12,0;73,0;55,0;186,0;32,0;6,0;3,0;5,0;8,0;5,0;34,0;;6,0;;7,0;6,0;9,0;;7,0;;11,0;1,0;44,0;31,0;12,0;9,0;1,0;9,0;5,0;22,0;;30,0;5,0;;18,0;;66,0;4,0;13,0;13,0;42,0;3,0;5,0;;;2,0;2,0;24,0;2,0;8,0;3,0;9,0;11,0;1,0;16,0;20,0;34,0;17,0;3,0;26,0;;8,0;257,0;22,0;4,0;;15,0;30,0;12,0;10,0;1,0;;3,0;2,0;5,0;184,0;22,0;3,0;;10,0;6,0;;;18,0;9,0;5,0;25,0;77,0;4,0;6,0;42,0;138,0;12,0;207,0;8,0;31,0;39,0;46,0;12,0;;;;1,0;3,0;;1,0;1,0;43,0;10,0;60,0;3,0;7,0;25,0;;17,0;;38,0;4,0;4,0;22,0;1,0;;18,0;4,0;25,0;16,0;1,0;2,0;19,0;11,0;170,0;;5,0;21,0;21,0;14,0;26,0;8,0;1,0;6,0;1,0;1,0;8,0;;6,0;1,0;1,0;;;1,0;7,0;;5,0;7,0;8,0;6,0;;5,0;2,0;1,0;;4,0;110,0;8,0;2,0;16,0;25,0;4,0;21,0;7,0;1,0;7,0;;1,0;1,0;3,0;;16,0;11,0;;;14,0;1,0;20,0;4,0;4,0;10,0;28,0;3,0;4,0;;;;;4,0;8,0;4,0;2,0;14,0;83,0;;;12,0;6,0;;;;;15,0;3,0;3,0;;21,0;4,0;;110,0;27,0;;5,0;2,0;8,0;;;6,0;1,0;64,0;1,0;;;;2,0;4,0;;;9,0;4,0;1,0;3,0;;3,0;5,0;;2,0;36,0;;6,0;1,0;;5,0;5,0;;;;22,0;;4,0;1,0;5,0;;;4,0;1,0;;13,0;9,0;;3,0;3,0;18,0;1,0;3,0;;;;;;33,0;;;5,0;8,0;1,0;3,0;;;15,0;;3,0;2,0;3,0;12,0;;1,0;;;;5,0;5,0;1,0;;;6,0;;6,0;1,0;24,0;;;1,0;;;2,0;2,0;;1,0;3,0;2,0;;;5,0;55,0;7,0;1,0;;2,0;22,0;;3,0;;10,0;;4,0;;1,0;;4,0;1,0;1,0;3,0;18,0;;2,0;10,0;2,0;2,0;19,0;53,0;;;2,0;5,0;;19,0;3,0;21,0;;;;;13,0;66,0;;;1,0;1,0;;;1,0;1,0;;5,0;4,0;1,0;2,0;;1,0;2,0;34,0;11,0;5,0;;;;3,0;;116,0;162,0;3,0;;;;1,0;1,0;2,0;;;3,0;5,0;;4,0;3,0;9,0;7,0;3,0;;;;1,0;6,0;10,0;;;;3,0;6,0;11,0;221,0;;3,0;10,0;2,0;1,0;18,0;2,0;4,0;9,0;;4,0;5,0;3,0;4,0;9,0;6,0;64,0;8,0;2,0;9,0;1,0;;41,0;1,0;;4,0;1,0;;;;;;;;6,0;18,0;35,0;7,0;14,0;3,0;;;;32,0;;;;2,0;;1,0;;9,0;11,0;;;;1,0;6,0;;;;1,0;;30,0;;3,0;;5,0;12,0;7,0;;;;4,0;1,0;;;;;;6,0;;11,0;;;;8,0;;;;;;2,0;;;;;;;;;2,0;4,0;9,0;;;1,0;2,0;;;3,0;;7,0;;;2,0;2,0;5,0;1,0;;;3,0;6,0;2,0;;5,0;;;;;1,0;1,0;6,0;6,0;;3,0;9,0;;8,0;;1,0;3,0;1,0;1,0;;4,0;;;;;;;;;;;1,0;;;;1,0;4,0;;8,0;;;29,0;1,0;2,0;1,0;3,0;2,0;2,0;7,0;1,0;;;;;10,0;;6,0;;;4,0;;28,0;12,0;;;3,0;13,0;4,0;1,0;;;13,0;7,0;1,0;;10,0;;8,0;2,0;12,0;;;1,0;;5,0;;2,0;3,0;;;7,0;7,0;;4,0;;;;;;4,0;2,0;;2,0;1,0;6,0;;;;;;;;;;;;;;;;1,0;;;2,0;;;;;;;;;2,0;;1,0;1,0;;;;
movement;;2,0;6,0;39,0;172,0;96,0;21,0;40,0;9,0;;8,0;4,0;33,0;360,0;;1,0;181,0;;;9,0;;;14,0;5,0;11,0;33,0;10,0;43,0;10,0;15,0;269,0;59,0;8,0;24,0;;182,0;21,0;133,0;11,0;5,0;273,0;420,0;1,0;26,0;144,0;19,0;2,0;309,0;;2,0;19,0;;23,0;3,0;37,0;13,0;10,0;59,0;9,0;77,0;2,0;;26,0;;403,0;5,0;146,0;17,0;7,0;56,0;20,0;556,0;23,0;;6,0;9,0;3,0;28,0;7,0;11,0;258,0;;37,0;28,0;133,0;100,0;2,0;214,0;17,0;10,0;24,0;3,0;;;9,0;;52,0;79,0;66,0;69,0;374,0;53,0;;6,0;30,0;53,0;6,0;6,0;;8,0;;32,0;74,0;11,0;;16,0;;25,0;42,0;178,0;13,0;3,0;147,0;18,0;;16,0;188,0;1,0;;;83,0;22,0;10,0;160,0;1,0;;40,0;45,0;108,0;2,0;1,0;10,0;16,0;4,0;18,0;23,0;48,0;17,0;78,0;5,0;12,0;43,0;77,0;1,0;9,0;1,0;;;;;;6,0;25,0;16,0;;;33,0;57,0;6,0;37,0;25,0;4,0;25,0;661,0;;14,0;7,0;2,0;32,0;;1,0;2,0;;22,0;38,0;5,0;22,0;31,0;177,0;6,0;2,0;10,0;1,0;26,0;23,0;4,0;62,0;1,0;7,0;1,0;;6,0;100,0;1,0;7,0;6,0;302,0;;8,0;68,0;104,0;;10,0;;3,0;19,0;29,0;24,0;;78,0;21,0;18,0;17,0;;36,0;;136,0;6,0;38,0;3,0;4,0;3,0;58,0;7,0;7,0;5,0;;;1,0;11,0;;22,0;32,0;2,0;1,0;26,0;7,0;8,0;26,0;20,0;6,0;;;57,0;6,0;;108,0;75,0;16,0;;;27,0;1,0;142,0;8,0;5,0;;;4,0;3,0;4,0;14,0;21,0;14,0;9,0;;76,0;47,0;2,0;6,0;4,0;12,0;209,0;2,0;;37,0;17,0;19,0;8,0;6,0;31,0;1,0;;;1,0;11,0;73,0;6,0;4,0;10,0;2,0;;4,0;8,0;4,0;11,0;12,0;112,0;9,0;42,0;1,0;;5,0;;26,0;15,0;10,0;35,0;28,0;89,0;127,0;420,0;25,0;13,0;;;5,0;;4,0;1,0;5,0;2,0;14,0;8,0;24,0;;25,0;3,0;72,0;3,0;26,0;45,0;157,0;6,0;;9,0;9,0;24,0;;17,0;12,0;1,0;7,0;;200,0;10,0;2,0;10,0;72,0;6,0;7,0;14,0;8,0;7,0;5,0;11,0;27,0;7,0;6,0;4,0;11,0;14,0;38,0;23,0;75,0;4,0;4,0;59,0;19,0;4,0;267,0;13,0;11,0;2,0;14,0;271,0;34,0;13,0;;3,0;40,0;2,0;21,0;79,0;26,0;9,0;;71,0;48,0;11,0;9,0;64,0;;10,0;47,0;65,0;;35,0;79,0;29,0;11,0;122,0;12,0;26,0;56,0;50,0;47,0;24,0;;19,0;;33,0;3,0;3,0;5,0;134,0;15,0;88,0;8,0;39,0;59,0;4,0;13,0;9,0;200,0;46,0;6,0;65,0;33,0;;3,0;15,0;47,0;90,0;2,0;14,0;4,0;14,0;149,0;9,0;17,0;5,0;2,0;12,0;37,0;4,0;3,0;4,0;1,0;23,0;31,0;1,0;5,0;10,0;1,0;;3,0;5,0;1,0;13,0;12,0;10,0;9,0;12,0;;11,0;;4,0;2,0;9,0;31,0;2,0;;5,0;7,0;14,0;83,0;39,0;9,0;1,0;1,0;3,0;2,0;16,0;;;19,0;5,0;2,0;28,0;1,0;14,0;2,0;4,0;10,0;33,0;5,0;4,0;2,0;5,0;;5,0;2,0;;9,0;2,0;3,0;18,0;;;8,0;5,0;;;2,0;;5,0;6,0;6,0;;5,0;64,0;3,0;63,0;48,0;;2,0;9,0;15,0;6,0;1,0;3,0;3,0;24,0;;;;;;6,0;4,0;;2,0;1,0;;1,0;2,0;2,0;3,0;;;24,0;1,0;2,0;;;9,0;;;11,0;1,0;4,0;;4,0;3,0;11,0;;1,0;;;;4,0;6,0;9,0;8,0;5,0;24,0;;2,0;;;2,0;;;30,0;;5,0;4,0;1,0;;9,0;;3,0;38,0;;4,0;45,0;8,0;3,0;;;8,0;1,0;3,0;22,0;3,0;6,0;3,0;;1,0;8,0;1,0;1,0;8,0;;;1,0;2,0;;5,0;;;;6,0;15,0;;4,0;33,0;39,0;43,0;;2,0;;15,0;;1,0;;;;4,0;;7,0;4,0;8,0;1,0;;2,0;5,0;45,0;8,0;;3,0;;29,0;19,0;;;;1,0;;10,0;2,0;23,0;3,0;;2,0;2,0;2,0;71,0;;2,0;2,0;;1,0;2,0;9,0;7,0;;13,0;12,0;;9,0;1,0;4,0;5,0;71,0;2,0;7,0;1,0;3,0;;;4,0;20,0;28,0;;2,0;;;3,0;1,0;3,0;;;6,0;1,0;;;5,0;8,0;3,0;;;;16,0;3,0;21,0;5,0;1,0;2,0;;2,0;;18,0;300,0;;;13,0;23,0;;12,0;3,0;9,0;;6,0;5,0;16,0;2,0;12,0;7,0;10,0;42,0;;;;;6,0;21,0;;;11,0;11,0;1,0;;;;;;3,0;1,0;16,0;;14,0;15,0;4,0;;;;21,0;;1,0;;2,0;10,0;;3,0;3,0;3,0;8,0;;;3,0;12,0;;;;1,0;;;;2,0;;;;;;;;7,0;5,0;;1,0;;;;3,0;;11,0;5,0;3,0;;19,0;1,0;;;;;5,0;;9,0;3,0;;3,0;;5,0;2,0;;17,0;4,0;;4,0;;;;5,0;5,0;;;1,0;;1,0;1,0;4,0;4,0;12,0;;14,0;2,0;;1,0;9,0;;1,0;3,0;;1,0;1,0;23,0;;;1,0;1,0;11,0;3,0;1,0;8,0;;1,0;;3,0;4,0;9,0;9,0;;;2,0;;;2,0;;;1,0;;;4,0;;5,0;;28,0;;;45,0;1,0;;;5,0;;1,0;1,0;;;;;;;2,0;6,0;;;10,0;;7,0;12,0;1,0;;30,0;20,0;;;;;11,0;5,0;1,0;;10,0;;6,0;;18,0;2,0;;3,0;4,0;;7,0;3,0;;;;;5,0;2,0;;6,0;3,0;;;;;;;3,0;;;;;1,0;2,0;1,0;;8,0;;;6,0;;2,0;5,0;;;;;;2,0;;;;;;;1,0;1,0;;;1,0;;2,0;;;
moving;;3,0;2,0;36,0;83,0;294,0;15,0;84,0;3,0;;9,0;;86,0;326,0;;;212,0;;2,0;2,0;8,0;;9,0;2,0;4,0;4,0;7,0;33,0;16,0;7,0;218,0;57,0;26,0;25,0;2,0;103,0;13,0;7,0;20,0;;209,0;298,0;3,0;11,0;144,0;51,0;1,0;48,0;4,0;;24,0;;14,0;4,0;55,0;22,0;68,0;1,0;9,0;86,0;;;58,0;1,0;874,0;;284,0;3,0;6,0;10,0;23,0;1046,0;40,0;2,0;6,0;;5,0;6,0;7,0;18,0;264,0;;86,0;16,0;185,0;60,0;;182,0;5,0;9,0;4,0;8,0;8,0;;21,0;;23,0;48,0;200,0;90,0;352,0;79,0;2,0;13,0;92,0;51,0;5,0;8,0;8,0;;7,0;15,0;46,0;13,0;3,0;3,0;4,0;21,0;47,0;112,0;37,0;3,0;70,0;7,0;;44,0;175,0;;4,0;5,0;94,0;6,0;12,0;534,0;8,0;;73,0;29,0;25,0;;;10,0;2,0;18,0;9,0;33,0;88,0;20,0;22,0;70,0;6,0;22,0;186,0;5,0;1,0;2,0;2,0;3,0;;;4,0;32,0;4,0;2,0;;;78,0;29,0;;32,0;8,0;;13,0;562,0;24,0;12,0;12,0;1,0;11,0;;1,0;4,0;;41,0;;24,0;14,0;38,0;437,0;21,0;2,0;1,0;1,0;8,0;47,0;23,0;102,0;5,0;6,0;10,0;1,0;37,0;13,0;6,0;12,0;5,0;521,0;37,0;13,0;102,0;207,0;122,0;26,0;;;24,0;31,0;9,0;4,0;40,0;20,0;13,0;40,0;;83,0;;197,0;;12,0;4,0;;;47,0;2,0;3,0;6,0;5,0;3,0;1,0;25,0;;16,0;2,0;2,0;;20,0;6,0;12,0;59,0;9,0;5,0;;;72,0;13,0;6,0;212,0;112,0;22,0;;1,0;23,0;1,0;138,0;2,0;15,0;;;3,0;7,0;1,0;48,0;91,0;31,0;;;4,0;31,0;9,0;1,0;2,0;33,0;134,0;15,0;;7,0;15,0;22,0;30,0;6,0;204,0;3,0;;3,0;2,0;1,0;151,0;17,0;50,0;3,0;4,0;;8,0;4,0;;30,0;2,0;16,0;7,0;97,0;;2,0;14,0;2,0;5,0;8,0;29,0;5,0;22,0;55,0;29,0;956,0;34,0;17,0;2,0;8,0;11,0;;25,0;3,0;17,0;;8,0;11,0;41,0;;1,0;2,0;3,0;;37,0;39,0;1,0;4,0;2,0;;8,0;23,0;2,0;4,0;3,0;;5,0;;200,0;11,0;3,0;36,0;115,0;3,0;;1,0;;3,0;1,0;17,0;44,0;3,0;2,0;11,0;17,0;;60,0;32,0;87,0;3,0;9,0;177,0;7,0;4,0;270,0;60,0;3,0;2,0;14,0;171,0;15,0;11,0;3,0;10,0;;13,0;36,0;131,0;10,0;8,0;;19,0;32,0;;;26,0;4,0;;3,0;107,0;;18,0;81,0;76,0;6,0;;4,0;16,0;126,0;9,0;9,0;;8,0;28,0;;20,0;2,0;;1,0;49,0;7,0;26,0;5,0;7,0;53,0;;12,0;3,0;201,0;3,0;5,0;90,0;8,0;;4,0;34,0;59,0;59,0;2,0;4,0;;6,0;23,0;7,0;2,0;53,0;2,0;8,0;34,0;;1,0;28,0;1,0;4,0;25,0;;24,0;3,0;;4,0;12,0;1,0;1,0;4,0;8,0;33,0;9,0;12,0;;;1,0;1,0;1,0;3,0;150,0;9,0;5,0;7,0;3,0;;128,0;7,0;8,0;5,0;;4,0;;17,0;1,0;18,0;7,0;2,0;;9,0;;23,0;7,0;3,0;2,0;7,0;14,0;1,0;;;2,0;7,0;3,0;;3,0;;5,0;19,0;3,0;2,0;11,0;1,0;1,0;13,0;;;2,0;3,0;;;6,0;6,0;3,0;64,0;14,0;9,0;;3,0;5,0;20,0;33,0;7,0;4,0;20,0;3,0;51,0;;1,0;4,0;19,0;3,0;;4,0;;2,0;;4,0;10,0;1,0;2,0;20,0;18,0;1,0;1,0;3,0;;3,0;7,0;;1,0;;13,0;;3,0;5,0;1,0;;26,0;1,0;2,0;;2,0;1,0;2,0;2,0;3,0;3,0;4,0;2,0;4,0;1,0;;4,0;;3,0;;1,0;14,0;4,0;;;1,0;2,0;23,0;1,0;3,0;4,0;8,0;3,0;;;;;9,0;1,0;1,0;1,0;;;;1,0;;1,0;16,0;;;2,0;;;8,0;;;;5,0;5,0;;;;10,0;1,0;1,0;6,0;10,0;64,0;;3,0;1,0;;;6,0;;6,0;;8,0;1,0;9,0;;;5,0;7,0;8,0;3,0;9,0;1,0;19,0;2,0;;;3,0;1,0;2,0;1,0;6,0;14,0;1,0;2,0;;12,0;141,0;;;7,0;;7,0;5,0;7,0;7,0;;4,0;9,0;1,0;7,0;1,0;10,0;14,0;12,0;2,0;10,0;;;;2,0;7,0;43,0;130,0;5,0;4,0;2,0;;3,0;;8,0;;;1,0;4,0;32,0;6,0;;26,0;2,0;1,0;;2,0;;4,0;4,0;8,0;;20,0;1,0;;2,0;3,0;81,0;;1,0;3,0;10,0;;8,0;2,0;13,0;1,0;;15,0;2,0;;3,0;12,0;2,0;77,0;;;3,0;;;5,0;;;17,0;6,0;;1,0;;;1,0;;2,0;;32,0;1,0;8,0;5,0;;6,0;4,0;;;;1,0;;1,0;;4,0;6,0;3,0;34,0;7,0;;;;5,0;9,0;;;;1,0;2,0;;2,0;;2,0;16,0;;;;;12,0;;;;;;;3,0;;11,0;;5,0;5,0;1,0;;;1,0;;2,0;;;1,0;;;1,0;;1,0;2,0;5,0;2,0;7,0;;2,0;4,0;2,0;2,0;;18,0;;1,0;;;;5,0;3,0;;4,0;1,0;8,0;2,0;;2,0;26,0;2,0;;;;2,0;;6,0;;;5,0;7,0;2,0;11,0;;;5,0;2,0;1,0;;3,0;;;2,0;;5,0;;2,0;;;2,0;1,0;;2,0;;;;;6,0;2,0;;5,0;;21,0;2,0;2,0;3,0;3,0;1,0;;;;1,0;;2,0;;5,0;;;4,0;;7,0;3,0;;;52,0;13,0;;1,0;;;6,0;;;3,0;17,0;;3,0;;2,0;37,0;;14,0;;2,0;;;;1,0;;1,0;10,0;1,0;;3,0;;5,0;;;;;;;1,0;;2,0;1,0;;1,0;;;2,0;;1,0;1,0;;;;;;;2,0;;6,0;18,0;19,0;1,0;;;;2,0;;4,0;;1,0;;;;;
multiple;;2,0;1,0;19,0;4,0;41,0;54,0;33,0;;;;11,0;9,0;57,0;;14,0;185,0;;27,0;20,0;1,0;;58,0;2,0;2,0;1,0;16,0;20,0;10,0;5,0;86,0;8,0;9,0;;;86,0;8,0;21,0;76,0;2,0;70,0;156,0;21,0;42,0;37,0;11,0;9,0;170,0;;13,0;24,0;2,0;5,0;3,0;113,0;13,0;44,0;10,0;42,0;55,0;;;127,0;;787,0;1,0;355,0;;10,0;2,0;3,0;293,0;43,0;;5,0;;1,0;20,0;12,0;6,0;191,0;11,0;28,0;10,0;55,0;20,0;2,0;127,0;;24,0;22,0;3,0;;1,0;7,0;2,0;69,0;15,0;29,0;100,0;80,0;7,0;3,0;17,0;22,0;51,0;13,0;14,0;1,0;;1,0;57,0;69,0;28,0;;6,0;100,0;46,0;28,0;102,0;26,0;3,0;29,0;7,0;14,0;5,0;214,0;;9,0;;56,0;3,0;;35,0;4,0;;173,0;19,0;163,0;;;12,0;1,0;;9,0;8,0;45,0;35,0;70,0;1,0;;12,0;7,0;;9,0;;;;;;2,0;10,0;4,0;;2,0;6,0;21,0;4,0;;1,0;24,0;;6,0;39,0;;;;6,0;13,0;;2,0;;1,0;22,0;;1,0;41,0;;52,0;8,0;5,0;19,0;;4,0;6,0;2,0;19,0;2,0;2,0;1,0;;11,0;18,0;;4,0;12,0;12,0;;18,0;27,0;16,0;5,0;;1,0;3,0;;12,0;7,0;;11,0;21,0;16,0;16,0;;8,0;;31,0;2,0;;7,0;;4,0;24,0;;4,0;3,0;2,0;10,0;;17,0;;4,0;1,0;;6,0;53,0;3,0;7,0;7,0;;2,0;2,0;4,0;13,0;2,0;1,0;25,0;25,0;8,0;;10,0;3,0;12,0;27,0;4,0;;;9,0;8,0;21,0;;;2,0;4,0;;;2,0;26,0;;5,0;3,0;13,0;13,0;5,0;;1,0;1,0;3,0;5,0;2,0;;7,0;;;;;86,0;;;2,0;2,0;;5,0;;;;1,0;5,0;4,0;24,0;;;1,0;4,0;;;13,0;;1,0;9,0;18,0;84,0;;10,0;3,0;;;;12,0;3,0;;;1,0;4,0;20,0;;;;2,0;1,0;5,0;2,0;1,0;1,0;;3,0;10,0;2,0;2,0;6,0;;1,0;12,0;;14,0;5,0;;3,0;139,0;4,0;1,0;;1,0;4,0;;1,0;2,0;8,0;1,0;;1,0;;43,0;4,0;4,0;2,0;21,0;5,0;7,0;2,0;44,0;8,0;6,0;3,0;4,0;31,0;5,0;25,0;4,0;15,0;;5,0;6,0;16,0;3,0;15,0;;35,0;13,0;4,0;;22,0;4,0;8,0;;23,0;1,0;12,0;18,0;7,0;5,0;7,0;2,0;12,0;17,0;3,0;3,0;;;;;6,0;2,0;8,0;;64,0;5,0;9,0;3,0;;11,0;;12,0;7,0;12,0;;4,0;34,0;7,0;6,0;25,0;1,0;2,0;6,0;1,0;12,0;1,0;3,0;50,0;;6,0;1,0;;7,0;2,0;2,0;2,0;23,0;;20,0;46,0;3,0;2,0;7,0;;3,0;;1,0;;1,0;7,0;1,0;17,0;24,0;6,0;8,0;;;4,0;;;1,0;9,0;;5,0;7,0;37,0;;;11,0;;3,0;43,0;7,0;2,0;;3,0;3,0;3,0;1,0;20,0;70,0;4,0;3,0;12,0;3,0;10,0;;;12,0;6,0;1,0;;;1,0;3,0;;;4,0;3,0;9,0;5,0;8,0;2,0;;2,0;1,0;4,0;2,0;;;5,0;2,0;2,0;;1,0;1,0;5,0;1,0;33,0;6,0;4,0;11,0;;;1,0;;;2,0;2,0;;;4,0;2,0;3,0;11,0;;4,0;;1,0;1,0;5,0;2,0;;1,0;;4,0;3,0;11,0;4,0;2,0;1,0;;;4,0;13,0;;4,0;;14,0;;;14,0;2,0;3,0;7,0;4,0;8,0;28,0;13,0;1,0;1,0;;4,0;;;;;7,0;;;;;48,0;1,0;1,0;20,0;4,0;2,0;2,0;8,0;;2,0;3,0;1,0;4,0;4,0;1,0;6,0;7,0;3,0;;8,0;24,0;;1,0;2,0;;;1,0;;;6,0;5,0;;;;1,0;1,0;8,0;4,0;3,0;;1,0;3,0;5,0;;2,0;;;;1,0;12,0;3,0;2,0;2,0;4,0;7,0;13,0;15,0;5,0;;5,0;3,0;19,0;;1,0;5,0;;;33,0;1,0;2,0;;14,0;13,0;3,0;1,0;20,0;8,0;1,0;7,0;;;;4,0;8,0;2,0;4,0;;;1,0;14,0;;;19,0;;1,0;;1,0;;2,0;12,0;3,0;4,0;;1,0;;;;3,0;3,0;;3,0;;5,0;;2,0;;32,0;2,0;;;;4,0;4,0;;;4,0;;;;2,0;;24,0;;;;;;4,0;2,0;2,0;9,0;;1,0;5,0;2,0;1,0;3,0;;;;;1,0;5,0;2,0;;;4,0;;;;;;;;10,0;;4,0;9,0;;8,0;;;2,0;19,0;;;;;;;4,0;;54,0;;2,0;;;;;3,0;;;;;;;;;;4,0;13,0;;1,0;;;3,0;19,0;1,0;12,0;3,0;;2,0;22,0;1,0;;;4,0;;7,0;;;10,0;1,0;;1,0;;3,0;10,0;;2,0;;;7,0;;1,0;2,0;;;2,0;3,0;;;4,0;1,0;;1,0;;9,0;8,0;;;6,0;1,0;8,0;16,0;;14,0;;12,0;1,0;;;;;;8,0;6,0;2,0;3,0;;11,0;7,0;;;6,0;13,0;1,0;1,0;2,0;2,0;1,0;14,0;1,0;;;;;;2,0;1,0;;1,0;;;1,0;3,0;;;1,0;;2,0;1,0;;6,0;2,0;1,0;;;;3,0;;;;;;;2,0;;1,0;1,0;;4,0;;8,0;;1,0;;;;;1,0;10,0;;1,0;;;;3,0;;;1,0;;12,0;1,0;4,0;;;10,0;;;;;1,0;;;;;1,0;5,0;;3,0;;;;;;;70,0;1,0;4,0;;4,0;;1,0;1,0;1,0;;;12,0;3,0;;14,0;;3,0;2,0;3,0;;;22,0;;2,0;;;1,0;;;
notification;;7,0;;2,0;;15,0;;;;;;;;13,0;;;9,0;;;;;;;;4,0;;;2,0;2,0;7,0;33,0;3,0;;;;9,0;;1,0;;;15,0;89,0;;1,0;42,0;1,0;;1,0;;8,0;;;;6,0;1,0;;1,0;;;7,0;;;2,0;1,0;35,0;2,0;44,0;;;;;7,0;6,0;;;;;2,0;3,0;1,0;40,0;;2,0;;2,0;;;2,0;;;;3,0;;2,0;1,0;;2,0;;9,0;4,0;2,0;6,0;;1,0;1,0;13,0;;;1,0;;;;1,0;;;3,0;;;;4,0;;;39,0;2,0;;2,0;41,0;;;;11,0;;;48,0;;;5,0;;3,0;;;;;;6,0;;2,0;;11,0;1,0;;;4,0;;;;;;;;;;10,0;;;;1,0;;;22,0;;;1,0;1,0;;;;1,0;3,0;;;;;3,0;;;1,0;;2,0;;;;;;;;2,0;;;;;;1,0;;2,0;2,0;1,0;;;3,0;;;;;;;28,0;;;;;4,0;3,0;;;;15,0;;;5,0;;;2,0;2,0;;;;;;6,0;;;;;;8,0;1,0;;;;;;;1,0;;;;;;;;22,0;;19,0;;;;;;;;;;;;;1,0;;;;;;;1,0;;;;9,0;2,0;;;6,0;;;;;;2,0;;;;;;;;;;;;;;;;6,0;;;;;;;9,0;6,0;1,0;;;;3,0;;4,0;;;;;;4,0;;7,0;;3,0;;;;;;;;;1,0;;;;;;;;;3,0;;15,0;13,0;;;;10,0;1,0;1,0;;;;;;9,0;2,0;;6,0;1,0;;3,0;;;54,0;;;;1,0;10,0;3,0;;;19,0;3,0;1,0;;;3,0;7,0;;11,0;53,0;5,0;;1,0;;2,0;;15,0;;5,0;6,0;3,0;3,0;2,0;;4,0;49,0;3,0;;;;;;;;;;49,0;7,0;29,0;5,0;;;2,0;5,0;2,0;;;6,0;;7,0;;;;4,0;;;;;;46,0;;;;2,0;;;;;;;2,0;14,0;2,0;;8,0;;;;;;;4,0;2,0;6,0;8,0;;;;5,0;;14,0;;;;;4,0;;5,0;;4,0;;;;;;;1,0;1,0;6,0;;;;17,0;;;;;;2,0;;;6,0;;;;;;;;;;2,0;;;;;;;;;;;;;;;;;;;20,0;;;;;;1,0;;;;1,0;;;2,0;;9,0;;;2,0;;10,0;;14,0;2,0;;7,0;;7,0;;;;;;;;;;;;;;;2,0;;;;;;1,0;1,0;;1,0;;;;3,0;;;;3,0;;1,0;1,0;;3,0;;;;;;;;;;;;;3,0;;;;5,0;4,0;;1,0;;;;;;;;;;5,0;;;;;;;3,0;;;;;;;;;;2,0;;5,0;3,0;;;;;;;;39,0;2,0;1,0;;;;;;3,0;;3,0;;33,0;;;;2,0;9,0;;;;;4,0;3,0;4,0;;;;;;;;;;;3,0;;;;1,0;;;;3,0;;;;;;;;;;;3,0;;;3,0;;12,0;;;;1,0;;;;;;;2,0;;;;;;;;;3,0;;;;;;;6,0;;;;;;;;;;;;;;;;;;6,0;;;;;;;;;;;;;;;;;;2,0;;;;;;;;;;;;;;;8,0;;;;;3,0;;;;;;;;;;;;;;2,0;;;;;;;;;;;;;;;;;;;;;;3,0;;;;;;;1,0;;;;6,0;2,0;;;;;;;;;;1,0;;;;;;;;;;;;;;;;;;;;;8,0;;;;;;;;;;;1,0;;;;;2,0;;1,0;;;;8,0;;;;;;;;;6,0;;;;;;;;;;;;;;;;;;;;;;;;;;;1,0;;;;;;;;;;;;;;;;;;;;;;;;;;;;;;;;;;;;;;;;;;;;;;;;;;;;;;2,0;;;;;
object;;9,0;5,0;99,0;51,0;351,0;41,0;121,0;47,0;93,0;19,0;;6,0;1271,0;5,0;12,0;1033,0;1,0;15,0;194,0;6,0;6,0;145,0;16,0;14,0;8,0;5,0;40,0;104,0;40,0;605,0;102,0;31,0;12,0;2,0;971,0;100,0;64,0;429,0;17,0;1742,0;901,0;11,0;96,0;622,0;96,0;7,0;144,0;5,0;22,0;153,0;;5,0;28,0;468,0;89,0;213,0;4,0;29,0;475,0;13,0;11,0;391,0;5,0;5686,0;5,0;972,0;23,0;20,0;5,0;53,0;1408,0;852,0;3,0;17,0;;29,0;136,0;40,0;83,0;1328,0;;101,0;307,0;180,0;97,0;3,0;475,0;19,0;314,0;85,0;15,0;87,0;12,0;116,0;37,0;239,0;187,0;732,0;808,0;1202,0;290,0;;89,0;193,0;235,0;31,0;49,0;77,0;11,0;8,0;452,0;553,0;28,0;1,0;32,0;44,0;173,0;548,0;440,0;120,0;43,0;213,0;261,0;3,0;154,0;1020,0;19,0;30,0;4,0;268,0;26,0;13,0;522,0;19,0;8,0;595,0;226,0;80,0;;1,0;33,0;7,0;3,0;60,0;57,0;293,0;183,0;374,0;24,0;3,0;36,0;61,0;14,0;12,0;3,0;1,0;2,0;4,0;1,0;2,0;44,0;53,0;78,0;3,0;13,0;31,0;124,0;11,0;392,0;67,0;;79,0;236,0;;109,0;16,0;54,0;12,0;4,0;12,0;29,0;2,0;116,0;1,0;2,0;72,0;12,0;385,0;93,0;;43,0;;40,0;3,0;1,0;62,0;41,0;2,0;18,0;;7,0;9,0;;251,0;41,0;40,0;1,0;47,0;58,0;186,0;420,0;24,0;;;37,0;106,0;9,0;16,0;172,0;230,0;25,0;57,0;5,0;10,0;1,0;412,0;3,0;10,0;67,0;10,0;38,0;90,0;31,0;21,0;137,0;346,0;51,0;1,0;259,0;;3,0;2,0;;;308,0;63,0;116,0;1460,0;2,0;1,0;;;98,0;3,0;17,0;36,0;832,0;58,0;104,0;6,0;117,0;54,0;483,0;9,0;68,0;67,0;26,0;11,0;38,0;;3,0;13,0;33,0;22,0;;19,0;123,0;;18,0;4,0;12,0;68,0;6,0;121,0;;1,0;42,0;23,0;8,0;7,0;19,0;3,0;2,0;94,0;;1023,0;6,0;3,0;4,0;;;3,0;18,0;4,0;;6,0;38,0;87,0;276,0;1,0;;43,0;;16,0;1,0;328,0;7,0;31,0;9,0;55,0;;7,0;119,0;7,0;2,0;40,0;;141,0;25,0;2,0;1,0;1,0;1,0;77,0;3,0;1,0;;5,0;;64,0;55,0;4,0;5,0;5,0;13,0;69,0;229,0;37,0;;1,0;3,0;127,0;;783,0;;24,0;14,0;393,0;6,0;74,0;13,0;;62,0;8,0;10,0;84,0;16,0;21,0;9,0;;3,0;239,0;63,0;160,0;25,0;19,0;23,0;150,0;35,0;416,0;399,0;4,0;34,0;63,0;1148,0;109,0;60,0;6,0;29,0;15,0;46,0;184,0;217,0;26,0;64,0;6,0;711,0;144,0;37,0;6,0;143,0;6,0;85,0;8,0;546,0;30,0;113,0;267,0;39,0;5,0;956,0;53,0;25,0;76,0;230,0;;8,0;19,0;182,0;4,0;24,0;16,0;30,0;25,0;247,0;37,0;170,0;15,0;8,0;53,0;6,0;88,0;6,0;71,0;6,0;86,0;122,0;16,0;16,0;27,0;3,0;83,0;60,0;13,0;83,0;30,0;34,0;334,0;37,0;29,0;4,0;27,0;1,0;;;18,0;165,0;1,0;27,0;162,0;21,0;49,0;45,0;16,0;10,0;22,0;1,0;20,0;20,0;42,0;40,0;46,0;71,0;7,0;2,0;23,0;7,0;7,0;45,0;;56,0;1,0;84,0;37,0;42,0;179,0;264,0;11,0;110,0;50,0;73,0;7,0;146,0;11,0;12,0;87,0;14,0;5,0;2,0;49,0;31,0;13,0;115,0;75,0;16,0;50,0;37,0;10,0;58,0;31,0;18,0;8,0;1,0;31,0;27,0;1,0;195,0;;;9,0;4,0;8,0;39,0;29,0;8,0;4,0;1,0;2,0;5,0;5,0;25,0;;29,0;30,0;18,0;12,0;46,0;33,0;275,0;51,0;10,0;12,0;13,0;8,0;60,0;;11,0;;71,0;18,0;14,0;110,0;91,0;10,0;24,0;9,0;34,0;1,0;97,0;22,0;24,0;29,0;37,0;33,0;10,0;109,0;;11,0;41,0;1,0;17,0;;2,0;46,0;6,0;7,0;61,0;1,0;44,0;6,0;;73,0;;27,0;3,0;31,0;1,0;24,0;41,0;3,0;49,0;7,0;19,0;3,0;5,0;10,0;65,0;195,0;5,0;75,0;7,0;7,0;338,0;27,0;66,0;4,0;30,0;6,0;10,0;15,0;13,0;31,0;24,0;;1,0;34,0;57,0;80,0;12,0;8,0;3,0;40,0;602,0;;1,0;17,0;2,0;8,0;11,0;;;1,0;17,0;;;2,0;4,0;4,0;2,0;;15,0;13,0;8,0;18,0;28,0;22,0;;2,0;8,0;2,0;13,0;11,0;3,0;50,0;34,0;237,0;6,0;84,0;16,0;27,0;46,0;4,0;8,0;17,0;;;1,0;;;104,0;;68,0;10,0;4,0;9,0;5,0;8,0;851,0;23,0;9,0;6,0;;15,0;4,0;28,0;24,0;;4,0;4,0;15,0;;3,0;12,0;5,0;28,0;1,0;24,0;1,0;4,0;;9,0;20,0;17,0;42,0;5,0;1,0;21,0;2,0;;8,0;;22,0;;14,0;103,0;;3,0;5,0;12,0;24,0;14,0;;6,0;5,0;7,0;;19,0;33,0;23,0;4,0;9,0;;39,0;330,0;20,0;18,0;;69,0;2,0;211,0;1,0;13,0;1,0;3,0;11,0;28,0;98,0;10,0;5,0;2,0;2,0;2,0;2,0;6,0;100,0;43,0;17,0;2,0;4,0;7,0;11,0;6,0;7,0;;1,0;1,0;;15,0;2,0;36,0;1,0;43,0;;;;;;;1,0;3,0;;;4,0;4,0;19,0;1,0;58,0;11,0;;;;36,0;;;;7,0;13,0;6,0;;;1,0;1,0;31,0;2,0;21,0;;1,0;41,0;1,0;3,0;18,0;;;4,0;60,0;4,0;3,0;15,0;2,0;;58,0;96,0;4,0;2,0;6,0;8,0;37,0;5,0;;35,0;;27,0;20,0;21,0;18,0;7,0;6,0;2,0;7,0;3,0;;28,0;;10,0;15,0;4,0;26,0;11,0;;32,0;18,0;8,0;12,0;31,0;4,0;110,0;22,0;5,0;3,0;157,0;164,0;2,0;;8,0;6,0;5,0;19,0;10,0;10,0;3,0;36,0;18,0;120,0;33,0;7,0;17,0;2,0;17,0;40,0;;2,0;6,0;3,0;12,0;185,0;;16,0;1,0;119,0;5,0;11,0;2,0;20,0;2,0;2,0;;;4,0;;;5,0;4,0;7,0;11,0;5,0;;13,0;13,0;12,0;1,0;63,0;3,0;;2,0;12,0;6,0;2,0;44,0;4,0;12,0;;2,0;;;175,0;14,0;;15,0;92,0;34,0;;;13,0;10,0;1,0;;2,0;2,0;4,0;;;11,0;;3,0;2,0;28,0;72,0;;;31,0;;29,0;114,0;11,0;15,0;1,0;4,0;5,0;10,0;1,0;16,0;16,0;9,0;4,0;5,0;1,0;58,0;5,0;1,0;63,0;37,0;4,0;1,0;13,0;5,0;5,0;20,0;;22,0;;5,0;9,0;2,0;37,0;10,0;1,0;;55,0;9,0;3,0;;1,0;;5,0;;2,0;10,0;2,0;
objective;;1,0;;19,0;1,0;3,0;6,0;13,0;;;;;3,0;17,0;;;5,0;;3,0;;3,0;;6,0;;;;1,0;6,0;3,0;;33,0;;;;;5,0;20,0;;;2,0;5,0;53,0;1,0;1,0;1,0;12,0;1,0;91,0;;12,0;9,0;1,0;2,0;2,0;6,0;5,0;47,0;;;5,0;1,0;;;;171,0;3,0;70,0;1,0;4,0;;3,0;337,0;62,0;1,0;1,0;;10,0;;2,0;2,0;35,0;;;;55,0;2,0;1,0;108,0;3,0;2,0;;4,0;11,0;;2,0;;13,0;103,0;33,0;2,0;65,0;2,0;4,0;1,0;1,0;6,0;1,0;9,0;;;;4,0;10,0;;;;;3,0;3,0;142,0;;;2,0;;23,0;1,0;43,0;;1,0;;;;;38,0;;;13,0;;1,0;;;2,0;;;7,0;2,0;45,0;21,0;5,0;1,0;;4,0;18,0;1,0;;;2,0;5,0;;;;17,0;;;;;18,0;4,0;;2,0;;;1,0;6,0;;7,0;;4,0;;;;;1,0;49,0;;;7,0;4,0;3,0;29,0;;;;6,0;123,0;;48,0;12,0;59,0;12,0;;;;;4,0;;3,0;;1,0;95,0;1,0;3,0;2,0;3,0;;76,0;7,0;10,0;;6,0;4,0;;;;3,0;;70,0;2,0;3,0;24,0;3,0;3,0;4,0;;2,0;;5,0;;;1,0;;2,0;2,0;;13,0;6,0;6,0;11,0;47,0;1,0;;;;2,0;4,0;1,0;12,0;82,0;12,0;;;2,0;;10,0;2,0;;;4,0;;98,0;2,0;;;5,0;;;3,0;16,0;6,0;25,0;;;57,0;3,0;;;26,0;6,0;15,0;2,0;;;;5,0;4,0;;8,0;;3,0;3,0;6,0;;;;;10,0;;19,0;14,0;65,0;;;4,0;;;;11,0;;5,0;;;12,0;2,0;2,0;;;;;;5,0;;;;3,0;2,0;1,0;;;;;;4,0;2,0;3,0;;3,0;3,0;5,0;;;;;;;1,0;50,0;;2,0;6,0;;;;;2,0;;6,0;;3,0;;3,0;;;1,0;4,0;7,0;3,0;4,0;;;;19,0;;;;1,0;2,0;;13,0;;;;;;12,0;;66,0;;;;;;;;;2,0;;;;;1,0;;4,0;;1,0;;2,0;;;;;;;1,0;;;22,0;10,0;;;;;;1,0;;;;2,0;64,0;;;6,0;;;16,0;;1,0;;;12,0;;;;;;;;;;;;;;;2,0;;;;;;;4,0;;9,0;4,0;;1,0;;;;2,0;;3,0;;11,0;;;8,0;;;;;;1,0;1,0;;;3,0;;;;;;6,0;;;11,0;;;1,0;;;;;;;2,0;32,0;;;;37,0;;;;;;;;5,0;;;;;9,0;1,0;;4,0;;1,0;;;4,0;;6,0;;;;1,0;;;;14,0;;;;;;;2,0;;2,0;;;3,0;;;8,0;;;;;;;;10,0;6,0;;;;;;;7,0;;;;5,0;;;;;;;4,0;;;;2,0;;;1,0;;;4,0;;;;;;;;;;;;1,0;;;;5,0;;;;;;;2,0;;;;;;;;;;;;11,0;;;2,0;5,0;5,0;;2,0;;;;;;;3,0;;;;;;;;;;;;6,0;1,0;;;;;8,0;;;;;;;;30,0;;;2,0;;;;;;;34,0;;;;;;;18,0;;;;;;;;;;;14,0;;15,0;;18,0;11,0;1,0;;8,0;13,0;;1,0;19,0;;;1,0;;;;3,0;;4,0;;;;;;2,0;26,0;;;;;;;;;8,0;;;4,0;2,0;;;;;;;;3,0;;4,0;3,0;;;;;;;;;;;;4,0;;3,0;3,0;;;;1,0;2,0;;;;;3,0;;;;1,0;;;;;;;;;;1,0;;;;;;1,0;;;;;;;;;;;;;6,0;;;;;6,0;;;;;;11,0;;;;;;;;3,0;;;;;;;;4,0;;;;1,0;;;;;;;;;;;;;;1,0;;;;;;;;;;;;1,0;;;;;;;;;;;;;;;;;;;;1,0;;;;;7,0;;;;;;;;;;2,0;;;;;;;;;;;;;;;;;;1,0;;;3,0;;;;;;;;;;;;;;;;;1,0;;;;;;;2,0;;;;1,0;;;;;;4,0;;;;3,0;;;;;;;;;;;;;;;;;;;;;4,0;;;;;;;;;;;
occur;;1,0;;12,0;4,0;9,0;9,0;1,0;2,0;;;;;25,0;;;28,0;;4,0;;;;5,0;;6,0;1,0;;3,0;1,0;26,0;8,0;4,0;11,0;3,0;;32,0;;;14,0;;81,0;38,0;;3,0;16,0;;8,0;4,0;;25,0;;;;2,0;;;2,0;;1,0;8,0;;;;;89,0;1,0;8,0;;;;;9,0;11,0;1,0;;;1,0;1,0;;5,0;71,0;;13,0;4,0;11,0;;;13,0;;3,0;;3,0;;;;;41,0;;28,0;15,0;24,0;11,0;;3,0;7,0;6,0;;2,0;;;1,0;8,0;37,0;;;;1,0;14,0;3,0;4,0;3,0;;11,0;;;8,0;17,0;;;;86,0;;;5,0;8,0;;4,0;3,0;14,0;;;1,0;;;;6,0;36,0;11,0;26,0;2,0;;20,0;1,0;1,0;;;;;;;;6,0;2,0;;;;4,0;4,0;2,0;11,0;2,0;2,0;1,0;4,0;1,0;2,0;1,0;;;2,0;;;;;;;1,0;;9,0;;;;;;1,0;;1,0;1,0;;;;1,0;;;;3,0;2,0;;;1,0;;16,0;;;;;6,0;4,0;;;1,0;31,0;1,0;4,0;;;13,0;1,0;2,0;;;;;;;1,0;;1,0;;;;5,0;;;;7,0;2,0;;1,0;;;;;;2,0;17,0;;;;;;15,0;;6,0;;1,0;;;;9,0;;;3,0;2,0;;;1,0;1,0;;;;2,0;8,0;;;;;;18,0;;2,0;8,0;;;;;3,0;;;;;;;1,0;;;;1,0;;10,0;;;3,0;;;;2,0;;;;13,0;5,0;1,0;2,0;;;;;9,0;;;;;;1,0;;;;;;;4,0;;;;;13,0;;;;;;4,0;;2,0;;2,0;;21,0;6,0;;;;1,0;;;1,0;;;;;;5,0;2,0;41,0;;;4,0;;3,0;7,0;5,0;7,0;;;12,0;6,0;2,0;;65,0;;2,0;;;3,0;1,0;;3,0;15,0;;;9,0;;1,0;3,0;8,0;;1,0;59,0;;;;;2,0;3,0;3,0;;4,0;;;;6,0;;;;9,0;4,0;19,0;7,0;;1,0;;3,0;;7,0;2,0;8,0;;2,0;1,0;;4,0;5,0;11,0;;1,0;6,0;;15,0;;;4,0;;;;;1,0;8,0;9,0;;3,0;1,0;8,0;;3,0;;;1,0;;;3,0;4,0;7,0;4,0;;;;;2,0;4,0;;;;4,0;;;4,0;;1,0;4,0;;1,0;;;;;10,0;;;;;6,0;;9,0;4,0;3,0;;;;1,0;1,0;3,0;;;;;2,0;;;;1,0;;;1,0;;;;;1,0;;2,0;20,0;;;5,0;;;4,0;;4,0;;1,0;;;;1,0;;;2,0;;;;2,0;2,0;1,0;1,0;;;;;;3,0;;1,0;1,0;;3,0;;;12,0;;;1,0;;;;;1,0;;;;;2,0;;;;;;;;;;2,0;;1,0;;;;9,0;;;;;4,0;4,0;;;3,0;;;1,0;;;;3,0;;;;1,0;;5,0;;2,0;11,0;2,0;;;;;2,0;;;;4,0;;10,0;;;;3,0;;;;;;;;;;;5,0;4,0;;3,0;;;1,0;4,0;3,0;1,0;;3,0;3,0;;13,0;;;;;;2,0;;;13,0;3,0;;;;4,0;;1,0;;;9,0;;18,0;;;;1,0;;;3,0;;4,0;3,0;;;;;;;13,0;3,0;4,0;;;;;;;;;;;;1,0;;;3,0;;;;1,0;;;;;;;;;;;6,0;;;;;;9,0;;3,0;;;;;1,0;;;;;;;;;;;;;;;;;;;;;2,0;;3,0;;;;;;;;1,0;;;;1,0;1,0;1,0;;1,0;;;;;;;;;;;2,0;;;;;;26,0;;;;;;;;;;;11,0;;2,0;3,0;;10,0;;;;;;;;3,0;1,0;1,0;;6,0;2,0;;;5,0;;2,0;;;1,0;1,0;;;;1,0;;;;;;;;1,0;;;;;;;;1,0;2,0;;;;;;;;1,0;2,0;3,0;1,0;;;;1,0;;;2,0;;35,0;;;;;;;;;;;;;2,0;1,0;;;;2,0;5,0;;;;;;3,0;2,0;2,0;;2,0;;;;;;;;;;;2,0;;;;1,0;;1,0;;;;;3,0;;;;;;1,0;;;4,0;;;;;;1,0;;;;;;;;;;;2,0;;;3,0;;;;;;;;;;1,0;;;2,0;;;;;;;;;5,0;;2,0;;;;;;;;2,0;;;;;
open;;12,0;;6,0;6,0;52,0;6,0;133,0;;;2,0;;35,0;179,0;;4,0;47,0;1,0;109,0;;8,0;1,0;78,0;14,0;80,0;1,0;;69,0;8,0;;180,0;27,0;2,0;1,0;2,0;17,0;128,0;7,0;20,0;3,0;37,0;243,0;105,0;4,0;27,0;152,0;2,0;164,0;;;;5,0;145,0;12,0;22,0;10,0;354,0;1,0;2,0;9,0;7,0;;14,0;;198,0;2,0;282,0;8,0;3,0;14,0;92,0;381,0;201,0;5,0;1,0;;87,0;;1,0;21,0;157,0;;13,0;2,0;196,0;30,0;;69,0;2,0;11,0;4,0;65,0;64,0;9,0;11,0;1,0;81,0;25,0;102,0;34,0;599,0;11,0;1,0;4,0;9,0;12,0;9,0;2,0;6,0;;;7,0;88,0;12,0;15,0;;;35,0;2,0;174,0;1,0;2,0;22,0;59,0;;3,0;89,0;2,0;3,0;20,0;37,0;;2,0;150,0;3,0;;48,0;1,0;9,0;;;53,0;6,0;;52,0;43,0;88,0;79,0;9,0;39,0;15,0;65,0;228,0;59,0;;9,0;;2,0;;18,0;28,0;83,0;;;;2,0;84,0;225,0;1,0;17,0;3,0;;10,0;127,0;15,0;71,0;11,0;10,0;6,0;;3,0;4,0;75,0;105,0;62,0;63,0;63,0;7,0;64,0;185,0;;11,0;16,0;39,0;50,0;69,0;421,0;27,0;114,0;77,0;44,0;127,0;3,0;16,0;2,0;;204,0;33,0;14,0;201,0;64,0;24,0;6,0;15,0;24,0;83,0;7,0;9,0;;11,0;49,0;14,0;;14,0;124,0;8,0;571,0;2,0;18,0;2,0;25,0;4,0;5,0;2,0;55,0;1,0;9,0;5,0;1,0;2,0;2,0;162,0;8,0;25,0;38,0;9,0;13,0;172,0;359,0;35,0;39,0;4,0;8,0;64,0;61,0;12,0;43,0;299,0;26,0;;;12,0;5,0;32,0;112,0;;;;;76,0;14,0;28,0;38,0;18,0;7,0;;32,0;53,0;7,0;9,0;16,0;4,0;47,0;64,0;;5,0;36,0;183,0;43,0;16,0;9,0;71,0;2,0;61,0;31,0;18,0;27,0;9,0;9,0;38,0;20,0;12,0;29,0;19,0;3,0;23,0;12,0;13,0;4,0;41,0;5,0;19,0;43,0;34,0;29,0;12,0;54,0;29,0;8,0;37,0;2,0;13,0;37,0;8,0;19,0;12,0;11,0;13,0;11,0;29,0;13,0;4,0;5,0;77,0;6,0;25,0;26,0;;1,0;;23,0;14,0;1,0;15,0;15,0;19,0;42,0;60,0;2,0;46,0;3,0;6,0;;8,0;1,0;13,0;17,0;92,0;41,0;10,0;;;;4,0;2,0;6,0;;;;6,0;5,0;1,0;1,0;65,0;7,0;1,0;1,0;6,0;;;72,0;;7,0;1,0;;46,0;5,0;6,0;;6,0;2,0;1,0;3,0;25,0;5,0;5,0;3,0;1,0;9,0;;;8,0;2,0;1,0;2,0;6,0;;3,0;4,0;8,0;13,0;20,0;;33,0;31,0;10,0;4,0;;;;;3,0;3,0;;;181,0;3,0;7,0;10,0;;15,0;;11,0;7,0;4,0;2,0;48,0;3,0;16,0;;18,0;6,0;6,0;;;;;1,0;30,0;;;;6,0;7,0;38,0;9,0;;1,0;16,0;6,0;6,0;3,0;;6,0;;;;1,0;1,0;;;3,0;1,0;20,0;21,0;6,0;;9,0;;1,0;18,0;;12,0;;12,0;;21,0;;13,0;;;;;9,0;2,0;5,0;13,0;4,0;;4,0;;;7,0;1,0;;10,0;14,0;1,0;6,0;;4,0;;11,0;8,0;3,0;;6,0;447,0;73,0;9,0;39,0;13,0;;12,0;3,0;;41,0;;41,0;;25,0;1,0;;17,0;11,0;1,0;3,0;3,0;16,0;4,0;;57,0;6,0;;;3,0;;7,0;9,0;1,0;2,0;25,0;;;3,0;1,0;;;;;4,0;9,0;3,0;7,0;;;;1,0;74,0;6,0;2,0;1,0;3,0;23,0;153,0;8,0;;;28,0;5,0;;28,0;11,0;23,0;9,0;58,0;28,0;;2,0;;1,0;;;;196,0;;;44,0;19,0;;;;1,0;2,0;4,0;25,0;;22,0;;12,0;1,0;;;17,0;5,0;22,0;10,0;2,0;2,0;3,0;;1,0;2,0;;;;3,0;;;2,0;11,0;;;6,0;8,0;;;24,0;9,0;10,0;;1,0;;7,0;3,0;2,0;3,0;16,0;;13,0;1,0;1,0;1,0;;;9,0;2,0;;1,0;;;4,0;;1,0;201,0;21,0;;;11,0;;16,0;;5,0;6,0;;;;2,0;;;;;;1,0;;4,0;;6,0;34,0;2,0;;32,0;1,0;11,0;;38,0;3,0;47,0;;4,0;;;2,0;34,0;22,0;18,0;7,0;15,0;1,0;;10,0;;;;5,0;12,0;;1,0;5,0;8,0;5,0;4,0;14,0;;;18,0;16,0;6,0;1,0;;;1,0;3,0;1,0;14,0;;4,0;26,0;9,0;14,0;;14,0;2,0;26,0;7,0;2,0;3,0;14,0;7,0;;64,0;26,0;23,0;16,0;3,0;1,0;23,0;15,0;24,0;1,0;11,0;11,0;3,0;7,0;1,0;2,0;1,0;3,0;11,0;;2,0;1,0;1,0;4,0;;3,0;;10,0;27,0;22,0;;;1,0;6,0;45,0;;;107,0;;6,0;;;;;;1,0;14,0;;4,0;4,0;3,0;12,0;23,0;65,0;2,0;;;;1,0;;;;;5,0;;;15,0;1,0;;;3,0;;;;2,0;;1,0;50,0;2,0;6,0;;11,0;;;;;5,0;1,0;;;5,0;10,0;;;;9,0;;1,0;;;8,0;;;;;;7,0;;6,0;1,0;;;1,0;6,0;;;4,0;1,0;1,0;4,0;1,0;;1,0;1,0;1,0;1,0;1,0;1,0;;2,0;4,0;6,0;;;;;;;;1,0;;14,0;;;;;4,0;;10,0;1,0;;;;;;3,0;11,0;;2,0;2,0;1,0;;1,0;2,0;;;4,0;10,0;;;;2,0;;;;1,0;;;2,0;1,0;;;15,0;12,0;;4,0;1,0;2,0;;2,0;1,0;;;1,0;;59,0;43,0;;;2,0;;3,0;5,0;3,0;;4,0;;;;;7,0;;;;;;14,0;;3,0;;;;12,0;;;37,0;;;;13,0;4,0;;;;;;;;;;;;2,0;;;;;;;
operable;;2,0;;31,0;2,0;30,0;8,0;16,0;;;;;1,0;5,0;1,0;1,0;111,0;2,0;;;5,0;;14,0;2,0;18,0;;;5,0;7,0;8,0;31,0;33,0;5,0;2,0;;183,0;17,0;2,0;17,0;3,0;63,0;186,0;;17,0;115,0;4,0;;30,0;1,0;;2,0;;6,0;3,0;23,0;5,0;7,0;;4,0;30,0;1,0;;1,0;;363,0;2,0;55,0;;;;6,0;52,0;76,0;2,0;1,0;;;3,0;18,0;36,0;20,0;;33,0;6,0;53,0;4,0;;19,0;6,0;;2,0;4,0;7,0;;4,0;;9,0;5,0;56,0;13,0;63,0;1,0;;72,0;53,0;151,0;3,0;14,0;;;;7,0;9,0;1,0;;2,0;2,0;3,0;30,0;56,0;7,0;;41,0;;;31,0;237,0;;;;23,0;;3,0;37,0;1,0;;53,0;4,0;13,0;;;1,0;5,0;;4,0;7,0;8,0;4,0;6,0;4,0;;2,0;12,0;;;1,0;;;;;5,0;10,0;4,0;5,0;1,0;;51,0;9,0;;8,0;10,0;;11,0;4,0;;5,0;;11,0;1,0;4,0;1,0;15,0;;6,0;;6,0;10,0;3,0;31,0;;1,0;;10,0;1,0;1,0;1,0;26,0;1,0;;;;1,0;;2,0;11,0;14,0;7,0;;1,0;11,0;25,0;7,0;4,0;;;;17,0;1,0;;2,0;8,0;;2,0;;;;18,0;;1,0;5,0;;12,0;11,0;;3,0;1,0;1,0;;;;;;2,0;4,0;;8,0;;6,0;2,0;;;;1,0;9,0;;21,0;5,0;17,0;;;2,0;33,0;;32,0;;3,0;;6,0;;;;8,0;36,0;2,0;;;3,0;1,0;;;;;18,0;3,0;;3,0;;;5,0;1,0;;3,0;;2,0;;;13,0;14,0;;;;;;22,0;;;;5,0;1,0;21,0;;;2,0;2,0;;;8,0;5,0;;9,0;9,0;37,0;;4,0;1,0;;;;49,0;2,0;3,0;;;;2,0;1,0;5,0;;;1,0;6,0;7,0;;;;;13,0;1,0;3,0;4,0;;;;;7,0;1,0;;1,0;113,0;25,0;;;1,0;1,0;7,0;5,0;1,0;;;;;;4,0;3,0;5,0;;;5,0;3,0;1,0;72,0;2,0;;;;45,0;3,0;5,0;2,0;;3,0;64,0;2,0;13,0;1,0;5,0;;15,0;;;;9,0;;6,0;;7,0;;20,0;6,0;5,0;;3,0;;16,0;12,0;3,0;;;;;;4,0;;9,0;3,0;88,0;2,0;2,0;14,0;2,0;11,0;;;2,0;1,0;;15,0;;16,0;4,0;8,0;;3,0;5,0;;2,0;;3,0;25,0;;3,0;14,0;6,0;;;7,0;2,0;35,0;4,0;;9,0;;;2,0;;2,0;;;;3,0;;;58,0;24,0;;;1,0;2,0;18,0;6,0;;;2,0;5,0;;1,0;18,0;1,0;2,0;;;3,0;;6,0;9,0;2,0;9,0;;7,0;;3,0;10,0;1,0;36,0;;;56,0;;;3,0;6,0;1,0;19,0;1,0;;13,0;5,0;7,0;8,0;;5,0;5,0;2,0;;;;;1,0;4,0;;1,0;3,0;;2,0;;;;;2,0;22,0;1,0;2,0;;12,0;;32,0;;;1,0;;3,0;1,0;3,0;1,0;2,0;3,0;;;;12,0;;;;5,0;6,0;;2,0;6,0;2,0;;;3,0;;;;;2,0;1,0;3,0;3,0;;6,0;10,0;9,0;2,0;;;;15,0;4,0;;;;;26,0;;2,0;;;;;3,0;;5,0;1,0;2,0;;;;6,0;1,0;9,0;;1,0;;3,0;3,0;3,0;;13,0;3,0;;9,0;4,0;;;;;1,0;;;;;5,0;;;;1,0;;;;;;;;3,0;;;;;;;;;;1,0;;;;;3,0;7,0;8,0;4,0;14,0;;;;;;27,0;4,0;;2,0;25,0;1,0;15,0;3,0;10,0;;;1,0;12,0;11,0;14,0;3,0;4,0;;1,0;;;1,0;2,0;;8,0;4,0;4,0;4,0;;;1,0;;;;;;;2,0;;1,0;;;;;;19,0;;;;4,0;1,0;;;4,0;;;5,0;;7,0;;1,0;;1,0;4,0;2,0;2,0;;;2,0;;;;;;;;1,0;4,0;;;;;;;1,0;3,0;;;1,0;3,0;;9,0;;;;1,0;1,0;;1,0;;1,0;;1,0;1,0;;;;;1,0;;;;;;2,0;;;1,0;;;;;;2,0;;;;;;;2,0;;2,0;;;;;;1,0;2,0;2,0;;;;;6,0;;;;;;2,0;;;;8,0;;2,0;2,0;;7,0;;12,0;;;1,0;;11,0;;;;;1,0;;;;1,0;2,0;;;1,0;19,0;;;1,0;;1,0;;1,0;6,0;;6,0;;2,0;;1,0;;;3,0;;;;;4,0;2,0;;;5,0;;2,0;;;8,0;;;6,0;;1,0;;;;;3,0;3,0;;3,0;;5,0;4,0;;;;;;;;1,0;;;;;;;;;4,0;;1,0;;;4,0;;;;;;2,0;;;;4,0;1,0;2,0;;;6,0;;1,0;;;;;;;;;;3,0;;;;;4,0;;;;;1,0;;;1,0;4,0;;;;;;;;;2,0;;;3,0;;;;;;;1,0;;;;2,0;;;;;;;;;;2,0;;;;;
operate;;8,0;4,0;53,0;28,0;69,0;72,0;29,0;;1,0;;17,0;9,0;74,0;;8,0;186,0;5,0;12,0;13,0;2,0;1,0;24,0;9,0;40,0;3,0;;13,0;24,0;41,0;325,0;72,0;;4,0;;103,0;14,0;13,0;15,0;5,0;97,0;414,0;3,0;44,0;129,0;6,0;;113,0;;2,0;;;7,0;16,0;18,0;17,0;13,0;;21,0;35,0;;;34,0;1,0;372,0;7,0;146,0;5,0;1,0;;13,0;78,0;95,0;1,0;;;5,0;8,0;2,0;21,0;442,0;6,0;510,0;4,0;83,0;15,0;;58,0;;2,0;181,0;3,0;;16,0;12,0;2,0;29,0;5,0;99,0;47,0;195,0;27,0;;25,0;36,0;117,0;;16,0;;6,0;;9,0;16,0;1,0;;;12,0;14,0;15,0;146,0;2,0;;73,0;1,0;3,0;8,0;372,0;;2,0;;65,0;;;122,0;5,0;3,0;22,0;17,0;7,0;;;1,0;;1,0;5,0;6,0;21,0;6,0;10,0;2,0;5,0;3,0;39,0;2,0;5,0;1,0;;;;1,0;3,0;32,0;10,0;4,0;16,0;;17,0;32,0;;12,0;13,0;;7,0;16,0;1,0;4,0;3,0;10,0;14,0;2,0;4,0;63,0;8,0;1,0;;;30,0;13,0;28,0;6,0;;2,0;8,0;2,0;3,0;3,0;14,0;;3,0;;;8,0;2,0;;14,0;10,0;85,0;4,0;9,0;18,0;31,0;26,0;3,0;1,0;3,0;6,0;55,0;9,0;;12,0;14,0;28,0;4,0;;5,0;2,0;58,0;;;2,0;1,0;12,0;22,0;4,0;4,0;8,0;3,0;1,0;;10,0;;12,0;4,0;1,0;;38,0;;1,0;17,0;11,0;4,0;;;11,0;;22,0;20,0;14,0;;;1,0;15,0;7,0;147,0;;;1,0;11,0;;7,0;2,0;26,0;26,0;7,0;;;16,0;13,0;;18,0;10,0;9,0;9,0;5,0;;4,0;;12,0;38,0;2,0;1,0;6,0;;2,0;;2,0;49,0;57,0;;3,0;;5,0;2,0;;;;16,0;1,0;;91,0;;;3,0;1,0;1,0;24,0;2,0;10,0;10,0;8,0;46,0;25,0;1,0;7,0;5,0;;;1,0;62,0;1,0;1,0;;2,0;4,0;18,0;;;;2,0;4,0;5,0;10,0;;;;4,0;;;1,0;6,0;;4,0;3,0;;15,0;5,0;21,0;3,0;70,0;68,0;1,0;1,0;;8,0;3,0;11,0;;4,0;1,0;1,0;;1,0;2,0;3,0;13,0;4,0;5,0;27,0;2,0;1,0;197,0;4,0;2,0;9,0;6,0;42,0;16,0;63,0;;19,0;1,0;28,0;1,0;17,0;17,0;47,0;;13,0;13,0;2,0;1,0;39,0;7,0;13,0;4,0;13,0;2,0;17,0;38,0;37,0;3,0;16,0;1,0;;162,0;13,0;;;;;;42,0;10,0;5,0;;63,0;27,0;63,0;6,0;2,0;14,0;6,0;47,0;3,0;8,0;6,0;13,0;3,0;50,0;9,0;46,0;50,0;36,0;4,0;2,0;4,0;;1,0;115,0;2,0;;48,0;20,0;6,0;2,0;13,0;;3,0;;2,0;34,0;;2,0;2,0;;15,0;;3,0;13,0;4,0;11,0;7,0;21,0;30,0;1,0;7,0;6,0;5,0;10,0;;4,0;5,0;4,0;12,0;16,0;4,0;31,0;;17,0;;4,0;;;3,0;9,0;1,0;14,0;2,0;21,0;;1,0;7,0;2,0;44,0;6,0;2,0;26,0;7,0;2,0;1,0;2,0;1,0;27,0;;8,0;18,0;2,0;11,0;5,0;;19,0;5,0;;3,0;;;2,0;1,0;1,0;3,0;7,0;9,0;1,0;2,0;;2,0;4,0;2,0;10,0;5,0;;2,0;1,0;33,0;;11,0;;;1,0;3,0;7,0;2,0;3,0;4,0;6,0;5,0;;3,0;;;1,0;30,0;7,0;14,0;3,0;8,0;9,0;;27,0;;2,0;1,0;1,0;;4,0;1,0;4,0;;;6,0;2,0;10,0;6,0;3,0;13,0;1,0;4,0;;8,0;6,0;7,0;1,0;3,0;1,0;17,0;;1,0;14,0;36,0;2,0;2,0;10,0;;4,0;2,0;5,0;1,0;5,0;5,0;5,0;;;;3,0;8,0;;4,0;;1,0;14,0;5,0;22,0;;7,0;2,0;;;;3,0;;1,0;;7,0;32,0;;4,0;;6,0;1,0;6,0;1,0;3,0;1,0;4,0;2,0;9,0;2,0;;6,0;;4,0;2,0;;1,0;;2,0;;2,0;4,0;;3,0;31,0;13,0;5,0;56,0;;;17,0;;16,0;51,0;35,0;;4,0;;5,0;4,0;;15,0;;3,0;3,0;1,0;1,0;8,0;1,0;1,0;;1,0;5,0;1,0;;18,0;4,0;7,0;;9,0;;2,0;;5,0;3,0;3,0;48,0;15,0;2,0;;1,0;1,0;3,0;1,0;;;1,0;9,0;24,0;;9,0;9,0;;1,0;;;4,0;2,0;;9,0;;9,0;6,0;6,0;2,0;;;17,0;2,0;;6,0;3,0;;9,0;3,0;;;8,0;2,0;3,0;8,0;6,0;;;;2,0;;;;;6,0;;;9,0;;;;1,0;3,0;1,0;;4,0;;8,0;2,0;;;;2,0;;1,0;4,0;;;;;13,0;3,0;1,0;5,0;2,0;;;;;2,0;;;;6,0;3,0;;;;3,0;;26,0;;;;1,0;;;1,0;2,0;;;2,0;;;;;;;;;;8,0;1,0;;1,0;;1,0;1,0;21,0;1,0;;;1,0;3,0;4,0;;;1,0;;2,0;;;1,0;3,0;;;;4,0;2,0;1,0;;;2,0;1,0;;4,0;1,0;1,0;3,0;;;;7,0;;;2,0;3,0;5,0;1,0;;5,0;5,0;;;1,0;1,0;;2,0;;;;;;3,0;1,0;;;2,0;1,0;;;1,0;;1,0;53,0;16,0;2,0;7,0;5,0;;5,0;;3,0;1,0;7,0;1,0;1,0;;;9,0;;;5,0;;;;1,0;20,0;;5,0;3,0;2,0;;4,0;3,0;5,0;;;;3,0;;;;2,0;;2,0;7,0;;;;1,0;;;;;;;;;;;1,0;;;;;;;5,0;9,0;;;;1,0;;;4,0;;;;;;;;;;;1,0;;;1,0;2,0;;;;3,0;;;28,0;;;;;;;;
operation;;35,0;3,0;83,0;88,0;150,0;23,0;18,0;1,0;27,0;;;49,0;265,0;10,0;;220,0;5,0;6,0;9,0;2,0;;17,0;30,0;95,0;5,0;4,0;92,0;56,0;63,0;327,0;137,0;3,0;34,0;;292,0;10,0;2,0;40,0;;273,0;576,0;1,0;64,0;214,0;2,0;9,0;35,0;;1,0;21,0;;10,0;30,0;24,0;17,0;16,0;;13,0;94,0;;;49,0;4,0;1127,0;22,0;254,0;10,0;1,0;;6,0;227,0;77,0;;11,0;17,0;;7,0;20,0;86,0;458,0;;695,0;15,0;105,0;17,0;1,0;76,0;1,0;9,0;125,0;5,0;9,0;10,0;112,0;1,0;75,0;14,0;273,0;98,0;317,0;59,0;;40,0;178,0;337,0;6,0;29,0;5,0;;2,0;57,0;48,0;15,0;;1,0;9,0;28,0;23,0;109,0;25,0;5,0;384,0;24,0;8,0;86,0;345,0;4,0;2,0;1,0;286,0;8,0;;570,0;2,0;6,0;51,0;14,0;249,0;;;4,0;1,0;27,0;26,0;14,0;33,0;17,0;104,0;6,0;8,0;31,0;36,0;;7,0;7,0;2,0;;;;;23,0;10,0;17,0;10,0;;16,0;20,0;1,0;121,0;44,0;1,0;11,0;81,0;5,0;23,0;9,0;10,0;43,0;12,0;4,0;;11,0;1,0;;2,0;27,0;2,0;62,0;10,0;;4,0;15,0;6,0;1,0;2,0;22,0;;;;;5,0;19,0;5,0;36,0;78,0;537,0;1,0;5,0;22,0;39,0;56,0;9,0;;;15,0;165,0;;1,0;5,0;21,0;82,0;3,0;7,0;1,0;;111,0;3,0;32,0;33,0;;1,0;27,0;11,0;1,0;20,0;4,0;;;5,0;;55,0;8,0;2,0;;213,0;4,0;2,0;24,0;22,0;2,0;;;6,0;4,0;18,0;22,0;21,0;;;15,0;48,0;63,0;91,0;;1,0;2,0;7,0;3,0;14,0;;46,0;38,0;18,0;8,0;3,0;43,0;18,0;1,0;2,0;5,0;73,0;32,0;5,0;;;2,0;25,0;47,0;;5,0;25,0;;14,0;;;17,0;13,0;2,0;25,0;;2,0;;4,0;9,0;;11,0;8,0;2,0;141,0;;;4,0;5,0;3,0;5,0;11,0;20,0;6,0;20,0;40,0;76,0;2,0;14,0;22,0;1,0;27,0;3,0;189,0;1,0;1,0;;4,0;;66,0;;29,0;2,0;7,0;9,0;35,0;138,0;130,0;;;1,0;10,0;7,0;1,0;2,0;3,0;3,0;8,0;12,0;65,0;;44,0;;153,0;31,0;2,0;8,0;;20,0;30,0;31,0;14,0;1,0;;13,0;1,0;1,0;59,0;13,0;84,0;73,0;2,0;17,0;25,0;29,0;804,0;112,0;15,0;5,0;7,0;263,0;40,0;13,0;30,0;16,0;6,0;132,0;15,0;188,0;1,0;49,0;;110,0;120,0;9,0;2,0;172,0;6,0;81,0;5,0;15,0;10,0;52,0;58,0;21,0;3,0;126,0;2,0;162,0;;3,0;2,0;;32,0;;3,0;21,0;11,0;54,0;17,0;256,0;12,0;162,0;45,0;;28,0;;67,0;;27,0;4,0;61,0;26,0;187,0;12,0;31,0;33,0;52,0;34,0;4,0;37,0;4,0;;371,0;1,0;1,0;19,0;16,0;9,0;5,0;2,0;;41,0;2,0;3,0;74,0;4,0;38,0;2,0;;55,0;;21,0;2,0;7,0;16,0;13,0;175,0;65,0;5,0;;23,0;7,0;44,0;48,0;5,0;6,0;6,0;17,0;12,0;2,0;1127,0;8,0;14,0;3,0;2,0;1,0;3,0;1,0;8,0;2,0;45,0;5,0;4,0;10,0;;8,0;2,0;57,0;12,0;8,0;;5,0;26,0;16,0;10,0;6,0;18,0;2,0;;22,0;;36,0;;;7,0;1,0;1,0;;1,0;;2,0;1,0;2,0;1,0;8,0;100,0;;3,0;9,0;12,0;24,0;13,0;14,0;31,0;3,0;9,0;;31,0;2,0;4,0;2,0;2,0;10,0;17,0;;;10,0;12,0;35,0;13,0;;7,0;3,0;;2,0;267,0;12,0;3,0;15,0;2,0;4,0;8,0;13,0;4,0;3,0;9,0;3,0;;17,0;3,0;;36,0;6,0;5,0;12,0;3,0;7,0;2,0;50,0;;;12,0;18,0;1,0;12,0;4,0;2,0;;30,0;11,0;5,0;1,0;12,0;9,0;5,0;17,0;;29,0;2,0;8,0;8,0;9,0;24,0;7,0;4,0;3,0;;1,0;5,0;;7,0;2,0;1,0;8,0;71,0;17,0;3,0;23,0;2,0;4,0;;;4,0;6,0;3,0;;1,0;49,0;;6,0;22,0;2,0;;16,0;19,0;14,0;8,0;;5,0;1,0;20,0;3,0;11,0;;16,0;3,0;15,0;3,0;;12,0;6,0;17,0;17,0;6,0;;12,0;5,0;;110,0;;3,0;4,0;;1,0;46,0;1,0;;27,0;277,0;7,0;1,0;;37,0;;33,0;;3,0;19,0;11,0;29,0;5,0;1,0;;2,0;5,0;1,0;32,0;21,0;4,0;65,0;18,0;5,0;;;4,0;3,0;6,0;68,0;119,0;;9,0;1,0;;8,0;9,0;;;;6,0;37,0;5,0;;30,0;12,0;5,0;2,0;;49,0;3,0;;4,0;3,0;14,0;10,0;;12,0;;2,0;19,0;;;;21,0;;36,0;;16,0;;;3,0;3,0;14,0;5,0;14,0;4,0;;;1,0;;;7,0;;;;2,0;3,0;;;8,0;1,0;1,0;;;;35,0;13,0;5,0;;;;;;;;;;;46,0;;1,0;11,0;2,0;2,0;1,0;2,0;1,0;8,0;10,0;35,0;;30,0;20,0;6,0;;;;;49,0;2,0;2,0;;7,0;1,0;6,0;7,0;;;;2,0;5,0;7,0;10,0;5,0;;;3,0;14,0;6,0;13,0;5,0;5,0;12,0;1,0;;1,0;18,0;4,0;;15,0;;3,0;16,0;;1,0;5,0;;14,0;3,0;;33,0;1,0;;4,0;5,0;5,0;15,0;15,0;9,0;;;16,0;;1,0;2,0;8,0;8,0;;1,0;3,0;2,0;;;5,0;3,0;9,0;3,0;30,0;47,0;5,0;3,0;2,0;27,0;8,0;1,0;1,0;2,0;5,0;9,0;;1,0;3,0;;1,0;1,0;3,0;2,0;;;;7,0;33,0;34,0;20,0;2,0;4,0;;4,0;5,0;2,0;2,0;9,0;10,0;6,0;;;;;1,0;;1,0;1,0;;7,0;5,0;56,0;;2,0;;16,0;4,0;1,0;3,0;7,0;;28,0;1,0;1,0;;4,0;2,0;;;;2,0;5,0;;4,0;;;;5,0;;;1,0;4,0;;1,0;3,0;19,0;1,0;3,0;;6,0;2,0;;1,0;6,0;;;;1,0;1,0;1,0;2,0;;1,0;;;;4,0;12,0;;;;8,0;56,0;4,0;;6,0;2,0;;4,0;3,0;;8,0;6,0;1,0;;1,0;;;1,0;;
opposite;;4,0;1,0;2,0;;20,0;43,0;63,0;;;5,0;1,0;17,0;82,0;9,0;;10,0;;6,0;;5,0;;18,0;1,0;;;3,0;18,0;;1,0;34,0;2,0;;13,0;3,0;2,0;32,0;5,0;;3,0;10,0;95,0;;9,0;27,0;188,0;;39,0;;3,0;;;93,0;22,0;8,0;;60,0;;;1,0;8,0;;;;118,0;;75,0;;;52,0;7,0;178,0;33,0;1,0;;1,0;21,0;1,0;;1,0;29,0;;;;71,0;16,0;;61,0;;3,0;;;4,0;34,0;13,0;;23,0;7,0;55,0;22,0;111,0;12,0;5,0;1,0;4,0;7,0;;;;2,0;;3,0;49,0;1,0;1,0;;;31,0;6,0;92,0;;;19,0;4,0;;;31,0;;3,0;1,0;39,0;;;53,0;;;21,0;;7,0;;4,0;27,0;;;26,0;15,0;18,0;63,0;12,0;20,0;8,0;16,0;55,0;46,0;;6,0;19,0;4,0;;1,0;14,0;68,0;;;7,0;;26,0;30,0;1,0;19,0;11,0;;11,0;549,0;2,0;96,0;2,0;2,0;2,0;;;;5,0;154,0;8,0;29,0;32,0;22,0;56,0;37,0;;;2,0;1,0;16,0;26,0;100,0;15,0;20,0;1,0;4,0;44,0;2,0;2,0;6,0;1,0;155,0;9,0;31,0;104,0;32,0;25,0;1,0;1,0;8,0;58,0;2,0;18,0;7,0;2,0;9,0;5,0;;17,0;60,0;1,0;231,0;1,0;;;13,0;;5,0;;21,0;;;29,0;2,0;3,0;1,0;15,0;5,0;6,0;3,0;3,0;8,0;11,0;935,0;10,0;53,0;3,0;;20,0;88,0;1,0;64,0;742,0;;1,0;;3,0;12,0;15,0;33,0;2,0;1,0;;1,0;22,0;;17,0;24,0;10,0;1,0;;6,0;21,0;16,0;1,0;8,0;3,0;63,0;35,0;;4,0;29,0;14,0;49,0;;137,0;21,0;2,0;8,0;;11,0;24,0;1,0;12,0;2,0;15,0;12,0;40,0;8,0;;11,0;9,0;8,0;6,0;6,0;15,0;2,0;4,0;;2,0;4,0;94,0;8,0;3,0;1,0;10,0;7,0;;2,0;9,0;8,0;1,0;13,0;3,0;27,0;17,0;7,0;22,0;14,0;3,0;3,0;;2,0;;;31,0;21,0;5,0;4,0;7,0;13,0;4,0;21,0;;18,0;3,0;9,0;;6,0;6,0;4,0;1,0;30,0;8,0;1,0;2,0;;;1,0;;;;1,0;;2,0;1,0;;;17,0;10,0;;;3,0;3,0;;4,0;7,0;;;1,0;4,0;1,0;;;;;;;6,0;15,0;3,0;1,0;5,0;;;2,0;5,0;6,0;7,0;1,0;13,0;1,0;;6,0;6,0;5,0;34,0;;1,0;2,0;16,0;10,0;;2,0;;;;3,0;3,0;;31,0;;3,0;;;24,0;;;;;1,0;;2,0;1,0;;;15,0;2,0;7,0;;3,0;;32,0;4,0;2,0;;15,0;4,0;4,0;9,0;1,0;;7,0;4,0;;;;;;;;;;;;;;1,0;1,0;4,0;2,0;3,0;9,0;;;167,0;1,0;;;;;1,0;;5,0;;;2,0;;17,0;3,0;8,0;6,0;2,0;;6,0;2,0;1,0;;10,0;7,0;9,0;;;;;;;2,0;;;3,0;2,0;7,0;3,0;;7,0;24,0;;37,0;;;3,0;2,0;6,0;;1,0;2,0;2,0;10,0;17,0;;2,0;3,0;6,0;2,0;;3,0;2,0;37,0;;;;;3,0;;8,0;3,0;;;;1,0;;;1,0;;;;;7,0;;;;;;;;;;2,0;18,0;;1,0;;7,0;;3,0;;5,0;13,0;1,0;2,0;2,0;1,0;;;;;;;7,0;;;2,0;;;;;;6,0;2,0;;;1,0;;3,0;1,0;;;4,0;;8,0;;1,0;;20,0;;;;2,0;;;;;;;23,0;;;;11,0;;;;13,0;2,0;3,0;;5,0;1,0;4,0;1,0;;2,0;;8,0;;;;;1,0;2,0;1,0;;;;;;;;8,0;1,0;;;6,0;;4,0;;8,0;;;4,0;;3,0;2,0;;;;;;;1,0;;12,0;4,0;2,0;4,0;5,0;;;1,0;27,0;;2,0;2,0;;;;;11,0;36,0;9,0;;8,0;2,0;;;2,0;3,0;;;3,0;;4,0;1,0;;;8,0;;1,0;1,0;32,0;16,0;;2,0;;2,0;;;2,0;12,0;;6,0;9,0;7,0;55,0;24,0;1,0;5,0;1,0;;3,0;;;;;3,0;12,0;1,0;;;13,0;;;;1,0;5,0;3,0;7,0;;3,0;;1,0;;3,0;2,0;4,0;1,0;4,0;;1,0;;6,0;;5,0;;5,0;;;3,0;13,0;2,0;9,0;;;5,0;;;;;;17,0;15,0;;;4,0;;1,0;23,0;;6,0;;7,0;;3,0;3,0;;3,0;;1,0;;;13,0;1,0;3,0;;;3,0;;;;;;;1,0;1,0;;6,0;;;;6,0;;1,0;;;;;;;;;2,0;;;;1,0;;;;;;;;;;3,0;1,0;;;;;;2,0;2,0;;;;;7,0;1,0;;;;;2,0;5,0;;;;;;;;;;;;;;;3,0;1,0;;1,0;;;;;;;;2,0;;3,0;2,0;;;;;;2,0;;;;;;1,0;9,0;;;;6,0;;;;;;;25,0;;;6,0;10,0;1,0;13,0;3,0;;1,0;;;1,0;20,0;;1,0;;;29,0;;4,0;;;;;;;10,0;;;2,0;;;;1,0;1,0;;;;10,0;1,0;;;;;2,0;;;;;;;;1,0;;;;;3,0;;;;;;;;
orient;;3,0;;6,0;;8,0;2,0;19,0;;;4,0;;9,0;33,0;1,0;;24,0;1,0;;;;;1,0;;1,0;;;2,0;2,0;;16,0;;;;4,0;5,0;15,0;13,0;2,0;;13,0;81,0;2,0;3,0;14,0;16,0;;15,0;;1,0;;;1,0;;46,0;;1,0;1,0;;6,0;;2,0;3,0;;86,0;2,0;18,0;;;6,0;7,0;75,0;29,0;6,0;3,0;;;;;5,0;14,0;;1,0;2,0;18,0;6,0;;43,0;;;;2,0;2,0;6,0;;;;24,0;48,0;11,0;55,0;6,0;3,0;;;7,0;;3,0;2,0;;;5,0;8,0;3,0;;;1,0;9,0;12,0;33,0;;;;;1,0;;39,0;;1,0;;1,0;1,0;;14,0;;;43,0;2,0;3,0;;;5,0;2,0;;17,0;4,0;3,0;11,0;4,0;1,0;1,0;5,0;1,0;;;3,0;;;;;;4,0;;;;;5,0;6,0;;1,0;;;7,0;144,0;6,0;4,0;;;;;;;;12,0;;;14,0;3,0;7,0;27,0;;;;1,0;4,0;;39,0;2,0;;;;4,0;;1,0;4,0;1,0;19,0;;8,0;40,0;1,0;3,0;2,0;;;6,0;;31,0;;4,0;13,0;;;;1,0;;12,0;;;4,0;1,0;;7,0;;11,0;;;;4,0;;;8,0;15,0;;;8,0;;2,0;13,0;;6,0;;;4,0;;;6,0;38,0;;;;;;15,0;4,0;;;;2,0;7,0;;7,0;6,0;;3,0;;;20,0;1,0;3,0;;2,0;47,0;17,0;2,0;1,0;3,0;7,0;14,0;;5,0;;;;1,0;2,0;4,0;;;1,0;2,0;;4,0;;;;3,0;1,0;1,0;13,0;3,0;;;;4,0;;;1,0;1,0;1,0;;7,0;32,0;7,0;;;;;;12,0;1,0;4,0;4,0;4,0;8,0;6,0;;;;1,0;6,0;5,0;6,0;;3,0;6,0;3,0;1,0;;4,0;1,0;;;;1,0;2,0;4,0;4,0;11,0;;;;;2,0;;1,0;4,0;3,0;2,0;1,0;1,0;;;9,0;1,0;2,0;3,0;5,0;1,0;;13,0;1,0;;1,0;2,0;2,0;4,0;3,0;;;;;;2,0;5,0;3,0;;4,0;4,0;;;1,0;;1,0;;6,0;;;3,0;3,0;;4,0;;;;45,0;6,0;4,0;;;;;;;;19,0;2,0;5,0;;6,0;;;3,0;4,0;;;1,0;;1,0;;;;7,0;;;1,0;;;22,0;4,0;12,0;2,0;;;;2,0;;6,0;;;12,0;;;;1,0;;;;;6,0;;;6,0;2,0;;8,0;4,0;;;;16,0;;4,0;4,0;;;;;;;;;;3,0;;;2,0;;;4,0;4,0;3,0;;;2,0;12,0;;;;1,0;;;;5,0;;;3,0;1,0;;;1,0;;;8,0;;;1,0;;;;;2,0;1,0;1,0;8,0;;;;;;;;3,0;18,0;;;;2,0;14,0;;3,0;7,0;;;;12,0;;;;;;;2,0;2,0;;;;;;;;;;;;;;;1,0;;;;5,0;;;;;;;;1,0;;;;1,0;;;;1,0;;;2,0;;9,0;;;;1,0;;;;;;;;;;;;;;;3,0;2,0;;;2,0;;;;;;;;;;;;32,0;;;;;1,0;;;;;;1,0;;;;;3,0;;;;4,0;;;2,0;;;2,0;;;;;;5,0;;;;;;;;7,0;;;;;;;3,0;1,0;;;;;;;;;1,0;;;;;;;;6,0;1,0;1,0;;3,0;;;;2,0;;;;1,0;;;;;;1,0;;;;;;1,0;1,0;1,0;;;;;32,0;;;7,0;1,0;1,0;1,0;;;;;;1,0;;;;;;2,0;;;;3,0;3,0;;1,0;5,0;;;;;;;;;;;;2,0;;;4,0;;;;;;;4,0;;1,0;;;8,0;;;;;;;;;;;2,0;;;;;;;4,0;;;;;;;2,0;;;;;;;;;3,0;;;4,0;;;;;;;;;;;;;;;;2,0;;1,0;;;;;;;;1,0;;;;;;1,0;;;;;2,0;1,0;3,0;;;;2,0;;;;3,0;;;;;;;;;7,0;;;;;1,0;1,0;;;;;;2,0;;1,0;;;;1,0;;;;;;;;;;1,0;;;;;;;;;;;1,0;;;;;;1,0;2,0;;;;;;;5,0;;;;;;;;;;;;;;;;;;;;;;;;;;;;;;;2,0;;3,0;;;;;;;;;;3,0;;;;11,0;;;;;;1,0;;;1,0;;;;;;;;;;
orientation;;3,0;;133,0;27,0;93,0;7,0;41,0;;;;;;354,0;;;277,0;1,0;1,0;34,0;;1,0;5,0;4,0;16,0;4,0;3,0;37,0;20,0;10,0;142,0;33,0;20,0;7,0;2,0;273,0;33,0;20,0;19,0;;488,0;660,0;;67,0;147,0;20,0;;24,0;5,0;1,0;93,0;;17,0;9,0;46,0;14,0;14,0;5,0;1,0;56,0;;;9,0;6,0;704,0;2,0;141,0;2,0;1,0;2,0;8,0;99,0;25,0;16,0;;2,0;2,0;21,0;5,0;7,0;259,0;;26,0;12,0;71,0;;;55,0;3,0;10,0;32,0;2,0;7,0;11,0;3,0;1,0;33,0;26,0;155,0;71,0;917,0;83,0;;7,0;24,0;66,0;3,0;18,0;18,0;;;56,0;26,0;2,0;;1,0;4,0;55,0;31,0;493,0;2,0;2,0;39,0;30,0;1,0;20,0;240,0;;2,0;;66,0;1,0;;118,0;13,0;;68,0;47,0;6,0;;;9,0;2,0;;1,0;5,0;19,0;7,0;89,0;19,0;25,0;;59,0;4,0;;2,0;;;;1,0;1,0;21,0;4,0;;;12,0;21,0;1,0;4,0;23,0;1,0;;12,0;58,0;2,0;19,0;;;12,0;;5,0;1,0;5,0;29,0;1,0;5,0;7,0;;70,0;21,0;;1,0;1,0;3,0;6,0;5,0;128,0;1,0;1,0;2,0;;2,0;14,0;;58,0;12,0;30,0;1,0;31,0;147,0;46,0;50,0;19,0;;;;22,0;10,0;4,0;2,0;52,0;3,0;1,0;;5,0;;10,0;1,0;;9,0;;;56,0;2,0;7,0;20,0;;1,0;1,0;27,0;;6,0;1,0;1,0;;56,0;2,0;34,0;26,0;;;;;25,0;3,0;1,0;22,0;50,0;;;3,0;14,0;5,0;94,0;11,0;;;2,0;7,0;3,0;;1,0;8,0;4,0;;;9,0;268,0;1,0;5,0;1,0;3,0;57,0;15,0;1,0;;;6,0;8,0;3,0;2,0;2,0;;;3,0;8,0;14,0;2,0;;5,0;4,0;;7,0;;1,0;3,0;42,0;61,0;6,0;121,0;;16,0;2,0;;2,0;;13,0;23,0;3,0;6,0;123,0;230,0;16,0;2,0;1,0;;;8,0;6,0;1,0;1,0;;2,0;1,0;17,0;4,0;1,0;;;2,0;40,0;55,0;49,0;5,0;5,0;11,0;8,0;14,0;;;2,0;;;;46,0;8,0;4,0;;41,0;15,0;4,0;2,0;37,0;2,0;6,0;23,0;18,0;38,0;5,0;5,0;;;52,0;20,0;184,0;20,0;17,0;24,0;65,0;25,0;99,0;70,0;;23,0;41,0;182,0;6,0;68,0;3,0;2,0;8,0;2,0;5,0;7,0;3,0;17,0;;34,0;57,0;33,0;14,0;10,0;10,0;13,0;6,0;189,0;16,0;51,0;67,0;25,0;;9,0;1,0;13,0;3,0;;50,0;13,0;3,0;;;2,0;;4,0;3,0;84,0;15,0;63,0;5,0;4,0;26,0;1,0;12,0;3,0;10,0;2,0;10,0;84,0;2,0;;14,0;23,0;46,0;19,0;2,0;13,0;3,0;4,0;162,0;18,0;7,0;5,0;10,0;14,0;;2,0;21,0;19,0;3,0;10,0;47,0;2,0;;11,0;46,0;;20,0;2,0;13,0;2,0;29,0;35,0;13,0;21,0;4,0;;2,0;3,0;2,0;;20,0;1,0;9,0;3,0;3,0;12,0;4,0;45,0;10,0;33,0;6,0;;5,0;16,0;1,0;;25,0;13,0;3,0;1,0;2,0;17,0;1,0;34,0;14,0;30,0;1,0;2,0;1,0;;9,0;7,0;1,0;;9,0;1,0;;6,0;1,0;;1,0;8,0;;1,0;5,0;;;2,0;;;;3,0;6,0;42,0;35,0;14,0;3,0;;59,0;7,0;7,0;;2,0;10,0;10,0;1,0;;;;21,0;;7,0;3,0;22,0;2,0;9,0;;1,0;;;;12,0;1,0;;12,0;;34,0;;;21,0;;;;;8,0;7,0;10,0;14,0;3,0;;;;14,0;2,0;3,0;;;5,0;4,0;6,0;2,0;1,0;;;;;;;35,0;3,0;1,0;3,0;;105,0;8,0;13,0;1,0;4,0;4,0;;;;5,0;13,0;1,0;1,0;3,0;3,0;;1,0;;;;23,0;;;;;;43,0;5,0;;;1,0;;;;17,0;7,0;1,0;2,0;3,0;;6,0;;8,0;;;;3,0;2,0;;;;14,0;1,0;11,0;;1,0;14,0;14,0;8,0;14,0;;1,0;;2,0;;;;7,0;8,0;3,0;3,0;3,0;12,0;;;107,0;1,0;;4,0;2,0;1,0;2,0;3,0;1,0;;;;;4,0;1,0;;;12,0;1,0;;;7,0;1,0;4,0;;2,0;;;2,0;11,0;;2,0;1,0;;;;6,0;2,0;2,0;3,0;;;4,0;;;3,0;3,0;45,0;2,0;7,0;16,0;13,0;;1,0;2,0;7,0;272,0;;1,0;3,0;2,0;4,0;9,0;;3,0;4,0;;7,0;7,0;3,0;2,0;;2,0;;;;4,0;;;;;;1,0;7,0;;1,0;;1,0;;;;;;;3,0;9,0;;2,0;2,0;;;1,0;4,0;;1,0;;1,0;;1,0;;;;;1,0;18,0;;;;;;;;;;;;3,0;16,0;;4,0;92,0;10,0;;;;;1,0;3,0;;;;;;21,0;1,0;;2,0;2,0;;;1,0;;;;5,0;;;;;;;;;1,0;;2,0;;17,0;;;;13,0;8,0;17,0;3,0;2,0;5,0;;4,0;;3,0;;;;12,0;;;;;2,0;;;3,0;1,0;5,0;;11,0;;5,0;;1,0;5,0;6,0;1,0;;4,0;;3,0;;;1,0;;;17,0;4,0;3,0;1,0;;3,0;;9,0;;;4,0;1,0;;7,0;2,0;;2,0;1,0;;;;3,0;;;4,0;2,0;;;1,0;;;;;;7,0;13,0;;;;1,0;;;16,0;;;;;;2,0;;;;;;;;;;;1,0;;3,0;;;;2,0;;;;;;;;1,0;;;2,0;9,0;;6,0;;;;;;11,0;;;;2,0;;;4,0;1,0;;12,0;;;;;;;7,0;;;;;;
output;;34,0;5,0;50,0;89,0;193,0;92,0;30,0;1,0;;2,0;65,0;9,0;376,0;8,0;5,0;161,0;35,0;46,0;38,0;42,0;2,0;153,0;3,0;55,0;4,0;;103,0;29,0;26,0;940,0;135,0;88,0;65,0;3,0;941,0;14,0;8,0;44,0;2,0;173,0;620,0;3,0;277,0;447,0;20,0;32,0;115,0;8,0;29,0;18,0;5,0;12,0;17,0;23,0;24,0;50,0;;30,0;433,0;;4,0;78,0;;2763,0;3,0;275,0;26,0;12,0;1,0;5,0;133,0;432,0;2,0;4,0;10,0;1,0;22,0;30,0;59,0;270,0;;105,0;16,0;172,0;7,0;11,0;109,0;2,0;7,0;50,0;2,0;14,0;55,0;44,0;1,0;796,0;14,0;270,0;142,0;217,0;128,0;5,0;188,0;266,0;248,0;1,0;34,0;2,0;;2,0;114,0;67,0;6,0;;10,0;98,0;47,0;54,0;597,0;41,0;;2865,0;15,0;26,0;64,0;246,0;;6,0;2,0;180,0;1,0;4,0;762,0;9,0;;91,0;1,0;40,0;2,0;;15,0;;11,0;11,0;29,0;53,0;31,0;100,0;4,0;27,0;15,0;62,0;1,0;118,0;64,0;;1,0;;3,0;11,0;292,0;13,0;77,0;126,0;12,0;115,0;;5,0;174,0;48,0;5,0;20,0;49,0;4,0;29,0;59,0;7,0;10,0;40,0;1,0;7,0;4,0;61,0;;4,0;62,0;6,0;289,0;10,0;;;;73,0;1,0;;31,0;19,0;2,0;3,0;;30,0;;10,0;15,0;11,0;31,0;;3,0;19,0;8,0;29,0;11,0;;;;;16,0;13,0;38,0;20,0;54,0;5,0;86,0;3,0;;158,0;;17,0;92,0;;12,0;48,0;32,0;10,0;17,0;13,0;5,0;;47,0;;5,0;3,0;;;185,0;14,0;23,0;35,0;;;;1,0;1,0;4,0;66,0;8,0;110,0;4,0;9,0;41,0;54,0;11,0;62,0;;1,0;9,0;22,0;7,0;8,0;1,0;17,0;27,0;25,0;7,0;3,0;16,0;31,0;;8,0;;10,0;17,0;15,0;2,0;;2,0;23,0;383,0;;15,0;13,0;;;90,0;2,0;35,0;92,0;;1,0;;;;7,0;;;;19,0;2,0;308,0;1,0;;8,0;40,0;;6,0;14,0;1,0;20,0;;21,0;106,0;2,0;2,0;9,0;;3,0;1,0;80,0;6,0;;;;3,0;39,0;;2,0;;;5,0;16,0;8,0;22,0;;4,0;;2,0;30,0;13,0;3,0;;;;1,0;21,0;12,0;21,0;2,0;712,0;6,0;;;1,0;7,0;1,0;35,0;15,0;41,0;2,0;8,0;;;35,0;37,0;41,0;7,0;5,0;25,0;68,0;78,0;601,0;13,0;15,0;2,0;10,0;135,0;74,0;24,0;10,0;16,0;29,0;27,0;17,0;84,0;26,0;62,0;;37,0;64,0;18,0;5,0;386,0;43,0;272,0;17,0;25,0;10,0;34,0;41,0;29,0;;31,0;;55,0;165,0;22,0;2,0;3,0;14,0;;6,0;37,0;8,0;36,0;4,0;338,0;91,0;87,0;33,0;1,0;66,0;4,0;54,0;28,0;14,0;1,0;20,0;63,0;97,0;19,0;22,0;380,0;106,0;2,0;4,0;19,0;;3,0;65,0;28,0;;287,0;15,0;1,0;9,0;6,0;12,0;33,0;8,0;1,0;25,0;5,0;67,0;41,0;;88,0;17,0;5,0;24,0;;58,0;9,0;47,0;128,0;1,0;1,0;36,0;7,0;30,0;6,0;2,0;15,0;22,0;12,0;17,0;6,0;71,0;2,0;4,0;3,0;14,0;2,0;2,0;;12,0;;34,0;;3,0;;6,0;109,0;2,0;9,0;6,0;13,0;12,0;11,0;2,0;6,0;98,0;17,0;;;9,0;52,0;2,0;6,0;;3,0;34,0;53,0;1,0;13,0;3,0;5,0;3,0;;8,0;;12,0;5,0;;9,0;8,0;2,0;7,0;6,0;6,0;31,0;2,0;3,0;7,0;7,0;;14,0;;14,0;37,0;34,0;4,0;4,0;7,0;21,0;5,0;17,0;;4,0;;1,0;20,0;56,0;5,0;4,0;4,0;3,0;16,0;10,0;4,0;11,0;1,0;1,0;8,0;;3,0;25,0;9,0;6,0;1,0;10,0;2,0;;58,0;16,0;6,0;1,0;7,0;10,0;56,0;74,0;7,0;1,0;6,0;4,0;4,0;11,0;5,0;5,0;6,0;;27,0;2,0;;54,0;57,0;3,0;;31,0;54,0;45,0;18,0;2,0;40,0;1,0;7,0;;1,0;2,0;14,0;8,0;;10,0;46,0;5,0;2,0;15,0;7,0;;4,0;8,0;2,0;3,0;3,0;25,0;19,0;12,0;7,0;2,0;;17,0;4,0;53,0;25,0;2,0;73,0;16,0;3,0;;;;23,0;5,0;4,0;1,0;9,0;2,0;4,0;1,0;24,0;14,0;2,0;14,0;3,0;36,0;30,0;;;4,0;1,0;7,0;125,0;;3,0;14,0;3,0;7,0;3,0;21,0;105,0;1,0;6,0;;11,0;47,0;5,0;27,0;15,0;;;;31,0;5,0;91,0;4,0;14,0;50,0;10,0;8,0;;;13,0;5,0;10,0;41,0;61,0;;;;;15,0;8,0;8,0;;23,0;17,0;63,0;1,0;3,0;13,0;8,0;23,0;;;28,0;6,0;;1,0;1,0;5,0;1,0;2,0;4,0;;5,0;33,0;2,0;1,0;13,0;7,0;;13,0;7,0;;2,0;;21,0;2,0;27,0;1,0;2,0;;;3,0;;;2,0;6,0;4,0;;1,0;6,0;1,0;;;;;;;;1,0;13,0;;2,0;;3,0;;;;;;;65,0;;43,0;1,0;5,0;4,0;15,0;13,0;12,0;194,0;22,0;15,0;34,0;142,0;5,0;113,0;62,0;21,0;8,0;;8,0;4,0;14,0;18,0;1,0;;10,0;5,0;18,0;359,0;10,0;24,0;2,0;18,0;;20,0;51,0;7,0;;;1,0;;1,0;33,0;13,0;10,0;3,0;6,0;;18,0;252,0;8,0;;16,0;23,0;5,0;21,0;;11,0;1,0;4,0;6,0;2,0;5,0;6,0;2,0;58,0;5,0;;;11,0;13,0;6,0;24,0;80,0;32,0;5,0;5,0;11,0;;11,0;5,0;4,0;;6,0;1,0;3,0;23,0;15,0;1,0;2,0;6,0;8,0;16,0;2,0;;9,0;16,0;1,0;;30,0;11,0;55,0;;1,0;;1,0;2,0;;22,0;12,0;2,0;3,0;5,0;;;23,0;1,0;1,0;;3,0;;2,0;18,0;;10,0;9,0;4,0;;1,0;6,0;;4,0;;;;1,0;7,0;;4,0;2,0;47,0;2,0;;5,0;5,0;39,0;56,0;;4,0;3,0;2,0;8,0;6,0;3,0;;;5,0;25,0;;80,0;4,0;;;12,0;;;;21,0;19,0;;3,0;;1,0;4,0;20,0;;2,0;16,0;;19,0;1,0;6,0;2,0;;2,0;;1,0;;2,0;1,0;;2,0;2,0;2,0;5,0;4,0;;4,0;11,0;34,0;;3,0;6,0;;3,0;8,0;2,0;;;;;16,0;;20,0;;;;
path;;11,0;;18,0;2,0;50,0;20,0;21,0;5,0;;;12,0;1,0;105,0;;;74,0;1,0;12,0;2,0;13,0;2,0;1,0;3,0;86,0;8,0;;49,0;11,0;4,0;96,0;8,0;3,0;4,0;4,0;34,0;86,0;4,0;8,0;4,0;129,0;136,0;2,0;9,0;38,0;81,0;;153,0;;2,0;4,0;10,0;29,0;8,0;27,0;1,0;84,0;;1,0;66,0;3,0;;30,0;;337,0;;123,0;3,0;;4,0;64,0;236,0;372,0;30,0;;1,0;8,0;16,0;1,0;7,0;116,0;2,0;19,0;11,0;70,0;17,0;6,0;968,0;11,0;2,0;14,0;7,0;55,0;5,0;30,0;1,0;46,0;43,0;149,0;102,0;129,0;55,0;5,0;14,0;92,0;9,0;1,0;7,0;3,0;;;23,0;22,0;;;;;50,0;172,0;135,0;10,0;;114,0;3,0;7,0;6,0;110,0;5,0;;1,0;23,0;15,0;8,0;102,0;1,0;;87,0;34,0;1,0;2,0;8,0;36,0;1,0;;23,0;7,0;20,0;89,0;32,0;3,0;4,0;10,0;39,0;;6,0;20,0;3,0;;;;35,0;40,0;17,0;6,0;12,0;;15,0;8,0;4,0;2,0;22,0;1,0;36,0;55,0;;8,0;1,0;16,0;2,0;;2,0;16,0;;10,0;;3,0;71,0;2,0;42,0;13,0;3,0;;13,0;2,0;4,0;8,0;32,0;26,0;7,0;6,0;;8,0;4,0;6,0;10,0;7,0;28,0;;90,0;32,0;34,0;78,0;9,0;2,0;;2,0;38,0;12,0;2,0;;20,0;9,0;1,0;4,0;15,0;;84,0;;3,0;6,0;1,0;14,0;22,0;;3,0;;50,0;15,0;;32,0;;2,0;1,0;;1,0;48,0;14,0;5,0;26,0;8,0;8,0;5,0;2,0;13,0;7,0;17,0;33,0;41,0;5,0;;20,0;21,0;;115,0;4,0;1,0;;15,0;;14,0;;13,0;25,0;8,0;;;13,0;15,0;;7,0;;8,0;72,0;11,0;57,0;2,0;5,0;;24,0;11,0;6,0;16,0;1,0;2,0;1,0;8,0;35,0;7,0;;5,0;;2,0;;20,0;;1,0;;16,0;10,0;115,0;;;1,0;;;1,0;35,0;1,0;18,0;16,0;5,0;172,0;2,0;39,0;;1,0;33,0;;39,0;10,0;3,0;;4,0;;5,0;;;1,0;6,0;;19,0;9,0;30,0;;3,0;4,0;6,0;11,0;3,0;;2,0;;;;53,0;3,0;17,0;2,0;38,0;;3,0;;;;;6,0;2,0;1,0;3,0;1,0;;;12,0;33,0;11,0;;;2,0;4,0;2,0;31,0;9,0;8,0;6,0;1,0;11,0;;7,0;3,0;1,0;1,0;;21,0;25,0;15,0;6,0;2,0;27,0;12,0;1,0;;32,0;4,0;23,0;10,0;31,0;13,0;4,0;144,0;;1,0;40,0;;12,0;5,0;2,0;4,0;;;28,0;;;4,0;11,0;3,0;29,0;;13,0;6,0;;16,0;;2,0;;6,0;;3,0;21,0;45,0;;;;15,0;26,0;;7,0;59,0;71,0;41,0;1,0;9,0;4,0;3,0;1,0;5,0;1,0;;8,0;1,0;95,0;5,0;3,0;30,0;5,0;;;2,0;;;;;12,0;4,0;1,0;1,0;;18,0;27,0;2,0;7,0;1,0;;;11,0;2,0;;23,0;2,0;3,0;2,0;2,0;3,0;4,0;22,0;;5,0;;;;5,0;;3,0;1,0;5,0;1,0;3,0;1,0;;;;;2,0;1,0;14,0;8,0;1,0;30,0;3,0;;19,0;76,0;2,0;1,0;33,0;;;4,0;2,0;17,0;;;1,0;;48,0;3,0;1,0;;;2,0;1,0;;1,0;6,0;11,0;;;;1,0;15,0;3,0;1,0;;1,0;3,0;3,0;1,0;;16,0;;;;7,0;9,0;22,0;14,0;2,0;;1,0;2,0;2,0;;1,0;;;32,0;140,0;;6,0;;2,0;5,0;8,0;136,0;4,0;11,0;22,0;;1,0;6,0;13,0;;;11,0;4,0;;;;25,0;46,0;;;;;;2,0;4,0;;12,0;5,0;2,0;3,0;;2,0;7,0;4,0;3,0;1,0;3,0;5,0;;;;4,0;4,0;;;28,0;;;;;2,0;;21,0;;;2,0;2,0;10,0;2,0;;2,0;;6,0;;4,0;;;;13,0;31,0;;9,0;;1,0;2,0;3,0;2,0;2,0;2,0;;;4,0;2,0;3,0;;;;;;46,0;;2,0;;;1,0;1,0;8,0;36,0;;;1,0;;120,0;;1,0;1,0;1,0;;1,0;;1,0;;3,0;3,0;7,0;;17,0;;;7,0;;;12,0;3,0;7,0;;2,0;2,0;;5,0;;;;;37,0;4,0;4,0;3,0;4,0;;;;;;4,0;16,0;4,0;7,0;3,0;;2,0;;;48,0;;1,0;2,0;15,0;;3,0;1,0;14,0;;;9,0;20,0;10,0;;;4,0;;;;;;3,0;5,0;2,0;;1,0;66,0;;;;1,0;1,0;;;5,0;3,0;;31,0;41,0;;;3,0;;;;;;;2,0;9,0;;;;10,0;;;;4,0;;;;5,0;2,0;;1,0;20,0;5,0;;;;;;4,0;7,0;7,0;6,0;36,0;6,0;;;7,0;;4,0;;;;3,0;1,0;;2,0;;3,0;6,0;;;;30,0;2,0;;;2,0;;4,0;;30,0;4,0;1,0;1,0;;;;2,0;;;;12,0;9,0;7,0;1,0;;;8,0;;1,0;6,0;;5,0;3,0;;1,0;11,0;34,0;;;3,0;;3,0;;2,0;;4,0;3,0;2,0;;;2,0;;;;;;;;;1,0;;;;;;;;;;;;3,0;;;3,0;;;;17,0;12,0;1,0;;;;;;3,0;6,0;;;;;5,0;;;15,0;5,0;;8,0;2,0;;;;1,0;;;;;;3,0;10,0;;;;1,0;;19,0;11,0;;;12,0;;;1,0;;;;2,0;3,0;1,0;1,0;;1,0;40,0;;;9,0;;5,0;;;;;;2,0;;1,0;;;6,0;;;;5,0;4,0;;22,0;;;;;8,0;;;;;;;;
pattern;;15,0;;49,0;4,0;60,0;126,0;5,0;;;;1,0;2,0;248,0;7,0;7,0;343,0;;7,0;42,0;1,0;1,0;196,0;6,0;3,0;4,0;5,0;48,0;27,0;1,0;111,0;14,0;20,0;24,0;;108,0;41,0;10,0;62,0;2,0;211,0;196,0;2,0;10,0;258,0;79,0;15,0;81,0;15,0;16,0;14,0;1,0;33,0;3,0;30,0;2,0;282,0;;20,0;157,0;;3,0;28,0;;953,0;2,0;404,0;16,0;6,0;6,0;4,0;60,0;670,0;2,0;;;38,0;20,0;23,0;22,0;377,0;;8,0;9,0;153,0;5,0;;78,0;9,0;9,0;25,0;12,0;6,0;;9,0;1,0;255,0;26,0;454,0;120,0;161,0;167,0;3,0;19,0;48,0;37,0;1,0;3,0;7,0;4,0;6,0;125,0;200,0;2,0;;11,0;29,0;79,0;160,0;86,0;55,0;7,0;69,0;20,0;5,0;57,0;219,0;;241,0;8,0;49,0;8,0;14,0;236,0;22,0;;34,0;17,0;1,0;4,0;;10,0;;;16,0;78,0;50,0;108,0;101,0;24,0;;33,0;8,0;19,0;21,0;2,0;;8,0;1,0;;91,0;102,0;13,0;6,0;2,0;4,0;18,0;25,0;4,0;13,0;11,0;27,0;9,0;49,0;;33,0;6,0;67,0;1,0;;13,0;;20,0;42,0;;116,0;82,0;;24,0;21,0;;1,0;6,0;1,0;19,0;17,0;44,0;2,0;24,0;3,0;31,0;147,0;6,0;;14,0;14,0;59,0;25,0;7,0;16,0;7,0;21,0;3,0;25,0;16,0;13,0;20,0;16,0;1,0;20,0;;22,0;9,0;2,0;4,0;2,0;143,0;2,0;1,0;22,0;1,0;33,0;20,0;32,0;5,0;12,0;85,0;56,0;;37,0;6,0;3,0;;;;35,0;10,0;145,0;43,0;;;2,0;5,0;152,0;71,0;7,0;13,0;192,0;18,0;;3,0;19,0;13,0;19,0;3,0;;13,0;8,0;;94,0;;68,0;43,0;13,0;;;2,0;26,0;;;;;14,0;96,0;6,0;;19,0;6,0;197,0;26,0;71,0;1,0;;1,0;14,0;;61,0;2,0;;;;;1,0;2,0;;1,0;1,0;4,0;12,0;71,0;;;4,0;;79,0;;41,0;;3,0;;38,0;230,0;9,0;14,0;12,0;;2,0;2,0;17,0;31,0;5,0;;;2,0;3,0;6,0;;;;;2,0;26,0;;;1,0;;15,0;6,0;;;;;19,0;;10,0;;2,0;23,0;13,0;;3,0;2,0;;6,0;9,0;47,0;22,0;;;20,0;;;38,0;13,0;38,0;7,0;3,0;2,0;32,0;7,0;56,0;94,0;;10,0;2,0;129,0;6,0;6,0;;3,0;4,0;14,0;35,0;11,0;3,0;22,0;;81,0;30,0;9,0;;14,0;3,0;4,0;5,0;104,0;6,0;5,0;27,0;4,0;4,0;20,0;;14,0;21,0;52,0;3,0;2,0;;;5,0;14,0;2,0;10,0;5,0;67,0;;18,0;;3,0;15,0;3,0;5,0;8,0;14,0;1,0;10,0;17,0;18,0;;12,0;30,0;11,0;7,0;20,0;13,0;2,0;2,0;90,0;;1,0;11,0;10,0;;;;2,0;329,0;;19,0;17,0;6,0;;23,0;3,0;40,0;2,0;;;;3,0;17,0;4,0;1,0;4,0;;12,0;4,0;;16,0;6,0;6,0;;21,0;8,0;1,0;40,0;3,0;1,0;6,0;13,0;5,0;5,0;370,0;1,0;8,0;21,0;6,0;;;8,0;1,0;5,0;5,0;1,0;5,0;5,0;3,0;;11,0;1,0;;;6,0;;8,0;;28,0;;114,0;;2,0;;20,0;;;;;;4,0;;8,0;;3,0;1,0;15,0;7,0;;1,0;69,0;2,0;1,0;4,0;49,0;3,0;;1,0;2,0;;7,0;;;29,0;4,0;2,0;1,0;2,0;1,0;;2,0;;3,0;7,0;38,0;3,0;2,0;28,0;;;;;3,0;;4,0;22,0;4,0;1,0;27,0;3,0;6,0;;;26,0;4,0;;;;;142,0;3,0;;;;17,0;3,0;;2,0;3,0;;9,0;3,0;1,0;1,0;51,0;2,0;;;5,0;2,0;2,0;2,0;13,0;14,0;20,0;;;3,0;10,0;22,0;5,0;;1,0;22,0;18,0;1,0;;11,0;;;1,0;3,0;;;2,0;;;;;4,0;4,0;1,0;;;1,0;4,0;;;2,0;;;;;;1,0;16,0;3,0;8,0;;80,0;6,0;18,0;14,0;12,0;;10,0;;;;;;94,0;;;14,0;1,0;14,0;10,0;;190,0;23,0;;1,0;;;9,0;;9,0;5,0;1,0;3,0;;;;7,0;;15,0;2,0;65,0;;;3,0;;6,0;5,0;5,0;1,0;;3,0;;3,0;18,0;1,0;2,0;;;187,0;9,0;1,0;;;1,0;1,0;3,0;;1,0;13,0;;9,0;144,0;2,0;;;4,0;;46,0;2,0;;;9,0;3,0;9,0;;7,0;;;1,0;;19,0;1,0;;;1,0;;13,0;1,0;2,0;6,0;;19,0;;;3,0;;;;;1,0;;;1,0;16,0;;178,0;;;;1,0;;4,0;;14,0;;;1,0;36,0;7,0;2,0;16,0;6,0;2,0;;;1,0;;;;2,0;;;;;;66,0;30,0;;;;;110,0;15,0;;3,0;3,0;;5,0;34,0;32,0;;3,0;;6,0;326,0;1,0;4,0;16,0;;4,0;51,0;;5,0;;;7,0;;6,0;10,0;;1,0;;3,0;;1,0;;35,0;;1,0;1,0;11,0;3,0;;13,0;8,0;;;8,0;;80,0;;10,0;1,0;;41,0;;14,0;5,0;36,0;10,0;;12,0;2,0;16,0;35,0;2,0;19,0;14,0;;2,0;7,0;17,0;13,0;;;2,0;;;4,0;;;;1,0;18,0;15,0;2,0;;3,0;;;;;1,0;;;;1,0;;;5,0;7,0;6,0;5,0;;;;;;;;;;4,0;;;;;5,0;7,0;;12,0;8,0;;;;;45,0;1,0;2,0;1,0;;2,0;;;;;1,0;;2,0;;1,0;;;;1,0;3,0;5,0;1,0;4,0;2,0;;2,0;27,0;;10,0;8,0;8,0;;;;6,0;;;10,0;;6,0;5,0;16,0;6,0;13,0;41,0;;1,0;;5,0;;;12,0;;;;21,0;;;;;1,0;;;;;;
perform;;3,0;1,0;52,0;16,0;197,0;73,0;7,0;17,0;3,0;;1,0;7,0;248,0;2,0;25,0;280,0;1,0;16,0;11,0;5,0;2,0;113,0;17,0;182,0;9,0;24,0;47,0;186,0;42,0;620,0;149,0;22,0;267,0;;340,0;23,0;2,0;97,0;1,0;265,0;623,0;1,0;91,0;157,0;12,0;16,0;61,0;12,0;16,0;42,0;;2,0;23,0;33,0;9,0;25,0;;19,0;105,0;;2,0;81,0;12,0;1606,0;6,0;210,0;10,0;5,0;5,0;18,0;200,0;97,0;;;;2,0;44,0;19,0;87,0;983,0;;113,0;35,0;124,0;10,0;19,0;107,0;2,0;23,0;60,0;3,0;14,0;5,0;96,0;;198,0;24,0;243,0;79,0;147,0;54,0;1,0;297,0;650,0;798,0;10,0;105,0;4,0;1,0;12,0;31,0;133,0;2,0;1,0;1,0;29,0;25,0;65,0;136,0;21,0;;283,0;12,0;1,0;61,0;448,0;11,0;26,0;1,0;125,0;3,0;2,0;571,0;4,0;;56,0;20,0;100,0;;;4,0;4,0;;19,0;33,0;44,0;31,0;46,0;3,0;;29,0;73,0;2,0;4,0;28,0;;;3,0;;1,0;23,0;29,0;23,0;6,0;27,0;11,0;18,0;2,0;210,0;30,0;4,0;10,0;94,0;30,0;32,0;24,0;8,0;44,0;5,0;3,0;1,0;4,0;44,0;1,0;6,0;75,0;2,0;87,0;12,0;16,0;3,0;1,0;6,0;7,0;9,0;7,0;1,0;2,0;2,0;3,0;1,0;8,0;7,0;28,0;56,0;27,0;2,0;10,0;54,0;21,0;83,0;36,0;;;2,0;71,0;11,0;11,0;23,0;40,0;61,0;13,0;37,0;4,0;;65,0;;15,0;18,0;1,0;7,0;47,0;13,0;1,0;16,0;6,0;3,0;1,0;5,0;1,0;4,0;;;;138,0;4,0;9,0;11,0;12,0;3,0;1,0;3,0;16,0;2,0;18,0;4,0;20,0;3,0;;33,0;29,0;16,0;199,0;;3,0;3,0;1,0;13,0;10,0;;7,0;19,0;34,0;5,0;1,0;12,0;20,0;;3,0;2,0;76,0;52,0;13,0;3,0;6,0;11,0;28,0;160,0;;3,0;8,0;;;3,0;;56,0;8,0;;2,0;8,0;;2,0;4,0;;;;6,0;6,0;183,0;;;;1,0;3,0;1,0;4,0;6,0;10,0;18,0;48,0;179,0;1,0;32,0;;;27,0;;52,0;;;;1,0;;44,0;;2,0;;4,0;3,0;15,0;102,0;10,0;;7,0;1,0;22,0;12,0;;;;;5,0;;57,0;;18,0;5,0;196,0;60,0;1,0;;7,0;120,0;6,0;116,0;13,0;2,0;;40,0;;;63,0;12,0;60,0;25,0;8,0;40,0;34,0;44,0;533,0;25,0;20,0;16,0;5,0;146,0;68,0;17,0;13,0;7,0;7,0;286,0;44,0;122,0;1,0;262,0;;59,0;29,0;;;81,0;18,0;31,0;15,0;35,0;26,0;45,0;69,0;19,0;;128,0;2,0;31,0;1127,0;4,0;2,0;36,0;3,0;;;27,0;;29,0;17,0;220,0;19,0;114,0;5,0;15,0;22,0;2,0;73,0;4,0;101,0;7,0;11,0;41,0;55,0;23,0;22,0;37,0;25,0;22,0;17,0;23,0;7,0;7,0;157,0;;7,0;3,0;17,0;;3,0;1,0;50,0;169,0;5,0;18,0;123,0;3,0;57,0;23,0;3,0;34,0;38,0;19,0;6,0;3,0;14,0;12,0;308,0;36,0;4,0;2,0;23,0;6,0;18,0;40,0;6,0;2,0;5,0;37,0;18,0;1,0;;3,0;22,0;26,0;1,0;;9,0;10,0;2,0;;10,0;4,0;23,0;31,0;13,0;14,0;18,0;10,0;11,0;14,0;4,0;6,0;;9,0;15,0;14,0;9,0;;3,0;29,0;1,0;26,0;;1,0;17,0;5,0;3,0;4,0;4,0;;1,0;1,0;1,0;1,0;8,0;70,0;2,0;3,0;18,0;2,0;14,0;1,0;5,0;93,0;6,0;;8,0;21,0;5,0;10,0;;17,0;2,0;22,0;;2,0;129,0;25,0;15,0;25,0;4,0;16,0;;;2,0;19,0;25,0;16,0;16,0;1,0;9,0;10,0;11,0;13,0;5,0;9,0;2,0;1,0;29,0;51,0;2,0;109,0;;3,0;74,0;;6,0;5,0;2,0;;27,0;13,0;59,0;37,0;12,0;1,0;8,0;7,0;;16,0;26,0;3,0;10,0;3,0;38,0;55,0;6,0;69,0;8,0;4,0;1,0;5,0;17,0;1,0;17,0;6,0;27,0;;3,0;2,0;7,0;8,0;;10,0;11,0;22,0;10,0;24,0;3,0;23,0;3,0;18,0;9,0;10,0;;7,0;12,0;50,0;;;6,0;;4,0;35,0;4,0;8,0;3,0;2,0;4,0;8,0;4,0;;1,0;1,0;11,0;10,0;9,0;19,0;3,0;12,0;13,0;4,0;62,0;39,0;6,0;3,0;15,0;3,0;39,0;;1,0;15,0;;5,0;52,0;5,0;4,0;27,0;26,0;16,0;2,0;6,0;44,0;6,0;7,0;3,0;2,0;20,0;3,0;7,0;15,0;5,0;;;;4,0;22,0;16,0;13,0;9,0;16,0;3,0;4,0;;;5,0;3,0;48,0;109,0;;;;;28,0;2,0;3,0;1,0;5,0;1,0;21,0;;5,0;39,0;3,0;8,0;;3,0;5,0;4,0;;;2,0;17,0;11,0;;2,0;1,0;4,0;32,0;2,0;1,0;;14,0;2,0;19,0;1,0;3,0;3,0;;14,0;1,0;8,0;7,0;31,0;3,0;;;;;;2,0;3,0;;3,0;;;;;2,0;2,0;4,0;9,0;10,0;5,0;44,0;;8,0;1,0;;;;;2,0;;13,0;;;6,0;;1,0;2,0;6,0;8,0;;;;17,0;4,0;10,0;;123,0;18,0;3,0;1,0;5,0;;1,0;63,0;3,0;6,0;1,0;;4,0;17,0;4,0;31,0;3,0;;3,0;56,0;1,0;14,0;3,0;6,0;;15,0;8,0;;8,0;7,0;;25,0;3,0;;6,0;11,0;30,0;;49,0;6,0;39,0;26,0;;53,0;5,0;;13,0;10,0;5,0;23,0;1,0;5,0;17,0;1,0;6,0;23,0;3,0;7,0;4,0;3,0;23,0;6,0;3,0;6,0;8,0;12,0;2,0;7,0;1,0;;14,0;8,0;5,0;5,0;5,0;4,0;9,0;58,0;26,0;10,0;5,0;5,0;42,0;3,0;6,0;6,0;3,0;3,0;;;1,0;3,0;6,0;1,0;4,0;1,0;;12,0;3,0;2,0;6,0;12,0;7,0;24,0;6,0;7,0;;2,0;32,0;2,0;3,0;4,0;1,0;6,0;;6,0;3,0;1,0;;1,0;1,0;;;8,0;1,0;;2,0;;;;13,0;7,0;;1,0;12,0;3,0;;1,0;;7,0;2,0;;;1,0;;3,0;125,0;;1,0;;;1,0;;1,0;7,0;;2,0;;2,0;3,0;35,0;10,0;31,0;5,0;3,0;12,0;8,0;;2,0;;8,0;4,0;;1,0;12,0;1,0;;;5,0;;9,0;;;;5,0;79,0;;;21,0;3,0;;15,0;37,0;2,0;3,0;3,0;5,0;8,0;9,0;;;;;23,0
period;;4,0;7,0;27,0;22,0;28,0;17,0;1,0;;;;2,0;;111,0;;11,0;164,0;;3,0;8,0;;;3,0;10,0;59,0;;1,0;5,0;7,0;16,0;34,0;19,0;3,0;4,0;;98,0;19,0;;5,0;;149,0;142,0;;19,0;73,0;6,0;;12,0;;3,0;20,0;;;;8,0;9,0;2,0;;35,0;45,0;2,0;;34,0;;319,0;;42,0;7,0;3,0;;20,0;85,0;83,0;;4,0;5,0;1,0;11,0;;24,0;158,0;;27,0;2,0;9,0;;;59,0;8,0;2,0;;1,0;32,0;;2,0;4,0;107,0;2,0;68,0;25,0;44,0;270,0;3,0;42,0;38,0;30,0;1,0;5,0;2,0;;;16,0;7,0;4,0;;1,0;;15,0;7,0;75,0;42,0;;298,0;6,0;;28,0;94,0;;;;1304,0;2,0;;140,0;9,0;3,0;11,0;3,0;15,0;2,0;;12,0;2,0;9,0;5,0;6,0;5,0;2,0;45,0;2,0;2,0;7,0;31,0;;15,0;14,0;;;;;8,0;7,0;1,0;2,0;7,0;;5,0;4,0;12,0;8,0;4,0;1,0;;27,0;;4,0;12,0;17,0;;;3,0;;4,0;8,0;;6,0;7,0;1,0;184,0;8,0;;;;15,0;;;;1,0;3,0;5,0;1,0;2,0;6,0;1,0;4,0;11,0;5,0;;40,0;;6,0;18,0;30,0;2,0;;;54,0;4,0;;9,0;22,0;;4,0;5,0;;;33,0;3,0;;1,0;;1,0;10,0;6,0;;1,0;3,0;;;14,0;1,0;;;;;44,0;5,0;8,0;1,0;3,0;;;;14,0;;15,0;1,0;9,0;;1,0;8,0;17,0;4,0;38,0;;;3,0;2,0;2,0;;2,0;;8,0;5,0;;;7,0;8,0;3,0;5,0;;;;1,0;;;;9,0;34,0;;2,0;;;;;;3,0;1,0;;;;;;1,0;;;1,0;1,0;;68,0;;;;;;;;;2,0;2,0;9,0;25,0;5,0;9,0;;;5,0;;24,0;;;;;;20,0;;2,0;;;;4,0;1,0;;;2,0;;;2,0;;;;;26,0;;7,0;;23,0;;77,0;6,0;2,0;1,0;;2,0;5,0;3,0;3,0;24,0;3,0;2,0;;;20,0;1,0;61,0;2,0;12,0;17,0;10,0;4,0;176,0;8,0;53,0;;2,0;23,0;24,0;1,0;;15,0;15,0;2,0;;10,0;5,0;16,0;11,0;13,0;33,0;;4,0;42,0;6,0;47,0;;12,0;;9,0;40,0;7,0;;13,0;;28,0;82,0;3,0;;;;;2,0;42,0;8,0;17,0;2,0;75,0;10,0;44,0;2,0;;4,0;2,0;55,0;3,0;2,0;;7,0;2,0;26,0;7,0;6,0;12,0;39,0;;;16,0;;;20,0;29,0;11,0;16,0;12,0;;;1,0;2,0;2,0;;;8,0;3,0;27,0;;;3,0;3,0;;;1,0;4,0;;5,0;3,0;1,0;;2,0;2,0;3,0;4,0;;2,0;;16,0;;;61,0;4,0;2,0;;;;;11,0;1,0;;;2,0;;;1,0;3,0;;1,0;;9,0;;3,0;;3,0;6,0;6,0;4,0;;;5,0;2,0;5,0;;;8,0;;;;;34,0;;;;;;6,0;;;35,0;4,0;41,0;1,0;6,0;1,0;;8,0;;14,0;;31,0;;5,0;;1,0;;;;1,0;10,0;32,0;;2,0;;;1,0;31,0;3,0;;5,0;;1,0;5,0;8,0;55,0;3,0;;;40,0;1,0;2,0;;;;;;2,0;;;4,0;;;1,0;;4,0;;;55,0;1,0;;;;;2,0;3,0;;;1,0;12,0;1,0;;6,0;12,0;1,0;20,0;;2,0;;1,0;;;;5,0;5,0;2,0;6,0;1,0;1,0;6,0;;;;6,0;;;;;;5,0;;5,0;2,0;;1,0;5,0;;;;;9,0;;1,0;;;;18,0;;14,0;;3,0;2,0;7,0;15,0;27,0;;;5,0;10,0;;17,0;;;6,0;;2,0;33,0;1,0;20,0;16,0;1,0;;;11,0;13,0;;5,0;1,0;;25,0;;6,0;1,0;;;4,0;;;28,0;;;8,0;;;;;;;;26,0;40,0;;;;;;;;;;13,0;80,0;4,0;1,0;21,0;7,0;;;;4,0;31,0;;;3,0;1,0;6,0;;11,0;;;10,0;;;;2,0;;12,0;;;;;2,0;;2,0;;;;;;;;;;;;;;;2,0;;;;;;;;33,0;;2,0;;;;;;;;;2,0;;8,0;1,0;;4,0;;1,0;5,0;1,0;;4,0;21,0;5,0;;26,0;18,0;1,0;;11,0;;;177,0;5,0;;;29,0;8,0;4,0;2,0;2,0;1,0;1,0;22,0;2,0;3,0;;;3,0;;15,0;3,0;31,0;4,0;2,0;2,0;4,0;6,0;;;15,0;;;;2,0;2,0;3,0;46,0;;1,0;;;;;;;;;;2,0;3,0;11,0;;1,0;3,0;1,0;;34,0;;;4,0;;;;;;3,0;;;3,0;;7,0;13,0;;3,0;;14,0;;3,0;;3,0;;;;;;;;;4,0;;;;;;3,0;1,0;;;;;;;;1,0;2,0;;;2,0;;;;7,0;;;;;2,0;2,0;;;;21,0;3,0;2,0;;11,0;34,0;;;;;4,0;;3,0;;;;4,0;4,0;;;;;;6,0;;;3,0;5,0;;;;2,0;;;;;7,0;;7,0;8,0;;;;2,0;1,0;;;;;;;9,0;;28,0;4,0;;;2,0;;;;3,0;;;;;;2,0;34,0;;;;13,0;;;;
permit;;4,0;;3,0;2,0;;3,0;15,0;;;;;3,0;7,0;;;2,0;;2,0;;;;;1,0;4,0;;;3,0;1,0;;35,0;;;1,0;;9,0;5,0;2,0;;;2,0;16,0;;;23,0;;;23,0;;3,0;;;4,0;;;;13,0;;;1,0;;;2,0;1,0;10,0;;8,0;;;;;31,0;22,0;;;;1,0;;;;3,0;;;;21,0;5,0;;7,0;;1,0;;;17,0;1,0;4,0;;;;3,0;;32,0;;2,0;;6,0;;4,0;1,0;;;;1,0;1,0;;3,0;;;1,0;1,0;2,0;;;1,0;6,0;;;2,0;;;;8,0;;4,0;3,0;;;;;;;;2,0;;;10,0;;3,0;1,0;3,0;6,0;3,0;1,0;24,0;;;;;;;;;14,0;;;;;9,0;7,0;;;;;1,0;4,0;;;;;;;2,0;;;4,0;;;3,0;2,0;5,0;2,0;1,0;;;6,0;3,0;1,0;20,0;;;4,0;;;7,0;;;1,0;22,0;;;7,0;5,0;33,0;;;;5,0;2,0;;;2,0;;;;;4,0;;28,0;;;;;1,0;16,0;;1,0;3,0;;1,0;1,0;;;3,0;;;1,0;26,0;;3,0;4,0;15,0;1,0;;;13,0;;4,0;18,0;17,0;;;4,0;2,0;;8,0;13,0;;;;;6,0;8,0;4,0;1,0;1,0;3,0;2,0;6,0;21,0;;;1,0;;9,0;;;;;;4,0;;1,0;;;10,0;;;3,0;1,0;;4,0;;;2,0;6,0;;2,0;2,0;3,0;;2,0;;;;1,0;;;;1,0;2,0;12,0;1,0;4,0;;;;;;;2,0;;3,0;;;;2,0;;1,0;;;;6,0;28,0;1,0;4,0;;4,0;;6,0;;2,0;;;;;2,0;2,0;;2,0;8,0;2,0;;;;2,0;;11,0;;;6,0;;;1,0;;;;;;;;;10,0;;;;;1,0;;1,0;;;;;;6,0;;;;;;1,0;;1,0;;1,0;;;;2,0;4,0;1,0;;;;6,0;2,0;17,0;;;;;;24,0;;;;12,0;1,0;;;;1,0;1,0;5,0;3,0;;;;;;;5,0;5,0;;2,0;;;;;21,0;;3,0;17,0;;;16,0;;;;;;;;;1,0;;;;2,0;;;;;;2,0;8,0;2,0;;;;;1,0;;;1,0;1,0;;;5,0;;;;;;;;;;2,0;;;;;;;;1,0;;1,0;;;;;1,0;;;2,0;;6,0;;;8,0;14,0;;;;;;;;;1,0;;;4,0;1,0;;;;;;;8,0;;24,0;;;;;1,0;;;;2,0;;;2,0;;;;;;1,0;;;;;;1,0;15,0;;;;;;5,0;;;;;;;;1,0;5,0;;2,0;7,0;;;;;;1,0;;6,0;;;10,0;;;;;;1,0;;;;;;2,0;;;;1,0;;10,0;;;;2,0;;;;2,0;;;;;;;;;6,0;;;;;;2,0;1,0;;;;1,0;;;;;;;;2,0;2,0;;1,0;2,0;2,0;;;;;1,0;;;;;;;1,0;;;;;;;;;;;;;;;2,0;;;;;;;;4,0;;;;2,0;;1,0;;1,0;2,0;;;;;2,0;1,0;;6,0;;;;;;;;;;2,0;6,0;2,0;;;;;;14,0;;;;;;;;14,0;;;10,0;3,0;;2,0;1,0;;2,0;1,0;;3,0;2,0;;3,0;;;;;;1,0;;;;;2,0;;;2,0;2,0;;;;;;;;;;;;;;;;;;;;;;;3,0;;;;;;;1,0;;;;;;;;;6,0;;;;;;;;;;1,0;;;;;;;;;;;;;;;;;;;;;;;1,0;;;;;;;;;;;;;;;;;;;;;;2,0;;;;;;;;;1,0;;;;;;2,0;;;;;;;;;;;;;;;1,0;;;;;;4,0;;4,0;;;;3,0;;;;;;;;;;;;2,0;;;;1,0;;;;;;;;;;5,0;;;;;;6,0;;;;1,0;;;1,0;;;;;;;2,0;;;;;;;4,0;;;;;;;1,0;;;;;;;;;;;;;;;;;;;;;;;;;;;;;;;;;;;;1,0;;;
person;;2,0;;3,0;;29,0;;;2,0;50,0;;;;45,0;;;76,0;;;4,0;;;7,0;1,0;4,0;;;;2,0;1,0;41,0;4,0;;;;18,0;;4,0;1,0;;114,0;86,0;;5,0;18,0;;;1,0;;16,0;4,0;;3,0;;4,0;;6,0;;;4,0;;;12,0;;220,0;;63,0;;1,0;;1,0;2,0;6,0;;;;;;4,0;;77,0;;3,0;;3,0;;2,0;;;4,0;;;;;13,0;;36,0;10,0;22,0;4,0;5,0;26,0;;2,0;6,0;7,0;2,0;3,0;;1,0;;1,0;9,0;1,0;;1,0;;6,0;2,0;12,0;;;11,0;;;18,0;50,0;;;;13,0;;;16,0;5,0;1,0;43,0;6,0;;2,0;;;;;;;36,0;1,0;26,0;5,0;;2,0;12,0;;;;;;;;;;7,0;;;;;;;42,0;7,0;2,0;8,0;35,0;;;;;2,0;;;;;137,0;;4,0;1,0;;28,0;5,0;;25,0;;2,0;;;3,0;;;;;;;;2,0;3,0;4,0;;;13,0;9,0;17,0;4,0;;;2,0;5,0;;;1,0;9,0;4,0;;;2,0;;25,0;;;2,0;;;1,0;1,0;;18,0;;;1,0;6,0;;;;;;7,0;;;15,0;;;;;;;;1,0;3,0;;;;5,0;13,0;28,0;;3,0;;;;5,0;2,0;1,0;;;;;1,0;3,0;;;;;;1,0;;;;7,0;;;;;;;;;19,0;;;;;;;;;;;19,0;34,0;5,0;;;5,0;;3,0;;25,0;1,0;;5,0;4,0;57,0;;9,0;1,0;;;;;;;;;;14,0;;;;;;;;3,0;;;;;9,0;;;;2,0;;;58,0;;5,0;6,0;66,0;;3,0;;;2,0;;;6,0;2,0;;;;;3,0;2,0;;;;2,0;8,0;2,0;11,0;;2,0;;4,0;183,0;4,0;1,0;;5,0;1,0;;23,0;6,0;;;;39,0;10,0;6,0;;1,0;;1,0;;11,0;9,0;4,0;12,0;2,0;;40,0;;4,0;3,0;1,0;;;;;6,0;;;;;11,0;5,0;9,0;;;7,0;;10,0;12,0;;;;47,0;;;;8,0;;;;3,0;;;35,0;;;;1,0;1,0;;;2,0;1,0;;;6,0;;25,0;5,0;;;;;;4,0;;;4,0;;;;;1,0;;;;;;16,0;2,0;;13,0;5,0;1,0;2,0;3,0;40,0;2,0;3,0;;;;4,0;;;;1,0;;;;1,0;;12,0;;1,0;5,0;;3,0;;;;;7,0;;;3,0;;;;9,0;8,0;;;1,0;;;1,0;;;;2,0;2,0;10,0;1,0;4,0;;1,0;;;2,0;4,0;;;;2,0;;;34,0;1,0;4,0;;12,0;;3,0;;;1,0;;2,0;;;2,0;5,0;14,0;1,0;5,0;;;;;;;;;;;1,0;;;4,0;1,0;;1,0;;3,0;;15,0;;3,0;8,0;;;8,0;5,0;11,0;3,0;1,0;15,0;19,0;;;;;;;;;3,0;;3,0;;11,0;6,0;8,0;;;1,0;;7,0;;;;;;1,0;;;;4,0;8,0;;;;;;;;1,0;1,0;;;;;;;;;43,0;;;3,0;4,0;;;;;4,0;1,0;8,0;3,0;;;;;;2,0;1,0;6,0;5,0;;3,0;;;;;;;;;;9,0;;;1,0;6,0;;4,0;;;;3,0;;;;;;;4,0;;;;;4,0;;;;;;;;5,0;;;;1,0;3,0;;;3,0;1,0;;;;1,0;1,0;;;;;10,0;;;;;;6,0;;;;;;;4,0;2,0;1,0;;;;;;;;;;;;;1,0;;;8,0;1,0;;;;;;1,0;;;;;;;;;;;;;3,0;;1,0;;;;;;;;;;1,0;;;;;;;;;;;3,0;2,0;;;;;;4,0;;;;;;;;;;;;1,0;;;;;;;;;;;;;;;;;;1,0;;3,0;;;;1,0;1,0;;;;;;6,0;;4,0;2,0;;4,0;;;;;;;2,0;1,0;;;;;;;;;;;1,0;;;5,0;;;;;;;;;;;;;;;;;;2,0;1,0;;;;;;;;;;;;;;;;;1,0;;;;;;;1,0;;;;;1,0;;3,0;;;;;;;;;;;;;;;;;;;1,0;;;;;;;;;;;;1,0;;15,0;;;;;;;;;;;;;;6,0;;10,0;;;;;;4,0;;;;;;;;;
phase;;1,0;;14,0;23,0;17,0;15,0;;;21,0;;1,0;;45,0;;;25,0;2,0;;10,0;3,0;;32,0;;4,0;1,0;13,0;2,0;4,0;;33,0;;3,0;32,0;4,0;60,0;1,0;12,0;70,0;9,0;77,0;33,0;1,0;16,0;2,0;1,0;;8,0;;2,0;2,0;;;;6,0;2,0;8,0;;53,0;9,0;;;2,0;;178,0;6,0;21,0;6,0;;;1,0;112,0;37,0;3,0;;34,0;6,0;32,0;;3,0;106,0;;15,0;2,0;6,0;3,0;;15,0;;1,0;8,0;4,0;4,0;;1,0;;107,0;1,0;40,0;1,0;117,0;17,0;;2,0;18,0;18,0;1,0;3,0;;5,0;;13,0;2,0;;;;;9,0;13,0;34,0;5,0;;139,0;;;;23,0;;;;26,0;;;45,0;5,0;;8,0;7,0;;;;1,0;;17,0;;11,0;26,0;14,0;7,0;1,0;;3,0;2,0;;;;;;;;;2,0;;25,0;;;1,0;4,0;;28,0;7,0;;;14,0;;103,0;1,0;6,0;1,0;;1,0;;;;;1,0;12,0;;15,0;;1,0;;;4,0;;;3,0;2,0;;1,0;;1,0;;;21,0;1,0;4,0;;3,0;4,0;7,0;43,0;3,0;1,0;;;17,0;11,0;;2,0;4,0;5,0;;;13,0;;5,0;;;1,0;;14,0;13,0;;;;6,0;4,0;;3,0;;;;;;;;1,0;6,0;;;;;;;1,0;;4,0;1,0;;;15,0;;12,0;;;;4,0;;;;;27,0;;;;3,0;24,0;;;;12,0;9,0;;3,0;5,0;5,0;1,0;20,0;;2,0;;;;;;25,0;10,0;2,0;;;;;;;;;;;7,0;;;;1,0;;;;2,0;;;;2,0;2,0;;;;;;2,0;;;;;;6,0;;;;;;2,0;5,0;3,0;;;;;;;;;;2,0;;1,0;;;2,0;5,0;2,0;;;;;;1,0;;;;;;;21,0;11,0;45,0;17,0;;;9,0;1,0;38,0;5,0;5,0;;;39,0;2,0;253,0;2,0;;;;2,0;36,0;;12,0;;20,0;6,0;;;8,0;;;6,0;;3,0;3,0;3,0;;;1,0;;6,0;16,0;1,0;1,0;4,0;;;;;;3,0;1,0;14,0;;11,0;8,0;;10,0;;13,0;;;;3,0;2,0;3,0;2,0;18,0;4,0;18,0;;;3,0;;;1,0;;;8,0;;;;;;1,0;;;21,0;;2,0;2,0;;;;;;;4,0;17,0;1,0;;;;1,0;;;;;;;8,0;;;35,0;;;;;;3,0;1,0;;;1,0;;;;;2,0;;;1,0;1,0;;1,0;;;7,0;;;;;;;12,0;;1,0;1,0;;;;;;;;;;4,0;;;;;;2,0;;;1,0;;;;10,0;;;;;;;;;4,0;7,0;;1,0;;1,0;;;2,0;2,0;1,0;;;;;1,0;1,0;;;;;;;;2,0;8,0;;13,0;;;3,0;;6,0;;;;;9,0;;;8,0;1,0;;;;;2,0;;3,0;;;3,0;;;;2,0;2,0;16,0;2,0;;;;;;;;;;;;3,0;;;9,0;;;;;5,0;;;;;;;1,0;6,0;;;3,0;;;4,0;;;;;;22,0;;2,0;;;;1,0;;8,0;;;;;;11,0;;;;;;6,0;;;;;;2,0;2,0;27,0;;;;1,0;2,0;;;1,0;;;;;;21,0;;9,0;6,0;;;;;;;7,0;20,0;8,0;;;;;4,0;;;;;;6,0;1,0;;;;;;;;3,0;;;;;2,0;;;;;2,0;;;;70,0;;1,0;;;;;6,0;;;;1,0;;;;;;;;;3,0;;;;;;;3,0;;;;;;;1,0;;;;;;;;;;;;;8,0;4,0;4,0;;;2,0;1,0;7,0;3,0;;;7,0;2,0;;;;;;17,0;;;;14,0;;;;;;5,0;4,0;;;4,0;7,0;;;2,0;;;;;4,0;35,0;3,0;;1,0;2,0;3,0;;;7,0;;;;;;;;;7,0;;;;1,0;;;2,0;;;4,0;;3,0;;1,0;1,0;;;;;;30,0;;;2,0;3,0;;1,0;;1,0;;4,0;;4,0;;3,0;;;;;;;;;1,0;;;;;1,0;;;;;;;;;;;;;;;;;2,0;;;;;;;;;8,0;;;;;;;25,0;;19,0;;;;;;1,0;;5,0;;;10,0;;5,0;;;;;;;;;;;;;;;;;;;;25,0;;;6,0;;;;;;;;;3,0;6,0;;;;;;;;4,0;;;;;;;;;;;;;;;;;
phone;;5,0;;2,0;;9,0;3,0;44,0;;;;;;5,0;;;7,0;53,0;;3,0;;;;5,0;11,0;1,0;;10,0;36,0;;25,0;;;;1,0;17,0;;1,0;3,0;;1,0;186,0;;28,0;24,0;;27,0;;;;;;1,0;10,0;;;3,0;;7,0;4,0;3,0;;2,0;8,0;28,0;;35,0;;;;6,0;22,0;11,0;1,0;1,0;;;;5,0;10,0;25,0;;3,0;;87,0;1,0;;;;;;;;1,0;;;;9,0;2,0;;22,0;;;2,0;;11,0;1,0;2,0;;1,0;;;4,0;;2,0;;1,0;;1,0;17,0;;;8,0;6,0;;8,0;35,0;;;2,0;1,0;;;1,0;;;15,0;1,0;1,0;;;3,0;;;7,0;1,0;2,0;;3,0;8,0;;3,0;3,0;;;1,0;;;;;1,0;9,0;3,0;;;;13,0;2,0;;1,0;;;;2,0;;1,0;;;7,0;;;8,0;;3,0;;;2,0;;2,0;11,0;;3,0;;2,0;;8,0;26,0;3,0;1,0;;;;;;3,0;2,0;4,0;;;63,0;1,0;;2,0;;;5,0;4,0;3,0;;;1,0;;;1,0;5,0;;17,0;;;;;;2,0;;2,0;;;;5,0;;1,0;1,0;4,0;4,0;;2,0;3,0;2,0;28,0;1,0;1,0;1,0;;4,0;;;3,0;5,0;11,0;;;11,0;14,0;;3,0;;;;;;;4,0;;6,0;;;11,0;1,0;;;32,0;;3,0;8,0;;;;39,0;;;1,0;;;;;;;2,0;;2,0;;2,0;;;;;;1,0;;9,0;;;;1,0;;;3,0;2,0;3,0;;237,0;;3,0;1,0;;7,0;;;3,0;1,0;;;;3,0;;1,0;;;2,0;;3,0;;;;;1,0;;1,0;;;;;;;;;1,0;1,0;16,0;14,0;;;;1,0;;1,0;2,0;;;;;;;;;1,0;2,0;3,0;;;31,0;;;2,0;;1,0;1,0;;;;;4,0;;1,0;;4,0;;;;3,0;1,0;1,0;13,0;;;1,0;;4,0;;;1,0;1,0;;1,0;19,0;2,0;;;;;;;;;1,0;20,0;2,0;7,0;1,0;;;;2,0;4,0;;;3,0;1,0;1,0;;;9,0;1,0;;;3,0;;;21,0;;;1,0;2,0;1,0;;6,0;;;;2,0;18,0;1,0;;1,0;;;;;2,0;;3,0;;5,0;14,0;;;;2,0;8,0;2,0;;;;4,0;;;4,0;;9,0;1,0;;;;;5,0;1,0;5,0;2,0;;;;;1,0;2,0;;;1,0;3,0;;;3,0;;;;;;;;;;7,0;4,0;;;;;8,0;;;1,0;;;2,0;;;1,0;;;;1,0;;;;;;3,0;6,0;;;1,0;;;;;;;;;;;3,0;;1,0;;;;3,0;2,0;4,0;3,0;;;1,0;;;8,0;;;;5,0;;;;1,0;1,0;;32,0;2,0;1,0;;2,0;;;;;;;3,0;1,0;;;;;3,0;;;;;;;;;;;3,0;;;;;3,0;1,0;;;;7,0;;;;;;1,0;;37,0;10,0;;;;;8,0;;;3,0;;;;;;9,0;;;;;1,0;;;;2,0;;15,0;;1,0;3,0;1,0;;1,0;;1,0;;;103,0;10,0;;;;;;;;;;;;;;2,0;;1,0;;;;1,0;4,0;;;;;;;3,0;;;;;;2,0;5,0;;;;;;;3,0;1,0;;;;4,0;;;11,0;;;3,0;;;;;2,0;;;;;;;1,0;;;;;1,0;15,0;5,0;;6,0;;;;;3,0;;1,0;;;1,0;;;;;;;;;;;;;;1,0;;;;;;1,0;;;;;;;;;;;;2,0;;;;;;;;;;;;;;;;4,0;;;;;;;;;;;1,0;;1,0;;;1,0;;;5,0;;;;;;;;;;;;;;;;;;;;;2,0;;;;;;1,0;;;;;;;;;;;9,0;;2,0;;1,0;;;;;;;;3,0;;;2,0;;;;;;;;;2,0;;;3,0;;;;;;;;;;;;;;1,0;1,0;;;3,0;;;;;;;;;;;;;;;;;;;;1,0;;;;;;1,0;;;3,0;;1,0;;;1,0;;;;;;;;;;;;;2,0;;;;;;;;;2,0;1,0;;;;;;;;;;;3,0;;;;;;;;2,0;;;;;;;;;;;;;;;;;;;
physical;;2,0;;25,0;4,0;44,0;16,0;16,0;;1,0;;;1,0;77,0;1,0;1,0;40,0;2,0;3,0;31,0;;;2,0;1,0;16,0;1,0;;33,0;8,0;10,0;53,0;4,0;;12,0;;64,0;6,0;3,0;9,0;;89,0;99,0;3,0;8,0;13,0;9,0;;14,0;3,0;;26,0;20,0;2,0;1,0;25,0;1,0;20,0;;1,0;13,0;;;6,0;;171,0;7,0;69,0;1,0;7,0;;1,0;16,0;18,0;;;69,0;34,0;24,0;12,0;4,0;63,0;;3,0;9,0;128,0;;4,0;15,0;17,0;1,0;21,0;3,0;;;;;51,0;3,0;36,0;46,0;148,0;;;1,0;3,0;38,0;;1,0;14,0;;;46,0;12,0;2,0;;10,0;;29,0;54,0;65,0;;;14,0;10,0;;16,0;50,0;;;3,0;10,0;;;13,0;;;62,0;44,0;5,0;;;8,0;4,0;;10,0;2,0;12,0;4,0;20,0;1,0;;13,0;13,0;;;;;1,0;;;1,0;6,0;1,0;13,0;;2,0;16,0;9,0;1,0;3,0;2,0;;13,0;;;6,0;;;3,0;;;;2,0;4,0;1,0;;1,0;6,0;5,0;5,0;;3,0;1,0;;4,0;3,0;34,0;;;3,0;;16,0;6,0;2,0;93,0;7,0;3,0;;1,0;35,0;7,0;39,0;2,0;;;4,0;2,0;;;2,0;3,0;4,0;5,0;;2,0;1,0;22,0;;5,0;;;;;;16,0;1,0;;;;25,0;;;1,0;;;8,0;;17,0;2,0;;;;;18,0;;;4,0;99,0;1,0;;2,0;8,0;;6,0;;;1,0;;;;;;2,0;1,0;;;3,0;20,0;;10,0;1,0;;1,0;;;;;;3,0;;;20,0;;;50,0;2,0;7,0;28,0;;;;;;;;;13,0;2,0;;7,0;;;;;;;4,0;6,0;;16,0;11,0;264,0;;;;;;;3,0;1,0;;2,0;;;1,0;;6,0;;3,0;;1,0;4,0;8,0;;;1,0;;84,0;;1,0;;3,0;;;8,0;;;;16,0;6,0;1,0;;1,0;;1,0;5,0;23,0;;;;;;;;12,0;;;2,0;7,0;3,0;43,0;18,0;;6,0;7,0;38,0;4,0;6,0;;1,0;;7,0;;6,0;5,0;12,0;;37,0;11,0;29,0;1,0;18,0;2,0;16,0;;64,0;2,0;1,0;25,0;;;7,0;;;8,0;45,0;;;1,0;;1,0;;;4,0;1,0;42,0;3,0;6,0;5,0;1,0;6,0;;10,0;;5,0;;1,0;13,0;;;;1,0;7,0;;4,0;6,0;;;79,0;;;1,0;4,0;;;;;9,0;1,0;;42,0;6,0;;;;;1,0;;8,0;;4,0;2,0;1,0;21,0;;;1,0;13,0;3,0;6,0;22,0;8,0;;;1,0;;3,0;;1,0;;;2,0;;1,0;2,0;6,0;21,0;;5,0;;;4,0;;1,0;;1,0;1,0;;3,0;1,0;1,0;2,0;13,0;2,0;1,0;;;1,0;;;21,0;1,0;8,0;4,0;;;;1,0;;;;1,0;;2,0;1,0;;;5,0;4,0;2,0;;5,0;;;;5,0;19,0;;2,0;;;2,0;1,0;11,0;3,0;;;;3,0;;1,0;;2,0;1,0;1,0;;6,0;;2,0;2,0;;1,0;12,0;;6,0;1,0;;2,0;;3,0;;5,0;;5,0;2,0;2,0;;;3,0;2,0;13,0;7,0;;;;;;1,0;132,0;;;;;31,0;2,0;1,0;;;;;1,0;;14,0;;2,0;;4,0;8,0;6,0;6,0;;;;9,0;;;;;;;1,0;;2,0;7,0;;;;5,0;4,0;;;;;1,0;;5,0;;;1,0;4,0;;7,0;2,0;;17,0;;52,0;;2,0;6,0;;5,0;;;2,0;;;;;;3,0;;;;;1,0;;1,0;14,0;;;;1,0;9,0;5,0;1,0;4,0;;2,0;1,0;;;;;1,0;23,0;;2,0;1,0;;;;;;5,0;;;;;;;2,0;;1,0;;;;3,0;;;;;;;;;1,0;;;3,0;;;;5,0;66,0;2,0;;;1,0;;1,0;;;;;;;9,0;1,0;;;;1,0;;;2,0;;;1,0;;4,0;;;;;;;;;;;;7,0;;;;1,0;;1,0;1,0;;;;1,0;;;;;;;;;4,0;;;;1,0;;;;;;;2,0;;;;;1,0;;1,0;2,0;;;;;3,0;;;;;;;;;;;7,0;;;;;2,0;;;7,0;;;;;6,0;;;;;;;;;;10,0;1,0;2,0;;;;3,0;1,0;;1,0;;;9,0;2,0;;1,0;;;;8,0;;;;;;;;;4,0;1,0;;;5,0;1,0;;;2,0;1,0;;;;;;2,0;;;;;;;;2,0;;;;;;;5,0;;;;;;;;1,0;;;;;;;;;;;;;;;;;7,0;;4,0;2,0;;;;;;;;;;;;1,0;;;;1,0;2,0;;;1,0;;;;4,0;4,0;;;;;;;;;;;4,0;;;;;2,0;;;;;;1,0;8,0;;;;;;;;;;;;;;;
pickup;;10,0;;9,0;24,0;236,0;1,0;;;;;;3,0;29,0;;;36,0;2,0;;;;;4,0;5,0;27,0;1,0;;;;4,0;40,0;15,0;5,0;8,0;1,0;30,0;4,0;1,0;2,0;;3,0;434,0;5,0;3,0;3,0;5,0;4,0;164,0;;4,0;;;2,0;;;12,0;27,0;;;31,0;4,0;;;;1272,0;;85,0;;;;2,0;231,0;49,0;1,0;;;4,0;11,0;;2,0;7,0;;14,0;;37,0;8,0;;159,0;;;;;8,0;2,0;2,0;25,0;44,0;24,0;34,0;2,0;49,0;22,0;;2,0;14,0;2,0;;;1,0;;1,0;3,0;15,0;;;;;;;6,0;;;30,0;2,0;1,0;1,0;105,0;;;1,0;27,0;;;97,0;;;10,0;;5,0;;6,0;;1,0;;11,0;1,0;6,0;20,0;;8,0;;4,0;10,0;;;2,0;;;1,0;;8,0;8,0;;8,0;;;;18,0;;7,0;1,0;;2,0;17,0;;;4,0;;;;;2,0;;2,0;;;19,0;;10,0;4,0;;;1,0;10,0;8,0;;29,0;10,0;4,0;;;2,0;;;3,0;;23,0;;10,0;30,0;8,0;5,0;2,0;;;3,0;3,0;4,0;;33,0;2,0;5,0;;3,0;4,0;;49,0;;4,0;1,0;1,0;;7,0;;;1,0;3,0;;7,0;1,0;;1,0;;;4,0;1,0;;23,0;21,0;;;;;;93,0;3,0;1,0;17,0;;;7,0;8,0;6,0;;;;;2,0;1,0;;;2,0;3,0;6,0;;;;5,0;;;1,0;2,0;23,0;;;;4,0;18,0;10,0;;;;;1,0;;;8,0;;1,0;;;;;;;3,0;;;;4,0;;;4,0;4,0;;;2,0;;;1,0;;40,0;1,0;;;3,0;;;18,0;;;;;;5,0;4,0;;1,0;;;1,0;;;;;;;3,0;;1,0;;;1,0;;;;14,0;;6,0;;;;;;3,0;;;;;;;;2,0;21,0;12,0;11,0;;8,0;;;22,0;8,0;;;;13,0;1,0;2,0;;;;;;21,0;;6,0;;;;;;;;1,0;;;;;27,0;;;11,0;;;27,0;;;;;;;;;1,0;;30,0;;;;;1,0;;1,0;;;;;40,0;7,0;;4,0;6,0;;3,0;1,0;;;;;;;1,0;;;;;1,0;;;;;;;;;;;3,0;;;;;3,0;;;3,0;;3,0;;;;;;;;;27,0;;;;;;;;4,0;;;;;;;;;;;3,0;;;;;;;;;;;;4,0;;;27,0;;;14,0;;2,0;;;;;;;;6,0;1,0;;2,0;;;;;2,0;;11,0;;;;;;2,0;;;2,0;;;;;;;;;11,0;;;;;;;;;;;;;;;;;;;;3,0;;;;;;;;1,0;;;;;;;;11,0;;;;1,0;;;;;;3,0;;1,0;;;;1,0;;1,0;;;;;;;2,0;;2,0;;1,0;;;3,0;;;;;6,0;;;;;;;;;;5,0;;;;;;;;;;;;;;4,0;2,0;;;;;4,0;1,0;;;;;3,0;;;;;;;;4,0;;;5,0;;1,0;;;2,0;;;;;;;;;3,0;5,0;;;6,0;;;;1,0;22,0;;;;;;;;;;;;;2,0;18,0;1,0;;;;3,0;;;;;;;;;;3,0;;;;;3,0;;;;;;;1,0;4,0;;;1,0;;;;;;2,0;;2,0;;;;;;;;;2,0;;;;;;;1,0;;;;;8,0;;;;;;10,0;;;;2,0;;;5,0;5,0;1,0;1,0;;1,0;;;5,0;;;2,0;2,0;5,0;;;;;;2,0;;;;4,0;;3,0;8,0;;;;;;2,0;;;;4,0;4,0;;;6,0;;;;1,0;;;;;4,0;;;;;5,0;;;;;;;;;;;;;;;;;;;;;;;;1,0;;;7,0;;5,0;;;;4,0;;;;;;;;;;;;;;;;;;;;;;;;;;;2,0;;;;;;;;;;;;;;1,0;;;;;;;;;;;;;;;;;;;;;;;;;;;;;;;;;;2,0;;;;;;;;;;;;;;;;;;;;;;;;;;;;;;;;;;;;;;;;;;;;;;
picture;;2,0;;11,0;;50,0;;;;33,0;;;;35,0;;4,0;124,0;;;3,0;;;1,0;8,0;5,0;;;1,0;8,0;9,0;66,0;12,0;1,0;;;162,0;3,0;12,0;1,0;;93,0;214,0;;87,0;137,0;3,0;3,0;17,0;;;1,0;;3,0;6,0;15,0;1,0;3,0;;;102,0;;;14,0;;376,0;4,0;43,0;15,0;10,0;2,0;;24,0;14,0;1,0;;;1,0;2,0;;64,0;129,0;;20,0;3,0;53,0;3,0;;6,0;;7,0;9,0;3,0;;1,0;25,0;;57,0;6,0;26,0;32,0;46,0;35,0;;19,0;33,0;41,0;4,0;11,0;1,0;1,0;;25,0;273,0;;;6,0;31,0;9,0;4,0;52,0;41,0;;53,0;11,0;;109,0;75,0;;3,0;;77,0;;24,0;16,0;;;34,0;;10,0;;;;;;15,0;7,0;38,0;15,0;17,0;1,0;24,0;3,0;19,0;;;;;;1,0;;;11,0;1,0;;;;3,0;;20,0;10,0;1,0;;;17,0;8,0;;;17,0;7,0;;;2,0;1,0;27,0;;3,0;3,0;;79,0;1,0;;4,0;;;;;6,0;2,0;;2,0;;1,0;4,0;;;14,0;;1,0;24,0;2,0;;;;;;3,0;14,0;1,0;;;;31,0;4,0;;;;15,0;;1,0;5,0;;1,0;3,0;4,0;;2,0;8,0;4,0;;;;1,0;;;;25,0;17,0;2,0;5,0;;;;;10,0;;;;15,0;9,0;;14,0;27,0;6,0;3,0;1,0;;22,0;;23,0;7,0;;1,0;;1,0;2,0;;10,0;1,0;;25,0;;2,0;2,0;;1,0;;;1,0;1,0;;;1,0;;;7,0;;22,0;;;;;;;;;;;2,0;1,0;4,0;;;2,0;;1,0;;15,0;1,0;;1,0;29,0;60,0;;8,0;;;;;;9,0;;;;;60,0;2,0;;;;;14,0;10,0;;;;;6,0;2,0;;;1,0;;;;;;2,0;;225,0;7,0;15,0;;;1,0;;2,0;4,0;;;3,0;;;12,0;29,0;7,0;;;10,0;31,0;13,0;44,0;28,0;;1,0;;17,0;2,0;18,0;;4,0;;5,0;3,0;17,0;;19,0;;16,0;15,0;;;18,0;2,0;86,0;;6,0;;10,0;238,0;6,0;;51,0;;11,0;4,0;1,0;;;;;;6,0;;;2,0;58,0;13,0;28,0;5,0;;;14,0;24,0;8,0;20,0;;22,0;20,0;20,0;;;20,0;13,0;;;11,0;;4,0;86,0;;;;1,0;;;;1,0;5,0;;1,0;;;;25,0;;;;;3,0;;7,0;4,0;22,0;12,0;1,0;;;;;5,0;;;2,0;1,0;32,0;;10,0;5,0;2,0;;;;;4,0;;;9,0;;6,0;1,0;;;1,0;31,0;;1,0;;1,0;1,0;7,0;6,0;;19,0;2,0;1,0;3,0;;17,0;2,0;;14,0;7,0;;;4,0;;3,0;;;5,0;;4,0;;1,0;17,0;13,0;1,0;;;11,0;;;;3,0;3,0;;23,0;;;3,0;;;4,0;;9,0;4,0;13,0;10,0;;;;1,0;;;9,0;3,0;6,0;5,0;4,0;5,0;;2,0;;;6,0;5,0;1,0;1,0;;;1,0;;;;;5,0;;;3,0;1,0;;9,0;2,0;;2,0;;;;12,0;;;;4,0;8,0;;8,0;2,0;14,0;;;6,0;;;;;;23,0;;1,0;;1,0;9,0;;5,0;1,0;;;;;2,0;;;2,0;4,0;;;;;;;3,0;2,0;;;3,0;12,0;;;10,0;;;2,0;2,0;;1,0;6,0;;;6,0;;;3,0;3,0;2,0;4,0;;;;;;2,0;;;;6,0;;;;10,0;;3,0;;;;4,0;5,0;;;;1,0;1,0;;;2,0;14,0;3,0;5,0;;3,0;4,0;;;56,0;2,0;;;;2,0;8,0;;;10,0;;;;;;1,0;;1,0;13,0;;;1,0;1,0;;;;2,0;60,0;;19,0;;;16,0;;9,0;;;;1,0;;;;;;6,0;4,0;3,0;;;;;;1,0;;;;;;;;;2,0;;;;;;1,0;3,0;2,0;;1,0;;;;1,0;;;;;;;3,0;;;5,0;;;;;;;;;;3,0;55,0;;;;;4,0;;2,0;;;;;;;;;;1,0;;;;;;;;;;;1,0;38,0;4,0;;2,0;;;;;;9,0;8,0;;;1,0;;;;3,0;7,0;;;;1,0;;2,0;;4,0;1,0;;8,0;;;;;1,0;;;;;;;;13,0;;;2,0;;;;10,0;1,0;;5,0;;;;1,0;;;;37,0;;;3,0;1,0;;1,0;;;1,0;3,0;;2,0;3,0;;;26,0;1,0;;;;1,0;;;12,0;;2,0;;1,0;1,0;;;;;;3,0;;5,0;;;1,0;;;1,0;;;;;;;;4,0;;;;;;;;;;;3,0;;;;;8,0;;;;;;;;;;;10,0;;;1,0;;;;;2,0;2,0;;;;;;2,0;;;;1,0;;;;2,0;;3,0;;1,0;;25,0;;;;;
pivot;;1,0;;14,0;3,0;17,0;;69,0;;;;;13,0;25,0;;;2,0;;6,0;;;;;;6,0;;;41,0;;;48,0;2,0;;;;;20,0;10,0;;2,0;;35,0;1,0;;12,0;38,0;;53,0;;;;;50,0;2,0;10,0;1,0;8,0;;;1,0;;;;;12,0;;28,0;;;6,0;4,0;9,0;4,0;;;;7,0;;;;24,0;;;;14,0;10,0;;11,0;;;;4,0;10,0;1,0;;;;39,0;4,0;27,0;64,0;3,0;;;;1,0;1,0;;;;;1,0;3,0;;;;1,0;11,0;;2,0;;3,0;4,0;;;1,0;44,0;;;;;;;42,0;;;8,0;5,0;;;;;;;6,0;;2,0;15,0;;17,0;14,0;10,0;17,0;5,0;;2,0;;;;;;62,0;;;;;84,0;8,0;;;4,0;;;30,0;;3,0;;;5,0;;;;1,0;4,0;2,0;;;4,0;31,0;27,0;;4,0;;1,0;;15,0;89,0;;3,0;6,0;;;1,0;1,0;;;62,0;;50,0;64,0;6,0;21,0;1,0;;;6,0;1,0;33,0;1,0;16,0;;;;;23,0;;91,0;2,0;5,0;;5,0;;12,0;;8,0;;2,0;;3,0;4,0;;3,0;12,0;1,0;5,0;8,0;;1,0;13,0;7,0;26,0;;;10,0;2,0;;86,0;12,0;;;;1,0;1,0;4,0;;1,0;;;;1,0;;;12,0;7,0;;;13,0;12,0;9,0;1,0;;;81,0;;;;15,0;4,0;5,0;;4,0;7,0;;2,0;1,0;7,0;16,0;;5,0;8,0;4,0;;1,0;;;9,0;5,0;19,0;;3,0;;;1,0;2,0;43,0;27,0;18,0;7,0;1,0;33,0;;;16,0;1,0;;;;5,0;6,0;1,0;;;;9,0;4,0;;9,0;2,0;;1,0;50,0;20,0;16,0;;1,0;6,0;2,0;24,0;;17,0;1,0;22,0;;;5,0;12,0;;9,0;4,0;3,0;;;;;2,0;6,0;;;4,0;1,0;1,0;11,0;;3,0;3,0;4,0;;;;;3,0;;;;1,0;;;;;;;;;;1,0;;1,0;;;;;1,0;;1,0;3,0;2,0;;2,0;6,0;4,0;3,0;4,0;;9,0;4,0;2,0;2,0;;;;;1,0;;;;7,0;;3,0;;;1,0;;;;;;;;1,0;;;;;23,0;;;;;11,0;;;;;3,0;5,0;;;;3,0;;;;;;;;;;1,0;;;;;2,0;;79,0;;31,0;;;2,0;;;;5,0;;;1,0;;;;;;;;;;;;;;;3,0;;;17,0;;;;;;;;;;;;10,0;;1,0;10,0;15,0;;;;;10,0;2,0;;;21,0;;9,0;;13,0;1,0;;;2,0;3,0;;;;16,0;;;;;;;4,0;4,0;;;;;;6,0;4,0;;;;1,0;;;;;;;;;;;;3,0;4,0;;;;;9,0;10,0;;10,0;;6,0;9,0;;;;;;;;7,0;;;4,0;;;;;;7,0;;;;6,0;;;;;;;1,0;37,0;;;;1,0;;;;1,0;;;1,0;;;;;;;;;;;14,0;10,0;;;;;14,0;;;;3,0;;;;;;;;;;;;;;;;;19,0;;;8,0;22,0;;;;;;;;;;;;;;;;2,0;;;;4,0;;;31,0;;;3,0;4,0;;12,0;;;;;;17,0;2,0;5,0;;;;;;37,0;2,0;;;;;;;2,0;;4,0;;;;;;3,0;;;;;6,0;13,0;80,0;;;46,0;;;;11,0;16,0;2,0;2,0;;3,0;;;;;;;2,0;;4,0;;;1,0;;6,0;;1,0;;;;;;;;;;;;;;;2,0;5,0;;;;;;;;;;;;;;;;;;;;;;;;;;;;;;2,0;;;;;;1,0;;;;;;;;;;;;;;;;;;;;;;;;;;4,0;5,0;;;;;;;;;;;;;;;1,0;;;;;;3,0;;;;;;;;;;;;;;;;;;;1,0;;;;;;;;;;2,0;;;;;;;2,0;;;12,0;;;;;;;4,0;;;;;;;;1,0;;;;;;2,0;;;;;;;;;1,0;7,0;;;3,0;;;;6,0;;;;;;;;;;;1,0;;;5,0;;;;;;;3,0;;;;;;;;1,0;;;;;;;;;;;;;;;;;;;;;;;;;;;;;;;
plate;;38,0;;13,0;2,0;104,0;11,0;163,0;3,0;;7,0;2,0;3,0;426,0;;;15,0;;58,0;1,0;16,0;;3,0;1,0;5,0;2,0;;14,0;1,0;;146,0;5,0;;3,0;5,0;6,0;87,0;27,0;13,0;;19,0;109,0;6,0;9,0;23,0;178,0;;71,0;;;1,0;2,0;200,0;14,0;11,0;8,0;186,0;;;10,0;27,0;;6,0;;73,0;;349,0;5,0;1,0;140,0;16,0;187,0;150,0;5,0;1,0;;44,0;;;4,0;57,0;;2,0;;150,0;86,0;;52,0;;2,0;1,0;16,0;19,0;6,0;2,0;;;45,0;207,0;26,0;165,0;7,0;10,0;;1,0;3,0;;3,0;;4,0;;7,0;14,0;16,0;12,0;;;20,0;;73,0;;61,0;11,0;6,0;;17,0;189,0;;2,0;30,0;11,0;;4,0;55,0;4,0;;26,0;;;4,0;6,0;45,0;1,0;;91,0;29,0;21,0;53,0;1,0;213,0;3,0;32,0;96,0;187,0;;;4,0;4,0;;;28,0;206,0;;;;2,0;240,0;244,0;3,0;16,0;7,0;3,0;18,0;82,0;3,0;35,0;7,0;12,0;3,0;;5,0;3,0;12,0;112,0;57,0;;22,0;12,0;57,0;140,0;13,0;;52,0;30,0;20,0;139,0;158,0;9,0;52,0;8,0;11,0;61,0;;8,0;8,0;;371,0;169,0;15,0;725,0;46,0;36,0;3,0;1,0;23,0;73,0;3,0;51,0;1,0;15,0;4,0;;2,0;;;;396,0;13,0;6,0;6,0;31,0;4,0;3,0;;31,0;3,0;8,0;1,0;28,0;;3,0;31,0;20,0;20,0;36,0;6,0;17,0;62,0;372,0;82,0;75,0;13,0;8,0;68,0;18,0;;325,0;313,0;9,0;;10,0;6,0;15,0;72,0;31,0;;9,0;1,0;16,0;20,0;6,0;10,0;18,0;8,0;82,0;1,0;26,0;45,0;24,0;4,0;58,0;6,0;92,0;83,0;;7,0;34,0;5,0;51,0;9,0;15,0;7,0;11,0;6,0;;16,0;27,0;;31,0;71,0;28,0;22,0;39,0;2,0;2,0;45,0;16,0;9,0;19,0;21,0;;;13,0;13,0;42,0;5,0;31,0;31,0;5,0;60,0;;10,0;60,0;10,0;16,0;15,0;4,0;2,0;31,0;41,0;23,0;4,0;10,0;42,0;3,0;10,0;14,0;12,0;14,0;4,0;41,0;26,0;20,0;25,0;26,0;103,0;9,0;53,0;2,0;94,0;2,0;15,0;;43,0;71,0;2,0;1,0;169,0;20,0;;;;;3,0;;17,0;1,0;2,0;4,0;1,0;63,0;8,0;1,0;82,0;4,0;;;;;;33,0;;;6,0;2,0;6,0;;5,0;;8,0;;;;;4,0;6,0;8,0;15,0;4,0;;;4,0;6,0;8,0;2,0;14,0;;5,0;2,0;34,0;6,0;83,0;;5,0;1,0;5,0;7,0;1,0;6,0;;5,0;;;1,0;;54,0;;2,0;2,0;4,0;8,0;;;;;;1,0;3,0;9,0;;2,0;13,0;1,0;24,0;;;;;16,0;;;27,0;3,0;14,0;21,0;2,0;;9,0;1,0;7,0;8,0;4,0;;8,0;;;1,0;;;;;;1,0;6,0;6,0;14,0;4,0;15,0;;18,0;62,0;4,0;;8,0;;;4,0;2,0;5,0;;7,0;;2,0;16,0;6,0;3,0;3,0;5,0;;10,0;;;10,0;;1,0;20,0;1,0;;1,0;;;1,0;10,0;;1,0;;;5,0;;6,0;41,0;28,0;4,0;14,0;;;3,0;14,0;9,0;;16,0;;13,0;37,0;2,0;;1,0;7,0;3,0;4,0;;;3,0;124,0;1,0;;;1,0;11,0;;3,0;;6,0;;;;;;16,0;;3,0;;;9,0;;;2,0;;1,0;;;1,0;;9,0;40,0;16,0;;2,0;20,0;1,0;;2,0;1,0;3,0;28,0;28,0;70,0;;4,0;1,0;;13,0;;30,0;;;;1,0;;17,0;;;;5,0;;;;;;2,0;;3,0;;2,0;;;1,0;2,0;6,0;;;;;;;;;;;;;;1,0;1,0;5,0;;;4,0;46,0;13,0;5,0;;13,0;33,0;;4,0;;11,0;;9,0;;;;;;2,0;;;1,0;1,0;;;;1,0;38,0;;;;3,0;1,0;29,0;;34,0;;;7,0;;11,0;;;2,0;4,0;;;;12,0;;;6,0;;;37,0;;;4,0;68,0;;17,0;13,0;14,0;1,0;;1,0;37,0;30,0;30,0;10,0;5,0;;;3,0;9,0;55,0;;8,0;8,0;;14,0;;1,0;;3,0;1,0;;;1,0;23,0;1,0;;;;;6,0;4,0;60,0;;34,0;32,0;;16,0;4,0;13,0;6,0;13,0;4,0;1,0;;2,0;;;26,0;16,0;3,0;21,0;5,0;3,0;6,0;6,0;3,0;;14,0;1,0;6,0;7,0;4,0;1,0;7,0;3,0;;7,0;;6,0;3,0;1,0;1,0;7,0;11,0;;142,0;8,0;1,0;;2,0;;89,0;;21,0;7,0;;;;;;5,0;;4,0;;;1,0;11,0;5,0;;5,0;1,0;;;;;;4,0;;;8,0;;;;1,0;;;;;4,0;1,0;;;;;3,0;;6,0;;;;;8,0;;6,0;;2,0;;26,0;12,0;;;;;;;1,0;2,0;1,0;;;;;;2,0;;;20,0;;1,0;3,0;2,0;;;;;;;;;;;;;4,0;1,0;;;1,0;;;;;;;;;1,0;;;1,0;;;;1,0;;2,0;;;;1,0;;2,0;1,0;25,0;;3,0;2,0;;;;4,0;;;10,0;4,0;;1,0;;6,0;22,0;;;;7,0;;2,0;;;6,0;25,0;15,0;2,0;;3,0;;;;24,0;;;1,0;;;4,0;;1,0;;;11,0;1,0;1,0;;;;;;1,0;9,0;;2,0;;5,0;;2,0;;;2,0;;;2,0;1,0;;;;;9,0;;;;;;;;1,0;;;;;6,0;;;;6,0;;;;
platform;;14,0;;9,0;;35,0;2,0;82,0;;;;;;74,0;;;5,0;;4,0;;;;;;7,0;;1,0;2,0;2,0;;26,0;8,0;;;;9,0;9,0;1,0;4,0;;4,0;26,0;;5,0;4,0;8,0;;17,0;1,0;2,0;11,0;;32,0;2,0;4,0;;8,0;1,0;;6,0;;;5,0;;31,0;;53,0;;4,0;2,0;4,0;2,0;5,0;;;;3,0;7,0;1,0;;21,0;;17,0;5,0;29,0;8,0;;10,0;;;11,0;;;;4,0;;;7,0;13,0;5,0;38,0;;;;5,0;10,0;;;;;;4,0;;3,0;;;;;;18,0;;;5,0;1,0;;;63,0;;;1,0;3,0;;;11,0;;;30,0;;;;;1,0;17,0;;1,0;;1,0;;3,0;55,0;;;37,0;18,0;;;;;;;;34,0;;1,0;;;33,0;10,0;1,0;;;;2,0;1,0;;;2,0;;5,0;4,0;;;1,0;6,0;;1,0;2,0;;36,0;14,0;;2,0;;10,0;;1,0;42,0;;;;;4,0;;16,0;6,0;;25,0;5,0;2,0;114,0;22,0;15,0;3,0;;;4,0;2,0;8,0;;6,0;1,0;;1,0;1,0;33,0;;25,0;;;;;;1,0;;3,0;;3,0;;4,0;;;2,0;2,0;;2,0;;5,0;3,0;23,0;4,0;5,0;;;2,0;5,0;;30,0;50,0;;;;2,0;3,0;7,0;10,0;;;;3,0;;;;10,0;10,0;;;7,0;8,0;;;11,0;;24,0;3,0;;1,0;;;1,0;2,0;;8,0;7,0;;;7,0;6,0;;1,0;10,0;;;;;3,0;;;14,0;4,0;8,0;;;3,0;;25,0;2,0;11,0;10,0;;6,0;61,0;8,0;1,0;;;;;;7,0;;2,0;;1,0;6,0;5,0;8,0;;;;;18,0;19,0;2,0;1,0;;5,0;4,0;2,0;;;28,0;;;;47,0;5,0;2,0;2,0;16,0;2,0;;;;12,0;;3,0;;2,0;5,0;12,0;16,0;4,0;3,0;10,0;2,0;;;1,0;;;26,0;9,0;;1,0;5,0;1,0;;1,0;1,0;;;;;;2,0;;;2,0;;;4,0;2,0;1,0;23,0;6,0;5,0;;6,0;8,0;14,0;23,0;64,0;;4,0;;6,0;;4,0;;;;4,0;;2,0;;13,0;2,0;;;6,0;1,0;;1,0;;2,0;2,0;2,0;;;;1,0;;;18,0;;;2,0;;10,0;;;;1,0;21,0;;5,0;;3,0;;;51,0;3,0;;;;;7,0;;;;;;;;;4,0;6,0;3,0;1,0;1,0;;;;1,0;;11,0;2,0;1,0;1,0;3,0;;;3,0;;;;;;;2,0;;;2,0;;2,0;3,0;;;;;;;;;;2,0;;;;;4,0;18,0;;;;;8,0;;;4,0;2,0;;1,0;5,0;5,0;1,0;;;;;2,0;;5,0;7,0;;;1,0;;;;;;2,0;;;;;1,0;13,0;;;;2,0;1,0;2,0;;;;1,0;;;;;;8,0;10,0;;;;9,0;1,0;;2,0;;5,0;3,0;;;;;1,0;;;;3,0;;;;;3,0;;;;;;;;5,0;;;;;;3,0;2,0;;;;;;;;;2,0;;;;;;;;;;4,0;;;;1,0;5,0;;;;;;;3,0;;;;;;;2,0;;2,0;;;;;;12,0;;;;;;2,0;;;;4,0;;3,0;;;;6,0;2,0;2,0;;2,0;;;;;;;;;2,0;;2,0;;;;2,0;;16,0;;;;;;16,0;;2,0;;4,0;;1,0;2,0;;2,0;1,0;;3,0;;;;;;;;;;1,0;14,0;;;;;;1,0;2,0;10,0;;;6,0;;;1,0;;7,0;3,0;7,0;;;;3,0;;;;;;;;;;;;1,0;;;5,0;;4,0;;;;3,0;2,0;;;10,0;20,0;3,0;;;;;;;;;1,0;;1,0;4,0;;;;;;;;;1,0;;;;;;;;;;;;;;;;;;;;;;;;;;;;;;;;;;;;1,0;;;3,0;;1,0;;;4,0;;;;;;;;;;1,0;;;;;;;;;2,0;;;;;;;;;;;;;;;;;;;;3,0;17,0;;;;;;1,0;1,0;;;;1,0;1,0;;;;;;1,0;1,0;;5,0;;;;4,0;;;;;;;;;;;4,0;;;1,0;;;1,0;;;;;;;;;2,0;5,0;1,0;;5,0;;;;;;;;1,0;;;;;1,0;;;;;;;;;;;;;;;;;;;1,0;;;;;;;;;;;;;;;;;;;;;;;;;;;;;;;;
pole;;1,0;;5,0;;26,0;;8,0;;;2,0;;1,0;26,0;;;5,0;;;;;;;;;;1,0;1,0;;;7,0;1,0;;;;1,0;4,0;1,0;;3,0;;28,0;;5,0;;3,0;;;;;;;16,0;;3,0;;8,0;1,0;;;;;;;4,0;;25,0;;;;13,0;10,0;9,0;;;;3,0;1,0;;;4,0;;;;13,0;;;5,0;;;;;10,0;;2,0;;;3,0;21,0;3,0;31,0;1,0;;;;;;;;;;3,0;;;;;;;;16,0;;;1,0;2,0;;4,0;13,0;;;3,0;;;;15,0;;;1,0;4,0;;;2,0;;;;;1,0;;1,0;;17,0;2,0;;;21,0;;;;;;;;15,0;;;;;4,0;4,0;;;;;;2,0;;1,0;;;;;;1,0;;10,0;1,0;;;;6,0;;;5,0;;4,0;9,0;13,0;3,0;;3,0;5,0;;;1,0;;;;5,0;6,0;;35,0;5,0;;;;3,0;4,0;1,0;6,0;;;2,0;;;;2,0;1,0;5,0;2,0;5,0;;2,0;;;;;;;;1,0;;;10,0;;10,0;;;;;11,0;5,0;;;;3,0;;;16,0;18,0;;;;1,0;;2,0;2,0;;;;1,0;;;3,0;5,0;2,0;;;6,0;;;;2,0;3,0;2,0;;;;;;1,0;;5,0;;;1,0;;3,0;;;4,0;12,0;;6,0;4,0;;5,0;;4,0;15,0;2,0;1,0;;;;;;;2,0;2,0;2,0;1,0;6,0;;13,0;;;3,0;;;;;;4,0;;;;1,0;1,0;2,0;3,0;;3,0;4,0;;4,0;1,0;1,0;2,0;3,0;;;;5,0;;;2,0;3,0;1,0;14,0;4,0;;;;;1,0;;7,0;;;;;1,0;;2,0;5,0;2,0;;;;;;8,0;;;;;;;;;;;;;1,0;;1,0;2,0;;;;;;2,0;3,0;;2,0;;;2,0;;;;;1,0;3,0;8,0;;;;;;;;;;39,0;;;;;;;;;;;;;2,0;;;4,0;;;;;;;5,0;;;;;12,0;;1,0;;;3,0;4,0;;;;;;;;;;;;;;;;7,0;;;;;49,0;2,0;;;;;;;;;;;;;;;;;;;;;;;;4,0;;;3,0;;;;;;;;;4,0;;;;;;3,0;;;;8,0;;;2,0;;4,0;30,0;;;;;1,0;;;;;13,0;;;;;3,0;;;;;;;;;;;;;;;;;;1,0;;;;;;;;3,0;;;1,0;6,0;;2,0;;;14,0;;;14,0;;;1,0;;;;;;;;;;2,0;;;;1,0;;;;;;1,0;;1,0;;12,0;;;;;;;;;;;;;;;;;;;;;;;;;2,0;;;;;;;;;2,0;;;;;;;;1,0;;;;;;;;;1,0;;4,0;;2,0;;;;;;;;;;2,0;;;;;;;;1,0;;;;;4,0;;;;5,0;;;;;;2,0;2,0;;9,0;2,0;;;;;;21,0;;;;;;;;;;1,0;;;;;5,0;;;;;;2,0;;5,0;;5,0;3,0;;;;24,0;;6,0;3,0;;;;;;;;;;;;;;;;3,0;;2,0;1,0;;;;;;;;;;1,0;;;;;;;;;;;;;;;;;;;;;;;;;;;;;;;;;;;;;;;;;;;;;;;;;;;;;;;;;;;;;;;3,0;2,0;;;;;3,0;;;;;;;;2,0;;;;;;;;;;;;;;;;;;1,0;1,0;;2,0;;;;;;;;;;;;;;;;;;;;;;;;;;;;;;;;;;;;;;;;;;;;1,0;;;;;;;;;;;;;;;;;;;;19,0;;;;;;;;;;;;;;;;2,0;;;;;;;;;;;;;;;;;;;;;;;;;;;;;;;;;;;;;;;;;;;;;;;;
port;;17,0;;;;13,0;3,0;5,0;;8,0;2,0;;1,0;15,0;;;8,0;;22,0;;1,0;;;5,0;146,0;;;2,0;2,0;;86,0;;;;;59,0;9,0;3,0;;2,0;1,0;55,0;;21,0;5,0;23,0;;6,0;;5,0;1,0;24,0;13,0;42,0;;;3,0;;;4,0;;;4,0;2,0;38,0;3,0;66,0;2,0;;;3,0;16,0;38,0;13,0;;;;17,0;16,0;7,0;28,0;;;;25,0;1,0;;2,0;;2,0;;8,0;;8,0;;;5,0;1,0;36,0;2,0;31,0;4,0;4,0;1,0;9,0;51,0;1,0;2,0;;;;;4,0;;;;;2,0;7,0;7,0;2,0;;22,0;;;1,0;35,0;;;3,0;4,0;;;12,0;;;12,0;;;;;3,0;;;9,0;8,0;6,0;17,0;32,0;9,0;;4,0;22,0;7,0;2,0;28,0;;;;;;46,0;;;;;93,0;4,0;;7,0;;2,0;13,0;10,0;3,0;2,0;2,0;;;;;;2,0;10,0;;;;1,0;;4,0;;;;;2,0;1,0;32,0;2,0;5,0;3,0;;;;;;2,0;25,0;;1,0;40,0;2,0;;;;2,0;1,0;37,0;;;15,0;;;;;11,0;3,0;23,0;3,0;;2,0;2,0;;;;3,0;1,0;;;;;;;;1,0;5,0;3,0;4,0;1,0;19,0;;;;;3,0;5,0;2,0;4,0;33,0;;;10,0;13,0;;10,0;7,0;9,0;;;;5,0;;2,0;;6,0;3,0;;1,0;;3,0;;2,0;;4,0;4,0;;;;1,0;6,0;;1,0;39,0;2,0;;;1,0;12,0;;;1,0;;4,0;2,0;27,0;;1,0;;2,0;1,0;9,0;;5,0;2,0;;;;8,0;;1,0;;;;3,0;2,0;2,0;;;3,0;21,0;;;2,0;;2,0;1,0;;2,0;;;;;;;;;4,0;1,0;22,0;;3,0;;;;;2,0;1,0;;;23,0;3,0;;;;;;;;5,0;;;;;;2,0;6,0;;;;;;24,0;;;;;21,0;;;;;;;;8,0;3,0;3,0;;1,0;3,0;;;43,0;9,0;7,0;;6,0;;1,0;;;;4,0;;1,0;10,0;;;;;;1,0;2,0;1,0;;;58,0;;1,0;1,0;;;;1,0;4,0;;;3,0;;;;;5,0;2,0;;;4,0;;;;;;13,0;2,0;;1,0;17,0;;;;;3,0;;1,0;4,0;2,0;;;;;;2,0;;6,0;11,0;10,0;;;29,0;1,0;6,0;1,0;;8,0;2,0;1,0;;2,0;2,0;;;;;;;;;;3,0;;;;9,0;;;;2,0;3,0;;5,0;;5,0;1,0;8,0;1,0;1,0;5,0;20,0;;7,0;;18,0;7,0;;;;;3,0;;39,0;;;;;9,0;;;;;;;;;;9,0;;;;;;;;4,0;;;2,0;;;;;;;;2,0;;;;3,0;;23,0;;;;1,0;;10,0;;;4,0;;;;;;13,0;;8,0;3,0;;;5,0;15,0;;;;;;1,0;2,0;;;;;;;;;;12,0;;;6,0;1,0;;3,0;;;;;20,0;4,0;;;;;1,0;;3,0;;;;3,0;;4,0;28,0;;;;1,0;3,0;;;;;;;58,0;;;7,0;1,0;;;4,0;;;3,0;;;;;;1,0;;;3,0;;2,0;13,0;;;12,0;;3,0;;;;;;;;;1,0;;;;;;;;;1,0;;;;17,0;3,0;1,0;;;1,0;;;;2,0;;;1,0;8,0;;1,0;;;;8,0;;2,0;;;;;2,0;;;;2,0;14,0;;;;;;;2,0;;2,0;;;10,0;;;;;;2,0;;;;;;;;;;2,0;;;;1,0;;;4,0;;;;;;;;;;;;;1,0;2,0;;;2,0;;;;;2,0;2,0;2,0;;;;;;;;;;1,0;;;;;;53,0;;;;;;;;;;;;;;;;;;;;;1,0;;;;;;;;;;;;;;;;;;;;;;;;;;;;;;;;;;;;;;1,0;;1,0;7,0;;;;;;;;;;;;;;;2,0;;1,0;;;;;;;3,0;;;;;;;;;;;6,0;;;5,0;;;;;1,0;;;;;1,0;;;;;;;;;;15,0;;;;;;;;;;;;;;;;;;;;;;;;;;8,0;;;;;;;;;;;;;;;;;;;;1,0;;;;;;;;;;;;;;28,0;;;;;;;;;;;;;;;;;;;
portable;;14,0;;6,0;6,0;137,0;1,0;22,0;2,0;;;5,0;5,0;53,0;;;57,0;1,0;;6,0;1,0;1,0;3,0;10,0;17,0;1,0;;21,0;52,0;;55,0;12,0;2,0;;;52,0;4,0;2,0;;2,0;47,0;944,0;;33,0;87,0;14,0;1,0;9,0;;;;;3,0;30,0;11,0;21,0;6,0;2,0;3,0;12,0;1,0;;6,0;2,0;210,0;5,0;88,0;1,0;;;21,0;100,0;51,0;;1,0;;2,0;1,0;1,0;17,0;104,0;;31,0;3,0;43,0;;;53,0;;1,0;1,0;;;4,0;11,0;;;2,0;15,0;18,0;39,0;4,0;2,0;8,0;58,0;48,0;;11,0;;16,0;;1,0;3,0;;1,0;;4,0;1,0;5,0;40,0;4,0;;49,0;3,0;;16,0;102,0;;;2,0;3,0;;;27,0;;;23,0;;15,0;;;;;;15,0;1,0;6,0;5,0;4,0;8,0;1,0;1,0;14,0;6,0;;;;;;;2,0;23,0;10,0;5,0;;;13,0;2,0;1,0;3,0;2,0;1,0;3,0;21,0;;5,0;;3,0;12,0;2,0;1,0;10,0;;31,0;;3,0;1,0;5,0;12,0;12,0;4,0;1,0;;2,0;3,0;2,0;65,0;;;1,0;1,0;12,0;;;14,0;;6,0;;9,0;42,0;1,0;9,0;;;1,0;15,0;4,0;8,0;;3,0;1,0;2,0;1,0;;5,0;;37,0;;1,0;2,0;2,0;;15,0;2,0;7,0;;1,0;;;9,0;;;;;;13,0;1,0;8,0;18,0;1,0;;;7,0;2,0;1,0;1,0;16,0;45,0;3,0;;2,0;36,0;6,0;5,0;1,0;;;;2,0;4,0;;5,0;3,0;5,0;4,0;4,0;6,0;10,0;1,0;;;3,0;19,0;7,0;;;7,0;7,0;2,0;;1,0;1,0;2,0;;;2,0;18,0;;;2,0;1,0;;2,0;;;;;15,0;1,0;13,0;;;2,0;;9,0;;9,0;10,0;4,0;4,0;12,0;11,0;5,0;;8,0;;;;12,0;4,0;;;1,0;2,0;17,0;;1,0;;;;5,0;4,0;;;1,0;5,0;;1,0;;1,0;1,0;;;;;;1,0;7,0;90,0;79,0;;;1,0;19,0;;1,0;5,0;1,0;9,0;2,0;1,0;;;7,0;3,0;;;19,0;1,0;1,0;30,0;12,0;;3,0;9,0;27,0;1,0;2,0;1,0;21,0;2,0;26,0;;8,0;3,0;21,0;;12,0;8,0;1,0;;29,0;19,0;;;7,0;6,0;8,0;1,0;3,0;1,0;8,0;;17,0;14,0;10,0;;;;;;;;2,0;;59,0;1,0;18,0;3,0;;6,0;1,0;3,0;;1,0;;1,0;;2,0;;1,0;243,0;7,0;8,0;;1,0;;2,0;73,0;;;2,0;13,0;1,0;1,0;5,0;;1,0;;1,0;135,0;6,0;;3,0;;;;4,0;4,0;9,0;6,0;1,0;13,0;26,0;1,0;;;;;;1,0;5,0;5,0;;2,0;1,0;22,0;1,0;;1,0;;;4,0;;1,0;5,0;37,0;2,0;;5,0;;10,0;;21,0;;2,0;3,0;4,0;;1,0;12,0;;4,0;;;2,0;;;1,0;1,0;11,0;1,0;;10,0;8,0;;7,0;;;;;8,0;;1,0;1,0;;1,0;5,0;;;;;;13,0;;2,0;;;;2,0;1,0;;1,0;7,0;5,0;6,0;;1,0;;;;6,0;1,0;;1,0;;;;8,0;1,0;;2,0;37,0;;;4,0;1,0;;;2,0;;;;;2,0;;;;3,0;1,0;22,0;;;;;;;13,0;4,0;2,0;;1,0;1,0;2,0;;11,0;2,0;5,0;;;;2,0;;1,0;59,0;;;;22,0;2,0;;4,0;;3,0;2,0;;5,0;1,0;;1,0;1,0;;;29,0;;;;;2,0;;9,0;;;1,0;1,0;4,0;;;2,0;;;;1,0;;;;3,0;;;;;13,0;10,0;1,0;3,0;;;;;10,0;16,0;1,0;2,0;11,0;;;24,0;;24,0;;;;15,0;8,0;1,0;7,0;;;;1,0;;2,0;;;;8,0;;;12,0;1,0;;;2,0;1,0;3,0;;;1,0;;6,0;2,0;;;6,0;7,0;;;10,0;;;1,0;;;4,0;1,0;;;;;1,0;;;;12,0;13,0;;;;;;3,0;2,0;;;;1,0;;1,0;;1,0;;;;;;;;;;;;;;;1,0;1,0;1,0;;27,0;;;1,0;2,0;5,0;1,0;;;;;;;;;;8,0;;1,0;;;;;;;;;;;1,0;;;;;;2,0;;;;2,0;;;;3,0;;;;;;1,0;;;;;;;;3,0;;;1,0;;1,0;;3,0;;1,0;;4,0;;;;1,0;;;;;1,0;;;;;;1,0;;;;;;8,0;5,0;5,0;1,0;8,0;;;;;;;;2,0;;;8,0;4,0;2,0;;;3,0;;1,0;3,0;;;1,0;6,0;;1,0;;;;2,0;;1,0;;;4,0;;;1,0;8,0;;2,0;6,0;;;;1,0;;1,0;1,0;;4,0;;;;2,0;;;;;;;;;;;;1,0;;;;;;;;2,0;1,0;;;;3,0;;;2,0;;;;8,0;1,0;;1,0;1,0;1,0;;;;;6,0;;;;;;;;;;;;;;;3,0;;;;;;1,0;;1,0;;;;;;1,0;;;;;12,0;;;1,0;;;;;
portion;;19,0;;61,0;59,0;385,0;191,0;595,0;3,0;3,0;6,0;48,0;266,0;1457,0;8,0;14,0;561,0;3,0;108,0;23,0;36,0;6,0;147,0;66,0;15,0;8,0;4,0;171,0;32,0;39,0;1172,0;37,0;22,0;9,0;5,0;772,0;296,0;77,0;116,0;38,0;300,0;857,0;146,0;134,0;649,0;961,0;22,0;669,0;;12,0;17,0;24,0;1234,0;62,0;514,0;18,0;1012,0;4,0;55,0;244,0;39,0;14,0;111,0;7,0;3395,0;8,0;2020,0;49,0;13,0;101,0;146,0;1681,0;1070,0;21,0;26,0;37,0;262,0;76,0;23,0;47,0;530,0;3,0;30,0;50,0;833,0;274,0;4,0;494,0;17,0;14,0;23,0;158,0;126,0;251,0;40,0;2,0;505,0;172,0;1229,0;111,0;980,0;197,0;25,0;35,0;74,0;116,0;14,0;40,0;11,0;7,0;1,0;46,0;839,0;69,0;15,0;86,0;46,0;225,0;398,0;990,0;20,0;17,0;402,0;75,0;41,0;98,0;515,0;;31,0;87,0;109,0;25,0;53,0;506,0;2,0;7,0;646,0;33,0;32,0;97,0;37,0;226,0;12,0;;281,0;111,0;446,0;611,0;151,0;468,0;53,0;158,0;699,0;518,0;45,0;127,0;73,0;32,0;;2,0;269,0;867,0;104,0;10,0;55,0;13,0;874,0;665,0;19,0;113,0;39,0;2,0;70,0;606,0;52,0;299,0;46,0;54,0;46,0;53,0;6,0;104,0;158,0;455,0;111,0;121,0;166,0;137,0;397,0;985,0;1,0;28,0;131,0;410,0;327,0;353,0;1736,0;57,0;467,0;117,0;107,0;309,0;93,0;10,0;43,0;43,0;1205,0;144,0;278,0;1364,0;125,0;136,0;50,0;20,0;7,0;568,0;158,0;134,0;20,0;84,0;143,0;33,0;25,0;395,0;396,0;12,0;;6,0;40,0;50,0;240,0;109,0;183,0;11,0;704,0;8,0;161,0;78,0;29,0;143,0;17,0;165,0;191,0;60,0;94,0;147,0;87,0;338,0;1092,0;55,0;43,0;48,0;16,0;385,0;574,0;30,0;811,0;1912,0;147,0;79,0;181,0;120,0;43,0;574,0;296,0;12,0;59,0;66,0;23,0;136,0;80,0;265,0;147,0;91,0;40,0;11,0;121,0;208,0;92,0;33,0;337,0;19,0;417,0;280,0;2,0;;85,0;269,0;370,0;59,0;264,0;69,0;30,0;499,0;53,0;180,0;220,0;13,0;122,0;282,0;62,0;175,0;205,0;22,0;5,0;219,0;43,0;78,0;34,0;344,0;158,0;84,0;90,0;140,0;64,0;17,0;367,0;173,0;31,0;93,0;41,0;412,0;231,0;442,0;52,0;75,0;49,0;5,0;71,0;71,0;283,0;33,0;44,0;358,0;160,0;47,0;37,0;14,0;45,0;40,0;103,0;160,0;61,0;136,0;89,0;216,0;63,0;255,0;13,0;157,0;4,0;128,0;6,0;107,0;25,0;123,0;16,0;781,0;478,0;18,0;28,0;40,0;12,0;12,0;5,0;85,0;35,0;23,0;133,0;1,0;39,0;;27,0;219,0;44,0;9,0;28,0;9,0;31,0;18,0;313,0;40,0;4,0;14,0;5,0;208,0;31,0;11,0;25,0;21,0;18,0;1,0;80,0;67,0;48,0;52,0;4,0;187,0;33,0;13,0;4,0;141,0;52,0;54,0;77,0;202,0;24,0;59,0;84,0;52,0;18,0;197,0;4,0;58,0;111,0;10,0;18,0;28,0;2,0;;5,0;34,0;14,0;57,0;11,0;1079,0;35,0;72,0;7,0;11,0;103,0;;24,0;8,0;15,0;1,0;81,0;71,0;37,0;;4,0;172,0;56,0;11,0;7,0;32,0;;5,0;291,0;13,0;10,0;53,0;21,0;22,0;76,0;19,0;2,0;14,0;80,0;15,0;43,0;8,0;2,0;11,0;22,0;57,0;;3,0;7,0;7,0;35,0;41,0;61,0;151,0;157,0;89,0;93,0;1,0;13,0;40,0;284,0;42,0;16,0;31,0;18,0;75,0;65,0;22,0;37,0;11,0;1,0;;5,0;65,0;15,0;16,0;70,0;31,0;2,0;22,0;8,0;139,0;19,0;35,0;;110,0;74,0;14,0;2,0;14,0;33,0;10,0;50,0;4,0;;42,0;18,0;204,0;7,0;50,0;275,0;434,0;10,0;107,0;1,0;;103,0;16,0;35,0;;38,0;69,0;59,0;135,0;122,0;1,0;27,0;35,0;22,0;28,0;8,0;27,0;70,0;571,0;6,0;15,0;4,0;25,0;23,0;29,0;17,0;17,0;6,0;46,0;15,0;42,0;5,0;15,0;73,0;4,0;5,0;44,0;51,0;84,0;13,0;;96,0;8,0;24,0;3,0;;18,0;1,0;92,0;180,0;32,0;10,0;21,0;119,0;42,0;18,0;33,0;68,0;245,0;23,0;99,0;99,0;61,0;31,0;118,0;1,0;3,0;6,0;5,0;12,0;;4,0;44,0;153,0;21,0;12,0;;3,0;182,0;8,0;59,0;14,0;3,0;5,0;80,0;32,0;4,0;12,0;35,0;1,0;51,0;23,0;12,0;19,0;123,0;;;10,0;64,0;;;5,0;;;18,0;122,0;;10,0;16,0;14,0;9,0;;28,0;72,0;5,0;17,0;1,0;30,0;25,0;13,0;21,0;;22,0;3,0;26,0;32,0;1,0;7,0;;10,0;74,0;23,0;;88,0;22,0;4,0;1,0;2,0;20,0;62,0;2,0;14,0;3,0;82,0;2,0;75,0;2,0;62,0;4,0;28,0;14,0;1,0;5,0;210,0;;;30,0;4,0;20,0;18,0;4,0;3,0;59,0;100,0;1,0;9,0;221,0;;2,0;12,0;642,0;19,0;149,0;16,0;36,0;1,0;24,0;15,0;208,0;249,0;79,0;259,0;149,0;14,0;;;12,0;64,0;1,0;75,0;61,0;;12,0;3,0;13,0;8,0;74,0;57,0;15,0;13,0;12,0;91,0;69,0;47,0;6,0;23,0;15,0;10,0;18,0;216,0;11,0;50,0;57,0;27,0;157,0;6,0;26,0;43,0;173,0;;2,0;72,0;127,0;3,0;2,0;57,0;127,0;135,0;16,0;4,0;96,0;18,0;18,0;44,0;22,0;163,0;41,0;55,0;72,0;23,0;17,0;17,0;1,0;23,0;5,0;3,0;154,0;112,0;18,0;15,0;;33,0;30,0;231,0;75,0;8,0;2,0;21,0;43,0;124,0;28,0;15,0;196,0;4,0;27,0;35,0;25,0;5,0;7,0;14,0;29,0;378,0;4,0;9,0;73,0;1,0;3,0;137,0;19,0;62,0;;36,0;2,0;29,0;4,0;4,0;11,0;10,0;1,0;19,0;6,0;390,0;12,0;3,0;;25,0;9,0;6,0;1,0;15,0;12,0;15,0;98,0;7,0;60,0;16,0;42,0;3,0;;8,0;6,0;;18,0;4,0;7,0;28,0;176,0;2,0;;12,0;28,0;37,0;1,0;2,0;4,0;96,0;5,0;4,0;16,0;5,0;1,0;48,0;10,0;;6,0;27,0;88,0;24,0;8,0;;3,0;2,0;40,0;52,0;8,0;1,0;5,0;2,0;17,0;8,0;20,0;11,0;1,0;5,0;4,0;7,0;11,0;6,0;;1,0;2,0;;24,0;64,0;15,0;11,0;37,0;1,0;3,0;11,0;2,0;2,0;1,0;7,0;2,0;7,0;29,0;40,0;5,0;9,0;10,0;124,0;8,0;77,0;3,0;7,0;2,0;6,0;;5,0;11,0;18,0;5,0;4,0;43,0;;9,0;10,0;1,0;;;16,0;62,0;23,0;10,0;;8,0;13,0;106,0;7,0;5,0;11,0;5,0;;5,0;50,0;1,0;6,0;5,0;5,0;15,0;16,0;8,0;;3,0;6,0;124,0;3,0;115,0;5,0;22,0;;2,0;;18,0;147,0;15,0;3,0;8,0;3,0;4,0;;6,0;9,0;19,0;10,0;3,0;54,0;8,0;18,0;17,0;;24,0;1,0;7,0;7,0;70,0;;3,0;18,0;6,0;7,0;2,0;11,0;6,0;11,0;11,0;;1,0;;1,0;;1,0;;
power;;21,0;3,0;48,0;62,0;132,0;14,0;72,0;1,0;;;2,0;1,0;134,0;;2,0;43,0;6,0;11,0;2,0;5,0;;8,0;19,0;100,0;3,0;;188,0;22,0;48,0;379,0;90,0;;2,0;2,0;106,0;7,0;9,0;9,0;1,0;93,0;499,0;;49,0;70,0;76,0;;357,0;;1,0;7,0;2,0;8,0;98,0;21,0;93,0;21,0;1,0;64,0;44,0;2,0;;377,0;4,0;351,0;3,0;224,0;19,0;2,0;18,0;22,0;1714,0;184,0;2,0;16,0;6,0;2,0;;1,0;27,0;150,0;4,0;146,0;3,0;282,0;4,0;;440,0;1,0;24,0;2,0;2,0;9,0;2,0;4,0;10,0;16,0;12,0;85,0;19,0;86,0;40,0;;11,0;63,0;133,0;3,0;3,0;7,0;3,0;1,0;30,0;33,0;6,0;2,0;1,0;3,0;19,0;17,0;207,0;15,0;;222,0;5,0;78,0;21,0;338,0;3,0;;2,0;82,0;18,0;2,0;770,0;7,0;3,0;11,0;1,0;40,0;;2,0;3,0;8,0;;52,0;50,0;15,0;90,0;43,0;27,0;2,0;4,0;78,0;13,0;;83,0;;;;;18,0;302,0;1,0;10,0;33,0;;129,0;12,0;18,0;21,0;13,0;1,0;7,0;25,0;4,0;4,0;207,0;23,0;10,0;;19,0;;9,0;29,0;1,0;3,0;49,0;2,0;31,0;16,0;1,0;;12,0;29,0;3,0;4,0;74,0;3,0;11,0;5,0;;4,0;14,0;23,0;27,0;8,0;70,0;2,0;57,0;84,0;34,0;4,0;;;1,0;6,0;80,0;9,0;;39,0;17,0;24,0;;;31,0;15,0;71,0;1,0;3,0;12,0;4,0;19,0;18,0;5,0;20,0;;3,0;;1,0;1,0;3,0;1,0;1,0;;3,0;31,0;25,0;25,0;183,0;;;;;7,0;11,0;1415,0;23,0;190,0;6,0;;37,0;101,0;12,0;59,0;4,0;1,0;10,0;20,0;6,0;7,0;;68,0;44,0;13,0;38,0;7,0;6,0;6,0;1,0;1,0;4,0;7,0;44,0;58,0;;5,0;10,0;17,0;157,0;;114,0;4,0;4,0;4,0;;1,0;14,0;30,0;9,0;3,0;;;10,0;14,0;8,0;2,0;5,0;18,0;18,0;51,0;;10,0;29,0;2,0;1,0;;36,0;4,0;5,0;13,0;34,0;141,0;3,0;2,0;25,0;2,0;18,0;;;6,0;;;1,0;4,0;30,0;;6,0;5,0;1,0;2,0;19,0;2,0;;3,0;4,0;1,0;2,0;9,0;;9,0;;2,0;23,0;1,0;38,0;3,0;71,0;28,0;112,0;131,0;;;3,0;2,0;19,0;4,0;;;;3,0;1,0;9,0;17,0;6,0;41,0;16,0;24,0;5,0;16,0;;347,0;10,0;3,0;5,0;3,0;30,0;16,0;30,0;4,0;26,0;18,0;4,0;;18,0;4,0;18,0;3,0;4,0;24,0;4,0;5,0;55,0;10,0;139,0;1,0;9,0;10,0;109,0;33,0;91,0;;25,0;;62,0;189,0;6,0;;;;;;6,0;1,0;;5,0;225,0;17,0;39,0;22,0;2,0;69,0;;27,0;2,0;11,0;1,0;32,0;7,0;143,0;1,0;46,0;117,0;129,0;11,0;10,0;4,0;;4,0;31,0;1,0;;224,0;28,0;6,0;7,0;189,0;2,0;;1,0;6,0;20,0;16,0;;;50,0;6,0;;;1,0;;9,0;2,0;34,0;133,0;5,0;4,0;18,0;5,0;11,0;32,0;13,0;;32,0;12,0;49,0;3,0;52,0;3,0;12,0;;;3,0;1,0;4,0;42,0;;8,0;26,0;1,0;3,0;;7,0;;;1,0;;15,0;3,0;3,0;;15,0;7,0;35,0;1,0;2,0;55,0;;51,0;18,0;59,0;85,0;153,0;;1,0;;;14,0;19,0;;;15,0;4,0;3,0;4,0;2,0;5,0;22,0;2,0;33,0;1,0;31,0;10,0;;11,0;;;;1,0;21,0;;5,0;23,0;;;10,0;4,0;1,0;14,0;1,0;;6,0;7,0;33,0;4,0;1,0;;1,0;11,0;7,0;;2,0;14,0;;8,0;1,0;;1,0;4,0;;9,0;;;25,0;55,0;18,0;16,0;;;1,0;;31,0;2,0;;59,0;8,0;;7,0;9,0;2,0;;;2,0;;5,0;27,0;1,0;;35,0;;4,0;56,0;4,0;;39,0;3,0;;1,0;1,0;;1,0;6,0;;7,0;7,0;2,0;;;;1,0;;1,0;60,0;15,0;65,0;;2,0;;2,0;1,0;2,0;3,0;1,0;;7,0;42,0;15,0;;;2,0;6,0;32,0;;2,0;;;;3,0;28,0;;;;9,0;1,0;3,0;6,0;1,0;1,0;3,0;;2,0;763,0;24,0;2,0;9,0;15,0;3,0;4,0;3,0;6,0;;2,0;;11,0;45,0;79,0;10,0;;;4,0;9,0;6,0;;18,0;7,0;;163,0;2,0;21,0;9,0;7,0;7,0;;;103,0;92,0;;;3,0;;;1,0;;;4,0;;53,0;6,0;16,0;35,0;50,0;1,0;1,0;;4,0;9,0;;6,0;;20,0;1,0;;2,0;;12,0;7,0;;4,0;8,0;9,0;;5,0;2,0;;;7,0;17,0;6,0;1,0;4,0;3,0;3,0;4,0;2,0;;13,0;43,0;;17,0;9,0;5,0;8,0;6,0;2,0;3,0;;;;;2,0;;5,0;9,0;;3,0;;4,0;1,0;;4,0;8,0;;1,0;;2,0;6,0;10,0;;;;1,0;7,0;2,0;3,0;46,0;6,0;;3,0;2,0;;6,0;3,0;14,0;12,0;16,0;9,0;;;7,0;;;69,0;;;1,0;9,0;;10,0;3,0;2,0;;3,0;;;1,0;1,0;;13,0;;;3,0;;35,0;;8,0;;3,0;;18,0;;;1,0;2,0;;;;;;;3,0;;;4,0;32,0;;;1,0;2,0;;;24,0;1,0;4,0;3,0;;;4,0;;;2,0;31,0;;1,0;68,0;;;;;;;1,0;19,0;1,0;1,0;;7,0;;;;;1,0;;2,0;;;1,0;;2,0;1,0;;3,0;10,0;;;;;2,0;;3,0;;3,0;1,0;;;3,0;2,0;2,0;6,0;;;3,0;4,0;;19,0;;1,0;;;6,0;11,0;2,0;;1,0;;;;;;3,0;1,0;;21,0;;2,0;2,0;2,0;15,0;1,0;1061,0;;;;4,0;;92,0;;;1,0;;;;1,0;4,0;37,0;3,0;7,0;;1,0;;;14,0;;;;;;;;1,0;1,0;30,0;9,0;;;;;;;;;;1,0;2,0;;;;;;;;
prevent;;9,0;;8,0;5,0;6,0;4,0;19,0;;;;1,0;6,0;14,0;;;13,0;2,0;13,0;;;;8,0;;2,0;;;12,0;;;57,0;2,0;;1,0;;7,0;5,0;;;1,0;1,0;39,0;2,0;1,0;2,0;3,0;4,0;32,0;;3,0;;;2,0;8,0;5,0;8,0;11,0;;;6,0;2,0;;3,0;;69,0;1,0;21,0;2,0;5,0;1,0;;50,0;73,0;3,0;;;14,0;;;6,0;9,0;;3,0;;25,0;10,0;;11,0;1,0;7,0;5,0;1,0;5,0;3,0;3,0;;18,0;2,0;7,0;5,0;46,0;;;4,0;1,0;4,0;2,0;3,0;1,0;;3,0;;4,0;;3,0;;;2,0;1,0;51,0;;;17,0;;;1,0;16,0;;;;7,0;;;39,0;2,0;;2,0;;2,0;2,0;1,0;7,0;5,0;;7,0;2,0;16,0;5,0;6,0;4,0;1,0;6,0;11,0;4,0;;6,0;2,0;1,0;;;1,0;6,0;;;3,0;;5,0;30,0;;8,0;;;5,0;15,0;;5,0;2,0;2,0;;;3,0;1,0;7,0;;1,0;;10,0;1,0;12,0;14,0;;;8,0;5,0;6,0;5,0;54,0;3,0;5,0;;;6,0;1,0;1,0;;;46,0;;6,0;30,0;16,0;38,0;;4,0;3,0;4,0;17,0;;;3,0;1,0;;;4,0;6,0;;40,0;4,0;;2,0;1,0;;2,0;;3,0;;1,0;8,0;;;;8,0;5,0;;10,0;5,0;13,0;3,0;11,0;28,0;8,0;4,0;6,0;22,0;10,0;7,0;15,0;33,0;;;3,0;3,0;1,0;13,0;10,0;10,0;;2,0;1,0;6,0;2,0;;;5,0;;;21,0;;;2,0;2,0;1,0;9,0;6,0;;2,0;2,0;7,0;5,0;;3,0;4,0;;3,0;;;2,0;;;5,0;;4,0;;7,0;;12,0;1,0;3,0;;5,0;5,0;1,0;7,0;11,0;;;4,0;13,0;3,0;8,0;1,0;10,0;;4,0;2,0;;4,0;5,0;3,0;1,0;6,0;;5,0;8,0;5,0;;;;7,0;2,0;17,0;20,0;2,0;1,0;;6,0;3,0;3,0;;9,0;;2,0;;;1,0;13,0;3,0;8,0;9,0;;;;;8,0;2,0;5,0;;;;;5,0;5,0;;4,0;;;3,0;;;;21,0;1,0;;;;1,0;;;;2,0;;;;;4,0;4,0;;;;;;;2,0;1,0;;3,0;;14,0;2,0;4,0;;12,0;;;32,0;;;;;;;;13,0;;;20,0;;;;;;1,0;2,0;;1,0;1,0;;1,0;5,0;;4,0;1,0;;2,0;;;;;8,0;;;4,0;3,0;;13,0;5,0;;;3,0;;5,0;7,0;;3,0;;;;;;;1,0;;1,0;3,0;;5,0;;;;;4,0;;;;1,0;;15,0;5,0;1,0;;;;;7,0;;;4,0;1,0;;1,0;;;;2,0;;1,0;;;1,0;;6,0;;1,0;;;5,0;;8,0;;;;4,0;;;;;3,0;;15,0;;4,0;;4,0;8,0;;;;1,0;;;;;3,0;18,0;;1,0;;;;;;;5,0;;4,0;;;;;;;5,0;1,0;;;;;;24,0;;;;;3,0;;;;1,0;4,0;;;4,0;;2,0;1,0;1,0;2,0;1,0;1,0;;1,0;;;;10,0;;;35,0;6,0;;;;;11,0;;;2,0;7,0;;;2,0;;;8,0;;;3,0;;;3,0;1,0;;1,0;1,0;;;;;;;;;;2,0;2,0;;;;4,0;;;5,0;4,0;;;;;3,0;;;;;;;;7,0;;;;;;;;;;;;;;1,0;2,0;;;;;;;;1,0;;;;;7,0;;;;;1,0;;;7,0;;1,0;;18,0;;;;;;;;8,0;12,0;;2,0;;;;1,0;;;;5,0;11,0;;;;;;;;;2,0;;5,0;;;1,0;;;1,0;;16,0;;;1,0;2,0;;;;;;4,0;;1,0;2,0;6,0;;;4,0;6,0;2,0;;;;1,0;;;;;1,0;;;;;;;;;2,0;2,0;1,0;;;;3,0;10,0;1,0;;;;;1,0;2,0;1,0;;2,0;1,0;;;;;;1,0;;;;;2,0;1,0;;1,0;;;;;;;;;;;;;;1,0;4,0;;2,0;;;;;;;;;4,0;;;;;;;;;;1,0;;;2,0;;;1,0;;;;;;;;;;;;;;;;;;;;;;3,0;;;;1,0;;1,0;1,0;;;;;;6,0;2,0;;;;;;;;;;1,0;;;;;1,0;;;11,0;;;2,0;;1,0;;;;4,0;;;;;;1,0;;;;;;;;1,0;;;;2,0;1,0;;;;;2,0;;1,0;;;;;;;;2,0;;;;5,0;;4,0;;;1,0;1,0;;;;;;;;1,0;;;2,0;;;5,0;4,0;;;1,0;;;;;3,0;;;1,0;3,0;;3,0;;;;;;;;;;;;;;;;;;
preview;;2,0;;19,0;;9,0;2,0;;;4,0;;;;40,0;;44,0;134,0;;;8,0;;;6,0;;;;;;7,0;15,0;49,0;23,0;6,0;;;72,0;;;;;55,0;120,0;;53,0;440,0;;;4,0;;;1,0;;;;10,0;;;;;107,0;;;;;1241,0;1,0;53,0;;;;;14,0;;;3,0;;;;4,0;1,0;107,0;;132,0;1,0;57,0;;;22,0;;;10,0;;;;23,0;;5,0;;77,0;31,0;21,0;7,0;;16,0;17,0;32,0;;8,0;;;;3,0;23,0;1,0;;;2,0;5,0;21,0;37,0;21,0;1,0;7,0;8,0;;16,0;13,0;;3,0;;11,0;;;13,0;;;44,0;4,0;;;;;;;;46,0;72,0;;8,0;;;;;;3,0;;;;1,0;;;;9,0;;;;1,0;;1,0;19,0;;;;6,0;;1,0;;;2,0;;;;;18,0;;;5,0;;15,0;14,0;;;;1,0;;;;;;;;;;4,0;;3,0;;;;;4,0;6,0;;;;;34,0;;36,0;3,0;7,0;1,0;2,0;;;;29,0;;;;;;6,0;8,0;2,0;2,0;3,0;;;7,0;;;;;;24,0;1,0;;1,0;;;;;;;;;25,0;;;;2,0;1,0;;;;;;;8,0;;;;3,0;;;6,0;17,0;;;;3,0;;;;;;3,0;2,0;;;2,0;;;6,0;;26,0;6,0;;;;;;;;;;;8,0;2,0;;;;;;;1,0;;1,0;;28,0;71,0;;10,0;;;2,0;;;;;;;;3,0;;;;;;22,0;18,0;;;;;;;;;;;;;1,0;;2,0;;41,0;;;;;5,0;1,0;;4,0;;;1,0;;;10,0;;5,0;8,0;10,0;4,0;4,0;;37,0;16,0;;;3,0;35,0;5,0;4,0;;6,0;;6,0;6,0;9,0;;5,0;;14,0;7,0;;;42,0;;13,0;;20,0;20,0;1,0;;;;19,0;2,0;3,0;17,0;21,0;;;;;;5,0;;1,0;;31,0;;32,0;3,0;3,0;2,0;;2,0;2,0;;;3,0;10,0;4,0;;;19,0;;;;5,0;;;40,0;;3,0;;13,0;;;;;3,0;1,0;2,0;20,0;;;9,0;;2,0;;10,0;1,0;;6,0;8,0;10,0;16,0;;;;;;;;;;2,0;;;22,0;;2,0;6,0;;;;;;;87,0;;5,0;;3,0;20,0;;30,0;;2,0;2,0;;2,0;;;;2,0;;8,0;;;;;;;;;;;;;;;;1,0;24,0;;3,0;3,0;2,0;;9,0;6,0;;;;;1,0;7,0;3,0;;;;;;;3,0;;2,0;;;4,0;;;;12,0;;;12,0;;16,0;;2,0;2,0;;1,0;;;;;;;;;;;;;;;;;;4,0;;;;33,0;;1,0;;4,0;2,0;;;1,0;;;13,0;1,0;;;;;;1,0;;;3,0;;;1,0;3,0;;1,0;1,0;;3,0;;;;;6,0;228,0;;;;;;;;;;;1,0;1,0;3,0;;;1,0;;;;;;11,0;;;2,0;4,0;2,0;4,0;;2,0;;;;1,0;6,0;;;;;;;;;;2,0;;;3,0;15,0;;;;;;;8,0;2,0;;;;2,0;;4,0;2,0;2,0;;2,0;;;;;;3,0;4,0;5,0;;;;;;;;;6,0;;;;;;;;;;1,0;;;;;;47,0;;;;;1,0;;;;;;30,0;;;;;;55,0;;;3,0;;;;;;;3,0;;;;;;;;;;;;;1,0;27,0;;;;;;;;;;;;;2,0;;;;;;;;;1,0;;;;;;;;;;;71,0;;;;;;;;;;;;4,0;;;;;;;;;;12,0;;;;;;;;;2,0;;4,0;;;;1,0;;;;;5,0;;;;;;;;;14,0;;;;1,0;;;;;;;;;;;;;;9,0;;;;10,0;;;;;;;1,0;;;;2,0;;;;;;6,0;;3,0;;;;6,0;;;;5,0;2,0;;;;;;;6,0;;;;;;;;;;;;;;;;;;;;;;;;;;;;;;;;;;;;;;;;;;;3,0;2,0;3,0;;;;;;;;;;;;;;;;;;2,0;;;;;;;;;;;16,0;;;;;;;;;6,0;;;;;
probe;;15,0;;;;13,0;;43,0;;;;;;8,0;;;28,0;1,0;3,0;;;;;2,0;3,0;;;;5,0;;14,0;;;;;5,0;;9,0;3,0;;25,0;81,0;33,0;;2,0;30,0;;19,0;;;;;2,0;11,0;16,0;;2,0;8,0;;1,0;;;3,0;;47,0;1,0;65,0;;1,0;;;5,0;7,0;;;;;15,0;;;39,0;;1,0;;;3,0;;10,0;;1,0;;2,0;2,0;;;;1,0;;28,0;39,0;34,0;1,0;;;;11,0;;;;;1,0;4,0;1,0;;;;;;;91,0;;;13,0;;;;27,0;;67,0;;;;4,0;;;;15,0;;;;;;;;;3,0;2,0;2,0;4,0;12,0;;;11,0;4,0;;;;;;;4,0;3,0;;;;;47,0;;;;5,0;;;1,0;;;1,0;;;;;1,0;;8,0;;;;2,0;13,0;4,0;60,0;;;;;;54,0;;;7,0;;;2,0;;18,0;;16,0;;;8,0;10,0;5,0;;;;3,0;1,0;;;4,0;9,0;3,0;;;1,0;;69,0;;;1,0;;;;;;;;;;;;2,0;6,0;1,0;;2,0;3,0;9,0;2,0;4,0;;;;6,0;;1,0;10,0;16,0;1,0;;;;;;;;;;;;;;;2,0;;;1,0;;;2,0;;;18,0;2,0;;;1,0;;5,0;;;;;;;56,0;1,0;;;;;;12,0;;;2,0;2,0;15,0;;19,0;;;;;;;23,0;;3,0;2,0;;19,0;;;;;;;;6,0;;4,0;;2,0;;;;;;;3,0;5,0;;;;;7,0;;;;;;;;5,0;;10,0;;2,0;2,0;;;;;;;;;;;;;;17,0;;;;;;;6,0;46,0;;;;3,0;;;;;;4,0;;;;1,0;;;;2,0;;;2,0;1,0;;9,0;;;2,0;2,0;;8,0;;;3,0;7,0;;;;;;;;;;7,0;1,0;3,0;;;;;;;;;;;;;22,0;;;;;;;;2,0;;;;;;;;;;;;;2,0;;2,0;;;;;;;;;3,0;;26,0;;4,0;;;3,0;;;;;;;2,0;;;1,0;;;;;;;;;;;;;;11,0;;;;;;;;;;;;;;;1,0;;11,0;2,0;3,0;;;;;;;;;;1,0;;;;;;1,0;;;;4,0;6,0;;;;;;;;;;;;;;;;;;;;;;;;;;;;1,0;;;;;;;;;;;;;1,0;;;;4,0;2,0;;;;;;;;;;;;3,0;;10,0;;;;;;;;;;;2,0;2,0;;;;;;;;11,0;;;;;;;;;;;;;;;1,0;;;;1,0;;;;;;;4,0;;;;;;7,0;;;1,0;;10,0;;;;;1,0;;;;;21,0;;1,0;;1,0;;;;6,0;;;;;;;;4,0;;1,0;;;;;;;30,0;;1,0;;;;;;2,0;;1,0;;4,0;;;;;;;;5,0;;;;2,0;;;1,0;;;1,0;3,0;;1,0;;;;;;13,0;;2,0;;;;;;;;;;;1,0;2,0;;2,0;;8,0;;2,0;2,0;;;1,0;;;;;;;;;;11,0;;;;;;;;;2,0;5,0;;;;;;2,0;;;;;;;;;;;;;1,0;;;;;;;;;;;2,0;;;;;;;;;;;;;;;;;2,0;;;;;;;;;;;;;;;;;;;;;;;;;;;;;;;;;;2,0;;1,0;1,0;;;;;;;;;;;2,0;;;;;;;;;;4,0;;;;;;;;;;3,0;;;;;1,0;;;6,0;;;;;;;;;;;;;2,0;;1,0;;;;;;;;;;;;;;;;;;;;;;;;;;;;;;4,0;;;;;;;;;;;;;;;;;1,0;;;;;;;;;;;;;;;;;;;;;;;;;;;;;;;;;;;;
produce;;9,0;;10,0;8,0;13,0;63,0;7,0;;1,0;;29,0;7,0;35,0;7,0;1,0;78,0;2,0;;6,0;21,0;;45,0;2,0;2,0;1,0;;37,0;18,0;5,0;145,0;4,0;3,0;3,0;;223,0;;3,0;29,0;;18,0;89,0;2,0;50,0;34,0;7,0;5,0;23,0;;;18,0;;2,0;9,0;24,0;11,0;12,0;1,0;4,0;11,0;;12,0;12,0;1,0;942,0;;42,0;1,0;11,0;;6,0;81,0;159,0;;2,0;2,0;17,0;7,0;31,0;3,0;132,0;2,0;11,0;20,0;46,0;;;67,0;9,0;22,0;13,0;2,0;2,0;;;;80,0;11,0;80,0;12,0;44,0;6,0;;27,0;39,0;68,0;11,0;5,0;9,0;4,0;;8,0;16,0;2,0;;32,0;5,0;17,0;47,0;122,0;10,0;;170,0;5,0;40,0;8,0;45,0;;;;29,0;;;36,0;3,0;;29,0;20,0;5,0;1,0;;1,0;;;23,0;9,0;16,0;4,0;13,0;4,0;;;24,0;;;1,0;1,0;;6,0;;4,0;6,0;10,0;4,0;;;20,0;3,0;;1,0;10,0;2,0;11,0;9,0;;2,0;3,0;11,0;2,0;10,0;9,0;;;14,0;;6,0;18,0;13,0;65,0;4,0;2,0;5,0;28,0;1,0;1,0;2,0;6,0;22,0;7,0;;;9,0;;4,0;24,0;5,0;2,0;2,0;11,0;6,0;4,0;3,0;;;1,0;;92,0;;1,0;6,0;22,0;1,0;2,0;;6,0;;50,0;;2,0;;;18,0;15,0;8,0;4,0;;7,0;2,0;;14,0;2,0;1,0;1,0;;1,0;22,0;2,0;1,0;2,0;;;;;17,0;2,0;9,0;;14,0;5,0;;18,0;9,0;1,0;22,0;;;2,0;1,0;4,0;1,0;;;9,0;7,0;;;5,0;26,0;;6,0;;;21,0;1,0;1,0;;;;20,0;;7,0;10,0;;;22,0;3,0;29,0;;;1,0;1,0;1,0;;7,0;;;;1,0;1,0;22,0;;;;;3,0;;1,0;3,0;3,0;5,0;4,0;67,0;;3,0;;;1,0;;12,0;5,0;;;;1,0;2,0;4,0;;;;;5,0;22,0;;;;5,0;4,0;10,0;1,0;5,0;2,0;;;;1,0;;1,0;;92,0;11,0;;;6,0;1,0;2,0;2,0;6,0;4,0;3,0;;2,0;;6,0;1,0;3,0;1,0;;3,0;3,0;;33,0;13,0;;2,0;7,0;7,0;;9,0;6,0;2,0;2,0;3,0;6,0;13,0;4,0;20,0;;15,0;11,0;9,0;5,0;5,0;3,0;8,0;4,0;4,0;13,0;6,0;35,0;19,0;;4,0;;2,0;33,0;9,0;;;;2,0;3,0;3,0;1,0;1,0;4,0;21,0;;66,0;2,0;1,0;;;3,0;1,0;6,0;2,0;3,0;7,0;2,0;;1,0;1,0;7,0;1,0;8,0;4,0;;1,0;9,0;;1,0;20,0;15,0;1,0;;;1,0;2,0;;7,0;2,0;4,0;;1,0;;52,0;4,0;;2,0;;6,0;1,0;9,0;21,0;;;1,0;;5,0;8,0;6,0;5,0;11,0;7,0;5,0;21,0;18,0;;2,0;2,0;1,0;1,0;6,0;2,0;7,0;6,0;2,0;;1,0;;2,0;33,0;;1,0;10,0;2,0;;;;2,0;7,0;4,0;;;;1,0;;;;;1,0;;1,0;;;;3,0;1,0;;;4,0;;;4,0;1,0;;3,0;;1,0;2,0;;;24,0;2,0;;5,0;;;2,0;;;1,0;;14,0;;3,0;;6,0;;11,0;;;4,0;3,0;4,0;;12,0;;;2,0;;1,0;;;8,0;14,0;;1,0;;2,0;3,0;;15,0;;2,0;2,0;;1,0;;17,0;;;;2,0;1,0;;3,0;3,0;9,0;1,0;2,0;1,0;;29,0;2,0;6,0;;11,0;7,0;;;5,0;17,0;2,0;;;2,0;1,0;;2,0;;;7,0;2,0;;;;;;4,0;2,0;2,0;2,0;3,0;10,0;3,0;;;;1,0;;;1,0;;;3,0;;2,0;;1,0;;2,0;2,0;;1,0;;4,0;;13,0;3,0;6,0;1,0;;;12,0;;;3,0;;;74,0;;;;50,0;4,0;;2,0;8,0;;;2,0;;5,0;2,0;9,0;2,0;6,0;;;;;2,0;4,0;2,0;7,0;3,0;5,0;;;8,0;1,0;;6,0;8,0;;;4,0;1,0;4,0;;;;;;14,0;;;;4,0;;;2,0;5,0;;4,0;;1,0;6,0;2,0;;;2,0;;5,0;;;;6,0;;1,0;;1,0;;;1,0;;30,0;;;;;6,0;;1,0;;;;2,0;;;;;;;;2,0;;;;;;23,0;;;;2,0;;;;;;;;2,0;;3,0;2,0;;;1,0;;3,0;;;;1,0;;;1,0;;;;5,0;;14,0;;;3,0;;;5,0;4,0;;2,0;;;2,0;;2,0;;11,0;;;;12,0;1,0;20,0;;;2,0;;2,0;;;14,0;1,0;;3,0;;;3,0;;4,0;;;;2,0;2,0;;1,0;;;;;;32,0;;;25,0;5,0;10,0;;;;2,0;1,0;;;;2,0;3,0;;6,0;6,0;;;6,0;5,0;1,0;10,0;1,0;1,0;3,0;;2,0;;;6,0;2,0;10,0;1,0;27,0;;;;;;;;;1,0;;7,0;;3,0;;;;4,0;;;1,0;;;;6,0;1,0;1,0;;;;2,0;;;4,0;1,0;3,0;12,0;;;22,0;;;1,0;;;3,0;;;;1,0;21,0;;;;;;;;4,0;;;;;;;;;;;2,0;;;10,0;;;;;;2,0;;;8,0;;2,0;;1,0;1,0;3,0;;8,0;;5,0;;;;3,0;6,0;;;;;;;;;;;
project;;3,0;;9,0;12,0;27,0;36,0;16,0;;;;;4,0;58,0;1,0;2,0;105,0;;11,0;5,0;2,0;5,0;41,0;;;;;11,0;6,0;;130,0;3,0;5,0;8,0;;20,0;17,0;1,0;33,0;;46,0;98,0;6,0;14,0;26,0;16,0;4,0;28,0;;3,0;4,0;;16,0;5,0;54,0;6,0;74,0;;8,0;18,0;1,0;1,0;25,0;;526,0;1,0;112,0;11,0;;;5,0;117,0;437,0;;2,0;;;5,0;3,0;10,0;112,0;1,0;4,0;46,0;16,0;4,0;;91,0;7,0;;6,0;1,0;4,0;5,0;11,0;;54,0;34,0;93,0;130,0;89,0;31,0;4,0;1,0;22,0;30,0;1,0;3,0;2,0;;;37,0;33,0;;;;9,0;22,0;161,0;75,0;36,0;;6,0;26,0;9,0;2,0;83,0;3,0;2,0;;29,0;;2,0;90,0;3,0;;55,0;17,0;5,0;;;8,0;;;29,0;3,0;24,0;26,0;8,0;9,0;;;41,0;12,0;;1,0;4,0;;;;6,0;13,0;4,0;;;;4,0;20,0;8,0;4,0;11,0;2,0;7,0;51,0;3,0;28,0;;18,0;4,0;;2,0;;1,0;10,0;;;6,0;1,0;72,0;42,0;;;;12,0;5,0;7,0;40,0;6,0;18,0;2,0;;;9,0;;20,0;3,0;101,0;;33,0;29,0;3,0;16,0;3,0;;;20,0;;3,0;;22,0;370,0;11,0;3,0;;16,0;;65,0;;7,0;2,0;1,0;18,0;1,0;5,0;3,0;1,0;16,0;4,0;;26,0;;9,0;3,0;;4,0;13,0;10,0;19,0;53,0;;5,0;2,0;2,0;52,0;;;23,0;146,0;3,0;2,0;1,0;1,0;;19,0;6,0;;2,0;12,0;4,0;9,0;6,0;13,0;2,0;4,0;;;;48,0;2,0;1,0;;;56,0;2,0;;;10,0;1,0;4,0;;2,0;1,0;;1,0;6,0;18,0;37,0;4,0;;6,0;;6,0;1,0;;;1,0;1,0;3,0;1,0;20,0;1,0;;6,0;8,0;20,0;;5,0;1,0;;7,0;1,0;146,0;17,0;7,0;;3,0;;;4,0;;16,0;1,0;;7,0;10,0;;;;1,0;;3,0;;2,0;;11,0;1,0;7,0;16,0;;1,0;3,0;;;2,0;13,0;4,0;;10,0;16,0;;;;2,0;;;2,0;2,0;;;1,0;;6,0;10,0;17,0;15,0;;5,0;2,0;4,0;4,0;15,0;28,0;;3,0;;20,0;3,0;10,0;;;;3,0;9,0;12,0;2,0;1,0;;1,0;3,0;;;1,0;;;6,0;33,0;2,0;1,0;4,0;1,0;15,0;17,0;;3,0;1,0;16,0;;;;3,0;1,0;1,0;1,0;10,0;6,0;16,0;4,0;4,0;;;8,0;;1,0;;4,0;;1,0;18,0;;;1,0;;9,0;;;2,0;1,0;;11,0;3,0;;;2,0;;;;;13,0;;;1,0;1,0;2,0;3,0;1,0;;3,0;5,0;;;;;4,0;4,0;;;64,0;;;1,0;1,0;;;7,0;6,0;4,0;10,0;1,0;;;;;1,0;;1,0;3,0;23,0;;;;39,0;;3,0;;8,0;9,0;3,0;;;2,0;3,0;;;2,0;;8,0;1,0;2,0;;;2,0;2,0;7,0;6,0;;;;1,0;;;;;2,0;15,0;7,0;;3,0;;2,0;1,0;;;1,0;9,0;;4,0;;;;;;;;;;;;;1,0;1,0;;;12,0;;7,0;5,0;3,0;;;;;;;;;11,0;;;8,0;4,0;;6,0;81,0;;;7,0;3,0;;15,0;3,0;;3,0;;;2,0;;3,0;6,0;21,0;3,0;;2,0;;14,0;;4,0;;8,0;;;1,0;5,0;;2,0;;;3,0;;;5,0;3,0;;;33,0;;;4,0;;;;;;;5,0;;;;;5,0;1,0;;2,0;2,0;;;3,0;;1,0;;1,0;;;;1,0;8,0;2,0;10,0;3,0;8,0;3,0;3,0;;;;1,0;;;;1,0;;39,0;;1,0;;;13,0;;2,0;53,0;;;;;;3,0;1,0;;;;;;2,0;;;;7,0;;2,0;;;2,0;;;1,0;;;3,0;;;;1,0;;6,0;;;57,0;;1,0;;2,0;;;;;;3,0;;;137,0;1,0;;;1,0;;12,0;;1,0;6,0;12,0;;3,0;;1,0;1,0;;;;14,0;3,0;;;;1,0;1,0;;9,0;;;1,0;;;4,0;;4,0;2,0;;2,0;;1,0;2,0;;;109,0;2,0;;;3,0;4,0;1,0;;;;1,0;;1,0;;;4,0;;;;;1,0;;;;4,0;;;;;;24,0;11,0;;;;;11,0;8,0;;;;;;2,0;;;;;1,0;21,0;3,0;;3,0;;;;;;;;4,0;;;;;;;;2,0;2,0;1,0;4,0;;;;21,0;1,0;;12,0;;;;;;16,0;6,0;3,0;;4,0;45,0;1,0;;;;;;12,0;;;9,0;;13,0;;;;1,0;;;;1,0;2,0;7,0;;;;;;;;1,0;2,0;;;;;;;;;;12,0;;10,0;;;5,0;1,0;2,0;;;1,0;1,0;;;;1,0;9,0;;;5,0;;;;28,0;;;5,0;;;;;13,0;;;;;;3,0;;;;;;;;;;;;;;2,0;;2,0;;1,0;;;;13,0;;;4,0;2,0;;;5,0;;6,0;3,0;;;6,0;;;3,0;4,0;;;;4,0;1,0;;;4,0;;2,0;2,0;;;;;;;;;;
projector;;4,0;;8,0;1,0;26,0;27,0;16,0;;;;;;36,0;1,0;;44,0;;;2,0;;;6,0;;2,0;;;18,0;2,0;;72,0;3,0;3,0;13,0;4,0;2,0;9,0;;31,0;;29,0;76,0;;3,0;45,0;3,0;24,0;14,0;;;23,0;;1,0;16,0;10,0;9,0;8,0;;;26,0;;2,0;2,0;;129,0;1,0;41,0;9,0;;;6,0;29,0;146,0;3,0;;;;4,0;;10,0;77,0;2,0;4,0;70,0;9,0;2,0;;33,0;;;47,0;;6,0;3,0;2,0;;40,0;36,0;41,0;27,0;30,0;7,0;;6,0;5,0;17,0;;1,0;11,0;;;28,0;13,0;;;;3,0;19,0;13,0;16,0;6,0;;17,0;;;7,0;68,0;;;;7,0;3,0;3,0;13,0;;;4,0;1,0;2,0;;;;;;;6,0;15,0;10,0;9,0;11,0;;;3,0;;;;;;;;;3,0;2,0;;;12,0;11,0;4,0;3,0;2,0;3,0;;3,0;11,0;;;;51,0;9,0;;;;4,0;;;;1,0;;11,0;1,0;;;;;;;;;;;;;5,0;;20,0;2,0;;;;12,0;;1,0;18,0;;2,0;;5,0;1,0;;7,0;144,0;1,0;1,0;;;;47,0;;;6,0;;;5,0;;;;4,0;;;6,0;;;;;;;4,0;;4,0;;1,0;2,0;;14,0;4,0;4,0;7,0;39,0;1,0;;;;;5,0;2,0;;;1,0;;2,0;;;;1,0;;;;13,0;;;;1,0;18,0;;;;2,0;;9,0;;1,0;1,0;;;;;21,0;4,0;;;;;2,0;;;;;3,0;;12,0;;;;;;;2,0;;4,0;;;33,0;2,0;10,0;;;;;20,0;;;;;;1,0;;;;;;4,0;6,0;2,0;1,0;;;;2,0;;;;;;;1,0;;;;2,0;;;;;;;3,0;;;;17,0;;;2,0;25,0;2,0;2,0;;;;;34,0;31,0;;3,0;;2,0;2,0;5,0;2,0;;;;;6,0;;2,0;;1,0;;;;4,0;;;;8,0;;;2,0;4,0;6,0;;;9,0;14,0;16,0;;9,0;;;;;3,0;;;9,0;;3,0;1,0;;1,0;;;;;2,0;1,0;1,0;;;4,0;;8,0;2,0;3,0;2,0;;;2,0;;;;22,0;;;1,0;1,0;31,0;;2,0;6,0;;;1,0;4,0;;;;;;;;2,0;;;;83,0;;2,0;2,0;;;;4,0;7,0;;17,0;;;;2,0;6,0;;137,0;;;35,0;;;;1,0;1,0;;;;4,0;;2,0;;1,0;1,0;6,0;;;;4,0;;4,0;;;3,0;;;1,0;;;;;;;;;;;13,0;;;;2,0;8,0;;;;1,0;;2,0;;;;;;;;;;;;;;;;;;;;;;1,0;;;;;;;;1,0;;;;;;;70,0;1,0;;2,0;;;3,0;1,0;;;;;4,0;;;;6,0;;1,0;;;13,0;;;;;14,0;;;1,0;;;;;;;;;;1,0;10,0;6,0;;;;;;;;;;;;;;;1,0;;2,0;3,0;;;;3,0;;3,0;;;;;;;7,0;;;;;1,0;30,0;9,0;;1,0;;1,0;;;;;15,0;;1,0;;;3,0;;4,0;1,0;;;;;;;;;;;;;;1,0;;;;;1,0;;1,0;1,0;;;;3,0;;;2,0;;;;;2,0;;;13,0;;1,0;;3,0;;;;;;1,0;;1,0;;;;;;4,0;7,0;4,0;;;;;7,0;;2,0;;;1,0;;3,0;1,0;;;;;3,0;;;;;;;;;;2,0;;;;;;;7,0;;65,0;;1,0;;;;;;;;;;;;;;;;;;3,0;;;;;;;;;;;7,0;;;;;2,0;3,0;;;;;;;;;;;;;;;;;2,0;;;;;;;;;;;;;;;;;;;;;2,0;;;;9,0;;;;;3,0;1,0;;;;3,0;;;;;;;;;;;3,0;1,0;1,0;10,0;;3,0;;1,0;;1,0;;;;;;;;;1,0;;;1,0;;;;;3,0;;;1,0;;;;;;;2,0;9,0;;;;2,0;;;1,0;;;32,0;;;2,0;;;;5,0;;5,0;;;;;;;;;;;1,0;;;;;;;;;;;;;;;;;7,0;2,0;;;;;;1,0;;3,0;;4,0;;;;;;1,0;;;;3,0;;;;;;;51,0;;;;;14,0;;;;;;;;;;
protective;;4,0;;2,0;;11,0;2,0;14,0;;;2,0;;4,0;4,0;;;1,0;;;;;;6,0;;;;;12,0;;8,0;17,0;3,0;;;1,0;1,0;4,0;1,0;1,0;;5,0;73,0;2,0;;;35,0;;65,0;;;;;11,0;7,0;;;15,0;;;;16,0;;;;18,0;1,0;23,0;;;;4,0;89,0;33,0;7,0;;;11,0;;;1,0;12,0;;;;18,0;11,0;;12,0;;;;2,0;9,0;;;;;5,0;;;44,0;3,0;3,0;;;1,0;;;1,0;;2,0;;7,0;;7,0;;;1,0;1,0;26,0;;;2,0;2,0;;;59,0;;;2,0;1,0;;;21,0;;;4,0;;;;;3,0;12,0;;21,0;3,0;4,0;2,0;;11,0;;2,0;14,0;2,0;;;;7,0;;;;;;;;;22,0;129,0;;2,0;;;;11,0;24,0;4,0;;;2,0;;;;3,0;20,0;;16,0;15,0;;1,0;16,0;;;1,0;;3,0;3,0;43,0;;20,0;1,0;;28,0;;;;;22,0;3,0;1,0;3,0;10,0;;;;1,0;47,0;;1,0;;;2,0;;;;11,0;;22,0;1,0;3,0;2,0;1,0;4,0;;1,0;;;1,0;1,0;1,0;1,0;;5,0;11,0;1,0;7,0;;;5,0;6,0;;;;;4,0;1,0;;5,0;54,0;4,0;;;1,0;2,0;1,0;6,0;1,0;;3,0;;44,0;;4,0;12,0;5,0;2,0;2,0;1,0;3,0;;;2,0;1,0;1,0;1,0;;;2,0;74,0;3,0;2,0;;7,0;;5,0;3,0;;1,0;;2,0;;2,0;;1,0;;;1,0;;3,0;;18,0;1,0;1,0;4,0;1,0;1,0;;6,0;1,0;;1,0;34,0;;2,0;;;;;2,0;;;2,0;;;2,0;;1,0;;;;;14,0;5,0;;1,0;;3,0;1,0;;;1,0;;;;;;28,0;;12,0;;;;;;;;;;;;;;;;;4,0;;;;;;4,0;;;1,0;;2,0;;;;;;;;2,0;;;;;1,0;;;6,0;20,0;2,0;;;;3,0;1,0;8,0;;;;;3,0;;;;;;;1,0;;;;11,0;;6,0;;;;;;;;;;;1,0;;;;1,0;2,0;;;;;10,0;;;;;;;;;;;;;;;;;;;;;;;;1,0;3,0;4,0;;10,0;;;;;;;2,0;;9,0;;;;;;;;1,0;;;;;;;;;;;;;;;;;;;;;;1,0;;27,0;;;;;;;;;37,0;5,0;;;9,0;;;10,0;;;;;;;;;;16,0;;;;;;;;;;;;;;;;;;;1,0;;;;;;1,0;;;1,0;;2,0;2,0;;;;2,0;2,0;;2,0;2,0;;;;;;;;;;;;;;;;2,0;1,0;;;;3,0;;;;2,0;;;;;;;;2,0;;;;;;;;;;;2,0;;;;;;;;;;;;;;9,0;;2,0;;;;;;;3,0;;1,0;;;;7,0;;;;;;;;1,0;1,0;;;;;;;;;;;;;;;;;;;;;;;5,0;2,0;;;;;;;8,0;2,0;;1,0;;;;;2,0;1,0;3,0;;;;;;;3,0;;1,0;;;6,0;;;;;1,0;;;;3,0;;3,0;;;;;4,0;7,0;;;;;;;14,0;;;;1,0;;;;;;;;;;1,0;5,0;;1,0;3,0;;;;;;;;;;;;;1,0;1,0;;;3,0;5,0;7,0;;;;11,0;;25,0;;;2,0;;;;;;;;;;;;;;;;;;;;;;1,0;;;;;;;;;;;2,0;;;;;;;;;2,0;;;;;;;;;;;;;;;;;;;;;;;;;;;;;;;;;;;;;5,0;;;;;;;;6,0;;;;;;;;1,0;;;;;;;;;;;;;;1,0;;;;;;;;;;3,0;;;;;;;;;;;;;;;;;;;1,0;;;;;;;;1,0;;;;;;;;;;;;;3,0;;;;;;2,0;;;;;;;;1,0;;;;;13,0;;;;;;;1,0;1,0;;;;;2,0;;;;;;;;;;;;;6,0;;;;;;;;
protocol;;2,0;;;;20,0;;;;8,0;;;;6,0;;;1,0;;;;;;;16,0;42,0;;;;3,0;2,0;24,0;3,0;;2,0;;43,0;4,0;1,0;;;6,0;85,0;;5,0;1,0;;;;;2,0;;;;;3,0;;;;1,0;7,0;;;7,0;;17,0;10,0;11,0;;;;;;1,0;;;;;;34,0;3,0;46,0;;21,0;4,0;1,0;;;;;14,0;4,0;;;12,0;;;;;5,0;;;13,0;;;13,0;8,0;;;;;;;1,0;;;;1,0;;5,0;9,0;3,0;;15,0;1,0;;2,0;16,0;;;;5,0;;;10,0;;;1,0;;;;;;;;;5,0;4,0;;13,0;;;;;;;;;;;;;7,0;1,0;;;;2,0;;;;;;;;;;;;3,0;;;2,0;;;;;;;7,0;;;;;1,0;;;5,0;;;2,0;;3,0;;1,0;;10,0;;;;;;;;;;;;;;;;;;;;;3,0;;;;;;;;;;;;;;;;1,0;;;6,0;3,0;;;;;;5,0;;;;4,0;;;;12,0;8,0;8,0;3,0;;;;;;;;5,0;;1,0;2,0;;1,0;;;1,0;;;;;;;;;12,0;;;10,0;;;;;;;;;;;;;;;;;;5,0;;;2,0;;;;;;;;2,0;2,0;;;;;;;2,0;;;;;;2,0;;;;;;;;;;;;;;;;;;;;;;;;35,0;85,0;;;;;;;;;;2,0;;;;;18,0;14,0;1,0;2,0;;;41,0;;;;;7,0;;;3,0;;;;9,0;;;2,0;1,0;;5,0;;;1,0;;;;4,0;3,0;25,0;;;;;;6,0;11,0;;;;;;;2,0;;;2,0;5,0;10,0;12,0;6,0;;;;2,0;;2,0;;4,0;;;;;25,0;;;;1,0;;;8,0;;;;5,0;;;;;;;1,0;3,0;1,0;;1,0;;;;;2,0;;;;1,0;23,0;;1,0;;3,0;;;;;;;;;1,0;1,0;2,0;;;;;;;;;7,0;1,0;;;7,0;;;;;;;;1,0;3,0;;;;;;;;;;30,0;;;;;;;;;;;;;;;1,0;;;1,0;;2,0;;;;;10,0;;;7,0;;;;;;8,0;;;;;;11,0;2,0;1,0;;4,0;4,0;;2,0;1,0;;;;6,0;;;;;;;;;;;;;;;1,0;;5,0;20,0;2,0;;3,0;;;;;;;;;;;;2,0;;;;;28,0;;;;;;;1,0;36,0;;2,0;4,0;;;45,0;;;;;1,0;;;;18,0;;4,0;;;;;;;;;;;;;;;;;;3,0;;;;;3,0;;;11,0;3,0;;;;1,0;5,0;;4,0;1,0;;;;;;;;;;;;;18,0;1,0;;1,0;;;;;;;;2,0;;;;;;;;;;;;;;;;;;;28,0;;;;;;;10,0;;;;;;;;;;;;;;;;;;1,0;;1,0;;;;;;;;;;;;;;;;;;;;5,0;;;;;;;;;;;;;;;;;;;;;;;;;;;;;;;;;;;;;;;;;;;;;;;;;;3,0;;;;;;;;;;;;2,0;;;;;;;;;;2,0;;;;;;;;;;;;;;;;;;;;;;;4,0;;;;2,0;;;;;;;;;;;;;;;;;;;;;;;1,0;;;;;;;;;;3,0;;;;;3,0;;;;;;;;;;;;;;;;;;;1,0;;;;11,0;;;;;;;;;;;;;;;;;;;;;;;;;;;;;;;;;;;;;;;;;1,0;;;;;;;;;;;;;;;;;;;;;;2,0;;;;;;;;;;;;;;;;
proximate;;1,0;;5,0;;15,0;14,0;3,0;;;;;;10,0;;;5,0;1,0;2,0;;3,0;;;;;;;2,0;;;8,0;;;;;5,0;2,0;;26,0;;6,0;42,0;;6,0;41,0;42,0;;24,0;;;;;5,0;;7,0;14,0;9,0;;;1,0;2,0;;;;85,0;;3,0;;10,0;;4,0;88,0;29,0;;;;2,0;;;;6,0;;;3,0;2,0;3,0;;24,0;;1,0;;1,0;;;;;7,0;27,0;15,0;23,0;83,0;1,0;2,0;;;;6,0;;;;;;35,0;;1,0;;;12,0;1,0;41,0;;;;;4,0;;15,0;;1,0;;9,0;;;10,0;;;16,0;;;;;;;;20,0;1,0;8,0;22,0;3,0;10,0;;14,0;16,0;7,0;;;;;;;;6,0;;;;;1,0;12,0;;;;;2,0;;2,0;16,0;;5,0;;;;;;3,0;6,0;;4,0;;11,0;44,0;;;;;;3,0;31,0;;3,0;;;33,0;;;;;17,0;;;15,0;4,0;4,0;5,0;17,0;;12,0;;4,0;29,0;13,0;;;;;9,0;13,0;26,0;;;1,0;1,0;5,0;;;5,0;5,0;1,0;;;;;;;;1,0;4,0;;1,0;21,0;;1,0;;2,0;3,0;3,0;1,0;3,0;49,0;3,0;;;1,0;;16,0;7,0;2,0;;;;16,0;5,0;6,0;;;3,0;;4,0;9,0;;;12,0;;;;;;4,0;2,0;;;5,0;;;;;9,0;4,0;;;1,0;;;2,0;2,0;;2,0;6,0;;;4,0;;;1,0;;2,0;;36,0;;;3,0;14,0;8,0;8,0;;;;;;6,0;;2,0;1,0;3,0;1,0;2,0;;;;;;;;;;;;;1,0;;;;5,0;;;1,0;1,0;;;1,0;;;;;;;;2,0;;;;;;;;;;;;;1,0;8,0;;;;;2,0;;;;;;;;8,0;;;12,0;;;;;4,0;;;;22,0;;2,0;;2,0;3,0;6,0;;;;3,0;;;;;;;;;;11,0;1,0;2,0;;;;;;2,0;2,0;;;;;;;;;;;;;;41,0;;;;;;;;;4,0;;;8,0;1,0;;;;;;;;1,0;1,0;5,0;;1,0;1,0;;;;;;8,0;;8,0;;;;1,0;4,0;;;;;;1,0;8,0;;17,0;1,0;;;;;;11,0;;1,0;;1,0;;;2,0;;;;;;;;;;;2,0;;5,0;;;4,0;3,0;1,0;;;;1,0;;1,0;;;;;;1,0;;;13,0;;;;;1,0;;;2,0;;1,0;;;;7,0;;;;;;1,0;;;3,0;;4,0;;;;;1,0;;;;1,0;;7,0;;;1,0;;;9,0;2,0;;;;;;;;;;;;6,0;;;;;2,0;;;;1,0;;;;1,0;;4,0;;;;;;2,0;;;;7,0;;;2,0;;;;;;;;;;;;4,0;;;1,0;1,0;;;;;3,0;;;;;;;;;;;;;2,0;;;1,0;;;;;;;5,0;4,0;;;;;;;12,0;;;2,0;;1,0;;3,0;;;;4,0;6,0;2,0;;;;;4,0;8,0;;;3,0;;;;;5,0;;;1,0;;;;2,0;;;;;1,0;;;;;;;;1,0;;4,0;;;;;;;;;;;;1,0;6,0;;;2,0;;;22,0;2,0;1,0;1,0;1,0;;1,0;;;10,0;;;;;;;;;;;;;;;;;;1,0;;;;;;;;;;;6,0;;;;;;;;1,0;;;;;;;;;;;4,0;;;;;;;;1,0;;;;;;;;;;;;;;;;;;;;;;;4,0;;;1,0;;;;;1,0;;;;;;;2,0;;;;;;;;;;;;1,0;;;;;;;9,0;;;;;1,0;;;;;;;;;;;;;;1,0;;;;;;;;;;1,0;;;;;;;;;;;;;;;4,0;;;;;5,0;;;;;;;;;;;;;;;;1,0;;2,0;;;;;;;;;;;5,0;;;;;;;;;;;;;;;;;;;;;2,0;;;;1,0;7,0;;;;;;;;3,0;;;;;;;;;;;;;;;;;;;
quality;;1,0;8,0;12,0;;14,0;3,0;;;;;;;69,0;;5,0;33,0;;7,0;4,0;;;25,0;2,0;1,0;1,0;;;5,0;23,0;10,0;5,0;10,0;4,0;;78,0;4,0;;25,0;;72,0;47,0;;22,0;19,0;;2,0;6,0;;;1,0;;;;;17,0;2,0;;;18,0;1,0;;1,0;;469,0;1,0;36,0;20,0;42,0;;1,0;8,0;6,0;;;;;7,0;1,0;;68,0;;15,0;;10,0;;;11,0;3,0;;5,0;10,0;;1,0;13,0;;;;28,0;16,0;21,0;36,0;;3,0;19,0;19,0;1,0;1,0;1,0;;;7,0;3,0;;;;44,0;9,0;11,0;33,0;;;9,0;5,0;;15,0;39,0;;;;21,0;;;9,0;5,0;;4,0;1,0;1,0;;;;;;2,0;3,0;4,0;;30,0;;;2,0;;;2,0;;;;6,0;;;1,0;42,0;1,0;;;1,0;;20,0;5,0;;;;3,0;;;;;6,0;;;;1,0;24,0;;;;;29,0;;;;;;;;;;;;;1,0;;;10,0;3,0;;;;1,0;;2,0;;;;;1,0;;;3,0;2,0;6,0;1,0;;;;6,0;;1,0;2,0;;;2,0;1,0;;;;;;6,0;;;;;;16,0;;;1,0;;;;;;;;;4,0;;;2,0;7,0;1,0;;;;;;5,0;2,0;;;;;;;3,0;4,0;;;;;;;;;;2,0;2,0;;;1,0;;;;;;;;;;;;;;;;;;22,0;3,0;;;;;;1,0;;3,0;;1,0;23,0;;;;;;;1,0;;;1,0;;;19,0;;;;;;15,0;;;;;;;1,0;;;;;3,0;;4,0;;1,0;;141,0;4,0;;;;2,0;;10,0;2,0;;;2,0;;;21,0;;6,0;7,0;;1,0;14,0;4,0;18,0;1,0;;3,0;2,0;18,0;5,0;2,0;;12,0;6,0;4,0;4,0;5,0;;7,0;;5,0;11,0;11,0;;1,0;1,0;135,0;;4,0;;3,0;;;;20,0;;6,0;10,0;13,0;;;;;4,0;41,0;6,0;;1,0;2,0;;9,0;2,0;;3,0;1,0;41,0;1,0;24,0;;3,0;;;;2,0;1,0;29,0;;;2,0;;;27,0;;;;;;;1,0;9,0;4,0;;;18,0;1,0;;1,0;;31,0;9,0;;1,0;;;6,0;1,0;;3,0;;;;;;;;2,0;;;2,0;11,0;3,0;1,0;3,0;;1,0;;1,0;3,0;;;3,0;;;;36,0;;;;;;1,0;;6,0;11,0;1,0;;;1,0;;;;;;;;;;13,0;;;1,0;;;;;;;;;;;1,0;9,0;;;;;;60,0;;;;47,0;;;;3,0;;;;;;;;;3,0;1,0;;1,0;2,0;;;2,0;;;;;1,0;1,0;;2,0;;;;;1,0;;;;;;2,0;13,0;;;;16,0;;;;;;;;;;13,0;6,0;;;1,0;1,0;;4,0;;3,0;;;;;;;;;1,0;;10,0;;;;;3,0;;;;;3,0;;;;;;2,0;;3,0;;;;4,0;3,0;;;;;;;;4,0;;2,0;1,0;3,0;3,0;;1,0;;;;;;;;;1,0;;;;16,0;;;1,0;2,0;;;;;2,0;4,0;1,0;;;;;;;;;2,0;;;;;;;;3,0;;;;;;;8,0;;;;1,0;;5,0;;;;;;;;;;1,0;;;;;;;;;13,0;;;;;;;;;;;;;4,0;;;;;;;;;;;;;;;;;;;5,0;;;;4,0;;;;;;;;;;;;;;;;;;;;;;;;;;;;;;;;;59,0;;;;;8,0;;;;;;;;;1,0;;;;;;;;;;;;;;;7,0;;1,0;;2,0;;;;;;;;;5,0;3,0;1,0;1,0;;;;;;;;;3,0;;;;;;;;;5,0;1,0;;;;;2,0;;;;;2,0;;3,0;;1,0;;;;1,0;;;;;;;;16,0;;;;;;2,0;2,0;;;3,0;;;;2,0;;;;;;;;;;;;;;;;;;;;1,0;;;;;;;;;;;;;;;1,0;;;;;;;;4,0;;;;1,0;;;;;1,0;;;;;;;;;;;;;;;;;;;;;;;;;;60,0;;;;1,0;;;1,0;;;;;;;
quantity;;3,0;;5,0;;;;1,0;;;;;;27,0;;;30,0;;;2,0;;;;;;;;12,0;2,0;;5,0;6,0;10,0;37,0;;5,0;5,0;;9,0;;9,0;14,0;;5,0;2,0;;;8,0;;;;;;;;;;;1,0;6,0;;;9,0;;81,0;;8,0;1,0;1,0;;4,0;2,0;124,0;;1,0;;;1,0;;2,0;11,0;3,0;2,0;1,0;5,0;;;10,0;;3,0;;;3,0;;;;96,0;;4,0;2,0;2,0;10,0;;1,0;2,0;4,0;;;;;;3,0;2,0;;;;6,0;3,0;4,0;27,0;;;10,0;;;1,0;9,0;;;;7,0;3,0;;1,0;2,0;;;2,0;;;;;;;4,0;;4,0;6,0;4,0;;;;;;;2,0;;;;;;2,0;;;;;;;;2,0;;1,0;;4,0;;;;;;;;;;;;;3,0;;2,0;;;;;;;;1,0;6,0;;;;;;;19,0;1,0;;;;;1,0;;;;;;6,0;;;;5,0;2,0;6,0;;5,0;;5,0;;;3,0;;;3,0;23,0;;;14,0;;;1,0;;;;;;1,0;;;;;;;1,0;;;;;3,0;;;;3,0;;;;;;1,0;;;;;;3,0;;;;1,0;;;;;11,0;;;;;;;;;1,0;;;;;3,0;1,0;;;;;;;;2,0;;;27,0;6,0;;;;;;;5,0;;;;;4,0;;1,0;;;;;;;;;;;2,0;;;;;;;;;;;;;;;;;;;;4,0;;;;6,0;;;1,0;1,0;;;;1,0;;;;;;14,0;1,0;3,0;;1,0;;1,0;;6,0;5,0;2,0;;;9,0;4,0;;;;;;;1,0;;;;2,0;1,0;5,0;;2,0;;;;;;;;;;;;;3,0;;;;;;;4,0;1,0;3,0;;3,0;1,0;1,0;;1,0;4,0;;1,0;10,0;2,0;;;;1,0;;;;;;;;;;;;;;;;;;;;;;5,0;;15,0;2,0;;;;;;;1,0;;1,0;;;;;;;;;2,0;;;;;;1,0;;;;;;1,0;;;3,0;;;;;6,0;;;1,0;2,0;;;;;3,0;2,0;;;;;;;;;;;;;;;;;;;;;;;;;14,0;12,0;;;;4,0;;;;;;;1,0;;;;;;2,0;;;;;;;;;;;;;;;;;;;;;6,0;2,0;;;;;;4,0;;1,0;;;;;;;;;;;;;3,0;1,0;;;;;5,0;;;;;;;;;;;;;;;;;;;;;;;;;;;;;;;;;;;;;;;;;;;;;;;;;;;;;;;;;;1,0;;;;;;;;;6,0;;;;;1,0;;;6,0;;;;;;;;;;;;;;;;;2,0;1,0;;;;;;;;;;;;;;;;;;;;;;;5,0;;;;;;;;;;4,0;;;;;3,0;;;;;;;;;;;;;;;;;;;;;;;2,0;;;;;;;;;;;;;;;;;;;;;;;;2,0;;2,0;;;;;3,0;;;;;;;;;;;;;;;;;;;;;;;;;;;;;;;;;1,0;;;;;;;;;;;;;;;;;;;;;;;;;;;;;;;;;;;;;;;;;;;;;;;;;;;;3,0;;;;;;;;;;;;;;;;;;;;;;;;;;;;;;;;;;;1,0;;;;;;;;;;;;;;;;;;;;;;;;;;;;;;;;;;;;;;;;;;;;;;;;;;;;;;;;;;;;;;;;;;;;;;;;;;;;;;;;;;;;;;;;;;;
rail;;7,0;;3,0;;15,0;;32,0;;;;;;51,0;;;;;9,0;;;;;;7,0;;;101,0;;2,0;36,0;;;;;;10,0;17,0;;;;30,0;2,0;;;20,0;;2,0;;;;;70,0;;;;20,0;;;;;;;;7,0;;47,0;;;12,0;20,0;26,0;2,0;;;;3,0;;;;5,0;;;;11,0;12,0;;8,0;;2,0;;;1,0;;;;;22,0;15,0;3,0;37,0;;6,0;;;1,0;;;;;;;4,0;2,0;;;;7,0;;7,0;;;;1,0;;;77,0;;;;;;;22,0;;;;;;;2,0;3,0;8,0;;3,0;2,0;1,0;10,0;;23,0;1,0;1,0;59,0;8,0;;;;;;1,0;;62,0;;;;;17,0;13,0;;;;;;38,0;;26,0;4,0;;;;;;;3,0;15,0;;;14,0;14,0;4,0;;;;4,0;;2,0;9,0;;6,0;23,0;;;2,0;;;;87,0;1,0;;219,0;7,0;14,0;3,0;;;4,0;;13,0;;4,0;;;;;10,0;6,0;44,0;2,0;5,0;;12,0;;;;2,0;;;;11,0;;;;4,0;1,0;;;2,0;15,0;37,0;102,0;29,0;7,0;;22,0;;;129,0;52,0;;;;;;28,0;9,0;;;;2,0;3,0;;;11,0;9,0;;;12,0;19,0;14,0;;3,0;1,0;7,0;;;15,0;18,0;;;;;1,0;;;1,0;11,0;4,0;;;24,0;;7,0;14,0;;;12,0;10,0;1,0;;6,0;;5,0;17,0;7,0;3,0;4,0;4,0;18,0;;5,0;;1,0;22,0;;1,0;;;;1,0;;1,0;2,0;;9,0;2,0;2,0;2,0;2,0;;;7,0;;;1,0;;15,0;10,0;18,0;;3,0;1,0;2,0;;;22,0;2,0;;18,0;4,0;;4,0;;;;;;;;;;3,0;5,0;;2,0;;;;;;;;;;;;;;;;;;;;;3,0;;;;;;;;4,0;;;5,0;;1,0;;8,0;5,0;8,0;;2,0;4,0;2,0;6,0;;;;;;;;;20,0;;5,0;;21,0;;;;;;;1,0;;2,0;;;;;;;;;4,0;;;;;;5,0;22,0;3,0;;;1,0;;;;;;;;;;;;;;;;4,0;;;;;;;;3,0;1,0;;;1,0;;1,0;;;;3,0;;2,0;5,0;;;;;7,0;;1,0;;2,0;3,0;;;;;;;15,0;;1,0;;;;6,0;;10,0;;;;;;;;;;;;16,0;99,0;12,0;;;;;1,0;;;;5,0;;;;;;;;;;;;;;;;;6,0;;;;;;;;;;;;;;31,0;1,0;;2,0;;1,0;;;;1,0;;1,0;2,0;;;;;;;;;;;;;;;;;1,0;;;;;;;;;;1,0;;;;;;;;;;;;;;;;;;;8,0;;;;;;6,0;;;;1,0;1,0;;;;;;3,0;;;;;12,0;3,0;;;;;;;;;2,0;;;;;;;2,0;3,0;;;;;;;;;;;;;3,0;;;4,0;;;25,0;;;;13,0;2,0;6,0;;;;;;24,0;;16,0;6,0;;;;;;10,0;;;;;2,0;;;;;;;;4,0;;;;;;;3,0;;14,0;;2,0;;;;;;;1,0;3,0;;1,0;;;;;;;;;;;;;;2,0;2,0;18,0;;3,0;;;;2,0;;;4,0;;;;;;;3,0;;;;;;;;;6,0;;;;;;;;;;;;;;;;;;;;;;;;;;;;;;;;;;;;;;;;;;;;;;;;;;18,0;;;2,0;6,0;;;;;;;;;;;;;;;;;;;;;;;;;;;;;;;;;;;;;;;21,0;1,0;;;;;;;;;;;;;;;;;7,0;1,0;2,0;;;;;;;;15,0;;;;;;;;1,0;;;16,0;;14,0;;;;;;;;;;2,0;;;;;;;;;;;;;;;;;6,0;;;;;;;;;;;;3,0;;;;;;;;1,0;;;;;;;;;;;;;;;;;;;;;;;;;;;1,0;;;;
range;;7,0;1,0;52,0;30,0;96,0;47,0;49,0;2,0;4,0;1,0;10,0;10,0;212,0;15,0;75,0;261,0;5,0;3,0;12,0;;12,0;59,0;5,0;56,0;3,0;7,0;15,0;12,0;70,0;110,0;52,0;28,0;120,0;;103,0;75,0;178,0;306,0;7,0;314,0;223,0;17,0;31,0;99,0;19,0;;53,0;2,0;38,0;43,0;;31,0;1,0;118,0;112,0;33,0;2,0;98,0;63,0;6,0;4,0;34,0;1,0;942,0;1,0;219,0;23,0;15,0;;78,0;322,0;369,0;;48,0;3,0;7,0;22,0;9,0;14,0;265,0;;53,0;3,0;94,0;114,0;1,0;132,0;2,0;2,0;24,0;3,0;36,0;;47,0;2,0;176,0;12,0;124,0;52,0;183,0;328,0;3,0;13,0;29,0;50,0;4,0;8,0;15,0;;2,0;52,0;94,0;11,0;1,0;6,0;50,0;57,0;78,0;199,0;11,0;1,0;134,0;61,0;84,0;36,0;230,0;14,0;3,0;20,0;137,0;52,0;;147,0;8,0;2,0;101,0;16,0;57,0;2,0;;3,0;4,0;23,0;42,0;25,0;38,0;33,0;125,0;3,0;2,0;29,0;28,0;;13,0;4,0;2,0;1,0;14,0;16,0;1,0;9,0;7,0;12,0;7,0;;7,0;24,0;12,0;37,0;47,0;7,0;8,0;142,0;2,0;4,0;;10,0;16,0;4,0;9,0;3,0;;9,0;19,0;11,0;64,0;5,0;86,0;6,0;;;1,0;3,0;9,0;18,0;27,0;39,0;;;2,0;23,0;119,0;3,0;39,0;24,0;30,0;5,0;9,0;24,0;57,0;58,0;17,0;;1,0;2,0;48,0;1,0;8,0;22,0;20,0;10,0;1,0;6,0;3,0;;183,0;;2,0;15,0;;34,0;;65,0;2,0;5,0;29,0;3,0;1,0;35,0;1,0;4,0;9,0;;;70,0;9,0;19,0;29,0;1,0;1,0;;;41,0;4,0;4,0;41,0;36,0;1,0;;5,0;26,0;3,0;41,0;3,0;8,0;3,0;482,0;12,0;47,0;;;10,0;15,0;1,0;;12,0;179,0;4,0;10,0;;27,0;77,0;3,0;4,0;;2,0;10,0;16,0;1,0;4,0;14,0;2,0;1,0;5,0;;290,0;2,0;13,0;;1,0;;;4,0;1,0;;2,0;43,0;16,0;156,0;;;6,0;;31,0;1,0;42,0;10,0;8,0;4,0;15,0;90,0;5,0;41,0;;;7,0;;18,0;;4,0;;;;54,0;;2,0;;56,0;;21,0;47,0;19,0;20,0;4,0;;3,0;26,0;;1,0;1,0;;3,0;1,0;9,0;3,0;;30,0;32,0;8,0;7,0;;;1,0;;25,0;3,0;122,0;1,0;17,0;6,0;;47,0;21,0;95,0;15,0;8,0;4,0;16,0;20,0;130,0;27,0;8,0;7,0;57,0;67,0;4,0;93,0;337,0;2,0;15,0;12,0;11,0;116,0;2,0;15,0;8,0;26,0;36,0;1,0;1,0;31,0;5,0;110,0;22,0;35,0;4,0;52,0;172,0;27,0;4,0;47,0;31,0;22,0;27,0;56,0;2,0;11,0;;3,0;3,0;72,0;8,0;7,0;1,0;43,0;6,0;32,0;8,0;11,0;4,0;;85,0;4,0;26,0;;17,0;30,0;5,0;2,0;42,0;46,0;48,0;85,0;5,0;19,0;12,0;4,0;130,0;1,0;12,0;11,0;8,0;35,0;5,0;1,0;6,0;40,0;1,0;11,0;17,0;16,0;1,0;12,0;5,0;12,0;3,0;1,0;9,0;4,0;8,0;2,0;5,0;15,0;;2,0;21,0;4,0;;2,0;5,0;1,0;1,0;24,0;11,0;2,0;47,0;;15,0;7,0;2,0;;5,0;1,0;10,0;1,0;13,0;1,0;1,0;3,0;7,0;2,0;;1,0;10,0;26,0;3,0;1,0;;9,0;5,0;5,0;2,0;;3,0;7,0;;14,0;1,0;;4,0;5,0;;;7,0;3,0;3,0;2,0;;1,0;;;2,0;9,0;53,0;;26,0;4,0;1,0;16,0;23,0;19,0;4,0;5,0;1,0;3,0;;;;6,0;;2,0;11,0;1,0;;8,0;;;;;12,0;2,0;3,0;7,0;14,0;;65,0;;;80,0;;2,0;2,0;1,0;6,0;5,0;2,0;12,0;;4,0;1,0;;22,0;4,0;1,0;;;6,0;23,0;14,0;9,0;2,0;22,0;4,0;3,0;1,0;2,0;37,0;1,0;;13,0;;;30,0;1,0;;2,0;5,0;4,0;4,0;3,0;1,0;;2,0;1,0;;13,0;;3,0;3,0;;;33,0;25,0;;;4,0;;1,0;;;2,0;4,0;2,0;6,0;4,0;;16,0;2,0;13,0;2,0;1,0;1,0;1,0;;15,0;;;;;;1,0;7,0;4,0;5,0;3,0;6,0;5,0;12,0;5,0;;3,0;1,0;1,0;2,0;2,0;2,0;;;2,0;50,0;2,0;;2,0;2,0;28,0;4,0;6,0;122,0;8,0;;;1,0;16,0;1,0;3,0;3,0;;2,0;;19,0;4,0;;2,0;5,0;6,0;;21,0;3,0;;1,0;;7,0;8,0;15,0;;2,0;1,0;;19,0;17,0;2,0;3,0;3,0;1,0;29,0;;3,0;18,0;38,0;2,0;7,0;;2,0;;7,0;12,0;;5,0;2,0;;;3,0;14,0;29,0;;;3,0;26,0;;21,0;6,0;2,0;10,0;;57,0;;50,0;3,0;12,0;;1,0;;;;1,0;;8,0;;1,0;;5,0;1,0;;;;1,0;;;;56,0;;21,0;3,0;1,0;;2,0;;26,0;;;;1,0;1,0;10,0;13,0;;37,0;;2,0;;2,0;22,0;1,0;;;6,0;1,0;1,0;;;;;77,0;;18,0;;4,0;12,0;3,0;;53,0;7,0;;4,0;63,0;7,0;9,0;;;4,0;14,0;2,0;2,0;80,0;8,0;;20,0;20,0;;23,0;;16,0;;36,0;1,0;4,0;4,0;1,0;12,0;15,0;5,0;3,0;19,0;2,0;20,0;7,0;1,0;2,0;1,0;15,0;6,0;11,0;;;;1,0;4,0;5,0;2,0;2,0;15,0;1,0;1,0;10,0;;4,0;12,0;2,0;23,0;1,0;2,0;2,0;34,0;22,0;;;6,0;;5,0;;1,0;;2,0;;1,0;1,0;;12,0;1,0;1,0;;6,0;;;1,0;;;6,0;3,0;;;;2,0;1,0;9,0;2,0;;3,0;6,0;1,0;1,0;;2,0;1,0;;3,0;;22,0;;;4,0;2,0;;;2,0;42,0;13,0;9,0;24,0;;2,0;;7,0;1,0;3,0;;;;3,0;;;116,0;;1,0;12,0;;17,0;;;;2,0;;;1,0;6,0;;;;31,0;;;13,0;1,0;;1,0;;;4,0;5,0;;6,0;;9,0;2,0;;10,0;;;;1,0;;24,0;;2,0;;3,0;2,0;21,0;;1,0;;;8,0;;1,0;;;;
rear;;4,0;;4,0;;16,0;9,0;102,0;;;5,0;;4,0;45,0;;;98,0;4,0;3,0;;;;4,0;;8,0;;;36,0;10,0;12,0;106,0;6,0;;;;22,0;23,0;5,0;;2,0;6,0;103,0;7,0;16,0;98,0;99,0;;113,0;;;2,0;;85,0;6,0;13,0;8,0;53,0;1,0;;6,0;18,0;;80,0;;175,0;;175,0;4,0;;7,0;8,0;363,0;14,0;1,0;;;17,0;3,0;;;72,0;;6,0;;125,0;7,0;3,0;49,0;;4,0;;11,0;11,0;10,0;9,0;;3,0;6,0;46,0;19,0;96,0;28,0;;45,0;1,0;7,0;2,0;3,0;1,0;;;2,0;31,0;6,0;4,0;;;2,0;4,0;50,0;;;20,0;2,0;;1,0;150,0;;;11,0;7,0;;;86,0;2,0;13,0;177,0;;;2,0;5,0;21,0;;;34,0;3,0;58,0;43,0;12,0;83,0;5,0;21,0;105,0;28,0;1,0;;5,0;20,0;;2,0;51,0;48,0;;;;;87,0;94,0;1,0;7,0;1,0;;32,0;29,0;7,0;28,0;4,0;2,0;2,0;;;59,0;4,0;164,0;41,0;;16,0;2,0;19,0;686,0;;;19,0;13,0;7,0;23,0;953,0;;39,0;10,0;;46,0;1,0;;;2,0;275,0;5,0;41,0;127,0;4,0;7,0;;;1,0;44,0;10,0;6,0;1,0;3,0;5,0;;;;31,0;4,0;704,0;1,0;3,0;4,0;25,0;;2,0;2,0;;;4,0;;4,0;5,0;;29,0;5,0;8,0;18,0;8,0;7,0;49,0;330,0;;5,0;;;36,0;9,0;;34,0;418,0;3,0;;7,0;4,0;3,0;377,0;101,0;;;;4,0;32,0;6,0;14,0;5,0;1,0;;1,0;5,0;28,0;7,0;1,0;53,0;1,0;18,0;75,0;;3,0;15,0;27,0;51,0;10,0;8,0;1,0;1,0;4,0;5,0;9,0;38,0;11,0;3,0;18,0;11,0;8,0;2,0;1,0;;2,0;11,0;10,0;2,0;34,0;11,0;3,0;13,0;;61,0;;55,0;1,0;8,0;3,0;22,0;21,0;21,0;22,0;30,0;3,0;;;20,0;37,0;23,0;;2,0;19,0;4,0;;;;3,0;1,0;20,0;6,0;5,0;10,0;46,0;27,0;18,0;28,0;1,0;1,0;;68,0;;;4,0;14,0;1,0;11,0;69,0;4,0;2,0;;;;;;4,0;;;1,0;3,0;1,0;;21,0;3,0;;;;;;22,0;;;2,0;1,0;10,0;;4,0;;2,0;;;;12,0;58,0;1,0;1,0;4,0;;;;;10,0;2,0;;3,0;3,0;4,0;1,0;11,0;;3,0;3,0;4,0;1,0;7,0;;;;;;;;;;34,0;1,0;5,0;;;14,0;;;4,0;1,0;1,0;7,0;3,0;6,0;;;23,0;;4,0;;2,0;;;24,0;1,0;;;9,0;4,0;;1,0;;;4,0;1,0;2,0;;;;;;;3,0;;;;1,0;;15,0;34,0;4,0;1,0;;;;24,0;;7,0;4,0;3,0;;1,0;16,0;7,0;;;;;3,0;;1,0;22,0;2,0;;;;;13,0;9,0;;8,0;14,0;;;;2,0;;2,0;;;9,0;2,0;10,0;6,0;1,0;19,0;246,0;3,0;13,0;;;9,0;;;;6,0;;5,0;9,0;8,0;3,0;1,0;;7,0;2,0;;;2,0;55,0;1,0;;;;3,0;2,0;13,0;;;;;1,0;;12,0;8,0;;3,0;1,0;2,0;1,0;;;2,0;1,0;4,0;1,0;;14,0;;6,0;30,0;14,0;1,0;1,0;24,0;1,0;2,0;;3,0;8,0;;3,0;;;;1,0;2,0;1,0;;;7,0;;;;4,0;;;;;15,0;;;;3,0;1,0;2,0;;;;6,0;;;;;;15,0;;;;3,0;;;1,0;;;1,0;8,0;;3,0;;;;8,0;1,0;17,0;;2,0;1,0;4,0;3,0;5,0;;;;;5,0;;;;;;3,0;;;;;;;;;24,0;;;1,0;6,0;4,0;5,0;;;1,0;;10,0;;;10,0;;;;1,0;1,0;;1,0;;;6,0;;1,0;21,0;;;;33,0;2,0;11,0;;1,0;;;1,0;;4,0;2,0;3,0;7,0;1,0;;;4,0;2,0;;5,0;3,0;;13,0;;5,0;3,0;1,0;6,0;;;11,0;8,0;;;;5,0;;1,0;1,0;23,0;;;7,0;;;;;1,0;3,0;;3,0;;8,0;;;4,0;;11,0;1,0;5,0;1,0;7,0;5,0;6,0;;15,0;7,0;3,0;2,0;14,0;3,0;5,0;1,0;;;3,0;;7,0;1,0;4,0;;;11,0;1,0;;6,0;;;;37,0;;1,0;5,0;;;;1,0;;;;;;2,0;;;1,0;2,0;21,0;;;;;1,0;2,0;;;;;;2,0;;;;2,0;;;2,0;9,0;;;5,0;6,0;;;;4,0;;;1,0;;;2,0;2,0;4,0;;;62,0;7,0;;;2,0;;2,0;;;2,0;;4,0;;;;;;;;;;;;;;;;1,0;;;3,0;1,0;;2,0;;;;;2,0;43,0;;;;5,0;;1,0;;;4,0;;2,0;;1,0;;;;2,0;;;2,0;;;;;;;;29,0;;;;;3,0;;;;;1,0;;1,0;5,0;;;;1,0;;;;2,0;;3,0;1,0;9,0;;2,0;;;;5,0;;;;6,0;;;;2,0;6,0;;;2,0;;6,0;;1,0;;;;;43,0;;;;1,0;1,0;;2,0;1,0;14,0;6,0;;12,0;;;;;;;;2,0;;;;;;;;;2,0;;2,0;;;;;;;;
rearview;;5,0;;;;8,0;1,0;124,0;;;;;;6,0;;8,0;8,0;;;;;;1,0;;2,0;;;;;;8,0;5,0;;;;6,0;;;;1,0;2,0;13,0;;;47,0;11,0;;12,0;;;2,0;;5,0;;4,0;;3,0;;;;;;;1,0;45,0;2,0;18,0;;;;;10,0;2,0;;;;2,0;;;;21,0;;4,0;;13,0;;;2,0;;;;2,0;;;2,0;;2,0;;1,0;;8,0;1,0;;;7,0;1,0;;;;;;;2,0;3,0;;;;1,0;4,0;10,0;2,0;;1,0;;;;122,0;;;;6,0;;;3,0;;1,0;15,0;;;;;11,0;;;3,0;;1,0;;3,0;23,0;;;;;;;;;;;;6,0;;;;;3,0;3,0;;3,0;;;2,0;;;;;;;;;6,0;;7,0;2,0;;;;;4,0;;;2,0;;;;28,0;;;;;;1,0;;;;1,0;;114,0;11,0;;;;;;;2,0;;;;;;;;;;23,0;1,0;;;;;;;5,0;;;2,0;;;;;;;;;;1,0;11,0;;2,0;;;6,0;;;15,0;4,0;;;;;;83,0;;1,0;;;;;7,0;;;1,0;;;;4,0;1,0;;13,0;;;;;;;1,0;;;;;;;;;1,0;3,0;;;1,0;1,0;3,0;;;;;1,0;;1,0;;;;;;;9,0;;;;;4,0;2,0;1,0;1,0;;;;;;;;;;;2,0;;;;;;;;;2,0;3,0;;2,0;;;;;;;7,0;;3,0;;1,0;;;;;3,0;1,0;2,0;1,0;;;;;;;3,0;;;;;2,0;;10,0;;;4,0;;10,0;;;2,0;;;;;;2,0;;;;;;;;3,0;;;1,0;;6,0;;7,0;;1,0;;6,0;;;;;;;;;;;;2,0;;4,0;2,0;;;;;;;;;;8,0;;;;;;;;;;2,0;;;;1,0;;;;;;;2,0;;;;;;;;;;;;;;;54,0;;;;;;;;;;1,0;7,0;;;;;;;;;;2,0;2,0;;;;;2,0;;;;;2,0;;;;;;;;;;1,0;;;;1,0;1,0;;;;;;;;;2,0;;;3,0;;;;;;;;;;;;;;;;;3,0;;;;;;;;;;2,0;;;;;;;;;;;;;;;;1,0;1,0;;;;;;2,0;;;;;;;;;;;;;;8,0;;;;;;3,0;5,0;;;;;;;;;;;;;;;;;;;;;;;;;1,0;1,0;;;;;;1,0;;;;;;;;1,0;;;;;;;;;;;;;;;1,0;;;;;;;;;;;3,0;;2,0;;;;;;;;;;;;;;;;;;3,0;9,0;;;;;;;;;;;;;8,0;2,0;;7,0;;;;;;;;;;14,0;;;;;1,0;;;;;;;;;;;;6,0;;;;;;;;;;;;;;;;;;;;;;;;;;;1,0;;;;;;;;;1,0;;;;;;;;;3,0;;;;;;;;;;;;;;;;;;;;;;;;;;;;;;;;;;;;;;;;;;;;;;;;;;;;;;;;;;;;;;;;;;;4,0;;;;;;;;;;2,0;;;;;1,0;;;;;;;;;;;;;;;;;;;;1,0;;;;;;;;;;1,0;;;;;;;1,0;;;;;;;;;;;;;;;11,0;;;;;;;;;;;;;;;;;;;;;;;;;;5,0;;;;;;;;;3,0;;;;;;;;;;;;;;;;;;;;;;;;;;;;;;;;;;;2,0;;;;;;;;;;;;;;;;
receive;;104,0;;59,0;118,0;288,0;130,0;322,0;1,0;12,0;2,0;45,0;53,0;827,0;6,0;14,0;737,0;6,0;102,0;17,0;47,0;1,0;128,0;41,0;273,0;3,0;3,0;229,0;168,0;39,0;2193,0;271,0;13,0;31,0;4,0;2157,0;111,0;142,0;105,0;13,0;265,0;1833,0;14,0;186,0;405,0;76,0;2,0;758,0;;16,0;11,0;6,0;48,0;95,0;81,0;48,0;164,0;128,0;53,0;174,0;1,0;7,0;35,0;18,0;4142,0;13,0;728,0;3,0;15,0;;27,0;842,0;1747,0;4,0;17,0;3,0;22,0;101,0;39,0;92,0;1109,0;;134,0;45,0;529,0;23,0;12,0;454,0;30,0;22,0;111,0;94,0;58,0;43,0;92,0;5,0;231,0;68,0;786,0;101,0;496,0;68,0;6,0;170,0;302,0;819,0;27,0;163,0;10,0;2,0;;133,0;107,0;5,0;17,0;36,0;32,0;139,0;188,0;943,0;84,0;3,0;1796,0;42,0;31,0;148,0;636,0;;25,0;3,0;287,0;7,0;;847,0;7,0;14,0;194,0;28,0;40,0;;;31,0;10,0;3,0;160,0;25,0;145,0;134,0;219,0;107,0;4,0;61,0;181,0;32,0;25,0;54,0;1,0;2,0;;;26,0;121,0;97,0;97,0;39,0;10,0;150,0;37,0;1,0;87,0;79,0;7,0;81,0;133,0;5,0;32,0;23,0;72,0;15,0;19,0;33,0;22,0;12,0;100,0;111,0;21,0;130,0;14,0;337,0;113,0;;1,0;10,0;31,0;50,0;207,0;267,0;90,0;31,0;24,0;;40,0;1,0;15,0;73,0;61,0;146,0;6,0;52,0;232,0;43,0;134,0;23,0;;9,0;30,0;338,0;34,0;3,0;29,0;67,0;75,0;11,0;77,0;54,0;5,0;1079,0;5,0;20,0;21,0;21,0;103,0;43,0;17,0;34,0;18,0;216,0;24,0;18,0;59,0;1,0;26,0;7,0;4,0;19,0;106,0;30,0;89,0;135,0;19,0;111,0;3,0;2,0;295,0;46,0;54,0;179,0;400,0;23,0;;55,0;337,0;28,0;374,0;47,0;7,0;25,0;44,0;11,0;49,0;18,0;123,0;29,0;131,0;30,0;;43,0;109,0;11,0;10,0;26,0;16,0;69,0;76,0;1,0;6,0;27,0;98,0;263,0;5,0;85,0;68,0;3,0;82,0;25,0;2,0;63,0;67,0;8,0;23,0;25,0;5,0;5,0;33,0;6,0;65,0;18,0;68,0;16,0;328,0;2,0;3,0;28,0;30,0;19,0;9,0;63,0;38,0;10,0;42,0;185,0;247,0;31,0;16,0;27,0;2,0;30,0;39,0;225,0;28,0;76,0;2,0;20,0;115,0;107,0;20,0;7,0;2,0;1,0;1,0;73,0;47,0;8,0;66,0;14,0;91,0;62,0;105,0;2,0;24,0;1,0;19,0;18,0;4,0;32,0;39,0;30,0;26,0;1069,0;184,0;13,0;2,0;11,0;29,0;40,0;39,0;38,0;15,0;4,0;20,0;13,0;1,0;30,0;22,0;76,0;11,0;20,0;288,0;64,0;30,0;772,0;53,0;10,0;26,0;22,0;163,0;9,0;19,0;3,0;89,0;10,0;114,0;15,0;87,0;25,0;40,0;4,0;116,0;136,0;30,0;23,0;1008,0;15,0;37,0;16,0;245,0;23,0;75,0;179,0;50,0;14,0;49,0;;63,0;256,0;84,0;4,0;1,0;4,0;8,0;3,0;38,0;15,0;39,0;11,0;;195,0;489,0;75,0;9,0;124,0;51,0;111,0;41,0;36,0;28,0;82,0;79,0;74,0;43,0;49,0;205,0;60,0;29,0;14,0;17,0;16,0;36,0;738,0;11,0;30,0;116,0;41,0;7,0;33,0;42,0;5,0;63,0;32,0;16,0;185,0;2,0;24,0;15,0;25,0;60,0;11,0;21,0;28,0;4,0;199,0;70,0;359,0;375,0;27,0;33,0;25,0;26,0;46,0;22,0;19,0;1,0;85,0;64,0;88,0;21,0;220,0;42,0;59,0;20,0;11,0;7,0;22,0;16,0;256,0;10,0;77,0;20,0;13,0;7,0;28,0;276,0;18,0;128,0;15,0;14,0;11,0;41,0;1,0;10,0;166,0;7,0;25,0;28,0;3,0;74,0;1,0;16,0;23,0;6,0;63,0;106,0;11,0;;2,0;5,0;12,0;14,0;20,0;;18,0;28,0;4,0;71,0;10,0;24,0;20,0;14,0;12,0;26,0;40,0;7,0;22,0;181,0;17,0;58,0;1,0;6,0;58,0;31,0;7,0;25,0;10,0;34,0;388,0;180,0;1,0;37,0;5,0;4,0;8,0;97,0;32,0;10,0;54,0;10,0;55,0;49,0;56,0;32,0;3,0;;18,0;9,0;38,0;24,0;13,0;26,0;4,0;82,0;5,0;3,0;121,0;142,0;8,0;91,0;16,0;80,0;53,0;34,0;41,0;15,0;8,0;15,0;6,0;102,0;27,0;31,0;73,0;21,0;12,0;48,0;2,0;76,0;40,0;59,0;;34,0;6,0;93,0;7,0;16,0;10,0;12,0;55,0;;24,0;47,0;40,0;22,0;23,0;9,0;42,0;53,0;37,0;1,0;5,0;;6,0;63,0;17,0;5,0;10,0;200,0;14,0;36,0;5,0;12,0;11,0;14,0;20,0;34,0;8,0;13,0;36,0;63,0;10,0;11,0;5,0;11,0;12,0;5,0;32,0;2,0;7,0;1,0;12,0;9,0;22,0;9,0;19,0;60,0;143,0;6,0;35,0;;10,0;22,0;7,0;47,0;166,0;64,0;10,0;45,0;;21,0;15,0;5,0;111,0;4,0;4,0;11,0;54,0;99,0;24,0;72,0;3,0;;14,0;11,0;;35,0;93,0;14,0;29,0;56,0;14,0;10,0;12,0;7,0;3,0;7,0;15,0;39,0;110,0;17,0;13,0;5,0;27,0;9,0;2,0;9,0;14,0;13,0;19,0;60,0;22,0;14,0;23,0;7,0;85,0;6,0;5,0;49,0;9,0;19,0;7,0;7,0;9,0;2,0;2,0;39,0;6,0;7,0;45,0;5,0;3,0;41,0;10,0;6,0;27,0;27,0;;33,0;8,0;5,0;19,0;55,0;2,0;5,0;2,0;1,0;3,0;49,0;6,0;5,0;7,0;8,0;16,0;12,0;5,0;14,0;2,0;11,0;13,0;3,0;;11,0;15,0;20,0;17,0;29,0;45,0;1,0;;;7,0;2,0;16,0;22,0;2,0;30,0;4,0;9,0;26,0;2,0;11,0;4,0;4,0;;5,0;5,0;11,0;13,0;44,0;5,0;58,0;26,0;42,0;2,0;5,0;;8,0;21,0;5,0;1,0;;1,0;14,0;2,0;2,0;1,0;8,0;7,0;22,0;24,0;17,0;2,0;5,0;7,0;;10,0;22,0;14,0;9,0;4,0;;8,0;12,0;7,0;8,0;154,0;7,0;;3,0;5,0;31,0;15,0;;;3,0;6,0;8,0;3,0;3,0;13,0;6,0;7,0;7,0;4,0;6,0;3,0;3,0;5,0;16,0;19,0;51,0;4,0;5,0;13,0;2,0;40,0;9,0;17,0;4,0;24,0;7,0;30,0;23,0;70,0;2,0;4,0;3,0;26,0;12,0;3,0;;7,0;2,0;3,0;16,0;1,0;16,0;6,0;1,0;;7,0;6,0;2,0;1,0;24,0;7,0;4,0;5,0;2,0;9,0;9,0;39,0;35,0;3,0;22,0;1,0;2,0;4,0;16,0;16,0;18,0;3,0;5,0;8,0;11,0;15,0;10,0;1,0;1,0;;6,0;1,0;49,0;6,0;15,0;;11,0;;22,0;8,0;5,0;13,0;29,0;;;3,0;1,0;23,0;1,0;;;;2,0;4,0;11,0;48,0;;6,0;;3,0;2,0;;;;21,0;;;4,0;7,0;2,0;1,0;1,0;2,0;5,0;40,0;34,0;;22,0;6,0;1,0;;1,0;;8,0;24,0;8,0;3,0;12,0;12,0;;2,0;6,0;9,0;19,0;7,0;;;9,0;6,0;4,0;27,0;;;4,0;3,0;4,0;;5,0;26,0;12,0;9,0;;;15,0
receiver;;6,0;;4,0;6,0;36,0;17,0;5,0;;;;3,0;;17,0;;;26,0;;24,0;;;;28,0;8,0;38,0;2,0;;8,0;4,0;7,0;153,0;23,0;2,0;2,0;;81,0;1,0;;1,0;;26,0;78,0;1,0;17,0;19,0;5,0;;8,0;;;;;4,0;3,0;9,0;4,0;2,0;;30,0;27,0;;;4,0;;69,0;;69,0;;;;2,0;60,0;210,0;;;;;1,0;;3,0;27,0;1,0;2,0;;10,0;;1,0;21,0;4,0;1,0;;;3,0;;6,0;3,0;15,0;2,0;63,0;7,0;62,0;3,0;;;10,0;45,0;;;;;;5,0;5,0;;1,0;;;25,0;1,0;20,0;5,0;;131,0;;2,0;9,0;95,0;;;;67,0;;;25,0;;;6,0;1,0;;;;1,0;;1,0;4,0;;1,0;29,0;2,0;5,0;;;13,0;1,0;;;;;;;;33,0;;;;;49,0;3,0;;9,0;16,0;;3,0;7,0;;;1,0;5,0;6,0;;3,0;;6,0;2,0;1,0;;10,0;;10,0;3,0;;;;;1,0;;18,0;1,0;1,0;;;;;3,0;14,0;2,0;8,0;3,0;3,0;26,0;;;3,0;;4,0;;12,0;1,0;;;1,0;1,0;;36,0;6,0;;15,0;;;7,0;;7,0;10,0;1,0;;;10,0;1,0;;;;;;;;14,0;3,0;;2,0;;2,0;;;17,0;;4,0;10,0;;3,0;2,0;1,0;35,0;1,0;36,0;;8,0;1,0;5,0;;5,0;;10,0;;16,0;3,0;;1,0;7,0;;;2,0;;2,0;2,0;;;1,0;1,0;12,0;;17,0;;;;;4,0;16,0;2,0;;3,0;;;2,0;;;;;;;1,0;;;2,0;;;;15,0;;5,0;1,0;6,0;11,0;3,0;;2,0;;4,0;;42,0;;;4,0;2,0;;9,0;;;;;;1,0;5,0;;;;8,0;;1,0;;;;4,0;1,0;;2,0;5,0;;;68,0;71,0;;;2,0;;;2,0;3,0;;;;;;2,0;;1,0;;1,0;7,0;5,0;6,0;20,0;10,0;3,0;3,0;;11,0;;2,0;;2,0;1,0;5,0;1,0;1,0;6,0;3,0;1,0;11,0;6,0;;;10,0;5,0;;;20,0;;9,0;2,0;;1,0;1,0;2,0;9,0;8,0;1,0;;;;;;1,0;;;;256,0;8,0;8,0;;;5,0;;1,0;;2,0;2,0;10,0;;2,0;19,0;1,0;;16,0;;;;;;6,0;;;1,0;1,0;1,0;11,0;4,0;;;;;3,0;;;4,0;;6,0;;;5,0;;;;3,0;14,0;;;;43,0;1,0;;;;;2,0;9,0;;2,0;2,0;1,0;;2,0;;;1,0;;1,0;;;;;2,0;5,0;;;6,0;1,0;3,0;2,0;;;8,0;;;;;11,0;;;;;;11,0;;;;1,0;6,0;;;;;;;;1,0;;6,0;;;;;;;2,0;;;;;;;;;;;7,0;;;1,0;;;;3,0;;1,0;2,0;;;;1,0;;;;;;7,0;1,0;;;;22,0;;1,0;8,0;1,0;;;;;1,0;1,0;6,0;;1,0;;;;;;;;;;;1,0;1,0;;;2,0;;;;5,0;;;;;;;;;1,0;;3,0;1,0;;1,0;;;;;;;10,0;7,0;;17,0;;;;;5,0;;;;;2,0;;;;8,0;;;5,0;;;;;;1,0;;;7,0;3,0;;;;2,0;;4,0;;20,0;20,0;;;;2,0;;;1,0;;1,0;;4,0;16,0;81,0;20,0;1,0;;1,0;;;;7,0;;;;;;;1,0;;;1,0;14,0;;3,0;;;;;;;2,0;4,0;;1,0;;8,0;2,0;4,0;5,0;;;;;;;;;3,0;;7,0;;;1,0;;;;3,0;;4,0;;;9,0;;;;3,0;;1,0;;;3,0;1,0;;;;;;;;;;;;1,0;;;;;;;;;;;;;2,0;;;8,0;;;;;;;;;;;;;3,0;;;;;;;;;3,0;;;;;4,0;;;;;;;;;;1,0;;;;6,0;;5,0;;;;1,0;;1,0;;;;;;;;;;3,0;;1,0;;;;;1,0;;;;;;;3,0;;4,0;;4,0;1,0;;1,0;;;1,0;9,0;;;;68,0;;;;1,0;;;;1,0;;;;;4,0;;;;3,0;;;;7,0;3,0;;;1,0;1,0;;;;;3,0;;;;;;;;;;28,0;3,0;1,0;;;;;;2,0;;10,0;;;;4,0;1,0;;2,0;6,0;;;;;;2,0;;;;;;;5,0;;;;;;;;;;;;;1,0;;;;;;;4,0;;;;;;;;;1,0;;1,0;20,0;;;;;;1,0;;;;6,0;;;;;;;1,0;;;;;;;;;14,0
receptacle;;2,0;;;;6,0;;13,0;;;;7,0;;24,0;;;;;1,0;;;;;;4,0;;;1,0;;;37,0;1,0;;;;4,0;14,0;1,0;;;3,0;55,0;2,0;5,0;3,0;30,0;;4,0;;;;;10,0;3,0;2,0;;11,0;;;1,0;;;;;21,0;;46,0;;;;;6,0;7,0;;;;3,0;;;21,0;9,0;;;;19,0;;;4,0;;;;2,0;3,0;2,0;;;;8,0;22,0;2,0;6,0;;;1,0;2,0;;;;;;;;;;;;;2,0;;3,0;2,0;;6,0;3,0;;;5,0;;2,0;;;1,0;;;;;3,0;1,0;;;;;;;;;;4,0;;1,0;;;13,0;;;;1,0;;;;1,0;6,0;;;;;14,0;;;2,0;;;;;;;;;6,0;;;;2,0;1,0;6,0;;;;13,0;1,0;;1,0;;8,0;;;6,0;;;1,0;;7,0;;2,0;;;39,0;;;15,0;;;;;3,0;7,0;4,0;2,0;;;;;;;;3,0;17,0;;;1,0;;;2,0;;;;;;;;;1,0;;;5,0;;2,0;5,0;11,0;;1,0;;;;;1,0;28,0;35,0;;;;6,0;;;1,0;;;;3,0;;;;1,0;4,0;10,0;;2,0;2,0;;9,0;4,0;;2,0;2,0;;;3,0;10,0;5,0;;1,0;;;;;4,0;2,0;;7,0;4,0;1,0;;;;;;;9,0;1,0;;;;;9,0;;;1,0;;;7,0;3,0;14,0;3,0;1,0;;;;;23,0;;4,0;;;;2,0;;5,0;;;1,0;;;1,0;6,0;;7,0;;3,0;;;;;;;;;3,0;2,0;3,0;;;;;3,0;;;;2,0;;;;;;2,0;;;;;;;3,0;;;;;7,0;;;;;;;;;;;;;;;;;;;1,0;2,0;;;;;;;;2,0;;7,0;;;;;;5,0;;;;25,0;;;;;;;;;;;;;;;;2,0;;;;;;;;;;2,0;2,0;;;4,0;;2,0;1,0;1,0;;1,0;;;;;;;;;;;;5,0;5,0;1,0;;;;;1,0;;;;1,0;;2,0;2,0;;;;;1,0;;;;;;2,0;;4,0;;5,0;;;;;;1,0;;;2,0;1,0;;1,0;;;3,0;;;2,0;22,0;1,0;;;;4,0;6,0;;;;;;3,0;1,0;;;;2,0;;;;14,0;25,0;;;;;4,0;;;;;;;;;;1,0;;;;;;;;;;;;;2,0;;;;1,0;;;8,0;;;;;;1,0;;10,0;;;;;;;;1,0;;;4,0;;;;;;10,0;;;;9,0;;;3,0;;;;;;;;;;;;;;;;;;;;1,0;;;;;;;;;;;;;;;;;;;2,0;;;;;2,0;;;;;;;;;;1,0;;;;1,0;;;;;;;;;;1,0;;;;;;;;;;6,0;;;2,0;;;;11,0;;20,0;;2,0;;;;;;;2,0;8,0;;;;;;;;;;3,0;;;;;;;;7,0;4,0;;;;;;;;1,0;;;12,0;;3,0;5,0;;;13,0;8,0;;;;;;;;;;;15,0;6,0;;;2,0;5,0;;4,0;;1,0;;;;;;;1,0;;;;;;;1,0;1,0;;;;;;;;1,0;;;;;;;;;2,0;;;;;;;;;;;;;;2,0;;;;;;;;;;;;;;1,0;;;;;;;;;;;;;;;;;;;;;;;;;;;;;;;;;;;;;;;;;;;10,0;;;;;;;;;;;;;5,0;;;;;;;;;;;4,0;;;;;;;1,0;;1,0;;;;;;;;;;;;;;;;;;;;2,0;;;3,0;;;;;;;;1,0;;2,0;;;;;;;;;;;;;;;;;;;;;;;;;;;4,0;;;;;;;;;;;;;;;;;;;;;;;;;;;;;;;;;;;;;;;
reception;;1,0;;3,0;1,0;1,0;;;;;;1,0;;6,0;;;11,0;1,0;2,0;1,0;;;;;25,0;;;;2,0;;15,0;16,0;;1,0;;35,0;2,0;;;;2,0;17,0;3,0;;5,0;;;7,0;;;;;;3,0;3,0;11,0;12,0;;2,0;;;;;;40,0;;7,0;;;;2,0;9,0;37,0;1,0;;;;1,0;;;4,0;;23,0;;13,0;1,0;;17,0;10,0;1,0;2,0;;1,0;;3,0;;20,0;3,0;9,0;6,0;27,0;12,0;;;;2,0;1,0;1,0;;;;13,0;1,0;;;;;;;18,0;;;73,0;;1,0;3,0;7,0;;;;15,0;;;49,0;;;2,0;;;;;;;;;1,0;4,0;1,0;;;;;8,0;;4,0;;;2,0;;;;3,0;;1,0;;;1,0;1,0;;5,0;;;1,0;;;;9,0;;4,0;;;;;2,0;;;;1,0;12,0;1,0;;;4,0;;2,0;5,0;2,0;;3,0;1,0;;;;;1,0;;1,0;;;8,0;3,0;2,0;;;;1,0;4,0;;;2,0;;11,0;;;;;15,0;;;;;;;;;;;;;;;;;;;;;;6,0;;;;;;1,0;;1,0;12,0;;;;6,0;;6,0;;;;;;3,0;;;;;;;;2,0;;;;;5,0;;;;;8,0;15,0;;13,0;;;;;;1,0;;;;;;;;;10,0;;;;11,0;;1,0;;;;;;;;;;9,0;;2,0;;2,0;;;2,0;;;;;;9,0;;;;;;;;;;;;;1,0;;;;;;;;;4,0;3,0;18,0;14,0;8,0;;;;2,0;;;;;;;;1,0;2,0;1,0;;;4,0;1,0;;8,0;;1,0;;;7,0;;;;1,0;;3,0;;;;;;1,0;10,0;;;4,0;;;;;;;;;;;;2,0;12,0;1,0;;;;;;;;;;39,0;;38,0;3,0;;;;3,0;;;;3,0;;5,0;2,0;;1,0;;;;;;;21,0;;;;1,0;2,0;;;1,0;;;3,0;;;;;;;;;;;;;;9,0;;;;;;;12,0;;;;;;2,0;;;;;;;;7,0;;;;;;;6,0;;4,0;;;;2,0;;;;;;;;;;;;;2,0;;;1,0;;;;;;;;;;;;;;;;;;;;1,0;;19,0;;;;;;;;;28,0;;;;;;;12,0;;;;;3,0;;;1,0;;;;;;;;;;2,0;;;;;;;;;2,0;;;;;;;;;;;;3,0;;;;3,0;;;4,0;;;1,0;;;;;;;1,0;;;;1,0;;;1,0;;;;;3,0;;1,0;;;;;;;;;;1,0;1,0;;;;1,0;;;;;;;;;;;;;;;;1,0;;;;;;;;;;;;;;;;;;;;;26,0;;;1,0;;3,0;;1,0;;2,0;3,0;;1,0;1,0;;;;;;3,0;1,0;2,0;;;;;;;;;1,0;;10,0;1,0;;1,0;;;;;2,0;;;;;;;;;;;;;;;;;;;;;;;;1,0;;;;;;;;1,0;;;;;;;;;;;;;;;1,0;;;;;;;;;;;;;;;;;;;;;;1,0;;;;2,0;;2,0;;;;;;;;;;;;;;;;;;;;;;;;;;;;;;;;;;;;;;;;;;;;;;;;;;;;;;;;;;;;;;;;;;;;;;;3,0;;;;;;;;;;;;1,0;;;;;;;;;;;;;;;;;;;1,0;;;;;;;;;4,0;;;4,0;;;;;;;;;;;;;;;;;;;;;;;;;;;;;;;;;;;;;;;2,0;;;;;;;;;;;;;;;;;;;;;;;;;;;;;;;;;;;;;;;;;;;;;;;;
recess;;2,0;;2,0;;22,0;;70,0;;;2,0;;9,0;82,0;;;6,0;;44,0;;10,0;;1,0;31,0;1,0;;;7,0;;;82,0;5,0;;;;1,0;47,0;2,0;37,0;;;62,0;6,0;3,0;2,0;76,0;;45,0;;;;6,0;102,0;6,0;2,0;;157,0;;;;;;2,0;;34,0;;114,0;2,0;;12,0;30,0;64,0;24,0;1,0;;;46,0;;;;28,0;5,0;;;118,0;11,0;;33,0;;;;24,0;3,0;17,0;;;;7,0;103,0;8,0;131,0;;2,0;;1,0;3,0;;;;;;1,0;11,0;1,0;2,0;;;16,0;;49,0;;;1,0;8,0;;7,0;50,0;;2,0;7,0;;2,0;;78,0;;;15,0;;;;8,0;10,0;;;14,0;2,0;31,0;28,0;6,0;3,0;6,0;9,0;53,0;64,0;7,0;;4,0;;;;5,0;24,0;;;;;26,0;34,0;;3,0;1,0;;4,0;58,0;5,0;37,0;;;2,0;;;;8,0;47,0;6,0;2,0;12,0;4,0;7,0;49,0;;;3,0;6,0;15,0;32,0;123,0;3,0;43,0;15,0;4,0;33,0;1,0;1,0;1,0;;87,0;4,0;5,0;110,0;6,0;8,0;7,0;;2,0;91,0;3,0;7,0;3,0;;2,0;;;;42,0;4,0;358,0;4,0;8,0;1,0;21,0;3,0;;;19,0;;;;1,0;;;27,0;3,0;3,0;6,0;;7,0;61,0;78,0;18,0;7,0;5,0;;15,0;26,0;4,0;46,0;400,0;26,0;1,0;;2,0;;1,0;45,0;12,0;1,0;;1,0;;;9,0;7,0;19,0;3,0;;14,0;2,0;12,0;7,0;11,0;1,0;9,0;26,0;;;16,0;2,0;11,0;16,0;2,0;6,0;;8,0;2,0;2,0;7,0;1,0;6,0;21,0;13,0;5,0;4,0;;6,0;68,0;1,0;23,0;8,0;11,0;9,0;;10,0;4,0;5,0;2,0;27,0;44,0;;6,0;3,0;1,0;14,0;2,0;;4,0;;;4,0;1,0;50,0;;9,0;;1,0;5,0;3,0;1,0;1,0;;8,0;6,0;4,0;2,0;21,0;27,0;67,0;32,0;;7,0;;1,0;;6,0;8,0;8,0;;66,0;2,0;4,0;;;;2,0;;1,0;;;;;8,0;;;5,0;;;4,0;;;;2,0;;;2,0;;2,0;;;;;5,0;;;;;;4,0;;;;;;;1,0;2,0;3,0;;14,0;1,0;5,0;3,0;11,0;;4,0;;1,0;1,0;;4,0;;;;;;;115,0;;1,0;;5,0;4,0;;4,0;1,0;;;3,0;3,0;2,0;;;17,0;;;;;;;14,0;;;;;;12,0;;;1,0;1,0;;;2,0;;3,0;;;;;;;;1,0;;12,0;25,0;;;2,0;;;10,0;;15,0;4,0;;;;;2,0;;1,0;;;7,0;;;1,0;;;;;;8,0;;;1,0;;;;;;;1,0;;;;;3,0;;3,0;2,0;9,0;;16,0;;;11,0;6,0;2,0;;;1,0;4,0;5,0;1,0;;;;1,0;;;;3,0;77,0;;;;;2,0;;3,0;;;;;;;;;;;;3,0;3,0;;;2,0;;;;;1,0;;40,0;12,0;1,0;1,0;;9,0;4,0;;;;20,0;;26,0;1,0;;;;;;;1,0;6,0;;;8,0;;;;;;1,0;;;3,0;2,0;1,0;;;1,0;;11,0;;5,0;;;;5,0;;;1,0;;;;2,0;;;;;;;;11,0;;;;;;3,0;1,0;5,0;6,0;;28,0;;2,0;;1,0;;;;;;3,0;;;;;;;;;2,0;;;;;;4,0;;4,0;;;;;;;;2,0;2,0;;1,0;;;;;37,0;;;4,0;;;;21,0;;41,0;2,0;;;;;7,0;17,0;2,0;3,0;8,0;;;;1,0;4,0;;14,0;;;2,0;;;;1,0;19,0;;;4,0;9,0;2,0;;;;;;1,0;7,0;;1,0;11,0;;63,0;;3,0;;4,0;;;1,0;;;;;7,0;7,0;2,0;1,0;36,0;11,0;1,0;14,0;;5,0;1,0;;1,0;11,0;2,0;;;;;;1,0;20,0;5,0;2,0;;;2,0;4,0;;1,0;;1,0;;11,0;;;32,0;;;;;;3,0;;;;;;;;14,0;6,0;;2,0;;;;;;;;;;;;;;;;3,0;;;;;;3,0;13,0;;4,0;;1,0;;;;;;;1,0;;2,0;13,0;;;;;;;;;2,0;;1,0;;;;;1,0;;;;;;;;;;;1,0;;;;;;;;;;;;1,0;;;;;;;;;5,0;;2,0;;;;;;;;;;;;;;;5,0;;4,0;;;;;;1,0;;;;;;;;;1,0;;;1,0;;;7,0;;;;6,0;1,0;;;;;;4,0;;;;;4,0;3,0;;;;;3,0;;2,0;;;;;;;3,0;;;1,0;;;;;;;;;7,0;;;;;;;;;;;;;;;;;;;;;;;;;;;
recognition;;2,0;;13,0;1,0;25,0;;;;;;;1,0;78,0;;2,0;23,0;;1,0;6,0;;;8,0;;5,0;;;2,0;8,0;8,0;80,0;4,0;1,0;2,0;;22,0;5,0;;6,0;;78,0;89,0;;3,0;33,0;1,0;2,0;1,0;1,0;10,0;1,0;;;3,0;6,0;2,0;;;;22,0;;;6,0;2,0;294,0;3,0;49,0;1,0;;;2,0;12,0;12,0;7,0;;;;1,0;2,0;5,0;84,0;;14,0;1,0;77,0;;;53,0;;5,0;51,0;;;;8,0;;27,0;;11,0;51,0;59,0;8,0;;64,0;60,0;32,0;1,0;11,0;;5,0;;12,0;54,0;;;1,0;;22,0;5,0;47,0;;;13,0;13,0;2,0;13,0;148,0;;;;13,0;;;88,0;;;6,0;;1,0;;;3,0;;;;8,0;36,0;2,0;5,0;;;4,0;3,0;;;;;;;;;;7,0;;;;6,0;;;15,0;8,0;3,0;;18,0;;;1,0;;3,0;;1,0;;;47,0;;;3,0;;7,0;10,0;;1,0;;1,0;;;8,0;;;;;;3,0;;;13,0;;;1,0;;9,0;2,0;;;;;7,0;;1,0;1,0;29,0;;34,0;;6,0;;6,0;;5,0;;;;11,0;2,0;;60,0;3,0;;;18,0;;;;;;19,0;1,0;4,0;2,0;;;;;6,0;1,0;;2,0;2,0;;;;6,0;2,0;39,0;;;;;;;;;;1,0;;;;7,0;;;;;4,0;9,0;;;;2,0;10,0;;;;;;;;6,0;;;2,0;;;;;;;;;1,0;18,0;;;;;;;17,0;;;;39,0;110,0;;;;;2,0;;;;;;;;4,0;;;;;;1,0;;;;;;1,0;6,0;;;;;;;8,0;;;1,0;39,0;;2,0;;;;;8,0;4,0;;;2,0;;1,0;17,0;1,0;6,0;1,0;;12,0;5,0;;51,0;5,0;;3,0;1,0;22,0;4,0;4,0;1,0;12,0;1,0;25,0;13,0;;2,0;12,0;;41,0;15,0;2,0;;19,0;;;2,0;12,0;1,0;9,0;8,0;;;4,0;;3,0;10,0;3,0;;13,0;;1,0;;;;;1,0;10,0;;16,0;1,0;;;;;;5,0;;12,0;66,0;6,0;;;47,0;2,0;;;5,0;;;18,0;;2,0;;1,0;;;;4,0;;2,0;;8,0;4,0;;;1,0;1,0;6,0;6,0;;3,0;;;2,0;8,0;;;;1,0;6,0;2,0;;3,0;4,0;4,0;3,0;;129,0;1,0;1,0;;;2,0;2,0;;;;1,0;11,0;41,0;;;;1,0;3,0;2,0;3,0;5,0;;1,0;;2,0;2,0;;6,0;;;;1,0;;;;;;;;2,0;;;;8,0;;37,0;;;1,0;;;1,0;;8,0;;1,0;;;;4,0;;;;3,0;;;;;11,0;8,0;;;;3,0;;46,0;;4,0;2,0;;16,0;32,0;;2,0;;;;;;;;10,0;;;;;;;2,0;;;;10,0;;;1,0;;4,0;;;10,0;3,0;15,0;;30,0;31,0;57,0;43,0;;1,0;3,0;;;;;;;;;;2,0;5,0;;;;;;4,0;;;;;;4,0;;1,0;;3,0;;;;2,0;;4,0;;;;2,0;;;;;;;;;1,0;;4,0;;;2,0;1,0;;;5,0;10,0;8,0;3,0;1,0;;;;6,0;;;;;;4,0;;6,0;7,0;;;;;;;;2,0;;4,0;;;;;;;;;;;;;;1,0;1,0;2,0;;;;;;;;;;;3,0;1,0;4,0;;;6,0;;;2,0;2,0;;;;;;;;;;9,0;;1,0;;;;4,0;;;;;;;1,0;;;;;;;;;;;;;;;;;;1,0;;;;;4,0;;;;;;;;;;1,0;;;;;;;;;;;;8,0;;;;;;1,0;;;;;1,0;;;;;5,0;;;;;;;3,0;;;10,0;;;2,0;13,0;3,0;;;;;;;;;25,0;;60,0;;1,0;;;;;;9,0;6,0;;;;;11,0;;;2,0;;;;;1,0;1,0;;6,0;;;;68,0;55,0;;3,0;;;;;4,0;1,0;4,0;1,0;;;;1,0;;;;;5,0;;1,0;;33,0;;;;;;2,0;;;;;;;;5,0;2,0;;19,0;;;2,0;;;;;1,0;2,0;;1,0;;;3,0;;;;;;;;2,0;3,0;;1,0;2,0;;;;;;;;;;;;;;;;;;;1,0;;;;2,0;;4,0;;;1,0;1,0;;;;;;;1,0;;;;;;;3,0;;;1,0;;;;;;;;1,0;;;;;;4,0;;;;;;;;;
record;;6,0;1,0;10,0;11,0;102,0;13,0;52,0;1,0;6,0;;4,0;;108,0;;25,0;177,0;;3,0;2,0;;;53,0;12,0;15,0;;9,0;8,0;73,0;55,0;242,0;20,0;5,0;6,0;;571,0;7,0;2,0;4,0;;58,0;459,0;;77,0;95,0;12,0;2,0;46,0;6,0;6,0;4,0;2,0;3,0;19,0;29,0;6,0;9,0;;2,0;38,0;;;41,0;2,0;1184,0;5,0;140,0;3,0;12,0;;1,0;73,0;59,0;1,0;;;;3,0;8,0;65,0;258,0;;118,0;10,0;171,0;;4,0;39,0;2,0;4,0;11,0;4,0;3,0;5,0;11,0;;80,0;16,0;116,0;34,0;121,0;16,0;;42,0;52,0;57,0;12,0;72,0;3,0;;;19,0;22,0;6,0;23,0;35,0;31,0;44,0;90,0;113,0;17,0;1,0;163,0;10,0;7,0;112,0;199,0;;4,0;;198,0;;;178,0;;;39,0;2,0;4,0;;1,0;1,0;;;10,0;9,0;31,0;11,0;33,0;12,0;;33,0;20,0;;7,0;;;;;;;19,0;42,0;1,0;;2,0;5,0;7,0;;12,0;4,0;;8,0;39,0;;1,0;3,0;1,0;37,0;;;;;20,0;1,0;8,0;15,0;;114,0;8,0;;40,0;1,0;;;;25,0;12,0;10,0;2,0;;12,0;4,0;1,0;4,0;262,0;10,0;;13,0;17,0;9,0;24,0;8,0;;;4,0;39,0;1,0;;5,0;3,0;20,0;14,0;2,0;3,0;;160,0;;5,0;2,0;;;54,0;9,0;4,0;7,0;1,0;;8,0;12,0;;3,0;;;;56,0;8,0;1,0;12,0;1,0;;;;3,0;;;22,0;3,0;16,0;;15,0;76,0;5,0;44,0;;;1,0;;11,0;21,0;;1,0;5,0;2,0;6,0;2,0;15,0;21,0;2,0;2,0;5,0;;7,0;2,0;2,0;;5,0;9,0;10,0;;;2,0;;;;3,0;12,0;18,0;;3,0;2,0;;8,0;;1,0;;2,0;3,0;4,0;69,0;;;1,0;;6,0;;9,0;;;10,0;26,0;77,0;3,0;14,0;1,0;;5,0;;30,0;7,0;;;2,0;1,0;;;3,0;;2,0;;14,0;11,0;9,0;;;7,0;7,0;6,0;;;;2,0;3,0;;8,0;2,0;6,0;4,0;1043,0;42,0;1,0;;;12,0;29,0;11,0;10,0;;;2,0;;;2,0;2,0;23,0;3,0;3,0;39,0;7,0;;173,0;3,0;;3,0;2,0;26,0;10,0;6,0;;37,0;4,0;9,0;3,0;7,0;4,0;63,0;2,0;6,0;48,0;2,0;3,0;40,0;4,0;32,0;;35,0;1,0;68,0;102,0;6,0;1,0;41,0;1,0;18,0;66,0;17,0;;;;;2,0;19,0;6,0;19,0;17,0;107,0;13,0;54,0;8,0;;2,0;2,0;39,0;41,0;12,0;1,0;50,0;14,0;32,0;3,0;17,0;3,0;9,0;;35,0;62,0;;1,0;72,0;1,0;1,0;2,0;13,0;7,0;1,0;1,0;1,0;79,0;3,0;;28,0;7,0;6,0;5,0;16,0;9,0;;3,0;2,0;6,0;17,0;10,0;73,0;48,0;6,0;;3,0;8,0;2,0;;;1,0;12,0;20,0;2,0;7,0;44,0;1,0;17,0;9,0;1,0;;7,0;10,0;9,0;;3,0;8,0;2,0;6,0;30,0;31,0;31,0;1,0;12,0;7,0;;79,0;2,0;20,0;98,0;;14,0;;4,0;5,0;2,0;8,0;;;6,0;;;;;2,0;;;;;;2,0;;;4,0;1,0;13,0;5,0;13,0;10,0;37,0;1,0;2,0;6,0;1,0;60,0;;2,0;1,0;3,0;;2,0;4,0;1,0;29,0;9,0;;7,0;1,0;;5,0;209,0;9,0;6,0;4,0;;26,0;13,0;54,0;1,0;3,0;;7,0;;7,0;2,0;19,0;8,0;;;8,0;;5,0;7,0;3,0;;;2,0;8,0;5,0;2,0;7,0;6,0;4,0;;3,0;;22,0;3,0;4,0;;2,0;;68,0;3,0;52,0;;5,0;4,0;;3,0;9,0;24,0;1,0;11,0;;;2,0;1,0;3,0;19,0;20,0;12,0;6,0;;;;;12,0;35,0;11,0;;10,0;23,0;;;;2,0;;6,0;;15,0;;5,0;1,0;;4,0;;2,0;2,0;;4,0;9,0;5,0;5,0;;;;8,0;4,0;;9,0;28,0;4,0;1,0;;3,0;;;4,0;8,0;6,0;1,0;13,0;1,0;23,0;;18,0;24,0;;6,0;;1,0;21,0;6,0;19,0;4,0;;;;3,0;;4,0;1,0;28,0;10,0;2,0;4,0;73,0;2,0;;2,0;21,0;2,0;3,0;2,0;2,0;17,0;;20,0;;;;3,0;1,0;12,0;;;5,0;;9,0;;;4,0;1,0;8,0;4,0;;1,0;19,0;;9,0;;1,0;22,0;1,0;;;8,0;;1,0;;1,0;;;1,0;;10,0;3,0;1,0;1,0;;;;;;;;5,0;;;;4,0;;;;;;22,0;;5,0;2,0;;;;;;1,0;;;;1,0;1,0;5,0;4,0;2,0;;2,0;;5,0;;;7,0;;;;1,0;3,0;2,0;;1,0;;;23,0;;;;;2,0;;;3,0;;;;5,0;;;;3,0;;1,0;;3,0;1,0;;;2,0;26,0;;;;1,0;;1,0;;7,0;25,0;;;1,0;;;;1,0;17,0;2,0;;;;;4,0;2,0;8,0;4,0;;8,0;1,0;5,0;11,0;;2,0;;1,0;;3,0;;4,0;;;3,0;;1,0;4,0;4,0;;1,0;6,0;;2,0;;3,0;3,0;;;4,0;;;4,0;;1,0;11,0;;;1,0;6,0;;;3,0;32,0;108,0;;;2,0;5,0;;;;2,0;;;;1,0;1,0;;;1,0;;;;1,0;;1,0;;;3,0;;3,0;3,0;;1,0;;;2,0;;1,0;1,0;;;;;;;;;;;;;6,0;;;;;1,0;1,0;;1,0;;;;;;;1,0;1,0;31,0;;;;;;;5,0;4,0;;;1,0;2,0;;2,0;;;2,0;1,0;1,0;;;10,0;;;;1,0;;2,0;;;8,0;;
rectangular;;2,0;;;;19,0;36,0;13,0;;;;;;37,0;;;1,0;4,0;;;;;15,0;;;;;7,0;;;6,0;;;;;;16,0;1,0;3,0;;2,0;30,0;;2,0;7,0;9,0;;12,0;;;1,0;;9,0;2,0;4,0;3,0;39,0;;;8,0;;;6,0;;52,0;;26,0;;;;17,0;26,0;20,0;;;;4,0;;;;14,0;;1,0;5,0;19,0;3,0;;22,0;;1,0;2,0;;;8,0;;1,0;60,0;50,0;11,0;9,0;9,0;2,0;11,0;;2,0;4,0;;;;;;;21,0;;1,0;;;2,0;;18,0;1,0;;;16,0;;;36,0;;;;1,0;;;21,0;4,0;1,0;9,0;2,0;1,0;;1,0;2,0;;;4,0;;28,0;11,0;;2,0;1,0;6,0;5,0;;;;;1,0;;;2,0;8,0;;;;;3,0;5,0;;2,0;;;2,0;7,0;;31,0;7,0;3,0;;;;;1,0;13,0;;1,0;15,0;;27,0;;;;;4,0;;5,0;15,0;;6,0;1,0;;6,0;;;;;24,0;4,0;5,0;21,0;;;;;5,0;27,0;;9,0;;;6,0;;;;10,0;;47,0;;;4,0;2,0;;;1,0;;;1,0;;;;;4,0;;;;7,0;1,0;137,0;50,0;;;2,0;;4,0;;;5,0;48,0;3,0;;;1,0;;6,0;2,0;;;;2,0;8,0;;1,0;1,0;;5,0;;;4,0;1,0;1,0;1,0;1,0;10,0;2,0;;;;2,0;1,0;6,0;5,0;4,0;;5,0;8,0;9,0;2,0;;;;1,0;;5,0;;;;;;6,0;16,0;;;6,0;;5,0;;13,0;;;;3,0;3,0;3,0;;10,0;9,0;4,0;1,0;;;2,0;9,0;2,0;5,0;;;;;;;;;;;;;1,0;3,0;;;;;;;1,0;;1,0;7,0;5,0;;;;;;;1,0;;;;;3,0;;;7,0;;;;;;;1,0;8,0;;;;3,0;;;;;;;;3,0;;2,0;2,0;2,0;;;;;;;;2,0;;;;6,0;;;;;;4,0;5,0;;;;;;;;;20,0;;;;;24,0;;1,0;;;;1,0;2,0;2,0;;;2,0;;4,0;;;;;1,0;;;;;;;;;3,0;;2,0;;2,0;;;;;;;;;;;;4,0;;;1,0;1,0;1,0;;3,0;1,0;;;1,0;;;;;;;;1,0;;;;;;;;;;;;;3,0;;;;;;;;;;;;;;;;1,0;3,0;8,0;;;;2,0;1,0;;;;;1,0;2,0;;;;;3,0;;;1,0;25,0;;2,0;;;;;;;;;;;;;;;;;;;;;;;;;;;;;;4,0;;;;;;;4,0;;;;5,0;;;8,0;;;;;3,0;;;;1,0;;;;;;;1,0;;;;;;;3,0;;;;;;;;;;;4,0;;;;;;;1,0;;2,0;;;;;;8,0;;1,0;;;8,0;;;;1,0;;;;;;;;;2,0;;1,0;;;;;;;;;;;;;;;;1,0;4,0;;2,0;;;;;;;;;;;1,0;;;2,0;;;;3,0;;2,0;;;;;;4,0;2,0;;;3,0;;;;;6,0;;;1,0;;;;;;8,0;;;;6,0;;;;;2,0;;6,0;;2,0;;;;;;2,0;3,0;2,0;;;1,0;2,0;;;;;2,0;;;;;2,0;;;;;;;3,0;;;;;;;;;1,0;;;;5,0;;1,0;;11,0;;;1,0;11,0;;;5,0;;;;;;;;;;;;4,0;;;;;;;;;2,0;;;;;4,0;;;;;;;;;;;4,0;;;3,0;;;;;;;;;;;;;;;;;;;;;;;1,0;1,0;;;;;4,0;;;;;;;;;;;;;;;;;;;;;;;;;;;1,0;;;;;;;;;;;;;;;;;;;;;;;;;19,0;;1,0;;;;;;;;;;;;;;;;;;;;;;1,0;6,0;;;;;;;;;;;;;;;;;;;;2,0;;;;1,0;;;;;;2,0;;2,0;;;;;;;5,0;;;;;29,0;;1,0;;;;;;;;;;;;;;;;;;;;
reflector;;1,0;;;;2,0;2,0;16,0;;;;;;10,0;;;3,0;1,0;13,0;;1,0;;;;;;;2,0;;;17,0;15,0;;;;;16,0;1,0;7,0;;;27,0;;;;4,0;;11,0;;;;;5,0;;4,0;8,0;12,0;;;;;;;;18,0;;22,0;3,0;;;1,0;21,0;53,0;;;;;;;;2,0;;;;7,0;2,0;;11,0;2,0;;;;;;;;2,0;3,0;60,0;76,0;52,0;;2,0;;1,0;;;;;;;;;;;;;;2,0;5,0;;;;1,0;;;27,0;;;1,0;;;;36,0;;;3,0;4,0;;;;1,0;;;;;1,0;15,0;5,0;;1,0;;;3,0;;;3,0;4,0;;;;3,0;;;;;4,0;2,0;;1,0;2,0;;3,0;9,0;;6,0;;1,0;1,0;;;;;4,0;;;1,0;;6,0;5,0;;;;;;;6,0;1,0;;;;22,0;;;9,0;;;4,0;5,0;15,0;6,0;;;;;;;2,0;1,0;;4,0;;;;6,0;;10,0;;1,0;2,0;;4,0;3,0;;1,0;;30,0;5,0;;2,0;;;;;;1,0;1,0;3,0;6,0;1,0;;;;7,0;10,0;;12,0;20,0;5,0;;;;;4,0;1,0;;1,0;;;;;1,0;2,0;1,0;;1,0;;19,0;;3,0;2,0;;6,0;2,0;;;;;2,0;;;6,0;;1,0;;;5,0;;;;;3,0;1,0;;;2,0;;;;12,0;;;;;6,0;;2,0;;1,0;;;;;;;3,0;;2,0;;;;;3,0;;;6,0;;;;;5,0;;;;;2,0;;;;;;;;;;;;1,0;;;;;;;;3,0;;;;;;;;12,0;3,0;;;;;;3,0;57,0;;;;2,0;;;;;;;3,0;1,0;1,0;;;;;;;;;;1,0;;;;;;;2,0;;;;2,0;;;;;;;;;;6,0;;;;;;;;7,0;;;;;1,0;;;;;1,0;;;;1,0;;;;;;1,0;;;;;;;;;;;;;;;;;;;;1,0;;;2,0;;;;;2,0;8,0;2,0;1,0;1,0;1,0;;;;;;;1,0;;11,0;;;;;;;4,0;;;1,0;;;;;;;;;;;;1,0;;;2,0;;;;;;;;;;;;;;;;;;;;;;;3,0;;;;;2,0;;;;;;;;;;;;2,0;;;;;;2,0;;;;;;;1,0;;;;;;3,0;;;8,0;;;;;;;;;;;1,0;;;;4,0;;;;;;;;;;;;;;;;;2,0;;;;;1,0;;;;1,0;;;;;;;;;;;;;;;1,0;;;3,0;;1,0;;;;;;;;;;;;1,0;;;;;;;;;;;1,0;;;;10,0;;;;;;;;1,0;;;;;;;;1,0;;;;;1,0;;;;4,0;;4,0;;;2,0;;;1,0;;;;;;;;;;;;10,0;;;;;;;;;;;6,0;;;;;;;;5,0;;;;;;;;;2,0;;;;;;;;;1,0;;2,0;1,0;;;;;;;;;;;;;;;;;;4,0;;;;;4,0;;;;;1,0;3,0;;;;;;;;;;;;;;;;;;;1,0;;;;;;;;;;;;;;;;;;;;;;;;;;;;;;;;;;;;;;;2,0;;;;;1,0;;;;;;;;;7,0;;;;;1,0;;;;;;;;;;1,0;;5,0;;;;;;;;;;;;;2,0;;;;;;;;;;;;;;;;;;;;;;1,0;;3,0;;2,0;1,0;;2,0;;;;;;;;;;;;;;;;;;;;;;;;;;;;;;;;;;;;;;1,0;;;;;;;;;;;6,0;;;;;;;;;;;;;;;;;;;;;;;;2,0;;;;;;;;;;;
register;;3,0;;;24,0;24,0;8,0;2,0;;;;;;25,0;;;13,0;3,0;;1,0;;1,0;22,0;;7,0;;;;1,0;2,0;49,0;2,0;1,0;;;106,0;;;23,0;1,0;33,0;73,0;;5,0;17,0;3,0;;10,0;31,0;3,0;3,0;;8,0;;4,0;147,0;18,0;;;17,0;;;46,0;;165,0;;39,0;1,0;;;2,0;1,0;42,0;;;;;1,0;1,0;6,0;60,0;;6,0;25,0;23,0;;;15,0;1,0;;58,0;;;;;;32,0;114,0;68,0;13,0;71,0;11,0;;;3,0;27,0;1,0;;;;;16,0;14,0;;;1,0;;;25,0;44,0;;;18,0;2,0;;40,0;58,0;;;;29,0;4,0;;58,0;;;19,0;17,0;2,0;;;2,0;2,0;;;7,0;3,0;2,0;55,0;1,0;;;;;4,0;;;;;;;9,0;;;2,0;1,0;3,0;;;;3,0;;2,0;8,0;;3,0;;;1,0;;1,0;;;2,0;;;;;8,0;;;;;3,0;;;1,0;2,0;1,0;;;;;15,0;9,0;2,0;;;1,0;2,0;;4,0;9,0;;;;4,0;1,0;;9,0;;14,0;43,0;4,0;;;7,0;;;2,0;;;7,0;1,0;;1,0;25,0;;;4,0;;;;;;17,0;;;1,0;;;;;12,0;;1,0;2,0;5,0;;;11,0;13,0;17,0;2,0;1,0;;;;;;;3,0;2,0;;;;;2,0;;;;;;1,0;3,0;;;;19,0;;1,0;19,0;;;;;4,0;1,0;;;;;;;;;;1,0;;15,0;;;;4,0;;;;;;;6,0;11,0;;4,0;;;;;2,0;;;;;;9,0;;;;;;;7,0;;;;;1,0;1,0;;;;;;;7,0;;;;27,0;24,0;;;;;;;;;;;;;1,0;3,0;35,0;5,0;;19,0;3,0;;36,0;33,0;;;;11,0;8,0;3,0;;2,0;1,0;;;1,0;;12,0;;22,0;12,0;1,0;;4,0;2,0;3,0;;7,0;3,0;10,0;;1,0;;;;;15,0;;;;;;;3,0;2,0;3,0;;32,0;4,0;7,0;1,0;3,0;3,0;;41,0;4,0;2,0;;11,0;2,0;4,0;;;6,0;1,0;2,0;2,0;;;;82,0;;3,0;5,0;1,0;;;;;6,0;;2,0;2,0;;12,0;5,0;;;;;;3,0;;;5,0;20,0;;;;4,0;;;;;1,0;12,0;;2,0;9,0;2,0;1,0;9,0;;;;;5,0;;15,0;2,0;;;;;5,0;;3,0;4,0;7,0;1,0;;4,0;14,0;4,0;;;;15,0;;;;;;;;;;;;;;;;;;;9,0;;1,0;;1,0;12,0;;;3,0;1,0;;2,0;;;4,0;;;;1,0;;4,0;8,0;;3,0;;;;1,0;3,0;;;;2,0;5,0;2,0;;;;54,0;;5,0;;;1,0;;1,0;;;;;1,0;;4,0;;7,0;3,0;;1,0;1,0;4,0;;;;1,0;2,0;;;;;20,0;;;;;4,0;14,0;1,0;4,0;;;4,0;;;;3,0;6,0;;2,0;;2,0;;;;;2,0;2,0;;;;4,0;;1,0;;2,0;;2,0;1,0;;;2,0;4,0;;;;;;1,0;1,0;;7,0;1,0;;4,0;2,0;2,0;1,0;2,0;;1,0;;;;2,0;10,0;;1,0;9,0;;22,0;2,0;;;;;6,0;;18,0;;;2,0;2,0;2,0;1,0;;;;;;1,0;;;;;;;;;;4,0;6,0;;;;;;;;;;;;;5,0;;;;1,0;;;5,0;;;;;;;;;;;2,0;;;;41,0;;4,0;;;;;;;;;;;;;;;;;;;;1,0;;;;;;;;;2,0;4,0;;1,0;;;;;;;;;;;6,0;;;;1,0;;;;;;;2,0;;4,0;;;;;;12,0;5,0;4,0;;12,0;9,0;13,0;1,0;;;;;1,0;6,0;2,0;;;;;;;15,0;1,0;;;;;3,0;;;;;;;;;;;;;;;;;;;;;2,0;3,0;1,0;;;;1,0;;;;;;1,0;26,0;1,0;;;;3,0;;;;2,0;2,0;;;;;;;;;;;;;;;;;;;1,0;;;;;32,0;;;;;;;;;;1,0;;;;;;;;;;;;;1,0;;;;1,0;;;;15,0;;;;;;;2,0;;;;;;2,0;;;;;;;;1,0;6,0;;1,0;;;;;;;;;;;3,0;;;;;1,0;;;;;;;;43,0;;;;;;;6,0;;;;;;;;;;;;6,0;;;;
registration;;1,0;;1,0;;4,0;13,0;;2,0;;;;;24,0;;;1,0;;;;;;;2,0;;;;;;;3,0;1,0;2,0;3,0;;4,0;;;23,0;;30,0;11,0;;;1,0;;;15,0;;8,0;9,0;;;;5,0;6,0;1,0;;;8,0;;;;;103,0;;21,0;;;;;1,0;;;;;;;;1,0;39,0;8,0;;7,0;7,0;;;9,0;;5,0;24,0;3,0;;;;;1,0;;10,0;14,0;73,0;;;5,0;2,0;21,0;;;;;;8,0;4,0;;;;;;2,0;10,0;;;1,0;;;2,0;14,0;;;;7,0;;;2,0;;;4,0;;;;;3,0;;;;5,0;1,0;1,0;3,0;;7,0;;;;;;;;;;;;;;;12,0;;;;;;;;1,0;;3,0;;;1,0;;;;;1,0;;;;;7,0;;;;;;;;;;;;;;;;6,0;1,0;1,0;;;;4,0;8,0;;;;;1,0;;;;1,0;;;;;;;;;;;;4,0;;;;;;;1,0;;;;;;5,0;;;;15,0;;;;1,0;;;;5,0;;;;;;3,0;1,0;;;;3,0;;;;;;;;1,0;;;;;;1,0;;;;;5,0;;;;;;;;;;;;;;;;;;1,0;;;;;1,0;;;;;;12,0;;1,0;;1,0;3,0;;;;;;;;;;;;;5,0;;1,0;;;;;;;;;;;1,0;;1,0;;;1,0;;1,0;;;;2,0;;;;;;;;2,0;;;;;;11,0;1,0;;;1,0;2,0;;;;16,0;;;;1,0;4,0;8,0;;4,0;;4,0;;;4,0;5,0;1,0;8,0;4,0;;;1,0;;;;1,0;3,0;4,0;;;;8,0;;1,0;3,0;;;;;;;;;2,0;1,0;2,0;4,0;2,0;;;;;2,0;;2,0;;;18,0;1,0;;1,0;;4,0;;;4,0;3,0;;1,0;;;;;;;;;;;;11,0;;;2,0;;;;;;;;;;1,0;;;;;;;;2,0;;3,0;;;19,0;;;3,0;;;2,0;1,0;;;;;2,0;;;;;;2,0;1,0;;;;;;;;;1,0;3,0;;;;;;;;2,0;5,0;;;;;;;;;1,0;1,0;;;;1,0;;;;;;;;;;;;;;;4,0;5,0;;1,0;;;;;;;;2,0;;;;1,0;;;;2,0;;5,0;3,0;;3,0;;;;;;;2,0;;;;;3,0;;1,0;;;;;2,0;;2,0;;2,0;;;2,0;;;;2,0;;;;;;;;;;1,0;4,0;;;2,0;;1,0;;;;;;;;;;4,0;;;1,0;;;;;;;;;;;;3,0;;;5,0;7,0;;;;2,0;;1,0;;19,0;;;;;;4,0;;;;;;;2,0;1,0;1,0;;;15,0;1,0;;;;;;;;;;;;;;1,0;;;;;;;;;;;;;;;;;;;;;;;;;;;3,0;;;3,0;3,0;;;;;;;;;7,0;6,0;;;;2,0;1,0;1,0;;;;;;;2,0;;;;;;;;;;;;;3,0;;;;;;;;4,0;;3,0;;;;;;;;;;;;;;;;;;;;;;;;;;4,0;;;;;;;;1,0;;;;2,0;6,0;;;;;;;;;;;;;;1,0;;;;;;;;;14,0;;;3,0;;;;;;;;;;;;;1,0;;2,0;1,0;;;;;;;;;;;;;;;;;;;;;;2,0;1,0;;;;7,0;;1,0;;;;;;;;;;;3,0;;7,0;;;;3,0;;;;1,0;;;;;;;;;;1,0;;;;;;;;;;;;;;;;;;;;;;;;;;;;;;;;;;;;;;;;;;;;;;;;;;;;;;;;;1,0;;;;;;;;;;;;;3,0;;;;;;;2,0;;;;;1,0;;;;;;
relation;;1,0;2,0;11,0;;18,0;1,0;31,0;;;;;;37,0;;;18,0;;;;;;2,0;;;;2,0;17,0;4,0;2,0;11,0;;4,0;1,0;;19,0;12,0;1,0;9,0;2,0;48,0;56,0;;9,0;25,0;;;23,0;;;6,0;;6,0;;3,0;23,0;1,0;;2,0;3,0;7,0;;4,0;;121,0;2,0;12,0;2,0;1,0;;24,0;108,0;9,0;;9,0;1,0;2,0;6,0;;;29,0;;7,0;;4,0;2,0;;40,0;2,0;2,0;8,0;;;;4,0;;12,0;25,0;30,0;24,0;70,0;7,0;;;5,0;14,0;;3,0;;3,0;;9,0;7,0;5,0;;;;7,0;;28,0;1,0;;13,0;1,0;;6,0;23,0;3,0;;;13,0;;;15,0;;;3,0;4,0;1,0;;;6,0;;;;3,0;2,0;5,0;4,0;5,0;1,0;;12,0;;;;;;;10,0;;3,0;;8,0;;23,0;6,0;10,0;;3,0;11,0;;1,0;26,0;1,0;2,0;2,0;;;;;1,0;1,0;6,0;;13,0;1,0;14,0;14,0;2,0;2,0;3,0;1,0;2,0;4,0;;10,0;;;;;;;;;1,0;13,0;;;26,0;11,0;18,0;6,0;;;3,0;5,0;1,0;5,0;;;;;;4,0;;18,0;1,0;;;;1,0;14,0;2,0;1,0;;2,0;;;21,0;;;3,0;;;5,0;;4,0;6,0;8,0;;;;8,0;4,0;;13,0;20,0;;;;4,0;;15,0;3,0;;;;1,0;3,0;;6,0;;;;;;21,0;;2,0;1,0;;34,0;1,0;3,0;;16,0;;;;;3,0;;;;4,0;10,0;1,0;3,0;1,0;;;;;1,0;1,0;4,0;;7,0;31,0;3,0;;;;;;3,0;;;;11,0;39,0;2,0;;;;3,0;;12,0;;;8,0;;1,0;1,0;;1,0;;;;17,0;1,0;8,0;;;1,0;5,0;11,0;;1,0;;;;;9,0;4,0;3,0;;13,0;3,0;;;;1,0;1,0;1,0;;1,0;;;;;17,0;3,0;1,0;2,0;;;;;11,0;82,0;;5,0;;9,0;3,0;6,0;;;;;1,0;4,0;2,0;7,0;;16,0;14,0;;1,0;3,0;;16,0;2,0;10,0;;6,0;9,0;2,0;1,0;3,0;;;2,0;7,0;;;;1,0;;;;3,0;;7,0;9,0;5,0;2,0;1,0;;4,0;4,0;;1,0;9,0;;1,0;8,0;;2,0;1,0;;6,0;;3,0;;;24,0;;;;14,0;6,0;3,0;;;7,0;;;;2,0;;;;;1,0;;;;4,0;3,0;;2,0;;2,0;5,0;17,0;;;13,0;1,0;;;4,0;1,0;4,0;5,0;12,0;15,0;;;2,0;;;;7,0;2,0;;2,0;;;2,0;;1,0;13,0;;1,0;;;;;;;;;;;;;1,0;;;6,0;;;;;;;2,0;1,0;;2,0;3,0;;;;1,0;11,0;;;2,0;1,0;;;;;;;;;;;;;;;;;;;4,0;;;;;;;2,0;3,0;;;6,0;3,0;5,0;;;;2,0;;;;;;;;;1,0;1,0;1,0;;;4,0;;;;;6,0;;;;;6,0;;;;6,0;;;;;10,0;2,0;9,0;;2,0;;;;3,0;;1,0;7,0;;;;;;;;;;;;;;;3,0;;;;;2,0;;;;4,0;;;;;;7,0;1,0;;3,0;;1,0;;;2,0;2,0;;;;;;;;13,0;;1,0;;1,0;2,0;;;26,0;;;;;;;;;1,0;;;;;;;;3,0;;1,0;;;;;;5,0;;;;;;;;;1,0;;3,0;5,0;;2,0;;;;;;;;;13,0;;4,0;;;;;;7,0;;;1,0;2,0;;;5,0;1,0;;;9,0;;;;;;;;;;;;;;;2,0;;;;;;;;;;4,0;;17,0;;;;;;1,0;;;;;;;2,0;;1,0;;;;;;;;;;;;;;;;;;;;;19,0;1,0;;;;;;;;;;2,0;;37,0;;;1,0;;;;;;;;;;;2,0;;;;;5,0;;2,0;;;;;4,0;4,0;;5,0;3,0;3,0;;3,0;13,0;;;;;;;2,0;;;;;;;2,0;;5,0;55,0;;12,0;;;;4,0;;1,0;;;;;;;;;11,0;;;;;2,0;2,0;;;;;;;;;;;;;;;;;;;;;;;1,0;;;;;1,0;;;4,0;;;15,0;;;2,0;;;;9,0;;;;;;;;;;;;;;;;;;;;;1,0;;;;;;;;;;;;;;;;;;2,0;;;;;;;6,0;;1,0;;;;2,0;;;;;;;;;;;1,0
relative;;7,0;31,0;101,0;22,0;77,0;87,0;155,0;;8,0;5,0;4,0;58,0;422,0;;4,0;103,0;;3,0;3,0;5,0;9,0;16,0;8,0;2,0;7,0;9,0;121,0;3,0;14,0;142,0;14,0;2,0;6,0;1,0;119,0;85,0;110,0;85,0;1,0;308,0;367,0;;97,0;168,0;49,0;30,0;166,0;;;34,0;3,0;73,0;10,0;90,0;26,0;32,0;18,0;8,0;43,0;8,0;;30,0;2,0;849,0;2,0;68,0;24,0;11,0;19,0;33,0;630,0;83,0;2,0;2,0;3,0;7,0;9,0;1,0;4,0;187,0;8,0;16,0;9,0;147,0;167,0;3,0;251,0;89,0;9,0;50,0;4,0;6,0;8,0;2,0;;84,0;146,0;173,0;131,0;1187,0;52,0;6,0;5,0;6,0;41,0;;2,0;1,0;4,0;;206,0;76,0;52,0;6,0;9,0;8,0;42,0;19,0;447,0;4,0;;21,0;25,0;3,0;7,0;225,0;;2,0;;57,0;9,0;;149,0;14,0;;100,0;36,0;20,0;;;16,0;;;59,0;21,0;30,0;44,0;41,0;12,0;17,0;19,0;105,0;31,0;4,0;;;;;;;15,0;15,0;3,0;6,0;2,0;27,0;37,0;3,0;5,0;11,0;2,0;8,0;361,0;;25,0;2,0;14,0;9,0;6,0;10,0;8,0;2,0;33,0;7,0;4,0;24,0;6,0;188,0;52,0;;19,0;1,0;22,0;56,0;3,0;381,0;4,0;15,0;2,0;2,0;1,0;21,0;;20,0;6,0;219,0;1,0;32,0;272,0;221,0;300,0;57,0;4,0;;30,0;33,0;23,0;2,0;48,0;46,0;10,0;10,0;6,0;60,0;3,0;216,0;;16,0;5,0;9,0;5,0;29,0;;23,0;1,0;17,0;9,0;;10,0;1,0;24,0;98,0;7,0;9,0;73,0;4,0;14,0;106,0;16,0;14,0;1,0;14,0;108,0;11,0;25,0;133,0;236,0;6,0;;1,0;5,0;1,0;179,0;27,0;3,0;3,0;3,0;5,0;12,0;8,0;4,0;29,0;9,0;9,0;;31,0;350,0;3,0;16,0;19,0;5,0;350,0;36,0;6,0;17,0;41,0;6,0;53,0;;77,0;6,0;;16,0;10,0;33,0;110,0;11,0;12,0;20,0;5,0;2,0;5,0;4,0;;3,0;18,0;71,0;55,0;75,0;30,0;2,0;7,0;1,0;13,0;7,0;56,0;16,0;16,0;18,0;33,0;330,0;12,0;7,0;4,0;2,0;;5,0;7,0;23,0;4,0;24,0;14,0;7,0;22,0;2,0;10,0;;17,0;3,0;133,0;196,0;52,0;7,0;1,0;20,0;37,0;57,0;4,0;17,0;4,0;1,0;1,0;;41,0;35,0;12,0;9,0;49,0;1,0;;;;10,0;;27,0;21,0;35,0;2,0;2,0;1,0;6,0;53,0;64,0;58,0;11,0;8,0;;35,0;10,0;61,0;92,0;;6,0;17,0;45,0;1,0;17,0;4,0;1,0;;;14,0;22,0;38,0;19,0;2,0;27,0;26,0;19,0;3,0;80,0;5,0;21,0;8,0;195,0;10,0;18,0;107,0;10,0;9,0;81,0;;17,0;19,0;272,0;40,0;13,0;6,0;;3,0;17,0;3,0;8,0;;45,0;13,0;20,0;5,0;16,0;22,0;1,0;7,0;2,0;19,0;13,0;7,0;42,0;2,0;;14,0;1,0;10,0;69,0;;12,0;21,0;5,0;203,0;5,0;10,0;10,0;;21,0;15,0;;1,0;50,0;3,0;40,0;56,0;1,0;9,0;;4,0;3,0;8,0;;2,0;10,0;11,0;15,0;12,0;18,0;3,0;10,0;8,0;11,0;1,0;4,0;31,0;9,0;1,0;24,0;2,0;19,0;32,0;66,0;13,0;222,0;33,0;1,0;1,0;12,0;1,0;27,0;26,0;;2,0;5,0;5,0;35,0;1,0;;19,0;33,0;8,0;;;2,0;;4,0;3,0;;1,0;6,0;14,0;15,0;;;8,0;23,0;1,0;16,0;;1,0;8,0;2,0;5,0;;6,0;12,0;3,0;11,0;44,0;13,0;5,0;19,0;9,0;11,0;4,0;4,0;26,0;14,0;5,0;16,0;;1,0;2,0;1,0;3,0;1,0;9,0;3,0;3,0;;3,0;7,0;9,0;7,0;;10,0;8,0;10,0;9,0;12,0;10,0;3,0;;;;3,0;1,0;4,0;43,0;37,0;3,0;26,0;2,0;;;;27,0;18,0;7,0;7,0;60,0;;2,0;7,0;;;5,0;1,0;2,0;;1,0;1,0;17,0;3,0;3,0;;;106,0;;;15,0;1,0;4,0;1,0;;3,0;18,0;65,0;4,0;16,0;1,0;4,0;2,0;95,0;;;7,0;46,0;;;;;;;3,0;1,0;;11,0;1,0;;;14,0;29,0;2,0;;;4,0;10,0;4,0;17,0;3,0;7,0;;;;8,0;2,0;6,0;43,0;14,0;6,0;;2,0;22,0;4,0;;;1,0;4,0;;25,0;2,0;33,0;;21,0;2,0;41,0;2,0;8,0;1,0;;;102,0;;;2,0;;5,0;;;9,0;12,0;3,0;1,0;;22,0;1,0;2,0;1,0;23,0;2,0;2,0;;;4,0;2,0;7,0;26,0;30,0;6,0;8,0;5,0;3,0;3,0;;3,0;14,0;;1,0;11,0;;2,0;1,0;8,0;;1,0;1,0;;6,0;32,0;80,0;13,0;7,0;13,0;6,0;;5,0;7,0;;;;18,0;43,0;1,0;7,0;6,0;7,0;14,0;2,0;2,0;;9,0;11,0;4,0;5,0;8,0;1,0;8,0;;;;26,0;;14,0;20,0;9,0;2,0;3,0;1,0;;;1,0;;5,0;9,0;1,0;23,0;15,0;;;1,0;;20,0;4,0;3,0;;2,0;;12,0;7,0;2,0;5,0;;;;;6,0;9,0;;;5,0;3,0;;;;;2,0;14,0;2,0;;;;24,0;5,0;;1,0;;3,0;2,0;3,0;2,0;;;;5,0;53,0;3,0;2,0;8,0;9,0;;11,0;;1,0;;;2,0;3,0;1,0;17,0;;;;;3,0;4,0;7,0;8,0;3,0;5,0;;;;;1,0;10,0;6,0;12,0;1,0;4,0;8,0;21,0;2,0;;4,0;;4,0;2,0;16,0;;;;4,0;10,0;2,0;19,0;;2,0;1,0;1,0;2,0;3,0;1,0;4,0;28,0;;;;3,0;1,0;;1,0;;1,0;;;;1,0;;4,0;2,0;2,0;1,0;;;17,0;2,0;;;;;1,0;11,0;;;3,0;13,0;;;;2,0;;2,0;;;8,0;1,0;;3,0;2,0;42,0;;;;8,0;5,0;7,0;24,0;4,0;;;;;16,0;4,0;;1,0;4,0;;;;11,0;;;6,0;;5,0;3,0;1,0;1,0;;;;7,0;4,0;2,0;;2,0;1,0;;;3,0;;9,0;;10,0;2,0;;2,0;1,0;;;;;;30,0;5,0;;9,0;1,0;1,0;1,0;3,0;6,0;;;;8,0;2,0;1,0;;;2,0;
release;;2,0;;1,0;3,0;20,0;;8,0;1,0;;;;;21,0;;;6,0;;5,0;;;;;1,0;1,0;;;25,0;;;37,0;2,0;;;;6,0;4,0;1,0;;;6,0;48,0;2,0;1,0;13,0;21,0;;13,0;;;4,0;;8,0;3,0;;1,0;1,0;;;;;;;;22,0;;18,0;;;;1,0;17,0;3,0;;;;;;;3,0;14,0;;33,0;;8,0;9,0;;1,0;;1,0;;2,0;;;7,0;;;;7,0;12,0;94,0;1,0;;;;5,0;;;;;;;;;;;;2,0;;4,0;;;2,0;;;1,0;14,0;;2,0;;11,0;;;29,0;;;3,0;;;;2,0;1,0;;;7,0;7,0;2,0;3,0;2,0;7,0;6,0;1,0;12,0;;;;1,0;;;;;9,0;;;;;6,0;6,0;;;;;;19,0;;;;;13,0;1,0;1,0;;15,0;;;;4,0;2,0;4,0;12,0;;1,0;1,0;4,0;3,0;2,0;19,0;;1,0;1,0;;7,0;4,0;6,0;;;28,0;;2,0;57,0;7,0;25,0;;;;;2,0;;;;;2,0;;;14,0;2,0;37,0;2,0;;;3,0;;2,0;;;;;;;;;18,0;2,0;;2,0;7,0;13,0;3,0;7,0;13,0;15,0;;;21,0;;;9,0;30,0;;;;2,0;8,0;8,0;;;;;;;;2,0;1,0;;9,0;;8,0;4,0;2,0;1,0;28,0;;16,0;;;5,0;1,0;2,0;;;;2,0;;;;;1,0;;1,0;13,0;11,0;;2,0;;2,0;;;1,0;2,0;4,0;1,0;3,0;1,0;19,0;;36,0;13,0;113,0;2,0;73,0;5,0;1,0;;;2,0;;;1,0;6,0;;18,0;;2,0;3,0;3,0;;;;20,0;;9,0;7,0;5,0;2,0;1,0;8,0;2,0;5,0;;12,0;;1,0;;;;;2,0;1,0;;;;;;1,0;1,0;7,0;;;;7,0;;4,0;;;3,0;;;8,0;;;13,0;;;;1,0;23,0;;;;10,0;;;;2,0;;1,0;;;4,0;;;24,0;;3,0;;8,0;;;3,0;;1,0;1,0;;;29,0;1,0;;;;;;;;;;7,0;1,0;5,0;;;;;2,0;;;1,0;;;5,0;;1,0;;;;;;;;14,0;;;9,0;5,0;5,0;1,0;;;;;;;;;;1,0;;2,0;;;;1,0;;;3,0;1,0;2,0;;;1,0;;1,0;;;;5,0;;2,0;6,0;1,0;;2,0;;;;;;4,0;1,0;;2,0;;;;32,0;;1,0;;;;;;;47,0;;1,0;3,0;2,0;9,0;;;7,0;;;;;;1,0;1,0;1,0;;2,0;1,0;;;;;;;;1,0;;2,0;;26,0;;;;;2,0;;;5,0;;;3,0;;;;;;;3,0;;8,0;;;;;2,0;;;7,0;;4,0;;;;1,0;;;;1,0;;1,0;;2,0;42,0;;;;;;;3,0;;;;;;1,0;;;;;;;;;;;;;;;;;;1,0;;;;1,0;;;;;;;;;1,0;;3,0;;;;;1,0;;;;;2,0;;;11,0;6,0;;;;;;;1,0;;1,0;;;;3,0;;;;;9,0;;;;1,0;;8,0;;;2,0;;;;;;;3,0;;;;;6,0;;;;5,0;1,0;1,0;;3,0;10,0;16,0;;;;2,0;;;;4,0;3,0;;12,0;;;1,0;;4,0;;;;1,0;;;2,0;;;;2,0;7,0;;;9,0;;;;;;;1,0;10,0;;;5,0;2,0;7,0;;2,0;;;5,0;;;;2,0;;;;3,0;;;;;;;;3,0;;;;3,0;;;;4,0;2,0;;6,0;1,0;3,0;;;;2,0;1,0;;;;;1,0;;;;6,0;;;;;;;;;;;3,0;;1,0;;2,0;6,0;1,0;;;;;;;;;;4,0;;;;;;;;;;;;;;;;;;;;;6,0;10,0;6,0;;;;;;;;5,0;;;;;;;;;1,0;;;1,0;;;;;;;;;;1,0;;;;;;;;;;;;;3,0;;;;;;;;;;;;;;;1,0;;;8,0;;5,0;2,0;;;;;;;;;;;;;;;6,0;;;;;;;;;;3,0;;1,0;;;8,0;;;;;;;;1,0;1,0;;;;;;;;;;;;;;;;;;;;;;;;;;3,0;10,0;;;;;;;;;;;;;;;;;;;;;;;;;;;;;;;;
remote;;1,0;;4,0;16,0;31,0;1,0;33,0;;1,0;;;3,0;110,0;;1,0;81,0;3,0;;5,0;;;4,0;36,0;96,0;;;8,0;30,0;5,0;84,0;52,0;;;;214,0;4,0;2,0;3,0;;84,0;875,0;;14,0;235,0;12,0;;10,0;;;3,0;;2,0;25,0;33,0;;7,0;;1,0;19,0;;;18,0;;204,0;3,0;104,0;1,0;1,0;;;17,0;49,0;;;1,0;6,0;14,0;8,0;31,0;142,0;;4,0;1,0;50,0;;;9,0;;;11,0;;1,0;1,0;;;2,0;;14,0;35,0;60,0;16,0;1,0;16,0;24,0;37,0;;9,0;12,0;;;6,0;12,0;1,0;;1,0;6,0;36,0;;89,0;11,0;;208,0;2,0;;56,0;298,0;;3,0;;33,0;;;180,0;;;32,0;7,0;17,0;;;;8,0;;;22,0;7,0;1,0;52,0;28,0;;;24,0;4,0;;;;;;;;14,0;5,0;15,0;;;36,0;;;3,0;4,0;;;10,0;1,0;;1,0;5,0;;;1,0;6,0;7,0;7,0;;;1,0;;10,0;4,0;;;;2,0;;;8,0;2,0;;;;;1,0;;1,0;14,0;4,0;;5,0;25,0;10,0;15,0;;;;2,0;91,0;3,0;;;;10,0;5,0;;;;35,0;;;;;6,0;6,0;;1,0;;5,0;;;17,0;;1,0;2,0;;;28,0;7,0;3,0;10,0;;;;;2,0;;5,0;2,0;13,0;;;;99,0;;102,0;8,0;;;1,0;;1,0;;3,0;3,0;11,0;2,0;6,0;7,0;6,0;;;9,0;;10,0;;;;4,0;1,0;16,0;;;3,0;;;;1,0;9,0;;;4,0;;;;1,0;1,0;;10,0;18,0;;15,0;;3,0;2,0;;1,0;;28,0;4,0;1,0;8,0;93,0;37,0;;8,0;4,0;;;;17,0;;;;;;13,0;;1,0;;;1,0;4,0;6,0;;;;13,0;;;;;2,0;;11,0;;6,0;3,0;1,0;;207,0;64,0;;5,0;2,0;5,0;10,0;11,0;5,0;2,0;20,0;1,0;;2,0;;8,0;5,0;1,0;4,0;50,0;17,0;2,0;691,0;26,0;;2,0;3,0;21,0;12,0;5,0;4,0;22,0;;6,0;4,0;3,0;;14,0;;45,0;12,0;;3,0;15,0;7,0;4,0;;161,0;1,0;48,0;7,0;5,0;;7,0;;27,0;12,0;15,0;8,0;1,0;;;1,0;2,0;1,0;;19,0;195,0;;38,0;15,0;6,0;17,0;25,0;33,0;12,0;2,0;2,0;68,0;6,0;8,0;7,0;22,0;41,0;;41,0;;6,0;16,0;;142,0;4,0;;;8,0;;1,0;1,0;;1,0;;1,0;51,0;;;;4,0;2,0;;;12,0;;19,0;1,0;30,0;57,0;1,0;;3,0;6,0;;6,0;;3,0;17,0;5,0;2,0;;19,0;3,0;1,0;1,0;;5,0;;4,0;8,0;;29,0;12,0;2,0;2,0;4,0;61,0;;10,0;;;8,0;18,0;1,0;;26,0;;3,0;;2,0;5,0;;2,0;3,0;1,0;15,0;5,0;;;;;9,0;;1,0;;2,0;;2,0;5,0;1,0;58,0;2,0;;3,0;7,0;;;10,0;3,0;;13,0;;1,0;;;;;;4,0;16,0;6,0;;;;2,0;1,0;10,0;11,0;2,0;11,0;;4,0;;28,0;5,0;;2,0;2,0;;14,0;13,0;;1,0;;;;2,0;20,0;1,0;;;;28,0;7,0;2,0;12,0;15,0;;2,0;1,0;64,0;1,0;1,0;9,0;2,0;4,0;3,0;;13,0;27,0;13,0;;98,0;1,0;;;1,0;;;17,0;;;11,0;5,0;;16,0;;;1,0;10,0;;;;;22,0;1,0;6,0;2,0;66,0;;;;1,0;;;2,0;1,0;1,0;2,0;;1,0;;;10,0;1,0;;7,0;4,0;4,0;;;4,0;1,0;;;5,0;66,0;136,0;;;;36,0;3,0;;2,0;45,0;108,0;;7,0;1,0;;7,0;;49,0;;1,0;;18,0;22,0;15,0;6,0;;;;;;1,0;;;1,0;;;;;;1,0;;;8,0;;;;;;;;;;21,0;;5,0;2,0;;;;18,0;;;7,0;4,0;2,0;;1,0;;;;;;9,0;13,0;2,0;1,0;2,0;;;5,0;1,0;;4,0;;;;4,0;10,0;;;;;;;;;;;;1,0;;;1,0;;11,0;;;;;1,0;;3,0;;;;;;;;;134,0;1,0;1,0;5,0;;1,0;;;;;;;;;;2,0;;;;;;;1,0;;;;;;;;;;;;1,0;;;;;;;1,0;;;;;7,0;;;;;;;;;;;;;1,0;;;;;1,0;1,0;4,0;;;7,0;;;;;;;;2,0;2,0;;2,0;;3,0;;;;1,0;;19,0;;;;;1,0;;;11,0;;;3,0;;2,0;1,0;;;3,0;3,0;1,0;;3,0;;;;;;;;1,0;23,0;1,0;20,0;;;1,0;;;;1,0;;;;;1,0;;;;;1,0;;;;;;1,0;3,0;;;2,0;;;;2,0;;;;;;;;;;;;;;;;;;7,0;;1,0;;1,0;;;;;;;;;;;1,0;;;1,0;;6,0;27,0;;;;;;;2,0;;15,0;;;;1,0;;;;;;;;;;1,0;;;;;
removably;;12,0;;1,0;;21,0;1,0;34,0;;;;;2,0;55,0;;;;;6,0;;;;;;;;;3,0;;;72,0;1,0;;;;5,0;;;;2,0;;40,0;;1,0;1,0;11,0;;4,0;;;;;;1,0;;;6,0;;;;1,0;;;1,0;12,0;;12,0;;;;;43,0;13,0;;;;2,0;;;;10,0;;;;18,0;2,0;;4,0;;;;;;2,0;;;;;10,0;;6,0;;;;1,0;4,0;;;;;;;;;13,0;;;;;7,0;;;1,0;2,0;;;13,0;;1,0;;;;;12,0;;;1,0;;;1,0;;;;;13,0;;;6,0;;119,0;;;34,0;11,0;;;;;;;6,0;46,0;;;;;100,0;21,0;;;;;;2,0;2,0;4,0;;1,0;2,0;;;;;6,0;15,0;;6,0;1,0;3,0;16,0;;;6,0;2,0;8,0;9,0;20,0;1,0;2,0;;;;;1,0;;;40,0;;;79,0;;1,0;;;1,0;3,0;;;;;;;1,0;;28,0;6,0;29,0;;;;3,0;;1,0;;4,0;;;;;;;4,0;3,0;;;;1,0;11,0;17,0;2,0;3,0;;;8,0;;;22,0;34,0;2,0;;;1,0;;13,0;2,0;;;;2,0;;2,0;;2,0;5,0;6,0;1,0;;;;3,0;12,0;;3,0;;;;;3,0;;;;6,0;;1,0;;11,0;;;;22,0;4,0;2,0;1,0;;12,0;1,0;3,0;4,0;;3,0;;;;1,0;;;;2,0;;16,0;7,0;1,0;2,0;;;;7,0;1,0;1,0;;7,0;4,0;11,0;1,0;8,0;;;;;;2,0;;1,0;4,0;;40,0;;1,0;;1,0;;5,0;;;1,0;3,0;3,0;1,0;2,0;4,0;;;;;;8,0;;;;;;;;1,0;;;;;;;;;;;;;;;;;;;;;;;;;;;;;;1,0;;1,0;;5,0;;3,0;;1,0;;;;1,0;2,0;;;;;;;;;18,0;;;;1,0;;;;;;;1,0;;5,0;1,0;;;;1,0;;;;;;;;;;3,0;;3,0;;;2,0;;;;;;2,0;;;;;;;;;4,0;;;;5,0;;;2,0;;;;;1,0;1,0;;;;;;;;;;;1,0;;;;;;;;;;;;;1,0;;7,0;;;1,0;;;1,0;;8,0;20,0;7,0;2,0;;;4,0;12,0;2,0;;;;6,0;;;;;;;;;;;1,0;;;;;;;1,0;;;;;;;12,0;;;;;;;;;;;;;;;;10,0;;;;;2,0;;;;2,0;5,0;;4,0;17,0;;;;;;;;;;;;;;;;;1,0;;;;2,0;;;;;;;1,0;;;;;;;;;;;;;;;;;;;;;;;1,0;;;5,0;;;4,0;;;;1,0;;;;;;;;;;;;;;;;;;;;;3,0;1,0;1,0;;1,0;1,0;;;;3,0;5,0;;;;;;;;;;;;;8,0;;;;;;2,0;1,0;;;;;;;5,0;;2,0;1,0;;;;2,0;;4,0;3,0;;;13,0;;;;;;;4,0;3,0;;;;;;;;;;9,0;3,0;;;;1,0;;2,0;4,0;;3,0;;;;;;;;;;;;;3,0;;;2,0;;1,0;;;;4,0;2,0;;;;;;;1,0;2,0;3,0;2,0;;;;;5,0;;;;;;;;;;;;;;;;;;;;1,0;;;;;;;;;;;;;;;;;;;;;;;;;;;;;;;;;;;;4,0;3,0;;;;;;;;3,0;;;;;;;;;;;;;;;;;;2,0;;;;;;;;;;;;;2,0;;;;;;;;;;;;;;;;;;;;;;;;;2,0;;;;;;;;;;;3,0;;;;;;;;;;;;;;;;3,0;;;9,0;;;;;;;;3,0;;;;;4,0;;;;;;;;;;;;;;;;;;;;6,0;;;;;;;;;;;;;;;;;;;;;;;;;;;;;;;
request;;10,0;;6,0;2,0;53,0;;;;3,0;;;;53,0;;2,0;144,0;;7,0;4,0;;;1,0;9,0;75,0;;;3,0;17,0;11,0;77,0;18,0;;1,0;;135,0;12,0;;;1,0;45,0;426,0;;5,0;51,0;;;3,0;;;;2,0;;29,0;8,0;;9,0;;4,0;28,0;;;6,0;3,0;296,0;4,0;132,0;;5,0;;;56,0;11,0;;5,0;;;4,0;37,0;9,0;121,0;;32,0;3,0;20,0;;1,0;9,0;;3,0;13,0;2,0;2,0;1,0;34,0;;2,0;;23,0;2,0;15,0;6,0;;5,0;17,0;50,0;1,0;19,0;;;;1,0;2,0;1,0;;3,0;6,0;1,0;1,0;9,0;1,0;;193,0;;;15,0;53,0;;;;38,0;;;49,0;3,0;;29,0;2,0;13,0;;;;;;;;12,0;;31,0;;;;27,0;;5,0;;;;;;;9,0;41,0;6,0;3,0;;7,0;1,0;1,0;1,0;;;5,0;1,0;;;6,0;;6,0;3,0;;;2,0;;;;6,0;;28,0;;;1,0;;2,0;;;;;;;;3,0;21,0;16,0;;11,0;6,0;;;;1,0;;4,0;;;;5,0;;;3,0;2,0;10,0;4,0;;;;15,0;;4,0;;;;;4,0;;;;;;;;;;;;19,0;;2,0;;1,0;2,0;;;;;7,0;4,0;1,0;;;73,0;168,0;16,0;25,0;;;;;;1,0;;;;2,0;3,0;;6,0;5,0;;1,0;;;;;;;;11,0;10,0;;;4,0;;;;;;;;;;;;;;;;;;32,0;;;;;;;;16,0;;;56,0;10,0;;;;;;;10,0;;;;;;29,0;;3,0;;;;;;;;3,0;4,0;;;;;;;5,0;;;;25,0;;77,0;49,0;;;;31,0;24,0;;9,0;;;1,0;;;2,0;;28,0;1,0;;9,0;;;104,0;;;3,0;8,0;33,0;6,0;;3,0;14,0;;10,0;6,0;1,0;2,0;34,0;;7,0;19,0;17,0;;53,0;1,0;8,0;;30,0;;55,0;1,0;1,0;;2,0;;6,0;35,0;2,0;;;;;2,0;;;5,0;4,0;388,0;16,0;241,0;23,0;;1,0;31,0;39,0;;1,0;;12,0;3,0;11,0;5,0;;34,0;2,0;7,0;;10,0;;2,0;104,0;1,0;;;9,0;;;;;;;6,0;12,0;3,0;2,0;3,0;;;1,0;11,0;;;5,0;5,0;36,0;30,0;;;2,0;;2,0;1,0;;2,0;;3,0;2,0;1,0;15,0;3,0;5,0;24,0;1,0;;;;7,0;;8,0;7,0;;;;24,0;2,0;2,0;;;;6,0;4,0;10,0;;;2,0;;;1,0;;6,0;;;37,0;;;;;2,0;;;1,0;;;6,0;;4,0;;;;16,0;;7,0;2,0;;;3,0;;9,0;;;2,0;2,0;;;11,0;11,0;;5,0;;;;;;13,0;4,0;;;;;5,0;61,0;23,0;5,0;;2,0;;;1,0;;;;;2,0;;;2,0;4,0;;;75,0;1,0;;14,0;;6,0;;1,0;4,0;2,0;10,0;;5,0;;2,0;1,0;;8,0;55,0;;1,0;;;5,0;4,0;1,0;;2,0;;;7,0;16,0;;20,0;1,0;;1,0;;;1,0;;;2,0;;;1,0;70,0;;;3,0;;;;;3,0;;;;;10,0;;8,0;;;;4,0;5,0;;;2,0;4,0;;2,0;;60,0;29,0;13,0;5,0;;;78,0;;25,0;6,0;;;17,0;;;;1,0;18,0;;5,0;;2,0;58,0;4,0;9,0;;;;1,0;;;;;;;7,0;;;;2,0;2,0;1,0;2,0;12,0;;;;;1,0;;;;3,0;3,0;;;3,0;25,0;22,0;64,0;;;9,0;1,0;;;;;;;28,0;;;3,0;6,0;;;;;1,0;;;;;;;;;;;;;;;;;2,0;;;;;;;;;;;;;24,0;;2,0;;;;;;;;;4,0;;4,0;;;;;6,0;;;;;;;;6,0;;2,0;;;;;9,0;;;;;;;;;;;;7,0;;;;;;;;3,0;;;;4,0;;;;;;;1,0;;12,0;;;;;;2,0;;;12,0;;4,0;;;;;;;;;;1,0;;;;;;;2,0;;;;;3,0;;;2,0;2,0;;;;;;;;;4,0;1,0;;;;2,0;6,0;;;;;;;;1,0;31,0;;;4,0;2,0;;4,0;1,0;;;;;;;;;;;;;;;;1,0;;;;;;;;;;;;;;;;;;;;;;;;;;;;;;;;2,0;;;;;;;;;;;;;;;;;;;;;;;;;;;;;;3,0;1,0;;;;;;;1,0;;;;1,0;;;1,0;;
resilient;;4,0;;;;2,0;;11,0;;;;;;7,0;;;;;2,0;;;;;;;;;1,0;;;17,0;;;;;;3,0;;;;;30,0;4,0;;;3,0;;1,0;;;;;5,0;;;;5,0;;;;5,0;;;;1,0;;28,0;;;;7,0;14,0;;;;;23,0;;;;;;;;4,0;2,0;;;;;;;;;;;;3,0;1,0;;9,0;;;;;;;;;;;;;;;;;;;2,0;;;;;;;7,0;;;;;;;5,0;;;;;;;2,0;1,0;;;;3,0;;4,0;;5,0;3,0;;3,0;;;;;;;;;4,0;;;;;17,0;9,0;;;;;;5,0;;17,0;;;;;;;;2,0;;;;7,0;7,0;3,0;;;;1,0;;;4,0;;8,0;;;;;;;;58,0;3,0;;31,0;;3,0;;1,0;;8,0;;;;1,0;;;;;12,0;1,0;14,0;;;;6,0;;;;;;;;;;;3,0;1,0;;3,0;;;5,0;4,0;;;;;6,0;;;5,0;4,0;3,0;;;;;;;;;;1,0;;;;6,0;;;;1,0;3,0;1,0;;;;2,0;;;;1,0;;;;1,0;2,0;;;;7,0;;;1,0;4,0;;22,0;3,0;;;;;;;1,0;;;;;;2,0;2,0;;;2,0;;;2,0;;;1,0;1,0;2,0;5,0;;2,0;7,0;2,0;1,0;;;;;;;2,0;2,0;;;1,0;2,0;;;;2,0;;2,0;;;;;;2,0;;;;;;;4,0;;;;;;;;;;;;;;;;;;;;;;;;;;;;;;;;;;;;;;;;;;;;1,0;1,0;;2,0;;;2,0;;;;;;;;;;;2,0;;;;4,0;;;;;;;;;;;;;;;;;;;;;;;;;1,0;;;;6,0;;;;;;;;;;;;;;;;;;;;;;;;;;;;;;;;;2,0;;;;;;;;;;;;;;;;;;;;;;;;;8,0;;;;3,0;;;;;;;;;;;;3,0;4,0;;;;;;;;;;;;;;;;;;;;;;;;;;;;;;4,0;;;;1,0;;;;;;;;1,0;;;;;;;2,0;;;;;;;;;;;;;;;;;;;;;3,0;;;;;;;;;;2,0;;;;;;;;;;;;;;;;;;;;;;;;;;;;;;;;;;;;;;;;;1,0;;;;;;;;;;;;;;4,0;;5,0;;;;;;;;;;;;;;;;;;;;;;;;7,0;9,0;;;;;;;;;2,0;;;;;;;;;;;;;;;;;;;;;;2,0;;;;;;;;;;3,0;;;;;;;;;;;;;;;;;1,0;;;;;;;;;;;;;;;;;;2,0;;2,0;;;;2,0;;;;;;;;;;;;;;3,0;;;;;;;;;;;;;1,0;;;;;;;;;;;;;;;;;;;;;;;;;;;;;;;;;;;;;;;;;;;;;;;;;;;;;;;;;;;;;;;;;;;;;;;;;;;;1,0;;;;;;;;;;;;;;;;;;;;;;;;;;;;;;;;;;;;;;;;;1,0;1,0;;;;;;;;;;1,0;;;;;2,0;;;;;;;;;;;;;;;;;;;;;;;1,0;;;;;;;;;;;;2,0;;;;;;;;;;;;;;;;;;;;;;;;;;;
response;;8,0;;39,0;37,0;83,0;8,0;10,0;3,0;8,0;;23,0;3,0;71,0;;22,0;294,0;9,0;28,0;42,0;;;51,0;9,0;65,0;;2,0;59,0;26,0;32,0;158,0;55,0;6,0;8,0;1,0;241,0;12,0;6,0;32,0;1,0;483,0;506,0;;51,0;308,0;1,0;;51,0;;16,0;47,0;5,0;10,0;33,0;33,0;12,0;6,0;;80,0;178,0;3,0;;14,0;;772,0;5,0;68,0;9,0;11,0;;18,0;102,0;199,0;1,0;7,0;3,0;8,0;16,0;3,0;39,0;210,0;;141,0;10,0;81,0;3,0;1,0;56,0;;10,0;22,0;5,0;19,0;6,0;18,0;;87,0;22,0;196,0;75,0;157,0;68,0;;16,0;35,0;153,0;8,0;34,0;11,0;1,0;;40,0;52,0;9,0;6,0;4,0;33,0;29,0;50,0;265,0;14,0;20,0;590,0;44,0;39,0;50,0;153,0;;14,0;;184,0;12,0;4,0;88,0;3,0;;62,0;31,0;38,0;;;;;;2,0;38,0;41,0;6,0;83,0;3,0;4,0;8,0;9,0;1,0;7,0;10,0;;1,0;;;;31,0;8,0;13,0;;4,0;12,0;15,0;4,0;149,0;17,0;16,0;3,0;45,0;1,0;11,0;25,0;36,0;20,0;5,0;1,0;;1,0;34,0;;;18,0;46,0;58,0;10,0;1,0;12,0;5,0;3,0;2,0;;11,0;32,0;;6,0;;12,0;7,0;3,0;39,0;28,0;30,0;;5,0;9,0;60,0;88,0;9,0;;;;87,0;3,0;1,0;13,0;18,0;44,0;9,0;1,0;2,0;;72,0;5,0;;66,0;;20,0;32,0;46,0;5,0;11,0;35,0;;;7,0;;4,0;10,0;;;75,0;6,0;3,0;10,0;1,0;;;3,0;17,0;4,0;11,0;11,0;28,0;;;15,0;84,0;15,0;153,0;;25,0;;6,0;2,0;15,0;;5,0;29,0;4,0;1,0;;3,0;23,0;;2,0;;8,0;15,0;1,0;23,0;;3,0;3,0;20,0;2,0;26,0;10,0;;1,0;;;33,0;5,0;1,0;10,0;;;1,0;5,0;;;2,0;13,0;2,0;67,0;;;;7,0;6,0;1,0;12,0;3,0;4,0;13,0;55,0;170,0;3,0;17,0;5,0;1,0;;;39,0;;;;5,0;1,0;54,0;;5,0;;2,0;;16,0;27,0;7,0;1,0;2,0;1,0;10,0;19,0;;7,0;3,0;;5,0;2,0;10,0;1,0;20,0;;173,0;51,0;1,0;1,0;;40,0;108,0;19,0;23,0;18,0;;36,0;;4,0;26,0;7,0;126,0;10,0;1,0;144,0;15,0;18,0;284,0;14,0;2,0;;16,0;431,0;159,0;44,0;31,0;149,0;46,0;54,0;4,0;27,0;3,0;95,0;;67,0;42,0;5,0;5,0;296,0;6,0;55,0;24,0;145,0;9,0;28,0;81,0;9,0;1,0;26,0;9,0;63,0;162,0;63,0;;3,0;8,0;10,0;1,0;35,0;4,0;22,0;6,0;489,0;38,0;;2,0;;36,0;8,0;85,0;10,0;7,0;3,0;32,0;37,0;65,0;17,0;41,0;29,0;90,0;21,0;;17,0;2,0;3,0;395,0;8,0;4,0;25,0;106,0;1,0;4,0;7,0;;28,0;8,0;23,0;63,0;;36,0;16,0;;28,0;2,0;49,0;21,0;10,0;55,0;23,0;133,0;40,0;;;5,0;15,0;1,0;23,0;15,0;5,0;;9,0;2,0;;114,0;6,0;18,0;10,0;;29,0;8,0;4,0;8,0;5,0;35,0;19,0;1,0;1,0;1,0;49,0;7,0;106,0;15,0;1,0;;12,0;1,0;1,0;4,0;12,0;14,0;2,0;4,0;8,0;1,0;4,0;;;29,0;2,0;2,0;;2,0;4,0;;;;;4,0;162,0;;1,0;1,0;2,0;6,0;1,0;2,0;15,0;15,0;6,0;;7,0;;28,0;;4,0;1,0;32,0;1,0;;16,0;7,0;241,0;48,0;;3,0;;4,0;5,0;54,0;9,0;21,0;17,0;2,0;12,0;9,0;17,0;5,0;9,0;6,0;4,0;;4,0;4,0;12,0;14,0;;;2,0;6,0;7,0;4,0;;;;25,0;47,0;4,0;3,0;4,0;4,0;5,0;9,0;19,0;3,0;10,0;20,0;4,0;4,0;19,0;18,0;52,0;10,0;28,0;2,0;10,0;1,0;11,0;4,0;;2,0;4,0;16,0;3,0;16,0;34,0;18,0;;37,0;1,0;3,0;41,0;3,0;;1,0;;1,0;9,0;;;;30,0;;8,0;3,0;;3,0;11,0;7,0;8,0;;;6,0;6,0;4,0;6,0;12,0;2,0;2,0;;7,0;2,0;2,0;8,0;21,0;9,0;21,0;3,0;5,0;40,0;15,0;1,0;51,0;;2,0;16,0;;18,0;39,0;4,0;;16,0;2,0;4,0;1,0;1,0;58,0;;4,0;;4,0;41,0;1,0;66,0;;2,0;;10,0;3,0;;32,0;4,0;4,0;15,0;9,0;25,0;;;14,0;3,0;;20,0;29,0;;1,0;;4,0;4,0;4,0;;;;;20,0;;1,0;16,0;15,0;27,0;;;29,0;19,0;5,0;3,0;3,0;3,0;9,0;4,0;38,0;;5,0;20,0;1,0;;3,0;5,0;;15,0;;;;;2,0;13,0;29,0;;1,0;;1,0;;4,0;;;4,0;;;;;;;;;1,0;;;;1,0;23,0;;13,0;1,0;;;;;4,0;;2,0;25,0;;10,0;1,0;5,0;5,0;2,0;5,0;15,0;;1,0;;;1,0;;9,0;22,0;7,0;;;1,0;1,0;29,0;;1,0;;;3,0;;1,0;2,0;3,0;1,0;14,0;4,0;;10,0;3,0;;;61,0;6,0;8,0;1,0;1,0;;2,0;1,0;;;4,0;2,0;;25,0;2,0;5,0;13,0;;6,0;8,0;;4,0;4,0;3,0;7,0;3,0;2,0;1,0;;5,0;4,0;1,0;;2,0;;3,0;13,0;10,0;;14,0;2,0;2,0;11,0;;1,0;;5,0;5,0;5,0;4,0;2,0;3,0;5,0;11,0;;;1,0;;;;;14,0;4,0;;2,0;;1,0;5,0;1,0;2,0;2,0;;;;6,0;13,0;15,0;15,0;2,0;16,0;5,0;;;28,0;2,0;;;4,0;4,0;2,0;;3,0;2,0;;;;1,0;5,0;;;3,0;;;1,0;16,0;;4,0;20,0;;1,0;;;1,0;;3,0;;4,0;;1,0;1,0;;6,0;;;;;;;1,0;6,0;;;;6,0;3,0;;;;25,0;2,0;;40,0;;;;;;;;5,0;;;;4,0;1,0;;2,0;;4,0;;6,0;;1,0;4,0;3,0;;;;;12,0;;;;11,0;;;;;2,0
responsive;;4,0;;32,0;7,0;5,0;5,0;9,0;;;;2,0;;24,0;;6,0;85,0;;1,0;8,0;;;;;3,0;;1,0;2,0;7,0;18,0;39,0;10,0;2,0;5,0;;83,0;2,0;1,0;8,0;;144,0;124,0;;5,0;56,0;2,0;;9,0;;;;;6,0;9,0;5,0;;;;11,0;14,0;;;6,0;1,0;247,0;;6,0;3,0;2,0;1,0;1,0;26,0;34,0;4,0;;;;2,0;1,0;14,0;57,0;;39,0;15,0;15,0;;;8,0;;;12,0;;;9,0;;;11,0;;30,0;3,0;14,0;5,0;;7,0;79,0;97,0;2,0;4,0;7,0;;;;13,0;;2,0;;6,0;13,0;5,0;28,0;;;133,0;9,0;1,0;7,0;69,0;;6,0;;47,0;;;7,0;;;7,0;5,0;2,0;;;2,0;1,0;;;5,0;12,0;;12,0;1,0;56,0;3,0;4,0;;;;;;;;;7,0;3,0;1,0;;;2,0;;3,0;19,0;1,0;;3,0;1,0;;2,0;;1,0;6,0;7,0;1,0;4,0;;13,0;;;4,0;11,0;9,0;3,0;;3,0;4,0;;;;4,0;4,0;;;;9,0;;;21,0;2,0;;;2,0;3,0;3,0;8,0;3,0;;;;33,0;;;6,0;;2,0;;;2,0;;7,0;;;2,0;;;8,0;12,0;;5,0;3,0;1,0;;1,0;;;;;;28,0;2,0;;16,0;;;;;1,0;;11,0;;4,0;6,0;;14,0;12,0;;56,0;;1,0;;;2,0;1,0;;;4,0;;;;;8,0;;;1,0;;9,0;;;1,0;;2,0;3,0;;;1,0;;;1,0;;15,0;4,0;;;;;;4,0;;;;1,0;;9,0;;;;;;;;9,0;;4,0;22,0;15,0;;6,0;1,0;;;;22,0;;;;;;8,0;;;;;;5,0;;1,0;;;;;2,0;;6,0;;;2,0;;8,0;2,0;3,0;18,0;30,0;3,0;3,0;2,0;6,0;53,0;14,0;14,0;5,0;;;2,0;;;1,0;;15,0;;;11,0;;;59,0;7,0;1,0;1,0;;81,0;74,0;9,0;3,0;19,0;49,0;13,0;4,0;3,0;1,0;21,0;;9,0;13,0;9,0;1,0;63,0;;27,0;3,0;8,0;;12,0;45,0;1,0;;5,0;3,0;6,0;45,0;5,0;;7,0;;;;;6,0;;1,0;75,0;15,0;2,0;;3,0;13,0;;26,0;;;;4,0;12,0;10,0;2,0;12,0;;47,0;5,0;;2,0;4,0;;96,0;;;22,0;12,0;;;;;9,0;;;20,0;;5,0;1,0;;6,0;;2,0;5,0;;10,0;5,0;21,0;11,0;;;;;;;1,0;;29,0;3,0;14,0;2,0;5,0;5,0;3,0;2,0;;4,0;3,0;;;;4,0;10,0;11,0;2,0;;5,0;2,0;6,0;1,0;1,0;22,0;1,0;1,0;1,0;22,0;14,0;4,0;;;1,0;;8,0;;1,0;8,0;;4,0;;4,0;;;2,0;1,0;;;8,0;;8,0;;2,0;20,0;;;4,0;;;;10,0;3,0;5,0;;;1,0;3,0;7,0;;1,0;1,0;23,0;15,0;;;;;;2,0;;5,0;5,0;2,0;1,0;2,0;4,0;;;3,0;;;;;5,0;1,0;;7,0;;;2,0;1,0;2,0;;;4,0;4,0;;;;;;1,0;3,0;1,0;1,0;;1,0;2,0;9,0;2,0;34,0;1,0;13,0;;;;3,0;4,0;;;;2,0;;1,0;;11,0;;9,0;1,0;;;;;;;;4,0;1,0;;;4,0;;;3,0;;;8,0;1,0;5,0;;;1,0;;;;6,0;;;14,0;1,0;;;3,0;;;1,0;;4,0;3,0;3,0;;15,0;;;1,0;;;9,0;1,0;;3,0;12,0;1,0;5,0;;22,0;;3,0;;1,0;13,0;;6,0;3,0;;;12,0;;;4,0;;3,0;;3,0;;;;;;;;12,0;;;1,0;;15,0;;;;1,0;;3,0;;;2,0;6,0;14,0;;;5,0;7,0;;;;1,0;2,0;2,0;3,0;;2,0;5,0;;;1,0;11,0;;;;;;;8,0;4,0;1,0;;;;;;;;;;;;;;;;;;;;;;;;;4,0;;;;;;;;1,0;;;3,0;;;;;;;;;4,0;;;;;;;;;;;6,0;;;;;;2,0;;;;;;;;;;4,0;;2,0;;;;6,0;;;;2,0;;;14,0;;;5,0;;2,0;;1,0;;;;;;2,0;;;;;;4,0;1,0;;;;2,0;1,0;1,0;;;1,0;;;;;;1,0;1,0;10,0;;;;;;;;2,0;;;1,0;;;3,0;;;;10,0;;;;;;;;;;10,0;;;;2,0;;;;1,0;;;;;;;;;;5,0;1,0;;;10,0;;;;5,0;;;;20,0;;;;;;;;;;;;;1,0;;;;;;;;;5,0;;;;;;;;;;;;1,0;;;1,0;;;;;;;;;1,0;98,0;;1,0;;;;;;;4,0;;;;;;;2,0;;;;;;;;;
restrict;;4,0;;;;1,0;3,0;10,0;;;2,0;;2,0;17,0;;;19,0;;1,0;;;;1,0;;3,0;;;5,0;;;33,0;1,0;;;;18,0;10,0;3,0;148,0;;24,0;29,0;2,0;8,0;21,0;8,0;;3,0;;;19,0;;7,0;;117,0;;3,0;4,0;;30,0;;;;;44,0;5,0;17,0;1,0;;;3,0;32,0;4,0;;;;2,0;;;8,0;19,0;;5,0;1,0;6,0;12,0;;19,0;;;6,0;;;2,0;;;3,0;;12,0;;8,0;8,0;;;;9,0;;;1,0;2,0;;3,0;4,0;;;;;;;11,0;;;;;;2,0;15,0;;;;6,0;;;8,0;;;8,0;;1,0;;2,0;4,0;;;1,0;3,0;49,0;1,0;4,0;;2,0;;6,0;;1,0;;;;;;;17,0;3,0;;;;5,0;10,0;;;;;;35,0;;;;;4,0;;;;;;2,0;;8,0;1,0;39,0;3,0;;;1,0;;6,0;1,0;17,0;1,0;2,0;;;;7,0;;;1,0;87,0;;1,0;6,0;11,0;72,0;;;3,0;2,0;;;;6,0;;;;;14,0;;45,0;;7,0;;;;56,0;;3,0;;;;;;;2,0;;;;2,0;;;9,0;2,0;49,0;;;8,0;;;;7,0;6,0;;;;;1,0;;;;;;;;;;1,0;;;4,0;2,0;;;;1,0;9,0;2,0;;;3,0;4,0;4,0;;;;;;;;61,0;;;10,0;;;;5,0;;3,0;;2,0;;3,0;;2,0;;;1,0;;17,0;10,0;1,0;1,0;7,0;5,0;;10,0;;;;3,0;1,0;;35,0;;;1,0;2,0;;20,0;;;30,0;;60,0;1,0;;;;1,0;11,0;;1,0;;;;;;;;;6,0;2,0;8,0;;;4,0;2,0;2,0;;;;;2,0;;;;;10,0;;7,0;;;10,0;6,0;;2,0;2,0;;2,0;;;4,0;;;;;4,0;9,0;;4,0;3,0;;;4,0;;;;1,0;1,0;;13,0;;;3,0;;2,0;7,0;;;;;;;;;;;1,0;;2,0;;;4,0;2,0;;;;;1,0;;46,0;;;;;;;1,0;;;18,0;;16,0;;;;8,0;;;;;1,0;4,0;;;1,0;;;;;;;9,0;;;2,0;;;;3,0;;;;;;2,0;;;4,0;3,0;;;;;;1,0;;;;1,0;;;;;;;4,0;1,0;;;;;5,0;;;;;;;;;;2,0;4,0;;;;;;;2,0;;;;;11,0;;;;3,0;;2,0;;;;1,0;;;;;;;4,0;;;12,0;;3,0;;;3,0;;;;;;;;2,0;;27,0;;;;;;1,0;2,0;;;;;;;1,0;2,0;;2,0;;3,0;5,0;;;1,0;;;;;;7,0;;;;;;3,0;;;;;;;;;;;1,0;;;;;;;;;;;;1,0;;;;2,0;;;3,0;;;;;;;2,0;;;;;2,0;;;;;;;;;;;;;4,0;;;;3,0;;;;1,0;;2,0;;;;;;;;;;;;;6,0;;;;;;;5,0;;;2,0;;;;8,0;;;;;;;;;3,0;1,0;5,0;;;;;;;;;1,0;;;;;;;;3,0;;;;;;;;;;;17,0;;1,0;1,0;;;;;;2,0;;;;;;;;;;;;;;1,0;;;;;;2,0;3,0;;;;;;;1,0;4,0;3,0;;;;;1,0;;;;;;;;;6,0;;;;;;;;;;1,0;;;;;;;;;;;1,0;;;;;;;3,0;;;3,0;;1,0;;;;;;;1,0;;3,0;3,0;;;;;;;;;;;;;;;;;;;;2,0;;;;;;1,0;;;;;;;;;;;;;;;;;;;;;;3,0;;;1,0;;;;;;;;;;;;;;;;;;;;;;;;;;;;;1,0;;;;;;4,0;;;2,0;;;;;;;7,0;1,0;;;;;2,0;;;;;;;;;;2,0;;;;1,0;;;;;2,0;;;;;;;;;;;;;;;1,0;;;;;;;;;;;;;;;;;;;;;;;;;3,0;;;;;;;;
retrieve;;3,0;;2,0;;5,0;;;;2,0;;;;15,0;;;8,0;;11,0;;;;1,0;;1,0;2,0;;;5,0;4,0;9,0;2,0;;;;51,0;;;;;25,0;46,0;;3,0;5,0;;1,0;;;;;;;1,0;1,0;2,0;;;;1,0;;;3,0;;59,0;;13,0;;1,0;;2,0;;2,0;;;;;6,0;3,0;21,0;34,0;;12,0;14,0;3,0;;;;;;27,0;;;;1,0;;4,0;;12,0;14,0;58,0;2,0;;;2,0;9,0;;3,0;1,0;;;2,0;29,0;;;;1,0;;4,0;;1,0;;3,0;;;26,0;13,0;;;;4,0;;;4,0;;;7,0;;;;;;;;;;1,0;;3,0;;;;;;10,0;;;;;;;2,0;1,0;;;;2,0;;;;;;;;;;;;1,0;;;;;;;;;;4,0;;;;;;;;;;;;;;;;5,0;6,0;2,0;;;;;;2,0;;;;2,0;4,0;;;2,0;;;;;;11,0;;;;;18,0;;;;;;;;;;;;;;6,0;;;;;;;;2,0;;;;1,0;;;;4,0;;6,0;;;;;;;;;;3,0;;;4,0;5,0;;;;;;;;;;;;;;5,0;;;;;1,0;;;;;;;;;;;;;;;;1,0;;;;;;;;2,0;20,0;;;;;;;;;;;;;1,0;;;;;;;;;;;;2,0;;;;;;;;;;;;4,0;;;;;;;;;;;;;;3,0;;1,0;3,0;;;;;12,0;;;1,0;;1,0;1,0;;;2,0;;1,0;;1,0;;1,0;;2,0;5,0;;;4,0;;;;18,0;;1,0;;;;;;2,0;;;;2,0;;;;;;;;5,0;2,0;1,0;;;;;;;;2,0;7,0;3,0;;;;;;;;;1,0;;7,0;;;;;;;;;;;;4,0;;;;;;;;1,0;;2,0;;10,0;9,0;;;;2,0;;;;;;;2,0;;2,0;2,0;;;;;18,0;;;;;;1,0;;;1,0;;;;;;3,0;;1,0;4,0;;;;;;;;;;;;;;;;;;;;;;;;;;;;;5,0;2,0;;;;;;;;;;;;;;6,0;1,0;;1,0;;7,0;;;;;2,0;;;;;;;;3,0;;;;;;;;;;;1,0;1,0;;;;2,0;;;57,0;3,0;;4,0;;1,0;1,0;;;;;;13,0;7,0;;;;;1,0;;;;;;;;3,0;11,0;;;;;;1,0;;;;;;;1,0;;6,0;;;;;;;1,0;;;;;;;;;;;;;;;;2,0;2,0;;1,0;;1,0;5,0;;;;2,0;;;2,0;1,0;;;1,0;3,0;;;1,0;2,0;;;;;;;;1,0;6,0;;;;;1,0;;;;;;;;;;;3,0;;;;;;;;;;;;;;;;;3,0;;;;;;;;4,0;;;;;;;;;;;;;;;;;;;;;;;;;;;;;;;;;;;;;;;;3,0;;4,0;;;;;;;;;;;;;;;;;;;;;;3,0;;;;;;;;;;;1,0;;;;;;;;;;;;36,0;;;;;;;;;;;;;;;;;;;;1,0;;2,0;;;;;;;;;;;;;;;;;;;;;;;;;;;;;;;;;;;;;4,0;;;;;;2,0;1,0;1,0;;;;;;;;;;;;;;;;;;;3,0;;;;;;;;;;;;;;;;;;;;;3,0;;;;;;;;;;;;;;;;;;;5,0;;;;;;;;;4,0;;;;;;;;;;;;;;;;;;;;;;;;;;;;;;;;;;;;;;;2,0;;;;;;;1,0;;2,0;
rigid;;1,0;;1,0;;8,0;;24,0;;;;;1,0;32,0;;;6,0;;1,0;;7,0;;;;;;;2,0;1,0;;15,0;;;;;;2,0;1,0;7,0;;42,0;23,0;;;4,0;5,0;1,0;11,0;;10,0;;;10,0;3,0;;;10,0;1,0;;12,0;;;2,0;;34,0;;32,0;;;;2,0;14,0;4,0;;;;12,0;1,0;2,0;;11,0;;;2,0;20,0;;;5,0;;3,0;3,0;4,0;1,0;3,0;3,0;;;13,0;33,0;26,0;41,0;;;4,0;1,0;;;1,0;;;;;7,0;;3,0;;;2,0;;27,0;4,0;;2,0;;;1,0;16,0;;3,0;;4,0;;;18,0;;;6,0;;;;;2,0;;;2,0;;1,0;6,0;;19,0;;2,0;23,0;7,0;;;;;;;2,0;23,0;;;;3,0;23,0;2,0;;;;;;6,0;;11,0;;;;;;;;3,0;;;1,0;6,0;19,0;3,0;;;10,0;3,0;;4,0;18,0;;1,0;1,0;;;;;2,0;;57,0;1,0;2,0;78,0;3,0;;;;;7,0;1,0;1,0;;1,0;;;;;34,0;;50,0;;;;7,0;;;;;1,0;1,0;;9,0;;2,0;1,0;;;;;;13,0;29,0;;;1,0;;52,0;114,0;3,0;50,0;38,0;;;1,0;3,0;;;;;;;;;;7,0;14,0;9,0;4,0;;;12,0;1,0;6,0;20,0;;6,0;83,0;;;2,0;1,0;68,0;2,0;;3,0;;;;5,0;11,0;;1,0;;;1,0;50,0;;;;;5,0;;6,0;;1,0;3,0;;3,0;;3,0;2,0;;3,0;1,0;18,0;6,0;4,0;;;;5,0;4,0;11,0;1,0;;2,0;1,0;;;;3,0;1,0;;;22,0;;1,0;;3,0;2,0;11,0;;3,0;;1,0;;1,0;;1,0;;8,0;12,0;;;;;;;;;;;;;;7,0;3,0;4,0;;;;;;;3,0;;2,0;;;;;;;;2,0;1,0;;;1,0;2,0;4,0;2,0;;;;;;6,0;4,0;;2,0;6,0;;;1,0;;;;1,0;;;;;;;;;;3,0;1,0;;;;;;;;;;;;;;;4,0;;;1,0;;12,0;;1,0;;;;;4,0;;;3,0;1,0;;2,0;;;;;;2,0;;;;;;;;;;5,0;;12,0;;;;;;;;;1,0;;;15,0;;2,0;;1,0;;1,0;1,0;;;;;;;;;;;;;;1,0;;;;2,0;;;;;1,0;11,0;7,0;;1,0;;;2,0;;;;;;3,0;3,0;2,0;;;;2,0;;;;;4,0;;9,0;;;;;;;1,0;;;;;;3,0;;;;;;;;1,0;;;;;;;1,0;2,0;9,0;;;;;;;12,0;8,0;;2,0;3,0;;;;;1,0;;;2,0;;;;;;;;;10,0;;;;;2,0;;;;;1,0;;4,0;;;;3,0;;;;14,0;;;;;;;2,0;;;;4,0;;;;;;;;;;;1,0;;;;;;;;;;;2,0;1,0;;;;;;;;13,0;;;;;2,0;;1,0;;;;;;3,0;;;1,0;;;2,0;;1,0;;;;1,0;;;;;7,0;;1,0;;;;;;;;2,0;;;;4,0;;1,0;3,0;;;;;;;;1,0;;1,0;;;;;2,0;;;;;;;;;;;;;;;;;;;;;;;2,0;;9,0;;;;;;5,0;1,0;5,0;;;2,0;;;3,0;;3,0;;;1,0;;;;;1,0;6,0;;;3,0;;;;;7,0;;;;;;;;;;;;;;;;;11,0;;;;;;1,0;10,0;;;;;;;;;;;;;;;;;;;;;;;;;;3,0;;;;;;6,0;;;;;;;;;;;;;;;;;;;;;3,0;;;;;;;;;;;;;;;;34,0;;;;;;;;;;;;;5,0;;;;;;;;;;;;;;;15,0;;;;;;;;;;;;;;;;;;;;;;;;;;6,0;4,0;;;;;;;;;;;;;;;;;;;;;;;;;;;3,0;;;;;17,0;;;;;;;;;;;;;;;;;2,0;;;;;;;;2,0;;;;;;;;;
ring;;9,0;;26,0;6,0;36,0;5,0;123,0;;;2,0;;38,0;118,0;;;20,0;;9,0;5,0;10,0;;85,0;2,0;;;;13,0;1,0;3,0;51,0;1,0;2,0;;1,0;3,0;23,0;21,0;1,0;;7,0;107,0;43,0;2,0;10,0;105,0;;71,0;;;1,0;;25,0;14,0;;;132,0;;2,0;5,0;;;17,0;;27,0;;184,0;16,0;;7,0;160,0;257,0;14,0;2,0;;;47,0;1,0;;9,0;56,0;;3,0;;46,0;9,0;;73,0;2,0;;1,0;3,0;1,0;23,0;4,0;;8,0;4,0;93,0;5,0;117,0;6,0;;;;1,0;;;;;;2,0;25,0;5,0;;;;16,0;;18,0;;2,0;1,0;6,0;;4,0;44,0;1,0;;10,0;7,0;;6,0;34,0;23,0;;8,0;2,0;15,0;1,0;6,0;18,0;;;25,0;10,0;8,0;33,0;4,0;51,0;11,0;5,0;97,0;34,0;8,0;;21,0;;1,0;3,0;10,0;61,0;2,0;1,0;;;103,0;33,0;5,0;6,0;8,0;;1,0;61,0;64,0;52,0;;4,0;1,0;;;1,0;11,0;57,0;;12,0;127,0;7,0;54,0;52,0;;;24,0;28,0;43,0;18,0;80,0;;287,0;10,0;2,0;53,0;16,0;3,0;;;114,0;6,0;;187,0;11,0;22,0;2,0;;1,0;206,0;5,0;14,0;8,0;2,0;3,0;;;;31,0;;165,0;6,0;8,0;1,0;14,0;3,0;4,0;;29,0;;;3,0;4,0;15,0;;;56,0;20,0;83,0;6,0;10,0;85,0;119,0;6,0;13,0;23,0;;25,0;15,0;;58,0;162,0;35,0;;19,0;;22,0;1,0;52,0;;27,0;;;18,0;;1,0;11,0;10,0;25,0;14,0;18,0;12,0;5,0;2,0;18,0;2,0;73,0;5,0;;2,0;2,0;100,0;1,0;29,0;26,0;5,0;8,0;27,0;18,0;1,0;17,0;2,0;15,0;50,0;60,0;8,0;5,0;;5,0;9,0;4,0;9,0;6,0;15,0;4,0;;22,0;1,0;7,0;;20,0;51,0;11,0;19,0;4,0;3,0;15,0;5,0;6,0;12,0;1,0;10,0;1,0;;13,0;1,0;;27,0;3,0;4,0;18,0;3,0;2,0;4,0;134,0;111,0;10,0;21,0;6,0;45,0;16,0;15,0;3,0;47,0;;7,0;;;2,0;4,0;8,0;19,0;1,0;2,0;;;;;;16,0;;2,0;;;32,0;;2,0;19,0;5,0;;2,0;;;;46,0;15,0;;;1,0;17,0;;;;2,0;;;1,0;106,0;5,0;2,0;;4,0;7,0;;;;3,0;2,0;2,0;9,0;;;3,0;12,0;6,0;16,0;;12,0;55,0;6,0;;1,0;;;;;;1,0;1,0;26,0;1,0;4,0;;1,0;;;6,0;2,0;;1,0;6,0;5,0;12,0;;;13,0;9,0;1,0;;1,0;;;1,0;;;;;12,0;3,0;1,0;1,0;4,0;1,0;4,0;;3,0;;;;;;;;;4,0;9,0;;;13,0;4,0;1,0;6,0;;1,0;15,0;3,0;;4,0;;1,0;4,0;;;;;;2,0;9,0;;;;1,0;;;;;2,0;;;2,0;3,0;2,0;;;;;1,0;;1,0;;;4,0;1,0;4,0;12,0;2,0;1,0;2,0;;;;;;;24,0;;8,0;36,0;1,0;;6,0;;6,0;8,0;;52,0;2,0;162,0;;1,0;;4,0;;;;1,0;;;;1,0;;1,0;;;;2,0;2,0;11,0;;;;;;1,0;;1,0;;14,0;36,0;12,0;;3,0;33,0;1,0;;;;39,0;;11,0;37,0;;;;;;;3,0;;;;;;1,0;;;;4,0;;;2,0;5,0;;1,0;;;3,0;;;;;2,0;;1,0;;;19,0;;;2,0;1,0;;;;;;1,0;9,0;1,0;;;3,0;5,0;;1,0;;3,0;2,0;;3,0;;5,0;;;;;;;;1,0;;;;3,0;;;;;1,0;1,0;;;7,0;1,0;7,0;;3,0;;;;;28,0;3,0;;;;;3,0;;;1,0;6,0;6,0;;;5,0;;;5,0;75,0;3,0;1,0;2,0;4,0;2,0;;;21,0;21,0;3,0;10,0;20,0;3,0;;2,0;5,0;;;7,0;4,0;;2,0;6,0;8,0;;;3,0;;5,0;8,0;3,0;2,0;;;;;;;24,0;;1,0;1,0;2,0;;;7,0;1,0;21,0;;;;3,0;7,0;;6,0;1,0;7,0;;;2,0;;54,0;5,0;;27,0;4,0;;6,0;;;;;6,0;4,0;;6,0;8,0;;1,0;9,0;4,0;21,0;3,0;2,0;;3,0;12,0;;2,0;;2,0;153,0;;;;;;;;25,0;;9,0;;;;;5,0;;14,0;;;;21,0;;;;;;;;;;;;;;;;;;5,0;;;29,0;;;;;;;12,0;1,0;2,0;;;2,0;;;;;;;;;2,0;;6,0;;;;;;;5,0;;;;;;;;1,0;1,0;;2,0;;;;;;;;;;;;;1,0;;;3,0;;;;;5,0;4,0;;;;28,0;;;;;;;;3,0;3,0;12,0;;3,0;;2,0;;;1,0;;12,0;1,0;;;;;;3,0;;;;1,0;5,0;;12,0;;1,0;;10,0;;9,0;6,0;;;;;;;2,0;;4,0;;;26,0;4,0;;14,0;9,0;;;;4,0;;;;10,0;;;;2,0;1,0;;;2,0;;;;11,0;;;17,0;;;;;1,0;;;;2,0;;;;;;;;;2,0;;;24,0;;;
rotate;;3,0;;50,0;27,0;58,0;18,0;196,0;4,0;;3,0;;28,0;193,0;;5,0;35,0;;;;1,0;5,0;6,0;;7,0;;1,0;95,0;6,0;6,0;277,0;31,0;2,0;2,0;;30,0;13,0;116,0;;;29,0;216,0;3,0;7,0;61,0;33,0;;88,0;2,0;;1,0;;22,0;8,0;22,0;4,0;26,0;15,0;4,0;15,0;1,0;;16,0;1,0;300,0;;109,0;;1,0;8,0;14,0;128,0;33,0;2,0;3,0;1,0;4,0;14,0;3,0;2,0;106,0;;22,0;3,0;90,0;67,0;;114,0;2,0;5,0;5,0;3,0;9,0;2,0;8,0;;2,0;61,0;76,0;58,0;339,0;45,0;4,0;6,0;16,0;39,0;;4,0;;;3,0;19,0;2,0;1,0;3,0;;4,0;26,0;4,0;50,0;4,0;6,0;35,0;3,0;;4,0;106,0;;5,0;;9,0;;3,0;294,0;1,0;;38,0;3,0;12,0;;5,0;6,0;;1,0;7,0;16,0;17,0;29,0;22,0;19,0;34,0;5,0;159,0;6,0;;;10,0;;;;;58,0;;1,0;;;66,0;41,0;;2,0;69,0;;11,0;410,0;11,0;6,0;3,0;;11,0;;;;2,0;42,0;22,0;5,0;57,0;32,0;75,0;45,0;2,0;4,0;2,0;43,0;25,0;19,0;97,0;7,0;25,0;6,0;;;23,0;3,0;8,0;4,0;373,0;;165,0;175,0;44,0;26,0;2,0;;;16,0;16,0;43,0;;19,0;2,0;4,0;;16,0;41,0;;103,0;4,0;17,0;5,0;16,0;8,0;21,0;2,0;20,0;2,0;14,0;;2,0;;;134,0;60,0;26,0;;5,0;11,0;16,0;36,0;21,0;9,0;;;57,0;10,0;7,0;91,0;74,0;3,0;;6,0;15,0;3,0;32,0;14,0;;3,0;;;5,0;;12,0;11,0;7,0;8,0;;75,0;148,0;5,0;;14,0;2,0;442,0;10,0;3,0;9,0;7,0;20,0;2,0;5,0;2,0;13,0;7,0;18,0;6,0;6,0;7,0;23,0;13,0;43,0;4,0;2,0;;;1,0;16,0;13,0;32,0;1,0;41,0;5,0;12,0;5,0;;19,0;29,0;28,0;25,0;15,0;71,0;8,0;64,0;31,0;2,0;3,0;3,0;1,0;3,0;19,0;;7,0;;7,0;8,0;14,0;;9,0;2,0;;14,0;;272,0;68,0;23,0;4,0;30,0;15,0;10,0;2,0;14,0;11,0;10,0;;;7,0;16,0;7,0;26,0;17,0;;1,0;;;5,0;;16,0;;20,0;;4,0;44,0;;15,0;34,0;20,0;2,0;1,0;2,0;2,0;3,0;159,0;29,0;;7,0;5,0;23,0;5,0;2,0;;;;4,0;;17,0;3,0;13,0;;5,0;2,0;;;15,0;6,0;1,0;9,0;4,0;;2,0;18,0;209,0;20,0;37,0;;5,0;35,0;40,0;;3,0;1,0;;;7,0;6,0;;;73,0;4,0;16,0;5,0;14,0;8,0;;6,0;2,0;31,0;5,0;3,0;24,0;42,0;2,0;;2,0;3,0;50,0;4,0;6,0;1,0;5,0;58,0;5,0;;;17,0;11,0;26,0;;;26,0;2,0;;4,0;;;5,0;1,0;12,0;;;1,0;1,0;2,0;7,0;16,0;10,0;;44,0;13,0;11,0;1,0;4,0;49,0;;14,0;5,0;6,0;3,0;15,0;1,0;5,0;21,0;;5,0;;3,0;1,0;1,0;9,0;;;1,0;;3,0;3,0;9,0;;54,0;;;;;1,0;;8,0;;;3,0;1,0;9,0;;;17,0;15,0;1,0;2,0;;;6,0;;3,0;;146,0;7,0;4,0;27,0;73,0;;2,0;;3,0;4,0;;3,0;;23,0;;14,0;;1,0;;22,0;2,0;;1,0;;;4,0;;;5,0;;;5,0;3,0;1,0;1,0;3,0;5,0;;;;;;;31,0;15,0;1,0;;;5,0;1,0;3,0;;13,0;7,0;11,0;6,0;30,0;;7,0;2,0;;1,0;;5,0;1,0;;3,0;;;1,0;;3,0;;2,0;;;2,0;6,0;;;1,0;;;;1,0;43,0;;;;6,0;;;;;;;2,0;1,0;;4,0;2,0;;;;1,0;;;6,0;30,0;2,0;3,0;4,0;15,0;18,0;;1,0;1,0;14,0;;;;;;;;7,0;3,0;;7,0;4,0;2,0;2,0;;;12,0;;;15,0;9,0;;6,0;;5,0;;4,0;;3,0;7,0;29,0;2,0;1,0;4,0;1,0;7,0;;3,0;3,0;;7,0;1,0;;28,0;;;3,0;28,0;7,0;;1,0;;;9,0;3,0;158,0;133,0;9,0;4,0;;;;1,0;9,0;1,0;;5,0;;;6,0;1,0;;;;;;;6,0;50,0;3,0;4,0;15,0;;;5,0;17,0;133,0;;;153,0;2,0;;6,0;;4,0;9,0;2,0;;31,0;5,0;7,0;;27,0;1,0;1,0;;;;;36,0;3,0;1,0;5,0;1,0;;1,0;3,0;3,0;;2,0;4,0;;19,0;8,0;3,0;25,0;4,0;15,0;;8,0;6,0;6,0;;;20,0;;2,0;2,0;15,0;2,0;;;;;1,0;;;;;;;;;;;14,0;;;;;2,0;1,0;;;;;3,0;;;;;;;;;;;;;1,0;;;;;;;8,0;;;2,0;;;;2,0;;5,0;;3,0;;;1,0;;;2,0;2,0;;;;1,0;;2,0;5,0;;1,0;1,0;1,0;;;;2,0;;;;;;2,0;1,0;;;;1,0;;18,0;;;1,0;;;;;3,0;;;1,0;;;;;6,0;;5,0;;;;1,0;;9,0;;;;1,0;;;;1,0;;15,0;;4,0;;;44,0;;1,0;47,0;;;2,0;2,0;;2,0;;;10,0;27,0;1,0;;8,0;15,0;;1,0;14,0;;;;;;;;;32,0;4,0;1,0;;1,0;;;;;;;;3,0;;2,0;;20,0;;;;;;15,0;;2,0;;;;;;;;2,0;2,0;18,0;;;;;;;;;;;;7,0;;;1,0;;
rotation;;24,0;1,0;26,0;127,0;60,0;40,0;55,0;5,0;;10,0;;31,0;332,0;;2,0;40,0;;2,0;2,0;;4,0;1,0;5,0;13,0;8,0;26,0;32,0;7,0;7,0;236,0;34,0;33,0;25,0;;66,0;51,0;69,0;10,0;;167,0;239,0;2,0;22,0;92,0;14,0;2,0;43,0;3,0;7,0;30,0;;32,0;1,0;1,0;5,0;27,0;16,0;;53,0;;;6,0;;281,0;;140,0;5,0;;5,0;17,0;98,0;24,0;;2,0;3,0;3,0;10,0;3,0;3,0;151,0;;13,0;5,0;116,0;88,0;;109,0;;25,0;44,0;;4,0;5,0;6,0;;23,0;48,0;69,0;47,0;176,0;31,0;;7,0;17,0;32,0;;;3,0;;2,0;25,0;6,0;1,0;1,0;9,0;1,0;28,0;3,0;126,0;6,0;2,0;62,0;6,0;;5,0;84,0;3,0;;;24,0;;10,0;233,0;4,0;;18,0;52,0;20,0;;4,0;5,0;1,0;;9,0;29,0;39,0;19,0;14,0;8,0;18,0;;46,0;;;3,0;;;;1,0;;50,0;;6,0;;4,0;48,0;39,0;;42,0;52,0;2,0;6,0;424,0;58,0;7,0;5,0;2,0;21,0;10,0;;1,0;2,0;16,0;12,0;;4,0;30,0;73,0;12,0;5,0;1,0;;44,0;13,0;12,0;128,0;;11,0;2,0;;;70,0;5,0;63,0;9,0;342,0;;55,0;95,0;31,0;45,0;10,0;;1,0;3,0;8,0;28,0;;9,0;26,0;1,0;;2,0;26,0;;160,0;2,0;20,0;22,0;;13,0;47,0;8,0;6,0;6,0;2,0;;;27,0;;111,0;130,0;6,0;2,0;13,0;6,0;6,0;20,0;4,0;16,0;;;42,0;;;72,0;62,0;1,0;;5,0;31,0;3,0;30,0;6,0;;38,0;;7,0;5,0;;4,0;8,0;6,0;1,0;19,0;37,0;722,0;3,0;5,0;17,0;1,0;721,0;4,0;;10,0;13,0;24,0;3,0;;3,0;6,0;;3,0;;10,0;41,0;11,0;5,0;36,0;7,0;6,0;;2,0;7,0;2,0;14,0;27,0;8,0;50,0;6,0;4,0;6,0;4,0;16,0;8,0;27,0;20,0;4,0;73,0;39,0;55,0;21,0;;;;;4,0;2,0;1,0;10,0;9,0;;6,0;11,0;;7,0;2,0;60,0;21,0;272,0;;64,0;48,0;;16,0;5,0;13,0;;49,0;13,0;;;;34,0;30,0;6,0;10,0;29,0;;;5,0;2,0;2,0;;30,0;1,0;35,0;1,0;3,0;8,0;1,0;88,0;48,0;59,0;14,0;;34,0;9,0;1,0;154,0;67,0;;10,0;5,0;140,0;;7,0;;5,0;11,0;1,0;;22,0;1,0;13,0;;17,0;7,0;2,0;;14,0;13,0;6,0;6,0;39,0;1,0;2,0;39,0;150,0;13,0;39,0;;10,0;138,0;55,0;13,0;36,0;;1,0;;5,0;;1,0;;47,0;6,0;27,0;;42,0;32,0;2,0;14,0;1,0;118,0;10,0;10,0;15,0;21,0;4,0;;28,0;6,0;85,0;12,0;5,0;206,0;4,0;9,0;1,0;;;15,0;5,0;5,0;;20,0;45,0;29,0;;28,0;;6,0;5,0;7,0;2,0;3,0;;2,0;;;2,0;10,0;4,0;;2,0;19,0;11,0;1,0;;35,0;;16,0;2,0;7,0;26,0;102,0;4,0;4,0;11,0;4,0;;1,0;;5,0;3,0;15,0;;;2,0;2,0;1,0;;11,0;52,0;39,0;1,0;1,0;;;;5,0;7,0;;;5,0;;6,0;1,0;1,0;3,0;25,0;;;;;6,0;;2,0;;50,0;4,0;1,0;23,0;41,0;;;1,0;3,0;19,0;;1,0;4,0;14,0;3,0;10,0;;;;18,0;1,0;;;;;;;;;;1,0;17,0;1,0;4,0;2,0;;1,0;;1,0;;;;;17,0;4,0;1,0;;;1,0;2,0;2,0;;8,0;3,0;1,0;;93,0;;2,0;;;;;3,0;5,0;;3,0;;;;;;;14,0;;;1,0;1,0;;;5,0;1,0;2,0;;;16,0;1,0;3,0;2,0;8,0;2,0;;;4,0;;;9,0;;;8,0;7,0;;;3,0;;;;28,0;49,0;5,0;;10,0;3,0;19,0;;2,0;;5,0;;;;;7,0;;;8,0;;14,0;;7,0;2,0;10,0;;;6,0;;;2,0;2,0;;4,0;;1,0;;;1,0;;;56,0;;1,0;2,0;;3,0;;;1,0;4,0;1,0;;;38,0;3,0;5,0;1,0;54,0;1,0;3,0;1,0;26,0;;;6,0;142,0;91,0;1,0;10,0;2,0;2,0;1,0;5,0;5,0;;;2,0;5,0;;2,0;6,0;21,0;;1,0;;;4,0;5,0;20,0;5,0;6,0;;;;;1,0;196,0;;22,0;117,0;10,0;;;6,0;4,0;9,0;1,0;1,0;16,0;;1,0;;1,0;;2,0;;;;;6,0;;12,0;5,0;7,0;;3,0;;2,0;;;;1,0;6,0;2,0;7,0;4,0;;12,0;;2,0;8,0;9,0;;;2,0;;;10,0;3,0;1,0;;;;;14,0;2,0;;;;1,0;;;;;1,0;4,0;;;;;3,0;193,0;;;;;;8,0;;;;;1,0;16,0;;;;15,0;;9,0;;;;;9,0;;;;;;6,0;;;1,0;;;;1,0;;;;;;11,0;2,0;3,0;2,0;;11,0;;;1,0;;;8,0;;;;;;;;;7,0;5,0;1,0;;;2,0;1,0;19,0;;27,0;;;;;6,0;;;;;;;3,0;;;;5,0;;6,0;3,0;;4,0;2,0;;;3,0;;;2,0;;;;;;35,0;;4,0;;;14,0;;4,0;30,0;;;3,0;11,0;;;1,0;1,0;5,0;10,0;2,0;;3,0;3,0;;;11,0;2,0;;7,0;;;;;;24,0;;2,0;;2,0;2,0;;;;;;;6,0;;2,0;;;;;3,0;;;3,0;;;;;;;;;;20,0;2,0;22,0;;3,0;;;;1,0;;1,0;1,0;;;;;3,0;;;
scanner;;1,0;;;;4,0;;7,0;;;;;;6,0;;;16,0;2,0;;;;;5,0;;;;;;10,0;;56,0;6,0;;;;;;6,0;10,0;;11,0;45,0;;9,0;;3,0;;2,0;;;;;2,0;5,0;6,0;;8,0;5,0;;1,0;;;;2,0;42,0;1,0;37,0;;;;;;31,0;;;;;10,0;;1,0;27,0;;2,0;1,0;;;;38,0;;;3,0;;5,0;;;;;;10,0;19,0;36,0;;;;1,0;51,0;1,0;2,0;;;;6,0;4,0;;;;;;;3,0;;;28,0;;;;60,0;;;;1,0;2,0;;1,0;;;10,0;;;;;;;;;;5,0;5,0;4,0;8,0;;;;;;;;;;;;;;;;;9,0;;;1,0;;;1,0;1,0;;;;5,0;;;;3,0;;;;2,0;;;8,0;;;;;;;;7,0;;;;;;;;19,0;;;;5,0;9,0;10,0;;;;;;2,0;;;;18,0;;;;;;4,0;;;6,0;;;;;;;4,0;;;;;;;;;;3,0;1,0;;;;;;11,0;;;3,0;12,0;;;;;10,0;;;;;;;13,0;;;;;;;;3,0;;;;;17,0;;;;;;;;;;;;;;;;;;;;;;;;;;;8,0;;;;;;;14,0;;;2,0;2,0;27,0;;;;;;;;;;;;;;;;;;;2,0;2,0;4,0;;;;;4,0;;;;;;;;5,0;;;;;;;;;;;;;1,0;;;;;19,0;;;4,0;;1,0;;8,0;31,0;;;;1,0;;;;;;;;;;;;1,0;;;;;;;;;;;1,0;3,0;10,0;8,0;;3,0;;14,0;1,0;;;;;;;1,0;1,0;19,0;5,0;5,0;4,0;;;;2,0;;;;;1,0;;;;;;;;1,0;;;1,0;;;;;;;1,0;;;;;1,0;2,0;;2,0;6,0;;;;;;;;1,0;;;;55,0;;;;;;;5,0;3,0;;6,0;;;;;;;3,0;;;1,0;3,0;;;;;;;;5,0;;;;;1,0;;;3,0;;;;;;;;7,0;;;3,0;;;;;;;;;;2,0;;;2,0;;;;;;;;;;;;;;;;;;;;;;;;2,0;;;;;;;5,0;4,0;;;;;;;;;;;;;7,0;;5,0;;;;20,0;;;;;;;;;;;;;3,0;;;;;;;;;;;;;;;;;;;;;;;;;;;;;;;;5,0;;;;;;;1,0;;;12,0;;2,0;;;;2,0;4,0;;2,0;19,0;;;;;1,0;;;5,0;;;;;;;;;12,0;2,0;1,0;;;;;;1,0;;;;;;;;2,0;;;;;;;;;;;;1,0;3,0;;;;;;;;;;;;;;1,0;1,0;6,0;;;;;;;;;;;;10,0;30,0;;;;;;4,0;;;;;;;;;;;;;1,0;;;;;;;;;;;;;;;;;;;;;;;;;2,0;;;2,0;;;;;;;;;;;;;;;;;;;;;;;;;;;;;;;;;;;;;;;;;;;;;;;;;;;;;;;;;;;;;;2,0;;1,0;;;;;;;;;;;;;;;;;;1,0;;;;;2,0;;;;;;;;;;;13,0;;;;;;2,0;;;;;;;;;;;1,0;;;;;;;;1,0;;1,0;;;;;;;;;;;;;;;;;;;4,0;;;2,0;;;;;;;;;;;;;;;;2,0;;;2,0;;;;;;;;;;;;;;;;;;;;;;;;;;;;;;;;1,0;;;;;;;;;;;16,0;;;;;;;;;;;;;;;
screw;;3,0;;4,0;;21,0;;73,0;;;;1,0;25,0;36,0;;;;;7,0;;;;;1,0;;;;118,0;;;79,0;;;;;;20,0;10,0;2,0;5,0;;86,0;26,0;;;21,0;;22,0;;;;;21,0;8,0;;;54,0;9,0;;;1,0;;;;5,0;;110,0;1,0;;4,0;10,0;59,0;3,0;;;;;;;;13,0;;;;31,0;9,0;;3,0;;2,0;;1,0;45,0;;;;;;21,0;;57,0;7,0;;;;;;;;;;;8,0;;;;;2,0;;6,0;;;;3,0;;;46,0;;4,0;1,0;;;;12,0;;2,0;;;;;6,0;;;;4,0;8,0;;4,0;4,0;16,0;8,0;7,0;46,0;17,0;;;5,0;;;;;20,0;;;;;53,0;2,0;1,0;;;;2,0;38,0;4,0;;;;4,0;;;;;4,0;96,0;;;6,0;18,0;11,0;;1,0;;1,0;19,0;364,0;28,0;;28,0;48,0;;1,0;;;1,0;;106,0;3,0;;130,0;9,0;6,0;1,0;;;21,0;;2,0;1,0;;;;;;25,0;4,0;136,0;1,0;1,0;;12,0;;20,0;;10,0;;;;4,0;;;21,0;10,0;4,0;7,0;1,0;2,0;5,0;33,0;;6,0;3,0;;235,0;;;20,0;77,0;17,0;;;;2,0;1,0;11,0;;;;;2,0;;;5,0;2,0;3,0;;3,0;2,0;3,0;;11,0;;46,0;21,0;;;1,0;1,0;3,0;;;5,0;10,0;1,0;;1,0;5,0;5,0;2,0;36,0;39,0;;;;;5,0;;20,0;2,0;;;6,0;3,0;1,0;2,0;6,0;25,0;31,0;2,0;17,0;2,0;5,0;4,0;;;;;4,0;3,0;2,0;18,0;4,0;1,0;2,0;;;2,0;;;;23,0;48,0;8,0;;2,0;14,0;2,0;7,0;4,0;21,0;;1,0;;;1,0;3,0;1,0;14,0;;;;;;;;7,0;;;;;6,0;2,0;;3,0;;;;;;;3,0;;;5,0;;;;;;;;;;2,0;2,0;;4,0;;;;;;;;1,0;5,0;;;13,0;12,0;8,0;4,0;;;;5,0;;;;;;;;;;66,0;;1,0;;;;;;;1,0;;;;;;;4,0;;1,0;;;;8,0;1,0;;;;1,0;;9,0;;;;1,0;3,0;;2,0;;;;;;;;;;;;;1,0;7,0;;;;;;;;1,0;;22,0;;;;;;;;;;;;;;;;;3,0;;;6,0;;;;;;;;;;;;;;;14,0;2,0;;1,0;;;6,0;2,0;;;1,0;;2,0;8,0;;;;;1,0;41,0;;;3,0;15,0;;;;3,0;;;6,0;6,0;;;;;;;29,0;;25,0;;1,0;;;;;;;;;2,0;;9,0;16,0;;;;5,0;;;;;4,0;;;40,0;;;;;;;;;;;;;;;;;;;;;;;;;;;;;3,0;;;1,0;;;;;;;;;;;;;;2,0;5,0;;;;4,0;;;;;2,0;1,0;;;;1,0;;;;;;;;2,0;;;;1,0;;;;;;;;;11,0;;;;1,0;;;;;;;;1,0;;;;;;;;1,0;;;20,0;;;;6,0;;2,0;1,0;7,0;;;;37,0;1,0;2,0;16,0;1,0;;;;;1,0;;4,0;2,0;;;;2,0;;1,0;;;;;;;1,0;;;;;;7,0;;1,0;7,0;;2,0;;4,0;;346,0;59,0;;;;;;27,0;28,0;5,0;;;1,0;;1,0;1,0;;;;;;2,0;;1,0;;;;;2,0;;;1,0;;;2,0;;8,0;;;4,0;;1,0;;;1,0;;;;;;;;;;;;;;;;;;;;;;;;;;;;;;;;;;;;;;;;;;;;;;;;4,0;1,0;;;;;;;;;;;;;;;;;;;;;;;;;;;;;;;;;;;;;;;;;;;;2,0;1,0;;;;;;;;3,0;;2,0;;;;;;;;;;;;;;;1,0;;3,0;;;;;1,0;141,0;;11,0;;;;;1,0;;;;;;;;;;6,0;1,0;;;5,0;;;;2,0;;;;;;;4,0;;;;;;;;;;;;;;18,0;;;;;;;;;;;;;;;;;;;;;;;;;;;;;;;1,0;;;;;;;;
secure;;11,0;;5,0;;32,0;;161,0;;;;7,0;33,0;144,0;;;9,0;;22,0;;;;2,0;8,0;5,0;;;70,0;1,0;2,0;174,0;;;6,0;;14,0;11,0;3,0;3,0;1,0;4,0;131,0;2,0;14,0;20,0;16,0;;86,0;;;;3,0;26,0;28,0;;1,0;23,0;;1,0;2,0;;;2,0;;44,0;5,0;57,0;2,0;3,0;6,0;6,0;187,0;15,0;;;;28,0;;3,0;17,0;74,0;;;7,0;110,0;10,0;;43,0;;13,0;;4,0;4,0;;6,0;;;;64,0;24,0;73,0;2,0;1,0;7,0;11,0;46,0;;;;;;;9,0;4,0;13,0;;;17,0;3,0;65,0;1,0;;8,0;2,0;;5,0;90,0;;1,0;1,0;;;5,0;13,0;1,0;;11,0;;;;1,0;5,0;;;50,0;1,0;74,0;14,0;5,0;18,0;;15,0;118,0;34,0;;;;1,0;;;12,0;15,0;;;;;49,0;58,0;;5,0;6,0;;4,0;23,0;;17,0;;;20,0;;;;2,0;5,0;76,0;1,0;16,0;8,0;47,0;24,0;6,0;4,0;;8,0;17,0;32,0;290,0;;9,0;10,0;;3,0;;1,0;;;173,0;2,0;6,0;323,0;9,0;9,0;1,0;;3,0;11,0;;4,0;4,0;4,0;;;;;103,0;6,0;216,0;6,0;6,0;5,0;2,0;;;;27,0;;;;40,0;;2,0;45,0;8,0;15,0;6,0;13,0;1,0;26,0;45,0;20,0;9,0;4,0;;96,0;19,0;;64,0;195,0;11,0;;1,0;;2,0;29,0;20,0;4,0;;;8,0;9,0;2,0;9,0;6,0;18,0;24,0;;15,0;20,0;5,0;4,0;59,0;;14,0;22,0;1,0;4,0;2,0;5,0;18,0;11,0;;20,0;2,0;10,0;;20,0;4,0;2,0;1,0;28,0;11,0;33,0;40,0;;14,0;14,0;24,0;45,0;2,0;20,0;1,0;1,0;7,0;26,0;1,0;9,0;6,0;24,0;5,0;100,0;16,0;13,0;13,0;5,0;9,0;;;1,0;1,0;4,0;17,0;8,0;15,0;27,0;7,0;;8,0;2,0;;;30,0;16,0;4,0;14,0;5,0;;32,0;10,0;4,0;14,0;;45,0;;;14,0;3,0;3,0;11,0;16,0;3,0;3,0;;;;1,0;9,0;;;;;1,0;;;8,0;;;;1,0;1,0;;5,0;;;;3,0;8,0;;;;3,0;;;2,0;6,0;1,0;;;5,0;;;;2,0;6,0;3,0;1,0;10,0;;15,0;4,0;3,0;2,0;;;4,0;1,0;11,0;;;;;;;;;;91,0;13,0;1,0;;;;4,0;;3,0;2,0;;5,0;;39,0;;;;;1,0;;;;;24,0;;;;1,0;21,0;15,0;5,0;;2,0;9,0;;;1,0;;21,0;;;;;;;;;;23,0;12,0;11,0;;3,0;;;6,0;;2,0;3,0;;;1,0;1,0;5,0;;;;;1,0;8,0;;;12,0;;1,0;;1,0;9,0;1,0;;;1,0;2,0;;;;;25,0;;;;2,0;26,0;8,0;;12,0;6,0;;3,0;;;21,0;14,0;;;;;16,0;26,0;;;;11,0;1,0;;;;3,0;19,0;;;1,0;;4,0;;1,0;7,0;;;4,0;3,0;;12,0;;;;6,0;5,0;;;;;;9,0;;1,0;;;30,0;16,0;7,0;;;;;1,0;1,0;5,0;9,0;3,0;22,0;48,0;1,0;;1,0;;2,0;;;20,0;;;2,0;2,0;8,0;;;;2,0;;1,0;;1,0;;;;;;7,0;5,0;18,0;14,0;8,0;;;;;;1,0;;;;;;;2,0;;5,0;;;;;4,0;;;1,0;;2,0;5,0;;3,0;;3,0;;;;;;;5,0;5,0;1,0;1,0;3,0;;;;3,0;;8,0;;;;6,0;;15,0;5,0;;2,0;;;;;1,0;;;5,0;;;3,0;14,0;1,0;3,0;2,0;;;33,0;;;5,0;4,0;;8,0;5,0;21,0;;;;17,0;4,0;9,0;7,0;3,0;8,0;;;5,0;8,0;;1,0;2,0;;2,0;3,0;;;;10,0;;;6,0;6,0;;;;3,0;;2,0;1,0;20,0;;3,0;7,0;;2,0;;26,0;;19,0;;;;;;;3,0;;1,0;2,0;;;;;3,0;;8,0;;8,0;1,0;24,0;2,0;;;;5,0;;;;2,0;;;3,0;;1,0;17,0;8,0;;;1,0;14,0;;1,0;2,0;;;;;;;;;;;;;;;;;1,0;;;;2,0;;;;;;;;;2,0;;1,0;1,0;;;;2,0;;;;;;;;;;;;1,0;18,0;3,0;;;;;;;;;;;7,0;1,0;;;;;;1,0;;;;1,0;;;;;;;6,0;1,0;1,0;;;5,0;;;;;;;1,0;3,0;;;;;1,0;;;;2,0;2,0;8,0;;;;1,0;;;10,0;;2,0;5,0;;;;;;;2,0;;;;;;;;;;;;;;2,0;;;;2,0;;;;;1,0;4,0;2,0;;2,0;;;;;;;;9,0;;4,0;;;;;;1,0;;;1,0;;;;;;33,0;;;;;;;;1,0;;;;37,0;4,0;;;;;;;;;;;;;;;;;;1,0;;;;4,0;;;;
security;;1,0;;4,0;;38,0;;15,0;;;;;;29,0;;;8,0;2,0;2,0;;;;;4,0;14,0;;;2,0;7,0;4,0;40,0;7,0;;;;54,0;;1,0;1,0;;11,0;72,0;;4,0;7,0;;;8,0;;;;;3,0;4,0;7,0;;7,0;;;16,0;;;1,0;;24,0;1,0;36,0;;3,0;;;51,0;58,0;;;;;;5,0;7,0;46,0;;1,0;;14,0;1,0;;24,0;;;7,0;;;;;;;9,0;91,0;;11,0;16,0;;2,0;9,0;10,0;2,0;;;;;;1,0;;;;;92,0;1,0;54,0;1,0;;7,0;1,0;;6,0;353,0;;;;3,0;;;16,0;;;38,0;5,0;;;;;;;5,0;;12,0;;53,0;5,0;;2,0;21,0;1,0;;;;;;;;7,0;7,0;1,0;;;4,0;16,0;;9,0;9,0;;3,0;;;1,0;1,0;;2,0;;1,0;3,0;;10,0;;;1,0;3,0;8,0;5,0;;;12,0;;3,0;5,0;26,0;;;5,0;;;5,0;;2,0;1,0;6,0;;;27,0;;5,0;2,0;;;2,0;;3,0;;;6,0;2,0;4,0;;5,0;;31,0;;1,0;;;;1,0;;2,0;;;;1,0;;;1,0;1,0;;12,0;;;2,0;1,0;;2,0;;;1,0;;1,0;5,0;8,0;;;;10,0;;34,0;5,0;;;;;1,0;;;2,0;;6,0;;;2,0;;6,0;;2,0;2,0;;;;;;;;;;;;;;2,0;;;;;3,0;;;2,0;;;10,0;;;;1,0;;;;;5,0;1,0;;3,0;;14,0;2,0;;8,0;;;;26,0;;;;;;8,0;;1,0;;1,0;;;;;;1,0;12,0;;1,0;;;;;;;5,0;2,0;;;34,0;1,0;;;4,0;;;;1,0;;;;;;;;11,0;;;1,0;;;25,0;;2,0;5,0;;36,0;6,0;;;35,0;2,0;7,0;;1,0;1,0;9,0;;11,0;9,0;1,0;;5,0;3,0;9,0;;;;12,0;42,0;;;2,0;;2,0;5,0;13,0;;;;;;1,0;;;2,0;20,0;12,0;19,0;10,0;;1,0;3,0;1,0;;;;4,0;;;;;;2,0;;1,0;2,0;;;15,0;;;1,0;14,0;5,0;;;;;;2,0;11,0;;;;;;;;2,0;;2,0;;10,0;9,0;1,0;;;26,0;;;;;;3,0;;;4,0;;2,0;;;5,0;;;;;2,0;;4,0;;;8,0;;;;;;1,0;;1,0;3,0;;;2,0;;1,0;;;1,0;1,0;3,0;7,0;;;;;;4,0;;1,0;;2,0;;;;;;4,0;;1,0;;1,0;;4,0;;;;;3,0;;;;11,0;13,0;7,0;;;;;;;;7,0;1,0;;;9,0;;31,0;;;;;;;;;;;;;11,0;;6,0;1,0;2,0;;3,0;14,0;1,0;1,0;;;;3,0;;;1,0;1,0;;;4,0;2,0;1,0;1,0;;;1,0;;;1,0;;;;2,0;;1,0;2,0;;3,0;1,0;3,0;;2,0;3,0;;;;;;;;;10,0;1,0;;;2,0;1,0;;2,0;;;;;;2,0;;7,0;1,0;;;2,0;;;1,0;;5,0;;;3,0;4,0;13,0;15,0;1,0;;;;1,0;1,0;6,0;;;33,0;;1,0;;;;;1,0;1,0;6,0;1,0;;4,0;;;2,0;1,0;;7,0;;;;4,0;;;;;;;;;;;;2,0;;;;;;;;;;6,0;;;1,0;;;6,0;;;;;;3,0;;;;2,0;;;;;;;1,0;;;;;;;4,0;;;;;;;;;;;;;;;;;;3,0;;;;;;;;;;;;;1,0;1,0;;;;;;;;;;;;;;;;;;;;;;;;;;;;;;;;;;1,0;;;;2,0;;;;;;;;;;;;;;;;;2,0;;1,0;;;;;;;;;;;;1,0;;;;1,0;;;;;;;;;;;;;;;;;;;;;;;;;;;;;;10,0;;;;;;;;;;;;4,0;;;;;;2,0;;;;;;;;;;;;;2,0;;;;;;;;;;;;;;;;;;;;;1,0;;;;;;;4,0;;;;;;;;;;;1,0;;4,0;;;;;;;;;;;;;;;;;2,0;;;;;;;;;;;;;;;;;;;;;;;;;;;;
select;;7,0;5,0;40,0;35,0;113,0;75,0;12,0;;71,0;;46,0;;498,0;1,0;22,0;289,0;1,0;34,0;27,0;;;68,0;6,0;10,0;11,0;5,0;73,0;62,0;62,0;291,0;77,0;8,0;56,0;5,0;451,0;28,0;14,0;113,0;2,0;275,0;400,0;1,0;94,0;293,0;8,0;;97,0;;11,0;28,0;2,0;4,0;8,0;147,0;42,0;62,0;;24,0;106,0;2,0;9,0;666,0;9,0;1823,0;4,0;333,0;4,0;7,0;;15,0;169,0;130,0;;19,0;13,0;34,0;8,0;16,0;36,0;484,0;1,0;229,0;62,0;121,0;2,0;4,0;69,0;3,0;35,0;135,0;5,0;5,0;1,0;39,0;4,0;321,0;125,0;661,0;376,0;237,0;92,0;3,0;64,0;181,0;139,0;39,0;31,0;12,0;14,0;;212,0;301,0;11,0;;23,0;30,0;66,0;61,0;142,0;20,0;6,0;166,0;17,0;42,0;114,0;285,0;2,0;27,0;7,0;161,0;13,0;;195,0;2,0;;159,0;30,0;34,0;2,0;;28,0;4,0;2,0;16,0;19,0;189,0;23,0;116,0;10,0;2,0;112,0;22,0;1,0;70,0;9,0;;1,0;6,0;20,0;3,0;22,0;22,0;8,0;4,0;1,0;18,0;4,0;;36,0;19,0;6,0;20,0;65,0;;25,0;4,0;2,0;12,0;;1,0;6,0;;34,0;1,0;;70,0;2,0;367,0;9,0;18,0;2,0;3,0;15,0;5,0;5,0;42,0;6,0;1,0;1,0;;19,0;2,0;2,0;11,0;42,0;27,0;5,0;11,0;19,0;21,0;26,0;27,0;1,0;7,0;13,0;185,0;7,0;46,0;48,0;35,0;44,0;7,0;5,0;6,0;;147,0;;5,0;22,0;1,0;16,0;70,0;21,0;8,0;15,0;17,0;5,0;;27,0;8,0;6,0;4,0;;7,0;;9,0;26,0;41,0;2,0;2,0;1,0;4,0;10,0;8,0;2,0;8,0;87,0;7,0;;7,0;32,0;80,0;78,0;1,0;2,0;;52,0;20,0;29,0;;8,0;11,0;17,0;4,0;;41,0;71,0;11,0;26,0;9,0;9,0;17,0;10,0;67,0;;5,0;8,0;66,0;4,0;1,0;20,0;2,0;1,0;5,0;;130,0;10,0;5,0;;1,0;4,0;2,0;;1,0;;2,0;25,0;7,0;154,0;;;11,0;;5,0;5,0;30,0;;6,0;19,0;70,0;308,0;3,0;39,0;3,0;;1,0;;31,0;8,0;;;;;56,0;7,0;7,0;;2,0;;5,0;13,0;2,0;1,0;;13,0;26,0;23,0;;4,0;1,0;;4,0;2,0;52,0;2,0;11,0;9,0;319,0;5,0;46,0;1,0;3,0;21,0;15,0;20,0;20,0;10,0;1,0;7,0;;;56,0;35,0;30,0;17,0;7,0;22,0;37,0;10,0;242,0;68,0;1,0;6,0;35,0;49,0;45,0;15,0;10,0;49,0;21,0;14,0;31,0;101,0;9,0;120,0;;104,0;48,0;13,0;4,0;117,0;2,0;51,0;18,0;117,0;5,0;43,0;47,0;4,0;3,0;20,0;4,0;38,0;213,0;56,0;;1,0;28,0;5,0;1,0;84,0;1,0;26,0;5,0;106,0;28,0;75,0;28,0;;29,0;2,0;177,0;5,0;30,0;5,0;52,0;118,0;86,0;3,0;20,0;26,0;86,0;14,0;6,0;26,0;14,0;19,0;405,0;8,0;21,0;32,0;13,0;5,0;8,0;1,0;1,0;50,0;10,0;62,0;46,0;505,0;9,0;16,0;1,0;11,0;;2,0;;6,0;31,0;4,0;65,0;92,0;1,0;4,0;18,0;1,0;14,0;7,0;1,0;9,0;95,0;53,0;8,0;10,0;138,0;8,0;13,0;38,0;;4,0;38,0;13,0;14,0;5,0;37,0;;13,0;1,0;25,0;15,0;1,0;22,0;32,0;8,0;18,0;10,0;6,0;24,0;47,0;14,0;27,0;2,0;21,0;27,0;1,0;13,0;;3,0;34,0;2,0;8,0;13,0;21,0;6,0;;;;;;10,0;2,0;7,0;27,0;1,0;48,0;40,0;2,0;81,0;10,0;29,0;6,0;9,0;3,0;25,0;5,0;;3,0;24,0;3,0;;19,0;11,0;19,0;129,0;2,0;11,0;;2,0;7,0;8,0;4,0;2,0;29,0;51,0;35,0;;13,0;11,0;8,0;3,0;71,0;8,0;11,0;15,0;5,0;35,0;;6,0;9,0;10,0;14,0;4,0;5,0;;;6,0;30,0;10,0;35,0;15,0;16,0;8,0;2,0;6,0;1,0;1,0;40,0;3,0;15,0;4,0;2,0;189,0;7,0;72,0;8,0;17,0;26,0;14,0;2,0;;10,0;13,0;7,0;;15,0;18,0;34,0;11,0;8,0;2,0;20,0;131,0;;1,0;;;9,0;1,0;;4,0;4,0;44,0;;19,0;12,0;26,0;6,0;;2,0;20,0;9,0;;52,0;24,0;16,0;;6,0;4,0;6,0;;17,0;5,0;31,0;;15,0;10,0;92,0;23,0;;19,0;6,0;15,0;27,0;1,0;5,0;;;;71,0;;2,0;41,0;128,0;90,0;6,0;21,0;178,0;11,0;14,0;4,0;3,0;9,0;5,0;14,0;7,0;1,0;;2,0;4,0;1,0;9,0;1,0;2,0;18,0;4,0;7,0;;2,0;5,0;4,0;11,0;5,0;8,0;1,0;;;;57,0;;;1,0;13,0;1,0;33,0;1,0;1,0;4,0;31,0;10,0;;1,0;8,0;7,0;8,0;8,0;2,0;;16,0;;;1,0;5,0;73,0;6,0;;;11,0;;22,0;2,0;4,0;;;2,0;7,0;3,0;2,0;3,0;;;;;;;21,0;2,0;;1,0;1,0;;;;5,0;2,0;1,0;;;1,0;72,0;;2,0;;;;2,0;;1,0;;;15,0;;3,0;3,0;5,0;;9,0;;;5,0;;25,0;;;;4,0;;67,0;;1,0;2,0;;111,0;2,0;12,0;;1,0;6,0;31,0;2,0;22,0;2,0;;15,0;27,0;6,0;;7,0;5,0;;42,0;10,0;4,0;9,0;10,0;;31,0;8,0;1,0;6,0;76,0;37,0;;6,0;30,0;30,0;7,0;;29,0;31,0;;5,0;11,0;5,0;9,0;2,0;8,0;4,0;4,0;9,0;19,0;2,0;6,0;15,0;;9,0;;2,0;6,0;4,0;15,0;4,0;28,0;38,0;;1,0;6,0;2,0;6,0;1,0;41,0;5,0;6,0;5,0;;1,0;1,0;2,0;2,0;10,0;4,0;9,0;2,0;;5,0;;6,0;18,0;;3,0;2,0;6,0;2,0;8,0;14,0;5,0;6,0;9,0;6,0;;6,0;12,0;12,0;20,0;2,0;7,0;28,0;2,0;;1,0;5,0;5,0;2,0;;;2,0;1,0;9,0;;2,0;1,0;2,0;;12,0;3,0;5,0;10,0;7,0;;22,0;;;6,0;;;;;2,0;;5,0;2,0;1,0;;;1,0;;;;28,0;2,0;1,0;6,0;;;12,0;1,0;1,0;7,0;39,0;;;15,0;;5,0;1,0;18,0;;1,0;;3,0;13,0;4,0;;31,0;8,0;6,0;3,0;;;;2,0;;1,0;2,0;5,0;;3,0;21,0;3,0;;3,0;;7,0;23,0;1,0;1,0;;;
send;;19,0;;4,0;5,0;25,0;2,0;6,0;;3,0;;;1,0;21,0;1,0;1,0;39,0;;;2,0;2,0;;4,0;1,0;48,0;;;22,0;18,0;14,0;92,0;30,0;1,0;2,0;;184,0;;;6,0;2,0;42,0;282,0;;28,0;80,0;;;6,0;;3,0;;2,0;;5,0;6,0;;;;;9,0;;;3,0;2,0;161,0;;57,0;;4,0;;;47,0;51,0;;;;;6,0;2,0;1,0;88,0;;15,0;;24,0;;;3,0;;;4,0;;;1,0;22,0;;;1,0;28,0;3,0;44,0;3,0;;2,0;13,0;89,0;;20,0;2,0;;;6,0;1,0;;;3,0;19,0;5,0;;17,0;21,0;1,0;216,0;;;7,0;59,0;;2,0;;45,0;;;64,0;;;15,0;14,0;4,0;;;;1,0;1,0;;;2,0;2,0;31,0;;;;25,0;;;1,0;;;;;;21,0;15,0;10,0;;2,0;18,0;;;1,0;5,0;;1,0;4,0;;5,0;2,0;3,0;4,0;;;1,0;;;;;2,0;;14,0;;;;1,0;;;;7,0;;1,0;;;;;;;2,0;2,0;;;3,0;2,0;3,0;1,0;;;;14,0;2,0;;;14,0;5,0;4,0;6,0;;;1,0;;;1,0;;;3,0;1,0;;;5,0;1,0;;1,0;;;;;;19,0;2,0;;;;;;;;;;;6,0;;;11,0;9,0;;10,0;;;1,0;1,0;;;;1,0;3,0;6,0;4,0;;1,0;6,0;;;;;1,0;8,0;;;;1,0;30,0;;;2,0;;;3,0;;6,0;1,0;;;;;;1,0;;;2,0;1,0;;7,0;;;;;;;;;;;21,0;46,0;;;;;;;9,0;8,0;;;;;9,0;;;;;1,0;2,0;10,0;;;;;1,0;4,0;;;;;1,0;;;;2,0;;153,0;37,0;;;;4,0;18,0;4,0;5,0;;;3,0;;;1,0;;9,0;1,0;;80,0;;;148,0;7,0;;1,0;3,0;26,0;;;;7,0;6,0;6,0;5,0;9,0;;6,0;;6,0;22,0;4,0;2,0;32,0;1,0;9,0;;20,0;;16,0;4,0;12,0;;3,0;;31,0;12,0;8,0;6,0;;;;1,0;3,0;;3,0;;60,0;66,0;40,0;3,0;;3,0;5,0;10,0;1,0;3,0;;9,0;8,0;4,0;3,0;;22,0;12,0;3,0;;;3,0;;72,0;;;;11,0;;;;;4,0;;;29,0;;1,0;1,0;;5,0;;1,0;1,0;;10,0;1,0;86,0;22,0;;1,0;2,0;12,0;;10,0;;;3,0;;7,0;2,0;3,0;5,0;13,0;1,0;2,0;1,0;;;7,0;;;4,0;;;2,0;23,0;;;1,0;;;3,0;;1,0;1,0;1,0;2,0;;;9,0;;3,0;;;22,0;2,0;;;;;;;;;;2,0;;;;5,0;1,0;3,0;;9,0;1,0;;;4,0;1,0;3,0;;1,0;1,0;;;;5,0;5,0;60,0;2,0;;;;5,0;4,0;4,0;2,0;;8,0;3,0;2,0;1,0;4,0;;;;1,0;1,0;2,0;;;;;2,0;;12,0;12,0;3,0;;;;14,0;7,0;;10,0;5,0;1,0;;;28,0;4,0;2,0;11,0;3,0;;3,0;;19,0;12,0;29,0;1,0;2,0;;;;;;;10,0;;;29,0;15,0;3,0;;;;;5,0;;;;2,0;;;2,0;;49,0;3,0;5,0;;1,0;;;3,0;4,0;;;3,0;2,0;4,0;;11,0;;;1,0;;;;;11,0;;;;5,0;;29,0;7,0;2,0;;10,0;20,0;;11,0;16,0;;1,0;12,0;;;2,0;;17,0;;2,0;;3,0;7,0;12,0;14,0;;;;;1,0;;12,0;1,0;2,0;11,0;1,0;;4,0;;1,0;;;6,0;11,0;;;;;;;;;1,0;;;3,0;;20,0;2,0;76,0;;;39,0;3,0;2,0;;;9,0;1,0;;;;2,0;;1,0;;;;;1,0;;;;;;1,0;;;;;;;;;;;;;;1,0;;;;;;;;;;8,0;;;;;;;1,0;;;;68,0;;;;;;;;;;;;;;;1,0;;6,0;;;;;2,0;;;;;;;4,0;;1,0;;4,0;2,0;;;;;;;1,0;;;;;;;;;;3,0;;;;;;;;;;;;;;;;;;;;;;4,0;;1,0;;;2,0;;4,0;;;;3,0;;2,0;;1,0;;14,0;;1,0;;;;4,0;;1,0;;;8,0;;;;;2,0;2,0;;1,0;1,0;;;;1,0;;14,0;7,0;1,0;;1,0;;;;2,0;;;;;2,0;;;;;;;;3,0;;1,0;;;;2,0;;;1,0;;;;;;;;;;;;;;4,0;;;;;;;;;;;;;3,0;;1,0;;;;;2,0;;2,0;;;;;;;9,0;;;;1,0;;;1,0;;;4,0;;;1,0;;;1,0;;;;;;;1,0;9,0;;;;;1,0
sense;;3,0;;12,0;6,0;99,0;52,0;20,0;3,0;6,0;12,0;7,0;7,0;127,0;3,0;2,0;62,0;;2,0;24,0;1,0;;60,0;2,0;15,0;;1,0;77,0;8,0;33,0;297,0;36,0;;23,0;1,0;152,0;16,0;2,0;92,0;2,0;49,0;429,0;;43,0;94,0;99,0;1,0;223,0;2,0;1,0;4,0;;1,0;36,0;37,0;12,0;46,0;;19,0;96,0;1,0;3,0;10,0;;942,0;2,0;144,0;10,0;;12,0;6,0;178,0;400,0;1,0;1,0;2,0;5,0;15,0;;23,0;131,0;11,0;59,0;31,0;103,0;10,0;3,0;77,0;7,0;8,0;7,0;4,0;21,0;5,0;4,0;;185,0;29,0;270,0;10,0;205,0;27,0;;28,0;39,0;42,0;4,0;1,0;12,0;8,0;;63,0;98,0;1,0;;;1,0;38,0;31,0;663,0;2,0;;178,0;15,0;5,0;22,0;165,0;;4,0;;88,0;;1,0;387,0;;1,0;24,0;11,0;1,0;;;5,0;2,0;;3,0;16,0;79,0;64,0;45,0;7,0;1,0;4,0;19,0;8,0;;3,0;;;;;10,0;28,0;1,0;5,0;16,0;6,0;41,0;24,0;;28,0;17,0;;10,0;48,0;1,0;6,0;18,0;22,0;2,0;4,0;26,0;3,0;2,0;36,0;;15,0;22,0;28,0;7,0;1,0;;5,0;1,0;5,0;8,0;9,0;34,0;22,0;2,0;;1,0;41,0;;;26,0;4,0;37,0;2,0;10,0;56,0;25,0;59,0;1,0;;;12,0;66,0;4,0;;16,0;15,0;4,0;7,0;19,0;8,0;;103,0;8,0;;;1,0;8,0;4,0;1,0;14,0;2,0;39,0;16,0;;5,0;;;;;;29,0;6,0;13,0;36,0;;4,0;3,0;4,0;12,0;38,0;18,0;16,0;112,0;17,0;;1,0;34,0;9,0;62,0;5,0;5,0;1,0;;11,0;4,0;2,0;3,0;10,0;11,0;;;7,0;10,0;1,0;10,0;;;29,0;11,0;;2,0;19,0;4,0;287,0;;35,0;1,0;;11,0;2,0;;34,0;7,0;;1,0;;;3,0;1,0;;9,0;2,0;16,0;1,0;45,0;1,0;3,0;3,0;;1,0;;31,0;1,0;4,0;17,0;21,0;53,0;24,0;10,0;5,0;13,0;1,0;;69,0;;;;;4,0;2,0;24,0;;;4,0;3,0;8,0;32,0;5,0;;1,0;;;4,0;;;;;;3,0;6,0;1,0;4,0;11,0;33,0;7,0;49,0;13,0;6,0;4,0;;23,0;10,0;14,0;;;;;9,0;7,0;26,0;;5,0;6,0;18,0;3,0;63,0;2,0;;2,0;3,0;25,0;26,0;2,0;4,0;13,0;4,0;9,0;2,0;12,0;;10,0;;4,0;11,0;8,0;2,0;38,0;29,0;13,0;3,0;25,0;;6,0;106,0;11,0;2,0;53,0;;14,0;28,0;26,0;6,0;4,0;4,0;;4,0;1,0;;17,0;4,0;124,0;17,0;36,0;13,0;4,0;;1,0;1,0;9,0;;1,0;1,0;16,0;16,0;5,0;172,0;16,0;53,0;7,0;5,0;6,0;2,0;;23,0;14,0;;15,0;11,0;;;3,0;3,0;4,0;;2,0;15,0;1,0;34,0;26,0;2,0;;;;7,0;;6,0;14,0;8,0;7,0;;;5,0;;6,0;2,0;166,0;;13,0;11,0;11,0;;22,0;6,0;6,0;;13,0;5,0;3,0;8,0;5,0;2,0;26,0;1,0;1,0;;9,0;;2,0;58,0;;4,0;;;;;45,0;1,0;2,0;1,0;;36,0;;5,0;1,0;;9,0;;3,0;11,0;;32,0;2,0;;;;4,0;11,0;11,0;;14,0;5,0;7,0;1,0;;;3,0;1,0;;15,0;;;1,0;2,0;;2,0;1,0;;;;1,0;15,0;;;;;;1,0;23,0;2,0;1,0;;4,0;6,0;4,0;5,0;;10,0;;2,0;;;7,0;;;22,0;1,0;10,0;5,0;4,0;3,0;;5,0;;11,0;3,0;;2,0;;;19,0;;;;8,0;;2,0;;;2,0;;;4,0;3,0;4,0;1,0;1,0;1,0;;1,0;12,0;;;3,0;;11,0;;;10,0;1,0;;;;2,0;;;;;;10,0;;;;1,0;4,0;10,0;;2,0;;1,0;2,0;1,0;;;;;8,0;;3,0;;;;;1,0;31,0;;;3,0;1,0;11,0;4,0;;;;;;24,0;2,0;2,0;10,0;;1,0;1,0;3,0;16,0;;;1,0;4,0;5,0;9,0;11,0;6,0;;;3,0;;1,0;10,0;;11,0;11,0;1,0;7,0;;;;1,0;2,0;23,0;23,0;;;;;5,0;2,0;1,0;;;15,0;49,0;;10,0;;;;;;;1,0;;1,0;;1,0;3,0;;;;;22,0;;;4,0;;;10,0;3,0;;;;18,0;5,0;2,0;;2,0;;45,0;;;2,0;;4,0;;5,0;8,0;;4,0;4,0;;;;;;;;7,0;;11,0;;;;;;5,0;;;;;;15,0;25,0;3,0;7,0;;;;1,0;6,0;3,0;4,0;;11,0;;;;1,0;;20,0;8,0;;;;9,0;4,0;22,0;4,0;;6,0;6,0;2,0;;25,0;12,0;;;;5,0;;2,0;6,0;1,0;;;2,0;;;4,0;;;1,0;;;;;;;;5,0;;;2,0;5,0;;10,0;;;;;2,0;;;7,0;;;8,0;;13,0;;;;12,0;;;5,0;2,0;;;2,0;;1,0;;;7,0;;;;;1,0;2,0;;;3,0;7,0;;;;6,0;2,0;1,0;;;;;3,0;3,0;;;;;;;;;;1,0;;;1,0;;;;12,0;;8,0;;;6,0;2,0;;;;14,0;3,0;3,0;8,0;;;2,0;;2,0;;6,0;;;4,0;;4,0;2,0;;;;;;;;2,0;;;1,0;2,0;16,0;;3,0;;8,0;;22,0;;3,0;3,0;;;;1,0;1,0;2,0;6,0;;1,0;;1,0;;;;3,0;;;;;;;;1,0;;;;;;;;;;;;
server;;1,0;;1,0;;21,0;9,0;;;;;;;30,0;;;23,0;;2,0;4,0;;;;18,0;33,0;;;2,0;116,0;5,0;64,0;5,0;;2,0;;104,0;3,0;;1,0;;30,0;205,0;;7,0;26,0;;1,0;;;;4,0;;;27,0;3,0;1,0;4,0;;1,0;47,0;;;17,0;;133,0;2,0;59,0;;;;;2,0;2,0;;;1,0;;2,0;13,0;20,0;87,0;;1,0;6,0;15,0;;;12,0;;1,0;22,0;;;;28,0;;1,0;;44,0;6,0;26,0;21,0;;18,0;70,0;49,0;1,0;26,0;;;;12,0;;;;;20,0;14,0;1,0;16,0;1,0;;11,0;3,0;;42,0;128,0;;;;30,0;;;16,0;;;12,0;1,0;;;;;;;;6,0;30,0;;35,0;1,0;;;;;;1,0;;;;;;47,0;19,0;;;;20,0;;2,0;8,0;4,0;;;1,0;;;;4,0;1,0;;;;1,0;;;1,0;;;5,0;;;;;;;;;;;;;;2,0;23,0;1,0;2,0;;;4,0;1,0;2,0;;;;;;3,0;1,0;4,0;4,0;12,0;10,0;1,0;;;;2,0;;;;;;1,0;;;2,0;;;;1,0;;;;;;6,0;6,0;1,0;;;;;;7,0;;;1,0;3,0;;;3,0;83,0;1,0;14,0;;;;;;;;1,0;;4,0;;;1,0;1,0;;;;;;;;;4,0;2,0;8,0;;;2,0;;;;;;2,0;;;;;;;;;;;;7,0;;;;;;;8,0;;;;46,0;4,0;;1,0;;;;;1,0;;;;;;28,0;;;;3,0;;;;;;;3,0;8,0;;;;;;;;1,0;;;;169,0;14,0;;;;;5,0;;14,0;;;;;;7,0;;4,0;;;1,0;2,0;1,0;41,0;1,0;7,0;1,0;;4,0;1,0;;;33,0;1,0;26,0;5,0;;;28,0;;15,0;5,0;;;6,0;3,0;2,0;;14,0;1,0;14,0;2,0;;;9,0;;13,0;5,0;14,0;;;;1,0;;;;;2,0;143,0;136,0;15,0;3,0;;1,0;54,0;6,0;1,0;2,0;;27,0;5,0;5,0;2,0;;46,0;5,0;;7,0;2,0;;2,0;50,0;;16,0;;;;;;;33,0;4,0;;42,0;;;10,0;4,0;3,0;4,0;1,0;1,0;;6,0;;14,0;10,0;;;;2,0;;1,0;;;4,0;5,0;8,0;7,0;15,0;;10,0;;;1,0;1,0;;3,0;;1,0;13,0;;;;36,0;;;2,0;;;13,0;;;11,0;;2,0;;;24,0;1,0;;;;7,0;;;;1,0;1,0;;;;2,0;;1,0;;2,0;;28,0;;9,0;2,0;12,0;3,0;;;;2,0;3,0;;;;;;;10,0;21,0;29,0;;6,0;3,0;;;6,0;6,0;4,0;;1,0;1,0;3,0;;21,0;4,0;;;18,0;;;;;3,0;;;;;;3,0;;;;36,0;5,0;3,0;8,0;8,0;3,0;2,0;;1,0;;;2,0;6,0;3,0;2,0;;4,0;16,0;26,0;;;;;1,0;1,0;;;;;;6,0;17,0;;1,0;2,0;1,0;2,0;12,0;;;;2,0;;;6,0;;116,0;;12,0;;;;;1,0;1,0;2,0;;;;;;3,0;;;;1,0;;;1,0;;;;1,0;;29,0;;5,0;;;5,0;4,0;;5,0;4,0;2,0;;1,0;1,0;3,0;6,0;;10,0;;;;1,0;7,0;1,0;3,0;;;;;1,0;;29,0;;1,0;;;;;;;;;;;;;;;;;;;;;;2,0;12,0;;;24,0;;;2,0;3,0;;;;;;;1,0;;2,0;;5,0;;;;;2,0;1,0;;1,0;2,0;;;1,0;;;;;;;1,0;;;;;;;;;;;;;;2,0;;;;;;;;;;;;;;1,0;;;;;;1,0;;;;1,0;;;;;;;;;;;;;1,0;;;3,0;;;;;;;;;7,0;;;;;7,0;;;;;7,0;1,0;;;;3,0;;;;;;;;;;;;;1,0;;;;;;;;;1,0;;;;;;1,0;;;;5,0;;;;;6,0;;;;6,0;14,0;;3,0;11,0;;;;;1,0;;;1,0;;;;;1,0;2,0;1,0;3,0;1,0;;;13,0;1,0;4,0;2,0;;;;;;;;;4,0;;1,0;;;;;;;;;;;;;1,0;;;;;;;;;1,0;;;;;;;;;;;;;;;;;4,0;;;;6,0;;;;1,0;;;;;;;;1,0;;;;;2,0;;1,0;3,0;;;;;;;;;;;7,0;;;;;;;;;;;;;;
service;;3,0;;1,0;1,0;29,0;;4,0;;;;;;23,0;;;8,0;;2,0;;;;;15,0;6,0;2,0;;19,0;7,0;;35,0;;;;;46,0;1,0;;;;4,0;72,0;;;1,0;;;1,0;;;1,0;;4,0;;1,0;;;;;8,0;;;;;40,0;11,0;13,0;;;;;2,0;;;;;1,0;;6,0;10,0;31,0;;;;14,0;;;;;1,0;1,0;;;;5,0;;;;6,0;6,0;3,0;;;13,0;28,0;8,0;1,0;6,0;;;;;;;3,0;5,0;;4,0;;9,0;3,0;;1,0;;;10,0;50,0;;;;;;;;;;3,0;1,0;;;;;;;;;5,0;15,0;15,0;;;;4,0;;;;;;;;;10,0;26,0;;;;2,0;6,0;;;;;2,0;;;;;;1,0;;;;8,0;;;;1,0;;1,0;;;;;;;;;;;;;1,0;;;1,0;;;;;1,0;;4,0;;;;;4,0;;;;3,0;2,0;;;;;;2,0;1,0;;;;;;;;;;;;;;;;;2,0;;;3,0;;;;;1,0;;;2,0;;;;1,0;13,0;;3,0;;;;;;;;;;;;;4,0;2,0;;;;;;;;;1,0;;;;;;;;;;;1,0;;;;;;;;;1,0;1,0;;;;1,0;;;;;1,0;2,0;1,0;2,0;7,0;6,0;;;;;;;;2,0;;;;;2,0;;;;2,0;;;2,0;;;;4,0;;19,0;;;;;;;1,0;;1,0;;54,0;3,0;;2,0;;1,0;8,0;;;;;1,0;;;;;;;;;;;15,0;2,0;;;;6,0;;;;10,0;;8,0;;;;1,0;;1,0;;;;5,0;;3,0;;12,0;;14,0;6,0;1,0;;;;6,0;;1,0;;;;;;;;1,0;1,0;51,0;25,0;8,0;;;1,0;;2,0;2,0;1,0;;2,0;2,0;2,0;;;23,0;;;;1,0;;;29,0;;2,0;;;;;;;;;2,0;8,0;;;2,0;;1,0;;;;;5,0;;;6,0;;;;;;;;;;;;;2,0;;1,0;2,0;;;2,0;;;;;3,0;2,0;;;15,0;;;;;;;;4,0;;;;;;;;;;;9,0;;;;;;;;;2,0;;4,0;;;;21,0;2,0;;2,0;;;;;;;14,0;;;;;;;;1,0;31,0;2,0;;;;;;1,0;13,0;;;;;;11,0;;;;25,0;;;;;;;;;;;;;;;6,0;;;2,0;;;43,0;;;;;1,0;16,0;;9,0;;;;;;;;;2,0;;;;;;;5,0;36,0;;7,0;;;;1,0;;;;;;;5,0;;23,0;;;;1,0;;;;;2,0;;;;;;;;;;;;;;3,0;;;;;5,0;54,0;4,0;;;;;;1,0;5,0;1,0;;4,0;;;2,0;;6,0;;;1,0;;1,0;1,0;;;;;;;;;;;1,0;;;;;;;1,0;1,0;;;;;;;;;;;;;2,0;13,0;;;21,0;;;2,0;;;;;;1,0;;;;4,0;1,0;;;;;;1,0;;;;;;1,0;;;;;;;;;;;;;2,0;;;;;;;;;;;;;;;;;;;;;;;;;;;;;;;;;1,0;;;;;;13,0;;;;;;;;;;;;;;;;1,0;;;;;;;;2,0;;;1,0;;;;;;;;;;;;2,0;;;;;;;;;;;;;;1,0;;;;;;;;;;;;;;;;;;3,0;;;;;;;;;;;;;1,0;;;;;;;;;4,0;3,0;;1,0;;;;;;;;1,0;;;;;;;;;;;;;;;;;;;;;;;;;2,0;;;;;;;;;;;3,0;;;;;;;;4,0;;;;;;;;;;;;;;;;;;;;;;;;;;;;;;;;;;;;;;;;;;;;;;;;;;;;;
setting;;1,0;6,0;312,0;34,0;116,0;13,0;10,0;7,0;6,0;;4,0;;304,0;1,0;34,0;433,0;3,0;5,0;10,0;4,0;26,0;61,0;6,0;47,0;2,0;1,0;12,0;25,0;72,0;153,0;44,0;6,0;136,0;1,0;201,0;31,0;;82,0;9,0;340,0;455,0;;46,0;164,0;1,0;;41,0;1,0;11,0;27,0;;3,0;19,0;9,0;84,0;3,0;;9,0;66,0;;;9,0;;699,0;3,0;238,0;28,0;4,0;3,0;74,0;90,0;70,0;5,0;1,0;9,0;2,0;21,0;3,0;20,0;417,0;;169,0;12,0;91,0;7,0;;16,0;1,0;9,0;111,0;2,0;2,0;3,0;29,0;3,0;59,0;3,0;124,0;52,0;178,0;49,0;;28,0;31,0;48,0;1,0;10,0;22,0;;4,0;98,0;75,0;1,0;;;48,0;39,0;19,0;167,0;21,0;4,0;84,0;30,0;1,0;68,0;188,0;;14,0;;232,0;2,0;;183,0;12,0;1,0;30,0;31,0;94,0;;;4,0;;5,0;88,0;39,0;122,0;10,0;86,0;;75,0;3,0;22,0;;1,0;1,0;6,0;;;;;23,0;3,0;4,0;1,0;3,0;1,0;11,0;10,0;101,0;1,0;1,0;5,0;24,0;;;;13,0;17,0;;3,0;;1,0;47,0;;;7,0;4,0;222,0;6,0;;;4,0;2,0;2,0;1,0;4,0;1,0;;;;;31,0;4,0;8,0;25,0;19,0;;1,0;8,0;17,0;13,0;11,0;;;;54,0;;2,0;2,0;5,0;55,0;10,0;;;;24,0;;2,0;3,0;;;85,0;10,0;;7,0;;1,0;;10,0;;6,0;2,0;;;177,0;3,0;;4,0;11,0;;;;;;5,0;6,0;10,0;2,0;;6,0;66,0;5,0;51,0;1,0;;;;5,0;24,0;3,0;;8,0;7,0;3,0;;7,0;36,0;4,0;17,0;1,0;40,0;11,0;4,0;5,0;;;16,0;37,0;;;209,0;;1,0;;;42,0;19,0;;;;;;7,0;1,0;;;1,0;10,0;31,0;;;;1,0;1,0;;3,0;8,0;6,0;13,0;8,0;88,0;;10,0;1,0;;1,0;;27,0;4,0;;;;4,0;39,0;1,0;2,0;;;;6,0;14,0;3,0;;;;;12,0;;;;3,0;4,0;;5,0;1,0;12,0;7,0;175,0;77,0;21,0;1,0;;6,0;2,0;70,0;1,0;3,0;;5,0;;;51,0;6,0;129,0;44,0;3,0;30,0;19,0;2,0;207,0;30,0;4,0;1,0;;91,0;35,0;28,0;13,0;10,0;8,0;15,0;8,0;273,0;;88,0;;27,0;16,0;1,0;;53,0;;42,0;15,0;19,0;11,0;43,0;42,0;1,0;1,0;12,0;;47,0;67,0;12,0;;7,0;7,0;1,0;1,0;138,0;3,0;16,0;6,0;111,0;33,0;85,0;26,0;;1,0;2,0;;;90,0;4,0;33,0;33,0;96,0;11,0;26,0;17,0;75,0;8,0;5,0;16,0;;14,0;108,0;;5,0;20,0;7,0;13,0;;;;16,0;1,0;7,0;34,0;4,0;6,0;10,0;;12,0;9,0;2,0;3,0;;11,0;14,0;34,0;23,0;;4,0;7,0;5,0;1,0;1,0;2,0;7,0;4,0;12,0;;4,0;73,0;10,0;3,0;9,0;3,0;;33,0;1,0;1,0;3,0;24,0;1,0;;;;22,0;;11,0;10,0;9,0;5,0;;6,0;3,0;19,0;10,0;2,0;2,0;1,0;1,0;;14,0;;;62,0;;2,0;;7,0;2,0;;;;;1,0;4,0;;4,0;11,0;5,0;54,0;13,0;1,0;58,0;6,0;7,0;1,0;11,0;4,0;24,0;;;1,0;2,0;;;;1,0;39,0;32,0;;;;;2,0;12,0;16,0;1,0;44,0;;4,0;;18,0;5,0;;;;;;8,0;1,0;8,0;;;29,0;;1,0;6,0;22,0;;;8,0;11,0;8,0;;8,0;1,0;6,0;;;1,0;3,0;4,0;;;;;7,0;7,0;8,0;;86,0;64,0;22,0;3,0;6,0;;2,0;7,0;;1,0;1,0;11,0;6,0;1,0;10,0;11,0;17,0;1,0;;;;;3,0;1,0;27,0;;132,0;2,0;;;5,0;2,0;13,0;2,0;49,0;;1,0;9,0;2,0;6,0;;2,0;;;2,0;41,0;2,0;;;2,0;2,0;13,0;2,0;2,0;10,0;6,0;2,0;17,0;;1,0;;;10,0;32,0;;2,0;9,0;4,0;15,0;;12,0;56,0;;51,0;8,0;2,0;19,0;1,0;6,0;;;;5,0;;1,0;10,0;;3,0;4,0;7,0;;;;1,0;6,0;4,0;20,0;34,0;;;;1,0;6,0;4,0;;;4,0;;16,0;7,0;1,0;3,0;4,0;8,0;;;5,0;3,0;3,0;;;;41,0;;3,0;;4,0;7,0;;;;7,0;;13,0;;;;;9,0;39,0;;13,0;10,0;;;;;;;;3,0;;;;;1,0;;4,0;1,0;;;;;80,0;;1,0;;1,0;;;;2,0;1,0;;;;;;1,0;9,0;3,0;;;;13,0;23,0;1,0;1,0;;6,0;1,0;2,0;;1,0;;;211,0;;2,0;;2,0;5,0;;;;;;;15,0;10,0;19,0;;;;;;5,0;2,0;2,0;;7,0;23,0;;1,0;;9,0;;;;1,0;6,0;;;5,0;;;16,0;5,0;35,0;;;;;5,0;2,0;;1,0;3,0;;1,0;2,0;14,0;;3,0;;;15,0;;1,0;2,0;4,0;;8,0;2,0;;6,0;23,0;;;;13,0;;7,0;1,0;1,0;1,0;5,0;;;;;10,0;;3,0;1,0;;2,0;;7,0;2,0;10,0;5,0;;2,0;;5,0;;;;;10,0;;;;;;;;1,0;;;2,0;7,0;;;4,0;;1,0;;;21,0;1,0;1,0;8,0;;;;;;;;;3,0;;1,0;24,0;;;;;;;2,0;17,0;;;;;2,0;;;6,0;;;;2,0;;;;1,0;2,0;;;;;;1,0;19,0;;123,0;4,0;;;;;;;;3,0;;;;;;;;;1,0;18,0;;;;
shaft;;3,0;2,0;;;6,0;;45,0;;;10,0;;1,0;33,0;;;2,0;;3,0;;;3,0;;4,0;7,0;;;24,0;;1,0;40,0;2,0;;3,0;;;10,0;11,0;;;;46,0;20,0;2,0;16,0;40,0;;8,0;;;;18,0;66,0;11,0;;;28,0;;;;;;2,0;;;;60,0;;;5,0;6,0;24,0;5,0;;;;3,0;1,0;;;2,0;;;;10,0;3,0;;11,0;;2,0;;16,0;14,0;2,0;2,0;;;3,0;31,0;16,0;42,0;1,0;;2,0;;1,0;;;;;1,0;16,0;12,0;;;;;1,0;;8,0;;2,0;1,0;6,0;;1,0;21,0;;;;2,0;;;27,0;2,0;;7,0;1,0;;;;9,0;1,0;;4,0;14,0;;11,0;6,0;17,0;4,0;1,0;62,0;24,0;;1,0;;;;;1,0;69,0;;2,0;;;88,0;2,0;;;;;;58,0;;2,0;8,0;2,0;1,0;10,0;4,0;;1,0;14,0;3,0;;7,0;4,0;18,0;2,0;;;;1,0;;87,0;22,0;;19,0;12,0;;;1,0;;;;97,0;1,0;6,0;90,0;10,0;13,0;8,0;;;17,0;13,0;19,0;;2,0;;;;;32,0;;57,0;;1,0;;8,0;;3,0;;7,0;;;;3,0;1,0;;1,0;46,0;28,0;;;;5,0;51,0;5,0;10,0;;;5,0;4,0;2,0;55,0;40,0;8,0;;;;;13,0;5,0;;;;7,0;;;14,0;3,0;1,0;;;10,0;19,0;;2,0;2,0;;65,0;1,0;;;;4,0;1,0;;4,0;3,0;;37,0;;31,0;1,0;;3,0;42,0;9,0;1,0;2,0;;3,0;6,0;13,0;12,0;1,0;1,0;7,0;31,0;15,0;;10,0;1,0;30,0;17,0;7,0;11,0;1,0;;9,0;;;3,0;;3,0;8,0;1,0;13,0;15,0;;11,0;;;5,0;;1,0;30,0;153,0;117,0;45,0;7,0;4,0;7,0;25,0;1,0;1,0;13,0;;2,0;;9,0;1,0;6,0;7,0;11,0;5,0;;;;;;;;;3,0;;2,0;12,0;;;30,0;;;;;;;11,0;;;;3,0;;;;;;;;;;8,0;1,0;;;;;;;2,0;4,0;1,0;1,0;;6,0;6,0;83,0;3,0;3,0;;6,0;;3,0;2,0;;;;;;;;;41,0;2,0;3,0;1,0;2,0;4,0;;;;;1,0;;;1,0;;;1,0;2,0;19,0;;;;;;1,0;;;5,0;7,0;7,0;;;1,0;3,0;1,0;;2,0;1,0;;;2,0;;;;;;;;5,0;11,0;8,0;;4,0;;;9,0;;;;;;;;;;;;;6,0;;;;;;;;;;;;13,0;;;;;4,0;;3,0;;1,0;;;;;;8,0;13,0;;;;;1,0;;1,0;;66,0;;1,0;32,0;7,0;;;;1,0;2,0;;;;26,0;;;;;10,0;;3,0;12,0;;;;;;2,0;;;;4,0;;;;;;;;;;;;1,0;6,0;;;;;3,0;2,0;;;11,0;1,0;10,0;4,0;;;;;;;;;;;;;;;;;;;;;;;;;;;;;10,0;;;;2,0;;;;;;;;;;;3,0;;;;;;;10,0;11,0;;;1,0;6,0;6,0;;3,0;;;;;;;;;;;;;;;;;;;4,0;;;2,0;5,0;;4,0;;13,0;;;;;;2,0;;3,0;;1,0;17,0;1,0;;;;2,0;;;11,0;;1,0;1,0;11,0;;;;;1,0;;;112,0;31,0;7,0;;6,0;;;4,0;11,0;3,0;;5,0;;;10,0;;;;;;;;7,0;46,0;;;;;;;1,0;18,0;;;;;;;1,0;;51,0;2,0;;2,0;2,0;;;1,0;;;;;;;;12,0;13,0;4,0;;;17,0;;;;;;;;1,0;1,0;;1,0;;;6,0;1,0;9,0;;;2,0;2,0;1,0;;2,0;;;;;;;;;;;;;;;;;;;;;;;;;;;;;;;;;;;;;;;;;;;;;;;;;;;;;;;;;;;;;;;;1,0;;;;;;;;;;;;;;;;;4,0;;;;;;;;;;;;;18,0;;;;;;;;;;;;;;;;;;;;;;;;;;;;;;;;;;1,0;;;;;;;4,0;;;;;;;;;;7,0;2,0;1,0;;;1,0;;;1,0;;;2,0;;;;;;1,0;;1,0;1,0;4,0;2,0;;;;3,0;;;14,0;;;;;;;;;;;;;;;;;;;;;;;;;;;;;;;;;;;;;;;
shape;;8,0;;10,0;3,0;65,0;36,0;96,0;;13,0;;9,0;29,0;167,0;2,0;2,0;26,0;6,0;6,0;2,0;2,0;11,0;43,0;;1,0;;1,0;23,0;5,0;6,0;82,0;4,0;;10,0;2,0;18,0;64,0;4,0;11,0;1,0;79,0;130,0;18,0;11,0;49,0;57,0;1,0;99,0;;2,0;7,0;17,0;53,0;13,0;11,0;4,0;257,0;;1,0;20,0;1,0;6,0;24,0;;272,0;1,0;223,0;4,0;;15,0;22,0;446,0;97,0;4,0;2,0;1,0;43,0;2,0;4,0;139,0;138,0;9,0;2,0;6,0;141,0;9,0;;77,0;;13,0;2,0;7,0;7,0;10,0;;;30,0;31,0;121,0;24,0;80,0;52,0;13,0;15,0;8,0;5,0;1,0;8,0;5,0;4,0;1,0;9,0;89,0;;;6,0;;13,0;3,0;41,0;2,0;2,0;75,0;121,0;2,0;4,0;110,0;;1,0;23,0;7,0;2,0;3,0;86,0;3,0;3,0;43,0;14,0;;1,0;2,0;10,0;;;66,0;3,0;42,0;42,0;13,0;32,0;6,0;26,0;65,0;51,0;4,0;;6,0;;;;29,0;26,0;1,0;10,0;2,0;;57,0;56,0;2,0;8,0;5,0;;1,0;87,0;19,0;49,0;1,0;6,0;2,0;;3,0;;1,0;56,0;4,0;11,0;24,0;4,0;46,0;19,0;1,0;9,0;7,0;12,0;27,0;30,0;112,0;6,0;27,0;12,0;1,0;21,0;3,0;1,0;4,0;4,0;192,0;11,0;34,0;100,0;9,0;8,0;1,0;4,0;11,0;58,0;23,0;36,0;;5,0;145,0;8,0;;5,0;62,0;;338,0;8,0;3,0;1,0;25,0;;19,0;16,0;49,0;3,0;5,0;10,0;11,0;10,0;;85,0;4,0;;4,0;26,0;7,0;;206,0;;38,0;7,0;4,0;49,0;26,0;;89,0;417,0;23,0;;5,0;4,0;6,0;40,0;16,0;;19,0;;;36,0;3,0;47,0;66,0;10,0;21,0;;13,0;45,0;7,0;61,0;10,0;5,0;51,0;58,0;2,0;;3,0;29,0;45,0;79,0;53,0;10,0;16,0;79,0;32,0;8,0;32,0;3,0;11,0;17,0;2,0;5,0;8,0;;1,0;48,0;26,0;27,0;9,0;56,0;4,0;4,0;9,0;2,0;9,0;6,0;22,0;11,0;;14,0;11,0;116,0;11,0;11,0;;8,0;23,0;;25,0;25,0;36,0;3,0;15,0;61,0;1,0;137,0;3,0;5,0;;1,0;16,0;6,0;4,0;5,0;4,0;26,0;9,0;28,0;;12,0;1,0;4,0;4,0;4,0;7,0;13,0;6,0;52,0;10,0;;3,0;;;2,0;;11,0;2,0;8,0;4,0;5,0;2,0;;17,0;23,0;27,0;9,0;;;22,0;;26,0;6,0;;10,0;3,0;32,0;;3,0;;3,0;;4,0;6,0;9,0;1,0;25,0;12,0;26,0;4,0;7,0;;36,0;3,0;3,0;8,0;44,0;1,0;7,0;15,0;3,0;;12,0;;1,0;2,0;34,0;3,0;;;1,0;;;;;1,0;89,0;3,0;3,0;;1,0;13,0;;;;3,0;;2,0;45,0;4,0;;;12,0;10,0;;6,0;6,0;3,0;1,0;46,0;;;6,0;;9,0;7,0;1,0;;5,0;5,0;11,0;10,0;6,0;;;1,0;;5,0;;;;8,0;12,0;10,0;4,0;9,0;3,0;7,0;4,0;;1,0;37,0;6,0;5,0;7,0;6,0;;9,0;17,0;8,0;3,0;7,0;;9,0;19,0;;5,0;20,0;2,0;;;2,0;;1,0;3,0;4,0;9,0;7,0;4,0;1,0;3,0;;;;;1,0;;15,0;44,0;1,0;16,0;15,0;26,0;2,0;34,0;;;9,0;3,0;5,0;;6,0;;4,0;25,0;12,0;;;3,0;5,0;50,0;;;11,0;172,0;1,0;2,0;;18,0;1,0;;;5,0;4,0;;2,0;3,0;;;1,0;;1,0;;4,0;1,0;;;;5,0;3,0;;;7,0;;21,0;19,0;7,0;2,0;3,0;32,0;2,0;1,0;;11,0;18,0;1,0;25,0;5,0;;3,0;3,0;;;;4,0;4,0;4,0;;1,0;;;1,0;1,0;1,0;28,0;;;3,0;1,0;4,0;15,0;;8,0;64,0;10,0;;5,0;10,0;;;14,0;;;8,0;;;;;;2,0;;8,0;;1,0;;4,0;;;3,0;12,0;1,0;2,0;;7,0;3,0;;6,0;;5,0;;1,0;;;;;;12,0;6,0;2,0;;2,0;1,0;;1,0;;6,0;2,0;;;3,0;1,0;11,0;;;;;2,0;;8,0;11,0;;;1,0;;4,0;;1,0;6,0;4,0;14,0;;;88,0;;;;24,0;5,0;117,0;;;;6,0;;13,0;21,0;18,0;5,0;10,0;4,0;16,0;;1,0;41,0;;5,0;10,0;1,0;;2,0;4,0;4,0;;9,0;;;2,0;1,0;9,0;;;1,0;;3,0;4,0;14,0;;13,0;5,0;2,0;5,0;2,0;1,0;21,0;6,0;5,0;1,0;5,0;3,0;;;2,0;7,0;11,0;2,0;1,0;79,0;50,0;2,0;3,0;2,0;3,0;3,0;;25,0;12,0;1,0;3,0;;5,0;1,0;;;34,0;2,0;1,0;;2,0;1,0;10,0;2,0;53,0;;2,0;13,0;25,0;1,0;2,0;15,0;;;2,0;;10,0;;1,0;;4,0;;;6,0;;1,0;15,0;;6,0;1,0;;;41,0;8,0;;;;;;2,0;3,0;1,0;1,0;10,0;2,0;3,0;;2,0;;1,0;3,0;6,0;;4,0;4,0;;2,0;;1,0;1,0;;1,0;1,0;;2,0;16,0;5,0;;;3,0;;2,0;;;1,0;1,0;;;;;28,0;1,0;1,0;2,0;3,0;;;;;;3,0;1,0;1,0;;2,0;15,0;2,0;4,0;5,0;;1,0;;;1,0;2,0;;;7,0;13,0;1,0;1,0;;5,0;8,0;;;3,0;;;4,0;;;5,0;;;2,0;15,0;4,0;5,0;1,0;8,0;2,0;26,0;3,0;;;3,0;;;6,0;4,0;;;;;1,0;;;3,0;1,0;;;3,0;7,0;;2,0;3,0;16,0;4,0;;1,0;3,0;;30,0;6,0;5,0;;;;5,0;2,0;27,0;1,0;;;13,0;1,0;79,0;1,0;3,0;5,0;;;2,0;9,0;;;2,0;;2,0;2,0;;1,0;12,0;;3,0;15,0;3,0;;;2,0;;;;3,0;;;;;8,0;3,0;;;;2,0;;;;10,0;1,0;;;;
shift;;8,0;;6,0;52,0;15,0;12,0;6,0;;;;1,0;9,0;90,0;1,0;;37,0;5,0;6,0;2,0;;;13,0;;2,0;6,0;;13,0;4,0;3,0;40,0;5,0;12,0;21,0;1,0;19,0;2,0;2,0;6,0;4,0;145,0;53,0;;12,0;18,0;28,0;;3,0;4,0;1,0;4,0;;13,0;;12,0;4,0;25,0;;29,0;11,0;1,0;14,0;16,0;;382,0;;61,0;2,0;;4,0;5,0;95,0;25,0;1,0;;19,0;;4,0;;1,0;53,0;;14,0;2,0;11,0;27,0;2,0;58,0;1,0;13,0;41,0;4,0;9,0;1,0;;;224,0;23,0;36,0;53,0;90,0;18,0;1,0;;3,0;18,0;;2,0;;3,0;;36,0;42,0;1,0;;;;12,0;21,0;82,0;;;62,0;1,0;16,0;2,0;43,0;6,0;1,0;;19,0;;;43,0;4,0;;34,0;7,0;19,0;;;;;4,0;6,0;35,0;14,0;7,0;21,0;12,0;2,0;14,0;4,0;;;;;;;;;7,0;;;;;5,0;;;;17,0;;;102,0;2,0;1,0;;7,0;4,0;;2,0;1,0;;4,0;;8,0;66,0;15,0;65,0;1,0;1,0;;;3,0;9,0;;2,0;;2,0;;;;1,0;9,0;11,0;9,0;14,0;1,0;;12,0;2,0;23,0;7,0;;2,0;;7,0;4,0;;15,0;9,0;2,0;;12,0;;;27,0;1,0;2,0;6,0;;9,0;26,0;2,0;;;8,0;1,0;;10,0;;2,0;;;;11,0;;2,0;16,0;5,0;4,0;;13,0;17,0;;2,0;1,0;5,0;;;2,0;1,0;8,0;23,0;;;;1,0;1,0;;;;2,0;;;;7,0;11,0;3,0;5,0;1,0;5,0;50,0;;6,0;;1,0;1,0;5,0;;2,0;1,0;;;;;64,0;15,0;4,0;1,0;;3,0;;4,0;;2,0;21,0;2,0;3,0;19,0;;;;7,0;24,0;;3,0;2,0;5,0;6,0;2,0;69,0;7,0;10,0;;;3,0;;9,0;;;;;;8,0;;2,0;;;;2,0;10,0;2,0;;1,0;;;3,0;2,0;21,0;;;9,0;;7,0;20,0;5,0;14,0;30,0;;;;;;;1,0;;;;;;;28,0;13,0;3,0;;6,0;3,0;1,0;10,0;20,0;14,0;;;;42,0;2,0;4,0;2,0;;1,0;1,0;;1,0;2,0;14,0;7,0;71,0;19,0;;1,0;28,0;;36,0;3,0;4,0;2,0;4,0;17,0;1,0;1,0;10,0;;3,0;21,0;2,0;1,0;1,0;2,0;;;1,0;;2,0;3,0;10,0;;5,0;11,0;4,0;;;7,0;;4,0;21,0;3,0;2,0;4,0;1,0;2,0;2,0;2,0;22,0;1,0;2,0;10,0;;7,0;;2,0;8,0;;;;;5,0;11,0;;;8,0;;;7,0;;1,0;;;;4,0;1,0;3,0;14,0;;2,0;;;3,0;1,0;1,0;16,0;;;;2,0;;14,0;1,0;;2,0;;;14,0;12,0;3,0;;6,0;;;4,0;2,0;8,0;;1,0;1,0;23,0;1,0;;;;;1,0;;;;6,0;;6,0;;;;3,0;;;2,0;;;;;;28,0;;;;32,0;;;;;14,0;;2,0;;9,0;4,0;;;;;;3,0;;;;;;1,0;2,0;;;;9,0;;;1,0;5,0;;;;;;1,0;;;2,0;9,0;;;;;;;6,0;;;;23,0;;1,0;8,0;;;2,0;;2,0;;;;2,0;;;;;14,0;1,0;;2,0;3,0;29,0;2,0;;4,0;5,0;;;;;;;;;;;15,0;;;;;;2,0;;;8,0;3,0;;;3,0;3,0;7,0;70,0;;;;;;;;;1,0;;3,0;;41,0;2,0;1,0;9,0;;;4,0;5,0;;;;;;;;;;;2,0;;;;1,0;13,0;;;3,0;;;;;13,0;;2,0;;;;2,0;;;4,0;;5,0;9,0;;;;;;;1,0;33,0;18,0;;2,0;;;5,0;1,0;;;;;2,0;;;2,0;10,0;1,0;3,0;;;;1,0;;;;;;;;2,0;43,0;;;;;;;;;;;2,0;1,0;1,0;;;;;;;;;;;;;1,0;;;;1,0;;;;2,0;;;;11,0;;;;;;1,0;;;;2,0;;;4,0;;1,0;;;;;8,0;;;;11,0;;;1,0;1,0;;;6,0;2,0;;6,0;;;3,0;;19,0;;3,0;;;;2,0;;;;1,0;;;13,0;;;4,0;;;;1,0;15,0;;;;;;;;1,0;;;;;;2,0;;1,0;;;14,0;;4,0;;;2,0;1,0;;;;;;9,0;;9,0;;;1,0;1,0;;;8,0;;4,0;4,0;;12,0;10,0;;;;;;;;;;1,0;;;;;;;;;;1,0;;;;;6,0;;;;;6,0;;;;;;;;1,0;;;3,0;1,0;;;;2,0;;5,0;;3,0;;;;1,0;;2,0;;;;;19,0;;2,0;;1,0;;;;2,0;;;2,0;;;;;;;1,0;;;;10,0;;;1,0;;;3,0;;;1,0;;;;12,0;;;;;;;5,0;;;3,0;;;;7,0;;;2,0;;;;;;1,0;;
shoulder;;3,0;;3,0;;14,0;;35,0;;;;;;12,0;;;;;;;;;;;3,0;;;;;;55,0;;;;;;3,0;2,0;;;1,0;25,0;1,0;;;5,0;;4,0;;;;;22,0;2,0;;;3,0;;;;1,0;;;;4,0;;27,0;;;;1,0;3,0;1,0;;;;;;;;8,0;;;;6,0;1,0;;;;;;4,0;;1,0;;;;;;17,0;11,0;;;;;;;;;;;;1,0;2,0;;1,0;;4,0;;;;;2,0;;;;3,0;;;;;;;9,0;;;;;;;;2,0;;;10,0;;29,0;;;3,0;;2,0;16,0;3,0;;;;;;;;34,0;;;;;7,0;2,0;;;;;;4,0;;6,0;;;;;;;;1,0;10,0;;;;2,0;11,0;;2,0;;8,0;1,0;;12,0;;;;;;;;;;7,0;;;56,0;5,0;3,0;;;;2,0;;;;;;;3,0;;16,0;;73,0;;;;2,0;;;;8,0;;;;;1,0;;;;4,0;4,0;;4,0;1,0;5,0;;;;;11,0;;;47,0;10,0;2,0;;;;;;2,0;;;;10,0;2,0;;;1,0;;33,0;25,0;1,0;6,0;;;1,0;;4,0;;;;;;;;1,0;;6,0;;2,0;;;;;5,0;;;1,0;;;;2,0;5,0;;;;;;;5,0;;;11,0;;5,0;;1,0;1,0;;;;;;1,0;;;1,0;;;1,0;;;;3,0;;5,0;;;29,0;;;;1,0;;;;18,0;;;1,0;;;1,0;12,0;;;;;;;2,0;;;4,0;;1,0;;;;;;;;;;;;;;;;;;;;;;;;;;;;;;;;;;;7,0;;;9,0;;;1,0;;;3,0;;;;;;;;;;;5,0;;;;3,0;;;;;;;;;;;;2,0;;;;1,0;3,0;;24,0;;;1,0;;1,0;;1,0;;;;;1,0;;;;;;;;;;;;;;2,0;1,0;33,0;1,0;;;;;;;;;;3,0;;;;;;1,0;;;;;;;;;1,0;;;1,0;;;2,0;;;;;;;;;;4,0;;14,0;25,0;;;;;1,0;;;;;;;;;;;;;;;;2,0;;;;;;;;;1,0;;;;;;;;;;;;;;;1,0;;;;;;;;;1,0;;;;;;;;;;;;;;1,0;;;;;;;;;;;;;;;;;1,0;;;;;;;;;;;;;;;;;;;;;;;;;;;;;;;;;;;;;13,0;;;;;;;;;;;;;;;;;;;;;;;;;4,0;;;;;;;;;;1,0;;;;;;;;;;;;;;;;;2,0;;1,0;;;;;;;;;;2,0;;;;;;;;;;;;;;;;;;;4,0;;;;;;;;9,0;;3,0;;;;;1,0;1,0;;5,0;;;;;;;;;;;;2,0;;;;;;4,0;;1,0;;;;;;;;;;;;;;;;;;;;;3,0;;1,0;;;;;;;;;;;;;;;;;;;;;;;;;;;;;;;;;;;;;;;;;;;;;;;;;;;;;4,0;;;;;;;2,0;;;;;;;;;;;;;;;;1,0;;;;;;;;;;;;;;;;;;;1,0;;;;;;;1,0;;;;;;;;;12,0;;;;;;;;;;;;;;;;;1,0;6,0;;;;;;;;;;;;;;;2,0;5,0;2,0;;3,0;;;;;;;;;;;;;1,0;;;;;;;;;;;;;;;;;;;2,0;;;;;;;;;;;;;;;;;;;;;;;;;;;;;;;;
side;;45,0;2,0;5,0;6,0;144,0;148,0;438,0;;;48,0;14,0;129,0;830,0;;;142,0;12,0;80,0;4,0;44,0;4,0;40,0;7,0;10,0;;4,0;166,0;8,0;7,0;241,0;23,0;4,0;36,0;;78,0;181,0;11,0;15,0;9,0;40,0;520,0;22,0;19,0;227,0;807,0;;410,0;;1,0;5,0;16,0;486,0;70,0;70,0;60,0;483,0;;2,0;12,0;65,0;;326,0;1,0;1979,0;2,0;612,0;29,0;1,0;155,0;166,0;2823,0;282,0;;;;72,0;1,0;2,0;13,0;147,0;16,0;15,0;;291,0;56,0;;435,0;4,0;307,0;;36,0;38,0;52,0;34,0;2,0;100,0;126,0;336,0;101,0;599,0;74,0;22,0;5,0;12,0;15,0;;;1,0;4,0;;51,0;242,0;19,0;10,0;;1,0;82,0;21,0;525,0;32,0;1,0;27,0;16,0;;8,0;274,0;41,0;9,0;36,0;50,0;19,0;7,0;538,0;3,0;2,0;229,0;5,0;69,0;11,0;18,0;139,0;4,0;;175,0;37,0;102,0;424,0;24,0;215,0;12,0;34,0;516,0;347,0;;8,0;52,0;11,0;8,0;10,0;78,0;249,0;4,0;5,0;7,0;5,0;437,0;292,0;7,0;14,0;10,0;;40,0;388,0;7,0;215,0;6,0;31,0;15,0;1,0;1,0;56,0;77,0;823,0;23,0;43,0;117,0;34,0;272,0;777,0;2,0;47,0;37,0;31,0;208,0;131,0;752,0;46,0;272,0;30,0;21,0;312,0;19,0;8,0;4,0;8,0;1294,0;34,0;180,0;730,0;64,0;26,0;12,0;4,0;31,0;297,0;35,0;135,0;3,0;26,0;43,0;1,0;15,0;70,0;372,0;9,0;1092,0;7,0;11,0;2,0;96,0;20,0;29,0;28,0;330,0;16,0;33,0;16,0;17,0;13,0;1,0;119,0;42,0;11,0;32,0;41,0;34,0;206,0;;65,0;147,0;58,0;19,0;72,0;422,0;13,0;309,0;2626,0;51,0;;62,0;10,0;38,0;390,0;426,0;5,0;1,0;18,0;27,0;93,0;17,0;79,0;85,0;34,0;24,0;;24,0;122,0;18,0;37,0;37,0;10,0;232,0;288,0;;13,0;118,0;114,0;342,0;13,0;173,0;35,0;11,0;43,0;14,0;63,0;157,0;33,0;52,0;48,0;93,0;43,0;104,0;8,0;;51,0;42,0;63,0;18,0;181,0;34,0;5,0;19,0;21,0;358,0;9,0;481,0;21,0;31,0;16,0;56,0;1460,0;935,0;41,0;55,0;35,0;21,0;11,0;183,0;156,0;94,0;27,0;37,0;78,0;12,0;50,0;7,0;4,0;9,0;2,0;36,0;20,0;8,0;33,0;17,0;45,0;59,0;128,0;24,0;81,0;4,0;9,0;5,0;18,0;30,0;10,0;25,0;368,0;76,0;2,0;17,0;;;2,0;;11,0;1,0;1,0;;3,0;15,0;4,0;9,0;114,0;4,0;2,0;1,0;7,0;7,0;;51,0;11,0;;4,0;1,0;28,0;2,0;;;2,0;;1,0;5,0;44,0;54,0;17,0;10,0;3,0;13,0;;2,0;31,0;21,0;4,0;9,0;35,0;2,0;30,0;3,0;30,0;18,0;59,0;;17,0;24,0;26,0;13,0;6,0;15,0;;;;4,0;19,0;1,0;135,0;10,0;10,0;16,0;5,0;36,0;3,0;4,0;1,0;4,0;;14,0;21,0;16,0;;1,0;66,0;;33,0;;4,0;;9,0;87,0;;;14,0;9,0;19,0;28,0;4,0;;11,0;;4,0;30,0;21,0;3,0;2,0;;;;;;1,0;6,0;7,0;3,0;19,0;243,0;29,0;16,0;8,0;2,0;;256,0;21,0;16,0;7,0;2,0;1,0;11,0;2,0;18,0;;;7,0;5,0;53,0;2,0;17,0;35,0;1,0;;12,0;2,0;;9,0;11,0;1,0;54,0;9,0;10,0;;2,0;4,0;;31,0;21,0;7,0;15,0;11,0;306,0;21,0;17,0;69,0;46,0;2,0;49,0;;4,0;56,0;;52,0;;19,0;37,0;26,0;104,0;62,0;;6,0;3,0;13,0;13,0;;2,0;47,0;359,0;;5,0;;1,0;19,0;1,0;20,0;11,0;2,0;;;5,0;;5,0;5,0;;2,0;2,0;1,0;6,0;;1,0;16,0;6,0;18,0;6,0;;1,0;2,0;32,0;113,0;14,0;;1,0;18,0;1,0;7,0;7,0;41,0;24,0;3,0;33,0;19,0;;1,0;8,0;;;;12,0;30,0;;;23,0;1,0;3,0;15,0;;;6,0;28,0;;1,0;2,0;2,0;77,0;1,0;;1,0;10,0;3,0;60,0;3,0;;;34,0;;;5,0;4,0;;;9,0;;;;24,0;2,0;8,0;1,0;23,0;;2,0;4,0;78,0;6,0;28,0;2,0;9,0;23,0;2,0;5,0;2,0;6,0;;21,0;3,0;;1,0;;6,0;5,0;;;8,0;14,0;;;;6,0;24,0;27,0;;;7,0;;61,0;;7,0;2,0;;2,0;1,0;10,0;19,0;;;5,0;;3,0;1,0;6,0;2,0;45,0;26,0;;10,0;37,0;;;6,0;281,0;5,0;60,0;12,0;74,0;5,0;18,0;1,0;26,0;117,0;15,0;18,0;243,0;1,0;2,0;17,0;8,0;64,0;;5,0;27,0;;41,0;17,0;13,0;;3,0;13,0;;1,0;13,0;13,0;2,0;4,0;1,0;11,0;6,0;6,0;6,0;106,0;;29,0;51,0;16,0;34,0;;7,0;31,0;29,0;1,0;1,0;;4,0;;2,0;12,0;83,0;104,0;8,0;10,0;258,0;3,0;42,0;21,0;14,0;19,0;12,0;3,0;12,0;9,0;1,0;9,0;;4,0;16,0;2,0;7,0;16,0;5,0;1,0;;23,0;4,0;31,0;31,0;4,0;;3,0;1,0;70,0;;28,0;67,0;;4,0;1,0;5,0;8,0;24,0;1,0;16,0;43,0;2,0;;21,0;6,0;1,0;96,0;6,0;33,0;;13,0;;9,0;4,0;6,0;4,0;1,0;11,0;;;95,0;4,0;5,0;;5,0;6,0;9,0;;37,0;2,0;8,0;5,0;1,0;11,0;;60,0;;27,0;;4,0;1,0;2,0;;;14,0;33,0;12,0;;;1,0;3,0;;1,0;2,0;7,0;;5,0;;;8,0;3,0;;;3,0;;56,0;5,0;2,0;;;6,0;5,0;10,0;;;9,0;37,0;1,0;2,0;;3,0;;;5,0;12,0;26,0;;;30,0;3,0;;3,0;;144,0;;3,0;4,0;;;9,0;1,0;1,0;2,0;2,0;1,0;6,0;;;;4,0;63,0;;17,0;8,0;12,0;;47,0;;12,0;2,0;6,0;3,0;;1,0;1,0;7,0;17,0;;;1,0;2,0;;1,0;247,0;;;9,0;50,0;9,0;9,0;8,0;21,0;;;6,0;;16,0;19,0;7,0;2,0;46,0;149,0;1,0;;;51,0;;254,0;2,0;4,0;3,0;12,0;;;19,0;;12,0;4,0;7,0;2,0;2,0;8,0;3,0;4,0;2,0;;36,0;4,0;;1,0;2,0;9,0;2,0;1,0;8,0;1,0;5,0;;9,0;1,0;11,0;;;7,0;3,0;2,0;;2,0;;2,0;2,0;;;
sidewall;;1,0;;;;6,0;1,0;;;;;;12,0;55,0;;;2,0;;;;;;;4,0;;;;;;;4,0;;;4,0;;2,0;22,0;;;;;15,0;3,0;;;27,0;;6,0;;;;15,0;62,0;4,0;;;28,0;;;2,0;;;;;14,0;;18,0;;;;2,0;24,0;4,0;;;;2,0;;;;2,0;;;;46,0;1,0;;5,0;;;;1,0;4,0;10,0;;;;5,0;12,0;;18,0;1,0;;;;;;;;;;;1,0;;;;;5,0;;13,0;;;;5,0;;;;;1,0;3,0;;;6,0;7,0;;;4,0;;;;;20,0;;;;;;13,0;;6,0;2,0;;11,0;47,0;3,0;;2,0;5,0;;;7,0;27,0;;;;;;7,0;1,0;;;;;36,0;;55,0;1,0;;1,0;;;;2,0;10,0;;6,0;18,0;;19,0;1,0;;;;1,0;4,0;22,0;38,0;;31,0;2,0;2,0;25,0;1,0;;;;8,0;6,0;8,0;26,0;1,0;;5,0;;;23,0;;5,0;;;3,0;;;;16,0;;157,0;;;;1,0;;;;;;;;;;;;1,0;;;;1,0;5,0;34,0;7,0;;;;2,0;5,0;;8,0;49,0;4,0;;;;;;4,0;;;;;2,0;;2,0;3,0;1,0;;;1,0;6,0;1,0;4,0;2,0;;5,0;7,0;;;6,0;14,0;9,0;;1,0;1,0;;12,0;3,0;;16,0;;;1,0;;1,0;4,0;;;10,0;;;6,0;;3,0;6,0;9,0;;4,0;;10,0;2,0;1,0;1,0;3,0;2,0;55,0;;;;;;;2,0;3,0;2,0;;63,0;;;7,0;;;;;;;2,0;;2,0;10,0;5,0;;;;;;2,0;;;;25,0;;;;;;;;;;;;;2,0;;2,0;9,0;;;;;;;;;;3,0;;4,0;;;;;1,0;;;;;;;;;;;;;1,0;;4,0;;;;;1,0;;;;;4,0;;;;;;;;;;6,0;;;;;;;;;;;;;1,0;;;3,0;;;;;;;6,0;;;;;3,0;;;;2,0;13,0;1,0;;;;;;;;;;;;;3,0;;5,0;4,0;;;;;;;;;;;2,0;;;;;;3,0;;;1,0;1,0;;;2,0;;;;;;2,0;;;;;;2,0;;;;;;;;;;10,0;;;;;;;;;;;;8,0;;;;;;;;;;14,0;;;;;;;1,0;3,0;;;;;;;;;;;;;;;;;;;;;;;;1,0;;;18,0;;;;;13,0;;18,0;;;;;;;;;;;;;2,0;;;;;;;;;2,0;;;;;;;;2,0;;;;;;;;;;;4,0;;;;;;;;1,0;;;;5,0;;;;;;;;;;;1,0;;;;1,0;1,0;;;;;;;;;;;;;;1,0;;;;;;;;;;;;;2,0;;;;;;;18,0;;;2,0;;;;6,0;;7,0;;;;;;;2,0;;;;4,0;;;;;;1,0;;;;;4,0;;;1,0;;;1,0;;;;;;;;;1,0;;;;;;;;;;;;;;;;;;2,0;1,0;;;2,0;;1,0;;1,0;;;;;;1,0;;;;;;2,0;;;;;;7,0;;;;2,0;1,0;1,0;;;4,0;;;;;;;;;;;;;;;;;;;;;;;;;1,0;;;;;;;;2,0;;;;;;;;;;;;;;;;;;;;;;;;;;;;;;;;;;;;;;;;;;;;;;;;;;;;;;;;;;;;1,0;;;;;;1,0;;;1,0;;;;;;;;;;;;;;;;;;;3,0;;;;;1,0;2,0;;;;;;;;;;;;;;;;;;;;1,0;;;;;;;;;;;;;;;;;;;1,0;;;;;;;;;;;;;;;;;;;1,0;;;;;;;;;;;;;;;;;;;;;6,0;;;;;;
slide;;12,0;;3,0;2,0;6,0;;33,0;;;9,0;1,0;6,0;94,0;;;2,0;;65,0;;;;;;2,0;;;118,0;;;104,0;;;;;8,0;12,0;3,0;;;1,0;54,0;6,0;1,0;10,0;36,0;;76,0;;;;;17,0;4,0;;;11,0;;;4,0;;;;;26,0;2,0;44,0;;;;2,0;41,0;10,0;1,0;5,0;;2,0;;1,0;;21,0;;2,0;;11,0;13,0;1,0;21,0;;9,0;2,0;1,0;2,0;;2,0;;;2,0;14,0;2,0;154,0;8,0;;;2,0;3,0;2,0;1,0;1,0;;;2,0;4,0;3,0;4,0;;;4,0;3,0;4,0;;1,0;3,0;;;5,0;24,0;;;;9,0;;;19,0;;;2,0;;6,0;2,0;5,0;1,0;;;16,0;3,0;2,0;5,0;7,0;9,0;9,0;22,0;34,0;4,0;;;2,0;;;;;23,0;3,0;;;;32,0;22,0;;4,0;2,0;;6,0;62,0;3,0;19,0;1,0;;5,0;;;;3,0;3,0;3,0;;;12,0;15,0;2,0;;;;8,0;4,0;21,0;62,0;;2,0;10,0;;;;;;1,0;170,0;1,0;1,0;221,0;22,0;20,0;;;;2,0;;3,0;2,0;8,0;;3,0;;;82,0;12,0;55,0;1,0;28,0;;13,0;;1,0;;;;;;2,0;1,0;;6,0;3,0;4,0;;2,0;2,0;;65,0;;26,0;;;18,0;;;24,0;41,0;1,0;;;;13,0;2,0;8,0;;;;1,0;31,0;;;9,0;13,0;5,0;;22,0;17,0;;1,0;7,0;;17,0;4,0;;;;16,0;2,0;1,0;;3,0;9,0;4,0;;7,0;24,0;;6,0;17,0;;8,0;3,0;;18,0;72,0;1,0;23,0;;3,0;2,0;;15,0;51,0;;43,0;;29,0;6,0;22,0;8,0;2,0;10,0;;1,0;4,0;;5,0;;;13,0;6,0;102,0;18,0;1,0;;13,0;;2,0;1,0;21,0;4,0;1,0;;8,0;20,0;1,0;2,0;;18,0;1,0;15,0;;;23,0;3,0;13,0;7,0;;;;;;;1,0;12,0;;;;;6,0;;;3,0;1,0;;;;;;16,0;;1,0;;;8,0;;;;10,0;;;1,0;;3,0;1,0;;;2,0;;;;4,0;;21,0;7,0;;1,0;6,0;10,0;7,0;9,0;;11,0;22,0;;1,0;;;;;2,0;;1,0;;19,0;;1,0;;;;;11,0;;;4,0;2,0;;45,0;;;16,0;;2,0;;2,0;7,0;4,0;38,0;;;;;4,0;2,0;;;;;;6,0;4,0;;1,0;;;;;;;;;3,0;9,0;30,0;;;2,0;;;;;;;;;12,0;;1,0;7,0;;;;;;3,0;44,0;;;1,0;;;;30,0;2,0;5,0;;;7,0;;;;18,0;;1,0;;3,0;11,0;2,0;;43,0;2,0;;;;;8,0;1,0;;;23,0;;4,0;57,0;10,0;;;;1,0;3,0;;;1,0;35,0;2,0;;;;;;;;;;1,0;;;;;;;6,0;;;1,0;;;;;;;7,0;;1,0;8,0;2,0;;;;;;;;5,0;3,0;11,0;10,0;;;;;;;;9,0;;;1,0;;1,0;;;;1,0;;;29,0;;;;;;;4,0;;7,0;;;;;;;;;;;1,0;;;;;;;;;;;15,0;5,0;;1,0;;;4,0;;1,0;;;;;;;;15,0;;5,0;;;3,0;1,0;;;;;4,0;;;;4,0;;3,0;;3,0;4,0;;1,0;;5,0;;6,0;;;;2,0;;;1,0;;4,0;2,0;;27,0;;;;27,0;;;10,0;2,0;;;;20,0;7,0;1,0;16,0;2,0;;;;;1,0;;1,0;8,0;;;7,0;;;;6,0;;;;7,0;4,0;;;;;1,0;8,0;16,0;;;5,0;5,0;7,0;;2,0;;8,0;;1,0;3,0;;1,0;;;;;;;;;;;;6,0;;2,0;;16,0;;;;;2,0;;6,0;1,0;2,0;1,0;;;1,0;7,0;2,0;;;5,0;;;;;2,0;;;;;;;;;;;;;;;;4,0;19,0;;;;;;;;;;1,0;;;;;;14,0;;;;2,0;;;1,0;;;;;;;;;;7,0;;;1,0;1,0;;;;;;;;;;;;;1,0;;;;;;;1,0;;;;;;;;;;;;;;;;;;;;;;;;1,0;;;;;;;;;;;3,0;;6,0;;;2,0;;;;;;;1,0;;;;;;;;3,0;;;5,0;;7,0;;;;;4,0;;;;;20,0;14,0;;2,0;;;;;;2,0;;;4,0;;4,0;;;1,0;;;;;;;;;;;;1,0;;;;;;;;;;;;;;;;;;;;;;;;;;;;;;;;5,0;;;7,0;;;;
slot;;3,0;;2,0;;25,0;1,0;75,0;;;;;2,0;92,0;;;1,0;;4,0;;5,0;5,0;;3,0;3,0;;;3,0;;;36,0;;;;;3,0;46,0;;1,0;3,0;;36,0;1,0;2,0;;56,0;;18,0;;;;;52,0;2,0;;;107,0;;;2,0;;;;;7,0;;64,0;;;;15,0;22,0;;;;;;;1,0;39,0;28,0;;;;8,0;5,0;;1,0;;;;3,0;9,0;1,0;;;;8,0;45,0;1,0;76,0;;3,0;1,0;;1,0;;;;;;7,0;;;2,0;;;10,0;;11,0;;;1,0;;;;28,0;;3,0;1,0;12,0;;;15,0;;;13,0;;;2,0;;4,0;2,0;;21,0;;;24,0;4,0;18,0;;17,0;33,0;13,0;;1,0;1,0;;;;;17,0;;;;;18,0;20,0;1,0;;;;2,0;9,0;6,0;11,0;;;3,0;;;;;21,0;22,0;;13,0;;7,0;9,0;;;1,0;10,0;23,0;18,0;68,0;;7,0;23,0;;;5,0;;;;65,0;3,0;5,0;132,0;2,0;6,0;1,0;;1,0;9,0;;9,0;;8,0;;;;;75,0;1,0;43,0;;8,0;;7,0;;1,0;;5,0;;;;3,0;2,0;;13,0;1,0;;4,0;2,0;6,0;38,0;147,0;26,0;;2,0;1,0;22,0;4,0;;13,0;82,0;8,0;;;3,0;4,0;12,0;29,0;;;;;26,0;;;5,0;9,0;7,0;;9,0;19,0;1,0;7,0;6,0;;11,0;;;2,0;;9,0;;2,0;;;1,0;12,0;13,0;3,0;2,0;;;41,0;6,0;9,0;10,0;4,0;;10,0;5,0;8,0;;1,0;3,0;6,0;;5,0;10,0;6,0;18,0;23,0;3,0;8,0;;1,0;53,0;4,0;1,0;;;;;2,0;35,0;;29,0;7,0;;;15,0;;49,0;;9,0;16,0;;6,0;1,0;9,0;;12,0;;14,0;;2,0;;;1,0;54,0;9,0;10,0;2,0;;;;;;;13,0;;;;;23,0;2,0;;3,0;3,0;;;;;;5,0;;;;;;;;;2,0;;;;;;;;;8,0;;;3,0;;;1,0;3,0;;1,0;;;1,0;5,0;;4,0;2,0;;2,0;;;;;;;;;111,0;;;;1,0;4,0;;;;;1,0;;;;;;6,0;;7,0;;;;;2,0;;;;;3,0;3,0;3,0;;;;;;;;;;;;;;;;;;1,0;13,0;3,0;;2,0;;;;;;2,0;;1,0;3,0;;;;;;2,0;5,0;2,0;;;2,0;;;;6,0;3,0;;;16,0;;2,0;4,0;;;;5,0;85,0;;;;3,0;;;14,0;3,0;;;;;2,0;;8,0;;1,0;1,0;10,0;58,0;;;;2,0;6,0;6,0;;;;39,0;;;;;;;;1,0;;;2,0;;;;;;2,0;;2,0;;;;;;3,0;;;1,0;;;25,0;11,0;;;4,0;18,0;;;8,0;9,0;;6,0;9,0;;;;;;;;1,0;;;;;1,0;;;;7,0;2,0;;;;;;;;;2,0;;1,0;;;;;;;;;;;;;;;;;3,0;8,0;;;;1,0;6,0;;1,0;;1,0;5,0;;5,0;;;;1,0;;;;;;1,0;;;5,0;;;;;;1,0;;;;2,0;;;;3,0;;;;;;1,0;;;;;1,0;;;;;9,0;;;19,0;;;;9,0;;27,0;;2,0;;;;1,0;;40,0;17,0;9,0;;;;12,0;6,0;;1,0;;;1,0;;;;;;;;6,0;26,0;;1,0;;2,0;;;;14,0;;;10,0;4,0;;;;34,0;11,0;;;;2,0;;;1,0;;7,0;;;6,0;2,0;3,0;;;3,0;;4,0;2,0;7,0;;1,0;;;10,0;;;18,0;1,0;;;;;;;;;2,0;;4,0;;;5,0;;;;;;;;;;;;;3,0;;;;;;;;;;;;;;;;;;;;;;;;;;;;;;;;;;;;;;;;;;;;;;;;;;;;;;;;;;;1,0;;;;;;;;1,0;;;;;;;;;;;;11,0;;;;;;;;;;5,0;;1,0;;;;;;;;;;;;;;;;;1,0;;;;;;;;;;;;;;1,0;;;;;;;3,0;;1,0;;;;2,0;;;;;;;;4,0;;;;;;;;;;;;1,0;;;;;19,0;;;;;;;1,0;;;;;7,0;;;;;;;;;;;;;;;;;;;;;;;;;;;
smart;;6,0;1,0;1,0;2,0;2,0;;;;;;;;2,0;1,0;;17,0;;;7,0;;;3,0;9,0;16,0;;2,0;45,0;9,0;;79,0;7,0;;;;30,0;;;4,0;;14,0;354,0;;7,0;26,0;2,0;;1,0;;;;;;;1,0;;5,0;;1,0;5,0;1,0;;;2,0;27,0;;14,0;;;;;3,0;10,0;;;;;1,0;5,0;2,0;35,0;;15,0;;54,0;1,0;;5,0;;;2,0;;;1,0;;;;;4,0;14,0;24,0;;;4,0;2,0;16,0;1,0;;;1,0;;;;;1,0;;;1,0;1,0;14,0;;;11,0;;;9,0;24,0;;;;6,0;;;6,0;;3,0;7,0;;1,0;;;1,0;;;5,0;1,0;;2,0;3,0;1,0;;;1,0;;;1,0;;;;;;13,0;;;;;32,0;;;1,0;;;;;;;3,0;1,0;5,0;;4,0;2,0;;;;;;;;;;;;;;;;;;;;;;1,0;;1,0;2,0;2,0;;4,0;;;;;;;7,0;;;;;2,0;;1,0;1,0;;2,0;;1,0;;;;2,0;;4,0;2,0;;;1,0;;1,0;1,0;;;;;2,0;1,0;;;;;;;;5,0;2,0;;;;;15,0;;10,0;1,0;;;;;;;2,0;2,0;;;;11,0;;;;;1,0;;;;;;3,0;;;;9,0;;;;;;11,0;;;;;;;;;;;;6,0;;;;;;;1,0;;;;19,0;;;1,0;;;;;2,0;;;;;;4,0;;;;;;;;;;;;;;;;;;;;;;2,0;;8,0;43,0;;;;;1,0;;;;;;1,0;;3,0;1,0;6,0;3,0;;;1,0;;15,0;;;;;9,0;4,0;;;4,0;;5,0;;;3,0;2,0;;2,0;1,0;3,0;;;;2,0;;6,0;;3,0;13,0;1,0;;1,0;;16,0;1,0;;;;;;;;;;;47,0;2,0;18,0;;;;1,0;10,0;;;;4,0;;;;3,0;22,0;3,0;;;3,0;;;23,0;;;;8,0;1,0;;;;;;;10,0;8,0;;1,0;;3,0;;;;;;;6,0;8,0;;;;2,0;27,0;;;;8,0;;;;5,0;;10,0;;;;;;;;;1,0;1,0;;;;;;;;1,0;;;;3,0;;;;;;;;;;27,0;;;;;;1,0;;;;;;;1,0;;;;;;;;;;;;;2,0;;;;;;6,0;;25,0;3,0;;;;;1,0;;6,0;;1,0;;;2,0;32,0;;;;6,0;;;;;2,0;;;;;;;;;;3,0;;;16,0;;;;1,0;;;1,0;5,0;2,0;;;;;;;;;;;;;;;;;;;;;;2,0;;;2,0;;;;;;;;4,0;4,0;;;;;;;103,0;;;;;;;;4,0;;;2,0;1,0;;;;;;;;;11,0;5,0;;;;;;;;7,0;3,0;;1,0;;10,0;;;;;;3,0;;1,0;;;2,0;;;;;;;;;;;;;;1,0;;;;;;;;;;;;;;;1,0;;3,0;;;3,0;;;3,0;;;;;;;;;;;;2,0;;;;;4,0;;;;6,0;;;6,0;;;;;;;;;;;;;;;;;;;;;1,0;;;;;;;;;;;;;;;;;;;;;;;;1,0;;;;;;;;;;;;;;;;;;;;;1,0;;;;;;;;;;1,0;;;;;;;;;;;;;;;;;;;;;;;;;1,0;;;;;;;;;;;6,0;;;;;;;;;;;;;;;;;;;;;;;2,0;;;;;;;;;1,0;;;;;;1,0;;;;;;;;;;;;;;7,0;1,0;;;;;;;;;;;;;;;1,0;;;;;;;;;;;1,0;;;;;;;;;;;;;;;;;;;;;;;;;;;;;;;;;;;;;;;;;;;;;2,0;;;;;;;;;;;;;;;;
source;;24,0;7,0;33,0;18,0;155,0;96,0;60,0;;;;14,0;4,0;128,0;8,0;26,0;83,0;5,0;10,0;17,0;5,0;1,0;79,0;9,0;63,0;4,0;1,0;33,0;26,0;4,0;320,0;46,0;5,0;8,0;1,0;107,0;32,0;14,0;26,0;4,0;154,0;460,0;4,0;41,0;101,0;103,0;;116,0;;5,0;10,0;10,0;46,0;44,0;46,0;2,0;38,0;;57,0;165,0;2,0;14,0;22,0;2,0;771,0;13,0;282,0;4,0;15,0;3,0;2,0;132,0;3995,0;;;1,0;32,0;28,0;6,0;22,0;233,0;;20,0;5,0;68,0;10,0;4,0;136,0;26,0;10,0;19,0;7,0;23,0;4,0;45,0;;97,0;30,0;490,0;167,0;134,0;46,0;;8,0;60,0;133,0;11,0;15,0;6,0;9,0;;78,0;89,0;8,0;;;;16,0;49,0;177,0;12,0;;282,0;7,0;4,0;37,0;293,0;;7,0;1,0;109,0;4,0;;212,0;2,0;;65,0;6,0;2,0;;;18,0;;4,0;16,0;37,0;48,0;109,0;64,0;21,0;5,0;28,0;19,0;1,0;18,0;15,0;;;1,0;;6,0;301,0;21,0;5,0;11,0;6,0;122,0;15,0;;20,0;50,0;2,0;78,0;42,0;;23,0;13,0;339,0;9,0;1,0;53,0;8,0;12,0;18,0;1,0;20,0;44,0;;65,0;39,0;20,0;;7,0;32,0;2,0;10,0;106,0;23,0;1,0;;;18,0;;24,0;38,0;21,0;33,0;1,0;19,0;55,0;19,0;10,0;15,0;5,0;;9,0;125,0;12,0;;46,0;94,0;33,0;2,0;4,0;29,0;1,0;75,0;4,0;2,0;74,0;;133,0;50,0;49,0;5,0;8,0;41,0;29,0;1,0;15,0;2,0;7,0;1,0;1,0;3,0;71,0;24,0;11,0;61,0;3,0;;;;14,0;12,0;168,0;28,0;47,0;9,0;;20,0;51,0;12,0;48,0;11,0;;18,0;81,0;6,0;61,0;;16,0;19,0;12,0;8,0;;7,0;36,0;6,0;11,0;11,0;1,0;50,0;19,0;4,0;;3,0;3,0;78,0;1,0;17,0;14,0;;1,0;8,0;15,0;84,0;3,0;;2,0;;;2,0;16,0;3,0;;7,0;10,0;14,0;139,0;;;19,0;;;;46,0;2,0;3,0;9,0;30,0;104,0;4,0;7,0;13,0;;3,0;;763,0;1,0;;6,0;;4,0;8,0;;8,0;5,0;;;6,0;4,0;;;2,0;15,0;21,0;28,0;2,0;;;1,0;;14,0;23,0;7,0;93,0;1,0;151,0;20,0;;;;1,0;30,0;15,0;15,0;2,0;;4,0;;7,0;18,0;21,0;37,0;25,0;2,0;21,0;13,0;3,0;221,0;16,0;17,0;1,0;8,0;66,0;14,0;13,0;25,0;72,0;1,0;2,0;14,0;1,0;6,0;16,0;12,0;49,0;18,0;1,0;2,0;72,0;21,0;86,0;5,0;117,0;2,0;18,0;31,0;13,0;;2,0;;51,0;46,0;7,0;1,0;;;;6,0;34,0;14,0;4,0;7,0;166,0;45,0;39,0;9,0;;24,0;5,0;32,0;114,0;6,0;10,0;16,0;44,0;66,0;8,0;40,0;33,0;13,0;1,0;6,0;6,0;;7,0;45,0;;2,0;75,0;128,0;6,0;2,0;48,0;;55,0;10,0;8,0;70,0;7,0;7,0;20,0;4,0;;1,0;1,0;2,0;3,0;4,0;5,0;31,0;29,0;1,0;;97,0;2,0;2,0;5,0;;6,0;26,0;33,0;27,0;9,0;52,0;3,0;16,0;53,0;6,0;3,0;2,0;39,0;20,0;3,0;14,0;6,0;5,0;;3,0;41,0;2,0;;10,0;19,0;8,0;1,0;;;20,0;4,0;4,0;3,0;1,0;8,0;5,0;22,0;14,0;4,0;26,0;11,0;10,0;20,0;;;8,0;30,0;30,0;2,0;;;3,0;11,0;6,0;5,0;5,0;10,0;2,0;14,0;12,0;1,0;8,0;16,0;;2,0;;4,0;12,0;;1,0;;;6,0;6,0;13,0;8,0;1,0;;;;11,0;21,0;2,0;10,0;;5,0;3,0;8,0;12,0;;37,0;;;11,0;8,0;27,0;10,0;9,0;26,0;4,0;3,0;112,0;7,0;12,0;18,0;4,0;3,0;11,0;8,0;5,0;3,0;3,0;6,0;1,0;2,0;5,0;5,0;19,0;2,0;9,0;2,0;;8,0;9,0;26,0;;83,0;22,0;26,0;12,0;16,0;18,0;5,0;4,0;;6,0;7,0;;1,0;6,0;3,0;65,0;6,0;1,0;;4,0;;2,0;;;3,0;5,0;15,0;;;;;4,0;6,0;10,0;5,0;;4,0;58,0;19,0;5,0;;1,0;5,0;1,0;1,0;9,0;;10,0;1,0;;4,0;4,0;;12,0;16,0;4,0;1,0;28,0;;;;;7,0;;6,0;2,0;6,0;2,0;43,0;3,0;6,0;139,0;;1,0;1,0;3,0;60,0;18,0;26,0;11,0;;4,0;2,0;;2,0;31,0;2,0;16,0;73,0;2,0;1,0;;;19,0;1,0;5,0;103,0;53,0;3,0;;;;;;;4,0;;3,0;329,0;;11,0;1,0;5,0;7,0;;;;2,0;5,0;;21,0;15,0;1,0;3,0;;10,0;13,0;21,0;1,0;2,0;4,0;2,0;;3,0;;1,0;1,0;;28,0;3,0;93,0;6,0;;;1,0;1,0;5,0;;;;;16,0;26,0;4,0;2,0;;;;;1,0;4,0;22,0;;;;37,0;2,0;;1,0;1,0;1,0;22,0;;9,0;;;;15,0;;10,0;16,0;;11,0;27,0;20,0;3,0;30,0;1,0;3,0;9,0;4,0;2,0;20,0;5,0;92,0;29,0;18,0;3,0;4,0;2,0;4,0;7,0;4,0;48,0;;1,0;5,0;10,0;6,0;65,0;;2,0;;;11,0;2,0;;10,0;2,0;4,0;6,0;4,0;;;294,0;6,0;;4,0;;2,0;2,0;;;4,0;2,0;;;;7,0;12,0;14,0;;;;10,0;16,0;;2,0;21,0;22,0;1,0;2,0;4,0;2,0;215,0;1,0;7,0;;11,0;7,0;;6,0;4,0;6,0;8,0;3,0;61,0;;1,0;;3,0;1,0;15,0;;1,0;3,0;48,0;;14,0;;3,0;;2,0;1,0;4,0;;;1,0;;2,0;;3,0;;;;3,0;;;61,0;2,0;2,0;;63,0;5,0;;7,0;12,0;1,0;1,0;3,0;1,0;;12,0;;;1,0;24,0;;18,0;6,0;31,0;53,0;;;;;9,0;;;;1,0;1,0;2,0;4,0;;4,0;;;;1,0;1,0;;11,0;2,0;;;;;;2,0;5,0;10,0;20,0;1,0;34,0;10,0;1,0;1,0;;1,0;2,0;;;4,0;;4,0;;1,0;3,0;4,0;4,0;7,0;3,0;8,0;6,0;1,0;2,0;1,0;1,0;2,0;;5,0;3,0;;4,0;2,0;3,0;;1,0;10,0;;2,0;
space;;4,0;;21,0;14,0;42,0;26,0;75,0;;;5,0;;28,0;207,0;5,0;6,0;55,0;12,0;14,0;6,0;1,0;3,0;329,0;24,0;5,0;1,0;;186,0;12,0;5,0;113,0;26,0;;19,0;1,0;58,0;140,0;5,0;39,0;1,0;78,0;139,0;9,0;16,0;32,0;203,0;2,0;72,0;2,0;3,0;10,0;21,0;66,0;33,0;47,0;1,0;157,0;;1,0;46,0;7,0;2,0;34,0;15,0;459,0;4,0;232,0;1,0;5,0;28,0;9,0;424,0;94,0;;3,0;;18,0;2,0;1,0;39,0;116,0;10,0;;37,0;164,0;25,0;;142,0;12,0;4,0;21,0;10,0;7,0;10,0;4,0;8,0;40,0;52,0;226,0;85,0;212,0;75,0;8,0;4,0;7,0;38,0;8,0;1,0;;;;29,0;48,0;12,0;2,0;;12,0;19,0;30,0;154,0;9,0;6,0;41,0;18,0;1,0;28,0;151,0;2,0;;9,0;37,0;;2,0;163,0;;;104,0;94,0;14,0;;5,0;41,0;1,0;;34,0;27,0;50,0;101,0;22,0;19,0;5,0;5,0;119,0;42,0;;;8,0;1,0;;1,0;8,0;29,0;6,0;23,0;3,0;;105,0;70,0;1,0;35,0;5,0;;9,0;128,0;4,0;43,0;;1,0;9,0;2,0;;4,0;7,0;33,0;5,0;6,0;60,0;3,0;62,0;33,0;4,0;1,0;5,0;11,0;58,0;39,0;143,0;8,0;74,0;7,0;3,0;20,0;6,0;1,0;7,0;9,0;133,0;4,0;13,0;62,0;22,0;24,0;11,0;5,0;9,0;49,0;30,0;48,0;2,0;11,0;6,0;2,0;9,0;;53,0;3,0;255,0;1,0;3,0;10,0;11,0;;26,0;;28,0;8,0;2,0;1,0;1,0;21,0;2,0;15,0;6,0;5,0;36,0;23,0;20,0;28,0;128,0;2,0;12,0;8,0;;42,0;33,0;7,0;86,0;203,0;16,0;1,0;3,0;5,0;7,0;48,0;49,0;;1,0;;3,0;20,0;20,0;28,0;14,0;8,0;2,0;;11,0;14,0;649,0;6,0;5,0;1,0;110,0;49,0;2,0;2,0;45,0;9,0;33,0;5,0;63,0;2,0;5,0;7,0;9,0;4,0;163,0;;21,0;10,0;10,0;2,0;7,0;8,0;;42,0;14,0;19,0;6,0;87,0;5,0;2,0;21,0;;8,0;4,0;59,0;15,0;6,0;10,0;16,0;229,0;21,0;16,0;11,0;20,0;3,0;3,0;9,0;12,0;29,0;4,0;18,0;32,0;6,0;3,0;5,0;;11,0;1,0;10,0;13,0;5,0;7,0;14,0;10,0;6,0;;;27,0;5,0;;;1,0;47,0;5,0;;45,0;107,0;3,0;2,0;;;9,0;;7,0;11,0;3,0;1,0;2,0;3,0;4,0;20,0;20,0;15,0;3,0;8,0;6,0;2,0;10,0;35,0;130,0;;3,0;;25,0;1,0;14,0;;;;2,0;1,0;14,0;8,0;8,0;29,0;49,0;10,0;1,0;1,0;10,0;4,0;2,0;7,0;79,0;10,0;15,0;21,0;7,0;4,0;23,0;5,0;;7,0;14,0;7,0;4,0;;6,0;;1,0;;3,0;6,0;105,0;;19,0;2,0;3,0;4,0;19,0;12,0;2,0;1,0;2,0;42,0;4,0;4,0;;6,0;3,0;5,0;6,0;3,0;7,0;1,0;1,0;60,0;;5,0;;;9,0;9,0;2,0;1,0;23,0;;;16,0;;3,0;14,0;4,0;21,0;5,0;;;;1,0;;;22,0;89,0;12,0;2,0;12,0;1,0;9,0;71,0;2,0;29,0;2,0;1,0;25,0;12,0;84,0;1,0;11,0;;1,0;8,0;16,0;1,0;;10,0;1,0;;2,0;8,0;5,0;4,0;6,0;16,0;14,0;1,0;;;;1,0;;;2,0;1,0;11,0;2,0;52,0;16,0;;18,0;5,0;13,0;2,0;;;9,0;4,0;30,0;;3,0;43,0;1,0;20,0;18,0;;23,0;;9,0;4,0;1,0;;5,0;60,0;1,0;2,0;;1,0;22,0;;;3,0;6,0;4,0;;1,0;2,0;8,0;1,0;;2,0;;;;12,0;;4,0;;6,0;1,0;2,0;1,0;;11,0;10,0;8,0;;4,0;27,0;4,0;4,0;;4,0;;2,0;8,0;26,0;;8,0;2,0;;4,0;1,0;9,0;3,0;;1,0;3,0;42,0;;;1,0;;39,0;2,0;3,0;2,0;5,0;;1,0;;;5,0;14,0;1,0;;10,0;2,0;;3,0;1,0;;7,0;2,0;;;2,0;1,0;;;2,0;1,0;;;1,0;2,0;2,0;6,0;8,0;;1,0;1,0;4,0;2,0;;18,0;;;;1,0;;1,0;1,0;1,0;59,0;6,0;10,0;;10,0;4,0;4,0;4,0;;;7,0;2,0;;;1,0;;28,0;;2,0;;11,0;4,0;;1,0;54,0;2,0;;1,0;;1,0;10,0;;1,0;;88,0;;;12,0;;;1,0;23,0;;19,0;1,0;1,0;1,0;;39,0;16,0;38,0;15,0;6,0;7,0;2,0;35,0;;;6,0;24,0;9,0;10,0;;16,0;;7,0;;6,0;1,0;1,0;;1,0;24,0;;2,0;1,0;2,0;1,0;;11,0;57,0;;11,0;1,0;3,0;5,0;4,0;5,0;;4,0;2,0;4,0;;13,0;;3,0;18,0;37,0;27,0;4,0;;6,0;3,0;9,0;9,0;;8,0;;10,0;42,0;5,0;13,0;2,0;2,0;;16,0;10,0;4,0;31,0;;;1,0;1,0;11,0;27,0;;;;1,0;;35,0;1,0;9,0;5,0;2,0;;;2,0;6,0;1,0;;;51,0;;1,0;;8,0;2,0;12,0;;9,0;1,0;;;15,0;34,0;;6,0;;;1,0;4,0;;;;3,0;;7,0;6,0;;14,0;;5,0;1,0;;5,0;5,0;;4,0;;4,0;8,0;;;;;12,0;4,0;;;;1,0;;6,0;;;;6,0;2,0;6,0;1,0;;47,0;;;;1,0;7,0;;;;1,0;6,0;;3,0;;;1,0;4,0;2,0;;;5,0;;15,0;4,0;15,0;;2,0;;5,0;;1,0;;1,0;5,0;2,0;;;2,0;4,0;;;;1,0;;;8,0;;1,0;;;1,0;;7,0;;;;1,0;;;;;5,0;;2,0;1,0;1,0;;;;1,0;;8,0;;;;;;12,0;7,0;;1,0;2,0;;;5,0;;1,0;2,0;;2,0;81,0;;;;5,0;13,0;;4,0;;;;;2,0;;;;;;;;5,0;2,0;10,0;;1,0;8,0;6,0;;;1,0;3,0;6,0;;;;1,0;3,0;5,0;;;;2,0;;;6,0;;;3,0;;;;3,0;;
specific;;8,0;;1,0;7,0;30,0;3,0;5,0;3,0;;;80,0;;113,0;;9,0;118,0;;10,0;22,0;;2,0;35,0;6,0;14,0;;;16,0;5,0;38,0;73,0;12,0;2,0;10,0;;22,0;5,0;;16,0;2,0;55,0;42,0;;1,0;62,0;2,0;;4,0;;1,0;2,0;;;2,0;11,0;23,0;9,0;;1,0;23,0;;;7,0;;317,0;2,0;60,0;1,0;6,0;;4,0;59,0;178,0;;20,0;3,0;1,0;1,0;;7,0;70,0;;26,0;4,0;19,0;8,0;;15,0;;5,0;23,0;1,0;52,0;;13,0;;18,0;15,0;56,0;52,0;165,0;42,0;;3,0;25,0;11,0;4,0;17,0;1,0;;;20,0;88,0;3,0;;1,0;3,0;7,0;16,0;17,0;12,0;18,0;56,0;24,0;80,0;36,0;53,0;;;;37,0;;;26,0;;;27,0;1,0;4,0;;;5,0;;;1,0;5,0;18,0;7,0;17,0;;1,0;8,0;9,0;;5,0;;;;;;;2,0;48,0;17,0;;;2,0;5,0;1,0;12,0;4,0;;2,0;115,0;;;1,0;8,0;6,0;;2,0;;;44,0;;2,0;63,0;;60,0;1,0;;;;;;;7,0;;3,0;;;;;;2,0;1,0;3,0;;1,0;24,0;18,0;12,0;;2,0;;;13,0;1,0;6,0;3,0;9,0;12,0;6,0;15,0;4,0;;6,0;;;1,0;3,0;;21,0;;;8,0;3,0;;;3,0;;;2,0;;;22,0;;2,0;;;;;;7,0;;6,0;2,0;24,0;;;;32,0;7,0;36,0;1,0;;;37,0;;3,0;1,0;;1,0;16,0;6,0;;6,0;18,0;;;;4,0;6,0;1,0;7,0;;1,0;8,0;11,0;;10,0;2,0;;;;;68,0;5,0;;;;;;;;;2,0;19,0;;7,0;;2,0;;;;;7,0;;1,0;;23,0;211,0;24,0;3,0;1,0;;;;5,0;;;;;;1,0;2,0;;;;;6,0;;2,0;;;;4,0;4,0;;;;;;;5,0;;;;35,0;5,0;;;;;10,0;;;2,0;;;3,0;;12,0;7,0;19,0;6,0;3,0;11,0;2,0;;32,0;18,0;2,0;5,0;3,0;30,0;7,0;2,0;;30,0;8,0;4,0;4,0;17,0;1,0;39,0;;30,0;13,0;2,0;;9,0;14,0;14,0;;33,0;;36,0;8,0;;;8,0;1,0;9,0;36,0;9,0;;;;4,0;;1,0;5,0;1,0;1,0;27,0;5,0;15,0;;4,0;10,0;1,0;13,0;2,0;1,0;;4,0;55,0;4,0;;3,0;57,0;6,0;;;2,0;;;97,0;;;15,0;7,0;;;;1,0;14,0;5,0;5,0;1,0;4,0;3,0;2,0;;;;1,0;1,0;5,0;1,0;6,0;2,0;13,0;;;;5,0;;;;1,0;;4,0;;;19,0;1,0;3,0;4,0;;8,0;;3,0;4,0;;23,0;1,0;9,0;;;;;9,0;4,0;;;;;2,0;1,0;1,0;1,0;6,0;1,0;;;5,0;;;4,0;;;;17,0;;;;2,0;;;31,0;;6,0;;;13,0;7,0;4,0;4,0;2,0;;;;;1,0;;1,0;;30,0;;5,0;4,0;1,0;1,0;1,0;;2,0;;3,0;1,0;;2,0;;2,0;;4,0;1,0;;8,0;2,0;1,0;;;;;5,0;1,0;;;;;;;;;;;14,0;;;;;;3,0;;;;;;;;4,0;47,0;1,0;;5,0;4,0;3,0;;3,0;;;5,0;;;1,0;6,0;;2,0;1,0;1,0;7,0;2,0;;;;;4,0;6,0;;1,0;14,0;2,0;;;;2,0;1,0;1,0;1,0;3,0;;1,0;;;;;1,0;6,0;;;4,0;1,0;;2,0;2,0;5,0;3,0;1,0;;1,0;2,0;;2,0;;;4,0;;4,0;3,0;2,0;;6,0;;8,0;1,0;;36,0;;;3,0;;;1,0;7,0;4,0;;7,0;;;1,0;;1,0;;3,0;7,0;1,0;;;;;;;1,0;;;;;;;;2,0;1,0;;3,0;;5,0;2,0;;4,0;;;3,0;9,0;1,0;;;7,0;;;;;;7,0;;;;;;;;1,0;;;20,0;;9,0;1,0;;;;;;;;;;;;;;;;;;;;;;6,0;;;;;;;;;;;;;;1,0;;2,0;1,0;;;;2,0;5,0;;;;25,0;;;;;;;4,0;;3,0;;;;;;;;;;;;;;;;;;1,0;;;;;;;;;7,0;;10,0;1,0;6,0;;1,0;4,0;;;19,0;;;1,0;1,0;;2,0;;2,0;;;;;;3,0;;;;;;;;2,0;;;;;;;;23,0;;1,0;;;;1,0;;;;1,0;;1,0;1,0;3,0;4,0;1,0;2,0;;;;;;3,0;;;;;;2,0;2,0;1,0;1,0;;;;;4,0;4,0;20,0;;;;;2,0;27,0;;;1,0;1,0;2,0;;;;1,0;;4,0;;5,0;;;;;3,0;;;;;;;13,0;;;;2,0;1,0;;2,0;;;;;25,0;1,0;;;;8,0;;;;;;;3,0;;1,0;;;;;4,0;;;;;;;;;;;;2,0;;;3,0;2,0;4,0;;;2,0;1,0;;;9,0;;
spring;;2,0;;1,0;;41,0;1,0;51,0;;;;1,0;13,0;45,0;;;8,0;;25,0;;;;;;;;;12,0;;;67,0;;;1,0;;;8,0;;3,0;3,0;;111,0;4,0;4,0;1,0;48,0;;87,0;;;;;59,0;4,0;3,0;;71,0;;;4,0;;;2,0;;11,0;;151,0;3,0;;5,0;5,0;135,0;3,0;;;;11,0;;;;15,0;;6,0;1,0;126,0;19,0;;40,0;;1,0;;5,0;4,0;2,0;1,0;;;5,0;88,0;43,0;75,0;7,0;;1,0;;;;;;;3,0;;3,0;1,0;1,0;;;15,0;;11,0;;2,0;;;;;36,0;;;4,0;;2,0;1,0;74,0;;;5,0;;;;4,0;6,0;1,0;;11,0;51,0;4,0;50,0;2,0;47,0;240,0;2,0;40,0;20,0;2,0;;;2,0;;2,0;18,0;185,0;;;;;108,0;24,0;2,0;1,0;;;3,0;45,0;10,0;5,0;;;4,0;;;6,0;;12,0;6,0;;3,0;135,0;27,0;11,0;;;1,0;9,0;57,0;13,0;90,0;;18,0;9,0;4,0;1,0;5,0;37,0;;;514,0;11,0;10,0;109,0;30,0;17,0;4,0;;1,0;45,0;3,0;5,0;;;;;;;94,0;;157,0;14,0;9,0;5,0;5,0;;1,0;1,0;1,0;;;;1,0;;2,0;47,0;9,0;1,0;1,0;4,0;15,0;12,0;81,0;18,0;14,0;4,0;4,0;17,0;8,0;7,0;96,0;52,0;6,0;;;;;6,0;14,0;;57,0;;5,0;4,0;1,0;67,0;25,0;11,0;;4,0;10,0;1,0;11,0;21,0;6,0;20,0;61,0;2,0;;3,0;6,0;9,0;8,0;;69,0;3,0;2,0;5,0;2,0;;3,0;1,0;55,0;52,0;21,0;3,0;9,0;1,0;;18,0;7,0;2,0;;3,0;;;21,0;;;6,0;7,0;10,0;;69,0;1,0;;18,0;;2,0;5,0;1,0;;9,0;1,0;2,0;1,0;3,0;7,0;;;12,0;2,0;1,0;14,0;14,0;49,0;3,0;21,0;;14,0;;27,0;;;1,0;4,0;;;;2,0;2,0;107,0;;;;;;1,0;;7,0;;;;;;;;3,0;;;;;;;13,0;;;;;;;;;;;;;2,0;2,0;1,0;;;;;;;;;5,0;;;;2,0;10,0;5,0;4,0;;6,0;2,0;;;3,0;;;;;;;;24,0;;7,0;6,0;;;;;;;9,0;;;4,0;;4,0;15,0;;1,0;;;;;1,0;;;;;3,0;1,0;3,0;;;4,0;;;7,0;;3,0;;;;;;;;;;1,0;7,0;6,0;;3,0;;;33,0;;;6,0;4,0;21,0;;1,0;1,0;;;;;1,0;;;;;;2,0;;;;;;11,0;;;1,0;;;;;;;;5,0;22,0;;1,0;19,0;6,0;1,0;3,0;;;4,0;;5,0;;3,0;;1,0;12,0;4,0;;2,0;;5,0;;;;;46,0;;;;;3,0;;;;;2,0;;;;;;;;;2,0;5,0;;;;2,0;2,0;;;6,0;;1,0;9,0;3,0;;;4,0;;3,0;;2,0;1,0;2,0;24,0;95,0;;;5,0;;;;;10,0;;;;;;;;;;;;;2,0;;;;;;7,0;;2,0;;;;;;;;;;;;;;;;;;;;;;2,0;3,0;;;;2,0;;;;;1,0;;;;;;1,0;;;;;;;;;;;3,0;;;;5,0;;;;2,0;;;;;19,0;;;;;;2,0;;;;;8,0;;;25,0;;;15,0;50,0;1,0;5,0;1,0;;;;6,0;53,0;33,0;2,0;1,0;3,0;;;;;34,0;;3,0;;;2,0;1,0;;;;;;;4,0;17,0;;;;;;;1,0;17,0;;3,0;13,0;21,0;;;1,0;;8,0;;;;;;4,0;33,0;26,0;3,0;2,0;;;1,0;13,0;12,0;;23,0;5,0;3,0;2,0;3,0;;;;;;;8,0;7,0;3,0;;;8,0;;3,0;12,0;;;;;;;1,0;4,0;;;;;;;;1,0;;1,0;;;;;3,0;1,0;;;;;;;;;;;;;;1,0;;;;;;;;;;;;4,0;;;;;;1,0;23,0;;;;1,0;2,0;;;;;;;;;;;5,0;;;;;;;;;;;;;;;;;;;;;;;;;;;;5,0;;;;;;;;;2,0;;;;;;;;;;;;;;;;;1,0;;13,0;;;;;;5,0;;5,0;;;;;1,0;;;;;1,0;;;;;;19,0;;;;1,0;;;;7,0;;;6,0;;;3,0;;;1,0;;24,0;1,0;3,0;;;2,0;;;;1,0;;;;;;;;;;;;;;;;;;;;;;;;;;;;;1,0;;1,0;;;;;;;;
stand;;1,0;;3,0;;13,0;2,0;84,0;;;;;1,0;57,0;;;;;1,0;;;4,0;;;;;;5,0;;;15,0;1,0;;;;;4,0;7,0;3,0;1,0;2,0;34,0;2,0;;9,0;1,0;2,0;13,0;;;;3,0;9,0;;;;10,0;6,0;;3,0;;;1,0;;4,0;;30,0;;1,0;;;5,0;1,0;;;;2,0;;;;12,0;;3,0;;4,0;1,0;;1,0;;;;;1,0;;2,0;;;1,0;;1,0;70,0;3,0;;;;;;;;;;;;4,0;3,0;;;;;2,0;;;17,0;;;;23,0;;;;;;;10,0;;;1,0;2,0;;;;3,0;;;6,0;1,0;4,0;;5,0;12,0;;;3,0;8,0;;34,0;;;;;;20,0;;;;;19,0;;;;;;;6,0;;;;;2,0;;;;;15,0;9,0;;;3,0;3,0;5,0;;;;5,0;;10,0;15,0;;;4,0;;;;;;;32,0;2,0;5,0;39,0;2,0;3,0;;;;2,0;7,0;;;1,0;;;;;13,0;;26,0;;;;;;6,0;;;;;;1,0;;;7,0;1,0;;;2,0;4,0;1,0;7,0;2,0;;;;28,0;;;28,0;30,0;1,0;;;;;12,0;7,0;;;;;;;1,0;;6,0;;3,0;2,0;8,0;;1,0;2,0;;6,0;1,0;;;;24,0;;;;;;;2,0;;4,0;;3,0;5,0;2,0;;2,0;;;;7,0;6,0;1,0;1,0;2,0;;1,0;;7,0;2,0;;;2,0;7,0;2,0;1,0;1,0;;;1,0;;24,0;2,0;;;6,0;;3,0;;3,0;2,0;;;4,0;;6,0;1,0;4,0;;26,0;;5,0;;1,0;;4,0;;;1,0;;2,0;4,0;;2,0;;;;;;;;;1,0;;1,0;;;4,0;;;;;;;4,0;;;1,0;5,0;16,0;;;;;;;;;;2,0;;;;;;2,0;2,0;4,0;2,0;4,0;;8,0;13,0;4,0;;2,0;;3,0;;;;;;;;;;;;27,0;1,0;;;;3,0;;;;2,0;;;;;;;;;;;;;1,0;8,0;;;;;;;;;;;1,0;7,0;;;;;;;;;;;;;;;6,0;;;;;;;;2,0;;;1,0;;2,0;;;;1,0;;;;1,0;;;;;;;;;3,0;;;;;;;;;;;;15,0;2,0;;2,0;1,0;;;;;1,0;;1,0;;;;;3,0;2,0;;;;;;;;;14,0;;;;;;;2,0;;;;;;;;1,0;;;;;;;;;;;;;;;;;;;;;;;;;7,0;;;;;;;;;;;;;;;;;;;;1,0;;;;2,0;;;;;;5,0;6,0;11,0;;;;1,0;;;1,0;;;;;;;;;;1,0;;;;;1,0;3,0;;15,0;;;;;;;14,0;;;;;;;;1,0;;;15,0;;;;1,0;;;;;;;;;;;;;;;2,0;;;;;;1,0;;;;;;;;;;;;2,0;;;3,0;2,0;;;;1,0;1,0;;;;;;;3,0;;;13,0;;;;;;3,0;;;;;;11,0;;;;;;;5,0;6,0;;;1,0;;;;;;1,0;2,0;;;2,0;;;;;;;;;;;;;;;;;1,0;;;;;2,0;4,0;1,0;2,0;2,0;;;;;;;;;;;2,0;;;1,0;;;;;;;;;;;;;;1,0;;;;;;;1,0;;;;;;;;;;;;4,0;;;;;;;;;;;;;;;;;;;;;;;;;1,0;;;;;;;2,0;;;;;;;;;;;;;;;;;;;;;;;;;;;;;;;;;;;;;;;;;;;;;;4,0;;;25,0;;;;;;;;;;;;;;;;;;;;;;;;;;;;;;1,0;;4,0;;1,0;;;;1,0;;;;1,0;;;;;;;;1,0;1,0;;;;;;;;;;;;;;;;;;;;1,0;;;;;2,0;;;;;;;;;;;;;;;;;;3,0;;;;
start;;2,0;;14,0;18,0;38,0;;2,0;1,0;4,0;2,0;;;40,0;;5,0;75,0;4,0;;;;;;;9,0;;;3,0;6,0;49,0;74,0;12,0;;;;83,0;12,0;;;;95,0;141,0;;11,0;39,0;1,0;;29,0;;;;;8,0;2,0;3,0;2,0;2,0;;2,0;18,0;;;1,0;3,0;228,0;4,0;58,0;3,0;2,0;;2,0;35,0;34,0;;;;;8,0;1,0;7,0;63,0;;46,0;;44,0;6,0;1,0;32,0;;1,0;9,0;;3,0;;94,0;;14,0;4,0;37,0;103,0;72,0;15,0;;46,0;18,0;10,0;;7,0;;;;28,0;6,0;1,0;;;;9,0;5,0;46,0;4,0;;180,0;8,0;;22,0;58,0;;;;220,0;;;119,0;5,0;;6,0;;1,0;;;1,0;6,0;;11,0;;18,0;7,0;17,0;;;4,0;9,0;;8,0;5,0;;;;;1,0;5,0;6,0;;7,0;;3,0;;;9,0;;;1,0;5,0;;;;6,0;8,0;;;;5,0;7,0;;1,0;;1,0;47,0;1,0;;;;2,0;2,0;;2,0;5,0;;;;3,0;;4,0;19,0;7,0;14,0;;1,0;6,0;36,0;24,0;24,0;;;2,0;56,0;;;7,0;3,0;31,0;1,0;1,0;;;44,0;3,0;5,0;;;4,0;2,0;;1,0;12,0;1,0;;;3,0;;2,0;;;;8,0;;;2,0;6,0;;;;1,0;;27,0;;6,0;;;9,0;41,0;;22,0;;;;;;7,0;;24,0;1,0;;;;3,0;8,0;;2,0;;6,0;;2,0;;;;17,0;34,0;;6,0;;;;;;8,0;12,0;1,0;;;;;5,0;;3,0;;8,0;;33,0;;;18,0;1,0;1,0;;2,0;8,0;;4,0;73,0;24,0;;;3,0;;11,0;;7,0;;;;;;209,0;;3,0;;;;5,0;17,0;2,0;;;6,0;16,0;;;;;;;;29,0;;7,0;;148,0;16,0;;;;3,0;6,0;9,0;3,0;1,0;;1,0;;1,0;10,0;5,0;27,0;39,0;;7,0;3,0;;91,0;13,0;7,0;;;25,0;11,0;4,0;;17,0;1,0;14,0;;6,0;1,0;18,0;;16,0;36,0;;;34,0;1,0;10,0;;105,0;;9,0;15,0;10,0;;18,0;;30,0;267,0;12,0;;;;;;2,0;;15,0;;97,0;10,0;54,0;2,0;;1,0;1,0;12,0;2,0;3,0;;10,0;20,0;71,0;8,0;4,0;33,0;1,0;;;3,0;;;91,0;;;;21,0;;;1,0;;12,0;1,0;1,0;5,0;2,0;33,0;18,0;;1,0;4,0;3,0;;;8,0;3,0;65,0;25,0;;;;2,0;1,0;;3,0;;;5,0;;;19,0;;6,0;3,0;;;;;3,0;;6,0;;11,0;;2,0;10,0;;;;5,0;;43,0;4,0;5,0;2,0;;13,0;;;2,0;5,0;3,0;4,0;;1,0;;;3,0;2,0;;;;4,0;;;45,0;1,0;3,0;4,0;;27,0;5,0;;1,0;;3,0;;9,0;;1,0;;;;12,0;;;46,0;;13,0;4,0;1,0;3,0;;;;;1,0;2,0;;;1,0;1,0;;3,0;;;;1,0;;;6,0;1,0;;;;;;1,0;;;;;7,0;;;;20,0;2,0;3,0;;;6,0;;3,0;;;;10,0;1,0;8,0;;2,0;;;;;;;;2,0;;12,0;;1,0;36,0;18,0;;2,0;;;;;;7,0;;;;5,0;;8,0;;1,0;;2,0;;;;;;;;;2,0;;26,0;;1,0;;;;;3,0;4,0;2,0;2,0;4,0;6,0;;20,0;;;1,0;;;11,0;;;4,0;2,0;;;3,0;13,0;;19,0;;;19,0;4,0;15,0;;;;;;;16,0;1,0;;26,0;1,0;;;;1,0;;;7,0;5,0;;;;;9,0;3,0;;;;5,0;1,0;31,0;3,0;11,0;;9,0;;;14,0;3,0;;;;;;;12,0;;;10,0;;;4,0;9,0;;;;;11,0;;;5,0;;6,0;;;3,0;;;;;2,0;;;;;;;;;;;;;;12,0;2,0;4,0;1,0;;;;;;;;;;;;;;3,0;;8,0;;;6,0;4,0;;;1,0;23,0;88,0;3,0;1,0;;;19,0;;;;;6,0;;;;;5,0;10,0;7,0;;;;;5,0;;1,0;6,0;24,0;;;;2,0;;6,0;7,0;1,0;;;;;8,0;1,0;;;;;;;14,0;;;;;2,0;2,0;;4,0;;;3,0;;1,0;;;2,0;;;;;1,0;;;3,0;;;10,0;1,0;2,0;9,0;;8,0;;3,0;;;;1,0;;;;;;;;7,0;;;;5,0;;14,0;;4,0;47,0;;3,0;;;3,0;;2,0;3,0;18,0;;;;;;;;;;;32,0;;;1,0;14,0;;;1,0;8,0;;;;;;1,0;;;;;;;;;;;;;;;;;;;;;;;;2,0;;;6,0;;;;;;;;;;;;;;;;;;;;;;;2,0;;;;;;;;;;;;;2,0;;
status;;10,0;;4,0;3,0;23,0;3,0;1,0;;;;;;58,0;;6,0;12,0;;6,0;7,0;;;4,0;5,0;37,0;;;10,0;10,0;3,0;93,0;1,0;;4,0;2,0;43,0;;;;;104,0;56,0;;14,0;36,0;;;2,0;;4,0;;;;4,0;;3,0;;;3,0;2,0;;;4,0;4,0;46,0;;56,0;3,0;4,0;;3,0;20,0;24,0;2,0;;;;;;10,0;52,0;;34,0;2,0;39,0;4,0;;9,0;;1,0;3,0;;4,0;;1,0;1,0;;;37,0;2,0;38,0;16,0;;57,0;17,0;36,0;;1,0;;;;28,0;3,0;1,0;;;;2,0;;18,0;;;47,0;;;8,0;105,0;;;;10,0;;;17,0;;;;;;;;;;;;;2,0;3,0;22,0;;1,0;3,0;18,0;;;2,0;;;;;;2,0;;;;;2,0;;;4,0;11,0;;2,0;;;;;1,0;1,0;;1,0;;1,0;1,0;;;2,0;;22,0;1,0;;;1,0;;1,0;;2,0;;;;;4,0;;;1,0;4,0;7,0;;4,0;1,0;;3,0;;;;;14,0;;;;14,0;16,0;5,0;;;;4,0;;;;;;2,0;;1,0;;6,0;;1,0;5,0;;;;;;41,0;;;2,0;4,0;;;;1,0;;;1,0;1,0;;;5,0;17,0;;50,0;;;;;;;;;2,0;;;1,0;6,0;;;;;;;1,0;;;;;1,0;;;1,0;;;;;;4,0;;;;;;;;;;1,0;;2,0;;1,0;;;;;1,0;11,0;;;8,0;10,0;;;;;;;9,0;;;;;;13,0;;2,0;;;;;;;;10,0;2,0;1,0;;;;;;;;6,0;;1,0;;4,0;6,0;;;;;2,0;7,0;5,0;;;4,0;;;;;41,0;3,0;;10,0;5,0;5,0;27,0;3,0;1,0;;;32,0;48,0;3,0;;27,0;2,0;9,0;;6,0;1,0;1,0;;15,0;106,0;4,0;;6,0;1,0;6,0;;7,0;5,0;27,0;24,0;;;14,0;;4,0;27,0;3,0;;;;;;;;;;45,0;7,0;16,0;3,0;;10,0;4,0;9,0;2,0;;;;2,0;16,0;;;13,0;23,0;;;1,0;;;37,0;;;1,0;2,0;;;15,0;;;;;;;1,0;;4,0;1,0;;;;;6,0;66,0;2,0;10,0;;;;1,0;3,0;;;;1,0;;2,0;1,0;27,0;;11,0;;;6,0;;;;;15,0;33,0;;;;3,0;;2,0;2,0;;;1,0;;;1,0;;2,0;;;3,0;;2,0;2,0;;2,0;;;;;;;;;;;;;;;;4,0;1,0;1,0;2,0;;;;6,0;;;;;;;;;;;17,0;3,0;;;;;;4,0;;;5,0;;9,0;;7,0;;;;1,0;;;;;;;;10,0;3,0;;;2,0;;;;3,0;;1,0;2,0;;;21,0;;;1,0;;;;1,0;;2,0;2,0;;;42,0;4,0;;;;;;5,0;;;2,0;;;6,0;;;;;;1,0;;;;;;;1,0;;;2,0;;;;;;;;;;;;;;;1,0;2,0;2,0;;;;;;;;12,0;1,0;1,0;;;;;;1,0;6,0;;18,0;;;;;;6,0;;;;7,0;3,0;1,0;;5,0;;;;;;2,0;;3,0;;;;1,0;;;6,0;1,0;4,0;5,0;;;;;4,0;;;;;1,0;;55,0;;3,0;;6,0;;;33,0;13,0;;;;;;;;;;2,0;1,0;;;;;6,0;;;;;;;2,0;1,0;25,0;;;;;;;;;;;;;;;;;;;6,0;;1,0;;;;;;;;;;;;;;4,0;;3,0;;;;;;14,0;;;;;;1,0;;;;;10,0;;1,0;;;;;;;;;3,0;;;;;;;;;;;;;1,0;;;;;;;;;;1,0;;;;;1,0;;;;;;;;1,0;;;;;;;;;;;1,0;;2,0;;;5,0;;;;;43,0;;;;;;;;;2,0;3,0;1,0;;;6,0;;;;;;1,0;;;;;2,0;3,0;;;;;;;;1,0;;;;;;;;;;;;;;;1,0;;;;;;;;;;;;;;;;;;;;;;;;;;;;;;;;;;;;;;;;;;;;;;;;;;;;;;;;;;;;1,0;;;;;;;;;;;6,0;;;;;;;;
storage;;1,0;;12,0;24,0;91,0;12,0;24,0;3,0;2,0;;4,0;;62,0;;5,0;110,0;6,0;1,0;8,0;;;22,0;6,0;34,0;1,0;6,0;17,0;608,0;33,0;182,0;48,0;14,0;15,0;;439,0;9,0;4,0;25,0;;112,0;851,0;;63,0;113,0;30,0;;23,0;2,0;7,0;13,0;;2,0;24,0;13,0;;29,0;1,0;7,0;26,0;;;6,0;5,0;680,0;1,0;217,0;2,0;3,0;7,0;3,0;125,0;26,0;;12,0;1,0;;5,0;147,0;203,0;138,0;;26,0;18,0;77,0;2,0;;13,0;;1,0;20,0;;3,0;;35,0;;20,0;2,0;102,0;22,0;91,0;14,0;;27,0;67,0;205,0;9,0;342,0;2,0;2,0;;12,0;75,0;2,0;21,0;1,0;12,0;14,0;11,0;58,0;16,0;;77,0;5,0;;920,0;164,0;;3,0;;33,0;11,0;;258,0;;;38,0;6,0;22,0;;;3,0;;;4,0;9,0;29,0;29,0;15,0;5,0;2,0;5,0;50,0;6,0;12,0;22,0;;;;;;40,0;12,0;4,0;;;38,0;3,0;;21,0;6,0;;14,0;11,0;;14,0;;2,0;6,0;;7,0;3,0;3,0;20,0;;;6,0;;43,0;7,0;1,0;;4,0;7,0;12,0;1,0;37,0;4,0;7,0;1,0;;4,0;4,0;2,0;3,0;1374,0;9,0;;4,0;13,0;4,0;6,0;;;;1,0;20,0;2,0;;3,0;10,0;7,0;;4,0;1,0;;81,0;;;3,0;3,0;3,0;17,0;8,0;7,0;2,0;19,0;2,0;1,0;7,0;;6,0;2,0;;8,0;52,0;2,0;2,0;14,0;2,0;;;;16,0;;9,0;6,0;15,0;1,0;3,0;8,0;29,0;22,0;16,0;23,0;7,0;9,0;1,0;8,0;21,0;;1,0;;7,0;;;11,0;23,0;;4,0;1,0;;12,0;;2,0;;1,0;10,0;21,0;;1,0;9,0;;;1,0;1,0;6,0;1,0;;;;;;4,0;;;6,0;1,0;2,0;28,0;1,0;;21,0;;5,0;;12,0;4,0;;2,0;23,0;86,0;;3,0;3,0;;;;32,0;;1,0;1,0;1,0;3,0;50,0;1,0;;;1,0;1,0;3,0;10,0;2,0;;4,0;5,0;5,0;42,0;;;;;4,0;;14,0;;7,0;6,0;136,0;11,0;2,0;2,0;;2,0;1,0;6,0;11,0;2,0;;6,0;13,0;1,0;12,0;7,0;16,0;2,0;1,0;15,0;4,0;4,0;114,0;3,0;8,0;2,0;1,0;30,0;11,0;11,0;1,0;15,0;;127,0;1,0;18,0;1,0;22,0;1,0;11,0;4,0;3,0;4,0;15,0;3,0;4,0;;31,0;4,0;30,0;13,0;1,0;1,0;5,0;;13,0;61,0;10,0;;;1,0;2,0;;3,0;1,0;16,0;493,0;82,0;68,0;32,0;4,0;;1,0;2,0;33,0;2,0;11,0;;;11,0;11,0;4,0;31,0;12,0;34,0;;;1058,0;2,0;;33,0;4,0;5,0;3,0;8,0;1,0;;13,0;;24,0;10,0;5,0;23,0;;1,0;3,0;5,0;24,0;6,0;14,0;;;6,0;;403,0;29,0;13,0;1,0;;4,0;8,0;42,0;;1,0;7,0;4,0;15,0;;11,0;1,0;1,0;13,0;1,0;;3,0;1,0;10,0;;7,0;4,0;16,0;;;45,0;29,0;2,0;4,0;;1,0;8,0;;4,0;14,0;8,0;2,0;13,0;4,0;8,0;;8,0;190,0;;18,0;11,0;;;1,0;;6,0;;;1,0;;9,0;;;2,0;8,0;1,0;8,0;8,0;12,0;5,0;1,0;2,0;48,0;;22,0;2,0;;3,0;3,0;1,0;;12,0;4,0;12,0;1,0;8,0;4,0;;;;10,0;15,0;;4,0;30,0;6,0;6,0;43,0;5,0;1,0;;10,0;;;8,0;;4,0;;4,0;;;1,0;5,0;3,0;;;5,0;77,0;2,0;30,0;2,0;2,0;6,0;16,0;4,0;6,0;;11,0;4,0;6,0;30,0;;28,0;2,0;37,0;1,0;3,0;2,0;;5,0;1,0;1,0;;;1,0;2,0;8,0;4,0;2,0;1,0;2,0;;7,0;13,0;;3,0;7,0;1,0;;;;;63,0;1,0;;;;;3,0;3,0;1,0;1,0;2,0;1,0;6,0;7,0;;4,0;;;;11,0;;7,0;4,0;6,0;;5,0;5,0;;9,0;27,0;5,0;4,0;;1,0;3,0;;4,0;16,0;1,0;;;16,0;5,0;3,0;10,0;12,0;;3,0;1,0;5,0;5,0;8,0;11,0;2,0;;;;;;3,0;2,0;13,0;4,0;;;2,0;2,0;;;4,0;16,0;3,0;;;1,0;;1,0;1,0;;;2,0;;1,0;;9,0;22,0;1,0;11,0;;;6,0;8,0;1,0;;;1,0;3,0;;3,0;;;7,0;7,0;;;3,0;;4,0;;;;;2,0;1,0;3,0;3,0;1,0;;;;26,0;;;;4,0;2,0;5,0;;2,0;;;;;1,0;3,0;6,0;;65,0;1,0;1,0;1,0;;1,0;;1,0;;;;;1,0;3,0;17,0;1,0;2,0;1,0;1,0;;2,0;;;6,0;;2,0;27,0;;4,0;4,0;;1,0;6,0;1,0;16,0;6,0;3,0;;8,0;3,0;8,0;1,0;;;2,0;1,0;5,0;2,0;;;;3,0;1,0;4,0;;3,0;;18,0;5,0;;;24,0;2,0;;1,0;10,0;;1,0;;;;;;6,0;2,0;4,0;3,0;1,0;1,0;;1,0;3,0;;2,0;2,0;;5,0;;;1,0;;6,0;;;44,0;;;;;1,0;1,0;;6,0;4,0;3,0;;;2,0;7,0;4,0;;;12,0;4,0;;;1,0;;;;1,0;;;3,0;;;;3,0;;;20,0;;2,0;;7,0;;;;2,0;;;;;;;;;;;;;;;2,0;;;1,0;;;;6,0;;1,0;;;1,0;1,0;;;;;;;;;;;;;;4,0;;;;1,0;;;1,0;;;;;5,0;;;6,0;;;;;5,0;1,0;;1,0;5,0;;;;;;;;;;1,0;1,0;1,0;;3,0;2,0;2,0;;3,0;1,0;2,0;;;2,0;;1,0
straight;;2,0;;1,0;2,0;17,0;2,0;;;;;;90,0;8,0;;;;;;;1,0;;1,0;;;;;2,0;;;3,0;3,0;;6,0;;1,0;1,0;6,0;;;26,0;15,0;;;6,0;29,0;2,0;3,0;;1,0;3,0;;14,0;;2,0;;21,0;;;7,0;;;4,0;;39,0;;18,0;1,0;;1,0;6,0;27,0;7,0;;;2,0;;;;;9,0;;1,0;;4,0;40,0;;10,0;;;;;15,0;;;;;17,0;12,0;62,0;16,0;;;1,0;2,0;1,0;;;;1,0;;10,0;3,0;3,0;;;;6,0;;9,0;;;;;1,0;;21,0;;;;;;;6,0;;2,0;4,0;11,0;;;;;;;;;9,0;8,0;;2,0;;3,0;7,0;1,0;;;1,0;1,0;;;;28,0;;1,0;;;1,0;1,0;1,0;6,0;;1,0;;28,0;;7,0;;;1,0;;;;3,0;9,0;;;3,0;;1,0;3,0;;1,0;7,0;9,0;;4,0;2,0;;;1,0;;1,0;;;3,0;1,0;8,0;;;15,0;4,0;9,0;;;;10,0;;32,0;;14,0;7,0;;;;6,0;;43,0;;;1,0;;2,0;2,0;;1,0;1,0;1,0;;;6,0;;1,0;;;;4,0;;21,0;31,0;;34,0;;;;;;;23,0;;;4,0;;;34,0;;;;;;;;1,0;;1,0;;;2,0;13,0;;;;;19,0;2,0;6,0;;;7,0;1,0;3,0;6,0;;;10,0;;1,0;2,0;;;5,0;;;;;;22,0;2,0;5,0;;5,0;;;4,0;;3,0;;13,0;;3,0;;9,0;13,0;5,0;;;;;;;;2,0;1,0;;;1,0;2,0;;;;;4,0;4,0;;;;;24,0;;;;;;;;2,0;;;2,0;;1,0;4,0;;;1,0;;1,0;;;1,0;;;;9,0;8,0;3,0;;;2,0;1,0;;3,0;22,0;;;;1,0;1,0;4,0;;;;;3,0;1,0;1,0;;;12,0;;;;2,0;1,0;;1,0;1,0;;3,0;11,0;4,0;1,0;13,0;;;16,0;3,0;;;;;;;3,0;;;;;;;;;;;;;4,0;;6,0;;;;2,0;;8,0;3,0;;;27,0;1,0;;;;;;;;1,0;4,0;;2,0;;6,0;;;;;2,0;;;4,0;;2,0;;;7,0;;;1,0;;1,0;7,0;1,0;;2,0;;;3,0;;;;;;;1,0;;;1,0;;;;;;;;5,0;8,0;;;;;;;;;;;;;;;;;;4,0;;;;;;;;;;26,0;5,0;;;;2,0;1,0;;;;2,0;;;;;;;;;;;;;;;1,0;;;;;;;;;;;;;;;;4,0;1,0;;;;;;;;;;;;;;;;;;;;;;;;;;;;18,0;;;;;;1,0;;;;4,0;;;;;;;;;;;;;8,0;;;;;;;;2,0;;;;4,0;;5,0;;;7,0;;;;;;;;;;;;;;;;;;;;;;;;;;;1,0;;;;;;;;3,0;;;1,0;;;;;;;;;;;;;;4,0;;23,0;;;;;2,0;;12,0;1,0;;;;;;;3,0;;;2,0;;;;;;1,0;;;3,0;;16,0;;2,0;;;;;1,0;7,0;;;;;;1,0;;;;;;;;;;3,0;4,0;;;;1,0;6,0;;;;2,0;;;;6,0;;;;;2,0;;;5,0;;;;;;;;2,0;;;;;;;1,0;;;;;3,0;;;;;;;;;;;;;;;;2,0;1,0;;1,0;;;;4,0;;;1,0;;;;;;;;6,0;;;;;1,0;;;;;;;;;;1,0;;;;;;;;;5,0;1,0;;;1,0;;;;;;;;;;;;;;;;;3,0;;;;;;;1,0;;2,0;;;;;;;;2,0;;;;;;;;;;;;;2,0;;;4,0;;;;3,0;;;;;;;2,0;;;;;;;1,0;;;4,0;;;;;;;1,0;;;1,0;;;;3,0;1,0;;;;;;1,0;;;;1,0;;;;;;;;;;;;;;;;;13,0;;;;;12,0;;;2,0;;;;;;;;;;;;;;;;;;;;;;;;
strap;;4,0;;6,0;;17,0;;21,0;;;;2,0;;27,0;;;;;6,0;;;;;;3,0;;;9,0;;4,0;37,0;;;;;;4,0;;;1,0;;14,0;;;2,0;9,0;;3,0;;;;;16,0;;;;;;;;;;;;;;25,0;;;;2,0;8,0;;;;;4,0;;4,0;;12,0;;;;3,0;;;2,0;;;;;2,0;;;;;4,0;8,0;13,0;17,0;;;;;;;;;;;;;;;;;9,0;;;;8,0;;2,0;;;35,0;;;;;;;1,0;;;1,0;;;;3,0;;;;8,0;;;;4,0;30,0;1,0;;34,0;;;;;;;;1,0;50,0;;;;;64,0;;;;;;2,0;3,0;;;;;;;;;;6,0;32,0;;;1,0;;18,0;;12,0;;9,0;;12,0;12,0;;2,0;5,0;;1,0;1,0;2,0;;;24,0;;;75,0;;1,0;;1,0;1,0;;;2,0;;;;;2,0;;15,0;;128,0;;2,0;;3,0;;;;68,0;;;;5,0;;;7,0;1,0;1,0;;;12,0;4,0;9,0;15,0;2,0;;;12,0;;;24,0;31,0;;;;;;1,0;;;;;;;;;;8,0;12,0;;3,0;2,0;;;15,0;;;;;;;;;;;2,0;;;;16,0;;;;24,0;1,0;;6,0;;;2,0;1,0;;;1,0;;;8,0;;;2,0;6,0;;;28,0;5,0;3,0;9,0;7,0;14,0;;;5,0;2,0;;;11,0;2,0;1,0;2,0;;1,0;2,0;;;10,0;;2,0;1,0;;45,0;;;;4,0;;;;;;;1,0;11,0;;;;;;;;12,0;;;;;;;;6,0;;;;;;;;;;;;;;;;;;;;;;;;;;;;;;;;;;;;;;;;4,0;3,0;;;;;;;;;;;19,0;;;;;;;3,0;;;;;;;;;;;1,0;;;;;3,0;;;;;41,0;;;;;8,0;2,0;;;;;;;;;;;;;;;;;;;;;2,0;;1,0;1,0;;;;3,0;;;;;;;4,0;;;;;;;;1,0;;;;;;1,0;;;;4,0;;;;;10,0;;;4,0;58,0;;;;;1,0;;;;;;1,0;1,0;;;;;;;;;;6,0;;;;;;;;;;;;;;9,0;18,0;;;;;;;;;;;;;;;;3,0;;;;;1,0;;;;;11,0;;11,0;;;;;;;;;;;3,0;;2,0;;;;;;;;;;;;;;;;7,0;4,0;;;;;;;;;;;;;;20,0;;;;;;;;;;;;2,0;;;3,0;;;;5,0;;;;;;;;;;;;;;;;;;;;;1,0;;;;;;;;;;;;;;;;;;;;;6,0;;1,0;2,0;2,0;1,0;;;;;;;2,0;;13,0;10,0;;;;;;2,0;;2,0;;;1,0;;;;;;;;;22,0;;;;;;;;1,0;;1,0;2,0;;;;4,0;;5,0;5,0;;;;;;;;;;;;;;1,0;;2,0;;;;15,0;;;;;1,0;;;;;1,0;;;;;4,0;;;;;;;;;;;;;;;;;;;;;;;;;;;;;;;;;;;;;;;;;1,0;;;;;;;;;;;;;;;;;;;;;;;;;;;;;;;;;;;;;;;;;;;;;;;1,0;;;;;;;;;;;;;;;;1,0;;;;;;;;;;;;;;;;;;;;;;;1,0;;;;;;;;;;1,0;;;;;;;;;;;;;;;1,0;;2,0;;2,0;;;;;;;;;;;;;;;;;;;;;;;;;;;;;;;;;;;;;;;;;;;;;;;;;;;;;;;;;;;;;;;;
structure;;17,0;1,0;13,0;;83,0;33,0;296,0;;;;6,0;13,0;361,0;3,0;4,0;56,0;;19,0;15,0;25,0;2,0;23,0;8,0;2,0;;;62,0;8,0;2,0;380,0;11,0;5,0;4,0;68,0;124,0;47,0;89,0;16,0;90,0;63,0;265,0;28,0;7,0;49,0;75,0;;418,0;;4,0;32,0;2,0;113,0;27,0;10,0;1,0;216,0;74,0;5,0;47,0;18,0;3,0;49,0;3,0;336,0;1,0;555,0;4,0;6,0;9,0;14,0;360,0;321,0;21,0;;;54,0;2,0;;26,0;173,0;;10,0;46,0;230,0;32,0;;115,0;9,0;6,0;6,0;33,0;17,0;5,0;;;46,0;30,0;230,0;51,0;170,0;13,0;;15,0;15,0;12,0;;6,0;8,0;;1,0;16,0;22,0;1,0;29,0;11,0;3,0;27,0;52,0;107,0;5,0;4,0;26,0;7,0;;17,0;252,0;;66,0;3,0;24,0;3,0;3,0;96,0;6,0;;15,0;26,0;;2,0;4,0;26,0;;;23,0;32,0;33,0;214,0;38,0;257,0;31,0;3,0;141,0;42,0;;;7,0;3,0;11,0;29,0;65,0;114,0;10,0;;5,0;1,0;301,0;103,0;;9,0;13,0;2,0;19,0;59,0;35,0;49,0;;3,0;39,0;;11,0;11,0;34,0;91,0;780,0;28,0;35,0;17,0;58,0;65,0;9,0;1,0;17,0;134,0;33,0;136,0;250,0;6,0;38,0;10,0;14,0;177,0;12,0;5,0;27,0;5,0;168,0;29,0;21,0;541,0;15,0;57,0;1,0;6,0;7,0;40,0;1,0;27,0;34,0;13,0;152,0;14,0;;44,0;68,0;;385,0;3,0;22,0;17,0;14,0;18,0;41,0;;36,0;1,0;16,0;9,0;8,0;56,0;2,0;25,0;48,0;5,0;11,0;10,0;25,0;49,0;72,0;18,0;22,0;4,0;13,0;;65,0;9,0;638,0;285,0;13,0;2,0;16,0;11,0;3,0;93,0;36,0;8,0;;12,0;8,0;99,0;21,0;113,0;81,0;22,0;6,0;;15,0;36,0;4,0;19,0;71,0;;120,0;39,0;;9,0;88,0;11,0;60,0;8,0;44,0;9,0;11,0;13,0;18,0;6,0;63,0;1,0;13,0;69,0;205,0;10,0;36,0;;1,0;14,0;3,0;55,0;21,0;35,0;;;9,0;5,0;7,0;3,0;52,0;29,0;3,0;53,0;4,0;98,0;20,0;6,0;9,0;6,0;;3,0;7,0;13,0;9,0;2,0;22,0;15,0;3,0;4,0;21,0;6,0;8,0;4,0;57,0;42,0;2,0;235,0;3,0;96,0;14,0;42,0;2,0;17,0;4,0;12,0;;1,0;8,0;7,0;2,0;28,0;15,0;26,0;;;;4,0;;35,0;9,0;1,0;;1,0;12,0;16,0;19,0;10,0;11,0;;3,0;2,0;12,0;2,0;31,0;4,0;;31,0;2,0;26,0;1,0;2,0;;1,0;;1,0;11,0;19,0;4,0;4,0;2,0;11,0;11,0;1,0;2,0;8,0;17,0;4,0;33,0;42,0;7,0;5,0;82,0;13,0;15,0;72,0;;11,0;6,0;25,0;54,0;;;;;;13,0;3,0;;295,0;2,0;17,0;1,0;;12,0;1,0;;;4,0;;16,0;10,0;7,0;;;;5,0;9,0;1,0;8,0;;7,0;70,0;;;;2,0;7,0;22,0;4,0;1,0;9,0;15,0;4,0;5,0;5,0;;7,0;1,0;11,0;;;;;4,0;10,0;7,0;18,0;72,0;107,0;13,0;2,0;;11,0;19,0;9,0;13,0;13,0;9,0;18,0;16,0;18,0;2,0;13,0;1,0;7,0;3,0;52,0;17,0;12,0;11,0;1,0;1,0;10,0;2,0;;5,0;7,0;1,0;11,0;8,0;4,0;3,0;;;3,0;5,0;1,0;14,0;1,0;1,0;19,0;3,0;1,0;22,0;34,0;1,0;4,0;;1,0;29,0;;5,0;;5,0;1,0;1,0;51,0;9,0;;6,0;;9,0;21,0;6,0;;2,0;64,0;;10,0;;2,0;3,0;;1,0;;6,0;2,0;;5,0;;3,0;11,0;1,0;;1,0;9,0;9,0;;3,0;4,0;1,0;1,0;4,0;;3,0;;36,0;19,0;37,0;;6,0;3,0;6,0;;8,0;22,0;26,0;39,0;12,0;51,0;;14,0;46,0;1,0;;;;53,0;;1,0;3,0;28,0;5,0;8,0;;;41,0;;5,0;;9,0;;8,0;4,0;29,0;9,0;5,0;2,0;41,0;1,0;2,0;;39,0;;;;6,0;;;;;;;4,0;;37,0;4,0;11,0;;;13,0;18,0;;4,0;20,0;19,0;2,0;;1,0;;4,0;;3,0;;2,0;12,0;1,0;13,0;3,0;6,0;4,0;;2,0;11,0;;7,0;4,0;25,0;3,0;;;10,0;;14,0;;21,0;1,0;;12,0;;3,0;29,0;2,0;;14,0;;1,0;11,0;;3,0;1,0;7,0;3,0;;41,0;;5,0;2,0;69,0;2,0;4,0;6,0;34,0;2,0;52,0;1,0;30,0;25,0;6,0;25,0;6,0;;1,0;13,0;3,0;15,0;;8,0;5,0;;3,0;;;;2,0;10,0;1,0;;4,0;10,0;6,0;14,0;;6,0;;7,0;8,0;108,0;2,0;52,0;5,0;17,0;2,0;7,0;28,0;;69,0;2,0;;;8,0;;;7,0;;7,0;2,0;;1,0;;1,0;34,0;;13,0;6,0;;2,0;1,0;4,0;10,0;;5,0;7,0;11,0;7,0;23,0;;1,0;;5,0;3,0;19,0;22,0;;;2,0;8,0;17,0;;1,0;5,0;;2,0;;;1,0;;;1,0;6,0;;;7,0;1,0;6,0;38,0;19,0;10,0;;6,0;1,0;1,0;2,0;2,0;;4,0;;6,0;4,0;7,0;3,0;1,0;;1,0;19,0;1,0;;;;2,0;4,0;;2,0;;10,0;10,0;;1,0;5,0;7,0;6,0;;;7,0;;;4,0;3,0;;;;6,0;;1,0;;1,0;1,0;1,0;5,0;15,0;2,0;;8,0;;7,0;2,0;6,0;6,0;9,0;;6,0;2,0;4,0;2,0;2,0;;9,0;;;;;4,0;4,0;;1,0;2,0;;;1,0;;;;2,0;;20,0;;8,0;4,0;;2,0;;3,0;2,0;;;;;4,0;5,0;14,0;1,0;17,0;;;;4,0;;1,0;11,0;21,0;;;;;;4,0;;;2,0;3,0;1,0;4,0;;4,0;22,0;3,0;27,0;;;2,0;;;8,0;15,0;;;30,0;;4,0;4,0;13,0;1,0;4,0;2,0;2,0;8,0;4,0;;;1,0;5,0;;;90,0;;;2,0;2,0;;;3,0;5,0;;;;5,0;2,0;;;;4,0;;;5,0;;;;3,0;;;;;1,0;3,0;1,0;;1,0;;;;;;
subject;;8,0;8,0;44,0;32,0;75,0;35,0;1,0;2,0;8,0;;;8,0;182,0;;17,0;281,0;;4,0;29,0;;5,0;90,0;2,0;9,0;1,0;;12,0;41,0;28,0;142,0;31,0;4,0;16,0;4,0;218,0;23,0;5,0;51,0;1,0;211,0;241,0;;56,0;175,0;21,0;3,0;46,0;;11,0;21,0;;4,0;3,0;34,0;11,0;132,0;;;71,0;;;10,0;;1468,0;1,0;183,0;2,0;3,0;2,0;1,0;141,0;184,0;5,0;2,0;;1,0;6,0;2,0;8,0;131,0;1,0;13,0;4,0;45,0;4,0;;207,0;;7,0;24,0;;10,0;3,0;106,0;46,0;88,0;18,0;149,0;24,0;142,0;33,0;1,0;23,0;74,0;70,0;16,0;28,0;;6,0;6,0;65,0;88,0;1,0;;;7,0;17,0;19,0;98,0;3,0;;91,0;20,0;;18,0;188,0;;12,0;16,0;101,0;;6,0;135,0;5,0;;58,0;10,0;4,0;;;8,0;8,0;;9,0;14,0;85,0;10,0;78,0;4,0;;1,0;42,0;;;6,0;;8,0;;;;4,0;3,0;10,0;;1,0;3,0;7,0;2,0;58,0;21,0;5,0;36,0;105,0;;3,0;;15,0;;;2,0;;5,0;95,0;;5,0;13,0;3,0;56,0;20,0;;;3,0;9,0;1,0;6,0;3,0;18,0;;7,0;;3,0;5,0;;20,0;7,0;36,0;1,0;8,0;6,0;22,0;65,0;8,0;;;;63,0;10,0;;21,0;17,0;2,0;47,0;2,0;3,0;;71,0;1,0;1,0;7,0;;26,0;30,0;5,0;3,0;12,0;26,0;3,0;;43,0;;5,0;;;;118,0;6,0;45,0;21,0;;;;;10,0;2,0;;1,0;65,0;4,0;;5,0;25,0;5,0;88,0;1,0;;;8,0;1,0;107,0;1,0;;3,0;8,0;;;9,0;30,0;;;;10,0;22,0;;3,0;;;7,0;2,0;;1,0;8,0;;;;;154,0;3,0;;;;;;;;;;33,0;;149,0;;;12,0;;2,0;;35,0;9,0;8,0;3,0;31,0;122,0;2,0;14,0;;;40,0;;7,0;3,0;;;;3,0;14,0;2,0;;;;;24,0;15,0;4,0;;;;;4,0;;;;;6,0;1,0;136,0;;3,0;;75,0;2,0;32,0;1,0;;;1,0;5,0;8,0;;;6,0;;;48,0;19,0;54,0;17,0;22,0;41,0;31,0;4,0;55,0;17,0;;4,0;9,0;155,0;13,0;3,0;8,0;3,0;2,0;2,0;39,0;189,0;1,0;6,0;;70,0;16,0;;;50,0;3,0;17,0;;77,0;4,0;6,0;13,0;1,0;;90,0;4,0;3,0;26,0;84,0;2,0;;;5,0;;28,0;5,0;5,0;4,0;79,0;6,0;37,0;12,0;;16,0;2,0;33,0;5,0;28,0;;11,0;;2,0;2,0;22,0;6,0;23,0;15,0;;10,0;;9,0;47,0;23,0;;;3,0;;23,0;1,0;2,0;3,0;;;11,0;;1,0;3,0;3,0;4,0;;;;3,0;5,0;1,0;26,0;15,0;;;1,0;2,0;1,0;3,0;;;18,0;34,0;;;41,0;13,0;;2,0;7,0;4,0;20,0;18,0;;5,0;28,0;;1,0;;58,0;1,0;;2,0;;1,0;3,0;2,0;1,0;7,0;9,0;3,0;2,0;;1,0;;;30,0;;;;;;1,0;13,0;2,0;;;;;;9,0;;10,0;;;7,0;2,0;5,0;34,0;;3,0;64,0;3,0;4,0;20,0;;3,0;;10,0;;;66,0;1,0;3,0;10,0;1,0;;;;;20,0;1,0;5,0;5,0;;49,0;58,0;4,0;3,0;;;;;;;8,0;8,0;;;3,0;;6,0;;7,0;;;;1,0;15,0;9,0;12,0;;7,0;2,0;;;2,0;6,0;;5,0;;8,0;79,0;18,0;2,0;1,0;10,0;;3,0;1,0;12,0;;;;;52,0;12,0;6,0;6,0;9,0;;;157,0;;4,0;;;1,0;6,0;;1,0;;33,0;1,0;;;;;2,0;1,0;4,0;1,0;;11,0;32,0;2,0;;;;;5,0;2,0;18,0;2,0;4,0;10,0;1,0;;6,0;1,0;8,0;5,0;4,0;20,0;;43,0;;;;44,0;1,0;1,0;2,0;;31,0;;16,0;126,0;2,0;;;2,0;;;6,0;10,0;;;2,0;1,0;;13,0;;;8,0;11,0;4,0;;1,0;;;11,0;14,0;8,0;2,0;;1,0;32,0;;25,0;;6,0;1,0;;6,0;;;4,0;4,0;;;;;;;;;1,0;;;;;1,0;42,0;3,0;;;2,0;;55,0;;6,0;;;2,0;37,0;;;;;;3,0;;1,0;;;;2,0;;;;2,0;;;;;;4,0;;18,0;;4,0;;;4,0;;;1,0;1,0;;;2,0;;5,0;3,0;2,0;;;;;;22,0;;;;15,0;;;;;;;11,0;;2,0;;;30,0;3,0;3,0;4,0;;3,0;;28,0;2,0;15,0;35,0;14,0;;1,0;;4,0;;1,0;;6,0;2,0;;2,0;;2,0;;;2,0;;2,0;;;;;1,0;;1,0;7,0;;3,0;;;;2,0;;3,0;;;36,0;9,0;;;11,0;32,0;;;7,0;;5,0;95,0;;;;;;5,0;;;11,0;;;4,0;1,0;26,0;15,0;8,0;;4,0;2,0;5,0;2,0;;;;1,0;11,0;;;;1,0;;8,0;1,0;;;13,0;20,0;;;4,0;2,0;2,0;;21,0;;3,0;;3,0;;;;;;;4,0;;18,0;3,0;;6,0;2,0;;;;;;2,0;;;;;;;;8,0;;;;;;;;;;;;11,0;;4,0;11,0;4,0;4,0;;;2,0;;;;;;22,0;;;2,0;;;18,0;;;;2,0;;4,0;;;;;;2,0;4,0;;13,0;6,0;;;;4,0;;;;;
subset;;1,0;;18,0;4,0;30,0;23,0;2,0;;2,0;;82,0;;87,0;;2,0;38,0;;;2,0;1,0;;15,0;;;1,0;;80,0;11,0;3,0;62,0;;1,0;;;46,0;6,0;;21,0;;102,0;33,0;;14,0;105,0;;;28,0;;3,0;7,0;;1,0;;4,0;;19,0;;1,0;16,0;;;29,0;1,0;438,0;;98,0;2,0;1,0;2,0;2,0;69,0;93,0;;;1,0;;;;3,0;77,0;;8,0;15,0;30,0;;;9,0;5,0;3,0;15,0;;;;;;312,0;4,0;200,0;112,0;15,0;1,0;;25,0;14,0;21,0;3,0;11,0;;;;13,0;16,0;1,0;1,0;7,0;9,0;31,0;9,0;21,0;6,0;;4,0;14,0;;12,0;49,0;;;;33,0;4,0;;3,0;;;23,0;;3,0;;;17,0;;;;7,0;19,0;12,0;42,0;;;2,0;3,0;;4,0;;;;;;1,0;;9,0;4,0;;;14,0;8,0;3,0;1,0;;;;9,0;;4,0;;23,0;;9,0;;;;6,0;;;1,0;;122,0;;;;1,0;3,0;;;12,0;1,0;;;;;;;5,0;2,0;1,0;;;;;2,0;4,0;;;;7,0;;;1,0;14,0;;3,0;;7,0;;14,0;;;4,0;;3,0;28,0;2,0;10,0;1,0;1,0;;;12,0;;;;;;90,0;1,0;2,0;2,0;1,0;;;1,0;12,0;;3,0;;36,0;;;4,0;1,0;2,0;;;;;4,0;;2,0;;;;4,0;;;2,0;6,0;;;;5,0;10,0;1,0;2,0;;;1,0;1,0;;;9,0;;;5,0;;5,0;;;;;;;2,0;;;;;1,0;2,0;;;;;3,0;;13,0;;;;1,0;9,0;4,0;24,0;;1,0;;;3,0;1,0;;;;;23,0;4,0;;;;;;1,0;;;;;8,0;4,0;;;;;;;46,0;;;;101,0;7,0;;;;;5,0;2,0;2,0;4,0;;;;;1,0;11,0;7,0;;;;14,0;;26,0;5,0;;;1,0;1,0;;2,0;6,0;5,0;2,0;;2,0;1,0;;7,0;;72,0;3,0;;1,0;2,0;1,0;5,0;3,0;20,0;2,0;1,0;17,0;;;2,0;;5,0;7,0;12,0;;;;;1,0;2,0;1,0;5,0;2,0;21,0;;4,0;1,0;;1,0;;15,0;;;;5,0;31,0;2,0;2,0;;;10,0;2,0;3,0;6,0;;;19,0;;11,0;;55,0;;;;;7,0;9,0;;17,0;1,0;;1,0;;20,0;;;;;;;10,0;5,0;;;10,0;;2,0;;;;5,0;13,0;1,0;;16,0;1,0;;23,0;;4,0;2,0;13,0;2,0;;56,0;1,0;;;6,0;15,0;;;33,0;1,0;;;;6,0;;4,0;;;;2,0;;4,0;;;6,0;;;2,0;5,0;;1,0;;;;;1,0;;1,0;1,0;;7,0;;3,0;23,0;;;;;;;3,0;2,0;;;;;4,0;3,0;;14,0;;;;;;;;;;;10,0;;1,0;;;;;;2,0;;1,0;1,0;;;;;8,0;;2,0;2,0;;;9,0;3,0;;;14,0;;;;1,0;;2,0;;;;;108,0;9,0;;;;;;;;;3,0;;;;;1,0;;;2,0;19,0;5,0;;;;4,0;3,0;4,0;;;;3,0;;2,0;;;;;;2,0;;;4,0;4,0;;;;;;;;1,0;4,0;3,0;;;;;;;3,0;;;;;1,0;;10,0;43,0;;;;;;;;47,0;;;;;;;;3,0;;7,0;3,0;;;1,0;2,0;1,0;1,0;;1,0;;;;;1,0;;;;;;;;;;;;;11,0;;;;;;;;;;;;;3,0;;;;;2,0;1,0;;;;13,0;;8,0;;;;;;15,0;3,0;;;;;;;2,0;;17,0;;;;;;;;;;;3,0;;;2,0;;12,0;;;;;;;;;;;;;;;3,0;;;;;;;;;;;;;;;;;;17,0;;1,0;;7,0;;;;;1,0;14,0;;;;9,0;;1,0;2,0;;1,0;2,0;;5,0;;;;;1,0;;24,0;1,0;;;;;;;;22,0;;;;;;;;1,0;;;;;6,0;;1,0;13,0;;4,0;;;3,0;;;;;;;;2,0;;;;;;7,0;;;;;4,0;;5,0;;;;;4,0;;;;;;;;;;;2,0;4,0;;;;;;;6,0;;;79,0;;;;;;;3,0;;;;3,0;;8,0;3,0;6,0;;;1,0;;;;;;;;;;;;;;;;;;;;;;;;;;;;11,0;3,0;;;9,0;;;;4,0;;;;25,0;;;;4,0;;;6,0;;1,0;;2,0;;;2,0;2,0;;;8,0;4,0;;;;4,0;4,0;;;;;
supply;;12,0;;12,0;26,0;32,0;14,0;8,0;;;2,0;4,0;1,0;46,0;;;12,0;4,0;4,0;1,0;13,0;;;;34,0;;2,0;18,0;4,0;3,0;404,0;45,0;15,0;2,0;;45,0;;;3,0;;12,0;157,0;;13,0;24,0;19,0;;33,0;;;2,0;;2,0;32,0;2,0;2,0;10,0;;9,0;11,0;;;8,0;1,0;154,0;;71,0;8,0;;1,0;6,0;74,0;47,0;32,0;;5,0;2,0;1,0;;7,0;34,0;;39,0;;86,0;1,0;;50,0;1,0;;;;2,0;;;6,0;24,0;;59,0;;24,0;10,0;;3,0;16,0;45,0;;1,0;;;;60,0;70,0;;;;4,0;19,0;3,0;98,0;1,0;;337,0;1,0;;1,0;74,0;;17,0;;28,0;3,0;;355,0;4,0;;5,0;;;1,0;2,0;4,0;6,0;;6,0;12,0;1,0;58,0;4,0;3,0;17,0;15,0;39,0;;5,0;20,0;3,0;;;;18,0;141,0;;;50,0;;21,0;4,0;10,0;35,0;3,0;4,0;13,0;35,0;;;132,0;1,0;9,0;;13,0;;;;1,0;2,0;20,0;6,0;6,0;4,0;;;20,0;30,0;4,0;;16,0;1,0;1,0;;2,0;5,0;4,0;8,0;15,0;4,0;30,0;;23,0;31,0;20,0;;8,0;;;4,0;66,0;2,0;;17,0;7,0;15,0;;2,0;;10,0;30,0;;7,0;9,0;;;4,0;;;;;;;;;;1,0;;5,0;2,0;7,0;;13,0;;;;;9,0;20,0;;9,0;29,0;;;28,0;7,0;6,0;21,0;;8,0;1,0;3,0;;10,0;;38,0;11,0;2,0;3,0;1,0;1,0;2,0;1,0;1,0;;8,0;17,0;26,0;;;;18,0;187,0;;142,0;1,0;;;;5,0;10,0;64,0;13,0;;;;8,0;17,0;;;1,0;4,0;;16,0;;1,0;5,0;4,0;2,0;;4,0;1,0;6,0;12,0;4,0;17,0;1,0;2,0;20,0;;3,0;;1415,0;3,0;;;;4,0;;;;;;2,0;7,0;;;;1,0;;;7,0;;7,0;;;;;20,0;13,0;11,0;3,0;26,0;16,0;;2,0;;;2,0;1,0;1,0;2,0;;;;;;;8,0;;3,0;;2,0;;271,0;;;;2,0;21,0;8,0;;;2,0;;1,0;;1,0;13,0;7,0;5,0;;3,0;6,0;;33,0;4,0;28,0;;1,0;1,0;1,0;9,0;20,0;;6,0;;22,0;18,0;1,0;;;1,0;;;3,0;4,0;3,0;;54,0;5,0;11,0;11,0;8,0;18,0;;5,0;;;;9,0;;67,0;1,0;10,0;111,0;4,0;1,0;1,0;1,0;1,0;6,0;5,0;1,0;;461,0;10,0;1,0;;38,0;;4,0;1,0;;4,0;2,0;4,0;;13,0;;;;;;;;3,0;11,0;3,0;;;3,0;4,0;4,0;2,0;;4,0;1,0;21,0;1,0;18,0;;1,0;;9,0;;;;4,0;;2,0;1,0;;;;;;1,0;;1,0;12,0;;;2,0;3,0;;1,0;;2,0;7,0;21,0;2,0;2,0;14,0;19,0;18,0;;;;;5,0;6,0;31,0;;2,0;;;3,0;2,0;1,0;1,0;;18,0;;;1,0;1,0;12,0;;;;;2,0;;;1,0;;2,0;7,0;4,0;;9,0;;;1,0;27,0;7,0;1,0;;;1,0;8,0;;1,0;2,0;3,0;;1,0;2,0;;3,0;3,0;;;;;3,0;6,0;1,0;1,0;;;5,0;1,0;7,0;1,0;;;;;3,0;;;3,0;;;;;4,0;;;;;10,0;16,0;6,0;;40,0;1,0;;1,0;;;;;;;;;;;;;;;;2,0;8,0;;;;4,0;2,0;1,0;;;;;91,0;;;;;1,0;39,0;;1,0;;1,0;;;2,0;7,0;;;;;1,0;6,0;;;;1,0;5,0;168,0;6,0;1,0;;;3,0;3,0;1,0;1,0;;7,0;3,0;1,0;8,0;4,0;;;;4,0;;1,0;;37,0;2,0;3,0;52,0;5,0;;;3,0;1,0;;;32,0;86,0;;;2,0;;;7,0;;;;;4,0;1,0;7,0;18,0;;1,0;;;;17,0;;;1,0;4,0;;;;;;25,0;;3,0;2,0;2,0;;6,0;;;;;2,0;;;3,0;2,0;3,0;1,0;1,0;;;;;;;2,0;;;;1,0;;;1,0;;;;;1,0;;;;;1,0;;;2,0;;1,0;;2,0;21,0;;;3,0;;2,0;5,0;6,0;1,0;20,0;2,0;;1,0;37,0;;6,0;4,0;8,0;13,0;2,0;6,0;;;1,0;;;50,0;;;;26,0;;56,0;2,0;1,0;;;;;;7,0;3,0;;;8,0;3,0;;54,0;1,0;;;;;12,0;;;;;;;;;;;1,0;;;4,0;153,0;;;3,0;;;1,0;9,0;;1,0;;;;4,0;;;;;;;;;;;;3,0;;;;2,0;1,0;1,0;;;;;1,0;;;;;;;;;;;3,0;2,0;;;;1,0;;;;;3,0;;;;;1,0;4,0;1,0;;;;2,0;;1,0;;;;;;108,0;;;;;1,0;;1,0;;2,0;1,0;9,0;14,0;1,0;;;;;13,0;;;;;;;;;;;;1,0;;;12,0;;;;;;;;1,0;;;;;;;;;;;1,0;;;;;;;;;;;;;;;5,0;;;;
support;;46,0;;25,0;1,0;139,0;8,0;569,0;4,0;;3,0;7,0;56,0;627,0;1,0;;78,0;;27,0;1,0;67,0;;;;26,0;1,0;1,0;102,0;5,0;6,0;493,0;11,0;5,0;14,0;1,0;33,0;114,0;24,0;4,0;5,0;15,0;419,0;23,0;20,0;36,0;268,0;1,0;442,0;;1,0;;;250,0;2,0;33,0;15,0;172,0;6,0;;13,0;10,0;;4,0;;282,0;1,0;482,0;3,0;;56,0;24,0;712,0;66,0;1,0;;;49,0;7,0;;32,0;99,0;;16,0;7,0;303,0;197,0;;230,0;;6,0;;19,0;16,0;12,0;1,0;;17,0;85,0;212,0;61,0;304,0;24,0;3,0;5,0;8,0;14,0;2,0;1,0;4,0;;;2,0;94,0;7,0;8,0;;6,0;44,0;9,0;264,0;3,0;10,0;8,0;7,0;;5,0;275,0;;13,0;8,0;4,0;2,0;35,0;318,0;5,0;;46,0;25,0;40,0;26,0;10,0;33,0;5,0;1,0;51,0;5,0;31,0;118,0;18,0;210,0;69,0;56,0;467,0;129,0;3,0;4,0;21,0;;;;49,0;346,0;;8,0;2,0;;331,0;140,0;;18,0;10,0;;14,0;161,0;12,0;48,0;12,0;8,0;18,0;1,0;1,0;;10,0;72,0;23,0;7,0;54,0;27,0;312,0;61,0;;11,0;12,0;101,0;180,0;149,0;441,0;;111,0;35,0;4,0;115,0;5,0;8,0;;8,0;1732,0;64,0;201,0;553,0;56,0;108,0;13,0;;6,0;118,0;8,0;41,0;5,0;33,0;13,0;1,0;1,0;;325,0;1,0;811,0;15,0;15,0;;32,0;;41,0;2,0;34,0;4,0;;;22,0;1,0;;58,0;90,0;71,0;22,0;8,0;17,0;89,0;309,0;24,0;13,0;30,0;6,0;638,0;196,0;9,0;;642,0;13,0;1,0;7,0;6,0;5,0;47,0;45,0;3,0;4,0;;47,0;18,0;3,0;132,0;88,0;60,0;17,0;1,0;31,0;22,0;16,0;54,0;113,0;16,0;199,0;159,0;;46,0;63,0;39,0;135,0;24,0;86,0;24,0;12,0;33,0;;55,0;42,0;12,0;184,0;68,0;48,0;7,0;34,0;;9,0;57,0;40,0;64,0;17,0;94,0;24,0;11,0;44,0;;25,0;14,0;68,0;32,0;45,0;64,0;20,0;36,0;64,0;15,0;33,0;12,0;1,0;16,0;23,0;35,0;94,0;27,0;129,0;46,0;22,0;5,0;9,0;5,0;;5,0;91,0;72,0;42,0;20,0;16,0;64,0;15,0;86,0;2,0;96,0;7,0;24,0;;12,0;38,0;163,0;6,0;129,0;91,0;20,0;2,0;;1,0;14,0;;28,0;1,0;;12,0;2,0;46,0;25,0;5,0;104,0;6,0;;;6,0;2,0;;36,0;3,0;;14,0;6,0;11,0;2,0;4,0;11,0;;;;;16,0;5,0;10,0;6,0;;2,0;1,0;;12,0;21,0;5,0;17,0;20,0;7,0;28,0;7,0;45,0;30,0;212,0;;20,0;22,0;22,0;51,0;30,0;;;;15,0;2,0;;1,0;179,0;2,0;11,0;;37,0;16,0;2,0;6,0;1,0;4,0;7,0;6,0;1,0;6,0;3,0;;34,0;;26,0;;1,0;6,0;2,0;48,0;;;4,0;3,0;25,0;53,0;11,0;;3,0;8,0;14,0;10,0;1,0;;5,0;;;;1,0;1,0;;;;;37,0;14,0;48,0;;28,0;2,0;17,0;95,0;;13,0;25,0;5,0;3,0;4,0;4,0;16,0;;;;8,0;23,0;10,0;2,0;5,0;5,0;;26,0;;;44,0;4,0;22,0;111,0;2,0;2,0;;1,0;6,0;;9,0;;1,0;14,0;5,0;28,0;2,0;2,0;48,0;52,0;1,0;49,0;;2,0;30,0;12,0;9,0;;16,0;;34,0;53,0;17,0;;5,0;;6,0;1,0;1,0;;12,0;43,0;;;;2,0;4,0;;4,0;28,0;2,0;;4,0;;;;47,0;;4,0;;8,0;19,0;;;1,0;4,0;;5,0;;10,0;;19,0;21,0;15,0;;4,0;6,0;15,0;23,0;;2,0;45,0;10,0;25,0;79,0;1,0;2,0;5,0;21,0;2,0;;1,0;1,0;;4,0;2,0;5,0;12,0;;;;14,0;;;1,0;3,0;;;;19,0;;12,0;4,0;33,0;4,0;;;36,0;;;4,0;3,0;;;1,0;;;2,0;1,0;;3,0;20,0;6,0;;;18,0;20,0;;3,0;5,0;30,0;30,0;;5,0;;5,0;4,0;3,0;;2,0;2,0;;7,0;1,0;;5,0;;1,0;3,0;;1,0;;52,0;5,0;1,0;2,0;6,0;2,0;28,0;2,0;55,0;1,0;1,0;;1,0;9,0;3,0;;;4,0;1,0;4,0;;3,0;;4,0;74,0;7,0;;104,0;;;;99,0;3,0;16,0;12,0;7,0;2,0;27,0;9,0;67,0;93,0;22,0;12,0;16,0;1,0;;1,0;19,0;3,0;1,0;14,0;23,0;;18,0;5,0;12,0;1,0;19,0;2,0;;;6,0;86,0;10,0;7,0;;15,0;1,0;12,0;13,0;133,0;;50,0;55,0;1,0;8,0;2,0;28,0;;33,0;31,0;3,0;18,0;7,0;1,0;9,0;20,0;106,0;43,0;4,0;4,0;9,0;14,0;;11,0;;17,0;9,0;66,0;15,0;11,0;5,0;5,0;;18,0;14,0;3,0;30,0;10,0;18,0;4,0;9,0;10,0;5,0;7,0;1,0;3,0;;5,0;4,0;15,0;;12,0;17,0;;;;;3,0;;;3,0;;2,0;2,0;;1,0;;32,0;;3,0;;;;3,0;1,0;;6,0;;;2,0;;14,0;;;;;2,0;;;10,0;2,0;13,0;2,0;;2,0;;;;;;;;;;12,0;17,0;58,0;;;;;;;1,0;;;;;;;;3,0;1,0;;9,0;;5,0;2,0;;;;;11,0;;2,0;1,0;;;2,0;;;2,0;;;3,0;30,0;1,0;;1,0;;2,0;2,0;;;1,0;;11,0;;;;;;1,0;6,0;4,0;5,0;13,0;1,0;;;7,0;11,0;;12,0;;;;;2,0;6,0;2,0;8,0;;;19,0;16,0;9,0;17,0;;;;7,0;;1,0;;;;5,0;30,0;;5,0;;5,0;;;104,0;1,0;;12,0;;;4,0;7,0;41,0;;3,0;7,0;1,0;3,0;;;;;;;11,0;;;23,0;2,0;;;2,0;;;;;4,0;;;;;;;;;;;;3,0;;;;;;;;;;;10,0;;;;
surface;;75,0;;31,0;7,0;295,0;115,0;464,0;;;39,0;13,0;202,0;1365,0;9,0;1,0;177,0;1,0;57,0;24,0;56,0;3,0;67,0;10,0;21,0;3,0;7,0;340,0;31,0;47,0;783,0;42,0;18,0;25,0;8,0;69,0;364,0;75,0;152,0;6,0;175,0;904,0;117,0;63,0;229,0;1004,0;8,0;788,0;17,0;9,0;34,0;40,0;734,0;228,0;81,0;72,0;1234,0;7,0;18,0;68,0;110,0;;155,0;1,0;1690,0;7,0;1250,0;27,0;37,0;420,0;104,0;3903,0;1129,0;50,0;7,0;5,0;247,0;13,0;;8,0;406,0;10,0;5,0;130,0;739,0;97,0;1,0;653,0;35,0;16,0;6,0;105,0;116,0;162,0;22,0;;95,0;271,0;742,0;364,0;939,0;119,0;137,0;13,0;42,0;89,0;46,0;9,0;50,0;14,0;5,0;132,0;395,0;39,0;16,0;2,0;2,0;140,0;78,0;667,0;15,0;6,0;57,0;30,0;6,0;24,0;472,0;26,0;5,0;73,0;39,0;35,0;15,0;709,0;1,0;4,0;202,0;72,0;52,0;4,0;98,0;219,0;8,0;2,0;166,0;74,0;378,0;405,0;80,0;375,0;32,0;54,0;617,0;1015,0;1,0;33,0;136,0;102,0;1,0;25,0;190,0;364,0;27,0;11,0;22,0;6,0;597,0;571,0;5,0;42,0;53,0;4,0;68,0;449,0;27,0;437,0;33,0;132,0;28,0;1,0;6,0;66,0;123,0;934,0;55,0;148,0;133,0;60,0;176,0;931,0;5,0;22,0;83,0;105,0;312,0;283,0;1253,0;180,0;1122,0;48,0;65,0;409,0;37,0;11,0;73,0;13,0;1186,0;107,0;247,0;1561,0;118,0;75,0;21,0;21,0;17,0;1432,0;110,0;266,0;75,0;41,0;192,0;9,0;3,0;78,0;313,0;30,0;1912,0;14,0;33,0;14,0;332,0;39,0;36,0;8,0;418,0;3,0;178,0;96,0;34,0;55,0;7,0;162,0;47,0;20,0;98,0;87,0;39,0;417,0;2626,0;41,0;82,0;75,0;32,0;285,0;880,0;29,0;642,0;;101,0;1,0;26,0;80,0;19,0;223,0;307,0;46,0;9,0;19,0;11,0;225,0;127,0;111,0;120,0;91,0;33,0;3,0;56,0;455,0;106,0;56,0;118,0;17,0;304,0;420,0;;;92,0;116,0;440,0;46,0;263,0;37,0;32,0;183,0;8,0;115,0;367,0;29,0;78,0;176,0;35,0;88,0;88,0;30,0;13,0;224,0;23,0;47,0;122,0;425,0;140,0;2,0;181,0;26,0;103,0;9,0;317,0;28,0;8,0;55,0;120,0;832,0;742,0;26,0;100,0;69,0;17,0;18,0;190,0;102,0;274,0;46,0;52,0;400,0;3,0;48,0;30,0;4,0;7,0;5,0;74,0;62,0;22,0;77,0;86,0;195,0;97,0;203,0;13,0;52,0;2,0;31,0;6,0;33,0;51,0;87,0;19,0;1376,0;33,0;15,0;10,0;;4,0;8,0;2,0;28,0;9,0;18,0;2,0;1,0;74,0;1,0;17,0;126,0;30,0;13,0;30,0;2,0;17,0;1,0;100,0;75,0;;36,0;24,0;98,0;3,0;42,0;;9,0;9,0;4,0;6,0;62,0;31,0;27,0;4,0;56,0;25,0;3,0;1,0;75,0;27,0;45,0;16,0;122,0;9,0;35,0;48,0;40,0;31,0;112,0;1,0;14,0;21,0;50,0;25,0;6,0;;2,0;3,0;8,0;9,0;;7,0;400,0;13,0;28,0;4,0;;112,0;;10,0;;4,0;1,0;15,0;65,0;19,0;;5,0;140,0;34,0;28,0;4,0;17,0;;37,0;70,0;1,0;4,0;14,0;3,0;13,0;55,0;29,0;3,0;51,0;8,0;11,0;53,0;4,0;;25,0;33,0;6,0;8,0;1,0;;1,0;3,0;8,0;11,0;67,0;328,0;90,0;46,0;2,0;4,0;22,0;458,0;16,0;43,0;25,0;17,0;93,0;20,0;99,0;45,0;17,0;9,0;10,0;45,0;146,0;;556,0;57,0;8,0;;1,0;7,0;6,0;12,0;52,0;79,0;68,0;11,0;1,0;4,0;5,0;6,0;10,0;27,0;5,0;15,0;21,0;24,0;110,0;10,0;13,0;56,0;132,0;13,0;42,0;;1,0;29,0;6,0;15,0;;23,0;19,0;39,0;190,0;69,0;1,0;25,0;;33,0;27,0;;3,0;82,0;299,0;1,0;15,0;;20,0;33,0;25,0;14,0;35,0;2,0;5,0;1,0;2,0;;3,0;10,0;;2,0;6,0;29,0;20,0;9,0;;6,0;8,0;8,0;4,0;;16,0;;171,0;79,0;31,0;12,0;10,0;92,0;24,0;;6,0;28,0;69,0;19,0;168,0;280,0;;;23,0;4,0;1,0;1,0;4,0;27,0;9,0;1,0;37,0;38,0;1,0;1,0;;;121,0;7,0;;22,0;9,0;;10,0;1,0;4,0;22,0;97,0;7,0;16,0;6,0;6,0;6,0;95,0;;;8,0;22,0;;;42,0;;;;29,0;1,0;13,0;11,0;16,0;;3,0;17,0;167,0;4,0;5,0;12,0;40,0;50,0;16,0;113,0;;54,0;;49,0;;1,0;5,0;5,0;23,0;18,0;29,0;2,0;2,0;8,0;12,0;6,0;3,0;5,0;15,0;32,0;1,0;;29,0;;47,0;3,0;39,0;1,0;2,0;36,0;;2,0;68,0;4,0;1,0;5,0;;5,0;2,0;8,0;4,0;37,0;55,0;;7,0;111,0;;5,0;11,0;1067,0;12,0;342,0;2,0;24,0;17,0;13,0;22,0;33,0;123,0;31,0;67,0;306,0;2,0;;3,0;33,0;317,0;3,0;10,0;55,0;;42,0;12,0;14,0;;11,0;74,0;;;38,0;12,0;16,0;39,0;4,0;4,0;12,0;20,0;20,0;236,0;1,0;38,0;40,0;5,0;49,0;24,0;30,0;23,0;108,0;7,0;17,0;;31,0;30,0;2,0;40,0;166,0;43,0;14,0;8,0;665,0;18,0;32,0;38,0;16,0;39,0;98,0;4,0;28,0;17,0;11,0;24,0;8,0;12,0;16,0;2,0;45,0;287,0;6,0;1,0;2,0;29,0;40,0;114,0;44,0;2,0;;18,0;8,0;179,0;5,0;16,0;95,0;1,0;11,0;3,0;;13,0;2,0;;17,0;44,0;;1,0;6,0;15,0;5,0;96,0;6,0;37,0;1,0;15,0;;23,0;2,0;;1,0;7,0;7,0;2,0;;217,0;6,0;7,0;;31,0;16,0;2,0;7,0;3,0;1,0;7,0;18,0;6,0;24,0;1,0;7,0;2,0;34,0;1,0;16,0;2,0;16,0;8,0;15,0;60,0;30,0;5,0;;;17,0;;27,0;5,0;50,0;22,0;7,0;20,0;6,0;1,0;4,0;74,0;10,0;;11,0;;39,0;3,0;12,0;;1,0;2,0;8,0;50,0;1,0;3,0;106,0;46,0;16,0;9,0;3,0;6,0;1,0;;25,0;11,0;1,0;;3,0;384,0;6,0;1,0;1,0;3,0;282,0;;16,0;5,0;;2,0;;4,0;1,0;5,0;;;10,0;1,0;;15,0;4,0;95,0;1,0;30,0;55,0;2,0;1,0;8,0;;5,0;2,0;13,0;31,0;;30,0;1,0;4,0;6,0;;2,0;;15,0;2,0;5,0;243,0;;32,0;1,0;461,0;1,0;11,0;4,0;13,0;1,0;2,0;23,0;6,0;;2,0;5,0;25,0;6,0;191,0;8,0;;1,0;41,0;;635,0;1,0;4,0;;5,0;;4,0;110,0;;6,0;30,0;1,0;5,0;13,0;28,0;3,0;;;;85,0;10,0;;10,0;4,0;;6,0;43,0;7,0;;19,0;;18,0;;14,0;;5,0;27,0;6,0;2,0;;;;;3,0;;12,0;
surround;;3,0;;3,0;;26,0;14,0;32,0;;;1,0;;6,0;27,0;2,0;11,0;48,0;1,0;3,0;;6,0;;21,0;3,0;1,0;;;38,0;;;48,0;;2,0;;1,0;4,0;14,0;8,0;9,0;2,0;26,0;53,0;1,0;8,0;31,0;23,0;;26,0;;;;;15,0;7,0;16,0;2,0;43,0;;1,0;9,0;2,0;27,0;5,0;;156,0;;54,0;;;4,0;2,0;139,0;39,0;3,0;;;14,0;;;2,0;43,0;;23,0;4,0;36,0;6,0;;26,0;;;;31,0;2,0;12,0;2,0;2,0;82,0;;77,0;33,0;24,0;6,0;6,0;;4,0;12,0;;;3,0;2,0;;16,0;121,0;5,0;;;14,0;6,0;8,0;58,0;;4,0;2,0;4,0;;1,0;79,0;;2,0;;3,0;;;41,0;;;72,0;9,0;;7,0;;8,0;1,0;;35,0;;97,0;40,0;;9,0;;4,0;28,0;5,0;;;5,0;1,0;;;5,0;10,0;4,0;;3,0;;10,0;27,0;;3,0;3,0;2,0;;12,0;4,0;4,0;2,0;2,0;;;;5,0;1,0;29,0;4,0;;20,0;;22,0;13,0;;;13,0;8,0;10,0;17,0;70,0;1,0;18,0;2,0;5,0;21,0;2,0;;2,0;;63,0;1,0;1,0;30,0;7,0;16,0;;11,0;;57,0;4,0;1,0;1,0;5,0;18,0;;;11,0;9,0;2,0;147,0;2,0;;5,0;3,0;3,0;1,0;;3,0;;1,0;5,0;2,0;1,0;;35,0;4,0;3,0;14,0;7,0;;23,0;51,0;1,0;8,0;12,0;;13,0;13,0;;13,0;101,0;;;5,0;3,0;7,0;67,0;26,0;5,0;6,0;;;29,0;;7,0;4,0;2,0;;;1,0;6,0;2,0;;2,0;;10,0;18,0;;;2,0;14,0;18,0;10,0;33,0;;;6,0;;3,0;8,0;1,0;5,0;6,0;2,0;6,0;9,0;1,0;1,0;4,0;4,0;3,0;3,0;20,0;;;6,0;4,0;1,0;;17,0;;2,0;1,0;18,0;58,0;;;6,0;11,0;;;6,0;2,0;6,0;;;26,0;16,0;3,0;;3,0;6,0;;3,0;1,0;1,0;17,0;2,0;11,0;3,0;16,0;;6,0;;;;;3,0;8,0;;;18,0;1,0;31,0;;;5,0;;2,0;1,0;;;1,0;;;5,0;11,0;4,0;1,0;4,0;;;;4,0;4,0;;;;2,0;;1,0;;2,0;;;;4,0;;10,0;;4,0;2,0;;;2,0;3,0;;;9,0;;10,0;2,0;4,0;;22,0;;;;;;;;2,0;;;;2,0;;23,0;;;6,0;;17,0;;2,0;7,0;;;1,0;4,0;3,0;;3,0;4,0;1,0;;1,0;7,0;;;21,0;;;;;;;;;2,0;;;7,0;;;2,0;;2,0;;;;;;;1,0;11,0;2,0;;;;1,0;;13,0;;;8,0;;9,0;3,0;1,0;3,0;1,0;;;;3,0;3,0;3,0;11,0;;;;;1,0;2,0;1,0;;2,0;9,0;;;4,0;;;;6,0;;;3,0;5,0;1,0;9,0;3,0;2,0;;5,0;;;6,0;4,0;;;2,0;;6,0;11,0;;;;;1,0;1,0;;;12,0;26,0;;9,0;;;;;;;;;;1,0;;;2,0;;;;2,0;;;;;;;;;;;2,0;7,0;8,0;;;5,0;6,0;;2,0;4,0;7,0;;4,0;7,0;;;1,0;;;;;;;;1,0;40,0;;;;;1,0;;10,0;;;;2,0;;;1,0;6,0;;;;3,0;;18,0;;;5,0;6,0;;;;;;1,0;6,0;;;2,0;3,0;;2,0;;2,0;1,0;11,0;1,0;1,0;;;;;4,0;;3,0;;;;;7,0;;;;17,0;;;;;;1,0;;;;24,0;;9,0;;4,0;;;;;1,0;5,0;;;;;;;;;1,0;;3,0;;6,0;;;;13,0;;8,0;;1,0;;;;1,0;12,0;1,0;;5,0;1,0;;;1,0;;1,0;;14,0;;2,0;;3,0;;;1,0;;;;;1,0;1,0;;;;5,0;;6,0;;;8,0;;4,0;;1,0;;4,0;;2,0;1,0;1,0;;;8,0;6,0;7,0;;;1,0;3,0;;4,0;;;;1,0;;;;;;;;;;3,0;;;1,0;;2,0;15,0;2,0;1,0;;2,0;2,0;30,0;;;;;;;3,0;;3,0;;6,0;11,0;;1,0;6,0;;;2,0;;7,0;;2,0;;2,0;;;;;;;;12,0;;;;7,0;;;;;5,0;;3,0;;;;5,0;;;;;;4,0;;;4,0;;4,0;11,0;;;;5,0;;;7,0;;;;;;;;;;;1,0;2,0;2,0;;;;;;;;;;5,0;;;;;;;;;;;;;;;;;1,0;;;;;1,0;;;;;;;;;;;6,0;;;;;;;1,0;;;;1,0;3,0;;;;1,0;;;;1,0;;;;;;;14,0;;;1,0;;;;5,0;;;;;24,0;1,0;2,0;;;;2,0;6,0;2,0;;;;;;;;;;;;;;;;;;;18,0;2,0;;;;;;;3,0;;;;;;;;;;;;;11,0;;;1,0;;;
switch;;10,0;;11,0;12,0;51,0;2,0;51,0;;35,0;1,0;;5,0;75,0;;3,0;87,0;7,0;14,0;;;;7,0;;81,0;;;13,0;1,0;7,0;354,0;54,0;1,0;10,0;4,0;47,0;4,0;4,0;4,0;;45,0;448,0;;22,0;181,0;43,0;;73,0;;6,0;;;3,0;21,0;10,0;5,0;8,0;2,0;9,0;12,0;2,0;;41,0;2,0;221,0;;194,0;;4,0;;;84,0;93,0;4,0;;2,0;;;4,0;17,0;103,0;;298,0;2,0;53,0;3,0;;21,0;9,0;5,0;10,0;2,0;4,0;1,0;14,0;;30,0;8,0;135,0;15,0;59,0;36,0;;8,0;31,0;63,0;1,0;5,0;;;;20,0;16,0;3,0;;;4,0;6,0;4,0;135,0;7,0;;370,0;;4,0;17,0;121,0;;1,0;;61,0;;;259,0;;;77,0;;18,0;;;;;;20,0;23,0;10,0;22,0;31,0;6,0;6,0;;43,0;;1,0;38,0;4,0;;;;28,0;119,0;3,0;3,0;35,0;;109,0;20,0;;45,0;2,0;;30,0;20,0;;3,0;32,0;3,0;14,0;;6,0;;3,0;15,0;;;107,0;17,0;21,0;8,0;;1,0;;35,0;3,0;3,0;26,0;;8,0;;4,0;6,0;;21,0;5,0;5,0;58,0;2,0;35,0;39,0;1,0;33,0;1,0;;;3,0;97,0;10,0;;45,0;18,0;26,0;;4,0;9,0;;37,0;25,0;5,0;2,0;;;5,0;;6,0;;1,0;;5,0;2,0;;12,0;;1,0;;86,0;5,0;4,0;16,0;45,0;;;4,0;7,0;6,0;67,0;6,0;19,0;3,0;;11,0;30,0;2,0;40,0;4,0;;;;;2,0;;3,0;24,0;2,0;3,0;1,0;7,0;8,0;;8,0;1,0;3,0;3,0;11,0;5,0;3,0;4,0;16,0;208,0;;4,0;5,0;4,0;;;2,0;4,0;14,0;12,0;20,0;1,0;;;2,0;;6,0;3,0;10,0;;76,0;;;10,0;3,0;3,0;;21,0;2,0;2,0;23,0;16,0;16,0;1,0;1,0;5,0;1,0;7,0;2,0;143,0;;;;2,0;2,0;32,0;2,0;5,0;;46,0;45,0;42,0;21,0;2,0;;5,0;39,0;6,0;4,0;2,0;4,0;;;3,0;;9,0;;170,0;3,0;139,0;6,0;;1,0;;6,0;28,0;12,0;4,0;9,0;;7,0;1,0;;;3,0;36,0;35,0;2,0;29,0;6,0;4,0;312,0;3,0;;2,0;2,0;66,0;20,0;;38,0;5,0;;9,0;1,0;11,0;;24,0;;;13,0;1,0;;96,0;7,0;32,0;16,0;8,0;2,0;17,0;4,0;22,0;1,0;8,0;;50,0;187,0;2,0;;;;;1,0;12,0;2,0;22,0;;74,0;8,0;65,0;10,0;1,0;16,0;2,0;96,0;15,0;7,0;1,0;11,0;2,0;;8,0;19,0;41,0;37,0;4,0;;1,0;;;60,0;9,0;2,0;36,0;80,0;3,0;;;9,0;5,0;;1,0;11,0;;1,0;2,0;1,0;14,0;;2,0;10,0;;4,0;14,0;31,0;46,0;4,0;4,0;4,0;;4,0;;7,0;1,0;8,0;7,0;16,0;;55,0;;2,0;;;;;;2,0;;16,0;;;1,0;8,0;22,0;2,0;56,0;;1,0;6,0;14,0;1,0;29,0;9,0;;28,0;;5,0;9,0;;29,0;3,0;1,0;50,0;;;;21,0;;;9,0;;;73,0;1,0;19,0;25,0;32,0;20,0;1,0;5,0;2,0;3,0;;;;16,0;;20,0;;6,0;;4,0;;;6,0;6,0;11,0;26,0;;4,0;;;2,0;71,0;5,0;;;22,0;3,0;3,0;6,0;3,0;;17,0;17,0;;4,0;;;;;;3,0;;;11,0;2,0;;;3,0;4,0;2,0;6,0;2,0;3,0;;19,0;;;1,0;3,0;4,0;7,0;;;3,0;4,0;;2,0;5,0;3,0;33,0;;8,0;;3,0;7,0;;;1,0;;1,0;6,0;32,0;2,0;2,0;3,0;;;;;;1,0;1,0;;11,0;4,0;12,0;;;;3,0;1,0;1,0;9,0;;21,0;5,0;5,0;1,0;;;8,0;;4,0;1,0;2,0;1,0;2,0;2,0;18,0;;;4,0;5,0;1,0;42,0;;;10,0;2,0;;66,0;2,0;;16,0;;2,0;1,0;7,0;7,0;;;;;17,0;6,0;24,0;5,0;;;3,0;5,0;6,0;19,0;1,0;;19,0;1,0;;;;1,0;4,0;1,0;67,0;34,0;;3,0;1,0;;11,0;;;2,0;;5,0;7,0;4,0;3,0;22,0;;;;;7,0;2,0;1,0;1,0;;;;8,0;5,0;1,0;8,0;2,0;;;1,0;4,0;1,0;4,0;;;;;25,0;3,0;3,0;4,0;6,0;7,0;;;;;;;4,0;;1,0;10,0;3,0;3,0;;;;2,0;;;;53,0;20,0;4,0;5,0;9,0;;;;;;;;;12,0;1,0;;2,0;;;;17,0;;5,0;47,0;19,0;;8,0;4,0;11,0;8,0;5,0;14,0;5,0;28,0;2,0;;;;5,0;;23,0;;;;27,0;;6,0;;;;;;;1,0;11,0;7,0;;;8,0;;4,0;57,0;;;;;;4,0;;;;;4,0;;;3,0;;;1,0;;;;10,0;;2,0;12,0;2,0;4,0;1,0;;;;;;;2,0;2,0;;2,0;2,0;;;;;;;;6,0;;;1,0;1,0;;1,0;;;;1,0;;;4,0;;1,0;2,0;;;22,0;;3,0;;2,0;6,0;;;;7,0;1,0;;;;1,0;;;5,0;;4,0;11,0;;2,0;;4,0;1,0;;;;;1,0;;14,0;;;2,0;;;;2,0;4,0;;;4,0;;1,0;;1,0;;;2,0;;;7,0;;;;;1,0;3,0;;7,0;;;;;;;5,0;;;;;;1,0;;;5,0;;;5,0;;;;2,0;;;;;;;;3,0;;;;22,0;1,0;;6,0;1,0;;;
synchronization;;7,0;2,0;6,0;3,0;19,0;;;;;;;;69,0;;;10,0;;11,0;;;;3,0;13,0;18,0;;;;;;74,0;22,0;2,0;120,0;1,0;77,0;2,0;1,0;7,0;;53,0;74,0;;3,0;4,0;;;1,0;;1,0;;;;1,0;3,0;;;;2,0;37,0;;;4,0;;54,0;;12,0;;;;;21,0;24,0;;;;;2,0;1,0;;44,0;;2,0;;16,0;;7,0;6,0;;2,0;4,0;1,0;16,0;4,0;1,0;;2,0;;31,0;19,0;;3,0;3,0;7,0;32,0;9,0;;;;;;10,0;;;2,0;4,0;1,0;2,0;2,0;22,0;;;363,0;;;;32,0;;4,0;;128,0;;;12,0;;2,0;5,0;;;;;1,0;;;;3,0;2,0;1,0;32,0;;;1,0;16,0;;;;;;;;;13,0;3,0;3,0;;;10,0;;;8,0;1,0;;;;;14,0;;6,0;21,0;;;;9,0;;;1,0;;;71,0;;;1,0;;;;;;;;;;;;;2,0;4,0;;;;;;;;;;;19,0;;;;;7,0;;;;;;;;;;;2,0;;;;10,0;;1,0;;;;;;;3,0;;;;;;;;;;1,0;3,0;;;;;29,0;;2,0;;;;;4,0;;;;;;;;3,0;2,0;;;;1,0;;;;;3,0;;22,0;;;;;;;;;;;;;;;;;;;1,0;;9,0;;;;1,0;;;;;;;7,0;16,0;;;;;;;1,0;;;;;;3,0;;;;;;2,0;4,0;;;;;;;;;;;;;1,0;;1,0;;95,0;;;1,0;;11,0;;;;;;;;;3,0;;3,0;;;;6,0;;39,0;;3,0;1,0;3,0;20,0;;14,0;;4,0;2,0;1,0;;;1,0;;;10,0;9,0;;;6,0;;2,0;;2,0;;2,0;1,0;;;;;9,0;12,0;;;;;;;3,0;;2,0;;43,0;7,0;17,0;2,0;;5,0;;11,0;1,0;;;4,0;2,0;8,0;;;4,0;3,0;;;3,0;;;9,0;;;;1,0;;;;5,0;5,0;1,0;;2,0;1,0;4,0;2,0;;7,0;;;;;1,0;;2,0;4,0;;;;1,0;13,0;;;;1,0;6,0;4,0;1,0;23,0;;;;;;;;19,0;;;;;;;13,0;;;;16,0;2,0;;;1,0;11,0;;;;;1,0;;;;;1,0;10,0;;;;;;;;;;;;;16,0;;1,0;;;;;42,0;;;;;;;;;;;;;5,0;;;8,0;;;;8,0;;;;;5,0;;7,0;1,0;;;;;3,0;8,0;;;;;11,0;;;3,0;;;;;;6,0;;;7,0;;;;;;;;;1,0;;;;7,0;;1,0;;11,0;;5,0;;1,0;4,0;;;;12,0;;;;;2,0;;;;;;;;1,0;1,0;6,0;;;;;;2,0;;8,0;2,0;;;3,0;;;;;;2,0;;;;;;;;;;3,0;2,0;;15,0;;;;;;8,0;;;;;2,0;;;1,0;;;;;123,0;1,0;1,0;2,0;;;;;;80,0;7,0;1,0;9,0;;;2,0;;;;;;;;;;;;;;;1,0;;;1,0;;6,0;46,0;;;;;1,0;;;;;;;2,0;;;;;;;1,0;;;;;;;;;;;11,0;;;;;;;;;;;;;;;;;;;;;;;;;;;;;;;;2,0;;;;;;;;;;;;;;;;5,0;;;;;;;;;;;;;1,0;;;;4,0;;1,0;;;;;;;;;;;;;;;;;;;;;;;;;;;;;2,0;;;3,0;;;;;;3,0;;;;3,0;;;3,0;;;;6,0;;;;;;;;3,0;1,0;;;19,0;;;;1,0;;;;;;;;;;;;;;;;1,0;;;;;;2,0;;;;;;;;;;;;;;;;4,0;;;;;;;;;18,0;;;;;;;;;;;6,0;;;;;;;;;;;;;;;;;;;;;;1,0;;;;;;;;;;;;;;;;;;;;;;;;;;;;;;4,0;;;;;;;;
target;;4,0;13,0;55,0;18,0;147,0;37,0;25,0;3,0;4,0;;;12,0;371,0;;12,0;400,0;32,0;3,0;53,0;;3,0;40,0;15,0;12,0;1,0;4,0;26,0;83,0;29,0;156,0;37,0;5,0;47,0;;285,0;88,0;34,0;40,0;3,0;591,0;470,0;3,0;23,0;202,0;54,0;1,0;52,0;6,0;13,0;78,0;2,0;10,0;6,0;200,0;9,0;28,0;;52,0;285,0;1,0;;32,0;1,0;1977,0;4,0;288,0;17,0;1,0;8,0;4,0;140,0;211,0;;9,0;7,0;32,0;47,0;7,0;34,0;383,0;;9,0;80,0;80,0;16,0;;137,0;;2,0;48,0;4,0;15,0;32,0;50,0;5,0;204,0;64,0;436,0;390,0;778,0;66,0;2,0;46,0;104,0;121,0;4,0;17,0;3,0;;;231,0;145,0;20,0;;23,0;58,0;97,0;222,0;92,0;70,0;;156,0;51,0;14,0;70,0;383,0;;9,0;1,0;168,0;5,0;8,0;120,0;7,0;2,0;556,0;25,0;16,0;;;19,0;3,0;4,0;15,0;23,0;329,0;56,0;90,0;35,0;6,0;14,0;101,0;;15,0;;1,0;1,0;;8,0;;9,0;11,0;12,0;;13,0;11,0;11,0;12,0;53,0;12,0;1,0;31,0;177,0;14,0;33,0;2,0;13,0;8,0;;3,0;;1,0;90,0;;31,0;28,0;;177,0;23,0;30,0;8,0;4,0;5,0;;;11,0;4,0;;;;2,0;5,0;;23,0;25,0;88,0;1,0;3,0;49,0;66,0;71,0;38,0;;;;105,0;10,0;20,0;36,0;190,0;13,0;;1,0;;;210,0;6,0;1,0;8,0;;49,0;122,0;94,0;10,0;52,0;121,0;15,0;5,0;76,0;;3,0;2,0;;;178,0;5,0;11,0;19,0;;1,0;;6,0;29,0;;1,0;3,0;68,0;5,0;;17,0;45,0;1,0;192,0;2,0;1,0;3,0;23,0;29,0;115,0;22,0;;4,0;6,0;;;6,0;144,0;;3,0;28,0;2,0;34,0;6,0;46,0;;8,0;7,0;12,0;1,0;;15,0;;2,0;19,0;;275,0;10,0;;8,0;;;;3,0;;;;22,0;19,0;92,0;1,0;;21,0;;8,0;;45,0;2,0;24,0;1,0;3,0;851,0;2,0;31,0;1,0;;4,0;2,0;6,0;;;;;;24,0;;;;;;29,0;56,0;;;1,0;1,0;8,0;54,0;2,0;;;;13,0;;384,0;6,0;3,0;1,0;157,0;21,0;6,0;;;7,0;;21,0;13,0;11,0;;5,0;6,0;1,0;117,0;74,0;28,0;6,0;12,0;10,0;68,0;7,0;131,0;260,0;;23,0;16,0;213,0;8,0;32,0;4,0;30,0;11,0;9,0;45,0;56,0;3,0;53,0;;111,0;55,0;14,0;;24,0;1,0;45,0;9,0;291,0;5,0;32,0;77,0;14,0;;141,0;2,0;15,0;37,0;107,0;;5,0;;34,0;6,0;42,0;6,0;11,0;8,0;111,0;49,0;58,0;22,0;2,0;16,0;6,0;56,0;9,0;113,0;11,0;12,0;126,0;7,0;1,0;22,0;3,0;49,0;17,0;13,0;20,0;20,0;5,0;59,0;22,0;2,0;11,0;12,0;1,0;2,0;;7,0;399,0;14,0;19,0;89,0;1,0;;;;;2,0;;6,0;10,0;26,0;5,0;22,0;30,0;1,0;4,0;24,0;19,0;3,0;14,0;;62,0;3,0;20,0;10,0;13,0;44,0;14,0;24,0;96,0;;7,0;;53,0;1,0;1,0;79,0;;;3,0;6,0;29,0;2,0;13,0;14,0;21,0;47,0;3,0;;;9,0;20,0;;;4,0;6,0;;8,0;;;3,0;;;2,0;4,0;3,0;3,0;4,0;3,0;1,0;;12,0;;3,0;39,0;6,0;2,0;;30,0;47,0;19,0;3,0;30,0;;2,0;10,0;;;;15,0;;1,0;7,0;5,0;18,0;11,0;2,0;1,0;1,0;;1,0;13,0;27,0;2,0;37,0;1,0;39,0;;2,0;8,0;24,0;;11,0;11,0;30,0;30,0;;7,0;;;;;168,0;;6,0;;1,0;;33,0;82,0;20,0;11,0;;9,0;;;;4,0;10,0;2,0;55,0;;3,0;150,0;3,0;79,0;;5,0;2,0;;10,0;5,0;2,0;28,0;;;51,0;47,0;20,0;3,0;2,0;;73,0;92,0;6,0;5,0;8,0;13,0;2,0;1,0;;;;28,0;;16,0;;;3,0;27,0;;;;2,0;6,0;9,0;1,0;;;12,0;;2,0;6,0;15,0;10,0;6,0;23,0;14,0;60,0;43,0;1,0;17,0;10,0;;5,0;;5,0;;;;139,0;4,0;7,0;6,0;3,0;47,0;30,0;6,0;;1,0;1,0;5,0;4,0;10,0;11,0;4,0;8,0;;;;1,0;;;15,0;9,0;12,0;4,0;1,0;;1,0;;;29,0;88,0;11,0;;;1,0;2,0;4,0;13,0;;2,0;2,0;2,0;40,0;15,0;5,0;1,0;13,0;9,0;;;9,0;4,0;7,0;;6,0;1,0;2,0;;;1,0;26,0;102,0;2,0;3,0;2,0;3,0;;36,0;;3,0;;;1,0;2,0;9,0;1,0;3,0;;;;;2,0;;2,0;;4,0;7,0;3,0;8,0;2,0;;;;1,0;;17,0;;45,0;;14,0;1,0;;;;;;;2,0;;;1,0;6,0;9,0;;21,0;7,0;46,0;;1,0;32,0;;;;3,0;;1,0;;2,0;;;125,0;;3,0;;;43,0;26,0;;8,0;6,0;1,0;;44,0;;21,0;;16,0;;35,0;;4,0;5,0;6,0;;1,0;;;;;3,0;;;18,0;7,0;;3,0;20,0;8,0;;9,0;1,0;;29,0;;3,0;2,0;9,0;8,0;42,0;1,0;5,0;14,0;;26,0;6,0;6,0;1,0;;32,0;4,0;;;26,0;3,0;1,0;;12,0;;10,0;3,0;11,0;3,0;1,0;;4,0;23,0;22,0;13,0;1,0;3,0;81,0;;16,0;;1,0;2,0;;2,0;;6,0;16,0;2,0;;;;2,0;1,0;;15,0;2,0;8,0;3,0;;;;8,0;1,0;;2,0;1,0;;;1,0;;2,0;35,0;12,0;;;13,0;;;15,0;7,0;;8,0;;8,0;;;9,0;2,0;2,0;;;;3,0;;;1,0;;;;;4,0;;4,0;1,0;;7,0;;24,0;3,0;;;12,0;29,0;;3,0;;;2,0;;2,0;7,0;67,0;9,0;1,0;36,0;;;18,0;1,0;1,0;25,0;1,0;4,0;3,0;2,0;13,0;5,0;4,0;;;;;1,0;1,0;2,0;;4,0;;;;7,0;;18,0
thread;;11,0;;5,0;;10,0;;61,0;;;1,0;;29,0;67,0;;;;;3,0;;;;;;2,0;;;36,0;;;45,0;;;;;5,0;38,0;3,0;4,0;3,0;4,0;37,0;63,0;;2,0;25,0;;48,0;;;3,0;;27,0;30,0;;;75,0;;;9,0;1,0;;;2,0;8,0;;144,0;2,0;5,0;7,0;13,0;216,0;1,0;;;;1,0;;;;12,0;;;;24,0;8,0;;11,0;6,0;;;1,0;12,0;4,0;;;;;39,0;23,0;21,0;7,0;3,0;2,0;4,0;3,0;;;;;1,0;1,0;3,0;;2,0;;;4,0;3,0;8,0;;;;14,0;;;50,0;;;;;;;16,0;;1,0;;1,0;;;;7,0;;;44,0;6,0;;2,0;;17,0;1,0;7,0;44,0;13,0;;1,0;12,0;;;;2,0;61,0;;;;6,0;53,0;8,0;1,0;13,0;;;;11,0;8,0;9,0;1,0;;6,0;;;;1,0;2,0;67,0;1,0;16,0;12,0;23,0;17,0;;;;2,0;23,0;134,0;45,0;;63,0;13,0;;;1,0;1,0;;2,0;128,0;8,0;;112,0;9,0;;1,0;1,0;;99,0;2,0;2,0;;;;;;;13,0;;173,0;1,0;;;5,0;;10,0;;3,0;;;;2,0;;;21,0;27,0;2,0;4,0;;6,0;6,0;29,0;8,0;11,0;11,0;;69,0;1,0;;33,0;108,0;4,0;;;;1,0;1,0;14,0;;;;;6,0;;;3,0;8,0;21,0;;2,0;8,0;3,0;12,0;7,0;;19,0;7,0;;;;;3,0;6,0;1,0;;1,0;20,0;;2,0;4,0;;5,0;107,0;27,0;1,0;;;;2,0;;23,0;4,0;1,0;;;9,0;;;14,0;9,0;21,0;1,0;11,0;;1,0;1,0;1,0;;;;6,0;;1,0;13,0;;1,0;4,0;;;;;2,0;;9,0;9,0;3,0;346,0;1,0;19,0;18,0;4,0;;8,0;4,0;5,0;;;14,0;35,0;8,0;55,0;2,0;;;;;;;4,0;;;;;;;;3,0;;;;;;;1,0;;;;;4,0;;;;;;10,0;;5,0;1,0;;5,0;;;;;2,0;2,0;2,0;;;;2,0;;2,0;;1,0;;;;4,0;;10,0;;;;;;1,0;;33,0;4,0;;;;;;;;;;;;;;;;;1,0;;3,0;;1,0;3,0;;;;;10,0;10,0;;;;5,0;;7,0;;;;;;;;;;;;;12,0;31,0;2,0;;;;;5,0;;;9,0;;17,0;3,0;;;3,0;;;;1,0;9,0;;;;;;;;;;;8,0;5,0;;;;;;3,0;2,0;;;;;;;20,0;43,0;1,0;2,0;;;;2,0;;;5,0;;2,0;5,0;;;;;;24,0;;;8,0;26,0;;;;;2,0;;2,0;13,0;;1,0;;;;;;;7,0;11,0;1,0;1,0;;;2,0;;;;;1,0;;10,0;5,0;;;;2,0;;;;;2,0;3,0;11,0;17,0;;;;;;;;;;;;;;;1,0;;3,0;;;;;;;;;;;;1,0;;;;;;;;;;;;;;;;;;1,0;;;;2,0;1,0;;;;1,0;3,0;;3,0;;;;2,0;;;;;;2,0;;;;;;;1,0;;;;;;6,0;;1,0;;;;;;;;;;1,0;1,0;;;;;;;;;;7,0;;;2,0;5,0;;;;2,0;;;;46,0;;;38,0;16,0;;;;4,0;5,0;;;3,0;;;;15,0;;;1,0;;;;2,0;;;;;;2,0;;14,0;;;51,0;;;;1,0;;;18,0;;;;;;1,0;27,0;9,0;;;1,0;;;;;4,0;;5,0;;;;;;;3,0;;;;;;;;;;21,0;;;2,0;;;;;;;;;;;;;;;7,0;;;;;;;;;;;1,0;;;;;;;;;;;;;;;;6,0;;;5,0;;;;;;;;1,0;8,0;3,0;5,0;;;2,0;;;;;;;;;;;;;;;;;;;;;1,0;;;;5,0;;;;;;;;;;;;;;3,0;;;;;;;;;3,0;;5,0;;;;;;;;1,0;;;;;;;;;2,0;;;4,0;;;22,0;;6,0;;;;;;;;;;;;;;;7,0;;1,0;;7,0;;;;;;;;3,0;;;12,0;;;;;;;;;25,0;;;;;39,0;;;;;;;;;;;;;;;;;;;;;;;;;;;;;;;1,0;;;;;;;;
tilt;;4,0;;74,0;56,0;53,0;8,0;96,0;4,0;4,0;;;4,0;103,0;;1,0;52,0;;;;;;;;3,0;13,0;3,0;20,0;10,0;3,0;111,0;26,0;25,0;10,0;;72,0;26,0;33,0;2,0;9,0;103,0;142,0;4,0;28,0;23,0;9,0;4,0;13,0;;7,0;7,0;;3,0;;28,0;8,0;17,0;4,0;2,0;7,0;2,0;;8,0;1,0;153,0;2,0;102,0;10,0;;8,0;;113,0;16,0;;;1,0;;15,0;;9,0;105,0;2,0;13,0;4,0;76,0;44,0;4,0;169,0;8,0;;52,0;1,0;8,0;1,0;13,0;;1,0;64,0;62,0;23,0;132,0;15,0;;3,0;4,0;15,0;1,0;4,0;13,0;;;13,0;10,0;4,0;;;;32,0;3,0;132,0;2,0;;38,0;5,0;;2,0;150,0;;4,0;;6,0;;;129,0;;;38,0;45,0;100,0;;;1,0;3,0;;1,0;9,0;21,0;32,0;19,0;29,0;2,0;4,0;46,0;6,0;;;6,0;;;;1,0;27,0;;;1,0;;18,0;5,0;11,0;8,0;37,0;1,0;11,0;282,0;8,0;10,0;1,0;;12,0;;;;;20,0;3,0;;12,0;26,0;34,0;3,0;;8,0;;3,0;18,0;;41,0;3,0;4,0;1,0;;;;;13,0;4,0;44,0;;23,0;52,0;16,0;90,0;7,0;;;11,0;2,0;19,0;28,0;26,0;7,0;;;;24,0;;11,0;;2,0;1,0;;2,0;85,0;;4,0;;4,0;;1,0;6,0;;1,0;30,0;;;14,0;3,0;;33,0;2,0;7,0;;;9,0;1,0;1,0;26,0;28,0;;;1,0;8,0;;6,0;8,0;;;;5,0;2,0;;;27,0;1,0;1,0;;8,0;480,0;4,0;2,0;1,0;1,0;449,0;6,0;;4,0;;2,0;;;56,0;3,0;;11,0;;;21,0;68,0;4,0;2,0;2,0;;;;1,0;;3,0;85,0;31,0;60,0;5,0;1,0;4,0;;34,0;10,0;9,0;3,0;9,0;29,0;6,0;60,0;7,0;4,0;2,0;;3,0;;11,0;;1,0;;;;;4,0;;;;;50,0;85,0;4,0;1,0;;1,0;;6,0;2,0;1,0;;1,0;;;31,0;3,0;2,0;10,0;37,0;;;2,0;4,0;;;22,0;;12,0;;;3,0;56,0;48,0;13,0;36,0;11,0;1,0;11,0;1,0;;105,0;4,0;;2,0;11,0;106,0;;3,0;2,0;;2,0;1,0;;11,0;8,0;22,0;;16,0;9,0;13,0;;20,0;;2,0;15,0;42,0;1,0;27,0;39,0;76,0;2,0;59,0;1,0;4,0;34,0;19,0;3,0;8,0;1,0;1,0;;4,0;;;;29,0;41,0;21,0;5,0;85,0;7,0;;8,0;;21,0;7,0;;15,0;4,0;;;;1,0;;3,0;5,0;1,0;;26,0;;;;2,0;4,0;6,0;3,0;3,0;2,0;;6,0;17,0;;;3,0;;;1,0;;1,0;;4,0;1,0;11,0;;1,0;11,0;4,0;;;;140,0;;;6,0;5,0;5,0;22,0;;8,0;;;;;;;2,0;6,0;;2,0;11,0;1,0;;;1,0;3,0;31,0;;;;4,0;;;;;2,0;5,0;;1,0;;;;6,0;1,0;;;;5,0;1,0;;;12,0;1,0;4,0;;50,0;;;;6,0;2,0;1,0;;16,0;;4,0;;;;;;;;;;7,0;;3,0;;;;1,0;;7,0;;;;;1,0;;1,0;;3,0;;;19,0;16,0;;;;3,0;;;;2,0;;;;;2,0;;;;;;;;;;;;;;;10,0;;;;;;;;;7,0;9,0;1,0;2,0;;1,0;2,0;6,0;1,0;;;3,0;;;9,0;;;6,0;;1,0;;1,0;;;;2,0;10,0;;;1,0;;18,0;;;;2,0;;;;;2,0;;7,0;1,0;;;;;;3,0;;;;1,0;;;;;1,0;;4,0;;;2,0;1,0;5,0;17,0;;;;;5,0;4,0;;;;1,0;5,0;;23,0;;;;9,0;;4,0;;;;13,0;1,0;159,0;104,0;;;2,0;;10,0;;;4,0;;4,0;4,0;;5,0;2,0;2,0;2,0;3,0;2,0;;11,0;;23,0;;2,0;;;;1,0;6,0;69,0;;;19,0;22,0;;;;8,0;1,0;;1,0;;2,0;3,0;3,0;;4,0;;;;;;;;;1,0;9,0;;4,0;;;;;;6,0;10,0;1,0;2,0;;;1,0;;2,0;9,0;2,0;3,0;;;1,0;2,0;10,0;;;;;;;;;;;;;;2,0;;;;6,0;;;;;;;;3,0;;;;;;6,0;;;3,0;2,0;;;;5,0;;;;;;;;;;;;;;1,0;1,0;;;;;;;;;;3,0;3,0;1,0;1,0;1,0;;20,0;;;1,0;;;;2,0;;;;;4,0;;;;6,0;8,0;;;;1,0;;;;;;2,0;;;;;;;;;;;;;1,0;;1,0;;;1,0;;;;;1,0;;;;;;2,0;;;1,0;3,0;;;34,0;;1,0;19,0;;;;4,0;;;;;;;;;7,0;;;;;2,0;;2,0;;;;;;;;8,0;41,0;;3,0;;2,0;;;;;;;;;;;2,0;1,0;3,0;;;4,0;1,0;;1,0;;;;;;;;;;2,0;;;;;;;5,0;;;;;;;2,0;
transfer;;1,0;1,0;6,0;16,0;16,0;11,0;16,0;;;;;3,0;37,0;;1,0;38,0;4,0;50,0;;6,0;;2,0;5,0;19,0;5,0;;18,0;12,0;2,0;326,0;9,0;;4,0;;275,0;;;6,0;;42,0;216,0;;17,0;29,0;12,0;;94,0;;3,0;;;;15,0;21,0;3,0;46,0;;3,0;67,0;;;5,0;;232,0;4,0;100,0;4,0;3,0;1,0;3,0;35,0;42,0;1,0;;2,0;18,0;2,0;;34,0;58,0;;5,0;1,0;19,0;1,0;;23,0;1,0;11,0;11,0;;1,0;8,0;;1,0;137,0;2,0;160,0;6,0;24,0;16,0;;15,0;23,0;28,0;1,0;2,0;;;;;105,0;1,0;;;2,0;23,0;5,0;44,0;;;229,0;6,0;1,0;29,0;107,0;;;;32,0;6,0;4,0;259,0;;6,0;16,0;;3,0;2,0;;2,0;1,0;;;12,0;3,0;50,0;8,0;;;52,0;21,0;2,0;22,0;275,0;;;;3,0;12,0;61,0;;17,0;92,0;6,0;27,0;9,0;1,0;23,0;4,0;;8,0;38,0;;7,0;41,0;3,0;4,0;1,0;75,0;;6,0;29,0;;;3,0;6,0;3,0;5,0;;;141,0;13,0;;2,0;22,0;6,0;3,0;2,0;;2,0;;5,0;2,0;4,0;20,0;2,0;1,0;12,0;4,0;;;;;7,0;41,0;7,0;5,0;20,0;3,0;8,0;;198,0;10,0;;181,0;3,0;3,0;18,0;;8,0;5,0;1,0;7,0;;3,0;;;1,0;;19,0;;;;7,0;6,0;5,0;62,0;;;;5,0;16,0;61,0;28,0;7,0;26,0;5,0;;;11,0;3,0;12,0;1,0;;3,0;;4,0;11,0;;8,0;3,0;6,0;;2,0;3,0;;;;;;7,0;9,0;;;9,0;1,0;57,0;;3,0;3,0;;;;3,0;5,0;57,0;3,0;;;;1,0;;;;;7,0;1,0;48,0;;;6,0;2,0;2,0;1,0;7,0;;;3,0;9,0;6,0;;1,0;;2,0;7,0;;37,0;;;;;;15,0;;;;;1,0;6,0;5,0;1,0;;;1,0;;3,0;;;;;6,0;;2,0;3,0;21,0;1,0;61,0;34,0;6,0;;;;;1,0;2,0;;;;1,0;;9,0;3,0;10,0;;;5,0;2,0;1,0;122,0;2,0;2,0;1,0;;4,0;3,0;1,0;1,0;4,0;1,0;;;16,0;11,0;47,0;2,0;5,0;13,0;;;35,0;2,0;25,0;2,0;2,0;;5,0;8,0;;;1,0;;1,0;15,0;3,0;;;;;;5,0;;16,0;;55,0;;15,0;14,0;;1,0;1,0;6,0;;9,0;;8,0;5,0;11,0;;;3,0;14,0;1,0;;1,0;;1,0;5,0;;;32,0;;;1,0;3,0;;5,0;8,0;1,0;28,0;;;11,0;;9,0;;;2,0;;;2,0;4,0;33,0;8,0;;1,0;;4,0;;10,0;;;10,0;2,0;;33,0;2,0;2,0;;;;;1,0;1,0;;1,0;;;;2,0;11,0;;;1,0;21,0;;;1,0;2,0;4,0;;2,0;2,0;1,0;;2,0;;;9,0;10,0;12,0;;1,0;16,0;;4,0;;17,0;;2,0;;;1,0;32,0;1,0;;;2,0;3,0;;2,0;;;;14,0;;;10,0;;;;;1,0;73,0;8,0;;;;2,0;3,0;9,0;1,0;11,0;1,0;;1,0;;4,0;3,0;;;1,0;4,0;;;;;;;;2,0;;3,0;3,0;;;8,0;1,0;6,0;36,0;2,0;;2,0;;;2,0;7,0;;1,0;;;;1,0;1,0;86,0;;;;208,0;;1,0;;;;2,0;;3,0;16,0;6,0;13,0;;;;2,0;;;;1,0;2,0;1,0;4,0;7,0;18,0;3,0;12,0;;4,0;;;;;;;6,0;1,0;;;12,0;;6,0;;11,0;;;;1,0;1,0;3,0;;;11,0;3,0;28,0;17,0;;;19,0;;;20,0;4,0;;5,0;;4,0;1,0;;17,0;;;2,0;;7,0;3,0;7,0;3,0;3,0;;;;;;11,0;2,0;10,0;;3,0;;;;;1,0;7,0;9,0;;;1,0;;2,0;;;1,0;;6,0;3,0;;;;4,0;12,0;;8,0;;;;;;;2,0;;;;;1,0;;1,0;;2,0;;;;4,0;;;;;;;;;;3,0;;1,0;;;;2,0;1,0;;;2,0;;;;;;1,0;;;;7,0;;;;;;;1,0;;;;;2,0;;;6,0;28,0;21,0;24,0;4,0;;5,0;1,0;1,0;85,0;;12,0;86,0;1,0;1,0;32,0;1,0;77,0;;14,0;1,0;;2,0;18,0;;;15,0;32,0;;53,0;;;1,0;;1,0;;2,0;21,0;;;3,0;1,0;1,0;1,0;434,0;1,0;;;;2,0;2,0;;1,0;;;;;3,0;;;;1,0;;2,0;;;;;1,0;2,0;;;15,0;;2,0;1,0;;;3,0;;;12,0;1,0;7,0;;9,0;18,0;2,0;;;3,0;;1,0;12,0;3,0;;;;;;;;;;;16,0;;;;;5,0;2,0;;1,0;;;;;;;2,0;;;;;;;;1,0;;;;;;;;;;;;4,0;7,0;;3,0;;;;;;;;;;;8,0;;;;;;;;;;;;1,0;;;;;;;;20,0;8,0;;;1,0;;;;;;;2,0;;;;;;;;;;;;;2,0;;;;;;2,0;;;13,0;;;1,0;;
transitory;;1,0;;13,0;11,0;13,0;14,0;6,0;4,0;4,0;;1,0;;78,0;;4,0;124,0;;2,0;7,0;;1,0;16,0;2,0;11,0;;3,0;14,0;856,0;14,0;25,0;8,0;2,0;6,0;;88,0;7,0;8,0;20,0;2,0;69,0;295,0;;16,0;87,0;;1,0;7,0;1,0;4,0;9,0;;1,0;16,0;14,0;2,0;1,0;2,0;7,0;24,0;1,0;;5,0;;382,0;;71,0;8,0;1,0;1,0;4,0;22,0;15,0;;22,0;7,0;;4,0;142,0;119,0;50,0;4,0;28,0;25,0;14,0;;;25,0;3,0;2,0;22,0;1,0;1,0;4,0;4,0;2,0;33,0;10,0;73,0;33,0;40,0;29,0;;13,0;28,0;137,0;79,0;189,0;2,0;2,0;;11,0;41,0;4,0;1,0;;8,0;11,0;19,0;70,0;9,0;;44,0;10,0;5,0;267,0;73,0;;4,0;;53,0;;;21,0;;;57,0;20,0;16,0;;;4,0;;;1,0;5,0;18,0;2,0;20,0;2,0;1,0;7,0;4,0;;1,0;;;;1,0;;;4,0;21,0;;;5,0;11,0;1,0;;6,0;5,0;;2,0;21,0;;16,0;;2,0;2,0;1,0;;1,0;;11,0;;;12,0;;46,0;;;2,0;;2,0;;;4,0;;2,0;1,0;;3,0;;1,0;8,0;1633,0;;;1,0;5,0;2,0;14,0;3,0;;;1,0;19,0;1,0;;7,0;13,0;16,0;3,0;;;;32,0;1,0;;4,0;;;19,0;19,0;2,0;2,0;;;;6,0;;1,0;1,0;;;26,0;;6,0;4,0;2,0;;;5,0;8,0;;1,0;1,0;17,0;7,0;;1,0;7,0;8,0;19,0;;;1,0;1,0;8,0;;;;1,0;;;;1,0;25,0;;;;2,0;13,0;3,0;1,0;2,0;3,0;1,0;3,0;1,0;2,0;4,0;;;;1,0;27,0;3,0;;;;;;2,0;;;1,0;3,0;2,0;12,0;;1,0;1,0;;;;5,0;3,0;;2,0;49,0;83,0;3,0;6,0;1,0;4,0;;;4,0;4,0;;;;;62,0;;;;1,0;;6,0;5,0;;;;;4,0;7,0;;;1,0;;5,0;;20,0;1,0;10,0;4,0;56,0;3,0;3,0;4,0;2,0;6,0;4,0;12,0;3,0;5,0;1,0;2,0;2,0;1,0;9,0;10,0;12,0;;;7,0;5,0;5,0;41,0;13,0;;14,0;;38,0;1,0;14,0;1,0;11,0;4,0;25,0;4,0;7,0;;27,0;;9,0;5,0;3,0;2,0;33,0;2,0;32,0;11,0;24,0;6,0;5,0;15,0;5,0;;4,0;1,0;4,0;37,0;13,0;2,0;1,0;4,0;2,0;;21,0;1,0;1,0;843,0;17,0;6,0;17,0;2,0;;6,0;1,0;16,0;;6,0;;1058,0;10,0;1,0;3,0;3,0;;61,0;5,0;1,0;;;1,0;46,0;7,0;11,0;3,0;2,0;;;3,0;1,0;12,0;3,0;3,0;38,0;1,0;3,0;4,0;;17,0;;17,0;2,0;3,0;5,0;1,0;104,0;21,0;1,0;2,0;1,0;4,0;9,0;75,0;;2,0;4,0;12,0;2,0;;23,0;6,0;1,0;14,0;;;2,0;2,0;;;13,0;2,0;10,0;;2,0;21,0;;9,0;8,0;6,0;;;;2,0;3,0;7,0;2,0;1,0;4,0;7,0;;3,0;;;1,0;;1,0;1,0;1,0;;;;;;;24,0;;3,0;8,0;;8,0;6,0;;3,0;1,0;4,0;1,0;;1,0;11,0;2,0;;4,0;5,0;;;5,0;1,0;10,0;13,0;1,0;;1,0;2,0;;3,0;3,0;3,0;12,0;1,0;3,0;1,0;5,0;7,0;1,0;;;;1,0;6,0;;4,0;;2,0;;1,0;1,0;;2,0;;;12,0;55,0;;3,0;6,0;6,0;1,0;;;3,0;;9,0;2,0;6,0;26,0;2,0;25,0;7,0;7,0;1,0;8,0;2,0;;;;2,0;1,0;;;2,0;5,0;1,0;;1,0;;1,0;11,0;;;;;2,0;1,0;1,0;;;11,0;;;2,0;;1,0;3,0;3,0;4,0;;;1,0;4,0;;;1,0;;;2,0;;4,0;1,0;2,0;6,0;;5,0;4,0;1,0;;2,0;3,0;4,0;;4,0;;;3,0;6,0;1,0;4,0;1,0;10,0;6,0;;8,0;20,0;5,0;8,0;;2,0;;1,0;6,0;;;2,0;;;;5,0;;2,0;3,0;1,0;;;;1,0;;1,0;1,0;1,0;;;;;6,0;;;1,0;2,0;;1,0;;2,0;;3,0;4,0;;;;1,0;1,0;;;2,0;2,0;;;;3,0;12,0;;;;2,0;;2,0;;;3,0;;;7,0;5,0;;2,0;;;;;;;;;;;;;1,0;;;;;;2,0;1,0;5,0;;3,0;;;;6,0;;;;3,0;;;2,0;3,0;1,0;;1,0;;7,0;1,0;;;1,0;;;1,0;1,0;5,0;;;1,0;;9,0;;5,0;;2,0;9,0;7,0;;2,0;;1,0;;5,0;;;5,0;1,0;;2,0;1,0;;1,0;2,0;;5,0;;;;;3,0;;3,0;5,0;3,0;1,0;;;;;1,0;2,0;2,0;2,0;2,0;1,0;2,0;;4,0;6,0;;;3,0;3,0;3,0;6,0;1,0;;3,0;2,0;;;4,0;;1,0;;;1,0;;;6,0;3,0;5,0;;;;5,0;1,0;1,0;;;12,0;;;;4,0;4,0;;;1,0;1,0;;;2,0;;3,0;1,0;2,0;1,0;17,0;;2,0;6,0;;;2,0;1,0;;;3,0;1,0;;;;;;1,0;;;;2,0;;;6,0;1,0;;;;;;;;;;;;;;;;;;;;;;;;4,0;;;1,0;;;1,0;;;2,0;;;1,0;2,0;;;2,0;;;;5,0;1,0;;1,0;8,0;;2,0;;;;2,0;6,0;;2,0;;3,0;1,0;;12,0;2,0;1,0;2,0;;;3,0;;;;;
transmission;;5,0;;30,0;2,0;39,0;22,0;16,0;;4,0;;27,0;1,0;31,0;1,0;2,0;34,0;;13,0;3,0;;;8,0;2,0;65,0;;;;11,0;63,0;110,0;16,0;;7,0;1,0;286,0;2,0;;;1,0;36,0;170,0;;23,0;18,0;7,0;;9,0;;12,0;;;4,0;10,0;8,0;;15,0;;36,0;27,0;6,0;1,0;20,0;1,0;162,0;14,0;98,0;2,0;;;10,0;45,0;68,0;1,0;;;2,0;;;1,0;61,0;;142,0;3,0;23,0;3,0;;31,0;;5,0;5,0;1,0;7,0;;33,0;6,0;82,0;1,0;52,0;7,0;22,0;41,0;;;98,0;33,0;;10,0;7,0;;;11,0;3,0;;3,0;;6,0;3,0;;39,0;3,0;4,0;444,0;;5,0;11,0;70,0;;1,0;;110,0;1,0;;305,0;6,0;;5,0;;1,0;;;;;;1,0;5,0;14,0;5,0;22,0;13,0;1,0;4,0;53,0;1,0;7,0;12,0;;1,0;;;3,0;81,0;7,0;10,0;4,0;;7,0;7,0;;11,0;;;13,0;2,0;3,0;16,0;7,0;1,0;30,0;2,0;3,0;1,0;;;;;65,0;2,0;60,0;6,0;1,0;;10,0;7,0;;10,0;6,0;10,0;;1,0;;9,0;10,0;2,0;7,0;9,0;49,0;;12,0;10,0;;1,0;;;;;47,0;23,0;3,0;120,0;;25,0;;;;;20,0;;7,0;5,0;;1,0;16,0;4,0;1,0;;4,0;3,0;;2,0;;3,0;;4,0;;9,0;;4,0;3,0;2,0;1,0;;;1,0;5,0;8,0;4,0;5,0;;;7,0;176,0;37,0;32,0;;;21,0;30,0;;;;21,0;;9,0;3,0;23,0;3,0;6,0;1,0;;15,0;;5,0;;;4,0;9,0;10,0;33,0;;20,0;4,0;;;;;7,0;10,0;;3,0;;;;3,0;;;3,0;8,0;;18,0;;;6,0;;;;;3,0;;20,0;7,0;15,0;;1,0;2,0;;1,0;;45,0;1,0;;;;1,0;21,0;;;;;;7,0;3,0;;;;;;1,0;1,0;2,0;;;;;;5,0;1,0;;106,0;112,0;2,0;;;1,0;5,0;;3,0;;;;;;;6,0;5,0;3,0;;21,0;8,0;1,0;109,0;1,0;20,0;1,0;5,0;31,0;10,0;27,0;;5,0;;2,0;;;5,0;6,0;11,0;3,0;15,0;;;4,0;;26,0;;3,0;1,0;5,0;2,0;6,0;1,0;7,0;;1,0;19,0;1,0;;;;;;25,0;3,0;3,0;1,0;99,0;22,0;41,0;13,0;1,0;5,0;1,0;19,0;2,0;22,0;53,0;5,0;;17,0;123,0;;8,0;16,0;5,0;;;;;2,0;;;16,0;20,0;1,0;1,0;5,0;;1,0;1,0;1,0;2,0;;;;;22,0;;2,0;;;3,0;;12,0;10,0;2,0;;;16,0;2,0;;;;3,0;;11,0;;20,0;9,0;8,0;1,0;1,0;;14,0;;16,0;;1,0;1,0;;;1,0;28,0;;;;;1,0;;;1,0;5,0;9,0;;;2,0;15,0;;4,0;;;20,0;3,0;;;;;;;;1,0;29,0;;;;;6,0;12,0;3,0;;2,0;;;;1,0;;;;;;;;;;5,0;58,0;3,0;;;;;;19,0;3,0;;;;2,0;2,0;7,0;6,0;;1,0;7,0;1,0;1,0;;;1,0;;19,0;;;32,0;26,0;8,0;;4,0;2,0;1,0;;9,0;;34,0;3,0;;;1,0;4,0;8,0;;1,0;;;1,0;1,0;;;12,0;;13,0;;1,0;;;2,0;;;4,0;3,0;;12,0;;3,0;1,0;3,0;1,0;;;1,0;3,0;;3,0;;42,0;;13,0;12,0;2,0;3,0;2,0;;;;;;;4,0;;18,0;1,0;;1,0;2,0;;;2,0;;4,0;;;;7,0;7,0;1,0;43,0;;4,0;14,0;1,0;1,0;60,0;1,0;;3,0;;;;;10,0;;3,0;;4,0;;11,0;1,0;5,0;;5,0;;4,0;6,0;17,0;11,0;1,0;6,0;1,0;;;2,0;1,0;;2,0;29,0;10,0;;;;;;;;;11,0;;3,0;22,0;2,0;8,0;1,0;1,0;;;4,0;9,0;;;;;2,0;;26,0;;;5,0;;;17,0;13,0;;;1,0;;;;8,0;;18,0;3,0;;;;5,0;;4,0;;;;;;;;;;;;;;;;1,0;;1,0;;;;;;3,0;;;;7,0;13,0;1,0;;2,0;;;;;;19,0;;;;8,0;;;;8,0;2,0;;;;;;;;;11,0;;;;10,0;;;;;;;;;;;;;2,0;;;;79,0;;;;;1,0;13,0;;;65,0;;1,0;;;;;4,0;;;;;;7,0;5,0;2,0;;;1,0;;;2,0;1,0;6,0;;4,0;;;;113,0;;;;1,0;;;;14,0;;;6,0;;;;;;;;;;1,0;11,0;4,0;;;;1,0;15,0;;2,0;;;;;;;;;;;;;;;;;;;2,0;;29,0;;2,0;;19,0;;;2,0;2,0;;;;3,0;;;;;;;8,0;;2,0;;11,0;;;;;;;;;;;;;;;;;;;2,0;1,0;;;;;;;;;;1,0;;;;;1,0;3,0;;;;;;;;;;;;3,0;;;;;;;;
transmit;;20,0;;6,0;53,0;96,0;31,0;12,0;;2,0;;5,0;2,0;119,0;2,0;3,0;268,0;1,0;22,0;15,0;19,0;;33,0;17,0;198,0;;2,0;30,0;39,0;52,0;518,0;91,0;2,0;6,0;;798,0;5,0;1,0;1,0;8,0;46,0;541,0;4,0;56,0;137,0;16,0;2,0;48,0;;3,0;4,0;;;85,0;4,0;5,0;25,0;;32,0;93,0;1,0;1,0;16,0;2,0;1152,0;2,0;135,0;1,0;5,0;1,0;19,0;237,0;650,0;;7,0;2,0;12,0;19,0;24,0;32,0;272,0;;62,0;11,0;141,0;2,0;;61,0;3,0;13,0;45,0;56,0;17,0;28,0;20,0;21,0;51,0;3,0;126,0;23,0;74,0;60,0;1,0;35,0;80,0;124,0;2,0;15,0;;;;20,0;38,0;2,0;;;20,0;24,0;29,0;183,0;53,0;;903,0;6,0;6,0;89,0;206,0;;7,0;1,0;92,0;;;365,0;;;51,0;12,0;33,0;9,0;;3,0;2,0;;25,0;8,0;31,0;37,0;40,0;3,0;1,0;20,0;115,0;;7,0;13,0;;1,0;;;18,0;64,0;20,0;25,0;8,0;;18,0;8,0;;20,0;4,0;10,0;23,0;37,0;6,0;2,0;13,0;36,0;11,0;6,0;3,0;1,0;8,0;13,0;;11,0;69,0;15,0;120,0;4,0;;;2,0;13,0;2,0;12,0;29,0;41,0;6,0;;2,0;36,0;2,0;;13,0;18,0;45,0;5,0;64,0;15,0;19,0;27,0;5,0;;;1,0;54,0;17,0;3,0;21,0;19,0;17,0;5,0;27,0;6,0;2,0;120,0;2,0;3,0;9,0;;56,0;26,0;7,0;4,0;6,0;85,0;7,0;1,0;32,0;1,0;;10,0;;;32,0;2,0;4,0;10,0;;3,0;;2,0;11,0;67,0;7,0;6,0;80,0;3,0;17,0;11,0;;8,0;85,0;;8,0;53,0;36,0;2,0;4,0;4,0;62,0;2,0;21,0;11,0;;8,0;36,0;;10,0;5,0;;7,0;16,0;;;2,0;7,0;81,0;1,0;28,0;38,0;4,0;;9,0;3,0;23,0;14,0;;1,0;;;2,0;1,0;;1,0;;11,0;;78,0;;;2,0;;8,0;;12,0;5,0;3,0;34,0;94,0;117,0;3,0;1,0;1,0;;8,0;1,0;101,0;6,0;;;;2,0;76,0;1,0;2,0;;;6,0;15,0;31,0;4,0;;;;8,0;5,0;;;;;7,0;9,0;14,0;;17,0;2,0;550,0;141,0;;2,0;3,0;3,0;38,0;10,0;5,0;;5,0;5,0;;;19,0;1,0;36,0;12,0;22,0;155,0;3,0;3,0;378,0;11,0;12,0;2,0;2,0;49,0;9,0;;;26,0;2,0;4,0;6,0;37,0;3,0;4,0;;12,0;43,0;8,0;4,0;39,0;13,0;15,0;;86,0;1,0;50,0;33,0;17,0;;23,0;;15,0;48,0;14,0;3,0;;;;3,0;15,0;;15,0;;337,0;99,0;84,0;12,0;;34,0;13,0;66,0;13,0;9,0;1,0;29,0;25,0;30,0;29,0;20,0;62,0;21,0;8,0;3,0;7,0;;3,0;116,0;;8,0;3,0;3,0;;1,0;2,0;2,0;9,0;5,0;8,0;33,0;;2,0;7,0;13,0;24,0;;;;1,0;15,0;3,0;78,0;95,0;6,0;;13,0;17,0;13,0;2,0;1,0;2,0;18,0;3,0;33,0;7,0;29,0;8,0;36,0;;4,0;2,0;4,0;1,0;35,0;7,0;27,0;10,0;2,0;5,0;6,0;169,0;3,0;3,0;;4,0;1,0;30,0;;;93,0;;10,0;1,0;2,0;37,0;;1,0;;7,0;46,0;8,0;;;;1,0;1,0;2,0;1,0;;11,0;;;4,0;7,0;22,0;8,0;2,0;5,0;3,0;8,0;;2,0;12,0;2,0;27,0;;;13,0;2,0;;6,0;6,0;4,0;168,0;25,0;1,0;1,0;;;4,0;41,0;18,0;3,0;9,0;;19,0;6,0;11,0;15,0;;3,0;14,0;1,0;2,0;1,0;9,0;3,0;;92,0;;1,0;72,0;35,0;8,0;8,0;1,0;48,0;12,0;6,0;31,0;5,0;12,0;4,0;2,0;;;16,0;13,0;5,0;5,0;4,0;;8,0;42,0;30,0;;20,0;10,0;14,0;11,0;4,0;2,0;22,0;24,0;5,0;;25,0;14,0;12,0;11,0;6,0;7,0;1,0;39,0;;;;3,0;35,0;;9,0;;157,0;4,0;43,0;;2,0;;15,0;11,0;12,0;2,0;2,0;;4,0;16,0;1,0;8,0;1,0;;8,0;13,0;;;;;4,0;4,0;;;9,0;83,0;1,0;23,0;;1,0;18,0;1,0;15,0;51,0;37,0;1,0;17,0;1,0;1,0;20,0;;45,0;;1,0;;57,0;176,0;166,0;41,0;1,0;2,0;;;;1,0;3,0;14,0;17,0;20,0;7,0;;1,0;;1,0;;9,0;39,0;23,0;;8,0;17,0;;3,0;3,0;;;21,0;;28,0;25,0;6,0;34,0;2,0;79,0;;;22,0;15,0;;1,0;;;7,0;;6,0;;4,0;5,0;4,0;3,0;;1,0;;32,0;;;;;11,0;1,0;51,0;;;;;9,0;;5,0;;13,0;12,0;3,0;12,0;;;8,0;;;2,0;;;1,0;;11,0;13,0;2,0;1,0;1,0;;1,0;;5,0;;;;;14,0;8,0;;10,0;2,0;1,0;;4,0;12,0;3,0;2,0;1,0;;30,0;;3,0;3,0;;;6,0;27,0;3,0;1,0;;;;3,0;;;;2,0;6,0;;2,0;7,0;;1,0;;;17,0;;3,0;2,0;;8,0;3,0;;8,0;3,0;;;2,0;5,0;29,0;;;;17,0;;2,0;;;;4,0;;;1,0;1,0;;;;2,0;2,0;1,0;;1,0;;;13,0;2,0;16,0;20,0;11,0;;1,0;8,0;85,0;;4,0;;4,0;7,0;;6,0;10,0;;;5,0;2,0;38,0;4,0;6,0;;;3,0;1,0;2,0;8,0;12,0;2,0;1,0;;;;36,0;8,0;2,0;24,0;10,0;;;4,0;2,0;;3,0;;;1,0;;1,0;;1,0;;;2,0;20,0;;43,0;;;;92,0;9,0;3,0;1,0;35,0;;2,0;4,0;;;;;;4,0;;4,0;;18,0;1,0;;;3,0;;;;6,0;7,0;;;2,0;2,0;;;2,0;1,0;;;8,0;;;11,0;1,0;1,0;;1,0;7,0;1,0;5,0;;3,0;;;2,0;;2,0;;7,0;;;2,0;;;;2,0;;;;2,0;;1,0;5,0;;;3,0;;
tripod;;6,0;;;;2,0;;12,0;;;;;;27,0;;;4,0;;;;;;;1,0;2,0;;;;;;51,0;;;;;7,0;;;;;;15,0;;;14,0;;;25,0;;;;;4,0;1,0;;;18,0;;;;;;;;4,0;;7,0;;;;;;4,0;;;;2,0;;;;3,0;;;;3,0;;;;;;;;1,0;;;;;;4,0;;11,0;;;;;;;;;;;;;;2,0;;;;;1,0;;;;;;;8,0;;;;;;;;;;;;;;;;;;2,0;;;2,0;;11,0;;;1,0;1,0;;3,0;;;;;;13,0;;;;;14,0;1,0;;;;;;1,0;;;2,0;4,0;1,0;;1,0;;;;2,0;;;;2,0;;;;;2,0;1,0;15,0;;;;;;;;;2,0;;2,0;;;65,0;;6,0;;;;;;;;;;;;;4,0;;;;4,0;;;;;;;;;;4,0;;;;;;;;;5,0;1,0;;;;;2,0;;;31,0;7,0;;;;;;;;;;;;;;;;;12,0;6,0;1,0;;;;2,0;2,0;24,0;;;;;;;;;;2,0;;;;;;;2,0;;;;;4,0;;2,0;29,0;;;;;;;;;;11,0;;6,0;;3,0;;;;;;3,0;7,0;;;;3,0;;;;5,0;;;;2,0;1,0;;59,0;1,0;;4,0;2,0;;;2,0;5,0;;;;;1,0;1,0;10,0;;;;;;;1,0;;;;3,0;;4,0;;6,0;;;;;;;1,0;;;;;;;;;;;;;;;;;;;;;;;;;1,0;;;;;4,0;;;8,0;;;;;;;;;;;;8,0;;;;;;;;;;;;;;;;;;;;;;;2,0;;;;1,0;19,0;;1,0;;;1,0;1,0;;;;2,0;;;;;;;;;;;7,0;;;;;;;;;;;2,0;;;;;;;;;;;;;;4,0;;;;;;;;;;;;;3,0;;;;;;;;3,0;;;;;;;;;;;;1,0;;;;;;;12,0;;;;7,0;;;;;;;;8,0;;;;;;;5,0;;48,0;;;;;;;;;;;;;;;;;;;;;;;1,0;;;8,0;;;1,0;;;;;;;;;;2,0;;;;;;;;1,0;;;;;;1,0;;;;;;;;;;;;;;;;;;;1,0;;;;;1,0;;;6,0;;;7,0;;;;;;;;;;;;;;;;;;;2,0;;;;;;;6,0;;;;;;;;;;;;1,0;;;;;;;;;;3,0;;;;;;;;;1,0;;;;1,0;3,0;;;;;;;;;1,0;13,0;;;;;;;;;;;2,0;;;;;;;;2,0;;;2,0;;;;2,0;;18,0;;;;;1,0;;;;;;;;;;7,0;;;8,0;4,0;2,0;;;;;;1,0;;;;;;;;;;;;;;;;;;;;;;;;;;;;;;;;;;;;;;;;;;;;;;;;;;;;;;;2,0;;;;;;;;;;;;;;;;;;;;;;;4,0;;;;;;;;;;;;;;1,0;;;;;;2,0;;;;;;;;;;;;;4,0;;;;;;;2,0;;;;;;;;;;;;;;;;;;;;;;;;;;;;;2,0;;;;;3,0;;;;;;;;;;;;;;;;;;;;;;;;;;;;;;;;;;;;;;;6,0;;;;;;;;;;;;;;;;;;;;;;;;;;;;;;;;;;;;;;;
tube;;3,0;;11,0;;9,0;1,0;67,0;;;25,0;;3,0;62,0;;;4,0;;14,0;;1,0;1,0;;;10,0;2,0;;3,0;3,0;;21,0;6,0;;;;;15,0;1,0;;;;47,0;11,0;1,0;4,0;34,0;;8,0;1,0;;4,0;3,0;42,0;12,0;2,0;;39,0;;;1,0;1,0;;;;31,0;;48,0;;;;25,0;30,0;24,0;;;;11,0;;;;19,0;;;1,0;29,0;4,0;;29,0;10,0;;19,0;4,0;8,0;2,0;;;;20,0;36,0;6,0;47,0;1,0;;3,0;1,0;2,0;;1,0;;;;6,0;9,0;;;;;9,0;;6,0;;;1,0;;;;105,0;;1,0;;4,0;;;29,0;;;10,0;;;;2,0;10,0;;;6,0;1,0;49,0;8,0;;63,0;1,0;20,0;84,0;5,0;;;6,0;;;;3,0;39,0;;;;;43,0;8,0;6,0;;2,0;;1,0;23,0;7,0;2,0;;9,0;;;;;1,0;1,0;6,0;;1,0;4,0;1,0;27,0;;1,0;5,0;10,0;42,0;8,0;16,0;;52,0;23,0;;;;;;1,0;12,0;;;48,0;4,0;10,0;2,0;2,0;;45,0;12,0;6,0;;3,0;;;;6,0;2,0;;123,0;;13,0;;3,0;;3,0;1,0;14,0;;1,0;;3,0;;;4,0;8,0;7,0;13,0;2,0;1,0;13,0;10,0;3,0;54,0;;;7,0;2,0;13,0;163,0;87,0;8,0;;3,0;;;1,0;19,0;;;;1,0;1,0;;17,0;;11,0;9,0;;7,0;4,0;2,0;2,0;;;35,0;;;2,0;;3,0;;;;;;5,0;2,0;93,0;;;3,0;12,0;13,0;9,0;3,0;1,0;;20,0;9,0;;4,0;34,0;;;13,0;;52,0;;10,0;13,0;3,0;2,0;;;4,0;;;;;3,0;3,0;;3,0;48,0;2,0;8,0;2,0;;;;;1,0;16,0;30,0;5,0;3,0;;3,0;;5,0;;2,0;;;;;1,0;;;31,0;;;;;;;;3,0;;;;;6,0;;5,0;8,0;1,0;1,0;;;;;55,0;9,0;;2,0;1,0;;;;;3,0;;;;1,0;;5,0;2,0;;;;;9,0;11,0;2,0;;5,0;;14,0;;6,0;;11,0;;5,0;;8,0;1,0;;;;;;;;1,0;39,0;3,0;1,0;2,0;;1,0;;1,0;;;3,0;;;;;;;1,0;3,0;;1,0;;;5,0;;;;;20,0;6,0;;;7,0;;4,0;;;;;;;;;;;;;1,0;;12,0;4,0;;;;3,0;;;;5,0;1,0;;;;;;;;;4,0;5,0;;;2,0;;2,0;;;;;;3,0;;;;;;;3,0;;;2,0;8,0;7,0;;1,0;7,0;3,0;;;;;;3,0;21,0;;11,0;;2,0;12,0;1,0;;;;3,0;;;;50,0;13,0;;;;;1,0;;;;;1,0;;;;;;;;;;16,0;;;;;;;;4,0;;;3,0;;;;2,0;;;;3,0;57,0;1,0;4,0;35,0;;;;;;;;;;;3,0;;;;;;2,0;;;;1,0;;;6,0;;;;2,0;;;;;2,0;;;;3,0;;;;;;;;;;;;;;2,0;4,0;;;3,0;;5,0;;;;28,0;;1,0;;;;;;1,0;;;;;5,0;;;;;1,0;;;2,0;;7,0;;;;;;;5,0;6,0;;;4,0;;5,0;;;;;9,0;;;21,0;;2,0;1,0;7,0;;1,0;;;3,0;;;64,0;;7,0;3,0;4,0;20,0;;;12,0;1,0;;6,0;1,0;;1,0;;;;;1,0;;;2,0;12,0;;;;;;;4,0;35,0;;1,0;6,0;20,0;;;;;35,0;;;28,0;;;;;;2,0;;;;2,0;;4,0;5,0;81,0;;;4,0;;;1,0;;16,0;;;;2,0;1,0;2,0;;;3,0;1,0;;1,0;;10,0;;2,0;;1,0;;;;;;;;;4,0;;;;;;;;;;;;;;;;;;;;;;;;;;;;;1,0;;;2,0;;;;;;;;10,0;;2,0;;;3,0;46,0;;;;;;;;;;;;;;;;;;;;1,0;1,0;;;;;;;;;;;;2,0;;;;6,0;1,0;;;;;;;;;;;;;;1,0;;;;;1,0;;;;;;;;1,0;;2,0;2,0;3,0;;3,0;1,0;;3,0;;;;;;;;;;;;;;;;;;;;;;;;;;;;;;;1,0;;;;;;;;;;;;;;1,0;;;;;;;;1,0;;;;1,0;;;;;;;1,0;;;;;;;2,0;;;;;2,0;;;;;;;;
turn;;1,0;;15,0;17,0;47,0;;15,0;;1,0;;3,0;5,0;52,0;;;14,0;;2,0;1,0;1,0;;3,0;2,0;1,0;;;16,0;2,0;6,0;78,0;17,0;;;1,0;11,0;5,0;;1,0;;45,0;151,0;;5,0;45,0;10,0;;25,0;;6,0;1,0;;;;12,0;9,0;12,0;;;9,0;;;;;78,0;;41,0;1,0;1,0;;1,0;78,0;134,0;;3,0;;1,0;3,0;;3,0;86,0;;54,0;;19,0;1,0;;12,0;1,0;3,0;2,0;1,0;1,0;1,0;3,0;5,0;29,0;8,0;38,0;28,0;70,0;16,0;2,0;2,0;17,0;2,0;;3,0;2,0;;;4,0;31,0;;;;1,0;2,0;;11,0;;;188,0;;;;44,0;;;1,0;47,0;;;68,0;;;15,0;1,0;2,0;;1,0;2,0;;;2,0;;2,0;;11,0;8,0;;11,0;4,0;;;16,0;2,0;;;;;11,0;;;10,0;;14,0;11,0;;9,0;3,0;;4,0;38,0;2,0;;1,0;8,0;;;6,0;;2,0;3,0;;;2,0;;9,0;3,0;;;1,0;4,0;4,0;3,0;20,0;;1,0;;;1,0;;9,0;10,0;4,0;54,0;;4,0;40,0;13,0;2,0;1,0;;;2,0;21,0;;;17,0;2,0;23,0;5,0;8,0;1,0;;16,0;;3,0;1,0;1,0;;;1,0;1,0;2,0;;;3,0;;2,0;8,0;;1,0;;11,0;8,0;6,0;25,0;13,0;9,0;;;2,0;4,0;11,0;6,0;19,0;;;21,0;17,0;;135,0;3,0;;40,0;;;1,0;;;1,0;8,0;;;6,0;14,0;1,0;;2,0;1,0;20,0;;;;;;21,0;2,0;2,0;;;;;;6,0;9,0;4,0;4,0;2,0;18,0;;2,0;;1,0;1,0;16,0;;19,0;2,0;;;9,0;32,0;1,0;4,0;2,0;8,0;8,0;37,0;24,0;1,0;;;;14,0;1,0;71,0;;;;;;6,0;1,0;2,0;;;3,0;7,0;6,0;1,0;1,0;1,0;3,0;;;;2,0;;1,0;;4,0;1,0;;;2,0;7,0;4,0;;2,0;;3,0;1,0;1,0;1,0;;;7,0;;3,0;5,0;18,0;16,0;1,0;;3,0;1,0;;87,0;9,0;3,0;;;31,0;9,0;3,0;;9,0;1,0;2,0;;;3,0;42,0;1,0;1,0;26,0;;;14,0;1,0;11,0;;2,0;;;;13,0;;3,0;;21,0;44,0;4,0;;;;1,0;;;;13,0;;30,0;1,0;20,0;3,0;;4,0;1,0;12,0;2,0;16,0;15,0;7,0;3,0;170,0;1,0;1,0;25,0;5,0;2,0;;10,0;;8,0;15,0;5,0;;14,0;35,0;4,0;;1,0;;;;4,0;;;;2,0;;;;4,0;4,0;;1,0;32,0;;1,0;2,0;;;;1,0;;;;;;;1,0;18,0;;1,0;;1,0;;;;;;9,0;;;1,0;;1,0;;;;1,0;;1,0;;;;;2,0;;;2,0;2,0;7,0;2,0;18,0;;;;2,0;;;1,0;4,0;1,0;;5,0;;;27,0;3,0;;12,0;;6,0;4,0;;;;17,0;;2,0;;;;2,0;1,0;3,0;;;25,0;7,0;;1,0;;;;7,0;;1,0;1,0;;2,0;;;;;3,0;;42,0;1,0;;1,0;;;;;;;;2,0;;4,0;2,0;1,0;;2,0;;;;3,0;;;1,0;;3,0;;;;7,0;13,0;;;4,0;1,0;2,0;;;;8,0;;;;;;;5,0;;7,0;16,0;;;;;;2,0;;;;3,0;;;3,0;;1,0;;1,0;;;2,0;2,0;;;;;;6,0;3,0;;;1,0;;;1,0;;;;2,0;;;27,0;;1,0;;;2,0;93,0;;;1,0;;;;10,0;3,0;;;;1,0;1,0;;5,0;;;;;8,0;;1,0;16,0;;7,0;1,0;;1,0;;;;;13,0;10,0;;3,0;;;;;;1,0;;8,0;5,0;;;5,0;;;;;3,0;2,0;4,0;;10,0;;1,0;3,0;4,0;;3,0;12,0;;;7,0;5,0;;;2,0;;8,0;1,0;;;;;;;;1,0;;;;;;;;;3,0;2,0;;;1,0;;;;;7,0;2,0;;;2,0;;;;;;7,0;;;3,0;7,0;;;;8,0;;7,0;;1,0;2,0;2,0;;21,0;4,0;9,0;11,0;;;3,0;2,0;8,0;;;;;;5,0;;;;34,0;;;1,0;1,0;;4,0;2,0;2,0;;;;;1,0;;;;61,0;;;;;2,0;1,0;;;;;1,0;;;;;1,0;;;;3,0;;;;;;13,0;;;;5,0;;;;;;;;4,0;1,0;;;;1,0;;;;;2,0;9,0;1,0;2,0;;;;;;;;;1,0;;;;;;;5,0;2,0;4,0;;;3,0;;30,0;1,0;;9,0;;;;;19,0;;1,0;;;;1,0;;1,0;4,0;;;;;1,0;29,0;;;;;1,0;;1,0;;;;5,0;;;;;;;;2,0;5,0;6,0;;;2,0;2,0;2,0;1,0;;;;;2,0;;;;;;;;;;1,0;;;;;;;;;;;;;7,0;;;;;;;;;;;;2,0;;;;
type;;22,0;;3,0;8,0;53,0;21,0;7,0;;10,0;;8,0;;59,0;1,0;;51,0;;9,0;16,0;13,0;;63,0;4,0;1,0;;;2,0;1,0;1,0;56,0;2,0;1,0;;;57,0;;;15,0;1,0;61,0;157,0;1,0;14,0;85,0;8,0;3,0;32,0;;30,0;;;17,0;1,0;16,0;7,0;124,0;;1,0;9,0;2,0;2,0;27,0;;165,0;1,0;137,0;1,0;1,0;;15,0;252,0;58,0;14,0;3,0;;12,0;2,0;19,0;38,0;93,0;;2,0;7,0;100,0;1,0;;39,0;;3,0;16,0;;5,0;3,0;2,0;;50,0;2,0;82,0;16,0;45,0;7,0;1,0;5,0;19,0;11,0;;;;;;9,0;394,0;4,0;;;5,0;4,0;48,0;49,0;;;37,0;4,0;24,0;9,0;39,0;;2,0;3,0;32,0;8,0;;40,0;;;20,0;;9,0;2,0;;10,0;3,0;2,0;6,0;8,0;58,0;65,0;48,0;4,0;;7,0;21,0;2,0;;24,0;;;2,0;;29,0;29,0;;1,0;3,0;;8,0;5,0;;5,0;1,0;2,0;;24,0;;16,0;2,0;2,0;1,0;;1,0;1,0;;21,0;;9,0;79,0;;8,0;4,0;3,0;4,0;;;1,0;2,0;1,0;8,0;;;;49,0;;1,0;7,0;7,0;6,0;;5,0;45,0;3,0;1,0;;;;2,0;11,0;3,0;2,0;;13,0;4,0;13,0;17,0;15,0;;43,0;;1,0;1,0;;6,0;3,0;3,0;3,0;;2,0;;;;;22,0;;;;80,0;1,0;6,0;38,0;13,0;4,0;;;3,0;78,0;6,0;5,0;19,0;7,0;;3,0;8,0;;18,0;;;;19,0;3,0;;;;22,0;;7,0;;6,0;3,0;1,0;2,0;;;4,0;;;;1,0;4,0;17,0;3,0;1,0;18,0;;;4,0;;3,0;;;;1,0;;;;;;4,0;7,0;;86,0;1,0;;;;;1,0;13,0;;;4,0;27,0;54,0;12,0;9,0;;;6,0;;12,0;;;;;;5,0;;8,0;;;;3,0;3,0;;2,0;;2,0;2,0;7,0;;;;;;;;;;2,0;7,0;;;;;;;;2,0;;;;;;;6,0;2,0;1,0;;1,0;;;26,0;1,0;;2,0;2,0;26,0;32,0;;;;;;3,0;3,0;;5,0;;32,0;24,0;;;10,0;;17,0;;18,0;;;26,0;1,0;;1,0;;7,0;63,0;5,0;;2,0;;1,0;;;2,0;5,0;2,0;28,0;;15,0;;;9,0;;5,0;;;;22,0;5,0;2,0;;;6,0;5,0;;;8,0;;;10,0;1,0;;6,0;;;3,0;2,0;;1,0;;5,0;10,0;11,0;2,0;3,0;;;;;3,0;;1,0;;14,0;15,0;;1,0;2,0;;4,0;;6,0;;1,0;12,0;;;16,0;;6,0;4,0;;1,0;;;1,0;;3,0;;;;;16,0;;4,0;;;15,0;;2,0;;;3,0;2,0;;1,0;4,0;;1,0;1,0;;6,0;3,0;;;;;2,0;;;;;39,0;;;;;7,0;3,0;;2,0;1,0;;;5,0;;6,0;;4,0;;1,0;;;2,0;;16,0;3,0;;8,0;;;;;1,0;1,0;;;4,0;4,0;2,0;2,0;;;1,0;;;;3,0;5,0;;1,0;4,0;4,0;;;6,0;;;;2,0;6,0;;;;21,0;;1,0;;;;;;;;36,0;;1,0;;1,0;;19,0;;;;1,0;;;;8,0;8,0;35,0;;;2,0;17,0;;;;;;;;;6,0;2,0;;;4,0;;4,0;;14,0;;;3,0;6,0;;13,0;2,0;8,0;;26,0;;17,0;;;;3,0;;10,0;2,0;10,0;;1,0;6,0;50,0;12,0;;;;;12,0;;;;;2,0;;;1,0;;;;;37,0;;;2,0;;4,0;1,0;;;3,0;;;26,0;;;5,0;;4,0;;;12,0;1,0;;3,0;;;;;;;9,0;;9,0;;4,0;28,0;1,0;;;2,0;;;;1,0;;;1,0;;;;;1,0;;;;8,0;;7,0;;;1,0;;1,0;3,0;;;4,0;;;;;2,0;;;2,0;;;;;;;;;4,0;;;;4,0;;5,0;;;;;;;2,0;6,0;;;;;;;2,0;7,0;24,0;7,0;;;;;419,0;22,0;;;2,0;;3,0;19,0;25,0;1,0;1,0;106,0;;;;;;2,0;2,0;;;292,0;;5,0;;;;1,0;;3,0;1,0;9,0;6,0;;;1,0;90,0;;;;;;;;1,0;;;;;;;;;;;;;1,0;;;;2,0;;;;;8,0;;;;2,0;;;;;;;;;3,0;;;10,0;;2,0;;;2,0;1,0;;;1,0;;8,0;;;;;;;;;;;;8,0;;;2,0;8,0;1,0;;2,0;;;2,0;2,0;;;;;;;;32,0;4,0;;;;;;;;;;;;;;;;;;;;2,0;2,0;;;;;;;;;;;;;;;;;;;1,0;1,0;;;;;;;;;;2,0;;;;;;;;;;;;;;;;;;;1,0;22,0;;;1,0;;2,0;;;
update;;1,0;1,0;8,0;1,0;13,0;;;4,0;;;;;142,0;;;18,0;;9,0;1,0;;;20,0;1,0;4,0;1,0;7,0;;44,0;6,0;41,0;17,0;1,0;116,0;;68,0;2,0;2,0;74,0;;97,0;54,0;;15,0;61,0;;1,0;3,0;;12,0;37,0;;;;18,0;1,0;;;21,0;61,0;;;1,0;3,0;274,0;;35,0;;8,0;;;2,0;12,0;;6,0;;;37,0;1,0;4,0;103,0;;6,0;73,0;15,0;1,0;;;;4,0;62,0;;;;9,0;;84,0;1,0;28,0;59,0;27,0;11,0;;14,0;21,0;33,0;7,0;14,0;;;;17,0;39,0;;;5,0;;;22,0;36,0;3,0;;17,0;3,0;;28,0;79,0;;2,0;;79,0;;;14,0;3,0;;17,0;15,0;8,0;;;;;;;22,0;4,0;3,0;10,0;2,0;;34,0;1,0;;;;;;;;;1,0;4,0;1,0;;2,0;;;;1,0;;;5,0;22,0;1,0;7,0;;;2,0;;2,0;;;;;6,0;1,0;;25,0;;;;;;;;1,0;;1,0;;;;1,0;;4,0;8,0;3,0;;;;1,0;;23,0;;;1,0;4,0;;;14,0;3,0;5,0;;;;;13,0;;;4,0;;;14,0;;;1,0;12,0;;;4,0;;;;;;29,0;;;;1,0;;;;;;;;9,0;;;1,0;9,0;;4,0;;;;;8,0;1,0;;;;;;;;39,0;;;;;;;3,0;;;2,0;1,0;;;9,0;;;;;31,0;;;;;;;2,0;;;;;3,0;2,0;;;;;;;8,0;1,0;;;12,0;33,0;;;;1,0;;;1,0;;;;;;4,0;;;;;;1,0;2,0;1,0;;2,0;;3,0;12,0;;;;;2,0;;28,0;;1,0;;52,0;1,0;6,0;;;10,0;;7,0;6,0;5,0;;;;;35,0;1,0;20,0;2,0;1,0;31,0;14,0;;45,0;31,0;23,0;4,0;7,0;10,0;11,0;6,0;1,0;8,0;;12,0;4,0;5,0;;36,0;;6,0;12,0;;;7,0;;3,0;2,0;47,0;3,0;;8,0;;;3,0;2,0;3,0;15,0;12,0;;1,0;;;;47,0;2,0;1,0;3,0;54,0;11,0;17,0;5,0;2,0;1,0;;44,0;;4,0;;4,0;5,0;;;24,0;5,0;15,0;;9,0;12,0;;;25,0;3,0;;;2,0;;;;;42,0;;2,0;27,0;;;18,0;;4,0;3,0;1,0;;;;3,0;13,0;19,0;;12,0;;;8,0;;;;;1,0;6,0;;16,0;1,0;1,0;24,0;;;;7,0;2,0;;5,0;;2,0;21,0;;15,0;;14,0;1,0;;;1,0;3,0;;;18,0;;;;;;1,0;;;1,0;;;;;;;;;;;6,0;;;2,0;;3,0;3,0;;7,0;55,0;1,0;;;8,0;9,0;;;;12,0;;;2,0;11,0;;3,0;;3,0;;32,0;;;14,0;3,0;;1,0;10,0;;4,0;3,0;2,0;;;;;16,0;;6,0;;;;;;;1,0;;;4,0;3,0;5,0;;15,0;17,0;;;;2,0;1,0;7,0;1,0;2,0;3,0;;13,0;;3,0;;;;;;;10,0;;2,0;;;2,0;;;;;;10,0;3,0;12,0;;1,0;10,0;;16,0;;;2,0;;;;;;;;2,0;;2,0;;;1,0;;4,0;;;1,0;;2,0;1,0;3,0;28,0;;13,0;2,0;;8,0;1,0;3,0;1,0;;;;;1,0;10,0;;1,0;5,0;4,0;;;14,0;37,0;10,0;;;;;2,0;;4,0;;;;;;12,0;;;;38,0;;;;;;1,0;;1,0;;;;;;;;;5,0;;2,0;;;;;;;;7,0;1,0;;;;;;;;;;9,0;2,0;;;1,0;;2,0;;;;;;9,0;;;;;;;;;;;;;;;;;;;;;;;;3,0;;4,0;;;;;;;1,0;1,0;;;;;;;;;;;;3,0;;;;;;;;;;;4,0;;2,0;;8,0;3,0;5,0;;;;;;;;;1,0;2,0;;2,0;8,0;;2,0;;;9,0;2,0;;;;4,0;;;4,0;;;;;;;1,0;;;;1,0;;3,0;;3,0;2,0;5,0;;20,0;;5,0;;;;5,0;;;;;;;1,0;;2,0;;1,0;1,0;1,0;5,0;;;1,0;3,0;;;;;;;5,0;;3,0;;;;;2,0;1,0;;2,0;;4,0;3,0;;;2,0;;;;;;;;;;1,0;;;;;;;2,0;;;;;;;2,0;;2,0;;;;;;;1,0;;;;;;;;;;;;;;;;2,0;;6,0;;;;;;;;;18,0;;;;;1,0;;;;;;;;;;;;;;;;;;6,0;;;;10,0;;;;;;;;;;;
upper;;2,0;;13,0;2,0;61,0;13,0;76,0;;;6,0;4,0;50,0;331,0;;1,0;22,0;;4,0;;;2,0;14,0;;;;2,0;118,0;;;83,0;1,0;;;;5,0;57,0;2,0;11,0;;4,0;107,0;37,0;1,0;18,0;293,0;;31,0;;;;;116,0;7,0;5,0;1,0;179,0;;;4,0;3,0;;12,0;;114,0;;168,0;2,0;;46,0;17,0;329,0;43,0;;;;49,0;;;29,0;21,0;;;4,0;115,0;13,0;;30,0;;;;9,0;33,0;5,0;3,0;;45,0;54,0;63,0;32,0;142,0;11,0;;1,0;14,0;4,0;;;;;;17,0;112,0;5,0;;1,0;;6,0;4,0;141,0;;2,0;9,0;4,0;;6,0;52,0;;5,0;3,0;17,0;3,0;;121,0;;;27,0;;12,0;;4,0;28,0;5,0;;84,0;4,0;89,0;80,0;8,0;66,0;;40,0;94,0;106,0;3,0;;15,0;9,0;;2,0;11,0;160,0;;;;;225,0;195,0;;;14,0;;;72,0;;85,0;2,0;2,0;1,0;;;2,0;13,0;119,0;3,0;52,0;35,0;7,0;64,0;35,0;;;14,0;23,0;142,0;72,0;238,0;11,0;62,0;18,0;21,0;27,0;67,0;;2,0;;629,0;13,0;5,0;261,0;13,0;10,0;2,0;;;55,0;2,0;32,0;;2,0;23,0;;6,0;3,0;169,0;5,0;781,0;2,0;8,0;;56,0;;30,0;3,0;11,0;3,0;;4,0;1,0;;2,0;19,0;33,0;10,0;22,0;9,0;9,0;52,0;368,0;7,0;10,0;10,0;2,0;28,0;141,0;3,0;129,0;1376,0;;;1,0;2,0;2,0;12,0;72,0;;;13,0;;22,0;6,0;9,0;65,0;10,0;1,0;;11,0;14,0;37,0;;6,0;2,0;46,0;112,0;;6,0;16,0;66,0;97,0;1,0;71,0;1,0;4,0;5,0;7,0;10,0;25,0;1,0;246,0;18,0;4,0;11,0;13,0;1,0;1,0;36,0;17,0;5,0;30,0;19,0;12,0;3,0;6,0;;43,0;9,0;31,0;5,0;1,0;8,0;6,0;14,0;30,0;21,0;5,0;12,0;;14,0;28,0;18,0;58,0;2,0;18,0;66,0;4,0;7,0;1,0;2,0;;;26,0;10,0;2,0;14,0;4,0;11,0;10,0;45,0;;107,0;3,0;11,0;;;5,0;31,0;2,0;;11,0;2,0;3,0;;;;;3,0;;;1,0;2,0;1,0;13,0;13,0;12,0;3,0;;3,0;;;;4,0;4,0;;4,0;;7,0;;5,0;;;5,0;;;6,0;1,0;;5,0;;;;;1,0;;26,0;2,0;7,0;;12,0;2,0;9,0;2,0;36,0;;3,0;;;1,0;;;;;12,0;;;;26,0;;;18,0;2,0;11,0;;7,0;;2,0;9,0;6,0;;3,0;;1,0;48,0;97,0;10,0;;4,0;;;7,0;;;4,0;;4,0;14,0;;;;5,0;2,0;2,0;1,0;;1,0;;;;;;;;;;9,0;4,0;3,0;10,0;6,0;;;112,0;;26,0;3,0;1,0;19,0;5,0;;7,0;;;;;10,0;;1,0;9,0;;;1,0;;1,0;8,0;3,0;;20,0;1,0;;;;;2,0;;;2,0;;;27,0;3,0;6,0;31,0;9,0;1,0;28,0;;;1,0;;1,0;;4,0;;5,0;44,0;10,0;;;;;1,0;;;2,0;92,0;;;;;;;1,0;2,0;1,0;;;;;2,0;1,0;;;;5,0;5,0;;;;3,0;;;;1,0;;17,0;2,0;1,0;;;4,0;7,0;;1,0;7,0;8,0;4,0;22,0;71,0;;;1,0;;;;25,0;;;;11,0;;1,0;;;;3,0;5,0;;;1,0;;2,0;;;;17,0;;1,0;10,0;;;;1,0;;1,0;1,0;1,0;;3,0;2,0;;;;;;;;;4,0;2,0;37,0;2,0;1,0;;10,0;2,0;6,0;3,0;;12,0;;;;;;;4,0;;;;;;;;;;;6,0;;2,0;1,0;;1,0;;5,0;;;;;1,0;1,0;;;;;;;;;13,0;20,0;;;12,0;;;;58,0;2,0;17,0;;2,0;;2,0;18,0;4,0;22,0;1,0;8,0;1,0;;1,0;2,0;;12,0;;;1,0;;23,0;;17,0;;14,0;4,0;;;4,0;9,0;;;;;3,0;1,0;;9,0;;8,0;11,0;14,0;25,0;;4,0;2,0;55,0;1,0;3,0;;9,0;2,0;1,0;4,0;105,0;1,0;;;8,0;;2,0;17,0;;3,0;8,0;8,0;9,0;1,0;;;1,0;;22,0;1,0;2,0;4,0;;;;6,0;1,0;29,0;31,0;3,0;;21,0;;8,0;;2,0;39,0;;15,0;;;;;20,0;;2,0;9,0;;;;9,0;73,0;21,0;2,0;;;;2,0;;;1,0;;;;6,0;14,0;;;;1,0;;;;10,0;;1,0;2,0;7,0;9,0;;3,0;;;;;2,0;;;;17,0;2,0;2,0;;;;;;;;8,0;;;;;;;5,0;;;;1,0;;;;;1,0;2,0;1,0;;;;;2,0;;;;;;;3,0;3,0;;;;;;;;2,0;;;;;;;;;4,0;;;2,0;;;;;27,0;;5,0;;;;;;3,0;;;;;1,0;;2,0;1,0;;;;;;;2,0;;;1,0;18,0;;3,0;26,0;;;3,0;7,0;;;1,0;;1,0;5,0;10,0;7,0;;;27,0;;3,0;;26,0;;;;;1,0;;;10,0;;3,0;;;3,0;;;18,0;1,0;;88,0;;;;4,0;;4,0;;;;;;;;;;;3,0;;3,0;;;;;;
user;;22,0;2,0;71,0;20,0;254,0;20,0;105,0;4,0;13,0;;15,0;2,0;737,0;1,0;;596,0;;16,0;8,0;;1,0;22,0;38,0;89,0;3,0;;58,0;84,0;31,0;464,0;83,0;8,0;4,0;1,0;450,0;82,0;5,0;22,0;20,0;749,0;1963,0;;120,0;1233,0;26,0;;88,0;8,0;9,0;17,0;;42,0;32,0;83,0;46,0;56,0;;8,0;143,0;4,0;;27,0;5,0;1741,0;12,0;469,0;4,0;5,0;;16,0;68,0;71,0;;1,0;;14,0;21,0;44,0;53,0;737,0;;142,0;54,0;152,0;5,0;2,0;87,0;2,0;28,0;38,0;27,0;37,0;12,0;31,0;1,0;22,0;97,0;226,0;96,0;588,0;63,0;;46,0;131,0;218,0;20,0;46,0;2,0;33,0;;19,0;103,0;20,0;13,0;30,0;5,0;43,0;88,0;193,0;27,0;2,0;163,0;34,0;;132,0;589,0;1,0;7,0;;149,0;71,0;;186,0;;1,0;342,0;87,0;69,0;;;7,0;3,0;;10,0;22,0;150,0;53,0;408,0;12,0;1,0;15,0;136,0;6,0;9,0;4,0;;;1,0;2,0;;68,0;42,0;3,0;;2,0;65,0;13,0;3,0;56,0;6,0;;74,0;233,0;;15,0;;10,0;143,0;;;2,0;10,0;187,0;1,0;7,0;8,0;24,0;59,0;61,0;;150,0;;34,0;5,0;6,0;161,0;11,0;3,0;4,0;3,0;24,0;7,0;4,0;13,0;44,0;31,0;;8,0;168,0;170,0;149,0;14,0;;;18,0;65,0;5,0;7,0;41,0;90,0;20,0;35,0;;16,0;7,0;291,0;13,0;8,0;9,0;6,0;7,0;130,0;4,0;24,0;68,0;14,0;9,0;;72,0;;1,0;;;;405,0;11,0;46,0;87,0;38,0;2,0;;4,0;70,0;;5,0;48,0;70,0;21,0;;5,0;116,0;10,0;197,0;12,0;8,0;;;4,0;49,0;;11,0;5,0;23,0;6,0;;216,0;94,0;7,0;3,0;9,0;6,0;17,0;9,0;9,0;;;25,0;15,0;1,0;;36,0;;10,0;1,0;;146,0;9,0;2,0;22,0;5,0;;8,0;2,0;5,0;;38,0;246,0;12,0;88,0;1,0;3,0;14,0;;40,0;1,0;70,0;36,0;5,0;24,0;445,0;334,0;4,0;30,0;18,0;1,0;;5,0;31,0;14,0;2,0;8,0;;14,0;72,0;1,0;14,0;;18,0;;58,0;9,0;1,0;1,0;13,0;24,0;28,0;60,0;;1,0;;3,0;26,0;;88,0;5,0;15,0;7,0;369,0;69,0;38,0;12,0;3,0;88,0;76,0;18,0;64,0;1,0;;5,0;;1,0;68,0;43,0;110,0;15,0;14,0;145,0;51,0;16,0;451,0;146,0;2,0;22,0;64,0;385,0;35,0;36,0;14,0;94,0;2,0;44,0;35,0;113,0;22,0;114,0;;282,0;227,0;41,0;3,0;1353,0;13,0;52,0;;324,0;54,0;69,0;116,0;8,0;;23,0;17,0;115,0;371,0;162,0;2,0;;20,0;5,0;;19,0;14,0;14,0;9,0;738,0;142,0;395,0;96,0;;23,0;29,0;108,0;26,0;28,0;;33,0;47,0;60,0;9,0;1,0;217,0;34,0;26,0;;46,0;;11,0;;1,0;35,0;1,0;61,0;11,0;20,0;5,0;2,0;29,0;2,0;43,0;230,0;12,0;6,0;32,0;1,0;10,0;8,0;18,0;72,0;73,0;159,0;43,0;131,0;1418,0;1,0;5,0;1,0;6,0;1,0;4,0;2,0;6,0;37,0;50,0;25,0;6,0;157,0;79,0;73,0;43,0;2,0;5,0;25,0;11,0;6,0;5,0;252,0;15,0;7,0;5,0;;79,0;;198,0;14,0;9,0;35,0;107,0;37,0;39,0;29,0;10,0;72,0;2,0;2,0;9,0;;25,0;;;24,0;11,0;;6,0;4,0;11,0;6,0;6,0;1,0;1,0;3,0;293,0;38,0;69,0;26,0;5,0;5,0;35,0;14,0;67,0;;4,0;12,0;30,0;8,0;86,0;1,0;3,0;;40,0;;;18,0;37,0;104,0;234,0;1,0;;24,0;7,0;4,0;91,0;18,0;;25,0;4,0;87,0;60,0;73,0;13,0;41,0;23,0;3,0;3,0;43,0;13,0;;17,0;;3,0;1,0;4,0;1,0;6,0;22,0;2,0;3,0;111,0;27,0;5,0;39,0;21,0;5,0;15,0;5,0;34,0;3,0;65,0;90,0;62,0;7,0;12,0;22,0;166,0;14,0;13,0;114,0;12,0;1,0;;4,0;4,0;34,0;3,0;11,0;;52,0;72,0;65,0;1,0;51,0;36,0;2,0;90,0;20,0;;2,0;1,0;16,0;10,0;16,0;15,0;19,0;74,0;;;3,0;21,0;4,0;1,0;21,0;20,0;4,0;10,0;2,0;14,0;1,0;10,0;8,0;41,0;;10,0;82,0;1,0;12,0;20,0;42,0;20,0;1,0;;1,0;72,0;50,0;17,0;26,0;;6,0;;;23,0;45,0;30,0;3,0;37,0;5,0;19,0;9,0;1,0;59,0;1,0;2,0;11,0;8,0;2,0;13,0;55,0;16,0;;4,0;17,0;7,0;3,0;;11,0;;47,0;15,0;4,0;;2,0;3,0;4,0;;3,0;7,0;3,0;33,0;5,0;5,0;17,0;9,0;1,0;;2,0;48,0;8,0;;22,0;1,0;4,0;68,0;1,0;;46,0;15,0;22,0;11,0;2,0;2,0;27,0;2,0;21,0;;24,0;203,0;7,0;1,0;;7,0;6,0;97,0;8,0;1,0;3,0;2,0;4,0;74,0;38,0;10,0;3,0;;;5,0;;;;17,0;;;4,0;12,0;3,0;21,0;;;1,0;;;2,0;;33,0;12,0;11,0;2,0;;;5,0;;;;;2,0;95,0;30,0;3,0;11,0;18,0;7,0;;;;;2,0;;;;11,0;2,0;32,0;;1,0;;;19,0;;;;1,0;40,0;4,0;;1,0;;;;6,0;;5,0;7,0;;;5,0;8,0;;;10,0;;9,0;;;3,0;;8,0;;3,0;3,0;;5,0;;;;;;3,0;;3,0;;9,0;6,0;1,0;7,0;13,0;;4,0;13,0;;33,0;16,0;6,0;58,0;4,0;10,0;;18,0;;;6,0;7,0;;;2,0;25,0;;15,0;2,0;;7,0;5,0;;;3,0;4,0;47,0;11,0;;1,0;;26,0;1,0;;3,0;4,0;3,0;5,0;5,0;17,0;22,0;5,0;20,0;22,0;14,0;8,0;55,0;1,0;11,0;7,0;;;5,0;;1,0;14,0;;;3,0;30,0;5,0;6,0;1,0;;;11,0;;;6,0;21,0;;;1,0;2,0;3,0;1,0;;8,0;;2,0;;;1,0;;4,0;;12,0;;;;5,0;;;15,0;11,0;;21,0;;26,0;6,0;1,0;;3,0;2,0;;2,0;;;;;6,0;;37,0;1,0;14,0;3,0;5,0;6,0;5,0;;1,0;2,0;;;4,0;1,0;;11,0;38,0;57,0;;2,0;6,0;;8,0;;7,0;;4,0;;;1,0;;
variable;;1,0;;15,0;6,0;15,0;2,0;27,0;;7,0;;;;17,0;;;17,0;;2,0;;;5,0;2,0;;;;;4,0;4,0;1,0;29,0;11,0;;;;2,0;13,0;;4,0;;12,0;36,0;3,0;8,0;17,0;2,0;2,0;11,0;5,0;3,0;;;4,0;;20,0;50,0;17,0;;8,0;3,0;;;4,0;;58,0;;47,0;6,0;2,0;;23,0;183,0;67,0;;53,0;3,0;;12,0;1,0;;28,0;;29,0;2,0;18,0;;;54,0;;;4,0;;;;2,0;;18,0;1,0;79,0;;73,0;11,0;1,0;;9,0;6,0;4,0;3,0;;;;;3,0;;;;4,0;1,0;;37,0;3,0;;24,0;10,0;;2,0;61,0;10,0;;1,0;2,0;2,0;;8,0;2,0;;13,0;;1,0;;;;;6,0;40,0;17,0;5,0;9,0;4,0;;;7,0;15,0;2,0;;;;3,0;;;5,0;7,0;;2,0;;;2,0;;3,0;;1,0;;;9,0;1,0;;2,0;4,0;1,0;2,0;;1,0;1,0;3,0;;;22,0;;11,0;9,0;;;;;1,0;;1,0;10,0;;;;6,0;;;7,0;;12,0;;60,0;6,0;4,0;5,0;6,0;;;1,0;21,0;4,0;;9,0;1,0;2,0;;;1,0;;2,0;;;1,0;;;57,0;2,0;3,0;;13,0;6,0;;13,0;;;2,0;;;2,0;;1,0;1,0;1,0;;;8,0;;;2,0;3,0;17,0;2,0;;;11,0;1,0;4,0;;;;30,0;2,0;;;1,0;11,0;;;2,0;3,0;6,0;;;;1,0;2,0;1,0;;;;4,0;13,0;2,0;11,0;9,0;;;;;93,0;1,0;;1,0;;;;;;;2,0;;1,0;7,0;;;2,0;;;;11,0;;1,0;2,0;3,0;11,0;3,0;;;;1,0;;17,0;;;2,0;;;1,0;1,0;;;;2,0;;1,0;;;;;1,0;4,0;;;;;;;2,0;;;3,0;12,0;1,0;;;;;;1,0;;2,0;;;;;12,0;5,0;4,0;;;;3,0;3,0;40,0;1,0;5,0;;;1,0;;21,0;;;;1,0;1,0;29,0;;22,0;;13,0;2,0;;;6,0;1,0;13,0;7,0;3,0;;1,0;7,0;1,0;;15,0;;2,0;3,0;7,0;;2,0;;;;62,0;;;1,0;5,0;;2,0;8,0;;18,0;;9,0;1,0;;5,0;2,0;2,0;25,0;;1,0;;12,0;1,0;;;2,0;;4,0;3,0;;20,0;;1,0;;;;1,0;;9,0;1,0;1,0;;;;47,0;;;1,0;;1,0;1,0;1,0;;;;1,0;;1,0;;5,0;;;1,0;;;14,0;;1,0;;;;;;;;;;;;;;1,0;;2,0;;2,0;;;;;2,0;1,0;;;2,0;;3,0;;;1,0;;;1,0;;;;;;;;;;18,0;;;;;;;;2,0;;2,0;;;;;;;;;;;;;;;;;;;1,0;;;;1,0;;;;;;;;;;4,0;;;;4,0;;7,0;;;;1,0;;;1,0;;;1,0;;;;;4,0;;;;;;;;1,0;1,0;2,0;16,0;;;;;;4,0;;4,0;;;;1,0;;6,0;;;;;;;;;;;;;;;;;6,0;;3,0;;;2,0;;;1,0;;;;;;;;;;;1,0;1,0;;;;;3,0;;;;;;28,0;;;;;;2,0;1,0;1,0;;;;;8,0;;;;;;;;;;;;1,0;7,0;2,0;;;;2,0;1,0;;4,0;;;;;2,0;;;;;;7,0;;2,0;;;3,0;;;;;;;;1,0;;;;;9,0;2,0;;;;2,0;;20,0;;;;;;;1,0;;;1,0;;;;;3,0;;2,0;;;;;;;;;;;;;1,0;;;1,0;;;2,0;;;;;;;;5,0;1,0;;;;;4,0;;2,0;18,0;;;;2,0;;;;;6,0;1,0;;;;1,0;;2,0;3,0;;;;;;3,0;;3,0;;;;1,0;;2,0;;;;3,0;;;;;;;2,0;8,0;1,0;;;;;1,0;;;;;;;;;;2,0;;;;8,0;;3,0;;;;;;;4,0;2,0;;2,0;;;;;1,0;1,0;1,0;;;2,0;;;;;;;;;;;;;;;;;;;;;2,0;;;7,0;;;;;;2,0;1,0;;;;;;;;;;;;;;;;;;;3,0;1,0;;;;2,0;;;;;;;;;1,0;;;;;1,0;;3,0;;4,0;2,0;2,0;;;;;;;;9,0;;;;;;;;;;;;;;;;;;;;;;;;;;4,0;;;;;;4,0;;;1,0;;;
vehicle;;39,0;;38,0;23,0;183,0;14,0;233,0;5,0;59,0;;;4,0;447,0;;23,0;519,0;;30,0;139,0;4,0;;58,0;32,0;162,0;4,0;15,0;85,0;37,0;68,0;500,0;170,0;34,0;10,0;1,0;586,0;69,0;21,0;;6,0;557,0;621,0;1,0;30,0;513,0;371,0;18,0;99,0;;4,0;84,0;14,0;43,0;73,0;332,0;;29,0;;6,0;124,0;13,0;;29,0;;1460,0;9,0;556,0;14,0;;54,0;21,0;155,0;180,0;5,0;4,0;1,0;8,0;52,0;3,0;26,0;866,0;;30,0;48,0;282,0;18,0;1,0;42,0;7,0;18,0;85,0;17,0;38,0;34,0;38,0;4,0;19,0;15,0;288,0;125,0;687,0;131,0;6,0;71,0;99,0;262,0;5,0;25,0;1,0;;;116,0;151,0;9,0;10,0;8,0;4,0;68,0;26,0;361,0;20,0;;259,0;45,0;;41,0;2047,0;;2,0;;164,0;9,0;1,0;247,0;;135,0;696,0;6,0;1,0;4,0;1,0;52,0;302,0;;22,0;21,0;260,0;40,0;114,0;207,0;4,0;9,0;269,0;5,0;;14,0;11,0;8,0;;;11,0;143,0;11,0;2,0;1,0;;122,0;87,0;6,0;112,0;9,0;1,0;45,0;219,0;;18,0;12,0;17,0;23,0;2,0;1,0;910,0;16,0;63,0;4,0;2,0;15,0;9,0;82,0;341,0;;3,0;4,0;5,0;11,0;12,0;214,0;1,0;17,0;2,0;;16,0;14,0;26,0;55,0;22,0;41,0;1,0;167,0;589,0;68,0;142,0;14,0;;1,0;48,0;62,0;18,0;7,0;115,0;19,0;38,0;28,0;;72,0;38,0;574,0;5,0;13,0;22,0;9,0;4,0;41,0;10,0;377,0;36,0;11,0;6,0;13,0;28,0;12,0;1,0;1,0;3,0;4,0;78,0;19,0;40,0;390,0;2,0;12,0;;;93,0;2,0;21,0;47,0;223,0;67,0;;12,0;85,0;18,0;;22,0;17,0;1,0;3,0;11,0;86,0;338,0;56,0;10,0;35,0;10,0;3,0;7,0;201,0;3,0;42,0;79,0;;57,0;54,0;63,0;2,0;26,0;28,0;70,0;;10,0;4,0;;2,0;18,0;2,0;273,0;309,0;2,0;8,0;12,0;2,0;2,0;20,0;13,0;1,0;7,0;44,0;38,0;106,0;1,0;1,0;56,0;6,0;63,0;;194,0;6,0;9,0;13,0;54,0;483,0;15,0;15,0;10,0;47,0;;2,0;59,0;10,0;4,0;;28,0;1,0;44,0;6,0;8,0;;1,0;2,0;32,0;30,0;12,0;1,0;45,0;29,0;15,0;48,0;2,0;6,0;2,0;1,0;7,0;;106,0;1,0;135,0;12,0;406,0;24,0;7,0;30,0;9,0;36,0;17,0;6,0;43,0;8,0;106,0;16,0;1,0;45,0;60,0;30,0;127,0;8,0;13,0;8,0;44,0;23,0;574,0;195,0;16,0;14,0;7,0;428,0;33,0;13,0;81,0;54,0;11,0;32,0;21,0;;186,0;32,0;1,0;97,0;71,0;34,0;;55,0;22,0;16,0;2,0;394,0;16,0;145,0;96,0;486,0;3,0;138,0;17,0;147,0;91,0;94,0;;47,0;2,0;18,0;;14,0;6,0;23,0;9,0;374,0;102,0;153,0;56,0;26,0;62,0;3,0;51,0;2,0;275,0;134,0;16,0;88,0;40,0;2,0;26,0;5,0;47,0;6,0;13,0;19,0;5,0;322,0;197,0;14,0;26,0;;70,0;3,0;;11,0;9,0;149,0;4,0;6,0;42,0;18,0;7,0;9,0;;2,0;41,0;;3,0;3,0;41,0;70,0;49,0;66,0;108,0;;8,0;23,0;7,0;2,0;;11,0;1,0;27,0;32,0;5,0;199,0;6,0;5,0;47,0;20,0;43,0;10,0;19,0;36,0;1,0;12,0;34,0;4,0;1,0;;33,0;4,0;2,0;11,0;7,0;512,0;1,0;;4,0;20,0;7,0;1,0;1,0;2,0;15,0;108,0;40,0;33,0;3,0;39,0;62,0;;5,0;2,0;;1,0;1,0;8,0;;30,0;2,0;1,0;52,0;27,0;93,0;5,0;3,0;14,0;13,0;1,0;2,0;10,0;32,0;33,0;3,0;;16,0;10,0;;120,0;;39,0;5,0;25,0;22,0;;;;;19,0;22,0;2,0;13,0;4,0;;33,0;;8,0;17,0;1,0;10,0;5,0;15,0;20,0;14,0;10,0;19,0;2,0;21,0;2,0;7,0;37,0;11,0;14,0;;;29,0;17,0;4,0;11,0;13,0;2,0;1,0;48,0;;22,0;26,0;102,0;27,0;2,0;;1,0;104,0;8,0;29,0;;8,0;;50,0;7,0;11,0;11,0;45,0;6,0;2,0;6,0;29,0;18,0;57,0;10,0;;1,0;52,0;;1,0;8,0;1,0;;5,0;;8,0;2,0;64,0;3,0;;81,0;8,0;19,0;12,0;;3,0;2,0;7,0;20,0;24,0;2,0;1,0;3,0;16,0;;4,0;2,0;3,0;23,0;10,0;4,0;3,0;;9,0;;10,0;14,0;2,0;4,0;1,0;;3,0;;10,0;48,0;11,0;48,0;50,0;7,0;;15,0;2,0;192,0;1,0;;2,0;24,0;32,0;36,0;19,0;8,0;;1,0;2,0;1,0;137,0;1,0;29,0;9,0;14,0;5,0;20,0;7,0;6,0;4,0;;1,0;55,0;130,0;14,0;4,0;337,0;;;;1,0;7,0;;2,0;14,0;;79,0;;;11,0;2,0;3,0;19,0;6,0;15,0;4,0;;5,0;;83,0;6,0;4,0;15,0;179,0;6,0;;13,0;23,0;;36,0;12,0;34,0;1,0;;4,0;;20,0;2,0;;;;5,0;3,0;2,0;8,0;27,0;;;;;1,0;;1,0;17,0;41,0;10,0;;;3,0;52,0;9,0;28,0;;10,0;8,0;;;28,0;3,0;;2,0;;16,0;7,0;30,0;2,0;8,0;;;;;29,0;1,0;;3,0;1,0;;98,0;;6,0;;;33,0;;;;;24,0;3,0;1,0;3,0;;;;4,0;1,0;;32,0;;;43,0;46,0;;6,0;5,0;;6,0;;7,0;38,0;;10,0;;;16,0;;9,0;9,0;;9,0;5,0;145,0;;;1,0;1,0;12,0;1,0;18,0;27,0;45,0;6,0;10,0;5,0;5,0;11,0;;1,0;1,0;3,0;14,0;4,0;;32,0;;5,0;;1,0;39,0;9,0;129,0;1,0;;47,0;7,0;;4,0;1,0;3,0;62,0;2,0;34,0;8,0;;41,0;;2,0;4,0;9,0;;3,0;7,0;16,0;1,0;;2,0;7,0;55,0;;11,0;9,0;;;2,0;15,0;1,0;1,0;15,0;2,0;5,0;27,0;;8,0;9,0;16,0;1,0;23,0;27,0;;2,0;;2,0;1,0;;59,0;1,0;5,0;2,0;1,0;;11,0;1,0;;6,0;;;1,0;;71,0;24,0;5,0;2,0;1,0;;;;;;6,0;2,0;;46,0;;5,0;1,0;5,0;;15,0;1,0;;3,0;;;;;1,0;6,0;2,0;162,0;23,0;6,0;;;;7,0;;;;;;1,0;;8,0;10,0;;;;5,0;;;;;;;;;;;
video;;32,0;3,0;164,0;24,0;399,0;86,0;77,0;20,0;7,0;;9,0;7,0;624,0;2,0;13,0;2308,0;4,0;32,0;39,0;27,0;;99,0;60,0;179,0;14,0;9,0;114,0;157,0;27,0;870,0;64,0;64,0;28,0;;2826,0;62,0;23,0;136,0;11,0;708,0;1560,0;3,0;713,0;1379,0;48,0;69,0;30,0;4,0;10,0;49,0;2,0;13,0;29,0;237,0;11,0;80,0;;41,0;658,0;16,0;3,0;41,0;9,0;3064,0;17,0;786,0;26,0;52,0;;43,0;263,0;92,0;;17,0;1,0;2,0;30,0;35,0;187,0;1152,0;;322,0;47,0;323,0;10,0;6,0;64,0;19,0;22,0;186,0;7,0;21,0;21,0;54,0;6,0;300,0;14,0;767,0;212,0;426,0;159,0;1,0;211,0;610,0;421,0;11,0;73,0;53,0;;5,0;174,0;185,0;18,0;15,0;25,0;252,0;101,0;278,0;369,0;306,0;;1684,0;57,0;;365,0;1530,0;;7,0;;377,0;29,0;;276,0;9,0;4,0;632,0;86,0;90,0;;1,0;27,0;7,0;;13,0;68,0;127,0;28,0;302,0;28,0;2,0;100,0;143,0;21,0;26,0;2,0;;;;3,0;;146,0;321,0;115,0;8,0;1,0;100,0;33,0;2,0;118,0;13,0;1,0;97,0;132,0;3,0;14,0;28,0;2,0;85,0;44,0;2,0;80,0;8,0;123,0;;24,0;45,0;7,0;2177,0;51,0;4,0;4,0;17,0;31,0;15,0;6,0;170,0;10,0;1,0;18,0;1,0;15,0;12,0;5,0;31,0;79,0;16,0;3,0;47,0;199,0;42,0;72,0;8,0;;3,0;10,0;712,0;15,0;5,0;38,0;13,0;77,0;66,0;;20,0;9,0;478,0;5,0;9,0;92,0;1,0;5,0;32,0;32,0;69,0;11,0;2,0;6,0;2,0;130,0;;1,0;2,0;;;319,0;31,0;10,0;76,0;;2,0;4,0;2,0;15,0;;26,0;91,0;33,0;18,0;;61,0;550,0;7,0;406,0;15,0;15,0;;2,0;9,0;43,0;1,0;24,0;3,0;32,0;3,0;8,0;41,0;128,0;1,0;36,0;2,0;5,0;66,0;14,0;14,0;;6,0;25,0;70,0;;;31,0;;4,0;6,0;5,0;97,0;106,0;4,0;3,0;4,0;;12,0;46,0;3,0;;17,0;89,0;24,0;139,0;;;7,0;;16,0;1,0;61,0;3,0;22,0;58,0;71,0;393,0;8,0;35,0;3,0;1,0;6,0;4,0;112,0;1,0;;4,0;4,0;2,0;1043,0;5,0;;;6,0;2,0;17,0;29,0;10,0;;17,0;16,0;294,0;107,0;7,0;;85,0;;15,0;7,0;84,0;;7,0;11,0;;166,0;30,0;3,0;16,0;37,0;19,0;51,0;130,0;2,0;1,0;18,0;1,0;1,0;44,0;37,0;54,0;22,0;44,0;87,0;35,0;8,0;522,0;90,0;4,0;38,0;24,0;325,0;26,0;17,0;63,0;283,0;39,0;45,0;98,0;90,0;60,0;37,0;6,0;144,0;103,0;11,0;3,0;246,0;31,0;204,0;;178,0;87,0;242,0;292,0;11,0;2,0;115,0;22,0;70,0;153,0;41,0;;;;3,0;6,0;238,0;;8,0;21,0;1069,0;207,0;173,0;30,0;9,0;33,0;54,0;175,0;11,0;55,0;;136,0;75,0;139,0;95,0;33,0;27,0;70,0;37,0;6,0;56,0;13,0;21,0;369,0;;33,0;7,0;51,0;3,0;14,0;17,0;;120,0;154,0;25,0;147,0;19,0;10,0;79,0;14,0;178,0;3,0;8,0;6,0;2,0;74,0;34,0;94,0;183,0;14,0;10,0;3,0;20,0;16,0;6,0;;32,0;45,0;139,0;113,0;252,0;196,0;16,0;90,0;30,0;;11,0;45,0;16,0;68,0;1,0;99,0;34,0;13,0;81,0;150,0;2134,0;18,0;16,0;26,0;67,0;33,0;65,0;9,0;14,0;407,0;13,0;39,0;;18,0;94,0;4,0;33,0;4,0;24,0;70,0;87,0;8,0;3,0;7,0;1,0;12,0;3,0;;5,0;3,0;19,0;12,0;44,0;130,0;16,0;15,0;27,0;24,0;30,0;56,0;4,0;6,0;41,0;113,0;225,0;61,0;15,0;23,0;41,0;33,0;3,0;39,0;99,0;77,0;41,0;54,0;28,0;12,0;8,0;24,0;148,0;173,0;34,0;52,0;4,0;60,0;22,0;114,0;38,0;27,0;3,0;14,0;;52,0;18,0;4,0;81,0;;4,0;7,0;;;68,0;16,0;18,0;1,0;96,0;38,0;114,0;55,0;19,0;35,0;17,0;6,0;34,0;8,0;5,0;125,0;17,0;;31,0;8,0;108,0;243,0;126,0;2,0;6,0;36,0;4,0;21,0;3,0;12,0;19,0;10,0;;22,0;28,0;60,0;15,0;49,0;10,0;10,0;112,0;55,0;25,0;;2,0;14,0;213,0;7,0;13,0;55,0;369,0;4,0;70,0;18,0;8,0;5,0;5,0;16,0;48,0;4,0;16,0;2,0;66,0;19,0;;35,0;1,0;;65,0;27,0;2,0;7,0;36,0;51,0;4,0;22,0;11,0;;153,0;169,0;22,0;18,0;1,0;55,0;;;8,0;151,0;29,0;16,0;4,0;67,0;101,0;30,0;7,0;157,0;2,0;4,0;2,0;25,0;106,0;52,0;34,0;31,0;1,0;7,0;8,0;6,0;1,0;6,0;6,0;66,0;5,0;44,0;10,0;14,0;;3,0;5,0;30,0;6,0;5,0;1,0;14,0;16,0;1,0;27,0;3,0;1,0;2,0;83,0;8,0;34,0;;1,0;6,0;15,0;131,0;6,0;;15,0;21,0;11,0;4,0;2,0;2,0;141,0;1,0;18,0;;13,0;49,0;4,0;12,0;5,0;30,0;;35,0;;;2,0;10,0;12,0;17,0;26,0;5,0;5,0;5,0;;3,0;2,0;;3,0;16,0;15,0;5,0;18,0;;;5,0;17,0;;;;1,0;4,0;;61,0;3,0;5,0;3,0;;;3,0;14,0;8,0;3,0;;10,0;9,0;30,0;1,0;7,0;1,0;6,0;;;;1,0;7,0;4,0;;1,0;66,0;1,0;62,0;;;;;21,0;2,0;5,0;;3,0;35,0;10,0;10,0;16,0;1,0;1,0;3,0;11,0;4,0;27,0;13,0;2,0;;23,0;9,0;7,0;;10,0;15,0;49,0;;;32,0;4,0;26,0;;3,0;6,0;57,0;29,0;;;9,0;15,0;8,0;;11,0;9,0;;4,0;17,0;4,0;13,0;9,0;1,0;9,0;26,0;2,0;65,0;10,0;13,0;28,0;13,0;7,0;1,0;13,0;;2,0;;51,0;;30,0;5,0;9,0;1,0;8,0;27,0;18,0;26,0;60,0;4,0;4,0;;24,0;15,0;21,0;;22,0;31,0;63,0;20,0;;79,0;38,0;1,0;2,0;41,0;5,0;7,0;1,0;7,0;5,0;168,0;21,0;8,0;38,0;6,0;2,0;;18,0;5,0;;4,0;29,0;3,0;1,0;;6,0;15,0;;27,0;9,0;15,0;;10,0;4,0;;18,0;5,0;8,0;5,0;;14,0;;2,0;23,0;;43,0;1,0;;;12,0;;38,0;19,0;1,0;;1,0;19,0;;;12,0;2,0;;43,0;2,0;21,0;9,0;9,0;;6,0;2,0;1,0;1,0;1,0;2,0;1,0;1,0;2,0;3,0;1,0;41,0;1,0;83,0;3,0;5,0;1,0;8,0;;7,0;;;20,0;8,0;;6,0;5,0;;;8,0;;3,0;8,0;8,0;;2,0;1,0;;;6,0;;
viewfinder;;16,0;;1,0;2,0;35,0;;15,0;;;;;;31,0;;;29,0;;;;;;;;;;;;5,0;6,0;39,0;;5,0;3,0;2,0;21,0;8,0;1,0;1,0;;21,0;92,0;;339,0;304,0;4,0;;6,0;;;;;11,0;3,0;;4,0;7,0;;;13,0;;;;;132,0;;52,0;;;;3,0;21,0;14,0;2,0;60,0;;;;7,0;2,0;36,0;;9,0;;2,0;40,0;2,0;109,0;10,0;;1,0;1,0;;;4,0;;44,0;1,0;8,0;4,0;196,0;1,0;;4,0;;3,0;1,0;3,0;;;;;5,0;;;;;3,0;19,0;18,0;;;14,0;7,0;;3,0;22,0;;;;10,0;;;45,0;;;16,0;;75,0;;;2,0;;;3,0;16,0;2,0;5,0;8,0;13,0;;18,0;30,0;2,0;;;;;;;;;;;;;45,0;;;5,0;1,0;;7,0;27,0;;1,0;;;2,0;;;;3,0;;;;;1,0;17,0;4,0;;;;6,0;1,0;;28,0;4,0;;1,0;;80,0;1,0;;;4,0;14,0;;41,0;43,0;5,0;16,0;4,0;;;;2,0;5,0;;20,0;;;;;;1,0;72,0;;1,0;;;;;;;1,0;7,0;;3,0;1,0;;;16,0;7,0;;7,0;;5,0;;3,0;;;;;;;18,0;;1,0;;;1,0;3,0;;;;;;;30,0;;;;1,0;;;4,0;;;5,0;10,0;;29,0;;;;1,0;;;;;3,0;;;3,0;;3,0;;4,0;;;;5,0;;;;8,0;;;2,0;1,0;;;;;;;;;7,0;13,0;28,0;;25,0;1,0;;4,0;;6,0;;5,0;;1,0;1,0;;2,0;;;;;31,0;16,0;;;;;;;;;1,0;;3,0;;5,0;28,0;;;17,0;;;;;10,0;;5,0;;;;;;;;3,0;4,0;;;;;;28,0;;;;1,0;30,0;15,0;;;10,0;;5,0;;7,0;;31,0;;1,0;3,0;;;7,0;2,0;31,0;;11,0;8,0;4,0;6,0;;;2,0;1,0;3,0;3,0;7,0;2,0;;;;;71,0;1,0;;5,0;19,0;;13,0;4,0;;5,0;1,0;39,0;;;;1,0;37,0;3,0;;;5,0;13,0;;;7,0;;;74,0;;;;2,0;32,0;2,0;;;;;5,0;4,0;;;9,0;;;;;;3,0;6,0;;22,0;23,0;;1,0;;3,0;2,0;;1,0;;1,0;5,0;1,0;;1,0;;;;2,0;;;;;;59,0;;;;;;;;;3,0;;;;;1,0;;2,0;;;1,0;;11,0;;;;3,0;3,0;1,0;;;;;;;;62,0;;12,0;;;;;;2,0;;;4,0;3,0;5,0;6,0;;;;55,0;;;;12,0;;8,0;2,0;2,0;;;;5,0;;;9,0;2,0;16,0;;;;;;;;;;;;;;;;18,0;;;2,0;;;;2,0;;;;;;5,0;;;2,0;3,0;;;;;;1,0;4,0;1,0;1,0;;;;;;;6,0;;;;;;4,0;;4,0;;;;;;10,0;;;;;;;;3,0;1,0;;;2,0;1,0;;;;;;;22,0;;6,0;;;;6,0;9,0;;;;;1,0;;;12,0;;;;;;3,0;;;;;15,0;1,0;;2,0;1,0;;;;;;1,0;10,0;;;;;5,0;;;;6,0;;;;1,0;;;;3,0;;;2,0;;15,0;4,0;7,0;;;;1,0;10,0;;;2,0;;;;1,0;;;1,0;3,0;;;;;;;;;;;2,0;1,0;;;;;;;;;15,0;;;;;;;;;;;;;;1,0;;;;;;;;;;;;44,0;;;;1,0;;1,0;;;;4,0;4,0;;6,0;2,0;;;;;;;;;;;;;;;;;;1,0;;;13,0;;;1,0;;;;;;1,0;;;;;;;;9,0;2,0;3,0;;;4,0;;;;;;;;;;6,0;;;;;;;;2,0;;;;;;4,0;;;;;;;;;;;;6,0;;;;;;;;;;2,0;;;;;;4,0;;;;;;;;;;2,0;;;;;;;1,0;;;;;;;;;;;;;;;;1,0;;;;;;;;;;;;;;;;;1,0;;;;;;;;;;;;;;1,0;;;;;;;;;4,0;;;;;;;;;;;;;2,0;;;;;;;;;;;;;;;;;;;;;6,0;;;;;1,0;;;;;
visible;;2,0;;8,0;3,0;14,0;22,0;30,0;;;;28,0;;36,0;7,0;;60,0;;;;;;23,0;;5,0;;;16,0;2,0;4,0;87,0;6,0;;;;57,0;16,0;;5,0;;23,0;62,0;2,0;11,0;101,0;6,0;;9,0;;;11,0;;;;17,0;17,0;11,0;5,0;1,0;24,0;;6,0;2,0;;288,0;1,0;71,0;1,0;;;;49,0;859,0;;;;3,0;10,0;;;78,0;;12,0;;28,0;1,0;2,0;27,0;1,0;1,0;;4,0;11,0;;;4,0;37,0;9,0;57,0;65,0;14,0;10,0;;3,0;16,0;11,0;;5,0;;;;6,0;47,0;1,0;;3,0;2,0;26,0;67,0;96,0;3,0;;47,0;;21,0;5,0;56,0;;13,0;;16,0;4,0;;7,0;1,0;;20,0;;;;;;;1,0;4,0;;21,0;4,0;11,0;2,0;;27,0;7,0;;;;;2,0;;;;;2,0;9,0;7,0;2,0;13,0;11,0;;2,0;38,0;6,0;16,0;5,0;;18,0;;31,0;1,0;;3,0;;2,0;2,0;;1,0;82,0;;32,0;13,0;;;1,0;;1,0;6,0;19,0;14,0;;;;33,0;;;;1,0;1,0;;8,0;1,0;3,0;2,0;;;;4,0;27,0;1,0;;10,0;19,0;2,0;4,0;25,0;2,0;;127,0;;2,0;30,0;;21,0;50,0;;8,0;3,0;30,0;7,0;;1,0;;3,0;;;;3,0;;3,0;4,0;;2,0;;;8,0;;;7,0;31,0;1,0;;;51,0;;20,0;1,0;;1,0;119,0;;7,0;;;;7,0;2,0;;14,0;;4,0;;;1,0;5,0;3,0;;;;7,0;1,0;;;10,0;;;1,0;;7,0;;;;;;;;;;;;;37,0;;;2,0;;;;12,0;;1,0;2,0;8,0;98,0;;6,0;;;;;1,0;3,0;;;;;10,0;;;;;;5,0;;;;4,0;;;13,0;;;;;6,0;;1,0;;;9,0;26,0;8,0;;;;1,0;;;;6,0;;;2,0;;12,0;1,0;8,0;;;;;;8,0;10,0;;;;29,0;4,0;7,0;1,0;3,0;1,0;1,0;;4,0;;5,0;;12,0;6,0;1,0;;;1,0;19,0;1,0;14,0;;;5,0;;;;4,0;8,0;14,0;3,0;;;;;;2,0;;;2,0;55,0;4,0;29,0;1,0;;2,0;;;;;;3,0;;3,0;;;4,0;;2,0;;5,0;;2,0;38,0;;6,0;;1,0;;;3,0;;3,0;;9,0;1,0;;;5,0;1,0;;;1,0;12,0;1,0;2,0;9,0;;1,0;3,0;;15,0;1,0;;3,0;;3,0;;2,0;4,0;9,0;8,0;9,0;1,0;4,0;;;1,0;14,0;3,0;6,0;13,0;4,0;;;1,0;;2,0;1,0;;1,0;;;;;1,0;;1,0;;3,0;4,0;;13,0;3,0;;;;;;;;8,0;1,0;;2,0;;2,0;;5,0;;1,0;;2,0;3,0;;;;2,0;14,0;;4,0;;;;;;;1,0;;;1,0;;;;;;;;6,0;;;10,0;;;3,0;;12,0;;;9,0;1,0;17,0;;;1,0;;2,0;14,0;;2,0;;4,0;;;1,0;;;;;1,0;;1,0;1,0;2,0;;;;;17,0;8,0;;;5,0;;;;;;;;;17,0;6,0;;28,0;;;20,0;5,0;;;;;1,0;;;;;1,0;;;6,0;2,0;;;;;;;;2,0;;;;2,0;;;;2,0;;;;1,0;;2,0;1,0;;1,0;;1,0;;;;;6,0;93,0;;;2,0;10,0;3,0;1,0;;9,0;;;;;18,0;;;;;1,0;3,0;6,0;;;;;1,0;1,0;;;;9,0;;5,0;;;;;9,0;;;1,0;;;;;40,0;1,0;3,0;;1,0;1,0;1,0;;6,0;1,0;;;1,0;3,0;4,0;;1,0;;;9,0;;;2,0;1,0;;9,0;2,0;;;;1,0;15,0;;2,0;;;;2,0;;;1,0;;1,0;4,0;3,0;;;;;;;;;4,0;;;;1,0;1,0;;;3,0;;;;;;;1,0;10,0;;;3,0;;;;;;;;;22,0;;1,0;;1,0;;;;;;;1,0;12,0;;;4,0;;1,0;;;2,0;;;;;;;;;4,0;;;1,0;;;;;;;;;;;;;;;;;;76,0;;;;;;;1,0;;;16,0;;;;16,0;14,0;2,0;13,0;;7,0;;;;;;;;;;;;;2,0;;;1,0;;3,0;;;;;;;1,0;;;;5,0;;;;;;;;1,0;;2,0;;;8,0;;4,0;18,0;;5,0;2,0;;;;2,0;4,0;;;;;;;;;3,0;1,0;;;;;8,0;;;;;;;;;;;;;;;;1,0;;;;;;;;;;6,0;;;2,0;;;;;;;;;4,0;;5,0;;;;1,0;;;1,0;;6,0;;;2,0;8,0;;;;;;;;;;;;;
visual;;2,0;;16,0;;19,0;6,0;6,0;1,0;;;;;115,0;2,0;;204,0;3,0;3,0;59,0;;;13,0;;9,0;;;15,0;34,0;12,0;71,0;4,0;;;;417,0;27,0;3,0;11,0;1,0;72,0;156,0;;27,0;319,0;2,0;;16,0;;1,0;5,0;;19,0;2,0;44,0;3,0;1,0;;1,0;56,0;;;12,0;;581,0;3,0;120,0;;11,0;;3,0;16,0;35,0;;;;;7,0;;17,0;149,0;;;15,0;19,0;1,0;;47,0;;2,0;38,0;;;2,0;2,0;;46,0;;73,0;13,0;83,0;5,0;;10,0;9,0;61,0;2,0;2,0;2,0;;;15,0;23,0;6,0;;2,0;2,0;23,0;13,0;122,0;4,0;;17,0;21,0;;9,0;200,0;;1,0;;25,0;;;34,0;;;43,0;3,0;4,0;;;2,0;3,0;;1,0;7,0;9,0;1,0;78,0;16,0;;3,0;3,0;;;;;;;;;8,0;70,0;3,0;;;19,0;;;7,0;1,0;;7,0;6,0;;12,0;;17,0;;;1,0;18,0;;1,0;;;1,0;;13,0;1,0;;;;;;1,0;14,0;;;1,0;;;;3,0;2,0;11,0;;1,0;1,0;5,0;5,0;9,0;4,0;;;;16,0;18,0;;;28,0;1,0;2,0;2,0;2,0;;96,0;;;12,0;;;65,0;3,0;2,0;12,0;7,0;;;27,0;;;;;;35,0;;;16,0;;;;;4,0;;1,0;1,0;6,0;;;1,0;19,0;4,0;33,0;2,0;;;;;4,0;;;;2,0;;;1,0;3,0;;;;;32,0;4,0;1,0;;;1,0;1,0;;;2,0;;;3,0;2,0;5,0;4,0;;;;;;;;;1,0;4,0;;16,0;;;2,0;;;;10,0;2,0;;1,0;13,0;109,0;;6,0;;;;1,0;1,0;;;;;2,0;26,0;;;;2,0;;5,0;1,0;;;;;;4,0;;;1,0;;;;10,0;;2,0;;60,0;4,0;1,0;;;3,0;;1,0;3,0;;;1,0;;;7,0;4,0;3,0;17,0;16,0;11,0;31,0;8,0;19,0;9,0;;2,0;46,0;50,0;4,0;;;14,0;;4,0;12,0;1,0;;1,0;8,0;47,0;39,0;3,0;13,0;11,0;17,0;6,0;;65,0;20,0;4,0;6,0;1,0;;3,0;3,0;9,0;4,0;34,0;;;;6,0;;3,0;;10,0;;55,0;4,0;12,0;1,0;;4,0;;4,0;7,0;13,0;;6,0;49,0;3,0;5,0;5,0;1,0;7,0;;;3,0;;2,0;87,0;6,0;;;26,0;;;;;1,0;;6,0;45,0;6,0;2,0;;;19,0;15,0;3,0;31,0;8,0;95,0;89,0;12,0;25,0;2,0;3,0;2,0;2,0;1,0;5,0;;44,0;2,0;4,0;2,0;;9,0;6,0;;5,0;;;3,0;3,0;;19,0;26,0;9,0;;2,0;1,0;13,0;1,0;3,0;;;13,0;1,0;4,0;1,0;43,0;;;1,0;;4,0;;2,0;;;8,0;;;2,0;;;;;;13,0;1,0;;;34,0;;;1,0;;2,0;21,0;;4,0;8,0;;11,0;6,0;2,0;2,0;3,0;16,0;;;16,0;3,0;;9,0;;;1,0;;2,0;1,0;1,0;38,0;10,0;;;;;;;1,0;;;4,0;5,0;;6,0;;;;9,0;6,0;2,0;1,0;3,0;;5,0;15,0;35,0;3,0;;;2,0;;;3,0;1,0;12,0;;;4,0;3,0;47,0;7,0;2,0;;1,0;;;;;;1,0;6,0;2,0;3,0;4,0;29,0;;2,0;3,0;2,0;8,0;;;;;;10,0;;14,0;;7,0;5,0;;;;1,0;;3,0;;;;;2,0;;;;3,0;;4,0;2,0;;11,0;3,0;47,0;1,0;1,0;;;2,0;3,0;;;;36,0;;;;5,0;;;9,0;;10,0;;;39,0;;;9,0;1,0;2,0;3,0;5,0;1,0;;;;;;;1,0;3,0;;;;1,0;;3,0;;;1,0;2,0;;;;;;2,0;;;;;1,0;;;;;;;;7,0;3,0;;;;;2,0;;3,0;2,0;;10,0;;1,0;;;;4,0;;;2,0;;1,0;16,0;10,0;;;;;;;;;;;1,0;;;;;;;1,0;;;2,0;;;;;;3,0;;;;1,0;;;;;1,0;;;1,0;;;;;;2,0;;;;2,0;;6,0;;;;;1,0;;;;;106,0;;;1,0;;;;2,0;;;1,0;1,0;;7,0;1,0;;;;;14,0;;;;;;;;1,0;2,0;;;;3,0;;;;;;2,0;;6,0;35,0;;1,0;;7,0;3,0;;;;;3,0;7,0;8,0;10,0;;3,0;1,0;;2,0;;2,0;3,0;5,0;;;4,0;;3,0;;1,0;;1,0;;27,0;2,0;;1,0;;12,0;1,0;;;;8,0;1,0;2,0;;;2,0;9,0;;;1,0;;;9,0;;;3,0;;3,0;;4,0;;;;;;5,0;10,0;;;;;;;;;;;;;2,0;;4,0;;;;;;;1,0;;3,0;;;;;;;;;;3,0;;;;;;;;;;;;;;;;;;;;2,0;;;;2,0;4,0;;;2,0;1,0;;;1,0;;;;1,0;;3,0;;;;3,0;;;;;
voltage;;2,0;1,0;29,0;66,0;42,0;11,0;3,0;;;;2,0;4,0;104,0;;;10,0;;27,0;3,0;4,0;;;;34,0;2,0;2,0;19,0;;5,0;247,0;54,0;;;4,0;35,0;1,0;;7,0;1,0;37,0;82,0;6,0;43,0;1,0;;;46,0;1,0;;;;1,0;7,0;3,0;;14,0;1,0;14,0;196,0;21,0;;2,0;;68,0;6,0;62,0;23,0;;;3,0;58,0;25,0;4,0;;4,0;4,0;5,0;;;61,0;;42,0;;40,0;5,0;1,0;21,0;;;4,0;1,0;6,0;13,0;;3,0;59,0;1,0;63,0;15,0;3,0;82,0;;1,0;6,0;16,0;;3,0;3,0;;;254,0;57,0;;;7,0;;23,0;;75,0;;;274,0;2,0;;12,0;44,0;;12,0;;55,0;1,0;;191,0;27,0;;1,0;;;;;3,0;;3,0;8,0;338,0;;31,0;;8,0;96,0;28,0;12,0;;22,0;57,0;;;;;6,0;35,0;;57,0;127,0;;80,0;1,0;3,0;42,0;14,0;;8,0;15,0;;4,0;12,0;8,0;2,0;;2,0;;;;;26,0;3,0;2,0;;;;1,0;;97,0;1,0;;;3,0;3,0;;5,0;52,0;1,0;25,0;62,0;;5,0;;;9,0;21,0;5,0;5,0;;;;287,0;4,0;;4,0;11,0;16,0;;3,0;27,0;2,0;53,0;;4,0;20,0;;;11,0;2,0;;;3,0;21,0;;3,0;;;;;;32,0;1,0;6,0;14,0;;;;3,0;;21,0;461,0;4,0;14,0;;;32,0;3,0;6,0;;1,0;;5,0;;;;;8,0;76,0;2,0;;1,0;2,0;;;;;8,0;3,0;1,0;;6,0;2,0;7,0;231,0;;93,0;;;;5,0;;22,0;69,0;4,0;;;;;13,0;;;;;;48,0;;;5,0;2,0;;;9,0;3,0;;6,0;;4,0;15,0;;1,0;;1,0;;224,0;;;;;;2,0;;9,0;;;;;;;;;;;;;;;;;7,0;;;14,0;4,0;7,0;;1,0;1,0;;;2,0;1,0;;2,0;;2,0;;;2,0;6,0;51,0;13,0;;1,0;52,0;3,0;267,0;;;1,0;15,0;95,0;25,0;37,0;;3,0;12,0;;;4,0;1,0;;;4,0;11,0;2,0;11,0;178,0;;138,0;;7,0;;11,0;1,0;45,0;;53,0;;48,0;19,0;5,0;;;;;;2,0;25,0;14,0;;116,0;;25,0;22,0;;15,0;;20,0;3,0;2,0;;3,0;;36,0;;7,0;244,0;54,0;;;3,0;;;1,0;6,0;;;12,0;;;18,0;3,0;;;;2,0;2,0;12,0;7,0;;;;;41,0;;9,0;5,0;3,0;11,0;;;1,0;;14,0;;3,0;;;1,0;14,0;;3,0;1,0;2,0;;;;;;1,0;;1,0;1,0;2,0;;;1,0;;;;9,0;6,0;;;1,0;;;2,0;;;15,0;;;;5,0;3,0;28,0;;;;;;;4,0;;;;;1,0;;1,0;2,0;;5,0;;;8,0;;;;;;3,0;13,0;;;2,0;;6,0;;9,0;8,0;11,0;1,0;;1,0;;;;;;;27,0;;3,0;;;;;2,0;;;;;5,0;;;;;1,0;6,0;16,0;;;;3,0;;;3,0;;;;2,0;;;;;;2,0;8,0;;;16,0;3,0;55,0;18,0;9,0;;36,0;;;;;;;;1,0;3,0;;;;;;;;;;;1,0;;2,0;;17,0;3,0;8,0;1,0;;;;36,0;;;;;;11,0;;5,0;;7,0;23,0;;13,0;40,0;;;;;3,0;18,0;1,0;;;;;75,0;;;1,0;;;;2,0;11,0;;5,0;4,0;;16,0;;8,0;;;;4,0;8,0;;;;;17,0;;;;;36,0;4,0;12,0;111,0;41,0;;;;;;1,0;;;;20,0;3,0;2,0;1,0;2,0;8,0;;17,0;;;4,0;2,0;;;;;;;;;10,0;;;;8,0;;15,0;;;;;20,0;;;;;;;;;;;;4,0;;;7,0;;;;;;1,0;;;;;;;;;;;;;;4,0;;;8,0;5,0;6,0;;1,0;20,0;7,0;61,0;32,0;13,0;106,0;54,0;;28,0;9,0;;16,0;5,0;10,0;53,0;2,0;12,0;;;2,0;;2,0;39,0;;;25,0;48,0;;22,0;;;;10,0;;;;4,0;;;2,0;1,0;;;151,0;;;1,0;1,0;;2,0;;;;;;;;;;;;;;;18,0;;;8,0;;;1,0;;;;;4,0;;15,0;;;;1,0;;;1,0;;;;;;;4,0;;;1,0;;1,0;;;;;;;;;;;;1,0;;;;;;;;;;;3,0;8,0;;;;;4,0;1,0;;1,0;;;;1,0;;6,0;;;;5,0;3,0;6,0;;;;;;;;;17,0;;9,0;;48,0;;;2,0;2,0;;;;4,0;2,0;;;;;;;;;;;6,0;3,0;2,0;;;;;;;;;;2,0;;2,0;8,0;;;2,0;;;;;;;;;;;1,0;;;;;23,0;;;;
wall;;3,0;;;;37,0;5,0;43,0;;;1,0;5,0;22,0;67,0;;;6,0;;12,0;;1,0;;;2,0;;;;16,0;1,0;1,0;95,0;4,0;;;;8,0;72,0;3,0;2,0;1,0;9,0;74,0;23,0;8,0;11,0;99,0;;39,0;;;;9,0;269,0;37,0;8,0;1,0;192,0;;;;5,0;;1,0;1,0;25,0;;148,0;;;238,0;19,0;139,0;50,0;1,0;;;19,0;;;;14,0;;;;48,0;5,0;5,0;55,0;;1,0;;12,0;7,0;38,0;1,0;;2,0;23,0;99,0;9,0;116,0;2,0;;;;1,0;1,0;;;;;5,0;25,0;8,0;8,0;;;17,0;2,0;20,0;;4,0;;4,0;;;30,0;;2,0;1,0;1,0;;2,0;35,0;2,0;;12,0;;;6,0;33,0;34,0;;;53,0;;8,0;41,0;4,0;75,0;6,0;77,0;182,0;208,0;;;37,0;;;;5,0;76,0;;;;;55,0;112,0;;1,0;4,0;;8,0;81,0;12,0;23,0;1,0;6,0;6,0;3,0;;1,0;12,0;89,0;14,0;5,0;12,0;1,0;17,0;114,0;;;14,0;17,0;38,0;70,0;355,0;;233,0;4,0;3,0;7,0;4,0;1,0;;4,0;118,0;9,0;26,0;236,0;8,0;8,0;2,0;39,0;16,0;160,0;;25,0;;4,0;3,0;;;1,0;31,0;4,0;296,0;3,0;10,0;;30,0;3,0;3,0;;101,0;;2,0;8,0;2,0;1,0;1,0;52,0;5,0;;11,0;1,0;7,0;16,0;426,0;8,0;29,0;6,0;;36,0;23,0;;45,0;307,0;26,0;;1,0;;;22,0;;3,0;;;;28,0;4,0;5,0;31,0;47,0;16,0;1,0;7,0;63,0;4,0;13,0;30,0;1,0;19,0;11,0;;;2,0;29,0;13,0;4,0;22,0;3,0;23,0;45,0;6,0;21,0;22,0;;1,0;18,0;10,0;11,0;16,0;2,0;;28,0;6,0;14,0;26,0;12,0;50,0;;11,0;28,0;79,0;2,0;34,0;11,0;1,0;30,0;1,0;9,0;33,0;18,0;42,0;6,0;;2,0;4,0;4,0;21,0;9,0;9,0;45,0;;2,0;;;;2,0;14,0;6,0;1,0;11,0;3,0;20,0;51,0;49,0;3,0;14,0;;;;;;19,0;3,0;72,0;15,0;3,0;;;;2,0;1,0;;1,0;;1,0;;4,0;;;15,0;;;;;;;4,0;;;2,0;;4,0;;;;;;;;;4,0;;;;2,0;1,0;;7,0;6,0;1,0;2,0;22,0;;7,0;;4,0;4,0;2,0;;;;11,0;3,0;;;;;;2,0;;;47,0;8,0;;;;5,0;;1,0;1,0;;;23,0;1,0;4,0;;;24,0;1,0;8,0;;;;;12,0;;;1,0;;;;1,0;;8,0;2,0;2,0;1,0;1,0;;6,0;;;;;;;3,0;6,0;;16,0;62,0;;7,0;;;;39,0;;2,0;4,0;;;;;1,0;;;6,0;;6,0;;;5,0;5,0;;;1,0;;;1,0;;16,0;2,0;;;;;;4,0;;1,0;;6,0;26,0;42,0;;5,0;6,0;;37,0;;;14,0;3,0;1,0;;;;;6,0;14,0;;;;1,0;;;;2,0;112,0;;1,0;;;7,0;;1,0;1,0;;;;;;1,0;2,0;;;;7,0;3,0;;;2,0;1,0;16,0;;;;;6,0;14,0;1,0;;;31,0;2,0;;1,0;8,0;8,0;4,0;18,0;3,0;;1,0;;;;;;15,0;;;5,0;;;;;;;2,0;;;;;1,0;1,0;;;1,0;1,0;19,0;;;;;;;;;;;12,0;;;;5,0;;;9,0;;;;13,0;22,0;;3,0;;4,0;10,0;;2,0;;6,0;;7,0;;;1,0;1,0;;2,0;;2,0;2,0;6,0;;;;;;;;;;1,0;11,0;;;;;;;;2,0;;;1,0;;;;4,0;;1,0;17,0;4,0;;63,0;;;1,0;39,0;;26,0;;9,0;3,0;2,0;2,0;;5,0;17,0;6,0;46,0;17,0;;15,0;1,0;6,0;;9,0;4,0;;3,0;;3,0;;3,0;1,0;;;4,0;;;2,0;;;;1,0;3,0;27,0;;;5,0;;4,0;1,0;7,0;;14,0;;;;1,0;;;2,0;18,0;6,0;13,0;2,0;1,0;2,0;;7,0;12,0;27,0;5,0;1,0;20,0;4,0;;2,0;18,0;;;;2,0;8,0;6,0;;;;;22,0;2,0;5,0;;3,0;;10,0;;;6,0;;3,0;;;;;;;1,0;;;;;;1,0;;;;;;;;;1,0;;;;;1,0;;;;2,0;1,0;;;3,0;;;1,0;;2,0;;;;;;;;;;;;6,0;;2,0;;;;1,0;;4,0;4,0;;1,0;;;;;;;;;;;;;;;;;;;;2,0;;;;;;;2,0;3,0;;;;;;;;;;;2,0;;;;;;;;;;;;;;2,0;8,0;;6,0;;4,0;;4,0;3,0;;;1,0;;1,0;1,0;;;;;;;;;;;;1,0;;23,0;2,0;;;;;;1,0;;;2,0;;1,0;29,0;4,0;;;;12,0;;;;1,0;;;;;3,0;;;;;12,0;;3,0;;;;;18,0;;;;;;;;3,0;;;;;;;;;;;;;;;4,0;;;;
weight;;1,0;;21,0;16,0;13,0;3,0;16,0;;4,0;;;1,0;106,0;1,0;34,0;10,0;;9,0;4,0;1,0;;27,0;;;;;5,0;6,0;6,0;35,0;3,0;;;;44,0;3,0;;19,0;;113,0;26,0;;1,0;6,0;6,0;;12,0;3,0;10,0;2,0;;2,0;2,0;21,0;7,0;5,0;;5,0;26,0;;1,0;19,0;;174,0;1,0;49,0;17,0;7,0;;4,0;4,0;7,0;7,0;2,0;;14,0;3,0;;1,0;98,0;;;24,0;33,0;5,0;;3,0;;1,0;13,0;3,0;;1,0;6,0;;73,0;9,0;64,0;27,0;63,0;24,0;;16,0;5,0;4,0;2,0;3,0;3,0;;1,0;20,0;42,0;1,0;2,0;11,0;4,0;23,0;9,0;20,0;9,0;;8,0;3,0;5,0;8,0;45,0;;;;4,0;13,0;;9,0;19,0;;4,0;3,0;2,0;3,0;;;;;2,0;80,0;12,0;11,0;18,0;20,0;3,0;8,0;1,0;1,0;;;;;15,0;9,0;;14,0;7,0;;;;10,0;;3,0;1,0;;;;2,0;;15,0;;;;;1,0;;;;;1,0;3,0;5,0;13,0;;5,0;;2,0;1,0;2,0;;1,0;;1,0;;;;;7,0;24,0;10,0;25,0;2,0;1,0;32,0;3,0;4,0;;;;4,0;7,0;;1,0;;;2,0;;;16,0;;23,0;;1,0;4,0;;;12,0;12,0;4,0;;1,0;;2,0;4,0;3,0;;2,0;;;20,0;1,0;;27,0;1,0;;;;8,0;3,0;;47,0;11,0;;;4,0;2,0;3,0;11,0;;;;;;2,0;;1,0;;2,0;;;;7,0;;;8,0;;3,0;;8,0;2,0;;9,0;;;;4,0;;1,0;;;7,0;2,0;5,0;1,0;;;;4,0;5,0;1,0;3,0;;7,0;1,0;;;1,0;;1,0;;2,0;;;8,0;3,0;11,0;1,0;1,0;;;1,0;1,0;6,0;;;;2,0;1,0;11,0;2,0;;1,0;;;;7,0;7,0;;2,0;8,0;13,0;3,0;;5,0;4,0;;4,0;;19,0;1,0;;;9,0;;;10,0;1,0;6,0;;8,0;4,0;;;;3,0;;21,0;30,0;12,0;5,0;;;7,0;1,0;19,0;4,0;;1,0;;16,0;3,0;14,0;;11,0;7,0;3,0;2,0;24,0;3,0;46,0;;8,0;5,0;;;5,0;;30,0;3,0;68,0;15,0;;65,0;2,0;;3,0;;;3,0;7,0;;;;;;8,0;;;1,0;11,0;;2,0;2,0;1,0;11,0;;5,0;;2,0;;8,0;1,0;;4,0;22,0;;14,0;5,0;24,0;8,0;;6,0;4,0;;11,0;;;8,0;1,0;2,0;8,0;;;24,0;29,0;5,0;26,0;;;;1,0;1,0;;;;;10,0;4,0;;5,0;;1,0;1,0;;4,0;;;8,0;;;13,0;;2,0;;4,0;;;4,0;;;;;;;;;2,0;;17,0;8,0;;;;18,0;4,0;10,0;;;;1,0;;;1,0;;6,0;7,0;;;1,0;;;;4,0;;2,0;;10,0;;1,0;;6,0;4,0;;4,0;;4,0;;;;23,0;;1,0;;;;3,0;;;;;;;10,0;;;;1,0;;8,0;;;;3,0;1,0;;1,0;;1,0;2,0;;4,0;1,0;;;26,0;;;;;2,0;2,0;;1,0;9,0;;;;2,0;;;;;1,0;1,0;14,0;;;45,0;;;;;;;;;;4,0;;;;;;;;;8,0;8,0;;2,0;;;;;;;;2,0;;;;;;;;;;3,0;1,0;1,0;;;;;;;;3,0;3,0;3,0;;2,0;5,0;1,0;;;;;;;;;1,0;;6,0;;1,0;;;;;16,0;29,0;;;1,0;;;;;1,0;;;;4,0;;;;;;;;2,0;1,0;;;22,0;4,0;3,0;2,0;1,0;6,0;;45,0;;;1,0;;;2,0;;;;1,0;;;;;;2,0;;;;5,0;;;;1,0;5,0;;;7,0;1,0;;;;;;;2,0;;;2,0;;;;;;3,0;;;;;;;;3,0;;;;;;;3,0;;;2,0;;;;;;;;1,0;;2,0;;;5,0;;;;8,0;;;2,0;;;;;5,0;;;;;;11,0;8,0;6,0;;6,0;;2,0;4,0;;;;;8,0;;;;5,0;;;;;;5,0;;17,0;3,0;;;;3,0;;2,0;34,0;;;;;2,0;1,0;;8,0;1,0;;;3,0;;1,0;;;2,0;;3,0;;;;;;1,0;;;;;;;;;;1,0;;;;;;;;5,0;2,0;;;;;;;;1,0;;;;;;;;;;;4,0;;4,0;;;1,0;1,0;;;;;1,0;;;;;;;;;;;;;;;;;7,0;;;;;;;;;7,0;;;;;;;;;;;;;;;1,0;;;;;;;;;51,0;8,0;;7,0;;;2,0;;;;;;;;;25,0;;2,0;2,0;;;;;20,0;1,0;;6,0;;;14,0;;;;;1,0;;;;;;
windshield;;29,0;;3,0;2,0;19,0;;8,0;;;;;;10,0;;;3,0;;;;;;1,0;;2,0;3,0;;;;;45,0;2,0;;;;1,0;;3,0;;;6,0;13,0;;;6,0;60,0;;6,0;;;;5,0;11,0;4,0;30,0;;13,0;;;;3,0;;;;10,0;;25,0;;;3,0;1,0;25,0;65,0;;;;;;;;13,0;;;;96,0;;;5,0;;;;;;;;;2,0;2,0;9,0;7,0;19,0;4,0;18,0;3,0;2,0;5,0;;;;;;5,0;12,0;;;;;;;11,0;;;;;;;27,0;;;1,0;3,0;;;16,0;;;80,0;;;12,0;;;;;4,0;;9,0;8,0;;143,0;;3,0;29,0;;;;;;;;1,0;2,0;;;;;19,0;17,0;;;1,0;;3,0;27,0;;;;;1,0;;;95,0;2,0;21,0;;;;;2,0;34,0;;;2,0;3,0;2,0;;36,0;;10,0;;;21,0;;;;3,0;53,0;;18,0;84,0;;4,0;;;;1,0;1,0;6,0;1,0;;;2,0;2,0;;6,0;;80,0;;2,0;;;;;;6,0;;;;2,0;;1,0;;;;;;1,0;3,0;17,0;;;;;21,0;;;3,0;127,0;;;;4,0;;338,0;4,0;15,0;;;;13,0;;;;4,0;;;;41,0;6,0;9,0;61,0;;11,0;27,0;;;;13,0;22,0;1,0;;;;;;;13,0;3,0;;;1,0;;3,0;4,0;;1,0;;1,0;;6,0;;;7,0;;;;9,0;1,0;1,0;3,0;;;;;1,0;;;;;;1,0;;;;;;;;;;;;;;2,0;2,0;;20,0;;1,0;;;;;;;;6,0;1,0;;;;;;1,0;7,0;;5,0;;;;;;3,0;2,0;3,0;;;;;3,0;;;;;8,0;;;;;;;;;12,0;;;1,0;1,0;;;1,0;;;;5,0;;;;3,0;;1,0;;2,0;;;;;1,0;;;;;;;18,0;;;;;2,0;;3,0;;;;;1,0;;;;;;;;;;;;;;;4,0;;;;;5,0;;;;;;;;;;;;;;;;2,0;40,0;;;;;;;1,0;;;;;;;;;;1,0;;6,0;;;;;;;;;;;;;18,0;;;;;;;;;;;2,0;;;1,0;3,0;;;;;;;3,0;;;;;1,0;;;;;;;;;2,0;14,0;;;;;;;3,0;;;;;;;;;;;;;;;;;;;;;;;29,0;;;;;;;;;2,0;;;;;;;;;;;;;;;4,0;1,0;;;;;7,0;;;;;;;;;;;;;;;;12,0;;;;4,0;;;;;;;;;;;;;;8,0;6,0;;;;;;;;;;;5,0;;;;;;;;;;;;;;;;;;;;;;;;;;;;;22,0;;;;;;;;;;;;;121,0;;;;23,0;;6,0;;;;;;;;;;10,0;;;;;;;;;;2,0;;;;;1,0;;;;;;;;7,0;;;;8,0;;;;;;1,0;;;;;;;;;;;;1,0;;;;;;1,0;;;;;;;2,0;2,0;;;;;2,0;1,0;;;;;;39,0;;;;;;5,0;;;;;;;;;;;;;;;;2,0;;;;;;;;;;;;;;;;;;;;;1,0;;;;;;;;;;;;;;;;;;;;;1,0;;;;;;;;;;;;;;;;;;;;;;;;;;;;;;;;10,0;;;;;;;;;;;;;;;5,0;;;;;;;;;;;;;;;;;1,0;;1,0;;;;;;;;;3,0;1,0;;;;;;;;;;;3,0;;;;;;;;;;;2,0;;;;;;;;;;;;;;;;;;;;;;;;;;4,0;;;;1,0;;;;;;;;;;;;;;;;;;;3,0;;;;;;;;;;
wireless;;12,0;;4,0;5,0;59,0;1,0;24,0;;;;8,0;5,0;75,0;;;52,0;;13,0;;;;;97,0;547,0;;;18,0;38,0;15,0;240,0;26,0;;1,0;1,0;185,0;4,0;3,0;1,0;1,0;50,0;864,0;;55,0;55,0;16,0;;9,0;;;;;1,0;44,0;7,0;;7,0;;13,0;42,0;;;5,0;5,0;166,0;2,0;78,0;;4,0;;1,0;38,0;28,0;1,0;;;;;6,0;41,0;125,0;;16,0;2,0;157,0;3,0;1,0;6,0;;10,0;18,0;;;7,0;6,0;;;2,0;14,0;62,0;24,0;12,0;;15,0;30,0;117,0;3,0;21,0;;;;;;;;1,0;8,0;2,0;7,0;58,0;3,0;2,0;237,0;1,0;;18,0;261,0;;3,0;;46,0;;;118,0;;;10,0;;1,0;;2,0;;3,0;;2,0;;41,0;21,0;20,0;5,0;;;16,0;;1,0;8,0;;;;;2,0;108,0;16,0;1,0;1,0;;51,0;;;9,0;2,0;;;11,0;;1,0;;3,0;45,0;;7,0;3,0;;2,0;;;1,0;;27,0;8,0;;;2,0;;;;50,0;;8,0;;;2,0;;;3,0;4,0;;2,0;28,0;8,0;3,0;6,0;;;;10,0;6,0;2,0;;;;6,0;;;;;18,0;;;11,0;;;8,0;;4,0;2,0;4,0;1,0;4,0;;;2,0;2,0;;;5,0;21,0;;2,0;;;;;26,0;3,0;16,0;20,0;15,0;1,0;;34,0;141,0;;24,0;3,0;;5,0;4,0;;;;31,0;;4,0;8,0;;5,0;;;1,0;1,0;;1,0;7,0;;;4,0;1,0;10,0;;1,0;20,0;;;;;22,0;;;;;;;;;;2,0;1,0;1,0;33,0;;1,0;2,0;;;;11,0;6,0;9,0;7,0;45,0;6,0;1,0;;3,0;;;;131,0;;;;;4,0;42,0;;;;2,0;;;;;;2,0;3,0;;3,0;;;;;;;25,0;;4,0;2,0;166,0;;1,0;1,0;;4,0;8,0;;;;;4,0;;;1,0;;12,0;;8,0;20,0;4,0;;149,0;4,0;;4,0;1,0;37,0;;;;5,0;;3,0;2,0;1,0;1,0;8,0;;2,0;7,0;;;10,0;27,0;3,0;;18,0;2,0;38,0;13,0;;;3,0;;68,0;31,0;15,0;;;;;;11,0;;3,0;;184,0;64,0;51,0;3,0;1,0;7,0;3,0;77,0;;;;11,0;2,0;6,0;;3,0;10,0;9,0;;2,0;3,0;;;69,0;;;;12,0;1,0;10,0;21,0;1,0;3,0;1,0;1,0;16,0;5,0;1,0;;21,0;7,0;1,0;5,0;2,0;3,0;22,0;14,0;26,0;194,0;2,0;;;97,0;;;;;17,0;4,0;25,0;7,0;60,0;6,0;79,0;;2,0;4,0;;;71,0;;2,0;1,0;1,0;1,0;;41,0;1,0;6,0;;;1,0;23,0;;;19,0;2,0;6,0;4,0;1,0;74,0;;;;;249,0;5,0;;;;;14,0;8,0;;;;;;;;3,0;1,0;1,0;;;2,0;1,0;;10,0;;7,0;2,0;;3,0;;;;;;49,0;;;;;;12,0;16,0;43,0;;1,0;;4,0;7,0;81,0;;1,0;;1,0;;8,0;;;1,0;;62,0;;;;22,0;5,0;;;23,0;3,0;;127,0;3,0;;3,0;8,0;1,0;;1,0;;2,0;;;;;15,0;32,0;;;;;7,0;3,0;;;22,0;;;6,0;3,0;3,0;7,0;;1,0;2,0;16,0;;;;1,0;2,0;;1,0;7,0;442,0;;7,0;;2,0;;2,0;14,0;1,0;;2,0;;;;;85,0;;;;24,0;;2,0;;;;;;;37,0;14,0;1,0;4,0;;1,0;3,0;;43,0;20,0;72,0;;6,0;;7,0;2,0;;21,0;;;;212,0;112,0;102,0;4,0;8,0;;;4,0;;;;;3,0;;;3,0;2,0;3,0;1,0;;7,0;;1,0;;;4,0;;;;;;2,0;;1,0;;4,0;;;13,0;;;13,0;6,0;;3,0;2,0;;4,0;;14,0;;3,0;1,0;;;;;;5,0;2,0;1,0;;;1,0;;8,0;1,0;;;;9,0;;;6,0;;;1,0;1,0;;;;;;;1,0;;;;;;;;;;;;;4,0;;;;1,0;1,0;;;2,0;;;2,0;2,0;;;3,0;;15,0;;8,0;;;;;;;;;;;;1,0;;;;;;;;;;;;3,0;;;;;;;;;;;;;;;8,0;;;;;;;;;6,0;;2,0;3,0;;;;;1,0;;;;;4,0;;3,0;2,0;;2,0;;;;;63,0;1,0;;3,0;;;;;2,0;;;;;7,0;3,0;2,0;1,0;;;;;3,0;5,0;;;;;1,0;24,0;;2,0;5,0;;;1,0;;1,0;;;;2,0;;2,0;1,0;7,0;;;1,0;;4,0;;1,0;;;;;;;;1,0;;15,0;;;1,0;;2,0;;;3,0;;;1,0;;;;;;6,0;;;;;;;;;;;;;;;;;;1,0;;;;;;;;;;;;;;;25,0;;;;;;1,0;;;;;;;;;;;;;
work;;2,0;;4,0;1,0;3,0;;10,0;;;;;;2,0;;2,0;8,0;;38,0;;;;2,0;;1,0;;;7,0;;7,0;27,0;1,0;;;;6,0;8,0;2,0;10,0;14,0;6,0;55,0;;1,0;15,0;1,0;;19,0;;;;;21,0;;16,0;;6,0;;;3,0;;;;;19,0;4,0;22,0;1,0;1,0;;5,0;17,0;30,0;;3,0;;;;;;21,0;;23,0;;9,0;;;4,0;;;;;;;3,0;;;4,0;7,0;3,0;118,0;8,0;1,0;;3,0;11,0;;;1,0;;;4,0;43,0;2,0;;;;7,0;;1,0;;;5,0;;;3,0;39,0;;;;9,0;;;24,0;;;5,0;2,0;;;;1,0;;;;1,0;7,0;;2,0;;;1,0;2,0;1,0;;;;;;;;;;;;;;3,0;;11,0;30,0;;9,0;6,0;;1,0;;2,0;1,0;;;;;2,0;;;;4,0;3,0;13,0;;5,0;;;1,0;2,0;2,0;;;;;1,0;;2,0;2,0;;1,0;;1,0;2,0;4,0;12,0;;;;;1,0;3,0;;;1,0;;2,0;;;;3,0;3,0;6,0;;;;3,0;;;;;;;;;7,0;4,0;3,0;;2,0;;;;1,0;;;;;;3,0;1,0;30,0;;;;;;2,0;;;;;2,0;1,0;;;;1,0;;;1,0;5,0;;;;;1,0;;;;;1,0;;;2,0;4,0;;;;2,0;7,0;;;;;;1,0;18,0;;4,0;2,0;3,0;;;;9,0;2,0;;;;1,0;;3,0;;6,0;10,0;;;;;;;4,0;;2,0;1,0;;;3,0;;2,0;;;;7,0;1,0;8,0;;;;;;;;2,0;;;;4,0;;;2,0;5,0;1,0;1,0;;;;;;;9,0;;;;;10,0;;;;;1,0;;;15,0;7,0;;1,0;;17,0;;;;;;4,0;;;;1,0;;;2,0;;;;1,0;3,0;;3,0;;5,0;;;1,0;3,0;;6,0;5,0;2,0;;;;;;1,0;;;;2,0;10,0;;;;;;13,0;;;;3,0;;4,0;;1,0;;;3,0;;;;;10,0;;;;3,0;;;;13,0;;;;1,0;;;;;;;2,0;;;;3,0;;2,0;;;1,0;;;10,0;;;;1,0;;;7,0;1,0;;4,0;;;;3,0;;1,0;3,0;;;2,0;;;;1,0;;;3,0;;;;;;;;;;;;;1,0;;;;;;;;;7,0;;;10,0;;;;;;;;;;;;7,0;;3,0;;;;;;;;;;3,0;;;;;1,0;6,0;1,0;;;;;;;3,0;;3,0;2,0;;1,0;;;;;;;;13,0;1,0;;;;;;8,0;;;;;;;;;31,0;;;;;;;;;7,0;;;;;;;;;1,0;1,0;;;;;1,0;;;;;;;;;;;6,0;;;;;;;;2,0;15,0;3,0;;2,0;;;;1,0;;;;;;;;;;;;;;;;;;3,0;;;6,0;1,0;;1,0;;;;;1,0;;;2,0;;3,0;;1,0;;;;;;;;;;2,0;2,0;;;;;;;1,0;;;;;;;;;4,0;;;2,0;;;4,0;;;;;;;;;2,0;1,0;;;;;;11,0;;;;;;1,0;;;;1,0;;;2,0;;;;;;;1,0;;;6,0;;2,0;;1,0;;;3,0;;2,0;;;2,0;1,0;3,0;;;;;;;;;;;;;;;;;4,0;;;;1,0;;;;;;;;;;;;;;;;;;;1,0;;;;;1,0;;1,0;;;2,0;;;;;;;;;;;;;;;;;;;;;;;;1,0;;;;;1,0;1,0;;;1,0;;1,0;;;;;;;;;;;;;;;1,0;;;;;;;;17,0;;;;;;;;;;;;;;;;;2,0;;2,0;;;11,0;;;;;;;;;;;;1,0;;;;;;;;;1,0;;;;;;;;;;;;;;;;4,0;;;;;;;;;;;;;;;;;;;;;;4,0;;;2,0;;;;;;;;;1,0;;;;;;1,0;;;;;;;;;;;;1,0;;;;;;;;;
adjustment;;;2,0;156,0;105,0;116,0;17,0;33,0;2,0;6,0;1,0;4,0;7,0;234,0;8,0;13,0;46,0;3,0;;3,0;3,0;4,0;164,0;;2,0;2,0;11,0;22,0;8,0;20,0;92,0;26,0;23,0;23,0;;86,0;3,0;7,0;4,0;1,0;179,0;192,0;;27,0;94,0;16,0;;62,0;;;10,0;;13,0;;20,0;48,0;16,0;2,0;2,0;23,0;;10,0;4,0;1,0;267,0;7,0;88,0;5,0;7,0;11,0;21,0;117,0;84,0;;53,0;1,0;2,0;8,0;5,0;5,0;170,0;;109,0;7,0;82,0;17,0;;54,0;;2,0;46,0;2,0;2,0;;4,0;2,0;40,0;4,0;43,0;85,0;118,0;10,0;;24,0;44,0;23,0;5,0;5,0;5,0;;4,0;24,0;19,0;;;;4,0;12,0;5,0;61,0;1,0;3,0;56,0;12,0;;7,0;122,0;;;2,0;36,0;8,0;;282,0;;;54,0;;60,0;;;1,0;;;27,0;29,0;24,0;2,0;20,0;15,0;6,0;7,0;12,0;6,0;1,0;;;;4,0;;;33,0;9,0;6,0;;;19,0;1,0;1,0;18,0;2,0;2,0;;54,0;5,0;9,0;;;31,0;;;1,0;1,0;6,0;6,0;;;8,0;32,0;5,0;;1,0;;1,0;3,0;17,0;36,0;3,0;4,0;2,0;;;7,0;;2,0;9,0;93,0;;21,0;104,0;24,0;11,0;24,0;;4,0;4,0;35,0;1,0;5,0;6,0;47,0;3,0;;;17,0;;85,0;2,0;5,0;2,0;1,0;;25,0;;;;3,0;4,0;8,0;20,0;;16,0;1,0;1,0;;20,0;4,0;11,0;11,0;12,0;13,0;;;35,0;;1,0;28,0;28,0;2,0;;1,0;10,0;;6,0;;;;;8,0;3,0;7,0;4,0;10,0;39,0;2,0;1,0;41,0;93,0;;14,0;1,0;24,0;46,0;6,0;;;11,0;6,0;32,0;3,0;;7,0;;;3,0;7,0;27,0;;;12,0;;;3,0;1,0;2,0;;3,0;2,0;11,0;66,0;1,0;38,0;3,0;;;31,0;1,0;6,0;4,0;80,0;1,0;10,0;;;2,0;1,0;;7,0;4,0;;2,0;2,0;;1,0;11,0;1,0;7,0;;2,0;4,0;16,0;30,0;18,0;7,0;;9,0;3,0;7,0;;7,0;19,0;12,0;2,0;;8,0;3,0;1,0;3,0;51,0;;3,0;2,0;;1,0;;;2,0;11,0;;117,0;;;58,0;8,0;25,0;8,0;;23,0;8,0;7,0;112,0;32,0;;5,0;9,0;49,0;21,0;9,0;1,0;2,0;2,0;39,0;;311,0;;11,0;;3,0;13,0;5,0;;26,0;;32,0;3,0;49,0;2,0;;13,0;22,0;1,0;17,0;;11,0;31,0;23,0;;;;5,0;;5,0;3,0;6,0;2,0;39,0;11,0;19,0;14,0;7,0;23,0;;70,0;4,0;19,0;;6,0;5,0;12,0;;6,0;18,0;5,0;22,0;2,0;12,0;9,0;;18,0;;1,0;1,0;3,0;13,0;3,0;;19,0;77,0;;3,0;7,0;1,0;;;;;;;5,0;;1,0;6,0;8,0;5,0;;5,0;2,0;;1,0;;;;;1,0;5,0;14,0;116,0;5,0;1,0;20,0;15,0;;1,0;2,0;2,0;;2,0;;2,0;18,0;1,0;29,0;1,0;5,0;;17,0;2,0;2,0;2,0;;2,0;6,0;9,0;;;8,0;;4,0;;;5,0;22,0;3,0;1,0;6,0;;;5,0;1,0;;10,0;20,0;1,0;3,0;13,0;;;2,0;6,0;21,0;;2,0;6,0;6,0;2,0;2,0;;;;;1,0;;8,0;;;9,0;5,0;;2,0;;;9,0;8,0;;7,0;1,0;1,0;;1,0;1,0;;3,0;;;6,0;13,0;;2,0;;;47,0;;2,0;2,0;4,0;;23,0;;;4,0;;1,0;;;;;7,0;;;3,0;2,0;;;14,0;;;;6,0;12,0;;1,0;3,0;;2,0;;;6,0;1,0;;7,0;;;12,0;1,0;;2,0;;;;;;;;18,0;7,0;;;11,0;3,0;1,0;1,0;1,0;3,0;3,0;;;2,0;;;;;5,0;;;6,0;1,0;6,0;3,0;1,0;5,0;;4,0;;1,0;6,0;;;;2,0;;15,0;;;7,0;;2,0;;;21,0;;;2,0;;;;1,0;8,0;10,0;5,0;;;8,0;;16,0;;4,0;1,0;4,0;;;2,0;;;42,0;33,0;5,0;15,0;3,0;1,0;27,0;3,0;8,0;1,0;;;5,0;1,0;5,0;2,0;9,0;2,0;;;1,0;;1,0;6,0;;3,0;10,0;2,0;;3,0;1,0;27,0;;;;1,0;;;;1,0;4,0;1,0;1,0;5,0;;;3,0;;;;;;;;2,0;;1,0;1,0;;;;;4,0;1,0;;;1,0;8,0;6,0;17,0;;;;;;;2,0;;;;;1,0;1,0;1,0;2,0;1,0;;;2,0;4,0;;1,0;;8,0;;;;;;;52,0;;2,0;;;;23,0;;;;;;2,0;;;;;2,0;;;;;;;;3,0;;1,0;;29,0;;;42,0;1,0;1,0;;;3,0;;;;6,0;20,0;;;9,0;1,0;;2,0;;1,0;4,0;;;1,0;;1,0;;;1,0;14,0;;;5,0;5,0;;;4,0;;1,0;14,0;;1,0;;;4,0;;1,0;7,0;;;;;;;21,0;3,0;;;2,0;;;2,0;34,0;;2,0;;;3,0;;;1,0;3,0;;10,0;;1,0;;1,0;;34,0;;;5,0;;;;;3,0;;;;;;8,0;2,0;;2,0;;;1,0;1,0;1,0;;;;2,0;;;;;;;;;;;;;;;2,0;4,0;;4,0;;5,0;;;;;;;;1,0;;;;;;;;;;6,0;;;;1,0;;;;2,0;;;4,0;2,0;;;;;;;;;;
algorithm;;;3,0;29,0;;34,0;;1,0;2,0;;;;;62,0;;;16,0;;;13,0;;2,0;13,0;1,0;;2,0;;1,0;18,0;2,0;27,0;1,0;7,0;10,0;;67,0;1,0;4,0;59,0;1,0;62,0;25,0;;13,0;2,0;;4,0;1,0;;9,0;16,0;;1,0;;39,0;3,0;2,0;1,0;2,0;29,0;;;1,0;1,0;151,0;9,0;46,0;;2,0;;4,0;2,0;9,0;;;;;3,0;;6,0;94,0;;;17,0;6,0;1,0;;25,0;;;25,0;1,0;;;;;22,0;3,0;35,0;43,0;17,0;19,0;;16,0;54,0;26,0;1,0;5,0;5,0;;;3,0;8,0;1,0;;;;4,0;5,0;21,0;4,0;;15,0;;4,0;13,0;55,0;;;;4,0;;;11,0;;;13,0;;;;;;;;;43,0;8,0;4,0;14,0;;;1,0;1,0;;;;;;;;;1,0;;;;5,0;2,0;;;66,0;5,0;3,0;6,0;16,0;;10,0;;;6,0;;3,0;12,0;;24,0;;;18,0;;2,0;3,0;;;;;;;;;;;;;2,0;;1,0;4,0;;;;;;3,0;;;;;8,0;;;2,0;7,0;;;;;;3,0;;;2,0;;;16,0;;;9,0;;;;2,0;;;;;;37,0;;2,0;;;;;;10,0;;1,0;;2,0;;;1,0;;;10,0;;;;;3,0;3,0;;;;1,0;;;1,0;3,0;;1,0;;18,0;1,0;;3,0;;;1,0;;;;3,0;;;4,0;;10,0;;;;;;;20,0;;;;4,0;;4,0;;;2,0;;;;;;;;;27,0;;2,0;;;;;;;;;;;1,0;;;;;;;9,0;1,0;;;;3,0;4,0;;;10,0;;4,0;;31,0;;;;26,0;;1,0;;;4,0;;29,0;16,0;3,0;;5,0;;;32,0;;16,0;;1,0;;3,0;1,0;31,0;4,0;6,0;1,0;;23,0;47,0;9,0;5,0;9,0;;15,0;6,0;32,0;;16,0;;11,0;;;;24,0;1,0;1,0;8,0;4,0;1,0;3,0;13,0;;;1,0;1,0;1,0;4,0;5,0;;;3,0;3,0;;2,0;;;2,0;7,0;;2,0;14,0;;;;9,0;;10,0;;2,0;2,0;;;;;18,0;;12,0;3,0;9,0;;8,0;;;;2,0;;;;2,0;30,0;;3,0;25,0;1,0;;2,0;;;22,0;1,0;2,0;14,0;;;9,0;4,0;1,0;;;;1,0;22,0;;;5,0;2,0;12,0;1,0;30,0;2,0;3,0;8,0;;;;4,0;;;;;2,0;2,0;9,0;2,0;;;4,0;1,0;9,0;;;;2,0;4,0;;;;5,0;;15,0;;;1,0;;;6,0;;;;;;;;6,0;;;4,0;;;;;30,0;;1,0;;;;;;;;;;;25,0;;;7,0;;;;;2,0;1,0;;;4,0;;;8,0;;;;;;;;;;5,0;;;4,0;;;;;;;;9,0;1,0;1,0;1,0;;;;4,0;2,0;;;;;;8,0;57,0;;;;1,0;;;2,0;;3,0;;;;3,0;;;;2,0;1,0;3,0;4,0;;;;;;;;2,0;;;;1,0;;;;3,0;;;;1,0;;;;;2,0;;;;;14,0;2,0;1,0;6,0;;9,0;25,0;;3,0;3,0;;;;;1,0;;;6,0;;;;23,0;1,0;;2,0;3,0;2,0;;;;;;;25,0;;;;;;2,0;;;;;;;;1,0;;4,0;1,0;2,0;;;;;14,0;;;;;;;;2,0;;1,0;;;;;2,0;;;;;7,0;;;;;2,0;;;;15,0;;7,0;;;;;;;;;24,0;;;;;;;2,0;;;;;;;;;1,0;;;;;2,0;;;;;;;;;;7,0;;;;;;;;;;;;2,0;;1,0;;4,0;;;;;;;2,0;;2,0;;;;5,0;;2,0;;;;21,0;;;1,0;2,0;;2,0;1,0;;;;1,0;1,0;;;;;;;11,0;2,0;126,0;;;2,0;;;;;;;1,0;;;;4,0;1,0;3,0;5,0;5,0;;4,0;;;;;;;;4,0;;;;1,0;;2,0;;;16,0;17,0;;;;11,0;;;;;;;2,0;9,0;;;;;3,0;6,0;2,0;;;;;;;;;1,0;;;;;;;2,0;;2,0;;;;;;;;;;;;;;;;3,0;;;2,0;;1,0;2,0;;;;;;;;;1,0;;;;;;;;10,0;;1,0;1,0;;;;;2,0;2,0;;;;;;;;;;;3,0;;;1,0;8,0;;1,0;;;;;;;;;;;;5,0;;1,0;;;;;;;;;
angular;;;1,0;18,0;3,0;12,0;5,0;10,0;;;;4,0;;59,0;;;18,0;;;3,0;;;1,0;;6,0;5,0;18,0;8,0;;6,0;63,0;4,0;70,0;10,0;2,0;30,0;15,0;37,0;;;20,0;42,0;3,0;1,0;5,0;2,0;11,0;5,0;;;58,0;;;;49,0;2,0;11,0;1,0;19,0;24,0;;;2,0;;98,0;;28,0;;;1,0;2,0;26,0;15,0;2,0;;1,0;;5,0;;;41,0;;1,0;7,0;18,0;1,0;;38,0;;4,0;11,0;;;;2,0;3,0;2,0;3,0;13,0;2,0;132,0;10,0;9,0;2,0;2,0;8,0;;;;1,0;2,0;7,0;13,0;;;;28,0;15,0;2,0;102,0;;;195,0;20,0;;3,0;45,0;3,0;;1,0;21,0;;;36,0;;;35,0;;;;;2,0;;;;3,0;5,0;;16,0;;2,0;;3,0;;;;2,0;;;1,0;;;;6,0;;;5,0;16,0;3,0;48,0;15,0;80,0;5,0;28,0;;;2,0;4,0;4,0;;;;;10,0;1,0;1,0;45,0;;4,0;;4,0;1,0;;;;;11,0;18,0;;1,0;;;4,0;1,0;3,0;2,0;4,0;;47,0;22,0;8,0;7,0;29,0;;;1,0;41,0;;;1,0;;24,0;2,0;;2,0;;23,0;;;4,0;;3,0;122,0;;;;;1,0;;2,0;1,0;2,0;;;;10,0;18,0;8,0;1,0;;;;;1,0;2,0;2,0;;18,0;;;;;;8,0;;;1,0;;;5,0;5,0;;1,0;4,0;;;1,0;29,0;;2,0;2,0;;22,0;;;;;2,0;17,0;;2,0;;;6,0;;;4,0;6,0;;;;;1,0;;;;2,0;3,0;6,0;7,0;;;2,0;1,0;14,0;;1,0;;2,0;21,0;18,0;16,0;1,0;;;;;;;;;;;;;;;;;;20,0;35,0;13,0;;;;29,0;3,0;;;;;;;14,0;;;;2,0;;;15,0;3,0;3,0;;11,0;;;10,0;;;;28,0;10,0;10,0;3,0;;9,0;5,0;;39,0;16,0;;3,0;11,0;40,0;;6,0;;;6,0;2,0;;2,0;;18,0;1,0;8,0;5,0;2,0;1,0;1,0;10,0;4,0;9,0;5,0;;;36,0;4,0;;3,0;1,0;4,0;1,0;38,0;1,0;2,0;;10,0;;20,0;;2,0;;15,0;2,0;18,0;;7,0;14,0;;3,0;2,0;26,0;;2,0;;9,0;;;5,0;4,0;12,0;6,0;5,0;;;1,0;248,0;;2,0;1,0;;;;1,0;15,0;24,0;;1,0;;;;;;;;;4,0;;4,0;1,0;;;;3,0;8,0;;;;2,0;;8,0;;;2,0;;1,0;22,0;;;;;;;;;;;;1,0;;;14,0;11,0;3,0;;;;;11,0;;;;1,0;;;;;;;;;;;;5,0;2,0;;3,0;;;;9,0;;2,0;;1,0;1,0;;2,0;3,0;;;;;3,0;5,0;;;2,0;;;;;;2,0;;;;1,0;1,0;;5,0;;;;;12,0;;;;;1,0;2,0;;;;;;;3,0;1,0;;;3,0;;;;;3,0;;;;;;;;;;;;5,0;;;;1,0;;;5,0;;1,0;;;9,0;5,0;;;;1,0;;3,0;;;;;;1,0;;3,0;;;;;;;;1,0;;;;;2,0;;2,0;;;;;;;;;;10,0;;;5,0;;;;;;;;;;;;2,0;;4,0;;;4,0;;;11,0;;;;;;1,0;;;;;;;;;;;5,0;;;;;2,0;2,0;;1,0;6,0;;;;;;;;;2,0;;9,0;;;2,0;7,0;;;;;;3,0;;;;;;;;1,0;35,0;;;3,0;;;2,0;;;;;2,0;;6,0;9,0;;9,0;;;;;;;;;;;;;;;;1,0;;;;1,0;;;;;2,0;;;;;1,0;;;2,0;;2,0;;;;;;;;;;;;;;;;;;19,0;;;;2,0;;;;;;;;;;12,0;;;;4,0;;;;;;;5,0;;3,0;;3,0;;;;;;;;2,0;;2,0;;;;;;;7,0;6,0;1,0;3,0;1,0;1,0;;;;;;;;;2,0;;1,0;;;;1,0;;;;;;;;;2,0;2,0;3,0;;;;;;;;1,0;;;;;;;;;;;2,0;;5,0;;;;;;3,0;;;2,0;;;;;;1,0;;8,0;;;;4,0;;;3,0;48,0;;;;;;;;14,0;7,0;;;;1,0;;;2,0;;;;;1,0;;;;;;;;;;;;1,0;;;2,0;;2,0;;;;5,0;;;;;;;;;;;;;;;;1,0;;;;;2,0;;;;;;;;;;
autofocus;;;4,0;25,0;7,0;26,0;2,0;14,0;;;;;10,0;100,0;;24,0;19,0;;4,0;4,0;1,0;;2,0;;;2,0;10,0;29,0;;3,0;81,0;7,0;9,0;2,0;;9,0;5,0;1,0;3,0;6,0;66,0;90,0;1,0;8,0;5,0;8,0;;13,0;;;;;6,0;;3,0;5,0;5,0;;;40,0;1,0;;8,0;;200,0;4,0;70,0;;3,0;1,0;4,0;187,0;11,0;;;3,0;;9,0;;4,0;108,0;;4,0;;190,0;30,0;;113,0;4,0;;25,0;;;1,0;2,0;;4,0;5,0;33,0;21,0;100,0;1,0;1,0;62,0;5,0;16,0;;6,0;;;;6,0;30,0;;;;12,0;5,0;18,0;38,0;;;9,0;2,0;1,0;1,0;74,0;;;;2,0;;;106,0;;;3,0;;22,0;;1,0;4,0;;;;11,0;3,0;12,0;2,0;1,0;;1,0;12,0;5,0;;;1,0;;;;;14,0;;;;;11,0;2,0;;54,0;3,0;;;55,0;;;4,0;1,0;10,0;;;2,0;;20,0;;1,0;2,0;3,0;8,0;;;;;2,0;1,0;;4,0;;;;;;12,0;;1,0;3,0;17,0;;;15,0;27,0;12,0;6,0;;;6,0;10,0;12,0;;8,0;;;;;6,0;;19,0;;1,0;;3,0;;27,0;;1,0;;2,0;;;1,0;;2,0;;;;9,0;4,0;5,0;10,0;;;;1,0;;6,0;8,0;16,0;17,0;;;;;;;1,0;;;;;;;7,0;102,0;2,0;2,0;;2,0;1,0;;6,0;;;42,0;3,0;;;81,0;1,0;17,0;;128,0;1,0;;;1,0;;32,0;19,0;4,0;3,0;;;1,0;;;;;1,0;;7,0;;;1,0;;1,0;;16,0;3,0;1,0;19,0;6,0;12,0;3,0;3,0;;7,0;2,0;3,0;7,0;1,0;;;1,0;1,0;;1,0;;;1,0;;2,0;1,0;;;;;2,0;1,0;;20,0;9,0;;2,0;1,0;;;1,0;2,0;5,0;;34,0;;;1,0;2,0;24,0;3,0;;;3,0;;;5,0;;2,0;;;2,0;12,0;15,0;62,0;;4,0;;1,0;18,0;;8,0;;14,0;;4,0;;71,0;1,0;25,0;;;8,0;;;5,0;2,0;;1,0;;3,0;1,0;11,0;11,0;;33,0;;9,0;73,0;3,0;3,0;1,0;;;;;;2,0;;16,0;;8,0;;;;;40,0;;2,0;;;10,0;3,0;1,0;1,0;10,0;22,0;1,0;;2,0;;1,0;6,0;;;8,0;;1,0;;;;;;3,0;16,0;1,0;;;;;;;2,0;;6,0;;11,0;3,0;;;;;;;41,0;;;13,0;;;76,0;;3,0;;;;;;;;1,0;2,0;;28,0;;;;;;1,0;;;2,0;;;;;;;5,0;;6,0;;;2,0;;;9,0;;1,0;;1,0;2,0;;;;;6,0;;;;;1,0;;;;;4,0;1,0;2,0;;;;3,0;;;;1,0;;;;;;;1,0;6,0;;1,0;;;;7,0;;;;4,0;;1,0;1,0;4,0;;1,0;;;1,0;4,0;;;1,0;3,0;;;1,0;;1,0;;;;;;1,0;4,0;2,0;;;;;2,0;;;;4,0;;;2,0;1,0;;;;;;;;3,0;;;1,0;15,0;;;;;;3,0;1,0;;;;6,0;;;;;12,0;;;6,0;;2,0;15,0;;1,0;;;;;;;;;;1,0;;5,0;;;;;1,0;1,0;;;1,0;1,0;1,0;;;;;5,0;;;2,0;;;;;;;;2,0;;8,0;3,0;;;1,0;;;;1,0;;;;;;;25,0;85,0;;;;;1,0;;;;;;;1,0;20,0;1,0;;;;;;2,0;2,0;;;1,0;;;;;;5,0;;;;5,0;;4,0;;;;2,0;1,0;;1,0;;1,0;;15,0;;;;3,0;;;1,0;;;8,0;;;;;1,0;;;;;;1,0;;;;;;;;;;;;;;2,0;;;;;;2,0;;;;;;;;;;;5,0;;;;;;;;;;;;;;1,0;;;;;;;;;;;;;;;18,0;;;3,0;;11,0;;;;;;;1,0;;;;;;;;;;5,0;;;;;;;;;;;;;;;;;;;27,0;;;;1,0;1,0;;;;;;;;50,0;;;;;14,0;1,0;;;;6,0;;;;;;;;1,0;1,0;;15,0;;;;7,0;;;;;2,0;;4,0;2,0;;;;;;;1,0;3,0;;;;;;;;2,0;1,0;;;;1,0;;;;;;;;;;1,0;3,0;;;;;;;1,0;;;;2,0;;;;1,0;6,0;;;;;;;;;;;1,0;;1,0;18,0;;;;;;;31,0;;;;;;;;;;;
ball;;;2,0;2,0;1,0;14,0;9,0;37,0;;;2,0;;1,0;28,0;;;3,0;;;;;;;;;4,0;;92,0;16,0;1,0;45,0;6,0;;2,0;;31,0;4,0;3,0;;;52,0;57,0;11,0;;25,0;74,0;;40,0;;;2,0;1,0;12,0;2,0;3,0;;35,0;;;3,0;2,0;;2,0;;32,0;3,0;72,0;;;;5,0;70,0;;;1,0;;7,0;;;;22,0;;6,0;;79,0;21,0;;37,0;;1,0;1,0;12,0;11,0;;;;;6,0;110,0;8,0;76,0;1,0;;;2,0;16,0;17,0;1,0;;13,0;;;;1,0;;;;7,0;;5,0;;;9,0;;;1,0;22,0;;;;6,0;10,0;5,0;84,0;;;8,0;;3,0;;;;;;6,0;4,0;21,0;25,0;4,0;19,0;8,0;;16,0;14,0;;;3,0;;;;6,0;27,0;;;;;44,0;24,0;;;3,0;;4,0;74,0;;6,0;;;15,0;;;;5,0;15,0;;9,0;;8,0;24,0;4,0;;;2,0;5,0;13,0;11,0;24,0;;8,0;10,0;;;2,0;;2,0;;86,0;4,0;1,0;77,0;26,0;37,0;;;;8,0;9,0;3,0;;5,0;;;;;21,0;3,0;76,0;1,0;13,0;;8,0;;5,0;;;;;;;;;3,0;5,0;8,0;;8,0;6,0;7,0;28,0;2,0;3,0;3,0;;22,0;8,0;;53,0;55,0;;;1,0;1,0;3,0;;;2,0;;;1,0;;;8,0;1,0;10,0;5,0;;27,0;23,0;1,0;11,0;3,0;;51,0;3,0;;1,0;5,0;;4,0;;6,0;3,0;;;2,0;8,0;44,0;;8,0;13,0;3,0;3,0;;;;36,0;5,0;52,0;;;1,0;9,0;5,0;;1,0;1,0;11,0;7,0;2,0;6,0;16,0;;9,0;1,0;;;;;7,0;;23,0;;22,0;12,0;1,0;;1,0;1,0;8,0;;26,0;5,0;;9,0;6,0;15,0;43,0;9,0;4,0;1,0;1,0;;;;28,0;6,0;;14,0;14,0;10,0;3,0;;2,0;;;3,0;2,0;;;24,0;147,0;1,0;7,0;29,0;;1,0;;;;;5,0;1,0;;;11,0;11,0;2,0;;2,0;3,0;;;2,0;;;3,0;;2,0;;;;18,0;;;1,0;17,0;;;10,0;;;34,0;;2,0;5,0;;;2,0;;;;3,0;;;;33,0;1,0;4,0;;8,0;;;;2,0;29,0;;;23,0;;;1,0;4,0;;6,0;;;;3,0;20,0;8,0;;;;5,0;;;;5,0;;;18,0;4,0;;4,0;;;;;;;;7,0;;1,0;1,0;68,0;;1,0;;1,0;5,0;;;2,0;;;3,0;;1,0;;;;;;11,0;;;;;2,0;;;3,0;;7,0;2,0;;;;;;;1,0;;;;;8,0;;;8,0;6,0;;5,0;;;2,0;;;;;;8,0;71,0;1,0;;;;6,0;1,0;;;;38,0;;;;2,0;1,0;;;;;;;2,0;;;;;;;;;;;;;;;;;;3,0;7,0;;;;;;;;;1,0;11,0;1,0;24,0;;;;;;;;;;;;;4,0;;;;2,0;;;;;;;;;;1,0;;1,0;;7,0;;;;;;;;;;;;;;;;5,0;3,0;;;16,0;6,0;;;;4,0;;;;;;;;;11,0;;;;;;;;;;;;;;;2,0;;18,0;;2,0;;4,0;;;;;;2,0;;;;;1,0;3,0;;;;43,0;;;;;;4,0;13,0;;;;3,0;;;;1,0;29,0;3,0;3,0;;;;;3,0;4,0;;1,0;;;16,0;;;;;4,0;;;;5,0;;;;;;;3,0;15,0;;;7,0;;;;;;10,0;;;2,0;;;;;2,0;;1,0;;;;;2,0;;4,0;;;1,0;;;;;;;20,0;7,0;;;1,0;;;;;65,0;;;3,0;;;;;;;;;;;;;;;;;;;;;;2,0;;;;;2,0;;;;;;;;;;;14,0;;;;;;;;2,0;38,0;;;;;;;;;;;;1,0;;;;;;;;;;;;21,0;;;;;3,0;;;;;;;;22,0;;;1,0;;;;;;;;;;;;;;;;;;;;;;;;;17,0;;;;;;;;;17,0;;;;;;;;;;;;;1,0;;2,0;53,0;;;1,0;;;2,0;;;;;;2,0;;;;1,0;;;;;11,0;;1,0;;;;;;4,0;;;;;;;;;;3,0;;7,0;;;;;;;;;;;;;;;;;7,0;;;;;;;;;;;;;;;;;;;;;;
beam;;;1,0;50,0;7,0;40,0;42,0;6,0;;;3,0;15,0;;57,0;5,0;;20,0;;3,0;26,0;;;11,0;;3,0;;;30,0;1,0;8,0;115,0;7,0;;;1,0;2,0;6,0;6,0;11,0;1,0;50,0;64,0;1,0;;6,0;31,0;;48,0;;;;;22,0;;30,0;9,0;63,0;;76,0;72,0;2,0;3,0;9,0;;154,0;1,0;61,0;7,0;;;16,0;102,0;952,0;1,0;;;13,0;14,0;;2,0;46,0;4,0;10,0;;19,0;4,0;;166,0;2,0;3,0;;2,0;56,0;;2,0;;31,0;11,0;124,0;79,0;63,0;13,0;9,0;5,0;60,0;9,0;2,0;1,0;5,0;;;98,0;17,0;;;1,0;;26,0;9,0;43,0;13,0;;27,0;1,0;27,0;;99,0;;;;18,0;;;62,0;11,0;;24,0;;1,0;;;1,0;;;31,0;1,0;30,0;25,0;2,0;2,0;;16,0;35,0;;;;;;;;;7,0;;;;;21,0;3,0;3,0;3,0;43,0;3,0;122,0;65,0;;1,0;;99,0;12,0;3,0;5,0;;1,0;;2,0;;48,0;;6,0;13,0;;;;;;;68,0;48,0;12,0;1,0;;9,0;8,0;;31,0;3,0;12,0;2,0;58,0;48,0;9,0;6,0;;8,0;1,0;22,0;58,0;14,0;11,0;136,0;26,0;;;4,0;1,0;;68,0;;;15,0;;72,0;22,0;4,0;3,0;;204,0;47,0;2,0;10,0;;;7,0;1,0;;14,0;12,0;11,0;41,0;;8,0;;1,0;22,0;5,0;3,0;2,0;28,0;4,0;;;72,0;;37,0;8,0;;3,0;20,0;;15,0;2,0;;1,0;10,0;;;26,0;85,0;;13,0;;;62,0;1,0;;;;;7,0;;;4,0;;;6,0;2,0;14,0;8,0;;;2,0;;;;;;;;7,0;57,0;;;;2,0;;;17,0;;17,0;4,0;;73,0;5,0;1,0;;;;;25,0;;;;;;5,0;4,0;;2,0;1,0;;13,0;8,0;;;;5,0;;4,0;50,0;2,0;;;2,0;;10,0;3,0;;7,0;;;;;;;;2,0;1,0;3,0;;2,0;1,0;2,0;23,0;3,0;9,0;;9,0;;1,0;;38,0;12,0;;2,0;;35,0;3,0;9,0;;1,0;;;8,0;35,0;;12,0;;3,0;6,0;;;3,0;;3,0;;8,0;3,0;4,0;1,0;7,0;12,0;1,0;;6,0;7,0;14,0;5,0;;;4,0;4,0;;11,0;2,0;1,0;121,0;20,0;7,0;2,0;2,0;5,0;;1,0;2,0;;72,0;1,0;6,0;;;;;13,0;;7,0;1,0;1,0;6,0;1,0;;;;4,0;1,0;;;;7,0;2,0;1,0;4,0;;;4,0;;4,0;;;;;2,0;;;2,0;7,0;;318,0;6,0;4,0;1,0;;;3,0;14,0;10,0;2,0;6,0;;;2,0;;;;81,0;8,0;7,0;;;;;;;;;4,0;4,0;1,0;;;;1,0;;;;;1,0;;5,0;5,0;;14,0;1,0;7,0;3,0;;;;12,0;;;;;;24,0;3,0;;;1,0;1,0;3,0;;1,0;7,0;11,0;;;;;;;2,0;;;;;6,0;1,0;;;;1,0;;;2,0;;;6,0;;3,0;;;;;;6,0;1,0;;4,0;;21,0;;;;2,0;4,0;;;;;90,0;;;;;2,0;;1,0;16,0;4,0;;4,0;;;;;2,0;;1,0;;;;5,0;;;;3,0;6,0;3,0;;;;;17,0;4,0;;;7,0;;;;1,0;;;;;;;1,0;7,0;3,0;;7,0;13,0;2,0;;3,0;;2,0;;1,0;;;;;;;;;10,0;;7,0;12,0;;;;;;;;;112,0;;2,0;;;8,0;;;168,0;;;1,0;;32,0;;6,0;;;;;;;;;;;1,0;1,0;;;;;11,0;;6,0;;;;;;4,0;;;1,0;;68,0;;1,0;;12,0;;;;;2,0;5,0;;;70,0;1,0;;;8,0;;27,0;;12,0;;6,0;;;;;;;7,0;18,0;14,0;13,0;2,0;;;;4,0;;2,0;;;;;3,0;;;11,0;;;;5,0;6,0;;;;15,0;8,0;;;6,0;;1,0;;3,0;;;;4,0;1,0;;12,0;;;;2,0;;;;;1,0;;;;;;1,0;1,0;;;;;;1,0;;;8,0;;;;;;2,0;;;;;;2,0;1,0;;4,0;;;;;;;;;;;;;;;1,0;;;;;19,0;;;1,0;;;;;;21,0;;;;;13,0;;;;33,0;26,0;;;22,0;;4,0;1,0;;;;;;;;;;;2,0;;;;;2,0;;;;8,0;;;;;;4,0;;;1,0;;;;;;;26,0;10,0;15,0;;;;3,0;;4,0;4,0;;;;;;;;4,0;;6,0;18,0;;;;;1,0;3,0;;;;;4,0;;;;;;;1,0;;;;;;1,0;1,0;;;;13,0;;;;6,0;1,0;;19,0;;;;;1,0;5,0;;;;;;;;5,0;24,0;;;;;;;141,0;;;3,0;;4,0;;;;;;;;
bearing;;;1,0;;1,0;12,0;2,0;27,0;;;7,0;;4,0;26,0;;;3,0;;12,0;;;;;;1,0;;;;3,0;;18,0;;;1,0;;;11,0;;;;;29,0;2,0;;4,0;35,0;;45,0;;;;;8,0;2,0;2,0;;15,0;2,0;;;;;;;;;52,0;;;;;21,0;3,0;;;;2,0;;;4,0;8,0;;;;43,0;12,0;;8,0;;;1,0;3,0;3,0;;;;;;47,0;3,0;16,0;;;;;10,0;;3,0;;;;;1,0;;;;;;;;;;;;;;19,0;;;;;;;20,0;;;3,0;1,0;;;;2,0;;;8,0;1,0;1,0;1,0;;13,0;6,0;;4,0;11,0;;;;;;;;5,0;;;;;9,0;14,0;;;;;3,0;34,0;;1,0;;;11,0;;;;2,0;18,0;3,0;;13,0;2,0;27,0;1,0;;;2,0;2,0;;10,0;36,0;;5,0;;;7,0;6,0;;;4,0;20,0;12,0;;4,0;11,0;11,0;;;;19,0;;1,0;2,0;;;;;;63,0;;39,0;2,0;5,0;2,0;3,0;;6,0;;3,0;;;;;;;32,0;;1,0;12,0;;1,0;2,0;15,0;6,0;23,0;19,0;;12,0;;;46,0;74,0;;;1,0;;;1,0;4,0;2,0;;;3,0;;;8,0;1,0;6,0;;2,0;8,0;7,0;;;;;16,0;4,0;;;6,0;;1,0;6,0;2,0;;;;;1,0;;;1,0;39,0;3,0;3,0;;;;14,0;;10,0;;;;;;;45,0;2,0;3,0;2,0;1,0;3,0;1,0;;1,0;;17,0;;;1,0;1,0;;;;3,0;8,0;;3,0;;;2,0;;44,0;8,0;1,0;6,0;4,0;1,0;;3,0;;;;;;;3,0;6,0;;1,0;1,0;;;4,0;;2,0;;;;;;;;;;6,0;;1,0;;;;;;;;1,0;2,0;;;;;;;8,0;;;1,0;;1,0;;;;;;;1,0;;;;;2,0;7,0;;17,0;;;1,0;;;;;;;;;;;13,0;;;;3,0;;;;;;;13,0;;1,0;;;;;3,0;;2,0;;;;4,0;;;;;147,0;;2,0;;;;;;;;;;;;;;;;15,0;9,0;;2,0;;;;;2,0;;;1,0;;;;;1,0;;;;;;;;;;;1,0;;;;;;;;;;;;;;;;;1,0;;;;;;;;;;3,0;;;;2,0;;;16,0;;1,0;;;;;;;;5,0;;;;;;;;;;;;;;;1,0;;;;;;;;;;;;;;;;8,0;2,0;;;5,0;;;;1,0;3,0;;2,0;;;3,0;;;;;;;;;;;;;4,0;;;;;;;;;;;;;;;;;;;;;;;;;;;;;;;;;;;;;4,0;;;;4,0;16,0;;;;;;;;;;;;;;;;;;;;;;;4,0;;3,0;1,0;;2,0;;;;;;;6,0;;;;;;;;;;16,0;;;3,0;;;;5,0;;;;;;;;4,0;23,0;;7,0;;4,0;;;;;;;;;;;;;;;;;1,0;1,0;;;;;;;;1,0;;;12,0;;2,0;3,0;1,0;;;;;;2,0;;;;;;7,0;;;;;3,0;;;;;5,0;;;1,0;;;;;3,0;;;;;1,0;1,0;2,0;5,0;;;;;;;;;;;;;;;;;;;;;;;;;;;;;;;;;;;;;;;;;;;;;;;;;;;;;;;;;;;;;;;;;;;;;;;;;;;;;;;;2,0;;;;;;;;;;;;;;;;;;;;;4,0;;;;;;;;;;;;;;;;;;2,0;;;;;;;;;;1,0;;;;;;;;2,0;;;7,0;;;;;;;2,0;;;;;;;;;2,0;;;;;28,0;;1,0;;;;;;6,0;;;2,0;;;;;;;;;;;;;;;;;;;;;2,0;;;;;;;;;;;;;;;;;;;;;;;;;;;
board;;;5,0;24,0;;115,0;44,0;133,0;;;1,0;;41,0;106,0;;;35,0;9,0;1,0;;28,0;1,0;;6,0;11,0;1,0;1,0;115,0;4,0;11,0;144,0;14,0;2,0;5,0;;17,0;35,0;1,0;6,0;4,0;23,0;195,0;7,0;8,0;10,0;501,0;1,0;159,0;;;1,0;;68,0;10,0;4,0;1,0;146,0;;;30,0;1,0;;36,0;;378,0;2,0;309,0;;1,0;31,0;3,0;255,0;45,0;;;;14,0;;;7,0;79,0;;1,0;;387,0;4,0;4,0;58,0;11,0;10,0;;17,0;10,0;;;;4,0;27,0;160,0;22,0;131,0;14,0;;20,0;30,0;68,0;;;;;;5,0;33,0;2,0;1,0;;;24,0;;483,0;;6,0;63,0;7,0;;2,0;114,0;;11,0;10,0;2,0;;9,0;199,0;;6,0;11,0;;17,0;;16,0;18,0;1,0;;8,0;20,0;38,0;71,0;3,0;148,0;;10,0;42,0;89,0;;1,0;;2,0;;7,0;59,0;379,0;;4,0;;;239,0;57,0;;14,0;18,0;;2,0;40,0;1,0;74,0;13,0;4,0;13,0;;2,0;6,0;10,0;51,0;26,0;5,0;26,0;2,0;24,0;145,0;;;59,0;41,0;73,0;71,0;374,0;;43,0;11,0;2,0;19,0;;;9,0;2,0;190,0;24,0;6,0;473,0;9,0;2,0;1,0;3,0;2,0;37,0;15,0;42,0;7,0;11,0;96,0;1,0;1,0;12,0;83,0;5,0;280,0;6,0;6,0;1,0;28,0;8,0;3,0;3,0;75,0;2,0;1,0;;;;9,0;5,0;;;17,0;10,0;20,0;58,0;288,0;4,0;;1,0;1,0;39,0;59,0;26,0;159,0;420,0;18,0;;9,0;16,0;;54,0;11,0;5,0;;;;20,0;27,0;70,0;22,0;14,0;2,0;;6,0;43,0;33,0;2,0;18,0;3,0;26,0;;;;26,0;17,0;3243,0;12,0;136,0;;;4,0;1,0;14,0;62,0;8,0;24,0;18,0;10,0;12,0;246,0;5,0;;27,0;1,0;2,0;4,0;116,0;1,0;4,0;16,0;;2,0;;46,0;1,0;11,0;8,0;14,0;6,0;35,0;6,0;2,0;39,0;;;58,0;1367,0;15,0;;;26,0;2,0;2,0;;;2,0;;10,0;4,0;;21,0;17,0;22,0;1,0;49,0;;2,0;1,0;;1,0;6,0;6,0;;;112,0;14,0;7,0;11,0;;;5,0;4,0;6,0;;;;;4,0;;6,0;24,0;4,0;1,0;;3,0;;;188,0;29,0;;2,0;;15,0;;5,0;2,0;;;7,0;;1,0;8,0;2,0;;1,0;1,0;;;5,0;26,0;7,0;3,0;35,0;;4,0;1,0;16,0;2,0;15,0;;5,0;5,0;15,0;2,0;;;;;2,0;;;;76,0;;1,0;;;11,0;;4,0;;8,0;;;;11,0;;25,0;86,0;1,0;6,0;1,0;3,0;;1,0;9,0;;;1,0;;6,0;3,0;17,0;;2,0;4,0;;7,0;;;2,0;;;2,0;;;;;;1,0;24,0;11,0;4,0;;32,0;28,0;4,0;27,0;;9,0;5,0;3,0;6,0;13,0;;7,0;;2,0;;;2,0;2,0;;;;;2,0;2,0;;21,0;2,0;;13,0;13,0;;;;1,0;2,0;4,0;1,0;;103,0;;8,0;;51,0;94,0;158,0;;12,0;;;5,0;;12,0;;;;43,0;5,0;21,0;;;;31,0;9,0;;;3,0;64,0;;;;;4,0;;3,0;2,0;9,0;;;;;;;;;2,0;;16,0;;;4,0;2,0;3,0;1,0;;;;62,0;15,0;1,0;;1,0;2,0;;;;1,0;20,0;11,0;10,0;8,0;;;;2,0;;1,0;;;;;;1,0;3,0;;;;;;2,0;;;;1,0;1,0;;;38,0;;1,0;2,0;2,0;;87,0;;;3,0;;;;;;;;;1,0;11,0;17,0;5,0;;;;21,0;;8,0;;4,0;3,0;2,0;1,0;8,0;1,0;;;;;1,0;;;9,0;;1,0;;;;8,0;;;13,0;;;;2,0;;19,0;;10,0;1,0;;1,0;1,0;3,0;6,0;;;;1,0;;2,0;4,0;2,0;3,0;24,0;;;25,0;;;;147,0;;25,0;;1,0;1,0;1,0;2,0;9,0;72,0;3,0;2,0;9,0;;;;3,0;11,0;;10,0;6,0;;24,0;;;;1,0;2,0;1,0;;17,0;;2,0;;;;;2,0;1,0;36,0;;83,0;1,0;;7,0;1,0;1,0;2,0;7,0;;1,0;;3,0;;1,0;3,0;15,0;10,0;4,0;1,0;1,0;3,0;;13,0;5,0;31,0;2,0;6,0;9,0;;;10,0;2,0;;3,0;;2,0;1,0;;;;5,0;1,0;52,0;13,0;;;;;;;1,0;;;;;;1,0;6,0;;3,0;8,0;;;;1,0;;3,0;;;;;;6,0;;;;;;;;;10,0;;;;12,0;;;;12,0;8,0;;;13,0;;;;;;2,0;;;12,0;;5,0;10,0;;;;;;;;2,0;;;23,0;;;;2,0;;;22,0;;;;4,0;;;;;;1,0;;;;;9,0;1,0;;;;;;;;;;;;;;;;2,0;;;2,0;;;;;1,0;2,0;;;;;;32,0;;4,0;;;;5,0;3,0;;;4,0;;;;;;13,0;;;;1,0;;;2,0;;;1,0;53,0;8,0;;;;;;4,0;;;;;1,0;1,0;;2,0;;;3,0;;;2,0;;2,0;;;;15,0;;;21,0;;;;4,0;;;;;2,0;1,0;;;;;;;;1,0;;;;;;;;4,0;;;;;;;;7,0;;
buffer;;;4,0;3,0;21,0;18,0;;3,0;;;;;;23,0;;;79,0;;;;;;9,0;;;;;1,0;3,0;;58,0;3,0;;;;192,0;;;19,0;;19,0;37,0;;28,0;28,0;9,0;;;;1,0;;;;1,0;6,0;;5,0;;;41,0;;;2,0;4,0;529,0;1,0;26,0;8,0;;;;1,0;3,0;;;;12,0;;7,0;154,0;19,0;;19,0;2,0;28,0;;;;;;;;;;34,0;;8,0;;64,0;4,0;8,0;25,0;;8,0;25,0;43,0;;6,0;;;;;7,0;;;;1,0;9,0;2,0;39,0;7,0;;42,0;3,0;;119,0;30,0;;;4,0;44,0;;;83,0;;3,0;17,0;;1,0;5,0;;;;;3,0;;7,0;9,0;3,0;1,0;2,0;;;;;;;;;;1,0;29,0;;4,0;5,0;;14,0;;4,0;;1,0;;1,0;1,0;;1,0;;;3,0;;;1,0;;;;;;;122,0;1,0;;;;12,0;10,0;;8,0;;;;;1,0;1,0;4,0;;1,0;7,0;;2,0;;;9,0;;;;2,0;118,0;;;6,0;21,0;15,0;;;;;45,0;;;;;;13,0;;1,0;;;;;1,0;;8,0;;;;70,0;;4,0;;;;;1,0;;5,0;5,0;3,0;1,0;;;22,0;7,0;;;;;;;;3,0;;30,0;2,0;;;;;2,0;;;;;;;;;;1,0;53,0;1,0;1,0;;;;;1,0;6,0;1,0;2,0;;;;;;;;;2,0;;7,0;;;4,0;;;;;;1,0;;;12,0;;;;;;;;;;;;7,0;7,0;;;;1,0;;;;;;;;;;;2,0;;;;;;;;3,0;26,0;1,0;;;;;2,0;1,0;3,0;;;2,0;;;3,0;;2,0;;;;1,0;;15,0;;4,0;2,0;;2,0;8,0;2,0;5,0;1,0;3,0;;4,0;;;3,0;;;;;;11,0;10,0;18,0;;1,0;2,0;1,0;2,0;;;1,0;;5,0;7,0;;;;;;;4,0;1,0;56,0;;25,0;;7,0;;;;;1,0;;;2,0;12,0;;1,0;;;;15,0;;;1,0;;;9,0;;;22,0;;;;;4,0;;;;5,0;1,0;2,0;4,0;;34,0;;;3,0;;;;;4,0;;;;;;;;;;9,0;;;4,0;;;;;;;;;;1,0;;;3,0;;32,0;;;;;9,0;2,0;;;;;;;;2,0;;;;;2,0;;1,0;;;;;;;;;;;;;;1,0;;;;;13,0;;;;;;;2,0;3,0;;;;;5,0;1,0;;;;;;8,0;;;;;;;;;;;3,0;1,0;;1,0;;;;;;;;;;;;;;11,0;1,0;;2,0;;;1,0;;;;;;1,0;;;9,0;3,0;;1,0;;;;;;;;;;;;;1,0;;;1,0;;;;;;;;;;1,0;;20,0;;;;;;;;;;;;;;;2,0;;4,0;;;;1,0;10,0;14,0;8,0;;;;;3,0;1,0;;;;;18,0;;;;;4,0;;;15,0;;;;;7,0;;;1,0;;7,0;;2,0;;3,0;14,0;6,0;2,0;;;;;;;4,0;12,0;;;;;;;;;;;4,0;;;;;15,0;3,0;;;;;;;;;2,0;;4,0;;;4,0;10,0;;;;3,0;5,0;;;;;;;;;;;;;;;;;;;;;;;;;;;1,0;;;;1,0;;;;;;;;;;;;4,0;;;;;;3,0;6,0;;2,0;9,0;2,0;;;1,0;1,0;;;;;;;;;;;;;;;;;13,0;;;;;;1,0;;35,0;;;;;;17,0;;;;;;;11,0;;;;1,0;;;;;;;;;;;;;;2,0;;;;;;;;;;;;;;2,0;;1,0;;;16,0;;1,0;;;;;2,0;;;;;;;;;;5,0;;;;;;;;;;;;2,0;16,0;;;;;;;1,0;2,0;;;;;;;;;;;;;;;;1,0;2,0;;;;;;;;;;;;;23,0;;;;;;;7,0;;;;;;1,0;;;;;;;;;;;;;;;;;;;;3,0;;;;;;;;;;;;;;;;;;;;3,0;;;;;
calibration;;;2,0;45,0;10,0;148,0;46,0;18,0;1,0;1,0;;1,0;1,0;256,0;;;207,0;5,0;1,0;5,0;;;73,0;31,0;2,0;6,0;25,0;37,0;26,0;44,0;129,0;28,0;32,0;45,0;;346,0;22,0;1,0;70,0;;296,0;357,0;4,0;31,0;55,0;17,0;16,0;18,0;26,0;47,0;48,0;;6,0;5,0;28,0;13,0;7,0;;24,0;130,0;;;8,0;3,0;908,0;8,0;195,0;;1,0;;14,0;63,0;70,0;3,0;;;10,0;19,0;;30,0;502,0;2,0;23,0;87,0;79,0;6,0;10,0;81,0;;7,0;379,0;4,0;1,0;;8,0;;115,0;48,0;240,0;134,0;107,0;52,0;;90,0;36,0;73,0;;16,0;3,0;;3,0;196,0;47,0;;;1,0;10,0;96,0;54,0;73,0;49,0;2,0;32,0;14,0;2,0;97,0;516,0;;22,0;;77,0;;2,0;132,0;4,0;;44,0;9,0;4,0;;;8,0;12,0;;;76,0;23,0;12,0;60,0;9,0;;6,0;10,0;3,0;;2,0;;;;;;4,0;2,0;8,0;2,0;6,0;19,0;2,0;1,0;16,0;3,0;8,0;11,0;17,0;;9,0;;2,0;18,0;;;;;9,0;;;7,0;;47,0;2,0;5,0;;2,0;;9,0;;4,0;;;;;1,0;;2,0;35,0;48,0;31,0;;40,0;30,0;6,0;4,0;11,0;2,0;;1,0;33,0;21,0;;8,0;329,0;2,0;1,0;;9,0;1,0;14,0;1,0;;2,0;;16,0;40,0;2,0;;3,0;12,0;2,0;;4,0;;4,0;4,0;2,0;;50,0;3,0;5,0;11,0;;;;2,0;9,0;;4,0;3,0;51,0;2,0;;5,0;9,0;1,0;149,0;8,0;;;7,0;;17,0;5,0;;4,0;27,0;;;3,0;42,0;;;;;15,0;2,0;3,0;;2,0;4,0;16,0;1,0;;17,0;;;3,0;;63,0;4,0;;1,0;;;2,0;1,0;;;;10,0;5,0;79,0;;1,0;1,0;;6,0;;21,0;1,0;4,0;1,0;3,0;165,0;7,0;2,0;6,0;;;;;2,0;;;;1,0;79,0;3,0;;;;;26,0;45,0;9,0;;;2,0;7,0;23,0;;;;;8,0;;4,0;7,0;;;120,0;3,0;;;2,0;2,0;2,0;77,0;12,0;15,0;;24,0;;;74,0;76,0;9,0;7,0;3,0;;28,0;1,0;65,0;126,0;36,0;10,0;;43,0;16,0;23,0;13,0;7,0;1,0;12,0;23,0;34,0;3,0;33,0;1,0;36,0;5,0;8,0;6,0;12,0;2,0;13,0;12,0;63,0;11,0;4,0;5,0;8,0;1,0;28,0;3,0;3,0;41,0;19,0;;5,0;1,0;;;2,0;4,0;6,0;6,0;63,0;1,0;28,0;9,0;5,0;4,0;;16,0;;8,0;;24,0;3,0;5,0;5,0;14,0;;12,0;2,0;7,0;12,0;8,0;1,0;29,0;;;;10,0;13,0;5,0;;18,0;;;26,0;55,0;2,0;9,0;4,0;;2,0;13,0;1,0;2,0;1,0;;;16,0;19,0;;;11,0;;7,0;5,0;1,0;37,0;;23,0;35,0;6,0;169,0;9,0;1,0;99,0;17,0;;4,0;13,0;;;14,0;;12,0;;42,0;1,0;3,0;;5,0;3,0;24,0;;;7,0;1,0;3,0;;;7,0;24,0;;1,0;;;1,0;;6,0;1,0;;;;10,0;;;;8,0;;;4,0;12,0;;5,0;3,0;10,0;10,0;;;1,0;;5,0;;11,0;;3,0;;2,0;;7,0;;3,0;;4,0;;;3,0;12,0;1,0;6,0;42,0;8,0;1,0;;;3,0;;16,0;3,0;1,0;27,0;23,0;;10,0;;;1,0;;7,0;;2,0;;;;21,0;3,0;;4,0;32,0;14,0;;;;2,0;19,0;1,0;2,0;4,0;;65,0;;2,0;;;2,0;;4,0;5,0;55,0;1,0;;;;3,0;9,0;8,0;4,0;1,0;;2,0;;;1,0;;1,0;2,0;;;;7,0;;;;;2,0;1,0;;;;3,0;;4,0;;;;4,0;1,0;4,0;6,0;;37,0;2,0;1,0;5,0;15,0;8,0;;4,0;33,0;;3,0;;4,0;;4,0;;55,0;;4,0;;6,0;7,0;;10,0;399,0;10,0;;9,0;;1,0;;4,0;31,0;;;;;;20,0;7,0;;;;15,0;;;;;6,0;5,0;2,0;14,0;;1,0;;41,0;;;1,0;1,0;;1,0;;;;3,0;;;;;8,0;6,0;;;31,0;4,0;;;;7,0;50,0;;1,0;1,0;11,0;2,0;14,0;;4,0;;;1,0;;3,0;;24,0;;;;2,0;;;9,0;;;9,0;;;;;;1,0;1,0;;3,0;;3,0;;50,0;;;;1,0;;;;2,0;;;;5,0;10,0;;2,0;1,0;;;;5,0;;4,0;;3,0;;3,0;;;;;;;8,0;;2,0;39,0;28,0;;17,0;;;;1,0;;4,0;;2,0;;45,0;3,0;;6,0;;;33,0;2,0;;;;30,0;;;20,0;4,0;1,0;;7,0;1,0;;;;;2,0;;;24,0;;9,0;90,0;11,0;;15,0;;19,0;1,0;;;;13,0;6,0;;;;11,0;;;14,0;5,0;8,0;;2,0;108,0;;;2,0;14,0;;;5,0;;3,0;;1,0;1,0;;6,0;;3,0;18,0;;;8,0;;2,0;;;;;5,0;;6,0;;10,0;;4,0;3,0;;;2,0;;2,0;;1,0;4,0;;;;1,0;;7,0;;;1,0;;;1,0;;;;;18,0;1,0;1,0;;;;;;;;;;1,0;;;;2,0;1,0;;22,0;;;;;;;3,0;;9,0;8,0;;;;6,0;1,0;;;;;;;;8,0;1,0;26,0;;;;;29,0;1,0;5,0;1,0;;;3,0;5,0;;1,0;;;;;1,0;;;
cement;;;1,0;;;;;;;;;;;;;;;;;;;;;;;;;;;3,0;;;;1,0;;;;;;;;;;;;11,0;;28,0;;;;;;;;9,0;12,0;;;;;;26,0;;15,0;;23,0;;;;9,0;256,0;2,0;;1,0;;;;;;;;;;;2,0;;11,0;;3,0;;;;;;;;1,0;3,0;;;;;;;;;;;1,0;;;;;;;;;;;;;;;;;4,0;;;;;;;9,0;;;;;2,0;;;;;;8,0;;;;;;;;;;;;;;;;;;;;;;;;;;;;;;;;1,0;2,0;;;;;;;;;;;;1,0;;;;;;1,0;;;;;;2,0;;;;;;;;;;;;;;;;;;;;;;;;;;;;;;;;;1,0;;;;;1,0;2,0;;;;;;;;27,0;;;;;;;;;34,0;;;;;;;;;;;;2,0;;;;;;;;;;;;;;;;;;;;;;;;;;;;;;;;;;;;;;;;2,0;;;;;;;2,0;;;;;20,0;;;1,0;;;;8,0;;;;;;;;;;;;;;;;;;;;;;;;;;;;;;;;;;;;;;;;;;;;;;;;;;;;;;;;;;;;;;;;;;;;;;;;;;;;;;;;;;;;;;;;;;;;;;;;;;;;;;;;;;;;;;;;;;;;;;;;;;;;;;;;;;;;;2,0;;;;;;;;;;;;;;2,0;;;;;;;;;;;;;;;;;;;;;;;;;;;;;;;;;;;;;;;;;;;;;;;;;;;;;;;;;;;;;;;;;;;;;;;;;;;;;;;;;;;;;;;;;;;;;;;;;;;;;;;;;;;;;;;;;;;;;;;;;;;;;;;;;;;;;;;;;;;;;;;;;;;;;;;;;;;;;;;;;;;;;;;;;;;;;;;;;;;;;;;;;;;;;;;;;;;;;;;;;;;;;;;;;;;;;;;;;;;;;;;;;;;;;;;;;;;;;;;;;;;;;;;;;;;;;;;;;;;3,0;;;;;;;;;;;;;;;;;;;;3,0;20,0;;;;1,0;;;;;;;;;;;;;;;;;;;;;;;;;;;;;;;;;;;;;;;;;;;;;;;;;;;;;;;;;;;;;;;;;;;3,0;;;;;;;;;;;;;;;;;;;;;;;;;;;;;;;;;;;;;;;;;;;;;;2,0;;1,0;;;;;;;1,0;;;4,0;;;;;9,0;;;;;;;;;;;;;;;;;;;;;;;;;;;;;;;;;;;;;;;;10,0;;;;;;;;;;;;;;;;;;7,0;;;;;;;;;;;;;;;;;;;;;;;;;;;;;;;;1,0;;;;;;;;;;;;;;;;;;;;
character;;;1,0;8,0;1,0;8,0;;;;;;;;38,0;;;13,0;;;4,0;;;2,0;;;4,0;;;;;17,0;8,0;;;;;6,0;;;;72,0;19,0;;6,0;32,0;;2,0;1,0;;1,0;8,0;;1,0;2,0;2,0;;4,0;;;11,0;;;83,0;;133,0;;28,0;2,0;;;4,0;;;;;;;1,0;;;59,0;;6,0;;;;;40,0;;2,0;2,0;;;;;;7,0;;85,0;;6,0;9,0;;4,0;6,0;8,0;1,0;;;;;1,0;37,0;3,0;;;;;;6,0;;;8,0;76,0;;25,0;10,0;;;;6,0;;1,0;4,0;;;8,0;4,0;6,0;;;4,0;;;;;7,0;;13,0;;;2,0;;7,0;;;;;;;;4,0;5,0;5,0;;;;;2,0;7,0;;;;3,0;;8,0;;;4,0;;;;;5,0;;;;;2,0;;;;;;;;;;;;;;16,0;;1,0;;;;;;;5,0;;;;;16,0;;;;6,0;;;;8,0;;8,0;;;;;;36,0;2,0;;56,0;;;;3,0;;;;;;6,0;2,0;1,0;;;;;;1,0;;;;1,0;;;;2,0;;;;;;;2,0;;;;;;;;;;;;;;2,0;;68,0;;;4,0;;;;;;;;;2,0;;;;;;;;;;;;8,0;;;;;;;;;;;;1,0;21,0;;;;;;;;1,0;;;;;1,0;;;;;;8,0;;;;;;;4,0;;;;;;;;;;;3,0;;;;;;;;1,0;;;;;;6,0;;5,0;;;1,0;16,0;2,0;17,0;;;;;45,0;;;;3,0;1,0;4,0;13,0;7,0;;12,0;;28,0;7,0;;;38,0;;5,0;;5,0;;;;;;1,0;;;15,0;;;;;;;;;;1,0;3,0;;25,0;;;1,0;;;;;;1,0;;;;;;14,0;;;3,0;;;3,0;;;1,0;1,0;;;;2,0;;;;2,0;3,0;;;;1,0;;;1,0;2,0;;1,0;6,0;;;;;;;11,0;;4,0;;;;1,0;49,0;;1,0;;;;;;;;2,0;2,0;;;;;;3,0;;;2,0;;;;;8,0;;12,0;;;;19,0;;;;;;;;;;;;;;7,0;;;;;;11,0;;2,0;;4,0;;;;;;;;2,0;;;60,0;;1,0;8,0;;;;;;;;;;;;;;;;;;;;;;;;;;;;;;;;;138,0;3,0;;3,0;;;;;3,0;;;;4,0;;3,0;3,0;;;1,0;;;;;;;;1,0;;;2,0;1,0;;;;2,0;;;;;;;;;;;;;;;;;;;;2,0;;;;2,0;;;4,0;;;;;;;2,0;1,0;;;;;;;;;;;;;4,0;;;;;24,0;;;;;2,0;;;;;;;;;;;;;1,0;;;;;;;;;;1,0;;;;;;;;;;;;1,0;;;;;4,0;;;;;;;;;1,0;;;;;1,0;;;;;;10,0;;;;;;;;;;;;;;;;2,0;;;;;;;;;;;;;;4,0;;;;;;;;;;;;;;;;;5,0;;;;;;;;;;;;;;;;;;;;;;;;;;;;8,0;;2,0;;;;;;6,0;;;4,0;4,0;;;;;11,0;;;;;;;;2,0;;;93,0;;;;;;;3,0;;;;;;;10,0;;;8,0;;;;;;;;;;;;5,0;2,0;;;;;;;;3,0;;;;30,0;;;;;;;;;2,0;;;;1,0;1,0;;;;;87,0;;;2,0;;;;;;;;;;;;;;;;;5,0;1,0;;;;;;;;;;;;;;;;;;;;;;;;;;;;;;13,0;;;;;;;;;;;;;;5,0;;;;;;;20,0;;;;;;;;1,0;4,0;;;;;;;;;;;;;;
coefficient;;;1,0;4,0;25,0;14,0;9,0;10,0;;;;;;45,0;;;7,0;1,0;3,0;;;;6,0;;;1,0;11,0;3,0;1,0;2,0;13,0;9,0;27,0;22,0;;72,0;;7,0;5,0;;44,0;19,0;2,0;14,0;1,0;;21,0;25,0;6,0;3,0;44,0;;;;2,0;6,0;2,0;;5,0;8,0;1,0;;5,0;;88,0;;11,0;7,0;5,0;;4,0;56,0;21,0;;10,0;3,0;18,0;1,0;;;47,0;;1,0;7,0;9,0;;;24,0;;5,0;5,0;;1,0;;;;29,0;1,0;12,0;8,0;21,0;5,0;;1,0;12,0;6,0;6,0;3,0;;;;3,0;19,0;;;24,0;13,0;4,0;;7,0;;;17,0;10,0;;17,0;23,0;;;;5,0;;;32,0;8,0;;4,0;4,0;4,0;;;;2,0;;1,0;15,0;14,0;;33,0;;;2,0;1,0;;;;;1,0;;;3,0;2,0;;3,0;;2,0;;;3,0;6,0;4,0;2,0;;6,0;8,0;2,0;2,0;;;;6,0;;;5,0;4,0;;60,0;3,0;1,0;;;;;;4,0;4,0;1,0;;;;;4,0;3,0;;;1,0;6,0;;;2,0;;2,0;;;;;23,0;5,0;2,0;2,0;10,0;2,0;;2,0;;;6,0;;;14,0;;;1,0;3,0;;;;2,0;;23,0;1,0;;;;;30,0;;1,0;4,0;;;;;5,0;2,0;;;16,0;;;;5,0;;16,0;;;;5,0;34,0;;;;;2,0;;;1,0;5,0;;2,0;;3,0;1,0;2,0;;;;;11,0;2,0;4,0;;;;;;9,0;1,0;4,0;;;;;;;;;;5,0;;;;2,0;;;;;;1,0;;;18,0;6,0;;;;1,0;;3,0;;;;;;;;6,0;;;;;;;4,0;;;;8,0;;1,0;;;5,0;;;10,0;;;6,0;;;;;;;42,0;2,0;;;;;;56,0;2,0;13,0;3,0;;;2,0;;9,0;;2,0;6,0;;2,0;;19,0;1,0;;3,0;;6,0;16,0;;18,0;;2,0;1,0;9,0;;7,0;;7,0;4,0;23,0;1,0;1,0;16,0;;;2,0;;1,0;;;;3,0;;;;2,0;;12,0;;5,0;;2,0;5,0;;;;;;10,0;;10,0;2,0;;;21,0;;12,0;;2,0;5,0;2,0;1,0;3,0;;;1,0;;;;;14,0;20,0;;2,0;5,0;1,0;;;;2,0;23,0;;;4,0;;;1,0;;2,0;;;;2,0;;;;;7,0;1,0;;6,0;7,0;;1,0;10,0;;;;;;;;;;;2,0;;;;3,0;;;;15,0;;11,0;;;;1,0;;1,0;;2,0;2,0;;;;1,0;1,0;;;;;;;;;2,0;;;;;2,0;;1,0;3,0;;;;;;;;;;;;;7,0;;1,0;;;1,0;;2,0;57,0;4,0;;1,0;;;;;1,0;;;;;;4,0;;;1,0;;;;2,0;;;1,0;7,0;1,0;;;;3,0;;;;;;;5,0;;;6,0;;;;;;;;;;2,0;;;;;;;;;;;;;;;;;;;;;;;;;;7,0;;;;3,0;;;;;;;;1,0;;3,0;11,0;2,0;;;;;;;;;;;;;;;;;;;;1,0;;2,0;18,0;;;;;;;;1,0;;;;7,0;;;;;;;2,0;;;;;;;;;;;;1,0;;1,0;;;;1,0;;;;;;;;;5,0;;;;;;;;;2,0;17,0;1,0;3,0;;;;1,0;;;1,0;;2,0;;;;;;;;;;;;;;1,0;;;;2,0;;;;;;;2,0;;;;;;;;;;4,0;;;;;;;;;;;;;;;3,0;55,0;;;4,0;;;1,0;;;6,0;4,0;;;18,0;;;;1,0;;;;;;;;;;;;;3,0;9,0;;;;;2,0;;;;;;;;;;1,0;2,0;;;;;;;;2,0;11,0;;11,0;4,0;;;;;;;;;;;;3,0;;;;14,0;8,0;5,0;1,0;;;2,0;10,0;;53,0;;;;5,0;;;;;2,0;;;1,0;15,0;;;;;;;;;;;;;;9,0;;;;;;;;;1,0;;;;;;;;;;;;4,0;1,0;;182,0;;2,0;;2,0;;;;;;;2,0;;;;;12,0;;;1,0;;;;;;;;;;;;;;;;;;;;;;;;32,0;;4,0;;;;;;;;;5,0;;;;;10,0;;;1,0;;;;;;
compose;;;1,0;;;4,0;2,0;;;;;1,0;3,0;3,0;;;;2,0;;4,0;;;34,0;;;2,0;;1,0;;5,0;3,0;;;3,0;;15,0;;;;;1,0;9,0;;;;4,0;;93,0;;;;;;;;2,0;3,0;;;1,0;;;13,0;;50,0;;8,0;;;;2,0;185,0;5,0;;;;38,0;2,0;;1,0;4,0;;;1,0;10,0;;;37,0;2,0;;1,0;;;;;;11,0;2,0;36,0;4,0;7,0;;5,0;;2,0;1,0;;;1,0;;;1,0;4,0;;;;;1,0;;8,0;;;13,0;2,0;1,0;3,0;18,0;;;;2,0;;;79,0;;;1,0;1,0;15,0;;;4,0;;;1,0;2,0;15,0;3,0;;1,0;;3,0;4,0;;;;;1,0;2,0;2,0;;;;;;;4,0;5,0;;4,0;;;;2,0;;2,0;;;;;;;;;;;2,0;;1,0;2,0;2,0;;;2,0;4,0;;19,0;;5,0;;;1,0;;;;;11,0;11,0;;1,0;9,0;;;5,0;;3,0;;;;;1,0;;;;5,0;;4,0;;;1,0;1,0;1,0;;;5,0;;;;;;1,0;;;;;;;1,0;10,0;;;;;;1,0;;4,0;8,0;;;1,0;5,0;2,0;2,0;2,0;;;;3,0;2,0;;1,0;;;;;;;;;;;8,0;1,0;;3,0;;;;4,0;33,0;;;4,0;;;1,0;;5,0;;;;3,0;;;;;1,0;;12,0;;;;4,0;;;1,0;;;4,0;;6,0;;5,0;;;;;13,0;;;;;1,0;;;;;;;;;;;;;1,0;;;;;;4,0;;;;;;;;;;;;;;;;;;;;;1,0;;;;;;;;1,0;;;;1,0;;;;;;;3,0;1,0;;;;;;;;2,0;;;1,0;;;;3,0;16,0;;3,0;;;;4,0;1,0;;;;;;;;;6,0;;;;1,0;2,0;;;;;;;1,0;;;;;;;1,0;;;;;;;;;;;;1,0;;;;;;;;;;;;;;;;;;;;;;;;10,0;;;1,0;1,0;;;;;;;;;;;;;;;;3,0;;;;;;;;;;;;;;2,0;;;2,0;;1,0;;;;;;;;;;;;;;;;;;;;;;;;3,0;;1,0;;;;;;;;;;;;2,0;;;;;;1,0;;;;13,0;;;;;;3,0;;;;;;2,0;1,0;;;1,0;;;;;;3,0;;;;;;;;;;;2,0;;;4,0;;;;;;2,0;2,0;;;;;;;;;;;;1,0;;;;;;;;;;;;;;;;;;1,0;;;;;;;;;;;;;;;1,0;;;1,0;;;;1,0;;;;;;;;;;;;;2,0;;;2,0;;;;;4,0;;;;;1,0;;;;1,0;;;;;;;;;;;1,0;1,0;1,0;;;;;;;3,0;;;;;;1,0;;;;;;;;;2,0;;;;;2,0;;;;;;;;;;;;;;;;1,0;;;;;;;;1,0;;;;;;;;;;;;1,0;;;;;;;;;;;;;;;;;;;;;;;;;;;3,0;;;;;;;;1,0;;;;;;1,0;;;1,0;1,0;2,0;;1,0;1,0;;3,0;;;;;;;1,0;;;;;6,0;;3,0;;;;;;;;;;;;;;;;;;;;;;;;;;2,0;;;3,0;;;;;;;;;;;;;;;2,0;;;;;;;1,0;;;;;;;;;;;;;;;;;;;;;;;;;;;;;;;;;;;;;;;;;;1,0;;;;;;;2,0;;;6,0;;;;1,0;;;;;;;6,0;;;;;;;;;;1,0;;;;;;;;;;;;;;;;;;;;4,0;1,0;;;;;;;;;;;;;;;;;;;;;
compression;;;4,0;27,0;1,0;21,0;2,0;5,0;;;;;;13,0;;;30,0;;1,0;;16,0;1,0;4,0;;1,0;;;1,0;3,0;4,0;92,0;2,0;1,0;;;103,0;;1,0;4,0;;28,0;13,0;;3,0;31,0;;;4,0;;;;;4,0;;2,0;;2,0;;;33,0;;;13,0;2,0;366,0;2,0;34,0;11,0;;;2,0;8,0;4,0;;;;1,0;;;4,0;84,0;;2,0;;23,0;;;;;5,0;13,0;;1,0;;;;17,0;;20,0;2,0;2,0;25,0;;18,0;36,0;5,0;;;;;;10,0;1,0;11,0;;2,0;19,0;6,0;5,0;7,0;1,0;;1,0;18,0;;27,0;20,0;;;;3,0;;;9,0;;;1,0;1,0;;;;3,0;;;;10,0;;4,0;;1,0;2,0;1,0;10,0;;11,0;;;;;;;2,0;;1,0;;;9,0;1,0;8,0;;;;;;;3,0;;;;1,0;;;;;;;;;102,0;2,0;;;;;;;1,0;;;;;;;3,0;2,0;2,0;1,0;;;3,0;2,0;;;;;;5,0;;;;;2,0;;;6,0;;;4,0;;1,0;;7,0;4,0;109,0;2,0;;;;;;;12,0;1,0;;1,0;30,0;1,0;;1,0;;;;;7,0;;;;2,0;;;2,0;29,0;;;;;;;;;;;;;;;1,0;;;;;;;;;;;;11,0;;6,0;;;1,0;;;10,0;;1,0;2,0;;;;;;;6,0;4,0;2,0;1,0;;;2,0;2,0;;;1,0;6,0;16,0;23,0;;7,0;;1,0;;;;3,0;;;;;;;7,0;;10,0;;;;;;;1,0;;1,0;;;1,0;23,0;;;1,0;;1,0;;2,0;2,0;57,0;;;;;;;1,0;7,0;;;;;;4,0;;;1,0;5,0;;2,0;;8,0;;;;6,0;6,0;3,0;2,0;;;;1,0;;;;12,0;;5,0;;;;5,0;;15,0;;2,0;9,0;;12,0;;;5,0;;3,0;3,0;;;3,0;;;;48,0;;;1,0;31,0;;5,0;;;;;1,0;;;;;;;;;4,0;23,0;;;3,0;;;;1,0;;;;3,0;;;;4,0;;1,0;;8,0;;;;10,0;;;;;22,0;;;1,0;;;;;;7,0;;5,0;;;;;39,0;;4,0;;;;;;;;2,0;1,0;;;;1,0;;;10,0;3,0;;;;;;1,0;;;;;;3,0;;;;;;;;;2,0;;;;;2,0;;;;;3,0;1,0;6,0;;3,0;;;5,0;;9,0;;;;4,0;;;1,0;;12,0;2,0;;3,0;;;3,0;;3,0;;;;2,0;;;;;;;1,0;5,0;;;;3,0;;1,0;;;2,0;;;2,0;;;8,0;;2,0;;;;;63,0;;;;;;;;;4,0;;;;;;;;;;;;;;;;;;;;;;;;;;;12,0;4,0;;;;1,0;;;;;;;;;;;;;;1,0;;;;;1,0;;2,0;11,0;;;;;7,0;;;;;;2,0;;;;;;;11,0;7,0;;;;;1,0;;;;;;;4,0;;;;76,0;3,0;;;;;;;13,0;;;;;;;21,0;;;;20,0;;;;;1,0;;;;6,0;;;;;;;2,0;;;;;;;;;;;6,0;;;8,0;;8,0;;;;;;;;;;;;;;;2,0;;;;;;;;10,0;;7,0;4,0;;;;;;;;;;;;;;;1,0;2,0;;;;;3,0;;;;;;;1,0;;;;1,0;;;;;;;;;;;;2,0;;;;;;;;;;;;3,0;;;;;126,0;;;;;1,0;;;2,0;;;;;;;;19,0;;;2,0;;;;;1,0;;;5,0;;;;;;;;;;;;;2,0;;;;;;;;1,0;;;1,0;;;;;;;7,0;;;;;;;;;;;;;;;;;1,0;;;;;;;3,0;;;;;;;;;;;;;1,0;1,0;;;;;;;;;;;;;;;;;;3,0;;;4,0;;;;;;;2,0;;4,0;;;;;;;2,0;;;1,0;;;;;2,0;;;;;;;;;;;;;;;;;;;;;11,0;;;;;
continuous;;;2,0;2,0;;10,0;1,0;1,0;2,0;1,0;;5,0;;6,0;;;38,0;;13,0;2,0;;;5,0;;1,0;;;;4,0;1,0;17,0;2,0;;;;97,0;4,0;6,0;1,0;;7,0;21,0;;;3,0;4,0;;3,0;;;;;;;5,0;2,0;24,0;;;19,0;;;;;196,0;3,0;22,0;1,0;;1,0;1,0;11,0;3,0;1,0;1,0;;9,0;5,0;;2,0;43,0;;33,0;2,0;9,0;1,0;;2,0;;1,0;2,0;1,0;1,0;3,0;6,0;;11,0;1,0;2,0;11,0;14,0;1,0;4,0;12,0;32,0;6,0;;;;;;4,0;11,0;2,0;3,0;;;8,0;6,0;12,0;5,0;;18,0;2,0;;3,0;20,0;;;2,0;21,0;;;5,0;;;23,0;;10,0;;;6,0;;;;1,0;6,0;1,0;2,0;1,0;1,0;;4,0;1,0;;2,0;2,0;;;;2,0;3,0;7,0;1,0;;;;3,0;;;;;;2,0;;5,0;;3,0;1,0;;;;2,0;1,0;;4,0;5,0;;18,0;4,0;;;;;1,0;;4,0;;1,0;;;6,0;;;3,0;2,0;4,0;;2,0;3,0;4,0;17,0;;;3,0;4,0;21,0;;1,0;4,0;1,0;3,0;;;;;18,0;1,0;;;;;4,0;2,0;2,0;;;;;1,0;;1,0;;;3,0;7,0;1,0;1,0;2,0;7,0;;;;6,0;1,0;12,0;;16,0;4,0;;2,0;;;9,0;;6,0;4,0;;;1,0;;2,0;1,0;;;;8,0;;;1,0;4,0;11,0;1,0;;;;2,0;;;2,0;1,0;3,0;;1,0;;;1,0;1,0;;;;1,0;4,0;;;;;2,0;;5,0;;;1,0;;;1,0;2,0;;1,0;3,0;;6,0;1,0;1,0;;;;2,0;18,0;;;;18,0;;25,0;;6,0;;;;2,0;;;;;18,0;1,0;;;;;;;1,0;15,0;2,0;1,0;;29,0;8,0;;;;;4,0;1,0;;;;3,0;;;;;3,0;;;;1,0;1,0;16,0;9,0;;1,0;;8,0;;7,0;;;3,0;;3,0;8,0;;8,0;;1,0;8,0;;;7,0;;1,0;;18,0;;1,0;9,0;1,0;;2,0;;4,0;16,0;;;;;;;;;;;15,0;;13,0;2,0;;;2,0;6,0;;18,0;;1,0;2,0;4,0;;2,0;;9,0;;;1,0;;;5,0;3,0;2,0;2,0;2,0;;;2,0;;1,0;;;;;;2,0;;;;;;;;;;;;;;;;;1,0;;;1,0;11,0;3,0;26,0;;;;;;1,0;;;;;;;1,0;;2,0;;;;;1,0;;;;;;5,0;;;;5,0;1,0;;;;1,0;;;;;;;1,0;;1,0;;;;;;10,0;;5,0;;;;;1,0;;8,0;;;;;;;;;;1,0;;3,0;;;;8,0;;;;;;;;;;;;3,0;;;;;;;;;;56,0;3,0;;1,0;;1,0;7,0;;;;;;;;;6,0;;;;;8,0;;;;;;;1,0;;;;;;;;;2,0;;;2,0;;;;;;;;56,0;;;;;;;;;;;;5,0;1,0;2,0;1,0;;;;1,0;;3,0;;;;;;1,0;5,0;;2,0;;;;4,0;;1,0;;;;2,0;;;1,0;;;;1,0;;;;;;13,0;;;2,0;;;;2,0;2,0;;;2,0;5,0;;16,0;2,0;;;3,0;;2,0;1,0;1,0;;;;;;;1,0;;;;;;;;;;2,0;;2,0;;;;;;;;;;;2,0;;;;;;;;3,0;;1,0;;;;1,0;;;;;;;;;;;2,0;;;;2,0;;1,0;;;;;;;;;;;;1,0;;;;;;4,0;2,0;;;;;;;1,0;;;;;;;;;;;3,0;;;;;3,0;;;5,0;;;;;;1,0;;;2,0;;;;;;;3,0;;;;;;;;;1,0;;2,0;5,0;;;5,0;;2,0;75,0;;;;;6,0;;1,0;;;;1,0;;9,0;;;1,0;;;;;;;;5,0;1,0;2,0;2,0;3,0;;;;;;;;2,0;;;;4,0;;;;;;;;;;;2,0;1,0;;2,0;;;;9,0;;;;3,0;1,0;;;;;;;;;;;;;;;;;;;;;;;;;;;1,0;1,0;;;;;;3,0;;;;;;;;;;;;1,0;;;;;1,0;;4,0;;;;;;;;;;;1,0;;;;;;;;;;;;;;;;;;;;;;;;;;;
contour;;;1,0;;;3,0;;1,0;;;;;;5,0;;1,0;4,0;;1,0;;12,0;6,0;6,0;;;;;31,0;2,0;;28,0;2,0;3,0;;;8,0;6,0;;;5,0;53,0;28,0;;;13,0;2,0;;22,0;;;;;4,0;;1,0;;16,0;;;8,0;;;4,0;;109,0;;32,0;;;;3,0;13,0;2,0;;;2,0;;;;;52,0;;1,0;8,0;25,0;2,0;;;;;;1,0;;;;;10,0;1,0;31,0;27,0;10,0;1,0;;6,0;11,0;10,0;;4,0;;;;6,0;9,0;;;;;2,0;;12,0;;;41,0;1,0;;1,0;11,0;;;;;;9,0;6,0;;;;;;;;;;;5,0;4,0;22,0;13,0;2,0;3,0;;3,0;42,0;;;;1,0;;;;;1,0;;;;;1,0;9,0;;6,0;;;;2,0;;6,0;;;;;;;;5,0;;;;;11,0;4,0;;;1,0;14,0;1,0;;13,0;;6,0;2,0;;;;;;2,0;1,0;;1,0;11,0;;6,0;;;;13,0;6,0;;4,0;3,0;6,0;;;;6,0;;18,0;3,0;;;1,0;;;1,0;7,0;4,0;;;;1,0;;;;;;21,0;;50,0;3,0;;2,0;;;;;;14,0;18,0;3,0;;;13,0;;27,0;2,0;;;;;;;;1,0;13,0;1,0;;;2,0;1,0;;1,0;;2,0;3,0;;;2,0;1,0;18,0;8,0;1,0;;;1,0;;2,0;2,0;;;1,0;;;;;;1,0;;3,0;;;;;1,0;2,0;;;;1,0;3,0;9,0;2,0;43,0;;;;;;;;7,0;;;;11,0;;2,0;;;;;;;;;;;16,0;3,0;;1,0;;;;;;2,0;;;16,0;;;;;;;;6,0;;;;;;10,0;6,0;1,0;;;;4,0;4,0;2,0;31,0;;;;3,0;;;;;;2,0;15,0;;;;;18,0;1,0;;;8,0;;1,0;6,0;2,0;;;;2,0;1,0;;;;7,0;;;;;;;;;;;7,0;;4,0;;2,0;4,0;;;;;;;;;;;6,0;1,0;;;;1,0;;17,0;;;;;;;;;9,0;;;1,0;;;;;;;;;;;;2,0;3,0;;;;;;;1,0;;;2,0;;;2,0;;;1,0;;;;;;;3,0;;;;;1,0;1,0;7,0;1,0;1,0;;;;;;;;;;;;3,0;;;3,0;;;1,0;;;;;;;;4,0;6,0;21,0;;;1,0;;3,0;;;;;23,0;;;;;;3,0;;6,0;;;;1,0;;;2,0;;;2,0;2,0;;;;;;;;;;;;1,0;;;2,0;;1,0;;;;;;14,0;;;;;;;11,0;;;;;;;;;;;6,0;1,0;;;;11,0;;;;;;3,0;;;;;6,0;;;9,0;;;;;;;;6,0;;;;;;;;;;;;;;;;;5,0;;;;;;;;9,0;;;50,0;;;;;1,0;;;;;;;;;;;;17,0;;;2,0;;;;;;;;;;3,0;;;;;;;11,0;;7,0;;;;;6,0;;;;;4,0;2,0;;;4,0;2,0;2,0;;;;1,0;;;;;;;;3,0;;;;;;;;;;;;;;2,0;;;6,0;;;;;;;;3,0;;;;1,0;;;;;;;;;2,0;;;;;1,0;;3,0;1,0;1,0;;;;;;1,0;;;1,0;;;;;;9,0;;;;8,0;;;;;;;;;;;;;;;;;;;;;;;;;;;;;;;;;;;;6,0;;;12,0;;2,0;;2,0;;;;;;;;;;;;;;;;10,0;;;2,0;;;1,0;;;;;;;;;;;;;1,0;;;;;;;;;;;;;;;;;;;;;;;2,0;;;;;;;;;;;;;;;;;;;;;;;;;;;;;;;;;;;12,0;;;;2,0;;1,0;;;;;;;;;;;;;;;;;;;;;7,0;;5,0;;;;;;;;;4,0;;4,0;;;;;1,0;1,0;;;3,0;;;;;;;;;;;;;;;;;;;;;;1,0;
cure;;;9,0;;;2,0;8,0;2,0;;;;;;;;;;;;4,0;;;;;;;;;;;;;;;;;1,0;3,0;;;;5,0;;;;1,0;;3,0;;;;;;;;;9,0;;;;3,0;;;;6,0;;2,0;;;;;57,0;29,0;3,0;;;7,0;;;;76,0;;;;8,0;;;16,0;19,0;;;;;;;1,0;;;;;3,0;;2,0;325,0;;;;;2,0;;;;;6,0;;;;;;6,0;;;;;;;1,0;;;5,0;55,0;;;3,0;;12,0;;;;;;;;;;3,0;3,0;;;22,0;;1,0;;1,0;;;;1,0;5,0;;1,0;;;;;;1,0;;;;;;;;;;;;;;;;4,0;;;7,0;5,0;;;;;;13,0;15,0;6,0;;16,0;;12,0;;1,0;;4,0;;;;6,0;;;2,0;9,0;4,0;;;;2,0;;;;;;46,0;;;2,0;;4,0;;;3,0;;143,0;1,0;;4,0;;;;;;17,0;2,0;;;3,0;;;1,0;;;;1,0;;;2,0;;;8,0;;;;;;9,0;;;;1,0;;;;;;;;;;;;;2,0;;1,0;12,0;;;;;12,0;;1,0;;;;1,0;;;;;;1,0;;;;;;1,0;1,0;;9,0;;;;;;;;;;;;2,0;;;;;;;;16,0;;;;1,0;;;;;;;;6,0;;;;3,0;;;;;;;;;;;;;;;;;;;;;;;;;;;;;;;;;;;;;;;;;;;;;;;;23,0;;;;;;;;;;54,0;;;;;;;;7,0;;;;;7,0;;;;;;;;;;;;;;;;;;;;;;;;7,0;;;;;;;;;;;;4,0;;;;;;;;;;;;;;;;;;;;;;;;;;;;;;;2,0;;;;;;;;;;;;;;;;;;;;;;;1,0;;;;;;;;;;;;;;2,0;;;;;;;2,0;;;;;;;;;;;24,0;;;10,0;;;;;;;;;;;;;;;;;;;;1,0;;52,0;;;;;;;;;;386,0;;6,0;;;;;;;;;;1,0;;;;;;;;;;;;;2,0;;;;;;;;;;;;;;;;;;;;;21,0;;;;;;;;;;;;;;;;;;;;;;;;;;;;;;;;;;;;;;;;;;;;;;;;;;;;51,0;;;;;;;3,0;;;1,0;;;;;1,0;1,0;;;;;;10,0;;;;;;;;;;;;;;;;;;1,0;;;;;;;;;;;;;;;;;;;;;;;;;;;;;1,0;;;5,0;;;;;;;;;;;;;;;;;;;;;;;;;;;;1,0;;;;;;;2,0;;;;;3,0;1,0;;;;;;;;;;;;;;;;;;;45,0;;;;;;;;;;;;;;;;;;;;;;;;;;;;;;;;;;2,0;;;;8,0;;;;;;;;;;;;;;;;;;1,0;;;;;;;;;;;;;;;;;;;;;;;;;;;;;;;;;;;;;;;;;;;;;;;19,0;;;1,0;;;;;;;;;;;;;;;;;;;;;;;;;;;;;;;;;;;;;;;;;;;;;;;;;;;;;;;;;;;;;;;;;;;;;;;;;;;;;;;;;;;;;;;;;;
decrease;;;1,0;3,0;14,0;4,0;9,0;2,0;;;;1,0;;16,0;;22,0;15,0;;1,0;;;;5,0;;;;;;;1,0;18,0;2,0;2,0;1,0;;7,0;6,0;1,0;5,0;1,0;5,0;14,0;10,0;1,0;12,0;4,0;;;;5,0;;;5,0;;2,0;3,0;7,0;;3,0;3,0;;;9,0;1,0;50,0;;13,0;92,0;;;3,0;10,0;8,0;;3,0;2,0;;;;1,0;18,0;;1,0;;19,0;3,0;;15,0;;9,0;11,0;;;3,0;2,0;;7,0;;5,0;6,0;8,0;25,0;;2,0;7,0;5,0;;;2,0;1,0;;4,0;13,0;;;;17,0;;12,0;6,0;2,0;;12,0;17,0;;2,0;10,0;;;10,0;3,0;;;14,0;5,0;;8,0;14,0;9,0;4,0;;2,0;;2,0;;8,0;8,0;;;;;;1,0;2,0;4,0;;;;;;;;;3,0;;;;;;;1,0;;;29,0;1,0;6,0;;3,0;;;1,0;;;;1,0;;5,0;;12,0;1,0;3,0;;;;;3,0;4,0;;;;;1,0;2,0;6,0;8,0;;2,0;;;;3,0;6,0;;;;4,0;5,0;3,0;;4,0;4,0;12,0;;8,0;3,0;;19,0;1,0;;;;;12,0;12,0;1,0;;;5,0;;;;5,0;;;;;;2,0;7,0;;1,0;;;;;10,0;;5,0;;;1,0;;;6,0;;;;;3,0;;;8,0;3,0;;;;;11,0;;;;;8,0;;;;;7,0;1,0;;;;;1,0;4,0;;29,0;;;;;;;;;;;;;;4,0;;1,0;;;;;;1,0;;2,0;11,0;1,0;2,0;1,0;;;;18,0;;1,0;;;;;;;;;;;;;1,0;;;;1,0;;2,0;;;4,0;2,0;2,0;6,0;;;2,0;;3,0;;;;;1,0;;3,0;;;;1,0;3,0;10,0;7,0;1,0;;5,0;;;20,0;;1,0;;1,0;10,0;1,0;1,0;3,0;1,0;2,0;;;3,0;2,0;6,0;;5,0;;;;2,0;;27,0;;;1,0;1,0;1,0;;;;;;1,0;4,0;;;;;;10,0;3,0;;;1,0;;4,0;3,0;1,0;;;10,0;;32,0;;;2,0;;;;3,0;11,0;11,0;;;;;3,0;;5,0;3,0;5,0;;;;;1,0;;;3,0;;1,0;;;9,0;1,0;;;;1,0;;;;5,0;;4,0;;;;;2,0;;;;;2,0;1,0;1,0;;;;;8,0;;;;;1,0;;;;;1,0;;1,0;;;;;;4,0;1,0;;;;;;;;;3,0;;;;;;;1,0;1,0;;2,0;;12,0;7,0;;;2,0;2,0;;;;;1,0;;20,0;;;;1,0;;;;;1,0;2,0;;;;;;;1,0;;;;;;;;;;;;3,0;;;;;;2,0;;3,0;;;1,0;;;;;;;10,0;2,0;;;;;;;;;;;;;;1,0;6,0;;;;;;;;;;;1,0;;;14,0;;;;;;;;;;;1,0;;;;;;;;;;1,0;1,0;;;;;;;;;;;;;3,0;;;;;2,0;;2,0;;;;1,0;;;;;;;3,0;;;12,0;;8,0;;;;;1,0;1,0;2,0;;;2,0;;;;;1,0;;2,0;;;2,0;;;8,0;3,0;;1,0;;1,0;;2,0;1,0;3,0;;;4,0;;;;6,0;;;1,0;;2,0;;;;3,0;20,0;;;;;3,0;;;;;1,0;1,0;;1,0;1,0;;3,0;;;;1,0;;;;;;;;;;;2,0;;;;;;;;;;3,0;;1,0;;;;;;;;;;;;;;;11,0;;;;;;;;;8,0;;;;;;1,0;14,0;;2,0;10,0;3,0;1,0;;;;;;;2,0;1,0;;;;1,0;1,0;;;;;;;;;;;;;2,0;3,0;8,0;;;;1,0;;;;;;;;;;;;3,0;;;;;;;;;;;;;;;;;2,0;2,0;;;;1,0;;;3,0;;2,0;;;;1,0;;;;;;;;;;;;;;;;;;;;;;;;2,0;1,0;;;;;;;3,0;;;;;;;3,0;;;;;6,0;;;;;;;;;;;;;;;;;;;;;;;;;;;;;;;;;;;2,0;;;;;;;;;;;;;4,0;1,0;4,0;;;;;;;;;;1,0;;;;;;;;2,0;;;;
defect;;;1,0;;1,0;1,0;4,0;3,0;;;;;;;;;3,0;;;;;;;;4,0;1,0;2,0;66,0;2,0;;10,0;;11,0;5,0;;8,0;;4,0;;;15,0;7,0;;1,0;;;;;;2,0;2,0;;;;1,0;;;;;10,0;1,0;;;;47,0;;21,0;;;;;2,0;1,0;;;;;;;2,0;19,0;;;;3,0;;;2,0;;2,0;;;;;;;49,0;;35,0;;;11,0;;9,0;19,0;14,0;;;4,0;;;;8,0;;;;;;;;;;14,0;;;2,0;12,0;;1,0;;;;;1,0;;;;;;;;2,0;;;2,0;2,0;;;;;;;;;;;;;;;;;;;;;;1,0;;25,0;1,0;;;;;2,0;;;2,0;;;;;;;;;;;;;;;;;;;;;;;;;;;;;;;;;;;;;13,0;11,0;;;30,0;3,0;;;;;;7,0;;1,0;;;1,0;12,0;;;;;;;;;;;;;29,0;;;;;;;2,0;;;;12,0;15,0;;;1,0;;1,0;;;;;;;;;;;;;;;;;;;;;;;;;3,0;44,0;;;;;;;;12,0;;;;;;;;;;;;;59,0;;;;;;;;;;;;7,0;;;;;;;;;;;;;;;;;;;;;;;;;;;;;;;;;4,0;;;;;;;;;;;;;;;;;;;;;;;;6,0;;;1,0;;;;15,0;1,0;;;;2,0;;;1,0;;;;23,0;8,0;1,0;;;1,0;20,0;;9,0;;;;;;;;;1,0;;;;;;;;;;2,0;;;6,0;1,0;;;;;;;;;;;;;;4,0;1,0;3,0;;36,0;;;;;;;;;;;7,0;;;4,0;1,0;;;;1,0;;;;;;;;;;;;;;;;;;;;;53,0;;;;;7,0;;;;;;;3,0;;;;;;;;2,0;;;;;;;;;;;;;;;;;;5,0;;;;;;;;;;;;;;;;;;;;;;;;;;;;;;;;;;;;;;;;;;;;;;;;;;;;;;;;;;;23,0;;;;;2,0;;;;;;;;;;;;;;;;;;;;;;;2,0;6,0;;;;;;1,0;;;;;;;;3,0;24,0;;;3,0;2,0;;;;;;;;;;;;;18,0;;;;;;;;;;;;;1,0;;;1,0;;;;;;;;;;;;;;1,0;;;;20,0;;;;;;;;;;;;;;;;;;;;;;;;;;;;;;;;;;;;;;;;;;;;;3,0;;;;;;;;;;;;;;;;;4,0;;;;;;;;;2,0;;;;;;;;;;;;;;;;7,0;;;;;;;;;;;;;;;;;;;;;;;;;;;2,0;;;;;;;;;;;1,0;;;;;1,0;;;24,0;;;;;;;;1,0;;;;;;;;;;;2,0;;2,0;;;;;5,0;;;;;;;;;;;;;;;;;;;;1,0;;;;1,0;;;;;;;;;;;;;;;;;;;;;;;;1,0;;;;;;;;6,0;;;;;;;;;;;;;;;;;;;;;;;;;;;;;;;;;;1,0;;;;;;;;;;;;;;;;;;;;;;;;;;;;;;;;;;;;;;;;;;;2,0;;;;;;;;;;;;;;;;;;;;;;;;;;;;;26,0
dental;;;1,0;;;3,0;4,0;;;;;;;48,0;;;31,0;;2,0;;;;4,0;;21,0;;;;13,0;;66,0;;6,0;;;9,0;;2,0;;;6,0;7,0;;2,0;3,0;;;;;;;4,0;;;11,0;1,0;;;;;;;1,0;;112,0;;8,0;;;;;9,0;13,0;;;;;7,0;;2,0;16,0;;;5,0;15,0;;;4,0;8,0;;;;;;16,0;;;;20,0;6,0;16,0;;;3,0;;11,0;;5,0;;;;1,0;1,0;;;;;1,0;;27,0;;;1,0;;1,0;4,0;56,0;;;;3,0;;;2,0;;;15,0;;;;;;;;;;58,0;1,0;4,0;2,0;;;;;;24,0;;;;;;31,0;;1,0;;;;;;;2,0;;;3,0;;;;;;;;;;8,0;;;;;7,0;;;;;;;;1,0;;;1,0;;;;;4,0;;;;268,0;1,0;1,0;1,0;;;;;;;;;3,0;;;;;;22,0;;;;;;5,0;1,0;;1,0;1,0;;2,0;12,0;;;;;;1,0;;1,0;;;;;;1,0;;13,0;;33,0;;;;13,0;;;;1,0;;1,0;;4,0;;;;;1,0;;;2,0;;;3,0;;4,0;;;;;;;;;11,0;;;;;1,0;;;;;;;;;;22,0;12,0;;5,0;1,0;;;;;;;;;4,0;;16,0;;5,0;;;;;50,0;;;;;;16,0;;1,0;;;;1,0;7,0;;;;;;4,0;;;;;;;4,0;;;;14,0;21,0;;;6,0;;;;1,0;;;;;;;14,0;;;2,0;;7,0;;3,0;1,0;;;2,0;4,0;;;;;4,0;2,0;;1,0;;1,0;2,0;3,0;14,0;;;1,0;2,0;;;;;2,0;2,0;;;;;;;46,0;;;;;;;;;;25,0;4,0;;;;2,0;;;;;;5,0;3,0;1,0;;;;;;;;;;1,0;;1,0;;;;;2,0;3,0;;;;2,0;;;2,0;;;;;;;;;;4,0;5,0;;;;;;;;1,0;;;;3,0;;;;;;;1,0;;22,0;;;;;1,0;3,0;;;;;;;;;3,0;;3,0;;;;;;;;3,0;;1,0;;;;;;;;;;;;;;;;;1,0;;;;;;;;;2,0;;;;1,0;1,0;;;;;;;;;;;;;;;;;;2,0;;;;;;;;;;2,0;;2,0;;2,0;;;;;;;;;;;;;;;3,0;;;1,0;;2,0;;;;;;2,0;;;;;;;;;;;;65,0;;;;;;46,0;;;;1,0;;;;;;;;;;;;;;;;;;;;;;;2,0;;;;6,0;;4,0;;;;;;1,0;;4,0;28,0;;4,0;;;;;;;;2,0;;;2,0;;;;;;;;;;;;;;;;;;;;;;;;;;;;;1,0;;5,0;;;;;3,0;1,0;;;3,0;1,0;;;4,0;;;;;;4,0;;;;;;;;;;;;;1,0;;;;;;;;;;;;;;;2,0;;;;;;17,0;;;2,0;2,0;;;;;;;;;;5,0;;1,0;;;;;;;;;;;;1,0;;;;;;;;;;;3,0;;;;;;;;;;;;;;;;;;;;;;;;;;;;;;;;;;;;;;;;;;;;4,0;;;;;;;;;;2,0;38,0;;;;;;;;;;;1,0;;;;;;;;;;;;;;;2,0;;;;;;;;;;;;;;;;1,0;;;1,0;;;;;;;;;;;;;;;;;;;;;;;;;;1,0;;;;;;;;;;;;;;;;;;;;;;;;;;;;;;;;;;;;;;;2,0;;;;;;;;;;;;;;;;;;;;;;;;;;;
desire;;;16,0;9,0;33,0;26,0;27,0;6,0;6,0;;;;1,0;33,0;;1,0;30,0;;1,0;8,0;;4,0;2,0;;3,0;;;2,0;4,0;4,0;27,0;4,0;;5,0;;31,0;1,0;2,0;2,0;2,0;90,0;49,0;1,0;11,0;29,0;3,0;;21,0;;3,0;4,0;;2,0;2,0;38,0;4,0;;;3,0;13,0;;;;2,0;178,0;3,0;11,0;1,0;;;12,0;28,0;38,0;1,0;;1,0;;27,0;3,0;1,0;69,0;;;;15,0;;;10,0;;5,0;1,0;1,0;;;6,0;;13,0;8,0;15,0;23,0;149,0;7,0;2,0;;4,0;6,0;2,0;2,0;1,0;;;3,0;18,0;;;5,0;25,0;1,0;20,0;58,0;1,0;;33,0;30,0;3,0;7,0;33,0;;1,0;5,0;12,0;;;10,0;1,0;;70,0;11,0;16,0;;;;;;;1,0;24,0;;29,0;5,0;1,0;;;;;1,0;;1,0;;;;1,0;4,0;;1,0;;;;1,0;;;;9,0;60,0;;1,0;;1,0;4,0;;;;;2,0;;4,0;1,0;;8,0;;;3,0;;1,0;4,0;4,0;10,0;;;;;6,0;;3,0;2,0;;11,0;;;22,0;15,0;14,0;2,0;;;;10,0;1,0;;1,0;2,0;2,0;4,0;1,0;2,0;;5,0;;;7,0;;6,0;57,0;3,0;1,0;;2,0;;;15,0;;1,0;1,0;;;35,0;3,0;3,0;1,0;;;;1,0;2,0;;2,0;6,0;24,0;;;;2,0;2,0;7,0;;;;15,0;;4,0;;;;;;;1,0;25,0;;2,0;1,0;1,0;3,0;;;;1,0;;;;;;;;;;74,0;4,0;;;2,0;;1,0;;;;1,0;3,0;5,0;;;;;;;;2,0;3,0;;;8,0;63,0;1,0;3,0;;;;;3,0;;;;;;2,0;;1,0;;2,0;;5,0;5,0;3,0;;;3,0;12,0;;;;;;4,0;;7,0;1,0;;;24,0;1,0;;5,0;;;;9,0;;11,0;;1,0;2,0;;7,0;4,0;9,0;1,0;;;1,0;;22,0;1,0;;;;13,0;2,0;3,0;2,0;2,0;2,0;2,0;5,0;15,0;;21,0;5,0;16,0;10,0;;;13,0;3,0;17,0;;27,0;;3,0;33,0;17,0;;14,0;;6,0;7,0;41,0;;3,0;;;;6,0;9,0;6,0;;22,0;3,0;16,0;;;3,0;;;1,0;15,0;2,0;1,0;9,0;2,0;3,0;;;2,0;11,0;4,0;;;4,0;64,0;;2,0;15,0;;1,0;11,0;;;;;2,0;7,0;;;1,0;2,0;;;;;;10,0;;;;;1,0;;;;;;;;4,0;;;5,0;7,0;9,0;6,0;7,0;6,0;1,0;;;;8,0;;;;4,0;2,0;;2,0;12,0;7,0;1,0;;;;;1,0;;;;1,0;;;6,0;;2,0;;;;3,0;;;2,0;;;;;1,0;6,0;9,0;;;4,0;3,0;;15,0;;1,0;;;;;;;3,0;2,0;;1,0;2,0;8,0;5,0;;1,0;;;1,0;;;;7,0;;46,0;;;2,0;;;2,0;;3,0;1,0;1,0;;;;1,0;;;1,0;;;;4,0;1,0;2,0;;2,0;;1,0;;;;10,0;2,0;;16,0;;;3,0;;2,0;1,0;11,0;;;;;1,0;;;;;5,0;;1,0;;;8,0;4,0;;;;;;2,0;;;;;;;;;;;;;;5,0;;;;;;;;;;;;3,0;9,0;3,0;1,0;2,0;;3,0;;;4,0;;;1,0;;;8,0;;1,0;;;1,0;;1,0;16,0;;;1,0;;5,0;;10,0;;;;;;;;;;1,0;;1,0;2,0;;;;5,0;28,0;16,0;;1,0;;;4,0;;3,0;;2,0;;2,0;;;;2,0;;;2,0;1,0;;2,0;1,0;;;2,0;;;;;17,0;;;3,0;;;3,0;5,0;;;;;1,0;;;;;;;;;;;;;;4,0;;;;;1,0;;;;;;;3,0;2,0;1,0;;;;;;;;;;;;;;;;;;;3,0;1,0;;1,0;;8,0;;;;;;;;;;16,0;2,0;;1,0;;;;;;;4,0;;;6,0;;;;2,0;;1,0;;;;;;;;;6,0;;;;1,0;;16,0;;;1,0;;;;15,0;;;1,0;;;;1,0;;3,0;1,0;;2,0;;1,0;;;;;;2,0;2,0;;1,0;;;1,0;;;;;;;;5,0;;;;;2,0;;;;1,0;;;;1,0;1,0;2,0;;;1,0;1,0;7,0;;;;1,0;;3,0;;;;;;;;;;;;;;;;;4,0;;;4,0;;;;;;;;;;;;;;2,0;;;;;;;;;;;;;;;;;;;;;2,0;;;;;;;;;;;;;;;;;;;2,0;;;;;;;;;;2,0;;;;;;
direct;;;1,0;23,0;7,0;32,0;28,0;43,0;;;;9,0;12,0;36,0;;;127,0;3,0;15,0;11,0;11,0;1,0;18,0;24,0;23,0;;;60,0;9,0;;181,0;14,0;8,0;1,0;;31,0;8,0;4,0;11,0;4,0;43,0;405,0;;21,0;37,0;14,0;8,0;80,0;;1,0;7,0;4,0;3,0;1,0;28,0;7,0;37,0;;4,0;46,0;4,0;;3,0;;319,0;3,0;62,0;;1,0;1,0;4,0;282,0;661,0;;2,0;2,0;2,0;16,0;7,0;13,0;91,0;3,0;30,0;2,0;43,0;3,0;1,0;83,0;7,0;1,0;10,0;3,0;24,0;4,0;1,0;;12,0;35,0;97,0;40,0;80,0;6,0;18,0;1,0;40,0;109,0;1,0;42,0;;1,0;;7,0;35,0;;;;4,0;14,0;37,0;165,0;1,0;1,0;41,0;2,0;16,0;14,0;92,0;;;;19,0;;3,0;38,0;;;45,0;;3,0;1,0;;12,0;;;28,0;7,0;17,0;28,0;44,0;2,0;8,0;6,0;17,0;;1,0;;;;2,0;;4,0;24,0;4,0;;9,0;;25,0;4,0;;9,0;6,0;;;118,0;;;2,0;11,0;3,0;;;1,0;;21,0;;;25,0;7,0;6,0;35,0;4,0;;12,0;2,0;4,0;17,0;52,0;18,0;9,0;;;19,0;;;11,0;13,0;21,0;4,0;74,0;33,0;26,0;25,0;9,0;1,0;2,0;20,0;20,0;10,0;15,0;36,0;9,0;;8,0;;18,0;;70,0;1,0;5,0;11,0;;37,0;8,0;;32,0;;28,0;13,0;;7,0;;1,0;1,0;;;20,0;15,0;1,0;40,0;6,0;2,0;;10,0;19,0;3,0;13,0;14,0;68,0;;;8,0;23,0;;45,0;8,0;;1,0;17,0;;27,0;3,0;;8,0;3,0;8,0;;16,0;29,0;4,0;;;;39,0;2,0;;;8,0;1,0;10,0;8,0;;22,0;2,0;2,0;;2,0;2,0;2,0;1,0;1,0;;;;40,0;;;1,0;7,0;;27,0;;;;2,0;;;11,0;2,0;12,0;24,0;28,0;79,0;11,0;1,0;5,0;;2,0;;7,0;1,0;;;;4,0;8,0;2,0;;;;;11,0;6,0;2,0;2,0;9,0;4,0;14,0;9,0;4,0;3,0;;2,0;;;4,0;1,0;4,0;;97,0;;3,0;;1,0;1,0;2,0;;4,0;5,0;;;3,0;;1,0;18,0;5,0;;8,0;5,0;1,0;5,0;70,0;3,0;;;9,0;19,0;8,0;;;;;47,0;2,0;8,0;5,0;7,0;;10,0;6,0;;;17,0;6,0;4,0;6,0;26,0;4,0;7,0;1,0;20,0;;13,0;;7,0;11,0;12,0;;;;;;2,0;;6,0;2,0;81,0;;3,0;3,0;;10,0;2,0;5,0;6,0;3,0;5,0;14,0;36,0;30,0;;;7,0;6,0;11,0;3,0;2,0;;2,0;74,0;9,0;1,0;8,0;1,0;1,0;4,0;1,0;6,0;11,0;;5,0;8,0;1,0;3,0;1,0;;1,0;1,0;1,0;;14,0;3,0;1,0;25,0;31,0;3,0;;34,0;2,0;;2,0;1,0;1,0;14,0;6,0;11,0;2,0;10,0;13,0;3,0;2,0;;;;7,0;3,0;44,0;11,0;3,0;25,0;;2,0;7,0;1,0;3,0;;9,0;8,0;;1,0;;11,0;;;;;2,0;4,0;4,0;1,0;;34,0;4,0;;;;;5,0;;12,0;1,0;6,0;;;5,0;5,0;4,0;;13,0;2,0;;2,0;;1,0;10,0;;;;;13,0;;13,0;;;4,0;5,0;;5,0;;;;3,0;1,0;1,0;;5,0;;7,0;12,0;11,0;1,0;;1,0;;;1,0;9,0;10,0;7,0;;2,0;;;122,0;;;1,0;;2,0;2,0;16,0;52,0;;;5,0;3,0;;4,0;13,0;3,0;;1,0;7,0;1,0;;;;;28,0;;3,0;3,0;;;3,0;2,0;;1,0;8,0;;9,0;6,0;;;1,0;276,0;;3,0;;;6,0;;;;60,0;2,0;3,0;;1,0;3,0;;;3,0;8,0;2,0;;25,0;4,0;;;2,0;;;2,0;;;13,0;;;11,0;1,0;1,0;1,0;;1,0;2,0;6,0;2,0;7,0;;;78,0;;2,0;2,0;4,0;;1,0;;31,0;;;;;13,0;2,0;3,0;6,0;1,0;;1,0;1,0;5,0;;1,0;1,0;49,0;;9,0;;;2,0;;8,0;5,0;3,0;;1,0;1,0;;4,0;;;1,0;;6,0;33,0;;;2,0;4,0;;;;1,0;1,0;7,0;;;3,0;;2,0;1,0;3,0;1,0;8,0;;;;;;2,0;;;;;;7,0;16,0;9,0;;3,0;;;10,0;;;;;2,0;;;7,0;;2,0;;1,0;;;7,0;;;;6,0;;1,0;1,0;4,0;;16,0;2,0;1,0;;;;11,0;;4,0;1,0;;;;;1,0;;;;1,0;;4,0;;;;3,0;;;;;;2,0;;;;10,0;;;;3,0;;;;3,0;8,0;2,0;;2,0;1,0;;2,0;1,0;1,0;6,0;;6,0;;;;;;;;;;1,0;;;2,0;;1,0;2,0;1,0;2,0;2,0;3,0;;;;;1,0;;3,0;;9,0;1,0;;2,0;14,0;;;8,0;;1,0;;;9,0;1,0;;;1,0;3,0;3,0;;;1,0;1,0;;;1,0;;;;;1,0;4,0;;2,0;;3,0;1,0;8,0;;;;;;5,0;1,0;11,0;;;;12,0;;3,0;;2,0;1,0;;;;2,0;;;;1,0;;;;;4,0;;;;;2,0;;1,0;;2,0;;;;2,0;;;;3,0;;1,0;;;1,0;;;;2,0;;;1,0;;;;4,0;;;;;;26,0;7,0;;;7,0;1,0;2,0;;;3,0;2,0;3,0;;4,0;;;5,0;;4,0;7,0;;;2,0;;3,0;;1,0;;;;;;
endoscope;;;3,0;7,0;;7,0;7,0;24,0;;;;;2,0;6,0;;;11,0;;5,0;2,0;;;;;;;;25,0;;4,0;20,0;13,0;;1,0;;18,0;1,0;;;;3,0;17,0;2,0;;16,0;2,0;;9,0;;;;4,0;2,0;;8,0;;1,0;;;9,0;2,0;1,0;;;51,0;;19,0;1,0;;;;18,0;26,0;;;;5,0;;;6,0;17,0;;;;7,0;;;29,0;1,0;;4,0;3,0;4,0;;;;10,0;2,0;5,0;2,0;19,0;;;1,0;1,0;16,0;;;;;;;32,0;;1,0;;1,0;;;19,0;;;8,0;6,0;;3,0;37,0;;;;6,0;;;;;;7,0;1,0;5,0;;;;;;1,0;;;4,0;5,0;7,0;;;17,0;;;;1,0;;;;1,0;8,0;;;;;14,0;9,0;;;1,0;;;4,0;1,0;2,0;;4,0;1,0;19,0;;;;4,0;;;1,0;;;5,0;;3,0;;3,0;9,0;;60,0;1,0;9,0;15,0;;;;;;;;1,0;6,0;;;;3,0;;;8,0;1,0;;;;;;;;;;22,0;;;;2,0;14,0;1,0;4,0;;;1,0;4,0;3,0;1,0;;;1,0;;3,0;1,0;;2,0;14,0;;;;;;;2,0;;16,0;;;1,0;12,0;;;12,0;;;2,0;;10,0;;2,0;;3,0;;;1,0;;;;;;9,0;5,0;;;;;4,0;;;;1,0;8,0;1,0;35,0;8,0;;;5,0;;;9,0;;;;15,0;10,0;;14,0;;13,0;2,0;;9,0;;1,0;;;;;4,0;1,0;10,0;;2,0;;;5,0;;;26,0;;;;;;;;19,0;1,0;12,0;3,0;;;;7,0;;;;;;;;;5,0;;;18,0;1,0;;;;;;1,0;1,0;;5,0;;;;2,0;4,0;;5,0;;;;;15,0;;;;;;;1,0;;;;;;;;;;1,0;;;;5,0;;;;;1,0;;;;;;;;;;;;;;;;;;;12,0;;;;;8,0;2,0;;;;;5,0;;1,0;;;1,0;;;;;;1,0;4,0;;;;;;;;;9,0;;5,0;1,0;;;;;;;;;;;;;3,0;1,0;;;;;1,0;;;;4,0;3,0;;3,0;;;;;;;;;;3,0;;2,0;;19,0;4,0;2,0;;;1,0;;;;;;2,0;1,0;;;1,0;7,0;2,0;;;2,0;1,0;;;;;;;25,0;;3,0;;;1,0;1,0;;;;1,0;;;;;1,0;;;;;;;;2,0;;;;;;;;;;;;1,0;;;;;;;;;;;;1,0;1,0;;2,0;;;;;3,0;;11,0;;;;;;;;;;;;;4,0;;;;;;;;;;;;;;;;1,0;;;;;22,0;;;2,0;;;;;;;;;;;2,0;;;;;;;;;2,0;;;;;3,0;;;;;;;4,0;;;;;;;;;;;;;;;;26,0;;3,0;;;;;;7,0;;;3,0;6,0;;4,0;;;;1,0;;;;;;;1,0;;5,0;;;;7,0;;1,0;;2,0;;;1,0;4,0;;;;;4,0;8,0;;1,0;;;;;1,0;;;1,0;;;;;;;;;14,0;;1,0;13,0;;;;;;;;;;3,0;2,0;;;;;;;;;;6,0;;;;;2,0;;;3,0;;1,0;;;;;;;;;;;;;1,0;;;1,0;;;;;;;;;;;;;;;;;;;;;;;;5,0;;;;;;;;;;;;1,0;5,0;;;;;;;;;;;;1,0;;1,0;;;;;;;;;;;;;;;;;;;1,0;;;;;;;7,0;;;;;1,0;;;;;;;;34,0;;;;;;;;;1,0;;;;;;;;4,0;;;;;;;;;;;;;;;;;1,0;1,0;4,0;;10,0;;;;;;;;;;;;;;;;;;;;;;;;;;;;;;;;;;1,0;;;;;;;;;;;;;2,0;;;;;;;2,0;;;;;;1,0;;;;;;;;;;;;;;;;;;;;;;;;19,0;;;
environment;;;1,0;23,0;2,0;39,0;14,0;11,0;;;;;1,0;133,0;;27,0;175,0;;;1,0;1,0;;28,0;;3,0;;6,0;18,0;15,0;35,0;77,0;19,0;2,0;;;117,0;17,0;24,0;43,0;6,0;149,0;160,0;;23,0;53,0;9,0;;10,0;;3,0;35,0;;2,0;25,0;29,0;;1,0;;4,0;80,0;;2,0;5,0;27,0;542,0;1,0;77,0;1,0;2,0;;;42,0;99,0;;;;1,0;8,0;5,0;9,0;155,0;;;134,0;41,0;3,0;;12,0;;2,0;44,0;2,0;3,0;;5,0;;10,0;14,0;91,0;58,0;106,0;29,0;;3,0;24,0;43,0;5,0;9,0;21,0;;;34,0;3,0;;;2,0;;7,0;39,0;81,0;15,0;;7,0;;3,0;24,0;104,0;;;;49,0;;;20,0;;2,0;97,0;111,0;;;;;4,0;;;13,0;9,0;3,0;23,0;11,0;;14,0;3,0;1,0;;;;;;;;8,0;3,0;2,0;;1,0;5,0;10,0;;1,0;13,0;;3,0;6,0;;11,0;;;;;3,0;7,0;15,0;9,0;;;3,0;2,0;20,0;1,0;;6,0;2,0;1,0;;2,0;25,0;2,0;2,0;;;;;;11,0;10,0;;;7,0;5,0;8,0;1,0;;3,0;3,0;7,0;6,0;3,0;;46,0;;2,0;5,0;;;;153,0;;6,0;9,0;;3,0;1,0;10,0;4,0;8,0;15,0;;;21,0;;;;;3,0;40,0;2,0;;1,0;;;;;28,0;;;5,0;38,0;40,0;;;13,0;;102,0;;4,0;;;1,0;5,0;1,0;4,0;;;;;2,0;25,0;;;;2,0;1,0;1,0;3,0;;;;2,0;10,0;;5,0;;;1,0;;13,0;12,0;;;;;1,0;;;;;7,0;;121,0;;;;;;;27,0;;2,0;2,0;27,0;195,0;;;4,0;1,0;;;2,0;;;;;;3,0;1,0;;;;;;;2,0;;;2,0;2,0;42,0;;;4,0;;2,0;;24,0;;;;125,0;;;;;1,0;5,0;;14,0;;;;;1,0;6,0;3,0;12,0;2,0;;3,0;24,0;1,0;30,0;18,0;;12,0;2,0;40,0;3,0;3,0;;12,0;4,0;3,0;4,0;2,0;10,0;7,0;;44,0;70,0;14,0;6,0;2,0;9,0;3,0;;71,0;4,0;12,0;32,0;5,0;;4,0;1,0;36,0;12,0;35,0;;;;;1,0;4,0;1,0;;4,0;73,0;9,0;20,0;;;8,0;1,0;4,0;7,0;1,0;;11,0;6,0;3,0;;96,0;15,0;35,0;;3,0;9,0;;5,0;90,0;;10,0;;;;;;;19,0;;2,0;42,0;;;7,0;;3,0;;;1,0;;;3,0;11,0;11,0;;;4,0;;1,0;11,0;;;3,0;7,0;;1,0;10,0;132,0;4,0;57,0;;;1,0;21,0;;;12,0;1,0;;2,0;4,0;3,0;3,0;1,0;3,0;;3,0;9,0;;;1,0;1,0;;;2,0;;;16,0;1,0;;;;5,0;1,0;;;;;2,0;10,0;;;;3,0;5,0;;;;;6,0;15,0;;;19,0;;12,0;;;;2,0;;;15,0;41,0;;4,0;;;;;7,0;;;3,0;7,0;;12,0;;5,0;;;;;;1,0;6,0;7,0;;2,0;1,0;;;4,0;3,0;1,0;;;;1,0;;;1,0;1,0;1,0;;2,0;5,0;;;;;;;67,0;8,0;;;;;;;;1,0;8,0;7,0;;;;4,0;;3,0;;1,0;8,0;;2,0;;2,0;;3,0;;;;6,0;;;;;;2,0;1,0;;3,0;;;9,0;;2,0;;6,0;;5,0;2,0;2,0;1,0;1,0;24,0;;;;;11,0;2,0;2,0;;;6,0;3,0;;5,0;19,0;1,0;2,0;;;2,0;1,0;14,0;10,0;;;;;8,0;;5,0;1,0;;;;3,0;;;;;;2,0;7,0;;;;;;1,0;1,0;;;19,0;;32,0;;1,0;;;;82,0;;;1,0;;;;;3,0;9,0;1,0;;;6,0;;;;;6,0;17,0;;;;2,0;2,0;;;;;;;2,0;2,0;31,0;;;;;;;;;;;4,0;;;;;;;3,0;;;;5,0;;9,0;;;;;;1,0;;;;;1,0;2,0;1,0;;;1,0;;;;13,0;;;;;;;;2,0;;;4,0;;;;;6,0;3,0;;;;;;2,0;;;;12,0;;2,0;1,0;;;;;1,0;;;;;;;;;;6,0;2,0;;;;5,0;;;2,0;1,0;3,0;1,0;;6,0;6,0;;4,0;2,0;;37,0;;;;1,0;71,0;;;12,0;;4,0;;;2,0;;12,0;;4,0;;4,0;1,0;3,0;;;;1,0;4,0;;;3,0;;14,0;;;;;;;1,0;;;1,0;;;;26,0;;;3,0;;;2,0;;;1,0;5,0;;;;;;2,0;11,0;;3,0;;2,0;;;9,0;;;;;;;;4,0;;;;;;;;;2,0;;;;;;;;3,0;;7,0;;;;;;3,0;14,0;;3,0;;;;;2,0;3,0;1,0;;1,0;;;;3,0;18,0;;;2,0;1,0;2,0;3,0;;1,0;31,0;1,0;;;;;;;;;;;;;;
evaluation;;;3,0;5,0;5,0;35,0;;;;;;7,0;;74,0;1,0;;32,0;;;;;;1,0;;;;;;5,0;20,0;79,0;6,0;9,0;11,0;;30,0;13,0;10,0;4,0;6,0;70,0;72,0;;2,0;13,0;;3,0;2,0;4,0;4,0;5,0;;;5,0;6,0;;1,0;;13,0;24,0;;;4,0;;284,0;;22,0;;1,0;;3,0;6,0;12,0;;;;;4,0;;1,0;66,0;;3,0;5,0;;3,0;;2,0;3,0;5,0;17,0;;;;;;18,0;;11,0;10,0;18,0;19,0;;3,0;9,0;8,0;;3,0;;;;3,0;81,0;;;2,0;18,0;15,0;2,0;27,0;2,0;;21,0;;7,0;13,0;34,0;;;;14,0;;;175,0;;;;1,0;2,0;;;4,0;;;2,0;1,0;62,0;1,0;4,0;;;3,0;5,0;;;;;;;;;3,0;;1,0;;1,0;;;;12,0;18,0;5,0;1,0;4,0;;1,0;;;2,0;;1,0;;1,0;;;;9,0;1,0;23,0;;;;;;;;;;;;;;;;5,0;10,0;;;;2,0;3,0;9,0;;;;;27,0;;;;3,0;;3,0;;;;12,0;;;2,0;;;13,0;;;5,0;1,0;;;21,0;;;;;;15,0;;1,0;15,0;;;;;8,0;;;;1,0;;;;5,0;;2,0;;;;;14,0;;;;2,0;10,0;;;;8,0;;1,0;;;3,0;;;;;;;;;2,0;;;2,0;;7,0;;;;;;;;;;;;;8,0;;;;;;;4,0;;1,0;;;75,0;;2,0;;;;;;;;;;;;;;;;;;;;;1,0;;1,0;;;;;;;;;;;;;;2,0;;;;;2,0;18,0;;;;;;51,0;;2,0;24,0;;;18,0;4,0;77,0;;1,0;1,0;16,0;37,0;;11,0;2,0;;4,0;;1,0;50,0;;22,0;;8,0;6,0;;;;2,0;15,0;;;;1,0;;;;;;2,0;5,0;1,0;;;1,0;1,0;;23,0;;3,0;4,0;12,0;4,0;4,0;2,0;;2,0;;;;4,0;;6,0;5,0;7,0;;;;28,0;;1,0;6,0;;;7,0;;1,0;;;;;;13,0;2,0;;;47,0;;;3,0;3,0;;;;;8,0;;;9,0;;;;3,0;;3,0;;;;;;;;38,0;;;3,0;;;;;;;3,0;;;;;;1,0;;;1,0;6,0;;;1,0;;5,0;;;;;;1,0;;;1,0;;;;5,0;;;;;;;;;;2,0;;;;;18,0;;5,0;1,0;;;;;;;;;;30,0;;;2,0;;;;;;;1,0;;2,0;;;;1,0;8,0;;;;;;;;7,0;;;;;4,0;;7,0;;;;1,0;1,0;;1,0;;;;;;;;1,0;;;;6,0;;;;;;;;;;;;;;;;;;;1,0;3,0;;;;;;;;;;;;;;;;3,0;;;;;;;;;;;;;;2,0;10,0;;2,0;;1,0;1,0;;;3,0;;;;;;;;9,0;;;;;;;;55,0;;;;;1,0;;;;;;;4,0;;;3,0;;;3,0;;;;;;11,0;;;;;;;;;;;;;3,0;;;1,0;;5,0;;;1,0;;;;;1,0;;;3,0;;;3,0;;;;;;;;;;;;;;;;;;;;2,0;;;;;;;;;;;;;;;;3,0;;;;;;;;;;1,0;;;;;;;;;147,0;;;;;;;;;;;;;;105,0;;2,0;;2,0;;;;;;;;;;;;;;;;;1,0;;;9,0;;;13,0;;;;4,0;5,0;;;;;;2,0;;;3,0;;;;;;;;;;23,0;;1,0;;;;;2,0;;;34,0;;;;;;;1,0;3,0;;1,0;;;;;;3,0;1,0;;;;;;;;;;;;31,0;;;;;;;;;;;;;;3,0;;;;;;;;;1,0;;;;;;;;1,0;;;;;;;1,0;;;;;;;;;;;;;;;;;;;;;;;;1,0;;;;;;6,0;3,0;;;;;;;;;;;;1,0;;;;;;;;1,0;;;;;;;;;;;;;;;;;
exposure;;;7,0;168,0;60,0;92,0;26,0;3,0;;;;2,0;;232,0;7,0;47,0;114,0;;;8,0;;;23,0;1,0;2,0;4,0;56,0;6,0;5,0;20,0;76,0;68,0;15,0;22,0;5,0;89,0;13,0;13,0;2,0;;212,0;172,0;;15,0;61,0;3,0;;5,0;;76,0;20,0;;;2,0;10,0;15,0;5,0;;6,0;45,0;1,0;;75,0;;805,0;4,0;146,0;30,0;38,0;3,0;20,0;42,0;174,0;5,0;10,0;5,0;;4,0;9,0;3,0;228,0;;52,0;;32,0;2,0;2,0;12,0;8,0;7,0;141,0;4,0;3,0;1,0;20,0;;334,0;10,0;124,0;7,0;49,0;46,0;;37,0;40,0;55,0;5,0;6,0;65,0;;;28,0;51,0;1,0;;;3,0;13,0;109,0;138,0;8,0;4,0;85,0;20,0;;41,0;153,0;;;;1078,0;17,0;;95,0;5,0;;2,0;13,0;10,0;;;;;;34,0;39,0;282,0;8,0;33,0;;11,0;3,0;6,0;1,0;;10,0;;;;;;2,0;3,0;6,0;3,0;;;16,0;14,0;5,0;1,0;36,0;;36,0;;2,0;2,0;3,0;11,0;;9,0;;11,0;13,0;;2,0;24,0;9,0;155,0;1,0;29,0;;;;1,0;;;1,0;;8,0;;;41,0;;30,0;17,0;14,0;;28,0;;12,0;;11,0;;;;14,0;;4,0;;30,0;177,0;;2,0;1,0;;19,0;;1,0;5,0;;6,0;77,0;50,0;;;6,0;;;8,0;;;;2,0;;111,0;1,0;;6,0;4,0;;;;19,0;2,0;2,0;;6,0;;;1,0;27,0;25,0;33,0;;;;3,0;11,0;6,0;;;5,0;3,0;;;6,0;1,0;;2,0;;5,0;1,0;;11,0;;;11,0;11,0;;;13,0;;;;;5,0;3,0;;2,0;;;;;;;;2,0;;75,0;;;;;;1,0;7,0;6,0;;4,0;18,0;31,0;;17,0;;;2,0;;16,0;;;;;;23,0;;6,0;;;1,0;14,0;4,0;;;;;;;;1,0;2,0;;15,0;;7,0;;2,0;21,0;21,0;;;;;;3,0;52,0;2,0;19,0;;45,0;;;108,0;9,0;93,0;24,0;;9,0;18,0;12,0;537,0;5,0;4,0;3,0;;26,0;16,0;37,0;22,0;;9,0;44,0;17,0;52,0;2,0;42,0;;15,0;2,0;;1,0;22,0;8,0;109,0;;15,0;4,0;4,0;14,0;;4,0;16,0;6,0;26,0;49,0;;;1,0;;7,0;;9,0;25,0;14,0;9,0;21,0;1,0;29,0;6,0;1,0;8,0;;211,0;;61,0;;1,0;11,0;28,0;;3,0;14,0;74,0;6,0;;9,0;;8,0;19,0;15,0;;2,0;7,0;;;;1,0;;;11,0;35,0;23,0;9,0;3,0;;1,0;3,0;;3,0;;8,0;3,0;9,0;;;;2,0;;;6,0;;;;13,0;;;63,0;2,0;2,0;;;;;11,0;3,0;3,0;8,0;;;;1,0;;;;2,0;5,0;;;;3,0;;24,0;;;5,0;34,0;;48,0;;;;;3,0;;1,0;3,0;;;;;;2,0;;;8,0;;28,0;;9,0;6,0;;16,0;1,0;65,0;;4,0;;9,0;;71,0;;;1,0;1,0;9,0;5,0;;;;;;19,0;;;4,0;;1,0;;;9,0;;;;22,0;2,0;;5,0;7,0;;2,0;30,0;;1,0;;2,0;;;;;1,0;;;4,0;11,0;;;;;4,0;6,0;105,0;;;20,0;;;;9,0;111,0;25,0;1,0;9,0;1,0;1,0;;;;;;9,0;7,0;;19,0;1,0;;;;4,0;;;;;;;;;;6,0;;17,0;;3,0;;;;;;;;4,0;4,0;2,0;5,0;;10,0;;3,0;3,0;7,0;;;2,0;;;51,0;;;;;;18,0;;5,0;10,0;;;;5,0;125,0;;;;;;1,0;2,0;1,0;;;;3,0;10,0;;13,0;;1,0;6,0;;;;;;5,0;8,0;9,0;;;;;8,0;;;;;;24,0;;;2,0;23,0;2,0;14,0;;3,0;26,0;;;;7,0;59,0;;;1,0;;14,0;1,0;;;6,0;;4,0;;;;;1,0;;;;42,0;38,0;;;;1,0;;;1,0;;;;;;;;;;;;;35,0;1,0;4,0;;;;;;1,0;;;;;;9,0;1,0;;5,0;7,0;131,0;;;9,0;;;;4,0;;;8,0;;;;;1,0;23,0;;7,0;5,0;;;2,0;;4,0;41,0;6,0;1,0;;;3,0;3,0;;3,0;;7,0;;2,0;4,0;34,0;;4,0;;2,0;;;;1,0;3,0;45,0;1,0;;6,0;;;5,0;16,0;;;1,0;;;6,0;19,0;;2,0;;1,0;;45,0;;;1,0;1,0;;;4,0;;2,0;;;;1,0;4,0;1,0;;12,0;;13,0;;2,0;;3,0;;;;4,0;;;;;;;;1,0;;;;6,0;;;;1,0;;4,0;;67,0;;18,0;;1,0;2,0;1,0;;;;1,0;;;;16,0;;;1,0;;;1,0;3,0;5,0;27,0;;;;;;;;;;;;;2,0;2,0;;;19,0;;;;;;;;;1,0;;;;;7,0;;;;;2,0;;3,0;;6,0;;1,0;;1,0;;;4,0;3,0;;;;;;;;1,0;1,0;;;;;;11,0;;;;1,0;;;;
gear;;;1,0;1,0;;25,0;1,0;54,0;;;2,0;;2,0;25,0;;;2,0;;2,0;;;2,0;;2,0;;;;3,0;;;38,0;5,0;;;;;;13,0;;;2,0;55,0;7,0;;13,0;12,0;;9,0;;;;;6,0;8,0;;;41,0;;;2,0;;;14,0;;6,0;2,0;48,0;;;;;24,0;7,0;;;;;1,0;;;19,0;;9,0;;12,0;8,0;3,0;2,0;;5,0;;1,0;2,0;1,0;;;;5,0;25,0;1,0;30,0;6,0;;;;1,0;;;;;19,0;1,0;6,0;;;;;3,0;;4,0;;4,0;3,0;;;;29,0;;;;;;;41,0;;4,0;7,0;;;;;6,0;1,0;;2,0;2,0;;14,0;3,0;12,0;;2,0;23,0;2,0;;;8,0;;;;;121,0;;;;;46,0;5,0;;1,0;;;6,0;5,0;4,0;;9,0;;;6,0;;1,0;;7,0;;;18,0;8,0;13,0;4,0;;2,0;;3,0;2,0;10,0;14,0;;31,0;10,0;;;1,0;;;;66,0;;3,0;31,0;21,0;5,0;;;;9,0;12,0;5,0;2,0;;;;;;16,0;;38,0;;4,0;4,0;2,0;;;15,0;6,0;;;;;1,0;;24,0;25,0;9,0;;;12,0;6,0;19,0;23,0;1,0;;;5,0;;2,0;16,0;23,0;2,0;;2,0;11,0;;30,0;;;;;2,0;;;;14,0;3,0;1,0;;1,0;1,0;;2,0;1,0;;29,0;;;10,0;1,0;1,0;;2,0;;;6,0;;1,0;1,0;1,0;5,0;;93,0;;3,0;;;2,0;4,0;1,0;1,0;;9,0;;;;;3,0;20,0;35,0;7,0;2,0;20,0;;5,0;1,0;;;2,0;;2,0;15,0;;1,0;;;;;;2,0;;;3,0;146,0;50,0;8,0;1,0;1,0;;15,0;3,0;;3,0;;;;;1,0;11,0;5,0;4,0;3,0;;;;;;;10,0;;3,0;;2,0;2,0;;;2,0;1,0;1,0;;;;;26,0;;;;;1,0;;;;;2,0;;;8,0;7,0;;4,0;5,0;;;;;3,0;1,0;4,0;;;1,0;1,0;128,0;4,0;6,0;;7,0;8,0;;;3,0;;;;;1,0;;;18,0;2,0;4,0;;1,0;4,0;;1,0;;10,0;2,0;;;73,0;;;1,0;;12,0;;;;;3,0;;;;;;;2,0;;;;;;;2,0;;;;;;;;1,0;;;1,0;2,0;12,0;;;;;2,0;;;;1,0;;8,0;;;;;;;;;1,0;;;;;;;;;;5,0;4,0;1,0;1,0;;;;;;;;;9,0;;;10,0;;;;;;4,0;;;;;;;4,0;;;;;3,0;8,0;;;;25,0;4,0;;;;;1,0;;;;;;;;2,0;;;;;1,0;1,0;;;1,0;;;;;;;;;;;;6,0;;;;;;2,0;4,0;2,0;;;;;;;;5,0;;1,0;;;;;;;;;;;;;;;;;;;3,0;;;;;;;;;;;;;;;;;;1,0;;;;1,0;5,0;4,0;;;24,0;2,0;;;;9,0;;;;;;;;;;;;;;;;;11,0;;;64,0;;;;;4,0;;;;;;;;2,0;;;29,0;;;1,0;;1,0;3,0;;56,0;;;;6,0;1,0;;;;;;;280,0;177,0;2,0;6,0;;;;;;;;6,0;;;5,0;;;;;;;2,0;;21,0;;;;2,0;;;2,0;6,0;;;66,0;28,0;;;;;5,0;;;;;;;;;;;;;;;;3,0;8,0;;;;;;;1,0;;;;;1,0;2,0;3,0;;;2,0;9,0;;;;48,0;;;;8,0;;;;;;;;;;;;;;;;;;;;;;;;;;;;;;;;;;;;;;;;;;;;;;;;;;;1,0;;;3,0;;;;;;;;;3,0;;;;;;;;;;;;;;;;;;;;;;;;;;;;;;;20,0;;;;;;;;;;;;;;;;2,0;;;;;;;;;;;;1,0;;;;;;;;4,0;;;;;1,0;4,0;;;2,0;3,0;;;;;15,0;14,0;1,0;;;;;;32,0;;;;;;;;;4,0;;48,0;;1,0;;;;;;;;1,0;;1,0;;11,0;;;;;;2,0;;;;;;;;;;;;;;;;;;;;;;;;;;;;;
imager;;;28,0;24,0;3,0;24,0;301,0;89,0;;;;11,0;;16,0;19,0;1,0;180,0;4,0;23,0;60,0;50,0;;26,0;;18,0;4,0;;;5,0;2,0;80,0;10,0;2,0;;2,0;59,0;12,0;11,0;;4,0;6,0;26,0;;1,0;12,0;130,0;1,0;111,0;;;;;8,0;;12,0;55,0;52,0;4,0;;37,0;;43,0;23,0;5,0;382,0;7,0;254,0;1,0;;;5,0;384,0;56,0;3,0;;;9,0;2,0;;9,0;93,0;5,0;2,0;1,0;169,0;7,0;2,0;86,0;105,0;;3,0;18,0;9,0;9,0;;1,0;127,0;83,0;307,0;7,0;77,0;3,0;;30,0;16,0;20,0;1,0;3,0;;;;1,0;22,0;6,0;1,0;1,0;8,0;14,0;47,0;44,0;1,0;;18,0;10,0;52,0;7,0;72,0;;;2,0;93,0;;;11,0;;35,0;54,0;;13,0;;;4,0;;;34,0;;27,0;10,0;39,0;13,0;;31,0;11,0;2,0;;;1,0;;;;24,0;29,0;;;;;36,0;23,0;1,0;;8,0;;9,0;29,0;;12,0;;;;2,0;3,0;;;2,0;;3,0;161,0;;4,0;45,0;;5,0;3,0;6,0;16,0;;175,0;10,0;12,0;8,0;;3,0;;;2,0;;4,0;3,0;6,0;52,0;6,0;1,0;6,0;;;24,0;8,0;20,0;;;5,0;2,0;;;;;123,0;;3,0;2,0;3,0;14,0;3,0;;15,0;;;9,0;;;;1,0;6,0;;;11,0;13,0;14,0;34,0;;;;24,0;39,0;45,0;;36,0;95,0;18,0;;6,0;12,0;35,0;57,0;;2,0;;1,0;;20,0;12,0;3,0;1,0;8,0;;;3,0;18,0;3,0;4,0;;3,0;27,0;87,0;;;13,0;;155,0;;;48,0;;1,0;3,0;8,0;6,0;;;21,0;;3,0;5,0;15,0;;;;2,0;;119,0;;;5,0;;6,0;;51,0;;;;2,0;12,0;20,0;2,0;;;;;1,0;52,0;21,0;1,0;;5,0;3,0;;;;;;6,0;8,0;;;;;;3,0;1,0;;;;;;5,0;2,0;;;15,0;3,0;2,0;;;;;7,0;3,0;;;1,0;;;2,0;20,0;;;;2,0;18,0;2,0;29,0;5,0;;1,0;1,0;11,0;;5,0;;;;2,0;;92,0;2,0;9,0;;3,0;;;;;1,0;1,0;6,0;5,0;;3,0;6,0;4,0;;;;14,0;8,0;1,0;6,0;1,0;;;;;4,0;4,0;;22,0;;;;4,0;11,0;;6,0;;;;2,0;6,0;1,0;;;12,0;1,0;6,0;;;;;1,0;;;;2,0;2,0;;7,0;;8,0;9,0;;;23,0;;1,0;;1,0;;;;;;;2,0;2,0;3,0;;1,0;;;;;;;7,0;13,0;;10,0;6,0;2,0;;;4,0;;5,0;;;;3,0;5,0;;;6,0;;;;;22,0;;;;;;;;;33,0;;;3,0;;6,0;6,0;2,0;;;;;;;;;;;1,0;;;1,0;1,0;;;;;5,0;3,0;;;;1,0;4,0;;1,0;;;;;;;;;;;1,0;;32,0;;;;;2,0;;;;12,0;39,0;50,0;8,0;1,0;;;;;;;;1,0;;2,0;1,0;17,0;2,0;;;;10,0;;;;2,0;;;;4,0;;6,0;;;;1,0;;6,0;1,0;1,0;2,0;;;;;;3,0;;;;3,0;;;;1,0;;;;;;;6,0;;;;2,0;1,0;;3,0;;;;;5,0;;;;2,0;;;6,0;;;;;;5,0;;;3,0;;1,0;;;;;;;1,0;;;;;;;;3,0;;;;6,0;;;1,0;1,0;;11,0;;;;;;3,0;17,0;;;;;;2,0;;2,0;2,0;;2,0;2,0;;2,0;;;2,0;1,0;;3,0;;4,0;;;;;;;;;1,0;;;;;;1,0;;95,0;;3,0;2,0;;;2,0;1,0;;;;;;28,0;;;;;;;;;6,0;;;22,0;;;;;;1,0;6,0;;;;;6,0;;;;;1,0;;;;;;;;1,0;;;;;;;;;;;3,0;;;2,0;;;;;9,0;;;;;;;3,0;5,0;;;;1,0;11,0;;;;1,0;;;;1,0;;;;5,0;;;;;;;;;2,0;21,0;;;;;;;;;;;;;1,0;;;4,0;4,0;6,0;;;1,0;1,0;2,0;;;;;;;3,0;;;3,0;;8,0;;;;2,0;;;;;;;;;;;;;;1,0;21,0;2,0;;;;;;;;;;;;;;8,0;;;1,0;;1,0;;;;;;;;;;;;3,0;;;;;3,0;;;;7,0;;;;;;;;;;;;;;;;;;;;;2,0;;;;;;;;5,0;;;;;;5,0;;;;3,0;;;;;1,0;;;;;;1,0;1,0;;;;2,0;;;;;;;;;;;
imaging;;;2,0;70,0;46,0;804,0;447,0;173,0;9,0;3,0;1,0;;22,0;334,0;12,0;6,0;806,0;12,0;163,0;172,0;49,0;10,0;103,0;28,0;55,0;3,0;6,0;493,0;54,0;161,0;409,0;68,0;65,0;75,0;6,0;610,0;40,0;17,0;52,0;5,0;185,0;4279,0;3,0;216,0;172,0;232,0;13,0;692,0;52,0;6,0;23,0;10,0;46,0;10,0;184,0;201,0;208,0;;9,0;199,0;15,0;12,0;163,0;23,0;1923,0;6,0;901,0;14,0;7,0;17,0;118,0;1570,0;551,0;7,0;22,0;2,0;100,0;36,0;6,0;68,0;603,0;;255,0;44,0;514,0;78,0;8,0;928,0;119,0;30,0;196,0;6,0;31,0;27,0;24,0;;779,0;405,0;963,0;238,0;385,0;67,0;4,0;68,0;169,0;212,0;9,0;17,0;24,0;9,0;;174,0;237,0;4,0;7,0;8,0;37,0;67,0;85,0;1103,0;20,0;;497,0;24,0;39,0;53,0;1674,0;;40,0;46,0;158,0;13,0;1,0;894,0;5,0;31,0;222,0;45,0;60,0;;1,0;59,0;13,0;2,0;63,0;25,0;175,0;82,0;192,0;31,0;13,0;22,0;115,0;17,0;7,0;29,0;;5,0;5,0;;23,0;162,0;22,0;41,0;45,0;4,0;134,0;43,0;;77,0;81,0;1,0;27,0;267,0;5,0;16,0;15,0;18,0;32,0;;2,0;14,0;25,0;49,0;4,0;17,0;167,0;4,0;84,0;63,0;26,0;;17,0;31,0;18,0;28,0;154,0;57,0;10,0;22,0;5,0;85,0;12,0;10,0;19,0;22,0;110,0;9,0;29,0;263,0;84,0;42,0;58,0;3,0;5,0;41,0;308,0;49,0;;115,0;71,0;68,0;5,0;102,0;21,0;1,0;344,0;;5,0;22,0;1,0;53,0;156,0;3,0;34,0;6,0;39,0;19,0;3,0;36,0;;15,0;4,0;2,0;4,0;154,0;36,0;56,0;181,0;3,0;1,0;2,0;14,0;35,0;156,0;16,0;94,0;425,0;20,0;12,0;48,0;78,0;86,0;106,0;12,0;4,0;28,0;21,0;1,0;29,0;6,0;39,0;57,0;7,0;11,0;;37,0;115,0;1,0;18,0;16,0;7,0;192,0;116,0;;;28,0;29,0;244,0;2,0;7,0;31,0;;12,0;6,0;4,0;172,0;11,0;5,0;6,0;8,0;7,0;7,0;1,0;;1,0;9,0;77,0;33,0;;3,0;9,0;26,0;15,0;30,0;1,0;60,0;8,0;7,0;43,0;35,0;276,0;6,0;42,0;1,0;4,0;4,0;1,0;51,0;7,0;2,0;;6,0;11,0;69,0;16,0;4,0;1,0;3,0;1,0;41,0;50,0;4,0;;;20,0;5,0;87,0;;3,0;;1,0;4,0;12,0;26,0;34,0;19,0;19,0;139,0;33,0;4,0;;4,0;7,0;1,0;66,0;15,0;7,0;;6,0;;;38,0;71,0;54,0;15,0;20,0;28,0;20,0;11,0;591,0;56,0;20,0;16,0;;131,0;23,0;37,0;41,0;;5,0;35,0;9,0;162,0;10,0;142,0;4,0;42,0;63,0;22,0;;56,0;15,0;45,0;23,0;100,0;20,0;23,0;17,0;48,0;4,0;97,0;5,0;91,0;141,0;121,0;2,0;9,0;3,0;12,0;6,0;45,0;13,0;42,0;5,0;328,0;15,0;67,0;9,0;5,0;45,0;;31,0;3,0;13,0;;28,0;149,0;76,0;9,0;10,0;26,0;21,0;60,0;1,0;12,0;20,0;9,0;88,0;2,0;7,0;48,0;18,0;5,0;;5,0;10,0;79,0;;26,0;33,0;7,0;39,0;14,0;5,0;11,0;;6,0;;1,0;4,0;2,0;62,0;106,0;6,0;12,0;22,0;50,0;2,0;15,0;15,0;3,0;6,0;24,0;21,0;26,0;183,0;7,0;13,0;47,0;5,0;32,0;7,0;20,0;1,0;4,0;22,0;;21,0;2,0;18,0;11,0;11,0;5,0;5,0;28,0;16,0;6,0;3,0;4,0;8,0;2,0;10,0;2,0;2,0;110,0;2,0;34,0;;4,0;30,0;24,0;5,0;5,0;1,0;19,0;19,0;3,0;;;9,0;;15,0;12,0;25,0;8,0;30,0;;5,0;80,0;12,0;2,0;65,0;41,0;7,0;4,0;;21,0;9,0;2,0;11,0;;18,0;10,0;32,0;34,0;2,0;8,0;;;1,0;33,0;10,0;138,0;2,0;4,0;16,0;5,0;5,0;21,0;;7,0;6,0;17,0;43,0;17,0;6,0;5,0;1,0;6,0;1,0;3,0;57,0;44,0;25,0;9,0;8,0;4,0;23,0;13,0;10,0;1,0;24,0;3,0;;1,0;20,0;15,0;121,0;;8,0;;;89,0;8,0;5,0;5,0;18,0;10,0;55,0;6,0;1,0;5,0;12,0;52,0;1,0;2,0;1,0;6,0;119,0;5,0;3,0;18,0;11,0;2,0;2,0;15,0;;1,0;11,0;2,0;13,0;7,0;29,0;4,0;;;2,0;22,0;7,0;9,0;3,0;4,0;8,0;36,0;22,0;;18,0;5,0;4,0;40,0;3,0;15,0;;20,0;1,0;12,0;;43,0;7,0;8,0;7,0;7,0;35,0;58,0;10,0;3,0;;3,0;6,0;139,0;1,0;13,0;2,0;5,0;2,0;31,0;11,0;92,0;1,0;12,0;1,0;1,0;18,0;1,0;8,0;20,0;10,0;10,0;;8,0;2,0;3,0;4,0;;33,0;9,0;25,0;8,0;;1,0;5,0;6,0;65,0;78,0;;1,0;1,0;1,0;4,0;2,0;;9,0;6,0;10,0;113,0;2,0;13,0;21,0;4,0;7,0;5,0;;;10,0;13,0;3,0;19,0;12,0;22,0;1,0;11,0;12,0;31,0;75,0;;6,0;1,0;19,0;;7,0;1,0;5,0;1,0;;7,0;2,0;37,0;;3,0;;;11,0;6,0;12,0;7,0;;3,0;5,0;14,0;;2,0;2,0;5,0;4,0;3,0;67,0;1,0;19,0;;22,0;2,0;16,0;4,0;;3,0;3,0;;18,0;7,0;;;1,0;10,0;14,0;5,0;9,0;9,0;;3,0;35,0;7,0;23,0;15,0;43,0;25,0;100,0;42,0;9,0;41,0;5,0;27,0;36,0;75,0;30,0;;4,0;6,0;55,0;4,0;15,0;13,0;1,0;9,0;52,0;1,0;65,0;24,0;1,0;11,0;1,0;4,0;2,0;4,0;42,0;6,0;8,0;17,0;23,0;2,0;1,0;241,0;4,0;2,0;;;1,0;5,0;9,0;59,0;8,0;43,0;1,0;;;12,0;6,0;6,0;13,0;1,0;5,0;23,0;2,0;9,0;6,0;22,0;23,0;;;9,0;;43,0;4,0;5,0;;1,0;7,0;12,0;9,0;;6,0;1,0;81,0;23,0;31,0;1,0;8,0;15,0;3,0;;;14,0;;6,0;18,0;4,0;;2,0;3,0;2,0;;15,0;1,0;1,0;3,0;4,0;1,0;;;3,0;2,0;1,0;7,0;;;;27,0;7,0;4,0;16,0;2,0;;12,0;1,0;;3,0;5,0;3,0;;5,0;7,0;1,0;4,0;;;;23,0;4,0;30,0;1,0;;;;61,0;8,0;;;10,0;;;;8,0;12,0;37,0;18,0;3,0;;20,0;;2,0;1,0;;4,0;6,0;6,0;3,0;;9,0;;4,0;1,0;1,0;;5,0;19,0;;;7,0;3,0;2,0;;1,0;2,0;6,0;3,0;3,0;;5,0;4,0;2,0;;1,0;4,0;;13,0;;3,0;;4,0;4,0;11,0;;;2,0;1,0;3,0;3,0;2,0;;
installation;;;2,0;4,0;;10,0;;4,0;;;;;1,0;24,0;;;11,0;;;1,0;3,0;;;;;;;3,0;1,0;36,0;14,0;;2,0;;;3,0;6,0;;;1,0;21,0;22,0;;;5,0;4,0;;;;11,0;24,0;;3,0;;5,0;;12,0;;;4,0;;;;;14,0;;22,0;;;;;16,0;2,0;;;;;12,0;;3,0;10,0;;;;19,0;1,0;;5,0;;1,0;9,0;2,0;;;;;;12,0;13,0;1,0;81,0;;;;1,0;;;;;;1,0;3,0;4,0;;;;;1,0;;6,0;;;4,0;;;6,0;21,0;;2,0;;5,0;;;15,0;;;1,0;;;;;;;;;;;1,0;2,0;;;;3,0;1,0;;;;;;;;;;;;;1,0;2,0;;5,0;;;1,0;3,0;2,0;1,0;;;;;;;;4,0;;;6,0;2,0;;3,0;;;;;;3,0;13,0;;3,0;2,0;;;;;;;7,0;;;10,0;;;;;;5,0;;7,0;;1,0;;;8,0;;1,0;;17,0;;;;;;;;3,0;;;;;;;;;;;2,0;;1,0;1,0;;;;;4,0;;;5,0;11,0;;;;2,0;;41,0;;;;;;1,0;2,0;3,0;1,0;3,0;;;6,0;30,0;1,0;;;;;;;;;3,0;;2,0;1,0;;;;;;;1,0;;;;;;;;1,0;1,0;;6,0;3,0;1,0;;;;3,0;;;;;1,0;1,0;1,0;;2,0;;1,0;;;;;;;;2,0;;;;;;;3,0;2,0;4,0;;;2,0;;13,0;;;;;;;1,0;;1,0;;;;;;;;;4,0;;;;;;;13,0;;1,0;;;;;;17,0;4,0;;;1,0;7,0;4,0;;;;;;1,0;;;;;1,0;4,0;;;;;;2,0;16,0;;;;3,0;;;;3,0;1,0;1,0;;;;;;;;;;3,0;11,0;1,0;;1,0;;;1,0;;;;;;;;;2,0;;;;;;;1,0;;;;;4,0;;;;1,0;;;1,0;;;;;;10,0;;3,0;;;1,0;;;4,0;;;;;;;1,0;;;1,0;;2,0;;1,0;;1,0;;;;1,0;;;3,0;;;;;;;;1,0;;;;;;;;;;;1,0;;;;;;;1,0;;;;;;;;;1,0;1,0;1,0;;;;1,0;;;;;2,0;;;;;;;;;1,0;;;;;;;;;;8,0;;;;1,0;;;;;;;;;2,0;;;;;;;;3,0;;;;;6,0;;;1,0;;;;;;4,0;;;;;;;;;;;;;;;;1,0;;;;;;1,0;;;;;;;;;;;;;;;1,0;;;;3,0;3,0;;;;4,0;;;;;;;;;;;;;;2,0;;;;;;;;;;;;;;;;;;;;1,0;;;;1,0;;;;;;;2,0;;;;;;;1,0;;;;;;;;;1,0;;;;;;;;;;;1,0;;8,0;;;;;;6,0;;;;;;;;;;;;;;;;;;;;;;;;;;;;;;;;;;;;;;;;;;;2,0;;;;;;1,0;;;;;;;;;;;;;4,0;;;;;;;5,0;;;;;;;;;;;;;;;;2,0;;;;;;;;;;;1,0;;;;;;;;;;;;;1,0;;;;;;;7,0;;;;;;;;;1,0;;;10,0;;;;;;;;;;;;;;;;;;;;;;;;;;;;;;;;;;;;;;;;;;;;;;;1,0;;;;;;;;;;1,0;;;;;;;;;;;;;;;;;;;;;;;;;;;1,0;;;;;;;;;;;;;;;;;;;2,0;;;;;;;;;;;;;2,0;;;;;;;;;;;;;;;;1,0;;;;;;;;;;;;;;;;
intermediate;;;2,0;1,0;;2,0;1,0;4,0;;;1,0;5,0;5,0;35,0;;;13,0;5,0;;;;;4,0;;1,0;;;2,0;;;8,0;3,0;;6,0;5,0;11,0;;;6,0;;5,0;23,0;;6,0;6,0;6,0;;4,0;;;1,0;;10,0;;;4,0;29,0;;18,0;25,0;;;;;95,0;;40,0;1,0;;;1,0;29,0;2,0;6,0;15,0;;7,0;1,0;;4,0;24,0;;6,0;;8,0;8,0;2,0;6,0;1,0;;22,0;;5,0;7,0;3,0;;17,0;18,0;6,0;12,0;74,0;2,0;;3,0;6,0;4,0;;;2,0;1,0;;4,0;75,0;;;;22,0;6,0;2,0;11,0;1,0;;49,0;;;4,0;12,0;;1,0;;4,0;;;135,0;1,0;;2,0;;6,0;;;;;;1,0;3,0;22,0;3,0;;8,0;;;9,0;1,0;1,0;;;2,0;;;6,0;50,0;;2,0;;;7,0;2,0;1,0;2,0;5,0;;;7,0;1,0;4,0;;;;;;;;13,0;;2,0;8,0;;12,0;11,0;;;2,0;;40,0;4,0;8,0;;;;6,0;42,0;;;;;51,0;;22,0;11,0;;4,0;;;;2,0;1,0;1,0;2,0;4,0;;1,0;;;26,0;;28,0;;;;;;15,0;2,0;;;;;4,0;;;;;2,0;2,0;31,0;2,0;2,0;14,0;1,0;;;;7,0;13,0;;17,0;60,0;4,0;;;17,0;;9,0;;;3,0;;2,0;;;2,0;;1,0;6,0;;1,0;3,0;;1,0;;;;5,0;;;;7,0;11,0;;3,0;1,0;;;1,0;;1,0;;;;4,0;;2,0;;1,0;;;2,0;;8,0;;;;;7,0;1,0;16,0;;;;1,0;3,0;;7,0;;;4,0;;1,0;1,0;1,0;1,0;2,0;2,0;1,0;;;;;1,0;;;;;;;3,0;12,0;;1,0;;;;;;3,0;;17,0;9,0;;1,0;;;;2,0;3,0;;2,0;;;;;2,0;;1,0;;;;2,0;;20,0;;;;1,0;3,0;;;;;;16,0;;;;3,0;;2,0;;;;7,0;;15,0;;5,0;;4,0;;;;2,0;;1,0;5,0;;;;;;;1,0;1,0;;;3,0;1,0;8,0;;;;;5,0;;;;;;;;;;1,0;1,0;;;;;;;;;1,0;;;;;1,0;;;;;;3,0;;1,0;;;;;;;;;1,0;7,0;2,0;1,0;;3,0;;;;;;;5,0;6,0;1,0;;;;;2,0;3,0;;2,0;;;;1,0;;1,0;;;;;;;;;;;;;19,0;;;;;14,0;;;;;;;;;;3,0;;;;;;;;2,0;;;1,0;;5,0;;1,0;;;;1,0;;;;;;;;1,0;4,0;;;;;;;;3,0;;;3,0;3,0;;;;3,0;;;;;;;;;;;;;;;1,0;;;5,0;;;;;;;;;;;;;;;13,0;;;;;;1,0;;;;;;;;;;;;;;;;;;;1,0;;;;;;;;;;1,0;4,0;;;;;;;;;;;;;9,0;1,0;2,0;;;;;;2,0;;3,0;;;;4,0;4,0;2,0;;;;;;8,0;;4,0;;;65,0;;;;;;;;;4,0;;1,0;6,0;;;3,0;3,0;;;;4,0;6,0;;1,0;;;;;;1,0;;1,0;2,0;;2,0;2,0;2,0;;;2,0;;1,0;2,0;4,0;;;;;;;5,0;3,0;;;;1,0;;;;;;;;6,0;;;;;;;;;;;1,0;;;;;1,0;;;;1,0;;;;;;6,0;;;;;;;;;;2,0;4,0;;2,0;;;;;4,0;3,0;;;;;;;;;;;27,0;;;;;;;;;;;;;;;;;;;;;;;;;4,0;;;;;;;2,0;;2,0;;;;;4,0;;2,0;;;;;;;;23,0;;;;;3,0;1,0;;1,0;1,0;;;2,0;;;;;;68,0;;;;;1,0;;;;;;;;;;;;;;;;;;;;;;1,0;;;;;;;;;;;;;;;;;;;;;;;;;3,0;;;;2,0;5,0;;;;;;;;;;;;;;1,0;;;;;;;;;6,0;;;;;;;;;5,0;;;1,0;4,0;;;;;;;;;;2,0;;;;;;;;;2,0;;;;;;;1,0;;;;;;;;;;;
interpolate;;;1,0;;1,0;1,0;8,0;;;;;;;16,0;2,0;8,0;;2,0;43,0;;;;64,0;;;;;9,0;1,0;1,0;22,0;;1,0;1,0;;23,0;;;13,0;1,0;9,0;6,0;;2,0;;;;2,0;;;1,0;;;;3,0;;2,0;;;24,0;;1,0;6,0;;230,0;;8,0;;;;;3,0;9,0;;;;;;;;33,0;;4,0;1,0;8,0;;;;;;;;;;;;40,0;;24,0;3,0;13,0;;;20,0;20,0;15,0;;;5,0;;;5,0;;1,0;;;3,0;;;4,0;;;9,0;;28,0;9,0;5,0;;;;11,0;;;9,0;;;4,0;2,0;1,0;;;1,0;2,0;1,0;;;;;9,0;;;2,0;;;;;;;1,0;;;;;3,0;;;1,0;;;;;;;;;5,0;3,0;;;;;;;;;;6,0;;54,0;;;;;;;;;;;2,0;;;;;1,0;1,0;;;;2,0;;;3,0;;;;15,0;;;;;;;;;;;;;;;;;;;;;;;;;2,0;;;;1,0;;;;;;;;;;;;;;;;;;1,0;;;;;2,0;2,0;;;;1,0;;;;2,0;;;;;;;;;;;6,0;;;2,0;;;;;;;;;;;;;;;;;;2,0;;;;;;;;;;;;1,0;;3,0;;;;;;;;;;;;;;;;;;;;;;;;;;;;;;;;;;;25,0;;;;;;;2,0;3,0;;;;;;;;6,0;;;2,0;;;1,0;;;;;;;4,0;;;;1,0;;;;4,0;;;;;;4,0;;1,0;2,0;2,0;5,0;;;;;;;;4,0;;;1,0;;;;5,0;;;1,0;1,0;;;;;;;;;;;;4,0;;;5,0;;;;;;;;;;;;;;;;;;;;;;;;;;;;;;;;;;;;;;;;;;;1,0;;;23,0;;;;;;;;1,0;;1,0;;1,0;;;;;;;;;;;1,0;;;;;;1,0;;;;;;;;;;;;;;;;;;;4,0;;;;;3,0;;;;;;;;;;;;;;1,0;;2,0;;;;;;;;;12,0;;;;6,0;;;;;;2,0;;;;;;4,0;;;;;;;;;7,0;1,0;;9,0;;;;;;2,0;;;;;;2,0;;;;;;;;;;;;;;;;;;3,0;;;;;;;;;;;1,0;;;;;;9,0;;;;;;;;;;;;;;;;;;;;;;;;;;;;;;;;;;;;;;5,0;5,0;;;;;1,0;;;;;;;;;;;;;;;;;;;;;2,0;;;;;;;;;;;;;;;;;;;;;;;;;;;;;;;;;;;;;;;;;;;;;;;;;;;;;;;;;;;;;;;;;;;;;;;;;;;;;;;;;;;;;;;;;;;;2,0;;;;;;;;;;;;;1,0;;;;;;;;;;;;2,0;;;;4,0;;;;;4,0;;;;;;;;;;;;;7,0;;;;3,0;;;;;1,0;;1,0;;1,0;;;;;;;;;;;;;;;;;;1,0;;;;;;;;;;;;;;;;;;;;;;;;;;;;;;;;;;;;;;;;;;;;;;;;;;;;;2,0;;;;;;;;;;;;;;;;;;;;;;;;;;;;;;;10,0;2,0;;;;;;;;;;;;;;;2,0;;;1,0;;;;;;;;;;;6,0;;;;;2,0;;;;;;
join;;;1,0;3,0;;11,0;;17,0;;;2,0;;22,0;48,0;;;7,0;;2,0;;4,0;2,0;;;;;;6,0;;;18,0;;;;;2,0;6,0;1,0;7,0;;;9,0;4,0;;2,0;1,0;1,0;9,0;;;;;4,0;4,0;3,0;;21,0;;;17,0;3,0;;;;86,0;;24,0;;;;1,0;54,0;11,0;;;;15,0;1,0;;1,0;17,0;;;;13,0;;;14,0;;;;;6,0;2,0;;;;1,0;36,0;83,0;4,0;1,0;;13,0;9,0;3,0;;;1,0;;;3,0;1,0;;;;;1,0;;16,0;;;;;;;19,0;;;1,0;1,0;3,0;;27,0;;;5,0;;;;;4,0;;;1,0;5,0;4,0;14,0;;;;;46,0;15,0;;;;;;;2,0;12,0;;;;;1,0;1,0;;;;;;2,0;;10,0;;;1,0;;;;;6,0;4,0;;;;19,0;70,0;;2,0;1,0;7,0;15,0;1,0;131,0;;7,0;6,0;;3,0;;;;;41,0;;;9,0;1,0;;;;;4,0;4,0;1,0;;1,0;1,0;;;;12,0;1,0;176,0;1,0;;3,0;1,0;;5,0;;62,0;;;;3,0;1,0;1,0;2,0;4,0;;2,0;;4,0;16,0;33,0;1,0;;5,0;;;18,0;;58,0;30,0;;;;;;5,0;6,0;1,0;;;1,0;;;10,0;;;;;1,0;;;;1,0;;21,0;10,0;;;2,0;9,0;6,0;1,0;;;;2,0;;3,0;1,0;;;1,0;2,0;;4,0;;;2,0;;;1,0;43,0;1,0;;9,0;;6,0;;1,0;2,0;3,0;;2,0;;;;2,0;;;;2,0;3,0;3,0;;6,0;13,0;;;;;;;2,0;1,0;;;;;2,0;4,0;;2,0;;;;;;46,0;;2,0;15,0;;;;;2,0;;;;;;;;;;6,0;;;;;;;;;;;;;;;1,0;2,0;;;;;1,0;1,0;;;;;;;;;;;;16,0;6,0;;;4,0;;;;1,0;6,0;;;;;;;;;6,0;;;;;;;;;;;;;;;;;;;;;;;;;;;;1,0;1,0;;;;;;;;;6,0;;;;;;;;;;3,0;3,0;10,0;;1,0;;;;;;2,0;;1,0;;;;;2,0;;;2,0;;;;;;;;2,0;;;;40,0;;;;;;;1,0;;;2,0;1,0;1,0;;1,0;2,0;15,0;;6,0;;;1,0;;;;;;;;42,0;;;;;;;;;10,0;;;;;;;;;;6,0;;;;;;;;;;2,0;;;;;;;;;2,0;25,0;;1,0;;;;;;;;11,0;;2,0;;;;2,0;;;;;;;;;;;2,0;;;2,0;;;;;;;;;;1,0;;4,0;;;;;;;;;;;;;;4,0;;;;1,0;;;;;2,0;;;;;;;;;;;;;;;;2,0;;;;;;;;;;;;;1,0;;;2,0;1,0;;;;;;;;;;1,0;;;;;;;;;2,0;1,0;;;;3,0;;1,0;;;;;;;;1,0;4,0;;;;;1,0;;;;;;;;;;;4,0;;1,0;;5,0;;;;;;;;4,0;;6,0;;;;;;1,0;2,0;;;;;;;;;;;;;;;;;4,0;;;3,0;;;;;;1,0;;;;;;;;;;;1,0;;;;;;;1,0;;;;;;;;1,0;;;;;;;2,0;6,0;;;;;;;;;;;;;;;;;;;;1,0;;;;1,0;;2,0;;;;;;;;;8,0;;4,0;;;;;;;;;1,0;;;;;;;;;;;;;;;;;;;;;;;;;;;;;;;3,0;;;;;;;;;;;;;;;;;1,0;;;;1,0;;;;;4,0;;3,0;;;;;;;;;;;;;;;;;;;;;;;;;;;;;;;;9,0;;;;;;;;;;;1,0;;;;;;;;;;;;;;;;;1,0;;;;;;;;;;;;;;;;;;;;;;;;;;;;;;;
lane;;;2,0;2,0;6,0;16,0;5,0;;;;;;;77,0;;;6,0;;;;;;;;;;;1,0;1,0;2,0;15,0;4,0;3,0;;;19,0;1,0;;;;20,0;2,0;;;5,0;3,0;;;1,0;;18,0;;3,0;;;;3,0;;1,0;13,0;;;1,0;;38,0;2,0;22,0;;;;;;;;;;;;;;50,0;;;45,0;4,0;;;;;;;;;3,0;1,0;;;;15,0;13,0;29,0;14,0;;29,0;4,0;7,0;;2,0;;;;15,0;;1,0;;;;6,0;;19,0;2,0;;19,0;;;;39,0;;;;3,0;;;8,0;2,0;1,0;5,0;;;;;5,0;;;;1,0;2,0;;2,0;;;;;;;;;;;;;1,0;;4,0;;;4,0;2,0;;24,0;9,0;1,0;1,0;16,0;;17,0;;;5,0;;;15,0;1,0;;;;2,0;;1,0;9,0;;;;;;;;;;;;;;;;;;;;;2,0;;7,0;;;;6,0;1,0;;1,0;;;;;;;2,0;;2,0;;;;3,0;;7,0;10,0;;;;;;;;;;5,0;4,0;5,0;12,0;;;;;;;;;5,0;4,0;;;2,0;;145,0;;;;;;2,0;1,0;4,0;;;;;2,0;12,0;;;;;2,0;;;;;1,0;;;;;;;;;9,0;4,0;;;;;;;;;;1,0;2,0;1,0;;;;;4,0;;4,0;;;;;28,0;;;;;;3,0;;;;;;;;;;;;;;;;;;;;;;;;;;;22,0;;1,0;2,0;8,0;;;;;3,0;;;1,0;2,0;;4,0;;;11,0;;43,0;2,0;;3,0;;;41,0;2,0;;;16,0;58,0;1,0;3,0;;4,0;;;;;4,0;9,0;;10,0;8,0;3,0;;;1,0;5,0;;14,0;;3,0;1,0;2,0;;2,0;1,0;2,0;14,0;;;;;1,0;;;;;;8,0;;4,0;;3,0;5,0;;;;9,0;4,0;;1,0;4,0;;;;2,0;;;1,0;;14,0;;;;;;;;;;;;;;1,0;;;;;2,0;;;;1,0;14,0;;;2,0;;;1,0;2,0;;;10,0;;3,0;1,0;;13,0;;;;;1,0;;1,0;1,0;;1,0;;;;;;;;2,0;;;;;3,0;;1,0;;;;1,0;;;;;;;;;;;;;;;;;;;;4,0;;;;;;;;;;;;;;;;;9,0;;2,0;;;;;;;;;;1,0;;;;;;;;;;1,0;;;;;;;;1,0;;;;;;;;;2,0;;;;;;3,0;5,0;;;;;3,0;1,0;;;;;;;;;1,0;;;;;2,0;;;;;;;;;;2,0;;;;;;;;1,0;;;;2,0;;;;;;5,0;;;1,0;;;;;;;;;;;;;;;;;;;;;;6,0;1,0;1,0;;;;;9,0;;;;;1,0;2,0;;;7,0;;;;;1,0;14,0;;;;7,0;;;;;;;18,0;;;;;;;;;;;;;2,0;;;;;;;;1,0;;;;;;;2,0;2,0;7,0;;;;;;19,0;;;;;1,0;;;;2,0;;;;;;;;;;;;;;;;;;;;;4,0;;;;;;;;;;;;;;;;;19,0;;;;;;;;;;;;;;;;;;;;;39,0;;;;;;;;;;2,0;;;;24,0;;;;;;;1,0;;;;;;1,0;;5,0;;;;;;;;;;4,0;;;42,0;;1,0;1,0;;;;;;;;2,0;;;;;;;;1,0;;57,0;;;;;2,0;;;;;4,0;;;;;;;;16,0;;;;;;;;;;;;;;;;;;;5,0;;;;;;;;;;2,0;;1,0;;;;;8,0;;;;;;;;;2,0;;;;;;;;;;;;;;;;;;7,0;;;;;;;;;;;;;;;;;;;;;;;;;;;;;;;;;;;;;;;;;;;;;;;
magnet;;;2,0;1,0;4,0;142,0;2,0;77,0;;;;;64,0;147,0;;;;;;;;;;;;1,0;14,0;6,0;;;180,0;7,0;7,0;90,0;;;1,0;8,0;;;3,0;172,0;;;2,0;748,0;;60,0;;;;;14,0;52,0;85,0;;54,0;;3,0;65,0;14,0;;;;65,0;;489,0;3,0;;85,0;22,0;475,0;20,0;;;2,0;18,0;;;;15,0;;1,0;;352,0;134,0;;241,0;;8,0;;5,0;3,0;11,0;;;;20,0;241,0;23,0;393,0;5,0;2,0;;;5,0;;;;;;25,0;6,0;3,0;3,0;2,0;;29,0;;250,0;;;6,0;10,0;;;28,0;;;3,0;2,0;4,0;;320,0;1,0;;5,0;1,0;;;;36,0;;;6,0;18,0;19,0;115,0;4,0;67,0;21,0;11,0;34,0;28,0;;;21,0;1,0;;1,0;4,0;46,0;;;;;138,0;61,0;;64,0;4,0;;1,0;390,0;;7,0;6,0;4,0;4,0;;;;11,0;538,0;5,0;;29,0;120,0;155,0;16,0;;;;71,0;285,0;12,0;286,0;3,0;75,0;6,0;;2,0;2,0;;4,0;1,0;233,0;8,0;8,0;230,0;110,0;31,0;;;5,0;73,0;2,0;21,0;7,0;1,0;6,0;;;;62,0;1,0;284,0;;4,0;6,0;12,0;;5,0;;24,0;;2,0;;2,0;;3,0;15,0;2,0;1,0;1,0;1,0;10,0;37,0;256,0;;;;2,0;19,0;7,0;2,0;95,0;458,0;13,0;;10,0;1,0;6,0;;39,0;;;;4,0;;;15,0;64,0;5,0;3,0;;4,0;14,0;46,0;27,0;11,0;41,0;231,0;27,0;;5,0;40,0;6,0;32,0;;986,0;12,0;1,0;2,0;;3,0;26,0;11,0;46,0;12,0;3,0;;1,0;1,0;;13,0;3,0;;18,0;15,0;5,0;1,0;34,0;;3,0;5,0;42,0;4,0;16,0;17,0;9,0;;167,0;36,0;;26,0;;49,0;13,0;6,0;8,0;;;10,0;;3,0;1,0;;;;49,0;35,0;;;;6,0;7,0;71,0;;33,0;2,0;2,0;;;4,0;;;112,0;;;7,0;;3,0;;;;;;;5,0;2,0;;16,0;29,0;13,0;;;;;;57,0;1,0;;2,0;;126,0;;;;;6,0;;;21,0;3,0;6,0;4,0;2,0;3,0;;;5,0;1,0;1,0;9,0;33,0;;;6,0;27,0;8,0;150,0;;4,0;5,0;20,0;34,0;;;;;;;;;19,0;;15,0;1,0;;166,0;;2,0;;1,0;1,0;;;7,0;;;8,0;;140,0;;;;;2,0;;;3,0;1,0;20,0;5,0;;;1,0;2,0;1,0;1,0;;;1,0;;1,0;;;;;;2,0;;1,0;2,0;2,0;;1,0;;;;;;;;;6,0;22,0;1,0;;;2,0;;1,0;;12,0;;;;21,0;;;4,0;;;26,0;;1,0;;;;;;;;;;11,0;;;4,0;14,0;1,0;24,0;;;1,0;2,0;4,0;;2,0;;;22,0;27,0;;;;1,0;;;;;18,0;;;;;1,0;;;1,0;;;;1,0;;5,0;;;;3,0;4,0;;;;;9,0;;;;8,0;;10,0;25,0;3,0;;;4,0;;;;;;13,0;1,0;4,0;;;5,0;1,0;;;;;;;;;;;;;;;;;;;;;;;;;2,0;;;;;;;33,0;1,0;;;3,0;;;;;;3,0;;13,0;;;1,0;31,0;;;;26,0;;;;;;;8,0;;;;;3,0;3,0;;;;;;;;13,0;28,0;;1,0;;;;;;20,0;;;;;;;;;;;;;3,0;2,0;;27,0;4,0;;2,0;;;;8,0;;4,0;;;;;3,0;239,0;511,0;;2,0;;;;;;10,0;;6,0;;;19,0;;;;6,0;1,0;;;16,0;2,0;;;;;12,0;;13,0;31,0;;;9,0;16,0;;;;7,0;5,0;;5,0;1,0;;;13,0;6,0;217,0;;;10,0;6,0;1,0;8,0;4,0;;;1,0;;10,0;;;;3,0;;;1,0;;;2,0;;;;;12,0;;3,0;;;;;;15,0;23,0;;;;;;1,0;;;;;;;;;;;;;;;2,0;;;;;;;;;26,0;;;;;;;;;4,0;;1,0;5,0;;;;;;;;1,0;;;;;;;;;;;;1,0;6,0;;2,0;;;;10,0;;;;;;;;;;;;;;;;;;;;;;;;;;;;;;;;;4,0;;4,0;2,0;;;;;;;;;;;;;12,0;2,0;;1,0;;;;;;;;1,0;;;27,0;1,0;;13,0;;;;7,0;;;1,0;;9,0;;12,0;2,0;2,0;207,0;;;;11,0;;;3,0;1,0;;;;2,0;;;182,0;2,0;9,0;;;;;;;7,0;;;;1,0;;;;;;;;1,0;;;;;;1,0;;;;;;;;;;;;;;;3,0;;;;;;
mask;;;1,0;3,0;;5,0;5,0;5,0;;13,0;;;;46,0;1,0;2,0;25,0;;;;1,0;;2,0;;;1,0;;;6,0;;19,0;;;1,0;;16,0;36,0;1,0;;6,0;20,0;55,0;;;25,0;8,0;;16,0;;;1,0;;;4,0;1,0;1,0;34,0;;1,0;82,0;;1,0;3,0;;329,0;;72,0;1,0;;;;24,0;32,0;;;;12,0;;;1,0;98,0;;;2,0;21,0;4,0;;7,0;1,0;13,0;8,0;;9,0;10,0;;;140,0;3,0;70,0;8,0;42,0;19,0;;9,0;45,0;14,0;3,0;8,0;;;;7,0;225,0;;;;3,0;4,0;10,0;30,0;1,0;;38,0;5,0;7,0;19,0;46,0;;;15,0;7,0;;;13,0;4,0;;7,0;;;;;1,0;;;44,0;52,0;72,0;7,0;3,0;;1,0;35,0;3,0;1,0;;3,0;;2,0;;;;2,0;;;;;1,0;17,0;;3,0;6,0;1,0;2,0;7,0;;9,0;;1,0;;;;;3,0;4,0;;9,0;70,0;;24,0;5,0;;2,0;;4,0;6,0;4,0;5,0;4,0;3,0;;5,0;34,0;;;;11,0;37,0;1,0;;;2,0;5,0;10,0;49,0;10,0;;3,0;2,0;38,0;6,0;51,0;4,0;1,0;;3,0;;98,0;;;20,0;;13,0;20,0;2,0;;1,0;5,0;;;8,0;;;;;;31,0;2,0;6,0;5,0;1,0;;5,0;;4,0;10,0;;2,0;18,0;3,0;;3,0;8,0;6,0;6,0;1,0;;;;17,0;12,0;;2,0;;2,0;;;;;;6,0;;;2,0;;;;2,0;3,0;9,0;;;;;;2,0;;2,0;;;;;1,0;;;;;;;;17,0;;;18,0;3,0;1,0;;5,0;;2,0;;1,0;37,0;;9,0;;;4,0;;;2,0;;;;13,0;2,0;3,0;;;1,0;;1,0;9,0;;;;;7,0;1,0;;;;;;3,0;2,0;2,0;1,0;2,0;49,0;;1,0;;;;;;;;;;;;1,0;2,0;9,0;;;;2,0;14,0;21,0;3,0;;3,0;1,0;9,0;;6,0;;;;5,0;1,0;3,0;;10,0;;6,0;10,0;1,0;;7,0;;15,0;;2,0;18,0;17,0;4,0;3,0;;;;1,0;12,0;;3,0;;;;;;;;2,0;8,0;7,0;2,0;;;;;7,0;;3,0;;18,0;6,0;;;;1,0;1,0;;2,0;5,0;;;9,0;;;2,0;;;;;;33,0;;11,0;4,0;4,0;3,0;3,0;;;;65,0;;;;25,0;36,0;2,0;;;2,0;;1,0;2,0;;5,0;;1,0;2,0;3,0;25,0;7,0;;;;;;;;1,0;2,0;;;;;3,0;;;3,0;;;;;;;6,0;;;1,0;;;1,0;;;1,0;;;8,0;4,0;;3,0;;;;;6,0;;;2,0;;;3,0;6,0;7,0;2,0;4,0;11,0;50,0;;38,0;;;;;;;;1,0;4,0;;;;;;1,0;;;13,0;9,0;;14,0;;;1,0;;;;1,0;7,0;;;;;;;;4,0;;26,0;;;12,0;4,0;28,0;;;2,0;;;18,0;;;1,0;;9,0;;;10,0;;;;1,0;;;3,0;1,0;;;;;;6,0;;;;;;2,0;;;;;;;;;;3,0;;;;;;35,0;;;;;;;;;;;;;;;;5,0;;;7,0;3,0;;;7,0;;1,0;;;2,0;;;6,0;;;1,0;;5,0;;;1,0;;;;;2,0;;;;;;;;;;;2,0;4,0;3,0;5,0;;;;;;;;;;;3,0;2,0;2,0;;;;;;;;;;;;;;3,0;;;;;;;;;;11,0;;;;4,0;;;;;5,0;;;3,0;;;;;;;2,0;;;6,0;3,0;;;;;;;;;;;1,0;;;;4,0;;;;;;;;;;;8,0;27,0;;;5,0;;2,0;;;;;;;;2,0;;;;;;4,0;;;1,0;;;;;;;;;;5,0;;;;;1,0;;;38,0;1,0;;;;6,0;;1,0;1,0;;4,0;9,0;3,0;3,0;;;4,0;1,0;;;;;;;;;3,0;;;;;;;;;;26,0;6,0;;;;7,0;14,0;;;;;;1,0;;;;9,0;;;;;;;;;;;;;;;;;;;;;1,0;3,0;;;;;1,0;2,0;;;;1,0;;;;;;;;;;;;;;2,0;;;;3,0;8,0;;;;;;2,0;;;;;;;;;2,0;;;;2,0;;;;;;;;;26,0;;;8,0;;;;;2,0;;;;;3,0;;;;;1,0;;;15,0;;;;1,0;;;;;;;6,0;;;;;;;;;;;;
match;;;3,0;19,0;7,0;22,0;19,0;2,0;;14,0;;2,0;1,0;171,0;;6,0;35,0;;;24,0;;;66,0;1,0;3,0;;;12,0;7,0;39,0;49,0;8,0;16,0;4,0;2,0;93,0;8,0;27,0;13,0;3,0;307,0;79,0;7,0;32,0;30,0;;;19,0;9,0;5,0;17,0;;3,0;3,0;16,0;2,0;10,0;;1,0;31,0;;;88,0;1,0;751,0;1,0;95,0;;4,0;10,0;24,0;19,0;57,0;;1,0;1,0;1,0;5,0;1,0;4,0;161,0;;2,0;66,0;33,0;10,0;4,0;26,0;6,0;18,0;28,0;;;;20,0;;107,0;54,0;126,0;526,0;172,0;55,0;5,0;27,0;9,0;27,0;3,0;3,0;21,0;;;64,0;45,0;3,0;1,0;7,0;12,0;12,0;20,0;35,0;41,0;;27,0;12,0;;61,0;93,0;;2,0;;55,0;4,0;1,0;36,0;1,0;;45,0;7,0;7,0;;;10,0;;;4,0;15,0;31,0;7,0;50,0;1,0;;10,0;8,0;;;1,0;;;;3,0;3,0;7,0;3,0;;;33,0;4,0;1,0;;11,0;4,0;;;47,0;1,0;68,0;;;2,0;;1,0;;;28,0;14,0;;11,0;;93,0;8,0;;3,0;;1,0;3,0;24,0;4,0;;6,0;;;1,0;;;28,0;13,0;12,0;;;8,0;;6,0;6,0;;;14,0;31,0;2,0;3,0;1,0;69,0;1,0;4,0;;4,0;;28,0;;;2,0;;;16,0;14,0;2,0;6,0;2,0;1,0;;18,0;;8,0;;;;81,0;;50,0;13,0;3,0;6,0;;;21,0;3,0;;1,0;27,0;1,0;;3,0;3,0;2,0;13,0;;;;3,0;4,0;8,0;;;1,0;;1,0;;1,0;26,0;;;2,0;;5,0;9,0;24,0;;;4,0;5,0;9,0;2,0;3,0;;;7,0;;18,0;3,0;;1,0;;;;13,0;;2,0;3,0;1,0;;80,0;1,0;;4,0;;10,0;;2,0;2,0;2,0;;16,0;275,0;2,0;13,0;;1,0;;;1,0;;1,0;;1,0;;10,0;3,0;1,0;;2,0;;4,0;19,0;;41,0;1,0;;16,0;4,0;7,0;;;;;;46,0;;4,0;1,0;30,0;;;;;2,0;;21,0;10,0;1,0;;5,0;;;71,0;14,0;13,0;;;7,0;37,0;10,0;9,0;61,0;;1,0;;118,0;18,0;8,0;;;1,0;8,0;42,0;2,0;;48,0;;86,0;16,0;3,0;;31,0;;7,0;;54,0;1,0;1,0;32,0;;;20,0;14,0;5,0;31,0;7,0;1,0;3,0;1,0;69,0;;57,0;;;4,0;26,0;7,0;15,0;4,0;1,0;;;58,0;8,0;16,0;;12,0;34,0;3,0;;5,0;2,0;22,0;2,0;4,0;3,0;;2,0;67,0;;1,0;;1,0;5,0;1,0;;14,0;10,0;;;21,0;2,0;2,0;9,0;1,0;;;;;;4,0;6,0;19,0;5,0;;3,0;;;9,0;2,0;;7,0;;33,0;22,0;2,0;93,0;2,0;;82,0;9,0;;22,0;1,0;;;;1,0;1,0;;7,0;2,0;;;1,0;4,0;2,0;8,0;1,0;6,0;16,0;13,0;;;;2,0;;12,0;;;1,0;9,0;6,0;17,0;1,0;;;1,0;;;8,0;3,0;;4,0;4,0;;4,0;;;;;2,0;;4,0;;11,0;2,0;2,0;;;;;8,0;;7,0;2,0;;8,0;;53,0;18,0;1,0;;4,0;7,0;3,0;21,0;18,0;5,0;2,0;;;;;5,0;9,0;1,0;5,0;1,0;;;;3,0;;4,0;;;;15,0;3,0;;22,0;;1,0;;1,0;;7,0;6,0;;18,0;1,0;7,0;510,0;;8,0;;6,0;1,0;;;;18,0;;;;3,0;12,0;8,0;;;;4,0;22,0;;3,0;;2,0;;1,0;1,0;;10,0;6,0;;1,0;3,0;;;1,0;1,0;;;;54,0;;;;;;;1,0;12,0;;4,0;12,0;;;20,0;5,0;;9,0;12,0;;8,0;;;1,0;;;14,0;3,0;;2,0;2,0;23,0;;4,0;47,0;61,0;2,0;4,0;;2,0;;;13,0;;;;3,0;;1,0;1,0;1,0;3,0;1,0;4,0;;;;;;2,0;2,0;2,0;;;;10,0;;2,0;1,0;1,0;;3,0;;;;10,0;;;;20,0;4,0;;3,0;;8,0;9,0;;;;11,0;11,0;5,0;;2,0;14,0;;4,0;;1,0;24,0;12,0;;2,0;;;1,0;;;7,0;;;2,0;;;;;;;2,0;;;;;;2,0;;9,0;;2,0;;;;3,0;;;15,0;1,0;;8,0;;;6,0;;3,0;;;;;1,0;;2,0;;5,0;;;;;;;6,0;;3,0;;;8,0;17,0;7,0;22,0;;;5,0;23,0;;;6,0;20,0;;4,0;5,0;;2,0;;;7,0;;;;;30,0;;2,0;2,0;;;;;;;;36,0;;1,0;6,0;;11,0;;;10,0;1,0;;18,0;;15,0;;;;2,0;;;16,0;1,0;;2,0;3,0;3,0;1,0;;;15,0;52,0;23,0;2,0;;;9,0;;;1,0;;1,0;;11,0;;48,0;2,0;3,0;1,0;;;;1,0;;;1,0;2,0;;;3,0;;2,0;4,0;;;2,0;;6,0;;8,0;;;3,0;;2,0;;2,0;;;;1,0;;;5,0;;1,0;;3,0;10,0;;;7,0;2,0;;;;;;;7,0;;1,0;;;;;;;6,0;;;3,0;3,0;;14,0;;5,0;;8,0;;;;;;7,0;;;1,0;69,0;;1,0;;8,0;;1,0;;;;10,0;3,0;1,0;;3,0;43,0;;1,0;31,0;;7,0;;1,0;7,0;;;;1,0;;
modify;;;1,0;3,0;1,0;8,0;4,0;;1,0;6,0;;;;88,0;;3,0;42,0;2,0;;2,0;1,0;4,0;55,0;7,0;2,0;4,0;;17,0;13,0;3,0;25,0;7,0;9,0;2,0;;108,0;9,0;;10,0;;23,0;72,0;;5,0;57,0;;3,0;2,0;;6,0;7,0;;;;11,0;10,0;2,0;;2,0;53,0;;;4,0;3,0;371,0;;66,0;2,0;;;1,0;23,0;16,0;;;;;1,0;;1,0;83,0;;2,0;55,0;19,0;;;18,0;;6,0;43,0;3,0;;;;;80,0;11,0;50,0;17,0;25,0;6,0;;;17,0;38,0;1,0;5,0;5,0;;;;35,0;;;;5,0;12,0;22,0;19,0;11,0;;69,0;13,0;3,0;13,0;56,0;;2,0;;6,0;;;2,0;;;11,0;39,0;1,0;;;1,0;;;;;5,0;1,0;6,0;1,0;;1,0;;;2,0;;;;;;;3,0;41,0;2,0;4,0;2,0;;1,0;1,0;;2,0;;4,0;2,0;;;;1,0;;;;;;;;;5,0;1,0;67,0;;;;;;;;2,0;;;2,0;;5,0;;;3,0;10,0;4,0;;1,0;3,0;4,0;;;;;;10,0;;;13,0;6,0;;9,0;;;;24,0;;;13,0;;;4,0;3,0;3,0;;4,0;;;;6,0;;;;;5,0;;1,0;2,0;;;;;7,0;;1,0;7,0;9,0;;;;1,0;;16,0;;;;2,0;15,0;1,0;;1,0;11,0;14,0;1,0;;1,0;1,0;2,0;5,0;;3,0;;;;;;;;;;17,0;;;4,0;;1,0;;;;;;;3,0;;;;;1,0;20,0;;;8,0;;4,0;;2,0;;2,0;1,0;6,0;30,0;1,0;6,0;;;;;10,0;;;;;;1,0;;;;1,0;;;1,0;;;;;;10,0;2,0;;3,0;;;;2,0;;;;87,0;2,0;;1,0;;9,0;;2,0;6,0;;;;;;6,0;5,0;5,0;;;17,0;2,0;;27,0;4,0;;;;12,0;3,0;2,0;;10,0;1,0;2,0;7,0;3,0;;1,0;;5,0;3,0;6,0;;26,0;15,0;3,0;;39,0;;4,0;20,0;;;;;2,0;10,0;16,0;;;2,0;;;5,0;;;4,0;23,0;1,0;9,0;;;;;11,0;1,0;1,0;;4,0;4,0;2,0;;1,0;;1,0;1,0;1,0;6,0;;;54,0;;5,0;;;4,0;;;4,0;11,0;2,0;2,0;3,0;1,0;;11,0;;;;;1,0;;;1,0;21,0;22,0;;;;5,0;;3,0;;21,0;;1,0;;;26,0;2,0;6,0;2,0;;;2,0;2,0;;;6,0;;2,0;;;34,0;;1,0;5,0;;3,0;;2,0;;2,0;;;;;10,0;;1,0;;;;;;;;;;;;;;9,0;;3,0;;1,0;;;;1,0;1,0;;;;23,0;;;9,0;;20,0;;;1,0;5,0;;4,0;8,0;1,0;;;1,0;;;;3,0;5,0;20,0;;;;1,0;1,0;2,0;;;3,0;;10,0;;1,0;;;3,0;;;;;;;9,0;;;;1,0;;;;1,0;4,0;1,0;;;2,0;18,0;11,0;2,0;;1,0;7,0;;1,0;;;;10,0;;;;;;;;;16,0;;5,0;1,0;;;10,0;;4,0;;1,0;;1,0;1,0;;;3,0;;;;;;;;;3,0;;;5,0;3,0;3,0;;13,0;;;1,0;2,0;;;1,0;;;;;;;;2,0;;;5,0;;2,0;3,0;10,0;5,0;;;1,0;;1,0;;;;1,0;;;;;;;10,0;;;;;;1,0;3,0;5,0;2,0;;;;;;2,0;;;;;;11,0;;;;1,0;5,0;1,0;;;;;;;;;;;;;10,0;;;;2,0;;;;;;;;8,0;;;1,0;;;;;;;;;;1,0;;;;;;;;;;;;;4,0;;;;;;;;;;;;1,0;;;;;;;;;;;;1,0;;;;;;;4,0;3,0;;;;1,0;;;2,0;2,0;;;3,0;;;;;;3,0;;;;18,0;;18,0;;;;;1,0;;;1,0;9,0;;;;;;;;;;;1,0;;;;;;;;;1,0;4,0;;;;;;;;;;;;;;1,0;1,0;;;;;;8,0;;;;;5,0;;;;1,0;;;;;3,0;;1,0;;;;;;;;;1,0;1,0;;;;;1,0;;;;;;;;;;;5,0;;;;;;3,0;;1,0;;;1,0;;;6,0;;;;;4,0;;;2,0;;;;;;;;;;;;;;;;1,0;;;;;;;;;;;1,0;7,0;;;;;;;;;;;;;3,0;17,0;;;;;;;;;;;;;;;
observe;;;1,0;;;6,0;1,0;;;;;;;1,0;9,0;6,0;6,0;;;2,0;;;7,0;;;;;;2,0;1,0;4,0;1,0;1,0;;;1,0;5,0;;28,0;;17,0;11,0;;1,0;9,0;;;1,0;;;6,0;;;;5,0;;;;2,0;6,0;;9,0;2,0;;105,0;;8,0;;;;;1,0;4,0;;;;5,0;;;1,0;29,0;;2,0;;1,0;;;;;1,0;;;;;;1,0;34,0;1,0;18,0;1,0;3,0;7,0;;;;6,0;;3,0;;;;;6,0;;;3,0;;1,0;30,0;10,0;;;;;;;18,0;;;;16,0;14,0;;1,0;1,0;;7,0;;1,0;;;;;;;;;;;;;;4,0;;;;;;;;;1,0;;;;;;;;1,0;3,0;;;;;;;;1,0;;;;;;;;3,0;;10,0;;;1,0;1,0;;;;;;;;;;2,0;;1,0;;;;;1,0;8,0;12,0;1,0;;;;;;;;;;;;;;4,0;;;;;1,0;31,0;;3,0;;;;;8,0;;;;;;4,0;;;;;;;;;;;;1,0;;;;;;17,0;;;;1,0;;6,0;;;;;;;1,0;;;;;;3,0;;6,0;;;1,0;;;;;;;;;2,0;1,0;;;;;;;;;;;;5,0;;;;;22,0;;6,0;;;;;53,0;;;2,0;4,0;;;;;;;;;1,0;;;;;;;;;;;;2,0;5,0;;;;;9,0;;8,0;;;;22,0;;;1,0;;8,0;;;1,0;1,0;;;;;;;2,0;;;1,0;10,0;;2,0;3,0;;;;3,0;;1,0;;6,0;;;9,0;1,0;;;;1,0;;1,0;;4,0;;2,0;7,0;11,0;;;4,0;3,0;;4,0;;1,0;2,0;1,0;;;;3,0;;;;;;;;9,0;3,0;;;;;3,0;;;;4,0;;;2,0;;3,0;1,0;;1,0;;;17,0;;4,0;;;;;;;3,0;;;;;1,0;;;;;;;;;;1,0;1,0;;;;;;;;1,0;;2,0;;;2,0;;;18,0;;;2,0;;2,0;;2,0;;;;;4,0;;;;;;;;;;7,0;;;;;;;;;;;;;;;;;;;;5,0;;;;;;;;14,0;;;;;;;;;;2,0;;;;;;1,0;2,0;;;;;;;;2,0;;3,0;;;;2,0;;;;;;;;;;;;;;;;;;4,0;;;;;2,0;;;;;1,0;;;1,0;1,0;32,0;3,0;;;;;1,0;;;;;;;;;;;;;1,0;4,0;;;;;;;;;;4,0;;;1,0;;;;;;;;4,0;;;;;;;;;;;1,0;;;8,0;;;;;;;;3,0;;;;;;;;;;;;2,0;;;;;;;;;;;;;;;;;;;;;;;;;;;;;;2,0;;3,0;;;;;4,0;;;;;;;;;;;;;;;;;;;;;;;;;1,0;;;;;;1,0;4,0;;;;;;1,0;;;;;;;;;;;;;;;;;;;;;;;;;;;;;;;;;;;;;;;;;;;;;;;;;;6,0;;14,0;;;2,0;3,0;;;;;;;;;;;;3,0;;;16,0;;;;;;;;1,0;;;;;;;;;;1,0;;;;2,0;6,0;3,0;;;;;;;;;;;;;;;;;;6,0;;;2,0;3,0;;;;;;;;;;1,0;;;;;;;;;;;;;;;;;;2,0;;;;;;2,0;;;;;;;;;;;;;;;;;;;;;;;2,0;;;1,0;;;;4,0;;;;;;;;;;;;;;;;;;;;;;;;;1,0;;;;;1,0;;;;;1,0;;;;;;1,0;;;;;;;;;;;;;2,0;;1,0;;;;;;;;;
offset;;;2,0;37,0;38,0;9,0;31,0;17,0;;;3,0;1,0;7,0;117,0;;;19,0;1,0;3,0;;2,0;7,0;1,0;;;19,0;19,0;11,0;2,0;1,0;52,0;10,0;35,0;78,0;;17,0;17,0;24,0;9,0;;133,0;94,0;;4,0;19,0;3,0;1,0;19,0;36,0;6,0;25,0;8,0;6,0;;26,0;;7,0;;48,0;20,0;;;7,0;;213,0;;41,0;3,0;;33,0;8,0;53,0;24,0;;;4,0;;8,0;;4,0;68,0;;6,0;18,0;15,0;;;70,0;9,0;5,0;7,0;;;;;1,0;48,0;63,0;84,0;77,0;87,0;18,0;;;6,0;8,0;;2,0;;1,0;;33,0;15,0;2,0;;;;13,0;2,0;97,0;1,0;1,0;88,0;;;15,0;67,0;;1,0;2,0;78,0;;;25,0;;;15,0;;17,0;1,0;;3,0;;16,0;9,0;34,0;38,0;13,0;15,0;;16,0;4,0;7,0;3,0;;;8,0;;;;;15,0;10,0;1,0;5,0;3,0;5,0;3,0;;7,0;2,0;;9,0;73,0;1,0;14,0;1,0;;13,0;3,0;;;;4,0;;3,0;5,0;;29,0;3,0;;;;2,0;4,0;2,0;7,0;;;;;;;;46,0;4,0;13,0;2,0;2,0;19,0;3,0;10,0;;;;1,0;11,0;4,0;;9,0;3,0;30,0;4,0;;3,0;;50,0;;;;;;17,0;11,0;;;9,0;;;6,0;;2,0;;;;27,0;2,0;1,0;12,0;;1,0;;2,0;1,0;1,0;8,0;13,0;21,0;;;;5,0;;14,0;2,0;2,0;;;;;;1,0;4,0;;;;1,0;128,0;;;3,0;6,0;77,0;1,0;;;1,0;4,0;57,0;;2,0;;;;4,0;6,0;54,0;;2,0;;;1,0;;9,0;6,0;;19,0;5,0;12,0;58,0;;3,0;;;1,0;;10,0;;1,0;24,0;5,0;24,0;1,0;;4,0;5,0;2,0;;;6,0;1,0;;3,0;7,0;8,0;;;;;9,0;2,0;10,0;64,0;1,0;;1,0;13,0;11,0;;4,0;;;17,0;;2,0;2,0;1,0;2,0;8,0;;4,0;;3,0;;5,0;24,0;;29,0;6,0;;;;56,0;83,0;5,0;;;4,0;14,0;10,0;32,0;8,0;;1,0;2,0;3,0;2,0;21,0;1,0;;6,0;;;12,0;2,0;18,0;4,0;6,0;1,0;2,0;3,0;13,0;10,0;25,0;6,0;19,0;;2,0;12,0;10,0;;26,0;1,0;3,0;9,0;19,0;;56,0;18,0;;;5,0;;5,0;1,0;23,0;;9,0;3,0;7,0;1,0;;11,0;;21,0;3,0;;8,0;1,0;;22,0;10,0;9,0;7,0;;3,0;;;14,0;18,0;;5,0;;2,0;;;9,0;11,0;;6,0;11,0;4,0;26,0;10,0;;;1,0;;;8,0;1,0;;3,0;;;2,0;7,0;1,0;;;;;;;4,0;;36,0;2,0;;;;;;3,0;3,0;1,0;21,0;2,0;;;1,0;8,0;;;14,0;22,0;5,0;;;;;1,0;;1,0;3,0;5,0;;;;;1,0;2,0;;;1,0;9,0;;;;;;;2,0;2,0;32,0;;;;5,0;6,0;;;2,0;6,0;7,0;;;;;;;;;;4,0;3,0;;;;13,0;;24,0;1,0;;23,0;;4,0;;1,0;1,0;;1,0;1,0;;1,0;6,0;;10,0;;;1,0;;;7,0;1,0;;14,0;11,0;31,0;1,0;;;9,0;;;;;2,0;;;;1,0;;3,0;;;;;44,0;1,0;1,0;;;;;;;;;6,0;;;;;;3,0;2,0;;;;;;;;;;;;1,0;3,0;2,0;;2,0;3,0;2,0;;;;;5,0;;;9,0;;5,0;24,0;;6,0;21,0;15,0;;1,0;;;4,0;;;;;;15,0;;6,0;;;4,0;;;38,0;;;2,0;;;;6,0;;;;;;;20,0;;;;;7,0;;;;1,0;;3,0;4,0;;;;;10,0;1,0;2,0;;;;;;1,0;2,0;19,0;;;;;;2,0;1,0;;18,0;;;;;6,0;57,0;2,0;;8,0;7,0;5,0;;;;1,0;;6,0;4,0;;;;;;;;;;;;1,0;3,0;;;;4,0;1,0;;;;;;;1,0;9,0;;;;;;;;;;;6,0;1,0;;;5,0;1,0;;;;2,0;;10,0;;4,0;12,0;;;;;;11,0;;;;11,0;5,0;9,0;;;;;8,0;;2,0;5,0;;;1,0;4,0;;;11,0;;;10,0;;;;;;;;;;;;;;;7,0;1,0;;;;6,0;;3,0;;14,0;1,0;;;;7,0;;3,0;;;;;;;3,0;;;;1,0;;;2,0;3,0;;;;5,0;;;6,0;3,0;;;;;;;;;;;;;;;;;4,0;;;;;;;;;1,0;;;6,0;;;;1,0;12,0;10,0;;;7,0;;6,0;4,0;;7,0;;6,0;;55,0;;;;;1,0;;12,0;;;;;;;4,0;;;;;;;;;;;;;;;;4,0;;;6,0;;;;;5,0;5,0;;;3,0;;;;6,0;;1,0;;;;;;;1,0;5,0;;;;3,0;;;;;;;;;;;
patch;;;3,0;;9,0;1,0;;;;;;;;65,0;;;4,0;;;2,0;;;11,0;;;;;3,0;3,0;4,0;3,0;;;;;8,0;4,0;4,0;77,0;;64,0;16,0;;;;;;;;6,0;14,0;;;;;;2,0;;;27,0;;;97,0;;251,0;;21,0;12,0;1,0;;;;4,0;;;23,0;1,0;;;;22,0;;;;9,0;;;4,0;;6,0;;;12,0;2,0;;;64,0;;62,0;3,0;10,0;5,0;;1,0;4,0;1,0;;;;;;4,0;9,0;;;;23,0;13,0;8,0;;;;;;;11,0;21,0;;;;;;;7,0;;;;;6,0;;;6,0;;1,0;;;4,0;;25,0;;;;;2,0;;;;;;;;;;;;;;;;;;;;6,0;;;;;;;;;;;;;6,0;;3,0;;;;;;;;;;;;;;;;13,0;6,0;;;;;;;1,0;;;;2,0;;;;35,0;;;;;;;;;4,0;;;19,0;;;1,0;2,0;;;;;;;;;11,0;;;;;;;;4,0;;;;;11,0;;;;;;2,0;;;;8,0;;;1,0;;;;;;;;;;;;;15,0;;;;;;;16,0;;;;;5,0;;;;;;;3,0;;;;;;;;;;;;;;;;;;;;32,0;;;;;;;;;;;;;;;;;5,0;;;;;;11,0;;;;;;;;;;;;;;;;;;;;;;;;;;19,0;;;;;;6,0;2,0;;;;;;2,0;1,0;3,0;4,0;;;;17,0;24,0;;4,0;;12,0;;;;5,0;;;;16,0;;;;;;2,0;;;3,0;2,0;;;;1,0;;2,0;;2,0;;3,0;;4,0;;;;;16,0;;;;6,0;;;;;;1,0;;;2,0;;;3,0;;;;;;;;;;;;8,0;;;;;;;;;;;;;;;;;;;1,0;;;;;;;10,0;;;;;;;4,0;;;;;;;1,0;;;;122,0;;;;;;;1,0;;;;;;16,0;;;;;;;;;;;;;;;;;;;;;;36,0;;;4,0;;;;;;;;;;6,0;;;4,0;;4,0;;3,0;;;;;;;;;;;;;;;1,0;;1,0;;;;;;;1,0;1,0;;;;15,0;;;4,0;;;;1,0;;;;;;;;18,0;;;;;;;;;;;;;;2,0;;;;;;3,0;;7,0;;;;;1,0;;;;;;;;;;;;;;;;;;;;;;;;;;;;2,0;;;;;;;;;;;;;;;;;22,0;;;1,0;23,0;;;;;;;;;;;;;;;;;;;;;;;3,0;;;;;;;;;;;;;1,0;;;;;;;;;;;;;;;;;;;8,0;;;;;;;;;;;;;;;;;;;;;;;;;;;;;;1,0;;;;;;;;;;;;;;;;4,0;;;;;;;7,0;;;;;;;;;3,0;;;;;;;;;;;;;10,0;;;;;;1,0;;;;;;;;;;;;;;;;;;;93,0;2,0;;;;;2,0;;;;;;;;1,0;;;;1,0;;;;1,0;;;;;2,0;;;;;;;;;;;5,0;;;;;;;;;;;;;22,0;;;;;;;;12,0;;;;;;;;;;;;;;;;;;;;;;;;;;;;;;;;;;;;;;;;;;;;;;;;;27,0;;;;;;;;;;;;2,0;1,0;;;;;;;;;;;;;;;;;;;;;17,0;;;;;14,0;;;1,0;;;;4,0;;;;;21,0;;;;;;
pose;;;4,0;99,0;1,0;60,0;2,0;3,0;9,0;;;;;274,0;;;128,0;;;;;;6,0;;;;;;14,0;4,0;52,0;1,0;2,0;3,0;;70,0;21,0;4,0;102,0;2,0;347,0;83,0;;9,0;40,0;;;3,0;4,0;40,0;274,0;;37,0;;16,0;;;2,0;;22,0;;;4,0;;726,0;2,0;92,0;;;;;1,0;4,0;;;;;8,0;1,0;;240,0;;5,0;68,0;7,0;;3,0;3,0;;3,0;27,0;2,0;;;6,0;;12,0;12,0;102,0;72,0;87,0;38,0;;7,0;24,0;43,0;8,0;12,0;;;;74,0;2,0;27,0;;2,0;;28,0;37,0;58,0;3,0;2,0;5,0;;;32,0;93,0;;7,0;;60,0;;;20,0;;;34,0;53,0;;;;7,0;;;1,0;18,0;5,0;8,0;55,0;;;;3,0;;;;;;;5,0;;1,0;2,0;28,0;5,0;9,0;4,0;11,0;;11,0;13,0;3,0;2,0;22,0;;23,0;;;4,0;;5,0;;;11,0;;;11,0;;75,0;;;66,0;;;;;1,0;10,0;;4,0;;;;;14,0;10,0;3,0;;84,0;7,0;7,0;1,0;;;;;3,0;1,0;6,0;2,0;6,0;;2,0;;;;11,0;;;2,0;;;7,0;4,0;;2,0;3,0;;;44,0;;;;;;38,0;;3,0;;7,0;;;;13,0;;;;17,0;1,0;;;;4,0;47,0;;;;;;7,0;;;7,0;7,0;;;;20,0;;;;;4,0;;35,0;;;1,0;;;;;;;4,0;;11,0;;;;;;;1,0;;;;40,0;;47,0;;;;;;;3,0;;;;20,0;110,0;;5,0;;;;;;;;;;;9,0;;;;;;21,0;11,0;;;;;10,0;11,0;;;;;39,0;;40,0;;;;30,0;;;;3,0;;;20,0;3,0;22,0;;;;;83,0;2,0;8,0;;4,0;24,0;18,0;8,0;20,0;104,0;;5,0;6,0;59,0;15,0;36,0;1,0;;;3,0;7,0;;;11,0;;42,0;7,0;18,0;8,0;27,0;;2,0;10,0;95,0;2,0;;48,0;;;5,0;18,0;;3,0;33,0;;2,0;;12,0;;1,0;;;3,0;20,0;1,0;10,0;2,0;;;2,0;9,0;;10,0;;13,0;2,0;;;;;7,0;;10,0;14,0;1,0;;43,0;;;;;16,0;;;1,0;99,0;;35,0;88,0;2,0;;6,0;;3,0;60,0;;;4,0;1,0;1,0;18,0;3,0;;;;;4,0;11,0;;;;11,0;;1,0;26,0;;1,0;;20,0;;;;;;1,0;;;;12,0;5,0;3,0;;26,0;;2,0;9,0;;;;1,0;;;;2,0;;4,0;;;;;5,0;2,0;4,0;;;;;;;3,0;;8,0;;;1,0;1,0;11,0;82,0;4,0;6,0;;;4,0;;;;;6,0;;;;10,0;24,0;2,0;;9,0;;;;3,0;;;24,0;;5,0;;2,0;2,0;;4,0;;;7,0;7,0;;4,0;;;;;2,0;;2,0;;;;5,0;;;;;;;;9,0;;57,0;;3,0;;3,0;84,0;1,0;4,0;6,0;;4,0;;3,0;;46,0;;;;2,0;1,0;1,0;;;;2,0;6,0;;;1,0;;;;;;;;;;;;;;1,0;;;3,0;23,0;;;;;;;1,0;9,0;3,0;3,0;5,0;20,0;5,0;4,0;7,0;;1,0;;;;;2,0;;;;53,0;1,0;;;2,0;23,0;;;96,0;;;;;1,0;;;;;;;;;;1,0;;;;;;;;2,0;;;1,0;;;;;;;1,0;;;;;;;1,0;;;;;;4,0;;;1,0;;3,0;;;;15,0;222,0;;15,0;;2,0;;4,0;;;3,0;;;;4,0;4,0;;;;;;;;1,0;;;;4,0;;11,0;;;;;;22,0;;;;9,0;;;;;;;;;;;;;;;;;;;;1,0;;;;2,0;;;;;;;;;;;;28,0;4,0;17,0;;;;;9,0;;;;;;1,0;;;;;;;;;;;8,0;;;1,0;;;;;;;;;;;;;1,0;;;6,0;1,0;2,0;2,0;;1,0;;;;;;2,0;;9,0;;8,0;;;;3,0;;1,0;2,0;;;;;28,0;4,0;;;;;;10,0;;;;;1,0;;;5,0;;;;;;;;15,0;;;;;;;;;;6,0;;;;;;;1,0;;;;8,0;;;22,0;;5,0;;1,0;;;;10,0;;;;;;;;;;;;;;;;;20,0;;1,0;;2,0;;3,0;;19,0;;;;;;;;;;;;;1,0;;;1,0;;;1,0;;;;9,0;24,0;7,0;;;;;10,0;;15,0;;;;;;2,0;;;
print;;;1,0;8,0;;19,0;4,0;56,0;;;;;12,0;28,0;;;15,0;;;3,0;20,0;;2,0;;2,0;2,0;2,0;30,0;3,0;7,0;65,0;;;2,0;2,0;20,0;3,0;1,0;5,0;3,0;15,0;75,0;;12,0;7,0;113,0;1,0;21,0;;;;;8,0;;7,0;2,0;39,0;;;;3,0;;1,0;;231,0;;107,0;;3,0;;;132,0;14,0;2,0;;;22,0;2,0;25,0;4,0;46,0;;;8,0;163,0;;;33,0;;2,0;;2,0;;9,0;3,0;;;1,0;56,0;9,0;40,0;3,0;;14,0;6,0;11,0;9,0;1,0;;1,0;;1,0;19,0;1,0;;;20,0;23,0;4,0;120,0;;;34,0;18,0;;6,0;41,0;;8,0;1,0;;;3,0;64,0;;1,0;2,0;;;;3,0;13,0;;;1,0;15,0;10,0;36,0;;68,0;;3,0;1,0;50,0;;;;2,0;;;8,0;105,0;;;;;95,0;13,0;;11,0;;;1,0;16,0;;2,0;;;;;;;2,0;6,0;1,0;;10,0;3,0;16,0;89,0;;;5,0;7,0;41,0;6,0;141,0;;18,0;2,0;1,0;8,0;;2,0;7,0;3,0;20,0;7,0;;115,0;;1,0;6,0;;1,0;5,0;6,0;8,0;;10,0;31,0;;;20,0;41,0;1,0;71,0;2,0;1,0;5,0;5,0;;;1,0;37,0;;;;;;;;;;10,0;8,0;10,0;25,0;156,0;;2,0;2,0;4,0;13,0;39,0;3,0;35,0;102,0;2,0;;;6,0;;10,0;4,0;;;;;6,0;;34,0;30,0;4,0;;;1,0;15,0;1,0;4,0;;1,0;5,0;1367,0;3,0;;15,0;4,0;1455,0;4,0;21,0;;;6,0;;4,0;10,0;5,0;1,0;2,0;;;177,0;1,0;;;;8,0;1,0;7,0;;;2,0;;1,0;;9,0;;2,0;2,0;5,0;25,0;27,0;5,0;1,0;4,0;;;6,0;;6,0;;;1,0;7,0;;;;;;;1,0;;2,0;2,0;4,0;;12,0;;1,0;;;;;3,0;;;18,0;1,0;;;;;;;;;;;;;;;;;2,0;;2,0;;1,0;20,0;;;;;4,0;;;;;;;2,0;;;7,0;;2,0;;1,0;5,0;5,0;3,0;1,0;;2,0;;;;15,0;;3,0;;1,0;1,0;1,0;;;;;;;;;1,0;28,0;;;;1,0;;2,0;4,0;;;;;3,0;;;2,0;20,0;;;;4,0;2,0;;14,0;;;;;;;9,0;;2,0;;4,0;1,0;;;4,0;;1,0;;;;;1,0;;;;3,0;;5,0;;;1,0;6,0;;;3,0;2,0;1,0;;1,0;4,0;;;;;;;;12,0;;;3,0;;;11,0;1,0;1,0;;;;;;;;3,0;1,0;;45,0;;14,0;;31,0;23,0;13,0;;3,0;;3,0;;;;;;;;5,0;;2,0;;;4,0;;;6,0;5,0;29,0;;9,0;;1,0;;;;;;3,0;;;;;;3,0;1,0;;;;;;;2,0;3,0;;;5,0;;39,0;2,0;2,0;;;;;;;;8,0;9,0;1,0;2,0;;2,0;;;;;;;5,0;;;;;;;;6,0;;3,0;;4,0;;;;;;20,0;2,0;2,0;17,0;;;52,0;;;;2,0;;;;;;;;;2,0;;8,0;;1,0;;4,0;;1,0;;5,0;;2,0;;;;;;1,0;;;;1,0;2,0;;;3,0;;;8,0;;;1,0;;;;;;1,0;;;;;1,0;1,0;1,0;;;;;;1,0;3,0;4,0;2,0;;17,0;;;4,0;;;;48,0;;24,0;;;;;;1,0;10,0;;;4,0;;;;1,0;3,0;2,0;10,0;4,0;;19,0;;;;;4,0;;;12,0;1,0;6,0;;;;;;;23,0;;11,0;1,0;;2,0;;;;1,0;;;;3,0;;;;4,0;6,0;;;;7,0;;8,0;;1,0;2,0;1,0;;;;;;;;;14,0;;;;;3,0;1,0;10,0;;;;;;4,0;;;;;;;;1,0;;;;8,0;;6,0;;19,0;;7,0;;;;;;2,0;;;;;;;1,0;;;;;;;;;;12,0;2,0;2,0;;1,0;;;;;1,0;;;;16,0;;1,0;3,0;;;;;;;;;;1,0;;;;;1,0;;;5,0;;1,0;;;;;;;;1,0;;;;;;;;;;;;;;;;;;;;;;;;;;;;;;;;1,0;;;;3,0;32,0;;;1,0;;;;;8,0;;2,0;;;;;;2,0;1,0;;;1,0;;;;;;;8,0;;;;;8,0;;6,0;;;;;;1,0;;1,0;;10,0;1,0;;;;;;;;;2,0;;;;;;;;;;;;2,0;1,0;2,0;;;6,0;;;;1,0;;;1,0;;;;;;;;;;;;;;;
profile;;;1,0;12,0;4,0;30,0;5,0;27,0;;;6,0;17,0;;48,0;;5,0;9,0;;46,0;1,0;3,0;;52,0;;;1,0;;5,0;;11,0;41,0;;2,0;18,0;;31,0;1,0;2,0;24,0;;71,0;81,0;3,0;13,0;2,0;4,0;2,0;15,0;;;;;4,0;1,0;5,0;2,0;10,0;;;46,0;2,0;;7,0;2,0;48,0;;42,0;3,0;;;5,0;79,0;21,0;;;3,0;3,0;12,0;1,0;7,0;74,0;;4,0;;19,0;;;8,0;;5,0;;3,0;;;1,0;;14,0;;64,0;9,0;13,0;5,0;;;1,0;23,0;1,0;5,0;;;;31,0;16,0;;2,0;;5,0;6,0;;15,0;2,0;;20,0;1,0;;33,0;79,0;;;;7,0;;1,0;8,0;11,0;;9,0;;;;;;;;6,0;9,0;;9,0;60,0;;;;6,0;;;;;3,0;;;;3,0;1,0;1,0;;;6,0;4,0;;11,0;2,0;;;11,0;;2,0;1,0;4,0;3,0;;2,0;;;1,0;;;3,0;17,0;45,0;;;3,0;;1,0;;3,0;8,0;;;;;3,0;;;7,0;;1,0;;;6,0;1,0;2,0;;;;1,0;2,0;;;4,0;5,0;;2,0;;2,0;;5,0;2,0;;6,0;;;5,0;;;3,0;;;;2,0;4,0;2,0;4,0;;;38,0;;9,0;5,0;;2,0;;5,0;3,0;1,0;;8,0;45,0;;;;4,0;;10,0;;;;1,0;;2,0;;;1,0;1,0;;;1,0;2,0;;1,0;1,0;;;;8,0;;;;;1,0;;3,0;;;;;8,0;;;1,0;;1,0;;;;;2,0;5,0;21,0;7,0;;;;;;;1,0;;1,0;4,0;7,0;7,0;;;;;;;1,0;;;2,0;3,0;;7,0;1,0;;;;;;1,0;;;;;26,0;8,0;;;;;;;3,0;;;;45,0;;;;4,0;;;1,0;2,0;;;;;;6,0;5,0;;2,0;4,0;;19,0;5,0;5,0;;;;1,0;7,0;;;;;3,0;;6,0;10,0;;;;16,0;4,0;3,0;;13,0;3,0;20,0;2,0;11,0;2,0;;19,0;3,0;;;2,0;;3,0;5,0;;;;;;1,0;1,0;;;22,0;;8,0;3,0;;3,0;2,0;33,0;;4,0;;3,0;20,0;;;8,0;;20,0;;;2,0;6,0;22,0;25,0;;;;;;;;;4,0;;;17,0;;;6,0;;;;;;;3,0;;1,0;;;;;;;;;;1,0;43,0;;;9,0;;4,0;;1,0;;;1,0;;1,0;;;;;40,0;;;;;2,0;1,0;2,0;;;15,0;;;;5,0;;;;;;;;;;;;;;;2,0;;;;5,0;;1,0;;;6,0;22,0;;;1,0;;;;;;;;;1,0;2,0;;;5,0;;;;4,0;6,0;;2,0;;;;3,0;;;;;;;;12,0;14,0;5,0;6,0;;;;1,0;;8,0;;;;;16,0;;;26,0;;10,0;;;;;1,0;;;1,0;;1,0;;;;;;;;7,0;7,0;;;;;;6,0;;;;16,0;;;;1,0;;;;1,0;;;5,0;;;;;;3,0;;;;3,0;;;2,0;;;;;;;2,0;6,0;5,0;;;;;;;1,0;;3,0;;2,0;;;;2,0;;;;;2,0;4,0;;;;;;;14,0;;;;;;;2,0;;;;1,0;2,0;1,0;3,0;;;;;;1,0;2,0;;1,0;5,0;;3,0;;;1,0;;;23,0;;2,0;;3,0;;;;;;;;;;;;;;2,0;1,0;18,0;;;14,0;3,0;;1,0;;;;;;1,0;;;;;;;;3,0;;;;;;1,0;;5,0;;;1,0;;;;3,0;;3,0;;;;;;;;9,0;;;;;2,0;;1,0;;;;;2,0;;2,0;;7,0;;2,0;;;;1,0;;;;4,0;2,0;;;;;;;;2,0;;;;;;12,0;1,0;;;;;;;;;;;;;;;1,0;;;;;;;;;;;;;;1,0;;;;;;;;;;;;;;;2,0;1,0;;;;5,0;1,0;2,0;;1,0;;;;;1,0;;;;5,0;;;;;;;;3,0;;;;;;;;2,0;;;;;;;;3,0;;;;;;;;;;;;;;;;;;;19,0;3,0;;2,0;;;6,0;10,0;;1,0;;;;2,0;;;;;;;1,0;;;;;1,0;4,0;;;2,0;;;;;;1,0;;;;4,0;;;;;;;;;;1,0;;;1,0;;;;;;;;;;;;;;;;;;;;
rate;;;1,0;37,0;19,0;28,0;1,0;2,0;;16,0;;;;126,0;;3,0;118,0;;8,0;1,0;;;15,0;8,0;17,0;5,0;;5,0;29,0;;65,0;8,0;1,0;10,0;;232,0;10,0;10,0;20,0;;179,0;137,0;;75,0;139,0;2,0;;;;4,0;5,0;;;4,0;12,0;8,0;5,0;;25,0;36,0;;;2,0;;393,0;;46,0;37,0;15,0;;2,0;23,0;36,0;;9,0;16,0;;3,0;4,0;29,0;185,0;1,0;27,0;4,0;31,0;;;14,0;;7,0;19,0;;3,0;;3,0;;29,0;;62,0;10,0;38,0;44,0;;36,0;39,0;36,0;11,0;7,0;;;5,0;13,0;90,0;1,0;;3,0;132,0;11,0;3,0;124,0;7,0;4,0;108,0;1,0;;;55,0;;3,0;;102,0;6,0;;33,0;5,0;;2,0;2,0;69,0;;;3,0;;6,0;12,0;3,0;10,0;5,0;23,0;;;;4,0;;4,0;1,0;;;;;;5,0;24,0;14,0;5,0;;6,0;;10,0;5,0;1,0;;2,0;12,0;;15,0;1,0;1,0;1,0;;1,0;;8,0;1,0;;;5,0;2,0;1023,0;;6,0;;1,0;;;;4,0;1,0;3,0;;;1,0;34,0;6,0;29,0;5,0;2,0;;;3,0;3,0;33,0;5,0;;;5,0;37,0;1,0;;;14,0;42,0;;;;;34,0;47,0;;3,0;;6,0;72,0;18,0;;;;;;;;;1,0;;;84,0;;;;2,0;;;;;;3,0;15,0;8,0;;;5,0;15,0;;14,0;;;;5,0;8,0;2,0;;;2,0;4,0;1,0;;;28,0;;1,0;;;7,0;2,0;;;;14,0;5,0;;;;;;1,0;;1,0;10,0;;;;;;2,0;1,0;;;6,0;;45,0;;;;;;;2,0;;5,0;1,0;7,0;24,0;;;1,0;;;;6,0;;;;;;19,0;;;;;;7,0;5,0;5,0;;;;;1,0;;;;;3,0;1,0;5,0;;;12,0;238,0;11,0;4,0;2,0;;;1,0;5,0;4,0;20,0;;;;;48,0;;203,0;30,0;1,0;25,0;23,0;;89,0;5,0;10,0;1,0;6,0;41,0;35,0;8,0;;4,0;23,0;5,0;1,0;36,0;;14,0;3,0;16,0;18,0;2,0;1,0;30,0;;26,0;1,0;4,0;5,0;10,0;18,0;1,0;;20,0;;42,0;21,0;2,0;;;6,0;18,0;4,0;;2,0;6,0;3,0;38,0;2,0;35,0;;3,0;1,0;;138,0;;21,0;1,0;3,0;28,0;12,0;3,0;66,0;;62,0;4,0;1,0;21,0;;;19,0;7,0;3,0;2,0;5,0;;3,0;2,0;;2,0;3,0;1,0;7,0;;22,0;;;57,0;4,0;;;4,0;9,0;1,0;15,0;9,0;1,0;;3,0;;9,0;3,0;;;;6,0;4,0;;27,0;;;1,0;;;1,0;1,0;1,0;;;1,0;3,0;6,0;;77,0;;;;1,0;1,0;;;;5,0;38,0;;;;9,0;1,0;5,0;;;;5,0;;;;;;;;;;123,0;;;22,0;2,0;3,0;7,0;;57,0;3,0;3,0;;3,0;;6,0;;;2,0;5,0;;5,0;;;;2,0;1,0;6,0;;;12,0;2,0;3,0;14,0;47,0;;3,0;;4,0;2,0;;;;;;3,0;;13,0;;;1,0;;;1,0;;;;;6,0;;;;;;;;;;4,0;;23,0;;2,0;2,0;4,0;;;1,0;21,0;;;1,0;;;;;3,0;2,0;;;;1,0;3,0;2,0;;5,0;;;;6,0;10,0;;5,0;12,0;;2,0;;24,0;;;;;4,0;4,0;;;;1,0;2,0;;2,0;2,0;3,0;;10,0;;18,0;2,0;67,0;;;3,0;;;16,0;;;;;;34,0;;;;;2,0;;2,0;42,0;;4,0;;;25,0;2,0;3,0;1,0;;;;;;37,0;;13,0;12,0;8,0;;1,0;;;;7,0;9,0;10,0;;;;;18,0;4,0;;;10,0;;3,0;;;2,0;11,0;;;;;6,0;;1,0;;;41,0;;;;;17,0;;;;1,0;;1,0;;;;;62,0;71,0;2,0;1,0;;;;;;;;;;;;1,0;;;;;;;;4,0;;17,0;;;;;;;;;;;4,0;;4,0;;1,0;;4,0;;;2,0;;11,0;;1,0;;33,0;1,0;;;;;;9,0;;;;3,0;;;;;;;1,0;5,0;;;6,0;;;2,0;18,0;5,0;2,0;2,0;;;3,0;;3,0;;2,0;;;2,0;48,0;;;;1,0;;;2,0;;1,0;;;;;;3,0;2,0;1,0;35,0;;;;10,0;2,0;;;;;;9,0;;1,0;;4,0;4,0;;6,0;4,0;;;;5,0;;;2,0;2,0;;2,0;;;;;;;4,0;1,0;1,0;5,0;;;;1,0;;;4,0;;6,0;;;2,0;;2,0;;6,0;;4,0;;1,0;;;;;;10,0;1,0;1,0;;;17,0;;;2,0;19,0;;;;;;;;;;;;;;;;;;;;;;1,0;;;;2,0;;;;;;;25,0;;;;;;;;;;3,0;;1,0;;;;;;;;;8,0;;;;;;;;2,0;9,0;;;;;;;;
ratio;;;1,0;50,0;13,0;32,0;6,0;36,0;;5,0;1,0;1,0;;90,0;9,0;6,0;22,0;;;3,0;;22,0;57,0;;;4,0;;7,0;5,0;11,0;27,0;5,0;9,0;70,0;;65,0;24,0;13,0;7,0;;122,0;32,0;10,0;28,0;24,0;;;14,0;;1,0;;2,0;;;35,0;43,0;21,0;2,0;17,0;14,0;2,0;15,0;9,0;1,0;396,0;2,0;49,0;27,0;;2,0;67,0;107,0;67,0;2,0;23,0;1,0;15,0;1,0;;2,0;81,0;;;4,0;8,0;;;55,0;;1,0;25,0;;1,0;;4,0;;147,0;16,0;22,0;23,0;14,0;38,0;;6,0;11,0;21,0;32,0;2,0;1,0;;3,0;27,0;34,0;2,0;;;9,0;2,0;7,0;87,0;9,0;;48,0;30,0;2,0;1,0;78,0;24,0;28,0;;54,0;24,0;;71,0;8,0;;46,0;2,0;53,0;1,0;;;;3,0;11,0;40,0;51,0;2,0;2,0;;;10,0;13,0;4,0;;;;;1,0;1,0;;;1,0;7,0;;2,0;1,0;;12,0;11,0;12,0;21,0;;37,0;;8,0;;3,0;1,0;4,0;3,0;;;14,0;;2,0;21,0;;37,0;1,0;4,0;;;;;;3,0;;1,0;;;;;;15,0;13,0;12,0;1,0;1,0;1,0;2,0;7,0;11,0;;;;32,0;;19,0;;32,0;6,0;1,0;2,0;;;11,0;;;8,0;;7,0;65,0;;2,0;3,0;9,0;;;15,0;6,0;;1,0;;;21,0;2,0;16,0;28,0;;;;;;1,0;;2,0;8,0;;;1,0;7,0;3,0;10,0;;;1,0;6,0;12,0;3,0;;;5,0;;1,0;;2,0;16,0;;;3,0;;5,0;3,0;;;;2,0;6,0;;2,0;1,0;;;26,0;1,0;50,0;7,0;5,0;;;;;2,0;;;;;23,0;3,0;;;8,0;2,0;2,0;;4,0;;12,0;4,0;1,0;31,0;;15,0;;;;;5,0;1,0;;;;;9,0;1,0;;;;9,0;2,0;8,0;;;;;2,0;;;1,0;;;3,0;1,0;24,0;1,0;1,0;3,0;32,0;;;;;1,0;;;5,0;;;;;;89,0;11,0;23,0;5,0;;;4,0;;27,0;8,0;;2,0;3,0;24,0;;45,0;2,0;;13,0;8,0;6,0;17,0;1,0;24,0;1,0;9,0;8,0;;1,0;34,0;6,0;31,0;11,0;5,0;3,0;1,0;4,0;1,0;;2,0;;4,0;11,0;2,0;;;;;23,0;18,0;2,0;3,0;;17,0;;46,0;12,0;;1,0;;10,0;;2,0;;8,0;5,0;;;27,0;1,0;43,0;;3,0;19,0;4,0;;4,0;;;2,0;1,0;10,0;;;3,0;2,0;;;14,0;4,0;10,0;;1,0;6,0;1,0;3,0;;3,0;;;4,0;1,0;;;;;;;;5,0;;;;;13,0;;2,0;4,0;;;;5,0;1,0;;7,0;;1,0;;2,0;1,0;;;2,0;29,0;1,0;;;1,0;4,0;25,0;;;;;;7,0;;46,0;;;;;;;;;;;15,0;4,0;;;14,0;;19,0;2,0;;14,0;;4,0;;2,0;;4,0;;;;8,0;;;2,0;;4,0;;;1,0;;;2,0;;;2,0;;;3,0;3,0;;;;;;;;5,0;;1,0;;;;;4,0;;;;;;;10,0;;;;11,0;;;;;10,0;;;;;10,0;;;;3,0;26,0;3,0;;;;21,0;;;;;;;;;25,0;3,0;;;;;;1,0;;;12,0;;1,0;1,0;;;;;;1,0;;;;2,0;;1,0;;;;;1,0;;;2,0;3,0;;5,0;169,0;;1,0;;6,0;6,0;1,0;;;;;49,0;;;;;2,0;;3,0;94,0;2,0;;;;4,0;1,0;;13,0;;;;;;;;11,0;3,0;;8,0;;;3,0;1,0;9,0;3,0;2,0;;1,0;;;37,0;1,0;;;;1,0;2,0;;;11,0;15,0;2,0;8,0;;2,0;;;;;;1,0;;;;2,0;;;;;2,0;;;;;;;2,0;;;;;;;;;;1,0;1,0;;;4,0;;3,0;;;;;;;;;3,0;;14,0;;;;;;;;4,0;;;;6,0;2,0;2,0;46,0;;;;;7,0;;;;10,0;;;;;;;50,0;;;;;;1,0;;2,0;;;;2,0;;10,0;1,0;;;8,0;4,0;;;;;2,0;19,0;;;;;;2,0;3,0;109,0;2,0;;;2,0;;;;2,0;;4,0;;;;10,0;2,0;7,0;18,0;5,0;1,0;4,0;3,0;4,0;;9,0;;;;;;4,0;;4,0;;3,0;2,0;7,0;4,0;;;;;12,0;2,0;1,0;;;324,0;;;1,0;;17,0;;;;2,0;;;;1,0;;;1,0;;;;;;;;9,0;3,0;16,0;;1,0;;;;;;;;;;;;1,0;;2,0;;6,0;2,0;12,0;;;;;3,0;;;;;1,0;;;36,0;;;1,0;;3,0;;;;;;;;;;;7,0;6,0;;2,0;22,0;;;;;;;;;3,0;5,0;;1,0;;1,0;;;;;8,0;12,0;1,0;;1,0;;;;4,0;;;;;5,0;;;2,0;;
require;;;1,0;2,0;19,0;1,0;4,0;;;;;;2,0;8,0;1,0;;16,0;;1,0;1,0;1,0;;;;9,0;;4,0;1,0;;;1,0;3,0;7,0;2,0;;15,0;;;9,0;;18,0;11,0;;1,0;17,0;;2,0;3,0;;2,0;4,0;;;2,0;35,0;2,0;2,0;;;3,0;;;;;72,0;;1,0;1,0;;;1,0;4,0;20,0;;1,0;;2,0;1,0;2,0;4,0;9,0;;9,0;7,0;4,0;;;10,0;;4,0;9,0;;;;1,0;;13,0;;;4,0;9,0;7,0;;6,0;20,0;2,0;;;;1,0;3,0;12,0;2,0;;;;15,0;3,0;;18,0;;;5,0;7,0;1,0;;10,0;;;2,0;28,0;;;4,0;;;37,0;;;;;1,0;;;3,0;;7,0;2,0;9,0;2,0;;;1,0;;10,0;1,0;;;;1,0;;;1,0;2,0;3,0;2,0;;2,0;3,0;1,0;3,0;2,0;;8,0;2,0;;1,0;1,0;3,0;;10,0;;2,0;;3,0;;9,0;2,0;7,0;;;1,0;;;1,0;3,0;2,0;;;;;;3,0;;3,0;1,0;8,0;;;5,0;18,0;5,0;6,0;;;;1,0;;;2,0;;15,0;;;;;;5,0;;;;;5,0;;;5,0;;;;1,0;;;;;1,0;10,0;;2,0;;;;2,0;;4,0;;2,0;5,0;2,0;;;1,0;4,0;;3,0;2,0;;;;2,0;1,0;;;4,0;;;;1,0;17,0;;;;1,0;4,0;1,0;;1,0;;1,0;1,0;;1,0;;;;;;1,0;1,0;;;;;;;;;;;1,0;;;1,0;;;;;3,0;14,0;;3,0;15,0;6,0;;2,0;;;;;28,0;;;;;;;;;;;;;14,0;;;;1,0;;;;;;;;;;;1,0;;4,0;;;;;;;3,0;;;;2,0;;;1,0;16,0;;1,0;;;4,0;;9,0;2,0;;1,0;3,0;7,0;1,0;5,0;;9,0;1,0;;;1,0;;2,0;;3,0;4,0;;;4,0;;8,0;;;;5,0;2,0;4,0;;;;2,0;17,0;;;;;;;2,0;2,0;;2,0;9,0;1,0;9,0;;;1,0;;2,0;;;;;1,0;2,0;;;;4,0;;;;14,0;1,0;20,0;;;13,0;3,0;;;1,0;;5,0;1,0;;2,0;;1,0;2,0;;9,0;;;;;;;3,0;;;;;3,0;;2,0;;1,0;;7,0;;;4,0;;;5,0;;;;3,0;;;22,0;5,0;1,0;;1,0;;;;;;;2,0;;;;;;;;;;;;;;;;;;;;;;;;;;;;;;;7,0;;;2,0;;;;;;;;4,0;;;2,0;3,0;4,0;;;2,0;;;2,0;3,0;3,0;2,0;;;1,0;;1,0;4,0;;;;2,0;;;;1,0;;;;;;;;;;;3,0;;;;;;;;;;;;;;;;2,0;4,0;;2,0;;;6,0;;1,0;;;;1,0;;;;;;;1,0;;;;;;;;;;;;;;;;;;;1,0;;;;;;;;;;2,0;;;3,0;;;;;;;;;1,0;;2,0;;;;4,0;;;;2,0;;;;14,0;;;5,0;;4,0;;;;;3,0;1,0;;;;;1,0;2,0;;;;;2,0;;;23,0;2,0;;;1,0;;;;;;1,0;3,0;1,0;;1,0;1,0;2,0;;;;;4,0;;;;;1,0;;;;;;2,0;1,0;;;;5,0;;;;;;;1,0;;;;;;;;;;;;;;;;;;2,0;;;;;1,0;;;;;;;;1,0;;;;;;;;;1,0;1,0;1,0;;;1,0;;1,0;;;;;;;;;3,0;;;;;;;;;;1,0;;1,0;;;;;;;;4,0;;;;;;;;;;;1,0;;;1,0;;1,0;1,0;;;;;;;;2,0;;;2,0;;2,0;2,0;;;;;;;;2,0;;;;;2,0;;;;1,0;;1,0;;;;;1,0;;;;;;;;;3,0;;;;;;;;;1,0;;;;;;;;10,0;;;2,0;;2,0;;;;;;;;;;;;;2,0;;;;2,0;;;;;;;;;;;;;;2,0;1,0;;;;;;;;;;;;;;;;;;;;;3,0;;;;;;5,0;;;;;2,0;;;;;;;;;;;;;;;;;;;;;;;;;;
rotatable;;;1,0;2,0;3,0;35,0;;49,0;;;1,0;;8,0;155,0;;;1,0;;6,0;;;;;;;;;11,0;;1,0;59,0;4,0;;;;1,0;17,0;35,0;;;2,0;51,0;1,0;5,0;15,0;27,0;;49,0;;;;;25,0;2,0;2,0;;4,0;;;;;;;;10,0;2,0;83,0;;;1,0;3,0;61,0;36,0;3,0;1,0;;;2,0;;3,0;15,0;;;;15,0;46,0;;36,0;;;;;2,0;2,0;1,0;;1,0;27,0;13,0;6,0;110,0;2,0;6,0;;;;;1,0;1,0;;;;;7,0;;;;6,0;3,0;2,0;;8,0;;3,0;;;28,0;;1,0;;4,0;;;49,0;2,0;;5,0;;;1,0;3,0;5,0;;;11,0;1,0;3,0;14,0;4,0;8,0;15,0;2,0;36,0;7,0;;;7,0;;;;;24,0;;;;;59,0;29,0;;10,0;2,0;;1,0;72,0;26,0;2,0;;10,0;23,0;3,0;;;2,0;3,0;24,0;;15,0;15,0;20,0;1,0;4,0;3,0;;12,0;2,0;6,0;48,0;7,0;2,0;;;;4,0;3,0;1,0;2,0;425,0;;38,0;162,0;4,0;32,0;;;;9,0;3,0;17,0;;1,0;;;;;20,0;;191,0;2,0;5,0;1,0;2,0;;9,0;1,0;5,0;;1,0;;3,0;1,0;;56,0;;14,0;3,0;4,0;10,0;4,0;42,0;3,0;1,0;;;48,0;;1,0;90,0;47,0;4,0;;;10,0;;1,0;5,0;;;;2,0;14,0;;5,0;10,0;2,0;;;8,0;30,0;6,0;2,0;;;215,0;;;;1,0;2,0;;;2,0;1,0;9,0;12,0;1,0;9,0;;;2,0;19,0;25,0;;;;6,0;9,0;8,0;3,0;;4,0;;1,0;10,0;;;2,0;;13,0;17,0;49,0;1,0;2,0;5,0;;;1,0;;;1,0;;;10,0;4,0;3,0;;;2,0;1,0;;3,0;60,0;130,0;31,0;10,0;;8,0;32,0;6,0;;9,0;2,0;1,0;;;11,0;8,0;;33,0;2,0;2,0;;;;4,0;;1,0;;;;1,0;;;;8,0;7,0;2,0;;;;;33,0;;;;1,0;12,0;;;;;;;;26,0;;;;;;;;49,0;;;2,0;9,0;;3,0;2,0;22,0;2,0;2,0;;4,0;8,0;1,0;1,0;4,0;2,0;;;1,0;;;1,0;7,0;2,0;10,0;;;;;2,0;;9,0;10,0;2,0;;;;;;;30,0;;1,0;;;;;;;2,0;11,0;5,0;;;4,0;;;;;;;;;;;;;;4,0;;3,0;18,0;7,0;;1,0;;2,0;2,0;1,0;;1,0;2,0;4,0;;1,0;;;;;4,0;3,0;;1,0;;1,0;;2,0;1,0;;;;;11,0;;;;;;;8,0;;;;5,0;3,0;;;6,0;9,0;1,0;;;;6,0;;1,0;;25,0;;2,0;4,0;8,0;;;;2,0;;;;2,0;8,0;;;;;;;;;;;;;;2,0;;;;;8,0;;;;;;;;;2,0;;;1,0;;;;5,0;;;;7,0;;;2,0;49,0;;1,0;;;;;;;;;;;;;;;;;;;10,0;;;;;;4,0;1,0;10,0;;;;6,0;2,0;;;;;;;;;;19,0;;;;;;;;7,0;;4,0;;;2,0;;4,0;;11,0;1,0;;;;;;5,0;7,0;;;;6,0;;;;;;;1,0;;;;1,0;;4,0;;;;;4,0;2,0;;;;;;;1,0;;;4,0;1,0;;42,0;;;;12,0;4,0;;;30,0;;;;43,0;11,0;6,0;14,0;3,0;;;;;4,0;;1,0;;;3,0;;;;;;;;15,0;12,0;6,0;;;;;;3,0;98,0;;;46,0;;1,0;2,0;1,0;;27,0;;2,0;16,0;;4,0;;6,0;;2,0;7,0;;;;6,0;;1,0;;;;6,0;;;;;;;6,0;3,0;;;;2,0;;4,0;;3,0;;;;;;;;;;;;;;;;;;;;;;;;;;;;;;;;;;;;;;;;;;;;;;;;;;;;;;;;;1,0;;;;;4,0;;;;;;;;;;;;;;;1,0;;;;;;1,0;;;;;;;;;;;;;;;;;;17,0;;;;;;;;;;;;1,0;;;;3,0;;;;;;;;;;;;;;;;;;1,0;;2,0;;;2,0;;;;;;;4,0;;;;;3,0;;;;1,0;;;;;1,0;;;;;;;;4,0;;;;1,0;2,0;;;;;;;;;;;2,0;;;;;;;;;;;;;;;;;;;;1,0;;1,0;;;;;;;;;;;;;
screen;;;1,0;18,0;8,0;90,0;1,0;4,0;1,0;1,0;;;;115,0;;10,0;81,0;;;1,0;;;8,0;6,0;11,0;1,0;;16,0;23,0;6,0;136,0;25,0;8,0;13,0;2,0;84,0;7,0;3,0;15,0;;80,0;524,0;;63,0;1932,0;26,0;1,0;15,0;24,0;1,0;1,0;;1,0;4,0;7,0;3,0;11,0;;2,0;31,0;1,0;8,0;7,0;2,0;622,0;;107,0;;;;15,0;25,0;50,0;2,0;7,0;;4,0;7,0;3,0;20,0;157,0;;21,0;19,0;60,0;3,0;;22,0;1,0;12,0;8,0;;;;18,0;;79,0;61,0;37,0;55,0;158,0;61,0;;12,0;49,0;87,0;1,0;7,0;2,0;;;9,0;81,0;1,0;;;12,0;5,0;51,0;69,0;;;34,0;16,0;;12,0;141,0;;6,0;;13,0;;;100,0;3,0;1,0;135,0;29,0;15,0;;;1,0;;;9,0;16,0;182,0;13,0;11,0;4,0;1,0;8,0;12,0;6,0;1,0;;;1,0;4,0;;;17,0;79,0;15,0;;2,0;40,0;12,0;;7,0;7,0;;11,0;56,0;;10,0;3,0;;7,0;1,0;;4,0;1,0;16,0;;7,0;1,0;;45,0;43,0;3,0;;;4,0;1,0;;46,0;;;;;5,0;1,0;4,0;;13,0;14,0;1,0;4,0;28,0;11,0;19,0;21,0;10,0;;1,0;34,0;2,0;11,0;;21,0;;;;3,0;;70,0;2,0;4,0;2,0;;5,0;13,0;7,0;22,0;3,0;3,0;3,0;;13,0;;;;;;37,0;2,0;20,0;35,0;44,0;;;;11,0;;2,0;5,0;57,0;11,0;;1,0;27,0;3,0;12,0;5,0;8,0;;;;13,0;;2,0;;1,0;3,0;2,0;12,0;52,0;3,0;9,0;;1,0;5,0;;9,0;;;13,0;5,0;2,0;;;;;9,0;5,0;51,0;16,0;;;;;24,0;;;1,0;6,0;34,0;6,0;22,0;;;;;9,0;;31,0;43,0;29,0;7,0;100,0;87,0;6,0;36,0;1,0;3,0;;;8,0;12,0;;;;1,0;3,0;;4,0;;;;9,0;15,0;;;;;5,0;10,0;6,0;;;;4,0;1,0;28,0;;9,0;9,0;99,0;2,0;5,0;;4,0;4,0;2,0;2,0;;;;3,0;;;51,0;15,0;28,0;17,0;4,0;14,0;4,0;;178,0;140,0;;3,0;8,0;68,0;;4,0;3,0;31,0;;21,0;5,0;11,0;;9,0;;12,0;8,0;;2,0;94,0;5,0;3,0;;35,0;6,0;37,0;13,0;;;7,0;2,0;14,0;45,0;25,0;1,0;;;;3,0;;;;2,0;77,0;29,0;35,0;4,0;9,0;26,0;;24,0;3,0;2,0;;7,0;28,0;16,0;;;48,0;8,0;6,0;7,0;13,0;;;252,0;;;1,0;10,0;5,0;;1,0;6,0;14,0;;1,0;48,0;3,0;4,0;12,0;;2,0;2,0;44,0;1,0;16,0;11,0;24,0;17,0;90,0;3,0;;;2,0;8,0;10,0;;14,0;;3,0;9,0;15,0;10,0;21,0;37,0;1,0;;;;23,0;;4,0;;2,0;4,0;;1,0;24,0;;627,0;3,0;7,0;9,0;13,0;1,0;;4,0;;30,0;;;1,0;;2,0;;;;4,0;2,0;10,0;;;;;;8,0;;43,0;1,0;25,0;2,0;11,0;4,0;1,0;;;;2,0;3,0;13,0;30,0;9,0;1,0;;;87,0;2,0;;1,0;30,0;8,0;19,0;;;;;;6,0;;;5,0;1,0;26,0;;;4,0;;1,0;1,0;;5,0;4,0;;2,0;;4,0;2,0;;;3,0;2,0;;;3,0;1,0;;8,0;1,0;;;;2,0;;6,0;12,0;;3,0;;4,0;3,0;6,0;;15,0;;;;;;16,0;;9,0;;1,0;1,0;;;2,0;1,0;1,0;4,0;;1,0;;1,0;5,0;48,0;;;4,0;7,0;;1,0;;;1,0;1,0;5,0;;1,0;;;3,0;1,0;;;17,0;;14,0;15,0;;11,0;2,0;24,0;22,0;;1,0;1,0;;1,0;;21,0;;;;;;14,0;;11,0;15,0;6,0;56,0;;;79,0;;;;;1,0;2,0;9,0;5,0;;1,0;;;;;;;4,0;4,0;1,0;;;6,0;;5,0;;3,0;;;1,0;16,0;1,0;14,0;1,0;1,0;;1,0;6,0;1,0;;;2,0;11,0;;;1,0;10,0;2,0;;;35,0;;2,0;;;7,0;26,0;;1,0;;6,0;1,0;23,0;1,0;1,0;;;;59,0;13,0;3,0;2,0;;;;;;;3,0;;;3,0;;14,0;;;18,0;;;;;;16,0;;3,0;1,0;1,0;;;1,0;3,0;;3,0;8,0;;;1,0;;4,0;26,0;;1,0;;;2,0;;;;;;;;;;;8,0;;;;;7,0;4,0;;1,0;;;;;;2,0;;;;1,0;;3,0;;;;2,0;;;;4,0;;;2,0;;2,0;;;;2,0;;1,0;;;2,0;1,0;;2,0;;17,0;;;;4,0;;5,0;3,0;;1,0;;11,0;1,0;;;;1,0;2,0;;2,0;;4,0;5,0;9,0;;;9,0;;;;2,0;6,0;4,0;;;;;9,0;5,0;2,0;;2,0;2,0;;5,0;20,0;;2,0;3,0;5,0;;;1,0;2,0;2,0;;;3,0;;;;11,0;;;;;;6,0;;7,0;;2,0;;;5,0;;;2,0;;;;;1,0;2,0;2,0;;;;;2,0;;;;;;;;;;;;;7,0;;17,0;13,0;;1,0;;8,0;;;;1,0;;;5,0;12,0;;1,0;;3,0;4,0;22,0;;1,0;;56,0;2,0;;4,0;;;5,0;4,0;4,0;;;;2,0;4,0;;2,0;;2,0;;;;;
seal;;;1,0;2,0;;8,0;10,0;39,0;;;9,0;;34,0;24,0;;;9,0;;16,0;;2,0;;;2,0;7,0;;;8,0;;;49,0;2,0;;;6,0;;9,0;;;;;55,0;;5,0;;47,0;;110,0;;;;;37,0;16,0;;;89,0;;;;4,0;;9,0;;25,0;;39,0;;;4,0;;73,0;7,0;7,0;;;18,0;;;1,0;33,0;4,0;;;50,0;5,0;;13,0;2,0;2,0;;2,0;3,0;3,0;1,0;;2,0;;13,0;;33,0;;;;;;;;;;;;1,0;;5,0;;1,0;4,0;;19,0;;;3,0;1,0;;;51,0;;1,0;;;;;23,0;;8,0;2,0;;;1,0;1,0;2,0;;;26,0;4,0;6,0;28,0;;14,0;1,0;9,0;35,0;35,0;;;14,0;2,0;;2,0;1,0;8,0;;;;;38,0;83,0;;;14,0;;;4,0;13,0;4,0;;;;;;;;6,0;6,0;;2,0;;;47,0;;1,0;11,0;13,0;1,0;14,0;200,0;;17,0;8,0;;10,0;2,0;;;;172,0;;;31,0;;1,0;;4,0;;73,0;;;;1,0;;;;;36,0;6,0;94,0;10,0;10,0;1,0;;;;;18,0;;;;;;1,0;83,0;3,0;;;7,0;2,0;4,0;32,0;;4,0;2,0;;11,0;17,0;5,0;22,0;98,0;14,0;;;;;4,0;11,0;7,0;;1,0;;31,0;;9,0;4,0;6,0;;2,0;4,0;;1,0;36,0;11,0;;4,0;17,0;;;9,0;3,0;14,0;;7,0;6,0;5,0;20,0;3,0;1,0;;;4,0;10,0;;15,0;12,0;;;7,0;;1,0;3,0;4,0;;;5,0;1,0;5,0;;10,0;;5,0;2,0;;;3,0;;;7,0;4,0;;3,0;10,0;4,0;4,0;;6,0;;;2,0;3,0;;;;2,0;;7,0;1,0;6,0;2,0;36,0;;1,0;;;;;;13,0;;22,0;;;;;;;;;;;3,0;;12,0;;;2,0;;;;;;;4,0;;;;;;;;;;;;;1,0;;;;;;;;;;;;;;;;;;;;;;;;;;;;;;;;19,0;;;;;;;;;;;8,0;;;;;;;;;;;;;;;;;;;1,0;;;;1,0;;3,0;;47,0;;;;;;;;1,0;;10,0;16,0;1,0;4,0;;;;1,0;;5,0;6,0;;2,0;;;;;;;;4,0;;;;12,0;;;;;1,0;;;;1,0;;;;;;;4,0;3,0;;;16,0;14,0;1,0;;19,0;;4,0;;;26,0;;19,0;;;;;;;4,0;;;4,0;;;;13,0;38,0;;;;;5,0;;;5,0;;;;;;;4,0;;;;1,0;3,0;;;;;1,0;1,0;;1,0;;25,0;5,0;;1,0;;6,0;;;2,0;;54,0;1,0;32,0;4,0;;;;1,0;;;;10,0;;;3,0;3,0;;;;;;;;;;;;;;;;;5,0;;;;;;;;;;;;;;;;;;;;;;1,0;1,0;;;;2,0;2,0;;;;7,0;;1,0;;;;;1,0;;;1,0;;1,0;;;;;;1,0;;;11,0;;3,0;;;;;;;;;;;3,0;;;;;;3,0;9,0;;;12,0;;;8,0;10,0;;;;;;1,0;;3,0;1,0;;;8,0;;;;;;;4,0;;;1,0;;;;;5,0;;;;5,0;;;;;;;;9,0;;;;;;;;;4,0;;;;;;;;;17,0;3,0;;2,0;;15,0;8,0;3,0;20,0;;;2,0;;;;;;;;3,0;1,0;;;;4,0;9,0;2,0;2,0;;;;3,0;27,0;;2,0;;;;;;;;;;;;;;2,0;;2,0;;;;;;;;;;;;;;2,0;;;;;;;;;;;;;34,0;;;;;;;1,0;3,0;3,0;;2,0;2,0;;;;;;;;2,0;;;;;;;;;;;;;;;;;;;;8,0;;;;;3,0;;;;;;;;;;;;;;;;;1,0;;;;;;;;;;;;;;;16,0;;;;;;1,0;1,0;;;3,0;1,0;;;;;;;;;;;;;;;;;;;;;;;;;;;;;1,0;;;;;;1,0;;;;;;;;14,0;;;;;2,0;2,0;;;;;;13,0;1,0;;;;;;;;1,0;;;;;;;;;;;;;;;1,0;;;
seat;;;1,0;;;20,0;;3,0;;;1,0;;4,0;49,0;;;14,0;;2,0;;1,0;;;;2,0;1,0;;4,0;;;38,0;3,0;;;;;10,0;;2,0;2,0;3,0;34,0;;;11,0;29,0;;9,0;;;;;14,0;;;1,0;23,0;;;1,0;;;;;36,0;;43,0;;;;1,0;53,0;20,0;;;;2,0;;;;25,0;;1,0;3,0;24,0;4,0;;2,0;;1,0;;2,0;4,0;;;;;;22,0;;46,0;4,0;;;1,0;1,0;;;;;;7,0;3,0;;1,0;;;1,0;;15,0;;;9,0;;;2,0;19,0;;;;1,0;1,0;;28,0;;;16,0;1,0;;;5,0;;1,0;;;1,0;14,0;7,0;14,0;7,0;;;13,0;10,0;;;;;;;3,0;11,0;;;;;20,0;13,0;;7,0;;;9,0;17,0;2,0;3,0;;;;;;;;5,0;3,0;;2,0;;26,0;44,0;;;6,0;2,0;4,0;4,0;22,0;;;;;2,0;;;;;9,0;2,0;5,0;37,0;1,0;;;;;3,0;4,0;2,0;;3,0;1,0;2,0;;;26,0;;89,0;4,0;;;11,0;;4,0;;46,0;;1,0;1,0;;;;6,0;;1,0;1,0;;1,0;4,0;17,0;8,0;1,0;;;3,0;2,0;1,0;16,0;86,0;2,0;;;;;45,0;3,0;;;2,0;2,0;;2,0;1,0;2,0;2,0;;;2,0;5,0;2,0;;30,0;;3,0;17,0;;;40,0;48,0;11,0;;2,0;1,0;;2,0;;3,0;10,0;43,0;3,0;1,0;;2,0;;2,0;5,0;4,0;1,0;10,0;2,0;;;;1,0;5,0;2,0;;4,0;;;2,0;;5,0;7,0;;;10,0;;1,0;4,0;2,0;8,0;2,0;;21,0;;;1,0;1,0;;;4,0;;;2,0;;5,0;;14,0;;;;;2,0;;2,0;;1,0;4,0;17,0;2,0;;;;;;;1,0;;;;4,0;;;2,0;;;;;;1,0;12,0;;;3,0;;7,0;;4,0;;3,0;;;;;2,0;;;17,0;;;;;1,0;1,0;;4,0;;3,0;34,0;3,0;1,0;2,0;;;;5,0;;4,0;;;;;;1,0;;14,0;;2,0;;2,0;1,0;;;;;1,0;4,0;;5,0;;1,0;3,0;4,0;;;;;;13,0;;;;;;6,0;;;;;;;;;;;;;;;1,0;;;;2,0;5,0;1,0;1,0;1,0;;;;;;;;;7,0;;1,0;;;1,0;;11,0;;1,0;;1,0;;1,0;;;8,0;;2,0;2,0;;;;3,0;;;;;;;;;6,0;;4,0;4,0;;1,0;;;;6,0;;;1,0;;1,0;4,0;3,0;;;;8,0;1,0;;1,0;;15,0;;;;1,0;;;2,0;;;;3,0;;;;;;;;1,0;;2,0;;;;;;;2,0;;;;;2,0;;;;;;;;2,0;;1,0;;;;;;;;;;;;;4,0;1,0;;;;3,0;;;;;;;;;;;;1,0;2,0;;;;;;7,0;;;1,0;;;;;;;;2,0;;;;;;;;19,0;;;;;;;;;;;;;;;;2,0;;;;;;;;2,0;;;;2,0;;;10,0;;;;1,0;1,0;;;;;;;;;;4,0;;;3,0;;;;27,0;;3,0;1,0;1,0;;;;1,0;1,0;;7,0;;;;;1,0;5,0;;;;;6,0;;;;3,0;;;;3,0;1,0;;;;2,0;;;;1,0;;;4,0;1,0;;;;;1,0;1,0;;;4,0;;;;;3,0;;;;;;;;4,0;1,0;;;;;;;;1,0;;10,0;;2,0;;;;4,0;6,0;;;;;;;;;4,0;;;;;1,0;;;;;;;;4,0;;;;6,0;;;;;;;;;;;;;;;;;;;;;;;;;2,0;;;;;;;;;;;;;;;;1,0;;;;;;;;;;;;;;;;;;;;;;;4,0;;;;;;;;;;;;1,0;1,0;;;;;;;;;;;;;;;2,0;;;;;;;;;;1,0;;;;;;;;;;;;;;;;;;;;1,0;;;;;4,0;;2,0;;;;;;;;;;1,0;;;;;;;;;;;;2,0;;;;;2,0;;;;;;;;;;4,0;1,0;;;;;;;;;;;;;;;;;;;;;;;;;3,0;;;
segment;;;1,0;8,0;34,0;63,0;15,0;8,0;;;;1,0;;122,0;1,0;12,0;27,0;;22,0;3,0;;4,0;18,0;7,0;6,0;;;19,0;10,0;1,0;80,0;;;3,0;;41,0;24,0;6,0;32,0;1,0;155,0;39,0;2,0;20,0;38,0;6,0;11,0;15,0;;;1,0;;60,0;;42,0;;81,0;;2,0;65,0;2,0;1,0;46,0;;277,0;;187,0;;5,0;;48,0;16,0;17,0;;3,0;;12,0;13,0;8,0;2,0;131,0;;4,0;19,0;12,0;5,0;;16,0;;3,0;13,0;17,0;2,0;10,0;10,0;;33,0;32,0;284,0;87,0;116,0;7,0;;19,0;20,0;22,0;3,0;7,0;26,0;2,0;;28,0;37,0;1,0;7,0;3,0;6,0;44,0;75,0;25,0;18,0;;9,0;;9,0;8,0;33,0;;2,0;4,0;51,0;1,0;5,0;30,0;;;100,0;2,0;11,0;;23,0;22,0;;;7,0;11,0;22,0;21,0;24,0;14,0;2,0;9,0;12,0;77,0;;;13,0;;;;2,0;65,0;5,0;7,0;;;199,0;10,0;;17,0;13,0;1,0;14,0;15,0;10,0;47,0;1,0;1,0;11,0;;9,0;4,0;;22,0;6,0;;12,0;;263,0;41,0;;16,0;;;2,0;2,0;133,0;2,0;28,0;4,0;;3,0;;;3,0;11,0;13,0;1,0;;116,0;5,0;9,0;13,0;;;60,0;2,0;23,0;6,0;6,0;15,0;;;;9,0;;63,0;4,0;3,0;4,0;5,0;;3,0;2,0;18,0;2,0;1,0;;;40,0;;16,0;32,0;47,0;2,0;26,0;27,0;9,0;59,0;1,0;;16,0;;14,0;;;15,0;97,0;3,0;;;8,0;2,0;15,0;51,0;;;;13,0;2,0;;34,0;;7,0;;;;17,0;2,0;7,0;5,0;2,0;16,0;1,0;;2,0;9,0;2,0;3,0;13,0;;128,0;4,0;2,0;2,0;59,0;29,0;;4,0;6,0;2,0;4,0;6,0;4,0;;8,0;44,0;44,0;3,0;5,0;1,0;4,0;6,0;46,0;12,0;;17,0;6,0;1,0;52,0;;69,0;4,0;29,0;;3,0;;2,0;2,0;;43,0;5,0;10,0;67,0;7,0;1,0;2,0;;1,0;6,0;15,0;5,0;3,0;2,0;;32,0;;6,0;;;;;4,0;2,0;55,0;;;10,0;294,0;;;;;;;3,0;4,0;29,0;8,0;2,0;;;10,0;6,0;21,0;;;;21,0;;19,0;13,0;;;12,0;67,0;3,0;8,0;;5,0;1,0;6,0;24,0;20,0;1,0;19,0;1,0;50,0;9,0;;;6,0;4,0;21,0;20,0;15,0;;;12,0;6,0;;8,0;2,0;;10,0;8,0;4,0;1,0;;20,0;;;;4,0;1,0;62,0;;10,0;;9,0;;;;;12,0;;5,0;;6,0;;7,0;12,0;42,0;;8,0;4,0;7,0;1,0;28,0;;4,0;;;12,0;43,0;;;7,0;25,0;14,0;11,0;7,0;;10,0;;;;2,0;;;5,0;1,0;9,0;10,0;29,0;23,0;4,0;;;;7,0;4,0;;10,0;13,0;4,0;22,0;;;10,0;;;26,0;7,0;;15,0;5,0;;;;;7,0;1,0;;4,0;80,0;;;;12,0;30,0;2,0;6,0;;3,0;9,0;;27,0;;;6,0;2,0;4,0;5,0;;;;;;;15,0;3,0;16,0;16,0;72,0;;;;2,0;16,0;1,0;;3,0;42,0;;6,0;;;1,0;;;;1,0;124,0;;7,0;;6,0;;;;16,0;;;3,0;;;;;1,0;;;;;29,0;6,0;1,0;4,0;;;1,0;;;;4,0;;6,0;2,0;38,0;11,0;;;;5,0;;4,0;;;2,0;;1,0;1,0;2,0;28,0;1,0;10,0;;;;;9,0;;;;;25,0;2,0;;;;3,0;;3,0;4,0;;;1,0;;;4,0;;;6,0;18,0;;;;;19,0;;;1,0;12,0;4,0;2,0;;;1,0;;;;1,0;1,0;;5,0;3,0;;;1,0;;;1,0;8,0;;;;;1,0;1,0;;21,0;;3,0;1,0;6,0;8,0;;;8,0;;;6,0;;;2,0;;;;;;;;;1,0;1,0;1,0;;15,0;;14,0;;1,0;15,0;;2,0;6,0;;2,0;;;1,0;10,0;;1,0;;;;;;2,0;;11,0;;;13,0;3,0;2,0;7,0;;;;;;5,0;37,0;2,0;2,0;25,0;;10,0;4,0;;24,0;18,0;4,0;1,0;;;;;4,0;;;;1,0;;16,0;;41,0;7,0;8,0;21,0;1,0;21,0;;;;1,0;;;10,0;;7,0;;;1,0;2,0;;;12,0;;;1,0;;;;;72,0;;;;;;;;3,0;;;;;;;1,0;;5,0;2,0;;;7,0;20,0;;6,0;7,0;;;;;;1,0;2,0;;6,0;;;1,0;;;7,0;;;4,0;;3,0;;;;;1,0;;;3,0;2,0;;11,0;;;3,0;;1,0;;14,0;3,0;;;5,0;2,0;8,0;;2,0;4,0;30,0;;;;;;;;;;2,0;10,0;2,0;28,0;3,0;;1,0;;13,0;;;;;;;;;;;6,0;;1,0;;;;;;3,0;;20,0;;;2,0;;;;3,0;3,0;1,0;;;8,0;;;;;;;;;;7,0;;;;4,0;27,0;;2,0;3,0;;;;3,0;5,0;;1,0;3,0;;;5,0;1,0;10,0;;;;5,0;;2,0;;2,0;4,0;7,0;;5,0;;;;2,0;;;;;;;;;2,0;;;12,0;;1,0;;;;1,0;87,0;;;18,0;;;;;;;;39,0;;;;;;;;;;;
shake;;;2,0;11,0;173,0;121,0;;2,0;;;;;7,0;40,0;;;11,0;;;;;;;;3,0;12,0;40,0;4,0;;3,0;57,0;11,0;68,0;337,0;;6,0;6,0;;;;44,0;71,0;;4,0;4,0;9,0;3,0;17,0;;;;;;2,0;;1,0;11,0;;11,0;12,0;;;;;81,0;;39,0;;;;1,0;100,0;5,0;;;;;;;7,0;14,0;;1,0;;39,0;11,0;;14,0;;6,0;3,0;;;;6,0;;6,0;1,0;14,0;;13,0;7,0;;4,0;35,0;13,0;;1,0;;;;21,0;2,0;1,0;;;;;1,0;52,0;;;38,0;;;12,0;20,0;1,0;;;4,0;;;99,0;;;1,0;;2,0;;;;;20,0;;2,0;3,0;;8,0;;;;17,0;;;;;;;;;3,0;;;;;;;;84,0;61,0;3,0;;48,0;;;1,0;;1,0;;;;;5,0;;;;3,0;3,0;;;8,0;;4,0;5,0;;3,0;;;2,0;;;9,0;;5,0;;5,0;;;4,0;11,0;11,0;5,0;;;;51,0;;;4,0;;;;;;;12,0;;1,0;2,0;;;9,0;10,0;;1,0;;;;11,0;;;;;;;;1,0;4,0;;;;;3,0;;2,0;;6,0;;;;7,0;;;;;;;;;;3,0;30,0;3,0;;;;31,0;;3,0;;1,0;22,0;10,0;;;6,0;5,0;24,0;;20,0;3,0;;;;;10,0;15,0;;;;;;;;;;;1,0;24,0;1,0;;1,0;;;;3,0;;1,0;11,0;;3,0;1,0;;;;8,0;;3,0;;;;;;;;;;;;;;;;;2,0;;;;1,0;;;;;;;1,0;;27,0;;;;;;4,0;;;12,0;;3,0;;;11,0;;5,0;3,0;;4,0;;;39,0;;;;;114,0;16,0;1,0;;;8,0;11,0;;5,0;2,0;34,0;;;1,0;4,0;;;;3,0;;;;;7,0;2,0;;11,0;;;10,0;;5,0;;;;;;;;;2,0;;10,0;;4,0;12,0;;19,0;;10,0;;2,0;15,0;;;;;1,0;6,0;;;;;5,0;2,0;;;;;;;;4,0;;;2,0;;;;;;1,0;2,0;;;5,0;;;1,0;;;;;;;26,0;;;;;2,0;14,0;;1,0;;;1,0;;;;;2,0;2,0;;5,0;;2,0;;;3,0;2,0;;;;;;12,0;;;1,0;;;5,0;;;;;;1,0;;;;;;;;1,0;;;5,0;;;;;;;;;1,0;;;;;;;;;;;;;;;;;;;;;;;;2,0;;;;;;;;;;;;;;;;;2,0;;;8,0;;;;;;;;;;;;;;;;;3,0;;;;;;;;;;;;;;;;;;;;;;;;;1,0;;;;;;;1,0;;1,0;4,0;;1,0;4,0;;9,0;;4,0;;;;;;;;;;;;8,0;;;;7,0;8,0;9,0;;;;;;;;15,0;;;;;;21,0;;;;;;;;;;;;;;;;;;;1,0;;;;;;24,0;28,0;;;;;;;;;;;;;;30,0;;3,0;;;2,0;3,0;;;;;1,0;;;;;;;;;2,0;;;;;;;;1,0;;;3,0;;;;;1,0;3,0;;;;;;;;;;;;;;;;;;;;;;;;;;;;;;;9,0;;1,0;;;;28,0;;;;;;;;;;;;1,0;;;;;;;;;;;;;;;;;;;;;;;;;;;;;;2,0;;;1,0;;;;;;;9,0;;;;;;;;1,0;;1,0;;;;8,0;;;;;;;;;6,0;;;;;;;;;1,0;;;;;2,0;;;;;;;1,0;;;;;;;;;;;;;;;;;;;;;;;;;;;1,0;;;;2,0;;;4,0;;;;1,0;;;;1,0;;;;;8,0;2,0;;;;3,0;;13,0;;;;;;;;4,0;8,0;;;;;;;;;;;;;;;;;;;;;;;;;;;;;;;;;;;;;;;;;;;;;;;;
sharpness;;;5,0;2,0;7,0;5,0;;2,0;;;;2,0;;43,0;;2,0;12,0;;;2,0;;;4,0;;;;;4,0;;6,0;5,0;;1,0;1,0;;8,0;;6,0;10,0;;69,0;8,0;;;6,0;;;1,0;;;5,0;;;;2,0;18,0;5,0;;;;;;;;86,0;;6,0;1,0;;2,0;;7,0;3,0;;;;;;;1,0;11,0;;2,0;;;;;3,0;;3,0;14,0;;;2,0;4,0;;9,0;;29,0;;25,0;12,0;;;;;;;;;3,0;;19,0;;;;3,0;1,0;13,0;;;;;;;8,0;21,0;;;1,0;9,0;;;1,0;;;3,0;;1,0;;;;;;;;13,0;;9,0;;;;;;;;;;;;;;;;;;;;;;;;;1,0;;11,0;;;;;;;;;;1,0;;;18,0;;;;;;;;;;;;;;;;14,0;1,0;;;;;;5,0;;;;;5,0;;;;;;;;;;12,0;;;;;;2,0;2,0;;;;1,0;;;;;;;;5,0;;;;;;;;3,0;;;;;;;3,0;;;;;;;;1,0;;;;4,0;;;;;;;;;1,0;;;;;;;;;;;;;;;;;;;;;;;;;;;;;;;;;;;;;;;1,0;10,0;;;;;;;;;;;;;1,0;;;;;;;;;;;;;;;;;;1,0;;;;;;11,0;;;;;;;6,0;;;;;;;12,0;;;;;;5,0;3,0;8,0;;;;;5,0;2,0;3,0;;;25,0;;;6,0;;1,0;;1,0;15,0;;;3,0;;22,0;1,0;;;;3,0;2,0;;;;;;;;;;;;;3,0;;;3,0;;3,0;;;;;5,0;;;;2,0;1,0;;;;1,0;23,0;;;2,0;;;;;;;;;;;;;;;14,0;;;;;;;;;;;26,0;;;;;;2,0;1,0;;;;;;;;5,0;;;;;;;;;;;;;;;;;;;;;;;6,0;;2,0;;;;1,0;;1,0;;;;;;;;;;;;;;;;;;;;;;;;;;;;3,0;;;;;;;;;;;;;;;;;;;;;;;;;;;;;;;;;;;;;;;1,0;;;;;;;;;;;;;;;;3,0;;;;;;;;;;;;;;;;;;;;;;3,0;2,0;;;;;;;1,0;;;;;;;;;7,0;;;;;;;;;;;;;;;3,0;;;;;;;;;;;;;;;;;;;;;;;;;;;;;;;;;;;;;;;;;;;4,0;;;;;;;;;;;;;;;;;;3,0;;;;2,0;;;;;;;;;;;;;;;3,0;;;;;;;;;;;;;;;;;;;;;;;;;;;;;;;;;;;;;;;;;;;;;;;;;;;;;;;;;;8,0;;;;;;;;;;;5,0;;;;;;;;;;;;;;9,0;;;;;;;;;;;;;;;;;;;;2,0;;;;;;;;1,0;;;;;;;;;;16,0;;;;;;;;;;;;;;;1,0;;;;;;;;;;;;;;;;;;;;;;;13,0;;;;;;;;;;;;;;1,0;;;;;;;;;;;;;;;;;;;;3,0;;;;;;;;;;;;;;;4,0;;;;;;;;5,0;;;;;;;;;1,0;;;;;;;;;;;;;;;;;;11,0;;;;;;;;30,0;;;3,0;;;;;;;;;;;
shoot;;;2,0;32,0;2,0;13,0;1,0;22,0;1,0;;;;3,0;60,0;;;12,0;;;1,0;;;;;6,0;;;;4,0;69,0;6,0;6,0;;;;67,0;2,0;;;;5,0;23,0;;5,0;14,0;3,0;;1,0;;;7,0;;;5,0;;;5,0;;;16,0;;;;;233,0;;16,0;1,0;;2,0;1,0;27,0;2,0;;;;;;;1,0;52,0;;59,0;;10,0;;;10,0;;;26,0;;;;3,0;;4,0;9,0;7,0;5,0;31,0;2,0;;6,0;19,0;2,0;;3,0;;;1,0;;19,0;;;;1,0;;;13,0;;;9,0;1,0;;1,0;21,0;;3,0;;17,0;;;50,0;;;;;5,0;;;;;;4,0;3,0;8,0;2,0;2,0;2,0;;;14,0;1,0;;;;;;;;5,0;;;;;;;;;;;2,0;39,0;;2,0;;1,0;1,0;;;;;7,0;;;;;7,0;4,0;;1,0;;;;1,0;;1,0;;;;;4,0;;;4,0;;;;10,0;3,0;5,0;;;;;6,0;;;;1,0;;1,0;;;;28,0;;1,0;;;;20,0;;2,0;5,0;;;;;;;;;;9,0;1,0;3,0;1,0;;;;;;;;;17,0;;;;;;1,0;;;;;;2,0;;;;2,0;;;2,0;32,0;;1,0;;;10,0;;;;;1,0;;;;9,0;;;;;51,0;;;;;;;;;;;;;12,0;6,0;;;;;;;;5,0;;16,0;15,0;;;1,0;;5,0;;;;;;;;17,0;;5,0;;;;3,0;1,0;;;1,0;;;1,0;;;;;;;;;;;9,0;;;;;;;20,0;;;;2,0;;;3,0;;3,0;1,0;;;1,0;;29,0;;;;1,0;25,0;12,0;;;;;6,0;;8,0;;1,0;;1,0;2,0;;;5,0;;;;;;;;13,0;;18,0;;1,0;33,0;17,0;;;;;;1,0;;;;13,0;1,0;7,0;2,0;;2,0;;35,0;4,0;22,0;1,0;4,0;7,0;3,0;2,0;1,0;12,0;;;;2,0;;;3,0;;;;1,0;;;;;2,0;;;;;;;;;;;;;;;17,0;2,0;;2,0;;;;;;;;4,0;;16,0;23,0;;1,0;;;;;;;;2,0;;;;;;;;;;;;;;;;;;;;;8,0;;;;;;;;;;;;;;;6,0;;;;;;;1,0;;;;9,0;2,0;7,0;;;;5,0;;;;;12,0;6,0;;;;;;14,0;;;;;;;;;;;;;;;;3,0;;;;;;;1,0;;;;;2,0;;;;;;;;;2,0;;;;1,0;3,0;;2,0;;2,0;;;1,0;;7,0;;;1,0;12,0;;;;;1,0;;1,0;;;;;;2,0;;;;1,0;;;;;;;;1,0;;;;6,0;;;;;;;;;1,0;;;;;;;;1,0;;7,0;;;;;;7,0;;;;;;;;29,0;;;;;;;;;;;;2,0;;;;;;6,0;4,0;;;;;3,0;;6,0;;;;;;;;;;;;;;;;;;;;1,0;;;;;5,0;;;;;5,0;;;;;;1,0;1,0;;;;;;;1,0;;;;;;;;;;;;;;;;;;;;;;;;;;;;;;;;;;;;;;2,0;;;;;;;;;;;;;;1,0;;;16,0;;;;;;;;;;;;;;;;;;;;;;;;;;;;;;;;;;75,0;;;;;;;1,0;;;;;;;;;;;;;;;;;;;;;;;1,0;;;;1,0;2,0;3,0;1,0;;;1,0;;;;;;;;2,0;;;;;;;;2,0;;;3,0;;;;;;;7,0;;;;1,0;;;;;;;;;;;;;;;;;;;;;;;;;;;;;;;;;;;2,0;;1,0;;;;;;;;;;;8,0;;;;;;;;;;;;;;;;;;;;;;;;;;;;;;;;;;;1,0;;;;;;;;;
shutter;;;4,0;34,0;8,0;103,0;17,0;17,0;;36,0;;6,0;2,0;81,0;;;70,0;12,0;21,0;4,0;;;3,0;1,0;4,0;3,0;1,0;10,0;3,0;1,0;129,0;26,0;6,0;16,0;4,0;18,0;15,0;6,0;3,0;;69,0;163,0;;30,0;88,0;31,0;22,0;73,0;;;;;9,0;5,0;23,0;78,0;4,0;;7,0;24,0;1,0;;3,0;1,0;231,0;4,0;122,0;5,0;3,0;;7,0;184,0;108,0;4,0;;;13,0;3,0;;13,0;131,0;;28,0;1,0;14,0;40,0;2,0;32,0;;3,0;8,0;2,0;25,0;;28,0;;113,0;72,0;31,0;3,0;85,0;17,0;;;5,0;49,0;1,0;13,0;2,0;;;3,0;23,0;1,0;;;5,0;3,0;9,0;155,0;2,0;;98,0;5,0;3,0;19,0;85,0;;;;161,0;;1,0;105,0;5,0;;19,0;1,0;9,0;;;6,0;6,0;;53,0;16,0;21,0;18,0;3,0;17,0;13,0;18,0;17,0;;3,0;17,0;;13,0;;;12,0;25,0;;;;;54,0;19,0;2,0;47,0;1,0;1,0;2,0;63,0;;13,0;1,0;3,0;6,0;;;6,0;5,0;14,0;;3,0;7,0;6,0;51,0;28,0;;;;;;2,0;75,0;4,0;;;;9,0;5,0;;23,0;6,0;28,0;;4,0;18,0;53,0;19,0;4,0;9,0;;6,0;30,0;8,0;;3,0;10,0;17,0;3,0;6,0;38,0;2,0;62,0;;;12,0;5,0;;2,0;6,0;24,0;;2,0;;;9,0;;1,0;;17,0;;27,0;1,0;6,0;24,0;4,0;1,0;;;25,0;4,0;6,0;52,0;15,0;1,0;;17,0;23,0;50,0;4,0;;;;13,0;;36,0;;;31,0;2,0;3,0;;2,0;2,0;1,0;29,0;3,0;1,0;13,0;13,0;;;;5,0;8,0;;31,0;3,0;;1,0;;;4,0;7,0;;28,0;;;;;1,0;;;;;58,0;;;2,0;;;2,0;3,0;1,0;9,0;40,0;10,0;17,0;8,0;8,0;;;4,0;1,0;6,0;1,0;1,0;;2,0;2,0;1,0;;9,0;;;;12,0;6,0;2,0;;;8,0;;7,0;;3,0;;;2,0;;13,0;;27,0;;18,0;4,0;;;;;31,0;6,0;1,0;;;3,0;;;;4,0;10,0;4,0;6,0;13,0;;;124,0;;18,0;;4,0;35,0;;17,0;1,0;4,0;;5,0;5,0;12,0;;27,0;1,0;;12,0;;;11,0;6,0;;4,0;60,0;;1,0;8,0;44,0;;19,0;;56,0;110,0;1,0;2,0;;;5,0;;16,0;7,0;26,0;3,0;35,0;;51,0;15,0;;4,0;;17,0;11,0;105,0;;4,0;20,0;42,0;15,0;15,0;3,0;3,0;;;4,0;;2,0;26,0;37,0;;18,0;39,0;2,0;;1,0;;3,0;;1,0;10,0;5,0;4,0;1,0;;;2,0;;;;3,0;;10,0;7,0;2,0;;3,0;2,0;2,0;;28,0;1,0;9,0;19,0;14,0;1,0;39,0;2,0;3,0;;;;3,0;1,0;;;21,0;1,0;;;;;3,0;17,0;;;;1,0;;1,0;2,0;;107,0;;;5,0;;90,0;;;;3,0;;;;;4,0;2,0;3,0;;11,0;58,0;2,0;1,0;4,0;;9,0;;20,0;8,0;;3,0;6,0;201,0;;4,0;;;3,0;6,0;1,0;1,0;3,0;4,0;5,0;12,0;;2,0;;;;20,0;;17,0;1,0;;;2,0;1,0;6,0;;;;;6,0;;4,0;;;;;;;;12,0;1,0;;;;2,0;;;28,0;;;;1,0;4,0;;;;;;2,0;;;;12,0;6,0;7,0;;28,0;;;2,0;;;;;;2,0;10,0;8,0;9,0;;;;2,0;;3,0;2,0;;;;;;;;13,0;11,0;1,0;;;;;;;1,0;;;12,0;;;;2,0;6,0;;1,0;;;;2,0;;;;;3,0;;7,0;;28,0;;1,0;;;;;;5,0;;17,0;;;43,0;;27,0;;;1,0;4,0;;;10,0;17,0;12,0;2,0;6,0;;;9,0;4,0;;;72,0;20,0;2,0;1,0;2,0;3,0;;22,0;;3,0;;;10,0;;2,0;3,0;1,0;;1,0;;;13,0;2,0;19,0;;;;;;;;4,0;;;4,0;;;2,0;;;;;3,0;12,0;1,0;;1,0;16,0;;;1,0;;;;3,0;2,0;;1,0;;;;;;;;;1,0;;8,0;2,0;;;3,0;;2,0;;;;;2,0;7,0;;3,0;;;1,0;1,0;;;2,0;;;;;3,0;;14,0;4,0;;;51,0;9,0;;;;;;;;1,0;;11,0;;;9,0;;;;;;;;;;1,0;2,0;1,0;;14,0;;;;;7,0;4,0;;;2,0;;;;;7,0;6,0;;1,0;;2,0;3,0;6,0;;;;;;4,0;;2,0;5,0;;;;8,0;;;;;1,0;;2,0;1,0;;8,0;;11,0;;;;;;;;;;;;;;2,0;;;;35,0;5,0;;;;;;;8,0;;3,0;;5,0;;;5,0;;;;1,0;;8,0;;;196,0;;6,0;;;;2,0;4,0;6,0;9,0;;;4,0;;1,0;;;1,0;;;;;5,0;;;;;;;;6,0;1,0;;4,0;;;;;;;;2,0;2,0;1,0;;;;3,0;;;;;;1,0;;;;;;;;4,0;;;;2,0;;;;;;;;;;;;;;;
socket;;;1,0;9,0;3,0;15,0;;21,0;;;;1,0;;13,0;;;1,0;;;;1,0;;;1,0;3,0;;;95,0;;;48,0;1,0;;;;1,0;4,0;1,0;;;13,0;21,0;;5,0;7,0;17,0;;19,0;;;;;11,0;2,0;1,0;;5,0;;;;;;;;1,0;;25,0;;;;;26,0;2,0;1,0;;;1,0;;;;14,0;;;;22,0;2,0;;;;;;25,0;4,0;;;;;;28,0;1,0;9,0;;;;;10,0;;;;;;;;;2,0;;;3,0;;2,0;;;;;;;29,0;;26,0;;;;;12,0;;;1,0;;;;;2,0;;;1,0;2,0;3,0;10,0;;27,0;;2,0;14,0;6,0;;;;;;;2,0;12,0;;;;;17,0;2,0;;;;;2,0;3,0;;;;;2,0;;;;2,0;2,0;;;3,0;2,0;;4,0;;;;2,0;2,0;5,0;5,0;;;26,0;;;;3,0;;;5,0;;24,0;70,0;;;;;;6,0;;6,0;;;;;;;8,0;4,0;75,0;1,0;1,0;;;;;;;;;;2,0;;;2,0;3,0;4,0;2,0;;;2,0;31,0;2,0;;;;22,0;;2,0;1,0;44,0;2,0;;1,0;;2,0;3,0;2,0;;;;;;;2,0;;10,0;16,0;;;4,0;;1,0;23,0;;35,0;13,0;;;;3,0;9,0;;;1,0;;;;;2,0;;;16,0;;;5,0;;;6,0;;;;7,0;;4,0;5,0;;;2,0;4,0;1,0;4,0;2,0;3,0;1,0;;;;;;;8,0;;11,0;;;;;;;;;1,0;6,0;9,0;1,0;8,0;;17,0;12,0;;20,0;12,0;;4,0;;;;;;31,0;3,0;4,0;;;;1,0;;2,0;;;;;5,0;1,0;2,0;3,0;;;;;;;;;;;;;;;;;;;;;;;;;;;;1,0;;;;;;;2,0;2,0;;;;;;1,0;;;;;;;;;;22,0;;;;;;;1,0;;;;;1,0;;;;2,0;;2,0;;;;;;;;;;5,0;65,0;;;;;;;1,0;;;;;;;;;;;;5,0;5,0;7,0;;2,0;4,0;;;;;;;;;1,0;;;;;;;;;;1,0;;;;;;;;1,0;;;;;1,0;;;1,0;;1,0;;2,0;;;12,0;23,0;1,0;;;;;1,0;;;;;;;;2,0;6,0;;;15,0;;;;22,0;;;;;;;;1,0;;;;;;;;;4,0;;;2,0;1,0;;;;;;;;;;;3,0;;;;;;;;2,0;;;;;;;;;;;;;;;;;;;;3,0;;;;;;;;;;;;;;;;;;;;;;;;;;;;;9,0;;;;;;;;;;3,0;;;11,0;;;;;;;;;;2,0;;;;;;;;2,0;;;;;;;;;;;;;;;;;2,0;2,0;;;;;;;5,0;;;3,0;;;;5,0;;;;2,0;;;;2,0;;;1,0;;;;;;;;;;;4,0;;;;;1,0;;;;;;;;3,0;;;;4,0;;;9,0;;;;;;21,0;;;1,0;;;;;;;3,0;;;;;;;;;;;;;;;;5,0;;;;;;;;;;;;;;;;;;;;;;;;;;;;;;;;;;;1,0;;;;;;;;;;;;;;;;;;;;;;;;;;;;;;;;;;;;;;;;;;;;;;;;;;;;;;;;;;;;;;;;;;;;;;;;;;;;;;;;;;;;;;;;;;;;;;2,0;;;;;;;;;;;;;;;4,0;;;;;;;;;;;;;;;;;;;;;;;;;;;;;;;;;;;;;;;;;2,0;;;;;;12,0;;;;;;;;;;;;;;;;;;;;;;;;;;;;;;;;;;;;;;;
spatial;;;3,0;7,0;;14,0;32,0;7,0;;;;;;59,0;1,0;1,0;28,0;7,0;18,0;32,0;;;17,0;;2,0;;43,0;8,0;11,0;2,0;52,0;10,0;;9,0;;106,0;29,0;5,0;28,0;;140,0;18,0;;7,0;12,0;;10,0;12,0;;2,0;8,0;;2,0;2,0;17,0;22,0;6,0;2,0;116,0;8,0;1,0;;6,0;2,0;257,0;4,0;27,0;5,0;3,0;;1,0;45,0;187,0;;;;;12,0;1,0;5,0;102,0;2,0;6,0;15,0;12,0;;;59,0;4,0;2,0;6,0;;4,0;;;;49,0;47,0;47,0;37,0;68,0;26,0;1,0;5,0;11,0;40,0;;3,0;9,0;;1,0;38,0;19,0;5,0;;5,0;168,0;33,0;23,0;47,0;18,0;;9,0;2,0;39,0;6,0;51,0;;2,0;;18,0;;;16,0;8,0;;27,0;8,0;2,0;;;8,0;1,0;;2,0;19,0;13,0;15,0;12,0;1,0;1,0;8,0;1,0;;1,0;;;;;;;1,0;6,0;7,0;;3,0;5,0;3,0;1,0;18,0;5,0;;8,0;87,0;;7,0;;22,0;1,0;;1,0;;;3,0;;;29,0;;16,0;1,0;1,0;10,0;;;;;2,0;6,0;;;;;;;35,0;1,0;;;8,0;1,0;8,0;19,0;4,0;;;;1,0;3,0;;3,0;326,0;15,0;;;4,0;;9,0;;;11,0;;;14,0;8,0;2,0;;55,0;3,0;;6,0;;;;;;42,0;2,0;3,0;6,0;;;;28,0;19,0;2,0;;2,0;16,0;;;1,0;;;43,0;1,0;;;7,0;;3,0;1,0;;;2,0;;;1,0;13,0;;46,0;;;17,0;12,0;4,0;;;;1,0;;3,0;5,0;;;12,0;1,0;37,0;;;;;;;4,0;;;;5,0;;4,0;;1,0;1,0;;3,0;;2,0;;;;;58,0;3,0;3,0;;;;;;;;;;;1,0;;;;;;;16,0;3,0;;;;6,0;7,0;;;;;9,0;;11,0;;2,0;;23,0;;;;;;;;7,0;4,0;;3,0;;;45,0;23,0;15,0;1,0;3,0;;11,0;3,0;7,0;185,0;;;6,0;23,0;5,0;2,0;2,0;3,0;5,0;1,0;;2,0;;12,0;;9,0;1,0;13,0;4,0;1,0;;;;104,0;3,0;1,0;3,0;3,0;;1,0;3,0;;3,0;21,0;;5,0;;;1,0;2,0;;;1,0;10,0;;61,0;2,0;;5,0;;;2,0;2,0;;3,0;1,0;;;;;12,0;2,0;3,0;2,0;3,0;;5,0;4,0;7,0;;1,0;1,0;;;1,0;45,0;;;13,0;1,0;;;;5,0;3,0;;;8,0;3,0;;4,0;2,0;;;;;1,0;3,0;;3,0;;7,0;2,0;4,0;15,0;;;1,0;2,0;2,0;12,0;21,0;;7,0;1,0;;;;27,0;27,0;;;1,0;2,0;6,0;;;;2,0;2,0;;;;;;3,0;;;;;;;6,0;;;;;;;2,0;;3,0;;;8,0;;8,0;4,0;;;6,0;;;;;;1,0;;;;2,0;6,0;;3,0;3,0;1,0;;2,0;;;;;2,0;1,0;7,0;;;;;;;;4,0;3,0;;10,0;;;;;;;;2,0;;;5,0;;;;;11,0;;;;;2,0;;;1,0;2,0;26,0;;;;;;;;;8,0;;;;;;;;;;6,0;4,0;;2,0;1,0;1,0;;;;;;5,0;;;;;;2,0;5,0;;;;;3,0;3,0;;;;;;;;146,0;;;;8,0;1,0;;;;;;;;;;;11,0;;;;;1,0;3,0;2,0;35,0;;;;;;;5,0;4,0;;;;;;;1,0;5,0;;;6,0;;;;;;;;;;;;15,0;;9,0;;4,0;;123,0;;;;;;;;;;3,0;;;;;;;;37,0;53,0;;;;1,0;;;;;;;;;;2,0;;;;;;;;;;;5,0;;;;;;;;;;;;;9,0;;;;;;;;;;;1,0;;7,0;;;1,0;;;;10,0;;;;;;;;;;;;;;;;32,0;;;;1,0;;;;4,0;;;;;;;7,0;;;;1,0;5,0;;;;2,0;;;;;;;;;;;;;;3,0;;1,0;;10,0;1,0;3,0;1,0;4,0;;12,0;;;;;11,0;;;;29,0;;;1,0;;1,0;3,0;;4,0;;4,0;1,0;;4,0;1,0;;;;;;;;;;;;;1,0;;;;;;;;;;;2,0;;;;16,0;;;;;;;;;1,0;;;;;;;;;1,0;3,0;3,0;4,0;;9,0;;;;10,0;;;;;;;;;;;;;;;;1,0;;;;;;;;5,0;1,0;;6,0;;;;;;;;;1,0;1,0;;;2,0;;;2,0;;;2,0;;;1,0;2,0;11,0;;;5,0;;2,0;;;4,0;;;;;;
spectrum;;;1,0;;;2,0;27,0;7,0;;;;19,0;;12,0;7,0;;14,0;;8,0;12,0;;;12,0;;;;;4,0;4,0;;17,0;2,0;;;;12,0;5,0;;1,0;;16,0;5,0;;13,0;6,0;3,0;;3,0;;;;;;;;1,0;;;16,0;2,0;;6,0;2,0;;68,0;;8,0;;;;2,0;10,0;97,0;;;;;1,0;;;19,0;;6,0;;9,0;;;27,0;2,0;;1,0;;16,0;;;;9,0;;3,0;8,0;7,0;;;;;3,0;;;4,0;;1,0;12,0;1,0;;;;;;10,0;29,0;;;25,0;;2,0;1,0;17,0;;;;2,0;;;;;;2,0;;;;;;;;;2,0;3,0;8,0;2,0;;;1,0;3,0;;;;;;;;;;;2,0;;;;;;1,0;;;;;;;8,0;8,0;;;4,0;;;;;;23,0;;;1,0;;;;;;;3,0;4,0;;;;1,0;;;4,0;3,0;;;;;;;;;;;2,0;;;2,0;1,0;;;;;;37,0;;;;;6,0;7,0;4,0;;;6,0;;;2,0;;;;;;2,0;;;3,0;;;;1,0;;;;;;;1,0;;4,0;;1,0;;;;12,0;;;;;;1,0;;;3,0;1,0;;;;;1,0;;;;;;;;;2,0;;;;;1,0;;;;;;;;;;;;;6,0;;;1,0;;;;2,0;;;;;4,0;2,0;1,0;;;;;;;;;;;2,0;;;;;;;;;;;;3,0;;;;;;;;8,0;;;;;6,0;;;;;;;3,0;;;;;;1,0;3,0;;;;;;;3,0;;;;;12,0;;7,0;;3,0;;;;;;2,0;;;;;;;1,0;;;1,0;;;1,0;1,0;;;2,0;3,0;1,0;;;;;;;;;;;6,0;1,0;3,0;;;5,0;;;;;;3,0;;;;7,0;;;;;2,0;;;;;;;;;;;;;;;7,0;;1,0;;;;;;;;;;1,0;;;;;;2,0;;;;;1,0;1,0;;1,0;;;;;;;;;;1,0;;;;;;;;;;2,0;;;;;;;;1,0;;;;;;;;;1,0;;;;;;2,0;;;;;;;;;;6,0;;;;;;;;;;;;;;;;;;;;;;;;2,0;1,0;;2,0;;;;;;;;;;;1,0;;;;;;;;;;;;1,0;;;;;;;;1,0;1,0;;;;;14,0;;;;2,0;;3,0;;;;;;;3,0;;;;;;3,0;1,0;;;;;;;;;;;;;;;;;;;;;;;;;;;;;;;;;;;;;;;;;6,0;;;;;;12,0;;;;;;3,0;;;;;;;;;;;;;;;;;;;;;;;;2,0;2,0;;;1,0;;;;;;;;2,0;;;1,0;;;;;;;;1,0;;;;;;3,0;4,0;;;;;;;;2,0;;1,0;;;;;;;76,0;;;;;;;;;;2,0;;;;;;;;;;;;;7,0;;;;;;;;;;;;;;2,0;;;3,0;;;;;;;;;;;;;1,0;;;;;8,0;;;;;;6,0;;;;;;;;;;3,0;;;;;;;;;;;1,0;;;;;;;;;;;;;;;;1,0;;;;;;;;;;;;;3,0;;;;;;;;;;;;;;;;;;;;;;;;;;;;;;;;;;;;;;;;1,0;;;;;;3,0;;1,0;;;;;;;;;;;;;;;;;;;3,0;;;;;;;;;;;;;2,0;;;;;;;;;;;;;;;;;;2,0;;;2,0;2,0;;;;;;;;;2,0;1,0;;;;;;;;;;;;;;;;;;;;;;;;;;
speed;;;2,0;62,0;24,0;37,0;3,0;1,0;;1,0;1,0;;;152,0;;3,0;33,0;;5,0;4,0;;2,0;2,0;4,0;38,0;3,0;1,0;6,0;11,0;10,0;70,0;23,0;15,0;9,0;;103,0;28,0;2,0;3,0;;195,0;100,0;;8,0;50,0;2,0;;2,0;4,0;3,0;63,0;;1,0;;25,0;3,0;3,0;;;18,0;;;9,0;;116,0;;52,0;45,0;;1,0;9,0;83,0;19,0;3,0;10,0;;;5,0;;12,0;154,0;;27,0;4,0;21,0;9,0;;15,0;;5,0;13,0;;3,0;3,0;4,0;;12,0;3,0;19,0;20,0;96,0;76,0;;5,0;26,0;26,0;2,0;;2,0;;12,0;19,0;2,0;1,0;;2,0;13,0;2,0;18,0;22,0;6,0;;54,0;11,0;;2,0;170,0;;;;78,0;;;62,0;2,0;;30,0;;97,0;;;4,0;1,0;;31,0;7,0;24,0;2,0;16,0;2,0;;;25,0;1,0;;3,0;;;;;;9,0;;3,0;;2,0;3,0;1,0;32,0;5,0;9,0;;3,0;122,0;123,0;8,0;;;5,0;2,0;;;;;;;5,0;4,0;15,0;4,0;;;;;;1,0;;;;;;;37,0;3,0;42,0;7,0;24,0;;1,0;4,0;38,0;200,0;21,0;;;;14,0;;1,0;6,0;14,0;2,0;;2,0;;;15,0;;1,0;6,0;;8,0;26,0;2,0;1,0;9,0;3,0;5,0;;26,0;;;9,0;;;30,0;;3,0;4,0;;;;;4,0;;;4,0;4,0;;;9,0;9,0;;275,0;;1,0;3,0;;2,0;;;24,0;1,0;2,0;;;5,0;24,0;;1,0;;2,0;;8,0;;;;9,0;8,0;;;;;;1,0;;63,0;11,0;;;;;;5,0;;;;38,0;;13,0;;;2,0;;;;3,0;;4,0;5,0;21,0;71,0;;2,0;;;;;11,0;;;;;;12,0;;;;;;31,0;118,0;18,0;1,0;;2,0;12,0;1,0;;;;;;;64,0;;16,0;2,0;55,0;;;18,0;2,0;;;19,0;6,0;26,0;3,0;9,0;;2,0;51,0;29,0;50,0;30,0;;61,0;35,0;3,0;179,0;28,0;;;15,0;39,0;12,0;23,0;3,0;5,0;19,0;10,0;1,0;47,0;6,0;18,0;;27,0;25,0;2,0;1,0;10,0;6,0;14,0;19,0;12,0;1,0;5,0;38,0;49,0;;201,0;;8,0;27,0;10,0;2,0;3,0;;5,0;2,0;21,0;6,0;6,0;;36,0;2,0;7,0;;1,0;;1,0;90,0;1,0;;17,0;11,0;28,0;7,0;;1,0;;79,0;21,0;15,0;6,0;7,0;96,0;28,0;28,0;5,0;2,0;3,0;6,0;29,0;;2,0;8,0;;3,0;10,0;4,0;;1,0;;27,0;51,0;;;1,0;7,0;34,0;13,0;4,0;;;;;9,0;22,0;1,0;2,0;;12,0;1,0;;101,0;5,0;1,0;10,0;;;4,0;4,0;2,0;;2,0;;;1,0;;3,0;;;11,0;6,0;7,0;1,0;;;2,0;7,0;4,0;1,0;;4,0;4,0;8,0;;;;1,0;;;;2,0;;;5,0;;10,0;2,0;;;32,0;10,0;8,0;2,0;10,0;16,0;;17,0;;4,0;;20,0;3,0;;;;;;5,0;;1,0;4,0;;;;1,0;1,0;3,0;2,0;;4,0;;13,0;2,0;5,0;6,0;;;;;;;;;;;2,0;;;1,0;3,0;;;;4,0;;;19,0;5,0;;1,0;;1,0;;1,0;;4,0;;;19,0;5,0;3,0;;2,0;;;;3,0;;2,0;;;2,0;;2,0;;1,0;;;2,0;;;;;;;5,0;2,0;;4,0;;;9,0;;;;;3,0;1,0;2,0;;1,0;2,0;;2,0;2,0;;2,0;2,0;2,0;15,0;2,0;;;;6,0;;3,0;2,0;;105,0;;;;;;6,0;;1,0;;;;6,0;6,0;113,0;;4,0;;;22,0;;;1,0;;7,0;;2,0;2,0;1,0;2,0;;;3,0;;;;;3,0;2,0;45,0;48,0;;;;;2,0;5,0;;;;1,0;;;1,0;10,0;48,0;1,0;;;;7,0;;;;;24,0;;;;1,0;19,0;;;;4,0;;1,0;2,0;;;;;;;;;;;;1,0;;;;12,0;;;;;;;;;;;;3,0;93,0;;2,0;;;40,0;;;;;;;;10,0;;10,0;1,0;2,0;;;;;9,0;2,0;2,0;;2,0;;2,0;;2,0;;;61,0;;;;;3,0;1,0;;;;;;3,0;;10,0;12,0;;;2,0;6,0;;;;;3,0;4,0;;;;10,0;;;10,0;;18,0;;;;;9,0;;;22,0;;1,0;;10,0;4,0;4,0;14,0;2,0;10,0;4,0;1,0;;1,0;;;1,0;;;;;;21,0;;;;9,0;2,0;7,0;3,0;;;6,0;;;36,0;1,0;1,0;2,0;;1,0;;;1,0;2,0;;1,0;1,0;;12,0;1,0;;;;2,0;;;;1,0;;;;2,0;1,0;;;;;;;2,0;;;20,0;;35,0;10,0;;;;11,0;14,0;;;1,0;;;;;;;;;;;4,0;;;;;;;;;;;;;;;;;;;;;;;;;;;;;;4,0;;;;;;;;;;;;;2,0;;;;;;;;;1,0;;;;;;;
spot;;;1,0;;;4,0;13,0;2,0;;1,0;;;;19,0;;;13,0;;;;;;2,0;2,0;3,0;;;;;;3,0;2,0;1,0;;;5,0;6,0;2,0;2,0;;53,0;3,0;4,0;;9,0;;;5,0;;;;1,0;2,0;;5,0;16,0;6,0;;;22,0;;1,0;5,0;;37,0;;24,0;1,0;;;;2,0;254,0;;;;;3,0;;2,0;20,0;;;;;;4,0;5,0;;1,0;;;;1,0;51,0;;32,0;1,0;16,0;14,0;6,0;3,0;;5,0;2,0;8,0;;1,0;;;;1,0;15,0;;;;;7,0;4,0;18,0;39,0;;;19,0;;;9,0;;;;3,0;;;12,0;;;10,0;;;;;3,0;;;;;4,0;;7,0;;;;2,0;;;;;;;;;;;;5,0;3,0;;1,0;;10,0;;;1,0;;;;;;;;;;;1,0;;;1,0;;;;;;;;;;;1,0;;;;;;;4,0;1,0;;;2,0;2,0;7,0;;6,0;1,0;;;58,0;;;;11,0;;3,0;;;;1,0;;;2,0;;;1,0;;2,0;;2,0;;;;;;;;;8,0;;2,0;;;;;;;;;;27,0;5,0;;;;;12,0;1,0;;;;3,0;;;;;;;;2,0;12,0;;2,0;;;5,0;;;;;;;;;;;;;;45,0;7,0;;;;;;;;;;;;6,0;;;;;;;4,0;;4,0;2,0;1,0;26,0;;1,0;;;;;;;;;;;;;;;;;;;;;;;;6,0;;;;;;;6,0;;1,0;;4,0;;;;;;;;2,0;;;2,0;;;;;;2,0;;;;;8,0;2,0;;;;19,0;2,0;;;;9,0;;;3,0;;2,0;;2,0;;;;;;;;2,0;1,0;10,0;;1,0;;1,0;6,0;;;;;;;;;;;;;7,0;4,0;2,0;;;;;;;1,0;;1,0;3,0;;;2,0;8,0;1,0;;;1,0;;;9,0;;;;2,0;;;;2,0;;;;;;;4,0;;;;;;;;;1,0;;;;5,0;;;;;;;;2,0;;5,0;;;;;;;21,0;1,0;;;;;;;;;;;;;;;;;2,0;;;;;1,0;;;;;;;1,0;;;;;;;;;;2,0;;1,0;2,0;;;;;;1,0;1,0;;;;;;;;;;2,0;4,0;;;;2,0;;;;;;;;;;;;;;;;;;;;;;;3,0;19,0;;;;;;;;;;;;;;;;3,0;;;;;;;;;;;;;3,0;;;;;;1,0;;;;;8,0;3,0;;3,0;;;;;;;;;;;;;2,0;;;;;;1,0;1,0;;;;;;1,0;;;5,0;;;;6,0;;;;;;;;;;;;14,0;;;;;;;;3,0;;;;;4,0;;2,0;;;;;;;;1,0;;;;;;;2,0;;;;;;;;;;;;;;;10,0;;13,0;;;;;;;;;;;2,0;1,0;;;1,0;4,0;;;;;;;;;;;4,0;;;;;;;;;;;3,0;;;;;;;;;;;1,0;;;;1,0;;2,0;;1,0;;;;;;;;1,0;;11,0;;;1,0;;;;;;;;;;;;;;;;;;;;;2,0;;;2,0;;;;;;;;;;;;;;;;;;;;;;;;;;;;;;;4,0;;;;;;;;;;;;3,0;;;;;;;2,0;;;;;;;2,0;;;;;11,0;;;;;;;;;;;;;;;;;;;;;;;;;;8,0;;;;;;;;;;2,0;;;;;;;;;;;;;;;;;;;;;;;;;;;;;;;;;;;;1,0;;1,0;;;;;;;1,0;;;;;;;;;;;;;;2,0;;;;;;1,0;3,0;;2,0;;;;;;1,0;;;;;;;;;;;;;;;;
stabilization;;;2,0;13,0;2,0;9,0;;16,0;;;;;2,0;28,0;;;19,0;;;;;;;;;13,0;4,0;6,0;;5,0;58,0;28,0;2,0;3,0;;5,0;;1,0;;;30,0;27,0;;9,0;2,0;18,0;;7,0;;;;;;;;;3,0;;1,0;2,0;;;;;388,0;;29,0;1,0;;4,0;5,0;45,0;;;;3,0;;9,0;5,0;;51,0;;3,0;1,0;60,0;9,0;;214,0;;;4,0;;;;;;;1,0;37,0;25,0;17,0;1,0;;19,0;3,0;8,0;;;;;;;2,0;;;;;3,0;;27,0;4,0;;12,0;;;;184,0;;;;6,0;;;46,0;;;4,0;;3,0;;;1,0;;;3,0;8,0;3,0;2,0;3,0;1,0;;;;5,0;3,0;;;;;;1,0;3,0;;;;;4,0;;;3,0;;;;36,0;;;1,0;;15,0;;;;;11,0;;1,0;6,0;2,0;23,0;;;1,0;;;;;18,0;;;2,0;;1,0;;;9,0;;36,0;;;48,0;14,0;28,0;;;;2,0;;4,0;;5,0;;;;;10,0;;22,0;1,0;1,0;;;;3,0;;;;;;;;;;2,0;;;1,0;3,0;;12,0;1,0;;;;10,0;2,0;;26,0;1,0;;;;5,0;;1,0;;;;;;4,0;;5,0;53,0;1,0;;;5,0;25,0;;5,0;;28,0;35,0;2,0;;;56,0;;9,0;;75,0;;;;;;;;;3,0;2,0;;7,0;;17,0;;;;;2,0;;;2,0;;2,0;;1,0;;;28,0;4,0;2,0;6,0;1,0;;;;;3,0;3,0;;;;;6,0;;2,0;;;;1,0;2,0;7,0;;1,0;1,0;;2,0;;2,0;28,0;;;1,0;;2,0;1,0;1,0;81,0;1,0;;;2,0;;;18,0;;;;15,0;1,0;;;4,0;;1,0;1,0;13,0;1,0;;44,0;;3,0;4,0;;9,0;;;;;;17,0;1,0;4,0;1,0;44,0;;;5,0;;4,0;1,0;;1,0;;1,0;;;26,0;1,0;;9,0;;;10,0;1,0;;1,0;;;;6,0;;;;7,0;2,0;1,0;2,0;16,0;;;;2,0;1,0;14,0;;;1,0;;;1,0;3,0;11,0;;;1,0;;5,0;3,0;;;1,0;3,0;2,0;;;;;1,0;5,0;;;;;;2,0;;2,0;;;4,0;1,0;;;1,0;;;9,0;;21,0;;;1,0;;2,0;31,0;;5,0;;;;;;;;;;;;3,0;1,0;;;2,0;;;;;;;;;;1,0;;;;;;2,0;1,0;;2,0;;;1,0;;;;;;;2,0;;;;;1,0;;;;;4,0;;1,0;;;;;;;;;;;;1,0;;;;;;;21,0;;2,0;1,0;;1,0;;1,0;;;6,0;;;;;;2,0;;;;1,0;;;;;;;;;;;;4,0;;2,0;;;;;;;;;;;;;;;;3,0;;;;;;;;;;;;;;;;16,0;;;;2,0;;;;9,0;;;;;2,0;;;;;;;;;;;;;;;;2,0;;;;13,0;;;;;;;;;1,0;;1,0;;;;3,0;;;;;;1,0;2,0;;;;;;;;;;;;;;;;;;1,0;12,0;;;;;;;;;;;;;3,0;;;;;2,0;;;4,0;;;;;;;;2,0;5,0;;;;4,0;2,0;;;;;4,0;;;;2,0;;;;;;;;;1,0;1,0;;;3,0;;;;;;;;;;;;;;;;;;;;;;;;;;;;;;;;;;;;;;;;;;;3,0;;;;;;;;;;;;;5,0;;;;;;;;;;;;1,0;;;2,0;;;;;1,0;;;;;;;;;;;;;;;;;7,0;;;;;;;;;;;;;;;;;;;;;;;;;;;;;;;;2,0;;2,0;;;;;;;;7,0;;;;;;;;;1,0;;;;;;;;;;;2,0;;;;;;;;;;;;;;;;;;;9,0;;;;;4,0;;;;;;;;4,0;;;2,0;;;;;;;;;;;;;;;;1,0;;;;;;;;;;;;;;;;;;;;;;;;;;;;;;;;
stack;;;2,0;2,0;1,0;15,0;223,0;10,0;;;;2,0;25,0;17,0;;;32,0;;4,0;;10,0;;18,0;;;;;2,0;2,0;;24,0;3,0;6,0;;;8,0;37,0;;;13,0;9,0;34,0;;3,0;;11,0;;38,0;;;;;14,0;;4,0;71,0;82,0;;4,0;9,0;3,0;;1,0;;80,0;6,0;104,0;;1,0;;4,0;537,0;27,0;1,0;;;14,0;1,0;;3,0;35,0;14,0;2,0;;41,0;;;33,0;6,0;3,0;;2,0;3,0;;;;166,0;78,0;169,0;3,0;8,0;3,0;1,0;3,0;3,0;7,0;;;;;;2,0;8,0;;;1,0;;;10,0;93,0;;;4,0;2,0;8,0;;11,0;;;4,0;5,0;;;3,0;;;6,0;;1,0;1,0;;17,0;;;101,0;2,0;11,0;12,0;2,0;6,0;;5,0;30,0;1,0;1,0;;;;;;14,0;17,0;;;8,0;;10,0;5,0;;;9,0;;10,0;24,0;;;;;2,0;;;;;2,0;;7,0;27,0;2,0;20,0;5,0;;;;2,0;3,0;6,0;19,0;4,0;;;4,0;102,0;;1,0;;1,0;8,0;15,0;;12,0;1,0;;2,0;;;;1,0;4,0;;2,0;5,0;;;8,0;8,0;;16,0;;6,0;;;4,0;;;;;2,0;3,0;;;3,0;;;;;4,0;13,0;4,0;19,0;;1,0;4,0;;13,0;67,0;;6,0;32,0;;;5,0;2,0;;;;;;1,0;;6,0;;4,0;35,0;1,0;1,0;;1,0;;;13,0;;1,0;11,0;1,0;;;6,0;;10,0;;3,0;2,0;;;10,0;;1,0;1,0;;1,0;;;5,0;1,0;;;;;;14,0;;;3,0;;;;11,0;;1,0;1,0;;;;;3,0;;;;;4,0;;;;;;;;;;;;;;;;;;;;4,0;1,0;;;2,0;;;;2,0;2,0;;;;;;;;;;;1,0;;;;6,0;;;;1,0;1,0;;5,0;;;;1,0;9,0;;;;;;;;4,0;;5,0;;;;;;2,0;1,0;1,0;1,0;1,0;;;2,0;;;;;;;;;;;;1,0;;;;;2,0;;3,0;;;4,0;;;;;1,0;;;4,0;;;10,0;;;;5,0;;;4,0;;1,0;3,0;;;;;;2,0;;;3,0;;;2,0;;;;;;;;;;2,0;;4,0;;;1,0;;2,0;;;4,0;1,0;;3,0;;7,0;;;;5,0;2,0;;;;;;;;;;;6,0;7,0;;;;;;;;;;5,0;;1,0;;1,0;4,0;3,0;3,0;;;;;;;;;;;;;;;;;;2,0;;;8,0;;;;;;;;;;;;;;6,0;;;;;2,0;3,0;;;;;;;;;;1,0;29,0;1,0;;;;;;;1,0;;;3,0;1,0;;2,0;6,0;;;;;;;;8,0;;;;2,0;;;;;;1,0;;;;;;;;;;;;24,0;;;;;1,0;;;;;;;;3,0;;6,0;;;;4,0;;;;1,0;;;1,0;;;5,0;2,0;3,0;;;;30,0;2,0;;;1,0;;;;;;;2,0;;;;;;;4,0;;;1,0;;;6,0;;;;;;;;6,0;5,0;;;;;;;1,0;1,0;;;;;;;1,0;3,0;;;;;;;;;2,0;;2,0;;;;;;;;1,0;;;;;;;;;;;;14,0;;;;13,0;;;;;;;8,0;;;;2,0;3,0;;6,0;3,0;;;;4,0;;;;;;;;;6,0;;;;;;4,0;;;;9,0;;;;;;;;15,0;;;;;;;29,0;;;;;1,0;;;;5,0;;5,0;;;;;;;;;;;;;;23,0;;;;;28,0;;;8,0;;;;;;;;;;;;;;;2,0;;;;;;;1,0;;2,0;;;;;;;;15,0;8,0;;;;;;;;;;;;;;;;2,0;;;;;;;;;;;;;;;;6,0;;;;1,0;;;;;;;1,0;;;;;;14,0;8,0;;;;;;;;;;;;;;;;;;;;;;;;;;;;2,0;;27,0;;;;;;2,0;;;;;;;;;;3,0;;;;;;;;1,0;;;;;;;;;;;;;;;;;;;;;;;;4,0;;;4,0;;;3,0;;;;;;;;
steer;;;2,0;7,0;7,0;14,0;4,0;9,0;;;;;;33,0;;;4,0;;;;;;;;1,0;;;2,0;;;42,0;5,0;5,0;5,0;;33,0;;12,0;;;9,0;20,0;;;7,0;4,0;;4,0;;;3,0;;2,0;;6,0;;1,0;;;12,0;;;;;13,0;;36,0;;;;;7,0;30,0;;;;;14,0;;3,0;22,0;2,0;70,0;;20,0;2,0;;7,0;4,0;2,0;;4,0;;;;;;1,0;30,0;23,0;43,0;3,0;;;2,0;4,0;;;;;;;;1,0;4,0;;;2,0;1,0;11,0;;;19,0;;;2,0;87,0;;;;6,0;;;44,0;;;8,0;;;;;;2,0;;;;1,0;1,0;11,0;19,0;;;;;2,0;;;;;;;9,0;;;;;2,0;;;;;;5,0;68,0;;;1,0;;;;;7,0;;;;;;3,0;8,0;4,0;;1,0;;6,0;;;1,0;;;;;;;;12,0;3,0;82,0;;6,0;3,0;4,0;46,0;3,0;;;2,0;1,0;1,0;;;1,0;;;;;;1,0;;1,0;2,0;;;;;1,0;;;;;;;1,0;10,0;7,0;;5,0;;;;4,0;1,0;;1,0;;;;7,0;1,0;;;;1,0;;134,0;;;;;;;;;2,0;;;;8,0;216,0;5,0;;;;49,0;;;;;;1,0;;;;;;;;;2,0;1,0;4,0;;;;;6,0;1,0;37,0;1,0;5,0;;;;;;;;7,0;4,0;;11,0;7,0;6,0;1,0;;;;;;1,0;;;;;;1,0;;1,0;;;;5,0;10,0;46,0;;1,0;;;2,0;;9,0;4,0;;;;5,0;3,0;15,0;9,0;;;;2,0;;3,0;;;;;;;;13,0;3,0;6,0;17,0;;;2,0;;;63,0;18,0;;;2,0;7,0;;2,0;2,0;2,0;;;;;1,0;;;;3,0;6,0;2,0;5,0;;;1,0;1,0;;3,0;;7,0;3,0;3,0;;6,0;4,0;2,0;;4,0;;;;1,0;;;;28,0;2,0;3,0;;2,0;1,0;;4,0;;17,0;;;;1,0;;;;1,0;7,0;;;;6,0;;3,0;;;;1,0;;;;;;2,0;;;;;;;;;;;2,0;3,0;;;;17,0;3,0;2,0;;;1,0;2,0;;;;;7,0;;;;;;;;2,0;;;;;14,0;;;;;;3,0;;;;;;1,0;1,0;;;9,0;;;;;;;;2,0;;;;;;;2,0;1,0;;;;;8,0;;;;;3,0;;2,0;4,0;;;;;;;;;;;1,0;;1,0;;;;;;;;;;;;4,0;;1,0;;;2,0;;;;;;;;72,0;;;;8,0;;;;;;;;;;9,0;;;;;;;;;;2,0;;;;4,0;;;;;;;;;;;;;;;;;;;;;;;1,0;;;5,0;;;;;;;2,0;;;;;;;;;;;;;;;;;;;;;;;;;;;10,0;;;;;;;3,0;11,0;;;;;53,0;;2,0;;;;;;;;;;;;;;;;1,0;;21,0;2,0;;1,0;;;;;1,0;;;;8,0;;1,0;;3,0;;;;;2,0;;;;2,0;;;;;9,0;13,0;2,0;;1,0;21,0;;;;4,0;;;5,0;;;;;;;;;;;;;;;;;;2,0;;;;;;1,0;4,0;;;1,0;;;;;;;;;;;;;;;;;;;;;;;;;;;;;;;;;;;;;;;;;;;;;;;;;;;12,0;;;;;;1,0;;;;;;;;;;;;4,0;;;1,0;;;;;;;;;;4,0;;;;;;;;;;;;;;;;6,0;;;;;4,0;;;;105,0;;;;;;;;;6,0;;;;;;;;;5,0;;;;;;;;;;;;;3,0;;;;1,0;;;;;;;;;;3,0;;;;1,0;;;7,0;;;;;;;4,0;;;;19,0;;;;;;;;;1,0;;;;;;2,0;;;;;;;;;;;;2,0;;;;;;;;;;;;;;;;;;;;;3,0;;;;;;;;
stereoscopic;;;2,0;9,0;;34,0;5,0;2,0;;;;;;37,0;;;160,0;;13,0;;;;89,0;;4,0;;;5,0;4,0;20,0;22,0;2,0;2,0;19,0;;41,0;1,0;7,0;30,0;1,0;12,0;95,0;3,0;19,0;53,0;;1,0;1,0;;2,0;;;;;9,0;1,0;22,0;;;25,0;1,0;;2,0;;447,0;;24,0;;;;;42,0;11,0;;4,0;1,0;2,0;1,0;;;66,0;;;1,0;8,0;;;21,0;26,0;3,0;12,0;;1,0;;45,0;;17,0;8,0;52,0;5,0;3,0;9,0;;14,0;18,0;20,0;;3,0;;4,0;;42,0;2,0;;;4,0;3,0;6,0;47,0;23,0;108,0;;7,0;3,0;;19,0;103,0;;;;24,0;;;33,0;4,0;;80,0;8,0;2,0;;;3,0;;;;3,0;4,0;5,0;6,0;;;1,0;;;;;;;;;;;4,0;2,0;;;3,0;13,0;;;8,0;2,0;2,0;19,0;;4,0;;;3,0;;;;;;;;1,0;;26,0;;;;;;;;2,0;1,0;1,0;;;;;;1,0;;;;2,0;6,0;1,0;1,0;1,0;;;;6,0;5,0;;;8,0;1,0;;;;;8,0;;;2,0;;;7,0;2,0;;1,0;1,0;;;2,0;;;1,0;;;25,0;4,0;2,0;2,0;;;;;2,0;1,0;;;7,0;;;2,0;6,0;;;1,0;;;2,0;;2,0;;;;3,0;;;1,0;5,0;7,0;;;;2,0;2,0;;;;;;;;2,0;;;;2,0;14,0;;;3,0;;;;;;;;2,0;;18,0;;2,0;;;39,0;;1,0;;;1,0;;49,0;2,0;2,0;;1,0;;;;;;;7,0;;30,0;;;;;;;2,0;;;;;;8,0;;;8,0;;;;1,0;;;;150,0;;1,0;;1,0;1,0;;1,0;;;;;;;5,0;3,0;;1,0;1,0;;;;14,0;3,0;;2,0;4,0;13,0;4,0;;;;;;13,0;2,0;;4,0;;13,0;4,0;;;;;;;18,0;;5,0;;4,0;;;;1,0;;2,0;1,0;;;;;;1,0;;;28,0;4,0;1,0;;;9,0;;;;;;;58,0;8,0;;2,0;;1,0;1,0;;2,0;;;;;8,0;;;;;;;42,0;;;1,0;;;7,0;1,0;;;;;;;;1,0;5,0;;;;;;;;;;20,0;3,0;6,0;13,0;;;12,0;;;40,0;39,0;2,0;;1,0;;1,0;3,0;;6,0;;;1,0;;6,0;;;7,0;;;;;;;;2,0;;;;;;;;;;;;;;;;;7,0;;;;1,0;7,0;8,0;;;;;;;;;3,0;;4,0;;10,0;;8,0;1,0;;;;;2,0;1,0;;;;1,0;;;3,0;;;;;;;1,0;1,0;;;;;;;;1,0;;;;6,0;;7,0;;5,0;;;;;4,0;;;;;1,0;;11,0;;;;;;;;;;;4,0;3,0;;;;;;;;;;;1,0;;;;;10,0;;;2,0;;;;;;;;;;;;;;;10,0;;;7,0;;;1,0;;10,0;;2,0;;1,0;;;;;;;3,0;;;;8,0;6,0;;;6,0;;;;;1,0;;1,0;2,0;;;;;;;;1,0;;;3,0;;;;;;;;;;2,0;2,0;;;;;3,0;;10,0;;1,0;;3,0;1,0;;;;;4,0;;;1,0;;;;;;5,0;;;;2,0;;;;;;;;;1,0;;;;;;;3,0;;;;;19,0;;;;;;;;;;;2,0;;2,0;;;;;;;;;;4,0;;;;;2,0;;;;;;;;;4,0;;;;;;;1,0;;;;;4,0;2,0;;13,0;;;;;;;;;1,0;27,0;;;;;;;;;;;9,0;;;;;;;;1,0;;;1,0;;;;;;;;;1,0;;;;3,0;;;3,0;;;1,0;;;;;;;1,0;;;4,0;;14,0;1,0;;2,0;;;;;;1,0;;;;;;;;20,0;;;;;;4,0;6,0;;;;;1,0;;1,0;;;;;;2,0;;1,0;;;;;;;;;;;;;;;;2,0;;;;1,0;;;;;;2,0;;;;;;;;;;;;;4,0;;;;4,0;5,0;;;;;;;;;;;;;;;;;;;;;;;;;8,0;;;;;;2,0;;;;4,0;;;;;;;
stitch;;;2,0;15,0;;8,0;24,0;;;;;;;121,0;;2,0;79,0;;1,0;2,0;;;7,0;;;;;;7,0;;22,0;;1,0;1,0;;52,0;;7,0;30,0;;35,0;6,0;;4,0;11,0;;;1,0;;6,0;5,0;;;2,0;;;23,0;;;82,0;;;1,0;3,0;950,0;1,0;12,0;;1,0;;;14,0;;;;;;;6,0;;118,0;;8,0;;23,0;;;2,0;;2,0;49,0;;;;18,0;;8,0;;104,0;2,0;10,0;;;59,0;25,0;52,0;;2,0;;;;1,0;35,0;1,0;;;;1,0;4,0;10,0;3,0;;10,0;6,0;5,0;27,0;86,0;;;;5,0;1,0;;14,0;;;25,0;;;;;2,0;;;;21,0;;1,0;57,0;;;53,0;;;;;;;;;;;2,0;2,0;;;;;;;1,0;;4,0;;;;;;;;;;;;;;;;75,0;4,0;;;;;;;;;;;;;;;;23,0;1,0;;;;;;;;;;3,0;2,0;;;1,0;1,0;;;;;28,0;;;50,0;;;2,0;;;;;;;;;;;;;128,0;;;;;;;;;;;1,0;2,0;;;;1,0;;7,0;;1,0;;;;;;;1,0;5,0;;;;7,0;;2,0;;;1,0;;;;;;;;;;;;;;1,0;3,0;;;;;;;;;1,0;;;5,0;;;;;;;1,0;;;;1,0;4,0;;39,0;2,0;;;;15,0;;;;;;1,0;1,0;;;;;4,0;;;;;;6,0;11,0;;;;;10,0;;;;;;67,0;;;;;1,0;;;;;;;;;10,0;;1,0;;1,0;;4,0;;1,0;;;1,0;;8,0;15,0;;25,0;;2,0;6,0;;1,0;;9,0;;22,0;;;;7,0;;1,0;3,0;;;22,0;1,0;;;1,0;;;277,0;3,0;;;;;;;2,0;;;;1,0;2,0;12,0;;;;4,0;;;;16,0;;;;1,0;;15,0;;18,0;10,0;;;5,0;;;;;;;;;6,0;;1,0;6,0;3,0;;2,0;;1,0;;;;;2,0;;17,0;5,0;5,0;;;;;1,0;;;;14,0;25,0;12,0;26,0;;;2,0;;;;;;;6,0;;1,0;1,0;8,0;5,0;;;;1,0;2,0;;;;;3,0;;;;;;;;;;;;;;;;;;;;;;;2,0;;1,0;;;2,0;;;;;;6,0;;;;2,0;;;;1,0;;;;1,0;;;;2,0;;1,0;4,0;;;;27,0;1,0;;;;;2,0;;;;;;;;;;;;;;1,0;5,0;;;;;;;;;;;;4,0;;42,0;;;;;;;;;;;;;;;;;;;;;;;;;;;;;;3,0;;;;;;;;;;;;;17,0;;;;;;;1,0;1,0;;1,0;2,0;;2,0;;;1,0;;;;;3,0;;;2,0;;;;;;;;3,0;;;;;;;1,0;4,0;;;;;;;;1,0;;;;;;;;3,0;1,0;;;;;;10,0;;;;;;;;;;;;;;;3,0;;;1,0;;16,0;;;;1,0;8,0;3,0;;;1,0;;;;;;;;;10,0;;;;;;;;;;;;;;;;;;;;;;;;;2,0;;;;;;;;;;1,0;;;;;;;;;;;;;;;;;;;;;;;;;;;;;1,0;;;;;;;;;;;;;;2,0;;;;;;;23,0;;;;;;;1,0;;;;;;;;;;;1,0;9,0;;6,0;;;2,0;;;;;;;;;;;;;;2,0;;;;;;;1,0;;;;;;;;;;;2,0;;;1,0;7,0;;;;;;;;;;;;2,0;;;9,0;;;;;;;;;;;;;;;139,0;;;;;;;;;;;2,0;;;;;;;;;;;;;;;;;;;1,0;;3,0;;;20,0;;;;;;;;;;;;;;;;;;;;;;;;10,0;;;3,0;;;;;;;;;;;;3,0;;;
surveillance;;;1,0;33,0;1,0;99,0;2,0;11,0;;;;;;45,0;;24,0;31,0;3,0;1,0;3,0;1,0;;;2,0;4,0;;;;15,0;2,0;23,0;14,0;;;;71,0;7,0;4,0;1,0;;44,0;98,0;3,0;7,0;16,0;3,0;;12,0;;;;3,0;1,0;1,0;18,0;;16,0;;1,0;12,0;;;4,0;;202,0;2,0;67,0;1,0;1,0;;;16,0;36,0;;4,0;;7,0;;;3,0;97,0;;15,0;;44,0;;;39,0;;1,0;16,0;1,0;4,0;;2,0;;2,0;13,0;88,0;10,0;26,0;2,0;;5,0;11,0;14,0;2,0;7,0;7,0;;;2,0;42,0;;2,0;;2,0;10,0;2,0;21,0;3,0;4,0;10,0;2,0;;4,0;268,0;;;2,0;21,0;3,0;;65,0;;;30,0;;5,0;;;;7,0;;8,0;3,0;120,0;11,0;2,0;2,0;1,0;;1,0;5,0;;;;4,0;;;6,0;7,0;;1,0;;;6,0;16,0;1,0;7,0;1,0;;1,0;;11,0;4,0;;7,0;10,0;;2,0;1,0;6,0;11,0;1,0;;8,0;4,0;12,0;3,0;2,0;;;2,0;6,0;7,0;70,0;;4,0;;;5,0;1,0;2,0;2,0;2,0;11,0;1,0;6,0;57,0;;1,0;1,0;;;5,0;5,0;;;9,0;7,0;3,0;;;;;51,0;;1,0;4,0;;4,0;3,0;;2,0;;5,0;;;2,0;1,0;2,0;8,0;1,0;1,0;4,0;4,0;4,0;1,0;;2,0;;2,0;9,0;1,0;7,0;8,0;29,0;2,0;;1,0;18,0;1,0;2,0;7,0;1,0;;;1,0;9,0;;;;4,0;2,0;;;22,0;;1,0;;;13,0;;1,0;;2,0;8,0;4,0;2,0;1,0;6,0;;4,0;;;2,0;3,0;3,0;1,0;1,0;;;1,0;4,0;;;5,0;;10,0;;;;;;1,0;3,0;5,0;3,0;1,0;4,0;29,0;;9,0;1,0;4,0;;;33,0;;9,0;;;3,0;9,0;;;;;;3,0;1,0;3,0;1,0;1,0;5,0;;;;2,0;;;;1,0;6,0;;;5,0;173,0;43,0;1,0;;;;;8,0;9,0;1,0;;1,0;;;22,0;;;;;1,0;10,0;2,0;27,0;4,0;;1,0;;17,0;2,0;;;5,0;;3,0;;;1,0;6,0;;9,0;2,0;;;21,0;1,0;7,0;;4,0;;20,0;14,0;;;1,0;;7,0;12,0;1,0;;;2,0;;;3,0;8,0;1,0;;32,0;11,0;9,0;;;23,0;13,0;16,0;7,0;2,0;;15,0;1,0;5,0;;3,0;;7,0;7,0;;3,0;;;18,0;;;;;3,0;;5,0;;1,0;;;;;1,0;3,0;;;;;;;;;1,0;3,0;;;4,0;10,0;;;4,0;2,0;4,0;2,0;;;25,0;2,0;1,0;;;2,0;2,0;12,0;;;;7,0;;;1,0;19,0;4,0;;;;;;1,0;;8,0;;;5,0;11,0;1,0;6,0;2,0;4,0;;5,0;;1,0;;;1,0;3,0;3,0;;;1,0;;;6,0;5,0;;3,0;;1,0;;2,0;1,0;;3,0;;;;;2,0;;;;;;4,0;1,0;;;;;;1,0;;1,0;14,0;;1,0;5,0;1,0;;3,0;;;2,0;1,0;1,0;1,0;;;15,0;;;;13,0;;;;1,0;1,0;7,0;1,0;;;;5,0;;7,0;1,0;;7,0;1,0;;;6,0;1,0;5,0;;1,0;54,0;1,0;;;;2,0;;;1,0;4,0;;;;;;10,0;1,0;;4,0;;;;;12,0;;46,0;7,0;3,0;;;;1,0;1,0;;1,0;2,0;;4,0;42,0;1,0;1,0;;;;3,0;;;5,0;;3,0;;;;2,0;4,0;4,0;;;2,0;;1,0;6,0;21,0;2,0;1,0;;;;1,0;1,0;27,0;;;1,0;1,0;3,0;;;1,0;;1,0;1,0;;;;;;14,0;;;1,0;;1,0;;;1,0;4,0;1,0;2,0;5,0;;;;;;1,0;1,0;9,0;;8,0;;2,0;6,0;10,0;;2,0;;2,0;1,0;;;3,0;;;;4,0;8,0;;;;;;2,0;;;1,0;;1,0;;;1,0;;;;;;;;2,0;;;;;;;;;8,0;;;;1,0;14,0;;8,0;;;;;;8,0;;;;;3,0;8,0;;;;;;;;;;;;;;;;;;1,0;;;;;;;;;;;;;;;;;;2,0;;3,0;;;;;;;;;;;;;2,0;3,0;;;;;;;;;;;;2,0;10,0;;;;3,0;;;;1,0;;;3,0;5,0;;;;;;;7,0;;;;;1,0;4,0;;;;;;;;;;;;;;;;;2,0;;;;;4,0;;;;7,0;;;;;;;;;;;;;16,0;;;;1,0;19,0;;;;;;;3,0;;;2,0;;7,0;;;6,0;;;3,0;;;;;;;;;;;;;;;;;;6,0;3,0;;;;;1,0;;;;;;;;;;;;;;;;;;;;3,0;;;;;;;;;;;;;;;;;;;
table;;;1,0;6,0;1,0;13,0;6,0;;;;;;;49,0;3,0;5,0;2,0;;3,0;;;1,0;2,0;2,0;;;15,0;3,0;4,0;7,0;19,0;2,0;;5,0;;71,0;10,0;;8,0;;36,0;31,0;;4,0;1,0;11,0;3,0;4,0;;;10,0;;;;1,0;1,0;5,0;;;30,0;;;13,0;;77,0;;41,0;;;;;16,0;5,0;;;;;;;26,0;58,0;;;12,0;5,0;3,0;;4,0;;;33,0;1,0;;;1,0;;27,0;;52,0;8,0;31,0;8,0;;6,0;12,0;3,0;4,0;1,0;2,0;;;5,0;8,0;2,0;;3,0;;38,0;2,0;2,0;;5,0;15,0;5,0;;99,0;40,0;;;;6,0;;;10,0;;;1,0;;4,0;;;;;;;6,0;3,0;1,0;15,0;8,0;;1,0;;3,0;;;;;;;;3,0;;;;9,0;15,0;2,0;;1,0;1,0;2,0;;13,0;1,0;;;3,0;;;;;;5,0;;1,0;2,0;;3,0;;;;;6,0;;;;;15,0;;;;;6,0;1,0;6,0;;2,0;;20,0;13,0;2,0;;;;;21,0;;;8,0;;11,0;;;11,0;;5,0;;;2,0;;7,0;6,0;3,0;;;;;3,0;;;28,0;4,0;1,0;;21,0;;8,0;10,0;5,0;;;;3,0;;1,0;9,0;2,0;1,0;;;;;2,0;;;;;16,0;2,0;;;;;;;3,0;7,0;;;2,0;;3,0;3,0;;;;;3,0;1,0;;7,0;;1,0;;;8,0;;;;;;;;;;;;;11,0;;;;;;;4,0;;1,0;11,0;;8,0;3,0;3,0;;;;;3,0;1,0;;;;;18,0;2,0;;;;;7,0;;;;1,0;;;1,0;;19,0;;;;;;5,0;10,0;1,0;7,0;;;;;;;;;;;;;;5,0;1,0;;;;;;1,0;36,0;28,0;;1,0;1,0;22,0;3,0;;;4,0;;;1,0;3,0;;5,0;;21,0;3,0;;;10,0;;8,0;1,0;4,0;10,0;;9,0;5,0;;12,0;;;;;2,0;2,0;1,0;;;2,0;;8,0;5,0;5,0;;1,0;;;3,0;;12,0;;6,0;3,0;10,0;16,0;7,0;;8,0;;;5,0;10,0;8,0;;;1,0;;;2,0;;12,0;;;1,0;10,0;;;11,0;3,0;;15,0;;4,0;;1,0;;;;;1,0;;;;;;2,0;1,0;;1,0;;1,0;3,0;1,0;6,0;1,0;;;;;;2,0;;;;;;;;;;;26,0;;;;;;;7,0;;;1,0;;;;;;;;7,0;;;;;;;;;;;3,0;;;1,0;;3,0;4,0;;;;2,0;;;;;;3,0;;;6,0;;1,0;;;;;;11,0;3,0;1,0;;14,0;;;;32,0;3,0;;;4,0;;;;;1,0;;;;;;;2,0;;;;3,0;9,0;;2,0;;;;;;;14,0;;;1,0;;3,0;;12,0;;;2,0;;;3,0;15,0;;1,0;;;;2,0;;;;10,0;2,0;;5,0;;;4,0;;;;;3,0;;;;;;2,0;;;1,0;2,0;;;;;;;;;;;8,0;;;;;;;;;;;;1,0;;;;6,0;;2,0;;;;;;6,0;;;;;;;;2,0;;;6,0;;;;;6,0;;3,0;1,0;;;;2,0;;44,0;5,0;6,0;;;;4,0;;;;;;;;;;;;;;2,0;;;;;4,0;1,0;;;;;;1,0;;;;;;2,0;;;;1,0;;;;3,0;;;;;;;;;;;;;;;;1,0;1,0;;52,0;;;;3,0;;;;;;;;;;;1,0;;;;;;;;;3,0;;;;2,0;;;;;;;5,0;;;;;26,0;;4,0;;;;;6,0;;;;;;2,0;;;;1,0;;;;;;;2,0;;;2,0;11,0;1,0;;;;;;;;;;;2,0;;1,0;;3,0;;;;12,0;;;;;;;;;;;;;2,0;;;;;;;;1,0;10,0;4,0;;3,0;;;;;;;;;;;;;;;;;;;;;;;;;;1,0;;;;1,0;;1,0;;;2,0;;;;;;;;;;;;;;;;;;;;;;;;;;;;;;;;;;;;;;1,0;;;;2,0;;;;;;;;10,0;;;;;1,0;;1,0;;;;;;;;;;3,0;4,0;;;;;;;;;;;;;;;
technique;;;1,0;2,0;;14,0;6,0;1,0;;1,0;;;;10,0;;;18,0;;;;;;2,0;;;;2,0;4,0;;;4,0;2,0;2,0;12,0;;23,0;;;8,0;;9,0;26,0;;3,0;6,0;1,0;;3,0;;1,0;10,0;;3,0;;4,0;;10,0;;10,0;10,0;1,0;;3,0;1,0;128,0;6,0;17,0;;;;;5,0;6,0;;;;;16,0;1,0;1,0;33,0;;;3,0;5,0;;;8,0;1,0;2,0;5,0;;;;;;10,0;;6,0;7,0;6,0;;;12,0;21,0;4,0;;1,0;;;1,0;4,0;10,0;;;3,0;2,0;;5,0;13,0;4,0;;17,0;;3,0;1,0;45,0;;1,0;1,0;1,0;5,0;;1,0;;;6,0;2,0;;;;;;;4,0;9,0;;;4,0;;;6,0;;;;;;;3,0;;;1,0;3,0;;;;;;;19,0;;;2,0;;;1,0;;;2,0;;1,0;;;6,0;;;4,0;;4,0;2,0;;1,0;;;;;;;;;;;;;;3,0;;;;5,0;;1,0;;;;;5,0;;;;3,0;;;;1,0;;2,0;;;2,0;;;2,0;;;;;5,0;;;;;;;;4,0;1,0;;1,0;;;;2,0;6,0;4,0;1,0;1,0;5,0;;;1,0;;;1,0;;;;;;;;;;;;;2,0;2,0;;1,0;;;;;;;;2,0;;;;;;;1,0;;2,0;;;;;;;1,0;;;;;;13,0;;;;;;;1,0;;;2,0;3,0;11,0;;;;;;;3,0;;;;;;;;;;;;1,0;;;;;;1,0;;;;;;;;4,0;;;;17,0;2,0;;;;;;9,0;1,0;;;10,0;;;6,0;;;;;2,0;;3,0;8,0;2,0;;24,0;;7,0;;1,0;1,0;;;2,0;2,0;2,0;;;;6,0;;;2,0;8,0;1,0;2,0;;;;3,0;5,0;;;;3,0;;4,0;;;2,0;;;;;;;1,0;7,0;;1,0;;;10,0;;;;;;1,0;;1,0;3,0;1,0;;;;1,0;2,0;1,0;;6,0;;;;;;;2,0;;24,0;;1,0;7,0;3,0;;1,0;;;2,0;;1,0;;;;1,0;;;;;2,0;1,0;1,0;;2,0;;1,0;;;17,0;;;1,0;;;;1,0;;;2,0;1,0;1,0;;;3,0;;1,0;;;;;;;3,0;;;;;2,0;;;;;;;;;;;;;;;;1,0;;;;;;;;11,0;;1,0;;;;;;;;;;;11,0;;;1,0;1,0;;;1,0;;;2,0;;3,0;2,0;6,0;;;;;;;;;1,0;;3,0;;1,0;;;;;;;;;5,0;5,0;1,0;;;;;;;;1,0;;;;;2,0;1,0;;;2,0;;;2,0;;1,0;;;;1,0;;;;;;1,0;4,0;;;;;;1,0;;2,0;;3,0;;;;;;1,0;1,0;;;;;;;;;;;1,0;;1,0;;;;2,0;;;;;;;1,0;;;;;1,0;;;;;;;;2,0;2,0;;;1,0;;;;;21,0;4,0;;;;;1,0;;13,0;2,0;;2,0;;;;;;;;;;;;;;;1,0;;;;;;;;;;1,0;;;;;;;1,0;;;;4,0;;;;;1,0;;2,0;;;;;;2,0;;;;;;;;;;;;;;;;;;;1,0;;;;1,0;;;2,0;;;;;;;;;;1,0;;;;;;;;;;;;;;;;;;;;;1,0;;;;;;;;1,0;;;;;3,0;;;;;1,0;;;;;;;;;;;;;;;19,0;;;;;;;1,0;;;1,0;;;;;1,0;;1,0;1,0;;;;;;;2,0;;;;;;;;;;;;9,0;4,0;;;3,0;;1,0;1,0;1,0;;1,0;;2,0;1,0;1,0;8,0;;;;1,0;;;;;;;;;;;;2,0;;;;;2,0;;;;;;;;;1,0;;;;;;;;;1,0;1,0;;;;;;;;;;;;;;;;;;;;;;;;;;;;;;;;;4,0;;;;;;4,0;;;3,0;;;;;;;;;;;9,0;;2,0;8,0;;;;1,0;;;;;;;;;;;
thin;;;1,0;;;2,0;7,0;;;;4,0;;;;;1,0;;;;;;;;1,0;;;5,0;;;;9,0;;;;1,0;11,0;;;;1,0;3,0;49,0;;3,0;44,0;11,0;;1,0;;;;;7,0;2,0;7,0;1,0;41,0;;;;3,0;;;;21,0;1,0;23,0;;;;1,0;16,0;15,0;2,0;;;1,0;;2,0;3,0;12,0;;20,0;;25,0;;;3,0;4,0;;;;;;;1,0;13,0;;2,0;;2,0;1,0;;2,0;;;;;;;;;19,0;;;;3,0;;;20,0;;;6,0;1,0;;3,0;10,0;;;20,0;;;2,0;12,0;;;;;3,0;;2,0;6,0;;;;9,0;18,0;1,0;5,0;3,0;;1,0;1,0;;;3,0;;1,0;;;6,0;23,0;;;;;2,0;27,0;2,0;;1,0;;;6,0;;8,0;;4,0;3,0;;1,0;;3,0;;;115,0;3,0;;;2,0;;;;;1,0;18,0;;2,0;1,0;;;57,0;;;;;6,0;3,0;;4,0;;;;;;21,0;1,0;;;;;;;;43,0;;107,0;;;;;;1,0;1,0;;;;;;;;;;;;2,0;1,0;4,0;18,0;;;;2,0;1,0;15,0;;12,0;33,0;;;;9,0;;;;;;;;;;1,0;;;;;;;;3,0;;1,0;;6,0;;;4,0;1,0;6,0;;;;;21,0;;;2,0;;6,0;;;;13,0;;;;3,0;;;12,0;;;1,0;1,0;;;1,0;;;1,0;1,0;;6,0;;34,0;;;;1,0;;;;;6,0;;;;;;;;;;;;;2,0;1,0;;;;;;;;;4,0;;7,0;;10,0;;;;;;;;;;;;;2,0;;;;;;;5,0;10,0;;;;;;;;;;2,0;;3,0;;1,0;;;;;;1,0;;5,0;1,0;4,0;;;;;;;;;12,0;;;;;;;1,0;;10,0;;4,0;;2,0;;;3,0;;;;;;;1,0;;;;;;;;;;;;;;7,0;;;;;;;;;;;;;;;;;;;;4,0;;;;;;;;;;2,0;;;;;;;;;;;;2,0;;1,0;1,0;;;1,0;;;2,0;;;1,0;;;;;;;;;;;;6,0;;;1,0;;;;;;;;;;;;;;1,0;;;;;;;;;8,0;;;;;;;;;;;;;;;;;;;1,0;;;;;;;;;;;;;1,0;;;;;;;;;;;;;;1,0;;;;;;;;;;;;;;;;;;7,0;;1,0;;;;;;;;;;;;;;;;;;;;;;;;;;;;;;;;;;;;;;;;;;;;;;;;;;;;;;;;12,0;;;;;14,0;;;;;;;;;;;1,0;;;;;;38,0;;;;;1,0;;;;;2,0;;;3,0;;;;13,0;;;;;3,0;;;1,0;;;;;;;1,0;;;1,0;;;;;;;;;;;;;;1,0;9,0;;2,0;;;;;;;;;;;2,0;;;;;;;1,0;;;;;;;;;;;;;;;;;;;1,0;;1,0;;;;;;24,0;;;7,0;;;;;;;;;;;;2,0;;;7,0;;2,0;;;;;;;;;;;;3,0;;;;;;;;;;;3,0;;;;42,0;;;;;;1,0;;;;;;;;;;;;;;;;;;;;;;;;;;;;;;;8,0;;2,0;;;;;;;;;;;;;;;;;;;;;;;;;;;;;;;;;;;;8,0;1,0;;;;;;;;;;;;;;;;;;;;;;;;;;;;;;39,0;;;;;;;;;;2,0;;;;;;;;;;;;;;;;;;;;;;;;;;;;;;;;;;;;;;;;;;;;;;;;;;;;
trigger;;;1,0;10,0;2,0;22,0;12,0;34,0;;;;;;59,0;;;96,0;;4,0;;;;1,0;1,0;8,0;;;9,0;3,0;67,0;70,0;34,0;;;;67,0;3,0;1,0;2,0;;28,0;98,0;;19,0;47,0;1,0;;28,0;;1,0;;;3,0;27,0;4,0;;;;2,0;34,0;;2,0;2,0;6,0;177,0;2,0;55,0;1,0;4,0;;;13,0;49,0;;;;;;4,0;22,0;74,0;;14,0;;22,0;;2,0;9,0;;12,0;7,0;1,0;1,0;;11,0;;19,0;2,0;23,0;24,0;67,0;9,0;;10,0;18,0;33,0;;2,0;;3,0;;;1,0;1,0;;3,0;1,0;16,0;2,0;59,0;4,0;;213,0;;;10,0;65,0;;;;71,0;;;43,0;;;13,0;3,0;2,0;;;2,0;2,0;;;1,0;5,0;5,0;26,0;4,0;1,0;5,0;;;;;;;;;;18,0;1,0;1,0;;;22,0;11,0;1,0;38,0;12,0;;3,0;12,0;;1,0;;8,0;4,0;;;;;2,0;;4,0;9,0;;7,0;2,0;;27,0;;2,0;;;7,0;;;1,0;;;;;9,0;3,0;;;;18,0;1,0;9,0;6,0;;;;27,0;;;1,0;;6,0;9,0;15,0;12,0;;4,0;;;9,0;;5,0;3,0;;1,0;;;;;3,0;;;1,0;;;14,0;4,0;1,0;6,0;;;;;;;;3,0;8,0;;;7,0;41,0;;19,0;4,0;;1,0;7,0;;3,0;;2,0;14,0;;2,0;;2,0;3,0;;8,0;;;1,0;4,0;2,0;7,0;;2,0;53,0;;;3,0;;;;;8,0;6,0;;2,0;;;4,0;1,0;;;6,0;1,0;;8,0;;;1,0;2,0;1,0;;2,0;3,0;1,0;56,0;29,0;28,0;1,0;8,0;;;;;10,0;4,0;;;3,0;;19,0;;6,0;;;;3,0;;;;;14,0;;;;;;;1,0;;1,0;;5,0;;34,0;4,0;16,0;;;32,0;12,0;1,0;4,0;;;3,0;;5,0;1,0;;14,0;1,0;4,0;35,0;1,0;;77,0;2,0;14,0;;10,0;68,0;;;;163,0;;8,0;;1,0;2,0;29,0;;62,0;7,0;11,0;;12,0;;38,0;;2,0;;7,0;13,0;;;7,0;;1,0;29,0;3,0;4,0;;;1,0;;3,0;8,0;17,0;;72,0;6,0;66,0;6,0;;11,0;;6,0;5,0;;2,0;11,0;6,0;24,0;1,0;;21,0;32,0;;;6,0;;;55,0;1,0;;8,0;17,0;1,0;;1,0;;4,0;;;15,0;7,0;9,0;4,0;;1,0;;;;4,0;6,0;4,0;8,0;8,0;;;1,0;2,0;2,0;;3,0;;5,0;4,0;3,0;;7,0;1,0;7,0;;1,0;;;1,0;20,0;;9,0;4,0;2,0;2,0;1,0;3,0;;11,0;;;1,0;10,0;;;3,0;;9,0;;;9,0;;4,0;1,0;;1,0;2,0;;;5,0;;;1,0;;;;7,0;7,0;;;2,0;1,0;;;;;1,0;;4,0;;5,0;;;;8,0;;;;21,0;9,0;;;;;;;15,0;;;;;5,0;3,0;7,0;1,0;5,0;4,0;;;1,0;1,0;;1,0;;;;;6,0;1,0;;;;;;;;2,0;2,0;5,0;;;;;5,0;2,0;;;;;;1,0;2,0;24,0;;;1,0;8,0;;1,0;1,0;6,0;;11,0;3,0;1,0;14,0;;28,0;2,0;;;;;;;;;;;;;;;;;;20,0;;;;;;;;3,0;;1,0;2,0;;;;1,0;;;;;14,0;3,0;2,0;27,0;;;;;;26,0;3,0;;;1,0;;;;4,0;;2,0;;;1,0;10,0;;;;;5,0;1,0;;5,0;1,0;;4,0;;;1,0;;;;;2,0;;;3,0;;;;;;;1,0;;;;;;1,0;3,0;;;4,0;18,0;3,0;;;;1,0;;;;;;;;;2,0;;7,0;;;;;;1,0;;1,0;;;;;2,0;;;;;;;11,0;;;;;;;;;;1,0;7,0;13,0;1,0;;;;;;;;;;25,0;;;;;;;;;;;6,0;;1,0;5,0;;;;1,0;;2,0;;;;6,0;;;2,0;;2,0;;19,0;3,0;3,0;;;;;5,0;;;2,0;3,0;;;;;;;;;;;;;;;;;;;;;;2,0;;;3,0;;;4,0;;;2,0;;5,0;2,0;;1,0;;1,0;;1,0;;;2,0;3,0;1,0;2,0;17,0;2,0;;;;1,0;;;;;25,0;;;;;;;;4,0;2,0;;;;5,0;2,0;1,0;;;3,0;;;;;2,0;;;;4,0;;;;4,0;;;3,0;;;;;;;;;1,0;;;22,0;;;;;;;;;;;;;;;;;;;;;;8,0;;;;;;;;;;;;;;;;;;;;;;;;;;2,0;;;;6,0;;;;;;;;;;;;;;;;;;;
utilize;;;2,0;4,0;;16,0;29,0;;;1,0;;2,0;;15,0;;;33,0;;1,0;8,0;2,0;9,0;5,0;1,0;1,0;;;2,0;4,0;1,0;26,0;20,0;4,0;7,0;;48,0;17,0;;15,0;1,0;26,0;91,0;;2,0;22,0;;8,0;2,0;3,0;5,0;3,0;;2,0;;9,0;3,0;1,0;;4,0;9,0;;;5,0;;152,0;1,0;32,0;6,0;;;;19,0;9,0;;;;1,0;10,0;1,0;1,0;71,0;;;15,0;20,0;;;8,0;8,0;1,0;55,0;;;;1,0;2,0;12,0;7,0;16,0;27,0;30,0;1,0;;16,0;40,0;38,0;1,0;4,0;1,0;;4,0;14,0;11,0;;;3,0;1,0;1,0;4,0;18,0;3,0;;8,0;3,0;1,0;4,0;89,0;;4,0;;10,0;;1,0;31,0;;2,0;51,0;8,0;2,0;;;;1,0;;5,0;11,0;3,0;;8,0;1,0;;6,0;3,0;;1,0;;;;3,0;;2,0;1,0;;;;7,0;2,0;;1,0;19,0;8,0;;6,0;4,0;;2,0;;1,0;1,0;3,0;11,0;3,0;;1,0;;1,0;22,0;5,0;3,0;1,0;;;1,0;;;;;;;;;5,0;;;2,0;2,0;2,0;;;3,0;1,0;7,0;;;;;15,0;;;1,0;9,0;1,0;;;;3,0;3,0;;;2,0;;2,0;3,0;13,0;;2,0;;;;;;1,0;;;;7,0;1,0;6,0;2,0;1,0;;;6,0;3,0;2,0;;;4,0;;;3,0;1,0;2,0;8,0;;;1,0;1,0;1,0;1,0;;;;13,0;3,0;;;;;;;2,0;;2,0;;;;10,0;1,0;;3,0;2,0;;;6,0;;5,0;;;;;;;3,0;;;;1,0;1,0;20,0;;;;;1,0;;;1,0;;1,0;5,0;24,0;;2,0;;;2,0;1,0;;2,0;;;;;4,0;;;;;;3,0;1,0;2,0;;;1,0;;1,0;;;1,0;;;;8,0;;;;31,0;8,0;;;;5,0;;8,0;6,0;;;;;;6,0;2,0;2,0;;;1,0;;4,0;11,0;4,0;;1,0;;5,0;3,0;4,0;;1,0;;12,0;2,0;2,0;1,0;8,0;;4,0;;;;8,0;;6,0;1,0;12,0;;7,0;15,0;1,0;;7,0;;1,0;5,0;1,0;;;;2,0;;1,0;;;;3,0;;;3,0;;6,0;;;2,0;1,0;;2,0;10,0;5,0;2,0;;;;;30,0;;1,0;;16,0;1,0;2,0;;2,0;;;5,0;3,0;31,0;;3,0;4,0;;1,0;2,0;;3,0;;;1,0;3,0;2,0;;11,0;4,0;;;3,0;;;2,0;2,0;1,0;2,0;8,0;4,0;4,0;15,0;4,0;;;;;;;1,0;;5,0;;6,0;;2,0;3,0;;3,0;;;6,0;;;;1,0;;;2,0;;1,0;;1,0;1,0;2,0;;;;;;;;;;;1,0;4,0;;2,0;;1,0;1,0;;;13,0;4,0;;;;;;;;;2,0;;;2,0;;;;;;;1,0;;;1,0;;4,0;;1,0;5,0;3,0;1,0;2,0;;;1,0;1,0;3,0;;10,0;;1,0;1,0;;;;1,0;;;;;2,0;2,0;;2,0;;;1,0;;;1,0;1,0;;;;24,0;;4,0;7,0;7,0;;;;;4,0;;1,0;;1,0;;1,0;1,0;;;4,0;6,0;;;;;;;;1,0;;5,0;;;7,0;;;1,0;1,0;;;;;4,0;;;1,0;;;;1,0;;1,0;;;;;18,0;2,0;;;;;;;;1,0;2,0;11,0;1,0;;5,0;4,0;3,0;;2,0;8,0;;;1,0;1,0;5,0;3,0;;;2,0;;;;;2,0;;;;;;;;;;;1,0;4,0;;;;;;10,0;;;3,0;;10,0;;;;1,0;;;;;;1,0;;4,0;;;;1,0;1,0;;9,0;1,0;1,0;;;;4,0;;;;;;10,0;;;2,0;;;;;;;;;;;;;;;;;;;2,0;;3,0;;;;2,0;;;;;;3,0;;1,0;;;2,0;;;;;;;;;;;4,0;2,0;3,0;;;;;1,0;;;;;2,0;3,0;;;;;;5,0;;;;;;4,0;3,0;;;;;;;;1,0;;25,0;;;1,0;;2,0;1,0;;;;;;;;;;21,0;;6,0;15,0;;;1,0;3,0;2,0;;;3,0;;;2,0;3,0;;;;1,0;;4,0;;1,0;;;13,0;;;3,0;1,0;;;;3,0;;;;;1,0;;;1,0;1,0;2,0;;;;;;;;;2,0;;;;;;;;;;;;;;1,0;;;5,0;;;;1,0;;;;;5,0;;;;;;;1,0;;;;;;;;;;;;;;;;3,0;;1,0;;;;8,0;;1,0;;;1,0;;;;;;;;1,0;;;;;9,0;;;;;;5,0;3,0;;;3,0;2,0;;;4,0;1,0;;;;12,0;;;;;;
wavelength;;;1,0;1,0;4,0;24,0;26,0;9,0;;;;151,0;;20,0;19,0;;38,0;3,0;7,0;18,0;;;56,0;;2,0;;;46,0;3,0;6,0;33,0;7,0;2,0;;;22,0;21,0;7,0;5,0;13,0;22,0;49,0;;;1,0;2,0;;13,0;;;;;;2,0;;;12,0;;5,0;17,0;3,0;13,0;2,0;;150,0;;67,0;2,0;;;2,0;30,0;803,0;;;;17,0;;1,0;;77,0;;3,0;;19,0;;;86,0;;3,0;2,0;;72,0;;;6,0;41,0;11,0;19,0;7,0;16,0;75,0;2,0;10,0;18,0;6,0;;1,0;14,0;;1,0;2,0;144,0;7,0;;;1,0;10,0;4,0;78,0;;;68,0;;56,0;1,0;65,0;;;6,0;29,0;;;13,0;7,0;;2,0;;1,0;9,0;;;1,0;13,0;8,0;;7,0;3,0;20,0;;;43,0;;;;;;2,0;4,0;25,0;1,0;;;6,0;10,0;;5,0;4,0;;1,0;5,0;1,0;17,0;8,0;;1,0;5,0;85,0;;;2,0;;3,0;;;4,0;157,0;;3,0;;;;;;;6,0;26,0;42,0;5,0;;;11,0;15,0;;14,0;6,0;;5,0;15,0;1,0;4,0;;;6,0;;;22,0;2,0;;15,0;8,0;2,0;;11,0;1,0;;66,0;;2,0;1,0;;94,0;482,0;6,0;;;30,0;2,0;;16,0;;;;;1,0;52,0;32,0;;18,0;;;;1,0;12,0;10,0;3,0;;19,0;;6,0;;36,0;19,0;3,0;;;11,0;;;6,0;;;4,0;2,0;;;16,0;5,0;;6,0;;;1,0;;;;;;;2,0;;;;;2,0;;5,0;3,0;;;;;;;;;;;;21,0;;;1,0;;4,0;;2,0;;;;2,0;26,0;;5,0;1,0;;2,0;;20,0;;;;;;;;;;;;;;;;2,0;;;;1,0;;;;2,0;;5,0;;;13,0;2,0;4,0;4,0;;;2,0;;;;;;;;;6,0;30,0;12,0;6,0;;;2,0;;11,0;;;;15,0;39,0;2,0;20,0;;;4,0;1,0;3,0;11,0;;6,0;7,0;1,0;;1,0;;2,0;3,0;;;2,0;2,0;2,0;;6,0;;;1,0;11,0;7,0;2,0;;;;;1,0;5,0;;;2,0;44,0;1,0;6,0;;;;;;;;;1,0;8,0;;;;;10,0;;;1,0;;;;1,0;;;;;;;;7,0;;6,0;5,0;7,0;;;1,0;1,0;;;;;;;;;;;14,0;;;;;2,0;;9,0;6,0;;1,0;;;;;4,0;1,0;12,0;5,0;;;;;;2,0;;2,0;;;;2,0;;;;;6,0;;;4,0;;;;;;;;3,0;;;;;;;1,0;;;;;;;21,0;;2,0;3,0;;4,0;4,0;;;;;2,0;;;;;;;;;;23,0;;;;;;2,0;;;;;;;;;;;;;18,0;;;;;;20,0;;;5,0;;;;5,0;;;;;;;;2,0;;;;;;;;;;13,0;1,0;;2,0;;;;;;3,0;;;1,0;;;58,0;2,0;;;;;1,0;;;;;;;;;;2,0;4,0;;1,0;;;;7,0;;3,0;;;;;;;;;;;9,0;;;1,0;;;13,0;1,0;;;;;81,0;;;;;4,0;;;23,0;;;;;30,0;;7,0;1,0;1,0;;;6,0;;;;;1,0;;14,0;;;8,0;1,0;2,0;;3,0;;;;;;6,0;;5,0;;;38,0;1,0;;;27,0;;1,0;;;;;;;1,0;;;;;;3,0;;;;1,0;;37,0;;;;;30,0;;119,0;;;;;;;;;;4,0;;2,0;;;;;;;;;;;11,0;;;2,0;;;;;;;;;1,0;1,0;15,0;1,0;;10,0;;;;2,0;2,0;;;;20,0;;;;;;;3,0;;;;7,0;6,0;1,0;;;4,0;;;;25,0;;;;;7,0;;;;;;;5,0;;;;;;;5,0;;;1,0;;;;;;;;12,0;;;;;1,0;;;;;;;;1,0;;39,0;1,0;25,0;;;;;;7,0;;;1,0;10,0;2,0;;;;;;;1,0;;;;;;;;;;;;;;;;;;;;;1,0;;;;;5,0;1,0;13,0;;;6,0;1,0;;;;;;;;;;;;;;6,0;11,0;;;;;1,0;3,0;;;;;;;;;;;;2,0;13,0;;;;;;;;;;;;;;1,0;63,0;;4,0;;;;;;;;;26,0;;;;;1,0;1,0;;;4,0;;;;;;;;2,0;;;;;;;;;
acceleration;;;;5,0;1,0;5,0;;2,0;;;;;;43,0;;;1,0;;;;;;;;;;;2,0;2,0;1,0;15,0;2,0;2,0;;;26,0;;;;;18,0;16,0;;4,0;2,0;3,0;;;;;1,0;;;;1,0;1,0;2,0;;;12,0;;;1,0;;3,0;;13,0;2,0;;;;10,0;1,0;;;;1,0;14,0;;2,0;20,0;;7,0;1,0;17,0;1,0;;;;;1,0;;;;;;;;3,0;;7,0;11,0;;1,0;1,0;9,0;;1,0;;;2,0;3,0;;;;1,0;;5,0;;90,0;4,0;;9,0;;;;9,0;;;;19,0;;;10,0;;;2,0;;14,0;;;;;;;3,0;;;1,0;1,0;3,0;;7,0;;;;;;;;;;;;;;2,0;;;;;;;24,0;;;;;14,0;;;;;2,0;;;;3,0;1,0;2,0;;2,0;;;2,0;;5,0;;;;;;2,0;;2,0;2,0;1,0;;;1,0;;14,0;;;;;;1,0;;;2,0;1,0;;;;;40,0;;;;;;;;;;;;;9,0;;;;;;1,0;;;;;;;;;;2,0;;;;;;2,0;;30,0;;;;;10,0;;;;2,0;5,0;;;;2,0;;1,0;;;14,0;;;;;3,0;1,0;;;;;;;;9,0;;;;;;;;;;;6,0;;;;;;;;;;;;;15,0;13,0;;;;;;;;;;;;;;;;;;;;5,0;1,0;;;;;;;;;;;;5,0;;2,0;;3,0;1,0;;;13,0;1,0;3,0;2,0;1,0;15,0;15,0;2,0;4,0;9,0;7,0;2,0;4,0;5,0;4,0;9,0;1,0;2,0;62,0;10,0;5,0;1,0;5,0;45,0;1,0;2,0;18,0;1,0;6,0;2,0;6,0;19,0;2,0;2,0;5,0;2,0;1,0;3,0;6,0;12,0;4,0;2,0;9,0;5,0;1,0;1,0;12,0;1,0;1,0;1,0;1,0;1,0;8,0;2,0;2,0;2,0;2,0;2,0;1,0;2,0;2,0;4,0;1,0;2,0;5,0;1,0;2,0;2,0;13,0;2,0;1,0;3,0;18,0;2,0;2,0;1,0;1,0;1,0;1,0;13,0;11,0;2,0;3,0;4,0;4,0;10,0;12,0;30,0;3,0;1,0;;;;;;;;;;;;;;;;;;;;;;;;;;;;;;;;;;;;;;;;;;;;;;;;;;;;;;;;;;;;;;;;;;;;;;;;;;;;;;;;;;;;;;;;;;;;;;;;;;;;;;;;;;;;;;;;;;;;;;;;;;;;;;;;;;;;;;;;;;;;;;;;;;;;;;;;;;;;;;;;;;;;;;;;;;;;;;;;;;;;;;;;;;;;;;;;;;;;;;;;;;;;;;;;;;;;;;;;;;;;;;;;;;;;;;;;;;;;;;;;;;;;;;;;;;;;;;;;;;;;;;;;;;;;;;;;;;;;;;;;;;;;;;;;;;;;;;;;;;;;;;;;;;;;;;;;;;;;;;;;;;;;;;;;;;;;;;;;;;;;;;;;;;;;;;;;;;;;;;;;;;;;;;;;;;;;;;;;;;;;;;;;;;;;;;;;;;;;;;;;;;;;;;;;;;;;;;;;;;;;;;;;;;;;;;;;;;;;;;;;;;;;;;;;;;;;;;;;;;;;;;;;;;;;;;;;;;;;;;;;;;;;;;;;;;;;;;;;;;;;;;;;;;;;;;;;;;;;;;;;;;;;;;;;;;;;;;;;;;;;;;;;;;;;
access;;;;1,0;;9,0;2,0;14,0;1,0;;;;1,0;55,0;1,0;;40,0;1,0;22,0;;3,0;;;6,0;18,0;;;7,0;5,0;3,0;96,0;11,0;;1,0;;154,0;16,0;;16,0;;54,0;274,0;;7,0;11,0;8,0;;3,0;;2,0;;;6,0;11,0;4,0;;4,0;;;21,0;1,0;;;;160,0;9,0;51,0;;9,0;;1,0;20,0;9,0;;;;5,0;;29,0;51,0;66,0;;9,0;6,0;25,0;3,0;;6,0;;2,0;2,0;;9,0;;;;29,0;14,0;40,0;111,0;17,0;7,0;;;10,0;48,0;4,0;1,0;2,0;;;12,0;2,0;;3,0;8,0;8,0;42,0;8,0;45,0;1,0;;11,0;;;55,0;106,0;;;1,0;13,0;;;10,0;;;11,0;2,0;;;;2,0;;;2,0;4,0;25,0;16,0;43,0;;;3,0;2,0;;;;;;;;;23,0;13,0;;;;9,0;6,0;;2,0;;;11,0;1,0;;2,0;;;14,0;;;;2,0;1,0;2,0;;;;6,0;8,0;;1,0;;3,0;;;6,0;;3,0;3,0;;5,0;13,0;;2,0;5,0;19,0;;8,0;12,0;;;1,0;;4,0;3,0;4,0;1,0;;2,0;;8,0;14,0;;1,0;;24,0;2,0;24,0;;1,0;;;;4,0;1,0;;;;;;;;8,0;1,0;13,0;;3,0;18,0;;3,0;;;1,0;;;;8,0;;;4,0;11,0;2,0;8,0;16,0;;;;3,0;1,0;;;;5,0;;;61,0;;;;1,0;;;3,0;;;5,0;;21,0;;2,0;2,0;;1,0;;;18,0;4,0;;;;2,0;;;;2,0;;2,0;;5,0;;;1,0;;;;1,0;3,0;1,0;1,0;12,0;11,0;;5,0;3,0;;;;7,0;3,0;;;;;54,0;;2,0;;27,0;;;1,0;;;;9,0;;6,0;;2,0;;;10,0;;;;;;114,0;81,0;1,0;;;;;1,0;2,0;;1,0;1,0;;;;;;1,0;;11,0;4,0;1,0;67,0;1,0;3,0;;;16,0;3,0;2,0;4,0;9,0;1,0;8,0;;2,0;1,0;5,0;;11,0;18,0;;;31,0;;46,0;;26,0;;6,0;4,0;;;;;27,0;13,0;;;;;;;4,0;;1,0;1,0;56,0;28,0;17,0;4,0;;4,0;11,0;18,0;;5,0;;43,0;4,0;6,0;7,0;;14,0;2,0;;;5,0;;;73,0;;;;13,0;;;8,0;;;;;20,0;;;2,0;;14,0;;;;;4,0;;14,0;44,0;4,0;;1,0;;;;;;3,0;11,0;2,0;;11,0;2,0;8,0;2,0;;;;;1,0;;;31,0;;;;17,0;;6,0;3,0;;;;;;15,0;4,0;3,0;4,0;;9,0;2,0;18,0;25,0;;6,0;2,0;;;2,0;;2,0;;;;;7,0;1,0;;;;;;;5,0;3,0;;;74,0;;4,0;1,0;;23,0;2,0;;;;;61,0;2,0;;;;;;;1,0;;4,0;;;2,0;;3,0;2,0;2,0;10,0;3,0;9,0;2,0;1,0;1,0;2,0;9,0;1,0;2,0;3,0;3,0;11,0;1,0;6,0;20,0;14,0;3,0;7,0;14,0;1,0;6,0;26,0;1,0;2,0;1,0;5,0;4,0;1,0;1,0;1,0;13,0;3,0;11,0;1,0;3,0;5,0;3,0;3,0;1,0;4,0;17,0;4,0;1,0;3,0;8,0;10,0;2,0;2,0;1,0;11,0;2,0;24,0;6,0;1,0;1,0;1,0;21,0;2,0;2,0;1,0;37,0;1,0;1,0;4,0;15,0;1,0;1,0;4,0;2,0;2,0;1,0;2,0;4,0;1,0;1,0;1,0;4,0;6,0;4,0;2,0;1,0;3,0;1,0;3,0;1,0;1,0;1,0;5,0;4,0;21,0;42,0;1,0;1,0;4,0;8,0;2,0;32,0;8,0;10,0;2,0;7,0;27,0;1,0;8,0;32,0;2,0;2,0;2,0;2,0;7,0;7,0;2,0;7,0;3,0;5,0;;;;;;;;;;;;;;;;;;;;;;;;;;;;;;;;;;;;;;;;;;;;;;;;;;;;;;;;;;;;;;;;;;;;;;;;;;;;;;;;;;;;;;;;;;;;;;;;;;;;;;;;;;;;;;;;;;;;;;;;;;;;;;;;;;;;;;;;;;;;;;;;;;;;;;;;;;;;;;;;;;;;;;;;;;;;;;;;;;;;;;;;;;;;;;;;;;;;;;;;;;;;;;;;;;;;;;;;;;;;;;;;;;;;;;;;;;;;;;;;;;;;;;;;;;;;;;;;;;;;;;;;;;;;;;;;;;;;;;;;;;;;;;;;;;;;;;;;;;;;;;;;;;;;;;;;
acquisition;;;;14,0;20,0;16,0;4,0;1,0;;;;;;31,0;;;20,0;3,0;;;34,0;;1,0;1,0;6,0;4,0;;15,0;6,0;23,0;92,0;7,0;1,0;4,0;1,0;135,0;6,0;2,0;25,0;;34,0;90,0;;31,0;9,0;;;2,0;;2,0;5,0;;3,0;2,0;2,0;1,0;;;1,0;11,0;;;4,0;;454,0;2,0;37,0;;5,0;;1,0;38,0;45,0;1,0;;1,0;;4,0;;4,0;74,0;;4,0;19,0;40,0;;;21,0;;3,0;34,0;;;7,0;9,0;;15,0;;5,0;9,0;57,0;4,0;;2,0;44,0;13,0;;4,0;;;;;8,0;;;;3,0;2,0;22,0;35,0;4,0;28,0;47,0;1,0;4,0;8,0;95,0;;;;106,0;;;221,0;1,0;;13,0;3,0;2,0;;;;;;;1,0;14,0;9,0;1,0;;;;18,0;;;;;8,0;;;;2,0;;;;;10,0;;;1,0;19,0;;1,0;6,0;;;;;2,0;;1,0;;;;;;2,0;;16,0;6,0;;;;;;;;;;;;;1,0;;2,0;1,0;1,0;;1,0;1,0;;11,0;1,0;;;2,0;11,0;;14,0;2,0;;55,0;1,0;;;;3,0;;;2,0;;1,0;80,0;;1,0;;;;;4,0;;1,0;;;1,0;11,0;2,0;;6,0;;;;;4,0;;1,0;5,0;4,0;;;3,0;15,0;2,0;17,0;;;;;1,0;11,0;;;;3,0;;;1,0;7,0;;1,0;;;;1,0;;;1,0;;2,0;;;1,0;;;2,0;;4,0;;;;;;;;;;;;;21,0;;;1,0;;2,0;;;;;3,0;5,0;41,0;;;;;;;;;;;;;1,0;;;;;;;;2,0;;;;1,0;1,0;;;;;4,0;;;;;;38,0;;;;;1,0;;1,0;2,0;12,0;;;;;3,0;;7,0;4,0;4,0;13,0;1,0;;23,0;;2,0;;2,0;7,0;1,0;3,0;1,0;13,0;;4,0;1,0;7,0;;13,0;;4,0;1,0;;;1,0;;;;12,0;;1,0;8,0;2,0;;1,0;;;4,0;21,0;;;;;;2,0;;1,0;1,0;32,0;5,0;5,0;;;5,0;;5,0;;6,0;4,0;5,0;3,0;3,0;1,0;2,0;1,0;;1,0;;7,0;;4,0;13,0;6,0;;3,0;;;;;2,0;3,0;;;2,0;;;;;;2,0;;;;;;;6,0;;;;;;;;;;4,0;;2,0;13,0;2,0;1,0;2,0;5,0;;;;;;4,0;;;1,0;3,0;;1,0;1,0;1,0;;;2,0;;1,0;6,0;;1,0;;;4,0;;16,0;;;;;;;;;;;;;;;;1,0;;;1,0;2,0;1,0;2,0;4,0;;;6,0;;5,0;;;;2,0;;;2,0;;23,0;7,0;;1,0;;;;3,0;;1,0;3,0;;;;3,0;;;;;;;3,0;;4,0;;;;;;1,0;1,0;;;;;4,0;;;1,0;;;;;3,0;;1,0;8,0;;;2,0;;3,0;;5,0;;;1,0;;;5,0;5,0;;19,0;;;;4,0;;;1,0;;;;1,0;;;;;;4,0;;;;;;;3,0;;;;;16,0;1,0;;;;;;;;;;12,0;4,0;2,0;1,0;4,0;;4,0;;6,0;;2,0;;;;12,0;;;;1,0;;;3,0;8,0;;1,0;;;6,0;;1,0;1,0;;;;;;3,0;3,0;;;;;;;;;;3,0;;;;;1,0;;;;;;;8,0;;1,0;5,0;1,0;;;;;12,0;;;;;2,0;;1,0;;2,0;;;;;;;8,0;;;;;;;3,0;3,0;;2,0;;;;;;;1,0;;;;;;;;;;;;;2,0;;2,0;;;1,0;2,0;;;;;;;;;;;5,0;3,0;;;;3,0;;;;1,0;;;1,0;;;;9,0;;;;1,0;1,0;;1,0;3,0;;;6,0;;;;2,0;;;;;;;2,0;;1,0;;;;;;;;;;;;;3,0;;;;;;;;;1,0;19,0;1,0;3,0;1,0;1,0;1,0;3,0;1,0;5,0;3,0;1,0;3,0;1,0;2,0;3,0;1,0;5,0;6,0;2,0;3,0;1,0;9,0;1,0;6,0;1,0;1,0;2,0;17,0;2,0;4,0;1,0;;;;;;;;;;;;;;;;;;;;;;;;;;;;;;;;;;;;;;;;;;;;;;;;;;;;;;;;;;;;;;;;;;;;;;;;;;;;;;;;;;;;;;;;;;;;;;;;;;;;;;;;;;;;;;;;;;;;;;;
adaptor;;;;2,0;;2,0;;16,0;;;;;;12,0;;;3,0;;1,0;;;;;;;;;;;;11,0;3,0;1,0;;;;;;;;;9,0;;4,0;2,0;6,0;;;;;;;;2,0;;;;;;;;;;;9,0;;15,0;;;;;42,0;;;;;;;;;2,0;;3,0;;14,0;;;14,0;;;;;;1,0;;;;;2,0;1,0;3,0;;;;;;;;;;;;;;;;;;;1,0;;;38,0;;;;38,0;;;;;;;20,0;;;2,0;;;;1,0;;;;;;;;;8,0;;;2,0;;;;;;;;2,0;7,0;;;;;2,0;4,0;;;;;;;;;;;3,0;;;;;;;;2,0;;;1,0;;;;;2,0;;4,0;;;;;;;;;;;;;8,0;;;;;;;3,0;;;;;;;;1,0;2,0;11,0;;;;;;;;1,0;;;;1,0;;;14,0;;1,0;2,0;;;;;;;;;;;1,0;1,0;3,0;;;2,0;;;3,0;1,0;;;;;;;2,0;;;;;1,0;;;;10,0;;4,0;;;;;;;;;;;;;;;;;;;;;;;;5,0;1,0;;;;;;;2,0;;1,0;2,0;;10,0;;;;;;;;;7,0;;;;;;2,0;;;;;;;19,0;4,0;;;;;;;4,0;;;;;1,0;;;;8,0;;;;;;;1,0;;;;;2,0;;;;;;;;;;6,0;;;;;;;;;;;;;;;;;;;;;2,0;;;;;;;;;;;;;3,0;;;;;;;;;;;;6,0;;;;;;;;;;;;1,0;;;;;;;;;;;;;1,0;;;;1,0;;;;;;;;;;;;;;;;1,0;;;;;;;;;;;;;;;1,0;;4,0;;;;;;;;2,0;;;;;;1,0;;;;;;;;;;;;;;;;;;;3,0;;;;;;;;;;;;;;;;;;;;;;;;;;;;;;;;;;1,0;;;25,0;;;;;;;;;;;;;;;;;;;;;;;;;2,0;1,0;;4,0;;;;;;;;;;;;;;;;;;;;;;;;;;;;;;;;;;;;;;;;;;;;;;;;;;;2,0;;;;;;;;2,0;;2,0;;;;;;;;;;;;;;;;;;;;;;;;;;1,0;;;;;;;;;;23,0;;;;;;;;;;;;5,0;;;2,0;;;;;;;;;;;;2,0;;;;;;;;;;;;;;;;;;;;;;1,0;;;;;;;;;3,0;;;6,0;2,0;;;;;;;;;;;;;;;;;;;;;;;;;;;;;;;;;;;;;;;;;;;;;;;;;;;;;;;;;;;;;;;;;;;;;;;;;;;;;;;;;;;;;;;;;;;;;;;;;;;;;;;;;;;;;;;3,0;;;;;;;6,0;;;;;;;;;;;;;;;;;;;;;;;;;;;;;;;;;;;1,0;;;;;;;2,0;;;;;;;;;;;2,0;;;1,0;;;;;;;;;;;;;;;;;;;;;;;;;;;;;;;;;;;;;;;;;;;;;;;;;;;;;;;;;;;;;;;;;;;;;;;;;;;;;;;;
addition;;;;13,0;34,0;8,0;18,0;3,0;;;;1,0;;11,0;;1,0;15,0;1,0;;;;;7,0;;1,0;;4,0;5,0;1,0;1,0;11,0;3,0;;1,0;;44,0;;;4,0;;3,0;33,0;;25,0;38,0;;;1,0;;;;2,0;1,0;1,0;1,0;5,0;4,0;;;4,0;1,0;;;;57,0;1,0;11,0;;;;4,0;9,0;9,0;;;;4,0;3,0;;3,0;15,0;;5,0;;5,0;;;6,0;;;;;;;1,0;;49,0;2,0;8,0;2,0;3,0;6,0;;;6,0;1,0;;;;;;16,0;;;;;;11,0;;8,0;;;54,0;;;1,0;20,0;;;4,0;16,0;11,0;1,0;31,0;1,0;;3,0;;1,0;;;;;;1,0;4,0;11,0;14,0;1,0;;;3,0;;;;5,0;;;2,0;;1,0;;1,0;;2,0;;;;;1,0;8,0;;;1,0;;;;;1,0;;;;;2,0;;;;;1,0;1,0;;;1,0;2,0;1,0;;2,0;1,0;;;;;;;4,0;1,0;3,0;;;1,0;;9,0;3,0;;;;30,0;;;;;3,0;;2,0;;;11,0;;2,0;1,0;;;1,0;;;;;;;;;;;;;4,0;;;26,0;;;;;1,0;;2,0;1,0;1,0;;;3,0;2,0;;2,0;;2,0;;1,0;;;;;;;;;;2,0;;;;;;;;;;3,0;5,0;;1,0;;;;;;7,0;;1,0;;1,0;;;2,0;;;;;;14,0;;;;;4,0;;1,0;;;;1,0;2,0;;;;;;;1,0;;;;1,0;;3,0;;;;1,0;;;;3,0;1,0;1,0;;;;;;;;;;1,0;;1,0;3,0;24,0;;;;;1,0;;7,0;1,0;;;;;;1,0;;3,0;;;;2,0;3,0;13,0;;;;;9,0;4,0;3,0;1,0;;1,0;4,0;1,0;19,0;;6,0;3,0;2,0;5,0;;;8,0;1,0;4,0;;;;1,0;;;;;;;2,0;1,0;;;;;;2,0;;3,0;;1,0;;;;;;;1,0;;1,0;;;26,0;1,0;1,0;;;1,0;;;;;;4,0;;;;2,0;;;;2,0;5,0;;1,0;;;;;;;;;;;;;;;;;;;;;;;;2,0;;;6,0;;;;;;;1,0;;;6,0;;1,0;;;;1,0;;;;;;;;2,0;2,0;1,0;;2,0;4,0;;;;;1,0;;;;;;;;;;;;;;;1,0;;;;1,0;;;;6,0;;;;;;;;;;;;;;;;;;;;;;;;;;;;;;;;;;;;;;;;1,0;;;;;;;;;;;;;;;1,0;;1,0;;;2,0;;;;;1,0;;;;1,0;;;;;3,0;;;;;1,0;;;;;;;;;;;;;;;;;;;;6,0;;;;;;;;;;;;;2,0;;;2,0;;;;;;;;;;;;1,0;;;3,0;;;;3,0;1,0;;;;;;;;;;;;1,0;;;;1,0;;;6,0;;;;;1,0;;;;;;;1,0;;;;;2,0;3,0;;;;;;1,0;;;;;1,0;;1,0;1,0;1,0;1,0;;;;1,0;;;;;;;;;;;;1,0;;;;;;;;;;2,0;;;;;1,0;;;;;;;;;;;;;;;;2,0;;;;;;;;1,0;;;;;;1,0;;;;;;;;;;;3,0;;;;2,0;;2,0;;;;;;1,0;;2,0;;;;;;;;;;;;;;;;1,0;3,0;;;2,0;;;;;4,0;;;;;;1,0;;;;;2,0;;;;;;2,0;;;;;;;;;;;1,0;;;;1,0;;;;;;;;;1,0;;;;;;;;1,0;;;;;;;;;1,0;;;;;;;;;;;;;;;;;;;;;;;;;;;1,0;;;;;;;;;;;;;;;;;;;;;;;1,0;;;;;;;;;;;;;;;;;;;;1,0;1,0;;;;;;;;;;;;;;;;;;;;;;;;;;;;
aerial;;;;3,0;;5,0;;5,0;;;;;;15,0;;;55,0;;;;;;;4,0;11,0;;1,0;;2,0;1,0;47,0;4,0;;1,0;;20,0;4,0;;;;9,0;162,0;;50,0;3,0;30,0;;4,0;;;;1,0;;2,0;2,0;;;;;10,0;;;;;108,0;1,0;12,0;;;7,0;1,0;6,0;;;;;1,0;1,0;;6,0;35,0;;;;;5,0;;;;;2,0;;;;12,0;;;35,0;16,0;3,0;21,0;5,0;;1,0;1,0;20,0;;;;;;;;;;5,0;;8,0;;19,0;;;1,0;8,0;;1,0;152,0;;;;26,0;;;17,0;;;9,0;;;5,0;;2,0;;;;6,0;7,0;;2,0;7,0;1,0;2,0;2,0;6,0;;8,0;;;;;;1,0;;;;;8,0;18,0;;3,0;;;;21,0;;;;;;;;1,0;;;;;;1,0;3,0;;;;;;;1,0;2,0;;;;;;;;10,0;;2,0;;1,0;23,0;8,0;16,0;;;;;;;;1,0;;2,0;;;1,0;;12,0;;5,0;;1,0;;4,0;;;;;;;1,0;;;;;;4,0;1,0;;4,0;;2,0;;;;;6,0;5,0;8,0;1,0;;1,0;2,0;3,0;302,0;;;;1,0;;21,0;;;;1,0;;;;;;;1,0;;;1,0;;;;;;;;1,0;;;;;15,0;;;;;2,0;;;13,0;2,0;1,0;2,0;;13,0;;;;;;;;2,0;;;;7,0;;;;;1,0;;8,0;;;;8,0;;;;;;;;;1,0;;;1,0;;;1,0;;1,0;6,0;;;;6,0;;;5,0;7,0;3,0;;;;4,0;;;;;;;;;1,0;;1,0;;;4,0;;;19,0;;;;;6,0;1,0;;;;;;;;;;;8,0;;;;;;;;3,0;;4,0;;4,0;;2,0;;;1,0;2,0;;1,0;;;;;;;;10,0;8,0;;1,0;1,0;2,0;;;;1,0;2,0;;8,0;;;;;;3,0;;;;19,0;3,0;;;;;;;1,0;;12,0;;;4,0;;;;;;;;1,0;;;;1,0;3,0;;;;;;;;;;1,0;5,0;;4,0;4,0;;;1,0;;;;;;;;;;;;;;;1,0;;;;;;;;;;;;7,0;;;2,0;;;;;;;;;;1,0;;1,0;1,0;1,0;;;;1,0;;;;;6,0;;;;1,0;;;1,0;;;3,0;;;1,0;;;;;6,0;7,0;2,0;;;3,0;;;;;;;;;;;12,0;;;;;;;1,0;;;;;;1,0;;2,0;;;;1,0;;4,0;;;;;1,0;;;;;;;;;;2,0;1,0;;1,0;;;;;;;1,0;;2,0;;;;;;4,0;;4,0;;;;;;;;;;17,0;;1,0;;12,0;;;;;2,0;;;1,0;1,0;;;;;1,0;;;6,0;;9,0;;;;;2,0;;;;;;;3,0;;;;1,0;;;2,0;1,0;;1,0;;;;;4,0;;;;2,0;;;;;;;;;;;;;;;;;;;;;;;;;;;;2,0;;;;;;;;;;;;1,0;;;;;;;;;;;;1,0;;;;;;;;;;;;;;;;;;;;;;;;;;5,0;;;;;;;;;;7,0;1,0;1,0;;;;;;;;;;;2,0;;;;;;;;;;7,0;;;;;;;;;;;;;1,0;;;;;;;;;;;;;;2,0;;;;;;;;;;;;;;3,0;;1,0;;1,0;;;;;;;1,0;;;;;;19,0;2,0;;;3,0;;;;;;;;;;;;1,0;1,0;;;2,0;;;1,0;;;;;;;;;1,0;;;;;;;;;;;;;;;;;;;;;;;;1,0;;;;2,0;;;;3,0;2,0;;;;;;;;;;;;;;;;;;;;;;;;;;;1,0;;;;;;;;;;;;8,0;;;;;;;;;;;;;;;;;;;;;;;;;;;;;
aircraft;;;;4,0;2,0;19,0;;;;;;;;6,0;;;30,0;;;1,0;;;;;8,0;1,0;;;1,0;4,0;13,0;1,0;5,0;1,0;;42,0;;6,0;;;22,0;20,0;2,0;;12,0;1,0;;1,0;;;;;;;7,0;;;;;1,0;;;3,0;;67,0;;17,0;4,0;;;;;10,0;;;;;;;;28,0;;;;6,0;;;;;;;;;;;;;;16,0;6,0;81,0;;;2,0;4,0;2,0;;;;;;10,0;;;;;;;;;;;5,0;;;;41,0;;;;11,0;;;;;;28,0;;;;;3,0;3,0;;3,0;;8,0;5,0;6,0;6,0;;;41,0;;;;;;;;;;;;;;3,0;;;1,0;;2,0;1,0;4,0;;1,0;;;;;;;;;;;;;5,0;;;;;1,0;;18,0;4,0;;2,0;;;;;;1,0;;;;1,0;5,0;;;3,0;2,0;;2,0;;;;;;;;;2,0;4,0;4,0;;;;;;1,0;;;;;;3,0;1,0;;;;;2,0;4,0;;;2,0;;;;;;;;;50,0;;;;1,0;;18,0;4,0;;;;1,0;2,0;;;;;2,0;;1,0;8,0;;;1,0;;1,0;2,0;;;;;;;;;;;;;5,0;;;1,0;1,0;;;1,0;;;;;;1,0;;;;;2,0;;1,0;;;;2,0;;;;3,0;;;;;;;;;;;;;;;;;;;;;7,0;;;;;;;;;2,0;;;;4,0;3,0;;;;;;1,0;;7,0;;;;;4,0;;3,0;2,0;;;5,0;;1,0;4,0;;;15,0;5,0;1,0;4,0;;;;;10,0;;6,0;;;10,0;;;;;;;;16,0;;9,0;19,0;;3,0;;;;5,0;13,0;;9,0;;;;;;;;4,0;;;;9,0;;;;;10,0;;;;;;;;10,0;;;;;;1,0;;;;;;;;1,0;;;8,0;;1,0;;;;;;;;;2,0;4,0;;3,0;;;;;;;1,0;;;;;;1,0;;;;;;;;;;;;;;;2,0;;;;3,0;1,0;;;;;;;;;;;;;;;;;;;;;;;;3,0;;1,0;;3,0;;;2,0;1,0;;;;;;;1,0;;;;;;;;;;1,0;;;;;;;10,0;;;;35,0;;;1,0;5,0;;;;3,0;14,0;;;;2,0;;;;;14,0;;;;;;;;;;;;;;;;;;;5,0;;3,0;;;;;;;;18,0;;;;3,0;2,0;;;;;2,0;;;;;;;;;;6,0;;;;;;;;;;;;;;;;2,0;;7,0;;;1,0;;;;;1,0;;;;2,0;;;;;;;;;;;;;;;9,0;;;;;;;;;;;;;;;;;;;;;;;;;;;;;2,0;;;;;;;;;;2,0;;;;;;;;;;;;;;;;;;;;;;;;;;;;;;;;;;;;;;;;;;;;;;;;;;;;;10,0;;2,0;;;;;;;;;;;;1,0;;;;;;;;;;;;;;;;;;;;;;;;;;;;;;;;;;;;;;;;;;;;;;;;;;;;;;;;;1,0;;;;;;;;;;;;;;;;;;6,0;;;;;;;;;;;;;;;;;;;;;;;;;;;;;;;;;;;;;;;;;;;;;;;;;;;;;;;;;;;;;;;;;;;;;;;;;;;;;;;;;;;6,0;;;;;;;;;;;;1,0;;;;;;;;;;;;;;;;;;;;;;;;;;;;;10,0;;;;;;;;;;;;;;;;
ambient;;;;5,0;16,0;4,0;3,0;6,0;;;;5,0;;36,0;1,0;19,0;51,0;2,0;;;;;19,0;;;1,0;;6,0;;4,0;20,0;3,0;1,0;;;3,0;;;5,0;;36,0;20,0;;1,0;11,0;2,0;;1,0;4,0;;6,0;;1,0;1,0;4,0;;;;1,0;2,0;;;2,0;;17,0;1,0;15,0;3,0;;;;16,0;311,0;1,0;;;1,0;11,0;;;17,0;;9,0;;4,0;;;2,0;;1,0;5,0;1,0;4,0;20,0;;;5,0;;6,0;13,0;1,0;4,0;;1,0;1,0;6,0;;1,0;3,0;;;;;;;;;15,0;17,0;89,0;2,0;15,0;34,0;;1,0;4,0;21,0;;1,0;;10,0;;;;4,0;1,0;2,0;;;;;1,0;;2,0;1,0;4,0;;6,0;4,0;;;8,0;1,0;;;;;;;;;2,0;;;;;;;;4,0;5,0;1,0;10,0;;;;;1,0;1,0;;;1,0;4,0;4,0;;;3,0;;;;;;2,0;;;;7,0;8,0;;;;1,0;;;20,0;;;;2,0;;;;;;;;9,0;;;;1,0;;;;;;10,0;;;;;;2,0;;1,0;4,0;3,0;4,0;;16,0;;;;;1,0;5,0;1,0;2,0;;;;;;;;3,0;;12,0;;;;9,0;3,0;10,0;;;;18,0;4,0;3,0;;;;;;;;;;;;;;;;;;;;;1,0;;;1,0;3,0;;1,0;1,0;;;;;;2,0;;;;;;6,0;;;;;;;;;;;;7,0;1,0;;;;;;1,0;;;;;1,0;19,0;;;;;;;;;;2,0;;1,0;;;;;;;;;;1,0;;4,0;;;;;;4,0;;;;;;;;3,0;;4,0;2,0;;6,0;3,0;1,0;28,0;;;1,0;1,0;65,0;6,0;3,0;;;3,0;1,0;;1,0;4,0;2,0;;;;;;7,0;4,0;31,0;1,0;8,0;;2,0;;;;;;4,0;;10,0;;;;;2,0;;3,0;;;13,0;;12,0;5,0;;7,0;;1,0;3,0;;;;8,0;;;44,0;;4,0;;;;;5,0;;;;;;;;;;;;;2,0;1,0;;3,0;;2,0;;;;;8,0;2,0;2,0;;;;;;;;;;35,0;;2,0;;2,0;;1,0;;;;5,0;;;;;;;;1,0;;;;;;;;;;49,0;7,0;;;4,0;1,0;;1,0;;;;1,0;;;;;;4,0;;;;;;2,0;;;;;;1,0;;2,0;;;;1,0;;;;;6,0;;;;;;;;;;;6,0;1,0;;;;;1,0;1,0;;;;;;2,0;;;;;;;;;;;;;;;4,0;;;;2,0;;;;;7,0;;;;1,0;;;;;1,0;1,0;;;;;;;;;;;1,0;;;22,0;;;;;;;;;;;;;;3,0;;;2,0;;;;;;1,0;;;;;;;;;;;2,0;;1,0;;;;;;4,0;;;;;;27,0;;;;;1,0;;;;;;;;;;;;;;;;;;;;2,0;;;;;;;;;2,0;;;;1,0;;;;;;;15,0;;;;;;;;;;;;;;;1,0;;;;3,0;;;;;;5,0;;;;;4,0;;17,0;;;;;;;;;;;;1,0;;;;;;;;;;;18,0;;;;;;;1,0;3,0;;;;;;;2,0;;;;;;;3,0;;;;;;;;;;;5,0;;;;;;2,0;;;;;;;;;;;;;;;;;;;;;2,0;;;;;;;;;;;;;1,0;;;;;;;;;1,0;3,0;;;;;;;;2,0;;;;;;;1,0;2,0;;;;;;;;;1,0;2,0;;;;;;1,0;;;;;;;;;;;;;1,0;;;;;;;;;;;;;;;;;;;;;;;;;;;;;6,0;1,0;;;;;;;;;;;;;;;;;;;;;;;;;;;;;;;22,0;;;;;;;;;1,0;;;;;;;;;;;;1,0;;;;;;;;;;;;;;;;;;;
amplitude;;;;1,0;20,0;3,0;;;;;;;;24,0;;;;;;2,0;;;;;;;;10,0;;9,0;6,0;2,0;2,0;;;;;;3,0;;16,0;5,0;;;;;;;;4,0;2,0;;;;;;;;15,0;11,0;;;6,0;;;;3,0;8,0;;;2,0;6,0;12,0;;;;;;;1,0;9,0;;;;1,0;;;;;;2,0;;;;2,0;;11,0;;5,0;;6,0;9,0;;;;1,0;;;;;1,0;;;;;;;1,0;;6,0;;1,0;23,0;1,0;;1,0;5,0;1,0;;;9,0;;;;3,0;;1,0;;;1,0;;;;;;1,0;;;1,0;;;;;;;;;;;;;;;;;;;;2,0;;;;;;;;;1,0;;;;;;;;;1,0;;14,0;;;;;;;;;;;;;;;;11,0;;;;;;;4,0;16,0;;;;11,0;;;;;9,0;;;;;;;;;;;23,0;3,0;;;6,0;;;4,0;;;;;;2,0;;;;;;;;;;;1,0;2,0;;1,0;;;2,0;;;;1,0;13,0;;;;;4,0;;;;;1,0;;;;;1,0;;;;;;2,0;;;;;;;;;;;;;;;;;;;;;2,0;;;;;;;;;;;;3,0;;;;;;;;;;;;;;;;;;;1,0;;;;;;;;;;;;;;;;;;;;;;;;;;;;;;;;;5,0;1,0;;;4,0;;;3,0;;3,0;;;5,0;2,0;4,0;;;;;2,0;4,0;;;;2,0;3,0;;;;1,0;1,0;;;;;;;;18,0;;1,0;27,0;;;;3,0;;;6,0;;;;3,0;;;;;;;5,0;;;;;;;;6,0;;;;;;;;;;;3,0;;;;;;;;;;3,0;;;;1,0;;;3,0;;2,0;;;;;;;;;;;;;;;;;;;;;;;;1,0;;;;;;;;;;;;;;;;1,0;1,0;;;;1,0;;;;;;;;;;;;;;;;;;;;;;;;;;;;;;;;;;;;;;;;;;;;;;;;;;;;;;;;;;;;;2,0;1,0;;;;;;;;;;;;1,0;;;;;;;;;;1,0;;;;1,0;;;;;;;;;;;;;;;;;;;3,0;;;1,0;;;;;;;;;;;;;;17,0;;;;;1,0;;;;;;;;;;;;1,0;;9,0;;;1,0;;;;;;;;;4,0;;;;;;;;4,0;;;;;;;;;;;;;;;;;;;;;;;;;3,0;2,0;;;;;;;;;;;2,0;;;;;;;;;;;;;;;;;;;;;;;4,0;;;;;;;6,0;;1,0;;;;;;;;;;;;;;;;;;;;;;;;;;;;;;;1,0;;1,0;;;;;8,0;;;;;;;;;;;;;;;;;;;;;;;;;;;;;;;;20,0;;;;;;;;;;;;;;;;;;;;;;;;;;1,0;;;;;;;;;;;;;;;1,0;;;;;2,0;;3,0;;;;;;;;;;;;;;;;;3,0;;;;;;;;;;;;;;;;;;;;;;;;;;;;;;;;;;;;;;;;;;;;;;;;;;;;;;;;;;;1,0;;;;;;;;;;;;;;;;;;;;10,0;;;3,0;;;;;;;;;;;;;;;;;;;;;;;;;;;;;;;;;;;
analog;;;;2,0;4,0;9,0;11,0;;;;;;;26,0;;;2,0;1,0;3,0;;2,0;;;;7,0;;;1,0;;2,0;103,0;6,0;;;;47,0;;;;;;13,0;;127,0;3,0;3,0;;;;;;;;;;;3,0;;5,0;37,0;;;2,0;;99,0;;24,0;2,0;;;;3,0;14,0;;;4,0;;1,0;;;25,0;;1,0;1,0;1,0;;1,0;3,0;;;10,0;;;;;;83,0;;36,0;3,0;;3,0;;2,0;8,0;24,0;;;;;;36,0;;;;;;9,0;;11,0;;;545,0;;;12,0;14,0;;;;12,0;;;33,0;1,0;;;;;;;1,0;;1,0;1,0;9,0;2,0;;2,0;1,0;11,0;;1,0;;23,0;3,0;;;;;;5,0;;94,0;67,0;;8,0;;;;1,0;1,0;2,0;;;1,0;15,0;;;;;;;;;4,0;3,0;;7,0;;;;;2,0;;9,0;;11,0;;;;1,0;;;1,0;;;;;2,0;;;;;;5,0;80,0;;;;;;;4,0;;;1,0;;;1,0;;2,0;;;;;;;;4,0;;;;;;2,0;;5,0;;;;;;;5,0;1,0;1,0;6,0;;;8,0;18,0;2,0;5,0;;;3,0;;;;;;2,0;2,0;;;;;;;;;;;;;3,0;;67,0;;;;;;;;;1,0;;;;;;;;;;1,0;;8,0;;;;;;;4,0;;1,0;;1,0;;;;;;;;;;;;;;;;;;;;;;;;;;1,0;;;;;;;;;;;;38,0;1,0;;;;;;;;;;;;;;2,0;;;;;15,0;5,0;26,0;;;2,0;;3,0;17,0;;;;;;;;;11,0;;;;;;3,0;5,0;2,0;1,0;;;;;;;;;;;;;;;;;;;28,0;;48,0;;;;;4,0;;1,0;;;;;;1,0;;;1,0;;;;;;;;;;48,0;;;;;;;;;;;5,0;;;1,0;;;;;;;;;;;;;;;;;;;;;3,0;;;;;;;;5,0;;;4,0;;;;15,0;1,0;;;5,0;2,0;;;;1,0;;;;;;;;;2,0;4,0;;;;;;;;;;;;;;6,0;;;;;7,0;;;;;;;;1,0;;;;;;;;;;;;;;;;;;;;;;;;;;;;;;;;;;;;1,0;3,0;;1,0;;;1,0;;;;;;;;;;;;;;;;;;;21,0;;;1,0;;1,0;;;;;;;;;1,0;;;;;;;;;;;;;;;;;5,0;;1,0;;;8,0;;;;;;4,0;;2,0;;4,0;4,0;;1,0;12,0;;2,0;4,0;;;5,0;;;;;;;;;;;;;;;;;;1,0;2,0;4,0;;;;;;;;;;;;;;;;;;;2,0;1,0;;;;;;;;;;8,0;;;;;1,0;;;;;;;;;;;;;;;;5,0;;;2,0;;;;;;;;;;;;;;;;;;;;;;;;;;;;;;;;;;;;;;;;;;;;;;;;;;;;19,0;19,0;;7,0;25,0;;18,0;;;;;;;2,0;4,0;;;2,0;;;6,0;;1,0;;1,0;;;;;;4,0;;;;7,0;;4,0;;;;;12,0;;;;;;;;;;;;;;;2,0;;;;;;;4,0;;;;;;;;;;;;6,0;;;;2,0;;;;;1,0;;;1,0;;;;;;;;;;;;;8,0;;;;;;;;;;1,0;;;;;;;6,0;4,0;;;;;;;;;;;;;;;;;;;4,0;9,0;;;;;;;;;;;;;;;;;;;;;;;;;;;;;;;1,0;;;;;;;;;;;;;;;;;;;;;;;;;;;;;;;;;;;;22,0;;;;
analysis;;;;8,0;8,0;25,0;;1,0;;;;;;157,0;;1,0;90,0;1,0;;7,0;2,0;;8,0;;3,0;;;11,0;1,0;20,0;79,0;6,0;;6,0;;68,0;1,0;3,0;2,0;;91,0;94,0;;3,0;20,0;6,0;;4,0;;;8,0;;;5,0;2,0;;;;4,0;32,0;;;3,0;;483,0;5,0;33,0;;2,0;;;5,0;33,0;;;;;8,0;;1,0;98,0;;;5,0;75,0;;;10,0;;1,0;26,0;;;;3,0;;9,0;3,0;53,0;8,0;24,0;4,0;;6,0;35,0;53,0;2,0;8,0;5,0;;4,0;11,0;17,0;;;;3,0;;25,0;16,0;4,0;;8,0;5,0;4,0;9,0;92,0;;3,0;;7,0;1,0;;47,0;;;5,0;;;;;;12,0;1,0;;11,0;1,0;1,0;5,0;;5,0;5,0;3,0;;;;;;;;;8,0;28,0;;;;9,0;1,0;;48,0;2,0;3,0;7,0;1,0;;4,0;;3,0;2,0;;;;;16,0;;;1,0;;44,0;;;13,0;4,0;;;5,0;;;;;;;2,0;;4,0;3,0;1,0;;;;;1,0;10,0;;;;6,0;;1,0;6,0;27,0;;;;2,0;;21,0;;1,0;1,0;;;12,0;1,0;1,0;12,0;2,0;1,0;;;;3,0;;;;35,0;4,0;3,0;1,0;;;;;6,0;;3,0;4,0;10,0;;;;3,0;5,0;19,0;;;;;1,0;;;;3,0;4,0;;;2,0;5,0;;2,0;;1,0;;1,0;1,0;;;1,0;1,0;;;;;;4,0;;2,0;4,0;;;;;1,0;4,0;;;;5,0;2,0;5,0;;;;;;;3,0;;;27,0;5,0;61,0;;3,0;;;;1,0;4,0;;;;2,0;;8,0;;1,0;;;;;;10,0;;;;4,0;4,0;;;;;16,0;;12,0;;;;81,0;1,0;;;;;;2,0;35,0;;;;;;32,0;1,0;9,0;1,0;1,0;;12,0;;35,0;43,0;;;;30,0;3,0;;;1,0;;5,0;3,0;39,0;;8,0;;12,0;4,0;;;9,0;;12,0;1,0;4,0;10,0;8,0;48,0;;;26,0;;;36,0;14,0;;2,0;;;;13,0;;;;26,0;1,0;14,0;1,0;;;;8,0;10,0;;;4,0;8,0;;;1,0;1,0;5,0;;;4,0;;3,0;17,0;;;;3,0;;;;12,0;10,0;;3,0;11,0;;1,0;1,0;;;2,0;;4,0;1,0;3,0;;4,0;2,0;1,0;;;;;;;;;4,0;1,0;;109,0;2,0;;4,0;;1,0;6,0;;;;2,0;;;;1,0;15,0;3,0;;1,0;4,0;1,0;;;1,0;4,0;;;;1,0;2,0;;;;;;;9,0;;1,0;1,0;1,0;;;;;5,0;;1,0;;;3,0;1,0;;5,0;16,0;;;;;1,0;;;4,0;;;;10,0;;;1,0;;4,0;;;;1,0;;;6,0;3,0;6,0;;1,0;4,0;;;;;;;;;;;8,0;;4,0;;1,0;;;;9,0;6,0;;4,0;1,0;5,0;;;6,0;1,0;;;7,0;3,0;3,0;14,0;1,0;;;;;;;1,0;1,0;;;;;4,0;;;3,0;;;2,0;;;;;;;;;;5,0;;;;;;8,0;;;;;;2,0;1,0;;;1,0;;;1,0;3,0;;;;1,0;3,0;1,0;;;3,0;;;;;;;2,0;10,0;1,0;;;;1,0;1,0;1,0;7,0;;1,0;1,0;;1,0;;1,0;10,0;;;2,0;;;;;;;;1,0;;;;1,0;2,0;1,0;;;;;;1,0;;4,0;;;1,0;4,0;;;;;;;;;1,0;;;;;2,0;1,0;;;;26,0;;;;;;1,0;;;;;;;;;26,0;;;;9,0;;;2,0;;;;;;;;;;;;;;1,0;;7,0;;;;;;;;;;;;;1,0;;1,0;;;;;1,0;;;;2,0;;;;;;;7,0;;1,0;;;1,0;1,0;;;;;;;;;1,0;;;10,0;3,0;;;;;;;;;;5,0;;;4,0;;;;;;;;;;3,0;1,0;;3,0;;;1,0;;8,0;;;1,0;;;;6,0;;7,0;;2,0;;;;;;;15,0;4,0;1,0;4,0;;3,0;;;;1,0;;;;;4,0;;3,0;;;;;;4,0;;;1,0;;1,0;;;3,0;;;4,0;1,0;;3,0;;;;;;;;;;;4,0;;;;;;;;;;;;66,0;3,0;;;2,0;;;;;;;;;;;;;;;;;;;;1,0;;;;;;;;;;;;;2,0;;;;3,0;;;;;;;;;;;;1,0;;;;;;1,0;;;;;4,0;;;;;
apart;;;;1,0;1,0;5,0;12,0;13,0;;;;;11,0;49,0;;;21,0;;8,0;;;2,0;;;;;;1,0;;;27,0;;;1,0;;;14,0;14,0;;;;23,0;;6,0;12,0;70,0;;7,0;;;;;22,0;8,0;6,0;3,0;9,0;;;3,0;;;14,0;;36,0;;48,0;;;6,0;3,0;119,0;14,0;1,0;;;1,0;;;;5,0;1,0;;;37,0;9,0;;33,0;4,0;;;;;3,0;;;14,0;8,0;35,0;4,0;26,0;52,0;5,0;;2,0;3,0;;;;;;;6,0;7,0;;;;6,0;;57,0;;2,0;1,0;;;;13,0;;;4,0;4,0;;;73,0;1,0;;5,0;;;;1,0;7,0;;;7,0;;3,0;18,0;2,0;10,0;;1,0;6,0;21,0;;;7,0;;;;1,0;6,0;;;;;20,0;12,0;;;;;4,0;63,0;;18,0;;;;;;2,0;;29,0;;6,0;;;16,0;13,0;;;1,0;1,0;18,0;15,0;61,0;2,0;25,0;4,0;3,0;2,0;;;;;60,0;1,0;4,0;10,0;11,0;2,0;;5,0;1,0;24,0;;20,0;;;;3,0;;;24,0;6,0;92,0;;;;6,0;;4,0;;7,0;;;;;;;5,0;6,0;3,0;1,0;11,0;6,0;7,0;18,0;;1,0;;;4,0;15,0;1,0;16,0;106,0;2,0;;;;1,0;3,0;4,0;;;;;4,0;6,0;6,0;1,0;1,0;5,0;;8,0;5,0;;;6,0;;30,0;33,0;;;11,0;;25,0;1,0;44,0;;;2,0;2,0;1,0;107,0;1,0;17,0;3,0;;;2,0;;;29,0;;2,0;2,0;1,0;;1,0;3,0;;3,0;2,0;12,0;4,0;;;;;16,0;1,0;1,0;5,0;;;1,0;1,0;26,0;4,0;14,0;12,0;2,0;1,0;2,0;1,0;;;5,0;3,0;;3,0;2,0;5,0;2,0;649,0;;11,0;;;;;7,0;2,0;1,0;37,0;1,0;;;;;;;;;;;;;5,0;;7,0;;;1,0;1,0;;;;;;;;2,0;;;;;;;;1,0;1,0;;5,0;1,0;;;;3,0;;;;4,0;2,0;;1,0;3,0;;9,0;;;1,0;1,0;5,0;4,0;;;;;;;;11,0;;;;;1,0;;4,0;;;5,0;;;;;;2,0;;4,0;;;;;7,0;;;;;;1,0;;;;;;;;;2,0;;;;;;;;;;7,0;1,0;6,0;;3,0;;2,0;46,0;;31,0;;;;;;1,0;;;;;2,0;;;3,0;;;;7,0;;3,0;3,0;;4,0;;;;;;;;;;;;;;;16,0;3,0;;;;;2,0;;4,0;;;1,0;;7,0;6,0;;15,0;;6,0;;;;6,0;7,0;;;;;3,0;;;;;;;;;1,0;;;;;;;;;;;;;;;;6,0;1,0;;;;2,0;;3,0;;;;1,0;;5,0;;;;;;;;;;;;;;;;;;;;;;;;;;;4,0;;;;;;3,0;;;1,0;;;;;;;;3,0;;;;;;;;4,0;;;;1,0;;;;;;;;;;;;8,0;;;;;2,0;;;;;1,0;;;;;;6,0;;2,0;;;;;;;;;;;1,0;;;;;;;;;;;;5,0;;4,0;1,0;;;;;1,0;40,0;9,0;;1,0;4,0;;;;;;;2,0;;;;2,0;;1,0;;;;1,0;9,0;;;;1,0;;;;3,0;;1,0;;3,0;1,0;;;;3,0;;;;4,0;;;11,0;15,0;;1,0;;;1,0;;1,0;;2,0;;1,0;;;1,0;;;;8,0;;;1,0;;;;;4,0;22,0;;;;;;6,0;;1,0;5,0;;;;4,0;;;;;;;;;2,0;2,0;4,0;;;;;;;;;;;;;;1,0;;;;;;;;13,0;;1,0;;;5,0;;;;;;;;;;;;;;;;;;;;;;;2,0;;;;;;;;;;;;;;;;;;;;;;;;;;;;2,0;;;;;;;;;;;;;;;;;;;;;;;;;;;;8,0;;;;;;;;;5,0;;2,0;;;;;;;;;;;;;;3,0;;;;2,0;;;2,0;;;1,0;;;;;;;;10,0;;;;;;;;;1,0;;;;;;;;;;;;1,0;;;;;;;;;;;;;;;;;2,0;;;;1,0;;1,0;;;;
articulate;;;;4,0;;3,0;;18,0;;;;;1,0;19,0;;;24,0;;;;;;;7,0;5,0;;;2,0;2,0;;15,0;;;;;;1,0;1,0;;;2,0;9,0;;;1,0;3,0;;5,0;;;;;6,0;;;;;;;6,0;;;1,0;;43,0;;17,0;;;;;;2,0;;;;;9,0;;;17,0;;;2,0;;;;3,0;;;6,0;;4,0;;;;;;8,0;9,0;16,0;;;;;7,0;;;;;;;;;;;;;;28,0;6,0;;5,0;;;;23,0;;;;3,0;;;9,0;;;17,0;;;;;;;;;5,0;;;9,0;;;;2,0;;;;;;;;;13,0;;;;;14,0;;;;;;;;;5,0;;;;;;;;;;;;;;;;;;;;;2,0;;;;;;;;21,0;;;;;21,0;3,0;6,0;6,0;;;;2,0;;;3,0;;3,0;;;4,0;;133,0;;;3,0;;;1,0;;;;;;;;;;;1,0;3,0;1,0;;4,0;;;;;;;;;12,0;2,0;;;;5,0;;106,0;1,0;;;;;;;7,0;1,0;;;;;24,0;;;;;4,0;;;1,0;1,0;;1,0;;2,0;;;;1,0;20,0;;;;;;;;;;;;;;;;;;;;;1,0;2,0;8,0;5,0;;21,0;;;;;;;;;;;;;;;;;;;;1,0;4,0;;;;8,0;1,0;;;;;;;2,0;;;1,0;1,0;;;15,0;;;;;;10,0;;;;;;;;;;5,0;1,0;3,0;9,0;19,0;;;;;;6,0;;;;;;;;;;;;;;3,0;;;;;;9,0;;5,0;;2,0;;1,0;;5,0;;3,0;;;;;;;;4,0;20,0;;;6,0;;;;;3,0;;;;;;;;;;;1,0;;;;;;;;;;;;;1,0;2,0;;1,0;;;;;;;;;;;2,0;;4,0;2,0;1,0;2,0;;18,0;;;;1,0;;;;;9,0;;;;;;;;;;;;;;;;;;;;;;;;;;;3,0;;;;;;1,0;;;;;;;;;;;;;;2,0;;;;;;;;;;;;;;;;;;;;;;8,0;4,0;;;;;;;;;1,0;1,0;;;;;;;2,0;;;;;;;;;;;;;;;;;;;;;;;;;;;;1,0;;;;;;;;;;;;1,0;;;;;;;;;;;;;;;;;;;;;;6,0;;;;;;5,0;;;;;;;;;;;;;11,0;;;;1,0;;;;;;;;;;;;;;;;;;;;;8,0;;;;;;;;;;;;;;2,0;;;;1,0;;;;;;;;;;;;;;;;;;;;;;;;;;2,0;4,0;;;;;;;;2,0;;;;;;;1,0;1,0;;;;;;;;2,0;;;;;4,0;;;;5,0;;;4,0;;;;;;;;;;;;;8,0;;;;;;;;;;;;;;;;;;;;;;;;;;;;;;;;;;;;;;;;;;;;;;;;;;;;;;;;;;;;;;;;;;;;;;;;;;;;1,0;;;;;;;;;;;26,0;;;;;;;;;;;;;;;;;;;;;;;;;;;;;;;;;;;;;;;2,0;;;;4,0;;;;;;;;;;;;;;;;;;;;;;;;;;;;;;;;;;;;;;;;;;;;;;;;;;;;;;;;;;;;;;;;;;;;;;;;;;;;;;;;;;;;;;;;;;;;;;
aspect;;;;6,0;;19,0;12,0;7,0;;5,0;;;;5,0;;;20,0;;;;;;4,0;;;1,0;;2,0;1,0;;5,0;;;;;14,0;7,0;;2,0;1,0;26,0;23,0;2,0;11,0;17,0;;2,0;3,0;;;;;1,0;;9,0;;3,0;;1,0;1,0;;;;1,0;160,0;;27,0;;1,0;;3,0;17,0;8,0;1,0;;;;2,0;3,0;;68,0;;;2,0;9,0;;;2,0;;;1,0;;;;;;11,0;2,0;3,0;3,0;2,0;5,0;2,0;7,0;8,0;6,0;;;;;;2,0;2,0;1,0;;;3,0;;2,0;20,0;;;5,0;;2,0;2,0;52,0;;;;;;;10,0;;;13,0;2,0;1,0;;;;1,0;;;23,0;4,0;1,0;6,0;;;;4,0;;;;;;2,0;;;1,0;;7,0;;;;1,0;1,0;2,0;7,0;;1,0;;1,0;2,0;;;;2,0;;;;;;;;;11,0;;;;;;;;4,0;;;;;;;;;4,0;;;;;;;;;;1,0;55,0;;;;;;;;;;;;;3,0;;;2,0;324,0;;;;;;6,0;;1,0;;;;2,0;;7,0;;;;;;;;1,0;1,0;3,0;;;;4,0;1,0;8,0;;;;;;;;;;1,0;1,0;;;3,0;;1,0;;;8,0;;;;;;;;;;;;8,0;;2,0;1,0;;;;;;;;;;3,0;16,0;6,0;;;;;1,0;;;;;;1,0;3,0;;1,0;4,0;;;;;;;;;;;1,0;;;;;1,0;;;;;;;;;;;1,0;;;;;;;21,0;3,0;;;;1,0;;;;;;1,0;;;1,0;1,0;2,0;;;3,0;4,0;;27,0;1,0;;9,0;5,0;8,0;1,0;;;;;3,0;;3,0;;1,0;;3,0;;;;23,0;6,0;;8,0;9,0;5,0;;4,0;;;2,0;;;9,0;4,0;;;;;;2,0;;;;6,0;1,0;4,0;3,0;;2,0;;5,0;1,0;2,0;;4,0;8,0;1,0;;1,0;;5,0;2,0;;12,0;;;11,0;;;;;2,0;;;;3,0;;1,0;11,0;;;;;;;3,0;;3,0;;;3,0;;;;;;;;;;;1,0;;2,0;3,0;1,0;1,0;;;;;7,0;;;;;4,0;;1,0;5,0;;6,0;;2,0;1,0;1,0;;;;;;;;;;;;;2,0;2,0;;;;;1,0;;;;;4,0;;;1,0;;;;;1,0;;;;;;1,0;3,0;;;1,0;;;5,0;;1,0;1,0;;;;;;1,0;;;;;2,0;;;;;;;;4,0;;;;;;;;2,0;;;;;3,0;;1,0;1,0;;;;;;;;;;;;;7,0;;5,0;;1,0;;;;;;;1,0;;;;;;1,0;;;3,0;;;;;;;;;1,0;1,0;;;;;;;2,0;;;;;;;;;;;;;;;1,0;4,0;;;8,0;;;;;;;;;;;48,0;;;;;4,0;;;81,0;;;;;;;;;;;;;;;;;;;;;;;;5,0;;;;;;;1,0;1,0;;1,0;;1,0;;;;5,0;3,0;;;;;;;;4,0;;;;;;;;;;;;;;;;;;;;3,0;;;;;;;;;;;;1,0;;;;;;;;;;;;;1,0;;;;;;;;2,0;;;;1,0;2,0;;8,0;;;;;;;;;3,0;;;;;;;;;;;;6,0;;;4,0;;;;;;;1,0;;;;;;;;;;;;;;;;;;1,0;;;;;;;;;;;;1,0;;;1,0;;;2,0;;2,0;3,0;;;;;;;;;;;5,0;;;;;;;;;;5,0;;;1,0;1,0;;;;1,0;2,0;18,0;;2,0;;;;1,0;;;;;;;;3,0;;;;;;1,0;5,0;;;;;;;;;;;;;;;;;;;;;;;;2,0;;1,0;;;;;;;;;;;;1,0;;;;;;2,0;;;;;;;;;;;;;;;;;;;5,0;3,0;;;;;;;;;;;;;;;;3,0;;;;;;;;;;
assign;;;;2,0;3,0;5,0;4,0;;3,0;28,0;;;;49,0;;11,0;18,0;;1,0;3,0;;;32,0;;;;;9,0;3,0;;7,0;9,0;;;;52,0;6,0;;27,0;;8,0;73,0;;1,0;12,0;2,0;;13,0;;4,0;2,0;;;;;11,0;;;2,0;8,0;;;20,0;;186,0;;27,0;;3,0;;7,0;13,0;3,0;;;;2,0;;3,0;8,0;52,0;;1,0;4,0;;;1,0;1,0;;2,0;9,0;;3,0;;;;101,0;14,0;58,0;7,0;27,0;28,0;;7,0;11,0;17,0;;7,0;6,0;3,0;;16,0;32,0;6,0;;36,0;7,0;35,0;2,0;9,0;;;13,0;;;9,0;21,0;;;;11,0;;;17,0;;;2,0;3,0;1,0;;;;;;;;7,0;2,0;12,0;;3,0;6,0;;;;;;;;;;6,0;9,0;;;;3,0;;;;;;;;;2,0;1,0;;;;1,0;;;5,0;;;9,0;;12,0;;18,0;;;;;;;;;;;;;;;3,0;;;;;;5,0;;;;;6,0;;;;11,0;3,0;1,0;;;;14,0;;;2,0;;;9,0;1,0;;1,0;;;;1,0;;;;;;24,0;;3,0;2,0;;;;;;;2,0;1,0;5,0;4,0;;2,0;;;4,0;;;;;18,0;1,0;;;;;;;1,0;15,0;;;;;2,0;;8,0;;;;2,0;;;;;;;;1,0;;;;;;;3,0;;;1,0;;5,0;4,0;;;;;1,0;;;;;;16,0;58,0;;6,0;;;;;;;;;;;20,0;;;;;3,0;;;;;3,0;;12,0;;;;;;2,0;;6,0;;;;14,0;;;;;;;;4,0;;;7,0;;;3,0;6,0;2,0;2,0;;6,0;10,0;;26,0;9,0;;3,0;;1,0;2,0;1,0;;;7,0;2,0;3,0;;3,0;15,0;;22,0;;;;15,0;;13,0;;10,0;;2,0;3,0;;;;;1,0;16,0;;1,0;;;;;;;6,0;3,0;10,0;;1,0;1,0;;;4,0;3,0;2,0;;;4,0;7,0;29,0;1,0;;1,0;15,0;4,0;;2,0;;;39,0;;;1,0;;;;;;7,0;;;7,0;;;;;;;;;;4,0;3,0;4,0;10,0;;;;;8,0;;;;;12,0;3,0;;9,0;1,0;1,0;;1,0;;;2,0;;;;1,0;;;7,0;;;3,0;5,0;;4,0;1,0;3,0;;8,0;;;;1,0;;;;;;;;;;8,0;;;;;;;;;;;3,0;;;1,0;6,0;2,0;;;;;7,0;;1,0;;;;;;;10,0;;;1,0;;;;5,0;;;;;1,0;1,0;;1,0;;;3,0;;3,0;;;1,0;;;1,0;;;;;;;3,0;4,0;;;;;13,0;;2,0;;;;;1,0;;1,0;44,0;;3,0;;;;;;;;;;;4,0;3,0;41,0;;;;4,0;3,0;1,0;1,0;;;3,0;4,0;;1,0;;13,0;;2,0;;;;;;;;;;;40,0;;1,0;;;;4,0;;;2,0;4,0;;;;;1,0;;7,0;1,0;;;26,0;;;;;;;;6,0;;;;1,0;2,0;;;1,0;;;;;;1,0;;;;;;4,0;;;;;;9,0;;;;;;;;6,0;;;;2,0;;;;;;;;;;;1,0;1,0;;;1,0;6,0;;;;;2,0;1,0;;;;;2,0;;;;;;;;;;;;;;;;;;;;;;;;;;;;;;;;2,0;;;;;;;;;;;1,0;;;;;;;;;1,0;;;;;;2,0;;;;;3,0;;8,0;;;;1,0;1,0;;;;;;;;;;;;;;;;;;;;;;;;;15,0;;;;;;;3,0;;6,0;;;;;;;;;;;;;;5,0;;14,0;;;;;;;;;1,0;;2,0;;;;;;;;;;;;;;2,0;;7,0;;;;;;;;;;;;;;;;;2,0;;;;;;;;;;;;;;;;;;;;2,0;9,0;;;;;1,0;6,0;;3,0;;;;;;;;;1,0;;;;;;;;3,0;;;;1,0;;;;;;;6,0;;;4,0;;;;;;6,0;;;;;;;;;;6,0;;;;;24,0;;;2,0;;;;;4,0;;;;;;
assist;;;;1,0;;;;2,0;;;;;;18,0;;;3,0;4,0;1,0;;;;1,0;;;;3,0;;3,0;;19,0;5,0;;2,0;;9,0;;;6,0;1,0;10,0;42,0;;;10,0;1,0;1,0;10,0;;;;;2,0;;6,0;;18,0;;;20,0;;;;;31,0;2,0;;;;;1,0;4,0;1,0;;;;;4,0;;;20,0;;;;6,0;;;;;;1,0;;;2,0;3,0;;;;4,0;3,0;10,0;;;4,0;;;1,0;1,0;;;;1,0;1,0;;1,0;;;;20,0;2,0;;;;2,0;;;43,0;;;;;;;7,0;;;5,0;;;;;3,0;;;3,0;2,0;2,0;8,0;8,0;3,0;8,0;;5,0;;;;;;;;;1,0;1,0;;;;4,0;3,0;;4,0;;;;1,0;;1,0;;;;;;10,0;;;;;3,0;4,0;5,0;1,0;1,0;;3,0;;;;;;;;;;;;;;2,0;;;4,0;;2,0;;;;;3,0;;;;3,0;;;;1,0;;3,0;;1,0;;;;;;;;;;;;;9,0;1,0;;1,0;6,0;;1,0;;;;2,0;;8,0;;;1,0;;6,0;;;;;46,0;;2,0;;;;;;;;4,0;;;;7,0;;2,0;1,0;;;;;;;;;;1,0;;;;;;6,0;17,0;;;;;;3,0;;;3,0;;;4,0;;1,0;1,0;;;;2,0;10,0;1,0;;;29,0;;;;2,0;;;;;;;;;;;;;;;1,0;2,0;2,0;;;;7,0;;;1,0;;;;;7,0;;2,0;;43,0;;;;;;;;;;;;;;5,0;;14,0;;;1,0;;;6,0;3,0;;;;3,0;;;;;;1,0;;8,0;;6,0;;1,0;;;2,0;;;;;5,0;;1,0;3,0;;;1,0;;;1,0;3,0;;;;;;;;;;;1,0;;;;;;;;;1,0;;;;;;;;;;;;;21,0;;;;;;;;;22,0;;12,0;;1,0;;;;4,0;;8,0;1,0;;;;;10,0;;1,0;;;;;2,0;;;;4,0;;2,0;1,0;1,0;1,0;;;1,0;;;;7,0;1,0;;;4,0;;;;;2,0;2,0;;;;;;;;;1,0;2,0;1,0;;;;6,0;;;;;1,0;;;;1,0;;;13,0;2,0;;;;;;;;;5,0;3,0;;;;;;;;;;2,0;;;;;;;;;;6,0;;3,0;;;;;;;;4,0;5,0;;;;;;;1,0;;;;;;;;;;;;;;;;7,0;;;;;;;;;;;;4,0;;;;;;;;;;;;;5,0;;;;;;;;;;;;;2,0;;;;;;;;;;;2,0;;;;;1,0;;;1,0;3,0;;;;;;;;4,0;;;;;;;;;;1,0;;;;7,0;;;1,0;1,0;;;;1,0;;;;;;;;;1,0;;;;;;;;2,0;;;;;;;;;;;;;;;;;;;;;;;;;;;;;;;5,0;;;4,0;;;;1,0;;;;2,0;;;;;3,0;;;;;;;;;;;;;;;;;;8,0;;;;;1,0;;;;;2,0;;;;;;;;;1,0;;;;;;;;;;;;;;;;;;;;;;;;;;;;;;;;;;;;;;;;;;;4,0;;1,0;;;;;;;;;;7,0;;;;;;;;;;;;;;3,0;;;;;;2,0;;;;;;;;;;;;;;8,0;;;;1,0;;3,0;;;;;;;;4,0;;;;;;1,0;;2,0;3,0;;;;;;;;;;;;4,0;;;;;;;;;;;;;;;;;;;;;;;;;;;;1,0;;;;;;;;;;;;1,0;;;;;;;;;;;;;;;;;;32,0;;4,0;2,0;;;;;;;;;;;1,0;;;;;;;;;;;;;;;;
auto;;;;8,0;;15,0;1,0;3,0;;;;;;1,0;;3,0;3,0;;;1,0;;;5,0;;;1,0;3,0;4,0;1,0;;25,0;3,0;4,0;3,0;;9,0;;;2,0;;8,0;12,0;1,0;5,0;4,0;8,0;;1,0;;;;;;;;;8,0;;;5,0;;;6,0;;39,0;1,0;35,0;1,0;;;;73,0;12,0;;;;3,0;;;11,0;35,0;;28,0;;81,0;70,0;;15,0;;;9,0;;;;;;5,0;;9,0;;20,0;2,0;;2,0;2,0;5,0;;1,0;;;;4,0;10,0;;;;;;;21,0;3,0;;6,0;1,0;;7,0;8,0;;;;;;;38,0;;;;;39,0;;;;1,0;;;1,0;;1,0;1,0;3,0;;;2,0;2,0;;;;;;;;6,0;;;;;4,0;;1,0;20,0;1,0;;;12,0;;;;1,0;3,0;;;;;11,0;;;18,0;5,0;8,0;;1,0;1,0;;;2,0;1,0;7,0;;;;;20,0;3,0;;;;7,0;;;5,0;9,0;7,0;;;;;2,0;;;;;;1,0;;;;2,0;;;;;;12,0;;;;1,0;;;2,0;;;;;;3,0;;;2,0;;;;2,0;;;2,0;9,0;2,0;;;;;4,0;;;;;;;2,0;;1,0;24,0;;;;;;;2,0;;1,0;9,0;1,0;;;;;1,0;;9,0;3,0;;;;;2,0;5,0;4,0;;;;;;;;;;;3,0;;;;;;;;;;;2,0;5,0;;;;;1,0;;3,0;;;;;;1,0;;;;;;;;;;;;;3,0;;4,0;;;;;2,0;;;1,0;5,0;;;;;;;3,0;2,0;;;13,0;;;1,0;;;;;4,0;2,0;;20,0;;;1,0;;3,0;;3,0;;8,0;;;3,0;308,0;1,0;29,0;;2,0;;;;2,0;;8,0;;3,0;1,0;;12,0;2,0;;12,0;;;14,0;;;;4,0;;;;;5,0;;5,0;;1,0;;;2,0;;10,0;;;;1,0;;6,0;11,0;;11,0;6,0;3,0;;2,0;;;3,0;;;;;;;;;24,0;;;;;;;;;;;;;;;;;;;;;;;13,0;;;3,0;;;31,0;;1,0;;;;;;1,0;;2,0;;;;;;;5,0;;;;;;;;;;;;;;;;;;;;;;;;;;;;;;;;;1,0;;;1,0;;;;;;;;;;3,0;;;;;;4,0;;;;;;;;;;;;;;;;;2,0;;1,0;2,0;;26,0;;;49,0;;2,0;;;;;;15,0;;;;;;;;;;;;;;1,0;13,0;;;;28,0;11,0;;;;;;;;;;;;;;;3,0;;;;;;;;;;;;;;3,0;;1,0;3,0;;;;;2,0;;;;1,0;;1,0;;;;;;;;;;;;2,0;1,0;1,0;;;;;;;;25,0;;;;3,0;3,0;;;;;;1,0;;2,0;;1,0;1,0;;;;;;2,0;;;;;;;5,0;1,0;21,0;;;;;5,0;;;;;;;;;;;;;;;;;;;;;;;;;4,0;;;;;;;;;;;;;;;;;;;;;;;;;;;;;;;;;;;;;;;;;;;;;;;;;1,0;;;;;;;;;;;;;;;;;;;;42,0;;;;;;;;;;;;1,0;;3,0;2,0;;;;;;;;;;;;;;24,0;;;;;1,0;;2,0;;;2,0;;;;;;;;;;;;;;;;;;;;;;;;;;;;;;;3,0;;;;3,0;;;;;;;;;;;;;;;;;;;3,0;;;;;;;;;;;;;;;;;;;;;;;;;;;;;;;1,0;;;;;;;;1,0;1,0;;;;1,0;;;;;;;;;;4,0;;;;;;;;;;;;;;;;;;;;;;;;;;;;;;;;;;;;;;;;;;;;;;;;;
automatic;;;;5,0;1,0;48,0;;12,0;;;2,0;;4,0;15,0;;19,0;19,0;;1,0;1,0;;;3,0;;4,0;;9,0;;3,0;3,0;35,0;16,0;3,0;28,0;;5,0;3,0;;2,0;;11,0;89,0;;7,0;14,0;7,0;;1,0;;1,0;4,0;;;2,0;4,0;;1,0;;;1,0;;;;;75,0;3,0;33,0;1,0;;;;39,0;6,0;;;;;;2,0;2,0;119,0;;44,0;;22,0;;;8,0;;;19,0;1,0;1,0;;8,0;;2,0;8,0;11,0;8,0;15,0;5,0;;13,0;13,0;10,0;;7,0;;;1,0;7,0;;3,0;;;;;7,0;7,0;2,0;;8,0;5,0;;5,0;52,0;;;;11,0;;1,0;38,0;;2,0;12,0;2,0;2,0;;;;;;4,0;3,0;5,0;1,0;1,0;2,0;;1,0;6,0;;2,0;;;;;;;3,0;20,0;1,0;;;2,0;2,0;;7,0;3,0;;;9,0;;3,0;;1,0;20,0;;;;;6,0;;;;;2,0;1,0;;1,0;;;;2,0;1,0;;;;;;;;;2,0;17,0;;1,0;5,0;9,0;4,0;;;;;8,0;;;1,0;20,0;2,0;;;1,0;;1,0;1,0;;;1,0;;17,0;;1,0;;;;;;;;1,0;;;7,0;;5,0;3,0;;;;1,0;1,0;;;2,0;1,0;1,0;;;5,0;;16,0;;;;;;1,0;;;8,0;2,0;;;1,0;5,0;;;;3,0;8,0;;;;5,0;5,0;;;2,0;5,0;;;;1,0;3,0;7,0;1,0;1,0;;;;;2,0;;;3,0;2,0;6,0;;;;;;;;;;3,0;12,0;9,0;2,0;1,0;1,0;;;;3,0;;;;;;2,0;;7,0;;;;4,0;3,0;6,0;;;;2,0;2,0;;;;;;;28,0;;7,0;2,0;18,0;4,0;3,0;2,0;;;4,0;117,0;;;;;;3,0;;;4,0;2,0;;5,0;;1,0;91,0;1,0;;2,0;1,0;4,0;2,0;;2,0;2,0;;5,0;3,0;104,0;5,0;26,0;1,0;2,0;1,0;;;6,0;1,0;;;1,0;;4,0;1,0;3,0;;11,0;;1,0;13,0;5,0;;;;;;;3,0;1,0;;20,0;1,0;36,0;2,0;2,0;;1,0;5,0;3,0;9,0;;6,0;6,0;7,0;;;8,0;2,0;;;2,0;;;5,0;4,0;;2,0;18,0;3,0;24,0;;;24,0;;;4,0;2,0;;;;;1,0;;;;4,0;;4,0;3,0;;;2,0;;;;5,0;;2,0;;;;40,0;;2,0;;;;;1,0;;;3,0;;;15,0;;;;1,0;;3,0;2,0;1,0;;7,0;;;10,0;;;;22,0;7,0;;;10,0;;;1,0;;;;;;;2,0;;;;1,0;;;;;5,0;;4,0;3,0;6,0;;3,0;;;;1,0;;;2,0;;1,0;25,0;;;;1,0;;1,0;1,0;;;;1,0;;1,0;;;;;;;;;;1,0;;15,0;2,0;2,0;;;;;;;;;;;30,0;6,0;;1,0;;;2,0;;;;7,0;;;;5,0;29,0;;2,0;1,0;1,0;;;;5,0;1,0;;1,0;4,0;2,0;3,0;;2,0;;;;;;2,0;;;8,0;;;8,0;;2,0;;;4,0;;12,0;4,0;;;;2,0;;;;;;;1,0;;2,0;1,0;;;3,0;;;3,0;;;;;;4,0;;;4,0;;;3,0;;5,0;;;;;;;3,0;;;;;;;;;;1,0;;;;2,0;2,0;;;7,0;21,0;;;;;;;1,0;;1,0;;1,0;;;;3,0;2,0;;;;;1,0;1,0;;17,0;2,0;;;;;2,0;;;2,0;;;;;;;3,0;;;;;13,0;;;;;;;;;;;1,0;;;;;;;;;;14,0;2,0;;;;;;;;;;;;;;;2,0;;1,0;;;;;;;;;;3,0;;;;;45,0;2,0;;;;;;;1,0;;;;;;3,0;;;;3,0;;;;;;;1,0;;;;5,0;;;;;3,0;;;;;4,0;;;2,0;;2,0;10,0;;;;;;;;1,0;1,0;;1,0;;;;;;;;;;;;;;1,0;3,0;;;;;;;;;1,0;;;;;;;;;;;;1,0;1,0;;1,0;3,0;2,0;;;13,0;1,0;1,0;;;1,0;;;;;;;;;;;;;;;;;;;;;;;;;;;;;;;1,0;;;;;;;;;;1,0;;;;;;;;;;;;1,0;;;;;;1,0;;;;;;;;;;;;;;;;;;;;;;;;;;;;;;;;
average;;;;10,0;24,0;12,0;15,0;;;;1,0;;;89,0;13,0;34,0;11,0;5,0;9,0;2,0;;;32,0;;;;;22,0;1,0;12,0;21,0;6,0;3,0;5,0;;49,0;7,0;2,0;43,0;;132,0;23,0;4,0;6,0;2,0;;2,0;17,0;;11,0;13,0;;;;;6,0;3,0;;;23,0;1,0;18,0;3,0;;177,0;1,0;12,0;4,0;13,0;;3,0;21,0;23,0;;;10,0;3,0;3,0;;;67,0;;12,0;;4,0;1,0;;14,0;;4,0;16,0;2,0;16,0;3,0;;;334,0;9,0;42,0;12,0;12,0;37,0;;5,0;15,0;18,0;;9,0;;;1,0;28,0;31,0;;;13,0;4,0;30,0;4,0;6,0;16,0;;112,0;13,0;;8,0;29,0;;;3,0;38,0;12,0;;33,0;1,0;;5,0;1,0;;;;11,0;;1,0;;12,0;20,0;;11,0;;;48,0;1,0;;;4,0;;1,0;;4,0;2,0;9,0;;2,0;;;;;4,0;;3,0;12,0;;5,0;;2,0;;;;;;;;2,0;;;21,0;;57,0;1,0;;;;;;;1,0;2,0;;;;1,0;;;9,0;2,0;;;7,0;2,0;;5,0;1,0;;;;17,0;3,0;2,0;2,0;;6,0;;;1,0;;10,0;;;4,0;;;5,0;25,0;;;;;;13,0;;;;;;14,0;;;;;;;;3,0;;;;10,0;;;;;3,0;7,0;;;;6,0;10,0;8,0;;;;2,0;;;;9,0;;;;;13,0;2,0;13,0;;;;25,0;;4,0;8,0;;;;;16,0;8,0;;;;;;;;;;;26,0;2,0;;;;;5,0;;19,0;;;;9,0;18,0;;;;;;;7,0;;;;;;;;;;;;;5,0;;;;;2,0;;;;;;3,0;;1,0;;;2,0;13,0;2,0;15,0;;;;;6,0;3,0;11,0;;;;;135,0;3,0;13,0;3,0;2,0;1,0;9,0;6,0;5,0;59,0;3,0;;1,0;32,0;1,0;71,0;;;11,0;11,0;;3,0;;17,0;1,0;3,0;4,0;4,0;;;9,0;83,0;;14,0;;;5,0;1,0;;7,0;7,0;1,0;6,0;7,0;4,0;;;;2,0;38,0;1,0;;;7,0;;12,0;14,0;3,0;1,0;;10,0;;7,0;1,0;8,0;3,0;;;7,0;;28,0;;12,0;7,0;;3,0;10,0;17,0;;;;;;;22,0;3,0;;9,0;42,0;;5,0;6,0;;7,0;;;1,0;;2,0;1,0;3,0;;;;3,0;2,0;1,0;;;;;1,0;1,0;;14,0;2,0;;1,0;3,0;;;;;;;;;;;;;;1,0;12,0;;;2,0;;23,0;;;;;;;1,0;;;;3,0;;;;;;1,0;;;;;;;9,0;;3,0;;;13,0;;5,0;;;;;;4,0;1,0;;;2,0;2,0;;;1,0;;3,0;;49,0;12,0;;;1,0;18,0;;;;4,0;;;;;;;;7,0;;;;4,0;;;;;;1,0;1,0;2,0;3,0;;1,0;4,0;8,0;;;;;1,0;;5,0;;;5,0;;;;;2,0;;;;7,0;3,0;;;;;;;;;106,0;6,0;;;;3,0;;;;;;;;;;;;;;;1,0;;;2,0;;;;;;2,0;4,0;;9,0;1,0;;;6,0;5,0;;1,0;;;;;;;;;4,0;;;;3,0;4,0;;7,0;20,0;;;;;9,0;1,0;;;;;;;;;;;;;;;;;;5,0;;1,0;;;;;3,0;;;;;2,0;;;;1,0;6,0;;;;;3,0;;;;6,0;1,0;;;;;4,0;;;;1,0;2,0;1,0;;;;;2,0;;;;;;;;;;;;;1,0;2,0;;;;;;;;;;;5,0;;8,0;;;;;;;;6,0;;;;;6,0;;6,0;;;;;7,0;;;;;;;;;;;24,0;;7,0;;;3,0;3,0;;42,0;;;1,0;;;12,0;;;;2,0;11,0;;2,0;1,0;1,0;6,0;2,0;;;;4,0;;8,0;11,0;1,0;;;;;;1,0;1,0;2,0;;;2,0;;;;;1,0;;;;;;;;;1,0;;;5,0;2,0;;;;;3,0;3,0;8,0;;1,0;2,0;;;;;1,0;2,0;;;;;;;;2,0;1,0;;;;;;;1,0;;;;3,0;3,0;;;;;;;2,0;;;;;;;;;;;;;;;;;6,0;1,0;;;;3,0;;;;;;;;;;;;;;;;3,0;;;;;;;;3,0;;;;14,0;;;1,0;;;;;;;;;3,0;;;;;;1,0;;;;;;;;16,0;;;9,0;;1,0;;;2,0;;;;;;
basis;;;;30,0;15,0;24,0;2,0;;;;;8,0;;20,0;;3,0;41,0;;;2,0;;;19,0;4,0;4,0;3,0;11,0;1,0;1,0;7,0;9,0;6,0;19,0;35,0;;50,0;7,0;1,0;7,0;;68,0;29,0;;26,0;23,0;3,0;2,0;2,0;;;6,0;;;10,0;2,0;4,0;4,0;;3,0;42,0;;;8,0;14,0;233,0;6,0;16,0;;3,0;1,0;1,0;43,0;24,0;;1,0;;2,0;11,0;1,0;10,0;35,0;;17,0;10,0;2,0;3,0;1,0;53,0;;8,0;31,0;;;;1,0;11,0;47,0;4,0;40,0;14,0;90,0;15,0;;21,0;3,0;3,0;7,0;;3,0;;;29,0;12,0;;;;1,0;1,0;14,0;77,0;;3,0;72,0;6,0;7,0;4,0;35,0;;1,0;11,0;43,0;;;26,0;;;6,0;3,0;;;;;;;;1,0;33,0;1,0;4,0;;;2,0;2,0;;2,0;2,0;;;;;;3,0;;;;4,0;;;;37,0;2,0;12,0;1,0;44,0;;;;2,0;;;4,0;;;1,0;;;3,0;;28,0;;1,0;1,0;;;;1,0;1,0;14,0;;;;;1,0;;16,0;2,0;3,0;;;;6,0;12,0;2,0;;;;15,0;6,0;;4,0;1,0;4,0;;1,0;;;5,0;;;3,0;;6,0;22,0;7,0;;4,0;4,0;;;2,0;;;;;;25,0;;10,0;8,0;;;;;1,0;;1,0;3,0;13,0;;16,0;;3,0;;29,0;;;16,0;2,0;2,0;4,0;;;1,0;1,0;;;1,0;19,0;;;;2,0;1,0;1,0;;;2,0;2,0;3,0;;1,0;;;;3,0;;14,0;1,0;;;;;;1,0;;;;;5,0;23,0;;;;;2,0;;;;;6,0;1,0;36,0;;4,0;;;5,0;;3,0;1,0;;;;;7,0;;;;;;1,0;14,0;;;1,0;;;6,0;;;;;;;4,0;;1,0;;7,0;;;;;1,0;12,0;4,0;2,0;;;;;1,0;30,0;5,0;9,0;;1,0;2,0;29,0;8,0;34,0;21,0;1,0;27,0;;17,0;12,0;8,0;;;;1,0;9,0;;3,0;26,0;;4,0;5,0;;;3,0;10,0;3,0;;3,0;;1,0;10,0;1,0;;5,0;;2,0;8,0;18,0;4,0;5,0;1,0;;;11,0;;16,0;;11,0;;;4,0;1,0;6,0;1,0;23,0;;9,0;;;22,0;5,0;;;8,0;10,0;;;;1,0;;2,0;;1,0;13,0;;;;;;5,0;9,0;;11,0;;19,0;5,0;;;1,0;;;;;8,0;;;;;1,0;;5,0;2,0;;2,0;;3,0;;;17,0;4,0;;1,0;17,0;;2,0;1,0;;;2,0;;;;;4,0;;2,0;4,0;6,0;;;;1,0;;7,0;;;;;;2,0;;;;;;;1,0;;;;;;;;;3,0;4,0;;;;;1,0;;;;;;;;3,0;;1,0;;;8,0;;;2,0;;1,0;;;;6,0;;;3,0;;2,0;;;3,0;;;19,0;1,0;;4,0;3,0;1,0;;;1,0;;;;1,0;;;;1,0;5,0;;;;7,0;;;;;13,0;;;;;12,0;;1,0;;;11,0;;5,0;;;4,0;;;;;1,0;;;;4,0;5,0;;;;;;;;;;;;;7,0;;3,0;7,0;;1,0;;;;3,0;1,0;;;1,0;;1,0;;;3,0;;;1,0;2,0;4,0;;;1,0;2,0;2,0;;3,0;;;1,0;3,0;;4,0;14,0;;;;3,0;32,0;;;2,0;;19,0;1,0;;;;;;;;2,0;;;;;;;;;;4,0;4,0;3,0;;;;;3,0;;;;;;2,0;;;2,0;1,0;;1,0;;;;;;;3,0;;;1,0;;;6,0;3,0;;;8,0;;5,0;;3,0;;;2,0;;;1,0;;;;;;;;;;;;;;;;;5,0;;;;;;;6,0;;;;;;;;1,0;;;1,0;;;3,0;;2,0;;5,0;2,0;;;;;;2,0;18,0;;;;;9,0;;;;2,0;2,0;1,0;;2,0;;4,0;;;1,0;28,0;;;;10,0;;4,0;4,0;4,0;;;8,0;;;;2,0;;;;3,0;1,0;;2,0;;;;;8,0;;;;;;;4,0;;;6,0;;9,0;;;;;;;;;4,0;;;;;1,0;1,0;1,0;3,0;1,0;;;1,0;;;;1,0;;;;1,0;;;7,0;;;;;1,0;;;;;;;;3,0;;;2,0;;;;;1,0;;;;;;;;;1,0;1,0;2,0;;;;;;;;7,0;;;;;1,0;;;;;;;;;16,0;;;;;;;;1,0;;;;2,0;;;;;2,0;;2,0;;;;;;1,0;2,0;;;;;;;;;;;;;;;;;;;;18,0;;;;;2,0;;;;2,0;;16,0
bias;;;;5,0;2,0;22,0;1,0;17,0;;;4,0;;6,0;35,0;;;3,0;;3,0;;;;;;;;9,0;7,0;;;50,0;7,0;2,0;4,0;;3,0;4,0;;;;20,0;69,0;1,0;;;12,0;;68,0;1,0;2,0;6,0;;6,0;1,0;1,0;2,0;9,0;;3,0;13,0;;1,0;2,0;;26,0;;91,0;1,0;;11,0;;45,0;6,0;;;1,0;1,0;;;;18,0;;2,0;;3,0;14,0;;38,0;;4,0;1,0;;2,0;;2,0;;22,0;3,0;7,0;8,0;94,0;8,0;;3,0;3,0;2,0;;;;;;7,0;33,0;;;;;5,0;;13,0;;;34,0;;;;25,0;;;;32,0;;;36,0;;;1,0;;;6,0;2,0;;1,0;;15,0;68,0;;7,0;;4,0;;3,0;14,0;1,0;2,0;3,0;1,0;;1,0;;1,0;21,0;;;;;5,0;1,0;;;;;8,0;67,0;;2,0;1,0;;;1,0;;4,0;1,0;12,0;;;1,0;115,0;31,0;2,0;;;;23,0;11,0;;24,0;;2,0;;;;7,0;17,0;5,0;7,0;210,0;;5,0;25,0;22,0;12,0;16,0;;;;27,0;;;4,0;;2,0;;;3,0;;53,0;2,0;1,0;;4,0;8,0;2,0;;5,0;;;;;4,0;;11,0;15,0;1,0;1,0;2,0;;6,0;12,0;9,0;;;;31,0;;17,0;69,0;32,0;;;;1,0;;4,0;6,0;;5,0;;3,0;;;1,0;36,0;1,0;2,0;;2,0;7,0;;30,0;;;42,0;;;;;2,0;24,0;;8,0;7,0;4,0;;;2,0;1,0;;4,0;19,0;;;8,0;7,0;;3,0;1,0;5,0;;13,0;2,0;;4,0;;;3,0;1,0;11,0;;80,0;;3,0;8,0;;1,0;;;2,0;2,0;;;;1,0;6,0;;1,0;6,0;3,0;2,0;;34,0;18,0;34,0;8,0;;;2,0;5,0;;240,0;;1,0;3,0;;;1,0;;;2,0;;;3,0;1,0;;;6,0;;2,0;;;6,0;2,0;4,0;7,0;;;;1,0;;1,0;58,0;1,0;;;1,0;6,0;1,0;22,0;;;;;;;7,0;15,0;;;6,0;;1,0;3,0;;1,0;16,0;4,0;;;2,0;2,0;;6,0;;5,0;8,0;25,0;23,0;;;;;;;7,0;;4,0;;4,0;56,0;;1,0;;75,0;;;;2,0;;6,0;;4,0;4,0;10,0;2,0;;1,0;;;1,0;2,0;;96,0;;;8,0;;;;;;;;;;;;;;2,0;;;;;;3,0;2,0;;2,0;1,0;;21,0;;;;;34,0;;;1,0;;;;;;;;1,0;;;;;1,0;2,0;;;5,0;;;;3,0;;;;;1,0;;3,0;9,0;;;4,0;16,0;;;;;1,0;;4,0;;;;;7,0;1,0;;32,0;;4,0;;;3,0;;15,0;;24,0;;;;;2,0;;;;;3,0;5,0;;;;;;1,0;;;;;;;;;;;;;;;5,0;6,0;;;;;1,0;;3,0;50,0;;;;;;;;2,0;;;;;;;1,0;;16,0;1,0;;2,0;;;4,0;1,0;5,0;;2,0;;14,0;;;;;;;;;;;;;;1,0;1,0;;;;;;;3,0;;;;;;;;;;;;;;;;7,0;;;;;12,0;16,0;;;;;13,0;;;;1,0;;5,0;;1,0;1,0;;;;;6,0;;;;;1,0;;1,0;;;;;;2,0;1,0;;;12,0;1,0;;;;;;;50,0;27,0;1,0;14,0;;;;;;;1,0;10,0;;;;1,0;6,0;;;;;;1,0;14,0;;;;;;1,0;1,0;17,0;;;4,0;2,0;2,0;1,0;;;1,0;;;;;;;5,0;;3,0;;;;;23,0;;;2,0;;;1,0;;;;;;;;9,0;1,0;;2,0;;;2,0;;;;;;;;;1,0;;;;4,0;;;2,0;2,0;;;;;;;;;11,0;;;;;;1,0;;;;1,0;;;1,0;;;;;1,0;;;;;;1,0;;;;4,0;;;;;2,0;1,0;;;;;;;;;;;;;1,0;;;;;;;;;;16,0;;;;;;;;;;;;1,0;;;;;;1,0;;9,0;;;;;;;;;;;;3,0;;;;;;;;;;;;;;;;;;;;;;7,0;;;;;;;14,0;;;;;2,0;32,0;2,0;;;;1,0;;;;;;;9,0;;11,0;;2,0;;3,0;;;;;2,0;4,0;8,0;;;;;;;;;1,0;;;;;;;;;3,0;;;;60,0;;1,0;;;;;;;1,0;;;;;;;;;;;;;;;;
block;;;;4,0;1,0;29,0;36,0;16,0;3,0;7,0;;6,0;2,0;85,0;;17,0;58,0;;;1,0;7,0;;192,0;;2,0;;2,0;21,0;11,0;6,0;124,0;4,0;2,0;;;29,0;16,0;1,0;1,0;2,0;103,0;147,0;;5,0;25,0;41,0;1,0;70,0;;2,0;13,0;;28,0;4,0;24,0;3,0;49,0;;11,0;34,0;1,0;;49,0;3,0;320,0;2,0;158,0;;3,0;3,0;16,0;137,0;436,0;1,0;;;38,0;;;9,0;113,0;7,0;12,0;5,0;57,0;14,0;;72,0;2,0;10,0;8,0;30,0;32,0;10,0;;;627,0;7,0;218,0;16,0;156,0;11,0;7,0;3,0;34,0;38,0;3,0;9,0;22,0;1,0;;7,0;126,0;2,0;;4,0;9,0;37,0;6,0;72,0;3,0;2,0;21,0;11,0;;2,0;104,0;;2,0;1,0;40,0;7,0;1,0;64,0;1,0;1,0;95,0;3,0;;1,0;9,0;39,0;2,0;;27,0;24,0;39,0;70,0;25,0;11,0;3,0;;13,0;27,0;;;;3,0;3,0;;2,0;19,0;10,0;7,0;3,0;21,0;32,0;26,0;;4,0;9,0;10,0;6,0;7,0;3,0;11,0;1,0;20,0;5,0;1,0;7,0;1,0;20,0;24,0;28,0;15,0;64,0;3,0;77,0;13,0;;3,0;8,0;;8,0;15,0;31,0;26,0;6,0;11,0;3,0;50,0;8,0;2,0;1,0;6,0;95,0;10,0;25,0;65,0;28,0;43,0;4,0;30,0;;20,0;15,0;1,0;;10,0;33,0;7,0;2,0;1,0;32,0;7,0;158,0;;6,0;;6,0;18,0;29,0;10,0;21,0;;11,0;13,0;;38,0;2,0;5,0;2,0;2,0;9,0;112,0;3,0;26,0;34,0;22,0;17,0;9,0;5,0;3,0;26,0;15,0;56,0;54,0;4,0;;52,0;20,0;7,0;9,0;77,0;1,0;;43,0;8,0;16,0;3,0;5,0;5,0;3,0;;;6,0;59,0;1,0;22,0;7,0;1,0;20,0;10,0;32,0;1,0;5,0;1,0;91,0;4,0;4,0;2,0;8,0;;2,0;3,0;35,0;55,0;9,0;10,0;7,0;4,0;5,0;1,0;2,0;3,0;1,0;6,0;10,0;22,0;;;1,0;;26,0;17,0;41,0;28,0;2,0;145,0;3,0;36,0;16,0;24,0;15,0;1,0;4,0;;4,0;3,0;2,0;;1,0;9,0;33,0;6,0;1,0;;;5,0;5,0;;;7,0;;15,0;9,0;5,0;;2,0;1,0;;1,0;1,0;6,0;20,0;11,0;40,0;100,0;;;;;;4,0;7,0;1,0;;;1,0;;;17,0;19,0;6,0;2,0;;3,0;11,0;4,0;64,0;2,0;;1,0;;66,0;20,0;22,0;4,0;12,0;2,0;;11,0;2,0;3,0;35,0;;40,0;53,0;;;9,0;4,0;7,0;1,0;32,0;1,0;2,0;28,0;2,0;1,0;22,0;;3,0;31,0;;;;;;;;10,0;8,0;;61,0;;8,0;3,0;;4,0;;3,0;;;;5,0;1,0;;1,0;;4,0;28,0;4,0;5,0;7,0;2,0;1,0;15,0;;;28,0;5,0;29,0;;;3,0;6,0;;8,0;16,0;3,0;;;;7,0;;;10,0;;6,0;;4,0;6,0;;;;4,0;51,0;;11,0;;;12,0;2,0;;29,0;13,0;1,0;;;;;;;5,0;8,0;2,0;;;1,0;;6,0;;4,0;7,0;;;1,0;6,0;;48,0;;;4,0;;;8,0;2,0;;24,0;12,0;;3,0;;1,0;2,0;;2,0;;2,0;;;6,0;19,0;2,0;1,0;;1,0;10,0;8,0;4,0;4,0;65,0;;3,0;;1,0;4,0;;;;4,0;1,0;;29,0;;;2,0;;8,0;4,0;;;34,0;;3,0;;3,0;;;;;1,0;8,0;9,0;8,0;5,0;;;;2,0;16,0;9,0;1,0;5,0;;;1,0;18,0;1,0;;;;;;;10,0;14,0;1,0;3,0;;1,0;15,0;;;3,0;;8,0;1,0;;;;2,0;;2,0;4,0;;;31,0;;;2,0;;;2,0;1,0;2,0;;;;;;39,0;;;4,0;1,0;2,0;3,0;3,0;;2,0;;;11,0;11,0;2,0;;14,0;;1,0;;;24,0;4,0;;;106,0;1,0;;;;1,0;18,0;;;;4,0;;28,0;;;3,0;53,0;2,0;;1,0;14,0;2,0;4,0;4,0;;4,0;;5,0;6,0;;;;1,0;11,0;1,0;;;19,0;;;;;;;20,0;;;;3,0;2,0;;16,0;;2,0;10,0;6,0;10,0;2,0;;1,0;;1,0;2,0;20,0;;;20,0;5,0;10,0;;;2,0;;;;;19,0;;2,0;1,0;14,0;;8,0;;3,0;7,0;;7,0;18,0;27,0;1,0;;7,0;;;;3,0;;3,0;7,0;;;;5,0;;;;;;4,0;;;11,0;;5,0;5,0;;;;;37,0;2,0;8,0;;;;10,0;;22,0;7,0;;;;;2,0;;;;2,0;;;;;;;3,0;4,0;2,0;;3,0;;9,0;;2,0;5,0;;1,0;11,0;17,0;;;;;8,0;;;18,0;1,0;1,0;35,0;6,0;;5,0;1,0;1,0;;2,0;2,0;1,0;;1,0;;;;;;;;1,0;;6,0;;1,0;2,0;;;4,0;;7,0;;;9,0;;;;2,0;;1,0;;2,0;1,0;1,0;1,0;;;;1,0;;;;1,0;;1,0;3,0;3,0;;1,0;;;;;2,0;;14,0;1,0;6,0;;;;;;;1,0;;;;7,0;;;;;;6,0;;4,0;;2,0;;2,0;;;;;2,0;;;;;;7,0;;;7,0;;;2,0;;;;;;2,0;;;1,0;1,0;;;5,0;5,0;;;;7,0;;1,0;1,0;;;;;4,0;;;2,0;;2,0;1,0;1,0;;1,0;1,0;;;;;1,0;;;2,0;1,0;;;1,0;;;10,0;17,0;;3,0;23,0;;;;;2,0;;;;;;
blur;;;;1,0;52,0;11,0;;;;;;;4,0;33,0;;;33,0;;;7,0;;;1,0;;;72,0;48,0;;2,0;10,0;21,0;7,0;80,0;364,0;;19,0;;2,0;34,0;;52,0;54,0;;2,0;21,0;;1,0;;;;8,0;;;;3,0;25,0;4,0;;3,0;29,0;;;4,0;;481,0;1,0;51,0;7,0;;2,0;10,0;159,0;10,0;;;;;;;;54,0;;7,0;3,0;24,0;11,0;;21,0;;1,0;2,0;;3,0;;9,0;;21,0;13,0;34,0;4,0;3,0;11,0;;1,0;1,0;10,0;;;3,0;;;19,0;25,0;2,0;;;11,0;9,0;4,0;6,0;1,0;;14,0;;;;45,0;;;;6,0;;;143,0;2,0;;2,0;3,0;6,0;;;1,0;;;12,0;40,0;;;2,0;;;1,0;46,0;;;;;;;;;;2,0;;;;;;;27,0;3,0;;;240,0;;2,0;;;;;;;2,0;9,0;;;10,0;;34,0;4,0;;;;;;2,0;;;1,0;;;;2,0;;;12,0;37,0;;;;1,0;3,0;4,0;;;;4,0;4,0;;;;;;;;;6,0;;2,0;21,0;;;116,0;36,0;;;;;;2,0;;;;;;1,0;;;16,0;;;;;;;;;;;;;1,0;;2,0;;;;;;3,0;;;4,0;;;;;1,0;;;;;15,0;;;;;;17,0;;;16,0;;;;;25,0;4,0;;;;;;1,0;;;;;;12,0;2,0;;;;;;2,0;1,0;;;;11,0;1,0;;;;;;2,0;;;;;;;;;;2,0;;;7,0;;;;;10,0;1,0;;;;;1,0;;;;;;19,0;;;;;;;;;2,0;;;1,0;;17,0;11,0;;;;;2,0;;13,0;2,0;7,0;;;31,0;;1,0;;;;;5,0;45,0;;12,0;3,0;10,0;5,0;3,0;;1,0;;42,0;;;2,0;;52,0;;;14,0;;;4,0;;;89,0;;;;;;;;;;6,0;;41,0;2,0;;24,0;;;;;8,0;;;;;2,0;2,0;;;9,0;;12,0;2,0;;;;;1,0;;6,0;;1,0;;3,0;1,0;;2,0;;;;;3,0;;;;;;;;;;1,0;;;;;;;;125,0;;;;2,0;;;;;;;;;;;;;;;;;;;1,0;;;;;4,0;1,0;;;;;;;;;;2,0;;;;;;;;6,0;;;4,0;;;;;;;;;;;;;;;;;;;;;;;;;;;;;1,0;3,0;;;;;;;;;;;;;;1,0;;;;;;;;;1,0;;;;;;;;;2,0;;;2,0;;2,0;;;;5,0;;;;;;;;;;;;;;;;;;;1,0;;;;;;;;;;;;3,0;;;8,0;;;;;;;;;;;;;1,0;;;;;;;;;;;;;;;;4,0;;;;;;;;1,0;;;;;;;;;;;;;;;;;;;;;;;;;13,0;3,0;;;;;;;;;;;;;;10,0;3,0;;;;;4,0;;;;;1,0;;;;;1,0;;;2,0;;;13,0;;;;;1,0;;;;;;;;;;;;4,0;;;;;;;;;17,0;;;;;;;;;;2,0;;;;1,0;;;;;;;1,0;;;;;16,0;;;;;;;;;;;2,0;;;;;;;;;;;;;;13,0;;;;;;;1,0;2,0;;2,0;2,0;;2,0;;1,0;;;2,0;;3,0;;;;;;27,0;4,0;2,0;;;;6,0;;;2,0;;;;;;;;;;;;;;;;;;;;5,0;;;;;;;;;;;;;;;;;;;;1,0;;;;;;;;;;;;;;;1,0;2,0;;;;;;;;;;;9,0;;;;;;;;1,0;;19,0;;;;;;;;;;;;;;;;;;;;;;;;;;;;;;2,0;;;2,0;;;;;2,0;;;;;;;2,0;;;;;;;6,0;;;;;;;;;;;;;;;;;;
bottom;;;;6,0;;29,0;7,0;55,0;;;2,0;11,0;72,0;255,0;;;9,0;;15,0;;12,0;;;;;;1,0;66,0;1,0;;47,0;5,0;;;;;45,0;3,0;3,0;4,0;46,0;84,0;33,0;1,0;12,0;86,0;;30,0;;;;1,0;166,0;5,0;3,0;;165,0;;;;9,0;;6,0;1,0;86,0;;144,0;11,0;1,0;24,0;17,0;194,0;29,0;2,0;;;11,0;;;9,0;35,0;;;;99,0;;;29,0;;1,0;;6,0;6,0;5,0;;;30,0;20,0;89,0;21,0;114,0;9,0;;5,0;;;3,0;;1,0;;;2,0;24,0;;1,0;;;9,0;1,0;73,0;;9,0;11,0;3,0;1,0;1,0;40,0;;4,0;3,0;1,0;;2,0;88,0;;;5,0;;;2,0;6,0;10,0;6,0;;19,0;6,0;35,0;17,0;8,0;43,0;1,0;27,0;132,0;;;;;4,0;;;48,0;92,0;;;;2,0;112,0;78,0;2,0;;3,0;;;44,0;20,0;203,0;3,0;;2,0;;;2,0;3,0;159,0;6,0;2,0;18,0;4,0;23,0;49,0;;1,0;9,0;12,0;53,0;65,0;232,0;;88,0;25,0;10,0;52,0;;;1,0;;115,0;13,0;13,0;224,0;4,0;1,0;3,0;;2,0;34,0;1,0;34,0;;;19,0;;;;187,0;2,0;518,0;2,0;4,0;;23,0;;;4,0;28,0;;;2,0;11,0;;;34,0;7,0;14,0;35,0;1,0;;51,0;347,0;4,0;13,0;11,0;1,0;42,0;78,0;;129,0;1015,0;5,0;;2,0;;2,0;5,0;208,0;2,0;;;1,0;6,0;;11,0;30,0;7,0;11,0;;6,0;33,0;21,0;2,0;14,0;5,0;60,0;89,0;;;4,0;26,0;116,0;17,0;21,0;2,0;;55,0;1,0;6,0;12,0;3,0;32,0;15,0;6,0;25,0;7,0;1,0;;31,0;3,0;25,0;9,0;17,0;1,0;10,0;6,0;5,0;82,0;;48,0;9,0;;18,0;2,0;14,0;46,0;11,0;16,0;7,0;;21,0;13,0;50,0;44,0;;8,0;64,0;;;;;;1,0;6,0;;;17,0;10,0;34,0;77,0;42,0;1,0;20,0;1,0;;;;;5,0;;106,0;21,0;;3,0;;;1,0;;6,0;;;;;11,0;;;19,0;6,0;;;;2,0;;7,0;;;9,0;;4,0;;;3,0;;;;;10,0;6,0;2,0;8,0;1,0;;;;;8,0;2,0;;19,0;;3,0;;4,0;2,0;5,0;;2,0;;4,0;1,0;;;;;;2,0;;;32,0;4,0;1,0;;;8,0;;;;1,0;;6,0;;;;;11,0;;6,0;;;;;6,0;;2,0;;;2,0;14,0;7,0;;3,0;;;1,0;1,0;;1,0;;1,0;;;;;;2,0;;9,0;11,0;3,0;;;;;28,0;;1,0;;;;2,0;;6,0;;1,0;;;12,0;1,0;3,0;6,0;1,0;;5,0;;;5,0;1,0;;29,0;;;;;;;6,0;5,0;1,0;;1,0;26,0;9,0;;16,0;13,0;;20,0;;;15,0;4,0;6,0;;2,0;;17,0;24,0;19,0;;;12,0;;;;;1,0;59,0;;;;;7,0;;1,0;;;;;;;1,0;3,0;;;;5,0;3,0;;;;1,0;;;;;;24,0;10,0;3,0;;;11,0;1,0;;3,0;;;4,0;44,0;10,0;2,0;;5,0;;;;;10,0;;;1,0;1,0;1,0;;;;1,0;;;1,0;;;3,0;;;;4,0;;7,0;1,0;;;2,0;;;;;;;1,0;;;;;;4,0;;2,0;;1,0;;44,0;;;;6,0;18,0;;;;2,0;;7,0;;;;;1,0;7,0;;;;;;;;;;3,0;;;14,0;;1,0;;1,0;;;;;3,0;;;;2,0;;1,0;;;;3,0;9,0;;;34,0;;;7,0;42,0;3,0;15,0;2,0;2,0;;7,0;;3,0;7,0;3,0;10,0;22,0;;1,0;;1,0;26,0;2,0;4,0;2,0;;7,0;;2,0;;13,0;4,0;;1,0;;5,0;4,0;;;;;3,0;;31,0;;7,0;24,0;;47,0;;8,0;1,0;13,0;1,0;2,0;2,0;;1,0;2,0;;29,0;16,0;4,0;;11,0;;;3,0;;7,0;1,0;8,0;6,0;1,0;1,0;3,0;;;1,0;;2,0;1,0;;;;5,0;4,0;12,0;6,0;12,0;;;13,0;16,0;;;7,0;;;;;;;;;;;;;8,0;;58,0;1,0;11,0;;9,0;;;;;;;1,0;;;4,0;;;;1,0;;;;11,0;;;1,0;;7,0;;;;;7,0;;;1,0;1,0;;1,0;15,0;;2,0;;1,0;;;;;;;;;;;;2,0;;;;2,0;;;;;2,0;;;;;;;;;;;;;;3,0;;;;;;;;;6,0;;1,0;;;;;;;;;;;;;12,0;;15,0;;4,0;;2,0;;;;2,0;;2,0;;;;;1,0;;;;;;;;;;;;7,0;;;;;;2,0;;;;9,0;;3,0;;1,0;;;2,0;3,0;;4,0;;;;;;;9,0;;;4,0;;3,0;;;1,0;;;;7,0;;;;;;1,0;;1,0;5,0;;;;;;;;3,0;;6,0;;;;;;;;
boundary;;;;5,0;5,0;6,0;1,0;3,0;;;;1,0;;34,0;;;19,0;2,0;;;;5,0;20,0;;;;;7,0;3,0;;11,0;4,0;5,0;;;14,0;46,0;;2,0;;38,0;57,0;;;13,0;;;11,0;;;10,0;;20,0;;6,0;5,0;25,0;;;2,0;;;;;85,0;;21,0;;;;6,0;3,0;12,0;;2,0;;3,0;;;2,0;32,0;;;19,0;;;;3,0;;;4,0;3,0;;;;;60,0;4,0;27,0;103,0;33,0;8,0;;1,0;6,0;10,0;;;;;;24,0;76,0;1,0;;;3,0;4,0;1,0;3,0;;;;2,0;;3,0;29,0;;;;2,0;;;8,0;3,0;;19,0;15,0;2,0;;;11,0;;;4,0;6,0;44,0;1,0;12,0;;1,0;1,0;;;;;;;;;7,0;6,0;;;;3,0;2,0;4,0;;5,0;4,0;;2,0;19,0;;14,0;;2,0;1,0;;;;;7,0;;5,0;18,0;;6,0;1,0;;1,0;;;;4,0;8,0;;9,0;;;8,0;2,0;;;2,0;17,0;2,0;1,0;3,0;2,0;1,0;;;;29,0;;15,0;;12,0;13,0;2,0;;1,0;1,0;;96,0;;;1,0;;;15,0;10,0;2,0;3,0;;;;2,0;;2,0;;;;9,0;1,0;1,0;7,0;;;;;1,0;3,0;;;22,0;7,0;;2,0;1,0;;27,0;4,0;;;;;4,0;;;;;;;;1,0;;;1,0;;3,0;;;;;;1,0;;;;;2,0;1,0;;19,0;;;;;;3,0;5,0;;;;;;5,0;2,0;;;;9,0;;19,0;;;1,0;1,0;32,0;1,0;25,0;;;;2,0;;;;;;2,0;;1,0;;;2,0;1,0;;;;;;1,0;14,0;;;;;;;;11,0;;;8,0;13,0;;1,0;;;14,0;;;4,0;6,0;;;;;12,0;1,0;1,0;;;;1,0;1,0;5,0;7,0;;;;48,0;1,0;10,0;8,0;;;4,0;;;;5,0;;14,0;;;;8,0;;5,0;;6,0;;;;;;;;4,0;5,0;8,0;2,0;;;;;;4,0;;3,0;6,0;7,0;5,0;;;;;5,0;;4,0;;1,0;;;;3,0;;;3,0;;4,0;;;7,0;;;;;;;;;9,0;;;3,0;;6,0;3,0;;2,0;;;;;;;4,0;;;;4,0;;;;6,0;1,0;;9,0;1,0;1,0;6,0;10,0;;;1,0;;;12,0;;;17,0;;;;;;;13,0;;5,0;1,0;;;;;;;;;;;;;;;;3,0;13,0;;;;;;;;7,0;;;;;10,0;;;;;;;8,0;;;;;;;;;;1,0;;;;;;;;2,0;;;3,0;;;;;19,0;;;;;;;;;;;;;1,0;;;2,0;;;3,0;2,0;;;;;;;;;6,0;;;;;9,0;;;;;;1,0;;;;1,0;;;;1,0;;;;;3,0;6,0;;;1,0;;;;;;;;;;;;1,0;;;1,0;1,0;1,0;;6,0;;;;;;;2,0;2,0;;5,0;7,0;;;;;;;;2,0;;;;;;;;;1,0;1,0;;3,0;1,0;8,0;;;;2,0;;;3,0;6,0;;;;1,0;;;;;4,0;;12,0;;;;;4,0;;;;;;;;4,0;3,0;;;;3,0;;;;3,0;;;;6,0;;1,0;;;;;;;;5,0;1,0;;;1,0;;;2,0;;5,0;;;;;;1,0;;;;22,0;;;;10,0;;;;;;;;;;;;;;;;1,0;;;;;;3,0;;;;;1,0;;;;2,0;;;;;;;;;1,0;;;;;;;;;;;;5,0;;2,0;;;;;;2,0;;;;;10,0;;;;1,0;;3,0;;;;;4,0;;3,0;;;6,0;;;;;42,0;;;;;;;;;;1,0;;;;11,0;;;;;;;;;;;;;;;6,0;;1,0;;;;1,0;1,0;4,0;;;;;;;;;;;;4,0;;;;;;;5,0;;;;;;1,0;;1,0;3,0;6,0;;;;;;;;;;;;;;;;;;;;;;;;;;2,0;;;;;;;;;;;;;;;;;;;;;;;;4,0;;;;7,0;;;;;;;;;;4,0;;;4,0;5,0;;;;;;;;1,0;;;;;;;;;;;;;;;
calculate;;;;18,0;186,0;86,0;18,0;1,0;1,0;5,0;;2,0;1,0;486,0;;38,0;94,0;4,0;6,0;36,0;;3,0;165,0;2,0;6,0;6,0;14,0;84,0;16,0;27,0;311,0;87,0;81,0;172,0;;255,0;13,0;37,0;110,0;5,0;112,0;202,0;;36,0;49,0;1,0;8,0;21,0;71,0;87,0;47,0;;3,0;;32,0;12,0;10,0;;25,0;28,0;;2,0;21,0;1,0;1040,0;5,0;141,0;3,0;12,0;;35,0;89,0;115,0;;13,0;19,0;;49,0;1,0;13,0;304,0;7,0;39,0;23,0;115,0;13,0;2,0;102,0;1,0;1,0;163,0;1,0;10,0;2,0;24,0;1,0;376,0;87,0;189,0;238,0;336,0;24,0;;10,0;84,0;181,0;13,0;21,0;2,0;10,0;;140,0;86,0;7,0;;9,0;2,0;48,0;36,0;72,0;12,0;;92,0;43,0;2,0;40,0;173,0;;40,0;;191,0;10,0;;329,0;6,0;;70,0;42,0;40,0;;;11,0;1,0;;3,0;24,0;82,0;10,0;17,0;;4,0;17,0;21,0;;3,0;3,0;;;;;;11,0;1,0;9,0;;4,0;4,0;1,0;3,0;25,0;10,0;37,0;1,0;86,0;4,0;34,0;1,0;1,0;2,0;;5,0;;;31,0;;3,0;37,0;3,0;133,0;1,0;2,0;1,0;2,0;;2,0;2,0;3,0;4,0;2,0;;;;3,0;2,0;58,0;14,0;5,0;;3,0;16,0;16,0;38,0;56,0;;;;35,0;8,0;6,0;12,0;38,0;20,0;3,0;6,0;1,0;;27,0;;;6,0;;9,0;47,0;89,0;;6,0;9,0;1,0;;19,0;;2,0;;;;56,0;;17,0;9,0;;;;;19,0;;;5,0;17,0;5,0;;9,0;19,0;;60,0;;;;6,0;21,0;19,0;;;7,0;11,0;;;3,0;268,0;;7,0;;5,0;39,0;6,0;9,0;;1,0;5,0;74,0;;2,0;19,0;;;26,0;2,0;351,0;2,0;1,0;;;;2,0;24,0;;;;2,0;39,0;38,0;;;;;9,0;;15,0;;3,0;2,0;14,0;239,0;;22,0;;;2,0;2,0;17,0;;;;;;2,0;;;;;;15,0;88,0;2,0;;;;10,0;20,0;;;2,0;;3,0;;30,0;5,0;5,0;13,0;44,0;1,0;8,0;7,0;6,0;2,0;25,0;58,0;4,0;28,0;;;;;;34,0;64,0;12,0;13,0;17,0;47,0;23,0;125,0;264,0;1,0;5,0;7,0;55,0;24,0;169,0;11,0;6,0;5,0;8,0;12,0;110,0;4,0;156,0;;27,0;28,0;9,0;6,0;38,0;7,0;125,0;8,0;88,0;6,0;12,0;68,0;4,0;;60,0;;2,0;59,0;52,0;;10,0;1,0;2,0;14,0;48,0;;1,0;1,0;30,0;;26,0;1,0;13,0;9,0;;51,0;1,0;51,0;3,0;12,0;48,0;;3,0;19,0;2,0;57,0;48,0;21,0;9,0;18,0;;68,0;20,0;16,0;2,0;3,0;2,0;7,0;;159,0;74,0;;5,0;35,0;;6,0;3,0;;5,0;15,0;3,0;1,0;49,0;;11,0;21,0;3,0;;;4,0;3,0;9,0;6,0;16,0;9,0;8,0;43,0;4,0;;63,0;;;83,0;3,0;;6,0;10,0;2,0;;51,0;;1,0;;5,0;18,0;;5,0;100,0;17,0;2,0;;;3,0;1,0;135,0;;;10,0;20,0;;7,0;;;;;12,0;16,0;7,0;;;;;;;1,0;2,0;6,0;37,0;4,0;20,0;8,0;1,0;71,0;;9,0;1,0;1,0;5,0;12,0;;;;10,0;;;17,0;1,0;2,0;3,0;13,0;1,0;;17,0;13,0;10,0;22,0;3,0;35,0;2,0;7,0;;;3,0;;;1,0;;19,0;17,0;3,0;32,0;;;13,0;;23,0;;3,0;;1,0;6,0;5,0;13,0;;2,0;7,0;37,0;;1,0;4,0;24,0;6,0;;51,0;;;92,0;;1,0;10,0;6,0;30,0;;;;14,0;7,0;;;1,0;1,0;;2,0;;;31,0;2,0;;;;1,0;;;;1,0;4,0;4,0;;4,0;5,0;;2,0;21,0;;;1,0;3,0;;3,0;12,0;;;;2,0;;1,0;11,0;38,0;;12,0;1,0;9,0;16,0;;1,0;7,0;;;;3,0;;;3,0;18,0;5,0;;;10,0;1,0;2,0;5,0;117,0;4,0;5,0;;;;;1,0;6,0;6,0;;;3,0;;2,0;1,0;2,0;;4,0;5,0;;;1,0;;8,0;12,0;16,0;;;;;18,0;;14,0;2,0;;;5,0;;3,0;4,0;27,0;;;;2,0;5,0;;;;2,0;21,0;;1,0;;17,0;53,0;3,0;7,0;;28,0;2,0;12,0;;9,0;;;12,0;;12,0;10,0;1,0;;;;;;;10,0;;1,0;2,0;;;;;20,0;13,0;;;8,0;;17,0;;18,0;;;;;;;2,0;9,0;;;1,0;;8,0;;21,0;5,0;3,0;;;30,0;;;;48,0;;;;;;;108,0;;55,0;;14,0;38,0;45,0;;89,0;;;4,0;5,0;;11,0;3,0;37,0;7,0;45,0;3,0;2,0;5,0;1,0;7,0;1,0;28,0;;;;32,0;;6,0;56,0;4,0;;;;2,0;;11,0;19,0;12,0;3,0;1,0;;6,0;4,0;12,0;9,0;1,0;1,0;1,0;6,0;40,0;5,0;3,0;;3,0;;;;2,0;;33,0;2,0;;;;31,0;15,0;2,0;31,0;5,0;;;62,0;;1,0;1,0;;1,0;;3,0;6,0;;;12,0;2,0;2,0;5,0;8,0;2,0;;;;2,0;;;4,0;;;5,0;4,0;;36,0;;20,0;;2,0;;;;;;;1,0;1,0;;;;;;4,0;16,0;28,0;7,0;1,0;12,0;7,0;;5,0;;4,0;;;;;3,0;;17,0;;;2,0;;;;;13,0;;5,0;;;;2,0;;12,0;11,0;;;8,0;;;;21,0;50,0;3,0;;1,0;;;;11,0;;8,0;;;;8,0;7,0;7,0;3,0;3,0;22,0;;6,0;38,0;1,0;5,0;;;2,0;;;;;;1,0
calculation;;;;2,0;26,0;20,0;3,0;;1,0;;;2,0;;40,0;;3,0;21,0;;;1,0;;2,0;4,0;;1,0;;2,0;;1,0;11,0;56,0;9,0;13,0;18,0;;24,0;2,0;6,0;14,0;;24,0;72,0;1,0;3,0;14,0;;;1,0;;3,0;2,0;;3,0;1,0;3,0;4,0;4,0;;;8,0;;;7,0;1,0;86,0;2,0;22,0;;;4,0;;4,0;12,0;;;;;5,0;;;21,0;;6,0;1,0;25,0;;;5,0;;1,0;21,0;;;;8,0;;17,0;8,0;5,0;14,0;39,0;1,0;;3,0;34,0;11,0;;7,0;;2,0;;18,0;22,0;;;;;2,0;;8,0;;;26,0;;1,0;4,0;18,0;;;;40,0;;;172,0;;;3,0;;;;;;;;;;13,0;1,0;1,0;;;3,0;1,0;;4,0;;;;;;;;;;;;3,0;;;8,0;2,0;4,0;6,0;5,0;;3,0;;1,0;1,0;;;;;;;;5,0;;;2,0;;;;;;;;1,0;;;;;;1,0;5,0;;;;2,0;;1,0;3,0;9,0;;;;12,0;1,0;;;2,0;2,0;2,0;;;;2,0;;;1,0;;;6,0;3,0;;3,0;;;;;;1,0;;;;1,0;;;;;;;;1,0;;;;3,0;;;;2,0;;9,0;;;;;8,0;3,0;;;;;;;1,0;42,0;;;1,0;;;;;;;1,0;28,0;;;;;;1,0;;26,0;;;;;;;3,0;;;1,0;;1,0;10,0;;;;;;;;;;;4,0;18,0;;1,0;;;1,0;;2,0;;;;;;1,0;;;;;;;20,0;;;;;;1,0;;;;;;;10,0;;;;;1,0;;;7,0;;15,0;19,0;11,0;1,0;;;2,0;;159,0;;6,0;;;;2,0;;18,0;13,0;;1,0;;4,0;10,0;6,0;2,0;;;11,0;;4,0;;6,0;;1,0;8,0;;1,0;;4,0;13,0;3,0;3,0;4,0;5,0;8,0;;;1,0;;;;21,0;;1,0;;2,0;;;;;;5,0;;;;;3,0;;;;2,0;;;2,0;9,0;5,0;;;2,0;3,0;;1,0;;;2,0;1,0;;3,0;;;;;;18,0;;1,0;;1,0;;;3,0;;;;2,0;;;;3,0;;;;2,0;;;;;1,0;;2,0;2,0;;50,0;;;1,0;;;;;;;6,0;;2,0;;;;;;6,0;;1,0;;;;;22,0;;;;;;;;;;;2,0;;2,0;;;;;;;;;;;4,0;1,0;1,0;;14,0;;4,0;;;;1,0;;;;;;;4,0;;;1,0;;;;;;;;;;;;;;2,0;;;6,0;;;3,0;;12,0;;;;;;;;;6,0;;2,0;4,0;;;;;;;;;;;13,0;;;6,0;;;;;;;;1,0;2,0;;;;;;;;;;1,0;;;;;;;;;;;;;;;;2,0;;;;;;;;;;;;;2,0;;;1,0;;4,0;;2,0;4,0;;;;;;;;;;;;2,0;;;;;;1,0;7,0;2,0;;;;;;;3,0;;;;;;1,0;;;;;;;;;;;;3,0;;;;;;;;;;;1,0;;;;;2,0;;;;1,0;;;;1,0;9,0;;1,0;;;1,0;;3,0;;5,0;;1,0;;1,0;;;;;;13,0;;;;;;1,0;;;;;;;;;;17,0;;;;;;2,0;;1,0;;;;;;;;3,0;;;;;2,0;;1,0;;;1,0;1,0;;;;;4,0;;;;;;;1,0;3,0;4,0;;4,0;;2,0;;12,0;;;;;;;;6,0;;1,0;;;;3,0;;;;;;;2,0;;2,0;14,0;;;;;;;;;;;;2,0;;1,0;;8,0;;;;1,0;5,0;;;;;;;;;;;;;;;7,0;5,0;3,0;1,0;2,0;;;6,0;;;2,0;;;;;;;;5,0;;;;;;;;;;;;;;;;;;;;2,0;;;;;;;;;3,0;;;;;;;;3,0;7,0;;;2,0;;;3,0;;;;;;;;;6,0;;;;;;;;;;;;;;;;1,0;;;;;;;;1,0;;;;1,0;;;;;;3,0;;;;;2,0;;3,0;;;;;1,0;;;;;;;;;;;
calibrate;;;;24,0;1,0;55,0;30,0;3,0;;;;;;105,0;;;59,0;;;;;;8,0;;;;1,0;9,0;12,0;2,0;35,0;6,0;4,0;;;123,0;2,0;5,0;58,0;;30,0;69,0;1,0;18,0;15,0;1,0;;4,0;;12,0;13,0;;;;9,0;;1,0;;;32,0;;;1,0;;279,0;3,0;55,0;;3,0;;9,0;8,0;10,0;;2,0;;5,0;7,0;1,0;10,0;214,0;;;40,0;114,0;;;9,0;;1,0;58,0;2,0;;;3,0;;25,0;7,0;50,0;48,0;61,0;3,0;;8,0;11,0;26,0;5,0;7,0;1,0;;;12,0;12,0;;;;;6,0;4,0;58,0;31,0;;12,0;1,0;;17,0;168,0;;;;6,0;;1,0;15,0;;6,0;11,0;12,0;5,0;;;5,0;1,0;;1,0;14,0;7,0;;4,0;;;2,0;9,0;;;;;;;;;4,0;3,0;;1,0;2,0;;;;27,0;1,0;2,0;2,0;9,0;;9,0;;;;;4,0;;1,0;1,0;;;;;33,0;1,0;2,0;2,0;;1,0;;;1,0;;;;;;6,0;;12,0;10,0;;;5,0;5,0;2,0;1,0;14,0;;;;11,0;1,0;;9,0;8,0;3,0;1,0;;;;5,0;;;;;7,0;6,0;2,0;;;1,0;;;;;;;;;19,0;2,0;1,0;;;;;;;;4,0;;7,0;;;;;;45,0;;;;1,0;;;;;;;;;;18,0;;2,0;;;4,0;;2,0;;;;;;;;;1,0;1,0;;11,0;;;;1,0;;;;;;2,0;1,0;6,0;23,0;;;;;;;3,0;;;;3,0;18,0;;14,0;;;;;4,0;1,0;;;;;4,0;1,0;;;;;2,0;11,0;9,0;;;;3,0;6,0;;;;;3,0;;3,0;;3,0;;9,0;;2,0;;;1,0;;2,0;2,0;1,0;1,0;;;;9,0;19,0;;1,0;1,0;;;2,0;9,0;9,0;;9,0;;15,0;1,0;1,0;;2,0;;11,0;2,0;1,0;;16,0;;10,0;1,0;;;9,0;1,0;6,0;;11,0;;2,0;4,0;9,0;;5,0;;2,0;15,0;17,0;;;1,0;;;3,0;2,0;6,0;1,0;3,0;;4,0;4,0;;;1,0;2,0;;4,0;;3,0;2,0;;;3,0;;5,0;3,0;7,0;6,0;;1,0;13,0;;;;;;;;8,0;90,0;;;10,0;;2,0;;4,0;;1,0;1,0;;4,0;;;22,0;;;;;;1,0;1,0;;1,0;;8,0;19,0;5,0;23,0;1,0;1,0;6,0;;;1,0;;;;;;;;;;2,0;;1,0;;14,0;1,0;;;;;;;2,0;2,0;;;;;;;;;;;;1,0;;;;19,0;;;9,0;;;2,0;6,0;10,0;;1,0;;;;2,0;;;;;;;2,0;;;;;7,0;;;3,0;2,0;;2,0;2,0;;1,0;;;1,0;;1,0;;;1,0;39,0;;1,0;;;1,0;;;;;;;;2,0;2,0;;;5,0;6,0;;;;;6,0;1,0;;1,0;;8,0;;4,0;;3,0;19,0;;;;1,0;3,0;;;2,0;;2,0;1,0;;;1,0;1,0;;;;27,0;;;;;;;;;2,0;;;2,0;;;;;;;;;;;;;3,0;1,0;3,0;1,0;;2,0;1,0;;;;;;3,0;;;;;;10,0;;;;9,0;1,0;;;42,0;;;;;;;;15,0;;;3,0;;;;;6,0;;;15,0;;;;;1,0;;1,0;;;;;;;;;;;;;4,0;;;;;;2,0;;;;;9,0;;;;;3,0;10,0;;;;14,0;;;;1,0;;;;;;1,0;;;;;;;;;;;;;;;;;10,0;;;;;;;10,0;;;;;;6,0;;;;;1,0;;1,0;;;;;;;4,0;;;;;;;;;;;6,0;;;;;6,0;15,0;;;;;;;;;;1,0;;1,0;;6,0;;;;;;;3,0;;1,0;;;2,0;2,0;;;;23,0;;;;;;;;1,0;;;;;;;;1,0;;;;;;2,0;;;;;;1,0;3,0;5,0;1,0;;;5,0;;;3,0;11,0;;;;;1,0;;;;;;;;;;;1,0;;;;;;;;;1,0;;;;6,0;;;;;;;;3,0;;;;3,0;;;;;;2,0;;;;;;;;;1,0;1,0;;;;;;;;;;;;;;;;;;;;;;;1,0;;;;;;;;;;4,0;;;;;;;;;;;;;10,0;;;;;;;1,0;;1,0;;;;;;;;;
capacitor;;;;10,0;1,0;16,0;;1,0;;;;;;2,0;;;2,0;1,0;1,0;;;;2,0;;;;3,0;3,0;;;45,0;2,0;;;;5,0;;;;;10,0;26,0;;11,0;;2,0;;11,0;;;;;;;1,0;;11,0;;2,0;2,0;2,0;;;;9,0;;36,0;1,0;;;;7,0;1,0;;;;2,0;;1,0;7,0;8,0;;;;12,0;;;;;;;5,0;4,0;;;;10,0;;1,0;;;3,0;;;3,0;1,0;;1,0;;;;13,0;22,0;;;;;3,0;;15,0;;;66,0;;;34,0;11,0;;;;3,0;;;19,0;;;;;;;;;;;;4,0;;7,0;;;2,0;;;;9,0;86,0;;;;;4,0;94,0;;3,0;19,0;;63,0;;;;;;;;;;18,0;;;;29,0;;;;;;37,0;;;;;;;16,0;;;;;;;;4,0;1,0;;8,0;1,0;;;5,0;7,0;;;;;;;34,0;9,0;;;;21,0;;5,0;5,0;;7,0;;;;;;1,0;;;;;;;;;;;;;;1,0;;24,0;;;;;;;20,0;;2,0;3,0;;5,0;2,0;;1,0;;;;;;;;3,0;13,0;;;;;;;;;;;6,0;;;2,0;;61,0;;1,0;;;;;;;1,0;;1,0;;;;;;;;;;15,0;;;;;;;1,0;;;;1,0;;;;13,0;;1,0;;46,0;;;;;3,0;;;;;;;;2,0;;;;;;1,0;;;;;;;;;2,0;;4,0;;;;;;;;;;;;;;;;3,0;;;;2,0;;44,0;;1,0;;3,0;;;8,0;;;;1,0;;;;1,0;;;;;;48,0;1,0;7,0;;;;;1,0;1,0;1,0;9,0;;;10,0;;;;;;;;8,0;;;13,0;;;;;3,0;;1,0;;2,0;;6,0;;47,0;;;72,0;4,0;;;1,0;;;;;;106,0;;;;11,0;;;1,0;;5,0;;;;;;;;6,0;;;;;18,0;;;;;2,0;;1,0;;;;2,0;;4,0;;;;;;;;;;;;;;;;;;;1,0;;;;;;;;;;10,0;;;;;13,0;12,0;;;;;1,0;;;;;;;;;;;;3,0;;;;;;;;;3,0;;;;;;;;;;13,0;;;;4,0;;;;;;;;;;;;;;;;;;;;;;;;;1,0;;9,0;;;;;;;;;;;;;;;;;;;;;30,0;6,0;2,0;;4,0;;;;;;;;;;;;;;;;;;;;5,0;;;;;;3,0;;;;;3,0;;;;;;1,0;;;;;;;;28,0;;;;;;;1,0;;;;;30,0;;;;;;;;;;;;;;2,0;;;;;;;;34,0;;;;;;;;;;;2,0;4,0;;;;;;;;;;;5,0;2,0;;;;;;;;;;;;;;;;;;9,0;;;;;;;;;;;18,0;;;;;;;;;;;;;;;;;;;;;;;;;;;;;;;;;3,0;;;;;;;;;;5,0;;51,0;3,0;;;7,0;2,0;15,0;;;;24,0;2,0;34,0;;2,0;;;2,0;;;11,0;;;10,0;;;8,0;;;;;;;;21,0;;;;;;;36,0;;;;;;;;;;;;;;;;;;;;;4,0;;;16,0;;;;;;;;;;;;;;;;;;;;;;;;;;;;;;;;;;;;;;;;;;10,0;;;;;;;;;;;;;;;;;;;;;;;;;;;;;1,0;;;;;;;;;;;;;;;7,0;;;;;;;;;;;;;;;;;;;;;;;;;;;;;;;;;;;;;;;;;;;;;;;;;;;;;;;;;;
carrier;;;;14,0;;10,0;5,0;77,0;;;6,0;;106,0;111,0;;;5,0;;1,0;;9,0;;55,0;;2,0;4,0;1,0;25,0;1,0;1,0;56,0;5,0;3,0;59,0;;47,0;7,0;1,0;3,0;1,0;21,0;77,0;;2,0;4,0;72,0;;100,0;;;;;20,0;22,0;3,0;6,0;67,0;;13,0;32,0;;;5,0;;223,0;;101,0;;;1,0;2,0;540,0;32,0;;;;18,0;1,0;;;53,0;;;3,0;141,0;28,0;;177,0;15,0;5,0;;1,0;8,0;;;;12,0;23,0;91,0;8,0;110,0;14,0;;12,0;;4,0;;;;;;5,0;49,0;;20,0;;;6,0;;180,0;;;23,0;2,0;5,0;;72,0;;;1,0;1,0;;7,0;132,0;;;13,0;;;;1,0;3,0;;;5,0;11,0;20,0;65,0;8,0;61,0;;5,0;46,0;4,0;;1,0;2,0;;;1,0;22,0;52,0;;3,0;;;38,0;54,0;;;4,0;;8,0;70,0;;3,0;5,0;1,0;12,0;;;;3,0;31,0;15,0;13,0;6,0;12,0;3,0;37,0;;4,0;;34,0;27,0;34,0;77,0;9,0;31,0;21,0;5,0;44,0;3,0;;;1,0;32,0;11,0;3,0;145,0;79,0;17,0;1,0;;;26,0;2,0;24,0;;5,0;19,0;;;18,0;34,0;;85,0;1,0;2,0;;11,0;;2,0;;15,0;;;;;;2,0;2,0;1,0;;9,0;5,0;15,0;3,0;118,0;;;12,0;6,0;88,0;73,0;;63,0;92,0;2,0;1,0;9,0;2,0;1,0;26,0;2,0;;7,0;;;7,0;;15,0;41,0;5,0;;;10,0;3,0;11,0;3,0;5,0;81,0;69,0;26,0;;;;11,0;232,0;;59,0;1,0;;;;7,0;13,0;15,0;10,0;;21,0;;28,0;1,0;;1,0;1,0;6,0;3,0;28,0;;11,0;14,0;;;;36,0;;10,0;7,0;12,0;1,0;29,0;1,0;;;4,0;;10,0;15,0;3,0;2,0;18,0;16,0;5,0;;1,0;1,0;3,0;5,0;7,0;13,0;3,0;1,0;40,0;2,0;9,0;45,0;;6,0;66,0;;2,0;4,0;4,0;;;16,0;6,0;4,0;;;;;;11,0;;;1,0;5,0;6,0;;1,0;10,0;6,0;;;;;;9,0;1,0;;1,0;1,0;6,0;;2,0;;;;;4,0;8,0;1,0;;;;;;;6,0;3,0;;;9,0;;;51,0;12,0;7,0;15,0;;;2,0;;5,0;1,0;;;;;;;1,0;27,0;4,0;3,0;;6,0;19,0;1,0;;;;;1,0;;4,0;3,0;2,0;5,0;;;;3,0;;3,0;;;;2,0;;6,0;5,0;3,0;;2,0;;;2,0;1,0;;1,0;;;;;;;;;;9,0;20,0;14,0;5,0;5,0;;3,0;40,0;;;1,0;;;11,0;;7,0;;;;;10,0;1,0;;;;;56,0;;2,0;3,0;;;14,0;2,0;;;;;;3,0;;7,0;1,0;4,0;2,0;3,0;1,0;11,0;5,0;2,0;10,0;;;;6,0;2,0;;1,0;;;30,0;4,0;1,0;;;2,0;;;;26,0;36,0;;;;;;;1,0;3,0;;;;6,0;;3,0;;;4,0;;2,0;;;;;;5,0;1,0;;6,0;;13,0;8,0;1,0;;;;1,0;;9,0;;39,0;12,0;4,0;1,0;;;;;;;;;;;;;;;;;;;;;;;4,0;12,0;;;2,0;1,0;;1,0;;;13,0;;;;1,0;;;4,0;;;;;;;4,0;5,0;;;;13,0;5,0;;;7,0;;;;;2,0;;4,0;;;;;;5,0;;;;;;;4,0;;;;;;;;3,0;2,0;4,0;;;;;;8,0;;;;;9,0;;;;28,0;39,0;2,0;;1,0;;;;27,0;1,0;;1,0;1,0;;;;23,0;27,0;4,0;1,0;24,0;;;;2,0;;;11,0;1,0;;12,0;;;;;7,0;;;3,0;15,0;1,0;2,0;;;;;16,0;41,0;;2,0;;1,0;6,0;1,0;;;;;;1,0;;;;;;2,0;6,0;;3,0;2,0;;;;4,0;1,0;;10,0;1,0;;10,0;;;1,0;;2,0;5,0;3,0;;3,0;;;1,0;;;;;3,0;3,0;;64,0;;31,0;;;5,0;2,0;2,0;;1,0;21,0;1,0;;6,0;;;8,0;;6,0;;4,0;;;;;;;;3,0;1,0;14,0;6,0;14,0;;;;;;;;;2,0;;;;1,0;;;;;;2,0;;;;2,0;;;;;;;;;;;;;;1,0;1,0;;;;;;;;;9,0;2,0;;7,0;;;;;;;;;;;1,0;;;;;;;;;;;;4,0;;;;;;;1,0;;;;;;;1,0;2,0;;2,0;;;;;;;;;;;11,0;;;;;;;2,0;;3,0;;;;;2,0;;13,0;;;;1,0;9,0;3,0;;;;;1,0;;2,0;;;9,0;;;;;;;;6,0;;2,0;;;;;;;;1,0;;;;;;;;;;;;;;;;;;;;;;3,0;;;;;;;;
casing;;;;2,0;;6,0;;10,0;;;;;9,0;16,0;;;8,0;;4,0;;3,0;;;2,0;7,0;;;;;;44,0;3,0;;;;7,0;9,0;5,0;;;;65,0;1,0;4,0;13,0;37,0;;15,0;;;;;3,0;5,0;1,0;;72,0;;;1,0;11,0;;;;29,0;;55,0;;;1,0;6,0;88,0;2,0;;;;10,0;;;;40,0;;2,0;;43,0;;;36,0;;;;3,0;3,0;1,0;;;2,0;;3,0;;21,0;3,0;;4,0;;10,0;;;;;;;2,0;;11,0;;;4,0;;25,0;;;6,0;;;;3,0;;;;;;;58,0;;;7,0;;;;;;;;1,0;6,0;;9,0;;20,0;3,0;;16,0;16,0;;;5,0;;;;2,0;27,0;;;;;36,0;15,0;;;;;;12,0;3,0;3,0;;;;;;;8,0;16,0;;;;7,0;3,0;21,0;;3,0;26,0;6,0;4,0;21,0;28,0;;71,0;3,0;;22,0;;;;;57,0;3,0;;30,0;8,0;;;;13,0;51,0;3,0;2,0;;;;;;;3,0;;135,0;2,0;6,0;6,0;4,0;;;;11,0;;;;;;2,0;7,0;2,0;;17,0;;7,0;11,0;104,0;;7,0;;6,0;7,0;1,0;1,0;43,0;43,0;7,0;;3,0;9,0;;5,0;6,0;4,0;;;;2,0;1,0;;1,0;;12,0;;6,0;;;4,0;1,0;;39,0;10,0;;2,0;2,0;;7,0;2,0;;1,0;2,0;53,0;;3,0;3,0;;;;8,0;6,0;8,0;1,0;;;;17,0;;11,0;1,0;;14,0;2,0;;;14,0;;5,0;;16,0;2,0;1,0;;;3,0;;;2,0;6,0;1,0;;;7,0;;;3,0;;;;1,0;2,0;;5,0;3,0;1,0;;27,0;;3,0;;;;;;2,0;1,0;1,0;3,0;9,0;;;;;;;;;;;;;;2,0;;;;;;;1,0;;;;;;;;;;;;;;;2,0;1,0;;;;;1,0;4,0;;;;;4,0;;;;;;2,0;;;;16,0;;;;;3,0;;;3,0;;;;9,0;;;;;;;;3,0;;;1,0;2,0;;;;;;;5,0;;;;1,0;2,0;;1,0;;;8,0;;;1,0;;3,0;;;;;;;;2,0;;14,0;9,0;1,0;;7,0;;;;;;;;;;1,0;;;;;;1,0;3,0;3,0;;;;;;;;2,0;;;;;;;1,0;;;;;;;3,0;;;8,0;7,0;;8,0;;;;;;;;;1,0;;;;;;;7,0;;;;23,0;;;;;;;;;;;;;;;;;;;;;;;;;;;;;;;1,0;1,0;;;;2,0;;1,0;;;;;2,0;;;3,0;5,0;;;;;;4,0;2,0;;;;;;;;;1,0;;;;;;;8,0;13,0;2,0;;;;;;;;;;;;;;;;;;14,0;;;;;;;;;3,0;;;;;;;1,0;;;;;2,0;;;;;;;;;;;;;;;;1,0;;;;;;;;;;;2,0;;5,0;1,0;;;;34,0;;;1,0;;;;19,0;;16,0;2,0;2,0;;;2,0;;;1,0;;4,0;;;;;;;4,0;;;3,0;;;;;18,0;;;2,0;;8,0;;;;;1,0;;1,0;;9,0;;;2,0;;;;9,0;;;;2,0;;;5,0;;;;;;;;;;;;3,0;7,0;;;2,0;3,0;;;;;;;;4,0;;11,0;13,0;;;;;;5,0;;;;;;;;;;;;;;;;4,0;;;;;;;;;;;;;;;;;;;;;;;;;;7,0;;;;;;;;;;;;;;;;;;;;;;;;22,0;;;;;;;;;1,0;;2,0;;;;;;;;;;;;;3,0;;;;;;;;;;;;;;;;;3,0;;;;;;;;;;;;;;;;;;;;;;;;;;;;4,0;;;;;;;4,0;;;;;;;1,0;;;;;;;;;;;;;;;;;;;;;;;;;;;;;;;;;;;;;;;;;;;;;;;;;;;;;;;;;;;;;;;;;;
cleaning;;;;2,0;6,0;10,0;;15,0;;;;;;13,0;;;3,0;;5,0;;;;9,0;;;;;6,0;;;28,0;21,0;1,0;;;;;1,0;;2,0;2,0;170,0;3,0;1,0;;3,0;;14,0;;;1,0;2,0;13,0;;3,0;;16,0;;2,0;7,0;;;1,0;;9,0;;39,0;1,0;;1,0;2,0;191,0;1,0;97,0;;;7,0;;;;52,0;;4,0;;21,0;;;12,0;3,0;;;;1,0;;;;2,0;1,0;8,0;;94,0;8,0;;3,0;8,0;;;9,0;;;;;;2,0;1,0;;;1,0;;1,0;;;5,0;;;8,0;151,0;;6,0;1,0;24,0;;;48,0;;;6,0;;;;;1,0;;;5,0;3,0;;8,0;;4,0;3,0;;19,0;1,0;;;1,0;1,0;;;;19,0;;;;;1,0;15,0;;1,0;;;4,0;4,0;;4,0;2,0;;4,0;;;;1,0;9,0;;2,0;;1,0;;10,0;;;5,0;1,0;;;8,0;;3,0;;;;;1,0;1,0;;30,0;;;9,0;14,0;3,0;;;;10,0;2,0;;;30,0;;2,0;;;;;18,0;5,0;;;;;;;2,0;;;;;;;;5,0;1,0;;1,0;;15,0;11,0;3,0;;;;1,0;;21,0;5,0;24,0;3,0;;2,0;;;108,0;6,0;17,0;;;;17,0;;;;4,0;;;4,0;;;;;;15,0;;;;4,0;1,0;4,0;2,0;;;;3,0;1,0;15,0;;1,0;;;3,0;;1,0;7,0;;;;105,0;;2,0;;;3,0;;;;3,0;;;2,0;1,0;1,0;2,0;1,0;1,0;;;;;;;;;;2,0;;2,0;8,0;;;1,0;;1,0;;;2,0;;2,0;;5,0;;;;;;8,0;2,0;;4,0;;;;;;1,0;;;;;22,0;1,0;;;;;;;;;;7,0;;2,0;;;1,0;;;;;2,0;6,0;;;2,0;4,0;;;1,0;;;;3,0;;;;;8,0;;27,0;;5,0;;2,0;;;;;;;;1,0;1,0;;;1,0;;1,0;;;;;;;4,0;;;;;;5,0;;8,0;;;;;;;1,0;;;6,0;;;;;;;1,0;;5,0;;1,0;;;;;;;;;4,0;;;;;;;;;;;;5,0;;1,0;;;;;;;1,0;;;;;;;;;;;;4,0;2,0;;2,0;;;;;;;;;2,0;;;;3,0;;;;;;;99,0;;;1,0;;9,0;;;;;;;;;32,0;6,0;;;;;20,0;;;;;1,0;;;;;;;;5,0;6,0;;;;;;2,0;;;;;;;;;;18,0;;;;;1,0;;11,0;;;;1,0;;;;;2,0;;;1,0;;;;;;;;;;;;1,0;;;;1,0;;;;2,0;;;;;;;;;1,0;;;;;1,0;;;;;3,0;;2,0;;;;;;;4,0;;;;;;;;;;5,0;;;;;;;1,0;;;;;;;;5,0;;;;;;;;;;;;;;;;;;2,0;;;4,0;;;15,0;5,0;2,0;;1,0;;;6,0;;17,0;4,0;;;2,0;;;;;;;;;;2,0;;;;;;;2,0;3,0;;;;;1,0;;;;14,0;;;;;;;;;;;;;;;;5,0;;;2,0;;;;;;7,0;1,0;;;;;1,0;;;;;1,0;;;7,0;;;;;;;;;3,0;5,0;2,0;;;;;;;;;;;;;;;;23,0;;;;;;2,0;;;;;;;;;;;;;;;;;;;;;;;;;;;;;;;5,0;;;;1,0;;;;;;1,0;;;;;;;;;;;;;;;;;;;;;;;;;;;;;;;;3,0;;;;;;;;;;;;;2,0;;;;1,0;;;;;2,0;;;;;2,0;;2,0;;4,0;;;;;;;2,0;;;;;;;;;10,0;;;;;;;;;;;11,0;;5,0;;;;;;;4,0;;;;;;2,0;;;;;;;;;;;;;;;;;;;;;;;;;;;;;;;;;;;;;;;;;;;;;;;
client;;;;4,0;3,0;1,0;6,0;;;;;;;13,0;;;17,0;;;;;;21,0;14,0;35,0;;;3,0;11,0;5,0;17,0;;2,0;;;85,0;;1,0;;3,0;27,0;524,0;;4,0;56,0;;;;;;;;;2,0;;;;;2,0;10,0;;;;;61,0;9,0;32,0;;2,0;;;;4,0;;;;;;3,0;2,0;48,0;;;;18,0;;;4,0;;1,0;6,0;4,0;;;;;1,0;;13,0;;9,0;1,0;;2,0;6,0;29,0;1,0;8,0;;;;5,0;2,0;;;;2,0;;2,0;;;;6,0;;;2,0;45,0;;;;14,0;;;2,0;;;29,0;;1,0;;;;;;;11,0;2,0;;38,0;6,0;;;;2,0;;;;;;;;7,0;18,0;;;;6,0;;;;2,0;;2,0;2,0;;;;;3,0;;;;;;;;;;7,0;;;5,0;;;;;1,0;;;;;;;;;2,0;;;;1,0;1,0;;11,0;;;;10,0;;2,0;1,0;;1,0;1,0;;;;61,0;;1,0;1,0;;;6,0;;;;;;;6,0;;;;;;6,0;;;;;;;;;;;1,0;;;;8,0;48,0;;29,0;;;;;;;;;;1,0;;;12,0;;;;;;;;;;;3,0;;;;;;;;;3,0;;;;;;;;;;;;;4,0;;;;;;;7,0;;;1,0;10,0;1,0;1,0;;;;;;;;;;;;2,0;;;;3,0;;;;;;;1,0;2,0;;1,0;;;;1,0;;;;2,0;;96,0;23,0;;;;4,0;;;5,0;;;;;1,0;6,0;;6,0;;;12,0;;;20,0;;;;4,0;6,0;1,0;;;3,0;;38,0;6,0;4,0;;;;7,0;1,0;;;16,0;;3,0;;3,0;;4,0;;;;4,0;;;12,0;5,0;;;;;;;;4,0;;80,0;28,0;25,0;4,0;;;6,0;8,0;;;;5,0;;3,0;;;20,0;9,0;;5,0;12,0;;;111,0;;19,0;;4,0;;;6,0;;;;;22,0;;;7,0;;2,0;;1,0;;;6,0;;31,0;68,0;;;;1,0;;;;;;8,0;;;13,0;;;;;;;;;;3,0;3,0;7,0;;;34,0;5,0;;1,0;;;1,0;;3,0;1,0;1,0;;;;27,0;;;;;23,0;;;;;1,0;;1,0;;;;;;;;11,0;;3,0;;;2,0;3,0;;;3,0;;;5,0;;;;;;;75,0;16,0;;;;;;;1,0;;4,0;;5,0;;20,0;;;;;;;;;;;;;;;;;;;;;2,0;;;;1,0;;1,0;;;;;;;;;42,0;1,0;;;;;;1,0;;;;;;;1,0;1,0;1,0;;;;;;;;;11,0;;;;43,0;;9,0;;;;;2,0;;;;;;;;1,0;;;;;;;;3,0;;;;;14,0;36,0;17,0;;;3,0;;;3,0;3,0;4,0;1,0;;;;;;;1,0;;;1,0;2,0;;;;;;;;;;;;;1,0;;;;;;;;;;;;;;;;;2,0;;;;;;3,0;6,0;;;1,0;;;;;;;;;;;;;;;;;;;;;;;;;;;;;;;;;;;;;;;;;;;;;;;;;;;;;;;;;;1,0;;;;;;;;;;;;;;;;;;;;;;;;;;;;;;;;;;;;8,0;;;;;12,0;3,0;;;;12,0;;;;;;;;1,0;;;;;;;;;;;;;;;;;;;;;;;;;;;;;;;;;;3,0;;;;;;;3,0;;;;;;2,0;3,0;;;;;;;2,0;1,0;;;;;;1,0;;;;;2,0;;2,0;;;1,0;;;;2,0;;;;;;;;;;;;;;;2,0;;;;;;;;;;;;;;;;;1,0;;;;;;;;;;;;;;;;;;;;;;;;;;;;3,0;;;;;;;;;;;;;;3,0;;;;;;;;;;;;;;
coat;;;;4,0;;7,0;7,0;7,0;;;;1,0;2,0;3,0;;;;;;18,0;8,0;;7,0;;2,0;;;7,0;;;11,0;;1,0;;;;6,0;;;;8,0;31,0;;;;5,0;;12,0;;;;;2,0;;;;44,0;;;;18,0;;;;23,0;;28,0;;;;1,0;40,0;23,0;;;;90,0;;5,0;;23,0;;;;47,0;;;26,0;;1,0;;;13,0;1,0;;;1,0;2,0;8,0;2,0;2,0;;2,0;1,0;;1,0;;;1,0;;1,0;;3,0;;;;;1,0;;4,0;;;17,0;;;;10,0;;;4,0;;;;4,0;;;1,0;;;4,0;;;;;1,0;16,0;9,0;;;1,0;;3,0;2,0;4,0;;;;;6,0;2,0;22,0;;;;;;2,0;27,0;;1,0;1,0;;;2,0;;;;;;;;;;3,0;;20,0;39,0;;;14,0;1,0;;3,0;;3,0;1,0;58,0;1,0;5,0;;;60,0;;1,0;;;72,0;5,0;6,0;3,0;;;;8,0;;17,0;1,0;;28,0;;8,0;;;;4,0;;32,0;;1,0;;;;1,0;;20,0;;11,0;33,0;;;7,0;;;;2,0;1,0;1,0;;11,0;;;;;3,0;14,0;;;102,0;1,0;;;1,0;;8,0;;5,0;1,0;2,0;;15,0;;1,0;4,0;;;;;4,0;;2,0;;;2,0;2,0;;;;;5,0;;1,0;;;;;;;1,0;1,0;3,0;;;;;;1,0;;1,0;;5,0;1,0;;6,0;;;;;;1,0;1,0;;2,0;4,0;;;;;;;2,0;1,0;;;;;1,0;;;;;;;;;;1,0;;1,0;;2,0;;;;1,0;1,0;;;9,0;;;;;;;;;;;;;;;;2,0;;;;;;;;;;;1,0;2,0;3,0;;;;;;;;;;;;;;;;;1,0;;;;;;;;3,0;;;;;1,0;;;;;;;;;2,0;;1,0;;;;;;;;;;8,0;;;1,0;7,0;;;;;;4,0;;;;;;;;;;;;3,0;;;;7,0;;;1,0;;;;9,0;;;1,0;5,0;;;;;;1,0;;;;;;;1,0;;;;16,0;3,0;;;6,0;1,0;;;;;;2,0;;;;;;;;;1,0;;;;;1,0;4,0;;;;4,0;;1,0;;;;;;;;;;5,0;;;;;;;;;5,0;2,0;;;;3,0;;;;;;;;3,0;;;;;;;4,0;;;;;;;8,0;;;;2,0;;;;;;;;;;;;;;;;1,0;;;;;;;;;;;;;;17,0;;;;;;;;;;7,0;;;;;;;;;;;;;;;;;;;;;;;;;;;;;3,0;;;;;7,0;;;;;;;;3,0;;;;;;;;;13,0;1,0;;;;;;;;;;;;;1,0;;;;;1,0;;;;10,0;;;;;;;;13,0;;;;;2,0;;;6,0;1,0;;;;;;3,0;;3,0;;;1,0;;;;1,0;;;;;;;;;;;;2,0;4,0;;;;;;;5,0;;;1,0;;;3,0;;2,0;;;;;;;1,0;;;;;;;;;;;;;;;;;;;;;;;;3,0;;;;;;17,0;1,0;;;;;;;;;;;;;;;;;1,0;;;;;;;;;;1,0;;;;1,0;;;;;;;;;;2,0;2,0;;1,0;;;;;;1,0;;;1,0;;2,0;;;;;;;;;;;;;;;;;;;;;;;;;;;;;;;;;;;;;;;;;;;;;2,0;;;;;;;1,0;;;;;;;;;;;;;;4,0;;;;;;;;3,0;;;;;;;;;;;;;;;;;1,0;;;;;;;;;;;;;;;;10,0;;;;;;;;;;;;;;;;3,0;1,0;;;;;;;;;;;;;;1,0;;;;;;;;;;;;;1,0;;;;;;;;
coil;;;;9,0;4,0;146,0;1,0;75,0;;;1,0;;57,0;227,0;;;2,0;;3,0;;5,0;;;;2,0;1,0;23,0;40,0;;;243,0;17,0;14,0;44,0;;3,0;12,0;2,0;2,0;;19,0;100,0;12,0;;1,0;707,0;1,0;39,0;;;1,0;2,0;24,0;8,0;19,0;;89,0;;17,0;39,0;1,0;;;;124,0;1,0;427,0;3,0;;28,0;30,0;534,0;10,0;1,0;;1,0;8,0;;;4,0;36,0;;1,0;1,0;390,0;60,0;;179,0;;9,0;;15,0;28,0;19,0;;2,0;;23,0;151,0;5,0;196,0;5,0;;;;3,0;;3,0;;;;18,0;15,0;5,0;3,0;;;34,0;;141,0;1,0;;196,0;;;10,0;22,0;;3,0;;4,0;1,0;;383,0;18,0;;9,0;;1,0;;1,0;31,0;;;2,0;191,0;12,0;124,0;9,0;28,0;8,0;4,0;37,0;21,0;1,0;7,0;36,0;1,0;;;52,0;191,0;;15,0;4,0;;126,0;50,0;;29,0;8,0;;;341,0;;4,0;46,0;;2,0;1,0;4,0;2,0;11,0;470,0;;;;75,0;73,0;13,0;;;15,0;27,0;154,0;23,0;296,0;;49,0;5,0;2,0;16,0;1,0;4,0;8,0;;255,0;3,0;;131,0;139,0;31,0;2,0;;;121,0;15,0;25,0;3,0;6,0;71,0;2,0;;;15,0;;264,0;;3,0;7,0;11,0;1,0;4,0;2,0;8,0;;2,0;;;3,0;;26,0;2,0;2,0;7,0;1,0;13,0;53,0;173,0;;;;3,0;44,0;71,0;142,0;86,0;263,0;33,0;;3,0;28,0;1,0;10,0;22,0;;;;;3,0;;50,0;121,0;18,0;;;3,0;10,0;44,0;2,0;;128,0;202,0;136,0;;;59,0;4,0;182,0;2,0;;1,0;;6,0;7,0;1,0;64,0;44,0;54,0;1,0;;1,0;8,0;56,0;;30,0;;1,0;2,0;7,0;;;49,0;;;;44,0;1,0;9,0;10,0;11,0;7,0;137,0;35,0;;53,0;;5,0;114,0;21,0;11,0;;;2,0;;5,0;;1,0;;;2,0;3,0;;;2,0;;;63,0;;69,0;4,0;;1,0;;3,0;;2,0;71,0;;1,0;3,0;;;;;;;2,0;2,0;2,0;2,0;;2,0;35,0;11,0;;;1,0;1,0;;95,0;6,0;1,0;2,0;;39,0;;;;;2,0;1,0;;14,0;10,0;4,0;;;;;;10,0;2,0;2,0;14,0;12,0;;;1,0;276,0;3,0;204,0;;1,0;5,0;2,0;8,0;;1,0;;;;;;;85,0;;26,0;;;35,0;;;;;;1,0;1,0;4,0;;;97,0;;56,0;;2,0;;;;10,0;;93,0;2,0;1,0;6,0;;;;;;;;;4,0;;;;;;;;;1,0;1,0;3,0;;;;1,0;1,0;986,0;;;;;;3,0;;1,0;;;3,0;;2,0;17,0;;;;;75,0;;;16,0;;;30,0;;4,0;;;;4,0;;;9,0;3,0;;10,0;;6,0;2,0;9,0;;26,0;;;;;;;;;;12,0;19,0;1,0;9,0;;2,0;2,0;;;;9,0;;;;;1,0;;;1,0;;;;;;11,0;1,0;;;6,0;1,0;;;;;293,0;2,0;;;16,0;;5,0;9,0;;1,0;;5,0;;;;;3,0;3,0;;2,0;;;;;;2,0;;;;;;;;;;;;20,0;;;;;2,0;1,0;3,0;;2,0;;2,0;;;;;;;1,0;;;;;;;;9,0;;;;4,0;;;1,0;26,0;2,0;1,0;;;;2,0;43,0;;;;5,0;;;1,0;;11,0;1,0;3,0;1,0;;;;;;9,0;31,0;;1,0;;6,0;;17,0;1,0;23,0;;;;;;;;;;;20,0;14,0;;3,0;;15,0;1,0;;;;;;15,0;2,0;6,0;;;;;9,0;230,0;579,0;;;1,0;;;;1,0;6,0;;;;;30,0;;2,0;;3,0;1,0;;2,0;5,0;4,0;;1,0;;;13,0;;;77,0;;;4,0;2,0;1,0;10,0;;6,0;1,0;;11,0;;;2,0;9,0;17,0;250,0;;;33,0;;1,0;;5,0;;25,0;;;8,0;;1,0;2,0;;;;3,0;;2,0;;;1,0;;;21,0;;;;;;;1,0;31,0;15,0;2,0;;1,0;;1,0;1,0;;;;;;;;2,0;2,0;;4,0;;;;;;4,0;;;;;;;20,0;;;;3,0;;;2,0;;;;;13,0;;1,0;;;;4,0;6,0;1,0;1,0;;3,0;;;;;;;;;;;;4,0;1,0;;1,0;;;;;;2,0;;;;1,0;;;;;;;;3,0;;;;;;;;1,0;;;;;;;;2,0;;2,0;;;;;;;;;;;;;;4,0;1,0;;2,0;;;;;;1,0;;1,0;;;37,0;;;11,0;;;1,0;8,0;;17,0;;;4,0;;45,0;1,0;11,0;21,0;1,0;;21,0;8,0;;;3,0;1,0;24,0;;;;;;102,0;1,0;;;;;;;;;;;;;;;;;;;;1,0;;;;;;1,0;;;;;;;;;;;;;;;;;;;;;
combine;;;;11,0;3,0;22,0;20,0;3,0;;2,0;5,0;1,0;1,0;28,0;;10,0;110,0;;1,0;2,0;7,0;85,0;28,0;;2,0;1,0;;7,0;15,0;3,0;94,0;22,0;9,0;7,0;;191,0;26,0;4,0;23,0;;48,0;57,0;;14,0;60,0;;1,0;16,0;4,0;;2,0;;1,0;2,0;77,0;26,0;138,0;;3,0;151,0;2,0;;18,0;1,0;1223,0;5,0;95,0;9,0;6,0;2,0;18,0;81,0;25,0;;2,0;;12,0;7,0;;4,0;136,0;;23,0;7,0;32,0;4,0;;58,0;;12,0;8,0;3,0;;41,0;2,0;;77,0;12,0;136,0;22,0;24,0;10,0;2,0;10,0;36,0;49,0;;2,0;;;;30,0;37,0;;;1,0;26,0;14,0;20,0;47,0;8,0;;106,0;8,0;;7,0;44,0;2,0;1,0;1,0;3,0;8,0;;76,0;;;155,0;9,0;6,0;;;9,0;;1,0;2,0;21,0;21,0;1,0;4,0;;;18,0;12,0;5,0;11,0;;2,0;1,0;3,0;;;6,0;19,0;2,0;;;7,0;10,0;;2,0;5,0;;16,0;11,0;;9,0;;;1,0;;;;;15,0;;;12,0;1,0;93,0;4,0;2,0;1,0;;1,0;5,0;3,0;16,0;;1,0;;;11,0;1,0;2,0;6,0;3,0;8,0;;8,0;6,0;;;1,0;1,0;;1,0;74,0;3,0;9,0;13,0;3,0;4,0;3,0;2,0;1,0;;118,0;;;17,0;;2,0;14,0;10,0;1,0;2,0;8,0;1,0;;24,0;;;;;;10,0;12,0;3,0;8,0;;;;6,0;46,0;9,0;1,0;5,0;23,0;1,0;;6,0;6,0;6,0;4,0;;;;5,0;9,0;1,0;;1,0;1,0;4,0;;;3,0;2,0;;;3,0;;2,0;;;;;4,0;;;;12,0;;1,0;17,0;;7,0;;2,0;;;;1,0;6,0;;;5,0;2,0;;13,0;1,0;1,0;2,0;2,0;;;1,0;1,0;;2,0;3,0;41,0;;17,0;;;1,0;1,0;;;;;;;5,0;8,0;;;;;2,0;;;;;1,0;11,0;2,0;;5,0;;;2,0;1,0;8,0;;;1,0;114,0;;;;;;;4,0;;;;;;;13,0;4,0;;;2,0;2,0;5,0;;13,0;12,0;;5,0;2,0;26,0;10,0;6,0;7,0;3,0;6,0;2,0;16,0;5,0;;22,0;;13,0;3,0;;;9,0;4,0;15,0;2,0;10,0;9,0;4,0;9,0;;;4,0;;6,0;1,0;6,0;;;;;;;;7,0;;34,0;2,0;4,0;;;3,0;;8,0;3,0;;;2,0;15,0;2,0;6,0;6,0;;3,0;;10,0;;;;5,0;;;;;1,0;;;4,0;3,0;2,0;11,0;9,0;;3,0;29,0;;7,0;3,0;1,0;;;6,0;7,0;3,0;1,0;;;2,0;;;;5,0;;1,0;13,0;4,0;9,0;37,0;2,0;1,0;;;1,0;;3,0;1,0;;;1,0;2,0;;6,0;20,0;;;;;;;;;18,0;3,0;3,0;;;7,0;1,0;;;;;1,0;3,0;;;3,0;;2,0;4,0;;;;;3,0;;;2,0;;;3,0;14,0;6,0;;;5,0;1,0;;14,0;5,0;4,0;;;;2,0;;;5,0;8,0;1,0;;;;7,0;9,0;5,0;;35,0;1,0;3,0;4,0;;;;;5,0;1,0;4,0;6,0;;;;;90,0;1,0;;6,0;;2,0;;;;;;;;1,0;;;;;1,0;;;28,0;14,0;11,0;;2,0;1,0;2,0;2,0;;;3,0;1,0;;1,0;;2,0;2,0;;;4,0;3,0;;7,0;;;;1,0;;1,0;;1,0;3,0;;;;4,0;9,0;;1,0;;;;6,0;;;5,0;;2,0;1,0;3,0;3,0;;4,0;1,0;;28,0;4,0;;;3,0;8,0;2,0;;7,0;;;;8,0;;;;5,0;3,0;;9,0;82,0;3,0;;;1,0;;1,0;;2,0;1,0;;;;;3,0;;;;1,0;;;;;2,0;2,0;;;;;1,0;;;2,0;;;3,0;1,0;4,0;;1,0;;;;;8,0;;;;;2,0;1,0;13,0;;;;1,0;7,0;;;;8,0;;;;;;1,0;1,0;2,0;1,0;8,0;;2,0;;3,0;5,0;3,0;;;1,0;1,0;;;;;;;;;;;;3,0;;3,0;;;;7,0;;2,0;;;;;;;;1,0;;;;2,0;;5,0;;;;;;;;;;;1,0;;2,0;;;;;;3,0;4,0;;;;7,0;;;;;;;;;35,0;;28,0;2,0;;1,0;;1,0;;3,0;1,0;8,0;7,0;;;1,0;2,0;;;;2,0;1,0;;5,0;;2,0;2,0;;;3,0;;8,0;6,0;2,0;;11,0;;;;;8,0;;;5,0;;;;2,0;;;1,0;;5,0;10,0;4,0;;;;1,0;;;;;12,0;;;1,0;;;;1,0;;;;;;;;;4,0;2,0;2,0;;3,0;;;1,0;;;;;;;4,0;;;;1,0;;;1,0;3,0;;;;;1,0;;;3,0;;;;;;;1,0;1,0;;2,0;;;2,0;;;;;;1,0;;;;;;18,0;1,0;2,0;;;;;3,0;;;;6,0;3,0;;;1,0;3,0;1,0;2,0;;;;24,0;2,0;;2,0;3,0;;;;;4,0;3,0;;;;;;;;
communications;;;;2,0;;17,0;;2,0;;;;;;2,0;;;15,0;;11,0;;3,0;;;11,0;21,0;;;10,0;7,0;;60,0;2,0;;;;48,0;;;1,0;1,0;6,0;388,0;;4,0;36,0;;;5,0;;;;;1,0;3,0;68,0;;;;;2,0;;;4,0;;45,0;2,0;22,0;;;;3,0;16,0;4,0;1,0;;;;;9,0;5,0;53,0;;29,0;;62,0;;;4,0;;;;;;4,0;3,0;;2,0;;39,0;;8,0;2,0;;1,0;10,0;38,0;;7,0;;;;;2,0;;;;3,0;2,0;;7,0;2,0;;26,0;;;7,0;61,0;;1,0;;4,0;;;17,0;;;2,0;;2,0;;;;1,0;;;;4,0;3,0;24,0;;;1,0;18,0;;1,0;;;;;;;34,0;2,0;;;;36,0;;;;;;52,0;2,0;3,0;;;;8,0;;;;;4,0;;;;;;;;;1,0;;1,0;;10,0;;5,0;;;;1,0;3,0;;14,0;;;;;;;;;;6,0;7,0;1,0;;;;;;;;;1,0;;1,0;;;3,0;9,0;;2,0;;;;;;;;;;1,0;35,0;5,0;;;;;;;1,0;;7,0;21,0;4,0;;1,0;36,0;31,0;;11,0;;;;;;;;9,0;;10,0;;;6,0;;;1,0;;1,0;;2,0;;;;;43,0;;;;;;;;;9,0;;;;;;;;;;1,0;1,0;10,0;;;1,0;;;;4,0;;1,0;1,0;118,0;3,0;;;;;;;31,0;;;;;;2,0;;;;;;;;;;;;;;;;;;;;1,0;;2,0;;55,0;127,0;;;;1,0;;;;;;;;;;;;;;3,0;;;32,0;;;;;5,0;;1,0;;1,0;;7,0;;;1,0;2,0;;;1,0;;;11,0;4,0;;;5,0;;1,0;1,0;2,0;;1,0;;7,0;12,0;2,0;;;;;;;;;;41,0;12,0;3,0;;;;2,0;;;;;30,0;9,0;6,0;;;9,0;4,0;;;3,0;;;39,0;;;3,0;1,0;;;;;;;2,0;20,0;;;1,0;;;;;;;;;8,0;100,0;;;;42,0;6,0;;1,0;;8,0;1,0;;;12,0;13,0;22,0;;;;;;6,0;;8,0;1,0;;;;4,0;3,0;11,0;;;;4,0;;;10,0;;;;;11,0;;;;;41,0;;;;;;;;;;;;;;;4,0;;;;;;;;1,0;;;;;15,0;;;;;1,0;14,0;;;;;;2,0;;1,0;;;;3,0;4,0;7,0;;;5,0;;;;;;;;17,0;;;;9,0;5,0;;;;;;;;;;;1,0;;;;2,0;;1,0;;;7,0;16,0;;;;;;;;;;;;;;;3,0;;;;66,0;1,0;;;2,0;1,0;;;;196,0;1,0;;1,0;;;;2,0;;;1,0;;19,0;;;20,0;;;3,0;;;;;;;;;;10,0;8,0;2,0;;;1,0;7,0;;16,0;5,0;1,0;;1,0;;;;;20,0;;;;2,0;9,0;1,0;;2,0;;;1,0;4,0;;;;1,0;;;;;;;;;;;;;;;1,0;;;;;;;;6,0;6,0;;2,0;;;1,0;;1,0;;;;;;;;1,0;;;;;;;;;;;;;;;;;;;5,0;;;;;;;;4,0;;;;;;;;;;;;;;;;;;;;;;;;1,0;;;;;;;;;;;;;;1,0;;;;;;;;;;;;;;;;;;;;3,0;;;;;;;;;;;;;;1,0;;;;;;;;;;;;;;;;1,0;;;;;;;;;;;;;;;;;;;;;26,0;;;3,0;;;;;1,0;;;;;12,0;1,0;2,0;;;;;;;;5,0;;;;;5,0;;;2,0;;;;2,0;;;;;;;;;;;;;;;;17,0;;;;;;1,0;;;;;;;;;;;;;7,0;1,0;;;;;;;;;1,0;;;;;3,0;;;;;;;;;;;;;;;;;2,0;;;;;;;;;5,0;;;;;;1,0;;;;;;;;;;;;;
comparator;;;;2,0;;11,0;7,0;;;;;;;9,0;;;;;;;;;;;;;1,0;1,0;;6,0;109,0;2,0;;;;6,0;;1,0;;;15,0;58,0;;29,0;;16,0;;;;;;;;;;;3,0;;;8,0;;;1,0;;12,0;;148,0;;;;;;1,0;;;;;3,0;;38,0;;;7,0;;;;;;;;;;;;;;37,0;;137,0;4,0;;10,0;;;14,0;3,0;;;;;;59,0;;;;;;11,0;;4,0;1,0;;150,0;;;16,0;9,0;;;;39,0;;;40,0;;;;;;;;8,0;;;;2,0;;7,0;;;2,0;;;;2,0;2,0;;;;;;33,0;;;29,0;;27,0;;;2,0;4,0;;;9,0;;;;;;;;1,0;;;;;1,0;;4,0;4,0;;;;6,0;;7,0;2,0;;;;;;;;2,0;;;;;;;;10,0;;;;142,0;;;;;5,0;;;;;14,0;;;;;;;;;;;;;;;;;;;;;1,0;1,0;;;;;;3,0;2,0;;;;;1,0;1,0;;;;;;;;;;;;;;;;;;;;;;;;;;;125,0;;;;;;;;;;;;;;;;;;;;;43,0;;;;19,0;;;;;;;2,0;;;5,0;;;1,0;;6,0;;;;;;;;;;;;;;;;;;;;;;;;;;;;2,0;20,0;;3,0;;;;;2,0;1,0;;;;;;;;;3,0;;;;35,0;39,0;24,0;;;;1,0;4,0;;;;5,0;;;;1,0;;1,0;;1,0;;;;36,0;;6,0;;;;;;;;;;;35,0;;;;;;;1,0;;4,0;;44,0;;1,0;;;4,0;;1,0;;2,0;;;;19,0;;;23,0;;;;;;;;;;54,0;;;;;;4,0;;;;;66,0;;;;;;;;;;;;;;;;3,0;;;;;;;;10,0;;;;;;2,0;;3,0;;;;;;;;;;;4,0;;;;;4,0;;;;;1,0;;;;;;;;;;3,0;1,0;;;;;;;;;;;;;2,0;;;;;;;;20,0;1,0;;;;;;;3,0;;;;;;;;;;;;;;;;;;;;;;;;;;;;;;;4,0;;2,0;;;;;;;;;;;;;;;;;;;;;4,0;;1,0;;;;;;;;;;;2,0;;;;;;;;;;;;;;;1,0;;;;;;;7,0;;;;;;17,0;;2,0;;;;;1,0;2,0;;;;;;;1,0;;;;;1,0;;;;;;;;;;;;;;;6,0;;;;;2,0;;2,0;;;;;;;;;;;;2,0;;;;;;;;;;1,0;;;;;;;;;;;;;;;;;;;;;;;;;;;;;;;;;;;;;;;;;;;;;;;;;;;;;;;;;;;;;;;;;;;;;2,0;;;;;1,0;;35,0;;;7,0;;;15,0;52,0;;;2,0;;1,0;;;;;;;;3,0;;;4,0;10,0;;2,0;;;;;;;;20,0;1,0;;;;;;13,0;1,0;;;;;;;;;;;;;;;;;;;;6,0;;;8,0;;;;;;;;;;;;;;;;;6,0;;;;;;;;;;;;;;;;;;;;;;;;;;;;;;;;;;;;;;;;;;;;;;;;;;;;;;;;;;;;;;;;;;;;;25,0;;;;;;;;;;;;;;;;;;;;;;1,0;;;;;;;;;;;;;;;;;;;;;;;;;;;;;;;;9,0;;;;
compare;;;;18,0;36,0;17,0;8,0;3,0;;10,0;;9,0;1,0;117,0;1,0;16,0;112,0;3,0;13,0;50,0;1,0;;51,0;;1,0;4,0;1,0;19,0;22,0;11,0;107,0;27,0;3,0;12,0;2,0;197,0;5,0;1,0;67,0;3,0;177,0;125,0;;41,0;8,0;1,0;1,0;8,0;;1,0;47,0;;;1,0;27,0;2,0;9,0;;11,0;47,0;;1,0;18,0;1,0;912,0;1,0;99,0;4,0;1,0;;;46,0;26,0;2,0;1,0;6,0;2,0;8,0;4,0;8,0;147,0;;25,0;60,0;29,0;;;8,0;;2,0;45,0;1,0;3,0;14,0;7,0;2,0;282,0;1,0;116,0;87,0;99,0;69,0;;37,0;23,0;59,0;2,0;13,0;45,0;3,0;;139,0;73,0;19,0;;16,0;1,0;19,0;27,0;58,0;5,0;;313,0;21,0;;68,0;68,0;;9,0;2,0;64,0;4,0;3,0;49,0;;;36,0;5,0;5,0;;;3,0;;;;8,0;27,0;6,0;26,0;;;11,0;8,0;2,0;1,0;;;;;;;1,0;1,0;;;2,0;1,0;4,0;;10,0;7,0;10,0;1,0;14,0;3,0;45,0;6,0;;;;3,0;;;23,0;;;3,0;;99,0;2,0;10,0;2,0;;4,0;3,0;3,0;3,0;3,0;1,0;;;;3,0;9,0;21,0;9,0;4,0;;;4,0;;19,0;14,0;;;3,0;68,0;1,0;1,0;4,0;32,0;10,0;8,0;;;;31,0;3,0;;3,0;;1,0;16,0;4,0;;5,0;;13,0;;6,0;;;;;;37,0;2,0;22,0;7,0;;;;1,0;12,0;;2,0;2,0;17,0;;;2,0;3,0;;44,0;;;1,0;2,0;7,0;;;;;3,0;;;;35,0;;;;12,0;5,0;;12,0;;;4,0;81,0;;1,0;5,0;;;14,0;;28,0;7,0;;;;;;2,0;;;;3,0;18,0;20,0;;;;;13,0;;2,0;;2,0;2,0;8,0;150,0;3,0;5,0;;;;;16,0;;;;;;7,0;;;;;;2,0;9,0;13,0;;;1,0;21,0;2,0;;;1,0;;9,0;;20,0;;1,0;;35,0;4,0;4,0;1,0;;;;8,0;6,0;5,0;1,0;;;;47,0;6,0;36,0;2,0;;1,0;;19,0;52,0;42,0;;;1,0;73,0;3,0;39,0;11,0;4,0;1,0;8,0;19,0;9,0;;13,0;;50,0;11,0;2,0;2,0;15,0;5,0;141,0;;73,0;2,0;4,0;49,0;;;7,0;10,0;2,0;25,0;65,0;;;;2,0;1,0;23,0;6,0;8,0;3,0;64,0;17,0;15,0;;3,0;18,0;;19,0;5,0;35,0;;4,0;31,0;6,0;6,0;26,0;10,0;140,0;1,0;6,0;5,0;4,0;6,0;51,0;2,0;6,0;52,0;1,0;;;;2,0;28,0;;4,0;38,0;;19,0;4,0;7,0;5,0;;2,0;2,0;1,0;;2,0;20,0;;;2,0;;;5,0;2,0;;4,0;3,0;7,0;3,0;6,0;34,0;7,0;1,0;18,0;2,0;6,0;19,0;4,0;5,0;;4,0;;3,0;1,0;;11,0;;;26,0;;;;11,0;10,0;9,0;9,0;;1,0;1,0;6,0;;2,0;;;;;;;3,0;1,0;;;;;;8,0;;1,0;7,0;;;1,0;2,0;37,0;14,0;9,0;;;;31,0;2,0;;;4,0;;;5,0;11,0;;4,0;5,0;4,0;;15,0;4,0;3,0;10,0;6,0;14,0;1,0;31,0;1,0;4,0;1,0;;;;;1,0;1,0;3,0;12,0;;1,0;;;1,0;;7,0;;;;5,0;5,0;;4,0;;16,0;4,0;;2,0;;24,0;2,0;18,0;2,0;5,0;235,0;1,0;5,0;;;;8,0;;;3,0;1,0;;;4,0;7,0;2,0;18,0;;;19,0;28,0;;;2,0;;1,0;5,0;1,0;1,0;;2,0;3,0;2,0;;;;9,0;;1,0;1,0;;20,0;;2,0;;;;;;3,0;;2,0;1,0;10,0;4,0;9,0;4,0;1,0;;2,0;2,0;;;;;;1,0;13,0;4,0;3,0;5,0;4,0;14,0;;;68,0;10,0;3,0;1,0;;8,0;;1,0;;;;;;;3,0;;;;1,0;1,0;;;2,0;;1,0;2,0;4,0;;;;;2,0;;;;1,0;;5,0;;;2,0;9,0;;;;;;1,0;;;;14,0;2,0;1,0;;;35,0;;;;1,0;;2,0;;1,0;;;3,0;;;;2,0;;;;;;;4,0;3,0;;;;;;;;;;;4,0;;23,0;;6,0;;;3,0;;;5,0;;;;;;;5,0;;5,0;;;3,0;1,0;29,0;2,0;35,0;;4,0;;;;;;;18,0;;14,0;;5,0;16,0;5,0;1,0;8,0;;;7,0;14,0;;;2,0;14,0;;11,0;6,0;;22,0;1,0;;2,0;;;4,0;12,0;3,0;;16,0;2,0;2,0;1,0;;6,0;2,0;;;6,0;5,0;1,0;;;;5,0;1,0;;;;6,0;10,0;4,0;;1,0;1,0;12,0;;;17,0;1,0;1,0;13,0;;;;4,0;7,0;4,0;7,0;;3,0;4,0;;;1,0;;2,0;2,0;4,0;;14,0;;11,0;;;2,0;;29,0;;;;;;2,0;;;1,0;;;22,0;;2,0;10,0;;1,0;;;;2,0;;;;1,0;1,0;;;1,0;2,0;2,0;1,0;10,0;1,0;3,0;;;18,0;2,0;;1,0;3,0;;;;;;;15,0;2,0;;;;;;;;;;;;3,0;;;;;15,0;;;1,0;;;;1,0;3,0;;4,0;;;;;5,0;;3,0;1,0;;;;6,0;;2,0;;13,0;;;9,0;;3,0;;;1,0;2,0;15,0;;;;5,0
comparison;;;;13,0;6,0;20,0;17,0;;;;;6,0;;307,0;;21,0;18,0;;2,0;24,0;;;22,0;;;;;18,0;5,0;2,0;59,0;5,0;8,0;2,0;;23,0;2,0;1,0;5,0;;128,0;43,0;;8,0;9,0;;;2,0;;8,0;10,0;;;;4,0;2,0;2,0;;;50,0;;;1,0;;241,0;;25,0;1,0;1,0;;2,0;17,0;6,0;;;5,0;;5,0;;2,0;45,0;;18,0;5,0;6,0;;;5,0;;;26,0;;2,0;;;;82,0;7,0;23,0;10,0;35,0;38,0;;1,0;3,0;15,0;1,0;4,0;1,0;;;47,0;42,0;4,0;;1,0;;15,0;4,0;24,0;3,0;;94,0;8,0;;18,0;24,0;;2,0;;40,0;;1,0;47,0;5,0;;8,0;2,0;1,0;;;;;;;1,0;12,0;;8,0;;1,0;4,0;;;;;;;;3,0;;3,0;;;;;;;;3,0;;8,0;5,0;9,0;;9,0;1,0;6,0;;;;;;;;;1,0;1,0;12,0;;;;;;;;;;;;;;;1,0;7,0;3,0;;;;;8,0;4,0;10,0;;;;78,0;;;2,0;7,0;4,0;2,0;;;;18,0;;;;;;20,0;;;2,0;;3,0;;8,0;;;;;;10,0;;;;;;;;2,0;;;;1,0;;;1,0;3,0;;23,0;;2,0;;;1,0;;;;;;;;2,0;10,0;;;;15,0;6,0;;1,0;;;;14,0;;;;;;;;12,0;;;;;;;2,0;;;;;3,0;11,0;;;;11,0;12,0;;;;;;;35,0;;2,0;;;;;;1,0;;;;;;;;;;;3,0;1,0;;;1,0;;;10,0;;;;;4,0;;;;;;8,0;;;2,0;;1,0;1,0;7,0;7,0;;3,0;1,0;;;23,0;;22,0;1,0;;;19,0;;18,0;24,0;1,0;;;18,0;10,0;36,0;7,0;4,0;;3,0;5,0;3,0;2,0;10,0;2,0;22,0;30,0;;;3,0;;24,0;;23,0;;;4,0;;;4,0;;1,0;29,0;25,0;;;5,0;;;;;1,0;1,0;30,0;2,0;18,0;;;3,0;;2,0;;3,0;;4,0;4,0;4,0;;8,0;1,0;45,0;;4,0;5,0;;;16,0;;;3,0;2,0;;;;;1,0;;1,0;20,0;;47,0;;;;;;;;;4,0;6,0;;;;;2,0;;;;;;2,0;1,0;;44,0;3,0;1,0;8,0;;;5,0;4,0;6,0;;;;;;;;;;;;;;4,0;;1,0;6,0;;;;4,0;;2,0;;;;;;;1,0;4,0;;;;;;;;;;;2,0;1,0;;10,0;;;;;;13,0;;;;;;;;;;4,0;;3,0;;8,0;4,0;;2,0;2,0;;;8,0;;1,0;;;;;;;;1,0;;;;;;;;1,0;1,0;;;52,0;;;7,0;;2,0;;;1,0;;1,0;1,0;4,0;;;27,0;;;;16,0;1,0;;;;1,0;;;;;2,0;;2,0;3,0;;5,0;16,0;;;;;;;;;;;;;;;;1,0;;;;;3,0;;1,0;;;1,0;4,0;1,0;;;3,0;;;;1,0;;;;1,0;;;;;;;;3,0;;;5,0;;;;1,0;7,0;2,0;;;;1,0;;;4,0;;;;;;2,0;1,0;1,0;;;9,0;;;;;;;;;;;;;;;;;;;;;;;;;;;3,0;;;;;4,0;;;;;10,0;;;;10,0;;;;;;;3,0;;;;;;;;;;;4,0;;;;;;;;;;;;;;2,0;;;;;2,0;;;;;;;;;;2,0;;;;;4,0;1,0;8,0;;39,0;;3,0;18,0;;;;;;12,0;;5,0;;;;3,0;14,0;2,0;;1,0;1,0;;1,0;;4,0;4,0;;3,0;;;8,0;;;14,0;;;;15,0;1,0;;2,0;;;1,0;;;;;;2,0;3,0;;;;3,0;;1,0;2,0;;2,0;1,0;34,0;2,0;;;;2,0;;;;;;;;;;2,0;;;;1,0;;;;;;;3,0;2,0;;;1,0;;;;;;;;1,0;;;;;;;;;;;2,0;2,0;;2,0;3,0;;;;;7,0;;;;;;;;;;;2,0;;;;1,0;;;;;;1,0;;;;;;;5,0;;;;;;;;8,0;;;;;;10,0;;;;6,0;;;;;;;;;;;;;;;4,0;;3,0;;;;;4,0;;;;21,0;;;6,0;;;;;3,0;;5,0;;;;
composite;;;;2,0;;3,0;34,0;4,0;;;;;;33,0;;;39,0;;1,0;;;;7,0;;1,0;;;18,0;4,0;11,0;13,0;3,0;;4,0;;59,0;4,0;15,0;3,0;;12,0;20,0;;10,0;46,0;4,0;;11,0;;;2,0;;;;7,0;25,0;34,0;;;121,0;;;16,0;;647,0;;76,0;1,0;1,0;2,0;30,0;61,0;;;2,0;3,0;2,0;;;2,0;67,0;;1,0;;33,0;1,0;1,0;3,0;;;6,0;;;;;;31,0;2,0;37,0;12,0;7,0;6,0;;7,0;17,0;13,0;;1,0;;;;20,0;16,0;1,0;;9,0;3,0;5,0;15,0;20,0;3,0;;14,0;;;19,0;34,0;2,0;;;27,0;;;12,0;;;19,0;1,0;3,0;;;4,0;;;1,0;1,0;19,0;2,0;10,0;;;1,0;;;;;;;;;;4,0;;;;;;;;;5,0;;1,0;1,0;;5,0;;;;;;;3,0;2,0;;;;;24,0;1,0;;;;2,0;;;;;;;;17,0;2,0;;2,0;3,0;3,0;7,0;;;;;;;;5,0;13,0;1,0;;;;2,0;;22,0;;;12,0;;;12,0;;;8,0;;5,0;;;;;15,0;;;;;;10,0;2,0;1,0;2,0;;;;;;7,0;3,0;2,0;1,0;5,0;;;2,0;1,0;5,0;;;;;5,0;;;;;;;;;;;;;;4,0;12,0;;;;;;;;2,0;;;1,0;;1,0;10,0;;;;;;;;;;3,0;;6,0;;;;;2,0;;;;1,0;;3,0;6,0;;3,0;;1,0;;;;12,0;;;;;;;;;;;;15,0;;;;;;;;;;;1,0;;;;;;10,0;;;;;;;;2,0;;;;;;1,0;;;2,0;;;1,0;;4,0;4,0;;;2,0;12,0;;;3,0;12,0;4,0;2,0;6,0;;;;;12,0;;;;5,0;2,0;;;16,0;18,0;;1,0;;;;;1,0;5,0;2,0;;2,0;1,0;;;2,0;;3,0;;4,0;;1,0;6,0;;1,0;1,0;2,0;;;;3,0;1,0;7,0;;;1,0;9,0;5,0;4,0;2,0;;;10,0;;;;;;;;3,0;;;6,0;1,0;3,0;;22,0;;;;;;;;;1,0;1,0;2,0;;;3,0;;;;1,0;;1,0;8,0;3,0;7,0;;3,0;;;;;;;;;;1,0;;;1,0;;;4,0;;6,0;;;;;1,0;;;5,0;;;;;;;;;;;;;;;1,0;;;;;11,0;;;;;;;;;;1,0;;;6,0;;12,0;1,0;;;24,0;;;;3,0;;;;;;;;;;;;2,0;;;;2,0;;;;;;;;;1,0;;;;;;;35,0;;;;;;;;;;;;;;1,0;3,0;;;2,0;;;4,0;2,0;1,0;;;;;;;;;;;1,0;;4,0;;;;12,0;;2,0;;;;;;;;;;1,0;;;;;;;;;;;;;;1,0;8,0;;1,0;4,0;;;;;;;;8,0;;;2,0;;;;2,0;2,0;;1,0;6,0;;;6,0;;;;3,0;;11,0;;;;;;;;2,0;;;;;;;;;;;;;;;;;1,0;;;1,0;;;;;;;;;;;;2,0;;;;;;;9,0;;;;;;;;;;;;9,0;4,0;;;;;;;;;;1,0;;;;;;;;;;;4,0;;;3,0;1,0;;;;;;;;;;;;2,0;;;;;3,0;;;4,0;;1,0;;;;;;;;;;1,0;;;2,0;1,0;21,0;3,0;;4,0;;;;;;;;;;;;;;;1,0;;;7,0;;;;;;;;;;;;;;;;;;;;1,0;;;;8,0;;1,0;;;;;;2,0;;;;;1,0;2,0;;;;8,0;;;;10,0;;3,0;4,0;;;;;;;;3,0;;1,0;;;;;;;;;;;;;;;;;1,0;;;;;;;;;;;;;;;;;;1,0;;;;;;;;;1,0;;;;;;;;;2,0;;;;;;;;;;;3,0;;;;;;;;1,0;;;2,0;;4,0;;;;;;;2,0;;;;;1,0;;;;;;14,0;;;;;;;2,0;;;;;2,0;;;
composition;;;;5,0;2,0;2,0;;;;2,0;;;1,0;3,0;3,0;1,0;7,0;;;;;2,0;3,0;;;;;15,0;1,0;;3,0;1,0;;2,0;;2,0;2,0;7,0;;;4,0;6,0;;;1,0;;;3,0;;;;;;;;;19,0;;;3,0;1,0;6,0;31,0;1,0;24,0;;25,0;;;;;1,0;18,0;17,0;;;13,0;;;;18,0;;;;44,0;;;;;1,0;1,0;;15,0;;;;3,0;3,0;;1,0;2,0;2,0;;;;;;;1,0;;;3,0;1,0;;;;;;;2,0;;;;;1,0;1,0;2,0;;3,0;;;4,0;;2,0;;;;;;20,0;;;;;;7,0;;;;;1,0;3,0;;;;;;6,0;;69,0;5,0;1,0;23,0;;;;;5,0;;;;;2,0;;;;1,0;;;;;;;4,0;;8,0;29,0;;;;;;;3,0;;;;;;;;6,0;;;1,0;1,0;1,0;10,0;;;;;;;;;;;8,0;;1,0;;;;;;;;;6,0;;1,0;14,0;1,0;;4,0;;;;25,0;40,0;1,0;;;;6,0;;;8,0;;;;;11,0;1,0;;;1,0;;;;;2,0;;;;;4,0;15,0;;;;1,0;;;;;;;;;;;;;;;;1,0;;;;;;;;;;;;;;;;;;;;;5,0;;;;;;;;;;1,0;1,0;4,0;;;;;1,0;;;;;;;;;;;;;;;;;;;;;;;;;;;;;;;;;;;;;;;4,0;2,0;;;;;;;;1,0;;;;;;2,0;6,0;;;;;;;;;;;;;;3,0;;;;;;;1,0;1,0;;;;;;;;;;;;;;;;;;;;;2,0;;;;;;;;;;;;;;;;2,0;1,0;;;;1,0;;;1,0;;;;;;;;;;;3,0;4,0;;;;;;;;;;;;;2,0;;;;2,0;;;;;;;;;3,0;;;;;;;;;;4,0;;;;;;;;;2,0;;;;;;;;;;;;;;;;;;;;;;;;;;;;2,0;;;;;;;;;;;;1,0;;;;1,0;;;;4,0;;;;;;;;;;5,0;;;;;;;;;;1,0;;;;;;;;;;;;;;;;3,0;;;;3,0;;;;;;;;;;;;;;;;;;;;;;;;;;;1,0;;;;;1,0;;;;;;;;;;;;;;;;1,0;1,0;;;;;;;;;;;;;;;;;2,0;;;;;;;;;;;1,0;;;;;;;;;;;;;;;;3,0;;;;;;;;;;;;;;;;;;;;;;;;;;;;;;;;;4,0;;;13,0;;;;;;;6,0;;;;;;;;;;;;;;;;;;;;;1,0;;;;2,0;;;;;;;;;;;;8,0;;;;4,0;;1,0;;;;;;2,0;;;;;;;;;1,0;;;;;;;;5,0;;;;;;;;;;;;;;;;;;;;;;;;;;;;;;;15,0;;;;;;;;;;;;5,0;;;;;;;;;;3,0;;;;;;;;3,0;;;;;;;;;;;;;;;;;;;;;;;;;2,0;;2,0;;;6,0;;;;;1,0;;;;;;;;;;;;2,0;;3,0;2,0;;;;;;;;;;;;;;;;;;;;;;;;;;;;;;;;;;;;;;;;;;;;;;;;;;;;;;;;;;;;;;;;;;;;;;;8,0;;;;1,0;1,0;;;10,0;;;;;;1,0;;;;;;;;
compute;;;;52,0;25,0;74,0;30,0;9,0;3,0;9,0;;;;186,0;1,0;;217,0;3,0;1,0;9,0;4,0;4,0;25,0;23,0;44,0;1,0;;28,0;63,0;25,0;263,0;8,0;9,0;24,0;;250,0;19,0;6,0;239,0;;277,0;2894,0;;49,0;238,0;13,0;;61,0;11,0;46,0;55,0;;5,0;19,0;33,0;9,0;2,0;;8,0;65,0;;;18,0;6,0;815,0;31,0;189,0;3,0;3,0;15,0;12,0;41,0;42,0;;;;4,0;13,0;21,0;54,0;408,0;;36,0;77,0;35,0;4,0;2,0;40,0;;5,0;124,0;5,0;5,0;1,0;1,0;;96,0;28,0;195,0;111,0;130,0;32,0;;50,0;39,0;306,0;47,0;60,0;3,0;;;35,0;49,0;2,0;;9,0;59,0;37,0;68,0;107,0;12,0;3,0;42,0;10,0;;69,0;648,0;;7,0;;78,0;11,0;4,0;91,0;4,0;;71,0;47,0;15,0;;;2,0;4,0;;1,0;26,0;19,0;20,0;62,0;13,0;;16,0;3,0;1,0;5,0;3,0;;;4,0;;;37,0;22,0;;;6,0;40,0;3,0;3,0;5,0;7,0;18,0;8,0;35,0;;27,0;1,0;1,0;39,0;;7,0;;7,0;13,0;;;6,0;;67,0;8,0;2,0;4,0;;;1,0;;42,0;1,0;13,0;5,0;;2,0;;;23,0;63,0;1,0;;6,0;22,0;8,0;31,0;11,0;;;5,0;25,0;23,0;4,0;5,0;17,0;8,0;6,0;;8,0;;43,0;;5,0;2,0;;11,0;17,0;14,0;2,0;6,0;7,0;2,0;;6,0;;;;;;46,0;11,0;10,0;30,0;6,0;;;3,0;5,0;;4,0;10,0;53,0;7,0;;28,0;33,0;10,0;42,0;1,0;;;5,0;29,0;6,0;;3,0;2,0;5,0;;;12,0;80,0;;1,0;2,0;16,0;9,0;7,0;8,0;;2,0;1,0;23,0;;;11,0;;;2,0;;123,0;2,0;1,0;;1,0;;;25,0;1,0;;2,0;11,0;18,0;33,0;;3,0;1,0;;8,0;;25,0;9,0;;2,0;422,0;162,0;;1,0;;;;;20,0;1,0;;;;;28,0;;;;4,0;;4,0;28,0;2,0;;;;11,0;16,0;2,0;;;;2,0;;16,0;;;2,0;147,0;16,0;5,0;;7,0;39,0;13,0;7,0;26,0;1,0;;4,0;;;35,0;7,0;31,0;4,0;1,0;27,0;38,0;20,0;73,0;36,0;;26,0;7,0;86,0;30,0;39,0;;14,0;6,0;256,0;12,0;30,0;;34,0;;61,0;10,0;16,0;3,0;63,0;25,0;21,0;6,0;86,0;3,0;10,0;44,0;5,0;;25,0;;34,0;74,0;47,0;4,0;6,0;;4,0;5,0;7,0;;3,0;9,0;185,0;51,0;63,0;20,0;3,0;15,0;8,0;34,0;;10,0;;23,0;11,0;11,0;2,0;10,0;6,0;53,0;17,0;8,0;38,0;23,0;4,0;230,0;13,0;1,0;2,0;10,0;5,0;18,0;;;55,0;1,0;1,0;;;6,0;4,0;2,0;9,0;;38,0;3,0;11,0;31,0;15,0;312,0;79,0;1,0;;2,0;12,0;11,0;5,0;1,0;6,0;;46,0;9,0;5,0;123,0;42,0;135,0;88,0;8,0;;17,0;1,0;3,0;;48,0;11,0;5,0;5,0;1,0;43,0;14,0;14,0;24,0;8,0;1,0;8,0;;7,0;1,0;42,0;3,0;3,0;3,0;16,0;;;;1,0;5,0;4,0;6,0;2,0;1,0;1,0;3,0;;;1,0;;33,0;;6,0;7,0;34,0;12,0;2,0;;21,0;1,0;3,0;;6,0;;;;;3,0;20,0;1,0;;8,0;15,0;12,0;13,0;4,0;6,0;1,0;1,0;18,0;5,0;;1,0;27,0;2,0;45,0;1,0;20,0;2,0;6,0;;;;11,0;14,0;2,0;11,0;;3,0;;4,0;4,0;13,0;18,0;;;22,0;13,0;9,0;20,0;;1,0;40,0;;1,0;12,0;3,0;42,0;2,0;47,0;25,0;5,0;94,0;3,0;39,0;;3,0;2,0;;8,0;;;5,0;21,0;;4,0;3,0;4,0;;4,0;1,0;12,0;19,0;;;;;1,0;2,0;;10,0;3,0;34,0;2,0;6,0;;;1,0;21,0;18,0;4,0;;51,0;2,0;4,0;1,0;;3,0;8,0;;2,0;2,0;11,0;14,0;4,0;31,0;2,0;6,0;11,0;1,0;29,0;42,0;1,0;10,0;;2,0;;;10,0;70,0;2,0;;;6,0;17,0;3,0;11,0;89,0;4,0;20,0;3,0;4,0;2,0;1,0;15,0;4,0;2,0;;;1,0;2,0;6,0;;;2,0;7,0;10,0;;;;1,0;2,0;5,0;3,0;;6,0;;;25,0;1,0;1,0;;;13,0;6,0;3,0;7,0;;;13,0;3,0;;14,0;3,0;12,0;;;6,0;18,0;;;;;56,0;4,0;;;8,0;;1,0;7,0;;7,0;;1,0;4,0;1,0;1,0;;;;;;;;1,0;1,0;;1,0;;;6,0;;;1,0;;3,0;;;;;6,0;;;;;1,0;;;11,0;1,0;;1,0;;2,0;;2,0;5,0;20,0;;;11,0;5,0;;;1,0;;5,0;;;;;35,0;;4,0;;1,0;16,0;17,0;12,0;9,0;;;3,0;1,0;;2,0;3,0;;4,0;13,0;4,0;;;1,0;;4,0;;;;;25,0;;2,0;5,0;;;;4,0;;;;8,0;14,0;;7,0;;7,0;;3,0;10,0;1,0;21,0;1,0;8,0;16,0;1,0;;;1,0;1,0;2,0;4,0;2,0;;2,0;;3,0;6,0;6,0;6,0;5,0;22,0;2,0;;;3,0;14,0;1,0;;;9,0;11,0;;;;;3,0;;2,0;1,0;;2,0;6,0;7,0;3,0;;1,0;;;2,0;7,0;;13,0;;1,0;;2,0;4,0;3,0;8,0;4,0;;;;;;7,0;1,0;2,0;;;;;13,0;3,0;2,0;;;5,0;;;19,0;;;;;;;;;3,0;;;;;3,0;;;4,0;;;;8,0;3,0;;;5,0;18,0;;3,0;3,0;;;;5,0;2,0;;;18,0;3,0;;;11,0;2,0;7,0;1,0;;;;18,0;2,0;1,0;;17,0;1,0;;18,0;1,0;2,0;1,0;;6,0;1,0;;;4,0;;
conductor;;;;9,0;;16,0;;7,0;;;;;1,0;10,0;;;9,0;;;;1,0;;;1,0;1,0;;;26,0;;;40,0;;;;;5,0;1,0;;;;2,0;23,0;1,0;;1,0;8,0;;66,0;;;;;11,0;;;;60,0;;;1,0;;;;;31,0;;99,0;;;;;8,0;4,0;;;2,0;10,0;;;;15,0;;;;42,0;;;1,0;;;;;1,0;1,0;;;;2,0;76,0;14,0;3,0;;;;;;;;;;;;29,0;;;;;;;25,0;;;48,0;;;;14,0;;;;;;;12,0;;2,0;;;;;;1,0;;;;5,0;15,0;10,0;;6,0;;;2,0;;;;;;;;22,0;84,0;;;;;6,0;2,0;;4,0;1,0;20,0;;4,0;;2,0;36,0;;1,0;;2,0;1,0;;;;3,0;1,0;5,0;5,0;;;;46,0;;;7,0;38,0;;10,0;;6,0;49,0;;;3,0;;3,0;10,0;;21,0;;;;;;28,0;3,0;3,0;5,0;19,0;114,0;;;;6,0;14,0;50,0;2,0;;;;;;46,0;1,0;;;;;;1,0;4,0;;;1,0;3,0;6,0;16,0;17,0;;;1,0;1,0;1,0;7,0;14,0;2,0;13,0;9,0;;9,0;7,0;;3,0;;;;;;;;17,0;1,0;;3,0;;2,0;;;;;;;51,0;;;1,0;;49,0;;6,0;;;;;;28,0;;7,0;;;;2,0;1,0;;;;;1,0;4,0;;;4,0;;9,0;;9,0;;2,0;;;;;;;;;;59,0;31,0;;1,0;;3,0;;;;;;;;1,0;;;;;;;;1,0;;;;;4,0;1,0;18,0;6,0;24,0;;;;;;;;;;;;;7,0;;;3,0;2,0;;;;;2,0;;;1,0;;;;;;;;;;;;1,0;;;;;;5,0;1,0;2,0;;7,0;;;1,0;2,0;;2,0;;;;;;;;;;;;;;6,0;1,0;;1,0;;;;;;;;;;1,0;;;4,0;;;;;;;;;;5,0;;;;2,0;;;;;1,0;;;;;;;;;;;;;;16,0;;;;;1,0;;;;3,0;;;1,0;;1,0;;;;;;;;;1,0;;;;;;;;;4,0;;2,0;;;;;;2,0;;;2,0;;;18,0;17,0;;;;;5,0;;;;;;;;;;;;;;;;;9,0;;;;;;;;;;;;;;;;;;;;58,0;;;;;;;;;;2,0;;;;;1,0;2,0;;;;16,0;6,0;;;;;;;;;;;;;;;;;;;;;;;;;;;;;123,0;;;;;;;;;;;;;;;;;;;;;1,0;;;;;1,0;;;;;;;;;;;;;;;;;;;;;;;;;;;;;4,0;;4,0;;;;;;;;;;;;;;;;2,0;;;;;;;;;18,0;;14,0;;;;;4,0;;;;;14,0;;1,0;;;2,0;;;;;;;;;;1,0;;;;1,0;;;;;;;;;;1,0;;;;;;;;;;;;1,0;;;;;;1,0;;;;2,0;;3,0;8,0;;;;;;;;;;2,0;;;;;2,0;;5,0;;;;;;14,0;;;;;;;;;;;3,0;;8,0;;;;2,0;8,0;;;;;;;;;;;1,0;;;1,0;;;;;;;;;;2,0;;;1,0;;;;;;2,0;;;;;;1,0;;;;;;;;;;;;;;;;;;1,0;;;;2,0;;;;;;;;;;;;;;;;;;;;;;;;;;2,0;;;;;;;;;;;;;;;;6,0;5,0;;1,0;;;;;;;;;;;;;;;;;;;;;;;2,0;;4,0;;;;;;;;2,0;;;;2,0;;;;;;;;;;;;;;;;;;;;;;;;2,0;;;;;;;;;;;;;;;;;;;;;;;;;;;;;;
constant;;;;5,0;5,0;5,0;2,0;27,0;;;;2,0;;14,0;;2,0;5,0;;;1,0;;;4,0;1,0;3,0;;1,0;;1,0;1,0;54,0;;;;1,0;1,0;1,0;;;;10,0;35,0;3,0;2,0;1,0;;;3,0;3,0;;5,0;;1,0;;1,0;6,0;4,0;;4,0;7,0;4,0;;4,0;;36,0;;16,0;1,0;3,0;;2,0;30,0;13,0;3,0;30,0;12,0;3,0;3,0;;;19,0;;4,0;2,0;6,0;;;8,0;;;;;;1,0;;;8,0;18,0;2,0;10,0;6,0;5,0;;3,0;;6,0;;2,0;;1,0;;11,0;5,0;12,0;;;;;3,0;31,0;1,0;1,0;56,0;2,0;;;15,0;;;;7,0;;;11,0;2,0;;4,0;;1,0;;;;;;7,0;2,0;1,0;3,0;2,0;;;;;;;1,0;1,0;;;;;9,0;;;9,0;;;;3,0;;4,0;;3,0;11,0;;2,0;;;;;2,0;;;2,0;;;3,0;;9,0;2,0;1,0;;1,0;;;1,0;7,0;;2,0;;1,0;4,0;;;;;;;10,0;;5,0;4,0;1,0;;;7,0;13,0;;2,0;7,0;;11,0;1,0;;;;4,0;;;;;;11,0;7,0;4,0;;;;;2,0;;6,0;;;;2,0;;;5,0;;;;;1,0;;153,0;;20,0;;;;;1,0;6,0;1,0;;;;2,0;4,0;;2,0;1,0;;;;1,0;14,0;2,0;;;;8,0;23,0;;;;;28,0;;4,0;;;;6,0;;20,0;11,0;2,0;;;;1,0;;;;;;4,0;2,0;;;;;;;;;;1,0;;8,0;;;26,0;;;;32,0;;;;;1,0;2,0;;;;;;2,0;2,0;;;;;;2,0;;5,0;;;;;;;;;1,0;;;;;;;;;3,0;;;;;1,0;;4,0;;;;;;65,0;2,0;4,0;2,0;1,0;2,0;;;;2,0;1,0;1,0;;5,0;;7,0;10,0;;;;;;;4,0;7,0;;;1,0;2,0;1,0;;3,0;;1,0;15,0;3,0;2,0;;;1,0;;2,0;1,0;;;3,0;;1,0;1,0;;;;;;14,0;;;;10,0;;5,0;;;1,0;;;1,0;;;20,0;;18,0;;3,0;;1,0;;11,0;;1,0;1,0;;;;;;;;;;;4,0;;;3,0;3,0;3,0;;;;2,0;;;;;;3,0;2,0;;1,0;;1,0;;;;;;1,0;;;1,0;;;;2,0;2,0;6,0;;;;;1,0;;;;;;1,0;;;6,0;;;;;;;;4,0;;;;;;4,0;;5,0;;21,0;1,0;;;;;;;;;;;;;;1,0;;;;;;;;;;;5,0;;;;;3,0;;;;;;;1,0;;;;1,0;;;;;8,0;4,0;;;;;;8,0;;;;;1,0;;;;;;4,0;;;;;;;2,0;;;;;;2,0;;;;;;2,0;;;1,0;;;;;;;;;;;;;1,0;;;2,0;;;6,0;;;;;;;;1,0;;;;;;;2,0;;;;;6,0;;;;;;16,0;;;;;;;3,0;1,0;;;;;;;;;;;;2,0;;;;;;;2,0;;;;;;9,0;4,0;;;1,0;;3,0;;;;;;5,0;;;;1,0;;;;;;;;;;;;;;3,0;6,0;;;;;;;2,0;;;;2,0;;;;;;;;;;;;;;;;;;;;;;;1,0;;;;;;;;;;6,0;;1,0;;;;;3,0;2,0;14,0;;;14,0;;;4,0;6,0;;;;;;;;4,0;19,0;;;;;1,0;;16,0;;;;;3,0;4,0;1,0;;;;3,0;1,0;;;;;;;;;1,0;3,0;;;11,0;;1,0;;;;;1,0;1,0;;;;;;;1,0;;;;;2,0;4,0;;;;;2,0;;;;3,0;;;;;;;1,0;2,0;1,0;;;;;4,0;;;;;;;;;;4,0;;;;;;;;;;;;;1,0;;;;;1,0;1,0;;;;;;;;;;;;;;;;;2,0;4,0;;63,0;4,0;;1,0;;;;;;;;1,0;2,0;;2,0;;;;;1,0;;;;;;;;;;;;;;;;;;;;2,0;;;;;;;;;;;;;;;;;;;;;;;1,0;;;;;;;;;
content;;;;12,0;5,0;18,0;4,0;;4,0;15,0;;;;98,0;;;148,0;1,0;2,0;4,0;;;77,0;6,0;7,0;;;20,0;42,0;;46,0;4,0;;;;63,0;12,0;10,0;4,0;;102,0;183,0;;46,0;382,0;;;16,0;;;;1,0;;7,0;9,0;1,0;6,0;;9,0;77,0;1,0;;20,0;;442,0;2,0;75,0;1,0;;;;14,0;33,0;;;;;;92,0;9,0;117,0;;4,0;4,0;12,0;;;5,0;2,0;9,0;10,0;;4,0;39,0;;;14,0;;54,0;4,0;71,0;9,0;;5,0;17,0;58,0;1,0;10,0;;;;12,0;144,0;;;8,0;28,0;2,0;34,0;13,0;;;23,0;4,0;15,0;35,0;59,0;;3,0;;45,0;12,0;;12,0;2,0;;66,0;21,0;;8,0;;;;;2,0;;13,0;4,0;74,0;;;10,0;1,0;;;;;;23,0;14,0;;1,0;;;;;;;;1,0;3,0;;4,0;16,0;;;;;4,0;;;;;1,0;;;5,0;;76,0;;;;1,0;1,0;;;;2,0;;2,0;;;2,0;;;16,0;1,0;1,0;;13,0;17,0;25,0;10,0;;;;13,0;;3,0;17,0;13,0;1,0;7,0;;;;104,0;;;10,0;;;7,0;1,0;;10,0;3,0;;;23,0;2,0;2,0;;;;22,0;1,0;1,0;4,0;3,0;;;;10,0;;;;27,0;4,0;;;20,0;;11,0;;;;;7,0;18,0;;;;;;;9,0;10,0;;;;;3,0;;7,0;;;;1,0;;;21,0;;;;;1,0;;;;;;;;;;;16,0;;22,0;;2,0;;;;;1,0;;;1,0;13,0;53,0;;3,0;3,0;;;;1,0;;;;;;42,0;;;;3,0;;;;;;;;5,0;6,0;;;1,0;;13,0;;9,0;;;;321,0;16,0;;;;18,0;;9,0;19,0;;;20,0;;;1,0;1,0;17,0;2,0;6,0;10,0;1,0;;25,0;;;8,0;4,0;29,0;12,0;11,0;;5,0;;8,0;64,0;;5,0;13,0;;25,0;21,0;12,0;;10,0;2,0;5,0;;17,0;41,0;7,0;9,0;;;4,0;;10,0;10,0;4,0;;;;;;24,0;;2,0;10,0;97,0;5,0;8,0;3,0;;1,0;26,0;3,0;1,0;;;12,0;3,0;3,0;3,0;;;24,0;;;21,0;;;42,0;;3,0;;1,0;;;;;2,0;3,0;1,0;22,0;;;2,0;;10,0;;6,0;;;18,0;5,0;20,0;23,0;;;;11,0;;7,0;;;1,0;4,0;4,0;1,0;29,0;1,0;10,0;2,0;;;1,0;4,0;;;79,0;7,0;;;4,0;214,0;;4,0;;;3,0;;3,0;9,0;25,0;;1,0;;;;;;;;10,0;;;;;;;;;;;3,0;;;;;;26,0;2,0;3,0;7,0;;;;;1,0;4,0;;;9,0;;;7,0;26,0;41,0;1,0;;3,0;;;;6,0;;;4,0;19,0;70,0;;13,0;;12,0;;;;2,0;1,0;;28,0;;;;;;;;;;18,0;11,0;19,0;2,0;1,0;1,0;55,0;;10,0;7,0;;3,0;5,0;;2,0;;50,0;6,0;22,0;;;;;;;;4,0;3,0;;1,0;;23,0;;4,0;6,0;7,0;8,0;2,0;;;;2,0;32,0;;6,0;;44,0;;3,0;;;;;3,0;7,0;;;;;;;1,0;;;16,0;;;6,0;7,0;8,0;1,0;1,0;4,0;;15,0;19,0;12,0;;;5,0;;;;21,0;;;;2,0;9,0;23,0;;11,0;;3,0;1,0;;7,0;1,0;1,0;;;12,0;;;;;;;;15,0;;;;;;2,0;6,0;;;;;;4,0;;;;;7,0;;2,0;;3,0;;8,0;;;10,0;2,0;;;;2,0;42,0;;;;;15,0;1,0;;;;;48,0;;;;;;;2,0;;;;;;;;;;;;;;;;;;;;;;1,0;;;1,0;;;;;;;;;;;;;1,0;;;;;;;;;;;;;4,0;;;;;3,0;;;;;8,0;;;;;;;;;;2,0;4,0;;6,0;4,0;;;;;;;;;;;;5,0;;;7,0;;;;;;;;;;;3,0;;;3,0;;;;;;13,0;;;;;;;;;1,0;;;5,0;;;3,0;;;;;;;;;1,0;;;;4,0;;3,0;2,0;;3,0;;1,0;2,0;4,0;2,0;;2,0;6,0;;;2,0;;;9,0;1,0;;;;;;3,0;;;;;;;;;;;;;;;;9,0;;;;;;;;;;;;;;;2,0;;;;;;;;;;1,0;;2,0;2,0;7,0;;;29,0;;;1,0;;;;;;6,0;;;23,0;;2,0;;;;2,0;;;1,0;;;;;;1,0;3,0;;;;;2,0;;2,0;;;;;
contrast;;;;12,0;1,0;1,0;1,0;;;;;;;41,0;2,0;11,0;37,0;;1,0;4,0;;;44,0;;;;2,0;;3,0;18,0;8,0;7,0;4,0;5,0;1,0;66,0;1,0;;1,0;2,0;55,0;12,0;;10,0;15,0;;;7,0;;;;;;1,0;1,0;4,0;4,0;;16,0;17,0;;;1,0;;237,0;;21,0;22,0;;;3,0;32,0;21,0;1,0;2,0;;;1,0;;;61,0;;;;;1,0;;6,0;7,0;2,0;1,0;;;1,0;;;26,0;;53,0;12,0;20,0;2,0;;;5,0;11,0;;2,0;1,0;;;4,0;2,0;;;3,0;9,0;;16,0;45,0;;;16,0;5,0;;2,0;31,0;;;1,0;18,0;;;7,0;;;1,0;;1,0;;;;;;1,0;6,0;12,0;;5,0;;;;5,0;;;;;;;;;;;2,0;1,0;;;;2,0;23,0;23,0;;;7,0;;10,0;;1,0;1,0;;;;;3,0;;;30,0;;25,0;;1,0;3,0;;;;;;;;;;;2,0;;12,0;1,0;;;;2,0;2,0;1,0;1,0;;;;9,0;;2,0;;7,0;;;;;;8,0;;;;;;;9,0;;1,0;3,0;;;13,0;;;;;;28,0;;2,0;;;;;8,0;1,0;;;;1,0;;;2,0;3,0;2,0;1,0;;;;5,0;;;;;;;;;1,0;2,0;;;;15,0;;;;;;3,0;;;;;;;1,0;;4,0;2,0;;;;;;;;;;;;7,0;;;;;;;2,0;;;;1,0;13,0;;;;;;;3,0;;;;;;;;;;;;;;;;;;3,0;;;;;;;1,0;3,0;;;;18,0;;;;;;;10,0;;3,0;;;;;36,0;;4,0;;;;10,0;2,0;8,0;1,0;;2,0;1,0;45,0;26,0;13,0;;;6,0;;5,0;17,0;;21,0;;12,0;;;;4,0;;38,0;;;;;1,0;;;3,0;;7,0;10,0;2,0;;;;;;2,0;2,0;;;3,0;;;;;;;10,0;;2,0;;;4,0;;;1,0;1,0;17,0;;;2,0;6,0;;;;;3,0;3,0;;;;;4,0;;;;2,0;;1,0;1,0;;;;;;;;1,0;7,0;;;;;;;;;;2,0;;;4,0;;;;;;;5,0;;1,0;3,0;;1,0;;;4,0;;;;;;;;;;;;;;;;10,0;;;;;;;1,0;;;;;;;;;;;;;;1,0;2,0;;3,0;;;;;;;;;;;2,0;;;;;;;;;2,0;;1,0;;4,0;3,0;;;;;;;;;;;3,0;;;6,0;;;;3,0;;;1,0;;;;;;;;;;;2,0;;3,0;;1,0;9,0;;;;;1,0;1,0;;;;;;;1,0;;;8,0;;;3,0;1,0;;;1,0;;;;;;;;;;;;1,0;;;;;;2,0;;;;;;;;1,0;;;;2,0;2,0;;;;;;3,0;5,0;;;;;;2,0;;;;9,0;;;1,0;;;2,0;;;;;;;;;1,0;;;;;;;;;;;;;2,0;4,0;1,0;;;;;;;;;;;6,0;11,0;;;5,0;;;;;3,0;;;;;2,0;;;;;1,0;;;;;;;;;;;;;8,0;;;;;;;;;;;;;;;;;;;;;;;;;1,0;;;;;;;;12,0;;;2,0;;1,0;;;;;;;;;;;;5,0;;;;;;18,0;;;;;4,0;;;;;;;;;;;;;16,0;;;;;;;5,0;;;;;;2,0;9,0;1,0;3,0;;;;;;;1,0;1,0;3,0;;;;3,0;6,0;1,0;;;;;;;;;1,0;;;;;;;;;1,0;;;6,0;;;;;;;;;;;;;;;;;;;19,0;;;;;;;;;;;;;;;;1,0;1,0;;;;;;1,0;;;;;;;;;;;;3,0;;;;;;;2,0;;;;;;;6,0;1,0;;;;;;;;;;;;;;;2,0;;12,0;;;47,0;;;;;;;;;;;;;2,0;1,0;;;;;;;;;;;1,0;;;;;;;;;;;;
conversion;;;;3,0;37,0;70,0;26,0;;;;;1,0;;70,0;17,0;1,0;18,0;8,0;3,0;2,0;10,0;;153,0;;2,0;2,0;2,0;34,0;2,0;13,0;137,0;2,0;23,0;7,0;;132,0;5,0;1,0;3,0;1,0;13,0;220,0;;50,0;12,0;38,0;1,0;566,0;;;5,0;;6,0;1,0;2,0;2,0;56,0;;7,0;117,0;;11,0;9,0;;216,0;1,0;243,0;4,0;;;7,0;18,0;155,0;;;;2,0;4,0;;26,0;61,0;5,0;9,0;4,0;25,0;;;21,0;;2,0;3,0;6,0;9,0;4,0;10,0;6,0;318,0;1,0;317,0;11,0;21,0;59,0;2,0;14,0;66,0;3,0;7,0;6,0;4,0;;;18,0;226,0;;;;;34,0;1,0;41,0;;;177,0;33,0;1,0;55,0;51,0;;;4,0;11,0;4,0;;395,0;3,0;;6,0;;;;;22,0;;;;8,0;29,0;102,0;18,0;;;2,0;;;;157,0;;;;2,0;3,0;31,0;;134,0;35,0;3,0;11,0;11,0;8,0;14,0;2,0;;1,0;21,0;;2,0;68,0;2,0;;;10,0;1,0;;9,0;;57,0;9,0;;7,0;;;;4,0;29,0;;;;28,0;1,0;;12,0;22,0;2,0;;;4,0;8,0;8,0;1,0;;1,0;1,0;4,0;;1,0;5,0;113,0;1,0;;5,0;2,0;26,0;;1475,0;;2,0;378,0;;;1,0;;7,0;6,0;10,0;;;1,0;1,0;;2,0;;;;;;4,0;5,0;4,0;43,0;;;;1,0;6,0;68,0;1,0;;44,0;11,0;;85,0;30,0;22,0;1,0;1,0;;3,0;20,0;;;;9,0;;9,0;;;;;;1,0;;;3,0;8,0;;;21,0;2,0;99,0;1,0;;;;1,0;4,0;;23,0;;;;;;;1,0;;;;;;100,0;;;;;;;14,0;;;2,0;4,0;7,0;15,0;10,0;;5,0;1,0;;3,0;8,0;;;;;1,0;;;;;;;;;;;;;51,0;;;;;;;;;21,0;2,0;66,0;15,0;;;;;;8,0;;;;;;;48,0;14,0;8,0;1,0;;;4,0;3,0;47,0;29,0;2,0;3,0;1,0;12,0;;16,0;5,0;10,0;;26,0;2,0;23,0;1,0;14,0;;;10,0;;;24,0;;1,0;;5,0;1,0;;;;;;;6,0;30,0;;;1,0;1,0;;;33,0;9,0;33,0;;58,0;2,0;9,0;;;11,0;;6,0;;2,0;;27,0;15,0;8,0;;;34,0;;;1,0;1,0;;;11,0;;2,0;28,0;;;;;4,0;3,0;;;1,0;;;7,0;1,0;5,0;;8,0;;;;;;2,0;;;1,0;2,0;;;;;;;;;123,0;1,0;;2,0;;;7,0;4,0;;;;;;;4,0;;;;2,0;1,0;;1,0;;;1,0;;;;;17,0;;4,0;;;15,0;4,0;;;;;;;;;;;;9,0;2,0;1,0;;1,0;2,0;5,0;;;;14,0;;;;;;;;2,0;;1,0;6,0;4,0;2,0;;;;;1,0;;;;;2,0;;;1,0;;;21,0;;;;;2,0;;;1,0;1,0;1,0;1,0;4,0;;;;10,0;;;5,0;;1,0;;;;14,0;;;;;;7,0;;3,0;;8,0;;20,0;1,0;2,0;;4,0;1,0;;1,0;;;;4,0;;1,0;;;2,0;;;;;;;;14,0;;1,0;;;2,0;7,0;;20,0;;1,0;7,0;;;;;;8,0;;4,0;4,0;19,0;1,0;;;5,0;2,0;;1,0;;46,0;;2,0;;;;;9,0;;;;;;;2,0;3,0;;;;;8,0;;1,0;4,0;;;;;;1,0;4,0;2,0;12,0;;;;;;4,0;5,0;1,0;17,0;;;;;5,0;;;2,0;2,0;3,0;2,0;;6,0;;;;;;;;;;;;;;2,0;;;5,0;;;;11,0;;25,0;;;;;;;22,0;;;;;;;;;;;;;;;;;;;10,0;;;;8,0;;;;;;;;9,0;;;;;;;;;4,0;28,0;11,0;2,0;5,0;;15,0;15,0;12,0;;3,0;;56,0;12,0;10,0;11,0;4,0;63,0;1,0;6,0;;;57,0;22,0;3,0;4,0;8,0;28,0;;81,0;;;;;;;2,0;21,0;;4,0;;11,0;;;104,0;4,0;;;55,0;;;;;;;;3,0;;;;;;;1,0;;;;2,0;;;;;2,0;;;;;;1,0;;;;;;;;;;;;5,0;;;;;;3,0;;;;;;;5,0;1,0;;;;;;;;;;;;;6,0;;;;3,0;;;;;4,0;;;;;;;;;;;;;;;1,0;;48,0;;;4,0;2,0;;;;;;;18,0;;;;;;;;1,0;;;;;;;;;6,0;1,0;;;;2,0;;;;;;;;;;;;;1,0;;;3,0;;;4,0;;;;;2,0;2,0;;4,0;;;4,0;;;;;;
convert;;;;6,0;19,0;32,0;31,0;6,0;1,0;;;4,0;4,0;47,0;3,0;2,0;62,0;3,0;3,0;2,0;;;75,0;;5,0;2,0;;11,0;3,0;5,0;241,0;16,0;4,0;8,0;1,0;179,0;;3,0;43,0;;15,0;85,0;;121,0;62,0;7,0;;63,0;;;;;;5,0;17,0;1,0;44,0;;15,0;63,0;;1,0;36,0;;712,0;3,0;72,0;1,0;;;10,0;163,0;251,0;;;;;10,0;1,0;3,0;92,0;;2,0;10,0;41,0;;1,0;196,0;;3,0;33,0;1,0;10,0;;7,0;2,0;162,0;10,0;56,0;36,0;28,0;8,0;;15,0;42,0;30,0;;6,0;8,0;;;27,0;14,0;;;;20,0;8,0;17,0;111,0;23,0;;416,0;5,0;2,0;17,0;85,0;1,0;5,0;;15,0;2,0;;245,0;2,0;;10,0;4,0;39,0;5,0;;5,0;;;2,0;25,0;10,0;4,0;2,0;1,0;;7,0;3,0;;4,0;36,0;1,0;;;;;21,0;;;94,0;3,0;5,0;;3,0;3,0;6,0;2,0;;8,0;;7,0;110,0;3,0;;5,0;24,0;;;3,0;;22,0;20,0;;79,0;;1,0;;30,0;2,0;;;10,0;80,0;6,0;;;3,0;;;1,0;5,0;4,0;;1,0;5,0;;16,0;1,0;;;;77,0;4,0;;6,0;6,0;2,0;;122,0;;;10,0;;;4,0;;4,0;12,0;7,0;;;2,0;1,0;;;;1,0;;;;8,0;;10,0;5,0;;;;;;16,0;;8,0;11,0;;5,0;17,0;25,0;1,0;2,0;;;35,0;6,0;;4,0;;;5,0;9,0;2,0;;;10,0;;;;;5,0;4,0;;;3,0;2,0;38,0;;15,0;2,0;;;;;4,0;1,0;;;;;;;;;3,0;4,0;11,0;41,0;1,0;1,0;;;;;;;;;1,0;78,0;;4,0;;;8,0;;10,0;;;;;;1,0;;;;;1,0;1,0;6,0;1,0;;;;7,0;23,0;4,0;;;;;;12,0;;;;115,0;1,0;;;;;;6,0;;6,0;;1,0;;;9,0;6,0;;;;7,0;;;54,0;47,0;3,0;;;30,0;2,0;27,0;1,0;1,0;;5,0;5,0;31,0;;30,0;;2,0;1,0;;;13,0;1,0;3,0;12,0;4,0;2,0;2,0;5,0;11,0;;2,0;;4,0;17,0;;;;;;;14,0;;15,0;;97,0;15,0;13,0;1,0;;5,0;;4,0;;3,0;;4,0;10,0;3,0;3,0;;;;;2,0;;;;3,0;3,0;1,0;57,0;;4,0;;1,0;;8,0;;1,0;;;;2,0;1,0;16,0;;;;;;;5,0;3,0;;;;1,0;;;;;;;5,0;;23,0;13,0;5,0;28,0;;;1,0;;;;15,0;1,0;;;2,0;14,0;2,0;;;12,0;;1,0;;;12,0;2,0;;;;27,0;;;;;2,0;7,0;2,0;;;;;3,0;;;;;;;5,0;;;3,0;;;;;;;;;1,0;;;;1,0;;;;6,0;;5,0;4,0;;;2,0;;1,0;;1,0;;3,0;10,0;;;;;2,0;;;;;;;;;;;1,0;;1,0;;;16,0;2,0;;;;;;14,0;;7,0;2,0;;1,0;;;12,0;;6,0;;;;;;1,0;5,0;2,0;2,0;;1,0;5,0;;;;;2,0;1,0;;3,0;;;;2,0;;2,0;;;;4,0;;;;25,0;;3,0;;1,0;;3,0;;;;;1,0;;;;;3,0;1,0;2,0;24,0;;;10,0;;5,0;;;1,0;;;;5,0;;;;2,0;4,0;1,0;;12,0;;;2,0;1,0;10,0;2,0;1,0;;;3,0;;1,0;;6,0;1,0;8,0;5,0;;3,0;;;2,0;;7,0;5,0;8,0;;;;;;;;;18,0;1,0;;;;2,0;;;;;;;;;;;1,0;;1,0;;8,0;3,0;;;2,0;;;17,0;;1,0;;;2,0;;9,0;;;;;;;;;;1,0;;;;;;;;;;2,0;4,0;;2,0;;8,0;;;;;;;;10,0;19,0;;34,0;1,0;;;6,0;3,0;4,0;8,0;7,0;;3,0;;;134,0;;;1,0;;;7,0;6,0;;;;;7,0;15,0;4,0;19,0;2,0;2,0;3,0;;4,0;;;1,0;;7,0;;1,0;8,0;;;;5,0;;2,0;7,0;;;5,0;3,0;1,0;1,0;;;2,0;;4,0;;;;2,0;;;;;;;;;;3,0;13,0;;5,0;;;;;;3,0;3,0;1,0;1,0;5,0;1,0;3,0;;4,0;;2,0;;1,0;8,0;;1,0;;;7,0;;;;;;;28,0;4,0;1,0;;5,0;;;;1,0;;;;8,0;;24,0;;;2,0;;;;;;;;;2,0;;;;5,0;;2,0;;22,0;;1,0;2,0;36,0;;;;;;1,0;1,0;;;;1,0;;94,0;;;;;;;;;;;;;1,0;;1,0;7,0;5,0;;;;5,0;1,0;;;;2,0;;;;;;;;;;;5,0;;;;;;;;1,0;;2,0;;;1,0;;;;1,0;;;;
corner;;;;2,0;;25,0;9,0;16,0;2,0;;;;1,0;37,0;;;;3,0;4,0;1,0;1,0;2,0;11,0;;;;3,0;3,0;;;21,0;2,0;;6,0;3,0;9,0;9,0;5,0;1,0;;52,0;60,0;;1,0;18,0;100,0;16,0;;;;3,0;;28,0;4,0;9,0;1,0;41,0;;;1,0;;;1,0;;114,0;;46,0;17,0;4,0;17,0;2,0;54,0;30,0;3,0;;;1,0;;;;29,0;;;1,0;23,0;;;20,0;;;2,0;;2,0;;;;7,0;8,0;37,0;121,0;43,0;7,0;;;1,0;1,0;;;2,0;9,0;;4,0;77,0;;1,0;;;8,0;1,0;17,0;;;1,0;;;;25,0;;4,0;1,0;10,0;;;15,0;;;17,0;3,0;2,0;;;13,0;;;3,0;1,0;52,0;14,0;11,0;5,0;;3,0;18,0;20,0;;;1,0;1,0;;;4,0;28,0;;;;3,0;8,0;31,0;;15,0;1,0;;;15,0;;24,0;;1,0;;;;;3,0;41,0;3,0;;21,0;;37,0;11,0;1,0;2,0;;3,0;19,0;3,0;35,0;1,0;3,0;2,0;;;;;1,0;1,0;81,0;1,0;;72,0;;;;;8,0;21,0;13,0;6,0;;33,0;20,0;;;;14,0;;107,0;;;;12,0;;;;13,0;;;;2,0;16,0;;2,0;;1,0;4,0;13,0;1,0;34,0;49,0;;;;;4,0;4,0;;49,0;42,0;5,0;;1,0;;;5,0;37,0;;;;;2,0;;6,0;3,0;10,0;6,0;;1,0;7,0;;1,0;;9,0;12,0;12,0;;;10,0;16,0;17,0;;26,0;;;;1,0;;19,0;6,0;5,0;;;;11,0;;;6,0;1,0;1,0;;5,0;6,0;;3,0;;11,0;;60,0;;2,0;2,0;22,0;39,0;37,0;13,0;;;14,0;3,0;1,0;3,0;2,0;;;16,0;;8,0;;;;;2,0;;;1,0;1,0;3,0;5,0;2,0;;3,0;;;;;;;2,0;28,0;3,0;;1,0;;;;;1,0;;;;1,0;;;16,0;15,0;7,0;;;;;;3,0;38,0;;2,0;;4,0;;;;;;;3,0;;1,0;1,0;;3,0;;;;17,0;1,0;;;43,0;;3,0;;;;13,0;;3,0;;1,0;;;;;;;;;;;;;;;11,0;;;;;2,0;;1,0;;;;;;;13,0;1,0;;;6,0;;;;;1,0;5,0;1,0;;1,0;4,0;;2,0;;;2,0;;;;;;3,0;;;1,0;1,0;;;;;;;24,0;2,0;2,0;2,0;;;4,0;4,0;10,0;2,0;;;;6,0;;;10,0;;;2,0;;;;4,0;7,0;2,0;;;6,0;;;;2,0;;;;;;;;;;;;;;;;;;;10,0;1,0;1,0;1,0;;;;;17,0;;;;12,0;1,0;;;;;;;;;;;;;;;;;3,0;;;;;2,0;;;;;;;1,0;1,0;;;;;;;;3,0;;1,0;1,0;;;;;;;;;;;;;1,0;;;;;31,0;1,0;;;1,0;;;;;1,0;;;;;;;;1,0;;;11,0;;;;;;;;;;;;;;;2,0;;;;6,0;;;;;;;5,0;;;;2,0;;;2,0;;;9,0;;;;;;;;;;;20,0;;;;;2,0;;;2,0;;;;;;;;;;3,0;;;17,0;;;;2,0;2,0;3,0;2,0;;;;;3,0;24,0;;;1,0;;;;;4,0;;;;;4,0;;;;;;;1,0;8,0;;;1,0;;;1,0;;6,0;16,0;;1,0;;;;;;4,0;2,0;;1,0;1,0;;;;;13,0;8,0;;;;1,0;;;;5,0;1,0;1,0;;;1,0;;;;2,0;;;;;;;2,0;;;;17,0;;;;6,0;;;;;;;;;;;;;;;;;;3,0;;;4,0;;;1,0;1,0;;;;;;;;1,0;;;;;;;;;;8,0;;;;2,0;6,0;;;;;;;;;6,0;;;;;1,0;1,0;;;13,0;;;;;;;;;;;;;;;;;;;;;;;;;;3,0;;;;;;;;;;;;;;;2,0;;;;;;;;;;;;;;;;;10,0;;;;;;;;;;;;;;;;;;;;;;;;;2,0;;;1,0;;;;;;;6,0;;;;;;;;15,0;;2,0;;;;;;;;;;;;;;2,0;;2,0;;;9,0;;;1,0;3,0;;;;;8,0;;;5,0;4,0;;;;;;;;;;;;;;
correlate;;;;3,0;;4,0;2,0;1,0;;2,0;5,0;;;9,0;;3,0;27,0;;;;;;82,0;;;;3,0;;4,0;1,0;14,0;4,0;;;;86,0;;;1,0;1,0;8,0;16,0;;9,0;25,0;;1,0;5,0;3,0;;11,0;;;;13,0;;;;;3,0;;;;;146,0;;10,0;;1,0;;;1,0;8,0;;;;;;;6,0;21,0;;;7,0;3,0;;;3,0;;1,0;9,0;1,0;;;;;15,0;;4,0;20,0;47,0;2,0;;1,0;11,0;4,0;60,0;1,0;4,0;;;6,0;9,0;;;;;2,0;1,0;17,0;;;14,0;;;15,0;25,0;;;;145,0;;;13,0;;;31,0;20,0;;;;;1,0;;;2,0;;;4,0;;;;;;;;;;;;;;;;1,0;3,0;3,0;;;3,0;;;;2,0;;;;1,0;2,0;4,0;;;;;;1,0;2,0;;11,0;;1,0;;;;;;;16,0;;;;;;;3,0;3,0;;;;;1,0;4,0;;;;;6,0;;;1,0;;;;;;;16,0;;;;;2,0;;18,0;;;;;;3,0;;;;;;6,0;;;;;;;;1,0;;;;6,0;;;;;;10,0;;;;;;;;;2,0;;;;;12,0;;;;;14,0;;;;;;4,0;;1,0;;;;;;9,0;;;;;;;1,0;;;;12,0;;9,0;;;;2,0;;;3,0;;1,0;;;12,0;;7,0;;;;;;;;;;;8,0;;;;;;;3,0;4,0;;;;;6,0;;;;;;;13,0;;;;9,0;;;;;2,0;;1,0;1,0;1,0;;;;;1,0;;9,0;;;;;2,0;8,0;18,0;;1,0;;12,0;;;;7,0;;;13,0;;;11,0;;4,0;2,0;3,0;;2,0;;3,0;3,0;19,0;;1,0;16,0;;;;;;9,0;2,0;1,0;;;;;1,0;;;;5,0;;;;;2,0;;1,0;3,0;2,0;;2,0;3,0;;;62,0;;;1,0;;;;;4,0;2,0;;;;;21,0;;;;;3,0;21,0;;;3,0;;;;;;;;1,0;3,0;;;;2,0;;;;;1,0;2,0;;;;7,0;;;2,0;;;;;;;;;;;;;;;4,0;;;1,0;;;16,0;;;;;;;;;;;;;;;;;;;;;1,0;;;;;;;;;2,0;;;;2,0;4,0;;;;;;;;;;2,0;;;;;;4,0;3,0;;;1,0;7,0;;;1,0;;;4,0;;5,0;;3,0;8,0;;;;;;;;;;;;;;;;;;;4,0;;4,0;;;;;13,0;;;;2,0;2,0;;;;1,0;;;;;6,0;;;;;4,0;;;;;;;;;;;;;;;;;;;;;;;;;;;;;;;;;;;2,0;23,0;;;;;;;;;;;;;;;;6,0;;;;5,0;;1,0;;;7,0;4,0;4,0;;;;;;;;;6,0;;;;;;;2,0;;;;;;;;;;;;;;3,0;;;;;;;;;1,0;;;;;;;;;;12,0;;;;4,0;;;;;;;;;1,0;;;;;;;;;2,0;;;;;;;;;;;;;;2,0;;2,0;;;;;;;;;;;;;6,0;;;;;;;;;;;;;;;;;;;;;;;4,0;4,0;;;;;;2,0;;;2,0;;;1,0;;;;;;;;;;;5,0;;;;;;;;;;1,0;;;;;;1,0;;;;;;;;4,0;;;;;3,0;;;;;2,0;;;;;2,0;;;;;;;15,0;;;2,0;;;;;;;;;;;;;;;;;;;;;;;;2,0;;;;;;;;;;;;;;;;;;;;7,0;4,0;1,0;;;;;;;;;;;;;;4,0;;;;;;;;;;;;;;;;;2,0;;;;;;;;;;1,0;;;;;;16,0;;;;;;;;;;;;;;;;1,0;;;;;;;;;
correlation;;;;3,0;17,0;6,0;4,0;;;;;;;62,0;;;14,0;;2,0;2,0;;3,0;10,0;1,0;;;;1,0;2,0;;10,0;2,0;;;;36,0;1,0;;;;75,0;16,0;;1,0;2,0;;;;3,0;;2,0;;;;22,0;;;;;6,0;;;;;106,0;;19,0;;;9,0;;;5,0;;;;;8,0;;2,0;56,0;;;26,0;30,0;;;;;5,0;2,0;;4,0;;2,0;;53,0;;27,0;42,0;21,0;6,0;;;1,0;12,0;6,0;4,0;;;;4,0;5,0;;;15,0;;1,0;;8,0;1,0;;24,0;8,0;;5,0;25,0;;;;39,0;;;;;;19,0;10,0;;;;4,0;;;;16,0;7,0;;1,0;;60,0;1,0;4,0;;3,0;;;;;;;;;;;1,0;;;;;2,0;;;12,0;;6,0;;;;;27,0;;;;;;2,0;;6,0;;;;;;;;;5,0;;;;;2,0;;4,0;6,0;;;;;;6,0;6,0;;;;2,0;;;2,0;16,0;9,0;;;;;18,0;;;;;;2,0;1,0;;5,0;;;;8,0;;;;;;31,0;;;;;;;;;;;;;;;;;;;;;;;25,0;5,0;;;;;;;;;;;;;;;;;;;;;;;;;;;15,0;;;;;;;1,0;;;;2,0;;3,0;;;;;;;;;;;;13,0;;11,0;;;;;;2,0;;;;;4,0;;;;;;;;;;;;;;;;;;10,0;;9,0;;;88,0;1,0;;;;;;;;3,0;;;;;;11,0;;;;;4,0;5,0;4,0;4,0;;;1,0;;4,0;1,0;9,0;;;54,0;;9,0;;;18,0;;15,0;5,0;;;3,0;;3,0;18,0;12,0;;;12,0;;;1,0;;;;;;2,0;;;;;;3,0;;12,0;;4,0;98,0;;;;19,0;3,0;;;5,0;18,0;;;;;167,0;1,0;12,0;8,0;;;5,0;;;;;;;;;;;;11,0;;;;;;3,0;;4,0;;;;5,0;1,0;;;;;;;;16,0;30,0;4,0;;;5,0;;;1,0;;;;6,0;;;;;;;;;;;;;;;;;23,0;;;;;;;;;;;;;;;1,0;;;;;;5,0;;;;;35,0;;;8,0;1,0;;;;;2,0;;;;2,0;;;;;;;;;;1,0;;;;2,0;;1,0;;;;;;;;;1,0;;;;;;;;;;;;;;1,0;1,0;;4,0;;;;;7,0;;3,0;;1,0;;;45,0;;;;;;;;;3,0;;;;;;;;;;3,0;;;2,0;;;;;;;;1,0;;;;;;6,0;;;;;;;;;;;;;;;;2,0;;;;;;1,0;3,0;;;;;;;;1,0;;;;;4,0;;;18,0;6,0;;;;;;;9,0;;;;;;6,0;;1,0;;;;;;;;;;;;;;;;;;;;;;;;;4,0;;;;;;;;;;;;;;;2,0;;;;12,0;;;;;;;;;;;;;;;;;;;;;;;;;;;;;;;;;;2,0;;;;;;;;5,0;;;;;;;;;;;;;;;;;;;;;;;;;1,0;;;;;;21,0;;;;4,0;;;;;;2,0;;;;;;;;;;;8,0;;;32,0;;;;;;;;;;;;1,0;;;;;;16,0;3,0;;;;;;;;;;;;;;;;;;;;8,0;;;;;;;;;;;;;;;;;;7,0;2,0;;;;;;;;;;;;;;;3,0;;;;;;;;;;;;;;;;;3,0;;1,0;;;;;;;;;;;;;;;2,0;;;;;;;;2,0;;;;;;;;;;;;7,0;;;;;;2,0;;;;;;;;5,0;;;;;;;;;1,0;;;;;;;;;;;;;;
correspondence;;;;1,0;3,0;12,0;5,0;;;9,0;;;2,0;53,0;;;15,0;;;;;;15,0;;;;;9,0;2,0;1,0;9,0;;1,0;1,0;;37,0;7,0;1,0;25,0;;101,0;13,0;1,0;1,0;1,0;1,0;;;;4,0;6,0;;;;1,0;6,0;4,0;;;11,0;;;3,0;;123,0;2,0;15,0;;;;;11,0;15,0;;2,0;;;1,0;;;44,0;;;12,0;;2,0;;8,0;;;14,0;;;;1,0;;59,0;3,0;32,0;130,0;14,0;14,0;;1,0;3,0;15,0;1,0;1,0;2,0;;;4,0;2,0;;;;;11,0;17,0;2,0;;;13,0;5,0;;26,0;29,0;;1,0;;5,0;;;4,0;1,0;;1,0;;6,0;2,0;;;;;;4,0;2,0;7,0;8,0;;;21,0;1,0;2,0;;;;;;;;4,0;;3,0;;;;;;;;;;1,0;;7,0;;;;;;;;9,0;;;3,0;;1,0;;;;;;;;1,0;;;;;2,0;;;1,0;5,0;1,0;;;1,0;;;3,0;;;;12,0;;;;4,0;;;5,0;2,0;;13,0;;;;;;;2,0;;;;;;;;;;;;1,0;;;5,0;;;;;1,0;11,0;;;6,0;;;6,0;;;;;;;;;;;;;;;;;2,0;;;;;1,0;;;;;;3,0;;;4,0;;2,0;;;15,0;4,0;;;;;;;;;;;;4,0;;;;;;;;;;;;13,0;;;;;;;;;;;;;2,0;;;;;;;4,0;;;;;;;;;;;;;32,0;;;;1,0;;;;;;;;;;;;;;4,0;;3,0;;;2,0;2,0;;3,0;36,0;;;;13,0;3,0;1,0;;;1,0;2,0;9,0;;;1,0;;21,0;22,0;;;;;;;13,0;2,0;;10,0;;;;;;;12,0;;;;;;;;;1,0;10,0;;4,0;;;6,0;;3,0;;2,0;;;1,0;;;5,0;5,0;4,0;;;5,0;11,0;;2,0;;;;1,0;;;;;6,0;;;6,0;;;;;;1,0;;;;;;7,0;5,0;;;2,0;;;;;;;6,0;;;27,0;2,0;;9,0;;;;;;;2,0;;;;;1,0;;;;;3,0;;;;;;;;;4,0;;1,0;;;;;;3,0;5,0;;;;;;;;;1,0;;;;;;33,0;;;;2,0;;;;;;;;;;;;;;1,0;;11,0;;;;;2,0;;;;;;;;;;2,0;3,0;;;;;;;;;2,0;;;;1,0;;;;;;;;;;1,0;;1,0;;;23,0;;1,0;;;;;;;1,0;;;;;;;;;;;;;;;;;;;;;;;;;;;;;;4,0;;;;;;;;;;1,0;12,0;19,0;4,0;;2,0;;;;2,0;;;;;;;;;6,0;;;;;;;9,0;13,0;;;;;;;;7,0;;;;;;;;;;;;;;;;;;2,0;;;;;2,0;;;;;;;;;;2,0;;;;;;;;;12,0;;;;;23,0;2,0;;3,0;;;;;;;6,0;;;;2,0;;;;;;;;;;;;;;;;;;;;;;;1,0;;6,0;;;;;;;;;;;;;;;;;;;;4,0;;;;3,0;;;;;;;;;;;;;7,0;;;;;;7,0;7,0;;;;;3,0;;;3,0;;;;;;;;5,0;;;2,0;;;;;;;;;;;;3,0;;;3,0;2,0;;3,0;;6,0;1,0;;;;;;;;2,0;;17,0;;;;;1,0;;2,0;6,0;;;;2,0;;1,0;;;;;;;;;;;;;8,0;;;;;;;;;;;;;;;;;;;;;;;;;;;;;;;;;;;;;3,0;1,0;;;;;;;;;;;;;;;;;;;;;;;;;28,0;;;;;;;;;;;;;;;;;;1,0;;10,0;8,0;;;;5,0;;;1,0;3,0;;;15,0;5,0;;;;10,0;;;;;;
count;;;;2,0;;7,0;2,0;;;;;;;77,0;;;10,0;2,0;5,0;;;1,0;;;6,0;1,0;;;3,0;;117,0;10,0;4,0;3,0;;16,0;7,0;2,0;17,0;;67,0;38,0;;4,0;16,0;1,0;;1,0;3,0;1,0;52,0;;;11,0;;7,0;7,0;;22,0;46,0;;;;;247,0;;79,0;1,0;;;7,0;2,0;12,0;;;3,0;;52,0;;13,0;61,0;;15,0;;1,0;;2,0;;;;2,0;;11,0;;;;182,0;;62,0;33,0;1,0;17,0;;25,0;9,0;35,0;5,0;7,0;;;2,0;13,0;2,0;;;;;6,0;;44,0;4,0;;95,0;5,0;;36,0;30,0;;;;111,0;3,0;;48,0;;;2,0;2,0;;;;3,0;;;;;1,0;5,0;2,0;2,0;;;;;2,0;;;;;;;2,0;;;8,0;;;;1,0;4,0;9,0;2,0;3,0;5,0;;7,0;;;;;11,0;;;;;;10,0;;44,0;;15,0;;;2,0;;;;;;;;2,0;;;28,0;1,0;;;;;6,0;5,0;26,0;;;;67,0;;;30,0;;27,0;25,0;;;;2,0;;;;;;1,0;10,0;;3,0;;;;2,0;;;;;;9,0;2,0;;3,0;;;;;;1,0;4,0;;;;;;2,0;2,0;7,0;;;;;26,0;17,0;;;;2,0;;;;2,0;;;;;3,0;;;;;1,0;128,0;;;;;;;;9,0;2,0;;;;;;4,0;;;;1,0;64,0;39,0;;;1,0;39,0;;;3,0;;2,0;;1,0;49,0;;;;;;;;;;;;;6,0;;;;;;;6,0;;;;;;3,0;;;;;;;;;;;10,0;1,0;1,0;;3,0;;2,0;;4,0;;;;;;6,0;;12,0;;;;19,0;47,0;18,0;;2,0;;;34,0;20,0;26,0;;8,0;13,0;2,0;7,0;;;23,0;;6,0;10,0;;;7,0;81,0;;;10,0;;1,0;1,0;2,0;;24,0;1,0;2,0;38,0;;;;;1,0;15,0;22,0;;1,0;1,0;24,0;;36,0;5,0;;34,0;;6,0;2,0;;;1,0;1,0;1,0;4,0;;1,0;40,0;;1,0;3,0;;1,0;6,0;;;12,0;4,0;;;;;9,0;;2,0;6,0;;;6,0;;;4,0;;;;;;7,0;;;;2,0;;3,0;;;;;2,0;;;57,0;;;;;;;2,0;;;4,0;;2,0;;;;;2,0;;24,0;;;;;;5,0;;;;5,0;;;;;;;;;;17,0;;;;;2,0;;;;7,0;;;;;2,0;1,0;1,0;;;;;;9,0;1,0;;;;;;2,0;4,0;;;;;17,0;33,0;1,0;;;;2,0;;;;;2,0;;;;;;1,0;;;;;;;;;;;30,0;3,0;;;2,0;28,0;;;;;;;;;;14,0;;6,0;;2,0;;;;2,0;3,0;;;;;;7,0;;;;;1,0;;;;;;;;;;;;2,0;;;;2,0;;;;;;24,0;;;;;7,0;;12,0;;2,0;;;1,0;8,0;3,0;;1,0;;17,0;4,0;;;;;;7,0;;;1,0;;;;;;;16,0;;;;4,0;9,0;1,0;;;;;;50,0;;;;;;;;;;;;6,0;;;;;;;;;;;;;;;22,0;;;;;8,0;;;;;;;;;;9,0;;;1,0;;;3,0;;;;;;;;;;;;;;;;;;;;;;;;;;;;1,0;;;;;;;;;;;;;;1,0;16,0;;;;20,0;3,0;;;;19,0;;66,0;;;145,0;;;;;;9,0;;11,0;;6,0;;;;;;;11,0;;1,0;;;;;;;;11,0;;;3,0;4,0;;;;;;;;;;;;;;;;;;1,0;;;;6,0;2,0;;;;;;;12,0;;;;;;;;7,0;;;;;;;;;;;5,0;;;2,0;;;;;2,0;;;;;;;;;;;;2,0;;;;;;;;4,0;;;11,0;12,0;;;;;;;;;;2,0;;;;;;;;4,0;7,0;;;;;;;;;;;5,0;;5,0;;;;;;;;;;;;;;;;;;4,0;;;;;;;3,0;;;;;;;;;8,0;1,0;;;;;;;;;6,0;;;;;;;;;;;;;;
counter;;;;12,0;;8,0;17,0;1,0;;;;;;24,0;;3,0;7,0;7,0;;1,0;4,0;;;;;;;;;;112,0;6,0;4,0;;;1,0;1,0;;6,0;;6,0;81,0;;23,0;23,0;1,0;;5,0;;;;;1,0;;;;5,0;;1,0;15,0;;;;;42,0;;41,0;8,0;;;1,0;20,0;;1,0;;6,0;;2,0;13,0;5,0;12,0;;21,0;;1,0;2,0;;1,0;;7,0;;;;;;;12,0;;98,0;;6,0;15,0;;2,0;3,0;3,0;;;;;;39,0;;1,0;;;;7,0;22,0;29,0;1,0;;105,0;8,0;;11,0;9,0;;;;46,0;;;37,0;;;2,0;;;;;;;;2,0;3,0;1,0;1,0;4,0;5,0;;;;;1,0;;;;;;4,0;8,0;;;13,0;;12,0;;;3,0;2,0;;;6,0;;;;;;;;;;;;;3,0;37,0;10,0;4,0;;;;7,0;1,0;;;;;;;28,0;;;1,0;2,0;20,0;;;8,0;;;12,0;;;;62,0;;;2,0;;18,0;1,0;;;;4,0;;;;;;1,0;;2,0;2,0;;;;1,0;;9,0;;;;;2,0;;2,0;;;;;;6,0;37,0;2,0;;;;;;;;;;;;5,0;;;;;1,0;1,0;;1,0;;;;;;;;;;1,0;;35,0;;;;;;;;2,0;;5,0;8,0;2,0;;;;;;;;2,0;42,0;;;;27,0;;6,0;;;;;3,0;13,0;;;;;;;2,0;;;;;;3,0;;;;1,0;;;1,0;;;;;;;;1,0;;;;;;;4,0;9,0;1,0;;;;;;;;;;;;;;;;2,0;;1,0;;;18,0;24,0;;13,0;;;6,0;8,0;3,0;;13,0;;;1,0;;;2,0;;;;;;8,0;2,0;8,0;;4,0;;;1,0;2,0;;1,0;;3,0;20,0;;;;;;;1,0;3,0;;;26,0;;22,0;;;;;1,0;;;;;;4,0;5,0;1,0;3,0;3,0;;;1,0;;;2,0;;;9,0;;17,0;;;;;;;;;145,0;;;;;;;;;;1,0;;;;;;9,0;;;2,0;;;;;18,0;;1,0;;;;;;;;;;;;;;;;;1,0;2,0;;;;;;;;1,0;;;;;8,0;;;;;;;;;;;;1,0;;;;;;;2,0;;;;1,0;;;3,0;;;;;;;;;;3,0;;;;;;23,0;;;;;;;;;;;;;;;;;;;1,0;;;;;;;;52,0;;;;;;;;;;;;;;;;;;;1,0;;;4,0;2,0;;;;;;;;;;;;;;;;;;;;;;;;;;;;2,0;;;;;3,0;;;;;;2,0;;;;5,0;;;;6,0;;;;;;3,0;;;;;;4,0;;;;;;;;;;7,0;;;;;5,0;2,0;;;;;;58,0;2,0;2,0;;;;;;;;3,0;;2,0;;;;;;;;;;;;;;;;;;;;2,0;;;1,0;;;;;;;3,0;;;;;;;;;7,0;;2,0;;;;;;;;;;;;;;;;;;;;;;;;1,0;3,0;;;;;;;;;;;;;8,0;;;;;3,0;;17,0;;2,0;;52,0;;3,0;;;;;;18,0;;;;;;;;;;;;5,0;;;;;;;;;;21,0;;;2,0;;;;;;;;;;;;;;;;;;;;;;;;;;;;;;;;;;;1,0;;;;;;;;;;;3,0;;;;;;;;;;;;;;;;;;;;;;;;;;;;;;;;;2,0;5,0;;;;;;;;;;;;;;;;;;;;;14,0;;;1,0;;;;;;;;3,0;;;;;;;;;;;;;;;1,0;;;;;;;;;;;;;;;;;;;;;;1,0;;;;;;;;;;;;;;;;;;;5,0;;;;
create;;;;11,0;3,0;21,0;16,0;7,0;;;;;5,0;51,0;;;46,0;16,0;17,0;3,0;2,0;;82,0;;;8,0;2,0;8,0;13,0;5,0;48,0;5,0;16,0;12,0;;48,0;6,0;18,0;42,0;1,0;14,0;81,0;;27,0;34,0;4,0;14,0;6,0;8,0;3,0;1,0;1,0;3,0;5,0;14,0;;2,0;2,0;;12,0;;;2,0;;593,0;8,0;28,0;;2,0;;;22,0;50,0;;;;1,0;3,0;11,0;6,0;105,0;;9,0;43,0;11,0;1,0;;28,0;;6,0;18,0;1,0;3,0;;25,0;;28,0;14,0;65,0;48,0;9,0;7,0;2,0;35,0;32,0;44,0;2,0;7,0;;;;8,0;19,0;;;;8,0;14,0;15,0;17,0;4,0;;64,0;3,0;;28,0;65,0;;12,0;;22,0;;;41,0;3,0;;34,0;40,0;3,0;;;1,0;;;2,0;20,0;14,0;;3,0;;;;2,0;1,0;4,0;;2,0;7,0;;;2,0;;2,0;2,0;;;2,0;14,0;;41,0;1,0;;1,0;5,0;;10,0;6,0;;5,0;7,0;;;;18,0;;;9,0;3,0;41,0;17,0;;;2,0;3,0;;3,0;16,0;;1,0;2,0;;2,0;;3,0;7,0;1,0;3,0;;;4,0;1,0;10,0;10,0;;;14,0;41,0;3,0;7,0;5,0;23,0;;5,0;;8,0;2,0;11,0;13,0;3,0;1,0;;2,0;12,0;;;3,0;2,0;11,0;;;;;;;47,0;16,0;17,0;;2,0;1,0;;;2,0;7,0;2,0;;5,0;25,0;2,0;;11,0;7,0;3,0;9,0;6,0;3,0;1,0;;;29,0;;;2,0;;;;;5,0;2,0;2,0;;;4,0;2,0;3,0;;1,0;;6,0;;4,0;4,0;1,0;1,0;2,0;;9,0;;;;;;;6,0;;1,0;;3,0;;14,0;;;;2,0;6,0;;3,0;;;6,0;4,0;45,0;;8,0;;;;;;4,0;;;;3,0;5,0;;;;1,0;;5,0;5,0;;;;21,0;10,0;14,0;1,0;3,0;7,0;;;;5,0;;2,0;1,0;79,0;;1,0;;1,0;;;;8,0;;;;;;3,0;1,0;2,0;4,0;1,0;6,0;4,0;;15,0;11,0;;3,0;1,0;14,0;1,0;4,0;16,0;16,0;1,0;3,0;8,0;1,0;6,0;7,0;;10,0;3,0;1,0;1,0;20,0;;;3,0;14,0;11,0;;16,0;3,0;;3,0;;2,0;2,0;11,0;;;;1,0;2,0;;;;2,0;15,0;;16,0;1,0;3,0;26,0;2,0;10,0;6,0;1,0;;3,0;3,0;2,0;2,0;3,0;2,0;11,0;3,0;1,0;4,0;;1,0;32,0;;;7,0;3,0;2,0;4,0;;;4,0;10,0;;4,0;5,0;6,0;;2,0;10,0;;1,0;;;2,0;1,0;9,0;14,0;;;;;;;1,0;1,0;10,0;7,0;2,0;22,0;23,0;;3,0;6,0;;;6,0;3,0;4,0;;12,0;;1,0;;7,0;10,0;1,0;1,0;2,0;4,0;;;;;9,0;6,0;;;;6,0;1,0;3,0;;;8,0;;;2,0;;1,0;1,0;2,0;7,0;;;;4,0;19,0;10,0;;;4,0;;9,0;;;2,0;6,0;1,0;25,0;;;4,0;9,0;;;;12,0;3,0;8,0;1,0;4,0;;3,0;;18,0;3,0;3,0;18,0;1,0;;1,0;2,0;;;1,0;;;9,0;7,0;3,0;1,0;1,0;;;;4,0;;;3,0;;7,0;2,0;29,0;1,0;6,0;;2,0;1,0;5,0;1,0;3,0;7,0;;3,0;;14,0;16,0;9,0;13,0;4,0;;;2,0;;1,0;7,0;;;;;;3,0;1,0;;;1,0;11,0;3,0;;2,0;;1,0;;;;;4,0;;;;1,0;;2,0;1,0;5,0;;;4,0;;;;1,0;;;2,0;5,0;2,0;2,0;;4,0;2,0;18,0;1,0;2,0;1,0;10,0;3,0;1,0;;1,0;;1,0;1,0;20,0;;;;2,0;1,0;;15,0;;3,0;;2,0;;;;4,0;2,0;;;2,0;;4,0;1,0;;1,0;2,0;;;;;;;;3,0;;1,0;;2,0;;1,0;;;;1,0;;9,0;1,0;;;;3,0;;;8,0;;;;2,0;1,0;1,0;;;;;;;;;7,0;;2,0;;;;2,0;;9,0;5,0;;;;2,0;3,0;;;;;;1,0;;;1,0;2,0;2,0;;;;1,0;;;;;2,0;1,0;;;;;;;;;1,0;;;4,0;2,0;;;;;;5,0;;;;7,0;;6,0;;;3,0;;3,0;;2,0;;;5,0;12,0;;1,0;3,0;;;5,0;;;;;1,0;;1,0;;;22,0;;3,0;;;4,0;1,0;2,0;;;;;2,0;;;3,0;6,0;;;;;;4,0;1,0;;3,0;;;3,0;;;22,0;;;;2,0;5,0;1,0;1,0;;;;2,0;2,0;;3,0;2,0;;;1,0;;4,0;;5,0;1,0;;;;;;2,0;;;;;;1,0;10,0;3,0;;3,0;3,0;;;;;1,0;;;1,0;6,0;;1,0;;;;2,0;;;;;2,0;1,0;;;;;;;;;;;1,0;;;;;6,0;;;;;;;;;2,0;;;;;3,0;;;;1,0;;;;;;;;7,0;;;;;;;;;;1,0;2,0;1,0;4,0;;;;1,0;1,0;;6,0;2,0;7,0;;;1,0;;;;;1,0;;;6,0;;2,0;;;;;
criterion;;;;4,0;4,0;7,0;;;;;;;;57,0;;;27,0;;2,0;;;;1,0;;;;;1,0;3,0;13,0;7,0;2,0;;;;22,0;28,0;;3,0;;49,0;31,0;;10,0;4,0;;6,0;1,0;;;3,0;;;4,0;4,0;;;;;1,0;;;13,0;;117,0;;59,0;;1,0;;;;;;;;;1,0;1,0;1,0;63,0;;;;1,0;;;1,0;;;1,0;;5,0;4,0;;;5,0;6,0;8,0;17,0;12,0;51,0;;1,0;13,0;6,0;2,0;4,0;;;;4,0;22,0;4,0;;10,0;2,0;61,0;;5,0;1,0;;7,0;6,0;;2,0;20,0;;14,0;;3,0;2,0;;2,0;5,0;;16,0;;2,0;;;;;;;;;2,0;2,0;;;;;;;;;;;;;;;;;5,0;;;;6,0;;;;19,0;;;;3,0;;;;;1,0;6,0;;;2,0;;16,0;;;;;;;;;;;;;;;;;6,0;;;;;;2,0;1,0;;;;3,0;;;;;;9,0;;;;1,0;;;;;;7,0;;;;;;;;;;;;;21,0;;;;;;;;;;;;;;;16,0;;;2,0;;;;;1,0;;;;;;;;4,0;13,0;;;;;1,0;;1,0;;;4,0;;;;;;;8,0;;2,0;;;;;;;;;;;;3,0;1,0;;;;;;;3,0;;;;;29,0;;1,0;;;;;;;;;;;;;;;;;;;;;;;;;;;;;;;;;;;7,0;;;;;;6,0;6,0;1,0;;;;;;7,0;;4,0;;;;3,0;1,0;5,0;;2,0;8,0;3,0;27,0;4,0;4,0;;1,0;;;;;;;;5,0;17,0;;;2,0;;7,0;;;;1,0;6,0;;;;;;1,0;5,0;;;;;;;1,0;;3,0;2,0;;2,0;4,0;;;;7,0;;;;1,0;13,0;21,0;;4,0;;18,0;;;1,0;;;4,0;;;;1,0;;;;2,0;;;;1,0;;;;;;2,0;3,0;1,0;55,0;6,0;;3,0;4,0;;;;;;;;;;;;;4,0;;8,0;4,0;;;;;;;;;;;;;;;2,0;;;;1,0;8,0;;;;;;;;;;;;;1,0;;;1,0;;;;;;2,0;;;;;;;1,0;1,0;;2,0;;3,0;6,0;4,0;;;;;;;;;;32,0;;;;;;2,0;;;;;;;2,0;;;;;;;10,0;;1,0;;;;;;;11,0;;;;;;;;;12,0;;3,0;;;;;5,0;;;14,0;;;1,0;;;;;;;;;;18,0;;;;;;;4,0;;;;;;;;;;;;;;;;;;;;;;;;;;;;;;5,0;5,0;;4,0;;;;3,0;;1,0;37,0;;;;;;;;;2,0;;;5,0;;;4,0;;;;;;;5,0;;;;;;;;;2,0;;1,0;;;;;;;;;;;;;;;;;;;;;;;3,0;;;;;;;;;;13,0;;;;;;;;;2,0;;17,0;;;;;;;;;;;;;;;;;;;;;;;;;;;;;;;;;;;;;;;;;;;;;1,0;;;;;;;1,0;;;;;;;;;;;1,0;;;;;2,0;;;;;;;;;;;10,0;;6,0;;;;;;4,0;;;;;;;;1,0;;;;5,0;;;;;;;;;;;;;;;;;;;;;;;1,0;;;;4,0;;;;2,0;;76,0;;;;;;;;;;;;;;;;;;;;;5,0;;;;;;;;;;;;;;1,0;;;;;;;;;;;;;;;;;1,0;;;;;;;;;;;;;;;;;;;;;;2,0;;;;;;;;;;;;;;;;;;;;;;;;;6,0;;1,0;;;;;;;;;;;;6,0;;1,0;2,0;;;;;;8,0;;;1,0;;
crop;;;;3,0;;11,0;;;;;;;;19,0;;;41,0;;1,0;;;;22,0;;;1,0;;;6,0;;28,0;3,0;14,0;;;2,0;4,0;;;;6,0;14,0;;9,0;40,0;;2,0;;;;2,0;;;;9,0;;16,0;;;25,0;;;;;345,0;2,0;18,0;1,0;;;;2,0;4,0;;;;;;;;31,0;;11,0;2,0;7,0;;;3,0;;;8,0;;;1,0;;;4,0;1,0;8,0;1,0;4,0;8,0;;16,0;5,0;11,0;;2,0;;;;3,0;23,0;;;2,0;8,0;1,0;3,0;6,0;;;37,0;3,0;;14,0;7,0;;;;2,0;;;4,0;;;14,0;8,0;5,0;;;23,0;;;;2,0;28,0;2,0;10,0;;;;1,0;;;;;;;;;3,0;2,0;;;;;;;;;6,0;;5,0;;;;;;;;;;8,0;;;;;28,0;;;;;;;;;;;;;;;;;1,0;;;1,0;;;2,0;;;;;2,0;;;;;;;;;;64,0;;;6,0;;;12,0;17,0;;;;;;;;;;;;18,0;;5,0;;;;;;;;1,0;;3,0;;;;1,0;8,0;4,0;;;;;;16,0;;;;;;;;;;;;;2,0;;;;;;1,0;;;1,0;;;;;;;;;;;;2,0;;;1,0;;2,0;3,0;;;;;3,0;;;;;;;1,0;;14,0;;;;;;;;;;;4,0;;;;;;3,0;;;;;;;1,0;;;;;;;;;;;20,0;;2,0;;;9,0;;21,0;;1,0;;;;;;3,0;;;;1,0;;;6,0;;;;2,0;11,0;;;;;;2,0;6,0;;;6,0;;11,0;3,0;;;14,0;;5,0;;;;;;;;;;;1,0;1,0;;;;;;;;;;2,0;1,0;5,0;;;;;10,0;;1,0;;;2,0;;;;;;;;4,0;;;1,0;;;;;;;;;6,0;;2,0;3,0;;;;2,0;;;10,0;;;9,0;;9,0;;;;;;;;;35,0;;;;1,0;6,0;;;;;;;;;;5,0;;;2,0;;3,0;;;;4,0;;;;;;;7,0;;;;;;;;;;;;;;;;;;;4,0;;;6,0;2,0;;;2,0;2,0;;;;;;;;;;;;;;;6,0;1,0;;;;;;;;;;;1,0;;;;;;;;8,0;2,0;;;;;;;2,0;;;;;;;12,0;;;;;;;1,0;;;;;;;2,0;;;;;;;;;2,0;1,0;;;;;;;;;;2,0;;;;;;3,0;;;;1,0;;;;1,0;;1,0;;;;;;;;;;;;;;;;5,0;3,0;;8,0;9,0;;2,0;;;;;;;;;;;;;2,0;;;;2,0;;;;;;;;;;;;;;;;;;;;;;;;;;;;;;;;;;;;;;;;;;;;;;;;;;;;;;;;;;;;1,0;;1,0;;2,0;;;;;;;;;;;;;;;;;;;;;;;;;;2,0;;;;3,0;;;;;;;;2,0;;;;;;;2,0;;;;;7,0;;;;;;;;;;;;;;;;;;;;;;;;;1,0;;;;;;;;;;;;;1,0;;;;;;;;;;;;;;;;;;8,0;;;;;;;;2,0;;;2,0;;;;;;;;;;;;;;15,0;;;;;;;;;;18,0;;;;;;;;;;;;;;;;;;;;;14,0;;;;;;;;;;;8,0;;;;;;;;;;;;;;;;;;;;;;;;1,0;;;;;;;;;;;3,0;;;;;1,0;;;;;;;;;;;;;;;;;;;;;;;;;;9,0;;;;;;;;;;;;;;;;;;
cross;;;;2,0;;19,0;2,0;3,0;;;;5,0;;12,0;;;4,0;;2,0;;1,0;3,0;;;;;;5,0;;1,0;14,0;1,0;;;;23,0;2,0;2,0;2,0;;17,0;27,0;19,0;4,0;31,0;5,0;;19,0;;;1,0;;29,0;;2,0;2,0;14,0;;;5,0;;;;;30,0;;41,0;4,0;;3,0;11,0;10,0;23,0;;;;2,0;4,0;2,0;3,0;22,0;;;1,0;17,0;9,0;;43,0;;;;6,0;9,0;1,0;;;11,0;11,0;46,0;15,0;10,0;5,0;;14,0;5,0;3,0;;;13,0;;;13,0;14,0;;;3,0;;4,0;;7,0;1,0;;16,0;2,0;1,0;;60,0;;;;8,0;;;2,0;;;9,0;2,0;2,0;;;5,0;;;1,0;10,0;10,0;5,0;1,0;4,0;;;18,0;4,0;;;;;;1,0;1,0;16,0;;;;;11,0;6,0;1,0;8,0;3,0;;;45,0;;16,0;;;;;;3,0;;50,0;4,0;4,0;28,0;;4,0;11,0;;2,0;;2,0;;8,0;27,0;;3,0;3,0;;;4,0;;;;27,0;;4,0;17,0;7,0;1,0;;;;4,0;4,0;2,0;1,0;17,0;6,0;;;3,0;3,0;;77,0;;4,0;;3,0;;3,0;3,0;29,0;1,0;;;;;;3,0;;;;2,0;;26,0;17,0;1,0;1,0;;;17,0;4,0;;12,0;30,0;;;;;;15,0;6,0;;;1,0;;;1,0;;1,0;;;;1,0;10,0;8,0;2,0;2,0;;38,0;4,0;;;2,0;;2,0;38,0;2,0;1,0;2,0;7,0;40,0;3,0;5,0;;4,0;2,0;4,0;3,0;;;;5,0;4,0;7,0;;4,0;3,0;;3,0;;5,0;;6,0;;;8,0;2,0;13,0;3,0;;;1,0;;;;;2,0;;15,0;4,0;2,0;19,0;;;;;1,0;2,0;;3,0;;2,0;1,0;7,0;;13,0;4,0;;;;17,0;2,0;9,0;5,0;5,0;;;;;;;;;;;1,0;1,0;1,0;;10,0;9,0;1,0;;;;3,0;3,0;7,0;;;;2,0;1,0;;;;;;;;6,0;8,0;;;3,0;;;;;3,0;3,0;2,0;;;2,0;2,0;;1,0;;1,0;6,0;1,0;1,0;;;;1,0;;1,0;;;5,0;1,0;4,0;;;;;;;1,0;;2,0;2,0;;;;;15,0;;;1,0;;8,0;5,0;;;8,0;9,0;3,0;;;;3,0;;3,0;2,0;;11,0;;;;;;;;;2,0;2,0;;3,0;;3,0;22,0;;;1,0;;;1,0;;;1,0;5,0;1,0;;;1,0;3,0;1,0;;;;;;;;;;;;1,0;3,0;;;;;;;;;;2,0;1,0;;1,0;3,0;5,0;;10,0;;;1,0;;;;1,0;;;7,0;16,0;1,0;;;2,0;;;;2,0;2,0;;1,0;;6,0;;;4,0;;;;;;;9,0;;;;3,0;;;;;;;;;;;;;3,0;;;;5,0;;;4,0;26,0;7,0;;;;;;3,0;;;;;3,0;;;;;;;;;;21,0;;;;2,0;2,0;;;;1,0;;;;;;;3,0;;;;;;2,0;;;;5,0;;;;;;1,0;;14,0;;;1,0;;;;;;;;;;;;;2,0;;;;;;;;;;;;;;2,0;;;;;;;;;;8,0;2,0;;1,0;;;;;;;;;;6,0;;;;1,0;;7,0;;;;;1,0;6,0;;6,0;;6,0;2,0;;;;10,0;;1,0;1,0;;;;3,0;;1,0;1,0;;2,0;1,0;4,0;;2,0;;;;1,0;;11,0;;;;6,0;3,0;;;3,0;2,0;;2,0;;;;;3,0;;;;;;;;;1,0;;;1,0;4,0;;1,0;2,0;;;4,0;;1,0;3,0;;;;5,0;;1,0;;39,0;;;;4,0;;;11,0;;;;;;;;;3,0;;;;;;;;;3,0;;;1,0;;;;;2,0;1,0;;2,0;;;;3,0;;49,0;;;;;1,0;;;;;;;;;;1,0;;;;3,0;5,0;;;;;;;;6,0;;1,0;;;;2,0;8,0;;;;;;;;;;;;;;5,0;;;;;;;;3,0;3,0;;3,0;1,0;;;;;;;;1,0;1,0;;;;;;;2,0;;;;;;4,0;;1,0;;;;;;;2,0;;1,0;;1,0;;;;;;;;;;;;;;3,0;2,0;8,0;;;;1,0;;;4,0;2,0;;;;;;;;;;;;;;;;;;;;;;1,0;;;;2,0;1,0;;;;;3,0;;;;;;;;;;;;;;;;;10,0;;;;;;;;
curvature;;;;8,0;1,0;4,0;15,0;21,0;;;4,0;;1,0;16,0;;;1,0;;1,0;1,0;;1,0;;;;4,0;;;;21,0;10,0;;7,0;2,0;;2,0;3,0;15,0;9,0;;8,0;7,0;;4,0;2,0;2,0;6,0;21,0;;;1,0;;10,0;;32,0;16,0;11,0;;;;;;3,0;1,0;129,0;;6,0;2,0;;1,0;23,0;375,0;7,0;10,0;3,0;;5,0;;;;14,0;1,0;;3,0;6,0;1,0;;28,0;;;2,0;3,0;1,0;1,0;;;2,0;6,0;2,0;7,0;23,0;18,0;;;1,0;2,0;;;;2,0;;;2,0;1,0;;;;;;10,0;1,0;;3,0;5,0;;;28,0;2,0;;2,0;;;;17,0;;;3,0;;;;;;1,0;;1,0;;1,0;2,0;;1,0;;2,0;4,0;6,0;;;10,0;;;;;1,0;;;;;1,0;2,0;;3,0;5,0;;;40,0;7,0;3,0;;;;;;;;5,0;;;;;2,0;15,0;;;;1,0;1,0;;6,0;;7,0;;;;;;2,0;3,0;1,0;;;4,0;;;;;;12,0;;;;1,0;1,0;;;;1,0;;15,0;;;2,0;;2,0;1,0;;4,0;;3,0;1,0;;22,0;;;;;;;;8,0;144,0;;5,0;1,0;6,0;2,0;9,0;;1,0;282,0;;;;2,0;;9,0;;;;;;1,0;5,0;;2,0;1,0;;;;31,0;;3,0;;;5,0;;;;;;;;2,0;;;5,0;;;14,0;;;;;;2,0;;;;;;1,0;2,0;1,0;;;;1,0;;;;;;;119,0;;;;;;;1,0;;;;;5,0;;;;;;;;;;3,0;;2,0;6,0;5,0;;2,0;;;;;4,0;;;2,0;;;;;;2,0;;3,0;;;;;;;12,0;7,0;;;;;;;1,0;;;1,0;;11,0;;5,0;;;;;;1,0;;;;3,0;;;;;;;;7,0;;;;;;;;;1,0;;;;;;;;;;2,0;1,0;;1,0;;;;;;;2,0;6,0;;;;;;;16,0;;;;;4,0;;;;;;4,0;;;5,0;;;;;;;;;;;;;;;;;;;;2,0;1,0;;2,0;4,0;;;;;;1,0;;;;;;;;;;2,0;;;;;;;;;2,0;1,0;;;;;2,0;;;;2,0;;;;2,0;3,0;1,0;;;;;;;;;;;;2,0;3,0;;;;;3,0;;1,0;;1,0;;;;;;;;;;;;;;;1,0;;;;;;;;;;;;;;;;;;;;11,0;;1,0;;;;;;;;;;;;;;;;;;;;;;;9,0;;;;;;;;;3,0;;;;;;;;;;;;;;;;;;;;;;;;;;1,0;;;;;;;;;;;;;;;;2,0;;9,0;;;;;;;;;;;;;;2,0;;;;;;;;;;;;;;;;;;;;;;;;;1,0;1,0;10,0;;;2,0;;2,0;;2,0;;;;;1,0;;;4,0;;;1,0;;;;;;;;;;;;;;;;;;11,0;1,0;;;;;1,0;2,0;;;3,0;;;;;;;;;;;;9,0;;;;;;10,0;;;;;;;;;2,0;;2,0;;;;;;;;;;;;;;;1,0;;;;;;;;;;;;;;;;;;;;;;;;;;;;;1,0;;;;1,0;;1,0;;;1,0;;;;;;;;9,0;;2,0;;;;;;;16,0;;;;;;;;;;4,0;;;;;;;;;;;;;;;;5,0;;;51,0;22,0;;2,0;;;;;;;;;;;;;;;;;;;;;;;;;;;;;;;1,0;;;;;;;;;;;;;;;;;;;;2,0;;;;340,0;;2,0;;;;;;;;;;;;;;;;;;;;;;9,0;1,0;;;;;;;;;;;;;1,0;;;;;;;;;1,0;;;;;;6,0;;;;;;;;12,0;;;;;;;;;
dark;;;;1,0;;10,0;7,0;1,0;;;;;;15,0;;1,0;27,0;;;;;5,0;140,0;;;2,0;;;;1,0;1,0;2,0;2,0;;;7,0;;;1,0;;;6,0;;2,0;13,0;;;4,0;;;;;;3,0;2,0;4,0;42,0;;;;3,0;;;;41,0;;4,0;1,0;;;;1,0;18,0;;;;11,0;;;;17,0;;;;;;;;;;;;;;5,0;;31,0;4,0;9,0;28,0;;;;2,0;;;;1,0;;;;1,0;26,0;;;;;;9,0;7,0;2,0;1,0;5,0;;;;5,0;;1,0;;3,0;;;;;;1,0;;;;;3,0;;;;15,0;17,0;;4,0;;;;;;;1,0;;;;;;7,0;;;;;1,0;1,0;4,0;;;;;;1,0;13,0;;;;;;;3,0;;;;2,0;;23,0;;2,0;;;;;3,0;1,0;;3,0;;;;;;9,0;;;;;1,0;;;;3,0;;1,0;2,0;1,0;;;6,0;;;;;;17,0;;3,0;2,0;;;;;;;;;;;;17,0;;;;8,0;;;1,0;;;;;;;;;10,0;;;;;;7,0;;;;;;;;;;;;;;1,0;;;;;;;;;;52,0;;;;;;;;;1,0;;;;;;;;;;;;;3,0;;;;;;;;;;;2,0;5,0;;;;;;;;;;;;;;;;;;;;;;;;;;1,0;;;;;;;;;;;8,0;;;;;;;;;;;;;;;2,0;;;;;;;4,0;;;3,0;;5,0;1,0;;;;;;;;;;;1,0;1,0;;;;;4,0;;;;;;;;;1,0;;4,0;;;;;;;;;;;;;1,0;;;1,0;;;;;;;;;;;1,0;;;1,0;;;;;;;2,0;;;;3,0;;8,0;;;2,0;1,0;8,0;;;;;;;;;4,0;;;;;;;;;;;;;;;;;;;;;;;;;1,0;;;;;;;;;;;;;;;;;;;;;;;;;;;1,0;;;;;;;;;;;;;;;;;;1,0;;37,0;;;;;;;;;;;;1,0;;;;;;;;;;;;;;;;;;;;;;;;;1,0;;;;;;;;;3,0;;;;;;;;;18,0;;;;;;;;;;;;;;;;;;;;;;3,0;;1,0;;;;;;;;2,0;;;;;;;;;;;;1,0;;;;;;;;;;;;;1,0;;;;;;;;1,0;;;;;;;3,0;;;;;;;;1,0;;;;;;;;;;;;2,0;;;;;;;;;;;;;;;;;2,0;;;;;;;;5,0;;;;;;;;;2,0;;;;;;;;;2,0;1,0;;;;;;;;2,0;;;;;;;;;;;;;;;;2,0;;;;;;;;;;;;;;1,0;;;;;;2,0;;2,0;;;;1,0;;;5,0;;;;;;;;;;;;;;;;4,0;;;;;8,0;;;;;;;;;;;;;;;;;;;;;;;;;;;;;;;;;;;;;;;3,0;;;4,0;;;;3,0;1,0;1,0;;;;1,0;;;;;;;;;;;;;;;;;;;;;;;;;;;;;;;;;;;;;;;;;;;;;;;2,0;;;;;;;;;;;;;;;;;;;;2,0;;;;;;;;;;;;;;;;;;;;;;;;;;;;;;;;9,0;;;;;;;;;;;;;;;;;;;;;;;;;;;;;;;;;;;;;;;;
database;;;;1,0;;19,0;;;2,0;9,0;;;;91,0;;;3,0;;2,0;14,0;;;6,0;4,0;16,0;;;;14,0;5,0;23,0;3,0;;4,0;;95,0;3,0;;3,0;;74,0;39,0;;3,0;17,0;2,0;;1,0;;1,0;9,0;;;3,0;;;3,0;;3,0;4,0;;;1,0;;120,0;;37,0;;8,0;;;1,0;2,0;;;;;;3,0;24,0;36,0;;2,0;26,0;6,0;;;;;4,0;4,0;;;;;;1,0;;38,0;27,0;55,0;4,0;;9,0;3,0;11,0;5,0;4,0;;;;10,0;35,0;;;4,0;;;1,0;1,0;2,0;;2,0;;;158,0;55,0;;;;3,0;4,0;;12,0;;;;3,0;;;;;;;;2,0;;;38,0;1,0;;;1,0;;;;;;;;;4,0;1,0;;;;1,0;;;1,0;;;;;;;;;1,0;;;;;2,0;;;;;3,0;;;2,0;;6,0;;;3,0;;;;;;;;5,0;6,0;;;;;;2,0;;;;;1,0;;;;;;15,0;;13,0;;3,0;;;;;;2,0;;1,0;5,0;1,0;;;6,0;;;;;;15,0;;;;;;;;;;1,0;2,0;1,0;;;2,0;5,0;;13,0;;;;;;;;;;;;;;18,0;;;;;;;2,0;;;;;;;8,0;;;1,0;;9,0;;;;;;;;;;1,0;13,0;;1,0;;;;;;;3,0;;;;12,0;49,0;;;;;;;2,0;;;;;;7,0;;;;1,0;;1,0;;;;;2,0;;4,0;;;;;12,0;;;;;;19,0;3,0;;;;;;1,0;;3,0;;;;;2,0;;1,0;;;;4,0;7,0;10,0;2,0;;;2,0;13,0;3,0;2,0;;;;;8,0;;;;;10,0;;;;1,0;;;;24,0;;;;;;;;1,0;4,0;1,0;;;;;;;;;2,0;15,0;15,0;4,0;;;2,0;;8,0;;19,0;;2,0;12,0;2,0;;;;2,0;;;6,0;;1,0;21,0;;;;;;;;;4,0;;3,0;;1,0;;6,0;;;;;6,0;21,0;2,0;;5,0;;;;;;6,0;;;;;1,0;;;1,0;7,0;;;;;26,0;3,0;;;1,0;;1,0;;7,0;2,0;;;;;;1,0;;;1,0;1,0;;;;;;;;;6,0;;;;;;;;;;;10,0;;;;;;1,0;4,0;22,0;21,0;;;;;9,0;;;;;;;1,0;1,0;;;;1,0;;20,0;;;;;15,0;1,0;;;14,0;;;;;;;;;4,0;;;;;;;4,0;;;;2,0;;;;;5,0;;;1,0;;1,0;;1,0;;;46,0;;4,0;;;;;;1,0;1,0;;1,0;;9,0;17,0;3,0;;4,0;;;;11,0;;;;;;;1,0;;13,0;;;;;;;;;;;;;;;2,0;;;1,0;1,0;1,0;;;4,0;;1,0;;;5,0;8,0;;;;2,0;;;;3,0;2,0;;2,0;;;1,0;2,0;11,0;;;3,0;;;;2,0;;;;;;;;;1,0;;;2,0;;;;;;;;;;;;4,0;;;;;;5,0;1,0;;;;1,0;;;;;;;;;;;;;;;57,0;1,0;;;;;;;;;;;;;;;;;;;;;;;;;;;;;1,0;;;2,0;;;;3,0;;;;;;;;;;;;;;;;;;;;;;;;5,0;;15,0;;;;;;;;;;;;;;;;;47,0;;;;;;;6,0;;;;;;;;;;1,0;;3,0;;2,0;;;;;;2,0;4,0;;;;;;;;;;;2,0;;;;;;;;;11,0;;;1,0;;;;;;;;;;;;;2,0;;;;;;4,0;;;;;;;;;;;1,0;;;;2,0;;;;;;;;;;;;;;;;;;;;;;;;;4,0;;1,0;;;11,0;;;;1,0;;;;;;;;;;;;;;;;5,0;;;;;;;;;;;;;;;;4,0;;;2,0;;;;;4,0;;;;;;;;;;;;;;;;1,0;;;;;;;;;
denote;;;;4,0;;5,0;;;;;13,0;;;;;;;;;;;;5,0;;;;;3,0;2,0;23,0;2,0;;2,0;;;;3,0;1,0;40,0;;18,0;2,0;;;6,0;;2,0;;28,0;4,0;4,0;;;;1,0;74,0;;;;;;;11,0;;46,0;;4,0;;;1,0;83,0;149,0;;;1,0;;;6,0;;;10,0;;;;1,0;;;5,0;;;6,0;;;;;;40,0;22,0;;36,0;6,0;3,0;;;1,0;1,0;;2,0;;;;7,0;4,0;;;;6,0;;12,0;4,0;1,0;;;;1,0;;3,0;;;14,0;6,0;;;22,0;;;;;10,0;;;;;;;3,0;1,0;;;;;;;;;;;;1,0;;;;;;;;;;;;;;;;;;;;;;;;;3,0;;;4,0;;4,0;;;;;;;;;;;;;;;;;;;;;;;;;;;;;;7,0;;;;6,0;;;;;;;;;;24,0;12,0;;2,0;;;;4,0;;;;;;;;;5,0;;;;;;;;;19,0;;;;;;;;;;4,0;20,0;;;;;;;;;24,0;;;;;21,0;;;;;;;;;;;;;;50,0;;;;;;;;;;;;;4,0;;;;;3,0;;;;;;;9,0;;;;;;;;;;;;;;;;;;;18,0;22,0;;;;;;3,0;;;;;;;;;;;;;;;;;;;;;;;;;7,0;13,0;;;;;;;;25,0;;2,0;;5,0;;3,0;;;;;3,0;;;27,0;4,0;;;;;;;6,0;;8,0;;;;;;;;;4,0;;2,0;;;;;8,0;;;1,0;;;;;;;;;;;;;;;;;;2,0;;;;1,0;;;;;;;;;;;29,0;;;2,0;;;;;1,0;;;;;;1,0;;;;;;;;;;;;3,0;;;;;;24,0;;;;4,0;;;;;;;8,0;;;;8,0;2,0;;;;;;;;;;;;;;;;;;;;;;;;;;;;;4,0;;6,0;;;1,0;;;;;;;;;;;;;;;3,0;;;;;;;;;;;;;;;;;;;;;;;;;;;;;;;;;;;2,0;;;;2,0;;;;;;;1,0;;;;;;;;;;;;7,0;1,0;;;;;;;;;9,0;;;;;;;;;;;;;;;;;4,0;;;;;;;;;;;;;;;;;;;;4,0;;;;;;;;;;;1,0;;;;;;;;13,0;;;;;;;;;;;;;;;;;;;;;;;;;;;;;;;4,0;;;;;;;;;;10,0;;;;;;;;;;;;;;6,0;5,0;;2,0;;;;;;;;;;;6,0;;;;;;;;;;;;;;;;;;;;;;;12,0;;5,0;;;;;;;;;;;;;;;6,0;;;;;;;;;4,0;;;;;;;;;2,0;;;;13,0;;24,0;;;3,0;;;;;2,0;;;;;;;;;;;;;;;;;;;;;;;;;;;;;;;;;;;;;3,0;4,0;;;;;;;;;;;;;3,0;;35,0;;4,0;;;;7,0;;;;;;;;;;;6,0;;;;;;;;;;;;;;;4,0;;;;;;;;;;;;;;12,0;;;;8,0;;;;;;;17,0;;;;;;;;;;;;;;;29,0;;;23,0;;;;;;3,0;;;;;;;;;;;;;;5,0;;;;;;;;;;1,0;;;;;;;;;;;;;69,0;;;8,0;;;;;;
derive;;;;15,0;14,0;9,0;;;3,0;;;;;49,0;;3,0;63,0;;7,0;;;;2,0;;5,0;;2,0;16,0;1,0;;23,0;9,0;1,0;12,0;;140,0;2,0;5,0;12,0;;18,0;22,0;1,0;26,0;21,0;;;2,0;9,0;1,0;16,0;;;;2,0;;;;4,0;7,0;;;2,0;;238,0;;7,0;;3,0;;1,0;1,0;31,0;;8,0;;1,0;65,0;;;50,0;;6,0;15,0;8,0;;;9,0;;1,0;28,0;9,0;;;;;28,0;3,0;22,0;24,0;16,0;9,0;;6,0;20,0;6,0;;;;;;16,0;20,0;;;1,0;3,0;5,0;17,0;17,0;2,0;;19,0;4,0;;12,0;26,0;;5,0;;10,0;;3,0;40,0;1,0;;18,0;;;;;;;;;3,0;5,0;3,0;9,0;;;4,0;;;2,0;;;;;;;;;;;;;;;3,0;;;;6,0;;4,0;;;;;;;;2,0;;3,0;;;11,0;;;;;;;;1,0;5,0;;;;4,0;;;1,0;2,0;1,0;;;;;12,0;;;;3,0;24,0;;3,0;;8,0;1,0;;;;;5,0;;;;;;;5,0;;;2,0;;;10,0;4,0;;;;;15,0;;;;1,0;;;;1,0;;;;1,0;;;;2,0;;5,0;;;;;3,0;5,0;;;;1,0;;;1,0;64,0;;;;5,0;12,0;;;;;4,0;5,0;;;3,0;;;;;16,0;1,0;;;;;;5,0;1,0;;;;5,0;6,0;;;1,0;;1,0;;;;;;;31,0;;;;;;;;;;;;;4,0;;1,0;;;;;2,0;1,0;;;;5,0;1,0;;;;;5,0;;1,0;;;;26,0;1,0;;;;1,0;;4,0;9,0;1,0;;;;;1,0;;2,0;;;33,0;6,0;1,0;29,0;9,0;3,0;1,0;;3,0;6,0;2,0;;;;;;4,0;1,0;27,0;;;3,0;4,0;1,0;24,0;6,0;;5,0;13,0;;;27,0;;;4,0;;;;5,0;;;;;;35,0;1,0;;;16,0;;2,0;;1,0;;;3,0;;10,0;;2,0;;2,0;3,0;7,0;;8,0;1,0;4,0;3,0;;;13,0;;;;;;;;;15,0;;7,0;1,0;;;;;;9,0;;;;1,0;;1,0;4,0;;41,0;;;2,0;;;;;6,0;1,0;16,0;4,0;;;2,0;;;;;3,0;;4,0;;;7,0;;6,0;;;26,0;10,0;2,0;;;;8,0;;;;2,0;4,0;;;;;;;;;;6,0;;;;;;;;;3,0;;;;;18,0;1,0;4,0;;;1,0;1,0;;;;14,0;;;;1,0;;1,0;;22,0;;9,0;;;;2,0;20,0;;3,0;;;1,0;;;;;1,0;;;;;;4,0;;;;;;;;;3,0;;2,0;;6,0;;;;;2,0;;23,0;;1,0;17,0;3,0;5,0;;;;;;;9,0;;1,0;;3,0;;;4,0;;;3,0;;;1,0;;;;;7,0;;;;;;;;;4,0;;;;;2,0;;;;;;;;;;10,0;;;2,0;;7,0;;4,0;1,0;;;;;;;;2,0;;;;;;1,0;;14,0;5,0;;2,0;;5,0;1,0;;1,0;;;;1,0;;6,0;;1,0;;;;;;;;1,0;;;;;;;15,0;;1,0;;;;;;;;;;;;;;;;;;;;;;3,0;1,0;;;;;;;;1,0;;;;4,0;;1,0;;;;;;;;;;;1,0;;;;;;;;;;;;;3,0;;;;;;;;1,0;;;4,0;;3,0;;5,0;;;;;6,0;;;;2,0;;;;;;;2,0;;2,0;;6,0;;6,0;;;;;;;;1,0;;5,0;;4,0;;1,0;2,0;8,0;;;10,0;;7,0;;5,0;;;11,0;;;;;;;;;;;;3,0;1,0;;;;;;;4,0;8,0;;;;;;;;;3,0;;;;;4,0;;1,0;1,0;18,0;;;;1,0;;;;;2,0;;1,0;1,0;;;;1,0;1,0;;3,0;;;;;;;;2,0;;;;;;;;;;;;;;12,0;;;2,0;;2,0;;;;;;;;;;;1,0;;;;;;;;;;;;;;;;;;;;;;;;;;;;;;;;;;;;1,0;;;1,0;;;;3,0;3,0;1,0;;;;;;;;;;;;6,0;;;;;;;;2,0;;;
describe;;;;15,0;4,0;71,0;20,0;33,0;1,0;11,0;;;1,0;19,0;;;33,0;;;;;2,0;6,0;2,0;1,0;1,0;2,0;18,0;3,0;40,0;4,0;1,0;;;;82,0;8,0;;21,0;;19,0;125,0;3,0;6,0;21,0;4,0;9,0;13,0;2,0;1,0;7,0;;;;10,0;21,0;4,0;;;20,0;1,0;1,0;9,0;;116,0;6,0;124,0;3,0;2,0;1,0;14,0;114,0;15,0;1,0;1,0;;;2,0;3,0;1,0;169,0;;8,0;8,0;31,0;;1,0;14,0;3,0;1,0;24,0;;;6,0;1,0;;15,0;13,0;21,0;13,0;28,0;4,0;;1,0;8,0;9,0;1,0;;3,0;;;14,0;14,0;2,0;;;2,0;;12,0;41,0;1,0;1,0;;2,0;;2,0;147,0;2,0;14,0;;12,0;;;8,0;2,0;;19,0;1,0;3,0;;;;;;2,0;3,0;;2,0;4,0;1,0;;1,0;8,0;9,0;2,0;;;;;6,0;;2,0;8,0;;;;8,0;2,0;;3,0;4,0;2,0;;11,0;;;;;4,0;;14,0;;2,0;9,0;;;4,0;;26,0;2,0;2,0;;4,0;;2,0;2,0;8,0;;3,0;1,0;;3,0;7,0;;3,0;25,0;8,0;;1,0;33,0;;2,0;1,0;;;2,0;2,0;3,0;11,0;6,0;10,0;;;;6,0;;14,0;;;2,0;;;7,0;2,0;2,0;1,0;;;;34,0;;;;;;6,0;;10,0;4,0;;;1,0;;31,0;2,0;;14,0;36,0;;;1,0;2,0;2,0;14,0;2,0;;;;1,0;2,0;;;3,0;;1,0;;3,0;4,0;;1,0;;;14,0;2,0;1,0;;1,0;;1,0;;2,0;13,0;;1,0;2,0;;8,0;1,0;;;;2,0;5,0;2,0;;;4,0;7,0;4,0;16,0;;;;;;;2,0;;3,0;6,0;8,0;34,0;;2,0;1,0;;;;5,0;;;;;2,0;3,0;;;;2,0;;7,0;10,0;2,0;5,0;3,0;;;3,0;;;3,0;;1,0;;4,0;2,0;;4,0;38,0;4,0;;1,0;2,0;;;5,0;;3,0;;2,0;1,0;;5,0;3,0;;;;2,0;;;17,0;3,0;;;;6,0;1,0;;3,0;2,0;;3,0;15,0;9,0;3,0;22,0;1,0;8,0;;;4,0;4,0;2,0;5,0;2,0;5,0;;10,0;12,0;7,0;1,0;2,0;;9,0;5,0;23,0;5,0;;;;;1,0;;1,0;2,0;26,0;2,0;;1,0;7,0;2,0;;1,0;2,0;;;2,0;4,0;2,0;1,0;1,0;;3,0;2,0;1,0;14,0;8,0;;22,0;;;1,0;;;;1,0;1,0;10,0;;;26,0;4,0;;3,0;;;2,0;;;;;1,0;;3,0;;;2,0;;3,0;;2,0;2,0;;3,0;;;16,0;6,0;3,0;5,0;16,0;;;3,0;3,0;2,0;3,0;5,0;1,0;4,0;2,0;2,0;1,0;1,0;15,0;5,0;;2,0;;3,0;1,0;;;2,0;;;;;;1,0;;14,0;;2,0;8,0;;;3,0;;;;3,0;;1,0;3,0;;;4,0;1,0;1,0;1,0;2,0;;1,0;;1,0;;;;;;;3,0;2,0;3,0;;;;;;3,0;;1,0;2,0;4,0;;2,0;2,0;;;;;;;3,0;9,0;1,0;;;;;;2,0;;1,0;;;;;5,0;;;;2,0;;3,0;2,0;;12,0;1,0;1,0;;;37,0;1,0;6,0;;1,0;6,0;;;;;1,0;9,0;1,0;10,0;;1,0;1,0;;;;15,0;;;;;;;;;3,0;1,0;;2,0;;;;;2,0;2,0;2,0;1,0;;;;1,0;;;;1,0;;;8,0;3,0;;1,0;;;;1,0;1,0;2,0;;;;;;;1,0;;;;1,0;;;1,0;23,0;;;3,0;;1,0;;;1,0;;;;2,0;3,0;;2,0;;;;;;;;;;1,0;1,0;;;1,0;;;;1,0;7,0;;1,0;4,0;;1,0;1,0;;;;;;;1,0;;;3,0;3,0;4,0;;;5,0;6,0;1,0;2,0;;;3,0;5,0;1,0;;;;;;;1,0;1,0;;;;;;;;;;;2,0;2,0;;;;;4,0;;;2,0;;;1,0;;1,0;;;;;;4,0;;1,0;;;1,0;;;;;;;27,0;;;;3,0;;3,0;;;;;3,0;;2,0;;;1,0;8,0;2,0;;;;;1,0;;;;;1,0;;1,0;;;;;3,0;;;;;1,0;;;6,0;;1,0;;;;;;;;;;;24,0;;;9,0;2,0;1,0;1,0;1,0;2,0;3,0;;;;;;;;;;;;;;2,0;36,0;4,0;;;;2,0;;;;;;9,0;;;;12,0;;1,0;1,0;;;;;;;1,0;;;;;;;;1,0;;2,0;;;;;3,0;;;;1,0;;1,0;;1,0;;;;;3,0;;2,0;1,0;;;;;;;;;;;;;2,0;;;;;;4,0;;;3,0;;;;;;;;;;;;;;1,0;;;;;;3,0;;;;1,0;3,0;;1,0;;;2,0;;2,0;14,0;;;3,0;;1,0;;;5,0;;;;;;;;
designate;;;;2,0;;;3,0;;;;;;;33,0;;;13,0;;;;;;;;4,0;;;1,0;4,0;;6,0;3,0;;1,0;;17,0;;;;;7,0;14,0;;5,0;13,0;;;;;;;;;2,0;9,0;;1,0;;;4,0;;;4,0;;89,0;2,0;3,0;;;;;1,0;5,0;;5,0;;;;2,0;1,0;28,0;;42,0;;3,0;5,0;;;;;;;1,0;;;;;1,0;39,0;19,0;37,0;3,0;;2,0;3,0;8,0;;;;;;34,0;27,0;;;3,0;;1,0;1,0;3,0;;;11,0;;;4,0;16,0;;;;3,0;;10,0;14,0;;;7,0;3,0;3,0;;;;;;3,0;1,0;50,0;;;;;1,0;2,0;;1,0;;;;;;;;2,0;1,0;;;;;;;7,0;;2,0;;;;;;;;;;;4,0;;;3,0;;12,0;;;;;;;;;;;;;;;;7,0;;;;;;;6,0;;;;;1,0;;;;1,0;2,0;1,0;;;;5,0;;;;;4,0;1,0;;;;1,0;;;1,0;;;;;;;;1,0;2,0;;;;;;;;;1,0;;;;2,0;;5,0;;;;;;;;;;4,0;;;2,0;8,0;;;;;2,0;2,0;2,0;;;;4,0;;;;;;;;;;;;;;;;;;;;;6,0;;;5,0;;;;2,0;;7,0;;4,0;11,0;;1,0;;;;;;;;;;;1,0;;;;;;;;2,0;;;1,0;5,0;;;;;;;;1,0;;2,0;;21,0;;;;;;;2,0;;;;;;;;1,0;15,0;4,0;;1,0;3,0;;9,0;6,0;;;;2,0;1,0;;;1,0;3,0;6,0;;3,0;;;;1,0;4,0;1,0;;24,0;;1,0;;2,0;;2,0;1,0;;;3,0;;1,0;19,0;;;;;4,0;;2,0;;;;7,0;1,0;6,0;;1,0;2,0;;;;;;1,0;11,0;1,0;;;7,0;3,0;;;;;;26,0;2,0;;;;;;;;;;;8,0;;;;;;;9,0;;;;;8,0;2,0;;;1,0;6,0;2,0;;;;;;;;2,0;;;2,0;;;;;1,0;;17,0;4,0;;;;1,0;;19,0;;2,0;;;;1,0;;;;;;2,0;;3,0;;;30,0;;;;;;;;;;;;;1,0;;;;5,0;2,0;3,0;;;;;;8,0;;;;3,0;;;;;;2,0;;;;;;;6,0;;;;;;;;;;;;;;;1,0;;;;;;;;;;;;;3,0;;;;;;;;;;;;6,0;1,0;;;;;;;;;;;2,0;;;;;2,0;;;;13,0;;;;;;;;2,0;;6,0;;;;;;;;;;;2,0;21,0;;;;;;;;;;;;;;;;3,0;6,0;;;;;;;;;;;;3,0;;;1,0;24,0;;;1,0;;;;;;;;;;;;;;;;1,0;;;;;;1,0;;;;;;;;;;;;;;;;;;;;;;;;;;1,0;;;;;1,0;;;;;;25,0;;;;;;;;;;;;;;;;7,0;;;;;;;;;2,0;;;;;3,0;;;;;;;;;2,0;;;;;;;;;;;;;2,0;;;;;1,0;1,0;;;;;1,0;2,0;;;;;;;;;;;;;;;;;;;;;;;;;;;;;;;;;1,0;;;;;;2,0;;;;1,0;;1,0;;;;;;;;;;;3,0;;;;;;;;;;;;;6,0;;;;;;;;;;;;;;;;1,0;;;;;;1,0;;;1,0;2,0;;;;;;;;;;;;;;;;;;;;;;;;;;;;;1,0;;;;;;;;;;;;;;;;;;;;;;;;;;;;;;;;;;;;;;;;2,0;;;;;;;;;;;1,0;;;;;;;;;;;6,0;;;;4,0;;;;;
destination;;;;1,0;;15,0;;;;31,0;;;;27,0;;;;;;;;;;2,0;2,0;;;7,0;8,0;;8,0;4,0;;;;117,0;3,0;;2,0;;96,0;67,0;;10,0;10,0;;;;;3,0;;;;1,0;2,0;;;;;4,0;;;;;50,0;;32,0;;;;;;;;;;;;2,0;48,0;68,0;;;4,0;;;;;;;;;;;9,0;;21,0;4,0;17,0;14,0;90,0;16,0;;2,0;6,0;10,0;;7,0;;;;;;;;2,0;8,0;8,0;;2,0;;;17,0;;;11,0;32,0;;;;42,0;;;13,0;;;1,0;;;;;4,0;2,0;;;4,0;2,0;;12,0;2,0;;;;;1,0;;;;;;;2,0;4,0;;;;;;;;;;4,0;1,0;;;;;16,0;;;;;;;;;;35,0;;;;;2,0;;;;;;;;;;;;3,0;;;;;30,0;;;;;;21,0;;;;;1,0;;;1,0;;9,0;;;;;;1,0;;;1,0;;;;;;;;;;67,0;14,0;;;;;;;;;;2,0;1,0;1,0;;12,0;3,0;;98,0;;;;;;;;;;;;;;5,0;;;;;2,0;;1,0;;;;;2,0;;;;;;;1,0;;;;;;;;;;;;;9,0;3,0;;12,0;;6,0;;2,0;;;2,0;21,0;6,0;;;;;;;;6,0;;;;;2,0;;3,0;;;;;;;;;;;1,0;;;;;;;7,0;;9,0;;62,0;8,0;;;;;;;5,0;;;3,0;;;;2,0;20,0;;;18,0;;;16,0;;;3,0;8,0;;4,0;;;;;;;;;;;25,0;15,0;;;;;;;184,0;;;2,0;;;2,0;;;6,0;;;;;;;;2,0;;1,0;42,0;;7,0;;;;13,0;2,0;;2,0;;4,0;;11,0;;;;1,0;;;5,0;7,0;4,0;32,0;;;;;;;;;3,0;1,0;;5,0;;;6,0;;;;;;;1,0;3,0;5,0;3,0;;;;;;1,0;;;;;;;3,0;;;;;;2,0;;;;;;;;;15,0;;;;;;;;2,0;17,0;;;;34,0;;;;;;4,0;;;;;;;;;;;;;3,0;3,0;;;;1,0;;;;;4,0;;55,0;;;;;;;1,0;;2,0;;;;;;;88,0;;;;;6,0;;;;;;54,0;24,0;;2,0;;;;;;;;;;;;;1,0;;1,0;15,0;;21,0;1,0;;;;;;;;;;;7,0;;;;;;;;;;;;1,0;20,0;2,0;;;;;;;2,0;;;;;;;16,0;;9,0;7,0;;4,0;;;;;;;;;;;;;;;;;;;;;;;6,0;;;;;;;;;2,0;;1,0;1,0;;;11,0;;1,0;;;;;;;;3,0;6,0;;;;;;4,0;;1,0;;;;;;;;10,0;;;;;;;;;;;;;;;;;2,0;;;8,0;;2,0;;;;;;2,0;;;;;;;;;;;;;;;;1,0;;;;;;;;;;;;;;;;;;;;;;;;;;;;;;1,0;;;;;;;;1,0;;;2,0;2,0;;;18,0;;;;;;;;;;;;;;;;1,0;;;;;;;2,0;;;;;;;;;;;;;;;;;;;;;;;;;;;;;;;;;;;;;;;;;;;;;;;;;;;;;;;;;;;;;;;;;;;;;;;;;;;;;;;;;;;1,0;;1,0;;;;;;;;;;;;;;;;;;;;;;1,0;;;;;;;;3,0;;;;;;;;4,0;;;;;;;;;;;;;;;;1,0;;;;;;;;;;;;;;;;;;;;;;;;;;1,0;;;4,0;;;;;;;;;;;;;;;;
detector;;;;11,0;62,0;68,0;256,0;12,0;3,0;;;3,0;11,0;43,0;1,0;1,0;57,0;2,0;19,0;13,0;9,0;;;1,0;21,0;1,0;4,0;11,0;12,0;12,0;270,0;27,0;6,0;10,0;1,0;79,0;15,0;1,0;8,0;;53,0;118,0;;25,0;21,0;25,0;;36,0;2,0;;3,0;;1,0;6,0;23,0;12,0;19,0;;14,0;58,0;;1,0;30,0;;337,0;6,0;183,0;;2,0;4,0;;104,0;216,0;;;15,0;12,0;12,0;1,0;13,0;110,0;;12,0;9,0;66,0;11,0;2,0;133,0;1,0;;13,0;4,0;10,0;;5,0;;45,0;20,0;135,0;12,0;208,0;11,0;2,0;12,0;24,0;81,0;6,0;4,0;2,0;;;46,0;46,0;2,0;;3,0;3,0;27,0;7,0;92,0;10,0;1,0;101,0;10,0;;6,0;164,0;;12,0;1,0;38,0;2,0;;423,0;1,0;;39,0;1,0;9,0;1,0;;13,0;;;4,0;25,0;23,0;20,0;12,0;8,0;;9,0;19,0;3,0;1,0;4,0;;1,0;;;1,0;20,0;3,0;6,0;6,0;;70,0;9,0;1,0;48,0;;;6,0;86,0;;15,0;1,0;12,0;1,0;11,0;15,0;1,0;5,0;49,0;;1,0;9,0;;20,0;17,0;24,0;;3,0;5,0;3,0;4,0;45,0;;4,0;;;33,0;3,0;1,0;32,0;10,0;17,0;18,0;10,0;27,0;4,0;25,0;2,0;;;;48,0;3,0;;22,0;11,0;4,0;7,0;3,0;7,0;;39,0;;;10,0;;89,0;47,0;12,0;1,0;2,0;30,0;9,0;;2,0;2,0;8,0;2,0;;14,0;19,0;7,0;5,0;10,0;2,0;;1,0;9,0;13,0;37,0;3,0;10,0;53,0;3,0;2,0;4,0;4,0;1,0;9,0;4,0;;2,0;5,0;;18,0;1,0;1,0;5,0;33,0;2,0;;3,0;36,0;;2,0;;3,0;28,0;18,0;2,0;;4,0;7,0;41,0;4,0;8,0;;8,0;2,0;2,0;;22,0;12,0;;;;;2,0;2,0;;;;21,0;;81,0;;;1,0;5,0;;;10,0;13,0;2,0;15,0;4,0;67,0;11,0;14,0;19,0;2,0;1,0;;13,0;;;;;1,0;4,0;;;;;;69,0;52,0;18,0;;;6,0;13,0;5,0;;;1,0;;1,0;1,0;10,0;2,0;3,0;14,0;13,0;2,0;5,0;;4,0;5,0;1,0;2,0;6,0;15,0;;3,0;;1,0;10,0;13,0;4,0;1,0;12,0;1,0;7,0;;68,0;15,0;6,0;4,0;;452,0;1,0;3,0;;25,0;1,0;1,0;;87,0;6,0;6,0;;10,0;20,0;1,0;;5,0;13,0;5,0;1,0;17,0;2,0;6,0;99,0;8,0;;8,0;3,0;13,0;44,0;1,0;1,0;2,0;3,0;;;1,0;4,0;4,0;6,0;79,0;4,0;17,0;1,0;1,0;17,0;;1,0;7,0;9,0;;6,0;21,0;2,0;1,0;9,0;;29,0;37,0;4,0;5,0;1,0;;6,0;8,0;7,0;14,0;6,0;9,0;3,0;4,0;2,0;3,0;;4,0;7,0;2,0;9,0;1,0;2,0;;;;3,0;;4,0;2,0;2,0;8,0;;;2,0;5,0;9,0;7,0;4,0;;9,0;24,0;10,0;;30,0;2,0;2,0;13,0;;3,0;2,0;11,0;16,0;1,0;7,0;9,0;1,0;;8,0;7,0;2,0;3,0;3,0;15,0;2,0;3,0;2,0;;2,0;3,0;;1,0;;8,0;;2,0;;1,0;;;2,0;1,0;;1,0;4,0;;;;;8,0;;1,0;25,0;;;;1,0;4,0;;2,0;;3,0;1,0;1,0;;7,0;;;;;8,0;1,0;;1,0;;24,0;;;2,0;;1,0;16,0;;;1,0;2,0;;19,0;;;;2,0;6,0;13,0;5,0;2,0;1,0;2,0;6,0;;43,0;1,0;2,0;8,0;;2,0;13,0;5,0;;;;;;;;1,0;13,0;;18,0;;;9,0;;;11,0;3,0;2,0;;;3,0;9,0;2,0;;;3,0;3,0;;8,0;2,0;;16,0;4,0;;;;;;;;3,0;;1,0;2,0;;;;4,0;7,0;;108,0;;;;4,0;;;;;8,0;;3,0;;;;2,0;3,0;36,0;12,0;;5,0;4,0;1,0;1,0;7,0;7,0;;;;50,0;;7,0;11,0;1,0;;;1,0;12,0;;1,0;;;;1,0;12,0;8,0;29,0;1,0;;;1,0;;;;12,0;;;1,0;;;;1,0;7,0;31,0;;;;;;;;19,0;;1,0;;;2,0;5,0;5,0;3,0;5,0;;;2,0;;4,0;5,0;3,0;;;;2,0;11,0;11,0;;;;17,0;;4,0;;;;;1,0;1,0;38,0;30,0;1,0;;;;;;;;7,0;1,0;1,0;;5,0;;;;;4,0;;17,0;1,0;;;12,0;;;;;;;;;5,0;;;3,0;6,0;2,0;;2,0;1,0;5,0;;2,0;;4,0;;2,0;2,0;;;;;4,0;1,0;;1,0;;7,0;;1,0;;;4,0;5,0;;;7,0;61,0;20,0;1,0;;5,0;26,0;;13,0;5,0;6,0;6,0;1,0;14,0;;1,0;5,0;;;4,0;;;;1,0;5,0;;9,0;;;;;;;;4,0;1,0;4,0;;;;32,0;;8,0;5,0;;5,0;1,0;;16,0;6,0;;;4,0;8,0;;;2,0;9,0;2,0;4,0;;;2,0;4,0;;8,0;;7,0;;5,0;;;;5,0;;2,0;;1,0;;;2,0;;4,0;;;2,0;;;;1,0;5,0;23,0;3,0;8,0;4,0;;2,0;1,0;1,0;;;;1,0;17,0;4,0;5,0;14,0;;;7,0;29,0;1,0;20,0;;;;;19,0;8,0;5,0;3,0;2,0;;3,0;;1,0;3,0;;;3,0;;;;;42,0;;;;7,0;;;4,0;;2,0;;;37,0;2,0;2,0;;;;;;1,0;;1,0;3,0;2,0;;2,0;;;;;;;;;2,0;1,0;1,0;;;;;;;;;;;;
deviation;;;;13,0;25,0;9,0;1,0;1,0;;;;;;44,0;;;21,0;;;;;;6,0;;3,0;9,0;;;;1,0;4,0;12,0;10,0;6,0;;11,0;13,0;11,0;2,0;1,0;42,0;44,0;;3,0;2,0;;1,0;3,0;2,0;11,0;71,0;2,0;;12,0;;4,0;20,0;;;3,0;;;;;92,0;;10,0;2,0;;;3,0;18,0;13,0;;;4,0;;;;;37,0;;;;4,0;3,0;;32,0;;1,0;9,0;;;;8,0;;19,0;1,0;4,0;8,0;18,0;25,0;;2,0;;8,0;;;;1,0;;2,0;23,0;;;6,0;;3,0;;17,0;;;14,0;13,0;1,0;4,0;12,0;;2,0;;3,0;4,0;;26,0;;;;;;1,0;;;;;;1,0;;;6,0;1,0;;10,0;4,0;;;;;;;;;;;2,0;;;3,0;;;8,0;;;;34,0;;;;4,0;;;;1,0;;11,0;;;1,0;;5,0;;2,0;;;1,0;;;;;;;;;2,0;;17,0;1,0;;;;1,0;;4,0;;;;2,0;5,0;;;1,0;27,0;1,0;2,0;;3,0;;2,0;;;2,0;;1,0;7,0;21,0;;5,0;5,0;;;15,0;;;;;;6,0;;;;;;;;2,0;;4,0;;4,0;2,0;;;10,0;2,0;1,0;;;;1,0;;2,0;;;;;;;1,0;31,0;;;2,0;;13,0;;;;;3,0;2,0;;;;;;1,0;;51,0;;;;;;;;;;;1,0;;1,0;;;;;11,0;;;;6,0;;1,0;;;;;;;;1,0;;;;;;;;;;;;;2,0;;;;;1,0;;2,0;;;;;;3,0;;;;1,0;;;;;2,0;;2,0;1,0;80,0;;;;;37,0;31,0;;;;;10,0;8,0;10,0;;2,0;2,0;;13,0;2,0;11,0;;6,0;;4,0;;17,0;;1,0;;;5,0;1,0;;;;2,0;;13,0;;;;;;;;;1,0;;;;;;1,0;;;9,0;;7,0;;16,0;;;;;1,0;2,0;;;;5,0;;;;16,0;47,0;1,0;;;4,0;;;;;;;;;;4,0;8,0;;;18,0;;2,0;;;;1,0;;;3,0;;;;;;;;;;1,0;;;;;;;4,0;;1,0;3,0;12,0;;;2,0;;;;;;;2,0;;;;4,0;26,0;;;1,0;;;12,0;;;;;;;;20,0;;;;;;;;;;;;;;;21,0;;;;;;;7,0;;;;;;;2,0;;;;3,0;;;;;;;;101,0;;;1,0;;;;;;;;;;;1,0;21,0;1,0;3,0;;;;;3,0;;2,0;;;;;;;;;;;;;;;;5,0;;;14,0;;;;;2,0;;;;;;1,0;;5,0;4,0;;;1,0;;;;;;;;;;;;;;;2,0;;;;;;;;;;;;;;;;;;;3,0;;;2,0;2,0;;;;;;1,0;;;;;;2,0;;;;;;;2,0;1,0;;5,0;;;;;;;;;;;;;1,0;;;;;;;;;;;;;;;;;;;;2,0;;3,0;;;1,0;5,0;;;;;2,0;;;;;;;;;;2,0;;;;;;;;1,0;;;;;6,0;;;;;;;;;;;;;;;;;;;;;;;4,0;;;;;;;;;;2,0;;;;;;;2,0;;;3,0;;12,0;;;;;;;;;;;36,0;;;;;;;;1,0;;;;;8,0;3,0;;;;;1,0;;;;;1,0;58,0;;;;3,0;;;2,0;;;;;;;1,0;;;;;;;2,0;;2,0;;;;;1,0;;;;;;;;;;;;;;;3,0;;1,0;2,0;5,0;;;;2,0;;;;;;;;;6,0;;;;;;;;;;;;;;;;;;;;;;;;;;;;;;;;3,0;;;;;4,0;;;1,0;;;;;;;;;;;;;1,0;;;;;;;;;;;;;;;;;;;;1,0;;;;;;;8,0;;;;;;;;;;;;;;;1,0;;1,0;;;;;;;;;;;;;;
diaphragm;;;;42,0;40,0;35,0;;5,0;1,0;;8,0;;4,0;1,0;;;;;2,0;;;;;;;4,0;;;;7,0;36,0;27,0;;1,0;2,0;3,0;5,0;;4,0;;13,0;67,0;16,0;;4,0;16,0;;23,0;;3,0;;;;;5,0;7,0;13,0;;;1,0;;;10,0;;53,0;;44,0;3,0;1,0;;8,0;258,0;25,0;1,0;;;2,0;;;;5,0;;6,0;;1,0;;;65,0;;2,0;;;9,0;3,0;17,0;;;3,0;7,0;7,0;61,0;7,0;;;3,0;;;;;;;;11,0;;;;;;;11,0;;;19,0;6,0;;2,0;47,0;2,0;;;6,0;1,0;;103,0;5,0;;;;20,0;;;7,0;;;216,0;4,0;1,0;3,0;2,0;9,0;23,0;7,0;19,0;;;;2,0;;;;;;;1,0;;;1,0;;;;7,0;;;25,0;;1,0;;;4,0;;;;;14,0;;;3,0;7,0;1,0;3,0;;;;3,0;;6,0;5,0;5,0;1,0;1,0;;43,0;8,0;;;;6,0;;;3,0;41,0;21,0;;2,0;;4,0;4,0;;;5,0;;;;;6,0;;18,0;;1,0;;;;8,0;;5,0;;;;;2,0;;54,0;6,0;2,0;15,0;2,0;2,0;2,0;42,0;;3,0;;4,0;1,0;6,0;;;32,0;;;;12,0;2,0;;;;;4,0;;;;;6,0;2,0;;;1,0;;;2,0;;;38,0;;;;;5,0;;2,0;;;;;;;16,0;;;;;;1,0;2,0;;1,0;;;;3,0;;;;;;;13,0;4,0;5,0;10,0;;17,0;;;;;2,0;;17,0;;;;;1,0;;;;;1,0;;36,0;6,0;5,0;1,0;;;;9,0;;13,0;;;3,0;1,0;;;;2,0;15,0;;;;;;;2,0;;;;;;;;4,0;15,0;1,0;;;3,0;;230,0;;;;;10,0;;;;;;;;35,0;;;;;2,0;;;4,0;;;;;;;5,0;14,0;;5,0;;6,0;;;;;;;2,0;;5,0;;;8,0;;;;;;;3,0;;12,0;;4,0;;4,0;;;4,0;1,0;;;;;;;;;4,0;6,0;3,0;;;;;;;1,0;;;;;;;;;;4,0;4,0;;;;;;8,0;;;8,0;;8,0;;;;3,0;;;;;;;;;;;;;1,0;;;;;;;;;;;;;1,0;;;;;7,0;;;;4,0;;;;;;;4,0;;;;;;;;4,0;;1,0;;;18,0;4,0;15,0;;;;;1,0;;;;;4,0;2,0;;;;;;;;;;;;;;;1,0;;1,0;;;;;;;;;;;;;;;;;;1,0;;;;;;;;1,0;;;;;;;;;;;;;;;;;;;;1,0;;;;;;;;;;;;;;;;;;;;;;;;;;;;;;;;;;;;;;;;;;;;;;;3,0;;;;;;;;;;;;;;;;;;;;;;;;2,0;;2,0;;;;;2,0;3,0;;;;;;;20,0;5,0;;;;;;;2,0;;;;1,0;2,0;;47,0;15,0;;;;;;3,0;;;;;;;;;26,0;;;;;;;;;;;2,0;;1,0;6,0;;;;;;;;;;;;;;;;;;;;;;;;6,0;;;;;;;;;;;;3,0;;;;;;;;;;;;;;;;;;;1,0;1,0;;;;;;;;;;;;;;;;;;;;;1,0;;3,0;1,0;;;;;;;;;;;;1,0;;;;;;2,0;;;;;;;;;;;;;;;;;3,0;;1,0;;;;;;;8,0;;;;;;;;;2,0;;;3,0;;;;;;;;;;;;;;;;;;;;;;;;;;;;;;2,0;;;;;;;115,0;;;;;;;11,0;;;;;1,0;;;3,0;;;;;;4,0;;;;;;;;;;;;;;;;;;;;;;;;;;;;;;;;;;;;;;;;;;;;;;;;;;;;;;;;;
difference;;;;21,0;46,0;33,0;22,0;;1,0;;;12,0;;257,0;8,0;27,0;58,0;8,0;9,0;21,0;;;103,0;;3,0;8,0;1,0;41,0;8,0;4,0;89,0;7,0;45,0;26,0;;99,0;11,0;4,0;82,0;;295,0;73,0;5,0;8,0;12,0;;6,0;16,0;;19,0;10,0;;;2,0;15,0;12,0;16,0;;27,0;60,0;1,0;;10,0;;689,0;1,0;61,0;15,0;8,0;1,0;28,0;186,0;105,0;;13,0;18,0;;26,0;;7,0;115,0;;1,0;7,0;34,0;;;39,0;1,0;6,0;73,0;2,0;31,0;4,0;3,0;;398,0;9,0;99,0;121,0;195,0;140,0;;12,0;30,0;34,0;10,0;4,0;13,0;3,0;6,0;111,0;90,0;2,0;;22,0;3,0;13,0;10,0;35,0;3,0;;151,0;7,0;;9,0;54,0;;7,0;5,0;225,0;9,0;;63,0;2,0;;19,0;16,0;25,0;;;32,0;;4,0;1,0;20,0;55,0;8,0;48,0;2,0;22,0;22,0;10,0;;2,0;8,0;;;;3,0;;11,0;11,0;27,0;2,0;1,0;7,0;;1,0;61,0;3,0;11,0;;54,0;1,0;20,0;1,0;1,0;7,0;;7,0;;;4,0;;;38,0;;94,0;3,0;2,0;;;12,0;;2,0;;7,0;4,0;;;13,0;6,0;3,0;41,0;8,0;3,0;;;1,0;10,0;13,0;21,0;;;7,0;24,0;;1,0;7,0;6,0;1,0;1,0;1,0;5,0;;11,0;3,0;;9,0;;4,0;93,0;45,0;4,0;3,0;15,0;40,0;;18,0;;;;;;15,0;3,0;3,0;;;;;;2,0;;;4,0;42,0;1,0;;1,0;;;13,0;;;;20,0;14,0;1,0;;;7,0;1,0;2,0;;;158,0;;;2,0;8,0;32,0;5,0;7,0;;2,0;7,0;2,0;;;2,0;;;;;104,0;11,0;;2,0;;5,0;;4,0;;2,0;;4,0;39,0;37,0;;;;;7,0;;;2,0;;1,0;2,0;60,0;;14,0;;;2,0;;30,0;;;;;;6,0;;;;;;2,0;7,0;1,0;;4,0;;8,0;14,0;;;;;8,0;;3,0;;3,0;5,0;17,0;;;2,0;;;;9,0;3,0;6,0;6,0;;;;169,0;22,0;18,0;4,0;;1,0;39,0;36,0;30,0;166,0;7,0;;3,0;90,0;9,0;;3,0;6,0;61,0;1,0;6,0;104,0;;46,0;;37,0;29,0;10,0;;26,0;;64,0;7,0;34,0;2,0;15,0;33,0;;;11,0;1,0;63,0;13,0;68,0;;10,0;12,0;5,0;;8,0;2,0;;7,0;19,0;5,0;44,0;9,0;4,0;2,0;;28,0;1,0;23,0;2,0;11,0;3,0;;14,0;52,0;2,0;113,0;3,0;7,0;14,0;9,0;12,0;36,0;14,0;8,0;37,0;3,0;;;;6,0;23,0;1,0;6,0;39,0;;26,0;4,0;;;;;1,0;;2,0;2,0;5,0;2,0;;1,0;2,0;;;4,0;;7,0;1,0;25,0;5,0;;17,0;6,0;2,0;36,0;8,0;1,0;;10,0;2,0;;4,0;;;;;6,0;;5,0;26,0;64,0;1,0;3,0;;1,0;3,0;71,0;;;;4,0;;7,0;;;;3,0;;;4,0;;;;;;;3,0;;2,0;47,0;;10,0;2,0;7,0;8,0;;19,0;13,0;6,0;3,0;18,0;;;;4,0;;;4,0;4,0;;;;1,0;;5,0;7,0;4,0;;3,0;6,0;2,0;;2,0;2,0;3,0;;;2,0;;5,0;1,0;3,0;;3,0;;4,0;;9,0;1,0;;;1,0;;2,0;6,0;1,0;2,0;22,0;10,0;;;;;3,0;1,0;11,0;;;88,0;;;;1,0;;3,0;2,0;4,0;5,0;;;;;;;5,0;;;127,0;5,0;;4,0;;2,0;;;;;;;;;;1,0;;253,0;;;2,0;1,0;20,0;;;;;;;;3,0;8,0;11,0;2,0;;5,0;2,0;24,0;;;;;17,0;;;;;;13,0;;;3,0;;2,0;;;32,0;1,0;2,0;;;27,0;;;4,0;;3,0;;;;9,0;1,0;;;;1,0;;;;;7,0;6,0;10,0;;;;3,0;6,0;;;;;12,0;8,0;;;1,0;32,0;;;;;2,0;3,0;;;5,0;2,0;;;;6,0;17,0;;;;4,0;;2,0;;4,0;;;21,0;;7,0;;3,0;;;;;;;;;;1,0;;;;;;;;1,0;;;33,0;;7,0;;;;;;1,0;;29,0;1,0;;;2,0;4,0;;3,0;12,0;;2,0;;8,0;8,0;;;16,0;3,0;;;;;5,0;37,0;;11,0;;2,0;3,0;6,0;3,0;36,0;1,0;6,0;3,0;8,0;;1,0;4,0;;3,0;2,0;;;2,0;;2,0;6,0;14,0;;;;9,0;;;19,0;2,0;7,0;;;;;3,0;3,0;3,0;;7,0;;1,0;4,0;10,0;1,0;;;2,0;6,0;10,0;;;;1,0;;;;1,0;2,0;;;;;1,0;;9,0;1,0;;2,0;;2,0;5,0;;;3,0;;;;;;2,0;;5,0;;;;2,0;;;;;4,0;;;1,0;;;3,0;;;13,0;;3,0;;4,0;;;1,0;;2,0;;;1,0;;;;;;24,0;4,0;6,0;5,0;;;;;;3,0;;;;;6,0;;;1,0;;;;;6,0;;;3,0;;;;;1,0;;;;40,0;;7,0;;;5,0;;;;;3,0;;;2,0;2,0;9,0;;4,0;2,0;;;;9,0;3,0;1,0;10,0;18,0;;;26,0;1,0;;;;16,0;;;;;;
dimensional;;;;2,0;4,0;32,0;222,0;17,0;;;;;;64,0;;;76,0;12,0;6,0;14,0;;3,0;18,0;;;2,0;;2,0;6,0;1,0;41,0;6,0;11,0;8,0;2,0;108,0;30,0;4,0;69,0;1,0;73,0;54,0;;105,0;50,0;8,0;2,0;18,0;;;6,0;;3,0;3,0;23,0;27,0;43,0;;29,0;96,0;;;7,0;1,0;552,0;3,0;43,0;;1,0;;2,0;10,0;48,0;1,0;1,0;;15,0;33,0;;6,0;113,0;3,0;8,0;73,0;13,0;2,0;5,0;30,0;7,0;6,0;38,0;5,0;5,0;;2,0;;223,0;39,0;115,0;134,0;112,0;3,0;5,0;1,0;7,0;20,0;4,0;4,0;;;;21,0;16,0;;;;5,0;8,0;73,0;68,0;4,0;;26,0;4,0;;18,0;127,0;;1,0;11,0;10,0;;;22,0;;;27,0;33,0;;;;8,0;;;24,0;10,0;10,0;28,0;8,0;;;7,0;3,0;;;;;;3,0;1,0;2,0;2,0;;3,0;;1,0;4,0;;;24,0;32,0;1,0;;15,0;;6,0;;4,0;1,0;;2,0;4,0;;23,0;;;5,0;;40,0;1,0;;;;;1,0;1,0;1,0;1,0;;;;;;;4,0;1,0;1,0;1,0;2,0;1,0;3,0;14,0;7,0;;1,0;;32,0;5,0;4,0;8,0;80,0;1,0;;;2,0;;48,0;;;32,0;;7,0;1,0;4,0;;2,0;13,0;;;15,0;;;1,0;;;9,0;2,0;28,0;3,0;;;1,0;15,0;15,0;3,0;;3,0;74,0;;;2,0;1,0;2,0;11,0;;;;;;;;;4,0;6,0;;3,0;;44,0;;41,0;;;23,0;2,0;;;1,0;;4,0;;;21,0;;;9,0;;22,0;;;;;;;4,0;;;;4,0;;23,0;;;2,0;;11,0;;10,0;;3,0;3,0;;110,0;;3,0;1,0;;;;2,0;1,0;;;;;8,0;4,0;;;1,0;;1,0;11,0;;;;1,0;8,0;47,0;;;;;;;16,0;;;;65,0;;11,0;;;1,0;;;6,0;;;1,0;;;40,0;18,0;7,0;1,0;1,0;4,0;4,0;2,0;34,0;97,0;;2,0;1,0;25,0;;10,0;;;;;7,0;;;25,0;;16,0;;;;4,0;8,0;;13,0;7,0;1,0;6,0;13,0;;;8,0;;1,0;16,0;4,0;1,0;6,0;;;;;;4,0;1,0;51,0;;3,0;2,0;;7,0;;1,0;1,0;1,0;;5,0;36,0;2,0;;;;2,0;20,0;1,0;3,0;2,0;;33,0;;;;3,0;;;;5,0;19,0;;1,0;16,0;;;22,0;;1,0;1,0;;;;;;4,0;4,0;;1,0;1,0;;2,0;;10,0;2,0;;8,0;1,0;6,0;23,0;3,0;;1,0;;2,0;;16,0;4,0;;5,0;;3,0;;3,0;46,0;2,0;5,0;29,0;6,0;1,0;;;;;;;;;2,0;;1,0;;;;;3,0;;;;;9,0;;;;1,0;;;1,0;5,0;8,0;;;15,0;;3,0;;7,0;2,0;8,0;;;;;;;1,0;32,0;;4,0;1,0;14,0;;;1,0;3,0;;1,0;5,0;;;;;3,0;;;;;16,0;1,0;;1,0;;;;;21,0;2,0;;;;;46,0;8,0;;;;4,0;;;4,0;1,0;37,0;;1,0;1,0;14,0;39,0;;;;1,0;;3,0;3,0;3,0;20,0;4,0;;;9,0;;;6,0;;;3,0;3,0;;1,0;5,0;;;;;;;;;;;;7,0;3,0;;;;;;45,0;;;;;1,0;2,0;1,0;;2,0;1,0;7,0;;15,0;;;1,0;;3,0;;;1,0;;;;22,0;;;;2,0;6,0;;12,0;26,0;1,0;;;;;3,0;2,0;2,0;;;;;;2,0;;1,0;1,0;1,0;2,0;;;;4,0;6,0;2,0;;;;;;;;9,0;;;1,0;13,0;;;;;;;;;;1,0;1,0;;3,0;;2,0;;7,0;;8,0;;;;2,0;;3,0;;;;;8,0;;16,0;1,0;;;;;;;;1,0;;;;;;;;;;;;1,0;;1,0;;5,0;;;;;;;;;;;1,0;;;;;;;;;9,0;;;;;;;;;;3,0;1,0;;11,0;;;1,0;33,0;3,0;9,0;2,0;6,0;;;;;1,0;2,0;;12,0;31,0;;3,0;1,0;;;;;;;4,0;;;;1,0;1,0;;;3,0;;;1,0;;;;;;;11,0;1,0;4,0;4,0;8,0;;;;;1,0;4,0;2,0;;;;;4,0;;;;1,0;4,0;3,0;9,0;12,0;;3,0;;6,0;5,0;;;;2,0;;;;;2,0;;2,0;1,0;1,0;;9,0;;;8,0;;2,0;;1,0;;;;;1,0;;2,0;;;1,0;4,0;;;1,0;;;2,0;;;;3,0;;;8,0;8,0;;10,0;;1,0;;;13,0;;;;3,0;;3,0;;;;;;;;;;;;;3,0;;;;4,0;1,0;;;;2,0;;;;;1,0;1,0;;1,0;4,0;16,0;;;;1,0;;18,0;;;;7,0;3,0;;5,0;;;;4,0;2,0;;;;;;;;;;
displacement;;;;3,0;19,0;17,0;12,0;14,0;;;9,0;;2,0;48,0;;;5,0;;;;;;1,0;;;4,0;47,0;3,0;8,0;2,0;45,0;2,0;22,0;3,0;;3,0;1,0;;1,0;;51,0;49,0;;;3,0;7,0;3,0;22,0;;3,0;16,0;;2,0;1,0;25,0;3,0;3,0;;7,0;21,0;;;4,0;;51,0;2,0;13,0;;;7,0;2,0;112,0;5,0;;;1,0;;2,0;;;40,0;;1,0;1,0;40,0;10,0;;76,0;15,0;4,0;11,0;1,0;15,0;;;;16,0;6,0;32,0;50,0;55,0;4,0;;2,0;2,0;10,0;;3,0;5,0;;;25,0;11,0;;;;;1,0;3,0;45,0;28,0;;38,0;4,0;;;24,0;;;;4,0;;;19,0;1,0;;6,0;;27,0;;;;2,0;;4,0;15,0;;;9,0;;2,0;;10,0;;;;9,0;;;;1,0;2,0;;1,0;;;;1,0;;7,0;29,0;;;92,0;;;;;2,0;1,0;;;;;;;10,0;;21,0;;;;;2,0;8,0;;17,0;;;;;;2,0;2,0;9,0;2,0;10,0;;;;13,0;20,0;6,0;;;;5,0;7,0;;5,0;;;;;7,0;;16,0;;2,0;1,0;;;42,0;;;;4,0;;;3,0;;1,0;4,0;;;5,0;17,0;;2,0;4,0;;;;3,0;;;7,0;15,0;1,0;;;3,0;;1,0;;;;;7,0;;;1,0;10,0;2,0;;;8,0;1,0;;;;1,0;61,0;1,0;;2,0;2,0;4,0;2,0;;8,0;;;7,0;;;26,0;7,0;3,0;1,0;;;;5,0;;;;9,0;;23,0;;;;;;;;10,0;5,0;20,0;23,0;14,0;6,0;3,0;;;;;;1,0;;;;1,0;;;3,0;;7,0;;2,0;11,0;10,0;;1,0;2,0;27,0;;;1,0;;;;;9,0;;;;5,0;;;;;;1,0;;;48,0;;;2,0;;16,0;2,0;23,0;;;2,0;1,0;;5,0;13,0;;;4,0;56,0;;4,0;;;;;;1,0;;6,0;;4,0;;8,0;1,0;2,0;;3,0;;7,0;3,0;1,0;24,0;11,0;1,0;13,0;;4,0;1,0;13,0;16,0;;;;;;6,0;;;5,0;;;;;14,0;;;;14,0;;1,0;;1,0;;22,0;;3,0;4,0;1,0;1,0;2,0;;;2,0;;5,0;;;;;3,0;;;3,0;3,0;;;;;;;;1,0;;;;4,0;;;;2,0;3,0;;;7,0;;;8,0;2,0;;13,0;;;;;;;;;;;;;;;;;;39,0;14,0;;;;;;6,0;;;;;10,0;3,0;;;;;;;;;;;6,0;;3,0;;;2,0;12,0;;5,0;;;;;1,0;1,0;;;;;3,0;;;;;2,0;;;;2,0;1,0;;;;;;;;;;;;;;;;;1,0;1,0;;;;;;;;;2,0;1,0;;2,0;;3,0;1,0;;;;;;;;;;;;;15,0;;;;;3,0;;3,0;;;1,0;;4,0;;;;;;;;;;;;;;;;;;1,0;;;;5,0;3,0;25,0;;;;;;;;;;;;;;;1,0;;;2,0;;;;;;;4,0;;;;;;6,0;1,0;;;;3,0;1,0;;7,0;;;;;;;;;;;2,0;;;;;;;;;;;;;3,0;7,0;6,0;;;;;;;;;;;;;2,0;;4,0;;;;;1,0;2,0;;;5,0;;;;;4,0;42,0;;;;5,0;;1,0;;;;;;;;;;;9,0;4,0;;1,0;;;;;;;2,0;;;;;;;;;;;1,0;;;;;;;;;;;;;1,0;2,0;;;;;;;1,0;;;;;;;;;;3,0;;;;;;;;;;;;1,0;;1,0;;;;3,0;;;;;;3,0;1,0;;;;;;;;;;;;5,0;;;;;;;;;;;;4,0;4,0;;;8,0;;3,0;;3,0;;;;;;26,0;;;;;1,0;;;;;;;2,0;;;;;;;;;;;;;;;;;;;;;;;;;;;;;;;;;;;;;;;;;;1,0;;;;;1,0;;;;;;;;;;;;2,0;;;1,0;;;;;;;;;;;;;;;;;;;;;;;;;;;;;;;;;;;;;;;;;;;;;;;;;;;;;;;1,0;;;;
distribution;;;;17,0;5,0;19,0;2,0;2,0;;;;;;19,0;;73,0;16,0;;4,0;4,0;;3,0;16,0;;4,0;;;1,0;5,0;3,0;14,0;4,0;9,0;2,0;;24,0;12,0;;13,0;;64,0;21,0;;;1,0;4,0;;4,0;;1,0;7,0;;;;9,0;;6,0;;7,0;25,0;;;19,0;;143,0;;40,0;;;;;5,0;67,0;;;13,0;2,0;2,0;;1,0;42,0;;;12,0;19,0;;;6,0;;2,0;6,0;;;;2,0;;122,0;5,0;65,0;59,0;4,0;;;7,0;4,0;5,0;10,0;5,0;;;;26,0;27,0;;;5,0;;6,0;15,0;1,0;2,0;1,0;2,0;1,0;29,0;4,0;42,0;;;4,0;8,0;4,0;;38,0;1,0;;2,0;2,0;;;;3,0;;;;;4,0;1,0;19,0;;;;;;;9,0;;;3,0;;;;55,0;;;;5,0;1,0;2,0;8,0;;;5,0;4,0;;3,0;2,0;5,0;;;6,0;;;;;;;;5,0;;;;;;;;;2,0;2,0;;;2,0;;;19,0;2,0;2,0;;;6,0;;;;;;2,0;4,0;1,0;;4,0;17,0;1,0;3,0;1,0;30,0;;5,0;;;2,0;;1,0;4,0;11,0;;;22,0;;;3,0;;3,0;;;;8,0;;4,0;12,0;;;;;;;;1,0;4,0;;;2,0;4,0;21,0;1,0;;;;;2,0;3,0;;;;1,0;;;1,0;1,0;;1,0;1,0;;;;1,0;;;8,0;;;;;;;;;3,0;;;;;;;1,0;;;;1,0;75,0;3,0;;;3,0;;2,0;1,0;;2,0;;1,0;3,0;19,0;;;;;;;59,0;;;;;1,0;4,0;;3,0;;;;5,0;3,0;;;;;5,0;9,0;;;;;7,0;;1,0;;;25,0;17,0;3,0;;;;;;;4,0;;;30,0;;;37,0;7,0;3,0;5,0;;;16,0;2,0;3,0;;;2,0;1,0;2,0;;10,0;;8,0;;;;12,0;;35,0;1,0;5,0;14,0;;;;;27,0;3,0;38,0;1,0;2,0;2,0;;;;2,0;1,0;;;;;;;;;;;;15,0;2,0;5,0;;;;43,0;6,0;1,0;;;6,0;7,0;;;8,0;2,0;25,0;;11,0;1,0;;;15,0;;;3,0;;;;;;14,0;;;40,0;7,0;28,0;2,0;;;;;;;4,0;;10,0;;;;;;;;;;;4,0;;;7,0;;;;;;10,0;;;;;;;;5,0;;;;4,0;1,0;;4,0;;13,0;;8,0;;;;5,0;;1,0;;;;1,0;;;12,0;;;;7,0;;;;;1,0;4,0;;2,0;;4,0;1,0;;4,0;4,0;;;;;;;33,0;;;4,0;;;;;;;;1,0;2,0;;2,0;;;2,0;;6,0;;;;;;;;2,0;5,0;1,0;;2,0;;;;;2,0;;1,0;;;;5,0;;;;1,0;;;1,0;;;;4,0;11,0;4,0;;;;;;;;;;;;;2,0;;10,0;;;30,0;2,0;1,0;;1,0;;6,0;;;1,0;;25,0;;;;;;1,0;;;6,0;;13,0;;2,0;;3,0;;;;4,0;;;;;;7,0;;;;2,0;;;;;;;;6,0;;;;;;36,0;;9,0;;;;2,0;3,0;;5,0;;;1,0;;;;;;1,0;1,0;;;;;;;3,0;;;;;;;24,0;;4,0;;;;20,0;;1,0;;3,0;;;;;;;;;;16,0;;;1,0;4,0;1,0;;;;;;;;;;;;;;;;;;;;;;;;;;;;;;;;;;;;5,0;;1,0;;;;;;;;;;;2,0;3,0;3,0;;2,0;;33,0;;;7,0;;;;1,0;;21,0;1,0;;;1,0;11,0;;5,0;18,0;;;2,0;;;;;;;12,0;;;2,0;3,0;11,0;;;3,0;;;;5,0;;;;;;;3,0;;;;;;;;;;;;;;;;6,0;;;6,0;;4,0;;;;;;;;;;32,0;;;;4,0;;;;;;;;;1,0;;;;;;;;;;;;;;;;;;8,0;;;1,0;;;3,0;;;;;;1,0;;;;;;;;;;;;;;;;;;2,0;;;;;;;;;;;;;;;;;;;;2,0;;;3,0;;;;;;8,0;;;10,0;1,0;;7,0;;;;;2,0;;;;;;;;;6,0;;;;;;2,0;;;;;;;;3,0;;;;;;;2,0;;
document;;;;1,0;4,0;24,0;;2,0;;;;;;21,0;;;34,0;;;;;;;;;;;1,0;6,0;;7,0;;;;;11,0;2,0;;1,0;;28,0;29,0;1,0;;42,0;;;;;;;;;;;2,0;;;;4,0;;;;;99,0;;13,0;2,0;;;;1,0;;;;;;;1,0;1,0;48,0;;5,0;;;1,0;;2,0;;3,0;9,0;;;;1,0;2,0;1,0;19,0;11,0;6,0;28,0;;;;4,0;3,0;;;3,0;;;;2,0;;;;;1,0;1,0;;;;6,0;;;2,0;25,0;;;;1,0;;;8,0;;;2,0;;;;;;;;;;2,0;;17,0;;;;;2,0;;;;;;;;;13,0;13,0;;;;;;1,0;;;1,0;6,0;;1,0;;;;;;;;;;;;;1,0;2,0;;;;;;;2,0;;;;;;;;;4,0;;;;1,0;6,0;2,0;;;;1,0;5,0;5,0;;;;;;;;;10,0;;;;;;4,0;3,0;;5,0;;;;4,0;;;;;;;;1,0;;;;;8,0;2,0;;;1,0;10,0;;;;;;;;;;;;;;;;;;;;7,0;;;;;2,0;;;;;;;;;;;;;1,0;8,0;;;;;;;;;;2,0;9,0;;;;;;;1,0;;1,0;;;;8,0;22,0;;1,0;;;;;;;;;;1,0;1,0;;1,0;;;;;;;;;;;;;;;;;;;;13,0;5,0;10,0;;;;;;;1,0;;;;1,0;;;5,0;;1,0;;;;;;6,0;4,0;;3,0;;44,0;1,0;;;;;2,0;10,0;;1,0;7,0;;4,0;;;;18,0;1,0;;;4,0;4,0;;;;;2,0;;;;;;;;;;;;1,0;6,0;4,0;;13,0;1,0;;;;2,0;3,0;;;;9,0;4,0;;;;;;;6,0;2,0;;16,0;;;;;;;;;1,0;;;1,0;;;;;;;;;;;;2,0;3,0;;;;;;;;;;16,0;;;6,0;1,0;8,0;;;6,0;;6,0;;;3,0;;2,0;;;;;;;;;;;;9,0;;;1,0;;;;;;;;;;;;;;;;;;3,0;;;9,0;;;;;;;;;;2,0;;;1,0;;;;;1,0;3,0;1,0;4,0;;;;;;;1,0;;;;;;;1,0;;;;3,0;;;;;;;;;;;;;;;1,0;6,0;;;;;;;;;;;;;;3,0;;4,0;3,0;;;;;;;;;;;;;;;1,0;;;;;;;;;;;;;;;;;1,0;;;;2,0;;;;;;;;;;;;;;;;;;1,0;;;8,0;;;;;;;1,0;;;;;;;;6,0;;;;;;;;;;;;;;;;;;;2,0;;;;;;;;;;;;;;;;8,0;;;;;;;;;;;;;;;1,0;3,0;;;;;21,0;;;;1,0;;;;;;;;;;;;;;;;;;;;;;;7,0;;;;;;;;;;;4,0;;;;19,0;;;;;;;;;;;3,0;;;;;;;;;;;;;;;;;;;;;;;;2,0;;;;1,0;;;;;;;;;;;;;;;;;;;10,0;;;;;1,0;1,0;;;;;;;;;;;;;;;;;;;;12,0;;;;;;;1,0;;;;;;4,0;;;;;1,0;;;;;3,0;;;;;;;;;;;;2,0;;;;;;;;;37,0;;;;8,0;;;;;;;;;;;;;;;;;;;;;;;;;;;;;;;;;;;;;;;;;;;;;;;2,0;;;;;;;;;;;;;;;;;;;;;;;;;;;4,0;;;;;;;;;;;;1,0;;;;;
dome;;;;1,0;;11,0;1,0;11,0;;;;;2,0;42,0;;;;;;;;;1,0;;;;;;1,0;1,0;15,0;1,0;2,0;11,0;;;14,0;12,0;;;12,0;44,0;2,0;;;4,0;;;;;;;8,0;6,0;3,0;;9,0;;;1,0;;;;;3,0;;44,0;;;;;26,0;3,0;;9,0;;11,0;;;;16,0;;;;4,0;4,0;;11,0;;;;4,0;;;;;;1,0;2,0;4,0;31,0;2,0;;1,0;4,0;4,0;;;;;;10,0;;;;;;;4,0;;;1,0;2,0;4,0;;;54,0;;;1,0;6,0;;;5,0;;;6,0;;5,0;4,0;;6,0;;;9,0;4,0;;10,0;;20,0;;3,0;8,0;20,0;;;;;;3,0;;4,0;;;;;8,0;132,0;1,0;;;;;46,0;;6,0;;;8,0;;;;3,0;;2,0;;;6,0;3,0;4,0;;;4,0;;;19,0;106,0;;10,0;1,0;;;;;;;14,0;3,0;1,0;44,0;4,0;;1,0;1,0;;28,0;4,0;2,0;;;;;;;3,0;;52,0;9,0;;;1,0;1,0;2,0;;7,0;;;;2,0;;;64,0;26,0;3,0;13,0;;1,0;19,0;7,0;3,0;6,0;;;35,0;;;12,0;27,0;4,0;;;6,0;;;12,0;;;;;10,0;;;;;2,0;;1,0;10,0;;1,0;2,0;;21,0;1,0;;;;;;4,0;;7,0;3,0;64,0;;3,0;5,0;6,0;1,0;3,0;;9,0;1,0;;1,0;1,0;;;1,0;5,0;1,0;2,0;9,0;;;;2,0;9,0;3,0;7,0;;;2,0;;;;;;4,0;;4,0;;;5,0;;;;;;;11,0;58,0;6,0;4,0;2,0;;10,0;4,0;;10,0;;;;;28,0;7,0;2,0;;3,0;;;;;;;5,0;;;;;;;4,0;33,0;;;2,0;;3,0;;24,0;31,0;;;;;;1,0;1,0;1,0;1,0;;;;2,0;1,0;;;;;;1,0;19,0;;;5,0;;12,0;;5,0;;24,0;;1,0;5,0;2,0;;;;;;;;;;5,0;1,0;1,0;;;1,0;;;;123,0;;;;;;;1,0;2,0;8,0;3,0;;;;;;;;;2,0;;;;;;2,0;;;;;;;;;;;;;;;4,0;;;;;;;1,0;;;;;30,0;;;;;;;3,0;;;;;;;;;;;;;;;;;;;2,0;;;1,0;;2,0;;;6,0;;2,0;;;;14,0;;1,0;;4,0;;;4,0;2,0;2,0;;;2,0;1,0;;;;15,0;;8,0;;;3,0;;;;;;;;;;;;;;11,0;;1,0;;;4,0;;;;;;;4,0;;;;8,0;;;;;3,0;;;1,0;;;;3,0;;;;;;;;;;;;;;;;;;;;;;;;;;;;;;;;;;;;;;;;;;;;;;;;4,0;;;;;;;;;24,0;;2,0;;;;;;;;2,0;;;;;;;;;;;;;;;;;;;;1,0;14,0;;;20,0;;3,0;;;;;;;;4,0;;;5,0;;;4,0;7,0;;;;;;7,0;2,0;;2,0;;1,0;;3,0;3,0;;;;;;;;;;;;1,0;6,0;;;;;;;;1,0;;;;;2,0;;;;;8,0;;1,0;;;;;5,0;;3,0;;;3,0;;;1,0;1,0;;;;;;2,0;;;;1,0;;1,0;1,0;1,0;;;;;15,0;;;;;2,0;15,0;;;;;;;;;;;;;;;;;;;;;;;;;;;;;;;;;;;;;;;;;;;;;;1,0;;;;;8,0;;;;;1,0;;;;;;;;;;;;;;;;;;;;;;;;;;;2,0;;;;;;;;;;;;;;;;1,0;;;;;;7,0;;;;;;;;;;;;;;;;;;;;;1,0;;;;;;;;1,0;;;;;;;;;;;6,0;;;;;;;;;;;;;;;;;;2,0;;;;;;;;;;;;;6,0;;;;;;;;;;;;1,0;;;1,0;;;;;;;;;;;;;;;;;;;;1,0;;;;
duration;;;;13,0;12,0;7,0;;;;;;;;30,0;;;16,0;;;;;;;;;;;;2,0;;7,0;1,0;1,0;3,0;;17,0;5,0;;;;27,0;20,0;;;6,0;;;;;;;;;;;;;;2,0;1,0;1,0;;;;46,0;1,0;1,0;;3,0;;;6,0;2,0;;;1,0;;4,0;1,0;2,0;21,0;;6,0;;3,0;;;4,0;;1,0;;2,0;;;1,0;;24,0;;4,0;4,0;3,0;27,0;;3,0;3,0;5,0;;;;;;8,0;;;;;;6,0;;5,0;;;3,0;;;2,0;12,0;;12,0;;96,0;2,0;;7,0;4,0;;1,0;;;;;;;1,0;2,0;2,0;;;5,0;;;;;;;;;;;;;;;;1,0;;;;;6,0;8,0;;;3,0;;;;2,0;1,0;;;;;2,0;;3,0;2,0;;54,0;;;2,0;;;;;;;;;;1,0;;;3,0;3,0;;;;1,0;2,0;;3,0;;;;5,0;;;1,0;10,0;34,0;6,0;;;;;;;;;;5,0;4,0;;;;;;;;;;;;2,0;1,0;1,0;;;;;;;;1,0;;;;;;1,0;;1,0;;;;;;4,0;;;;1,0;;;;;;;;;;;;;;;6,0;;;;;;;;7,0;;;1,0;;;;;;;;;;;;;;;;;;;13,0;;;5,0;;1,0;;;;;;;;;;;5,0;;;;;;2,0;;;;;;2,0;;;;;;;;;;;;13,0;;;;;;1,0;;;;;;;;3,0;;;;;;1,0;;14,0;;3,0;;3,0;9,0;2,0;;;1,0;8,0;;1,0;;;1,0;;2,0;2,0;;;6,0;5,0;6,0;;1,0;;;;2,0;;;;4,0;1,0;3,0;;;;3,0;;10,0;;2,0;2,0;5,0;2,0;10,0;1,0;;;;14,0;;1,0;;;;1,0;3,0;;6,0;22,0;;;1,0;;1,0;6,0;;;1,0;3,0;;3,0;;;;2,0;;;;12,0;;;;;;;1,0;;;;;;;1,0;;;;;;1,0;;1,0;;3,0;;5,0;;;;;3,0;4,0;;;;;;;;;15,0;;;;3,0;;5,0;1,0;;;;;2,0;;4,0;;;;;;;;;;;;;;;;;;;15,0;;1,0;;2,0;2,0;;6,0;;;;;;1,0;;;;;;;;;;;;1,0;;;;;;;;5,0;;;;;;1,0;;;;;3,0;;;;;;;;;2,0;;;;;;;;;;;;;;1,0;1,0;;;3,0;6,0;8,0;;1,0;;;2,0;;;;1,0;;;;4,0;1,0;;;;;;;;;;;;;;2,0;;1,0;;;;;;;;;;;;;;;1,0;2,0;3,0;;4,0;;;;;;4,0;;;;;;2,0;;;;;1,0;;;6,0;;5,0;;;1,0;;5,0;;;;;;;1,0;;;;;;;;1,0;;;;1,0;;;;;;;;;;;4,0;;;;3,0;;;;;;;;;;;;;;;2,0;;;;;;;;;;;3,0;;;;;;;;;;;;;;;;;;;;;;;;;;;;;;;;;;;;;;12,0;;;;2,0;;;;;;;;;;;;2,0;;;;45,0;;;;5,0;;;;;;;1,0;;;8,0;;;;;;;;;;;;;;;;;;;;9,0;;;;;;;;;;;;;;;;;;;;;;;2,0;;;;;;;;;;;;;;;;;;;;;;;;;;;;;;;;1,0;;3,0;;;;;;;;;;;;;;;1,0;;;;;;;;;;;;;;;;;3,0;;6,0;;1,0;;;;;;;;;;;;;;;;;;;;;;;;;;;;;;;;;;;;;;;;;;;;;;;;;;;;;;;;;6,0;;;;;;;;;;;;
dynamic;;;;7,0;3,0;9,0;31,0;;;;;;;44,0;;;75,0;;;141,0;;;19,0;;1,0;2,0;7,0;2,0;1,0;;15,0;;1,0;1,0;;15,0;11,0;;17,0;1,0;68,0;25,0;;3,0;16,0;;;3,0;;2,0;6,0;;;;12,0;;1,0;;1,0;33,0;;;3,0;1,0;225,0;;47,0;7,0;2,0;;1,0;5,0;24,0;;5,0;;1,0;9,0;;5,0;49,0;;29,0;;15,0;;;8,0;;1,0;;2,0;;;;;16,0;;9,0;;;1,0;;1,0;6,0;15,0;1,0;7,0;;;;;38,0;;;;5,0;2,0;24,0;62,0;;;14,0;;;4,0;67,0;;;;16,0;;;18,0;;;158,0;1,0;1,0;;;;;;;5,0;7,0;;;;;4,0;;3,0;5,0;1,0;;;;;;;;1,0;;;1,0;3,0;3,0;6,0;;;;2,0;1,0;;;;13,0;;3,0;;;13,0;;;;;7,0;;;;;;;;;2,0;;;;;;;4,0;2,0;;;1,0;;1,0;;1,0;;;6,0;10,0;;;3,0;;;;;;;25,0;;;6,0;;;337,0;2,0;;;;;;13,0;;;;;;10,0;;;;;;;;;;;11,0;;;;1,0;;;81,0;;1,0;;;;;;;;1,0;;;;2,0;;;;;;2,0;;;;;12,0;;;1,0;;;1,0;;2,0;;;;;;;;;;;;;41,0;;;5,0;;;;;;;3,0;1,0;6,0;;8,0;;;;;4,0;;;;;;;;;;;;;;;;;;;;;;;;;;9,0;;;;63,0;;;18,0;;;;1,0;;;;2,0;;3,0;11,0;;3,0;7,0;2,0;;11,0;7,0;31,0;;;3,0;2,0;45,0;11,0;3,0;;;;5,0;;3,0;;2,0;;1,0;4,0;;;16,0;;43,0;8,0;4,0;;1,0;;;;3,0;;;30,0;3,0;;2,0;;;;;2,0;2,0;2,0;3,0;4,0;31,0;3,0;2,0;4,0;;13,0;;3,0;2,0;1,0;8,0;38,0;;;;5,0;2,0;;1,0;;1,0;14,0;;;;;;2,0;;2,0;13,0;;;;;;16,0;;;1,0;;;;1,0;7,0;5,0;;;;;;;;;;;4,0;2,0;;13,0;;1,0;1,0;;;;;;;3,0;;;;;;;;;;5,0;;;;;;;;;;;32,0;;;;;1,0;;;;;;;;;;;;;1,0;;;;;;;;;;;;4,0;;;;;1,0;;3,0;;;;;1,0;;;;;1,0;;;;4,0;1,0;;;;;;;;;;;;;;;;;;;;7,0;;;;;;1,0;;;;;2,0;1,0;;6,0;;;;1,0;;;;2,0;;2,0;;;1,0;;;;;;1,0;9,0;2,0;;;;;;;2,0;;;;;;;;2,0;;;;1,0;;;;;3,0;;;1,0;;;3,0;;2,0;;;;;;;;1,0;;;;;;25,0;;;;25,0;6,0;;;4,0;;;;;;;;;1,0;;;;;;;1,0;;;7,0;;;;;3,0;1,0;;;;;;;;2,0;;;;10,0;;;;;4,0;3,0;;;;;;;2,0;;2,0;;;;4,0;;;;2,0;;;;;;;;;1,0;;;;1,0;;;;;;;;;;;;;;;;;;;27,0;;;;;;;;1,0;;;;;;;;;;;;;;;;;;5,0;;;;;;;22,0;;;;;3,0;;;4,0;;;;;4,0;;;;;2,0;;;;3,0;;;2,0;;22,0;;5,0;;;1,0;;;;;;1,0;;4,0;;;;;1,0;;8,0;;;;;;;;;;;;;;;;;;;;;1,0;;1,0;;;;6,0;;3,0;;1,0;;;;;;;;;2,0;;4,0;;1,0;;;;;;;;;;;5,0;;;;;;;;;;;;;;1,0;;;;;;;;3,0;;;;;;;;;;;;;1,0;;;;;;;;;;;;;;;1,0;;;;9,0;;;;;;;;;;1,0;;;;;;;;;;;;1,0;;;;1,0;;2,0;;;;;;;;;;;;
edge;;;;4,0;4,0;50,0;100,0;21,0;;;;;14,0;280,0;;1,0;38,0;4,0;15,0;2,0;7,0;3,0;80,0;3,0;;;;35,0;11,0;1,0;78,0;4,0;22,0;15,0;;197,0;65,0;37,0;48,0;;411,0;174,0;7,0;9,0;68,0;57,0;3,0;32,0;;1,0;31,0;;135,0;6,0;25,0;;109,0;;8,0;63,0;12,0;;9,0;;951,0;2,0;207,0;5,0;;15,0;72,0;136,0;40,0;1,0;6,0;131,0;18,0;1,0;;;214,0;;;110,0;50,0;7,0;;29,0;;;6,0;4,0;27,0;106,0;;;200,0;32,0;203,0;112,0;169,0;20,0;4,0;9,0;18,0;61,0;;8,0;6,0;55,0;;68,0;79,0;7,0;1,0;2,0;1,0;43,0;45,0;67,0;2,0;1,0;155,0;3,0;;4,0;75,0;;2,0;5,0;27,0;8,0;11,0;71,0;;;20,0;4,0;1,0;2,0;9,0;88,0;;;7,0;32,0;148,0;42,0;33,0;41,0;2,0;11,0;94,0;203,0;1,0;;24,0;;;;13,0;76,0;;7,0;;7,0;46,0;70,0;6,0;58,0;15,0;;;68,0;6,0;;;8,0;5,0;4,0;;6,0;17,0;66,0;;3,0;24,0;8,0;85,0;80,0;3,0;;13,0;5,0;20,0;50,0;64,0;;88,0;6,0;;26,0;4,0;;11,0;20,0;106,0;4,0;1,0;75,0;17,0;14,0;14,0;3,0;3,0;158,0;29,0;40,0;2,0;8,0;33,0;4,0;;;35,0;3,0;299,0;1,0;5,0;2,0;39,0;;4,0;8,0;28,0;;9,0;3,0;4,0;16,0;1,0;52,0;2,0;;4,0;25,0;3,0;49,0;215,0;19,0;11,0;20,0;;49,0;32,0;;48,0;437,0;4,0;;7,0;2,0;16,0;18,0;23,0;1,0;;1,0;15,0;20,0;;3,0;4,0;25,0;9,0;;6,0;59,0;18,0;1,0;57,0;;49,0;74,0;51,0;;3,0;104,0;36,0;14,0;4,0;14,0;;19,0;14,0;25,0;101,0;1,0;1,0;28,0;20,0;11,0;2,0;13,0;;17,0;8,0;1,0;11,0;16,0;15,0;1,0;18,0;2,0;31,0;;74,0;3,0;;67,0;44,0;109,0;96,0;4,0;121,0;6,0;;1,0;4,0;2,0;20,0;18,0;26,0;37,0;1,0;31,0;;17,0;;1,0;6,0;7,0;3,0;;3,0;17,0;47,0;43,0;;5,0;;;2,0;8,0;9,0;2,0;;85,0;14,0;1,0;13,0;;;2,0;;9,0;1,0;;5,0;3,0;1,0;;34,0;57,0;11,0;;;;45,0;9,0;26,0;24,0;;;1,0;110,0;3,0;20,0;;;1,0;;16,0;2,0;1,0;2,0;;197,0;12,0;;;36,0;3,0;13,0;14,0;45,0;;13,0;9,0;1,0;1,0;12,0;;4,0;23,0;19,0;4,0;;;;;15,0;1,0;;5,0;32,0;;11,0;2,0;;6,0;;;;8,0;;14,0;3,0;3,0;14,0;;1,0;68,0;10,0;8,0;16,0;1,0;;15,0;;;4,0;3,0;1,0;6,0;;3,0;9,0;;4,0;27,0;4,0;7,0;10,0;;;;;;;2,0;4,0;20,0;7,0;24,0;7,0;2,0;;;1,0;7,0;2,0;2,0;;5,0;5,0;32,0;6,0;5,0;23,0;;;2,0;28,0;;17,0;10,0;1,0;;;4,0;3,0;;8,0;13,0;17,0;12,0;;;2,0;;2,0;2,0;;;;4,0;24,0;4,0;2,0;3,0;28,0;;24,0;;;6,0;1,0;1,0;;;8,0;9,0;20,0;111,0;2,0;2,0;13,0;;68,0;;9,0;7,0;71,0;;;;1,0;2,0;1,0;;;;3,0;;3,0;;10,0;6,0;;1,0;;4,0;1,0;7,0;;12,0;;2,0;;;;;10,0;29,0;8,0;;4,0;25,0;;6,0;;1,0;4,0;1,0;3,0;10,0;;;9,0;;;;3,0;20,0;;1,0;4,0;11,0;5,0;1,0;;;65,0;3,0;;;7,0;1,0;5,0;1,0;;1,0;1,0;;21,0;;;;12,0;;;2,0;7,0;;5,0;8,0;;10,0;;3,0;;;;;;;;40,0;103,0;1,0;10,0;8,0;;;15,0;;4,0;;16,0;;1,0;3,0;3,0;;12,0;12,0;;2,0;3,0;;5,0;;;13,0;4,0;;;10,0;;23,0;;15,0;;;4,0;1,0;;33,0;4,0;;4,0;;16,0;;1,0;2,0;12,0;3,0;;;9,0;7,0;;6,0;94,0;5,0;14,0;;;1,0;;3,0;2,0;5,0;19,0;6,0;39,0;;;;1,0;10,0;1,0;3,0;;;3,0;;2,0;;9,0;;;2,0;4,0;3,0;;;;;;6,0;2,0;25,0;;11,0;2,0;1,0;55,0;;;7,0;9,0;;;1,0;18,0;1,0;;20,0;;3,0;1,0;2,0;25,0;6,0;1,0;4,0;2,0;;3,0;1,0;;13,0;1,0;2,0;;;;11,0;;4,0;;;;2,0;2,0;3,0;;3,0;;9,0;2,0;8,0;1,0;2,0;14,0;3,0;;;;;;;;2,0;;;;;;4,0;2,0;;5,0;;;10,0;2,0;24,0;2,0;;;;;8,0;;;8,0;1,0;7,0;;;8,0;5,0;2,0;9,0;;;8,0;5,0;10,0;;8,0;2,0;3,0;5,0;;2,0;4,0;10,0;17,0;;11,0;2,0;;;1,0;1,0;14,0;9,0;2,0;;4,0;17,0;6,0;1,0;;;19,0;4,0;2,0;;2,0;;26,0;3,0;64,0;1,0;4,0;3,0;;2,0;2,0;1,0;1,0;15,0;2,0;1,0;1,0;;;2,0;3,0;1,0;;;;3,0;2,0;;10,0;;;;;;4,0;;;11,0;;;12,0;2,0;2,0;10,0;16,0;6,0;;;;;5,0;;;;;12,0;;;;;;;;2,0;2,0;4,0;;6,0;;20,0;1,0;1,0;2,0;;;;;1,0;2,0;;;1,0;;;;;;2,0;1,0;2,0;;;8,0;1,0;1,0;7,0;7,0;;;1,0;;2,0;;8,0;;6,0;;;14,0;;6,0;13,0;39,0;1,0;3,0;;;;;;;2,0;;;3,0;;;;;1,0;;;;;;
electrode;;;;7,0;4,0;20,0;4,0;8,0;;;4,0;;18,0;2,0;;;8,0;6,0;;;4,0;;;2,0;;;;3,0;;;32,0;;;;25,0;;2,0;;1,0;;2,0;77,0;1,0;6,0;3,0;75,0;;61,0;;;;;15,0;3,0;1,0;2,0;150,0;;;5,0;6,0;;;;94,0;;98,0;;;;1,0;53,0;19,0;31,0;;;25,0;7,0;;;31,0;;4,0;;44,0;1,0;;18,0;;4,0;;1,0;4,0;;;;53,0;2,0;62,0;;28,0;9,0;;;10,0;1,0;;;;;;;135,0;;;;;5,0;;69,0;;;24,0;6,0;;;3,0;;8,0;5,0;;6,0;;75,0;;;29,0;;;;;2,0;;;5,0;33,0;24,0;46,0;;21,0;;;;58,0;;7,0;;1,0;;;86,0;212,0;;7,0;2,0;;12,0;23,0;1,0;17,0;4,0;;3,0;17,0;;4,0;1,0;2,0;;;;;8,0;42,0;;50,0;4,0;3,0;2,0;30,0;;;;15,0;23,0;27,0;25,0;;1,0;;41,0;418,0;;2,0;;;1,0;20,0;;12,0;5,0;;;;;25,0;4,0;2,0;1,0;;66,0;;;16,0;5,0;12,0;137,0;6,0;;;3,0;;;;21,0;;;2,0;;;7,0;5,0;;;2,0;;4,0;15,0;96,0;;;4,0;5,0;38,0;179,0;13,0;32,0;96,0;2,0;3,0;32,0;6,0;19,0;;1,0;;1,0;;;;;22,0;30,0;;;;;;4,0;;;;2,0;3,0;;;8,0;;19,0;4,0;2,0;;4,0;;;;13,0;6,0;;;;;7,0;;;;;;3,0;36,0;;;1,0;;;;27,0;;;2,0;;1,0;23,0;77,0;6,0;;2,0;;12,0;7,0;3,0;;;6,0;;;2,0;;;;;1,0;2,0;;;;1,0;12,0;;3,0;;;;7,0;;;3,0;73,0;;;;;;;;;;;;;;;;1,0;6,0;2,0;;;;;20,0;;;;;3,0;;5,0;;;;;3,0;5,0;;2,0;;;;;;12,0;;;;13,0;;;;;;2,0;;;;;;;;;;;1,0;;;8,0;;1,0;;;20,0;;;;;;6,0;;5,0;;;77,0;;;;;;;;;;53,0;;;;;;;;;;;;;;;;;;;;;;2,0;5,0;;;;;;;;;4,0;2,0;;1,0;;;;;;1,0;24,0;;;;;;;;;;12,0;;;;;;;;;;;;;;3,0;;8,0;13,0;1,0;;3,0;;;;;;;;;;;;;;;;;;;;23,0;;;;;;;;;;;;10,0;;2,0;;;;;1,0;;;;;;;;;;;2,0;6,0;2,0;;;1,0;10,0;;2,0;1,0;2,0;;;;;;;;;;1,0;;;;;;;;;;;;;9,0;;;157,0;2,0;;;1,0;;;;;;;;;;;;;3,0;;;;;;;;;;;;1,0;;4,0;4,0;;;16,0;;;;;;;;12,0;;;;;;;;;;;4,0;;1,0;;;;;29,0;;;;;;;;;;;;;;;;;;;;;;;;;41,0;;;;;5,0;;1,0;19,0;7,0;;;;;;;;7,0;;1,0;;;1,0;;;;;1,0;;;;;;;;;;;;2,0;;11,0;;;;;;;;;6,0;;;;;;;;;;;;;;;;;;;;;5,0;;;;;;;;;;;;;;;;;;71,0;;;1,0;4,0;8,0;14,0;5,0;;34,0;1,0;5,0;11,0;18,0;;4,0;;8,0;;;2,0;;32,0;;;;7,0;;;3,0;1,0;;95,0;;;;;;;;8,0;;;;;;;103,0;;;;1,0;;;;;27,0;2,0;;;;;;;;;;;4,0;;;;3,0;;;;;;;2,0;;3,0;;;;;;;;;;;;;;;;;;;;;;;;;;20,0;;;;;;;;;;;;;;;10,0;;;;;;;;;;;;;;;;;;;;;;9,0;;;;;17,0;;;;4,0;;;;;;;;;;;;;;;;;;;;;;;;;;2,0;;;;;;;1,0;;;;;;;15,0;;;;;;;;;;;;;;;;;;;;;;
electronics;;;;2,0;;2,0;10,0;27,0;;;;;2,0;3,0;;;21,0;;1,0;;4,0;;;2,0;13,0;;2,0;4,0;6,0;;34,0;5,0;1,0;;;18,0;;;7,0;;2,0;49,0;1,0;31,0;17,0;5,0;1,0;8,0;;;;;;11,0;;;4,0;;;4,0;;;;;76,0;7,0;88,0;;2,0;;;15,0;11,0;;;;20,0;;;4,0;17,0;;;;134,0;;;63,0;3,0;;;;;1,0;;;3,0;;7,0;2,0;8,0;;;10,0;52,0;6,0;;;;;;;3,0;;1,0;;;3,0;;28,0;;;50,0;;;6,0;33,0;;1,0;;8,0;;4,0;11,0;;;16,0;;1,0;;;4,0;;;;2,0;6,0;;14,0;2,0;;9,0;50,0;;;;;;;;20,0;5,0;;5,0;;;42,0;1,0;;6,0;5,0;;3,0;;;;2,0;;1,0;;1,0;;8,0;25,0;;;2,0;;7,0;6,0;4,0;;41,0;2,0;;;83,0;;;;;3,0;;;2,0;1,0;;2,0;;9,0;;1,0;;;;;11,0;;;6,0;1,0;;;;20,0;1,0;6,0;2,0;;25,0;1,0;1,0;2,0;;;;;;;2,0;;5,0;;;;6,0;6,0;2,0;3,0;;1,0;5,0;;8,0;;9,0;9,0;11,0;;;15,0;;;1,0;;;;1,0;;;;;;19,0;;;3,0;1,0;;;2,0;;;22,0;;;;;19,0;;;2,0;;;;;;;;;;;5,0;2,0;;;;1,0;;9,0;;;1,0;;;;6,0;;;2,0;;3,0;;;3,0;;;;24,0;5,0;;;;;11,0;;;;;;5,0;1,0;;;;;4,0;;;;;;;;;;;;28,0;4,0;2,0;;;;;1,0;1,0;;;1,0;2,0;;;2,0;1,0;;;;1,0;;21,0;;;;1,0;7,0;;;;;;;7,0;;;2,0;;;;;;2,0;9,0;1,0;;1,0;;;2,0;5,0;;2,0;;1,0;2,0;;;;;;;2,0;;1,0;;13,0;2,0;;;;8,0;;;;;;1,0;;;;;;3,0;1,0;;;;;58,0;;;;1,0;;;3,0;;;;;;;;;;;;;;;;3,0;;71,0;3,0;;;;;;;;1,0;14,0;6,0;2,0;6,0;1,0;5,0;;;;;;1,0;;1,0;;;;3,0;1,0;;1,0;1,0;2,0;;;;;8,0;;;1,0;;;;1,0;1,0;1,0;;12,0;;;;;;;;6,0;;6,0;;;;;;;;;;;;1,0;;;;;1,0;;;;6,0;;;4,0;;;;;2,0;;;13,0;;;3,0;1,0;;3,0;;;;1,0;3,0;8,0;;;;;;;;;;1,0;;;2,0;;;;;;;;;;;;;;;;;2,0;;;3,0;;;;;;;1,0;;1,0;;1,0;;;1,0;;;;;;;;;;10,0;2,0;;;;;;1,0;9,0;;;2,0;;;;;2,0;;;2,0;;;;;;;;;;2,0;;;;;4,0;;;6,0;4,0;;;;;13,0;;;1,0;;;;;;;2,0;3,0;;;;;;;;5,0;;;;7,0;;;;;2,0;;;2,0;4,0;;;;;;1,0;;;;;;2,0;;;;;;;;2,0;;;;;;;;;;;;;;;;;;;;;;;;;1,0;;2,0;;;;1,0;;;;;;;;;;;;;;;;;;1,0;;;;;;;;1,0;;;;;;;2,0;;;;;2,0;;;;;;;;;;;;;;;;;;;;;;;;;;;;;;;;;;;;;;;;5,0;;1,0;;1,0;;;;;;;;;6,0;;;;;;;1,0;;;;;;;;;;;;;;;;;;;;;1,0;;2,0;1,0;2,0;;;;;;;2,0;;;2,0;1,0;;;;;;;6,0;1,0;3,0;;;;;;;;3,0;6,0;;;;;;;;;;1,0;;;;;;;;;;;;;;5,0;;;;;;;;;;;;;;;;;;;;;;;;;;;;;10,0;;;;;;;;;2,0;7,0;;;;;;;;;;;;;;;;;;;;;;;;;;
embed;;;;6,0;;11,0;4,0;5,0;1,0;;;;2,0;10,0;;;7,0;;7,0;;6,0;;4,0;;6,0;;3,0;15,0;2,0;;18,0;11,0;;;;44,0;2,0;5,0;;;10,0;76,0;;12,0;16,0;2,0;1,0;2,0;;;1,0;;4,0;;2,0;;7,0;;;6,0;5,0;;;;79,0;;35,0;;1,0;;1,0;13,0;13,0;;;;22,0;;3,0;9,0;18,0;;;;26,0;;;5,0;;;9,0;16,0;;;1,0;;14,0;1,0;14,0;3,0;1,0;;;4,0;8,0;11,0;1,0;5,0;;;;3,0;30,0;;;;;1,0;;23,0;16,0;;42,0;;3,0;3,0;48,0;;;;4,0;;;4,0;1,0;;7,0;;;;;;;;1,0;;1,0;;4,0;;;14,0;10,0;1,0;;2,0;1,0;;1,0;2,0;27,0;5,0;;4,0;;;3,0;9,0;;;2,0;;1,0;4,0;;;;;1,0;;;;3,0;1,0;7,0;7,0;8,0;;14,0;1,0;;;;;1,0;3,0;16,0;;;;23,0;18,0;3,0;;4,0;9,0;33,0;4,0;1,0;9,0;1,0;1,0;;;;2,0;12,0;;1,0;;15,0;;;;;;37,0;2,0;1,0;1,0;;;;;2,0;;;;;;2,0;5,0;;;1,0;2,0;2,0;;3,0;;1,0;;;20,0;25,0;;11,0;16,0;;;;12,0;;3,0;2,0;;;;;1,0;;13,0;;;1,0;;1,0;;;4,0;1,0;14,0;;2,0;;;4,0;3,0;12,0;1,0;2,0;;;;;4,0;1,0;1,0;;1,0;1,0;;5,0;;;;;;2,0;15,0;;;;;;;;;;1,0;8,0;11,0;;;;3,0;;;2,0;;;;;2,0;11,0;;;;;;1,0;;;2,0;;8,0;1,0;;;;;;1,0;;1,0;;1,0;;38,0;5,0;;;;3,0;;;;;;;;;2,0;4,0;;;;3,0;;;4,0;3,0;;;;;;;;2,0;;;3,0;1,0;;;;;;1,0;;6,0;1,0;;4,0;7,0;;1,0;;4,0;;1,0;;1,0;2,0;17,0;4,0;;;;;1,0;;5,0;1,0;7,0;;2,0;;;6,0;4,0;1,0;3,0;1,0;;;;;;;5,0;;;1,0;1,0;;;4,0;;;;;;;;;18,0;;1,0;1,0;;;1,0;;6,0;;;1,0;;;;6,0;1,0;;;1,0;;4,0;;4,0;;5,0;2,0;;;1,0;;;;;;;1,0;3,0;;2,0;;;;20,0;2,0;3,0;1,0;;;;;;;12,0;;;;;1,0;;1,0;;;;;;2,0;;;;;;;;;2,0;;;2,0;1,0;;2,0;;39,0;;;14,0;;1,0;;;;;;4,0;;;;;;;;4,0;;7,0;2,0;;;;;;;;;;;;;3,0;;;;2,0;;;;;;4,0;;1,0;12,0;1,0;;;;;;;2,0;1,0;;;;;;;;6,0;;2,0;;;;;;1,0;1,0;;;;5,0;1,0;;;;;;;;;;;1,0;;;;4,0;1,0;;;;;;;;1,0;;;;;;;;4,0;;3,0;;;1,0;;;;;1,0;2,0;1,0;2,0;2,0;;;;1,0;4,0;5,0;;1,0;1,0;;;;;2,0;;;;11,0;1,0;2,0;1,0;;;;;1,0;14,0;;;6,0;;5,0;;;1,0;1,0;;6,0;3,0;;;;;;;;;1,0;;;;1,0;;;;;2,0;;;;2,0;;;;1,0;;;;;;5,0;;;;;;;5,0;;;;;;;;;3,0;;;2,0;;;1,0;4,0;;;;;;;;;;;;;1,0;;;;1,0;;;;;;;5,0;1,0;;;1,0;;;;;;;;;1,0;;;1,0;;;20,0;;;;;;;4,0;;;;;;;;;;;;;;;;;;;;;;;3,0;;;;;;;;;;;;;;;;;;4,0;;;;1,0;;1,0;;;2,0;;;;;;;;;;1,0;;;;3,0;;;;;;;;1,0;;;;;;;;;3,0;;;;;;;;;;;;;;;;2,0;;1,0;;;;;;;;;;2,0;;;;;;14,0;;;;;;;5,0;;3,0;;;;;;;;;;;;3,0;;;;;;;;;;;;;;;;;;;;;1,0;;;;;;1,0;;;;;;;;;;;;;;;;;;;2,0;;;;;;;;
emission;;;;2,0;27,0;13,0;27,0;;;;;;;8,0;1,0;1,0;5,0;;;;;;6,0;;;;1,0;;;;11,0;1,0;2,0;5,0;;;7,0;2,0;6,0;;4,0;43,0;;;7,0;4,0;;3,0;;;;;6,0;;6,0;7,0;9,0;;;4,0;;;;;17,0;;7,0;;;;7,0;31,0;186,0;;;;2,0;;;;16,0;;1,0;;22,0;;;15,0;;;;;;;3,0;;;5,0;41,0;11,0;14,0;;;;1,0;9,0;4,0;;;;;2,0;4,0;;;;;4,0;;2,0;;;9,0;2,0;1,0;;6,0;;;;31,0;;;42,0;;;3,0;;;;;1,0;;;;;1,0;12,0;;;;;2,0;;;1,0;;;;;;2,0;;;;;;;;8,0;8,0;;;13,0;;6,0;1,0;50,0;;;6,0;;;;;;;;;;5,0;;1,0;;;;2,0;14,0;;;;1,0;1,0;;;;;;11,0;;1,0;;;;;;;17,0;;12,0;5,0;2,0;;;2,0;;3,0;;;4,0;;7,0;6,0;16,0;;;5,0;1,0;;;4,0;;;;;;1,0;3,0;8,0;;;;;;;3,0;;55,0;;;;;;2,0;;;2,0;13,0;1,0;2,0;;;;14,0;;;;22,0;;;;;18,0;;;;;;1,0;;;1,0;;;2,0;;6,0;;;;;;;;;;;;;16,0;4,0;;;;;;;;;;;12,0;2,0;;;;;;3,0;1,0;;;;;;;;;;;;;;;;;;;;;;;;;;2,0;;;;2,0;;;;;4,0;1,0;;;;;;;20,0;6,0;;;;;1,0;;20,0;;3,0;;3,0;16,0;;3,0;;6,0;;;;;;9,0;;2,0;;;;;1,0;2,0;;;1,0;;;;;;;1,0;;;;;;;;6,0;1,0;;;8,0;;4,0;;;1,0;;;;;;;2,0;;;1,0;;;;;;;;;;;;3,0;;;;2,0;;;;4,0;;12,0;;;;;;;;;;1,0;;;;8,0;;;;;;;;;;6,0;;1,0;;;;;2,0;;;;;1,0;;;;;;;;;;;;;2,0;;;2,0;;;8,0;;;;;;;;;;;;;;;;;;;;;;6,0;;1,0;;2,0;;;;;;;;;;1,0;;;;;;;;18,0;;;;;3,0;;;;;;;;;;;;;;;;10,0;;;;;;;;;;3,0;1,0;;;;;;;;;;;;;;14,0;;;;2,0;;;;;;;;;;;2,0;;;;6,0;;;;;;;;;;;;4,0;;;;;;;;;;;;;1,0;;;;;;2,0;;;;;4,0;;;;;;;;63,0;;;;;6,0;;;1,0;;;;;;;4,0;;;;;;;;;;;;;;;23,0;;1,0;;1,0;;;;;2,0;;;;;;5,0;;;;1,0;;;;;2,0;;;;9,0;;;4,0;;;;;;;;;4,0;;;;;1,0;;4,0;;;;;;;;;;;;1,0;;;;;;;;;20,0;;;;4,0;;;;;;2,0;;;;;;;;;4,0;;;;;1,0;;;;;;;;;;;1,0;;;;;10,0;;;;;;;;4,0;;;;;;;;;;;;6,0;;;2,0;2,0;;;;;;1,0;;;;;;;;1,0;2,0;2,0;;;;;;;;;;1,0;3,0;;1,0;;;;;;;;;;;;4,0;;;;;2,0;1,0;;;;5,0;;;;;;;;;;;;;;;;;;;;;;;;1,0;;;;;;;1,0;;;;;6,0;;;;;;;;;18,0;;;;;;;;;;;;;;;;;;;;;;;;;;;;;;;;;2,0;6,0;;;;;9,0;;;;;;;;;;;;1,0;;;;;;;;;;;;;;1,0;;;;;;
encoder;;;;1,0;8,0;8,0;;;;;3,0;11,0;4,0;9,0;;;9,0;;;;11,0;;1,0;2,0;9,0;;1,0;13,0;;;81,0;3,0;;;;39,0;;;;;6,0;13,0;2,0;4,0;21,0;3,0;;5,0;;;;;1,0;;2,0;;3,0;;;16,0;;;;6,0;100,0;2,0;37,0;;;;1,0;8,0;1,0;;;;;1,0;;18,0;26,0;;8,0;;4,0;3,0;;12,0;;;;;;;;;1,0;;21,0;;21,0;;;6,0;4,0;13,0;1,0;;;;;;1,0;;;2,0;;2,0;;7,0;;;24,0;2,0;;12,0;46,0;;;;;;;13,0;;;2,0;;;1,0;;;;;;;;2,0;1,0;;1,0;1,0;6,0;;;;1,0;;;;;1,0;;5,0;;;16,0;2,0;;;11,0;;;4,0;;4,0;;1,0;;;;;;6,0;;;;;30,0;1,0;;;;1,0;9,0;;6,0;;3,0;;;;1,0;;15,0;;4,0;;;;;;3,0;;;;40,0;2,0;;;;;;;;;53,0;;;10,0;;;4,0;4,0;;;2,0;;;;;;3,0;;;;;;1,0;;;;;;;;1,0;1,0;;;1,0;6,0;;2,0;3,0;;;;;1,0;;;;;;;;12,0;;;;;4,0;;;;;;3,0;;1,0;;9,0;6,0;;;1,0;;2,0;;;;;;;3,0;1,0;;;;;;2,0;;;;;;;2,0;;4,0;;;;;;;;;;;;;;;1,0;;;47,0;;10,0;8,0;;;;;2,0;;;;;;;;;;;44,0;;;;;;;;;;;;;;;1,0;2,0;;;;;;7,0;;;;;13,0;;;;;;4,0;;;6,0;2,0;;;;;;3,0;3,0;3,0;;;;2,0;4,0;43,0;;;;2,0;12,0;;;;;;;;;3,0;;19,0;;5,0;7,0;;4,0;;;;2,0;;;;;;;;;;7,0;1,0;;;;;;;;;;;;;;;;;;7,0;;83,0;;;;;1,0;;2,0;2,0;;;;;;;;;;;4,0;;5,0;;2,0;;;;;;;;1,0;;;;;;;;3,0;;;;;;2,0;;;;;;;;;;;;;;;;;;;2,0;6,0;;;1,0;;;;;;;3,0;;;;;;;3,0;;;3,0;;;1,0;3,0;;;;;;1,0;;;;;;;;;;;;;;;;;;;;;;3,0;;;;;;4,0;;;;;;;;;;;;;;;;;;;;;;;5,0;;;;;;;;2,0;;;;;;;;;;;;;;1,0;;;;;;;;;;4,0;;;10,0;;;;;;;;;;;;2,0;1,0;;;;;;;;;;;1,0;;;;;9,0;;;;;;;4,0;2,0;;;3,0;;;;;;;;2,0;;;;;;;;3,0;10,0;4,0;;;;;;;;;;;;;2,0;;;;;2,0;;2,0;;;;;;;;;;6,0;;;10,0;;;;;;;;2,0;;;;;;;;;;;;;;19,0;;;;;;;;;;;;;;;;;;;;;;;;;;;;;;;;;;;;;;;;;;;;;;;;;;;;;;;;3,0;;;;;;;;3,0;;;;;;;;;;;;;1,0;;;;;;;;;;;;;;;;;4,0;;2,0;;;;;;;;;;;;;;;;;;;;;;;;;;;;2,0;;;;;;;4,0;;;;;;;4,0;;;;;;;;;;;;;;;;;;;;;;;;;;;;;1,0;;2,0;;3,0;;;;;;;;;;;;;;;;;;;;;;;;;;;;;;;;;;;;;;;;;;;;;;;;;;;;;;;;;;;;;;;;;;;;;
energy;;;;3,0;26,0;8,0;2,0;5,0;;;;10,0;;25,0;;;10,0;1,0;;;;2,0;3,0;;2,0;;;31,0;4,0;;35,0;1,0;;;1,0;41,0;3,0;;;;44,0;47,0;;;2,0;10,0;14,0;1,0;;;9,0;;;5,0;27,0;3,0;3,0;;24,0;21,0;;;4,0;;54,0;;60,0;2,0;;;3,0;11,0;59,0;;;3,0;2,0;59,0;1,0;6,0;60,0;;1,0;;19,0;;;31,0;;;3,0;1,0;9,0;;;;4,0;;12,0;10,0;31,0;8,0;;18,0;12,0;8,0;;3,0;;;;;4,0;;;2,0;1,0;2,0;1,0;19,0;;1,0;52,0;3,0;2,0;37,0;42,0;;;2,0;12,0;5,0;;62,0;1,0;;4,0;;;4,0;;;;;;1,0;2,0;1,0;17,0;;;7,0;1,0;;;11,0;;;;;;3,0;;24,0;;;22,0;;1,0;3,0;15,0;;;2,0;;;7,0;33,0;;;;;;2,0;;;6,0;;4,0;;18,0;;;;;;1,0;1,0;;;;4,0;;2,0;19,0;;;;;4,0;;1,0;;;;;1,0;;;2,0;13,0;3,0;;1,0;5,0;;6,0;;3,0;9,0;;24,0;9,0;3,0;;;;;;5,0;;;;;;1,0;2,0;3,0;1,0;;;;;11,0;1,0;13,0;1,0;6,0;;;75,0;3,0;1,0;1,0;;;4,0;2,0;1,0;73,0;;2,0;;;;;5,0;2,0;;;;;3,0;2,0;;;;;9,0;;4,0;1,0;;;1,0;2,0;4,0;;8,0;;;;;6,0;;;;;;2,0;;;2,0;;;;1,0;1,0;;1,0;2,0;12,0;;2,0;14,0;;;;19,0;;;2,0;;;;;1,0;;;;;;4,0;;;;9,0;;2,0;;;;3,0;1,0;;;6,0;;2,0;7,0;;;;;;;;;;;;;5,0;;3,0;;4,0;;3,0;;8,0;7,0;;14,0;;19,0;;7,0;3,0;22,0;;2,0;7,0;;4,0;62,0;;1,0;;1,0;;2,0;7,0;6,0;;11,0;;7,0;4,0;;;1,0;;4,0;4,0;5,0;;;;;;1,0;;7,0;;33,0;1,0;1,0;1,0;;26,0;;3,0;1,0;;;7,0;2,0;6,0;;;;7,0;;10,0;;;;;;;2,0;;;;13,0;;;;2,0;7,0;;11,0;;;6,0;1,0;;;;;2,0;2,0;1,0;6,0;;;;;;;;1,0;2,0;1,0;;3,0;;1,0;5,0;;;2,0;2,0;3,0;;;1,0;;;;;;;;;;1,0;;1,0;2,0;;;;;13,0;;;;2,0;;1,0;4,0;;;;;;1,0;;;;;2,0;;1,0;7,0;;;1,0;;;;3,0;;;;;;;;;1,0;;;;;;;;;;2,0;1,0;2,0;;1,0;;;1,0;;;;2,0;1,0;12,0;;;;19,0;;;5,0;3,0;4,0;;;;;;;;3,0;6,0;1,0;;5,0;2,0;3,0;;1,0;;4,0;5,0;1,0;;;1,0;;;;1,0;;;;;1,0;;;3,0;4,0;;3,0;1,0;;;;;;;;;;3,0;;;;2,0;;1,0;;1,0;;;8,0;1,0;;;;;;;1,0;;3,0;1,0;;10,0;;;;;;;;;;;;4,0;53,0;;;1,0;;;;;3,0;;;2,0;3,0;3,0;1,0;;11,0;1,0;;;;;;;;1,0;;2,0;;;1,0;;4,0;3,0;;;;1,0;;;;;;2,0;;1,0;;1,0;;;;;;;;;;;;;;;;;10,0;;;4,0;2,0;;2,0;;;;1,0;;;3,0;;;;;;;;;;;;;;;;;;;1,0;;4,0;;;1,0;;;;1,0;;;2,0;;;;;;1,0;;1,0;;5,0;;;4,0;4,0;29,0;;;10,0;;;;;;;9,0;;;;;;4,0;;;;;;;;;;2,0;;1,0;;;;;;;;;;;3,0;;;6,0;;;;;;;;;;;4,0;;1,0;;;4,0;2,0;;;;2,0;;;1,0;;;;1,0;;17,0;;;1,0;6,0;;;;;;4,0;;;;1,0;;;;;;;;;;;;;;;;;1,0;1,0;;;;;;;;2,0;;;;6,0;1,0;;7,0;;;;4,0;;1,0;;;;;;;;;3,0;4,0;;;;;;;;;;;;;;;;;3,0;;;;;;;;;;;;;;;;4,0;21,0;;;;;;;;;;;;27,0;;1,0;;;2,0;;;;;10,0;2,0;;;;;;;;;;;;;;
engine;;;;6,0;2,0;21,0;2,0;;;2,0;;4,0;;4,0;;;18,0;;;;5,0;;;;5,0;;;6,0;13,0;;119,0;4,0;4,0;1,0;;40,0;;;;;23,0;25,0;;1,0;12,0;;;;;2,0;4,0;;;;7,0;1,0;3,0;;;10,0;;;;1,0;76,0;9,0;35,0;;;;;5,0;15,0;1,0;;;;;3,0;8,0;11,0;;;10,0;4,0;1,0;;5,0;;;5,0;2,0;;1,0;;;;1,0;4,0;15,0;10,0;;;17,0;3,0;7,0;;2,0;3,0;;;;;;;1,0;;;4,0;5,0;;;1,0;;;7,0;40,0;;;;;;;4,0;;;5,0;14,0;;;;;1,0;;;;;9,0;2,0;;;;2,0;;;;;;;;;1,0;7,0;;;;10,0;;;1,0;;;4,0;;;1,0;;2,0;;;5,0;;;;;;6,0;2,0;15,0;2,0;;;2,0;;;;5,0;;;;;;;;;2,0;;;;3,0;;5,0;;;;;5,0;2,0;;;2,0;;;;;;4,0;;;3,0;;;2,0;;;;;;;;;;;;;1,0;;;;;;;;1,0;;3,0;4,0;1,0;;;2,0;;;22,0;;;;;;;;;;3,0;;;2,0;;;;;1,0;;;;;;1,0;6,0;;;;;;;;;;;2,0;;;;1,0;;;;1,0;;20,0;;;;;;;3,0;5,0;;;1,0;10,0;;;;;;;7,0;;;;;;;;;;;;3,0;3,0;;;;;;1,0;;;;;3,0;;10,0;;;;8,0;;;;;;;7,0;8,0;;;1,0;;9,0;4,0;2,0;;;;6,0;2,0;1,0;24,0;;;2,0;;3,0;;;;;;4,0;1,0;;;;;8,0;1,0;;;;1,0;;;;;1,0;12,0;;;1,0;;1,0;5,0;;;;;;;;;;1,0;27,0;1,0;3,0;1,0;;;;1,0;;1,0;9,0;6,0;;;;3,0;;;;;3,0;13,0;;3,0;;;;;;;;;;;2,0;12,0;;;1,0;;;14,0;1,0;2,0;1,0;;;4,0;7,0;3,0;;;;;9,0;;;;;2,0;2,0;26,0;;;9,0;;;;3,0;;;;;;4,0;;7,0;1,0;;4,0;;11,0;;;;;;;;;13,0;;;;;;;;;;;;;;;1,0;;;1,0;;;;;1,0;;5,0;;;;2,0;;;;1,0;;2,0;;10,0;20,0;2,0;;;;;5,0;;;7,0;;2,0;;3,0;;2,0;;;1,0;;;2,0;13,0;;6,0;;;;;1,0;;1,0;;;;1,0;;;1,0;;;;;;;5,0;;;;3,0;4,0;;1,0;;;;;1,0;;1,0;;;;;;;;;;;;;;1,0;;;1,0;;;;1,0;;;;;;;;;;;;;3,0;;;;;;;2,0;;;3,0;;;;;4,0;;1,0;1,0;;;;;;5,0;;;;;1,0;;;;;;;1,0;1,0;;;;;;;;;;;13,0;;1,0;;;;;;;2,0;;;;;;;;;;;;;;;;;2,0;;;;;;;;;;;;;;1,0;1,0;;;;;;;;;;;;1,0;;;;;4,0;;;;;;;;;;;;;;;;;;;;3,0;;;;1,0;;;;;;;;;;;;;;;;;;;;;;;1,0;;;;;;;;;;;;;;;;8,0;;;;;;;;;;;;;;;;;2,0;;3,0;;63,0;;;;;;;;;;;;;;;;;4,0;;;4,0;;;;;;;;;;;;;;;;;3,0;1,0;;;;;;2,0;;;;;;;;1,0;;;2,0;;;;;;;2,0;;;3,0;;;;;;;;;;1,0;;;;;;;;;;3,0;;;;;;;;;17,0;;;;;;;;;;;;;;;;;;;;;;;;;;;;;1,0;;;;;;;;;;;;1,0;;;7,0;;;;;;;;;2,0;;;;;;;;;;;2,0;;;;;
estimation;;;;3,0;3,0;30,0;1,0;;;;;4,0;;39,0;;;19,0;;;;;;3,0;;;1,0;;36,0;5,0;10,0;40,0;3,0;10,0;5,0;;8,0;10,0;1,0;47,0;;45,0;35,0;;;8,0;;;;10,0;3,0;77,0;;;;2,0;;8,0;1,0;;12,0;;;4,0;;63,0;;35,0;;;;;;;;;1,0;;2,0;;2,0;104,0;;8,0;12,0;33,0;;;16,0;;3,0;9,0;;;;3,0;;14,0;13,0;2,0;44,0;75,0;2,0;;17,0;97,0;17,0;1,0;2,0;1,0;;;1,0;5,0;;;;1,0;;3,0;;5,0;;;;5,0;3,0;87,0;;1,0;;3,0;1,0;;31,0;3,0;;1,0;;;;;;;;;9,0;3,0;;3,0;;;;;;;;;1,0;;;;2,0;;;;1,0;4,0;;1,0;15,0;;1,0;1,0;21,0;;;;;6,0;;1,0;;;;;;5,0;;6,0;;4,0;;;;;;;;;;;;;3,0;3,0;9,0;;;;1,0;;3,0;1,0;;;;17,0;;;2,0;2,0;3,0;;;1,0;;;;;4,0;;;3,0;1,0;;;;;;;;;;;;;1,0;5,0;;;;;;;;;;8,0;;;;;;41,0;;;;;1,0;;;;;;;;2,0;3,0;;;;;;2,0;;;;;17,0;;;;;;1,0;;9,0;;;;;;;11,0;;;;3,0;3,0;;;;;;1,0;;;;;;14,0;22,0;;3,0;;;;;;;;;;;;;2,0;;;;;3,0;;;;;;5,0;;;;;22,0;;6,0;;;;3,0;1,0;;;1,0;;;;;;;1,0;;;15,0;;;;;;;;4,0;7,0;;2,0;;10,0;;;1,0;1,0;;17,0;2,0;;;14,0;;7,0;1,0;1,0;5,0;7,0;;;3,0;2,0;;;55,0;;;12,0;;;;20,0;;;2,0;;;4,0;;;1,0;11,0;;2,0;;;;;9,0;;51,0;;6,0;;;;;;10,0;1,0;;;1,0;;8,0;1,0;4,0;;1,0;;;;;13,0;;1,0;;;4,0;;;;;;;13,0;2,0;;9,0;1,0;;1,0;;;5,0;;;;;;;1,0;38,0;1,0;;60,0;;5,0;;3,0;;;2,0;;;2,0;;;;;16,0;;2,0;;;;;;;;;;;;;;;;;;2,0;;;;;;;;;;1,0;;;;;;;;;;;;;;;;;;6,0;1,0;1,0;1,0;;;;;;4,0;;;3,0;1,0;15,0;;;2,0;;;;;;5,0;;2,0;;;;;;;18,0;;;;1,0;3,0;;;;;;;14,0;;;;;4,0;2,0;11,0;;;;;;;;;;8,0;;;12,0;;;;;;6,0;;;;4,0;;;;;;;;;;;;;;;;;7,0;;2,0;;;;;;1,0;;;6,0;1,0;;;1,0;2,0;;;4,0;;2,0;;;;;;1,0;;;;;;;;2,0;;;;;;;;;;;;;;;1,0;;;;4,0;;;;;;;;;;;;1,0;;;;;;;;;;3,0;;;;;;;;;;9,0;;;;1,0;8,0;;;;;;;;2,0;;;;;;;;;;;;;;;;;;;;;;;10,0;;;;;1,0;;;;;;;;;;8,0;;;;;5,0;;1,0;;;;;1,0;;;;;;;;;;;3,0;;;;;13,0;6,0;;;;;;2,0;;1,0;;;;3,0;1,0;;;;;;;;;;22,0;;;23,0;;;;;;;2,0;;;;;;2,0;;;1,0;;;9,0;;1,0;;;;2,0;;;;8,0;;1,0;;;;;1,0;;;1,0;;;;;8,0;2,0;;;;;;;;;;;;;2,0;;;;;;;;;;;1,0;;;;;;;;;;;;;;1,0;2,0;;;;;;4,0;;;;1,0;;19,0;;;;;;;;;;;;;;;;;;;;;;;;;;;;1,0;;;;;;;;;;1,0;;;;;3,0;;1,0;;;;;;;1,0;;;;;8,0;;;;;1,0;;;1,0;;;
event;;;;7,0;4,0;19,0;10,0;1,0;4,0;7,0;;;;140,0;;26,0;142,0;;;4,0;;;2,0;19,0;7,0;;;3,0;13,0;38,0;54,0;23,0;;;1,0;107,0;8,0;1,0;1,0;;142,0;130,0;;2,0;128,0;;;6,0;;;2,0;;;12,0;4,0;;2,0;;2,0;41,0;3,0;;1,0;2,0;223,0;5,0;148,0;;25,0;;;4,0;38,0;;;;;;6,0;6,0;189,0;;39,0;13,0;17,0;;;8,0;;9,0;14,0;4,0;2,0;;;;34,0;;69,0;22,0;114,0;54,0;;25,0;34,0;55,0;6,0;9,0;11,0;;2,0;8,0;19,0;;;2,0;6,0;66,0;35,0;90,0;14,0;;108,0;;;24,0;85,0;;1,0;;129,0;;;22,0;;3,0;43,0;6,0;1,0;;;2,0;;;;10,0;28,0;2,0;131,0;1,0;;12,0;3,0;;1,0;;;;;;;1,0;5,0;1,0;;;5,0;4,0;1,0;117,0;25,0;6,0;;1,0;1,0;;;4,0;15,0;;22,0;;;8,0;;1,0;4,0;;13,0;15,0;7,0;1,0;1,0;;1,0;;;;;;;2,0;;;10,0;13,0;;;;4,0;;3,0;;;;;16,0;;7,0;1,0;3,0;15,0;5,0;;8,0;;21,0;;2,0;2,0;;2,0;2,0;;2,0;11,0;;;;27,0;;2,0;;;;49,0;6,0;3,0;2,0;10,0;2,0;;;1,0;;2,0;;9,0;2,0;;4,0;26,0;;54,0;;;;;11,0;14,0;;;1,0;;;;2,0;16,0;;;;14,0;;;10,0;;;25,0;4,0;;;4,0;;;3,0;;7,0;26,0;;;;;1,0;;;;;;2,0;;;1,0;;;;;9,0;16,0;;2,0;20,0;29,0;;;1,0;;;;26,0;;;;;;37,0;;10,0;;4,0;;;5,0;;;3,0;3,0;5,0;;;;;;;;10,0;3,0;9,0;;283,0;5,0;;1,0;2,0;14,0;10,0;2,0;7,0;;;2,0;;;6,0;;19,0;2,0;1,0;17,0;4,0;4,0;46,0;9,0;7,0;2,0;2,0;343,0;4,0;6,0;;;11,0;3,0;9,0;;;6,0;;84,0;55,0;4,0;;31,0;;34,0;;82,0;10,0;28,0;111,0;;;10,0;6,0;19,0;16,0;2,0;;;;8,0;;4,0;4,0;2,0;4,0;89,0;22,0;149,0;19,0;;13,0;10,0;10,0;151,0;5,0;2,0;15,0;3,0;5,0;4,0;;15,0;49,0;;2,0;11,0;;3,0;94,0;;;3,0;20,0;;3,0;1,0;;7,0;3,0;2,0;14,0;10,0;8,0;16,0;;2,0;1,0;8,0;4,0;;40,0;23,0;34,0;10,0;;;1,0;;;;;5,0;1,0;15,0;;3,0;7,0;1,0;21,0;;;4,0;;;2,0;;31,0;35,0;;;;34,0;;36,0;1,0;2,0;3,0;;3,0;;14,0;;20,0;;2,0;13,0;;6,0;;;2,0;;;;1,0;;;;;4,0;;6,0;2,0;;;;22,0;;4,0;;9,0;1,0;;6,0;;4,0;10,0;;;6,0;;;12,0;4,0;14,0;11,0;;2,0;;23,0;8,0;17,0;5,0;;8,0;;14,0;1,0;9,0;13,0;30,0;;;;;;;1,0;;4,0;;8,0;1,0;;3,0;;;3,0;1,0;3,0;1,0;;3,0;8,0;25,0;;;9,0;12,0;;;;1,0;5,0;13,0;8,0;;24,0;;;6,0;10,0;1,0;;;;;16,0;103,0;;12,0;1,0;5,0;217,0;;;2,0;;4,0;48,0;;;;20,0;;31,0;;;;;;4,0;;;1,0;;;;;;;6,0;2,0;4,0;;;3,0;9,0;3,0;3,0;;7,0;33,0;4,0;4,0;;;;;4,0;72,0;2,0;;27,0;;5,0;;4,0;30,0;;3,0;;;5,0;;163,0;1,0;;;1,0;;1,0;8,0;6,0;;;1,0;;;;1,0;9,0;5,0;;;;;;;2,0;;3,0;;1,0;;;;;;3,0;9,0;;;19,0;65,0;;;;;12,0;;1,0;;;1,0;2,0;;;;;30,0;;;;;;10,0;3,0;;8,0;;;;;;;;;;;;;;;;;;;;8,0;9,0;15,0;5,0;;;;;;;;;1,0;;;;1,0;3,0;;3,0;;;;;;5,0;;10,0;13,0;;;4,0;;;;;4,0;;1,0;6,0;;;;5,0;;54,0;3,0;;;1,0;;;3,0;8,0;;2,0;12,0;;;;;;;9,0;;3,0;;;;;;;2,0;4,0;;;;3,0;;;;;2,0;2,0;7,0;;;;;1,0;;;;;;;;;;;1,0;;;;1,0;;;1,0;2,0;;12,0;;;56,0;;;7,0;;11,0;;;;2,0;;;;;3,0;;;2,0;6,0;;1,0;;1,0;4,0;;;;6,0;;;;;;1,0;;;;;;;;;;1,0;;12,0;3,0;;7,0;;;;;;;;;1,0;1,0;;;;;;9,0;;;;1,0;;;;1,0;;;;;;;1,0;;;;;;;;;;;;;;;;;;;;;;;;16,0;;;;;;;;;5,0;;;;;
exceed;;;;12,0;41,0;7,0;1,0;;;;;;;29,0;;5,0;23,0;;;9,0;6,0;2,0;;;1,0;2,0;4,0;;4,0;7,0;3,0;2,0;;5,0;;34,0;;11,0;11,0;7,0;138,0;41,0;10,0;6,0;11,0;;;1,0;;24,0;;;;1,0;11,0;;;;5,0;14,0;;;8,0;;65,0;;15,0;2,0;2,0;;6,0;46,0;39,0;;12,0;2,0;1,0;28,0;;5,0;73,0;;1,0;;12,0;;;3,0;2,0;;4,0;;2,0;;;;86,0;1,0;43,0;6,0;55,0;181,0;2,0;3,0;4,0;25,0;1,0;6,0;;;;10,0;23,0;2,0;;2,0;10,0;5,0;5,0;27,0;3,0;;26,0;20,0;;4,0;35,0;;3,0;3,0;107,0;6,0;;17,0;1,0;;11,0;;;;;7,0;;;21,0;4,0;37,0;1,0;18,0;;;2,0;;;3,0;;;;;6,0;;;;;;1,0;1,0;;2,0;3,0;1,0;;;3,0;1,0;1,0;;;;;;;6,0;5,0;;;;12,0;42,0;;;;;;;;;2,0;1,0;;;2,0;20,0;33,0;30,0;2,0;1,0;;;;3,0;40,0;6,0;;;1,0;29,0;;;1,0;4,0;15,0;1,0;;;;18,0;6,0;;2,0;;12,0;15,0;13,0;;;1,0;;;;;;;;;21,0;;;;;;;;;;;;9,0;;;1,0;2,0;;11,0;;;;4,0;7,0;13,0;;;2,0;;;;;48,0;;;;;8,0;;4,0;;;;2,0;;2,0;;;;6,0;;19,0;1,0;;;;;;4,0;;;;4,0;89,0;5,0;1,0;;;;3,0;;;;;7,0;1,0;15,0;;1,0;;;;;18,0;;2,0;;;5,0;4,0;;;;;;;11,0;6,0;;;;1,0;;;;;;;;6,0;;1,0;5,0;39,0;;3,0;6,0;7,0;;;2,0;;6,0;;;;;5,0;3,0;15,0;;;3,0;1,0;;7,0;3,0;1,0;;2,0;34,0;4,0;61,0;;11,0;;;;23,0;;1,0;;13,0;19,0;;2,0;4,0;2,0;45,0;;;1,0;7,0;36,0;;;;;1,0;6,0;8,0;3,0;3,0;;;;23,0;2,0;8,0;2,0;10,0;;46,0;49,0;;4,0;;8,0;4,0;19,0;;;2,0;;2,0;17,0;;579,0;2,0;;4,0;;;2,0;1,0;;12,0;1,0;;;1,0;;1,0;6,0;;6,0;;13,0;1,0;4,0;2,0;;;;;2,0;;4,0;5,0;;15,0;3,0;;1,0;4,0;6,0;;;;3,0;;7,0;;2,0;;;2,0;3,0;;1,0;;;2,0;;;;2,0;;1,0;5,0;2,0;;2,0;3,0;7,0;4,0;11,0;;;4,0;;2,0;;;;;;;;;;;;;;2,0;18,0;6,0;;1,0;;5,0;;1,0;1,0;;12,0;;2,0;;;;;;;;;1,0;;;;;1,0;;;;1,0;;;;;;;1,0;;;;;;;5,0;3,0;;;;;;;;;;;;1,0;6,0;;;1,0;;;;;2,0;4,0;;4,0;;;8,0;;1,0;;3,0;;;;;;;;;;;1,0;;2,0;1,0;83,0;6,0;;;;;;;;;;;1,0;1,0;;;;;;;;;;;;;;;;;1,0;;1,0;;;1,0;4,0;;;6,0;1,0;;;;;;;;1,0;;;2,0;2,0;2,0;;;11,0;;1,0;;;;;;;;;;;;;;;2,0;2,0;;;;;;;3,0;;;;;;;;;;;;;;;1,0;27,0;;;;3,0;;;;;;6,0;;;;;;;;;1,0;1,0;8,0;;;;;;;1,0;;;;;;;;;;;;;1,0;;;;;;;;;;9,0;;;;;;;;;;;;;9,0;;14,0;;;;;;;;;;;;;;;;;;9,0;;;;;3,0;;;;;;;1,0;;8,0;;5,0;;5,0;;;2,0;4,0;;;;;;;;;1,0;3,0;;3,0;;2,0;;;;;25,0;;;9,0;;;;;1,0;;;;;;8,0;;6,0;;;;;;;;;;2,0;;6,0;;1,0;;;;;4,0;;1,0;;;;8,0;;;;;;;;;;;;;;;2,0;;;;;;;6,0;;;;;;;;1,0;;;;;;;2,0;;;13,0;;2,0;1,0;;;2,0;;;;;;;;;;;;;;;;;;;;;;;3,0;;;;;21,0;;;13,0;;;;;;;;1,0;;8,0;;54,0;;;14,0;;;;;;1,0;;30,0;;;4,0;;;;;4,0;;;;;;
extension;;;;5,0;7,0;42,0;1,0;13,0;;;41,0;2,0;16,0;31,0;;;2,0;;3,0;;;;;;2,0;;;8,0;;;21,0;;;;;1,0;33,0;5,0;;;5,0;30,0;4,0;2,0;1,0;37,0;;25,0;;;;1,0;102,0;6,0;;;26,0;;;2,0;;;8,0;;11,0;;43,0;;;9,0;4,0;45,0;2,0;;;;3,0;;;;15,0;;;;84,0;;;9,0;;;;6,0;2,0;3,0;;;10,0;7,0;7,0;45,0;28,0;1,0;;;;;;;;;1,0;;6,0;;11,0;;;11,0;;1,0;;;1,0;;;2,0;9,0;;;5,0;;;;33,0;;;3,0;2,0;;;;6,0;;;14,0;;3,0;10,0;;29,0;2,0;;34,0;7,0;;1,0;;;;;14,0;38,0;;;;;17,0;7,0;2,0;;;;;24,0;;;13,0;;1,0;;;5,0;5,0;5,0;;1,0;4,0;;6,0;2,0;;;;;7,0;37,0;31,0;;10,0;12,0;;;1,0;;;;54,0;1,0;6,0;39,0;4,0;11,0;;;1,0;20,0;6,0;3,0;;1,0;;;;;14,0;10,0;163,0;;;;11,0;3,0;;;15,0;;;;;1,0;1,0;27,0;;2,0;20,0;1,0;3,0;3,0;19,0;6,0;3,0;3,0;;13,0;5,0;;17,0;39,0;;;;;;;27,0;;;;;1,0;;20,0;1,0;6,0;9,0;;2,0;8,0;2,0;;2,0;;29,0;31,0;;;4,0;2,0;29,0;;25,0;4,0;;;;38,0;12,0;;7,0;13,0;6,0;;6,0;;;18,0;7,0;;2,0;;5,0;2,0;4,0;;8,0;;5,0;2,0;1,0;2,0;14,0;7,0;5,0;;;3,0;;3,0;8,0;1,0;13,0;12,0;2,0;5,0;;;3,0;;;;5,0;5,0;;;4,0;8,0;8,0;8,0;;23,0;2,0;2,0;;;1,0;81,0;;3,0;;;;;;2,0;;1,0;;;;1,0;;;;5,0;;;;;;;17,0;7,0;;2,0;4,0;12,0;;;;;1,0;;;;3,0;1,0;;;;;;;4,0;;;2,0;;6,0;4,0;16,0;;17,0;;9,0;2,0;1,0;;;;;;1,0;;;;5,0;1,0;;;;;;;;;;;;10,0;;;13,0;;1,0;;;;;12,0;;;7,0;;;4,0;;;;;2,0;;1,0;;;;;;;;;;;;14,0;1,0;7,0;;;;1,0;;;1,0;;;4,0;;4,0;;4,0;;;;;;;;;;;;;;;;23,0;;;;;;;6,0;;;;1,0;1,0;;3,0;2,0;3,0;;5,0;;;;;;;8,0;;3,0;1,0;32,0;3,0;;;2,0;;;;;11,0;;;;;4,0;;1,0;5,0;;;;;;27,0;;;;;;;;;;;;;;7,0;;7,0;3,0;;;;3,0;1,0;;;3,0;5,0;;2,0;1,0;;;;4,0;;;;;;;;;;;;;11,0;;;1,0;59,0;2,0;;;;;;;7,0;;;;;;;;;;;;;;;;;;2,0;;;;2,0;4,0;;;1,0;1,0;1,0;;;;;5,0;;;;1,0;3,0;;;;;;;;1,0;;;1,0;;;;;;4,0;;;;;;;;3,0;;;;;;;11,0;;;7,0;;;8,0;;;1,0;16,0;3,0;2,0;;1,0;;;;4,0;13,0;3,0;;;1,0;;;3,0;2,0;;;;;6,0;1,0;;;;1,0;;;5,0;6,0;;;;;;;2,0;20,0;;5,0;4,0;1,0;1,0;;;2,0;4,0;;;;;;;;2,0;;;;2,0;;;;;;9,0;1,0;7,0;8,0;;;;7,0;;;5,0;2,0;1,0;;;;;9,0;;;;1,0;;;;;;;;;;;;;;;;;;;;;;;;;;;;;;;;;;;;;;;;;;2,0;;;;;;;;;;;;2,0;2,0;;;;4,0;;;;;;;;;;;;;;;;;;;;;;;;;;;;1,0;;;;;;;1,0;;;;4,0;;;;;;;;;;;;1,0;;;;;1,0;;;;;;;;1,0;;;;;;;;13,0;;;5,0;;;;2,0;;;;;;;;2,0;;;2,0;;;;;;;;;;;;;;;;;2,0;;;;;;;;;;;;;;;;;;;44,0;;;;;5,0;;;;;;;;;;;;;;;;;;;5,0;;;;;;;;
extract;;;;1,0;17,0;27,0;4,0;;4,0;31,0;;;;133,0;5,0;;106,0;3,0;9,0;20,0;;;81,0;;;;1,0;12,0;16,0;2,0;85,0;23,0;5,0;4,0;;273,0;;;51,0;2,0;87,0;59,0;;15,0;27,0;;4,0;5,0;1,0;;9,0;;;;6,0;;1,0;;8,0;50,0;;2,0;7,0;;712,0;1,0;78,0;;2,0;;2,0;12,0;27,0;;;;1,0;4,0;33,0;9,0;119,0;;3,0;25,0;31,0;2,0;1,0;18,0;;21,0;34,0;;1,0;4,0;8,0;3,0;78,0;7,0;143,0;151,0;63,0;33,0;;11,0;29,0;51,0;2,0;39,0;1,0;;;33,0;30,0;3,0;;2,0;1,0;6,0;25,0;41,0;20,0;;168,0;25,0;;56,0;44,0;;1,0;;24,0;2,0;;62,0;1,0;;14,0;21,0;;;;4,0;;2,0;;7,0;35,0;1,0;29,0;;;11,0;27,0;;4,0;1,0;;;;;;;64,0;5,0;;9,0;;1,0;;11,0;;;2,0;11,0;;16,0;3,0;;;;7,0;;;34,0;;1,0;27,0;;112,0;;7,0;33,0;;;;;;3,0;;4,0;;;;5,0;13,0;8,0;;;;;5,0;21,0;;;;;17,0;;;21,0;35,0;;23,0;;;;80,0;;;6,0;;;11,0;6,0;;8,0;;3,0;;2,0;;1,0;;;;31,0;6,0;6,0;5,0;1,0;;;;11,0;;;;6,0;;;;6,0;3,0;21,0;;1,0;;3,0;2,0;2,0;;;;3,0;;;;6,0;;;;;10,0;;18,0;;4,0;3,0;15,0;2,0;;9,0;;;1,0;;23,0;;;;;;;8,0;;;;;;9,0;;;;;1,0;;18,0;;3,0;1,0;9,0;184,0;;14,0;;;;;;2,0;;;;;3,0;;;;;;;;;;;2,0;24,0;1,0;;;;;4,0;;16,0;;;;98,0;2,0;10,0;6,0;;2,0;;;10,0;;;3,0;;;12,0;8,0;8,0;2,0;9,0;2,0;19,0;5,0;17,0;24,0;;15,0;5,0;31,0;;6,0;;9,0;;3,0;;5,0;1,0;5,0;;11,0;6,0;16,0;2,0;32,0;;5,0;3,0;32,0;7,0;3,0;30,0;;;36,0;9,0;1,0;15,0;5,0;3,0;;;1,0;;1,0;;;5,0;15,0;4,0;4,0;4,0;1,0;2,0;;8,0;5,0;1,0;;1,0;39,0;1,0;;;10,0;4,0;;2,0;4,0;;;35,0;;;;;;2,0;;;23,0;;3,0;12,0;;7,0;8,0;;9,0;2,0;;;;;3,0;10,0;5,0;;1,0;;;3,0;3,0;;;1,0;6,0;2,0;5,0;44,0;;;7,0;;;6,0;9,0;1,0;;5,0;;;1,0;13,0;4,0;;4,0;26,0;4,0;3,0;;;3,0;32,0;;;;2,0;10,0;;1,0;;;;;3,0;3,0;;2,0;;;;;;6,0;;6,0;4,0;;7,0;1,0;2,0;42,0;21,0;;;3,0;;3,0;;;;6,0;;;13,0;8,0;6,0;2,0;;;;4,0;;;;;4,0;;12,0;;;1,0;5,0;;2,0;;;3,0;;3,0;;2,0;;;8,0;;;;;6,0;;16,0;;8,0;;;1,0;;1,0;;4,0;3,0;1,0;1,0;;490,0;2,0;18,0;2,0;;;;7,0;3,0;11,0;2,0;;;2,0;4,0;7,0;;;;6,0;63,0;;;;2,0;;16,0;;1,0;;7,0;;;;;;2,0;;8,0;2,0;;;2,0;;;9,0;;;1,0;;;5,0;2,0;2,0;;24,0;4,0;;5,0;5,0;;5,0;;;;;;14,0;;1,0;;;2,0;;1,0;45,0;;;;;;;;2,0;;;;1,0;;;;1,0;;;;;;;3,0;1,0;1,0;;;;;;4,0;;1,0;;2,0;;;;1,0;;13,0;;;;;;;;;;4,0;;;3,0;1,0;14,0;;1,0;;;;4,0;;3,0;;;1,0;;;;3,0;;;;;3,0;;15,0;;;;;;;;2,0;1,0;;;;;;;3,0;;;;;;;;9,0;;;;;;;2,0;;;;;9,0;;;;2,0;1,0;;;;;3,0;17,0;;;;;7,0;;;4,0;;;;12,0;;;11,0;;;;1,0;;;6,0;3,0;1,0;;;4,0;;6,0;;13,0;6,0;;3,0;;;;;;17,0;;;;;2,0;10,0;;2,0;;13,0;;5,0;7,0;10,0;1,0;7,0;1,0;;;2,0;;2,0;;;;;1,0;3,0;;;9,0;2,0;;;1,0;;;1,0;;;;8,0;;;6,0;;2,0;3,0;;1,0;;2,0;;;;;;1,0;;6,0;29,0;;;5,0;;;;16,0;;;;;;;;;;;;;;11,0;;;;;;;;;1,0;;;;;;;;5,0;;;;;;;;;;;;;2,0;28,0;;;19,0;;6,0;;;;;27,0;3,0;;;1,0;;;26,0;9,0;;3,0;;1,0;;;1,0;3,0;2,0;1,0;5,0;;;3,0;;4,0;1,0;;;1,0;;;;;
fastener;;;;1,0;;4,0;;108,0;;;;;;151,0;;;;;10,0;;;;;;2,0;;;;;;127,0;;1,0;;;;5,0;69,0;;;;15,0;1,0;;1,0;6,0;;72,0;;;;;74,0;3,0;;1,0;12,0;51,0;;1,0;;;1,0;;3,0;4,0;118,0;;1,0;;6,0;33,0;2,0;;;;11,0;1,0;;;22,0;;;;42,0;9,0;;;2,0;3,0;;2,0;9,0;;;;;;39,0;4,0;25,0;;;;1,0;;;;;;;;1,0;;;;;9,0;;18,0;;;;;;;20,0;;;;;;;7,0;;6,0;;1,0;;1,0;1,0;2,0;;;33,0;;;2,0;8,0;40,0;;28,0;25,0;6,0;;;;;;;13,0;15,0;;;;;102,0;13,0;1,0;;;;;15,0;2,0;;;;;;;;1,0;3,0;;;;1,0;1,0;18,0;;3,0;;34,0;3,0;56,0;37,0;;;4,0;;;;;;;32,0;;;135,0;3,0;38,0;;;13,0;3,0;;1,0;;;;;;;57,0;;111,0;;1,0;;6,0;;19,0;;41,0;;;;15,0;;;;24,0;2,0;6,0;1,0;1,0;4,0;23,0;3,0;22,0;2,0;;780,0;2,0;1,0;23,0;55,0;4,0;;;;;4,0;14,0;;;;;4,0;;;;14,0;9,0;;6,0;9,0;;;4,0;;17,0;26,0;;;15,0;9,0;16,0;4,0;;3,0;;1,0;;2,0;;;1,0;19,0;78,0;4,0;2,0;;;;;19,0;;4,0;;1,0;;;22,0;3,0;1,0;10,0;4,0;3,0;;1,0;8,0;1,0;2,0;;;1,0;1,0;1,0;2,0;;15,0;6,0;1,0;;;;2,0;;22,0;12,0;1,0;96,0;3,0;76,0;6,0;5,0;;6,0;;32,0;;;19,0;6,0;;3,0;;;;;;;;6,0;;1,0;;;3,0;;;1,0;4,0;;;;;;1,0;;;;;;;;;;;;;;;;;;;;;;;1,0;1,0;;;;44,0;;;;;;;1,0;;;;;;;9,0;;;111,0;;;;1,0;;;;;;;;;;;;;;3,0;;;;4,0;1,0;;;;;8,0;;;;;1,0;;;1,0;;;;;;;;;;;;;;37,0;;;;;5,0;;;;;;1,0;1,0;;;;;;;1,0;;;;;;;;;;;;;1,0;;;;;33,0;;;1,0;;2,0;1,0;;3,0;3,0;;3,0;;;2,0;1,0;;;;;3,0;;;;;9,0;;14,0;;;;62,0;;;;;;;;6,0;;;;;;3,0;10,0;;18,0;;1,0;;;;;;2,0;;;;;1,0;;1,0;;;;;;;2,0;1,0;;;3,0;;;;;;;;;;;;;;;;;1,0;;;2,0;;;;;;;1,0;;;;;;;;;;;;;;;;;9,0;;7,0;;1,0;;;;2,0;;;;5,0;;;;;;;6,0;;;;;;8,0;;3,0;;;;;;;;;;;5,0;;1,0;;;;;;;;;;;1,0;;;;;;;5,0;1,0;;35,0;;;;5,0;;3,0;;;;;;;;7,0;6,0;2,0;;;;1,0;4,0;;;;;3,0;;;;;;;;;2,0;;;;2,0;;;;7,0;;;3,0;;;;9,0;;67,0;2,0;;;;;;;;;;;;;;;;;;;1,0;8,0;;;;;2,0;;2,0;1,0;;;;;;6,0;;;;;;3,0;;2,0;;;;;;;;;;;;;;;;;;;;;;;;;;;;;;;;;;;;;;2,0;;;;;;;;;;;4,0;;;;;;4,0;;;;;;;;;;;;;;;;;;;;;;;;;8,0;;;;;;;;;;;;;;;;;;;;;;;;;7,0;;;;;;;1,0;;;;;;;;;;4,0;;;;;;;;16,0;;;;;;;;;;;;;;;25,0;5,0;;;;;;;3,0;;;;3,0;;;;;;;;;;;;;;;;;78,0;;;;;;;;;;;;;;;;;;;;;;;;;;;;;;;;;;;;;;;
feed;;;;1,0;;7,0;4,0;;;;;1,0;7,0;19,0;;;51,0;;1,0;;;;45,0;3,0;5,0;;;6,0;7,0;5,0;32,0;7,0;;3,0;;131,0;1,0;1,0;;1,0;16,0;160,0;;13,0;173,0;9,0;;1,0;;3,0;4,0;;2,0;12,0;1,0;;1,0;;;34,0;;;;;138,0;;61,0;;;;;10,0;8,0;;;;;;97,0;2,0;60,0;;2,0;4,0;11,0;;;2,0;;;2,0;6,0;3,0;;1,0;3,0;1,0;2,0;70,0;55,0;32,0;3,0;;4,0;10,0;8,0;;4,0;;;;4,0;3,0;3,0;;4,0;3,0;1,0;10,0;17,0;;1,0;14,0;;;4,0;47,0;;;;21,0;;;8,0;;;64,0;7,0;;;;;;;1,0;1,0;5,0;2,0;7,0;4,0;1,0;;1,0;;9,0;4,0;;;;;4,0;21,0;6,0;;;;18,0;;;7,0;;;;6,0;;3,0;;1,0;4,0;;1,0;;;1,0;;2,0;7,0;;86,0;4,0;;;;;2,0;;13,0;;2,0;;;;;;;5,0;7,0;2,0;;4,0;;;;;2,0;2,0;57,0;;2,0;2,0;2,0;1,0;;;;;8,0;4,0;;2,0;;;1,0;;;;;;;6,0;;;;;;7,0;;;28,0;;2,0;3,0;;;2,0;4,0;;7,0;;;1,0;42,0;;8,0;2,0;1,0;;;;;;7,0;;1,0;;;;;;2,0;;;3,0;;;;;;10,0;;20,0;;;;;;16,0;;;;;;1,0;;;;;6,0;;8,0;;;;;7,0;;2,0;;;4,0;20,0;27,0;2,0;;1,0;2,0;;;27,0;;;;;;3,0;;;;;;;;;;3,0;;1,0;2,0;1,0;;;;;;4,0;;13,0;5,0;243,0;15,0;;;;;;;6,0;;;;;;;;10,0;;;2,0;1,0;;6,0;;;1,0;;5,0;1,0;;;13,0;;2,0;2,0;4,0;;;;19,0;6,0;;;22,0;;3,0;;14,0;11,0;29,0;;;;1,0;3,0;2,0;2,0;8,0;;;;;;4,0;;;6,0;40,0;27,0;10,0;1,0;;;;7,0;;5,0;;2,0;18,0;4,0;;;;1,0;;;7,0;;;14,0;;;8,0;;;;11,0;;;;;3,0;;;9,0;;;;;;;13,0;5,0;4,0;20,0;;;;;;1,0;;;;1,0;1,0;;8,0;2,0;;1,0;;;;;1,0;;6,0;1,0;1,0;;;7,0;;;;;;1,0;;;14,0;;3,0;;;;;1,0;;;2,0;17,0;;1,0;;;;;;;;4,0;;1,0;;;;;;;;;;4,0;3,0;;;;;13,0;;;;6,0;8,0;7,0;;1,0;;;;1,0;1,0;1,0;;;7,0;;3,0;;;;;;2,0;;;1,0;;32,0;;;;3,0;;;;42,0;;14,0;7,0;;;4,0;;;;;8,0;;;;;;;2,0;;3,0;;;;;;;;;;;;;3,0;;;;;2,0;;;30,0;127,0;;2,0;1,0;5,0;;;;;;;;;;;;6,0;;;;;;3,0;;;;;;2,0;;;;12,0;16,0;;;;9,0;;;;9,0;;;2,0;;9,0;;;3,0;;;1,0;;1,0;1,0;;;;;;;1,0;;1,0;;5,0;;;;;;;;;;;;;;;;;;;;2,0;;;;;;;;;4,0;;;;;6,0;5,0;3,0;;;;7,0;;;1,0;;1,0;;;;;;;8,0;;;;;;;;;1,0;;;;;;;;;;;;;;1,0;1,0;;;;;;;;;;;;;;;;;;;;;;;;;;;;;;;;;;;;;;;10,0;;;1,0;;;;3,0;;;;;22,0;;;3,0;;;;;;;;;;;;;;;;;1,0;;;;;;1,0;;;;;;3,0;;;;1,0;;;;1,0;;;;;;;;;;;;;;;7,0;;1,0;;;;;;;;;;;;;;;;;2,0;;;;;;;;;;;;21,0;;1,0;;;;;;;;;;;1,0;;;;;;;1,0;;;;;;;;;;;;2,0;;;;;;;;2,0;;;;;;;;;;;;;;;;;;;;;;;;;;;;;;;;2,0;;;;;;;;;;;;;;;;;;;
feedback;;;;14,0;15,0;15,0;1,0;;;;;;;24,0;;;11,0;2,0;;;;;1,0;;;;;18,0;3,0;;27,0;19,0;;;;8,0;;6,0;4,0;;38,0;93,0;;7,0;9,0;;8,0;11,0;;;;;;;1,0;;2,0;;6,0;65,0;2,0;;3,0;1,0;39,0;3,0;29,0;;;;;19,0;9,0;;1,0;;;;;;41,0;;3,0;;18,0;2,0;;4,0;;;1,0;;;;1,0;;;;7,0;1,0;17,0;4,0;;5,0;4,0;13,0;6,0;2,0;;;;6,0;1,0;1,0;;;;;4,0;16,0;;;75,0;3,0;;1,0;18,0;;;;11,0;;;21,0;;;3,0;2,0;;;;;1,0;3,0;;26,0;4,0;2,0;8,0;2,0;2,0;10,0;3,0;;3,0;;;;;;;10,0;;;1,0;;6,0;6,0;;10,0;3,0;;;3,0;;;1,0;3,0;6,0;;;;;;;6,0;2,0;;1,0;;;;;2,0;;;2,0;;;;;;;;;1,0;;;;2,0;7,0;1,0;;;;;24,0;;;;;;;;;;7,0;1,0;;2,0;;;9,0;;;2,0;;10,0;;;;;;;;;;;;;;;;;;;1,0;;;;2,0;;3,0;3,0;;;;;;;;;6,0;18,0;;;8,0;;;;;2,0;1,0;;;;;;2,0;;;;;;;;13,0;;;;;;;2,0;;;;;;;;;;1,0;;;;;;13,0;;20,0;;;;;;;1,0;;;;;;2,0;;;;;;1,0;2,0;;;;;;;;;4,0;;;;;;4,0;;6,0;2,0;1,0;;1,0;4,0;;5,0;2,0;;;;;;1,0;;;2,0;1,0;4,0;2,0;;58,0;;;;;9,0;;1,0;;4,0;;3,0;;5,0;;1,0;;5,0;34,0;1,0;;6,0;;4,0;;2,0;1,0;4,0;5,0;2,0;;1,0;;13,0;2,0;13,0;;;;;;;5,0;;1,0;28,0;12,0;21,0;5,0;;7,0;;3,0;2,0;;;;;10,0;;;7,0;7,0;1,0;;2,0;;;72,0;;;41,0;5,0;1,0;;;2,0;2,0;;9,0;3,0;3,0;;;;;;;;;6,0;1,0;;;;;8,0;;;1,0;;;;;;;6,0;8,0;4,0;;;;;;5,0;;1,0;2,0;;2,0;;1,0;;2,0;;;;;;;11,0;1,0;;;;2,0;;3,0;;;3,0;;;;1,0;;1,0;;;;;;;7,0;;;;;2,0;;5,0;;;1,0;;3,0;;;;1,0;;;;;;5,0;;;;;;;;;;;31,0;;;;;;;;;1,0;;4,0;;;;;;;;;;;;;;6,0;;;;;2,0;;1,0;;;;;7,0;;7,0;;;1,0;;;1,0;;;3,0;;;;;;;1,0;;2,0;;;;;;1,0;12,0;;;3,0;;;;;;;2,0;;;;;;;;2,0;;;2,0;;;;1,0;;;4,0;;;1,0;1,0;;;;;;;;2,0;;;;;;;;6,0;;;1,0;;;;;1,0;;;;;;;;;2,0;2,0;;;;3,0;;2,0;3,0;4,0;;;;;;;;;;;2,0;;6,0;;;1,0;;;;;;1,0;;;1,0;;;;;2,0;1,0;;;;;1,0;;;;;1,0;;12,0;;;;;;;;;;;;;;;;;;3,0;;;;;1,0;;;;;;;;;;;;;;;;6,0;;;;4,0;;;6,0;;;;;;;;;;3,0;;;;;;;;;;;;;;;;;;;;;;;;;;;;;2,0;;1,0;;;;;;;;;;;;;;1,0;;;;;;;1,0;;;;;;2,0;;;;;;;;;3,0;;;;;;;;;;1,0;;;;;;1,0;;;;;1,0;;2,0;;;;;;;;;;;;;;;;;;;;;;;;;;;;;;;;;1,0;;;;;;;;;;;;;;;;3,0;;;;;;;;;;1,0;;;;;;;;;1,0;;;;;;;;;;;;;4,0;;;;;;7,0;;;;;;;2,0;;;;;;;;;;;;
film;;;;1,0;13,0;17,0;6,0;6,0;;;;;;33,0;3,0;;25,0;;1,0;;11,0;1,0;22,0;2,0;;;2,0;2,0;;2,0;28,0;5,0;;12,0;5,0;6,0;2,0;2,0;2,0;1,0;24,0;54,0;3,0;1,0;9,0;75,0;;21,0;;;;;19,0;2,0;15,0;6,0;342,0;;1,0;;3,0;1,0;4,0;;73,0;1,0;158,0;;;;1,0;78,0;138,0;8,0;;;100,0;;;4,0;98,0;8,0;2,0;;85,0;6,0;;25,0;4,0;2,0;;5,0;1,0;7,0;1,0;;42,0;8,0;72,0;9,0;78,0;3,0;;13,0;7,0;1,0;;2,0;8,0;;;;99,0;17,0;5,0;;;;;119,0;;1,0;12,0;;1,0;4,0;27,0;;;55,0;9,0;;2,0;25,0;2,0;;17,0;2,0;2,0;5,0;;3,0;;;5,0;27,0;51,0;92,0;3,0;16,0;;15,0;6,0;2,0;;13,0;;20,0;8,0;19,0;92,0;36,0;;22,0;27,0;;6,0;120,0;;4,0;1,0;;;13,0;;3,0;6,0;8,0;;;;;28,0;40,0;;;39,0;;45,0;6,0;;;12,0;;;44,0;30,0;17,0;3,0;;355,0;118,0;;;1,0;;56,0;27,0;;4,0;4,0;5,0;3,0;;2,0;10,0;4,0;1,0;;3,0;116,0;6,0;4,0;92,0;;34,0;121,0;8,0;;6,0;1,0;1,0;11,0;2,0;;;9,0;121,0;;;10,0;12,0;;;;;2,0;11,0;43,0;;;13,0;7,0;28,0;86,0;2,0;7,0;148,0;;;;11,0;9,0;2,0;5,0;3,0;7,0;4,0;1,0;24,0;;11,0;9,0;;;;;6,0;6,0;2,0;;1,0;2,0;5,0;;;13,0;1,0;11,0;;;2,0;;;7,0;;17,0;14,0;;;;;6,0;;;1,0;;;9,0;17,0;;;3,0;;;;8,0;;1,0;;2,0;2,0;29,0;20,0;1,0;2,0;;;3,0;;;;;2,0;8,0;1,0;;;;;5,0;;;;;1,0;;6,0;;;;;;115,0;4,0;;;52,0;24,0;;;;;5,0;;;2,0;1,0;;;;;3,0;6,0;16,0;1,0;;1,0;;;14,0;;;;4,0;8,0;;;;1,0;;;1,0;3,0;;11,0;;;;;;1,0;;7,0;;8,0;;;2,0;;;24,0;;;2,0;5,0;;;;;;;1,0;;;21,0;;;;109,0;15,0;;;;;;;5,0;;1,0;4,0;1,0;;;;;;;7,0;;;26,0;1,0;1,0;9,0;;;;;1,0;;;;;;;;;6,0;;;;;;;;;;;;;5,0;;1,0;6,0;;6,0;;3,0;;;;;;;4,0;7,0;;;1,0;;;6,0;1,0;;2,0;;;;;;;9,0;;;;2,0;1,0;15,0;3,0;2,0;;;;;;;;1,0;;;;;12,0;1,0;;2,0;;2,0;;;;;63,0;;3,0;;;;;;;;;;;1,0;;;;1,0;1,0;;;6,0;;;;;;;;;11,0;4,0;5,0;;;;;2,0;;;1,0;;;;;;;;;;;1,0;;;5,0;;;;;2,0;1,0;2,0;;;;;16,0;;;;2,0;;;;;;3,0;;;;;;;;;;;;;;;;;;;;1,0;;;;1,0;;;;16,0;;;;;;;;13,0;;;1,0;;2,0;;1,0;;3,0;93,0;;;;;20,0;;;;;;;1,0;31,0;;;;;;;4,0;1,0;12,0;;;1,0;;;;;89,0;3,0;;8,0;;6,0;4,0;;1,0;;;;;;;;;6,0;;;2,0;;;;1,0;;;1,0;;;;;;;;;;;13,0;4,0;;;;8,0;6,0;2,0;;;1,0;;;;1,0;;;;;;1,0;;4,0;;;1,0;;1,0;2,0;;;;;6,0;;;;1,0;;1,0;;;;7,0;;7,0;;;4,0;;;78,0;;;1,0;2,0;2,0;;;;;;12,0;57,0;;;3,0;;;50,0;2,0;;;2,0;;;;;;;4,0;;;33,0;;;;;;;;;;2,0;9,0;;2,0;;73,0;;;;;;4,0;7,0;;2,0;;;;1,0;;;;;;5,0;;;1,0;3,0;;;;3,0;;;;;;;;;3,0;;2,0;;;3,0;;;;;;;;1,0;;;;;;;;;;;7,0;;;12,0;;;;;;;;;;;;1,0;;4,0;;;;;;;;;1,0;;;;;;;;;;1,0;;;;;;1,0;;2,0;;40,0;;;;4,0;;;;;;16,0;;;;;;;;;;;1,0;;;;;4,0;7,0;;;;;;;;;9,0;;;;;2,0;;;;;;;;;2,0;;1,0;2,0;;;;;;;;;
flexible;;;;5,0;;24,0;17,0;54,0;;;;3,0;3,0;77,0;;;1,0;;1,0;;2,0;;;;;3,0;;17,0;;;56,0;;;;;2,0;9,0;;;1,0;2,0;67,0;2,0;5,0;17,0;71,0;;34,0;;;;;15,0;2,0;;;39,0;;;;;;1,0;;52,0;3,0;84,0;;;6,0;;64,0;16,0;1,0;;;75,0;;;;22,0;6,0;;;78,0;4,0;;16,0;5,0;;;12,0;5,0;9,0;;;1,0;4,0;62,0;10,0;36,0;3,0;;;;6,0;;;;;;2,0;6,0;1,0;2,0;;;9,0;;63,0;;;11,0;;;3,0;74,0;;6,0;;;;1,0;29,0;;;5,0;3,0;;;2,0;24,0;;;7,0;3,0;1,0;8,0;;28,0;8,0;5,0;17,0;7,0;;;;;;2,0;39,0;109,0;;;;;91,0;15,0;;1,0;2,0;;;35,0;1,0;2,0;;2,0;;;;1,0;1,0;15,0;2,0;6,0;8,0;2,0;27,0;10,0;1,0;;1,0;11,0;3,0;8,0;47,0;;5,0;2,0;;29,0;3,0;3,0;;;97,0;7,0;7,0;116,0;8,0;4,0;;;;19,0;;6,0;2,0;;1,0;;;1,0;39,0;;205,0;1,0;;;16,0;;;;2,0;;;;1,0;;4,0;5,0;;;12,0;2,0;19,0;8,0;104,0;3,0;10,0;12,0;5,0;36,0;222,0;8,0;34,0;88,0;9,0;;1,0;2,0;;2,0;16,0;;1,0;;;3,0;3,0;28,0;14,0;5,0;8,0;;10,0;3,0;2,0;1,0;6,0;1,0;13,0;246,0;;;28,0;2,0;325,0;2,0;8,0;6,0;1,0;1,0;6,0;7,0;4,0;4,0;13,0;4,0;2,0;1,0;;;;2,0;1,0;4,0;;7,0;;4,0;4,0;2,0;;5,0;14,0;18,0;2,0;1,0;3,0;3,0;40,0;6,0;5,0;;;4,0;10,0;177,0;;3,0;14,0;4,0;8,0;5,0;2,0;3,0;;;;;;;;40,0;6,0;7,0;;9,0;;6,0;;13,0;35,0;3,0;;13,0;12,0;;;;;;1,0;3,0;;1,0;;;;;2,0;;;;;;;;2,0;;;5,0;1,0;4,0;;;;1,0;;;;2,0;;;4,0;;;;5,0;;2,0;;6,0;1,0;;1,0;;2,0;;8,0;;2,0;;7,0;;;;;;;;;;5,0;;1,0;;;3,0;;;;;;;;;;1,0;2,0;;;;;;;8,0;;;;;19,0;;1,0;;2,0;1,0;2,0;;;;;;;;;;;;;;5,0;;12,0;;;;4,0;1,0;;2,0;5,0;;;2,0;;2,0;;;;;1,0;2,0;1,0;24,0;;;7,0;;;1,0;3,0;;;;1,0;3,0;;;;1,0;;;9,0;1,0;11,0;;2,0;28,0;55,0;;11,0;;;5,0;1,0;3,0;;;;1,0;20,0;1,0;1,0;1,0;;1,0;;;;;29,0;;;;2,0;2,0;;;;;;;;;;1,0;;;;;5,0;;;;;;;;;;6,0;1,0;1,0;;1,0;1,0;;;;;43,0;1,0;8,0;5,0;;;1,0;;;;;;;;;1,0;3,0;;;;1,0;1,0;;;3,0;;;4,0;;;4,0;;2,0;;;;5,0;;;;;;;;;;;39,0;;;;;;;2,0;4,0;;;;;;;;;1,0;;2,0;;;;;;1,0;;;;;;;;;;1,0;;;1,0;;2,0;;3,0;;;;;;;;;;;;2,0;4,0;;;5,0;;;4,0;;;4,0;58,0;;6,0;1,0;5,0;2,0;;;;7,0;34,0;1,0;;;;;;9,0;;3,0;;;3,0;;;;;8,0;;;4,0;1,0;12,0;2,0;;3,0;;1,0;;5,0;;50,0;2,0;;4,0;;2,0;;;;;5,0;;1,0;;1,0;1,0;8,0;;3,0;;;1,0;;9,0;6,0;19,0;1,0;;;;1,0;;;7,0;;2,0;;1,0;7,0;;76,0;;14,0;5,0;;;;;8,0;;;2,0;;;;;;;;;;;;;;;7,0;;3,0;;;;;;;;;;;;;;;;;;;;;;1,0;;;;;;;;;;;4,0;;;2,0;4,0;;;;;;;;;3,0;;1,0;;;;;;;5,0;;;1,0;;;;;1,0;;;;;;;;;;;;;1,0;;;;;;;;;2,0;;5,0;;;;;;;;;;1,0;;;;3,0;19,0;;;;;;;;8,0;;9,0;;;;;;;;;;;1,0;;;;;1,0;1,0;;;;9,0;;;5,0;;;;;9,0;;;2,0;;;;;1,0;;;;;;;2,0;;;5,0;;;;;;;;;1,0;;;;;;;;;;;;1,0;;;;;;;;;;;;1,0;;;
float;;;;2,0;;21,0;4,0;;;;;;;64,0;2,0;;3,0;2,0;16,0;;;;;;2,0;;;;;;38,0;;;;;;6,0;;;1,0;3,0;30,0;1,0;;;10,0;;96,0;;1,0;;;2,0;;;;13,0;1,0;;11,0;5,0;;18,0;;98,0;;58,0;1,0;;1,0;2,0;10,0;5,0;3,0;;;2,0;;;;12,0;;3,0;2,0;1,0;1,0;;26,0;;;;2,0;;;;;83,0;6,0;46,0;2,0;15,0;11,0;;1,0;1,0;;;;;;;30,0;179,0;;;;;5,0;;3,0;;;53,0;;;2,0;4,0;;1,0;;3,0;;;34,0;;;2,0;;;;;3,0;;;;9,0;;8,0;1,0;11,0;;4,0;3,0;11,0;;23,0;;;;;;40,0;;;64,0;;40,0;;;2,0;;;;34,0;;;4,0;;;;;;;6,0;;;3,0;6,0;;1,0;;2,0;;2,0;;2,0;9,0;2,0;;;;4,0;;;4,0;;8,0;;;42,0;7,0;;;;;;18,0;;;;;5,0;;117,0;;;62,0;;;;26,0;;;;;;;;1,0;;;14,0;;;;2,0;7,0;6,0;33,0;19,0;;;;10,0;10,0;6,0;3,0;37,0;7,0;;77,0;3,0;1,0;;;9,0;;;8,0;;;11,0;;1,0;;;3,0;3,0;;1,0;;;1,0;;;;6,0;;1,0;;4,0;5,0;;;;1,0;1,0;;3,0;;;1,0;3,0;;2,0;4,0;;;;30,0;;;;13,0;;;20,0;3,0;;;;2,0;6,0;;;;5,0;;9,0;;1,0;;;2,0;;;1,0;1,0;;;;;;;6,0;1,0;5,0;9,0;;;;;;2,0;2,0;;8,0;2,0;2,0;;;;;25,0;;;;;;2,0;;;;7,0;;;;;;;1,0;4,0;1,0;;;6,0;;;;;;;;;;4,0;;;2,0;8,0;;;;5,0;;10,0;3,0;;;8,0;;;;;2,0;3,0;6,0;;;;;;;10,0;;5,0;;;;;;;;;;;16,0;;2,0;;;3,0;;;;;;;;;;12,0;;;2,0;;3,0;;;2,0;;;;;;;;;;;;;;;;;;;;;;;;;;;3,0;;;;;;;;;;;;;3,0;;;;;;6,0;;;;;;;;;;;;;;;2,0;2,0;;;;;;;;;;;2,0;6,0;;;;;3,0;;;;;2,0;;;;;;;;;;;;6,0;;;;;;;;1,0;;;;;;;;;;;;;;;;1,0;;;;;;2,0;;;;;;;;;;;;;;1,0;;;;1,0;;;;;;25,0;;;2,0;;;;;;;;;;;;;;;;;;;;;;;;;;;;;;;;19,0;;;;;;3,0;;4,0;1,0;;;;;5,0;1,0;;;;44,0;9,0;;;;;;3,0;;;;;;;;;;;;;;;;;;;;;;;;;17,0;;;;;;4,0;;2,0;3,0;;;3,0;;;;;;;4,0;;;;;2,0;;;;;;;;;;;;;;;2,0;;;;2,0;;;;;;;;;;;;;;;;;;;1,0;;;;;;;;;;;;;;;;;;;;;;1,0;1,0;;;;;;;1,0;2,0;;30,0;1,0;;2,0;;1,0;63,0;;;437,0;2,0;4,0;2,0;1,0;;;5,0;;;2,0;40,0;;;3,0;48,0;;5,0;1,0;;;1,0;;;;1,0;1,0;;;;;7,0;134,0;;;;;;;;;;;;;;;;;;;;;;;;;;;;;;;;;;;;;;;;;;;;;;;1,0;;;;;;;;;;;;;;;;;;;;2,0;;;2,0;;;;;;;;;;;;;;;;;;1,0;;;;;;;;5,0;;;;;;1,0;;;;;;;;4,0;;;;;;;;;;3,0;;;2,0;;;;;;;;;;;;;;;;;;;;;;;;;;;;;;;;;;;;;;;;;;4,0;;;
flow;;;;2,0;4,0;15,0;6,0;1,0;;;;;2,0;59,0;;;9,0;3,0;48,0;;;;;;;;;4,0;2,0;;46,0;12,0;3,0;2,0;;25,0;20,0;;20,0;;58,0;64,0;;4,0;;10,0;1,0;18,0;;;9,0;1,0;3,0;3,0;44,0;;14,0;;;72,0;;;1,0;;95,0;;36,0;6,0;;;4,0;41,0;19,0;3,0;;10,0;4,0;6,0;;6,0;56,0;;11,0;12,0;28,0;;2,0;237,0;2,0;;9,0;1,0;4,0;;8,0;;11,0;1,0;44,0;61,0;11,0;5,0;;2,0;2,0;18,0;1,0;4,0;;1,0;;3,0;4,0;4,0;1,0;;2,0;19,0;2,0;15,0;5,0;;5,0;4,0;;1,0;46,0;;;;2,0;;1,0;9,0;;;7,0;;;;1,0;3,0;;;8,0;3,0;2,0;12,0;8,0;;7,0;1,0;6,0;1,0;;;;;;;1,0;28,0;;;6,0;;5,0;7,0;;1,0;2,0;;40,0;34,0;;13,0;11,0;4,0;4,0;;6,0;;;1,0;;;2,0;3,0;46,0;2,0;;;44,0;2,0;12,0;;18,0;;2,0;;1,0;;;7,0;10,0;2,0;2,0;1,0;;4,0;;8,0;9,0;;;3,0;7,0;;;20,0;2,0;1,0;;1,0;2,0;;22,0;1,0;7,0;7,0;;;4,0;2,0;1,0;;1,0;5,0;;2,0;;;;;;;9,0;;8,0;;4,0;;1,0;;;17,0;;30,0;1,0;;;1,0;;20,0;2,0;89,0;;;4,0;16,0;4,0;2,0;11,0;;;;6,0;;;;;;2,0;5,0;;;1,0;2,0;9,0;;56,0;;1,0;;;;6,0;2,0;;;;;;;;4,0;;;4,0;1,0;;;4,0;1,0;;;9,0;;;;;18,0;8,0;;4,0;;;;14,0;1,0;;;;;;;;;5,0;;;2,0;;;2,0;;4,0;8,0;;1,0;;;;;5,0;1,0;2,0;1,0;46,0;;;;;;2,0;1,0;22,0;;;;;;24,0;;11,0;;;1,0;2,0;2,0;32,0;6,0;;2,0;;16,0;1,0;4,0;;;4,0;5,0;8,0;;8,0;13,0;;11,0;;;;8,0;;;;22,0;3,0;7,0;46,0;5,0;;4,0;;;4,0;;;;;11,0;;2,0;;2,0;;33,0;1,0;5,0;4,0;;1,0;;7,0;2,0;5,0;;4,0;;2,0;;7,0;1,0;7,0;;4,0;2,0;7,0;2,0;2,0;9,0;;13,0;10,0;;;;3,0;1,0;;1,0;25,0;;4,0;6,0;;;11,0;1,0;2,0;;;;7,0;;4,0;;;;;;1,0;;3,0;;22,0;2,0;4,0;;;1,0;;2,0;;;;;;;;;;10,0;;;47,0;1,0;29,0;;;3,0;;;;;;;7,0;1,0;;1,0;;;1,0;;;;;;43,0;;;;;5,0;;;;;2,0;13,0;;11,0;;19,0;;;;;27,0;;1,0;;;1,0;;1,0;1,0;6,0;;;;5,0;1,0;;2,0;;;1,0;;;;5,0;;4,0;;;2,0;4,0;;;;;;;2,0;;;;1,0;6,0;;;;1,0;;;1,0;4,0;;;;;;8,0;;;;2,0;;;4,0;;;5,0;;;1,0;;;15,0;;;;1,0;;;;;;;;2,0;;;;;;6,0;;;;1,0;;;;2,0;;;;2,0;;;;;2,0;10,0;;;5,0;;;1,0;;;;;;;;;16,0;;;;;2,0;;;3,0;;;;;3,0;;1,0;3,0;;;;2,0;;;;10,0;6,0;;1,0;;;;;;2,0;12,0;;;1,0;;;;;;;;;;;;;;;1,0;;1,0;;;;;;;;;;4,0;;;;4,0;;;;;;;;;;18,0;;2,0;;1,0;;;;;2,0;;;;;;;;;;1,0;;;;;;;;;;;;;;;;;4,0;;;;1,0;;;;1,0;;;;1,0;;;;22,0;;;;;1,0;;1,0;;;2,0;;;;;1,0;;;;;;4,0;2,0;;;;;;;;;;20,0;;;;;;;;;;;3,0;;;;;1,0;1,0;5,0;;;1,0;5,0;;4,0;;;2,0;;;2,0;;;4,0;;;;;;2,0;;;4,0;11,0;;1,0;;;;2,0;;;;;1,0;1,0;2,0;;;;2,0;;;;;;;;;;;;;;;;;;;;;;;;;;;;;;;;;3,0;5,0;;;;;;;;;;;;;2,0;;;1,0;;;;27,0;;;;;4,0;3,0;;;;;;;;;;;2,0;;;;;;;;;;;1,0;;;12,0;;;;5,0;;;;;;;;;;;;2,0;;;;;;
fluid;;;;5,0;36,0;7,0;;29,0;;;;;2,0;14,0;;;;1,0;78,0;;;;;;73,0;;;91,0;;1,0;113,0;11,0;;;;2,0;4,0;1,0;;;2,0;22,0;;1,0;;17,0;;36,0;;;;12,0;8,0;;2,0;3,0;30,0;;;10,0;;;;;11,0;;25,0;8,0;;;8,0;59,0;11,0;6,0;;;7,0;;;;13,0;;;;19,0;4,0;;22,0;;2,0;;;8,0;1,0;;;1,0;;39,0;;15,0;4,0;;;;2,0;;;3,0;;;;4,0;;;;;18,0;;21,0;;;3,0;;;5,0;88,0;;;;8,0;;;20,0;;;11,0;;4,0;;;;;;8,0;1,0;6,0;3,0;;2,0;4,0;2,0;19,0;6,0;;1,0;;;;;1,0;33,0;;;;;22,0;9,0;1,0;;;;12,0;9,0;1,0;1,0;;3,0;;;1,0;1,0;2,0;2,0;;1,0;;;;29,0;;;2,0;3,0;1,0;16,0;52,0;;12,0;15,0;;5,0;;;5,0;1,0;8,0;;;5,0;3,0;6,0;;6,0;3,0;5,0;8,0;1,0;;17,0;;;1,0;;9,0;;35,0;6,0;15,0;;4,0;3,0;;;;;;;2,0;;;;1,0;;19,0;;;5,0;52,0;;8,0;;;5,0;9,0;31,0;9,0;15,0;;;17,0;1,0;;8,0;1,0;6,0;;;4,0;9,0;3,0;;;6,0;;;7,0;;4,0;;10,0;2,0;4,0;12,0;;;2,0;5,0;7,0;;;;2,0;7,0;;9,0;3,0;;;2,0;2,0;;3,0;43,0;;4,0;1,0;;4,0;;;1,0;1,0;;3,0;;;;2,0;12,0;;2,0;6,0;;;6,0;;;;;;10,0;;2,0;;1,0;1,0;;2,0;2,0;3,0;2,0;2,0;;;;;30,0;;5,0;;;;;;21,0;1,0;1,0;;;;;;;;1,0;;2,0;;;;1,0;;1,0;6,0;;6,0;;;;65,0;;;;;1,0;;;;;;;;;3,0;;;;;;;9,0;1,0;;;;;3,0;8,0;4,0;;;;1,0;2,0;;;;;;;;;1,0;;20,0;1,0;;1,0;;;;;1,0;5,0;;;;;;;;1,0;;;;;1,0;1,0;;;4,0;8,0;3,0;;;;;;;;1,0;;7,0;;;;;;;;;;;2,0;;;;;;4,0;;;2,0;4,0;;1,0;;;;;;;;;;;;;;;1,0;;;;;;;1,0;;;;;;;;99,0;4,0;;;3,0;;;;;;12,0;;;;;;;;;;;;2,0;;;;5,0;41,0;;;;;39,0;;;;;;1,0;;;;;;;4,0;;;;;;;;;;3,0;;1,0;4,0;;;;6,0;;;;;;2,0;17,0;;;;4,0;;;;7,0;;;;7,0;2,0;;;;;;;;;;;;4,0;;;;;;;;;;;;;;;;;;;;;;;;;;2,0;;;;;;;;;;;;;1,0;;;;;;15,0;;;;;;;;;3,0;1,0;;;1,0;;30,0;;;;;;;;3,0;;;6,0;;;;;;;23,0;8,0;;;;;2,0;13,0;;1,0;;;;2,0;1,0;;;;;2,0;;;;7,0;;;1,0;;;;;;;;;;1,0;;;;;;;;;;5,0;;;1,0;;;2,0;1,0;;;;;;;7,0;;;;;65,0;;;;4,0;;25,0;;;;;;;;;;;;;;;;;;;8,0;;;;2,0;2,0;19,0;;;;;;;;;;;;;;;;5,0;5,0;;;;;2,0;;;;;;;;;;;;;;;;;;;;;;;1,0;;;;;;;;1,0;;;;;;;;;;;;;;;4,0;;;;;;;;;;;2,0;;;;;;;1,0;;;;;;;;;14,0;;;;;;;1,0;;;;;;;;;;;;;;;;;;;;;;;;;;10,0;;;;1,0;2,0;;;;;2,0;;;;6,0;;;;;;;1,0;;;;;;;;;;;;;34,0;3,0;;;;;;;;;;;;;3,0;;;1,0;;1,0;2,0;;;;;;;;;;;;;;;;;;;;;;;;;;;;;;;;;
fold;;;;2,0;;1,0;18,0;18,0;;;;;;2,0;;;5,0;;;1,0;;;;;;5,0;2,0;;;1,0;50,0;2,0;2,0;;;;3,0;;;1,0;1,0;24,0;1,0;5,0;;3,0;;84,0;;;;;13,0;;12,0;5,0;17,0;;6,0;;;;3,0;;25,0;;40,0;4,0;;;9,0;114,0;155,0;;;;3,0;;;;25,0;;20,0;;102,0;4,0;6,0;76,0;14,0;3,0;;1,0;;1,0;;;;9,0;34,0;;81,0;4,0;19,0;6,0;;;;;;;;1,0;2,0;;;;;7,0;6,0;25,0;;;;;;;81,0;21,0;;;;4,0;;6,0;;;10,0;2,0;4,0;;;7,0;;;;;;2,0;;12,0;;5,0;8,0;1,0;;;;;;;6,0;5,0;;;;;6,0;8,0;;;5,0;;7,0;37,0;;3,0;;3,0;;;;;2,0;20,0;;2,0;1,0;1,0;11,0;6,0;;;15,0;2,0;4,0;;22,0;;10,0;;;;;;;;6,0;4,0;20,0;8,0;1,0;11,0;;;;1,0;1,0;12,0;;66,0;3,0;;;;1,0;;41,0;;;;;1,0;5,0;3,0;7,0;;2,0;;;;;4,0;;;;;;3,0;12,0;;;1,0;;6,0;8,0;;9,0;98,0;;;;;;1,0;5,0;;;;;6,0;;;7,0;;;;;6,0;;;3,0;8,0;62,0;2,0;;;1,0;4,0;4,0;;;49,0;;;6,0;;;;;2,0;;;19,0;;2,0;3,0;9,0;;24,0;2,0;2,0;;;4,0;;;3,0;;1,0;3,0;;11,0;3,0;;5,0;;;;6,0;2,0;1,0;;2,0;1,0;;;;;;1,0;1,0;7,0;2,0;;1,0;;21,0;;1,0;5,0;;;;;8,0;;3,0;8,0;;;;;;1,0;;;;;;;;;;1,0;4,0;;;;;;3,0;;;2,0;;13,0;;;;;;;;1,0;;;;;;;;2,0;;;;3,0;;1,0;1,0;1,0;;6,0;;;3,0;7,0;2,0;;;;;;;;;14,0;;;;8,0;4,0;;;;;;2,0;;3,0;;;;;9,0;;;;;3,0;;;;;2,0;;;;;;;;;;1,0;;;;;;;;;;;;;;5,0;;;1,0;;;;9,0;;;;;;;;1,0;4,0;;3,0;14,0;;;3,0;;;;;;;;;;;;;;;;;;1,0;1,0;8,0;2,0;1,0;;1,0;;;;;;;;;;6,0;2,0;;;;;;;;;11,0;;;;;;;;;;;;;;;;;;;;;;;;;;;;3,0;;1,0;12,0;6,0;;;;;;;;6,0;;;2,0;;;;;;;;;;;3,0;;;;;;1,0;;;1,0;;;;;;;;;4,0;;;;;;;;;;;;;;;;;;;2,0;;;;5,0;;;;10,0;;;29,0;;;;;;;;;;;;;;;;;;;;;;;;;2,0;;;;;;;;8,0;;;;;;;;;;4,0;5,0;;;;;;3,0;;;3,0;;;;;;;1,0;;;;;;;2,0;;;;;;;;;;;;;;;;;;1,0;;;;9,0;;;;;;;;;;8,0;;1,0;;1,0;;;;;;;;;;2,0;;9,0;;;;;;11,0;;;;;;1,0;8,0;;;;;;;;;;;;;;1,0;;;;;;;;;;;;;;;;;;;;;;;;4,0;;;;;;;;;;;;;;;;;;;;;;;;;;;;;;;;;;;;;;;;;;;;;;7,0;;;;;;;;;;;6,0;;;;;;;;;;;;;;;;1,0;;5,0;;;10,0;;;;;;;;;;;;;;;;;;;;;;;;;;;;;;;;;;;;;2,0;;;;;;;7,0;;;;;;;;;;;;;;3,0;2,0;;;;;;;;;;;;1,0;;;;;;;;;;;;;;;;;;;3,0;;;;;;;;;;;;;;;;1,0;;;;
forward;;;;1,0;;17,0;3,0;16,0;;1,0;3,0;4,0;8,0;33,0;;;33,0;;28,0;;;;2,0;;21,0;;6,0;3,0;2,0;2,0;43,0;18,0;11,0;2,0;;64,0;9,0;13,0;2,0;;29,0;59,0;;8,0;6,0;40,0;7,0;12,0;1,0;;;;38,0;8,0;69,0;;4,0;;;6,0;1,0;;3,0;;168,0;;22,0;1,0;;1,0;2,0;146,0;9,0;;;2,0;;9,0;;;27,0;;35,0;22,0;64,0;1,0;;38,0;1,0;;3,0;;1,0;8,0;6,0;;3,0;8,0;38,0;6,0;49,0;;3,0;22,0;11,0;25,0;;;;;;8,0;4,0;;;;;;21,0;41,0;;1,0;51,0;;;9,0;65,0;;;;12,0;2,0;;9,0;;5,0;113,0;;;;;4,0;;;;12,0;7,0;1,0;8,0;5,0;7,0;3,0;10,0;6,0;;;2,0;;;2,0;;6,0;5,0;;2,0;;15,0;6,0;2,0;17,0;6,0;;5,0;170,0;2,0;1,0;;3,0;4,0;6,0;4,0;48,0;;109,0;;;7,0;4,0;28,0;49,0;1,0;1,0;12,0;2,0;2,0;;27,0;1,0;3,0;;;1,0;1,0;;6,0;2,0;3,0;;5,0;8,0;22,0;26,0;2,0;;;3,0;26,0;3,0;;15,0;3,0;5,0;;;4,0;;48,0;;4,0;4,0;15,0;;2,0;1,0;58,0;7,0;2,0;5,0;;;;5,0;;;;9,0;;1,0;54,0;3,0;;;;4,0;10,0;13,0;5,0;31,0;;;11,0;3,0;;186,0;4,0;1,0;;;3,0;12,0;12,0;;9,0;2,0;;;1,0;4,0;1,0;2,0;1,0;1,0;33,0;8,0;3,0;;1,0;1,0;7,0;;10,0;4,0;;;;;23,0;27,0;4,0;1,0;;;;8,0;;;3,0;5,0;;10,0;1,0;1,0;;;12,0;;13,0;;2,0;6,0;;26,0;15,0;15,0;;;;;4,0;;18,0;;3,0;;4,0;;;;4,0;;3,0;1,0;;2,0;2,0;1,0;1,0;8,0;;2,0;;;5,0;;8,0;;3,0;1,0;60,0;1,0;;2,0;;2,0;5,0;;10,0;;;5,0;1,0;1,0;4,0;3,0;2,0;;;4,0;;2,0;25,0;1,0;;3,0;;23,0;2,0;;;;;1,0;1,0;;;;;1,0;5,0;3,0;;5,0;1,0;;10,0;22,0;;;29,0;6,0;;10,0;;17,0;1,0;3,0;;1,0;;3,0;;;;;;25,0;;3,0;1,0;1,0;;;;;6,0;1,0;1,0;1,0;;1,0;;3,0;3,0;8,0;5,0;;3,0;9,0;22,0;;;1,0;;3,0;;2,0;;3,0;1,0;1,0;;1,0;;6,0;;9,0;;;;;;2,0;4,0;6,0;;1,0;2,0;8,0;;;3,0;;2,0;3,0;1,0;1,0;1,0;5,0;3,0;;;;;2,0;6,0;2,0;;1,0;;1,0;;9,0;;;3,0;1,0;16,0;;1,0;3,0;;;7,0;;;;2,0;3,0;;;;;;1,0;;;;1,0;3,0;;7,0;;;2,0;2,0;3,0;1,0;;;;2,0;1,0;;5,0;;;;;3,0;;52,0;;2,0;;2,0;;;;;;;1,0;1,0;1,0;;;;2,0;1,0;;;;2,0;;7,0;;4,0;;1,0;;3,0;;;;;3,0;;;;;1,0;;;;;;;;10,0;;;;;10,0;;1,0;;;;4,0;;1,0;;1,0;3,0;2,0;1,0;2,0;;2,0;;;;;5,0;;;;;;;;;;4,0;12,0;;;;;;;1,0;2,0;;;;;;;;;;4,0;;;;;;;;;;;;;;;1,0;3,0;6,0;;4,0;1,0;;;2,0;;3,0;;;;;5,0;;2,0;1,0;;;;;7,0;;;;13,0;;1,0;;;2,0;;;12,0;24,0;;;8,0;;;;;;;;7,0;;;;;;;;3,0;3,0;5,0;1,0;;;;2,0;;1,0;2,0;38,0;;;8,0;2,0;;1,0;;1,0;1,0;;;;;;1,0;;5,0;;;;;;;;;3,0;;;;;;;;;;;;4,0;;;1,0;;;;;;;1,0;13,0;1,0;;1,0;1,0;;;1,0;;3,0;;;;1,0;;;;2,0;;;2,0;;;;;1,0;;;;;2,0;;13,0;;2,0;;;;;6,0;;3,0;;;;;;;8,0;;;;;;;;;;1,0;4,0;;;;;;;6,0;;;;;1,0;4,0;;1,0;;;;;;2,0;2,0;;;4,0;;;;4,0;;1,0;3,0;1,0;;;2,0;;4,0;;2,0;;;;;;;;;;7,0;;1,0;;;9,0;2,0;;6,0;;;1,0;6,0;;;;6,0;;;;;;;;;;;;;4,0;;;;11,0;;;1,0;;;;1,0;43,0;;2,0;;;;44,0;;;;;;;;;;;;1,0;;4,0;;;;;;;;;3,0;;;;;;;2,0;2,0;2,0;4,0;;;;;;;;;;;1,0;;;;;1,0;;;;;;;;;;;
friction;;;;2,0;;5,0;2,0;17,0;;;;;2,0;21,0;;;;;;1,0;;;;;;;;19,0;;3,0;15,0;3,0;;;;7,0;1,0;21,0;1,0;;6,0;6,0;1,0;;2,0;4,0;;16,0;;;29,0;;10,0;;;;1,0;18,0;;7,0;;;;;2,0;;10,0;2,0;;1,0;;23,0;;;;;8,0;;;;21,0;;;;25,0;1,0;;1,0;;1,0;;;1,0;3,0;;;;;1,0;2,0;3,0;1,0;;;;;;;;;3,0;;5,0;;;;;;;;;;3,0;;;;12,0;;;;;;;;;;;;1,0;;;;2,0;;2,0;;5,0;;21,0;2,0;;;3,0;;;;;1,0;;;1,0;1,0;;;;1,0;1,0;1,0;;1,0;;;;5,0;;6,0;2,0;;;;;;;;25,0;;;37,0;1,0;;;;;;;6,0;;;2,0;;;5,0;;;;;6,0;;;24,0;13,0;11,0;;;;1,0;3,0;;;;;;;;6,0;;8,0;;;22,0;4,0;;2,0;;3,0;;;;;;;1,0;3,0;1,0;;;;2,0;;20,0;1,0;1,0;;22,0;;;;32,0;;;;4,0;;11,0;1,0;;;;;2,0;;1,0;11,0;;;;8,0;2,0;;1,0;;;3,0;;;9,0;;;;;4,0;;;;;1,0;;1,0;3,0;1,0;;;;;;1,0;;;3,0;;;;11,0;1,0;;;;1,0;;2,0;2,0;;;;;;;;1,0;;;;2,0;;;;8,0;;;;10,0;5,0;3,0;6,0;4,0;1,0;;;;;;1,0;1,0;;14,0;;;;;;;;;;;;1,0;;;;;5,0;7,0;;;;;;2,0;;1,0;;3,0;;;1,0;1,0;;;;2,0;;;1,0;;;;;;2,0;2,0;;1,0;;;;1,0;1,0;6,0;3,0;9,0;6,0;;;1,0;;;;;;;;;;;3,0;;;;;;;;;;;;;2,0;;;;5,0;;;;;7,0;1,0;;;;;;2,0;;;;1,0;;;;;;;;19,0;;;;;;;;1,0;;;;;;9,0;;;;1,0;;3,0;;;;;;;;;;;;;;;;;;;;;;;6,0;;3,0;;;4,0;;;2,0;;2,0;;;;;;;;;;;15,0;;;5,0;;;;;;;;;;;;;;;;;;1,0;;;;;;;2,0;;;;;;;;2,0;;;;;1,0;;;;;;3,0;;;;;;5,0;;2,0;;;;1,0;;;;;;;;;;;1,0;;;;;;1,0;;;;;;;;;;;;;;;;;;;;;;;;;;;;;;;;;;;;6,0;2,0;;;;;;;;;;;;;;;;;;;;;4,0;;;10,0;2,0;;;;;;;;;;;;;1,0;;;;;;;;;6,0;;;;;4,0;;;;;;1,0;;6,0;2,0;1,0;2,0;;;;;;;;2,0;;;;;;;1,0;;;;;1,0;;;;;;;;5,0;;;7,0;;;;1,0;;7,0;;;;;;;;;;;;4,0;2,0;;;;2,0;;;;;;;;;;;;;;;;;;;;;;;;;;;4,0;;;;;;;;;;1,0;;;;;;;;;;;;;;;;;;;;;;;;;;;;;;;;;;;;;;182,0;;;;;;;;;;;;;;;;;1,0;;1,0;;;;;;;;;;;;;;;;;16,0;;;1,0;;;1,0;;;49,0;;;;;;;;;2,0;;5,0;;;;;;;;;;;;;;;;;;;;;;;;;3,0;;;1,0;;;;;;;;;4,0;2,0;;;;;;;;;;;;;;2,0;;;;;;;;;;;;;;;;;6,0;;;;;;;;;;;;1,0;;;;;;;;;;;;;;;;;;;;;;;;;;;
fundus;;;;2,0;;4,0;6,0;;;;;;;;;;12,0;;2,0;;;;2,0;;;;;;;;5,0;1,0;5,0;;;6,0;1,0;;;;;12,0;;5,0;2,0;3,0;2,0;;;;;;2,0;;14,0;1,0;1,0;;;1,0;;;6,0;;94,0;1,0;9,0;;;;;35,0;30,0;;;;;;;;13,0;;22,0;;32,0;;;18,0;;;3,0;5,0;;;6,0;;;2,0;23,0;1,0;1,0;;2,0;;3,0;;;;;;;;;;;;;;;10,0;;;;;;;19,0;;;;1,0;;;11,0;;;3,0;;;;;;;;3,0;;1,0;3,0;1,0;;;;;;;;;;;;;;;7,0;;;4,0;;;;4,0;;1,0;;;1,0;;2,0;4,0;;;;;4,0;;;;;;;;;;;;;5,0;;;;;;;;;;;;1,0;;;;;;;;;;;2,0;;;;;;;2,0;;;;;;;;;;12,0;2,0;;;;;;;;1,0;;;12,0;;;;;5,0;;;;5,0;;;;2,0;;;;;;;;;;;;4,0;;;;2,0;;;;;;;;;;;;1,0;;;;5,0;;4,0;;;;;;;;;;;;;;9,0;;;;;;;1,0;;;;6,0;4,0;;5,0;;;;;;;;1,0;;;1,0;1,0;;;;;;;;;;;;;;;;;;;;;;;;;;;;;;4,0;;;;;;;;;;;;;;;6,0;;;;;;;;;;;;;1,0;;;;;;;;;;;;;;;;;;;;;;;;;;;;;;;;1,0;;;;;3,0;;;;;;1,0;11,0;7,0;;;;;;3,0;;;;;;;;;;;;;;;;;;;;;;;;;;;;;;;;5,0;;;;;1,0;;;1,0;;10,0;;6,0;;;;;1,0;;1,0;1,0;;1,0;;5,0;;1,0;;;;;;;;;;;;;;;2,0;;;;2,0;;;;;;;;;;;;;;;;;;;;;1,0;;;;;;;;;;;;;1,0;;;;;;;;;;;;;;;;;;;;2,0;;;;;;;13,0;;3,0;;;;;;;;;;;;;3,0;;;;;;;;;;;;;;;;;;;;;;;;;4,0;;;;;;;;;;;;;;;;;;;;;;;;;;;;;;;;1,0;;;;;;;;;;;;;;;;5,0;;;;20,0;;;;;;;;;;;;;;;;;;;;;;;;;;;;;;;4,0;;;;;;;;;;9,0;;;;;;;;;;;;;2,0;;;;;1,0;;;;3,0;1,0;;;;;;;;;;;;;;;1,0;1,0;4,0;;;;;;;;;;;;;4,0;;;;;;;;;;;;;;;;1,0;;;;;;;;;;;;;;;;;;;;;;;;;;;;;;;;;;;;;;;;;;;;;;;;;;;;;;;;;;;;;;;;;;;;;;;;1,0;;;;;5,0;;;;;12,0;;;;;;;;;;;;;;;;;;;;;;;;;;;;;;;;;2,0;;;;;;;;2,0;;;;;;;;;;;;;;;;;;;;;;;;;;;;;;;;;;;;;;;;;;;;;;2,0;;;;;;;;;;;;;;;;;;;;;;;;;;;;;;;;;;;;;;;;;;;;;;
gain;;;;111,0;7,0;10,0;19,0;2,0;;;;;;52,0;113,0;50,0;8,0;3,0;13,0;4,0;;;66,0;;;8,0;11,0;3,0;2,0;4,0;42,0;13,0;5,0;61,0;;29,0;2,0;;1,0;;63,0;19,0;;34,0;4,0;;2,0;1,0;2,0;24,0;8,0;;1,0;8,0;2,0;4,0;5,0;;1,0;17,0;;117,0;14,0;;230,0;1,0;24,0;23,0;;;;6,0;49,0;;3,0;;;1,0;25,0;4,0;53,0;;18,0;;12,0;1,0;3,0;13,0;;3,0;36,0;;;;;;96,0;5,0;31,0;7,0;15,0;2,0;;4,0;7,0;10,0;2,0;;;;;34,0;7,0;;;;;16,0;1,0;47,0;;1,0;92,0;;;3,0;34,0;;4,0;;69,0;;;8,0;8,0;;4,0;;;;;;;;9,0;29,0;;;27,0;;;8,0;;;;;;;;;;5,0;;;6,0;;9,0;4,0;6,0;1,0;2,0;2,0;;2,0;;1,0;;;;;;;;7,0;;;28,0;;18,0;1,0;;;;;;;;;;;;;;;1,0;5,0;;;4,0;3,0;12,0;3,0;44,0;;;;54,0;;;5,0;2,0;1,0;;;;;5,0;;;7,0;;2,0;4,0;26,0;1,0;;;;;;;;;;;26,0;;4,0;2,0;;;;;;;;;;;;;10,0;;;;;;1,0;;;;;5,0;1,0;;;;6,0;;;;;12,0;;6,0;;;;68,0;;;;;;;;1,0;3,0;;;;;;;;;;;;10,0;;;;;;;;;1,0;;6,0;6,0;;1,0;;;;;;;;;;1,0;4,0;;;;;;;;;;;;;;;;2,0;;;;;;1,0;;36,0;;;;;;;12,0;;;;29,0;;;30,0;;18,0;;2,0;;;1,0;133,0;1,0;;6,0;;3,0;2,0;;;;;5,0;;;;8,0;;2,0;6,0;;;3,0;1,0;79,0;8,0;1,0;7,0;;7,0;4,0;;3,0;;5,0;24,0;4,0;;;;;;21,0;;6,0;7,0;6,0;1,0;1,0;;;4,0;;64,0;;;;2,0;;3,0;;1,0;6,0;9,0;;1,0;2,0;;;1,0;;;3,0;8,0;4,0;;;;2,0;;10,0;2,0;17,0;;;;;;;1,0;;;;1,0;;;;30,0;;;;;;;2,0;;;17,0;;;4,0;14,0;;;;;;;;;;;5,0;;;6,0;5,0;3,0;;;;;2,0;;;;;;;;;;;;;;;;;;;;;;15,0;3,0;;27,0;;;1,0;;2,0;;;;;;;;;;;;;;2,0;1,0;;;;;;54,0;;;3,0;;;5,0;;;;;;;;1,0;;;3,0;30,0;;;;;;;;;1,0;;;;;;;;;;;;;;9,0;;;;19,0;;;;;;;;;;;;;;;12,0;4,0;;;;;;;;;;;;;;;;2,0;;;;;;;;;;;1,0;;4,0;;3,0;;1,0;;8,0;;;;;;6,0;;;;;;22,0;;;4,0;;;;2,0;2,0;;;;;;;;;;;;;;;;;;;2,0;;;2,0;7,0;3,0;16,0;;;;;;75,0;;;;;;2,0;;;;14,0;;16,0;;;;;;;14,0;1,0;;;;;4,0;;2,0;;29,0;;3,0;;;;;16,0;1,0;;;11,0;;;;;;;11,0;;;;2,0;;;;;;;;;;2,0;;;;;;;;;;;;;;;10,0;;;;6,0;50,0;47,0;11,0;;;;;;;;;;;111,0;;;;4,0;1,0;2,0;;;;1,0;6,0;;4,0;;;;1,0;;;;;;;;13,0;;;;;;;;;;;;;;;;;;;;;;;19,0;;2,0;;;;;6,0;3,0;;;;;;;;;;;;;1,0;;1,0;;;2,0;;;;1,0;;;;;;;;;3,0;;;;;;;;;;;;;;;;;1,0;2,0;;;;2,0;26,0;;;;;;;;;12,0;;;;3,0;2,0;;;;;;;;6,0;;;;;;21,0;;;;;;;;;;;;;;;;;;1,0;;3,0;1,0;;;;;;;;;;;1,0;;;2,0;;;;;;;;;1,0;;;;;;;;;;;;;;
game;;;;1,0;2,0;6,0;;;;;;;;2,0;;;2,0;;;1,0;;;;;;;;1,0;1,0;;1,0;6,0;;;;22,0;1,0;;;;4,0;19,0;;3,0;32,0;2,0;;2,0;;1,0;;;;;2,0;;;;;3,0;;;;1,0;29,0;;20,0;;;;;;8,0;;;;;9,0;;4,0;30,0;;8,0;;4,0;;;;;;2,0;;;;4,0;7,0;;;6,0;1,0;3,0;;;;1,0;8,0;;2,0;;;;;;;;;;;15,0;13,0;;;2,0;3,0;;7,0;23,0;;;;3,0;;2,0;1,0;;;4,0;15,0;;;;;;;1,0;1,0;8,0;5,0;16,0;;;;;;;;;;;;;4,0;4,0;5,0;;;3,0;6,0;;13,0;;;2,0;;;;;1,0;2,0;;;;;4,0;;12,0;;;1,0;2,0;;;;;;;5,0;;;3,0;;;1,0;;16,0;;;;;3,0;;4,0;;;;;5,0;;;;3,0;;;;;;11,0;;;;;;;;;;;;;;;;;;;8,0;;;;;;;;4,0;;;;2,0;;;;;;1,0;;;;;;;;;;;;;;1,0;;;;;;2,0;;;;;;;;;;;;;12,0;;;;;;;;;;;;;3,0;;;;;;;;;;;3,0;2,0;;;;;;;1,0;;;;;;1,0;;;;;;;;;;;;;4,0;;;;;;;2,0;;;;41,0;;;;;1,0;;;8,0;;;;;;2,0;;1,0;;;;;;11,0;1,0;;;;2,0;1,0;;1,0;;;21,0;;;1,0;2,0;;2,0;;;;2,0;;;;2,0;1,0;1,0;1,0;;;;;1,0;;1,0;;;;;;;;;;2,0;;;;;;1,0;;;12,0;;;;;;;2,0;;;;;;;5,0;;;;;;17,0;;;8,0;;;6,0;;;;;;;9,0;;;;;1,0;1,0;;;;;;10,0;;;;1,0;;;3,0;;;;;;;;1,0;;5,0;4,0;;;;3,0;;;;;;;;;6,0;;1,0;;;;;1,0;;;;;;;;;;;;15,0;;;;;;;;4,0;1,0;1,0;;;;;;;8,0;;;;;;;21,0;;;;;;;;;;;;;2,0;;;;;;;;;;;;;;;;;;;;;;4,0;;;;;;;;;;1,0;;;;;2,0;;5,0;;;;;;;;;;;;;;;;;1,0;;2,0;;;;;;;;;1,0;;;;4,0;;;;;;;;;;;;;;;;;;;;;;;;;1,0;;;;;;;;1,0;;;;;;;;2,0;;;;;;;;;;;;;;;;;;1,0;;;;;;;;;;;;;;;;;1,0;;;;;;;2,0;;;;;1,0;;;;;;;;2,0;;;;;;;;;;;;;;5,0;;;;;;1,0;;;;;;;;;;;;;;;;;;;;;;;;;;;;;;;;;;;;;;;;;;;;;;;;;;;;;;;;;;;;;;;;;;;;;;;;;;;;;;;;;2,0;;;;;;;;;;;;;;;;;1,0;;;;;9,0;;3,0;;;1,0;;;;;;;;1,0;;;;;;;;;;;;;;1,0;;;;;;;;;2,0;;;;;;;;;;2,0;1,0;;;;;;;;;;;;;;;2,0;;;;2,0;;3,0;;;;;;5,0;;;;;;;;;;;;;;;;;;;;;;;;;;;;;;;;;;;;;;;;;2,0;;;;;;;;;1,0;;;;;;;;;;;;;;;;;;;
gamma;;;;8,0;;7,0;3,0;;;;2,0;;;12,0;4,0;28,0;5,0;;;;;2,0;6,0;;2,0;;4,0;16,0;1,0;2,0;5,0;5,0;;32,0;1,0;8,0;2,0;;;;13,0;10,0;14,0;;5,0;2,0;;1,0;4,0;;8,0;;;2,0;5,0;1,0;;;1,0;4,0;;5,0;;;68,0;;16,0;3,0;;;3,0;8,0;1,0;;;;4,0;5,0;;;31,0;;1,0;;;;;3,0;;;2,0;;2,0;;17,0;;2,0;;26,0;12,0;9,0;8,0;;;16,0;3,0;;1,0;;;;4,0;39,0;;;;;11,0;;67,0;4,0;;3,0;2,0;;;49,0;2,0;;6,0;6,0;10,0;;10,0;;;2,0;10,0;4,0;2,0;;6,0;;;2,0;6,0;21,0;1,0;;1,0;;;7,0;;;;;1,0;;;;18,0;;1,0;;;;;3,0;3,0;24,0;2,0;4,0;2,0;;3,0;;11,0;;;18,0;;1,0;1,0;;;;;;4,0;;;;;;2,0;21,0;;;;;;2,0;;9,0;1,0;;;;4,0;;2,0;;;;1,0;;1,0;;3,0;;;;;13,0;;1,0;;;2,0;;32,0;;4,0;;;;;;4,0;;;4,0;;;18,0;3,0;1,0;2,0;;;;;9,0;2,0;;;5,0;;;;;3,0;;;;;;5,0;1,0;;;;;;;1,0;9,0;;2,0;;;6,0;;;;;2,0;;;;;;;;;12,0;;;;;;1,0;;;;;13,0;2,0;26,0;;;;;;;14,0;;;;2,0;;;;;;;;1,0;;;;;;;;;;;;2,0;5,0;;;;6,0;;4,0;;;;;;;;;;;4,0;;;;;;;;1,0;4,0;;;;;2,0;;;3,0;4,0;;10,0;;2,0;;;2,0;;17,0;2,0;2,0;;7,0;;4,0;7,0;;1,0;1,0;;;1,0;;;;;;;1,0;;;;;;2,0;;;;;;;;;;6,0;;;;;;1,0;;;;;;;;;1,0;;;;;;8,0;;4,0;;;;;;3,0;;;;;;;5,0;;;2,0;;15,0;;;;4,0;;;;;;1,0;;9,0;;;;;;;;;5,0;1,0;;16,0;;4,0;;;;;;;;3,0;;1,0;;;;;;1,0;2,0;;;;18,0;;;;;;;;;;;;;;1,0;;;;;;;;;;;4,0;;;;;;;10,0;;;;;;;;;;;;;;;;;;;;;2,0;;;;;;;;;3,0;;;;;;;;;5,0;;;;;;;;;2,0;;;;;;;;;;;;;;16,0;;;;;;;;;;;;;;2,0;;;;;;;;;;;;;;;;;;;;1,0;;1,0;;;;;;;;;;;;;;;8,0;6,0;;;;;;;;;;;;;;;20,0;;;;;;;;30,0;;;;;1,0;;;;;;;9,0;;;;;;;;;;;;;;;;;;;7,0;;;;;;;;3,0;;5,0;;;;;;;;60,0;;;;;;2,0;;;;;1,0;;;;;;;;;;;1,0;;;;;2,0;;;;;;;;;;;;;;2,0;;5,0;;;;;;;;5,0;;2,0;;;;;;;;;;;;1,0;;;;;;;;;;;29,0;;;;;;;;;1,0;;;;;;;;;1,0;;;;;;;;;;;;;;;;;;;;;;;;;;;;;;2,0;1,0;1,0;;;;;;4,0;;;;;;;;;;;;;2,0;;;3,0;;;;2,0;;;;;;;;;;;;;4,0;;;;;;;;;;;;;1,0;;1,0;;5,0;;;;2,0;;;;;;;;;;;;;;;2,0;;;;;;;;;;;;;;;;;;;;;;;;1,0;;;;;;1,0;;;;;;;;;;;;;;;;;2,0;6,0;;;;;;;;;2,0;;;;;3,0;;;;;;;;;
gaze;;;;6,0;;1,0;;;;;;;;33,0;;;4,0;;;;;;;1,0;1,0;;;;;;20,0;1,0;;;;2,0;19,0;;;;86,0;53,0;;13,0;6,0;;;11,0;14,0;;17,0;;;3,0;;;7,0;;;15,0;;;;;90,0;;20,0;;;;;;4,0;;;;;;;;40,0;;;;;;;;;3,0;;;15,0;;;;;11,0;2,0;121,0;26,0;1,0;;;8,0;12,0;;4,0;;13,0;;;8,0;;;;1,0;;9,0;5,0;1,0;;9,0;4,0;;13,0;25,0;;;;8,0;;;12,0;;;;;;;;;;;;2,0;7,0;;63,0;;;;3,0;;;;;;;;;;;;;;;;;20,0;;3,0;14,0;128,0;;;;;;;;1,0;;20,0;;;2,0;;;1,0;;;;3,0;;;;;;;;;;;;10,0;3,0;;;;;13,0;8,0;;;;;;;;;1,0;4,0;;;;7,0;;;;;;4,0;3,0;;;;;;;;;;;;6,0;;;1,0;;;;;;;;;1,0;;;;1,0;;3,0;;;;;;;;;1,0;;;;4,0;44,0;;;;;;;;;;;11,0;;;;;;;;2,0;1,0;;;;;;;;;;9,0;;1,0;;;;;;;2,0;;;2,0;;20,0;;;;;;;;;;;;;6,0;;;;;;1,0;;;;1,0;;;;;;;;;;53,0;;;;2,0;3,0;;;1,0;4,0;;;;4,0;;;;;49,0;;24,0;;;3,0;1,0;;15,0;5,0;1,0;;;28,0;;;;;;;;;;4,0;;11,0;5,0;;;1,0;;;;9,0;;2,0;2,0;2,0;2,0;4,0;;4,0;7,0;2,0;;;;;;4,0;;;2,0;4,0;;10,0;;;;;;;1,0;;;3,0;;;;;2,0;;;3,0;;;73,0;;1,0;;;;;;;1,0;;9,0;11,0;;;;;;13,0;;;;6,0;;2,0;18,0;;;;;;2,0;;;;1,0;3,0;;3,0;;9,0;4,0;;;;;;;16,0;;;;;;;6,0;48,0;2,0;;;;;;;;;;;;;;;;;;3,0;55,0;;;;;;;;;3,0;2,0;;;;;;;;;;;;;;;;;;3,0;;;;;;;;;;;;;;8,0;6,0;;;;;;;;;;1,0;;;;;;;;;;;;;;21,0;;;;;1,0;;;;8,0;;;;;;;;;;;;;4,0;;;21,0;;;;;;;6,0;;;;;;2,0;1,0;;;;;;;;;;;;;;;;;;;1,0;;;3,0;;4,0;;;;;;;;;;;;;;;;3,0;;3,0;;;;;;10,0;;;;;;;4,0;3,0;;;;;;;;;;;2,0;;;;;;;;;;;;6,0;;;;;2,0;;;;;;;;;;;6,0;;;;;;;;;10,0;;;;4,0;;5,0;;4,0;;;;3,0;1,0;;;;;;;;;;;;;;;;;;;;;;;;;;;;;;;;;;;;;;;;;;;;;;;;;;;;;;;;;;;;;;3,0;;;;;;;;;;;;8,0;;;;;;;;;;;14,0;;2,0;4,0;;;;;;;;;;;;;;;;4,0;;;;;;;1,0;;;;;7,0;;;;;;;;;;;;;;3,0;;;;;;3,0;;;;;;;;;;23,0;;;;;;;;;;;;;;;;;;;;;3,0;;;;;;;;;;;;;;;;;;;;;;;;;;;;;;;;;;;;;;;;;;;;;;;;;;;;;11,0;5,0;;;8,0;;6,0;;;;;;;;;;;;4,0;;;;;;;;;;;;;;
generation;;;;1,0;1,0;19,0;74,0;1,0;3,0;;;2,0;;14,0;;;14,0;;;;;1,0;72,0;;3,0;1,0;1,0;4,0;3,0;1,0;65,0;;;26,0;;107,0;;1,0;7,0;;11,0;125,0;;3,0;22,0;;2,0;2,0;;1,0;;;;;5,0;;7,0;;2,0;164,0;;;;;220,0;1,0;56,0;2,0;;;;4,0;58,0;;;;3,0;;5,0;10,0;30,0;1,0;4,0;11,0;19,0;1,0;1,0;8,0;;12,0;4,0;;;2,0;1,0;;3,0;;12,0;5,0;6,0;12,0;;37,0;14,0;34,0;;3,0;;;14,0;31,0;1,0;;;1,0;2,0;2,0;2,0;6,0;2,0;;67,0;4,0;;7,0;22,0;;5,0;;12,0;;;122,0;;;7,0;24,0;;;;;;;;7,0;9,0;2,0;1,0;;1,0;;;;;;;;;;;4,0;;;1,0;;1,0;2,0;;;;;3,0;2,0;;1,0;;9,0;5,0;;;;;1,0;;;6,0;;16,0;;;;1,0;;;;;;2,0;1,0;2,0;22,0;;;;12,0;6,0;;;1,0;1,0;;1,0;;;;18,0;;;3,0;2,0;;;;;;32,0;;2,0;;;;3,0;;;;;;;;;;;;;2,0;;;1,0;;;;;4,0;4,0;16,0;;1,0;;25,0;;11,0;;7,0;1,0;4,0;29,0;2,0;;17,0;;;;1,0;;;3,0;10,0;;;;2,0;1,0;1,0;;;12,0;;40,0;;1,0;;;;;;;;;;;;4,0;4,0;;;;2,0;;6,0;;3,0;;1,0;2,0;;6,0;2,0;;;3,0;15,0;1,0;1,0;;1,0;;;56,0;;;;;;3,0;;;;;;1,0;5,0;;;;;9,0;;;;;;2,0;;3,0;6,0;;;21,0;7,0;;;;;;1,0;;5,0;;2,0;;;;2,0;4,0;;2,0;1,0;;;39,0;1,0;;;;;1,0;2,0;;6,0;;8,0;7,0;1,0;;2,0;4,0;3,0;1,0;;;5,0;;5,0;3,0;1,0;1,0;1,0;1,0;;;;;;4,0;;;1,0;;;;;4,0;;;7,0;;4,0;4,0;;1,0;2,0;3,0;3,0;;4,0;5,0;1,0;;;23,0;8,0;;;;;;;4,0;;;18,0;;;;;;4,0;3,0;1,0;8,0;;;;;;;1,0;;;;4,0;5,0;1,0;;;;;;26,0;;;;8,0;1,0;1,0;17,0;1,0;;3,0;;;;1,0;;;;1,0;2,0;;;1,0;1,0;;;2,0;;;;;7,0;;;;;11,0;;1,0;;;6,0;;;;;;;;4,0;;;;;;24,0;;;;;;2,0;;;1,0;;6,0;;1,0;6,0;;;3,0;;;5,0;;;;;;;;;;;;;;3,0;1,0;;;;;2,0;2,0;;;;;;;;1,0;;6,0;;;11,0;2,0;;;;;;;1,0;;;;;1,0;3,0;2,0;;38,0;;;;;;2,0;;;;;;;29,0;1,0;;;;3,0;;;;;;;1,0;;;5,0;;;;;;2,0;;;;;46,0;;;;28,0;;;;1,0;;;;7,0;6,0;1,0;1,0;;;1,0;;;;1,0;;;;12,0;;;;;;;;10,0;;;1,0;;;1,0;1,0;;;;;;;6,0;;2,0;;;;;1,0;;;;;2,0;2,0;;;;1,0;;;;;;;;;;;2,0;1,0;;;1,0;;;;;4,0;;1,0;;;;;;;;;3,0;;;;;;;;;;;;;;2,0;;;;;;;;;;;;;;;;;;;;;;;;;;;;;;11,0;;;;;;;1,0;5,0;6,0;;;1,0;4,0;;;;;2,0;1,0;;;;;;9,0;1,0;;;;;;;;;;;;;;;4,0;;3,0;;;;1,0;2,0;;;;;1,0;;;;;;;;1,0;;;2,0;;;;2,0;;;1,0;3,0;;;;;;1,0;;;;;1,0;;;;;;;;;;1,0;9,0;;1,0;;4,0;;;;;;;;;;;;;;;;;;;;1,0;;;;;;;;;;;;;;;;;;;;2,0;;;;3,0;;38,0;;;;;;;;;;;1,0;;;;;;7,0;1,0;;;;;;4,0;;;;;;;2,0;;;1,0;;;;1,0;;;;4,0;;;;;;1,0;1,0;;;2,0;;;;;;;;;;;;;;2,0;1,0;;;;
generator;;;;4,0;;38,0;1,0;;;;;;;2,0;;;2,0;;8,0;1,0;1,0;;;;2,0;;;2,0;;3,0;132,0;12,0;;;;31,0;;;3,0;;1,0;27,0;;1,0;2,0;2,0;;6,0;;;;;;;6,0;1,0;;;3,0;187,0;;;3,0;4,0;65,0;2,0;19,0;;;;;15,0;15,0;;;;1,0;;;10,0;8,0;1,0;;6,0;2,0;2,0;;45,0;;1,0;;;;;7,0;;;;20,0;;17,0;4,0;;1,0;2,0;13,0;;;;;;24,0;3,0;;;2,0;;3,0;;3,0;3,0;;140,0;;;7,0;22,0;;;;8,0;;;11,0;;;2,0;15,0;4,0;;;;;;;9,0;7,0;14,0;;;5,0;;1,0;;;11,0;;;;;2,0;4,0;;1,0;;;17,0;1,0;;;3,0;;;2,0;;;4,0;2,0;;5,0;1,0;;;;;;2,0;12,0;10,0;;;;2,0;;;;;;;;;1,0;;;;1,0;2,0;;1,0;1,0;;8,0;;;;;2,0;;;;13,0;2,0;;;3,0;;4,0;5,0;;5,0;;;1,0;;;2,0;;;;1,0;;;;;;;;8,0;;;;;;29,0;;6,0;19,0;4,0;;16,0;1,0;4,0;;11,0;;;16,0;;;;;;1,0;2,0;;;1,0;;;;;1,0;;;;;;;14,0;;3,0;;;;;;;3,0;;8,0;;;;;;;;;;1,0;;;1,0;;;;;;;;2,0;13,0;;6,0;;8,0;;1,0;4,0;;;;;1,0;9,0;;;;;;;1,0;;;;;;;;;;;;;2,0;;;;3,0;3,0;;;;;;3,0;1,0;;;1,0;;;;;6,0;;;;;;26,0;;;;;1,0;3,0;4,0;2,0;10,0;;4,0;3,0;4,0;1,0;;2,0;1,0;4,0;;;11,0;3,0;;;10,0;;1,0;5,0;2,0;;;;;3,0;;;;;;;1,0;;11,0;;16,0;1,0;;;;1,0;;6,0;1,0;3,0;;1,0;12,0;8,0;5,0;;9,0;1,0;;;;;;4,0;3,0;;9,0;6,0;;;3,0;1,0;5,0;;;;;2,0;1,0;2,0;;;;1,0;;2,0;;1,0;3,0;;;24,0;;;;;;7,0;;9,0;8,0;6,0;;2,0;;;;7,0;5,0;5,0;;;;;;;1,0;;;;;;;;;2,0;;;;;;;;;;3,0;3,0;1,0;;;;;;;;;;;;;;;;;;19,0;;;;;;;;1,0;1,0;;;;3,0;4,0;1,0;;;;;;;;;;;;2,0;1,0;;;;;;;;;1,0;;12,0;;;5,0;2,0;;;;1,0;;;;1,0;;;;;;;;2,0;;;;17,0;;;;;;;2,0;;;;;;;3,0;5,0;1,0;;;1,0;;;;;;;;1,0;;;6,0;;19,0;;;;;;;;;;2,0;;;;1,0;;;4,0;;;;;;1,0;;;;1,0;;28,0;;;;1,0;;16,0;1,0;3,0;;;;;3,0;5,0;;;;7,0;1,0;2,0;8,0;;;;;;;27,0;;;;;;;;3,0;;;5,0;1,0;;;;;2,0;;;;;;;;;;2,0;;;;;;;;;1,0;;;;;;3,0;;;;4,0;;;;;;;;;;;;;;;;;;;;;;;;;;;;;;;;;;4,0;;;;;;;;;;;;;;;;;;;1,0;;2,0;1,0;;2,0;2,0;;;;;;9,0;;4,0;;;17,0;;1,0;2,0;1,0;;1,0;;;;;;;;;;;2,0;2,0;1,0;;;;;;;;;;;;2,0;;;;;;;;3,0;;;;;;;;;3,0;;1,0;;;;;;;5,0;;2,0;1,0;;;;;;;;;1,0;;;;;;;;;;;;;2,0;;;;;;;;;;;3,0;;;;4,0;;;;2,0;;;;;;;3,0;;;;;;2,0;;;;;2,0;63,0;;4,0;;;;;;;2,0;;;;1,0;;;;;;1,0;;;;;;;;;;;;;;6,0;;;;;;;;;;;;;;;1,0;;3,0;;;;;;;;;;;;;;;;1,0;17,0;;;;
geometric;;;;2,0;3,0;8,0;13,0;;;2,0;;;;50,0;;2,0;19,0;3,0;;12,0;;;8,0;;;3,0;;5,0;1,0;19,0;13,0;;10,0;73,0;;53,0;4,0;;16,0;;74,0;11,0;;5,0;4,0;6,0;41,0;9,0;;3,0;17,0;;2,0;;9,0;;4,0;;;18,0;;;3,0;;248,0;;43,0;;;1,0;3,0;15,0;22,0;;1,0;;7,0;2,0;;4,0;52,0;;6,0;18,0;2,0;;;23,0;2,0;;33,0;;;;7,0;;30,0;13,0;37,0;14,0;55,0;8,0;;7,0;14,0;5,0;3,0;1,0;10,0;;;21,0;39,0;;;23,0;3,0;4,0;61,0;20,0;;;4,0;;2,0;15,0;38,0;;2,0;;5,0;;;13,0;;;13,0;7,0;;;;1,0;;;;16,0;2,0;5,0;5,0;;;;;;;;;;;3,0;;;;5,0;;1,0;;;;;9,0;;;1,0;;1,0;;;;;;;;;;;9,0;;5,0;;;25,0;;;1,0;2,0;;;;;;;;;;2,0;;;1,0;2,0;;1,0;;;;;40,0;;;2,0;14,0;;3,0;;;;12,0;;;17,0;;;;;;2,0;;;;3,0;;3,0;;;;10,0;2,0;64,0;1,0;;;;;9,0;;;;22,0;1,0;;;2,0;;11,0;;;;;;1,0;;;;3,0;;;;1,0;;3,0;;;2,0;;13,0;;;;3,0;;;29,0;;;8,0;;9,0;;;;;;;;;;;;1,0;5,0;;;;;2,0;;2,0;;;;1,0;31,0;;;;;;;;;;;;;24,0;3,0;;;;;;2,0;;;;;;5,0;;;;;;;;;;;12,0;;;;;;;;1,0;1,0;;1,0;;14,0;14,0;9,0;3,0;;;;3,0;1,0;;;;;1,0;23,0;2,0;5,0;;1,0;;1,0;11,0;;;8,0;1,0;19,0;;;;5,0;1,0;;;5,0;;;9,0;;;;;;;5,0;;;;;;;;;;10,0;;2,0;;;;;;1,0;;;1,0;;;;;;1,0;7,0;5,0;2,0;;1,0;34,0;;3,0;;;;;;2,0;55,0;;1,0;;;3,0;7,0;;6,0;;4,0;;;;;4,0;2,0;;;;;;;;;;2,0;;;27,0;14,0;;46,0;1,0;;7,0;;;;16,0;;3,0;;;;;;7,0;;;;;;;7,0;;;;;;;;;;;3,0;1,0;;;;6,0;;;;;;;1,0;;;;;18,0;;4,0;;;;;;;;;;;;2,0;1,0;;;;;;;;;4,0;10,0;;;;4,0;;;;;;1,0;29,0;;1,0;;;;;;;;;;;;;;1,0;;;;;1,0;;1,0;;;2,0;;119,0;;;;;;;;;;;;;;;;2,0;;;7,0;7,0;;;;;;;;1,0;;;;;;;;;;;;;;;;;;;;;;;40,0;;10,0;1,0;1,0;;;;;;;;;;;;18,0;;;;;;;15,0;2,0;;;;;;;;4,0;;;;;;;;;;1,0;;;;;;4,0;;;;;;;4,0;;;;;;15,0;;;;2,0;4,0;;;;;;;;;3,0;;;;10,0;18,0;;;;5,0;;;;;;;;;;;;;;;;;;;;;;;;;;;;;;;;;;36,0;;;;;;;;;;;;1,0;;;;;;;;;;;;;;;;;;;1,0;2,0;;;;;;;;;;;;;;;;1,0;8,0;1,0;;;1,0;;;;;;;3,0;;;;;;;6,0;;;;;;7,0;;;1,0;;;1,0;;1,0;9,0;;20,0;;;;2,0;10,0;;;;;3,0;;;;;;;;;;;;6,0;;;1,0;;;;;;1,0;2,0;3,0;;;;;;4,0;;;;;;;;;4,0;;;;;;;4,0;;;;;1,0;;;;;;;;1,0;;;;;;17,0;;;;;;;;;;;;;;;;;;;;;;;;;;;;;;;;;;;;;1,0;;6,0;;;5,0;;3,0;;3,0;1,0;;;;;7,0;;1,0;;;;;;;;;;;;;;;
gimbal;;;;6,0;;9,0;;6,0;;;;;25,0;14,0;;;2,0;;;;;;;;12,0;;;9,0;;;29,0;9,0;;;;;;1,0;6,0;;1,0;4,0;;1,0;;6,0;;;;;;;13,0;2,0;;;4,0;;;;;;;;2,0;;24,0;;;;;9,0;;;;;;7,0;;;7,0;;2,0;;4,0;6,0;;;;;;;2,0;;3,0;;;;6,0;8,0;15,0;;;;3,0;1,0;;;;;;;;;4,0;;;;;;;;;;;;83,0;;;;;;;21,0;;;;;;;1,0;1,0;13,0;;;;;11,0;;18,0;;2,0;15,0;;;;;;;;;14,0;;;;;19,0;;;;;;;7,0;1,0;;;;;;;;;;;;;;1,0;;;;;3,0;;;30,0;;4,0;2,0;;;;;;;37,0;;;124,0;;4,0;6,0;;;14,0;;;;;;;;;2,0;;5,0;;;;1,0;;1,0;;;;;;12,0;;;5,0;6,0;;;1,0;;1,0;;18,0;;;;1,0;;;9,0;13,0;1,0;;;;;13,0;;;;;5,0;5,0;;;1,0;;3,0;;3,0;16,0;;1,0;1,0;;14,0;;;;;;1,0;;;5,0;;2,0;;2,0;3,0;;;;;11,0;;;;;13,0;6,0;;;;1,0;;13,0;;6,0;6,0;13,0;;6,0;;4,0;;;;;;5,0;8,0;;10,0;2,0;;6,0;1,0;;2,0;;;;1,0;7,0;6,0;;5,0;14,0;;;;;5,0;;;;;;;1,0;3,0;;;;;;;2,0;;;;2,0;;;;9,0;;;;3,0;;;18,0;;;;;;;;;;;1,0;;;;;;;;;3,0;1,0;2,0;2,0;1,0;3,0;;1,0;;2,0;;;;;9,0;1,0;2,0;5,0;2,0;;;1,0;2,0;;;6,0;1,0;;;4,0;;;1,0;;;6,0;;;;;;;5,0;1,0;;;;;5,0;;;;;8,0;;;;;;;1,0;;;;;;;;;;;;5,0;15,0;;7,0;;;;;;;;;;;;;;;;;;;;;;2,0;;17,0;;;2,0;;;3,0;;;1,0;;;;;;;4,0;;;;;24,0;;6,0;;;;;;;;2,0;;1,0;;;;;;1,0;;;;;3,0;;;;;;;;;;;;;;;;;;;4,0;;;;;;;;;;;;;;;;;1,0;2,0;;;;;;;;;;;;;;;;;;;;;;;1,0;;;;;;;;;;;2,0;;;;;;1,0;;;1,0;;;;;;;1,0;;;;;;;;2,0;;;;;3,0;;;;;;;;;;;;;;;;;;;;;1,0;;;;;;3,0;;;;;;2,0;;;;;;;;;;;;;;;9,0;;;;;;2,0;1,0;;;;;10,0;1,0;;;;;;;;;;1,0;;;1,0;;;;;;;;;;;;;;;;1,0;;;;3,0;;;;;;;4,0;;;;;;;;;;;;;;;;;2,0;4,0;;10,0;;;;;3,0;;;;;;;;2,0;;;;;;;1,0;;;;;;;;;;;;;;;;;;;;2,0;;;;;;;;;;;;;;;;;;;;;;;;;;;;;;;;;;;;1,0;;;;;;;;;;;;;;1,0;;;;;;;;;;;;;;;;;;;;;;;;;;;;;;;;;;;;;;;;;;;;3,0;;;;;;;;;;;;;;;;;1,0;1,0;;;1,0;;;2,0;;;;;;;;;;;;;10,0;;;;;;;;;;;;;;;;;;;;;;;;;;;;;;;;;;;;;;;;;;;;;;;;;;;;;;;;;;;;;;;;
groove;;;;11,0;;23,0;1,0;28,0;;;14,0;;20,0;51,0;;;;;5,0;;1,0;;1,0;30,0;;;;55,0;;;94,0;1,0;;;;;43,0;;33,0;;;77,0;4,0;7,0;3,0;123,0;;36,0;;;;;60,0;4,0;2,0;;224,0;;;1,0;1,0;;;;6,0;;91,0;2,0;;27,0;22,0;104,0;13,0;;1,0;;5,0;;;;7,0;;;;141,0;20,0;;25,0;;1,0;;5,0;13,0;11,0;;;;7,0;138,0;;68,0;4,0;;;;;;;;1,0;;;3,0;;;;;13,0;;25,0;;1,0;;5,0;;;20,0;;;3,0;;;;45,0;;;2,0;;;;5,0;12,0;2,0;;;4,0;14,0;11,0;;7,0;3,0;3,0;39,0;31,0;;;17,0;1,0;;2,0;15,0;54,0;;;;;63,0;32,0;;9,0;;;;54,0;1,0;17,0;;4,0;4,0;3,0;;;6,0;18,0;;1,0;6,0;5,0;43,0;2,0;;;2,0;6,0;15,0;30,0;81,0;;53,0;64,0;;8,0;2,0;;;;136,0;7,0;;26,0;23,0;11,0;;;;57,0;;11,0;;1,0;1,0;;;;45,0;;219,0;10,0;12,0;;13,0;;;;2,0;;;;1,0;;;9,0;9,0;2,0;7,0;;7,0;48,0;51,0;72,0;10,0;5,0;;14,0;10,0;;57,0;224,0;4,0;;;1,0;;1,0;28,0;;;;1,0;1,0;1,0;10,0;2,0;6,0;6,0;;10,0;11,0;29,0;2,0;4,0;;22,0;27,0;;;1,0;13,0;26,0;12,0;30,0;;3,0;11,0;2,0;12,0;17,0;;26,0;31,0;16,0;2,0;2,0;4,0;;;;5,0;2,0;1,0;3,0;22,0;9,0;;1,0;;38,0;66,0;3,0;8,0;2,0;;11,0;1,0;;9,0;3,0;;2,0;;65,0;7,0;12,0;68,0;;;;;3,0;6,0;16,0;2,0;;5,0;4,0;14,0;8,0;42,0;;18,0;;2,0;;;;20,0;1,0;36,0;;;;;;1,0;;;;;;;14,0;;;5,0;;;4,0;;;;1,0;;;;;3,0;;2,0;;;;;;;;;;;;;;4,0;4,0;;2,0;60,0;;;;8,0;5,0;30,0;;;;3,0;;2,0;;;2,0;;;;;65,0;;;;;9,0;;;;;1,0;;;6,0;;1,0;12,0;;;;;;;;;;;1,0;1,0;36,0;;;;4,0;2,0;;;;1,0;;;;;;;;;;;5,0;;;;;;13,0;;;;;;;;;;4,0;;;1,0;;;1,0;;;;;;7,0;;;4,0;;;;;;;1,0;;;;;11,0;;;17,0;11,0;;6,0;;;13,0;;4,0;;4,0;;1,0;174,0;4,0;;;;;2,0;;1,0;10,0;23,0;;;;;1,0;;;;;;;;;;;;;3,0;;3,0;;;;7,0;2,0;;;2,0;;24,0;10,0;;;;26,0;;4,0;;;4,0;;;16,0;;;;;;;;;;;3,0;;;;;;2,0;;;;3,0;;;;;;;;13,0;;;;;;;;;;;;;;;;;;;3,0;;;2,0;2,0;;;3,0;;;;;;1,0;;2,0;;;;1,0;4,0;1,0;;;;;;;;;;;;;11,0;;;;;;;;;;;;;;;;;;;;86,0;;;6,0;;;2,0;7,0;;11,0;;3,0;;;;4,0;42,0;;13,0;11,0;;;;1,0;4,0;;2,0;;;5,0;5,0;1,0;;;;;;;9,0;2,0;;;;10,0;2,0;1,0;3,0;;;6,0;2,0;10,0;;;22,0;2,0;;;;;4,0;;;35,0;;1,0;;17,0;1,0;1,0;1,0;;18,0;3,0;;2,0;6,0;1,0;1,0;;;5,0;;8,0;7,0;;;;;;3,0;6,0;;;3,0;2,0;9,0;;;17,0;;;;;;;;;;;;;;;;;4,0;;;;;;;;;;;;;;;;4,0;;;;;;;;;2,0;;;;;;;;;;;;2,0;;;;;;;;;;;;;;;;;;;;;1,0;;;;;;;;;;1,0;;;;;;;;5,0;;;;;;;;;;;;;;;;;;;;;;;;;;;;5,0;;;;;;;;;;;9,0;;1,0;;;;;;;;;;1,0;;2,0;;;;;;;2,0;;;;;1,0;;;;;;21,0;;;;;3,0;;;;16,0;;;;;;;;;;;;;;;;;;;;;;;;;;;;;;;;;;;;;;;
height;;;;59,0;13,0;15,0;2,0;30,0;3,0;;2,0;;;109,0;;2,0;25,0;;;5,0;;3,0;15,0;;;;;15,0;24,0;6,0;17,0;;12,0;18,0;;26,0;26,0;3,0;13,0;;135,0;69,0;15,0;8,0;19,0;13,0;5,0;5,0;6,0;9,0;92,0;8,0;19,0;;17,0;23,0;22,0;;3,0;14,0;;;20,0;;379,0;1,0;64,0;4,0;;4,0;36,0;121,0;18,0;;4,0;;3,0;26,0;;1,0;83,0;2,0;2,0;;112,0;2,0;;70,0;;1,0;21,0;;3,0;1,0;6,0;;101,0;21,0;24,0;39,0;77,0;45,0;;6,0;11,0;34,0;6,0;42,0;2,0;17,0;1,0;35,0;15,0;1,0;;;1,0;19,0;;74,0;;;5,0;12,0;1,0;13,0;72,0;4,0;;27,0;7,0;5,0;;32,0;12,0;;17,0;1,0;7,0;;1,0;2,0;;;26,0;2,0;34,0;6,0;7,0;;;10,0;19,0;9,0;;;4,0;;;;;6,0;;11,0;;;6,0;2,0;;29,0;;;;39,0;1,0;11,0;1,0;;2,0;;;7,0;1,0;8,0;;9,0;10,0;1,0;2,0;5,0;2,0;2,0;1,0;1,0;8,0;3,0;15,0;17,0;14,0;;;8,0;6,0;75,0;14,0;1,0;3,0;5,0;;16,0;3,0;9,0;12,0;6,0;;7,0;2,0;11,0;19,0;10,0;12,0;;34,0;;19,0;;34,0;;;1,0;9,0;;16,0;23,0;2,0;1,0;1,0;1,0;;8,0;;6,0;;;3,0;7,0;;9,0;18,0;;;15,0;;21,0;8,0;;17,0;122,0;3,0;;1,0;;;38,0;26,0;;;;7,0;18,0;;;5,0;2,0;;;4,0;60,0;2,0;;;;30,0;4,0;2,0;;3,0;5,0;2,0;1,0;2,0;;;4,0;11,0;1,0;49,0;1,0;6,0;;3,0;2,0;;4,0;;2,0;4,0;;;33,0;2,0;1,0;2,0;;;;2,0;2,0;;13,0;8,0;87,0;6,0;11,0;1,0;;;2,0;18,0;1,0;17,0;9,0;;8,0;4,0;6,0;2,0;;;;1,0;8,0;;2,0;2,0;2,0;3,0;6,0;1,0;;;;;;7,0;4,0;;30,0;24,0;1,0;8,0;;;;;11,0;4,0;6,0;;2,0;;;39,0;2,0;2,0;3,0;;;18,0;3,0;18,0;1,0;;4,0;5,0;9,0;3,0;39,0;;2,0;89,0;;;21,0;;21,0;5,0;6,0;23,0;;;;1,0;3,0;;;1,0;1,0;2,0;2,0;;7,0;;;2,0;6,0;3,0;9,0;;;27,0;;3,0;2,0;1,0;16,0;;2,0;;15,0;1,0;;10,0;;;5,0;2,0;;;;;4,0;20,0;31,0;23,0;2,0;;8,0;12,0;3,0;;;;5,0;;;1,0;5,0;;;18,0;2,0;64,0;;;;3,0;;;;;9,0;35,0;;5,0;;;;1,0;13,0;18,0;;1,0;4,0;1,0;9,0;6,0;;1,0;;9,0;;21,0;1,0;;;6,0;;;;;;1,0;3,0;;122,0;3,0;;;5,0;;26,0;1,0;;6,0;2,0;;;;1,0;5,0;15,0;1,0;;3,0;;;;4,0;;;;5,0;;7,0;;;1,0;3,0;;4,0;5,0;14,0;4,0;;1,0;;1,0;1,0;8,0;;1,0;1,0;;;;;;;;;;;1,0;3,0;;;;;;;;;3,0;2,0;;;2,0;;;;4,0;7,0;2,0;1,0;10,0;1,0;;2,0;;1,0;;;75,0;1,0;1,0;;;;;;;;24,0;;3,0;;1,0;;6,0;;;1,0;42,0;;;1,0;;2,0;;;;1,0;;;;1,0;;;;;;;;2,0;;;;3,0;;;;1,0;4,0;;2,0;;;;;;;;;6,0;;2,0;1,0;;6,0;;;;;;;;1,0;;;14,0;;;;;1,0;;;19,0;;;;;;;;1,0;;2,0;;;3,0;;;4,0;2,0;;;;;;;17,0;3,0;1,0;;;;;8,0;;;2,0;;;;;;3,0;66,0;;2,0;;;;1,0;;;;;;;;7,0;55,0;;;1,0;3,0;6,0;;1,0;;4,0;;1,0;;;;;1,0;1,0;;;;5,0;;;;;2,0;24,0;;1,0;3,0;6,0;2,0;;;;;;6,0;;;;;;10,0;;3,0;;1,0;;;11,0;2,0;116,0;;;;;5,0;;;;;2,0;;;;;3,0;;;10,0;;;;21,0;;1,0;;;;1,0;1,0;1,0;;;3,0;;;;8,0;;;;10,0;1,0;;;;;8,0;5,0;2,0;;;;;1,0;2,0;;;;;;;;;6,0;4,0;;5,0;;;;;;2,0;;;;;;;;5,0;;;24,0;11,0;3,0;2,0;6,0;;;17,0;4,0;1,0;;;16,0;;16,0;1,0;;2,0;1,0;;2,0;;;;;;4,0;5,0;;;7,0;;2,0;2,0;;;;;;;;1,0;;;;;;;;;;;;2,0;3,0;;;;1,0;;3,0;;;2,0;;2,0;;;;4,0;;;;5,0;;2,0;5,0;;;;;;;;12,0;;;;;;;3,0;;;;5,0;1,0;;19,0;;;;;;;;;;;;;;1,0;;;;;1,0;2,0;;;;;;;;;;
histogram;;;;1,0;6,0;5,0;1,0;;;;;;;29,0;;4,0;9,0;;2,0;12,0;;;37,0;;;;;1,0;3,0;;22,0;;4,0;;;5,0;15,0;3,0;16,0;;17,0;1,0;;12,0;1,0;;;;;;3,0;;;;;;6,0;;;72,0;;;5,0;;71,0;;25,0;4,0;;;;;;;;;;5,0;;;44,0;;3,0;1,0;;;;1,0;;;7,0;;;;;;71,0;;46,0;5,0;7,0;12,0;;2,0;4,0;3,0;;1,0;12,0;;;35,0;21,0;4,0;;;1,0;16,0;8,0;;2,0;;4,0;;;26,0;27,0;;;;13,0;9,0;;4,0;;;;52,0;;;;;;;;5,0;2,0;;16,0;;;2,0;;;;;;;;;;3,0;;;;;;3,0;2,0;;1,0;;;1,0;;5,0;;;;;;;;;;;16,0;;2,0;;;;;;;23,0;;;;;;;;;2,0;4,0;;;;;;;;;;;1,0;;;;;;;;;;;;;14,0;;;18,0;;;;;;;8,0;;;;;;12,0;2,0;1,0;;;;;;;3,0;;;1,0;;;;1,0;1,0;;;;;;6,0;;;;;1,0;;;;4,0;;;;;;;5,0;;;;2,0;;;;;;;;10,0;;;;;;;1,0;;;;;10,0;;;;;;3,0;;;;;;;21,0;;;;;;;;;;;;;;;;;;;;;;;;;2,0;1,0;;;;;4,0;;12,0;;;;5,0;;;;;;;2,0;10,0;;;;;;55,0;;6,0;1,0;1,0;;14,0;5,0;2,0;1,0;;2,0;;6,0;1,0;11,0;;4,0;;1,0;;7,0;;14,0;;4,0;7,0;;;5,0;;7,0;;9,0;;;4,0;;;;14,0;;2,0;16,0;;;;;;;2,0;;2,0;1,0;;1,0;;;;;2,0;;;;6,0;2,0;;;1,0;;20,0;;;5,0;;;;;;;;;;;4,0;8,0;;6,0;4,0;;11,0;2,0;;;;;;;;;1,0;2,0;;3,0;;;3,0;;;;;1,0;;;6,0;;;;;;;;;;;;;;;;;;2,0;;;;;8,0;;7,0;;;;1,0;;;;;;;3,0;4,0;;;;;;;;;;;;;;1,0;;3,0;;2,0;;;;2,0;;;;;;;;;;;;;;2,0;;;;;2,0;;;;;;;;;;;;;1,0;;;;;;;;;;;;2,0;;;7,0;5,0;;;;20,0;;;2,0;;;21,0;;20,0;;;;;;4,0;;;;;;;;;;;3,0;;;;;;;;;;;;;;;;;;;;;;;;;;;;;;;;;;;;;12,0;;;1,0;;;;;;;;4,0;;;1,0;;17,0;;;3,0;;;;;;;;;;;;;;;;;;;4,0;;;;1,0;2,0;;;;;;;6,0;;;;;;;;;;;;;;;;4,0;;;;;;;;;;;;;;;3,0;;;;;;1,0;;;;;;;;;;;;;;;;;;;;;;;;;;;;;;;;;;;;;;1,0;;;15,0;7,0;;;;;;;;1,0;;;;;;;23,0;;;;;;;;;;;;;;;;7,0;;;;;2,0;;;;;;;;2,0;;;6,0;;;;;;;;;;;8,0;;;;;;;;2,0;;11,0;;;;4,0;;;;;;;;;;2,0;;;;5,0;;;;;;;;;;;8,0;;;;;;;1,0;;;;;;;;;;;;;;;;3,0;;;;;;;;;;;1,0;;;;;4,0;;;;;;;;;;;;;;;;;;;;;;;;;;;;;;;;;;;16,0;;;3,0;;;;8,0;;;;;;;;1,0;;10,0;;;;;;2,0;;;;;;2,0;;;;;;;;;;;
hollow;;;;2,0;;11,0;;10,0;;;;;14,0;18,0;;;;;3,0;;;;;;;;;1,0;;;30,0;;;1,0;;;16,0;;;;;5,0;;;6,0;11,0;;20,0;;;;;16,0;1,0;;;45,0;;;2,0;29,0;;;;9,0;;32,0;;;9,0;;49,0;4,0;1,0;;;7,0;;;;5,0;;;;25,0;1,0;;3,0;;;;1,0;4,0;;;;;4,0;9,0;2,0;11,0;;;;2,0;;;;;;;;11,0;;4,0;;;3,0;;14,0;;1,0;2,0;;;2,0;3,0;;;;;;;9,0;;;1,0;;;;;;;;2,0;;1,0;7,0;;7,0;1,0;;43,0;6,0;;;5,0;;;;3,0;1,0;;;;;10,0;2,0;;;;;2,0;19,0;;;;;;;;;1,0;2,0;1,0;;;;13,0;3,0;;;3,0;6,0;5,0;10,0;41,0;;;18,0;3,0;2,0;;;;;24,0;2,0;4,0;14,0;;;4,0;;3,0;1,0;;3,0;;;;;;;7,0;;72,0;;;;3,0;1,0;;;2,0;;;;;;;6,0;6,0;3,0;2,0;;1,0;25,0;12,0;;2,0;;;2,0;3,0;1,0;15,0;28,0;;;;;;1,0;20,0;2,0;;;;;;1,0;1,0;;2,0;;3,0;;;;2,0;;5,0;9,0;;;10,0;1,0;8,0;1,0;8,0;;15,0;22,0;;;;;;1,0;;;;;;2,0;11,0;3,0;1,0;5,0;;9,0;6,0;;1,0;1,0;12,0;;;;;7,0;;8,0;;1,0;;1,0;3,0;;;;;1,0;;3,0;;;2,0;;1,0;3,0;;;;1,0;21,0;42,0;1,0;2,0;;;;;;4,0;;9,0;17,0;;1,0;;;;;;;;;;5,0;2,0;;13,0;1,0;;;;;;2,0;;;;;;;;;;;;;;;;;;2,0;;;;;;;;;1,0;;2,0;1,0;1,0;;;;1,0;3,0;;;;;;;;;11,0;1,0;;;;;;;;;2,0;;;;;;1,0;;4,0;;;;;;;;;;2,0;1,0;;;;;;;;;2,0;;;;;;;;1,0;;;62,0;2,0;;1,0;;;10,0;;;;;2,0;;;;;;;5,0;4,0;;;;;;;;;;;;2,0;;;;;4,0;;;;;;;;1,0;;1,0;3,0;;;;;3,0;;;;;;;2,0;3,0;;1,0;;;;;;;7,0;;2,0;;;;;;;;;;;;;;;;;;;;;;;;;;;;1,0;;;;;2,0;1,0;;;11,0;;1,0;30,0;;;;;;;;;;;;;;;;;;;;;;;;;;;;;;;;;;;;;;;;;;;;;;;;;;;;2,0;4,0;;;;;5,0;;;;;;;;;;;;;;;;;;;;;;;;;2,0;;;;3,0;;;;;;;;;;;;;;;;5,0;;;;;;;5,0;;;;;;;2,0;;1,0;2,0;;13,0;;;;2,0;3,0;;;1,0;;2,0;;;;;;;;;;;2,0;;;;;;3,0;;2,0;17,0;;;;;;;2,0;;;;;;2,0;;7,0;;;;2,0;;17,0;2,0;7,0;;1,0;;;;;;;2,0;;;;;;;;2,0;;;2,0;;;;;;;;;;;;;;;;;;;;;;;;;;;;;;;;;;;;;;;;;;;;;;;;;;;;;;;2,0;;;;;;3,0;;;;;;;;;;;;;;;;;;;;;1,0;;;;;;;;;;;;;;;;;;;;;;;;;;;;;;;;;;;;;;;;;;;;;;4,0;;;;;;;;;;;;;1,0;;;;;;;;;;;1,0;;;;;;;;;;;3,0;;;;;;;;3,0;;1,0;;;;;;;;;;2,0;;22,0;;;;;;;;;;;;1,0;;;;;;;;;;;;;;1,0;;;;;;;;
horizontal;;;;24,0;9,0;81,0;65,0;43,0;;;;;8,0;61,0;;1,0;44,0;;;1,0;;1,0;15,0;8,0;2,0;4,0;1,0;13,0;4,0;;76,0;15,0;5,0;3,0;;80,0;56,0;65,0;;;39,0;68,0;1,0;14,0;41,0;14,0;;17,0;6,0;6,0;9,0;;54,0;2,0;58,0;5,0;72,0;;;61,0;;4,0;11,0;;441,0;;79,0;10,0;;16,0;16,0;38,0;20,0;;;;;3,0;2,0;19,0;87,0;;5,0;3,0;52,0;10,0;3,0;31,0;7,0;21,0;17,0;8,0;3,0;;;1,0;227,0;164,0;49,0;132,0;114,0;123,0;;31,0;13,0;26,0;5,0;1,0;;2,0;25,0;46,0;26,0;;1,0;1,0;107,0;18,0;30,0;176,0;;5,0;122,0;17,0;;6,0;99,0;;1,0;3,0;27,0;12,0;;139,0;;;106,0;10,0;2,0;;;7,0;1,0;;9,0;7,0;37,0;47,0;;1,0;1,0;19,0;22,0;19,0;;11,0;;;;1,0;;31,0;;5,0;7,0;;9,0;3,0;7,0;11,0;25,0;21,0;5,0;494,0;2,0;111,0;1,0;;9,0;;;2,0;22,0;36,0;;1,0;8,0;5,0;94,0;13,0;4,0;;;4,0;4,0;2,0;35,0;4,0;10,0;;;;;;24,0;6,0;19,0;;22,0;40,0;27,0;48,0;32,0;;;12,0;8,0;37,0;;3,0;1,0;35,0;;;2,0;;122,0;;;1,0;3,0;2,0;53,0;14,0;8,0;;;6,0;;26,0;;1,0;8,0;1,0;;27,0;;12,0;62,0;10,0;;;;9,0;10,0;2,0;17,0;69,0;;;32,0;7,0;;27,0;14,0;;;;1,0;11,0;;2,0;4,0;4,0;;;17,0;177,0;6,0;3,0;1,0;;274,0;21,0;;4,0;4,0;1,0;34,0;3,0;19,0;11,0;;3,0;38,0;6,0;203,0;4,0;;2,0;2,0;22,0;1,0;;;4,0;1,0;12,0;7,0;25,0;9,0;;;;41,0;;60,0;4,0;;7,0;2,0;30,0;17,0;13,0;3,0;;1,0;;2,0;;5,0;;12,0;1,0;4,0;2,0;;;;;73,0;41,0;3,0;;3,0;;72,0;18,0;1,0;4,0;;;12,0;1,0;44,0;1,0;3,0;10,0;130,0;;8,0;;;;;13,0;;9,0;;1,0;;;37,0;50,0;2,0;2,0;;3,0;7,0;;108,0;121,0;;3,0;9,0;33,0;;47,0;;;1,0;;4,0;;2,0;3,0;;19,0;6,0;2,0;;10,0;;14,0;6,0;22,0;;14,0;13,0;33,0;4,0;14,0;;;9,0;35,0;20,0;3,0;4,0;;;22,0;5,0;34,0;;10,0;1,0;1,0;;;14,0;;11,0;;32,0;;2,0;;32,0;16,0;;1,0;9,0;50,0;;8,0;2,0;1,0;26,0;;;;2,0;6,0;1,0;;;4,0;;31,0;7,0;1,0;7,0;10,0;;;1,0;;;2,0;4,0;12,0;1,0;4,0;;;8,0;;;;27,0;6,0;;;;;18,0;1,0;1,0;;7,0;;;7,0;1,0;1,0;2,0;;;;7,0;4,0;;;3,0;557,0;5,0;;1,0;;;9,0;;;;3,0;;6,0;;;;;;1,0;;2,0;;;;;;1,0;4,0;;;1,0;4,0;;15,0;4,0;;4,0;1,0;11,0;;17,0;;4,0;;3,0;;1,0;1,0;;;6,0;;;;;1,0;4,0;5,0;;2,0;;;2,0;;;;;;;19,0;26,0;;;;;;;3,0;1,0;1,0;2,0;2,0;;1,0;;;;;4,0;;;;;5,0;;2,0;1,0;;13,0;;2,0;3,0;;3,0;;24,0;;1,0;4,0;;2,0;2,0;;;;;;;6,0;;4,0;16,0;;;;1,0;;4,0;;10,0;4,0;;1,0;47,0;;;;2,0;5,0;;;;;;1,0;1,0;;9,0;1,0;13,0;;10,0;;62,0;;2,0;;;6,0;4,0;;;;8,0;;6,0;;2,0;;2,0;1,0;2,0;;39,0;;;;;;;;;;1,0;;1,0;10,0;3,0;;2,0;2,0;;10,0;1,0;;;;3,0;11,0;26,0;1,0;3,0;13,0;;13,0;2,0;;1,0;5,0;2,0;;5,0;2,0;;10,0;1,0;7,0;1,0;;5,0;8,0;13,0;;13,0;;;;;3,0;44,0;;2,0;7,0;32,0;;;2,0;5,0;;;;;;;;;4,0;;;;1,0;;;;1,0;32,0;2,0;;3,0;;1,0;;;;;7,0;;34,0;;;1,0;1,0;;5,0;;4,0;;;;2,0;;;43,0;1,0;;;;4,0;;;;2,0;;3,0;;;;;8,0;;;1,0;;2,0;4,0;;9,0;;;;10,0;2,0;5,0;4,0;;;;;8,0;21,0;11,0;9,0;2,0;;;;;4,0;;;2,0;;;;;;42,0;;;;;;;;3,0;;9,0;4,0;;3,0;;1,0;9,0;;;;10,0;3,0;;;;8,0;;8,0;;;4,0;4,0;31,0;6,0;;;9,0;;;;;;1,0;1,0;;;;6,0;3,0;;;;2,0;;;;1,0;;;1,0;2,0;;;2,0;;1,0;;16,0;;;1,0;;;2,0;3,0;;;;4,0;;;6,0;;;;12,0;;;;;;;3,0;2,0;2,0;;;;1,0;;6,0;;;;;;;2,0;;9,0;3,0;2,0;;;;;;;;;;;;;;;1,0;11,0;1,0;7,0;6,0;;;;;40,0;2,0;;;7,0;4,0;4,0;;;;;;1,0;;1,0;9,0;;;;;;2,0;;
host;;;;3,0;;4,0;;1,0;;;;;1,0;7,0;;1,0;29,0;;2,0;;1,0;;;7,0;21,0;;;1,0;30,0;;25,0;12,0;;;;55,0;;;4,0;;6,0;208,0;;8,0;26,0;8,0;;2,0;;2,0;;;;1,0;3,0;;;;2,0;18,0;;;;2,0;46,0;;17,0;;;1,0;;13,0;4,0;;;;;;17,0;4,0;29,0;;1,0;2,0;12,0;;;1,0;;;;;8,0;1,0;;;1,0;;21,0;1,0;2,0;;;7,0;6,0;51,0;;1,0;;;;1,0;3,0;;;;1,0;1,0;;58,0;;;5,0;;;2,0;41,0;;;;4,0;;;9,0;;;6,0;;;;;;;;;3,0;12,0;;5,0;2,0;;2,0;;;;;;;;;;22,0;;;;;16,0;5,0;;4,0;;;4,0;2,0;2,0;2,0;;;1,0;;1,0;2,0;3,0;;;;;;6,0;;;;;;;;3,0;;;;;;;;1,0;4,0;;;;3,0;;;;;;;2,0;;;1,0;15,0;4,0;2,0;1,0;;;1,0;;;;;;;;3,0;;;;;;;;;;4,0;1,0;1,0;;;;;;;;2,0;1,0;;1,0;;;1,0;22,0;;93,0;;;;;;;;3,0;;2,0;;;2,0;;;;;;1,0;;;;1,0;;2,0;;1,0;1,0;;;;1,0;5,0;4,0;;;;;1,0;;;;;;;8,0;;;;;6,0;;6,0;2,0;;1,0;56,0;18,0;;;;;;;5,0;2,0;;;;;1,0;;;;;;;;;;;;;;;;;;;;5,0;;;;16,0;3,0;3,0;;;;;;;;2,0;;1,0;3,0;4,0;;4,0;;;10,0;;;40,0;1,0;;;;7,0;;;1,0;;;1,0;;;3,0;1,0;;;;;;2,0;;;;;1,0;4,0;8,0;;;9,0;;2,0;12,0;14,0;7,0;;;;;2,0;;;1,0;24,0;58,0;2,0;2,0;;5,0;21,0;5,0;;10,0;;8,0;;20,0;;;;;;;;2,0;2,0;5,0;;;1,0;;1,0;;2,0;4,0;12,0;;1,0;34,0;;;;;;;;;;1,0;;;10,0;;;;;3,0;;;;;1,0;;;2,0;;;;;;1,0;;;;11,0;;1,0;;;19,0;;;1,0;;;;1,0;3,0;;;;;;;;;2,0;;6,0;7,0;;;;;;;;;;;1,0;;1,0;;;;;;1,0;;;1,0;;13,0;;;;2,0;3,0;;;;;;;;;;;;;;;;;;;;;;;;2,0;;;;;;;;;2,0;;;;11,0;3,0;;4,0;;;;;;;;;;;;;;;1,0;;;;;;;;;;2,0;;1,0;1,0;;5,0;;;6,0;4,0;;;;;;;;;12,0;;;;;;;1,0;;;1,0;;;;;1,0;;;;;;;1,0;1,0;;;4,0;;5,0;28,0;14,0;;;;;;;5,0;;;;;;;;6,0;;;;;6,0;3,0;2,0;1,0;;;;;;;7,0;;1,0;;;1,0;;;;;;1,0;;;;;;;;;;;5,0;;4,0;1,0;;;;;;;;1,0;;;;;;;;13,0;;;;;;;;;;;;;1,0;;;;;;;;;;;;;3,0;;;;;;1,0;;;;;;;;;;;;1,0;2,0;;;;;;;;;;;;;;;;;1,0;;;;;;;;;;;;;;;;;;1,0;;;;;;;;;;;;;;;;;;;;;;;;;;;;4,0;;;;;1,0;;;;;;;;;5,0;;;;;2,0;;;;;;1,0;;6,0;;2,0;;1,0;2,0;;;;;1,0;;1,0;;;;;;;2,0;;;2,0;;;;;;;;;;;;;;;;;1,0;;;;;;;1,0;;;11,0;;2,0;;;;;2,0;;;;;;;;;;;;;;;;;;;;;;;;;;;;;;;;;;;;;;;;;;;;1,0;;;;;;;;;;;;;;;;;;;;;;;;;;;;;;
human;;;;2,0;;16,0;2,0;;;;;3,0;;47,0;;;55,0;;;30,0;;2,0;7,0;;7,0;1,0;;2,0;3,0;5,0;11,0;3,0;2,0;;;23,0;1,0;2,0;17,0;2,0;50,0;34,0;2,0;9,0;14,0;1,0;2,0;;;2,0;5,0;;4,0;;5,0;;3,0;;4,0;8,0;;;2,0;;185,0;1,0;30,0;;1,0;;;8,0;15,0;1,0;;;;6,0;;7,0;67,0;;;29,0;;;;;;1,0;;6,0;;;2,0;4,0;4,0;;23,0;1,0;53,0;10,0;1,0;2,0;6,0;10,0;1,0;3,0;2,0;;;5,0;20,0;;3,0;;;;9,0;10,0;4,0;;18,0;2,0;;11,0;43,0;;;;5,0;;;12,0;;;12,0;5,0;2,0;;;;1,0;;;2,0;13,0;2,0;4,0;;;4,0;99,0;1,0;;;;;;;;;1,0;1,0;;;2,0;;;17,0;3,0;5,0;1,0;22,0;;;;;1,0;;1,0;;;173,0;;;;;6,0;;;7,0;3,0;;;;1,0;;;;;;4,0;;5,0;5,0;;;;2,0;1,0;6,0;;;;;1,0;;;1,0;3,0;;11,0;;1,0;;23,0;15,0;3,0;2,0;;;13,0;;;20,0;;9,0;;3,0;;;;;;15,0;;10,0;3,0;;;;;1,0;;1,0;4,0;6,0;;;;;;6,0;;;;3,0;;;;;;4,0;2,0;;1,0;3,0;;1,0;;;3,0;2,0;;;1,0;;1,0;;;3,0;;;7,0;;30,0;;1,0;;;;;1,0;;;;12,0;1,0;2,0;;1,0;3,0;;;;14,0;;;;7,0;34,0;;;;;;;1,0;17,0;;;;;;;;;;;;1,0;;;1,0;14,0;2,0;10,0;;;;4,0;2,0;;8,0;;;10,0;22,0;;;;;6,0;;6,0;2,0;5,0;;5,0;;;1,0;21,0;;1,0;;4,0;4,0;;33,0;2,0;;10,0;;68,0;;;1,0;;;1,0;2,0;1,0;1,0;;;23,0;6,0;;;7,0;1,0;2,0;;1,0;;5,0;3,0;;;1,0;;4,0;7,0;3,0;;;;7,0;;3,0;;;3,0;24,0;;16,0;1,0;;;;1,0;16,0;2,0;;2,0;52,0;;;11,0;;3,0;;1,0;2,0;;;52,0;;;;;;;;;;;2,0;4,0;2,0;;;;;12,0;;;21,0;;;4,0;3,0;;1,0;;;;4,0;;1,0;1,0;4,0;3,0;;7,0;4,0;;2,0;;15,0;;3,0;;;1,0;1,0;3,0;;4,0;17,0;;3,0;;3,0;;;;4,0;;;1,0;;1,0;;;;;;1,0;;;;18,0;;;;;;;;;1,0;2,0;;;1,0;;3,0;;;;10,0;;23,0;;;;;;;2,0;1,0;;7,0;;;;;;;1,0;15,0;;;3,0;4,0;3,0;19,0;7,0;;;;3,0;;;;;;;;6,0;;3,0;;;;;1,0;;9,0;;;;;;2,0;;1,0;;;10,0;21,0;;;1,0;8,0;;;;;;;;;;27,0;1,0;;;2,0;;2,0;;;;;;;4,0;;;;;;1,0;;;;;;;;;1,0;;;;;;;;;;;5,0;1,0;1,0;;;;;;;;;;;;6,0;;;;;;;;51,0;2,0;;;;;;;1,0;;;1,0;;;;;;2,0;;;;;;;;;;;;;;;;5,0;;;;1,0;;;;3,0;;;;3,0;;;;;;;;;;2,0;1,0;;;;;;1,0;;;;;4,0;;17,0;1,0;;;;;;;;;;;;;;13,0;;;;;;2,0;;;;;;;;;;;;;;4,0;;;;;;;;;;;;;;1,0;;;;;;;;;;;;;;;1,0;;;;;;;;4,0;;;;;;;;;7,0;;;;3,0;;;;;;;;;;;;;12,0;3,0;;1,0;;;2,0;2,0;;3,0;;9,0;;;;1,0;;;3,0;2,0;;;;;;;;;2,0;;;;;1,0;;;;3,0;;;;;;;;;;;;;;;2,0;36,0;;;1,0;1,0;;;;;1,0;;;;;;;;;;;;;;;;;;;;2,0;;;1,0;;;;3,0;;;;;;;;;;;;1,0;;;;4,0;;;;;;1,0;;;;;;;;;;;;5,0;;;;;;;;;;;;;;;;;1,0;;;;;6,0;;;;;;3,0;;;
identifier;;;;1,0;2,0;29,0;7,0;1,0;20,0;9,0;;;;36,0;;;13,0;;1,0;1,0;;;3,0;1,0;2,0;;;;27,0;6,0;23,0;8,0;;;;133,0;;;;;56,0;210,0;;2,0;70,0;;;2,0;;;;;;1,0;1,0;;;;;57,0;;;28,0;4,0;71,0;1,0;58,0;;1,0;;;;7,0;;;;;;23,0;;57,0;;11,0;1,0;17,0;;;;;17,0;10,0;3,0;12,0;20,0;;;20,0;;76,0;6,0;21,0;10,0;;4,0;19,0;33,0;;2,0;;;;6,0;1,0;4,0;;10,0;9,0;13,0;2,0;8,0;;;25,0;3,0;;26,0;42,0;;;;10,0;;;10,0;;;1,0;;;;;1,0;;;;;3,0;;104,0;;;;;;;;;;;;;1,0;23,0;;;;1,0;;;;;;;2,0;;;;;1,0;;;;;3,0;;;;;12,0;2,0;;1,0;;;;;;;;2,0;;;;;;10,0;1,0;;1,0;;;;;;;;14,0;;;5,0;22,0;5,0;8,0;;6,0;;19,0;;;;;;3,0;;;11,0;;;;7,0;;;;;;34,0;;;;;;;;;;;;6,0;;;16,0;14,0;8,0;18,0;;;;;;18,0;;;;2,0;;;;2,0;;;;;;;45,0;;;;;;;3,0;;;4,0;;;;;;;;;;;;;;2,0;6,0;;;;;;;8,0;;;;;80,0;;1,0;;;;;;;;;;;1,0;;;;;;;2,0;;1,0;;;;;;;;;;;;;;;60,0;3,0;4,0;;;;;;6,0;;;;;;;;;;;5,0;2,0;;16,0;7,0;;1,0;;2,0;4,0;;;103,0;1,0;2,0;7,0;;;1,0;;50,0;22,0;2,0;;4,0;;2,0;;40,0;;1,0;;;;;;1,0;1,0;;;2,0;;;;;;6,0;4,0;40,0;5,0;18,0;11,0;;;36,0;11,0;;2,0;;4,0;6,0;;12,0;;1,0;2,0;2,0;;1,0;;4,0;65,0;;;;;;;1,0;;9,0;;3,0;4,0;1,0;7,0;3,0;;25,0;;;;;;9,0;6,0;;;;;;;;;;;6,0;;;;6,0;22,0;1,0;2,0;1,0;6,0;;;;;;2,0;;;40,0;;;;;1,0;1,0;;41,0;3,0;;;;;2,0;;2,0;;;1,0;;;;;;;4,0;;;;;;;;1,0;;8,0;6,0;8,0;1,0;;;2,0;;1,0;8,0;;20,0;3,0;;;;2,0;16,0;11,0;;;;;;;;;;1,0;29,0;;10,0;;;;33,0;;;;;;;;;;;;2,0;;;1,0;13,0;2,0;;3,0;;;;;;;4,0;5,0;;;;4,0;;69,0;;;;;29,0;5,0;;;;;1,0;4,0;;3,0;1,0;;;;;;;;5,0;;;1,0;;15,0;;7,0;2,0;;;;;1,0;;;1,0;3,0;;;36,0;;;;3,0;4,0;;;4,0;;1,0;;;15,0;17,0;1,0;;;2,0;127,0;;;;;;;;1,0;;2,0;20,0;;;;3,0;3,0;;3,0;1,0;;;;;;;;;;;;;;;;;;;;;;;;;;;;;;;;;;5,0;;;;1,0;;;;;;;;;;2,0;11,0;;;;;;;;;;;;;;;;;;;;;;;;;;;;;;;;;;2,0;;;;;;;;;;;;;;;;2,0;;;;;;;1,0;;;;;;20,0;;;;;;;;;;;3,0;;;6,0;;;3,0;;;;;;;;1,0;;;;;;;;;;;1,0;;;;;1,0;;;2,0;;;;;;;2,0;;2,0;;;;;;;1,0;;;;;;;;;;;3,0;;;4,0;8,0;;;;;;;;;15,0;;;;;;;;6,0;5,0;;;;;;2,0;1,0;;;;1,0;1,0;;;;;;;;;;;;;;;;;;;;;2,0;43,0;;;;;;;;;;;;;;;;;;;;;;;;;;;;;;;;;;;;;;;;;;;;;7,0;;;;;;;;;;;;;;;;;;;;;;;;10,0;;;;;
illuminate;;;;13,0;2,0;23,0;40,0;22,0;;;;6,0;;6,0;;13,0;90,0;2,0;4,0;;;;20,0;;2,0;;;17,0;3,0;;105,0;11,0;;;;33,0;3,0;;8,0;6,0;31,0;97,0;1,0;7,0;19,0;9,0;1,0;19,0;;;;6,0;;1,0;149,0;7,0;8,0;;5,0;24,0;;;6,0;;252,0;;49,0;2,0;4,0;;1,0;18,0;506,0;;;;2,0;3,0;;;94,0;;2,0;;16,0;1,0;;35,0;8,0;5,0;1,0;4,0;23,0;2,0;4,0;;54,0;9,0;76,0;9,0;24,0;1,0;;1,0;2,0;3,0;3,0;;1,0;;;11,0;117,0;1,0;;;;15,0;150,0;101,0;11,0;;21,0;6,0;3,0;;60,0;;11,0;;36,0;;;76,0;;;149,0;3,0;2,0;;;4,0;;;2,0;3,0;76,0;31,0;6,0;;;;;2,0;;;;;;;;;;;1,0;;9,0;;;8,0;5,0;;9,0;15,0;;4,0;;54,0;;;;;1,0;3,0;;;22,0;;11,0;30,0;;;2,0;;;1,0;18,0;9,0;;;;2,0;;;6,0;5,0;4,0;;7,0;;;;;1,0;1,0;4,0;11,0;1,0;;5,0;41,0;4,0;2,0;;1,0;;88,0;;;10,0;;26,0;15,0;;;4,0;14,0;9,0;;4,0;;;;;;15,0;11,0;;56,0;1,0;;;;7,0;;1,0;5,0;39,0;1,0;;2,0;13,0;8,0;14,0;;;;39,0;;11,0;;;1,0;11,0;1,0;;;31,0;;2,0;;;13,0;;;;;;;;2,0;1,0;;;;1,0;15,0;1,0;;2,0;;;;;;;;4,0;;43,0;;;4,0;;4,0;;6,0;1,0;1,0;;14,0;164,0;1,0;5,0;5,0;;;;4,0;1,0;;;;;2,0;;;;;;1,0;;;;;;;7,0;5,0;;;;;;3,0;1,0;5,0;1,0;7,0;3,0;;;;;;;;;;;;10,0;;7,0;7,0;12,0;2,0;8,0;;;33,0;6,0;2,0;;2,0;11,0;1,0;;;;;;;;;2,0;6,0;5,0;1,0;6,0;;;;5,0;6,0;3,0;;2,0;2,0;2,0;1,0;2,0;;3,0;8,0;;;;;;;;;1,0;5,0;40,0;2,0;2,0;1,0;;13,0;;;;1,0;;6,0;32,0;;3,0;14,0;13,0;1,0;;;2,0;;;10,0;;;;10,0;;;;;13,0;;1,0;1,0;3,0;;5,0;2,0;1,0;;;2,0;;1,0;9,0;;;2,0;;8,0;;;5,0;;;;12,0;6,0;;12,0;;8,0;;;;;45,0;1,0;3,0;11,0;;;;;1,0;;1,0;;4,0;2,0;;;;;1,0;;;1,0;5,0;;1,0;4,0;;;;;;;;3,0;;;;;;1,0;6,0;10,0;2,0;2,0;1,0;;;;;1,0;;;1,0;;;1,0;;2,0;;;;;;4,0;7,0;;;;2,0;5,0;;;;8,0;;;3,0;;2,0;;;;4,0;2,0;;;;;;13,0;1,0;;;;;8,0;;;;;;;;;1,0;71,0;;2,0;;;7,0;;;;35,0;;1,0;;;10,0;1,0;;;;;;2,0;;;10,0;16,0;;;;;;;1,0;;;2,0;1,0;;;;1,0;;2,0;5,0;;;;2,0;;;;1,0;;1,0;;;;;;;3,0;;;4,0;;;5,0;;1,0;;;;215,0;1,0;;1,0;;4,0;;;32,0;;;;;2,0;5,0;1,0;;;;;;;;1,0;;1,0;;2,0;;;7,0;6,0;;;;9,0;1,0;3,0;;;;;1,0;;;224,0;1,0;1,0;;2,0;;;;1,0;1,0;2,0;;1,0;3,0;;1,0;;1,0;;;;;;;;;;;;1,0;;;14,0;;;;;2,0;1,0;;;;;;7,0;;;;;;;2,0;13,0;8,0;;4,0;;;;;;;;;;;1,0;2,0;;5,0;;;;;;;;;;;;;;;;;;;1,0;;;;;3,0;;;;9,0;1,0;;;20,0;;;;;11,0;;;1,0;;;6,0;;;;;;;;;;1,0;;1,0;;;2,0;2,0;;;3,0;2,0;2,0;;;;2,0;3,0;;3,0;2,0;;;;;;;17,0;;6,0;2,0;;3,0;;4,0;;;19,0;;;;;;1,0;;;;;;;;;;;;;;;1,0;;;;3,0;;;;1,0;;;;2,0;1,0;;1,0;4,0;;44,0;6,0;;;;;;4,0;;;;2,0;13,0;1,0;;1,0;23,0;;;;;;;;;;1,0;;;;;;;;;;;1,0;11,0;;;;;3,0;;5,0;;;;2,0;7,0;1,0;;;;;;;3,0;;2,0;;;;;;3,0;4,0;;;;;;;;;;;;;;;;;2,0;;;
illuminator;;;;3,0;;7,0;19,0;18,0;;;;7,0;;8,0;;;30,0;1,0;1,0;10,0;;;;;;;;17,0;1,0;;27,0;1,0;;;;;;1,0;6,0;;4,0;7,0;;;;5,0;;21,0;;;;;;2,0;20,0;;7,0;;;4,0;2,0;;1,0;;53,0;;27,0;;;;;18,0;78,0;;;;;;;4,0;30,0;;10,0;;6,0;8,0;;31,0;;1,0;;;3,0;;;;4,0;;67,0;;6,0;2,0;;6,0;1,0;4,0;1,0;;;;;7,0;24,0;;;;;22,0;4,0;26,0;;;9,0;3,0;;;88,0;;;;11,0;;;1,0;;;22,0;;;;;16,0;;;;;3,0;6,0;13,0;1,0;;4,0;1,0;;;;;;;;;3,0;;;;;3,0;9,0;;1,0;2,0;;3,0;;;;;49,0;1,0;;7,0;;;1,0;;;15,0;;;30,0;;;;;;;2,0;;;;;;;;;;;;8,0;;;;;;3,0;;;;;;;;;;;;6,0;;;1,0;;;;;;;3,0;1,0;;;;;;;1,0;5,0;;3,0;47,0;;;;;4,0;;;;8,0;;;;1,0;;;4,0;;;6,0;;5,0;;;;;;;2,0;1,0;;;;;1,0;5,0;;;;;5,0;;;;;7,0;;5,0;1,0;;;;;;;;;;;1,0;1,0;12,0;;;2,0;;25,0;;2,0;;;;;3,0;;4,0;;;;;;;;;;;1,0;;;;;;1,0;;;;;;;1,0;;;;;;;2,0;3,0;;;3,0;1,0;;;;;;;;;;;;;;;;;;1,0;;;6,0;;;3,0;;9,0;1,0;;;;;;;1,0;;;;3,0;;;;;1,0;;;14,0;;;;2,0;;1,0;;9,0;;3,0;;;;;;;1,0;;1,0;10,0;;3,0;;;1,0;;;;;;;;;;;;;2,0;;1,0;;;;;;;8,0;;;;;;;2,0;4,0;4,0;;;;;;1,0;;;;;1,0;;;;1,0;;;;;;;3,0;;;3,0;;;;;;;1,0;1,0;;;;;;;;;;;;;;;;;;;;;;;;;;;;;;;;2,0;;10,0;;;;;;;;;;;;;;;1,0;;;;;;;;;1,0;1,0;;;;;;;;;;1,0;;;;;;;;;;;7,0;;;;;;;;;1,0;;1,0;;;;;;;;;;;;;;;;;;;;;;;2,0;;;;;;;;;;;1,0;;;5,0;8,0;;;;;;;;;;;;;;2,0;;;;;1,0;;;;;;;4,0;;;;;;1,0;;;;;;;;;;2,0;;;1,0;1,0;7,0;;;;;79,0;;;1,0;;;;;;;;;;;;;;;;;;;1,0;;;2,0;71,0;;;;;;;;;;;;;;20,0;;1,0;;;;;;;;;;;;;;4,0;2,0;;13,0;;;;;;;;;;;;;5,0;;;;;;;;;;;;10,0;;;;;;;;3,0;;;;;1,0;;;;;;;;;;;;2,0;;;;;;;;;;;;;;;;;;;;;;;;;;;;;;;;;;;;;;;;;;;;;;;;;;;;;;;;;;;;;;;;;;;;;;;;4,0;;;;;44,0;;2,0;;;;;;;;;;14,0;;;;1,0;;;1,0;;;;;;;;;;;;;;;;;;;;;;;;;;;;;;;;;;;;;;;;;;;;;;;;;;;;;1,0;;;;;;1,0;;;;;;;;;;;;;;;;;;;;;4,0;;;;;;1,0;;;;;;1,0;;;;;;;;;;;;;;;;;;;;;;;;;;;
incident;;;;7,0;43,0;9,0;31,0;23,0;;;;6,0;2,0;18,0;1,0;1,0;59,0;5,0;3,0;2,0;36,0;;24,0;;4,0;;3,0;14,0;;;78,0;6,0;;1,0;;33,0;3,0;11,0;2,0;2,0;25,0;47,0;2,0;5,0;12,0;36,0;;72,0;;4,0;;3,0;2,0;16,0;10,0;8,0;27,0;;2,0;21,0;;1,0;5,0;;248,0;;35,0;;;1,0;6,0;188,0;1067,0;4,0;5,0;;22,0;3,0;;1,0;29,0;3,0;7,0;7,0;32,0;4,0;;165,0;1,0;5,0;;17,0;54,0;3,0;4,0;;129,0;13,0;41,0;8,0;33,0;18,0;4,0;;4,0;2,0;6,0;;1,0;2,0;;;24,0;;;28,0;;13,0;33,0;162,0;;12,0;53,0;5,0;18,0;5,0;60,0;;;;2,0;1,0;;64,0;;;6,0;69,0;;7,0;;23,0;;;9,0;7,0;45,0;14,0;11,0;;;26,0;2,0;;;37,0;;1,0;;;1,0;;2,0;80,0;11,0;;;18,0;;15,0;;;18,0;34,0;;;14,0;24,0;;;1,0;;6,0;17,0;;17,0;102,0;1,0;7,0;2,0;;;1,0;4,0;2,0;11,0;13,0;;7,0;;;26,0;1,0;;6,0;3,0;13,0;8,0;36,0;3,0;;1,0;;1,0;9,0;9,0;19,0;3,0;;26,0;2,0;1,0;;39,0;9,0;;57,0;1,0;3,0;22,0;;47,0;39,0;;;;62,0;26,0;1,0;17,0;;;7,0;;;6,0;3,0;6,0;46,0;;;;4,0;6,0;21,0;1,0;;180,0;1,0;3,0;6,0;41,0;8,0;1,0;;;5,0;42,0;;22,0;;4,0;5,0;6,0;;;22,0;136,0;2,0;;;;36,0;;;;9,0;1,0;9,0;2,0;;3,0;;;;2,0;1,0;3,0;;;;;;;;;;;17,0;57,0;2,0;;3,0;;2,0;;4,0;;1,0;;2,0;41,0;15,0;1,0;2,0;;10,0;;3,0;;1,0;;;3,0;12,0;;;;1,0;;7,0;;;;;;2,0;8,0;2,0;;;;;2,0;;;;11,0;10,0;;2,0;;;;;3,0;;18,0;;;;;4,0;2,0;17,0;2,0;5,0;;3,0;;17,0;4,0;;;;9,0;1,0;7,0;2,0;;2,0;2,0;3,0;32,0;1,0;13,0;;8,0;4,0;1,0;;15,0;;6,0;;;;;;;;5,0;;;;1,0;;;;;6,0;1,0;3,0;6,0;;90,0;2,0;32,0;4,0;;22,0;;1,0;2,0;;;4,0;18,0;;;1,0;;;3,0;;;;;11,0;;;3,0;;;;;1,0;;;;1,0;;;;;;;;;;;;;1,0;;;1,0;;4,0;;3,0;;1,0;2,0;1,0;2,0;1,0;;;10,0;;;;6,0;1,0;14,0;;;;;1,0;3,0;11,0;;2,0;3,0;;7,0;;;5,0;2,0;;;;2,0;;6,0;;;;1,0;;1,0;;3,0;;;;;;;;19,0;4,0;;2,0;;;;;;12,0;27,0;;2,0;;;2,0;;;;;;;;;2,0;;;;5,0;;20,0;;;;;;;;;;;;;8,0;;;;;1,0;48,0;;;;;;;;;;;2,0;;;;21,0;2,0;;;;;4,0;;;;2,0;;;;;;;;;;3,0;;10,0;;;24,0;;;;6,0;;;;;;;;;;;;6,0;2,0;3,0;2,0;;;;;;;;;;;2,0;;;2,0;;;8,0;;;;;;4,0;1,0;1,0;;2,0;;23,0;;;;;1,0;;;4,0;;;;;10,0;;;;2,0;;;1,0;2,0;;;3,0;4,0;;;;;;;;;6,0;;;14,0;;;6,0;;5,0;;;26,0;;7,0;;4,0;;;;;1,0;2,0;;;;;;;1,0;;4,0;;;;;;;;;;;10,0;4,0;14,0;;;;;;;;1,0;;5,0;;1,0;;;;;;;1,0;;;;1,0;;11,0;;;;;;51,0;;;;;;7,0;3,0;;4,0;4,0;3,0;;;14,0;;;;28,0;;;2,0;;;;1,0;2,0;;;1,0;;4,0;;;18,0;1,0;7,0;;2,0;;;;2,0;6,0;;;;;;4,0;10,0;;;4,0;;;;;;;;;;;;;;1,0;4,0;1,0;;;;;;16,0;5,0;;1,0;;;;;9,0;;9,0;;11,0;;;5,0;;;;1,0;;1,0;;;;;1,0;;1,0;;;1,0;;;;;;;;;;;;;;;;2,0;;;;;;1,0;;;14,0;1,0;;;;4,0;;;1,0;;;;;;;;;;2,0;3,0;;;;;4,0;3,0;;;;;;;11,0;;;;;1,0;9,0;;;;;;1,0;;;;;;;;2,0;;3,0;11,0;;;1,0;;;;;;2,0;5,0;;;;4,0;35,0;;;;;;;6,0;;;5,0;;;;;;;;;6,0;
incline;;;;3,0;4,0;8,0;6,0;10,0;;;;;3,0;7,0;;;5,0;;2,0;;;;2,0;;;;;;;;1,0;;;1,0;;;2,0;10,0;;;2,0;21,0;3,0;;3,0;17,0;;18,0;;1,0;;;23,0;;;;39,0;;;2,0;;;;;5,0;;37,0;5,0;;2,0;2,0;36,0;12,0;;;;12,0;;;;3,0;;;;13,0;6,0;;37,0;;;;1,0;;;;;;76,0;;;44,0;8,0;;1,0;2,0;1,0;;;;;;8,0;8,0;;;;;;;9,0;;1,0;;;;;5,0;;;;;;;37,0;;;3,0;;;;2,0;4,0;;;;;8,0;1,0;1,0;1,0;2,0;;15,0;1,0;;;2,0;1,0;;;;8,0;;1,0;;;2,0;6,0;4,0;;;;;63,0;1,0;15,0;;2,0;;;;;;20,0;;;;2,0;3,0;2,0;;;;4,0;8,0;6,0;7,0;2,0;8,0;1,0;;1,0;;3,0;;;17,0;1,0;7,0;20,0;3,0;1,0;;;;7,0;1,0;8,0;;;;;;;;;158,0;;5,0;;1,0;;;;11,0;;2,0;1,0;;;;4,0;;;;;;4,0;34,0;2,0;3,0;;;;2,0;;24,0;140,0;;;;;1,0;1,0;50,0;;;;;12,0;;;;4,0;;;2,0;48,0;;3,0;;;75,0;1,0;;;;1,0;;;;;;;;2,0;14,0;;;1,0;3,0;;;;;3,0;5,0;;2,0;3,0;;;2,0;;1,0;2,0;2,0;12,0;1,0;;;1,0;15,0;3,0;;;;;;;3,0;;;9,0;;;1,0;;;;5,0;6,0;9,0;;;1,0;1,0;5,0;;;;;;;;;2,0;12,0;;;;;;;;1,0;;;;;;;;5,0;;;;;;;;;;;;2,0;;;;;1,0;;;1,0;1,0;;;;1,0;;;;;2,0;;;;;;3,0;;;;;;;2,0;;;;;;;;;2,0;;;;;1,0;;;;;;1,0;;;;;;;5,0;;;;1,0;1,0;;;;;;1,0;;;;;;;;;;1,0;;;;;;;;;3,0;1,0;1,0;;;;;5,0;;;;;;;;;;;;;1,0;;;;;;;;;;;;1,0;;;;;;;;;1,0;;;;1,0;;;;;6,0;;;;;;;;;;5,0;9,0;;1,0;;3,0;1,0;;;;5,0;;;;1,0;;;;;;;;;;;;;;;;;;;;;;;;;;;3,0;;;;2,0;;;;;;1,0;;;;;1,0;;;;;;;;;;;;;;;;;;;;;;;;;;;;;;;;;;;;;;;;;;;;;;;;;5,0;;;;5,0;;;;;1,0;;;;;;1,0;;;;;;;;;;;;;;;;;;;;;;;;;1,0;;;;;;;;;;;;;;;;;2,0;1,0;2,0;;;;;;9,0;17,0;2,0;2,0;6,0;;;;;15,0;;4,0;2,0;;;;;;8,0;;;;3,0;;;;3,0;;;;3,0;30,0;;;7,0;;3,0;;2,0;;;;;1,0;;;;;;1,0;;;;;;;;5,0;2,0;;;1,0;1,0;;;;;;5,0;7,0;;;;;;9,0;;;;;;;;;1,0;;;;;;;;;;;3,0;;;;;;;;;;;;;;;;;;1,0;1,0;;;2,0;;;;;;;;;;;;;;;;;;;;;1,0;;;;6,0;;;;;2,0;;;;;;;;;;;;;;;;;;;;;;6,0;1,0;;;;;;;;;;;;;;;;1,0;;;;;;;;;;;;;;;;;;;3,0;4,0;;;;;;;2,0;;;;;;3,0;;;;;;;;;;;;;;;;;;;;2,0;;;;;;;;;;;;;;;;;;;;;;;;;;;;;;;;;;;;;;;;;;;;;;;;;;;;;4,0;;;;
insertion;;;;3,0;;7,0;;8,0;;;2,0;;3,0;4,0;;;;;12,0;;;;;;2,0;;;26,0;;;48,0;1,0;;;;11,0;3,0;;9,0;;;29,0;7,0;;3,0;3,0;;4,0;;;;;3,0;;2,0;;26,0;;;1,0;;;;;6,0;;14,0;1,0;;3,0;3,0;25,0;5,0;;;;;;3,0;1,0;3,0;;;;37,0;;;;;1,0;;;2,0;;;;;1,0;3,0;7,0;9,0;;;1,0;;1,0;;;;;;9,0;11,0;;;;;1,0;6,0;2,0;;;;6,0;;;6,0;;;;;;;41,0;;;3,0;3,0;;;3,0;;;;;2,0;1,0;4,0;;6,0;;;11,0;10,0;;;4,0;;;;;6,0;2,0;1,0;;;22,0;7,0;;;;;;26,0;2,0;1,0;;4,0;4,0;;;;;1,0;1,0;;2,0;;6,0;4,0;;;;2,0;;37,0;25,0;;6,0;22,0;;;;;;;12,0;;;20,0;4,0;;3,0;;;5,0;;4,0;;;;;;;;3,0;84,0;2,0;1,0;;6,0;;;;3,0;1,0;;;;;;;1,0;1,0;;;1,0;4,0;5,0;;6,0;;;;;1,0;11,0;2,0;;;;;;1,0;;;;;;1,0;;11,0;;2,0;1,0;;22,0;;1,0;1,0;;;12,0;4,0;;;11,0;;;3,0;;10,0;;3,0;;20,0;;;1,0;1,0;;;4,0;;1,0;22,0;10,0;3,0;1,0;9,0;;;;6,0;;;1,0;16,0;;4,0;;;2,0;;;;;;10,0;;16,0;3,0;5,0;;;;3,0;;2,0;3,0;12,0;4,0;1,0;6,0;;1,0;4,0;2,0;;;;;;;;;;3,0;;1,0;;;;;;38,0;;;;;;;;2,0;1,0;;;;;;3,0;;;;;1,0;;;;1,0;;;;;1,0;;;5,0;;;;8,0;;1,0;;;;;;1,0;;2,0;;;;16,0;;;;;;;2,0;;;3,0;3,0;;;;3,0;1,0;;;;;;;;;;2,0;;1,0;;1,0;;;3,0;;;;;;9,0;4,0;;1,0;1,0;;3,0;;;;;;;;;;;;;2,0;1,0;1,0;;;;3,0;1,0;;;;;;;;;;;;;;;;;1,0;;;2,0;;;;;;;;;;;;5,0;4,0;;;;1,0;2,0;;;2,0;;;;;;;1,0;;;;2,0;7,0;;;;;;;;;;19,0;;;;;5,0;;;;;;;;;;;;;;;;;;;;;;;;;;2,0;;;;;;;;;2,0;;5,0;;;;1,0;;;;;2,0;3,0;;;;;;;;;;;;;;;3,0;;;;;1,0;1,0;;;;;;;;;;;;;;;;;;;;;;1,0;;;;;;;;;1,0;;;;;;;;;;1,0;1,0;;;;;;;;1,0;;;;;;;1,0;;;;;;;;10,0;;;;;;;8,0;1,0;;2,0;;;;10,0;;;1,0;;;;;;3,0;;;;;;;;1,0;;1,0;;;3,0;;;;;;;;;;;;;;1,0;;;2,0;;1,0;31,0;;6,0;2,0;;;;;;;;9,0;;;;;;;1,0;;;;13,0;2,0;;;9,0;1,0;;1,0;;4,0;;;;10,0;;;;;;;4,0;;;;;;;;;;;;;;;;;;;;;4,0;;;;;;;;;;;;;;;;;;;;1,0;1,0;;;;;;;;;;;;;;;;;;;;;;;;;;;;;;;;;;;;;;;;;;;;;;;;;;;;;;;;;;;;;;;;;;;;;;;;;;;;;;;;;;;;4,0;;;;;;12,0;;;;1,0;;;;;;;;;;2,0;;;;;;;;;;;;;;;;;;;;;;;;;;;1,0;;;;;;;;;;;;2,0;;;;;;;;;;;;;;;;;;;;;;;;;;;;;;;;;;;
insulate;;;;2,0;;4,0;4,0;;;;;12,0;;14,0;;;;11,0;2,0;;5,0;;9,0;;;;;1,0;;;5,0;;;;6,0;;;;;;;27,0;;;1,0;25,0;;20,0;;;;;14,0;;;;140,0;;;;;;;;3,0;;57,0;;;;2,0;11,0;11,0;11,0;;;44,0;;;;22,0;;;;16,0;;;5,0;;;;4,0;6,0;6,0;;;20,0;;21,0;;12,0;;;1,0;;;;;1,0;;;;42,0;;;;;3,0;;27,0;;;14,0;1,0;;;3,0;;;10,0;;;;10,0;;;4,0;;;6,0;;1,0;;;;;33,0;70,0;2,0;2,0;;3,0;5,0;10,0;;7,0;;;;6,0;25,0;5,0;;;1,0;;3,0;35,0;;;;;;;;;;;;;;;5,0;18,0;;355,0;9,0;;2,0;3,0;;;2,0;1,0;2,0;15,0;9,0;;;;;218,0;;;;;61,0;17,0;;3,0;;;;;;3,0;;1,0;;;31,0;1,0;;14,0;11,0;19,0;107,0;;;;;1,0;2,0;;;;;1,0;;;4,0;2,0;;;;;9,0;1,0;21,0;;;5,0;4,0;14,0;83,0;2,0;4,0;65,0;5,0;1,0;;2,0;;;3,0;;1,0;;;;;47,0;3,0;;;;3,0;;3,0;;;;;2,0;;;5,0;5,0;6,0;;2,0;;;;;;1,0;;;;;;;1,0;;;;;;5,0;;;;;1,0;;14,0;;;;;;4,0;;1,0;3,0;;;;1,0;;;;4,0;;;;;;;;;;;;;;3,0;;4,0;;;;;;;;21,0;1,0;;;;;;;;;;;;;;;3,0;;;;;;;3,0;;;;;;;;;;;;;;;7,0;;;;;;;;;;;;1,0;;;;1,0;;;;;;;;;;;;;;;;;;;1,0;;;;;;;;4,0;;3,0;2,0;;;;;;;3,0;;;5,0;;;;;;;;;;;;;;;;;;;;;;;;;;;;;;;;;;;3,0;;1,0;;;;;;;;;;;;;;1,0;;;;;;;;;;;;;;;;;6,0;4,0;;;;;;;;;;;;;3,0;;;;;1,0;;;;;44,0;;;;;;;;;;2,0;;;;;;;;;;5,0;;;;;;;;;;8,0;;;;;;3,0;;;;1,0;;6,0;;;;;;;;;;;;;;;;;;;;;;;;22,0;2,0;;;8,0;;;;;;;;;;;;;;;;;;;;;;;;;;;;;;;;;;;;;;;;;;8,0;;;;;;;;;;28,0;;;;;;;;;;;;;;;;;;;;;;;;;;;;;;61,0;2,0;;;;;4,0;;;;;;;;;;;5,0;;;;;;;;;;;;;;;;;;;;;;2,0;;;;;2,0;;;;;;;;;;;;;;;;;;;4,0;;;;;3,0;;;1,0;;;;;;;;;;;;;;;;;;7,0;;;1,0;;;;;;;;;12,0;;;1,0;;;41,0;;;;;;;;;;;;;;38,0;;;;;;;;;;2,0;5,0;;;;21,0;;;;;;;1,0;;6,0;;;;;;;;;;;;1,0;;;1,0;;;;;;;;;;;;;;;;;1,0;;;;;;;;;;;;;;;;;;;23,0;;;;;;;;;;;;;;;;;;;;;;;6,0;;;;;;;;;;;;;;;;;;;;;;;;;;;;;;;7,0;;1,0;;;;3,0;;;;;;;;;;;;17,0;;;;;;;;;;;;;;;;;;;;;;;;;;;;;;1,0;;;;;;
integrate;;;;3,0;7,0;40,0;77,0;39,0;;;;5,0;16,0;17,0;;;33,0;10,0;6,0;;37,0;;2,0;;4,0;;2,0;27,0;5,0;;49,0;10,0;3,0;3,0;;44,0;7,0;8,0;13,0;3,0;20,0;162,0;;61,0;71,0;7,0;;31,0;;;24,0;;7,0;6,0;9,0;2,0;45,0;;1,0;10,0;1,0;;;1,0;182,0;8,0;71,0;6,0;;;2,0;60,0;109,0;1,0;1,0;;6,0;10,0;;7,0;75,0;4,0;;1,0;76,0;5,0;1,0;7,0;10,0;1,0;1,0;;7,0;1,0;17,0;2,0;57,0;5,0;64,0;6,0;16,0;16,0;13,0;11,0;28,0;48,0;2,0;8,0;1,0;;1,0;3,0;10,0;;1,0;;3,0;9,0;1,0;102,0;1,0;1,0;105,0;3,0;6,0;6,0;126,0;;;3,0;24,0;5,0;2,0;57,0;;;27,0;4,0;;;;3,0;;1,0;8,0;;8,0;3,0;8,0;11,0;;4,0;29,0;8,0;10,0;5,0;;;1,0;;3,0;9,0;2,0;1,0;;;17,0;9,0;;3,0;13,0;;6,0;3,0;19,0;3,0;2,0;2,0;1,0;3,0;7,0;;2,0;27,0;;;28,0;1,0;31,0;25,0;;3,0;4,0;8,0;11,0;4,0;119,0;;;3,0;;12,0;;;12,0;1,0;8,0;;42,0;56,0;9,0;;10,0;;;10,0;43,0;18,0;;4,0;3,0;6,0;;;6,0;3,0;52,0;;2,0;3,0;;;5,0;6,0;10,0;;1,0;;;;4,0;3,0;;;;2,0;5,0;3,0;21,0;4,0;;;1,0;17,0;28,0;4,0;21,0;27,0;3,0;;2,0;13,0;;22,0;6,0;1,0;;3,0;;21,0;;1,0;10,0;3,0;4,0;;1,0;17,0;;4,0;2,0;2,0;18,0;26,0;;;3,0;6,0;208,0;;2,0;;;;2,0;1,0;;12,0;;1,0;;5,0;2,0;;2,0;4,0;2,0;10,0;1,0;15,0;;;10,0;;;;2,0;1,0;2,0;;46,0;6,0;6,0;;3,0;1,0;;2,0;10,0;3,0;;1,0;4,0;;4,0;;;;;;6,0;13,0;;;1,0;6,0;4,0;4,0;;;;;4,0;;;11,0;1,0;;31,0;27,0;1,0;4,0;6,0;;;;1,0;10,0;;1,0;;;7,0;4,0;6,0;;9,0;;5,0;;31,0;5,0;;2,0;3,0;10,0;19,0;;;;2,0;;;2,0;1,0;11,0;;;;;1,0;11,0;;12,0;3,0;2,0;15,0;8,0;7,0;2,0;5,0;4,0;;7,0;6,0;10,0;;;;;;;5,0;6,0;1,0;15,0;7,0;6,0;;;29,0;;;;6,0;;3,0;3,0;7,0;;6,0;;3,0;;1,0;2,0;9,0;;13,0;7,0;;;;;;13,0;4,0;2,0;;1,0;25,0;2,0;81,0;;2,0;6,0;;;;;;;3,0;18,0;;2,0;3,0;2,0;15,0;;1,0;;4,0;4,0;;1,0;18,0;2,0;19,0;;;;3,0;;5,0;1,0;5,0;3,0;;;;17,0;1,0;13,0;5,0;;1,0;;;;1,0;9,0;1,0;2,0;1,0;47,0;3,0;1,0;;1,0;12,0;4,0;2,0;1,0;;35,0;;2,0;1,0;;3,0;;1,0;8,0;;;;;;;;;;2,0;2,0;2,0;1,0;1,0;9,0;;;;;3,0;1,0;;;;;;6,0;1,0;1,0;1,0;;;17,0;;;;;2,0;2,0;;6,0;;4,0;;9,0;7,0;;1,0;;4,0;2,0;11,0;1,0;;4,0;4,0;4,0;;2,0;;3,0;;1,0;;9,0;1,0;2,0;;;7,0;;1,0;;6,0;1,0;4,0;;3,0;1,0;;4,0;2,0;1,0;1,0;;1,0;;;4,0;2,0;7,0;;;;;;;2,0;14,0;4,0;9,0;;;;1,0;;13,0;1,0;;1,0;;20,0;;20,0;;;41,0;1,0;2,0;;;4,0;1,0;;;;;1,0;3,0;5,0;6,0;1,0;;1,0;;;21,0;1,0;;1,0;;1,0;3,0;;1,0;;1,0;4,0;;;5,0;;;3,0;1,0;;;2,0;4,0;;1,0;2,0;;;;;;1,0;;4,0;5,0;;;;;3,0;;;;2,0;;2,0;;;;;;;3,0;;;;;2,0;;1,0;3,0;;;;5,0;;;2,0;;;14,0;2,0;1,0;2,0;;1,0;2,0;1,0;1,0;;;;4,0;1,0;;;;;6,0;;4,0;;6,0;;1,0;;3,0;;;;1,0;;2,0;;;;;2,0;2,0;;5,0;1,0;3,0;1,0;13,0;;;3,0;;;;2,0;10,0;1,0;;;;2,0;;;1,0;2,0;;8,0;;;;14,0;2,0;10,0;1,0;;7,0;;8,0;;10,0;;;;;;;;2,0;2,0;;;;;;;1,0;;;;;;;1,0;;;1,0;;;;1,0;;1,0;;;1,0;;;6,0;;8,0;1,0;5,0;9,0;;;;4,0;;;;;;1,0;;;;;;;;;;;1,0;1,0;;6,0;;;1,0;;;;;1,0;;;;;;;;;3,0;1,0;;;;1,0;5,0;;;1,0;;3,0;1,0;;3,0;;;;4,0;1,0;;;1,0;;;;;;9,0;;;1,0;;1,0;1,0;;;;1,0;;5,0;5,0;;;;1,0;;;;;;;;;;;;;;3,0;3,0;;2,0;;;;;;;;26,0;;4,0;1,0;;;;;;;3,0;;;1,0;;;1,0;;;;;;;;;1,0;1,0;;;
integration;;;;7,0;6,0;2,0;25,0;;;;;8,0;;14,0;;9,0;5,0;;8,0;;;;1,0;;;;5,0;;5,0;;12,0;1,0;2,0;;;5,0;3,0;2,0;3,0;;6,0;10,0;;2,0;;3,0;;1,0;;;;;;;3,0;9,0;;;6,0;5,0;1,0;;4,0;;27,0;;19,0;3,0;;;;2,0;20,0;;;;;;;1,0;27,0;;2,0;;2,0;;;6,0;;2,0;15,0;;1,0;;;;48,0;3,0;16,0;;;15,0;;;3,0;2,0;;3,0;1,0;;;10,0;;;;3,0;;4,0;5,0;9,0;;;25,0;;;3,0;17,0;;;;136,0;2,0;;3,0;;1,0;7,0;;;;;2,0;;;;;;;6,0;;;3,0;;;;21,0;;;;;;2,0;;;;;;1,0;3,0;1,0;7,0;;;2,0;;;;;4,0;;;;;;;;2,0;;7,0;1,0;;;;;2,0;;;1,0;;;;;;;;4,0;;;1,0;1,0;;;11,0;;;;10,0;;;4,0;;29,0;;;;;2,0;;;;;6,0;4,0;;1,0;;;;;;;;;;;1,0;2,0;;;;;;;1,0;3,0;1,0;;;;;1,0;;;;;;;7,0;6,0;;;;2,0;1,0;;;;;;;;;;;;;;;42,0;;;;;;;;3,0;;;;;;;1,0;;;;;;6,0;;;;;;;;;;;1,0;1,0;;;;;;;7,0;;;;;;;;;;;;;;;;;;;;;;;;;;;;;;3,0;;;;;;;;;2,0;;;;;14,0;;5,0;;;;5,0;;15,0;;1,0;;;1,0;31,0;2,0;;1,0;;;;1,0;;3,0;;;;;;;14,0;;5,0;;;;;;;;;1,0;7,0;4,0;;;;;;3,0;;11,0;5,0;1,0;;;;;9,0;;2,0;;;;;;;;4,0;;;;;2,0;;;1,0;2,0;;2,0;;;;;4,0;2,0;;;1,0;6,0;6,0;;3,0;;;;;;;;1,0;1,0;;;;;1,0;2,0;;;;;;;;;2,0;;;;2,0;;;;;;;;;;;;;;1,0;;;;;;;;;12,0;;4,0;;;;;;;;1,0;;;;;;;;;;;;;;;3,0;;;;;;;;;;;;;;;4,0;;;;;;;;;8,0;;;;;1,0;;;;;;;;;;2,0;;;;;2,0;;;;;;;;2,0;;;;;;;;2,0;;;;;;;3,0;4,0;;;;;;;;;;;;;;17,0;2,0;;;;;;;;;;;;;;;;14,0;;;;;;;;;;;;;9,0;;;;;;25,0;;;;;;;;;;;;4,0;2,0;;;;1,0;;;;;;;;;;6,0;;;;;;;;;;;;;;;;;;5,0;1,0;;;;;;;;;;;;;;;;;;;;;;;;;;;;;;;;;;;;;;;;;1,0;;1,0;;;;;;;;;;;;;;;;;;;;;;;;;;;;;;;;;;;;;;;;;5,0;;17,0;;2,0;2,0;;;;;;;1,0;;;7,0;;;2,0;;;1,0;9,0;;17,0;3,0;6,0;;2,0;;;;;;;;2,0;2,0;;;;;;;;;;;;;;;;;;;;;;;;;;;;;6,0;2,0;;;5,0;;;;;;;;;;;;;;;;;;;3,0;;1,0;;2,0;;;;;;;;;;;;;;;;;;;;;;;;;;;;;;;;2,0;;;;;;;;;;;;;;;;;;;;;;;;;;;;2,0;;;;;;;;;;;;;;;;;3,0;3,0;;1,0;10,0;;;;;;;;;;;;;;;;;;;;;;1,0;;;;;;;;;;;;;;;
intensity;;;;31,0;4,0;29,0;94,0;4,0;;;;28,0;;98,0;12,0;10,0;39,0;17,0;3,0;2,0;;;75,0;;;;;33,0;3,0;8,0;42,0;10,0;11,0;3,0;;64,0;25,0;1,0;32,0;4,0;175,0;29,0;;10,0;48,0;;;41,0;1,0;4,0;9,0;;;;54,0;;11,0;;17,0;48,0;;9,0;10,0;;442,0;2,0;50,0;32,0;5,0;;;12,0;720,0;;;13,0;;68,0;;9,0;98,0;;6,0;6,0;16,0;;;40,0;2,0;2,0;17,0;;13,0;;11,0;;433,0;6,0;117,0;14,0;40,0;62,0;;5,0;16,0;25,0;3,0;5,0;;;;29,0;33,0;3,0;;35,0;7,0;66,0;26,0;65,0;24,0;2,0;98,0;8,0;30,0;40,0;51,0;;5,0;;57,0;9,0;;38,0;9,0;;17,0;1,0;;;;2,0;;3,0;3,0;4,0;8,0;7,0;38,0;;;2,0;1,0;;;2,0;;;;;;3,0;7,0;2,0;;;;3,0;14,0;8,0;16,0;;;7,0;;2,0;3,0;30,0;3,0;;3,0;5,0;8,0;3,0;;;41,0;1,0;52,0;1,0;;;;;;;;24,0;1,0;;;;5,0;;103,0;1,0;1,0;;;1,0;1,0;1,0;;;;2,0;46,0;;1,0;4,0;22,0;1,0;;;;;10,0;;1,0;7,0;;60,0;33,0;25,0;;;11,0;7,0;;24,0;;19,0;;;;20,0;4,0;8,0;5,0;;;;;;;;4,0;8,0;5,0;8,0;;7,0;2,0;1,0;;;8,0;58,0;8,0;;;;;14,0;;;1,0;12,0;1,0;5,0;;1,0;3,0;3,0;;;;;1,0;;1,0;7,0;;;;;32,0;5,0;;;;;;;;;;;1,0;18,0;;;;;2,0;;4,0;;2,0;;4,0;40,0;;6,0;;;2,0;;7,0;;;;;1,0;12,0;;;;;;;;;;;;3,0;7,0;1,0;;;;10,0;;;;7,0;1,0;10,0;1,0;;;;1,0;4,0;12,0;12,0;3,0;;3,0;;;31,0;8,0;39,0;5,0;;;19,0;5,0;23,0;7,0;3,0;;8,0;83,0;6,0;127,0;1,0;5,0;83,0;1,0;6,0;4,0;;21,0;1,0;19,0;9,0;7,0;;28,0;4,0;26,0;2,0;18,0;;4,0;4,0;;;1,0;1,0;;3,0;;;;;;;3,0;8,0;;1,0;42,0;;3,0;;;10,0;;11,0;6,0;;;;;2,0;;22,0;2,0;171,0;;;1,0;;;2,0;2,0;2,0;3,0;4,0;;;;1,0;;;4,0;12,0;1,0;;1,0;;;6,0;;;;;2,0;8,0;;1,0;;13,0;;;1,0;33,0;;;8,0;9,0;;10,0;;;2,0;;6,0;16,0;;3,0;;1,0;;;;;;2,0;;42,0;;;;;4,0;29,0;106,0;;;11,0;;;3,0;;;;;3,0;;;1,0;;5,0;;4,0;;;;;;;14,0;;2,0;4,0;;1,0;;2,0;;;;;;;;;;2,0;;2,0;;6,0;;;;;;15,0;;;2,0;;11,0;;;;;;3,0;2,0;22,0;;1,0;;16,0;;17,0;;;;;;1,0;4,0;;;;30,0;;;;1,0;1,0;;1,0;;;15,0;;;;16,0;12,0;;;1,0;7,0;;;;;;;3,0;;;;;;3,0;;;;;;;;;;;;;;3,0;;13,0;;;2,0;3,0;;;;;;;;;5,0;;2,0;;70,0;10,0;;;1,0;;8,0;;;;;;65,0;;;;;19,0;;10,0;73,0;;;;;3,0;;28,0;4,0;;1,0;;2,0;;;;;;;9,0;;;2,0;;7,0;;;;;;;6,0;;4,0;;8,0;;23,0;;;1,0;36,0;;;;;2,0;3,0;;;10,0;;;;;1,0;7,0;;;;;;7,0;1,0;;;;6,0;;20,0;1,0;;;2,0;;1,0;1,0;;9,0;;;2,0;;;;;;;;;;;13,0;;6,0;;;;;;;;2,0;;;7,0;2,0;26,0;;2,0;;;2,0;;4,0;;2,0;;1,0;;;;;;;19,0;;3,0;;17,0;;4,0;;;14,0;1,0;8,0;;3,0;;;4,0;;6,0;;;;;1,0;;4,0;;;;3,0;;2,0;;;2,0;;;;;;;3,0;;3,0;8,0;1,0;;3,0;1,0;2,0;4,0;3,0;;3,0;;4,0;1,0;;10,0;;;;30,0;8,0;;13,0;1,0;;;10,0;;;;;1,0;3,0;;;1,0;2,0;;;;;;;;4,0;;;;1,0;;;;;;;;;;;;;3,0;;2,0;;;5,0;4,0;1,0;;;;;;;;;;;;;9,0;5,0;;;;;1,0;;;;;;;;1,0;;;;;;1,0;;;;;;;;;;4,0;1,0;2,0;;3,0;13,0;;1,0;;2,0;2,0;;;;;;;3,0;1,0;9,0;3,0;;7,0;;;9,0;;;;;;5,0;;1,0;;;16,0;;;2,0;;;
interest;;;;32,0;18,0;32,0;15,0;4,0;4,0;;;;;147,0;;;127,0;;;6,0;;16,0;6,0;4,0;3,0;;;;48,0;4,0;40,0;11,0;4,0;;;128,0;85,0;4,0;66,0;;171,0;46,0;;2,0;36,0;6,0;3,0;11,0;;6,0;9,0;;1,0;;148,0;2,0;8,0;;3,0;52,0;1,0;;4,0;;663,0;3,0;123,0;2,0;;;1,0;10,0;48,0;;;;;21,0;2,0;3,0;225,0;;4,0;22,0;26,0;1,0;;11,0;;4,0;18,0;15,0;3,0;10,0;;;35,0;4,0;113,0;256,0;188,0;22,0;;11,0;12,0;54,0;5,0;8,0;;;;32,0;837,0;4,0;;6,0;15,0;71,0;111,0;74,0;12,0;;13,0;34,0;2,0;43,0;161,0;;;;46,0;;2,0;13,0;6,0;;202,0;4,0;18,0;;;1,0;1,0;;;23,0;281,0;4,0;45,0;4,0;;;;;1,0;;;;;;;5,0;8,0;1,0;;;;1,0;;16,0;4,0;;1,0;47,0;;7,0;;2,0;4,0;;1,0;1,0;;8,0;;;6,0;;95,0;5,0;;2,0;;4,0;;;1,0;;;;;6,0;9,0;2,0;10,0;6,0;;;;3,0;24,0;8,0;;;;;5,0;2,0;;4,0;18,0;6,0;7,0;;;;64,0;;1,0;2,0;;2,0;25,0;3,0;3,0;2,0;8,0;;;18,0;;;;;;131,0;;;4,0;;;;;6,0;;;3,0;22,0;6,0;;;1,0;17,0;52,0;;;1,0;2,0;8,0;5,0;4,0;;2,0;3,0;;;3,0;5,0;;3,0;;15,0;2,0;;3,0;;1,0;;1,0;8,0;;3,0;;;11,0;;47,0;1,0;;1,0;;;;1,0;1,0;;5,0;3,0;;11,0;;;1,0;;;;34,0;9,0;;2,0;3,0;602,0;2,0;43,0;;;;;7,0;2,0;;;;;6,0;4,0;;;;;;4,0;1,0;;7,0;1,0;4,0;2,0;;;2,0;;;;88,0;3,0;16,0;1,0;112,0;2,0;12,0;;;14,0;;1,0;14,0;;;;;;2,0;24,0;26,0;13,0;;65,0;28,0;16,0;54,0;28,0;;15,0;4,0;116,0;;5,0;9,0;217,0;6,0;2,0;63,0;36,0;;5,0;;181,0;25,0;5,0;;43,0;2,0;15,0;;115,0;16,0;11,0;23,0;2,0;13,0;16,0;4,0;7,0;23,0;23,0;;;;4,0;;2,0;;4,0;4,0;53,0;1,0;41,0;;;1,0;;17,0;;2,0;;7,0;157,0;2,0;2,0;5,0;1,0;10,0;3,0;;11,0;7,0;1,0;90,0;;5,0;;2,0;;;;;2,0;;1,0;19,0;2,0;1,0;11,0;65,0;2,0;;3,0;2,0;6,0;41,0;3,0;8,0;1,0;;;;;;8,0;1,0;3,0;4,0;24,0;4,0;;24,0;9,0;3,0;6,0;2,0;;;33,0;1,0;;4,0;2,0;;;;6,0;;2,0;3,0;7,0;5,0;;;3,0;3,0;6,0;9,0;;2,0;;;2,0;;;;;;11,0;4,0;2,0;;;;2,0;;5,0;;;6,0;6,0;9,0;;9,0;22,0;21,0;3,0;;;2,0;5,0;;;;3,0;;;4,0;1,0;1,0;9,0;;5,0;;;;2,0;10,0;4,0;10,0;3,0;8,0;33,0;2,0;1,0;16,0;1,0;;;11,0;7,0;;2,0;;;;;4,0;1,0;;;;;;3,0;;;;2,0;;;;;8,0;;3,0;;6,0;125,0;;8,0;;;4,0;;3,0;;7,0;1,0;1,0;;2,0;2,0;;;1,0;;;;;;2,0;;1,0;23,0;;3,0;;3,0;;;;2,0;;;;1,0;6,0;2,0;5,0;;16,0;;;7,0;;;2,0;1,0;1,0;3,0;20,0;1,0;8,0;7,0;;;2,0;4,0;9,0;;;;;;6,0;;3,0;;;5,0;;2,0;92,0;11,0;;1,0;;1,0;;2,0;6,0;;;;;;;;;1,0;18,0;;;;1,0;;4,0;2,0;;;;;;;;;;;;9,0;;1,0;;;;;;1,0;11,0;2,0;1,0;11,0;6,0;10,0;;;1,0;7,0;46,0;;14,0;;15,0;;2,0;;;;;;4,0;5,0;;3,0;;;;;;;;;;;;;;;;;;;24,0;;4,0;3,0;2,0;;;;;;;;;;;2,0;;4,0;;;;;;;5,0;;;;;;;;2,0;;;1,0;;;;2,0;8,0;3,0;;3,0;;;;13,0;;;9,0;1,0;;4,0;6,0;;;1,0;;2,0;;;;;4,0;;;;;;;;;;;3,0;2,0;1,0;1,0;3,0;4,0;2,0;6,0;1,0;;;;;3,0;;1,0;;15,0;16,0;2,0;1,0;;3,0;;;;;2,0;3,0;;5,0;3,0;2,0;;1,0;;19,0;;;5,0;3,0;;1,0;;;2,0;;4,0;;2,0;;;;3,0;;;;;1,0;;;;1,0;;1,0;;;;;8,0;;;;;;3,0;6,0;;;;;;2,0;;;;4,0;;;;;;;;;;;;;;;;1,0;5,0;;;;1,0;;5,0;;13,0;;1,0;;;6,0;;;2,0;;;;;2,0;1,0;;1,0;27,0;13,0;;;;1,0;;;;;3,0;;;;15,0;;;;;;;;;4,0;;;;;
internet;;;;1,0;;7,0;;;;;;;;13,0;;;31,0;1,0;;;;;3,0;21,0;14,0;;;3,0;6,0;;11,0;2,0;;1,0;;12,0;1,0;1,0;;;6,0;343,0;;6,0;12,0;;;;;;;;;8,0;;;2,0;;1,0;;;;;;107,0;;5,0;;;;;2,0;2,0;;1,0;;;;2,0;1,0;49,0;;23,0;4,0;;;;;;;;;;;1,0;;;;4,0;7,0;;;;;1,0;2,0;;37,0;;;;;;;;;1,0;;;;;;;;;3,0;45,0;;;;;;;2,0;;;;;3,0;;;;;;;;1,0;2,0;47,0;;;;;;;;;;;;;39,0;2,0;;;;4,0;;;;;;276,0;;;;;;;;;;;4,0;;;;;6,0;;;;;;;3,0;1,0;;;;;;;;;35,0;;;;;;;;;;;2,0;;;;1,0;;;;;;;;;;;;;;;;;;;;;;;;;;;;;;;;1,0;;;;;;;;2,0;39,0;;;;;;;;1,0;;3,0;;1,0;;;;;;1,0;;;;;;;;3,0;;;;;;;;;;;;;;;;;;;;;;2,0;;;;;;;;;1,0;;8,0;;;;;;2,0;;2,0;;;;;;;;;;;;;;;;;;;;;;;;;;;;;1,0;55,0;16,0;;;;;;;;;;2,0;;;;7,0;;;;1,0;;;12,0;;;;;9,0;;;2,0;;;42,0;;;5,0;2,0;;3,0;;;;1,0;7,0;;;6,0;;;;;;;;2,0;2,0;;;;;;;;;;1,0;37,0;10,0;3,0;;;;1,0;1,0;3,0;;;13,0;;3,0;;;2,0;2,0;;;;;;20,0;;;;;;;;;;;3,0;;;;3,0;;;;;;;3,0;;3,0;8,0;;;;1,0;;;;;;;;;3,0;;2,0;;;;;;;;;3,0;;;;13,0;;4,0;;;;;;1,0;18,0;;;;;;;;;;24,0;;;;;;;;;;;;;;;4,0;;;;;;;;;;1,0;;;1,0;;;;;;;;;;;;1,0;;1,0;;3,0;;;14,0;24,0;;2,0;;6,0;;;;;;;;;;;;;;;;2,0;;66,0;11,0;;1,0;;;;4,0;;;;;;;;3,0;;;;;;;;;;;;;;;;;;;;;;;;3,0;;;;62,0;;6,0;;;;;7,0;3,0;;;;10,0;;;45,0;;;;;;;;;;;;;5,0;12,0;1,0;;;3,0;;;2,0;1,0;;;;;;;;6,0;;;;4,0;3,0;;;;;;;;;;;2,0;;;;;;;1,0;1,0;;;;;;;;;;;11,0;;;1,0;;;;2,0;;;;2,0;;;;;;;1,0;;;;1,0;;;;;;;;;;;;;;;;;;;;;;;;;;;;;;;;;;;;;;;;;;;;;;;;;;;;;;;;;;;;;;;;;;;;;;;;;;;1,0;;;;;5,0;;;;;;;3,0;;;;;;;;;;;;;;;;;;;;;;;;;;;;;;;;;;;;;;;;;;;;;;;5,0;;;;;2,0;;;;;;;;;;;;;;;;;;;;2,0;;;;3,0;;3,0;;;;2,0;;;;;;;;;;;;;;;;;;;1,0;;;;;;;;;;;;;;;;;;;;;;;;;;;;;;;;;;;;;;;;;;;;;;;;;;;;;;;;;;;;;;;;;;;;;;2,0;;;;;;
intersection;;;;3,0;;5,0;12,0;;;;4,0;;;36,0;;;11,0;;;;;5,0;2,0;;;;2,0;8,0;;8,0;11,0;;2,0;;;14,0;21,0;2,0;;;54,0;10,0;;;21,0;6,0;;5,0;1,0;;4,0;;12,0;3,0;15,0;4,0;14,0;;;5,0;;;;;84,0;;11,0;;;1,0;4,0;14,0;19,0;;;;;;;;23,0;;;6,0;;;;12,0;;;2,0;;15,0;;;;5,0;72,0;28,0;228,0;31,0;1,0;1,0;4,0;;4,0;;;1,0;3,0;;9,0;18,0;;;;;9,0;4,0;7,0;1,0;;8,0;2,0;;3,0;13,0;;10,0;;1,0;;;6,0;;;7,0;3,0;;;;2,0;;;2,0;1,0;5,0;;1,0;;;;4,0;;;;;;;;;13,0;;2,0;;;;;;4,0;;;26,0;;;8,0;;;2,0;;;3,0;;1,0;;;;;7,0;3,0;;;;;;;15,0;1,0;;;;;;;3,0;2,0;23,0;;6,0;3,0;;1,0;5,0;;;;;8,0;;;6,0;1,0;;;;;6,0;;4,0;;1,0;4,0;;;2,0;;;1,0;;;;;;;;;;;8,0;;1,0;;;3,0;;;2,0;28,0;;;;;;6,0;3,0;;;;;;;1,0;;;2,0;;;13,0;;;;6,0;41,0;4,0;;;;;6,0;;;;;;;1,0;34,0;;;;;;;;;;;;1,0;7,0;;;;;;;18,0;;;;;58,0;1,0;3,0;3,0;;;;;;;;;;;;10,0;;;;;3,0;2,0;;;;2,0;2,0;;;;;4,0;;;;;;3,0;;;;;;;1,0;;;;1,0;;;50,0;16,0;;;;;3,0;;4,0;13,0;;;;16,0;;;;;;;3,0;;;;;10,0;2,0;;;;;;;16,0;;6,0;;4,0;;;;;1,0;2,0;;;;2,0;;;;;2,0;1,0;;;;;;;2,0;;;;;;;;;;;1,0;;;;3,0;;;;;;1,0;;;;1,0;;;2,0;;;;;;;;;11,0;;;;;;1,0;6,0;;;;;;;;;;4,0;;;;;;;;;1,0;12,0;;;1,0;;;;;11,0;;4,0;;;;;;;;;;;2,0;;;;;;2,0;;;;;;;;;;;1,0;;;;;;;;3,0;;;;;;;;;;;;;;;;2,0;;;;;;;;;;;;;;;;1,0;;;2,0;;;;;;1,0;;;;;;;;;;2,0;;;;;3,0;;;;;13,0;;;;;;;;;1,0;2,0;;;;;;;;;2,0;2,0;;;10,0;;;;;;;;;;;;1,0;;;;;1,0;;4,0;;;;2,0;;;;;;;;;;;;;;;;;;;;;2,0;;3,0;;;;;;7,0;;;;;;;;;;;;;;;;;;1,0;10,0;;;;;;1,0;8,0;;;;;;;;1,0;;;2,0;;;2,0;;;;;;;;;;4,0;;;;;;3,0;;;;3,0;;;;13,0;;;;;;;;;;;;;;4,0;;;;44,0;;;;;2,0;;;;;2,0;;12,0;;;;;;;;;;;;;;;;;;;;1,0;;;;;;;;;;;;;;;;;;;;;;;2,0;;;4,0;;;;8,0;;2,0;;;;;1,0;;;;;;;;;;;;;;;;;;;4,0;;;;2,0;;1,0;;1,0;;;;;;;;;;;;;;1,0;7,0;;1,0;;;1,0;;3,0;4,0;;;;;;;;;;1,0;;;;;;;;;;;;;;1,0;;;;;;9,0;;;;;;;;;;;;;;;;;;;;4,0;;;;;;;;;;;;;2,0;;;;;;;;;;;;;;;;;;;;;;;;;;1,0;2,0;;;;;;;;2,0;;;;;5,0;;;;;;;4,0;;;;1,0;;;;;;
interval;;;;39,0;3,0;7,0;;3,0;;;3,0;1,0;;48,0;;14,0;124,0;;;;2,0;4,0;6,0;1,0;7,0;;;4,0;7,0;7,0;32,0;10,0;;1,0;;38,0;9,0;1,0;19,0;1,0;81,0;44,0;;7,0;10,0;9,0;;;;2,0;6,0;7,0;;5,0;1,0;;16,0;;11,0;13,0;2,0;;35,0;;183,0;;12,0;4,0;8,0;;28,0;79,0;26,0;;;;;2,0;;3,0;71,0;;6,0;;13,0;;;13,0;;8,0;34,0;;;2,0;10,0;1,0;44,0;11,0;40,0;16,0;26,0;158,0;;7,0;31,0;17,0;1,0;1,0;;;;8,0;24,0;;;;;;3,0;33,0;10,0;;83,0;2,0;24,0;2,0;59,0;2,0;1,0;;526,0;2,0;;35,0;;;3,0;2,0;4,0;;;14,0;;;3,0;6,0;19,0;17,0;28,0;;32,0;1,0;5,0;;1,0;1,0;9,0;;;;2,0;2,0;;;1,0;;3,0;2,0;;2,0;;;;26,0;;2,0;;;;;7,0;;2,0;6,0;;2,0;;;152,0;1,0;;;;1,0;1,0;;9,0;2,0;;;;10,0;7,0;;2,0;10,0;9,0;5,0;;2,0;5,0;2,0;;;;5,0;7,0;;;;7,0;41,0;2,0;;1,0;;27,0;;;3,0;;13,0;26,0;19,0;1,0;;;1,0;;8,0;1,0;6,0;;;;48,0;4,0;;6,0;;;;;6,0;7,0;1,0;5,0;25,0;;1,0;;8,0;7,0;5,0;;;4,0;21,0;6,0;;;;1,0;;;;;12,0;15,0;3,0;;;5,0;;;;;9,0;;;9,0;;;;;;10,0;;;;;;1,0;;;;;3,0;;30,0;1,0;;1,0;;;;9,0;;;;9,0;12,0;2,0;4,0;;2,0;2,0;;22,0;;3,0;;;;13,0;;;;;;2,0;;;;;;;23,0;;2,0;;;8,0;;1,0;;12,0;;15,0;1,0;2,0;;;;2,0;;;2,0;;;;;20,0;8,0;11,0;1,0;4,0;2,0;;2,0;22,0;;5,0;;;10,0;2,0;10,0;;22,0;5,0;3,0;7,0;4,0;1,0;6,0;;7,0;2,0;;1,0;3,0;;4,0;6,0;8,0;;;10,0;1,0;;;;4,0;24,0;3,0;;;;1,0;14,0;3,0;;5,0;;20,0;2,0;6,0;20,0;1,0;7,0;2,0;54,0;;8,0;8,0;1,0;7,0;1,0;1,0;;3,0;36,0;;;8,0;;1,0;5,0;3,0;;2,0;9,0;2,0;;;1,0;;;;12,0;;;;;;;1,0;;;6,0;;12,0;;;;3,0;;1,0;;;1,0;56,0;1,0;;;14,0;;1,0;1,0;3,0;3,0;;3,0;6,0;9,0;4,0;;1,0;;;4,0;;3,0;;15,0;;1,0;6,0;;38,0;3,0;;;;2,0;;3,0;1,0;;1,0;2,0;;;;;;;;;;;;;4,0;;;;2,0;4,0;;3,0;4,0;3,0;;1,0;;4,0;;;;;;;;1,0;;2,0;;;;27,0;3,0;;3,0;;1,0;;;1,0;;;;4,0;;;;3,0;;3,0;;;;;;;;;;2,0;;;5,0;2,0;;;;;;;;;;3,0;;;;;27,0;;;;;2,0;;;;11,0;;1,0;;;14,0;9,0;;;;;;;;;;1,0;;;;;;2,0;;;;;;;;;;;3,0;;1,0;;;1,0;;;38,0;;;1,0;;1,0;9,0;;;;;;5,0;1,0;;4,0;1,0;7,0;;1,0;2,0;;1,0;;;12,0;;1,0;1,0;;7,0;;;;11,0;;;4,0;8,0;10,0;;;;1,0;4,0;2,0;9,0;;;;;1,0;;;1,0;;;19,0;;;;7,0;;4,0;;;;;;;;;;;;;5,0;;;;;;13,0;;;;;;;;;1,0;;;;;;;1,0;4,0;;;;;;1,0;;;;3,0;;;10,0;;1,0;;;;2,0;;;6,0;;;;;;8,0;;4,0;6,0;2,0;;;;;;;;;;;;;;28,0;;;;;21,0;;;;;;;7,0;5,0;;;;;8,0;;;1,0;;;;;;;;;;;;3,0;10,0;;;;;;;;;;2,0;;;10,0;;5,0;;;;8,0;;15,0;;;2,0;;;;;;;1,0;;2,0;;6,0;5,0;2,0;;3,0;1,0;;;;;;;;;;;;;;1,0;;;;;;;;1,0;;;1,0;;;;;;;;;;;10,0;;;;;;2,0;;;;;;;5,0;8,0;;2,0;5,0;;;;3,0;;;;;;;;4,0;;5,0;;;;2,0;;;;;1,0;;;;;;;;;3,0;1,0;;;1,0;;;;;;;;35,0;;3,0;;;;;;6,0;;;;;;;;5,0;;;1,0;;;;;;
iris;;;;16,0;;8,0;;2,0;;;;;2,0;18,0;;;39,0;1,0;;12,0;;;5,0;3,0;4,0;;;;;1,0;22,0;6,0;;;40,0;16,0;1,0;;1,0;;24,0;38,0;4,0;2,0;1,0;3,0;;5,0;;;;1,0;1,0;1,0;6,0;2,0;1,0;;;16,0;;;;;147,0;2,0;23,0;;;;2,0;53,0;83,0;51,0;;;;;;1,0;26,0;;4,0;5,0;2,0;;;19,0;2,0;6,0;4,0;;1,0;;;;;10,0;;;15,0;2,0;;3,0;2,0;3,0;;;;;1,0;12,0;5,0;;;;;1,0;5,0;16,0;;2,0;16,0;7,0;3,0;17,0;55,0;3,0;;;18,0;;;8,0;2,0;;1,0;;21,0;;;;;2,0;2,0;;;;;;;2,0;4,0;;;;;;;;;1,0;;;;;1,0;;;5,0;;;;12,0;;;1,0;;2,0;;1,0;;;1,0;;;25,0;;;2,0;;1,0;;1,0;;;;9,0;;;;3,0;1,0;;3,0;2,0;;;1,0;4,0;;3,0;;;;;4,0;;;;14,0;;4,0;;2,0;;8,0;;;;;;1,0;;;1,0;42,0;2,0;;1,0;;;;;;28,0;;;2,0;;;;;6,0;;;;12,0;2,0;;;16,0;;;;;;25,0;;1,0;;;;;;6,0;3,0;17,0;;;;;;4,0;;;;4,0;;;;;;;3,0;;1,0;;;;;3,0;;;;;;3,0;;5,0;;;;;1,0;;4,0;;;;6,0;;;3,0;;;;;;;;;;;1,0;;;;;;1,0;;;;;;;;;;;;;;1,0;;;;13,0;;2,0;;;;;14,0;7,0;2,0;;;;;;8,0;3,0;1,0;2,0;;17,0;;42,0;;;;1,0;6,0;;;;;;1,0;2,0;21,0;2,0;;;8,0;1,0;;;;4,0;;;2,0;;;;3,0;;;;;1,0;;;;;;;;;;;17,0;3,0;11,0;;;;;15,0;1,0;;;;;;;;3,0;1,0;2,0;;;;;18,0;;;4,0;;;;;;;;2,0;4,0;;;1,0;;1,0;;;;7,0;;;1,0;1,0;;;;;;;;;;;2,0;;7,0;2,0;;;;;;;;;;;;;;;;;;;;;;;;;;;;;;5,0;;2,0;;2,0;;;;;;;2,0;;;;;;;;;;;16,0;;;;6,0;;;;;;;;;68,0;;;;;2,0;1,0;1,0;;;;;;;;;;2,0;;;;;1,0;;;;;1,0;;;;;1,0;;3,0;;;;;11,0;;;;;;;;;;;1,0;7,0;;;;;;;;;;1,0;;;3,0;1,0;;;;;;1,0;;;;;;;;;;;;;;;;;1,0;;;;;;;;;;1,0;;26,0;;;;;;;;;;;;;;;;;;7,0;;;2,0;;;;;;1,0;;;;6,0;;1,0;3,0;;;;;;1,0;;;3,0;;;;;;;;2,0;3,0;;;;;;;;;;;18,0;5,0;;;2,0;;;;;;3,0;;;;;;;;;2,0;;;;9,0;;;;;;;;;13,0;;;10,0;;;;;;;3,0;;;;;;;;;;;;;;;;;;;;;;;;;;;6,0;2,0;;;;;;;;;;;;;;;;;2,0;;;;;;;;;;;;;;;;;;;;;1,0;;;1,0;;;;;;;;;;;;;;2,0;;;;;;;;;;;;;;;;;;;;;17,0;;;;;;;;;;;;10,0;;;;;;3,0;;;;;;;;;;;;;;;;;;;;;;;;;;;;;;;;;2,0;;;;;;;;;2,0;;;;;;;20,0;;;;;;;;;;;;;;;;;;;;;;;;;2,0;;;;;;;;;;;;;;;;;;;;;;;;;3,0;;;;;;;;;;;;;;;;;;;;;
item;;;;10,0;2,0;14,0;1,0;;3,0;;;;;36,0;;2,0;29,0;;;16,0;;;13,0;;;;;;8,0;4,0;39,0;2,0;1,0;9,0;;80,0;2,0;2,0;4,0;;68,0;40,0;;;68,0;3,0;;;;;6,0;;;;6,0;;3,0;;;22,0;;;1,0;;131,0;;55,0;;1,0;;4,0;;10,0;;;;;;6,0;2,0;35,0;;;;5,0;;;6,0;1,0;;1,0;;1,0;;3,0;;;2,0;56,0;7,0;27,0;7,0;;2,0;18,0;7,0;1,0;13,0;;2,0;;3,0;14,0;;;14,0;4,0;4,0;1,0;7,0;;;6,0;19,0;;11,0;16,0;;;9,0;10,0;;;4,0;1,0;;31,0;;4,0;;;1,0;;;;1,0;12,0;1,0;20,0;;;;9,0;12,0;;;;;;;;;26,0;3,0;1,0;;;3,0;2,0;1,0;;;13,0;5,0;;13,0;;;13,0;;;;;3,0;9,0;;14,0;;;;;;;;;;2,0;;;2,0;;;;;;3,0;5,0;;1,0;4,0;2,0;9,0;;;;;6,0;;8,0;;;1,0;10,0;;7,0;;35,0;;1,0;;;;4,0;2,0;;1,0;1,0;7,0;;4,0;;;;;;40,0;1,0;3,0;3,0;;2,0;;;;;;;;;;;2,0;3,0;3,0;;;;;4,0;1,0;;;;1,0;5,0;;1,0;6,0;;;;;2,0;;;;;1,0;;;;;;;;2,0;;;;1,0;;;;;;;;;1,0;;;;;;1,0;;4,0;;;;3,0;46,0;3,0;13,0;1,0;;;;2,0;;;;;;5,0;;;;3,0;;;1,0;;;;11,0;;;;;;;3,0;;;;;;27,0;1,0;1,0;;;3,0;2,0;2,0;3,0;;;;;;8,0;2,0;;3,0;;3,0;1,0;1,0;17,0;3,0;;4,0;4,0;13,0;;2,0;;;;9,0;1,0;35,0;;6,0;2,0;36,0;5,0;2,0;;20,0;;;;22,0;;4,0;4,0;;;3,0;;2,0;13,0;;;;2,0;2,0;12,0;7,0;;1,0;;14,0;;1,0;;;1,0;;13,0;;2,0;;8,0;2,0;5,0;;;;;;;6,0;;;35,0;;;;1,0;2,0;;;1,0;5,0;;;2,0;1,0;;4,0;;;;3,0;;;;;9,0;15,0;;;;;;;;1,0;;5,0;;;1,0;5,0;5,0;1,0;;;;;;;1,0;4,0;;;;5,0;1,0;1,0;;3,0;;2,0;4,0;;;;;;;;;1,0;1,0;;;;;;;;;;;;;;;29,0;;;;;;;2,0;;;3,0;2,0;;;;;9,0;1,0;;1,0;2,0;16,0;20,0;;;;;;5,0;;;3,0;;;;;2,0;;;;;15,0;12,0;;1,0;;;;;1,0;;4,0;;;3,0;8,0;;;1,0;;;;;;4,0;;;;;;;;4,0;;;;;;;;;;;1,0;12,0;8,0;1,0;3,0;;;;;;;;3,0;;;;;2,0;;;;;;;;;;;;;;;;;;;;;;1,0;;;;;2,0;3,0;9,0;;;;;;;;10,0;;;1,0;;;;;;;;;;3,0;;;;;;;;;;;;4,0;;;;;;;;;1,0;;2,0;6,0;1,0;;;;;1,0;1,0;1,0;;;;;;;;;4,0;;;;;;;;;;19,0;;;;;;7,0;;;;;;;2,0;;;;;;;;;;;;;;;;;;;;;1,0;;30,0;;;;;;;;;;;;;;;;;1,0;;;;;;;;;1,0;;;;;;;;;1,0;;;;;;19,0;;;;6,0;;;;;;;;;11,0;;;3,0;;;;;;;11,0;;1,0;;;;;;;;;;;;;2,0;;2,0;;;;;;;;;;1,0;;;;;;;;;;;;32,0;;;;;;9,0;;;;;;;;;;;;;;;4,0;;2,0;;;;;;5,0;2,0;34,0;;;;;;;;;;;;;;;;;;;;1,0;;;;;;;;;;;;;;;;;;;;;;;;;1,0;;;;;5,0;;;;2,0;;;;;;7,0;;;;;;;10,0;;;;;;;;;;;;;;;;;;;;;;;;;;;;
lamp;;;;63,0;1,0;13,0;;21,0;;;;;;11,0;;80,0;1,0;;;;;;5,0;;;;;;;;4,0;1,0;;;;;3,0;;;;68,0;16,0;;;8,0;6,0;;;;;;;1,0;;1,0;;5,0;;;;;;;;45,0;;23,0;;;;;5,0;38,0;2,0;;;;;;;16,0;;30,0;;4,0;1,0;;;;;2,0;1,0;1,0;;;;2,0;;;;;;;;;12,0;;;;;;;16,0;;;;;;;8,0;5,0;;31,0;;;;14,0;;1,0;;2,0;;;1,0;;;;;;;;23,0;;;4,0;;;2,0;1,0;;;;4,0;;;;;;;;3,0;2,0;;;;;9,0;;;;1,0;;;;;;;9,0;;;;4,0;5,0;;;;;;15,0;3,0;2,0;;2,0;4,0;11,0;3,0;5,0;;;1,0;;;;;2,0;;;2,0;;16,0;;;;;;;4,0;;;;;7,0;;;4,0;;;;;;;1,0;2,0;;3,0;;;;;2,0;;1,0;;;1,0;2,0;;;;;;;;;;;2,0;;1,0;;;;;8,0;3,0;;;1,0;;;;1,0;;;;;14,0;28,0;;;;;;3,0;1,0;;;;5,0;;;;;;;;;;;1,0;;;;;;;;4,0;;1,0;;;1,0;;;;5,0;;4,0;;;;;;;;;;3,0;;;;;;1,0;;;;;;;;;1,0;;;;;;;;;;;;1,0;19,0;;1,0;7,0;;;;;1,0;34,0;;;;;;;;2,0;;;;;2,0;7,0;13,0;;1,0;;;;;;;;;;;2,0;;;;4,0;;;;;;4,0;2,0;4,0;;;2,0;3,0;1,0;;;;1,0;;;;;;;1,0;3,0;;;1,0;1,0;2,0;;;;;;;;;;3,0;5,0;;;5,0;;;;;;;;;;4,0;4,0;3,0;;2,0;;2,0;;1,0;;;;;;;;;;;4,0;;;6,0;;;;;;;;;;;;;1,0;;;;;;;1,0;;;;2,0;;;1,0;;;;;;;1,0;;;4,0;;;;;;;2,0;;;;;2,0;;;;9,0;1,0;;;;;;;;;10,0;;;;;2,0;;2,0;;2,0;;;;;;;2,0;;;;;;;;;;16,0;;;;;;;;;;;;;;;;;;;;;;;;;;;;;;;;;;;;;;;;;;;;;8,0;26,0;;;;;;2,0;2,0;;;;;3,0;;4,0;;;;;;;;;;;;;;;;;;;;;;;;;;;;;;;;;;;;;;;;;;;;;;;;12,0;;;;;;;1,0;;;;;2,0;;;4,0;;;;9,0;;;;;;4,0;3,0;;;;2,0;;;;;;;;;;;;;;;30,0;;26,0;;3,0;;42,0;;6,0;;;;;2,0;;11,0;;1,0;;;;;;;1,0;;;;;;;;2,0;1,0;;;;;;;;;;;;13,0;;;;;;;;;;7,0;3,0;;;;;;;;4,0;;;;;;;;;;;;;;;;;4,0;;;;5,0;;;;;;;2,0;;;;;;;;1,0;2,0;;;;;;6,0;;;;;;;;;;;;;;;;;;;;;;;;;;;;;;;;;;;;;;;6,0;;;;;;1,0;;;1,0;;;;;;;;;;;;;;;4,0;;;;;;;;;;;;;;;;;;;;;;;;;;;;;;;;;;;;;;6,0;;2,0;;;;;;;;;;;;;;;;;;;;;;;;;;;;;;;;;;;;;;;;;;;;;;;;;;;;;;;;;;;;;;;;;;;;;;;;;;
lever;;;;10,0;2,0;4,0;;3,0;;;;;5,0;55,0;;;1,0;;;;;;;;;;;20,0;;;56,0;;;;;;1,0;;;;;19,0;;;2,0;14,0;;24,0;;;;;7,0;;;;8,0;;;;;;;;;;25,0;;;;2,0;12,0;1,0;;;;;;;;5,0;;1,0;;3,0;18,0;;;;2,0;;4,0;;;;;;3,0;5,0;40,0;60,0;;;;;;;;;;;9,0;1,0;;;;;4,0;;1,0;;;;;;;17,0;;;;1,0;;;8,0;;;;;;;2,0;1,0;;;5,0;5,0;;6,0;8,0;13,0;3,0;17,0;8,0;;;3,0;;;;1,0;;12,0;;;;;31,0;1,0;;4,0;;;;2,0;;;;;1,0;;;;3,0;9,0;3,0;;;14,0;;1,0;;;;;;22,0;11,0;;;5,0;;;;1,0;;;14,0;;;61,0;22,0;15,0;;;;2,0;6,0;4,0;;1,0;;;;;5,0;;17,0;;;;8,0;;1,0;;;;;;;1,0;;;2,0;2,0;;5,0;;6,0;9,0;43,0;6,0;;;3,0;;;14,0;9,0;;;1,0;;1,0;;2,0;;;;;;;;1,0;2,0;;;4,0;4,0;2,0;;1,0;;6,0;;;;;;;1,0;;27,0;;;;7,0;5,0;2,0;4,0;13,0;1,0;;5,0;;6,0;;4,0;;;1,0;2,0;;;16,0;6,0;;;108,0;5,0;12,0;;1,0;4,0;;;;;;;;6,0;;4,0;2,0;;;36,0;2,0;;17,0;29,0;8,0;6,0;6,0;;9,0;;4,0;;6,0;;2,0;;;1,0;;1,0;9,0;1,0;;;;;;;31,0;;;;;2,0;12,0;;2,0;;;;1,0;;;11,0;;;;;1,0;;;;;;;;1,0;;;;;;;;4,0;;;2,0;5,0;;;1,0;5,0;;8,0;;24,0;5,0;;;;;;;;1,0;;;9,0;;1,0;;;;;;;;;;;;;;;;10,0;;;;2,0;1,0;;;;;;1,0;;;;;;;;;;;;;;;;;;;3,0;1,0;;;6,0;;;5,0;;;;;;1,0;;;;;;;;;;;;;;;;;1,0;;;;;;;;;;;8,0;;;5,0;;;;6,0;;;;;;1,0;;;20,0;;2,0;1,0;;;;;2,0;;;;;12,0;;;;;;;;;;;;;;;;;;;1,0;;;;;;;;;19,0;;;7,0;;;;;;;;;;1,0;9,0;3,0;;;;;;;1,0;;;;;;;;;;1,0;;;;;;;;;;;;9,0;;;;;;;;;;;;;;;;;;;;;;;3,0;;;;;2,0;;;;;;;;;;;;7,0;;;;;;;;;2,0;;;;;;;;;;;;;;;;;;;;;;;;;;;1,0;;;1,0;9,0;;;;;;;;78,0;2,0;;3,0;;;;;;1,0;;;;;;;;;;;;;;27,0;;;;;;;;7,0;;;1,0;;;;2,0;;14,0;;;;;;;;;;;;;;;;;;;;1,0;11,0;;;;;3,0;;;;;;;;;;2,0;;;;3,0;;;;;;;;2,0;;;;;;6,0;;;;;;1,0;;;;;;;;;;;;;;;;;;;;;;;;;;;;;;;;;;1,0;;;1,0;;;;;;;;;;;;;;;;;;;;;;1,0;;;;;;;;;;;;;;;;;;;;;;;;;;;;;;;;;;;;;;;2,0;;;;;;;;;;;;;;;2,0;;;;;;;;;;;;;;;;;;;;;;;1,0;;;;;;;;;4,0;1,0;;;;;;;;;;;2,0;;;;;;;;;;;;;;;;;;;;;;;;;;;;;;;;;;;;;;;
linear;;;;5,0;5,0;10,0;115,0;12,0;;;1,0;1,0;1,0;36,0;;;16,0;;1,0;2,0;;;6,0;;;;;20,0;4,0;;35,0;4,0;3,0;6,0;;19,0;6,0;20,0;4,0;;39,0;49,0;2,0;3,0;;7,0;3,0;8,0;35,0;1,0;8,0;;13,0;3,0;4,0;1,0;15,0;2,0;;23,0;;;37,0;;191,0;3,0;41,0;1,0;1,0;;4,0;29,0;12,0;;;;4,0;1,0;;2,0;78,0;;25,0;12,0;14,0;5,0;;9,0;3,0;12,0;22,0;;2,0;;;;71,0;22,0;74,0;12,0;39,0;2,0;;10,0;10,0;3,0;;;;;;14,0;;;;;1,0;9,0;5,0;84,0;7,0;;17,0;;1,0;1,0;72,0;;1,0;;11,0;;;8,0;;;8,0;;26,0;;;;;;;34,0;2,0;9,0;6,0;14,0;16,0;1,0;2,0;;;;;;;;1,0;15,0;;12,0;2,0;;29,0;;;1,0;1,0;;6,0;47,0;;14,0;5,0;;2,0;;;1,0;10,0;1,0;1,0;;14,0;20,0;8,0;;;;;3,0;;1,0;4,0;;3,0;;;;;;5,0;4,0;21,0;;13,0;26,0;25,0;47,0;6,0;;;1,0;17,0;8,0;;10,0;5,0;;;;2,0;;77,0;;;4,0;;4,0;22,0;11,0;;;1,0;;;4,0;;2,0;2,0;;;18,0;15,0;8,0;9,0;21,0;1,0;;1,0;33,0;1,0;;17,0;16,0;;;2,0;;;2,0;2,0;;;;3,0;1,0;;5,0;108,0;8,0;2,0;;4,0;21,0;;11,0;;1,0;69,0;3,0;;1,0;;1,0;31,0;3,0;14,0;3,0;;;;2,0;5,0;17,0;;;;;6,0;;1,0;2,0;4,0;;;23,0;;;;;;2,0;2,0;4,0;4,0;2,0;;8,0;1,0;1,0;;;;;1,0;;;2,0;;2,0;;;;;;;9,0;6,0;8,0;1,0;;1,0;20,0;7,0;;5,0;;;6,0;1,0;18,0;;;2,0;;;;9,0;;;;3,0;1,0;9,0;;;;;8,0;;10,0;;;;;;13,0;9,0;;2,0;;18,0;;7,0;8,0;;;;3,0;1,0;10,0;66,0;;1,0;;;;25,0;3,0;;;1,0;;6,0;19,0;26,0;5,0;3,0;7,0;4,0;5,0;6,0;2,0;1,0;;;;1,0;;8,0;;16,0;;24,0;3,0;;3,0;;15,0;;19,0;1,0;;;16,0;;1,0;3,0;6,0;15,0;;11,0;;;;4,0;;;;;1,0;1,0;3,0;12,0;2,0;27,0;6,0;;;3,0;;;3,0;;;;;16,0;;4,0;;;;1,0;;3,0;9,0;;;;;3,0;15,0;;;10,0;;;2,0;6,0;;;;;;;;;2,0;9,0;7,0;6,0;;;;;;;;;1,0;;;3,0;;;;;;;;;3,0;5,0;;;4,0;;;16,0;6,0;;6,0;;;;;;2,0;2,0;;;;;;;;1,0;2,0;;;;2,0;2,0;;;;;;;2,0;;;1,0;;;;6,0;;;3,0;26,0;1,0;1,0;;;1,0;;;;1,0;;4,0;;2,0;2,0;;;;3,0;2,0;;;;;;;2,0;;21,0;;;;;8,0;1,0;3,0;;;;;;;;;6,0;;;2,0;;;2,0;6,0;;;;;;;;;;;;9,0;6,0;;;10,0;6,0;;;;;;;;;;;17,0;;;;;8,0;;;;;4,0;;;;;;5,0;;;;3,0;3,0;;1,0;9,0;;;;;;;;1,0;;;2,0;;2,0;;;;5,0;;32,0;;;;1,0;;66,0;33,0;;4,0;;;15,0;;1,0;;;;;;;;;;;10,0;;3,0;;3,0;;;;;;1,0;2,0;8,0;;6,0;1,0;3,0;;;2,0;1,0;;;7,0;;1,0;;;;;;1,0;1,0;;6,0;;;;;;;;;2,0;;;;;2,0;;11,0;8,0;2,0;;;;;;16,0;;1,0;4,0;;1,0;;3,0;;;;2,0;;;;;;;;;;;;;;;;5,0;;18,0;;10,0;;;2,0;;1,0;;;;1,0;;;;;;;;;;;2,0;8,0;;;4,0;;;;;;;;;1,0;;;;;;;;7,0;3,0;5,0;3,0;13,0;;;;1,0;6,0;2,0;;;;;;;;;4,0;;8,0;;2,0;;1,0;11,0;1,0;2,0;;;8,0;;;;;;;;4,0;;2,0;;;;;;;;6,0;;;;;;;3,0;;;;;2,0;;;;;;;;5,0;;;;;;;;;;;2,0;1,0;;;;;;8,0;;1,0;;;;;;;;;;;;2,0;;6,0;;;27,0;3,0;1,0;;3,0;;1,0;;;;;;;;;;18,0;;2,0;3,0;;;;16,0;;;1,0;;;;;;43,0;;;;;;;;;
linkage;;;;1,0;;;;7,0;;;;;;8,0;;;;;4,0;;;;;;;;;2,0;;;12,0;;;;;;;1,0;1,0;;;12,0;1,0;;6,0;2,0;;5,0;;;;;5,0;;;;1,0;;;;;;2,0;;6,0;;49,0;1,0;;2,0;2,0;3,0;2,0;;;;;;;;2,0;;;;;1,0;;;;;;;;;;;;2,0;6,0;1,0;16,0;;;;;;;;;;;;;;;;;10,0;;9,0;;;;;;;35,0;;;1,0;;;;27,0;;;;;;;;;;;1,0;;;1,0;;20,0;1,0;;;;;;;;;;;34,0;;;;;8,0;2,0;;;;;;8,0;;;;;1,0;;;;1,0;2,0;5,0;;;3,0;6,0;2,0;;;;7,0;;;1,0;;4,0;;;;;;;;33,0;;;18,0;7,0;5,0;;;;3,0;2,0;11,0;;;;;;;25,0;;13,0;;2,0;;;;;;1,0;;;;3,0;;;;;3,0;;;1,0;3,0;9,0;14,0;;;;3,0;;;5,0;1,0;;;;;;1,0;;;;;;;;;4,0;;;;4,0;1,0;;6,0;;;2,0;1,0;;;;;1,0;1,0;;3,0;;;;1,0;;;;1,0;;;1,0;;;;;;;;;;;2,0;;;1,0;3,0;;12,0;;;;;;;;;;;;;;;;1,0;;1,0;2,0;;27,0;10,0;1,0;1,0;;4,0;;;;19,0;;;1,0;;;;;1,0;2,0;;;;;;;;;;;;;;;4,0;;;;;;;21,0;;;;;1,0;;;;;;;;;1,0;;;;;;;;;6,0;2,0;;;;8,0;17,0;;;;3,0;1,0;;;;;;;;;;;1,0;2,0;;;2,0;2,0;;;;;7,0;1,0;;;;;;;;;;1,0;;;;;;;1,0;;;;;;1,0;;;;;;;;;;;;;;;;7,0;;9,0;;;;;;;2,0;;;;;;;;;;;;1,0;;;;;;6,0;;;2,0;;;;;;;;;;;;8,0;;;3,0;8,0;;;;;;4,0;;;14,0;;;2,0;;;;;;;;;;15,0;;;;;;;;;;;;;;;5,0;;;;;;;;;;;;;1,0;;;;;;;;;;;;;2,0;;;;;;;;;;26,0;;;;;;;;;;;;;;;;;;;;;;;;;;;;;;;;;;;;;;;;;;;6,0;;;;;;5,0;;;;;;;;;;;;;;;;;;;;;;;;6,0;;;;;;;;;;;;;;;;3,0;;;;;;;;7,0;;;;;;4,0;;;;;;19,0;;;1,0;;;;;;;;;;;;;;;;;;;;7,0;;;;;;;2,0;7,0;;6,0;2,0;1,0;;;;1,0;;;;1,0;;;;;;;;;;;;;;;;;1,0;;;;;;;;1,0;;;7,0;;;;;;;;;1,0;;;2,0;6,0;;;;;;;;;;;;;;;;;;;;;1,0;;;;;;;;;;;;;;;;;;;;;;;;1,0;;;;;;;;;;;;;;;;;;;;;;;;;;;;;;;;;1,0;;;;;;;;;;;;;;;;;;;;;;;;;;;;;;;4,0;;;;;;;;;;;;3,0;;;;;;;;2,0;;;;;;;;;;;;;;;;;3,0;;;;;;1,0;;;;1,0;;;;;;;;;;;;;;;;;;;;;;;;;;;;;;;;;;;;;;;;;;;;;;;;;;;;;;;;
live;;;;4,0;4,0;9,0;;;;;;;;17,0;;;62,0;;;1,0;;;42,0;6,0;9,0;;;;7,0;;30,0;4,0;2,0;;;49,0;;;4,0;;13,0;132,0;;28,0;243,0;;1,0;2,0;;;1,0;;;1,0;8,0;;2,0;;;24,0;;;1,0;;511,0;;39,0;;;;;2,0;;;;;;;4,0;1,0;55,0;;45,0;3,0;;;;3,0;;2,0;2,0;;;4,0;3,0;;2,0;;4,0;14,0;6,0;6,0;;10,0;4,0;15,0;;3,0;;;;;;3,0;;3,0;6,0;;23,0;45,0;3,0;;11,0;2,0;;9,0;25,0;;;;11,0;;;12,0;;;247,0;1,0;2,0;;;;;;;2,0;52,0;;2,0;;1,0;;;;;;;;;;;1,0;32,0;2,0;;;;;;1,0;;;6,0;;;;;;;;;1,0;;1,0;;;;;31,0;4,0;;;;;;;;;;2,0;;;;;;1,0;;;;1,0;2,0;5,0;;;;;8,0;;;;1,0;;1,0;;;;18,0;;;4,0;;;;1,0;1,0;;;1,0;;10,0;;;;;;1,0;;;;;;;;;;;2,0;;1,0;;2,0;35,0;;5,0;;;;;;;;;;;;;3,0;7,0;;;;3,0;;;;;;;;;;2,0;;;;;1,0;;;;;;;;;;;2,0;;11,0;;;;;;;3,0;;;4,0;2,0;11,0;;6,0;;;3,0;;;;;;;;35,0;;;;;;4,0;8,0;;;;;4,0;;;;;;2,0;;4,0;;2,0;;213,0;2,0;1,0;;;1,0;;;;;;;;;;1,0;9,0;3,0;2,0;2,0;5,0;;28,0;;;;2,0;9,0;1,0;;;48,0;;1,0;16,0;10,0;;;;8,0;4,0;;;12,0;;6,0;;27,0;10,0;2,0;1,0;;;8,0;;;6,0;43,0;;;;;;6,0;;;;63,0;22,0;9,0;4,0;;;;3,0;;;;;6,0;;;;;;6,0;;1,0;;;10,0;;;;1,0;;;;;2,0;;;2,0;1,0;;;46,0;;;;1,0;2,0;14,0;11,0;1,0;11,0;;;;1,0;1,0;1,0;;;;1,0;;2,0;10,0;;1,0;;;;;;;;48,0;;;;;55,0;;9,0;;1,0;;;;4,0;9,0;;;;;;;;;;1,0;;;;;;;;;;;;;10,0;;;;;;1,0;;;;2,0;2,0;2,0;;;;228,0;1,0;;4,0;;2,0;1,0;;;;;;7,0;;;;6,0;10,0;;21,0;;1,0;;;;;;;;;;;;;;;;;11,0;;1,0;1,0;;1,0;;;;1,0;;3,0;;;8,0;2,0;;127,0;1,0;;;;;;;;;4,0;4,0;;;;;;;;23,0;3,0;;;;;;;;;14,0;;;;;;;;;;;;;;;1,0;;;5,0;2,0;;;1,0;3,0;;;;;;;5,0;3,0;;;;;;;3,0;;;;4,0;;;1,0;;;1,0;;3,0;;;;;;;;;;;;;1,0;;;;;;;;;;3,0;;;;;;;;;;;;1,0;;10,0;;;;2,0;;;;;;1,0;3,0;;;;;;;2,0;;6,0;;;;;;10,0;;;;;;;;;;;;;;;;;;;;;;;;;;;;;;;;;;;;;;;;;;;;;;;;;;;;;;;;;;;;;;;;;;;;;;;1,0;;;;;1,0;;;12,0;;;;;;;;;;;;;;;;4,0;;;;2,0;;;1,0;;;;;;;;;;;;;;;;;;;;;;;;;3,0;;;7,0;;;;;;;;;;;8,0;3,0;;;;1,0;;;1,0;;;1,0;;3,0;;;;1,0;;;;;;;;;;;;;18,0;;1,0;;;;;;;;;;;;;;;;1,0;;;;;;;;;;;;;;;;;;;;1,0;;;;;;;;;;;;;;;;20,0;;;;;;;;;;;;;;11,0;;;;;3,0;;;;2,0;;;;;
location;;;;72,0;18,0;80,0;82,0;18,0;21,0;4,0;8,0;1,0;;708,0;1,0;4,0;307,0;9,0;11,0;11,0;1,0;8,0;59,0;17,0;30,0;5,0;;23,0;38,0;87,0;180,0;27,0;15,0;14,0;4,0;653,0;84,0;4,0;255,0;1,0;1209,0;789,0;4,0;27,0;281,0;49,0;6,0;48,0;14,0;8,0;142,0;;18,0;20,0;72,0;23,0;86,0;2,0;11,0;122,0;4,0;3,0;70,0;10,0;1332,0;1,0;262,0;5,0;37,0;2,0;11,0;84,0;123,0;9,0;27,0;1,0;26,0;44,0;20,0;33,0;411,0;2,0;5,0;53,0;88,0;2,0;;69,0;1,0;12,0;37,0;9,0;14,0;5,0;20,0;1,0;590,0;105,0;438,0;498,0;286,0;77,0;;11,0;45,0;164,0;4,0;24,0;26,0;20,0;;243,0;142,0;5,0;3,0;43,0;7,0;119,0;63,0;256,0;37,0;;70,0;64,0;7,0;142,0;376,0;;62,0;;206,0;4,0;;57,0;4,0;;144,0;104,0;42,0;;;15,0;3,0;;26,0;17,0;60,0;46,0;262,0;6,0;4,0;32,0;33,0;19,0;1,0;1,0;1,0;;;;;25,0;17,0;4,0;;13,0;18,0;9,0;;114,0;17,0;13,0;26,0;213,0;5,0;45,0;;5,0;13,0;;11,0;45,0;;59,0;;8,0;18,0;9,0;124,0;17,0;1,0;17,0;;;;31,0;32,0;;7,0;12,0;;24,0;2,0;2,0;51,0;14,0;21,0;4,0;8,0;74,0;77,0;65,0;19,0;;;17,0;25,0;8,0;1,0;31,0;104,0;12,0;11,0;3,0;14,0;;202,0;;3,0;4,0;3,0;7,0;35,0;5,0;3,0;2,0;11,0;2,0;1,0;84,0;3,0;9,0;9,0;;;117,0;12,0;44,0;35,0;7,0;3,0;;1,0;42,0;7,0;1,0;20,0;122,0;9,0;;2,0;86,0;18,0;394,0;22,0;3,0;;2,0;68,0;37,0;5,0;5,0;4,0;5,0;6,0;;4,0;134,0;4,0;3,0;3,0;;33,0;35,0;11,0;;9,0;4,0;34,0;1,0;12,0;8,0;;;4,0;3,0;223,0;19,0;;5,0;;;1,0;22,0;3,0;60,0;27,0;12,0;;100,0;;;24,0;;12,0;5,0;118,0;21,0;2,0;2,0;139,0;546,0;13,0;39,0;3,0;1,0;;2,0;9,0;2,0;2,0;1,0;5,0;3,0;35,0;2,0;8,0;;1,0;;4,0;39,0;1,0;5,0;4,0;10,0;15,0;79,0;;;1,0;;11,0;4,0;121,0;5,0;2,0;7,0;178,0;18,0;4,0;5,0;2,0;14,0;5,0;49,0;8,0;5,0;;1,0;;;88,0;149,0;61,0;35,0;13,0;14,0;73,0;23,0;108,0;292,0;;5,0;27,0;252,0;42,0;34,0;4,0;82,0;;3,0;32,0;33,0;22,0;24,0;1,0;223,0;127,0;22,0;2,0;131,0;2,0;18,0;1,0;;39,0;54,0;31,0;8,0;3,0;107,0;11,0;13,0;15,0;189,0;2,0;6,0;;64,0;;4,0;1,0;29,0;8,0;245,0;161,0;145,0;8,0;;25,0;12,0;19,0;11,0;12,0;1,0;31,0;77,0;8,0;2,0;3,0;14,0;46,0;42,0;15,0;24,0;;18,0;324,0;14,0;107,0;7,0;9,0;1,0;17,0;3,0;3,0;63,0;2,0;67,0;86,0;23,0;10,0;14,0;;16,0;2,0;1,0;2,0;9,0;61,0;18,0;45,0;45,0;2,0;1,0;19,0;16,0;9,0;3,0;33,0;15,0;13,0;23,0;7,0;3,0;35,0;64,0;7,0;95,0;6,0;4,0;11,0;33,0;20,0;;35,0;;2,0;1,0;18,0;51,0;3,0;43,0;24,0;23,0;16,0;9,0;1,0;10,0;4,0;14,0;4,0;7,0;;12,0;;16,0;4,0;7,0;12,0;;2,0;43,0;;;;1,0;;;;225,0;2,0;30,0;22,0;;8,0;22,0;10,0;54,0;19,0;11,0;;6,0;6,0;6,0;;2,0;6,0;20,0;9,0;2,0;12,0;18,0;30,0;5,0;2,0;6,0;7,0;3,0;1,0;105,0;4,0;2,0;47,0;11,0;65,0;3,0;26,0;12,0;3,0;;;;6,0;16,0;8,0;4,0;;9,0;1,0;;8,0;11,0;;4,0;;3,0;59,0;10,0;5,0;24,0;4,0;38,0;1,0;1,0;;16,0;71,0;3,0;;;8,0;179,0;14,0;22,0;13,0;10,0;1,0;;1,0;10,0;5,0;20,0;22,0;4,0;1,0;10,0;40,0;5,0;3,0;1,0;18,0;115,0;6,0;2,0;25,0;;;27,0;11,0;2,0;;24,0;4,0;1,0;3,0;;4,0;;1,0;4,0;;5,0;28,0;16,0;;;4,0;22,0;;16,0;7,0;1,0;29,0;7,0;31,0;;9,0;8,0;;20,0;14,0;1,0;60,0;;15,0;;;6,0;117,0;15,0;12,0;7,0;;20,0;4,0;4,0;291,0;13,0;17,0;20,0;1,0;3,0;8,0;2,0;12,0;8,0;;1,0;4,0;7,0;2,0;4,0;;18,0;2,0;7,0;1,0;1,0;;1,0;;13,0;6,0;7,0;;10,0;1,0;4,0;1,0;4,0;;;2,0;12,0;;13,0;;3,0;8,0;1,0;;15,0;8,0;6,0;2,0;9,0;8,0;4,0;1,0;;;10,0;195,0;18,0;4,0;1,0;4,0;4,0;33,0;4,0;1,0;;1,0;3,0;11,0;14,0;3,0;3,0;5,0;1,0;;;;;2,0;;;;2,0;3,0;;;;16,0;;1,0;7,0;;19,0;1,0;36,0;;;;4,0;;;;7,0;;1,0;16,0;1,0;2,0;;8,0;3,0;;;;3,0;;;;5,0;4,0;184,0;;;2,0;13,0;15,0;10,0;9,0;;;39,0;3,0;;3,0;;;6,0;11,0;4,0;;2,0;10,0;;104,0;18,0;;14,0;16,0;;2,0;;10,0;1,0;1,0;4,0;;5,0;23,0;2,0;18,0;;9,0;5,0;;14,0;16,0;;;1,0;2,0;;16,0;6,0;11,0;;19,0;13,0;2,0;7,0;4,0;1,0;1,0;4,0;3,0;25,0;2,0;1,0;;74,0;2,0;;13,0;1,0;72,0;2,0;11,0;2,0;;3,0;;;5,0;1,0;;3,0;9,0;;5,0;;13,0;;7,0;7,0;7,0;;;2,0;22,0;;;3,0;;;7,0;1,0;5,0;19,0;;;;2,0;;5,0;;14,0;4,0;;;;;1,0;8,0;;3,0;16,0;;;12,0;7,0;1,0;5,0;8,0;7,0;;;10,0;;2,0;18,0;;;;;;;;;;;3,0;;;7,0;2,0;5,0;;2,0;;;;7,0;2,0;;1,0;;5,0;;;4,0;16,0;10,0;6,0;24,0;24,0;;;12,0;;3,0;3,0;2,0;;6,0;;8,0;12,0;40,0;7,0;;3,0;46,0;2,0;3,0;1,0;;16,0;;;;;2,0;
loop;;;;5,0;;6,0;;1,0;;;;1,0;;36,0;;;9,0;;;;;;6,0;;;;;18,0;4,0;;17,0;5,0;;;;3,0;2,0;;;;1,0;14,0;;;;16,0;;9,0;;;;3,0;8,0;;;;31,0;;1,0;;;;;;5,0;3,0;53,0;;;11,0;4,0;10,0;1,0;;;3,0;17,0;;;;23,0;;1,0;;7,0;;;3,0;;;2,0;11,0;1,0;8,0;;;;;4,0;6,0;11,0;;;6,0;;;1,0;4,0;;;;;;;;;;;;;;;2,0;8,0;;;12,0;;;;;;;5,0;;;;;2,0;;;3,0;;;36,0;1,0;;;;2,0;1,0;;3,0;;;;;;;;3,0;7,0;;;;;27,0;11,0;;3,0;;;;1,0;;3,0;1,0;;5,0;;;;;4,0;9,0;;2,0;;;;;;;;;11,0;23,0;;3,0;10,0;;2,0;1,0;4,0;2,0;;5,0;;2,0;25,0;2,0;;;;;9,0;2,0;;2,0;;3,0;;;;;;122,0;;;2,0;;;;;8,0;;;;;;;;19,0;1,0;;;;8,0;24,0;;;;;4,0;;;1,0;29,0;6,0;;1,0;;;;5,0;;;;;2,0;;;8,0;6,0;;;;6,0;3,0;;9,0;1,0;2,0;;;;;2,0;2,0;;9,0;2,0;;;;;;13,0;7,0;3,0;1,0;;39,0;;1,0;;;;;2,0;;;;1,0;;;;1,0;;13,0;1,0;;23,0;2,0;4,0;2,0;;;1,0;;;;;;11,0;1,0;1,0;;2,0;;2,0;7,0;3,0;;;2,0;;2,0;;;6,0;20,0;;;6,0;;;;7,0;;;;;5,0;;;;3,0;;2,0;;;;;;;;17,0;1,0;;67,0;;;;;6,0;;;;;;7,0;;;;;;2,0;7,0;;;1,0;;;;11,0;;;;;;;;1,0;3,0;5,0;;;;;;10,0;;;1,0;17,0;1,0;;1,0;;;;1,0;;5,0;;;;1,0;;;;;;;1,0;;;16,0;6,0;;;1,0;;;;;;1,0;;;;;;;;;;12,0;1,0;;1,0;;;;2,0;;;;;;;;;;;;1,0;1,0;;;;1,0;;;;;;;16,0;;;;3,0;;;;;;;;;1,0;;;;;32,0;;;;17,0;;;;;4,0;1,0;;;;;;7,0;1,0;;;;;1,0;;;;11,0;;;;;3,0;;;1,0;;;;;;;;;;;;;16,0;;;;2,0;;;;;1,0;1,0;;;;;;;;1,0;55,0;6,0;;4,0;;1,0;;;;;;;;;;;;;;;6,0;;;;8,0;;;1,0;1,0;;;;;4,0;;;;;;;;;;;;;;;;;;;;;;;5,0;1,0;;;;1,0;;;;;;;;;;;;;;;;;;;;2,0;;1,0;;;;;;;;;;;;;;;;;;;;;;;;;1,0;;;;8,0;2,0;1,0;2,0;;;;;7,0;8,0;;21,0;;;;;;;;;;;;;;;;;;;;;;;;1,0;;;;3,0;;2,0;3,0;;;;;;;;;;;;;;;;;;;6,0;;;;;;7,0;;27,0;;;;;;;;;;;;;;;;;;;;;;;;;;;1,0;;;;;;;;;;;;;;;;;3,0;;;;;;;;;;;;;;;;;;;;;;;;;;;;;56,0;;3,0;;;;1,0;1,0;;;;;;;;;;7,0;;;;;;;1,0;;;;;;;;;;;;;;;;;;;;;;;;;5,0;;;;;1,0;;;;;1,0;;;;1,0;;;;;;;;5,0;;;;;;;;;;;;;;;;;1,0;;;;;;;;;;;;9,0;;;;;;;;;;;;;;;;;;;;;;;;;;;;;;;;;;;;;;2,0;;;;;4,0;;;;;;;;;;;;;;;;;;;
luminance;;;;10,0;1,0;8,0;3,0;;;;;;;70,0;7,0;21,0;36,0;2,0;6,0;;;;103,0;;2,0;11,0;;9,0;;;18,0;11,0;27,0;10,0;;60,0;6,0;2,0;;;38,0;16,0;;9,0;17,0;;;10,0;;1,0;;;;7,0;6,0;7,0;10,0;;;22,0;;7,0;1,0;;309,0;;21,0;6,0;3,0;;;5,0;19,0;;;;;4,0;;1,0;37,0;;;10,0;3,0;;;13,0;;;17,0;;;;;;133,0;;82,0;3,0;1,0;15,0;;4,0;13,0;14,0;;1,0;2,0;;;3,0;37,0;;;;7,0;9,0;1,0;22,0;3,0;11,0;53,0;;;7,0;24,0;;;;12,0;;;8,0;3,0;;7,0;;1,0;;;1,0;;;;6,0;19,0;;9,0;;;4,0;;;;;;;;;;;29,0;;;;3,0;;;1,0;2,0;;;2,0;;7,0;;;;;;;;;;;9,0;;23,0;;;;;;;;1,0;;;;;;;;14,0;1,0;;;;;4,0;;;;;;16,0;;;1,0;27,0;7,0;;;1,0;;18,0;;;;;;31,0;6,0;;4,0;2,0;;;10,0;;;;;;39,0;;2,0;;;;;;;;;;4,0;;;;;;1,0;;;;;51,0;;;;;2,0;;;;;;;;;;;;;6,0;;1,0;;;;;;;;1,0;;;;;;;;;;;;;4,0;;;;;1,0;;2,0;;;1,0;;10,0;;;;;;;;;;;;;;;;;;;;;;;;;;;;;;;2,0;;4,0;;;;2,0;;;;;;;5,0;2,0;1,0;;;;;11,0;;22,0;6,0;;;15,0;6,0;11,0;1,0;;;;34,0;1,0;40,0;9,0;;21,0;;19,0;2,0;;;;20,0;10,0;;;2,0;3,0;14,0;3,0;2,0;;;8,0;;;;1,0;;2,0;;;;;;;;;2,0;;5,0;;25,0;;;8,0;;;;;;;4,0;;;6,0;;35,0;;2,0;2,0;;;2,0;2,0;;;;;;;;3,0;;6,0;18,0;;4,0;7,0;;;1,0;;;;;;21,0;;;;;;;;;;;;;;5,0;;;;;;;;;;8,0;;;;;;;;1,0;4,0;5,0;;;;;14,0;;;;1,0;;;;;;;;;;;;;;;;1,0;;;;;;;2,0;;1,0;2,0;;;;;;;;;;;1,0;;;4,0;;;;;;;;;;1,0;;;;;;;;;2,0;3,0;22,0;;;;;;;;;;;;;18,0;;;;10,0;;;1,0;;14,0;;;;;;;1,0;2,0;;1,0;;2,0;;;;;;;;;;;;2,0;6,0;;2,0;;;;;;;;2,0;;;;;;;;;;;;;;;;;;2,0;;;6,0;;5,0;;21,0;14,0;;;;;;;;;;;20,0;;;;;3,0;;;29,0;;;;;;;;;;;;;;;;;;;4,0;;;;;3,0;;;;;;;;;;;;;3,0;;;;2,0;;;;;2,0;;;;;1,0;;;;;7,0;;;;;;8,0;;;;;;;6,0;;;;;;;;;;;1,0;2,0;;;;;;;;;;;16,0;;;;;;;;;;;;;;;;;;;;;;2,0;;;;1,0;;;;;;;7,0;;16,0;;3,0;12,0;8,0;;3,0;;;;;;;;;;1,0;;;;;;;;;14,0;;2,0;;;;;1,0;;;;;;;1,0;;2,0;;;;;;;;;;;;;;;;2,0;;;;4,0;;;;;;;;;;;;;;;;;;;;;;;;;;;;;;;;;;;1,0;;;;;;12,0;;;;;;;;;;;;;;;;;;;;10,0;;;;;;4,0;1,0;;;;;;;1,0;2,0;;;;;;;;;;;;;;;;;;;1,0;;;;;;;;;;;;;;9,0;9,0;6,0;;;;;;;;;;4,0;;;;;;;;;;;;
maintain;;;;14,0;2,0;26,0;3,0;11,0;;;;;1,0;9,0;;;11,0;1,0;;3,0;;2,0;7,0;;4,0;;;10,0;3,0;4,0;93,0;16,0;1,0;1,0;;31,0;1,0;4,0;;;5,0;80,0;;5,0;48,0;6,0;5,0;17,0;;1,0;;;3,0;5,0;3,0;2,0;4,0;;;5,0;1,0;;4,0;;104,0;;18,0;;1,0;;5,0;78,0;3,0;1,0;5,0;;8,0;1,0;3,0;17,0;44,0;;21,0;;26,0;2,0;;40,0;;10,0;1,0;;1,0;1,0;1,0;;6,0;9,0;29,0;19,0;61,0;25,0;;24,0;3,0;14,0;;1,0;;;;6,0;4,0;1,0;2,0;2,0;8,0;4,0;10,0;28,0;;2,0;13,0;16,0;;10,0;35,0;;;;21,0;;;13,0;;;6,0;22,0;10,0;;;2,0;1,0;;3,0;2,0;7,0;2,0;5,0;3,0;4,0;1,0;10,0;;;;;;;;2,0;6,0;2,0;;;;5,0;7,0;2,0;19,0;1,0;;2,0;18,0;2,0;;;1,0;1,0;;;;;4,0;;2,0;1,0;2,0;21,0;16,0;;;18,0;3,0;2,0;1,0;15,0;;1,0;;1,0;2,0;10,0;1,0;;6,0;27,0;;1,0;14,0;8,0;15,0;5,0;;2,0;;6,0;6,0;2,0;2,0;1,0;6,0;1,0;1,0;3,0;1,0;22,0;3,0;;1,0;;7,0;1,0;;7,0;2,0;;;;;1,0;6,0;2,0;;4,0;2,0;3,0;5,0;13,0;1,0;6,0;3,0;;9,0;;18,0;6,0;33,0;1,0;;2,0;5,0;;14,0;1,0;;;2,0;;17,0;;4,0;13,0;4,0;3,0;;3,0;13,0;6,0;10,0;;1,0;5,0;31,0;;;2,0;1,0;3,0;2,0;2,0;2,0;;3,0;;;34,0;2,0;2,0;5,0;1,0;2,0;1,0;2,0;1,0;;2,0;;3,0;5,0;3,0;;1,0;;1,0;2,0;;12,0;6,0;22,0;26,0;33,0;6,0;3,0;;;;1,0;33,0;4,0;6,0;1,0;;1,0;13,0;;;;;;3,0;3,0;2,0;1,0;8,0;1,0;2,0;9,0;;5,0;;;4,0;;16,0;3,0;6,0;;24,0;;3,0;;;;;6,0;;1,0;;;;;1,0;16,0;10,0;2,0;;5,0;2,0;;24,0;1,0;1,0;1,0;3,0;13,0;;7,0;;4,0;1,0;6,0;2,0;38,0;;3,0;2,0;3,0;1,0;3,0;;6,0;;13,0;;10,0;;;7,0;5,0;;5,0;;10,0;14,0;59,0;;;4,0;;;;;3,0;;12,0;3,0;2,0;;;;2,0;1,0;;10,0;;8,0;5,0;2,0;;32,0;2,0;9,0;6,0;;;;;14,0;6,0;2,0;5,0;3,0;1,0;6,0;4,0;;3,0;;;;;;;;;;2,0;2,0;;;;16,0;;2,0;2,0;;2,0;;3,0;1,0;;;1,0;2,0;;5,0;4,0;;11,0;2,0;;6,0;2,0;;;;;;1,0;1,0;6,0;;1,0;1,0;7,0;;;1,0;1,0;2,0;;;;;9,0;;3,0;5,0;;20,0;14,0;1,0;;1,0;;;;2,0;;3,0;16,0;;2,0;15,0;;2,0;;;;;5,0;1,0;16,0;;;;;;6,0;;2,0;;3,0;;;;5,0;;;;;1,0;1,0;;;2,0;2,0;;1,0;;;1,0;24,0;4,0;16,0;;;;;4,0;1,0;1,0;5,0;;;16,0;;;;;4,0;;4,0;;;1,0;;;;;;;10,0;;6,0;;1,0;;;;;;2,0;;1,0;;;6,0;;2,0;;2,0;9,0;;;;;7,0;;;;;1,0;;;;;;;;;;;;;;;1,0;;;;1,0;1,0;23,0;8,0;;7,0;;;;;2,0;1,0;20,0;;2,0;2,0;;;2,0;;2,0;1,0;;3,0;2,0;3,0;30,0;;2,0;1,0;;;;;;;1,0;;;6,0;;;;21,0;2,0;2,0;;;;;;1,0;3,0;;8,0;;;;;;;;;2,0;3,0;5,0;;1,0;;;;;;;2,0;1,0;2,0;1,0;;;;1,0;9,0;;2,0;1,0;;;4,0;;2,0;;;;;3,0;;;;1,0;;;;;3,0;1,0;;1,0;2,0;;1,0;;;1,0;1,0;;;;1,0;;2,0;;;;;;2,0;;;;;2,0;18,0;;;6,0;;;;;;3,0;;;2,0;2,0;1,0;;;;;9,0;3,0;;;;2,0;;4,0;;;;;;;;3,0;;;8,0;3,0;;;;;6,0;1,0;;;;;;;;6,0;5,0;24,0;;2,0;;;;;;;;;1,0;;6,0;21,0;;;;;;1,0;;;;;;;;;;;;1,0;;;;1,0;;;;;;;;;;;;;;2,0;;;2,0;;;1,0;1,0;;;;;;2,0;;;6,0;;3,0;1,0;2,0;;;;;;;;1,0;;;;;;3,0;;;8,0;;;2,0;;;;;;3,0;;;;;;1,0;;;;;;;;;;;;;1,0;2,0;;;;;2,0;;;;;1,0;;;;4,0;;;;;2,0;;;;;;;;;;;;;;;1,0;;;;;1,0;;2,0;;;;
manipulate;;;;3,0;;1,0;;9,0;;;;;;7,0;;;21,0;;1,0;;;;2,0;;;;;;;;3,0;;;;;59,0;;;;;6,0;17,0;;;73,0;;2,0;3,0;;;;;1,0;1,0;8,0;;;;;18,0;;;;;119,0;;3,0;11,0;;;;;1,0;;;1,0;;1,0;1,0;;9,0;;1,0;2,0;1,0;;;2,0;;;2,0;12,0;;;;;2,0;;5,0;;;1,0;;;;11,0;;1,0;;;;;111,0;;;;;;8,0;;;;;;;;13,0;;;;;;;1,0;;;8,0;2,0;2,0;;;8,0;;;;;;10,0;;;;;;;;;;;;;;;;;;;;;3,0;;;;1,0;;;;;;5,0;;;;;;;;;1,0;;;;2,0;;;;;1,0;;;1,0;;;;;;;2,0;;;;;2,0;12,0;;;;;;;;;;;;;;11,0;;;;;;;;;1,0;;;;;;12,0;;;;;;6,0;2,0;;;;;11,0;;4,0;2,0;2,0;;;1,0;;;16,0;;;;;;;;;;;;;2,0;;;;;;3,0;;;;;;;;;;;;;1,0;;1,0;;1,0;;;;;1,0;;2,0;;;3,0;;1,0;;;7,0;;;2,0;3,0;;;12,0;2,0;;;;;1,0;2,0;;;1,0;;;;;;;;;;;;;;;;;;;;;;;;3,0;1,0;;6,0;;;;;;;;;;;;;;;;;;;1,0;;;3,0;;;;;;;;;1,0;1,0;;;12,0;;3,0;;;;;;14,0;;4,0;;;;;1,0;1,0;;;;5,0;1,0;4,0;;;;;;;1,0;;;;;;5,0;;;;1,0;;2,0;1,0;;3,0;4,0;;1,0;;;1,0;;;;;30,0;1,0;;;3,0;3,0;;;;1,0;;;;;;;;;;;;;;;3,0;5,0;;;;;;;;;;;4,0;;1,0;;2,0;;;;;;;;;;1,0;;;;;3,0;;2,0;;;;;;;;;;;;;;;;;1,0;;;;1,0;;;;;1,0;;;3,0;1,0;;;;;;;;;;1,0;;;;;;;1,0;2,0;;1,0;;;1,0;;;;;1,0;;;;;;;;4,0;;;;;;;;;;;;;;1,0;;;;;;;;;;;;;;1,0;;1,0;;1,0;;;;1,0;;;;;;;;;;;;;;;;;;;;;;;;;;;;;;;;;;;;;;;;;;;;;;;;;;;;1,0;;;;;;;;;;;1,0;;;;;;;;1,0;;;;;;;;1,0;;;;;;;;2,0;;6,0;;;;;;;;1,0;;;;;;;1,0;;;;;;;;;;;;;;;;;;;;;2,0;;;;;;;;;;2,0;;;;1,0;;;;;;;;;;;;;;;;;;;;;;3,0;;;;;;;;;;;;;;;;;;;;;;;;;;;;;;;;;;;1,0;;;;;;;;;;;;;;1,0;;;;;;;;;;;;;;;;;;;;;;;;;;;;;;;;;;3,0;;;12,0;;1,0;;;;;;1,0;;;;;;;;;;;;;;;;;1,0;1,0;;;;;;;;8,0;;;;;;;;1,0;;3,0;1,0;;1,0;;;;;;1,0;;;;;;;;;;;;;;;;;;;;;;;;;;;;;;;;;;;;;;;;;;;;;;;;;;;;;;;;;;;;;;;;;;;;;;;;;;8,0;;;;;;2,0;;;;;;;;;;;;
manual;;;;5,0;1,0;12,0;;6,0;;;;;7,0;10,0;;;2,0;;;;;;;;2,0;1,0;;2,0;;16,0;16,0;26,0;1,0;;;2,0;;;;;4,0;9,0;;1,0;5,0;;;1,0;;1,0;;;;1,0;;1,0;;;;;;;1,0;2,0;12,0;;10,0;;4,0;;1,0;19,0;1,0;;;;;;1,0;;13,0;;34,0;;6,0;;;7,0;;;;;;;3,0;;;;12,0;6,0;6,0;1,0;;5,0;;1,0;;;1,0;1,0;;;;;;;;1,0;;;;;2,0;;;;21,0;;;;3,0;;;26,0;;;;;1,0;;;;;;;6,0;1,0;4,0;;3,0;;;2,0;;;3,0;;;;;;;;;;;3,0;6,0;;15,0;2,0;;3,0;4,0;;;1,0;;8,0;;1,0;;;;;;;14,0;1,0;;;1,0;;;;;5,0;;;;;2,0;;;;;8,0;;4,0;2,0;4,0;5,0;;;;;;;;;;3,0;;;1,0;;2,0;3,0;1,0;;;;;1,0;;;;;;;;28,0;3,0;;;5,0;;;1,0;3,0;;;;2,0;;;;4,0;;;;;;2,0;;;2,0;;;;;;7,0;3,0;;;4,0;3,0;;;;6,0;11,0;;1,0;;;;;;;2,0;;;;;;;;6,0;;;;;;;1,0;;;1,0;;;1,0;;;;;2,0;;;3,0;;1,0;;;;;;2,0;;;;;;;;;;;;6,0;5,0;1,0;;2,0;;;;;;1,0;;;;;;;;7,0;1,0;;;;2,0;5,0;34,0;;;;1,0;;;;1,0;4,0;;;9,0;;;46,0;;;;1,0;39,0;1,0;;;3,0;;;;31,0;;3,0;;;1,0;;;13,0;;1,0;;;;;;3,0;2,0;;;1,0;33,0;3,0;1,0;;;;;;;;;9,0;;13,0;;1,0;;;2,0;;;;;;22,0;;;;1,0;1,0;;;;;22,0;;;1,0;;12,0;;1,0;;2,0;;2,0;3,0;;;3,0;;;;;;;2,0;;;4,0;;;;;;;;;;;;;6,0;;;;;;;;;;;;;7,0;;;;;;;;;;;;;5,0;;;;1,0;2,0;;;7,0;;2,0;;;;;;;;2,0;;1,0;2,0;;;;2,0;;;;;;4,0;;1,0;;;;;;;;;1,0;5,0;;;;;;;4,0;;;;;;;;;;;;;;;1,0;1,0;;;;;;9,0;;;;;;;1,0;;;6,0;;;4,0;;;;;;;2,0;;;;;;;;;;;;;;;;;;;3,0;;;;;;;1,0;;;;;;;4,0;;;;;;;;;;1,0;;;;;;;;;;1,0;;;;;;;5,0;;;;;;2,0;;;2,0;;;;;;;;2,0;;1,0;;2,0;;;;4,0;;;;;;6,0;;;;;;;;3,0;;;2,0;;;1,0;;;;;;;;;2,0;1,0;1,0;;;;1,0;;;;;;;;;;2,0;;;;;;;;;;;;;;2,0;3,0;;;;;;;;;;;;;;;;;;;;;1,0;1,0;;;1,0;;;;;;;;;1,0;3,0;;29,0;;;;;;;;;;;;;;;;;;;;;;;;;1,0;;;;2,0;;;;;;;;;;;;;;;;;;;;;;2,0;;;1,0;;;;;3,0;;;;;;;;;;;;;;;;;;;;;;;;1,0;;;;;;;;;;;;;;;;;;;;;;;1,0;;;;;;;;;;;;1,0;;;;;;;;;;;1,0;2,0;;;;;;;;;;;;;2,0;;;4,0;;;;;;;;;;;;;;;;3,0;;;;1,0;;;;;;;;;;;;1,0;;;;;2,0;;;;;;;;;;;;;;;;;;;;;;;11,0;;;;;;;
manufacturing;;;;1,0;;70,0;36,0;17,0;;;;;3,0;3,0;2,0;;6,0;;;;8,0;;;1,0;;2,0;15,0;8,0;;;;;9,0;;2,0;;2,0;15,0;1,0;2,0;;65,0;;;4,0;3,0;;14,0;;;1,0;;;;8,0;1,0;17,0;;;1,0;2,0;;2,0;;84,0;;25,0;2,0;;;3,0;60,0;9,0;3,0;;;8,0;1,0;;;517,0;;;;189,0;1,0;;19,0;;;;1,0;;;1,0;;5,0;3,0;16,0;2,0;5,0;6,0;21,0;19,0;8,0;;;;1,0;;1,0;;15,0;;;;1,0;1,0;3,0;73,0;;;2,0;;2,0;;16,0;;1,0;;1,0;;;9,0;;1,0;8,0;;2,0;;;;;;1,0;;5,0;2,0;;3,0;;;8,0;3,0;;;;;8,0;;3,0;2,0;;;;;2,0;6,0;;1,0;4,0;;;5,0;;2,0;2,0;;;;1,0;1,0;2,0;4,0;;6,0;16,0;;;2,0;;;4,0;;5,0;7,0;23,0;1,0;;;1,0;17,0;;;2,0;;18,0;3,0;1,0;1,0;;;;;;;;;;1,0;1,0;;1,0;5,0;7,0;;17,0;;;2,0;;;1,0;;5,0;;;1,0;;;9,0;;;;;1,0;;3,0;9,0;;1,0;1,0;6,0;10,0;43,0;1,0;5,0;24,0;;;;;4,0;10,0;2,0;;;;;5,0;2,0;1,0;3,0;;3,0;;;15,0;;2,0;;1,0;8,0;10,0;;;10,0;;26,0;;2,0;;;;;;;;1,0;1,0;;;1,0;;;1,0;1,0;1,0;2,0;67,0;;1,0;1,0;;;;;1,0;;;1,0;1,0;1,0;;5,0;;2,0;;;;;;;;;;;;;;;;;1,0;;;;2,0;1,0;;1,0;;1,0;;1,0;1,0;;;;1,0;;;;;;1,0;;1,0;;;1,0;;;;;;;;;;1,0;;;4,0;;;;;;;;;;;;2,0;;1,0;;;;;3,0;;;;;;;4,0;;1,0;;1,0;1,0;;;;;;;;;;;;;;;;;;;;;;1,0;;2,0;;2,0;;;;;;;1,0;;;;1,0;;2,0;;;;1,0;;2,0;;;;;;;;;;;;;;;1,0;;2,0;;;3,0;;1,0;;;1,0;;4,0;;1,0;;;;1,0;2,0;;;;;;;;;;;;;;;;;;;;2,0;1,0;;;1,0;;;;;;;;;1,0;1,0;;;;;;3,0;;1,0;;;1,0;;;;;1,0;;;;1,0;;;;;;;;;;;;;;;;1,0;;;;;;;;;;2,0;;2,0;;;;;;;;;11,0;2,0;;;;;;;;;;;;;3,0;;;;;;;;;;;2,0;;;;;;;;;;6,0;;;;;;;1,0;;;;;;;;1,0;;;;1,0;;;;;;3,0;;;;;;;;;;;1,0;;;;;;;;;;4,0;;;;;1,0;;;;;;;1,0;1,0;;;;;;;;;2,0;1,0;;;;;;;1,0;;1,0;;;;4,0;;2,0;3,0;;;;;1,0;;;6,0;1,0;;3,0;;2,0;2,0;;;;2,0;;;;;;;5,0;;;;;;;3,0;;;1,0;;;;;;;;;2,0;;;;2,0;;;;;;;3,0;;11,0;;;;2,0;;;;;;;;;;;;;1,0;;;;;;1,0;3,0;;1,0;;;;;;;;2,0;10,0;;;;;;5,0;;;;2,0;;;;;;;;;;29,0;;;;;;;;;;;;;2,0;;3,0;;;;;;1,0;;;1,0;;;;;;;1,0;;;;;;;;;;;;;;2,0;1,0;;;;;;;;;;;;;;;;;;;;;;;;7,0;;;;;;;;;;;;;;;;;;;;29,0;;2,0;;;;;;;;;;;;;1,0;1,0;;;;;;;;;;;;;;;;;;;;17,0;;;;;1,0;;;;;;;;;;;;;;;;;;;;;;;;;;;;;;;;;;;;;;;;;;;;;;;;;;;;
mark;;;;1,0;;13,0;2,0;11,0;;;;;;13,0;;3,0;34,0;;;1,0;;;46,0;;;;;26,0;2,0;;20,0;3,0;;1,0;;30,0;15,0;2,0;11,0;;11,0;30,0;1,0;8,0;33,0;2,0;;8,0;;;8,0;;2,0;;1,0;;18,0;;;14,0;;;3,0;;270,0;;39,0;;2,0;;9,0;4,0;11,0;;;;;3,0;;7,0;38,0;;2,0;18,0;;8,0;;11,0;;;;;;1,0;1,0;1,0;21,0;8,0;12,0;58,0;91,0;19,0;;;29,0;5,0;;;;;;58,0;23,0;;;;;2,0;6,0;6,0;2,0;;14,0;3,0;;6,0;43,0;;2,0;;1,0;;;7,0;;;5,0;;5,0;;;5,0;;;;3,0;11,0;12,0;6,0;10,0;;;11,0;;;;;;;;;7,0;;;;;;6,0;2,0;12,0;;;1,0;13,0;1,0;2,0;;;;;;;;8,0;;5,0;;4,0;15,0;1,0;;;;;2,0;;8,0;;;;;;;;1,0;2,0;13,0;5,0;;8,0;8,0;2,0;;2,0;;1,0;15,0;;;;6,0;2,0;;;4,0;;42,0;2,0;;5,0;;;1,0;5,0;;11,0;;;;8,0;1,0;3,0;1,0;;;9,0;5,0;6,0;21,0;;;;;9,0;;;;16,0;;;;2,0;;11,0;;2,0;;2,0;;;1,0;;2,0;;;;;4,0;;1,0;;;2,0;;;;;1,0;;;;;;2,0;1,0;;13,0;1,0;;;;;;;;;;;;3,0;;;;1,0;1,0;;9,0;;;;6,0;56,0;1,0;;;;;2,0;;;;;;;1,0;1,0;;;;;;;;;;;4,0;2,0;;;;;;2,0;;;;;32,0;;;;2,0;;;;1,0;2,0;;;;;9,0;4,0;4,0;;;2,0;4,0;;12,0;24,0;;2,0;;55,0;2,0;7,0;;5,0;;;;9,0;;;;31,0;22,0;1,0;;4,0;;;;15,0;21,0;4,0;5,0;;;9,0;1,0;5,0;6,0;1,0;;;;;2,0;;;1,0;2,0;1,0;3,0;5,0;;;;;7,0;;2,0;2,0;1,0;;1,0;;;;2,0;;;2,0;;;6,0;;;;;;;;1,0;37,0;;;6,0;2,0;;1,0;;1,0;;4,0;;;8,0;;;;;;;;4,0;4,0;;;;1,0;;;2,0;8,0;5,0;;3,0;1,0;;;;;14,0;;;;;5,0;3,0;17,0;;;;;;;;;;1,0;;;;2,0;;;;;1,0;2,0;;;;2,0;;;;;;;6,0;;1,0;1,0;;7,0;;;3,0;;1,0;;;;;;;;3,0;3,0;2,0;;;;;;;;2,0;;;;44,0;;;;;1,0;;1,0;15,0;19,0;;;;;;;;;5,0;;;;6,0;;;;;;;;;;;;;;;12,0;;;;;;5,0;;;;2,0;;;1,0;2,0;;;;;;3,0;;;;;;;;;;;;;;;;;;;;;;;;;;;;;;2,0;4,0;;4,0;1,0;;3,0;;;;;1,0;;;;;;6,0;1,0;;;;;;1,0;62,0;4,0;;5,0;;;;;1,0;7,0;;;;1,0;;;;;;;;;;;1,0;;2,0;;;;;;;;;;;1,0;;;;;;;;;;;;;;;;;2,0;1,0;9,0;;;;;;1,0;;1,0;;;;;3,0;;;;;;;;4,0;;;1,0;;;;;;;1,0;1,0;;;;;;6,0;;;;;;;;;;;;7,0;;;;;;;;2,0;;;;;2,0;;;;;;;;;;;3,0;;;;;;1,0;8,0;;;3,0;;;3,0;2,0;2,0;;1,0;;5,0;;;3,0;;;;4,0;;5,0;;;;;;10,0;;;;;;2,0;;1,0;1,0;;1,0;;1,0;2,0;;;;;;3,0;;1,0;;;4,0;;;1,0;10,0;;1,0;;;3,0;;1,0;;;;;;;;;3,0;35,0;;;;;1,0;;4,0;;;;;;17,0;;1,0;;;;;;;;;;;;;;;;;;;;;2,0;;;;;;;;;2,0;;;;;;;;;;;;;;;;;;;;;;;;1,0;1,0;;;2,0;;;7,0;;;;8,0;;;;;1,0;16,0;;;;;;;;;;;;;;;;;;;;;;;;;
marker;;;;6,0;5,0;26,0;2,0;12,0;;;;2,0;;95,0;;;55,0;;;26,0;;2,0;45,0;;;;;13,0;7,0;6,0;23,0;18,0;1,0;3,0;;47,0;9,0;;;;98,0;46,0;;6,0;141,0;12,0;2,0;11,0;;8,0;22,0;;11,0;2,0;20,0;6,0;6,0;;1,0;41,0;;;36,0;;238,0;;89,0;;;1,0;4,0;4,0;28,0;;;;7,0;10,0;;2,0;134,0;;1,0;4,0;5,0;;;69,0;;1,0;;;3,0;;11,0;2,0;;37,0;125,0;42,0;337,0;50,0;;21,0;27,0;26,0;1,0;12,0;;3,0;;19,0;21,0;;;4,0;;11,0;3,0;28,0;;;45,0;27,0;;3,0;151,0;;;;46,0;;4,0;20,0;;1,0;24,0;3,0;;;;11,0;7,0;;2,0;6,0;7,0;31,0;17,0;21,0;;;10,0;;;;1,0;;;;1,0;8,0;8,0;7,0;;;26,0;4,0;1,0;20,0;;;2,0;13,0;;10,0;;18,0;1,0;;;;2,0;7,0;;;4,0;;16,0;7,0;;;;;2,0;2,0;10,0;;;;;;;;2,0;5,0;;1,0;;4,0;4,0;7,0;5,0;6,0;;4,0;5,0;;;7,0;110,0;8,0;3,0;;;;29,0;;;3,0;;;12,0;;2,0;16,0;5,0;;;23,0;;21,0;;1,0;;6,0;;41,0;9,0;;;;;1,0;;;3,0;23,0;2,0;;;;;24,0;;;;6,0;;1,0;;;;4,0;;;2,0;17,0;;5,0;;;4,0;6,0;19,0;;;5,0;;;;1,0;;;3,0;;14,0;;;3,0;;;;;;;1,0;2,0;;55,0;;;;;;;6,0;;;;3,0;41,0;3,0;11,0;;;;;;2,0;;;;;2,0;2,0;;;1,0;;2,0;3,0;;;;2,0;7,0;15,0;;;;;1,0;;26,0;;;2,0;35,0;;;;;;;;;;;;;;38,0;12,0;4,0;2,0;;;16,0;;18,0;108,0;1,0;1,0;16,0;83,0;;3,0;3,0;6,0;3,0;5,0;7,0;;1,0;11,0;;39,0;31,0;6,0;1,0;4,0;2,0;;;39,0;1,0;;7,0;;1,0;12,0;2,0;;1,0;92,0;;;;10,0;;;;1,0;5,0;14,0;;3,0;;;4,0;;5,0;;3,0;;8,0;30,0;5,0;;1,0;;5,0;;1,0;9,0;;2,0;40,0;1,0;;;1,0;;;;;39,0;1,0;2,0;16,0;3,0;;5,0;;;13,0;2,0;;;2,0;9,0;1,0;26,0;2,0;1,0;4,0;3,0;;3,0;2,0;3,0;;3,0;1,0;;4,0;1,0;;28,0;10,0;3,0;;11,0;4,0;51,0;7,0;;;;4,0;;1,0;3,0;2,0;;4,0;3,0;;;;3,0;;;;5,0;;6,0;5,0;;;;;1,0;2,0;;;1,0;;;;;;24,0;2,0;;21,0;;2,0;8,0;;;;1,0;5,0;;;3,0;;;;;5,0;4,0;;3,0;2,0;;;;;6,0;;;3,0;;106,0;;;1,0;1,0;;;1,0;23,0;6,0;;1,0;;;;;;3,0;3,0;5,0;;;;;;;;;;;;1,0;6,0;;;;5,0;44,0;;3,0;;;1,0;;;17,0;;;;;;22,0;;;;2,0;;8,0;;;1,0;;;;3,0;;;3,0;;6,0;;;2,0;;;1,0;1,0;;3,0;5,0;;;;;;;13,0;2,0;4,0;;2,0;;21,0;;;;3,0;1,0;;;;;;;7,0;;;;;;;26,0;43,0;2,0;;17,0;;;;;2,0;;;;;;2,0;2,0;;;;;;;1,0;11,0;;;1,0;;;;;;;6,0;;;;2,0;1,0;3,0;;;;1,0;;;;;2,0;2,0;2,0;8,0;;;;19,0;24,0;;1,0;;;;;1,0;2,0;1,0;;;13,0;12,0;;;;;;;;;;;;5,0;;;;;;2,0;;;18,0;;;;2,0;;;;4,0;;;;1,0;;;;;8,0;;4,0;1,0;;;;2,0;;;;;;1,0;;;;;5,0;;;;;;4,0;;;;;;2,0;;;2,0;;;32,0;2,0;;;1,0;;;;;;;;;;;;3,0;;1,0;;;39,0;;;;;2,0;;;5,0;6,0;1,0;4,0;;;1,0;;;;;3,0;7,0;;;;;;;;4,0;6,0;5,0;;3,0;;2,0;1,0;5,0;;;;;6,0;;;;;;;;;;4,0;;;;;;;;4,0;;;;;;4,0;1,0;10,0;;;;;;;;;;;;;;;12,0;;;;7,0;;;;1,0;47,0;;;;;;;;;;;;;;;;;1,0;;;;;;1,0;;;12,0;;8,0;;;;;;;;;;;1,0;;;8,0;;29,0;;;;;;2,0;1,0;;;;;;;;;6,0;2,0;;;;;
master;;;;4,0;2,0;8,0;3,0;;;;;1,0;;10,0;;;13,0;;;;;;2,0;6,0;7,0;;;10,0;2,0;9,0;35,0;5,0;;;;52,0;5,0;1,0;;;28,0;287,0;;;4,0;;;;;;;2,0;;;;;8,0;;26,0;6,0;;;;;95,0;;32,0;1,0;;;;5,0;;;;;;;4,0;1,0;28,0;;13,0;;64,0;;;7,0;;;35,0;;11,0;1,0;;;;;69,0;;9,0;;;2,0;14,0;69,0;1,0;1,0;;;;;;;;;5,0;;;19,0;;;114,0;;;1,0;71,0;;;;3,0;2,0;;13,0;1,0;;7,0;;;;;;;;;2,0;2,0;;2,0;;;;;;;;;;;;;9,0;2,0;;;;20,0;;;3,0;;;1,0;;;;;;;4,0;1,0;;;;;;37,0;;6,0;2,0;;;;;;;1,0;;;;;;7,0;;;3,0;;3,0;;;;;;;;;23,0;;1,0;;;1,0;;;;;1,0;;;;;;;;2,0;;;;;;;;;;;6,0;6,0;;1,0;;;;;;2,0;;1,0;1,0;;;5,0;36,0;;7,0;;;;;;;;;;;;;2,0;;;;;;;;;;;1,0;10,0;;;;;;;;;;;;;;;;;;;;4,0;;;;;;;;1,0;;;;;;;1,0;;;;;1,0;;;;;;;;;;;;;;;;;;3,0;;6,0;;;;;;;;;;1,0;24,0;2,0;;;2,0;;;;;;;;;;;1,0;1,0;;11,0;;;70,0;;;1,0;1,0;4,0;2,0;;;;;;;;9,0;18,0;;7,0;7,0;;;5,0;;;;;;26,0;;;;;;53,0;34,0;;;;;;;1,0;;1,0;;39,0;;15,0;10,0;;;;10,0;;;;3,0;1,0;;1,0;;;;;;3,0;;;5,0;;;;2,0;;;2,0;;;;;;;2,0;;;;;;;;;2,0;;2,0;;;;;1,0;;;;1,0;1,0;5,0;5,0;12,0;;;;;;;;;;2,0;;;;4,0;;;;;;25,0;;;;5,0;1,0;;;;;;6,0;;;12,0;;;;;;;;;;;;;;1,0;;;;;1,0;;;;;;3,0;;;6,0;;6,0;;;;31,0;1,0;;;;;;14,0;;;4,0;;2,0;;;;1,0;;;;;;;;;;;;;;15,0;1,0;;1,0;;;5,0;;;8,0;;2,0;;;1,0;;;;;1,0;;18,0;;;;;;;;1,0;;;2,0;;2,0;;7,0;6,0;;;;;;;1,0;;;;;22,0;;;;;;;;;;;;3,0;3,0;;3,0;1,0;;;32,0;3,0;;;;;;;;14,0;13,0;4,0;;;;101,0;;1,0;;;;3,0;;;;;;;;4,0;;15,0;;1,0;;;;;;;74,0;;;2,0;;;;;;;;4,0;8,0;;;;;;;;;;;;;;;6,0;;;7,0;;;;;;;;;;;;2,0;;;;;;;;;;;;;;;;;;;;;;;;;;1,0;;;;;;;;;;;;;;;;;;;;1,0;4,0;;;;;;;;;;;;10,0;;;;;;;;;;6,0;;;;;;;8,0;;;;;;;;;;;;;;;;;1,0;;;;;;;;;;1,0;;;;1,0;;;;;;;;;;;;;;;8,0;;;;;;;;;;;;;;;;;2,0;;;;10,0;;;;;;;;;;;;;;;;;;;;;;;;;;;;;;;;;;;;;;;;;;;;;;;;;;;;;;;;;;;;;;3,0;;;;;;;;;;;;;;;;;4,0;;;;;;;;;;;;;;;;;;;;;;;;;;;;;;;;;;;6,0;;;;;;;;
matrix;;;;4,0;4,0;27,0;48,0;1,0;;;;1,0;;77,0;13,0;;9,0;10,0;5,0;;;1,0;84,0;;;;;16,0;5,0;11,0;23,0;1,0;28,0;7,0;1,0;42,0;24,0;3,0;2,0;;94,0;23,0;;;47,0;6,0;4,0;32,0;25,0;6,0;33,0;;;;2,0;17,0;33,0;;;57,0;;8,0;6,0;;115,0;;50,0;;2,0;;36,0;6,0;16,0;;;8,0;2,0;9,0;;3,0;96,0;1,0;1,0;20,0;4,0;;;7,0;;7,0;56,0;;2,0;4,0;;;196,0;27,0;139,0;50,0;33,0;4,0;;11,0;16,0;26,0;21,0;2,0;4,0;1,0;;10,0;7,0;3,0;;3,0;35,0;58,0;12,0;31,0;8,0;;25,0;9,0;;2,0;50,0;;5,0;;119,0;;;72,0;;;30,0;29,0;2,0;;;2,0;;;2,0;34,0;11,0;97,0;26,0;;1,0;9,0;10,0;;;;;;;;;4,0;;15,0;;7,0;;1,0;;;1,0;;;10,0;;2,0;;1,0;;;4,0;;;;;;15,0;;33,0;1,0;;;;;;;;4,0;;;;2,0;3,0;;4,0;4,0;;;;;1,0;5,0;9,0;;2,0;;18,0;2,0;;7,0;15,0;4,0;2,0;16,0;4,0;;4,0;;;;;;3,0;1,0;;;;;;69,0;;;;;;31,0;;8,0;4,0;;;;;2,0;4,0;;1,0;2,0;;;2,0;3,0;;3,0;;;;1,0;2,0;;;3,0;;1,0;;;1,0;8,0;;1,0;;;;;;;;3,0;14,0;;;;;;7,0;;24,0;;;;;;;;;;;;21,0;4,0;;;;;;;;;;;1,0;1,0;3,0;4,0;;;;;;;;;;;;;;;;;1,0;193,0;6,0;;;;20,0;34,0;;;;;;;7,0;;;;10,0;;;;;;;23,0;;;;;;;45,0;7,0;;2,0;;;5,0;3,0;5,0;24,0;;8,0;2,0;1,0;1,0;6,0;;;;;;;;9,0;;16,0;3,0;;1,0;2,0;10,0;3,0;18,0;3,0;;;8,0;;;;3,0;;6,0;10,0;;8,0;1,0;;;;;6,0;;2,0;;;2,0;11,0;22,0;;;;1,0;;3,0;3,0;;;4,0;1,0;12,0;;19,0;7,0;48,0;;4,0;;;2,0;;;2,0;;2,0;28,0;;;17,0;;;12,0;;;6,0;;;3,0;;;8,0;;;;;;1,0;;;;;19,0;2,0;;17,0;;;4,0;;;;8,0;;;4,0;;;;2,0;2,0;;33,0;91,0;2,0;1,0;;;1,0;;3,0;;;;;;;;;7,0;;3,0;1,0;;;;;;;;;;;4,0;;;;;17,0;;;;;2,0;;;1,0;;;;;;3,0;;8,0;;2,0;;;;;;;5,0;;;;;;;;;1,0;7,0;;2,0;1,0;;;2,0;;1,0;;2,0;;;;14,0;;;;7,0;2,0;;;;;3,0;;;2,0;;49,0;;;;;2,0;3,0;9,0;;;;;;;;3,0;;;;4,0;3,0;;1,0;;;1,0;;;;;;;;;;;;;;;;;;;1,0;;;2,0;2,0;1,0;6,0;19,0;;;;;5,0;;;;;;;;;;;4,0;;;;;7,0;;;26,0;;;;;;;;3,0;;;;;;;;;;;;;;;;2,0;2,0;6,0;;;;;2,0;;;6,0;4,0;;;;;;15,0;;;;;;;;;3,0;;;;;1,0;5,0;;10,0;;3,0;;;;1,0;;;2,0;;;;;;;;;1,0;;;;;;;;;;;;;5,0;;;;;23,0;;;;;;;;2,0;;;2,0;;6,0;;20,0;1,0;;;2,0;1,0;;;;57,0;;;;;;;;2,0;;;1,0;4,0;;2,0;;;;4,0;;2,0;;5,0;3,0;;;;;24,0;21,0;;;;2,0;;;5,0;;;18,0;;;;;;;;10,0;;;;;;;;15,0;;4,0;6,0;;33,0;;;;6,0;;;;;;;;2,0;;;;;6,0;1,0;;;;189,0;1,0;;2,0;;;;;;;;;;4,0;;;;;;;3,0;;;;;;;;;;;;;;;;;;;;1,0;3,0;;;;;;3,0;;2,0;;;;;;;;;;;;;;;;;;;;;;;;;;5,0;;;;;;8,0;;;;;;;40,0;;;;7,0;;;;;;9,0;13,0;;;;15,0;13,0;;18,0;4,0;;;;;;;;2,0;;9,0;;;;
measure;;;;13,0;34,0;44,0;55,0;15,0;;3,0;;4,0;3,0;269,0;2,0;11,0;71,0;8,0;3,0;25,0;3,0;8,0;24,0;1,0;1,0;4,0;3,0;52,0;7,0;15,0;255,0;19,0;20,0;8,0;;93,0;12,0;12,0;123,0;3,0;171,0;372,0;5,0;13,0;51,0;6,0;7,0;37,0;4,0;11,0;48,0;1,0;3,0;13,0;50,0;15,0;12,0;;12,0;57,0;1,0;2,0;18,0;1,0;443,0;2,0;152,0;16,0;16,0;12,0;34,0;51,0;248,0;;;35,0;8,0;127,0;3,0;15,0;275,0;;11,0;24,0;104,0;4,0;8,0;80,0;1,0;5,0;32,0;1,0;5,0;1,0;11,0;;182,0;15,0;98,0;164,0;139,0;44,0;;18,0;23,0;87,0;7,0;7,0;4,0;4,0;;65,0;18,0;;;;14,0;16,0;23,0;249,0;7,0;;58,0;20,0;18,0;12,0;199,0;;16,0;7,0;187,0;20,0;;238,0;3,0;;31,0;;;1,0;;6,0;10,0;11,0;2,0;14,0;48,0;24,0;25,0;3,0;5,0;1,0;16,0;1,0;;;;;1,0;;;10,0;;1,0;;1,0;21,0;2,0;8,0;49,0;32,0;17,0;11,0;63,0;;11,0;1,0;24,0;2,0;15,0;19,0;;;3,0;;1,0;22,0;19,0;38,0;1,0;9,0;1,0;1,0;;1,0;1,0;14,0;6,0;;;;;1,0;5,0;;9,0;7,0;;8,0;12,0;4,0;7,0;46,0;;;11,0;15,0;6,0;1,0;10,0;14,0;4,0;2,0;;8,0;;43,0;6,0;;24,0;;46,0;39,0;15,0;;4,0;55,0;1,0;;20,0;1,0;;1,0;;;11,0;;4,0;4,0;;;;;27,0;7,0;15,0;;73,0;2,0;14,0;2,0;13,0;7,0;55,0;;;18,0;14,0;24,0;29,0;;6,0;58,0;8,0;;;;255,0;;4,0;;1,0;41,0;9,0;4,0;;;1,0;15,0;;8,0;7,0;1,0;;56,0;;473,0;21,0;2,0;1,0;;;;10,0;;;3,0;13,0;14,0;19,0;;;2,0;;1,0;;11,0;7,0;3,0;2,0;14,0;251,0;6,0;4,0;1,0;;3,0;;27,0;7,0;;;;1,0;4,0;;;;;;8,0;63,0;1,0;1,0;;;3,0;7,0;;;;;1,0;;27,0;;10,0;2,0;31,0;3,0;5,0;2,0;11,0;;;2,0;16,0;3,0;21,0;;;4,0;58,0;26,0;51,0;1,0;8,0;4,0;21,0;7,0;40,0;113,0;1,0;3,0;2,0;48,0;32,0;41,0;4,0;10,0;30,0;2,0;13,0;78,0;6,0;19,0;4,0;26,0;12,0;20,0;16,0;3,0;12,0;64,0;5,0;51,0;3,0;17,0;58,0;21,0;8,0;12,0;1,0;14,0;36,0;58,0;;3,0;14,0;;19,0;29,0;8,0;8,0;4,0;73,0;1,0;39,0;21,0;3,0;26,0;1,0;8,0;1,0;42,0;12,0;3,0;20,0;5,0;2,0;83,0;;36,0;13,0;1,0;8,0;2,0;2,0;13,0;;7,0;62,0;4,0;;2,0;;5,0;35,0;;2,0;23,0;2,0;28,0;7,0;4,0;;3,0;;;;8,0;7,0;21,0;10,0;;2,0;27,0;;;40,0;4,0;1,0;1,0;4,0;11,0;;28,0;93,0;14,0;14,0;4,0;1,0;7,0;20,0;14,0;1,0;;2,0;2,0;9,0;1,0;2,0;;4,0;13,0;25,0;1,0;;;;;9,0;9,0;;4,0;5,0;1,0;;;3,0;1,0;2,0;;1,0;;2,0;;;5,0;;;2,0;3,0;2,0;24,0;1,0;2,0;;;28,0;;2,0;4,0;2,0;4,0;;;;;;;;;;;;;7,0;;;;19,0;2,0;7,0;4,0;;2,0;;2,0;2,0;;;;4,0;5,0;17,0;20,0;4,0;;6,0;2,0;;31,0;;12,0;;;;2,0;6,0;;5,0;26,0;19,0;;;;4,0;11,0;;5,0;14,0;;62,0;;;;1,0;1,0;2,0;;;;;2,0;;5,0;2,0;;2,0;7,0;;103,0;10,0;;1,0;;;5,0;;2,0;1,0;;5,0;;;;;9,0;21,0;3,0;1,0;6,0;6,0;;2,0;;;;;;8,0;9,0;6,0;4,0;2,0;6,0;3,0;13,0;1,0;19,0;;1,0;;23,0;;1,0;;;;38,0;;;1,0;;5,0;;1,0;23,0;3,0;4,0;;;7,0;;9,0;2,0;1,0;1,0;2,0;;;;;;2,0;7,0;3,0;;;3,0;;;13,0;7,0;;;1,0;;2,0;;;1,0;1,0;1,0;20,0;;1,0;1,0;1,0;;;;2,0;;4,0;;18,0;20,0;10,0;;1,0;9,0;;20,0;5,0;2,0;;11,0;;2,0;;3,0;;2,0;7,0;;;2,0;;;;;1,0;;;;;1,0;;;;;;;;2,0;;;;;4,0;11,0;;;;;;1,0;;1,0;;2,0;;;31,0;4,0;5,0;1,0;;1,0;;16,0;8,0;2,0;;;1,0;;;;;;30,0;4,0;2,0;;;2,0;4,0;5,0;93,0;2,0;1,0;;;;5,0;;22,0;;35,0;;;;2,0;3,0;;1,0;;4,0;;1,0;;1,0;;2,0;3,0;;;;;;13,0;14,0;;4,0;4,0;;1,0;;12,0;;3,0;1,0;;4,0;;3,0;2,0;3,0;6,0;4,0;3,0;;1,0;;;4,0;1,0;3,0;1,0;2,0;5,0;20,0;4,0;4,0;;3,0;12,0;3,0;4,0;;;;;;;;2,0;;4,0;1,0;;16,0;;;;5,0;;;1,0;;;;3,0;;12,0;;;7,0;5,0;;2,0;;;;;7,0;3,0;;;;;;8,0;9,0;4,0;8,0;;;;;1,0;1,0;;;;;;1,0;1,0;;;;;2,0;;;;;2,0;;;7,0;;1,0;;;14,0;;7,0;7,0;4,0;;;;3,0;;;1,0;;;1,0;4,0;9,0;1,0;;;;;2,0;;;1,0;;;;3,0;;;;2,0;4,0;;3,0;;;;
mechanical;;;;10,0;;22,0;4,0;43,0;;;;;9,0;21,0;;;4,0;;7,0;;2,0;;;;15,0;2,0;;16,0;2,0;;14,0;1,0;;;;;3,0;7,0;;2,0;7,0;26,0;;1,0;;2,0;1,0;29,0;;;;;2,0;;;1,0;6,0;6,0;;4,0;;;;1,0;19,0;;26,0;;;;1,0;16,0;10,0;;;1,0;1,0;1,0;;3,0;34,0;;12,0;;15,0;3,0;2,0;14,0;4,0;2,0;;;1,0;;;;;1,0;16,0;4,0;14,0;;;;;1,0;;;5,0;;;2,0;1,0;;1,0;8,0;;15,0;;14,0;2,0;;1,0;;;3,0;46,0;;;1,0;2,0;;;13,0;;1,0;3,0;;6,0;;;3,0;;;3,0;19,0;2,0;2,0;3,0;9,0;;2,0;24,0;2,0;;;;;;2,0;6,0;10,0;;2,0;;;13,0;1,0;;;;;;3,0;;;8,0;;4,0;;4,0;;5,0;;16,0;;;37,0;10,0;2,0;;;;3,0;;4,0;8,0;;1,0;6,0;;;1,0;;;;2,0;;;23,0;6,0;6,0;10,0;;1,0;;;;;3,0;;;;;10,0;;18,0;6,0;;6,0;1,0;;3,0;;;;;;3,0;;1,0;1,0;2,0;;3,0;2,0;4,0;4,0;6,0;3,0;;;;21,0;4,0;1,0;8,0;13,0;;;;;;1,0;1,0;;;;;;;;36,0;14,0;;2,0;;2,0;;24,0;6,0;2,0;6,0;4,0;;1,0;;;5,0;;1,0;1,0;;3,0;;4,0;1,0;;;1,0;5,0;1,0;9,0;;1,0;;5,0;2,0;;5,0;2,0;;;;;2,0;3,0;10,0;1,0;26,0;;6,0;;;;;;;6,0;2,0;;;1,0;;1,0;;6,0;;4,0;;4,0;4,0;2,0;11,0;;;;;;5,0;;1,0;;;10,0;;;;15,0;1,0;1,0;;;;;5,0;;1,0;;;2,0;1,0;;6,0;1,0;;;1,0;;;9,0;;;1,0;;;;2,0;;;;;;5,0;;2,0;;;;;;;;;;;;;12,0;7,0;;5,0;;;1,0;2,0;;;;;;;;;;6,0;;;1,0;;12,0;;;4,0;;;;;11,0;;;;;3,0;;;;1,0;5,0;;;1,0;4,0;3,0;1,0;;;4,0;2,0;;;;;2,0;;;;;;;;;;12,0;1,0;2,0;1,0;3,0;;;1,0;;3,0;;;;1,0;1,0;;;;;;;;;;;;2,0;;;;2,0;;;;;;;1,0;;4,0;;;;;1,0;;;30,0;;;;;;6,0;8,0;1,0;;4,0;2,0;;3,0;;;;;1,0;2,0;;;;4,0;;1,0;;;;;;;;1,0;;;;;6,0;;2,0;;;2,0;;;;1,0;;;;2,0;;3,0;1,0;2,0;;;;;;;4,0;;;1,0;2,0;;;;;;2,0;;3,0;;;;;;1,0;;;2,0;;;;1,0;;;;3,0;1,0;;;3,0;;;;;;1,0;;;;;;;;;;;;;;;;1,0;;;;;;4,0;;;;;1,0;;;;;;;1,0;;;;;;;;;8,0;;;;;;3,0;1,0;;;;;;2,0;;;;;;;;3,0;;;;3,0;;3,0;;;;17,0;;;;;;;3,0;2,0;;;;;;;;;2,0;;;;;;;;;;1,0;;;;1,0;1,0;1,0;;;;;;2,0;;;;1,0;;2,0;;;6,0;2,0;;;;;;;;;;;;;;;;5,0;;;;4,0;;;;;;;2,0;2,0;;;1,0;;;;;;;;;3,0;4,0;2,0;;;;;;;;;;;;;;;;;;;;;;;;;;;;;;;;;;;1,0;;;;;;;;;;;;;;1,0;;;;;;;;;;;;;;;;;;;;;;;;;;;;;;;;;;;;;;;;;1,0;;;1,0;4,0;;3,0;;;;;;;;;;;4,0;;;2,0;;;;;;;;;2,0;;;1,0;;;;;;;;;;;;;;;;;;;2,0;;;2,0;3,0;2,0;6,0;;;;4,0;;1,0;;;;2,0;;;;;;;;;;;;;;;;;;;;;;;;;;;;;;2,0;;;;;;;;;;;;;;;;;;;;;;;;;;
microphone;;;;3,0;;65,0;71,0;24,0;;;;;;62,0;;;117,0;;52,0;7,0;5,0;;;4,0;17,0;;;11,0;7,0;21,0;86,0;34,0;;;;29,0;4,0;4,0;;1,0;93,0;98,0;;28,0;7,0;8,0;;;;;;1,0;5,0;2,0;2,0;4,0;;;1,0;29,0;;;9,0;;36,0;4,0;113,0;;;;;14,0;9,0;14,0;;;2,0;;2,0;3,0;46,0;;2,0;;12,0;5,0;1,0;9,0;;;;1,0;;1,0;1,0;;;2,0;104,0;2,0;52,0;7,0;;14,0;1,0;59,0;1,0;1,0;;;;24,0;4,0;;2,0;1,0;;29,0;;52,0;;;160,0;2,0;;10,0;75,0;;2,0;;56,0;;;19,0;3,0;;7,0;;1,0;;;10,0;;;;2,0;1,0;5,0;26,0;3,0;;;15,0;1,0;;3,0;1,0;;;;;27,0;1,0;;1,0;;45,0;5,0;;1,0;9,0;;14,0;12,0;;2,0;;;15,0;;1,0;;1,0;21,0;;;1,0;22,0;6,0;9,0;;;2,0;;2,0;8,0;34,0;1,0;;;;1,0;;;1,0;1,0;7,0;;1,0;30,0;2,0;;;;2,0;;22,0;;;;;;;;;2,0;16,0;1,0;;11,0;;;1,0;;7,0;5,0;;;;16,0;;;;;5,0;95,0;1,0;5,0;16,0;;;;;13,0;;4,0;13,0;43,0;;;;18,0;1,0;1,0;2,0;10,0;;;;;;2,0;;1,0;;;1,0;16,0;31,0;3,0;2,0;;11,0;9,0;;;;2,0;6,0;;;;;;;;2,0;;;1,0;;;2,0;3,0;;;4,0;;1,0;6,0;;;9,0;;10,0;;21,0;;;4,0;5,0;1,0;;;2,0;;;;32,0;;;;3,0;15,0;12,0;;;;;;14,0;16,0;;;;2,0;;29,0;;;;1,0;;;;;;26,0;45,0;17,0;4,0;;6,0;1,0;;;2,0;;;2,0;;;8,0;;;1,0;13,0;19,0;3,0;;26,0;;;;;49,0;1,0;1,0;;1,0;;5,0;1,0;;2,0;4,0;;9,0;1,0;;;45,0;4,0;10,0;;13,0;;2,0;18,0;;;5,0;;4,0;6,0;9,0;2,0;;;;;;;2,0;;85,0;17,0;;29,0;;13,0;;4,0;74,0;;;7,0;18,0;8,0;1,0;;13,0;38,0;;;4,0;;1,0;37,0;;;;11,0;5,0;;6,0;;;;;;10,0;;10,0;1,0;1,0;;;;;8,0;;7,0;7,0;1,0;1,0;;;1,0;;;;;9,0;2,0;;5,0;;5,0;;;;1,0;;;4,0;;;;;;14,0;1,0;3,0;17,0;;;2,0;2,0;;235,0;;2,0;;1,0;1,0;;7,0;1,0;;;7,0;;2,0;;;1,0;;;;;;1,0;;;;56,0;;;;;;;12,0;;2,0;;;8,0;;1,0;;4,0;38,0;;29,0;;;;1,0;;;4,0;;;;2,0;42,0;3,0;;;;;;11,0;;35,0;;;3,0;;;3,0;;;1,0;;;1,0;1,0;8,0;;;;;;;1,0;3,0;;;2,0;;1,0;;1,0;;;;;;7,0;;;3,0;;1,0;;;;2,0;;;4,0;;;;;;;;;2,0;1,0;;;;;;;;;;;;;6,0;;;8,0;;2,0;1,0;;;;;;;;;3,0;4,0;;9,0;;1,0;;3,0;8,0;26,0;27,0;;1,0;;5,0;;;3,0;;;;3,0;3,0;1,0;5,0;2,0;;;;;;1,0;2,0;2,0;2,0;;;;;;;;5,0;3,0;;;;;;;;;3,0;;;;3,0;;;3,0;;;;;4,0;;;;2,0;;;8,0;;1,0;;;;;;;;;;;;1,0;;;;;;;4,0;;;;8,0;;;1,0;;;;;;;;;;;;;;;;;4,0;;;;;;;;;1,0;;;;;;;;;;;;;;;29,0;;;;;;;;;;;;;1,0;;;;;;;;;;;;;;;;;;5,0;;;;;;;;;;;;;;;;;;;;;2,0;;;;;1,0;1,0;;;;;;2,0;;;;;;;;;11,0;;;;;;;;;;;;;;;;;5,0;20,0;;;;;1,0;;;7,0;34,0;6,0;;;24,0;;;;;;;;;1,0;;3,0;;;;1,0;6,0;;;;;;21,0;;;;;;;;;;;;;;;;;;;;;;;;;;;;;;;;;;;;;;;;;3,0;;;;;;30,0;;;;;;68,0;;;;;;;2,0;;;;;2,0;;;;;;;
motor;;;;35,0;10,0;92,0;5,0;55,0;;;4,0;;2,0;122,0;;1,0;21,0;;11,0;1,0;2,0;;2,0;3,0;26,0;;8,0;28,0;8,0;3,0;161,0;73,0;3,0;1,0;;37,0;6,0;14,0;;;31,0;195,0;;2,0;16,0;36,0;;47,0;;1,0;;;15,0;4,0;4,0;3,0;22,0;1,0;2,0;15,0;11,0;;8,0;;84,0;4,0;161,0;1,0;;7,0;9,0;286,0;27,0;;;;3,0;13,0;;12,0;123,0;;4,0;;158,0;32,0;2,0;18,0;5,0;1,0;6,0;;7,0;8,0;1,0;;;8,0;51,0;10,0;210,0;31,0;;5,0;54,0;37,0;1,0;3,0;1,0;;8,0;4,0;50,0;1,0;;;;20,0;;51,0;3,0;2,0;97,0;1,0;;3,0;199,0;;5,0;;15,0;12,0;;126,0;;;9,0;;41,0;;;9,0;4,0;;27,0;52,0;29,0;29,0;8,0;40,0;2,0;2,0;47,0;4,0;;3,0;;;;;7,0;164,0;;11,0;;;161,0;70,0;;17,0;8,0;;20,0;70,0;5,0;1,0;111,0;6,0;13,0;43,0;;1,0;;6,0;;;38,0;27,0;41,0;11,0;;;2,0;10,0;13,0;6,0;99,0;;10,0;8,0;;1,0;18,0;1,0;21,0;2,0;61,0;;14,0;87,0;138,0;29,0;10,0;;1,0;17,0;29,0;;;;4,0;7,0;2,0;;34,0;1,0;52,0;;4,0;19,0;;4,0;27,0;1,0;11,0;3,0;;;3,0;2,0;;12,0;22,0;9,0;;4,0;3,0;3,0;30,0;10,0;;;;13,0;5,0;20,0;45,0;40,0;4,0;;;17,0;1,0;486,0;4,0;;8,0;6,0;2,0;20,0;3,0;4,0;58,0;26,0;;;5,0;76,0;3,0;23,0;6,0;11,0;99,0;16,0;;8,0;12,0;4,0;30,0;4,0;276,0;;;2,0;;3,0;44,0;41,0;8,0;15,0;6,0;2,0;2,0;5,0;2,0;8,0;7,0;11,0;2,0;48,0;3,0;1,0;6,0;;9,0;5,0;16,0;1,0;5,0;45,0;3,0;39,0;6,0;;1,0;;;;91,0;15,0;2,0;3,0;8,0;5,0;6,0;6,0;;1,0;;1,0;209,0;150,0;36,0;12,0;3,0;3,0;6,0;7,0;1,0;10,0;7,0;;;;10,0;6,0;13,0;9,0;11,0;;1,0;1,0;;2,0;8,0;22,0;;4,0;5,0;3,0;7,0;;4,0;4,0;25,0;10,0;8,0;49,0;;;344,0;14,0;5,0;7,0;17,0;29,0;;;;;;;;118,0;6,0;2,0;1,0;1,0;9,0;;;28,0;2,0;7,0;26,0;8,0;;16,0;10,0;;7,0;76,0;3,0;37,0;21,0;25,0;2,0;;;;;1,0;;;6,0;50,0;5,0;9,0;1,0;28,0;11,0;1,0;1,0;;49,0;7,0;1,0;1,0;22,0;;6,0;8,0;3,0;76,0;;5,0;2,0;4,0;8,0;;;45,0;14,0;9,0;;3,0;;8,0;;3,0;5,0;;2,0;3,0;;;;;2,0;2,0;4,0;3,0;18,0;15,0;3,0;2,0;;13,0;;;27,0;;;7,0;5,0;2,0;19,0;;3,0;;2,0;2,0;3,0;1,0;;24,0;;;1,0;1,0;4,0;;;;2,0;30,0;;;;;1,0;1,0;;;2,0;2,0;27,0;6,0;;2,0;10,0;2,0;;;;;15,0;3,0;4,0;;128,0;2,0;;10,0;33,0;;1,0;;5,0;;;8,0;1,0;8,0;;6,0;;;;;;;;1,0;1,0;;2,0;2,0;;;;10,0;;1,0;;;1,0;235,0;;2,0;;30,0;;;8,0;;;;7,0;;1,0;;7,0;9,0;2,0;2,0;;;1,0;;2,0;;8,0;;7,0;;;;5,0;;;;;6,0;;3,0;1,0;5,0;4,0;2,0;;2,0;;6,0;;3,0;;3,0;;4,0;;6,0;;2,0;;;;;;;;;3,0;1,0;;;3,0;1,0;5,0;;;;;14,0;3,0;;;8,0;;2,0;;;1,0;;;;;4,0;;;3,0;12,0;;;44,0;;;2,0;;1,0;13,0;;2,0;;;;2,0;5,0;14,0;;;;1,0;6,0;;;1,0;;1,0;5,0;;32,0;;1,0;;8,0;3,0;27,0;;1,0;3,0;;;353,0;194,0;2,0;2,0;15,0;;;;2,0;1,0;;;1,0;1,0;8,0;4,0;15,0;1,0;;;3,0;;3,0;4,0;2,0;4,0;;7,0;;;2,0;10,0;;;83,0;1,0;;;4,0;4,0;2,0;;1,0;;;;2,0;2,0;17,0;;;16,0;;2,0;14,0;4,0;;16,0;1,0;;2,0;1,0;3,0;4,0;;;;2,0;;2,0;1,0;;19,0;;;1,0;2,0;1,0;;10,0;;;;2,0;6,0;;;1,0;2,0;1,0;1,0;;;;2,0;;;;;;;8,0;;;;;;;;;;1,0;;;2,0;1,0;;;3,0;;;;;;3,0;;1,0;;1,0;;;;;;1,0;;;;;2,0;;2,0;13,0;1,0;1,0;;;;9,0;1,0;;;1,0;;;2,0;5,0;;2,0;;3,0;;4,0;2,0;;;1,0;;1,0;;4,0;3,0;;;1,0;1,0;;22,0;;;;;2,0;;;;;;4,0;1,0;;;;3,0;;;;;1,0;;;;;;;2,0;;;;2,0;3,0;7,0;1,0;7,0;;;;;12,0;4,0;;;2,0;11,0;2,0;10,0;;;3,0;17,0;;;8,0;2,0;9,0;;1,0;1,0;;;2,0;;;;;6,0;;5,0;9,0;;;;;;;;;1,0;;;;15,0;;;4,0;;;;;;;;;;;;4,0;3,0;;;1,0;;;;;;;;4,0;;;;;;;;
navigation;;;;1,0;;33,0;;1,0;;13,0;;;;11,0;;;5,0;;1,0;;;;;;2,0;;;1,0;1,0;1,0;17,0;1,0;;;;4,0;2,0;;;;4,0;28,0;;;24,0;2,0;1,0;3,0;;;3,0;;;;1,0;;;;;7,0;;;1,0;;71,0;1,0;16,0;1,0;;;;4,0;;;;;;2,0;;3,0;69,0;;3,0;4,0;25,0;;;;;;6,0;;1,0;;;;;;4,0;13,0;14,0;;;;9,0;8,0;;7,0;;;;;;;;2,0;1,0;;10,0;4,0;;;3,0;;;9,0;95,0;;;;14,0;;;9,0;1,0;;1,0;4,0;;;;;;;;;;;;;1,0;;2,0;;;;;;;;;;;;;;6,0;;;;;1,0;5,0;6,0;;;;;1,0;;;;;1,0;;;;;;;;;;;;;1,0;;;;;;;;;2,0;;;1,0;2,0;2,0;2,0;1,0;;;1,0;3,0;;;5,0;;;;;;;3,0;;;5,0;;;;1,0;;;;;;1,0;;;;;;1,0;1,0;;;;;;;;;;;;;;;2,0;;8,0;;;;;1,0;;;1,0;;;;;;2,0;;;;;;;1,0;;;;;;;;;;;;6,0;2,0;;;;;;;;;;;1,0;;;;;;2,0;;;;;;17,0;2,0;;;;;;;;;;;;;2,0;;;;;;;;;;;;;5,0;;;;;;;3,0;;7,0;;6,0;;;;;;;;;;;;;;3,0;2,0;4,0;1,0;1,0;2,0;2,0;;11,0;;;14,0;2,0;4,0;;1,0;;;1,0;2,0;2,0;;1,0;;;7,0;5,0;;24,0;2,0;1,0;4,0;;12,0;3,0;2,0;1,0;1,0;;6,0;;1,0;;4,0;;;;1,0;;;;;;9,0;;1,0;4,0;;;;;1,0;2,0;;;;;;;;;;;2,0;;;11,0;2,0;;;;;;;3,0;1,0;;;1,0;;;;;;1,0;1,0;;;;2,0;7,0;1,0;;;;;3,0;3,0;;;;;;;;1,0;;7,0;1,0;;;1,0;6,0;;5,0;;4,0;;;;;5,0;;;;;;;6,0;;;;;3,0;;2,0;;;2,0;;;;;;;;;;;;;62,0;;;;;;;;;;;;;;;;;1,0;;;1,0;1,0;;;;;;;;;;;;;;;;;;;;;;;1,0;;12,0;;;;;;;;;;;;;;;;;2,0;;1,0;;;2,0;;;;;;;;;;;;;;;;;;1,0;;;;;;;;;;;;;;;;1,0;;;;;;;;;;1,0;;;2,0;;;1,0;6,0;;;;;;;1,0;;1,0;;;;;;;;2,0;2,0;;;;;;3,0;3,0;5,0;;;;;;;;;;;;;;;;;;;;;;;;;;5,0;;;;;;;;;;;;;3,0;;;;;;;;;;;;;2,0;;;;;;;;;;;;;;;;;;;;;;;;;;;;;;;;;;;1,0;;;;2,0;;;;;;;;;;;;;;;;;;;;;;;;;;;;;4,0;;;;;;;;;;2,0;;;;;;;1,0;;;;;;1,0;;;;;;;;;;;;;;;;;;;;;;;;;;1,0;2,0;10,0;;;;;;;;;;;;;;;;;;;;1,0;;2,0;;;5,0;;;;;;;;;;;;;10,0;;;;;;1,0;;;;;;;;5,0;;;;;;;;;;;;;;;;;;;;;;;;8,0;;;;;;;;;;;;;;;;;;;;;;;;;;;1,0;;;;;;;;;;;;;;;;;;;;;;;;;;;;;;;;;;;;;;;;;;;;;;;
network;;;;33,0;2,0;111,0;1,0;1,0;1,0;;;9,0;;71,0;;2,0;186,0;;2,0;;;;12,0;90,0;250,0;;;16,0;115,0;16,0;163,0;37,0;;3,0;;319,0;11,0;;2,0;1,0;53,0;622,0;7,0;33,0;42,0;1,0;;9,0;;1,0;2,0;;1,0;71,0;5,0;;25,0;;3,0;53,0;;;6,0;1,0;303,0;7,0;138,0;;17,0;1,0;1,0;16,0;14,0;;;1,0;;;21,0;21,0;262,0;;69,0;15,0;47,0;;;4,0;;10,0;12,0;;4,0;6,0;18,0;;;;109,0;15,0;41,0;27,0;;27,0;99,0;62,0;6,0;27,0;10,0;;;12,0;8,0;;1,0;6,0;19,0;6,0;9,0;12,0;;;62,0;6,0;;52,0;217,0;;3,0;;48,0;3,0;;121,0;;;39,0;16,0;7,0;;;;4,0;;;2,0;109,0;4,0;56,0;8,0;;39,0;1,0;;1,0;2,0;;;;;;246,0;44,0;;3,0;;29,0;2,0;1,0;9,0;1,0;;60,0;2,0;;;1,0;;11,0;1,0;3,0;7,0;;1,0;;;1,0;;28,0;1,0;;;;;;6,0;11,0;;12,0;;;2,0;5,0;55,0;5,0;40,0;;;1,0;2,0;3,0;6,0;;;1,0;1,0;25,0;;1,0;21,0;2,0;5,0;4,0;;1,0;;16,0;;2,0;3,0;3,0;;2,0;;;11,0;;;;2,0;;9,0;;;;44,0;17,0;;1,0;;8,0;;;4,0;;8,0;20,0;11,0;2,0;;18,0;157,0;2,0;64,0;9,0;;1,0;;2,0;;;13,0;;4,0;12,0;;1,0;;;;;;;17,0;4,0;;4,0;5,0;4,0;;;50,0;;;;;4,0;1,0;;8,0;3,0;7,0;;;;;;;;29,0;;;;;2,0;;8,0;;3,0;33,0;39,0;17,0;;4,0;3,0;;;;65,0;;;;;;23,0;;;;3,0;;;3,0;;5,0;;;18,0;;2,0;;;;5,0;;16,0;;3,0;;369,0;442,0;;;;2,0;3,0;18,0;6,0;;;8,0;;;4,0;;2,0;3,0;;31,0;2,0;;128,0;5,0;1,0;1,0;;24,0;8,0;;;20,0;;22,0;7,0;1,0;;13,0;;24,0;11,0;;;7,0;4,0;3,0;;24,0;1,0;48,0;15,0;1,0;;5,0;4,0;32,0;49,0;1,0;;1,0;1,0;1,0;;12,0;;1,0;7,0;200,0;66,0;30,0;4,0;;10,0;23,0;132,0;;4,0;1,0;63,0;33,0;11,0;6,0;5,0;49,0;7,0;1,0;;11,0;3,0;2,0;74,0;;;1,0;4,0;;5,0;3,0;;7,0;17,0;5,0;34,0;11,0;;4,0;1,0;9,0;;7,0;3,0;;14,0;;18,0;90,0;;11,0;;19,0;1,0;8,0;;;1,0;5,0;5,0;14,0;50,0;7,0;29,0;;;;5,0;5,0;7,0;;7,0;10,0;;;10,0;76,0;1,0;;2,0;;2,0;;;13,0;19,0;;2,0;6,0;3,0;13,0;;1,0;;;258,0;1,0;;;;;;;;1,0;1,0;;;;;12,0;1,0;2,0;1,0;6,0;4,0;;;6,0;;4,0;;;28,0;;;;3,0;2,0;70,0;2,0;;;;1,0;10,0;5,0;46,0;;2,0;;7,0;2,0;37,0;4,0;4,0;;30,0;;4,0;;;5,0;;3,0;4,0;;;47,0;5,0;;;43,0;15,0;1,0;196,0;13,0;1,0;25,0;;4,0;1,0;3,0;6,0;1,0;;;4,0;18,0;5,0;34,0;;;;;5,0;6,0;;2,0;5,0;;;5,0;15,0;6,0;3,0;;;3,0;62,0;1,0;;;1,0;14,0;;21,0;;;;12,0;;;;;10,0;1,0;;4,0;2,0;5,0;3,0;;18,0;;;;4,0;4,0;;;;;;;5,0;49,0;116,0;12,0;;;12,0;15,0;;4,0;15,0;7,0;;1,0;3,0;3,0;5,0;3,0;28,0;;;;21,0;42,0;7,0;;5,0;;;;;;5,0;2,0;9,0;;5,0;;;1,0;;1,0;1,0;1,0;2,0;;4,0;;;;;14,0;;4,0;;25,0;;2,0;;7,0;14,0;;;5,0;4,0;;;;;3,0;;;;;11,0;6,0;;;3,0;;2,0;;;1,0;;;;1,0;6,0;;;;14,0;;;;;;;2,0;2,0;;;;;;;;;;;;;;;;;1,0;;;;1,0;;;;;;;2,0;;;1,0;;5,0;;;14,0;;16,0;;;;;;;;;;3,0;;15,0;1,0;;;1,0;20,0;;;1,0;;;5,0;7,0;;;;1,0;3,0;;;;;;;;;4,0;;;;;1,0;;;;1,0;;;3,0;6,0;;;;;;1,0;;;;2,0;;2,0;6,0;;2,0;;;1,0;;18,0;1,0;4,0;;6,0;;;3,0;6,0;;;1,0;;4,0;1,0;;;;2,0;1,0;;2,0;;;;1,0;;;22,0;;;16,0;6,0;;;;2,0;;;;;;4,0;;;;;;;;;;;;;;4,0;1,0;;;;14,0;;;;;;;;;;;;;;;;;;;;4,0;;;;6,0;;;;;2,0;;;;;;1,0;1,0;;;;4,0;2,0;;;1,0;;;;1,0;;2,0;;;;;;;;;;;3,0;;5,0;;;;1,0;;
node;;;;1,0;;6,0;6,0;;;;;;;7,0;;;1,0;;4,0;;;;;2,0;;;;3,0;;;33,0;;;;;15,0;1,0;2,0;2,0;;4,0;23,0;;3,0;;10,0;;31,0;;;;2,0;;;2,0;;2,0;;;13,0;;;2,0;;14,0;1,0;36,0;2,0;;;;;;;;2,0;;;;;12,0;;13,0;10,0;2,0;;;3,0;;;;;;;;;43,0;;42,0;29,0;3,0;7,0;;1,0;5,0;8,0;;;;;;28,0;;;;;;3,0;;42,0;2,0;;83,0;2,0;;11,0;18,0;;;;;;;24,0;;;5,0;;;;;;;;2,0;;3,0;1,0;12,0;;;;2,0;;;12,0;;;;;;134,0;;4,0;12,0;;11,0;;;18,0;;;;;;24,0;7,0;;;;;;;;;;4,0;;;;;;;37,0;;;;;;;;1,0;;;5,0;;;;;;;;;;;;359,0;1,0;;6,0;;2,0;;23,0;;;4,0;;;;;;;;;;;;;6,0;;;;;;2,0;;;6,0;;;;;2,0;1,0;50,0;;;;;18,0;;;1,0;;;;;4,0;;;;;2,0;;;;;;;;;;;;;;;29,0;;4,0;1,0;;;;;4,0;1,0;;;;;;2,0;;;;2,0;;15,0;;;;2,0;;;2,0;;6,0;;;3,0;;;;;2,0;;69,0;;;;;;;;;;;;;;;;;;;;2,0;;;;;;2,0;;5,0;;10,0;1,0;;;;;;;;;;;;;;;12,0;;;;1,0;14,0;8,0;;;2,0;;9,0;;3,0;;;;;;20,0;;1,0;;4,0;;;;42,0;1,0;56,0;;;;2,0;;;;;;1,0;7,0;;;;;;;;;4,0;;2,0;;1,0;;;4,0;;;;;;8,0;3,0;23,0;1,0;;10,0;;;;;;;;;;39,0;;;;;;;;;12,0;;;;;;;2,0;;;;;2,0;14,0;;;;;13,0;;;;;1,0;2,0;;4,0;1,0;;17,0;;;;;;;;;;;;4,0;;;;9,0;7,0;;;1,0;;;;;1,0;;;;;;3,0;;1,0;;;7,0;;;;;;;;;;;;;4,0;7,0;;;;;;;;;;;;2,0;;;;;;3,0;;;;;;;;;;;;1,0;;;1,0;;6,0;;;;;;;;;;;;6,0;;;;;;;;;;;;;;;;;12,0;10,0;;;;;37,0;1,0;1,0;;6,0;;;;;;3,0;1,0;;;;1,0;;;;;;;;;15,0;;;;;;;;;1,0;;58,0;;;;3,0;;;;;;;;;;1,0;;;4,0;;30,0;;;;1,0;;;48,0;;;;;;;4,0;;;;;;11,0;;2,0;;;;;12,0;;2,0;;;;;;;;2,0;2,0;;2,0;1,0;;;;;;;;;;;;1,0;;;;;;;;;;;;;;;;;;;;;;;;;;;;;3,0;;;;;;;;;;;;;;;;;;;;;;;;;;;;;;;;;;;;;;3,0;;;;3,0;4,0;;118,0;2,0;;11,0;3,0;2,0;22,0;;;2,0;2,0;7,0;7,0;;40,0;;;9,0;;2,0;;;;2,0;14,0;;;;;;;;;;3,0;3,0;;;2,0;;;185,0;;;;;;;;;;;;;;;;;;;2,0;;16,0;;;34,0;3,0;;;;;;;;;;;;;;;;;;;;;2,0;;;;;;;;;;;;;;;;;;;;8,0;;;;;;;;;;;;;;;;;;;;;;;;;2,0;;2,0;;;;3,0;;;;;;;;;;;;;6,0;;;;;;;;;;;;;;;;;;;;2,0;;;;;;;;;;;;;;;;3,0;;;;;;;;4,0;;;;;;;;;;;;;;
noise;;;;11,0;2,0;36,0;7,0;;;;;4,0;;87,0;;11,0;12,0;2,0;2,0;8,0;3,0;;35,0;;;4,0;7,0;42,0;2,0;;22,0;4,0;15,0;4,0;;25,0;;;33,0;;67,0;20,0;;52,0;2,0;;;5,0;;;6,0;;;4,0;3,0;;;;9,0;34,0;1,0;;1,0;;163,0;;35,0;4,0;;;;6,0;28,0;;;4,0;;10,0;3,0;16,0;61,0;;1,0;30,0;16,0;;;20,0;;1,0;7,0;;1,0;;;3,0;42,0;2,0;18,0;15,0;2,0;;;5,0;7,0;18,0;;;8,0;;17,0;5,0;1,0;;;1,0;2,0;1,0;3,0;24,0;1,0;5,0;179,0;;5,0;6,0;10,0;;7,0;;23,0;;;27,0;;;;;1,0;;;;;;;10,0;;1,0;23,0;;32,0;7,0;;;1,0;;;;;;;;9,0;2,0;6,0;;;;6,0;2,0;1,0;;;;;2,0;;;2,0;;3,0;;;1,0;;1,0;39,0;;22,0;;;;2,0;60,0;;;2,0;2,0;;;;;4,0;;4,0;4,0;1,0;;;;4,0;;;;;;39,0;;;;12,0;11,0;;;;;62,0;;1,0;3,0;;8,0;13,0;6,0;;1,0;;8,0;;5,0;;5,0;;;;10,0;1,0;;;;;;;1,0;;;;2,0;;;4,0;1,0;;5,0;;;;6,0;;3,0;;;6,0;;;;;;;;;3,0;;;6,0;;;;7,0;;;1,0;;;4,0;;3,0;1,0;;;;;1,0;;;;1,0;;;4,0;;;;;;;;;;;;;;;;;;;6,0;;;;;;3,0;;;;1,0;;;;;;;;;8,0;;;;;;;;;1,0;;8,0;;;;;;1,0;8,0;;;;;;;28,0;;1,0;1,0;1,0;;3,0;;10,0;;;2,0;;12,0;;6,0;3,0;12,0;2,0;1,0;;;;6,0;;7,0;5,0;;;7,0;;128,0;;1,0;;;23,0;2,0;;;2,0;3,0;3,0;;;;;;;2,0;;1,0;;13,0;;4,0;20,0;;3,0;2,0;21,0;11,0;;;;6,0;;;;;23,0;;2,0;;12,0;;;;;3,0;;;;;7,0;;;3,0;2,0;4,0;4,0;;;;;;;;5,0;18,0;3,0;;;;;;1,0;;;;21,0;;;;7,0;;1,0;5,0;;;19,0;;2,0;;2,0;;;;;2,0;;;2,0;;;;;;55,0;1,0;;;;;;;;;3,0;;;;;;;;;;;;;;;;8,0;;;1,0;2,0;3,0;;;;1,0;;;;;;;3,0;1,0;;;;;;;;1,0;;;2,0;;;;;;;;;;;3,0;6,0;;;;1,0;;6,0;1,0;3,0;1,0;;;2,0;;;1,0;;2,0;;;;;;;;;;5,0;;;;;2,0;;;2,0;;;;;2,0;;;;;;9,0;;;2,0;;;;;;;;;;1,0;;;;;;;;;;;;;;;4,0;;;;2,0;32,0;22,0;;3,0;1,0;;1,0;;;6,0;;;;;1,0;31,0;1,0;2,0;;;6,0;;;;3,0;;;;2,0;;;5,0;;;;;;1,0;;;;;;;;;;2,0;;1,0;;;;;6,0;;1,0;3,0;;21,0;;;;;;;;;;;;;;;1,0;;;;;;;;;;;;;;;;;;3,0;;1,0;;;;;;;12,0;;;;;;;;;;;1,0;;;;;;;;;;;1,0;;;;;2,0;;;2,0;;;;;5,0;;;;;;;;;;;;5,0;5,0;;;;;2,0;;;1,0;;40,0;3,0;;;;;;3,0;;2,0;14,0;;;8,0;4,0;;;9,0;3,0;;;;1,0;;;1,0;;;;;3,0;;;;1,0;;;;;1,0;;;;;;;;1,0;;;;;6,0;;;1,0;;;;;3,0;;;;;;;1,0;;;;;;;;;;;3,0;;;;;;;;;;;2,0;;2,0;;3,0;;;;;;;;;2,0;;;;;;;;;;;;;;;;;;;;;;;;;4,0;1,0;;;;;;;;;;;;;;;;;10,0;;;4,0;;;;;;;;;;;;1,0;2,0;8,0;;;;4,0;;;;;;;2,0;5,0;;;;;;;;;2,0;;
observation;;;;24,0;1,0;9,0;;2,0;;;;;;8,0;;;14,0;;;;;;1,0;;;;;;;;14,0;;10,0;;;19,0;3,0;;34,0;;64,0;8,0;;;12,0;4,0;;1,0;;3,0;1,0;;4,0;;1,0;8,0;4,0;;;;3,0;;1,0;;77,0;;22,0;;;;10,0;10,0;45,0;;;;;;;;21,0;;18,0;20,0;;;;37,0;1,0;2,0;;;3,0;;15,0;;4,0;2,0;39,0;194,0;1,0;7,0;;6,0;2,0;2,0;11,0;3,0;;;;35,0;2,0;;;;1,0;;;16,0;;;3,0;3,0;;;34,0;;;;5,0;4,0;;7,0;;;9,0;;;;;;19,0;;3,0;;28,0;1,0;5,0;1,0;;;;2,0;;;;;;;;1,0;1,0;3,0;;17,0;;9,0;;5,0;;;;14,0;;26,0;;;;;;;;7,0;8,0;;3,0;;3,0;6,0;;;;;;4,0;4,0;;;;;;3,0;;;3,0;4,0;;;2,0;1,0;1,0;;1,0;;;1,0;;;34,0;10,0;;;;;;2,0;;;1,0;;;4,0;4,0;;;9,0;3,0;;8,0;;;;;;1,0;;3,0;6,0;;;;;;;;;2,0;;;;;;5,0;;;;;;19,0;;;;2,0;;;;3,0;;;;;3,0;;;;2,0;;;;;;;;2,0;;4,0;2,0;;;2,0;;;;;;1,0;1,0;;7,0;;;1,0;;;;14,0;;;;1,0;5,0;;;;;;;;;;;;;;;;;;;;;;;;;;6,0;;;;;;;13,0;;;1,0;;;;;;;;5,0;;;;;;;33,0;3,0;4,0;1,0;;;13,0;;6,0;;;;;18,0;;;;;;3,0;;;;;;;;;;6,0;;;;74,0;;4,0;10,0;2,0;;;6,0;;;;4,0;;;;;;;;;7,0;;;;1,0;;;2,0;;;;;5,0;2,0;;8,0;;17,0;;;1,0;;1,0;6,0;1,0;;;;;22,0;;;11,0;;2,0;2,0;;7,0;;;;1,0;;;;;;2,0;;;;;;;;;;;;;;14,0;;;8,0;;;2,0;;;;1,0;;2,0;;;;;;;8,0;;;;;;;;;;1,0;;6,0;2,0;;;;;;4,0;;;;;1,0;;;;4,0;8,0;;;;;2,0;;10,0;;4,0;;;;;;;;;3,0;;;1,0;;;;;;1,0;;;;;;;;5,0;;;;;;;;;;;;;26,0;;;;;;;;;1,0;;32,0;;;;;4,0;;;;;26,0;;;;;;;;;3,0;2,0;;;;;;;;;8,0;;;;;;;;;;;;;;;;;;;;;;;;;5,0;;;;;;;;;2,0;;;;;;;;;;;;;;7,0;;;5,0;;;;;3,0;;;;;;;;;;;;;;;;;;;;;;;;;;;;;;;20,0;6,0;;;;;;;;;;4,0;;;;;;;;;5,0;;;;;;;;;;;;;;5,0;;2,0;6,0;;;;;;;4,0;;;;;;1,0;;;;;;;;;;;;;9,0;;;;;;1,0;;;;;2,0;;3,0;;;;;;;;;;;;;;;;;;;;;;;;;;;;;;;;;;;;;;;10,0;;;14,0;;;;;;;;;;;;;;;;;;;;;;;;;;2,0;;;4,0;;;;;2,0;;;;;;;;;;5,0;;;;;;;;;;;;;;;;;;;;;;;;;;;1,0;;;;;;4,0;;;;;;;;;;;;;;2,0;;;;;;;1,0;26,0;6,0;;;;;;;;;;;;;;;;;1,0;;;;;;;;;;;4,0;;12,0;12,0;4,0;;;;;;;;;;;;;;;;;;;;;;;;;;;;;;;;;;;;;;;;
opening;;;;2,0;;;2,0;5,0;;;1,0;;2,0;12,0;;;4,0;;3,0;;;;3,0;;1,0;;;13,0;;;17,0;;;;;;5,0;;;;;12,0;;;7,0;19,0;;5,0;;;;;18,0;;;;31,0;;;;3,0;;;;5,0;;32,0;;;3,0;;18,0;19,0;;;;11,0;;;;17,0;;;;17,0;1,0;;8,0;;2,0;;;5,0;1,0;;;10,0;;126,0;;13,0;;;;;;;;;;;;6,0;;;;;9,0;;4,0;;;;2,0;;;10,0;;;;;;;1,0;;;1,0;;;1,0;;18,0;;;3,0;;;4,0;;11,0;;;14,0;2,0;;2,0;;;;;;2,0;;;2,0;;6,0;14,0;;;;;2,0;;;3,0;;1,0;3,0;;;;5,0;6,0;13,0;2,0;1,0;;11,0;7,0;;;1,0;4,0;2,0;;27,0;9,0;11,0;3,0;;5,0;;;;;23,0;;;20,0;1,0;3,0;;7,0;;2,0;;;;;16,0;;;4,0;23,0;;7,0;;3,0;1,0;2,0;;1,0;;1,0;;;2,0;1,0;;;1,0;;;;7,0;;11,0;31,0;;1,0;;;7,0;1,0;;6,0;17,0;;;;;;1,0;16,0;;;;;3,0;;;;13,0;1,0;;1,0;;1,0;;3,0;;3,0;2,0;;;;5,0;2,0;4,0;;1,0;;9,0;2,0;4,0;;;;5,0;3,0;;;;;;;7,0;;5,0;;;;;4,0;;3,0;;;2,0;2,0;;8,0;6,0;2,0;;;3,0;1,0;1,0;;;;2,0;;5,0;;;3,0;;;1,0;3,0;;;3,0;;9,0;;1,0;;1,0;;;4,0;;;;3,0;;;;;;;4,0;;;;;;;;1,0;;;;;;;;;;;;;;;;;;;;;;;;;;;;;;;;;;;;1,0;1,0;;;3,0;;;;;;;;;1,0;;;9,0;;;;;;;;1,0;;;;;;;;;;;;;;;;;;;;1,0;;5,0;;;;;;;;;;;;;;;;1,0;;;;;;;;;5,0;;2,0;3,0;;;;;1,0;;;;;;4,0;;;;;;;;;;;1,0;;;;;6,0;;1,0;;;;;7,0;5,0;;;5,0;;8,0;;;3,0;;3,0;;;;3,0;;;;;;2,0;;;;;24,0;;;;1,0;2,0;;;3,0;;;;;;;;;;;;;;;;;4,0;;;;;;29,0;2,0;;;;;;;1,0;;;;1,0;;;;;;;;7,0;;;;3,0;;;;;;2,0;;;1,0;;;;;;;;;;;;;;;;;;;;;;;;;;1,0;;;;;;;;;;;;;;1,0;;;;;;;;;;;;;;;;;;;1,0;;;;;;;;;;;;;;;;;;;;;;6,0;;;9,0;;;;2,0;;2,0;;;;4,0;;1,0;;2,0;7,0;4,0;;;;;1,0;;;4,0;;;;;;;;;;;;;2,0;;;;;;;;;;2,0;;;;;;;;;;;;;;13,0;1,0;;;;;;;1,0;;;3,0;;;;;;;;;1,0;;;;;;;;6,0;;;;8,0;;;;;1,0;;;;;;;1,0;;;;;;;;;;;;;2,0;;;;;;;1,0;;;;;;;;2,0;;;10,0;;;;;;;;;;3,0;;;;;;;;;;;;;;;;;;;1,0;;;;;1,0;;;;;;;;;;;;;;;;;;;;;;;;;;;;;;;;;;;;;;;;;;;;;;;;;;;3,0;;;;1,0;;;;;;;;;;;;;;;;;;;;;;;;;;;;;;9,0;;;;;;;1,0;;;;;;;3,0;;;;;;;;;;;;1,0;;;;;;;6,0;;;;;;;;;;;;;;;;;;;;
operator;;;;5,0;6,0;12,0;;2,0;;;;1,0;;29,0;;;28,0;;;3,0;;;;;11,0;;;;;;28,0;3,0;;3,0;;6,0;3,0;3,0;;;17,0;38,0;;;16,0;2,0;;1,0;;;10,0;3,0;3,0;;6,0;;2,0;;;8,0;;;8,0;;76,0;;9,0;;;;;1,0;7,0;;;1,0;1,0;;;;44,0;;5,0;2,0;7,0;1,0;;4,0;;;;1,0;;2,0;;;18,0;;3,0;6,0;9,0;;;4,0;8,0;;2,0;3,0;;;;2,0;1,0;;;;;;;2,0;2,0;;17,0;1,0;;;48,0;;;;4,0;;2,0;13,0;20,0;;27,0;;;;;;1,0;;;6,0;19,0;;11,0;1,0;;;3,0;;;1,0;;;;;;2,0;6,0;1,0;;;1,0;5,0;;5,0;4,0;;8,0;18,0;;4,0;;;5,0;;;;;5,0;1,0;;1,0;1,0;;2,0;;1,0;;1,0;;;3,0;;;;;;;;5,0;;2,0;2,0;;12,0;8,0;28,0;4,0;;;;1,0;1,0;;;;;;;2,0;;7,0;;;;;;6,0;;;;;;;;;;;;;9,0;;5,0;2,0;6,0;;;;3,0;;;6,0;5,0;;;2,0;8,0;;55,0;;;;;4,0;5,0;;;;;;1,0;1,0;13,0;;;2,0;;1,0;;;;1,0;;1,0;;;;;;1,0;;7,0;1,0;1,0;;;;;;3,0;;;4,0;5,0;;;;;;1,0;;11,0;1,0;;;6,0;4,0;1,0;;;;;;;;;;7,0;;3,0;;8,0;;;;5,0;6,0;1,0;;;10,0;;1,0;;;;;;;7,0;1,0;5,0;4,0;7,0;;;;;3,0;;2,0;;;;1,0;2,0;;2,0;;3,0;;1,0;16,0;2,0;;41,0;;;;2,0;27,0;;4,0;;;;;;1,0;2,0;7,0;;;2,0;;;28,0;;2,0;;3,0;;2,0;22,0;;;6,0;2,0;16,0;20,0;9,0;;;;1,0;;;;;;35,0;1,0;15,0;;4,0;3,0;;5,0;;;5,0;;;3,0;;;;4,0;1,0;;1,0;1,0;;20,0;1,0;;;6,0;3,0;;;;;;;1,0;8,0;;;;;;;;;2,0;2,0;13,0;12,0;3,0;2,0;;;;1,0;;;;3,0;4,0;;7,0;;1,0;;;;;;;;3,0;;;;6,0;12,0;;11,0;;;;2,0;;;;;;;10,0;1,0;;;12,0;;1,0;3,0;;;;;;;;;;;1,0;4,0;;;;;;2,0;;1,0;7,0;10,0;;;;;;;;1,0;;;;2,0;;;12,0;;;;;;3,0;;9,0;1,0;;;2,0;2,0;;;;;1,0;1,0;;;;41,0;4,0;1,0;;;;;;;;;;;;;2,0;5,0;;1,0;;;;7,0;;;2,0;;;;;;;;4,0;;36,0;1,0;1,0;;;;;;3,0;;;;;1,0;;;;;;1,0;;;;;;;;1,0;1,0;;;;;;;;;;;;1,0;;;;1,0;7,0;1,0;;;;;;;;3,0;;;;;;;;2,0;;3,0;1,0;2,0;;;;;;;;;;;;;;;;;;;;;;2,0;;;;;;;;;;4,0;;;1,0;;;1,0;;;2,0;;1,0;2,0;1,0;3,0;;1,0;;;;1,0;;;;1,0;;;4,0;;;;;;;2,0;;;4,0;;;;;;;;;;;;;;1,0;;;;;3,0;;;;;;;;5,0;2,0;;;;;;;;;;;;;;;;;;;1,0;;;;;;2,0;;;;;3,0;;;;;;;;;;;;;;1,0;;;;3,0;;;;;;;1,0;;;;;;;;;;;;;;;;5,0;;;;;;;;;;;3,0;;;;;1,0;;;4,0;;;;;;;;;3,0;;6,0;;3,0;;;;;;;;;;;;;1,0;;;;;;8,0;3,0;;;2,0;;;;;;;;;;3,0;;;;;;1,0;1,0;;1,0;;;;;;;;;;;1,0;;;;;;;;;;;;;;;;;2,0;;1,0;3,0;;;;;;;;;;;;;;1,0;;;;1,0;;;2,0;;;;;;;;;;;;;;;;;;;;;;;
orthogonal;;;;5,0;;3,0;3,0;35,0;;;;;3,0;19,0;;;1,0;;1,0;;;;4,0;;;;;4,0;;;10,0;1,0;1,0;3,0;;17,0;12,0;;1,0;1,0;10,0;13,0;;6,0;8,0;8,0;;7,0;;;;;16,0;1,0;9,0;;5,0;;;7,0;;;;;38,0;;10,0;;;7,0;;114,0;13,0;;;;1,0;;;;7,0;;;;14,0;17,0;;316,0;;4,0;1,0;2,0;3,0;1,0;;;;94,0;13,0;13,0;34,0;;;4,0;7,0;1,0;;;;;;4,0;2,0;;;;4,0;7,0;7,0;30,0;;2,0;5,0;2,0;;;13,0;;;;22,0;;;26,0;;;14,0;1,0;;;;3,0;;;9,0;2,0;3,0;12,0;2,0;1,0;23,0;;7,0;1,0;;;;1,0;;;;6,0;;;;;1,0;5,0;;1,0;1,0;;;393,0;;4,0;;;;;;;;15,0;;;2,0;1,0;22,0;1,0;;;;5,0;13,0;6,0;7,0;;;;;3,0;1,0;;;;6,0;1,0;2,0;17,0;12,0;47,0;;;;3,0;2,0;8,0;;4,0;3,0;;;2,0;7,0;;18,0;;;;6,0;1,0;2,0;;;;;;2,0;;;;1,0;;;;;3,0;13,0;1,0;2,0;;;54,0;9,0;;51,0;25,0;;;;3,0;;;3,0;;;;;4,0;;2,0;4,0;;;;15,0;16,0;5,0;1,0;;3,0;391,0;2,0;;;5,0;;2,0;;8,0;;;10,0;9,0;;6,0;;1,0;1,0;;;;;2,0;;;;3,0;2,0;2,0;;4,0;;2,0;;3,0;;15,0;2,0;15,0;;10,0;2,0;;;;;;;3,0;;6,0;1,0;;5,0;;;;;;13,0;15,0;;;;4,0;7,0;;;2,0;;;;;1,0;;1,0;;;;2,0;;;;;;1,0;;;;;;10,0;;;;3,0;;;1,0;4,0;;5,0;;2,0;;;;;3,0;;3,0;;;1,0;;10,0;;;;5,0;;;2,0;2,0;;;2,0;2,0;;9,0;;;2,0;50,0;;;;;;;;1,0;;4,0;8,0;;;;6,0;;;;2,0;;;2,0;;;;;4,0;3,0;;2,0;2,0;;2,0;6,0;;;;;;;;;;;4,0;1,0;;;;1,0;;;;;;;;;;;2,0;;;;34,0;;2,0;3,0;;;2,0;;;;;;;;;;1,0;;;;1,0;;;;;14,0;;;;1,0;;4,0;;;;;;;;;;1,0;;;;;;;;;;;;;20,0;7,0;;;;1,0;;;;4,0;;;;;;;;;;;;;;;;;;;;;;;;;;;;1,0;;;9,0;1,0;;;;;;;5,0;;;;;;2,0;;;;;;1,0;;;;;;;;;;;;;;;1,0;;;;;;;;4,0;;6,0;;;;;;;3,0;;;;;;;;4,0;;;;4,0;1,0;;;2,0;;;2,0;;;;;;;;;;;;;;;1,0;6,0;;;2,0;2,0;;;;;1,0;;;;;;;2,0;;;;;;;;4,0;;;3,0;;;2,0;;;;3,0;;;;;;;;3,0;7,0;2,0;;;;;2,0;1,0;;;;1,0;;;;;;;;;;6,0;2,0;;;;;;;;40,0;;;2,0;1,0;;;;;;;;2,0;;;;2,0;;;;1,0;;;;;;;2,0;;3,0;;;;;;;;;4,0;;;1,0;;;;;1,0;;;;2,0;1,0;1,0;5,0;;;;;4,0;;;;;;;;;;;;6,0;;;;;;;;;;;;2,0;5,0;;;;;;4,0;1,0;;;3,0;;1,0;;;;;;;;;7,0;;;6,0;;;;;;;;;2,0;;2,0;1,0;;;1,0;;;;;;;;;;4,0;;3,0;;;;;1,0;;;;;;;4,0;;;;;;;;;;1,0;4,0;;;;;1,0;;;;;;;;;;1,0;;1,0;;;;;;;;;;;1,0;;;;;;;16,0;;;2,0;;;;3,0;;;1,0;;;;1,0;;;;;;;;;;;8,0;;;;;;;;;;;;;2,0;;;;;;;;1,0;;;;;;;;;;2,0;;;;;;;;;;;;;;;;;
overlap;;;;25,0;15,0;20,0;31,0;10,0;;;;3,0;2,0;85,0;;;154,0;;5,0;1,0;;2,0;15,0;;3,0;;;7,0;10,0;1,0;32,0;8,0;6,0;1,0;1,0;101,0;58,0;32,0;13,0;1,0;121,0;88,0;1,0;10,0;86,0;15,0;2,0;29,0;2,0;12,0;2,0;;17,0;2,0;516,0;2,0;30,0;;;54,0;3,0;;3,0;;836,0;;42,0;6,0;;18,0;4,0;46,0;43,0;1,0;;10,0;6,0;2,0;;1,0;113,0;;3,0;;36,0;1,0;1,0;33,0;;1,0;2,0;140,0;11,0;1,0;20,0;;73,0;4,0;153,0;18,0;98,0;11,0;5,0;28,0;11,0;29,0;3,0;5,0;3,0;;;11,0;503,0;;;45,0;5,0;31,0;79,0;86,0;4,0;1,0;29,0;8,0;2,0;16,0;79,0;;;1,0;56,0;;;59,0;1,0;;594,0;7,0;;;2,0;82,0;;;6,0;12,0;231,0;36,0;40,0;3,0;;24,0;11,0;11,0;;7,0;;;;2,0;6,0;3,0;3,0;4,0;1,0;;2,0;27,0;2,0;26,0;14,0;;1,0;104,0;;4,0;;2,0;1,0;;2,0;;;9,0;1,0;20,0;19,0;1,0;103,0;16,0;;;;6,0;5,0;1,0;45,0;1,0;2,0;;;42,0;;1,0;4,0;9,0;32,0;;11,0;7,0;6,0;13,0;;;6,0;3,0;2,0;4,0;2,0;39,0;14,0;9,0;9,0;10,0;10,0;;442,0;;4,0;3,0;;;41,0;15,0;22,0;;;5,0;;5,0;;5,0;;;;39,0;2,0;11,0;41,0;;4,0;;;6,0;29,0;2,0;15,0;26,0;;;1,0;1,0;9,0;15,0;18,0;1,0;;5,0;1,0;11,0;;3,0;5,0;;;;2,0;17,0;1,0;5,0;;3,0;12,0;6,0;3,0;;1,0;3,0;2,0;6,0;35,0;3,0;;;16,0;;26,0;;10,0;7,0;2,0;6,0;6,0;;;1,0;1,0;;11,0;42,0;3,0;;7,0;;15,0;;21,0;;8,0;1,0;;119,0;2,0;;1,0;;;;2,0;5,0;7,0;;;2,0;14,0;;;;10,0;;2,0;;2,0;;;5,0;29,0;16,0;;;4,0;7,0;;;17,0;;;21,0;35,0;;59,0;;;1,0;;;5,0;;;1,0;;;22,0;2,0;2,0;;4,0;;5,0;2,0;36,0;9,0;;2,0;3,0;39,0;12,0;14,0;8,0;;1,0;;14,0;;15,0;14,0;2,0;57,0;8,0;;;7,0;;1,0;1,0;39,0;6,0;27,0;8,0;;;17,0;;7,0;14,0;2,0;2,0;;;;1,0;;2,0;1,0;6,0;16,0;8,0;17,0;6,0;;10,0;;10,0;;2,0;;3,0;14,0;1,0;;;4,0;6,0;4,0;4,0;6,0;;1,0;30,0;;1,0;;;;1,0;1,0;1,0;2,0;;4,0;1,0;;;8,0;5,0;;3,0;;;;2,0;;4,0;1,0;;4,0;2,0;;1,0;1,0;36,0;;;10,0;4,0;6,0;32,0;;;5,0;;;;7,0;;1,0;36,0;;;1,0;2,0;4,0;;13,0;42,0;27,0;6,0;;1,0;6,0;;;;;;4,0;1,0;3,0;2,0;;3,0;4,0;;13,0;1,0;;;;;;;;3,0;14,0;13,0;;4,0;13,0;3,0;13,0;;;2,0;8,0;1,0;8,0;;;2,0;10,0;3,0;1,0;;;;4,0;;1,0;;;;;9,0;;;3,0;6,0;;5,0;;;;;2,0;44,0;10,0;;3,0;2,0;;;;1,0;6,0;1,0;;;;2,0;17,0;;;;;;;;;;;2,0;;;66,0;;;;;1,0;1,0;1,0;6,0;;2,0;;2,0;;;1,0;2,0;;;6,0;43,0;;3,0;3,0;;;6,0;2,0;;;4,0;;;;;5,0;;1,0;6,0;4,0;;;;6,0;;;;;;4,0;;;1,0;1,0;2,0;19,0;;;;1,0;2,0;8,0;2,0;;;6,0;1,0;7,0;2,0;;;39,0;24,0;;3,0;31,0;;;;;1,0;2,0;8,0;2,0;6,0;;;;1,0;;;2,0;3,0;2,0;;;;2,0;;21,0;;6,0;;;1,0;5,0;1,0;;;;1,0;2,0;7,0;;3,0;;6,0;;2,0;;;2,0;7,0;1,0;;10,0;;1,0;2,0;;;7,0;;4,0;;10,0;;3,0;;;1,0;;;25,0;6,0;;;;10,0;;;5,0;1,0;;;;10,0;;;;8,0;2,0;2,0;;2,0;4,0;;;1,0;6,0;;;;;;8,0;;2,0;;;2,0;3,0;;;2,0;;1,0;;;4,0;;5,0;;10,0;;;1,0;;;77,0;17,0;;;3,0;;11,0;4,0;;11,0;;;2,0;3,0;4,0;;1,0;2,0;;3,0;1,0;;;3,0;;9,0;;;9,0;4,0;2,0;;;;1,0;1,0;;;7,0;;;32,0;;;1,0;1,0;;;25,0;14,0;;7,0;;;3,0;1,0;1,0;;5,0;5,0;;3,0;;1,0;;1,0;9,0;;1,0;3,0;;;8,0;3,0;;;2,0;5,0;;;;1,0;;;;;14,0;;;;1,0;1,0;;;;1,0;;1,0;;;;1,0;;;3,0;;;;;1,0;4,0;;;;;;4,0;6,0;;;8,0;;;;3,0;;6,0;;;;;;;;;;;;;;;;;;2,0;;;;;3,0;;1,0;1,0;;;5,0;;;;;1,0;;;;3,0;3,0;;;1,0;14,0;4,0;;11,0;;;1,0;1,0;3,0;2,0;13,0;;;3,0;;;;2,0;;;1,0;;7,0;;;2,0;;;
overlay;;;;13,0;5,0;9,0;;;1,0;2,0;;;;29,0;;;3,0;;;3,0;;;16,0;;4,0;;;;5,0;;24,0;1,0;;;;37,0;1,0;;1,0;1,0;15,0;29,0;;6,0;97,0;;;2,0;;;1,0;;;;13,0;;1,0;;;44,0;;;;;140,0;;30,0;;;;1,0;2,0;1,0;;1,0;;;5,0;1,0;;24,0;;1,0;3,0;3,0;;;;;;4,0;6,0;;;;;3,0;1,0;9,0;3,0;29,0;1,0;;1,0;17,0;22,0;4,0;8,0;;;;2,0;10,0;;;2,0;;;1,0;1,0;1,0;;3,0;8,0;;8,0;22,0;;;;3,0;;;46,0;;2,0;5,0;1,0;;;;;;;;14,0;1,0;;2,0;;;;;;;;;;;;;1,0;;;;;;2,0;;3,0;1,0;;;2,0;;;;1,0;2,0;;;24,0;;2,0;;;5,0;;22,0;;;;;;;1,0;;;;;;;;;4,0;;;;;;1,0;;7,0;;;;;;;;3,0;;2,0;;1,0;;6,0;;;;;1,0;1,0;;1,0;2,0;;5,0;;6,0;;;;;;3,0;1,0;1,0;;2,0;;;;;;;;1,0;;;;2,0;;33,0;;;;;;5,0;;;;1,0;;;;1,0;;;;1,0;;;2,0;;;;;;;;;;;;5,0;6,0;;;;;;;;;;2,0;;7,0;;;;;;;;;;;1,0;8,0;;1,0;;;;;;;;;;;1,0;;;;;;;3,0;1,0;;;;;1,0;;;;;;;;;;;113,0;;6,0;;;;;2,0;;;;;;;5,0;;;3,0;;;;;;;;;;1,0;2,0;3,0;;;;1,0;;4,0;;5,0;;2,0;10,0;4,0;;3,0;2,0;;;6,0;23,0;3,0;1,0;;;3,0;;;2,0;10,0;;;;;;;;;;17,0;;;3,0;1,0;;;4,0;;;4,0;;4,0;;;1,0;1,0;;4,0;4,0;1,0;;4,0;8,0;;;;2,0;;;;;;;2,0;;;;1,0;;;;1,0;;;4,0;8,0;6,0;1,0;;;;;;;;1,0;;;;;5,0;;;4,0;1,0;;;;;;30,0;;;;;2,0;;3,0;;;10,0;;1,0;;;;;;;;;;;;4,0;;4,0;1,0;6,0;;;;;2,0;4,0;2,0;;22,0;;;;2,0;;;2,0;;;;;3,0;;;;7,0;;;;8,0;;3,0;;1,0;;;;;;;8,0;8,0;11,0;;;;;;;;;2,0;;;;;;;;;;;;3,0;;5,0;;;;;;;2,0;;;;;;2,0;2,0;3,0;6,0;1,0;;;;;;;;;;;;;;;;;2,0;;;;;;2,0;;;;;;;;;;;;2,0;;;;;;;;;;5,0;;;;;;;;;;1,0;2,0;;;;1,0;;;;;;;;;;;;2,0;2,0;;;;;;;;;;;;;;;;;;;;;1,0;;;;;;;;;;;;;;;;;;;;4,0;;;;;;;;;;;;;;5,0;;;;4,0;;;;;;;;5,0;;;;;;;;;;;;;;;;;;;;;;1,0;;;;;;;;;;;;;;;;11,0;;;;;;;;;;;;;;;;;;;;;;;;5,0;2,0;;;;;;;;;;;;;;;;1,0;;;;;;;;;;;;;;;;;;;;2,0;;;;;;;;2,0;1,0;;2,0;2,0;;;;;;;;;;;;;;;;;;;4,0;;;;1,0;;;;;;;;;;;;;;;9,0;;;;;;;1,0;;9,0;;;;;;;82,0;;;;;;;;;;;;;3,0;4,0;;;;;;;;;;;;;;;;;;;;;;;;1,0;;;3,0;;;;;;;;;;;;;;;;;1,0;;;;;;;;4,0;;;;;;;3,0;;;;;;;;;;;;;;;
packet;;;;4,0;24,0;4,0;3,0;;;;;;;13,0;;;1,0;;8,0;;;;;;5,0;;;;;7,0;24,0;1,0;;;;227,0;;;;;38,0;19,0;;;2,0;;;;;9,0;;;;8,0;;1,0;;;;29,0;;;;;21,0;2,0;31,0;1,0;;;2,0;;;;;;;;;20,0;33,0;;;;;;;;;;;;;;1,0;;;1,0;20,0;;;28,0;;3,0;11,0;7,0;;;;;;;4,0;;;;;;;3,0;;;28,0;;;12,0;23,0;;;;7,0;;;25,0;;;2,0;2,0;;;;;;;;;4,0;;;;;;;;20,0;13,0;;;;;;2,0;3,0;4,0;;;;;;1,0;;2,0;3,0;;;;;;1,0;;;;;;;;1,0;;32,0;;;;;;;;;;;1,0;;;;;;;;;;;;;;;;;12,0;;2,0;;;5,0;;;;;9,0;;;3,0;;;4,0;1,0;;;;;;;;;;;;19,0;3,0;;;;;;;;;;;;;;12,0;43,0;;;;;;;;;;;;;;;;;;;;;;;;;;;3,0;;;4,0;;;;;;;;;;;;;;;;23,0;;;;;;;;;;;;;2,0;;;;;;;;2,0;;;;;;;;;;;;;;;;;;;2,0;;;;;2,0;;;;;;70,0;7,0;;;;;;;3,0;;;;;;4,0;;25,0;;;2,0;2,0;;5,0;;;2,0;;;2,0;;;31,0;1,0;;;;12,0;;;7,0;7,0;;;;;1,0;;1,0;1,0;;;;;;;4,0;6,0;;;;;3,0;;2,0;;1,0;;36,0;;8,0;;;;;;;;;;;12,0;;;2,0;11,0;;1,0;;;;;;;2,0;;;;;;;;;6,0;;2,0;;;8,0;;;;;2,0;;3,0;7,0;;;;7,0;;;;;;;;;;;;;;;;;17,0;;1,0;;;;;59,0;;;;5,0;;;;2,0;;;;;;1,0;;;;;5,0;;;;;;;;;;;;;;4,0;;;;;1,0;;;;;;;;;;;;;;;;;;;;;1,0;8,0;3,0;;;;;1,0;1,0;;;;10,0;;;;;;;;;;;;5,0;;;9,0;1,0;;;;;;;;;;;;;;;;;;;;;;;19,0;;;;;;;7,0;;;;;;6,0;;2,0;;;;;3,0;;12,0;;;;;;;;;;;;2,0;;;4,0;;;;1,0;;;;;;;;;5,0;12,0;;;;;1,0;;;;1,0;;;;2,0;;;16,0;;13,0;;;13,0;4,0;;;;;;1,0;;3,0;4,0;3,0;;;;;;;;;;1,0;;;;;;;;;1,0;;;;;;1,0;1,0;;;;10,0;;;;;;;;;;;;;;;;;;;;;;;;;;;;;;;;;;;;;;;;;;;;;;;;;;;;;;;;;;;;;;;;;;;;;;;;1,0;;9,0;;;;;;;;;;6,0;;;;;;;;;;;;;;;;;;19,0;;;;;;1,0;;;;;;;;;;;;;;;;;;;;;;;;;;;;;;;;;3,0;;;;;;;;;;;;;;;;;;;;;;;;;1,0;1,0;;;;;;;1,0;;;;;;;;;;;;;7,0;;;;;;;;;4,0;;;;;;;1,0;;;;;;;;;;;;;;;;;;;;;;;;;;;;;;;;;;;;;;;;;;;;;;;;;;;;;;;;1,0;;;;;;;;;;;;;;;;
panoramic;;;;1,0;1,0;26,0;8,0;19,0;;;;;;125,0;;2,0;129,0;;;;;;;4,0;5,0;;;;2,0;;22,0;4,0;9,0;;;44,0;8,0;33,0;12,0;;25,0;307,0;1,0;56,0;62,0;1,0;1,0;;;1,0;4,0;;1,0;1,0;10,0;;24,0;;;61,0;;;;;716,0;1,0;97,0;2,0;;2,0;2,0;34,0;4,0;1,0;1,0;;1,0;;4,0;2,0;80,0;;10,0;1,0;13,0;10,0;;32,0;;1,0;16,0;1,0;13,0;4,0;7,0;;4,0;10,0;40,0;11,0;34,0;6,0;;5,0;24,0;28,0;1,0;1,0;;;;33,0;3,0;;2,0;;9,0;14,0;12,0;35,0;15,0;;3,0;7,0;;2,0;107,0;;1,0;;18,0;;;17,0;;;81,0;1,0;6,0;;;1,0;;;2,0;4,0;6,0;2,0;9,0;10,0;34,0;;3,0;;;1,0;2,0;;;;;4,0;1,0;;;;3,0;;;;;;2,0;23,0;;5,0;;;1,0;;;;;;;;;;96,0;3,0;;;5,0;;;;7,0;2,0;1,0;1,0;;;;;;4,0;120,0;1,0;1,0;22,0;4,0;14,0;;;;14,0;6,0;6,0;4,0;;1,0;;;;;;75,0;;;21,0;;;2,0;;;;4,0;;1,0;9,0;;1,0;4,0;12,0;2,0;10,0;;;1,0;;1,0;;;18,0;;1,0;3,0;93,0;9,0;;;7,0;;5,0;;2,0;;;;;;1,0;;3,0;;;;23,0;;2,0;;;25,0;6,0;;;;1,0;12,0;9,0;;;;8,0;1,0;;4,0;;;7,0;;;;2,0;;;;2,0;9,0;26,0;;;;;;;17,0;;;43,0;2,0;42,0;;6,0;;12,0;;;3,0;1,0;;;;;7,0;;;;;;3,0;26,0;2,0;22,0;;;4,0;25,0;1,0;21,0;1,0;;;;5,0;;1,0;19,0;252,0;7,0;;;2,0;;;14,0;4,0;;;;;;;8,0;7,0;1,0;;5,0;6,0;;23,0;;;;;;1,0;;;3,0;;6,0;5,0;1,0;1,0;1,0;;2,0;;;;5,0;1,0;33,0;3,0;3,0;;2,0;4,0;2,0;;;;4,0;2,0;12,0;;;;;;;;;1,0;21,0;;;2,0;;;;4,0;;;;;;;1,0;;;5,0;5,0;;;6,0;;6,0;;3,0;;;;;2,0;;6,0;;;5,0;;;22,0;;;1,0;;;;3,0;;16,0;;1,0;;;;;;;;;7,0;1,0;;1,0;;1,0;1,0;;;;4,0;;;15,0;;;2,0;6,0;11,0;;;;13,0;;;2,0;;11,0;;;;;;;;;;2,0;4,0;4,0;;;;5,0;;;;;;;;;;;;;2,0;1,0;;;;;;;;;;;;;;1,0;1,0;;52,0;;;;;;;;;;;;2,0;1,0;;;;3,0;;;;;;;;2,0;;;2,0;66,0;;;9,0;;;;;;;2,0;;1,0;;;;;3,0;;48,0;;;;;1,0;8,0;;;;;;;;;;1,0;;;;;;;;2,0;;;;14,0;;;;;;;;;;11,0;;;;9,0;;;;;2,0;;;5,0;1,0;;3,0;1,0;;2,0;7,0;;1,0;;1,0;;10,0;;9,0;;;1,0;12,0;;;1,0;13,0;;;;;;;;4,0;;5,0;;;;;;;;;2,0;;;;;1,0;1,0;1,0;;23,0;6,0;;;;;;2,0;2,0;;;;;10,0;9,0;;1,0;;;;;;;2,0;7,0;;1,0;1,0;19,0;;;;;;;;;17,0;2,0;;;9,0;;;;;;;;;;;1,0;;4,0;;;2,0;;;;;2,0;;;;;;;;;;;;;;;;7,0;;;7,0;;;;;;;;;;;;;;;;;;;;;;;;2,0;;;;;;2,0;;;;4,0;;;;3,0;;3,0;;;;;1,0;;1,0;;;3,0;;;;1,0;;;;16,0;;;;;1,0;5,0;;;16,0;;6,0;;;2,0;;;;;;;;1,0;;;;;1,0;;;;;;3,0;;;;;2,0;;;;;1,0;;;;;;;1,0;;5,0;;26,0;;;;8,0;;;;;;;;;;;;;;;;;;;;;1,0;;;;;;;;;2,0;;;;;;2,0;;;;11,0;;;;;;;;;;;;;;;;;;;;;;4,0;;;;;;;;;;;;;;;;2,0;;;4,0;;;;2,0;;;;;;;;;;;
parallax;;;;11,0;21,0;19,0;84,0;6,0;;;;;;53,0;;3,0;96,0;;;20,0;;;6,0;;;30,0;;16,0;4,0;22,0;74,0;4,0;2,0;2,0;;56,0;;;58,0;;55,0;20,0;;2,0;4,0;;;;6,0;36,0;1,0;;3,0;;6,0;4,0;;;;41,0;;;16,0;;308,0;;29,0;2,0;;;6,0;17,0;3,0;;;;;172,0;;;37,0;;;;199,0;;;5,0;4,0;1,0;1,0;;;;1,0;;38,0;18,0;88,0;15,0;4,0;33,0;;16,0;26,0;22,0;1,0;3,0;2,0;1,0;;7,0;31,0;;;;9,0;;47,0;5,0;31,0;;;;;12,0;13,0;;;;18,0;;3,0;33,0;;;44,0;5,0;1,0;;;3,0;;;;2,0;8,0;;8,0;;;2,0;;;;1,0;;;;;;;;19,0;3,0;;4,0;;;6,0;;1,0;;;;2,0;;;;;;;2,0;3,0;;;7,0;;16,0;;;;;;;;;;1,0;;;;;;93,0;;;;7,0;;;1,0;;2,0;;;10,0;2,0;;36,0;3,0;2,0;;;;;11,0;;;5,0;;;53,0;2,0;;4,0;;;;1,0;;;;;;22,0;6,0;;4,0;;;;;;;;6,0;1,0;;;;;;3,0;1,0;;;;;;;;;;;;;28,0;;;;;2,0;;;;;;;;;;;;3,0;;28,0;;;;;;;;;;;;1,0;13,0;;;;;5,0;;9,0;;1,0;;;18,0;3,0;11,0;;;;;;;;;;;3,0;;;;;;;;;;;;6,0;6,0;;;;;;;2,0;;;1,0;16,0;;;;;;;;;;;1,0;;;89,0;1,0;;;;;8,0;2,0;2,0;6,0;;;1,0;46,0;1,0;36,0;4,0;;;;4,0;;;;;3,0;3,0;;;;;;10,0;3,0;2,0;;14,0;;;;;2,0;;;;;;;;;;;;1,0;;2,0;;;;;;;;;1,0;4,0;;;;;20,0;3,0;;2,0;39,0;;1,0;;5,0;;;;;;12,0;17,0;;;9,0;1,0;;1,0;;;;1,0;;;;;;;;;;;;;;;;12,0;;2,0;31,0;2,0;3,0;;;8,0;;;;;1,0;;1,0;;13,0;;;;;1,0;;;;;;42,0;;;;;;1,0;;;;;;;;1,0;;;;;;;;;9,0;;;19,0;;22,0;;;;;;;;;;;;;;;;;;2,0;;;;;;;;;1,0;;;3,0;;;8,0;;6,0;;;;;;;12,0;;;;;;;;3,0;;;;;;;;6,0;;;;;;9,0;;;;;;;;2,0;;1,0;;;1,0;;;5,0;;;;3,0;;;12,0;;;;;;;1,0;;;;;;;;;1,0;;;;;;;1,0;;;;;12,0;1,0;;;3,0;;;;;;;;;;;;;;;;1,0;;1,0;;8,0;;;;;;;;;;;;;;;;;;;;;;;;1,0;;;;;;;;1,0;;;;;;;;;28,0;;;;;;;;;;;;;;;1,0;;;;19,0;;;;1,0;;;;1,0;4,0;1,0;;;;;;;7,0;;;;;;4,0;;;;;;;;;20,0;;;;;;;;;;1,0;;;;5,0;1,0;;;3,0;;;;2,0;;;;3,0;;;;;;;2,0;;;;;;;;;;;2,0;;;;;;;;;;;;19,0;;;;4,0;;2,0;;;;;5,0;;24,0;;;;;;;6,0;2,0;1,0;;;;;;;;9,0;2,0;;;;;;;;;;;;;;;14,0;;34,0;;2,0;;;;;;;4,0;;;;;;;;;1,0;;;;1,0;;;;;;;;;;;;;;;;;;;;;;;;;;;;;;;;;;;;;;;;;;;;;;;;;;;;;;;;;;;;;;;3,0;;;;;;;;;;;7,0;;;;21,0;;;;;;;8,0;24,0;;3,0;;;;13,0;1,0;;;;;;;;2,0;;
parallel;;;;4,0;;24,0;20,0;41,0;;;1,0;3,0;21,0;100,0;;;38,0;1,0;11,0;;2,0;;;;12,0;;;19,0;7,0;;63,0;4,0;3,0;;1,0;30,0;28,0;25,0;8,0;5,0;23,0;71,0;7,0;6,0;13,0;83,0;;34,0;;;;2,0;180,0;8,0;16,0;1,0;37,0;1,0;;6,0;4,0;;2,0;;208,0;;81,0;3,0;1,0;17,0;14,0;174,0;55,0;1,0;;;1,0;2,0;1,0;13,0;55,0;;27,0;3,0;36,0;29,0;;327,0;6,0;;6,0;6,0;22,0;;;;70,0;319,0;141,0;41,0;90,0;11,0;14,0;12,0;15,0;31,0;2,0;3,0;;;;12,0;12,0;5,0;1,0;1,0;;16,0;2,0;91,0;4,0;;31,0;1,0;;2,0;49,0;;;2,0;21,0;;2,0;75,0;2,0;3,0;19,0;9,0;;1,0;3,0;1,0;;;11,0;3,0;19,0;78,0;;2,0;;1,0;33,0;34,0;;;;;;;10,0;50,0;;4,0;3,0;;16,0;16,0;3,0;;3,0;;10,0;374,0;2,0;40,0;;4,0;;2,0;;3,0;;91,0;1,0;1,0;12,0;2,0;23,0;36,0;1,0;;9,0;7,0;1,0;17,0;41,0;3,0;14,0;3,0;1,0;4,0;;5,0;6,0;;56,0;6,0;28,0;51,0;23,0;24,0;4,0;;;8,0;16,0;;;12,0;16,0;4,0;;6,0;51,0;2,0;134,0;;;;;;1,0;;6,0;;2,0;;;22,0;;14,0;17,0;1,0;;7,0;5,0;36,0;135,0;3,0;9,0;;4,0;27,0;37,0;2,0;41,0;266,0;1,0;;7,0;17,0;3,0;18,0;25,0;;;2,0;;13,0;6,0;7,0;23,0;3,0;9,0;;3,0;44,0;20,0;4,0;7,0;12,0;542,0;42,0;;2,0;24,0;11,0;54,0;;25,0;7,0;9,0;10,0;2,0;3,0;53,0;8,0;4,0;10,0;3,0;3,0;6,0;;;11,0;6,0;4,0;11,0;49,0;8,0;4,0;1,0;;14,0;4,0;12,0;4,0;4,0;14,0;3,0;9,0;18,0;4,0;29,0;;4,0;6,0;9,0;8,0;13,0;3,0;13,0;7,0;1,0;9,0;;;;1,0;43,0;28,0;17,0;2,0;2,0;4,0;23,0;48,0;;5,0;;2,0;3,0;;3,0;6,0;;32,0;15,0;2,0;;1,0;1,0;2,0;;1,0;;;;;1,0;;8,0;42,0;1,0;2,0;;;1,0;;15,0;11,0;;3,0;1,0;10,0;7,0;;;;;3,0;;3,0;3,0;2,0;;19,0;4,0;9,0;3,0;6,0;18,0;3,0;8,0;8,0;;;14,0;;5,0;9,0;;9,0;;10,0;8,0;1,0;1,0;;;1,0;3,0;1,0;2,0;34,0;3,0;3,0;;2,0;4,0;;;;;1,0;2,0;10,0;10,0;;;10,0;;19,0;8,0;1,0;;3,0;5,0;;;4,0;4,0;;3,0;2,0;1,0;21,0;;3,0;23,0;;;3,0;;9,0;;;;;;3,0;11,0;1,0;;13,0;2,0;27,0;;;21,0;;;7,0;1,0;6,0;11,0;;8,0;1,0;;;;3,0;1,0;2,0;2,0;3,0;;4,0;5,0;3,0;4,0;2,0;12,0;29,0;6,0;;;;;3,0;;;;;;;1,0;3,0;9,0;3,0;;6,0;;;3,0;;1,0;;5,0;2,0;4,0;35,0;37,0;;;;6,0;2,0;;;10,0;9,0;;1,0;;5,0;;;1,0;2,0;;4,0;;4,0;;9,0;;;;;;6,0;;2,0;18,0;;1,0;;;1,0;;4,0;40,0;10,0;;;4,0;1,0;;;14,0;5,0;3,0;1,0;10,0;;7,0;3,0;1,0;;;1,0;1,0;;2,0;4,0;3,0;;;;;;;;;;;13,0;;;;35,0;;;;;;20,0;;;;2,0;;;6,0;;;;;;1,0;;;;9,0;;27,0;11,0;3,0;3,0;4,0;8,0;2,0;1,0;;1,0;;4,0;;2,0;1,0;;16,0;;5,0;;;1,0;;2,0;1,0;1,0;8,0;;4,0;;7,0;;12,0;;1,0;;2,0;;;;10,0;;;;;23,0;;;;3,0;;2,0;3,0;12,0;;;3,0;19,0;;4,0;1,0;;;;5,0;9,0;9,0;21,0;;1,0;1,0;;;;20,0;;1,0;2,0;5,0;2,0;;;;1,0;2,0;;4,0;31,0;33,0;;1,0;;;;2,0;1,0;23,0;4,0;1,0;19,0;4,0;5,0;1,0;;32,0;2,0;;4,0;5,0;1,0;3,0;;5,0;13,0;2,0;;;1,0;;;12,0;;3,0;12,0;;3,0;;7,0;;;;1,0;;1,0;5,0;;;;2,0;;4,0;6,0;;;;;;;1,0;18,0;2,0;;16,0;;6,0;9,0;;;1,0;;;;;;2,0;;;;;;;2,0;1,0;2,0;;;;;9,0;;;;2,0;3,0;;;31,0;1,0;1,0;2,0;;5,0;;5,0;;;;5,0;;;;;1,0;1,0;1,0;;;;;;;;15,0;1,0;;;;1,0;5,0;5,0;;;;1,0;6,0;;;;;;3,0;;;9,0;;3,0;3,0;;;;;;16,0;;;;;;;;;;16,0;;;;;;;;1,0;;1,0;;;;5,0;4,0;;;2,0;17,0;;4,0;;;2,0;;;2,0;;7,0;12,0;1,0;1,0;;;1,0;7,0;;8,0;;;;11,0;22,0;;12,0;;;;;9,0;;4,0;3,0;;;2,0;;1,0;;;4,0;;;;;;;;;;;2,0;1,0;;;;8,0;14,0;;;;1,0;;;1,0;;;;;;;;;;;;;1,0;1,0;;25,0;;;;;;;;
partial;;;;1,0;;;1,0;;;1,0;;2,0;1,0;31,0;;2,0;25,0;;4,0;;8,0;;;;;;1,0;;1,0;1,0;10,0;;;;;32,0;11,0;4,0;25,0;;8,0;25,0;;;36,0;4,0;;27,0;6,0;;;;3,0;;1,0;;15,0;;;27,0;3,0;;9,0;;275,0;;38,0;2,0;4,0;;2,0;64,0;14,0;;;;3,0;;;;25,0;;3,0;9,0;4,0;42,0;;21,0;;3,0;4,0;4,0;1,0;1,0;;;1,0;1,0;49,0;10,0;9,0;4,0;;4,0;7,0;16,0;;;;;;2,0;167,0;;;;10,0;11,0;31,0;2,0;1,0;;14,0;2,0;;;14,0;;;;6,0;;;54,0;4,0;;11,0;;;1,0;;;;;;2,0;77,0;3,0;;1,0;;;9,0;;;1,0;;28,0;8,0;28,0;;4,0;3,0;;1,0;;3,0;3,0;;1,0;;;15,0;4,0;;2,0;;1,0;;;;;6,0;5,0;;;8,0;;13,0;;;;;;;2,0;6,0;;3,0;;;2,0;;;1,0;;10,0;2,0;5,0;5,0;;;;;;25,0;13,0;;;2,0;1,0;;;;1,0;;20,0;;;1,0;;;8,0;19,0;1,0;2,0;10,0;24,0;;36,0;;8,0;;;;46,0;3,0;;3,0;2,0;;;;34,0;3,0;;5,0;75,0;1,0;;5,0;3,0;2,0;7,0;;;;;1,0;6,0;1,0;2,0;2,0;;;;;6,0;;;;;3,0;7,0;;;;1,0;6,0;2,0;3,0;;;;;;6,0;9,0;;;;;2,0;;;;;;19,0;;;;14,0;;;;2,0;;1,0;1,0;1,0;16,0;7,0;2,0;;;;;;;;;;3,0;;;;;;;;;;1,0;;4,0;6,0;2,0;3,0;;;;;;1,0;;;;5,0;;;;;;;5,0;;;;;2,0;;6,0;62,0;13,0;1,0;;;1,0;;15,0;31,0;;11,0;;13,0;;1,0;;7,0;;;;5,0;;;;;;;;6,0;;3,0;;1,0;;7,0;;;;4,0;;;1,0;4,0;;;;;;;;;;3,0;;1,0;;;;;2,0;;1,0;;;;;;;1,0;;28,0;1,0;;;;7,0;;;;;;;;;;;1,0;4,0;1,0;;7,0;;;;3,0;;;1,0;;;1,0;;;;;;;7,0;;;;;4,0;11,0;;;6,0;;;;;;;11,0;;;;;;;6,0;;1,0;;;;;;2,0;;5,0;;2,0;;;;5,0;;1,0;;;;;3,0;;;;2,0;;;2,0;;;;8,0;2,0;3,0;2,0;;;;;;;;;36,0;;;1,0;;;1,0;;2,0;;;;;;2,0;;;;;;14,0;;;;;3,0;;;1,0;1,0;;;;11,0;;;2,0;;2,0;1,0;9,0;;;;;;;;;;;;;;3,0;2,0;;;;;;;;;;;6,0;;;;;;;1,0;;;;;;;;2,0;;;1,0;;2,0;;;;;;;;;;4,0;1,0;;;29,0;;;;;;;3,0;;6,0;1,0;;;4,0;;;;;;;;;;;;;;;;20,0;;;;;3,0;;;;;;;;;;;;6,0;;;;;;;3,0;19,0;20,0;;2,0;;;;;;2,0;1,0;;;1,0;;;;;;10,0;;;;1,0;;;;;;1,0;5,0;2,0;;;;;;6,0;;;;;;;;;;;;;;;3,0;4,0;;;;;;;;;;;;;;;;;;;;;;4,0;;;;;;1,0;1,0;;21,0;;1,0;;;;;;;;;;;;;1,0;4,0;;;;;;;;;;;;;;;;;;;;;;;;38,0;;2,0;;;;;;2,0;;1,0;;;2,0;;;;;;;;;;;;2,0;;3,0;6,0;4,0;;;;;;;;;;;;;;2,0;6,0;;1,0;2,0;;;;;;1,0;;;;;;;;;;;1,0;;3,0;;;;1,0;;;;;;;;;;2,0;1,0;;;1,0;;;;;;;;1,0;;;;;;;;;;6,0;;;;;;;;;;;;;;;1,0;;;2,0;;;;;;133,0;;5,0;;;;;;;;;;;;;;1,0;;;;;;;;;;;;;7,0;;;;;;6,0;;1,0;;;1,0;;;;1,0;;
peak;;;;2,0;5,0;3,0;1,0;7,0;;;;3,0;;31,0;6,0;;12,0;;;4,0;;1,0;21,0;;;;;;;;13,0;1,0;;;1,0;2,0;;2,0;35,0;;41,0;20,0;;;5,0;;;;;;;;;;4,0;;3,0;;39,0;;;6,0;;;53,0;;13,0;;;3,0;;24,0;35,0;;;;;;;;20,0;;1,0;1,0;16,0;;;34,0;;3,0;1,0;;1,0;;;;33,0;3,0;64,0;14,0;34,0;2,0;;;7,0;;;;2,0;;;;25,0;;;;;2,0;1,0;;;;7,0;;22,0;;14,0;;10,0;2,0;22,0;;;3,0;;;3,0;;;;;;;;2,0;1,0;;2,0;21,0;;;2,0;;;;;;;;;;;1,0;5,0;4,0;;;;2,0;9,0;37,0;;;26,0;;;;2,0;;;21,0;1,0;;1,0;;;22,0;;1,0;;;;;;;;;;;;;;10,0;;7,0;;;;2,0;;2,0;3,0;;;;;1,0;2,0;;1,0;8,0;8,0;;1,0;2,0;;3,0;;;;;;13,0;22,0;;;;;;;;;;;;15,0;;;12,0;;;;;;3,0;;;6,0;;;8,0;;;;;;;63,0;7,0;;;;;2,0;;;;1,0;;1,0;;2,0;1,0;;;;;3,0;;;;;;;;;4,0;;;;;;;;;;;;3,0;;;;;;;;2,0;;;;;16,0;;1,0;;;;;37,0;;;;;;;;;;;;2,0;2,0;;;;;;;;;;;;;;;;;1,0;;;;;;;;;2,0;;;;;8,0;13,0;3,0;;;;1,0;;13,0;2,0;;;;38,0;;;;;13,0;;;21,0;3,0;5,0;;9,0;4,0;;;;2,0;;3,0;;;;14,0;;;;;9,0;6,0;;;;;;;;2,0;;;;;40,0;;;;;2,0;;;;5,0;2,0;;;1,0;;7,0;;;1,0;7,0;;;;;3,0;;4,0;;;;8,0;;3,0;3,0;;;;;;;;;;;;1,0;;;;;;;;;;;;;;8,0;;;;;;1,0;;;;;;;;;2,0;;;4,0;;;;;;;1,0;;;;;;;;;;;;;;;;;;;1,0;;;;;;3,0;;;;;4,0;;;;;;;;;;;;;;;;;;;;;;;;;;;;;;;;;;5,0;;;;2,0;;;1,0;;6,0;;;;;;;;;7,0;;;;;;;3,0;;;;;;;;1,0;;1,0;;;;;;;;;5,0;;;13,0;2,0;;;;;;;;;;;;;;;;;;;;;;;;;;;;;;;;3,0;;3,0;;;;;;;1,0;;;;;;10,0;;;;;9,0;;;;;;;;2,0;;;;;;;2,0;;;;;;;4,0;;;;;;;;;;;;;;;;;;4,0;;;;4,0;;;;;3,0;;;;;;;;;;;;;;;;;;;;;;;2,0;;;;;;;;;;;;;;;;;;;;;;;;;;;;;1,0;;;;;;;;;;;;;;;5,0;;;;;;;;;;;;;;3,0;11,0;10,0;;;;;;;;;12,0;;;;5,0;;;;;;;;14,0;;;;;;;;;;;;4,0;;;;;;2,0;;;;7,0;;;;;;;;;;;7,0;;;;;;;;;;;4,0;6,0;;;;;;2,0;;;;;;;;;;;;;;;;;;;;;;;;;;;;47,0;;6,0;;;;;;;;;;;;;;;;;;4,0;2,0;;;;;;;;;;;;;;2,0;;;;;;;;;;;;;;;;;;;8,0;;;;;1,0;;;;;;;;7,0;;;;;;;;;;;1,0;;;;3,0;;;;;;;;;;
periphery;;;;2,0;;13,0;3,0;8,0;;;;;10,0;17,0;;;21,0;;3,0;;15,0;;2,0;;;;;2,0;;2,0;20,0;;;;;6,0;10,0;4,0;1,0;;1,0;55,0;2,0;1,0;30,0;41,0;;22,0;;;;;35,0;1,0;3,0;;43,0;;;12,0;;;1,0;1,0;104,0;;31,0;1,0;;;1,0;107,0;10,0;;2,0;;3,0;2,0;;;7,0;;;;30,0;2,0;;14,0;;;;;;3,0;4,0;;1,0;3,0;69,0;6,0;25,0;8,0;;1,0;4,0;4,0;;;;;;;22,0;;;;;2,0;15,0;21,0;;1,0;4,0;1,0;;;8,0;;2,0;6,0;;;;16,0;;;4,0;;2,0;;6,0;8,0;;;17,0;2,0;5,0;26,0;5,0;7,0;;1,0;20,0;7,0;;;7,0;;;;3,0;1,0;;;;;14,0;29,0;;2,0;2,0;;;15,0;;6,0;;;1,0;;;;;1,0;;2,0;6,0;;6,0;4,0;;;3,0;;24,0;25,0;27,0;;37,0;;3,0;2,0;;;;;46,0;2,0;;27,0;5,0;;5,0;;;110,0;;;;1,0;;;;1,0;15,0;;75,0;;;;10,0;;;;3,0;;1,0;;;10,0;1,0;12,0;1,0;;7,0;;1,0;8,0;35,0;4,0;;2,0;;6,0;12,0;;12,0;69,0;11,0;;2,0;;;47,0;6,0;;;;;24,0;;1,0;5,0;1,0;2,0;;;;5,0;;;7,0;4,0;39,0;;;;2,0;27,0;3,0;53,0;;;;;4,0;16,0;;1,0;;;12,0;;;;9,0;1,0;1,0;;4,0;;;4,0;;;;24,0;12,0;3,0;;6,0;2,0;8,0;;;;3,0;3,0;2,0;4,0;4,0;;;4,0;;9,0;;1,0;;2,0;3,0;;;;10,0;;3,0;20,0;;5,0;;;;;2,0;;;12,0;1,0;;2,0;;;;;1,0;;;;;;;;41,0;;;1,0;;;;1,0;2,0;;;;2,0;;;;;;1,0;;;;;;;;;;;1,0;;;1,0;;1,0;;;;8,0;4,0;;1,0;;;;;;;;;;;2,0;;1,0;;;13,0;;;1,0;;;;;1,0;;1,0;;;;;4,0;;;1,0;;4,0;;;;;;;;;;;;;;;;;;;;;;;1,0;4,0;;;2,0;;;26,0;;;;;12,0;;;;;;;;3,0;;1,0;3,0;;;;1,0;;;;;;;;;;;;;;;;;2,0;;;;;2,0;;;;3,0;;6,0;;2,0;;;;;;2,0;;;1,0;;;;12,0;;;;;;;;;;;;;;;;;;;4,0;;1,0;;;;;;;;;3,0;2,0;;;;6,0;2,0;;;;;;8,0;;;;;;;;;;;;4,0;1,0;;;;;1,0;2,0;;;1,0;;2,0;1,0;8,0;;3,0;;;;;;;;;;;;;;;;;2,0;;;;1,0;;;;2,0;;7,0;;1,0;;;;;;;;2,0;1,0;;;;;;;2,0;;;;;;;;;;;;;;;;;1,0;;;;;8,0;;;;;;;;1,0;;;2,0;;;;1,0;;;1,0;;;;;;9,0;8,0;;;;;;;2,0;;;;;7,0;;;;;;;;;;;;;;2,0;3,0;;2,0;;;3,0;;;;1,0;;;;;;;;;1,0;29,0;3,0;;;24,0;;;;2,0;3,0;;;1,0;;1,0;;;;;;3,0;6,0;;;;3,0;;2,0;;;;;;5,0;;;1,0;;;;;;;;;5,0;;;;;;;;;;1,0;;;;;;;;;;;;;;;;;;;1,0;;;;;4,0;;;;;;;;;;;;;;;;;;;;;;;;;;;;;;;;;;;;;;;;;;1,0;;;;;;1,0;8,0;;;;;;;;;;;;3,0;;;;;;;;;;;;;1,0;;1,0;;1,0;;;;;;;;;;;;;;2,0;;;;;;;1,0;1,0;;;1,0;;1,0;;;;;6,0;;;;;;;1,0;;;;6,0;2,0;20,0;;;;;;;2,0;;;6,0;2,0;;;;;;;;;;;;;;;;;;;;;;;;;;;;;;;;;;;
permanent;;;;2,0;;;;1,0;;;;;1,0;6,0;;;;;;;;;;;;;;;;;3,0;;4,0;2,0;;;;2,0;;;;5,0;;;;36,0;;;;;;;;37,0;1,0;;8,0;;;12,0;4,0;;;;1,0;;26,0;;;1,0;;7,0;;;;;3,0;;;1,0;2,0;;;;14,0;8,0;;1,0;;;;1,0;;;;;;;7,0;2,0;26,0;;;;;;;;;;;18,0;;;3,0;;;;;20,0;;;;;;;1,0;;;;;;;4,0;;;;;;;;;;;;1,0;;8,0;1,0;5,0;;;2,0;;;;;;;;;1,0;;;;;1,0;5,0;;;3,0;;;10,0;;2,0;2,0;;;;;;;33,0;;;2,0;18,0;54,0;;;;;2,0;4,0;;3,0;;2,0;;;;;;;;2,0;;;7,0;;;;;;;;;;;1,0;;;;3,0;;11,0;;;;;;;;;;;2,0;;;;6,0;;;;;;1,0;8,0;;;;;2,0;;;;4,0;1,0;;;;;;;;;;;;;2,0;6,0;;;;;;;;;1,0;1,0;;;;;;;;21,0;;;;;;1,0;;;2,0;;;;;;;;;2,0;;;;3,0;;;;;;;;;;6,0;;;;;;;;;;;;1,0;;;;;;15,0;3,0;;;;;1,0;1,0;;1,0;;;;;;;;26,0;1,0;;4,0;;;;;;;;;;;;;;3,0;;;;;;;;;;;2,0;;;;;;;;2,0;;;;;;;;;;;;18,0;;;;2,0;;;;2,0;;;1,0;;;;;;;;;;;;;;6,0;;;;;;1,0;;4,0;;;;;;;;;;;;;;;;;;;;;;;;;;;;;;;;;;;;;;;;;;207,0;;;1,0;;;2,0;2,0;1,0;;;;1,0;;;;;;;;;;;;;1,0;;;;;;;;;;;;;;;1,0;;;1,0;;;;;;;;;;2,0;;;;;;;;;;1,0;;;;;;;;;;;;;;;;;;;3,0;;;;;3,0;;;;;;;;3,0;;;;;;;;;;;;;;;;;;;;;;;;;;;;;;;;;;;;;;;;;;;;;;;;;;;;;;;;;;;;;;1,0;1,0;5,0;;;3,0;;;;;;;;;;;;;;;;;;;;;;1,0;;;;;;;;;;;;;;;;;;;;;;;;;1,0;;1,0;;;;2,0;;;;;;;2,0;3,0;3,0;;;;;;;;;;;;;;;9,0;;;;;;;;;;;;;;9,0;;;;1,0;;;;;;;;;;;;1,0;;;;;6,0;;;3,0;;;;;;;;;;;;;;;;;;;;;1,0;;2,0;;;;;;;1,0;;;;;;;;;;;;;;;;;;;;;;;;;;;;;;2,0;;;;;;;;;;;;;;;;;;;;1,0;;;;;;;;;;;;;;;;;;;;;;;;;;;;;;;;;;;;;;;;;;;;;;;;;;;;;;;;;;;;;;;;;;;;;;;;;;;;;;;;;;;;;;;;;;;;;;;;;;;;;;;;;;;;;;;;;;7,0;;;;;;;;;;;;;;;;;;;;;1,0;;;;;;;;;;;;;;;;;;;;;;;;2,0;;;
perpendicular;;;;3,0;4,0;29,0;28,0;23,0;;;9,0;;14,0;48,0;;;10,0;;1,0;;;;;;1,0;;1,0;20,0;3,0;;36,0;4,0;1,0;7,0;8,0;3,0;11,0;11,0;1,0;;10,0;27,0;2,0;2,0;7,0;34,0;;21,0;;;;6,0;90,0;6,0;2,0;3,0;15,0;;;13,0;;;9,0;;64,0;;20,0;;1,0;19,0;25,0;158,0;28,0;8,0;;;3,0;1,0;;;20,0;;;;52,0;40,0;;450,0;;10,0;;;15,0;;;;33,0;249,0;23,0;15,0;48,0;3,0;13,0;;7,0;5,0;;1,0;;;;22,0;13,0;4,0;1,0;;;10,0;;54,0;;;4,0;1,0;;1,0;15,0;;1,0;13,0;1,0;;;55,0;;;14,0;10,0;;;;7,0;;;5,0;2,0;3,0;15,0;;7,0;;2,0;31,0;44,0;;;2,0;;;2,0;1,0;9,0;;;;;4,0;10,0;;;4,0;;3,0;877,0;4,0;40,0;;;5,0;;;;;37,0;2,0;;11,0;12,0;44,0;25,0;;;1,0;1,0;7,0;2,0;30,0;6,0;3,0;1,0;;7,0;2,0;;9,0;1,0;54,0;3,0;1,0;55,0;55,0;39,0;1,0;;;6,0;;27,0;;10,0;4,0;1,0;;5,0;46,0;;72,0;;4,0;;6,0;;2,0;;17,0;;;5,0;;2,0;;5,0;7,0;1,0;1,0;6,0;1,0;12,0;78,0;5,0;6,0;1,0;4,0;18,0;38,0;2,0;20,0;167,0;2,0;;;;4,0;19,0;22,0;;;2,0;;6,0;6,0;;9,0;1,0;8,0;;2,0;37,0;4,0;1,0;12,0;;776,0;21,0;;;13,0;2,0;18,0;1,0;26,0;4,0;;14,0;;7,0;12,0;;16,0;1,0;5,0;4,0;4,0;;2,0;2,0;8,0;3,0;3,0;22,0;5,0;1,0;2,0;;4,0;3,0;14,0;9,0;4,0;5,0;3,0;4,0;13,0;5,0;7,0;2,0;;2,0;1,0;4,0;2,0;;6,0;;;8,0;;;;4,0;30,0;49,0;6,0;;;;19,0;8,0;;3,0;6,0;;;;7,0;4,0;1,0;37,0;5,0;;;;;;;3,0;;1,0;;2,0;4,0;;2,0;26,0;4,0;1,0;;;;;4,0;7,0;;;;1,0;;;;;;2,0;;1,0;;;;10,0;;;;;1,0;;9,0;4,0;;;3,0;5,0;1,0;10,0;;1,0;;7,0;4,0;;;;;;;;;11,0;;3,0;;11,0;4,0;;2,0;;;;;;;;;2,0;;10,0;;1,0;;5,0;4,0;2,0;;3,0;;1,0;6,0;;2,0;2,0;;;1,0;;;;;;;;;;;;4,0;1,0;6,0;3,0;7,0;;;;31,0;;;1,0;;;4,0;4,0;2,0;;1,0;;;5,0;;;1,0;1,0;;9,0;;;;1,0;12,0;17,0;;;;;;;;;;;2,0;;;;7,0;3,0;;2,0;;1,0;;;;;5,0;;1,0;6,0;47,0;;;;;;;1,0;11,0;9,0;;;;;3,0;;;;;;;;;;;;;;;;;;1,0;;1,0;;;4,0;;;12,0;4,0;;;2,0;;;4,0;7,0;7,0;3,0;4,0;;;;4,0;;;;;;;;;;;;;;4,0;;;;1,0;;5,0;;;;6,0;;4,0;;;;1,0;;;;;;;5,0;;;;;;;;;;;2,0;;6,0;8,0;;6,0;5,0;;;;;;4,0;;;;;5,0;;;;2,0;;;;;3,0;13,0;;;;;;4,0;;;;;;;;3,0;;;;;3,0;1,0;;;;;;;18,0;;;6,0;1,0;;3,0;;;;;;16,0;33,0;6,0;1,0;1,0;;;1,0;1,0;3,0;;1,0;4,0;;1,0;2,0;1,0;;;;;;32,0;10,0;1,0;1,0;;;;1,0;3,0;29,0;;;11,0;7,0;5,0;1,0;3,0;4,0;1,0;;;1,0;;;;;5,0;;;;2,0;;;;;4,0;5,0;;4,0;2,0;3,0;1,0;;;1,0;;;1,0;1,0;;;1,0;;11,0;;1,0;;;;;;;4,0;;;;;3,0;;;;2,0;;4,0;;1,0;;1,0;;;;;;2,0;;;;;;;;10,0;1,0;;;2,0;;;;3,0;;;;;1,0;1,0;4,0;;;;;;;;;;2,0;;;;;;2,0;;;1,0;;1,0;;;;7,0;1,0;;;;1,0;;;;;;6,0;6,0;;;;;2,0;;;;;;;4,0;;;;;;;;;1,0;;;;;;;;;;;;;;1,0;;;;1,0;14,0;4,0;;;;;;;;;;16,0;;2,0;1,0;1,0;;;3,0;;;;;;;37,0;;3,0;1,0;;1,0;;1,0;;3,0;;;;2,0;;;;;2,0;;;;;;;;;;;;;;;3,0;1,0;9,0;;;;2,0;;;;;;3,0;;;;;;1,0;;;;;;;2,0;;;;;;;;
perspective;;;;6,0;4,0;5,0;1,0;6,0;;;;;;88,0;;;27,0;;;;;;3,0;;;;;;11,0;;10,0;2,0;5,0;37,0;;22,0;;8,0;30,0;;47,0;44,0;;;78,0;;18,0;;;1,0;1,0;;;1,0;9,0;;9,0;;;28,0;;;;;146,0;1,0;19,0;2,0;;;;6,0;6,0;;;;;;2,0;;51,0;;;18,0;2,0;1,0;;7,0;;;8,0;3,0;8,0;;;2,0;12,0;27,0;16,0;29,0;25,0;12,0;;;5,0;6,0;1,0;7,0;1,0;;;4,0;8,0;1,0;;;;2,0;54,0;8,0;;;2,0;;;;28,0;;;;7,0;;;1,0;;;75,0;60,0;;;;;;;;5,0;6,0;1,0;18,0;1,0;;10,0;2,0;;;;;;;;;;;;;1,0;2,0;;;;;;;;;;;;;;10,0;;;8,0;;;2,0;;13,0;6,0;;;;;;;;;;;;;;;1,0;1,0;;;1,0;7,0;;;5,0;;;;6,0;;;4,0;12,0;3,0;10,0;;;;18,0;;;;;;2,0;;;;;;;21,0;;2,0;1,0;;;2,0;;;9,0;;;;;3,0;;;3,0;18,0;;;;;;10,0;;;;;;;;;;;;;;12,0;;;;;1,0;;;;;;;;;1,0;;;;;29,0;3,0;;;;;1,0;;;;;4,0;;13,0;;;;;5,0;;;;1,0;;1,0;37,0;;3,0;;;;;;1,0;;;;;1,0;;;;;;;3,0;;;;;;;1,0;;;;;;3,0;;;;5,0;;3,0;;;;;;1,0;1,0;;;;;3,0;40,0;13,0;11,0;1,0;;;;12,0;4,0;;;;1,0;;10,0;;;;;1,0;3,0;;2,0;;2,0;;;;1,0;;;1,0;40,0;17,0;4,0;5,0;;;18,0;;2,0;6,0;1,0;;;;;;;;;;6,0;1,0;4,0;;;;;;;;;1,0;;;;;;;2,0;3,0;;;;38,0;;2,0;;;;;;;5,0;;;;;;1,0;;;;;;;;;8,0;2,0;3,0;;;;;;;;;14,0;2,0;4,0;21,0;8,0;;;;;;;;;4,0;;;;;;;;;;2,0;;;;;;;;1,0;3,0;;2,0;;;;;;5,0;;;;;;;;;;;;;;;;3,0;;;;;3,0;1,0;;;;;;;1,0;14,0;;;2,0;2,0;;;;2,0;;;6,0;;1,0;;;;;;;;1,0;7,0;;;;;;;;;;;;;;2,0;;;;;;;;;31,0;;;;1,0;13,0;;;;;;;;;1,0;1,0;6,0;;;;;1,0;;;;;;;;;;;;;;;;;;;1,0;;;2,0;;;;;;;;;;1,0;;;;;7,0;;;2,0;16,0;;;;2,0;;6,0;;;;1,0;;;;3,0;2,0;;4,0;4,0;5,0;;;;;;;3,0;;;;;;;;;;1,0;;;;;1,0;;;9,0;;;1,0;;;;;;;;;;;;;1,0;;;;5,0;;;;51,0;;;;;1,0;9,0;;;;3,0;;;;;;;;;;;;;;;;;;;;;;;;;;;;;;;;;;12,0;;;;;;;;1,0;;;;;;;;;;;;;;;;;;;;;;;1,0;;;;1,0;1,0;18,0;;3,0;;;;;;;;;;2,0;;;;14,0;;;;;;;;;1,0;;;;;;;;;1,0;;;;;8,0;;1,0;;;;;;5,0;;;;;;1,0;;;;;;;;3,0;;;;1,0;;1,0;2,0;12,0;;;;;;;;;;;;;;;;;;;;;;;;;;;1,0;;;;;;;;;;;;2,0;;;;;;;;1,0;;;;;;;;4,0;2,0;;;;;;;;;;;;;;;;;;;;;;;;4,0;;;;;;;;;;;9,0;;;1,0;;;;;2,0;;;;;;;;4,0;;;2,0;;;;;;;;;;;
photo;;;;4,0;1,0;21,0;91,0;;;;;;;18,0;;;85,0;1,0;8,0;;8,0;;2,0;;1,0;;;;2,0;1,0;19,0;;2,0;;1,0;34,0;1,0;2,0;2,0;;8,0;76,0;;26,0;26,0;4,0;;19,0;;;;;;8,0;3,0;1,0;6,0;;13,0;43,0;1,0;;;;126,0;;32,0;;;;8,0;24,0;68,0;;;;;2,0;3,0;4,0;39,0;;18,0;;30,0;;4,0;3,0;;;12,0;;1,0;;13,0;;4,0;3,0;51,0;1,0;3,0;2,0;;6,0;4,0;20,0;3,0;6,0;;;;23,0;8,0;;;1,0;;3,0;2,0;102,0;3,0;;69,0;3,0;;21,0;21,0;;;;17,0;;;14,0;;;25,0;1,0;;;;4,0;;;;2,0;12,0;3,0;1,0;;;;;;;;;;1,0;;30,0;3,0;7,0;3,0;1,0;;18,0;2,0;;4,0;108,0;;3,0;7,0;;10,0;18,0;;;;1,0;;;1,0;;;30,0;;22,0;6,0;;;1,0;2,0;2,0;2,0;;2,0;1,0;;;2,0;;4,0;1,0;5,0;4,0;;;1,0;;2,0;;;;3,0;53,0;3,0;;2,0;;;;18,0;;;1,0;;5,0;;1,0;1,0;1,0;1,0;1,0;;9,0;;;;;;;;;20,0;;;2,0;;;;;20,0;4,0;;5,0;12,0;1,0;17,0;;12,0;;3,0;;;12,0;1,0;;3,0;;1,0;;4,0;;;4,0;1,0;;;2,0;;;;;;;;3,0;;;;;;;;3,0;6,0;;;;;;1,0;;3,0;;;;3,0;;;;;1,0;;3,0;;;;6,0;15,0;;6,0;3,0;;;;1,0;;;;;1,0;15,0;;;;;;4,0;10,0;;;;;1,0;1,0;;;;;;;1,0;3,0;;;48,0;1,0;;;;1,0;;1,0;;;;4,0;;;;4,0;25,0;2,0;3,0;3,0;1,0;;8,0;;;2,0;;12,0;4,0;;;4,0;;;8,0;;;10,0;;2,0;1,0;;;3,0;1,0;4,0;;4,0;;;15,0;;;6,0;;3,0;14,0;3,0;;;5,0;;;;1,0;;1,0;34,0;1,0;8,0;5,0;;2,0;;49,0;;3,0;;1,0;4,0;1,0;8,0;;;5,0;1,0;;4,0;;;20,0;;;;5,0;;;;;;4,0;;4,0;;;5,0;;7,0;;;;;1,0;;3,0;5,0;;;1,0;;;;;;;3,0;;;8,0;;;;;;;2,0;;;;;;;;8,0;;2,0;;1,0;;;;;;;3,0;;;1,0;;;;;;;;;;;;;;;;2,0;;;;;;;;;4,0;;2,0;1,0;2,0;2,0;;;;1,0;;;;7,0;3,0;7,0;;;;;;;;;2,0;3,0;;;2,0;;;;;;24,0;;;;;30,0;;;7,0;;;;;;2,0;1,0;;;;;;2,0;;;;;;;;4,0;;;4,0;8,0;;36,0;;;;;;;;;1,0;;6,0;;13,0;1,0;3,0;;;;;;;;;1,0;;;;;;3,0;3,0;;7,0;;;;;;;1,0;;;;;4,0;;;;19,0;;;4,0;1,0;1,0;;4,0;;;1,0;;5,0;;;;;2,0;;;;;;;;;;20,0;;;;;;1,0;;;;;2,0;2,0;1,0;2,0;3,0;;1,0;;5,0;2,0;;;;;;;;2,0;;;;;;;;;;;;;;;3,0;3,0;;1,0;3,0;;;;;1,0;;;3,0;;;;;3,0;2,0;;2,0;;;;;;;;;;;;1,0;;;;;;;;;;6,0;;;1,0;;;;;;;;;;1,0;;;;;;;1,0;;1,0;;;;20,0;;;;;;4,0;3,0;;;;;1,0;;;;;2,0;;3,0;;1,0;;;;;;;;1,0;;;1,0;;;;;;;;;;;;;;;;;1,0;;;;;1,0;;2,0;;;;;;;;;5,0;;;;;;;3,0;;;;;;;3,0;;1,0;;;;;;;;3,0;;;;;;;;;;;;;;1,0;;;;2,0;;;;;1,0;;8,0;;;;1,0;;;;;;;;;;;;;;19,0;;;;;;2,0;;;;;;;1,0;8,0;;;;;;;;;;;;;;;;;;;;;4,0;;;;;;;;;;1,0;;;;;;;;;;;2,0;;;;;;;;;;10,0;;;;;
photographic;;;;7,0;9,0;22,0;;10,0;;;;;2,0;12,0;;2,0;20,0;;;;;;;;1,0;;;;;;17,0;1,0;6,0;9,0;;15,0;1,0;2,0;;1,0;17,0;70,0;;51,0;2,0;1,0;;4,0;;;2,0;;2,0;1,0;8,0;6,0;9,0;;;2,0;;;5,0;;114,0;;16,0;1,0;;;2,0;32,0;29,0;3,0;;;1,0;;;2,0;12,0;;1,0;;6,0;;1,0;44,0;;;;;10,0;5,0;4,0;;;;11,0;4,0;24,0;5,0;;;4,0;6,0;5,0;;;;;;;;2,0;;;;6,0;12,0;;;3,0;9,0;;3,0;34,0;;;;6,0;;;27,0;;;3,0;;1,0;;;8,0;2,0;;;1,0;9,0;;8,0;2,0;;2,0;12,0;;;;;;;;;2,0;;1,0;;;6,0;2,0;;;;;;10,0;2,0;3,0;;;9,0;;;;;2,0;;3,0;4,0;1,0;3,0;;;1,0;;3,0;;;;;;;;;;;;10,0;11,0;;10,0;19,0;6,0;23,0;;;;;3,0;;;;;3,0;;4,0;;;40,0;;3,0;;;;12,0;;;3,0;;;2,0;2,0;;1,0;;;;6,0;;1,0;5,0;;1,0;;;6,0;;;11,0;8,0;;;;1,0;;;;;;;;9,0;;;1,0;;;;1,0;;;;;;12,0;;;;;2,0;3,0;1,0;;1,0;;;;;;1,0;;3,0;;;1,0;;;;;;;12,0;;;;3,0;;;3,0;;;2,0;1,0;19,0;2,0;1,0;;;;;;;;;;;4,0;;1,0;;;;2,0;;;;;6,0;;;;;;1,0;;;22,0;;;2,0;51,0;;;;;;;5,0;;;;;;;2,0;4,0;2,0;;;;;;6,0;;;;;15,0;3,0;;;;;;;13,0;4,0;2,0;;13,0;;;;14,0;;1,0;;2,0;;;1,0;;;6,0;;;;2,0;;;;;;1,0;;;2,0;30,0;1,0;5,0;1,0;;;;4,0;1,0;21,0;;;95,0;;;;;2,0;;;;;10,0;7,0;;;;;2,0;;;;;;;;1,0;;2,0;;;;1,0;;;2,0;;1,0;15,0;;2,0;1,0;;4,0;;;4,0;;;;1,0;8,0;;;;;;1,0;;;;2,0;;;;;;;7,0;;1,0;;;;;1,0;;;;;;;;;;;;;;;;1,0;1,0;;;;;;;;1,0;;;;3,0;;;;1,0;;;;;;;5,0;10,0;;2,0;;1,0;;;;;;;;;1,0;;2,0;;;6,0;1,0;;;;;;;;;;1,0;;;;8,0;;;;;;;;;;;;;;;41,0;;;;5,0;;2,0;;3,0;;;1,0;2,0;;;1,0;;;1,0;;;;;;;;;;;;;;;2,0;1,0;;;;1,0;6,0;;;;;;;2,0;;;;;;;;;;;2,0;2,0;;;;2,0;;;;;;;;;;;;;;;;;1,0;2,0;1,0;;;;2,0;;1,0;;;1,0;;;;;;2,0;;;;;;;1,0;2,0;15,0;;;;;;1,0;;;2,0;;;;2,0;3,0;;;;;;;2,0;;;;1,0;;;;;;;;4,0;;;;;;;2,0;;;;;;;;;;;;;;;;;;;;1,0;;;;;;;;;;;;;;;;;;;;2,0;;;;;;;;;;;;;;;;;;;2,0;;;;;;;;;;;;1,0;;6,0;;;;;;;;1,0;;;;;;;;;;3,0;;;;;;;;;;1,0;;;;;;;;;;;;1,0;;;;;;;;;;;;;;;;4,0;;;;;;;;;;;;;;;;;;;;;;2,0;;;;4,0;;;;2,0;19,0;;;;;;;;;1,0;;;;;;;;;;;;;;;;;;;;;;;;;;;;;;;;;;;;;;;;;;;;;;;;;;;;;;;;;;;;;;;;;;;;;;;;;;;;2,0;;;;;;;;;;
photosensor;;;;4,0;2,0;3,0;201,0;2,0;;;2,0;;;6,0;;;36,0;4,0;;2,0;3,0;;;;;;;;;;46,0;15,0;4,0;;;18,0;;;2,0;;16,0;35,0;;2,0;;19,0;2,0;55,0;;;;;2,0;4,0;4,0;5,0;14,0;;1,0;10,0;;;;;100,0;;46,0;;;;5,0;66,0;96,0;;;;;;;2,0;25,0;31,0;;;6,0;3,0;;7,0;;1,0;;;;;;;84,0;13,0;64,0;6,0;20,0;1,0;;2,0;7,0;8,0;;1,0;;;;4,0;1,0;;1,0;;2,0;6,0;20,0;16,0;1,0;;19,0;7,0;;;71,0;8,0;;;1,0;5,0;;28,0;;5,0;4,0;;;;;8,0;;;;;;16,0;2,0;;;1,0;;;2,0;;;;;;;7,0;;1,0;;;20,0;;;4,0;4,0;;8,0;1,0;;64,0;;13,0;;;1,0;;4,0;1,0;;;6,0;;3,0;;;;;;;;21,0;5,0;;;;3,0;;;4,0;;1,0;1,0;;1,0;6,0;;;;;4,0;23,0;3,0;;;12,0;;;;;;52,0;;;;;;2,0;4,0;1,0;;;;;;;1,0;;;;2,0;;1,0;10,0;;;;;2,0;17,0;;;50,0;;;12,0;8,0;;1,0;;;;;;6,0;;2,0;21,0;;;;2,0;8,0;;;;;13,0;;;;7,0;;2,0;;;;;;;;;;;;;;;;;;;;5,0;9,0;;;1,0;;;;7,0;;8,0;;;10,0;2,0;9,0;;;;1,0;2,0;;;;;1,0;;;;;;;;;;;4,0;1,0;;3,0;;;;;;8,0;;;;1,0;;;1,0;;;;;;;;;;;;;;1,0;;;;;;17,0;;;;;11,0;;;;;;;;14,0;;;;;;;;;;4,0;;;;;;;;;;2,0;5,0;;3,0;;;;;;;;;23,0;;5,0;1,0;;5,0;;;;;;;;2,0;;;;;4,0;;;;;;;;;1,0;;;;;;;;3,0;;;2,0;;;;;;;;;1,0;;;;;;;;;;;8,0;3,0;;5,0;;;;;;;12,0;;;;;;;;;;;;1,0;;;;;;;;;2,0;4,0;;;;;2,0;;;;;;;6,0;;;;;;;8,0;;1,0;;;3,0;;;;1,0;;;;;;;;;;;;;;;;;;;7,0;;;;;;;2,0;;;;;9,0;1,0;1,0;;;;;;;;;;;;;5,0;;;;;;;;;;;;1,0;;4,0;;;;;;10,0;;1,0;;;;;;;;3,0;;;13,0;;;;;;;;;;;;;;;;6,0;2,0;;3,0;;;;;;;;9,0;9,0;;3,0;;;1,0;;;;;;;;;;;;;;;6,0;;;;;;;;;;;;;;;2,0;;18,0;;1,0;;;;;;6,0;;16,0;;;2,0;;;;;1,0;2,0;;;1,0;;;;;;;;1,0;;4,0;;;;;;;;;;;;;;;4,0;;;;1,0;;;;;;;2,0;;;;;;;;;;24,0;;;1,0;;;6,0;;;;;;;;;;;;;;;;;;;6,0;;;;;6,0;;;;;;;;;;;;;;;;;;;;;;;;2,0;;;;;;;1,0;;;;;1,0;;;8,0;2,0;;;;;;;1,0;;;;;;;;;;;;;;;2,0;;;;1,0;;;;;;;;;;3,0;;;;;;;;;;1,0;;;;;;;;;;;;5,0;;;;;;5,0;;;;;;;;;;;;;;;;;1,0;;;;;;;;;;;;;;;;;;;;;;2,0;5,0;;;;;;;;;;;1,0;;;;;;;;;;1,0;;;;;;;;;;2,0;;;;;;;;;;;;;2,0;;;;;2,0;3,0;;;;;;;;;;1,0;;;;;;;;;;
piece;;;;1,0;;8,0;2,0;7,0;;8,0;;;3,0;21,0;;6,0;1,0;;;;;;5,0;;1,0;;;9,0;1,0;;25,0;4,0;1,0;1,0;;70,0;6,0;2,0;1,0;;1,0;21,0;;35,0;3,0;14,0;;17,0;;;2,0;;12,0;;3,0;3,0;69,0;;;4,0;4,0;;10,0;1,0;47,0;;59,0;;2,0;;32,0;54,0;10,0;;;;25,0;;;;21,0;;6,0;;12,0;;;34,0;;;;;;4,0;;;4,0;12,0;59,0;7,0;30,0;2,0;7,0;8,0;9,0;2,0;;;;;;13,0;1,0;2,0;1,0;2,0;;;;18,0;2,0;;15,0;;;4,0;67,0;;11,0;3,0;20,0;2,0;;11,0;;;1,0;2,0;;;;13,0;;;5,0;;3,0;18,0;;6,0;;2,0;30,0;6,0;;;11,0;3,0;1,0;;3,0;17,0;;;;4,0;36,0;13,0;;2,0;;;8,0;13,0;;8,0;;;;;;;;15,0;5,0;;;;5,0;7,0;;9,0;1,0;2,0;10,0;4,0;16,0;;15,0;11,0;;9,0;;;6,0;2,0;16,0;14,0;2,0;121,0;2,0;;2,0;;;9,0;25,0;4,0;;;;;1,0;9,0;13,0;1,0;30,0;;4,0;1,0;;;1,0;;4,0;;;;;;;3,0;;;2,0;9,0;2,0;7,0;9,0;;1,0;;1,0;19,0;1,0;;30,0;40,0;1,0;;;2,0;;2,0;4,0;1,0;;;;14,0;;;;1,0;;;3,0;6,0;1,0;1,0;;6,0;19,0;4,0;;;7,0;13,0;3,0;1,0;;;1,0;2,0;2,0;;2,0;;7,0;;2,0;;;;;;32,0;1,0;1,0;4,0;5,0;;;;9,0;;10,0;11,0;;1,0;;13,0;5,0;4,0;4,0;1,0;;;;5,0;4,0;1,0;1,0;5,0;;;2,0;;;;15,0;3,0;1,0;2,0;19,0;2,0;12,0;4,0;;2,0;;2,0;;;;;;10,0;4,0;;;;;;;3,0;;;;;4,0;;1,0;1,0;;;2,0;;1,0;;7,0;2,0;2,0;2,0;;5,0;;2,0;;;;;2,0;1,0;1,0;5,0;;2,0;1,0;;;4,0;;2,0;10,0;;;;;;;10,0;;1,0;8,0;;2,0;;;;;4,0;;1,0;;8,0;1,0;;;;;2,0;;;1,0;;1,0;1,0;9,0;2,0;1,0;7,0;;;;;;1,0;4,0;;;;2,0;1,0;4,0;;;;1,0;;;;;;;;;;;;;;;3,0;;18,0;;;;2,0;26,0;;;;;;3,0;;;;13,0;;;2,0;;;1,0;;;;;;;4,0;;10,0;;;;;;1,0;;;;;;1,0;;;1,0;;3,0;6,0;;;8,0;;;;24,0;;2,0;2,0;2,0;;;;;;;2,0;5,0;;;;;1,0;;3,0;;;;;;3,0;;1,0;;;;;1,0;;;;;;2,0;;;;;;7,0;;;;1,0;;;;13,0;2,0;;1,0;;;;;;;;6,0;1,0;;;;3,0;7,0;;;;1,0;;;;;;;;;;1,0;1,0;2,0;;2,0;;;;;;6,0;;;;;;;;;;;1,0;;;;6,0;;;7,0;;;;;;2,0;;1,0;;;;;;1,0;;1,0;;;;;2,0;;;;;4,0;;;;;;;;;;1,0;;;;;;;;;;;9,0;;;2,0;2,0;;;3,0;;;2,0;2,0;;;2,0;;34,0;;4,0;;;;;;3,0;1,0;1,0;;;;2,0;2,0;;;14,0;;;;;1,0;;;;1,0;;;4,0;;;6,0;;;;;;1,0;;;1,0;;15,0;;;;3,0;;;10,0;;;1,0;2,0;1,0;10,0;;;;;;;;3,0;8,0;;5,0;;;;2,0;7,0;;3,0;;;;;7,0;;;3,0;;;;;;;;;;;;8,0;;;;;;;;;1,0;;1,0;1,0;;;;;1,0;4,0;;;;;;;;;;;;;;;;;2,0;;;5,0;;;1,0;;;;;;;;;;1,0;;;;;;;2,0;;;;;;;;;;;;;;;1,0;;;;;;;;;6,0;;;;;;;;;;;;;;;;;;;;2,0;;;;;;;;;1,0;;1,0;;;;;;;;;;;;;;;;;;;6,0;;;;;3,0;;;;;;;3,0;1,0;;;2,0;;;;3,0;;2,0;;;;;;;4,0;;;;;;;;;;;;;;;1,0;;;;;;;;;;;;;;;1,0;;;;;;;;;
pitch;;;;3,0;2,0;5,0;33,0;5,0;;2,0;;;5,0;28,0;;;8,0;;;2,0;;4,0;1,0;;7,0;2,0;;22,0;6,0;;4,0;;15,0;77,0;1,0;12,0;18,0;11,0;;;52,0;31,0;;;1,0;3,0;;15,0;3,0;;1,0;;;;;10,0;1,0;;5,0;;;3,0;5,0;;37,0;;33,0;;;;4,0;38,0;;1,0;;6,0;;6,0;;;30,0;2,0;1,0;8,0;6,0;;;2,0;4,0;2,0;7,0;;1,0;;;;110,0;13,0;16,0;3,0;26,0;8,0;;;2,0;;;1,0;;;;3,0;;;;3,0;6,0;12,0;;26,0;1,0;;1,0;10,0;;;15,0;;;1,0;5,0;;;4,0;;;;7,0;;;;13,0;1,0;;1,0;1,0;9,0;18,0;5,0;6,0;;;10,0;;;;3,0;;;;;10,0;;;;;;;;1,0;2,0;;;102,0;;;;3,0;;;;1,0;;;;;2,0;1,0;1,0;;;;;;;;2,0;;;;;;1,0;;3,0;;2,0;;;9,0;;24,0;56,0;;;4,0;3,0;1,0;;;2,0;;;3,0;1,0;;28,0;;;;1,0;;11,0;;;;;;;;;1,0;4,0;8,0;;1,0;;;6,0;;;;;;1,0;;30,0;6,0;;;;;2,0;47,0;;;;;;;;;;;;;8,0;115,0;4,0;6,0;;1,0;29,0;;;;1,0;;;;;;;;1,0;;5,0;;;1,0;;;;;5,0;2,0;;6,0;9,0;9,0;;;;;;;;;;1,0;3,0;8,0;;;;;;;;;;;;;;;;;;;3,0;36,0;6,0;;4,0;;1,0;4,0;;3,0;;;;;;;;;;;;2,0;12,0;;;;;2,0;3,0;;;;10,0;;26,0;;;;;;14,0;4,0;;;3,0;7,0;4,0;10,0;2,0;;3,0;1,0;;;1,0;4,0;5,0;2,0;10,0;2,0;;;;6,0;1,0;6,0;;;21,0;;;;;;;13,0;;;;;;;;;;1,0;1,0;3,0;7,0;132,0;4,0;;7,0;1,0;3,0;4,0;;;;;1,0;;1,0;8,0;8,0;1,0;;;;;;;;;2,0;;1,0;5,0;;7,0;6,0;2,0;;;;2,0;;;;;;5,0;;;;;1,0;;;;;;;;;;36,0;;;2,0;6,0;;;;;;;;1,0;1,0;;;;;;3,0;4,0;2,0;;;;;;;;3,0;;;;;;;1,0;;;;;;;;3,0;;;;3,0;;;;;3,0;;3,0;;;;;;;;;;;13,0;2,0;;;;;;;;;;4,0;1,0;;;2,0;;;;;;;1,0;1,0;;2,0;;;;;;;;3,0;;;;;;;;;;;;;;;;;;1,0;;;;1,0;;;1,0;;;;;;;;2,0;1,0;;;;;;1,0;;;;;;;;1,0;;;;;;4,0;;;;4,0;;;;;;;;;;;2,0;;;;;;;;;;;;;;;;;;9,0;;;;;2,0;5,0;;;;;;;;;;4,0;;;;;;;18,0;;1,0;;;;;;1,0;;;;;;;;;;;;;;;;6,0;;;;;4,0;4,0;;;9,0;;;;;;13,0;2,0;;;1,0;;;;;10,0;;2,0;;;;;;;16,0;;;;;;;;;;;;;;;;;;;;2,0;;;;;;;;;;;;;9,0;;;;;;;5,0;;;;1,0;;;;;;;1,0;;;;;;8,0;;;1,0;;;;;;;;;5,0;;;;2,0;;;2,0;;;;;;;3,0;3,0;;;;;;;;;;;;2,0;9,0;;;;;;;6,0;;;;;;;;;;;;;;;;5,0;;;;;;;5,0;;;;;;;;;;;;;;;;;;;;;;;;;;;;;;;;;;;;;;;;10,0;;;;;;;;;;1,0;;;;;;1,0;;;;;1,0;;89,0;;;;3,0;;;;;;;;;;;;;;;;;;;;;;;;;;;;2,0;;;;;;2,0;;;;;;;3,0;;;2,0;;;;;;;;;
planar;;;;7,0;;23,0;51,0;18,0;;;;;2,0;55,0;;;14,0;1,0;;;;;14,0;;7,0;;;11,0;5,0;;27,0;2,0;2,0;;5,0;20,0;19,0;6,0;10,0;2,0;21,0;20,0;5,0;4,0;8,0;32,0;4,0;74,0;;;;1,0;29,0;15,0;15,0;1,0;26,0;;;6,0;10,0;;12,0;;104,0;2,0;63,0;1,0;8,0;;4,0;93,0;27,0;4,0;;;10,0;;;;50,0;;;25,0;37,0;;;35,0;;;3,0;3,0;6,0;;4,0;;8,0;36,0;50,0;23,0;56,0;5,0;1,0;;3,0;6,0;;1,0;;;;15,0;48,0;1,0;;;;17,0;5,0;35,0;;;2,0;;;;44,0;;;2,0;8,0;;;9,0;1,0;;38,0;39,0;;;;9,0;;;27,0;;9,0;17,0;;18,0;;2,0;13,0;7,0;;4,0;;;;1,0;26,0;6,0;;;;;11,0;7,0;;1,0;19,0;;2,0;17,0;;20,0;9,0;2,0;;;;;1,0;54,0;;1,0;10,0;1,0;39,0;3,0;;;9,0;4,0;5,0;1,0;21,0;4,0;10,0;;;8,0;;;1,0;2,0;46,0;;6,0;17,0;1,0;1,0;1,0;2,0;;14,0;8,0;22,0;;1,0;45,0;4,0;1,0;4,0;15,0;;106,0;;;;4,0;2,0;7,0;;9,0;;1,0;;;6,0;;10,0;;;;6,0;8,0;16,0;50,0;;;2,0;;27,0;64,0;1,0;30,0;461,0;14,0;;;;;;23,0;;;1,0;;19,0;;;2,0;5,0;;;1,0;19,0;3,0;4,0;12,0;;16,0;53,0;;;2,0;9,0;4,0;5,0;45,0;7,0;;24,0;3,0;26,0;8,0;;;;;10,0;1,0;;;2,0;;2,0;;61,0;;;1,0;;1,0;;12,0;;10,0;7,0;;13,0;25,0;;32,0;1,0;;;;8,0;;2,0;;6,0;2,0;6,0;;;;;1,0;2,0;1,0;;2,0;2,0;3,0;12,0;;;;2,0;;;1,0;;1,0;18,0;23,0;1,0;;;;;;1,0;;;;;;;5,0;17,0;;;;;1,0;;;3,0;;;;2,0;;;;;;3,0;;;43,0;2,0;;12,0;;;;;1,0;1,0;1,0;10,0;;4,0;1,0;;;;;;;16,0;3,0;;;;;;;;;23,0;;1,0;;;;;;;;;;;;;;;1,0;;;;10,0;;8,0;;;;;2,0;;;3,0;18,0;1,0;;19,0;;;6,0;1,0;;;;;;;1,0;2,0;7,0;1,0;4,0;;2,0;;;12,0;2,0;;1,0;;2,0;1,0;7,0;;10,0;;;6,0;13,0;;4,0;2,0;;1,0;;1,0;;3,0;;1,0;;;;;3,0;;;;;;;;3,0;1,0;4,0;4,0;4,0;;2,0;;;;;1,0;;1,0;;;;3,0;;;;;7,0;;1,0;;12,0;;;;;;;;2,0;;1,0;;;;;2,0;;;;6,0;2,0;;;4,0;;;;;1,0;;1,0;9,0;5,0;;;3,0;;;;1,0;6,0;;5,0;;;1,0;;;;;;;;;;4,0;;;;;18,0;;;;1,0;;1,0;;;;;;;;;;7,0;;;1,0;;;;;;;;;;;;;;;;37,0;;3,0;;;1,0;12,0;;;1,0;;1,0;;;;;4,0;;2,0;;;;;;1,0;;1,0;3,0;;;1,0;;9,0;;;;2,0;;;;9,0;17,0;;8,0;;;;;;8,0;;;;;1,0;;1,0;15,0;2,0;3,0;;;2,0;;;;;2,0;1,0;4,0;2,0;;;2,0;9,0;;1,0;2,0;;5,0;;;;;16,0;;3,0;5,0;;;;;;;;;24,0;;4,0;1,0;;;;4,0;;1,0;;2,0;;8,0;;;;1,0;1,0;1,0;2,0;13,0;1,0;1,0;;;;7,0;;;7,0;;;;;;;;;;;;;1,0;;;1,0;;;;30,0;;;1,0;;;;;1,0;;;;4,0;;;;;;17,0;;1,0;;1,0;;47,0;;;;;;;;8,0;;;;1,0;;;;;1,0;;2,0;;;;7,0;2,0;;;2,0;;;;;;;;;;;;;;;;;;;;;13,0;;;;;;;;;9,0;;;;;;1,0;;;;;;;1,0;;1,0;;;2,0;24,0;;;;;;;3,0;;;;;;;;;;2,0;;;;;7,0;;2,0;;;;1,0;;;;6,0;;;;;;4,0;;;;;;;;;;3,0;;;1,0;;;;;;;;;;;3,0;;;;;;;2,0;;;;;;4,0;;;;;;;2,0;;;;;;3,0;;;;6,0;93,0;;;;5,0;;;4,0;;1,0;;;;;;;;;;;;;
plural;;;;1,0;;15,0;11,0;;;;;;1,0;10,0;;;24,0;2,0;;8,0;;;18,0;;2,0;4,0;;;;2,0;15,0;2,0;2,0;3,0;;6,0;16,0;;3,0;;15,0;12,0;;12,0;2,0;4,0;;29,0;;1,0;;;;;1,0;;2,0;;;9,0;;;7,0;;142,0;;39,0;;;;;3,0;16,0;;;;2,0;;2,0;29,0;24,0;;5,0;;8,0;;;3,0;;;23,0;;1,0;;;;30,0;;8,0;2,0;15,0;3,0;;;15,0;12,0;;;;;;10,0;5,0;;;;1,0;9,0;;10,0;;;37,0;2,0;;26,0;22,0;;;;16,0;3,0;;28,0;;;2,0;;;;;2,0;1,0;;1,0;1,0;;18,0;1,0;;;1,0;3,0;;;;;3,0;;;;11,0;;;6,0;;;3,0;;;7,0;;;2,0;;1,0;;11,0;8,0;3,0;;;3,0;;;;8,0;1,0;99,0;;;;;;;;;;2,0;;;7,0;;;;;9,0;3,0;;7,0;;;;;1,0;1,0;14,0;5,0;;1,0;2,0;5,0;;4,0;1,0;;25,0;1,0;;;5,0;4,0;;;;;;1,0;;3,0;;4,0;;;;;;18,0;1,0;;;;;2,0;1,0;;2,0;20,0;;;;;4,0;16,0;;;;2,0;1,0;;;3,0;1,0;;;;;;;18,0;;;2,0;;;;;3,0;2,0;5,0;;;;;;;5,0;;3,0;;;;2,0;;;;7,0;2,0;1,0;21,0;1,0;;;14,0;;;;5,0;;;;11,0;;;;;;;1,0;1,0;;;;;2,0;;;;;;1,0;;2,0;3,0;1,0;;;1,0;;;;;;;6,0;;;;15,0;;;;;17,0;;;;3,0;;;;;;;2,0;;;;;;8,0;;;;;6,0;1,0;;4,0;;;2,0;;;;3,0;;11,0;;;;7,0;1,0;;;2,0;9,0;1,0;;;;1,0;;;2,0;;;;;;;;;4,0;;6,0;1,0;4,0;;;2,0;;;;;;;3,0;6,0;;;4,0;;;;;;2,0;3,0;;;3,0;;;2,0;2,0;;11,0;;8,0;;1,0;9,0;;;;;1,0;;;;;;1,0;;;;1,0;1,0;1,0;;;;;;;17,0;;;;;;;;;;;;;;;5,0;;;;7,0;;;2,0;1,0;;4,0;;;;;;;2,0;;5,0;1,0;;;;;;;;;;;1,0;2,0;4,0;;4,0;;;2,0;;;1,0;7,0;;;;;;;;;;;;;;;;;;;;;;;2,0;;;;;;;1,0;;;;;;3,0;;;;;;11,0;;5,0;;14,0;;;;;;1,0;;;;3,0;;;;12,0;;;;2,0;;;1,0;;;;;;;;;1,0;;;;;;;;;;;;;;;;;;;;;;;1,0;;;;;;;;;;;;;;;;;;;1,0;;;;;;;;;4,0;;;;;2,0;;;;;;;;;;;;;;16,0;;1,0;;;;;3,0;;;;6,0;;2,0;3,0;1,0;;6,0;;;;;;;;;;;;;;;;;;;2,0;;;;;;;;;1,0;;;;;;1,0;;;;;;;;;;4,0;1,0;;;;;;;;;;;;;;;1,0;;;;3,0;;;;;;3,0;1,0;1,0;;;;;;;1,0;;1,0;;;;;3,0;3,0;20,0;;;;;2,0;;;;9,0;;;;;3,0;1,0;;;;;;;;;;;;;1,0;;17,0;6,0;;;;;;;;;;;;;;;;;;;;;;;;;;;;;;1,0;;1,0;;;;;;;;;;;;;;;1,0;3,0;3,0;1,0;;;;;;;;;;;;;;;;;;;;;;;;;;;1,0;;;;;;6,0;;;;;;;;;;;;;;;;;;3,0;;;;;;;;;;;;;;1,0;1,0;;;;;;;;1,0;;;;;;;;;;;;;;;;1,0;;;;3,0;;;;;;;;;;;;;;;;;;;;;;;;;;;;;;
polarization;;;;8,0;;8,0;3,0;;;;;;;10,0;;;13,0;;;12,0;;;5,0;;;;;10,0;;1,0;9,0;14,0;;;2,0;;5,0;5,0;;2,0;1,0;18,0;;;6,0;3,0;;;;;;;;;;;4,0;;2,0;1,0;;;;;80,0;;20,0;2,0;;;;10,0;21,0;1,0;;;;1,0;;3,0;8,0;;;;;4,0;;7,0;1,0;1,0;;;6,0;;;;7,0;;10,0;;26,0;;;;14,0;;;;;4,0;;2,0;14,0;1,0;;;;;;5,0;;;3,0;;;;27,0;;;;;;;;;;;;;;;;;3,0;2,0;;;;5,0;;;2,0;;;;;;1,0;;;;2,0;;;;;;16,0;;;2,0;;;9,0;;;;;;;;;;3,0;;7,0;154,0;;9,0;2,0;;;;1,0;;1,0;;11,0;;10,0;;;;;;;;;;;6,0;;;;;2,0;2,0;;;;;;;;5,0;;3,0;;;10,0;;15,0;;;1,0;;10,0;2,0;;5,0;;2,0;2,0;;;5,0;2,0;;7,0;;;;;2,0;6,0;;2,0;1,0;;;;11,0;;;;;2,0;4,0;;1,0;;;;6,0;;;1,0;27,0;;;;;4,0;;;;;;;;;;;;;;3,0;;;;;;;;;;;;;19,0;;2,0;;;;;1,0;;;;;4,0;;;;2,0;;;7,0;;;;;;1,0;;;;;;20,0;;;;;;;;;;;;;;;;;;1,0;;;;;;;;1,0;2,0;;;;;;2,0;8,0;;;;;;11,0;;;1,0;2,0;6,0;;5,0;;;;;;2,0;;3,0;;;1,0;;;4,0;;;1,0;;;1,0;;15,0;;;1,0;;;1,0;2,0;;1,0;;;;;;;6,0;;;1,0;;3,0;;;;;;;;5,0;;;;;;;;;;;;;;;;;;;;;;;;;;;;;;;;;;;2,0;;;;;;;1,0;7,0;;;;;2,0;;;;;;;4,0;;;;;;;;;;;;;;;;4,0;;;;;2,0;;;;;;;;;;;;;;;;11,0;;;;;;;7,0;1,0;;;;;;;;;;;;;;;;;1,0;;;;;;;;;;;;;;;;;;;;;;;;;;;19,0;;;;;;2,0;;;;;;;;;4,0;;;;;;;;;;;;;;;;;;;;;;;;;1,0;;;;;;;;;;;;;;;;;6,0;;;;;;;;;;;;;;;;;;;;;;;;;;;1,0;;;;1,0;;;;;;;;2,0;;;;;;;;;;;;;;;;;8,0;;;;;;;;;;;;;;;4,0;;;;1,0;;;;;;;;;;;2,0;;;;;;;6,0;;1,0;;;;1,0;;;;;;;;;;;;;;;;;;;;;;;;;;;;;;;;10,0;;;;;;;;;;;;;;8,0;;;;;;;;;;;;;;;;;;;2,0;;;;;;;;;;;;;;;;;;;;;;2,0;;;;;;;;;;;;;;;;;;;;;;;;;;;;;;;;;;;;;;;;;;;;1,0;;;;;1,0;;;;;;;;;;;;;;;;;;;;;;1,0;;;;;;;;;;;;1,0;;;;;;;;;;;;;;;;;;;;;;;;;;5,0;;;;;;;;;;;;;2,0;;;;;;;;;;;;;;;;;;;;;;;;;;;;;;;5,0;;;;;;;;14,0;;;;;;;;;;;;;
polarize;;;;5,0;;3,0;5,0;;;;;2,0;1,0;1,0;;;1,0;;;;;;;;;;;;;;14,0;;;1,0;9,0;;;7,0;;2,0;;21,0;;3,0;6,0;3,0;;12,0;;;;4,0;;;2,0;3,0;6,0;;;;1,0;;;;17,0;;4,0;;;;;15,0;68,0;5,0;;;2,0;;;;2,0;;;;2,0;;;7,0;;;;;6,0;;;;2,0;3,0;1,0;1,0;6,0;;;2,0;1,0;1,0;;;2,0;;;;3,0;;;;;;;3,0;;2,0;13,0;;1,0;;2,0;;;;;;;2,0;1,0;;;;;;;1,0;;;;;9,0;2,0;;7,0;;1,0;1,0;1,0;;;;1,0;;;;;;5,0;;;;;;2,0;;;3,0;7,0;;3,0;3,0;8,0;;;;;;3,0;;2,0;88,0;;;15,0;;;;;;;;4,0;1,0;;;;;;;;;;2,0;;;;;;;;;;;;;;;;9,0;;1,0;;1,0;1,0;;4,0;;;;;6,0;1,0;;;;;;;;;;;2,0;;;;;;3,0;;;6,0;;;;2,0;;;;;8,0;1,0;;4,0;;;;;;;6,0;13,0;;;;1,0;;;;;;;;;1,0;;;;;;;;;;;;;;;;;;;4,0;;;;;;;1,0;;2,0;;2,0;;2,0;1,0;6,0;;;;1,0;;;;;;2,0;;;;;;;;;;;;;;;;;;;;;;;4,0;;;;;;;;;;;;;;;;;1,0;;;;;;;;;;;;;;;;;;1,0;;;;;;;;;;;;;2,0;;;;;;;;;;;;;;;;;1,0;;;9,0;2,0;;;;;;;;;;;2,0;;;1,0;;;;;;;;;;;;;;;;;;;1,0;;4,0;;;;;;;;;;;;;;;1,0;;;;1,0;;;1,0;;;;;1,0;;;;;4,0;;;2,0;;;;;;;;;;;;;;1,0;;;;9,0;;;;;;;;;;;;;;;;;;;;;;;;;;;;;;;;;;;;;;;;;;;;;;;;;;;;;;;;;;;;;;;;;;;;5,0;;;;;;;;;;;;;;;2,0;2,0;;;;;;;;;;;;;3,0;;;;;;;;;;;;;;;;;;;;;;1,0;2,0;;;;3,0;;;;;;;11,0;;2,0;;;;;;;;1,0;;;2,0;;;;;;;;;;;;7,0;;;;;;;;1,0;;;;;1,0;;;;;;;;;;;;;;;;;;;4,0;;;;;;;;7,0;;;;;;;4,0;;;;;;;;;;;;;;;;;;;;;;;;;;;;;;;1,0;;;;;;1,0;;;;;;;;;;;;;;;;1,0;;;;;;;;;;;;;;4,0;;;;;;;;;;;;;;;;;;;;;;;;;;;;;;;;;;;;;;;;;1,0;;;;;;;;;;;;;;;;;;;;;;;;;;;;;;;;;;;;3,0;;3,0;;;;;2,0;;;;;;;;;;;;;;;;;;;;;;;;1,0;;;;;;;;;;;;;;;;;;;;;;;;;;;;;;;;;;;;;;;;;;;;;;;;;;;;;;;;;;;;;;;;;;;;;;;;5,0;;;;;;;;;;;;;;;;;;;;;;4,0;;;;;;;;;;;;;
post;;;;1,0;;4,0;;22,0;;;8,0;;3,0;9,0;;;1,0;;2,0;;;;;4,0;5,0;;;3,0;1,0;;8,0;;4,0;;;1,0;;;;2,0;3,0;3,0;;2,0;;3,0;;1,0;;;;;17,0;;2,0;;1,0;;;2,0;;;;;6,0;;14,0;;2,0;;4,0;16,0;;;;;;3,0;1,0;;12,0;;2,0;;11,0;4,0;;3,0;;;;;1,0;;;;6,0;1,0;23,0;;7,0;2,0;;2,0;15,0;23,0;;1,0;;;;;6,0;;1,0;;;;;3,0;;;;3,0;1,0;;23,0;;;;3,0;;1,0;;;;;;;;;1,0;;;6,0;;1,0;2,0;1,0;23,0;;;2,0;1,0;;;;;;;;11,0;1,0;;;;21,0;2,0;;;1,0;;;3,0;1,0;;1,0;;;;;;;;2,0;;;;9,0;;;;;1,0;8,0;22,0;4,0;;3,0;8,0;;;3,0;;;;6,0;2,0;;83,0;6,0;1,0;;;;4,0;1,0;1,0;;5,0;1,0;;;;7,0;;5,0;;;;2,0;;;;;;;;2,0;1,0;;4,0;;1,0;;1,0;2,0;1,0;16,0;2,0;10,0;2,0;;7,0;4,0;;14,0;16,0;;;;;;3,0;;;;;3,0;;;;2,0;;;;;;8,0;;1,0;;4,0;3,0;;;1,0;;2,0;4,0;;;;;;2,0;;;;13,0;2,0;;7,0;;3,0;5,0;2,0;6,0;;;;;;;;3,0;2,0;16,0;;1,0;2,0;2,0;2,0;;;;;;;;2,0;;;;;;2,0;;;;;1,0;2,0;;1,0;5,0;;16,0;2,0;;;1,0;;;1,0;;;22,0;;;;;;;;1,0;;;;;;2,0;;9,0;;;;;;;;;;2,0;;;;;;8,0;;;;;;;;;;;;;;;;;;4,0;;;;;;;;;;;;;;;;;;20,0;;1,0;;;;;;;3,0;1,0;;;;;;;;6,0;;1,0;;;;;;;;;;;;;;;;;;;;;;;;;;;;;1,0;;;2,0;;1,0;;;;4,0;;;5,0;;;;;;;2,0;;;;;;;;;1,0;;;4,0;3,0;;;;1,0;;;;;;;;;;1,0;2,0;;2,0;;;1,0;;;;;;1,0;14,0;;;;;;;;;;;;1,0;;;;1,0;;;;;;;;;;;1,0;;1,0;;;;;;;;;;;1,0;1,0;2,0;;;;4,0;;;;;;;2,0;;;;;;;;;3,0;;;;;;;;;;;;1,0;;;;;;;;;;;2,0;;;;;;;;;;;;;;;;;;;;1,0;;;;3,0;3,0;;;;;;;;;2,0;;;2,0;;;;3,0;;;;;1,0;;1,0;;;;;;;;;;;;;;;;;;;;;;1,0;;;1,0;;;;2,0;;;;;;;;1,0;;2,0;32,0;;;4,0;;;;;;;;;;;;;;;;;;;;;;;;;5,0;;;;;;;2,0;2,0;3,0;1,0;;;;2,0;;;;;;;;;;;;;;;2,0;;;;;;;;;2,0;1,0;;;;2,0;;5,0;;;;;;;;;;;;;;;;;;1,0;;;;;;;;;;;;;;;1,0;;;;;;;;;;;;;;;;;;;;;;;;;;;;;1,0;;;;;;;1,0;;;;;;;;;;;;;;;;;;;;;;;7,0;;;;;;;;;;;;;;;;;;;;;;;;;;;;;;;;;;;;;4,0;;;;;;;;;;;1,0;;1,0;2,0;;;;;;;;;;;;;4,0;;;;;;;;1,0;;;;;;;;;;;;;;;;;46,0;;;;;;;;1,0;;;;;;;;;;;;;;;2,0;;;;;;;;;;;;;;;;
posture;;;;7,0;;5,0;;;;;;;1,0;31,0;;;11,0;;;;;;;;;;;23,0;3,0;1,0;16,0;22,0;2,0;;;8,0;4,0;;;;69,0;47,0;;;7,0;2,0;;;;;9,0;;2,0;;1,0;3,0;5,0;;;2,0;1,0;;;;26,0;;26,0;;1,0;1,0;3,0;29,0;;;;;;;;15,0;20,0;;7,0;4,0;19,0;;6,0;3,0;;;;;;;;1,0;;6,0;10,0;1,0;98,0;5,0;;3,0;5,0;2,0;;2,0;;;;8,0;;1,0;;;;;;39,0;;2,0;9,0;1,0;;17,0;5,0;6,0;1,0;;8,0;;;40,0;2,0;;1,0;3,0;5,0;;;;;3,0;;4,0;8,0;;2,0;1,0;;;2,0;;;;;;;;;3,0;;;;;;1,0;;33,0;3,0;;;15,0;;;;;;;;;;1,0;;;5,0;;;;;3,0;;;;1,0;12,0;;;;;;;;14,0;;7,0;;;6,0;;;18,0;;;;14,0;1,0;;;;;;2,0;6,0;;2,0;;;;1,0;;;;;3,0;;;;;;;2,0;;;28,0;;;15,0;;;;;;;1,0;;;;;;;;2,0;;;;;;1,0;1,0;;4,0;;;;;9,0;;;;;3,0;;;;;;;;1,0;;;;;;2,0;;;;;;;;2,0;;;13,0;;3,0;;;;;;;;;;;;19,0;2,0;;;;;;;;1,0;;;4,0;;;;;;;1,0;;2,0;;;;;;;;;;;;;;;;;;;2,0;;;;;;;;;;;1,0;;37,0;1,0;;1,0;;5,0;11,0;;;;;60,0;;12,0;;;;2,0;;4,0;;;;1,0;1,0;;;1,0;;;;;2,0;1,0;2,0;;;8,0;;;32,0;3,0;;;;;;6,0;;1,0;;4,0;;8,0;;;4,0;;7,0;;;;1,0;;;;7,0;;4,0;1,0;;4,0;;1,0;20,0;;;;5,0;;;;;1,0;1,0;;;;;;;;2,0;;;;;;;;;;1,0;;2,0;2,0;;;;;;;3,0;1,0;;;4,0;;;;;;;;;;;;;;2,0;;;;;;;;;;;;;;;;;;;;;;;;;;;2,0;;;4,0;;;2,0;4,0;1,0;;;;;;;;;;;;;;;;;;;;;;;2,0;;;;;;;;;;;;;;;;;;;;;;;;;;;;;;;;;;;;;;1,0;1,0;;;;;;;;;;;;9,0;;;;;;;;;;;;;;;;;;;;1,0;;;;;;;;5,0;;;;;;;;;;;;;2,0;;;;;;;;;;;;;;;;;;;;;;;1,0;;1,0;;;;;;;;;;;8,0;;;;;;;;;;;;;1,0;6,0;;;;;;;2,0;;;;;;;;;;;;;;;;;;;;;;;6,0;;;;2,0;;;;;;;;;;;4,0;;;;;;;;;;;;;;;;;;;;;24,0;;;;;;;;;;;;;;;;;3,0;;;;;1,0;;;;1,0;;;;;;;;;;;;;1,0;;;;;;;;;;;;;;;;1,0;;;;;;;3,0;;;;;;;;;;;;;;;;;;;1,0;;;;;;;;;;;;;;;;;;;;;;;1,0;;;;;;;;;;;;;;;;;;;18,0;;;;;;;;;;;;;;;;;;;;;;;;;;;;;;;;;;;;;;;;;;;;;;;;;;;;;;;;;;;;;;;;;1,0;;;;;;1,0;;;;;;;;;;;;;;;;;;;;;;;;;;;;;;;;;;;
predict;;;;11,0;7,0;1,0;;;3,0;;;;;66,0;;2,0;37,0;;;4,0;;;3,0;;;;;;5,0;5,0;7,0;1,0;4,0;;;21,0;;;24,0;;34,0;17,0;;;2,0;;2,0;5,0;3,0;3,0;13,0;;;;6,0;;;;;6,0;;;4,0;;86,0;;18,0;;;;;1,0;9,0;;;;;10,0;2,0;3,0;46,0;;;86,0;7,0;;;13,0;;;6,0;;2,0;;;2,0;1,0;1,0;12,0;81,0;40,0;9,0;;1,0;;5,0;;2,0;1,0;;;2,0;17,0;;;;;2,0;9,0;24,0;4,0;;2,0;;;10,0;15,0;;;;51,0;;;5,0;;;12,0;;;;;2,0;;;;3,0;5,0;;16,0;;;;;;;;;;;;;;;;;;;;;1,0;;;;5,0;;;;;;;;;;4,0;;;1,0;;17,0;;;;;;;;;;;;;;;;;1,0;;;;;;19,0;;;;;;;;28,0;;;;;;;;;;2,0;;;3,0;;;1,0;1,0;;;3,0;;;;;;5,0;5,0;1,0;;;;;;;;;;2,0;2,0;;;;1,0;18,0;;;;;;2,0;;;4,0;;;;;1,0;;;;;;;;;;;1,0;;;21,0;;;;;11,0;;;;;;;11,0;;;;;;12,0;;;;;;;;;;;2,0;182,0;;;;;;;;;;;;;;;;;;;;1,0;;;;;20,0;6,0;15,0;;;;7,0;;10,0;;1,0;;3,0;;;2,0;;2,0;;5,0;1,0;10,0;;;;;2,0;;3,0;;;;2,0;;4,0;6,0;;;;13,0;2,0;5,0;;8,0;;;1,0;;3,0;4,0;;20,0;;;1,0;;;1,0;;64,0;;1,0;32,0;;;28,0;3,0;;;;;;;;;18,0;;8,0;;8,0;;10,0;;;;;1,0;2,0;5,0;;2,0;5,0;;;;;1,0;1,0;2,0;2,0;2,0;1,0;5,0;4,0;;;3,0;;;;2,0;;;;4,0;;1,0;1,0;;;;;;;;;1,0;2,0;;;;;;;;;;;;;;;;12,0;;1,0;;3,0;;;;;;;;;;;1,0;;3,0;;;;;;;;;;;3,0;;;;;;;;3,0;;;;;;;;;;;1,0;2,0;;69,0;;;;;;;;;;;;;1,0;15,0;;;;;;;;;;;;;6,0;;;;;;;;1,0;;;;;;;;4,0;;;;;;1,0;;;;;;;;;17,0;;;1,0;;1,0;4,0;;8,0;;4,0;;;;;;;;;7,0;;;;;;;4,0;;;;;;;;;;1,0;;3,0;;;;;;;;;4,0;;;;;;;;;;;;;;22,0;;;;1,0;;5,0;;;;;;;;4,0;;;;;;34,0;;;;;;;1,0;2,0;;;;;;;;;;;;;;;;;;19,0;;;;;;;;;;;1,0;;;;;;;;;;;;;;;;;;1,0;;;;;;;4,0;;;;;;;;;;;;;;;;;;;;;;;;;;;;;;;;;;;;;;;;3,0;;;;;;;;2,0;;;;;;;;;;;;;;;7,0;;;;;10,0;;;;;;3,0;5,0;;;;;;;6,0;;;;;;;;;;3,0;;;;;;;;;;1,0;1,0;;;;;;;;;1,0;;;1,0;;;3,0;;;;;;1,0;;;;;;;;2,0;87,0;;;;;1,0;;;;1,0;;;3,0;;;;;;;;2,0;;;;;1,0;;;2,0;;;;1,0;;;;;;4,0;;;;;;;4,0;;;;;;;6,0;;;19,0;;;;;;1,0;;;;;;;;;;;;;;;;;;;;4,0;;2,0;;;;;;;;;;;2,0;;;80,0;6,0;;;;;;3,0;;;;;;1,0;;;;;;;;;;;2,0;;;;;
preset;;;;48,0;3,0;40,0;2,0;4,0;1,0;;;12,0;1,0;41,0;;24,0;57,0;;9,0;;;;4,0;;;;;;3,0;47,0;35,0;9,0;2,0;3,0;;40,0;13,0;10,0;35,0;;76,0;35,0;;1,0;42,0;;;2,0;;;17,0;;;;2,0;14,0;2,0;;6,0;12,0;;;3,0;;132,0;;49,0;6,0;;8,0;78,0;15,0;10,0;;2,0;1,0;;2,0;2,0;14,0;116,0;;39,0;29,0;26,0;;;17,0;;11,0;30,0;;2,0;;10,0;;29,0;6,0;31,0;39,0;63,0;9,0;;5,0;11,0;44,0;;1,0;;;;2,0;36,0;4,0;;9,0;6,0;6,0;20,0;10,0;3,0;10,0;42,0;20,0;;98,0;25,0;;12,0;;105,0;2,0;;26,0;1,0;;154,0;;5,0;;;4,0;;;3,0;11,0;83,0;;15,0;;;11,0;6,0;;;;;;4,0;;;1,0;;2,0;;1,0;;6,0;3,0;3,0;;4,0;;31,0;;11,0;3,0;2,0;;;;;;7,0;;1,0;12,0;3,0;37,0;;5,0;;;;;;6,0;1,0;;;;;4,0;8,0;;1,0;1,0;;;5,0;18,0;16,0;;;;;13,0;;;3,0;16,0;33,0;;4,0;;;3,0;;;;;1,0;56,0;3,0;3,0;5,0;1,0;;;;;;6,0;;;72,0;;;2,0;;;;;11,0;;;3,0;2,0;;;;11,0;4,0;52,0;;;17,0;11,0;;1,0;;;;;;;2,0;62,0;;;;;5,0;;;;;14,0;;3,0;3,0;23,0;;;1,0;;72,0;4,0;;;;;;;;;;1,0;;22,0;;;23,0;;;;5,0;;1,0;2,0;21,0;36,0;4,0;;;;;;5,0;;;;;;5,0;;;;;;19,0;6,0;;;;;10,0;10,0;;;;;;;42,0;;7,0;1,0;61,0;;3,0;;;;1,0;8,0;1,0;1,0;;14,0;;;17,0;4,0;41,0;8,0;;24,0;23,0;2,0;119,0;;;;;79,0;1,0;33,0;27,0;9,0;9,0;3,0;;28,0;;13,0;4,0;4,0;12,0;4,0;;16,0;1,0;18,0;2,0;19,0;;4,0;19,0;2,0;;32,0;;8,0;35,0;;;;24,0;;;17,0;13,0;8,0;3,0;17,0;1,0;23,0;;;7,0;;80,0;25,0;93,0;4,0;65,0;18,0;53,0;;5,0;20,0;104,0;10,0;2,0;5,0;;;33,0;;;;6,0;5,0;20,0;;2,0;3,0;7,0;1,0;;;;;;;1,0;;1,0;;;9,0;6,0;7,0;;1,0;10,0;;;1,0;1,0;;;9,0;1,0;;44,0;;;;2,0;;3,0;;;;16,0;;;;2,0;;;9,0;7,0;;2,0;;;;2,0;5,0;;;2,0;;1,0;3,0;;;;;;;;1,0;;;;;;3,0;;5,0;7,0;;10,0;30,0;1,0;9,0;;3,0;4,0;2,0;;3,0;;3,0;;27,0;;;4,0;;24,0;14,0;;;;;1,0;12,0;14,0;;3,0;;;1,0;;2,0;;;;;;;18,0;1,0;;;;;;;;;;;;3,0;;;1,0;5,0;;;;2,0;5,0;;3,0;1,0;3,0;16,0;1,0;;;8,0;2,0;;;;;1,0;;;;3,0;;;;5,0;13,0;4,0;;;;11,0;3,0;;;;;;;;;;;;;6,0;8,0;2,0;;;;;;;1,0;;4,0;3,0;10,0;;1,0;1,0;4,0;;;8,0;;;;;;;;;;;4,0;1,0;;2,0;;;45,0;;3,0;;;1,0;;1,0;3,0;;1,0;;3,0;;;1,0;;;1,0;2,0;;;3,0;;4,0;5,0;14,0;;;;;3,0;;;;;;2,0;;;;11,0;;;;;3,0;;;;7,0;4,0;1,0;1,0;;4,0;9,0;4,0;;;;;6,0;4,0;;;;1,0;;;1,0;;2,0;;;;;;3,0;;;;;;;;;;;;;;;;1,0;;;;;;5,0;;8,0;;;;;;;5,0;;;;;;;;;8,0;3,0;;;;;;35,0;;;;;;;;20,0;;;;;;;;;;;;;;;;;8,0;;;;2,0;;4,0;2,0;7,0;;;;;;4,0;;;;7,0;1,0;;10,0;;;;2,0;;;1,0;;;;;4,0;;;;;;;;;;2,0;9,0;2,0;2,0;;;;4,0;11,0;;;;;;1,0;;;;2,0;;;;;;6,0;1,0;;3,0;2,0;;;;;;;;;;;;2,0;;7,0;;;;;;;;;;;;;;;20,0;;2,0;;;;;;;;;;;;;;;;;;;;;;;;3,0;;;;;16,0;;;;;10,0;;;2,0;;;;;;;;;8,0;2,0;1,0;;;;12,0;;;;;;;;2,0;;;3,0;;;;1,0;;
pressure;;;;4,0;5,0;2,0;1,0;20,0;;;;;;3,0;;;1,0;3,0;;;;;;3,0;;;;7,0;12,0;2,0;24,0;1,0;;;1,0;3,0;5,0;;1,0;1,0;10,0;13,0;;;;5,0;;58,0;;1,0;;1,0;1,0;4,0;;;6,0;;;17,0;1,0;;;;14,0;;4,0;4,0;4,0;2,0;;22,0;4,0;5,0;;4,0;1,0;4,0;;;11,0;;;;14,0;2,0;;3,0;1,0;1,0;2,0;4,0;;;;;;;;6,0;9,0;11,0;;;;1,0;;2,0;;;;2,0;;;;;;;;59,0;;;5,0;;;;15,0;;2,0;;1,0;;;15,0;2,0;;2,0;;;5,0;;;;;;61,0;4,0;3,0;;;2,0;;3,0;2,0;;;1,0;;;;6,0;6,0;;;;;2,0;7,0;1,0;1,0;;;1,0;26,0;9,0;1,0;6,0;1,0;7,0;;;;;6,0;;8,0;1,0;9,0;3,0;;;;10,0;1,0;3,0;13,0;11,0;1,0;2,0;1,0;;5,0;;;6,0;1,0;10,0;3,0;1,0;10,0;;6,0;;;;;;;;;2,0;3,0;;;13,0;;6,0;;4,0;;;;;;1,0;;;;;;;6,0;2,0;2,0;10,0;;;8,0;7,0;1,0;;;;3,0;2,0;;15,0;14,0;2,0;;3,0;2,0;;5,0;3,0;1,0;;;;1,0;;1,0;;3,0;;;1,0;;;;1,0;;3,0;6,0;;2,0;1,0;1,0;2,0;;;1,0;;2,0;;2,0;;;14,0;1,0;2,0;;1,0;1,0;;10,0;3,0;3,0;;;;2,0;2,0;;;;1,0;1,0;2,0;1,0;1,0;3,0;1,0;;1,0;;;2,0;1,0;2,0;;;2,0;4,0;;;2,0;;;;4,0;2,0;;1,0;4,0;6,0;4,0;1,0;1,0;14,0;;;;;;;;2,0;5,0;;;;1,0;;;2,0;;;;1,0;2,0;2,0;;;46,0;;;;3,0;;5,0;;;;;16,0;;3,0;;;6,0;;;;;1,0;;;;;;3,0;;1,0;;;;2,0;3,0;;;;;;3,0;1,0;;;;;;47,0;;;;5,0;;5,0;;;8,0;2,0;;1,0;;;;1,0;25,0;;15,0;1,0;15,0;;;1,0;;;13,0;;;;2,0;1,0;1,0;;;1,0;;;;1,0;;13,0;;;;;1,0;;;1,0;;5,0;2,0;2,0;;;;;;2,0;1,0;2,0;;;;;;;;;2,0;;;;2,0;;;1,0;;;;19,0;8,0;2,0;;;;;;;3,0;;2,0;;5,0;1,0;;2,0;;;;;;;;;6,0;;;;34,0;4,0;;;;;3,0;;3,0;;2,0;2,0;;;;1,0;3,0;;;;;;;;;;;;;3,0;;;;;;;2,0;;;;;33,0;3,0;1,0;;;;;;;;1,0;;8,0;4,0;;;;;;;;;;;2,0;;;;;11,0;;4,0;;;1,0;;;;5,0;;;;;15,0;;;;;;;;;;;;;;;1,0;;;;;;;;;;;;;;;;1,0;;;;;;;;4,0;;5,0;;1,0;;;;;;;;;1,0;;4,0;;;;;;;;6,0;;;;;;;;;11,0;1,0;;;1,0;;;2,0;19,0;;2,0;1,0;;;;2,0;1,0;5,0;;;;;;;;3,0;;;;;2,0;2,0;;;;1,0;;1,0;;2,0;;;;1,0;;;1,0;;;;;1,0;;;;;1,0;;;;;3,0;;;1,0;2,0;;;;3,0;;;;;;;;;;;;;;;8,0;1,0;;;;1,0;;;1,0;;;;;;;3,0;6,0;;;;;;;;;;;;;;;6,0;;;;;;;;;;;;2,0;;;;;;;;;;;;;;;;;;;;;;4,0;1,0;;;;1,0;;;;;;;;;;;;;;;;;;2,0;;;;;;;;;;;;;;;;;;;;;4,0;;;;;;;;;;;2,0;;;;;3,0;;;;;;;;;2,0;2,0;;;;;;;;;;6,0;;;2,0;;1,0;;;;;;;2,0;;;;;;;;;;;;;;;;;;3,0;;;;;;;;;;;;;;;;;;;1,0;;;;;;;;28,0;;;;;;;;;;;;;;;;;5,0;;;;;;;;;
primary;;;;7,0;3,0;3,0;18,0;5,0;;;;;;19,0;5,0;;54,0;;2,0;1,0;;;90,0;5,0;91,0;;;23,0;4,0;1,0;46,0;;;;;43,0;1,0;;22,0;;29,0;133,0;;50,0;84,0;1,0;1,0;24,0;;;23,0;;3,0;;59,0;;22,0;;;14,0;;4,0;;;282,0;1,0;46,0;;1,0;;4,0;24,0;147,0;3,0;;;1,0;;1,0;2,0;43,0;;66,0;1,0;8,0;9,0;;14,0;;4,0;;7,0;2,0;2,0;;;13,0;10,0;81,0;2,0;82,0;13,0;6,0;;5,0;31,0;1,0;3,0;6,0;;;6,0;42,0;6,0;;;1,0;25,0;27,0;56,0;2,0;;36,0;7,0;3,0;3,0;35,0;;;5,0;3,0;;;16,0;;;59,0;2,0;;;;6,0;1,0;;1,0;3,0;19,0;5,0;13,0;7,0;;11,0;6,0;;;3,0;;;;;;8,0;;3,0;;;56,0;;;;4,0;;25,0;9,0;;15,0;2,0;7,0;1,0;;1,0;;9,0;2,0;;;26,0;2,0;16,0;9,0;;;1,0;;;3,0;8,0;;;;;4,0;;;2,0;8,0;5,0;;9,0;30,0;3,0;1,0;;;;2,0;16,0;1,0;4,0;4,0;;;;;4,0;;21,0;;;3,0;2,0;;15,0;2,0;;2,0;20,0;;;6,0;;3,0;4,0;;;24,0;;6,0;5,0;1,0;5,0;;1,0;1,0;6,0;;5,0;113,0;;;1,0;4,0;;24,0;2,0;;;7,0;1,0;14,0;;;;;1,0;2,0;;8,0;;;6,0;15,0;20,0;1,0;;;;1,0;1,0;4,0;43,0;4,0;;;;;10,0;2,0;;2,0;;;;2,0;;;;;2,0;22,0;;;5,0;;11,0;;11,0;;5,0;2,0;10,0;28,0;1,0;;;;;;15,0;;;;;28,0;;;11,0;;2,0;1,0;1,0;2,0;;;;3,0;;18,0;;;;3,0;;;4,0;;;3,0;66,0;;;;;;;;;2,0;;;;;3,0;;4,0;1,0;;1,0;;;13,0;8,0;;;;30,0;1,0;;;;;;2,0;17,0;;;;5,0;;;;;20,0;;;16,0;;2,0;;;1,0;3,0;;9,0;1,0;8,0;2,0;;;;;;;;;63,0;1,0;6,0;;;1,0;;2,0;;1,0;;6,0;32,0;5,0;3,0;;;1,0;;;4,0;;;14,0;;;;5,0;;;1,0;;4,0;;2,0;4,0;3,0;24,0;;;;2,0;;;;5,0;;1,0;9,0;;;;6,0;;;;;;5,0;3,0;;8,0;5,0;4,0;;;2,0;;3,0;2,0;9,0;3,0;;;;;30,0;;;;;1,0;;;;8,0;2,0;4,0;;;28,0;4,0;1,0;;;51,0;;;;;;;;;;;;;;;;;;;;;;2,0;2,0;;12,0;;;58,0;1,0;;;;;;;;;;;;;4,0;;;;2,0;;4,0;16,0;;;;;;13,0;1,0;2,0;;;;;3,0;;;1,0;;;2,0;6,0;19,0;;;;;;;;9,0;;;;;;6,0;1,0;1,0;5,0;;;;2,0;;2,0;;;1,0;;3,0;5,0;;;3,0;;10,0;;;;;;;;;5,0;;2,0;;;;;;;;3,0;;;;;;;;;;;;;3,0;;1,0;;2,0;2,0;;;;;1,0;;;;19,0;;;;;4,0;2,0;;9,0;;;;1,0;;;;4,0;;;;;2,0;;;1,0;1,0;;;1,0;;;;;;;;;;;;;;;3,0;3,0;;;;;;;;;;;;;;3,0;4,0;;;;;17,0;;1,0;3,0;;;;;;3,0;;;;2,0;2,0;2,0;;;;;;;;;;;;29,0;;;;;;;;;;;1,0;;;;;;;11,0;;;;;2,0;;;;;;;;3,0;;;;;;;;;;;;;;;;5,0;;;;;;3,0;;;;;2,0;;3,0;3,0;;;;1,0;;;;;;;;;;;1,0;;;;;;;;6,0;;1,0;;;6,0;;;;;;45,0;;;;1,0;2,0;1,0;;;;;2,0;;;;;;;;;;6,0;1,0;2,0;;;;;;;;;;;;;2,0;;;;;3,0;;;;;;;;;;;;;;;;;;;;;;;;;;;;1,0;;;;;1,0;;;;;;;;;;;;;;;2,0;;;;;;;;;21,0;;;;;;2,0;;;;;;;4,0;;;;;;4,0;;;;;11,0;3,0;4,0;8,0;;1,0;;;;;1,0;;;;;;;;;;;
projection;;;;19,0;;22,0;14,0;111,0;;;1,0;;2,0;113,0;;;62,0;;;6,0;;;7,0;;1,0;;;11,0;10,0;5,0;86,0;;10,0;;;23,0;17,0;3,0;26,0;1,0;107,0;123,0;13,0;37,0;42,0;14,0;14,0;21,0;18,0;40,0;63,0;3,0;51,0;17,0;8,0;1,0;37,0;2,0;;26,0;;;26,0;1,0;344,0;2,0;88,0;1,0;;1,0;19,0;215,0;188,0;;1,0;;;2,0;2,0;;84,0;2,0;12,0;42,0;26,0;5,0;;93,0;16,0;28,0;61,0;3,0;15,0;4,0;9,0;;47,0;104,0;116,0;214,0;162,0;27,0;1,0;1,0;8,0;19,0;;;11,0;4,0;;38,0;13,0;1,0;;;1,0;26,0;18,0;33,0;4,0;;7,0;12,0;1,0;1,0;123,0;;1,0;4,0;16,0;5,0;5,0;64,0;;;32,0;69,0;68,0;;;4,0;;;9,0;27,0;17,0;24,0;24,0;1,0;1,0;5,0;10,0;1,0;;;;;1,0;;;12,0;1,0;8,0;;6,0;5,0;6,0;1,0;3,0;12,0;;6,0;25,0;1,0;4,0;1,0;6,0;7,0;;;;7,0;30,0;1,0;1,0;3,0;1,0;22,0;9,0;;;;4,0;;18,0;8,0;11,0;16,0;6,0;;1,0;1,0;;11,0;3,0;18,0;;20,0;17,0;7,0;14,0;9,0;1,0;1,0;22,0;2,0;5,0;;31,0;178,0;2,0;1,0;;3,0;;112,0;1,0;2,0;23,0;12,0;5,0;21,0;14,0;7,0;1,0;29,0;1,0;;5,0;;8,0;;;1,0;2,0;4,0;34,0;16,0;1,0;18,0;4,0;4,0;23,0;;;10,0;287,0;3,0;;7,0;2,0;5,0;28,0;8,0;;;;2,0;2,0;1,0;;2,0;;2,0;;1,0;128,0;1,0;3,0;6,0;1,0;45,0;1,0;2,0;;5,0;;3,0;;2,0;;4,0;27,0;12,0;;51,0;;;9,0;;;;;;7,0;1,0;;6,0;16,0;7,0;10,0;7,0;;37,0;;24,0;42,0;1,0;;1,0;43,0;4,0;6,0;;6,0;;;;;4,0;;;20,0;;1,0;1,0;;4,0;;3,0;7,0;6,0;;;;7,0;31,0;;7,0;;;5,0;;2,0;2,0;;4,0;5,0;;;;;4,0;;17,0;;;;;;;18,0;170,0;8,0;3,0;;;6,0;;13,0;30,0;5,0;1,0;3,0;14,0;3,0;7,0;;5,0;;;3,0;;4,0;15,0;;3,0;1,0;;;4,0;2,0;4,0;11,0;36,0;4,0;2,0;1,0;2,0;;8,0;;;5,0;3,0;4,0;2,0;;;;;;;2,0;45,0;3,0;13,0;4,0;;11,0;;1,0;;2,0;;1,0;4,0;4,0;;;;13,0;2,0;19,0;3,0;;1,0;11,0;;;;4,0;1,0;;;1,0;50,0;;3,0;6,0;;;2,0;2,0;;;;;;;;2,0;5,0;15,0;;11,0;;5,0;1,0;;6,0;;8,0;1,0;;8,0;7,0;2,0;9,0;1,0;9,0;3,0;109,0;;5,0;3,0;;;;2,0;;1,0;1,0;5,0;25,0;1,0;1,0;;2,0;;8,0;3,0;3,0;4,0;16,0;;1,0;;;2,0;;4,0;;;;;;;;1,0;1,0;;18,0;34,0;;1,0;;2,0;2,0;;;3,0;1,0;;;;;;;;;;3,0;2,0;;;2,0;;;;4,0;8,0;;4,0;;;;;2,0;;;;;22,0;6,0;;7,0;15,0;;;3,0;15,0;1,0;;7,0;;;11,0;3,0;;3,0;;1,0;;;3,0;1,0;9,0;;;1,0;;29,0;;;;3,0;;1,0;;4,0;36,0;42,0;;;;;;;;;6,0;2,0;;;7,0;;;;;;;;;;;;1,0;1,0;;;5,0;;;1,0;;1,0;;;;2,0;1,0;;5,0;;;;;;2,0;;;;2,0;;2,0;;;;37,0;1,0;;;2,0;12,0;;3,0;14,0;;;;;1,0;;13,0;;;2,0;;4,0;10,0;;3,0;5,0;13,0;;3,0;;;;;7,0;1,0;3,0;11,0;15,0;;;2,0;;13,0;24,0;;;10,0;;5,0;2,0;;;;;;;2,0;;;65,0;;;;;17,0;23,0;;;1,0;11,0;2,0;;2,0;5,0;;;;;1,0;;;;;;1,0;;3,0;1,0;6,0;3,0;;2,0;1,0;1,0;;1,0;1,0;;;;2,0;1,0;1,0;;2,0;;;;;;;;;;;5,0;6,0;;2,0;;;;;6,0;;;;;;;;;;;4,0;;;;;2,0;23,0;;;;;;;1,0;;;;;9,0;;3,0;17,0;1,0;;4,0;;;;;;;;;;;;;6,0;;;;;;;2,0;2,0;2,0;1,0;10,0;;2,0;3,0;1,0;5,0;4,0;;;4,0;;2,0;;;3,0;9,0;;;;;17,0;1,0;;3,0;;;1,0;9,0;2,0;;;1,0;1,0;;;;;3,0;2,0;1,0;1,0;;6,0;;;;;;;;;;;3,0;1,0;;1,0;3,0;4,0;1,0;;1,0;;;;2,0;;;2,0;;;;;;;1,0;;3,0;;;;;;1,0;;;;;1,0;;;;;;;;;;;;;;2,0;;;;;;;;;;;;1,0;;12,0;;;;;;;2,0;1,0;2,0;;;;;6,0;5,0;;12,0;;2,0;;3,0;4,0;;;;2,0;;;;;;
protrude;;;;4,0;;8,0;;12,0;;;4,0;;22,0;128,0;;;;;11,0;;;;;;1,0;;;22,0;;;20,0;;;;;;4,0;;;;1,0;18,0;9,0;1,0;13,0;30,0;;67,0;;;;;14,0;5,0;;;34,0;;;3,0;4,0;;2,0;;7,0;;48,0;;;8,0;9,0;115,0;8,0;1,0;;;6,0;;;;2,0;;;;35,0;5,0;;9,0;;3,0;;8,0;14,0;4,0;;;;1,0;63,0;1,0;51,0;2,0;;;;;;;;;;3,0;17,0;;7,0;;;7,0;;18,0;;;;;;;28,0;;;1,0;;;;34,0;;;;;1,0;1,0;7,0;5,0;1,0;;6,0;;10,0;7,0;3,0;10,0;4,0;6,0;51,0;23,0;;;4,0;;;;11,0;23,0;;;;;24,0;41,0;;;;;;56,0;1,0;39,0;;;;;;2,0;7,0;31,0;6,0;1,0;1,0;;20,0;28,0;;;19,0;3,0;27,0;30,0;89,0;;48,0;5,0;;;;;;;49,0;8,0;2,0;81,0;1,0;4,0;;2,0;2,0;48,0;;;;1,0;1,0;;;;31,0;;240,0;;1,0;;;1,0;;;25,0;;;;3,0;;;14,0;2,0;;;1,0;;25,0;96,0;13,0;7,0;;;14,0;9,0;;32,0;332,0;3,0;;;;;9,0;30,0;2,0;;;;5,0;;4,0;4,0;;9,0;;;16,0;6,0;;7,0;3,0;8,0;28,0;;1,0;11,0;18,0;25,0;4,0;11,0;2,0;16,0;1,0;;7,0;11,0;2,0;5,0;10,0;5,0;18,0;16,0;;1,0;13,0;;;9,0;1,0;1,0;6,0;11,0;1,0;4,0;8,0;10,0;16,0;7,0;2,0;1,0;10,0;13,0;;2,0;10,0;1,0;2,0;4,0;5,0;115,0;3,0;12,0;21,0;;2,0;3,0;6,0;;;16,0;;8,0;12,0;11,0;2,0;5,0;11,0;;5,0;;3,0;;;;3,0;1,0;56,0;1,0;;;;;1,0;;1,0;;;;1,0;3,0;;;2,0;;;2,0;;;;6,0;;;;;;;;;;;;;;15,0;1,0;;;;;;;;;;3,0;;1,0;;;;;;1,0;;;6,0;1,0;1,0;;;;;;;21,0;;;;;1,0;;;;;;3,0;;;;;30,0;;;;;;1,0;6,0;;;;;;8,0;1,0;;;;2,0;;4,0;;;;;;;;;;;;5,0;3,0;;;;;;12,0;;;;;;1,0;;2,0;;;4,0;;1,0;;;;;;;;;9,0;;;1,0;;;;;;;5,0;;;;;3,0;3,0;;8,0;16,0;;12,0;;;4,0;;4,0;;2,0;;6,0;26,0;3,0;;;;;;;;3,0;25,0;;;;5,0;2,0;;;;;;;;;3,0;2,0;;;;;;;;;;1,0;;;1,0;;1,0;5,0;;;;7,0;4,0;5,0;;;1,0;;19,0;;;;;;;;;2,0;;;;;;;;;20,0;;;4,0;;;;;;;4,0;;;;;;3,0;;;;;;;;;;;;;;3,0;;;;;6,0;;;1,0;;;;2,0;;1,0;;1,0;;;;;;;;;;;;;;;5,0;;;;10,0;;;;4,0;;;;;;;;;;;;;;;;6,0;;;;;;;23,0;2,0;4,0;1,0;;;;;;4,0;1,0;;18,0;;;;1,0;4,0;;;;;2,0;;;;1,0;;;;1,0;5,0;;;;;;;;9,0;;7,0;8,0;;1,0;3,0;;;5,0;;;;;;;16,0;7,0;4,0;4,0;1,0;2,0;1,0;;;2,0;11,0;;4,0;3,0;;;;;;2,0;;6,0;12,0;8,0;;;;;7,0;;;;1,0;;;;1,0;;;;;;;;;;;;;;2,0;;3,0;;26,0;;;;;;;;;;;;3,0;;;;4,0;;;;;;;;;1,0;;;;;;;;;;;;1,0;;;;;;;;;;;;;;;;;;1,0;;;;;;;;;;;;;;;;;;;;5,0;;;;;;;;;;;;;;;;;;;;;;;;;;;;;3,0;;;;;;;;1,0;;;;;;3,0;;;;;;;;;4,0;;4,0;;;;;;1,0;4,0;;;;;;2,0;;1,0;;;4,0;;1,0;;;;;;;2,0;;;;;;;1,0;;;;;6,0;;;;;;;;;;;;;;;;;;;;;;;;;;;
protrusion;;;;2,0;;24,0;;26,0;;;;;12,0;48,0;;;;;4,0;;;;;;1,0;;;83,0;1,0;;104,0;4,0;;;;;13,0;8,0;6,0;;1,0;45,0;19,0;;6,0;81,0;;16,0;;;;;90,0;1,0;;;136,0;;;6,0;7,0;;1,0;;7,0;;129,0;1,0;;27,0;29,0;152,0;10,0;;;;7,0;;;;4,0;1,0;1,0;;102,0;9,0;;20,0;;;;16,0;4,0;6,0;;;;;241,0;5,0;65,0;8,0;3,0;;;;;;;;;;3,0;1,0;;;;12,0;;14,0;;1,0;1,0;13,0;;;30,0;;;13,0;1,0;;;105,0;2,0;;;1,0;;;3,0;10,0;;;23,0;;3,0;13,0;1,0;5,0;;2,0;42,0;44,0;;;7,0;1,0;;;9,0;17,0;;;;;97,0;47,0;1,0;;;;;64,0;4,0;20,0;1,0;;;;;;;25,0;2,0;;8,0;;15,0;36,0;;;9,0;9,0;23,0;99,0;102,0;1,0;67,0;49,0;;;1,0;;;;98,0;2,0;1,0;106,0;6,0;5,0;1,0;;;54,0;;13,0;;3,0;5,0;;;;23,0;;283,0;;6,0;;115,0;;4,0;;23,0;;;;7,0;;;13,0;;2,0;4,0;;5,0;36,0;94,0;13,0;35,0;4,0;;9,0;3,0;;94,0;274,0;6,0;;;;;4,0;21,0;;1,0;;;3,0;1,0;;;6,0;16,0;;4,0;11,0;26,0;;1,0;;37,0;15,0;;1,0;3,0;10,0;19,0;5,0;11,0;;1,0;8,0;1,0;4,0;2,0;;16,0;21,0;6,0;;;;10,0;65,0;;2,0;17,0;2,0;3,0;16,0;8,0;2,0;2,0;6,0;21,0;47,0;;26,0;;2,0;17,0;7,0;1,0;4,0;;;;6,0;;;1,0;50,0;;2,0;18,0;2,0;35,0;;7,0;10,0;;18,0;8,0;17,0;43,0;29,0;4,0;2,0;;;;;;3,0;;58,0;;;;;;;;2,0;;;;;;;;2,0;;;;;;;3,0;;;;;2,0;;;;;2,0;;;;18,0;;1,0;;;;;2,0;;;;2,0;;4,0;;2,0;;17,0;;1,0;1,0;1,0;3,0;;1,0;;;;;;;76,0;;;;;;;;;;;1,0;;;;;2,0;;1,0;;;;;2,0;;;;;;23,0;;;;4,0;;;;;;;;;;;;;;;6,0;1,0;;;;;;8,0;;;;3,0;;;;;;;;;16,0;;;;;;;;;9,0;;;9,0;6,0;2,0;;;;;13,0;;;;;4,0;1,0;;2,0;1,0;;2,0;;;;;;;1,0;;4,0;125,0;5,0;;3,0;;6,0;1,0;;;;13,0;;;;;;;;4,0;;;;;;18,0;;;;;9,0;1,0;;;;;;;;3,0;;3,0;30,0;3,0;;;12,0;3,0;;;;3,0;;10,0;;;;;;;;;;;;1,0;;;;;;3,0;;;;;;;;;;12,0;1,0;;;;;21,0;;;;;;;;;;;;;;;;;;3,0;2,0;;;;4,0;2,0;;;;2,0;;2,0;;;;;;2,0;;;;;;;;;1,0;;;;6,0;;;;;;;;;;;;;;1,0;;;;;;15,0;;;1,0;;;1,0;68,0;1,0;10,0;;;;;;2,0;17,0;1,0;11,0;4,0;;;;6,0;4,0;;;;;2,0;;2,0;;1,0;1,0;;;1,0;;;;;;;;;4,0;;1,0;13,0;;3,0;;;2,0;13,0;;;5,0;;2,0;;;2,0;1,0;1,0;;3,0;;;1,0;;13,0;1,0;;;12,0;;;;;2,0;;6,0;4,0;;;;;;29,0;11,0;1,0;;;;;;;10,0;;;;;;;;1,0;;;;;2,0;;3,0;;1,0;;;;;;;;;;;;;;;;;;;;;;;;;6,0;;;;;;;;;;;1,0;3,0;;;;;;;;;;;;;;;;;;;;;;;;;;;;;;;1,0;;;;;;;;;;;;;;;;;;;;;;;;;;;;;;;;;;15,0;;2,0;;;;;;;;;;;;;;;;;;;;;;;;;;1,0;;;;;;1,0;;;;;;;;;;;7,0;;2,0;;;;;;;4,0;;;;;;;;;;;;;;;;;;;;;;;;;;;;;;;;;;;2,0;;;;
pulse;;;;8,0;9,0;28,0;10,0;;1,0;;;;;28,0;;;44,0;;;7,0;;;3,0;;6,0;;;;1,0;5,0;121,0;9,0;;;;27,0;7,0;2,0;3,0;;13,0;83,0;;16,0;5,0;;;10,0;1,0;;;;;;1,0;;7,0;;39,0;179,0;;;7,0;;38,0;2,0;25,0;2,0;2,0;;17,0;10,0;377,0;;;13,0;1,0;;;;41,0;;9,0;;21,0;;5,0;102,0;1,0;;1,0;5,0;4,0;;3,0;;28,0;;29,0;;4,0;2,0;;;;2,0;1,0;1,0;;;;13,0;16,0;1,0;;;;;37,0;34,0;25,0;;399,0;;;;20,0;;;;89,0;;;44,0;4,0;;1,0;;;;;;;;;3,0;5,0;;1,0;;2,0;;2,0;;2,0;;;;;2,0;13,0;6,0;;36,0;11,0;;8,0;2,0;;19,0;20,0;1,0;4,0;;;2,0;2,0;20,0;2,0;2,0;4,0;;;;;;4,0;;15,0;;2,0;;;;;;;3,0;;;;6,0;;;8,0;1,0;;;4,0;;1,0;;55,0;;;;56,0;8,0;;8,0;8,0;34,0;1,0;;2,0;;23,0;2,0;;12,0;;1,0;9,0;2,0;;;45,0;1,0;;1,0;;;;;;7,0;2,0;3,0;1,0;;;;;4,0;5,0;108,0;1,0;5,0;;27,0;7,0;35,0;;2,0;;;139,0;11,0;;8,0;;;30,0;3,0;;;2,0;;;;;;;;;;3,0;;44,0;;17,0;;;;;;4,0;18,0;;;;;;;;;;;;30,0;;;1,0;;;;8,0;;;4,0;;15,0;;6,0;16,0;;;;11,0;;;;;;3,0;;1,0;;;;2,0;;;;;;2,0;;;;;;4,0;;;;29,0;;5,0;1,0;;;;;1,0;2,0;;;;;;;7,0;14,0;21,0;1,0;10,0;2,0;;1,0;101,0;;19,0;1,0;;22,0;1,0;5,0;;3,0;1,0;;;;1,0;;5,0;10,0;2,0;;;14,0;9,0;1,0;;5,0;1,0;2,0;;10,0;;1,0;;5,0;7,0;;;;;19,0;;19,0;;;;29,0;2,0;20,0;;;3,0;;1,0;3,0;;;;2,0;14,0;18,0;1,0;10,0;6,0;;;;;;1,0;5,0;;6,0;;;;;;1,0;;;;;7,0;1,0;;;;;;;;;;;;;16,0;1,0;2,0;;;;;1,0;;;;;;;;1,0;3,0;5,0;6,0;;;;;;;26,0;1,0;;;;;;;;;;;;2,0;1,0;;;;;;2,0;;;;;;;;;;;;1,0;;;;;2,0;;;4,0;;2,0;;;;;;;;;;;;;;;;;;8,0;2,0;;;;;;;;;;;;1,0;;1,0;;;43,0;;;18,0;;;;;;26,0;;;;6,0;;;;;;;;;;;15,0;1,0;;;22,0;;38,0;38,0;63,0;;;;;;;;;5,0;;5,0;;;;;;;;;;;;;;;;;19,0;;19,0;;;;;;;;;;;15,0;;;;;;;;;;;;9,0;;;;;;53,0;;;;;;;;8,0;;5,0;;;2,0;5,0;22,0;;;;;;;13,0;;;;;;;;;;;43,0;22,0;;;;;;;;;;;18,0;;;;2,0;;;;;1,0;;;;5,0;;;;;;;;;;3,0;;4,0;;;;;3,0;;1,0;;;;;;;;;;11,0;;;2,0;;;;;;;;;;20,0;;3,0;;;;;;;;69,0;;;1,0;;6,0;;83,0;;;1,0;3,0;7,0;;;;1,0;14,0;;;;;9,0;27,0;;;;;7,0;;3,0;;;;17,0;1,0;7,0;;;;;4,0;2,0;;4,0;;2,0;;1,0;;;12,0;;;;4,0;1,0;;;;;;;;;;3,0;;1,0;;;;63,0;;;;10,0;;6,0;;;23,0;;20,0;;14,0;;;2,0;;2,0;;;;;7,0;;8,0;;;;;;;;;;;;;;;;;;;;;;;;;;3,0;;12,0;;;;18,0;4,0;;;;;;;;1,0;;;;2,0;;;2,0;;;;;;4,0;;;;;;8,0;;1,0;;9,0;;;;;;;;;58,0;;;;1,0;;;;;;;17,0;2,0;;;;;;;;;;;;;;3,0;;;;;;;;;;;;;;;;;;;1,0;;;;
radar;;;;4,0;;19,0;1,0;;;;;;;37,0;;;4,0;;;1,0;;;;;3,0;;;1,0;3,0;;30,0;1,0;;;;59,0;;;1,0;;28,0;22,0;;;2,0;1,0;;2,0;;;;;;;44,0;4,0;;;3,0;7,0;;;5,0;;19,0;;36,0;;;1,0;;;4,0;;;;;19,0;;;21,0;;;1,0;8,0;;;7,0;;;;;;;;;;6,0;30,0;59,0;22,0;;;1,0;;23,0;2,0;3,0;;;;;3,0;;;;1,0;;;198,0;;;27,0;1,0;;15,0;118,0;;;;13,0;;;33,0;;;42,0;;6,0;;;;;;3,0;;9,0;2,0;5,0;;;;;;;;;;;;;4,0;;;;;3,0;7,0;;19,0;1,0;;;2,0;1,0;;;7,0;2,0;;1,0;;;1,0;;;;;2,0;;;;;;;1,0;5,0;;;;;;;;7,0;;;;;2,0;;;;;;;7,0;;;;;2,0;;;;;4,0;;;1,0;;11,0;22,0;;1,0;;;7,0;;;;;;;;9,0;;;;;;;;;;;;;3,0;;;20,0;;27,0;1,0;;;;;;1,0;;;5,0;;;;3,0;;1,0;;4,0;;;;;;;1,0;;;;;;1,0;;30,0;;1,0;;;;;;;;;;;;;;;;;;1,0;;;;2,0;44,0;;4,0;;;;;;;;;;;;;;;;;;;;;;;;;;;;;;;15,0;;;;27,0;4,0;;;;;;;6,0;8,0;;;;;1,0;;1,0;;;1,0;1,0;;9,0;;;1,0;;33,0;2,0;;;;;;;;;6,0;;6,0;1,0;;;1,0;4,0;10,0;;1,0;;1,0;1,0;;;;;;7,0;;;;;4,0;;;;;;49,0;1,0;5,0;;;8,0;;2,0;;20,0;;;;2,0;;;;6,0;;;1,0;;;1,0;4,0;;;1,0;1,0;2,0;;3,0;;;1,0;7,0;5,0;;;;;1,0;;;;2,0;;;;;;23,0;;;9,0;;;;;;;;;;1,0;;1,0;;9,0;2,0;;;;;;;;;;;;35,0;;;;;;;;;1,0;;;;;;;;;;;;;;;;;;;;11,0;;;;2,0;;;;;;;;;;;;;3,0;;;;;;;;;;19,0;;2,0;;10,0;;;;;;;;1,0;1,0;;4,0;;3,0;;;;;;;;;;4,0;;;;;;;;;11,0;;;;;;;;;15,0;;;;;;;;;;;;;;;;3,0;;;;;9,0;;;;;;;;;;;;;;;;1,0;;;;;;;;;;;1,0;;;;;;3,0;;;;;;;;;;;;;;;;;35,0;;;;3,0;2,0;2,0;;5,0;;;;;1,0;;;;;;;;;;;;;;;;;;;;;;;;;;;;3,0;;;;;;;;;;;;;;1,0;2,0;;;;;;;;;;;;;4,0;;;;;;;;;;;;;;;;;;;;;;;;;;;;;;;;;;;;;;;;;;;;;1,0;;;;;;;;;;;;;;;;;1,0;;;;;;;;;;;;;1,0;;;;;;;;;;;;;;;;;;;;2,0;;;;;;1,0;;;;;;2,0;;2,0;;;;;;;;;;2,0;;;7,0;;3,0;;;1,0;;;;6,0;;;;;;;9,0;;;;;;2,0;;;2,0;;;;;;;;;;;;;;1,0;;;;;;;;;;;;;;;;1,0;;;;1,0;;;;;;;;;;;;;;;;;;;;;;;;;;;;;;;;;;;;;;;;;;1,0;;;;;;;;;;;;12,0;;;;;;;;;;;;;;;;;
radiation;;;;4,0;9,0;3,0;47,0;8,0;;;;33,0;1,0;54,0;;;34,0;;3,0;1,0;;1,0;8,0;5,0;14,0;;1,0;35,0;7,0;14,0;173,0;3,0;12,0;1,0;;74,0;11,0;5,0;2,0;1,0;40,0;48,0;2,0;11,0;6,0;25,0;9,0;32,0;;;7,0;10,0;3,0;13,0;27,0;33,0;17,0;;8,0;42,0;;;9,0;;82,0;;63,0;1,0;;1,0;9,0;54,0;52,0;1,0;;;16,0;19,0;1,0;;90,0;;16,0;;23,0;;;48,0;2,0;9,0;4,0;15,0;38,0;2,0;6,0;;33,0;53,0;47,0;18,0;27,0;7,0;15,0;102,0;10,0;14,0;;8,0;;1,0;;;29,0;;;1,0;;9,0;39,0;115,0;2,0;;36,0;1,0;87,0;1,0;119,0;;;10,0;47,0;;;51,0;2,0;4,0;10,0;;;11,0;;9,0;;;6,0;12,0;32,0;9,0;8,0;10,0;8,0;18,0;13,0;;;;;;1,0;2,0;1,0;5,0;;4,0;;;5,0;6,0;;24,0;89,0;1,0;37,0;21,0;1,0;;;122,0;4,0;;24,0;;15,0;2,0;;1,0;82,0;;8,0;;32,0;;74,0;19,0;2,0;;48,0;47,0;7,0;;1,0;184,0;6,0;1,0;46,0;1,0;59,0;;2,0;1,0;;3,0;;;;6,0;12,0;;;14,0;33,0;1,0;;;4,0;;109,0;;;18,0;1,0;;34,0;7,0;;;85,0;23,0;;14,0;1,0;3,0;;;;16,0;22,0;;20,0;;;;4,0;18,0;5,0;;;39,0;3,0;1,0;8,0;56,0;6,0;4,0;3,0;;6,0;94,0;;6,0;;;2,0;17,0;;;17,0;15,0;;2,0;;;3,0;8,0;;;;1,0;10,0;;1,0;;;;2,0;;17,0;;;;;;;;;;;;;53,0;;;;;8,0;;5,0;;;4,0;4,0;38,0;;;;;;;19,0;;;;;3,0;;;;;;;8,0;13,0;;;;;;;3,0;;;;;;;;;;5,0;;;;;;;;;3,0;;;;;9,0;5,0;19,0;4,0;16,0;;1,0;;8,0;;;;6,0;143,0;;4,0;;2,0;12,0;;;49,0;;13,0;;2,0;2,0;3,0;;2,0;;19,0;4,0;7,0;;3,0;2,0;4,0;;;1,0;12,0;1,0;;1,0;;;;;6,0;1,0;;1,0;103,0;6,0;20,0;;;8,0;;;;8,0;;3,0;26,0;;;1,0;1,0;8,0;2,0;;;;7,0;7,0;2,0;;;;;;;;16,0;;1,0;11,0;4,0;;2,0;;1,0;;1,0;;;2,0;;3,0;3,0;;;13,0;3,0;7,0;12,0;;;;4,0;12,0;;7,0;;;;4,0;;;18,0;7,0;;5,0;;;;;;11,0;;;2,0;4,0;;;;;;;;3,0;1,0;;;;;;;1,0;;;;9,0;;3,0;;;;1,0;1,0;2,0;;13,0;;7,0;;;;3,0;4,0;1,0;1,0;;4,0;;;;;;;;;;;;;;4,0;4,0;27,0;;;;;;1,0;;;;19,0;;;;;;15,0;1,0;6,0;72,0;1,0;4,0;1,0;;;3,0;2,0;3,0;;5,0;1,0;;;;10,0;3,0;;;1,0;;4,0;;;;;2,0;;;;;1,0;;;;2,0;;14,0;;;60,0;2,0;;;2,0;;;;;;2,0;;;;;1,0;;14,0;;1,0;;;;;;4,0;;5,0;;2,0;;;8,0;;;;3,0;;;;;;;;;;;;133,0;2,0;;;;3,0;;7,0;49,0;;;;;1,0;9,0;5,0;2,0;;;;;;;10,0;;2,0;;4,0;4,0;;10,0;;;2,0;;;;1,0;;;;;;;;2,0;;;;;;;1,0;;;;;;;;;;4,0;1,0;5,0;18,0;;;9,0;;;;2,0;;;;;21,0;;;;;;1,0;1,0;1,0;;;9,0;14,0;3,0;1,0;;1,0;;;;1,0;8,0;;1,0;;5,0;;;;5,0;;33,0;;;;;;10,0;6,0;;;;;;;6,0;;;;7,0;;;;;;;6,0;;;;6,0;;;;;;;;;;;;;;;;;;;;13,0;1,0;;;;;;;;7,0;;143,0;1,0;;;;;;;6,0;;;;;7,0;;2,0;;;7,0;;;1,0;;26,0;;;;32,0;;;;1,0;;;10,0;1,0;4,0;;;2,0;;;;;1,0;;;;;;;2,0;1,0;;;;;;;;;;;;;;;;;;;7,0;19,0;;;1,0;;;;2,0;11,0;;;;;;;;;8,0;1,0;;;;;2,0;;;;;;;;2,0;;;;1,0;2,0;;;;;;;;4,0;;;;;;;4,0;;;15,0;;;4,0;;;;;;6,0;;;;;4,0;6,0;;;;;;;1,0;;;;;;;;;;;;;
radio;;;;6,0;;42,0;2,0;2,0;;;;34,0;3,0;18,0;;;7,0;;35,0;;1,0;;;12,0;31,0;;;22,0;5,0;1,0;51,0;3,0;;;;54,0;;;;;9,0;63,0;;1,0;12,0;;;1,0;;;8,0;;;;9,0;;;;227,0;5,0;;;5,0;1,0;53,0;1,0;25,0;4,0;;;;4,0;7,0;;;;3,0;1,0;1,0;1,0;29,0;;7,0;;9,0;;;11,0;;;1,0;;3,0;;4,0;;;;24,0;1,0;9,0;1,0;;4,0;16,0;25,0;;;2,0;;;;;;;;;27,0;3,0;23,0;1,0;;138,0;;2,0;;49,0;;;;6,0;;;81,0;;1,0;2,0;;;;;;;;;6,0;10,0;16,0;7,0;4,0;;1,0;15,0;;;;;;;;;10,0;5,0;5,0;12,0;;20,0;;2,0;7,0;8,0;;;1,0;;1,0;;9,0;;;6,0;;;8,0;;2,0;8,0;;;2,0;;;1,0;;;;4,0;;;;;;;;1,0;;1,0;;;3,0;;;1,0;;;;15,0;;;3,0;2,0;;;;;;8,0;;;;;1,0;23,0;;;;8,0;8,0;;;;;;;8,0;6,0;;;;;;;;4,0;3,0;;2,0;1,0;;1,0;1,0;85,0;;39,0;;;67,0;7,0;;;;5,0;;13,0;;;2,0;;;;6,0;;;1,0;;;;;43,0;;;;;;;;11,0;;;;;;;;;;;;;;;;1,0;;;;7,0;;1,0;;7,0;10,0;;;1,0;;1,0;1,0;31,0;1,0;;;;;;;;;;;;;;;;1,0;;;1,0;;;;;;5,0;;4,0;;30,0;63,0;;;;;2,0;;;1,0;;;;;;;;;;1,0;;;26,0;;;;2,0;9,0;5,0;;;1,0;;;;;;2,0;;3,0;;;;7,0;1,0;;;13,0;;2,0;3,0;1,0;;;2,0;3,0;3,0;;;;;;;4,0;;;;70,0;19,0;5,0;10,0;2,0;2,0;3,0;8,0;;;;1,0;;2,0;;;4,0;;;;1,0;;;;;;1,0;;1,0;1,0;;;14,0;;;6,0;5,0;;;;;;;;;2,0;4,0;2,0;9,0;;;;5,0;;;;;;6,0;;;5,0;8,0;2,0;;;;;;68,0;;2,0;;1,0;;1,0;5,0;;;;;;;;1,0;;;;;;10,0;;1,0;;;16,0;3,0;;;;;;6,0;;;;;;;;6,0;;;;1,0;;;;4,0;;13,0;;;;;;;;;3,0;;;1,0;;;7,0;3,0;;;2,0;;2,0;;;3,0;;;;;;;2,0;;;34,0;;;22,0;8,0;5,0;;;3,0;;;26,0;;4,0;;;;;1,0;2,0;;;;3,0;;;;;12,0;;3,0;;;;;;1,0;;12,0;3,0;;;;1,0;;5,0;;;;;;;;;18,0;;;;;;3,0;;;;;;;;;;;;;;;;;;;;;;1,0;6,0;;;;;;;;4,0;1,0;;;;;14,0;2,0;12,0;;1,0;;34,0;113,0;46,0;3,0;4,0;;;;;;4,0;;;;;4,0;;;;;;1,0;1,0;;;;;;;;;;;1,0;;;;;;;;;;;;;;;;3,0;;2,0;10,0;;;;1,0;;;;;;;;;;;;;;;;;;1,0;;;;1,0;;;;;;;;;;;;;;;;;;;;;;;;;;;3,0;;;;1,0;;;;;;;;;;;;;;;;;;;;;;;;;;;;;;;;;;;;;;;1,0;;;;;;;5,0;;;68,0;;1,0;;;;;;;;;3,0;;;;6,0;;;;;;;;;;2,0;;;;;;;;3,0;;;;1,0;;;;;;;;;;;;;;1,0;;;1,0;;1,0;;4,0;;;;;;;;;;;;1,0;;;;;;;;7,0;;;;;;;;;1,0;;;;;;;;;;;;;;2,0;;;;;;;;;;;;;;;;;;;;5,0;;;1,0;;;;;;;;1,0;;;;;;;;;;;1,0;;;;;;;;;;;;;;;;
reach;;;;1,0;14,0;5,0;8,0;11,0;;;;;;6,0;;9,0;4,0;;;;;;1,0;;;;;2,0;;;9,0;4,0;;;;6,0;;2,0;2,0;;10,0;29,0;;2,0;3,0;6,0;;28,0;;13,0;4,0;;2,0;1,0;2,0;;12,0;15,0;2,0;6,0;;;1,0;;51,0;;10,0;1,0;;;;53,0;95,0;2,0;;2,0;1,0;3,0;;1,0;19,0;;1,0;;3,0;;;13,0;;;2,0;;13,0;;;;12,0;1,0;15,0;12,0;102,0;18,0;;2,0;4,0;;;1,0;;;;10,0;9,0;;;;;8,0;4,0;46,0;;1,0;25,0;3,0;;2,0;5,0;;;;22,0;;6,0;21,0;1,0;;1,0;1,0;;;;;;;3,0;;9,0;1,0;27,0;;;10,0;;2,0;1,0;1,0;;;;;2,0;;;;;;4,0;1,0;3,0;2,0;4,0;;;11,0;;1,0;;5,0;5,0;;;;;4,0;9,0;1,0;6,0;1,0;4,0;;;3,0;;11,0;;7,0;3,0;3,0;;2,0;;3,0;4,0;;8,0;1,0;2,0;;1,0;2,0;;3,0;;;1,0;1,0;8,0;3,0;;4,0;2,0;8,0;;9,0;;1,0;14,0;;13,0;1,0;;1,0;8,0;2,0;;;7,0;2,0;;3,0;;;;2,0;;1,0;;;4,0;;;;;13,0;4,0;4,0;2,0;9,0;;;;;2,0;6,0;2,0;3,0;;;;1,0;;4,0;1,0;;;;12,0;8,0;;5,0;5,0;;3,0;;;;;4,0;;;;;;;;;10,0;1,0;;;;;;;2,0;;2,0;2,0;3,0;13,0;;2,0;;;;1,0;2,0;;1,0;;;16,0;3,0;2,0;;;;;1,0;;;;;;6,0;;;;;;6,0;;;;;;;;2,0;;;;;;;;;;;;;2,0;;;;3,0;;;;3,0;;;;2,0;3,0;4,0;;;6,0;;43,0;;;;9,0;7,0;3,0;2,0;2,0;4,0;2,0;;;5,0;;10,0;;2,0;;;;1,0;5,0;43,0;;1,0;;;;;;2,0;;10,0;11,0;;;;;;1,0;2,0;;;;15,0;1,0;4,0;6,0;;;;3,0;1,0;6,0;;1,0;5,0;2,0;;10,0;4,0;51,0;;;1,0;3,0;6,0;14,0;;;25,0;6,0;;;;;4,0;;;;;;;;;;;5,0;;2,0;;;1,0;;;;2,0;;;;;;2,0;;;;;;;;;1,0;1,0;;;;;;;1,0;;;;;3,0;;2,0;;;1,0;1,0;;;;;1,0;1,0;;;3,0;;;;1,0;;1,0;;;;1,0;;;;5,0;;;;;;;20,0;1,0;3,0;;;;;1,0;;;;;;;;;;;;;;8,0;;2,0;;;;;;;;;4,0;1,0;;3,0;;;;;;11,0;;1,0;;;;1,0;;;;;;;;;2,0;1,0;;;;;;;;2,0;11,0;;1,0;4,0;;;5,0;;;;;;4,0;;;8,0;;;;;;;;;;;;;;;;;;;1,0;;;24,0;;;;;;;;2,0;;;;;2,0;1,0;;;;;;7,0;;;;;;14,0;;;;2,0;1,0;2,0;;6,0;;;;;3,0;;8,0;;;;;;2,0;1,0;;;;3,0;;;;;;;1,0;1,0;1,0;2,0;1,0;;;;;1,0;;;3,0;;;;22,0;;2,0;;;;;;;3,0;6,0;;;;;3,0;;;;;;5,0;;3,0;;;;1,0;;;;;;3,0;1,0;;;;5,0;;;;;;;;;;;1,0;;13,0;2,0;;;;;;;2,0;;;;;1,0;;;;;;;;;;8,0;;;9,0;3,0;2,0;;;;1,0;25,0;;2,0;;;;;;;2,0;;1,0;;1,0;;;;;;;;;;;;;;;;;;;;;;;;1,0;;;;3,0;;;;;;4,0;2,0;1,0;;1,0;;;;;;;;;;;;;;;;;;;6,0;;;;;;1,0;;;;;;;;;;;;;;;;;;;;;;;;;;1,0;;2,0;1,0;1,0;;;1,0;3,0;;1,0;;;;;;6,0;1,0;;;;6,0;;;;;;;;;;;;;;;;;;;4,0;;;;;;;;;;;;;;;;;2,0;4,0;;;;;;;;;;;;;;;1,0;;;;;;;;;;;1,0;;2,0;;;;2,0;;;;
read;;;;44,0;6,0;15,0;69,0;5,0;;;;;;16,0;;2,0;45,0;;43,0;1,0;9,0;;31,0;;3,0;;;1,0;12,0;;141,0;4,0;6,0;31,0;;230,0;10,0;3,0;10,0;2,0;58,0;135,0;3,0;20,0;6,0;5,0;;22,0;;;;;4,0;1,0;28,0;5,0;14,0;;1,0;35,0;;;15,0;;422,0;;78,0;1,0;;;3,0;57,0;32,0;;;;;5,0;;67,0;75,0;;38,0;;43,0;;;22,0;;4,0;14,0;;1,0;11,0;4,0;1,0;500,0;;83,0;11,0;61,0;7,0;;11,0;22,0;77,0;;9,0;3,0;3,0;5,0;19,0;9,0;;;5,0;4,0;13,0;4,0;323,0;6,0;;449,0;;;22,0;170,0;;1,0;1,0;34,0;;;170,0;;;15,0;;;;;1,0;;;4,0;3,0;18,0;6,0;5,0;;7,0;8,0;5,0;;56,0;60,0;;;;;;5,0;2,0;15,0;12,0;;12,0;1,0;;9,0;4,0;9,0;6,0;19,0;;;8,0;7,0;3,0;3,0;7,0;;53,0;;;;15,0;;36,0;1,0;;12,0;;2,0;;;21,0;6,0;;;;;5,0;;8,0;5,0;;;;;1,0;3,0;5,0;;;;36,0;1,0;;11,0;10,0;17,0;;25,0;1,0;;57,0;;;1,0;;;7,0;3,0;;;;;;6,0;;1,0;;;;26,0;;;19,0;1,0;;;;3,0;15,0;3,0;;;2,0;;16,0;15,0;5,0;23,0;;;;;;149,0;;2,0;1,0;5,0;;;8,0;;;;6,0;2,0;;;;;;;47,0;;;2,0;;;;;5,0;;;;;;;2,0;;;1,0;;2,0;42,0;;;2,0;2,0;5,0;;8,0;;3,0;3,0;46,0;30,0;3,0;1,0;;;1,0;;;;;;;;19,0;;;;;;;1,0;;;1,0;;4,0;3,0;;;;;;10,0;9,0;;13,0;;8,0;3,0;;4,0;15,0;;8,0;6,0;;2,0;;1,0;;4,0;1,0;2,0;4,0;;;22,0;8,0;1,0;74,0;4,0;2,0;1,0;6,0;12,0;7,0;;2,0;2,0;8,0;29,0;;13,0;;3,0;;12,0;7,0;1,0;;17,0;6,0;9,0;8,0;29,0;;;11,0;;;;;5,0;54,0;4,0;1,0;;1,0;8,0;3,0;6,0;;;5,0;39,0;;22,0;;2,0;17,0;1,0;16,0;1,0;6,0;;16,0;5,0;22,0;2,0;2,0;5,0;50,0;;;1,0;;;14,0;6,0;1,0;14,0;1,0;;;1,0;;6,0;;3,0;3,0;;1,0;;;5,0;;2,0;;;8,0;8,0;18,0;2,0;;;;;13,0;4,0;;1,0;2,0;8,0;9,0;;29,0;4,0;2,0;;15,0;;;10,0;;;;;1,0;;;1,0;;3,0;14,0;11,0;4,0;;;6,0;2,0;;;6,0;1,0;13,0;;;;;;;2,0;;;4,0;;;1,0;;;;;2,0;34,0;;5,0;1,0;3,0;;;;;;;;;4,0;;1,0;;;;;5,0;2,0;;3,0;;;;15,0;1,0;;1,0;;10,0;;1,0;1,0;;1,0;7,0;;;;;;;;8,0;2,0;2,0;;7,0;2,0;;4,0;53,0;7,0;;;;;;;;;;;3,0;16,0;;8,0;;3,0;;;6,0;14,0;;11,0;;;;;;9,0;6,0;4,0;8,0;8,0;;4,0;;;;;;;;1,0;;1,0;;1,0;;;;3,0;;;1,0;2,0;10,0;;;;;;68,0;;3,0;2,0;2,0;;4,0;;6,0;;1,0;3,0;;4,0;26,0;;;10,0;;;4,0;;;;;5,0;;8,0;11,0;;;;1,0;3,0;;17,0;;;;;2,0;;7,0;1,0;7,0;;2,0;1,0;;;;3,0;4,0;6,0;15,0;;1,0;;;;;;;4,0;;3,0;;;4,0;;;;;;;;;;;;;;;3,0;8,0;;;;2,0;;1,0;;;1,0;;;;;;5,0;;;;;;;;;;;;;;;;;;;;;8,0;;;;;;;;;;;;;3,0;;;;;1,0;;10,0;6,0;16,0;;4,0;;33,0;;;6,0;;;;14,0;10,0;;2,0;11,0;1,0;6,0;4,0;;4,0;1,0;25,0;;22,0;;1,0;;4,0;;;23,0;47,0;3,0;;;11,0;;2,0;17,0;;;;12,0;;;;;;;;2,0;;;;;;;;6,0;;;;;4,0;1,0;2,0;1,0;;1,0;;;;;;;;;;1,0;;12,0;;;;2,0;;;;3,0;;;;;;2,0;;;5,0;5,0;;;;;;1,0;;;;;;;2,0;;;;;;;4,0;;;;;;;;9,0;;;;;;;;1,0;;;;;;;;;;;;;;28,0;;;;;;;;;;;;;;;1,0;;;2,0;;;;;;;;;;;2,0;;;;3,0;;;;;;;;;;;;;;;;;;;;;;;;;
readable;;;;5,0;3,0;11,0;3,0;3,0;1,0;1,0;;;;1,0;;;22,0;;;;;1,0;9,0;;14,0;;1,0;3,0;1219,0;12,0;25,0;3,0;1,0;2,0;;41,0;5,0;1,0;8,0;;33,0;117,0;;8,0;43,0;3,0;;10,0;;;9,0;;;;6,0;1,0;;;2,0;14,0;;;6,0;;149,0;1,0;63,0;5,0;2,0;;1,0;2,0;9,0;;2,0;1,0;;3,0;124,0;72,0;39,0;;4,0;7,0;8,0;;;4,0;;3,0;14,0;;;;;;14,0;2,0;23,0;7,0;8,0;2,0;;7,0;26,0;165,0;37,0;239,0;;1,0;;6,0;18,0;;;1,0;1,0;3,0;4,0;20,0;2,0;;16,0;3,0;;203,0;46,0;;4,0;;27,0;;;18,0;;;19,0;2,0;5,0;;;1,0;;;1,0;3,0;1,0;;11,0;;;;;;;;;;2,0;;;1,0;10,0;;;1,0;16,0;;;;6,0;;2,0;4,0;;5,0;;;12,0;;;;;1,0;;;2,0;;10,0;;;1,0;;;;;;;;;;;;;4,0;1017,0;;;;1,0;1,0;5,0;1,0;;;;4,0;2,0;;3,0;5,0;2,0;;;;;11,0;;;4,0;;1,0;1,0;;;;;;;;;1,0;1,0;;;5,0;;1,0;1,0;;;;;;;;1,0;7,0;;;;;2,0;9,0;;;1,0;2,0;1,0;;;;;2,0;;;;1,0;;;;;1,0;;;;1,0;1,0;6,0;;;1,0;;;;;8,0;;;;;;;;;;1,0;;1,0;5,0;;;;;;;;1,0;;;2,0;25,0;;6,0;;;;;5,0;1,0;;;;;17,0;;;;;;;;1,0;;;;1,0;6,0;;;;;;;10,0;1,0;;;21,0;;3,0;1,0;;14,0;;2,0;2,0;;;;;;1,0;4,0;1,0;1,0;;1,0;3,0;1,0;32,0;4,0;;2,0;;9,0;3,0;7,0;2,0;4,0;2,0;47,0;5,0;1,0;;6,0;;20,0;1,0;1,0;;14,0;1,0;20,0;;8,0;4,0;1,0;1,0;6,0;;1,0;;;17,0;3,0;;;;;;3,0;;5,0;;11,0;19,0;6,0;1,0;;4,0;1,0;6,0;1,0;;;493,0;4,0;;;;;24,0;;;843,0;;;9,0;;;;6,0;;;;;6,0;5,0;5,0;9,0;1,0;1,0;2,0;;9,0;1,0;3,0;1,0;2,0;1,0;;262,0;12,0;;;2,0;;3,0;155,0;;2,0;;;3,0;1,0;17,0;1,0;;3,0;;2,0;;6,0;;;2,0;2,0;14,0;;;5,0;23,0;11,0;2,0;;1,0;;;3,0;;;;;2,0;2,0;;1,0;;;;;;;3,0;;;;;;;11,0;;1,0;;1,0;;;;4,0;1,0;1,0;;;;2,0;;;;;;;1,0;1,0;4,0;3,0;;;;;;;;2,0;3,0;;;;1,0;1,0;2,0;;;;1,0;1,0;;;;;;;1,0;1,0;2,0;;;;142,0;;;2,0;4,0;;1,0;;1,0;;4,0;;4,0;21,0;;11,0;6,0;7,0;;4,0;7,0;;;;;;;;3,0;;4,0;;;2,0;1,0;4,0;1,0;1,0;;;;;1,0;;;7,0;;;1,0;;;1,0;1,0;1,0;;;2,0;;;;2,0;;;1,0;;1,0;1,0;1,0;;2,0;4,0;;1,0;;2,0;1,0;3,0;;1,0;;;;7,0;;;;;2,0;1,0;5,0;8,0;;3,0;;;1,0;;;;;;;;;;;;1,0;;;;;;;;3,0;1,0;;;;;3,0;;;;4,0;;4,0;1,0;;;;10,0;;;;;;;;;1,0;;;;;;;;;3,0;;1,0;;;;;1,0;5,0;2,0;;;;;;;;;;;;;;;1,0;;;;;1,0;5,0;;3,0;;2,0;;;;;1,0;;;;;;1,0;;2,0;;;;4,0;1,0;;;;;;;;1,0;;;;;9,0;;2,0;;5,0;5,0;;;;2,0;;;2,0;;;;;;1,0;;;;;;2,0;;;;;2,0;;1,0;;1,0;;;2,0;;;;;;;;;1,0;;3,0;1,0;;;;;1,0;6,0;2,0;;;5,0;1,0;;2,0;;;2,0;;;;;8,0;4,0;;;;;1,0;1,0;;;;;;;;;;2,0;1,0;1,0;;;;1,0;;;;;;2,0;;;11,0;;;;;;;;1,0;;;;;;;1,0;;;;;3,0;;;;;;;;;;;;;;;;;;;;;;;;;;;;;;;;;;;;;;;;;;3,0;2,0;;;1,0;;;;;;1,0;;;;1,0;;1,0;;;;;;6,0;;;3,0;;;1,0;;;;;
rearward;;;;2,0;;;;3,0;;;;;1,0;2,0;;;17,0;;1,0;;;;;;;;;;4,0;2,0;15,0;;;;;8,0;;;;;3,0;13,0;;7,0;10,0;23,0;;7,0;;;;;16,0;8,0;75,0;;;;;2,0;2,0;;2,0;;38,0;;4,0;;;;;9,0;14,0;;;;;;;;2,0;;;;1,0;1,0;;6,0;;1,0;;;;3,0;;;;1,0;2,0;3,0;21,0;;;;;9,0;;3,0;;;;;3,0;;1,0;;;;4,0;14,0;;;;;;;15,0;1,0;;;;;;13,0;1,0;11,0;153,0;;;;;1,0;1,0;;;;3,0;4,0;;1,0;2,0;;3,0;1,0;;;;;;;;8,0;;1,0;;;2,0;3,0;;3,0;;;13,0;34,0;;;;2,0;;3,0;;33,0;;49,0;;;2,0;;;14,0;;;;;;;13,0;;2,0;;;;;;;;3,0;;3,0;6,0;;4,0;;;;;4,0;1,0;;1,0;;;;;3,0;;17,0;;;;;;;;13,0;;1,0;;1,0;;;;;;;3,0;;;20,0;;;;;1,0;7,0;;4,0;14,0;;;;;;120,0;1,0;;;;;7,0;3,0;;9,0;;;;;1,0;;;;;1,0;3,0;;;1,0;4,0;;;;;;;;5,0;9,0;16,0;;;;;;1,0;;;;;;11,0;;;;;5,0;;8,0;;;;;18,0;8,0;3,0;;;;;5,0;;;;;3,0;;;;;4,0;;2,0;1,0;;6,0;2,0;1,0;;;;;;;;;;;1,0;1,0;33,0;;;;;;;1,0;4,0;;;;;;;2,0;1,0;;;;;;4,0;;;;2,0;14,0;8,0;;;;;;;;52,0;;;;4,0;;;;;;;9,0;;5,0;;;;3,0;;7,0;;;;;;;;;;;;7,0;;1,0;7,0;;1,0;;;;;;1,0;;;;;;;;;;;3,0;;;;;1,0;1,0;;1,0;;;;1,0;1,0;;;;;;;;;;;1,0;;5,0;1,0;;;;;;;;1,0;;3,0;;;;1,0;;;2,0;;;;1,0;2,0;;;;;;;;;;7,0;;1,0;;;;1,0;;;;;1,0;10,0;;1,0;;;;;;;;;;;;;;;3,0;;1,0;;;;;;2,0;;;;;;;;;;;;;;;;;;;;;;;;;;;;;;;;;6,0;;1,0;1,0;;;2,0;;;;;;;;;;;;;;2,0;;;;;;;;;;;;;;;;;;;;;;;1,0;;;;;;;;;;1,0;;;;;;;1,0;;;;;;;;1,0;;;;;;;;;;;;;;;;;;;;1,0;;;;;;1,0;;;;;;;;;;;;;;;;;;;;;2,0;;;;1,0;;;1,0;;;;;;;;;8,0;;;;;;;;2,0;;1,0;;;;;;;;3,0;4,0;;;;3,0;;;;3,0;;;3,0;3,0;1,0;;2,0;;2,0;;;;;;;;;;;;3,0;;;;;1,0;;;;1,0;;;;;;;;;;1,0;;;;;;;;;;;;;1,0;;;;;;;;;;;;;;;;;;;;;;;;;;;;;;;;;;;4,0;;;1,0;;;;;1,0;;;;;;;;;;;;;;;;;;;;;;;;;;;;;;;2,0;;;;;;5,0;;;;;;;;;;;;;2,0;;;;;;;;;;;;;;;;;6,0;;;3,0;;;;;;;;4,0;;;;;;;;;;;;;;;;;1,0;;;;;;;;;;;;;;2,0;;;;;;;;;;;;;;;;;;;;;;;;;;;;;4,0;3,0;;;2,0;;;;;;;;;;;1,0;;;;;;;;;;;;;;;;
recognize;;;;5,0;;9,0;;;3,0;;;;;28,0;;;44,0;;;7,0;;1,0;7,0;;2,0;2,0;;2,0;9,0;27,0;71,0;18,0;1,0;;;26,0;;3,0;6,0;;24,0;34,0;;4,0;37,0;1,0;1,0;8,0;;3,0;2,0;1,0;;1,0;5,0;;18,0;;;13,0;;;5,0;;241,0;;23,0;;5,0;4,0;;;9,0;;;2,0;4,0;6,0;5,0;1,0;68,0;;11,0;;16,0;;;1,0;;1,0;1,0;5,0;4,0;1,0;11,0;;11,0;2,0;23,0;49,0;47,0;13,0;;24,0;35,0;29,0;;3,0;4,0;;;8,0;36,0;;;;1,0;11,0;10,0;11,0;8,0;;14,0;5,0;;5,0;44,0;;;;7,0;;1,0;97,0;;;2,0;6,0;4,0;1,0;;;;;;4,0;11,0;1,0;15,0;;;;1,0;;;;;;4,0;;;4,0;10,0;;;;4,0;;;19,0;2,0;5,0;;6,0;;;;;;;;;;49,0;;;6,0;;19,0;6,0;;13,0;;;;;1,0;;;1,0;;;7,0;;4,0;;3,0;;1,0;2,0;2,0;5,0;;;;;17,0;;2,0;;12,0;1,0;18,0;;3,0;;8,0;;;;;;5,0;3,0;;;1,0;;;3,0;;;;;;15,0;4,0;3,0;16,0;;;;;1,0;;;4,0;3,0;;;;6,0;;36,0;;;;;;;;;;;;;;;;;;;;2,0;;;;4,0;18,0;3,0;;;;;2,0;;11,0;;;;;;;;;;;;1,0;6,0;;1,0;3,0;;1,0;;2,0;;1,0;1,0;12,0;137,0;;;;;1,0;;;;;;;;7,0;;;;;;2,0;6,0;;;;;2,0;8,0;;;;;;;4,0;;2,0;3,0;11,0;2,0;7,0;;;4,0;2,0;;10,0;;;;;;6,0;1,0;2,0;2,0;;30,0;5,0;2,0;17,0;11,0;;1,0;;28,0;;3,0;;11,0;;11,0;8,0;;7,0;9,0;;1,0;4,0;2,0;;23,0;;2,0;;2,0;;7,0;13,0;3,0;;6,0;;8,0;20,0;20,0;;;3,0;1,0;;;;;;18,0;;11,0;5,0;;2,0;;7,0;17,0;9,0;;2,0;12,0;;;2,0;3,0;1,0;;;2,0;;5,0;68,0;;;;2,0;;;;3,0;3,0;;;6,0;;3,0;3,0;1,0;1,0;;;2,0;;;;3,0;3,0;;;;1,0;2,0;2,0;;11,0;5,0;3,0;1,0;;16,0;1,0;;2,0;;6,0;3,0;1,0;;;3,0;;1,0;;1,0;1,0;;13,0;;;;;6,0;1,0;8,0;;;2,0;1,0;9,0;;3,0;;;;;;;;;;;;;;129,0;;;;;;1,0;2,0;6,0;;;;1,0;2,0;2,0;;;1,0;2,0;;;60,0;2,0;;7,0;;;;;3,0;12,0;;1,0;1,0;;12,0;31,0;1,0;;2,0;;2,0;2,0;;1,0;4,0;12,0;;;;;;;;;;;7,0;2,0;;5,0;1,0;;;;;6,0;8,0;3,0;5,0;;7,0;40,0;;;;;;;;2,0;2,0;;;;20,0;2,0;11,0;;;;;2,0;;;;;4,0;;;;;11,0;;;;3,0;;;;;;;;2,0;1,0;;;5,0;;2,0;1,0;;6,0;;1,0;5,0;3,0;;;;2,0;;;;4,0;7,0;;2,0;8,0;;;;;1,0;;;52,0;3,0;2,0;;;;;;2,0;;;;;;;;;;;;;;;;2,0;;;;;;;;;2,0;;1,0;;;;;;;1,0;1,0;;;1,0;;;;;;;;;;1,0;;1,0;;;;8,0;;1,0;;;;1,0;3,0;;;;;;;;;4,0;;;;;;;;1,0;;;;;;5,0;;1,0;;;;;;;;;;;;;;;3,0;;;;;4,0;;;;;2,0;1,0;;;;;;;;;;16,0;;;4,0;;;;;;1,0;21,0;;;;18,0;1,0;;;;1,0;;;;;9,0;;56,0;;;;;;;;10,0;1,0;;5,0;;;;;3,0;;;;;;2,0;5,0;;;;4,0;;1,0;30,0;;;3,0;;;;1,0;2,0;;3,0;1,0;;;1,0;;;;;;;;;;;;1,0;;;;;;;;;;;6,0;;4,0;59,0;;;1,0;1,0;;;;;;;1,0;;;;;;;;;;4,0;;1,0;;;1,0;;;;;;;;;;;;;;;2,0;;;;;1,0;;;;;3,0;;;;4,0;;;;;;;;;;;;;1,0;;5,0;;5,0;;;;;;2,0;;;;;;1,0;;6,0;;;;2,0;;;;;
recorder;;;;2,0;10,0;13,0;;;;;;;;4,0;;;16,0;;;;;;;3,0;4,0;;;;;;16,0;2,0;;;;52,0;;;;;10,0;25,0;;76,0;6,0;15,0;;;;;1,0;;;7,0;;;8,0;;;3,0;;;;;43,0;;20,0;;1,0;;;5,0;5,0;2,0;;;;;1,0;12,0;16,0;;6,0;;59,0;;;;;;1,0;;;;;;;;;;11,0;1,0;;2,0;3,0;1,0;;;;;;2,0;;;8,0;;1,0;;;3,0;;;19,0;;;5,0;23,0;;;;1,0;;;2,0;;;1,0;;3,0;;;;;;;;4,0;;;1,0;;1,0;1,0;;;4,0;;;;;;57,0;;;;;1,0;;;1,0;;;;;;;;;;;;;;6,0;;;;;25,0;6,0;;;;;5,0;;16,0;2,0;;;;;;;;13,0;2,0;;;18,0;;;;;;;;1,0;;;;;;;;;7,0;;;;;;;;2,0;;;;;;;;;;;;;;1,0;;;;1,0;;;2,0;5,0;;;;1,0;24,0;8,0;11,0;;;;;4,0;;;;;;;;2,0;;;;;;;2,0;;;;;;;;1,0;;;;;;;;;5,0;;;;;;;;;2,0;;;;;;;4,0;;;5,0;3,0;;;;;;;;10,0;;;;2,0;;108,0;;5,0;;;;;;;;;2,0;;;;;;;;;;;4,0;;168,0;5,0;;;;3,0;;;;;;2,0;;;;;;;;8,0;;;20,0;;;;;2,0;;;;6,0;2,0;;;;6,0;6,0;;1,0;18,0;;;7,0;3,0;4,0;;;;42,0;;;;;;7,0;4,0;;;;;;;4,0;;;;22,0;1,0;16,0;;;;;2,0;1,0;;;20,0;1,0;2,0;;;;;;;1,0;;;14,0;;;;;;;8,0;;;6,0;;;;;;;;;;;;;;4,0;7,0;;;;14,0;;;;;7,0;;;;6,0;;;;;;2,0;;3,0;;;2,0;;;;4,0;;;;;;33,0;;;7,0;;9,0;1,0;;4,0;;;;;3,0;;;;;;;;;;;;;;1,0;;;;;;;;;;;3,0;;;5,0;;3,0;1,0;;;4,0;;;;;;;47,0;7,0;;;;;;;;;;;;;;;;;;;;;1,0;;;;;;;2,0;2,0;;1,0;;;;;;;;;;4,0;;;;;;;;;;;;;;1,0;;;1,0;14,0;;;3,0;;;;;3,0;1,0;6,0;10,0;16,0;;;2,0;3,0;;;1,0;;;;;;;;;;;;;;;;;;;;1,0;;2,0;;;;;;;;;;;;;;;;;;;;;;;3,0;;;;4,0;;;3,0;;3,0;;;;;;;;;;5,0;;1,0;;;2,0;;;;;;;;;;;2,0;;;1,0;2,0;;;;;2,0;;1,0;;;;;;;;;;;;;;;;;;;;;;;;;;;;;;;;;4,0;;;;;;;;;;;;;;;;;;;;;;;;;;;;;;;;;;1,0;;;;;;;;;;;;;;;;;;;;;;;;4,0;;;;;;;;;;;;;;;;;;;;;;;;;;;;;;;;;;;;;1,0;;;;;;;;;;;1,0;;;;;;;;;;;1,0;;;;;;;;;;;;;;;;;;;;;;;;;;;;;;;;;;;;;;;;;;;;;;;;;;;;;;;;;;;;1,0;;;;;;;;;;;;;;;;;;;;;;;;1,0;;;;;;;;;;;;;;;;;;;;;;;;;;;;;;;;3,0;;
reflect;;;;4,0;27,0;10,0;15,0;15,0;1,0;;;;1,0;62,0;2,0;1,0;49,0;;2,0;2,0;2,0;;2,0;;;;1,0;33,0;8,0;;144,0;16,0;;4,0;;66,0;2,0;6,0;19,0;4,0;86,0;64,0;;10,0;8,0;15,0;;99,0;;4,0;;2,0;4,0;5,0;30,0;1,0;49,0;;31,0;49,0;;;3,0;;238,0;;34,0;1,0;2,0;;2,0;104,0;1182,0;;;;4,0;30,0;1,0;4,0;44,0;;9,0;;17,0;11,0;;111,0;5,0;;7,0;;30,0;1,0;13,0;;24,0;18,0;78,0;34,0;67,0;5,0;15,0;3,0;34,0;9,0;1,0;1,0;1,0;5,0;1,0;29,0;15,0;;;;2,0;4,0;67,0;85,0;4,0;;56,0;4,0;;4,0;41,0;;2,0;;34,0;4,0;;100,0;1,0;;54,0;1,0;;3,0;;2,0;;6,0;12,0;1,0;27,0;27,0;18,0;;;11,0;2,0;;;;;11,0;;;;4,0;3,0;2,0;2,0;;5,0;5,0;;7,0;30,0;5,0;28,0;22,0;;9,0;1,0;49,0;;2,0;;;3,0;18,0;;9,0;28,0;;14,0;3,0;;;;;1,0;;28,0;62,0;18,0;2,0;;10,0;;;55,0;4,0;11,0;1,0;166,0;16,0;2,0;;9,0;2,0;;24,0;13,0;2,0;10,0;50,0;85,0;3,0;;3,0;8,0;;161,0;;1,0;7,0;;85,0;29,0;9,0;4,0;1,0;;57,0;;8,0;;;1,0;;;17,0;5,0;5,0;33,0;;;;2,0;16,0;10,0;;;178,0;1,0;31,0;3,0;85,0;2,0;11,0;2,0;4,0;66,0;30,0;1,0;4,0;;;1,0;6,0;;;6,0;22,0;;1,0;;2,0;41,0;1,0;1,0;;;9,0;;;2,0;21,0;;;3,0;;28,0;;;;;;;1,0;;;1,0;4,0;1,0;39,0;2,0;;8,0;;;;1,0;;5,0;5,0;2,0;346,0;;;5,0;1,0;3,0;;3,0;;;;;;1,0;1,0;;;;;14,0;2,0;;;1,0;;1,0;2,0;2,0;;;;;;20,0;1,0;;;2,0;4,0;10,0;;;2,0;;3,0;2,0;;;;;;9,0;4,0;8,0;;7,0;;;;8,0;3,0;;;2,0;58,0;;15,0;;;1,0;;;5,0;2,0;8,0;4,0;1,0;2,0;;;5,0;1,0;;1,0;11,0;4,0;;4,0;;1,0;5,0;;3,0;4,0;;;;;1,0;14,0;;7,0;;;216,0;5,0;35,0;3,0;;39,0;;;2,0;3,0;;19,0;26,0;1,0;10,0;;;;4,0;;;;4,0;14,0;;;3,0;;;;;;12,0;;;7,0;1,0;;2,0;1,0;;;;;;;;;3,0;22,0;;32,0;;4,0;;2,0;;;2,0;1,0;4,0;6,0;;1,0;3,0;;;;16,0;10,0;73,0;3,0;;;;1,0;;;4,0;5,0;1,0;;;;;;;;;;;;1,0;;;;;;;;;4,0;;;1,0;;;;4,0;;;;1,0;;2,0;;;5,0;9,0;;8,0;;;;3,0;1,0;;3,0;;;1,0;;2,0;;;1,0;1,0;5,0;;12,0;;7,0;;;;;;;;3,0;;3,0;2,0;;26,0;;;204,0;2,0;2,0;;;;;8,0;;1,0;;22,0;;;;14,0;15,0;;1,0;;;52,0;;3,0;;3,0;;5,0;;;;1,0;;;;;;;;;11,0;8,0;;;1,0;;;;;;;;;;;;;6,0;;9,0;;3,0;;20,0;;1,0;;1,0;;;25,0;;1,0;;;;2,0;2,0;4,0;5,0;;;2,0;1,0;1,0;;;;41,0;3,0;;6,0;;1,0;;;121,0;;;2,0;;4,0;;;;;;;6,0;;3,0;;4,0;;2,0;;;;6,0;;21,0;7,0;1,0;;;1,0;;;1,0;;;;;45,0;;;;;;1,0;;;;;2,0;;4,0;;;;30,0;2,0;17,0;;1,0;;8,0;;3,0;;1,0;;;13,0;7,0;30,0;;1,0;;;;;;3,0;;;5,0;1,0;;2,0;;;;;;;30,0;;1,0;;29,0;2,0;;;8,0;;1,0;;;;;1,0;;;;;;;;;4,0;;;;1,0;;;;;;;6,0;;;;;5,0;;;;;3,0;;;1,0;;;4,0;;55,0;;;;;;5,0;;;;;;;;;;;;;;;;2,0;;;6,0;2,0;;;;1,0;;;2,0;;13,0;;;;;14,0;;42,0;2,0;30,0;9,0;;;8,0;;7,0;;;1,0;1,0;1,0;1,0;;;;;;;;;;;;3,0;;;;;;;;;;;;;;;;;;3,0;;5,0;5,0;1,0;3,0;;;;;13,0;;;;;;;;4,0;4,0;;45,0;;;;;1,0;1,0;;;;;;;;;;;;;1,0;;;4,0;;;;1,0;;;12,0;;2,0;;4,0;;;10,0;1,0;;;;3,0;1,0;;;;;;1,0;;6,0;4,0;;;;;;1,0;12,0;;;;;;;;;1,0;;;2,0;
reflection;;;;3,0;14,0;19,0;1,0;4,0;;;;;;14,0;6,0;1,0;37,0;;;2,0;8,0;3,0;;;1,0;;;4,0;;;28,0;5,0;2,0;;;4,0;1,0;;4,0;;38,0;42,0;;4,0;20,0;20,0;1,0;26,0;;6,0;2,0;1,0;;;6,0;;26,0;;13,0;5,0;;;4,0;;88,0;;59,0;1,0;;3,0;;9,0;192,0;1,0;;;2,0;1,0;1,0;1,0;26,0;;11,0;;20,0;7,0;;63,0;;1,0;1,0;;5,0;1,0;;;25,0;9,0;40,0;10,0;5,0;1,0;;1,0;9,0;4,0;;;5,0;4,0;5,0;10,0;70,0;;;;;5,0;9,0;16,0;;;43,0;1,0;6,0;2,0;22,0;;;3,0;9,0;30,0;;21,0;1,0;;6,0;;;13,0;;1,0;;;2,0;9,0;15,0;22,0;;;;13,0;9,0;2,0;;;6,0;33,0;;;5,0;;;1,0;3,0;;;5,0;5,0;15,0;9,0;;13,0;9,0;;3,0;1,0;10,0;1,0;;;;;32,0;;121,0;17,0;;;1,0;;;;;;;18,0;26,0;2,0;;1,0;39,0;2,0;;1,0;10,0;6,0;8,0;87,0;5,0;;;;;2,0;2,0;5,0;;24,0;15,0;56,0;;;5,0;1,0;;78,0;;8,0;2,0;;23,0;3,0;;;;57,0;;;4,0;;3,0;;;;5,0;1,0;10,0;16,0;;;;3,0;9,0;31,0;;;96,0;5,0;;;7,0;;6,0;8,0;;4,0;2,0;;;;3,0;10,0;;;;3,0;9,0;;4,0;;;3,0;;;;;;;;;;;;11,0;;29,0;13,0;;;;;;5,0;;;;;1,0;19,0;1,0;;;;;;16,0;;2,0;;;51,0;29,0;5,0;3,0;;;;;;;;;;;;;;;;;;;;1,0;;;1,0;;;;;1,0;;;;;4,0;6,0;1,0;3,0;;;;;4,0;7,0;1,0;;;;;1,0;12,0;15,0;1,0;1,0;;13,0;3,0;19,0;;;;;25,0;3,0;40,0;;;;1,0;3,0;;5,0;3,0;1,0;14,0;;;;1,0;;;;2,0;;17,0;5,0;;;3,0;;1,0;;1,0;;;;;;;2,0;;;24,0;;;1,0;;16,0;;1,0;;5,0;;2,0;3,0;;;1,0;;1,0;;;;;;9,0;;;21,0;3,0;;;;;2,0;;;2,0;1,0;;11,0;;;;1,0;10,0;;;;2,0;2,0;;;45,0;;4,0;;;;;10,0;;;3,0;;;;;3,0;;4,0;1,0;5,0;3,0;;;;;3,0;;;;2,0;1,0;;;;;;;;;1,0;;1,0;;;;;;;;;;;;;;;;10,0;6,0;;1,0;7,0;;1,0;;;;5,0;5,0;4,0;;1,0;;;;;;;;;;1,0;;;;;;;;;;;;;;;;;8,0;1,0;4,0;1,0;6,0;1,0;;;47,0;;;;;;;1,0;;;;;;;;2,0;;;;;;5,0;;;;;;;;;;2,0;;;9,0;;;9,0;;;7,0;;;;;;;1,0;;;;;;;;1,0;5,0;4,0;;;;;;;;1,0;;;;;;;;1,0;;;;;;1,0;;;;;;;;;29,0;;;;;;1,0;;15,0;;;;1,0;3,0;;;;;1,0;;1,0;;;;;2,0;;3,0;;;15,0;;;;;;;;;;1,0;;;;;48,0;;3,0;;4,0;;;;;1,0;;;;;;2,0;;5,0;;9,0;;;;1,0;;;;;;;6,0;;7,0;;;;;;;;1,0;;;;4,0;;;;;;;1,0;;;;;;1,0;;;;2,0;;;;;;;;6,0;;;;;;1,0;;;;;;1,0;;;1,0;;;2,0;;;;;;;;;;;;;;8,0;;;;;3,0;;;;;;;;;1,0;;;;;2,0;;;;;;;;;1,0;;;;5,0;;;;;;;;;;;;;9,0;;2,0;;4,0;3,0;;;8,0;;5,0;;1,0;5,0;;;;;;;;;;;;;;;1,0;;;1,0;;;;;;;;;1,0;;;;;;;;1,0;;5,0;1,0;;;;;;7,0;;;;;1,0;;;;8,0;1,0;;;;;;;;2,0;;;;;;;;;;;3,0;;;;;;;;;;2,0;;;;;;;2,0;;;1,0;;;;;;;;;;;1,0;;;;;;;;14,0;;;;;;;;;;4,0;;;
reflective;;;;1,0;;43,0;10,0;11,0;;;;3,0;;15,0;;;19,0;;1,0;1,0;;;1,0;;;;;36,0;;;60,0;3,0;1,0;;1,0;9,0;;4,0;3,0;1,0;1,0;51,0;;;11,0;19,0;;142,0;;;3,0;;10,0;5,0;5,0;1,0;12,0;;;2,0;1,0;;12,0;;43,0;;35,0;2,0;2,0;;;37,0;137,0;1,0;;1,0;20,0;;1,0;;33,0;;4,0;3,0;8,0;21,0;;18,0;;3,0;;3,0;8,0;;;;2,0;27,0;60,0;1,0;97,0;;23,0;;;26,0;;;1,0;;;;9,0;;;;;;6,0;40,0;;2,0;8,0;;;;35,0;;;;1,0;;;13,0;;;17,0;;;;;1,0;;;3,0;1,0;;8,0;1,0;2,0;;5,0;21,0;3,0;;;;6,0;;;1,0;19,0;;;;;35,0;10,0;;;1,0;;44,0;15,0;;17,0;;7,0;5,0;;;;1,0;2,0;;4,0;7,0;;13,0;2,0;;;;;;;22,0;14,0;1,0;;;37,0;;;1,0;;4,0;1,0;139,0;17,0;16,0;;1,0;3,0;;3,0;;2,0;;5,0;8,0;;;;3,0;2,0;16,0;;;6,0;;;1,0;;1,0;;73,0;5,0;;3,0;;;1,0;;;5,0;;5,0;17,0;3,0;;;;12,0;8,0;;2,0;556,0;3,0;1,0;;7,0;;1,0;;;2,0;;;2,0;;1,0;2,0;11,0;1,0;;1,0;55,0;;;9,0;;9,0;;17,0;;;4,0;;;;4,0;;;;;;4,0;;;;;1,0;;;;;;;4,0;;;;;;;;1,0;1,0;12,0;6,0;12,0;8,0;1,0;1,0;1,0;;;;;;;5,0;;;;;;;;1,0;3,0;;;1,0;;15,0;;;;;;;1,0;3,0;;;1,0;1,0;;5,0;;2,0;;;;;;;;;;;3,0;26,0;5,0;;;;;18,0;;;2,0;;19,0;;;;;;;;;2,0;1,0;;3,0;1,0;;;12,0;1,0;;;;;1,0;;24,0;1,0;18,0;;1,0;2,0;;;;;;;;;;;10,0;;5,0;;;2,0;;3,0;;;;;5,0;;;;6,0;;2,0;;;;;5,0;;;;;;;;;;;2,0;;3,0;;;22,0;;;;;;;4,0;;;4,0;;7,0;;;;12,0;;4,0;;2,0;;;6,0;5,0;;;;1,0;3,0;1,0;;4,0;;;;;1,0;;;;1,0;;;;;;;2,0;;;;;;;;1,0;1,0;;;;;6,0;;;;1,0;;;21,0;1,0;;9,0;;;;;;;5,0;;;;;;;1,0;;;;;;;;;;;;;;;;19,0;;;;;;;;3,0;;;;;;;;7,0;3,0;;2,0;;;;;;;;;;;;;;;;;;1,0;;;;4,0;;;;;;;1,0;;;;;;;;;;;;1,0;;;;;;;;10,0;;;;;;1,0;;;;;9,0;;;;;;;;;;;;;9,0;3,0;;;;;;1,0;;;;;3,0;;7,0;;;;;;1,0;;;;;;;;;;;;;;;;3,0;2,0;;1,0;;;;;;3,0;1,0;;;;;;2,0;4,0;1,0;;;3,0;;;;;;;;1,0;;;;;;;2,0;;11,0;;27,0;;1,0;;;1,0;;;;;;;;6,0;1,0;;;;3,0;;;22,0;;;1,0;;;3,0;;;;;;;;;;;5,0;1,0;;;6,0;;;;;;;;;;;;1,0;;;;;;;;;;;;;;;3,0;;;;;51,0;;;;;;;;1,0;;;;;7,0;;;;;;1,0;;;;;;;;;;;;;;;;;;;;;;;;;;;;4,0;;;;;;3,0;;;;;;;;;;4,0;;;;;;;;;;;;;;;;;;;;;;;;;;;;;;;;;;;;1,0;;;;;;;;;;;;;;;;;;;;;;;;;;4,0;;;;;;;;;;;;;;9,0;;;;;;2,0;;;;1,0;;;;;;;;;;1,0;;;;;;;;;;;;;;;;;;;11,0;;;;;;;;;;1,0;;;
refractive;;;;6,0;2,0;3,0;8,0;10,0;;;;;;5,0;;;2,0;;;;;;;;;;1,0;136,0;;36,0;6,0;;13,0;;;3,0;2,0;1,0;;;1,0;5,0;;;;7,0;;233,0;;7,0;;;;;1,0;19,0;9,0;;;3,0;6,0;;234,0;;61,0;;40,0;;;2,0;20,0;1459,0;41,0;;10,0;;75,0;;;;8,0;5,0;;;25,0;;;81,0;;13,0;;;6,0;1,0;;;3,0;1,0;37,0;8,0;10,0;2,0;43,0;;;1,0;;;4,0;;;;22,0;;;;;1,0;3,0;24,0;;;;;3,0;3,0;39,0;2,0;;2,0;2,0;2,0;;32,0;3,0;;1,0;;13,0;;;11,0;;;29,0;1,0;10,0;24,0;1,0;;;5,0;6,0;1,0;;;;10,0;;;;;;;;;2,0;5,0;;;;;1,0;1,0;2,0;;;1,0;;;;;;10,0;;16,0;2,0;;;3,0;;;;2,0;;2,0;;9,0;;;1,0;25,0;;;;6,0;6,0;13,0;4,0;3,0;3,0;;;;;;;;2,0;11,0;1,0;;;;;;8,0;;;;;;17,0;3,0;2,0;;1,0;3,0;;14,0;;;;;;;8,0;27,0;149,0;;;;;13,0;13,0;;7,0;191,0;2,0;;;;;;4,0;2,0;;13,0;;4,0;;;2,0;;;;;1,0;;;;;13,0;;;;;2,0;;;;;;;;;4,0;;;;;;;;;;;;5,0;20,0;;;;;;;6,0;;;;;72,0;;;;1,0;;;1061,0;;;;;;;;;;;;;;;;;;;;;;;;;2,0;;;2,0;10,0;;6,0;;;;;;;;1,0;;;;;;4,0;14,0;6,0;;;;;2,0;;;4,0;;;;6,0;;;;;;3,0;;3,0;;;;;;3,0;;;;3,0;;;;;;;;;;;;;;;;;;;;;;;;;;;;;;;;;;;9,0;2,0;;;;;;;;;;;;1,0;;;;;;2,0;3,0;2,0;;3,0;;;;;;;;;;11,0;;;;;;;;;;4,0;3,0;;1,0;;8,0;;;;1,0;;;9,0;;;;;;;;;;;;;;;;3,0;;;1,0;;;7,0;;;;;;;;;;;3,0;1,0;;;;5,0;;;;;;;;;;;;;;;;;;;;;;;;;;;;;;;;;;;;;;;;;1,0;;;;;9,0;;;;;;;;;;2,0;;;;2,0;;;;;;;;;;;;;;;;;;1,0;;;;;;;;;;;1,0;;;;1,0;;;;;;;;;;;;;;;;2,0;;;;;;;;;;;;;;3,0;;;;;;;;;;;;;;1,0;;;;;;;;4,0;;;;;;;;;;;;1,0;;;;;4,0;;;;;;;;;;;;;;;;;;;;;;;2,0;6,0;;;;;;;;;;;;;;;11,0;;;;2,0;;1,0;;;;;1,0;;;;;;;;;6,0;72,0;;;;;;3,0;;;;;1,0;;;;;;;;;;;;;;;;;;14,0;;;;;;;;;;;;;;;;;;;;;;;;;;;;;;;;4,0;;;;;;;;;;2,0;;;;;;;7,0;;12,0;;;;;;;;;;;;1,0;;;;;1,0;;;;;;;;;;;;;;;;;;;;41,0;;;;;;;;;;;1,0;18,0;;;;;;;;;;;;;;;;;;;;;;;;;;;;;;;;;;;;;;;;;;;;;;;;;;;;;1,0;;;;;;;14,0;;;;;;;;;121,0;;;;;;;;;;;2,0;;;;;;;;;;;;;;;3,0;;;23,0;;;;;;;;15,0;;;;;;;;;
relationship;;;;4,0;2,0;14,0;32,0;3,0;;;;;;60,0;1,0;2,0;24,0;2,0;9,0;;;3,0;22,0;;2,0;;2,0;7,0;2,0;4,0;11,0;4,0;;2,0;;57,0;50,0;3,0;22,0;1,0;60,0;35,0;;1,0;7,0;11,0;;6,0;;;8,0;;;;13,0;30,0;1,0;;;12,0;;1,0;15,0;;198,0;;10,0;;;;8,0;51,0;13,0;;12,0;13,0;7,0;2,0;;;44,0;;;18,0;6,0;8,0;;13,0;2,0;7,0;14,0;1,0;;;;;61,0;55,0;50,0;29,0;30,0;37,0;;;4,0;8,0;7,0;2,0;6,0;;2,0;23,0;1,0;5,0;;;5,0;5,0;2,0;26,0;4,0;;13,0;8,0;;10,0;38,0;;;;23,0;1,0;;19,0;8,0;;12,0;14,0;19,0;;;1,0;;;9,0;2,0;12,0;12,0;2,0;7,0;;24,0;1,0;1,0;;;;;;;;5,0;6,0;;;19,0;1,0;1,0;;1,0;;3,0;;11,0;;;;1,0;;;3,0;;;5,0;;;;;10,0;;8,0;;;4,0;;;3,0;;4,0;;;;7,0;;4,0;3,0;25,0;;;15,0;1,0;1,0;5,0;3,0;;2,0;9,0;16,0;;1,0;16,0;3,0;;;;5,0;10,0;;;1,0;;8,0;5,0;;;6,0;1,0;;;12,0;;;5,0;;1,0;31,0;2,0;;6,0;;;;30,0;13,0;2,0;1,0;7,0;23,0;7,0;;;;;23,0;;;;;3,0;;;4,0;;2,0;1,0;;;14,0;8,0;2,0;;;7,0;;;;;;1,0;;11,0;;;;1,0;2,0;34,0;2,0;;;;;;2,0;;4,0;;;6,0;20,0;;;;;2,0;;2,0;;4,0;;;50,0;1,0;;1,0;;;;;1,0;;;12,0;;5,0;;;1,0;;;;;2,0;;;5,0;5,0;59,0;;;1,0;;;;4,0;;1,0;4,0;7,0;2,0;;;;;;6,0;4,0;;;;;;38,0;2,0;11,0;6,0;;;2,0;3,0;10,0;62,0;1,0;8,0;;8,0;;11,0;3,0;;1,0;2,0;5,0;7,0;;18,0;;8,0;8,0;7,0;;4,0;;13,0;17,0;29,0;;1,0;8,0;;;1,0;;;;14,0;;2,0;2,0;;;10,0;;2,0;1,0;7,0;;2,0;;;;;;;15,0;;7,0;2,0;2,0;;4,0;1,0;;7,0;4,0;1,0;7,0;;12,0;;1,0;7,0;;2,0;;;1,0;37,0;;2,0;14,0;;2,0;2,0;;;6,0;;;4,0;;2,0;4,0;;;;;2,0;6,0;;3,0;4,0;;2,0;;;3,0;17,0;;3,0;106,0;;6,0;8,0;;;11,0;;;;7,0;;;;8,0;;1,0;;;;;9,0;;;5,0;;;;1,0;;5,0;;;;5,0;;;;;;;;1,0;2,0;13,0;;;;23,0;4,0;;;;;;1,0;;;;2,0;;2,0;4,0;2,0;;4,0;;;;;3,0;;;;1,0;;11,0;;3,0;;;;4,0;;8,0;2,0;;;2,0;;;;;;;;16,0;;;;;;;;;3,0;;;1,0;;10,0;4,0;;23,0;;;3,0;;3,0;1,0;;;40,0;1,0;;;;;;;;;5,0;1,0;;;;2,0;;;;;;;;;;1,0;5,0;;;4,0;;2,0;;;;;;;2,0;;1,0;;;;;;;;;;;5,0;2,0;;;;4,0;;10,0;;;;1,0;4,0;;8,0;10,0;;;;;;;;1,0;;;;;;;;;5,0;;2,0;;;1,0;;6,0;4,0;2,0;1,0;;;;1,0;;;;;;;;;;4,0;;;;;;3,0;;;7,0;4,0;;;;1,0;43,0;;;;1,0;1,0;;;;;;;;;;;;;2,0;;;;;;;4,0;;;;;;;;;;;10,0;;5,0;;;;;;;;;;;;1,0;5,0;;1,0;1,0;;;2,0;3,0;;;;19,0;5,0;;;;;;10,0;;;;;4,0;19,0;;12,0;;;2,0;;1,0;;;1,0;;146,0;;;;;;;;;;;2,0;;;11,0;;;;;;2,0;;;3,0;1,0;;5,0;;1,0;;3,0;;;10,0;;2,0;;1,0;;;;;;;;;;;;;3,0;7,0;;4,0;;3,0;1,0;;;1,0;;;;;;;;;2,0;;;;2,0;;;;;;;;;;;;;;;2,0;;;;;;;;;5,0;;;;;;;4,0;;1,0;2,0;;;;;;4,0;;;;1,0;;7,0;;4,0;1,0;;;;;;;;;;;;;;;1,0;;6,0;1,0;1,0;;;;;;;;;1,0;;;;;;3,0;;;2,0;;;;;;16,0;;;1,0;;1,0;;;;;;;1,0;;
remove;;;;3,0;8,0;10,0;8,0;13,0;;;;;4,0;24,0;;8,0;22,0;;5,0;;;;8,0;;3,0;;;63,0;2,0;2,0;30,0;;2,0;2,0;;33,0;1,0;;8,0;;15,0;46,0;1,0;4,0;20,0;5,0;14,0;15,0;;12,0;8,0;;7,0;;2,0;2,0;11,0;;12,0;8,0;4,0;;4,0;;140,0;;44,0;1,0;9,0;;1,0;97,0;7,0;;;;13,0;1,0;6,0;6,0;70,0;;1,0;17,0;27,0;;;11,0;1,0;1,0;1,0;;;2,0;;;26,0;3,0;15,0;21,0;24,0;14,0;1,0;9,0;4,0;4,0;;;3,0;;3,0;;54,0;7,0;5,0;;;7,0;27,0;11,0;2,0;;29,0;1,0;1,0;5,0;44,0;;8,0;;9,0;;;16,0;;;7,0;7,0;1,0;;;4,0;1,0;;4,0;7,0;14,0;2,0;7,0;11,0;;4,0;15,0;7,0;;4,0;;3,0;;;1,0;16,0;7,0;3,0;1,0;4,0;;25,0;;2,0;;;13,0;1,0;;12,0;7,0;1,0;6,0;;1,0;;6,0;9,0;8,0;13,0;10,0;9,0;27,0;13,0;6,0;1,0;3,0;;4,0;2,0;14,0;2,0;1,0;19,0;8,0;30,0;;;2,0;2,0;40,0;1,0;;19,0;1,0;;24,0;;;5,0;2,0;;;2,0;3,0;2,0;3,0;1,0;2,0;2,0;74,0;4,0;7,0;;;;3,0;2,0;3,0;;;1,0;;;;1,0;7,0;;;;5,0;12,0;5,0;5,0;1,0;;2,0;3,0;6,0;;1,0;18,0;;;;;;10,0;2,0;25,0;;;3,0;15,0;;2,0;2,0;4,0;6,0;;6,0;7,0;;2,0;3,0;;1,0;9,0;2,0;;5,0;1,0;11,0;2,0;1,0;1,0;;2,0;;;4,0;1,0;5,0;;4,0;2,0;1,0;10,0;;1,0;3,0;2,0;;1,0;;;;;1,0;7,0;;4,0;1,0;6,0;8,0;34,0;2,0;1,0;;;;1,0;;2,0;2,0;;3,0;3,0;;;1,0;;;;7,0;8,0;;2,0;;5,0;3,0;6,0;;;;;3,0;;;1,0;;;36,0;;3,0;;;;;1,0;;10,0;;1,0;;;;2,0;7,0;1,0;2,0;;1,0;;13,0;;;3,0;3,0;22,0;2,0;2,0;;;;;2,0;;;2,0;;4,0;2,0;;;4,0;4,0;7,0;;7,0;13,0;7,0;36,0;;;9,0;1,0;2,0;12,0;1,0;;;;;;;;;1,0;1,0;;8,0;3,0;3,0;;;;1,0;2,0;;4,0;4,0;1,0;;2,0;1,0;14,0;1,0;3,0;2,0;1,0;;20,0;8,0;;23,0;1,0;;;2,0;;2,0;;;4,0;;;;;;1,0;;1,0;;;1,0;7,0;4,0;;;3,0;2,0;7,0;1,0;3,0;;;2,0;1,0;5,0;12,0;;;5,0;;;5,0;2,0;;;2,0;1,0;2,0;;;5,0;2,0;;;;7,0;;;2,0;;1,0;;8,0;;;5,0;4,0;2,0;;7,0;9,0;;;;;5,0;;15,0;;;;;;;1,0;1,0;1,0;8,0;12,0;;;;9,0;;6,0;;;3,0;4,0;;;;3,0;;2,0;;;;;4,0;;5,0;;3,0;;3,0;1,0;1,0;;;;;7,0;2,0;4,0;;;;;;1,0;;6,0;;4,0;;;2,0;4,0;;;3,0;;;;;;1,0;1,0;;;;3,0;;2,0;;;;;;;;;;;;;;;2,0;;;3,0;;;;;;1,0;;;4,0;;2,0;;;2,0;;;;;1,0;;;;;7,0;;;;1,0;;;;;;3,0;7,0;1,0;;;1,0;;6,0;;;;3,0;;1,0;1,0;;;;3,0;;;6,0;3,0;;2,0;;2,0;;;;3,0;1,0;;;10,0;;;6,0;1,0;;;2,0;;;;;2,0;4,0;;6,0;;;;1,0;2,0;;;2,0;;;;11,0;;;;2,0;;;;;7,0;;;;;1,0;;14,0;;;;9,0;;2,0;1,0;;2,0;;;6,0;;;;;;;6,0;1,0;;9,0;;;;;;;;;;1,0;;3,0;2,0;;;;;1,0;;2,0;1,0;5,0;2,0;;;3,0;;4,0;;;;;;;;;;;;1,0;;;;1,0;;;;;;3,0;;;;;1,0;;;;1,0;1,0;;;;;;4,0;;1,0;1,0;;5,0;;1,0;;;1,0;;;2,0;;;;;;;;;;;;;;;5,0;1,0;;;;;1,0;;2,0;;2,0;;;;;;;;1,0;;3,0;;;2,0;4,0;5,0;1,0;;6,0;;;2,0;;1,0;;1,0;;;5,0;;;;;;;2,0;;;;;;;;;2,0;;2,0;;;;;;1,0;;;;1,0;2,0;1,0;;;;1,0;;;;;32,0;;;;;;;6,0;;;;;;;4,0;;;;;;;;;;;1,0;;;;;;;;1,0;;3,0;;;;;;;;;;;3,0;2,0;1,0;;;1,0;;;13,0;;;;2,0;;;7,0;;;;;;;;;;;
render;;;;7,0;5,0;7,0;3,0;1,0;5,0;;;;;80,0;;;44,0;;3,0;;1,0;;19,0;;;;;17,0;9,0;12,0;55,0;12,0;9,0;7,0;;74,0;6,0;;60,0;1,0;66,0;95,0;;1,0;118,0;;;12,0;;2,0;5,0;;;;32,0;1,0;8,0;;;40,0;;;;1,0;324,0;5,0;63,0;2,0;2,0;;;5,0;3,0;;;;3,0;;2,0;1,0;110,0;;3,0;56,0;9,0;;2,0;4,0;;4,0;8,0;1,0;;;5,0;;24,0;14,0;55,0;77,0;41,0;1,0;;49,0;24,0;42,0;1,0;11,0;4,0;;;7,0;12,0;;;;19,0;15,0;125,0;6,0;15,0;;7,0;5,0;;11,0;75,0;;;;26,0;;;7,0;;;84,0;87,0;;;;;3,0;;;1,0;15,0;;16,0;;;1,0;1,0;;;;;;4,0;;9,0;1,0;26,0;;;;;1,0;;;1,0;;4,0;1,0;;3,0;;;2,0;1,0;;;;2,0;;;7,0;10,0;78,0;;;;;3,0;;;;;;1,0;2,0;27,0;;;;2,0;;;;2,0;4,0;1,0;;;;;21,0;4,0;;3,0;4,0;1,0;1,0;;;;46,0;;;14,0;;;1,0;;;2,0;;;;14,0;;;;;;11,0;3,0;;;;;;;2,0;;2,0;;5,0;;;1,0;4,0;;5,0;;;;;;6,0;;;;3,0;;;1,0;1,0;;;;1,0;;;;;;;5,0;;;128,0;;;;;1,0;;;2,0;;;;1,0;;;;11,0;;10,0;;;;;2,0;;;;;;8,0;91,0;;;1,0;;;;;3,0;;;;;1,0;;;;12,0;;;;;;;;124,0;4,0;;2,0;;;9,0;;29,0;1,0;;;99,0;;;;;1,0;;;4,0;;;;;;1,0;;13,0;;;2,0;11,0;;6,0;2,0;;2,0;2,0;11,0;1,0;4,0;;4,0;;23,0;8,0;2,0;;3,0;;13,0;;;;2,0;3,0;1,0;;18,0;5,0;2,0;8,0;1,0;;;;4,0;12,0;22,0;;2,0;;15,0;;;;;1,0;34,0;4,0;7,0;1,0;;;1,0;1,0;3,0;;;4,0;1,0;6,0;;;4,0;4,0;;;1,0;;;37,0;;9,0;6,0;;;;;;7,0;;4,0;15,0;;;12,0;1,0;3,0;1,0;6,0;;;11,0;;6,0;19,0;;;;;1,0;2,0;;3,0;38,0;2,0;1,0;;25,0;11,0;7,0;10,0;;1,0;;;;;30,0;13,0;;;10,0;6,0;4,0;1,0;;;;;4,0;;3,0;;;;;2,0;1,0;4,0;;;2,0;;;;;;;;;2,0;;3,0;;;;;;2,0;3,0;;;;;;8,0;;;;;;;;;;11,0;;1,0;1,0;;;;;;;11,0;2,0;3,0;15,0;;;;1,0;;;;;;;;;;;;;;;;;3,0;2,0;1,0;1,0;;;;1,0;20,0;;41,0;;;3,0;;6,0;6,0;4,0;;;;;;3,0;2,0;;3,0;;1,0;;2,0;;1,0;;2,0;1,0;;1,0;;;;;;;;2,0;;;;;;7,0;;7,0;;;;;;;;1,0;;;;4,0;2,0;3,0;18,0;3,0;;10,0;;5,0;21,0;;4,0;;;;1,0;;6,0;;;;1,0;3,0;;;5,0;2,0;;2,0;;5,0;;21,0;;;;;;;2,0;1,0;;;1,0;;;;;;;;;;;;;7,0;;;;;;1,0;;;;;;;;;2,0;;;;;3,0;;;;;3,0;;;;;;1,0;;;1,0;;;12,0;;;;;;;;;;;4,0;;;;;;;;;;;;;;;3,0;;;;;;1,0;;;;;2,0;2,0;2,0;;;;;;;;;;;1,0;;;;;;;1,0;;;;;4,0;3,0;;;;;;1,0;;;;;;6,0;;;;24,0;;1,0;;;3,0;;;;;;;;;;;6,0;;;;;;2,0;;;1,0;;1,0;;1,0;;32,0;3,0;;;;;;;;;;2,0;;;2,0;;4,0;;;;;;1,0;1,0;;;;;;;;;;;4,0;;1,0;;21,0;;;;;;;;2,0;;7,0;;;;;1,0;;5,0;1,0;;;2,0;1,0;;;;;;;;;;;1,0;;;;;;1,0;;;;;;2,0;;;;;;;;;;;;;;;;;;;;;;;;;;;1,0;;;;;;;;;;3,0;70,0;;;;;;1,0;14,0;4,0;;;3,0;;;;;;;;;;;
repeat;;;;6,0;;2,0;3,0;1,0;;;;;;1,0;;4,0;15,0;;;;;;6,0;;1,0;;;;1,0;1,0;7,0;7,0;;;;10,0;3,0;;2,0;;29,0;5,0;;3,0;2,0;;;4,0;;8,0;5,0;;;;;;;;;7,0;1,0;;;;61,0;;14,0;4,0;4,0;;4,0;10,0;8,0;3,0;;;;;2,0;2,0;37,0;;1,0;5,0;11,0;;;2,0;;3,0;8,0;1,0;;;2,0;;12,0;;24,0;6,0;5,0;6,0;;8,0;;2,0;;1,0;;;;1,0;6,0;;;;2,0;5,0;5,0;11,0;2,0;;;;1,0;5,0;12,0;;2,0;1,0;19,0;;;22,0;;;6,0;2,0;;;;;3,0;;1,0;2,0;7,0;6,0;;2,0;;1,0;2,0;;1,0;;;;;;;;;1,0;;;3,0;1,0;2,0;;;;1,0;2,0;;4,0;;1,0;;;;;1,0;;;;3,0;;7,0;;;;;;;;;;;;;;;;3,0;;;;;1,0;3,0;1,0;;;;;1,0;;2,0;;16,0;3,0;2,0;;;;1,0;;;2,0;;;1,0;3,0;;;;;;4,0;;2,0;;;;1,0;;2,0;;;;;;2,0;;;1,0;3,0;;;7,0;;;9,0;;;;;1,0;;;;;;;;1,0;3,0;;;;;1,0;;3,0;;;;2,0;;;;;;3,0;;5,0;;;;;;;;;;;;;6,0;;;;;;;2,0;;1,0;;1,0;3,0;;1,0;;;;;;;;;;;3,0;;;;;;;;;;;;2,0;;;;;;5,0;2,0;;;1,0;;5,0;1,0;;;;3,0;;4,0;5,0;;;;;;;;5,0;1,0;;;4,0;2,0;7,0;;10,0;;2,0;6,0;6,0;1,0;;;2,0;1,0;1,0;2,0;;5,0;;1,0;3,0;;;7,0;;;;1,0;;3,0;;;;5,0;3,0;5,0;9,0;3,0;;;;;;4,0;;;;2,0;;4,0;;;;;2,0;;;;1,0;;;;;;8,0;;;;;;2,0;;;;;;;;;5,0;;2,0;6,0;;;3,0;;;;;3,0;;;1,0;4,0;2,0;;;;;3,0;;;1,0;;2,0;;;5,0;;;3,0;1,0;;;;;;;;;;;;;;;1,0;;1,0;;;;3,0;1,0;;;;;1,0;;;;;;;2,0;;;;1,0;;;;;;;;2,0;;1,0;;;;;1,0;;;;;;;;;;2,0;;;;;;;;;;;;;3,0;;;1,0;;;;;1,0;;;;;;;;;;;;;;;;;;;4,0;;;;;;;;1,0;;3,0;;;;;;1,0;;;;;;;;;;;;;;2,0;;;;;;;;;;1,0;;;;;;;;;;;;;;;;;;1,0;;;;3,0;;;3,0;;;;;1,0;1,0;;;2,0;;;6,0;;;;2,0;;;;;;;2,0;;;;1,0;;1,0;;;;;;;;;3,0;;;;;;;;1,0;;;;;1,0;;;;;;3,0;;;;1,0;;;3,0;;1,0;;;;;;;;;;2,0;;;;;;;;;;;;;;;;;;;;;;;;;;;;;;;;;;;;;;;;;;;;;;;;;;;;1,0;;;;;;1,0;;;;;;;;1,0;;;;;2,0;;;4,0;;;;;;3,0;3,0;;;;;;1,0;;;;;;;;;;;2,0;;;;;1,0;;;;;;;1,0;;;;;;;5,0;;;4,0;;1,0;;;;;4,0;;;;;;;;;;;1,0;;;1,0;1,0;2,0;;;;1,0;;;;2,0;3,0;;;;;;;1,0;;;;;;;1,0;;1,0;;1,0;;;1,0;;;;;;1,0;;;;;;;;;;;;;;;2,0;;;;;;;;;;;;;;;;;;;;;;2,0;;;;;;;;;;;1,0;;;;;;1,0;;6,0;3,0;;;;;;1,0;;;;;;3,0;;3,0;;;;;;;;;;;;;;1,0;
represent;;;;1,0;46,0;14,0;7,0;15,0;1,0;;1,0;4,0;;71,0;;4,0;116,0;;18,0;5,0;;6,0;64,0;;3,0;;2,0;19,0;9,0;37,0;46,0;1,0;4,0;29,0;;385,0;15,0;12,0;41,0;5,0;93,0;97,0;1,0;8,0;149,0;3,0;12,0;62,0;14,0;6,0;19,0;;4,0;3,0;35,0;97,0;7,0;;1,0;94,0;;1,0;161,0;;730,0;1,0;77,0;1,0;4,0;1,0;103,0;228,0;96,0;2,0;13,0;1,0;20,0;23,0;4,0;10,0;88,0;1,0;4,0;51,0;6,0;;;45,0;;6,0;37,0;3,0;6,0;;26,0;7,0;197,0;16,0;123,0;130,0;204,0;6,0;4,0;20,0;21,0;20,0;11,0;5,0;8,0;8,0;;23,0;77,0;2,0;;3,0;15,0;53,0;160,0;34,0;14,0;;144,0;5,0;1,0;39,0;54,0;6,0;1,0;27,0;46,0;24,0;;45,0;4,0;;78,0;62,0;5,0;1,0;;16,0;1,0;4,0;10,0;11,0;33,0;4,0;36,0;;4,0;38,0;7,0;;1,0;;;;25,0;68,0;;;23,0;;1,0;;;5,0;;10,0;2,0;15,0;7,0;49,0;;16,0;;1,0;;;5,0;;2,0;17,0;;;13,0;6,0;76,0;6,0;4,0;;;;1,0;2,0;2,0;17,0;8,0;;;;;;20,0;7,0;13,0;3,0;14,0;2,0;5,0;11,0;6,0;;;1,0;47,0;22,0;36,0;32,0;37,0;14,0;6,0;;;;143,0;;;14,0;;14,0;35,0;15,0;5,0;3,0;8,0;4,0;;;1,0;15,0;1,0;;;27,0;;10,0;13,0;1,0;2,0;;;56,0;11,0;;1,0;55,0;1,0;;1,0;32,0;;28,0;1,0;;;16,0;4,0;1,0;;;;3,0;;;6,0;67,0;;;;1,0;37,0;;2,0;;;;5,0;1,0;3,0;;;;;4,0;97,0;;2,0;;;;;2,0;;;2,0;5,0;8,0;36,0;;;;;2,0;1,0;5,0;;3,0;;10,0;259,0;3,0;5,0;1,0;10,0;1,0;;1,0;;;;;;12,0;;;;;;;27,0;4,0;;;;40,0;21,0;3,0;;;;2,0;;47,0;;;;130,0;;;9,0;2,0;1,0;;20,0;1,0;2,0;;;;;19,0;11,0;41,0;1,0;;19,0;6,0;8,0;42,0;93,0;1,0;34,0;15,0;35,0;3,0;18,0;13,0;27,0;;3,0;2,0;40,0;;37,0;4,0;39,0;8,0;;;13,0;;17,0;4,0;84,0;;6,0;75,0;2,0;;25,0;8,0;10,0;5,0;27,0;;;;3,0;1,0;;3,0;6,0;;59,0;17,0;7,0;1,0;;5,0;;10,0;6,0;26,0;;7,0;43,0;2,0;;8,0;22,0;13,0;6,0;2,0;6,0;6,0;;72,0;;10,0;3,0;;;;;;4,0;4,0;21,0;6,0;9,0;2,0;;12,0;14,0;;1,0;;;2,0;16,0;4,0;38,0;3,0;;;21,0;;3,0;;8,0;16,0;17,0;;9,0;5,0;25,0;9,0;44,0;12,0;;2,0;26,0;;3,0;13,0;;;;2,0;20,0;1,0;22,0;34,0;28,0;3,0;;;1,0;54,0;13,0;;;1,0;7,0;;11,0;;;;;;16,0;;;;;;;1,0;4,0;;;26,0;;8,0;4,0;;18,0;;9,0;1,0;2,0;6,0;;;3,0;;7,0;;;18,0;14,0;;4,0;;12,0;1,0;28,0;;3,0;2,0;5,0;4,0;6,0;27,0;;;4,0;1,0;;;;2,0;7,0;16,0;;;;2,0;;10,0;;;1,0;;6,0;6,0;24,0;;6,0;7,0;3,0;;;;15,0;21,0;;21,0;;1,0;30,0;6,0;7,0;;2,0;;;;1,0;3,0;2,0;3,0;;3,0;;7,0;;;;24,0;18,0;;;;;;10,0;;;;2,0;;;1,0;;2,0;3,0;;;;;3,0;6,0;;1,0;;;;1,0;4,0;1,0;12,0;;16,0;1,0;16,0;6,0;;1,0;1,0;;9,0;;4,0;1,0;;;15,0;;1,0;5,0;;12,0;;;76,0;2,0;29,0;;;2,0;;3,0;;;;;;;1,0;;2,0;;;7,0;;;;;;2,0;5,0;;5,0;;;7,0;;;;6,0;;28,0;;;5,0;6,0;;5,0;;6,0;;;4,0;;6,0;6,0;;;2,0;21,0;10,0;;;1,0;10,0;;3,0;;6,0;;;13,0;1,0;1,0;;2,0;;;;;;;1,0;2,0;;1,0;1,0;;;;;;;;19,0;1,0;;;5,0;2,0;;;;;;;2,0;;1,0;12,0;;7,0;;14,0;;;;;2,0;;;;2,0;1,0;;;;;;8,0;;8,0;;;23,0;69,0;6,0;1,0;1,0;;;3,0;3,0;11,0;6,0;11,0;;6,0;;;10,0;15,0;4,0;8,0;16,0;;;;2,0;1,0;3,0;23,0;;1,0;;;;1,0;;;;;2,0;;;1,0;2,0;;2,0;3,0;10,0;3,0;15,0;4,0;;2,0;13,0;4,0;;1,0;3,0;4,0;8,0;2,0;;;4,0;5,0;25,0;5,0;;4,0;;2,0;8,0;4,0;1,0;;;6,0;;;;;;22,0;7,0;;;2,0;;10,0;;;;;;;;1,0;1,0;1,0;14,0;13,0;;;;3,0;;2,0;;;;1,0;;3,0;4,0;;;;17,0;9,0;3,0;5,0;1,0;30,0;;;;6,0;;;;;;;;4,0;2,0;;4,0;;2,0;14,0;;;7,0;;;;1,0;;;;2,0;10,0;;;;;5,0;;;;4,0;;3,0;;;;8,0;;;13,0;;1,0;;;4,0;1,0;21,0;3,0;;;2,0;3,0;15,0;3,0;;9,0;;;;;;
representation;;;;9,0;2,0;9,0;9,0;;;;;16,0;;54,0;;;56,0;1,0;6,0;6,0;;;59,0;;;;;4,0;4,0;4,0;35,0;;39,0;2,0;;136,0;5,0;;27,0;2,0;88,0;74,0;;58,0;111,0;2,0;2,0;6,0;;10,0;;;;;56,0;;20,0;;14,0;75,0;;;5,0;;368,0;;181,0;;;;;19,0;14,0;;30,0;;1,0;3,0;1,0;19,0;74,0;;7,0;12,0;1,0;;;31,0;;2,0;6,0;;1,0;;;;36,0;5,0;41,0;38,0;32,0;9,0;;5,0;17,0;16,0;6,0;3,0;;;;10,0;16,0;4,0;;1,0;5,0;11,0;106,0;17,0;2,0;;12,0;11,0;18,0;29,0;62,0;;;;15,0;;;8,0;;;57,0;27,0;8,0;;;;1,0;1,0;;11,0;18,0;;25,0;1,0;;;2,0;;1,0;;;;;;;4,0;8,0;1,0;;;;;;;2,0;;;9,0;;12,0;;;1,0;;;;;12,0;;;5,0;;4,0;;;1,0;;;;;;;2,0;6,0;;;;;6,0;1,0;6,0;;;1,0;3,0;2,0;;;;;4,0;5,0;3,0;3,0;8,0;7,0;4,0;;;;23,0;;;4,0;;;6,0;3,0;;1,0;;;;16,0;;;;;;15,0;2,0;6,0;;;;;;6,0;;;;29,0;;;1,0;;3,0;4,0;;;;;;;;;;;;;3,0;1,0;;;;;1,0;;;;;;7,0;;3,0;;;;28,0;;17,0;;;;;;;;;;1,0;;2,0;12,0;;;;;2,0;;8,0;1,0;;;2,0;237,0;1,0;1,0;;;;;3,0;;;;;;;2,0;;;;;3,0;;;;;1,0;;10,0;;;;;7,0;;24,0;;;;51,0;;;;;13,0;;6,0;24,0;;11,0;;;;12,0;1,0;17,0;4,0;2,0;;10,0;;9,0;11,0;1,0;;9,0;39,0;6,0;;2,0;3,0;;1,0;2,0;6,0;;3,0;;14,0;11,0;1,0;;2,0;1,0;29,0;;31,0;;2,0;9,0;;;;;;6,0;11,0;;;;;;18,0;;4,0;;12,0;4,0;21,0;;;;3,0;2,0;;;;6,0;10,0;2,0;;16,0;;;;8,0;6,0;1,0;;42,0;;1,0;;1,0;1,0;;;4,0;1,0;1,0;2,0;31,0;5,0;;4,0;2,0;13,0;;;;;2,0;4,0;5,0;6,0;;;;;;3,0;;4,0;;4,0;;1,0;13,0;52,0;3,0;20,0;;;;10,0;;;24,0;;;;;2,0;;2,0;1,0;;;;;4,0;;;;2,0;;2,0;;4,0;;;;;11,0;2,0;4,0;;;;;;;3,0;;;10,0;1,0;;;;;;1,0;;2,0;;;;;;2,0;;;;18,0;2,0;10,0;;5,0;;;;;;;28,0;;47,0;;3,0;12,0;;;;;7,0;6,0;2,0;;;;;;;2,0;;;;3,0;2,0;1,0;;4,0;;;2,0;;3,0;;24,0;;2,0;1,0;;38,0;;2,0;;1,0;1,0;;7,0;;10,0;1,0;1,0;;5,0;3,0;4,0;;;;2,0;20,0;;;;;;3,0;;;;;;;;2,0;;1,0;2,0;;;;;3,0;;;;;;;4,0;2,0;;;;;;12,0;;11,0;;;;;10,0;;;;;;;;1,0;;;;23,0;2,0;;;;;;1,0;;;;;;;;;4,0;;16,0;;;1,0;;;;;;;;;;;2,0;;;15,0;;;;;3,0;;;;;;1,0;;;;;2,0;;;;3,0;6,0;2,0;2,0;;;;2,0;;;;;;9,0;;;;;;;;;;;;;;;;;;;;;;;;1,0;;;;;;;;;;;;;;;;;4,0;;;;;;;;;;;;;;;;3,0;;;;;2,0;;;;;;;;;;;4,0;;;;;;8,0;;;;;;;6,0;;2,0;;1,0;;;;9,0;;;;;;;;;;7,0;;;;;;7,0;;3,0;;9,0;;;;4,0;;2,0;2,0;;;;;;;;;14,0;;2,0;2,0;;;6,0;4,0;;;6,0;;3,0;9,0;1,0;1,0;;2,0;;;;;1,0;;;;;;72,0;;;2,0;;;;;;;;;;5,0;;;;;3,0;;9,0;;;22,0;;;;;;2,0;;;;;;;;;;;;;;3,0;;;;;3,0;;;;;;;5,0;;;;;;;;;;;1,0;;;;;;;;;;;;;;7,0;;;;;;;;;;;;1,0;;;
reset;;;;2,0;4,0;19,0;6,0;2,0;;;;;;21,0;;1,0;3,0;14,0;7,0;;;;;2,0;1,0;;;;;14,0;69,0;7,0;4,0;2,0;;3,0;6,0;;;;7,0;87,0;;3,0;;5,0;;52,0;;;;;1,0;1,0;;;7,0;;;9,0;;;4,0;;38,0;;28,0;;1,0;;;;12,0;;;;;;;7,0;32,0;;1,0;;7,0;;;;;;2,0;;1,0;;;;116,0;;41,0;1,0;25,0;8,0;;3,0;3,0;10,0;;1,0;;;;8,0;24,0;1,0;;;;2,0;5,0;54,0;;;184,0;6,0;;2,0;22,0;;1,0;;70,0;;;37,0;7,0;;;3,0;;;;;;;;1,0;12,0;4,0;;;;1,0;;;;22,0;;;;;;35,0;;3,0;33,0;;26,0;;;9,0;;;;2,0;;;8,0;;;;;;3,0;;;;1,0;5,0;3,0;;;;;13,0;;;1,0;7,0;;6,0;;1,0;;;;;10,0;;;2,0;;;8,0;;;;18,0;;;;5,0;22,0;;22,0;;;19,0;2,0;;2,0;;;4,0;;2,0;;;;;;;;;;;15,0;1,0;;;1,0;;;;6,0;2,0;26,0;2,0;2,0;;;32,0;6,0;;;;;;;;;;;4,0;;;;2,0;2,0;;;;;;;;;3,0;;26,0;;;;;;;;1,0;;7,0;;;;;;;;;1,0;;52,0;;;;;;;;;;16,0;2,0;4,0;;2,0;;;4,0;;9,0;;;;;;;;4,0;;;;3,0;;4,0;;;;;1,0;;;;;1,0;;;;34,0;;3,0;;;;;;;;;;;;;;4,0;;;;;6,0;7,0;1,0;41,0;;7,0;;;6,0;14,0;3,0;;54,0;;;;1,0;;18,0;;;8,0;;;32,0;8,0;10,0;2,0;6,0;;;;1,0;;;;2,0;2,0;1,0;;;;3,0;;1,0;1,0;25,0;;22,0;;14,0;;;2,0;1,0;;1,0;;;2,0;;27,0;4,0;;2,0;1,0;;;;;;;;;48,0;;;;;;;;;3,0;;11,0;;;;;;;;5,0;3,0;3,0;1,0;;;;;5,0;;;1,0;1,0;2,0;;;3,0;;;;;;;;;;;;;;;;;4,0;;6,0;;;;;;1,0;;;1,0;18,0;;;;;;;;;;2,0;;;;;;;;;;1,0;;;;5,0;;;;;;;;;;;;;;;;26,0;;;;;;10,0;;;;;;;;6,0;;;3,0;;;;;;;;;;;;8,0;;;;;;;;;;;;;;;;;;;3,0;;;;;6,0;55,0;;1,0;;8,0;;;;;;;;;8,0;;;;;;;;;;;1,0;;;;;;4,0;;;;;58,0;3,0;;;;;11,0;;1,0;;2,0;;;;;;;4,0;;18,0;11,0;;;;;;10,0;;;3,0;;1,0;;;;;;;1,0;10,0;;19,0;;;;2,0;4,0;;;2,0;;4,0;;;;;;;3,0;3,0;10,0;;;;;;;;;;9,0;1,0;1,0;6,0;;;;1,0;;;11,0;;1,0;;;;;;;;2,0;;;;;;;;;;;;;;;;;;;;2,0;;;;;;;;;;;;;;;;;1,0;;;;;;;;;;;;1,0;;;;1,0;12,0;;37,0;11,0;;;10,0;;28,0;5,0;;28,0;13,0;10,0;1,0;41,0;48,0;;;6,0;;4,0;14,0;2,0;1,0;;;;2,0;;;;;;;5,0;;;;;4,0;;;352,0;;;;;;;;;;;;;;;;;;;;;;;;4,0;;;1,0;;;;;;;;;;;;3,0;;;;;;;;;;;;;;;;;;;;;;;;;;;;;;;;;;;;;;1,0;;;;;;;;;;;2,0;;;;;;;;40,0;17,0;;;;;;;;;;;;;1,0;;;;;;;;;1,0;;;;;;;;;;;;;;;;;;;;;;;;;;;;;;1,0;;3,0;;;;;;;;;;;;;;;;;
reverse;;;;5,0;;19,0;;19,0;;;;;1,0;28,0;;;3,0;;34,0;1,0;;;;;;;;4,0;;;17,0;14,0;;1,0;1,0;27,0;2,0;12,0;;;11,0;13,0;;2,0;22,0;;1,0;3,0;;;;;;;;;2,0;12,0;1,0;2,0;;;;;35,0;;13,0;;;;;7,0;2,0;1,0;;11,0;;;;;7,0;;38,0;;7,0;9,0;;6,0;;;;;;;;;9,0;;1,0;4,0;20,0;2,0;;3,0;;6,0;;;;;2,0;4,0;;;;;;;;5,0;;;72,0;;;3,0;12,0;;;;1,0;;2,0;19,0;;4,0;4,0;;1,0;;;;;;;19,0;1,0;1,0;24,0;;9,0;2,0;;2,0;;;;;;;2,0;2,0;;1,0;;;3,0;;;1,0;3,0;;;73,0;;;;;6,0;;;12,0;;;3,0;;;;1,0;;;;;;;;4,0;;;;;;1,0;;;;8,0;;1,0;4,0;12,0;18,0;;;;;25,0;;;3,0;;4,0;;;;2,0;5,0;;;;1,0;;3,0;1,0;5,0;;;;;;;;;;;;9,0;30,0;;;;;;8,0;;9,0;;2,0;;;;4,0;;71,0;;2,0;;;;;;;8,0;;1,0;;;3,0;;;;;5,0;;;;1,0;1,0;2,0;;21,0;1,0;;;;;4,0;15,0;;1,0;;;;2,0;;;1,0;;;;;;;;12,0;1,0;;;1,0;1,0;;4,0;13,0;;;;;;;;;;;;;;1,0;;;;14,0;11,0;1,0;2,0;;;;;2,0;;;;1,0;;;;5,0;3,0;12,0;;;;;;;2,0;;1,0;;1,0;;;;1,0;;;;;;;13,0;7,0;;;;9,0;2,0;6,0;;1,0;;1,0;;;44,0;2,0;;;9,0;;;1,0;;2,0;8,0;;4,0;;3,0;1,0;;2,0;;7,0;2,0;2,0;;;;;;;;;;4,0;;1,0;;;4,0;;3,0;;;4,0;;;4,0;6,0;;3,0;;;;;1,0;33,0;;1,0;;9,0;;;;;;;;;;;5,0;;;7,0;;;;;;;1,0;3,0;2,0;;1,0;10,0;;;;;;;;2,0;1,0;;;;;1,0;;3,0;;;2,0;;;;2,0;;;;1,0;2,0;4,0;;;;7,0;;;;;2,0;5,0;2,0;;;;;;;;;;;;;32,0;;;;1,0;;;;;;;;;2,0;;;;;;;2,0;;;2,0;;;;;;;;;;;;;;;;;;;;;;;;;;;;;4,0;;1,0;;;;;;7,0;;3,0;;6,0;;;;;;;;;;;1,0;;;;4,0;1,0;;;1,0;;1,0;;;;;;;;;;;;;;;;;;;;;;1,0;;10,0;;;;;;;;;;;;;;;7,0;;;;;;;;;;;1,0;;;;;2,0;;;;;;;;3,0;;;;;8,0;;;;;;2,0;1,0;;5,0;2,0;;;;;;;;;;7,0;18,0;;;;;;;;;2,0;;;;1,0;;;;;;;1,0;;6,0;;1,0;;5,0;;;;16,0;;;1,0;19,0;;;1,0;3,0;;;;;;;;;;;;;;;;;;;;;;;;;;;;;;1,0;;;;;;;;;;;10,0;;;;1,0;;;1,0;2,0;;;;;;3,0;;;;;;;;;;;;;;;;;;4,0;1,0;;;;;;;;;;;;;;;9,0;;;;;;;;;;;;;;;;;;;;;1,0;;;6,0;3,0;;;;;;;;;2,0;;;;;;;;;;;;;3,0;;4,0;;;;;;;;1,0;;;;;;;;;3,0;;;;;;;;;;;;;;;1,0;;;;1,0;;;;3,0;;;;;;;;1,0;;;;1,0;;;;;;;;;;;;;;;;;;;;1,0;;;;;;;;;;;;;;;;;6,0;;;;;;;;;;;;;;;;;;;;;;;;;;;;;;
road;;;;1,0;5,0;10,0;;;;3,0;;;;62,0;;;26,0;;;1,0;;;1,0;1,0;;;;;5,0;74,0;51,0;2,0;2,0;1,0;;86,0;1,0;;2,0;;44,0;23,0;;3,0;20,0;;;;;;7,0;;7,0;;2,0;;10,0;;;4,0;;;;;115,0;;34,0;1,0;;3,0;3,0;;15,0;;;;;;;;44,0;;;10,0;16,0;1,0;;2,0;;3,0;8,0;1,0;1,0;;;1,0;8,0;13,0;30,0;50,0;27,0;21,0;;6,0;6,0;3,0;;2,0;;;;18,0;9,0;;;;;2,0;5,0;2,0;3,0;;3,0;;;13,0;56,0;;;;1,0;;;34,0;1,0;;2,0;1,0;2,0;;;;;;;;7,0;3,0;27,0;;;;;;;;;;;;;3,0;;3,0;;1,0;1,0;;;9,0;;3,0;;17,0;;3,0;;;;;;6,0;;;;;;;6,0;4,0;;;;;;;;;;;;;3,0;;1,0;;;;;2,0;9,0;1,0;;;;;2,0;9,0;6,0;3,0;35,0;;1,0;;;;5,0;;1,0;3,0;;;2,0;2,0;3,0;1,0;7,0;5,0;;5,0;;;;;;41,0;3,0;15,0;9,0;;;;;2,0;;;;106,0;;;;4,0;;129,0;;;;;;1,0;;;;4,0;;;5,0;37,0;;;;;12,0;;2,0;;;1,0;;;;;;;;;15,0;3,0;;;;;;2,0;;;;;24,0;1,0;;;;;;;9,0;;;;;36,0;;3,0;;;;2,0;1,0;;;;;;;;;;;;;7,0;1,0;;;;10,0;1,0;;;;;;;8,0;;;;9,0;;;;;;;;;;;;;;31,0;;11,0;;;;7,0;;22,0;5,0;;2,0;;46,0;10,0;;1,0;;;1,0;3,0;;4,0;3,0;;19,0;1,0;1,0;;5,0;;2,0;4,0;72,0;1,0;2,0;6,0;1,0;;7,0;;1,0;3,0;1,0;;;;;;;;1,0;;4,0;;2,0;;;;;;;9,0;6,0;;;;;;;1,0;;;;;47,0;25,0;;;;;;;;7,0;8,0;;;6,0;;;2,0;;1,0;1,0;;;;;;1,0;;;;;12,0;;;;10,0;;3,0;;;4,0;;;;11,0;;5,0;9,0;;4,0;4,0;;1,0;;;1,0;1,0;;;;4,0;;;2,0;;3,0;;;;;;4,0;;;3,0;;;;;;;;;;;;;;4,0;2,0;;;;;;;;;;;;;;;;;4,0;;;2,0;;1,0;;;3,0;;;;1,0;;5,0;;;9,0;;;;;;;;15,0;;;;7,0;4,0;;;;;;;;;;;;;;;;12,0;;1,0;;;23,0;;;;;;;;;;;3,0;;;7,0;;3,0;;;;3,0;;;2,0;;;;;;;4,0;;;;;;1,0;3,0;;;;;;;;;;;;;;3,0;;;1,0;;;;14,0;;;;;;;;;8,0;;6,0;43,0;;;;;10,0;;;;;;;2,0;1,0;;;;;;;;;;;6,0;;;;;2,0;2,0;7,0;;;;;;;1,0;10,0;;;;;2,0;;;;;;;2,0;3,0;;;;;;;1,0;5,0;19,0;;;;;;;;3,0;;;;;;1,0;;;;;;;;;;;;;;;;;;;;;7,0;2,0;;17,0;;;;;;;;;;;;;;;40,0;;;;;1,0;;;;;;;;;;;1,0;;;;;6,0;;;;;;;;;;51,0;;;3,0;15,0;;;;;;;;;;;;;14,0;;2,0;;;;;57,0;;;1,0;;;;;6,0;1,0;;2,0;;;4,0;;;;;;;;7,0;;5,0;;1,0;;;;8,0;;2,0;5,0;;;;;3,0;;;;;6,0;;;;51,0;;;;;;;;;;;;;;;;;;;5,0;;;;;;;;;;3,0;;;;1,0;;;;1,0;;;;;16,0;;1,0;;;;;;;5,0;;;;;;;;;;;;;;;;;;;;;;;;;;;7,0;;;;;;;;;;;;;;;;2,0;;;;;1,0;;;;;;;;;;;
robot;;;;20,0;1,0;;;1,0;;;;;;79,0;;;54,0;;;2,0;;;;;3,0;;;4,0;8,0;1,0;21,0;14,0;;1,0;;15,0;4,0;4,0;6,0;;33,0;15,0;;4,0;30,0;;;3,0;;1,0;17,0;;4,0;;16,0;;2,0;1,0;;13,0;;;;;88,0;;57,0;;;7,0;;4,0;2,0;;;;;1,0;4,0;;45,0;;1,0;4,0;17,0;3,0;1,0;10,0;;4,0;3,0;;;;;;;;10,0;13,0;112,0;12,0;1,0;6,0;3,0;23,0;;3,0;;;;6,0;;;;;;2,0;;33,0;2,0;;18,0;;;7,0;171,0;;6,0;;4,0;;1,0;4,0;14,0;;17,0;2,0;1,0;;;4,0;;;;5,0;4,0;1,0;3,0;9,0;;;;;;;;;;;1,0;2,0;2,0;;;;42,0;;;;2,0;;;14,0;;11,0;;;2,0;;;1,0;;51,0;;;;;15,0;2,0;;;;;;;3,0;;1,0;;;;;;1,0;9,0;3,0;;15,0;10,0;29,0;45,0;;;;;3,0;;;3,0;;;;;;;29,0;;;1,0;;;;;;6,0;;1,0;;;;;;;;6,0;;2,0;6,0;2,0;;;;;;;13,0;10,0;;;;10,0;;9,0;;;;;;;;;4,0;6,0;;;2,0;24,0;;4,0;;;12,0;;;;;;3,0;;;;;;;;22,0;;;;;;1,0;;;;2,0;31,0;7,0;1,0;;;1,0;;5,0;2,0;6,0;;;23,0;99,0;5,0;;;;;;;;1,0;;;;;;;2,0;;;;;4,0;6,0;;;5,0;;8,0;;;;;2,0;;9,0;;;2,0;21,0;;;;;2,0;;3,0;2,0;5,0;2,0;;;;4,0;6,0;;3,0;1,0;1,0;1,0;;141,0;32,0;;;1,0;7,0;;1,0;;;;9,0;1,0;;;1,0;;4,0;;;9,0;10,0;1,0;;6,0;7,0;;42,0;23,0;1,0;;5,0;;5,0;;4,0;;;;2,0;;;;;2,0;1,0;20,0;5,0;2,0;;;;;4,0;;;;;6,0;;;;1,0;1,0;;17,0;;;8,0;2,0;;;;5,0;;;;5,0;;;2,0;;;1,0;;;;1,0;;;2,0;;1,0;4,0;;3,0;;4,0;;4,0;;17,0;34,0;1,0;;;7,0;2,0;2,0;15,0;;;;;;;;;;;;;;;;18,0;;;;;;3,0;;;;6,0;2,0;;;;;6,0;;;;;;;;;;;;1,0;2,0;;;;2,0;3,0;;;;;;;;;;;;;5,0;;2,0;2,0;;;;;;;;;2,0;;1,0;;;;;2,0;;;1,0;7,0;;3,0;;;;;1,0;;;;;;;;;;;;;;3,0;2,0;26,0;3,0;;;;6,0;;;;;;;;3,0;;;;;1,0;;;;;;;1,0;;;;;;;;;;6,0;;;;;;;1,0;;2,0;5,0;;;;;;;;;;1,0;;;;;;;;1,0;;;;;;3,0;;;;23,0;;;;2,0;;;15,0;;;22,0;;;;;2,0;58,0;;;;;;;;6,0;;;;;;;;1,0;;;;;;4,0;;;;;;;;;;;;;;;5,0;;12,0;6,0;1,0;;;;;;17,0;3,0;;;;;2,0;25,0;2,0;;;;;;11,0;;;;;;;;;;;;;;;;;;;;4,0;;;;;;;;;;;;;;;;;;;;;;;;3,0;;;;;;;;;;;1,0;2,0;;;;4,0;;;;;;;3,0;;;;;3,0;;;;;;;;;;;;;;;;;;;;;1,0;;;;;1,0;;;;;;;;2,0;;1,0;;;3,0;;;2,0;;;;;;;;;;1,0;;3,0;;;;1,0;;1,0;;;;;;;;;;;;;;;;;;8,0;;;;;;;3,0;;;;;;;;;;1,0;;;;;;;;;;2,0;;;;;;;;2,0;;;;;;;;;;;;;;;;;;;;;;;;;;1,0;;;;;;;;;;;;;1,0;;;;2,0;;;;27,0;;;5,0;;;;;;;;;;;;2,0;;;;
roll;;;;3,0;9,0;23,0;9,0;31,0;;;;2,0;2,0;24,0;;;11,0;;;;;;;1,0;;5,0;3,0;9,0;4,0;;17,0;2,0;7,0;40,0;;19,0;20,0;5,0;;;27,0;22,0;;6,0;;5,0;;2,0;3,0;;7,0;;1,0;;;;6,0;;6,0;;;;7,0;;41,0;;31,0;1,0;;1,0;12,0;11,0;;;;2,0;2,0;12,0;;;39,0;;8,0;;1,0;1,0;;7,0;3,0;2,0;1,0;;;;;;;5,0;23,0;6,0;39,0;5,0;;;1,0;1,0;;2,0;;;;1,0;;15,0;;;;3,0;1,0;4,0;1,0;;2,0;1,0;;1,0;20,0;;1,0;;4,0;;;6,0;;;;4,0;1,0;;;9,0;1,0;;;4,0;2,0;9,0;4,0;2,0;;;6,0;;;;;;;;;5,0;;;;;8,0;;1,0;2,0;1,0;;;74,0;;;;;;;;;12,0;;1,0;109,0;2,0;;55,0;28,0;;2,0;;;;2,0;29,0;;;2,0;;1,0;3,0;;3,0;1,0;13,0;1,0;2,0;4,0;7,0;39,0;7,0;;;;1,0;2,0;;;3,0;;;;4,0;;11,0;;;1,0;;;11,0;;;;;;1,0;;;1,0;;3,0;;;;1,0;5,0;;1,0;;;;11,0;8,0;37,0;;;;;;;26,0;;;1,0;;1,0;13,0;;;6,0;5,0;;;11,0;137,0;;1,0;1,0;;193,0;;;1,0;6,0;2,0;2,0;1,0;;8,0;;;;;1,0;;;;1,0;5,0;;;4,0;;2,0;9,0;15,0;5,0;;;;;;;2,0;;;4,0;1,0;8,0;;;;;;;2,0;1,0;;;21,0;5,0;;;;4,0;;;14,0;42,0;6,0;;2,0;;9,0;3,0;;;4,0;;;;18,0;;;2,0;9,0;1,0;;2,0;8,0;;;7,0;;7,0;6,0;2,0;3,0;;13,0;7,0;12,0;2,0;1,0;2,0;3,0;;11,0;3,0;;7,0;;6,0;3,0;4,0;2,0;;;;1,0;1,0;1,0;4,0;;;;2,0;3,0;1,0;;1,0;;;;1,0;14,0;28,0;;7,0;;2,0;;4,0;;132,0;;;1,0;3,0;;2,0;;9,0;6,0;;3,0;;4,0;;;;1,0;2,0;;;1,0;;;;5,0;85,0;;;;;;;;;;1,0;8,0;;;5,0;;9,0;3,0;;;3,0;;;;;;;;3,0;;;1,0;7,0;;;;;;;;;2,0;;15,0;1,0;;;;;;;;;9,0;;;16,0;;;;1,0;;3,0;;;;;;3,0;6,0;;;;;;21,0;;1,0;4,0;;;;;;;;;1,0;;;8,0;;;1,0;;;1,0;;1,0;;;1,0;;;;;3,0;;;;;;;;;3,0;;;;;;2,0;;;;;;;;;;1,0;1,0;;;;;3,0;;2,0;;;;;;;;;;;;;;;;;;;;;;;;;;;3,0;;;;3,0;;;;;;4,0;;;;;;;;;1,0;;;;;;;;;;11,0;;;;;6,0;;;;;;;;;3,0;;;3,0;;;;;;;;;;;;;;;;;2,0;;;;;;2,0;;;;;1,0;;;;;9,0;1,0;;;;;;;;;8,0;;;;;10,0;1,0;;;;;;;2,0;;;2,0;;;;6,0;;;;2,0;;;6,0;;;;;;;;1,0;16,0;;;2,0;4,0;;4,0;;;;;;;;;;;;9,0;;1,0;1,0;2,0;;;;;8,0;;;;1,0;;;;;;;;;;;;;16,0;;;;;2,0;;9,0;;4,0;;;;;1,0;;;;;;;;;;;1,0;;;;;;11,0;;;;;;;;4,0;;;;;;;;;;;;;;;;;;;;;;;;;3,0;;;;;;;9,0;;;;;1,0;;;;;;;;;;;;1,0;;;2,0;;;;;;3,0;;;;;12,0;;;;;;1,0;;;;;;;;;;1,0;;4,0;;;;;;;;;;;;;;;;;;;;;5,0;;2,0;;;;;;;;;;;2,0;;;1,0;;;1,0;;1,0;;41,0;;;;;;1,0;;;;;;1,0;;;;;;;;;;;;;;;;;;;;;;;;;;;;;;;;;;;;;;;;;1,0;;;;
rotary;;;;2,0;;13,0;;15,0;;;;;;1,0;;;;;;;;;;;;;;1,0;;;8,0;7,0;;;;;;3,0;;;3,0;11,0;;10,0;;15,0;;29,0;;;;;6,0;;;;2,0;;;4,0;;;;;1,0;;10,0;;;;4,0;2,0;3,0;;;;;;;;2,0;;;;3,0;1,0;;9,0;;;;;;2,0;5,0;;;;5,0;2,0;16,0;;;;;;;;;;;;;;;;;2,0;1,0;1,0;;;;;;;8,0;;;;;;;6,0;;;6,0;;;;2,0;1,0;;;;4,0;1,0;1,0;;5,0;;5,0;8,0;1,0;;;;;;;;8,0;;1,0;;;4,0;;;2,0;;;;14,0;;1,0;4,0;;;47,0;;;;4,0;;;;;;;;;;;2,0;1,0;9,0;;3,0;;;;;;;;7,0;;;6,0;1,0;3,0;9,0;;;;5,0;1,0;;;;;;;4,0;;40,0;;2,0;;;;;9,0;1,0;;;;;;;4,0;3,0;3,0;;;;1,0;2,0;1,0;;;;4,0;;2,0;5,0;5,0;;;1,0;6,0;;2,0;2,0;;;;;;;8,0;1,0;;2,0;;;8,0;;;;;9,0;;;;5,0;4,0;;;;;;1,0;;3,0;;;2,0;2,0;17,0;;;;;6,0;1,0;3,0;;1,0;;3,0;;;2,0;17,0;;;3,0;1,0;1,0;;;;;2,0;;;2,0;;;3,0;;;;;;;30,0;;14,0;21,0;19,0;;;;6,0;1,0;;14,0;;;;;;1,0;3,0;;2,0;;;;;;;4,0;;;;;;;;1,0;;2,0;;;;;7,0;4,0;;;;6,0;;;;;;;;;;7,0;;;;;;;;1,0;;;;2,0;10,0;1,0;;;;4,0;9,0;2,0;;;;;;;;;;1,0;1,0;;;;3,0;;;;;;1,0;;45,0;;;1,0;;;;;;;;;;;;;;;;;;;;;;;;;;;;;;;;;;31,0;;;;;;;;1,0;1,0;;3,0;;;;;;;;;;;;;;;;1,0;;;;;;;3,0;;;;;5,0;;;;;;1,0;;;;;;;;2,0;;3,0;;;;;;;;;;;;;;;;;;;;;1,0;;;;;;;;;;;;;;;;;;;;;;;1,0;;;;1,0;;;;;;;7,0;7,0;;;;;;;;;;;;;;;;;;;;;;;;;;;;1,0;2,0;;;;;;;;;;;;;;;;;;;;;;;4,0;;;;;;;1,0;;;;;;;;;;;;;;6,0;;1,0;;;;;;;;;;;2,0;;;;;;;;;;;;;;;;;;;;;;;1,0;;;;;;;;;;1,0;2,0;;;;;;1,0;;;;;1,0;;;;;;;;1,0;1,0;;;;;;;;3,0;;;30,0;;;;4,0;;;;2,0;;;;;;;;;;;;;;19,0;;1,0;;;;;;;;;;;;;;;;;;1,0;;;;2,0;;;;;;;;;;;;;;;;;;;;1,0;;;;;;;;;;;;;;;;;;;;;;;;;;;;;;;;;;;;;1,0;;;;;;;;;;1,0;;;;;;;;;;;;;;;;;;;;;;;;;;;;;;1,0;;;;;;;;;;;;;;;;;;;;;;;;;;;;;;;;;;;;;;;;;;;;;;;;;;;;;;;;;;;;;;;2,0;;;;;;;;;;;;;;;;;;;;;;;;;;;;;;;;;;;;;;;;;;;;;;;;;;;;;;;;
rotatably;;;;7,0;;2,0;;42,0;;;3,0;;10,0;49,0;;;3,0;;2,0;;;;;;;;;17,0;;;20,0;;;;;;2,0;;;;;18,0;;;4,0;13,0;;9,0;;;;;;8,0;;;1,0;;;;;;;;3,0;;17,0;;;;;18,0;1,0;;;;;;;1,0;;;;;9,0;13,0;;;;;;;;1,0;1,0;;;8,0;3,0;1,0;14,0;2,0;2,0;;1,0;;;;;;;4,0;;;;;;;;2,0;;;;;;;6,0;;1,0;;;;;21,0;;;2,0;;;1,0;3,0;3,0;;;4,0;;2,0;9,0;;42,0;1,0;2,0;40,0;14,0;;;;;;;;57,0;;;;;127,0;8,0;;;;;;2,0;3,0;;;;4,0;;;;;4,0;2,0;;8,0;;13,0;9,0;;1,0;;11,0;6,0;4,0;27,0;;1,0;2,0;;;;;;;69,0;;6,0;87,0;7,0;2,0;;;;2,0;;1,0;;;;;;;20,0;;60,0;2,0;;;;;;;8,0;;;;;;;20,0;14,0;;;;2,0;;11,0;4,0;;;;5,0;;;71,0;20,0;3,0;;;;;3,0;;;;;;2,0;;3,0;4,0;;4,0;1,0;1,0;;3,0;2,0;2,0;;30,0;;;4,0;;4,0;;1,0;2,0;3,0;4,0;;;6,0;;1,0;2,0;15,0;9,0;;;;;2,0;12,0;1,0;;2,0;;1,0;3,0;;1,0;2,0;2,0;8,0;7,0;4,0;5,0;;6,0;;3,0;;;10,0;;;2,0;3,0;1,0;3,0;;;;;;3,0;26,0;6,0;8,0;4,0;1,0;15,0;47,0;5,0;;1,0;;1,0;;;;7,0;1,0;10,0;;;;;;1,0;;1,0;;;1,0;;1,0;3,0;;12,0;1,0;;;;;;;;;;;;;;;;;;;;;;;;;;;;;;;;;;;9,0;4,0;2,0;;1,0;2,0;1,0;;8,0;;;;;2,0;;;4,0;;;;3,0;;;;;;7,0;;;1,0;;;;;;;;;;;;;;;1,0;8,0;2,0;;2,0;1,0;;;1,0;;;;;;;;;;;1,0;2,0;;4,0;;;;;1,0;;;;4,0;12,0;;;;;;;;;;;;;;;;;;;;1,0;;;;;;;3,0;2,0;;;1,0;10,0;;;1,0;1,0;;1,0;;;5,0;1,0;;;9,0;;;2,0;1,0;;;;;;;;;25,0;;;;;1,0;;;;;;;;;;4,0;;;;1,0;;;;;;8,0;;;;;;3,0;;;;;;;;1,0;1,0;;2,0;20,0;;;;;;;;19,0;;;;;;;;;;;;;;;;;;;;;3,0;;;;;;1,0;;;;;;;;;1,0;;;;;;;;1,0;;4,0;;;;;;;1,0;;;;;;;;;;;;;;;;;17,0;;;2,0;;;1,0;;1,0;;;;;1,0;;;;;;4,0;;;;;;;;13,0;;;;;;;;;;;;10,0;9,0;;;1,0;;;;2,0;;;4,0;;;4,0;;;;1,0;;;;;1,0;1,0;;;;;;;7,0;;;28,0;;;;;;2,0;;;7,0;;3,0;;8,0;;;;;;;2,0;;;2,0;;;3,0;;;;;;1,0;;;;;2,0;1,0;;;;4,0;;;;;;;;;;;;;;;;;;;;;;;;2,0;;;;;1,0;;;;;;;;;;;;;;;;;;;;;;;;;;;;;;;;2,0;;;;;;;;;;;;;;;;;;;;;;;;;;;;;;;;;;;;;;;;17,0;;;;;;;;;;;;;;;;;;;;;;;;;1,0;;;;;;;;;;;;;;3,0;;3,0;;;;;;;;;;1,0;3,0;;;1,0;;;;;2,0;;;13,0;;;;;1,0;;;;;;;;;;;;;;;;;;;;;;;;;;;;;;;;;;;;;;1,0;;;;;;;;;;;;;
rotational;;;;16,0;16,0;20,0;;22,0;1,0;;;;57,0;54,0;;;12,0;;;;;;;;6,0;;9,0;41,0;2,0;;35,0;11,0;1,0;;1,0;34,0;17,0;18,0;;1,0;80,0;75,0;;;13,0;18,0;;1,0;;1,0;3,0;;13,0;;3,0;;17,0;4,0;5,0;3,0;;;5,0;;63,0;;18,0;1,0;;6,0;1,0;26,0;2,0;1,0;;;3,0;19,0;;1,0;44,0;;2,0;2,0;10,0;14,0;;41,0;3,0;3,0;43,0;;3,0;2,0;1,0;;1,0;29,0;57,0;10,0;258,0;20,0;;1,0;3,0;4,0;;1,0;;;;7,0;1,0;;;1,0;;25,0;1,0;43,0;;;6,0;;;10,0;32,0;;;;2,0;;;29,0;;;12,0;7,0;10,0;;4,0;5,0;;;3,0;12,0;8,0;16,0;11,0;10,0;34,0;;27,0;;;1,0;6,0;;;;;18,0;;1,0;;;23,0;12,0;;3,0;18,0;;2,0;114,0;6,0;3,0;1,0;;2,0;8,0;4,0;;;6,0;1,0;;2,0;18,0;9,0;4,0;;1,0;;9,0;7,0;1,0;30,0;;1,0;4,0;;;10,0;1,0;1,0;3,0;238,0;1,0;19,0;94,0;12,0;157,0;64,0;;3,0;6,0;22,0;17,0;;30,0;;;3,0;;20,0;1,0;61,0;;2,0;;8,0;;19,0;;5,0;;;;1,0;4,0;;10,0;31,0;8,0;;2,0;1,0;4,0;8,0;1,0;;;;2,0;;;42,0;22,0;1,0;;1,0;4,0;;12,0;1,0;;3,0;;7,0;3,0;;2,0;42,0;3,0;;4,0;21,0;129,0;;28,0;7,0;;150,0;;;;3,0;;;;;1,0;;10,0;;3,0;4,0;;1,0;43,0;4,0;;;;6,0;;2,0;8,0;;4,0;9,0;1,0;2,0;;17,0;6,0;2,0;5,0;11,0;15,0;2,0;4,0;5,0;2,0;;;;;;;;;;4,0;9,0;;5,0;;1,0;19,0;68,0;64,0;;8,0;;4,0;3,0;5,0;;3,0;2,0;2,0;;;6,0;5,0;1,0;2,0;10,0;;;1,0;;1,0;;18,0;4,0;13,0;4,0;6,0;1,0;;2,0;12,0;9,0;3,0;2,0;;13,0;;11,0;1,0;;2,0;3,0;34,0;;1,0;;;6,0;;;1,0;;3,0;;;19,0;9,0;1,0;8,0;;2,0;8,0;1,0;;3,0;96,0;36,0;;1,0;;;130,0;49,0;15,0;6,0;2,0;;;5,0;;;1,0;8,0;;7,0;1,0;6,0;5,0;;3,0;;18,0;46,0;2,0;4,0;2,0;;;2,0;10,0;4,0;1,0;;6,0;1,0;1,0;16,0;;;;6,0;;;;9,0;;;2,0;;;;;;;;;;;5,0;2,0;1,0;2,0;22,0;7,0;;;;;;;1,0;;2,0;10,0;8,0;;;19,0;;;2,0;;;;;;7,0;;;1,0;;3,0;10,0;1,0;;;;;;;;;;1,0;1,0;;;;;1,0;;;;8,0;;2,0;;8,0;;2,0;2,0;3,0;;;;2,0;;;;2,0;1,0;1,0;;;2,0;;;;1,0;;;;;;;;;;2,0;3,0;;1,0;;;;;2,0;;5,0;1,0;;18,0;6,0;;10,0;;;;;;5,0;;6,0;4,0;;;;;;;;;;;;2,0;;;1,0;;;;;;;;;;;;4,0;;;;;;;;;;1,0;;;4,0;;;;3,0;;;;;;;1,0;6,0;3,0;;;1,0;2,0;;;;;;;;;;;2,0;;;;;6,0;4,0;;;;2,0;;;;;;;;;;;;;;;;2,0;;;;;;2,0;16,0;;;;3,0;;;;5,0;3,0;1,0;;;;2,0;;21,0;7,0;;14,0;;;;;;;;;;;;;;;1,0;1,0;;;6,0;16,0;;2,0;;;;;8,0;52,0;;;45,0;2,0;;2,0;1,0;;3,0;;;;;8,0;;16,0;;;;;;;5,0;1,0;3,0;;2,0;;;;4,0;;;;2,0;;;6,0;2,0;2,0;6,0;;;5,0;1,0;;;;;;;;;;;;;;;;;;;;;;;2,0;;;;;;;6,0;;;;;4,0;;;;;;;3,0;;;;;;;;;;;1,0;;;;;;;;;;;;;;;;;;;9,0;;4,0;1,0;;;;;;;;;;;;;;;;;1,0;;;;;;2,0;2,0;;10,0;3,0;;;;;;;;;;;;;;;1,0;;1,0;;;6,0;;;;;;;;;;;;;;;2,0;;;;;1,0;3,0;;;2,0;10,0;;;1,0;;3,0;1,0;1,0;;12,0;;16,0;;1,0;;;;;;;;;;;1,0;;2,0;;2,0;;;;;;;;;;;;;2,0;;;;;;;;;;;;;;;;;;;;;;;;;;;;;;;;
rotor;;;;19,0;;2,0;1,0;6,0;;;;;;16,0;;;;;;;;;;;;;;2,0;;;26,0;2,0;;;;4,0;1,0;4,0;;;3,0;1,0;;;;4,0;;2,0;;;;;2,0;;7,0;;;;;1,0;;;;;4,0;;13,0;;;;;1,0;2,0;;;;;;;;3,0;;;;2,0;;;2,0;;;;;2,0;2,0;;;;;4,0;;12,0;;;;;;;;;;;;;;;2,0;;1,0;;7,0;;;1,0;;;;26,0;;;;;;;2,0;;;4,0;;;;;;5,0;;1,0;1,0;;;3,0;2,0;;;2,0;;;;;;;;;4,0;;;;;20,0;;;;;;1,0;2,0;;;;;;;1,0;;;;;;1,0;1,0;1,0;;;;;;;2,0;2,0;;;;;;;;;;;;12,0;;;;;;;;;;;;;;;;7,0;;;;;;;;;;;;;;;;;9,0;2,0;1,0;;;;;;;;;;;;;9,0;2,0;1,0;;;;;8,0;;;;;;4,0;;;13,0;;;;;11,0;;;;;10,0;;;;3,0;;;;1,0;;;4,0;;;1,0;;;;;;;;;;;2,0;;3,0;;;;;;;;;;;;;;;;;;;4,0;;;;;;;;;;;;15,0;12,0;6,0;;;;1,0;1,0;;;;;;;11,0;;;;;;;;;2,0;;;;2,0;8,0;;;;;;;;;;3,0;2,0;13,0;;;;;1,0;;;;;;;;;1,0;;;;;;;;;;;;;;;19,0;3,0;6,0;;2,0;;2,0;1,0;;;;;;;;;;;;;;;;;;40,0;;1,0;4,0;;;;;;1,0;;;;;;;;;;;;;;;;1,0;;;;;;;;;;;;;;;;;;;;;;;;2,0;;;;;;;;;;;;;;;;;;;;;;;;;;;;;;;;;;;;;;;;;;;;;;;;;;1,0;1,0;;;;;;;;;3,0;;;;;;;;;;;;;;;;;;;;;;;;;;1,0;;1,0;;;;;;;;;;;;;;;;;;;;;;;;;;;;;;;;;;;;;;;;;;;;;;;;;;;;;;;;;;;;1,0;;;;;;;;;;;;3,0;;;;;;;;;;;;;;;;;2,0;;;;3,0;;;;;;1,0;;1,0;;;;;;;;;;;;;;;;2,0;;;;;;;2,0;;;;;;;;5,0;3,0;;;2,0;;;;;;;;;;;;;;;;;;4,0;;;;;;;;;;;;;;;;;;;;;;;;;9,0;;4,0;;;;;;;;;;;;;;;;;;;;;;;;;;;;;;;;;;;;;;;;;;;;;;;;;;;;;;;;;;;;;;;;;;;;;;;;;;;;;;;;;;;;;;;;;;;;;;;;;;;;;;;;;;;;;;;;;;;;;;;;;1,0;;;;;;;;;1,0;;;;;;;;;;;;;;;;;;;;;;;;1,0;;;;;;;;;;1,0;;;;;;;;;;;;;;;;;;;;;;;;;;;;;;;;;;;;;;;;;;;;;;;;;;;;;;;;;;;;;;;;;;;;;;;;;;;;;;;;;;;
rule;;;;16,0;;1,0;;;;;;;;56,0;;;20,0;;;;;;;;2,0;;;;;;11,0;;;;;10,0;1,0;;;3,0;43,0;11,0;;;1,0;;;1,0;;;18,0;;;;;;;;5,0;4,0;;;5,0;2,0;33,0;1,0;7,0;;;;;;;;;;;;5,0;24,0;12,0;;;;2,0;;;;;;;;;;;;;;2,0;4,0;6,0;33,0;;2,0;7,0;4,0;;;;;;29,0;7,0;;;;;6,0;4,0;;1,0;;1,0;;;49,0;36,0;;;;1,0;;;5,0;;;;;;;;;3,0;;;2,0;;;12,0;;;7,0;3,0;;;;;;;;;;;;;3,0;1,0;;;;;;;;;;;;;3,0;;;;;;;;;3,0;;;;;;;;;;;;;;;;;1,0;;;;1,0;;;;;;;4,0;;;;;;;;;;;;;;;;;;;1,0;;;;;;;;;;22,0;;;;;;;;4,0;;;;;;;3,0;2,0;;;;;;;;;;2,0;;;;;;;;18,0;;;;;;;;;;;;;;;;;;2,0;;;;;;;;;;;;;;;;;;;;;;1,0;;34,0;;;;1,0;;;;;;;;;1,0;;;;;;;1,0;;;;;;;;;;;;;;;;;14,0;15,0;;;;;;2,0;;;;;;;12,0;;2,0;;;6,0;18,0;;;50,0;;;;9,0;14,0;;;7,0;;1,0;;2,0;;1,0;;2,0;3,0;;;4,0;;1,0;;7,0;;;;;;;1,0;;28,0;1,0;;;;;;;;;;;;1,0;;;;;8,0;;;;6,0;;;;;6,0;;;1,0;;;;3,0;;;;;;;;2,0;;;1,0;5,0;;;;;2,0;;;;;;;1,0;1,0;;;;1,0;;1,0;;;;;4,0;;12,0;;;;;;2,0;;;;;;14,0;;;;;;;;;;;1,0;2,0;;;;;;;;;;11,0;;1,0;;;;;;;;;6,0;;;;;5,0;;;10,0;;;;;;1,0;2,0;;;;;;2,0;;;3,0;;1,0;;1,0;;;7,0;;;;;;;;8,0;;;;;;;66,0;;;;;;;;;;;;;;11,0;;;;;17,0;;;;;2,0;;;;1,0;;;;;;4,0;17,0;;;;1,0;;;;;;;;;;;;;;;;;14,0;;;1,0;;;;1,0;;;;;1,0;2,0;;;;;;;;;;;;;;;;;;;;;;;;;;;;;1,0;;;8,0;;;;2,0;;;;;;;;;;;;;;;5,0;;;;;;;;1,0;;;;;;;;3,0;;;;;;;;;;;;;;;;;;;;;8,0;;;;;;5,0;;;;;;;;;;;;;;;;;;;;;;;;;;;;;;2,0;;;;;;;;;;;;;;;;;;;;;;;;;;48,0;;3,0;;;;;;;;;;;;;;;;;2,0;;1,0;;1,0;;9,0;;;;;;;;;;;2,0;;;;;;;;;;;;;;;;;;;;;;;;1,0;;1,0;;;;;;;;;;;;;;;;;;;;26,0;;;;4,0;;;1,0;;3,0;;;2,0;;;;5,0;;;;;;;;;;;;;;;;;;;;;;2,0;;;;;;;;;;;;;;;;;;;;;;;;;;;;;;;;;;;;;;;;;;;;;;;;;;;;;;;;;;;;;;;;;;;;;;;;;;;;;;;;;;;
sample;;;;16,0;18,0;27,0;81,0;7,0;2,0;;;6,0;3,0;121,0;;71,0;70,0;4,0;12,0;6,0;10,0;8,0;67,0;;;6,0;48,0;13,0;1,0;;103,0;12,0;13,0;3,0;;126,0;11,0;2,0;73,0;1,0;66,0;69,0;;55,0;17,0;3,0;;11,0;;;27,0;;;;1,0;16,0;21,0;;42,0;121,0;;;13,0;;464,0;2,0;97,0;15,0;;1,0;;10,0;108,0;;;14,0;1,0;15,0;3,0;9,0;136,0;1,0;11,0;23,0;12,0;;;41,0;;11,0;30,0;2,0;2,0;;9,0;;152,0;22,0;192,0;90,0;37,0;11,0;;3,0;16,0;38,0;4,0;2,0;6,0;1,0;;27,0;27,0;2,0;3,0;24,0;34,0;27,0;28,0;62,0;16,0;;74,0;17,0;5,0;9,0;46,0;;64,0;;257,0;;;53,0;7,0;;23,0;3,0;;;;2,0;;9,0;13,0;14,0;108,0;4,0;10,0;;12,0;106,0;;;14,0;4,0;;;;;;9,0;1,0;24,0;1,0;;7,0;;;5,0;36,0;2,0;11,0;2,0;;2,0;;3,0;1,0;2,0;;2,0;;1,0;;1,0;16,0;;113,0;1,0;;;;57,0;12,0;4,0;14,0;8,0;7,0;1,0;;;;;13,0;13,0;7,0;2,0;2,0;;;45,0;21,0;;;;24,0;;6,0;2,0;80,0;27,0;;;1,0;;88,0;;;13,0;;3,0;12,0;5,0;;3,0;2,0;;;16,0;;;;;;92,0;22,0;;8,0;3,0;5,0;;1,0;;1,0;7,0;;2,0;17,0;;3,0;4,0;10,0;;2,0;;;9,0;5,0;9,0;;;1,0;4,0;;;1,0;;;;;;4,0;;27,0;;;;52,0;;;;;;3,0;5,0;22,0;;1,0;;;;;5,0;;;;2,0;;43,0;;1,0;;4,0;;;14,0;;;6,0;2,0;84,0;;19,0;;2,0;4,0;;;3,0;;;;;8,0;1,0;;;4,0;;7,0;;;;2,0;3,0;1,0;10,0;;;;;11,0;;6,0;;;;22,0;;;;;;;1,0;4,0;5,0;;1,0;;;9,0;9,0;1,0;1,0;11,0;;9,0;1,0;5,0;;1,0;;1,0;62,0;;2,0;;3,0;4,0;;24,0;4,0;;33,0;;19,0;;6,0;;7,0;;11,0;;9,0;1,0;3,0;64,0;;;5,0;8,0;4,0;17,0;1,0;;;;22,0;;67,0;1,0;6,0;4,0;22,0;;21,0;1,0;;31,0;;13,0;;;;5,0;;18,0;;;7,0;14,0;;3,0;5,0;;;1,0;;;40,0;1,0;;;;2,0;15,0;6,0;6,0;6,0;;8,0;18,0;;15,0;1,0;;4,0;;;;1,0;6,0;;;4,0;;1,0;3,0;;;;13,0;;3,0;62,0;2,0;;4,0;;;;8,0;1,0;9,0;;;;;;11,0;;;7,0;10,0;;;;;16,0;6,0;;;;18,0;;1,0;;;;;8,0;;;;;;;;;;;5,0;62,0;;38,0;;;20,0;;7,0;;1,0;;6,0;;;;;;;1,0;;;2,0;;;;;1,0;4,0;;;13,0;;1,0;;1,0;2,0;;;;;;3,0;1,0;3,0;;;3,0;;10,0;;3,0;;1,0;;4,0;28,0;;1,0;;7,0;;;;;;;1,0;;;16,0;;11,0;;2,0;8,0;17,0;1,0;1,0;1,0;1,0;;;1,0;;1,0;5,0;;;70,0;8,0;;;;1,0;;;;;;;;;1,0;;2,0;8,0;15,0;19,0;;;1,0;1,0;;;3,0;;;1,0;2,0;1,0;;7,0;;;;46,0;1,0;;;;;;;;;;4,0;;4,0;;;;;;60,0;1,0;;;;;;;;;;;;;10,0;;49,0;;3,0;5,0;;;;;2,0;;;;;;;46,0;;8,0;;;;9,0;4,0;;;6,0;;5,0;;;3,0;4,0;;1,0;;3,0;;;;1,0;2,0;;;;4,0;;3,0;15,0;;;;1,0;;;;;;;;3,0;1,0;;50,0;;;;;;;;;;;;2,0;;4,0;;;;;;;;;;7,0;;;;;;;;17,0;;23,0;;2,0;28,0;2,0;;5,0;6,0;;;;;;7,0;5,0;;;25,0;21,0;;1,0;3,0;25,0;;;6,0;;8,0;22,0;;;8,0;10,0;2,0;1,0;1,0;;7,0;;;;20,0;9,0;;;;2,0;5,0;;;2,0;;;2,0;;;;6,0;;;;1,0;;23,0;;2,0;15,0;;4,0;;;3,0;1,0;;;10,0;;;;;3,0;;;41,0;;2,0;;5,0;;;;2,0;;;;;;;8,0;;2,0;;;;;;;;;;;;6,0;;;;;;;;;;;;;;;;;;;;2,0;;9,0;;;3,0;;;;;;;;;;;;;;12,0;;;;;;;;;24,0;;;;;;2,0;;;21,0;;;;;;;;;;;24,0;;;;;;6,0;2,0;2,0;;;4,0;;;;;;3,0;4,0;;;;;;;;;;;
satisfy;;;;3,0;21,0;18,0;;19,0;;;23,0;;;11,0;;5,0;15,0;;;3,0;;1,0;;;;;2,0;24,0;5,0;665,0;23,0;;;;;22,0;1,0;5,0;13,0;;38,0;31,0;1,0;;12,0;1,0;;75,0;78,0;1,0;9,0;;;;3,0;180,0;2,0;;1,0;2,0;;;59,0;;161,0;1,0;17,0;;1,0;6,0;163,0;760,0;5,0;;3,0;2,0;4,0;3,0;2,0;3,0;36,0;1,0;1,0;1,0;24,0;;;220,0;;;1,0;;3,0;1,0;1,0;;4,0;21,0;11,0;28,0;19,0;79,0;1,0;;3,0;3,0;;1,0;2,0;;2,0;20,0;23,0;;;;2,0;6,0;1,0;10,0;;;2,0;6,0;;7,0;288,0;13,0;11,0;21,0;65,0;13,0;;41,0;;;10,0;;51,0;;;2,0;;;8,0;1,0;3,0;3,0;10,0;;1,0;;;;;;;;;4,0;;;3,0;;4,0;;;;;4,0;2,0;;;12,0;;;1,0;;;;;;;8,0;;3,0;4,0;;12,0;1,0;2,0;;;4,0;;;1,0;1,0;5,0;;1,0;;13,0;;2,0;3,0;10,0;;;;;11,0;2,0;;;2,0;6,0;;;;2,0;7,0;;1,0;;;2,0;;;;;10,0;2,0;7,0;1,0;2,0;;;;25,0;;;;;;5,0;1,0;2,0;37,0;;;1,0;;;;;;46,0;;;9,0;;;1,0;2,0;;;1,0;;;;;1,0;;;;;19,0;;;5,0;;50,0;;;;;;;;;;;;;;35,0;;;;;;;;;1,0;;;11,0;81,0;6,0;;;;;;;;2,0;;6,0;18,0;;;;1,0;7,0;;68,0;;1,0;;;;1,0;;;;;;;5,0;;;;5,0;2,0;4,0;;;;;1,0;;2,0;;;;1,0;3,0;;;;1,0;1,0;1,0;;;;;;;15,0;3,0;15,0;;;;4,0;;4,0;2,0;3,0;36,0;1,0;20,0;10,0;9,0;;;6,0;;;31,0;;;;7,0;4,0;;;8,0;;8,0;;2,0;1,0;;21,0;;;2,0;;;30,0;5,0;;5,0;;2,0;;6,0;;;8,0;3,0;;3,0;;;2,0;;6,0;;2,0;;6,0;;;;;6,0;39,0;6,0;2,0;6,0;2,0;;;;;1,0;5,0;;;;5,0;;;;5,0;;;;;;;;;;;;2,0;;;;3,0;;;;;;;;;1,0;9,0;;8,0;1,0;;;1,0;;;;5,0;;;;4,0;;;;7,0;3,0;2,0;;;;;8,0;;;2,0;;;4,0;;;;;;;76,0;;;;;;;1,0;;3,0;4,0;;6,0;;;15,0;1,0;6,0;;1,0;;2,0;;1,0;;9,0;;;1,0;4,0;2,0;;;2,0;;;7,0;10,0;;;1,0;;;;;1,0;;;;;;;;4,0;;;;;1,0;;1,0;;;;;2,0;3,0;;;;;;;9,0;;;3,0;;;14,0;;;;;1,0;;;;;;1,0;;;;4,0;;;;10,0;;;;;1,0;;;;;;;;;;;;;;;1,0;;;;;;;;;;2,0;;7,0;;;;;;;;;;2,0;;;;;;3,0;;;;;2,0;;;3,0;;;;;;;17,0;;;;;;;;;3,0;2,0;;;;;;1,0;;1,0;10,0;;;;;;3,0;;;;;;;;1,0;16,0;;;;;3,0;;;;3,0;2,0;;;;55,0;;;;;8,0;;23,0;;;;;;;;;;;;;;;2,0;;8,0;;;;;;;;;;;;;9,0;;1,0;;;;;;;;3,0;;;2,0;;;;;;;3,0;;1,0;;6,0;;;;;;;;;4,0;;;3,0;;5,0;;;14,0;;;;;7,0;;;2,0;1,0;;12,0;2,0;;8,0;;1,0;3,0;;;;;2,0;5,0;8,0;2,0;2,0;;;;;;5,0;;2,0;;;;;;;1,0;;1,0;;3,0;;;;;;;;;;;;;;1,0;8,0;;;;;;;;;;;4,0;;2,0;;;;;22,0;;;;1,0;;;;;;11,0;;1,0;;;;;;;;;;;;;;;;;;3,0;;;;;;;;;;23,0;;;;;;;;;;;;;5,0;;194,0;;;41,0;;;;;;1,0;;;;;;;;;4,0;6,0;;;;;;;;;;;;;;;;;;;35,0;;;;;;;;195,0;;;;12,0;;;;;
scale;;;;16,0;9,0;25,0;;;;;;;12,0;53,0;;1,0;44,0;;;1,0;6,0;14,0;25,0;4,0;1,0;3,0;;25,0;6,0;;37,0;1,0;4,0;;;44,0;10,0;;25,0;;36,0;15,0;;7,0;35,0;;26,0;3,0;2,0;1,0;;;1,0;;5,0;;7,0;;5,0;43,0;;;9,0;;445,0;;30,0;5,0;;;5,0;16,0;5,0;;1,0;3,0;;;;5,0;77,0;;;12,0;16,0;10,0;;12,0;;;21,0;;;;4,0;;48,0;3,0;27,0;36,0;33,0;10,0;;10,0;15,0;19,0;;2,0;;;;72,0;34,0;;;;25,0;1,0;9,0;21,0;;;;16,0;;2,0;34,0;;;;1,0;;;12,0;11,0;;24,0;3,0;13,0;;;;;;;39,0;7,0;2,0;9,0;19,0;16,0;1,0;12,0;;8,0;;19,0;;2,0;;;3,0;4,0;;;;1,0;;;4,0;12,0;;1,0;38,0;;3,0;;1,0;1,0;1,0;;1,0;;;;;2,0;;33,0;1,0;;;;24,0;52,0;;;;12,0;3,0;;;4,0;;1,0;;14,0;;;1,0;2,0;8,0;15,0;;;16,0;14,0;1,0;1,0;2,0;6,0;;;;1,0;;22,0;1,0;;3,0;;;5,0;169,0;;;2,0;;;6,0;;3,0;6,0;;1,0;23,0;;2,0;14,0;1,0;;;;2,0;;;1,0;8,0;;;;;2,0;9,0;6,0;;;;1,0;;;;;4,0;;;;;2,0;;;5,0;14,0;;8,0;;;1,0;;;;;29,0;10,0;15,0;3,0;30,0;;1,0;;;;;;;;;;6,0;7,0;;;;;;;1,0;;;4,0;;16,0;;;;;2,0;;;;;;;;4,0;;3,0;;;6,0;4,0;7,0;6,0;1,0;;;;4,0;;;;;;;6,0;;;;11,0;;;;;;;5,0;;;;;;;16,0;8,0;19,0;3,0;;4,0;4,0;;9,0;11,0;;;2,0;12,0;;24,0;;3,0;;1,0;4,0;;;43,0;;3,0;4,0;;;80,0;;2,0;8,0;8,0;2,0;;6,0;;;7,0;;;6,0;14,0;;;;;;;;;;9,0;;3,0;;;;;2,0;;6,0;;5,0;6,0;;;7,0;1,0;13,0;;12,0;4,0;;;;;3,0;;;;;;4,0;8,0;;;11,0;6,0;3,0;1,0;;;2,0;;;;;22,0;5,0;;;;;;;;;3,0;;15,0;;1,0;39,0;6,0;;7,0;;;;3,0;;3,0;1,0;;;2,0;10,0;4,0;;;2,0;;;;;;;5,0;;;;;;;;;;;2,0;9,0;;;;;;;;;;;;4,0;;;;5,0;;1,0;;;;;;;;2,0;;;;10,0;2,0;;;;;;;2,0;;;2,0;3,0;;;1,0;1,0;;;;;;7,0;;1,0;;;;;;;;;;;1,0;4,0;;;;;;;;;;;1,0;;;19,0;;;2,0;;;;1,0;;;4,0;;;;;;;;;10,0;7,0;;;;;;;;;;;6,0;;;;;;;;;;;;;;;;1,0;;1,0;;;1,0;12,0;;46,0;;;;1,0;;;;;;;;;;;;2,0;;;;43,0;7,0;;;;;;;18,0;;;;;;;;;;;;;;;;3,0;;;;;;;142,0;;;1,0;;;;;;;;;;1,0;;1,0;;;;1,0;3,0;1,0;;;;22,0;1,0;;;5,0;;1,0;;;;;1,0;;2,0;;;;;;;;;;;;;;;;;;;;;;3,0;;;;;;;;;;;;;;;;3,0;;6,0;;;;;4,0;;;;2,0;;;;;;;;1,0;12,0;;;;5,0;;;;;;;;;;;;1,0;3,0;;;4,0;;3,0;;;;;25,0;;;;11,0;;;;;;;;;;;;;1,0;;;2,0;;7,0;;;;;;;;1,0;;;;;;;;;;;;1,0;4,0;;;32,0;;;;;8,0;;;;;9,0;;;;;;;;;;;;;;;;;;;;;;;2,0;;;;1,0;;;;;;;;;3,0;;;1,0;;;;;;;;;;;;;;;;;;1,0;;;;;;;;;;2,0;2,0;;6,0;14,0;;;;;;;;;;;5,0;;;3,0;;;4,0;;;;;58,0;4,0;1,0;2,0;;;6,0;3,0;;;;;;;;;;;
scan;;;;4,0;2,0;14,0;;10,0;;;;;;30,0;;;15,0;;4,0;2,0;;;3,0;;1,0;;2,0;3,0;6,0;4,0;43,0;7,0;5,0;2,0;;68,0;6,0;;5,0;;54,0;50,0;;7,0;14,0;8,0;;4,0;8,0;1,0;2,0;;5,0;2,0;14,0;5,0;15,0;;10,0;32,0;;;;;224,0;1,0;59,0;1,0;;;;45,0;92,0;;;;;1,0;;5,0;73,0;6,0;13,0;42,0;8,0;5,0;;17,0;;8,0;3,0;;2,0;;;;56,0;18,0;91,0;159,0;42,0;14,0;;11,0;18,0;30,0;5,0;4,0;;;;5,0;41,0;;;3,0;;2,0;11,0;52,0;7,0;;49,0;7,0;3,0;13,0;67,0;;3,0;;89,0;;;65,0;3,0;;33,0;;2,0;;;;;;;20,0;24,0;5,0;8,0;;;;6,0;;16,0;;;;;;;5,0;;4,0;5,0;2,0;4,0;11,0;;1,0;9,0;1,0;9,0;18,0;;2,0;2,0;;;;;;;3,0;;;1,0;;29,0;;;;;;;;5,0;;;;;;10,0;1,0;5,0;5,0;5,0;;;2,0;8,0;3,0;3,0;;;1,0;8,0;3,0;1,0;2,0;19,0;13,0;;;;;17,0;;1,0;6,0;;1,0;34,0;4,0;;;;1,0;;5,0;;;;;;6,0;21,0;4,0;1,0;;;;2,0;9,0;2,0;;2,0;16,0;5,0;;18,0;4,0;;;;;;10,0;;55,0;;;;3,0;;;2,0;26,0;;;;27,0;5,0;;;;;;51,0;;3,0;;;;4,0;;10,0;;;;;;;;;;;;3,0;23,0;1,0;;;;;;;2,0;1,0;11,0;4,0;120,0;7,0;;;;;;;;;;;;4,0;;;;;;2,0;1,0;;;;;28,0;2,0;;;;;;;8,0;;;2,0;8,0;;12,0;;;;3,0;14,0;;;;1,0;;;2,0;;9,0;2,0;;7,0;7,0;;59,0;11,0;;4,0;;23,0;;1,0;1,0;1,0;;6,0;;23,0;1,0;3,0;2,0;49,0;;2,0;;;;;8,0;11,0;;3,0;9,0;4,0;;11,0;;5,0;47,0;;1,0;;;87,0;3,0;4,0;6,0;12,0;4,0;26,0;;5,0;;;;;23,0;;7,0;;4,0;5,0;;3,0;;;8,0;8,0;;3,0;;;15,0;;;;4,0;;;;3,0;2,0;;;22,0;;;;1,0;2,0;;5,0;;;1,0;;6,0;1,0;1,0;;48,0;;;4,0;;1,0;;11,0;4,0;;58,0;;4,0;2,0;4,0;;2,0;13,0;1,0;;9,0;;1,0;;;;;1,0;;34,0;;;;;;;;;1,0;;;;;;;;8,0;;;;;;;;;;;1,0;31,0;1,0;5,0;32,0;;52,0;;3,0;1,0;1,0;;;;3,0;;;;;4,0;;2,0;;;14,0;;;;1,0;1,0;1,0;1,0;;;3,0;;6,0;;;;;;;;1,0;;;;;;;13,0;;;;12,0;;;;;;1,0;;3,0;;4,0;;;;2,0;1,0;;;;;;;;;;;2,0;;2,0;;8,0;8,0;1,0;;;5,0;;;3,0;;;3,0;;;1,0;6,0;;;;2,0;2,0;1,0;;;;;;;;;;1,0;4,0;1,0;2,0;2,0;;2,0;;1,0;41,0;;13,0;1,0;6,0;;1,0;;;10,0;;;61,0;;1,0;;;;;;11,0;;;;;1,0;1,0;2,0;;;;2,0;2,0;;6,0;1,0;;;;1,0;;;;1,0;;3,0;16,0;;;;;;;;;1,0;;14,0;;;1,0;;;2,0;;;1,0;;;2,0;1,0;;;;5,0;;2,0;;;;;;;;;;;1,0;;;;3,0;;;;;;;;;;;;;;;;;;30,0;5,0;;2,0;;;;;1,0;3,0;;;;;8,0;;4,0;;1,0;;1,0;;;;;3,0;;;;;3,0;;;;;;1,0;;;;;;6,0;;;;;;2,0;;;;;;4,0;;;17,0;;;;;;;;16,0;;2,0;5,0;;3,0;;;;;;;;3,0;;11,0;9,0;;1,0;;2,0;;1,0;1,0;9,0;4,0;;;;19,0;4,0;10,0;;;;4,0;;3,0;;;;;;;;6,0;;5,0;;;;;;;;;15,0;;8,0;3,0;;;;;;2,0;;;;;;;;;;6,0;;4,0;;;14,0;;;;;;;1,0;;;1,0;;2,0;2,0;;;;;;;;;;;;;;;;;;;;;;;;;;;;;6,0;;;;;;;;6,0;;;;;1,0;;;105,0;;;;;;1,0;;;;;;;;;;;;;;;;;;;;;;;
score;;;;5,0;6,0;;6,0;;;15,0;;;;71,0;;;27,0;;;;;;20,0;;;;;;;10,0;1,0;;1,0;;;5,0;3,0;1,0;;;85,0;17,0;;1,0;;;;;;1,0;2,0;;;;;10,0;4,0;;;10,0;;;;;106,0;;21,0;;41,0;;;1,0;;;;;;;;;36,0;;;13,0;;;;;;1,0;15,0;;;6,0;;;20,0;16,0;51,0;14,0;5,0;5,0;;;3,0;1,0;;1,0;1,0;;;;22,0;;;;7,0;10,0;;10,0;9,0;;;;;3,0;8,0;;1,0;;8,0;;;;;;1,0;;;;;;;;;1,0;;;20,0;;;17,0;;;;;;;10,0;;;;;;;3,0;;;;;2,0;1,0;4,0;;;2,0;;;;;2,0;;;;;;1,0;;17,0;;2,0;;;;;;;;;;;;;;;1,0;;;;;;;;;;;;;;;;;;;;;6,0;;;;;;;1,0;;;1,0;;;3,0;;;;;;5,0;;8,0;1,0;;;;4,0;;;;;;;;2,0;;;;;;;;6,0;;;;;;;;;10,0;;;;;;;17,0;;;;;;;;;;;;2,0;4,0;;;;;;;;;;;;;;;;;;;2,0;;3,0;;;10,0;;;;;;;;;;;;;1,0;;;;;;;;;;;;;;;;;;;;;;;;;;;;;;;2,0;;;;;;;22,0;;;;;;13,0;21,0;14,0;;;;;;1,0;18,0;1,0;16,0;30,0;;5,0;3,0;;7,0;;16,0;9,0;7,0;;2,0;;3,0;;7,0;;2,0;1,0;;;19,0;;;2,0;;;;;;;;;;;4,0;;3,0;;;;;3,0;5,0;;;1,0;;;;;;41,0;;;3,0;;;57,0;;;;;;;;;1,0;;;17,0;;6,0;;;;;1,0;;4,0;3,0;;3,0;;;;;;;;;;;;;;3,0;;;;;;;;;;4,0;;;;;;;;;;;8,0;;24,0;;16,0;;;4,0;;;;;;;;;4,0;6,0;;;;;;;;;;;;;;;43,0;;;;;;;;;;16,0;;;;4,0;;;;;;3,0;;;;1,0;;;;;;;;;;;2,0;;;;;;;;;;;;;3,0;5,0;3,0;;;;;;;;;1,0;;;;;19,0;;;;;1,0;;;;;;;;1,0;;;;;;;15,0;;;;;;11,0;;;;;;;;;;;;;;;;;;;;;;;;;16,0;2,0;;;;;;;7,0;;;;;;;;1,0;;;;;2,0;;;;1,0;;;;;;;2,0;;;;;;;;;;;;;;;;;;;;;;;;;;;;;;;;;9,0;;;;;;;;;;60,0;;;;;1,0;;;;;;2,0;;;;;;;2,0;;;;;;;;;;;;;;;;;;;;;;;;;;;;;;;;;;;;;;3,0;;;;;;;;;;;;;;;;;;1,0;;;;;;4,0;4,0;;;;;;;;;4,0;;11,0;;;;;;;;;;;;;4,0;5,0;;;;;;;;;30,0;;;;;;;;;;;;;;;;;;;;;;;;;;;;;;;;;;;;;;;;;;;;;;;;;;;;;;;;;;;;;;;;;;;;;;;;;;;;;;;;;7,0;;;;;;;;;;;;;;;;;;;;;;;;;7,0;;;;;;;;;;;1,0;1,0;;;;;;;1,0;;;;;1,0;;;6,0;;;;;;;4,0;;;;;;;;;;;;;;;
search;;;;5,0;;28,0;;;1,0;;;;;57,0;;2,0;23,0;;;41,0;;;6,0;;;;2,0;;4,0;27,0;35,0;2,0;;2,0;;113,0;47,0;1,0;16,0;;108,0;41,0;;2,0;11,0;;;2,0;1,0;;19,0;;;;1,0;;;;1,0;12,0;;;4,0;;270,0;2,0;41,0;7,0;;;2,0;2,0;;;2,0;;;;2,0;3,0;90,0;;;5,0;47,0;;;4,0;;24,0;10,0;;;;1,0;;27,0;3,0;44,0;49,0;87,0;4,0;;4,0;6,0;31,0;3,0;4,0;51,0;;;20,0;121,0;;;;2,0;2,0;3,0;;;;6,0;53,0;;9,0;34,0;;5,0;;16,0;;;21,0;;;2,0;5,0;;;;5,0;;;6,0;4,0;14,0;;1,0;1,0;;11,0;2,0;;13,0;;;;;;;6,0;;;;7,0;;;2,0;8,0;;;;55,0;;;;;;3,0;;;;2,0;;;;;21,0;;;2,0;;;;;;;;;;;;;;5,0;;;;;6,0;3,0;;;;;;;;7,0;34,0;2,0;4,0;;;;6,0;;;;;;63,0;2,0;;;;;;3,0;;;;;;27,0;2,0;2,0;;;;;;4,0;;;;;;;;;;4,0;;;;;8,0;90,0;;;;4,0;;;;7,0;;;;;;;11,0;;1,0;6,0;;;;;;;;;5,0;;;;;;;1,0;;;;;1,0;1,0;;;;;;;1,0;;1,0;;5,0;60,0;;3,0;;;;;;1,0;;;;;5,0;;;;3,0;;;8,0;;;;;;4,0;;;;;;;12,0;;;6,0;11,0;;;;;3,0;;2,0;24,0;;;;;;5,0;1,0;4,0;;;;14,0;;14,0;5,0;;1,0;;16,0;2,0;8,0;;3,0;1,0;26,0;12,0;10,0;13,0;8,0;6,0;44,0;1,0;;;11,0;;5,0;;11,0;3,0;2,0;10,0;;;3,0;;;5,0;3,0;;;;5,0;;5,0;;;2,0;24,0;1,0;4,0;;;;;15,0;;3,0;;1,0;28,0;;;;;1,0;;;5,0;6,0;;6,0;;4,0;;;;;;;1,0;;;1,0;;;5,0;;;2,0;;;;;1,0;11,0;3,0;;;;2,0;;4,0;;8,0;;22,0;6,0;;56,0;;;9,0;;;2,0;2,0;;;;;;;;;1,0;;10,0;14,0;;;;;;;;;;1,0;;;;;;;;;;;;;;;;;;;10,0;;7,0;6,0;;23,0;;5,0;;;;1,0;;;;4,0;;;3,0;1,0;7,0;1,0;;;;;;7,0;;;;;2,0;;;;;;1,0;;;;;;;;;;;;;;;;4,0;;;47,0;;;;;8,0;;2,0;2,0;;;;29,0;;;;;;;;;;;;;;;3,0;1,0;24,0;;;13,0;5,0;;1,0;;;;;;;20,0;;;;;;;1,0;3,0;;;3,0;;;;;;;;6,0;;;1,0;;1,0;6,0;;;2,0;;;;;2,0;;;;6,0;;;;;14,0;;6,0;44,0;2,0;;3,0;;;;3,0;5,0;;;;;;;;;;;1,0;;;;;2,0;18,0;15,0;;;;;;;;4,0;;;;;;;;;;;;;;;;;;;;;;3,0;36,0;;;;;;;4,0;;;;;;;1,0;;;;;;;;;;;;;;;;;;;;;;;;;;;;;;;;;;;;;;1,0;4,0;;;;;;;;;;2,0;;;;;6,0;;;;;2,0;;;;;;;;;;;1,0;;;;;;;;;;;;;21,0;;8,0;;2,0;;;;;;;1,0;;;;;;;;;3,0;2,0;;;;1,0;;;12,0;;;;;;;1,0;;;3,0;;;2,0;4,0;11,0;;;2,0;;;1,0;;;;3,0;;;;;;;3,0;;;;2,0;;;;;3,0;;;9,0;;;;;;;;;1,0;;;;;;;;;;;;;1,0;3,0;1,0;9,0;2,0;;;;;;;;;4,0;;;;;;;;;;;;;;;;;;;;;;;;;;;;2,0;;;;;;;4,0;;;7,0;;;;;;1,0;;;;;33,0;;;;;7,0;1,0;;;;;
selectable;;;;5,0;1,0;1,0;4,0;2,0;;;;;;3,0;1,0;;1,0;;;;;;3,0;;;;3,0;3,0;1,0;;26,0;2,0;;;;2,0;7,0;2,0;;;4,0;26,0;;7,0;36,0;;;27,0;;;;;;;44,0;;1,0;;1,0;3,0;;;;;61,0;;41,0;;;;;;12,0;;;;;;;2,0;22,0;;22,0;;1,0;;;1,0;;;1,0;;;;;;;7,0;41,0;1,0;5,0;1,0;;;20,0;1,0;2,0;2,0;;;;2,0;;2,0;;;;7,0;14,0;12,0;;;3,0;4,0;;1,0;13,0;;;;1,0;;;3,0;;;27,0;;5,0;;;;;;11,0;;6,0;;;;;;1,0;;2,0;;;;;;;;;8,0;;;;;;;;;;4,0;;;;;7,0;;;;9,0;;;;1,0;;6,0;;;;;;;;;;;;;;;;;1,0;1,0;;;1,0;1,0;1,0;;;;;;;;;;;;;1,0;;40,0;;2,0;;;;;;;;;;;;;;;;;12,0;;15,0;;;;;;;;;1,0;1,0;;;;;;;;;;1,0;;4,0;;;;3,0;;;;;;;;;1,0;;2,0;;;;1,0;;;;;;;;;;;;;;;;;;;1,0;;7,0;;;;;;;;;;;1,0;4,0;;;;;;;;;;;;;;;;;;;1,0;2,0;;;;;2,0;;;;;;;;;;;;8,0;;;;;3,0;;;;;;;;;;;;2,0;;;;;26,0;;1,0;;1,0;;;;;1,0;;;;3,0;;4,0;;2,0;;;;21,0;;;;1,0;;;1,0;;;;;;4,0;1,0;;;;;;6,0;;;;2,0;;;;;;1,0;5,0;1,0;;;2,0;;;;1,0;;;;;;;;55,0;;;;8,0;;;;;;;3,0;7,0;;;;;;;2,0;;;;;1,0;22,0;;;;;;;;;6,0;;;;;;6,0;;;;;12,0;;;1,0;;7,0;;;;;;;;;;;;2,0;3,0;5,0;;;;;1,0;;;;;;;;;;;;;;;;;;;1,0;5,0;;;;;;;1,0;;;1,0;;;;;2,0;2,0;;16,0;;;;;;3,0;;;;;;1,0;;;;;;;;;;;;;;;;;;;;2,0;;;;;;;;;;;;;;;;2,0;;1,0;;;;;1,0;;;;;;1,0;;1,0;;3,0;;;;;;;;;;;;;;;;;;;;;;;;;;;;;;;;;;;;;;6,0;;;;;;;;;;;;3,0;;;;;4,0;;;2,0;;;;;;;;;;;;;;1,0;;;;7,0;;;;;1,0;;;;;;;;1,0;;;;;;1,0;;;;;;;;;;;;;;;;;;;2,0;;;;;;2,0;;;;;7,0;;1,0;;;;;;;;;;;;;;;;;;;;;;;;;;;;;;;;;;;;;;;;;;;;;;;;;;;;;;;;;;;;;;;;;;;;;;;;;;;;;;;;;;;;;1,0;;;;;;;;;;;;;;;;;;;;1,0;;;;;;;;;1,0;;;;;;;;;1,0;;;;;;;;;;2,0;;;3,0;;;;;;;;;;;2,0;;;;3,0;;;;;;2,0;;;;;;;;;;;;;;;;;;;;;;;;;;;;;;;;;;;;;;;;;;;;;27,0;;;;;;;;;;;;;;;;;;;;;;;1,0;;;;;;;;;;;;;;;;;;;;;;1,0;;;;;
selection;;;;2,0;3,0;29,0;2,0;2,0;1,0;5,0;;1,0;1,0;87,0;;;58,0;14,0;4,0;1,0;1,0;;10,0;2,0;7,0;;;;13,0;4,0;72,0;10,0;;2,0;;48,0;2,0;;4,0;5,0;14,0;184,0;;9,0;105,0;4,0;;5,0;3,0;;;;;17,0;6,0;1,0;7,0;;5,0;23,0;;;22,0;2,0;216,0;9,0;71,0;;4,0;;1,0;19,0;8,0;;;;;;5,0;1,0;106,0;;46,0;3,0;11,0;;;3,0;;1,0;6,0;2,0;;;3,0;;87,0;;120,0;32,0;8,0;10,0;;3,0;28,0;21,0;3,0;14,0;;1,0;;15,0;31,0;4,0;;13,0;2,0;10,0;5,0;5,0;1,0;;113,0;1,0;1,0;9,0;56,0;;;;2,0;;;78,0;;;19,0;3,0;12,0;;;1,0;;;;;26,0;13,0;14,0;;3,0;29,0;;;1,0;3,0;;3,0;;;;21,0;1,0;;1,0;;58,0;;2,0;10,0;1,0;;;13,0;;3,0;1,0;;19,0;;;;;3,0;;;7,0;;24,0;1,0;;;;4,0;2,0;4,0;;;;1,0;;15,0;1,0;1,0;;6,0;1,0;2,0;;1,0;3,0;1,0;3,0;;;;17,0;4,0;1,0;1,0;1,0;32,0;;3,0;;;42,0;;;3,0;;;8,0;;1,0;7,0;1,0;;;4,0;;1,0;;;;129,0;2,0;3,0;5,0;;;;;5,0;;4,0;;2,0;1,0;;8,0;25,0;3,0;22,0;;;;;;2,0;;2,0;1,0;4,0;;1,0;4,0;6,0;;1,0;;;1,0;;14,0;;6,0;4,0;62,0;;;13,0;;;;;2,0;4,0;;;;;;1,0;;;;1,0;;34,0;;;;;;;22,0;;6,0;;22,0;24,0;1,0;4,0;4,0;;;;4,0;;;;;;9,0;;;;3,0;;4,0;;;;;3,0;7,0;1,0;;;;;;;11,0;;7,0;;41,0;;;;;7,0;;9,0;1,0;;;25,0;;;3,0;1,0;4,0;;;4,0;4,0;4,0;85,0;3,0;;;5,0;44,0;2,0;;;11,0;;10,0;2,0;13,0;;19,0;;13,0;42,0;7,0;;85,0;;8,0;;5,0;4,0;5,0;;;;;1,0;5,0;13,0;9,0;;;;;;2,0;;2,0;3,0;180,0;6,0;48,0;15,0;;15,0;2,0;32,0;1,0;4,0;1,0;1,0;10,0;26,0;;;7,0;7,0;;;13,0;;;234,0;;11,0;9,0;4,0;1,0;2,0;;1,0;3,0;;2,0;13,0;2,0;4,0;8,0;;;1,0;;5,0;;;6,0;15,0;35,0;;;;6,0;3,0;1,0;1,0;;29,0;11,0;3,0;1,0;25,0;;6,0;2,0;;;5,0;;;;19,0;;2,0;;8,0;8,0;;21,0;;;2,0;2,0;1,0;;2,0;1,0;15,0;;1,0;6,0;;;;;12,0;;1,0;;32,0;9,0;;;;;;25,0;;4,0;6,0;;1,0;20,0;;2,0;;;;1,0;3,0;4,0;;;;;;;8,0;;5,0;;;;;1,0;;4,0;1,0;1,0;3,0;;9,0;;2,0;7,0;3,0;3,0;6,0;;15,0;7,0;;1,0;;;6,0;;6,0;;6,0;;;16,0;19,0;;;;;;;1,0;;1,0;4,0;;2,0;2,0;;11,0;7,0;6,0;6,0;8,0;2,0;12,0;;1,0;;;6,0;;7,0;3,0;11,0;;6,0;2,0;2,0;9,0;;2,0;;;3,0;1,0;;4,0;;2,0;;;1,0;2,0;;1,0;;7,0;3,0;;1,0;;2,0;;;;4,0;;8,0;;4,0;2,0;10,0;;2,0;;;2,0;;16,0;12,0;;;;;3,0;13,0;;1,0;3,0;;14,0;;;11,0;2,0;;;;3,0;;;;;;4,0;4,0;;3,0;;;5,0;;;;;;;1,0;;6,0;;;;;1,0;;1,0;;1,0;;5,0;;;2,0;;7,0;1,0;;;1,0;12,0;;;;;;;;;;1,0;;;;;1,0;;;;;;8,0;1,0;3,0;4,0;;;;;;;1,0;;;;;;;;1,0;;;;;;14,0;;;;;;;;;;;;;;;1,0;1,0;;;;12,0;7,0;2,0;;3,0;;4,0;3,0;;5,0;;;10,0;5,0;6,0;;;4,0;3,0;8,0;;;;;26,0;1,0;1,0;;;;;3,0;3,0;4,0;5,0;;;;;;;281,0;7,0;;8,0;7,0;2,0;1,0;;;;;;4,0;;6,0;;;1,0;1,0;;;;2,0;1,0;;4,0;4,0;;4,0;;;;;16,0;;1,0;1,0;;;;2,0;;;1,0;;;;;2,0;;;;1,0;;;;1,0;1,0;;;;;;;8,0;5,0;1,0;2,0;3,0;;2,0;16,0;;28,0;;;;;;;2,0;;;;1,0;;;;;;;;;;;;;;;3,0;;;;;;;;;;;;;;;;;;;10,0;;;;;2,0;2,0;1,0;1,0;;4,0;;;;;1,0;;;;;2,0;1,0;;;7,0;;1,0;1,0;;;;;1,0;;;;;;;;;;;;1,0;1,0;;;;;
semiconductor;;;;4,0;;122,0;57,0;17,0;;;;2,0;;11,0;;6,0;24,0;5,0;34,0;3,0;62,0;;9,0;;3,0;;;4,0;;;64,0;2,0;;8,0;;;4,0;;22,0;2,0;;291,0;;5,0;4,0;92,0;;71,0;;;;;17,0;3,0;1,0;;210,0;;1,0;2,0;;;24,0;;161,0;;340,0;3,0;;13,0;6,0;42,0;152,0;;;2,0;19,0;;;5,0;72,0;14,0;;;65,0;;;21,0;18,0;;;6,0;12,0;4,0;1,0;;159,0;10,0;270,0;;53,0;2,0;;3,0;13,0;4,0;;;;3,0;;12,0;1384,0;4,0;;;;2,0;;242,0;;;64,0;1,0;1,0;;27,0;;2,0;12,0;9,0;1,0;;56,0;;;22,0;;;;;7,0;;;9,0;3,0;25,0;361,0;;4,0;1,0;17,0;;4,0;;55,0;;1,0;;9,0;48,0;62,0;;4,0;50,0;7,0;25,0;37,0;1,0;1,0;7,0;8,0;3,0;84,0;;8,0;10,0;45,0;;;;;;75,0;;33,0;4,0;;1,0;;;;;2,0;;1,0;;2,0;;;38,0;333,0;;;;2,0;19,0;50,0;;13,0;;;2,0;;1,0;2,0;20,0;9,0;;;32,0;3,0;;118,0;1,0;21,0;390,0;;;;3,0;;7,0;;;;1,0;8,0;;3,0;;;;;2,0;6,0;32,0;3,0;95,0;;;1,0;23,0;7,0;828,0;56,0;14,0;217,0;12,0;2,0;53,0;2,0;292,0;1,0;1,0;;;25,0;;5,0;;42,0;1,0;;;;3,0;1,0;1,0;;;;1,0;;;;14,0;;46,0;;;;;;1,0;;27,0;;;;;;;;;;1,0;;1,0;65,0;1,0;;7,0;;1,0;;47,0;;2,0;2,0;2,0;4,0;13,0;4,0;5,0;;3,0;;10,0;;;;;;;;;;;;;;;;;;;;;;;;;3,0;;;;14,0;4,0;;;;;;;;;;;;;;;2,0;2,0;;;;;1,0;45,0;;;;;9,0;;;4,0;;;;;;;5,0;2,0;;;;;4,0;10,0;4,0;1,0;4,0;;;;;;;;;7,0;;2,0;;;;;;1,0;22,0;;17,0;;;;;25,0;;10,0;;;;5,0;2,0;6,0;1,0;;6,0;;;;;;;;1,0;;22,0;;;;;;;;;;1,0;1,0;;;;;;;;;;;1,0;;;56,0;;1,0;;;;;1,0;;;1,0;3,0;;;5,0;;;;;1,0;;;;;;;;;;2,0;1,0;;;;;;;;;4,0;;4,0;;1,0;1,0;1,0;3,0;;;1,0;;;;;;;;;2,0;;5,0;;;;;7,0;6,0;15,0;;;;;;;;;;;;1,0;;2,0;;;1,0;;;;;;;;;;;;;4,0;1,0;;;;;9,0;;34,0;;1,0;;3,0;;;;7,0;;;;12,0;;;;2,0;;;;;;;;;;;4,0;85,0;;;;;;;;;;11,0;;;3,0;;;;;;;;;;;;10,0;;;;10,0;;;;1,0;;55,0;;;;;;9,0;;2,0;;1,0;1,0;;;;;;;;;;9,0;;;;;65,0;;;;;;;;;;;;;;;3,0;;9,0;;;2,0;;1,0;;;45,0;;8,0;;;8,0;;;3,0;;;;;;1,0;;;1,0;;;3,0;;2,0;;6,0;;;5,0;;2,0;;;;;;;;;;2,0;;;;;;;;;;;3,0;;2,0;1,0;;;;;;1,0;;;;;;;;;;;;29,0;;;;;;1,0;;;;;;9,0;;;;;;18,0;;;18,0;10,0;30,0;2,0;1,0;1,0;8,0;2,0;237,0;81,0;;;8,0;;4,0;95,0;1,0;5,0;;81,0;2,0;;2,0;;;7,0;13,0;2,0;;;;;;;4,0;;;5,0;;8,0;5,0;10,0;;;50,0;;;;;;;;;;;;;;;;;3,0;;2,0;;4,0;;;;;;;;;20,0;;;;;;;1,0;;;;7,0;;;;;3,0;;;;;;;;;;;;1,0;1,0;;;;;;;;;3,0;;;;;;2,0;22,0;;2,0;4,0;2,0;;;2,0;;;;;;;;;;;;;;;7,0;;;;;8,0;;;;;;1,0;;;;;;;;4,0;;;;;;;;1,0;;;;;;;12,0;;;;;;;;;;;;;;7,0;;;;;;;;;;;;;;;;;1,0;;6,0;;;;
sensitivity;;;;6,0;7,0;11,0;2,0;;;;;7,0;;8,0;5,0;;10,0;21,0;;20,0;;;14,0;;2,0;6,0;3,0;;;2,0;11,0;1,0;22,0;24,0;;3,0;2,0;;1,0;1,0;5,0;38,0;;;;;;20,0;2,0;;57,0;;;20,0;1,0;;;;;44,0;;5,0;7,0;;68,0;;18,0;;1,0;;;72,0;37,0;;;;;3,0;;20,0;24,0;;34,0;;6,0;;;19,0;;3,0;16,0;;;;2,0;;82,0;;10,0;7,0;;36,0;;1,0;7,0;1,0;;;;;1,0;5,0;8,0;;;;2,0;;;59,0;;;11,0;12,0;37,0;5,0;14,0;;;;26,0;;;55,0;;;;;2,0;;;;;;21,0;2,0;5,0;5,0;12,0;;;6,0;3,0;;;1,0;;;;;;3,0;;5,0;6,0;;;;;6,0;1,0;58,0;1,0;5,0;;;;;1,0;;;;;1,0;;;9,0;;1,0;;;;;2,0;;;;10,0;;;;;1,0;;1,0;1,0;;;;;;;;;;;6,0;;;;;6,0;;13,0;;;7,0;;;;;1,0;20,0;19,0;;;;;;16,0;;;;;;8,0;;;1,0;;;;;;;8,0;;6,0;;;1,0;3,0;;;;;;5,0;3,0;2,0;;;17,0;3,0;;;;8,0;;2,0;;;;;;;;2,0;1,0;;;;;;;;6,0;;;;;;;;;;;;10,0;23,0;;;;;;;;;;1,0;1,0;5,0;1,0;;;;4,0;;;;;;;;26,0;;;;;;;;;;;;;;;;;;;;;;;7,0;;;4,0;;;;;3,0;1,0;5,0;;1,0;;;28,0;;3,0;1,0;;;;;19,0;;;;;5,0;1,0;14,0;2,0;;;3,0;;55,0;;25,0;;1,0;4,0;8,0;;;;11,0;;;;;;;;;;;1,0;1,0;;2,0;;;;3,0;;11,0;;12,0;;1,0;;;2,0;;23,0;;4,0;;5,0;2,0;8,0;;;16,0;5,0;;;;;;;2,0;;1,0;;;2,0;;;2,0;;3,0;;;4,0;;;;;;;;;;;;;;;;;;1,0;;;;2,0;;3,0;;1,0;;9,0;;;;1,0;;;;;;;;1,0;;;;;;;;;2,0;;;1,0;;;;;;;;;;;;;;;;;;;;;;;;1,0;;;1,0;;2,0;;4,0;;;;;;;;;;;;;;;;2,0;;;2,0;;;;;;;;;;;;;;;;;;;;;;;;;2,0;;;;5,0;;;;;;;;;;;;;;4,0;13,0;;;;;;;;7,0;;;5,0;;;4,0;;;;;;;;;;;;;;;;;3,0;;1,0;;;;;;;;;;;;;;;;;;;;;1,0;;2,0;;;;;;4,0;;;;;;;;;;;;;;;;;;;;1,0;;;;;;;1,0;;;;;;2,0;5,0;;;;;3,0;;;;;;2,0;;;;2,0;;;;;1,0;;;;;;;;;;;;;;;;;;;;;3,0;;1,0;;;;;;;;;;1,0;;;;;;;;;;;2,0;;8,0;;;;;;;;;;;;;;;11,0;;5,0;;3,0;2,0;1,0;8,0;;;;11,0;;;;;;;34,0;;;;;;;2,0;;12,0;;4,0;;10,0;;;;;5,0;;1,0;;;;;;;;;;;;;;;;;;;;;;;;;;;;;;;10,0;;;;;;;;;;;2,0;;;;;;;3,0;;3,0;;;;;;;;;;;;;;;;;;;;;;;;;;;;;;;;;5,0;;6,0;;;;;;;;;;;;;;;;;1,0;4,0;1,0;;;;;;;;;;;;;;2,0;;2,0;;;;;;;1,0;;;;;;;;;;;14,0;;;;;;;;;;;;;;;;;;;;;;;;;;;;;;;;;;;;;
separate;;;;9,0;1,0;30,0;65,0;17,0;;3,0;3,0;;7,0;45,0;;;70,0;;18,0;;3,0;;9,0;4,0;12,0;;1,0;22,0;5,0;2,0;44,0;19,0;;2,0;;43,0;12,0;4,0;46,0;;31,0;143,0;2,0;12,0;30,0;17,0;1,0;53,0;;;2,0;;2,0;14,0;6,0;19,0;68,0;;;11,0;1,0;;21,0;;204,0;2,0;60,0;;4,0;4,0;17,0;145,0;63,0;1,0;2,0;;8,0;10,0;6,0;1,0;52,0;1,0;6,0;9,0;40,0;5,0;;51,0;6,0;;3,0;1,0;8,0;;10,0;4,0;48,0;9,0;107,0;30,0;66,0;30,0;2,0;8,0;8,0;32,0;;;;3,0;;4,0;49,0;1,0;1,0;;5,0;23,0;19,0;82,0;1,0;;64,0;6,0;5,0;5,0;52,0;4,0;;7,0;31,0;;;53,0;;;19,0;;1,0;3,0;;14,0;1,0;;27,0;2,0;17,0;13,0;20,0;4,0;;3,0;25,0;;;;4,0;1,0;;;28,0;26,0;1,0;;5,0;;21,0;13,0;;8,0;7,0;;15,0;31,0;1,0;3,0;;4,0;5,0;;2,0;;3,0;4,0;1,0;2,0;10,0;;12,0;13,0;3,0;;17,0;;7,0;;46,0;3,0;2,0;1,0;9,0;15,0;4,0;;;;60,0;5,0;1,0;20,0;2,0;7,0;2,0;1,0;;11,0;14,0;5,0;3,0;14,0;10,0;5,0;;10,0;17,0;1,0;87,0;;13,0;2,0;;22,0;9,0;2,0;7,0;4,0;5,0;1,0;1,0;;;10,0;10,0;2,0;2,0;9,0;;7,0;34,0;2,0;6,0;21,0;13,0;25,0;76,0;7,0;17,0;39,0;;;6,0;2,0;1,0;19,0;7,0;16,0;2,0;32,0;1,0;36,0;1,0;8,0;5,0;6,0;1,0;;7,0;9,0;6,0;3,0;2,0;4,0;19,0;20,0;;;15,0;4,0;30,0;1,0;13,0;10,0;;;;1,0;33,0;6,0;16,0;2,0;12,0;;19,0;9,0;;7,0;;3,0;;36,0;;1,0;4,0;2,0;1,0;;5,0;2,0;1,0;19,0;11,0;63,0;8,0;2,0;2,0;1,0;;;25,0;10,0;5,0;;2,0;7,0;8,0;1,0;13,0;;;;11,0;6,0;1,0;2,0;1,0;1,0;27,0;20,0;4,0;15,0;;12,0;1,0;1,0;14,0;1,0;8,0;9,0;31,0;21,0;;;;;;4,0;1,0;18,0;;;1,0;;;7,0;4,0;;;;2,0;;29,0;14,0;;;3,0;11,0;;3,0;;6,0;;3,0;6,0;47,0;;2,0;;24,0;3,0;;;13,0;5,0;7,0;15,0;12,0;;1,0;18,0;3,0;;6,0;;;4,0;2,0;;;;5,0;;;;;;30,0;7,0;6,0;2,0;;6,0;;3,0;;;;2,0;6,0;5,0;;3,0;8,0;4,0;3,0;;;;;11,0;;5,0;1,0;;2,0;6,0;18,0;;3,0;1,0;2,0;11,0;2,0;2,0;17,0;;;1,0;;;;2,0;2,0;2,0;7,0;6,0;;;1,0;2,0;2,0;10,0;5,0;1,0;3,0;;;4,0;;1,0;;5,0;;;10,0;3,0;;2,0;;;3,0;4,0;7,0;1,0;1,0;;2,0;3,0;9,0;1,0;;6,0;;1,0;2,0;;1,0;;4,0;5,0;6,0;7,0;11,0;;1,0;;;2,0;2,0;;;12,0;5,0;1,0;12,0;;1,0;4,0;1,0;3,0;;2,0;;6,0;13,0;1,0;17,0;;;4,0;1,0;;2,0;1,0;3,0;;2,0;;;4,0;;;;4,0;6,0;;;;5,0;;2,0;;;;9,0;10,0;7,0;1,0;4,0;2,0;6,0;;1,0;12,0;2,0;1,0;6,0;10,0;;1,0;12,0;5,0;;2,0;;;;;;2,0;1,0;;1,0;;5,0;;5,0;;;;;;;2,0;4,0;10,0;7,0;;;;13,0;;;4,0;;;;;;;;;;4,0;17,0;2,0;3,0;;;1,0;;3,0;;2,0;5,0;;;;;3,0;;7,0;;;;2,0;5,0;2,0;;22,0;;3,0;2,0;6,0;;1,0;;;;;2,0;24,0;3,0;12,0;;;1,0;;;5,0;;;;;;3,0;4,0;1,0;3,0;4,0;1,0;;;;4,0;;13,0;;;1,0;;4,0;2,0;3,0;10,0;12,0;2,0;;1,0;;;;;;;;1,0;;4,0;;;;;5,0;1,0;2,0;;;3,0;4,0;;;;1,0;;4,0;;;;;1,0;;4,0;;6,0;;;;;;;;3,0;7,0;7,0;;;;2,0;;;3,0;;;1,0;;;;1,0;;2,0;;;4,0;;;;;;1,0;;;;;;10,0;;;;;;;;;1,0;;;5,0;2,0;14,0;3,0;9,0;;4,0;1,0;7,0;2,0;;2,0;;;;6,0;16,0;;1,0;2,0;32,0;;;;;2,0;2,0;;5,0;2,0;;2,0;;;2,0;1,0;;;2,0;;1,0;1,0;;;2,0;4,0;4,0;;;1,0;;;1,0;;1,0;2,0;;;;;2,0;;1,0;6,0;3,0;11,0;2,0;;;;;;;;;3,0;1,0;21,0;;;;;2,0;;;;;;;1,0;;;;;;2,0;1,0;;;;;6,0;;;;;;;3,0;;1,0;;;1,0;;;;;;;4,0;3,0;;2,0;;;1,0;;;9,0;17,0;1,0;2,0;;;;1,0;8,0;10,0;;;;;9,0;;;;;;2,0;2,0;8,0;;;4,0;1,0;;;;;;;;;;;;2,0;2,0;1,0;;;;;21,0;;;2,0;;;;6,0;;;;1,0;;1,0;;;1,0;;;;;;;3,0;;;;;;
separation;;;;3,0;;7,0;3,0;2,0;;;1,0;;1,0;2,0;;;2,0;;2,0;1,0;;;9,0;;;;;19,0;;;2,0;1,0;;4,0;;;;10,0;;;10,0;24,0;;;2,0;1,0;;6,0;;;3,0;;;;;;6,0;;;;;;2,0;;38,0;;10,0;;;;;15,0;;;;3,0;1,0;;;;5,0;2,0;;;7,0;;4,0;9,0;1,0;;;;;;;1,0;6,0;1,0;11,0;1,0;7,0;2,0;7,0;;;;;;;;;11,0;;;;;;;;10,0;;;6,0;3,0;;1,0;5,0;;1,0;;4,0;;;11,0;;;2,0;;;;;2,0;;;;;;12,0;5,0;;;;1,0;;;;;;;;;;;1,0;;;1,0;7,0;;;8,0;;;3,0;;1,0;;;2,0;;;;;1,0;;;;;15,0;;;5,0;;;;;;3,0;;;;;;;1,0;;;;;6,0;;;;;;;6,0;;;;1,0;;;;2,0;12,0;7,0;;1,0;1,0;;;1,0;3,0;;;1,0;;;;;;;;;;10,0;4,0;9,0;2,0;;;;;;;;1,0;;;;;;6,0;2,0;;;3,0;;;;;2,0;2,0;;;;;;;;;3,0;8,0;;;;;2,0;4,0;1,0;;;;;;37,0;;;;;;;;;;;;2,0;8,0;;;1,0;;;;;;1,0;;4,0;10,0;;;;;;;;;1,0;;;1,0;;;;;;;;;;;;;5,0;7,0;2,0;;;;;;1,0;;;;;;;;;;;1,0;;14,0;;;;;;5,0;3,0;7,0;;;3,0;1,0;5,0;1,0;;;;6,0;;3,0;;;;;1,0;;;;;3,0;;;;;1,0;;;;6,0;;;;;3,0;4,0;;4,0;;;;;1,0;;;;;;1,0;;;;;2,0;;;;;;;2,0;;;;;;;;;;1,0;;;;;;4,0;;4,0;;1,0;;;;;;;;;;;;;;;1,0;2,0;;;;;1,0;;2,0;;;10,0;;;;;;;;;10,0;;2,0;;2,0;1,0;;;;;;;;;;;;;1,0;;4,0;;1,0;;;;3,0;;1,0;;;;;;;;;;;;5,0;;2,0;;3,0;;3,0;2,0;;1,0;;;;;;;;;;;;;;;;;;;;1,0;;2,0;1,0;;;;;;;1,0;;;;;;2,0;;;;;3,0;;;;2,0;;;3,0;;1,0;;;;;;;;;;;;1,0;;;;1,0;;;;;;;;;3,0;;;;;;;;;;;;;;;;;;;;;;;1,0;;2,0;;;;;;;;;;;;;;6,0;;;;;;;;;;;4,0;;8,0;;;;1,0;;;;;;2,0;;;;;;;;1,0;;;;;;;;1,0;1,0;;;;2,0;;;1,0;;;;;;;;;;;;;;;;;;;;1,0;;;;;;;;;;;;4,0;;;;2,0;1,0;;;;;;;;;;;;;;;;;;;;;;;;;;;;;;;;;1,0;;;;;;;;;;;;;;;3,0;;;;;;;;;2,0;;;;;;;;;;;;;;;;;;;;;;;;;10,0;;;;;;;;;;;;;;;;;;;;;2,0;;;;;;;;2,0;1,0;;;;;;;;5,0;;;;;;1,0;;;;;;;;;;;;;;;;;;;;;;;;;;;;;;;;;;;;;;;;;;2,0;8,0;;;;;;;;;;;;;;;;;;;;;;;;;;;;;;;;;;;;;;;;;;;1,0;;;;;;;;1,0;;1,0;;1,0;5,0;;;;;;;;;;;;;;;;;;;;2,0;;;;;;;;;;;;;;;
series;;;;1,0;4,0;10,0;10,0;2,0;;;;1,0;;24,0;;;93,0;;;;;;7,0;4,0;;;;2,0;;2,0;13,0;4,0;;;;41,0;4,0;;;;31,0;19,0;;28,0;27,0;;;4,0;;;;;;;3,0;;20,0;;;35,0;;;;;448,0;2,0;41,0;;2,0;;;3,0;32,0;;;;;;;5,0;44,0;;2,0;2,0;14,0;4,0;1,0;14,0;;6,0;19,0;;1,0;;1,0;;33,0;;12,0;27,0;12,0;4,0;;2,0;5,0;8,0;6,0;2,0;;;;44,0;9,0;;6,0;3,0;;29,0;9,0;10,0;34,0;;38,0;9,0;2,0;3,0;21,0;;;;18,0;;;18,0;1,0;;16,0;;;;;5,0;;;;1,0;;16,0;12,0;;;;2,0;1,0;;;;;;;;28,0;3,0;4,0;;1,0;29,0;6,0;;3,0;24,0;;;2,0;;10,0;;9,0;;;;;;;3,0;;5,0;;168,0;;;;;;;40,0;1,0;2,0;;;;;;;7,0;9,0;4,0;;;3,0;3,0;2,0;;;;;4,0;9,0;2,0;16,0;1,0;2,0;;;;;15,0;;;6,0;3,0;;;1,0;12,0;;2,0;1,0;12,0;12,0;;1,0;2,0;;;11,0;;;5,0;;;;6,0;3,0;;9,0;;3,0;;;;1,0;8,0;;1,0;;;23,0;;10,0;;;4,0;1,0;;;1,0;4,0;1,0;;;;2,0;;1,0;;3,0;;2,0;;11,0;;;;;;;2,0;;;;;;6,0;;;;;;8,0;;;;3,0;;;6,0;;1,0;;;34,0;;1,0;;;;;14,0;;18,0;;;;7,0;;;;;;;;;;;12,0;6,0;8,0;;;;9,0;;;2,0;;1,0;2,0;28,0;;;;;2,0;;;1,0;2,0;8,0;;;;1,0;1,0;2,0;;;4,0;4,0;3,0;26,0;3,0;1,0;;1,0;2,0;;1,0;;2,0;1,0;1,0;;;;2,0;;6,0;;;;22,0;;;2,0;6,0;1,0;;16,0;2,0;;10,0;;3,0;7,0;1,0;;;;;;6,0;;3,0;;37,0;;3,0;;;;;;1,0;;1,0;4,0;;4,0;8,0;;;3,0;;;;;;;6,0;;11,0;;;;;;4,0;5,0;;6,0;;;4,0;;;;;;;3,0;;5,0;8,0;;8,0;;10,0;;;5,0;;;4,0;;52,0;16,0;;1,0;9,0;;;;;1,0;;;;;1,0;;14,0;;2,0;1,0;;;;1,0;1,0;3,0;3,0;14,0;;;1,0;;;;;7,0;;2,0;;;;;;;;2,0;;;;;;2,0;;5,0;8,0;;;;;1,0;10,0;;;;4,0;;;;1,0;;;16,0;;;;;3,0;;;3,0;;;;;1,0;;;;;6,0;1,0;;4,0;;;;;;3,0;3,0;;;;;8,0;;1,0;2,0;;;;;;;;;;;7,0;1,0;26,0;2,0;;;5,0;;;;;;;;;;;3,0;;6,0;5,0;;;;;;;;;7,0;;1,0;;;;;1,0;;;1,0;1,0;;;;;;7,0;;1,0;3,0;;;;5,0;2,0;;;;;3,0;1,0;2,0;;;;;;1,0;;;;1,0;;;;1,0;9,0;1,0;;;;;;;;;4,0;;;;;4,0;6,0;1,0;;;;9,0;1,0;;4,0;;;;;;;;;;;;;;;;3,0;;;;2,0;;;6,0;;;;;;;;7,0;1,0;;2,0;2,0;;2,0;;;;;;2,0;;;;;;;;2,0;;;;;;27,0;;;;3,0;;;;;;;;2,0;;;;;;;;;;3,0;;1,0;;;;;;;;1,0;13,0;;2,0;;;;;;1,0;2,0;;;;;;;2,0;3,0;2,0;;;;;2,0;;;1,0;;1,0;;1,0;;3,0;;;;2,0;;60,0;;;;1,0;3,0;3,0;;;1,0;;;4,0;;;;;;;;7,0;;;22,0;3,0;14,0;;;;5,0;7,0;2,0;2,0;;;;;;1,0;;1,0;2,0;14,0;1,0;2,0;1,0;;4,0;;;;;;;;;;;;;;;;;;;;;;;;;;;;;;9,0;;;;;;;;;;;;;;;;;4,0;1,0;;;;1,0;;;;;;;;;;;;;;;;;;;;;;;;;;;;;;;;;;;;;;;;;;;;;;;;;;;;;;2,0;;;;;;;3,0;;3,0;;;;;;
shot;;;;2,0;;8,0;;;;;;;;19,0;;3,0;4,0;;;;;1,0;;;;;;;3,0;;9,0;;;;;6,0;;1,0;;;17,0;1,0;;;23,0;4,0;;;;;;;;;1,0;;7,0;;;9,0;;;8,0;;154,0;;7,0;;;;;2,0;;;;;;;;3,0;10,0;;42,0;;;;;3,0;;;3,0;1,0;;;6,0;;;;4,0;15,0;16,0;3,0;;;5,0;3,0;3,0;4,0;;;;;;;;;;;16,0;3,0;;;4,0;;;1,0;;;;;12,0;;;3,0;;;2,0;;;;;8,0;;;1,0;;4,0;;;1,0;;;2,0;;16,0;;;;2,0;;;;;;;;;;;;;;;13,0;;;;;;;;;;16,0;;;;;16,0;;;;;;;2,0;;;;;;;;;;;;;;;2,0;;;;;;2,0;;;;1,0;;2,0;;;;5,0;;;7,0;;;2,0;;;4,0;;;;1,0;;;;;;12,0;;4,0;;;;;;;;;;;;;;;2,0;;;;;;1,0;;;;;;;;;;;;;;1,0;;;;;;;;;;;;;;9,0;;;;;;;;;;;;2,0;;;;;;;;;;1,0;;2,0;7,0;;1,0;;;;;;;;;;;2,0;;;;;;;;;;;;;1,0;;;;;4,0;;;;3,0;;38,0;1,0;;;;8,0;;;;;;13,0;;;;14,0;2,0;1,0;;1,0;;;11,0;;;;7,0;8,0;;;;;;1,0;6,0;1,0;1,0;;;2,0;;;;2,0;;;;5,0;1,0;;;;;21,0;;5,0;5,0;;;;;;;;;;;4,0;;;;;;;;3,0;1,0;;;13,0;;2,0;;;;;;2,0;;;1,0;;;;;;17,0;;;6,0;;;;4,0;;;;;;;;;;;;6,0;;;;;;;;1,0;;2,0;;8,0;2,0;;;;;;;;;;2,0;;;;1,0;1,0;;;;;;;;;;;6,0;;;;;;;;;;;;;;;;;;;;;;;;;2,0;;2,0;2,0;;;;;26,0;;;;5,0;;;;;4,0;;;;;;;;;;;;;;;;;;;;;;;;;;;;;;;;;;;;;;;3,0;;;;2,0;;;;;;1,0;;1,0;;3,0;;;;;;;;;;;1,0;;;;;;;;;2,0;;;;;;;;;;;1,0;;;2,0;;;;;;;;;;1,0;;;;;;;;;;;;;8,0;;;;4,0;;;;;;;;;;8,0;;;;1,0;;;;;;;;;;;;;3,0;3,0;;;;;;;;1,0;;;;;;;;;1,0;;1,0;;;;;;;;;;;;;;3,0;;;;;;;;;6,0;;1,0;;;;;;;;;;;;;;;;;;;;;;;;;;;;;;;;;;;;;;;;;;;;;;1,0;;;;;;;;;;;;;;;;;4,0;;;;;;;;;;;;;;;;;;2,0;;;;;;1,0;;;;;;;;;;9,0;;;;;;;;7,0;;;;;;1,0;;;;;;;;;;;;;;;;2,0;;;;;;;1,0;;;6,0;;;;;;;;;;;;;;;;;1,0;;;;;7,0;;;;;;;;;;;;;;;;;;;;;;;;1,0;;2,0;;2,0;3,0;;;;;;;;;;;;;;;;;;;;;3,0;;;;;;;;;;;;;;;;;;1,0;;;;;;;;;;;;;;;;;;;;;;;;;;;2,0;;;;;
sight;;;;5,0;;5,0;;;;7,0;;;;12,0;;;11,0;;;;;;;;;;;;;;10,0;3,0;;;;;4,0;;;;33,0;28,0;;22,0;14,0;1,0;;3,0;;2,0;7,0;;3,0;;7,0;2,0;9,0;;;;;;;;31,0;;36,0;;2,0;;;8,0;3,0;;;;6,0;;3,0;;10,0;;;;3,0;1,0;;4,0;;;;;;;3,0;;;;18,0;5,0;38,0;1,0;;;4,0;3,0;;;2,0;1,0;;2,0;;;;;;2,0;1,0;4,0;;;3,0;;;1,0;9,0;;;;2,0;;;1,0;;;24,0;17,0;;;;;;;3,0;;8,0;1,0;1,0;10,0;;1,0;26,0;1,0;;;;;;;;;6,0;;;;;;;3,0;;8,0;7,0;43,0;;;;;2,0;;;;;4,0;;;5,0;;3,0;3,0;;;;1,0;;;2,0;;;;;;;2,0;;;2,0;;2,0;13,0;;2,0;;;;;1,0;14,0;;5,0;;;15,0;;;;9,0;;;;;;4,0;;1,0;;;;6,0;4,0;;2,0;;;;1,0;;1,0;3,0;;;;;5,0;;;;3,0;;;;1,0;;2,0;;;;;;4,0;;;;;1,0;;2,0;13,0;;;;;6,0;;;;;8,0;;;;;;;;1,0;14,0;2,0;;;1,0;;;;;;;18,0;;3,0;;;;;;;;2,0;;;;5,0;1,0;;;;;;;;;;1,0;;;;;;;;;;;;;1,0;;10,0;;;;;;;7,0;1,0;;3,0;1,0;;;;;;;;;5,0;;;;;3,0;29,0;2,0;;;;;;8,0;2,0;;;;25,0;1,0;;;;;;;;;;;6,0;14,0;1,0;;;;6,0;;10,0;;;;;;1,0;;;1,0;9,0;;;;;;;;;;;1,0;;;;1,0;;;;;;;22,0;;;;;;3,0;;;;;37,0;;;;;;;;;;;;;;;;;;;;;5,0;10,0;1,0;;1,0;;;;;;9,0;;8,0;3,0;;;;;;;;;;;5,0;;;;;;;;;;;;6,0;;;;;;;;;1,0;2,0;;;;;;;;;;;;;;;;;;;11,0;;;;4,0;;;;;3,0;;1,0;;;;;4,0;;;;;;;;;;;;;;;;;;;;;;;9,0;6,0;;1,0;;;;;;;;;;;;;;;;;;;;;;1,0;;;;;1,0;;;;;;;;;;;;;5,0;;;5,0;;;;1,0;;;;;;;;;;;;;;;9,0;;;;;;;;;;;;;;1,0;1,0;;;;5,0;;;;;;;;;4,0;;;;;;;;;;;;67,0;;;;;;;;;;;;1,0;;;;1,0;;;;;;;;;;;;;;5,0;;;;;;;;;1,0;;;;;;;;;1,0;;;;;;;;;;;;;;1,0;;;;;;2,0;;;;;;;;;;;;;;;;;;;;;;8,0;1,0;;;;;;;;;2,0;;;;;;;;;;;;;;2,0;;;;;;;;;;;6,0;;;;;;;;;;;;;;;;;;;;;;;;3,0;;;;;;;;;1,0;;;;;1,0;;;;;;2,0;;;;4,0;;1,0;;;;;;;;;2,0;;;;;;;;;;;;;;;;;;;;;;;;;;;;;;;;;;;;;;;;;;;;;;2,0;;;;;;;;;;;;;;;;;2,0;;;;;;;;;;;;;;;;;;;;;;;;;;;;;2,0;;;;;;;;;;;;;1,0;;;;;;;2,0;;;;;;;;;;;;;;;1,0;;;;;;;;;;
slid;;;;8,0;;6,0;;22,0;;;;;;19,0;;;1,0;;1,0;;;;;;;;;;;;15,0;7,0;;;;;1,0;;;;6,0;4,0;6,0;22,0;3,0;5,0;;;;;;;5,0;;;;7,0;;;;;;;;4,0;;15,0;;2,0;1,0;2,0;1,0;;;;;;;;;1,0;;;;6,0;13,0;;1,0;;;;;3,0;;;;;6,0;2,0;1,0;51,0;1,0;;;;;;;;;;;2,0;;;;;;;6,0;;;;;;1,0;2,0;;2,0;;3,0;;;1,0;1,0;;;;;;;8,0;;;2,0;;;;;5,0;14,0;2,0;18,0;1,0;;1,0;;;;;;3,0;;;;;2,0;4,0;;;5,0;;;11,0;;;2,0;;;;;;;5,0;;;;4,0;1,0;3,0;;;;3,0;;4,0;4,0;;3,0;5,0;;;1,0;2,0;;;12,0;;5,0;13,0;28,0;7,0;6,0;;;8,0;2,0;1,0;;;;;1,0;;6,0;;9,0;1,0;;;;;4,0;;5,0;;;;;;;;;3,0;;1,0;;1,0;7,0;7,0;;;;;;;9,0;4,0;;;;;;;;;;;;;;;;;;;1,0;;;;;;5,0;;;15,0;;3,0;;;;;;;1,0;;6,0;;;;;;;;;1,0;;3,0;;1,0;;;6,0;;2,0;;;2,0;18,0;1,0;;;1,0;;;;;;;;;;14,0;;;;;1,0;;;1,0;4,0;1,0;1,0;;;7,0;1,0;;1,0;;;;;;;1,0;2,0;;;;;;;1,0;3,0;;;;;;7,0;;;4,0;;;2,0;1,0;;166,0;;;;;4,0;;;;;;;;10,0;4,0;;;;;;;1,0;;;5,0;3,0;;;;12,0;;7,0;;;;;;;;;;1,0;6,0;;;;;3,0;;2,0;6,0;;;;10,0;;;;1,0;;;;;1,0;;;;;11,0;;;;5,0;3,0;;;;;;;;;;;;;;;;;;;;;;;;;;;;;6,0;1,0;;;;;;;;;;5,0;;;2,0;;;;;;4,0;35,0;;3,0;;;;;;;;;;;;11,0;;;;;;;;;;;;;1,0;;5,0;10,0;;;;;;;;;;2,0;;;;;;;;;;;;;;;;;;;;;;;;;;;;3,0;;;;;;;;;1,0;;;1,0;1,0;;2,0;;;;;;;;;;3,0;;;1,0;;;;;1,0;;;;;;;;;;;;;;;;1,0;;;;;;;;;;;;;;;;;;2,0;;;;;;;;;;;;;;;;;;;;;;;;;;6,0;;;;;;;;;;;;;;;;;;;;;;;;;;;;;;;5,0;;;;;;;;18,0;2,0;;;;;;;3,0;;;;;1,0;;;8,0;;;;;;;;;;;;;;;8,0;;;4,0;;;1,0;;;;3,0;;;;;;;;;;;1,0;;115,0;;;;;;1,0;;;1,0;;;1,0;;4,0;;;;;;;;;;;;;;;;;;;;;;;;;;;;;;;;;;;;;;;;;;;;;;;;;;;;;;;;;;;;;;;;;;;;;3,0;;;;;;;;;;;;;;;;;;;;;;;2,0;;;;;;;;;;;;;;;;;4,0;;;;;;;;;;;;;;;;;;1,0;;;;;;;;;;;;;;;;1,0;;;;;;;;;;;;;;;;;;;;;;;;;;;;;;;;;;3,0;;1,0;;;;;;;;;;;;;;;;;;;;;;;;;;;;;;;;;;;;;;;;;1,0;;;;;;;;
software;;;;7,0;1,0;8,0;22,0;4,0;;;;;;13,0;;2,0;15,0;;2,0;3,0;3,0;;;;6,0;;;3,0;27,0;;50,0;3,0;7,0;5,0;;13,0;;;;7,0;22,0;64,0;;7,0;37,0;;3,0;5,0;;1,0;2,0;;;1,0;3,0;2,0;3,0;;;16,0;;;4,0;8,0;90,0;7,0;20,0;;1,0;;5,0;7,0;2,0;;;;;;8,0;22,0;29,0;;;1,0;28,0;;4,0;7,0;;;3,0;;;;;;1,0;3,0;13,0;1,0;7,0;;;12,0;15,0;73,0;11,0;27,0;;;;6,0;4,0;;;;9,0;5,0;3,0;5,0;5,0;;5,0;5,0;;48,0;70,0;;24,0;;10,0;;;14,0;;;5,0;1,0;2,0;;;;;;2,0;5,0;;;8,0;1,0;;;;;;;;;;;;4,0;;;;;1,0;;1,0;22,0;1,0;;25,0;;;;;;17,0;;;1,0;;1,0;;;6,0;;2,0;;1,0;2,0;;2,0;;;;;;;;;;1,0;2,0;19,0;;;;;;2,0;;;;;3,0;;;;;;;;;;2,0;;;1,0;;;1,0;1,0;;1,0;;;;;;;;;;13,0;;;;;;;;1,0;;;;;;;;2,0;;4,0;;;;;;1,0;;1,0;1,0;6,0;;;;;;;4,0;;;;;;;;5,0;;;1,0;;;1,0;2,0;1,0;8,0;;;;;;;;;16,0;;;21,0;;;1,0;;2,0;;3,0;1,0;;;37,0;5,0;;;;;;;1,0;;;;;;2,0;;;;;;;;;;;;;;;;;;;;1,0;;;;13,0;1,0;4,0;;1,0;;;2,0;11,0;;;;;;1,0;;4,0;2,0;1,0;14,0;3,0;;25,0;1,0;;1,0;;20,0;;;;;;53,0;;3,0;;1,0;;4,0;6,0;2,0;;3,0;;;;2,0;2,0;8,0;3,0;1,0;;;;21,0;4,0;3,0;;1,0;;;;3,0;;1,0;14,0;13,0;2,0;1,0;11,0;;1,0;2,0;;2,0;;;16,0;1,0;;;1,0;21,0;;2,0;;10,0;;;7,0;;3,0;2,0;7,0;2,0;;;2,0;12,0;;1,0;5,0;;2,0;1,0;;3,0;;7,0;;;1,0;;65,0;4,0;;;;;1,0;12,0;;;;3,0;7,0;;23,0;5,0;;;;;;;;;4,0;4,0;;;1,0;;1,0;;;;;;1,0;;2,0;;1,0;;;3,0;;;;;;;;;;;;;;1,0;;9,0;;;;1,0;1,0;;;1,0;;;;;;6,0;9,0;;;5,0;;2,0;41,0;;;2,0;;;;;3,0;11,0;;;2,0;1,0;;;;;;1,0;;;;1,0;;;;;;;;;2,0;;;7,0;15,0;2,0;;1,0;;;;;;;;1,0;;30,0;2,0;;1,0;9,0;3,0;3,0;;;2,0;;3,0;;;;3,0;;2,0;5,0;;;;;;1,0;;;;;;;1,0;;;;;;;;;;;;;;;;1,0;;;1,0;;2,0;;2,0;;1,0;;;;;;;;;;;;1,0;5,0;1,0;;;1,0;;10,0;;;;2,0;2,0;;;;2,0;6,0;;;;;;;;;;;;;;;;;2,0;;;;;;;;;;;;;1,0;;;;1,0;;;;;;;;;;;;;;2,0;1,0;;;;;9,0;;;;;;;;;;;;;;;;;;;2,0;;;;;;;;;;;;;;;;;1,0;;;;;;;;;2,0;;;;;;;;;;;;;;;;;;;;;;;;;;1,0;;;;;;;1,0;;;;;1,0;2,0;1,0;;;;;3,0;;2,0;;;;;;;3,0;;;;;;;;;1,0;;;;;;;;3,0;2,0;;;;;;;;;2,0;;;1,0;;1,0;;1,0;;;;;;;;1,0;;4,0;;;;1,0;;;1,0;;1,0;;;1,0;;;;;;;7,0;;;;;1,0;;1,0;;4,0;;;;1,0;;;;;;;;;;;;;;;14,0;;;1,0;;;;;;;;;;;;;;;;;;;;;;;;1,0;;;;;;;;;;;;;;;;;;;;;;;;;;4,0;;;;;1,0;;;;;;;;;1,0;;
sound;;;;6,0;;45,0;2,0;2,0;;;;9,0;;25,0;;2,0;23,0;;18,0;2,0;;;;1,0;2,0;;;3,0;3,0;7,0;50,0;18,0;;;;40,0;;2,0;;;26,0;43,0;;3,0;14,0;1,0;;1,0;;;;1,0;;2,0;1,0;1,0;4,0;;15,0;28,0;2,0;;;;144,0;;11,0;;;;;8,0;13,0;1,0;;;;;;9,0;37,0;;27,0;3,0;4,0;;;;;;2,0;;2,0;;;;3,0;;47,0;1,0;24,0;4,0;;13,0;3,0;11,0;2,0;8,0;;;;;1,0;;;4,0;2,0;33,0;3,0;15,0;;;81,0;3,0;;9,0;41,0;;;;13,0;;;23,0;;;6,0;;;;;1,0;;;4,0;;;;12,0;;;;3,0;;;;2,0;;;;;7,0;1,0;;;;7,0;4,0;;8,0;7,0;2,0;6,0;9,0;;;;15,0;4,0;;1,0;;;5,0;;;19,0;2,0;9,0;;;1,0;2,0;;3,0;;8,0;2,0;2,0;;;;;;1,0;1,0;1,0;;1,0;2,0;;9,0;;2,0;1,0;;28,0;;;;8,0;3,0;12,0;;;;8,0;1,0;;1,0;;;4,0;;4,0;17,0;2,0;;;6,0;;2,0;;;;5,0;;;1,0;;;;;;;;1,0;;7,0;;;13,0;;2,0;1,0;;3,0;;;1,0;;;;1,0;;;1,0;4,0;;;;;1,0;;4,0;;;7,0;;;;;;;;;;1,0;;;;;;2,0;;;2,0;;;3,0;;;;;1,0;;2,0;3,0;1,0;2,0;2,0;6,0;;;;1,0;;;2,0;;;;;1,0;41,0;;;;;;2,0;1,0;;;;3,0;;2,0;;;;;;;;;2,0;;11,0;;;3,0;;2,0;1,0;4,0;11,0;2,0;;3,0;;;1,0;3,0;;1,0;30,0;14,0;5,0;;24,0;;;2,0;1,0;53,0;4,0;1,0;;151,0;4,0;;5,0;;;;;2,0;20,0;;;28,0;;12,0;;11,0;1,0;4,0;29,0;;;3,0;3,0;3,0;;3,0;;1,0;;2,0;10,0;;1,0;1,0;1,0;41,0;12,0;10,0;;;9,0;2,0;;;1,0;;2,0;5,0;15,0;1,0;2,0;3,0;3,0;;;;;;26,0;;;3,0;1,0;;2,0;;;;;1,0;;;2,0;6,0;;;;;2,0;;1,0;4,0;8,0;5,0;;;;;2,0;1,0;;;74,0;7,0;2,0;;4,0;;;;;2,0;;;;;3,0;;2,0;2,0;;1,0;;;;;;1,0;;2,0;32,0;;13,0;1,0;;;;;3,0;;1,0;3,0;;;;;;;1,0;;;;;;;;;;;8,0;6,0;;;7,0;;8,0;;;4,0;2,0;;;;3,0;;1,0;;1,0;;4,0;;2,0;7,0;;;;7,0;35,0;;;;;;;;;3,0;10,0;;;;;2,0;5,0;3,0;;;;;3,0;;;1,0;1,0;7,0;;;1,0;7,0;;;1,0;;2,0;;3,0;;;;;3,0;1,0;1,0;3,0;;;16,0;;;;1,0;;6,0;;3,0;;;;;;;;;;;;;3,0;;;4,0;;;;;;;;;2,0;;;4,0;;;1,0;;;;;;1,0;1,0;;11,0;;1,0;;;;114,0;3,0;;2,0;;;;;9,0;;;;;2,0;1,0;5,0;2,0;;;;;;2,0;;;;;;;;;;2,0;;;;;;;;;;;;;;;2,0;;;1,0;;;2,0;;4,0;;;;1,0;;;7,0;;2,0;;;;;;2,0;;;;;1,0;;;;;;;;3,0;;;;;;;;;;;;;;;;;25,0;3,0;;;;;;1,0;;;;1,0;;;1,0;1,0;5,0;;;;;1,0;;;;;;;;;;;;;;;;;;;;;;;1,0;;;;;;1,0;2,0;;2,0;;;;;;;6,0;;;;;;;;;;;;;;;4,0;;;;;;;;3,0;;;1,0;3,0;;;;;;1,0;;1,0;;1,0;;;;;;;1,0;;;1,0;;17,0;;;6,0;1,0;;5,0;;;;;;3,0;1,0;;;;;;;;1,0;4,0;1,0;3,0;;5,0;;;;;;;;;;;4,0;;;;;;6,0;;;;;11,0;3,0;;;;;;;1,0;;2,0;;;;;;;;;;;;2,0;;;;;;;;;;;;;;;;;;;;;;3,0;;;3,0;;;;;;29,0;;;1,0;;5,0;;2,0;;;;;2,0;;;;;;;
spacer;;;;4,0;3,0;3,0;8,0;47,0;;;;;2,0;23,0;;;;;3,0;;11,0;;;;;;;2,0;;;19,0;;;2,0;;;1,0;;;;1,0;22,0;9,0;4,0;;30,0;;31,0;;;;;17,0;1,0;;;67,0;;;;4,0;;;;37,0;1,0;52,0;1,0;4,0;;5,0;127,0;9,0;;;;25,0;;;3,0;12,0;;;;40,0;;;20,0;;;;1,0;;3,0;;;7,0;5,0;38,0;3,0;4,0;2,0;;2,0;;;;;;;;;10,0;;;;;3,0;1,0;41,0;;;1,0;;2,0;;12,0;;;15,0;;;;10,0;;;1,0;;;6,0;;14,0;;;;3,0;2,0;8,0;;47,0;;9,0;1,0;11,0;;;;;;2,0;10,0;10,0;;;;;19,0;11,0;;;1,0;;;3,0;;20,0;;;;;;;2,0;19,0;2,0;13,0;9,0;2,0;4,0;13,0;;;1,0;1,0;2,0;2,0;13,0;;18,0;4,0;5,0;15,0;;;;;31,0;11,0;;38,0;;;;2,0;;11,0;;;;5,0;2,0;;;;13,0;;48,0;;4,0;;;;;;;;;;;;;23,0;;;2,0;1,0;21,0;7,0;58,0;;2,0;;4,0;4,0;90,0;;30,0;75,0;12,0;;;;;;6,0;;;;;;;7,0;;;;;;;;;3,0;;3,0;1,0;;;12,0;;;;;;;;2,0;;2,0;;7,0;;2,0;5,0;12,0;;;5,0;;;15,0;2,0;;;2,0;;;;9,0;;;;;;3,0;;;2,0;;;;2,0;4,0;;7,0;5,0;;2,0;;;;;;;;3,0;;4,0;16,0;8,0;;4,0;;;;;;;;10,0;4,0;;;;;;;;;;;;19,0;;;;;;;;;;;;;1,0;;;;;;;;;;;;;;;;;;;;1,0;;;;;;;;;;;;;;;;;;;;;;3,0;;;;;3,0;;;;;;;;;;1,0;;2,0;;;;;;;;;;;;3,0;;;;;;;;;;;;;;;;;;;2,0;;;;;;;;;;2,0;;;1,0;;;;;;;2,0;;;;;;;;;;;;;;;;;;;;;;;;16,0;;1,0;;;;;;;2,0;;;;;;;;;;;;3,0;;;;;4,0;;;;;;;;;;;;;;;;;;;;6,0;;;;;;;;;;11,0;;;;;;;;;;;;3,0;;;;;;;;;;;;;;;;;;;3,0;;;4,0;;10,0;;;;;;;;;;;;;;;;;;;;;;;;;4,0;;;;1,0;;1,0;;;;;;;;;;;;;;;;;2,0;;;;;;;;4,0;;;1,0;;;;;;;;;;;;;2,0;;;;;;3,0;;;;;;;;5,0;;6,0;;;;;;;;;5,0;;;1,0;;;;;;;;;;;;;;;;;;;2,0;;;;;;1,0;;1,0;;;;;;;11,0;;;;;;;;2,0;;2,0;;;;;1,0;;3,0;1,0;;;;;1,0;;;2,0;;;4,0;;;;;;;;;;;;16,0;;;8,0;;;;;;;;;;;;;;;4,0;;;;;;;;;;;;;;1,0;;;;;;;;;;;5,0;;5,0;;5,0;;;;;;;1,0;;;5,0;;;;;;;;;;;;;;;1,0;;;5,0;;;;;;;;;;;;;1,0;;1,0;;;;;4,0;4,0;;;;;;;;;1,0;;;;;;;;;;;;;;;;4,0;12,0;;;;;;;;;;;;;;;;;;;;;;;;;1,0;;2,0;;;;;;;12,0;;;;;;;;;;;4,0;2,0;;;;;;;;;;;2,0;;;;;;;;;2,0;;;;;;;;;;;;;;;;;;1,0;;;;;;;;;
splitter;;;;12,0;;19,0;1,0;1,0;;;;;;;;;3,0;;;;;;;;1,0;;;6,0;1,0;;9,0;;;;;;;2,0;;;;13,0;;3,0;2,0;6,0;;12,0;;;;6,0;4,0;;4,0;;4,0;;;1,0;;;4,0;;20,0;2,0;11,0;1,0;;;;22,0;76,0;;;;;1,0;;;9,0;;;;2,0;;;69,0;2,0;;;1,0;14,0;;;;;1,0;;;11,0;;;;1,0;;;;;;;;;;;;;;2,0;7,0;;;1,0;;;;17,0;;;;;;;1,0;;;1,0;;3,0;;;;;;3,0;1,0;;1,0;;;;;;;;;;;;;;;1,0;1,0;;;10,0;1,0;;;1,0;;7,0;5,0;;;;2,0;;;;1,0;;14,0;;;;;;;;;;;;;18,0;6,0;;;;;;;;2,0;;;8,0;9,0;;;;;;;3,0;;;22,0;;;;;1,0;;7,0;;;;;1,0;3,0;;;;12,0;14,0;;;;;1,0;1,0;;;1,0;3,0;11,0;;;;;;;;;14,0;;;;;;;;;2,0;;;;;;;;;;;2,0;;1,0;;;7,0;;;;;;;;;1,0;;;;;;;;2,0;;;;;;;;;;3,0;;;;;;;1,0;;;1,0;;1,0;1,0;;;;;;;;;;;;;;;;;;;;;;;;;;10,0;;;;;;;2,0;;;;1,0;;;;;;;;;;;;;;1,0;3,0;;;;;;1,0;1,0;;3,0;;2,0;;;;;;;;9,0;;;;;;;;1,0;1,0;;;;;;;;;1,0;;;;12,0;;;;;;;;;;27,0;;;;;;;;;;;1,0;2,0;;;;;;;;1,0;;;;;;;;;;;;;;;1,0;;;;;;;;;;;;;;;;;;;;;;;3,0;;;;;1,0;;;;;4,0;;11,0;;;;;;;;;;;;;;;;;;;;;;;;;;;;;;;;;;;;;;;;;;;;;;;;;;;;;;;;;;;;;;;;;;;;2,0;;;;;;;;;;;1,0;;;;;;;;141,0;;;;;;;;1,0;;;;;;;2,0;;;;;;;;;;;;;;;;;;;;;;;;;;;;;;;;;;;;;;;;;;;;;;;;;;;;;;;;;;;;;;;;1,0;;;;;;;;;2,0;;;;;;;;;;;;;;;;;;;;;;;;;;;;;;;;;;;;;;;;1,0;;;;;;;;;;;;;;2,0;1,0;;;;;;;;;1,0;;;;;;;;;;;;;8,0;;;;;;;;;;;;;;;;;;;;;;;;;2,0;;;;;;;;;;;;2,0;;;;;;;;;;;;;;;;;;;;;;;;;;;;1,0;;;;;;;;;;;;;;;;;;;;;;;;;;;;;;;;;;;;;;;;;;;;;;;;;;;;;;;;;;;;;;;;;;;;;;;;;;;;;;;;;;;;;;;;;;;;;;;;;;;;;;;;;;;;;;;;;;;;;;;;;1,0;;;;;;;;;;;;;;;;;;;;;;;;;;;;;;;14,0;;;;;;;;;;;;;;4,0;;;;;;;;;;;;;;;;;;;;;
stabilize;;;;5,0;3,0;42,0;;22,0;;;;;1,0;17,0;;;5,0;;1,0;;;;;;;3,0;;1,0;;;29,0;3,0;2,0;;;31,0;1,0;;;;12,0;8,0;;1,0;8,0;2,0;;2,0;;;;;4,0;;;;5,0;;;8,0;;;;;134,0;;18,0;;1,0;;3,0;11,0;2,0;;;;4,0;3,0;;;23,0;;2,0;3,0;8,0;4,0;;73,0;;1,0;;;;;3,0;;2,0;;10,0;40,0;4,0;;;8,0;1,0;3,0;;;;;;;5,0;;;;;;;4,0;9,0;;;;;;34,0;;;;3,0;;;12,0;;;;1,0;;;1,0;4,0;6,0;;;18,0;;2,0;;;;1,0;15,0;1,0;;;;;;1,0;;6,0;1,0;;;;4,0;;;;1,0;;;23,0;;;;;4,0;;;;;4,0;;;1,0;;38,0;1,0;;;4,0;;;;4,0;;3,0;;;;;;;2,0;2,0;;;64,0;5,0;12,0;;;;3,0;;;;2,0;;;;;2,0;;4,0;;;2,0;;;1,0;;;;;;;;;;2,0;;;1,0;;1,0;4,0;1,0;;;1,0;4,0;;;7,0;2,0;;;;;;2,0;;;;;4,0;;;2,0;2,0;;;;2,0;18,0;;1,0;;9,0;20,0;1,0;;;66,0;;;;4,0;;;;;;;;;4,0;;1,0;;;5,0;;6,0;;;;;;;;;;1,0;;;;;1,0;3,0;4,0;;;;;;;;;1,0;;;;;;;;11,0;13,0;2,0;;;;;5,0;;1,0;;;;;;;;3,0;85,0;;1,0;;;;;19,0;;;;;;;2,0;;;;;14,0;1,0;;11,0;;;3,0;;6,0;;;;;;10,0;;;;5,0;;1,0;;;;;;2,0;;1,0;3,0;;13,0;7,0;;3,0;;;3,0;2,0;2,0;;;;;;;;;1,0;2,0;3,0;;4,0;;;;;;4,0;;;;;;;3,0;;1,0;1,0;1,0;;;;;;1,0;;1,0;;;;;;;;;7,0;;;;;4,0;;;;;;;;;;;2,0;2,0;;;;;1,0;;;1,0;;;;;3,0;;;;;;28,0;8,0;21,0;1,0;;;;;;;;;;;;;;;1,0;;;1,0;2,0;1,0;;;;1,0;;;;;2,0;;2,0;;;;;;;;;;3,0;;1,0;;;;;;;;;;;;;;;;;;;;;1,0;;;;;;;;2,0;;;;;;;;;1,0;;1,0;;;1,0;;;;;;;;;;4,0;4,0;;1,0;1,0;;;;;;2,0;;;;;;1,0;;;;;;;;;2,0;;;;;;;6,0;;;;;;;;6,0;;;;;28,0;;;;;;;;;;;1,0;;;;;;;;;;;;;;;;;;3,0;;;;;;;;;;;;;;1,0;;8,0;;;;;;;;;;;;;;;8,0;2,0;;;;;;;;;;;;;2,0;;;;;;;;1,0;1,0;;;;;;;;4,0;;;;;;;;;4,0;2,0;;1,0;;2,0;;;;;;;;;;1,0;;2,0;;;;;;1,0;;;;;;;1,0;;;;;;;;;;;;;;;;;;;;;;;;;;;;;;2,0;;;;;;;;;;;;;;;;;;;;;;;;;;;;;10,0;;;;;;;;;;;;;;;;;;;;;;;;;;;;;;;;;;;;;;;;;;1,0;;;;;;;;;;;;1,0;;;;;;;;;;1,0;;;;;;;;;;;;4,0;;;;;;;;;;;1,0;;;;;;3,0;;;;;;;;;;10,0;;;;;1,0;;;;;;;;;;;;;;;;;;;;;;;;;;;;;;;;;;;;;;;;;;;;;;;;;;;;;;;;;;;
stabilizer;;;;4,0;;46,0;;66,0;;;2,0;;;13,0;;;2,0;2,0;1,0;;;;;;7,0;2,0;;1,0;;;25,0;;3,0;;;;;3,0;;;4,0;42,0;2,0;;;15,0;;;;;;;2,0;3,0;;;2,0;;2,0;4,0;;;;;144,0;;32,0;;;2,0;4,0;41,0;;;;;;;;;15,0;;;;30,0;2,0;;125,0;;;;;1,0;;;;4,0;1,0;15,0;;7,0;;;;;9,0;;;;;;;;;;;;1,0;;4,0;;;10,0;;;1,0;30,0;;;;;;;22,0;;;;;;;;;;;;;1,0;19,0;2,0;22,0;;;1,0;;;;1,0;;;3,0;;12,0;;1,0;;;20,0;13,0;;;5,0;;1,0;52,0;;1,0;;;;;;;;1,0;;2,0;8,0;;9,0;2,0;;1,0;;4,0;;3,0;2,0;;1,0;1,0;;;3,0;;;;3,0;3,0;;86,0;10,0;10,0;12,0;;;3,0;3,0;12,0;;;2,0;3,0;3,0;;;;5,0;;;;;;3,0;;2,0;;;;9,0;;;9,0;1,0;1,0;;;;;9,0;;2,0;;2,0;;;1,0;5,0;11,0;;;;;;;;;;;7,0;;;;32,0;;1,0;;2,0;5,0;;;;2,0;9,0;;;2,0;13,0;3,0;;;11,0;;;1,0;;5,0;7,0;;;;1,0;;;;10,0;;17,0;4,0;;;;;;;;;3,0;5,0;;9,0;;1,0;;;;1,0;;19,0;;;;2,0;;;1,0;;;;;;8,0;3,0;12,0;5,0;;2,0;;;;;10,0;2,0;;;;;1,0;3,0;43,0;2,0;;;;;;1,0;;7,0;;;2,0;;4,0;8,0;;;;;;;4,0;;;;;1,0;;;;;;;;2,0;2,0;3,0;;;;;;;;;;2,0;;4,0;1,0;8,0;;17,0;;;2,0;;;1,0;;;;;;;;;;3,0;;1,0;;;;1,0;;;1,0;;2,0;;;;;7,0;;;;;2,0;5,0;;;;8,0;1,0;;;1,0;;;;;;;;;;;;;;;1,0;;;;;;;;2,0;;;;6,0;;7,0;4,0;2,0;;;;;;;;;;;9,0;;;;;;2,0;;;;;;;;;;;;;1,0;;2,0;;;;;;;;;;;;12,0;6,0;2,0;;;;;;;;;4,0;;;;;;;;;;;;;;;3,0;;;;;;;;;;;;;5,0;;;;;;;;;10,0;;;;;;5,0;;;;;;;;;;;;;;;;;;;;3,0;;6,0;;;;;;;1,0;;;;;;;;;;;;;;1,0;;;;;;;;;3,0;;1,0;;;5,0;;;;;;2,0;;;2,0;;;;;;;;;;;;;;;;;;;;;;;;;;2,0;;;;;;;;;;;;;;;;;;;1,0;;;;;1,0;6,0;19,0;;;2,0;;;;;4,0;;;;;;1,0;;;;1,0;;;;3,0;;;;;;;;;;;;;;3,0;1,0;1,0;7,0;;;;;;1,0;;;;;;;;;;;;;2,0;;;1,0;;;;4,0;;;;1,0;;;;;;;;;;;;;4,0;;;;;;;;;;;;;;;;;;;;;;;;;;;;;;;8,0;;;;;;;;;;;;;;;;;;2,0;;1,0;;;;;;;;;;;;;;1,0;;;;;;;;;;;;;;;;;;;;;;;1,0;;;;;;3,0;;;1,0;;;;;;;;;;;;;;;1,0;;;;;;;;;;;;;;;;;;;;;2,0;;;2,0;;;;;;;;;;;1,0;;;;;;;;;;;;;;;;;;;;;;;;;;;;;;;;;;;;;;;;;;;;;;;;;;;;;;;;;;;;;;;;;;
stage;;;;4,0;;34,0;4,0;11,0;;;;;;7,0;;;12,0;;;;3,0;;;;;1,0;;;;2,0;14,0;;;4,0;;;9,0;9,0;;;6,0;16,0;;10,0;1,0;34,0;;15,0;;;;;4,0;;;5,0;6,0;;;42,0;;1,0;3,0;;215,0;2,0;23,0;4,0;;2,0;3,0;15,0;2,0;;;;1,0;;5,0;;45,0;;;18,0;4,0;3,0;;19,0;;1,0;23,0;1,0;;;;;;25,0;17,0;2,0;21,0;5,0;;62,0;16,0;;;;;;;5,0;;7,0;;;;2,0;4,0;33,0;;;17,0;4,0;;;33,0;2,0;;1,0;;;;14,0;2,0;;;18,0;;;;5,0;1,0;;;12,0;2,0;4,0;31,0;1,0;;;4,0;;;;;;;;;16,0;;2,0;2,0;;17,0;7,0;3,0;;14,0;;;9,0;;;1,0;;2,0;;;;;;;;4,0;6,0;5,0;;;;;;;;13,0;;;;;;;8,0;;;31,0;;;13,0;12,0;12,0;4,0;;;2,0;47,0;1,0;;5,0;;;;;22,0;;10,0;;1,0;2,0;3,0;;2,0;;;;;;;;;3,0;;;;2,0;1,0;;17,0;;1,0;;;4,0;8,0;1,0;17,0;6,0;1,0;;;;;2,0;;;;;;3,0;;;3,0;2,0;;;;12,0;;;;;37,0;13,0;;;;1,0;14,0;1,0;11,0;;;;;;1,0;4,0;;1,0;;;;;2,0;;;4,0;;4,0;3,0;;3,0;;8,0;;3,0;4,0;;10,0;;2,0;9,0;8,0;;2,0;;;19,0;2,0;;;;;1,0;;;1,0;;;47,0;30,0;3,0;;;2,0;;;;;;;3,0;;;;4,0;1,0;10,0;;;;;;;;;4,0;;;;;;3,0;;;10,0;;2,0;;28,0;;;;;3,0;;;;;2,0;;;1,0;;;;;;;;3,0;1,0;1,0;;16,0;;3,0;17,0;4,0;;3,0;;5,0;2,0;;;;;;;;1,0;;;11,0;;;;;2,0;;4,0;6,0;;;;4,0;;;;5,0;9,0;19,0;;2,0;2,0;;;2,0;;6,0;3,0;1,0;1,0;;;7,0;;;;5,0;;;;;;;;;;1,0;;;;;;1,0;2,0;;13,0;;;1,0;;;2,0;;;8,0;;1,0;;;;;;;;;;1,0;;;;5,0;;;;;;;;;;;;;;;;2,0;;;;;;;2,0;;4,0;;;4,0;6,0;;;;3,0;1,0;;;;;;3,0;;;;;;;;;;;;;;;;;;;;;;;;;;3,0;;3,0;1,0;;;;;;;;;;;;7,0;;;1,0;;;;;;;;;2,0;;;;;2,0;;;;;12,0;5,0;2,0;2,0;;;3,0;;;;;;2,0;;;;;;;;;;;;2,0;;;;;;1,0;;;;;1,0;;;;;;;;1,0;;;;1,0;3,0;2,0;2,0;;2,0;;;1,0;;;;;;;1,0;;20,0;;139,0;;;;13,0;;;;;2,0;;;1,0;;;;;;1,0;;;7,0;;;;;;;;28,0;3,0;;;;;;;;;;;;;2,0;;1,0;;;;;2,0;;2,0;;2,0;;;;;;1,0;3,0;;;;;2,0;;1,0;;;;;;1,0;;;;;;;;;;;;;;;;;;1,0;2,0;;2,0;;;;;;;;;;;;;;7,0;;;;;;;3,0;3,0;;;;;;;1,0;;;;;1,0;;;;;;;2,0;;;;;;;4,0;;;;;;;;;;2,0;;;3,0;27,0;;;;;;;;;;;;;;;;;;;;;;;;;3,0;;;;1,0;;;;;;;;;;;1,0;;1,0;;6,0;2,0;2,0;2,0;;;;;;;;;;;;;;;;2,0;;;;1,0;;;;;;;;;;;;;;;;1,0;;;;;;;;;;;;;;2,0;;;;;4,0;;2,0;;;;;10,0;;;;;;;;;;;;;;;;;;;;;;;;;;;;;;;;;;;;;;;;;;8,0;;;;;;;;;;;4,0;;;;;;
standard;;;;1,0;;8,0;17,0;12,0;;;;;;12,0;;4,0;37,0;;;1,0;;;13,0;15,0;48,0;;;2,0;2,0;2,0;39,0;;;2,0;;28,0;2,0;;2,0;;34,0;21,0;;12,0;4,0;1,0;;19,0;2,0;9,0;4,0;;6,0;1,0;2,0;;;;;15,0;;;2,0;;102,0;4,0;14,0;1,0;1,0;;5,0;25,0;7,0;;;4,0;;6,0;;1,0;27,0;;14,0;8,0;21,0;;;1,0;;1,0;23,0;3,0;;1,0;2,0;;30,0;4,0;11,0;1,0;9,0;21,0;;11,0;7,0;8,0;10,0;;2,0;;;4,0;3,0;;3,0;8,0;;1,0;;16,0;;;37,0;3,0;1,0;4,0;25,0;;;;5,0;;;12,0;;;1,0;;;;;2,0;;;6,0;;;5,0;7,0;2,0;;8,0;;;;;;;;;;4,0;;2,0;;;;2,0;;5,0;2,0;101,0;3,0;;;1,0;;;4,0;1,0;;1,0;;12,0;18,0;1,0;1,0;;17,0;;;;;3,0;2,0;;1,0;;;;;1,0;;;;;11,0;;;26,0;2,0;;;;;;20,0;;;;;1,0;;;3,0;;5,0;;;;;;12,0;2,0;3,0;3,0;1,0;;;;;;;;;7,0;;1,0;2,0;;2,0;;;;1,0;1,0;4,0;2,0;;;3,0;4,0;;19,0;;;;;;1,0;;;;2,0;;;3,0;1,0;;;1,0;1,0;1,0;;;;4,0;;5,0;;;1,0;;;3,0;;9,0;;;;;;;;;;2,0;;;1,0;;;;;;;4,0;;8,0;2,0;10,0;22,0;;;;;;;6,0;1,0;;;6,0;;5,0;;;;;;;1,0;;25,0;;;;2,0;;;;;;;;;;;24,0;12,0;;;;;;;1,0;;;;;;13,0;2,0;1,0;;;;4,0;4,0;10,0;1,0;;3,0;1,0;5,0;;7,0;;8,0;;;;4,0;;1,0;;;4,0;;;5,0;6,0;1,0;;1,0;1,0;;;;;20,0;;1,0;2,0;;;;;;;12,0;;;;8,0;1,0;5,0;;;;;2,0;;1,0;;;;2,0;;;1,0;10,0;1,0;1,0;;4,0;;4,0;;;1,0;;;;;;3,0;;;18,0;1,0;17,0;;;5,0;;;;;;;;6,0;;1,0;;;;;;;;1,0;;;2,0;1,0;;;3,0;;6,0;;;;;;3,0;;;1,0;1,0;;2,0;;1,0;1,0;2,0;;11,0;12,0;;5,0;1,0;;;;;;7,0;3,0;;;;;;;;;;;;;1,0;;;;;18,0;;4,0;2,0;4,0;;;;;;;;;;;;;;;;;;;;1,0;;2,0;2,0;;;;;;;;;;;;;;9,0;;1,0;3,0;;;;;1,0;;2,0;;;1,0;;;;;7,0;;;;;2,0;;4,0;;7,0;;;;;;;;;;;;;;;;;1,0;;;;;;;;;10,0;;1,0;;;;2,0;3,0;;;;;;;;11,0;;;;;;3,0;4,0;;2,0;1,0;;;4,0;6,0;;;;;;;1,0;;;;;;;;11,0;1,0;;2,0;1,0;1,0;;;;;;;;;17,0;;6,0;1,0;1,0;;;;;;;;;;;;1,0;;2,0;;;;4,0;;;;;;;;;;;;;;;;;2,0;;2,0;;;;;;;;1,0;;;7,0;48,0;;;;1,0;;;;;;;;;;;;;;;;;;;;;1,0;1,0;;;;;;;;;4,0;4,0;1,0;;;;;;43,0;;;;;;;;;;;;;;;;;;;;;;;;;;;;;1,0;;;;;;;;;;;1,0;;;;;2,0;;;1,0;3,0;;;;;;;;;;;;;;;3,0;;;;2,0;1,0;;;2,0;;;;;3,0;;;;;7,0;;3,0;7,0;;1,0;;;;;;;;;;;;;;;;;;;;;;;;;1,0;;;;;;;;;;;;;;;;;2,0;;;;8,0;;;;;;;;;;;;;;;;;;;;;;;;;;;;;;;;;;;;;;;;;1,0;;;;;;;;;;;;;;;;;;;;;;;;;;;;;;;;;;;;;;
stationary;;;;3,0;13,0;22,0;;24,0;;;;;2,0;37,0;;;8,0;;;1,0;;;5,0;;1,0;;;2,0;4,0;4,0;21,0;;;1,0;;23,0;7,0;12,0;;;26,0;51,0;;;2,0;10,0;1,0;25,0;34,0;;1,0;;2,0;1,0;15,0;3,0;9,0;;;4,0;6,0;;5,0;;63,0;;41,0;;;2,0;;94,0;4,0;;;;;;;;29,0;;;;12,0;58,0;;24,0;;;;4,0;3,0;;;6,0;2,0;33,0;5,0;19,0;175,0;2,0;;5,0;12,0;9,0;;;;;;3,0;2,0;39,0;;20,0;;2,0;3,0;44,0;2,0;;12,0;;;3,0;39,0;;;4,0;8,0;;;60,0;;;5,0;;;;;1,0;;;1,0;4,0;5,0;18,0;4,0;6,0;1,0;;7,0;1,0;;;;;;;1,0;26,0;;;;;14,0;6,0;;;7,0;;2,0;17,0;;15,0;1,0;;3,0;;;3,0;;13,0;;;1,0;1,0;21,0;7,0;;;;2,0;3,0;;40,0;;3,0;4,0;;1,0;;;;2,0;75,0;2,0;19,0;5,0;21,0;23,0;6,0;;;5,0;3,0;1,0;;2,0;;20,0;6,0;;34,0;;62,0;;;;4,0;;;;;;;;1,0;1,0;;3,0;4,0;1,0;;2,0;12,0;;7,0;3,0;3,0;;4,0;21,0;4,0;1,0;55,0;39,0;4,0;;;1,0;;48,0;;;;;1,0;1,0;;1,0;10,0;12,0;;;3,0;5,0;2,0;;;;13,0;10,0;;2,0;4,0;;10,0;;23,0;;;;;12,0;4,0;;;15,0;;;3,0;;;;;8,0;;13,0;;;;;9,0;;;2,0;;2,0;25,0;68,0;8,0;;;;;;2,0;;;9,0;3,0;4,0;1,0;;;;;2,0;5,0;1,0;;1,0;;;3,0;2,0;1,0;2,0;3,0;;;;3,0;;;5,0;16,0;;;;;;;;;4,0;;;;;;;7,0;;;;3,0;;5,0;7,0;;;1,0;10,0;6,0;;;;;;1,0;;4,0;2,0;;3,0;1,0;;;1,0;;;;12,0;;;3,0;2,0;3,0;6,0;;;;3,0;;9,0;;4,0;;;;;;10,0;;;;2,0;2,0;;2,0;;1,0;;;1,0;;;;10,0;;4,0;;4,0;;3,0;3,0;;;;2,0;;4,0;;;4,0;2,0;2,0;;;;;;;;;;3,0;1,0;;1,0;;;2,0;;1,0;;;20,0;;;2,0;;;4,0;;2,0;;;;;1,0;;7,0;11,0;;;1,0;;;;;4,0;5,0;3,0;;;;;;;;1,0;;;;;;5,0;;;;2,0;;;1,0;;;4,0;;;3,0;2,0;;;;2,0;;;;;5,0;;;;;3,0;;;;;;;1,0;;;;;;;1,0;;1,0;;;;2,0;;;;;;;;;;;;;;2,0;5,0;;;;1,0;;;;;;;;;;2,0;2,0;;;;;5,0;;;;;;;;3,0;;;;1,0;;;;;;;;3,0;;;1,0;;2,0;;;;;;;;;;;;;;;3,0;;;;;;;;;22,0;;;;;;4,0;;1,0;1,0;;;1,0;;;;;;2,0;;;18,0;;;;2,0;7,0;;;;;;;;;;;;;14,0;;;;6,0;1,0;;;;2,0;;;5,0;19,0;;;1,0;;;;;1,0;;5,0;;;3,0;;;1,0;;;;;;;1,0;1,0;;2,0;;;1,0;41,0;;1,0;13,0;;;;;;;;;;;;;;2,0;;2,0;;2,0;;;;3,0;;;;3,0;;;;1,0;;;4,0;;;2,0;;1,0;2,0;1,0;;;2,0;;1,0;1,0;;;;;;;;;4,0;;;;;;1,0;;;;;5,0;;;;;;;;;;;;;;15,0;;;;;;;;;;;;;;;;;;;;;;;2,0;;1,0;;;;;;;;;;;;;1,0;;;;;;;;;;;;;;;;6,0;;1,0;;;2,0;;;;2,0;;;;;;;;;;;;;;;;;;;;;;;;;;1,0;;;;;;;;1,0;;;;;4,0;;;20,0;;;;;2,0;;;;;;;1,0;;;;;;8,0;;;;;;;;;;;7,0;;3,0;;;;;;;1,0;;;;;;;3,0;;;;;;;;;;4,0;;;;;;;;;;;;;;;;;;;;;;
stereo;;;;17,0;1,0;69,0;12,0;11,0;;;;;1,0;41,0;;;53,0;;1,0;5,0;2,0;;11,0;;;;1,0;6,0;1,0;2,0;23,0;12,0;1,0;1,0;;19,0;;2,0;18,0;;19,0;191,0;;5,0;15,0;1,0;1,0;7,0;1,0;6,0;15,0;;2,0;3,0;20,0;;3,0;;;41,0;2,0;;2,0;1,0;327,0;1,0;55,0;1,0;;;1,0;35,0;15,0;;;;3,0;;;2,0;98,0;;23,0;3,0;28,0;;;51,0;;7,0;75,0;2,0;;1,0;7,0;;17,0;34,0;41,0;29,0;34,0;8,0;;6,0;23,0;22,0;;2,0;;;;27,0;15,0;;;;;3,0;16,0;61,0;1,0;;10,0;5,0;;7,0;104,0;;1,0;;5,0;;;58,0;;;20,0;;1,0;;;;;;;12,0;14,0;1,0;3,0;4,0;;1,0;1,0;;;;;;;;1,0;4,0;;;;6,0;10,0;1,0;1,0;14,0;2,0;2,0;1,0;13,0;;2,0;;;2,0;;;1,0;;7,0;;;8,0;2,0;1,0;8,0;;;;;2,0;;27,0;1,0;5,0;;;;;2,0;20,0;1,0;4,0;4,0;8,0;23,0;;1,0;;;;7,0;16,0;3,0;2,0;;14,0;;;;;;8,0;;1,0;6,0;;4,0;22,0;;2,0;3,0;1,0;5,0;;;;;;;3,0;5,0;;5,0;2,0;;;1,0;;;10,0;;;9,0;;;2,0;7,0;3,0;47,0;;;;2,0;;16,0;10,0;2,0;3,0;34,0;;;;5,0;;14,0;;;14,0;9,0;3,0;;;7,0;17,0;;;;;;;;45,0;;;;2,0;;;4,0;;;;;2,0;31,0;;;3,0;;18,0;;3,0;;;;3,0;33,0;1,0;8,0;;;5,0;;;;;;;;4,0;;;;;;1,0;;;;;;3,0;;;;1,0;;;;5,0;2,0;1,0;;27,0;;;;;;1,0;;1,0;;;3,0;;;31,0;19,0;;;;;;1,0;13,0;2,0;;;;17,0;3,0;;;;1,0;8,0;9,0;;3,0;2,0;;10,0;2,0;;;20,0;;;;2,0;;1,0;;3,0;;;;5,0;5,0;11,0;;;1,0;;;;;;;12,0;1,0;11,0;;;1,0;;;1,0;3,0;;3,0;;;1,0;2,0;;5,0;;;5,0;;4,0;2,0;;;;9,0;2,0;;;1,0;108,0;;;2,0;1,0;;1,0;;2,0;1,0;1,0;;;;;4,0;1,0;;;;;;3,0;;;11,0;7,0;2,0;;26,0;;2,0;;;;;;;;;;;;14,0;;;;;1,0;1,0;;;;8,0;1,0;;;1,0;;;;;;;;;;;;;;;;;;;1,0;6,0;2,0;2,0;;1,0;23,0;;;;1,0;;;;3,0;;;;;1,0;;;1,0;;1,0;;;1,0;2,0;4,0;3,0;5,0;;4,0;;;1,0;;;1,0;1,0;5,0;4,0;;4,0;;;;;;;2,0;;;;;;;;;;;;1,0;2,0;;;1,0;;;24,0;;;;;1,0;;;;;2,0;;;;2,0;;;1,0;;;3,0;2,0;1,0;;;;;;;;;;;3,0;;;;2,0;;;;1,0;;;6,0;;;;4,0;;1,0;4,0;4,0;;;;1,0;;;14,0;;;;;;;;;1,0;;;;;;;3,0;;;2,0;;;;;13,0;;;;;3,0;;;;;;;;;;;1,0;1,0;2,0;;;;;;;;;;;;2,0;1,0;;;;;;;;;;;1,0;;;;;12,0;1,0;4,0;;;4,0;;1,0;;;;;1,0;;;;;;;3,0;;;;;;;34,0;;;;;;;;2,0;;;2,0;;3,0;;;;3,0;;9,0;;;;;;;;;3,0;;;;;1,0;;;;;;;;;;;;;5,0;;;3,0;1,0;;34,0;;;;4,0;;;;;;;1,0;;;;2,0;;3,0;;;;17,0;1,0;;1,0;;;;;1,0;;;;;1,0;;;4,0;;;5,0;1,0;;18,0;10,0;12,0;;;;5,0;;;;;;;;;;;2,0;;;;;2,0;;;;;1,0;1,0;;;;;;;2,0;;;;;;;;;;;;3,0;;1,0;;1,0;;;;;;;;;;;;3,0;1,0;;;;;;;9,0;;3,0;;2,0;;1,0;;;;1,0;;;;;2,0;1,0;;;;4,0;;;;;4,0;;;;;;1,0;;;;;;;;1,0;;;;;;;;;2,0;8,0;;;;;;2,0;2,0;4,0;5,0;1,0;;;;36,0;;;;;;;;;;;
stream;;;;73,0;6,0;34,0;;;;2,0;;;;134,0;;1,0;205,0;4,0;20,0;23,0;;;27,0;10,0;25,0;;;11,0;34,0;9,0;160,0;2,0;3,0;;;872,0;19,0;;16,0;;106,0;223,0;;54,0;253,0;5,0;;4,0;;;;3,0;;11,0;37,0;;18,0;;8,0;194,0;;;22,0;3,0;814,0;3,0;118,0;;1,0;;;3,0;6,0;;;1,0;;5,0;49,0;22,0;184,0;;82,0;2,0;46,0;3,0;3,0;19,0;1,0;1,0;92,0;1,0;3,0;17,0;3,0;;23,0;4,0;167,0;16,0;21,0;19,0;;74,0;72,0;113,0;5,0;12,0;;;4,0;11,0;45,0;7,0;2,0;4,0;51,0;15,0;27,0;76,0;12,0;;52,0;9,0;;48,0;133,0;;6,0;;78,0;;;46,0;1,0;2,0;86,0;44,0;5,0;;;3,0;;;;13,0;9,0;3,0;84,0;;1,0;;1,0;;32,0;;;;;;;6,0;214,0;14,0;8,0;1,0;5,0;3,0;;2,0;7,0;;7,0;2,0;;3,0;;;10,0;;;;4,0;11,0;;;2,0;;162,0;;;;;11,0;3,0;;;3,0;;10,0;;1,0;;;2,0;21,0;;;13,0;1,0;20,0;14,0;8,0;;;;109,0;3,0;;3,0;1,0;3,0;1,0;;;;139,0;;;33,0;;;2,0;1,0;;1,0;;3,0;;20,0;;;;;;15,0;7,0;;;;6,0;;;;;;;6,0;1,0;;11,0;169,0;16,0;33,0;;9,0;4,0;;;11,0;;;;2,0;;;11,0;9,0;;6,0;;;6,0;;;;2,0;;8,0;;;49,0;;;;;;2,0;;;;;;10,0;;;1,0;2,0;;11,0;;;;;4,0;;8,0;;2,0;;14,0;31,0;1,0;4,0;;;;;7,0;;;;;;31,0;;;;;;3,0;1,0;;;;1,0;7,0;5,0;;;21,0;;6,0;;6,0;;1,0;1,0;2134,0;41,0;;;1,0;2,0;;29,0;24,0;1,0;;;;;18,0;3,0;21,0;7,0;10,0;13,0;11,0;;84,0;2,0;;2,0;2,0;43,0;3,0;6,0;;34,0;2,0;4,0;4,0;;9,0;2,0;;86,0;1,0;4,0;;119,0;17,0;6,0;;51,0;34,0;11,0;7,0;;;23,0;4,0;7,0;8,0;17,0;;;;;6,0;77,0;;1,0;5,0;276,0;61,0;49,0;5,0;;;15,0;22,0;1,0;3,0;;45,0;1,0;22,0;13,0;;4,0;10,0;;;21,0;;;79,0;;2,0;1,0;;1,0;;;;1,0;;1,0;43,0;6,0;;10,0;3,0;24,0;;;1,0;;18,0;;37,0;67,0;;;;21,0;3,0;5,0;;5,0;14,0;70,0;10,0;11,0;14,0;4,0;10,0;5,0;;3,0;;;5,0;1,0;24,0;8,0;;1,0;6,0;;2,0;1,0;;6,0;2,0;2,0;3,0;;64,0;;1,0;;;;;;;;33,0;;7,0;;;;;;1,0;1,0;;3,0;;7,0;4,0;19,0;4,0;5,0;6,0;2,0;7,0;;;;2,0;;;5,0;9,0;20,0;;;;6,0;24,0;8,0;4,0;14,0;;9,0;1,0;10,0;19,0;;15,0;19,0;13,0;4,0;17,0;;5,0;;;;8,0;;;15,0;;1,0;2,0;;;10,0;7,0;;;34,0;10,0;20,0;4,0;2,0;10,0;;;;7,0;2,0;3,0;1,0;;4,0;;4,0;7,0;1,0;;6,0;5,0;;1,0;1,0;;;6,0;;17,0;3,0;40,0;6,0;4,0;8,0;;6,0;13,0;;;;4,0;55,0;;2,0;;76,0;4,0;59,0;5,0;;;2,0;;8,0;;;3,0;30,0;13,0;;7,0;;;15,0;;;;5,0;2,0;;11,0;4,0;;23,0;36,0;6,0;;;;;;;41,0;4,0;;3,0;5,0;15,0;13,0;;29,0;;9,0;;19,0;28,0;4,0;3,0;3,0;;8,0;;1,0;;3,0;9,0;32,0;;11,0;;2,0;;;;;;1,0;;5,0;9,0;;2,0;;;;15,0;;;;;;;9,0;;;17,0;6,0;3,0;;;1,0;36,0;2,0;6,0;;;35,0;1,0;;;8,0;;;;;;;;;;;;;;;;;;1,0;;;4,0;;;3,0;;;;;;;;;;;;;;3,0;;;;;6,0;;;3,0;1,0;;1,0;;;;1,0;4,0;;;;;;15,0;;;;;;;;;;;2,0;4,0;;2,0;;;;;2,0;;;;27,0;2,0;8,0;;1,0;;3,0;;;1,0;;2,0;;;2,0;1,0;2,0;;;;2,0;;;;;;;3,0;2,0;;;;;6,0;;46,0;;;1,0;1,0;1,0;1,0;;;5,0;;;;5,0;;1,0;;;;10,0;6,0;14,0;1,0;;;;;5,0;;;;52,0;3,0;;6,0;2,0;;3,0;3,0;2,0;;;12,0;;4,0;;;1,0;16,0;;;4,0;;;;;;;;;;;;;16,0;;1,0;;8,0;;;2,0;26,0;;;;;;;;;;;;;15,0;;;;;;;;;;;;;1,0;;;;;;;;2,0;;;;5,0;;;;;10,0;;;;;;;;;7,0;1,0;;;;;;;;;;;;;;;;;;
subsequent;;;;19,0;2,0;5,0;3,0;1,0;;;3,0;;;46,0;;;81,0;;;;3,0;4,0;27,0;;;;3,0;3,0;;6,0;14,0;;2,0;;;51,0;1,0;;3,0;1,0;63,0;41,0;;6,0;29,0;1,0;;17,0;;1,0;16,0;1,0;;1,0;2,0;6,0;4,0;;6,0;23,0;;;35,0;;504,0;;39,0;1,0;;3,0;2,0;143,0;25,0;;;;;1,0;;;54,0;;4,0;2,0;4,0;;;21,0;;3,0;8,0;;7,0;;1,0;;69,0;4,0;22,0;8,0;68,0;3,0;;7,0;11,0;7,0;;4,0;;;;4,0;71,0;;;1,0;1,0;5,0;34,0;55,0;27,0;4,0;6,0;8,0;1,0;11,0;17,0;3,0;;2,0;53,0;3,0;;76,0;;;7,0;2,0;11,0;;1,0;;;;10,0;12,0;1,0;3,0;8,0;;3,0;1,0;;;;2,0;;;;1,0;;;13,0;;;;;;4,0;;1,0;;;7,0;;2,0;;;4,0;;3,0;;1,0;5,0;;;3,0;;69,0;;;;;;;;;;;1,0;;2,0;2,0;;1,0;;;;1,0;1,0;18,0;7,0;17,0;;;2,0;;3,0;;;19,0;26,0;;;;;6,0;;;;;;3,0;3,0;;;;1,0;;2,0;;;;;;4,0;1,0;4,0;5,0;;;;;;;;;6,0;;;6,0;7,0;;7,0;;;;2,0;4,0;;;;;3,0;;;1,0;;;;;2,0;4,0;1,0;76,0;;2,0;;7,0;;1,0;2,0;;;;;6,0;;;;;;;;;;;;;4,0;;;;;;;3,0;;;;;127,0;;;;;1,0;;23,0;;;;;;3,0;;;;;;;;;;2,0;;4,0;;;;;;;;14,0;;;;15,0;;;;;;;2,0;4,0;;;;;;3,0;3,0;10,0;;5,0;3,0;9,0;4,0;33,0;4,0;5,0;1,0;4,0;37,0;9,0;8,0;;;;1,0;4,0;5,0;5,0;4,0;;7,0;9,0;;;25,0;4,0;2,0;6,0;11,0;;;4,0;;;5,0;9,0;3,0;8,0;;;;;7,0;;3,0;;;;18,0;11,0;5,0;2,0;;;;4,0;;;;4,0;6,0;3,0;;;1,0;5,0;;5,0;5,0;;;26,0;;1,0;;1,0;;;;;8,0;;;2,0;;;;;;22,0;;;;5,0;;2,0;;;;;;1,0;;;;;12,0;;;5,0;;;39,0;;;;;1,0;;4,0;;;;;6,0;;;;7,0;;;;2,0;;3,0;;;;;;4,0;;;;1,0;;;;;;;;;;6,0;;3,0;12,0;;8,0;3,0;4,0;;;;;;;;;;;;;;;9,0;5,0;;;;;;;;;28,0;2,0;;;1,0;10,0;4,0;;;;;;;;16,0;;;2,0;;2,0;;2,0;;;1,0;5,0;2,0;;12,0;11,0;7,0;;;3,0;2,0;2,0;;;;3,0;13,0;;4,0;;10,0;;2,0;2,0;;;;;;2,0;;;;;;10,0;;;;;;;2,0;;;1,0;5,0;;2,0;;;;2,0;;;;;20,0;;;;;;1,0;;;1,0;;3,0;7,0;;11,0;;;1,0;;;2,0;;;;;;;;;;10,0;;;;13,0;;5,0;1,0;;;1,0;1,0;;;;;;;1,0;;1,0;;3,0;;;;;;;;;;;;;;;1,0;;1,0;;10,0;;;;1,0;;;1,0;;4,0;;;;;3,0;;;;;1,0;;;;9,0;;;;;;;;3,0;6,0;;;;;;;4,0;;;3,0;;;;;;;;;1,0;;;;;;5,0;;;;;;1,0;;;;;4,0;;;;1,0;3,0;;;2,0;;;;;;;;;;;;15,0;;4,0;;;1,0;;;;;;1,0;;;;;;;9,0;;;10,0;1,0;;;;;;2,0;4,0;;;5,0;1,0;;;;;;;;1,0;;;;;;;3,0;;;5,0;1,0;;;;;1,0;;;;;3,0;;;;;5,0;;1,0;;;;;15,0;3,0;;1,0;;;;1,0;1,0;;;;;;1,0;;;;;;;;;;2,0;;4,0;;;1,0;;;;;;;;;;;;;;;;3,0;;6,0;2,0;;;4,0;;;1,0;1,0;;;;;;;1,0;;;1,0;;;;;;;;2,0;;;;;;;;;2,0;;;;1,0;;;2,0;4,0;;;;2,0;;;10,0;;;;;;;;;;;;;;;;;;;;;;;;;
substrate;;;;6,0;1,0;62,0;205,0;175,0;;;1,0;2,0;13,0;78,0;;;33,0;19,0;26,0;;53,0;;60,0;;8,0;;;66,0;1,0;;96,0;21,0;;6,0;42,0;16,0;27,0;;19,0;1,0;2,0;270,0;1,0;19,0;101,0;479,0;;244,0;;;;1,0;62,0;22,0;2,0;7,0;422,0;;1,0;23,0;76,0;;7,0;;549,0;6,0;552,0;8,0;6,0;15,0;18,0;591,0;175,0;49,0;;;63,0;5,0;;16,0;165,0;24,0;;;385,0;3,0;;112,0;11,0;7,0;;55,0;24,0;11,0;;;188,0;25,0;549,0;1,0;134,0;5,0;20,0;13,0;22,0;14,0;;1,0;2,0;;;8,0;257,0;6,0;2,0;2,0;1,0;20,0;6,0;597,0;;;89,0;7,0;2,0;1,0;89,0;;14,0;25,0;4,0;;2,0;301,0;;;16,0;1,0;;9,0;3,0;20,0;;;54,0;13,0;57,0;295,0;9,0;68,0;;26,0;48,0;78,0;5,0;23,0;;14,0;1,0;23,0;88,0;229,0;;16,0;26,0;11,0;315,0;90,0;;26,0;37,0;;3,0;86,0;;32,0;12,0;6,0;;;1,0;1,0;12,0;111,0;2,0;86,0;70,0;3,0;30,0;30,0;2,0;;17,0;29,0;24,0;121,0;147,0;21,0;15,0;9,0;83,0;466,0;;4,0;7,0;1,0;102,0;42,0;;178,0;26,0;6,0;1,0;5,0;1,0;11,0;4,0;37,0;3,0;7,0;71,0;;;97,0;18,0;8,0;574,0;2,0;10,0;2,0;9,0;5,0;4,0;1,0;9,0;;10,0;31,0;;11,0;26,0;15,0;;;17,0;8,0;76,0;26,0;422,0;;4,0;90,0;67,0;65,0;;20,0;196,0;880,0;13,0;4,0;61,0;67,0;78,0;2,0;23,0;;2,0;10,0;3,0;14,0;;142,0;58,0;;;;1,0;25,0;15,0;;;6,0;24,0;59,0;;;73,0;8,0;318,0;2,0;71,0;6,0;;;;2,0;39,0;;6,0;2,0;9,0;6,0;222,0;;;10,0;;4,0;8,0;156,0;2,0;;23,0;5,0;;;79,0;;11,0;;;3,0;88,0;29,0;28,0;12,0;93,0;;11,0;39,0;3,0;;;26,0;;;;;;;10,0;;;;2,0;19,0;;33,0;;8,0;;;;15,0;;2,0;4,0;141,0;;3,0;3,0;;;;;;1,0;2,0;;;;;;10,0;1,0;2,0;;;;;43,0;;;2,0;;17,0;1,0;;;;;;;8,0;10,0;1,0;2,0;4,0;;2,0;;;28,0;;1,0;7,0;;1,0;;5,0;1,0;13,0;;;4,0;3,0;9,0;1,0;;;;;4,0;15,0;;46,0;;4,0;;11,0;38,0;;;;;;;2,0;6,0;;1,0;37,0;2,0;1,0;;;;1,0;;1,0;;21,0;1,0;;8,0;;;;;1,0;;3,0;1,0;2,0;;;;;;;;;1,0;8,0;;8,0;;;6,0;;7,0;;;2,0;;;2,0;;1,0;;;1,0;1,0;;;8,0;;;;2,0;1,0;;11,0;2,0;;4,0;2,0;;3,0;;;;;;2,0;37,0;;17,0;;7,0;29,0;23,0;;4,0;;1,0;29,0;;9,0;;;;;23,0;10,0;2,0;7,0;;;3,0;;;4,0;61,0;;;;1,0;5,0;;7,0;;1,0;;;;;;;;1,0;;1,0;4,0;;;;8,0;;;;;;37,0;12,0;6,0;;;;1,0;;11,0;5,0;1,0;5,0;70,0;;;;9,0;;;;;1,0;;;9,0;;1,0;;;;;2,0;;;7,0;;48,0;4,0;;;7,0;;;;;;45,0;;;;;;;3,0;;;;;1,0;;;11,0;;;;38,0;;;4,0;1,0;5,0;13,0;6,0;;1,0;;3,0;8,0;;;;2,0;6,0;;;1,0;;;;;;4,0;71,0;;;5,0;;12,0;;4,0;;;;;;;;;2,0;;5,0;;;2,0;23,0;22,0;;;;;;;90,0;2,0;20,0;;;2,0;2,0;1,0;15,0;22,0;;;1,0;;;;;17,0;;1,0;2,0;;17,0;;;;4,0;46,0;;2,0;;2,0;;4,0;;;1,0;10,0;4,0;11,0;;114,0;4,0;;5,0;;;;1,0;;;;;;;;6,0;1,0;1,0;1,0;3,0;;6,0;8,0;;5,0;8,0;2,0;3,0;;;43,0;1,0;;4,0;;5,0;;;;;7,0;;30,0;;4,0;;;;236,0;;;18,0;;6,0;11,0;1,0;;;3,0;80,0;68,0;6,0;;6,0;1,0;1,0;179,0;2,0;10,0;3,0;12,0;3,0;;4,0;1,0;;12,0;8,0;2,0;;828,0;;;;1,0;2,0;;;20,0;7,0;5,0;10,0;;26,0;;39,0;;;;2,0;;1,0;2,0;;13,0;18,0;;;;;;;4,0;;3,0;;;;;;3,0;;;;;;;;;;;;17,0;3,0;;;;2,0;10,0;;;1,0;;;;;;;;;;;;9,0;;25,0;;;;;;2,0;;;;;;;;1,0;179,0;;4,0;;;;;;7,0;;4,0;;;;;;8,0;;;;;;5,0;1,0;;;;64,0;;;;1,0;5,0;;2,0;5,0;;1,0;;13,0;;13,0;1,0;5,0;;1,0;;;;;;;;;;;3,0;5,0;6,0;;;;;;;;5,0;;;;;6,0;3,0;;;;;;;;;;;;;;;;;;;;;
subsystem;;;;2,0;;3,0;;3,0;;;;;;7,0;;;8,0;;;;2,0;;;;16,0;;;;13,0;;31,0;5,0;1,0;;;28,0;;;1,0;;29,0;4,0;;1,0;5,0;;1,0;;;;;;;;10,0;;1,0;;1,0;9,0;;;2,0;;30,0;4,0;25,0;;1,0;;;;3,0;;;;;3,0;8,0;7,0;19,0;;;;4,0;;;1,0;;;6,0;;;;;;;;8,0;3,0;14,0;;;9,0;10,0;18,0;;;;;;5,0;;;;1,0;1,0;2,0;;19,0;;;12,0;;;2,0;44,0;;16,0;;3,0;;;3,0;;;7,0;;;;;;;;;2,0;3,0;1,0;2,0;;;;1,0;;;;;;;;;;23,0;1,0;;;7,0;;;;;;1,0;;;1,0;;17,0;2,0;;;;;;;;;;5,0;;;;;2,0;;;2,0;;;;;;;;;1,0;;;;19,0;;2,0;;;;;3,0;;;1,0;10,0;;;;;;1,0;;;;;;4,0;;;;;1,0;;;;;;;;6,0;;;1,0;;;;;;;3,0;1,0;;;;1,0;20,0;;15,0;;;;;;;;;;;;;6,0;2,0;;;;;;1,0;;;;;1,0;;;1,0;;;6,0;;;;;;;;;;2,0;;;3,0;;31,0;;;;;;;3,0;;;;3,0;5,0;;;;;;;4,0;1,0;;;;;;;;;;;3,0;;;;;;;;;;;;;;3,0;;;;30,0;2,0;;;;;;;;;;3,0;;;2,0;;;;;10,0;;;46,0;;;;;10,0;;;;;;13,0;;2,0;2,0;;;6,0;1,0;;;2,0;3,0;1,0;;4,0;3,0;5,0;2,0;2,0;;;;4,0;1,0;;;;;;;;2,0;;1,0;15,0;7,0;1,0;5,0;;1,0;2,0;;;6,0;;3,0;;1,0;;;;1,0;1,0;;;;;9,0;;;;;;;1,0;;;;1,0;3,0;;;;;;;;;;2,0;;17,0;6,0;;;;;3,0;;;;;3,0;15,0;;2,0;;24,0;;;;4,0;;;;;;10,0;;;13,0;;;;;1,0;;;;;;;;;;;;;;;;;;;;;;;;;;;;2,0;;;;2,0;;;;;;;;;;;;;;;;;;;;;;;;1,0;1,0;;;;;8,0;;;;;;;;;1,0;;;;;;;;;;;;;;1,0;;36,0;;;;;1,0;;;2,0;;1,0;;;;;;;;;;;3,0;;;;;;1,0;;;;;;;;;;;1,0;;5,0;;;;;;2,0;;;;6,0;;2,0;;;;;;;;;;;;;;;;2,0;6,0;;;;;;;;3,0;;;;;;;;30,0;;;;;;;;;;;;;;;;;;;;;;;;;1,0;;;;;;1,0;3,0;;;;;31,0;;;;;;;;;;;;;;;;;;;;;;;;;1,0;;;;;2,0;1,0;1,0;;;;;;;;;;;;;;;;;;;;;;;;;;;;;;;;;;;;;;;;;;;;;;;;;;;11,0;;;;;;;;;;;;;1,0;;;;;;;;;;3,0;;;;;;;;;;;;;;;;;;;;;;;;;3,0;;;;3,0;;;;1,0;;;;;;;;;;;;;;;14,0;;;;;;;;;;1,0;;;1,0;;;;;;;;;;;;;;;;;;;;;;;;;;;;1,0;;;;;;;;;;;;;;;;1,0;;;;;;;;;;;;;;;;;;;;;;;;;;;;;;;;;;;1,0;;;;;;;;;;;;;;;;;;;;;;3,0;;;;;;;;;;;;;;;;
superimpose;;;;2,0;;;;1,0;;;;;;4,0;;1,0;11,0;;;;;1,0;3,0;;;;;1,0;;;13,0;2,0;;1,0;;17,0;1,0;;;1,0;7,0;14,0;1,0;1,0;35,0;;;12,0;;;;;;;;;;;;15,0;;;;;110,0;;17,0;;;;2,0;1,0;4,0;;;;;;;;24,0;;1,0;8,0;;;;4,0;;1,0;1,0;2,0;;;1,0;;7,0;1,0;2,0;10,0;13,0;;1,0;;;3,0;5,0;;2,0;1,0;;1,0;1,0;;;;;4,0;6,0;3,0;;;44,0;;;;6,0;;;;;;;21,0;;;3,0;10,0;;;;;;;;;;1,0;2,0;;;;;;;;;;;;;1,0;;;;;;2,0;;;;;;1,0;;1,0;;;;;;;;;;;;;;;;;;;;1,0;;;1,0;2,0;;;;;4,0;;2,0;;;1,0;3,0;;;;;1,0;;;;3,0;2,0;;;;4,0;;11,0;;;;;;;;;;1,0;;;;;;;;;1,0;;1,0;3,0;;;;;;;;2,0;6,0;;;;6,0;;;;;;;;4,0;;;;;;;;4,0;;;;;;;;;;;;;;;;;;;;;;;;;;;;;;;;8,0;;;;;;;;;;;;17,0;;;;;;;;;;;;;1,0;;;;;;;2,0;;;;;1,0;5,0;;;;;;;2,0;;;;26,0;;;;;;;;;;;;;;;;;;;1,0;4,0;;32,0;2,0;;;;;2,0;;;1,0;;;;4,0;;1,0;;;1,0;;;;;;;3,0;;;;;;5,0;;;2,0;5,0;;;;;;;;;;;;;;;;;;;;4,0;;11,0;;;;;;;;;;;7,0;;;;;;;;;;;1,0;;;;4,0;;;;;;;;8,0;4,0;1,0;;;;;;;;3,0;;;;;5,0;;;;;;;;;;9,0;;;;;6,0;2,0;;;3,0;;;;;2,0;;;;;12,0;;;;;;;;3,0;;;;;;;;1,0;;;;;3,0;;;;;;;1,0;4,0;10,0;;;;10,0;;;;;;;;1,0;;;;;;;;;3,0;;;2,0;;;;;;;;3,0;;;;;;7,0;;;;3,0;;;;;;;;;;;1,0;1,0;;2,0;;;;;3,0;;;;;;;;;;;;;;;;;;;;;;;7,0;;;;3,0;;;;;;;;;;;;;;;;;;;;;3,0;1,0;14,0;;;;;;3,0;;;;1,0;;;;;;2,0;;;;;;;;;;;;;;;;;;;;;;;;2,0;;;;;;;;1,0;;;;4,0;;;;;;;;;;;;;;;;;;;;;;;;;;2,0;;;;;;;;;;;;2,0;;;;;;;;;;;;;;1,0;;;;;;;;;;;;;;;;;;1,0;;;;;;2,0;;;;;;;;;;;;;;;;;;;;;;;;2,0;;;2,0;;;;;;1,0;;;;1,0;1,0;;;10,0;;9,0;;;2,0;;;;;;;;;;;;2,0;;;;;;;;;;;;;;3,0;;;;;;;;;2,0;;;;;1,0;;;;2,0;;;;;;;;;;;;;3,0;;;;;;;;2,0;;;;;;;;;;;;;;;;4,0;;;;;1,0;;;;;;2,0;;4,0;1,0;;;;;;;;;;;;;;;;;;;;;;;;;;;8,0;;;1,0;;;;;;;;;;;;1,0;;;;;;;;;;;;;;;;;1,0;;;;;;;;;;;;;;;
synchronize;;;;4,0;2,0;13,0;2,0;1,0;;;;;4,0;54,0;;;67,0;2,0;;;;;6,0;1,0;2,0;;;4,0;;;29,0;10,0;;4,0;;76,0;;;7,0;;10,0;57,0;;16,0;14,0;;;;;;;;;;;;;;5,0;26,0;1,0;;3,0;3,0;159,0;1,0;9,0;3,0;;;;10,0;19,0;;;;;;;2,0;68,0;1,0;10,0;;11,0;;1,0;;2,0;;7,0;;2,0;;9,0;;12,0;;52,0;4,0;3,0;2,0;;5,0;5,0;15,0;1,0;1,0;;;;30,0;;3,0;;;1,0;12,0;5,0;71,0;7,0;;130,0;;;2,0;29,0;;;;97,0;;;12,0;;;2,0;2,0;4,0;;;;;;;;;;;;;;2,0;;;;;;;;;3,0;;1,0;;;;;3,0;;;;1,0;3,0;;15,0;;5,0;1,0;;;;3,0;;;;;;43,0;1,0;;;;;;;;;;;;;;;;5,0;;;2,0;;1,0;1,0;5,0;;;;9,0;;;2,0;7,0;14,0;;;1,0;;1,0;;;6,0;;2,0;6,0;;;;1,0;;;2,0;;;;;;1,0;;;;;;;;;1,0;3,0;;1,0;;;3,0;10,0;10,0;4,0;;;;;;;;;;1,0;;;;3,0;;3,0;;1,0;;;;;;1,0;8,0;;;;;;;;2,0;2,0;;;;;;1,0;;;;;;15,0;;;;;1,0;;;;4,0;;2,0;2,0;;;;;;;;;;;;;6,0;;;;;;;1,0;2,0;;;;;;;;;;15,0;;1,0;;;;60,0;2,0;;;;5,0;;;;;;;;;;;3,0;1,0;2,0;3,0;;;13,0;;6,0;2,0;;6,0;;2,0;6,0;2,0;;6,0;;;;11,0;;5,0;;;;4,0;;8,0;1,0;;;1,0;11,0;1,0;;2,0;;1,0;27,0;;;;;;;5,0;;2,0;;7,0;11,0;1,0;2,0;;7,0;;13,0;1,0;6,0;;2,0;;6,0;19,0;;14,0;;1,0;;;;;5,0;;;;2,0;;;;;2,0;;;3,0;;5,0;;;;;;;3,0;;;21,0;6,0;;;;1,0;2,0;;;;;6,0;5,0;;5,0;;3,0;;;;;1,0;1,0;;;;;;2,0;14,0;;;;2,0;;;;;10,0;;;;;6,0;;3,0;;;1,0;;;;;;;;;;;;;;9,0;;1,0;;;;1,0;;;1,0;;1,0;;;2,0;;;;;;;;;;;;;8,0;;;1,0;;;;;17,0;;;;;;;;;;;1,0;;;;;;;;;5,0;1,0;;2,0;;;;;;3,0;;;;1,0;;7,0;;;21,0;2,0;;1,0;1,0;;;1,0;;;;;2,0;;;1,0;1,0;;;;;;;;;;6,0;;;;;;4,0;;1,0;;;;6,0;;;;;9,0;3,0;;;1,0;;;;5,0;;;4,0;11,0;;11,0;;;3,0;;;3,0;;;;1,0;;;1,0;4,0;;10,0;;;14,0;;1,0;3,0;;;;1,0;;53,0;;2,0;;;;2,0;;2,0;;;4,0;4,0;;;;;;;;;;;2,0;;;;;;;;;1,0;;;;3,0;2,0;;;;;3,0;;;;12,0;;;;;;;;;;;3,0;;;;;2,0;;;;;;;;;;;;;;;;;;1,0;;;;;;;;;;;;1,0;;;;;;;;1,0;;;;5,0;;;1,0;;;;13,0;;;;3,0;1,0;;2,0;;;;;;3,0;;;1,0;;;1,0;;1,0;;;;;;;;;;;2,0;;;;;;;;;;1,0;;;3,0;;1,0;3,0;;;;;;;;1,0;;;;;;;;;;1,0;2,0;;;6,0;;;;;;;;;;;;;;;;;;;;;;;;10,0;;;;;;6,0;;;;;;;1,0;;1,0;;;;;;;6,0;1,0;;2,0;;;;;;8,0;;;1,0;;;;;;;;;;1,0;;;;;;;;;;;;;;;;;1,0;;;1,0;;;;;;;;;;;;;;;;;;;;;;;2,0;;;;;;;5,0;;;;;;;;
television;;;;3,0;;29,0;;;;;;;;8,0;;;2,0;;;;;;;2,0;;;;;1,0;;5,0;;;;;2,0;;;;;44,0;115,0;;3,0;44,0;;;;;;;;;;;;;;;;;;;;53,0;;1,0;;;;;;4,0;;;;;;;;29,0;;;7,0;1,0;;;7,0;;;;;;;;;;;1,0;2,0;1,0;;1,0;1,0;4,0;20,0;1,0;41,0;;;;;2,0;;;;7,0;;1,0;4,0;8,0;;34,0;;;11,0;29,0;;;;1,0;;;2,0;;;;;;;;;;;;;;;28,0;;;;;;;;;;;;;5,0;;19,0;;;;;;;5,0;;;;;;;;;;;;;;;4,0;5,0;;1,0;;;;;;;;;;;;;;2,0;;;;;;;;;;;;;;65,0;;;;;2,0;;;;;2,0;;;;;;;;;;;;;;;3,0;;;;15,0;;;;;;;;;;1,0;;;;;;;;2,0;;;;;;1,0;;;;;;;1,0;;;;;;;;;;;;;;;;;;;;;5,0;;;;;;;;;;;;;;;;;;;;;;;;;;;;;;;1,0;;;;;;1,0;;;;;;;;;;;;;;;;;;;;1,0;;;;10,0;;;;;;;;;;;;;;;;;;;36,0;;;148,0;;;;;;;1,0;;1,0;;;;;;4,0;;1,0;2,0;;;;1,0;;;;;4,0;1,0;;;;;;;;;;;;2,0;4,0;;;;30,0;134,0;25,0;;;;;;1,0;;;;;;2,0;;;;;;;6,0;;2,0;;;;;;;;;;;;1,0;;;;;;;;;;3,0;;1,0;3,0;;;;;;;;;;;;;;;;;;;;;8,0;;8,0;;;;;6,0;;;;2,0;;;;;;;;;;;;;;;2,0;;;;;;;;;;;;;;;;;;;;;;;;;;4,0;;;;;;;;4,0;;;;;;1,0;;;;;;;;;;;;;;;;;;;;;;;2,0;1,0;;;1,0;;;;;3,0;;;83,0;;;;;;1,0;;;;;;;;;;;;;1,0;;;43,0;;;;;;;;;;;;;;;1,0;1,0;;;;;;;;;;;;;;;;;;;;;;;;;;;;68,0;;;;;;;;;;;;;;;;;;;;;;;;;;;2,0;;;;;;;;;;;;;;;2,0;1,0;;;;;;;;;;;;;;;;;;;;;;;;;;;;;;;;;;;;;;;;;;;;;;;;;;;;1,0;;;1,0;;;;;;;;;;;;;;;;;;;;;;;;;;;;;;;;;;;;;;;;;;;;;;;;;;;;;;;;;;;;;;;;;;;;;;;;;;;;;;;;;;;;;;;;;;;;;;;;;;;;;;1,0;;;;;;;;;;;;8,0;;;;;;;1,0;;;;;;;;;;;;;;;;;4,0;;;;;;;;3,0;;;;;;;;;;;;;;;1,0;;;;;;;;;;;;;;;;;;;;;;;;;;;;;;;;;;;;;;;;;;;;;;;;;;;;;;;;;;;;1,0;;;;;;;;;;;;;;;;3,0;;;
temperature;;;;46,0;5,0;18,0;3,0;10,0;;;;3,0;2,0;94,0;;22,0;29,0;16,0;;9,0;;;299,0;4,0;3,0;2,0;48,0;32,0;2,0;10,0;78,0;33,0;7,0;13,0;;57,0;7,0;88,0;11,0;1,0;129,0;45,0;;1,0;27,0;7,0;1,0;40,0;;7,0;3,0;;;5,0;4,0;10,0;1,0;;;34,0;7,0;;4,0;;103,0;;47,0;33,0;4,0;;22,0;152,0;107,0;1,0;1,0;10,0;6,0;9,0;6,0;5,0;102,0;;7,0;6,0;62,0;1,0;;26,0;1,0;1,0;11,0;;4,0;;;;25,0;9,0;21,0;34,0;25,0;30,0;;3,0;12,0;14,0;30,0;1,0;;;;28,0;143,0;;2,0;;1,0;5,0;20,0;256,0;;2,0;24,0;5,0;3,0;8,0;91,0;;7,0;;135,0;1,0;2,0;34,0;2,0;;4,0;;26,0;;;3,0;;6,0;1,0;1,0;15,0;5,0;11,0;1,0;4,0;;5,0;;;;;1,0;2,0;;6,0;23,0;;;;5,0;16,0;;;11,0;9,0;;;7,0;;;1,0;13,0;3,0;;;;6,0;22,0;;4,0;2,0;8,0;2,0;;;;40,0;;;1,0;21,0;1,0;;1,0;3,0;8,0;;1,0;83,0;2,0;4,0;;;6,0;18,0;3,0;22,0;;;2,0;22,0;;;;12,0;6,0;;;2,0;;4,0;15,0;4,0;1,0;;1,0;42,0;27,0;;2,0;;1,0;;8,0;4,0;;;;;20,0;3,0;;1,0;;;1,0;;;1,0;10,0;;5,0;3,0;;;20,0;;26,0;;19,0;3,0;;22,0;38,0;;;;5,0;3,0;;2,0;;;4,0;;1,0;1,0;25,0;;;2,0;;7,0;;;;3,0;;;;15,0;2,0;;;;;1,0;7,0;;1,0;3,0;1,0;;10,0;;;11,0;;;;9,0;;;7,0;3,0;27,0;;;;1,0;4,0;;46,0;2,0;;;;;17,0;;1,0;;;;;;;;1,0;;7,0;6,0;;4,0;;;;;;;1,0;1,0;33,0;3,0;;1,0;1,0;;1,0;6,0;5,0;;;;;;19,0;;117,0;12,0;;;26,0;8,0;48,0;;;1,0;;102,0;2,0;52,0;;;17,0;6,0;;8,0;;1,0;8,0;;22,0;12,0;1,0;3,0;6,0;2,0;1,0;3,0;1,0;25,0;3,0;6,0;;4,0;2,0;46,0;31,0;14,0;;1,0;7,0;;;66,0;10,0;2,0;;49,0;22,0;41,0;12,0;;172,0;;26,0;2,0;1,0;;31,0;22,0;19,0;;;3,0;133,0;;;3,0;;3,0;1,0;;;7,0;11,0;;1,0;2,0;;14,0;;;10,0;4,0;;3,0;;;;;;;5,0;4,0;4,0;;2,0;;;;3,0;6,0;;;;25,0;8,0;;22,0;;1,0;;;;8,0;1,0;1,0;;;;1,0;;2,0;;1,0;;;;;;;;1,0;7,0;;;6,0;1,0;5,0;4,0;18,0;;1,0;;;;4,0;;;;;;;;;;;;;;32,0;5,0;;5,0;6,0;18,0;1,0;;;;;;;;;;;;;;;;;4,0;3,0;42,0;24,0;;5,0;;;2,0;;;;3,0;;;44,0;1,0;;;36,0;;;;;;;;4,0;6,0;;;;8,0;;;3,0;;96,0;;;;;;;;;10,0;1,0;;23,0;;;;;;11,0;;;;;;22,0;5,0;;5,0;;;;;;2,0;;5,0;;;;5,0;;18,0;;;1,0;1,0;;;;;;;2,0;5,0;;1,0;4,0;2,0;16,0;;;7,0;;;;;15,0;;;;;3,0;40,0;;;;1,0;;;8,0;22,0;;;;;;;;;;;;2,0;;;;;;13,0;1,0;;;1,0;1,0;5,0;3,0;6,0;;;;;38,0;;;3,0;;1,0;17,0;;6,0;1,0;17,0;;;11,0;;;;;22,0;4,0;2,0;;;;2,0;14,0;;;;2,0;;3,0;;;;;1,0;;;1,0;;;;1,0;;;;;;;;;;;;;;2,0;;;;5,0;;;;;;;;;;;;;7,0;36,0;7,0;2,0;;;1,0;;;;;;;;1,0;;;;;;3,0;;1,0;;4,0;1,0;4,0;;;;;;;;;;;;;;;;;;;;8,0;;;;;;21,0;;2,0;7,0;;;;;;;1,0;7,0;2,0;1,0;;3,0;3,0;5,0;62,0;7,0;;;;;;;14,0;;;;;8,0;;;;;;;;2,0;;;;;2,0;;;1,0;1,0;;2,0;1,0;;;;;;;;;;;;;;;;1,0;;1,0;;10,0;1,0;;1,0;;3,0;;;;1,0;;;;;;;;;;;22,0;;1,0;;;;;;;;;;;;;;;;;2,0;;9,0;;;;;;;;;;;1,0;6,0;;;1,0;;;;;;;;;;;6,0;;;8,0;;1,0;;;;;;;;;;;;;;;;;;;;;
template;;;;2,0;;5,0;40,0;2,0;;;;;;27,0;;;3,0;;;17,0;;;;;;;;;;;11,0;;;;;9,0;1,0;12,0;1,0;;13,0;4,0;;2,0;;;;;;2,0;;;;;6,0;;;;;22,0;;;2,0;;135,0;1,0;5,0;1,0;1,0;;;2,0;;;;;;;;8,0;15,0;;;4,0;;;;2,0;;;13,0;;;;;;16,0;3,0;33,0;2,0;12,0;7,0;;3,0;;8,0;2,0;2,0;;;;5,0;12,0;;;4,0;;3,0;24,0;;1,0;;;15,0;;7,0;9,0;;;;15,0;;;4,0;2,0;;12,0;;;;;;;;;4,0;;;1,0;;;2,0;;;;;;;;;;;;;;;;;;;;;;3,0;;4,0;;;;;;;;2,0;;;;;25,0;;;6,0;;;;;;;;;;;2,0;;3,0;1,0;;;;;;;;;;;1,0;;;;23,0;;;;;;;;;;;;8,0;2,0;;3,0;;;;2,0;;;;;;11,0;;;;6,0;;;;2,0;;;;4,0;;;;;;1,0;;;;;;1,0;;;;;;;;4,0;;;;;;;;;;;;;;;;;;;7,0;;;;;;;;;;;;;1,0;;;3,0;;;;;;;;;23,0;;;;;;;;;;;;;;;;;;;2,0;;;;;;;2,0;;;;;;;26,0;;;;2,0;;;;;;;;;;;;;;4,0;;10,0;;;;10,0;2,0;;2,0;;;;5,0;23,0;1,0;;;;;;;;6,0;;6,0;;2,0;;9,0;;2,0;;13,0;;1,0;6,0;;;;;;;1,0;;;1,0;;;;;;;4,0;;;;;;;;;;;;2,0;;;;;;;;5,0;;;1,0;;;;;;;;2,0;10,0;;;4,0;;;3,0;;1,0;;;;;;;1,0;;;;;;;;;4,0;;8,0;;;6,0;;;;;;;;;;;;;;;;;;;;;;;1,0;;;;;;;;;;;;;;;;;;;;;;;;;;;;;;61,0;;;;;2,0;;;;;;;;;2,0;;2,0;;9,0;;;;;;;10,0;4,0;;;2,0;;;;;;;;;;;;;;;;;;;1,0;;3,0;;;;;;2,0;;;;;;;;7,0;;4,0;2,0;;;;;;;;;;2,0;;;;;;;11,0;;;;1,0;;;;;;;;;1,0;;;;;;;;;;;;;;;;;1,0;;3,0;2,0;;1,0;7,0;;;;;;;;;;;;;;;;;;;1,0;;;;;;;;;;;;;;;;;;;;;;;;7,0;;;;;;;;;;;;;;;;;5,0;;;;;;;;;;;;;;;;;;;;;;;;;;;1,0;;;;;;;;;;;;;;;;;;;;;;;;;;;;;;;;;;1,0;;;;;;;;;;;;;;;;;;;;;;;;;;;;2,0;;;;;;;2,0;;;3,0;10,0;;;6,0;;;;;;;;;;2,0;;;;;;;;;;;23,0;;;;;;;;;;;5,0;;1,0;;;;6,0;;;1,0;;;;2,0;;;;;;;;;;;;;;;;;;;;;;;;2,0;;;;;;;;;;;;;2,0;;;;2,0;;;;;;;;;;;;;;;;;;;3,0;;;;;;17,0;;;;;;;;;;;;;;;;;;;;;;;;;;;;;;;;;;;;;;;;;6,0;;5,0;;;;;16,0;;;5,0;1,0;;;;;;;;7,0;;;;2,0;;
terminal;;;;9,0;3,0;84,0;11,0;18,0;;4,0;;4,0;22,0;108,0;;8,0;73,0;3,0;58,0;1,0;;;5,0;30,0;200,0;;5,0;14,0;2,0;9,0;168,0;49,0;;6,0;2,0;95,0;3,0;8,0;;2,0;68,0;214,0;4,0;30,0;142,0;101,0;;51,0;;;;;39,0;153,0;3,0;1,0;76,0;;;20,0;;;13,0;3,0;261,0;3,0;243,0;1,0;;14,0;9,0;174,0;32,0;2,0;2,0;1,0;10,0;;3,0;12,0;149,0;;75,0;;166,0;2,0;;32,0;;5,0;6,0;7,0;18,0;10,0;73,0;;5,0;5,0;195,0;9,0;47,0;42,0;;19,0;38,0;38,0;3,0;12,0;;;;33,0;11,0;1,0;1,0;;1,0;34,0;1,0;82,0;2,0;1,0;326,0;5,0;;26,0;67,0;;1,0;10,0;65,0;3,0;2,0;277,0;;;14,0;3,0;2,0;;;20,0;;;;42,0;55,0;48,0;1,0;9,0;4,0;4,0;141,0;11,0;;10,0;;7,0;1,0;;119,0;415,0;;;89,0;5,0;285,0;26,0;3,0;55,0;;16,0;7,0;27,0;1,0;1,0;25,0;10,0;31,0;;;8,0;26,0;33,0;;1,0;4,0;2,0;12,0;35,0;;5,0;;13,0;47,0;16,0;67,0;;45,0;5,0;2,0;23,0;;3,0;;3,0;62,0;10,0;;66,0;4,0;15,0;10,0;;;71,0;380,0;10,0;1,0;;30,0;12,0;8,0;3,0;13,0;6,0;172,0;1,0;1,0;1,0;30,0;1,0;46,0;1,0;23,0;3,0;;;;22,0;1,0;13,0;;;;26,0;8,0;12,0;66,0;16,0;6,0;;10,0;;37,0;111,0;34,0;140,0;4,0;;3,0;62,0;6,0;5,0;24,0;;;;;6,0;;68,0;65,0;13,0;;;5,0;18,0;2,0;1,0;;10,0;15,0;86,0;;;5,0;21,0;210,0;3,0;97,0;4,0;;11,0;;1,0;34,0;13,0;20,0;26,0;;7,0;2,0;1,0;;12,0;1,0;;4,0;26,0;;2,0;5,0;3,0;1,0;;33,0;5,0;3,0;2,0;733,0;3,0;15,0;4,0;;;6,0;4,0;117,0;20,0;2,0;;;17,0;3,0;2,0;;;;1,0;2,0;28,0;2,0;4,0;3,0;;12,0;3,0;;15,0;;;1,0;;;;25,0;48,0;27,0;10,0;;13,0;;6,0;1,0;18,0;;5,0;;8,0;;4,0;2,0;3,0;19,0;5,0;3,0;3,0;10,0;1,0;305,0;1,0;1,0;;;48,0;4,0;2,0;;15,0;;28,0;10,0;13,0;3,0;19,0;;6,0;18,0;;;355,0;;29,0;3,0;14,0;;107,0;12,0;8,0;;34,0;;50,0;33,0;23,0;;;;;;;4,0;5,0;;205,0;41,0;29,0;;;16,0;23,0;17,0;3,0;;;12,0;6,0;41,0;4,0;3,0;;8,0;;1,0;;;1,0;217,0;5,0;;244,0;18,0;1,0;4,0;11,0;;;1,0;;6,0;22,0;1,0;2,0;;;;9,0;7,0;;6,0;;16,0;21,0;1,0;22,0;;;;;8,0;;13,0;1,0;;;37,0;1,0;243,0;;24,0;;;;;6,0;48,0;;21,0;1,0;;4,0;1,0;31,0;;;;1,0;;1,0;;;6,0;;1,0;;;10,0;3,0;4,0;127,0;89,0;;;;;;;;3,0;1,0;;4,0;4,0;1,0;;3,0;;2,0;2,0;2,0;2,0;;6,0;1,0;20,0;;4,0;5,0;19,0;;2,0;47,0;4,0;34,0;7,0;;;2,0;;1,0;33,0;;;5,0;;1,0;2,0;14,0;1,0;;5,0;36,0;3,0;;;;1,0;;;2,0;;;14,0;1,0;;18,0;20,0;9,0;;9,0;;1,0;2,0;;;;24,0;15,0;3,0;;;;3,0;;4,0;;3,0;6,0;51,0;8,0;9,0;;138,0;16,0;;;;1,0;12,0;2,0;;2,0;1,0;2,0;;;1,0;4,0;;;10,0;;49,0;20,0;2,0;;5,0;2,0;4,0;9,0;;7,0;;71,0;;;;25,0;;;2,0;6,0;;1,0;1,0;;;7,0;1,0;;22,0;46,0;;3,0;;;;4,0;22,0;33,0;;10,0;13,0;;;;;3,0;;30,0;;6,0;8,0;3,0;21,0;;2,0;12,0;;6,0;17,0;53,0;2,0;;73,0;;1,0;1,0;13,0;3,0;;3,0;23,0;46,0;;;12,0;;2,0;;;1,0;;6,0;4,0;5,0;77,0;19,0;5,0;;;7,0;;4,0;;;;;1,0;;1,0;;1,0;1,0;;4,0;1,0;2,0;3,0;57,0;;2,0;;;;5,0;4,0;;11,0;;5,0;2,0;;;1,0;6,0;4,0;1,0;1,0;13,0;;;1,0;1,0;2,0;;;;;20,0;19,0;;;;;;;11,0;2,0;;;;;4,0;;3,0;4,0;;;69,0;12,0;8,0;72,0;23,0;;34,0;3,0;;;4,0;11,0;77,0;14,0;3,0;;;;;1,0;10,0;;;2,0;2,0;;6,0;;;;5,0;;;;10,0;1,0;1,0;1,0;16,0;16,0;1,0;310,0;;;;;4,0;;;;;;;;1,0;12,0;;8,0;;;;;;;;7,0;;;6,0;;;13,0;;3,0;;;;;;4,0;;;6,0;;;;;14,0;;;;;4,0;;;4,0;;1,0;;;2,0;5,0;;3,0;2,0;7,0;;;;27,0;;;;;;1,0;9,0;1,0;;;1,0;1,0;;5,0;;;;;;;5,0;;5,0;;;;;;10,0;;6,0;;;;;;;;;3,0;2,0;1,0;;;;;;2,0;;;;6,0;;1,0;7,0;;;;;;;;;;;;;;;;;;;;;1,0;;;;;;;;;;;;;;;;;;;1,0;;;;;
text;;;;1,0;5,0;5,0;;;;3,0;;;;14,0;;;42,0;;;;;;13,0;1,0;2,0;1,0;;;17,0;;12,0;;;;;17,0;;;;;45,0;47,0;;;70,0;;;7,0;;;5,0;;;;16,0;;3,0;;;19,0;;;;;154,0;1,0;34,0;1,0;;;1,0;;;;;;;;5,0;;79,0;;4,0;;29,0;;;7,0;;1,0;2,0;;;;;;11,0;9,0;16,0;14,0;5,0;6,0;;1,0;4,0;9,0;3,0;10,0;2,0;;;;38,0;;;;;12,0;17,0;3,0;;;;13,0;;28,0;29,0;;;;8,0;;;3,0;;;1,0;4,0;;;;;;;;1,0;14,0;1,0;18,0;;;7,0;;12,0;;;;;;;;1,0;9,0;24,0;9,0;;;;;10,0;;;5,0;13,0;;12,0;;;;;;;;1,0;;;;;;;;;;3,0;;;;;;;;4,0;;;;6,0;;;1,0;;1,0;;;;;;18,0;5,0;;3,0;;;1,0;;2,0;;9,0;;1,0;;;;1,0;;;59,0;;;;1,0;;3,0;;;;20,0;3,0;5,0;;;;;;4,0;;1,0;;15,0;;;;4,0;8,0;2,0;;;;;1,0;5,0;;;;;;;2,0;3,0;;;;1,0;;;2,0;;;1,0;;;;1,0;;;;;2,0;;;;;;;;;;;;2,0;;;;;;2,0;;3,0;;;;19,0;11,0;;;;1,0;;;;;;;;;5,0;;;;;;9,0;;;;;;;;;;;;;;2,0;;;;6,0;;;;;22,0;;1,0;14,0;;;1,0;;;5,0;1,0;6,0;;;2,0;22,0;2,0;2,0;11,0;;;;27,0;;3,0;;1,0;;1,0;29,0;2,0;6,0;9,0;;31,0;13,0;;;68,0;;;;19,0;1,0;2,0;5,0;;;2,0;2,0;;2,0;7,0;;;;;;;;2,0;11,0;16,0;1,0;28,0;;;;;;;;;7,0;20,0;;;1,0;;3,0;;2,0;6,0;5,0;;11,0;;;;8,0;;;;;;;2,0;13,0;;;1,0;1,0;;1,0;5,0;;;10,0;;10,0;4,0;;;;;;1,0;;;;1,0;;;32,0;;;;;;;10,0;;;2,0;;;;;16,0;;;;11,0;;;;2,0;17,0;;;;;;;;;;;;1,0;;;;;;;2,0;;2,0;;2,0;2,0;;;34,0;6,0;4,0;;;;;9,0;1,0;1,0;;;2,0;;;19,0;7,0;1,0;28,0;;;;;;;;;;;9,0;;;;;;1,0;;;3,0;;4,0;;;;;;;;;;2,0;4,0;4,0;2,0;;;;;;;4,0;3,0;;;1,0;;3,0;;5,0;;;;;;;4,0;;1,0;;;6,0;;;;;;;2,0;;;;1,0;1,0;;;;;;;;;;;3,0;;;;;;;;;;;;;;;2,0;72,0;10,0;;;;;;1,0;;;;;;;;4,0;;;2,0;;;;3,0;2,0;;;;;;;;;;;;;;1,0;;2,0;;;;;;2,0;2,0;;;;;;;;;1,0;;;1,0;;;;;;28,0;;;8,0;;;;;;;;;;;;;;;;;1,0;;4,0;;;;;2,0;;;;;;;;;;;;;;;4,0;;;;;;9,0;;;;3,0;;;;;;;;;;;;;;;1,0;;;;;2,0;;;;6,0;;;;;;;;;;;;;;;;;;;9,0;;;;;;;;12,0;11,0;;3,0;2,0;;;;;;;87,0;;;;;;;;;;;;;;2,0;;1,0;;;;;;;37,0;;;;;;;;;4,0;19,0;;;1,0;;;;;;;;3,0;;;;3,0;;;4,0;;;14,0;;11,0;;;4,0;;5,0;1,0;;;;;;2,0;;;;;;;;;4,0;;;;;;;;;;;;;5,0;;;;;;;;;;;;;;;;;;;;;;;;;;;;;;;;;;;;;;;;;;7,0;;;;;;;;;;;;;;;;4,0;;;;;;;;;;;;;;;;;
thereon;;;;1,0;1,0;6,0;2,0;25,0;;;;1,0;5,0;14,0;;;6,0;;;1,0;10,0;;2,0;;4,0;;;10,0;51,0;;18,0;5,0;;1,0;;9,0;4,0;;2,0;;6,0;43,0;;3,0;13,0;47,0;;8,0;;;3,0;;8,0;;;3,0;42,0;;;6,0;;;;;62,0;4,0;32,0;;;;1,0;43,0;31,0;;;;10,0;;19,0;18,0;16,0;;8,0;3,0;15,0;3,0;;18,0;;1,0;1,0;1,0;1,0;;;;;;32,0;2,0;11,0;;;6,0;16,0;148,0;5,0;62,0;;;;3,0;6,0;;6,0;;;4,0;;52,0;1,0;4,0;6,0;1,0;;170,0;38,0;;;;;;;30,0;1,0;;1,0;;;;;7,0;;;3,0;1,0;7,0;16,0;;3,0;2,0;6,0;12,0;5,0;;;;2,0;;;19,0;10,0;;2,0;;;13,0;2,0;;1,0;2,0;;1,0;5,0;;;;;4,0;;;;7,0;2,0;;6,0;3,0;;6,0;13,0;;;;5,0;7,0;7,0;33,0;11,0;1,0;3,0;1,0;6,0;1,0;;;100,0;30,0;;;90,0;4,0;2,0;;;;1,0;2,0;4,0;;1,0;5,0;;;;10,0;;19,0;;;;9,0;11,0;;;13,0;;;;;1,0;;2,0;;;1,0;1,0;1,0;1,0;9,0;;3,0;;;5,0;11,0;;44,0;12,0;2,0;;;3,0;;4,0;;;;2,0;2,0;12,0;;;1,0;9,0;;1,0;2,0;2,0;3,0;1,0;;;6,0;21,0;;2,0;3,0;4,0;30,0;4,0;16,0;4,0;;1,0;;;;;1,0;;1,0;;1,0;;2,0;7,0;;1,0;1,0;11,0;;;1,0;1,0;;;6,0;;;;3,0;13,0;;;;;;;;11,0;9,0;;1,0;8,0;31,0;;;;;1,0;3,0;;1,0;3,0;8,0;9,0;1,0;4,0;;;1,0;1,0;;2,0;11,0;;;8,0;18,0;1,0;;;2,0;;;1,0;;;;;;;;;2,0;;;;;;8,0;1,0;;1,0;;1,0;;;;;;117,0;;4,0;;1,0;;;2,0;;;;1,0;;2,0;3,0;;1,0;2,0;;;7,0;;2,0;2,0;1,0;;;;;;;;;23,0;18,0;;7,0;2,0;;2,0;;;;;;29,0;;2,0;;1,0;1,0;;;;;;2,0;;;;;1,0;;3,0;1,0;;3,0;;;14,0;;;1,0;;22,0;;21,0;;;1,0;;186,0;3,0;1,0;;;;1,0;1,0;4,0;3,0;1,0;4,0;1,0;;18,0;;;3,0;;;;3,0;;;;;1,0;;;2,0;;;;1,0;2,0;;;;;;;;1,0;;;3,0;;;1,0;16,0;;;;;2,0;;;;;;4,0;10,0;;;;1,0;;;;;6,0;7,0;;1,0;;;;;;5,0;1,0;4,0;2,0;;;;1,0;;1,0;;4,0;;;;1,0;1,0;;1,0;;1,0;;4,0;1,0;1,0;;3,0;1,0;;4,0;;;;2,0;;;5,0;21,0;;3,0;;;;;;1,0;;3,0;;1,0;25,0;1,0;;;;1,0;;;;1,0;;;;;;;;;;;;2,0;;;;;;;;;;;1,0;;;;;;;1,0;;;2,0;;;;;;;;;5,0;;;2,0;;;;;;;;;3,0;;;;1,0;;2,0;;;;;;;;2,0;;;;2,0;;;;;2,0;1,0;;;;5,0;;;6,0;;;;;;;;;7,0;;;1,0;;;;;;;;1,0;;5,0;2,0;;;;;;;;3,0;;;;;;4,0;2,0;1,0;;;;;;;;;;;1,0;;2,0;;;3,0;1,0;;;;;1,0;;;2,0;;;;;;;;;;1,0;;;1,0;;1,0;;1,0;;2,0;;;;;;7,0;;;;;;;;;;;;;;;;;;;;;;;;1,0;;;;;;;1,0;;;1,0;;;;;;2,0;;;;1,0;3,0;;6,0;;;;;;;;;1,0;;;;;;;;;;;2,0;;;;;2,0;;;;;;;;;;;;;;;1,0;;;;;2,0;;;;7,0;1,0;;;;;;;;;;3,0;;;;8,0;;;;;;;;;;5,0;3,0;;;;;6,0;;;;;;;;;3,0;4,0;;;;;;;1,0;;;;6,0;3,0;;;;;;;;1,0;;;;;;;;;;;;;;;;1,0;;;6,0;;;;;;;;;;;;1,0;;;;;;;;;;;;;;;;;;;;;;;;;;;
thermal;;;;5,0;;37,0;7,0;28,0;;;;;5,0;25,0;;;24,0;;;4,0;1,0;;;;1,0;3,0;9,0;14,0;;1,0;45,0;6,0;;6,0;;32,0;7,0;7,0;8,0;;34,0;24,0;;1,0;7,0;17,0;2,0;83,0;;;;;10,0;;7,0;7,0;8,0;;;5,0;2,0;;1,0;;219,0;;52,0;5,0;;;9,0;46,0;16,0;;;3,0;82,0;2,0;4,0;12,0;39,0;;12,0;3,0;39,0;12,0;;15,0;1,0;9,0;1,0;12,0;3,0;;1,0;;19,0;22,0;15,0;;35,0;;;28,0;11,0;6,0;;2,0;;;;;22,0;;;;5,0;2,0;87,0;69,0;1,0;;17,0;4,0;;8,0;67,0;;2,0;;7,0;;;9,0;;1,0;8,0;;;;;;2,0;;1,0;1,0;81,0;1,0;15,0;15,0;;;1,0;3,0;;;;;5,0;;30,0;3,0;;;;;17,0;3,0;;;16,0;1,0;;19,0;;1,0;;;2,0;;1,0;;;12,0;;;1,0;5,0;11,0;2,0;;;29,0;;3,0;;75,0;20,0;2,0;;5,0;29,0;;12,0;7,0;2,0;6,0;;;15,0;6,0;2,0;;;;1,0;4,0;6,0;2,0;22,0;38,0;;2,0;;9,0;;84,0;;;3,0;;27,0;7,0;2,0;1,0;1,0;;;;5,0;1,0;11,0;;;3,0;2,0;6,0;1,0;6,0;;;6,0;3,0;9,0;4,0;1,0;19,0;20,0;;;11,0;3,0;1,0;13,0;3,0;2,0;;2,0;;4,0;;;;1,0;;;;6,0;;2,0;2,0;1,0;2,0;16,0;;;;;19,0;;;;;2,0;;;5,0;;2,0;17,0;;;5,0;;;3,0;1,0;1,0;1,0;138,0;;;9,0;;;;6,0;;;;;37,0;7,0;;;;;;4,0;;1,0;;;3,0;6,0;;8,0;4,0;;;1,0;4,0;;;;;;;;5,0;;;28,0;;7,0;16,0;1,0;5,0;34,0;;2,0;;;;15,0;;9,0;;;;;;3,0;1,0;18,0;2,0;;;6,0;2,0;5,0;;;2,0;;62,0;1,0;3,0;;;;;;6,0;1,0;6,0;;5,0;;5,0;;;1,0;5,0;;2,0;;5,0;4,0;1,0;;1,0;;14,0;3,0;;;4,0;;;;14,0;;;2,0;10,0;2,0;21,0;5,0;;2,0;;1,0;;;;;5,0;;;42,0;;3,0;;;3,0;;1,0;;;;;;;;;;6,0;7,0;2,0;1,0;3,0;;3,0;;;;;;;;;2,0;5,0;17,0;;;;1,0;3,0;;;;;5,0;;16,0;1,0;;;;1,0;;;1,0;;;1,0;;;;;;;;1,0;5,0;;2,0;;1,0;1,0;;;;;;;;58,0;3,0;4,0;;;;;20,0;;;;1,0;;;;;;;;1,0;4,0;;9,0;3,0;7,0;;;;;;;;;4,0;;;1,0;;;;2,0;1,0;2,0;1,0;;3,0;;38,0;;;1,0;1,0;;;13,0;;;;;;10,0;;;2,0;;;;5,0;;3,0;9,0;;;;2,0;;;;;3,0;;;;4,0;;1,0;;;;;;;;4,0;;;;15,0;;;32,0;;;15,0;4,0;;;;;;;;8,0;1,0;;;;;;;;;;;1,0;;;;;;1,0;;2,0;;;;;;2,0;;;;;;;17,0;;;;;;2,0;6,0;;;1,0;;1,0;;2,0;;;;;;;;;;;;;1,0;;;1,0;103,0;5,0;2,0;;;;;1,0;;;;;13,0;;;;;;;;;;;1,0;;;;;;1,0;2,0;;;;1,0;;;;;10,0;;;;;;;;;1,0;;;;6,0;;;;;;;1,0;;;;4,0;1,0;;;;;;;1,0;;;;;6,0;;;;;2,0;;;2,0;;;;2,0;1,0;;;;;;;;;;;107,0;;;;;;;;;1,0;;;;;;;;;;;;;;1,0;;;;;;;;;13,0;;;;;;;;57,0;;;52,0;;;2,0;;;;;2,0;;;;;2,0;;;2,0;;1,0;;;13,0;;;;;;;;;;;;;;1,0;3,0;;;;;;1,0;;;;;4,0;;;;;;;7,0;;;;;;;;;;;;;;1,0;1,0;;;;;1,0;;;1,0;2,0;;;;1,0;;;;;;;;;;;;;2,0;2,0;;;;;;;;;;;;1,0;;;;;;;;;;73,0;;;;;;;;;;;;;;;;1,0;6,0;2,0;;7,0;;;;;2,0;;;;1,0;2,0;;;;;;;;;;;;;
threshold;;;;49,0;211,0;83,0;20,0;3,0;;2,0;;1,0;;125,0;3,0;98,0;87,0;2,0;2,0;4,0;8,0;2,0;33,0;5,0;6,0;1,0;3,0;23,0;33,0;92,0;66,0;18,0;1,0;12,0;;94,0;35,0;28,0;108,0;;499,0;156,0;;67,0;49,0;;2,0;6,0;;64,0;26,0;;4,0;1,0;18,0;3,0;13,0;;9,0;78,0;1,0;12,0;16,0;;431,0;;92,0;23,0;4,0;2,0;21,0;70,0;96,0;;14,0;27,0;;74,0;8,0;20,0;427,0;;75,0;27,0;29,0;;3,0;14,0;;;34,0;2,0;7,0;;2,0;;322,0;4,0;99,0;100,0;142,0;769,0;1,0;19,0;57,0;78,0;3,0;12,0;31,0;1,0;;43,0;57,0;11,0;2,0;;32,0;14,0;16,0;116,0;6,0;;144,0;27,0;;20,0;177,0;;8,0;;298,0;14,0;;60,0;3,0;6,0;21,0;6,0;73,0;;;9,0;;;18,0;18,0;36,0;1,0;83,0;1,0;10,0;28,0;11,0;;15,0;19,0;;;;;;3,0;24,0;;;4,0;6,0;2,0;11,0;29,0;29,0;47,0;6,0;22,0;2,0;68,0;;6,0;2,0;;7,0;;;38,0;;;3,0;59,0;95,0;;8,0;;3,0;;2,0;;1,0;;3,0;;;;9,0;13,0;36,0;34,0;6,0;;2,0;10,0;25,0;47,0;9,0;;;2,0;106,0;;;15,0;11,0;39,0;;8,0;1,0;;56,0;15,0;;7,0;;8,0;48,0;43,0;;1,0;;1,0;;13,0;;9,0;;;;86,0;4,0;10,0;;;;2,0;;5,0;2,0;4,0;;34,0;1,0;;14,0;21,0;5,0;47,0;1,0;;1,0;10,0;14,0;45,0;;;5,0;3,0;;;1,0;110,0;;;;22,0;8,0;1,0;25,0;;;3,0;21,0;;;11,0;;;1,0;;260,0;3,0;;;;;;7,0;5,0;;;4,0;20,0;21,0;;;1,0;;;;11,0;;;5,0;2,0;83,0;2,0;6,0;;;;;129,0;;;;;;9,0;;;;;;3,0;6,0;10,0;;4,0;;42,0;5,0;;;3,0;;5,0;;24,0;1,0;5,0;97,0;70,0;9,0;1,0;11,0;10,0;1,0;;5,0;14,0;4,0;;2,0;;4,0;57,0;16,0;68,0;9,0;2,0;31,0;140,0;45,0;102,0;21,0;1,0;3,0;2,0;144,0;42,0;113,0;5,0;49,0;579,0;9,0;4,0;32,0;3,0;16,0;;36,0;42,0;26,0;;17,0;3,0;234,0;6,0;46,0;1,0;25,0;146,0;3,0;;59,0;3,0;36,0;52,0;46,0;4,0;1,0;4,0;1,0;;62,0;51,0;50,0;24,0;60,0;;90,0;47,0;5,0;53,0;;75,0;3,0;79,0;1,0;34,0;23,0;37,0;3,0;133,0;8,0;;1,0;7,0;61,0;6,0;3,0;34,0;;10,0;54,0;21,0;4,0;;16,0;2,0;12,0;;11,0;53,0;1,0;40,0;11,0;;30,0;10,0;;7,0;2,0;5,0;5,0;30,0;12,0;;32,0;6,0;;;8,0;;2,0;38,0;2,0;3,0;5,0;25,0;7,0;7,0;7,0;;3,0;20,0;9,0;16,0;;8,0;2,0;;3,0;1,0;10,0;;3,0;22,0;9,0;10,0;5,0;3,0;15,0;21,0;28,0;;;4,0;9,0;8,0;33,0;;;8,0;;;;18,0;;5,0;;1,0;;;24,0;14,0;5,0;9,0;;36,0;;9,0;22,0;1,0;87,0;;6,0;;13,0;;;2,0;;;;2,0;4,0;2,0;7,0;;3,0;;2,0;10,0;1,0;7,0;3,0;15,0;;7,0;;2,0;;3,0;;;;4,0;29,0;4,0;5,0;;1,0;;1,0;13,0;;4,0;;;9,0;6,0;3,0;4,0;2,0;10,0;25,0;4,0;;;4,0;35,0;;28,0;;;36,0;1,0;2,0;;36,0;9,0;;;1,0;1,0;;;;3,0;;2,0;1,0;10,0;;171,0;10,0;2,0;;;2,0;;;;;;7,0;;11,0;;;;18,0;1,0;5,0;;;4,0;1,0;;1,0;;;;2,0;1,0;4,0;;14,0;;4,0;14,0;13,0;;12,0;5,0;;3,0;;;1,0;1,0;3,0;13,0;;;23,0;15,0;10,0;1,0;;49,0;;4,0;2,0;1,0;16,0;1,0;32,0;;;;5,0;1,0;;;4,0;2,0;4,0;3,0;;;;;1,0;8,0;18,0;7,0;;;;;23,0;;;3,0;;1,0;4,0;;;;114,0;;;;4,0;5,0;7,0;;;8,0;29,0;;;;;10,0;;;2,0;2,0;;6,0;;;;;12,0;13,0;;;6,0;;;;;;;1,0;1,0;;;;;;;;;;;;;104,0;;13,0;;;;;;;;;;;29,0;1,0;33,0;;22,0;1,0;28,0;4,0;9,0;10,0;4,0;;;;3,0;1,0;;;;;74,0;;20,0;;;5,0;12,0;;20,0;1,0;;1,0;1,0;;1,0;;22,0;;12,0;11,0;;13,0;9,0;;1,0;5,0;;1,0;8,0;18,0;;14,0;12,0;23,0;9,0;;4,0;1,0;;2,0;1,0;23,0;;;1,0;;10,0;;5,0;;;8,0;2,0;2,0;;22,0;3,0;15,0;1,0;;1,0;;;17,0;2,0;;;8,0;1,0;39,0;8,0;5,0;;;;;4,0;;1,0;21,0;5,0;;17,0;2,0;3,0;;16,0;;;1,0;;;4,0;1,0;;4,0;1,0;;1,0;;;3,0;;;17,0;15,0;;8,0;;;;;;;;6,0;2,0;;;9,0;;4,0;11,0;3,0;23,0;6,0;3,0;;5,0;;1,0;;;;;;;;;2,0;;;;1,0;;;;2,0;;;;3,0;1,0;;;;35,0;;;7,0;3,0;;;2,0;;;;;28,0;;;167,0;;20,0;31,0;;;;3,0;2,0;;;41,0;;;6,0;;;;;6,0;;3,0;;;;
tone;;;;1,0;;4,0;;;;;;;;24,0;5,0;;7,0;;;2,0;;;11,0;;;;;;1,0;;3,0;;;13,0;;13,0;;;;;3,0;4,0;;;;;;;;;6,0;;;;;;;;3,0;16,0;;3,0;;;41,0;;7,0;4,0;;;;;;;;;;;;;5,0;;;;;;;;;8,0;6,0;;;;;;;;3,0;;;3,0;;;7,0;1,0;;2,0;;;;;;;;;;;2,0;2,0;;;;;;;3,0;;11,0;;6,0;;;;;;3,0;;;;;;;;;3,0;;;;;;3,0;3,0;;;;;;;;;;3,0;;;;;;1,0;;1,0;;;;;;;6,0;;;;;;;;2,0;3,0;;5,0;;;;;;;;;;;;;;;;;1,0;;;1,0;;;;;;;;8,0;;;;;;;;;;2,0;;;3,0;;;2,0;;;;;;;;;;;;;3,0;;;;;;;;;;;;;;;;2,0;;;;;;;;;;;;;;;;;;;;;;;;;;;;;;;;;;;;;;;;;;;;;;;;;;;;;;;;;;;;;;;;;;;;;;;;;;;;;;;;;;;;;;2,0;;;;;;;;;;;8,0;;;;;;;;;;;;;;6,0;;;;;;;;;;;;;2,0;;;2,0;;;;;;;;;;3,0;;;;;7,0;;3,0;;;;;;;;;4,0;;;3,0;;;;;;;;;;;;;1,0;;;2,0;;;;4,0;;;;;;;;;;;2,0;;;;;;;;;;;9,0;;;;;;;;;2,0;;;;2,0;2,0;;;;;;;;;2,0;2,0;;;15,0;;;;;;;;;;;;;;;;;;;;;;;;3,0;;;;;;;;;;;;;;1,0;;;;;;;;;;;;;;;1,0;;;;;;;;;;;;;;;;;;;;;;;;;;;;2,0;;;;;;;;;;;;;;;;;;;;;;;;;;;;10,0;;;;;;;;;;;;;;;;;;;2,0;;;;;;;;;;;;;;;;;;;;;;;;;;;;;;;;;;;;;;;;;;;;3,0;6,0;;;;;;;;;;;;;;;;;;;;;;;;;;;;;;;;;;;;;;14,0;;;;;;;;;;;;;;;;;;;;;;;;;;;;;;;;;;;;;1,0;;;;;;;;;;;4,0;;;;;;;;;;;;;;;;;;;;;;;;;;;;;;;;;;;;;;;;2,0;;;;;;;;;;;2,0;;;;;;;;;;;;;;;;;;;;;;;;;;;;;;;6,0;;;;;;;;;;;;;;;;;;;;;;;;;;;;;;;6,0;;;;;;;;;;;;;;;;;;;;;2,0;;;;;;;;;;;;;;;;;;;;;;;;;;;;1,0;;;;;;;;2,0;;;;;;;;;;;;2,0;;;;;;;;;;;;;;;;;;;;;;;;;;;;;;;;4,0;;;;;;;6,0;;;;;;;;;;;;;;;;;;;;;;;;;;;;;;;;;
tool;;;;5,0;;13,0;;13,0;;;3,0;;6,0;7,0;;;2,0;;2,0;;;;2,0;3,0;1,0;;;2,0;8,0;;22,0;3,0;1,0;;;12,0;;;2,0;;11,0;10,0;;3,0;;13,0;;3,0;;;;;9,0;;3,0;;11,0;;;3,0;;;6,0;;23,0;1,0;32,0;;;;1,0;8,0;5,0;;;;5,0;;;5,0;28,0;;2,0;;5,0;;;2,0;;;2,0;2,0;;;;6,0;;1,0;1,0;18,0;24,0;;;6,0;2,0;12,0;;;;;;9,0;;;;;;;2,0;9,0;;;3,0;2,0;;4,0;30,0;;24,0;1,0;2,0;;;3,0;;;7,0;3,0;;;;2,0;;;3,0;2,0;2,0;4,0;4,0;8,0;;4,0;5,0;2,0;;;;;;;;10,0;1,0;2,0;;;;;;;;;;;20,0;4,0;;;8,0;;2,0;;1,0;;1,0;;1,0;;;1,0;;1,0;1,0;8,0;10,0;1,0;19,0;;2,0;6,0;;3,0;;;;;9,0;12,0;;16,0;1,0;2,0;2,0;;;;;;;1,0;1,0;1,0;;;4,0;1,0;30,0;;;2,0;;;;;;;2,0;;;;;;;;3,0;4,0;;1,0;5,0;;;2,0;;14,0;2,0;3,0;4,0;5,0;;;2,0;;;2,0;1,0;;;;1,0;1,0;;6,0;;4,0;;;4,0;2,0;;7,0;;;1,0;;;;;3,0;4,0;;;;;10,0;;10,0;2,0;;;1,0;;2,0;;;;;1,0;4,0;;1,0;;10,0;2,0;;;;4,0;2,0;;2,0;;6,0;;;;;5,0;;;;;;;2,0;;;;;6,0;;4,0;2,0;;;;5,0;6,0;1,0;;;;;1,0;1,0;8,0;4,0;;;2,0;;;;;;;2,0;;;8,0;;;;;12,0;1,0;;;;1,0;;6,0;12,0;;3,0;1,0;1,0;;;;;;;;1,0;;1,0;;1,0;4,0;;;1,0;4,0;2,0;;20,0;1,0;2,0;;;1,0;7,0;;3,0;;4,0;;;;;;;;;;11,0;;;;;1,0;1,0;8,0;;;;1,0;;;;;;2,0;;;;;;11,0;;;4,0;;;;;;9,0;;6,0;3,0;;;2,0;2,0;;;;1,0;;1,0;5,0;8,0;1,0;;1,0;2,0;1,0;;10,0;;5,0;;7,0;1,0;;3,0;;;;;1,0;;;;;;1,0;2,0;;;;;;;;;;;;;;;;;;;;;;;2,0;1,0;;;;4,0;;6,0;;;;8,0;2,0;;;;;1,0;4,0;;;2,0;;;;;;1,0;;;;;2,0;;;;;;;1,0;;1,0;;;;9,0;;2,0;;;;;2,0;1,0;5,0;;1,0;;;;;1,0;1,0;2,0;1,0;2,0;;25,0;;;3,0;;;;;;;;1,0;;;;4,0;1,0;;5,0;;;;1,0;;;;;;;;;;;;;1,0;;;;;;1,0;;;2,0;;;;;;;;;;;;;;;;;2,0;;;;;;2,0;;5,0;;;;;;;;;;;;3,0;1,0;;;;;;;;5,0;;;;;;;;1,0;1,0;;;2,0;;;;1,0;;;;;3,0;2,0;;;;;;;1,0;;;1,0;;;;1,0;;;1,0;;;;;7,0;;;;;;;;;;;;2,0;;1,0;;;2,0;3,0;;1,0;1,0;1,0;;;;2,0;;;;2,0;;;;;;2,0;3,0;;;;;;1,0;;;3,0;;;;;;;;;;;2,0;;;;3,0;3,0;;;;;;;;2,0;;;;;;;;;;;;;;;;17,0;;;;;;;3,0;;;;;;;;;;6,0;;;;;;;;;;;;;1,0;;;1,0;;;;;;;1,0;;;;;;2,0;;;;;;;;14,0;;;;;;;;2,0;;;;2,0;;;;;;;;;;;;;;;;1,0;;;;;;2,0;4,0;1,0;;;22,0;;;;3,0;6,0;;1,0;;;;;;;;;;;;;;;;;;;;;;;1,0;;8,0;;;;;;;;;;;;;;;;;;;1,0;;1,0;;;;;;2,0;;;;;;3,0;;;;;;;2,0;;;;1,0;;;;;;;;;;;1,0;;;;;;;;;;;
tooth;;;;1,0;;6,0;;7,0;;;;;;10,0;;;;1,0;7,0;;;;2,0;;;;;;;;8,0;;;;;;1,0;2,0;;1,0;1,0;11,0;;;;5,0;;1,0;;;;;9,0;3,0;;;8,0;;;;;;6,0;;2,0;2,0;16,0;;;;8,0;2,0;;;;;;;;;5,0;;;;1,0;;;;;;;;;;1,0;;;;51,0;1,0;22,0;;;;;;;1,0;;;;2,0;;;;;;3,0;;1,0;;;;;;;20,0;;;;1,0;;;3,0;;;1,0;;;;;9,0;;;;;;4,0;1,0;8,0;;;6,0;;;;6,0;;;;;6,0;;;;;5,0;1,0;;;;;;19,0;;9,0;1,0;;;;;;;;;;;3,0;;;;;;2,0;;;3,0;;4,0;4,0;;;;;2,0;;11,0;;;11,0;2,0;2,0;;;;;;;;;;;;;2,0;;21,0;;;;1,0;;1,0;;;;;;;1,0;;12,0;;;;;;2,0;3,0;5,0;2,0;;;2,0;;;5,0;18,0;2,0;;;;;;3,0;;1,0;1,0;2,0;;;;;5,0;1,0;;;;;;5,0;;1,0;;;;;;;1,0;;;;;1,0;;;;;29,0;;3,0;;;;3,0;1,0;;1,0;1,0;;;4,0;;1,0;;8,0;4,0;;1,0;;;;;1,0;;;;;;;;;1,0;1,0;;;;;;20,0;2,0;;4,0;;;1,0;1,0;;;;;;;3,0;10,0;;21,0;9,0;;;;;;;;;;;;;;;;;;;;;;1,0;;;1,0;;1,0;;;;;;;;1,0;1,0;;;;;;;;3,0;2,0;1,0;1,0;;;;10,0;;1,0;;;;1,0;;;;;;;;;;4,0;1,0;;;;;;;;;;1,0;2,0;;;;;;;;;;;95,0;;;;3,0;;3,0;;;;;1,0;;;1,0;1,0;5,0;;;;;;;;;;;;;1,0;;;;;;;;;;;;;;;;1,0;;;;;;;4,0;;;;;;;;;;;;;;;;3,0;;;;3,0;;;;;;;;2,0;;48,0;;12,0;;;;;;;8,0;;;;1,0;;;;;2,0;;;;;;;;;3,0;;;;;;;;;;;;;;;;1,0;3,0;;;;4,0;;;;;;;2,0;;;;;;;;;;;;;;;;;;;;;;;;;;;;;;;4,0;;;;;;;;;;;;1,0;;;;;;;;;;;;;;;;;;;11,0;;;;;;;;3,0;;;;;;;1,0;;2,0;;;;;;;;1,0;;1,0;;;;;;;;;7,0;;;1,0;;4,0;;;1,0;;2,0;;8,0;;;;;;;;15,0;;;;;;;;;;;;;;;;;;;;;1,0;4,0;;;;;;;;;2,0;;;2,0;2,0;2,0;;;;2,0;;;;;;;;;;;;;;;;;1,0;;;;;;;;3,0;;;;;;;;;;;;;;;;;;;1,0;;;;;;;;;;;;;;;;;;;;;;;;;;;;;;;;;;;;;;;;;;;;;;;;;;;;;2,0;;;;;;;1,0;1,0;;;;;;;;;;;;;2,0;;;;;;;;;;;;;;;;;;;4,0;;;;;;4,0;;;;;;;;;;;;;;;;;;;;;;;;;;;;4,0;;;;;;;;;;;;;;;2,0;;;;;;;;;;;;;;;;;;;;;;;;;;;2,0;;;;;;;;;;;;;;;14,0;;1,0;;;;;;;1,0;;;;;;;;;;;;;;;;;;;
touch;;;;8,0;10,0;33,0;1,0;6,0;2,0;2,0;;;;97,0;;2,0;31,0;;;1,0;;;;;1,0;;;13,0;11,0;;112,0;48,0;;;;24,0;9,0;;16,0;;78,0;262,0;1,0;26,0;535,0;28,0;;1,0;;;;1,0;;6,0;1,0;2,0;9,0;;;24,0;11,0;;;;339,0;;86,0;;;;14,0;21,0;18,0;;5,0;;;;;8,0;85,0;;26,0;;30,0;1,0;;4,0;;4,0;3,0;;;3,0;52,0;1,0;23,0;10,0;58,0;55,0;142,0;16,0;;10,0;7,0;35,0;6,0;;;;;13,0;71,0;2,0;;;2,0;3,0;5,0;150,0;5,0;;27,0;6,0;;8,0;40,0;;;;42,0;;23,0;36,0;5,0;;9,0;16,0;24,0;;;5,0;;;1,0;43,0;94,0;11,0;10,0;3,0;;;15,0;1,0;;;;;;;2,0;7,0;4,0;;;;15,0;17,0;1,0;5,0;3,0;;3,0;17,0;;8,0;;3,0;6,0;;;1,0;3,0;13,0;;1,0;9,0;;14,0;19,0;;;;2,0;2,0;4,0;8,0;;;2,0;;24,0;;;4,0;14,0;39,0;;4,0;6,0;4,0;4,0;;;;1,0;9,0;2,0;6,0;5,0;5,0;1,0;;;;;35,0;19,0;2,0;1,0;;;1,0;;9,0;13,0;4,0;;;22,0;;;;;;22,0;1,0;3,0;11,0;30,0;;;;7,0;2,0;1,0;4,0;52,0;1,0;;;3,0;4,0;2,0;1,0;;;;;13,0;;;2,0;;1,0;;2,0;4,0;3,0;11,0;;;2,0;2,0;;3,0;;4,0;3,0;;;1,0;;;;;8,0;;;;;;3,0;;;;2,0;;3,0;5,0;;;;;5,0;1,0;10,0;;;;16,0;115,0;10,0;13,0;41,0;;;;;1,0;;;;;1,0;;32,0;;;;9,0;11,0;;;;1,0;;6,0;;;;;;;9,0;;;3,0;16,0;6,0;4,0;;4,0;4,0;3,0;5,0;1,0;;;1,0;;;5,0;10,0;14,0;2,0;;20,0;;;111,0;71,0;;1,0;2,0;120,0;;5,0;;36,0;1,0;7,0;4,0;20,0;;4,0;;25,0;12,0;3,0;;349,0;13,0;2,0;9,0;43,0;1,0;6,0;2,0;;3,0;3,0;;44,0;57,0;34,0;;;;;;;;3,0;11,0;128,0;10,0;106,0;6,0;1,0;58,0;;11,0;;;;2,0;2,0;56,0;;;31,0;3,0;1,0;;9,0;;;198,0;;;;43,0;;;;;;1,0;1,0;14,0;;2,0;1,0;;6,0;;28,0;2,0;6,0;6,0;1,0;8,0;34,0;;;1,0;;5,0;1,0;;17,0;3,0;3,0;36,0;;10,0;1,0;21,0;;1,0;1,0;;;;;627,0;;;;;1,0;;;;;;7,0;3,0;3,0;3,0;;21,0;;;;;2,0;;;2,0;;;4,0;;;;;;1,0;;70,0;5,0;2,0;;;3,0;1,0;1,0;;1,0;;;1,0;3,0;31,0;;;;30,0;;;3,0;1,0;2,0;21,0;;2,0;;;;;;;14,0;;3,0;7,0;6,0;1,0;;8,0;;;;;;;;;;;;;1,0;;;;2,0;;11,0;;;;;2,0;;15,0;1,0;;;;;1,0;;;121,0;2,0;;;;;;;9,0;;3,0;;;;5,0;;;2,0;4,0;;;;;9,0;3,0;;2,0;;;;;;1,0;;2,0;2,0;4,0;;;;;;;11,0;;7,0;;;;;2,0;;;;;;;;17,0;;;;;;;;;2,0;;;;;13,0;;18,0;;1,0;;;11,0;3,0;;;3,0;;;;;;13,0;1,0;;;;1,0;6,0;3,0;1,0;2,0;;;;2,0;;;;;;;;;;;;;;;;9,0;;;11,0;;;;4,0;;;;;;;1,0;;9,0;;;;;;;1,0;1,0;5,0;;;2,0;;;;7,0;;;;;;;;1,0;;;;;;9,0;;1,0;;;;;;;;2,0;;;;18,0;;;15,0;;;;;2,0;;;;;;;;;;12,0;;;;;;3,0;33,0;;;;;4,0;;;;;;;;;;4,0;;;;;;;;;;3,0;;;;;;;;;;;;;;1,0;;13,0;;;;;;5,0;;15,0;1,0;;1,0;1,0;;;;;7,0;;;;;;1,0;;;;;;;1,0;;;6,0;;;;;;;;1,0;;;;55,0;;;11,0;2,0;;;;;;;;;;;;6,0;;;;3,0;2,0;;;;;35,0;;;2,0;;;;;;;;;;;;;;;;;;;3,0;;;;;;;;;;;19,0;8,0;;;;;;;;;;;5,0;;;3,0;;;3,0;41,0;;;;;;;;;;5,0;;;;;;;;;;;14,0;;;;;
track;;;;24,0;;137,0;3,0;109,0;12,0;2,0;;5,0;2,0;204,0;;;80,0;;;16,0;;;24,0;4,0;9,0;2,0;;34,0;48,0;11,0;121,0;42,0;15,0;11,0;;140,0;48,0;3,0;25,0;;258,0;236,0;1,0;9,0;47,0;16,0;2,0;29,0;1,0;19,0;35,0;;5,0;2,0;55,0;41,0;18,0;2,0;11,0;103,0;;1,0;18,0;2,0;397,0;4,0;159,0;10,0;16,0;6,0;140,0;45,0;61,0;;;;1,0;13,0;1,0;19,0;356,0;2,0;65,0;40,0;90,0;12,0;1,0;38,0;;9,0;34,0;4,0;4,0;2,0;;;22,0;46,0;191,0;226,0;282,0;14,0;;83,0;33,0;109,0;9,0;22,0;8,0;6,0;;22,0;54,0;6,0;;13,0;2,0;44,0;68,0;53,0;26,0;;33,0;20,0;;42,0;335,0;7,0;;;83,0;99,0;;64,0;;;88,0;27,0;9,0;;4,0;22,0;6,0;;5,0;9,0;83,0;5,0;77,0;23,0;;6,0;32,0;;;1,0;;1,0;;;10,0;18,0;9,0;12,0;;32,0;50,0;13,0;2,0;71,0;10,0;3,0;4,0;44,0;28,0;9,0;;3,0;12,0;;;;;25,0;19,0;4,0;8,0;2,0;123,0;14,0;;23,0;;2,0;;2,0;26,0;;1,0;6,0;;;5,0;;27,0;24,0;22,0;1,0;15,0;37,0;66,0;200,0;2,0;;4,0;;21,0;3,0;1,0;53,0;10,0;7,0;58,0;;71,0;;25,0;;1,0;1,0;;;9,0;24,0;4,0;4,0;20,0;;1,0;47,0;;2,0;11,0;;;52,0;14,0;7,0;30,0;23,0;1,0;;;8,0;;20,0;38,0;51,0;3,0;;2,0;14,0;;106,0;;2,0;;5,0;19,0;3,0;;;8,0;26,0;;1,0;6,0;21,0;7,0;;2,0;;3,0;6,0;22,0;18,0;4,0;3,0;18,0;5,0;3,0;8,0;;;7,0;1,0;25,0;3,0;;6,0;4,0;;35,0;5,0;;;1,0;52,0;7,0;26,0;;;25,0;;7,0;1,0;18,0;3,0;1,0;3,0;77,0;783,0;6,0;17,0;1,0;2,0;;2,0;38,0;3,0;;;22,0;8,0;8,0;1,0;;;;;7,0;34,0;6,0;1,0;2,0;14,0;55,0;47,0;1,0;;;;14,0;;;1,0;1,0;5,0;84,0;25,0;;5,0;;6,0;;8,0;4,0;14,0;2,0;28,0;3,0;1,0;30,0;13,0;26,0;11,0;5,0;10,0;20,0;;72,0;86,0;1,0;4,0;7,0;124,0;20,0;3,0;9,0;10,0;6,0;14,0;16,0;13,0;8,0;6,0;1,0;63,0;11,0;5,0;5,0;22,0;;2,0;18,0;121,0;2,0;15,0;182,0;10,0;9,0;200,0;8,0;15,0;65,0;46,0;;;;10,0;4,0;5,0;;9,0;10,0;32,0;6,0;10,0;8,0;18,0;6,0;1,0;5,0;;64,0;5,0;14,0;136,0;9,0;1,0;;;24,0;31,0;;20,0;27,0;10,0;88,0;3,0;;;1,0;2,0;28,0;1,0;10,0;4,0;;26,0;16,0;;;5,0;4,0;;6,0;;;53,0;4,0;10,0;13,0;;6,0;2,0;37,0;13,0;2,0;5,0;4,0;;;14,0;7,0;5,0;57,0;8,0;;40,0;2,0;;3,0;13,0;2,0;3,0;28,0;5,0;1,0;;1,0;6,0;11,0;9,0;5,0;11,0;17,0;4,0;;6,0;2,0;1,0;1,0;;5,0;2,0;;13,0;1,0;4,0;3,0;2,0;;;;;2,0;4,0;;1,0;1,0;3,0;6,0;64,0;44,0;5,0;1,0;;16,0;46,0;16,0;4,0;1,0;1,0;;;;6,0;2,0;1,0;;;8,0;29,0;;11,0;1,0;2,0;1,0;38,0;;29,0;6,0;7,0;28,0;;10,0;6,0;;;3,0;;;;7,0;6,0;;12,0;;;;;10,0;1,0;2,0;;3,0;;2,0;8,0;1,0;;;1,0;5,0;;10,0;12,0;24,0;4,0;;;4,0;251,0;4,0;;7,0;;;2,0;3,0;2,0;;5,0;22,0;;8,0;6,0;;5,0;1,0;;;88,0;;;;;15,0;4,0;6,0;;;16,0;;;1,0;2,0;7,0;1,0;;1,0;;47,0;4,0;4,0;2,0;;;1,0;;14,0;7,0;1,0;4,0;;24,0;;6,0;6,0;;;1,0;;13,0;;;;;;23,0;2,0;3,0;6,0;;46,0;3,0;;384,0;26,0;5,0;8,0;;;2,0;1,0;8,0;;1,0;;1,0;15,0;2,0;;;2,0;9,0;5,0;;;;;6,0;4,0;3,0;4,0;;21,0;;7,0;;1,0;2,0;;2,0;4,0;2,0;16,0;;13,0;4,0;;1,0;;2,0;1,0;5,0;5,0;1,0;4,0;7,0;;;9,0;41,0;;;1,0;7,0;;5,0;1,0;2,0;14,0;;2,0;5,0;1,0;4,0;2,0;4,0;;;;;;;;3,0;;1,0;8,0;;;;1,0;1,0;;3,0;1,0;42,0;;2,0;2,0;1,0;11,0;;;4,0;;1,0;1,0;3,0;2,0;5,0;;;20,0;9,0;;;;4,0;;;;;;7,0;;;;;7,0;2,0;12,0;;;26,0;7,0;2,0;2,0;;;;12,0;;;23,0;44,0;;11,0;43,0;;;;;2,0;;;1,0;;31,0;;;;1,0;15,0;;4,0;;;22,0;;;;8,0;6,0;4,0;2,0;11,0;3,0;;13,0;1,0;;16,0;;;;1,0;3,0;;1,0;;1,0;13,0;22,0;;5,0;;8,0;2,0;8,0;5,0;2,0;2,0;1,0;11,0;;5,0;1,0;2,0;;5,0;6,0;;;;4,0;;1,0;1,0;7,0;2,0;1,0;;;7,0;2,0;;9,0;;;2,0;;;3,0;17,0;;;1,0;2,0;;;;10,0;;15,0;3,0;;;;;;26,0;9,0;;;;;14,0;;1,0;1,0;;;;;;;;;8,0;;;;;3,0;;;;7,0;;1,0;;1,0;;1,0;4,0;1,0;;;;;;;;7,0;12,0;;21,0;2,0;3,0;9,0;;;4,0;;;;;;3,0;3,0;;;;1,0;;;2,0;;;;;;2,0;;
trailer;;;;3,0;;5,0;;;;;;;;22,0;;;11,0;;;;;;;;4,0;;;5,0;;;34,0;21,0;;;;12,0;;;;2,0;41,0;2,0;;;14,0;7,0;;;;;3,0;;1,0;1,0;2,0;;;;;14,0;;;2,0;;44,0;;38,0;;;;;;;;;;;1,0;;4,0;28,0;;;;;;;;;;;;;;;;;;5,0;4,0;24,0;2,0;;;;5,0;;;;;;1,0;1,0;1,0;;2,0;1,0;;;;;;20,0;;;2,0;54,0;;;;;;;1,0;;4,0;16,0;;;;;;;;;;3,0;;11,0;25,0;;1,0;1,0;;;;;;;;;20,0;;;;;29,0;;;15,0;;;;;;6,0;;;;;;38,0;;;;;;;2,0;22,0;;;;;;;;;;;;;;4,0;;;;;;1,0;;1,0;;;;;;;1,0;;;;;;2,0;37,0;19,0;;;;;;5,0;;14,0;;3,0;;;;;;;;;;;12,0;4,0;;;;;;;1,0;;;;;;7,0;;162,0;;;;;;;;;;;2,0;;1,0;16,0;;;1,0;;1,0;;;;1,0;;2,0;;;;;;4,0;;12,0;11,0;;;;;;;;;;;19,0;2,0;;;;;;;12,0;;;;;1,0;;;;;;;14,0;;;;;;;;;;;;;;;;;;;;;;;;;;12,0;;;;41,0;;1,0;;;;;;9,0;;;;;;;;5,0;;;;4,0;;4,0;;;;;3,0;1,0;3,0;1,0;;;1,0;;;2,0;;;37,0;;1,0;;2,0;;;;6,0;1,0;2,0;;;;;1,0;4,0;2,0;;;;;;;;;;;8,0;;;;;1,0;;;;;;;;;;;;;;;;;;1,0;;;;;;;;;;;;;;;1,0;;;1,0;;;;;;;;;;;;;;;;;;;;1,0;;;;;4,0;;;;;1,0;;;;;;;3,0;;;11,0;;;;1,0;;;;;;;6,0;;2,0;8,0;19,0;;2,0;;;;;;;;;;17,0;1,0;1,0;;;;1,0;;;;;1,0;;;3,0;;;3,0;;;;;2,0;;;;;;;;;;;;;;;;;;;3,0;;;;;;;;1,0;;;;;;;;;2,0;;;;;;1,0;;;;;;14,0;;;;;;;;;6,0;;;;;1,0;;;;;;;;;;;;;;;;;;;;;;;;;;;;;;;;;;;;;;;;;;;;;;;;;;;;;;;;;;;;;9,0;;;;;;;;1,0;;;;;;;;;;;;;;;;;;;;;;;;;;;;;;;;;;;;;;;;;;;;;;;;9,0;;;;;;;;;;;;;;;;;;;;;;;;;;;;;;;;;;;;;;;;;;;;;;;;;;;;;2,0;;;;;;;;;;;;;;;;;;;;;;;;;;;;;;;;;;;;;;;;;;;;;;;5,0;;;;;;;;;;;;;;;;;;;;;;1,0;;;;;;;;;;;;;;6,0;;;;;;;;;;2,0;;;;;;;;;;;;;;;;2,0;;1,0;;;;;;;;;;1,0;;;;;;;;;;;;;;;;;;;;;;;;;;;;;;;6,0;;;;;;;;;;;;;32,0;;;1,0;;;;;;;;;;;;2,0;;;;;;;;;;;;;;;;;9,0;1,0;;;;;;;;;;;;;;
trajectory;;;;2,0;;27,0;;;;;;;;50,0;;;16,0;;;;;;3,0;;;;;10,0;1,0;;17,0;14,0;;1,0;;28,0;4,0;;;;93,0;27,0;;6,0;17,0;;;2,0;;1,0;42,0;;;;7,0;;3,0;3,0;;41,0;;;3,0;;79,0;1,0;10,0;;;;;;13,0;;;;;2,0;;2,0;46,0;;1,0;;1,0;;;3,0;;3,0;5,0;;2,0;;;;;6,0;27,0;28,0;28,0;11,0;;;12,0;12,0;;;;;;1,0;8,0;;;;1,0;4,0;1,0;8,0;2,0;;3,0;6,0;;5,0;40,0;;;;36,0;;;9,0;;;9,0;10,0;;;;;;;;3,0;4,0;;8,0;;;;2,0;;;;;;;;;;;;;;2,0;;;;7,0;4,0;;8,0;;;;;;;;2,0;;1,0;;;6,0;;11,0;1,0;;;;;;;11,0;;;;;;;;8,0;2,0;;;;;3,0;30,0;;;;;5,0;1,0;;15,0;7,0;2,0;;;;;;;;4,0;;;2,0;2,0;1,0;4,0;4,0;;;9,0;;;;;;3,0;9,0;1,0;1,0;;;;;2,0;;;;;;;;9,0;;59,0;;;;;;2,0;;;2,0;;;;;2,0;;;;;2,0;;1,0;;;;;4,0;1,0;;;;;;3,0;;;;;;;3,0;;;;2,0;3,0;;;2,0;;;;;2,0;;;;1,0;175,0;;;;;;;;;;;;;3,0;;;;;;2,0;3,0;2,0;;;;4,0;1,0;;;3,0;;2,0;;26,0;;;;18,0;;;;;;1,0;;3,0;3,0;;;;;4,0;;2,0;;2,0;8,0;10,0;;12,0;;;3,0;;14,0;2,0;24,0;;1,0;13,0;;11,0;;11,0;;;9,0;12,0;2,0;9,0;7,0;;;;12,0;;9,0;25,0;2,0;;52,0;;;4,0;7,0;;;;6,0;;;;;;8,0;3,0;16,0;;;;;;;11,0;3,0;;3,0;;;;;11,0;;;6,0;;27,0;21,0;1,0;1,0;;1,0;;2,0;;;1,0;;;13,0;;;;;;4,0;;;;1,0;17,0;1,0;6,0;;;;;;12,0;;;;;;;;;;22,0;;;;28,0;1,0;;;;;;;;;;4,0;;;;;9,0;2,0;;;;;;;;;;;;2,0;;;;;3,0;;;2,0;4,0;;5,0;;2,0;;;8,0;5,0;;;;1,0;4,0;;;;;;1,0;;;;;;;4,0;;;;;3,0;;2,0;;;;;;;;;;1,0;;;;;;;;4,0;;;;;;;1,0;;4,0;;;;;;;9,0;;;;;59,0;;;1,0;;;;;;;;;;;;43,0;;;;;2,0;;;;;;;1,0;;;4,0;;;7,0;;;;;;;;;1,0;;1,0;;;;;;;;;;;;;;;;;2,0;;;;;;18,0;;;;;8,0;;;15,0;;;;;;2,0;1,0;;;;;;1,0;;;;;;;;;;;;;1,0;;;;;;;3,0;;;;;;;;;;;;;;1,0;;;;;;;;;2,0;;;;;;;;4,0;;;;;;;;;;;;;;;;;;;;2,0;;;;;;;;;;;;;;;;;;;;;;;;;;;;;;;;;;;;;;;;;1,0;;;;;;3,0;;;;;;;;;;;;1,0;;;;;;;;;11,0;;;;1,0;;;;;;2,0;;8,0;;;;;;;;;2,0;2,0;7,0;;;8,0;;;;30,0;1,0;;;2,0;;1,0;;;;;;;2,0;9,0;;1,0;;;;;;1,0;;;1,0;;;;2,0;;;;;;;;;;;;2,0;;2,0;;;;;;;;;;2,0;;;;;;2,0;;;;;;;1,0;;2,0;;;;;;;;;;;;;;;;;;;;;;;;;;;;;;7,0;;;;;;;;;;2,0;;;;;;3,0;;;;;;;;;8,0;1,0;7,0;;;1,0;;;;;;;;;1,0;;
transceiver;;;;2,0;;7,0;2,0;;;;;;;10,0;;;6,0;;;;;;;22,0;37,0;;;2,0;16,0;2,0;86,0;7,0;;;;30,0;;;;;3,0;90,0;;4,0;5,0;7,0;;2,0;;;;;1,0;13,0;;;;;32,0;7,0;;;;;42,0;;12,0;;;;2,0;1,0;13,0;;;;;;2,0;16,0;9,0;;;;25,0;;;;;;;;;;;;;;7,0;2,0;27,0;5,0;;8,0;1,0;28,0;;2,0;;;;2,0;;;;;;4,0;1,0;19,0;;;19,0;;;16,0;26,0;;;;;;;8,0;;;1,0;;;;;;1,0;;;;2,0;;2,0;;;;1,0;;;1,0;;;;;;6,0;;1,0;;;41,0;;;;;;;;;;;1,0;3,0;4,0;3,0;;;;;;;;;1,0;;;;;;;8,0;;;;;;;;;1,0;;;;;1,0;;;;;;11,0;;;;;;;;;;4,0;;;;;;1,0;;1,0;;;1,0;;;;;;;;3,0;;;;;;;;;;1,0;1,0;;;;;57,0;;24,0;;;1,0;;;;;2,0;;;;;;;;;1,0;;;1,0;;;;;58,0;1,0;;;;;;1,0;1,0;;;;;;;;;;;;;1,0;;;;;;;1,0;1,0;;;2,0;;;;1,0;;;;11,0;;1,0;1,0;;;1,0;;;;;;1,0;;;;;;;;;;;;;;;;1,0;;25,0;212,0;;;;;5,0;;;;;;;;;;;;;5,0;;;43,0;;;;;2,0;1,0;;;;;;;;;;;5,0;;;;6,0;;1,0;;1,0;;;2,0;1,0;;;;1,0;3,0;2,0;;;;;;;;1,0;;54,0;18,0;4,0;1,0;;4,0;;2,0;;;;5,0;2,0;;;;6,0;1,0;;;2,0;;;8,0;;;;;;;;;;;;4,0;;;;;;;;;;6,0;;4,0;11,0;;;;6,0;;1,0;;;3,0;;12,0;;2,0;1,0;15,0;;;1,0;;;4,0;;;6,0;;;;19,0;2,0;1,0;;;1,0;2,0;;;9,0;;1,0;;;3,0;;;;;13,0;;;;;;3,0;9,0;;;;;;;;;;;;;;;;;;;;;;;;;;;2,0;;;;;;1,0;;1,0;;;;1,0;;7,0;;;;;;;;;;;22,0;;;;;1,0;;;1,0;;1,0;2,0;;;2,0;1,0;;1,0;2,0;;;;;;;;;;;;;;7,0;;;20,0;;;2,0;3,0;6,0;;;;;4,0;;;;;;;;;21,0;;;2,0;;;1,0;;;;;;1,0;;;;;;;;;;;;;;;;3,0;1,0;;;;;;;;3,0;;;7,0;;;;;4,0;;;;;4,0;5,0;;1,0;;;;;;;;;;;;;;;;;;;;;;;;;;;;;;;;;;5,0;;;;;;;;;;;;;;;;;1,0;;;;;;;;;;;;;;;;;;;;;;6,0;;;;;;;;;;;;;;;1,0;;;;;;;;;3,0;;;;;;;;;;;;;;;;;;;;;;;;;;;;;;;1,0;;;;;;;;;;;;;;;;;;;;;;;;;;;;;;;;;;;;2,0;;;;;;;;;;;;;;;;;;;34,0;;;;;;;;;;;;;3,0;;;;;;;;2,0;;;;;;;;2,0;;;;;1,0;;;;;;;;;;2,0;;;;;3,0;;;;;;;;;;;;2,0;;;;;;;;;;;1,0;;;;;;;;;;;1,0;;;;;;;;;;;;;;;;;;;;;;;;;;;;3,0;;;;;;;;;;;;;;;;;;;
transform;;;;10,0;7,0;5,0;2,0;;;;;;;29,0;5,0;;22,0;;;3,0;;1,0;19,0;;3,0;1,0;;8,0;11,0;;43,0;5,0;;2,0;;24,0;11,0;;1,0;;36,0;17,0;;9,0;6,0;;;2,0;;6,0;5,0;;;;1,0;1,0;1,0;;6,0;22,0;;6,0;23,0;;361,0;1,0;9,0;;;;4,0;19,0;10,0;;;10,0;;4,0;;1,0;58,0;;;23,0;5,0;;;3,0;;;111,0;;;;;;29,0;12,0;41,0;31,0;27,0;14,0;;4,0;8,0;50,0;1,0;11,0;4,0;;;23,0;52,0;;;2,0;;5,0;2,0;9,0;7,0;;41,0;2,0;;6,0;58,0;;;;7,0;;;20,0;;;23,0;6,0;2,0;;;18,0;;;;57,0;5,0;1,0;3,0;;;5,0;;;;;;;;;;1,0;;2,0;1,0;;1,0;1,0;;5,0;4,0;;3,0;7,0;3,0;8,0;;;;7,0;10,0;;;;;;;;30,0;3,0;4,0;;;;;;1,0;;;;;;3,0;;1,0;;;3,0;;;1,0;2,0;;;;;4,0;8,0;1,0;;20,0;;;;;;7,0;;;8,0;;;5,0;3,0;;;;;;2,0;;;;;;6,0;;6,0;;;;;;1,0;;1,0;;4,0;1,0;;;3,0;;13,0;;;;;24,0;;;;;3,0;5,0;;4,0;14,0;;;;;4,0;1,0;;;;;1,0;2,0;;;;;2,0;;4,0;;;;;;;4,0;;;;;23,0;1,0;;;;;;;6,0;;1,0;;;13,0;;4,0;;;1,0;;10,0;;;;;;35,0;;;;;;4,0;12,0;1,0;;;;8,0;3,0;;;1,0;;5,0;;;;;;6,0;2,0;;3,0;;;6,0;2,0;;6,0;;;;;21,0;;;;1,0;1,0;6,0;4,0;8,0;107,0;1,0;1,0;4,0;10,0;;7,0;;2,0;;2,0;2,0;;5,0;46,0;;3,0;6,0;;;3,0;1,0;22,0;;15,0;1,0;12,0;32,0;;;2,0;;2,0;4,0;2,0;;8,0;;2,0;;1,0;;;;14,0;;;;;5,0;;5,0;;15,0;;;;;;;1,0;7,0;3,0;;1,0;2,0;;;;5,0;;;;;1,0;;7,0;;;8,0;;1,0;1,0;;3,0;;;;;;;11,0;;;;;;;;;;;1,0;;;17,0;4,0;;10,0;;;;;;;7,0;1,0;;;;;;;3,0;5,0;;;;;1,0;12,0;;;;7,0;;1,0;;;;;;13,0;;;;;;;;2,0;;;;;;;;4,0;6,0;3,0;;;4,0;;;;;;;;;;;;;;;;1,0;;;;9,0;;;;;;;;1,0;;1,0;3,0;;;;;;;7,0;;2,0;;;5,0;1,0;10,0;;;3,0;11,0;;;;;3,0;;1,0;;;32,0;;1,0;;4,0;1,0;;;;5,0;6,0;1,0;;1,0;;;;;;;;;;;;;;;;;;;1,0;;;;;;;;;;;;;;;;;2,0;;4,0;3,0;8,0;;3,0;12,0;;;7,0;;;;;;;;6,0;;;;18,0;3,0;;10,0;13,0;;;;;;;;30,0;;;;;;1,0;;5,0;3,0;;;;;;10,0;1,0;3,0;;;;;;;;;;1,0;;;;;;;1,0;;;;;;;;3,0;;;;;;;;1,0;;1,0;;;;3,0;;;;;;;;;;;;1,0;;;;;;;;;;;;;;1,0;;2,0;;19,0;;;;;;;;;;;;;6,0;;8,0;;;;;;;;;1,0;;;;;;;;;;;;1,0;19,0;;;;;;;;;;;;3,0;;;;4,0;1,0;2,0;;;;;12,0;;;2,0;;;;3,0;;;;;;;;;1,0;;;7,0;;;4,0;;1,0;;;;;;1,0;;4,0;;;;;;;;2,0;;;;;;20,0;;;;;;;;;;;;4,0;1,0;;;;;;;;;;;;;2,0;;;;;;;;;;;;;;;;;;;;;;1,0;2,0;;;1,0;;;;;;;;;;;;;;;1,0;;;;;;;;;;;;3,0;5,0;2,0;;;;;;;;;;;;;;;12,0;1,0;;2,0;;;;2,0;;;3,0;;;;6,0;;;;;;16,0;;;;;
transformation;;;;16,0;1,0;25,0;1,0;;;;;;;60,0;;;20,0;;;;;;37,0;;;2,0;;6,0;;;18,0;6,0;7,0;5,0;;8,0;1,0;;15,0;;60,0;12,0;;1,0;4,0;;7,0;3,0;7,0;1,0;18,0;;;;2,0;6,0;;;1,0;56,0;;;6,0;;251,0;;37,0;;;;1,0;4,0;6,0;;;;;1,0;1,0;1,0;57,0;;;55,0;16,0;;;;;;44,0;;;;1,0;;32,0;12,0;36,0;38,0;39,0;7,0;;2,0;18,0;31,0;5,0;5,0;;;;18,0;;;;;;17,0;6,0;5,0;20,0;;;;;;75,0;;7,0;;8,0;;;23,0;;;7,0;3,0;;;;;;;;88,0;3,0;1,0;8,0;;1,0;1,0;10,0;;;;;;;;;5,0;;8,0;;2,0;;;;;2,0;;3,0;2,0;;2,0;;;;;;;;;;;1,0;;61,0;;;;;;;;;;;;;;;;3,0;11,0;;;;5,0;1,0;;;;;;16,0;;;;17,0;;;;;;5,0;;;5,0;;;;12,0;;1,0;;;;8,0;;;;;;2,0;2,0;;;;;;;4,0;;;;;;;;;;1,0;;;2,0;;5,0;;;;;5,0;;;;8,0;;;;1,0;4,0;;;;;1,0;;;;;;;4,0;;3,0;1,0;;;;;;;;;;;17,0;3,0;;;;;;;1,0;;;;1,0;17,0;;2,0;;1,0;4,0;;;;;;;;;;;;3,0;;1,0;19,0;2,0;;;;13,0;15,0;;;;;3,0;;11,0;6,0;;;4,0;;;;;;;4,0;1,0;2,0;;;;;62,0;1,0;15,0;;;;;;2,0;126,0;;;;1,0;;5,0;;;;18,0;1,0;;2,0;12,0;;30,0;;4,0;1,0;23,0;;;11,0;;8,0;;6,0;1,0;;1,0;;1,0;8,0;1,0;;;;1,0;;;;;1,0;2,0;;;;;;;;;;;7,0;;;;;;;;20,0;5,0;3,0;;;;;;;;;;6,0;14,0;;1,0;14,0;1,0;;5,0;;2,0;;;;;;;12,0;;;;;;;1,0;;1,0;;13,0;;3,0;42,0;4,0;;28,0;;;;;;;;;;;;1,0;;;;6,0;;;;;;;;;3,0;2,0;;;;;;;;;;;;;;;;;;;;;;;;9,0;;;;;;;;;;;;;1,0;1,0;;;;4,0;;;;;;;3,0;;1,0;;;2,0;;;1,0;;8,0;19,0;1,0;;;;;;;;;;;;;10,0;;;;;;;;;;;;;;18,0;;1,0;;;;;9,0;;6,0;2,0;;;1,0;;;;;;3,0;;;;;;2,0;;;;;;;;;;;;;;;;;1,0;;;;;;;;7,0;;6,0;2,0;1,0;;32,0;;;;;;;;;;;1,0;;;;;7,0;;10,0;23,0;;;;;;;;1,0;;;;;;;;4,0;;;;;;;4,0;1,0;;;;;;;;;;;4,0;;;;;;;1,0;;;;;;;;;;;;;4,0;1,0;;34,0;;10,0;;1,0;;1,0;;;2,0;;2,0;;;;;;;;;;;;;;;;;;;;;3,0;;4,0;;9,0;;;;;;;;1,0;;;;;1,0;;;;;;;;;;;;;;;;;;;1,0;;;;5,0;189,0;;;;;;2,0;;;2,0;;;4,0;;;;3,0;;;;;;;11,0;;;10,0;;;;;;;;;;;;;;;1,0;11,0;;15,0;1,0;;6,0;1,0;;;;;2,0;;2,0;;;;;;;;;;;;;;;;;;;5,0;;;;;;;;;1,0;;;;;;3,0;;;1,0;;;3,0;;;;;2,0;;;;;;;;;6,0;;;;2,0;;;;2,0;;;;26,0;;;1,0;;;;;1,0;3,0;;;;;;;;;;;;;;;;;;;6,0;;;;;;;;;3,0;;;;;;;;;;3,0;;;;17,0;7,0;;12,0;;;;;;;;;;;;;;;
transition;;;;1,0;;14,0;2,0;2,0;1,0;;;;;21,0;;1,0;22,0;;1,0;;;;6,0;;;1,0;;3,0;4,0;4,0;37,0;3,0;1,0;;;78,0;7,0;12,0;;;63,0;48,0;3,0;4,0;14,0;1,0;;5,0;;;;;2,0;;4,0;;;4,0;;26,0;8,0;;;;78,0;;19,0;2,0;2,0;;;14,0;7,0;;;;;;;6,0;38,0;;83,0;;2,0;;;4,0;;8,0;1,0;;;1,0;;;28,0;;5,0;52,0;34,0;6,0;;2,0;13,0;12,0;;;;;;;4,0;;;;;6,0;;31,0;49,0;2,0;77,0;;;3,0;18,0;;;;33,0;;;4,0;;;9,0;13,0;14,0;;;1,0;;;;;18,0;3,0;2,0;1,0;;;3,0;13,0;4,0;5,0;;;;;;3,0;;34,0;;;;4,0;;;;;;7,0;2,0;2,0;;;7,0;;;;4,0;2,0;;;2,0;;2,0;1,0;;6,0;;;;;3,0;;6,0;;;2,0;;;;8,0;8,0;4,0;;4,0;;10,0;6,0;;;7,0;43,0;;;2,0;1,0;8,0;;;;;43,0;;;;;;1,0;;;;1,0;;;12,0;;;;;3,0;3,0;;13,0;1,0;;;;;8,0;;2,0;4,0;8,0;2,0;;;14,0;;16,0;;4,0;;1,0;;;;30,0;1,0;1,0;;;;2,0;;;;;3,0;;;;3,0;;11,0;;;8,0;;3,0;;2,0;7,0;;;;;;;;;2,0;1,0;;;10,0;;;;4,0;;3,0;5,0;4,0;;;2,0;4,0;3,0;2,0;;;;;2,0;;;;;;5,0;1,0;1,0;;;2,0;;;;;;1,0;;;;;;;4,0;;2,0;;3,0;;30,0;1,0;;;;;2,0;;1,0;2,0;;;;;1,0;;8,0;;;;;;33,0;1,0;4,0;;;49,0;5,0;;;;9,0;;;10,0;13,0;13,0;;5,0;9,0;;;9,0;1,0;23,0;4,0;16,0;;8,0;3,0;;;;;13,0;46,0;;;;;;2,0;4,0;1,0;3,0;1,0;9,0;1,0;10,0;3,0;2,0;;;;;10,0;;3,0;;12,0;;7,0;;29,0;1,0;;2,0;;8,0;30,0;;;8,0;;1,0;;;;;;;1,0;;16,0;;;15,0;;;;;1,0;3,0;7,0;18,0;;;;3,0;;7,0;;;;4,0;;;6,0;1,0;;;;;;;;;;;;;;;;;;;;1,0;;1,0;;;;;;18,0;5,0;4,0;;;;;;;;;;;2,0;;;4,0;;;;;;;2,0;;;;3,0;6,0;;;;;2,0;2,0;;;;2,0;4,0;;;;;;;;3,0;2,0;;;1,0;;;;4,0;7,0;;3,0;;;;;;;;;;;;;;;;;;;1,0;2,0;1,0;;;1,0;1,0;;;;;;;;;;;3,0;;;;1,0;;1,0;;;;;1,0;;7,0;2,0;;;;;;;;;;;;;;;;;;1,0;;;5,0;;;;;;2,0;;6,0;;;;;;;;;;;;7,0;;;;;;;;1,0;;;;;1,0;1,0;;;3,0;3,0;13,0;2,0;25,0;;;1,0;;;6,0;14,0;;;2,0;1,0;6,0;;;;2,0;;9,0;;;;;;;;;;;;;;;;1,0;;1,0;;2,0;1,0;;;;;;;;1,0;;;;;2,0;;1,0;;;;;;;4,0;1,0;;1,0;;;;;;;;;;;;;;;;;;;;;;;;;;;;;;;1,0;;;;1,0;;;;;;;;1,0;;2,0;;;8,0;;;3,0;;;;;;;;;2,0;3,0;;;;1,0;;;;;2,0;1,0;1,0;;;3,0;;;8,0;;;2,0;;;;;;;;3,0;;4,0;;;;;;;;;;1,0;1,0;;;4,0;;1,0;;12,0;;;;;;;;2,0;;;;;;2,0;4,0;;;;;;;;;;;;;;;;;6,0;5,0;;;;;1,0;;;;;;;;;;;2,0;;;;;;;;;;;;;36,0;;7,0;;103,0;;;2,0;1,0;;;;1,0;;;;;;;10,0;;;;;;;;;;;;;;;;;;;;;;;;;;;;;;;;;;;;;;;;;;;;;;;;;;;;2,0;;;;;;;;
translation;;;;2,0;14,0;11,0;5,0;3,0;;1,0;;;;79,0;;;7,0;;;;;;1,0;;;9,0;5,0;15,0;2,0;;15,0;5,0;30,0;9,0;;23,0;18,0;4,0;2,0;;95,0;25,0;;6,0;3,0;;;1,0;;5,0;18,0;;2,0;;;1,0;1,0;;;16,0;;;3,0;;80,0;;26,0;;;3,0;2,0;11,0;1,0;;;7,0;;4,0;;;30,0;;;17,0;;8,0;;13,0;;;9,0;;;;;;12,0;1,0;27,0;18,0;27,0;16,0;;13,0;1,0;15,0;3,0;3,0;18,0;;;20,0;5,0;1,0;;;;4,0;2,0;10,0;4,0;;1,0;6,0;;;35,0;;2,0;;;;;7,0;;;1,0;13,0;1,0;;;;;;;25,0;1,0;;3,0;;;2,0;3,0;;;;;;;;;;;;;11,0;;;;;1,0;4,0;;46,0;;1,0;;;1,0;;;;;1,0;;;;;49,0;;;;;;;;1,0;;;;;;;;2,0;5,0;10,0;;;5,0;19,0;4,0;;;;;;;;59,0;2,0;;;;;;;;;;;;12,0;4,0;;;;;;6,0;;;;;;14,0;;3,0;;7,0;;;;;;1,0;6,0;;;;;;;5,0;;;;;;;;2,0;;;;;3,0;5,0;;;;;21,0;;5,0;;;;6,0;;;;;;;;7,0;;;;;;;7,0;;;;;;20,0;;;;;;;4,0;;;;;30,0;;;;;;;;2,0;;;;;;;;;;;1,0;206,0;6,0;;;;7,0;1,0;;;1,0;;;;27,0;;;;13,0;;;4,0;;;;9,0;;;;;;;18,0;12,0;;;;28,0;4,0;;18,0;31,0;;8,0;;;;9,0;;;;;;3,0;3,0;5,0;;11,0;;;;;9,0;;;;;;30,0;2,0;;;;;4,0;3,0;2,0;;;2,0;;;3,0;;;16,0;16,0;2,0;4,0;;2,0;;;;7,0;;2,0;;;;;;6,0;1,0;2,0;;;;;;;;1,0;;;;;8,0;;3,0;23,0;1,0;;;;;1,0;;;;;;;;;;2,0;;;;;;;1,0;;6,0;7,0;;;1,0;;;6,0;1,0;;;;;;1,0;;;;;49,0;20,0;1,0;;1,0;;;;;;;;;3,0;;;;4,0;;;;;;;;;;2,0;;;2,0;2,0;;;;;6,0;6,0;;;;;;;;;;;;;;;;;3,0;;4,0;;;;;;;;;;;;;;;6,0;;;;;;;1,0;;;18,0;;;7,0;;;;;;;3,0;13,0;;;;;;;2,0;;;;;;;;;;;;;;4,0;;;3,0;;;7,0;;;12,0;;;;;;;3,0;;;;;;;;;;2,0;;;;;;;;;;3,0;7,0;1,0;1,0;14,0;;;;3,0;;;;;;;;;;;;;;;;;20,0;;;;;;;;1,0;;;;;1,0;;;;;;;;;;;;;;;;;;;;;;;;;;1,0;;;;;;;6,0;;;;;;;;;;21,0;1,0;12,0;;10,0;;;;;;;2,0;;;;;;;;;;;1,0;;;;;;;;;;;;;;;;;;;;;;;;;6,0;;;;4,0;;;;;;;1,0;;;;;;7,0;;;;;;;;;;;48,0;;39,0;;;;6,0;;;;2,0;;3,0;;;;;;;;;;;9,0;;;2,0;;;;36,0;;;;;;;;;1,0;;;;1,0;;;;2,0;2,0;;;;;;;;;;;;;;;2,0;;;;;;3,0;;;;;;;;;;;;;;;;;;;;1,0;;;;;;5,0;;;6,0;;;;;;;;;;;;;;;2,0;;;;2,0;12,0;;;;;1,0;10,0;;;;;;1,0;2,0;;9,0;;;;;;;;;;;;;;;;;;;;7,0;;;;;;;;;;;;;;;1,0;;;;;1,0;;;;;;4,0;;1,0;;;;;;;;;
transmitter;;;;3,0;;13,0;;4,0;;;;3,0;;6,0;;;25,0;;8,0;1,0;;;4,0;2,0;20,0;;;8,0;4,0;;82,0;26,0;;;;44,0;;;;1,0;6,0;59,0;;8,0;5,0;5,0;;;;;4,0;;;8,0;6,0;;;;24,0;16,0;1,0;;;;68,0;;25,0;;;;;8,0;20,0;;;;;2,0;1,0;7,0;16,0;;2,0;;18,0;;;8,0;2,0;1,0;1,0;;;;2,0;;;;23,0;;26,0;3,0;;6,0;4,0;16,0;;;1,0;;;2,0;1,0;;;;;12,0;6,0;10,0;;;64,0;;;5,0;41,0;;;;15,0;;;29,0;;;;;4,0;;;;;;;2,0;;4,0;3,0;5,0;;;9,0;;;;;;;;1,0;26,0;1,0;2,0;2,0;;27,0;;;2,0;1,0;;2,0;;;;;2,0;1,0;;1,0;1,0;;;;;;;11,0;;;;3,0;;;;22,0;;;;;;;1,0;;5,0;1,0;;;12,0;;2,0;;;;;5,0;;;;9,0;;;;;;18,0;;;2,0;;9,0;1,0;1,0;;;;;;;;;;;;5,0;3,0;;1,0;;;;;11,0;;4,0;;2,0;;;3,0;166,0;;36,0;;;;;;;;11,0;;8,0;;;;;;;;;3,0;2,0;;;;;16,0;;14,0;;;;;;1,0;;;1,0;;;2,0;;;;;6,0;;1,0;;;1,0;;;;14,0;2,0;;8,0;19,0;4,0;;2,0;;;;;79,0;3,0;;;;;6,0;;;;;;;;;;;3,0;2,0;10,0;;;;;1,0;;2,0;;;;52,0;102,0;;;;;;;1,0;1,0;;;;;;;4,0;;2,0;12,0;;;24,0;4,0;;;;4,0;;;;;;4,0;;;;5,0;;6,0;1,0;;;5,0;5,0;9,0;;8,0;;13,0;6,0;;;5,0;;8,0;11,0;2,0;;;;;;2,0;;;;24,0;15,0;1,0;;;9,0;1,0;1,0;1,0;;;8,0;;6,0;1,0;;3,0;1,0;4,0;;1,0;;;13,0;;;;1,0;;3,0;3,0;;;;;1,0;;4,0;;2,0;2,0;;;;;;2,0;3,0;6,0;;;31,0;24,0;;;;;1,0;;14,0;;3,0;5,0;1,0;;;1,0;;3,0;81,0;;2,0;;;1,0;;4,0;;;;;;;;;4,0;1,0;;;;2,0;;;;;8,0;7,0;;;;;2,0;;;;;;;;;3,0;;;;;;;;;;4,0;;;;;;;;;4,0;;;;;;;4,0;;;2,0;;3,0;;2,0;;;;1,0;;;;;;;16,0;;;;1,0;;;;;;1,0;1,0;;;;;;;;;;;;;;1,0;3,0;;3,0;;;1,0;2,0;;5,0;7,0;1,0;;;;;3,0;2,0;;;;;;;;;;;;7,0;;4,0;;;1,0;;2,0;;;;;;;;1,0;;;;2,0;;;;;;;;;12,0;1,0;;;;;2,0;;;18,0;12,0;;1,0;;;;;11,0;;1,0;;5,0;11,0;;10,0;3,0;;;;;;;3,0;1,0;;;;;;;;5,0;1,0;;1,0;;;;;;;;;;2,0;;;;1,0;3,0;;;3,0;;;2,0;;;4,0;;;;;;;2,0;1,0;;;1,0;;;;;;;;;1,0;;;1,0;;;;;;4,0;4,0;;;;;;;;;2,0;;;;;;;;;;;;1,0;;;2,0;;;;;;;;;1,0;2,0;;;;;;;;;;1,0;;;;;;;;;;;;;;;;;;;;;;;;;;;;;;;;;;;;;;;2,0;;;;;;;;;;;4,0;1,0;;3,0;;;;;5,0;;;;10,0;;2,0;;46,0;;;;1,0;;;;;;;;;6,0;;;;;1,0;;;2,0;1,0;;;;;;;;;;;;;;;;;;;;;;;;;;;2,0;;4,0;;;;;2,0;;;5,0;;;;;;;;;;;;;4,0;;;;;;;;;;;;;;;;;;;;;;;;;;;;;;;;;;;;;;;;;;;;;;;;;;;;;;;;;;1,0
transparent;;;;4,0;;14,0;36,0;21,0;;;4,0;3,0;;24,0;;;29,0;16,0;1,0;2,0;10,0;;11,0;1,0;;1,0;4,0;104,0;1,0;;72,0;3,0;2,0;3,0;40,0;1,0;28,0;9,0;2,0;;2,0;126,0;8,0;33,0;118,0;119,0;;153,0;;;;1,0;31,0;3,0;4,0;9,0;152,0;;;4,0;39,0;;1,0;;149,0;;140,0;4,0;11,0;;10,0;159,0;166,0;34,0;;;144,0;;;1,0;61,0;;2,0;;61,0;3,0;;104,0;17,0;3,0;;24,0;13,0;1,0;1,0;;28,0;2,0;93,0;8,0;38,0;2,0;;7,0;2,0;;11,0;;1,0;;1,0;2,0;217,0;1,0;8,0;;;21,0;12,0;93,0;;;1,0;8,0;;1,0;83,0;;;18,0;4,0;1,0;;34,0;6,0;;14,0;;;;;23,0;;;43,0;15,0;54,0;42,0;18,0;25,0;;10,0;47,0;16,0;;;1,0;17,0;;2,0;166,0;14,0;;1,0;;;31,0;260,0;;;3,0;;11,0;19,0;15,0;8,0;;24,0;;;1,0;;21,0;28,0;3,0;78,0;38,0;;5,0;79,0;;;40,0;9,0;6,0;16,0;110,0;7,0;17,0;;7,0;436,0;;;;;135,0;;11,0;17,0;1,0;;1,0;59,0;8,0;80,0;1,0;;1,0;9,0;36,0;1,0;;3,0;89,0;4,0;124,0;;1,0;2,0;;10,0;10,0;6,0;37,0;;;6,0;5,0;;11,0;2,0;;;27,0;3,0;10,0;25,0;70,0;;4,0;16,0;15,0;17,0;236,0;21,0;15,0;179,0;30,0;;2,0;8,0;;7,0;10,0;5,0;1,0;15,0;;293,0;5,0;6,0;;6,0;;;7,0;2,0;6,0;7,0;2,0;;9,0;;;;3,0;10,0;13,0;2,0;;1,0;;42,0;1,0;3,0;1,0;1,0;;6,0;;3,0;8,0;4,0;1,0;9,0;1,0;6,0;;14,0;;;19,0;;;;39,0;;2,0;;1,0;4,0;13,0;3,0;75,0;5,0;10,0;;6,0;4,0;;1,0;;11,0;4,0;11,0;;;;;2,0;;;1,0;;14,0;;35,0;;;;;;24,0;5,0;2,0;7,0;8,0;1,0;1,0;4,0;;;1,0;;1,0;;;;;;;;18,0;5,0;2,0;;;;;22,0;2,0;;;;6,0;;2,0;;;;;;;1,0;3,0;;;1,0;;;;13,0;;;1,0;1,0;4,0;;;;4,0;;3,0;;1,0;2,0;;;;;;;;;26,0;5,0;1,0;;;15,0;;;1,0;;;17,0;5,0;1,0;;36,0;4,0;1,0;2,0;;3,0;;;3,0;;;5,0;5,0;;;;;5,0;3,0;;;1,0;;;1,0;;;;;;;;;6,0;6,0;;;;;;;7,0;;;2,0;7,0;;;8,0;;;;;1,0;;;1,0;;;;;3,0;7,0;18,0;;4,0;2,0;1,0;;;;;3,0;5,0;1,0;2,0;2,0;3,0;12,0;14,0;;;3,0;6,0;;;3,0;;19,0;;;;2,0;7,0;2,0;;;;18,0;;;;;45,0;11,0;3,0;;;2,0;;;;;2,0;;;;1,0;;;;;8,0;1,0;;25,0;;;;;;;;4,0;33,0;4,0;;;2,0;;;7,0;4,0;;;2,0;;;;;1,0;;;3,0;7,0;;;3,0;2,0;;;;;3,0;;1,0;;;;2,0;11,0;;1,0;;;;;;;1,0;;;2,0;;;;;;;;;;;;3,0;;;;;;;;7,0;1,0;6,0;2,0;;25,0;;6,0;;;;;1,0;4,0;;;;;;;;;;;;;;;15,0;;;4,0;;;;;6,0;;;3,0;;1,0;;;;18,0;4,0;;3,0;6,0;;;;25,0;3,0;11,0;;;1,0;;;;;;;8,0;;;;1,0;7,0;;;10,0;;;;1,0;;10,0;14,0;;1,0;1,0;;2,0;;;;;3,0;;12,0;;;1,0;;1,0;1,0;2,0;;;;5,0;4,0;10,0;;;3,0;;5,0;;;8,0;;3,0;5,0;1,0;;;;;;;1,0;;;;;;5,0;;;;1,0;5,0;70,0;;;;;1,0;;;;5,0;;;;;;;;;;;;2,0;;;71,0;9,0;;1,0;2,0;;;;;5,0;;;;;18,0;;;;;;;;;2,0;1,0;27,0;;;;5,0;;;;;;4,0;1,0;;;;;;;;2,0;11,0;;1,0;;;;;;;;;;1,0;;5,0;;6,0;;6,0;;2,0;;;;;;;;;2,0;1,0;;7,0;;;;1,0;;;;;;;;1,0;1,0;;;;3,0;;;;;;;;;;9,0;;4,0;;;;2,0;;;;3,0;27,0;;;;;;;;;;;;;;;;30,0;;;;;;;;;;;;1,0;2,0;14,0;;;;;;1,0;;1,0;;1,0;;;;;;;8,0;7,0;;;;;;;9,0;;;1,0;1,0;10,0;4,0;7,0;;;;;;;2,0;;;;;;;;;;;;;
variation;;;;6,0;4,0;13,0;5,0;;;;;1,0;1,0;35,0;;6,0;6,0;;;3,0;;;19,0;;;11,0;;2,0;2,0;;6,0;1,0;10,0;4,0;2,0;14,0;7,0;4,0;10,0;1,0;83,0;8,0;;;;;;8,0;;9,0;1,0;;;3,0;;1,0;;;1,0;9,0;2,0;;5,0;;118,0;;6,0;;4,0;;5,0;18,0;41,0;;;10,0;;5,0;;2,0;24,0;;;5,0;2,0;;;4,0;;1,0;11,0;;;2,0;6,0;;31,0;8,0;24,0;12,0;33,0;19,0;;4,0;1,0;4,0;;2,0;;;;;2,0;;;3,0;1,0;7,0;9,0;29,0;1,0;;14,0;1,0;8,0;9,0;9,0;;;5,0;47,0;6,0;;19,0;6,0;;;1,0;53,0;;;1,0;7,0;8,0;;4,0;6,0;2,0;2,0;;;;2,0;;;;;1,0;;;;;1,0;;;;;3,0;;5,0;6,0;;;6,0;;1,0;;;;;;;;19,0;;;20,0;16,0;5,0;;;;;;;;;3,0;;;;;;;31,0;;2,0;;;;;3,0;;;;;5,0;;1,0;;7,0;;3,0;;;;28,0;;2,0;;;6,0;13,0;2,0;;;;;;7,0;;;;;;5,0;;1,0;;;;;;;;;;5,0;;;;;;30,0;;;;1,0;5,0;;;;3,0;;;;1,0;9,0;;3,0;;;8,0;;;;;;2,0;;1,0;8,0;;;;;26,0;;;;;;;;;;;;11,0;5,0;;;;;;;;;;;5,0;19,0;2,0;;;;;;10,0;;;;;;2,0;;;;;;2,0;10,0;;;;;;1,0;1,0;;;;;;;;;;7,0;;;;;;;1,0;;2,0;;;;;8,0;2,0;1,0;;;;5,0;2,0;8,0;14,0;;1,0;;45,0;1,0;4,0;;1,0;14,0;;;2,0;;2,0;;1,0;11,0;6,0;3,0;;;2,0;1,0;2,0;;2,0;21,0;;;6,0;;1,0;1,0;;1,0;9,0;;;;1,0;;;2,0;2,0;;5,0;;9,0;25,0;;1,0;1,0;10,0;;1,0;3,0;;;7,0;;33,0;10,0;6,0;1,0;4,0;;11,0;;3,0;6,0;;;;;2,0;10,0;;1,0;2,0;5,0;;4,0;;;5,0;1,0;;;;;1,0;;;;2,0;;;;;;;54,0;;;1,0;;;;;5,0;2,0;;;;;;2,0;;;1,0;;;3,0;3,0;;;;;;6,0;;;1,0;3,0;;;;;;;;;1,0;;;;;;;;;;;;8,0;;;6,0;;;;;;;;1,0;;;;;;2,0;;1,0;;;3,0;;;;;;;2,0;;;;;;;;;4,0;;2,0;1,0;;;7,0;3,0;1,0;2,0;;;;;1,0;;;;2,0;3,0;;;;;1,0;;;;;3,0;;;7,0;2,0;10,0;;;;;;;;;;2,0;;;;26,0;4,0;;;;;3,0;;;;;;;;;;;8,0;;;;;1,0;;;;;;;;;;5,0;;;;;3,0;;;;;3,0;;;;;;;;;;;;;;9,0;;;;;;;;2,0;;7,0;;;;;;1,0;;;;;;;;;;;;;;;2,0;;;;;;;;;;2,0;;;;;;;;;;;;;;2,0;7,0;;7,0;;4,0;;;;;;;1,0;;;;;;;;;;;;;;;;;;;;4,0;3,0;;6,0;;;;6,0;;;;;;;;;;;;;;;5,0;3,0;;;2,0;;;;;;;1,0;;;;;1,0;;;;;8,0;6,0;;1,0;;1,0;;;;;1,0;;2,0;7,0;;;;;;;11,0;;;;;;;;;2,0;;;2,0;;;;;;;;;;;1,0;3,0;6,0;3,0;;;;;;;;;2,0;;;3,0;;6,0;;;;;1,0;;;;;1,0;;3,0;;;2,0;;;;;;;;;1,0;;;;;;;;;;;;;;;1,0;;;;;;;2,0;;4,0;;;3,0;;;;;;;1,0;;6,0;;;;;;;;;;;;;;;;;;;;;;;;;;;;;;;;;;;;;;;;;;1,0;18,0;;;;;1,0;;;;;;;;;3,0;;2,0;14,0;;3,0;;;7,0;;;1,0;;;
vector;;;;5,0;8,0;17,0;12,0;;;;;2,0;;151,0;;;26,0;;2,0;7,0;;;4,0;;;;;60,0;2,0;6,0;52,0;4,0;16,0;16,0;;84,0;27,0;4,0;16,0;;222,0;15,0;;3,0;21,0;1,0;;12,0;17,0;4,0;26,0;;;;69,0;8,0;43,0;;6,0;72,0;;;6,0;;288,0;;34,0;2,0;1,0;;21,0;3,0;39,0;;;40,0;;;;16,0;120,0;;8,0;12,0;5,0;;;41,0;2,0;8,0;14,0;;26,0;;;;144,0;28,0;133,0;61,0;39,0;17,0;;6,0;10,0;97,0;24,0;1,0;;12,0;;43,0;29,0;6,0;;1,0;47,0;106,0;9,0;4,0;1,0;;5,0;29,0;;20,0;88,0;;4,0;;26,0;2,0;;44,0;;;16,0;2,0;2,0;;;;;;;22,0;11,0;;50,0;;;4,0;;;;;;;;;;7,0;;;;;10,0;;;2,0;3,0;4,0;;71,0;;13,0;;;1,0;3,0;;;;4,0;;;18,0;;60,0;;1,0;;;;;;;2,0;14,0;2,0;;;1,0;;13,0;5,0;;;7,0;1,0;10,0;10,0;14,0;;;;6,0;12,0;;1,0;1,0;;;;1,0;;;8,0;;10,0;;;10,0;2,0;;;5,0;;;34,0;;;;;;32,0;;4,0;1,0;2,0;;;6,0;1,0;;;22,0;79,0;;;1,0;;;11,0;;;;;17,0;2,0;;;;1,0;;;;23,0;;;;;13,0;;2,0;;;2,0;22,0;;;;;;;;36,0;;;;;;;47,0;;;;3,0;;5,0;;;;;2,0;;7,0;;;;;75,0;7,0;42,0;;;;;1,0;1,0;;;2,0;;12,0;;;;4,0;;;52,0;3,0;;2,0;;4,0;16,0;;;;;;;5,0;;;;26,0;;;;1,0;;;;1,0;14,0;;;;;100,0;23,0;21,0;2,0;1,0;;26,0;;7,0;64,0;;15,0;12,0;21,0;1,0;26,0;;1,0;5,0;22,0;26,0;;3,0;10,0;1,0;45,0;19,0;;;9,0;5,0;;7,0;24,0;5,0;;380,0;2,0;;2,0;;6,0;12,0;14,0;;;2,0;1,0;1,0;;;14,0;2,0;15,0;;15,0;1,0;;;;10,0;;11,0;;4,0;;;;;;22,0;3,0;3,0;8,0;49,0;4,0;14,0;;;;3,0;;7,0;;6,0;5,0;;21,0;24,0;1,0;;2,0;;;16,0;;;48,0;2,0;;26,0;;;;2,0;;;16,0;;;17,0;12,0;;;11,0;;;26,0;6,0;3,0;;8,0;6,0;;3,0;;;2,0;1,0;;;;;8,0;;;;5,0;5,0;1,0;;;;1,0;;2,0;;;;;4,0;7,0;2,0;2,0;;;;;;;;7,0;3,0;1,0;;;1,0;1,0;1,0;9,0;;;;;;;;;;;2,0;;;;;1,0;;;2,0;;;;1,0;;;;3,0;1,0;9,0;;;;;61,0;;1,0;;;;;4,0;;3,0;;;1,0;2,0;;;;;4,0;;;4,0;2,0;3,0;;;;;260,0;;2,0;;;6,0;4,0;;;7,0;4,0;;;;;;;;;42,0;3,0;;;1,0;;;;;;;2,0;;;;;12,0;1,0;;;;2,0;;;;;;;;;3,0;2,0;8,0;;1,0;;7,0;2,0;;1,0;2,0;;;;;;;;10,0;;4,0;2,0;;33,0;;26,0;14,0;;;;;;;;;;;;;;;;;1,0;;;;;;;12,0;;;;;;;2,0;;2,0;;;;;;;;;;;;;4,0;2,0;;;;;;;;1,0;19,0;;;;1,0;;4,0;;5,0;;;2,0;;;;;;;;;;;1,0;;;;;;;;;;;;;;7,0;;5,0;;;;;;;;7,0;;;;;3,0;;;;;;;4,0;;;;2,0;;;;;;;2,0;;2,0;;;2,0;91,0;;;;;;10,0;;3,0;;3,0;;1,0;;3,0;6,0;4,0;;3,0;;;;;4,0;;;;10,0;;;;;;2,0;122,0;;;;;;;;1,0;2,0;4,0;26,0;;29,0;;;1,0;6,0;;;;;;;;;;;;7,0;;;5,0;;;;1,0;;;;;;6,0;;;;;10,0;;;;;;;;;;;;;;;;;;;;;;;;;;;;;;;;;;;4,0;39,0;2,0;;;;;;1,0;;;;;;1,0;;;;;;;;;;;6,0;;;;;;;;;1,0;;;4,0;;;;4,0;11,0;;;;;;;;;9,0;;;;;;8,0;;;;;;70,0;;1,0;;;11,0;;;;;;
velocity;;;;9,0;3,0;11,0;;;;;;;;56,0;;;3,0;;;2,0;;;;;;;10,0;3,0;4,0;6,0;33,0;7,0;62,0;5,0;;22,0;4,0;;;;72,0;28,0;;;6,0;;;;;4,0;8,0;;;;;;;;16,0;11,0;;;10,0;;41,0;;28,0;3,0;;;3,0;26,0;4,0;;;1,0;;7,0;;;32,0;;;1,0;14,0;;;10,0;;1,0;4,0;3,0;;8,0;;;10,0;;7,0;18,0;58,0;14,0;;;1,0;10,0;;1,0;;;;7,0;4,0;;;;;;1,0;77,0;5,0;;120,0;9,0;;;30,0;;;;32,0;2,0;;11,0;1,0;;;;12,0;;;;;;1,0;1,0;;;7,0;;2,0;;;;;;;;;;;2,0;;3,0;;;3,0;;;39,0;8,0;;9,0;24,0;;;;;;;;;;;;;35,0;1,0;4,0;;;;;;;;;;;;;;2,0;;;;;;40,0;;;9,0;18,0;;;;28,0;;;1,0;;29,0;;;;;13,0;;;;;2,0;1,0;;1,0;;;;;;;;;;;8,0;;;;;;;;;1,0;1,0;;1,0;;;;;1,0;14,0;;;;1,0;;;;;;;;;;30,0;;;;;4,0;;;;;;25,0;;10,0;;;;;;4,0;6,0;;;;;;9,0;;;;21,0;3,0;2,0;;;;;;;2,0;;;;8,0;37,0;2,0;;;;;;1,0;;;;;;1,0;;;;;;5,0;1,0;16,0;;;;;;;;;;;;3,0;;5,0;;;;;30,0;;1,0;;;4,0;248,0;;4,0;4,0;;20,0;3,0;16,0;2,0;;12,0;2,0;;6,0;6,0;;;;27,0;;14,0;;;1,0;;;;;6,0;;10,0;7,0;;2,0;2,0;7,0;;4,0;14,0;;;8,0;;;7,0;;2,0;1,0;18,0;6,0;;;4,0;;7,0;;6,0;;11,0;4,0;8,0;;;14,0;;;;28,0;3,0;4,0;23,0;9,0;;;5,0;;;;7,0;;7,0;1,0;;21,0;6,0;1,0;;8,0;;1,0;;;2,0;13,0;;;;;;1,0;;;;;;1,0;;;;;;;;;;;;;;;;;;2,0;;;3,0;;;;;;3,0;;;;;;3,0;3,0;;;;;17,0;;;;2,0;1,0;;;;;;;;;;;;;;;;;;;;3,0;;6,0;;;;;;;;2,0;;;;;;;;1,0;;;6,0;;;;;;;3,0;;6,0;;;6,0;;;;;;;;;;;;;;6,0;;;;;;;;;15,0;;;;;;;;;;;;;;1,0;2,0;;;;3,0;;1,0;;;;;;;;;2,0;;;;;;;;6,0;;;;;;;;2,0;;;;;;;;;;;;;;;;;8,0;;;;;;;;;37,0;;;;;;;;;;;;;;22,0;;;;;;;1,0;1,0;;;;;;;;;2,0;;;;;;;;5,0;7,0;;;;;;;;;;;;;;;3,0;;;;;;4,0;;;;;;;;;5,0;;;1,0;;;;;;;;3,0;;;;;1,0;;;;;;;;;;;;;;;;;;;;;;;;;;;;;;;;;;;;;;;;;;;;;;;;;;;;;15,0;;;;2,0;1,0;;;;;;;;1,0;2,0;;;;4,0;3,0;;;;;;2,0;;;;;;;;1,0;3,0;;;;;;;;;;;;;;;20,0;2,0;;;;;;;;;;;;;1,0;;;;;;;;;;;;;;;;;;;;;;;;;;;;;;;;1,0;;;2,0;;;;;;;;;;;;;;1,0;;;4,0;;;;2,0;;;1,0;2,0;;5,0;;;;;;;5,0;;;1,0;1,0;1,0;;2,0;;;;;;;;;;;;2,0;;;;;2,0;;;;;;;;;;;;3,0;;;;;;;;;;;;2,0;;;;;;;;;;;;;;;;
vertical;;;;41,0;18,0;50,0;17,0;48,0;3,0;;6,0;;5,0;99,0;;;29,0;;16,0;1,0;;2,0;16,0;7,0;1,0;1,0;;36,0;12,0;1,0;79,0;2,0;7,0;7,0;;36,0;27,0;33,0;10,0;2,0;49,0;60,0;1,0;11,0;50,0;37,0;;26,0;4,0;2,0;32,0;;45,0;3,0;34,0;6,0;37,0;1,0;;41,0;;;13,0;;270,0;;103,0;2,0;1,0;8,0;30,0;46,0;31,0;1,0;2,0;;;61,0;3,0;6,0;76,0;;7,0;;45,0;18,0;;38,0;1,0;9,0;14,0;2,0;5,0;;2,0;5,0;147,0;43,0;74,0;142,0;158,0;92,0;9,0;26,0;10,0;30,0;6,0;13,0;;2,0;36,0;40,0;10,0;;;;8,0;25,0;4,0;53,0;;1,0;137,0;20,0;;2,0;71,0;;1,0;;21,0;10,0;;65,0;9,0;;91,0;19,0;2,0;;;9,0;1,0;;19,0;5,0;25,0;31,0;3,0;18,0;5,0;7,0;16,0;29,0;;13,0;;;2,0;;;60,0;;12,0;3,0;;14,0;10,0;1,0;1,0;15,0;26,0;9,0;539,0;;17,0;;5,0;11,0;;;2,0;13,0;38,0;;2,0;8,0;3,0;33,0;7,0;2,0;;;3,0;2,0;4,0;34,0;3,0;12,0;1,0;;;3,0;2,0;25,0;5,0;28,0;;17,0;132,0;28,0;33,0;22,0;;1,0;15,0;13,0;29,0;1,0;3,0;5,0;9,0;1,0;;20,0;;110,0;2,0;1,0;2,0;1,0;2,0;26,0;29,0;8,0;;1,0;2,0;;28,0;;2,0;11,0;1,0;;8,0;2,0;9,0;54,0;5,0;16,0;;7,0;11,0;4,0;1,0;111,0;68,0;2,0;;21,0;4,0;;7,0;16,0;;;;8,0;11,0;;;;10,0;4,0;;8,0;174,0;4,0;1,0;;1,0;316,0;13,0;2,0;2,0;14,0;4,0;28,0;;30,0;;5,0;1,0;37,0;8,0;203,0;1,0;4,0;;4,0;7,0;;1,0;3,0;4,0;12,0;16,0;122,0;28,0;1,0;;2,0;1,0;49,0;;46,0;2,0;3,0;33,0;;16,0;9,0;27,0;3,0;;3,0;4,0;;;9,0;4,0;3,0;1,0;7,0;3,0;1,0;;1,0;;54,0;39,0;10,0;6,0;2,0;;80,0;14,0;1,0;11,0;;;7,0;1,0;11,0;3,0;1,0;20,0;67,0;;1,0;;3,0;;;17,0;;11,0;;3,0;;;17,0;38,0;6,0;3,0;;3,0;;;40,0;124,0;;5,0;7,0;18,0;2,0;64,0;;2,0;2,0;1,0;4,0;;1,0;12,0;8,0;;9,0;3,0;;16,0;;3,0;6,0;23,0;;;11,0;30,0;3,0;7,0;;2,0;8,0;30,0;14,0;3,0;;;2,0;1,0;3,0;11,0;;14,0;;1,0;1,0;3,0;4,0;;9,0;;6,0;3,0;;1,0;1,0;16,0;;;9,0;31,0;5,0;6,0;20,0;2,0;9,0;3,0;;9,0;;9,0;2,0;;;3,0;;15,0;8,0;4,0;24,0;4,0;;;;;;2,0;4,0;12,0;16,0;1,0;;4,0;15,0;2,0;;;26,0;;;3,0;;13,0;14,0;1,0;2,0;;2,0;;2,0;9,0;1,0;1,0;7,0;;;;;6,0;1,0;;8,0;;2,0;;;;;12,0;;;;;4,0;5,0;;;;4,0;1,0;2,0;;;2,0;4,0;;;5,0;2,0;6,0;20,0;557,0;;15,0;3,0;7,0;4,0;;10,0;11,0;10,0;;1,0;;7,0;2,0;2,0;;;3,0;;;;2,0;;1,0;;;5,0;;1,0;;;;;;;;;;;12,0;18,0;;4,0;;6,0;1,0;1,0;4,0;1,0;;19,0;2,0;;1,0;;;;;1,0;;;;;;;1,0;;;9,0;;1,0;4,0;;5,0;;2,0;;;6,0;;2,0;3,0;;;;;;;7,0;;;6,0;;;1,0;;;;;;5,0;;1,0;17,0;1,0;;1,0;10,0;3,0;5,0;;;;;1,0;2,0;;4,0;1,0;;;;;10,0;;5,0;;;6,0;;;1,0;;1,0;;19,0;;5,0;;1,0;1,0;;;21,0;;;;;;;;;;;;;12,0;1,0;;8,0;3,0;;23,0;;1,0;;;2,0;21,0;29,0;5,0;;;;14,0;1,0;;4,0;;3,0;;;1,0;2,0;2,0;;3,0;;;3,0;12,0;17,0;;4,0;;;;1,0;13,0;33,0;;;13,0;23,0;2,0;;3,0;8,0;8,0;;;3,0;1,0;;;;8,0;;;;;1,0;;;1,0;23,0;;4,0;2,0;5,0;1,0;;;;4,0;;;25,0;;;;;1,0;3,0;1,0;1,0;2,0;;;4,0;3,0;3,0;19,0;1,0;;6,0;8,0;6,0;1,0;4,0;;1,0;1,0;;;;10,0;;5,0;6,0;;;;;2,0;9,0;1,0;;;6,0;14,0;2,0;2,0;1,0;;;2,0;2,0;;60,0;;8,0;;;;;22,0;1,0;;;3,0;3,0;;;;;40,0;;;;;;;;3,0;5,0;;2,0;;10,0;;6,0;;;2,0;;4,0;2,0;;;;8,0;1,0;1,0;;1,0;;3,0;34,0;1,0;;3,0;2,0;6,0;1,0;;;;2,0;;;;;4,0;2,0;;;1,0;;;;;;;;;18,0;;;11,0;;;;1,0;;;;;;6,0;2,0;;;;2,0;1,0;3,0;5,0;;;;14,0;;;;;;2,0;;;2,0;1,0;;;2,0;;5,0;;;;;2,0;;;;8,0;1,0;2,0;1,0;2,0;;4,0;;;4,0;;;;;;;;;6,0;;6,0;10,0;;;;;;2,0;;1,0;13,0;;2,0;;;;;;;;;;;;;2,0;;;;
vibration;;;;2,0;2,0;25,0;;8,0;;;1,0;;11,0;33,0;;;4,0;;;;;;;2,0;1,0;3,0;;6,0;;;41,0;5,0;12,0;92,0;;1,0;4,0;;;;;24,0;;1,0;4,0;24,0;;10,0;;;;;;;;;5,0;;4,0;5,0;;;;;13,0;;23,0;;;2,0;;54,0;5,0;;;;3,0;;;;15,0;;4,0;;30,0;2,0;;1,0;;1,0;;;;;1,0;;;;6,0;;18,0;;;3,0;2,0;6,0;;1,0;;;;;2,0;;;1,0;;;;21,0;;;12,0;;;2,0;7,0;;;;6,0;;;100,0;;;1,0;;;;;;1,0;;;;;3,0;1,0;1,0;1,0;22,0;3,0;;;;;;;;;3,0;;;;;4,0;3,0;;19,0;2,0;;4,0;13,0;;2,0;2,0;2,0;;;1,0;;;5,0;2,0;;;6,0;9,0;;;;1,0;8,0;;;;;4,0;2,0;;;;1,0;4,0;;55,0;;15,0;30,0;9,0;3,0;;;;6,0;4,0;1,0;;;2,0;4,0;;;21,0;;15,0;3,0;1,0;3,0;1,0;;;2,0;1,0;;;;;;;2,0;;;2,0;;;2,0;28,0;;;;;1,0;;;12,0;16,0;;;;10,0;;2,0;;;1,0;;;1,0;;1,0;37,0;6,0;;;3,0;;1,0;;;2,0;10,0;1,0;1,0;;64,0;5,0;;2,0;31,0;;;2,0;;;9,0;;8,0;;;;;;;;;3,0;2,0;9,0;;;;;1,0;;14,0;;;;6,0;1,0;9,0;;;;;;;;;;;;;;;;;;15,0;3,0;;;;1,0;;9,0;;1,0;;;;;;1,0;;2,0;1,0;;;;;;;1,0;;;;2,0;;;;5,0;;;;9,0;;;80,0;;;;;36,0;;;;3,0;;2,0;;1,0;1,0;3,0;;;1,0;1,0;;10,0;;1,0;;;;;2,0;2,0;;3,0;;5,0;11,0;1,0;1,0;;;;;;;;;11,0;1,0;5,0;;;3,0;;9,0;5,0;1,0;;2,0;2,0;2,0;;2,0;3,0;;;;;;;18,0;;;;1,0;1,0;;;;;;;;;;2,0;;;;;6,0;;1,0;1,0;1,0;;;;;;;;15,0;;1,0;;;;2,0;;1,0;;;;;;;;4,0;;;;;;;;;3,0;;;;;1,0;;;;;;;1,0;;;2,0;;;;;;;;;;8,0;;;1,0;;;;;;;;;;;;;;;;;;;;;;1,0;;;;;;;;;;;1,0;2,0;;;;5,0;;;;;;;;;;;;;;;;;;1,0;;;;;3,0;;;;;;;;;;;;;;;;;;;;;;;;;;;;;;;;;;;;;;;;;;;;;4,0;2,0;;;1,0;;;;;;;;;;;;;;;;;;;;;;;;;;;10,0;;;3,0;;;;;;;;;;2,0;;;;;1,0;;;;;;;6,0;;;;;;;1,0;3,0;29,0;;2,0;;;;;;;;;;;;;;;;;;1,0;;;;;;;;;;2,0;;;2,0;;;2,0;;;;;;6,0;;;;;1,0;;;;;;;;;;;;;;;;;;;;;;5,0;;;;;;;;;;;;;;;;;;;3,0;;;;;;;;1,0;;;;;;;;;;;;;;;;;9,0;;;;;;;;;;;;;;;;;;;1,0;;;;;;;;;2,0;;;;;;;2,0;;;;;;;;;;;;;;;;;;1,0;;;;;;;;;;1,0;1,0;4,0;;;;;;;;;;1,0;;;;29,0;;;;;;;1,0;;;;;;;;;;;;;2,0;;;4,0;;;;;;;2,0;2,0;;;;;2,0;;;4,0;;;;;2,0;;;;;;;;;;;6,0;;;;;;;;;;4,0;;;;;;;;;;;;;;;;;;;;;;;;;;;;;;;12,0;;;;;;;
viewpoint;;;;8,0;;12,0;28,0;;;;;;;57,0;;;148,0;;2,0;;;;11,0;3,0;;;;3,0;1,0;;12,0;13,0;3,0;;;19,0;;1,0;85,0;;37,0;26,0;;24,0;32,0;;;4,0;;1,0;12,0;;;;34,0;1,0;5,0;;;30,0;;1,0;1,0;;345,0;3,0;21,0;5,0;1,0;;;1,0;;;;;;1,0;1,0;8,0;27,0;;;6,0;1,0;;;1,0;2,0;;;;;;;;29,0;;32,0;11,0;27,0;23,0;;2,0;9,0;3,0;;6,0;;;;109,0;14,0;2,0;;;13,0;;47,0;19,0;4,0;;;2,0;;8,0;22,0;;;;;;;1,0;;;45,0;10,0;;;;;;;1,0;1,0;1,0;2,0;12,0;;;;;2,0;;;;;;;;;3,0;1,0;;;;;5,0;;7,0;;1,0;30,0;;;;;;;;;;4,0;;;;;25,0;;3,0;;;;;;;;;;;;;;7,0;1,0;;;;;5,0;17,0;;;;1,0;;;;9,0;1,0;11,0;;;;;10,0;;;1,0;;;12,0;;;;;;;10,0;;;;;;21,0;5,0;;;;;;1,0;;;;;4,0;;;;8,0;;26,0;;;;;11,0;;;;;;;;;13,0;;;;;2,0;;1,0;;;;;;;;;;;;20,0;;;;;;;;;;;;;7,0;;;;;;;26,0;;;;;29,0;;1,0;;4,0;;;;;;;;;1,0;;;;16,0;;;;;;;;4,0;5,0;;;;;1,0;;;;;;33,0;;;3,0;1,0;;;1,0;;;;;;1,0;16,0;;3,0;1,0;;10,0;6,0;;9,0;;;;2,0;6,0;;8,0;;;;2,0;;;;;;18,0;9,0;;;2,0;;;;107,0;5,0;;;;;2,0;4,0;;1,0;7,0;;;;;;3,0;;1,0;;30,0;;4,0;;;;2,0;5,0;;5,0;;5,0;;2,0;;;;10,0;;5,0;11,0;;7,0;35,0;21,0;;;;;;;;;;;1,0;1,0;;;1,0;4,0;4,0;;;1,0;;;11,0;1,0;;;;;;;;;;6,0;3,0;3,0;7,0;;;;;1,0;;;;;;;3,0;;8,0;2,0;;;;;;;;;;;;;;25,0;;2,0;;;;;;;;;;;;;;;;;;;;;2,0;1,0;;;;;;;;;;3,0;;;2,0;9,0;;11,0;;;;;;;;;;;;;;;;;;;;;;;;;;;;;;1,0;;19,0;;;;;10,0;;;;;;10,0;;1,0;;;;;;;3,0;;;;;3,0;;;;;;;;;;2,0;5,0;;;;;;;;;;;;;;3,0;;;;;;;;;;;;;;;3,0;;1,0;;1,0;;;3,0;;;16,0;1,0;;;;;;;2,0;;;;;11,0;;;2,0;;;;;;;;2,0;;;;;;;;;;;2,0;;;;;1,0;;;;;;;2,0;;;1,0;;;1,0;;;;;;;;;;12,0;;;;;;;;;10,0;;;;2,0;;;;;;;;;6,0;;;;;;;;;;;;;;;;;;;;;;;;;;;;;;;;;;;;;;3,0;;2,0;;;;;1,0;;;;2,0;;;;;;;;;;;;;;;5,0;;;;4,0;;;;1,0;;7,0;;;;;;;;;18,0;;;;;;;2,0;;;;;;;;;;;;;;;;;;1,0;;;;;;;;;;;;;;;;;;;;;;;;;;;;;;;;;;;;;;;;;;;;;;;;;;;;;;;;;;;;;;;;;;;;;;1,0;;;;;;;;;;;;;;;;;;;;;;;;;;;;;;;;;;;;;;;;;;;;;5,0;;;;;;;;;;;12,0;;;2,0;;;;11,0;;;;;;;;;;;
voice;;;;4,0;;37,0;;11,0;;;;;1,0;45,0;;;9,0;;;6,0;;;;;5,0;;;4,0;3,0;1,0;56,0;10,0;;1,0;;30,0;15,0;1,0;;;18,0;46,0;;;12,0;3,0;;1,0;;22,0;;3,0;;;;;2,0;;3,0;25,0;;;;;29,0;;40,0;3,0;;2,0;2,0;28,0;1,0;1,0;;;;;;1,0;36,0;;6,0;;70,0;2,0;;5,0;;1,0;2,0;;;4,0;2,0;;;;11,0;;27,0;1,0;;9,0;8,0;19,0;;2,0;;;;1,0;2,0;1,0;7,0;2,0;;;;30,0;1,0;;46,0;;;4,0;38,0;;4,0;;7,0;1,0;;41,0;;;;;;;;1,0;;;;37,0;2,0;2,0;10,0;;;;2,0;1,0;;;;;;;6,0;8,0;;10,0;;;13,0;7,0;;7,0;2,0;;12,0;13,0;4,0;;11,0;1,0;3,0;;;;;1,0;;;;24,0;5,0;1,0;;;;;3,0;1,0;7,0;;3,0;1,0;;;;;;1,0;6,0;;;;5,0;;;;;;10,0;;;1,0;;5,0;5,0;;;;8,0;;;;;;;3,0;1,0;31,0;;;;;;;;;;;5,0;5,0;6,0;;;;;1,0;8,0;8,0;4,0;8,0;;;;6,0;4,0;;1,0;;;;;;;;41,0;;;;;4,0;;;;7,0;5,0;2,0;;;;;5,0;;293,0;5,0;;;;;5,0;24,0;4,0;;;;;1,0;;7,0;;;;5,0;;;;;;;;3,0;;1,0;;;;;;;;;11,0;2,0;;;;;13,0;;;1,0;;;;;;;;;;;;2,0;;;1,0;;6,0;;;3,0;22,0;7,0;;;;;3,0;;;;1,0;;;;;;2,0;;2,0;145,0;1,0;;61,0;;;2,0;;9,0;;2,0;;1,0;;2,0;;1,0;2,0;24,0;1,0;3,0;6,0;;;86,0;;;1,0;3,0;;;;235,0;;7,0;;;8,0;;;2,0;;;;;;;;49,0;;9,0;2,0;;6,0;;;35,0;2,0;;6,0;58,0;3,0;;;2,0;;1,0;;1,0;;;60,0;;;27,0;8,0;;;;;;;;1,0;;;1,0;;;;;;6,0;9,0;1,0;9,0;2,0;;;;;1,0;;9,0;;42,0;3,0;6,0;;10,0;;;;;;;;;;;;;1,0;;4,0;1,0;7,0;;;;;1,0;1,0;13,0;;1,0;;;;;1,0;;;1,0;;;;;;;;;;;2,0;;3,0;2,0;;;;2,0;18,0;;;;1,0;;5,0;;;;;;;32,0;15,0;5,0;;;;;;;1,0;5,0;;;;;;2,0;;2,0;;;2,0;;;1,0;;;;;;;;;;;;1,0;1,0;4,0;;4,0;;;;;;;;;2,0;4,0;1,0;;;;;;2,0;;2,0;;;;;4,0;2,0;;;;6,0;;33,0;14,0;;;;;;;;;2,0;;1,0;;1,0;;1,0;2,0;;;;;;;;2,0;;;;5,0;;;1,0;;;;;;1,0;;;2,0;;;;;2,0;3,0;;;;;;;;;;;;;2,0;;3,0;5,0;;;;;;;;;;;1,0;;;;;;23,0;46,0;;;1,0;;;;;1,0;;;;;;;;2,0;;;;;;;;1,0;;;;;;3,0;;;;;;1,0;;;;;;;;;;;5,0;;;13,0;;;;;;;;;;;;;;;;1,0;;;;;;;;11,0;;;;;;;;2,0;1,0;;;;;;;;;;;;;;2,0;;;;;;;;;;;;;;;;2,0;;;;;;;;;;;;2,0;;;8,0;;;;;;;;;;;;;;;;;;;;;;;;;;;1,0;;;;;;2,0;;;;;;;;3,0;;;;;;;;;;;;;;;;;;;1,0;;;;;;1,0;;;;1,0;;;5,0;;;;;;;;;;;1,0;;;;;;;;2,0;;;;;;;;;;;;3,0;1,0;;;;;;;;;;;;;;2,0;;;;;;;;;;;;;;;;;;;;;;3,0;;;;;;;;;;;;;;2,0;;;;;;;;;;;;
volume;;;;14,0;4,0;3,0;3,0;6,0;;;;;;27,0;;;49,0;;;;;;;;3,0;;;1,0;2,0;;5,0;4,0;;;;20,0;23,0;;3,0;2,0;18,0;25,0;1,0;9,0;7,0;6,0;1,0;9,0;;;9,0;;1,0;2,0;9,0;;1,0;;2,0;6,0;;;;;34,0;;19,0;5,0;;;2,0;7,0;5,0;6,0;;;4,0;1,0;;;20,0;;;7,0;9,0;;;5,0;;;1,0;1,0;;;;;;;28,0;6,0;11,0;7,0;;2,0;4,0;2,0;1,0;1,0;1,0;;;4,0;11,0;;;;10,0;6,0;2,0;6,0;;;;3,0;;6,0;22,0;;;;5,0;;;3,0;;;20,0;9,0;2,0;;;;;;2,0;;10,0;3,0;2,0;1,0;;;1,0;;;;;;;;1,0;3,0;;;;;2,0;5,0;2,0;;4,0;2,0;3,0;2,0;;1,0;1,0;2,0;;;1,0;;;1,0;;;;;2,0;;2,0;;;1,0;;1,0;17,0;1,0;4,0;;;1,0;;;12,0;;1,0;;3,0;8,0;;3,0;;;;2,0;1,0;;;;13,0;3,0;;;;;4,0;;;1,0;5,0;;5,0;2,0;2,0;;;;;4,0;;;;;;2,0;;1,0;5,0;;11,0;4,0;;4,0;;;3,0;25,0;;;1,0;;2,0;3,0;2,0;2,0;;;2,0;2,0;;;;1,0;;;;3,0;;;;;1,0;;;;1,0;;;;;;;;3,0;;8,0;;;;1,0;;;;;;;2,0;4,0;;;;5,0;;;;7,0;;;;;40,0;2,0;5,0;2,0;8,0;;;1,0;;;;;;2,0;;;;;;;;;;;1,0;;4,0;;;;;;;;1,0;2,0;;4,0;;3,0;;;;;;;2,0;;;;;;1,0;3,0;4,0;3,0;;1,0;;7,0;1,0;;;;7,0;1,0;;3,0;12,0;4,0;;;;;;1,0;2,0;;;;3,0;;22,0;1,0;5,0;;2,0;31,0;;;;;;1,0;5,0;;5,0;;;;;1,0;;1,0;3,0;;;;;;;7,0;17,0;;;4,0;4,0;;;2,0;;4,0;;;1,0;;;;;;4,0;;1,0;;;;;1,0;;1,0;;;1,0;;;8,0;;;;;;;;4,0;;1,0;;;;;;;1,0;2,0;;3,0;1,0;1,0;4,0;;;;;;;;;;;;;;;1,0;1,0;;;;;2,0;;21,0;;;;3,0;;;;;;2,0;;;;1,0;;14,0;;;;1,0;;;1,0;;9,0;;;;3,0;;2,0;;5,0;;;1,0;;;;;1,0;;2,0;;;;;;3,0;;;;;;;;4,0;;;;;2,0;;2,0;;1,0;;;;;;;26,0;;;3,0;4,0;;2,0;;1,0;;;;1,0;;;;;;2,0;1,0;;;1,0;;;;;;;;;;;;;;;;19,0;;;2,0;;;;;;;;;;;;;3,0;;;;3,0;;2,0;;;;;;;;;;;2,0;;;;2,0;1,0;;;;;;;;;15,0;;;;;;1,0;4,0;22,0;;;;;;;;;;;2,0;;;;;;;;2,0;;;;;2,0;2,0;;1,0;;3,0;;;;1,0;;;1,0;2,0;;;;;;;;;;;;;1,0;3,0;;;;;4,0;;;;;;;;;;;;;;17,0;;;;;;;3,0;;;7,0;;;;;;;;;;;;11,0;;2,0;;;;;;;;;;;;7,0;;;1,0;;;;;;;;;;;;;;;;2,0;;;;1,0;;1,0;;;;;;;;;;;;1,0;1,0;;;4,0;;;;;;;;;;;;;;;;;;;;;;;1,0;;4,0;;4,0;;;;5,0;;;2,0;;1,0;;3,0;;;;;;;;;;5,0;;;;;;;;;;;;;1,0;;;;;;;;;;;;;;;;;;;;;;3,0;1,0;;;;;;1,0;1,0;;;;;;;;;;;;;;;;;;;;;;2,0;;;;;;;;;;;;;;;;;;;;;;2,0;;2,0;;;;;4,0;;;;;;;;;;;;;1,0;;;;;;;2,0;;;;;;;;;;;;
wafer;;;;4,0;;1,0;20,0;6,0;;;;1,0;;15,0;;;23,0;;;;16,0;;1,0;;;;5,0;36,0;;;;;;2,0;;8,0;8,0;;;;13,0;7,0;;;;15,0;;43,0;;;;;4,0;1,0;;7,0;63,0;;;;3,0;;43,0;;107,0;2,0;75,0;3,0;6,0;4,0;;220,0;2,0;;;;19,0;;;9,0;64,0;;;;52,0;1,0;;45,0;47,0;;4,0;2,0;;;;1,0;6,0;7,0;56,0;;50,0;2,0;;12,0;1,0;;;;1,0;;;9,0;1,0;1,0;;;;;;139,0;;;2,0;4,0;;;23,0;;3,0;8,0;;;;7,0;;;;;;;;6,0;;;;1,0;;12,0;;8,0;;;;3,0;;;;10,0;;;11,0;5,0;;;;;3,0;2,0;2,0;;29,0;;1,0;5,0;;12,0;;;;;1,0;;2,0;2,0;;12,0;1,0;;;;;;;1,0;;5,0;8,0;2,0;;;;19,0;;3,0;1,0;;;1,0;;;;;;;;;;3,0;;1,0;5,0;;;;;;59,0;11,0;;6,0;;;;;;;;;;;;6,0;;;3,0;1,0;3,0;4,0;45,0;;;3,0;5,0;1,0;23,0;;4,0;37,0;1,0;;3,0;2,0;;;1,0;;;1,0;;27,0;;1,0;;;;;;;;2,0;;;16,0;3,0;;;28,0;;6,0;;;;;;1,0;;1,0;;;;;;;;;;6,0;;;10,0;;;;;;;;2,0;;;2,0;;12,0;6,0;;;;;;;;;;;;;;;;;;4,0;16,0;;;3,0;;;;;;;;38,0;;;;13,0;1,0;;;;;;;10,0;4,0;;;;;;6,0;12,0;;;;;;;5,0;;;;;;;;1,0;;;;;;;;;;;;;;3,0;119,0;;8,0;1,0;;;;;;;;1,0;;;;;;;;;;;;;2,0;;;;;;;;;;;;;;2,0;;;;;;;;;;;;;;;;;;;2,0;1,0;;;;;;;;;2,0;;;1,0;;;2,0;;;;;7,0;;2,0;;;5,0;;;;;;;;;;;;;;;;2,0;;;;;;;;;;;1,0;;;;;;;;;;;;;;1,0;;;;;;;;;;;;;;;;6,0;;;;;;;;;;;;;;;;;;;;;;;;;5,0;;;;;17,0;23,0;36,0;;;;;;;;;;16,0;;;;1,0;;;;;;;;;;;;;;9,0;;;;16,0;;;;;;;;;;;;;;;;;;;;;;;;;;;31,0;;;;;;;;;;;;;5,0;;;2,0;;;;;3,0;;;;;;;;;;6,0;;;;;;;;;;;;;;;;1,0;;;;;2,0;;;;;;;;;10,0;;;;;;2,0;;;;;;;;;;;;;;;;;;;;;5,0;;;;;;;;;;;1,0;12,0;6,0;;;;;;;;;;;;;;;;;;;;;;;;;;;;;;;2,0;;;;;;;;;;;;;;;;;;18,0;;;;;;;;;;;2,0;;;6,0;;;;;;;;;;;;;;;;;;9,0;;;;;;;;;11,0;;;;5,0;;;;;;;;;1,0;;;;7,0;;;;;;4,0;;;;;;;;;;;;;;;;;;;;18,0;;1,0;;;;;;;;;;;;;;;;;;;;;;;;;;;;;;;58,0;;;;;47,0;;;;;;;;;;;;;;;;;;;;;;;;;;;8,0;;;;9,0;;;;;;;;;;;;;;;;;;;;;;;;;;2,0;;;;;;;;;1,0;12,0;;;;;;;;2,0;;;;;;;;;;;;;;;;;;
warp;;;;19,0;15,0;3,0;1,0;2,0;;;;;;34,0;;;12,0;;;;;;;;;5,0;;;4,0;;26,0;;3,0;1,0;;11,0;3,0;;30,0;;39,0;2,0;;12,0;;;44,0;;;1,0;3,0;;;;2,0;3,0;4,0;;;76,0;;;2,0;;706,0;;22,0;;;;5,0;4,0;;;;23,0;;;;;76,0;;;39,0;8,0;;;7,0;;;64,0;10,0;;;;;8,0;;49,0;4,0;5,0;9,0;;15,0;16,0;20,0;;;1,0;;;3,0;30,0;;;2,0;;20,0;;8,0;5,0;;3,0;;;;40,0;;;;7,0;;;5,0;;;18,0;3,0;;;;6,0;;;1,0;59,0;;;3,0;;;1,0;;5,0;;;;;1,0;;;1,0;;;;5,0;;;;1,0;;;;;;;;;;;;;;;;;1,0;;13,0;;;;;;;;;;;;;;;;2,0;2,0;;;;;;;;;;;34,0;;;;5,0;;;;;;70,0;;3,0;8,0;;;;8,0;;;;;;;;;;;1,0;2,0;1,0;;1,0;;;;;;;;;;;;;;;1,0;;;;;;1,0;;;;;;;;;;;;18,0;7,0;1,0;;;;;5,0;;;1,0;;;;;;;;;;;;5,0;;;;;;1,0;;;;;;;;;;;;5,0;;13,0;;;;;;1,0;;;;;;;;;;;2,0;2,0;;;;;;1,0;;;;;;;;;;;8,0;;;;;;;1,0;;;;;;;7,0;15,0;2,0;;;;6,0;4,0;;;;;;5,0;;9,0;1,0;;;1,0;1,0;;;96,0;;9,0;;;;82,0;;;16,0;;;;1,0;;;2,0;;;56,0;;;;;;;;;;;;;6,0;;;;;;;;;;;;;;;3,0;;2,0;6,0;;;1,0;;12,0;;;;;;2,0;;;;18,0;;;7,0;;;;;;;;;7,0;1,0;;;;;1,0;;;;;12,0;;2,0;79,0;;;9,0;;;;;;;;;;;;1,0;;;;;;;;;;;;;;3,0;;2,0;;;;;;8,0;;;;;;;;;;;4,0;;;;;3,0;;;;;;;;;;;;;;;;1,0;;;;1,0;;;;2,0;;;1,0;;;;;;;;36,0;2,0;;;;;;;;;;;;;;24,0;;;;;;;;;3,0;;;1,0;;13,0;;;;;;;;;;;1,0;;;;;;;;;3,0;;;;;;;;;;;;;;;;;;;;;;8,0;;;;;;;;3,0;;13,0;;;4,0;58,0;;;;;;;;;;;6,0;;;;10,0;2,0;;;2,0;16,0;;;;;;;3,0;2,0;;;;;;;8,0;;;;;;;;;;1,0;;;;;;;;;;;2,0;;;;;;;;;;;;;;;;;;;30,0;;;;5,0;;;;;;;;;;;;;;;;;;;;;;;;;;;;;;;;;;6,0;;;;;;;;;;;;;;;;;;;;;;;;;;;;;;;;;;;;;15,0;;8,0;;;;;;;;;;;;;;;;;;;15,0;;;;;;;;;;2,0;;;14,0;;;;;9,0;;;10,0;;;;;7,0;;;;;;;;;;;;;;;;;;2,0;;;;17,0;;;;;;;;;;9,0;;;;;;;;;;;;;;;;;;3,0;;;;;;;;;8,0;;;;;;;;;;;;;;;;;;5,0;;;;;;;;;6,0;;;;;;;;1,0;;;;;;;;;;;;;;;;;;;;;;;;;;2,0;3,0;;;;;;;;;;;13,0;;;;;6,0;;;;;;
water;;;;2,0;;2,0;;6,0;;;;;;17,0;;;9,0;;9,0;;;;2,0;;3,0;;;;;8,0;61,0;18,0;3,0;;;2,0;;4,0;1,0;1,0;36,0;22,0;;8,0;9,0;14,0;;21,0;;1,0;1,0;;4,0;2,0;3,0;;15,0;;1,0;16,0;1,0;;2,0;;24,0;;7,0;1,0;;;;109,0;2,0;1,0;;;4,0;;;;35,0;;9,0;28,0;12,0;2,0;;;1,0;;;6,0;;;28,0;;;;4,0;2,0;7,0;;;3,0;;1,0;;;2,0;;;4,0;50,0;5,0;3,0;;;;1,0;67,0;;;3,0;;;;33,0;;;1,0;;;;5,0;;;1,0;;2,0;1,0;;;;;3,0;1,0;1,0;17,0;1,0;4,0;;1,0;20,0;2,0;;;;5,0;;;;15,0;;;;;;10,0;;5,0;;;;5,0;;1,0;;;5,0;;;;;4,0;;3,0;4,0;;;;;3,0;28,0;4,0;;;13,0;;8,0;;;;9,0;;;1,0;10,0;;;4,0;;5,0;2,0;;;22,0;1,0;;;1,0;;;3,0;;;;12,0;1,0;10,0;;2,0;;8,0;;;;4,0;;;;;;;;7,0;2,0;16,0;;5,0;;;;;8,0;;8,0;3,0;46,0;5,0;;;8,0;;17,0;3,0;;;;;5,0;15,0;;;1,0;;;7,0;19,0;;;2,0;;1,0;5,0;;;;4,0;;;;1,0;;;;;1,0;1,0;;;;;;89,0;;;1,0;1,0;;4,0;;;;;;;2,0;;3,0;;;68,0;2,0;1,0;;;;;1,0;;;;;12,0;;;;;;;;;;;;4,0;;;;;;;;;2,0;;;;15,0;;5,0;;1,0;1,0;7,0;;1,0;;;;2,0;;;2,0;;;6,0;;;2,0;13,0;1,0;;;;9,0;6,0;;1,0;;;;1,0;3,0;1,0;1,0;;5,0;6,0;;;;1,0;1,0;;3,0;;;;;;15,0;;;1,0;;;;;;;;3,0;;;7,0;;25,0;1,0;;5,0;;;;1,0;;7,0;;;;19,0;;;;;;;1,0;8,0;;;;10,0;;2,0;;;;;;;1,0;;3,0;1,0;;;;;;;2,0;11,0;;5,0;;;;;;;2,0;10,0;;3,0;2,0;3,0;;;;;2,0;;;8,0;;8,0;;;;;9,0;;;;;4,0;;;;1,0;;;;;;17,0;;;;2,0;4,0;;;;;1,0;1,0;6,0;;;;4,0;1,0;;;;;;;;;;;;;;;9,0;;;;;;;;;;;2,0;;;1,0;2,0;;;;;;;8,0;;;;;;;;;1,0;2,0;;;;;;;;1,0;;;;;;;;;10,0;4,0;;;;;4,0;1,0;;;;;;4,0;;;2,0;;;;;;2,0;;;;;;;;;;;;2,0;;;;;;;;;;;1,0;;;;;1,0;;2,0;;;;;;25,0;;;;;;;;;;;;;;;;;;;1,0;;;;1,0;;;;;;;;;;;;1,0;;;;3,0;15,0;;;;;;;;;1,0;;;2,0;;;;;;;2,0;;;;;;;;;;1,0;;1,0;;;;1,0;;;;3,0;;;;;;;;;;;;;;;;;;4,0;;;;;;;;;;;2,0;;;;;;;;;;;;;;;;;;;;4,0;5,0;;;;;;;;;;;;;;;;18,0;14,0;;;9,0;;;;;;;;;;;;;;;;;;;;;;;;;;;;;;;;;6,0;;;;1,0;;;;;;;;;;;;;;;;;;;;;;;;;;;;;;;;;;;;;;2,0;;2,0;;;;;;;;;;;1,0;;;;;;;;;;;;;;;;;;6,0;;;;;;;;;;;;;;;;;;;;;;;;;;;;;2,0;;;;;;;;2,0;;;;;2,0;;;;;;;;;;;;;1,0;;;;;;;5,0;;;;;;;;;;;;;;;;;;;;;;;;;;;
wave;;;;3,0;;18,0;4,0;;;;;4,0;3,0;38,0;;;5,0;;;3,0;;1,0;;;2,0;;;;2,0;;87,0;;;;;27,0;3,0;;;;8,0;140,0;;7,0;4,0;1,0;;6,0;;;;2,0;2,0;1,0;;;7,0;;16,0;173,0;;;;;40,0;;32,0;;;;25,0;6,0;85,0;1,0;;;4,0;15,0;;1,0;5,0;;;;12,0;;;6,0;;;;;21,0;;;;;2,0;;1,0;3,0;1,0;;;14,0;2,0;;1,0;;;;5,0;;;;;;;2,0;4,0;;;157,0;;7,0;21,0;5,0;;;1,0;22,0;;;161,0;;;5,0;;;25,0;;8,0;;1,0;;8,0;10,0;20,0;2,0;2,0;5,0;;4,0;;;2,0;;1,0;;2,0;23,0;2,0;;35,0;9,0;;;7,0;;186,0;2,0;;1,0;;;;1,0;122,0;;;4,0;;;;;7,0;7,0;;;;;;8,0;;1,0;;4,0;5,0;1,0;;1,0;22,0;;;18,0;1,0;1,0;6,0;;12,0;;;;;;;9,0;;;;13,0;3,0;;;9,0;;59,0;;;2,0;;6,0;3,0;1,0;;;66,0;4,0;;;;27,0;;;;;2,0;19,0;1,0;;;;;;2,0;1,0;4,0;9,0;6,0;651,0;3,0;53,0;;1,0;;;;11,0;;;;;2,0;2,0;;;;;;;11,0;;2,0;;;;7,0;;;;;;;;;;2,0;;;;;;1,0;;;;;;;28,0;;;1,0;;;;;;;2,0;;67,0;1,0;;;;;;10,0;;1,0;;;1,0;1,0;;;;;;3,0;38,0;3,0;;;;;1,0;;57,0;;;;;;;40,0;;;5,0;3,0;;;;;;;1,0;;;;;;;4,0;;;;1,0;;3,0;;1,0;;;308,0;;;;;;2,0;;1,0;;3,0;;;;;;;;;;;;;8,0;8,0;;;;1,0;2,0;;;;;;;;;;1,0;25,0;;;;1,0;1,0;;;3,0;3,0;;9,0;;;;3,0;;1,0;;;1,0;;;;;;5,0;1,0;;;;;;;;;;;1,0;;;;;;;;;;2,0;;;;;;;;;;;;;3,0;1,0;;;;;;2,0;1,0;2,0;;;;;;4,0;;;;;2,0;;;;1,0;;;;;;;;;;;;;;;;;;;;;;;;;;4,0;;;;;;;;;22,0;;;;;;;;;;;;;;;;;;;;;;;;;;;;;;;;;6,0;76,0;;;3,0;6,0;;;48,0;;;;;;;;;;;;;;;;;1,0;;;;;;;29,0;16,0;;;;;;;;;;;8,0;1,0;;;;;;;;;;1,0;;;;;;;;12,0;;;;;;;;;;;;;;;;;;;;1,0;;;;;;;;;18,0;;;;;;;;3,0;;;;1,0;21,0;;1,0;1,0;;;;;;;;1,0;16,0;;;;;;;7,0;5,0;1,0;;;;;;;;;;;4,0;;1,0;;;;;;;;;;;;;;;1,0;;3,0;;;;;;;;;;;;;1,0;;;;;;;;;;;;;;;;;;;;;;;17,0;;;;;;1,0;;4,0;;53,0;;1,0;;1,0;;1,0;24,0;;;;3,0;16,0;;;;3,0;;;;;;1,0;;;;;;;;;;1,0;;;;;;;;;;;;;;;;;;;;;;;;;4,0;;;3,0;;;;;;;;;;;;;;;1,0;;;;;;;;;;4,0;;;;67,0;;;;;;;;;2,0;;;;;;;;1,0;;;;;;;;;;2,0;;;;;;;;;1,0;7,0;;;2,0;;;;;;;;;;;;;;;;;;;139,0;;;;;;;;;;;;;3,0;;;;;;;2,0;;;;;;;;;;;;;3,0;;;2,0;;;;;;;;;;;;;;8,0;;;;;;;;2,0;;;;;;;;;1,0;;;;
wheel;;;;2,0;11,0;5,0;1,0;94,0;;;;;3,0;28,0;;;2,0;;;;;;;1,0;;;;6,0;;1,0;20,0;;;;;18,0;2,0;;;;9,0;9,0;2,0;;8,0;15,0;;8,0;;;4,0;;9,0;;;;;;;1,0;;;;;8,0;3,0;51,0;;;6,0;1,0;;;;;1,0;;2,0;;1,0;38,0;;13,0;5,0;21,0;3,0;;;;;;;4,0;;;;;13,0;17,0;9,0;53,0;3,0;;;1,0;1,0;;;;;1,0;;;;;;;10,0;;10,0;;;14,0;;;6,0;42,0;;;;5,0;;;15,0;;;;;;;;;;;;;4,0;13,0;8,0;28,0;9,0;1,0;25,0;3,0;2,0;;1,0;;;;;31,0;;1,0;;1,0;18,0;;;;;;;9,0;;1,0;3,0;;2,0;;;;;2,0;;1,0;3,0;1,0;43,0;30,0;;1,0;;4,0;5,0;8,0;5,0;;3,0;1,0;;;;;3,0;;7,0;;;30,0;4,0;4,0;6,0;;;4,0;;16,0;1,0;2,0;;;;;1,0;;7,0;4,0;6,0;10,0;;;;1,0;43,0;;;;2,0;1,0;;;17,0;17,0;;10,0;;2,0;12,0;;;4,0;;;;;30,0;11,0;;;12,0;5,0;;62,0;3,0;;;;;;;;5,0;13,0;;;4,0;33,0;2,0;;3,0;;23,0;;;12,0;;;;1,0;;9,0;;;;3,0;6,0;1,0;;18,0;10,0;;1,0;;;5,0;3,0;3,0;1,0;;;;1,0;;;;2,0;;2,0;1,0;11,0;;5,0;;;;;;19,0;;;;21,0;1,0;;;3,0;1,0;;1,0;18,0;27,0;10,0;2,0;1,0;3,0;;15,0;;5,0;;;1,0;;5,0;;9,0;3,0;;;;;;;;1,0;2,0;3,0;;;4,0;7,0;1,0;18,0;2,0;;2,0;;;;14,0;1,0;1,0;;;8,0;;;;;;;;3,0;4,0;;;;7,0;1,0;1,0;;1,0;;2,0;1,0;;4,0;6,0;22,0;4,0;3,0;1,0;2,0;1,0;6,0;4,0;;;;;2,0;;;;16,0;3,0;;1,0;12,0;;;1,0;;36,0;105,0;;1,0;1,0;;;;;;;1,0;;1,0;3,0;;;;;10,0;;2,0;;;;2,0;;;2,0;;;6,0;2,0;;1,0;;;;;;1,0;;;1,0;;;;;;1,0;;;6,0;;3,0;;;2,0;1,0;;;;2,0;;;;;;7,0;1,0;;;;;;;;1,0;1,0;;;1,0;;6,0;;;2,0;2,0;1,0;;;;;;;;20,0;;4,0;43,0;;;;;;;;;;4,0;1,0;;;;;;2,0;5,0;;;;;;;;;;;;1,0;;;1,0;;;1,0;;;;;17,0;1,0;;1,0;;;;;;2,0;;;;;;;;;;;3,0;;2,0;1,0;;;3,0;;;1,0;;;;;;;1,0;;;2,0;;4,0;;;;;;;;;;;;;;;;;;1,0;;;;;4,0;;;;;17,0;;;;;;;;;;1,0;1,0;;;;;;;;;;;;;;1,0;;;4,0;2,0;2,0;;;;;13,0;;;;;6,0;;;;;;;3,0;;;;;18,0;;7,0;;;;;;135,0;7,0;1,0;4,0;3,0;;;;3,0;2,0;;;;;1,0;;5,0;;;;;2,0;7,0;;;;;;;;1,0;28,0;2,0;;18,0;;1,0;;;2,0;3,0;4,0;;;;;;;;;;;2,0;;;;;4,0;;1,0;;;;;;;;;;;;;;;;;;;1,0;4,0;;;3,0;1,0;;;;;;;;;;;;;;;;;;;;;;;;;;;;;;;;1,0;;;;;;2,0;;;;;;;;;;;53,0;1,0;;;;;3,0;;;;;;;1,0;;;;;;;;;;;1,0;;;;;;;;;;;;3,0;;;;;;;;;;;;;;;;;;;;;;;;;;;6,0;;;1,0;2,0;;;;;;3,0;;;;1,0;;;1,0;4,0;;;14,0;;4,0;;;;;;;;;;49,0;;1,0;;3,0;;;;4,0;6,0;;;10,0;;;;;2,0;4,0;2,0;;1,0;1,0;;;;;;;1,0;;;;;;;;;2,0;;;;;;;;;;;;;;;;;;;;;;1,0;;;;;;;;
width;;;;7,0;;21,0;10,0;8,0;;;;2,0;7,0;71,0;;1,0;6,0;1,0;15,0;3,0;;2,0;31,0;9,0;2,0;;;4,0;;13,0;25,0;6,0;2,0;;;13,0;18,0;2,0;27,0;;49,0;46,0;26,0;9,0;42,0;6,0;;19,0;;7,0;7,0;;19,0;2,0;3,0;4,0;21,0;;4,0;19,0;;;6,0;;117,0;;14,0;32,0;;11,0;217,0;66,0;52,0;;16,0;2,0;21,0;;;1,0;47,0;;3,0;;56,0;;;11,0;;2,0;3,0;;10,0;1,0;2,0;;94,0;16,0;60,0;16,0;39,0;20,0;5,0;;7,0;11,0;;;;;;17,0;87,0;;;;;6,0;9,0;54,0;7,0;;43,0;6,0;9,0;;44,0;;3,0;3,0;27,0;;;57,0;21,0;;21,0;;;;;3,0;1,0;;35,0;4,0;79,0;27,0;2,0;2,0;;7,0;5,0;7,0;;;;;1,0;;1,0;10,0;;6,0;;;18,0;8,0;11,0;;;2,0;1,0;155,0;;14,0;2,0;1,0;1,0;;;;;13,0;;1,0;8,0;;17,0;22,0;;1,0;;4,0;4,0;10,0;25,0;4,0;181,0;4,0;1,0;15,0;1,0;;5,0;;19,0;1,0;;11,0;11,0;3,0;5,0;;;154,0;15,0;18,0;21,0;;16,0;;1,0;2,0;7,0;;196,0;6,0;;2,0;;;37,0;46,0;5,0;3,0;;;;14,0;;153,0;;;;9,0;;15,0;67,0;2,0;5,0;8,0;;5,0;18,0;3,0;17,0;95,0;;;6,0;2,0;2,0;8,0;6,0;;24,0;10,0;;14,0;;2,0;3,0;2,0;;;9,0;14,0;5,0;1,0;1,0;;17,0;;4,0;;;34,0;4,0;5,0;15,0;;6,0;1,0;23,0;2,0;22,0;1,0;4,0;;;4,0;2,0;;;17,0;4,0;;116,0;9,0;1,0;;5,0;2,0;;;1,0;3,0;1,0;1,0;2,0;58,0;;2,0;;1,0;;;;;10,0;;6,0;32,0;2,0;5,0;6,0;;6,0;;2,0;1,0;;1,0;4,0;2,0;72,0;5,0;;4,0;;;1,0;7,0;20,0;;;39,0;6,0;2,0;7,0;;;;1,0;2,0;;;;;;;21,0;21,0;7,0;1,0;;1,0;5,0;;8,0;2,0;;;;2,0;1,0;3,0;;;;2,0;2,0;;1,0;5,0;26,0;4,0;1,0;;;6,0;3,0;1,0;3,0;8,0;;;2,0;6,0;;34,0;;2,0;2,0;;5,0;;3,0;;;4,0;;;;4,0;;2,0;;4,0;7,0;;3,0;;2,0;;1,0;;;;;4,0;22,0;;8,0;1,0;;5,0;7,0;;2,0;1,0;;2,0;;;1,0;2,0;;;2,0;;20,0;;;2,0;1,0;;;;;4,0;4,0;1,0;9,0;4,0;1,0;;;;23,0;;;2,0;1,0;7,0;6,0;;;;;;1,0;4,0;;;26,0;;;;2,0;1,0;;15,0;;19,0;3,0;;;;;6,0;;;2,0;1,0;;3,0;1,0;;7,0;4,0;;;;;;4,0;;;;;4,0;14,0;43,0;;4,0;1,0;6,0;3,0;;74,0;1,0;107,0;;5,0;;1,0;;;1,0;1,0;;;;;;;1,0;;43,0;3,0;;;;;;1,0;;5,0;;;;8,0;36,0;;;1,0;;3,0;;;12,0;;;2,0;;;6,0;;;;;2,0;;;;;;1,0;;;;;;;;;;9,0;;;;1,0;;;;;;;;;2,0;;;;;2,0;;;;;;;;;2,0;3,0;4,0;4,0;;;3,0;4,0;;;;2,0;;;;;1,0;;1,0;;4,0;1,0;;6,0;;;;;;;;;;;16,0;;;;;3,0;;;21,0;;;;;;;;;;4,0;;1,0;;;;7,0;5,0;1,0;6,0;1,0;;;;11,0;11,0;5,0;3,0;;11,0;;35,0;;;1,0;;;1,0;;;;47,0;;;4,0;;;8,0;;;;;;;;1,0;5,0;;;;1,0;4,0;1,0;1,0;1,0;;;;2,0;3,0;;;3,0;4,0;;;;2,0;9,0;;;;;1,0;;;;;1,0;;;;5,0;;2,0;;;;2,0;;17,0;;5,0;;1,0;;5,0;5,0;;;;;1,0;;;;;;4,0;;;5,0;;;1,0;5,0;1,0;15,0;2,0;;4,0;20,0;3,0;;;;1,0;1,0;18,0;;;;1,0;;;;4,0;;3,0;5,0;5,0;2,0;;9,0;;;5,0;;2,0;;;;;1,0;19,0;7,0;;;3,0;1,0;;;2,0;;14,0;;5,0;;;3,0;2,0;;;;;;;2,0;;;;3,0;;40,0;;1,0;3,0;;;;;1,0;;;2,0;8,0;;7,0;1,0;;2,0;1,0;5,0;1,0;;;;;;;;;;;;;1,0;;3,0;;11,0;4,0;;1,0;;;;;;;;3,0;;;;;;;;;83,0;1,0;;4,0;6,0;1,0;3,0;;1,0;;2,0;1,0;;;1,0;;;;;;;;;8,0;1,0;2,0;;;;;;;;14,0;;;;1,0;;;;2,0;;;12,0;;;5,0;11,0;;;;;;6,0;;;;;;;;;;;;;;;;;
window;;;;42,0;4,0;32,0;52,0;50,0;1,0;;;5,0;9,0;88,0;;3,0;78,0;8,0;4,0;6,0;;;5,0;3,0;3,0;;;29,0;22,0;;92,0;9,0;;;2,0;47,0;32,0;10,0;42,0;32,0;47,0;105,0;4,0;3,0;110,0;61,0;2,0;44,0;;1,0;6,0;13,0;41,0;21,0;23,0;7,0;91,0;;1,0;21,0;41,0;;4,0;;425,0;2,0;131,0;1,0;;3,0;17,0;209,0;208,0;1,0;;;38,0;98,0;1,0;2,0;100,0;;;;82,0;2,0;;154,0;13,0;2,0;5,0;5,0;28,0;16,0;6,0;;64,0;21,0;114,0;15,0;111,0;18,0;6,0;7,0;14,0;50,0;8,0;1,0;5,0;;;16,0;74,0;9,0;3,0;;2,0;6,0;11,0;150,0;6,0;;10,0;55,0;8,0;26,0;97,0;;2,0;3,0;72,0;;;62,0;2,0;1,0;83,0;9,0;1,0;2,0;;32,0;21,0;;22,0;29,0;45,0;55,0;18,0;15,0;;16,0;12,0;6,0;3,0;;2,0;15,0;;;2,0;9,0;18,0;4,0;;;36,0;80,0;;14,0;18,0;2,0;27,0;29,0;10,0;20,0;1,0;12,0;2,0;1,0;73,0;1,0;25,0;98,0;4,0;24,0;33,0;4,0;59,0;111,0;1,0;12,0;38,0;21,0;11,0;50,0;169,0;22,0;47,0;6,0;;75,0;1,0;;29,0;2,0;46,0;;8,0;35,0;3,0;3,0;;4,0;3,0;48,0;8,0;13,0;6,0;14,0;94,0;;5,0;;20,0;;136,0;1,0;6,0;1,0;5,0;6,0;47,0;3,0;32,0;;4,0;;;1,0;;18,0;14,0;2,0;31,0;29,0;36,0;36,0;93,0;31,0;26,0;;6,0;99,0;14,0;10,0;18,0;225,0;29,0;;11,0;4,0;;86,0;28,0;5,0;;6,0;2,0;;13,0;1,0;9,0;20,0;2,0;;18,0;52,0;4,0;21,0;1,0;;33,0;20,0;6,0;;7,0;15,0;11,0;2,0;3,0;6,0;;5,0;8,0;7,0;7,0;3,0;;5,0;8,0;;3,0;16,0;5,0;1,0;1,0;10,0;18,0;29,0;12,0;1,0;25,0;;8,0;;50,0;;1,0;11,0;14,0;38,0;22,0;11,0;13,0;24,0;;;7,0;6,0;3,0;2,0;3,0;;21,0;8,0;;;;;5,0;5,0;3,0;2,0;;9,0;2,0;20,0;;4,0;;;;;3,0;1,0;1,0;22,0;43,0;;12,0;;;;;3,0;;5,0;;1,0;;;19,0;19,0;4,0;1,0;;8,0;;;22,0;2,0;;2,0;4,0;40,0;2,0;1,0;;14,0;13,0;;2,0;131,0;12,0;2,0;1,0;13,0;3,0;1,0;2,0;9,0;21,0;27,0;1,0;37,0;1,0;5,0;24,0;20,0;;7,0;6,0;7,0;14,0;3,0;4,0;;1,0;2,0;;2,0;1,0;149,0;;49,0;1,0;15,0;1,0;13,0;4,0;;24,0;1,0;;;21,0;107,0;2,0;;38,0;6,0;45,0;2,0;;;;;49,0;;;;3,0;3,0;;;3,0;17,0;4,0;6,0;6,0;1,0;17,0;29,0;4,0;1,0;;;;;7,0;;6,0;42,0;5,0;13,0;1,0;;;;;;;21,0;;;10,0;;4,0;7,0;;;2,0;9,0;5,0;2,0;13,0;1,0;1,0;4,0;2,0;11,0;12,0;13,0;2,0;11,0;3,0;2,0;;1,0;;8,0;1,0;30,0;3,0;1,0;17,0;19,0;20,0;;6,0;1,0;1,0;2,0;;;3,0;4,0;9,0;;;4,0;;5,0;11,0;;;1,0;17,0;8,0;;3,0;98,0;76,0;5,0;7,0;20,0;;5,0;8,0;7,0;;;6,0;1,0;2,0;;10,0;2,0;;1,0;7,0;9,0;4,0;1,0;;4,0;;1,0;11,0;;3,0;;7,0;29,0;7,0;3,0;;4,0;;;3,0;15,0;2,0;1,0;26,0;;;9,0;1,0;;;;3,0;15,0;8,0;;3,0;5,0;;;;;3,0;;;5,0;4,0;;;17,0;;1,0;2,0;2,0;;;;18,0;20,0;;;;5,0;1,0;2,0;4,0;;;;2,0;;;;7,0;;;6,0;6,0;;;3,0;14,0;;;14,0;;44,0;;16,0;4,0;1,0;;;;15,0;;1,0;9,0;;13,0;;;;36,0;1,0;;;4,0;;61,0;;1,0;;;2,0;;2,0;115,0;1,0;;1,0;;;;3,0;1,0;27,0;6,0;3,0;2,0;8,0;;;;15,0;4,0;4,0;;;;2,0;2,0;2,0;;1,0;;6,0;77,0;2,0;30,0;4,0;1,0;1,0;1,0;45,0;;18,0;;3,0;2,0;1,0;;;9,0;7,0;1,0;;2,0;2,0;;3,0;;3,0;12,0;;;;;2,0;3,0;;;6,0;;;30,0;7,0;1,0;2,0;;;2,0;7,0;2,0;1,0;;;5,0;10,0;1,0;6,0;;;;1,0;5,0;;;;1,0;2,0;2,0;;;4,0;;3,0;47,0;;10,0;1,0;;;293,0;;1,0;14,0;;1,0;;;4,0;;;1,0;;;;;;;;6,0;;;4,0;;1,0;;;;;;;90,0;5,0;;;;;3,0;;;;;;12,0;2,0;2,0;;2,0;3,0;2,0;;;;1,0;;;;;2,0;;;2,0;;;;2,0;4,0;;4,0;;5,0;;;;4,0;;;11,0;;1,0;;;19,0;9,0;6,0;;;1,0;;55,0;16,0;;4,0;;;2,0;;;1,0;;;1,0;;;16,0;1,0;;1,0;;;;;;;5,0;;;;4,0;;5,0;3,0;10,0;;;2,0;;2,0;5,0;;;;;48,0;;9,0;;;3,0;;3,0;2,0;;3,0;8,0;1,0;;2,0;;19,0;;;;;;;1,0;;3,0;;;;;4,0;;;;;;1,0;;2,0;;;2,0;;1,0;;;;1,0;;;;4,0;;;;8,0;;5,0;;5,0;;4,0;1,0;1,0;1,0;;;;;;;4,0;;;2,0;;;;;1,0;;;
wire;;;;3,0;2,0;69,0;2,0;107,0;;;;;;54,0;;;6,0;;25,0;;49,0;;5,0;26,0;21,0;;;20,0;2,0;20,0;140,0;3,0;;2,0;;20,0;33,0;;;1,0;11,0;168,0;13,0;2,0;;90,0;;36,0;;;;;90,0;12,0;;;98,0;;6,0;17,0;;;8,0;;82,0;;146,0;8,0;;2,0;25,0;94,0;19,0;2,0;;;28,0;;;76,0;44,0;;54,0;6,0;176,0;12,0;;35,0;;1,0;;1,0;27,0;2,0;;;31,0;5,0;282,0;8,0;58,0;7,0;;10,0;17,0;2,0;;1,0;;;;1,0;33,0;1,0;;;1,0;15,0;27,0;76,0;50,0;1,0;134,0;;;8,0;47,0;;9,0;2,0;12,0;5,0;3,0;132,0;;6,0;15,0;1,0;;5,0;6,0;9,0;;;5,0;36,0;16,0;67,0;4,0;103,0;1,0;5,0;25,0;11,0;30,0;4,0;3,0;1,0;;3,0;69,0;312,0;;;8,0;;152,0;20,0;8,0;;1,0;;;59,0;;3,0;12,0;;5,0;;2,0;6,0;17,0;31,0;;11,0;8,0;;5,0;2,0;;;1,0;2,0;98,0;43,0;49,0;4,0;7,0;31,0;47,0;165,0;;13,0;6,0;;195,0;28,0;3,0;60,0;14,0;14,0;1,0;;;20,0;17,0;7,0;2,0;13,0;68,0;;1,0;11,0;10,0;6,0;265,0;1,0;;;4,0;;;;14,0;;;3,0;;;;1,0;5,0;3,0;9,0;8,0;8,0;47,0;79,0;;;7,0;4,0;113,0;142,0;38,0;132,0;111,0;7,0;;8,0;62,0;;56,0;5,0;;;;1,0;1,0;;;49,0;4,0;1,0;2,0;5,0;4,0;6,0;7,0;;7,0;19,0;70,0;;;15,0;12,0;78,0;;50,0;;1,0;2,0;;32,0;18,0;3,0;12,0;;3,0;2,0;28,0;2,0;;10,0;1,0;14,0;;39,0;;11,0;10,0;;;;22,0;3,0;10,0;1,0;1,0;3,0;17,0;3,0;1,0;1,0;2,0;3,0;68,0;34,0;;;;9,0;1,0;1,0;2,0;;;8,0;12,0;4,0;2,0;;1,0;9,0;34,0;28,0;1,0;67,0;2,0;;;1,0;;17,0;;9,0;24,0;31,0;2,0;;;;;4,0;;;7,0;;8,0;;;5,0;8,0;;1,0;7,0;;;50,0;;4,0;;;;;;;;;;;1,0;;7,0;;;2,0;;;2,0;1,0;1,0;5,0;5,0;1,0;10,0;;4,0;;48,0;;26,0;46,0;1,0;2,0;;;;;;4,0;2,0;;123,0;3,0;5,0;;;3,0;;;;24,0;;1,0;;3,0;;;68,0;;;;;2,0;;11,0;;;8,0;3,0;;8,0;8,0;;;10,0;1,0;3,0;4,0;;;;2,0;;;;;;;;9,0;16,0;12,0;;2,0;;;15,0;;2,0;;8,0;1,0;7,0;;5,0;;;;;13,0;10,0;1,0;2,0;;1,0;5,0;;;;;;;2,0;;;;1,0;;;1,0;;9,0;;9,0;4,0;17,0;89,0;41,0;;6,0;;;1,0;5,0;;;;;;23,0;2,0;3,0;;;4,0;;;;;28,0;;1,0;;3,0;2,0;;;;;;;2,0;;;;;;24,0;;;;;;;;;;1,0;;15,0;2,0;;;;;2,0;;;;41,0;8,0;5,0;2,0;;;1,0;9,0;;;;;;;;4,0;;;;;1,0;7,0;;;5,0;;;;;;30,0;;4,0;;;;3,0;;;;;3,0;;2,0;;;;;;;13,0;2,0;;;4,0;;;4,0;1,0;;;7,0;;;4,0;5,0;6,0;;;3,0;;4,0;2,0;;;;;;1,0;1,0;12,0;;;;;6,0;2,0;16,0;1,0;1,0;;;;;;;;;6,0;2,0;21,0;11,0;2,0;;1,0;4,0;;;11,0;10,0;;;47,0;;11,0;;1,0;2,0;;;19,0;48,0;;;;;;;;;;;;;14,0;;4,0;;;2,0;;;7,0;;;;;;;1,0;6,0;4,0;;7,0;14,0;;2,0;;1,0;1,0;;;1,0;;;;1,0;1,0;;;;1,0;6,0;;;6,0;2,0;20,0;;;1,0;1,0;3,0;1,0;1,0;;;;1,0;;1,0;;;;3,0;6,0;2,0;;;;30,0;6,0;;1,0;2,0;;;;6,0;;3,0;;3,0;9,0;;;6,0;;5,0;22,0;;11,0;;;;;3,0;;;4,0;;;;42,0;3,0;;;;;;;20,0;;7,0;2,0;;50,0;;34,0;;;;;;2,0;;;2,0;10,0;4,0;1,0;;;;;;;;;2,0;;;12,0;;;;;;;;;;;;;2,0;5,0;;;;;2,0;;;;;;;;;;;;1,0;;;;2,0;13,0;;;;;;;;;;;;;;2,0;149,0;;;;;;;1,0;13,0;;;;;;198,0;;;;78,0;;1,0;;;;2,0;1,0;;;;;2,0;;;;178,0;;;;;4,0;1,0;;;;;;;;;;;;;;1,0;;;3,0;;1,0;;1,0;;;;;;1,0;;;;3,0;;;;;;1,0;;;;;;;;;;;;;;;;
zone;;;;16,0;1,0;9,0;15,0;5,0;;;;;;2,0;;1,0;15,0;;;;;;;;1,0;;;2,0;4,0;4,0;15,0;8,0;;;;15,0;53,0;;17,0;;38,0;46,0;;;27,0;2,0;;2,0;4,0;;;;7,0;;39,0;2,0;8,0;;;8,0;;;;;229,0;;40,0;;;;11,0;1,0;18,0;;;6,0;1,0;1,0;1,0;;40,0;2,0;1,0;;15,0;;;43,0;;1,0;8,0;8,0;1,0;6,0;;;106,0;7,0;59,0;3,0;85,0;2,0;;7,0;3,0;9,0;4,0;;;;;9,0;3,0;3,0;;;;6,0;14,0;63,0;;1,0;4,0;2,0;;;41,0;;;;6,0;;1,0;16,0;;2,0;31,0;20,0;10,0;;2,0;8,0;;;10,0;4,0;33,0;13,0;29,0;;;;2,0;3,0;;;;;;;;5,0;;;;;;1,0;3,0;169,0;5,0;;3,0;14,0;;13,0;;;2,0;;;;;3,0;;;4,0;;4,0;;;;5,0;;;5,0;3,0;2,0;9,0;;;5,0;;;5,0;7,0;3,0;;;52,0;5,0;7,0;4,0;;;19,0;;;;3,0;3,0;2,0;3,0;;;;28,0;;;;;;7,0;;2,0;7,0;10,0;3,0;;;;;;;;46,0;;3,0;17,0;;;;;;3,0;;2,0;10,0;31,0;;6,0;;;7,0;;5,0;3,0;4,0;;12,0;;2,0;1,0;;;;7,0;16,0;;;;34,0;5,0;11,0;69,0;;;;6,0;7,0;3,0;1,0;;;3,0;;16,0;;;;;;;;;;8,0;;8,0;4,0;;;12,0;;2,0;;29,0;2,0;;;;74,0;2,0;59,0;3,0;2,0;;;;;;;4,0;;1,0;;;;8,0;;1,0;;;;;3,0;;2,0;;;1,0;;;10,0;;;;3,0;30,0;1,0;;;;7,0;1,0;3,0;;;;3,0;;;8,0;22,0;15,0;6,0;;5,0;4,0;;11,0;5,0;;;;25,0;2,0;;;;3,0;2,0;10,0;17,0;;;1,0;8,0;25,0;;;4,0;1,0;4,0;;4,0;;17,0;9,0;1,0;;;;1,0;2,0;4,0;;;;;;4,0;;;3,0;13,0;;1,0;3,0;;49,0;;21,0;;;;2,0;32,0;;;;;1,0;;;3,0;;;38,0;;;1,0;;;3,0;;;;;1,0;5,0;;1,0;1,0;;;;;1,0;;;5,0;1,0;3,0;;;;;;;7,0;;4,0;1,0;;;1,0;1,0;;;;5,0;;;;5,0;5,0;;4,0;;1,0;;;4,0;;1,0;;;;;4,0;15,0;;;;;;3,0;;;;1,0;1,0;1,0;;;;2,0;;;;37,0;;1,0;8,0;3,0;2,0;1,0;3,0;;;;;;6,0;15,0;;;;;;;2,0;;;;;;;;;;1,0;2,0;6,0;;1,0;;1,0;;;;;;1,0;;;;10,0;;;;;;;4,0;;;;;;;;;1,0;;;3,0;;;2,0;;;;;;;;;;;;;;;;;2,0;4,0;2,0;;;;12,0;;;2,0;;;1,0;;;;;;;;;;;;;;;;;;;;;;;;;;3,0;;;;;;;;;;;;;;;;;;;;;;;6,0;;;;;2,0;;16,0;;;;;;5,0;;;;;;;;;;;14,0;2,0;1,0;;;;6,0;;;;;;;17,0;;;;;;;;;;;;;;;;8,0;;;;;;;;;;;4,0;;;;;;1,0;;;;;;;;;;;;;;;1,0;;;;;;;3,0;;;;;;;;;;;;;;4,0;;;7,0;;;;;;;;;;;;;;;;;;;;;;;;;;;;;;;;;;;;;;;;1,0;4,0;;17,0;;1,0;;;;;;;;1,0;;;;;;;;;;1,0;2,0;;;;;11,0;;;2,0;;;;2,0;;;;;1,0;;;;;12,0;;;;;;3,0;;;;;;;;3,0;2,0;;;;;;;;;2,0;;;;;;;;;;;;;;18,0;;;;;1,0;;;;;;;;;;;;;2,0;;;;;;;4,0;;;;;;;;1,0;;;;;;;;;;;29,0;;;;;;6,0;;;;;2,0;;;1,0;;;;;;;;;;;;;;;3,0;;;;4,0;;;;;5,0;;;;;;
accelerometer;;;;;1,0;14,0;4,0;3,0;;;;;1,0;28,0;;;25,0;;;;;;;;;;;1,0;3,0;6,0;24,0;2,0;;;;67,0;;3,0;;;18,0;53,0;;6,0;6,0;1,0;;2,0;;;;;1,0;3,0;;;;;;6,0;;;7,0;3,0;16,0;;42,0;;;;2,0;16,0;3,0;;;;;26,0;;15,0;22,0;;;;11,0;;;4,0;;1,0;1,0;;;;;;;;10,0;;16,0;13,0;;;3,0;19,0;;2,0;;2,0;;3,0;;;;2,0;;;;80,0;3,0;;12,0;;;3,0;35,0;;;;9,0;;;6,0;;;2,0;;;;;;;;;;;;10,0;4,0;1,0;;8,0;;;;;;;;1,0;3,0;;;;;10,0;2,0;;1,0;4,0;;1,0;10,0;;;;;2,0;;;2,0;;;;;1,0;17,0;5,0;;;;1,0;;1,0;;;;;;;;;;11,0;1,0;;;6,0;3,0;;8,0;3,0;;;;1,0;1,0;;;;;;;;;12,0;1,0;;6,0;;;;;;;;;;2,0;;;;;;3,0;;;;;;;;;;;1,0;4,0;;;;3,0;;9,0;;1,0;;;1,0;;;;;;;;1,0;10,0;;;;;11,0;;;;;;;;;;;;;;;2,0;;;;;;;;;4,0;1,0;;4,0;;;;;;;;4,0;;1,0;15,0;;;;;;;;3,0;;;;;;;;;;;;;2,0;;;;;;;;;;;;;;;;;16,0;;;13,0;;1,0;4,0;;7,0;3,0;;;;;6,0;2,0;3,0;;15,0;;;;4,0;;;2,0;;32,0;1,0;;;2,0;7,0;1,0;;2,0;;;;2,0;7,0;;6,0;14,0;6,0;;;2,0;;2,0;47,0;;;;;;;37,0;;12,0;;;1,0;;;15,0;;11,0;2,0;;6,0;8,0;6,0;;;;2,0;;;;;;1,0;;10,0;4,0;;2,0;;1,0;3,0;;1,0;;4,0;1,0;2,0;1,0;7,0;2,0;1,0;2,0;7,0;5,0;3,0;1,0;6,0;3,0;1,0;1,0;1,0;1,0;2,0;1,0;3,0;1,0;5,0;1,0;1,0;1,0;1,0;2,0;3,0;2,0;6,0;1,0;1,0;2,0;7,0;1,0;1,0;3,0;2,0;1,0;4,0;2,0;2,0;2,0;4,0;4,0;1,0;2,0;1,0;1,0;2,0;4,0;1,0;3,0;1,0;4,0;;;;;;;;;;;;;;;;;;;;;;;;;;;;;;;;;;;;;;;;;;;;;;;;;;;;;;;;;;;;;;;;;;;;;;;;;;;;;;;;;;;;;;;;;;;;;;;;;;;;;;;;;;;;;;;;;;;;;;;;;;;;;;;;;;;;;;;;;;;;;;;;;;;;;;;;;;;;;;;;;;;;;;;;;;;;;;;;;;;;;;;;;;;;;;;;;;;;;;;;;;;;;;;;;;;;;;;;;;;;;;;;;;;;;;;;;;;;;;;;;;;;;;;;;;;;;;;;;;;;;;;;;;;;;;;;;;;;;;;;;;;;;;;;;;;;;;;;;;;;;;;;;;;;;;;;;;;;;;;;;;;;;;;;;;;;;;;;;;;;;;;;;;;;;;;;;;;;;;;;;;;;;;;;;;;;;;;;;;;;;;;;;;;;;;;;;;;;;;;;;;;;;;;;;;;;;;;;;;;;;;;;;;;;;;;;;;;;;;;;;;;;;;;;;;;;;;;;;;;;;;;;;;;;;;;;;;;;;;;;;;;;;;;;;;;;
accumulate;;;;;21,0;2,0;;;;;;;;14,0;;43,0;5,0;;;;;;;1,0;1,0;;;2,0;;;27,0;;;;;12,0;;;;;8,0;9,0;;1,0;2,0;;;8,0;;13,0;;;;2,0;6,0;;2,0;;;33,0;;;;;50,0;;18,0;;6,0;;;5,0;14,0;1,0;;;2,0;;;14,0;5,0;;;1,0;5,0;;;4,0;;;6,0;2,0;;;;;30,0;;20,0;4,0;3,0;12,0;;;2,0;;;;;;;3,0;38,0;;;;;6,0;;9,0;1,0;;94,0;;;8,0;3,0;;;;11,0;;;36,0;;;3,0;4,0;;;;;;;;1,0;19,0;2,0;;;;;;;;140,0;;;;;;;;3,0;2,0;;1,0;2,0;;9,0;2,0;;;3,0;;3,0;11,0;;;;5,0;;;;;2,0;;;17,0;;;;;3,0;;2,0;;4,0;;;;2,0;;3,0;1,0;;;;;;;8,0;1,0;;;1,0;13,0;2,0;;10,0;6,0;1,0;;41,0;;;4,0;;2,0;;;;;;;;;;;;;;;;;;;;;;;;;;;;;1,0;;;28,0;1,0;7,0;;;;;;;;;;;;;;;;;;;;;;;;31,0;;2,0;;2,0;;;;;;4,0;;;;;;;1,0;;;;;;;;;;;;;7,0;;;;;11,0;;;;;2,0;;;;;;;;;;;;;;;;;;;;;2,0;;;;;3,0;;9,0;;8,0;;;;;;;;;1,0;;;;1,0;;;5,0;;;1,0;;1,0;;;9,0;3,0;5,0;;;6,0;;12,0;;3,0;;2,0;;;;2,0;;3,0;;3,0;;10,0;;3,0;;3,0;;;2,0;;;7,0;;;2,0;;;;;2,0;3,0;;;1,0;;4,0;;5,0;;;;;;;;;1,0;;;;;;1,0;;;;;;;;;20,0;;;;;;1,0;;;5,0;;3,0;;;;;;;;;;;;;;;;;;;;;;;;8,0;;;;;;;;;1,0;;;;;;;;;;1,0;;;;;;;;;;;;2,0;;;;1,0;;;;;;;;;;;;7,0;1,0;;6,0;;;;;2,0;;;;;;;;;;;;;6,0;;;;;5,0;;;;;;;;;;3,0;;;;;;3,0;;;;;;8,0;;1,0;;;;;;;;;;;;;;3,0;1,0;;;;;4,0;;;;;;4,0;;;;;;;;9,0;;;;;;;;;;;;;;;;2,0;;;;;;;;;;;10,0;;;;;;7,0;;;;1,0;;;1,0;17,0;;;;1,0;;1,0;;;;;;;;;;;;;;7,0;;;;;;;;;;;;;;5,0;;;;;;;;2,0;;;1,0;2,0;;;;;2,0;;;;;;;;;1,0;1,0;;;;;;;;;;;;;;;;;;;;;;;;;;;;;4,0;;1,0;;;;;;;;;;;;;;;;;;;;;;;;;;;;1,0;;;;;;;3,0;;;;25,0;6,0;2,0;2,0;5,0;1,0;5,0;28,0;3,0;2,0;1,0;5,0;1,0;4,0;7,0;2,0;7,0;4,0;5,0;1,0;1,0;4,0;3,0;1,0;5,0;12,0;4,0;10,0;1,0;1,0;1,0;1,0;1,0;3,0;4,0;;;;;;;;;;;;;;;;;;;;;;;;;;;;;;;;;;;;;;;;;;;;;;;;;;;;;;;;;;;;;;;;;;;;;;;;;;;;;;;;;;;;;;;;;;;;;;;;;;;;;;;;;;;;;;;;;;;;;;;;;;;;;;;;;;;;;;;;;;;;;;;;;;;;;;;;;;;;;;;;;;;;;;;;;;;;;;;;
accumulation;;;;;10,0;5,0;;;;;;;;;;;;2,0;;;;;;;;;;;5,0;;4,0;;;;;7,0;;;4,0;;6,0;6,0;;;7,0;;;5,0;;;;;;;5,0;;47,0;;;7,0;;;;;102,0;;18,0;;;;1,0;1,0;4,0;;;1,0;2,0;;;;38,0;;2,0;;2,0;;;2,0;2,0;;;;;;;;47,0;;26,0;;10,0;10,0;;;3,0;1,0;;;;;;;188,0;;;;;;;15,0;;;8,0;;;;13,0;;;;63,0;;;53,0;;;5,0;;;;;4,0;;;;;;26,0;1,0;;;;;;3,0;185,0;;;;;;3,0;;4,0;6,0;;;1,0;;1,0;1,0;;;13,0;;;5,0;;;;;;;;;2,0;;;;;;;;1,0;;;;3,0;;;;1,0;;;;4,0;;;;;;;;;1,0;;12,0;;1,0;;2,0;5,0;;13,0;;;27,0;;1,0;;;;2,0;;;;;;;;;;;;;;;;4,0;;;;;2,0;6,0;2,0;;11,0;;;21,0;;24,0;;3,0;;;;8,0;1,0;;;;;;;;;;;;;;;;;;;;;;;;;;;;;;;;;;;;;;;;3,0;;;;;;;;;;;;;5,0;1,0;;;;;1,0;;;;;;5,0;;;;;;;;;;;;;;;;;;;;;;;15,0;;;;;;;;;;;;;;;3,0;;2,0;;;;;;55,0;;;;;;;;;;;;;;;;;;1,0;;;;;18,0;;;;;5,0;;;;;;1,0;;;;;;;;;;4,0;;;15,0;;;;;;;;;;;;;1,0;;28,0;;;7,0;;;;;;7,0;;;;;;;;;20,0;;;;;;;;;;;;;;;5,0;;;;;;;;;;;;;;;;;;;;;1,0;;;;;;;;;;;;;;;;;;;;;;;;;;;;;;;;;;;;;;;;2,0;;;;;;;6,0;;;;;;;;;;;;;;;;;;8,0;;;;;;;;;;;;;;;;;;;;;;;;;;;;;;;;33,0;;;;;;;147,0;;;;;;;;6,0;8,0;;;;;;;;;;;;;;;;;;;;;;;;;;;;;;;;;;;4,0;;;;;;;;;;;;;1,0;;;;;;;1,0;;;;;;11,0;;;;;;;;46,0;;1,0;;;;;;;;;;;;;;;2,0;;;;;13,0;;1,0;;;;;;;;;;1,0;;;;;;;;;;;;;;;;;;;;;;;;;;;;;;;;;;;;;;;;;;;;;;;;;;;;;;;;;;;;;;;;;;;;;;;;;;;;25,0;;;;;;;25,0;11,0;;2,0;;;;8,0;131,0;;;5,0;;;;;;2,0;;;;30,0;;;;;;;;1,0;3,0;9,0;2,0;3,0;2,0;10,0;3,0;;;;;;;;;;;;;;;;;;;;;;;;;;;;;;;;;;;;;;;;;;;;;;;;;;;;;;;;;;;;;;;;;;;;;;;;;;;;;;;;;;;;;;;;;;;;;;;;;;;;;;;;;;;;;;;;;;;;;;;;;;;;;;;;;;;;;;;;;;;;;;;;;;;;;;;;;;;;;;;;;;;;;;;;
amplify;;;;;1,0;5,0;3,0;;;;;;;8,0;;;3,0;3,0;;;2,0;;;;;2,0;;1,0;;;49,0;3,0;7,0;15,0;1,0;6,0;;;1,0;2,0;;19,0;;9,0;2,0;;;24,0;;;;;;8,0;;;1,0;;17,0;14,0;;;;;24,0;;33,0;;;;;4,0;4,0;;;1,0;3,0;;;2,0;6,0;;2,0;;2,0;;1,0;1,0;;;;;;;;;57,0;;23,0;;3,0;;;;;3,0;;;;;;13,0;2,0;;;;;4,0;;13,0;1,0;;172,0;;;;13,0;;9,0;;8,0;;;35,0;;;;;;;;4,0;;;1,0;;;;;;;;;;;10,0;;;;;;33,0;;7,0;1,0;;5,0;;;9,0;;;;;;;7,0;;;;4,0;;;;;;5,0;;5,0;;;;;4,0;;;1,0;;;;;1,0;;;;;7,0;;;;1,0;3,0;;;;2,0;22,0;;;;;;;4,0;;;25,0;;;;;;2,0;;1,0;;;;;;;;;;;;;;5,0;;;;29,0;;1,0;6,0;;;3,0;;4,0;12,0;;;;;3,0;2,0;;;;6,0;14,0;;;;;;4,0;;;;4,0;;;;5,0;;49,0;;;1,0;;;;;;5,0;;;;;;;;;;;;7,0;;;;;;2,0;;;;;2,0;;;;;;5,0;;2,0;;;;;;;;;3,0;;;;;;;;;;2,0;;;;;2,0;;;;;;1,0;2,0;;;;;2,0;2,0;;;;;;;;;2,0;;;;1,0;1,0;6,0;;;;;1,0;;;;;;;;2,0;;;;;;;;8,0;2,0;6,0;2,0;;;;2,0;2,0;;;;;1,0;1,0;;;;;;;;6,0;;5,0;;1,0;;;1,0;;13,0;1,0;;;;;;;;12,0;9,0;;;;;;;;;32,0;;;;;1,0;;1,0;;;;;;;;;;;;;;;;;;1,0;;;;;;;;;;;;;;14,0;;;;;;;;;;;1,0;;;;8,0;;;;;1,0;;;;;;;;;;1,0;;;;;;;;;;;;;;;;;;;;;;;;;;;;;;;;;;;7,0;;;;;;;;;;;;;;;;;;;;;;;;;;;2,0;;;;;;;;;;4,0;;;;;;;;;;;;;;;;47,0;22,0;1,0;1,0;;;;;;;;;;;;;;;;;;;1,0;;;1,0;;;1,0;;;1,0;;;;;9,0;;;;;;;;;;2,0;;;;;;;;;8,0;;;;;;;20,0;;;;;;;;1,0;;;;;;;;;;;;;;;;;;;;;;3,0;;;;2,0;;;;;;;;;;;;;;;;;;;;;;;;;;;;;;;;;;;;2,0;;;;;;;;;;;;;;;;8,0;;;;;;;;;;;;;;;;;;;;;;;;;;;;;2,0;;;2,0;;43,0;;2,0;3,0;;;5,0;;;;;9,0;5,0;;1,0;;;;;2,0;2,0;;;;11,0;;1,0;;;;;;;;6,0;;;;1,0;;3,0;78,0;;;;;;;;;3,0;;;;;;;;;;;;;;;3,0;;;;2,0;;;;;;;;;;1,0;;;;;;;;;;;;;;;;;;;;;;;1,0;;;;;;;;;;;;;;;;;;;;;;;;;;;;;;3,0;;;;;5,0;3,0;;;;;;;;;28,0;;2,0;;19,0;;;;;;;;;;;;;;;;;;;;;5,0;;;;;;;;;;;;;;;;;;;;;;;;;;;;;;;;;;;;;
candidate;;;;;5,0;2,0;;2,0;3,0;12,0;;;;52,0;;9,0;11,0;;;4,0;;;11,0;;;;9,0;4,0;3,0;7,0;10,0;1,0;;;;23,0;2,0;;4,0;;74,0;8,0;;;12,0;;2,0;;;4,0;8,0;;;;4,0;6,0;;;;11,0;;2,0;70,0;;204,0;;19,0;;;3,0;16,0;4,0;;;;;;;;;42,0;;2,0;23,0;;;;;;1,0;3,0;;;;;;24,0;6,0;144,0;29,0;18,0;9,0;;1,0;4,0;16,0;;;17,0;;;17,0;135,0;2,0;;;;13,0;;2,0;36,0;;;5,0;3,0;7,0;11,0;;2,0;;;;;;;;3,0;5,0;;;2,0;9,0;;;;5,0;30,0;;11,0;;;32,0;;;;;;;;;;;7,0;;;;;;;1,0;2,0;;;5,0;;51,0;;;;;;;;;;;2,0;;62,0;;;;;;;;;;;;;;;;4,0;4,0;;;;;8,0;;;;;;2,0;;;57,0;6,0;;;;;;2,0;;;1,0;;;4,0;;;;1,0;;;2,0;;;;;;67,0;;2,0;;;;;;;;;;;;;;;;63,0;;;;;8,0;6,0;;;;4,0;;;;;;;;;;;;;;;;;;;;;;;8,0;;;;;;;;;;;;2,0;;;;;;;;8,0;;;;;121,0;;3,0;;;;;;3,0;;;;;2,0;;;;;;3,0;;;;;1,0;;2,0;;;;;76,0;;22,0;;;;14,0;;69,0;;;;;;;;;;;;9,0;6,0;1,0;2,0;1,0;;12,0;1,0;3,0;7,0;;1,0;;48,0;;7,0;;10,0;4,0;;18,0;4,0;3,0;4,0;1,0;55,0;6,0;4,0;;10,0;;11,0;;11,0;;;1,0;;;;6,0;;;1,0;;;;;;;;;;1,0;;23,0;;;;;5,0;4,0;;;2,0;3,0;5,0;;;;25,0;;;1,0;5,0;;9,0;;1,0;;;;;;;3,0;;2,0;8,0;;;3,0;;;;;;;;;2,0;;;;;;;10,0;;;;;;;3,0;;;35,0;2,0;;8,0;;;17,0;9,0;;;;;;;;2,0;2,0;;;;8,0;;13,0;;;7,0;;;6,0;;;1,0;;;;1,0;;;;;;;;;6,0;;;;;;24,0;;4,0;;;2,0;1,0;;;;;;;;;;14,0;;1,0;;;;;1,0;;3,0;;1,0;;;;;;;;3,0;57,0;;1,0;;;;;;;;;;;55,0;;;2,0;;1,0;;;;;3,0;;;;;4,0;;;3,0;;6,0;;;;13,0;;;;;1,0;45,0;;;;;3,0;;;;;;;;1,0;;4,0;;;;;;3,0;;;;;;;1,0;;;;;;3,0;;;2,0;;;27,0;8,0;;;;3,0;;;;;;;4,0;;;;;2,0;;;46,0;;;;;;;2,0;;;;;;;;;;;;;;;;;;1,0;;;;;;;;6,0;;;;;;;;5,0;;;;;;2,0;;;;;;;;3,0;6,0;;;;6,0;;7,0;;6,0;;;;;;;;;;;;;;;;;;;;;;;;;;;;;;2,0;;;;;;;;;;;;;;1,0;4,0;;;;;;;;;;;1,0;;;;;11,0;;5,0;;;19,0;;;;;;;11,0;;;;2,0;;4,0;;;;;2,0;;;;;;3,0;;68,0;;;;;;;;;15,0;;;;;;;;2,0;;;;;;;;;11,0;;;;;;;;;;3,0;2,0;;;3,0;;;;;;;;;;;24,0;;;;;;;;;;;1,0;;;;;;2,0;;2,0;;;;;;;;;1,0;;;;;;;;;;;;1,0;;6,0;;;;;;;;;;;;;;;;;;;;;;;9,0;;;;2,0;2,0;;;;;;3,0;;;;;;;;;7,0;;;;;;;;;;;;;1,0;;17,0;;;18,0;;;;;;2,0;;;;;
chamber;;;;;21,0;3,0;1,0;2,0;;;;;;17,0;;;9,0;;;;;;;2,0;8,0;;;;;;31,0;3,0;;;;;21,0;;2,0;;;11,0;;3,0;;20,0;;13,0;;;;7,0;6,0;2,0;;2,0;23,0;;;3,0;;;;;15,0;;11,0;1,0;;;;42,0;21,0;;;;2,0;;;;4,0;;1,0;;;5,0;;5,0;;1,0;;;;;;;5,0;2,0;26,0;;18,0;;;;1,0;;;;;;;;6,0;;;;;16,0;;15,0;2,0;;2,0;1,0;;;11,0;;;;;;;9,0;;;9,0;;;;;;;;2,0;;3,0;9,0;;;;;8,0;4,0;;;;;;;1,0;4,0;;;;;8,0;17,0;;;;;10,0;5,0;;1,0;;1,0;;;;;;1,0;;1,0;4,0;;8,0;1,0;;;;2,0;;4,0;34,0;;23,0;5,0;;;1,0;8,0;1,0;;12,0;;1,0;2,0;2,0;;;;1,0;2,0;;;;;13,0;;;;21,0;;16,0;;2,0;;4,0;1,0;;;1,0;;;;;;;;7,0;;3,0;;7,0;2,0;8,0;;;2,0;3,0;2,0;1,0;;4,0;14,0;;;;;;3,0;13,0;;;;;7,0;;;;;;;4,0;;1,0;;6,0;;;4,0;;;6,0;;1,0;3,0;;1,0;;;1,0;1,0;1,0;1,0;;1,0;;;;;;1,0;;1,0;;6,0;;;5,0;1,0;;;5,0;;9,0;;;2,0;;;;;;;;;1,0;;;2,0;;;;1,0;;;;;;;;2,0;;4,0;;2,0;;;;;;;;;2,0;;;;;;;;;;;;7,0;;;2,0;2,0;;;;;;5,0;;;;;5,0;;;;;;;;;;;;;;;;;1,0;;1,0;;;;;;;;1,0;;1,0;;;;;;;;1,0;;;49,0;;4,0;;;;;;3,0;1,0;;26,0;;;;;;;;;;;;;;;;;;1,0;17,0;;2,0;;;;;;;;;;;;;;;;;11,0;;;;;;;;4,0;;;;;;;;;;;1,0;1,0;;;;;;;;;;;;;;;;;;4,0;;;;2,0;7,0;;;1,0;1,0;4,0;;;;;2,0;65,0;;;;;;;;;;;;;;;16,0;;;;;2,0;;;;;;;;;;;;;;;;;;;;;;;;;;;;;9,0;6,0;;;;4,0;;;2,0;;;;5,0;;;;;8,0;;;1,0;;;;;;;;;1,0;;;;;;;;;;;;;;;;1,0;;;;;;;;;;;;;;;;;;;;;;;;;;;;;;;;;6,0;;;3,0;;;;;;1,0;;;;;;5,0;;2,0;;;;;;;;;;;;;2,0;;;9,0;;1,0;;;;1,0;1,0;;;;;;;2,0;1,0;5,0;;;2,0;;;;;;;;5,0;;;;;;;;;;;2,0;;3,0;;;;;;8,0;;;;;1,0;;;;;;;;;;;29,0;;;;;;;;;;;;;;1,0;;;;;;;;1,0;2,0;;;2,0;;9,0;3,0;;;;;;;;;;;;;;;;;;;;;;;;;;;;;;;;;;;;;;;;;;;;;;;1,0;2,0;;;;;;;;;;;;;;;;;;;;;;;;;;;;;;;;;;1,0;1,0;;;;4,0;;;;;;;;;;;;;;;;;;;;;;;;;;;;1,0;;;;;;;;;;;;;;;;;;;;;;;;;;;;;;;;;;;;;;;1,0;;;;;;;;;;;;;3,0;;;;;;;;;;;1,0;;;3,0;;;;;2,0;1,0;;;;;;;;;;;;;;;;;;;;;;;;;;;;;;;;;
column;;;;;2,0;6,0;112,0;2,0;;;;;;21,0;4,0;18,0;3,0;8,0;;;2,0;;21,0;;;;;4,0;;;55,0;5,0;;1,0;;17,0;1,0;3,0;8,0;;29,0;44,0;;6,0;2,0;21,0;;23,0;;;1,0;;21,0;;1,0;19,0;45,0;;;11,0;;1,0;11,0;;197,0;;124,0;;4,0;;2,0;4,0;11,0;;;1,0;;;;3,0;23,0;1,0;;;1,0;2,0;4,0;27,0;;1,0;;4,0;4,0;;;;674,0;23,0;269,0;25,0;50,0;3,0;9,0;10,0;101,0;4,0;;;;;;10,0;32,0;4,0;;;;21,0;4,0;70,0;;;293,0;;;;29,0;;;;26,0;8,0;;134,0;;2,0;12,0;10,0;;;;29,0;;;5,0;;15,0;123,0;8,0;2,0;;18,0;;11,0;;7,0;;;;;2,0;40,0;;8,0;41,0;3,0;6,0;10,0;;;13,0;;2,0;110,0;;8,0;;;1,0;;;4,0;18,0;4,0;2,0;;6,0;;18,0;7,0;;;2,0;4,0;;;8,0;;1,0;;;2,0;;;;;3,0;;;3,0;;;11,0;4,0;2,0;4,0;33,0;31,0;;2,0;16,0;4,0;;11,0;;;15,0;;;;;;80,0;;;;;;;10,0;;;;;;9,0;5,0;;37,0;2,0;;;8,0;;20,0;7,0;10,0;3,0;;;21,0;3,0;3,0;6,0;3,0;;;;;;;20,0;;;;;;3,0;13,0;7,0;;;17,0;;;;;;77,0;1,0;2,0;;;;1,0;;3,0;2,0;;;;;;;;;;;8,0;42,0;;;;;62,0;;18,0;3,0;;4,0;2,0;2,0;;;;;;;1,0;;;;;;1,0;4,0;;;;;;;;;;2,0;1,0;14,0;;;;;10,0;;;1,0;;10,0;;;;;;;;;;;;;;;5,0;15,0;4,0;;;;22,0;8,0;17,0;11,0;;;;4,0;1,0;2,0;;2,0;2,0;;;;3,0;8,0;;5,0;16,0;;;26,0;2,0;15,0;;14,0;;;;;;1,0;16,0;8,0;13,0;2,0;1,0;;;;;2,0;;47,0;;9,0;;1,0;;;6,0;;2,0;;;12,0;;;11,0;;;10,0;13,0;;;1,0;;;;;;4,0;;11,0;;;;6,0;;;;;11,0;;;;;;;;;;;1,0;;;;1,0;;;;;;10,0;;;8,0;;;;;;;3,0;5,0;;;;2,0;;;;2,0;4,0;6,0;60,0;;;;;;2,0;;;;6,0;;1,0;5,0;;4,0;;1,0;;;;;;;;;;;;21,0;;1,0;11,0;;2,0;;;;2,0;;;;17,0;;;;1,0;;;;5,0;;;;;;24,0;;;2,0;;;;;;;;2,0;;6,0;;;;;;;6,0;2,0;;;;;;7,0;;;;2,0;3,0;;;;;;;1,0;;;1,0;;;;;;10,0;;;;;;;;;;1,0;;;;;;;;;;;;;;;;;;;3,0;;;;;;5,0;;;;;;9,0;;1,0;;;1,0;;;1,0;;;;;11,0;;;;;;;10,0;;;;;1,0;;;5,0;;;;;;;2,0;;;;;;;12,0;6,0;;2,0;;;;;;2,0;5,0;4,0;2,0;2,0;;;;;;9,0;;;;;;;;;;;;;;4,0;;;;;;;;1,0;8,0;;;;13,0;;;;;6,0;2,0;2,0;;;;;;;;;;;;;2,0;;2,0;;;;;;;;;;;;17,0;1,0;;;2,0;;;;4,0;;;3,0;;;;4,0;;1,0;13,0;6,0;4,0;21,0;20,0;;21,0;21,0;;1,0;;1,0;8,0;7,0;1,0;2,0;;2,0;;24,0;3,0;;;19,0;;;5,0;;;;;;;;;;3,0;38,0;;4,0;;13,0;;;;;;;;;;;;;;;;;;;;;;;2,0;3,0;3,0;;;;;1,0;;;;;10,0;;8,0;;;;;17,0;;;;1,0;;;2,0;;;;;;;;;;;;;;;;;;;;;;;;11,0;;;;;;;;;;;;;;;;;;;;;;;14,0;4,0;;;;;;;;;;;;;7,0;1,0;3,0;;;;;;;;;;;;;;;;;;;;;;;2,0;2,0;;;;2,0;;;;;;2,0;;;;;;;;;;;;;;;;;;;;;;
compound;;;;;1,0;1,0;1,0;15,0;;;;;;3,0;;;;7,0;1,0;;;;;;;;;14,0;;2,0;2,0;;;;2,0;2,0;1,0;1,0;;;1,0;3,0;5,0;;;15,0;;5,0;;;;;2,0;;3,0;11,0;52,0;;;2,0;1,0;;42,0;;17,0;;22,0;;;;7,0;68,0;;;;;7,0;;;;5,0;;;;7,0;;;30,0;;;;2,0;;7,0;;;6,0;1,0;3,0;19,0;2,0;;;;;;;;;;;5,0;31,0;;;;;;;15,0;;;;;;;3,0;;;2,0;12,0;;;;;;10,0;;;19,0;;;;;;;10,0;9,0;1,0;2,0;;;;;;;;2,0;69,0;;;1,0;14,0;;;;3,0;17,0;;;;;;1,0;3,0;;;;;;;;3,0;2,0;;19,0;33,0;;;10,0;;;;;;1,0;5,0;;;2,0;6,0;56,0;;;;;4,0;36,0;;6,0;;;;;;;3,0;;28,0;;;;;2,0;;2,0;2,0;;;;;2,0;16,0;1,0;2,0;;;;;68,0;13,0;3,0;;;2,0;20,0;;;10,0;;;2,0;;29,0;23,0;;;25,0;;2,0;3,0;;;;;;2,0;25,0;9,0;;;3,0;;;;;;;;;;;;7,0;;;1,0;;3,0;;;;;;;;;;;;;;2,0;;;2,0;;;;;;;;;;1,0;;;;;;1,0;1,0;2,0;;;;;;;;;1,0;;;;;;;;;1,0;;;;;;1,0;;2,0;1,0;;1,0;;;;;2,0;3,0;;;;;;;;;1,0;;;;;;;;;;;;3,0;;19,0;;6,0;;3,0;;3,0;;;6,0;;;;2,0;3,0;;;;;;;;;;;;;1,0;;;;;1,0;;1,0;;;;;;;;;;;;;;;;;;;;;;;;;;;;;;;;;2,0;;;;;;;;;;;1,0;;13,0;;;;;;;;;;;;;;;;3,0;;;1,0;;;;;;;;;5,0;;;;;;;;;;;;;;;;;;;;;;4,0;;;4,0;;;;;;;;;;;;1,0;;;;;;;;1,0;;;;;3,0;;;;18,0;;;;;;;;;;;;;;;;;;;;;;;;;;;;;;;;;;;;;2,0;;;;;;;;;;;;;;;;;;;;;;;3,0;;;;;;;;;3,0;;;;;;;;;;;;;;;;;;;;;;;;;;2,0;;;;;;;;;;;;;;;;;;;1,0;;;;;;;;50,0;7,0;;;;;;;;;;;;8,0;;;;;;;;;;;;;;;;;4,0;;;;;;;;;;;;;;;;;;;;;;;;25,0;;;28,0;;;;;;;;;;;10,0;;;;;;;;;;;;;;;;;;;;;2,0;;;;1,0;;;;;;;;;;;;;;;;;;;;;;;;;;2,0;;;;;;;;;;;;2,0;;;;;;;;;;;;;;;;;;;;9,0;;;;;;;;;;6,0;;;;;;;;;;;;;;;;;;;;;;;;;;;;;;1,0;;;;;;;;;;;;;;;;4,0;;;;;;;;;;;;;;2,0;;;;;2,0;;;;;;;;;;;;;;1,0;4,0;;1,0;;;;;;1,0;;2,0;;;;;;;;;;;;2,0;;;;;1,0;;3,0;;;;;;;;;;;;;;;;;;;;;;;;;;;;;;;;;;;;;;;;;;;;;;;;;;;;;;;;;;;;;;;;
conductive;;;;;1,0;23,0;5,0;32,0;;;;1,0;38,0;38,0;;;3,0;3,0;1,0;;28,0;;;;9,0;;;50,0;;;33,0;2,0;;;;;9,0;;;;3,0;81,0;1,0;1,0;;97,0;;156,0;;;;;60,0;11,0;1,0;;178,0;;;17,0;38,0;;9,0;;67,0;;147,0;;5,0;9,0;;63,0;35,0;1,0;;;297,0;3,0;;1,0;44,0;;4,0;;207,0;;;31,0;4,0;1,0;;29,0;2,0;1,0;;;4,0;23,0;117,0;8,0;34,0;5,0;;5,0;3,0;14,0;;;6,0;;;;174,0;;4,0;;;37,0;;97,0;;;24,0;1,0;;;28,0;;4,0;13,0;;;152,0;64,0;1,0;2,0;8,0;;2,0;1,0;5,0;2,0;;;20,0;27,0;20,0;35,0;2,0;7,0;1,0;2,0;43,0;48,0;1,0;;1,0;22,0;5,0;;;228,0;;;;;102,0;40,0;;4,0;1,0;;4,0;19,0;;13,0;21,0;1,0;2,0;;;6,0;35,0;10,0;13,0;92,0;14,0;2,0;7,0;47,0;;;113,0;2,0;16,0;42,0;120,0;1,0;35,0;2,0;25,0;474,0;;3,0;;;298,0;31,0;;20,0;;;;;;67,0;11,0;10,0;;35,0;91,0;8,0;;1,0;28,0;23,0;269,0;6,0;1,0;4,0;11,0;1,0;1,0;;51,0;;;5,0;6,0;;8,0;10,0;;;1,0;3,0;28,0;29,0;78,0;;;10,0;14,0;65,0;88,0;18,0;49,0;190,0;5,0;18,0;12,0;18,0;29,0;11,0;5,0;;23,0;1,0;;2,0;1,0;69,0;16,0;7,0;1,0;2,0;1,0;;1,0;7,0;;;5,0;59,0;;1,0;22,0;19,0;110,0;;52,0;3,0;4,0;14,0;;;1,0;20,0;25,0;6,0;;1,0;39,0;1,0;;15,0;;;;23,0;;;5,0;;;;27,0;;4,0;;1,0;2,0;14,0;6,0;;3,0;8,0;;18,0;8,0;9,0;2,0;;5,0;;2,0;;;;;;;;;3,0;12,0;2,0;8,0;;18,0;;1,0;;6,0;10,0;3,0;;11,0;;2,0;;;1,0;;;;;;;;;;;7,0;3,0;;;;;;9,0;;;;;;;;;;;;;6,0;;4,0;;;;;;;3,0;15,0;1,0;;;3,0;;7,0;;4,0;;3,0;;1,0;;;;;;;2,0;;;26,0;;;;;10,0;;;;;;;;28,0;;6,0;119,0;;1,0;;;;;;;;6,0;;;6,0;;;;;1,0;;1,0;;2,0;;;;;;;;1,0;;;6,0;;2,0;7,0;;;4,0;;;2,0;5,0;;1,0;1,0;2,0;;;;;6,0;;1,0;;;;1,0;;;19,0;2,0;;;3,0;;1,0;;;2,0;;;2,0;4,0;;1,0;;22,0;33,0;84,0;2,0;4,0;;;3,0;;1,0;;;;;;;;2,0;;2,0;3,0;;1,0;;28,0;;;;;;;;1,0;;9,0;;;;;;;;1,0;6,0;30,0;;;;6,0;;;;;;41,0;2,0;1,0;;;6,0;43,0;;5,0;;18,0;5,0;5,0;11,0;;;;;;;;;;;3,0;;;;;;;4,0;;;3,0;;;;2,0;;51,0;;;;;;24,0;;;;;;;;;;;3,0;;;;;;;;1,0;;1,0;30,0;3,0;;5,0;;;;;;;;;;;1,0;;;;;;;;;12,0;5,0;;;;;6,0;;1,0;;;1,0;;;;;;;;3,0;1,0;;2,0;11,0;10,0;;2,0;7,0;2,0;;;111,0;2,0;;;;;1,0;;2,0;9,0;6,0;;4,0;;;;;;;;;;2,0;;;;;11,0;;;;;4,0;;;;;;;;;2,0;1,0;;7,0;;;;2,0;;5,0;;;;;;;2,0;1,0;;;;;3,0;1,0;14,0;6,0;;3,0;;;3,0;;;;;4,0;;;;;2,0;;63,0;2,0;;;;;166,0;;;1,0;;;;;;4,0;;5,0;3,0;4,0;;;;;86,0;;;;19,0;;1,0;;;;;;;;48,0;;;;;;;;2,0;;5,0;;;31,0;;18,0;;;;3,0;;2,0;1,0;;6,0;2,0;;;;;;;;;7,0;;;;;;2,0;;;20,0;;;;;;;;;;;;;;;1,0;;;;;1,0;;1,0;;;;;1,0;;;;3,0;27,0;7,0;;;;;;;;;1,0;;;;;20,0;;1,0;;1,0;;;3,0;22,0;;6,0;;;;1,0;;;;;;1,0;;13,0;;;1,0;;26,0;;;;9,0;;2,0;5,0;;;1,0;;5,0;;;;;;3,0;;2,0;;;;;;;2,0;;;17,0;;;;;;;;;8,0;1,0;;;;;;;;;;;;;;;;;;;;;;;;;;
constitute;;;;;1,0;4,0;4,0;2,0;;;;1,0;;3,0;1,0;1,0;;1,0;;;1,0;;2,0;;;;;;;1,0;1,0;;1,0;1,0;2,0;18,0;;;;;;6,0;8,0;6,0;2,0;;;60,0;;;2,0;;;;1,0;2,0;8,0;;;1,0;;1,0;22,0;;26,0;;5,0;;;;1,0;128,0;4,0;5,0;1,0;;10,0;;;7,0;1,0;3,0;;;10,0;1,0;;23,0;;2,0;1,0;;;;;;28,0;1,0;16,0;9,0;15,0;;2,0;;4,0;1,0;;;4,0;;;3,0;29,0;2,0;;;;11,0;;13,0;9,0;;9,0;1,0;;;17,0;;;4,0;;;;61,0;;;;;8,0;;;6,0;;;;;;6,0;;;;1,0;4,0;;;9,0;;2,0;15,0;6,0;5,0;14,0;;;;;1,0;;;;6,0;;;1,0;;2,0;;;1,0;;;;;;;2,0;4,0;;16,0;1,0;;;;3,0;6,0;1,0;1,0;;;1,0;2,0;10,0;1,0;;3,0;;20,0;1,0;;;;;;;;;10,0;1,0;;3,0;4,0;2,0;;4,0;;;15,0;;;1,0;;;;;6,0;;;;;4,0;4,0;5,0;;;;;;3,0;8,0;;;;;2,0;5,0;;13,0;7,0;;;;;9,0;;;;;;;;;7,0;1,0;1,0;;;2,0;2,0;1,0;2,0;;;1,0;8,0;2,0;2,0;;;28,0;;;;;;;;3,0;;6,0;;;;1,0;;;;;;;8,0;;;;;;;1,0;;;2,0;;8,0;;;;;;;13,0;2,0;;;;3,0;;;;;;;;;;;;;;5,0;;;;;;;;;;1,0;15,0;;;;;;;;;;;;;;7,0;;;;;;;;1,0;6,0;;;;2,0;;2,0;;;;;3,0;3,0;;;;8,0;;;;;;3,0;;;;1,0;;;;2,0;;;5,0;;;;;;;;;;;;;;;;;;;;;;;;;;;1,0;;;1,0;;;;;;;;;;;;;;;2,0;;;;;;;;;;;;;;2,0;;;;;;;4,0;;;;;;;;;;;;;;;;;;;;;;;;;8,0;;;;;3,0;1,0;;;;;;;;2,0;;;;;;;;;;;;;;;9,0;;;;;;;;;1,0;;1,0;;;;;;;;;;;;;;;;;;;;;;;;;;;;1,0;;;;;;;;;;;;;;;;;;;;;;;;;;;;;;;;;;;;;;2,0;;1,0;;;;;;;;;1,0;;;;;;;;;;;1,0;;19,0;;;;4,0;;;;;;1,0;;;;;;;;;;;;;;;;;;;;;;;;;4,0;;;;;;;;;;;;;;;;;;;;;;;;;2,0;;;;;;;;;1,0;;;;;;1,0;;;;;;;;1,0;;;;;;;;;;2,0;;;;;;;;;;;;;;6,0;;;;2,0;;;;;;7,0;1,0;1,0;;;;;;;;;;;;;;;;;;;;;;;;;;;;;;1,0;;;3,0;;9,0;8,0;;;;;9,0;4,0;;;;;;;2,0;;;;;;;;19,0;;1,0;;;8,0;;;;;;;;3,0;;;;;;;6,0;1,0;3,0;4,0;3,0;;;;;;;;;;;;;;;;;;;;;;;;;;;;1,0;;;;;;;;;;;2,0;;;;;;;;;;;;3,0;;;;;;;;;;;;;;;;;;3,0;;2,0;;;;;;;;1,0;;;;;;2,0;;;;;;;;2,0;;;;;;;;;;;;;4,0;;3,0;;;;2,0;6,0;;6,0;2,0;;2,0;;;;;;;;;;;;;;;;;;;2,0;;;;;;;;;;;;;;;;;;;;;;;;;;;
container;;;;;2,0;;;;;;;;;1,0;;;4,0;;;;;;3,0;;2,0;;;;;;2,0;;;;;;2,0;1,0;;;;17,0;1,0;;7,0;5,0;;;;;;;;5,0;;;2,0;;;7,0;;;;;12,0;;;;;;;9,0;1,0;7,0;;;;;;3,0;3,0;;;;2,0;;;;;;;;;;;;;;1,0;;2,0;;;;;1,0;;;;;;;;;4,0;;;;;2,0;;;;;;3,0;2,0;;;;;;;;;;;;;;;;;;;;1,0;;;3,0;;1,0;22,0;3,0;;;;;;;;;;;;;;;;;;;;;;2,0;;;;;;;;;;;;;2,0;1,0;;;;;;;2,0;;7,0;;;;;;;;2,0;;;;;;;;;;;;;;;;;;;;4,0;1,0;;;;;1,0;;1,0;;1,0;;;;;1,0;;;2,0;1,0;1,0;2,0;2,0;;;;;;;;;5,0;;;1,0;1,0;;;12,0;1,0;;;2,0;;;1,0;;;2,0;;;1,0;;;;;;;;;;1,0;;1,0;;;;7,0;;;;;;;;;;;;;;;;;;;3,0;;;;;;;;;5,0;;;;;;;;;;;;;1,0;2,0;;;;;;;;;;;;;;;;;;;;;;3,0;1,0;1,0;;;;;;;;;;;;;;;;;;;;;1,0;;;;;;;;;;;;;;;;;;;;;;;1,0;;;;;;;;2,0;;;;;;;;;;;;;;1,0;1,0;;;;;;;;;;6,0;;;;;;;;;;;;;;;;;;;;;;;;;;;;;1,0;;;;;;;;;4,0;;;;;;;;;;;4,0;;;;;;;;2,0;;;;;;;;;;;;;;;;;4,0;;;;;;;;;;3,0;;;;;;;;1,0;;;;;;;;;;;;;;;;;10,0;;1,0;;;;;;;;;;;;;;;;;;;;;;;;;;;;;;;1,0;;;;;;;13,0;;;;;;;;;;;;;;;;;;;;2,0;;;;;;;;;;;;;;;;;;;;;;;;;;;;1,0;;;;;;;;;;;;;;13,0;;;;;;;;;;;;;;;;;;;;;;;;;;;;;;;;;;;;;;;;;;;;;;;;;;;;;;;2,0;;;;;13,0;;;;;;2,0;;;;;;;2,0;;;;;;;;3,0;;;;;;;;17,0;;;;;;;;;;;;;;;;;2,0;;;4,0;;;;;;;22,0;;;;;;;;;1,0;;;;;;1,0;;;;;;7,0;;;1,0;;;;;;;;;;;;;;;;;;;;;;;;;;;;;;;;;;;;;;;;;;;;;;;;;2,0;;;;;;;;;;;;;;;;;;;;;;;;;;;;;;;;;;;;;;;;;;;;;;;;;;;;;;;;;;;;;;;;1,0;;;;;;;;;;;;;;;;;;;;;;;;;;;;;;;;;;;;;;;;;;;;;;;;;;;;;;;;;;;;;;;;;;;;;;;;;;;;;;;;;;;;;;;;;;;;;;;;;;;
converter;;;;;4,0;13,0;7,0;10,0;;;;1,0;;6,0;;;;2,0;9,0;;;;11,0;;;;;8,0;;4,0;155,0;8,0;3,0;1,0;;6,0;;1,0;;1,0;2,0;57,0;;91,0;1,0;1,0;;;;;;;;;;;13,0;;4,0;67,0;;;42,0;;63,0;;191,0;;;;;4,0;65,0;;;;;;;6,0;16,0;5,0;11,0;;7,0;2,0;1,0;14,0;;;;;4,0;;;;201,0;2,0;143,0;5,0;13,0;2,0;;5,0;9,0;23,0;;2,0;;;;20,0;45,0;;;;;3,0;;74,0;;;289,0;1,0;;3,0;19,0;;;2,0;6,0;;;67,0;1,0;;;;;4,0;;2,0;;;;2,0;4,0;62,0;25,0;;;3,0;4,0;;5,0;211,0;;;;;;36,0;;94,0;;;33,0;10,0;;1,0;6,0;;9,0;52,0;;;2,0;;;;;;;16,0;;27,0;7,0;;;;;;;9,0;;;2,0;11,0;;;1,0;21,0;;;;;3,0;3,0;;1,0;;;5,0;;2,0;;126,0;3,0;1,0;12,0;2,0;7,0;;718,0;;3,0;55,0;;3,0;;;;7,0;;;;2,0;3,0;;1,0;;;;;;4,0;5,0;2,0;7,0;;;;8,0;5,0;26,0;50,0;2,0;22,0;3,0;;92,0;8,0;3,0;1,0;;;9,0;10,0;;;;8,0;1,0;;;;1,0;;;;;;;;;;;;126,0;2,0;4,0;;;;2,0;;1,0;1,0;;;;;;6,0;;;;1,0;;45,0;;;;6,0;;;28,0;;;1,0;;3,0;7,0;1,0;;;;;33,0;;;;;;;;;;;;;;;;;;;3,0;;;;;;;;;10,0;;8,0;1,0;;;;3,0;;;2,0;;;;;;;6,0;17,0;2,0;;;;;41,0;11,0;2,0;;1,0;7,0;1,0;2,0;;;;;;2,0;2,0;;;;;;;60,0;;8,0;2,0;;4,0;;;;;;;16,0;10,0;;;;;;;5,0;;12,0;;39,0;;;;;16,0;;1,0;;;;;;35,0;;;89,0;;1,0;1,0;;;2,0;;;;127,0;;;;9,0;;2,0;;;;;8,0;;;;;;1,0;;;;;2,0;;;;;2,0;;;;1,0;2,0;1,0;;6,0;;;5,0;;;;;;;;;;;;8,0;;;;3,0;;;;;2,0;;;;;1,0;;;;;;4,0;;;;;;;;;;;;4,0;7,0;;1,0;1,0;;;;;;;;;;6,0;;;;;;;3,0;1,0;;;;;;7,0;;;;;;;;;;;;;;;;;;;;;;;;;5,0;;2,0;;;;;;;;;;;;;;;;;;;;6,0;6,0;1,0;;;;;;;;;;;;;;;;;;;;;;;3,0;;;;;;;;1,0;;;51,0;;;;;;8,0;;2,0;;;1,0;;3,0;1,0;;;;;8,0;;1,0;;;;;11,0;;;;;;;;;;;;;4,0;2,0;;;;;;;;5,0;;;6,0;;;;;1,0;;;1,0;6,0;;;;;;;;;;;1,0;;;;;;;;;;;;;;;;;;;6,0;;;;;;;;;;;;;7,0;;;;;;;;;;;;;;;;;;;;;;;;;;;;;;;3,0;;;;;;;;;;2,0;6,0;46,0;1,0;;19,0;29,0;9,0;35,0;13,0;;54,0;;;2,0;3,0;64,0;;;;;;12,0;3,0;1,0;1,0;33,0;;50,0;;;;;;;;41,0;;;;6,0;;;69,0;;;;;;;;;;;;;;;;5,0;;;;1,0;9,0;1,0;;10,0;;;1,0;;;1,0;;;;;;;;12,0;;;4,0;5,0;;;;;;;;2,0;;;;;;;;;;;;;;;;;;;;;;;9,0;;;1,0;;;;;;;;;;;;;;;2,0;;;;;6,0;11,0;;;;;;;;;;;;;67,0;;;;;;;;;;;;;;;;;;;;;4,0;;;;;;;;;;;;;;;;;;;;;;;;;;;;;;;;;5,0;;;;
core;;;;;1,0;1,0;1,0;3,0;;;;;;13,0;;;;;;;;;;;31,0;;;3,0;;;10,0;5,0;;;;;;;;;1,0;8,0;16,0;;;6,0;;5,0;;12,0;;3,0;3,0;;;;13,0;;1,0;2,0;2,0;;1,0;;16,0;;25,0;;;5,0;;7,0;12,0;;;;20,0;;;8,0;3,0;;;;5,0;;;2,0;;;;16,0;1,0;;;;1,0;;9,0;;12,0;1,0;;;6,0;3,0;;;;;;;1,0;;;;;5,0;;12,0;;;;1,0;;;8,0;;;5,0;6,0;;;1,0;;;;;;;;;;;;;2,0;;;1,0;3,0;;24,0;3,0;;2,0;;;;;5,0;2,0;;;;;3,0;;;;3,0;;3,0;4,0;;1,0;1,0;;;;3,0;;;;;;;;;;;;;;6,0;8,0;6,0;;;;7,0;34,0;4,0;;;;5,0;11,0;;2,0;;7,0;;;;1,0;12,0;;;;2,0;;;;;;15,0;;;;;1,0;12,0;1,0;;2,0;;;;;;4,0;;;;1,0;2,0;5,0;2,0;4,0;;;;4,0;13,0;;;25,0;24,0;;;3,0;;;1,0;;;;;;;4,0;2,0;;;;;;;;;;;1,0;;;;;;;24,0;;1,0;;4,0;;;;;;;;9,0;;;1,0;4,0;;;3,0;;;14,0;;;;;;;;;2,0;1,0;;1,0;;;;15,0;;;;;4,0;;;;;;;;;;;;4,0;;2,0;;;;;;;;;;1,0;1,0;;;;;;;;;;;;;;2,0;;;;;;;;9,0;;;;;;;;;;;;;4,0;;1,0;;;;;;4,0;1,0;4,0;;;;;;;;;;;;;;;;;;;4,0;;;3,0;;;;;;;;;;;;;;;2,0;;;;1,0;;;;;;;2,0;;;;1,0;;1,0;;;;;;;;;;;;;;;;;1,0;;;;;;;;;12,0;;;;;;;;;;;;;;;;;;;;;;;;3,0;;;;;;;1,0;2,0;;;;2,0;;18,0;;;;;;;;;;;4,0;;;;;;;;;;;59,0;;;;;;;;;;;;;;;;;;;;;;;;;;;;;;;;;;;;;;;;7,0;;;;;;;;;;;;;;;;1,0;;;;;;;;;;;7,0;;;;;;;;;;;;;1,0;;;;;;;;;2,0;;;;;;;;;;;;;2,0;;;;;;;;;;;;;;1,0;;;;;;;;;;;;;;;;;;;;;;;;;;;;;;;1,0;;;;;4,0;;;1,0;2,0;;;;;;1,0;;;;3,0;;;;;;;;3,0;;;;;3,0;;;;;;;;;;;;;;;;;;;;;;;;;;;;;;;;;7,0;;;;;;;;;;;;;;;;;;;;;;;3,0;;;;;;1,0;;;;;;;;;;;;;;;;;;;19,0;;;;;;;;;;;;;;;;;;;;;;;;;;;;;;;;;;;;;;;;;;;;1,0;;;;;;;;;;;;;;;;;;;;;;;;;;;4,0;;;;;;;;;;;;;;;;;3,0;3,0;;;;;;;;;;;;;;5,0;;;;;1,0;;;;;;;;;;;;;;;;;;;;;;;;;;;;;;;;;;;;;;;;;;;;;;;;;;;;;;;;;;;;;;;;;;;;1,0;;;;;;;;;;;;;;;;;;;;
decision;;;;;3,0;4,0;;;;;;;;9,0;;;13,0;;;;;;;;;3,0;;14,0;;;27,0;2,0;;;;4,0;;;;;13,0;18,0;;7,0;;;;;;;;;;;;;;;;4,0;;;8,0;;33,0;;19,0;;4,0;;;6,0;1,0;;;;;;;6,0;9,0;;;;;;;;;2,0;;;;2,0;;;48,0;1,0;16,0;;5,0;;;6,0;23,0;5,0;;;;;;4,0;5,0;;;4,0;;3,0;;3,0;;;16,0;;;1,0;17,0;;;;6,0;;;23,0;;;;;;;;;;;;;;1,0;;;;1,0;;;;;;;;;;;;;;;;;;3,0;1,0;;;;;;6,0;;;;;;;4,0;;;;;9,0;;;;;;;;;3,0;;;;;1,0;1,0;2,0;1,0;;;;;;;9,0;;;;5,0;;;;;34,0;8,0;1,0;;;;;;;;;3,0;;;;;;;;;;;;;6,0;;;4,0;;;;;1,0;1,0;;2,0;1,0;;;;1,0;;;;;;;;;;;;;;;1,0;;;;;1,0;;;;;;;47,0;;;1,0;;;;;;;;;;;;;;;;;;19,0;;;;;;;;;;;;8,0;;;;;2,0;;;3,0;;;;;2,0;;;;;;;;;;;;;;2,0;;;;;;;;;;1,0;;;;;12,0;;;1,0;;;;;;;;2,0;;;;1,0;4,0;;3,0;27,0;;;5,0;4,0;;;;;3,0;2,0;;;2,0;;3,0;1,0;;;16,0;35,0;;;;;;;;;;;;;;;;;3,0;;;;4,0;;5,0;;4,0;;;32,0;;2,0;;2,0;;;2,0;;;;;;;;;;;11,0;;;;;;;;;;;;1,0;;17,0;1,0;;;;;;;;;;;;;2,0;;2,0;2,0;;;;2,0;;;;;;;;1,0;;;1,0;;;;;;;;;;2,0;;;;1,0;;;;;;;12,0;;;;;;;;;1,0;;;;;;;;;;2,0;;;;;;;;;;;;;;;;;;2,0;;2,0;9,0;;;;;;;1,0;;;;;;;;;;;;;;;1,0;;;;;;;3,0;;;1,0;6,0;3,0;;;1,0;;;3,0;;;;;;;;2,0;;;;;;;;;;;;;;3,0;;;;;1,0;2,0;;;;;4,0;;;;;;;;;;1,0;;;;;;;;;;;;;;;;;;;;;;;;1,0;;;;;;;;;;;;;;;;3,0;;;;;;;;;;;;1,0;;;;;;;;;;2,0;;;;;;;;;;;;;;;;;;;;;;;;;;;;;;;;;;1,0;;;;;;;;;;;;;;;;;;;;;;;;;;;;;;;;;;;;1,0;;;;;;;;;;;;;;;;;;;;;;;;3,0;;;;;;5,0;;;3,0;;;;1,0;;;7,0;1,0;;;2,0;;1,0;;;;;;2,0;;;;;;;;;;;;;1,0;;;;;;;;;;;;;;;;;;;6,0;;;;;;;;;;;;;;;;;;;;;;;;;;;;;;;3,0;;;;;;;;;;;;;;;;;;;;;;;;;;;;;;;;;;;;;;;;;;;;;;;;;;;;;;;;;2,0;;;;;;;;2,0;;;;;3,0;;;;;;;;;;;;;;;;;;;1,0;;;;;;;;;;;;;;;;;;;;;;;4,0;;
decode;;;;;3,0;12,0;1,0;;;;;4,0;;13,0;;;21,0;4,0;;;;;6,0;;1,0;;;9,0;7,0;2,0;31,0;;;1,0;;157,0;;;5,0;;19,0;18,0;;9,0;15,0;;2,0;8,0;;1,0;;;;;14,0;;1,0;;;21,0;;;;2,0;201,0;;8,0;;;;3,0;;1,0;;;;;;;8,0;50,0;;5,0;;2,0;1,0;1,0;8,0;;3,0;21,0;;;;1,0;;5,0;;35,0;1,0;1,0;2,0;;9,0;5,0;7,0;;1,0;;;;10,0;8,0;;;;;6,0;;2,0;15,0;;51,0;;;5,0;30,0;;;;18,0;;;7,0;;;18,0;;;;;;;;;7,0;6,0;;21,0;;;;;;5,0;;;;;;3,0;1,0;3,0;28,0;;;;;;2,0;;;;;;2,0;;;2,0;4,0;;;;;;;;;84,0;;;;;;;;;;;;;1,0;;;;1,0;;;;;;;;;;;22,0;16,0;;;18,0;4,0;;;;;11,0;;;10,0;;1,0;1,0;;;1,0;;;;7,0;;;;;;3,0;;;;;;;;;;;;;1,0;;;8,0;;;;;;;;;;2,0;;5,0;;;;1,0;;;2,0;;;;;;;1,0;1,0;;;;;;;;;;;;;;;;;;;;;;;;;;;;2,0;;;;4,0;5,0;;;;;;;;;;;;;1,0;;;;;;;;;;;2,0;;2,0;;;;;;;;;;;79,0;3,0;;;;3,0;;;3,0;;;;;;2,0;;3,0;;;;2,0;;1,0;4,0;;1,0;;;;;2,0;;;3,0;2,0;;;1,0;;8,0;2,0;1,0;;1,0;;10,0;;7,0;;;12,0;;;2,0;;2,0;3,0;;1,0;;;;;4,0;;5,0;1,0;24,0;3,0;2,0;;;;;3,0;;;;1,0;;4,0;;;2,0;;;4,0;;;;3,0;;;;;;;;;3,0;;;2,0;;;;;67,0;;;;;;7,0;4,0;1,0;;;1,0;;8,0;2,0;;;;;;;4,0;;2,0;1,0;;;;;7,0;;;;1,0;;;6,0;;;10,0;;1,0;;;;;1,0;;;;1,0;;;;;3,0;;;;;;;;;;;;;;;;;;;1,0;;;;;;3,0;;;;;;;;4,0;;;;;;;;;;;;3,0;;;;;;;;;;;;;;;;;;;;;;2,0;45,0;;;;;;;;;;;;;;;2,0;;5,0;;;3,0;;;2,0;;;;;;;6,0;;;;4,0;4,0;;;;;;;;;;2,0;;1,0;;;;;;;;;;;;;;;;;;;;;1,0;;2,0;;1,0;1,0;1,0;;;;;;;;1,0;;;;;4,0;;;2,0;;;1,0;2,0;1,0;2,0;4,0;1,0;;;;;;4,0;;;;;;;;;;2,0;;;;;;;;;;;1,0;;;;;;;3,0;;;;;;;;1,0;;;;;;;;;;;;;;;;;;;1,0;;;;;;;;;;;;;;;;;;;;;;;;;1,0;;;;;;;;;;;6,0;;;;5,0;;;;;;;;;5,0;;;;;;;;;;;;;;;;;;;;1,0;;;;;;;;;;;;;;;1,0;;;;;7,0;;;;;;;;;;;;;;;;;;1,0;;2,0;;;;;;;;;;;;;;;;;8,0;;;;;;;;;2,0;2,0;;;;;;;;3,0;;;;;;;;;;;;;11,0;;;;;;;;;;;;;;;;3,0;;;;12,0;;;;;;2,0;;;;;;;;;;;8,0;;;;;;;;;;;4,0;;;;;;;;;4,0;;;;;;;;;;;;;;;;;;;;;;;;;;;4,0;;;;;1,0;;;;;;
diffusion;;;;;15,0;6,0;2,0;;;;;;;2,0;;;;2,0;7,0;;;;;;;;;;;;47,0;1,0;;;3,0;;;;;;;58,0;;;;4,0;;113,0;;;;1,0;3,0;;;;13,0;;;;;;15,0;;18,0;;37,0;;1,0;;2,0;7,0;41,0;3,0;;;5,0;;;;3,0;;3,0;;3,0;;;3,0;;;;;;;;;63,0;;29,0;;3,0;4,0;;;1,0;;;;;;;;194,0;;;;;2,0;;6,0;;;30,0;;;2,0;4,0;;;;;;;14,0;12,0;;3,0;;;;;3,0;;;1,0;2,0;3,0;24,0;1,0;2,0;;;2,0;;;5,0;;;;;;33,0;;1,0;54,0;;30,0;;;;;;;11,0;;;2,0;12,0;;;;;;6,0;;3,0;5,0;;;1,0;;;;2,0;;;2,0;2,0;;;1,0;6,0;1,0;;;4,0;;;;1,0;;;;;;;8,0;;;1,0;;;;61,0;11,0;;73,0;;;1,0;;;;;;;;1,0;;;;;;;;;3,0;6,0;21,0;;;;;7,0;6,0;6,0;;6,0;6,0;;86,0;3,0;2,0;;;;;;;;;6,0;;;;;;;;;;;1,0;;;;6,0;;1,0;;;;;;2,0;;;1,0;;;;;;;;;;;;41,0;;;1,0;;;;16,0;;;;;;4,0;1,0;1,0;;5,0;;6,0;;;;;;;4,0;;;;;;;;;;;;;;;;;;2,0;;;11,0;;;;;;;;;;;;;;;;;;;;;;;;;;;;;;;;;;;;;;;;;;;;;;;;;;;;;;;;;;;;;;;;;;;6,0;;2,0;;;;;;;;;;;4,0;;8,0;;;;;2,0;;;;;;;;16,0;;;;;;;;1,0;;;;;;;;;;;;;;;;;1,0;;;;;;;;;;1,0;;;;;;;;;;;;;;;;;;;;;;;;;;;;;;;3,0;;;;;;;;;;;;;;;;;;;;;;;;;;4,0;;;;2,0;;;;;;;;5,0;;;;;;3,0;;;;;;;;1,0;;;;;;;;;;;;;;;;;;;;;;;;1,0;;;1,0;;;;;;;;;;;;;23,0;;;;;;;;;;;;;;;;;;;;;;;;;;;;;;;;;8,0;;14,0;;;;;;3,0;;;;;;;;;;;;;44,0;14,0;;;;;;20,0;;;;;;;;;;;;;;;;;;;;;;;;;9,0;;;;;4,0;4,0;;2,0;;;;;;;;;;;4,0;;;;;;;;;;;;;;;;;;;;;;;;1,0;;;;;;;;;;;;;;;;;;;;;;;;;;;;;;;;;;;;;;3,0;;;;;;;;2,0;;;5,0;1,0;;26,0;;;;;1,0;56,0;;;;;;4,0;8,0;437,0;;30,0;;;;2,0;;;2,0;28,0;;8,0;;;;;;;;1,0;;;;;;5,0;153,0;;;;4,0;1,0;;;;;;;;;;;;;;;;;;;;;;2,0;;;;;;;;;;;;;;;;;;;1,0;;;;;;;;;;;;;;1,0;;;;;;;;;;;;;;;;;;;;;;;;;;2,0;;;;;;;;;;;;;;;;;;;;;;;;;;;;;;;;;;;;;;;;;;;;;;;;;;;;;;;;;;;;;;;;;;;;;;;;;;;;;;;;;;
discharge;;;;;1,0;5,0;;;;;;;;5,0;;;5,0;;;;;;;;2,0;;;;;5,0;22,0;;;;;;;;;;;20,0;;4,0;1,0;4,0;;7,0;;;;;3,0;;2,0;;1,0;;;1,0;;;;;9,0;;15,0;1,0;;;;10,0;6,0;21,0;;;;;;;4,0;;;;24,0;;;3,0;;;;;1,0;;;;21,0;;3,0;;8,0;2,0;;1,0;5,0;;;1,0;;;;3,0;1,0;;;;;;;;;;12,0;;1,0;1,0;2,0;;;;1,0;;;6,0;;;3,0;2,0;;;;18,0;;;;;28,0;;;;;;1,0;8,0;;81,0;;;;;;2,0;;;;;;12,0;;;;;;3,0;;;14,0;;1,0;;;;1,0;2,0;;;2,0;1,0;;;;;4,0;;;3,0;7,0;;;;;;;;;;5,0;;;9,0;3,0;2,0;;;;;;;;20,0;;11,0;;4,0;5,0;;1,0;;2,0;;2,0;;;;1,0;;;;;;;;;;2,0;1,0;9,0;;6,0;;3,0;;5,0;1,0;1,0;4,0;1,0;15,0;;;1,0;;;6,0;;18,0;;;;;2,0;;;;;;3,0;;2,0;;;;;1,0;;;;1,0;12,0;;;;;;;1,0;1,0;;;;;;;22,0;;;;1,0;;5,0;;4,0;2,0;;;;;;3,0;;;;;;;;;;3,0;19,0;2,0;;;;1,0;;1,0;;;;;;;;4,0;;;8,0;;;;;;;;;;;;;;;;;;;;;;;;;;;;;;;;;41,0;;1,0;;;2,0;;;;4,0;;;;;2,0;;;;;;;1,0;1,0;1,0;;;;;;;;2,0;;;;;;;;;;;;;;5,0;;;;;1,0;;1,0;;2,0;;;;5,0;;;4,0;;;;;;3,0;1,0;;;5,0;;;;1,0;;;;;;;;;;;;;;;1,0;;;;;;;;;;;;;;2,0;;5,0;;;;;;;;;;;;;;;;;;;;;;;;;;;;;;23,0;;;;2,0;1,0;;;;5,0;;;5,0;2,0;;;;5,0;;;;;;;;;;3,0;;;;;53,0;;;;;;;;;;;;;1,0;;;;;;;;;;;;;;;;;;;;;;;4,0;;;;;;;;;;;;;;2,0;;;;;;;;;7,0;;9,0;;;;1,0;;;;;;;;;;2,0;;;;;;;;;;;;;;;1,0;;;;;;;;;;;;2,0;;;;;1,0;;;;;;;;;4,0;;;;;;5,0;;;;;;;;2,0;;;;;8,0;;;;;;;;;;;18,0;;1,0;;;;;;;1,0;;;;;;;;;;;;;;2,0;;;;1,0;;;;;;;;;;;;;;;;;1,0;;;;;;;;;1,0;;;;;4,0;;;;;;;;;;;;;;;;;;;;;;;;1,0;;2,0;;;;;3,0;;;1,0;;5,0;;1,0;;;24,0;2,0;;12,0;;;;;1,0;;;2,0;;;1,0;;;2,0;;;;13,0;;;;;;;;;;;;;;;;;14,0;;;;;;;;;;;;;;1,0;1,0;;;;;;;;;;;;;;;;;;;;;;;;1,0;;;;;;;;;;;;;;;;;;;;;;;;;;;;;;;;;;;;;;;;;;;5,0;;;;;;;;;;;;;;;;;;;;;;;;;;;;;;;;;7,0;;;;;;;;;;;;;;;;;;;;;;;;;;;;;;;;;;;;;;;;;;;;;;;;;;;;;
disparity;;;;;9,0;11,0;9,0;;;;;;;142,0;;;19,0;;1,0;;;;57,0;;;;;;6,0;;36,0;;5,0;1,0;;18,0;3,0;;70,0;;203,0;22,0;;4,0;10,0;3,0;;;5,0;9,0;47,0;;;;3,0;;4,0;;;72,0;;;4,0;;430,0;;4,0;6,0;10,0;;4,0;5,0;1,0;;;8,0;;;;;67,0;;;;2,0;;;;1,0;1,0;7,0;;;;;;111,0;3,0;60,0;144,0;9,0;11,0;;28,0;22,0;36,0;;;;3,0;;16,0;19,0;5,0;;7,0;15,0;15,0;69,0;10,0;1,0;;1,0;;;1,0;80,0;;;;;5,0;;14,0;;;28,0;1,0;2,0;;;;;;3,0;6,0;9,0;;35,0;;;23,0;;;;;;;;;;;;2,0;;15,0;1,0;;;;;;;2,0;;3,0;;;1,0;;;;;7,0;;;7,0;;1,0;;;;;;;;;;;;;;;;3,0;4,0;;;;;;;3,0;;;;2,0;1,0;6,0;;21,0;;;;;;11,0;;;6,0;;;21,0;;;1,0;;;;2,0;;;;;;21,0;;;;;;;4,0;;;;;5,0;;;;;;5,0;;;;;14,0;4,0;;;;;;;2,0;5,0;;;;31,0;;;18,0;;;;;;;;;;1,0;;23,0;;;;;;;;;;;;1,0;4,0;;;;;33,0;;2,0;;;;;55,0;;2,0;;;;;;;;;;;10,0;;;;;;;1,0;;;;;39,0;;;;;;;;1,0;;;;;;4,0;;;;;4,0;2,0;;;;;;38,0;;;;;;9,0;6,0;4,0;9,0;;1,0;;5,0;15,0;26,0;;;4,0;;3,0;27,0;1,0;10,0;;23,0;11,0;;;;;18,0;;46,0;;1,0;4,0;;;;2,0;3,0;3,0;;;;;;;;;;6,0;;;;;;;;;;;;3,0;;3,0;;;;6,0;;6,0;12,0;4,0;;6,0;;11,0;;;;;;1,0;3,0;;2,0;18,0;;;;;;8,0;3,0;;;3,0;;1,0;;;;;;;;;;;3,0;;2,0;37,0;;;10,0;6,0;5,0;;2,0;;;;;1,0;;2,0;;;;70,0;;;;;2,0;;9,0;;;;1,0;;6,0;;;;;;;2,0;;;;;;;;;;1,0;;;;1,0;31,0;;;4,0;;;2,0;;;;;;;;3,0;;;;;;;;;;;10,0;;1,0;;;;;;;;;;;;;;;;;;5,0;;;;1,0;;;;;;;;;;;;;1,0;;21,0;;;;;;;;;;;;;;;;2,0;;;5,0;;;6,0;;;;;;;;;;;;;;;;;;;66,0;1,0;;;;;;;;2,0;1,0;7,0;;;4,0;3,0;;;;;;;;;;;5,0;;;;;8,0;;;;;;1,0;;;;;4,0;;;;;;;;;;;2,0;;;;;1,0;1,0;1,0;;;;;2,0;;;;;;;;;;10,0;;;;;;;;;;;;;2,0;2,0;3,0;;;;7,0;;3,0;;;;;;;;;;;;;;;;;;;;;;;;;;;;;;;;3,0;;;;;;;;;;;;;14,0;;;;;;;18,0;;;;2,0;;;;;;;;;2,0;;;;;;13,0;;;;33,0;;;;;;5,0;;;;;;;;;;;5,0;;;;;;;;1,0;;;4,0;3,0;;;;1,0;;;1,0;;;6,0;;4,0;;;;;;;;;;;;;;;1,0;;;36,0;1,0;;;;;;;;;;;;;;;4,0;;1,0;;;;;;;;;;;;;;;;;;;;;;;;;;;;;;;;;1,0;;5,0;;;;;;;;;;;;;1,0;;;;;;;;;;;;;;;;;;;;;;;;;;;;;;;;;;;;;;;;;13,0;;;2,0;;;;;;;;;4,0;;;;;;
distal;;;;;1,0;12,0;;17,0;1,0;;16,0;;16,0;24,0;;1,0;25,0;;24,0;;;1,0;1,0;;8,0;;;18,0;;;19,0;;;;;6,0;19,0;2,0;1,0;;3,0;37,0;10,0;1,0;12,0;56,0;;10,0;;;;;77,0;4,0;11,0;;23,0;;;2,0;;;;;37,0;1,0;57,0;1,0;;;27,0;27,0;39,0;11,0;;;3,0;;;;4,0;;;;8,0;4,0;1,0;13,0;;;;1,0;5,0;;;;;1,0;25,0;13,0;45,0;;;;2,0;9,0;;1,0;;;;;5,0;;7,0;;;17,0;;9,0;;;2,0;;;1,0;19,0;;;1,0;;;;12,0;;;14,0;;;;4,0;7,0;;;11,0;1,0;4,0;9,0;;63,0;2,0;3,0;47,0;6,0;1,0;;10,0;;;;;57,0;;;;;59,0;13,0;;;;;2,0;18,0;3,0;25,0;;3,0;6,0;;2,0;;;35,0;2,0;;;1,0;;13,0;;1,0;;11,0;;8,0;119,0;2,0;27,0;22,0;;1,0;1,0;4,0;;1,0;67,0;1,0;1,0;45,0;2,0;11,0;6,0;;4,0;4,0;2,0;3,0;;8,0;;;;;16,0;;180,0;2,0;;3,0;7,0;;;1,0;9,0;;;;11,0;4,0;;1,0;9,0;6,0;1,0;;1,0;8,0;63,0;7,0;3,0;;;6,0;2,0;5,0;55,0;115,0;3,0;;3,0;3,0;;2,0;21,0;;;;;7,0;;32,0;8,0;7,0;;;5,0;7,0;1,0;;16,0;;9,0;14,0;;;7,0;8,0;9,0;;1,0;;10,0;8,0;1,0;;5,0;;6,0;22,0;2,0;2,0;7,0;;2,0;12,0;36,0;25,0;1,0;4,0;2,0;20,0;4,0;3,0;;7,0;14,0;5,0;;5,0;1,0;;11,0;;;4,0;;3,0;1,0;4,0;4,0;182,0;11,0;2,0;3,0;9,0;;7,0;;3,0;6,0;10,0;3,0;1,0;3,0;20,0;59,0;4,0;;;;16,0;;;1,0;93,0;;10,0;5,0;;;;;;;7,0;;;20,0;1,0;1,0;;2,0;20,0;;;;5,0;;;16,0;2,0;;;;;;;;;;;;2,0;;;;;3,0;;;;1,0;;2,0;3,0;;7,0;9,0;3,0;;1,0;;2,0;;8,0;;;;;;;;;;2,0;1,0;;;;;;;;;;1,0;;2,0;;;1,0;;;;1,0;;;;;;;;1,0;8,0;;;;;2,0;;;;;;;;;;;;;;3,0;2,0;;;2,0;;2,0;3,0;;;;;;;2,0;2,0;;;;;18,0;4,0;;5,0;;2,0;;2,0;;;;;8,0;;;;;;;2,0;;1,0;1,0;15,0;;;;15,0;14,0;;;;;1,0;3,0;9,0;;1,0;;7,0;5,0;6,0;1,0;;2,0;;;;1,0;;18,0;;;;;1,0;;5,0;4,0;;;;;;;;;;;;;;;2,0;;;;;1,0;;;7,0;4,0;;;5,0;;;;2,0;13,0;1,0;3,0;2,0;;3,0;;;;;;;;;;;;;;;;;;;;;;;;;;;7,0;;2,0;;8,0;;;;;;;;;;;;;;;;;;;7,0;;;;;7,0;;;;;;9,0;;;;;2,0;;;;5,0;3,0;;;;;;;;;5,0;;15,0;;12,0;;;;;;;;;10,0;1,0;;;;;;;;;3,0;;;2,0;12,0;;9,0;;3,0;1,0;;;13,0;;10,0;13,0;;1,0;;;1,0;1,0;;;10,0;;2,0;;;;7,0;2,0;;;2,0;7,0;56,0;;;;;;4,0;33,0;;5,0;31,0;;;;;1,0;2,0;;;;;2,0;;3,0;1,0;3,0;1,0;;8,0;2,0;;;35,0;38,0;;;;5,0;;;;2,0;2,0;;;;;;;;;2,0;;;;;2,0;3,0;;;2,0;;;;;;;;;;;;;1,0;;;;1,0;;;;;;;;;;;;;;;;;1,0;;;;;;;;13,0;;;;;;;;;;;;3,0;;;;;;;;;;;;;;;;1,0;;;;1,0;6,0;;;;;;;;;;;;;;;;;;3,0;;;;;;;;;;;4,0;;;;;;;;;;;;;;14,0;;;3,0;;;;5,0;;;1,0;4,0;;;;;;;;;;;;;;;1,0;1,0;26,0;;5,0;;;;;;;;;;;12,0;;;1,0;;;;8,0;;;;4,0;;;;;;;;;;1,0;1,0;;;;;;;;;;;;;;;;;;;;;;;;;;;1,0;;;;
elastic;;;;;2,0;34,0;11,0;16,0;;;1,0;21,0;38,0;42,0;;;;;1,0;;;;;;;;;89,0;;;51,0;;;1,0;;;1,0;;;1,0;;53,0;6,0;;4,0;112,0;;48,0;;;;;12,0;9,0;1,0;;37,0;;;5,0;;;;;4,0;;105,0;8,0;;5,0;1,0;200,0;1,0;;;4,0;73,0;;;;16,0;;;;127,0;13,0;;18,0;;1,0;4,0;1,0;1,0;6,0;1,0;;;5,0;48,0;11,0;23,0;;;1,0;;;;;;;;2,0;;3,0;;;;;;8,0;;1,0;;;;8,0;10,0;;;13,0;;;;133,0;1,0;;1,0;;;;6,0;1,0;;;;11,0;3,0;28,0;;8,0;4,0;9,0;32,0;32,0;2,0;;1,0;1,0;;;25,0;187,0;;;;;122,0;24,0;;;;;1,0;61,0;1,0;1,0;10,0;;1,0;2,0;8,0;;;28,0;1,0;;;53,0;32,0;1,0;;1,0;1,0;4,0;40,0;14,0;118,0;;41,0;4,0;;;;;2,0;1,0;912,0;5,0;;36,0;12,0;4,0;2,0;;;49,0;;4,0;;;;;;;31,0;2,0;122,0;14,0;;;5,0;;13,0;5,0;3,0;;;;;2,0;1,0;15,0;2,0;2,0;4,0;5,0;16,0;11,0;52,0;6,0;;7,0;;13,0;6,0;13,0;184,0;78,0;5,0;;3,0;;;2,0;1,0;;;;5,0;;;12,0;3,0;1,0;2,0;;5,0;2,0;17,0;3,0;6,0;4,0;40,0;24,0;;1,0;10,0;7,0;19,0;;54,0;2,0;;1,0;;6,0;3,0;;;;9,0;;13,0;;;26,0;3,0;;6,0;5,0;;1,0;9,0;3,0;;4,0;3,0;4,0;3,0;2,0;1,0;3,0;12,0;10,0;;1,0;1,0;4,0;9,0;1,0;16,0;;;6,0;;;1,0;1,0;;2,0;13,0;5,0;1,0;2,0;3,0;1,0;4,0;21,0;;55,0;;;;6,0;;3,0;4,0;246,0;4,0;;;;;3,0;;;;;;1,0;1,0;;1,0;1,0;;4,0;;;;;3,0;;;;;1,0;;;;;;;;6,0;4,0;;;;;;;;;;;;;1,0;2,0;8,0;;50,0;;;2,0;;1,0;;;;;;;;;8,0;;1,0;;;;;;;;1,0;;;12,0;;;20,0;;4,0;;;;;2,0;;;4,0;;5,0;8,0;;;;3,0;;1,0;;;;;1,0;;;;;;;;;;;;2,0;;;46,0;;;;;;;;;;;;;;;;;;;;;;1,0;;;4,0;;;;;;;;;6,0;;;1,0;;7,0;28,0;13,0;;5,0;;;2,0;;;;;;4,0;23,0;;;;;2,0;;;;3,0;9,0;;;;3,0;;;;7,0;;;;;;;;;;1,0;3,0;2,0;;;;4,0;;;;;;10,0;2,0;;;;2,0;;;;;14,0;;;29,0;;;2,0;;;;;;;;;;4,0;;;;;;;3,0;2,0;;;;;;;;;1,0;;;;;;;;;;;;;;7,0;;;;;;;;16,0;2,0;;;7,0;1,0;8,0;;;2,0;;;;;;;;5,0;;;1,0;1,0;;;;;;1,0;;;3,0;;;;;;;;;;;;;;;;;;;;13,0;;;1,0;;;15,0;26,0;;2,0;;;;;11,0;6,0;57,0;;;;;;;1,0;1,0;;;;;;;;;;1,0;;;;5,0;;;;;;;3,0;12,0;;1,0;3,0;4,0;;;3,0;;5,0;;;4,0;;;4,0;;103,0;;;5,0;;;;;;7,0;;3,0;;;;1,0;;;;;14,0;;2,0;;;22,0;;11,0;;;;;;;;8,0;4,0;;;;;;;;;;5,0;;;;;;;3,0;;;;;;;;;;7,0;;;;;;4,0;;;;;;6,0;;;6,0;;;;;;4,0;1,0;;;;;;;;;;;;;;;;2,0;;;;;;;;;;;;;;;;;;;;;;;;;;;;;1,0;;;;;;;;;;;1,0;;;;;;1,0;;;;;;;1,0;;;4,0;;;;;;1,0;;;;1,0;;;;;;;;3,0;;;;;3,0;;;;;;;;;9,0;;;;;;3,0;;16,0;;;;;;;;;;;;;;;;;;;;;;;;;;;;;;;;;;;;;;;;;;;;;;;;;;;
encode;;;;;12,0;9,0;;;;;;68,0;;11,0;3,0;;81,0;29,0;16,0;;8,0;;48,0;3,0;2,0;;;64,0;39,0;11,0;111,0;6,0;1,0;;;402,0;9,0;8,0;7,0;;29,0;52,0;;8,0;36,0;;5,0;37,0;;;;;3,0;2,0;12,0;;8,0;;15,0;53,0;;3,0;2,0;2,0;634,0;;36,0;;12,0;;;5,0;18,0;;;;;;7,0;49,0;64,0;;84,0;;5,0;;1,0;11,0;;1,0;10,0;;;;2,0;;39,0;;65,0;6,0;19,0;19,0;;18,0;23,0;76,0;3,0;17,0;;;;14,0;3,0;;;2,0;15,0;1,0;;8,0;18,0;;82,0;4,0;;40,0;65,0;;1,0;;19,0;;;14,0;3,0;1,0;16,0;;2,0;;;;;1,0;3,0;;5,0;;8,0;;;7,0;;1,0;34,0;;;;;;;;10,0;16,0;;;6,0;;9,0;;;;1,0;1,0;;;;3,0;5,0;83,0;6,0;;;;;;;;115,0;;;;;1,0;;;;;;;;2,0;;;;37,0;;;;;;;;;;;88,0;9,0;;;40,0;3,0;;;;;57,0;;;52,0;;1,0;12,0;6,0;;1,0;;;;14,0;;;;;;11,0;;;;;;;;11,0;;;;6,0;2,0;;9,0;24,0;;2,0;;;;1,0;;1,0;;2,0;;4,0;;;;7,0;;;;;;;;;;2,0;5,0;;;;;;;;;;1,0;;;;;;;;;;;11,0;;;;;;;7,0;;;;;10,0;;;;;;;6,0;1,0;;;;;9,0;;;;;;12,0;2,0;;;;;;21,0;3,0;;;;;;;;;;178,0;7,0;;;3,0;;;;1,0;;;;;;5,0;;4,0;10,0;3,0;1,0;5,0;;30,0;6,0;;;;10,0;;;;2,0;2,0;23,0;9,0;;9,0;1,0;;7,0;;1,0;;2,0;6,0;23,0;;16,0;;;7,0;;;4,0;;15,0;55,0;;1,0;2,0;;;;57,0;;5,0;9,0;60,0;2,0;28,0;6,0;;;1,0;12,0;;27,0;;24,0;4,0;14,0;7,0;;;30,0;;3,0;17,0;;;10,0;;4,0;;;;;;;2,0;;;9,0;1,0;;10,0;;;;4,0;;;;13,0;35,0;3,0;4,0;;;10,0;11,0;3,0;1,0;1,0;1,0;3,0;2,0;;34,0;;;3,0;;;;;6,0;;2,0;;3,0;;;24,0;22,0;6,0;;;;;;;16,0;7,0;;;;4,0;;;;;2,0;;;;;;;;;1,0;;1,0;;;;;;;;;3,0;;;;;;;;;2,0;;;1,0;3,0;;;;;;;5,0;1,0;;;4,0;18,0;19,0;;14,0;;;;;;;;2,0;;;1,0;;;4,0;;;;;2,0;58,0;7,0;;;2,0;;;;;;3,0;;;10,0;1,0;;;4,0;;;;;;;6,0;;7,0;;;6,0;25,0;1,0;;;;2,0;;;;;;;;;;9,0;;8,0;;;;;;7,0;;;1,0;;2,0;;;;;;;;;;13,0;9,0;15,0;;;5,0;3,0;1,0;;;;;;3,0;;;;1,0;1,0;20,0;;4,0;;1,0;;;;22,0;2,0;1,0;3,0;;;;;;2,0;;6,0;;;9,0;;;;;1,0;1,0;3,0;;;;;;;;;12,0;;;;;;;;;;;;;;;;31,0;;;;;3,0;;2,0;2,0;1,0;;;;;;;47,0;;;;;;;;;;;;;;;;;;;;;;;;;;;;;;;;;;;;;;15,0;;;;2,0;;;;;;;;;5,0;;;;;;;1,0;;;;;;;;;;;;;;;3,0;;;5,0;;3,0;;;;;;;;;;;1,0;2,0;10,0;;;1,0;1,0;;;;;;;;;;2,0;;;;;5,0;1,0;;;;;1,0;;1,0;;9,0;;;;;;1,0;;2,0;2,0;;;;2,0;;6,0;;;;;;;;;;67,0;6,0;;;;2,0;;;;;;;;;;;;;;;;;;;;;;;;;10,0;;;;17,0;;;;;;2,0;;;;;;;;;7,0;;1,0;;;;;;;;;;;4,0;;;;;;;;;6,0;;;;1,0;;;;;;;;;;;;;;;;;1,0;;;;;;;;;;;;;;;;;
evaluate;;;;;1,0;2,0;2,0;;;;;;;17,0;2,0;2,0;23,0;;;6,0;1,0;;1,0;;;;;1,0;6,0;5,0;19,0;6,0;1,0;10,0;;12,0;2,0;2,0;6,0;;13,0;31,0;;4,0;;;3,0;4,0;2,0;10,0;4,0;;;;;2,0;;;5,0;2,0;;;2,0;;114,0;;8,0;;;;;1,0;;;;;;3,0;;;32,0;;7,0;2,0;8,0;;;;;;13,0;;;;;;17,0;;18,0;21,0;30,0;3,0;;4,0;8,0;7,0;;3,0;;;;2,0;12,0;;;1,0;49,0;2,0;1,0;8,0;;;12,0;;;3,0;6,0;;2,0;;5,0;;;39,0;;;;2,0;;;;;;;;2,0;13,0;1,0;5,0;;;6,0;;;;;;;;;;;2,0;;;8,0;;;;6,0;1,0;;;;;;;;;;;;;1,0;;;4,0;2,0;3,0;;;;;;;;1,0;;;;;;1,0;;;1,0;;;1,0;;;;;;;;3,0;;3,0;;;;;;;;3,0;;;;;;;;1,0;;;;;2,0;;;;;;2,0;;;;;;;1,0;8,0;;;;;;;;1,0;;16,0;;;;;;;;;;1,0;;;;24,0;;2,0;;;;;;;;;;;;5,0;;;;;;;;;;;;;;;;;;1,0;;;;;;;;;;;;20,0;;1,0;;;;;;;;;;;;;;;;;;;;;;;;2,0;;;;;;;7,0;1,0;;;2,0;;;;;2,0;;;1,0;;;;;;8,0;;6,0;;;;;1,0;6,0;4,0;;;;15,0;;2,0;;;;;1,0;;;12,0;;;2,0;;;;;2,0;2,0;;;3,0;4,0;;;2,0;;;;3,0;;;18,0;2,0;;5,0;;;;5,0;;;;;1,0;;2,0;;;;3,0;11,0;2,0;;;3,0;;;;;;1,0;5,0;;;;;;;;;;;2,0;2,0;;;3,0;;;2,0;;2,0;23,0;2,0;;8,0;;;;;;2,0;;;1,0;;;3,0;;12,0;2,0;;5,0;;2,0;;;;;;;;;;3,0;;;;;;;;;;;;;;;;1,0;;;;;;;5,0;;;;;;;;;;2,0;;;;;;;;1,0;;;1,0;;;;6,0;;;2,0;;;;;;;;;;;;1,0;;1,0;;;;;;;;;;;4,0;;;;;;;1,0;;;;;;;;;;;;;;;;31,0;1,0;;12,0;;;;;;;;;;;;;;;;2,0;;;;;;;;;;;;;;;;;;;;1,0;;;;;2,0;;;;;;;;;7,0;2,0;;2,0;;;;;;3,0;;;;;;;;;;;;;;;;16,0;;;;;;;;;;;;;;;;;;;;;;;;;;;;;;;;;;;;;;;;;4,0;;;;1,0;;;;3,0;1,0;16,0;;;;;1,0;;;;;;;;;;;;;;;;;;;;;;;;;;;;;;;;;;3,0;;;;6,0;;;;;;;;1,0;;;;;;;;;;;;1,0;;;;;;;;;;;1,0;;;;;4,0;;;;;;;;;;1,0;;;;;;;;;;;;;;2,0;;;15,0;;;;6,0;;;;12,0;13,0;2,0;;;;;;;;;3,0;;;;;;;;;;1,0;;;;;;1,0;;1,0;;;;;;;;;;;;;;;;;;;;;;;;;;;;;;;;4,0;;;;;;;;;;;;4,0;1,0;;;;;;;;;;;;;;;;;;;;;;;;;;;;;;;;;8,0;;;;;;;;;;;1,0;;;;;;;;;;;;1,0;2,0;;;;;;;;;1,0;;;;;;;;;;;;;;;;
expression;;;;;3,0;;2,0;;;;6,0;;;12,0;;;6,0;1,0;;;;2,0;;;;;;;32,0;23,0;11,0;3,0;;;;7,0;1,0;1,0;;;29,0;9,0;2,0;;5,0;1,0;;2,0;;;;;;;;45,0;9,0;;;6,0;;;20,0;;30,0;;1,0;;;;16,0;109,0;2,0;;1,0;;2,0;;;;23,0;1,0;;6,0;2,0;;;20,0;;6,0;6,0;;;;;;;;2,0;7,0;9,0;2,0;;;1,0;3,0;;2,0;;;;;2,0;;;;;3,0;;;1,0;;2,0;;1,0;8,0;69,0;;;7,0;6,0;;;;;;4,0;1,0;9,0;;;;;;;4,0;;;2,0;;;;3,0;;;;;;;;;3,0;;;;;;;;4,0;;;;2,0;;;;;;;;;;13,0;;2,0;;;1,0;3,0;3,0;;;;;;;;;;;;;;;4,0;1,0;;;2,0;;1,0;;;;;;;1,0;;;2,0;4,0;;;;11,0;5,0;;;;;1,0;;;6,0;;;;15,0;;;;;;;;2,0;3,0;;;1,0;;3,0;;;;6,0;;;;;1,0;;;;;2,0;;;;;;;;;;4,0;;;;;5,0;;;;;;;;;;;;;;12,0;;;2,0;;;;;;;;6,0;;11,0;;;;;;;;;;;;3,0;;;;;;;1,0;;;;;;;;;;;;;1,0;;;;;;6,0;;;;;;;;;;;8,0;;;;;;;;2,0;;;;;;5,0;5,0;17,0;;;;3,0;;1,0;13,0;;;;12,0;;;;;;1,0;4,0;;;;;;2,0;;;;;1,0;43,0;3,0;;2,0;1,0;;;2,0;1,0;;8,0;;;2,0;;;;2,0;;;;3,0;;12,0;2,0;;;;;;;;2,0;6,0;;;;;;;;1,0;1,0;;8,0;;;1,0;;;;;;;;1,0;2,0;;;;;;;;;;;;1,0;;;;;;;;;;;;;;3,0;;;15,0;;;;;1,0;;4,0;;;;;;;;1,0;;;;;;;1,0;;;;;;;;;;;;;;;;;;;;1,0;;;1,0;;5,0;;;7,0;;;;;;3,0;;;;;;;4,0;;1,0;;;;;;;;;;;;3,0;;;;;;;;;;;;;;;;;;;;;;;4,0;;1,0;;3,0;;;;;;;;;84,0;2,0;;;;;;;;;;;;;6,0;;;;;;1,0;;;;;;;3,0;;;;;;;;;;;;;1,0;;;;;;;;;1,0;;;1,0;;;;;;;;;2,0;;;;;;;;;;;;;;;1,0;;;;;;;;;;;;;;;;;2,0;;;;;;;;3,0;2,0;;;;;;3,0;1,0;;;;;;;4,0;3,0;;;;;;;;;;;;;;;;;2,0;;;;4,0;;;;;;;;1,0;;;;;;;;;;;;;;;;;;;;;;2,0;;;;;;;;;;5,0;;;;;3,0;;;;;;;;;;;4,0;;;;;;;;;;;;;;;;;;;;;;;;;2,0;;;;;;;;;;;1,0;;;10,0;;;;;;;;;;1,0;;;;;;1,0;1,0;1,0;;;;;;;;;;;;;;;;;;;195,0;;;;;;;;;;;;;;;;;12,0;;;;;;;;;;;;;;;;;;;;;;;;;;;;;;;;;;;;;;;;16,0;;;;;;;;;;;;;;;277,0;;;15,0;;;1,0;;;;6,0;;;;;;;;;;;;;;;;;;;;;;1,0;;;;;;69,0;;;;;;;;;;;;;;;;;1,0
extraction;;;;;3,0;3,0;;4,0;;;;;;;;;6,0;;;;;;4,0;;;;;2,0;;;11,0;1,0;1,0;;;11,0;;;8,0;;5,0;16,0;;;;6,0;;25,0;;;1,0;;;;;;;;;13,0;;;;;29,0;;26,0;;2,0;;;2,0;4,0;;;;;;;2,0;8,0;;;4,0;6,0;;;;;3,0;1,0;;;;;;2,0;;12,0;5,0;14,0;14,0;;1,0;;4,0;;;;;;;;;;;1,0;1,0;;1,0;;;5,0;1,0;;2,0;6,0;;;;;;;17,0;;;;;;;;;;;;2,0;29,0;;3,0;;;;1,0;;;;;;;;;;7,0;1,0;;28,0;7,0;;;4,0;;;;4,0;;8,0;;;;;;;;;;;2,0;;6,0;;;;;;;;6,0;;;;;10,0;;2,0;1,0;1,0;;;;;;;;;;;20,0;;;;2,0;;;;;;;;;;;;;;;;;;;;;4,0;;;;1,0;;5,0;3,0;;;;;1,0;;;;;;;;;;5,0;;;;;;;;;;1,0;;;1,0;;;;;;;2,0;;;;;5,0;;;;;2,0;;;1,0;;;;;;;;;3,0;;2,0;;;;;;;;;;;;;;1,0;;;1,0;;;;1,0;;;;;;;;;;;;;;;;;;;;;2,0;;;;;1,0;;;;9,0;;;;;;;;;;;;;;2,0;1,0;;;;;;;;1,0;;;;2,0;1,0;;;;;;28,0;;;;;4,0;;;;14,0;;;;;;;;;;5,0;;;3,0;2,0;;;;2,0;;;;1,0;;1,0;;;;;;;;;;;;4,0;;;;;;;;1,0;;;1,0;;;;;;;;;;;2,0;;;;;;;;;;;;;2,0;1,0;;;;;;;;;;;;;35,0;1,0;;3,0;;;2,0;;;;;;;;4,0;;;;;4,0;;;;;1,0;;;;;;;;;;4,0;;;;;;;;;;;;;4,0;;;;;;14,0;1,0;;;;;;;;;3,0;;;;;;1,0;;;;;;;;73,0;;1,0;;;;;;;;;;1,0;;;;;;;;;1,0;;;;;;;;;8,0;;;;;;;;1,0;;47,0;;;;;;;;;;;;;1,0;;;;;;;1,0;;;;;;;;;;;;;;;;;;;;;;;;;;;;;;;;;;;2,0;2,0;;1,0;;;;;;;;;2,0;;;;;;;;;;;;;;;;8,0;;;;;;;;;17,0;;;;;;;;1,0;;;;1,0;;;;;;;;;;;;;;;;;;;;;7,0;;;;;;;;;;;;;;;;;;;;;;;;;;;;5,0;;;;;;;;;;;;;;;2,0;;;;;;;;;;;2,0;;;;;;;;;;;;;;;;;;;;;;;;;;1,0;;;;;;;;;;;1,0;;;;;;;;;;;;;;;;;2,0;;;;;;;;;;;;;;;;;;;;4,0;;;;;;;;;;;;;;;;;;1,0;;;;;;;;;;;;;;;;;;;;;;;4,0;;;;;;;;;;;;;;;;;;;;;;;;;;;;;;;;;;;;;;;;;;;;;;;;;;;;;2,0;;;;;;;;;;;;;;;;;;;;;;;;;;;;;;;;;;;;;;;;;;;4,0;;;;;;
fixture;;;;;1,0;13,0;;18,0;;;;;;26,0;;;2,0;;3,0;;;;;1,0;;;;1,0;;;32,0;;;;;;2,0;1,0;4,0;;;11,0;;4,0;8,0;18,0;;;;;;;16,0;;1,0;;3,0;;3,0;;;;;;3,0;2,0;35,0;;;;5,0;2,0;203,0;;3,0;;7,0;;;;3,0;;2,0;;12,0;;;3,0;;;;2,0;;;;;;8,0;6,0;12,0;5,0;3,0;;;;1,0;;;;;;;;;;;2,0;;;2,0;;5,0;1,0;2,0;;;20,0;;1,0;3,0;;1,0;;8,0;;;10,0;;;;;2,0;;;4,0;;3,0;6,0;5,0;32,0;;;;4,0;;;;;;;;7,0;;3,0;;;13,0;4,0;;;;;;2,0;;1,0;;2,0;1,0;;;;1,0;;1,0;;;;3,0;;;;;27,0;10,0;;37,0;;3,0;;;;;;;;1,0;2,0;;70,0;3,0;6,0;;;;2,0;;;;2,0;;;;;14,0;;16,0;;;1,0;;;2,0;;;;;;12,0;;;;;1,0;;;2,0;3,0;;1,0;;;;;;6,0;12,0;6,0;4,0;;;2,0;;1,0;3,0;1,0;;;;4,0;;5,0;3,0;2,0;3,0;;;;;;6,0;1,0;4,0;;;;6,0;;15,0;3,0;;6,0;;;;3,0;;;;;;;1,0;;;;;;;3,0;;;;;;1,0;5,0;;;13,0;;1,0;2,0;;6,0;;;8,0;19,0;;;;;6,0;;2,0;1,0;;;;;;;2,0;6,0;14,0;;4,0;;;;;;;4,0;3,0;4,0;;3,0;8,0;2,0;;;;;5,0;;5,0;;;;;;1,0;2,0;3,0;;1,0;;;21,0;;;3,0;2,0;6,0;;;;;;;;;1,0;1,0;;1,0;;;;;2,0;1,0;5,0;1,0;;;3,0;3,0;;3,0;;1,0;1,0;2,0;;;;;;;;;;14,0;;;2,0;;;;;;;;;;9,0;;;;;1,0;;;;;6,0;;;;3,0;2,0;;;;10,0;;;;;;2,0;;;;;;;;;2,0;2,0;1,0;;;;;;2,0;2,0;;4,0;1,0;;1,0;1,0;;;;;;1,0;;;;4,0;;;;;;;;4,0;;;1,0;;;1,0;;;;;;2,0;;;5,0;;;;;;3,0;;;;;;1,0;;;;;;;1,0;;;;;;;;;;;;6,0;;;;;;;;;;;3,0;;;;;;;;;5,0;;;1,0;4,0;4,0;;;1,0;;;12,0;1,0;;6,0;1,0;1,0;;2,0;;;;;;;;;;;;;;;;;;;;;;;6,0;;;;;;4,0;;;;5,0;;;;;;;;1,0;;;;;;;;;;;;;;1,0;;;5,0;;3,0;;;;;;;;;;;;;;;2,0;;;;;;30,0;1,0;1,0;;;;;;4,0;;;;9,0;;;1,0;;1,0;;;;1,0;;;;3,0;1,0;;;;2,0;;;1,0;;;;;;;;;;;2,0;6,0;;2,0;;;;;;;;;2,0;;;1,0;;;;;2,0;;;;;;;;;2,0;;;;1,0;;;;;;2,0;;;;;3,0;;;;;;1,0;;1,0;;;;;;;3,0;;;;;;1,0;;;;;;;;4,0;;;;;;;;;;;;;;;;;;;;;1,0;;;;;;;;;;;;;;;;;;;;;;;;;;;;;;2,0;;;;;;;;;;;;;1,0;;;;;9,0;;;;;;1,0;;;;;1,0;6,0;6,0;;;;;;;;;;;;;;;;;;;;;;;;;;;;;;;;;;;;;;;;;;;;1,0;;;8,0;;;;;;;;;3,0;;;;;;;4,0;;;;;;;;;;;;;;;;;;;;;;;;;;;;1,0;;;;;;;;;;;;;;;;;;;;;;;;;;;;;;;;;;;;;;;
foreground;;;;;5,0;;1,0;;;;;;;47,0;;;29,0;;;3,0;;;12,0;;;;;;5,0;1,0;5,0;;;;;9,0;7,0;;10,0;;66,0;12,0;;1,0;9,0;;;4,0;;;1,0;;;;;;;;;16,0;;;;;158,0;1,0;25,0;1,0;;;;3,0;14,0;;;;;1,0;;;41,0;;1,0;15,0;3,0;;;1,0;;;1,0;;;;;;128,0;2,0;31,0;1,0;12,0;2,0;;;1,0;11,0;2,0;2,0;;;;;84,0;;;;;13,0;9,0;5,0;1,0;;;38,0;;1,0;11,0;;;;4,0;;;18,0;;;2,0;;;;;;1,0;;;;;;12,0;;16,0;;7,0;;;;;;;;;;;;;;;;;19,0;;;;;;19,0;;;3,0;;;;;2,0;;;6,0;;59,0;;;;;;;;;;;;;;;;3,0;;;;;;5,0;9,0;;;;;;;;;;;4,0;;;;27,0;;;5,0;;;2,0;9,0;;;;;;13,0;;;;;;4,0;3,0;3,0;;;;;;;;;;;;;;;;3,0;;;;;1,0;;;;;1,0;;;;1,0;;;;;5,0;;11,0;;;;;;;;;;;;12,0;;;;;;;;;;;1,0;2,0;;;;;;;;;;;4,0;;157,0;3,0;5,0;;;;;1,0;;;;;;;;;;;;;;;;;1,0;30,0;1,0;;;;;1,0;;1,0;;;;13,0;;;;;2,0;;;1,0;;;;;;3,0;;5,0;;;;12,0;2,0;4,0;2,0;;;;42,0;12,0;1,0;;;6,0;;1,0;7,0;;3,0;;47,0;;;;1,0;;;1,0;4,0;;;4,0;;;26,0;;1,0;8,0;;;;;;;;;;;2,0;;14,0;;;;;3,0;;;;;11,0;;;;;15,0;;;3,0;;;4,0;;;;;1,0;;;;;;;1,0;;;2,0;;;2,0;;;;;;1,0;;;;;;;;;;;;;;8,0;;1,0;;;;;4,0;;;;;;;;1,0;;;6,0;;;;;14,0;;;;;;;;;;;;;1,0;;;;;;;;;;;;;;;;;2,0;;2,0;;;;;;;;;;;;;;;;5,0;;;;;3,0;;5,0;;7,0;;;1,0;1,0;;;;2,0;;;6,0;;;;;;;;;;;;11,0;;;;;;;;;1,0;;;;;15,0;;;;1,0;;;;;2,0;;;;1,0;;;1,0;;;;15,0;;;;;;;;;;;;;;;;;;;;;6,0;1,0;;;;;;;;;;2,0;9,0;;;;;;1,0;;2,0;;;;;;2,0;;;;;;;;;6,0;;;;;;;;;;;;;;;;;;;;;;;1,0;;;;;;;;;;;;;;;;;;;;;;;;;;;;;;;;4,0;;;;;;;;;;;;;16,0;;;;;;;;;;;;;;;;;;;;;;;;;4,0;;;;;;;;;;;;;;;;;;;;;;;;;;;;;;;;;4,0;;;;6,0;;;;;;12,0;;;;;;;;;;;;26,0;;;;;;;8,0;;;;;;1,0;;;;;;;;;;;;;;;;4,0;12,0;2,0;;;;;;;;;;;;;;;;5,0;10,0;;;;;;;;;;8,0;;;;;;;;;;;;;;;;;;;;;;;;;;;;;;;;;;2,0;;;1,0;;2,0;30,0;3,0;;;;;;;;;;;;;;;;;;;;;;;;;;;6,0;3,0;;;;;;;;;;;;;;;;14,0;;;;;1,0;;;;;;;;;;;;;;;;;;;;;;;;
gaming;;;;;2,0;;;;;;;;;1,0;;;;;;1,0;;;;;2,0;;;1,0;2,0;;3,0;3,0;;;;;;;2,0;;1,0;22,0;;6,0;23,0;1,0;;;;;;;;;1,0;;;;;;;;;1,0;2,0;;7,0;;;;;1,0;5,0;;;;;2,0;;1,0;7,0;;1,0;;12,0;;;;;;;;;;;1,0;;;;;1,0;;;;;2,0;;;;;;;;;;;;;;;;;;;;2,0;45,0;;;;;;;;2,0;;3,0;7,0;;;;;;;;1,0;1,0;;1,0;;;;;;;;;;;;;;;;;;2,0;;1,0;1,0;;;1,0;;;;;3,0;;2,0;;;;11,0;;;;;;;;;;;;;4,0;;;;;;;;;;;;;;;;;;;;;;;;4,0;;;;;;;;;;;;1,0;;;;1,0;;;;;;;;;;;;;;;;;;;;;;;;;;;;;;;1,0;;;;;;1,0;;;1,0;3,0;;;;;;;;;;;;;;1,0;;;;;2,0;;;2,0;;;;;;;;;;;;;;;;;;;;;3,0;5,0;;;;;;;;;;;;;;;;;;;;;;;;;;;;;;;;;1,0;;;;5,0;;;;;;;;;;;;;;;;;;;;;;;;;;;2,0;;;;4,0;;;;;;;;;;;;;;;;;;;;;;;;3,0;1,0;;;;;;;;;;;;;;;;;2,0;;;;;1,0;;;;;3,0;;;;;;;1,0;;;;;;;;;;;;1,0;;;;;1,0;;;;;1,0;;;1,0;;;;;;34,0;;;;;;;1,0;;;;;;2,0;;;;8,0;1,0;1,0;;;1,0;;1,0;;;;;1,0;;;;;;;;;;;;;;;;;;;;;;;;;1,0;;;;;;;;;;;2,0;5,0;6,0;;;;;;8,0;2,0;;;;;;;;;;;;;13,0;;;;;;;;;;;;;;;;;;;;;;;;;;;;;;;;10,0;;;2,0;;3,0;;;;;;;;;;;;;;;;;;;4,0;2,0;;;;;;;;;;1,0;;;;;;;1,0;;;4,0;;;;;;;;;;;;;;;;;;;2,0;;;;;;;;2,0;;;;;;;;1,0;;;;;1,0;;;;;;;;;;;;;;;;;;;;;;;;;;;;;;;;;;;;1,0;1,0;;;;;;;;;;;;;;;;;;;;;;;;;;;2,0;;;;;;;;;;;;;;;;;;;;;;;;;;;;;;;;;;;;;;;;;;;;;;;;;;;;;2,0;;;;;;;;;;;;;;;;;;;;;;;;;1,0;;;;;;;;;;;;;;;;;;;;;2,0;;;;;;;;;;;;;6,0;;;;;;;1,0;;;;;;;;;;;;;;;;;;;;;;;;;;;;15,0;;;;;6,0;;;;;2,0;;;;;;;2,0;;;;;;;;;;;;;;;;;;;;;;;;;;;;;;;;;;;;1,0;;;;;;;;;;;;;;;;;;;;;;;;;;;;;;;;1,0;;;;;;;;;;;;;;;;;;;;
gate;;;;;3,0;12,0;21,0;1,0;;;;1,0;;8,0;;;2,0;1,0;17,0;;1,0;;;;;;;11,0;;;70,0;30,0;;;;17,0;2,0;;2,0;;25,0;87,0;;2,0;1,0;18,0;;13,0;;;;;12,0;;14,0;;55,0;;18,0;9,0;;;8,0;;28,0;1,0;51,0;3,0;;;3,0;3,0;34,0;;;1,0;2,0;2,0;;2,0;22,0;;2,0;;1,0;;;1,0;;;1,0;;1,0;;;;60,0;24,0;58,0;;29,0;;;;3,0;;;6,0;;;;2,0;100,0;;;;;;5,0;33,0;1,0;;140,0;10,0;;1,0;22,0;;;1,0;15,0;2,0;;29,0;1,0;;2,0;;;;;2,0;;;71,0;16,0;11,0;61,0;4,0;1,0;4,0;1,0;4,0;3,0;;20,0;;;;;;113,0;;;6,0;;57,0;16,0;;17,0;;;3,0;57,0;;5,0;5,0;2,0;1,0;;;;1,0;24,0;;16,0;;;12,0;1,0;;;;;;2,0;;;1,0;;22,0;32,0;;15,0;2,0;;;6,0;10,0;;;;1,0;;;3,0;45,0;13,0;;2,0;2,0;20,0;;7,0;2,0;5,0;80,0;;;;;;4,0;3,0;2,0;;5,0;;;;3,0;1,0;;;;14,0;;15,0;77,0;;;10,0;;8,0;48,0;10,0;;10,0;2,0;;208,0;14,0;19,0;50,0;1,0;;;;;;;;;;;;2,0;7,0;;;;;;1,0;;;4,0;;45,0;;2,0;;;4,0;;;16,0;;;;;;;;;;1,0;;6,0;55,0;;;;2,0;;;8,0;;;6,0;;10,0;3,0;1,0;1,0;2,0;1,0;1,0;4,0;;;;;;;;;;;;;;;;;;;1,0;;;;;2,0;1,0;2,0;;2,0;2,0;4,0;;;;;5,0;;;2,0;;;;;;;;8,0;;1,0;;8,0;;72,0;;2,0;;;6,0;1,0;3,0;;;;6,0;;11,0;4,0;5,0;;4,0;;;;60,0;4,0;22,0;1,0;;;;;2,0;;;1,0;5,0;7,0;;1,0;;;;;;1,0;14,0;;93,0;;11,0;3,0;3,0;1,0;;22,0;;;;;3,0;33,0;11,0;;51,0;;;;;;;;;;55,0;1,0;1,0;;;;;;9,0;;3,0;;2,0;;;;;;;4,0;;;;;;1,0;2,0;34,0;;;5,0;;2,0;6,0;;1,0;;;;;3,0;;;;;;;;;;;;;4,0;;;;;;;;;;;;1,0;4,0;;;2,0;;;;;;;;;;;;;;;;;;;;;;;12,0;;;;;;;;;;;;12,0;;5,0;;;;;1,0;;;;;2,0;3,0;;;;;;;1,0;;;1,0;;;;;;4,0;3,0;;;;2,0;;;;;2,0;;;4,0;;;;;;15,0;;;;;;;;;;8,0;;;;;;6,0;;;;;;;3,0;;;;;;;;;;;2,0;5,0;16,0;;36,0;;;30,0;;;;;;4,0;;14,0;;1,0;;;;17,0;;;;;5,0;7,0;;;;;;26,0;;;;;;;;;;;;;13,0;;;;;;;2,0;;1,0;;;5,0;;;;;6,0;;6,0;3,0;;;;;;;;;;;;;8,0;;;;;4,0;;;;;;;;;;;;;1,0;1,0;;;2,0;;;;1,0;;;;;;;;;;;;2,0;;;;;;;;;;;;2,0;;;;;;1,0;;;;;;1,0;;;;;3,0;2,0;;;9,0;4,0;8,0;31,0;22,0;;30,0;4,0;18,0;20,0;;;23,0;9,0;36,0;157,0;25,0;25,0;;8,0;;;3,0;37,0;;;2,0;55,0;;85,0;;;;8,0;;;;10,0;;;;;;;608,0;;;;;;;;;;;;;;;3,0;;;;1,0;;;;;34,0;3,0;;8,0;;;1,0;;;;;;;10,0;3,0;1,0;;;;;;;;;;;;;;;;;;;;;;;;;;;;;;;;;;;;;1,0;2,0;;;;;;;;;;;;1,0;;5,0;;;;;;38,0;;;;;1,0;;;;;;4,0;;;;;;;;;;1,0;2,0;;;;;;;;;;;;;;;;;;;;;;;;;;;;;;;;;;;;;;;;;;;;;;;;;
gesture;;;;;4,0;24,0;;2,0;2,0;;;;;79,0;;;56,0;;;;;3,0;;;;;2,0;5,0;21,0;100,0;47,0;7,0;;;;35,0;25,0;12,0;8,0;2,0;128,0;212,0;2,0;56,0;142,0;;;13,0;;;;;3,0;;11,0;1,0;4,0;;;7,0;;;;;114,0;1,0;111,0;2,0;;;;1,0;;;33,0;28,0;;;4,0;5,0;138,0;;18,0;;15,0;;;;;1,0;4,0;5,0;;;7,0;;21,0;51,0;51,0;12,0;29,0;61,0;;4,0;20,0;44,0;2,0;10,0;;;;5,0;17,0;2,0;;2,0;;;1,0;85,0;37,0;;11,0;54,0;;10,0;142,0;;;;27,0;;5,0;89,0;1,0;;26,0;74,0;76,0;;;;;;;8,0;7,0;2,0;51,0;;;;5,0;;;;;;;;;;3,0;;;;6,0;;2,0;212,0;8,0;;;10,0;;8,0;;;3,0;;;;1,0;;;;6,0;;9,0;;;40,0;;6,0;;;2,0;;1,0;;;1,0;3,0;;2,0;13,0;;;;5,0;4,0;64,0;;;;2,0;5,0;2,0;;1,0;8,0;6,0;1,0;;;;69,0;;;;;;;4,0;;129,0;;;;4,0;;;;;;10,0;5,0;;37,0;;1,0;;;1,0;;;;19,0;;;;;39,0;2,0;;;;;;4,0;;;;3,0;;;2,0;4,0;1,0;;;;;;;;;;;;;2,0;;;;;20,0;1,0;;;;;;;;;22,0;2,0;;;;;;;11,0;;7,0;3,0;;1,0;25,0;25,0;2,0;;1,0;;;;4,0;;;;;1,0;2,0;;1,0;;;;7,0;4,0;;;;;3,0;43,0;;;2,0;;6,0;;3,0;;;;19,0;;37,0;;;10,0;2,0;20,0;4,0;;;;;;1,0;1,0;15,0;9,0;;30,0;8,0;;74,0;3,0;;3,0;;334,0;63,0;3,0;;6,0;18,0;31,0;6,0;6,0;;65,0;;49,0;23,0;9,0;;209,0;;41,0;;225,0;9,0;7,0;21,0;2,0;;6,0;5,0;9,0;100,0;3,0;;;2,0;;;123,0;;;11,0;28,0;;162,0;8,0;;11,0;4,0;4,0;;2,0;1,0;9,0;9,0;1,0;;;;24,0;1,0;2,0;24,0;2,0;;293,0;;;;14,0;;;;;8,0;;2,0;33,0;;;;;1,0;;6,0;;;18,0;36,0;53,0;18,0;;;;;2,0;3,0;;;;5,0;3,0;;70,0;1,0;8,0;3,0;;;;;;;43,0;2,0;9,0;;;3,0;;70,0;;2,0;1,0;;18,0;;3,0;;2,0;;;1,0;1,0;;;;2,0;;6,0;10,0;2,0;;;;;;;;;;1,0;;;;16,0;3,0;;2,0;;1,0;2,0;4,0;;;;24,0;;;37,0;3,0;6,0;25,0;;;;;;45,0;;;6,0;;;2,0;7,0;;;2,0;;;4,0;;;5,0;;;6,0;;;;;;;;12,0;;;10,0;;;;;;13,0;;8,0;;;4,0;27,0;4,0;;3,0;8,0;;;;;;;;;;3,0;;;;;;5,0;;;;;;;;;;;;;;;;;;2,0;;;;;;;;;;1,0;;;;;3,0;;;;;2,0;1,0;1,0;58,0;;;;;;;;;;;1,0;;;12,0;;31,0;;;;;7,0;4,0;;;;;;;4,0;;22,0;;;;;;;;1,0;;;;;;1,0;;;;;;;2,0;;;2,0;;;;;20,0;2,0;;;;;;;;1,0;12,0;;;;;;31,0;;;;;;62,0;2,0;10,0;;;;;;;;4,0;;;;;;;;;;;;;;3,0;1,0;1,0;;;;;;;;;;;4,0;;;;;;;;;;;;;;1,0;;;;;;2,0;;;;;;;;;;;;;;1,0;;;;2,0;;;;;;6,0;;;;;6,0;;7,0;;2,0;;;;;;;;;;;;1,0;;7,0;19,0;;1,0;;;1,0;3,0;;6,0;;;;;;;;;;;;;1,0;;;;1,0;;;;;;;4,0;;;;7,0;4,0;;;;;;;4,0;;;;8,0;;;;;2,0;;;;;;;;;;;1,0;2,0;;;;;;;;;4,0;;;;;6,0;;;;;;;;;;;;;;;;;;;;;;;;;4,0;;;;1,0;;;;;;;;;;;;;;2,0;5,0;;2,0;;;;;;;;;;;;;;1,0;;;;;;;1,0;;
grid;;;;;19,0;3,0;16,0;2,0;;;;;;65,0;;;12,0;;;1,0;;;2,0;1,0;1,0;;;3,0;8,0;;13,0;2,0;;1,0;;14,0;27,0;;12,0;;129,0;11,0;;;22,0;4,0;1,0;3,0;;2,0;1,0;;;;7,0;;7,0;;;10,0;;1,0;1,0;;84,0;;36,0;7,0;;;;2,0;4,0;;;;3,0;;;2,0;33,0;;2,0;3,0;1,0;;;21,0;1,0;;10,0;;;1,0;;;27,0;3,0;89,0;101,0;13,0;6,0;;;1,0;2,0;;1,0;;;;3,0;29,0;;;;30,0;36,0;6,0;10,0;1,0;2,0;1,0;15,0;;4,0;26,0;;2,0;3,0;4,0;;;6,0;8,0;;10,0;2,0;;;;12,0;;;;4,0;4,0;18,0;12,0;2,0;;2,0;3,0;;;;;;8,0;;;;2,0;;;8,0;12,0;;4,0;;;;2,0;2,0;;1,0;;;;;;;;7,0;;;4,0;;22,0;;;;;;;;;;;;;;;;;1,0;;;;1,0;;5,0;;2,0;;;4,0;;;;41,0;4,0;;;;;24,0;;;1,0;;;;;;;;;;13,0;;;;;;3,0;6,0;;9,0;;;;;4,0;6,0;;;;;;;;;;;;;;2,0;;;3,0;;;;;1,0;4,0;;3,0;2,0;;6,0;;;;;;;;;91,0;;;16,0;;15,0;;;;;;;12,0;;;;;;5,0;;;;;;;4,0;;;;1,0;20,0;;1,0;;;;;1,0;6,0;;;;;1,0;29,0;;;;;;;;;;;87,0;6,0;;;;;;;4,0;;;;7,0;;;;;;;6,0;;;;;;;;5,0;2,0;;;;1,0;;4,0;74,0;;1,0;;1,0;;2,0;;;14,0;1,0;;;;4,0;;12,0;14,0;;;;;18,0;3,0;3,0;;2,0;1,0;;;;;;;;;;;3,0;;;;;;6,0;;2,0;;;;;4,0;;;;;;;;;;31,0;;2,0;;1,0;;2,0;;;;;;7,0;;;26,0;;;1,0;;;1,0;;;;;;;1,0;3,0;;;;;;;;;;;;1,0;;;;2,0;;1,0;;;;3,0;;;56,0;;;;;;;;;2,0;;;;;;1,0;;;;;;1,0;;;;;;;;;;;;;;;;2,0;2,0;;;;;;;;;;4,0;;;;;;;;;70,0;;;;;;;;;;;;;4,0;;;;;;;;6,0;6,0;;;;;;;;;;;;;;2,0;;;;;;;;;;;;;;;;;;;;;1,0;;1,0;;;;;;;1,0;;;3,0;;;1,0;;;;;;;;;3,0;;;;;;;;;;;;;;;;;;;;;;;;2,0;;;1,0;;;;;;;;;4,0;;4,0;;;6,0;;;25,0;;;1,0;;;;;;;;;;;;;;;;4,0;;;;;6,0;;;;;;;;;;6,0;5,0;;;;;;;;;;;;;;;3,0;;;;;;;;;;;;;2,0;;;;;;1,0;;;;;;;4,0;;;;;;;;;1,0;;;;5,0;;;2,0;;;;;;;;;;2,0;;;;10,0;;;;;;;;;;;;;;;;;;15,0;;;;;;29,0;13,0;3,0;;;;;7,0;;;;;;2,0;;;2,0;;;;;1,0;;;;;;;;;;;;;;;11,0;;;2,0;;;;;;;;;18,0;;;;;;1,0;;;;;;;;;;;;;;;;3,0;;;;;;;;;;;;;;;;;;;;;;;;;;;;;;;;;2,0;;;;;;;;;;;;;;;;;;;;;;93,0;;;;;;;;;;;;;;;;;;;;;;;;;3,0;6,0;;;;;;;;2,0;;;;;2,0;;;;;;;;;3,0;1,0;;2,0;6,0;;;;;;;;;;6,0;;;;
heat;;;;;6,0;14,0;4,0;19,0;;;;;6,0;19,0;;2,0;4,0;;;;8,0;;;4,0;1,0;;;58,0;;;104,0;15,0;;;;3,0;3,0;10,0;5,0;;3,0;45,0;1,0;8,0;19,0;28,0;;187,0;;;;;16,0;15,0;1,0;;29,0;;1,0;185,0;;;14,0;;43,0;;68,0;3,0;;;;61,0;19,0;3,0;;;42,0;2,0;;4,0;41,0;;2,0;;113,0;;;6,0;;10,0;;6,0;6,0;1,0;;;2,0;;41,0;1,0;20,0;;;3,0;5,0;34,0;;;;;;;6,0;;27,0;;;2,0;4,0;49,0;;;5,0;1,0;;;53,0;;;;;;2,0;61,0;;;3,0;;;11,0;;4,0;;;1,0;14,0;9,0;21,0;1,0;16,0;;8,0;70,0;9,0;;;;3,0;;;113,0;20,0;1,0;30,0;;;45,0;8,0;;2,0;3,0;;12,0;4,0;4,0;13,0;9,0;5,0;12,0;;;;7,0;17,0;;12,0;;1,0;61,0;21,0;;;;2,0;6,0;8,0;109,0;1,0;13,0;7,0;2,0;16,0;;;1,0;1,0;106,0;13,0;;56,0;1,0;1,0;;;1,0;16,0;;9,0;;13,0;6,0;;;4,0;52,0;;131,0;10,0;8,0;28,0;19,0;74,0;1,0;;19,0;;;;6,0;;6,0;24,0;;;11,0;3,0;17,0;7,0;37,0;;1,0;1,0;;17,0;17,0;20,0;12,0;83,0;13,0;8,0;141,0;2,0;;4,0;14,0;28,0;8,0;;2,0;38,0;2,0;1,0;4,0;20,0;;;3,0;1,0;1,0;1,0;1,0;;2,0;59,0;;;;4,0;67,0;2,0;15,0;2,0;1,0;1,0;;;3,0;3,0;1,0;;1,0;;1,0;44,0;;2,0;;7,0;1,0;17,0;;;16,0;;2,0;;18,0;;;4,0;;;2,0;;12,0;3,0;1,0;;12,0;5,0;9,0;;;3,0;1,0;;1,0;;1,0;;2,0;;;;6,0;;;5,0;;1,0;4,0;;;;;5,0;1,0;14,0;17,0;2,0;5,0;;1,0;;1,0;;1,0;;;;2,0;;2,0;1,0;1,0;;;;;;8,0;;2,0;4,0;;9,0;;;;1,0;;;;6,0;12,0;4,0;1,0;;2,0;2,0;;4,0;4,0;4,0;;;;1,0;2,0;2,0;;1,0;1,0;8,0;15,0;1,0;;;;;;1,0;;;;10,0;;5,0;4,0;;1,0;;4,0;2,0;;;4,0;3,0;;;40,0;;3,0;;;;;1,0;;;;;22,0;;2,0;;;2,0;;;;8,0;;2,0;;;;;;;;2,0;5,0;2,0;11,0;;6,0;;12,0;2,0;;;2,0;;10,0;5,0;1,0;1,0;;;;;;;;;;12,0;;;;;;;;;;;;;;;;2,0;;8,0;5,0;;;46,0;3,0;9,0;;;;;3,0;;2,0;;;;1,0;1,0;;;;;18,0;;;;;16,0;;;;;;;;;;;;;;;;2,0;;;;29,0;;;;;;;;;;18,0;5,0;2,0;2,0;4,0;;;;;;1,0;1,0;7,0;;;;;1,0;;;;3,0;;2,0;1,0;2,0;1,0;;;;;;;;;;;1,0;2,0;;;;;3,0;;;3,0;;;;;;;5,0;;;;;7,0;;;;;;;1,0;;;1,0;1,0;;;1,0;;1,0;;;;;;;;3,0;;;;;;1,0;;;;;;;;;7,0;;;1,0;;1,0;;;4,0;;;1,0;;10,0;3,0;;1,0;;2,0;;;;;;;38,0;6,0;1,0;;;1,0;;;;;;;30,0;;;;;;;;4,0;;5,0;;2,0;;;6,0;;;;;;;;2,0;4,0;;1,0;1,0;;10,0;;;;;;7,0;;;;;1,0;;;;;26,0;;;;1,0;;9,0;;;15,0;;3,0;;;4,0;;2,0;;;;;;;;2,0;;2,0;;2,0;;;;40,0;;1,0;;;;;;;;;14,0;4,0;;;;4,0;;;;;;1,0;;;;;;;;;;;;1,0;;;;;;2,0;;;;;20,0;;;;;;;;;13,0;;2,0;1,0;;;;;;;;;;;1,0;;;;;;;41,0;;2,0;;;;;;;;1,0;;;;;;;;;;;;1,0;;;;;;;;;;;18,0;;;;;;;;;;;;;;20,0;;;1,0;1,0;;;2,0;;;;;;;;;;;;;;2,0;;;;;;9,0;;;;1,0;;;;;;7,0;;;3,0;;;;;;3,0;;;;;;;;1,0;;;1,0;;;;;;;;;2,0;;;;;;;;;;;;;;;;;;;;;;;;;;2,0;
hook;;;;;8,0;9,0;1,0;2,0;;;;;;18,0;;;2,0;;;;;;;;;;;1,0;;;17,0;;;;;;5,0;;;;;12,0;;;14,0;6,0;;18,0;;;;;3,0;;;;16,0;;;;;;6,0;1,0;19,0;;21,0;;;1,0;3,0;;1,0;;;;15,0;;;;4,0;;;;10,0;5,0;;;;;;;;;;;;;4,0;12,0;76,0;6,0;;;1,0;;;;;;;11,0;3,0;4,0;1,0;;;4,0;;;;;;2,0;;;4,0;;;;;;;17,0;;;;;;;;1,0;;;;;;2,0;2,0;22,0;;;24,0;1,0;;;;;;;;5,0;;;;;6,0;6,0;;4,0;;;;13,0;;13,0;;;;;;;;6,0;8,0;;;;6,0;9,0;;;;;;20,0;7,0;;;3,0;;;;2,0;;;17,0;;1,0;12,0;;;1,0;;;;;;;;;;;;4,0;;23,0;;;;;;;;14,0;1,0;;;1,0;;;;;;;5,0;;12,0;9,0;16,0;7,0;;;1,0;;;11,0;17,0;;;;;;17,0;4,0;;;;;;;1,0;;;;;;5,0;;;17,0;;2,0;;;;1,0;5,0;;;;4,0;;1,0;6,0;5,0;3,0;;;16,0;4,0;3,0;;;10,0;6,0;2,0;14,0;3,0;4,0;1,0;1,0;;23,0;;11,0;2,0;3,0;;11,0;3,0;;3,0;2,0;4,0;;;;;;12,0;1,0;3,0;11,0;;;3,0;;3,0;;3,0;;;2,0;;24,0;;5,0;;3,0;;15,0;;;;;;1,0;;;;;;;;;;;;;;;20,0;6,0;;;;;;;;;;;;;;;;;;;2,0;;;;;;3,0;;;;1,0;;;;;14,0;;1,0;;;;1,0;8,0;;;;;;;;;;;13,0;;;;;;;4,0;;;;;;;;;1,0;;;;;;;;;;;;2,0;;1,0;17,0;;3,0;;;6,0;;;;;;;;;;;;;2,0;;;;;;;;;;;;2,0;;1,0;;;;;2,0;;;18,0;;;;;;;1,0;;5,0;;;;;;;7,0;;;;;1,0;;;;16,0;;;;;2,0;1,0;;;;;;;;;;;;;;;;1,0;;;;;;;1,0;1,0;;;;1,0;;3,0;1,0;;;;;;;;;;;;;;;2,0;;;;;;;;;;;;;1,0;;;;;;;;;;;;;1,0;;;;;;;3,0;;;;;;;;;2,0;;;;;;;;;;;;;;;27,0;;;;;;;2,0;2,0;;;;;;;;;;;;;;;;;;;;;;;;;;;;;;;;;;;;;;;;;;;;;;;;;;4,0;2,0;;23,0;;;;1,0;;;1,0;;;;;1,0;4,0;1,0;7,0;;;;;;;;4,0;;;1,0;;;;;;;;;;;;;;;;;1,0;;;;1,0;;;1,0;6,0;;;;;;3,0;;;;;1,0;;;;;1,0;;8,0;;;;;;;;;;;6,0;1,0;;;;;;;;;;;;;;;;;;;;;;;;;;;;;;;;;;;;;;;;;;;;;;;;;;;;;;;;;;;;;;;;;2,0;;;;;;1,0;;;;;;;;;;;;;;;;;;;;;;;;1,0;;;;;;;;;;;;;;;;;;;;;;;;;1,0;;;;;;;;4,0;;;;;;;;;;;;;;;;4,0;;;;;;;;;;;;;;;;;7,0;;;;;;;;;;;;;;;;;;;;;;;;;;;;;;;;;;;;;;;;;;;;;;;;;;;;;;;;;;;;;;;;;;
impurity;;;;;8,0;7,0;;;;;;;;1,0;;;;;4,0;;;;;;;;;;;;15,0;;;;;;;;19,0;;;9,0;;;;;;5,0;;;;;12,0;;;;57,0;;;6,0;;;1,0;;3,0;;15,0;6,0;;;;;2,0;;;2,0;2,0;;;;3,0;;;;2,0;;;;;;;;1,0;;;;4,0;1,0;10,0;;23,0;;;;;;;;;;;;359,0;;;;;;;17,0;;;;;;;;;;1,0;;8,0;;28,0;1,0;;3,0;;;;;;;;;;1,0;19,0;;;;;;9,0;;24,0;;;;;19,0;;;;;;;2,0;10,0;;;;;29,0;;;;;;;;;;;;2,0;;;;;;;1,0;;;;2,0;;;;;10,0;;;;;;;;;;;;;;;;;;;;;;7,0;;;36,0;;;;;;;;;;;;;;;;;;;;;;13,0;;;;;6,0;12,0;;;15,0;2,0;;14,0;;106,0;;;;;;;4,0;;;;;;;;;;;;;;;;;4,0;1,0;;;;;;;;;;;;;;;;;;;;;;4,0;;;;;;;;;;;;;7,0;3,0;;1,0;;;;;;;;;;;;;;;;;;;;;;;;;;;;;;;;;;;;;;;;;;;;;;;;8,0;2,0;;;;;;;;;;;;;;;;;;;;;;;;;;;;;;;;;;;;;;;;;;;;;;;;;2,0;;;;;;;;;;;;;3,0;;;;;;;;;;;;;;;;;;;;;;;;;;;;;;;;;;;;;;;;;;;;;;;;;;1,0;;;;;;4,0;;;;;;;;;;;;;;;;;;;;;;;;2,0;;;;;;;;;;;;2,0;;;;;;1,0;;;;;;;;;;;;;;;;;;;;;;;;;;;;;;;;;;;;;;;;;;;;;;5,0;5,0;;;;;;;;;;;;18,0;;;;;;;;;;;;;;;;8,0;;;;;;;;;;;;;;;;;3,0;;;;;;;;;;;;;;;;;;4,0;;;;;;;;12,0;;;3,0;;;;;;;;;;;;;;;2,0;;;;;;;;;;;;;;;;;;;;;;;;;4,0;;;;;;;;;;;;;;;;;;;;;;;;4,0;;;;;;;;;;;;;;;;;;;6,0;;;;;;;;;;;;;;;;;;;;;;;;;;;;2,0;;;;;;;;;;;;;;;;;;2,0;;;2,0;4,0;5,0;;;;;;65,0;6,0;;;30,0;;1,0;32,0;;5,0;;;2,0;;;;;;1,0;;;81,0;;;;;;;;;;;1,0;;;;11,0;;;;4,0;;;;;;;;;;;;;;;;;;;;;;;;;;;;;;;;;;;;;3,0;;;;;;;;;;;;;;;;;;;;;;;;;;;;;;;;;;;;;;;;;;;;;2,0;;;;;;;;;;;;;;;;1,0;;;;;;;;;;;;;;;;;;;;;;;;;;;;;11,0;;;;;;;;;;;;;;2,0;;;;;;;;;;;;;;;;;;;;;;;
instrument;;;;;1,0;16,0;;;;;;;;7,0;;;27,0;;8,0;;;;;;3,0;1,0;;2,0;4,0;1,0;15,0;3,0;;;;12,0;5,0;;1,0;;19,0;31,0;;;5,0;;;2,0;2,0;2,0;;;9,0;1,0;3,0;1,0;;;;4,0;;;1,0;;77,0;;17,0;;;;;5,0;3,0;;;;;6,0;;;21,0;;;3,0;6,0;;;77,0;;;;;1,0;;;;4,0;;25,0;27,0;21,0;2,0;5,0;5,0;7,0;3,0;;;;;;17,0;6,0;;;;;;;17,0;;;2,0;;;2,0;50,0;;3,0;;;;;13,0;;;13,0;;;;;3,0;;;;;1,0;2,0;2,0;3,0;;;;;;;;;;;;2,0;;;;;9,0;2,0;;;1,0;;1,0;;;2,0;;3,0;1,0;;;1,0;;;;;1,0;1,0;9,0;1,0;;;;5,0;1,0;;4,0;;;2,0;;;;;4,0;;6,0;1,0;5,0;4,0;;1,0;;;;;5,0;6,0;;3,0;;;;;3,0;;24,0;;;;;;1,0;;;;;;;;;;1,0;;;4,0;2,0;;5,0;;;;;2,0;;;2,0;3,0;2,0;;1,0;2,0;;4,0;;;;1,0;;;;;2,0;4,0;7,0;;1,0;;;;;;7,0;;;;;3,0;;;;;;;;6,0;1,0;;;;3,0;;1,0;2,0;;1,0;1,0;1,0;;4,0;;;1,0;;1,0;1,0;6,0;2,0;;2,0;1,0;2,0;;;2,0;;;;3,0;;;;;;;;;;;;1,0;8,0;;;;;;;;;;;;;;1,0;;;1,0;2,0;;;;1,0;;1,0;;;26,0;;;;;11,0;;1,0;;;;;12,0;23,0;;;;6,0;;;;;;;;;;;;3,0;;;;5,0;;;2,0;25,0;;31,0;1,0;;;;;;;12,0;;;;;;;;;1,0;9,0;;2,0;;;;;;;;;;;;;;;;;1,0;;;;;;;;;2,0;;;;6,0;;2,0;2,0;1,0;;1,0;38,0;;;7,0;;;;3,0;1,0;;3,0;;3,0;;;;;3,0;;1,0;;;2,0;9,0;;2,0;;1,0;;1,0;;;1,0;;;;1,0;1,0;;1,0;;2,0;;;;;;;;;;;;;;;;;;;1,0;;1,0;1,0;;;;;;7,0;3,0;;;;;;;;;1,0;;;;;7,0;;;;;;;;;2,0;;;;;;;;;10,0;;;1,0;;;1,0;;7,0;10,0;;7,0;;;;;;;;1,0;18,0;;;;;;;;;;;;;3,0;;;;;1,0;;;;;;1,0;;;;;;;;;;;;;2,0;;;;;;;;;;6,0;;;;;;;;;;;;1,0;;;;;;7,0;1,0;;;;;2,0;1,0;1,0;2,0;;;;;;4,0;;;;1,0;3,0;;;;;;;4,0;;;14,0;;1,0;;;2,0;;;;;1,0;;1,0;;;;;;;;;;1,0;;;;;12,0;;;;;;;1,0;;;;;;;;;2,0;1,0;3,0;1,0;;;;;;2,0;4,0;;3,0;;;;;;;1,0;;;;2,0;;;;;;1,0;3,0;;;;;;;;;1,0;;;1,0;;2,0;;;;2,0;;;;;;;;;;;;;;;;;;;;;;;;;1,0;;;;;;1,0;;;;;7,0;;;;;;;;;;;;;;;2,0;;2,0;;;;;;;;;;;;;;;;;;;;;;;;;;2,0;;;;;;;;;;;;;;;;;;;;;;4,0;;;;;2,0;;;;;;;;;;;;;;;;;;;;;;;2,0;;;;4,0;;;;;;;;;1,0;1,0;;;;;;;;;;;;;;;;;;;;;;;;;;;;;;;;;;;;;2,0;;;;;;;2,0;1,0;1,0;;;;;7,0;;2,0;;;;;;;;;1,0;;;;;;;1,0;;;;;;;;;;;;;;;
modulation;;;;;9,0;2,0;4,0;2,0;;;;;;32,0;;;1,0;;1,0;3,0;;;4,0;;2,0;;;2,0;2,0;1,0;27,0;2,0;;;;2,0;3,0;4,0;4,0;;16,0;37,0;;;;;;7,0;;;;;;;2,0;;;;271,0;33,0;;;;;34,0;;25,0;;;;;3,0;116,0;;;;;19,0;;;21,0;;1,0;1,0;5,0;;;9,0;;8,0;;;;4,0;;;17,0;1,0;10,0;;14,0;;;2,0;2,0;5,0;;;;;;10,0;16,0;;;;;1,0;7,0;25,0;18,0;;147,0;2,0;;;20,0;;1,0;;28,0;1,0;;33,0;4,0;;;12,0;;;;3,0;;10,0;;1,0;9,0;;10,0;;1,0;;1,0;;;2,0;;;;;;7,0;;;;;2,0;;;1,0;;1,0;4,0;;;;;30,0;1,0;;4,0;;;;;;;;1,0;;;;;;;;;2,0;;;;;;;7,0;;;;;;;;6,0;;;;19,0;;;;10,0;7,0;;;;;15,0;;;2,0;;4,0;;2,0;;;4,0;;;;;;;;;;;;;;;;1,0;;;12,0;;;;;20,0;8,0;1,0;3,0;;;3,0;1,0;;;;;;1,0;;;;;;;;;;;3,0;;2,0;;7,0;;;;;;;;15,0;;;;;;;;;;;;;1,0;;;;;;;;;1,0;1,0;;16,0;;;;;;;4,0;;;;;;;;;;;;;;;;;;;;;;;;;;;;;;1,0;;6,0;;;;;;;;;1,0;;;;;1,0;;;;;;50,0;;21,0;;;5,0;4,0;7,0;;1,0;;;6,0;6,0;;25,0;;4,0;2,0;;;1,0;;19,0;;1,0;;;;;;;;5,0;1,0;;;;;;;25,0;;;;34,0;;;1,0;;22,0;;;;;;;;;1,0;;;;;;;;;2,0;;;6,0;;;;;;9,0;;4,0;3,0;;;;;6,0;;;1,0;;;2,0;1,0;1,0;;;14,0;;5,0;;;2,0;;5,0;4,0;;12,0;4,0;;;;;;13,0;4,0;;;;;;;;;;;;;;;6,0;30,0;;;;;2,0;;;;;;;;;;;;;;;;;;;;;;;;;;;;;;;;;;;;;;;;;;;;;1,0;6,0;;;18,0;;;;;;;;1,0;;;;;;;;;;6,0;;5,0;;;;4,0;2,0;;;1,0;;;;;1,0;3,0;;6,0;;;2,0;;;;;3,0;;;6,0;;;;;;4,0;;;;;3,0;;;;;;;;;;;;;;;;;25,0;1,0;;;;;;;;1,0;;;;;;1,0;;;;;;;2,0;;;2,0;;;;;;34,0;;;;;;1,0;;3,0;;;;;;;;1,0;;;;;;10,0;;;;;;;;15,0;;;;2,0;;;;;;;;;;;13,0;;;;;;;;;;;;;;;;;;;2,0;;;;10,0;;;;;;;9,0;;;;;;;;;;;;;;;;;;;;;;;;;;;;;;;;;;;;;;;;;4,0;14,0;;;;;2,0;;;;;;;;;;;;;;;1,0;8,0;;2,0;;;;;;;;;;;6,0;;;;1,0;;;;;;;;;;;;4,0;;;1,0;;;;;;;;4,0;;;;;;;1,0;2,0;;;;;2,0;1,0;;;26,0;;;;5,0;1,0;;;;;6,0;;1,0;;;;;;;;;;;;;4,0;;;1,0;;;;;;;;;;;;;;;;2,0;1,0;;;;;;;;;;;;;;;;;;17,0;;;;;;1,0;;;;;;;;;;;;;;;;;;;;;;;;;1,0;;;8,0;;;;;;;;;;;;;;;;;;;;;;;1,0;;;;;;;;;;;;6,0;;
neighboring;;;;;2,0;4,0;5,0;;;;;;;16,0;;;9,0;1,0;;;;;;;;2,0;;2,0;;1,0;5,0;2,0;;6,0;;;;4,0;12,0;;34,0;10,0;;;2,0;1,0;;;;;23,0;;1,0;;2,0;;15,0;;;2,0;;;15,0;;60,0;;9,0;;;2,0;2,0;25,0;6,0;;;;;8,0;;;30,0;;2,0;;3,0;;;5,0;;;3,0;1,0;;;;;171,0;;30,0;47,0;22,0;1,0;;14,0;;12,0;;2,0;;;;23,0;4,0;;;;;4,0;;6,0;1,0;;4,0;2,0;;3,0;11,0;;;;8,0;;;1,0;;;2,0;6,0;;;;;;;;;6,0;4,0;;;;2,0;;;;;;;;;;1,0;;;;10,0;;1,0;;;;;1,0;9,0;;1,0;;;;;;;;;;;;;29,0;;;;;;;;1,0;;2,0;;1,0;3,0;;;4,0;1,0;3,0;;;;;;;;;;16,0;;1,0;;1,0;;;4,0;;;1,0;;;;;;8,0;;;;;;;9,0;;2,0;;;;7,0;3,0;;2,0;;;;;1,0;;;;;11,0;;;1,0;;;;;;;1,0;;;;;;;;;27,0;1,0;;;;1,0;;;;;;;2,0;;;;;;;9,0;;;1,0;;;;2,0;;;;;;2,0;;;;;2,0;;1,0;;;;;;;7,0;;;;;;;;;;;;;;;;;;;;;;;;3,0;;;;;;;;;;3,0;2,0;;5,0;;;;;;;;;;;;2,0;1,0;;;;;1,0;3,0;;;;;2,0;1,0;;16,0;;;4,0;;;;;2,0;;20,0;1,0;;;13,0;;;;16,0;;;1,0;;;;;;;7,0;;;;;;;;;;5,0;;;;;;;;;;;1,0;;1,0;;;;6,0;;;;;;;;;;;;;2,0;;;;;6,0;;;;;;1,0;;;;;;;;;1,0;;;;;3,0;;;2,0;;;8,0;;;;;;;;;;;;;;;;;;11,0;;;;;4,0;;2,0;;;;;;1,0;;;;;;;;;;;;;;;;;;;1,0;;1,0;7,0;;;;;;;;;;;;;;;;1,0;;3,0;;;;;;;;;;;;;;;;;;;;;3,0;;;;;;;3,0;;;;;;;;;;;;;;;;;;7,0;;;;;;;;;;;;;;;;;;;16,0;;2,0;2,0;4,0;;;;;;;5,0;;;;;;;;;;;;;;;;;;;;1,0;;;;;;;;1,0;;;;;1,0;;;;3,0;;;;;4,0;;;4,0;7,0;;;;;;;12,0;;;;;;;;;;;;;;;5,0;;;;;;;;;;;;;;;;;;2,0;;;;;;;;;;;;;;;8,0;;;;;6,0;2,0;;;;;4,0;;;;;;;;;;;;;;;;;;;;;;;;;3,0;;2,0;;;;;;;;;;;;;7,0;;;;;;;2,0;;;;4,0;;;;;;;;;;;;6,0;2,0;;;;1,0;;7,0;1,0;;;4,0;;4,0;;;;;;;;;;;;;;1,0;;;;;;;;21,0;;;;;;;;;;;;;;;;;;;;;;;;;;;;;;;;;;;;;;;;;;;;;;;1,0;;;;;;;;;;;;;;;;14,0;;;1,0;;;;;;;;;;1,0;;;4,0;;;;;;;1,0;;;;;;;;;;;;;;;;;;;;;;;;;;;4,0;;;;;;;;;;;1,0;;;;;;;;;1,0;;;;;6,0;8,0;;;;;;4,0;;;;;;;;1,0;;;
photodetector;;;;;1,0;2,0;112,0;;;;;11,0;;8,0;;;10,0;2,0;;;;;;;;;;1,0;1,0;;13,0;;;;;7,0;;;;;2,0;17,0;;;1,0;14,0;;6,0;;;;1,0;;;10,0;;7,0;;2,0;17,0;;;;;33,0;;17,0;;;;;26,0;82,0;;;2,0;;6,0;1,0;1,0;23,0;;;;14,0;;;9,0;2,0;1,0;;3,0;9,0;;;;14,0;5,0;22,0;;1,0;;;;;5,0;2,0;1,0;;;;4,0;2,0;;;;;10,0;6,0;33,0;2,0;;18,0;;18,0;;11,0;;;4,0;19,0;;;3,0;;;11,0;2,0;;;;1,0;;;6,0;;;7,0;14,0;;;5,0;;;;6,0;;1,0;;;;;;2,0;1,0;;7,0;;;4,0;4,0;;10,0;;;;;2,0;;;;4,0;2,0;;;;16,0;;;1,0;1,0;;;;;1,0;;18,0;4,0;;;;;;2,0;2,0;;;;2,0;;;;;;;24,0;;;6,0;3,0;1,0;;4,0;8,0;;10,0;;;4,0;;;7,0;;;;;;;1,0;;;;;;2,0;16,0;;1,0;;;;;4,0;12,0;;;7,0;;;;;2,0;;;;1,0;4,0;;;;4,0;;;4,0;;;;;;;;;;;;;1,0;1,0;;;;;;;;;;;;;;;;;;;;;1,0;;;;;;;1,0;;;;;;;;;;;;;;;;;;;;;;;;;;;;;;7,0;;;;;;;;;;;;1,0;;;;;;;;;;;;;;;;;;;;;;;1,0;;;;9,0;;1,0;;5,0;;;;;;6,0;1,0;;4,0;;;6,0;7,0;1,0;;;2,0;;;;;;;;;;;1,0;;;;;2,0;4,0;2,0;8,0;;3,0;;;6,0;;;;;;;;;;;;1,0;;;;;;;;;;;;;;;;;;;;;3,0;;;;;;;;;;;;;;;;;;;;3,0;;;3,0;;;;;;;;;;;;;;;2,0;;;;;;;;;;;;;;2,0;;;;;;;;;;;;;;;;;;;;;;;;;;;;;;;;;;;;;;;;;;;;;;;;;;;;;;;;;;;;;;;;;;;8,0;;;5,0;;;;4,0;;;;;;;;2,0;;;;;;;;;;;;;;1,0;;;;;;;6,0;;;;14,0;;;;;;;;;;;;;;;;;;;;;;;;;;;;;;;;;;;;25,0;;;1,0;;2,0;1,0;;;;;;1,0;;;;;;;;6,0;;2,0;;;;;2,0;;;;;;;;;;;2,0;;;;;;;;;;;;;4,0;;;;;;;;;;;;;;;;2,0;;;;;;;;;;;;;;1,0;;;;;;;;;;;;;;;1,0;;;;;;;;;;;;;;;1,0;;;;;;;;;;;;;;;;;;;1,0;2,0;;;;;;;4,0;;;;;;;;;;;17,0;;;;;;;1,0;;7,0;;;;;1,0;;;;4,0;;;12,0;;;;;;;;;;;;;;;;;;;;;;;;;;;;2,0;;;;;9,0;;;;8,0;;;;;;;;;;;;;;;;;;;;;;;;;;;;;;;;;;;;;;;;;;;;;;;;;;;;;;;;;;;;;;1,0;;;;;;;;;;;;;;1,0;;;;;;;;;;;;;;;;;;;;;;;;;3,0;;;;;;;;;;;;;;;;;;;;1,0;;;;;;;;;;;;;
photoelectric;;;;;15,0;32,0;31,0;;;;;1,0;;16,0;18,0;;9,0;8,0;1,0;;4,0;;22,0;;;;;4,0;;;115,0;2,0;4,0;1,0;;2,0;6,0;;1,0;;2,0;173,0;;3,0;;48,0;;587,0;;;;;4,0;;1,0;;64,0;;;147,0;;11,0;17,0;;96,0;;321,0;2,0;;;7,0;11,0;237,0;;;;;2,0;;1,0;17,0;7,0;3,0;;22,0;;;23,0;;3,0;;10,0;9,0;2,0;;3,0;464,0;3,0;423,0;;16,0;38,0;;7,0;13,0;25,0;;;;1,0;;14,0;233,0;;;;;33,0;;65,0;;;289,0;;;5,0;18,0;;;4,0;1,0;3,0;;280,0;;;4,0;;;4,0;;21,0;;;;3,0;14,0;150,0;35,0;;;1,0;;;;349,0;;;;2,0;1,0;37,0;;122,0;718,0;5,0;3,0;18,0;8,0;27,0;3,0;;;20,0;;;52,0;3,0;;;1,0;;;32,0;;92,0;16,0;;3,0;;;;4,0;31,0;;;;39,0;3,0;;14,0;33,0;;;;;10,0;9,0;;3,0;2,0;;;;4,0;7,0;86,0;6,0;;4,0;2,0;5,0;;;;3,0;395,0;;4,0;;;;6,0;2,0;;;3,0;5,0;;;;;;;;5,0;10,0;5,0;70,0;;;;8,0;44,0;97,0;2,0;;78,0;11,0;;198,0;27,0;17,0;;1,0;;;11,0;;;;11,0;;6,0;;;;;;4,0;;;8,0;12,0;;;18,0;;10,0;2,0;;;1,0;;2,0;;16,0;;;;;;1,0;1,0;;;;3,0;;102,0;;;;;;;45,0;;1,0;;;5,0;17,0;10,0;2,0;1,0;3,0;;;20,0;;;;;2,0;;;;;;16,0;2,0;;;;;;;;;;;;;;6,0;8,0;3,0;;;;;;;;;;;;;;;6,0;21,0;1,0;;;;;;4,0;;;;1,0;6,0;;1,0;;;;;;10,0;;9,0;2,0;;;;;21,0;;1,0;;3,0;;;1,0;;;;;;7,0;;2,0;3,0;2,0;;;;9,0;25,0;;77,0;;1,0;;;19,0;;;;2,0;;4,0;2,0;4,0;;;3,0;8,0;;;;;;;;;3,0;;;;;;;;;;;;;;;;;;;;;2,0;;2,0;;;;;;;;;;;;37,0;;;;;;;;36,0;;;;;;;;;;;;;;;;;;;;;2,0;;4,0;;;7,0;7,0;;;;1,0;;;;;;;;9,0;;1,0;;;1,0;;;;;14,0;;;;4,0;;;;;;;;3,0;;;;;;1,0;;;;;2,0;;;;;;1,0;;;;;;;;;1,0;4,0;1,0;;;;;;2,0;;;;1,0;;;;16,0;;;;;;;;;;;;7,0;;;;3,0;;;;;;;;;;;;;;;;;;;;;;;;;5,0;;1,0;18,0;9,0;1,0;9,0;;;;;;2,0;;4,0;;;1,0;;;;;;6,0;;43,0;6,0;2,0;;;;1,0;4,0;;;;;;;;1,0;;;;;;;15,0;;;;;;;;;;16,0;1,0;;;;;4,0;2,0;;3,0;;;;;;;;;;2,0;1,0;;12,0;;;;;;;4,0;;;;;;;;;;6,0;;;;12,0;;15,0;;;;;;;25,0;;;;;;;;;;;;;;;;;;;5,0;;;;4,0;;;;;;;;10,0;;;;;;3,0;;;2,0;41,0;13,0;9,0;4,0;1,0;5,0;;20,0;1475,0;;;61,0;4,0;4,0;16,0;2,0;117,0;;7,0;;;16,0;23,0;;4,0;7,0;22,0;;118,0;;;;;;;;11,0;22,0;4,0;;13,0;;;106,0;;;;2,0;;;;;;;;;;;;;;;1,0;;;;;;;;;;;;;;;;;4,0;;;;;1,0;;;;;;;;;2,0;;;;;;;;;;;;;;;;;;;;;;;;;;;3,0;;12,0;;;;;;;;;;;;;;;;;;;;;;;4,0;;;;;;;;4,0;;;;;;;;;;;;;;;;;;;;;1,0;;;;;;;;;;;;;;;;;;;;;;;;;;;;;;;4,0;;;;;;
photography;;;;;2,0;10,0;;;1,0;;;;;2,0;;;7,0;;;;;;;;2,0;;;2,0;7,0;34,0;1,0;;;;;10,0;;1,0;2,0;;7,0;14,0;;34,0;8,0;;;1,0;;;;;;1,0;2,0;;1,0;;;2,0;;;;;51,0;;15,0;;;;;4,0;3,0;;;;8,0;;;1,0;46,0;;44,0;;13,0;;;;;;;;;1,0;6,0;;;;7,0;1,0;6,0;2,0;;2,0;2,0;2,0;;;;7,0;;;;;1,0;;;;1,0;2,0;;;1,0;;;5,0;33,0;;;;29,0;;;5,0;;;;;;;;;;;;;;;6,0;;;;1,0;;;;;;;;;;;;;;;;;;;;;2,0;;;;1,0;2,0;;;;;4,0;;;;;3,0;;;;;;;;6,0;;;;;;;;;;;;;2,0;;;;;;;1,0;;;;1,0;;;;;;2,0;;11,0;;;;3,0;1,0;;;;;;;;;;;;6,0;;;2,0;;;;;2,0;;3,0;4,0;;;;;2,0;;;;;;;;;;;;;;;2,0;4,0;;3,0;;;;1,0;;;;;;1,0;;;;;;;;;;;;;;;;;;2,0;;3,0;;;;;;;;1,0;1,0;;9,0;;;1,0;;;;;3,0;;;;1,0;;32,0;;;;;;;3,0;;;;;20,0;;;;;;;;2,0;;2,0;;5,0;2,0;;;;7,0;;;;2,0;;3,0;;;;2,0;2,0;;;3,0;;;18,0;;;;;3,0;;;;2,0;;3,0;;;;8,0;;3,0;;;;2,0;;1,0;;;;;4,0;;;2,0;;2,0;2,0;;;;;;;;;;;3,0;23,0;2,0;;;3,0;;;;2,0;;;8,0;;;;27,0;1,0;;;2,0;;;22,0;;;;2,0;;;;;;;;;;;;;;;2,0;;;;;11,0;4,0;;;;;;;;;;;;26,0;24,0;;8,0;;;;;;;;5,0;;;;;;;2,0;;;;;;;6,0;;;;;;;2,0;;;1,0;;;;;;;;;6,0;;8,0;1,0;;;;1,0;;;;;;;1,0;;2,0;;;;6,0;;;;;;3,0;;;;;1,0;4,0;;;;;;;;;1,0;;;;;;;;;2,0;;;;;;;;;;;;;;;;;;;;4,0;;;;;;;;6,0;;;;;;;1,0;;;;;;;;;;;;;;;;;1,0;;;;;;;;;;1,0;;1,0;;;;;;;;;;;;;;;;;;1,0;4,0;;;;;;;;;;;;;;;;1,0;;;;;2,0;;;;;;;;;;;;;;;;;;;;;;;;;;;;;;;;2,0;;3,0;;;;;;;;;;;;2,0;;;;;;;;;;;;;;1,0;;2,0;1,0;;;;;;;;;;;;;;;;;;;;;;7,0;;2,0;;;;;;;;;;;;;;;;;;;;;;;;;;;;;;;;;;;;;;;;;;;;;;3,0;;;;;;;;;;;;;;;;;;1,0;;;2,0;;;;;;;;;;8,0;;;;;;;;;2,0;;;6,0;;;;;;;;4,0;;;;;11,0;;;;;;;;;;;;;;;8,0;;;;;;;;1,0;;;;;;;;7,0;;;;;2,0;;;;;;;1,0;;;;;;;;1,0;1,0;;;;;;;;;;;;;;;;;;;;;;;;;;;;3,0;;2,0;;;2,0;;;;;;;;;;;;;;;;;;;;;;;;;;;;;;;;;;;;;;;;;;
potential;;;;;6,0;27,0;2,0;;;;;2,0;;19,0;;;26,0;1,0;;4,0;;;;2,0;;;;2,0;2,0;;94,0;;;;;17,0;1,0;;3,0;;64,0;67,0;;1,0;8,0;3,0;;17,0;3,0;1,0;7,0;;;;5,0;;16,0;;;28,0;;;2,0;;66,0;;13,0;2,0;11,0;;;;21,0;;;3,0;;1,0;;;16,0;;9,0;;17,0;;;3,0;;1,0;3,0;;6,0;;;;25,0;;87,0;91,0;;26,0;;1,0;17,0;2,0;;1,0;;;;61,0;113,0;;;;;;;18,0;;;104,0;;;14,0;25,0;;;;;;;111,0;;;17,0;;;;;1,0;;1,0;2,0;10,0;5,0;6,0;10,0;;;;;;;18,0;;;;;5,0;41,0;;;51,0;;20,0;;1,0;2,0;;;;26,0;;;13,0;9,0;;;8,0;12,0;;3,0;;;;;4,0;5,0;;;;5,0;;;;;;;;18,0;3,0;;;;;;1,0;;;;2,0;2,0;;3,0;73,0;2,0;;;4,0;9,0;;9,0;;4,0;13,0;;;;;;;;5,0;;;;;3,0;;;;;;52,0;;;2,0;;;;;;13,0;91,0;;16,0;;;6,0;;6,0;20,0;;;;;1,0;;;7,0;;;;;;;;;;2,0;;2,0;;;;;11,0;;2,0;9,0;;;;;9,0;7,0;8,0;;;;;;;;;;;36,0;;;;;;;;;2,0;6,0;;18,0;4,0;;;;5,0;;42,0;2,0;;;;;1,0;;;;;;;;;;;;2,0;;;;;;20,0;;4,0;;2,0;6,0;2,0;;;;;;2,0;;;;;4,0;;;;3,0;55,0;3,0;2,0;;20,0;3,0;117,0;;;;;27,0;;20,0;;1,0;;;;1,0;;8,0;;9,0;21,0;3,0;;52,0;;12,0;;28,0;;1,0;;3,0;;;4,0;2,0;5,0;;;;;4,0;;;24,0;10,0;2,0;36,0;;6,0;1,0;;2,0;;9,0;;;;1,0;11,0;21,0;;;71,0;4,0;;;1,0;;;2,0;;;36,0;5,0;;;;;;;;2,0;;;4,0;;1,0;;;;;;;1,0;1,0;;;;;;;;;;3,0;;;4,0;;1,0;23,0;;11,0;;;;;;;;;;3,0;;;;5,0;5,0;;;;;;;;;;;5,0;;;1,0;2,0;;;;;;1,0;;;;;;;;;;;;54,0;3,0;;;3,0;;3,0;;;;;1,0;;;;;1,0;;;;;;;;;;;;;2,0;;1,0;;;;;;;;;;;38,0;;4,0;;;12,0;;1,0;;;;;13,0;;;;;;;;;;13,0;;1,0;;4,0;;30,0;46,0;;;49,0;;;;1,0;1,0;;;;2,0;5,0;;;;;;;1,0;;;2,0;;;2,0;;;4,0;;;;;;;;;;;1,0;;4,0;;;;;;1,0;;;3,0;;;;;;;;;58,0;;;;;4,0;;;6,0;;;;;;;;;;;;2,0;;1,0;;;9,0;;;;;;;2,0;2,0;1,0;;;6,0;;;;;;;;;1,0;;;5,0;;;;;;;;;;;1,0;;;;4,0;;;;;;;;;;;2,0;;;;;;;;;;;;;;;;;;;;;3,0;;;;;;;;;;;;;;;;;5,0;6,0;1,0;;;10,0;4,0;12,0;9,0;;3,0;7,0;1,0;7,0;3,0;;14,0;;14,0;16,0;;19,0;;4,0;;3,0;;58,0;;;;58,0;3,0;55,0;9,0;;;;;1,0;;5,0;;;;;;;134,0;;;;;;2,0;;18,0;;;;;;;;1,0;;;;;6,0;;2,0;8,0;;;;;6,0;;;;;;;;;;;;;;1,0;;;;;;;;2,0;;;6,0;;;;;;;;2,0;;;;;1,0;;;;;;;;;2,0;;;;;;;;;;;1,0;;;;;;;;;;;;;;;12,0;;;;;;;;8,0;;;;;;;;;;;;;2,0;;;;;;;;;;;;;;;;;;;;;;;;;;;;;;;;;;66,0;;;;;;;;;;;
readout;;;;;10,0;3,0;24,0;;;;;;;9,0;;;12,0;11,0;;;3,0;;1,0;;;;1,0;;;1,0;52,0;11,0;;3,0;;16,0;;;;;3,0;5,0;;10,0;;3,0;;3,0;;1,0;;;;1,0;;;4,0;;2,0;13,0;;;4,0;;53,0;;81,0;2,0;;;4,0;;7,0;;;;;;;9,0;33,0;4,0;13,0;;;;;31,0;2,0;;7,0;;;;;;238,0;5,0;89,0;;;1,0;;1,0;2,0;;;;;;;4,0;4,0;;;;;8,0;;44,0;2,0;;194,0;;;1,0;9,0;;;;21,0;;;206,0;;;;;;;;13,0;;;;;;21,0;4,0;;;;;;2,0;24,0;;;;;;8,0;;1,0;8,0;;19,0;;;;8,0;;;;;;2,0;;2,0;;;;;;;;1,0;;4,0;;;;;2,0;;;;;;;;2,0;;;;;;4,0;;;;;;;;;23,0;;;31,0;;18,0;;2,0;;;32,0;;;;;;;;;;;;;;;;;;;6,0;7,0;;3,0;;;;3,0;;8,0;39,0;;;;;6,0;;26,0;;;;;;;4,0;;;10,0;1,0;;;;;;;;;;;;;;4,0;125,0;;;;;;;;;;;;;;;;;;;1,0;;40,0;;;;11,0;;;;;;;;2,0;;;;2,0;;;32,0;1,0;;;;;;;;;;;;;;;;;;;;;;;1,0;;;;6,0;;;;;;;;;;;;;;;;2,0;;1,0;;2,0;;;4,0;31,0;;2,0;;;4,0;;;;;;;;1,0;;5,0;;1,0;;;;1,0;41,0;6,0;;;;;;;;;;4,0;16,0;2,0;;;;;;2,0;;68,0;;12,0;;2,0;;;8,0;;;;;;;;8,0;;2,0;;;;;;;;;;;11,0;;;;;;1,0;;3,0;;;7,0;;;;;;;;;;;;;;1,0;;15,0;;;;;;;;11,0;;;;;;;;;;;;;;;;;;;2,0;;;;;;;;4,0;;33,0;;3,0;;;1,0;;;;;;;;;;;;;17,0;1,0;;3,0;;;;;;;1,0;;;;;;;;;;;;4,0;;;;;;26,0;;;;;;;6,0;;;;3,0;;;;;;;;;;;;;;;;;2,0;;;;;;;;;;;;;;;;;;1,0;1,0;4,0;;;;1,0;;;;;;;;1,0;;;;;;;;;;;;;4,0;;;;;22,0;;;;;1,0;;;;;;;;1,0;;2,0;;;;;1,0;4,0;;;4,0;12,0;2,0;;;;;1,0;;;;;;;;;;;;;;;;;2,0;;;4,0;;;4,0;;;;;;;;;1,0;25,0;12,0;;;;;;;;;;;2,0;;;;;;;;2,0;5,0;;;;;;;;;;;;;;3,0;;;;;;;;;;;;;;;;;;;;;;;;;;;;;;;;1,0;;;;;;;;;;;;;2,0;;;;;7,0;;3,0;;;1,0;17,0;;8,0;2,0;;3,0;2,0;;;4,0;3,0;;;;;2,0;;;;;11,0;;9,0;;;;;;;9,0;9,0;;;;;;;11,0;;;;;;;;;;;;;;;;;;;;;;;;1,0;1,0;;;;;;;1,0;;;;;9,0;;;;;4,0;;1,0;;9,0;;;;;;;;;;;;;;;;;;;;;;;;;;;;;;;;;;;;;;;;;;32,0;;;;;;;;4,0;;;;;;;;;;;;;;4,0;;;;;;;;;;;;;;;;;;;;;;;;;;;;;;;;;;;;;;;;;;;;;;;;;;;;;;;;;;
refract;;;;;2,0;1,0;3,0;14,0;;;;2,0;1,0;3,0;;;1,0;;;;;;;;3,0;;;10,0;;;32,0;;;;;;;;1,0;;;;;;;1,0;;63,0;;;;;;;21,0;;7,0;;;;;;5,0;;7,0;;9,0;5,0;;;;115,0;200,0;;;;7,0;;;;8,0;;;;3,0;;;23,0;;1,0;;;2,0;;;;;10,0;14,0;;16,0;1,0;7,0;;;;;;;;;;;1,0;;;;;3,0;1,0;;;1,0;;1,0;;16,0;;;;;;;10,0;4,0;;2,0;;;;;2,0;;;;2,0;1,0;1,0;;;;;4,0;;;;;;;;;;;;;;4,0;;;;;;;6,0;;;;10,0;;;2,0;;;;;;;;;;;;;;;;4,0;35,0;;;;;;;;;;;;;;;;;6,0;;4,0;;;6,0;1,0;;;;;;7,0;;3,0;3,0;;6,0;;;;;4,0;;;1,0;;;;;;;;;1,0;;;;;;;;;43,0;;;;;;;;;;1,0;;1,0;;;;;;;;7,0;;;1,0;;24,0;;;;;;1,0;;;;;;1,0;;;;;;;;;;;;;;;2,0;;;1,0;;;;;;3,0;;;22,0;;3,0;;;;;30,0;;;;;;;1,0;;;;;;;;;;;;;;;;;;;;1,0;;;;;;;;;;;;;;;;;;;4,0;;;;;;1,0;;;;;;;;;;;;;4,0;;;;;;;;;;;;;;;;4,0;;;;;;;;;;;;;;;;19,0;;4,0;;;3,0;;;;;;;;;;;;;;;;;;;;;2,0;;;;;;;;;;2,0;;6,0;;;;;;;;;;;;;;;;;;;;;;;;;;;;;1,0;;1,0;;;;;;;;;;;1,0;;;;;;;;;1,0;;;;;;;;;;;;;;;1,0;;;;8,0;;;;;;;;;;13,0;;;;;;;;;;;;;;;;;;;;;;;;;;;;;;;;;;;;;;;24,0;;;;;;;;;;;;;;;8,0;1,0;;;;;;;;;;;;;;;;;;;;;;;;7,0;;;;3,0;;;;;;;;;;;;;;;;;;;3,0;;;;;;;;;2,0;;;;;;;;;;;;;;;;3,0;;;;;1,0;;;4,0;;;;;3,0;;;;;;;;;;;;;;1,0;;;;;;;4,0;;;;;;;;;;;5,0;;;;;;;;;;;;;;;;;;;;;;;;;;;;;;;;;;;;;;;;;;;;;;3,0;;;;;;;;;;;;;;;;;;;;;;;7,0;;;;;;;;;;;;3,0;;;;;;;;;;;;;;;;;;;;;;;;2,0;;;;;;;;;;;;;1,0;;;;;;;;;;;;;;;;;;;;;;;;;;;;4,0;;;;;;;3,0;;;;;;;;;;;;;;;;3,0;;;;;;;;;;;;;;;;;;;;;;;;;1,0;;;;;;;;;;;;;;;;;;;;;;;;;;;;1,0;;;;;;;;1,0;;3,0;;;;;;;1,0;;;;;;;;;;;;;;;;;;;;;;;;;;;;;;;;;;;;;;;;;;;;;
resin;;;;;6,0;8,0;1,0;6,0;;;;;2,0;6,0;;;;;;;;;;;;;1,0;3,0;;;1,0;;1,0;;2,0;;1,0;10,0;;;;8,0;;1,0;;4,0;1,0;10,0;;;;;5,0;;;;37,0;;;;9,0;;12,0;;5,0;;34,0;;;;;43,0;2,0;4,0;;;67,0;;;;15,0;;;;38,0;4,0;;27,0;;;;1,0;;1,0;;;;2,0;4,0;5,0;1,0;;;2,0;;;1,0;;1,0;;;;;;;;;;;2,0;;;;;;;8,0;;1,0;1,0;;3,0;;16,0;;3,0;1,0;;2,0;1,0;;1,0;;;;5,0;;;;6,0;;2,0;2,0;;;;1,0;7,0;40,0;13,0;8,0;7,0;2,0;;;;;9,0;;1,0;2,0;;;2,0;;1,0;1,0;;;;;;1,0;1,0;;10,0;16,0;;2,0;3,0;;;6,0;3,0;3,0;14,0;5,0;;3,0;;4,0;61,0;;;1,0;;9,0;2,0;10,0;10,0;;;;;;1,0;;;;;6,0;1,0;;;3,0;;17,0;;;2,0;;1,0;1,0;6,0;;;;;;1,0;;;;;1,0;8,0;;;1,0;;;;3,0;2,0;26,0;;;7,0;;;;1,0;;12,0;1,0;;;;3,0;;1,0;;;;;;;;;;1,0;;;9,0;;;2,0;4,0;4,0;;;;;3,0;;;;;1,0;;;6,0;4,0;;;;;;;;;;1,0;;;;1,0;;;1,0;;;1,0;;2,0;1,0;;;3,0;;;;;;;;;;;;;;;;;2,0;;2,0;;2,0;;;;;;;2,0;2,0;;;;;;;;;;1,0;;;;;;;3,0;;;;;;;;;;;;;;;;;;;;;;;;;;;;4,0;;;3,0;6,0;;;;;;;;;;;;;;;;;;;1,0;;;;;;;;;;;;;;;4,0;1,0;;;;;;1,0;;;;;2,0;;;;;;;;;6,0;;;;;;;;;;;;1,0;;;;;;;3,0;1,0;;;;;1,0;;;;;;4,0;;;;;;;;;;;;;;;;;;;;;;;;;1,0;;1,0;1,0;3,0;;;;;;;;;;;;;;;1,0;;1,0;;;;;2,0;;;;;;;;;;;;;;;;;;;1,0;1,0;;;;;;;;;;14,0;;1,0;;;1,0;;;;;3,0;;4,0;;;;;;;;;;;;;;;;;;1,0;;;;;;3,0;;;;;;;;;;;;;;;;;;;;;;;;;;;;;;;1,0;;;;;;;;;;;;;;;;;;;;;;;;;;;;;1,0;2,0;;;;;;;;;;;;;;;;;;1,0;;;;;;1,0;1,0;;;;;;;;;14,0;;;;;;;;4,0;;;;;;;1,0;;;49,0;;;;;;;;;;;;1,0;;2,0;;;;;;;;;;;;;;;;2,0;;1,0;1,0;;;;;1,0;;3,0;;;;9,0;;;;;1,0;;;;;;;1,0;;;;;;11,0;;;;;;;;;;;;;;;;;;7,0;;;;;;;;;;;;;;;;;;;;;;;;4,0;;;;;2,0;;2,0;;1,0;;;17,0;;;1,0;;;;;;;;;;;;;4,0;;;;;;;;;;;;;;;;;;;;;;;;;;;;;;;;;;;;;2,0;;;;;;;;;;;;;;1,0;4,0;;;4,0;;;;;;;1,0;;;;;;;;;;;;;;;;;;;;;;;;;;;;;;;;;;;;;;;;;;;;;;;24,0;;;;;;;;;3,0;;;;;;;;;;;;;;;;;;;;;;;;;;;
selector;;;;;1,0;;;1,0;;;;;;1,0;;;;;;;;;;;;;;;;;25,0;;;;;10,0;;;2,0;;1,0;17,0;;1,0;20,0;4,0;;16,0;;;;;1,0;;8,0;;2,0;;;2,0;;;;;17,0;;6,0;;;;;;5,0;;;1,0;4,0;;;;3,0;;10,0;;1,0;;;;;;;;;;;;;;;1,0;13,0;;;1,0;2,0;5,0;;2,0;;;;;;2,0;;4,0;;4,0;;6,0;;;18,0;;;;3,0;;;;4,0;;;;;;7,0;;;;;1,0;;;;;3,0;4,0;;;;;;;;;;;;;;;;;;;9,0;;;;;;;1,0;;;;;7,0;;;;;;;;;;4,0;;;;;;;;5,0;;;;;2,0;;;;;;;;1,0;;;;;;;21,0;;;;;3,0;;;;;3,0;;;;;;;;;;;;;;;4,0;;;;28,0;;;;;;;;4,0;5,0;;;;;;;6,0;;6,0;;;;;;;;;1,0;;;;;2,0;;;;;;;;;;;4,0;;;;;;;1,0;5,0;;;1,0;;;;;;;;;;2,0;;;;;;1,0;;;;;7,0;;;;;;;;;;;;;;6,0;;;;;;4,0;;;;;;;;;1,0;;;;;;;6,0;;12,0;;;;;;;;;;;1,0;;;;;13,0;;;;;8,0;12,0;;;;;;;;;;;1,0;;5,0;;4,0;;;;;;6,0;;6,0;;;;;;;;;;;1,0;;;;;;;;;;;;;1,0;5,0;;;;2,0;2,0;;;;;7,0;;;;;;;;;;15,0;;;4,0;;;;;;2,0;;;;;;;;;;;;;;;;12,0;;;;;;;;;;;;;1,0;;;;;;;;;;;;;;;;;;;;;;;;;;;;1,0;;;;;;;;;;;;;;;;;;;;;;;1,0;;;;;;2,0;1,0;3,0;;1,0;;;;;1,0;;;10,0;;;;;;;;;;;;;;;;;;;;;;;;;;;;;;;;;;;1,0;;;;;;;;;;;2,0;1,0;;;;;;;1,0;;;;;;;;;;;;;;;;;;;;;;;;;;;;;;;;;;;;;;;;;;;1,0;;;;;;;;;;;;6,0;;;;;;11,0;;;;;;;;4,0;;;;;;;;;;;;;;;;;1,0;;;;;2,0;;;;;;;;;;;;;;;;;;;;;;;;;;;;;;;;;;;;;;;;2,0;;;;;3,0;;1,0;;;;;;;;;;;;;;;;;;;;;;;;1,0;;;;;;;4,0;;;;;;;;;;;;;;;;;;1,0;;;;;;;;;;;;;;;;;;;;;;;;;;;;;;;;;;;1,0;;;;;4,0;;;;6,0;;;;;;;;;;;;;;;;;;;;;1,0;;;;;;;;;;;;;;;;;;;4,0;;;;;;;;;;;;;;;;;;;;;;27,0;3,0;;;;;;;;;;;;;;3,0;;;;;;;;;;;;;;;;;;;;;;;;;;;;;;;;;;;;;;;;;;;;;;;;;;;;;;;;;;;2,0;;;;1,0;;;;;;;;;;;;;;;1,0;;;;
shield;;;;;1,0;30,0;23,0;18,0;;;2,0;;10,0;16,0;;;24,0;;2,0;;;;8,0;;4,0;;;15,0;;;100,0;5,0;;2,0;;3,0;17,0;1,0;;10,0;2,0;92,0;2,0;1,0;;90,0;;34,0;;;;;35,0;10,0;15,0;;64,0;;;2,0;3,0;;;;37,0;;81,0;2,0;;15,0;13,0;121,0;670,0;;;;43,0;;;;20,0;;;;174,0;22,0;;15,0;;3,0;;8,0;3,0;11,0;1,0;;23,0;1,0;26,0;23,0;117,0;3,0;1,0;1,0;1,0;2,0;;;4,0;5,0;;;23,0;4,0;35,0;;;;;54,0;;25,0;13,0;;;;24,0;;;17,0;;1,0;;164,0;1,0;2,0;17,0;;;;;7,0;;1,0;20,0;;32,0;58,0;2,0;35,0;;37,0;8,0;12,0;;4,0;;3,0;2,0;;63,0;41,0;;;3,0;;40,0;97,0;;11,0;;;16,0;20,0;15,0;3,0;;4,0;5,0;;2,0;;11,0;14,0;6,0;7,0;45,0;6,0;22,0;37,0;5,0;;2,0;6,0;15,0;75,0;57,0;51,0;14,0;9,0;;89,0;6,0;1,0;1,0;;201,0;29,0;;21,0;32,0;21,0;;2,0;;53,0;;4,0;4,0;;4,0;;;10,0;142,0;1,0;231,0;;10,0;;7,0;33,0;26,0;;1,0;;1,0;;3,0;;1,0;3,0;;;2,0;1,0;1,0;10,0;31,0;7,0;;;;19,0;30,0;;7,0;114,0;15,0;;;5,0;;28,0;22,0;;4,0;;;47,0;39,0;6,0;12,0;5,0;2,0;;9,0;12,0;22,0;13,0;9,0;;19,0;52,0;;;1,0;14,0;22,0;7,0;21,0;;;2,0;;2,0;13,0;23,0;11,0;14,0;8,0;;14,0;;;3,0;1,0;7,0;10,0;18,0;9,0;;14,0;11,0;;;3,0;;7,0;2,0;;;5,0;8,0;4,0;2,0;8,0;;4,0;10,0;29,0;;3,0;4,0;;1,0;1,0;;1,0;;6,0;8,0;5,0;;6,0;1,0;;27,0;;3,0;;;1,0;1,0;4,0;1,0;;29,0;8,0;;;;;;;;;;;;2,0;;;2,0;3,0;1,0;;2,0;5,0;;38,0;;;;;2,0;;1,0;1,0;;;;;2,0;;3,0;2,0;;;;;;2,0;2,0;;;;5,0;;1,0;2,0;;;4,0;;;;;;;;;2,0;;;16,0;;4,0;;16,0;5,0;;2,0;;;;;1,0;;;;11,0;;9,0;;;;;;;;;;;;;;;;;;;;;;;;;;;;;;;6,0;2,0;;;;;12,0;;;;1,0;;2,0;1,0;;;;1,0;;1,0;2,0;;3,0;1,0;;;;;2,0;;;3,0;3,0;3,0;;;;;;;1,0;;;;3,0;5,0;4,0;25,0;;;;;18,0;;8,0;;9,0;;;6,0;5,0;1,0;;;2,0;;;;2,0;27,0;;;;1,0;;;;1,0;;1,0;;;;;;;;;8,0;;;;1,0;11,0;;;;;;10,0;2,0;2,0;3,0;;;;;;1,0;2,0;;5,0;3,0;;;2,0;;;;;;;;4,0;1,0;;;;;5,0;;;;;;1,0;;;;49,0;;;;;;;;;;;;;;;;;;;;;;;;;11,0;;;;;;;;;7,0;;;;2,0;;;;5,0;;1,0;;;;;;;;2,0;;;2,0;;22,0;;;;;;;;;;;;;3,0;;;;;15,0;;;16,0;;;14,0;53,0;;3,0;1,0;;;1,0;1,0;4,0;4,0;;;;6,0;;2,0;;5,0;;4,0;1,0;;7,0;;;;8,0;1,0;;1,0;;5,0;5,0;;;;;4,0;1,0;20,0;;;1,0;1,0;7,0;;;;;;;;;;;;7,0;13,0;9,0;;5,0;1,0;;11,0;;9,0;;;;;;1,0;6,0;2,0;;5,0;2,0;;10,0;;;2,0;;;;;;;;70,0;;;17,0;1,0;;;;;3,0;;2,0;9,0;;;;2,0;;;1,0;;;;;;;;;;;;;9,0;;;;;;;;;;;;;8,0;;;;;;;;1,0;2,0;;;;;;;;;;;;3,0;6,0;6,0;;;;;;;;;;;;;;1,0;;;;;;;;9,0;;1,0;;;;;2,0;;;;;;;;;;;3,0;;;;;;5,0;;;;;;;;10,0;;1,0;2,0;;;;;;;;1,0;;;;;;;;;;1,0;;;;;;;;;1,0;;;;;;;;;3,0;;;;4,0;;4,0;2,0;1,0;;;;;;;;;;;;1,0;;;2,0;;;;1,0;;;2,0;;;;;;;;;;;;;;;;;;;;;;;;
slave;;;;;3,0;;;1,0;;;;1,0;;;;;6,0;;;;;;;14,0;39,0;;;;;10,0;30,0;;;;;86,0;;;;;2,0;617,0;;;;;;;;;;;;;;;1,0;;;7,0;;;32,0;;63,0;2,0;17,0;;;;;;;;;;;;;;32,0;;11,0;;20,0;;;15,0;;;9,0;;;3,0;;;;;84,0;;;;;;16,0;45,0;;;;;;;;;;;2,0;2,0;;;;;8,0;;;2,0;16,0;;;;4,0;;;12,0;;;2,0;;;;;;;;;1,0;;;3,0;;;;;;;;;;;;;3,0;;;;;21,0;;;4,0;;;7,0;3,0;;;;;1,0;;;;;3,0;;;;;;1,0;;;;;;;;;;;;;3,0;;;;10,0;;;;2,0;;;;;;4,0;;;;;6,0;;;;;3,0;;;3,0;;;;;1,0;7,0;;;;1,0;;;;2,0;;;;;;;;;;;;;2,0;;;;19,0;18,0;;3,0;;;;;;;;;;7,0;;;2,0;;;;;;;;;;;1,0;17,0;;;;;;;;;;;7,0;;;;;;;;;1,0;;;;;;;;2,0;;;1,0;;1,0;;;;;;;3,0;;;;;;;;;;;;15,0;2,0;;;;;1,0;;1,0;;;;;;;;;2,0;;3,0;;;;2,0;;;;;;;;;;;;;;20,0;;;69,0;;;;1,0;7,0;;;;;;;;;;25,0;;10,0;2,0;;;;1,0;2,0;;;;7,0;;2,0;;;;17,0;4,0;;;;;;;;;10,0;;22,0;3,0;16,0;1,0;;;;;;;;3,0;;10,0;;;;1,0;;;;;;;;;;4,0;;;;;;;;;;;;;;;;;;;4,0;;16,0;;;;1,0;1,0;;;;;5,0;;;15,0;;;;;;;;;;;;;;;;;;;;12,0;;;26,0;;;;;;;;;;;3,0;;;;;;;;;;64,0;;;;;;;;2,0;1,0;;;;;;;;;13,0;;;;;;78,0;;;;;;;1,0;;;;;;;8,0;;;;25,0;;;;;;;;;;;1,0;;;;;;;7,0;;;;;;;;3,0;;;;;;;;;;;;;;;;;;;;127,0;;1,0;4,0;;;;;;;5,0;;;;;15,0;;1,0;;;;;;;4,0;;;;;;5,0;;;;10,0;;;;;;;;;20,0;4,0;8,0;;;;;;;;;;;3,0;1,0;;;;;;;;14,0;2,0;;;;;;;10,0;1,0;;;;;;;;;;;12,0;10,0;;;;;;;;;;;;;;;7,0;5,0;;;;;;8,0;;;;;;;;2,0;;;2,0;;;4,0;;;;;;;;3,0;;;;;;;;;;;;;;;;;;;;;;;;;;;;;;;;;;;;;;;;;;;;;;;;;;;;;;;;;;;;;;1,0;;;;;;;;;;;;;1,0;;8,0;;2,0;;;;;1,0;;;;;;;;;1,0;;;;;;;;;;;;;;;;;;;;;;;;;;;;;2,0;;;10,0;;;;3,0;;;;;;;;;;;;;;;;;;;;101,0;;;;3,0;;;;;;;;;;;;;;;;;;;;;;;;;;;;;;10,0;6,0;;;;;;;;;;;;;;;;;;;;;;;;;;;;;;;;;;;;;;;;;;;;;;;;;;;;;;;;;;;;;;;;;;;
station;;;;;1,0;8,0;1,0;3,0;;;;;;189,0;;;22,0;;2,0;1,0;;;;9,0;32,0;;;2,0;13,0;;54,0;5,0;;;;20,0;;14,0;;;8,0;17,0;;;46,0;3,0;;;;;;;;;14,0;;;;;3,0;;;;;62,0;1,0;43,0;;;;;1,0;;;;;;2,0;;13,0;34,0;;;;16,0;;2,0;6,0;;;;;1,0;;1,0;;;;18,0;12,0;7,0;;3,0;2,0;2,0;15,0;;1,0;;;;5,0;;;;;;;;20,0;;;4,0;;;5,0;78,0;;3,0;;3,0;6,0;;10,0;;;8,0;;5,0;;;;2,0;;;;1,0;;4,0;;;;;;;6,0;;;;;;11,0;;;;;15,0;;;1,0;;;;;;;4,0;;2,0;;;;;4,0;;;;;1,0;;;;;;;;5,0;;;;;;;;;1,0;;;25,0;5,0;3,0;2,0;;;;;;;;;;1,0;1,0;;;;2,0;;;;;2,0;2,0;;;;3,0;;;;;;;;;;3,0;;;;;;;;;6,0;2,0;3,0;;;4,0;37,0;;11,0;;;;;;;;1,0;;;;;4,0;;;;;;;;;;2,0;;;;1,0;4,0;;1,0;;;;;;4,0;;;;;;;;;;1,0;;;;;;;16,0;2,0;1,0;;12,0;;;2,0;2,0;;;;24,0;;;;2,0;;6,0;;;;;;;;;;;5,0;;;;;;;;;2,0;;;;29,0;72,0;;;;;1,0;;2,0;;;;2,0;;5,0;;;;3,0;4,0;4,0;;21,0;;;;;3,0;;;;2,0;;2,0;;;;3,0;;1,0;9,0;3,0;;16,0;1,0;1,0;;15,0;;50,0;;;;1,0;;35,0;1,0;8,0;;;;;;;;;;64,0;108,0;4,0;1,0;;2,0;1,0;;3,0;;;1,0;1,0;2,0;;;;;;;1,0;;;30,0;;;;1,0;;;2,0;2,0;;;;2,0;;;;28,0;;;;;;1,0;;2,0;21,0;;;2,0;4,0;;;;1,0;27,0;1,0;4,0;;5,0;;1,0;1,0;;1,0;;;20,0;;;;1,0;;;4,0;;;;;;;;;2,0;;1,0;;;;;1,0;;;9,0;;;;;;2,0;1,0;;;;;;;;;1,0;;;3,0;;;;;;;;;;;;;;;;;;;;;;;2,0;6,0;;;;;10,0;;;;;11,0;;;;1,0;;;;;;1,0;;;1,0;4,0;;;1,0;2,0;;;;;;;1,0;;;;;;;;;;;;;1,0;;;;;;;;;;;;;;;;;;3,0;;;;7,0;;1,0;;;;;;;;;;;;;;4,0;;;;;;1,0;;;;;2,0;;2,0;;;;5,0;;;3,0;6,0;;;;;;;;4,0;;;;;1,0;12,0;3,0;1,0;;;;;5,0;;;;;;;;;;;1,0;;;;;;;;;;;;;;;;;;14,0;;;3,0;;;;;;;;;;;2,0;;;;;;2,0;;;;;;;;1,0;;;;;;;;;;;;;;14,0;;;;;;4,0;;;4,0;1,0;;1,0;;;;;;;;;;;;;;;;;;;;;;;;;;;;;;;;;2,0;;;;;;;;;;;;;;;;;;;;;;;;;;;;;;;51,0;;4,0;1,0;6,0;;;;;;;;;;;;;;;;;;;1,0;3,0;;;;;;;1,0;;;;;1,0;;;;;;4,0;;1,0;;;;;;;;;5,0;;;;;;;;;;23,0;;;4,0;1,0;;;;;;;;;;;1,0;;;;;;;;;;1,0;1,0;;;;;;;;;;;;;;;;;;;;;;;;;;;;;;;;;;;;;;;;;;;;;;;;;;;;;24,0;;;;;;;;;;;;;;;;;;;
strobe;;;;;2,0;1,0;;;;;;;;;;;3,0;;;;;;3,0;;;;;;;;;2,0;;;;1,0;;;;;16,0;3,0;;1,0;;;;;;;;;;;;1,0;;;50,0;1,0;;;;;4,0;;;;;;;1,0;44,0;;;;;;;;6,0;;;;;;;2,0;;;;;;;;;6,0;1,0;;;2,0;8,0;;;;;;;;;;;;;;;;;;4,0;;;;;;;6,0;;;;4,0;;;3,0;;;;;;;;;;;;;;;;;;;1,0;;;;;;;;;1,0;;;;;;;;;;;1,0;1,0;;;;;2,0;;;;;;;;;;6,0;;;;;;;;;;;;;;;;;1,0;;;;;;1,0;;;;;2,0;;;;;21,0;;;;;1,0;;;;;;;1,0;;;;1,0;;;;;;;;;;;;;;;;;;;;;;;;;;1,0;;;;;;;;;1,0;;;;;;;;;;;;;;;;1,0;;;;;;;;;;;;;;;;;;;;;;;;;;;;;;;;;;;;;;;;;1,0;;;;1,0;;;;;;;;;;;;;;;;;;;;;;;;;4,0;;;;;;;;;;;;;;;;;;;;2,0;;1,0;;;;;16,0;1,0;;;;;;;;;;;;1,0;;;;;;;;;;;;;;;3,0;;;;;;;;;;;;;;;5,0;;;;;;;;2,0;;;;;;;;;;;;;;;;2,0;;;;;;;;;;;;;;;;;;;;;;;;;;;;;;;;;;;;;;;;;;;;;;;;;;;;;;;;;;;;;;;;;;;;;;;;;;;;;;;;;;;;;;;;;;;;;;;;;;;3,0;;;;;;;;;;1,0;;;;;;;;;;;;;;;;;;;;;;;;;;;;;;;;;;;;;;;;;;;;;;1,0;;;;;;;;;;;;;2,0;;;;1,0;;;;;;;;;;1,0;;;;1,0;;;;;;;;;;;;;;;;;;;;;;;;;;;;;;;;24,0;;;;;3,0;;;;;;;;;;;;;;;;;;;;;;;;3,0;;;;;;;;;;9,0;;;;;;1,0;;;;;;;;;;;;;;;;;;1,0;;;;;;;;;;;;;;;;;;;;;;;;;;;;;;;;;;;;;;;;;;;;;;;;;;;;;;;;;;;;;;;;;;;;;;;;;;;;;;;;;;;;;;;;;1,0;;;;;;;;;;;;;;;;;;;;;;;;;;;;;;;;;1,0;;;;;;2,0;;;;;;;;;;;;;;;;;;;;;;;;;;;;;;;;;;;;;;1,0;;;;1,0;;;;;;;;;;6,0;;;;;;;;;;;;;;;;;;;;;;;;;;;;;;;;;;;;;;;;;;;;;;;;;;;;;;;;;;;;;;;;;;;;;;;;;;;;;;;;;;;;;;
thumbnail;;;;;2,0;4,0;;;;;;;;;;;17,0;;;;;;;;;;;;3,0;1,0;9,0;1,0;;;;10,0;;;;;8,0;13,0;;1,0;55,0;;;1,0;;;;;;1,0;;;;;;12,0;;;;;269,0;;10,0;;;;;1,0;;;;;;;;15,0;20,0;;3,0;;;;;1,0;;;;;;;1,0;;;;5,0;;4,0;9,0;;1,0;4,0;4,0;;12,0;;;;4,0;3,0;;;3,0;3,0;3,0;;;;;;2,0;;24,0;2,0;;;;5,0;;;7,0;;;12,0;;;;;;;;;;2,0;2,0;7,0;2,0;;;;;3,0;;;;;;;;2,0;;;;;;;;;;;;;;;;;;;;;4,0;;;;;3,0;2,0;;;;;;;;;;;;;;;;1,0;;;;;1,0;1,0;;;;;;;;;;;;;;;;;;;;;;5,0;;2,0;;;;;;;;;;23,0;;10,0;;;;;;;;;;;;;13,0;5,0;1,0;;;;;;;;;;;;;;;1,0;;;;;1,0;;2,0;;;1,0;1,0;;;;3,0;;;;;;;;;;;;;;;;;1,0;;;;;;;;;;;;5,0;;;;;;;;;;;;;2,0;;;;;;7,0;;;;;;;;;;;;;;;;;;1,0;;;;;;;;3,0;;;;;;;;3,0;;2,0;;2,0;;8,0;;;;;;;;;5,0;;;1,0;;;6,0;;8,0;5,0;;;4,0;;2,0;;;;;;;;1,0;;;1,0;;;;;2,0;;;;;1,0;26,0;1,0;11,0;;;;;1,0;;;;2,0;4,0;;;;1,0;;;16,0;3,0;;;4,0;;;;;;;;;;;;1,0;;;2,0;;;;;;;;;2,0;5,0;;;;;;;;;;;2,0;;9,0;;1,0;;;4,0;;;;;2,0;;;;;;;14,0;;;;;;;;;;;1,0;;;;;;;;;;8,0;;;;;;;;;;;;;;;;1,0;;;;;25,0;;;;6,0;;;;;1,0;1,0;;;;;;;;;;;3,0;;;;;;;;;;;4,0;;;;;;;;;;;;;;;;;;1,0;2,0;;;;;2,0;;;;;;;;;2,0;1,0;;;;;;;10,0;;;;;4,0;;;;;8,0;2,0;;;;;;;;;;;;10,0;;;;;;;;;;;;;;;;;;;;9,0;;;;;;;;;;;;;;4,0;;;;;;;;;;;;;;;;;;;10,0;;2,0;;;;;;;;;;;;;;;;;;;;;;;;;;;2,0;2,0;;;;;;;;;;2,0;;;;;;1,0;;;;;;1,0;;;;;;;;;;;;;;;;;;;;;;;;;;;;;;;;;;;;;;;;;;;;;;;;;;;;;;;;;;;;;;2,0;;;;;;;1,0;;;;3,0;;;;;;;;;;;;;;;;;11,0;;;;;;;;;;;;;;;;;;;;;1,0;;;;;;;;;;;;;;;12,0;;;;;;;;;;;;;;;;;;;;;;;;;;;;;;1,0;2,0;;;;;;;;;;;;;;;;4,0;;;;;;;;;;;;;;;;;;;;;;;;;;;;;;;;;;;4,0;;;;;;;;;;;;;;;;;;;;;;;;;;;;;;;;;;;;;;;;;;;;;
timer;;;;;9,0;21,0;1,0;;;;;;;59,0;;;21,0;;;;;;;;;;;5,0;6,0;;25,0;4,0;2,0;;;;;;;;60,0;23,0;;;37,0;;;30,0;;;;;2,0;;;;;;;2,0;;;;1,0;4,0;1,0;19,0;16,0;;;;2,0;2,0;;;;;;7,0;;42,0;;25,0;;;;;;;;;;;;30,0;;;;5,0;5,0;1,0;3,0;;;2,0;13,0;;2,0;;;;5,0;;10,0;;;;1,0;28,0;18,0;4,0;;10,0;;;1,0;26,0;;;;43,0;;;67,0;;;;;;;;;;;;8,0;3,0;;9,0;;;4,0;;;;;;;;;;6,0;3,0;;;;1,0;;8,0;28,0;1,0;5,0;;6,0;;;;;;;;;;;;;1,0;4,0;5,0;;;;;;;;6,0;;;;;;;2,0;4,0;2,0;;;;28,0;;2,0;;;;;6,0;;;;;5,0;;;2,0;;;;;;;;;;;2,0;;;;29,0;;;;;;14,0;;;;;;;;;;7,0;;1,0;;;;1,0;;;;;;;;;;;1,0;;;;;1,0;;;;;;;;;;7,0;6,0;;;2,0;;;;;7,0;;;;;;;;;;;;;12,0;;;;;;;;;;2,0;;9,0;;;;8,0;;;2,0;;;;;2,0;6,0;;3,0;;;;1,0;1,0;2,0;1,0;;;;;;;;;5,0;;5,0;;;;4,0;;;;;;1,0;;;;;;;;5,0;7,0;7,0;;;;3,0;;26,0;2,0;;;;34,0;1,0;2,0;;3,0;1,0;2,0;;;;3,0;;3,0;6,0;;;7,0;1,0;;;17,0;;;13,0;;;;;3,0;33,0;;;;;;;4,0;;;3,0;4,0;1,0;4,0;3,0;;;;51,0;;4,0;;3,0;;;;;30,0;4,0;;;8,0;;;2,0;;;5,0;12,0;;;;;;;;20,0;;16,0;;;;;;;;;;4,0;1,0;;;;;;;;;;1,0;;;7,0;;;;;;;;1,0;;;1,0;2,0;;;9,0;;18,0;;;;;;2,0;;;;;;4,0;;2,0;;;;;;;;;;;;;2,0;31,0;;;;;1,0;;2,0;2,0;;;;;;3,0;;;;;;;;;5,0;;;1,0;;;2,0;19,0;;;;;;;2,0;1,0;;;;;1,0;;;1,0;;;;;;;9,0;;;;;;;;16,0;;;;;;;;;;;;;;1,0;2,0;;;;;;;;;;;;;3,0;;;;;;;;;;;;;;;13,0;;;;;;;;2,0;;;;;;;;;18,0;;;;;;;;;2,0;;;17,0;;;;;;1,0;;;;;;;;1,0;;;;;3,0;1,0;2,0;;;;;2,0;;1,0;;;;;;;;;;3,0;2,0;1,0;;;1,0;;;;;;;;;;;;;;;;;1,0;;;;;;;;;;;;;3,0;;;;;;1,0;;;;;;;;;;;;;;;;;;;;;;;;;;;3,0;;;;;;;;;2,0;;;;;;;;;;1,0;;;;;;;;7,0;;;;;;;;;;;;;;;2,0;;;;;;;;;;;;;;;;;;;;;;2,0;;;;;;4,0;;;;;;;;;;;;;1,0;;;;;5,0;;;;;;;;;1,0;;1,0;;;;;;;;10,0;;;;;;;;;;1,0;;;;;;;;11,0;;;3,0;;;;;;;;;2,0;;;;;;;;;;;;;2,0;;;;;;;;5,0;;;;;;;;;;;;;;;;;;;;;;;;;;;;;;;;;;;;;;;;;;;;;;;;;;;;;;;;;;;;;;;;;;;;;;;
traffic;;;;;4,0;2,0;;;;;;;;19,0;;;11,0;;5,0;1,0;;;6,0;;;;;3,0;1,0;15,0;9,0;1,0;;;;164,0;;;1,0;;42,0;13,0;;;16,0;;;;;;3,0;;1,0;6,0;3,0;;;;4,0;;;;;;78,0;;37,0;;;;7,0;1,0;25,0;;;;;9,0;;3,0;34,0;;;;1,0;;;;;;;;3,0;;;;1,0;2,0;92,0;11,0;26,0;13,0;;11,0;1,0;5,0;;4,0;;;;3,0;24,0;;;;;5,0;;;;;29,0;3,0;;12,0;101,0;;1,0;;22,0;;;10,0;1,0;;6,0;1,0;;;;;;;;;4,0;;25,0;;;;;;;;;;;;;;4,0;;;;;;;22,0;26,0;1,0;2,0;;;;;;;;;7,0;;2,0;;;2,0;;5,0;13,0;;;;;;;;;;;;;9,0;;;1,0;;;;3,0;;1,0;;;;;;;;1,0;1,0;3,0;;;1,0;;6,0;;;;;;2,0;4,0;9,0;18,0;;;;;;;;;;10,0;2,0;;9,0;;;;;1,0;;;;2,0;;;;17,0;1,0;46,0;;;;;;;;;;;;;1,0;;;;;;;;;;;;;;;;;;;;2,0;1,0;;;;;;2,0;;;;;;2,0;;;3,0;;;;14,0;;;;1,0;96,0;;1,0;;;;;;;;;;;;;;;;;;;;;;;;6,0;;;;;;;43,0;;2,0;;9,0;3,0;;;;;;;1,0;;;;;1,0;3,0;;2,0;;3,0;;6,0;;6,0;11,0;;1,0;;39,0;;;;8,0;;;1,0;;6,0;3,0;;16,0;7,0;;;2,0;;1,0;;18,0;;31,0;;;;;;;14,0;1,0;;;;6,0;;18,0;;;;22,0;1,0;6,0;;;;2,0;;;6,0;;1,0;;;;;;11,0;;;1,0;;;8,0;3,0;;;5,0;;;;;3,0;;;4,0;1,0;;1,0;;;1,0;;;;;1,0;8,0;3,0;;;4,0;;;3,0;;2,0;;;;;8,0;;;;;7,0;1,0;3,0;6,0;;;;;;;2,0;;;;2,0;;;;;;11,0;;;;;;;;;;;;;;2,0;;;;;;;;;;;;;3,0;5,0;;;;;;;;1,0;;;4,0;;13,0;;;3,0;;;;;;1,0;3,0;;8,0;;1,0;;;;2,0;;;;;;;3,0;;;;;;;;;;12,0;;;;6,0;;;;1,0;;;1,0;;;;;3,0;22,0;;;;;;;;1,0;;;;;1,0;;;;;;6,0;3,0;;;;;1,0;;;;7,0;;;;;;;;;;;1,0;3,0;;;2,0;;;;;;;4,0;;;10,0;3,0;;1,0;7,0;1,0;;;;;;;2,0;;;;;2,0;;;;6,0;;;;;;;3,0;;;;;;1,0;;;;5,0;;;;;;;;11,0;;;;;;;;;;;3,0;;;;4,0;;;;;;;;;;;;;;;3,0;;;;;;;;;;;1,0;;;;;;;;;;;;;;;;;;;;;;;;;;;;;;;;;;;;;;;;;;;3,0;;;;;;;;;;;;;;;3,0;;;;;2,0;;;;;;;;;;153,0;;;;;;;;;;;;;;1,0;;;;;;;;;;24,0;;;;;;;;;;1,0;;;;31,0;;;;;;;;;;;;;;;15,0;12,0;;1,0;;1,0;1,0;;1,0;;;5,0;;;25,0;;;;1,0;;;2,0;;;2,0;;;;;4,0;;;;;1,0;;;49,0;;;;;6,0;;;;;1,0;;;;;1,0;;;;;2,0;;;;;;;;;;;;;;;;;;;;;;12,0;;;;;;;;;;;;;;;;;8,0;;;;67,0;;;;;;;;;;;;;;;;;;;;;;;;;;;;
train;;;;;2,0;5,0;;7,0;2,0;24,0;;;8,0;19,0;;;25,0;;;3,0;;;7,0;;;;;56,0;13,0;;30,0;2,0;;;;24,0;4,0;;10,0;;19,0;36,0;;;;25,0;;11,0;;;3,0;1,0;;;;10,0;;;1,0;10,0;;;28,0;;159,0;;28,0;;4,0;;;69,0;34,0;;;;;;;6,0;49,0;;4,0;10,0;13,0;13,0;;125,0;;;4,0;3,0;2,0;;;;4,0;10,0;18,0;11,0;6,0;;;22,0;3,0;5,0;;;;;3,0;10,0;20,0;;;;;6,0;17,0;31,0;2,0;;5,0;6,0;;12,0;35,0;;1,0;2,0;5,0;;;1,0;;;;3,0;3,0;;;;;;5,0;7,0;;1,0;3,0;5,0;2,0;;1,0;2,0;;;;;;;;6,0;;;;;28,0;;;1,0;42,0;;1,0;1,0;;;;;1,0;;;;;2,0;;;2,0;1,0;11,0;;;;;;2,0;;34,0;;;;;;;;;4,0;4,0;;;5,0;7,0;;;;;;19,0;;;12,0;;5,0;;;;;6,0;;;4,0;;;;;;1,0;4,0;;;7,0;;;;;;2,0;4,0;;;;;;;2,0;;;3,0;1,0;;;;7,0;;2,0;;;;;1,0;;;;15,0;2,0;;;;;;;;1,0;1,0;;9,0;;;;12,0;;;6,0;;;3,0;;3,0;;;;;;;;;;;5,0;;1,0;;;;;;;2,0;;;;4,0;31,0;;;;;;;;10,0;;;;;;;;;;;1,0;2,0;1,0;;;;2,0;5,0;;;;;2,0;;;;;;2,0;;;;;;;;;;;;;;13,0;4,0;;;4,0;;;;5,0;;;3,0;;5,0;1,0;3,0;;1,0;;1,0;;4,0;;;;8,0;;8,0;;5,0;;1,0;;7,0;;;1,0;5,0;;1,0;;;4,0;1,0;;;;;;1,0;;;;21,0;7,0;6,0;;;2,0;;17,0;;;;4,0;;;;;;2,0;8,0;;4,0;;;11,0;;;2,0;;;;2,0;;1,0;;;4,0;;;;;;;;;;;;2,0;1,0;;;;;;67,0;;;;10,0;;;7,0;;1,0;20,0;;;;;;;;;;;;;;;6,0;8,0;;;;3,0;;;;;10,0;;;;;;;;;;;2,0;;;;;48,0;;;;9,0;;;;;6,0;;;;;;;;;;;;;;;;;;;;4,0;;;;;2,0;;;;;;;;;;14,0;;;;;;;;;;2,0;;;;;;;5,0;;3,0;1,0;;;5,0;3,0;;;;;27,0;;;;;;2,0;;;;9,0;;;4,0;;;;;2,0;;1,0;;;;;;;;;;4,0;;;5,0;;;;;;;;;;;;;;;;6,0;;;;;;24,0;;;;4,0;;1,0;;;;;;2,0;;;;;;;;1,0;;;;;;;8,0;3,0;;;;;;;;;;;;;;;;;14,0;1,0;;;;;;;8,0;;;;2,0;;1,0;;;;;;;;;1,0;;;4,0;;;;;6,0;4,0;;1,0;2,0;;;;1,0;;;;;;;4,0;;;;;;;;;;;;;4,0;;;;;;;;;;;;;;;;;;;;;;;;;;;;;;1,0;;;;;;;;;;;;;;;;1,0;;;;;;1,0;;;4,0;13,0;3,0;;1,0;12,0;;;;6,0;;;;;;10,0;;;1,0;;;;;;;;;5,0;;;;;;;;;;;;;;;;;11,0;;;8,0;;;;1,0;;2,0;;;;4,0;3,0;;;;;2,0;1,0;;;;17,0;;3,0;3,0;;;;;8,0;;;;;;;;;;;;;;;;;;;;;;;;;;;;1,0;;;;;;;58,0;;;;;;;;;;;;;;;;;;;;;;;;;;;;2,0;;;;;;;;;;;;;;;;;;2,0;;;;;;;1,0;;;;7,0;;;;;1,0;;;;;;;;;
transistor;;;;;2,0;68,0;12,0;;5,0;;;2,0;;7,0;2,0;;3,0;14,0;55,0;;14,0;;4,0;;;;;;;;274,0;5,0;;;3,0;3,0;1,0;;;;6,0;323,0;;4,0;5,0;80,0;;108,0;;;;;5,0;;19,0;;88,0;;;4,0;;;9,0;;51,0;;305,0;1,0;;;1,0;3,0;31,0;;;1,0;;;;1,0;17,0;;8,0;;9,0;;;5,0;;;;1,0;3,0;5,0;;;340,0;;228,0;8,0;2,0;47,0;;1,0;7,0;;;;;;;45,0;162,0;;;;;40,0;;48,0;;;354,0;;;8,0;18,0;;;;5,0;;;58,0;;;5,0;;;;;3,0;;;;6,0;39,0;84,0;16,0;;4,0;1,0;;;;122,0;;;;;18,0;478,0;;7,0;69,0;;426,0;13,0;;;1,0;;;28,0;;5,0;10,0;;;;;;;27,0;;73,0;12,0;4,0;;2,0;;;;2,0;;18,0;1,0;4,0;1,0;;21,0;87,0;;88,0;;;;1,0;13,0;8,0;;;;1,0;;;252,0;5,0;;30,0;;15,0;;106,0;;17,0;42,0;;;;;;;;;;;;;;2,0;;;;;76,0;1,0;;60,0;;;5,0;;10,0;39,0;54,0;;7,0;5,0;;434,0;3,0;90,0;;;;;;;2,0;;34,0;2,0;;;;;;;;;;;;;;1,0;;197,0;;1,0;3,0;;;;;7,0;12,0;;;;;;;;;;;;241,0;;;;4,0;;;1,0;;4,0;;1,0;;6,0;4,0;2,0;;6,0;;35,0;;;;;1,0;;;;;;;;;;;;;;;;;;;2,0;42,0;;;61,0;3,0;4,0;;;;;;6,0;;;;;;;;;;1,0;;;;12,0;15,0;103,0;;;;;19,0;1,0;;;;;;;;8,0;1,0;4,0;;;;;91,0;;39,0;2,0;1,0;;;3,0;1,0;;;;21,0;18,0;;;;;;;;;17,0;;154,0;;4,0;;;4,0;;;;;;24,0;;57,0;;;310,0;8,0;;;;;;;;;151,0;2,0;;;;;;;;;;;1,0;;;;;;;;;;4,0;;;;;;;;;;;;;11,0;;;;;;;;;;4,0;;;;;;6,0;;;22,0;;;;;;;;;;2,0;;;;;9,0;;10,0;2,0;;;;;;;;;;;;;;;;;;;;11,0;;;;;;;;;;;;281,0;;60,0;;;;7,0;;;;;;;;;;;;;2,0;;;;;;;3,0;;;;;4,0;;;;;;;;;;;;;;;;;;;;;;;608,0;1,0;;;22,0;;;;;;;;;;;;;;;;;;;;;;;;;4,0;2,0;;;;;134,0;;;;;;11,0;;;;;;;;20,0;;;;;82,0;14,0;2,0;;;;;294,0;;;;;;;;;;;;;79,0;;;;;;;;;1,0;;;23,0;1,0;;;;3,0;4,0;;9,0;6,0;;;;;;;;2,0;;;;22,0;24,0;;;;;;;6,0;;;;;;;;;;;;;;1,0;;;;1,0;;;;;;;;;;;;6,0;;;;;;;;;;;;3,0;;;;;;;;;;;;;;;;;;5,0;;;9,0;;3,0;302,0;78,0;;36,0;13,0;74,0;104,0;;;153,0;14,0;218,0;103,0;;134,0;;11,0;;;;185,0;;;16,0;352,0;;50,0;;;;8,0;;;;13,0;;6,0;1,0;;;;;;;;;;;;;;;;;;;;;;;;;1,0;;;121,0;;;;;;;;;;;;;;;;;;;;;;;;;;;;;;;;;;;1,0;;;;;;;;;;;;;;;;1,0;;;2,0;;;;;;;;;;;1,0;;27,0;;;;;9,0;12,0;;;;;7,0;;;;;;9,0;;12,0;;;;;;;;1,0;;;;;;;;;;;;;;2,0;;;;;;;;;;;;;6,0;;;;;;;;;;;;;;;;;;;;;;;
travel;;;;;4,0;3,0;1,0;54,0;;;4,0;;;63,0;;;32,0;;1,0;7,0;;;1,0;3,0;;;;6,0;2,0;21,0;15,0;7,0;;4,0;;19,0;3,0;66,0;;;47,0;31,0;;1,0;17,0;2,0;;31,0;;;29,0;6,0;8,0;;1,0;;4,0;105,0;;26,0;;;1,0;;45,0;1,0;21,0;9,0;1,0;3,0;1,0;51,0;39,0;;;;3,0;;;;31,0;;2,0;;8,0;;;15,0;;;2,0;1,0;8,0;;;;;;23,0;10,0;43,0;22,0;5,0;2,0;;4,0;;1,0;;;;9,0;7,0;;;;;6,0;9,0;7,0;;;17,0;14,0;;3,0;46,0;;;;31,0;;2,0;10,0;;3,0;4,0;27,0;;;;;19,0;;;4,0;11,0;;103,0;1,0;;1,0;;;;1,0;;4,0;;;;;;;2,0;;1,0;1,0;;;;;2,0;257,0;;;;3,0;;;;22,0;;5,0;4,0;;2,0;;1,0;8,0;;;1,0;1,0;1,0;3,0;6,0;;;1,0;;;13,0;4,0;2,0;10,0;;;5,0;3,0;11,0;14,0;;;;1,0;3,0;3,0;;71,0;2,0;;;;;;5,0;;;1,0;1,0;7,0;4,0;;;5,0;4,0;;;;1,0;;;;;19,0;;1,0;9,0;4,0;;;;7,0;1,0;6,0;2,0;37,0;;;1,0;3,0;;322,0;;1,0;;;6,0;;;;8,0;;;;12,0;12,0;;;;1,0;7,0;1,0;;4,0;3,0;2,0;3,0;;;;;;;;39,0;;;;;;;2,0;;;;;8,0;9,0;1,0;;;;2,0;2,0;;;1,0;1,0;;34,0;32,0;1,0;;;;;4,0;;;;4,0;;1,0;;;;;;5,0;4,0;1,0;8,0;;;1,0;1,0;;;;;;;10,0;;8,0;;21,0;;;10,0;1,0;1,0;;;4,0;;;;;1,0;;3,0;1,0;4,0;;;6,0;;25,0;15,0;;;4,0;33,0;5,0;12,0;1,0;3,0;;;;2,0;9,0;1,0;;1,0;5,0;7,0;;5,0;;;;18,0;;3,0;24,0;4,0;;6,0;;1,0;;4,0;;;1,0;1,0;;;6,0;;;36,0;;3,0;;;;;14,0;;96,0;6,0;;9,0;;;3,0;1,0;3,0;;;1,0;;;11,0;7,0;7,0;;;;3,0;;;1,0;;;4,0;1,0;1,0;1,0;;;;;;;;2,0;38,0;3,0;;;;;;8,0;;;1,0;3,0;3,0;;7,0;;2,0;;1,0;1,0;22,0;;;;;;;;;;2,0;;4,0;2,0;6,0;;;;6,0;3,0;;;1,0;2,0;;1,0;;;2,0;1,0;;;;;;;1,0;;;;;7,0;1,0;2,0;1,0;;;2,0;;;;1,0;4,0;4,0;;2,0;;;3,0;;;;2,0;;;;;;;;;1,0;;;2,0;;;4,0;;2,0;;;;;5,0;3,0;;;;;6,0;;1,0;;;;;;;1,0;;;;;;;5,0;;;;;18,0;;;;;;;;;1,0;2,0;;;;;4,0;;1,0;;;1,0;;;4,0;;;;;;;2,0;;;7,0;;5,0;;;;1,0;;;;;;;;;;;;;;;1,0;;;;;2,0;;2,0;;;;1,0;;7,0;;3,0;;;;;;5,0;;;;;;;;;;;;1,0;;;;;;;4,0;;;;;;3,0;;;;;;;;;3,0;;;;;1,0;;;;;;;;;;;;;;;1,0;;5,0;;;;;;;1,0;27,0;1,0;;;;2,0;;;;7,0;;;;;;;;1,0;;;;;;;1,0;;;;;;1,0;;;;;;;;;;;8,0;;;;5,0;;;;;;;;;;;4,0;;3,0;;;8,0;;;;;2,0;;;;;;;;;;3,0;;;;;;;;;;;;11,0;;;;;1,0;;;;;;;14,0;;;;;;;;;1,0;;;;;;;1,0;;;;;;2,0;;1,0;10,0;;;;47,0;;;4,0;2,0;;;;;1,0;;;;;;;;;4,0;;;;1,0;;;;;;;;;;;;;;;8,0;;1,0;10,0;;;;;1,0;;;;;;;;;27,0;;;;;;7,0;;;1,0;;;;;33,0;;;;;;;;;;;;;;;;;;;;;;;;;;;;3,0;;;;;;;;;;;;;;;;;;;;;;;;9,0;;;;;7,0;;;
wearable;;;;;2,0;88,0;;;;10,0;;;;18,0;;;62,0;;;;;;;2,0;18,0;;;;3,0;;65,0;;;;;56,0;;;;;12,0;207,0;;8,0;58,0;3,0;;;;;;;;;11,0;;;;;10,0;4,0;;;;96,0;;70,0;;;;;3,0;3,0;;;;2,0;;;10,0;56,0;;1,0;1,0;16,0;;;;;;;1,0;;1,0;;;;;2,0;4,0;3,0;4,0;;1,0;14,0;21,0;6,0;;;;;;3,0;1,0;;;;;;15,0;3,0;;10,0;1,0;;19,0;158,0;;1,0;;20,0;;1,0;12,0;;;12,0;2,0;;;;1,0;;;3,0;;10,0;;13,0;3,0;;;7,0;;2,0;4,0;;;;;;6,0;;1,0;;;3,0;;;;3,0;;;3,0;;;;1,0;16,0;;1,0;;;2,0;1,0;;;;1,0;1,0;;6,0;;;8,0;;8,0;7,0;;;;;1,0;2,0;;1,0;;;;17,0;4,0;4,0;;;;;11,0;;;;3,0;3,0;12,0;;;;14,0;;;;;;1,0;;;;;;;;;2,0;;;;10,0;9,0;4,0;10,0;;2,0;;;4,0;;;2,0;1,0;;;;30,0;;1,0;;;;;;2,0;;;;;;;;4,0;;;1,0;;;;;;;1,0;3,0;;4,0;;;;3,0;;;;;2,0;2,0;;1,0;;;;;8,0;;6,0;;;;;4,0;;2,0;;;14,0;3,0;37,0;;;;;;;3,0;;2,0;;;;79,0;;;;;;;1,0;;;;2,0;;;1,0;;;;;;4,0;;1,0;;65,0;23,0;;;4,0;8,0;1,0;2,0;;;;1,0;;;;;3,0;;;1,0;;;36,0;2,0;;2,0;;10,0;;3,0;;;2,0;2,0;;;;;;5,0;7,0;;;11,0;;;;9,0;;;4,0;;;1,0;;7,0;5,0;2,0;;2,0;;;;;2,0;;;41,0;18,0;12,0;1,0;;;;;1,0;1,0;;8,0;2,0;14,0;;;1,0;5,0;;;;;;107,0;;;;3,0;;;;;;1,0;;8,0;;;;;;;;;;8,0;4,0;18,0;1,0;;;;;;;1,0;;2,0;;;;6,0;;4,0;9,0;;;2,0;;2,0;;13,0;1,0;;;;2,0;;7,0;;;8,0;;;1,0;4,0;;1,0;8,0;;;;;;;3,0;;;;;;;;;;1,0;;;3,0;;;1,0;2,0;;8,0;;;;1,0;;1,0;;;;;;;;;6,0;2,0;;;;;1,0;43,0;;;1,0;;1,0;;;2,0;1,0;;;;2,0;;;;;;;;;;;3,0;;1,0;;;4,0;1,0;;4,0;;;;7,0;9,0;;;;;;1,0;;;;;;;;;;;;;7,0;1,0;;;4,0;;;;;;;;;;;;;;;;1,0;;1,0;3,0;;;;;;;;;1,0;;;1,0;;;;;2,0;;;;3,0;13,0;;1,0;;;;;;1,0;;;1,0;;;;;3,0;;;;2,0;;;10,0;;;;;;;;;;;;;;;;;;;1,0;;;;;4,0;;;;;;;;;;;1,0;;;2,0;;;;;2,0;1,0;;2,0;;1,0;;3,0;;;;;;;;;;;;;;;;;;;;;;;;;;;;;;;;;;;;;1,0;;;;;;3,0;;;;;1,0;1,0;;;;;;;;;;;;1,0;;;;;;;;;;;;3,0;;;;;;;;;;;;;;;;;;;;;;;;;;;;;;;;;;;;;;;;;;;1,0;;1,0;;;;;3,0;;;;;;;;;;;;1,0;;;;;;;;;;;;;1,0;;;;;;;;;;;;;;;2,0;;33,0;;;;;;;;;;;;;1,0;;;;;;;;;;;;;;;;;;;;;;;;;;;;;;;;3,0;;;;;;;;;;;;;;;;;;;;;;;;;;;;;;;;;;;2,0;;;;;8,0;;;;;;;;;;;;;;
write;;;;;2,0;3,0;2,0;;;;;;;2,0;;;5,0;5,0;;;;;4,0;;1,0;;;2,0;;1,0;14,0;4,0;;;;100,0;;;;;5,0;34,0;;;11,0;;;;;;;;;5,0;5,0;4,0;3,0;;;1,0;;;2,0;;82,0;;6,0;;;;;;6,0;;;;;;;135,0;9,0;;2,0;;21,0;;;1,0;;;;;;;;;5,0;;30,0;8,0;;5,0;;4,0;5,0;13,0;;;;;8,0;;1,0;;;;;11,0;;7,0;;;40,0;;;1,0;1,0;;;;18,0;;;56,0;;;1,0;10,0;;;;;;;;;;1,0;12,0;;;;;;35,0;;;;;;;;;1,0;;;1,0;;;;;;;12,0;;;;;1,0;3,0;;;;;;;1,0;;23,0;;;;;1,0;;;;;;;;;;;;6,0;;;;;;;;;;;1,0;;;;4,0;31,0;;;;;1,0;;;;;;2,0;;;1,0;;;;;;;;;;4,0;;2,0;;;;;;;;;;7,0;;;2,0;;;;;;;;;;;;;4,0;;;;;;;;;;;;;;;1,0;;;1,0;;;;;;;;;;;;;;;;;;4,0;;;1,0;2,0;;;;;;;;4,0;;;;;2,0;;1,0;;;;;;3,0;;;;;;;;;;;;;;;;;;;;;;;;7,0;;;;;;;;1,0;;;;;;2,0;;8,0;;;19,0;;;33,0;;;;;2,0;;;;;;;;;;;;;6,0;;;;;14,0;;;;;3,0;;;;;;6,0;;4,0;;;;;5,0;;23,0;;14,0;;8,0;;;2,0;;5,0;2,0;;;4,0;4,0;1,0;;;;;;;;;;;;;;2,0;;;;;;;3,0;;;;;;3,0;;;;;;;3,0;4,0;;;;;;;;2,0;;;;;;;;;;3,0;;;;;3,0;;1,0;;;8,0;;;3,0;;;;;;;;;;;;;;;;;;;;;;;;;;;;;;8,0;;;;;;;;;;;;;;;;;;3,0;;3,0;4,0;;1,0;;1,0;;6,0;;;;;;;;;;;16,0;;;;;;;;;;;;;;;3,0;;;;;2,0;;;;;;;;;1,0;;;;3,0;;;;;;;;;;;;;1,0;;;;;;;;;;;;;;;;;;;;;;;;;;;;2,0;;;;9,0;;15,0;1,0;;;;4,0;2,0;;;;;;;;;1,0;;1,0;;;;;;;;;4,0;;;;;;;;;;;;;;1,0;;2,0;;1,0;;;;;;;;;;;;;;;;;;1,0;;;;;;2,0;;;;;;;;;;;;;;2,0;;;;;;1,0;;;;;;;;;;;;;;;;;;;;;;;;;;;;;;;;3,0;;;;;;;;;;;;;;;;4,0;;;;4,0;;;;2,0;;;;;;;;;;;;;;;;;;5,0;;;;;;;7,0;;;;;;;1,0;;;;;;6,0;;;;;;;1,0;;;;;;;;;;6,0;;;1,0;;;;;;;;2,0;1,0;;;;;;;;;2,0;;;;;;;;;;;;;;;;;;;;;;;;;;1,0;;;;;;12,0;;;;;;;;;;;;;;;;;;;;;;;2,0;;;;;;;;;;;;;;;;;;;;;;;;;;;;;;;;;;;;;;;;;;;;;;;;;;;;;;;;;;;;;;;;;;;;;;;;
activity;;;;;;4,0;;;;;;;;21,0;;;9,0;;;;;;;4,0;;;;;;;7,0;2,0;;;;4,0;;;1,0;;15,0;30,0;;1,0;3,0;;;;;;;;;;5,0;;;;;14,0;;;;;7,0;;22,0;;;;;;1,0;;;;;;4,0;1,0;14,0;;3,0;;;;;;;;;;;;3,0;;;;12,0;;2,0;3,0;;1,0;1,0;3,0;;;;;;;;;;;2,0;1,0;7,0;4,0;6,0;;12,0;;;4,0;15,0;;;;6,0;;;;;;3,0;;;;;;;;;6,0;9,0;;8,0;2,0;;;;;;;;;;;;2,0;12,0;;;;;;;5,0;;;;;;;;;1,0;;;;;;;;1,0;;10,0;;;;;;;;;;;;;;1,0;;;1,0;;;;;;1,0;;;;;1,0;;;;;3,0;5,0;;;;;;;;;;;;;2,0;;;;1,0;;;;;;8,0;;;;;;;;;;2,0;;;;;;;;1,0;;8,0;;;;;;;15,0;;;;;;;;;;;;;;;;;;;;;;;;;;;3,0;;;;;;;;;;;;;;;;;;4,0;;;18,0;1,0;;;;;;;2,0;;;;;;3,0;;;;;;;;;;;1,0;;2,0;;;;;;;3,0;;;;27,0;1,0;;;;2,0;;;;;;;;;;;1,0;;;;;;8,0;;1,0;;;21,0;;;;30,0;;;5,0;;;5,0;;4,0;;6,0;;;;29,0;;3,0;1,0;8,0;;;;;2,0;2,0;3,0;;;;;;;;;;2,0;3,0;;9,0;;;;;;;;;1,0;;;;;;3,0;;;1,0;;;41,0;;;;;;;;;;5,0;;6,0;;;;;;;;;;11,0;;3,0;4,0;;;;;;2,0;;;;2,0;;1,0;5,0;;;;;;;;;;;;;;;5,0;;;9,0;;;1,0;;;1,0;;;;3,0;;;;;;;;;;;;;;;;;;2,0;;;;;;;;;;;2,0;;;;;;;;;;;5,0;3,0;;;;;;;3,0;1,0;2,0;;;2,0;2,0;;;;;;;;;;;;;;;;;;;;;;;;;;6,0;;;;;;;;2,0;18,0;;;;;;;;;;;;;7,0;;;;3,0;;;16,0;2,0;;;;6,0;1,0;;3,0;;4,0;;;;;;;;;;;1,0;;;;;;;;;;;;;;;;;;;2,0;;;;;;;;;;;;;;;24,0;;;;;;;5,0;2,0;;;;;;;;;;;;;;;;;;;;;;;;;;;;;;;;;2,0;;;;;;;;;;;;;;3,0;;;;;;;2,0;;;;;;;;;;;;;;;;;;;;;;;;;;;;;;;;;;;;;;;;;;;4,0;;;;;;;;;;;;;;;;;;;;;;;;;1,0;;;;;;;;;;;;;;2,0;;;;;;;;;;;;;;;;;;3,0;;;;;;;;;5,0;;;;;;;;;;;1,0;;;;;;;1,0;;;;;;;;1,0;;;;;;;8,0;;;;;;;;;;;;;;;1,0;2,0;1,0;;;;;;;;;;;;;;;;;;;;;;;;;;;;;;2,0;8,0;;;;;;;;;;;;;;;;;;;;;;;;;;;;;;;;;;;;;;;;;;;;;;;;;;;;;;;;;;;;;;;;;;;;;
address;;;;;;38,0;7,0;1,0;;;;;;18,0;;;1,0;;1,0;;;;;;2,0;;;;3,0;;12,0;4,0;;;;61,0;;;;;4,0;65,0;;1,0;5,0;;;8,0;;;;;;;;8,0;;;;4,0;;;11,0;;58,0;;27,0;1,0;;;;;2,0;;;;;;6,0;10,0;18,0;;2,0;;18,0;;;;;1,0;8,0;;;;1,0;;28,0;10,0;6,0;3,0;2,0;2,0;;;24,0;4,0;1,0;9,0;;;;;6,0;;;;2,0;6,0;;16,0;;;18,0;;;14,0;7,0;;;;4,0;;;15,0;;;2,0;27,0;;;;;;;;3,0;5,0;;26,0;;;;;;3,0;;;;;;;4,0;;2,0;;;10,0;;;;;;;;;;6,0;;;;;;;1,0;;;;;12,0;;;;;;;;1,0;;;;;;;;;;;;;;;;1,0;;;;8,0;;;;;;;1,0;;;1,0;;;;;;2,0;;;2,0;;;;;;;;;;71,0;;;2,0;;;;;;;;;;;;1,0;14,0;1,0;5,0;;;;;;;;;;3,0;;;1,0;3,0;;;;;;;;;;;1,0;;;1,0;;;;;;;;;;;;;;;;;;6,0;;;;;;;;;;;3,0;;;;;;;;;;;;;;7,0;;;;;;;;1,0;;;;;;;;;;;;;;;;14,0;1,0;;;;;7,0;;4,0;;;;;;1,0;;9,0;;;24,0;;;46,0;1,0;;;2,0;1,0;;2,0;;;;1,0;2,0;;2,0;1,0;;11,0;6,0;;;11,0;2,0;4,0;;;2,0;6,0;1,0;;;;;1,0;3,0;;;;;;;;;7,0;;18,0;2,0;4,0;;;;25,0;;;;;10,0;;17,0;;;36,0;;;1,0;;;;3,0;;;;;;;;6,0;3,0;;;;;;;;;;;;;2,0;;4,0;15,0;;;;;1,0;;;;;;;;2,0;12,0;37,0;;;;;;;;1,0;;;;;;;;;;;;;3,0;;;;1,0;;6,0;;3,0;;;5,0;3,0;;;;;;;;;;;;;;;;;1,0;;;;;3,0;;;;;1,0;;;;;;2,0;6,0;3,0;;;;;;;;;;;;10,0;;;;;;;;;;;;;;;;;;;;8,0;;;;;;;;;;;2,0;;;;;;2,0;;1,0;;;;;;;;;;4,0;33,0;12,0;1,0;;;;6,0;;;;8,0;;;;;30,0;;10,0;;;;;1,0;;;;;;;;6,0;;3,0;;54,0;2,0;4,0;;;;;;;1,0;18,0;4,0;;;;25,0;;6,0;;;;1,0;;;;4,0;11,0;;;;;7,0;1,0;;;;;;;;;;;1,0;;;;;;;5,0;;;;;;;;;;;;;2,0;;;;;9,0;;;;1,0;;;;;;;;;;1,0;3,0;;;;;;;;;;;;;2,0;2,0;;;;;;;;;;;;;;;;;;;;;;;;;;;;3,0;;;;;;;;;;;;;;;19,0;;;;21,0;;54,0;;;;;;;;;;;;1,0;8,0;;;3,0;1,0;;;;;;;;16,0;2,0;;;;;;;;;;;;;;;;;2,0;;;;;;;;;;;;4,0;;;;;;;;;1,0;;;;;;;;;;;;1,0;;;;1,0;;;;;;;;;;;;;;;;;;;;;;;;;;1,0;;;;;;2,0;;;;;;;;;;;;;;;;;;;;;;;;;;;;;;1,0;;;;;;;;;;;;;;;;;;;;;1,0;;;;;;;;;;;;;;;;;;;;;;;;;;;;;;;;;;;;;;
alert;;;;;;8,0;;;;;;;;27,0;;;4,0;;;25,0;;;1,0;3,0;4,0;;;3,0;1,0;54,0;30,0;5,0;;;;9,0;3,0;;5,0;;21,0;57,0;;11,0;63,0;1,0;;3,0;;1,0;1,0;;;2,0;2,0;;;;4,0;49,0;;;;2,0;48,0;;11,0;;1,0;;;1,0;3,0;;;;;;;9,0;49,0;;;;3,0;;;;;8,0;;;;;;;;;13,0;;2,0;;;6,0;3,0;23,0;;;2,0;;;3,0;4,0;;;;;8,0;4,0;6,0;1,0;;15,0;;;6,0;98,0;;;;;;;6,0;1,0;;1,0;;;;;;1,0;3,0;;;12,0;;19,0;;;3,0;2,0;;;;;;;;;2,0;;;;;;;;2,0;;;1,0;2,0;;;;;;;;20,0;;1,0;;;3,0;;8,0;2,0;;;;;;;;;;;;;2,0;;;;;;;;;9,0;;;;;11,0;;;;2,0;;1,0;;;;6,0;;;1,0;;1,0;;;;;;;;;;;;;;9,0;;;;;;;;2,0;;1,0;;;;;;38,0;2,0;34,0;;;;;;1,0;;;;;;;;;;;;;;;;;;;1,0;;;;;;;;;17,0;;;;;;;;;;1,0;;;;;;;;;;1,0;3,0;6,0;2,0;6,0;;;6,0;;;;1,0;;;;;;3,0;;;;;;;;;;;;;2,0;;;;;;;2,0;;2,0;;15,0;7,0;;;;3,0;2,0;;1,0;;;;;;;;3,0;;;;2,0;2,0;19,0;;;;;17,0;;;;56,0;;;;;2,0;4,0;;;2,0;1,0;;;;3,0;;3,0;;6,0;10,0;;;;;;5,0;;;;;1,0;;;;;;16,0;2,0;14,0;;;1,0;1,0;1,0;6,0;1,0;;12,0;15,0;;;1,0;4,0;21,0;;;;;;47,0;;;1,0;4,0;;;2,0;;;;2,0;9,0;;;;;;;;;;5,0;21,0;1,0;2,0;;;;1,0;;3,0;;;;2,0;8,0;;3,0;5,0;;;;4,0;;2,0;4,0;;4,0;10,0;;;;;;;;;19,0;;;;21,0;;;;;;;;;;;;;;;;;;;;;;;;;;;;;;;1,0;;;;;;;;;;;;;4,0;;;;1,0;;;;;;;;27,0;;;;8,0;;;;3,0;3,0;;;;1,0;;;;;1,0;;;2,0;;;12,0;;;;1,0;;;;4,0;;;;;4,0;;3,0;;;;;4,0;;;;;;3,0;2,0;15,0;;3,0;;2,0;5,0;;;;;;;;3,0;;4,0;;;;;;;;;;;2,0;;;1,0;1,0;;;;;;;;6,0;;;;;8,0;1,0;;;;;;;2,0;3,0;1,0;;1,0;;;1,0;;3,0;;;;3,0;;6,0;25,0;3,0;;;;2,0;;;;;;;;;;;;;;;;;;;;;;;;;;;1,0;1,0;;2,0;;;8,0;35,0;;;;;;;;;;;1,0;;;;;1,0;;;;;;4,0;;;;;;;;;;;;;;;;;;;;;;;;;;1,0;;;1,0;;;;;;;;;;;4,0;2,0;;;;;;;;;;;;;;;;;;;;;;;;;;;;;;;;;;;5,0;;;;;;;;;;;;;;;;;;;;;;;;;;;;;;;;;;;;;;;;;;;;;;;;;;4,0;;1,0;;;;;;;;;1,0;;;;;;;2,0;;2,0;;;;;;3,0;;;;;;3,0;;;;3,0;;;2,0;;;;;3,0;;;;;;;;;1,0;;;;;4,0;;;;;;;;;;;;;;;;;;;;;;3,0;;;;;;;;;;;;;;1,0;;;;;;;;;;;;;;3,0;;;;;;;;;;;;;;;;;;;
amplifier;;;;;;12,0;;;;;;;;;;;;3,0;3,0;;;;;;;;1,0;;;;77,0;4,0;;4,0;2,0;4,0;;;;;;39,0;;8,0;1,0;1,0;;5,0;;;;;;;;;5,0;;12,0;2,0;;;;;22,0;;134,0;2,0;;;;1,0;1,0;;;;;;;;4,0;;2,0;;3,0;;1,0;4,0;;;3,0;;;;;;15,0;;33,0;;5,0;6,0;;;9,0;4,0;;;;;;8,0;12,0;;;;;;;13,0;;;124,0;;;;9,0;;;;2,0;;;23,0;;;;;;;;;;;;2,0;;7,0;;;4,0;;;;6,0;24,0;;;;;;74,0;;8,0;46,0;;13,0;;;1,0;5,0;3,0;;5,0;;;3,0;;;;;;;;;;3,0;2,0;;;;;;12,0;;;;;;;;;;4,0;1,0;;;;31,0;;;;;;;;194,0;16,0;;;;1,0;;9,0;;;35,0;;;1,0;;;;;;;;1,0;;;;;;;;5,0;;2,0;1,0;;;;;;11,0;5,0;;3,0;;;24,0;4,0;7,0;;;;;;;;;;7,0;;;;;;;;;;;;;;;;56,0;;1,0;;;;;;;2,0;;;;;;;;;;;;35,0;;;;;;;1,0;3,0;;;4,0;;;;;;;;7,0;;;;;;;;;;;;;;;;;;;;;;;;;;;;7,0;;;2,0;;;;;;;;;;;;;;;3,0;2,0;;;3,0;4,0;30,0;;;;;18,0;;2,0;;;;1,0;;;1,0;;;;;;;85,0;;48,0;;;;;;1,0;;;;;2,0;;;;;;;2,0;;10,0;1,0;5,0;;;;;;;;;;;2,0;;17,0;;;69,0;4,0;;;1,0;;;;;;61,0;;;;;1,0;;;;;;;;;;;;4,0;;;;;;;;;;;;;;;;;;;;;;5,0;;;;;;;;;;;;;;;6,0;;;;;;;;;;2,0;;;;;4,0;;;;;;;;;;;;;1,0;;;;;;;;;;;;;;;;;;;;;;12,0;;;;;;;;;;;;;;;;;;;;;;;;;;;;;;;;;;2,0;;;;;;;;;;;;;;;;;;;50,0;31,0;;;;4,0;;;;2,0;;;;;2,0;;;;;;;;;;;;;;1,0;;;2,0;;1,0;;;12,0;;;;;;3,0;;;;;;;;23,0;;;;;5,0;;;;;;;27,0;;;;;;;;;;;;;;;;;;;;10,0;;;;;;;;;;;;;;4,0;;;;;;;;;;2,0;;2,0;;;;;;;;;;;;;;;;;;;;;;;;;;;;;4,0;;;;;;;;;;;;;;;;;;;;;;;;;;;;;;;;;;;;;;;;;;1,0;6,0;;;43,0;5,0;51,0;35,0;4,0;2,0;17,0;;26,0;1,0;2,0;14,0;;30,0;;;17,0;;;118,0;;;2,0;37,0;;2,0;;;;;;;;13,0;;8,0;;2,0;;3,0;302,0;;;;;;;;;4,0;;;;;;;;;;;;14,0;;;58,0;;;;;;;;;;;;;;;;;3,0;;;;;;;;;;;;;;;;;;;;;;;;;;;;;;;;;;;;;;;;;;;;;;;;;;3,0;;;;;;1,0;;;;;;;;;;;1,0;;19,0;;;;;;;;;;;;;;;;;;;;;;;;;;;;;;;;1,0;;;2,0;;;;;;;;;;;;;;;;;;;;;;;
annular;;;;;;5,0;1,0;23,0;;;2,0;;3,0;24,0;;;;;16,0;;;1,0;;;;;;6,0;;;12,0;;;;;;8,0;;;;;23,0;4,0;;;38,0;;22,0;;;;1,0;18,0;6,0;;;37,0;;;;;;;;1,0;;26,0;1,0;;4,0;;52,0;36,0;1,0;;;2,0;;;;6,0;;;;7,0;3,0;;21,0;;;;8,0;10,0;17,0;;;;9,0;15,0;;54,0;;;;;;;;;;;;5,0;;;;;4,0;;3,0;;;;2,0;;;3,0;;;;;;3,0;2,0;;3,0;7,0;;;;;3,0;;;7,0;;;16,0;;21,0;6,0;;58,0;11,0;;;4,0;;;;6,0;11,0;;;;;6,0;13,0;;;1,0;;;19,0;8,0;25,0;;;2,0;;;1,0;;;;;5,0;2,0;10,0;32,0;;;;6,0;6,0;7,0;12,0;;27,0;7,0;;2,0;;1,0;;;29,0;;7,0;20,0;4,0;;;;;55,0;1,0;4,0;1,0;;3,0;;;;20,0;;119,0;;4,0;;7,0;;;;24,0;;;6,0;2,0;;1,0;33,0;5,0;;6,0;;2,0;32,0;18,0;;4,0;;;3,0;;;6,0;92,0;5,0;;;;;2,0;31,0;;6,0;;;4,0;;;1,0;;1,0;;1,0;;2,0;2,0;;;10,0;2,0;;;;;1,0;4,0;5,0;;4,0;8,0;3,0;5,0;2,0;;2,0;4,0;3,0;40,0;1,0;;;26,0;;14,0;;1,0;2,0;;3,0;;;;4,0;5,0;;;;1,0;7,0;2,0;;6,0;;6,0;;;12,0;5,0;;9,0;;;;;;1,0;5,0;1,0;;5,0;;;;27,0;;4,0;;;;;;2,0;;4,0;;;10,0;;;;;;;;;1,0;5,0;;;13,0;;;;;;;;;;;;;;3,0;;;;;;1,0;1,0;1,0;;;;;;2,0;9,0;1,0;;;;;;7,0;;1,0;;;6,0;3,0;;;;;;;;;;4,0;;;;;;;;;;;;;;;;;;;;;;;;;;;;;;;;;;;;1,0;;1,0;;;;;;;;;;;4,0;1,0;3,0;;;;4,0;;;;3,0;;;;;;1,0;;;8,0;;;;;;;;;1,0;;;;;;;;;;;;;1,0;18,0;2,0;;1,0;1,0;4,0;;;;;5,0;;6,0;;6,0;;;2,0;;;;;;1,0;;;;28,0;;;;;;;1,0;8,0;;;;;;;;;;;;;;;;;2,0;;;;;13,0;2,0;;;;;;;2,0;;1,0;;11,0;2,0;;;;;;;1,0;;;;;2,0;;;;;;;;;;;1,0;;;;;;;;;;;;;1,0;;;;1,0;;;;;;;;;;2,0;;2,0;;;;1,0;;;;;2,0;;;;;;;2,0;;;;;;;;;;;;;;;;9,0;;;;;;;;;;;;;;;;;;1,0;;;3,0;;;;3,0;;4,0;;2,0;1,0;;;2,0;;;1,0;3,0;;;;2,0;;;;7,0;;;2,0;;;;;;;1,0;;;;;;;;;2,0;;;;;18,0;;;;2,0;;;;;;;;;;6,0;;;;;2,0;2,0;3,0;;;2,0;;;;;;;;3,0;15,0;;;;2,0;;;;;;4,0;;2,0;;;;;;;;;;;;;;;;;;1,0;;;;;;;;;;;;;;;;;;;;;;;;;;;;;;;;;;3,0;;;;;;;;;;;;;;;;;;;;;;;;;;;;;;;;;;;;;;;;;;;1,0;;;;;;;;;;11,0;;;;;;;1,0;;;;;;;;;;;;5,0;;;;;;;;;;;;;;;;;;;;;;;;;3,0;;;;;;;;;;;;;;;;;;;;;;;;;;;;;;;;1,0;;;;;;;3,0;;;;;;;;;;;;;;;;;;;;;3,0;;;;;;
aspheric;;;;;;4,0;;106,0;;;;;1,0;;3,0;;;;;;;;1,0;;;15,0;;19,0;;4,0;100,0;;29,0;;;;;8,0;;;;8,0;;63,0;;4,0;6,0;286,0;;22,0;;;;;48,0;2,0;3,0;;;;2,0;;12,0;;20,0;;128,0;;;;6,0;513,0;12,0;;;;;;;;2,0;;;;1,0;;;164,0;;2,0;;;2,0;;;;;1,0;15,0;57,0;;;;;;;;;;;;;;1,0;;;;;;8,0;;;;5,0;;;6,0;2,0;;1,0;43,0;6,0;;4,0;;;3,0;;2,0;;;;;;6,0;;;;;;;1,0;;;;;;;;;;;;;;;;;;;;;;;;3,0;;;;;;;;18,0;;;7,0;;;4,0;;;;;;;;1,0;;;;;;;;;;;;;;;;;;;;;;;;;;;;;1,0;;;;;;;;5,0;;;;;;;;;;;;;13,0;30,0;;;;;;;;;384,0;;;;6,0;;;;;;;;;;;;;;;;;;;;;2,0;;;;;;;;;;;;4,0;;9,0;;;;;;;;;;;;;18,0;;;;;;;;;;;;12,0;;;;;;;7,0;;;;;;;;;;;;;;;;;;;5,0;;;;;1,0;;5,0;;;;;2,0;;;;3,0;;;;;;;;;;9,0;;;;;;;;;;;;;;;;;;;;;;;;;;;;;;;;;;;;;;;;;;;;;;;;;;;;1,0;;;;;;;;;;;;;;;;;;;;;;;;;;1,0;;;;;;;;;;;;;;;;;;;;;;;;1,0;;;;;;;;14,0;;;;;6,0;;;;5,0;;;;;;;;;;;;;;;;;;;;;;;;;1,0;;;;;;;;;;;;;;;;;1,0;;;;;;;;;;;;;;;;;;;;;;;;;;;;;;;;;;;;;;;;2,0;;;;;;;;;;;;;;;;2,0;;;;;;;;;;;;;;;;;;;;;;;;;;;;;;;;;;;;;;;;;;;;;;;;;;;;;;;;;;;;;;;;;;;;;;;;;;;;;;;;;;;;;;;;;;;;;;;;;;;;;;;;;;;;;;;;;;;;;;;;;;;;;;;;3,0;3,0;;;5,0;;;;;;;;;;;;3,0;;;;;;1,0;;;;;;;;;;;;;;1,0;;;3,0;;;;1,0;;;;;;;;;;;;;;;;;;;;;;;;;;;;;;;;;;;;;;;;;;;;;;;;;;;;;;;;;;;53,0;;;;;;;;;;;;;4,0;;5,0;;;;;;;;;;;;;;;;;;;;;;;;;;;;;;;;;;;;;2,0;;;;;;;;;;;;;;;;;;;;;;;;;;;;;;;;;;;;;;;;;;;;;;;;;;;;;;;;;4,0;;;;24,0;;;;;;;;;;;;;;18,0;;;;;;8,0;;1,0;;;;;;;;;;;;;;;;;;;;;;;;3,0;;;;;;;;;;;;;;;;;;;;
auxiliary;;;;;;25,0;;11,0;;;;;1,0;17,0;;;8,0;;;;;;;;3,0;;28,0;1,0;2,0;;11,0;;;;;10,0;;;;;5,0;49,0;;4,0;16,0;10,0;;1,0;;;1,0;;3,0;;3,0;;3,0;;;4,0;;;1,0;;26,0;;22,0;;1,0;;5,0;15,0;69,0;;;;;2,0;;6,0;10,0;;2,0;;6,0;;;8,0;;;4,0;;;;;;;;3,0;;26,0;;;;3,0;11,0;;1,0;;;;2,0;5,0;;3,0;1,0;;5,0;4,0;8,0;;;24,0;;;2,0;15,0;;;;44,0;1,0;;1,0;;;18,0;2,0;;;;;;;;6,0;;7,0;2,0;;;;3,0;;;;;;3,0;1,0;;7,0;1,0;;;;10,0;11,0;;2,0;1,0;;1,0;9,0;;2,0;;;2,0;;2,0;1,0;;1,0;;;;;25,0;;1,0;;;;3,0;;;;;1,0;;;;3,0;3,0;;;;;20,0;3,0;5,0;;;;;;4,0;;;;1,0;;;1,0;;10,0;2,0;;3,0;;;9,0;;;;;;2,0;1,0;1,0;3,0;;1,0;;2,0;;1,0;4,0;;;4,0;;5,0;1,0;;7,0;4,0;;;;2,0;1,0;15,0;2,0;;1,0;;;3,0;;2,0;;;2,0;2,0;;;;;;1,0;5,0;;;2,0;1,0;1,0;3,0;;4,0;4,0;;;;14,0;;;1,0;;;;3,0;;;;;;;;;4,0;2,0;;3,0;;;2,0;;1,0;3,0;5,0;;;;;2,0;;2,0;3,0;;1,0;;;;;;;;;;3,0;;;;;;;;;;;;;;;30,0;;2,0;1,0;;;;;1,0;3,0;5,0;;4,0;1,0;;;4,0;1,0;;;2,0;;;2,0;8,0;;2,0;1,0;;6,0;;;5,0;4,0;;;;2,0;;;;;;;;3,0;1,0;6,0;;;;4,0;1,0;;;2,0;;3,0;2,0;2,0;;;;1,0;;2,0;1,0;;;16,0;;2,0;1,0;;;;;5,0;;;;;7,0;;;1,0;;;;;;;7,0;;;;1,0;1,0;;1,0;;10,0;;;;;4,0;6,0;;;;;;;;;;;;;1,0;4,0;;;12,0;;24,0;;;;2,0;;;;;;;;;;;;;1,0;1,0;;5,0;;;;;;;;7,0;;10,0;2,0;1,0;;;3,0;;6,0;3,0;2,0;;;;;;;;;;;;1,0;;;;;;;;;;3,0;;;;;1,0;;;;;;;;;;;;;3,0;;;;;;5,0;;;;1,0;;;2,0;;;1,0;;;;;;;;;;;;2,0;;;;;;;;3,0;;;;;;;;;;;;;;4,0;;;;;;1,0;;;;;;1,0;;;;;;;;;;2,0;;;;;;;;;;4,0;;;;;;;;;;;;;;;;;;2,0;;;3,0;;2,0;;3,0;;61,0;1,0;;1,0;;;;;;;;3,0;;;;2,0;;;;;;;;;;;;;;3,0;;;;2,0;3,0;;;;;;;;;;;1,0;;2,0;;;;;;;;;;;;;;;;;;;;;;;;;;;;;;;;;;;;;;;;;;;1,0;;;;;;;;;;;;1,0;;;;;;;;;3,0;;;;;;;;;;;;;;;;;;;;;;67,0;;;;;;;;;;;;;2,0;;;;;;1,0;;;;;;;;;;;;;;;;;;;;;;;;;;;;;;;2,0;;;;;;;;;4,0;;;;;;;;;;;;1,0;;;;;;;;;;;;;;;1,0;;;;;;;;;2,0;;;3,0;;;;;;;4,0;;;;;;;;2,0;;;;;;;;;;;2,0;12,0;;;;;;;;;;;;;;;;;;;;;;;;;;;;;;;;;;;;;;1,0;;;;;;;;;;;;;;;;;;1,0;;;;;;;;;;;;;;;
barrier;;;;;;13,0;10,0;2,0;;;;;;;;;14,0;;;;;;;;5,0;;;;1,0;;7,0;5,0;;;;;4,0;;1,0;;7,0;11,0;;1,0;;5,0;;1,0;;;;1,0;7,0;1,0;6,0;3,0;16,0;;;;;;;;17,0;;16,0;;;;;31,0;14,0;;;;1,0;;;;14,0;;;;4,0;;;39,0;1,0;;;;;2,0;;;;6,0;16,0;2,0;16,0;8,0;;1,0;3,0;;;2,0;;;;;48,0;;;;;;;7,0;;;2,0;2,0;1,0;;8,0;;;6,0;2,0;;;6,0;;;3,0;;;;;4,0;;;3,0;;;4,0;8,0;;;2,0;2,0;3,0;;18,0;;;;;5,0;5,0;;;;;1,0;15,0;;4,0;;;;;;;;;;;;;;2,0;;;1,0;;2,0;;;;;;;;4,0;1,0;2,0;;;20,0;1,0;;;;;14,0;7,0;;13,0;4,0;;3,0;;2,0;;;;8,0;;2,0;1,0;1,0;2,0;;33,0;;4,0;;;6,0;;;;;;;;;;;;;2,0;10,0;1,0;;7,0;;;;;8,0;11,0;;;6,0;2,0;;2,0;1,0;4,0;7,0;1,0;;;;;3,0;;;5,0;;;;;;;;4,0;4,0;;;;;9,0;;;;;;;;;;2,0;1,0;;2,0;;2,0;;;;;;;4,0;3,0;;;1,0;;;;5,0;;;4,0;1,0;;;;;;3,0;;;;;;;;;;1,0;;;;;;;;;1,0;;;;;;;;;;;;1,0;;;;;;;2,0;;;;;2,0;;;;;;;;11,0;;;12,0;;;;;24,0;2,0;;;8,0;;;;;;;;;3,0;;;4,0;1,0;;;;;;12,0;;;2,0;;10,0;3,0;;;;;;;;;2,0;;3,0;2,0;6,0;;;10,0;;;;;;;;;;;;1,0;;;1,0;;;4,0;;;;4,0;;;;;;;;4,0;;;;2,0;;;;;;;4,0;9,0;3,0;;;;;;;;;;;6,0;;;5,0;;;;;1,0;6,0;1,0;;;11,0;;;;;;;;1,0;;;;;;;;;;5,0;;13,0;;;;;2,0;;;;2,0;;;;;;1,0;;;;;;1,0;;;;;28,0;;;;;;;;;;;;;;;;;;;;;;;9,0;;2,0;;;;;;;;;;2,0;;;;;;;;;;;;;;;;;;;;;;;;;;;;;;;;;;;;;;;;;;;;;;;;;;;;;;;;;;;;4,0;;;;;;38,0;;;2,0;;;;;;;;1,0;;;;;;12,0;;;;;;;1,0;;3,0;;;3,0;;;;;;;;;;;;;;;1,0;;;;;;;3,0;;;;;;;;6,0;;;;;;;;;;;;;;;;;;;;2,0;;;10,0;;;;;;;;;;;;;;;;;;;;;2,0;;;;;1,0;;;3,0;;;;;;;;;;;;;;;;;3,0;;;;;;;;;;;;7,0;3,0;;;8,0;;;;;;;;1,0;;;;;1,0;2,0;;;;5,0;;;;;12,0;;;;;34,0;;;;;;;;6,0;;;;;;;3,0;;;;;;;;;;;;;;;;3,0;;;;;;;;;;;;;;;;;;;;;;;;7,0;;;;;;;;;;;;;;;;;;;;;;;;;;;41,0;;;;;;;;;;4,0;;;;;;;;;;;;;;;;;;;;;;;;;;;;;;;;;;;;;;;;;;;;;1,0;;;;;;;;;;;;;;;;;;;;;;;;;;;;;;;;;;;;;;;;;;;;;;
bobbin;;;;;;31,0;;17,0;;;2,0;;25,0;78,0;;;;;;;;;;;;;4,0;;;;75,0;2,0;;7,0;;;;;;;;39,0;6,0;;;416,0;;;;;;;5,0;3,0;1,0;;54,0;;;1,0;;;;;20,0;;94,0;1,0;;41,0;;172,0;;;;;;;;;;;;;78,0;1,0;;36,0;;;;;3,0;7,0;;;;;10,0;;79,0;8,0;;;;;;;;;;;;;;;;;;79,0;;;2,0;1,0;;;;;;1,0;;;;135,0;2,0;;;1,0;;;;;;;;8,0;1,0;41,0;;2,0;;;7,0;29,0;;;22,0;;;;;50,0;;;;;229,0;43,0;;19,0;;;;100,0;;;2,0;;;;;4,0;1,0;44,0;;;3,0;;38,0;;;;;;70,0;13,0;264,0;;78,0;1,0;;;9,0;;;;223,0;;;44,0;64,0;42,0;;;;124,0;;13,0;;;1,0;;;;16,0;;127,0;1,0;4,0;;7,0;;1,0;;;;;;;;;1,0;;;;;3,0;7,0;83,0;;;2,0;;;6,0;1,0;106,0;166,0;6,0;;;;;;18,0;;;;;;;;24,0;;;;1,0;1,0;15,0;;;15,0;35,0;15,0;;;;1,0;13,0;;250,0;;;;;1,0;13,0;;103,0;;;10,0;1,0;;;35,0;;;1,0;;;;57,0;;;;3,0;;;;1,0;2,0;12,0;10,0;;29,0;;;4,0;4,0;2,0;;;7,0;;2,0;;;;;1,0;;;28,0;;;;37,0;;26,0;;;;;;;;105,0;;;;;;;;;;;;;;;;13,0;;;;;;;1,0;;;;;11,0;;;1,0;;;;;2,0;5,0;;;;;;;;;;;1,0;;;;17,0;;77,0;;;;;;;;;;;;;;1,0;;1,0;;;45,0;;;;;;;;;;;5,0;;4,0;;;;7,0;;;;;;;2,0;;;;;;;;;2,0;;;;;;;;;;;1,0;;;;;;217,0;;;;;;;;;;;;;;;;;;;;;;1,0;;;8,0;;;;;;;;;;;;;;;7,0;1,0;;13,0;;;;;;;;;;6,0;4,0;;;;1,0;;;;;26,0;;;;1,0;;;;;;;;;;;;;;3,0;;;;;;5,0;;;;2,0;;1,0;;;;;;;;;;;;;;;;;;;;;;;;;;;;;;;;;;;;;;;;;;;;;;;;;2,0;;;;;;;;;;;;;;;;5,0;;1,0;;;;;;;;;;;;;;;;;;;;;;;;;;;;;;1,0;;2,0;;;;;;;;;;;;;;;;24,0;;;;;;;5,0;;1,0;;;;;;2,0;71,0;;;;;;;;1,0;;;;;15,0;;;;;;;;;;;;;;;;;8,0;;;;;;;;4,0;27,0;;;;;;;30,0;;;;;;;;;;2,0;;;;;;;1,0;;;;;;;;;2,0;;7,0;;;;;;;;1,0;4,0;;;;;;;;;;;;;;;;;;;;;;;;;;;;;;;;;;;;;;;;;;;;;;;;;;;;;;;;;;;;;;;;;;;;;;;;;;;;;;;;;;;;;;;;;;;;;;;;;;;;;;;;;;;;;;;4,0;;;;;;;;1,0;;;;;;;;;;;;;;;;;;;;9,0;;;;;;;1,0;;;;;;;2,0;;;;;;2,0;;;;;42,0;;;;;;;;;;;;;;;;;;;;;;;;;;;;;;;;;;;;;;;;;;;;;;;;
bond;;;;;;21,0;17,0;41,0;;;;;5,0;20,0;;;2,0;1,0;;;38,0;;;;;;3,0;21,0;;;12,0;;;;1,0;;;3,0;1,0;1,0;1,0;34,0;2,0;2,0;;15,0;;17,0;;;;5,0;1,0;;;;83,0;;;1,0;10,0;;39,0;;118,0;1,0;35,0;;1,0;1,0;1,0;92,0;14,0;1,0;;;14,0;;;;104,0;1,0;;;45,0;;;21,0;12,0;;;5,0;1,0;3,0;;20,0;3,0;1,0;65,0;4,0;17,0;1,0;;14,0;;;;;;;;;7,0;1,0;;;;6,0;1,0;129,0;;;;;;;9,0;;;8,0;;;;24,0;;5,0;;1,0;;;;2,0;;;2,0;12,0;26,0;1,0;;14,0;;;;15,0;;;;4,0;2,0;4,0;20,0;36,0;;;;;19,0;14,0;;;5,0;;11,0;6,0;;2,0;2,0;;;;;1,0;2,0;6,0;;1,0;13,0;;5,0;19,0;;;20,0;10,0;5,0;8,0;45,0;1,0;4,0;1,0;;361,0;;;;;34,0;2,0;;18,0;2,0;;;;;3,0;10,0;;;;5,0;2,0;;;25,0;;124,0;2,0;;;;;2,0;;;;;;;14,0;4,0;12,0;;;16,0;7,0;1,0;8,0;63,0;;;12,0;14,0;14,0;179,0;;11,0;95,0;6,0;;;;;1,0;8,0;;7,0;;;10,0;1,0;149,0;3,0;;;;2,0;;;;1,0;;2,0;32,0;;;2,0;3,0;47,0;;1,0;;;;1,0;;12,0;;;2,0;1,0;3,0;19,0;;;;2,0;20,0;;27,0;;;2,0;;4,0;;6,0;;12,0;;;;2,0;3,0;3,0;1,0;;;;32,0;15,0;;;5,0;;;;;;;;;;1,0;1,0;;3,0;1,0;;1,0;;1,0;1,0;8,0;;1,0;1,0;27,0;;;;;;;;;;;;;;;;;;;;;2,0;;3,0;10,0;;;;;;;;;;;;;;;;;4,0;;;2,0;5,0;3,0;;;;;;;;3,0;;1,0;9,0;;1,0;;;;;;;;;18,0;;;;;;;;;;;;;1,0;;10,0;9,0;;1,0;;;;;;;;;1,0;;;;;;;5,0;1,0;3,0;;;;;;;;;;;1,0;6,0;;2,0;;6,0;;;2,0;;;6,0;1,0;;3,0;;1,0;;;;;;;;;;;;;;3,0;;;;2,0;;;;;;;;;;2,0;2,0;;5,0;32,0;;;;;;1,0;;;;;;;2,0;1,0;;;;3,0;;;13,0;;11,0;;;;;;;;;;;;;;;;;;;;1,0;;;;;;;;;;53,0;6,0;;;;;;;;;6,0;;;;;;2,0;;;;;;;;;;;;;;;;;;5,0;;;;;;3,0;;;;;;;;;;;;;;;;;;;;;6,0;;;;;;;;;;;;;3,0;;;;;;;;2,0;;;;;;;;;;22,0;;;6,0;;2,0;;1,0;;;;;;;;;6,0;;;;;;47,0;;;;2,0;;2,0;;69,0;;;;;;;;3,0;5,0;;1,0;;;;;;2,0;;;;;;;;;;6,0;;;;;;;;;;;;;;15,0;;;;;;;;;;;;;;;1,0;;;;;;;;;;;;;;;29,0;;;;;;;;;1,0;;;10,0;;;;;;9,0;;;3,0;;;;;;;;;;2,0;;;;;10,0;;;;;;;;;;;2,0;;;22,0;;;;;;;;;1,0;2,0;;;13,0;;1,0;;;;;;;19,0;;;4,0;;;;;;;;;1,0;;;;;;1,0;;;;;2,0;;;;;;;1,0;;;;;;;;;;;;;;;;;;;;;;;2,0;;;;;;;;;;;;;;;;;;;;;;;2,0;;;;;;;;;;;;;;;;;;;7,0;;;;;;;;;;;;5,0;;;;;;;;2,0;;;;;;;;;;3,0;;;;;;;;;1,0;1,0;;;;;;;;3,0;;;;;;;;;;;;14,0;;;;;;
brake;;;;;;8,0;;11,0;;;;;;24,0;;;;;;2,0;;;;;2,0;;;1,0;;;9,0;3,0;;;;;;;;;16,0;9,0;;;;;;3,0;;;;;1,0;1,0;;;3,0;;;;;;;;2,0;;16,0;1,0;;;;;27,0;;;;;;;;13,0;;2,0;;;2,0;;;;;;;;;;;;;;;10,0;;;;;;;;;;;;14,0;;;;;;;1,0;;;9,0;;;;29,0;;;;24,0;;;11,0;;;;;;;;;;;;13,0;;4,0;3,0;8,0;2,0;;7,0;;;;;;;;;10,0;;;;;2,0;;1,0;6,0;1,0;;;2,0;;;;;2,0;;;3,0;;;;;;5,0;;;;;;1,0;;;1,0;;;;;;;;4,0;1,0;21,0;;;7,0;1,0;14,0;;;;7,0;;;;;;;;;8,0;;;2,0;5,0;;;;;;1,0;;;;;;;;;3,0;;;;;4,0;;2,0;;;16,0;;;25,0;1,0;;;;;;45,0;;;;;;;;;;;;;;;5,0;;;;5,0;;;5,0;;;;;;;;;;;3,0;;;4,0;;;;;;;;;;;;;;;35,0;12,0;;9,0;;1,0;;3,0;;;;;;;9,0;;;;5,0;;;;4,0;;;;;1,0;;2,0;;;;4,0;2,0;;;;;;1,0;;3,0;13,0;1,0;;;9,0;;;;;2,0;;;3,0;;;;1,0;;;;4,0;;;31,0;;;;;3,0;;;3,0;;;2,0;;;1,0;13,0;;;1,0;;;5,0;;;;;;;;;;;;1,0;1,0;;;;;;;;;4,0;;1,0;2,0;4,0;;;;;;;2,0;13,0;1,0;;;;;4,0;4,0;56,0;;1,0;;1,0;1,0;;1,0;;3,0;2,0;1,0;;;;;;;;;;;;;;;;;;1,0;;;12,0;;1,0;;;;;;;;;;;;;;;;6,0;;;;;;;;;;;;;1,0;;;;;;;;;;;;;7,0;;;;;;;;;1,0;;;;;;;3,0;;;;;;;;1,0;;;;;;;;;1,0;;;;;;;;;1,0;;;;;;;;;;4,0;;;;;;;;;;;2,0;;;;;1,0;;;;;1,0;;;;9,0;3,0;1,0;;;;;;;;;;;;;;14,0;3,0;;;;;;;;;;;;;;;;;;;;;;;;1,0;;;;;;4,0;;;;;;;;;;;;;;;;;;;;;;;;;;;7,0;;;;;;;;1,0;;;;;;;5,0;;;;;;;;;;;;;;;;;;21,0;3,0;1,0;1,0;;;;;;;;;;;;;;;;;9,0;;;11,0;;;;;;;;6,0;;;;;;;;;;4,0;;;;;;;;;;;;;;;;;;;2,0;;;;;;2,0;;;;;;;;;;1,0;;;;;;;;;;;;;1,0;;;;;;;;;;;;;;;;;;;;;;;;;;;;;;1,0;;;;;;;;;;;;;;;;;;;;;;;;;;;;;;;;;;;;;;;10,0;;;;;;;;;;;;;;;;;;;7,0;;;;;1,0;;;;;;;;;;;;;;;;;;;;;;;1,0;;;;;;;;1,0;;;;;7,0;;;;;;;;;;5,0;;;;;;;;;;;;;;;;;;;;;;;;;;;;;;;;;;;;;;;;;;;;;;;;;;;;;;;;;;;;5,0;;;;;;;;
capsule;;;;;;4,0;;;;;;;;;;;24,0;;;1,0;;;;;;;;;;1,0;3,0;;;;;;;1,0;;1,0;2,0;11,0;;;;;;;;;;;;;;;2,0;;;;;;;;59,0;;2,0;;;;;3,0;13,0;;;;;;;;18,0;;;;1,0;3,0;;;;;1,0;;1,0;;;;;;1,0;;;;;2,0;3,0;;;;;;;2,0;;;;;;;;13,0;1,0;;;2,0;;2,0;1,0;;;;1,0;;;1,0;;;;;;;;;;;;1,0;;;1,0;;;;1,0;;;;;;;;;1,0;;;;;1,0;;;1,0;;;;;;;;1,0;;;;2,0;;3,0;;;1,0;;6,0;;;;;;;;18,0;;2,0;;;;;;;;;;;3,0;;2,0;;;;;;;;;;;;;;;;;;;;;;;;;;4,0;;;;24,0;;;1,0;1,0;;;2,0;;;;;;;;;3,0;1,0;;;;2,0;;;;;;;1,0;;;;;;;;3,0;;;;;;;;;;;;;;;;;;;;;;;;;1,0;;;;;;;3,0;;;3,0;;;;;;;;;2,0;;2,0;;;;;;;;;;;;;;;;;;3,0;;;3,0;;;;;;;;;;;;;;;;;;;;;;;;;;;;;1,0;;;;;;;1,0;;;;;;;;;;;;;;;;;;;;;;1,0;;;;;;1,0;;;;;;;;;;;;;;;;;9,0;;;;;;;;;;;;;1,0;;;;;;;;;7,0;;;;;;;;;;1,0;;;;;;;;;1,0;;;;;;;;;;;;;;;;;1,0;;;;;;2,0;;;;;;1,0;;;;;;;;;;;;;;;;;;;1,0;;;;;;;;;;;;;;;;;;;;;;;;;;;;;;;;;;;;;;;;;;;;;;;;;;;;;;;;;;;;;;;;;;;;;;;;;;;;;;;;;;;;;;;;;;;;;;;;;;;;;;3,0;;;;;;2,0;;;;;;;;;;;;;;;1,0;;;;;;;;;;;;;;;;;;;1,0;;;;;;;;;;;;;;10,0;;;;3,0;;;;;;;;;;;;;;;;;;;;;;;;;;;;;;;;;;;;;;;;;1,0;;;;;;;;;;;;;;;;;;;;1,0;;;;;;;;;;1,0;;;;;;;;;;;;;;19,0;;;;;;;;;;;;;;;;;;;;;;3,0;;;;1,0;;;;;;;;;;;;;;;;;;;4,0;;;;;;;;;;;;;;;;;;;;;2,0;;;;;;;;;;;;;;;;;;;;;;;;;;;;;2,0;;;;;;;2,0;;;;;;;;;;;;;;;;;;;;;;;;;;;;;;;;;;;;;;;;;;;;;;;;;;;;;;;;;;;;;;;;;;;;;;;;;;;2,0;;;;;;;;;;;;;;;;;;;;;;;;;;;;;;;;;;;;;;;;;;;;;;;;;;;;;;;;;1,0;;;;;;
card;;;;;;4,0;;5,0;;;;;;4,0;;;24,0;;;;27,0;;;2,0;5,0;;;;2,0;;26,0;;;;;23,0;;;;1,0;13,0;26,0;;10,0;6,0;7,0;;1,0;;;;;5,0;2,0;;;5,0;;;;;;2,0;;44,0;;9,0;;;;;1,0;5,0;;;;;;1,0;82,0;8,0;;4,0;1,0;4,0;;;;;;;;;;;;;;19,0;;2,0;2,0;;;3,0;5,0;1,0;;;;;;4,0;1,0;14,0;;;;;2,0;;;4,0;;;10,0;27,0;;;;1,0;;;27,0;;;1,0;;1,0;;;;;;5,0;6,0;5,0;3,0;7,0;1,0;;;2,0;5,0;;;;;;;;7,0;;;;;7,0;8,0;;1,0;1,0;;;;;;;;;;;;;16,0;;;;;;;;;2,0;1,0;30,0;;12,0;;;10,0;;;;;;4,0;;1,0;;;8,0;;1,0;;;;;;5,0;14,0;6,0;;;;;;4,0;;;;;;;;;2,0;;;;;;;;2,0;4,0;2,0;2,0;;21,0;;85,0;;;1,0;;;;5,0;6,0;;2,0;1,0;;1,0;;;;;;30,0;;1,0;;1,0;;;;;;11,0;;;;1,0;;;;2,0;4,0;;;;;;;;1,0;2,0;;2,0;;;;;;;1,0;;;2,0;;4,0;2,0;;;;;;2,0;;2,0;1,0;;;4,0;;;;1,0;1,0;;;;;;;;;;;;;;;;;;2,0;;;;;;;;;;;;4,0;;;;;;;;;;;;;;;;;1,0;;1,0;;2,0;;;2,0;;4,0;;;;;;;;;;;;2,0;;;;;2,0;;;7,0;;;3,0;;;;;;2,0;;;;;;;;;6,0;;28,0;;2,0;;;1,0;;2,0;1,0;1,0;;13,0;;;;;;;;;1,0;;;2,0;;;;;;;;;;;;3,0;1,0;;;;;;;;;;;;10,0;1,0;;;;;;;1,0;;;1,0;;;2,0;;;;;;2,0;;;;2,0;;;;;;;;;;8,0;4,0;;;;1,0;;;;;;;;;8,0;;;;;;;;;;;;;;;;;;;;;;8,0;;2,0;;;1,0;;;;6,0;;;;;;;;5,0;;5,0;;;;1,0;;4,0;;;;1,0;;;;;;;;;;;;;;;;22,0;;;;;;;;;;;;;;;;;;;2,0;;;;;;;;;;;;;1,0;;;;;;;;;;;;;6,0;;;;;;;;;;;;;;;;;4,0;;;;;8,0;2,0;;;;3,0;;;;;;;;;;3,0;;;;;;;;;;;;;;;;2,0;1,0;2,0;;;;;;;;;;;2,0;;;;2,0;;;;;;;;;;1,0;;;;;;;;;;;;5,0;;;;;;;;;;;;;;;6,0;;;2,0;;;;;;;;;;;;;;;;;;;;;;;2,0;;;;;;3,0;;;;;;;1,0;;;;;5,0;;;;;;;;;;;;;;;;;;;;;;;;;;;;;;;;;;;;;;;;;;;;;;;;;;12,0;;;;;;;;;;;;;;;;;;;;;;;1,0;;1,0;;;;;;;;;;;;;;;;;;;;;;;;;;;;;;;;;;;;;;;;;1,0;;;;;2,0;;;;;;;;;;;;;;;;;;;;;;;;;;;;;;;;;;;;;;;;;;;;;;;;;;;;;;;;;;;;;;;;;;;;;;;;;;;;;;;;;;;;;;;;;;;;;;
chain;;;;;;49,0;2,0;5,0;;;;;1,0;;1,0;;92,0;;1,0;;;2,0;1,0;;;;;2,0;2,0;2,0;7,0;;;;;6,0;;7,0;1,0;2,0;;99,0;;;;;;39,0;;;;;16,0;;5,0;85,0;11,0;;;5,0;1,0;2,0;;;81,0;1,0;199,0;;4,0;;85,0;50,0;89,0;;;;;;;1,0;36,0;;8,0;;68,0;2,0;;711,0;;;;;32,0;;;;2,0;19,0;110,0;;26,0;;4,0;;3,0;13,0;;;;;;;4,0;;;;;4,0;14,0;113,0;;;7,0;;;;13,0;;;;52,0;;;1,0;;;5,0;;;;;;;;46,0;;8,0;;;2,0;;;;6,0;;;;1,0;1,0;;;7,0;;1,0;;;13,0;2,0;;;;;3,0;4,0;;;5,0;;;;;;;10,0;;;28,0;;12,0;9,0;;;;;;;17,0;;24,0;;;;;;;2,0;;;18,0;38,0;;1,0;;;;28,0;;25,0;;8,0;;34,0;;;6,0;;11,0;;;;;;;;2,0;;;;;3,0;;;;;;3,0;;;2,0;;;;3,0;1,0;;;;2,0;;;2,0;2,0;22,0;;;;;;;2,0;;;;;;;3,0;;;1,0;;;24,0;;;1,0;3,0;;6,0;31,0;;2,0;;;;;;;;1,0;;;;;;;;;;;;;;5,0;4,0;;22,0;;1,0;;;;3,0;1,0;;;;;2,0;;;;;;;;;;3,0;;;1,0;;1,0;;1,0;;;;1,0;;;;;2,0;2,0;;3,0;8,0;;;;;;;;;;;;;5,0;;5,0;;;;;;;30,0;1,0;;5,0;;;;;;;;;1,0;;;1,0;;1,0;;;;2,0;;;;1,0;;;2,0;4,0;3,0;;;28,0;6,0;;;;;;;9,0;2,0;;3,0;4,0;;;;;;;;;;3,0;;;;4,0;;;;5,0;;2,0;;9,0;;;;;;;;;;1,0;;;1,0;;;;;;;;;;;;3,0;;;;;9,0;;;;;;22,0;;;3,0;;12,0;;;;;;;;;;;;;;;;;;;;;;;;;;;;;8,0;;;4,0;2,0;;;;;;;;;;;;;9,0;;;;;;;;;;;;;;;;;;;;;;;3,0;;;;;;;;;;;;;;;;;;;;;;;;;4,0;4,0;;;;;;3,0;;;;;;;;2,0;;;;;;;;;;;;;;;;;2,0;;;;;;;;;;;;;;2,0;;;;;3,0;;;;;2,0;;;;;;;;;6,0;;;;;;;;;;;;;;;;;;;;;;;4,0;;;6,0;;;;;2,0;;;;;3,0;;;;;;;;;;;;;;;;;;;;2,0;;;;;;;;;;;;;;;;;4,0;;;;;;;;;;;;;;;;;;2,0;;;;;1,0;;;;;;;;;;;;;;;;;5,0;;;1,0;;;;;;;;;;;;;;;;;;;;2,0;;;;;;;;;;;;;;;;;;;;11,0;;;;;;;;;;;;;;;;;;;;;;2,0;;;;;;;;;;;;;;;;;;;;;;;;;;;;;;;;;;;;;;;;;;;;;;;;;;;;5,0;;;1,0;;;;;;;;;;;2,0;;;;;;6,0;;;;;;;;;;;10,0;;;;;;;;;;;;1,0;1,0;;;;;;;;;;;;;;;;;;;;;;3,0;;;;;;;;;;;;;;;;;;;;;;;7,0;;;;;;;;;;;;;;;;;;;;;;;;;;;;;;;;;
circular;;;;;;12,0;12,0;5,0;;;;2,0;5,0;30,0;;;5,0;;5,0;;4,0;2,0;3,0;;2,0;;;7,0;;;12,0;1,0;;;;1,0;30,0;1,0;;;5,0;73,0;24,0;;6,0;12,0;2,0;22,0;;;;;4,0;1,0;2,0;8,0;27,0;;;1,0;1,0;;2,0;;27,0;;47,0;;;;32,0;69,0;30,0;;;;1,0;1,0;;2,0;9,0;;;;15,0;;;55,0;;;;;13,0;10,0;2,0;;4,0;5,0;38,0;10,0;8,0;2,0;4,0;;4,0;1,0;;;;;;;9,0;2,0;;;;2,0;;32,0;;;;;;1,0;13,0;;;;;;;13,0;;3,0;4,0;1,0;;;4,0;2,0;;;100,0;;5,0;38,0;;14,0;;4,0;7,0;17,0;1,0;;8,0;;;;;8,0;;;2,0;;1,0;5,0;;;4,0;;8,0;23,0;4,0;14,0;3,0;;;;;;;16,0;4,0;;17,0;2,0;39,0;11,0;;;2,0;9,0;;15,0;19,0;2,0;16,0;3,0;;3,0;;;;;14,0;;6,0;17,0;9,0;6,0;;2,0;4,0;11,0;;;2,0;11,0;26,0;;;2,0;9,0;;59,0;;;;4,0;;1,0;;10,0;3,0;;;;1,0;;29,0;;1,0;;4,0;1,0;79,0;13,0;1,0;2,0;;;8,0;2,0;;24,0;46,0;10,0;;;1,0;3,0;;4,0;;;2,0;;2,0;1,0;;1,0;2,0;;;2,0;7,0;1,0;;;;8,0;12,0;;;;4,0;4,0;;2,0;6,0;2,0;21,0;;;;;;2,0;;;2,0;;;12,0;;8,0;1,0;2,0;;3,0;2,0;;;1,0;9,0;;3,0;5,0;;8,0;;6,0;5,0;3,0;;;;4,0;5,0;;;16,0;;6,0;;;;;5,0;;;;;11,0;13,0;5,0;;;;;;;5,0;;2,0;1,0;;;7,0;;;;;3,0;;;;;6,0;;;12,0;;;;2,0;;;5,0;;;;;4,0;;;;;;2,0;2,0;;;;3,0;;;;;2,0;;;3,0;1,0;;2,0;8,0;4,0;;6,0;;2,0;;3,0;;;;;;;;;;5,0;;2,0;;1,0;;;;;;;;;;;;3,0;;;2,0;1,0;;;1,0;;;;;;;3,0;;1,0;;;;1,0;;;;;;;;;;;2,0;;;1,0;;3,0;;;;;;2,0;1,0;9,0;;;;;;;1,0;;;;2,0;;;;;;4,0;;;;5,0;;;;;;1,0;;1,0;;2,0;5,0;;;4,0;;1,0;;;;;3,0;;;2,0;;;4,0;3,0;;;;2,0;9,0;;;2,0;16,0;;;;5,0;;;;;;;;;;;;;;;2,0;;;;;;;;;;;;10,0;;;;4,0;;;;;;;3,0;12,0;;;;;;;;;;;;10,0;;;;;1,0;;;;3,0;;;;;;;;;;;;;;;;8,0;;;;;1,0;;;;;;;;;;1,0;;;;1,0;2,0;;4,0;;2,0;;;;;;;;2,0;;;;;;;;;;;;;4,0;;1,0;;;;;;;1,0;1,0;;;;1,0;;;;;;1,0;;;;;;;13,0;;5,0;;1,0;1,0;;;;3,0;;;12,0;;;;;5,0;;;;;;3,0;2,0;;;1,0;;;;;;;;;;;;;;2,0;;;;;;3,0;6,0;;2,0;;;;;;;2,0;3,0;4,0;8,0;8,0;2,0;2,0;;;;;1,0;;2,0;;;;4,0;3,0;;;;;;2,0;;7,0;;1,0;;1,0;;2,0;;2,0;5,0;;;;;;;;;1,0;;2,0;;;;4,0;;;;;;;;;;;;;;;;;;;;;;1,0;;;;;;;;;;;2,0;;2,0;;;;1,0;;;;;;;;;;;;;;;;;;;;;;;;;;1,0;;;;;;;;;;;;;1,0;;;;;;;;;;;1,0;;;;;;;;1,0;;;;;;;;;38,0;;;;;;;;;;;;;;1,0;;;4,0;;;;14,0;;;1,0;5,0;4,0;;;;;;;;;;;;;;;;;;;;;;;1,0;;;;;;;;1,0;;;;;;;1,0;;;;;;;;;;;;;;;;;;;31,0;;2,0;;;;;;
classify;;;;;;2,0;;;;12,0;;;;56,0;;2,0;4,0;;;17,0;;;1,0;;;;;6,0;;10,0;18,0;;;;;51,0;;;;;26,0;2,0;;1,0;7,0;;;3,0;;3,0;2,0;;;;11,0;;;;;9,0;;2,0;34,0;;75,0;;32,0;;;;3,0;;17,0;;;;1,0;4,0;;6,0;59,0;;;13,0;2,0;;;1,0;;2,0;1,0;;;;;;21,0;;18,0;;7,0;19,0;;2,0;6,0;7,0;;;;;1,0;7,0;1,0;1,0;;;;4,0;;1,0;;;2,0;1,0;;21,0;25,0;;1,0;;6,0;;;10,0;;;12,0;;1,0;;;;;;;;;3,0;9,0;;;;2,0;;;;;2,0;;;;2,0;4,0;;;;;;;1,0;5,0;;;3,0;;1,0;;;;;;;;;;;;;16,0;;;;;;;;;;;;;;;;;2,0;;;;;;2,0;;;;3,0;1,0;;;;4,0;;5,0;;;;2,0;;;2,0;;;1,0;;;;;;;;;;;;;5,0;1,0;1,0;3,0;1,0;;;;1,0;;;2,0;6,0;;;;;;41,0;;;;;;1,0;;;;;;;1,0;1,0;;;;;;;24,0;;;;1,0;;;;;;;;13,0;;;;;;;;;;;2,0;16,0;4,0;;;;;;;3,0;;;;5,0;185,0;;;3,0;;;;;;;;;;4,0;;;;;;;6,0;;;;1,0;;;;;;;1,0;;6,0;;;;22,0;1,0;;;;1,0;;;2,0;;;;;1,0;3,0;;1,0;;;1,0;14,0;1,0;6,0;1,0;;;;37,0;1,0;;;7,0;8,0;;8,0;;;1,0;;2,0;2,0;6,0;;;;2,0;;5,0;;;14,0;2,0;;5,0;;;1,0;3,0;;;;3,0;;;;;;;;2,0;;;;;;5,0;1,0;;;4,0;;;2,0;4,0;17,0;;;;;;1,0;;;;3,0;;;;;1,0;;;;;2,0;2,0;;;;;;;6,0;;;1,0;1,0;;3,0;3,0;;5,0;;;;1,0;6,0;;;;;10,0;1,0;;;;;;;;;;;;;;6,0;;;;;2,0;;;;;6,0;1,0;;;;;;;1,0;;;3,0;;;;;;;;;;;;;;11,0;2,0;;;;;;;;;;;;1,0;;;;;;;2,0;;;;4,0;5,0;;1,0;;;;;;;;;;1,0;4,0;;;;;;;;;;;1,0;;;4,0;;;;;;;3,0;1,0;;;;4,0;;;;;;;;;;;;;;;;;;;;1,0;;;;;;;;;;;;;;;;;;3,0;;;6,0;;2,0;;;;;;;;;1,0;;;;;;;1,0;;;;;;;;14,0;;;6,0;;5,0;;;16,0;;;;;;;;;;;;;;;;;;;;;;;;;;;;;;;;;;;;;;;;;;;;;;;1,0;;;;1,0;;;;;1,0;;;;;;1,0;;;;;;;;;;;;;;;;;;;;;;;;;;;;8,0;;1,0;;;;;;;;;;;;;;;;;7,0;;;;;1,0;;;;;;;;;;;4,0;;8,0;;;;;;;;;;3,0;;;;1,0;;;25,0;;;;;;;;;;2,0;;30,0;;;4,0;;1,0;;;;22,0;;2,0;;;2,0;;;;;;1,0;;;;;;8,0;;;;;;;;;;2,0;6,0;;;;2,0;;;;;;;;;;;;;;;;;;;;;;;;;;;;;4,0;;;;;;;;;4,0;;;;;9,0;;;;;;2,0;1,0;;;;;1,0;;;;;;;;;;;;;;;;;;;;17,0;;;;;;;;;;;;;;;;;;;;4,0;6,0;;10,0;;;;;;;;;;;;;;;;;;;;;;;;;;
cluster;;;;;;2,0;4,0;;;;;9,0;;11,0;;;28,0;;3,0;;;;3,0;;;;;10,0;;3,0;14,0;;1,0;;;35,0;;;23,0;;26,0;15,0;;2,0;40,0;10,0;;16,0;;;;;;;4,0;;11,0;;1,0;8,0;;;5,0;;79,0;;41,0;;2,0;;8,0;1,0;4,0;;;;4,0;;;;33,0;;4,0;19,0;3,0;;;;;1,0;;;3,0;;;;56,0;;86,0;19,0;20,0;3,0;;14,0;36,0;15,0;;5,0;;;;;12,0;5,0;;5,0;50,0;20,0;;26,0;;;5,0;3,0;1,0;;104,0;;;;29,0;;;33,0;;;16,0;;;;;;8,0;;;1,0;16,0;7,0;32,0;;3,0;;;;;;;;;;;3,0;;;;;2,0;;;;1,0;;;;;;;2,0;2,0;;;;;;;;15,0;;9,0;8,0;;;;;;;;;;;;;;;1,0;2,0;2,0;;;;;;3,0;;;;2,0;;;;10,0;;;;;;10,0;;1,0;2,0;;;;;6,0;;1,0;;;3,0;;;;;;3,0;21,0;;2,0;;;;;;;;;;;;;1,0;;23,0;;;;;;;1,0;;;;;;;1,0;;1,0;;;15,0;;7,0;;;;;;;;;;1,0;;1,0;3,0;;;;;;;;;6,0;1,0;;;;;;;9,0;;1,0;;1,0;;7,0;63,0;;1,0;1,0;;;;;;;;;;;;;;;;15,0;3,0;;;4,0;;12,0;1,0;4,0;;;;;;;;1,0;;1,0;;;;;;;;;;;;;;1,0;3,0;7,0;;1,0;;;;3,0;4,0;;3,0;;22,0;3,0;;;;1,0;;1,0;;2,0;;;57,0;6,0;;;3,0;26,0;2,0;;24,0;7,0;;;;;;;;;6,0;;;;80,0;;;;2,0;1,0;24,0;6,0;5,0;;;2,0;;;;4,0;2,0;5,0;;1,0;;;;;;;5,0;;;14,0;;5,0;;;;;;1,0;;;;18,0;;;2,0;;;;;;;;;7,0;;;;6,0;;;;;;;70,0;2,0;;12,0;;;;;;;6,0;1,0;;;;;;;;;;;6,0;1,0;;;6,0;10,0;;;;;;;12,0;;;7,0;;;;;;;;;;2,0;;;;7,0;;;;;69,0;;;;;;;;;;;;;;;;1,0;;;;;;;;;;;;;;;;;;;;;;;;;;;5,0;;;;;;;6,0;;;;;;;;;1,0;;;1,0;;13,0;;;;;;;4,0;;;;;;;;7,0;;;;;1,0;;;;;;;;;;4,0;;;;;;;;;;;;;;;;;;;;;1,0;;1,0;;24,0;5,0;;9,0;;;;;;;;;4,0;;;;;25,0;;;1,0;;;;;;;;;;;;;;1,0;;;;;;;;;;1,0;2,0;3,0;;;;;1,0;;;;;;1,0;;2,0;;;;;;;;;;;;;;;;;;;;;1,0;;;;;;;;;;;;;;;;;;;;;;;;;;;;;;;;;;;;;;;;;;;;;;;1,0;;;;;;;;;;;;;;;;;1,0;1,0;;;;;;7,0;;7,0;;;;;;;;6,0;;1,0;;;;;;;;;;;3,0;;;;;;;2,0;;;;;;;;;3,0;;;;;;1,0;;4,0;;;;14,0;3,0;;;;;;;;;3,0;;;105,0;;;;;;;;1,0;;;;4,0;;;;;;;;;;;;;;;;;;;;;;;;;;6,0;;;;;;;1,0;;;;;;;;;;;;;;;;;;;;;;;;;;;;;;;;;;;;;;;;;;;;;;;;7,0;;;;;;;;;;;;;;24,0;;;;;;;;;;;;;;;;;;;
compact;;;;;;3,0;;3,0;;;;;;6,0;;;;;1,0;;;;;;;;2,0;21,0;;;3,0;;;1,0;;;;2,0;;2,0;2,0;7,0;2,0;5,0;;;1,0;;;;;;6,0;3,0;6,0;;1,0;;;;1,0;;;;3,0;;13,0;;;;7,0;16,0;7,0;3,0;;;;6,0;;;10,0;;;;95,0;7,0;;19,0;;;;;;;;;;;;4,0;7,0;;1,0;;;;;;3,0;;;;;;;;2,0;;;1,0;;;1,0;5,0;;1,0;16,0;4,0;;2,0;4,0;;;9,0;;;7,0;;2,0;;;;2,0;;1,0;;;;;;;;1,0;;;;;;6,0;2,0;1,0;;;;;;11,0;1,0;;;;;1,0;;;;;;8,0;;;;;;;;;;;;;;;1,0;;;1,0;;;;;;2,0;;;;1,0;;;2,0;;;;;;;;;;;;;;;;;;;;;;;1,0;1,0;1,0;;;;;;;3,0;;;;;;1,0;;;;;;;;;2,0;1,0;;;;;1,0;;;;1,0;;;;;1,0;12,0;;;;1,0;2,0;;1,0;1,0;50,0;;;;;;7,0;;;;6,0;;;;;3,0;5,0;;;;;;1,0;;;;;1,0;;;;;;;;;;;;;;;;;;;;;;;;;;;;;;;;;;;;;;;1,0;;;1,0;;;;;;;;31,0;;;;;3,0;;;;;;;;;6,0;;;;;;;;15,0;;;;;3,0;;;;;;;;3,0;;;;;;;;;1,0;;;;;;2,0;;;;;3,0;3,0;;;;;;;;;;;7,0;3,0;;;1,0;3,0;;;;;;1,0;2,0;;;1,0;;2,0;;;;;;;;;;;;;;;1,0;;6,0;;;;;;;;;1,0;;;;;;;;;;;;;;;;;;1,0;2,0;1,0;;;;;;3,0;;;;;2,0;;;;;;;;;;;;;;;;;;1,0;;;;;;;;;;;1,0;;;;1,0;;;;;;;;;2,0;;;;;;;3,0;;;;;;;;;;;;;;;;;;;;;;;;;;1,0;5,0;;;;;;;;;;;;;;;;;;;;;;;;;;;;6,0;;;;3,0;;;;;;;;;;;;;;;;;;;;;;;5,0;;;;1,0;;;;;;3,0;;;1,0;;;;;;;;;;;;;6,0;;;;;;;;;;;;;;;;;;;;;;;;;;;;;;;;;;;1,0;;;;;;;;;;;;;;;;;;3,0;;;;4,0;;;;;1,0;;;;;;;1,0;;;;;;;2,0;;;;;;;1,0;3,0;;;;;;;;;;;;;;;;;;;;;5,0;;;;;7,0;;;;;;;1,0;;;;;;;;;4,0;;;;;1,0;;;;;;;;;;;;;;;;;;;;;;;;;;;;;;;;;;;;;;;3,0;;;;;;9,0;;;;;;;;;;;;;;;;1,0;;;;;;1,0;;;;;;;;;;;;;;;;3,0;;;;;;;;;1,0;;;;1,0;;;;;;;;;;;;;;;;;;;;;;;;;;;;;;;;;;;;;;;;;;;;;;;;;;;;;;;;;;;;;;;;;;;;;;;;;;;;;;;;;;;;;;;;1,0;;;;;;;;;2,0;;;;;;;;;;;;;;;;;;;
concave;;;;;;28,0;59,0;16,0;;;;;1,0;10,0;1,0;;11,0;;;;;;;;;;;14,0;;;25,0;;;;;;11,0;;4,0;;;12,0;11,0;;1,0;5,0;;33,0;;;;2,0;18,0;;;23,0;50,0;;;;;;13,0;;139,0;;43,0;;;;2,0;376,0;16,0;1,0;;;10,0;;;;4,0;1,0;;;16,0;;;19,0;;1,0;;4,0;3,0;3,0;;;4,0;19,0;37,0;17,0;3,0;;8,0;;;;;;;;;;13,0;;;;;3,0;;6,0;;;;;;;12,0;;;1,0;;2,0;;10,0;;;3,0;3,0;;;;;;;11,0;;3,0;10,0;;;;;8,0;11,0;;;1,0;;;;;16,0;;;;;5,0;1,0;;;;;;4,0;3,0;25,0;;;;;;;;34,0;;4,0;1,0;;1,0;4,0;;;;;1,0;2,0;11,0;1,0;17,0;4,0;;;;;;;11,0;1,0;116,0;20,0;1,0;;;3,0;;14,0;2,0;1,0;3,0;;2,0;;;;3,0;;96,0;;;;2,0;1,0;1,0;1,0;1,0;;3,0;1,0;;;1,0;2,0;;;2,0;;;79,0;258,0;;6,0;;;1,0;3,0;;9,0;665,0;1,0;;;;;8,0;1,0;;;;;1,0;;6,0;2,0;5,0;;;1,0;2,0;;;;3,0;23,0;1,0;;;3,0;1,0;;8,0;;;;;;8,0;2,0;;;11,0;;11,0;;;;17,0;;;5,0;7,0;;1,0;3,0;;;;4,0;3,0;;;;100,0;13,0;1,0;;24,0;2,0;;43,0;;3,0;14,0;;36,0;;;;;;;;;;1,0;;;;6,0;;;;;;;;;;8,0;3,0;6,0;;;;;;;;;4,0;;;;;24,0;;;;;;;3,0;;;;;;;;;;;;;;;;;;;;;;;;;;;;;;;;;;;;;;;;;;;;;5,0;;;;1,0;;;;;;;;;;;;1,0;;;;;;;;;;;;;;;;;;1,0;;2,0;;;;;;;;;;;;;4,0;;;;;;6,0;4,0;;5,0;3,0;;;2,0;;;;;3,0;9,0;;22,0;;;;;;;;;;;;;;;;;;;;2,0;;4,0;;;;3,0;;;;;1,0;;;;;;1,0;5,0;1,0;;;;;2,0;;;3,0;1,0;;;;;;;3,0;15,0;;;;;;;;;;;;;;;;;;;;;;;;5,0;;;;1,0;;3,0;2,0;;;;;;;;;;;;;;;3,0;;;;;;2,0;;;;;;;;;;1,0;;;;;;;;;;;;;8,0;;;;;;;;;;;1,0;2,0;;;;10,0;;;;;1,0;;10,0;;;;;;;;;;;;;;;;;;;;;;;2,0;;;;;;;;;;;;;;;;9,0;;;2,0;;;;9,0;2,0;48,0;;;;;3,0;1,0;3,0;4,0;;;1,0;;2,0;;8,0;;;;;;;;;;2,0;;;;4,0;2,0;;;;1,0;1,0;;;;;;;;;;1,0;1,0;;3,0;;1,0;;;;;;;;;;;1,0;;2,0;;;;;;;;;;;1,0;3,0;;;;;2,0;5,0;;;;;;8,0;;;2,0;;;;;;;;;;;;;;;;;;;;;;;;7,0;;;;;;3,0;;;;;;;;;;;;;;;;20,0;;;;;;;;;;;;;;3,0;;;;;;;;;;;;;;;;;;;;;24,0;;;;2,0;;;;;;;3,0;2,0;;;;;;;;;9,0;;2,0;;;;;;;;;;;;;;;;;;;;;;;;;;;;;;1,0;;;;;;;;4,0;;4,0;;13,0;;;;2,0;;;;;;;;7,0;2,0;72,0;;;;;;102,0;;;;4,0;;;4,0;;;;;;1,0;;;;;;;;;;;;;;;;;;;;;;;;;;;;;;;;;
conductivity;;;;;;8,0;;1,0;;;;;;;;;;;;;16,0;;;;;;;;;;16,0;;;;;;;;4,0;;;32,0;;;;8,0;;4,0;;;;;5,0;;;;76,0;;;;;;;;1,0;;39,0;;;;;;6,0;;;;46,0;;;;3,0;;;;4,0;;;1,0;;2,0;;;1,0;1,0;;;7,0;16,0;20,0;2,0;18,0;;;;;;;;;;1,0;;311,0;2,0;1,0;;;;;20,0;;;3,0;;;;5,0;;;1,0;;;;3,0;;;;;;;;10,0;;;;;1,0;47,0;;;;;;;;34,0;;;5,0;;5,0;20,0;;;9,0;;5,0;2,0;;;;;;14,0;;;;;;;;;;10,0;;12,0;;;;1,0;;;14,0;;1,0;;8,0;;1,0;;;34,0;;;;1,0;3,0;;4,0;4,0;;;;;;6,0;5,0;;;;;;;20,0;4,0;1,0;29,0;;1,0;;;;;;;;;;;;;25,0;;;;;;;16,0;;;;;1,0;80,0;;3,0;17,0;6,0;;1,0;;419,0;3,0;;;;;;1,0;;3,0;;;;;2,0;;;;;;;3,0;;;1,0;;5,0;;;;;;;;;;;6,0;;;;;;;;;;25,0;;;;;;;;;;;;;17,0;;;;;;;;1,0;;;;;;;;;;;;;;;;3,0;;;1,0;;;;;;4,0;;;1,0;;;;;;;;;;;;;;;;;;;;;;1,0;;;;;5,0;;;;;;;;;;;;;;;;6,0;;2,0;;;;;;;;;;;;;;;;;;;;;;5,0;;;;;;;;;;;2,0;;;;;;;;;;;;;;;;;;;;;;;;;;;;;;;;;;;;;;;;;;;;;;;;;;;;;;;;;;;;;;;;;;;;;;;;;;;;;;;;;;;3,0;2,0;;;;;;1,0;;;;;;;;;;;;;;;9,0;;1,0;;;;;;;;;;;;;;2,0;;;;;;107,0;;;;;;;;;;;;;;;;;;;;;;;;;;;;;;;;;;;;;;;;;;;;;;18,0;;;;;;;;;;3,0;;;;;;;;;;;;;;;;;;;;;;;;;1,0;;;;;;;;;;;;;;;;;;;;;;;;;;3,0;;;;;;;;;;;;;;;;;2,0;;;;;;;;4,0;;;;;;;;;;;;;;;;;;;;;;4,0;;3,0;;;;;;;;;;;;;;;;;;;;;;;;;;;;;;;;;;;3,0;;;;;;;;;;;;2,0;;;;;;;;;;;;2,0;;;;;;;;;;5,0;25,0;4,0;;;2,0;;;12,0;;;1,0;;2,0;5,0;;1,0;;65,0;;;;2,0;;;1,0;;;237,0;;;;;;;;;;9,0;;;;;74,0;;;;3,0;;;;;;1,0;;;;;;;;;;;;;;;;;;;;;;;;;;;;;;;;;;;;;;;;;;;;;;;;;;;6,0;;;;;;;;;;;;;;;;;;;;;;;;;;;;;;;;;;;;;;;;;;;;;;;;;;;;;;;;;;;;;;;;;;;;;;;;;;;;;;;;;;;;;;;;;;;;;;;;;;;;;;;;;;;
context;;;;;;3,0;;;4,0;21,0;;;;31,0;;;35,0;;;;;;;;;;;;4,0;5,0;7,0;;;;;20,0;1,0;;;;51,0;22,0;;109,0;18,0;;;1,0;;;;;;;;;1,0;;;2,0;;;;;28,0;;12,0;;;;;;3,0;;;;;;4,0;5,0;35,0;;18,0;;1,0;;;1,0;;;2,0;;;;;;;;14,0;2,0;;25,0;;;1,0;17,0;3,0;9,0;;;;;;;;;;;2,0;1,0;6,0;;1,0;;;51,0;17,0;;;;1,0;;;;;;8,0;1,0;;;;2,0;;;;;6,0;;24,0;2,0;;;;;;;;;;;;;3,0;;;;;;;;;;;;;;;;2,0;;;;;;;;;;;;;;;;;;;;;;;;;;;;;;;;;;;;;;1,0;;;;;;;;;;24,0;;;;;;;;;;;;;;;;;;;6,0;;;3,0;;;;;;;;;1,0;;;;3,0;;2,0;;;;;1,0;;;;;;;;;;;;;;;;;;;;3,0;;;3,0;;;;;;;;;;;;1,0;;;;;;2,0;;;;;;;1,0;;;;5,0;16,0;;;;;;;;;;;;;;;;;;;;;;;;;;;;;;;;;;;;;63,0;;3,0;;;1,0;;;3,0;;;;;;;;3,0;;3,0;1,0;11,0;;1,0;;;12,0;;12,0;;2,0;;11,0;;;;6,0;;;;19,0;6,0;;;2,0;;;;13,0;1,0;;;;;2,0;;1,0;;;;;;;;;;2,0;;6,0;3,0;1,0;10,0;;7,0;;;;;;;5,0;1,0;;;1,0;3,0;;;4,0;;;26,0;;;;2,0;;;;;;;;;;;;;;;7,0;;;2,0;;13,0;3,0;;;;;1,0;;;3,0;;;1,0;;3,0;1,0;;;;;;;;;9,0;;1,0;;;52,0;;;;;;;;7,0;;;;;;2,0;;;;;;;;;;;;;;;;7,0;1,0;;;;;;;48,0;1,0;;;;;37,0;;;;2,0;;;33,0;;2,0;1,0;;;;;;;;;3,0;;12,0;;;;;;;;;;;3,0;;;;;;;;;;;3,0;;;;;;;;;;14,0;;;4,0;;2,0;;2,0;;;;;;;1,0;;;;;;;;;;;;;;;;;8,0;;;;2,0;;;;;;;;;;1,0;;;1,0;;;1,0;;;;;;;;3,0;;;;2,0;;4,0;;;;;;;3,0;;;;;;;;1,0;;1,0;;;;1,0;;1,0;;;;;;;;;3,0;;;;;;;3,0;;1,0;;;;;11,0;;;;;3,0;;;;;;;;;;;;;;;;;;;;1,0;;;;;;4,0;;;;2,0;;;;;;;;;;;;;;;;;;;;;;;;;;;;;;;;;;;;;;;;;;;;;;;;;;;;;;;;;;;;;;;;;;;;;;;;;;;;;;;;;3,0;;;;;;;;;;;;;;;;;;;;;;;1,0;;;;;;;;;;;;;;;;;;;;;;;;;;;;3,0;;;;;;;2,0;;;;;;;;;;;;;;;;8,0;;;;;;;;;;;;;;;;;;;;;;;;;;;;;;;3,0;;;;;;;;;;;;;;;;;;;;3,0;;;;;;;;;;;;;;;;;;;;;;;;;;;;;;;;;10,0;;;;;;;;;;;;;;;;
convex;;;;;;9,0;9,0;16,0;;;;;4,0;1,0;;;1,0;;;;;3,0;;;;;;24,0;;;24,0;;;;;;6,0;1,0;;;6,0;22,0;10,0;;6,0;2,0;;44,0;1,0;;;;4,0;;2,0;14,0;22,0;1,0;;6,0;;;12,0;;109,0;;30,0;3,0;;;5,0;404,0;2,0;1,0;;;4,0;;;;8,0;;;;7,0;36,0;;28,0;;;;4,0;29,0;;;;;5,0;18,0;12,0;13,0;6,0;;;;;;;;;;;18,0;;;;2,0;11,0;;6,0;;;;;;;10,0;;;;;;;38,0;;;;2,0;4,0;;;4,0;;;3,0;;;6,0;;;;1,0;3,0;4,0;;;;;;;2,0;11,0;;;;;3,0;8,0;;1,0;;;;;;2,0;;3,0;;;;;4,0;50,0;;;;;4,0;15,0;;;;;;;9,0;1,0;;;;1,0;;;;1,0;10,0;;15,0;1,0;4,0;;;;1,0;30,0;;;133,0;1,0;5,0;;;;1,0;;115,0;;;;1,0;;;;6,0;;;;;;;;2,0;;;;;79,0;254,0;;;;3,0;4,0;;;3,0;635,0;2,0;;1,0;2,0;;;;;;;;1,0;;;;1,0;;;1,0;3,0;;1,0;1,0;;17,0;;;;;1,0;2,0;;;;;;;8,0;;9,0;;8,0;;;1,0;;;;;;;6,0;;;15,0;;;;3,0;1,0;;;1,0;114,0;4,0;1,0;;20,0;2,0;;92,0;;2,0;15,0;;2,0;;2,0;;;;;;2,0;;;;;;4,0;;3,0;;;;;;;2,0;3,0;2,0;;;;;;;;2,0;;;;;;;40,0;;;;;;;3,0;;;;;8,0;;;;;;1,0;;;4,0;;;;;;;;;;2,0;;;;;;;;;;3,0;;;;;;;;;;;4,0;;;;;1,0;;;;;;;;;;;1,0;;3,0;;1,0;;;;;;;;;;2,0;;;;;;1,0;;;;;;;;;;;;;2,0;4,0;;;;;9,0;;;;;;;2,0;;;;;4,0;2,0;;2,0;;;;;;;;;;1,0;;;;;;;;;;;;;;;;5,0;;2,0;;;4,0;;;;;;;;;;1,0;;1,0;3,0;;;2,0;3,0;;;;;;;;;2,0;;;;;;;;;;;;;;;;;;;;;;1,0;1,0;;;;;;1,0;1,0;;;;;;1,0;1,0;;;;;;;;;;1,0;;2,0;;;;;;;;;;;;1,0;;4,0;;;;;;;;;;;12,0;;;;;;;;;;;4,0;;;;;2,0;;;;;;;;;;;;;;;;;;;;;;;;;;;;;;3,0;;;;;;;;;;;;;;;;;;;;;;;25,0;;19,0;;;;;;6,0;3,0;;;2,0;2,0;;;;7,0;;;;;;;;;;3,0;;;;5,0;;;;;;1,0;;3,0;;;2,0;;1,0;;;;;;2,0;;;;;;;;;;102,0;;;;;;;;1,0;;;;;;;;;2,0;;;;;9,0;1,0;;4,0;;;;1,0;;;2,0;;;;;;;;;;;;;;;;;;;;;;5,0;;;;;;;;;;;;;;;;3,0;2,0;;;;;;1,0;;;;;;;;;;;;;;;;;;;;;;;;;;;;6,0;;;2,0;;;;;;;;;1,0;;;;;;;;1,0;;;2,0;8,0;;;;;9,0;;;;;;;;;;;;;;;;;2,0;;;;;;;;;;;;;;;;;;;;;;;2,0;;;;2,0;;;;;;;;;;;;;;121,0;;;;;;;;;;2,0;;;1,0;;;;;;;;;;;;;;;;;;;;;;3,0;;;;;;;;;;;;;;;;;
cylinder;;;;;;11,0;;7,0;;;2,0;;;30,0;;;;;;;2,0;3,0;;;4,0;;;3,0;;3,0;31,0;2,0;;;;;2,0;3,0;;;;19,0;9,0;;1,0;4,0;;3,0;;;;;12,0;4,0;;;15,0;;;;1,0;;;;8,0;;30,0;;8,0;;1,0;6,0;2,0;;;;;;;;2,0;;;;8,0;9,0;3,0;7,0;;;;;9,0;;;;;;12,0;;17,0;;;;;;2,0;;;;;;1,0;;;;;;;7,0;;1,0;;;;;10,0;;;;;;;2,0;;;;;;;1,0;;;;3,0;;2,0;1,0;2,0;15,0;4,0;8,0;59,0;;;;15,0;;;;4,0;19,0;;;;;5,0;1,0;;1,0;8,0;;2,0;23,0;3,0;;;;;9,0;;;;6,0;;;;;8,0;2,0;;;1,0;15,0;9,0;7,0;28,0;;17,0;1,0;;;1,0;2,0;1,0;;12,0;;;19,0;4,0;;;;;21,0;;9,0;;1,0;;;;1,0;11,0;;30,0;;;;16,0;;2,0;;1,0;;;;;;;8,0;9,0;4,0;5,0;2,0;;16,0;11,0;9,0;1,0;;;11,0;;;12,0;32,0;;;;4,0;;;23,0;;;;;;;1,0;;;;;2,0;;;;1,0;;2,0;;;;;;;2,0;;;;5,0;2,0;10,0;;;;2,0;;;1,0;1,0;;3,0;;;;;;;6,0;;1,0;;7,0;;;3,0;;3,0;2,0;;;;;;4,0;;1,0;4,0;;;;;;;;;7,0;;;10,0;;2,0;4,0;5,0;;2,0;;;;;;;;4,0;;;;;;;;;;;;;;;;4,0;;;;;;;7,0;;;;;18,0;;;;;;;;;;;;;;;;;;1,0;;;;1,0;;;;;;;;;;;;;;;;;;3,0;;;;;;;;;;;;;4,0;;3,0;;;;;;;;;;;;;1,0;;;;;;;;;;1,0;;;;;;;;;;;2,0;;;;;4,0;1,0;;;;;;;;2,0;;;;;;;;;;;;;;;;;5,0;;;;;;;;;;;;;;;;1,0;;;;;6,0;;2,0;;6,0;;;11,0;;;;;;;;;;2,0;;;;;2,0;;;;;;;;;;6,0;;;;;;;;;;;;;;;;4,0;;;;4,0;;;;;2,0;;6,0;;;;;;;;;;;;;;;;;;1,0;;;;;;;;;;;;4,0;;;;;;;;;;;;;;;;;;;;;;;;;;;1,0;7,0;;;;;;;;;;;;;;;;29,0;;;;;;;;;;;;;;;;;;;;;;;;;;;;;2,0;;;;;;;4,0;;2,0;;;;;;3,0;;6,0;;;;;;1,0;;;;;;;;;;;5,0;;;;;;;;;;;;;;;;;;;;;1,0;2,0;;;;;;13,0;;2,0;;;;;;2,0;1,0;;;;15,0;;;;;;;;1,0;4,0;;;;;;;;1,0;;;;;;;6,0;;;;;;;;;;;;;;;4,0;;;;;;;;;;;;;;;;;;;;;;;;;;;;;;;;;;;;;;;;;;;;;;;;;;;;;;;;;;;;;;;;;;;;;;;;;;;;;;;;;;;;;;;;;;;;;;;;;;;;;;;;;;2,0;;;;;;;;;;;;;;;;;;;;;;;;;;;;;;;;;;;;;1,0;4,0;;;;;5,0;;;;;;;;;;;;;;;;;;;;;;;;;;;;;;;;;;;;;;;;;;;3,0;;;;;
decide;;;;;;2,0;2,0;;;;;;;5,0;;;9,0;;;;;;;;;;;1,0;;1,0;8,0;;;2,0;;1,0;;;;;6,0;5,0;;;;;;;;;;;;;1,0;;;;;;;;;;20,0;;1,0;;;;;1,0;;;;;;;;5,0;5,0;;;;;2,0;;2,0;;31,0;6,0;;;;;;;4,0;;;9,0;;;1,0;1,0;;;;;;;8,0;;;;;1,0;;;;;;;;;2,0;8,0;;;;16,0;;4,0;31,0;;;;1,0;2,0;;;;;;;1,0;1,0;;;;;;;;;;;;;;;;;;;;;;;15,0;;;;10,0;;;;;1,0;;;;;;;;;;2,0;;;;;;;;;;;;;;;;;;1,0;;;;;;;;;;;;1,0;;;;;;;;1,0;;;;;;;2,0;;;;;;;;;;;;;;;;;;;;;;;;;;;1,0;3,0;;;;;;;;;;;;;;;;1,0;;;;;;7,0;;;;1,0;;;;;;;;;7,0;;;;;;;;;;;;;2,0;;;;;;;;;;;;10,0;;;;;;;;;;;;;8,0;;;;;;1,0;;;;;;;3,0;;;;;;;2,0;;;;6,0;;;;;;;;;;;;;;;;1,0;;;1,0;;;11,0;;;;;5,0;1,0;;;;;1,0;;;;;;;;;;;;3,0;;;;8,0;;;;;;;1,0;;;;;;;;;;;;;;;;;;;;;;2,0;;;;;;;;;;;;1,0;;;;;;;;;;;;4,0;;;;;;;;;;;;;;;;24,0;;;;;;;;;;;;;;;;;;;;;;1,0;;;;;;;;;;;;;;;;;8,0;;;;;;;;;1,0;4,0;;;;;;1,0;;;2,0;;;;;1,0;;;;;;;;;;;;;;;1,0;;;;;;;2,0;;;;;;;;;;;;;;;;;;;;;;;3,0;;;;;;;;;2,0;;;;;;;;;;;;;;2,0;;;;;;;;;;1,0;;;;;;;;;;;2,0;;;;;1,0;;;;;;;;;;;;;7,0;;;;;;;;1,0;;;;;;;;;2,0;;;;;1,0;;;;;;;;;;7,0;2,0;;;;;;;;;;;3,0;;;;;;;;;;20,0;;;4,0;35,0;;;;;;;;;;;;;;;;;;;;;;;;;;;;;;;;;;1,0;;9,0;;;;;;;;;;;;;;;;;;;;;;1,0;;;;;;;;1,0;;;;;;;;;;;;;;;;;;;;;;2,0;;;;;;;;;;;;;;;;;;;2,0;;;;;;;;;;;;;;;;;;;;;;;;;;;;;;;;;;;;;;;;;;;;;;;;;;;;;;;;;;;;;;;;;;;;;;;;;;;;;;;;;;;;;;;;;3,0;;;;;;;;;;;;;;;;;;;;;;;;;1,0;;2,0;;;;;;;;;;;;;;;;;;;;;;;;;;;;;;;;;;6,0;;;;;;;;;;;;;;;;;;;;;;;;;;;;;;;;;;;;;;
differential;;;;;;6,0;;;;;;;;23,0;;;1,0;;5,0;1,0;;;11,0;;11,0;;;2,0;1,0;;36,0;1,0;;;;56,0;;;13,0;;11,0;32,0;;10,0;;;;;11,0;;2,0;;;;1,0;;2,0;;;14,0;;;;;33,0;;52,0;;;;3,0;1,0;3,0;;;4,0;;;;;15,0;;8,0;;3,0;;;1,0;;2,0;6,0;;;;;;5,0;;34,0;1,0;7,0;3,0;;;;4,0;;;;;;11,0;;;;;;3,0;8,0;4,0;1,0;;92,0;;;4,0;22,0;;;;9,0;;;7,0;;3,0;2,0;;;;;8,0;;;;6,0;1,0;18,0;4,0;;;;;;;;;;;;;51,0;;;10,0;6,0;;;;2,0;;;;2,0;;17,0;;;;2,0;;;;;;;;;6,0;;;;;2,0;;;;;;1,0;1,0;;;4,0;;;2,0;;;;;;;;;2,0;80,0;1,0;6,0;;;3,0;;;;;1,0;;;;;;;1,0;;;;;;3,0;;;;;;;;;8,0;;;;;5,0;;3,0;;4,0;;;1,0;2,0;;5,0;;;1,0;;;;;12,0;1,0;;;;;;;;;;;;;;1,0;;20,0;;1,0;1,0;;;;;1,0;14,0;;;;;;;;;;1,0;;22,0;;;;;;;;;10,0;;1,0;4,0;;;;;;;1,0;;;;;;;;;;;;;;;;;;2,0;;;;;;1,0;;;;;;2,0;;;;;;;;;;;;;;6,0;2,0;8,0;;;;10,0;34,0;5,0;;;1,0;;12,0;;6,0;;;;;5,0;;4,0;;;;2,0;;;21,0;;;3,0;2,0;;;7,0;1,0;;1,0;;2,0;;;;;;1,0;;;;;;19,0;;;;;;;;;4,0;4,0;;;12,0;;;7,0;2,0;;;3,0;;;;;1,0;8,0;3,0;;;;1,0;;;;8,0;;;;;5,0;;;1,0;;;;;8,0;;;;2,0;3,0;;;1,0;;1,0;;;3,0;;;;;;;;;4,0;;;;;;;;;;;6,0;;;;;;;;;;;3,0;;;7,0;;2,0;;;;;;;;;;;;;;;;;;;;;;;;;1,0;;;;;;;;;;3,0;;;2,0;;;;;;;;;1,0;;;;;;;;;;6,0;4,0;;;;;;;;;;;;;;;;;;;;;;;;;;;3,0;;34,0;1,0;;;11,0;;;;;;4,0;;;;;;;;;;;;;;1,0;;;;;;;;;;;8,0;;;;4,0;;1,0;;;;;;;;2,0;;;;;;;;;;;;21,0;;1,0;;;;;;;;;;;2,0;;;3,0;;;;;;;;;48,0;;;;;;;;2,0;1,0;;;;;;;;;4,0;;1,0;4,0;;;;;;;;;;;;;;;;;13,0;4,0;;;;;;;;;;;;;;;;;;;;;;;;;;;;;;;;;;;;;;1,0;;;;;;;;;;;;;;;;;;58,0;3,0;;16,0;8,0;;;;;;;22,0;;;;;;2,0;;;34,0;;;;4,0;;;;;;8,0;;;;3,0;;;;;;;121,0;;;;4,0;;;;;;;;;16,0;;;;;;;;2,0;;4,0;;;;;;;3,0;;;;2,0;;;;6,0;;;;1,0;10,0;;;;;;;;;;;;;;;;;;;;;;;;;;;;;;;;;;;;;;;;;;;;;;8,0;;;1,0;;;;;;;;;;;;;;;;6,0;;;;;;;;;;;;;;;;;;;;;;1,0;;;;;;;;;;;;;;1,0;;;;;;;;;;;;;;;;;;;;;;;;
door;;;;;;20,0;;98,0;;;;;;6,0;;;17,0;;4,0;;;;;4,0;4,0;;;6,0;;;54,0;4,0;;;;7,0;3,0;;;;16,0;36,0;;;9,0;4,0;;6,0;;;;1,0;11,0;1,0;;;3,0;;;;;;1,0;;27,0;;40,0;;;3,0;2,0;2,0;8,0;;;;;;;1,0;13,0;;5,0;;10,0;4,0;;;;;;;;;5,0;;;;4,0;;127,0;5,0;;;1,0;;8,0;;;;;9,0;2,0;3,0;;;;10,0;;46,0;;;6,0;3,0;;;84,0;;;;9,0;;;12,0;;;7,0;;;;;3,0;;;;2,0;28,0;9,0;5,0;9,0;2,0;;32,0;10,0;;;;;;;;9,0;;;;;54,0;19,0;;6,0;;;3,0;15,0;;20,0;;;;;1,0;;4,0;31,0;;1,0;;7,0;12,0;4,0;;;3,0;;;3,0;83,0;;19,0;;;1,0;4,0;8,0;;;1,0;;1,0;26,0;33,0;30,0;;;7,0;18,0;4,0;1,0;;;3,0;;8,0;;;;12,0;;10,0;1,0;2,0;;3,0;;7,0;;;;;;;;;19,0;10,0;2,0;;4,0;30,0;9,0;1,0;;;53,0;1,0;;1,0;27,0;;;;2,0;;48,0;15,0;;;;;15,0;;;11,0;1,0;;;2,0;28,0;;;2,0;;3,0;;;;;;5,0;;;;;;;;1,0;4,0;;1,0;21,0;2,0;;;;;13,0;3,0;1,0;;;2,0;17,0;;1,0;;16,0;34,0;;2,0;1,0;3,0;7,0;;8,0;;;;8,0;;;;;6,0;;3,0;;;;;1,0;5,0;;;;20,0;;3,0;;10,0;;;;;5,0;;3,0;;6,0;8,0;1,0;;;2,0;9,0;;;;;6,0;;;;6,0;;;;;4,0;;18,0;;;;;27,0;4,0;;;25,0;;;1,0;;;;;;3,0;;;;3,0;;2,0;1,0;;;3,0;7,0;5,0;3,0;;17,0;30,0;;1,0;;;;;;;;1,0;6,0;1,0;9,0;1,0;;19,0;;;7,0;1,0;;16,0;2,0;19,0;;;;4,0;;;;;;5,0;;;;11,0;2,0;;3,0;;;3,0;1,0;;1,0;;1,0;;;;;;;;1,0;;7,0;3,0;;;;;1,0;;;;;26,0;;;;;;;1,0;;2,0;;;;3,0;;;;;;;;;10,0;;;;;;;;;;2,0;136,0;46,0;;;;1,0;;;;13,0;;;;5,0;;;5,0;;;;;;;;2,0;;196,0;;2,0;;;;;;1,0;;;1,0;;;;;;;3,0;5,0;;;;;;26,0;;6,0;;;;;;;;;;;;2,0;7,0;1,0;3,0;;;;;;;;;;;;;;;;;;;;;;;;2,0;;;;;1,0;41,0;;;;;;;;;;;;;;;;;;;;;;6,0;;;;;1,0;3,0;;;;;;;;;;;;;2,0;;;;;;;;;;;;;1,0;1,0;;;21,0;;;;;;;;;1,0;;;;;;1,0;;;1,0;;;;6,0;;2,0;8,0;6,0;;;;1,0;;;;3,0;;;;;;3,0;;;;3,0;;;;;;3,0;1,0;1,0;7,0;;4,0;;;;;;2,0;4,0;2,0;;2,0;;3,0;;;;;;;1,0;;;;;;8,0;;;;;15,0;;;;;;;;;2,0;;;;;;6,0;4,0;;;;;;;;;1,0;7,0;;3,0;;;;;;;;;;;;1,0;;;;;;;;;;;;;;;;;;;;;;;;;;;;;;;;;;;;;;;;;;;;;;;;;;;;;;;;;;;;;;;;;;;;;;;;;;;1,0;;;;;;;3,0;;1,0;;;;;;;;;;;;;;6,0;;;;;;;;;;;;3,0;;;;;;;;3,0;;;;;;;;;;;;;;;;26,0;;;;;;;6,0;;;;;;;;;;;1,0;;;;;;;;;;;;;;;;;;;;;;2,0;;;;;;;;;;;;;;;;;;;;;;;;;;;
drain;;;;;;2,0;;;;;;;;;;;2,0;4,0;17,0;;;;;;;;;1,0;;;5,0;5,0;;;;;;;;;;33,0;;;;13,0;;11,0;;;;;1,0;;4,0;;5,0;;;;;;4,0;;5,0;;8,0;;;;;7,0;3,0;7,0;;;;;;;1,0;;2,0;;;;;;;;;;;1,0;;;7,0;;5,0;;;9,0;;;;;;;;;;4,0;28,0;;;;;;;3,0;;;21,0;;;;5,0;;;;;;;10,0;;;;;;;;;;;;2,0;;;;;;;1,0;;;1,0;;;;;;119,0;;;;;48,0;3,0;;;;;;2,0;;;;;4,0;;;;;8,0;;;;;;6,0;;;;;;;2,0;;;;;6,0;;10,0;;;;;;;;;;;;5,0;8,0;;;5,0;;;;4,0;;1,0;3,0;;1,0;;;;;;2,0;;;;;;;;;;;2,0;;1,0;1,0;;;;;6,0;1,0;8,0;;5,0;;;1,0;;3,0;;;14,0;;;;;;5,0;;;;;5,0;;2,0;;;;;;;;;;18,0;;2,0;;;;;;;;;;;;;;;;;;;27,0;;;;;;;;;;2,0;;1,0;1,0;;;;;;14,0;;;;;14,0;;;;;;;;;;;;;;2,0;;;;;;;;;;9,0;;;;;;;2,0;;;;;;;;;;;;2,0;;;;2,0;;;;;10,0;;;;;;;;;;;;;;;;2,0;2,0;;;2,0;;;;;;;;3,0;;;;;;;;;;;;;;1,0;;;;;;;;;1,0;;14,0;;;11,0;;;;1,0;;;;;;10,0;;;;;;;;;;;;3,0;;;;;;;;;;;2,0;;;;;;;;29,0;;;;;;;;;;;;;;;;;;;;;;;10,0;;;;;1,0;;;;;;;;;2,0;;;;;;;;;5,0;;;;;;;;;;;;;;;12,0;;;;;;;;;;;;;;1,0;;;;;;;;;;2,0;;;;;;;;;;;;;;1,0;;2,0;;;;;;;;;;;;;;10,0;;;;;;10,0;;;;;;36,0;;;;5,0;;;;;;;;;;;;;;;;;;;;;;;;;;;;;;;14,0;;;;;;;;;;;;;;;;;;;2,0;;;;;;;92,0;;;;;;;;;;;;;2,0;;1,0;;;;;;;;4,0;;3,0;;;;;;;;1,0;;;;;;;;;;;;;4,0;;;;;;;;;;;;;;;;;;;;;;;;;1,0;;;;;;;;;;;;;;;;;;;;;;;;;;;;;;;;;;;;;;;;;;;;;;;1,0;;2,0;9,0;;2,0;;2,0;10,0;;;;1,0;;8,0;;4,0;;1,0;;;;7,0;;;;10,0;;4,0;;;;1,0;;;;1,0;;;;;;;218,0;;;;;;;;;;;;;;;;;;;;;;;;22,0;;;;;;;;;;;;;;;;;;;;;;;;;;;;;;;;;;;;;;;;;;;;;;;;;;;;;;;;;;;;;;;;;;;;;;;;;;;;;;;;;;;;;;;;;;;;;;;;;;;;;;;;;;;;;;;;;;;;;;;;;;;;;;;;;;;;;;;;;;;;;;;;
edit;;;;;;13,0;;;;;;;;34,0;;1,0;3,0;;;;;;4,0;;;;;;;;4,0;;;;;8,0;5,0;;3,0;;4,0;80,0;1,0;4,0;87,0;1,0;;;;2,0;;;;;;;3,0;;;15,0;;;;;256,0;1,0;9,0;;;;;;;;;;;;4,0;2,0;61,0;;2,0;;3,0;;;;;4,0;3,0;;;;;;;;8,0;1,0;;;;6,0;4,0;31,0;7,0;33,0;;;;;1,0;;;;6,0;1,0;;3,0;4,0;;27,0;3,0;;32,0;11,0;;;;5,0;;;;;;4,0;;;;;;;;3,0;;;;20,0;;;;;;1,0;;;;;;;2,0;10,0;14,0;;;;;;;;;;;;;;;4,0;;;;;;;;4,0;;2,0;;;;;;;;;;;;;;;;;4,0;;;;;;;;;;;11,0;;;;;;;;;;;;;;;;1,0;;;;;;;;;;;;;6,0;;4,0;;;;;;;;;;9,0;;;;;1,0;;;;;;;8,0;;;;;;;1,0;;;;;;;;;;;;;;;;;;;;1,0;;;;;;;;;;;;1,0;1,0;;3,0;;;;;;;;;;5,0;;;;;;;;5,0;;;;;3,0;;;;;;;;;;;;4,0;;;;;;;;;;;;34,0;1,0;;;;;;;1,0;;;;;;1,0;;;2,0;;44,0;;;68,0;;;3,0;;2,0;;;1,0;;;;;;;1,0;;;1,0;;;5,0;;1,0;;1,0;;;;;;;;;11,0;;;;;;;;;;;102,0;64,0;19,0;3,0;;;;;;;;4,0;;;;;;;;;;3,0;;34,0;;;;;;;;;;27,0;;1,0;;;5,0;;;;;;;;;6,0;31,0;;;;;;;;;;;;;16,0;;;;;;;;;;2,0;;;;;;;2,0;;;;;;2,0;1,0;;;;;;;;;;;;;;3,0;3,0;;;;;;;;;;;;;;1,0;;;;;;;;1,0;;1,0;;;;1,0;4,0;1,0;3,0;;;;;;;;;2,0;;;1,0;;;2,0;;;;;;;;;;;;;;;;1,0;12,0;1,0;1,0;;;1,0;;;;;2,0;;;2,0;;;;4,0;23,0;;;;;;;;;;;;;;;;;;;;;;3,0;;;;;4,0;;;;;;;;2,0;;;;;;;;;;1,0;;;3,0;;;;;;;28,0;1,0;;;;;;;;2,0;;;;;;;;;2,0;;;;;;;1,0;;;;;;;;;;;;;;;;;;;;;;;;;;;;;;;;;;;;;;;;;;;;;;;;;;;;;;;;;;;;5,0;;;;;;;;;;;;;;;;;;;;;;;3,0;;;;;;;;;;;;83,0;;;;;;;;;;;;;;;;;;;;;;;;;;;;;;;;;;;;;;;;;1,0;;;;;18,0;;;;;4,0;;;;;;;;;;;1,0;;;;;;;;;;;;;;;;;;;;;;;;;;;;;;;;;;;;;;;;;;;;;;;;;;;;;;2,0;;;;;;;;;;;;;;;;;;;;;;;;;;;;;;;;;;;;;;;;;;;;;;;;;;;;;;;;;;;;;;;;;;;;;;;;;;;;;;;;;;;;;;;;;;10,0;;;;;;;1,0;;;;;
emitter;;;;;;4,0;7,0;2,0;;;;2,0;;2,0;;;4,0;;;;;;3,0;;2,0;;;4,0;;;30,0;5,0;;;2,0;;1,0;;;;1,0;40,0;;1,0;2,0;3,0;;13,0;;;2,0;;3,0;;;;8,0;;2,0;5,0;;;1,0;;7,0;;21,0;;;10,0;;3,0;107,0;2,0;;;;;;;17,0;;;;;;;14,0;1,0;;;;7,0;;;;4,0;10,0;44,0;;8,0;;;;;5,0;;;;;;;;;;;;1,0;7,0;12,0;1,0;;5,0;;;;11,0;;1,0;;;;;2,0;;;7,0;4,0;;;;1,0;;;4,0;;1,0;;1,0;2,0;;6,0;;2,0;1,0;;;;;;1,0;2,0;;;;;10,0;1,0;;;4,0;;12,0;4,0;1,0;;;58,0;1,0;;1,0;;2,0;3,0;;;3,0;;1,0;1,0;;;1,0;;;;14,0;1,0;;;;;;;7,0;;;;4,0;4,0;;;6,0;;;;1,0;;;1,0;;;;12,0;;;7,0;;;;;19,0;1,0;;;;5,0;;;;;2,0;;;;1,0;;;12,0;;;;;;;;;2,0;;;;1,0;2,0;5,0;4,0;6,0;;;;;;;;2,0;;;1,0;2,0;;;;;5,0;;;;;;;;;;;;;;;4,0;;;;;;;;;;;;2,0;;;;;;;8,0;;;;;1,0;;;;;;;1,0;;;;;;;1,0;;;1,0;;;;;;;;;;3,0;;;;;;;3,0;;;4,0;;;;;;2,0;;;2,0;;;;;;;1,0;;;;;;1,0;;;;;2,0;;;;;;;;;;;;;;1,0;;2,0;;2,0;;5,0;;4,0;2,0;;;;;;;;;;;;;;;;;11,0;;2,0;;;;;;;;;;;1,0;;;1,0;8,0;;;;;1,0;1,0;;;;4,0;;;;;;;1,0;3,0;1,0;;;;;;;;;2,0;;;;;;1,0;;;;;;;;;;;;;;;;;;28,0;;;;;;;;;;;;;;;;;;;;;1,0;4,0;4,0;;;;;;;;;;;;;;;;;;;;;;;;;;1,0;;;;;1,0;;;;;;;;;;;;;;;;;;;;;;;;2,0;;;;;;;;;;15,0;;;2,0;;;;;;;;;;;;1,0;1,0;;;;;;1,0;;;2,0;;;;;;;;;;1,0;;1,0;;;;;;;;;;;;;;;2,0;;;;;2,0;;8,0;1,0;;;;;;;;;;;;;;;;;;;2,0;;1,0;5,0;;;;;;5,0;;;;;;1,0;;;;;;;;;;;;;;;;;;;;;;;;5,0;;;;1,0;;;;;;;;;;;5,0;;;;;;;;;;;;;;;;;3,0;;;;;;;;4,0;;;;;;;18,0;;;;;;;;;;;6,0;4,0;;;;;;;;;;;;;1,0;;;;;;;;;;;;;;;;;;;;;;;;;;;;;;;2,0;;;;;;;;;;1,0;;;2,0;;;;;;;;;;;;;;;;;;;;;;;;;;;;;;;;;;;;;;;;;;;6,0;;4,0;;;;;;;;1,0;;;;;;1,0;;1,0;;;;;;;;;;;;;;;;;;;;;;;;;;;;;;;;;;;;;;;;;;;;;;;;;;;4,0;;;;;;;;;;;;;;;;;;1,0;;;;;;;;;;;;;;;1,0;;;;;;;;;;;;;;;;;;;;;;;;;;;;;;;;;;;;;;
enclose;;;;;;7,0;7,0;18,0;;;;;1,0;31,0;;;2,0;;3,0;;;;2,0;;;;1,0;43,0;;;71,0;1,0;;;;1,0;2,0;3,0;6,0;;1,0;19,0;3,0;;3,0;6,0;;20,0;;;;3,0;6,0;7,0;;;11,0;;;3,0;1,0;;;1,0;49,0;;14,0;;;1,0;;42,0;20,0;;;;9,0;;;1,0;8,0;;;;21,0;2,0;;7,0;2,0;1,0;;74,0;;3,0;;;7,0;3,0;23,0;;15,0;1,0;;1,0;2,0;11,0;;;;;;;8,0;;2,0;;;;3,0;53,0;;;6,0;;;;20,0;;1,0;;2,0;;;16,0;;3,0;6,0;1,0;;;;1,0;;;;1,0;6,0;3,0;1,0;3,0;;;35,0;3,0;;1,0;;;;1,0;3,0;14,0;;;;;13,0;25,0;;1,0;1,0;;2,0;1,0;1,0;4,0;4,0;7,0;;;;;;9,0;;1,0;3,0;;8,0;26,0;;;9,0;6,0;3,0;3,0;188,0;;14,0;;4,0;2,0;;;1,0;;18,0;2,0;5,0;20,0;1,0;;1,0;2,0;;15,0;;12,0;;2,0;19,0;;;;3,0;;44,0;;;2,0;;9,0;;;6,0;;5,0;;;;;5,0;;;8,0;;;3,0;21,0;;;1,0;;34,0;8,0;;11,0;38,0;4,0;;2,0;3,0;;;7,0;;;;;5,0;1,0;6,0;;;;;1,0;4,0;1,0;;2,0;1,0;2,0;13,0;;4,0;;4,0;12,0;2,0;5,0;1,0;2,0;15,0;;;;;;5,0;;;;;;1,0;4,0;;;5,0;;;30,0;3,0;1,0;;10,0;;;4,0;;2,0;;;;;;;9,0;8,0;1,0;3,0;;14,0;5,0;;;;;;3,0;;1,0;1,0;;3,0;41,0;9,0;;12,0;1,0;1,0;;;3,0;4,0;;17,0;5,0;1,0;;;;;;;;;;;3,0;;1,0;2,0;;5,0;;;;;2,0;2,0;;;;2,0;;;;;;;;;;;;3,0;;;;;6,0;;;;;1,0;;4,0;;;;;;;;;;;;;;;;16,0;;;;;5,0;;;;;;2,0;2,0;;;;1,0;;;;;;;;;;;2,0;;2,0;11,0;;;;1,0;;;;1,0;;;;;;;;6,0;;8,0;20,0;;;;;;4,0;1,0;;;1,0;1,0;;1,0;;;;;;1,0;;1,0;;;;1,0;;;;;;;1,0;;;;;1,0;;;;4,0;;11,0;1,0;2,0;2,0;4,0;1,0;;;;53,0;3,0;;;;;1,0;1,0;;;;;;;;;3,0;24,0;;;;;;;;;;;;;;;;;;;;4,0;;;1,0;;;;;;;;2,0;;;;2,0;3,0;;;;5,0;;46,0;2,0;;;1,0;;;;;15,0;;;;;;;;;;;;;1,0;;;;;;;;;;;;;;;;;;;;;;;;;6,0;;;;;;;3,0;;;1,0;;;;;1,0;;;;;;;;;;;;;;;;;2,0;;;;5,0;;16,0;;;;;;;;4,0;;;2,0;;;4,0;;;;1,0;;;;;;;;;3,0;1,0;;7,0;;;2,0;1,0;5,0;;8,0;3,0;;;;1,0;;;2,0;;;;;;;4,0;;;;1,0;1,0;;;;;;;;;5,0;12,0;;1,0;;;;;7,0;;;4,0;;;;;;;;1,0;;;;6,0;;2,0;;17,0;1,0;;;;;;;;3,0;1,0;3,0;;;;11,0;;;;;;5,0;;;;;;;;;;;;;;;;;;;;;;;;;;;;;;;;;;;;;;;;2,0;;;;;3,0;;;;;;;;;;;;;;;;;;;;;;;;;;;;;;1,0;;;;;;;;;1,0;;;;;;;;;;;7,0;;;;;;;;;;;;1,0;;;;;;;;;;;;;;;;;;;6,0;;;;;;;;;;;;;;;;;;;;;;;;;;;;;;5,0;;;;;;;;;;;3,0;;;;;;;;1,0;;;;3,0;;;;;;;;;;;;2,0;;;;;;;;;;;;;;;;;;;;;;;;
enhance;;;;;;2,0;7,0;1,0;;;;;;19,0;;;17,0;;;3,0;;;47,0;2,0;;;;4,0;3,0;1,0;9,0;;;4,0;;10,0;;;7,0;;10,0;31,0;;11,0;10,0;;;1,0;;;;;3,0;1,0;8,0;;1,0;;1,0;13,0;;;1,0;;229,0;1,0;14,0;1,0;1,0;;;17,0;5,0;2,0;;;9,0;1,0;;;31,0;;;5,0;11,0;2,0;;2,0;;14,0;1,0;;;;;;3,0;;32,0;3,0;4,0;;;22,0;4,0;8,0;;;2,0;;;8,0;9,0;;;;4,0;;4,0;4,0;1,0;;3,0;1,0;;;19,0;;;;1,0;;;1,0;;1,0;14,0;2,0;10,0;;;;;;;2,0;3,0;;1,0;;3,0;1,0;1,0;;;;;1,0;;;7,0;2,0;1,0;1,0;;;1,0;;;5,0;;;4,0;;;10,0;;1,0;;;;8,0;;;;;7,0;1,0;;;4,0;;18,0;;;;1,0;;;;;2,0;3,0;;1,0;2,0;;1,0;3,0;6,0;;;;;;;2,0;;;;2,0;;;;1,0;;1,0;;;27,0;;;6,0;2,0;;;;1,0;;;;4,0;1,0;;;6,0;1,0;3,0;4,0;;;;;;;;;5,0;;;16,0;2,0;;7,0;;1,0;;;;;;;;;;;;1,0;;2,0;;1,0;;;;;;;5,0;;;4,0;;;;;;8,0;1,0;;;;;2,0;;;;;;1,0;;;;;;;;;1,0;1,0;1,0;2,0;;1,0;;;;;;;;;;;;;;;;;;3,0;;;;;;;;;;;;;1,0;;;;1,0;;;;;1,0;;2,0;5,0;;;;;;5,0;4,0;;;1,0;;29,0;;4,0;;;;1,0;1,0;;;4,0;;;2,0;;1,0;7,0;1,0;;1,0;;;;8,0;;9,0;;;3,0;;;1,0;;;;;;4,0;;;;;;1,0;;;;4,0;;;;;2,0;3,0;;1,0;1,0;;;1,0;1,0;;;;1,0;;;1,0;;;3,0;;;;;;;;;;;;;;;10,0;;;;;;;;;2,0;;;;;;;;2,0;;20,0;1,0;3,0;;;;1,0;;;;3,0;2,0;;;2,0;;1,0;;;;;;;1,0;5,0;;;;;;;;2,0;;2,0;;;;3,0;3,0;3,0;;;;;;;;;;1,0;4,0;;;;;;;;;;;;;;;;;;;;1,0;;;;;;;;;;7,0;2,0;;8,0;1,0;;;;;;1,0;;;;;;1,0;;;8,0;;1,0;;2,0;;;;5,0;;;;;;;;;;;2,0;;2,0;;1,0;;;;;;;;6,0;;;;;;21,0;;;;2,0;;;;;;1,0;;;;;;;;;;;;;;1,0;;2,0;;;3,0;;;;1,0;;;;;;;;;;1,0;;;;;;;;;;;;7,0;;;;6,0;;;;;4,0;;;2,0;;;;;1,0;;;;1,0;;;;;;;;;1,0;;;;;;;;;1,0;;1,0;;;;;;;;;;2,0;;;;;;;;;;;;;;;;;;;;;2,0;;;;;;;;;;2,0;;;;1,0;;;;1,0;;;;;;;;;1,0;;;;;3,0;;;;;;1,0;1,0;1,0;;;;;1,0;;;;6,0;;;;;;;;;;1,0;;;;;;1,0;;;;3,0;;;;;;1,0;2,0;;;;;;;;3,0;;6,0;;;1,0;;;;;;;;;;;;;1,0;;;;;;;;1,0;;1,0;1,0;;;;;;;;;;;;;;;;;;;1,0;;;;2,0;;;;;;;;;;;;2,0;;1,0;;;;;;;;;;;19,0;1,0;;;;;;;;;;;;;;;;;;;3,0;;;;;;;;;;;;;;;1,0;;;3,0;;;;;;;;;;;;;;;;;;;;;;;;;;;;;7,0;;1,0;;1,0;;;;;;;;;;1,0;;;;;;;;;;;
enlarge;;;;;;36,0;;10,0;;;;;;;;;4,0;;;;;;;;;;;1,0;;;5,0;1,0;;;;;1,0;;;;;4,0;25,0;;24,0;;;1,0;;;;;;11,0;3,0;;2,0;;;8,0;;;1,0;;135,0;;17,0;;;;;1,0;;;;;;;;;6,0;;;;;1,0;;2,0;;;;;;;;;;;2,0;3,0;1,0;;;3,0;4,0;;;1,0;;;;1,0;34,0;;;;1,0;;;2,0;6,0;;5,0;7,0;;;2,0;;;2,0;;;;8,0;;;4,0;;3,0;;;;;;;;10,0;;;;;;8,0;;;;;;;;;;2,0;;;;;4,0;;;;;;2,0;;;;;;;;;;;;;;;3,0;;;;;;;;2,0;;;;;;;;;1,0;;;;1,0;;3,0;;;;8,0;4,0;;5,0;;4,0;;;;;;22,0;;;;;;6,0;;1,0;3,0;;;;;;;;;;12,0;;3,0;4,0;;1,0;;;;;;;4,0;;;;;;1,0;1,0;;;;;2,0;;;;1,0;;;4,0;;;;;;3,0;;2,0;;;;;;;;;;1,0;;1,0;1,0;;4,0;;;;;;;;1,0;12,0;3,0;;;;;;;13,0;;;;;15,0;;;;;;;;;;;;;1,0;;;;;;;;;;2,0;;;;;;;;;;;;1,0;26,0;9,0;;29,0;;;;;4,0;;;;;;;;3,0;;;;;;10,0;4,0;;;;;5,0;;1,0;1,0;;;;2,0;4,0;;3,0;;;3,0;;;2,0;;;6,0;;;1,0;1,0;;;;;;1,0;;;;;;;;;;;2,0;;3,0;;;16,0;;2,0;;;;;;3,0;;;;1,0;2,0;;;;;6,0;;;;;;;;;;;;3,0;;;;;;;4,0;;;;;1,0;;;;;;;;;;;1,0;;;3,0;;;;;;;2,0;;;13,0;;;;;;;8,0;;;;;;;;3,0;;;;4,0;;;;;;;;;;3,0;;;;;;4,0;;;;;;;;;;;;4,0;;;;;;2,0;;;4,0;;;2,0;;;;;;;3,0;;;2,0;;;;;;;;;;;;;;;;;;;4,0;;;;11,0;;;;;;;;;;;;1,0;;;2,0;;;;;;;;;;;;;;;;;;;;;;;;;;1,0;;;;;;;;;;;;;;;;;;;;;;;;;;;;;;2,0;;;;;;;;;;;;;;;;;;;3,0;;;;;;;;;;;;;;;;;;;;;;;;4,0;;1,0;;;;;;;;;;;;;;;;;;;;;;;;;;;;;;1,0;;;;;;1,0;;;25,0;;;4,0;;;;;;;;;;;;;;;;;;;;;;;;;;;;;;;;;;;;;;1,0;;;;;;;;;;;;;;;;;;;;;;;;;;;;;;;;1,0;;;;;;;;;;;26,0;;;;;;;13,0;;;;;;;;;1,0;;8,0;;;;;;;;;;;;2,0;;;;3,0;;;;;4,0;;;;;;;;;;1,0;;;;;;;;1,0;;;;1,0;;;;;;;;;;3,0;;;;;;;;;;;;;;;;;;;;;;;;;;;;;;;;;;;;;;;;;;;;;;;;;;;;;;;;;;;;2,0;;;;;;;;;;;1,0;;;;;;;;;;;;;;;;;;;;;;;2,0;;;;;;;
entry;;;;;;9,0;5,0;;;;;;;14,0;;;13,0;;;;;;20,0;;;;;11,0;5,0;;6,0;;;6,0;;72,0;8,0;;3,0;;22,0;9,0;;2,0;2,0;;;2,0;;;1,0;16,0;6,0;1,0;3,0;;2,0;;;2,0;;;15,0;6,0;17,0;1,0;16,0;;;;;;23,0;;;1,0;;;12,0;3,0;32,0;;;7,0;;;;;;;10,0;;;;;;1,0;;68,0;18,0;1,0;1,0;3,0;1,0;;8,0;;3,0;;;;;;;;;;32,0;25,0;6,0;;;5,0;;;18,0;14,0;;;;14,0;2,0;;;;;1,0;;;;;;;;;;6,0;;17,0;;;1,0;1,0;;;;;;;;;;;;;;;;;;;;;3,0;;;;;;;;;;6,0;;;;;4,0;;;;;;2,0;;;;;;;;;;;6,0;1,0;;;12,0;;;5,0;;;;2,0;;;9,0;;2,0;1,0;;2,0;;;;5,0;;;;;;;;;;;;;;;;2,0;18,0;;2,0;2,0;;;;;;;;;13,0;;;;1,0;;1,0;;;;;;;4,0;;;;2,0;;2,0;1,0;;6,0;;1,0;;;;;;;;;;6,0;;;4,0;;2,0;;;;;;;;;;;;5,0;;;;;;1,0;;;1,0;;;;1,0;;3,0;;;;;1,0;;;;;;31,0;;3,0;;1,0;;;;;;;;;5,0;;;;;2,0;;;;;;2,0;;2,0;;;;;;3,0;;;;;;21,0;;2,0;;;;1,0;;19,0;;;;;2,0;;;;;;;27,0;3,0;;10,0;;8,0;;;;4,0;;;;4,0;;;;;;1,0;;1,0;1,0;;;;;;;;;;3,0;;;;;;;;1,0;;;;;;;;;;2,0;2,0;;2,0;;;6,0;;;;;;;;1,0;6,0;;;5,0;7,0;3,0;;;;;;;;;1,0;;;;;;9,0;;;;;;;;;8,0;;;;;3,0;4,0;;;;5,0;;;;;5,0;;5,0;4,0;;;;;;5,0;;4,0;;;;;;;;8,0;4,0;2,0;;;;;;2,0;;;;;8,0;;;1,0;;;7,0;3,0;;;14,0;;;;;1,0;;;;1,0;1,0;;;3,0;;;;;;;;1,0;;;;;;;;;;;;;;;;1,0;;;;;2,0;;;;3,0;;4,0;7,0;;;;;;2,0;;;2,0;;21,0;;13,0;1,0;;;;1,0;;;;;;;;;;1,0;;2,0;;;;;;1,0;;;;2,0;1,0;;;;;3,0;;;;;;;;;;;;;;;;;;;;;;;;1,0;;3,0;;1,0;;;;1,0;;;;;4,0;;10,0;2,0;;;3,0;;;;;;;;;;;;;1,0;1,0;;2,0;;;;;1,0;;;;;;;;;;4,0;;;;;;;;;;;;;3,0;;;;;;;;;;;;;;;3,0;;;;;;;;;;1,0;;;1,0;;1,0;;;;2,0;;;;;;;;;17,0;;;8,0;;;;;;;;;;;;;;;;;;;;;;;;;;;;;;;;3,0;;8,0;;;;40,0;;;3,0;;;;;;;;;;;;2,0;4,0;;;;;;;;;;;;;;;;;;;;;;;;;;;;;;;1,0;;;;;;7,0;;;;;;;;;;;;;;;;;;;;1,0;;;;;;;;;1,0;;;;;;;;;;;;;7,0;1,0;;;;;;;1,0;;;;;;;;;;;;;;;;;;;;;2,0;;;;;;;;;;;;;;;;;;;;;;;;;;;;;1,0;;;;;;;;7,0;;;;;;;;;;;;;;;;;6,0;;;;7,0;;;;;;;;
equipment;;;;;;17,0;1,0;11,0;;;;;;20,0;;;6,0;;1,0;;;;;;3,0;;;2,0;;2,0;14,0;5,0;;;;7,0;5,0;;;1,0;8,0;50,0;;7,0;17,0;3,0;;1,0;;;;;;1,0;2,0;;8,0;;1,0;2,0;1,0;;;1,0;11,0;;15,0;;4,0;;;11,0;1,0;;;;1,0;1,0;4,0;9,0;23,0;;;;7,0;;2,0;;;;1,0;;2,0;6,0;;;;;8,0;1,0;4,0;;;1,0;2,0;4,0;;;;;;;;;;;;;;7,0;1,0;;10,0;1,0;;2,0;23,0;;;;8,0;;;5,0;;;1,0;4,0;;;;;;1,0;;2,0;1,0;2,0;2,0;3,0;;1,0;5,0;1,0;;2,0;;;;;;3,0;5,0;;;;13,0;;;2,0;;;;;;5,0;3,0;;5,0;;;;;1,0;;;;;;2,0;;1,0;1,0;;7,0;1,0;3,0;;;;;;;1,0;;5,0;10,0;;;31,0;1,0;;;;;;;;;;9,0;3,0;11,0;;17,0;;21,0;;;1,0;;;;;;3,0;;;;;;1,0;;;;3,0;1,0;;3,0;1,0;1,0;;;5,0;1,0;3,0;12,0;1,0;;;1,0;5,0;;27,0;;;;;1,0;;;;;1,0;;;;;;;;;1,0;3,0;;;;;;;;;;;;;;;4,0;;;;3,0;;;;;;;;;;;2,0;;;3,0;1,0;;;4,0;5,0;;;;;;2,0;;;;;;;4,0;;1,0;;;;1,0;;;;4,0;8,0;;;;;4,0;2,0;;;4,0;;3,0;1,0;17,0;2,0;;;;1,0;2,0;3,0;;;;2,0;;;;3,0;;;;;2,0;1,0;33,0;;;1,0;;;;1,0;;;;3,0;3,0;;;3,0;;;;;;1,0;1,0;1,0;;3,0;1,0;7,0;3,0;;;;;2,0;9,0;3,0;;;;;;;;;;21,0;2,0;4,0;1,0;;;16,0;;;;;4,0;;4,0;;;3,0;;;;2,0;;;62,0;;;;;;4,0;;;1,0;;;2,0;;;;;;;;;;;;1,0;13,0;;3,0;;;;;;;;;;;3,0;;2,0;;;;;3,0;;;;;1,0;;;1,0;;;;;;;;;4,0;;1,0;;;3,0;;;;;;;2,0;;;;;;;;;8,0;1,0;1,0;;;;;;;;;;;;;;3,0;;;;;;;5,0;;;;;;;3,0;7,0;;1,0;;;;4,0;1,0;;;2,0;;;;;;;;;;;;7,0;;1,0;;;;2,0;;;;;;;;;;1,0;;;1,0;;;;7,0;;;;2,0;;;;;1,0;3,0;5,0;;;;;;;;;1,0;;;;;1,0;1,0;;;;;;;;;7,0;3,0;;;;1,0;;;;;;;;1,0;;;;;;3,0;6,0;;;;;;;2,0;2,0;;;;;;;;2,0;;;1,0;;;;2,0;1,0;;1,0;;;1,0;;;;;;;;;;;1,0;;1,0;;4,0;;;;;5,0;;;;1,0;;1,0;;;4,0;;;;;;;;;;;;;;3,0;;;;;;;;;;2,0;;3,0;;;;2,0;;;;;;;;;;;;;;1,0;;;1,0;;;;;;;;;;;;;;;;;;;;1,0;;;;;;;;;;;;;;;;6,0;1,0;;;;;;;;;;;2,0;;;;;;;;;;;;;;;;;;;;;;;;;;;;;;;;;;;;1,0;;;;;;;;;;;3,0;;;;;41,0;;;;;;;;;1,0;;;;;;;;;1,0;;;;;;;;;;;;;1,0;4,0;;3,0;;;;;;;;;;;;;;1,0;;;;;;1,0;;;;;;;;;;;;;;;;;;;;;;;;1,0;;;;;;;;1,0;;;;;;;;;;1,0;;;;;;;;;;;;;;;;;;;;;;;;;;;;;;;;;;;;
execution;;;;;;32,0;5,0;;1,0;;;;;8,0;;;22,0;;;;;;1,0;;1,0;;;;43,0;;34,0;3,0;;6,0;;3,0;4,0;;;;21,0;77,0;;;25,0;;;7,0;;2,0;;;;;;1,0;;;;9,0;;;;;49,0;8,0;16,0;;;;;4,0;2,0;;;;;;4,0;28,0;21,0;;23,0;;7,0;;;;;3,0;;;2,0;;3,0;;6,0;;10,0;2,0;6,0;12,0;;4,0;41,0;189,0;;82,0;;;;;50,0;;;;;4,0;4,0;5,0;7,0;;7,0;;;78,0;42,0;;8,0;;5,0;;4,0;21,0;1,0;;;2,0;4,0;;;;;;;4,0;30,0;;;;;;2,0;;;;;;;;;;6,0;;;;1,0;;;1,0;;;1,0;4,0;;;;;;;;;;;;;;;;;;;;3,0;;;;;;;;;;;;35,0;11,0;;;;1,0;5,0;;;;;5,0;;3,0;;;;;;;;3,0;;;;;1,0;1,0;3,0;3,0;;;1,0;;1,0;;;;;;2,0;;;;;;;;;;;1,0;1,0;;;;;;;;;;;1,0;;;;;;;;;;;;;;;;;;;;7,0;;;;;;;;;;;;;;;1,0;;;6,0;;;6,0;;;;;1,0;;;;;;9,0;1,0;;;;;3,0;;;;;;;;3,0;;;;;;;;;;;;2,0;;;;;;;;;;4,0;;8,0;5,0;;;1,0;14,0;;;;;;;;;3,0;;4,0;;;8,0;2,0;;12,0;1,0;;;;12,0;;;;8,0;;28,0;;4,0;;18,0;;6,0;8,0;;;39,0;;;;1,0;;5,0;;;;1,0;;3,0;21,0;2,0;;;;;;;;2,0;3,0;21,0;;49,0;2,0;;;;2,0;;;;14,0;;2,0;;;9,0;;;;17,0;;;18,0;;;;4,0;;;;;1,0;;1,0;38,0;;;1,0;;4,0;;;;;1,0;;163,0;1,0;;;;;5,0;2,0;;4,0;;1,0;;;19,0;;4,0;;;;;5,0;;;44,0;;7,0;;;;21,0;28,0;;;;;;;;;;;;;;;;;2,0;;;;3,0;;;;;;;6,0;;;;;1,0;3,0;2,0;;;;;1,0;1,0;;;1,0;;10,0;;;6,0;6,0;11,0;;;;;;;3,0;;;1,0;;3,0;;;;;;;;1,0;;;;;;;;;;2,0;;;1,0;25,0;1,0;;;3,0;;;;1,0;;;;;29,0;;2,0;;;;1,0;;;1,0;;4,0;;1,0;;;1,0;;;3,0;2,0;;3,0;;;;;;;;3,0;;7,0;;;1,0;2,0;;;;;;;;;;;;;;;;;;;;;;;;1,0;1,0;;;;;;;;1,0;;;;;;;1,0;;;;;;2,0;;;;;;;;;;4,0;;;;;;;;;;1,0;;;;;;;;;;;;;4,0;;;;;;;;1,0;;;;;;;;;;;;;;;;1,0;;;;;;;1,0;2,0;;;;;;;;;;;;;;;;;;;;;;;;;;;;1,0;;;;;;;;;1,0;;;;;;;;;;;8,0;;;;;;;;;;;;2,0;;2,0;1,0;;;;;;2,0;;;;;;;;;;65,0;;;;;1,0;;;;;;;;;;;;;;;;;;;1,0;;;;;;;;;;;7,0;;;;;1,0;;;;;;5,0;1,0;;;;;;;;;3,0;;;;7,0;10,0;;;;;;9,0;;;;;2,0;;1,0;2,0;;5,0;;;;;;;;1,0;;;;;;;;;;;;;;;;;;;;;;;;;;;;;;;;;;;;;;;;8,0;;9,0;4,0;;;;;;;;2,0;;;;;;;;;;;;;;;;;;;;1,0;;1,0;;;3,0;;;;;;;;;;;
finger;;;;;;2,0;;;;;;1,0;;14,0;;;2,0;;;;;;;;;;;;;;3,0;;;;;9,0;2,0;4,0;;;9,0;51,0;;;12,0;1,0;;10,0;;;;;7,0;;;;2,0;;;;;;2,0;;40,0;;30,0;;3,0;;6,0;22,0;;;;;;;;1,0;32,0;;1,0;;;;;;;;;;;3,0;;;5,0;1,0;7,0;6,0;26,0;3,0;;;;1,0;6,0;2,0;;;;9,0;5,0;;;;;10,0;;5,0;;;;3,0;;10,0;15,0;;;;1,0;;2,0;2,0;1,0;;2,0;8,0;6,0;;;;;;;5,0;;;;;2,0;3,0;9,0;1,0;;;;;;;;;;;;;1,0;;;;11,0;;;22,0;;;;;6,0;;;;;;2,0;;8,0;;7,0;1,0;;49,0;;;;1,0;;;;;;;;;;2,0;;;1,0;;2,0;45,0;;;;;;;;;;6,0;;;;;14,0;;2,0;;4,0;;2,0;;;;;;;;;2,0;;;;8,0;;3,0;1,0;29,0;;;;;;;1,0;22,0;;;;;;;;;;;;5,0;;;2,0;;;;1,0;6,0;;;;;;;3,0;;;;1,0;;;;;;;;27,0;;3,0;;1,0;;;;;;4,0;2,0;;5,0;;;;;2,0;;;;;;3,0;4,0;;;;;;;;;;;;3,0;;;;;;;2,0;1,0;;;;;;2,0;;;;;;;7,0;;;;2,0;;;;;1,0;;;;;;;;;10,0;;;2,0;3,0;1,0;;;3,0;39,0;;;1,0;29,0;;;;;;;2,0;;;;;6,0;;;;2,0;;;;13,0;;;17,0;1,0;;4,0;;1,0;8,0;1,0;;;;;;;2,0;;;;;2,0;;;4,0;;;;;2,0;1,0;1,0;2,0;;;;;;;1,0;;;114,0;1,0;;;;;;1,0;;;1,0;;;1,0;;4,0;;;;;;;;;;6,0;;;;;;;;;;20,0;;;1,0;;2,0;6,0;;3,0;;;;;15,0;;3,0;;;;1,0;121,0;;4,0;;;;;;;3,0;;;1,0;;;;;;;;;1,0;;;;;;;3,0;15,0;1,0;3,0;;;;;;;;;;1,0;2,0;;;;;;;3,0;;;6,0;;2,0;1,0;;;;;;;2,0;;;1,0;;;4,0;;;;;;;;;;;;;;;2,0;;2,0;;;;;;;23,0;;2,0;;;;;1,0;7,0;;;;;;;;;;;1,0;;1,0;2,0;;;;1,0;;;;;;;;;;;;;;;;;;;;4,0;;;;1,0;;;;;;;;;3,0;;;;;2,0;;1,0;;;;;;;;;;;;;;;;;;2,0;1,0;5,0;;;;2,0;7,0;;;4,0;;;;;;1,0;;;;;;;;13,0;;;;;;;;2,0;;;2,0;;;;;;;21,0;;;;;;;;;;;;;15,0;;;;2,0;;5,0;;;;;1,0;4,0;;;;;;1,0;1,0;;;;;;;1,0;1,0;;;3,0;;;;;;;3,0;;;;;;;;;;;;;;7,0;;;;;;;;;;;;;;;;;9,0;;;;;;;;;;;;;;;;3,0;;;;;;;;;;;;;;;;1,0;;;;;;;;;;;;;;;;;;;;;;;3,0;;;;;;;;;;;;;;;;;;;3,0;;;;;;;;;;;;;;;;;;;;;;2,0;;;;;;;;;;;;;;;;;;;;;;;;;;;1,0;;;;;;1,0;;;;3,0;;;;;;;;;;;;;;;;;;;;;;;;2,0;;;;;;;1,0;;;;;;;;;;;;;;;;;;;;;;;;;;;;;;;;;
foot;;;;;;9,0;;16,0;;;;2,0;;30,0;;;10,0;;;4,0;;;;2,0;2,0;;;;1,0;;14,0;1,0;;;;24,0;;1,0;;;6,0;1,0;;1,0;;7,0;;;;;;;6,0;;1,0;;4,0;;;;;;;;36,0;;20,0;;;;4,0;2,0;1,0;;;;;;;;7,0;;;;7,0;;;;;;;;;;;;;;34,0;33,0;55,0;1,0;;;;3,0;;;;;;1,0;2,0;;4,0;;;;;6,0;;;;;;;8,0;;;1,0;6,0;;;2,0;;;;;;;;;;;;;;;4,0;1,0;;;2,0;8,0;;1,0;;;;;;;;;;;7,0;1,0;;1,0;;;;;;1,0;;;1,0;;;;;2,0;;;;;9,0;3,0;;;;;;;17,0;;1,0;;;;;;;;5,0;;2,0;30,0;;1,0;;;;2,0;;;;;;2,0;1,0;;6,0;;55,0;;1,0;;4,0;;1,0;;3,0;;;;2,0;;3,0;;;;;;;;3,0;2,0;4,0;;;;2,0;;66,0;4,0;1,0;;2,0;8,0;;;1,0;;;;3,0;;;;;6,0;;;;2,0;1,0;;;;1,0;6,0;;;;;2,0;;;;;;;;1,0;;3,0;11,0;;2,0;1,0;;4,0;;4,0;22,0;;2,0;;;;;;;;2,0;;4,0;;6,0;7,0;;;;;2,0;2,0;1,0;;;18,0;;4,0;;;;;;;;;;;8,0;1,0;10,0;;3,0;;;;;;;2,0;8,0;5,0;;;;;23,0;;;;;4,0;;;;;;;;;;;;;;;;;5,0;;;;;;;;1,0;;;;;8,0;;;9,0;6,0;7,0;;;;;4,0;;;;;;;;;;;;;;;;1,0;2,0;;;;;4,0;;1,0;;;;;2,0;3,0;;;;;;;1,0;;;21,0;;;;;6,0;;2,0;;;;;6,0;;;2,0;2,0;;;;;;;;;6,0;;;;;;1,0;;;;;;;;;;11,0;;;;;;;;;;;;3,0;;;;4,0;;;;;3,0;;3,0;;;;;;;;;;;1,0;;;3,0;;;;;;;1,0;;;;;1,0;2,0;;;;3,0;;;;;;;;4,0;;;;;;;4,0;;;;;;;;;;;;;;;;;;;;;1,0;;;;;;;;;;;;;;;;;;4,0;;;;;;;;;;;;;;;;7,0;;1,0;13,0;;;;;;;;;;;;;;7,0;;;;;;;;;;;;;;;;;;;;;;;;;;;;;;;;;;;;;;;;;14,0;;;;;;;2,0;;;;;;;;;;1,0;;;1,0;;;;1,0;;;;;;;;;;1,0;;;;;;8,0;;;;;;;;;;;;;;;1,0;;;;;;;;2,0;;;;;;;;;5,0;4,0;;;;;;;;3,0;;;;;;;;1,0;;;1,0;;;;;6,0;;;4,0;1,0;2,0;;;;;;;;;;;;;;;;;;;;;;;;;;;;;;;;;;;;;;;;;;;;;;;;;;;;;;;;;;;;;;;;;;;1,0;;;;;;;;;;;;;;;;;;;;;;;;;;;;;;;;;;;2,0;;;;;1,0;1,0;;;;;;;;;;;;;;;;;;;;;;;4,0;;;;1,0;;;;;;;;;;;;;;;;;2,0;;;;;;;;;;2,0;;;;;;;;;;;5,0;;;;4,0;;;;;;;;;;;;;;;;;;;;;;;;;;;;;;;;;;;;;;;;;;;;;;;1,0;;
graphic;;;;;;4,0;5,0;;;;;;;3,0;;;6,0;;;;;;3,0;2,0;;;;;12,0;2,0;21,0;4,0;;;;10,0;2,0;;;2,0;4,0;20,0;;;48,0;;;6,0;;;;;;;12,0;2,0;;;;21,0;;;;6,0;63,0;5,0;42,0;2,0;;;1,0;2,0;;;;3,0;;;;2,0;30,0;;3,0;5,0;;;;;;2,0;1,0;;;;;;4,0;;18,0;1,0;31,0;;;1,0;57,0;20,0;;;;;;;;;;;1,0;;4,0;1,0;;1,0;11,0;;;1,0;38,0;;;;4,0;;;90,0;;1,0;10,0;5,0;;;;;;;;4,0;2,0;2,0;;;;;;;2,0;;;;;;;;3,0;;;;3,0;;;37,0;;;;4,0;;;;;;;;16,0;;;;;;;;;;;;;;;;;;1,0;;;;;5,0;;;;;;;;;;;;6,0;4,0;1,0;;;;;;;;2,0;;;;;;1,0;1,0;;;1,0;5,0;;3,0;;;;;;5,0;;;;;;;;;;;;1,0;;;;;2,0;27,0;;;;;;2,0;;;;6,0;;;;;;;;7,0;;;;;;;1,0;;;2,0;;;;;6,0;3,0;;;;;;;;;;;;;;12,0;;;;;;;;;7,0;63,0;;1,0;1,0;;;;;;;;;;;;;;;;;;;;;;8,0;;;;;;;;1,0;;;;29,0;2,0;18,0;;;;;1,0;;;;;;;2,0;;4,0;;;;;;4,0;;;;;;;4,0;;;;6,0;16,0;4,0;;1,0;;14,0;38,0;1,0;;3,0;3,0;;;;;9,0;9,0;;;;;;;;;;;4,0;;4,0;;4,0;;15,0;;;;;;;;;;3,0;;21,0;;;3,0;1,0;;;;3,0;;10,0;14,0;;;;1,0;;;;;2,0;;1,0;8,0;2,0;;2,0;;;;;;;;2,0;3,0;4,0;;2,0;;;3,0;;;;;;;;6,0;;4,0;6,0;;;;;3,0;;11,0;;4,0;;2,0;;6,0;6,0;;;2,0;;;;;;;;;;;3,0;;;1,0;;;;;;;;;2,0;;;;2,0;1,0;;;;;8,0;;;;;82,0;12,0;1,0;;;6,0;;;;5,0;;2,0;;;;;;;;;1,0;;4,0;;;;;;;;;;;;;;;;;;1,0;;;2,0;5,0;1,0;;;;;;;1,0;;5,0;;;;;33,0;;;;;;;;;4,0;;;;;;;;;;;;;;;;;;;;;4,0;;7,0;;;;;;;;;;;;;;;;2,0;;1,0;;;;;;2,0;;;1,0;;;;;;;7,0;;;;;;;;1,0;2,0;;;;;;;;;;;;3,0;;;;;;;;;;;;;;;;;3,0;;;;;;8,0;;;;;;;;;;;2,0;;;;;;;;;;3,0;;;;;;20,0;;;4,0;;;;;;;;;;;;;;;;;;;;;;;;;;;2,0;;;;;;;;;;;;;;;;;1,0;;;;;;;;;;;;;;;;1,0;;;;;;;;;;;;;;;;;;;;;;;;;;;10,0;;2,0;;;;;;;;;;;;;;;;;;;;;;;;1,0;;;;;;;;;;;;;;;;;;;;4,0;;;;;;2,0;;;;;;;;;;;;;3,0;;;;;;;;;4,0;;;;;;;;;;;;;;;;;;;;3,0;;;;;;;;;;;;;;;;;;;;;1,0;;;;;;;4,0;;;;;;;;;;;;;;;;;;6,0;;;;;;4,0;2,0;;;;;;;;;;;;;;;;;;;;;;
half;;;;;;55,0;2,0;5,0;;;2,0;;;2,0;;1,0;3,0;2,0;;6,0;;;4,0;;5,0;;;1,0;;1,0;4,0;;;4,0;;4,0;1,0;13,0;2,0;;3,0;23,0;2,0;2,0;1,0;3,0;;3,0;;;;;8,0;8,0;10,0;2,0;6,0;;12,0;9,0;;;;;29,0;;26,0;;;;21,0;19,0;20,0;;;;6,0;;;7,0;5,0;;2,0;;6,0;;;7,0;3,0;;1,0;;2,0;;;;23,0;5,0;;4,0;25,0;6,0;;;;5,0;;;;;;6,0;3,0;;;;;;;1,0;;;16,0;13,0;6,0;;10,0;11,0;;6,0;2,0;1,0;;12,0;;;29,0;;1,0;;;1,0;;;4,0;;4,0;3,0;1,0;;;;;8,0;;;;;;;;3,0;;;;;;9,0;;;;;;12,0;;;;;;;;;;10,0;;;;;2,0;5,0;;;1,0;;2,0;;7,0;;4,0;;;2,0;11,0;;4,0;;;;14,0;12,0;;;4,0;;;4,0;;;;2,0;;11,0;;2,0;8,0;;4,0;;;;;;8,0;1,0;1,0;;4,0;1,0;;4,0;;;;;;;;12,0;10,0;;;;;2,0;2,0;5,0;6,0;4,0;;;2,0;;;1,0;;;;7,0;;1,0;;;5,0;;;;;26,0;5,0;;1,0;;1,0;;1,0;;;1,0;3,0;3,0;;;;;2,0;;2,0;;;;;;4,0;;;;;;5,0;4,0;;;8,0;;4,0;;10,0;;;;;6,0;1,0;2,0;;;;2,0;3,0;;1,0;;;4,0;2,0;2,0;;;;;;;;4,0;;;1,0;29,0;;;;;;;1,0;2,0;1,0;5,0;6,0;;1,0;5,0;;;;;;1,0;;1,0;1,0;;;1,0;;;;;;2,0;1,0;;6,0;1,0;5,0;;;;;;;;;2,0;;;;;;;5,0;;;;;1,0;;;2,0;1,0;;;;;;;;5,0;;;;3,0;;;;4,0;;;;;;;;;;;1,0;;;;8,0;;;;;;;;;;;;;;;8,0;;1,0;;;;2,0;;;2,0;;;;;;;;;;;;;;;;4,0;;;;;;;;;;;;;;1,0;;;;;;;;;;1,0;8,0;;;;;2,0;1,0;;;;;;;;;1,0;1,0;;;;;;;;;4,0;;;1,0;;;;2,0;2,0;;;;;3,0;;;;;;;;;;;;;;;;;;;;;;;8,0;1,0;;;;;;2,0;1,0;3,0;;;;1,0;;;;2,0;;5,0;3,0;;;;;;;1,0;;;;;;;;;;;;;;;;;4,0;2,0;1,0;;;;;;;;;;1,0;;;;;;;;;;;;;;;;;;;;;;;;;;1,0;12,0;;;;1,0;;;;;;;;;;;1,0;;;;;;12,0;;;;;;;;;;;;;11,0;;;;;;;;;;;;;;;;;;;3,0;4,0;;;;;;;;;;;;;;;;14,0;;;;;;;1,0;;;;;;;;2,0;;2,0;;7,0;;;;;5,0;;;;;;;;;1,0;;;;;;;;;;;;;;;;;;4,0;1,0;;;;;;1,0;2,0;;1,0;;;;;;;26,0;;;;;;;;;;;;;;;;;;;;;;;;;1,0;;;6,0;2,0;;;;;;;;;;;;;;;4,0;;;;;;;;;;;;;;;;;;;;;10,0;;;;;;;;;6,0;;;;;;;;;;;;2,0;;;;;;1,0;;3,0;;;;;;;;;;;;;;;;;;;;;;;;;;;;;;;;;;;;;;1,0;;;;;;;;;5,0;1,0;;;;;;;;;;;;;3,0;;;;;;;;;;;;;;;;;;2,0;;;;;;;;;;;;;;;;;;;;1,0;;4,0;;;;;;;;;;;;;;;;14,0;
hand;;;;;;25,0;;20,0;;;;;2,0;36,0;;;55,0;;;;;;3,0;;;2,0;;12,0;4,0;9,0;27,0;1,0;2,0;;1,0;50,0;7,0;;2,0;1,0;52,0;36,0;;;8,0;2,0;;19,0;;;;;1,0;2,0;1,0;;8,0;;;1,0;;;5,0;;164,0;;24,0;;7,0;;3,0;8,0;1,0;;;;;1,0;;2,0;34,0;;;;2,0;2,0;;1,0;;;;;;;1,0;;2,0;3,0;66,0;1,0;11,0;2,0;;2,0;5,0;11,0;2,0;6,0;;;;3,0;2,0;3,0;;20,0;3,0;;1,0;6,0;5,0;2,0;3,0;;;16,0;31,0;;;;5,0;;;19,0;;;4,0;11,0;;2,0;;1,0;;;;1,0;6,0;4,0;29,0;6,0;;3,0;12,0;1,0;;;;;;;;6,0;;;;;17,0;2,0;;9,0;;;;4,0;;;;;5,0;;;;;3,0;3,0;;;;7,0;;;;;3,0;1,0;;4,0;;;;;;;;1,0;;8,0;;;24,0;1,0;10,0;;;;4,0;;;;;1,0;;25,0;;;;28,0;;;5,0;;;;;;13,0;;;;;;;3,0;1,0;1,0;2,0;;9,0;47,0;;;;;1,0;;;11,0;22,0;;;;;4,0;3,0;;3,0;;;;12,0;;;;2,0;;;5,0;14,0;;;;;5,0;;;;4,0;4,0;;;;;;1,0;4,0;1,0;2,0;3,0;1,0;5,0;;;;;;;10,0;2,0;2,0;;;;;;16,0;;1,0;1,0;;;;43,0;;;;;;5,0;;;;1,0;;;40,0;;1,0;;;;4,0;1,0;1,0;1,0;;4,0;16,0;1,0;;;;12,0;;;23,0;1,0;;;4,0;;;2,0;;10,0;;1,0;;1,0;;1,0;;;1,0;14,0;2,0;;;1,0;2,0;;9,0;2,0;;;3,0;70,0;;;;1,0;;11,0;33,0;;1,0;5,0;;60,0;1,0;6,0;;6,0;3,0;2,0;;17,0;;5,0;73,0;;;1,0;1,0;2,0;4,0;1,0;;;3,0;;;;3,0;12,0;1,0;1,0;;12,0;3,0;2,0;5,0;;;1,0;;1,0;;;1,0;1,0;;5,0;;8,0;;2,0;;;150,0;;;1,0;2,0;3,0;;1,0;;;;;4,0;;;;;;;;;;1,0;;4,0;;;;;;;4,0;;;;19,0;;;3,0;3,0;1,0;66,0;;;3,0;;;;;;2,0;1,0;;;;;;;;6,0;;;;;1,0;;;;;6,0;;;4,0;6,0;;2,0;;;;;;;2,0;40,0;36,0;;;;;;;3,0;;;;11,0;;4,0;;;;;;1,0;1,0;;1,0;;;;2,0;;;;;;;2,0;;;1,0;;;;;;;1,0;;13,0;;;;;;1,0;;;3,0;5,0;16,0;1,0;;2,0;;;;;;6,0;6,0;1,0;;;1,0;128,0;;;49,0;1,0;;;;;25,0;2,0;1,0;;7,0;9,0;1,0;5,0;;;;2,0;;;;;;;;;;;;;;;;;3,0;;9,0;2,0;;;;;;;;;;;;1,0;1,0;1,0;;;;;;;;;;;;;;;;;;;;;8,0;6,0;;1,0;;;;27,0;;;1,0;;;4,0;4,0;;;3,0;;2,0;;6,0;;2,0;;8,0;;1,0;10,0;;;;;4,0;6,0;;25,0;;;;;;;10,0;;;;;4,0;;;;;;;3,0;19,0;;;;;;;;1,0;;;;;;5,0;1,0;;;3,0;;;;;;;3,0;;;;;;;;;;;;2,0;;;1,0;;;1,0;;;;;;6,0;;;;1,0;;;;;1,0;;;;;;;;;;;;2,0;;;;;;;;;;;2,0;;8,0;;2,0;;10,0;;;;;;2,0;;;;;;;;;;;;;;2,0;;;;1,0;;;1,0;;1,0;2,0;;;;;;;2,0;;;;;1,0;;;;1,0;;;;;;;;;;;;;1,0;;;;;;;;;;;;;;;;1,0;;1,0;;;;;;;;;3,0;2,0;;;;;;;2,0;;;;;;;;;2,0;;;;;;;;;;5,0;1,0;;;;;;;;;;;;;;;;;;;;;;;;;;;;;;;;;;;;;;;;;;;;;3,0;;;;;;;;;;;;;;;;;;;
handheld;;;;;;15,0;;1,0;3,0;;;;;6,0;;;53,0;2,0;;;4,0;;2,0;5,0;19,0;;;10,0;50,0;3,0;34,0;23,0;;4,0;;79,0;;;5,0;2,0;9,0;491,0;;50,0;64,0;3,0;;1,0;;;;;;;1,0;;;;;7,0;;;1,0;;83,0;;39,0;;21,0;;;13,0;;;;;;;1,0;3,0;75,0;;10,0;;4,0;;;9,0;1,0;;6,0;;;34,0;;;;;28,0;2,0;14,0;1,0;;1,0;32,0;19,0;2,0;4,0;;;;;2,0;;1,0;;2,0;;13,0;16,0;1,0;;20,0;2,0;;2,0;51,0;;7,0;;7,0;;2,0;31,0;;;12,0;21,0;;;;;1,0;;;1,0;12,0;1,0;8,0;3,0;;;4,0;;;1,0;;;;;;5,0;3,0;2,0;;;9,0;;;2,0;;1,0;2,0;;;;;;;;;;;1,0;;;1,0;;3,0;2,0;;1,0;;1,0;;;11,0;;;;;;;;2,0;;4,0;;1,0;38,0;5,0;22,0;;;;;7,0;;;4,0;;;3,0;;;;1,0;;;;;;1,0;;;;;;1,0;3,0;;;1,0;;;7,0;10,0;;3,0;;;;;2,0;;1,0;4,0;7,0;;;;24,0;;6,0;1,0;;;;;2,0;;;;;16,0;;4,0;4,0;;;2,0;;;;;;1,0;1,0;;;;5,0;;;;;;;;1,0;;;;;2,0;;8,0;;;52,0;;;;;;;4,0;5,0;;;57,0;;;;;;;;3,0;2,0;1,0;1,0;;;11,0;;;;1,0;1,0;1,0;;;;;5,0;;1,0;;;1,0;;;;22,0;2,0;;;10,0;22,0;;;;;;;;;;;;;;;;;;17,0;;;30,0;;;9,0;;9,0;;;;;;5,0;;4,0;3,0;2,0;;2,0;8,0;2,0;;22,0;4,0;3,0;;22,0;10,0;;49,0;;;1,0;;8,0;5,0;1,0;;;;;;;;;;55,0;17,0;16,0;2,0;;12,0;;7,0;;;;;;7,0;4,0;;16,0;;1,0;1,0;;;;11,0;;;;1,0;;;2,0;;;1,0;;21,0;1,0;;;;7,0;;1,0;3,0;;3,0;2,0;10,0;14,0;;1,0;;4,0;2,0;;;;3,0;1,0;;;3,0;2,0;59,0;;;;;;;1,0;9,0;2,0;;3,0;;6,0;;9,0;;;;;;;19,0;;2,0;;;;;;;;4,0;;1,0;;;;5,0;;;;;;2,0;;;;;;;;;;;5,0;;;;;;3,0;;;;3,0;2,0;6,0;;;;;;;;;2,0;;6,0;;4,0;5,0;;;;;;;;;;;;;;;1,0;;;;5,0;1,0;;1,0;;;1,0;;;1,0;7,0;;;3,0;1,0;9,0;;;1,0;;;;;;;;;1,0;;;;;8,0;;;1,0;;;;;;4,0;;;;5,0;;;;;;;3,0;;1,0;2,0;;;;;;;;4,0;4,0;;;;1,0;;;;;10,0;;;2,0;;;;;;4,0;;;5,0;;;3,0;1,0;;;;;20,0;2,0;7,0;1,0;1,0;;;4,0;;;;;;2,0;;;;;1,0;;;;;;1,0;;;1,0;;;;1,0;4,0;;;;;3,0;2,0;;;;3,0;;1,0;2,0;;;;;2,0;9,0;4,0;;;;;;;6,0;;;;4,0;;;;;;;13,0;;;;3,0;;;1,0;;;;;;;;;;;;1,0;;;;;;1,0;;;;1,0;;;;;;;;;;;;;;;1,0;;;;;;;;;;;;;;;;;;;;;;;;;;;;;;;;;;;;;;1,0;;;;;;;;;;;;;;;;;;;;1,0;;;;2,0;;;;;;;;;1,0;;;;3,0;1,0;2,0;;;;1,0;;;;;;1,0;;;;;;;;1,0;;;;7,0;;;4,0;1,0;;;;;1,0;;;;;;;;;2,0;;;;;;;;;3,0;;;;;;;;;;;;;;;;2,0;;;;;;;;;;;;;;;;2,0;;;;;;;;;;;;;;;;;;;;;;;;;;;1,0;;;6,0;;;2,0;;;;2,0;;;;;;;;
icon;;;;;;3,0;;;1,0;2,0;;;;16,0;;;22,0;;;;;;3,0;;;;;3,0;2,0;;25,0;2,0;;;;7,0;;;;;15,0;33,0;;1,0;130,0;;;3,0;;;;;;;;;1,0;;;13,0;;;;;39,0;;26,0;;4,0;;;;;;;;;;;;18,0;;72,0;2,0;;;;;;;;;;;54,0;;;;9,0;2,0;22,0;1,0;;;5,0;2,0;;1,0;;;;;7,0;;;6,0;;3,0;;;;;1,0;;;;3,0;;;;26,0;;;5,0;;;2,0;;;;;1,0;;;;2,0;9,0;;15,0;;;;;;;;;;;;;;2,0;;;;;;;;;;;;;;;;;;;;;;;;;;2,0;;;;;;;;;;;;;;;;;;;;;;1,0;;;;;;;;;;;;;;;;2,0;;;;;;1,0;;;;;;;10,0;;;;;;14,0;;4,0;9,0;;;;;;;;;;1,0;;;;;;;;;;;;;;;;;;;;;;;;;;;;;7,0;;;;12,0;;;;;5,0;;;;;;;;;;;;;4,0;;;;;;;;;;;5,0;2,0;3,0;;1,0;;;;;;;;;;6,0;;1,0;;;;;;;;;1,0;;;;;;;;;1,0;;;;5,0;;;;;2,0;30,0;2,0;;;;1,0;;;;;;5,0;;3,0;;;12,0;4,0;;;;30,0;;;;;;;2,0;3,0;;6,0;;;8,0;4,0;;40,0;;3,0;;22,0;;;;;;;;;7,0;;;;;;;;;;1,0;9,0;;6,0;;;;;7,0;;1,0;;;;;;;7,0;4,0;;;2,0;;;17,0;;;;3,0;;;;;;;1,0;7,0;;;3,0;;2,0;;;;;9,0;4,0;3,0;5,0;;;;;;;;4,0;;;3,0;1,0;2,0;;4,0;;;;;;1,0;;20,0;;1,0;;;2,0;8,0;55,0;;;;;;;;;3,0;;;;;;;;;;;;;;;;;;;4,0;;;;;;;1,0;;;;;;9,0;;;;;3,0;;;;;;8,0;;;;;;5,0;;;2,0;;;;;;;;;;;;;;;;;;;;;;;;;1,0;;;1,0;;;;;;;;;;;1,0;;;;;;;;;4,0;;7,0;;;;;;;;;;;;;;;1,0;;;;;;;;;;;;;;;;;;;;;;;;;;2,0;;;;;;1,0;;;35,0;;;;;;;;;;;;;;;;11,0;;;;;5,0;;;;;;;;;;;3,0;;;;;;;;;;6,0;;;;;;;;;;;;;;4,0;;;;2,0;;;;;;;;;2,0;4,0;;;;;;3,0;;;;;;;;;;;;;;;;;;;;;;;;;;;;;;6,0;;;;;;;;;;;;;;;;;;;;;;;;;;;;;;;;;;;;;;;;;;;;;;;;;;;;2,0;;;;;;;;;;;;;;;;;;;;;;;;;;;;;;;;;;;2,0;;;;;;;;;;2,0;;;;;;;;;2,0;;;;;;;;;;;;;;;;;;;;;;1,0;1,0;;;;;5,0;;;;;;;3,0;;;;;;;;;;;;;3,0;;;;;;;;;;;;;;;;;;;;;;;;;;;;;;1,0;;;;;;;;;;;;;;;;;;;;;;;;;;;;;;;;;;;;;;;;;;;;;
inertial;;;;;;8,0;;2,0;;;;;;12,0;;;2,0;;;;;;;;;;;2,0;1,0;;19,0;1,0;1,0;;;36,0;;;;;14,0;29,0;;3,0;15,0;;;5,0;;;10,0;;1,0;;1,0;;;;;6,0;;;1,0;2,0;25,0;6,0;28,0;;;;;8,0;;;;;;165,0;;;26,0;;2,0;1,0;8,0;;;11,0;;;;;;;;;2,0;;1,0;1,0;9,0;;;2,0;;12,0;3,0;;;;;1,0;;;;;;;;85,0;;;23,0;;;2,0;49,0;;;;17,0;;;144,0;2,0;;1,0;;;;;;;;;9,0;;;2,0;18,0;1,0;;6,0;;;;;;;;;3,0;;;;;4,0;;;;;;;1,0;;;;;;;;;;;;;3,0;8,0;4,0;;;;;;;;;;;;;;;;16,0;;2,0;;;18,0;;9,0;3,0;;;;5,0;3,0;;;;4,0;;;;;4,0;;;5,0;;;1,0;1,0;;;;;;;;;;;;4,0;;;2,0;;;;;2,0;;;;1,0;;;;4,0;;;;;;;;2,0;;;41,0;6,0;;;;9,0;;;;;13,0;;;6,0;;;4,0;;;3,0;;;;;;2,0;;;;;5,0;;3,0;;;2,0;;;;;;;;;1,0;;;;7,0;6,0;2,0;;;;;;5,0;5,0;;;;;3,0;;;;;;;;1,0;;;;;1,0;;;;;;;5,0;;;;3,0;;;6,0;6,0;;;;;1,0;;;;;6,0;;2,0;;1,0;;2,0;;10,0;1,0;5,0;4,0;;14,0;;;;;2,0;;2,0;;;1,0;5,0;;1,0;;;1,0;1,0;;;2,0;;;12,0;;26,0;;;1,0;2,0;14,0;;;;1,0;;1,0;;;;23,0;3,0;5,0;1,0;3,0;2,0;;;;1,0;2,0;4,0;;;;1,0;;;;;2,0;;;3,0;2,0;;11,0;;;;;1,0;6,0;;;3,0;1,0;;1,0;;;5,0;;;;;;;;;;;;;;;;;;;;;1,0;;8,0;;;;;;;2,0;;;4,0;;;;;;;;;;;;;;;4,0;;;;;;;;;;;;;;;;;;;;;;1,0;;;;1,0;;;;;;;;;;;;;;;;;;;;;;;;;;13,0;;;;;;;;;4,0;;;;1,0;;;;;;;;;;;;;;;;;;;6,0;;;;;3,0;;;;;;;;;;;;;;;;;;;;;;;;;;;;;;;;;;;;;1,0;;;4,0;;;;;;;;;;;;;;;;;;2,0;;;;;;;;;2,0;;;;;1,0;;;;;;;;;;;;;1,0;;;;;;;2,0;;;;;;;;;7,0;;;;;;;;;;;;;;;;;;;;;;;;;;;;;1,0;3,0;;;;1,0;;;;;;;;;;;;;;;;;;;;;;;;;;;;;;;;;;;;;;;;;;;;;;;3,0;;;;;;;;;;;;;;;;;;1,0;;;;;1,0;1,0;;;;;;;;;;;;4,0;;;;;;;;;;;;;;;;;;;;;;;;;;;2,0;;;;;;1,0;;;;;;;;;;;;;;;;;;;;;;;;1,0;;1,0;;;;;;;;;;;;;;;;;;;;;9,0;;;;;;;;;;;;;;;;;;;;;;;;9,0;1,0;;;;;2,0;;;;;;3,0;;;;;;2,0;;;;;;;;;2,0;;;;;;1,0;;;;;;;;;;;;;;;;;;;;;;;;;24,0;;;;;;;;;;;;;;;;
interpolation;;;;;;6,0;5,0;;;;;;;20,0;2,0;;;;11,0;;;;46,0;;;;;3,0;;;10,0;;2,0;7,0;;29,0;4,0;;2,0;1,0;13,0;8,0;;2,0;;;;;3,0;;;;;;;;;;;10,0;;2,0;;;70,0;;13,0;;;;;;4,0;;1,0;;;;;2,0;22,0;;;4,0;1,0;;;1,0;;4,0;11,0;;;;1,0;;47,0;4,0;;37,0;8,0;1,0;;3,0;22,0;1,0;;;;;;11,0;;1,0;;;;;3,0;3,0;;;6,0;1,0;3,0;6,0;10,0;;;;6,0;;;5,0;;;2,0;;1,0;;;4,0;1,0;;;8,0;;;;;;;4,0;;;;;;;;;;;5,0;;;1,0;;;;;;;1,0;;1,0;3,0;;;;;;;1,0;;1,0;7,0;;4,0;;1,0;;;;;;;;;;;;;;;;;;;;;;4,0;;;;2,0;;;3,0;2,0;;;;;;;;;;;;;7,0;;;;;;2,0;;;;;;7,0;;;;;;;;;;1,0;;;;;;1,0;;15,0;;;;;;2,0;;;;1,0;;;;2,0;;;;1,0;;;;;;;5,0;;;1,0;;;;;;;;;;;;;;;1,0;;;;;;;;;;;;;;;5,0;;;;;;;;;;;;;;;;;;;;;;;;;2,0;2,0;;;;;;;1,0;;;;6,0;;;;;;;;;;;;;;12,0;;;;;;;;2,0;21,0;;;;4,0;;;;;;11,0;;;;;;;;;1,0;7,0;;;27,0;7,0;1,0;;;;;;;;6,0;;;;1,0;;;;;;;2,0;;;;;;;6,0;;;2,0;;4,0;;;1,0;;;;5,0;;;;3,0;;;;;;3,0;;1,0;;;;5,0;;;;;;;;;;;;;;;;;;;;;1,0;;;;;31,0;;;19,0;;;;;;;;;;;;;;;;;;;;;;;;;;1,0;;;;;;;;;;;;;;;;;;;;;;2,0;;5,0;;;;;;;;;;;;;1,0;;;;;;;;;2,0;;;;;;;;;;;;;;;;;;;;;;;1,0;;;;;;;;;;;;;;3,0;;;;;10,0;;;;;;;;;;;;;;;;;;;1,0;;;10,0;;;;;;;;;;;;;;;;;;;;;;;;;;;;;;;;;;6,0;;;1,0;;;;;;;;10,0;;;;;11,0;;2,0;12,0;;;;;;;;1,0;;;;;;;;;;;4,0;;;;;;;;;;;;7,0;;;;;;;;;;;;;;;;;;;;;;;;;;;;;;;;;;;;;;;;;;;;;;;;;;;;;;;;;;;;;;;;;;;;;;;;;;;;;;;;;;;;;;;6,0;;;;;;;;;;;3,0;;;;;;;;;;;;;;5,0;;;;;;8,0;;;2,0;;2,0;;;;4,0;;;;5,0;;;;;;;;;;4,0;1,0;;2,0;;;;;;;;;;;;;12,0;;;;;;;;;;;1,0;6,0;;;;;;;;;;;;;;;;;;;;;;;;;;;;;;;;;;;;;;;;;;;;;;;7,0;;;;;;;;;;;;;;;;;;;;;;;;;;;;;;2,0;;;;;;;;;;;;;;;;;;;;;;3,0;;;;;;;4,0;;;;;;;;;;;;;;;
judge;;;;;;4,0;;;;;;;;10,0;;10,0;;;;;;;3,0;;;;;;1,0;1,0;16,0;;;;;75,0;;2,0;;;7,0;1,0;;;;;;;;;8,0;;;;8,0;;;;1,0;;;;;;8,0;;1,0;;;;;13,0;;;2,0;;;;;5,0;6,0;;;;84,0;;;;;;;;;;;;3,0;;;15,0;7,0;1,0;;;;10,0;;;;;;;;;;;;;2,0;;;;14,0;1,0;;9,0;;;;;6,0;;;3,0;;;;;;;;;;;2,0;;5,0;;;;;2,0;1,0;;;;;;;;;;;;;;;1,0;;;;;;;;;;;;;;;;;;;;;3,0;;;;;;;;;;;;;;;;;5,0;;;;;;2,0;;;;;;;;;;6,0;;;;;;;;;;;;;;;;;;;;;;;;;;;;;;;;;;;;;;;;;;1,0;;;;;;;;;;;;;;;;;;;;;;;;;20,0;;;;;;;;4,0;;;;;;;;;;;;;;;;;;;;;;;;;2,0;;;;;;;;;;;;;;;;;;;1,0;;;;;;;1,0;;;;;;;;;;2,0;2,0;;;;;;;;;;;;;;1,0;;4,0;;1,0;;;;4,0;;;;;;;2,0;;;;;2,0;8,0;;;;;;;;;;18,0;;;;;2,0;;;;;;;;;;;;;;;;;;;;;;2,0;;;;;;7,0;;;;;1,0;2,0;;;;;;1,0;;;;;;;;;;;1,0;;;;;;;;;;;;;;;;;;;;;;;;;;;18,0;;1,0;;1,0;;;;;;1,0;;;;;;;;;;6,0;;;;;3,0;;;;;;;;;;;;;;;;;;;;;;;;;;;;2,0;;;;;;;;;;;;;;;;;;;;;;;;;1,0;;;;1,0;1,0;;;;;;;;;;;;;;;;;;;;;;;;;;;;;2,0;1,0;;;;12,0;;;;;;;;;;;;;;;;;;;;;;;;;;;;;;;;;;;;;;;;;;;;;;;;;;;2,0;;;;1,0;;;;;;2,0;;;;;;;;;;;4,0;;;13,0;1,0;;;;;;;;;;;;;;;;;;;;;;;;1,0;;;;;;;;;;;;;;;4,0;;;;;;;;;;;;;;;;;;;;;;;;;;;;;;;;;;;;;;;;;;;;;;;;;;;;11,0;;;;;;;;;;;;;;;;;2,0;;;;;;;;;;;;;;;;4,0;;;;;;;;;;;;;;;;2,0;;1,0;;;;;;;;;;;;;;;;;;24,0;;;;;;;;;;;;27,0;;;;;;;;;;;;;;;;;;;;;1,0;;;;;;;;;;;;;;;;;;;;;;;;;;;;;;;2,0;;;;;;;;;;;;;;;;;;;;;;;;;;;;;;;;;;;;;;;;;;;;;;;;;;;;;;;;;;;;;;;;;;;;;;;;;;;;;;;;;;;;;;;;;;;;;;;;2,0
landmark;;;;;;1,0;;;;;;;;55,0;;;12,0;;;;;;;;2,0;;;2,0;2,0;;1,0;;2,0;;;9,0;;;;;22,0;11,0;;;6,0;;;;;;2,0;;;;;;;;;;;;;;100,0;;46,0;;;;;;;;;;;;;;22,0;;;2,0;;;;;;;;;;;;;;4,0;52,0;23,0;35,0;;;;44,0;2,0;;11,0;;;;;;;;;;71,0;;;;;;;;51,0;22,0;;;;;;;19,0;;;1,0;;;;;;;;;3,0;;;1,0;;;;;;;;;;;;;2,0;;;;2,0;;;;2,0;16,0;;2,0;;;2,0;;;;;;;;7,0;;;;;2,0;;;;;;;;;;;;;;;;;36,0;;;;1,0;;;;;;;;;;1,0;5,0;;;;;;;;;;;;10,0;;;30,0;2,0;;;3,0;;;;;;38,0;;;;;;;;6,0;;;;;;;;20,0;;32,0;;;;;;;;;;;;;;2,0;;;;;;;;;;;;;;;;;;;7,0;;;;;;;;;;;;;;;;;;;;4,0;;;;;8,0;;;;;;;;;;;;;;;;;;;;;;;;;;;;;;;;;;;;;;2,0;;;;;;;;;;;;;2,0;;2,0;;;;1,0;;1,0;15,0;;;;11,0;1,0;1,0;;;;8,0;;;2,0;;;10,0;;;;;;;;1,0;;;;;;;;;3,0;;;;;1,0;;;;;2,0;4,0;;;;;;;;;;;44,0;7,0;;;;;;;4,0;4,0;;2,0;;;;;;;;;;;;;2,0;;;;;;8,0;;;;;15,0;2,0;;;;;;;9,0;;1,0;;;;;1,0;;;9,0;;;;;1,0;;;;;;;;;;;;;;;;;5,0;;;;;;;;;;;;;;;;;;;;;;;;;;;;1,0;;;;;;;;;;;;;55,0;;2,0;16,0;;;;;3,0;;;;;;3,0;;;3,0;;;;;;;;2,0;;;;;;;;;;;;;;;;;;;;;12,0;;34,0;;2,0;;;;;;;;;;;;;;2,0;;;;;;;;;;;;;;;;;2,0;;;;;;;;;;;;;;;;;;;1,0;;;;4,0;;;;;;5,0;;;;;;;;;;;;;3,0;;;;;;;;;;;;;;;;;;;;;;;;;;;;;;;;;;;;;;;;;;;;;5,0;;;;;;;;;;;;;;16,0;;;;;;2,0;;;;;;;;;;;;;;;;;;;;;;;;;;;;6,0;;;;;;;;;;;;;;;;;;;;;;;;;;;;;;;;;;;;;;;;;;;;;;;;;;2,0;;;;;;;;;;;;;;4,0;;;;;;;;;;;;;;;;;;;;;;;;;;;;;;;;;;;;;;;7,0;;;;;;;2,0;;;;;;;;;;;;;;;1,0;;;;;;;;;;;;;;;;;;;;;;;;;;;;;;;;2,0;;;;;;;;;;;;;;;;;;;;;;;;;8,0;;;;;;;;;;;;;;;;;;;;;;;;;;;;;;;;;;;;;;;;;;;;;;;;;
latch;;;;;;23,0;;4,0;;;;;;12,0;;;;;7,0;;;;;;;;;115,0;;;108,0;;;;;10,0;7,0;;;;2,0;25,0;;7,0;1,0;9,0;;12,0;;;;;7,0;7,0;;;4,0;;2,0;7,0;;;;;4,0;;47,0;;;;;3,0;;;;;5,0;;;;1,0;;6,0;;;;;3,0;;;;;;;;;1,0;;30,0;13,0;60,0;;;;1,0;;;;;;;;;;1,0;;;3,0;;9,0;;;32,0;;;6,0;6,0;;;;3,0;;;72,0;;;3,0;;;;5,0;1,0;;;;;;4,0;;2,0;;;33,0;5,0;;;;;;;;8,0;;;6,0;;45,0;;;;5,0;;2,0;;;2,0;;;4,0;;;;2,0;2,0;;;;;45,0;2,0;;;;2,0;7,0;12,0;83,0;;8,0;2,0;;;;2,0;;;24,0;4,0;;29,0;;;;;;12,0;40,0;;;;;;;;13,0;;140,0;;11,0;;1,0;;;2,0;;;;;1,0;;;1,0;;;1,0;;2,0;2,0;21,0;51,0;5,0;;;5,0;5,0;4,0;;26,0;4,0;;2,0;;;6,0;28,0;;;;;;;;;7,0;20,0;;6,0;1,0;;;4,0;;;;;;;2,0;21,0;;;43,0;;;;3,0;5,0;5,0;3,0;12,0;1,0;3,0;2,0;1,0;13,0;;;1,0;;15,0;;6,0;3,0;;1,0;16,0;11,0;23,0;;139,0;;;;;;;4,0;;2,0;;2,0;;7,0;4,0;;;19,0;;;;;4,0;;1,0;5,0;26,0;46,0;;14,0;;;;;1,0;;;9,0;;;;;;;;;;;1,0;;;;;;4,0;;;;;;11,0;9,0;;1,0;;;14,0;;;;;;1,0;;1,0;;;;;;;;7,0;;;;;;;;;4,0;2,0;;1,0;5,0;;;;;;;;;2,0;;30,0;;7,0;;;;;1,0;;;;;;3,0;1,0;;3,0;;;;;;;;;;2,0;;;;;;;2,0;;;;39,0;2,0;;;;;1,0;;;;;2,0;;;;;3,0;;;1,0;;4,0;2,0;;1,0;;;;;;;8,0;;;;;;;;;1,0;;;1,0;;;;;;;15,0;;;;;44,0;;;6,0;;1,0;;;;1,0;;;;;;;3,0;;;;;;;;3,0;;34,0;;;;14,0;;;;9,0;;;;;;3,0;;;;1,0;;;;;;;;;;5,0;;9,0;;;;;;;;;2,0;;1,0;;4,0;;14,0;2,0;;;1,0;;;;;;;2,0;;;;32,0;;;;;;2,0;1,0;;;1,0;;2,0;;;;;;;;;;;;;;;1,0;;;;;;;1,0;;1,0;1,0;;;;;;;1,0;;;11,0;;4,0;;;;;;4,0;;;;;;;;;;;;;;;;;;;;;;;;;;;2,0;;;16,0;2,0;;;7,0;;2,0;2,0;;;2,0;;;;;;2,0;;6,0;;;;;;;;;;;;;;;6,0;;6,0;;;2,0;;;;;;;;1,0;;;;7,0;;;;;;;;;;;;;;2,0;1,0;4,0;;2,0;;3,0;;;4,0;;;23,0;;;;;;;2,0;;2,0;;;;;11,0;;;;;4,0;;;;2,0;;;;;;;19,0;;;27,0;;;;;;;13,0;;;;;;2,0;;;;;;;;;;2,0;;;2,0;;;;3,0;;;;4,0;;;;;2,0;;;;;;;;;;;;;;;;;2,0;;;;;;;;;;;;;;3,0;;;;;;;;;;;;;;;;;;;;;;;;;;;;;;;;;;;;;;;;;;;;;;;;;;;;;;;;;;;;;;;;1,0;2,0;;;;;;;;;;;;;;;;;;;;;;;;;;;;;;;;;;;;;;;;6,0;;;;;;;;;;;;;;;;;;;5,0;;;;;;;;
lead;;;;;;3,0;;5,0;;;;1,0;3,0;1,0;;;;;1,0;;1,0;;;;5,0;;;3,0;;;9,0;;;;;;1,0;;;1,0;;35,0;;;1,0;13,0;;4,0;;;;;14,0;3,0;10,0;;6,0;;;;4,0;;;;34,0;;20,0;;;;2,0;14,0;4,0;;;;;;;;4,0;;;;8,0;;;2,0;;3,0;;;2,0;;;;;;29,0;;1,0;1,0;;;;7,0;;;;;;;;;;;;12,0;;35,0;;;;2,0;;;6,0;;;;;;;2,0;;3,0;10,0;;;;;;;;1,0;2,0;3,0;;1,0;5,0;7,0;2,0;7,0;2,0;;1,0;;3,0;;1,0;22,0;14,0;;;;;2,0;1,0;;;1,0;;2,0;15,0;;5,0;;1,0;;;;;;1,0;;;;5,0;10,0;;;;;;;;14,0;4,0;;;6,0;1,0;;;;;1,0;;;;10,0;;1,0;;;;;2,0;;;;;;;;;5,0;;1,0;;;;1,0;;;;;;;;;;1,0;;;;;;12,0;;;;;1,0;7,0;1,0;6,0;5,0;;;;1,0;;9,0;;;;;;;;13,0;;;5,0;;1,0;;;2,0;;;31,0;;;;;;6,0;;1,0;1,0;;;;;1,0;4,0;1,0;7,0;;2,0;8,0;;;;;4,0;;;;;;;;;;;;;;2,0;;;;;;;2,0;8,0;;;;1,0;;;;;;;15,0;35,0;;141,0;;;;;;5,0;;;;;;;;3,0;;;;;;;;;;;;;;;;1,0;6,0;;;;;;3,0;;;;;1,0;;1,0;;;;;;;;;;;;;;;3,0;;;;;3,0;;7,0;;2,0;;;;;;;;;;;;;;1,0;;;;;;;;;;;;;;;;;;;;;;;3,0;;;1,0;1,0;;;1,0;;;;;;;;;;;;;;3,0;;;;;1,0;;;;2,0;;;;1,0;;;;;;;;;;;;;;;;;;;;;;;6,0;1,0;;;;;;;;;;;;;;15,0;1,0;;;;;;;;;;;;;2,0;;;;;3,0;;;;;;;;;;;;;;;;;;;;;;;;;;;;;;;;;;;;;;;;;;;3,0;1,0;;2,0;;;;;;;;;;;;;;;;;;;;;;;;;;;;;;;;;;;;;1,0;;;;;;;;;;;;;;;;;;;1,0;;;;;;;;;;;;;;;;;;;;;;;1,0;;;;;;1,0;;1,0;;;;;;;;;;;;;;;;;;;1,0;;;;13,0;;;;;;;;30,0;2,0;;;;;;;;;;1,0;;;;;2,0;;;;;;;;2,0;;;;;;;;;;1,0;;2,0;;;;22,0;;;;;;;;;;;;;;2,0;;;;;;;;;;;;;;;;;;;;;;;;;4,0;;;2,0;;;;;;;;;;;;;;;;;;;;;;;;;;;;;;;;;;;;;;;;;1,0;;;;1,0;;;;;;3,0;;;;;;;;;;;;;;;;;;;;;;;;;;1,0;;;;;;;;;;;;;;;;;;;;;;;;;;;;;;;;;;;;;;;;;;;;2,0;;2,0;1,0;;;;;;;;;;;;1,0;1,0;;;;;;;;;;;;;;;4,0;;;2,0;;;;;;4,0;;;;;;;;;;;;;;;;;;;;;;;;;;;;;;;;;;;;;;;;;;;;;;;;;;;;;
list;;;;;;3,0;;;;;;;;16,0;;;8,0;;;;;;;;2,0;;;;9,0;6,0;2,0;2,0;4,0;;;10,0;5,0;;;;5,0;13,0;;;38,0;3,0;;2,0;;;3,0;;;;1,0;4,0;1,0;;;12,0;;;2,0;;32,0;;17,0;;;;;;;;;;;3,0;2,0;3,0;20,0;;3,0;;2,0;;;;;;;;;;;;;4,0;14,0;76,0;18,0;;;;7,0;9,0;1,0;2,0;2,0;;;3,0;;;;1,0;1,0;8,0;;3,0;1,0;;;;;16,0;12,0;;;;;;1,0;6,0;;;1,0;;;;;;;;;3,0;5,0;2,0;5,0;1,0;;;;;;;;;;;;;2,0;;;;;;;;;;;4,0;;10,0;;;;;;;;;;;5,0;;5,0;;;;;;;;;;;;;;;;5,0;;;;;;;;;;;;4,0;;;;;;;;;;;;;;;;1,0;;;4,0;;;;;;;;;;9,0;;2,0;;;;;;;;;;;;;1,0;3,0;;;;;;1,0;;;;;;;;;1,0;1,0;;;;;;;;;;;;1,0;;;;;;;11,0;;;;;;;;;;;;;1,0;;;;;;;4,0;;;;5,0;8,0;;;;;;;1,0;;;;;;12,0;;;;;;;;;;;;;;;;;;;;15,0;;;;14,0;1,0;;;;3,0;;;;1,0;;;;;;;;;;3,0;1,0;;10,0;4,0;;;;7,0;3,0;;;4,0;;;;;;6,0;;11,0;4,0;1,0;;1,0;;2,0;;;;2,0;;;;;;3,0;4,0;;;;;;;;;;;6,0;;1,0;;1,0;;;;;;;1,0;1,0;;;;4,0;;;;2,0;;;16,0;;;;;;;1,0;;1,0;2,0;3,0;1,0;;;1,0;;;;;;;;;;1,0;;;;5,0;1,0;;;;;;1,0;;9,0;;;;;;;;;;5,0;;;;1,0;4,0;;;;;;;;3,0;;;;;;;;;;;;;;;;4,0;;;;;;;;;;;;3,0;7,0;;;;;;;;;;;6,0;;;;;;3,0;;;;;;;;;10,0;;;;1,0;;6,0;;8,0;;;;;;;;;;;;;;;;;;2,0;;;6,0;;3,0;;;;;;;;65,0;30,0;2,0;;;;;;;;;;;;1,0;5,0;;;;;1,0;;;;;;;;;;1,0;;;;;;;;;;;;;;;;;;;2,0;;;;;;;;;2,0;2,0;;;;;5,0;;;2,0;;2,0;;;3,0;;4,0;2,0;;;;;1,0;;;;;;;;;;;;1,0;;;;;;;;;;;;;;;;;;;;1,0;;;;;;;;;;;;;;3,0;;;;;;;;;;;4,0;;;;;;;1,0;;;;;;;;;;;;;;;;;;;;;;;3,0;;;;;;;;;;;;1,0;;;3,0;;;;;;;;;;;;;;;;;;;;;;;;1,0;;;;;;;;;;;;;;;;;;;;;;;;;;;;;;;;;2,0;;;;;;;;;;;;;;;;;;;;;;;;;;;;;;;;;1,0;;;2,0;;;;;;;;;;;;;;;;;;;1,0;;;;;;;1,0;;;;;;;;;;;;;;9,0;;;;;;;;;;;;;;;;;;;;;;;;;;;;;;;;;;;;;;;;;;;;;;;;1,0;;;;;;;;;;;;;;;;;;;;;;;;;2,0;;;8,0;;;2,0;;
load;;;;;;6,0;5,0;8,0;;;;3,0;3,0;28,0;;;17,0;3,0;;1,0;;;;;;1,0;;2,0;13,0;3,0;28,0;1,0;;;;5,0;3,0;1,0;;;27,0;24,0;;4,0;8,0;4,0;;12,0;;;6,0;;1,0;;1,0;;2,0;;;;;;;;29,0;1,0;38,0;5,0;1,0;;;7,0;;;;4,0;;;;9,0;22,0;;;;27,0;2,0;;3,0;;;1,0;1,0;;;2,0;;5,0;;30,0;7,0;14,0;20,0;;2,0;55,0;35,0;1,0;17,0;;;;6,0;5,0;4,0;;;;;;18,0;;;16,0;;;;24,0;;1,0;;2,0;;1,0;27,0;;4,0;;;;7,0;;;;;;12,0;1,0;2,0;7,0;4,0;17,0;2,0;4,0;;4,0;;;1,0;;;3,0;43,0;;;;;13,0;6,0;6,0;1,0;1,0;;;6,0;;;1,0;;9,0;;2,0;8,0;;;;;4,0;2,0;7,0;;;;;;2,0;1,0;;;;;;;;;5,0;1,0;4,0;;;11,0;2,0;1,0;;;;1,0;10,0;5,0;;6,0;;1,0;;;8,0;;10,0;;1,0;4,0;;1,0;3,0;;;;;;1,0;;;3,0;3,0;;;2,0;;1,0;8,0;;;;1,0;5,0;4,0;8,0;8,0;11,0;;;5,0;;1,0;26,0;1,0;;;;7,0;;;13,0;3,0;6,0;;;1,0;;;1,0;;;4,0;;;1,0;;2,0;12,0;;4,0;2,0;2,0;;;4,0;;;;3,0;;;3,0;7,0;;;;;75,0;10,0;3,0;;;2,0;;1,0;1,0;5,0;2,0;13,0;2,0;;2,0;1,0;;;;;23,0;2,0;;;;1,0;1,0;;6,0;;;;3,0;5,0;1,0;;;1,0;;1,0;;37,0;;2,0;;;;;9,0;;5,0;;;;;;;;1,0;1,0;;;;;2,0;;3,0;;;;9,0;1,0;41,0;2,0;;;3,0;9,0;;3,0;;;33,0;3,0;5,0;;;1,0;;2,0;33,0;;;3,0;;2,0;;2,0;;;2,0;1,0;;6,0;;;5,0;;;;;;;6,0;;;;15,0;;3,0;;;;;4,0;;3,0;;2,0;;21,0;;1,0;3,0;13,0;;;1,0;;4,0;4,0;;;25,0;2,0;;;;1,0;2,0;;;;;;3,0;;;3,0;;;;;;15,0;2,0;;;;5,0;2,0;11,0;;;;;2,0;;7,0;2,0;;;;;;;3,0;;4,0;;1,0;;;;;;;2,0;;2,0;;;;;;;;4,0;1,0;2,0;;;;5,0;;;;1,0;;;;;;;;;;;;;1,0;;;;;16,0;;;;;;4,0;;2,0;;;16,0;1,0;;;;;;4,0;2,0;12,0;;;3,0;;;;;2,0;;;;2,0;;;1,0;27,0;4,0;;;;2,0;;11,0;;2,0;2,0;3,0;;;;8,0;;;;;1,0;;1,0;;1,0;;;;;;15,0;;;;;;;;;;;;;;2,0;;;;;;;4,0;;;55,0;;;;;;;;4,0;;16,0;;;1,0;;1,0;;;4,0;15,0;;;;;;;;;;23,0;;;;;;;1,0;24,0;;;;;;;6,0;;;2,0;;;2,0;1,0;;;3,0;;;1,0;;3,0;;;11,0;;2,0;;2,0;;;;2,0;1,0;;3,0;;;;;;;;;;;;;;1,0;;;;;1,0;1,0;;;;;;;;;;;;9,0;;;;;1,0;;;;;2,0;;;;;8,0;;;;;;;;;;;2,0;;;;;;8,0;11,0;;;;;;;1,0;3,0;;;;;;;1,0;;3,0;;4,0;;;;;;;;;;;10,0;2,0;;;;;;;;;;;;;;;;;;;;;;;;;;;;;88,0;;;;;3,0;;;;;;;;;;;;;;;;;;;4,0;;;;;;;;;;;;;;;;;;1,0;2,0;;;;;;;;;;;;;;;;;;;;;;;;;;;;;;;3,0;;;;;;;;;;;;;;;1,0;2,0;8,0;;;;2,0;;;;;;;;;;;;;;;;;;;;;;5,0;;;;;;;;2,0;;;;;;;;;;;;2,0;4,0;;;;;;;;;;;;;;;;;;;;;;;;;;;;;;
management;;;;;;11,0;1,0;1,0;;;;;;6,0;;;6,0;;1,0;;1,0;;;;3,0;;;8,0;4,0;1,0;21,0;2,0;;;;69,0;4,0;;;;26,0;36,0;;1,0;4,0;;;8,0;;;5,0;;;;1,0;;1,0;;;13,0;;;;;32,0;;32,0;;;;;1,0;1,0;;;;;;;;25,0;;3,0;;21,0;;;;;3,0;;;;;;;2,0;;8,0;2,0;2,0;;;5,0;1,0;17,0;;1,0;;;;2,0;1,0;;;;1,0;;;9,0;;;;;;1,0;132,0;;;;1,0;;;16,0;;;1,0;5,0;3,0;;;;4,0;;;2,0;4,0;;8,0;;;;;;;7,0;;;;;;2,0;6,0;2,0;;;8,0;;;1,0;3,0;;;1,0;;;;;;;;;;;;;;;;;;;7,0;;;;2,0;;;;;;;;1,0;1,0;1,0;;;;;;;;;;3,0;;;2,0;;;;;;;;1,0;;2,0;;;2,0;;;;;;;;;;;;;4,0;;;2,0;;;;;;1,0;;;1,0;;;4,0;9,0;;8,0;;2,0;;;;;;;;2,0;;;3,0;;;;1,0;;;1,0;1,0;;;;5,0;;;1,0;;;;;;;;;;;;2,0;;;;;;13,0;;;;;;;;;;;3,0;;;;;;;;60,0;;;;;;;;;;;;;;;;;;;1,0;1,0;;;;;;;;;;13,0;1,0;;;;;1,0;;;;;;;;1,0;;3,0;;;21,0;1,0;;32,0;;;;;9,0;1,0;;2,0;;;1,0;1,0;;;19,0;;5,0;;;;3,0;2,0;8,0;;2,0;4,0;2,0;;;;;;;;;;;;;;;;1,0;;5,0;6,0;;;;;5,0;27,0;;2,0;;;1,0;1,0;1,0;2,0;10,0;;1,0;;;;;15,0;;;;;;;6,0;;;;;10,0;;;;;;;3,0;;;;;;15,0;;;;5,0;;1,0;;;;;;;7,0;;;;;;;;;;;;;;;2,0;;;;;;;;1,0;;;;;;8,0;1,0;;;;4,0;;;;;;;;;;;;;;;;;;;;;;;;;;;;;;;;1,0;;;4,0;;;;;;;12,0;8,0;;;14,0;;2,0;;3,0;;;;;;;;;;;;;2,0;;;;;3,0;1,0;;1,0;;1,0;;;;;;;;;;2,0;2,0;4,0;;1,0;;;;;1,0;;;;;1,0;1,0;;1,0;;;3,0;;;;;;;;;;21,0;2,0;3,0;5,0;;;;;;;;;;;;;;;;;;;;;;;;;2,0;6,0;3,0;;;;;;;3,0;;;;;;1,0;;;;;;;3,0;;;1,0;;;;;;;;;;;;;;;;;;1,0;;;;;;;;;6,0;;1,0;;10,0;1,0;;1,0;;;;;;;;;;;1,0;;;1,0;1,0;;;;;1,0;;;;;;;;;;;;;;;;;;;;;;;;;;;;;;;;;;;1,0;;;;;;;;;;;;;;;;;;;;;;;;;;;;;;;;;;;;;;;;;;;;;;;;;;2,0;;;;;;;2,0;;;;;;;2,0;;;;;;;;;2,0;;;;;;;;;;;;;;;;;;;;;;;;;;;;;;;;;;3,0;;;;;;;;;;;;;;;;;1,0;6,0;;;;;;;;;;;;;;;;;;;;;;;;;;;;;;;;;;;;;;;;;;;;;;;;;;;;;;2,0;;;;;;;;;;;;;;;;;;;;;;;;;;;;;;;;;;;;;;;;;;;;;
mate;;;;;;7,0;;11,0;;;1,0;;6,0;26,0;;;;;33,0;;;;;;;;;23,0;;;98,0;;;;;;;10,0;;;;11,0;;;8,0;21,0;;61,0;;;;;1,0;;2,0;;6,0;3,0;;;;;;;;;11,0;;;;;54,0;2,0;;;;1,0;;;;23,0;;;;6,0;;;2,0;1,0;;;13,0;;;;;;;5,0;;8,0;;;;;;;;;;;;5,0;4,0;2,0;;;12,0;;;;;;2,0;;;6,0;;;;;;;2,0;;;2,0;;;;;;;;3,0;;;8,0;;4,0;;;1,0;9,0;;;;;;;2,0;7,0;;;;;6,0;2,0;;;;;;;6,0;7,0;;;2,0;;;;;8,0;78,0;;;;2,0;65,0;;;1,0;;20,0;4,0;164,0;;2,0;3,0;;;;;;;56,0;;;33,0;2,0;;;;3,0;3,0;;;;1,0;;;;;9,0;;147,0;;1,0;;2,0;;;;43,0;;;;;;;10,0;;;14,0;;;9,0;19,0;1,0;19,0;;;90,0;;;11,0;110,0;;;;;1,0;;3,0;;;;8,0;1,0;;1,0;;2,0;1,0;;;2,0;1,0;;2,0;;;15,0;;;;1,0;18,0;;;;;6,0;;;1,0;;;19,0;1,0;46,0;2,0;;;16,0;;9,0;;1,0;;;2,0;;2,0;2,0;;13,0;;12,0;;1,0;10,0;;1,0;2,0;;;1,0;2,0;4,0;;3,0;3,0;;;;1,0;;;3,0;6,0;;18,0;2,0;33,0;;;;1,0;;;;;1,0;1,0;2,0;1,0;1,0;;;;;;;;;;;;;;;;;;;;;;;;;;;;;;;;;;;;;;2,0;;;;;;3,0;;1,0;;;;;1,0;;;;;;;;;;;;;;;;40,0;;2,0;;;;;;;;;;;;;;;;;;;;;;;;;;;7,0;;;;3,0;;;;;;;;;;;;;;;9,0;2,0;12,0;;;1,0;1,0;7,0;;;1,0;1,0;;3,0;4,0;;;;;;;;;;;;;;;6,0;;;;;;;;4,0;;;;;;;;;;4,0;21,0;;;;;15,0;1,0;3,0;;1,0;;;5,0;;;;;;8,0;;;;7,0;;;;;;;;4,0;;;;;;;;;;;1,0;;;;;;;;;;;1,0;;12,0;;;;;;;;7,0;;1,0;;;;1,0;;;;1,0;;;;;;;;;;13,0;;;;;;;;;;;;4,0;;;;;;;;;;;;;;;;;8,0;;;;;1,0;;;2,0;;4,0;;;2,0;;1,0;;;;;;;1,0;1,0;;;;;;;;;2,0;;;;1,0;;1,0;;1,0;;;;;;;;;2,0;;;;;;;;;;;;;;22,0;;12,0;;3,0;;1,0;;7,0;;;18,0;;;;;;;;;1,0;;;;;;;1,0;;;;3,0;;;;;;;;4,0;;3,0;14,0;;;;;;39,0;6,0;;;;4,0;;;;;3,0;;4,0;;;;;;1,0;;;;;;;;46,0;;1,0;;;;;;;;12,0;;;;;;;;;;;;;;;;;;;;;;;;;;;;;;;;;;;;;;;;;;;;;;;;;;;;;;;;;;;;;;;;;;;;;;;;;;;;;;;;;;;1,0;;;;;;2,0;;;;;;;;;;;2,0;1,0;;;;;;;;;;;;;;;;;;;;;;;;;;;;;;;;4,0;;;;;;;;;;;;;;;;;;;6,0;;;;;;;;;;;;;;;;;;;;;;1,0;;;;;;;;;;;;;;;;;;;28,0;;;;;;;;;;;;;;;;;;;;;;;;;;;
metadata;;;;;;8,0;;;3,0;;;;;97,0;;;44,0;;3,0;;;;3,0;1,0;1,0;;;;54,0;3,0;23,0;13,0;;;;25,0;2,0;;9,0;1,0;73,0;23,0;;30,0;4,0;;;;;;15,0;;;;7,0;;6,0;;;49,0;;;4,0;1,0;291,0;;39,0;;2,0;;;2,0;2,0;;;;;3,0;2,0;3,0;44,0;;;6,0;;;;2,0;;;;;;2,0;;;10,0;;11,0;9,0;21,0;3,0;;4,0;16,0;4,0;;2,0;1,0;;;6,0;18,0;;;1,0;2,0;1,0;1,0;6,0;13,0;;24,0;;;39,0;27,0;;;;14,0;;;2,0;2,0;;1,0;2,0;3,0;;;;;;;;;;49,0;2,0;;8,0;;;;;;;;;;3,0;7,0;;;;2,0;;;1,0;;;2,0;4,0;;;;;2,0;3,0;;;;;;;;;14,0;;;;;;;;;;;3,0;;;;;;5,0;;;;;;1,0;;;;;2,0;;2,0;;2,0;;;;;;8,0;3,0;;;;;23,0;;;;;;;;;;;;;10,0;2,0;;;;;;2,0;6,0;;;1,0;;;;;8,0;1,0;1,0;;;;;;;;;;;;;;;;;;;;;;;;;;;;;;;;;2,0;1,0;;;;;;;;;;;4,0;12,0;;;;;;;2,0;;;;4,0;51,0;;;;;;;31,0;;;;;;37,0;;;;;;;;;;;;1,0;1,0;;;;;;;16,0;;;;56,0;2,0;;;;1,0;;;19,0;;;;;;;2,0;;;;2,0;14,0;;6,0;25,0;;1,0;15,0;2,0;6,0;;;9,0;;;21,0;;2,0;;;10,0;34,0;2,0;1,0;9,0;;2,0;;19,0;1,0;3,0;4,0;;;33,0;;;3,0;7,0;;;;;;3,0;;;1,0;40,0;;15,0;;;3,0;;6,0;6,0;;;5,0;;;;;2,0;1,0;1,0;6,0;1,0;6,0;;;;;;;;;1,0;;10,0;1,0;4,0;1,0;3,0;1,0;;;3,0;;;5,0;;3,0;;;;;;;2,0;;1,0;;;;6,0;1,0;1,0;6,0;;;4,0;;;;;;;;;;;8,0;7,0;;1,0;1,0;;;;1,0;2,0;1,0;;;;;;;;;;;;;;;;;;;;;;;;;1,0;;2,0;;;;;;;2,0;;;;;;;;;;2,0;;;;;4,0;;;2,0;;55,0;;;;3,0;4,0;;;;;;;;16,0;;;;;;;;;;2,0;5,0;14,0;;21,0;;;;;5,0;;15,0;;;1,0;;6,0;;25,0;;;;;2,0;19,0;;;;;;1,0;1,0;;;;;21,0;;;;;;;;;;4,0;;;;;;;;4,0;;2,0;3,0;;;;2,0;1,0;;;;;;;;;;;;1,0;3,0;2,0;;;;;;;12,0;;;;;;;;19,0;;;;;;;;4,0;;;;;;1,0;;;;;;;;;;;;;;;;;;;;;4,0;;;;;;;;;;;;;;;;;;;;;4,0;2,0;;;;;2,0;;;;;;;;;;;;;;;;;;;;;;;;;;;;;;;;;;;;;;;;;;;;;;;;;;;;;;;;;;;;;;;;;;;3,0;;;;;;;;;;;;;;;;;;;;2,0;;;;;;;;;3,0;;;;;;;;;;;;;;;;;2,0;1,0;;;;2,0;;;;;;;;;;;;;;1,0;;;;;1,0;;;;;;;;2,0;;1,0;;;;39,0;;;;;;;;;;;;2,0;;;;;;;;;;;;;;;;;;;;;;;;2,0;;;;;;;;;;;;;;;;;;;;;;;;;;;;;1,0;;;1,0;;;;;;;3,0;;;;;;;;1,0;;;;;;;;;;;;;;;;;;;;1,0;;;;;
modulate;;;;;;3,0;19,0;;;;;;;7,0;2,0;4,0;4,0;;5,0;;;;3,0;;2,0;;;23,0;;;26,0;;;;;21,0;3,0;;1,0;;12,0;14,0;;9,0;2,0;;;13,0;;;;;;1,0;12,0;;1,0;;54,0;8,0;;;;;22,0;1,0;17,0;;;;;8,0;170,0;;;1,0;;;;1,0;22,0;;2,0;;4,0;;;23,0;;;;;2,0;;;;10,0;8,0;9,0;;3,0;2,0;;;2,0;6,0;;;1,0;;;11,0;8,0;;;3,0;;10,0;17,0;16,0;10,0;;103,0;;2,0;;11,0;;;;10,0;1,0;;7,0;;;2,0;3,0;;;;1,0;;3,0;2,0;10,0;1,0;4,0;5,0;;;1,0;;;;;;;;;;1,0;;3,0;;;1,0;;;;6,0;;14,0;2,0;;;9,0;13,0;;;17,0;;;;;;1,0;;4,0;;;;;;;;;11,0;3,0;;;9,0;;;1,0;1,0;;;5,0;;1,0;1,0;3,0;;;;6,0;;;11,0;36,0;;;;;;3,0;;;2,0;;32,0;;;;;30,0;4,0;;4,0;;;;;;;;;;;;;;9,0;;4,0;;1,0;;;3,0;11,0;2,0;;;;4,0;;;;;;2,0;;;;;;;;;;1,0;;;;9,0;;1,0;;1,0;;;;1,0;;1,0;;;;;;;4,0;;;;;;1,0;;;;;;;;;1,0;;;6,0;;1,0;;;;;4,0;;;;;;3,0;;;;;;;;;;;;;1,0;;;;;3,0;;1,0;;;;2,0;;;;;;;;;1,0;;;;;;;;;;1,0;1,0;;3,0;;1,0;;;6,0;;2,0;;;;;2,0;;;5,0;;6,0;;;;4,0;;;;;;;;4,0;;2,0;;7,0;2,0;;;;;;;9,0;;;;24,0;;1,0;;;12,0;;1,0;1,0;;;;;2,0;6,0;;;;;;;;;;;;15,0;;;;;;;;2,0;;;;;;9,0;;;;;;;1,0;2,0;;;2,0;1,0;;;;;2,0;;1,0;;;1,0;;;;;;;9,0;;;;;;;5,0;;;;;;;;;21,0;2,0;;;;3,0;;;;;;;2,0;;;;;;;;;;;;;;;;;;;;;;;;;;;;;;;;;;;;;;;;;;;;1,0;2,0;;1,0;;;;;;;;;;;;;33,0;;5,0;;;;1,0;8,0;;;1,0;;;;;;;;;;;1,0;;;;;;;;5,0;;;;;;;;;;;30,0;3,0;;;;;;;;;;;;3,0;;;;30,0;;;;;;;;;;;;;;;;;;;10,0;;;3,0;;;8,0;;;;;;11,0;;;;;;;;26,0;;;;;4,0;10,0;1,0;;;;;;;5,0;;;;1,0;;;;;;;3,0;;;;;;;;;;1,0;;39,0;;;;;;;;;;;;;;;;;;;;;;;9,0;;;;;;;4,0;;7,0;;;;;;;;;;1,0;;;;;;;;;;;;;;;3,0;;;;;;;;1,0;;;;6,0;;;2,0;;;;;4,0;;;;1,0;;;;;;3,0;4,0;;;;;;;;;8,0;;;;;;;;;29,0;;;;;;7,0;2,0;;;;;;;;;;;;;;;;;;;;;;;;3,0;;3,0;2,0;;;;;;6,0;;;;;;;;2,0;;;;;;;2,0;;;;;;;;;;;;;;;;;;;;;;;;;;;;;;;;;;;;;;;;;;;;;;;;;;;;14,0;;;;1,0;9,0;1,0;;;;;2,0;;6,0;;;;;;;;;;;;;;;;;;;;26,0;;;;;;;;;;;;;;;;;;;;;;;;;;;;;;;;;;;;;;
moveable;;;;;;12,0;4,0;47,0;;;;;1,0;9,0;;;4,0;;;;;;;3,0;1,0;;;2,0;;;36,0;2,0;;;;;4,0;3,0;10,0;1,0;4,0;27,0;;;;20,0;;16,0;;;;;;;5,0;;6,0;3,0;;4,0;;;;;6,0;2,0;37,0;;;;1,0;92,0;5,0;;;;;;;;6,0;2,0;;;30,0;2,0;;15,0;;;;2,0;1,0;;3,0;;2,0;1,0;14,0;9,0;91,0;;;;2,0;2,0;;2,0;;;;;8,0;;;;;1,0;4,0;10,0;1,0;;2,0;;;1,0;16,0;;3,0;;;;;22,0;;;4,0;;1,0;;;11,0;;;2,0;;1,0;2,0;;29,0;;1,0;100,0;2,0;;;;;;;;6,0;;;;;9,0;3,0;;;;;;7,0;;1,0;;3,0;2,0;;;2,0;5,0;2,0;;;1,0;5,0;47,0;1,0;;;;4,0;2,0;6,0;16,0;;;2,0;;;;;8,0;;32,0;;114,0;32,0;12,0;11,0;;;1,0;13,0;;5,0;;1,0;4,0;;;;6,0;;18,0;;;;;;4,0;;;;1,0;;;;;6,0;2,0;4,0;;3,0;;;18,0;7,0;1,0;;;15,0;1,0;;30,0;31,0;;;;;;3,0;4,0;;;;;;;;37,0;;;;7,0;18,0;;;;;14,0;2,0;;101,0;7,0;;4,0;;3,0;2,0;;;;;2,0;3,0;;6,0;1,0;;;;;5,0;2,0;2,0;;4,0;;;;4,0;;;;3,0;;6,0;4,0;5,0;5,0;;;;;;;;;;5,0;3,0;1,0;;1,0;;;;20,0;13,0;;8,0;1,0;2,0;;4,0;;5,0;;;;;9,0;;;2,0;2,0;;;1,0;;;;1,0;;;;;;;;5,0;6,0;14,0;;;;;38,0;1,0;;1,0;;1,0;;;;;;;;15,0;;;;;;;26,0;;5,0;;5,0;3,0;;;;7,0;;6,0;;3,0;3,0;;;;;;;;;;;14,0;;1,0;;;2,0;;1,0;;;3,0;1,0;;1,0;;;;;2,0;;;;;;;;;;2,0;;;;1,0;;;;;;;;;;;;2,0;;;;;;;;;;;8,0;;;5,0;;;;;1,0;;;;;15,0;1,0;1,0;;;;;;;;3,0;;3,0;;;;;;;;;;1,0;;2,0;;;4,0;;;;;;1,0;;;;4,0;;;2,0;4,0;;;;;;;;;13,0;;;;;;;;;;;;;;;;;;;;;;;;;;;;;;;;5,0;;;;;;;12,0;;13,0;;1,0;;;;;;;;5,0;;;;;;;;;;;;;;;;;;;;;1,0;;;;;;1,0;;13,0;;;;;;;;;;;;;;;1,0;;1,0;;;23,0;;1,0;;;;3,0;;;;;;;;;;;10,0;;;;;;;;;;;;3,0;;;;;;;;;1,0;;1,0;;;;;1,0;2,0;;;;;;10,0;;;1,0;;;;;6,0;7,0;1,0;2,0;;;;;1,0;;;8,0;6,0;;;;;;;;3,0;;;3,0;;6,0;;;;;1,0;9,0;;;3,0;1,0;1,0;;;1,0;;4,0;;;;1,0;;;;;;;;1,0;;;;;;;1,0;;;;;;;;2,0;;7,0;;3,0;;;2,0;;;;;;;;;;;;;;;1,0;;;;;;;;;;4,0;;;;;1,0;;;;;;;;;;;;;;;;;;;;;;;;;;;;;;;;;;;;;;;;;3,0;;;;;;;;;;;;1,0;;;;;;;;;;;;;;;;;;;4,0;;;;;;;;;;;;;;;;2,0;;;;;;;;;;;;;;;;;1,0;;;;;;;;;;;;;1,0;;;;;9,0;;;;;;1,0;;;;;;7,0;;;;;;;;;;;;;;;;;;;;;;;;;;;;;;;;;;;;;;;;;;;;;;;;3,0;;;;;;;;
opaque;;;;;;4,0;5,0;5,0;;;;2,0;;;;;;;2,0;;;2,0;2,0;;;;;31,0;1,0;;1,0;;;;;;5,0;;1,0;;;16,0;2,0;2,0;5,0;8,0;;4,0;;;;;14,0;1,0;;3,0;5,0;;;;4,0;;1,0;;10,0;;33,0;;4,0;;;19,0;33,0;2,0;;;44,0;;;;12,0;;;;6,0;1,0;;8,0;;;;;2,0;1,0;;;4,0;1,0;18,0;2,0;15,0;1,0;;1,0;;;;;;;;;6,0;;;;;;;5,0;;1,0;;;;;4,0;;;2,0;;;;1,0;;;2,0;;;2,0;7,0;2,0;;;36,0;2,0;30,0;14,0;1,0;1,0;;30,0;1,0;;;;;8,0;;;;;;;;;1,0;13,0;;;;;1,0;1,0;1,0;3,0;;;;;;;;4,0;;;5,0;;;2,0;;;;1,0;;2,0;10,0;1,0;5,0;;;30,0;;;;;4,0;1,0;2,0;3,0;1,0;;;;7,0;25,0;;;;2,0;25,0;2,0;;;1,0;55,0;20,0;;4,0;;2,0;;;;;;2,0;;;;;;;;4,0;1,0;1,0;4,0;4,0;;;2,0;;6,0;5,0;;;21,0;11,0;;;;;;39,0;;;6,0;;4,0;;;;;;;5,0;34,0;5,0;;;;;3,0;;;;;6,0;2,0;;;;;;;;;;;;1,0;;;;;;;6,0;3,0;;;;;6,0;;4,0;;;;;;1,0;;;;;;;;;;;;;;;1,0;;;;;;;;;;5,0;;;;1,0;;;;2,0;;;;;;;;;;;;;;;;;;;;;;;;;;;;;;;;;;;;;;;;;;;;;;;;;;;;;;;;;;1,0;;;;;;;;;;;;;;;;;;;;2,0;;;;;;;;;;;;;;;;;;;;;;;;2,0;;;;1,0;;;;;;;;;;;;1,0;2,0;;;;;;;2,0;;1,0;;;;;;;;;;;;3,0;10,0;;;;;;;;;;;;;;;;1,0;;;;;;;;;;;;;;;;6,0;;;;;1,0;;;;;;;;;3,0;15,0;;;;;;;;;;;;;;;;;;;;;;;;;;;;;;2,0;6,0;;;;;2,0;;3,0;8,0;;;;;;;1,0;;;;;;;;3,0;3,0;;;;;;;;;1,0;;;;;;;;;;;;;;;;;;;;;;;;;;;1,0;;;;;1,0;;;;;2,0;;;;;17,0;;;;;3,0;;;;;;;;;;9,0;;;;;;5,0;;;;;;;;;;;;;;;;;;;;;;;;;10,0;;;;;;;;;;;;7,0;;;;;4,0;;;;;;;;;;;;;;;;;;;;;;4,0;;;;;;2,0;;;1,0;;;;;;;;;;;5,0;3,0;;2,0;2,0;;;;;;;;;;;;;;1,0;;;;2,0;;2,0;;;;;;59,0;;;;;;;;;;;;;;;;;;;;;;;;6,0;;;2,0;;;;;;;;;;;;;4,0;;;49,0;;;;1,0;;;;;;;;;;;;;;;;1,0;;2,0;;;;;;;;;;;;1,0;;;;;1,0;;;;;;;;;;;;;;;;;;;;;;;;;;;;;;;;;;;;;;;;;;;;;;;;;;;15,0;;;;;;;;;;;;;;;;2,0;;;;;;;;;;;;;;;;;;;;;;;;;;;;;;;;;;;;;;;1,0;;;3,0;;2,0;;;;;;;;;;;;;;;;;;;;;;
outer;;;;;;37,0;9,0;45,0;;;13,0;;101,0;113,0;;;10,0;6,0;11,0;;3,0;39,0;12,0;3,0;2,0;;;90,0;1,0;;79,0;;1,0;;4,0;13,0;54,0;6,0;3,0;;5,0;171,0;201,0;19,0;70,0;191,0;1,0;199,0;;;1,0;;101,0;8,0;29,0;2,0;175,0;;;6,0;14,0;;5,0;;97,0;;215,0;3,0;1,0;76,0;136,0;490,0;66,0;7,0;;;13,0;;;;17,0;;1,0;4,0;106,0;24,0;;79,0;18,0;4,0;;19,0;23,0;88,0;1,0;;29,0;25,0;115,0;2,0;98,0;12,0;7,0;;1,0;9,0;;;8,0;;1,0;5,0;65,0;7,0;3,0;;1,0;11,0;2,0;59,0;;2,0;2,0;8,0;;;72,0;1,0;;16,0;1,0;;6,0;153,0;3,0;;36,0;2,0;2,0;4,0;8,0;32,0;;;17,0;6,0;87,0;80,0;4,0;73,0;;20,0;114,0;34,0;2,0;1,0;136,0;17,0;;;67,0;128,0;;;;;120,0;233,0;4,0;3,0;;2,0;20,0;90,0;28,0;158,0;7,0;4,0;;;;5,0;31,0;156,0;3,0;10,0;16,0;6,0;176,0;119,0;1,0;4,0;16,0;32,0;92,0;41,0;412,0;9,0;552,0;12,0;3,0;70,0;2,0;1,0;11,0;1,0;214,0;12,0;10,0;120,0;2,0;19,0;1,0;25,0;2,0;;;8,0;25,0;2,0;13,0;;2,0;7,0;73,0;29,0;568,0;;4,0;;48,0;6,0;2,0;;44,0;;24,0;2,0;3,0;1,0;1,0;206,0;9,0;2,0;73,0;13,0;11,0;58,0;297,0;2,0;9,0;11,0;;40,0;11,0;4,0;118,0;1432,0;57,0;;7,0;1,0;2,0;48,0;160,0;22,0;;;4,0;48,0;1,0;20,0;13,0;15,0;7,0;;5,0;16,0;24,0;5,0;19,0;6,0;52,0;37,0;;22,0;26,0;30,0;33,0;11,0;121,0;16,0;21,0;76,0;16,0;4,0;44,0;;49,0;36,0;4,0;22,0;19,0;3,0;14,0;57,0;4,0;18,0;7,0;41,0;7,0;5,0;46,0;12,0;13,0;2,0;60,0;20,0;4,0;8,0;13,0;37,0;58,0;3,0;14,0;110,0;3,0;4,0;6,0;5,0;54,0;5,0;4,0;91,0;4,0;27,0;;8,0;2,0;;16,0;3,0;6,0;21,0;3,0;11,0;60,0;49,0;;45,0;3,0;;2,0;21,0;;45,0;2,0;55,0;10,0;10,0;19,0;;;;;4,0;1,0;1,0;;;19,0;7,0;;23,0;1,0;1,0;8,0;;3,0;;8,0;;;2,0;;14,0;;7,0;6,0;;1,0;;;4,0;3,0;6,0;4,0;1,0;;;;8,0;10,0;1,0;1,0;17,0;;9,0;;17,0;13,0;24,0;;6,0;15,0;;3,0;4,0;;;;5,0;1,0;;;30,0;2,0;;;;12,0;;;;;2,0;1,0;;3,0;;2,0;71,0;2,0;11,0;;1,0;;1,0;18,0;;1,0;;;13,0;8,0;9,0;;1,0;6,0;1,0;5,0;;;14,0;;;;;;;2,0;2,0;;7,0;16,0;2,0;1,0;3,0;;5,0;73,0;1,0;;;;14,0;2,0;4,0;15,0;;;1,0;1,0;20,0;;3,0;1,0;2,0;;2,0;;;1,0;1,0;;15,0;6,0;;2,0;;2,0;;2,0;;;4,0;10,0;17,0;6,0;28,0;38,0;39,0;6,0;21,0;;;18,0;2,0;5,0;;9,0;2,0;2,0;23,0;12,0;;5,0;;;14,0;;19,0;76,0;83,0;;3,0;;1,0;1,0;;;7,0;;;;;;;2,0;;;2,0;5,0;1,0;1,0;;;;3,0;2,0;;;;13,0;7,0;8,0;;;55,0;15,0;;2,0;22,0;34,0;4,0;13,0;20,0;;;1,0;6,0;;;2,0;18,0;;;19,0;7,0;;;;;;2,0;;;;;3,0;;;;2,0;;16,0;;;;24,0;;;2,0;;;;;;;;9,0;;;1,0;4,0;;2,0;5,0;6,0;;5,0;3,0;9,0;4,0;3,0;2,0;;47,0;;12,0;;;;;2,0;5,0;;;;16,0;;;;1,0;6,0;1,0;;;81,0;;9,0;;5,0;;;;;;;;;;;;;;;;12,0;2,0;;14,0;;4,0;2,0;59,0;1,0;25,0;;12,0;;;2,0;13,0;15,0;9,0;5,0;11,0;4,0;;;3,0;26,0;;2,0;7,0;;16,0;;73,0;;2,0;12,0;;;6,0;6,0;3,0;;;;1,0;;3,0;30,0;;7,0;17,0;;23,0;;2,0;10,0;99,0;;1,0;;4,0;;;75,0;124,0;51,0;2,0;3,0;14,0;13,0;4,0;15,0;8,0;20,0;1,0;2,0;1,0;;5,0;;;2,0;4,0;;1,0;22,0;2,0;;;15,0;83,0;53,0;6,0;4,0;;;7,0;80,0;;6,0;154,0;1,0;;;2,0;;;;6,0;5,0;;;;;5,0;25,0;;;;;;4,0;;;;;;;;2,0;;;;7,0;;;;4,0;5,0;;;;11,0;;;;;;;;4,0;2,0;13,0;2,0;4,0;;;;;;;;2,0;29,0;;7,0;;3,0;2,0;;1,0;;;;4,0;;;;;;;4,0;;;;2,0;1,0;7,0;;1,0;;;2,0;4,0;;;1,0;;3,0;;;;12,0;;2,0;;;;;;;;;;;;;;;3,0;;4,0;;;;;;;;;44,0;;6,0;;8,0;2,0;;;;;;;16,0;;1,0;3,0;14,0;;3,0;;;;;4,0;5,0;;;;1,0;;;19,0;;;18,0;;30,0;;8,0;;;;;3,0;;;;2,0;;;;;;;;101,0;1,0;;1,0;;;;;;;;1,0;;;;;;;;28,0;;;;;;;;
package;;;;;;3,0;12,0;61,0;;;;;1,0;20,0;;;5,0;;;3,0;20,0;;;;;;;10,0;2,0;1,0;11,0;1,0;;;;6,0;2,0;7,0;;;3,0;21,0;;;;7,0;;21,0;;;;;;7,0;4,0;12,0;16,0;1,0;1,0;10,0;2,0;;;;67,0;2,0;63,0;;3,0;8,0;6,0;45,0;15,0;;;;3,0;;;1,0;41,0;;;;51,0;;;126,0;;;5,0;19,0;2,0;;;;7,0;12,0;78,0;2,0;20,0;;;7,0;11,0;13,0;4,0;;;;;;2,0;;;;;9,0;;39,0;;;5,0;5,0;;;8,0;;;3,0;9,0;;;27,0;;;;;;;;6,0;;;;2,0;;;11,0;13,0;;;;2,0;;;;;;;;3,0;;;;;10,0;5,0;;3,0;2,0;;2,0;4,0;;;;11,0;;;;1,0;2,0;18,0;1,0;;1,0;;9,0;;;;;9,0;;2,0;6,0;;;;;40,0;;;;3,0;6,0;1,0;1,0;13,0;2,0;15,0;;1,0;;4,0;19,0;;;;;;8,0;;5,0;;14,0;;2,0;10,0;;;6,0;1,0;;;;;;;;1,0;;;;;2,0;4,0;23,0;;;4,0;6,0;11,0;11,0;;6,0;16,0;3,0;;3,0;4,0;;3,0;;;;;;7,0;;2,0;33,0;;;;1,0;1,0;;3,0;;6,0;29,0;5,0;;;5,0;;15,0;;4,0;;;;;;;1,0;;;;4,0;;;;3,0;;6,0;2,0;4,0;;;22,0;;4,0;;3,0;;3,0;;2,0;;11,0;;6,0;1,0;6,0;;;8,0;;;;11,0;;;;;;;1,0;;;;2,0;;;1,0;;;;;;;;;;;4,0;;;;;;;7,0;2,0;;;;;;;1,0;;;;;3,0;;24,0;;;;;15,0;;;;;1,0;;;;4,0;;;6,0;;;;;9,0;17,0;;4,0;;;9,0;;;5,0;;;;;4,0;;;;;;;;;14,0;;;;;;;2,0;;;;1,0;1,0;4,0;;;20,0;;;;;;;;;;;;4,0;3,0;;;;;;2,0;;;;;;;;;;;;;2,0;;9,0;;;;;13,0;;;;;;;;;;;7,0;;;;10,0;;1,0;;2,0;;4,0;;;;;;;;;;;;;;3,0;;;;1,0;1,0;;;;;;;;;;;;;1,0;10,0;;;;;;;;;8,0;;;;;;;;;;;;;;1,0;;;;;7,0;;;;5,0;;1,0;;;;;;1,0;;;;;;;;;1,0;;3,0;;;;3,0;1,0;;;;;;;;;;;;;;;;;;;;;;;;;;;;;;;;;;;;;;;;;2,0;;;;;;;;;;;1,0;;;;;;;;4,0;;;;;2,0;;;;6,0;;3,0;;;;1,0;;;;;;;;;;;;;;;;;;;;;;31,0;;;;;;;;;;;;;4,0;;;4,0;;;;;;;;;;;11,0;4,0;;9,0;;;;;3,0;;;;;;;;;;;;1,0;;4,0;;;1,0;;;2,0;;;;;;;;;;;;;;;;;;;2,0;;;;1,0;1,0;;;;;;;;;;;;;;;;;;3,0;;;;;;;;;;;;;;;;;;;;;;;;;;;;;2,0;;;10,0;;;;;;;;;;;;;1,0;;;;;;;;;;;;;;;;;;;;;;;;;;;;;;;;1,0;;;;;;;;;;;;;;;;;;;;;;;;;1,0;;;;;4,0;;;;;;;;;;;;;;;6,0;;;;2,0;;;;;;;;;;;;;1,0;;;;;;;;;;;;;;;;;;;;;;;;;;;;;;;;;;;;;;;;;;;;;;;;;;;;;;3,0;2,0;;;;;;;;;;;;;;;;;;;;;
panel;;;;;;9,0;1,0;16,0;;;;;;5,0;2,0;;13,0;;1,0;;;;6,0;;3,0;;;8,0;4,0;6,0;48,0;2,0;;;14,0;5,0;11,0;1,0;;;3,0;127,0;;1,0;281,0;35,0;;8,0;;;;;13,0;;8,0;;24,0;;;7,0;2,0;;;;58,0;;105,0;;1,0;;;34,0;43,0;15,0;;;6,0;;;4,0;31,0;;;;25,0;1,0;;2,0;1,0;;1,0;5,0;1,0;;;1,0;10,0;;36,0;;16,0;;;;1,0;5,0;2,0;;;;;4,0;7,0;;1,0;;;1,0;7,0;3,0;;;13,0;2,0;;13,0;65,0;;10,0;;;;;6,0;;;6,0;2,0;;;2,0;23,0;;;7,0;2,0;20,0;10,0;10,0;19,0;1,0;15,0;13,0;16,0;;1,0;;;;;;18,0;3,0;;;;41,0;21,0;1,0;1,0;19,0;;5,0;;;121,0;;11,0;;;14,0;;1,0;26,0;2,0;1,0;5,0;;18,0;63,0;;;12,0;6,0;1,0;8,0;21,0;2,0;;;1,0;20,0;;;1,0;4,0;4,0;1,0;15,0;28,0;3,0;;4,0;;2,0;14,0;9,0;29,0;;;12,0;;1,0;2,0;16,0;;52,0;1,0;2,0;;2,0;;;;30,0;;5,0;3,0;;1,0;2,0;6,0;;3,0;;3,0;2,0;;55,0;1,0;1,0;;3,0;9,0;28,0;20,0;33,0;100,0;6,0;;;1,0;;10,0;42,0;;;1,0;;13,0;1,0;1,0;2,0;;;;2,0;6,0;1,0;;37,0;;4,0;2,0;;;;7,0;;5,0;;11,0;;;;;7,0;1,0;;5,0;;;5,0;4,0;;;;;1,0;1,0;;;2,0;;;;16,0;;;41,0;1,0;7,0;9,0;1,0;;;;;25,0;1,0;1,0;;1,0;;1,0;10,0;2,0;;;;3,0;;;;;9,0;;11,0;;2,0;;14,0;;34,0;1,0;;;5,0;3,0;3,0;3,0;;;;;2,0;;;;1,0;17,0;;;19,0;;;;4,0;;;58,0;1,0;;1,0;;5,0;;;;1,0;;;;;;1,0;;;;;;9,0;3,0;;;3,0;;8,0;1,0;1,0;;2,0;2,0;5,0;22,0;1,0;;;;;;1,0;;;;27,0;4,0;5,0;1,0;;5,0;;1,0;;;;3,0;;5,0;;;;;2,0;;1,0;;;18,0;;;1,0;9,0;;;3,0;;6,0;;2,0;;;;;;;;;;;;8,0;6,0;14,0;10,0;;;;;1,0;;;2,0;3,0;1,0;;;;8,0;;;;;;2,0;1,0;1,0;8,0;;;;;;41,0;;3,0;1,0;;;;1,0;;15,0;4,0;;4,0;1,0;1,0;4,0;;2,0;1,0;1,0;;;;2,0;6,0;;;;1,0;;2,0;3,0;;;1,0;;;;1,0;;19,0;;;;;2,0;;;;;1,0;;4,0;;;;;;3,0;1,0;;;;;;3,0;;;;;2,0;6,0;8,0;;;;;;;;;4,0;1,0;;;;;;;;;8,0;;;3,0;4,0;;;1,0;;1,0;1,0;;;6,0;;1,0;;;;;;4,0;;;;;;;;;;;;;;;4,0;;;3,0;6,0;;;;7,0;;;3,0;4,0;;;;;;;;;;;;1,0;;;;;;;;;;;;;;;;13,0;2,0;;;2,0;;;;1,0;;;;1,0;2,0;;;;;;1,0;;;;;;11,0;;13,0;;2,0;2,0;2,0;1,0;3,0;1,0;;;4,0;2,0;;;;27,0;1,0;;;;2,0;;;1,0;;;;;;;;;;1,0;;;;4,0;;;;;;1,0;;;;;;1,0;;;;;;;;;;;;;;;5,0;;;4,0;;5,0;;;;;;;;;;2,0;;4,0;;;;1,0;;75,0;;;;;;;;;13,0;;;;;;1,0;;;6,0;;;;;;;;;;;;;;5,0;;;;5,0;;;;;;;;;;;2,0;;1,0;;;;;;;;2,0;;;;1,0;;;;3,0;;;26,0;;;;1,0;;;3,0;;5,0;2,0;;;;;;;1,0;;;;;;;;;;2,0;;;6,0;4,0;;3,0;;;;;;;;;;1,0;;;;;;;;;;;3,0;;;;;1,0;;;;;;;;;;;;;;;;;16,0;;;;;32,0;;;;;;;;;;10,0;;1,0;;;;;;;;;;;1,0;;;;1,0;;;2,0;;;;3,0;;;1,0;;;;;;;;6,0;;4,0;;;;;;;;;;;;;;;;;;;
park;;;;;;15,0;;;;;;;;16,0;;;1,0;;;;;;1,0;;;;;;2,0;;6,0;2,0;;;;15,0;;;;;10,0;11,0;;;38,0;4,0;;12,0;;;10,0;2,0;;;1,0;;;;;3,0;;;1,0;;52,0;;19,0;;;;;3,0;;;;;;;1,0;3,0;43,0;;44,0;;;2,0;;6,0;;;;;;;1,0;;;;9,0;;18,0;2,0;;5,0;;1,0;;;;;;;;;;;;;;;;;3,0;;;5,0;81,0;;;;4,0;;1,0;33,0;;;7,0;;;;;3,0;;;;;52,0;4,0;1,0;;;4,0;2,0;1,0;;;;;;;;1,0;;;;;;;;;;;;5,0;;;;;;;;;;;;;11,0;;;;;;;4,0;;;;;3,0;;;;;;;;;;;1,0;;4,0;;;;2,0;7,0;9,0;;2,0;;2,0;;;;;;;;;;;;;8,0;;;;;1,0;;;;;;12,0;;;2,0;;;;;;;;;3,0;2,0;;;;4,0;81,0;;;;;;;;;;;;;;18,0;;;;;;;;;;6,0;;;;;;;1,0;;;;;;;;;;;;;;;;;;2,0;;1,0;;2,0;;1,0;;1,0;2,0;;;;;;;;1,0;;;;;;;;;;;;;;;;;;2,0;;;;;;;1,0;;3,0;4,0;18,0;;;;;;;;4,0;;;8,0;;;5,0;;1,0;;2,0;;;;16,0;;;;;11,0;10,0;;;;;2,0;;;;3,0;;4,0;;4,0;;1,0;;;;3,0;1,0;4,0;;3,0;;;1,0;;22,0;;;;;;;;;;1,0;5,0;;3,0;3,0;;;;;;9,0;5,0;;;;;;;;;;2,0;;7,0;3,0;;;;;;;;;;;;;1,0;;;;;;1,0;;;1,0;;1,0;;;;;;25,0;;;;;;;;6,0;;;;;;;;;;;;;;2,0;5,0;;;;;;;;;;;;;;;3,0;;;;;;;;;;;;2,0;;;;;47,0;;;;;;3,0;;;;;;;;;;;1,0;;;;3,0;1,0;;;;;;;;;;;;;4,0;;;;;;;;3,0;;2,0;;;;;;;;;;3,0;;1,0;;;;;;;2,0;;;;;;;;;;;;;;;;;;;1,0;5,0;2,0;;1,0;;;;;;;;;;;5,0;;;;;;;;;;;;;2,0;;;;;;;;;1,0;;;;;1,0;;;;;;;;;;;;;;;2,0;;;;;;1,0;;;2,0;12,0;;;7,0;;;;;;;1,0;;;;;;;;;;3,0;16,0;;;;;;;;;;;;;1,0;;1,0;;8,0;;;;;;;;;1,0;;;;;;;;3,0;;;;;;;;;6,0;;;;;;;;;;;;;;;;;;;;;;;;;;;;;;;;;;;;;;;;2,0;;;1,0;1,0;7,0;;;;;;7,0;;;;;;;;;;;;;;;;;;;1,0;;;;;;;;;;;;;14,0;;;;;;;;;;;;1,0;;;;;;;;;2,0;;;;;;;;;;;;;;;;;;;;;;;3,0;;;;;;;;;;;;;;;;;;;;;;;;;;2,0;;;;;;;;1,0;;;;;;;;;;;;;;;;;7,0;;;;;1,0;;;;;;;;;;;;;;;;;;;;5,0;;2,0;;;;;;;;;;;;;;;;;;;;;;;;;;;;;;;;;;;;;;;;;;;;;;;
participant;;;;;;4,0;;;;;;;;15,0;;;39,0;;;;;;;;13,0;1,0;;7,0;1,0;;4,0;2,0;4,0;;;6,0;26,0;7,0;;;12,0;25,0;;;33,0;;;;;;;;;;;;;;;9,0;;;;;44,0;;22,0;;;;;1,0;;;;;;6,0;;2,0;25,0;;4,0;;;;;;;;;2,0;;9,0;;;;;8,0;15,0;39,0;23,0;;;;3,0;;;;;;7,0;2,0;;;;;;;;1,0;;;6,0;;1,0;19,0;;;;11,0;;;2,0;;;93,0;;1,0;;;2,0;;;;;9,0;;12,0;;;;;;;;;;;;;;23,0;;;;;;;;;;7,0;2,0;;;;;1,0;;;;;44,0;;;;;6,0;;;;;;;;3,0;;;;;;;;;1,0;6,0;;;6,0;;8,0;;;;;1,0;;;;;;;;;;3,0;;;;;;6,0;3,0;;;;;;;;;;;;13,0;;3,0;;;;;;;;;;;;;;5,0;2,0;6,0;;;;;;;;;;;;;2,0;2,0;;;;;;;;;;;;;;;;;21,0;;21,0;;;;;;;;;;;2,0;;1,0;;;;;;;12,0;;;;;37,0;;14,0;;;;;;;;;;;;;;;;;;;;;1,0;;;8,0;;;;;2,0;;21,0;;;18,0;83,0;;;;;;;;3,0;;;;;;;;;;;;;;12,0;12,0;;;;73,0;;;;;;;;17,0;2,0;;;8,0;7,0;;;3,0;;;;24,0;;;;;;2,0;;;1,0;;;;;6,0;;3,0;;;;8,0;27,0;;;;6,0;;;3,0;;;1,0;2,0;;;;;28,0;4,0;;1,0;;;3,0;3,0;;;;;;;;;;;3,0;;;1,0;;;;;;8,0;;;1,0;9,0;;;3,0;;;;;;;1,0;;;1,0;;;1,0;;;;3,0;;;3,0;2,0;;;;10,0;;;;10,0;;;;;4,0;3,0;;;;;;;;;3,0;;;;6,0;;;;;;;;8,0;12,0;6,0;;;10,0;;;;6,0;;;;;2,0;;;;;;;;;;;;;;;;;;;;;;;;;;;;6,0;;;3,0;;;;;;;;;;3,0;;3,0;2,0;;;;;;1,0;;;;;;;;;;;;;;;;;;;;;;;;;;;27,0;;;;;;20,0;;;;2,0;;;;;;;;;;;;;4,0;;;1,0;;;;;;;;;;;;;2,0;;;;21,0;;;;;;;;;;;1,0;36,0;;;;;;;;;;;;;;;;;9,0;;;;;;;;;;;;;;;;;;;1,0;;;;;;;;;;;;;;;;;;;;10,0;;;;;;;;;;;;;4,0;;;;;;;;;;;;;;;;;;;;;;;;;;;;;;;;;;;14,0;;;18,0;;;;;;;;;;;;;;;;;;;;;;;;;;;;;;;;;;;;1,0;67,0;;2,0;;;;;;;;;;;;;;;;;;;;;;;;;;;;;;;;16,0;;;;;;;;;;;;;;;;;;;;;;;;;1,0;;;;6,0;1,0;;;;;;;;2,0;;;;;;;;;;;;;;;;;;;;;;;;;;;;;;;;;;;;;;;;;;;;;;;;;;;;;;;;;;4,0;;;;;;;;;;;;;;;;;;;;;;;;;;;;3,0;;;;;;;;;;;;;;;;;;;
partition;;;;;;5,0;10,0;;;;;;;5,0;;;;;;;;;;;;;;;;;1,0;;;;;;1,0;;3,0;2,0;2,0;6,0;;;;9,0;;2,0;;;;;7,0;1,0;20,0;;3,0;;1,0;;;;;;33,0;;7,0;;1,0;;;1,0;34,0;;;;;;;;5,0;;;;6,0;;;2,0;;1,0;;;;;;;16,0;;22,0;;;;;;2,0;;;;;;;;7,0;;;;;8,0;3,0;23,0;;;2,0;1,0;;;5,0;;;;;;;3,0;;;20,0;;;;;;;;;;;2,0;;;;4,0;2,0;;1,0;;;;;;;2,0;;2,0;;;1,0;2,0;;;;;;4,0;;;;2,0;;;;;;2,0;;;;;2,0;;;;;;;1,0;3,0;;6,0;;;;;;;2,0;16,0;;;;;;;;;;;;;;;;;;3,0;;1,0;;;;;1,0;;;1,0;;;;;;;;;;;;1,0;;;;;;;;1,0;;;8,0;;;;;;;18,0;;;;;;;1,0;;;;;1,0;;;;;;;2,0;;;;3,0;3,0;;;;;;;;1,0;;;;;;;1,0;;;;;;1,0;;;2,0;;1,0;;;;;;;;;2,0;;;;;;;;;;;;;;;;;2,0;;;;;;1,0;2,0;;;;;;;;;;1,0;1,0;;;;;;;;;;;;;;;;;;;;;;;;;;;;;1,0;;;;;;;;;;;;;;;;;;1,0;;;;;;;;;;;;;;;;;;;1,0;11,0;;;;;;;;;;;3,0;;;;;;;;;;;;;;;;;;;;;;;;3,0;;;1,0;;;;;;;;;;;1,0;;;;;2,0;3,0;;;10,0;;;9,0;;;;;;;;;;;;;;;;;;;;;;;;;;;;;;;;;;;;;;;;;;;;1,0;;;;;;3,0;;;;;;;3,0;;;;;;;;;;;;;;;;;;;;;;;;;;;;;;;;;;;;;;;5,0;;;;;;;;;;;;2,0;;;;;1,0;;;;;;;;;;;;;;2,0;;;;;;;;;;;;;;;;;;;;;;;;;;;;;;;;;;;;;;;;;;;;;;;;;;;;;;;;;4,0;;1,0;;;3,0;;;;;;;;;;;;;1,0;;;;;;;3,0;;;;;;;3,0;;;;;;;;;;;;;2,0;;;;;;;;;;;;;;;;;;;1,0;;;;;;;;;;;;;;;;;1,0;3,0;;;;;;;;;;;;;;;;;;;;;;;;;;6,0;;;;;;;;;;;;;;;;;;;;;;;;;;;;;;;5,0;;;;;;;;;;;;;;;;;;;;;;;;;;;;;;;;;;;;;;;;;;;;;;;;;;;;13,0;;;;;;;;;;;;30,0;2,0;;;;;;;;;;;;;;;;;;;;;;;;;;;;;;;;;;;;;;3,0;;;;;;;;;;2,0;;;;;1,0;;;;;;;;;;;;;;;;;;;1,0;;;;;;;;;;;;;;;;;;;;;;;;;;;;;;;5,0;;;;;;;;;;;;;;;;;;;;;;
passage;;;;;;12,0;;5,0;;;12,0;;;5,0;;;5,0;;2,0;;;;;;2,0;;;48,0;;;20,0;;;;;;3,0;;;;1,0;11,0;;;6,0;7,0;;20,0;;;;;42,0;;;;28,0;;;2,0;;;;;16,0;;37,0;;;3,0;;10,0;28,0;9,0;;;;;;;3,0;;;;14,0;;5,0;;;;;;;;;;;;4,0;;19,0;9,0;;;;;1,0;;;;;;3,0;;;;;1,0;;6,0;;;2,0;;;;;1,0;;;8,0;;;5,0;;;;;;;;;;;2,0;;1,0;14,0;2,0;2,0;;5,0;11,0;;;;;;;;;18,0;;;;;1,0;20,0;;40,0;;;;9,0;;;;;;;;;;;;;8,0;;;15,0;;;3,0;;4,0;3,0;12,0;1,0;7,0;1,0;;;;;2,0;;1,0;;;1,0;2,0;3,0;;;9,0;;;2,0;;19,0;;6,0;;;4,0;1,0;16,0;3,0;5,0;;2,0;2,0;;;;;;;;2,0;;;;;1,0;;2,0;2,0;46,0;;;;;4,0;;13,0;4,0;6,0;1,0;;;;;;29,0;;;2,0;;;;1,0;2,0;2,0;2,0;;21,0;;;4,0;;;42,0;1,0;;;1,0;10,0;1,0;;;;4,0;;;12,0;1,0;;3,0;;;1,0;;27,0;;;;;2,0;;;;3,0;;;;1,0;;6,0;;;28,0;20,0;2,0;;;;;1,0;1,0;;2,0;;3,0;;;;;1,0;;;;;4,0;;;5,0;81,0;;3,0;;;;;;1,0;;5,0;19,0;;;;;;;;;;;;;;;;;;;;;;3,0;;;;;16,0;1,0;;;9,0;;;;;;;;;;;;;;;;;;;;;;;;;5,0;;;3,0;;;;;;;;2,0;;;;;;4,0;;;;;;;2,0;;;;1,0;;;;;;5,0;;;;;;;;;;;;;;;;;;;;;;;;;;26,0;;;;;4,0;;;;1,0;;;;;;;;;;;;;;;;;;;;;;2,0;;;;;;;;;;;4,0;2,0;;;10,0;;;;2,0;;5,0;;34,0;;;;;2,0;;;;;;;;;1,0;43,0;;;;;8,0;;;;;;;;;;;;;;;1,0;;;;;;;;;;;18,0;;;;;;;;1,0;;;12,0;;;;;;;;;;;;;;;;;;5,0;;;;;;;1,0;;;11,0;;;1,0;;;;;;;5,0;;;4,0;;;;;;;;;;;2,0;2,0;;;;;;;;;3,0;;5,0;;;;;;;;;;;;;;;;;;;;;1,0;;;;;;;;;;;;;;;;;;;;;;;;12,0;;;;;;;;18,0;;3,0;6,0;;;;;;;;;;1,0;;;1,0;;;;;;;;;4,0;;;;;;;;;;;;;2,0;;1,0;12,0;;;1,0;;;;2,0;2,0;;3,0;;2,0;;;;1,0;;;5,0;;;;;1,0;;;;;;;;;;;;;;;;;2,0;;;;;;;;;;;;;;;;7,0;;;;;;;;;;;;;;;;;;;;;;;;;;;2,0;;;;;;;;;3,0;;;;;;;;;;;;;;;;;;;;;;;;;;;;;;;;;;;;;;;;;;;;;;;;;;;;;;;;;;;;;;;;;;;;;;;;;;1,0;;;;4,0;;;;;;;;;;;;;;;;;;;3,0;;;;;;;;;;;;;;;;;;;;;;;;;;;;;;1,0;;;;;;;;;;;;;;;;;;;;;;;;;;;;;;;;;;;;
patient;;;;;;4,0;1,0;5,0;2,0;;;;;44,0;;2,0;60,0;;4,0;;;1,0;;;;;;;2,0;1,0;25,0;2,0;5,0;1,0;;21,0;;1,0;1,0;;5,0;37,0;;;22,0;5,0;;;;;36,0;;3,0;;3,0;6,0;2,0;;;;;;;;144,0;;6,0;;;;;2,0;24,0;;;;1,0;;;;54,0;;;64,0;3,0;4,0;;6,0;;;;;;;35,0;;1,0;;35,0;20,0;21,0;1,0;;5,0;2,0;3,0;;6,0;;23,0;1,0;1,0;21,0;;1,0;;;3,0;;1,0;;;;3,0;;5,0;64,0;;;;;;;;;;34,0;1,0;;;;3,0;;;2,0;;;1,0;7,0;4,0;;;25,0;;;;;;;;;1,0;;4,0;;;4,0;;;3,0;17,0;;7,0;;;;;;;;4,0;;;;;;1,0;1,0;;;2,0;;2,0;;1,0;;8,0;;;14,0;;1,0;;;;6,0;11,0;;6,0;4,0;;3,0;;;;2,0;;;;;;;;;;;23,0;;;;;8,0;;;;;30,0;;4,0;19,0;;6,0;;;;;;5,0;4,0;;;;;5,0;;;18,0;12,0;;;1,0;1,0;;;;;;;;;;;;3,0;;;1,0;4,0;;;;;;;;;;5,0;;;;1,0;;;;2,0;10,0;;;;;;;;;;1,0;6,0;;19,0;;4,0;6,0;;;;4,0;;;10,0;1,0;15,0;3,0;4,0;;;;;2,0;;;2,0;2,0;;22,0;;4,0;;;;4,0;;;;;;;;;;;;;;3,0;16,0;;;4,0;;;;;;;;1,0;;;;;;8,0;4,0;;;2,0;;4,0;;4,0;22,0;;;;48,0;;;;;;1,0;;;;2,0;;;;;;3,0;;2,0;;7,0;;15,0;;;;2,0;;4,0;;;;;;;;4,0;1,0;;5,0;15,0;;;;;;;;;;;6,0;4,0;;;;;;;1,0;2,0;;;2,0;;;;1,0;;;;;3,0;;5,0;;;1,0;;17,0;;;;;;;;;14,0;52,0;;2,0;;;15,0;;;;;1,0;2,0;10,0;;27,0;22,0;;;;1,0;;;;;;;;;;;;;;;;;5,0;;;;;;;1,0;;;;;;;;;;;;;;;;1,0;;;;1,0;;2,0;;;;11,0;1,0;;;;;;;;;;;;;;;;;;;;;;2,0;;;;;;;;1,0;1,0;;;;;;;6,0;;;18,0;1,0;;;;;2,0;;;;;;4,0;;;;;;;;;;;;;;;;;;;2,0;;;;;;;24,0;;;;;;;;;;;;;;;;;1,0;;;;;;;;;;;3,0;;4,0;;3,0;;;2,0;;;;2,0;;;;4,0;;;1,0;22,0;4,0;;6,0;;;;52,0;17,0;;;3,0;;;2,0;;2,0;;2,0;;;;;;;13,0;;;;;;;;;;;;;;5,0;;2,0;;;;;;1,0;;;;;;;2,0;;;11,0;;;;;;;;3,0;3,0;;2,0;;;;;;;;;4,0;;;1,0;;;;1,0;;1,0;;;1,0;7,0;;6,0;;;;;;;;;8,0;;;;;;;2,0;;;;3,0;;;6,0;;;;;;;;;;;;;;;;;;;;;;;18,0;;;;;;;;;;;;;;;;;4,0;;1,0;2,0;;;;;;;;10,0;;;;;;;;;;;;;;;;1,0;;;;1,0;;;;;8,0;2,0;;6,0;;;;;;;;;5,0;;;;;3,0;;;;;;;8,0;;;2,0;;;;;3,0;;;;;;7,0;;4,0;;;9,0;;;;;20,0;;;;;;3,0;;;;;;;;;;;;;;;;;;;;;;;;;;;;;;;;;;;;;8,0;;;;;4,0;;;;;;;;;17,0;;8,0;;;;;;;;;;;;;;;;;;;;;;;;;;;;;;;
perimeter;;;;;;1,0;1,0;11,0;;;;;6,0;3,0;;1,0;3,0;1,0;5,0;;1,0;2,0;3,0;;;;;7,0;;;14,0;;1,0;;;;31,0;;;;4,0;7,0;;5,0;10,0;27,0;;29,0;;;1,0;;15,0;4,0;7,0;;15,0;;;1,0;2,0;;;;27,0;;19,0;;;;27,0;34,0;7,0;2,0;;;4,0;;;3,0;17,0;;;;7,0;;;;;;;14,0;;;;;;1,0;14,0;26,0;11,0;3,0;;;2,0;1,0;;;;;;;12,0;;1,0;;;15,0;1,0;14,0;;;;2,0;;;6,0;;;2,0;;;;2,0;1,0;;6,0;;1,0;;;2,0;;;10,0;3,0;16,0;9,0;9,0;;;;10,0;7,0;;;;;;;8,0;;;;;;9,0;7,0;;2,0;1,0;;1,0;2,0;1,0;14,0;;;;;;;;26,0;;;5,0;2,0;9,0;33,0;;;2,0;;1,0;3,0;18,0;;77,0;;;10,0;;;;;7,0;;4,0;9,0;;;;1,0;1,0;101,0;;1,0;;;6,0;;;;2,0;5,0;54,0;;;;6,0;;;5,0;12,0;1,0;;;;;3,0;11,0;;;13,0;4,0;;15,0;36,0;;7,0;2,0;;5,0;5,0;;4,0;85,0;18,0;;2,0;;;;18,0;5,0;;;;8,0;;;;;;;1,0;6,0;1,0;;;;;2,0;;;;3,0;4,0;1,0;1,0;3,0;;8,0;;;13,0;;;3,0;;52,0;1,0;;;;1,0;;;2,0;;;6,0;6,0;2,0;;9,0;;;4,0;2,0;4,0;10,0;4,0;;;;;;2,0;;1,0;;7,0;;5,0;;2,0;;;2,0;;;;;37,0;1,0;6,0;;;;;;;2,0;1,0;;1,0;3,0;;;;;;;;;;;;2,0;;;10,0;;;;;;;;;;;;2,0;;2,0;;;8,0;;;9,0;4,0;;;8,0;;;;7,0;4,0;;;;;1,0;2,0;;;;;;;;1,0;;;;;;;;;3,0;;;;;;;;;;;;;;;;;;1,0;;;;;5,0;;;;;2,0;;;;;;1,0;;;;4,0;2,0;;;;;;;;;;7,0;;4,0;;;;1,0;;;4,0;;;;4,0;3,0;;;;;;1,0;;4,0;;;;;;1,0;3,0;;;;;;;;;;;;;;1,0;;;;;;9,0;;;;;;;;;1,0;;;;;;;1,0;;;;12,0;;;;;;;2,0;;;;;;;;;;;;;1,0;;;2,0;;;;;;;2,0;1,0;1,0;;;3,0;1,0;;;;1,0;;;;;;;;;;;2,0;;;;;;;;;3,0;;;;;;;;;5,0;;;;;;;3,0;;;;13,0;;;2,0;;;;;;2,0;;;;;;2,0;;3,0;;;;;;;1,0;;7,0;;;;;;;;;;;;;;;1,0;2,0;;;;;4,0;;;;;;;;;;;;;;;;;1,0;;;;;;;;3,0;;2,0;;;;1,0;;1,0;;;;;;;6,0;1,0;;;;4,0;;;;;;;;;1,0;;;;;;;;;;2,0;;;;;1,0;;1,0;12,0;;;;;;1,0;;;;;;;;1,0;;;1,0;5,0;;;;;;;;;;;;;;;;;;1,0;;1,0;;;;9,0;;;12,0;;;;;;;;;;;;;;;;1,0;;;;;1,0;;;;;;;;;;;;;;;;;;2,0;;;13,0;;;;;;;;1,0;;;2,0;;;;;;2,0;;;;4,0;;;;;;;;;2,0;;2,0;;;;;;;;1,0;;;;;;;;;;;;;;5,0;;;;;;;;1,0;;;;;;;;;;1,0;1,0;;;;1,0;;;;;;1,0;;;;;2,0;;;;;;;;;;;;;;1,0;;3,0;;;1,0;;;;1,0;;;;;;;;;;;2,0;2,0;;;;;;;;28,0;;;;;;;;;;;;;;;;;2,0;;;;;;;1,0;;;;;;;;;;;;;;;
photodiode;;;;;;10,0;15,0;2,0;;;;;;;;1,0;2,0;;;;;;7,0;;;;;;;1,0;8,0;;;;;;1,0;1,0;3,0;;3,0;18,0;;3,0;;10,0;;7,0;;;;;;;;;25,0;;;10,0;;;;;16,0;;39,0;;;;;;19,0;;;2,0;;;;;9,0;;;;1,0;;;8,0;;2,0;;;;;;;42,0;;16,0;;;;;;;1,0;;;;;;;41,0;;;;;15,0;;11,0;;;21,0;;1,0;3,0;1,0;;;;8,0;;;6,0;;;;;;;;;;;;;2,0;8,0;;;1,0;;;1,0;;23,0;;;;;;1,0;;2,0;1,0;;7,0;7,0;;;5,0;;;6,0;;;2,0;1,0;;;;;4,0;;;4,0;17,0;;;;;;;;;;;1,0;3,0;;;5,0;;;1,0;;;;;;;;;;;;2,0;;;;;1,0;;7,0;;;1,0;;;;;;;;;;3,0;;;;;;;;;;;;11,0;;;;;;8,0;;;7,0;;;15,0;2,0;2,0;;;;;;;;;;;;;;;;;;;;;;;;;;11,0;;;;;;;;;;;;;;;;;;;;;9,0;;;;;1,0;;;;;;;;1,0;;;;;;1,0;;;;;;;4,0;;;;;;;;;;;;;;;;;;;;;;;1,0;;;;;;1,0;;;;;;;;;5,0;;;;;;1,0;;;;;;1,0;2,0;6,0;;;;;;;2,0;;;;;;;;;;;;;;1,0;;;;;;;;;;;;;;;1,0;;7,0;;1,0;;;6,0;;;;;;;3,0;;;;2,0;;;;1,0;;;;;;25,0;;;;;;;;;;;;;;;;;;;;;;;;;;;;;;;;;;;;;;;;;;;;;;1,0;;;;;;;;;;;;;;;;;;;;;;1,0;;;;;;;;;;;;;;;;;;;;;;;;5,0;;;;;;;;;;;;;;;;;;5,0;;;;;;;;;;;;;4,0;;;;;;;;;;;;;;;;;;;;;;;;;;;;;;1,0;;;;1,0;2,0;;;;1,0;;;;;;;;;1,0;;;;;;;;;;;;2,0;;;1,0;;5,0;1,0;2,0;;;;;;;;;;;;;;;;1,0;;;;;;;;1,0;;;;1,0;5,0;;;;;;;;1,0;;;;;;;;;;;;;;;4,0;;;;;;;;;3,0;1,0;;;;;;;;;;;;;;;;;;;;;;;;;;;;;;;3,0;;;;3,0;;;;;;;;;1,0;;;;;;;1,0;;;;;;;;;;;;;;;;;;;;;;;;;;;;;;;1,0;;;5,0;;2,0;;4,0;10,0;4,0;1,0;8,0;;;2,0;;;3,0;4,0;3,0;;1,0;3,0;;;2,0;;;;;;13,0;;;;;;;;19,0;;1,0;;;;;16,0;;;;1,0;;;;;;;;;;;;;;;;;;;;;6,0;;;;;1,0;;;;;;;;;;;;;;;;;;;;;;;;;;;;;;;;;;;;;;;;;;;;;2,0;;2,0;;1,0;;;;;;;;;;;;;;;;;;;;;;;;;;;;;;;;;;;;;;;;;;;;;;;;;;;;;2,0;;;;;;;;;;;;;;;;;;;;;;;;;;;;;;1,0;;;;;;
photosensitive;;;;;;1,0;31,0;6,0;;;;;1,0;10,0;;;4,0;;;;48,0;;;;;;;21,0;2,0;;8,0;5,0;;;;2,0;6,0;;;;5,0;14,0;;3,0;;14,0;;96,0;;;;;1,0;;;;24,0;;;2,0;1,0;;;;46,0;6,0;35,0;1,0;;;;71,0;36,0;;;3,0;1,0;;;;6,0;;;;19,0;;;60,0;;;;;1,0;;;2,0;15,0;1,0;36,0;9,0;12,0;1,0;;5,0;1,0;2,0;;;;;;;;;;;;5,0;;157,0;;;5,0;;;;9,0;;;1,0;;;;3,0;;;;;;;;;;;16,0;2,0;84,0;7,0;3,0;;;;15,0;4,0;;;;3,0;;;17,0;44,0;;1,0;;;11,0;2,0;;;2,0;;;4,0;;1,0;1,0;;;;;;;;;4,0;12,0;;;;;;1,0;;8,0;14,0;1,0;3,0;1,0;;17,0;28,0;;;4,0;;34,0;;;;1,0;;;;;;6,0;1,0;;40,0;8,0;;;;;;8,0;;2,0;;;;1,0;;;;;;;;24,0;;;;;;2,0;2,0;4,0;;;2,0;;2,0;5,0;;23,0;30,0;;;;;;;;;;;;;;3,0;;4,0;;;;;;5,0;;;;21,0;;;;;48,0;;;1,0;;;;;2,0;4,0;;;;;5,0;2,0;;;;1,0;;5,0;;;;;;;3,0;;2,0;;;9,0;2,0;;2,0;6,0;;;3,0;;;;;1,0;;2,0;;;;;;;;;;;;;;;;;1,0;;;;;10,0;2,0;;;;;;;;1,0;;;;;;;1,0;;;2,0;;;;1,0;;;;;;;;;;;;;1,0;;1,0;;;1,0;1,0;;2,0;;;;5,0;;;;;;1,0;;;;;;;;;;;4,0;;;22,0;;;;;3,0;;;;;;;;;;;;3,0;;;2,0;;;;;;2,0;;2,0;;;;;;;;;;;;;;2,0;;;1,0;;2,0;;;;;;;;;;;3,0;;;;;;;;;;;;;1,0;;;;;;;;;;;;;;;;;;;;;6,0;;;7,0;;;;;;;;1,0;;;;;5,0;;;1,0;;;;;;4,0;;;;;;;;;;;;;;;;;;;;;;;;;;;;;;;6,0;5,0;1,0;;;;1,0;;;;;;1,0;;;;;;;;;;;;;;1,0;;;;;;;;2,0;;;;;;;;;;;;;;;;;;;;;;;;;;;;;;;;;;4,0;;;;;;;;;;;3,0;;;;;;;;;2,0;;;;5,0;;;;;1,0;;;;;;;;;;;;;1,0;;;;2,0;;;;3,0;;;;1,0;;;;;;;;;;;;;;;;;2,0;;;;;2,0;;;;;;;;;;1,0;1,0;;;;;;2,0;;;;;;;;;;;;;;2,0;;;;;;;;;;3,0;;;;;2,0;;;;;;;;;;;;;;;;;;;;;;;;;;;;;;;1,0;;2,0;;;;;;2,0;;;;;;;;;;;2,0;;;;;;;;;;;;;;2,0;;2,0;;2,0;;;;;;;;;;;;;;;2,0;;;;;;;;;;;;;10,0;;1,0;;;;;;;;;;;6,0;;;;;;;;;;;;;;;;;;;;;;;;;;;;;;;;;;3,0;;;;;;;;;;;;;;;;;;;;;;;;;;;;1,0;;;;;;;;;;;;1,0;;;;;;;;;;;;;;;;;;;;;;;;;;;;;;;;;;;;;;;;;;;;;;;;;;;;;
piezoelectric;;;;;;8,0;4,0;;;;;;4,0;1,0;;;;;;;;;;;;;;10,0;;;5,0;;;;16,0;;;;;;;16,0;;;;19,0;;54,0;;;;;6,0;1,0;;;;;2,0;7,0;1,0;;;;3,0;;30,0;3,0;;;;40,0;2,0;13,0;;;10,0;;;2,0;6,0;;;;21,0;;;2,0;4,0;;;4,0;2,0;;;;;;3,0;;1,0;;;;;;;1,0;;;;;1,0;;;;1,0;1,0;;6,0;;;1,0;2,0;;;6,0;;;;;;;9,0;;;;;6,0;;;;;;4,0;7,0;;2,0;;1,0;;;8,0;;;;;;;;9,0;15,0;;;;;11,0;2,0;;;2,0;;2,0;6,0;;;;;1,0;;;;;;;40,0;;20,0;8,0;;;;1,0;;2,0;;;;1,0;;;16,0;;;;;30,0;;2,0;5,0;8,0;6,0;;;;;;;;;;;;;;;5,0;;;3,0;;;;;;;;;;;;;;;;;;3,0;21,0;;;;27,0;;1,0;2,0;5,0;13,0;;;;4,0;;1,0;;;;;;;;;111,0;;;;;;2,0;;;;2,0;;;;;2,0;;;1,0;;;3,0;;;;2,0;;;;;9,0;;;;;;;10,0;;;;;;;;15,0;;4,0;;2,0;10,0;;;;;;3,0;;;;;;;;;2,0;;;;;16,0;;;;3,0;2,0;;;;;;39,0;;;;;;;;;;;;;;;;;;;;;1,0;1,0;;;;;1,0;;;;;1,0;;;;;;;;;;;;;;;3,0;;;7,0;;;;;32,0;9,0;1,0;3,0;;;;;;;;;;;;;;;;4,0;;;;;;2,0;;;;;;;;;;;;;;;;;;17,0;;;;;;;;;;;;;;;;;;;;;1,0;;;;;2,0;;;;;;;1,0;;;;;;;;;;;;;;;;;;;;;;;;;;;;;;;;11,0;;;;;;;;;;;;;;;;;;;;;;;;;;;2,0;;;;;;;;;;;;;;;;;;;;;;;;1,0;;;;;;;7,0;;;;;;;;;;;;;;;;;;;;;;;;;;;;;;;;;;;;;2,0;;;;;;;;;;;;;;;;;;;9,0;;;;;;;;;;;;;;;;;;;;;;;;1,0;;;;;;;;;;;3,0;;;;;1,0;;;;;;;;;;;;;;;;;9,0;;1,0;;;;;;6,0;;;;;;;;2,0;2,0;;;;;;;;;;;;;;;;;;;;;;;;;;;;;;;;;;;;;;;;;;;;;;;;;;;2,0;;;;;;;;;;;;;;;;;;;;;;;;;;;;;;;;;;;;28,0;;;;;;;;;;;4,0;;;;;;;;;;;;;;;;;;;;;;;;;;;;;;;;;;;;;;;;;;;;;;;;;;;;;;3,0;;;;;;;;;;;;;;;;;;;;;;;;;;;;;;;;;;;;;;;;;;;;;;;;;;;;;;;;;;4,0;;4,0;;;;;;;;;;2,0;;8,0;;;;;;;;;;;;;;;;;;;1,0;;;;;;;;;;;;;;;;;;;;;;;;;;;;;;;;1,0;;;;;;;;;;;;;;;;;;;;
plug;;;;;;18,0;3,0;;;;;;;12,0;;;;;;;;;;;;;;12,0;;;29,0;;;;;1,0;1,0;;;;1,0;31,0;;7,0;;1,0;;7,0;;;;;9,0;1,0;;;19,0;;2,0;;;;1,0;1,0;;1,0;22,0;;;;;10,0;19,0;;;;;;;;16,0;;;;11,0;;;;;;;;3,0;1,0;;;5,0;;22,0;;19,0;;;;;;;;;;;;43,0;;;;;;;10,0;;;3,0;;;;15,0;;;;;;;;;;;;;1,0;;;;;17,0;;;41,0;1,0;7,0;;7,0;4,0;2,0;;4,0;2,0;;;2,0;23,0;56,0;;;3,0;;9,0;2,0;;1,0;;;;5,0;;3,0;1,0;1,0;1,0;;;;2,0;1,0;;34,0;3,0;;1,0;8,0;;;;;;2,0;10,0;;10,0;8,0;19,0;22,0;;;;;2,0;2,0;;11,0;;;;55,0;;29,0;;2,0;;;2,0;;;3,0;;;12,0;;;;;;;;4,0;;;;6,0;;;;;;6,0;;1,0;;9,0;12,0;1,0;;;;8,0;10,0;1,0;30,0;2,0;;;2,0;;38,0;4,0;;;;;;;6,0;;;3,0;2,0;1,0;;6,0;;;;;5,0;;;;3,0;5,0;;;;;;;;4,0;;2,0;;2,0;;;;;;;;;1,0;;3,0;;;;;2,0;6,0;;;;1,0;1,0;;;;;1,0;15,0;1,0;;;6,0;4,0;;;2,0;1,0;;;;;1,0;4,0;;6,0;;3,0;;;;;;;;;;5,0;9,0;;;;;;;;;;;;;;;4,0;1,0;;;;;;3,0;;;;;1,0;;;;;;;;;;;;;;1,0;;;3,0;1,0;;;;1,0;;1,0;;;;2,0;;;;;;;;;1,0;;;5,0;;;;;;;;;;;;;;;;6,0;;;;;;;7,0;;;2,0;;;3,0;5,0;;1,0;;;;1,0;;2,0;;;;;;;;;;4,0;;3,0;;;;;1,0;;2,0;;;;;1,0;;;;;;;;2,0;;;;;;;;;;;;;;;;;4,0;;;;;1,0;3,0;14,0;25,0;11,0;;;;;;;;;;;;;;;;;1,0;;;;;8,0;;;;;3,0;;;3,0;;;;;;;;;;;;;;;;;;;;;;;6,0;;;;;;;;;7,0;;5,0;;;;;;;;;;;;;;;;;;;;;;8,0;;5,0;;;;;;;;;;;;;;;;;;;;;;;;;;;;;;;;;1,0;;4,0;;;;;13,0;;;;;5,0;2,0;;;;;;;;1,0;2,0;2,0;;;;;1,0;;;;;;;;;;;1,0;;;;;3,0;;;;;;;;;134,0;;;;8,0;1,0;;;;;;;;;;;;;;;;;2,0;;;;;1,0;;;;;;;;;;;;3,0;;;;;;;;;;;;1,0;;;;;;;;;;;;;;10,0;;;;;;;;;;;;;;1,0;;;;1,0;4,0;;;;;4,0;;;;;;;;;;;1,0;2,0;;;;;1,0;12,0;;;;;;;;;;;;;;21,0;;;;;;;;;;;;;;;17,0;;;;;;;;;;1,0;;;;;;;;4,0;;;;;;;;;;1,0;;;;;;;;;;;;;;;;;;;;;;;;;;;;;;;;;;;;;;;;;;;;;;;;;;;;;;;;;;17,0;;;2,0;;;;;;;;;;;;;;12,0;;;;;2,0;;;;;;;1,0;;;;;;;;;;;;;;;;;;;;;;;37,0;;;5,0;;;;;;;;;;;;;;;;;;;;;;;;;;;
positional;;;;;;4,0;;3,0;3,0;8,0;;;;29,0;;;7,0;;;;;;1,0;;;;;17,0;2,0;1,0;7,0;1,0;7,0;4,0;;64,0;2,0;;;;38,0;26,0;;1,0;8,0;;;9,0;;1,0;3,0;;;16,0;;;1,0;;;6,0;;;4,0;;56,0;;19,0;;;;1,0;6,0;2,0;;;1,0;2,0;1,0;;;22,0;;;;3,0;;;8,0;;;30,0;;;4,0;1,0;;30,0;1,0;12,0;17,0;41,0;55,0;;12,0;3,0;1,0;;2,0;;;;22,0;;5,0;;;1,0;1,0;;27,0;1,0;7,0;10,0;;;8,0;10,0;;;;12,0;;;9,0;;;;10,0;;;;;1,0;;;1,0;2,0;3,0;6,0;;;;;1,0;;;;;;;;;;;;;6,0;;;6,0;;12,0;;7,0;;;;;1,0;;;1,0;;2,0;;;1,0;;13,0;;;;;;;;;;;;;;;;4,0;;2,0;;;1,0;;1,0;;;;;14,0;;;2,0;13,0;;3,0;;7,0;;1,0;;;1,0;;4,0;2,0;;;;;;;12,0;;;;;;;5,0;7,0;;;;;;1,0;;9,0;;9,0;;;;4,0;;20,0;;;;;4,0;;;;2,0;1,0;;;;;;4,0;;;;2,0;2,0;;;;2,0;;;11,0;;;;;1,0;;;;;;;;;4,0;;2,0;9,0;5,0;;;;;;;3,0;;;1,0;2,0;50,0;;;;;;;;;;;;1,0;1,0;;2,0;;;;;4,0;19,0;;;;;;;;;;;;2,0;;1,0;;;2,0;;;2,0;;2,0;15,0;1,0;;;;;;3,0;2,0;12,0;5,0;;;2,0;;12,0;32,0;;16,0;7,0;9,0;1,0;8,0;;;;;;;;;;10,0;7,0;;;5,0;;;;6,0;;3,0;;2,0;;;;4,0;2,0;6,0;;6,0;4,0;;;;;15,0;;11,0;;;;;13,0;;3,0;;;;1,0;7,0;;;;24,0;;;;;;1,0;2,0;2,0;;;;;;;;17,0;;;8,0;;;;;;;;;;;;;1,0;;;;;;;;3,0;;;;;1,0;;;20,0;;;1,0;;2,0;;;;;;;;;1,0;6,0;2,0;;;;1,0;1,0;3,0;;;;3,0;;1,0;;;;;;;;;;;;;;;;;7,0;;3,0;;2,0;9,0;;;;;1,0;;;;;;;;;;1,0;;;;;;3,0;;;;;;;;;5,0;;;;;;;;;1,0;;;;;;;;;;;;;;;;;;;;;;;;;5,0;;;;;14,0;;;;1,0;2,0;;;;;2,0;;1,0;;;2,0;;;;1,0;;;;;;;;;;;1,0;;;;13,0;;;;1,0;;;;;;;;106,0;;;;;;;2,0;;;;;;;;;6,0;;;;;;;;;;;;;1,0;;1,0;;;;;;;;;;;;;;;;;2,0;2,0;;;3,0;;;;;;2,0;;;;;;;;1,0;;;;;;;;2,0;;;;;;33,0;;;;;;;;;;;;2,0;;;;;;;;;;;;;;;;;;;1,0;;;;;2,0;;1,0;;;;;;;;;;;;;;;;;;5,0;14,0;17,0;;;;;;;;;;;;;;;;10,0;;;;;;;;5,0;;;;;2,0;;;;;;;9,0;;;;;;;10,0;;;;;;2,0;;;;;;;;;1,0;;;;;;;;;;;;;;;;;;;;1,0;11,0;;4,0;;;;;;;;;;;;1,0;;;;;;;;;;;;;;;;;;;;;;;;;;;;;;;;;;;;;;;;;;;;;;;;;;;;;;;;;2,0;;;;;;;;;;;;;;;;;;;;;;;;;;;;;;;;;;;;;;;;;1,0;;;;;6,0;;;;;;;;;;;
presence;;;;;;3,0;;1,0;;1,0;;;;39,0;;;9,0;;;9,0;;;;1,0;;;;2,0;1,0;6,0;19,0;11,0;;;;4,0;;;;2,0;67,0;23,0;;1,0;8,0;;1,0;1,0;;;;2,0;1,0;;9,0;;;;2,0;3,0;;;;1,0;63,0;;21,0;;1,0;;;3,0;18,0;;;1,0;;;;;46,0;;;;4,0;;1,0;2,0;;2,0;6,0;;;;6,0;;7,0;;18,0;1,0;;14,0;;2,0;6,0;19,0;;1,0;;;;7,0;5,0;;1,0;;1,0;;13,0;40,0;;1,0;5,0;1,0;;2,0;55,0;;;;5,0;;;3,0;;;11,0;;;;;1,0;;;;2,0;9,0;2,0;9,0;;;;1,0;;;;;16,0;;;;1,0;;;;;;4,0;;12,0;3,0;;;2,0;;;3,0;;;;;10,0;;19,0;;;;;;1,0;;;;;;1,0;;;;;;1,0;;;1,0;;2,0;;;;1,0;3,0;;;;1,0;2,0;;;3,0;5,0;;40,0;;;;;;;1,0;4,0;;;;;6,0;;3,0;;;;;;;;4,0;;;7,0;;;;;7,0;1,0;;;10,0;;;;2,0;1,0;43,0;6,0;2,0;;4,0;;;1,0;;;1,0;;;;;;;;;;;;;;1,0;1,0;;3,0;;;;;;3,0;4,0;;;;1,0;;2,0;;;;2,0;;32,0;;;2,0;;;;7,0;;2,0;;10,0;73,0;2,0;;;;;;3,0;;;;;;;;;2,0;;;5,0;;;;1,0;;;1,0;;;;;;;;;;;11,0;4,0;5,0;;1,0;;3,0;;1,0;;;;;;;;3,0;;;;6,0;;1,0;;;;6,0;163,0;4,0;1,0;;4,0;2,0;;;;;;;18,0;25,0;3,0;;;;1,0;;4,0;;2,0;9,0;2,0;;4,0;;;1,0;;;;;1,0;;;;;2,0;7,0;5,0;29,0;4,0;;5,0;;;2,0;;;;4,0;;;;;3,0;;;;;1,0;5,0;;1,0;;2,0;;;;;;;;;;;;;;5,0;;;;13,0;4,0;8,0;;;2,0;;;;3,0;2,0;1,0;;3,0;3,0;;;2,0;;;;;;;;;;5,0;;;;3,0;;1,0;3,0;;4,0;;;;1,0;;;;;;;;;;3,0;;;;;1,0;1,0;;;;;;;;;;3,0;;;;;;;;;;;;;;2,0;;2,0;1,0;;;;;;;;;2,0;1,0;;4,0;;;;;;;;;;;;1,0;;;;;;;2,0;;;;4,0;1,0;;;;;1,0;;;;;;;4,0;;1,0;;;3,0;;;3,0;;;;;;;15,0;6,0;1,0;4,0;;;6,0;;;;;;;;;;;;7,0;;;;;;;;;;11,0;2,0;;;;;;;;;;;;;;;;1,0;1,0;;;;;;;;3,0;1,0;;6,0;;4,0;;;7,0;;;1,0;1,0;;1,0;;;;;3,0;;;;;;;;;;;2,0;;;;;;;6,0;;;;;;;;1,0;;;;;;;;;1,0;;;;6,0;1,0;;;;;1,0;;2,0;;;;8,0;;;;;;;;;;;;;;;;;;;;;;;;;;;;;;;;9,0;;;;4,0;;1,0;;;;;;;5,0;;;;;;;;;;;;;;;;;;;;;;;3,0;;;8,0;;;;;;1,0;;;;2,0;7,0;3,0;;;;;;;;;;;;;;;;7,0;;;1,0;;;;;;;;;;1,0;;;;2,0;6,0;;;;;1,0;;;;;;;;;;;;;;;;;;2,0;;4,0;;;;;;;;;;;2,0;;;;;;;;;;;;;;;1,0;;;;;;;;;;1,0;;;;1,0;;;;;;1,0;;;;;;;;;;;1,0;;;;;;;;;;;;;;;;;;;;;;;;;;;3,0;;;4,0;;;;;;;;;;;;;;;;;;;5,0;;;;;;4,0;;;;;
press;;;;;;7,0;;2,0;;;1,0;;1,0;16,0;;;9,0;;4,0;;;;2,0;;;;;13,0;;;30,0;;;;;;;;;;7,0;15,0;;1,0;;2,0;;34,0;;;;;12,0;6,0;;2,0;4,0;;;12,0;;;;;14,0;;15,0;;;;;25,0;3,0;;;;2,0;;;1,0;18,0;;1,0;;17,0;23,0;;6,0;1,0;;;4,0;;;;;;;12,0;6,0;23,0;4,0;;1,0;2,0;5,0;;1,0;;;;;;;;;;8,0;;14,0;;1,0;;;;2,0;8,0;;;;16,0;;;10,0;;2,0;1,0;;;;;2,0;;;;;4,0;1,0;3,0;7,0;9,0;;9,0;2,0;1,0;;;;;;4,0;1,0;;;;;5,0;;;;;;;30,0;1,0;;3,0;;2,0;;1,0;;1,0;;2,0;;3,0;15,0;31,0;4,0;;2,0;;13,0;12,0;1,0;27,0;;2,0;1,0;;;;11,0;4,0;1,0;78,0;;37,0;8,0;35,0;;1,0;;;1,0;;1,0;;;;;;;6,0;;154,0;8,0;2,0;;6,0;;;;;;;;;;1,0;6,0;3,0;;3,0;;;;7,0;6,0;;;;7,0;5,0;1,0;30,0;45,0;;;;13,0;;9,0;2,0;;;;;2,0;2,0;1,0;;;;;1,0;;;;2,0;;9,0;2,0;;;2,0;2,0;5,0;;;;1,0;;;;2,0;;14,0;1,0;2,0;8,0;2,0;;;8,0;1,0;5,0;;2,0;5,0;;2,0;2,0;1,0;;2,0;;;6,0;3,0;1,0;1,0;1,0;;3,0;;;9,0;14,0;6,0;;4,0;1,0;2,0;;6,0;2,0;1,0;;8,0;2,0;;2,0;10,0;;;4,0;;8,0;;;;;;;2,0;2,0;3,0;;;;;;;6,0;;;;2,0;3,0;;;;;;;;;;7,0;;;;;5,0;;;;15,0;;;;3,0;;;1,0;;;5,0;;9,0;;;;1,0;;1,0;;;2,0;1,0;;2,0;13,0;;;;;;;;2,0;;;29,0;;;;;;;;3,0;;;1,0;;20,0;;;19,0;;1,0;;;;;12,0;;;;1,0;;7,0;;;;2,0;;;;;;2,0;;;;;;;;;3,0;;;;1,0;;;;;;;;;;;1,0;;;;;;;;;;;;;;;;;;;;;;;;49,0;;1,0;;;;;2,0;1,0;2,0;;;;;;;;;;1,0;;1,0;;;;;;;;;;1,0;;2,0;;;;;;1,0;;;;;;;;;;2,0;;6,0;;;;;;;;;;11,0;3,0;;;;3,0;;;;;;;;2,0;;;;;;;;;;;;;;;;;;1,0;;3,0;;;;;;;2,0;1,0;;;;;6,0;;;;3,0;;;;;;;;;;;;;;;;;;;;;;;;;;;;;;;;;;;;;;;;;8,0;;;;;;;4,0;;;;;;;;;;;;;;7,0;;;1,0;3,0;;12,0;;;3,0;38,0;;2,0;;;;;;;4,0;;4,0;1,0;;;;11,0;;;;;;;1,0;;1,0;;2,0;;;;;;;;;;;;1,0;;1,0;1,0;;;;1,0;;;;;;;3,0;;4,0;;;;;1,0;1,0;;;;5,0;;4,0;;6,0;;;;8,0;;;;1,0;4,0;;;;2,0;2,0;;;;;;;;;;;;;;;;;;;;;;;;;1,0;;;;;;;;;;;1,0;;;;;;2,0;;;;;3,0;;;;;;;;;;;4,0;;1,0;;;;;;;;;;;;;;;;;;;;;;;;;;;;;;;;;;;;;;;;;;;;;;;;;;;;;;;;;;1,0;;;;;;;;;;;;1,0;;;;;3,0;;;2,0;;;;;4,0;;;;;;;;;;;1,0;;;;;;;;;;;;;;;;20,0;1,0;;1,0;;;;;2,0;;;;1,0;;;;;;8,0;;;;;;;;;;;;;;;;;;;;;;;;;;;;;;;;;
printer;;;;;;2,0;;4,0;;;;;;;;;;;;;;;;;3,0;;;;6,0;;14,0;10,0;;;;1,0;;;;;;18,0;;4,0;1,0;;;;;;;;;;;;2,0;;;3,0;;;4,0;;5,0;;4,0;;;;;12,0;;;;;1,0;;2,0;;2,0;;1,0;1,0;;;;2,0;;;;;;;3,0;;;;1,0;;6,0;2,0;;2,0;3,0;3,0;;;;;;;;;;;;;1,0;2,0;;;;1,0;;;;;1,0;;;1,0;;1,0;;;;;;;;;;;;;;;;;;;;;;;;;;;;2,0;;;;;;;;;;;;;;;;;;;;;;;;;;;;;;;;;;;;;;;;;;;;;;;;;2,0;;;;;;5,0;;;;2,0;;;;;;;;;;;;;;;;;;;;;;;;;2,0;;;;;;;;;5,0;1,0;;1,0;;;;;;;;;;;;;;;;;;;;;;;;;1,0;;;;;;;;;;;;;;;;;;;;;;;;;;;;;;;;;;;;;;;2,0;1,0;;;;;;1,0;8,0;;;;;;;;;;;1,0;;;;;;;;;;;;;;;;;;;3,0;;;;;;;;;;;;;;;1,0;;;;;;;;;;;2,0;;;;;;;;;;;;2,0;;;;;1,0;;;;;1,0;;;;;;2,0;;;;;;;;;;;;2,0;;;;1,0;;3,0;;;;;;;;;;;;;;;;;1,0;1,0;;;;;;;;;;;;2,0;;;;;;;;;;;;;;;2,0;;;;;;;;;;;;;;;;;;;;;;;;;;;;;;;;;;;;;;;;;;;;;;;;;;;;;;;;;;;;;;;;;;;;;4,0;;;;;;;;;;;;;;;;;;;;;;;;;;;;;;;;;;;;;;;;;;;;;;;;;;;;;;;;;;;;;;;;;;;;;2,0;;;;;;;;;;;;1,0;;;;;;;;;;;;1,0;;1,0;;;;;;;;;;;;;;;;;;;;2,0;;;;;;;;;1,0;1,0;;;;;;;;;;;;;;;;;;;1,0;;;;;;;;;;;;;;;;;;;;;;;;;;;;;;;;;;;;;;;;;;;;;;;;;;;;;;;;;;;4,0;;;;;;;;;;;;;;;;;;;;;;;;;;;;;;;;;;;;;;;2,0;;;;;;;;;;;4,0;;;;;;;;;;;;;;;;;;;;;;;;;;;;;;;;;;;;;;;;;;;;;;;;;;;;;;;;;;;;;;;1,0;;;;;;;;;;;;;;;;;1,0;2,0;;;;;;;;;;;;;;;;;;;;;;;;;;;;;1,0;;;;;;;;;;;;;;;;;;;;;;;;;;;;;;;;;;;;;;;;;;;;;;;;;;;;;;;;;;;;;;;;;;;;;;;;;;;;;;;;;;;;;;;;;;;
priority;;;;;;3,0;4,0;;;;;;;55,0;;;14,0;;;;;;;;1,0;;;;1,0;2,0;5,0;;;2,0;;32,0;2,0;;5,0;;30,0;30,0;;1,0;12,0;;;;;;;;;1,0;;;3,0;;2,0;4,0;;;;;108,0;;20,0;;;;;14,0;4,0;;;;;;;1,0;25,0;;27,0;3,0;;;;3,0;;30,0;;;1,0;;;;;;27,0;5,0;2,0;10,0;;4,0;5,0;13,0;;;;;;;21,0;;;;1,0;2,0;;4,0;;;14,0;2,0;;;17,0;;;;1,0;;;9,0;;;8,0;;1,0;;;;;;2,0;;5,0;;12,0;;;11,0;;;;;;;;;;;;;;;;;;1,0;;;4,0;6,0;;;1,0;;;10,0;;;;;;;;;;;;;;;;;;;;;;;;1,0;;2,0;;;;;;;;;;;3,0;;1,0;;;1,0;;;;;;;;;;;;;;1,0;;;;;;;;;;16,0;;;2,0;;;;;;;;;;;;;16,0;13,0;2,0;;;;;;;;;;;;;;2,0;;3,0;;;3,0;8,0;1,0;;;2,0;1,0;;;;;;;;5,0;;;;;;;;;;;;;;;;;;1,0;;;;1,0;;;22,0;;6,0;;;;;;;;;;;4,0;;6,0;;;;1,0;;;;;;;;;;;;;;2,0;;;;19,0;;;;;;;2,0;1,0;;;;;;12,0;;1,0;;;;2,0;1,0;30,0;;;;;12,0;;;;;;;;6,0;;6,0;;;4,0;;;;;4,0;;;;2,0;3,0;;;1,0;;2,0;20,0;;;;;;;;;;;10,0;;4,0;;;;;6,0;;2,0;;7,0;2,0;5,0;;;;;;;;;;1,0;;;;1,0;;;;;;;1,0;1,0;;;;;2,0;;;;;;2,0;;;;;;;1,0;;;;6,0;;;;4,0;;;;1,0;;2,0;;;;1,0;2,0;;;;13,0;;;;;6,0;;;40,0;2,0;;;;;;;3,0;;;;;;;;;;;;;;;;;;;;;;;;;;3,0;;;;;;;;;;;10,0;2,0;;;;;;;42,0;;1,0;;;;1,0;1,0;;;;;;;;1,0;;;;;;;1,0;;;;;;;;3,0;2,0;;;3,0;;;;;;;55,0;;1,0;;;;;;;;;;;;;;;;1,0;;16,0;;;;;;;;;;3,0;;;;;;;;;;;;;;;;;;;;;;;;;;;;4,0;;1,0;;;;;;;5,0;;;;17,0;;;;1,0;;;;;4,0;;;;;;;;;;;1,0;;;;;;;;7,0;;2,0;;;;;;;;;;;;;;1,0;;17,0;;;;;;;;;3,0;;1,0;;;3,0;;;;;;;;;;;;;;;;;;;;;;;;;;;;;;;;;;;;;;;;;;;;;;;;;;;;;;;;;;1,0;;;;;;;;;;;;;;;;;;;;;;;;;4,0;;;;3,0;;2,0;;;;;;;;;;;2,0;;;;;;;;5,0;;;;;;;;;;;;;;;;;;;;;;;;;;;;;;;;;;;;;;;;;;;2,0;;1,0;;;;;;;;;;3,0;;;;;;;;;;;;;;;;;;;;;;;;;;;;;;;;;2,0;;;;;;;;;;;;;;;;;;;;;;;;;;;;;;;;;;;;;;;;;4,0;;;;;;;;;14,0;;;;;;;;;;;;;;;;;7,0;;
proximal;;;;;;8,0;;13,0;1,0;;6,0;;1,0;19,0;;;;;10,0;;;;;;4,0;;;7,0;;;10,0;;;;;1,0;4,0;3,0;;;;10,0;11,0;1,0;4,0;20,0;;18,0;;;;;30,0;;2,0;;11,0;1,0;;;;;;;4,0;;22,0;;;;11,0;12,0;12,0;;;;4,0;;;;2,0;;;;6,0;2,0;1,0;2,0;;;;;;;;;1,0;;13,0;5,0;11,0;;;;2,0;7,0;;;;;;;1,0;;;;;1,0;;6,0;;;;;;;9,0;;;;;;;17,0;;;2,0;;;;2,0;;;;5,0;3,0;;5,0;1,0;9,0;;;9,0;;;;2,0;;;;2,0;23,0;;;;;26,0;1,0;;;;;;1,0;;18,0;;1,0;;;2,0;;;;;;1,0;3,0;6,0;3,0;;1,0;;2,0;1,0;2,0;78,0;;14,0;3,0;;;;;;;30,0;;;17,0;;2,0;;;;5,0;;3,0;;;;;;;4,0;;33,0;;;;3,0;;;;;;;;4,0;;;1,0;10,0;3,0;4,0;;;3,0;27,0;6,0;;;;2,0;;;27,0;46,0;;;;;;;9,0;;;;;2,0;;;;7,0;;;;1,0;4,0;;;;6,0;;;;2,0;1,0;;;;;4,0;3,0;;182,0;;;;18,0;1,0;2,0;3,0;;2,0;7,0;29,0;2,0;9,0;;;3,0;2,0;;;;11,0;1,0;;1,0;;1,0;7,0;;;;;4,0;;;;;2,0;;;9,0;;7,0;;3,0;;9,0;;4,0;2,0;8,0;5,0;4,0;;1,0;;11,0;;;;48,0;;2,0;4,0;;;;;;;2,0;;;;;;;;1,0;1,0;;;;;;2,0;;;;;;;;;;;;;;;;;;;;;;1,0;1,0;2,0;1,0;;2,0;12,0;3,0;;;;;;;;;;;;;;;;2,0;;;;;;;;;;;1,0;;;;;;;;;;;;8,0;;;;;2,0;;;;;;;;;;;;;;;;;;;;;3,0;;;;;4,0;;;;;;;;2,0;;;;;2,0;1,0;4,0;;;;;;;;;;;4,0;;;;;;;;;;;;;;1,0;2,0;18,0;;;;;3,0;;10,0;;;;3,0;;;;;;1,0;;;;;4,0;;;;;2,0;;;;;;;;;;1,0;;;;;;;;;;;;;1,0;;;;;;;5,0;;;;;7,0;;3,0;7,0;;;;;;;;;;;;;;;;;;;;;;;;;;;;1,0;2,0;;2,0;;1,0;;;;;;;;;;;;;;;;;;;;;;;1,0;;;;;;;1,0;;;;;;;;;;;;;;;;;;;;;6,0;;9,0;;;;;;;;;;1,0;;;;;;;;;;;;;5,0;;2,0;;3,0;2,0;;;14,0;;8,0;10,0;;2,0;;;;1,0;;1,0;1,0;;;;;;7,0;;;;4,0;;4,0;;1,0;;;;8,0;24,0;;;15,0;;2,0;;6,0;1,0;;;2,0;;;1,0;;1,0;;;;;14,0;;;3,0;26,0;12,0;;;;1,0;;;;2,0;;;;;;;;;;;;;;;;1,0;;;;;;;;;;;;;;;;;;;;;;;;;;;;;;;;;;;;;;;;;;;;;2,0;;;;;;;;;;;1,0;;;;;;;;;;;;;;;;;;;;;;;;;;;;;;;;;;;;;;;;;;;;;;;;;;;;;;;;;;;;;;;;;1,0;;;;;;;;;;1,0;;;;;;;;;;;;;;;;;;2,0;;2,0;;;;;;;;;;;2,0;;;;;;;15,0;;;;1,0;;;;;;;;;;;;;;;1,0;;;;;;;;;;;;;;;;;;;;;;;;;;;
radius;;;;;;9,0;13,0;2,0;;;13,0;;2,0;24,0;;;6,0;;1,0;;;5,0;1,0;;;;;;;25,0;;;1,0;;;;8,0;4,0;15,0;;22,0;10,0;1,0;;;;3,0;24,0;;;;;2,0;;2,0;13,0;5,0;;;1,0;;;6,0;;129,0;;4,0;8,0;;;15,0;292,0;;1,0;;;9,0;;;;5,0;2,0;;;1,0;;;9,0;;;;;;;2,0;;6,0;;1,0;22,0;3,0;12,0;;;;1,0;;;;;;;21,0;1,0;;;;1,0;2,0;8,0;;;3,0;5,0;;1,0;19,0;3,0;;5,0;4,0;;;6,0;;;;;;;;;;;;;12,0;3,0;;1,0;;;4,0;;;;4,0;;;;;;;;;;;1,0;;3,0;;;;8,0;6,0;4,0;;;;;;;;10,0;;;;;1,0;;;;;;4,0;2,0;2,0;;5,0;;;;1,0;;;1,0;;;;14,0;;;;;;16,0;;;6,0;2,0;;;;;;;10,0;;;;;;24,0;12,0;2,0;;;;;30,0;;12,0;;;;;;7,0;247,0;;3,0;;;;1,0;;;243,0;;;;;;1,0;;;;;;1,0;3,0;;;2,0;;;;8,0;;;;;19,0;2,0;;;;;2,0;14,0;;;;3,0;;;27,0;;;;;;;;;;;;1,0;1,0;;;2,0;;;;;;1,0;;;92,0;;;;1,0;;;2,0;;;;;7,0;;;;;;;;1,0;1,0;;;;3,0;;;;;;;;;;;2,0;;;2,0;;;;;;;;;;;;1,0;22,0;4,0;1,0;;;;;;1,0;;;4,0;;;;;;;;;2,0;;4,0;1,0;;3,0;;;1,0;;;;8,0;;;;;;;;;;;2,0;1,0;;;;;;;;;;;;;8,0;;1,0;;1,0;1,0;;;;;;;3,0;;;;;;2,0;;;;;2,0;;;;;;1,0;;;;;;;1,0;;;;;1,0;;;;;;3,0;;;1,0;;;;;;1,0;;;1,0;;;;;;;;;;;2,0;;;;;;;;;;;;;;;;;;;;2,0;;;;;;;;;;;;;;;;2,0;;;3,0;;1,0;3,0;1,0;;;;;;;;;1,0;;;;;;;;;;;;;;;;;;2,0;;;;;;;;;;;;;;;;;;;;;;;;;;;;;;;;;;;;;;;;;;;;;;;;;3,0;;;;4,0;;;;;;;;;;;;;;;;;;;;;;;;;;;;;;;;;;;;;;;;;;;;;;;;;;;;;;;;;;;;;;;;;;;;;;;;2,0;;4,0;;;;;1,0;;;;;;;;;;;1,0;;;;;;14,0;;;;;;;;;;;;;;15,0;;;;;;;;;;;;1,0;;;;;1,0;;;;;4,0;;;;;;;;;;;;;;;;;;;;;;;;;;;2,0;;;;;1,0;;;;;;;;;;;;;;;;;;;;;;;;;;;;9,0;;;;;;;;;;;;;;;;;;10,0;;1,0;;;;;;;;;;;;;;;;;4,0;;;;;;;;;;;;;;;;5,0;;;;23,0;;2,0;;;;;;;;;;4,0;;;;;340,0;;;;;;;2,0;;;;;;;;;;;;;;;;;;;;;;;;;;;;;;;;;;;2,0;;;;;;;;;;;19,0;;11,0;;;;;;;;;2,0;;;;;;;;;;;;;;4,0;;;;;;;;;;;;;;;17,0;;;;;;;;16,0;;;1,0;;;;;;
ramp;;;;;;5,0;;;;;;;;12,0;;;;;;;;;;;;;;;;;32,0;1,0;;;;3,0;1,0;;;2,0;;15,0;;4,0;;;;1,0;;;;;2,0;;;;;;;27,0;;;;;4,0;;8,0;1,0;;;;;1,0;;;2,0;;;;;11,0;;;;1,0;;;;;;;;;;;;4,0;;5,0;7,0;;2,0;;;4,0;1,0;;;;;;17,0;;;;;;4,0;;4,0;;;145,0;;;;1,0;;;;15,0;;;7,0;;;;;;;;;;;;;3,0;1,0;;;;;;;;;;;;;;;;1,0;5,0;;;;2,0;;;;;;1,0;;;;;;;;;;;;;;;;;;;;;;;;1,0;;;;;;3,0;;;;;2,0;1,0;;;;;;20,0;;;;;13,0;;;6,0;;1,0;;;;;;1,0;;;;1,0;;;;;;;;;1,0;;1,0;2,0;7,0;;;;;;5,0;10,0;;;;;;;;4,0;;1,0;;;;;;;;;;;1,0;1,0;;;;;;;;;;16,0;;;;;;;1,0;;;;;;;;;;;;;;3,0;4,0;;;;;;;1,0;2,0;;;;;;;;;;;;2,0;;1,0;;;;;;;;;;;;;4,0;;;;;;;;;;;2,0;;;;;;;;;;;;;;;;;;23,0;6,0;;;15,0;5,0;10,0;;;;;;;;;;;;;;;;;;3,0;;;;1,0;;;;;;;;;;;;;;;;;;;;2,0;;;12,0;;;;1,0;;;18,0;;;;;;6,0;;;;3,0;;;;;;;;;23,0;;;;;;;;;;;;;;;;;;;;;;;;3,0;;;;;;;;;;;;;;;;;;;;;;;;;;;;;;2,0;;;;;;;;;1,0;;;;;;;;;;;;;;;;;;;9,0;;;;;2,0;;;;;;;;;;;;;;;;;;;;;;;;;;;;;;;;;;;;;;;;;;;;;;;;;;;;;;;;;;;;;;;;;;;;;;;;1,0;17,0;;;;;;;;;;;;;;;;;;;;;;;;;;;;;;;;;;;;;;;;;6,0;;;;;;;;;;;;;;;;;;1,0;;;;;;;;;;;;;;;;;;;;;;;;;2,0;;;;;;;;;;;;;;;;;7,0;;;;;;;;;;;;;;;;;;;;;;1,0;;;;;;;3,0;;;;;;;;;;;;;;;;;;;;1,0;;;;;;;;;;;;;;;;;;;;;;;;;;;;;;;;;9,0;;;5,0;;;;;;1,0;;;;;;9,0;;;;;;;6,0;;;;3,0;;;;;;;;;;;;;;;;;;;;;;;;;;;;;;;;;;;;;;;;;;;;;;;;;;;;;;;;;;;;;;;;;;;;;;;;;;;;;;;;;2,0;;;;;;;;;;;;;;;;;;;;;;;;;1,0;;1,0;;;;;;;;;;;;;22,0;;;;;;;;1,0;;;;;;;;;;;;;;;;;;;;;;;;;;;33,0;6,0;;;;;;;;;;;;;;;;;;;;;;
realtime;;;;;;15,0;3,0;1,0;;;;;;12,0;;;23,0;;;3,0;;;1,0;;22,0;3,0;2,0;;6,0;1,0;9,0;6,0;;;;23,0;5,0;1,0;12,0;;16,0;23,0;;2,0;53,0;;3,0;2,0;;2,0;3,0;;;22,0;22,0;;;;;25,0;1,0;;;2,0;134,0;;2,0;;;;;;1,0;;;;;4,0;2,0;1,0;55,0;;1,0;2,0;7,0;;;3,0;;;9,0;;1,0;;;;7,0;1,0;4,0;13,0;14,0;;;1,0;14,0;3,0;2,0;8,0;;;;2,0;9,0;;;;2,0;;4,0;23,0;;;16,0;;;1,0;35,0;;4,0;;6,0;;;17,0;;;18,0;;4,0;;;;;;;1,0;4,0;1,0;5,0;1,0;;1,0;;;;;;;;;;1,0;16,0;;;;2,0;;;4,0;;;;1,0;;1,0;;;6,0;;;;;10,0;;;1,0;;7,0;3,0;;;;;;;2,0;;;;;7,0;;4,0;8,0;1,0;;;;;1,0;7,0;;;;;5,0;2,0;;;;;;;;;1,0;;;2,0;;2,0;1,0;;;2,0;;;;1,0;;;;;;;;;;;;;;2,0;;;2,0;1,0;;;;8,0;;4,0;;;;;;1,0;;;;;;;;1,0;;;2,0;;;;;;;;;;;;;;;;;;;;;;;;;;;;;3,0;;;;;1,0;;4,0;;;;9,0;13,0;;;;1,0;;;;;;;;;4,0;;;;;;;;;;;;1,0;1,0;;;;;;;14,0;;3,0;;65,0;;;;;;;5,0;;;;;;;;;1,0;;14,0;;;1,0;6,0;6,0;;1,0;;4,0;2,0;;1,0;6,0;;;1,0;;;3,0;;7,0;3,0;;;;1,0;;;16,0;5,0;2,0;1,0;;;6,0;;2,0;3,0;;;;;;;2,0;;;1,0;5,0;7,0;;14,0;;;;2,0;;2,0;;;5,0;;2,0;5,0;2,0;2,0;;;2,0;;;10,0;;;;;;11,0;;2,0;4,0;;1,0;2,0;;;2,0;;;1,0;;2,0;;3,0;;3,0;1,0;;;;;;;;;2,0;1,0;;;10,0;7,0;;1,0;;;;;;;14,0;;1,0;;10,0;15,0;;7,0;;;;;;;15,0;2,0;;;;;;1,0;;;;;1,0;;;;;;;;;1,0;;17,0;;;;;;1,0;;;;1,0;5,0;2,0;;;;11,0;;;;;;;;1,0;;;;;;2,0;1,0;;4,0;;4,0;;;;;;1,0;1,0;;;;1,0;;;;;;;;;1,0;1,0;3,0;1,0;;;;1,0;;;5,0;;;;;7,0;3,0;;;;;;;;;1,0;4,0;;;1,0;;;6,0;;;;;;;;;5,0;;;;;;;;2,0;;;;;;;;;;1,0;;;;;1,0;5,0;;1,0;;;1,0;;;1,0;;;;;;;;2,0;1,0;;;1,0;;;;;2,0;;;;;1,0;;1,0;;;;;;1,0;3,0;1,0;;;;;;;;;;;5,0;;;;;;;;;;;;;;;;4,0;;;;4,0;;;;;;;;;;8,0;;;;;;;;;;;;6,0;;;1,0;;;;;;;;;;;;;;;;;;;3,0;;;;2,0;;;;;;2,0;;;;;;;;;;;;;;1,0;;;;;;;;;;;2,0;;;;;;2,0;;;;;;;;;;;;;;;;;;;;;;;;;;1,0;1,0;3,0;;;;;;;;;;1,0;1,0;7,0;;;;;;;2,0;;;2,0;;1,0;7,0;;;;;;;;1,0;;;1,0;4,0;;;3,0;;;;;;;;;;;;;;4,0;;;;;;;;;;;;1,0;;;;;;1,0;;2,0;;;;;;;;;;;1,0;;;;;;;;;;;;;;;;;;;;;;;;;;;;;;;;;;;;;2,0;;;;;;;;;;;;;;;;;2,0;;;;2,0;;;1,0;1,0;;;;;;1,0;;;;;;;;;
reproduction;;;;;;16,0;;;;;;;;10,0;;;;;;;;;2,0;;;;;;;;;;;;;;;;;;;1,0;;1,0;12,0;;;;;;;;;;;;1,0;;;;;;1,0;;48,0;;1,0;1,0;;;;;2,0;;;;;;;1,0;15,0;;5,0;;;;;;;;;;;;;;;;27,0;;;;;7,0;3,0;3,0;;1,0;;;;;;;;;;;;;;;;;;4,0;1,0;;;;;;;1,0;;;;;;;;;;;;;;;;;;;2,0;;;;;;;;;;2,0;;;;;;;2,0;;;;3,0;;;;;;;;;;;;;;;;;;;;;;;2,0;;;;;;;;2,0;;;;;2,0;2,0;;;;;;;;;;;;;;;;;;;;;;;;;;;;;;;;;;;;;;;5,0;;;;;;;;;;;;;;;;;;;;;;;;;;;2,0;;;;;;;;;;;;;;;;;;;;;;;;;;;;;;;;;;;;;;;;;;;2,0;;1,0;;;;;;;;;;;;;1,0;;;;;;;;;;;;;;2,0;;;;;;;;;;;;;;;;;;;;;;;;;;1,0;;;2,0;;;7,0;;;;;3,0;;;;;;1,0;;;;;;;;;;;;;;;;;;;;4,0;;;1,0;;;;;;;;;;;;;;;;;;;2,0;1,0;;3,0;;22,0;;;;;;;;;;7,0;;;;;;;;;;;;;;;6,0;;;;;;;;;6,0;;;;;;;;;;2,0;;;;5,0;;;;;;;;;;2,0;;;;4,0;;;;;;;;;;1,0;;;;;;;;;;;;;;;;;;;;;;;;;;;;;1,0;;;;2,0;;1,0;;;;;;;;;;;;;;;;;;;;;;;;;;;;;;;;;;;;;;;;;;;;;;;;;;;;;;;;;;;;1,0;;;;;;;;;;;;;;;;1,0;;;;;;;;;;;;;;;;;;;;;;;;;;;;;;;;;;;;;;;;;;;;;;;;;2,0;;;;;;;;;;;;;;;;;;;;;;;;;;;;;;;;;;;;;;;;;;;;;;;;;;;;;;;;;;;1,0;;;;;;;;;;;;;;;;;;;;;;;;;;;;;;;;;;;;;;;;;;;;;;;;;;;;;;;;;12,0;;;;;;;;;;;;;;;;;;;;;;;;;;;;;;;;;;;;;;;;;;;;2,0;;;;;;;;;;;;;;;;;;;;;;;;;;;;;;;;;;;;;;;;;;;;;;;;;;;;;;;;;;;;;;;;;;11,0;;;;;;;;;;;;;;;;;;;;;;;;;;;;;;;;;;;;;;;;;;;;;;;;;;;;;;;;;;;2,0;;;;;;;;;;;;;;;;;;;;;;;;;2,0;;;;;;;;;;;;;;;;;;;
retract;;;;;;3,0;;9,0;7,0;;2,0;;;16,0;;;;;2,0;;;;;;;;;;;2,0;13,0;;;1,0;;;;;;;;6,0;;;5,0;6,0;;5,0;;;;1,0;61,0;1,0;;;;;;;;;;;15,0;;6,0;;;;1,0;5,0;1,0;;;;;;;;2,0;;2,0;;4,0;47,0;;48,0;;;;1,0;;;14,0;;;;2,0;;228,0;;;;;;;;;;;;;;;;;;;2,0;;;1,0;;3,0;1,0;40,0;;;;;;;10,0;;;1,0;;;;;6,0;;;4,0;;;2,0;;1,0;;5,0;10,0;;;;;;;;;;;;;;1,0;12,0;;;;;;4,0;1,0;;;;;;;;2,0;5,0;;;2,0;1,0;10,0;3,0;;;;9,0;;;23,0;;4,0;3,0;;;2,0;;;;38,0;;115,0;9,0;14,0;15,0;;;;2,0;;;;41,0;;;;;1,0;;18,0;;1,0;;8,0;;3,0;;1,0;;2,0;;;2,0;;;;;;;;2,0;5,0;2,0;1,0;;;;;;18,0;6,0;;;;1,0;;;6,0;;;2,0;;;;1,0;4,0;;;;9,0;1,0;;;;;9,0;;;1,0;3,0;;;;;23,0;;;;;1,0;;2,0;3,0;;;1,0;;;;2,0;9,0;;4,0;;;3,0;2,0;;;4,0;2,0;2,0;4,0;3,0;;;;;;1,0;1,0;3,0;;;;;5,0;;;3,0;2,0;3,0;;25,0;4,0;2,0;;2,0;2,0;;;;3,0;1,0;;;;2,0;1,0;;;3,0;;;;;;1,0;;;;;;;;;;;;;;;;7,0;;;;2,0;1,0;;;;;;;;;;;;;;;;;;;8,0;;;1,0;;1,0;7,0;5,0;;;;9,0;;;;;;;;;;1,0;;1,0;;;;;;;;1,0;1,0;;5,0;;;;;;;;;;2,0;;;;3,0;;;;;;;;;;;1,0;;;;;;;;;;;;;;;;;2,0;;;;1,0;;1,0;;5,0;;;;;2,0;;1,0;1,0;;;;;;;;;;;;;;;;1,0;;;;7,0;3,0;;;;;;;;;4,0;3,0;;;2,0;;;1,0;;;;;;;;;3,0;4,0;;1,0;;;1,0;;;;;;;;;;;;;1,0;;;;;;;;;;;;;;;;;;;;;8,0;;1,0;4,0;;;;;;;;;6,0;;;6,0;;;;;;5,0;;;;;;;;;;;;1,0;;;;;;;;;;;;;;;;;;;;;;;1,0;;;1,0;;10,0;;;;1,0;;1,0;;;;;;;;;;;;;;;;;;;2,0;;2,0;;2,0;;;;;;1,0;;;;;;;1,0;;;2,0;;;;;;;4,0;;;;;;;;7,0;1,0;;;;;;;;;;1,0;;;;;;;1,0;;;;;;;;;;;4,0;;15,0;;;;;;;2,0;;;;1,0;44,0;1,0;;;;;;2,0;;;;;1,0;;1,0;8,0;2,0;;;;;;;1,0;;4,0;2,0;;1,0;;;;10,0;;;;;;;;5,0;;;;;;;;;;;;;;;;;;;;;;;;;;;;;;;;;;;;;;1,0;;;;;;;;;;;;;;;;;;;;;;;;;;;;;;;;;;;;;;;;;;;;;;;;;;;;;;;;;;;;;;1,0;;;;;;1,0;;;;;;;;;;;;;;;;;;;;;;;;;;;;;;;;;;;;;;;;;;;1,0;;;;;;;;;;;;;;;;;1,0;;;;;;;;;;;;;;;;;;;;;;;;;;;;;;;;;;;;;;;;;;;;;;;
retractable;;;;;;2,0;;10,0;;;;;1,0;;;;;;;;;;;;;;;1,0;;1,0;1,0;;;;;;4,0;;;;;26,0;;;;;;4,0;;;;;4,0;;1,0;;;;;;;;;;;;5,0;;;;3,0;4,0;1,0;;;;;;;;;;;;;;;;;;;;;;;;;;6,0;1,0;2,0;;;;;;1,0;;;;;;;;;;;;;;;;3,0;;;;44,0;;;;;;;1,0;;;3,0;;;;;;;;2,0;;;;;3,0;2,0;;;;;;;;;;;4,0;;;;;4,0;;;;;;1,0;5,0;;;;;;;;;;;;;;;9,0;3,0;;1,0;;1,0;1,0;2,0;1,0;;7,0;2,0;;;;;;;2,0;;;3,0;3,0;4,0;;;;;3,0;;;;;;;;1,0;1,0;15,0;;;;;;1,0;;4,0;;;;;;;1,0;;2,0;;;;1,0;1,0;1,0;;;;1,0;;;4,0;1,0;;;;1,0;;10,0;;;;;;;;;3,0;1,0;;;;;;;2,0;;;;;;;;;;;2,0;;;;;;1,0;;1,0;;;7,0;;;;1,0;;;;;;1,0;;2,0;;;4,0;1,0;;;;1,0;;;;;;;;;;;2,0;;;;;;;4,0;;2,0;1,0;;;;;;;;1,0;;;1,0;2,0;2,0;;;;;;;;;;;;;;;;;;1,0;;;;;;;;;1,0;1,0;;;;;;;;;;;1,0;;;;;;;;;2,0;;;;1,0;;;;;;;;;;;;;;;;;;;;;;;;1,0;;;;;;9,0;;;;;;;;;;;;;;;2,0;1,0;;;;;;;;;;;;;;;;;;;1,0;1,0;;;;;;;;;;;;;;1,0;;;;;;;;1,0;;;;;;1,0;;;;;;;;;;;;;;;;;;;6,0;1,0;;;;5,0;;;;3,0;;;1,0;;;;;;;;;;;;;;;2,0;;1,0;;;;;;;;;;;;;;;;3,0;;;;;;;;4,0;;;;;;;;;1,0;1,0;1,0;;;;;;;;;4,0;;;;;;;;;;;;;;;;;;;;;;;;;;;;;;;;;;;;;;1,0;;;;;;;;1,0;;;20,0;;;;;;;;;;;;1,0;;;;;;;;;;;;;6,0;;;1,0;;;;;;;;;;;1,0;;;;2,0;;1,0;;;4,0;;;;;;2,0;;;;;;;;;;;;;;;;;;;;;;;;;;;;;;;1,0;;;;;;;;;1,0;;;;;;;;;;;;;;;;;;;;;3,0;;;;;;;;;;;;;;;1,0;;;;;;;;;;;;;;;;;;;;;;;;;;;;;;;;;;;;;;;;;;;;;;;;;;;;;;;;;;;;;;;;;;;;;;;;;;1,0;;;;;;;;;;;;;;;;;;;;;;;;;;;;;;;;;;;;;;;;;;;;;;;;;1,0;;;;;;;;;;;;;;;;;;;;;;;;;;;;;;;;;;;;7,0;;;;;;;;;;;;;;;;;;;;;;;;;;;;;;;;;;;;;;;;;;;;;;;;;;;;;;;;;;;;;;;;;;;
roller;;;;;;25,0;;5,0;;;;;2,0;4,0;;;;;;;;;;;;;;5,0;;;9,0;2,0;;;;;;;2,0;;1,0;8,0;22,0;;;7,0;;1,0;;;;;1,0;;;;1,0;;;;;;;;2,0;1,0;13,0;1,0;;;1,0;9,0;;;;;7,0;;;;1,0;;;;2,0;2,0;;6,0;;;;;;;;;;4,0;9,0;1,0;9,0;23,0;;;;;;;;;;;;;;;;2,0;;;;;;;;;4,0;;1,0;1,0;;;;;;;;;;;;10,0;;;;;;1,0;;2,0;;;6,0;;7,0;;1,0;;;;;;;;;;;;;;;;;2,0;;;5,0;;;;;;;2,0;;;;4,0;;9,0;;;;;;;1,0;;16,0;;;;8,0;5,0;;;8,0;;;4,0;;;;;;19,0;;1,0;;;;;;;1,0;;;;4,0;;1,0;;;;6,0;;;;4,0;;;26,0;4,0;1,0;;;;1,0;1,0;1,0;;;;1,0;1,0;;41,0;8,0;;;;;;;;;2,0;;;;;;2,0;1,0;;;4,0;;;;;;31,0;2,0;;14,0;2,0;;;;;;;;;;;1,0;16,0;;;;2,0;;;;;1,0;;;;;;;1,0;4,0;8,0;2,0;2,0;;;;1,0;;;;;;;1,0;;;6,0;;;;;;;;32,0;24,0;;;;;2,0;;;;;;;;3,0;;5,0;7,0;;;;;;;;;;;;;6,0;;;;;;;;;;1,0;;;;;1,0;;;;;;;;;;4,0;;;;;;;;;;;;;;6,0;;1,0;;;;;;;;;;;;;;;;;;1,0;;;;;;;;;;;;;;;;;;;;;;;;;4,0;;;;;;;;;;;;;;;;;;;;;;;2,0;;;2,0;;;;;;;1,0;1,0;;;;;;;;;;;4,0;;;;;;;;;;;;;;;;;;;;;1,0;2,0;;;;;;;;;4,0;;;7,0;2,0;;2,0;;;;;;;;;;;;;;;;;;;;;;1,0;;;;;;;;;;;;;;;4,0;;;;;;;;;;;;;;;;;;;;;;;;;;;;;;;2,0;;;;;;;;;;;;;;;;;;;;;;;;;;;;;;;;;;;;;;;1,0;;;;;;;;;;;;;;;;;;;;;;;;;;;;;;;;;;;;;;;;;;;;;;;;;;;2,0;8,0;;;;;;;;5,0;4,0;;2,0;;;;;;;;;;;;;;;;;;1,0;;;;;;3,0;;;;;;;1,0;;;;;;;;;;;;;;;;;;;;;;;2,0;2,0;;;;;;;;;;20,0;;;;;;;;;;;;;;;;;;;;;;;;;;;;;;;;;;;;;;;;;;;;;;;;;;;;;;;6,0;;;;;;;;;;;;;;;;;;;;;;;;;;;;;;;;;;;;;;;;;;;;;;;;;;;;;;2,0;;;;;;;;;;;;;;;;3,0;;;;;;;;;;;;;;;;;;;;;;;4,0;;3,0;;;;;;;;;;;;;;;;;;;;;;2,0;;;;;;;;;;;;;;;;;;;;;;;;;;;;;;;;;;;;;;;;;;;;;;;;;;;;;;;;
rolling;;;;;;9,0;32,0;1,0;;;;;4,0;38,0;;;35,0;;;;;;;;1,0;1,0;1,0;;3,0;;27,0;2,0;14,0;22,0;;2,0;9,0;;;;8,0;14,0;10,0;7,0;4,0;8,0;22,0;4,0;;1,0;;;5,0;3,0;;;1,0;;2,0;10,0;;;;;107,0;1,0;32,0;;;;;10,0;15,0;;;;;;;1,0;36,0;;5,0;1,0;11,0;12,0;;28,0;;;4,0;;4,0;;;;53,0;14,0;27,0;;5,0;;;;2,0;11,0;;;2,0;;;;11,0;;;;4,0;12,0;3,0;86,0;;;8,0;;;;23,0;;;;17,0;3,0;;56,0;;;;;;;;4,0;;;;7,0;;12,0;1,0;2,0;;;9,0;;;;;;;;;4,0;;;;;;1,0;;3,0;17,0;;2,0;112,0;;12,0;;;2,0;;;4,0;9,0;5,0;;;;;7,0;1,0;;;;;;2,0;9,0;;14,0;;;2,0;;;3,0;3,0;17,0;1,0;;3,0;4,0;10,0;7,0;;;6,0;;7,0;1,0;;4,0;2,0;;;1,0;;43,0;2,0;;;;;;;;;;;;3,0;;;2,0;3,0;;;2,0;;1,0;5,0;;;;;;;19,0;30,0;;;;;32,0;;1,0;;;;;9,0;;;;1,0;;1,0;1,0;16,0;2,0;;1,0;2,0;32,0;;;1,0;11,0;1,0;;;37,0;;;;;;;45,0;;2,0;;;;;1,0;9,0;;;;5,0;;;1,0;;;;5,0;8,0;;3,0;4,0;4,0;;6,0;;;1,0;;3,0;;;;16,0;;;;;;2,0;;44,0;14,0;;;;;;2,0;;;1,0;;;;3,0;;1,0;1,0;9,0;;;;;;1,0;;;;;;7,0;;1,0;9,0;;;;1,0;;;4,0;;;;;16,0;;1,0;1,0;;;;;3,0;;5,0;1,0;6,0;3,0;;;;1,0;;;8,0;;;18,0;;;4,0;;1,0;5,0;1,0;1,0;10,0;;;;10,0;;9,0;1,0;6,0;;;10,0;5,0;;;7,0;;;;;;;4,0;;;2,0;34,0;;;;;;;;;20,0;;53,0;;;;;;1,0;;2,0;;;;2,0;;;;1,0;2,0;2,0;2,0;;;;;;;27,0;;;2,0;;;8,0;;;;;;;;;;7,0;;;;;;;;;2,0;;;;;;;;;;;;1,0;;;3,0;1,0;;;;;;;;;;;;5,0;4,0;;2,0;;;;;;;;;;;;;;;;;;;;;;;;;;;;;;;;;;;;;2,0;1,0;;;;;;;;;;;;;;;;;;2,0;;;;;;;;;;;;;;;2,0;;;;;;;;;;;;;;;;6,0;;;1,0;;;1,0;;;;;;;;;16,0;8,0;;;;1,0;;;;;;;32,0;;;;;;;;;;4,0;;;;196,0;;;;;;12,0;;4,0;;;3,0;;;12,0;;;;;;;;;;;;;;;2,0;18,0;5,0;;;;;;;;53,0;45,0;;;;;;;;;;;4,0;;;;;;;;;;1,0;;;32,0;;;;;;;;;;3,0;;;;;;;;;;;;;;4,0;;;;;;;;;;;;;;;;;1,0;;;2,0;;;;;;;;;;;;;3,0;4,0;3,0;;;;;1,0;;;;;;;;;;;16,0;1,0;1,0;;;;3,0;;;;;2,0;;;2,0;;;;;;;;;;;;;;;;;;;;;;;;;;;;;;;;;;3,0;;;;;;;;;2,0;4,0;;;;;;;;;;;3,0;1,0;;9,0;;6,0;;;14,0;;;;;;;;;;;;;;;;;;;;;;;;;;;;;6,0;;;;;;;;;;;;;;;;2,0;;;;;;1,0;;;;2,0;;;;;;;9,0;;;;;;4,0;;;6,0;;;;;;;;;;;;;;;;;;;;;;2,0;;;;;;;;;;;;;;;;;;;;1,0;4,0;;;;;
sensitive;;;;;;4,0;23,0;2,0;;;;7,0;;11,0;7,0;;11,0;9,0;;;9,0;;34,0;;;;;6,0;;;19,0;2,0;;;;106,0;5,0;;;;3,0;76,0;;4,0;19,0;4,0;;9,0;;;;;;;23,0;;4,0;;;18,0;;11,0;1,0;;70,0;;64,0;;;;;22,0;196,0;;;;2,0;;;;16,0;;;;3,0;;;5,0;1,0;;;;;;;;76,0;13,0;72,0;;3,0;2,0;;7,0;9,0;1,0;;;;;;;33,0;;;12,0;2,0;5,0;6,0;61,0;;;4,0;;12,0;2,0;12,0;;;;5,0;;;3,0;;;;1,0;;;;;;;;8,0;6,0;4,0;2,0;;;;;;;1,0;;;;;1,0;;2,0;;;;4,0;;;;3,0;;2,0;3,0;;;12,0;4,0;;;;;2,0;;;9,0;2,0;;8,0;1,0;;;;1,0;;;1,0;2,0;;;;2,0;;;1,0;;;;;;;;;;;1,0;2,0;;;;5,0;;;;1,0;;8,0;28,0;;8,0;;6,0;9,0;;;;;;;;;;;;1,0;;2,0;3,0;4,0;;;;;2,0;;;;10,0;2,0;;;3,0;;;;;;26,0;;;;1,0;;;;;;3,0;;2,0;;;;1,0;;;;;1,0;;;;;;;;;;;;;;;;;;;;;6,0;;;;;;;;;;1,0;;1,0;1,0;;;;;;;1,0;;;;;5,0;;;;;;;;;;;4,0;;;;;;;;;3,0;;;;5,0;;;;;;;;;;;;;;;3,0;;;;2,0;;;3,0;;;;;11,0;;2,0;;;;;26,0;2,0;;;;1,0;;;;10,0;1,0;;;;;1,0;;;;1,0;;;;;;;;;;1,0;;;;12,0;;;1,0;;1,0;;1,0;;;;1,0;;5,0;;6,0;;;;;1,0;;;6,0;;;2,0;;;;;;;;1,0;;;;;;;;;;6,0;;;;6,0;;;2,0;;;1,0;;1,0;;;3,0;;;;;;;;;;20,0;;22,0;;;;;;;41,0;;;;;;;;;1,0;;;;;4,0;;;;1,0;;;1,0;;;;;;;2,0;;;;;;;2,0;;;;;;;2,0;;;;;;;3,0;;;7,0;;;;;;;;6,0;;;;3,0;;;;;;28,0;;1,0;;;;1,0;;;;;;1,0;;;;;;;;;;;;;;;;;;1,0;;;;;1,0;;;;;;;;;;;;;;;;;;;;;;;;;;;;;;;3,0;;1,0;;;;4,0;;1,0;;;;;;;;3,0;;2,0;;3,0;1,0;;1,0;;;;1,0;;;;;;;;;;;1,0;;;;2,0;;1,0;;;;12,0;;;;;;;2,0;;;;;;;;;;;;;;;;2,0;;;;;1,0;;;;;;;;;;;;;1,0;;;;;;;;;;;;4,0;;;;;;;5,0;;;;;;;;;1,0;;;;;;;;;;;;;;;;;;;;;;;;;;1,0;;;;;;;;1,0;;;;;;;;;;;;;;;;;;;;;;;;;;;;;;;;;;;2,0;;1,0;;;;;1,0;;;;2,0;;;;;;;;;;1,0;;;;;;;;;;;;;7,0;;;;;;;;;2,0;;;;;;2,0;;;;;;;;;3,0;;10,0;;;;;;;;1,0;;;;;1,0;;;;;;;;1,0;;;;;;;;;;2,0;;;2,0;;;;;;;;;;;;;;;;;;;;;;;;;;;;;;;;;;;;;;;;;;;;;;;;;;;;;;;;;;;;;;;;;;;;;;;;;;;;;;;;
sequential;;;;;;5,0;;5,0;;;;;;5,0;;;44,0;;;6,0;;;6,0;;;;;;3,0;3,0;7,0;;8,0;;;9,0;;;5,0;;5,0;22,0;;5,0;4,0;;;;;;2,0;;;;12,0;;10,0;;;1,0;;;;;125,0;2,0;9,0;;1,0;;;5,0;10,0;;;;;;;2,0;13,0;;2,0;;1,0;;;2,0;;6,0;;;;;2,0;;4,0;;55,0;2,0;9,0;;;3,0;3,0;10,0;;;;;;;2,0;;;;;5,0;8,0;8,0;;;;;;10,0;6,0;;;;1,0;;;2,0;;;14,0;;1,0;;;;1,0;;;;3,0;;4,0;;5,0;;;;;;;;;;;;;5,0;;;;;;;;;5,0;2,0;;;;;;;;;;12,0;;1,0;9,0;;76,0;2,0;;;;4,0;;;1,0;;;;;;;;;;;;;;;2,0;;;;;;;;;2,0;;12,0;;;;5,0;;;;;;;;;;;;;;;;;;;2,0;;;;;;;;;;;;;;;;1,0;;;;;;;;;;;;;;;;;;;;;;;;;;;;;;;;;;;;;;;;;;1,0;;;;;;2,0;;;;;2,0;;1,0;;5,0;;;9,0;;;;;;;1,0;;;;;;;;;;;;;;;;;;;2,0;;;;;;;1,0;;;;54,0;;;;;;;5,0;;;;;;;13,0;;21,0;;;;5,0;;5,0;2,0;;;;;;;;;;;;;;;;;3,0;;;7,0;;;2,0;2,0;8,0;;16,0;2,0;;4,0;2,0;;;;;;;;;1,0;;;;1,0;;;;;;;;;;;8,0;1,0;;;;;;3,0;;1,0;;;1,0;;;8,0;;;;;;;;;4,0;;;1,0;;;;;;;;;;;;;;;;;;;;;;;4,0;;;;;;;;;;;;;;1,0;4,0;;;;2,0;3,0;;1,0;;;;1,0;;;1,0;;;;;;;;;;;;;;;;;;;;;;;;;;;;;;13,0;;;;;;;;1,0;;;;16,0;;;;1,0;;;;;;;;;;;3,0;;1,0;;;;;;;;1,0;;;;;;6,0;5,0;;;;;;3,0;;;;;;;;;;1,0;;2,0;1,0;;;;;;;;;;;;1,0;;;;;;;;;;;;;;;;;;;;;;;;;;;;;;;;;1,0;;;;;;;;;6,0;;;;;;;;8,0;;;;;;;;2,0;;;;;;;;;;;;;;;;;;;;;;;;;;;;;;;;;;;1,0;;5,0;;;;;;;;;;;;;;;;;;;3,0;;;;1,0;;;;;;;;2,0;;;;;;;;;;;;;;;;;;;;;;;;;;;;;;;;;;;;;;;;;;;;;;;;;;2,0;;;;;;;;;;;;2,0;;;;;;;;;;;;;3,0;;;;;;;;;;;;;;;;;;;;;;;;;;;1,0;;;;;;;;1,0;;;;;4,0;;;;;;;;;;;;;;;;;;;;;;;;;;;;;;;;;;;;;;;;;;;;;;;;;;;;;;;;;;;;;;;;;2,0;;;;;;;;;;;;;;;;;;;;;;;;;;;;;;;;;;;;;;;;3,0;;;;;;;;;;;;;;;;;;2,0;;;;;;;;;;;;;;;
serial;;;;;;27,0;;;;;;;;4,0;;;1,0;;2,0;;;;;16,0;29,0;;;;;27,0;27,0;8,0;1,0;;;70,0;18,0;;;2,0;2,0;28,0;;1,0;;1,0;;;;;;;;3,0;;;10,0;;1,0;5,0;;;3,0;;26,0;;15,0;;;;;5,0;;;;;;2,0;;1,0;22,0;;83,0;1,0;9,0;;;;;;;;;2,0;;;;;8,0;;;;;;4,0;8,0;;;;;;1,0;;;;;;1,0;;14,0;49,0;;49,0;;;;19,0;;;;12,0;;;19,0;;2,0;;;;;;;;;;;;;;;;;5,0;;;3,0;;;;;1,0;14,0;;5,0;;;16,0;1,0;;;4,0;3,0;;;;;;;10,0;;;;;3,0;;;;;2,0;1,0;;;;;1,0;;;;;;;;;1,0;;2,0;;;;;;;;;;;4,0;12,0;;;;;;;;2,0;;;;;;;;;1,0;;;;;4,0;;;;;;2,0;;;1,0;;;;;;;2,0;16,0;1,0;;;;43,0;4,0;2,0;;;;;;;;198,0;;2,0;;;;;;1,0;;;;;;;;;17,0;;;;;;4,0;;;3,0;;;;;;;;;;;;7,0;;;;;;;;;;1,0;4,0;12,0;;;;;;;4,0;;;;;;1,0;;;;;;;;;;;;;1,0;;;;;;;;;;;15,0;1,0;;;;;;;;;;;;;;;4,0;;;4,0;;;7,0;;4,0;1,0;;;;;;;;;;;;;;2,0;;;;5,0;;;;;5,0;8,0;;;;;;20,0;56,0;;;;;;;1,0;;;;15,0;;;;;;;;;35,0;;;;4,0;;;5,0;;;;;;;;;;1,0;7,0;;;;;1,0;;;2,0;2,0;;;;10,0;;;;;;2,0;;57,0;;;;24,0;1,0;;1,0;;1,0;;4,0;;1,0;;;;;;;;10,0;;;;;;;16,0;3,0;;;1,0;2,0;;;;;;;;;;;;;;8,0;7,0;;;;;;;;;;;;;;2,0;;;;;;;;;;;;;15,0;;;2,0;;;1,0;;;;;;8,0;32,0;;1,0;;2,0;;;;;;;;;;;;;;;1,0;;;12,0;;;;;;;17,0;;;;;;;;3,0;;;;;1,0;;;;4,0;;1,0;;;;;;;;;;;;;;;;;;;;;;;;;;4,0;;;;;;;;;;;;;11,0;;;;1,0;;;;;;;;;1,0;;4,0;;;;;;;;;;1,0;;;;;;;2,0;;;29,0;4,0;;;;;;1,0;;17,0;;;;;;;;;;;;;;;;;2,0;;;;2,0;;;;3,0;1,0;8,0;;;;;;;;;;;;;;;;;;;1,0;;1,0;;;;;;;;;;;;;;;;;;;;2,0;;;;;;;;;;;;;;;;;;;;;1,0;;36,0;;;;;;;;;2,0;;;;;;;;;;;;;;;;;;;;;;;;;;;;;;;;;;2,0;;;;;1,0;;;;;;;;;;;1,0;;;;;;;;;;;;2,0;8,0;;;;1,0;;;;;;;;;;;;;;;;;;1,0;;;;;;;;;;;;;3,0;;;;;;;;;;;;;;;;;;;;;;;;;;;;;;;;;;68,0;;1,0;;;;;;;;;;;;;3,0;1,0;;;;;;;;;;;;;;;;;;;;;;;;;;;;;;;;;;;;;;;;;;;;;;;;;;;1,0;;;;;;;;
share;;;;;;20,0;11,0;4,0;;;;;1,0;14,0;4,0;;7,0;6,0;;6,0;6,0;1,0;2,0;;1,0;;;6,0;4,0;;18,0;8,0;;8,0;;23,0;;;2,0;2,0;14,0;101,0;;4,0;11,0;1,0;;85,0;;;3,0;;;;3,0;2,0;7,0;;;10,0;;6,0;13,0;3,0;86,0;;46,0;;;;;10,0;13,0;;;3,0;;;10,0;5,0;30,0;;1,0;;14,0;;;12,0;6,0;;1,0;;;;2,0;;207,0;5,0;128,0;12,0;36,0;1,0;;2,0;6,0;5,0;1,0;5,0;1,0;;;4,0;23,0;1,0;;;;111,0;2,0;35,0;;;36,0;;;2,0;47,0;;;;18,0;;;26,0;;;4,0;;;;;1,0;;;1,0;;1,0;6,0;5,0;;;1,0;1,0;;;2,0;;;;;;4,0;12,0;5,0;8,0;;50,0;;;8,0;1,0;;1,0;20,0;;;1,0;;9,0;;;;;;;;2,0;;90,0;1,0;;;;;;1,0;1,0;;;;;1,0;5,0;;;5,0;;;;;19,0;29,0;;;;1,0;36,0;1,0;;2,0;;;8,0;43,0;1,0;1,0;20,0;;;;;;1,0;6,0;;;;;;;;;;;;15,0;;;6,0;;;;;4,0;;1,0;;5,0;;;28,0;1,0;6,0;2,0;;;;;;;;12,0;20,0;;;;2,0;;;1,0;;;6,0;;3,0;;;;33,0;;9,0;;;;;;;;;;;;;;;;;1,0;;35,0;;;1,0;;;;3,0;;1,0;;28,0;8,0;;2,0;;;;;3,0;;;;;;4,0;;;;;;;;;;;;;;;;;;;;;;;;22,0;1,0;;;;6,0;1,0;1,0;;;;;;;;2,0;1,0;;;;2,0;;18,0;4,0;2,0;2,0;;9,0;;;;4,0;;2,0;;56,0;;2,0;;2,0;12,0;;;5,0;5,0;;;1,0;;;;;;1,0;;5,0;;;;;;;;;;4,0;1,0;6,0;;1,0;;;11,0;4,0;2,0;;;;5,0;4,0;1,0;;;;;;;3,0;;;17,0;;1,0;3,0;;;;2,0;;;;1,0;1,0;;17,0;3,0;;1,0;;;;;;;3,0;12,0;;;;;;1,0;13,0;;;3,0;4,0;;3,0;;1,0;;;;;;;;;15,0;;13,0;1,0;6,0;;;;6,0;;;;7,0;1,0;;;;3,0;;;;;;2,0;19,0;;;37,0;;;;;;;1,0;;;6,0;14,0;1,0;;1,0;;2,0;;;1,0;;2,0;;;;1,0;;;8,0;;13,0;16,0;;1,0;;;;;4,0;;3,0;;;;42,0;;2,0;;4,0;;3,0;1,0;;;;;;;;;;;;17,0;3,0;8,0;2,0;;;;;;1,0;;2,0;;;3,0;;27,0;;2,0;;;;5,0;;;;1,0;;;;;1,0;1,0;;;;4,0;1,0;;;;;5,0;;3,0;;12,0;;;;;3,0;;;1,0;;;;;1,0;1,0;;1,0;4,0;;;;5,0;;;;;;;7,0;5,0;;;;;8,0;;;1,0;;;1,0;;;;;;;;;;1,0;;2,0;;;;;;;6,0;;;6,0;;3,0;;;;;;3,0;6,0;;;;;;;;;;;;;;;;;;;1,0;;;;;1,0;;;;;;1,0;;;;;;;;;;;;;;;2,0;;;;;;;1,0;;;;;;;;;;;;;;;;;;;;;;;2,0;3,0;;;;;;;;;;5,0;8,0;2,0;;;;46,0;;;44,0;;2,0;4,0;;44,0;;;;1,0;;30,0;;2,0;;18,0;;;8,0;;;;;1,0;;11,0;;;;;;;82,0;;;;;;;;;;;;;;;;;;2,0;;;;;;;3,0;8,0;;;;;;;;;;;;;1,0;;;;;;;;;;;;;;;;;4,0;;;;1,0;;;;;;4,0;;;;;;;1,0;;;3,0;;;1,0;;;;;;;;;;4,0;;1,0;;;;;;;;;;;;;;;;;;;;;;;;;;;;;;;;;;;;;;;;;;;;;;;;;;;;;1,0;;;;;;;;;;;;;;;2,0;;;;;;;2,0;;
shell;;;;;;1,0;;27,0;;;;;9,0;1,0;;;;;;;;;;1,0;;;;4,0;1,0;;10,0;;;;;;7,0;;;1,0;;13,0;12,0;;;6,0;;;;;;;3,0;30,0;2,0;;11,0;;;;4,0;;;;2,0;;31,0;;;;;17,0;1,0;;;;2,0;;;1,0;4,0;;2,0;;10,0;;;2,0;1,0;;;;6,0;;;;;8,0;1,0;;6,0;;;;;1,0;;;;;;;;;;;;1,0;;4,0;;;;;;1,0;14,0;;;;;;;1,0;;;4,0;;;;;;;;1,0;;2,0;8,0;;6,0;2,0;;;4,0;;1,0;;;;;;19,0;;;;;9,0;20,0;;;;;;;;2,0;;;;;;1,0;;5,0;;;;1,0;2,0;33,0;;1,0;;;;;55,0;;15,0;;;;;;;;5,0;3,0;;2,0;;;;;;83,0;;;;;;;;;;;30,0;;3,0;;;;;;11,0;;;;2,0;;;21,0;4,0;;9,0;;;1,0;4,0;1,0;;;;3,0;;;5,0;40,0;2,0;;;;;;;;;;;3,0;;3,0;;1,0;;;2,0;1,0;4,0;;2,0;;2,0;1,0;;;;;2,0;;;;;4,0;;;;;;1,0;8,0;4,0;;;2,0;;1,0;2,0;;;;;2,0;;3,0;;4,0;8,0;;;;;;;;;;;;1,0;;;;2,0;1,0;;2,0;2,0;;;8,0;2,0;;2,0;4,0;;;11,0;;;;;;;;3,0;;1,0;14,0;;;;;;;;;;;;1,0;;;3,0;;;;;;;;;;;;;;;;;;;;;;;1,0;;;;;;2,0;;;;;;;;;;;1,0;;;;;;;;;;;1,0;2,0;;;;;;;;1,0;;;1,0;;;;;;;2,0;;;;;;;;;;;;6,0;;;;12,0;1,0;;;;;;;;;;;1,0;;;3,0;10,0;;;;4,0;;;4,0;;;;;;;;;;;4,0;;;1,0;;;;;;;;;1,0;;;;;;;;;;9,0;;2,0;;;2,0;3,0;;;;;2,0;;;;2,0;;;;;;;;;;;;1,0;10,0;;1,0;;1,0;2,0;;;;;;;;;;;;;;;;;;;;;;;;3,0;;;;1,0;;;;;;;;;3,0;2,0;;;;;;;;;;;;;;;;;;;1,0;;;;;;;;;1,0;;;;;;;;;;;;;;;;;;;1,0;;;;;;;;;7,0;;;;;5,0;;;;;;;;1,0;;;;;;1,0;;;2,0;;;;;;1,0;;1,0;;;;;;;;;;;;;;;;2,0;;;;;;;;;;2,0;2,0;;;;1,0;;;1,0;;1,0;;;;;;1,0;;;3,0;;;4,0;4,0;2,0;;;;2,0;2,0;;;;;;;;;6,0;6,0;;;;;;;;;1,0;;;;;;11,0;;;2,0;;;;;;;;2,0;;;;;;2,0;;2,0;;;;;;;;;;;;;5,0;;;;;;;;;;;;;;1,0;;;;;;;;;;;;;;;;;;;;;;;;;;;;;;;;;;;;;;;;;;;;;;;;;;;;;;;;;;;;;;;;;;;;;;;;;;;;;;;;;;;;;;;;;;;;;;;;;;;;;;;;;;;;;;;;;;;;;;;;;;;;;;;;;;;;;;;1,0;;;;;;;;;;;;;;;;;;;;9,0;;;;;;;;;;;;;;;;;;;;;;;;;;;;;;;;;;;;;;;;;;;;;;
sign;;;;;;3,0;;2,0;;;;;;9,0;;;;;;;;;18,0;;;;;;8,0;;10,0;;2,0;;;24,0;3,0;;2,0;;48,0;7,0;;50,0;17,0;1,0;;2,0;;;;;4,0;;10,0;;1,0;;;1,0;;;;;69,0;;18,0;;2,0;;10,0;5,0;5,0;;;1,0;6,0;3,0;;;34,0;;;11,0;;;;;;;21,0;1,0;2,0;;1,0;;3,0;;22,0;7,0;18,0;;;4,0;1,0;8,0;;2,0;;;;6,0;23,0;;;;;3,0;;2,0;;;19,0;;;5,0;53,0;;;;5,0;;;28,0;;;1,0;3,0;;;;;;;;1,0;;1,0;25,0;1,0;;;;;;;;;;;;7,0;2,0;;;;3,0;;;11,0;20,0;;;5,0;;;;;;;;;;2,0;;;;;8,0;14,0;;;1,0;;;;;;2,0;;;;13,0;;;2,0;;;;;;5,0;;;;;7,0;;;;3,0;;;;;;3,0;;4,0;;;;;1,0;2,0;21,0;;;;6,0;;;;;;7,0;;1,0;5,0;;;;;1,0;;1,0;;7,0;;;;;5,0;32,0;;;;;;;;;;1,0;;;1,0;3,0;;;;;;;;;14,0;;;;;4,0;;;;;20,0;3,0;;;;;;;;;;;;1,0;;;6,0;;;;8,0;;;;;15,0;3,0;1,0;;;;;2,0;;;;;;;;;;3,0;;;;;;;;1,0;;;;;;;;23,0;;1,0;;13,0;;;;;;;;;;;;;;3,0;;2,0;;;;2,0;4,0;8,0;4,0;;;4,0;23,0;1,0;4,0;;1,0;;;11,0;;;7,0;;2,0;1,0;;;1,0;;;;2,0;;4,0;6,0;1,0;;;;;5,0;;;;;;;6,0;;1,0;;5,0;;3,0;;;;;;;12,0;;;35,0;;;;;;;;5,0;;3,0;7,0;;;;;;;;;;;;3,0;;;;;3,0;;;;;2,0;;;5,0;;;;;;;;3,0;;;;;3,0;;;;;;;;1,0;;;;1,0;;;;1,0;;;1,0;;;;;;;;;;;;;;;;;;;;;;;;;;;;1,0;4,0;;;;3,0;6,0;;;;;;;;;;;;;10,0;;;;;;;1,0;;;;1,0;1,0;;1,0;;;2,0;;;;;;1,0;;1,0;;;;;2,0;;;;;;2,0;;3,0;;;;;;;;;;;;;2,0;;;3,0;;;;;;;;;;;;;;;;;9,0;;;;;;;;;;1,0;;;;;;7,0;1,0;;;;;;;;;;;;;;;;;;22,0;;;;;;;;;;;;2,0;;;;;;;;;3,0;;;;;;;;;;;;1,0;;;;;5,0;;;;;2,0;;;1,0;;;;;;;;;;;;;;;;5,0;;;;;;;;;;;;;;;;;;;;;;1,0;;;3,0;;;1,0;2,0;;;;;;;;;;;;;;;;;;;;;;;;;;;;;;;3,0;;;;;1,0;;;1,0;;;;;;;;;;;;;;;;;;;;2,0;5,0;;;;;;;;;;;;;153,0;;;;;;;;;;1,0;;;;;;;;;;2,0;;;;;;;;;;;2,0;;;1,0;;;;;;;;2,0;;;;;;;51,0;;;;;;;2,0;;1,0;;;1,0;;;;;;;;;;1,0;;;;;;;;;;;;;;;;;;;;;;;;;;;;;;;;;;;;;;;;;;;;;;;;;;;;;;;;;13,0;;;;;;;;;;;;;;;;;4,0;;;;;;;;;;;;;;;;;;;;;;;;;;;;;;;;
silicon;;;;;;11,0;18,0;4,0;;;;;2,0;1,0;;;;6,0;;;;;1,0;;;;;1,0;;;2,0;2,0;;;3,0;;;;;;;12,0;9,0;1,0;1,0;6,0;;13,0;;;;;3,0;;;;77,0;;;1,0;4,0;;1,0;;9,0;6,0;32,0;2,0;;;;37,0;;13,0;;;23,0;;;;24,0;;;;10,0;;;4,0;;;;;;3,0;;1,0;16,0;;7,0;;;2,0;;;;2,0;;;;;;;14,0;;;;;;;45,0;;;;;;;4,0;;;5,0;;;;5,0;;;;;;;;;;;1,0;;13,0;12,0;;1,0;;;;3,0;1,0;;;1,0;;50,0;5,0;5,0;;;1,0;;11,0;12,0;;;7,0;;6,0;;;4,0;;;;;;;3,0;1,0;;93,0;;;;1,0;;;;;;1,0;1,0;1,0;;;28,0;92,0;;;;;9,0;2,0;;2,0;;;;;;1,0;;;;;;;;2,0;;2,0;2,0;;;;;;2,0;1,0;;;1,0;;;;;1,0;;;1,0;1,0;;2,0;27,0;;;4,0;2,0;3,0;71,0;;5,0;32,0;;;;;12,0;1,0;;;;1,0;;1,0;;;28,0;;1,0;;;;;;;1,0;;;;;;;8,0;;;;;;;;5,0;;1,0;;;;1,0;;;;;1,0;;10,0;;;;;;;;;6,0;2,0;1,0;;1,0;2,0;;;1,0;;1,0;;;;;;;;;;;;;;;;;;;2,0;;;;;;12,0;;1,0;;6,0;1,0;;;;;;;;;;;;;;;;;;;;;;;;;;;;;;;;;;;5,0;;;;;;;;;1,0;1,0;;;;;;;;2,0;;;;;2,0;;;;;;;;;;;;;;;;;;;;;;;;;;;1,0;;;;;;;;1,0;;;;;;;;1,0;;3,0;;;;;;;;;;;;1,0;;;;;1,0;;;;;;;;;;;;;;;;;1,0;;;;;;;;;;;;;;;;;;;;4,0;;;;;1,0;;;;;;;;1,0;;;;;1,0;;;;;;;;;1,0;21,0;;;;;;;;;1,0;;;;;;;;;;;;;;;;1,0;;;;;;1,0;;;;;;;;;;;;;;;;;;;;;;;;;;;;;;;;;;;;;;;1,0;;;;;;;;;;;;;;;;;;;;;1,0;;;;;;;4,0;;;;;;;;;2,0;;;;;;;;;;;;;;;;;;;;;;;;;;;;;;;;;;;;;6,0;2,0;;;;;;;5,0;;;;;1,0;;;;;;;;;;;;;;;;;2,0;;;;;;;;;;1,0;1,0;;;;;;;;13,0;;;;;;;;;;;;;1,0;7,0;;;;;;;;;;;;;;;;4,0;;;;;;;;;;;;2,0;;;;;;;;;;;;;;;1,0;1,0;;2,0;;;;;;1,0;;;;;;;;;;;1,0;;;9,0;;;;;;;;;;;;;;;2,0;;;;;;;;;;;;;;;;;;;;;;;;;;;;;;;;;;;;;;;;;;;;;;;;;;;;;;;;;;;;2,0;;;;;;;;;;;;;;;22,0;;;;;;2,0;;;;;;;;;;;;;;;;;;;;;3,0;;;;3,0;;1,0;;;;;;;;;;;;;;;;;;;;;;;;5,0;;;;;;;;;2,0;;;;;;;;;;;;;;;;;;;;;;;;;;;
similarity;;;;;;8,0;4,0;;;3,0;;;;47,0;1,0;;2,0;;8,0;;;;7,0;;;;;9,0;;;3,0;;;1,0;;8,0;6,0;46,0;12,0;;61,0;6,0;;4,0;;;;2,0;;;13,0;;;;;;4,0;;;3,0;;;6,0;;77,0;;11,0;5,0;;;2,0;;;;;2,0;;;;;28,0;;;19,0;;;;;;;;;;;;;43,0;;27,0;6,0;5,0;16,0;;1,0;2,0;;;;16,0;;;2,0;3,0;1,0;;;;11,0;;;;;23,0;3,0;1,0;;3,0;;;;3,0;;;9,0;;;;;;;;;;;;3,0;1,0;;2,0;;;;1,0;;;;;;;;;;4,0;1,0;;;;;;;1,0;;;2,0;;8,0;;;;;2,0;;;;;;;;13,0;;;2,0;;;;;;;;;;;;;22,0;3,0;;;;;;3,0;;;;;;;;;;3,0;;;;;;;;2,0;;;;;;;4,0;;;11,0;;;;;;5,0;;10,0;;;;;;;;;;;;;1,0;1,0;;;;;;;5,0;;;;;;;;;;;;;;;;2,0;;;3,0;;;;;;;1,0;;;;;;;;;;;;;;;11,0;;;;;;;;;;;;2,0;;2,0;;;;;;;;;;;3,0;;;;;;;;;;;1,0;2,0;3,0;;;;;;;44,0;;;;2,0;;;;;;;;;;;;;;37,0;;2,0;1,0;;;14,0;4,0;;2,0;;;;3,0;2,0;;;;5,0;;;;;12,0;;8,0;10,0;;;12,0;;27,0;;10,0;;;14,0;;;5,0;;;;;;;;;;;;;;7,0;;;4,0;;;;;;;;;14,0;;;;;22,0;;;1,0;2,0;;;;1,0;;;;;;6,0;2,0;;;;;;;;;;;;;;;;;;;;;;;;;;4,0;;;6,0;;;;;;;;;;;;;;;;;;3,0;;;;;;33,0;;;;2,0;;;;;;;;2,0;;10,0;;;;;;;;;2,0;;;;;;20,0;;8,0;;;;;;;;;;;;;;;;1,0;;;;;;;2,0;;1,0;;;;;;;;;;;;;;;;;;;;;;;;;;;2,0;;;;;12,0;;;;;18,0;;;;;;;;;;;;;4,0;;;;;;4,0;1,0;;;;2,0;;;;;;;;;;;;;;;;;;2,0;;;;;;;;;1,0;;4,0;;;;;;;;;;;;;;;;;;;9,0;;;16,0;10,0;;;;;;;;;;;;;;;;;;;;;;;;;;;;;;;;;;;;;;;;2,0;;;;;10,0;;;;;;;;;2,0;;;;;;;;;;;;;;;;;;;;;3,0;;;;;;;;;;;1,0;;;;;;;;;;;;;;;;;;2,0;;;;;1,0;;;;;;;;;;;;;;;3,0;;7,0;;;;3,0;;;;;;1,0;;;;;;;;;;;;;;;1,0;;2,0;;;;;;;1,0;;;;;;;;;;;;1,0;;;5,0;;2,0;;;;;;;;;;;;;;;;2,0;;;;;1,0;;;;;;;;1,0;;;;;;;;;;;;;;;;;;;;;;;;;;;;;;;;;;;;;;;;;;;;;1,0;;;;;;;;;;;;;;;;;;;;3,0;;;;;;1,0;;;;;;;;;;;;;;6,0;;;;;;;;;;;;2,0;;;4,0;;;;;;;;4,0;3,0;;;;;
site;;;;;;7,0;6,0;;2,0;;;;;23,0;;;16,0;;2,0;;;;2,0;3,0;;;;5,0;;;12,0;;;;;11,0;2,0;6,0;12,0;;10,0;16,0;;29,0;42,0;2,0;;;;;;;;;2,0;1,0;6,0;;2,0;12,0;;;3,0;;107,0;;23,0;;;;;;1,0;;;;4,0;3,0;1,0;;17,0;;1,0;6,0;6,0;;;9,0;;3,0;;;;;2,0;;;3,0;7,0;2,0;54,0;7,0;;1,0;3,0;;6,0;;;;;24,0;;;;;;;;11,0;3,0;;8,0;6,0;;3,0;26,0;;;;3,0;;;34,0;;;14,0;20,0;;;;;9,0;;;1,0;3,0;;49,0;;;;;;;;1,0;;;7,0;;3,0;5,0;1,0;;;1,0;;;4,0;7,0;;2,0;2,0;;;;;1,0;;;;;;;;6,0;;20,0;;;;;;;1,0;;1,0;;;;;;;1,0;1,0;12,0;;;5,0;;;;;1,0;;;4,0;;;;;;;;;14,0;;;;;;2,0;;;4,0;1,0;;;4,0;;;1,0;;;5,0;;;;;;;;;;;1,0;1,0;;;;1,0;;;;;;;;;;;1,0;5,0;;;2,0;2,0;;;3,0;;;;;;;;;;1,0;;;;;;3,0;;;;;;;;;;;2,0;;3,0;;1,0;;;1,0;;10,0;;;;1,0;;;;;;;4,0;1,0;;;;;;3,0;;;;1,0;;;;;;2,0;;;;;;;;;;;;1,0;;55,0;1,0;;;;;;;;;;;4,0;;3,0;3,0;;;8,0;;;;6,0;;;;;2,0;;;;;;;;;;;;1,0;1,0;;;;;;;15,0;;5,0;;;;;3,0;;3,0;2,0;;;;;;;;;1,0;10,0;36,0;2,0;;;;;1,0;1,0;;;1,0;43,0;;;;;;;;4,0;;;6,0;;;;;;2,0;;;4,0;;;2,0;3,0;;1,0;;;;;;;;;23,0;4,0;1,0;;;5,0;;2,0;1,0;;1,0;1,0;;1,0;1,0;;;2,0;;;2,0;;2,0;;;;;;;;;;;1,0;;;;;1,0;;;;;;;1,0;;;1,0;;;;;;;;;;;;;;;;;;2,0;;;;;;1,0;;;;2,0;;;;;;;;;;;;;;2,0;;;;36,0;;4,0;2,0;;;;1,0;4,0;4,0;;;;;;;;1,0;1,0;;4,0;3,0;3,0;7,0;1,0;2,0;;;;;;;6,0;;;;;10,0;9,0;;;;;;1,0;;;2,0;;;;1,0;2,0;;;;;;3,0;;;;;;1,0;;;12,0;;;;;;;1,0;;;2,0;;1,0;;;1,0;;;;2,0;4,0;;;10,0;2,0;;;;10,0;5,0;;3,0;;;;;;;5,0;;;;;;1,0;5,0;;;;;4,0;;;;;;;;;;;;10,0;;;;;;;;1,0;;;;;;;;;;8,0;;2,0;;3,0;;;2,0;;;;;;;;;;;;1,0;;25,0;2,0;;;;;;;;;;;;;;;;;;;;;;;;;;;;;;;;;4,0;1,0;;;2,0;;;;;;;;;;;;;;;;;;;;3,0;;;;;;;;;;;;;;;;;;;;;;;2,0;;;;;;;;;;;;;;;;;;;;;;1,0;;;3,0;;;;;;;;;;;;;;;;1,0;;;4,0;;1,0;4,0;;;;;;;;;;;;;;1,0;;;;;;;;;;;;;;;;;;;;;;;;;;;;;2,0;;;;;;;;;;;;;;;;;;;;;;;;;;;;;4,0;;;;;;;;;;;;;;;;;;;;;;;;;;;;;;1,0;;1,0;;4,0;;;21,0;;1,0;;;;;;;;;;;6,0;;;;;;;;;1,0;;;;;;
sleeve;;;;;;8,0;;4,0;;;;;3,0;18,0;;;;;7,0;;;;;;;;;109,0;;;30,0;;;;;;7,0;3,0;;;;29,0;5,0;;1,0;34,0;;6,0;;;;;15,0;3,0;;;3,0;;;3,0;;;;;8,0;1,0;29,0;;;;1,0;24,0;1,0;;;;1,0;;;;12,0;;;;57,0;3,0;;7,0;;;;20,0;2,0;;;;;9,0;5,0;1,0;19,0;1,0;;;;;;;;;;;;;;;;1,0;;2,0;;1,0;;;;;15,0;;;;1,0;;;10,0;;;2,0;;;;;4,0;;;26,0;;;2,0;2,0;1,0;1,0;4,0;2,0;14,0;;;2,0;;;;;17,0;;;;;27,0;14,0;1,0;;;;;8,0;;10,0;3,0;;;;;;;3,0;5,0;;;3,0;;3,0;;;;;5,0;3,0;22,0;2,0;32,0;4,0;;;;;;;19,0;3,0;;63,0;5,0;1,0;;;;81,0;1,0;7,0;;;;;;;3,0;;82,0;1,0;;;10,0;;;;6,0;;;;3,0;;;7,0;;;11,0;;;3,0;7,0;4,0;2,0;1,0;;10,0;5,0;1,0;6,0;29,0;24,0;;;1,0;;;;;;;1,0;4,0;;6,0;;2,0;3,0;;4,0;1,0;;;5,0;1,0;17,0;2,0;;2,0;;1,0;;4,0;6,0;3,0;;17,0;;5,0;1,0;;3,0;10,0;;;1,0;;;11,0;8,0;;;3,0;;;5,0;;;;2,0;;;4,0;;;6,0;6,0;;;;2,0;;;6,0;;;;;;1,0;4,0;2,0;;9,0;2,0;;11,0;;6,0;1,0;1,0;;5,0;;;;;;2,0;;1,0;;;;;;;;2,0;;;;;3,0;;;1,0;;;;;;;2,0;;;;;;;;;;;;;1,0;1,0;;;;;;;;;;;;;2,0;;;;3,0;;;;;;;;;;;;;;7,0;;;;;;;;;;;;;2,0;;;4,0;1,0;;;;;1,0;;;;;;;18,0;;;4,0;;;;;;1,0;1,0;;;;;;;;;;;;;;;;;;3,0;;;10,0;;;;;;;;1,0;4,0;;;1,0;;;;;1,0;;;1,0;;;;;;;;;6,0;;;1,0;;4,0;;2,0;1,0;;;;;;1,0;;;;15,0;22,0;8,0;;;;;;;;;11,0;;;;;;;;1,0;;1,0;;;;;4,0;;;;1,0;;;;;;2,0;;;;;;3,0;1,0;;;;;;1,0;;14,0;;;8,0;;;;;;;;;;;;;;;;;3,0;;;;1,0;;;;1,0;;;;;;;;;;;;;;;;;;;;;;;;;;1,0;;;;1,0;;;;;;;;;;;;;4,0;3,0;;;;;;;;;7,0;;;;;;;;;;;;;;;;;;;1,0;;;1,0;;1,0;;;1,0;;;;;;;;4,0;;;;1,0;;;;7,0;5,0;;;;2,0;;;;;;;;;;3,0;;;;22,0;;;;;;;;33,0;;;5,0;;1,0;;;;6,0;;;;;;;;;;;;;;;5,0;;;;;2,0;;;;;;;;;;2,0;6,0;;1,0;;2,0;;;;;;;;;;;;;;;;;;;;;;;;;;;;;;;;;;;;;;;;;;1,0;;;;;;;;;;;;;;;;;;;;;;;;;;;;;;;;;;;;;;;;;;;;;;;;;;;;;;;;;;;;1,0;;;;;;;;;;;;;;;;;;;;;;;4,0;;3,0;6,0;;2,0;;;;1,0;;;;;;;;;;;;;;;;;;;2,0;;1,0;8,0;;;;;;;;;;;;;;;;;7,0;;;;;;;;;1,0;;;;;;;;;;;;;;;;;;;;5,0;;;;;;;;;;;;;;;;;1,0;;
slope;;;;;;4,0;;11,0;;;;;1,0;3,0;;3,0;;;7,0;;;;2,0;;;;;;;;16,0;;1,0;;;;3,0;;;;1,0;11,0;2,0;12,0;;3,0;;6,0;;;;;4,0;;15,0;;24,0;;;;1,0;;;;5,0;1,0;6,0;;3,0;1,0;;14,0;6,0;1,0;;;;;1,0;;3,0;3,0;;;3,0;;;17,0;;;;;3,0;;;;4,0;;12,0;33,0;7,0;;1,0;;;2,0;;;;;;14,0;2,0;;;;;;;;;;33,0;;;;;;4,0;;18,0;;;1,0;;;16,0;1,0;;;;;;;;;2,0;;;;;;;1,0;;;1,0;;;;;5,0;;;;;;4,0;1,0;;;;3,0;9,0;;1,0;;3,0;1,0;;;;;2,0;;;;;3,0;1,0;;;;;;2,0;3,0;2,0;7,0;2,0;;;;;;;4,0;;;;;;1,0;;;7,0;;2,0;;;6,0;;;;;;25,0;;2,0;;4,0;;4,0;;;;;;;;;;;;;;;2,0;5,0;14,0;;;;1,0;1,0;;;31,0;7,0;;;;;;2,0;;;;;;;;;;;;1,0;6,0;;;;;2,0;;;;;;6,0;;;1,0;;;;;1,0;;4,0;;;;;;;4,0;;;3,0;1,0;2,0;1,0;;2,0;;;;3,0;;1,0;4,0;;;;5,0;;;;3,0;;;;;3,0;;;;;1,0;;;1,0;;;;1,0;;;;;;1,0;;;;;4,0;1,0;;;;;;;;2,0;;;;;;;7,0;2,0;14,0;13,0;;;;;1,0;;;1,0;;;6,0;3,0;;;;;;;;;;;;;;6,0;;14,0;1,0;;;;;;;5,0;;;;;;;;;;;;4,0;;;;;;;;;;1,0;;;;;;;;5,0;;3,0;;;;;;;;10,0;;;14,0;;;;;;4,0;;;1,0;;;;;;;;;;;;;;;;;;;;;;;;;;;;;;1,0;;;;;;;1,0;;;;;;;;;;;;;;;;;;;;1,0;;;;;;;;;;;;;18,0;;;;;;;;;;3,0;;;;;;;;;;;;;;;;;;5,0;2,0;;;;;;;;;;;;;;;;;;;;;;;;;;;;;;;3,0;;;;1,0;;;;;;2,0;;;;;1,0;8,0;;;1,0;;;;;;;1,0;;;;;;;;;;;;;;;;;;;2,0;;;;;;;;;2,0;;;;;;;;;;;;;;;;;;;;;1,0;;;;;;;;;;;;;;;;;;;;;;;;;;;5,0;1,0;2,0;;;;;;;;;;;;;;;5,0;;;1,0;;;;;;;;;;;;;;;;;;;5,0;;;;;2,0;;4,0;;;;;;;;;;;;;;;;;;1,0;;;;;;;;;;;;2,0;;;;;;;;;;;;1,0;;2,0;;1,0;1,0;;;;;;;;;;;;;1,0;;3,0;1,0;;;;;;;;;;;;;;;;;;;;;;;;;;;8,0;;;;;;2,0;;;;;;;;;;;;;;;;;;8,0;;;;;;;;;;;;;;;;;1,0;;;;;;;;;;;;53,0;;;;;1,0;;;;;;;;;;;;3,0;;;;;;;3,0;;;;;;;;;;;;;;;;;;;;;;;;;1,0;;;;;;;;4,0;;;;;;;;;;;;;;;;;;;;;5,0;;;;;;;;;;;;;;10,0;;;2,0;;;;;;;;;;;;;;;;3,0;;;;
solder;;;;;;3,0;13,0;4,0;;;;;4,0;8,0;;;20,0;;;;10,0;;;1,0;;;;1,0;;;6,0;;;;;;;;1,0;;2,0;12,0;;;;85,0;;12,0;;;;;;4,0;;;27,0;;;;3,0;;1,0;;10,0;;14,0;;;;1,0;17,0;;;;;5,0;;;;34,0;;;;30,0;;;2,0;;1,0;;2,0;1,0;;;;;;55,0;6,0;4,0;1,0;;3,0;;8,0;;;;;;;;;;;;20,0;;10,0;;;;2,0;;;9,0;;1,0;;;;5,0;35,0;;;;;;;;3,0;;;;10,0;7,0;5,0;;7,0;;;;7,0;17,0;;;1,0;;;31,0;35,0;;;;;28,0;2,0;;;14,0;;1,0;3,0;;;1,0;;;;;;3,0;3,0;;2,0;1,0;;3,0;1,0;;;20,0;1,0;4,0;1,0;16,0;;8,0;;;9,0;;;;;10,0;1,0;;16,0;;9,0;;;;11,0;;5,0;2,0;;5,0;;;;6,0;;60,0;;4,0;;1,0;;;;;;;;;;;29,0;;;34,0;1,0;;4,0;11,0;;;5,0;;2,0;26,0;3,0;2,0;24,0;;;1,0;;;7,0;2,0;;;;;2,0;;50,0;3,0;;;;2,0;;5,0;;;;3,0;13,0;;;;;26,0;;13,0;;;;1,0;13,0;4,0;;6,0;;;;;;;2,0;;4,0;1,0;2,0;;;;;;;4,0;;;;;;1,0;;;;;;3,0;1,0;6,0;2,0;;4,0;;;;;3,0;;;;;;2,0;;;5,0;;4,0;;;;;;;;9,0;;;;;;;;;;;;;;;;;;;;;;;;;;;;;;;;;;;;;;;;;;;;;;;;10,0;;;;1,0;;1,0;;1,0;;;1,0;;;;;;;;;7,0;;;2,0;;;;;;;;;;;;8,0;16,0;;;;;;;;;;;;;38,0;;;;;;;1,0;;;;;;;;;;;;;;;4,0;;;;5,0;;;3,0;;;;;;;;;;;;;;;;1,0;;;3,0;;;;5,0;;;;;;;;;28,0;;;;1,0;3,0;47,0;;;;;;;1,0;;;;;;;;;;;;;;;6,0;;;;;;;;;;;;;;2,0;;;;;;;;;;2,0;;;;;;2,0;23,0;;;;;;;;;;;3,0;;;;;;;;;;;;;;;;;;;;;;;;;;;;3,0;;;;;;;;;;;;;;;;;;;;;1,0;;;;1,0;;;;;;;;;2,0;;;;;3,0;;;1,0;;;;;;;;;1,0;;;;;;;;;;;;;;;;;;;;;;;5,0;;;;3,0;;;;13,0;;;;;;;;;5,0;48,0;;;;;;;;;;;;;;;;;;;1,0;;;;;;;;;;1,0;;;;;;;;;;;;;;;;;;;;;;;;3,0;;;;;;;;2,0;;;;;;;;;;;;8,0;;1,0;;;;;;;2,0;;2,0;;;;;;;;;;;;;;;;;;;;2,0;;;;;;;;;;;;;;;4,0;;;6,0;;;;;;;;;;;;;;2,0;1,0;;;;;;;;;;;;;;;;;;;;;;;;;;;;;;;;;;;;;;;;;;;;;;;;;;;;;;;;;;;;;;;;13,0;;;;;;;;;;;;;;;;;;;;;;;;;;;;;;;;;;;;;;;;;;;;;;;;;;;;;;;;;2,0;;;;1,0;;;;;13,0;;;;;1,0;;;;;;;;;;;;;;;;;;;;;;
speaker;;;;;;19,0;14,0;2,0;;;;;;7,0;;;9,0;;;;3,0;;;1,0;16,0;;;6,0;4,0;;25,0;2,0;;;;18,0;9,0;;;;22,0;54,0;;11,0;19,0;15,0;;;;;;1,0;1,0;;4,0;;;;;7,0;;;;;13,0;;18,0;;;;;6,0;20,0;;;;;;;2,0;24,0;;14,0;;22,0;;;;;;;;;;;;;;8,0;41,0;5,0;2,0;;9,0;;19,0;;;;;;;;;;;;;;13,0;;;12,0;;;;29,0;;;;4,0;;;;1,0;;3,0;3,0;2,0;;;1,0;;;24,0;;3,0;3,0;4,0;2,0;;;;1,0;;;;;;;;4,0;1,0;;;;13,0;4,0;;5,0;;;4,0;;;;;6,0;1,0;;;;2,0;7,0;;;2,0;;;9,0;;3,0;;;1,0;;24,0;;;;;1,0;;;;;;;;14,0;1,0;;;;;;11,0;;;;;2,0;;;;;7,0;;;;;;1,0;;2,0;;;;;;;1,0;;;;;;3,0;8,0;;;;;5,0;;1,0;;7,0;3,0;;;7,0;;;3,0;;;;;1,0;;;;;;;;34,0;;1,0;;1,0;;;;;;;3,0;;;;;;;;13,0;2,0;;;;;;;;;3,0;4,0;;;;;4,0;;2,0;;39,0;;;;1,0;;;2,0;4,0;;;;9,0;;;;;;2,0;;;;;;2,0;20,0;;;;;18,0;;;;;;;;;;;4,0;20,0;25,0;;;;;;;1,0;;;;;;8,0;;;1,0;;;;;11,0;;;2,0;;10,0;;;;;;;;;;7,0;1,0;;6,0;;;1,0;3,0;;;6,0;;2,0;;3,0;;;;1,0;8,0;2,0;;2,0;;;;;;;1,0;7,0;15,0;;;;;;;29,0;;;;4,0;2,0;;;;;;;2,0;;;4,0;;;;;;;;;;;;;;;2,0;;;;;7,0;;2,0;;2,0;2,0;;;;;;1,0;;;68,0;;1,0;;5,0;;1,0;;;;;;;;4,0;;;;;7,0;;;;13,0;;2,0;;6,0;52,0;;5,0;;;;;;;;;;;;;;;;;;;;5,0;5,0;7,0;;;;;10,0;;;;4,0;;2,0;;;28,0;;;;;;;;;;;;;;3,0;;;;2,0;;;;;;;;;;1,0;;;1,0;;;;;;;;;;;5,0;;;;;;;;2,0;;;1,0;;;2,0;2,0;;9,0;;;2,0;;;;;;;;;;;;;;;;;;;;4,0;;;2,0;;;;;;;2,0;;;;;4,0;14,0;;;3,0;;2,0;;;;;;;;;;4,0;;;4,0;;;;5,0;;8,0;24,0;;1,0;;;;;3,0;;;;3,0;;;6,0;5,0;;;;;;;;;;;;;;3,0;;;;1,0;;;;;1,0;;;;;;;;;;;1,0;;;;;11,0;;;;;;;;;;;;;;;;;;;;;;1,0;;;;;;;;;;;;;;;;;;;;;;;;;;;;;;;;;;1,0;1,0;;;;;;;;;;;;;;;;1,0;;;;;;;;;;;;;;;;1,0;;;;;;;2,0;;;;;;1,0;;;;;;;;;;;;;;;;;;;;;;;;;;;;;;;;;;;;;;;;;;;;;;;2,0;;;;;1,0;;;3,0;;;;2,0;;;;;;;;1,0;;;;;;;27,0;;;;;;;;;;;;;;;;;;;;;;;;;;4,0;;;;;;;;;;;;;;;;;;;;;;1,0;;;;;;;;;;;;;;;;;;;;;24,0;3,0;;;;;;;;;;;;;;;;;;;;;2,0;;;;;;;
split;;;;;;2,0;1,0;1,0;;;;3,0;;1,0;;;1,0;;;;;;3,0;;;;;18,0;;;12,0;;;;;38,0;;1,0;;;4,0;8,0;;;5,0;;;2,0;;;;;1,0;;4,0;;2,0;;1,0;4,0;;;;;27,0;;12,0;;;;;1,0;54,0;;;;2,0;;;3,0;6,0;;1,0;26,0;;;;12,0;;;;;1,0;;;;;;8,0;;2,0;;;;;4,0;;;;;;;4,0;;;;;;6,0;2,0;;;10,0;;1,0;2,0;10,0;;;;;;;4,0;;;10,0;;1,0;;2,0;;;;1,0;;;2,0;;;;;;1,0;;;;;;;;2,0;;4,0;;;7,0;;;1,0;;2,0;4,0;;;;;;;;2,0;;;;;;;;16,0;3,0;;;;;;4,0;7,0;2,0;;;;1,0;;;;;;;6,0;6,0;;;;;;;13,0;;3,0;3,0;;;;;2,0;;13,0;1,0;;1,0;;3,0;;;1,0;;2,0;;;3,0;;3,0;;;;;4,0;;24,0;;;;;2,0;;;2,0;13,0;;;;;;2,0;3,0;;;1,0;;;;1,0;;8,0;1,0;;;4,0;;;;;;;;;;;12,0;;;5,0;;;;;5,0;2,0;;;;;;;;;;;1,0;;;;5,0;14,0;1,0;;3,0;;;3,0;;37,0;;;;;;;;;4,0;;;;;;;;;;2,0;;;4,0;;4,0;;;;;;;;;1,0;;;;7,0;;;;;;;;;;;;;2,0;;1,0;;;;;;;4,0;;;;;1,0;;;;;;;;;;;;;;;;;;;;;2,0;6,0;;1,0;;2,0;;1,0;1,0;;;;;15,0;;;2,0;;;2,0;;;;;;;;;;;;;2,0;;;;;2,0;;;;;;;;;;;4,0;1,0;;;;;2,0;;;1,0;;3,0;;;;;;;;;;;;1,0;;;;;;2,0;3,0;1,0;;;;;;;;;;;6,0;;;;;;;;;1,0;;1,0;;;;;;;;;;3,0;;;;;;;;2,0;;;;;;;;;1,0;;;;;7,0;;;;2,0;;;;;;;;;;;;;;;;;;;;;;;;;;;;;;;;1,0;;;;;;;50,0;;;;;1,0;;;;;;;;;;;;;;;;2,0;1,0;;;;;;;;;;;3,0;;;;1,0;;2,0;1,0;;;;;;;;;1,0;;2,0;;;;;;;;;;;;;;;;;;;;;;;;;;;;;;;;;;1,0;;;2,0;;1,0;;;;;;2,0;;;;;1,0;;;;;;;;;;;6,0;;;;;;;;;;;;;;;;;1,0;;;;6,0;;;;;;;;;;;;;;;;;;;4,0;;;1,0;2,0;;;;;;;;;;;;;;;;;;;;;;;1,0;;1,0;;;1,0;;;2,0;;;;;;;;;;20,0;;;;;;1,0;;;;;;;;;;;;;;;;;;;;;;;;;2,0;;;;;;;;;;;;;;;;;;;;;;;;;;1,0;;;;;;;;;;;;;;;;;;;;;;;;;5,0;;;;;;;;1,0;;;;;;;;;;;;;;;;;;;;;;;;;;;;6,0;;;;;;;;;;;;;3,0;;;;;;;1,0;;;;;;;;;;;;;;;;;2,0;;;;;2,0;;;;;;;;;;;;;;;;;;;;;;;;;;;;;;;4,0;;;;;;;;;;;;;;1,0;;10,0;;;;;;2,0;;;;;;;
square;;;;;;11,0;15,0;15,0;;;;6,0;;17,0;;;;1,0;;;;2,0;2,0;;;;;7,0;1,0;1,0;6,0;;;;1,0;5,0;8,0;;1,0;;12,0;4,0;;;2,0;8,0;;4,0;6,0;4,0;3,0;;1,0;;;5,0;12,0;;;10,0;;;1,0;;34,0;;6,0;;;;14,0;20,0;3,0;2,0;;;;4,0;;1,0;43,0;;;7,0;17,0;;;;;9,0;1,0;;;;;;62,0;1,0;37,0;30,0;10,0;;;1,0;;1,0;6,0;;;;;6,0;3,0;;;;1,0;8,0;1,0;6,0;;;84,0;1,0;;;24,0;;1,0;;10,0;1,0;;13,0;;;1,0;;;;;1,0;;1,0;;2,0;8,0;3,0;1,0;;;8,0;11,0;12,0;;;;;;;;1,0;;10,0;;;1,0;3,0;;;;2,0;1,0;14,0;;3,0;;;;;;;;39,0;;;;;2,0;11,0;2,0;;2,0;2,0;3,0;;34,0;;5,0;6,0;;;3,0;;1,0;1,0;4,0;;;11,0;;1,0;;;6,0;4,0;;;;;14,0;;;;1,0;;8,0;;;;;;;4,0;6,0;;;;;2,0;;;;;;;;53,0;4,0;;;;;;4,0;;3,0;2,0;1,0;;;;6,0;;5,0;;53,0;;1,0;10,0;;;;;;;4,0;3,0;;;;;2,0;;;;;;;1,0;;;1,0;1,0;9,0;;25,0;;;;;;;;;;;;3,0;;;;1,0;;5,0;;1,0;;1,0;;;3,0;5,0;2,0;;;;;;;1,0;;;1,0;;11,0;;;;;;;;;;8,0;;;;;;;;;1,0;1,0;7,0;3,0;;;;;;;;;;1,0;;;;;9,0;2,0;;;;;;;3,0;5,0;;4,0;;;;29,0;;;;;9,0;;;13,0;1,0;3,0;6,0;;;;5,0;;16,0;7,0;;;1,0;1,0;;1,0;;;;4,0;1,0;;;3,0;;;;;;2,0;;2,0;1,0;;;;;;;;;;;;;;;3,0;;3,0;;;;;;4,0;;;;;3,0;2,0;;;11,0;1,0;;;;;8,0;;;;;;;7,0;;;3,0;1,0;;;3,0;;;;;;13,0;;;;;;9,0;;;;3,0;;;;;;;2,0;7,0;1,0;;;;;;6,0;;;;;;;;;;;;17,0;;;;;;;;;;;4,0;;;;;1,0;;;;;;;;;;;;;1,0;;;;;;;;4,0;;;;1,0;;;;;;;;;;1,0;;;;;;;;3,0;;1,0;;;;2,0;;;;;;;;;;;;1,0;2,0;;6,0;;;;;;;;;;;;;;;;;;;2,0;;;;;;;;;;;;;;;;1,0;;;;;;;;;;;;;;;;;;;;7,0;;;;;3,0;;;;;;;9,0;;2,0;;;;;;2,0;1,0;;;;;1,0;;3,0;;9,0;;;1,0;;2,0;;;;;;;;1,0;1,0;4,0;1,0;4,0;;5,0;;1,0;1,0;3,0;;;;;;;;;;1,0;;;;;;;;;;;;;3,0;;3,0;;;;;;2,0;;;;;;;;;;;;;;;;;;;;;2,0;;;;;;;8,0;;;;;;;;;;;;;1,0;;;;5,0;;;;;1,0;;;;;;;;;;;;1,0;;;;1,0;2,0;;1,0;;;;;;;3,0;;;;;;4,0;;;;;1,0;;;7,0;;;4,0;;;;;;1,0;;4,0;;;;;;;;;1,0;;1,0;;;;;;;;;;;1,0;;;6,0;;;;3,0;;;;;;1,0;;;;;2,0;;;;;2,0;;;;;1,0;;;;1,0;;;;;;;;;;12,0;39,0;;;;;;;;;;;;;;;;;;;;69,0;;;;;1,0;;;2,0;;;;;;1,0;;;;;;;;;3,0;;4,0;;;;;;;;;;;;;;;;;;;1,0;;5,0;2,0;9,0;2,0;;;;;;;1,0;;;;;;5,0;;;;;;;;;
successive;;;;;;3,0;16,0;;;;;;;8,0;;2,0;20,0;;;;;;5,0;;;;3,0;;;;8,0;1,0;1,0;;2,0;28,0;;;2,0;;29,0;1,0;;3,0;4,0;;;;;;;;4,0;;1,0;;1,0;;6,0;6,0;;;2,0;;87,0;;14,0;1,0;;;;;9,0;2,0;;;;10,0;;2,0;17,0;;1,0;;5,0;;;11,0;;1,0;7,0;;;;20,0;;29,0;;11,0;7,0;11,0;1,0;;;2,0;;;;;;;;14,0;2,0;;;;5,0;7,0;7,0;5,0;;;8,0;;1,0;5,0;;;;14,0;2,0;;4,0;9,0;;2,0;2,0;;;;;;;;;2,0;3,0;;;;;1,0;;1,0;;;;;;;;;2,0;;;2,0;;;;4,0;5,0;;3,0;;1,0;;4,0;2,0;;4,0;;3,0;;;;3,0;;42,0;;3,0;;;2,0;;;;;;;;;;;4,0;;1,0;;;;1,0;8,0;;;;;2,0;;;4,0;;3,0;;;;;20,0;;;;;;;;;1,0;1,0;;;4,0;;;;;;;;;;;;;;;;;;3,0;;;;;;7,0;;;;;;;;;;;;;;2,0;;;;;;1,0;;;;;2,0;;;;;;;;19,0;;;;;;;11,0;;;;6,0;6,0;1,0;;;;;;;;;;;;7,0;;3,0;;;;;;;;;;;;;;;;;;;;;;;;;;;;;;;2,0;;;;18,0;;;;;;1,0;1,0;10,0;;;;;;5,0;;1,0;;;;3,0;;5,0;6,0;32,0;;1,0;1,0;;2,0;;;;;2,0;;1,0;2,0;;1,0;;;;1,0;;;2,0;;;;11,0;;;;;;3,0;;;;;;;;;;;3,0;;;;3,0;;;;;;;;;;;;;;;;;;2,0;;;;;3,0;;;;2,0;;;;;;;;;;;;;;;;;;;;;;2,0;1,0;;;;;;;10,0;;;;;;1,0;;;;;;;;1,0;10,0;;;5,0;;;;;;;2,0;;;1,0;1,0;;;;;;;1,0;;;;;;;;;;;;;;;;;2,0;;;;1,0;;;;1,0;;;;;;;;;;2,0;;;;9,0;;;;1,0;;;;1,0;1,0;;;;;;;;;;;;;;2,0;;;;;1,0;;;1,0;;;;;;4,0;;;;;5,0;;;;;;;;;;;;;;;;;;;;2,0;;;;;1,0;;;;;;;;;;;4,0;;3,0;;;;;;;;;1,0;;;;;5,0;;;2,0;4,0;;;;;8,0;;;;;;1,0;;;;;;;;1,0;;;;;;;;;;;;;1,0;;2,0;;;;;;;;;;6,0;;;;;;5,0;;;;;;14,0;;;;;;;;;;;;;10,0;;;;;;1,0;;;;4,0;;;;;;;1,0;;;;;;;;;;;;;;;;;2,0;;;;;;;;;;;;;;;;;;;;;;;;;;;;;;;;;;;;;;;;;12,0;;;;;;;;;;;;11,0;;;;;;4,0;;;;;;;;;;;;;;;;;;;;;;;;;;;;;;;;;;;;;;;10,0;;;;;;;;;;1,0;5,0;;;;;;;;;;;;;;2,0;;;;;;;;;;;;;;;;;;;;;;;;;1,0;;;;;;;;;9,0;;;6,0;;;;;;7,0;;;;;;;;;;;;;;;;;;;;;;3,0;;;;;;;;;;;6,0;;;;;;;;;;;;;;;;;;;;;;;;;;;1,0;;;;;;;;;;;
suspension;;;;;;7,0;;129,0;;;3,0;;;29,0;;;;;;;;;;;2,0;1,0;;2,0;;;35,0;6,0;;2,0;;9,0;1,0;;;;6,0;6,0;4,0;;;14,0;;42,0;;4,0;;;18,0;;;;3,0;;;5,0;3,0;;;;10,0;;44,0;;;2,0;;56,0;;;;;1,0;;;7,0;32,0;;;22,0;19,0;10,0;;44,0;;;10,0;5,0;6,0;1,0;;;3,0;;93,0;5,0;3,0;2,0;;;1,0;;;;;;;9,0;13,0;;;;;;;3,0;;;7,0;;;2,0;115,0;;1,0;;3,0;1,0;6,0;29,0;;;;;;;;1,0;;;5,0;;2,0;1,0;;22,0;;;4,0;;;;;;;;5,0;24,0;;;;;12,0;4,0;;;;;;17,0;;;;;3,0;;;;;1,0;;;;;2,0;;;;;;8,0;1,0;31,0;;10,0;;;22,0;;;1,0;;122,0;10,0;;16,0;;2,0;;;;4,0;;9,0;;10,0;;4,0;;;24,0;;50,0;;;;4,0;;;;;;;;;;;;1,0;2,0;;5,0;;6,0;6,0;2,0;;12,0;;15,0;2,0;14,0;104,0;23,0;5,0;;;;2,0;24,0;1,0;;;;;1,0;2,0;178,0;9,0;5,0;;;2,0;;2,0;3,0;;1,0;46,0;4,0;;;9,0;2,0;19,0;;8,0;1,0;;;;;;;9,0;4,0;1,0;4,0;5,0;;;2,0;;;4,0;;;;1,0;;;;2,0;;;5,0;;;3,0;;;6,0;;;21,0;6,0;1,0;;;4,0;;;1,0;;;;;2,0;;;;;5,0;5,0;;7,0;1,0;;;;;;;7,0;;;;;;;;;;;;;28,0;;3,0;1,0;;;;4,0;;;13,0;;;;;;1,0;;1,0;1,0;;;;1,0;;2,0;;;;;;;5,0;;;;;;;1,0;;37,0;;;5,0;;1,0;1,0;;;;;;;;11,0;;1,0;1,0;1,0;;;;;4,0;;;;;;;2,0;;2,0;;;2,0;;4,0;1,0;;;;;11,0;;;;;;;1,0;;;;;;;;;;;;12,0;3,0;;;3,0;;;11,0;;;3,0;;;;;3,0;;;;2,0;;;;;;;4,0;;;;;;;;;;;;;;;;;;;;;1,0;;;;;;;;;;;;;;;;;;1,0;;;;;1,0;;;;1,0;;;;;;;;;;;;;;;;;;;1,0;;;;;;1,0;;;;;;;;;;;1,0;8,0;;;;;;1,0;;;;;;;;;;;;;;2,0;;;;;;;;;;;;;;;;;;;;;;;;;;;;;;;;;;1,0;;;;;;;;;;;;;;;;;;;2,0;;;;;;;;;;;;;4,0;;8,0;;;;;;;;;;;;;;;;;3,0;;1,0;;;;3,0;;;;;;;;14,0;16,0;5,0;;3,0;;;;5,0;3,0;;;;;3,0;;;;;;1,0;;;;;;;;;;;4,0;;;;;;;;1,0;;;;;;;1,0;;2,0;;;1,0;;;;5,0;;;;;;;;;;;;;;;;;;1,0;;;;;;;;;;2,0;;;;;;;;;;;;;;;;;;;;;;;;;;;;;;;3,0;;;;;;;;;;;;;;;;;;;;;;;1,0;9,0;;;;;;;;;;;2,0;;;;;;;;;;;;;;;;1,0;;;5,0;;;2,0;;;;;;6,0;;;;;;;;;;;;;;;;;;;;;;;;;;;;;;;;;;2,0;;;;;;1,0;;10,0;;;;1,0;;;;;;;;;;;;;;;;;;;;;;;;;1,0;;;;;;;;;;;;;;;;;;;;;1,0;;;;;;;;;;;;;;;;1,0;;;;;;;;;;;
symbol;;;;;;12,0;1,0;2,0;;;;;;7,0;;;10,0;;;;;;2,0;3,0;2,0;;;;1,0;4,0;6,0;;;;;41,0;15,0;;;;;45,0;;1,0;25,0;1,0;;5,0;;;;2,0;;;;;2,0;;1,0;14,0;;;;;16,0;;14,0;;;;1,0;;6,0;;;;;1,0;;1,0;26,0;;14,0;;;;;;;;;;2,0;;;;1,0;;12,0;;23,0;6,0;;4,0;5,0;1,0;6,0;1,0;;;;;;;;;;1,0;6,0;;154,0;;49,0;3,0;;;7,0;;;;21,0;;;2,0;1,0;;;1,0;;;;;;;;;;;5,0;;;;;;;;;;;;;;;22,0;;;8,0;;;;;;;5,0;;;;;4,0;;;;;;;;;;6,0;;;2,0;;;;;2,0;;;4,0;;;;;;1,0;;;;;;;7,0;;;;;;;;5,0;3,0;;;;;;;;;;;;;;;;;;17,0;;;;;;12,0;;3,0;;;;;;;;;;2,0;;;;92,0;;;;;;;;3,0;;78,0;;1,0;;;;;;;;;;;;;;;;;;;;;;;;;;;;;;;;;;;2,0;;;;;;;;;;;;;;;;;;;;1,0;;;;;;;;;;;;;;;;;;;;;;;;6,0;;;;;;;;;;;;;;;;;;;;;;10,0;;;;1,0;2,0;3,0;;;;;;;;;;;;;;;13,0;;5,0;8,0;;;3,0;;;;;;;;;;;;2,0;16,0;;;;;;;17,0;;;3,0;22,0;1,0;1,0;;;;;1,0;;;;;18,0;;;;;4,0;;;;;;6,0;;;;6,0;;;;;;;;;;;;;17,0;;;;;;5,0;;1,0;;;;;;2,0;;2,0;;4,0;;1,0;;;;;;;;;4,0;;5,0;;;;;8,0;;2,0;;;;;;2,0;;;;;;;;;;;;;;;1,0;;;;;;;;;6,0;;;;1,0;;;;;;;3,0;5,0;;;;;;;;;;;;;;;;14,0;;;;;;2,0;;;;;;;1,0;;;;;;;;;;1,0;;;;12,0;;;;;;;;;;;;1,0;;;1,0;;;;;;;;;1,0;;;;;;2,0;3,0;;;;;;;;;;;;;;;;;;;;;1,0;;;;;;;;;;;;1,0;;4,0;;9,0;;9,0;3,0;;2,0;1,0;;;;;;;;;;;;;;;;;;;;;19,0;;;;;;;;;26,0;;;;;;;;;;;;;;;;;;;;;;;9,0;;;;;;;;;;;;;;;;;;;3,0;;;;2,0;;;;;;;;;;;;;;;;;;;;;;;;;;;;;;;;;;;;;;;;;;;;;103,0;;;;;;;;;;;;;;;;;;;;;;4,0;;;12,0;;2,0;;;;;;;;;;;;;;;1,0;;;;;;;;;5,0;;;;;;;;;;;;;;;;;;;;;;;;;;2,0;13,0;;;;;;;;;;;;2,0;;;4,0;;;;;;;;;2,0;;;;;12,0;14,0;;;3,0;3,0;;;1,0;1,0;;;;;5,0;;;;;;;3,0;;;;;;;1,0;;68,0;;;;;;;;;;;;;;;;;;;;;;;;;;;;;;;;;;;;;;;;;;;;;;;;;;;;;;;;;;;;;;;;;;;;;;;;;;;;;;;
synthesize;;;;;;14,0;12,0;;;;;;;15,0;;2,0;22,0;;;;;;17,0;;1,0;;;;3,0;1,0;34,0;6,0;4,0;2,0;;38,0;;1,0;20,0;1,0;4,0;5,0;;;94,0;;;;;;9,0;;;;6,0;5,0;5,0;;1,0;61,0;;;4,0;;524,0;;31,0;;;;;;;;;;;;;;26,0;;3,0;10,0;5,0;;;;1,0;2,0;;;;;5,0;;30,0;3,0;30,0;29,0;3,0;;;7,0;13,0;22,0;;;;;;9,0;8,0;;;;21,0;;7,0;4,0;;;59,0;2,0;;6,0;24,0;;;;5,0;;1,0;53,0;;;21,0;13,0;5,0;;;;;;;6,0;3,0;2,0;2,0;;;5,0;1,0;;;;;;;;;;;2,0;;;;1,0;;7,0;;;6,0;1,0;1,0;8,0;;;;;;24,0;;4,0;;;4,0;;7,0;;;;;;;;;;;;;;;;4,0;;;;;;;3,0;;;;;18,0;;;;;;;;;;16,0;;;2,0;;;23,0;;4,0;;;1,0;;;;;;;;6,0;2,0;4,0;;;;;;;;;;1,0;;;1,0;8,0;1,0;38,0;;;;;;;;;;;;;;3,0;;;;;;;;;;;11,0;;;;;;;;3,0;5,0;;;;;;;;;;;;1,0;;;;;;;;;;;;35,0;;9,0;;4,0;;;;;;;;;;;;;3,0;;;;;;;;4,0;5,0;;;;;;;1,0;;;;32,0;;17,0;;;;;1,0;;3,0;;;;;;1,0;1,0;;4,0;;4,0;;;2,0;;;;7,0;2,0;;22,0;;;5,0;4,0;1,0;;2,0;;5,0;3,0;;;4,0;;5,0;;1,0;;10,0;1,0;;;;;1,0;1,0;;;;;;;3,0;;2,0;;8,0;;;;;;;1,0;6,0;;1,0;;2,0;4,0;;;1,0;1,0;;;;;11,0;3,0;;18,0;;;;;;;;;;;;;4,0;;;;;;;;;;;;;;;3,0;;;3,0;;10,0;7,0;;6,0;;1,0;;;;;;1,0;;;;3,0;;;1,0;;;;;15,0;;;;4,0;;;;;;;;;;;;1,0;;;;;;;;;;;2,0;;;;;;;;;;;;2,0;;;;;1,0;;;3,0;;;;;;;;6,0;;;;;;;;;;;;;6,0;;2,0;;;;;;;;;;;;;1,0;;;;;;;;;;;13,0;;;5,0;;;;;;;;;;;;;;;;;;;;;;4,0;;;;;;;;;;;14,0;;1,0;1,0;;;;;;;;;;;;;;;;;;;;;;;;;;;;;;;;;;;;;;;;;;;;;;;1,0;;;;;;;;;;1,0;;;;;;3,0;;1,0;;;19,0;;;;;;;;;;;;;2,0;;;;;;;;;;;;;;;;;;;;;;;;;;4,0;;;;;;;;;;12,0;;;;;;;;;;;;;;;;;;;;;;;;;;;2,0;;;;;;10,0;3,0;3,0;;;;;;;;5,0;;;;4,0;7,0;;;;;;;4,0;;;;;;;;1,0;;;;;;7,0;;;;;;;;;;;;;;2,0;;;;;;;;;;;;3,0;;;7,0;;;;;;;;;;;;;;;1,0;;;;;;;2,0;;;;;;;;;;;;1,0;;;;3,0;;;;;;;;;;;;;;;;;;;10,0;;;1,0;;;;;;;;3,0;;;11,0;;;;;;;;;;;;;;;;;2,0;;;;;;;;;;4,0;;;;;;2,0;14,0;;;;;;;;;;;;;;;;;;;;;;15,0;;;;;;;;;;;2,0;;;;;;;
terahertz;;;;;;20,0;1,0;;;;;;;31,0;;;;;;;;;;;;;;;;;51,0;;;;;;;;;;;125,0;;;;1,0;;3,0;;;;;;;;;;;;205,0;;;;;4,0;;17,0;;;;3,0;;48,0;;;;1,0;;;;;;;;;;;1,0;;;;;21,0;;;;;;;;;;;;;;;;;;;;2,0;;;;;;;1,0;;;1,0;;;21,0;;;;1,0;;;;167,0;;;5,0;;;25,0;;3,0;;1,0;;;;19,0;;;;;;;;;;;;2,0;18,0;1,0;;5,0;;;;;;192,0;2,0;;;;;;;95,0;;;;;;;;;;;;;;;8,0;;;;;3,0;;;1,0;22,0;;;14,0;;;4,0;;;;;;;;;9,0;;;;;1,0;;;;;79,0;;;;;1,0;;;;;31,0;;;;;;;;;;;;;;;;;2,0;4,0;;1,0;1,0;;;;17,0;;;;;651,0;6,0;;;;;;2,0;;;;;;;;;;;;;1,0;;;;;;;;;;;;;;;;;;;;;;;12,0;;;;;;;;;;;;104,0;1,0;;;;;;;;;;;1,0;;;;;;;;;;;;;;1,0;;;;;;;;;;;;;;;;;;;;;;;;;;;;;;;;;;;;;;273,0;;;;;;;;;;;;;;;;;;;;;;;;;;;;;;;;;;;;;;;;;;;;;;;;;;;3,0;;;;;;;;;;;;;;;;;;;;;;;;;;;;;;;;;;;;;;;;;2,0;;;;;;;;;;;;;;;;2,0;2,0;1,0;;;;;;;;;;;;;;;;;;;;;;;;;;;;;;;;;;;;;;;;;1,0;;;;;;;;;;;;;;;;;;;;;;;;;;;;;;;;;;;;;;;;;;;53,0;;;;;;;;;;;1,0;;;;;;;;;;;;;;;;;;;;25,0;16,0;;;;;;;;;;;8,0;;;;;;;;;;;;;;;;;;;17,0;;;;;;;;;;;;;;;;;;;;;;;;;;;;;;;;;;;;;;;;;;;;;;;;;;;;;;;;;;;;;;;;;;;;;;;;;;;;;;;;;;;;;;;;;;;;;;;;;;;;;;;;;;;;;;;;;;;;;;;;;;;;;;;;;;;;;;;;;;;;;;;;;;;;;;;16,0;;;;;;;;;;3,0;;;;;;;;;;;;;;2,0;;;;;;;;;;;;;;;;;;;;;;;;;;;;;;1,0;;;;;;;;;;;;;;;;;;;;;;;1,0;;;;;;;;;;;;;;;;;;;;;;;;;;;;;;;;;;;;;;;;;;;;;;;;;;;;;;;;;;;27,0;;;;;;;;;;;;;;;;;;;;;;;;;;;;;;;;;;;;;;;;;;;;;;;;;;;;;;;;;;;;;;;;;;;;;;;
version;;;;;;1,0;;;;2,0;;;;22,0;;;10,0;;;2,0;;;1,0;;4,0;;;1,0;2,0;;4,0;;;;;8,0;;;1,0;;24,0;10,0;;27,0;18,0;;;;;;1,0;;;;;2,0;;;;4,0;;;1,0;2,0;112,0;1,0;18,0;;;;;109,0;;;;;;;1,0;;16,0;;1,0;10,0;;;;3,0;;1,0;6,0;5,0;;;;;4,0;3,0;20,0;;6,0;10,0;;1,0;;2,0;;;;;;3,0;2,0;;;;7,0;;1,0;4,0;1,0;;4,0;1,0;;24,0;77,0;;2,0;;23,0;;;1,0;;;1,0;2,0;11,0;;;1,0;;;;;6,0;;6,0;;;;137,0;;;;;;;;;;19,0;;;;;;;;;;;4,0;;;;;;;;;;;;;1,0;;4,0;;;2,0;;;;;;;;;;;;;;2,0;;;;65,0;;;;;;;3,0;2,0;;2,0;2,0;;;;;;;;;;;;;;;;;;;6,0;;;;;;51,0;;;1,0;;;;;3,0;;;;;;;;;;;;;;;;;;;;;;;;;;;;;;;;;;;;;;;;;;;;;;;;;;;;;;;;4,0;;;;;;;3,0;;;;;10,0;;3,0;;;;;;;;;;;;;;;;;3,0;;;;;;;;;;;;;;;;;;4,0;;;;;;;1,0;4,0;;;;;;2,0;;;;;;1,0;;1,0;2,0;;;;;;2,0;;;;;;3,0;;1,0;;2,0;;;;2,0;;;;11,0;5,0;;1,0;;;;;8,0;2,0;;;;;;;;;;;10,0;;2,0;2,0;;;;;;;;30,0;;22,0;;;;;;;1,0;;;4,0;;;;;;;;;8,0;17,0;;2,0;;;1,0;;18,0;1,0;;;;;11,0;2,0;1,0;;;;;;5,0;;;;;;;1,0;;;;;4,0;;5,0;;;1,0;;1,0;;;19,0;;;;;;;2,0;;2,0;;;;;;;;;;;;;;;;;;;;;;;;;;;;;3,0;;2,0;;;8,0;3,0;;;;;;;;2,0;;;;;;4,0;2,0;;;;1,0;;;;;;;;;;;1,0;;3,0;;;;;;;;;;;1,0;;;1,0;;;;2,0;;;;;;;;5,0;;1,0;2,0;;3,0;;;;;;;;;;1,0;;;1,0;;3,0;;;;;;6,0;;;;;;;;;;;;3,0;;;;;;;4,0;;;;;;;;;;;3,0;;3,0;1,0;;;;;;;;;;;;;;;;1,0;4,0;;;;;;;;;;;;;;;9,0;;;;;;;;4,0;;;;;;;8,0;;;;;;;;;14,0;;;;;;;;;;;1,0;;;;;12,0;;;;5,0;;;;;;;;2,0;;;;;;;;;;;;;;;;;;;;;;;;;;;;;;;;;;;;;;25,0;2,0;;;;;;;;;;;;;;;;;;;;;;;;;;;;;;;;;;;;1,0;;;;;;;;;;;;;;;;;;;;;;;;;;;2,0;;;;;1,0;;;;;;;;;;;;;;;;;;;;;;1,0;;;;;;;;;;;;;;;3,0;;;;;;;;;;;;;;;;;4,0;;;;;;;;;;;;;2,0;;;;;;;;;;;;;;;;;;;;;;1,0;;;;;;;;;;;;;2,0;1,0;;;1,0;;;;;;;;;;;;;;;1,0;;;;;;;;;;;;;;;;;;;;;;;;;
vision;;;;;;5,0;14,0;65,0;1,0;;;;;22,0;;2,0;38,0;;4,0;1,0;;;10,0;1,0;13,0;;;5,0;42,0;;11,0;4,0;4,0;2,0;;70,0;4,0;13,0;1,0;2,0;18,0;55,0;1,0;1,0;76,0;29,0;4,0;39,0;;2,0;2,0;;;;168,0;3,0;3,0;;;19,0;1,0;;6,0;;224,0;2,0;89,0;;1,0;3,0;2,0;85,0;7,0;8,0;6,0;;4,0;1,0;;2,0;67,0;;16,0;2,0;54,0;;;16,0;4,0;;15,0;3,0;1,0;3,0;;;2,0;3,0;58,0;91,0;61,0;6,0;2,0;17,0;18,0;36,0;1,0;2,0;;;;20,0;14,0;12,0;1,0;1,0;;12,0;9,0;117,0;;;9,0;;;3,0;1351,0;;1,0;;32,0;;;9,0;3,0;211,0;53,0;;;;;4,0;;;9,0;5,0;5,0;11,0;22,0;21,0;;;;;9,0;;;;;;3,0;5,0;3,0;;;3,0;3,0;13,0;;2,0;2,0;;8,0;8,0;;12,0;;4,0;1,0;;;114,0;;5,0;;;2,0;;7,0;18,0;;;;1,0;2,0;;42,0;;1,0;;;4,0;;;1,0;;2,0;;3,0;24,0;3,0;5,0;5,0;;;6,0;12,0;6,0;;1,0;5,0;;;;1,0;;74,0;;;;;4,0;3,0;1,0;14,0;;;1,0;;3,0;;3,0;;;1,0;18,0;3,0;7,0;9,0;;;;;8,0;2,0;12,0;2,0;11,0;9,0;;;1,0;15,0;512,0;2,0;4,0;2,0;2,0;;3,0;18,0;2,0;;4,0;;;1,0;11,0;;2,0;3,0;;11,0;13,0;;;2,0;1,0;9,0;5,0;;3,0;;;;;36,0;9,0;;6,0;;;;29,0;;;2,0;;3,0;16,0;;;;;2,0;;4,0;;2,0;;1,0;50,0;;6,0;1,0;;;;15,0;;6,0;;;;;;;;;;;1,0;1,0;;;1,0;;1,0;;;;;;;17,0;;;1,0;33,0;1,0;;;1,0;;;2,0;5,0;3,0;;2,0;;1,0;2,0;5,0;2,0;;2,0;3,0;;;42,0;1,0;;;1,0;30,0;9,0;1,0;5,0;3,0;;5,0;3,0;2,0;16,0;16,0;;12,0;1,0;;;9,0;1,0;7,0;;16,0;3,0;17,0;23,0;;;14,0;;26,0;;1,0;;4,0;;3,0;;1,0;;4,0;1,0;11,0;8,0;;22,0;;;;5,0;;7,0;;1,0;3,0;6,0;2,0;;;10,0;;;;1,0;6,0;35,0;3,0;;6,0;;2,0;;;1,0;24,0;2,0;1,0;1,0;;;;;;2,0;;;;2,0;7,0;;10,0;3,0;;1,0;1,0;3,0;11,0;;;;10,0;56,0;;4,0;1,0;3,0;2,0;;4,0;1,0;3,0;3,0;;9,0;;;;6,0;2,0;2,0;;;2,0;;8,0;;4,0;3,0;;;;;1,0;2,0;;;4,0;5,0;4,0;;;;;;;;;4,0;1,0;;2,0;5,0;;;;;2,0;;1,0;;14,0;10,0;;;;3,0;2,0;7,0;;5,0;;;2,0;3,0;;;;1,0;;;5,0;;;13,0;;;;;;;6,0;2,0;9,0;;1,0;;;7,0;;1,0;21,0;;;;;;;;;;;10,0;;11,0;1,0;3,0;;6,0;;;12,0;;;;1,0;3,0;;;;;3,0;;;;;1,0;22,0;;;;5,0;;;;6,0;;;;;;2,0;;;;;;;1,0;;;;5,0;1,0;6,0;;;;;;7,0;;1,0;7,0;;;;;;;;;;;;12,0;;1,0;8,0;;3,0;;2,0;;1,0;;47,0;;;;1,0;1,0;;1,0;6,0;;;;;35,0;;;;1,0;;2,0;;;4,0;1,0;;2,0;9,0;9,0;2,0;11,0;;;;;1,0;2,0;;11,0;;;;5,0;;;2,0;;;;;;;;2,0;;;;8,0;;;;1,0;;;;;5,0;;2,0;;;3,0;;;;;;;;;;1,0;;;;;;;;;;;3,0;2,0;;1,0;;;;;;3,0;;;;;;2,0;;;3,0;;;;;;;;;;2,0;;;;;;;;;;1,0;4,0;1,0;7,0;;;;;;1,0;;;;;6,0;;;;6,0;;;;5,0;15,0;;9,0;;2,0;;;1,0;1,0;2,0;;;;;;;2,0;;;1,0;1,0;14,0;6,0;;2,0;6,0;1,0;;;;;2,0;;;;;;;;;;4,0;2,0;;1,0;;;;;;;;19,0;1,0;;;;;;1,0;1,0;;5,0;;;;;25,0;;;;;;;;;2,0;;3,0;;;2,0;;;1,0;;;;35,0;;2,0;;;;;;;;;;;;;;;;;;;4,0;;2,0;;;;;;;;;;;2,0;;;;;;;5,0;;;;;;;;4,0;;11,0;1,0;;;;;;;;;;;;;;2,0;;;;;;;;;;;;;;;
yoke;;;;;;15,0;;6,0;;;;;9,0;32,0;;;;;;;;;;;;1,0;;;;;23,0;;;24,0;;;;;;;;9,0;;;;96,0;;2,0;;;;;9,0;1,0;4,0;;28,0;;;11,0;;;;;9,0;;41,0;2,0;;6,0;8,0;63,0;1,0;;;;6,0;;;;2,0;;;;65,0;10,0;;22,0;;;;;1,0;;;;;;46,0;;27,0;;;;;;;;;;;;2,0;;;;;3,0;;9,0;;;1,0;1,0;;;1,0;;;;;;;61,0;;;;;;;;5,0;;;;6,0;1,0;19,0;;6,0;4,0;7,0;5,0;3,0;;;;;;;3,0;7,0;;;;;14,0;24,0;;1,0;;;;30,0;;2,0;;;;;;;6,0;56,0;;;;17,0;18,0;3,0;;;;3,0;13,0;5,0;11,0;;111,0;6,0;3,0;1,0;;;2,0;;43,0;;;26,0;7,0;5,0;;;;18,0;;4,0;;;1,0;;;;11,0;;124,0;;1,0;;4,0;;2,0;;2,0;;;;;;;14,0;;;;1,0;1,0;13,0;51,0;;;4,0;;2,0;1,0;;7,0;41,0;2,0;;;;;;12,0;;;;;;;;20,0;;;;7,0;;10,0;;;3,0;25,0;3,0;;;9,0;1,0;5,0;;102,0;;5,0;6,0;;;15,0;3,0;;;;;;4,0;;21,0;;;;;;;4,0;;2,0;;7,0;;6,0;2,0;6,0;;29,0;3,0;;6,0;;2,0;4,0;1,0;7,0;;;3,0;;;;;2,0;;;;;;;1,0;4,0;13,0;;24,0;;;;;;;;27,0;;;;;;;;;;;;;2,0;;;13,0;3,0;;;;;;2,0;;;;;;;;;;;;;;1,0;2,0;;;;;;;;;;2,0;;;;9,0;;10,0;;;;;8,0;;;;;;;;;;;;;;;;;;;;;;;;;6,0;;41,0;;;;;;;;;;;;;;;;1,0;;;;1,0;;;;;;;;;;;1,0;;;;;;182,0;;;;;;;;1,0;;;;;;;;;;;2,0;;;;;;1,0;;;;;;;;;3,0;;;;;;2,0;3,0;;15,0;;;;;;;;;;6,0;3,0;;;;;;;;;3,0;;;;;;;;;;;;;;;;;;;;;;;;2,0;;;;;;;;;;;;;;;;1,0;;;;;;;;;;;;;;;;;;;;;;;;;;;;;;1,0;;;;;;;;;;;;;;;;;;;;;;;;;2,0;;2,0;;3,0;;;;;;;;;;;;;;;;;;;;;;;;;;7,0;;;;7,0;;;;;;;;;;;;;;;;;;;;;;;5,0;;1,0;;;;;;13,0;49,0;;;;;;;;2,0;;2,0;;;3,0;;;;;;;;;;;;;;2,0;;;;;;1,0;;;;1,0;;;;4,0;;;;;;42,0;;;;;;;3,0;;;;;3,0;;;;;;;;1,0;;;;;;;4,0;;3,0;;;;;;6,0;8,0;;;;;;;;;;;;;;;;;3,0;;;;;;;;;;;;;8,0;;;;;;;;;2,0;;1,0;;;;;;;;;;;;;1,0;;;;;;;;;;;;;;;;;;;;;;;;;;;;;;;;;;;;;;;;;;;;;;;;;;;;;;;;;;;;;;;;;;;;;;;;;;;;;;6,0;;;;;;;;;;;;;;;1,0;;7,0;;;;1,0;;;3,0;;;;;;;;;1,0;;;;;;;;;;;;;;;;;;;;2,0;;;;;;;;;;;;;;;;;;;;;;;;;;;
chassis;;;;;;;4,0;43,0;;;;;1,0;14,0;;;6,0;;;;;;;;;;;4,0;;;3,0;;;;;;;;1,0;;;42,0;;;3,0;8,0;;;;;;;2,0;5,0;3,0;;18,0;;;1,0;;;;;13,0;;19,0;;;;;11,0;;;;;;;;;5,0;;6,0;;13,0;4,0;;3,0;;;;3,0;1,0;1,0;;;;;26,0;3,0;6,0;;;5,0;;;;1,0;;;;;;;1,0;;;;;22,0;;;;;;;7,0;;;;;;;6,0;;;;;1,0;;;6,0;;;7,0;1,0;;;2,0;15,0;2,0;1,0;31,0;9,0;;;;;;;1,0;1,0;;;;;6,0;;;;;;;;;;;;;;;;1,0;;3,0;;;2,0;2,0;16,0;;;7,0;2,0;8,0;3,0;13,0;;;;;;2,0;;;;2,0;3,0;;40,0;;4,0;;;;;;3,0;;;1,0;;;;1,0;;5,0;;;;;;;;6,0;;;;3,0;;;2,0;;13,0;;;;;19,0;4,0;4,0;;2,0;30,0;1,0;;12,0;2,0;;;;;;1,0;2,0;;;;;;;;5,0;;;;7,0;;1,0;1,0;;;3,0;;;9,0;;;;;3,0;;;;;;;2,0;;;3,0;;;;;;1,0;2,0;;37,0;;;4,0;;4,0;;8,0;4,0;;3,0;6,0;;;;10,0;;;;2,0;;;;;;;;;;;2,0;;;;;1,0;9,0;;2,0;;6,0;;;;;8,0;;;1,0;1,0;;;;;;;;;;;;;;;1,0;;;;;;;2,0;;;;2,0;;;;;;;;;;;;;;;;2,0;;;;;;;1,0;;2,0;7,0;;;1,0;;;;;;;;;;;;6,0;;;;;;;;;;19,0;;;1,0;;;;;;;;;;;;;;;;;;;;;;;;;;;;;;;;;;;;;;;;;;3,0;;;1,0;;11,0;;;2,0;;;;;;;;;;;;;;;3,0;;;;;;;;;;;;;;;;;3,0;;;6,0;;;5,0;;;;;;;;;;;;;1,0;;;;1,0;;;;;;;;;;;;;;;;;;;;;;;;;;;;;;;;2,0;;;;;;;;1,0;1,0;;;1,0;;;;;;;;;;;;;;;;;;;;;;;;;;;;1,0;;;;;;;;;;;;;;;;;;;;;;;;;;;3,0;1,0;;;;;;;;;;;;;;;;;;;;;;;;;;;;;;;;;;;;;;;;11,0;;;;;;;;;;;;8,0;;;;;;;;3,0;2,0;;;;;;;;;;;;;;;;;;8,0;;;;;;;;;;;;4,0;;;;1,0;;;1,0;;3,0;;;;;;;;;;;;;;;;;;;;3,0;;;;;;1,0;;;;;;;;;;;;;;;;;;;;;;;;;;;;;;;;;;;;;;;;;;;;;;;;;;;;;;;3,0;;3,0;;;;;;;;;;;;;;;;;;;;;;;;;;;;;;;;;;;;;;;;;;;;;;;;;;;;;;10,0;;;;;;;;;;;;;;;;;;;;;;;;;;;;;;;;;;;;2,0;;;;;;;;;;;;;;;2,0;1,0;;;;;;;;;;;;;;;;2,0;;;3,0;;;;;;;;;;;;;;;;;;;;;;;;;;;;;;;;;;;;;;;;3,0;;;;;;;;
sheet;;;;;;;5,0;16,0;;;;;3,0;9,0;;;1,0;;;;;;4,0;;;;;3,0;;;14,0;;;;;4,0;2,0;4,0;;1,0;;10,0;;2,0;1,0;2,0;;8,0;;;;;;;;;26,0;;;;;;;;18,0;;23,0;;;;2,0;27,0;44,0;;;;42,0;;;;26,0;;;3,0;21,0;3,0;;7,0;;;;;1,0;;;;;;17,0;3,0;3,0;2,0;;;1,0;;;1,0;;;;;1,0;;;;;;;5,0;;;1,0;;;3,0;12,0;;;1,0;;;;5,0;;;;8,0;1,0;;;1,0;;;3,0;;1,0;7,0;;4,0;;;6,0;5,0;;;;;;;2,0;5,0;;;;;4,0;6,0;;1,0;;;4,0;;;2,0;;10,0;1,0;;;;1,0;6,0;;7,0;1,0;;;13,0;;;2,0;6,0;1,0;1,0;3,0;;6,0;;;7,0;1,0;;;5,0;21,0;9,0;4,0;6,0;;;;2,0;;15,0;;2,0;;3,0;1,0;;;;11,0;;33,0;1,0;;2,0;;5,0;2,0;;;;8,0;2,0;1,0;;;4,0;;;4,0;2,0;;2,0;23,0;;;;9,0;5,0;7,0;1,0;10,0;29,0;;;;1,0;;;;;1,0;;;;;;4,0;;2,0;;;4,0;;1,0;;;;5,0;;;;1,0;5,0;2,0;;;;;;;;;22,0;;2,0;;76,0;;;;;;;3,0;;;;;;;;;;1,0;;;6,0;;2,0;3,0;;;1,0;3,0;;;;;;5,0;;;;;;;;;;3,0;2,0;1,0;;8,0;;;;1,0;;;;6,0;3,0;;;;;;;;;;;;1,0;;;;;1,0;;;;;;;;;;8,0;;;;;;;;;;1,0;;1,0;;;;;;;;4,0;;;;;;4,0;;;;2,0;;;;;;;;;;7,0;;;;;;;;;;;;;;;;;;;;6,0;;;5,0;;;;;;;;;1,0;;;;1,0;;;;;;1,0;;;;;1,0;;;;;;;1,0;;;;19,0;;;;1,0;;;;4,0;;3,0;;6,0;;;1,0;;;3,0;1,0;;;;;;;;;;;;;;;;;2,0;;;;2,0;;;;;;;;;;;1,0;;2,0;;;3,0;;;;;;;;3,0;;;;;;;;;;;;;;;;2,0;;;;;;2,0;;;;12,0;1,0;;;;2,0;;;;6,0;;;1,0;;;;7,0;;;;;;;1,0;;;;;1,0;;;;;;;;;;;;;;;;;;1,0;;;;;;;;;;;;;;;;;;;1,0;;;;2,0;;;;;3,0;;;;;;;;2,0;;;;;;;;;;;;;1,0;;1,0;;2,0;;;;;;;;;;;;;;;;1,0;;;;;;;8,0;;;;;;;;1,0;1,0;1,0;;;;;;3,0;5,0;;1,0;;;;;;;;;;;;;;;;;;;;1,0;;1,0;;;;;;;;;2,0;;3,0;;;;2,0;;2,0;;;;;;;;;;;;;;;;;;;;;;;;;2,0;;;;;;1,0;;;2,0;;;;;;;;;;;;3,0;1,0;;;;;;;;4,0;;;;;;;;;;;;;;;;2,0;;;;;;;;;;;;;;;;;;;;;;;;;;;;;;;;;19,0;;1,0;;;;;;;;;;;;;;3,0;3,0;;;;;;;;;;;;;;;;;1,0;;;;;;;;;;;;;;;;;5,0;;;;;;;;;3,0;;;;;;;;;;;;;;;;;;;;;;;1,0;;2,0;;;;;;;;;;;;;;;;;;;;1,0;;;;;;;;;;;;;;;;;;;;;;;;;;;;;;;;;;;;;
blade;;;;;;;;10,0;;;;;1,0;47,0;;;6,0;;8,0;;;;;;;;;68,0;;;35,0;;;;;3,0;4,0;7,0;;;1,0;8,0;3,0;;;44,0;;3,0;;;;;4,0;;;6,0;24,0;1,0;;1,0;2,0;;20,0;;10,0;;36,0;;;;10,0;14,0;6,0;1,0;;;;;;;20,0;;2,0;;18,0;3,0;;9,0;;;;4,0;2,0;1,0;1,0;;;4,0;67,0;;23,0;4,0;;;;;;;;;;4,0;4,0;;3,0;;;2,0;;;;6,0;;2,0;;;48,0;;;2,0;;;;42,0;;;;;;;;;;;2,0;2,0;3,0;21,0;;12,0;5,0;7,0;6,0;;;;;;1,0;;;21,0;;;;;28,0;14,0;;;;;3,0;31,0;5,0;20,0;1,0;;;;;;;20,0;;;65,0;8,0;;;;;;;1,0;32,0;12,0;;4,0;1,0;;1,0;;;;;82,0;;;58,0;6,0;10,0;;;;75,0;;5,0;;4,0;;;;;26,0;;57,0;;;;16,0;;;;4,0;;;;;;;6,0;6,0;8,0;;;;2,0;12,0;;1,0;;3,0;7,0;;3,0;20,0;40,0;8,0;;;;;;2,0;;;;;;;1,0;3,0;;;;1,0;7,0;11,0;;;;2,0;3,0;;;;;;;17,0;;13,0;;;3,0;;;;;;;1,0;2,0;;;;3,0;1,0;;;;10,0;;;;11,0;;2,0;7,0;;2,0;3,0;;;1,0;;;3,0;;;1,0;;;1,0;;;;;;27,0;1,0;16,0;27,0;;3,0;4,0;18,0;;33,0;;;;2,0;4,0;;;4,0;5,0;;;;;;;;;9,0;2,0;;;;;6,0;;;;;;;2,0;;;;;;;;;;;;;;;;;;;;;;;;;5,0;;;;2,0;;2,0;;;4,0;2,0;2,0;;;;;;;;;2,0;;;;;;;;;;;;;7,0;;;;;;;;;;;1,0;;;;;;;;;;2,0;;;;;;;;;;;;;;;;;;4,0;;;6,0;;;;;;3,0;;;;;;;;;;;;;;;;3,0;;;;;;;;;;;;;;5,0;33,0;;;;;;;;;3,0;;;;;;;;;;;;;;;;;64,0;;;;4,0;;;;;;;;;;;;;;;;;;;;;;2,0;;;;1,0;4,0;;;;;1,0;;;;;;;;;;2,0;;;;;;;;1,0;;2,0;;;;;;;;;;;;;;;;1,0;;;;;;;;;;;;;;;;;;;;;;;;;;;;;;;;;;1,0;;;;;;;;;;;;;;;16,0;7,0;;;;;;;;;;;;;;;;;;;;;;;3,0;;;;;;;6,0;;3,0;;;;;;12,0;99,0;2,0;1,0;1,0;;;;;;;;;;1,0;;;;;;;;;;2,0;;;;;;;5,0;;2,0;1,0;;;;;3,0;1,0;;1,0;;;;;;30,0;5,0;29,0;;;3,0;;;;;;;2,0;;;;;1,0;;2,0;4,0;;;;9,0;;;;;;;;;3,0;;;3,0;1,0;;;;;;;;;;;;;;;38,0;;;;;;;;;;;;;;;;;;;;;;;;;;;;;;;;;;;;;;;;;;;;;;;;;;;;;;;;;;;;10,0;;;;;;;;;;;;;;;;;;;;;;;;;;;;;;;;;;;;;;;;;;;;;3,0;;;;;;;;;;;;;;;;;;;;;1,0;;;;;;;;;;;;;;;;;2,0;;;;;;3,0;;;;;;;;;;;;;;1,0;;;;;;;;;;;;;;;;;;;;;;;;;;;;;;;;;
gradient;;;;;;;;2,0;10,0;;;;;42,0;;;;;1,0;13,0;;;30,0;;;;;3,0;;7,0;9,0;1,0;;;;6,0;5,0;40,0;2,0;;64,0;19,0;;3,0;;;;;;2,0;8,0;;;;6,0;;3,0;;;10,0;;;7,0;;96,0;;28,0;;1,0;;4,0;10,0;1,0;;;16,0;;;;;45,0;;;3,0;6,0;;;1,0;;15,0;2,0;;2,0;;;;104,0;;42,0;14,0;3,0;18,0;;;4,0;3,0;;;15,0;;;1,0;6,0;;;;2,0;3,0;;3,0;;1,0;64,0;;;20,0;9,0;;;;27,0;8,0;;9,0;;;1,0;10,0;;;;1,0;;;;6,0;1,0;;;;1,0;;;;;;;;;;;1,0;;;;10,0;;;1,0;1,0;2,0;;3,0;66,0;;39,0;3,0;;;;1,0;;;1,0;;;7,0;;1,0;;6,0;;;;;;;;;1,0;;2,0;;;1,0;1,0;1,0;;;;;2,0;1,0;;;;5,0;;;1,0;13,0;28,0;;;;;;;;;;;10,0;1,0;;5,0;1,0;;;;;;;;;6,0;;2,0;2,0;;;;;;;;;4,0;;;;2,0;;;;;;;2,0;5,0;;;;;;;;;;;;;;;;;;4,0;2,0;;;;;;;;;;;;;;;;;;;;;;;;;;;;3,0;;;;3,0;5,0;;;;;;;;;;;;;;;;;;;;;;;;;1,0;3,0;;;;;;;;;;;;;;;;;;;;;;;;;8,0;3,0;37,0;16,0;;;3,0;3,0;4,0;1,0;;;;6,0;;4,0;;;;;3,0;2,0;;23,0;;;9,0;;;2,0;;9,0;2,0;3,0;;;;;;;;;12,0;11,0;;;;;;;;;1,0;2,0;;;1,0;;;;123,0;;;;;;5,0;;8,0;;20,0;;;2,0;;;1,0;;;8,0;;;;;3,0;1,0;;1,0;7,0;;1,0;1,0;;;1,0;;;;;;;;1,0;;;;;1,0;;;;1,0;;;9,0;;;;;;1,0;;;;;;;;;;;;9,0;;;;;;;;;;;;;3,0;;;;;;3,0;;;;;;;;2,0;;;40,0;;3,0;;;1,0;;;;;;;;;;;;;1,0;3,0;;1,0;;;;;;;;7,0;;;2,0;;;;;;;;;1,0;;;;;;;;;;;;;;1,0;;;;6,0;;;;;;;;;;22,0;;;;;2,0;;1,0;1,0;3,0;;;;;;;;;;9,0;1,0;;;;;;;;;;;;;;;;;;;;;;;;;;;;2,0;43,0;;3,0;;;;6,0;4,0;;;;;;;;;;;4,0;;;;;;;;1,0;5,0;;;;;;2,0;;;;;;;;;;1,0;;23,0;;;;;;;;1,0;;;;;;1,0;;;;;8,0;;;3,0;;;;;;3,0;;;;;;;;;;;;;;;;;;;;;;;;;;;;;;;3,0;;;;;;;;;;;;;;8,0;;2,0;;;;;;;;9,0;;;;1,0;1,0;;11,0;;;2,0;;;;;;1,0;1,0;;;;;;3,0;;10,0;2,0;;;9,0;;;;;;;7,0;;;;10,0;;;;;;;15,0;;;;6,0;1,0;;20,0;4,0;;;;;;;;17,0;;;;;;;5,0;;;;1,0;;;;;;;;;;;;;;;;1,0;;;1,0;;;;;;;;;;;;;;;;1,0;;;1,0;;;;;;2,0;;;2,0;;;;;;1,0;;;;4,0;;;;;;;;;;;;;;;;8,0;3,0;;;;;6,0;;;;;;;;;;;;;;;;2,0;;;;;;;;;;9,0;;;;;;;;;;;;;;;5,0;;;;;;;2,0;;;;;;;;;1,0;;;1,0;;33,0;;;;
pane;;;;;;;;2,0;;;;;;3,0;;;;;;;;;;;1,0;;;;;;2,0;1,0;;;;10,0;3,0;;;;;10,0;;2,0;14,0;;;2,0;;;;2,0;1,0;;1,0;;1,0;;;1,0;;;;;53,0;;24,0;;;;;1,0;17,0;;;;1,0;;;;3,0;;1,0;;1,0;;;4,0;;;;1,0;8,0;;;;;1,0;;;;;5,0;;;;;;;;;;2,0;;;10,0;;;;18,0;;;7,0;;;;5,0;;;;;;;;;1,0;24,0;;;;;1,0;;;3,0;;1,0;10,0;;1,0;;;5,0;;;;;;;;;;;;;;13,0;4,0;;;;;;1,0;;;;2,0;;;;;1,0;15,0;;1,0;;;;2,0;;;;5,0;;;9,0;1,0;16,0;;;1,0;;;;;;;9,0;2,0;;;;15,0;;44,0;1,0;2,0;;6,0;;;;;4,0;17,0;5,0;;;1,0;;2,0;;;;;13,0;;;1,0;;;;;1,0;1,0;3,0;;3,0;;;;;;;;;31,0;1,0;;;2,0;;23,0;;;;;;48,0;3,0;;;1,0;;;;2,0;5,0;4,0;;;;;;;;;1,0;;;;;;;;;;;1,0;;;;;;;;;;3,0;;;;;;;;;;;;2,0;;;;;;;;;;;;;;;;;;;;;;;;;;5,0;1,0;;;;;;;;;;;;;;;;;;;;;;;;;;;;;;1,0;;1,0;;;;;14,0;;;;;;;;;;;;;;;;;;;;;;;;;;;;;;;;;;;;;;;;1,0;;1,0;;;;;;;;;;;;;;;;;;;;;6,0;;;;1,0;;;;;;;;;;;1,0;;;;;;;;;;4,0;;;;;;;;;;;1,0;;;;;;;;;1,0;;;6,0;;;;;;;;;;;;;;;;;;;;2,0;;;;;;;;;;4,0;;2,0;;;;;;;;;;;;;;;10,0;;;;;;;;;;;;;;;;;;;1,0;;;;5,0;;;;;;;;;;;;;;;;4,0;;;;;;;;;;;;;;;3,0;2,0;;;;;;;;;;;;;;;;;;;;;;;;;;;;;;;18,0;;;;;;;;;;;;;;;;;;;;5,0;;;;;5,0;2,0;5,0;;;;;;;;;;;;;;1,0;;;;;;;;2,0;;;;;;;;;;;;;;;;;;;;;;;;;;;;;;;1,0;;;;;;2,0;;;;;;;;;;;;;;;;;;;;;;;;;27,0;;;;;;;2,0;;;;;;;;;;;;;;;;;;;;;;;;;;;;;3,0;;1,0;;;;;;27,0;;;;;;;;;;;;;;;2,0;;;;;;;2,0;;;;;;;;;;;;;;;;;;;;;;;;;;;;;;;;;;;;;;;;;;;;;;;;;;;;;;;;;;;;;;;;;;;;3,0;;;;;;;;;;;;;;;;;;;1,0;;;;;;;;;;;;;;;;;;;;;;;;;;;;;;;;;;;;;;;;;;;;;;;;;;;;;;;;3,0;;;;;;;;;;;;;;;;;;;;;;;2,0;;;;;;;;;;;;2,0;;;;;;;;;;;;;;;
principal;;;;;;;;3,0;;;;;;;;;11,0;;;;1,0;;;;;;;4,0;;;2,0;1,0;;2,0;;;;;48,0;;6,0;6,0;;;2,0;6,0;;5,0;;;6,0;;;;10,0;28,0;5,0;;;7,0;;;6,0;;35,0;;3,0;;;;22,0;18,0;5,0;1,0;;;;3,0;;;6,0;;;4,0;4,0;;;8,0;;;3,0;;;1,0;;;12,0;6,0;3,0;49,0;16,0;1,0;;;;1,0;;;;;;;6,0;;;;;12,0;15,0;2,0;;;;;;;5,0;;;;;;;4,0;;;13,0;;;;;;;;;;;2,0;7,0;;;;10,0;3,0;;;;;;;;;;;;5,0;2,0;1,0;;;;;2,0;2,0;;;;;;;;;;3,0;;1,0;;;;3,0;;;;;;;;5,0;;;;1,0;;;;;1,0;;;6,0;;;;;;;;1,0;;;;;;;;;6,0;;;;;;;4,0;2,0;;;;;3,0;;;;;;3,0;;;7,0;;;;;1,0;;;;27,0;;;;;;;;;;;;;3,0;;;;;;;14,0;2,0;;;;17,0;4,0;;;;;;;;;;;;;12,0;;;;;;;;;;;;2,0;4,0;;;;;;;;;3,0;;;9,0;;;;;;;;;;;;;;;;;;;;;;;;;;;;1,0;;;;;;;;;3,0;;;;;;;2,0;;2,0;;;;;1,0;;;;;;;;4,0;13,0;;;;;;1,0;;;;;;9,0;;7,0;;9,0;;;;;;;;2,0;;2,0;;;;;;;;;;;;;;;1,0;;;4,0;;;;;;;;;;;2,0;13,0;;;;;;;;2,0;;;;;;;;;;;;5,0;;;1,0;;;1,0;;;;;;;;;;;;;;;;;;;;;;;2,0;;;;;;;2,0;;;2,0;;;;;;;;;;;;;;;;;;;1,0;;3,0;;;;1,0;;;;;;;;;;;;;;;;;;;;;;;;;;;;;;;;;;;;;;;;;;;;;;;;;;;;;;;;1,0;;;;;3,0;;;7,0;;;;;;;;;;;;;;;;;;;;;;;;;;;;2,0;;;;;;;;;;;;;5,0;;;;;;;;;;;;;;;;;;;;;;;;;;;;;;;;;;;;;;;;;;;;3,0;;;;;4,0;;;1,0;;;;;;;;1,0;;;;;;;;;;;;;;;;4,0;;;;;;;;;1,0;;;;;;;;2,0;;;;;;1,0;;;14,0;1,0;;;;;6,0;2,0;;;;;2,0;;;;;;6,0;;;;;;;;;;;;;;;;;;;;;;;;;;4,0;;;;;;;;;;;;;;;;;;;;;;;;;;;;;;;;;;;;;;;1,0;;;;;;;;;;;;;;;;;;;;;;;;;;;;;;;;;;;;;;;;;;;;;2,0;;;;;;;;;;;2,0;1,0;;;;;;;;;;;;;;;3,0;;;;;;;;;;;;;;;;;;;;;;;;;;;;;;;;;;;;;;;;;;;;;;;;;;;;;;;;;;;;;;;;;;;;;;;;;;;;;;;3,0;;;;;4,0;1,0;;;;;;;;;;;;;;;;;;;;;;;;;;;;;;;
signature;;;;;;;;;3,0;;;;;28,0;;;2,0;;;;;;;;;;;;1,0;;;;;;;19,0;3,0;;;;25,0;19,0;;;;;;4,0;;;;;;;2,0;;;;;18,0;;;10,0;;35,0;;20,0;;1,0;;;;;;;;;;;;33,0;;9,0;1,0;1,0;;;;;1,0;;;3,0;;;;;;15,0;4,0;3,0;6,0;;2,0;;;;;;;;;6,0;;;5,0;;16,0;;;;;;;;1,0;41,0;;;;32,0;;;;2,0;;6,0;;;;;;;;;13,0;22,0;;21,0;;;;;;;;;;;;;;;;;11,0;;;;3,0;;;;;;;;;;;;;;;;;;;2,0;;;;2,0;;;;;;;;;;;;;;;;;;;;13,0;;;;1,0;;;;2,0;;;;;;4,0;;;11,0;;;;;;;;;;28,0;;;;;;2,0;;;;;;;;1,0;;;;;;;2,0;;;;;2,0;;;;;;;;;;;;;;;;;;;;;;;;;;;;;;;;;;;;;;;;;;;;;;;;;;;;;;;;97,0;;;;;;;;3,0;;;;;;;;;;;;;;;;;;;;;;;;;38,0;;;;8,0;;;;;;;;6,0;;;1,0;;;17,0;;;;;;15,0;8,0;;;;;;30,0;7,0;5,0;1,0;23,0;;;4,0;;;;;1,0;4,0;4,0;;;;;;3,0;;;;;;2,0;;;;;;;;;;;;;;4,0;2,0;4,0;;;;;;4,0;1,0;;;;;;;;2,0;;;2,0;;;7,0;;;;;;;;;;;;1,0;;;3,0;;;;;;;;;1,0;;;;;7,0;;;;;1,0;1,0;12,0;;;;;;;;4,0;1,0;;;;;;;;9,0;;;;;;;4,0;;1,0;49,0;;;;;;;;;;;;;;;;;;;;;;;;;;;;53,0;4,0;;;;;;;;;;;;3,0;;;1,0;;;;;;;;2,0;32,0;4,0;;;;;;;;;;;;;;;;;;;;;;;;;;20,0;;;;;5,0;;;;;;;18,0;;5,0;;;;;;;;;;;;;;;;;;;;;;;;;;;;1,0;;;;;;;;;;;;;;;;;;;;;;;;;;;;5,0;;;;;;;;;;;;;;;;;;;;;;;;;1,0;;;;;;;;;;;;;;;;;;;;;;;;;;;;;;;;;2,0;;;;10,0;;;;;;;;;;;7,0;7,0;;;;;3,0;;;;;;;;;;;;;;;;;;;;;;;;;;;;;;;;;;;;;;;;;;;;;;;;5,0;;;;;;;;;;;;;;;;;2,0;;;;;;;;;;;;;1,0;;;2,0;;1,0;;;;;;;;;;;;;;;;;;;;3,0;;;;;1,0;;;;;;9,0;;;;;;;;;1,0;;;;;;;;;;;;;;;;;;;;;;2,0;;;;;;4,0;;;;;;;;;;;;;;;;;;;;;;;;;;;;;;;;;;;;;;;1,0;;;;;;;;;;;;;;;;;;;;4,0;;;;;;;;;;;;;;;;;;;;;;;;1,0;;;;;;;1,0;;;;3,0;;;;;;;;;;;;;;
judgment;;;;;;;;;;;;;;13,0;;;;;;;;;;;;;;;;;;;;;;32,0;;;;;;1,0;;;;;;;;;1,0;;;;;;;;;;;;;;;;;;;;;15,0;;;;;;;;;;;;;;;;;;;;;;2,0;;;22,0;;1,0;;;;;;;6,0;;;;;;;;;;;;;;;;;2,0;1,0;;;;;;;4,0;;;;;;;;;;;;;;;;;;;;;;1,0;;;;;;;;;;;;;;;;;;;;;;;;;;;;;;;;;;;;;;;;;;;;;;;;;;;;;4,0;;;;;;;;;;;;;;;;;;;;;;;;;;;;;;;;;;;;;;;;;;;;;;;;;;;;;;;;;;;;;;;;;;;;;;;;;;;;;;;;;;;4,0;;;;;;;;;;;;;;;;;;;;;;;;;;;;;;;;;;;;;;;;;;;;;;;;;;;;;;;;;;;;;;;;;;;;;;;;;;;;;;;;;;;;1,0;;;;;;5,0;;;;;;;;;;;;;;;;;;;;;;;;;8,0;;;;;;;;;;;;;;;;;;;;;;15,0;;2,0;;;;;;;;;1,0;;;;;;;;;;;;;;;;;;;;;;;;;;;;;;;;;;;;;;;;;;;;;;;;;;23,0;;;;;;;;14,0;;;;;;;;;;;;;;;;;;;;;;;;;;;;;;;;;;;;;;;;;;;;;;;;;;;;;;;;;;;;;;;;;;;;;;;;;;;;;;;;;;;;;;;;;;;;;;;;;;;;;;;;;;;;;;;;;;;;;;;;;;;;;;;;;;;;;2,0;;;;;;;;;;;;;;;;;;;;;;;;;;;;;;;;;;1,0;;;;;;;;;;;;;;;;;18,0;;;;;;1,0;;;;;;;;;;;;;;;;;;;4,0;;;;;;;;;;;;;;;4,0;;;;;;;;;;;;;;;1,0;;;;;;;;;;;;;;;;;;;;;;;;;;;;;;;;;;;;;;;;;;;;;;;;;;;;;;;;;;;16,0;;;;;;;;;;;;;;;;;;;;;;;;;;;;;;;;;;;;;;;;;;;;;;;26,0;;;;;;;;;;;;;;;;;;;;;;;;;;;;;;;;;;;;;;;;;;;;;;;;;;;;;;;;;;;;;;;;;;;;;;;;;;;;;;;;;;;;;;;;;;;;;;;;;;;;;;;;;;;;;;;;;;;;;;;;;;;;;;;;;;;;;;;;;;;;;;;;;;;;;;;1,0;;;;;;;;;
player;;;;;;;;;;;;;;5,0;;;4,0;;;20,0;;;;;1,0;;;;3,0;;6,0;;;;;27,0;;;;;3,0;11,0;;4,0;9,0;;;1,0;;;;;;;;;;;;2,0;;;17,0;;5,0;;3,0;;;;;;4,0;;;;1,0;;11,0;1,0;13,0;;;;;;;;;;1,0;;;;;2,0;;;29,0;;1,0;4,0;;;;1,0;;;;;;;;;;;;;;;;;;;;3,0;36,0;;;;;;;;;;2,0;1,0;;;;;;;;1,0;;;13,0;;;;;;;;;;;;;;4,0;1,0;;;;;;5,0;;;;;;;;;;;;;;2,0;;;;;;;;;;;;;;;;;;;1,0;;;;;;;;;;;;;;;;;;1,0;;;;;;4,0;;;;;;;;;;;;;;;;;;;5,0;;;;;;;;;;;;;;;;;;;;;;;;20,0;;;;1,0;;;2,0;;;;;;;;;;;;;;;;;;;;;;;1,0;;;;;;;;3,0;;;;;;;;;;;;;1,0;;;;;;;;;;;;;;;;;;;;;;;;;1,0;;;;;;;;;;;;;61,0;2,0;;;;;;;2,0;;;;;;;1,0;;;;;2,0;;4,0;;;;;28,0;;;;10,0;;;;;;;;8,0;2,0;;;3,0;1,0;;;;;;1,0;;;;;;2,0;;;;;;;;;;;1,0;;;;;1,0;;;;3,0;;2,0;;;;;;;;;2,0;;;1,0;2,0;;;;;;;;;;;;;;;;;;;;;;;;2,0;;;;;;10,0;;;;;;;;19,0;;;;;;;;;1,0;;9,0;;;;;;;;;;1,0;;3,0;;;;;;;;;;;;;;;;;;;6,0;;;;;;;;;;2,0;;;;;;23,0;;;;;;;;;;;;;;;;;;;;;2,0;;1,0;;;;;;;;;;;;1,0;;;4,0;;;;;;;;;;;;;;;;;;;2,0;3,0;;2,0;;;;;;;;;;;;;8,0;;;;;;;;;;;;;;;;;;;;;;6,0;;;1,0;;;;;;;;;;;;;;;;;;;;;;;;;;2,0;;;;;;3,0;;;;;;;;;;;;;;;;;;;;;;;;;;;;;;;;;;;;;;;;;;;;;2,0;;;;;;;;;;;;;;;;;;;;;;;;;;;;;;;;;;;;;;;;;;;;;;;;;;;;;;;;;;;;;4,0;;;;;;;;;;;;;;;;;;;;;;;;;;;;;;;;;;;;;;;;;;;;;;;;;;;;;;;;;;;;;;;;;;;;;;;;;;;;;;;;;;;;;;;;;;;;;;;;;;;;;;3,0;;;;;;;;;;;8,0;;;;;;;;;;1,0;;;;;;;1,0;;;;;;;;;;;;;;;;;;;2,0;;;;;;;;;;;;;;;;;;;;;;;;;;;;;;;;;;;;;;;;;2,0;;;;;;;;;;;;;;;;;;;;;;;;;;;;
conditional;;;;;;;;;;;;;;;;;;;;;;2,0;;;;;;;;3,0;6,0;;;;;;1,0;1,0;;;4,0;;;;3,0;;;1,0;21,0;;;;;;6,0;20,0;5,0;;;;;;19,0;;11,0;;;;;;9,0;80,0;;;2,0;;;;;;;;;;8,0;;;66,0;;;;;;;;;;;;;2,0;;;;;;;;;;;;;;;;;;;;;;2,0;;1,0;;81,0;;;2,0;4,0;;;;;;3,0;;18,0;;;;;;;;;;;;;;3,0;;;;;;;;;;;;;;;;;2,0;;;;;;;2,0;;;;;;;;;;;;;;;;;;;;;;;;;;;;;;1,0;;;4,0;5,0;;;;;;;;1,0;1,0;;;;;;;5,0;;;;;;1,0;;;;;;;4,0;;;;;;;;;7,0;;;;;;;;;5,0;;;;;;;;;;;;;;;1,0;;;;;;;;;;4,0;;;;;;;;1,0;;;;;;7,0;;;2,0;;;;;;;;;5,0;18,0;;;;;;;;;;;;3,0;;;;;;;2,0;;;;;;;;;;;;;;;;;;;;;;;;;;;;;;;;1,0;;;;;;;;;;;;;;;;;;;;;;;;;;;;;;;;;;;;;;2,0;;;;;;;;;;;;;2,0;;;;;;;;;;;;;;;;;;;;;;;;;;;;;;;;;;;;;;;;2,0;;;;;;;;;;;;;;;;;;;;;;;;;;;;;1,0;;;;;;1,0;;;;;;;;;;;;;;;;;;;;;;;;;;;;;;;;;;;;;;;;;;;;;;;;;;5,0;;;;;;;;;;;;;;;;;;;;;;;;;;;;;;;;;;;;;;;;;;;;;;;;;;;;;2,0;;;;;;;;;;;;;;;;;;;;;;;;;;;;;;;;;;;;;;;;;;;;;;;;;;;;;1,0;;;;;;;;;;;;;;;;;;;;;;;;;;;;;;;;;;;;;;;;;;;;;;;;;;;;;;;;;;;;;;;;;;;;3,0;;;;;;;;4,0;1,0;;;;;;;;;;;;;;;;;;;;;;;;;;;;;;;;;;;;;;;;;;;;;;;;;;;;;;;;;;;;;;;;;;;;;;;;;;;;;;;;;;;;;;;;;;;;;;;;;;;;;;;;;;;;;2,0;;;;;;;;;;;;;;;;;1,0;;;;;;;;;;;;;;;;;;;;;1,0;;;;;;194,0;;;;;;;;;;;;;;;;;;;;;;;;;;;;;;;;;;;;;;;;;;;;;;;;;;;;;;;;;11,0;;;;;;;;;;;;;;;;;;14,0;;;;;;;;;;;;;;;;;;;;;;;;;;;;;;;;;;;29,0;;;;;;;;277,0;;;;;;;;;
omega;;;;;;;;;;;;;;;;;;;;;;;;;;;;;;2,0;;;;;;;2,0;1,0;;;2,0;;;;;;;2,0;;;;2,0;;;;1,0;;;;;;;;;1,0;;;;;;6,0;7,0;2,0;;;;;;;;2,0;;;;2,0;;;;;;;;;;;;2,0;;;;;;;;;;;;;;;;2,0;;;;;;;;;;;;;;14,0;9,0;;1,0;;;;1,0;;;13,0;;;;;;;;;;2,0;;;;;;;;;;;;;;;;;;;;;;;;;;;14,0;;;;;;;;;;;;;;;;;;;2,0;;;;;6,0;;;;;10,0;;;;;;;;;;;;;;;;;;;;;;;;;;;;;;;;;;2,0;;;;;;;;;;;;;;;;;;;;;12,0;;;;;;;;;;;;;;;;;;;;19,0;;;;;;;;;;;;;;;;;;;;;;;;;;;;;;;;;;;;;;;;;;;;2,0;;;;;;;;;;;;;;;;;;;;;;;;;;;;;;;;;;;;;;;;;;;;;;;;;;;;;;;;;;;;;;;;;;;;;;;;1,0;;2,0;14,0;;2,0;;;;;;;2,0;;;;;;;;;;;;;;;;;;;;;;;;;;;;;;;;;;;;;;2,0;;;;;;;;;;;;;;;;;;;;;;;;;;;;;;;;;2,0;;;;;;;;;;;;;;;;;;;;;;;;;;;;;;;;;;;;;;;;;;;;;;;;;;;;;;;;;;;;;;;;;;;;;;;;;;;;;;;;;;;;;;;;;;;;;;;;;;;;;;;;;;;;;;;;;;;;;;;;;;;;;;;;;;;;;;;;;;;;;;;;;;;;;;;;;;;;;;;;;;;;;;;;;;;;;;;;;;;;;;;;;;;;;;;;;;2,0;;;;;;;;;;;;;;;;;;;;;;;;;;;;;;;;;;;;;;;;;;;;;;;;;1,0;;;;;;;;;;;;;;;2,0;2,0;;;;;;;;;;;;;;;;;;;;;1,0;;;;;;;;;;;;;;;;;;;;;;;;;;;;;;;;;;;;;;;;;;;;;;;;;;;;;;;;;;;;;;;;;;;;;;;;;;;;;;;;;;;;;;;;;;;;;;;;;;;;;;;;;;;;;;;;;;1,0;;;;;;;;;;;;;;;;;;;;;;;;;;;;;;;;;;;;;;;;;;;;;;;;;;;;;;;;;;;;;;;;;;;;;;;;;;;;;;;;;;;;;;;;;;;;;;;;;;;;;;;;;;;;;;;;;;;;;;;;;;;;;;;;;
